"NCE","County","CountyId","LocalityKey","LocalityId","NSV","NCAS","A_SVD","AP_SVD","APP_SVD","APS_SVD","TVE_SV","VN_SV","DENL","TIPL","ZONA","CODL","ION","EMIL"
1,"Alba",10,"10-MUNICIPIUL ALBA IULIA",1017,1,2,1370,1118,1054,64,1111,7,"MUNICIPIUL ALBA IULIA",,7,,387,724
1,"Alba",10,"10-MUNICIPIUL ALBA IULIA",1017,2,2,1120,936,781,155,931,5,"MUNICIPIUL ALBA IULIA",,7,,266,665
1,"Alba",10,"10-MUNICIPIUL ALBA IULIA",1017,3,2,1355,1054,1019,35,1047,7,"MUNICIPIUL ALBA IULIA",,7,,356,691
1,"Alba",10,"10-MUNICIPIUL ALBA IULIA",1017,4,2,1426,1192,1096,96,1190,2,"MUNICIPIUL ALBA IULIA",,7,,338,852
1,"Alba",10,"10-MUNICIPIUL ALBA IULIA",1017,5,2,1205,1023,856,167,1019,4,"MUNICIPIUL ALBA IULIA",,7,,312,707
1,"Alba",10,"10-MUNICIPIUL ALBA IULIA",1017,6,2,1219,1022,951,71,1021,1,"MUNICIPIUL ALBA IULIA",,7,,265,756
1,"Alba",10,"10-MUNICIPIUL ALBA IULIA",1017,7,2,1307,1076,997,79,1072,4,"MUNICIPIUL ALBA IULIA",,7,,319,753
1,"Alba",10,"10-MUNICIPIUL ALBA IULIA",1017,8,2,1347,1044,923,121,1042,2,"MUNICIPIUL ALBA IULIA",,7,,304,738
1,"Alba",10,"10-MUNICIPIUL ALBA IULIA",1017,9,2,1454,1162,939,223,1157,5,"MUNICIPIUL ALBA IULIA",,7,,294,863
1,"Alba",10,"10-MUNICIPIUL ALBA IULIA",1017,10,2,1224,871,794,77,870,1,"MUNICIPIUL ALBA IULIA",,7,,259,611
1,"Alba",10,"10-MUNICIPIUL ALBA IULIA",1017,11,2,1202,837,677,160,833,4,"MUNICIPIUL ALBA IULIA",,7,,189,644
1,"Alba",10,"10-MUNICIPIUL ALBA IULIA",1017,12,2,1096,775,712,63,771,4,"MUNICIPIUL ALBA IULIA",,7,,157,614
1,"Alba",10,"10-MUNICIPIUL ALBA IULIA",1017,13,2,1187,860,813,47,856,4,"MUNICIPIUL ALBA IULIA",,7,,216,640
1,"Alba",10,"10-MUNICIPIUL ALBA IULIA",1017,14,2,1214,918,724,194,915,3,"MUNICIPIUL ALBA IULIA",,7,,180,735
1,"Alba",10,"10-MUNICIPIUL ALBA IULIA",1017,15,2,1238,1018,809,209,1016,2,"MUNICIPIUL ALBA IULIA",,7,,244,772
1,"Alba",10,"10-MUNICIPIUL ALBA IULIA",1017,16,2,1395,1200,1090,110,1197,3,"MUNICIPIUL ALBA IULIA",,7,,270,927
1,"Alba",10,"10-MUNICIPIUL ALBA IULIA",1017,17,2,1128,849,821,28,847,2,"MUNICIPIUL ALBA IULIA",,7,,318,529
1,"Alba",10,"10-MUNICIPIUL ALBA IULIA",1017,18,2,1157,911,860,51,907,4,"MUNICIPIUL ALBA IULIA",,7,,303,604
1,"Alba",10,"10-MUNICIPIUL ALBA IULIA",1017,19,2,1421,946,882,64,943,3,"MUNICIPIUL ALBA IULIA",,7,,216,727
1,"Alba",10,"10-MUNICIPIUL ALBA IULIA",1017,20,2,1323,1017,958,59,1015,2,"MUNICIPIUL ALBA IULIA",,7,,266,749
1,"Alba",10,"10-MUNICIPIUL ALBA IULIA",1017,21,2,1390,1007,983,24,1003,4,"MUNICIPIUL ALBA IULIA",,7,,278,725
1,"Alba",10,"10-MUNICIPIUL ALBA IULIA",1017,22,2,1129,1074,1012,62,1070,4,"MUNICIPIUL ALBA IULIA",,7,,213,857
1,"Alba",10,"10-MUNICIPIUL ALBA IULIA",1017,23,2,1320,1018,980,38,1012,6,"MUNICIPIUL ALBA IULIA",,7,,208,804
1,"Alba",10,"10-MUNICIPIUL ALBA IULIA",1017,24,2,1227,896,843,53,894,2,"MUNICIPIUL ALBA IULIA",,7,,223,671
1,"Alba",10,"10-MUNICIPIUL ALBA IULIA",1017,25,2,1427,1038,953,85,1031,7,"MUNICIPIUL ALBA IULIA",,7,,267,764
1,"Alba",10,"10-MUNICIPIUL ALBA IULIA",1017,26,2,1321,955,899,56,954,1,"MUNICIPIUL ALBA IULIA",,7,,236,718
1,"Alba",10,"10-MUNICIPIUL ALBA IULIA",1017,27,2,1318,1025,957,68,1024,1,"MUNICIPIUL ALBA IULIA",,7,,231,793
1,"Alba",10,"10-MUNICIPIUL ALBA IULIA",1017,28,2,1193,938,889,49,933,5,"MUNICIPIUL ALBA IULIA",,7,,210,723
1,"Alba",10,"10-MUNICIPIUL ALBA IULIA",1017,29,2,1475,1162,1132,30,1158,4,"MUNICIPIUL ALBA IULIA",,7,,280,878
1,"Alba",10,"10-MUNICIPIUL ALBA IULIA",1017,30,2,1552,1096,1053,43,1086,10,"MUNICIPIUL ALBA IULIA",,7,,311,775
1,"Alba",10,"10-MUNICIPIUL ALBA IULIA",1017,31,2,1585,1308,1231,77,1308,0,"MUNICIPIUL ALBA IULIA",,7,,274,1034
1,"Alba",10,"10-MUNICIPIUL ALBA IULIA",1017,32,2,1702,1393,1235,158,1385,8,"MUNICIPIUL ALBA IULIA",,7,,271,1114
1,"Alba",10,"10-MUNICIPIUL ALBA IULIA",1017,33,2,1485,995,886,109,991,4,"MUNICIPIUL ALBA IULIA",,7,,142,849
1,"Alba",10,"10-MUNICIPIUL ALBA IULIA",1017,34,2,1406,1095,1032,63,1088,7,"MUNICIPIUL ALBA IULIA",,7,,239,849
1,"Alba",10,"10-MUNICIPIUL ALBA IULIA",1017,35,2,1493,1153,1103,50,1147,6,"MUNICIPIUL ALBA IULIA",,7,,153,994
1,"Alba",10,"10-MUNICIPIUL ALBA IULIA",1017,36,2,1619,1212,1119,93,1207,5,"MUNICIPIUL ALBA IULIA",,7,,189,1018
1,"Alba",10,"10-MUNICIPIUL ALBA IULIA",1017,37,2,1437,1062,1009,53,1056,6,"MUNICIPIUL ALBA IULIA",,7,,162,894
1,"Alba",10,"10-MUNICIPIUL ALBA IULIA",1017,38,2,1502,1234,1127,107,1229,5,"MUNICIPIUL ALBA IULIA",,7,,343,886
1,"Alba",10,"10-MUNICIPIUL ALBA IULIA",1017,39,2,1218,1024,931,93,1013,11,"MUNICIPIUL ALBA IULIA",,7,,361,652
1,"Alba",10,"10-MUNICIPIUL ALBA IULIA",1017,40,2,612,423,367,56,417,6,"MUNICIPIUL ALBA IULIA",,7,,107,310
1,"Alba",10,"10-MUNICIPIUL ALBA IULIA",1017,41,2,853,797,710,87,790,7,"MUNICIPIUL ALBA IULIA",,7,,256,534
1,"Alba",10,"10-MUNICIPIUL ALBA IULIA",1017,42,2,569,508,443,65,503,5,"MUNICIPIUL ALBA IULIA",,7,,131,372
1,"Alba",10,"10-MUNICIPIUL ALBA IULIA",1017,43,2,513,497,465,32,489,8,"MUNICIPIUL ALBA IULIA",,7,,194,295
1,"Alba",10,"10-MUNICIPIUL ALBA IULIA",1017,44,2,0,248,0,248,247,1,"MUNICIPIUL ALBA IULIA",,7,,118,129
1,"Alba",10,"10-MUNICIPIUL ALBA IULIA",1017,45,2,0,668,0,668,665,3,"MUNICIPIUL ALBA IULIA",,7,,194,471
1,"Alba",10,"10-MUNICIPIUL ALBA IULIA",1017,46,2,0,210,0,210,210,0,"MUNICIPIUL ALBA IULIA",,7,,32,178
1,"Alba",10,"10-MUNICIPIUL AIUD",1213,47,2,1953,1609,1399,210,1602,7,"MUNICIPIUL AIUD",,7,,574,1028
1,"Alba",10,"10-MUNICIPIUL AIUD",1213,48,2,1557,1283,1136,147,1274,9,"MUNICIPIUL AIUD",,7,,538,736
1,"Alba",10,"10-MUNICIPIUL AIUD",1213,49,2,1905,1460,1223,237,1454,6,"MUNICIPIUL AIUD",,7,,534,920
1,"Alba",10,"10-MUNICIPIUL AIUD",1213,50,2,1668,1323,1190,133,1321,2,"MUNICIPIUL AIUD",,7,,570,751
1,"Alba",10,"10-MUNICIPIUL AIUD",1213,51,2,1502,1111,972,139,1105,6,"MUNICIPIUL AIUD",,7,,340,765
1,"Alba",10,"10-MUNICIPIUL AIUD",1213,52,2,977,812,685,127,809,3,"MUNICIPIUL AIUD",,7,,277,532
1,"Alba",10,"10-MUNICIPIUL AIUD",1213,53,2,1527,1492,1056,436,1485,7,"MUNICIPIUL AIUD",,7,,502,983
1,"Alba",10,"10-MUNICIPIUL AIUD",1213,54,2,1829,1426,1307,119,1422,4,"MUNICIPIUL AIUD",,7,,498,924
1,"Alba",10,"10-MUNICIPIUL AIUD",1213,55,2,1663,1368,1227,141,1358,10,"MUNICIPIUL AIUD",,7,,531,827
1,"Alba",10,"10-MUNICIPIUL AIUD",1213,56,2,1620,1313,1163,150,1300,13,"MUNICIPIUL AIUD",,7,,456,844
1,"Alba",10,"10-MUNICIPIUL AIUD",1213,57,2,1695,1392,1234,158,1379,13,"MUNICIPIUL AIUD",,7,,473,906
1,"Alba",10,"10-MUNICIPIUL AIUD",1213,58,2,451,399,313,86,394,5,"MUNICIPIUL AIUD",,7,,202,192
1,"Alba",10,"10-MUNICIPIUL AIUD",1213,59,2,534,460,400,60,455,5,"MUNICIPIUL AIUD",,7,,156,299
1,"Alba",10,"10-MUNICIPIUL AIUD",1213,60,2,1011,875,774,101,867,8,"MUNICIPIUL AIUD",,7,,303,564
1,"Alba",10,"10-MUNICIPIUL AIUD",1213,61,2,567,507,424,83,504,3,"MUNICIPIUL AIUD",,7,,206,298
1,"Alba",10,"10-MUNICIPIUL AIUD",1213,62,2,404,390,298,92,386,4,"MUNICIPIUL AIUD",,7,,183,203
1,"Alba",10,"10-MUNICIPIUL AIUD",1213,63,2,378,353,277,76,350,3,"MUNICIPIUL AIUD",,7,,161,189
1,"Alba",10,"10-MUNICIPIUL AIUD",1213,64,2,378,386,363,23,386,0,"MUNICIPIUL AIUD",,7,,80,306
1,"Alba",10,"10-MUNICIPIUL BLAJ",1348,65,2,1289,1075,942,133,1070,5,"MUNICIPIUL BLAJ",,7,,281,789
1,"Alba",10,"10-MUNICIPIUL BLAJ",1348,66,2,1494,1183,1060,123,1177,6,"MUNICIPIUL BLAJ",,7,,434,743
1,"Alba",10,"10-MUNICIPIUL BLAJ",1348,67,2,1637,1282,1165,117,1279,3,"MUNICIPIUL BLAJ",,7,,439,840
1,"Alba",10,"10-MUNICIPIUL BLAJ",1348,68,2,1407,1167,936,231,1162,5,"MUNICIPIUL BLAJ",,7,,324,838
1,"Alba",10,"10-MUNICIPIUL BLAJ",1348,69,2,1529,1196,1077,119,1192,4,"MUNICIPIUL BLAJ",,7,,378,814
1,"Alba",10,"10-MUNICIPIUL BLAJ",1348,70,2,1665,1349,1259,90,1343,6,"MUNICIPIUL BLAJ",,7,,452,891
1,"Alba",10,"10-MUNICIPIUL BLAJ",1348,71,2,1515,1342,1066,276,1336,6,"MUNICIPIUL BLAJ",,7,,463,873
1,"Alba",10,"10-MUNICIPIUL BLAJ",1348,72,2,1883,1385,1283,102,1381,4,"MUNICIPIUL BLAJ",,7,,479,902
1,"Alba",10,"10-MUNICIPIUL BLAJ",1348,73,2,1834,1460,1311,149,1438,22,"MUNICIPIUL BLAJ",,7,,400,1038
1,"Alba",10,"10-MUNICIPIUL BLAJ",1348,74,2,1420,1126,975,151,1118,8,"MUNICIPIUL BLAJ",,7,,319,799
1,"Alba",10,"10-MUNICIPIUL BLAJ",1348,75,2,705,527,484,43,527,0,"MUNICIPIUL BLAJ",,7,,222,305
1,"Alba",10,"10-MUNICIPIUL BLAJ",1348,76,2,476,425,383,42,425,0,"MUNICIPIUL BLAJ",,7,,8,417
1,"Alba",10,"10-ORAS ABRUD",1151,77,2,2351,1846,1645,201,1824,22,"ORAS ABRUD",,7,,1053,771
1,"Alba",10,"10-ORAS ABRUD",1151,78,2,2200,1789,1442,347,1780,9,"ORAS ABRUD",,7,,826,954
1,"Alba",10,"10-ORAS ABRUD",1151,79,2,80,80,68,12,80,0,"ORAS ABRUD",,7,,34,46
1,"Alba",10,"10-ORAS CAMPENI",1455,80,2,1285,961,758,203,951,10,"ORAS CAMPENI",,7,,503,448
1,"Alba",10,"10-ORAS CAMPENI",1455,81,2,1726,1254,1165,89,1245,9,"ORAS CAMPENI",,7,,643,602
1,"Alba",10,"10-ORAS CAMPENI",1455,82,2,1416,1165,962,203,1152,13,"ORAS CAMPENI",,7,,583,569
1,"Alba",10,"10-ORAS CAMPENI",1455,83,2,672,477,413,64,470,7,"ORAS CAMPENI",,7,,204,266
1,"Alba",10,"10-ORAS CAMPENI",1455,84,2,568,384,321,63,383,1,"ORAS CAMPENI",,7,,169,214
1,"Alba",10,"10-ORAS CAMPENI",1455,85,2,690,304,267,37,301,3,"ORAS CAMPENI",,7,,167,134
1,"Alba",10,"10-ORAS CAMPENI",1455,86,2,297,282,165,117,278,4,"ORAS CAMPENI",,7,,167,111
1,"Alba",10,"10-ORAS CAMPENI",1455,87,2,187,146,136,10,145,1,"ORAS CAMPENI",,7,,71,74
1,"Alba",10,"10-ORAS CUGIR",1696,88,2,2096,1416,1335,81,1411,5,"ORAS CUGIR",,7,,591,820
1,"Alba",10,"10-ORAS CUGIR",1696,89,2,1578,1169,1038,131,1162,7,"ORAS CUGIR",,7,,503,659
1,"Alba",10,"10-ORAS CUGIR",1696,90,2,1668,1196,1118,78,1190,6,"ORAS CUGIR",,7,,495,695
1,"Alba",10,"10-ORAS CUGIR",1696,91,2,1378,1097,936,161,1090,7,"ORAS CUGIR",,7,,416,674
1,"Alba",10,"10-ORAS CUGIR",1696,92,2,1305,1005,980,25,1000,5,"ORAS CUGIR",,7,,429,571
1,"Alba",10,"10-ORAS CUGIR",1696,93,2,1163,924,756,168,918,6,"ORAS CUGIR",,7,,370,548
1,"Alba",10,"10-ORAS CUGIR",1696,94,2,1559,1088,1060,28,1086,2,"ORAS CUGIR",,7,,516,570
1,"Alba",10,"10-ORAS CUGIR",1696,95,2,1512,1247,1077,170,1245,2,"ORAS CUGIR",,7,,546,699
1,"Alba",10,"10-ORAS CUGIR",1696,96,2,1323,1143,892,251,1133,10,"ORAS CUGIR",,7,,546,587
1,"Alba",10,"10-ORAS CUGIR",1696,97,2,1800,1165,1023,142,1153,12,"ORAS CUGIR",,7,,453,700
1,"Alba",10,"10-ORAS CUGIR",1696,98,2,1518,1022,934,88,1017,5,"ORAS CUGIR",,7,,494,523
1,"Alba",10,"10-ORAS CUGIR",1696,99,2,1318,916,853,63,913,3,"ORAS CUGIR",,7,,426,487
1,"Alba",10,"10-ORAS CUGIR",1696,100,2,1200,1003,885,118,992,11,"ORAS CUGIR",,7,,410,582
1,"Alba",10,"10-ORAS CUGIR",1696,101,2,1281,908,814,94,906,2,"ORAS CUGIR",,7,,381,525
1,"Alba",10,"10-ORAS CUGIR",1696,102,2,1324,1055,840,215,1051,4,"ORAS CUGIR",,7,,406,645
1,"Alba",10,"10-ORAS CUGIR",1696,103,2,929,775,627,148,768,7,"ORAS CUGIR",,7,,341,427
1,"Alba",10,"10-ORAS CUGIR",1696,104,2,976,742,622,120,728,14,"ORAS CUGIR",,7,,391,337
1,"Alba",10,"10-ORAS CUGIR",1696,105,2,101,117,100,17,117,0,"ORAS CUGIR",,7,,62,55
1,"Alba",10,"10-ORAS OCNA MURES",1794,106,2,2044,1430,1404,26,1422,8,"ORAS OCNA MURES",,7,,451,971
1,"Alba",10,"10-ORAS OCNA MURES",1794,107,2,2135,1690,1618,72,1684,6,"ORAS OCNA MURES",,7,,471,1213
1,"Alba",10,"10-ORAS OCNA MURES",1794,108,2,734,566,541,25,563,3,"ORAS OCNA MURES",,7,,196,367
1,"Alba",10,"10-ORAS OCNA MURES",1794,109,2,1158,926,895,31,922,4,"ORAS OCNA MURES",,7,,375,547
1,"Alba",10,"10-ORAS OCNA MURES",1794,110,2,1186,996,934,62,990,6,"ORAS OCNA MURES",,7,,279,711
1,"Alba",10,"10-ORAS OCNA MURES",1794,111,2,1485,1242,1118,124,1237,5,"ORAS OCNA MURES",,7,,370,867
1,"Alba",10,"10-ORAS OCNA MURES",1794,112,2,1093,844,793,51,837,7,"ORAS OCNA MURES",,7,,380,457
1,"Alba",10,"10-ORAS OCNA MURES",1794,113,2,1079,836,796,40,822,14,"ORAS OCNA MURES",,7,,318,504
1,"Alba",10,"10-ORAS OCNA MURES",1794,114,2,770,574,530,44,565,9,"ORAS OCNA MURES",,7,,265,300
1,"Alba",10,"10-ORAS OCNA MURES",1794,115,2,1202,1012,892,120,1007,5,"ORAS OCNA MURES",,7,,466,541
1,"Alba",10,"10-ORAS SEBES",1874,116,2,964,702,660,42,699,3,"ORAS SEBES",,7,,242,457
1,"Alba",10,"10-ORAS SEBES",1874,117,2,1384,1034,913,121,1024,10,"ORAS SEBES",,7,,319,705
1,"Alba",10,"10-ORAS SEBES",1874,118,2,1964,1334,1263,71,1331,3,"ORAS SEBES",,7,,359,972
1,"Alba",10,"10-ORAS SEBES",1874,119,2,934,767,656,111,760,7,"ORAS SEBES",,7,,225,535
1,"Alba",10,"10-ORAS SEBES",1874,120,2,1988,1484,1437,47,1478,6,"ORAS SEBES",,7,,435,1043
1,"Alba",10,"10-ORAS SEBES",1874,121,2,1480,1128,1014,114,1122,6,"ORAS SEBES",,7,,344,778
1,"Alba",10,"10-ORAS SEBES",1874,122,2,1871,1376,1245,131,1368,8,"ORAS SEBES",,7,,371,997
1,"Alba",10,"10-ORAS SEBES",1874,123,2,1262,1191,956,235,1186,5,"ORAS SEBES",,7,,370,816
1,"Alba",10,"10-ORAS SEBES",1874,124,2,1536,1159,1114,45,1103,11,"ORAS SEBES",,7,,318,785
1,"Alba",10,"10-ORAS SEBES",1874,125,2,1721,1241,1109,132,1236,5,"ORAS SEBES",,7,,287,949
1,"Alba",10,"10-ORAS SEBES",1874,126,2,1887,1339,1163,176,1335,4,"ORAS SEBES",,7,,299,1036
1,"Alba",10,"10-ORAS SEBES",1874,127,2,946,798,666,132,795,3,"ORAS SEBES",,7,,205,590
1,"Alba",10,"10-ORAS SEBES",1874,128,2,1173,892,798,94,889,3,"ORAS SEBES",,7,,238,651
1,"Alba",10,"10-ORAS SEBES",1874,129,2,1341,1033,828,205,1026,7,"ORAS SEBES",,7,,271,755
1,"Alba",10,"10-ORAS SEBES",1874,130,2,1512,1387,1022,365,1374,13,"ORAS SEBES",,7,,369,1005
1,"Alba",10,"10-ORAS SEBES",1874,131,2,666,540,433,107,539,1,"ORAS SEBES",,7,,222,317
1,"Alba",10,"10-ORAS SEBES",1874,132,2,205,189,0,189,189,0,"ORAS SEBES",,7,,60,129
1,"Alba",10,"10-ORAS TEIUS",8096,133,2,1379,1051,952,99,1043,8,"ORAS TEIUS",,7,,344,699
1,"Alba",10,"10-ORAS TEIUS",8096,134,2,1343,1049,998,51,1044,5,"ORAS TEIUS",,7,,357,687
1,"Alba",10,"10-ORAS TEIUS",8096,135,2,1344,919,827,92,911,8,"ORAS TEIUS",,7,,293,618
1,"Alba",10,"10-ORAS TEIUS",8096,136,2,827,982,624,358,970,12,"ORAS TEIUS",,7,,316,654
1,"Alba",10,"10-ORAS TEIUS",8096,137,2,205,160,141,19,159,1,"ORAS TEIUS",,7,,76,83
1,"Alba",10,"10-ORAS TEIUS",8096,138,2,241,196,168,28,194,2,"ORAS TEIUS",,7,,50,144
1,"Alba",10,"10-ORAS TEIUS",8096,139,2,225,183,156,27,181,2,"ORAS TEIUS",,7,,82,99
1,"Alba",10,"10-ORAS ZLATNA",1936,140,2,1375,1068,917,151,1060,8,"ORAS ZLATNA",,7,,536,524
1,"Alba",10,"10-ORAS ZLATNA",1936,141,2,2217,1852,1582,270,1840,12,"ORAS ZLATNA",,7,,681,1159
1,"Alba",10,"10-ORAS ZLATNA",1936,142,2,1245,889,825,64,882,7,"ORAS ZLATNA",,7,,421,461
1,"Alba",10,"10-ORAS ZLATNA",1936,143,2,871,443,398,45,440,3,"ORAS ZLATNA",,7,,227,213
1,"Alba",10,"10-ORAS ZLATNA",1936,144,2,492,382,338,44,380,2,"ORAS ZLATNA",,7,,229,151
1,"Alba",10,"10-ORAS ZLATNA",1936,145,2,487,289,261,28,286,3,"ORAS ZLATNA",,7,,125,161
1,"Alba",10,"10-ORAS ZLATNA",1936,146,2,398,326,292,34,326,0,"ORAS ZLATNA",,7,,179,147
1,"Alba",10,"10-ALBAC",2130,147,2,1291,810,710,100,804,6,"ALBAC",,7,,417,387
1,"Alba",10,"10-ALBAC",2130,148,2,444,284,242,42,281,3,"ALBAC",,7,,172,109
1,"Alba",10,"10-ALBAC",2130,149,2,179,130,98,32,127,3,"ALBAC",,7,,69,58
1,"Alba",10,"10-ALMASU MARE",2309,150,2,388,248,219,29,247,1,"ALMASU MARE",,7,,129,118
1,"Alba",10,"10-ALMASU MARE",2309,151,2,413,328,235,93,324,4,"ALMASU MARE",,7,,156,168
1,"Alba",10,"10-ALMASU MARE",2309,152,2,180,135,111,24,133,2,"ALMASU MARE",,7,,74,59
1,"Alba",10,"10-ALMASU MARE",2309,153,2,350,225,206,19,222,3,"ALMASU MARE",,7,,104,118
1,"Alba",10,"10-ALMASU MARE",2309,154,2,205,164,146,18,164,0,"ALMASU MARE",,7,,82,82
1,"Alba",10,"10-ARIESENI",2381,155,2,1233,938,886,52,925,13,"ARIESENI",,7,,698,227
1,"Alba",10,"10-ARIESENI",2381,156,2,88,85,73,12,84,1,"ARIESENI",,7,,77,7
1,"Alba",10,"10-ARIESENI",2381,157,2,212,154,129,25,154,0,"ARIESENI",,7,,91,63
1,"Alba",10,"10-AVRAM IANCU",2577,158,2,1004,688,565,123,682,6,"AVRAM IANCU",,7,,239,443
1,"Alba",10,"10-AVRAM IANCU",2577,159,2,797,598,498,100,586,12,"AVRAM IANCU",,7,,284,302
1,"Alba",10,"10-BAIA DE ARIES",2924,160,2,1147,846,723,123,843,3,"BAIA DE ARIES",,7,,422,421
1,"Alba",10,"10-BAIA DE ARIES",2924,161,2,1435,1173,981,192,1171,2,"BAIA DE ARIES",,7,,456,715
1,"Alba",10,"10-BAIA DE ARIES",2924,162,2,248,184,151,33,184,0,"BAIA DE ARIES",,7,,92,92
1,"Alba",10,"10-BAIA DE ARIES",2924,163,2,315,253,219,34,252,1,"BAIA DE ARIES",,7,,92,160
1,"Alba",10,"10-BAIA DE ARIES",2924,164,2,372,276,241,35,275,1,"BAIA DE ARIES",,7,,154,121
1,"Alba",10,"10-BERGHIN",2988,165,2,443,426,306,120,419,7,"BERGHIN",,7,,167,252
1,"Alba",10,"10-BERGHIN",2988,166,2,578,402,373,29,395,7,"BERGHIN",,7,,155,240
1,"Alba",10,"10-BERGHIN",2988,167,2,383,308,271,37,308,0,"BERGHIN",,7,,128,180
1,"Alba",10,"10-BERGHIN",2988,168,2,316,249,202,47,249,0,"BERGHIN",,7,,83,166
1,"Alba",10,"10-BISTRA",3039,169,2,2070,1573,1360,213,1565,8,"BISTRA",,7,,994,571
1,"Alba",10,"10-BISTRA",3039,170,2,1014,622,573,49,616,6,"BISTRA",,7,,377,239
1,"Alba",10,"10-BISTRA",3039,171,2,657,392,361,31,391,1,"BISTRA",,7,,270,121
1,"Alba",10,"10-BLANDIANA",3397,172,2,515,425,361,64,420,5,"BLANDIANA",,7,,123,297
1,"Alba",10,"10-BLANDIANA",3397,173,2,401,276,253,23,273,3,"BLANDIANA",,7,,144,129
1,"Alba",10,"10-BLANDIANA",3397,174,2,52,43,29,14,43,0,"BLANDIANA",,7,,9,34
1,"Alba",10,"10-BUCIUM",3459,175,2,489,366,291,75,366,0,"BUCIUM",,7,,235,131
1,"Alba",10,"10-BUCIUM",3459,176,2,482,343,295,48,339,4,"BUCIUM",,7,,187,152
1,"Alba",10,"10-BUCIUM",3459,177,2,299,227,192,35,224,3,"BUCIUM",,7,,94,130
1,"Alba",10,"10-BUCIUM",3459,178,2,367,240,214,26,232,8,"BUCIUM",,7,,132,100
1,"Alba",10,"10-CENADE",3761,179,2,765,540,460,80,530,10,"CENADE",,7,,126,404
1,"Alba",10,"10-CERGAU",3805,180,2,836,618,541,77,614,4,"CERGAU",,7,,327,287
1,"Alba",10,"10-CERGAU",3805,181,2,323,265,215,50,262,3,"CERGAU",,7,,107,155
1,"Alba",10,"10-CERGAU",3805,182,2,334,246,197,49,242,4,"CERGAU",,7,,111,131
1,"Alba",10,"10-CERU-BACAINTI",3841,183,2,364,194,165,29,190,4,"CERU-BACAINTI",,7,,81,109
1,"Alba",10,"10-CETATEA DE BALTA",3958,184,2,1808,1401,1309,92,1385,16,"CETATEA DE BALTA",,7,,597,788
1,"Alba",10,"10-CETATEA DE BALTA",3958,185,2,234,185,166,19,183,2,"CETATEA DE BALTA",,7,,58,125
1,"Alba",10,"10-CETATEA DE BALTA",3958,186,2,597,419,364,55,407,12,"CETATEA DE BALTA",,7,,275,132
1,"Alba",10,"10-CIUGUD",1071,187,2,514,501,417,84,496,5,"CIUGUD",,7,,209,287
1,"Alba",10,"10-CIUGUD",1071,188,2,538,477,383,94,475,2,"CIUGUD",,7,,186,289
1,"Alba",10,"10-CIUGUD",1071,189,2,420,375,318,57,371,4,"CIUGUD",,7,,119,252
1,"Alba",10,"10-CIUGUD",1071,190,2,350,309,251,58,306,3,"CIUGUD",,7,,123,183
1,"Alba",10,"10-CIURULEASA",4008,191,2,1209,768,740,28,761,7,"CIURULEASA",,7,,414,347
1,"Alba",10,"10-CALNIC",4106,192,2,823,576,470,106,573,3,"CALNIC",,7,,208,365
1,"Alba",10,"10-CALNIC",4106,193,2,1033,843,773,70,835,8,"CALNIC",,7,,243,592
1,"Alba",10,"10-CALNIC",4106,194,2,423,326,295,31,321,5,"CALNIC",,7,,62,259
1,"Alba",10,"10-CRICAU",4142,195,2,926,720,607,113,711,9,"CRICAU",,7,,263,448
1,"Alba",10,"10-CRICAU",4142,196,2,265,236,207,29,233,3,"CRICAU",,7,,84,149
1,"Alba",10,"10-CRICAU",4142,197,2,358,279,232,47,279,0,"CRICAU",,7,,98,181
1,"Alba",10,"10-CRACIUNELU DE JOS",4188,198,2,1543,1247,1102,145,1239,8,"CRACIUNELU DE JOS",,7,,518,721
1,"Alba",10,"10-CRACIUNELU DE JOS",4188,199,2,1715,1268,1180,88,1244,24,"CRACIUNELU DE JOS",,7,,393,851
1,"Alba",10,"10-DAIA ROMANA",4240,200,2,2383,1592,1525,67,1572,20,"DAIA ROMANA",,7,,730,842
1,"Alba",10,"10-DOSTAT",4268,201,2,574,395,359,36,388,7,"DOSTAT",,7,,190,198
1,"Alba",10,"10-DOSTAT",4268,202,2,268,240,194,46,239,1,"DOSTAT",,7,,104,135
1,"Alba",10,"10-FARAU",4302,203,2,595,404,375,29,400,4,"FARAU",,7,,154,246
1,"Alba",10,"10-FARAU",4302,204,2,312,238,205,33,235,3,"FARAU",,7,,84,151
1,"Alba",10,"10-FARAU",4302,205,2,206,144,121,23,139,5,"FARAU",,7,,18,121
1,"Alba",10,"10-FARAU",4302,206,2,355,246,217,29,243,3,"FARAU",,7,,119,124
1,"Alba",10,"10-FARAU",4302,207,2,416,284,253,31,276,8,"FARAU",,7,,136,140
1,"Alba",10,"10-GALDA DE JOS",4366,208,2,1448,1124,959,165,1119,5,"GALDA DE JOS",,7,,385,734
1,"Alba",10,"10-GALDA DE JOS",4366,209,2,386,309,254,55,308,1,"GALDA DE JOS",,7,,110,198
1,"Alba",10,"10-GALDA DE JOS",4366,210,2,494,312,284,28,305,7,"GALDA DE JOS",,7,,118,187
1,"Alba",10,"10-GALDA DE JOS",4366,211,2,568,368,303,65,363,5,"GALDA DE JOS",,7,,115,248
1,"Alba",10,"10-GALDA DE JOS",4366,212,2,644,521,459,62,518,3,"GALDA DE JOS",,7,,100,418
1,"Alba",10,"10-GARBOVA",4482,213,2,1036,814,684,130,806,8,"GARBOVA",,7,,257,549
1,"Alba",10,"10-GARBOVA",4482,214,2,294,235,196,39,233,2,"GARBOVA",,7,,99,134
1,"Alba",10,"10-GARBOVA",4482,215,2,175,187,134,53,186,1,"GARBOVA",,7,,67,119
1,"Alba",10,"10-GARDA DE SUS",4525,216,2,1003,704,561,143,690,14,"GARDA DE SUS",,7,,418,272
1,"Alba",10,"10-GARDA DE SUS",4525,217,2,161,104,82,22,102,2,"GARDA DE SUS",,7,,60,42
1,"Alba",10,"10-GARDA DE SUS",4525,218,2,452,331,225,106,329,2,"GARDA DE SUS",,7,,269,60
1,"Alba",10,"10-HOPARTA",4703,219,2,346,282,265,17,278,4,"HOPARTA",,7,,129,149
1,"Alba",10,"10-HOPARTA",4703,220,2,159,166,134,32,162,4,"HOPARTA",,7,,94,68
1,"Alba",10,"10-HOPARTA",4703,221,2,273,218,182,36,215,3,"HOPARTA",,7,,86,129
1,"Alba",10,"10-HOPARTA",4703,222,2,298,283,252,31,282,1,"HOPARTA",,7,,118,164
1,"Alba",10,"10-HOPARTA",4703,223,2,172,177,138,39,177,0,"HOPARTA",,7,,80,97
1,"Alba",10,"10-HOREA",4767,224,2,1059,761,723,38,754,7,"HOREA",,7,,535,219
1,"Alba",10,"10-HOREA",4767,225,2,366,359,336,23,357,2,"HOREA",,7,,303,54
1,"Alba",10,"10-HOREA",4767,226,2,377,304,285,19,301,3,"HOREA",,7,,251,50
1,"Alba",10,"10-IGHIU",4927,227,2,894,648,559,89,641,7,"IGHIU",,7,,206,435
1,"Alba",10,"10-IGHIU",4927,228,2,848,694,581,113,692,2,"IGHIU",,7,,286,406
1,"Alba",10,"10-IGHIU",4927,229,2,826,558,545,13,546,12,"IGHIU",,7,,99,447
1,"Alba",10,"10-IGHIU",4927,230,2,1344,1069,879,190,1061,8,"IGHIU",,7,,249,812
1,"Alba",10,"10-IGHIU",4927,231,2,979,593,576,17,586,7,"IGHIU",,7,,205,381
1,"Alba",10,"10-INTREGALDE",4981,232,2,478,252,207,45,250,2,"INTREGALDE",,7,,80,170
1,"Alba",10,"10-INTREGALDE",4981,233,2,155,105,69,36,104,1,"INTREGALDE",,7,,18,86
1,"Alba",10,"10-INTREGALDE",4981,234,2,196,175,132,43,171,4,"INTREGALDE",,7,,42,129
1,"Alba",10,"10-JIDVEI",5103,235,2,829,705,528,177,698,7,"JIDVEI",,7,,260,438
1,"Alba",10,"10-JIDVEI",5103,236,2,719,608,490,118,597,11,"JIDVEI",,7,,328,269
1,"Alba",10,"10-JIDVEI",5103,237,2,707,552,494,58,547,5,"JIDVEI",,7,,250,297
1,"Alba",10,"10-JIDVEI",5103,238,2,807,674,568,106,668,6,"JIDVEI",,7,,395,273
1,"Alba",10,"10-JIDVEI",5103,239,2,774,538,499,39,522,16,"JIDVEI",,7,,203,319
1,"Alba",10,"10-LIVEZILE",5167,240,2,642,539,511,28,535,4,"LIVEZILE",,7,,251,284
1,"Alba",10,"10-LIVEZILE",5167,241,2,284,224,205,19,216,8,"LIVEZILE",,7,,118,98
1,"Alba",10,"10-LIVEZILE",5167,242,2,403,370,332,38,364,6,"LIVEZILE",,7,,174,190
1,"Alba",10,"10-LIVEZILE",5167,243,2,214,193,167,26,192,1,"LIVEZILE",,7,,82,110
1,"Alba",10,"10-LOPADEA NOUA",5210,244,2,894,812,797,15,805,7,"LOPADEA NOUA",,7,,26,779
1,"Alba",10,"10-LOPADEA NOUA",5210,245,2,200,156,144,12,156,0,"LOPADEA NOUA",,7,,98,58
1,"Alba",10,"10-LOPADEA NOUA",5210,246,2,463,366,326,40,360,6,"LOPADEA NOUA",,7,,155,205
1,"Alba",10,"10-LOPADEA NOUA",5210,247,2,502,366,335,31,362,4,"LOPADEA NOUA",,7,,35,327
1,"Alba",10,"10-LOPADEA NOUA",5210,248,2,637,490,447,43,487,3,"LOPADEA NOUA",,7,,242,245
1,"Alba",10,"10-LUNCA MURESULUI",5309,249,2,1595,1240,1156,84,1229,11,"LUNCA MURESULUI",,7,,279,950
1,"Alba",10,"10-LUNCA MURESULUI",5309,250,2,449,428,357,71,425,3,"LUNCA MURESULUI",,7,,194,231
1,"Alba",10,"10-LUPSA",5336,251,2,825,768,718,50,762,6,"LUPSA",,7,,311,451
1,"Alba",10,"10-LUPSA",5336,252,2,200,154,86,68,150,4,"LUPSA",,7,,79,71
1,"Alba",10,"10-LUPSA",5336,253,2,1325,673,638,35,671,2,"LUPSA",,7,,347,324
1,"Alba",10,"10-LUPSA",5336,254,2,721,553,498,55,549,4,"LUPSA",,7,,150,399
1,"Alba",10,"10-METES",5577,255,2,616,384,355,29,381,3,"METES",,7,,169,212
1,"Alba",10,"10-METES",5577,256,2,582,463,384,79,457,6,"METES",,7,,196,261
1,"Alba",10,"10-METES",5577,257,2,226,180,135,45,179,1,"METES",,7,,61,118
1,"Alba",10,"10-METES",5577,258,2,378,301,273,28,300,1,"METES",,7,,116,184
1,"Alba",10,"10-METES",5577,259,2,279,192,163,29,189,3,"METES",,7,,99,90
1,"Alba",10,"10-METES",5577,260,2,530,435,378,57,432,3,"METES",,7,,142,290
1,"Alba",10,"10-MIHALT",5700,261,2,1847,1428,1244,184,1421,7,"MIHALT",,7,,504,917
1,"Alba",10,"10-MIHALT",5700,262,2,497,443,382,61,439,4,"MIHALT",,7,,159,280
1,"Alba",10,"10-MIHALT",5700,263,2,482,414,344,70,414,0,"MIHALT",,7,,195,219
1,"Alba",10,"10-MIRASLAU",5755,264,2,722,629,571,58,622,7,"MIRASLAU",,7,,248,374
1,"Alba",10,"10-MIRASLAU",5755,265,2,218,181,163,18,179,2,"MIRASLAU",,7,,93,86
1,"Alba",10,"10-MIRASLAU",5755,266,2,508,480,396,84,476,4,"MIRASLAU",,7,,96,380
1,"Alba",10,"10-MIRASLAU",5755,267,2,372,323,268,55,321,2,"MIRASLAU",,7,,168,153
1,"Alba",10,"10-MIRASLAU",5755,268,2,115,93,80,13,93,0,"MIRASLAU",,7,,52,41
1,"Alba",10,"10-MOGOS",5826,269,2,793,463,411,52,459,4,"MOGOS",,7,,249,210
1,"Alba",10,"10-MOGOS",5826,270,2,444,291,245,46,284,7,"MOGOS",,7,,123,161
1,"Alba",10,"10-NOSLAC",6048,271,2,1068,818,709,109,812,6,"NOSLAC",,7,,326,486
1,"Alba",10,"10-NOSLAC",6048,272,2,283,192,171,21,191,1,"NOSLAC",,7,,76,115
1,"Alba",10,"10-NOSLAC",6048,273,2,453,344,255,89,341,3,"NOSLAC",,7,,135,206
1,"Alba",10,"10-OCOLIS",6119,274,2,659,292,238,54,289,3,"OCOLIS",,7,,130,159
1,"Alba",10,"10-OCOLIS",6119,275,2,81,69,35,34,67,2,"OCOLIS",,7,,33,34
1,"Alba",10,"10-OCOLIS",6119,276,2,83,118,57,61,117,1,"OCOLIS",,7,,68,49
1,"Alba",10,"10-OHABA",6164,277,2,627,408,368,40,404,4,"OHABA",,7,,134,270
1,"Alba",10,"10-OHABA",6164,278,2,81,72,56,16,72,0,"OHABA",,7,,22,50
1,"Alba",10,"10-OHABA",6164,279,2,284,241,213,28,241,0,"OHABA",,7,,73,168
1,"Alba",10,"10-PIANU",6217,280,2,1283,1008,948,60,1000,8,"PIANU",,7,,411,589
1,"Alba",10,"10-PIANU",6217,281,2,902,722,701,21,716,6,"PIANU",,7,,362,354
1,"Alba",10,"10-PIANU",6217,282,2,266,162,134,28,161,1,"PIANU",,7,,76,85
1,"Alba",10,"10-PIANU",6217,283,2,201,126,109,17,125,1,"PIANU",,7,,69,56
1,"Alba",10,"10-POIANA VADULUI",6271,284,2,1017,558,522,36,550,8,"POIANA VADULUI",,7,,236,314
1,"Alba",10,"10-PONOR",6397,285,2,453,250,198,52,246,4,"PONOR",,7,,123,123
1,"Alba",10,"10-PONOR",6397,286,2,344,201,170,31,195,6,"PONOR",,7,,78,117
1,"Alba",10,"10-POSAGA",6468,287,2,489,395,319,76,389,6,"POSAGA",,7,,98,291
1,"Alba",10,"10-POSAGA",6468,288,2,215,203,140,63,197,6,"POSAGA",,7,,77,120
1,"Alba",10,"10-POSAGA",6468,289,2,160,93,75,18,87,6,"POSAGA",,7,,20,67
1,"Alba",10,"10-POSAGA",6468,290,2,218,124,100,24,118,6,"POSAGA",,7,,42,76
1,"Alba",10,"10-POSAGA",6468,291,2,312,204,183,21,203,1,"POSAGA",,7,,64,139
1,"Alba",10,"10-RADESTI",6547,292,2,875,759,689,70,758,1,"RADESTI",,7,,358,400
1,"Alba",10,"10-RADESTI",6547,293,2,327,243,204,39,240,3,"RADESTI",,7,,128,112
1,"Alba",10,"10-RIMETEA",6592,294,2,508,441,379,62,439,2,"RIMETEA",,7,,31,408
1,"Alba",10,"10-RIMETEA",6592,295,2,570,466,430,36,465,1,"RIMETEA",,7,,25,440
1,"Alba",10,"10-RAMET",6627,296,2,514,167,146,21,164,3,"RAMET",,7,,81,83
1,"Alba",10,"10-RAMET",6627,297,2,180,135,106,29,134,1,"RAMET",,7,,77,57
1,"Alba",10,"10-RAMET",6627,298,2,147,177,87,90,175,2,"RAMET",,7,,111,64
1,"Alba",10,"10-ROSIA MONTANA",6761,299,2,1426,1078,955,123,1068,10,"ROSIA MONTANA",,7,,658,410
1,"Alba",10,"10-ROSIA MONTANA",6761,300,2,1294,828,652,176,810,18,"ROSIA MONTANA",,7,,478,332
1,"Alba",10,"10-ROSIA MONTANA",6761,301,2,281,254,199,55,249,5,"ROSIA MONTANA",,7,,120,129
1,"Alba",10,"10-ROSIA MONTANA",6761,302,2,248,166,144,22,166,0,"ROSIA MONTANA",,7,,105,61
1,"Alba",10,"10-ROSIA DE SECAS",6930,303,2,673,506,441,65,503,3,"ROSIA DE SECAS",,7,,242,261
1,"Alba",10,"10-ROSIA DE SECAS",6930,304,2,478,389,319,70,388,1,"ROSIA DE SECAS",,7,,176,212
1,"Alba",10,"10-ROSIA DE SECAS",6930,305,2,246,220,178,42,218,2,"ROSIA DE SECAS",,7,,99,119
1,"Alba",10,"10-SALCIUA",6976,306,2,764,524,443,81,522,2,"SALCIUA",,7,,254,268
1,"Alba",10,"10-SALCIUA",6976,307,2,751,512,449,63,511,1,"SALCIUA",,7,,239,272
1,"Alba",10,"10-SALISTEA",7044,308,2,1271,876,765,111,866,10,"SALISTEA",,7,,460,406
1,"Alba",10,"10-SALISTEA",7044,309,2,67,39,17,22,38,1,"SALISTEA",,7,,12,26
1,"Alba",10,"10-SALISTEA",7044,310,2,602,542,453,89,541,1,"SALISTEA",,7,,309,232
1,"Alba",10,"10-SASCIORI",7099,311,2,1498,1194,998,196,1181,13,"SASCIORI",,7,,392,789
1,"Alba",10,"10-SASCIORI",7099,312,2,647,488,397,91,481,7,"SASCIORI",,7,,103,378
1,"Alba",10,"10-SASCIORI",7099,313,2,780,320,286,34,315,5,"SASCIORI",,7,,121,194
1,"Alba",10,"10-SASCIORI",7099,314,2,486,372,334,38,369,3,"SASCIORI",,7,,103,266
1,"Alba",10,"10-SASCIORI",7099,315,2,742,585,482,103,572,13,"SASCIORI",,7,,178,394
1,"Alba",10,"10-SCARISOARA",7197,316,2,1298,866,809,57,856,10,"SCARISOARA",,7,,608,248
1,"Alba",10,"10-SCARISOARA",7197,317,2,331,218,166,52,216,2,"SCARISOARA",,7,,136,80
1,"Alba",10,"10-SANCEL",7348,318,2,1336,1048,946,102,1035,13,"SANCEL",,7,,463,572
1,"Alba",10,"10-SANCEL",7348,319,2,376,269,235,34,266,3,"SANCEL",,7,,92,174
1,"Alba",10,"10-SANCEL",7348,320,2,586,508,440,68,502,6,"SANCEL",,7,,195,307
1,"Alba",10,"10-SANTIMBRU",7384,321,2,1125,989,822,167,982,7,"SANTIMBRU",,7,,331,651
1,"Alba",10,"10-SANTIMBRU",7384,322,2,310,269,229,40,266,3,"SANTIMBRU",,7,,119,147
1,"Alba",10,"10-SANTIMBRU",7384,323,2,568,469,376,93,466,3,"SANTIMBRU",,7,,108,358
1,"Alba",10,"10-SOHODOL",2283,324,2,1876,963,930,33,955,8,"SOHODOL",,7,,614,341
1,"Alba",10,"10-STREMT",7767,325,2,1173,856,797,59,851,5,"STREMT",,7,,370,481
1,"Alba",10,"10-STREMT",7767,326,2,791,480,418,62,473,7,"STREMT",,7,,200,273
1,"Alba",10,"10-STREMT",7767,327,2,382,280,253,27,278,2,"STREMT",,7,,147,131
1,"Alba",10,"10-SIBOT",7810,328,2,980,773,610,163,772,1,"SIBOT",,7,,323,449
1,"Alba",10,"10-SIBOT",7810,329,2,470,387,317,70,384,3,"SIBOT",,7,,169,215
1,"Alba",10,"10-SIBOT",7810,330,2,219,201,127,74,201,0,"SIBOT",,7,,63,138
1,"Alba",10,"10-SIBOT",7810,331,2,197,141,109,32,137,4,"SIBOT",,7,,38,99
1,"Alba",10,"10-SONA",7865,332,2,647,536,417,119,528,8,"SONA",,7,,263,265
1,"Alba",10,"10-SONA",7865,333,2,272,155,140,15,153,2,"SONA",,7,,106,47
1,"Alba",10,"10-SONA",7865,334,2,1169,858,781,77,848,10,"SONA",,7,,443,405
1,"Alba",10,"10-SONA",7865,335,2,407,340,307,33,339,1,"SONA",,7,,121,218
1,"Alba",10,"10-SONA",7865,336,2,1194,977,858,119,959,18,"SONA",,7,,153,806
1,"Alba",10,"10-SPRING",7945,337,2,553,482,374,108,472,10,"SPRING",,7,,242,230
1,"Alba",10,"10-SPRING",7945,338,2,399,381,304,77,380,1,"SPRING",,7,,173,207
1,"Alba",10,"10-SPRING",7945,339,2,415,401,313,88,397,4,"SPRING",,7,,186,211
1,"Alba",10,"10-SPRING",7945,340,2,421,386,291,95,380,6,"SPRING",,7,,164,216
1,"Alba",10,"10-SUGAG",8014,341,2,1794,1272,1046,226,1268,4,"SUGAG",,7,,220,1048
1,"Alba",10,"10-SUGAG",8014,342,2,355,375,233,142,373,2,"SUGAG",,7,,54,319
1,"Alba",10,"10-SUGAG",8014,343,2,56,282,34,248,281,1,"SUGAG",,7,,38,243
1,"Alba",10,"10-UNIREA",8158,344,2,1663,1353,1201,152,1339,14,"UNIREA",,7,,376,963
1,"Alba",10,"10-UNIREA",8158,345,2,1188,990,855,135,985,5,"UNIREA",,7,,428,557
1,"Alba",10,"10-UNIREA",8158,346,2,305,253,223,30,250,3,"UNIREA",,7,,132,118
1,"Alba",10,"10-UNIREA",8158,347,2,220,220,204,16,218,2,"UNIREA",,7,,96,122
1,"Alba",10,"10-UNIREA",8158,348,2,354,283,261,22,280,3,"UNIREA",,7,,88,192
1,"Alba",10,"10-UNIREA",8158,349,2,223,202,178,24,201,1,"UNIREA",,7,,96,105
1,"Alba",10,"10-UNIREA",8158,350,2,296,291,237,54,289,2,"UNIREA",,7,,112,177
1,"Alba",10,"10-VADU MOTILOR",8229,351,2,1207,738,659,79,730,8,"VADU MOTILOR",,7,,469,261
1,"Alba",10,"10-VALEA LUNGA",8354,352,2,1264,1030,826,204,1025,5,"VALEA LUNGA",,7,,268,757
1,"Alba",10,"10-VALEA LUNGA",8354,353,2,242,173,141,32,170,3,"VALEA LUNGA",,7,,60,110
1,"Alba",10,"10-VALEA LUNGA",8354,354,2,249,179,153,26,178,1,"VALEA LUNGA",,7,,103,75
1,"Alba",10,"10-VALEA LUNGA",8354,355,2,331,322,248,74,322,0,"VALEA LUNGA",,7,,153,169
1,"Alba",10,"10-VALEA LUNGA",8354,356,2,545,431,381,50,429,2,"VALEA LUNGA",,7,,187,242
1,"Alba",10,"10-VIDRA",8425,357,2,934,533,511,22,526,7,"VIDRA",,7,,198,328
1,"Alba",10,"10-VIDRA",8425,358,2,905,649,619,30,643,6,"VIDRA",,7,,383,260
1,"Alba",10,"10-VINTU DE JOS",8826,359,2,2379,1761,1361,400,1749,12,"VINTU DE JOS",,7,,423,1326
1,"Alba",10,"10-VINTU DE JOS",8826,360,2,1258,767,661,106,759,8,"VINTU DE JOS",,7,,176,583
1,"Alba",10,"10-VINTU DE JOS",8826,361,2,357,140,112,28,139,1,"VINTU DE JOS",,7,,35,104
2,"Arad",29,"29-MUNICIPIUL ARAD",9262,1,2,1434,1102,968,134,1097,5,"MUNICIPIUL ARAD",,1,,347,750
2,"Arad",29,"29-MUNICIPIUL ARAD",9262,2,2,2036,1696,1476,220,1691,5,"MUNICIPIUL ARAD",,1,,560,1131
2,"Arad",29,"29-MUNICIPIUL ARAD",9262,3,2,1390,1516,1020,496,1514,2,"MUNICIPIUL ARAD",,1,,499,1015
2,"Arad",29,"29-MUNICIPIUL ARAD",9262,4,2,1725,1244,1144,100,1241,3,"MUNICIPIUL ARAD",,1,,300,941
2,"Arad",29,"29-MUNICIPIUL ARAD",9262,5,2,1350,1050,937,113,1049,1,"MUNICIPIUL ARAD",,1,,294,755
2,"Arad",29,"29-MUNICIPIUL ARAD",9262,6,2,1890,1470,1334,136,1462,8,"MUNICIPIUL ARAD",,1,,462,1000
2,"Arad",29,"29-MUNICIPIUL ARAD",9262,7,2,1413,1118,1045,73,1113,5,"MUNICIPIUL ARAD",,1,,394,719
2,"Arad",29,"29-MUNICIPIUL ARAD",9262,8,2,1927,1535,1247,288,1529,6,"MUNICIPIUL ARAD",,1,,433,1096
2,"Arad",29,"29-MUNICIPIUL ARAD",9262,9,2,1247,1537,881,656,1535,2,"MUNICIPIUL ARAD",,1,,406,1129
2,"Arad",29,"29-MUNICIPIUL ARAD",9262,10,2,1709,1212,1118,94,1207,5,"MUNICIPIUL ARAD",,1,,416,791
2,"Arad",29,"29-MUNICIPIUL ARAD",9262,11,2,1793,1629,1411,218,1625,4,"MUNICIPIUL ARAD",,1,,563,1062
2,"Arad",29,"29-MUNICIPIUL ARAD",9262,12,2,1108,858,807,51,854,4,"MUNICIPIUL ARAD",,1,,307,547
2,"Arad",29,"29-MUNICIPIUL ARAD",9262,13,2,1550,1190,1088,102,1186,4,"MUNICIPIUL ARAD",,1,,458,728
2,"Arad",29,"29-MUNICIPIUL ARAD",9262,14,2,2045,1251,1072,179,1244,7,"MUNICIPIUL ARAD",,1,,395,849
2,"Arad",29,"29-MUNICIPIUL ARAD",9262,15,2,1055,954,814,140,951,3,"MUNICIPIUL ARAD",,1,,270,681
2,"Arad",29,"29-MUNICIPIUL ARAD",9262,16,2,1285,1087,940,147,1085,2,"MUNICIPIUL ARAD",,1,,284,801
2,"Arad",29,"29-MUNICIPIUL ARAD",9262,17,2,3237,2339,2100,239,2333,6,"MUNICIPIUL ARAD",,1,,559,1774
2,"Arad",29,"29-MUNICIPIUL ARAD",9262,18,2,2195,1518,1373,145,1510,8,"MUNICIPIUL ARAD",,1,,337,1173
2,"Arad",29,"29-MUNICIPIUL ARAD",9262,19,2,1824,1351,1198,153,1347,4,"MUNICIPIUL ARAD",,1,,312,1035
2,"Arad",29,"29-MUNICIPIUL ARAD",9262,20,2,2489,1884,1718,166,1881,3,"MUNICIPIUL ARAD",,1,,502,1379
2,"Arad",29,"29-MUNICIPIUL ARAD",9262,21,2,2273,1713,1585,128,1708,5,"MUNICIPIUL ARAD",,1,,426,1282
2,"Arad",29,"29-MUNICIPIUL ARAD",9262,22,2,2023,1386,1256,130,1381,5,"MUNICIPIUL ARAD",,1,,339,1042
2,"Arad",29,"29-MUNICIPIUL ARAD",9262,23,2,1418,1016,905,111,1011,5,"MUNICIPIUL ARAD",,1,,251,760
2,"Arad",29,"29-MUNICIPIUL ARAD",9262,24,2,1782,1309,1170,139,1306,3,"MUNICIPIUL ARAD",,1,,365,941
2,"Arad",29,"29-MUNICIPIUL ARAD",9262,25,2,2185,1505,1389,116,1502,3,"MUNICIPIUL ARAD",,1,,383,1119
2,"Arad",29,"29-MUNICIPIUL ARAD",9262,26,2,2232,1624,1519,105,1511,50,"MUNICIPIUL ARAD",,1,,391,1120
2,"Arad",29,"29-MUNICIPIUL ARAD",9262,27,2,2150,1580,1435,145,1566,14,"MUNICIPIUL ARAD",,1,,490,1076
2,"Arad",29,"29-MUNICIPIUL ARAD",9262,28,2,2666,1854,1711,143,1839,15,"MUNICIPIUL ARAD",,1,,482,1357
2,"Arad",29,"29-MUNICIPIUL ARAD",9262,29,2,1544,1201,1067,134,1197,4,"MUNICIPIUL ARAD",,1,,381,816
2,"Arad",29,"29-MUNICIPIUL ARAD",9262,30,2,1609,1150,1072,78,1146,4,"MUNICIPIUL ARAD",,1,,305,841
2,"Arad",29,"29-MUNICIPIUL ARAD",9262,31,2,1359,1076,924,152,1072,4,"MUNICIPIUL ARAD",,1,,295,777
2,"Arad",29,"29-MUNICIPIUL ARAD",9262,32,2,1492,1205,1024,181,1201,4,"MUNICIPIUL ARAD",,1,,298,903
2,"Arad",29,"29-MUNICIPIUL ARAD",9262,33,2,2169,1683,1577,106,1677,6,"MUNICIPIUL ARAD",,1,,541,1136
2,"Arad",29,"29-MUNICIPIUL ARAD",9262,34,2,1134,838,778,60,836,2,"MUNICIPIUL ARAD",,1,,254,582
2,"Arad",29,"29-MUNICIPIUL ARAD",9262,35,2,1896,1332,1196,136,1323,9,"MUNICIPIUL ARAD",,1,,300,1023
2,"Arad",29,"29-MUNICIPIUL ARAD",9262,36,2,1765,1369,1250,119,1365,4,"MUNICIPIUL ARAD",,1,,329,1036
2,"Arad",29,"29-MUNICIPIUL ARAD",9262,37,2,2164,1668,1574,94,1666,2,"MUNICIPIUL ARAD",,1,,450,1216
2,"Arad",29,"29-MUNICIPIUL ARAD",9262,38,2,1646,1193,1135,58,1188,5,"MUNICIPIUL ARAD",,1,,309,879
2,"Arad",29,"29-MUNICIPIUL ARAD",9262,39,2,1497,1215,1008,207,1208,7,"MUNICIPIUL ARAD",,1,,298,910
2,"Arad",29,"29-MUNICIPIUL ARAD",9262,40,2,1515,1227,1058,169,1220,7,"MUNICIPIUL ARAD",,1,,332,888
2,"Arad",29,"29-MUNICIPIUL ARAD",9262,41,2,1866,1306,1156,150,1302,4,"MUNICIPIUL ARAD",,1,,329,973
2,"Arad",29,"29-MUNICIPIUL ARAD",9262,42,2,1709,1192,1054,138,1185,7,"MUNICIPIUL ARAD",,1,,338,847
2,"Arad",29,"29-MUNICIPIUL ARAD",9262,43,2,1571,1105,965,140,1096,9,"MUNICIPIUL ARAD",,1,,301,795
2,"Arad",29,"29-MUNICIPIUL ARAD",9262,44,2,1607,1182,1058,124,1176,6,"MUNICIPIUL ARAD",,1,,262,914
2,"Arad",29,"29-MUNICIPIUL ARAD",9262,45,2,1493,1118,1009,109,1106,12,"MUNICIPIUL ARAD",,1,,260,846
2,"Arad",29,"29-MUNICIPIUL ARAD",9262,46,2,1883,1391,1188,203,1383,8,"MUNICIPIUL ARAD",,1,,332,1051
2,"Arad",29,"29-MUNICIPIUL ARAD",9262,47,2,1834,1334,1232,102,1319,15,"MUNICIPIUL ARAD",,1,,373,946
2,"Arad",29,"29-MUNICIPIUL ARAD",9262,48,2,1730,1249,1154,95,1239,10,"MUNICIPIUL ARAD",,1,,308,931
2,"Arad",29,"29-MUNICIPIUL ARAD",9262,49,2,1315,1022,779,243,1015,7,"MUNICIPIUL ARAD",,1,,228,787
2,"Arad",29,"29-MUNICIPIUL ARAD",9262,50,2,2046,1596,1382,214,1590,6,"MUNICIPIUL ARAD",,1,,383,1207
2,"Arad",29,"29-MUNICIPIUL ARAD",9262,51,2,1655,1167,1089,78,1164,3,"MUNICIPIUL ARAD",,1,,348,816
2,"Arad",29,"29-MUNICIPIUL ARAD",9262,52,2,1980,1213,1049,164,1213,0,"MUNICIPIUL ARAD",,1,,286,927
2,"Arad",29,"29-MUNICIPIUL ARAD",9262,53,2,2669,1928,1701,227,1919,9,"MUNICIPIUL ARAD",,1,,483,1436
2,"Arad",29,"29-MUNICIPIUL ARAD",9262,54,2,1518,1123,1034,89,1121,2,"MUNICIPIUL ARAD",,1,,329,792
2,"Arad",29,"29-MUNICIPIUL ARAD",9262,55,2,1610,1212,1047,165,1208,4,"MUNICIPIUL ARAD",,1,,320,888
2,"Arad",29,"29-MUNICIPIUL ARAD",9262,56,2,1786,1264,1165,99,1255,9,"MUNICIPIUL ARAD",,1,,274,981
2,"Arad",29,"29-MUNICIPIUL ARAD",9262,57,2,2363,1550,1327,223,1544,6,"MUNICIPIUL ARAD",,1,,365,1179
2,"Arad",29,"29-MUNICIPIUL ARAD",9262,58,2,603,918,380,538,917,1,"MUNICIPIUL ARAD",,1,,207,710
2,"Arad",29,"29-MUNICIPIUL ARAD",9262,59,2,1955,1646,1295,351,1622,24,"MUNICIPIUL ARAD",,1,,264,1358
2,"Arad",29,"29-MUNICIPIUL ARAD",9262,60,2,1582,1505,742,763,1498,7,"MUNICIPIUL ARAD",,1,,219,1279
2,"Arad",29,"29-MUNICIPIUL ARAD",9262,61,2,1441,1288,829,459,1285,3,"MUNICIPIUL ARAD",,1,,276,1009
2,"Arad",29,"29-MUNICIPIUL ARAD",9262,62,2,2384,1856,1467,389,1844,12,"MUNICIPIUL ARAD",,1,,395,1449
2,"Arad",29,"29-MUNICIPIUL ARAD",9262,63,2,2208,1595,1401,194,1587,8,"MUNICIPIUL ARAD",,1,,372,1215
2,"Arad",29,"29-MUNICIPIUL ARAD",9262,64,2,2415,1409,1253,156,1405,4,"MUNICIPIUL ARAD",,1,,250,1155
2,"Arad",29,"29-MUNICIPIUL ARAD",9262,65,2,1446,1692,1175,517,1684,8,"MUNICIPIUL ARAD",,1,,313,1371
2,"Arad",29,"29-MUNICIPIUL ARAD",9262,66,2,2918,2293,1898,395,2288,5,"MUNICIPIUL ARAD",,1,,487,1801
2,"Arad",29,"29-MUNICIPIUL ARAD",9262,67,2,1205,914,842,72,914,0,"MUNICIPIUL ARAD",,1,,216,698
2,"Arad",29,"29-MUNICIPIUL ARAD",9262,68,2,1469,1216,981,235,1215,1,"MUNICIPIUL ARAD",,1,,290,925
2,"Arad",29,"29-MUNICIPIUL ARAD",9262,69,2,2310,1800,1478,322,1794,6,"MUNICIPIUL ARAD",,1,,473,1321
2,"Arad",29,"29-MUNICIPIUL ARAD",9262,70,2,1855,1418,1262,156,1414,4,"MUNICIPIUL ARAD",,1,,313,1101
2,"Arad",29,"29-MUNICIPIUL ARAD",9262,71,2,1651,1176,1002,174,1169,7,"MUNICIPIUL ARAD",,1,,165,1004
2,"Arad",29,"29-MUNICIPIUL ARAD",9262,72,2,1447,1194,940,254,1186,8,"MUNICIPIUL ARAD",,1,,274,912
2,"Arad",29,"29-MUNICIPIUL ARAD",9262,73,2,1391,1022,887,135,1018,4,"MUNICIPIUL ARAD",,1,,231,787
2,"Arad",29,"29-MUNICIPIUL ARAD",9262,74,2,1403,1104,979,125,1101,3,"MUNICIPIUL ARAD",,1,,302,799
2,"Arad",29,"29-MUNICIPIUL ARAD",9262,75,2,1450,1136,1040,96,1130,6,"MUNICIPIUL ARAD",,1,,353,777
2,"Arad",29,"29-MUNICIPIUL ARAD",9262,76,2,1418,1124,934,190,1117,7,"MUNICIPIUL ARAD",,1,,325,792
2,"Arad",29,"29-MUNICIPIUL ARAD",9262,77,2,1283,1127,831,296,1119,8,"MUNICIPIUL ARAD",,1,,331,788
2,"Arad",29,"29-MUNICIPIUL ARAD",9262,78,2,825,559,525,34,557,2,"MUNICIPIUL ARAD",,1,,110,447
2,"Arad",29,"29-MUNICIPIUL ARAD",9262,79,2,1486,1143,1074,69,1140,3,"MUNICIPIUL ARAD",,1,,239,901
2,"Arad",29,"29-MUNICIPIUL ARAD",9262,80,2,1539,1076,1024,52,1069,7,"MUNICIPIUL ARAD",,1,,377,692
2,"Arad",29,"29-MUNICIPIUL ARAD",9262,81,2,1477,1142,1096,46,1135,7,"MUNICIPIUL ARAD",,1,,352,783
2,"Arad",29,"29-MUNICIPIUL ARAD",9262,82,2,1488,1002,910,92,995,7,"MUNICIPIUL ARAD",,1,,231,764
2,"Arad",29,"29-MUNICIPIUL ARAD",9262,83,2,2836,1950,1723,227,1935,15,"MUNICIPIUL ARAD",,1,,533,1402
2,"Arad",29,"29-MUNICIPIUL ARAD",9262,84,2,1417,1211,1003,208,1208,3,"MUNICIPIUL ARAD",,1,,420,788
2,"Arad",29,"29-MUNICIPIUL ARAD",9262,85,2,1484,1186,1018,168,1179,7,"MUNICIPIUL ARAD",,1,,337,842
2,"Arad",29,"29-MUNICIPIUL ARAD",9262,86,2,0,558,0,558,545,13,"MUNICIPIUL ARAD",,1,,154,391
2,"Arad",29,"29-ORAS CHISINEU-CRIS",9459,87,2,2297,1634,1495,139,1626,8,"ORAS CHISINEU-CRIS",,1,,560,1066
2,"Arad",29,"29-ORAS CHISINEU-CRIS",9459,88,2,1787,1352,1230,122,1351,1,"ORAS CHISINEU-CRIS",,1,,444,907
2,"Arad",29,"29-ORAS CHISINEU-CRIS",9459,89,2,1551,1112,1037,75,1109,3,"ORAS CHISINEU-CRIS",,1,,159,950
2,"Arad",29,"29-ORAS CHISINEU-CRIS",9459,90,2,1437,1026,957,69,1016,10,"ORAS CHISINEU-CRIS",,1,,382,634
2,"Arad",29,"29-ORAS CHISINEU-CRIS",9459,91,2,130,143,125,18,143,0,"ORAS CHISINEU-CRIS",,1,,39,104
2,"Arad",29,"29-ORAS CURTICI",9495,92,2,1543,1389,1215,174,1382,7,"ORAS CURTICI",,1,,416,966
2,"Arad",29,"29-ORAS CURTICI",9495,93,2,2630,2171,1899,272,2156,15,"ORAS CURTICI",,1,,779,1377
2,"Arad",29,"29-ORAS CURTICI",9495,94,2,1920,1454,1303,151,1444,10,"ORAS CURTICI",,1,,385,1059
2,"Arad",29,"29-ORAS CURTICI",9495,95,2,1494,1268,1214,54,1264,4,"ORAS CURTICI",,1,,38,1226
2,"Arad",29,"29-ORAS INEU",9538,96,2,2611,1951,1714,237,1949,2,"ORAS INEU",,1,,950,999
2,"Arad",29,"29-ORAS INEU",9538,97,2,1848,1362,1200,162,1357,5,"ORAS INEU",,1,,497,860
2,"Arad",29,"29-ORAS INEU",9538,98,2,1721,1207,1079,128,1204,3,"ORAS INEU",,1,,522,682
2,"Arad",29,"29-ORAS INEU",9538,99,2,1301,922,844,78,920,2,"ORAS INEU",,1,,424,496
2,"Arad",29,"29-ORAS INEU",9538,100,2,616,432,364,68,429,3,"ORAS INEU",,1,,128,301
2,"Arad",29,"29-ORAS INEU",9538,101,2,221,188,188,0,187,1,"ORAS INEU",,1,,129,58
2,"Arad",29,"29-ORAS LIPOVA",9574,102,2,1753,1326,1150,176,1323,3,"ORAS LIPOVA",,1,,511,812
2,"Arad",29,"29-ORAS LIPOVA",9574,103,2,1556,1226,1034,192,1219,7,"ORAS LIPOVA",,1,,473,746
2,"Arad",29,"29-ORAS LIPOVA",9574,104,2,1583,1029,938,91,1026,3,"ORAS LIPOVA",,1,,350,676
2,"Arad",29,"29-ORAS LIPOVA",9574,105,2,1189,794,681,113,793,1,"ORAS LIPOVA",,1,,332,461
2,"Arad",29,"29-ORAS LIPOVA",9574,106,2,840,548,466,82,547,1,"ORAS LIPOVA",,1,,161,386
2,"Arad",29,"29-ORAS LIPOVA",9574,107,2,1688,1268,1007,261,1258,10,"ORAS LIPOVA",,1,,363,895
2,"Arad",29,"29-ORAS LIPOVA",9574,108,2,776,586,493,93,584,2,"ORAS LIPOVA",,1,,183,401
2,"Arad",29,"29-ORAS LIPOVA",9574,109,2,303,309,292,17,306,3,"ORAS LIPOVA",,1,,62,244
2,"Arad",29,"29-ORAS NADLAC",9627,110,2,2037,1466,1256,210,1460,6,"ORAS NADLAC",,1,,237,1223
2,"Arad",29,"29-ORAS NADLAC",9627,111,2,2200,1575,1354,221,1565,10,"ORAS NADLAC",,1,,339,1226
2,"Arad",29,"29-ORAS NADLAC",9627,112,2,2132,1496,1332,164,1488,8,"ORAS NADLAC",,1,,386,1102
2,"Arad",29,"29-ORAS PANCOTA",9654,113,2,2021,1503,1350,153,1478,25,"ORAS PANCOTA",,1,,582,896
2,"Arad",29,"29-ORAS PANCOTA",9654,114,2,2318,1718,1530,188,1709,9,"ORAS PANCOTA",,1,,438,1271
2,"Arad",29,"29-ORAS PANCOTA",9654,115,2,1120,802,723,79,800,2,"ORAS PANCOTA",,1,,396,404
2,"Arad",29,"29-ORAS SEBIS",9690,116,2,1404,1108,1001,107,1103,5,"ORAS SEBIS",,1,,389,714
2,"Arad",29,"29-ORAS SEBIS",9690,117,2,1455,1112,1016,96,1109,3,"ORAS SEBIS",,1,,425,684
2,"Arad",29,"29-ORAS SEBIS",9690,118,2,1445,1179,1073,106,1174,5,"ORAS SEBIS",,1,,471,703
2,"Arad",29,"29-ORAS SEBIS",9690,119,2,545,472,409,63,469,3,"ORAS SEBIS",,1,,153,316
2,"Arad",29,"29-ORAS SEBIS",9690,120,2,493,390,358,32,390,0,"ORAS SEBIS",,1,,126,264
2,"Arad",29,"29-ALMAS",9743,121,2,1831,1359,1212,147,1347,12,"ALMAS",,1,,589,758
2,"Arad",29,"29-ALMAS",9743,122,2,492,403,352,51,403,0,"ALMAS",,1,,100,303
2,"Arad",29,"29-APATEU",9798,123,2,1926,1506,1405,101,1500,6,"APATEU",,1,,1085,415
2,"Arad",29,"29-APATEU",9798,124,2,798,640,562,78,635,5,"APATEU",,1,,461,174
2,"Arad",29,"29-APATEU",9798,125,2,339,294,270,24,294,0,"APATEU",,1,,225,69
2,"Arad",29,"29-ARCHIS",9832,126,2,556,499,446,53,497,2,"ARCHIS",,1,,308,189
2,"Arad",29,"29-ARCHIS",9832,127,2,883,611,558,53,607,4,"ARCHIS",,1,,336,271
2,"Arad",29,"29-BATA",9887,128,2,387,363,290,73,358,5,"BATA",,1,,157,201
2,"Arad",29,"29-BATA",9887,129,2,491,356,294,62,349,7,"BATA",,1,,129,220
2,"Arad",29,"29-BATA",9887,130,2,148,192,116,76,187,5,"BATA",,1,,83,104
2,"Arad",29,"29-BELIU",9930,131,2,1593,1221,1099,122,1217,4,"BELIU",,1,,604,613
2,"Arad",29,"29-BELIU",9930,132,2,648,498,416,82,495,3,"BELIU",,1,,247,248
2,"Arad",29,"29-BELIU",9930,133,2,197,163,150,13,163,0,"BELIU",,1,,45,118
2,"Arad",29,"29-BELIU",9930,134,2,418,368,314,54,366,2,"BELIU",,1,,252,114
2,"Arad",29,"29-BIRCHIS",10006,135,2,777,631,494,137,629,2,"BIRCHIS",,1,,307,322
2,"Arad",29,"29-BIRCHIS",10006,136,2,799,653,485,168,652,1,"BIRCHIS",,1,,318,334
2,"Arad",29,"29-BARSA",10051,137,2,1017,779,730,49,777,2,"BARSA",,1,,346,431
2,"Arad",29,"29-BARSA",10051,138,2,608,505,452,53,502,3,"BARSA",,1,,272,230
2,"Arad",29,"29-BARZAVA",10104,139,2,1003,801,625,176,794,7,"BARZAVA",,1,,255,539
2,"Arad",29,"29-BARZAVA",10104,140,2,274,200,169,31,199,1,"BARZAVA",,1,,70,129
2,"Arad",29,"29-BARZAVA",10104,141,2,320,281,249,32,279,2,"BARZAVA",,1,,145,134
2,"Arad",29,"29-BARZAVA",10104,142,2,259,196,162,34,195,1,"BARZAVA",,1,,62,133
2,"Arad",29,"29-BARZAVA",10104,143,2,193,158,137,21,157,1,"BARZAVA",,1,,107,50
2,"Arad",29,"29-BARZAVA",10104,144,2,401,311,282,29,307,4,"BARZAVA",,1,,108,199
2,"Arad",29,"29-BARZAVA",10104,145,2,69,76,48,28,73,3,"BARZAVA",,1,,14,59
2,"Arad",29,"29-BOCSIG",10195,146,2,1513,1152,1031,121,1146,6,"BOCSIG",,1,,669,477
2,"Arad",29,"29-BOCSIG",10195,147,2,340,352,298,54,350,2,"BOCSIG",,1,,122,228
2,"Arad",29,"29-BOCSIG",10195,148,2,691,526,465,61,520,6,"BOCSIG",,1,,225,295
2,"Arad",29,"29-BOCSIG",10195,149,2,352,307,269,38,302,5,"BOCSIG",,1,,179,123
2,"Arad",29,"29-BRAZII",10239,150,2,666,489,439,50,481,8,"BRAZII",,1,,259,222
2,"Arad",29,"29-BRAZII",10239,151,2,440,306,273,33,302,4,"BRAZII",,1,,125,177
2,"Arad",29,"29-BUTENI",10293,152,2,1732,1353,1166,187,1347,6,"BUTENI",,1,,551,796
2,"Arad",29,"29-BUTENI",10293,153,2,668,485,419,66,484,1,"BUTENI",,1,,306,178
2,"Arad",29,"29-BUTENI",10293,154,2,495,335,307,28,334,1,"BUTENI",,1,,147,187
2,"Arad",29,"29-CARAND",10346,155,2,677,588,549,39,584,4,"CARAND",,1,,307,277
2,"Arad",29,"29-CARAND",10346,156,2,481,380,340,40,376,4,"CARAND",,1,,174,202
2,"Arad",29,"29-CERMEI",10373,157,2,1580,1246,1063,183,1239,7,"CERMEI",,1,,641,598
2,"Arad",29,"29-CERMEI",10373,158,2,737,566,500,66,559,7,"CERMEI",,1,,338,221
2,"Arad",29,"29-CHISINDIA",10417,159,2,917,681,605,76,679,2,"CHISINDIA",,1,,265,414
2,"Arad",29,"29-CHISINDIA",10417,160,2,481,354,330,24,353,1,"CHISINDIA",,1,,150,203
2,"Arad",29,"29-CHISINDIA",10417,161,2,120,63,44,19,63,0,"CHISINDIA",,1,,25,38
2,"Arad",29,"29-CONOP",10453,162,2,378,334,251,83,330,4,"CONOP",,1,,130,200
2,"Arad",29,"29-CONOP",10453,163,2,285,271,184,87,271,0,"CONOP",,1,,162,109
2,"Arad",29,"29-CONOP",10453,164,2,350,313,242,71,310,3,"CONOP",,1,,179,131
2,"Arad",29,"29-CONOP",10453,165,2,328,302,234,68,300,2,"CONOP",,1,,131,169
2,"Arad",29,"29-CONOP",10453,166,2,334,318,253,65,308,10,"CONOP",,1,,151,157
2,"Arad",29,"29-COVASINT",10514,167,2,1875,1403,1144,259,1397,6,"COVASINT",,1,,487,910
2,"Arad",29,"29-CRAIVA",10532,168,2,937,725,641,84,722,3,"CRAIVA",,1,,447,275
2,"Arad",29,"29-CRAIVA",10532,169,2,561,418,367,51,415,3,"CRAIVA",,1,,285,130
2,"Arad",29,"29-CRAIVA",10532,170,2,476,305,281,24,304,1,"CRAIVA",,1,,203,101
2,"Arad",29,"29-CRAIVA",10532,171,2,362,213,201,12,213,0,"CRAIVA",,1,,118,95
2,"Arad",29,"29-CRAIVA",10532,172,2,475,352,306,46,348,4,"CRAIVA",,1,,221,127
2,"Arad",29,"29-DEZNA",10649,173,2,1029,824,717,107,819,5,"DEZNA",,1,,386,433
2,"Arad",29,"29-DEZNA",10649,174,2,347,260,233,27,260,0,"DEZNA",,1,,172,88
2,"Arad",29,"29-DIECI",10701,175,2,729,543,507,36,540,3,"DIECI",,1,,226,314
2,"Arad",29,"29-DIECI",10701,176,2,437,329,293,36,327,2,"DIECI",,1,,173,154
2,"Arad",29,"29-DIECI",10701,177,2,372,322,247,75,322,0,"DIECI",,1,,134,188
2,"Arad",29,"29-FELNAC",10827,178,2,1804,1414,1162,252,1409,5,"FELNAC",,1,,439,970
2,"Arad",29,"29-FELNAC",10827,179,2,1276,1113,841,272,1112,1,"FELNAC",,1,,333,779
2,"Arad",29,"29-FELNAC",10827,180,2,331,314,227,87,314,0,"FELNAC",,1,,143,171
2,"Arad",29,"29-FANTANELE",9280,181,2,1458,1151,1014,137,1146,5,"FANTANELE",,1,,288,858
2,"Arad",29,"29-FANTANELE",9280,182,2,1041,876,733,143,871,5,"FANTANELE",,1,,368,503
2,"Arad",29,"29-FANTANELE",9280,183,2,608,500,428,72,491,9,"FANTANELE",,1,,206,285
2,"Arad",29,"29-FANTANELE",9280,184,2,594,556,470,86,551,5,"FANTANELE",,1,,179,372
2,"Arad",29,"29-GHIOROC",10872,185,2,1395,1092,872,220,1085,7,"GHIOROC",,1,,241,844
2,"Arad",29,"29-GHIOROC",10872,186,2,1243,919,832,87,913,6,"GHIOROC",,1,,309,604
2,"Arad",29,"29-GHIOROC",10872,187,2,572,510,413,97,508,2,"GHIOROC",,1,,163,345
2,"Arad",29,"29-GRANICERI",10916,188,2,1007,800,675,125,796,4,"GRANICERI",,1,,431,365
2,"Arad",29,"29-GRANICERI",10916,189,2,894,634,496,138,628,6,"GRANICERI",,1,,323,305
2,"Arad",29,"29-GURAHONT",10943,190,2,2095,1706,1433,273,1692,14,"GURAHONT",,1,,715,977
2,"Arad",29,"29-GURAHONT",10943,191,2,633,475,422,53,472,3,"GURAHONT",,1,,146,326
2,"Arad",29,"29-GURAHONT",10943,192,2,428,324,280,44,316,8,"GURAHONT",,1,,142,174
2,"Arad",29,"29-GURAHONT",10943,193,2,558,370,338,32,369,1,"GURAHONT",,1,,215,154
2,"Arad",29,"29-HALMAGIU",11058,194,2,1773,1025,955,70,1019,6,"HALMAGIU",,1,,583,436
2,"Arad",29,"29-HALMAGIU",11058,195,2,972,544,491,53,539,5,"HALMAGIU",,1,,313,226
2,"Arad",29,"29-HALMAGIU",11058,196,2,505,210,192,18,208,2,"HALMAGIU",,1,,119,89
2,"Arad",29,"29-HALMAGEL",11174,197,2,1093,684,617,67,680,4,"HALMAGEL",,1,,390,290
2,"Arad",29,"29-HALMAGEL",11174,198,2,541,273,234,39,271,2,"HALMAGEL",,1,,152,119
2,"Arad",29,"29-HASMAS",11236,199,2,754,590,512,78,587,3,"HASMAS",,1,,332,255
2,"Arad",29,"29-HASMAS",11236,200,2,498,390,326,64,390,0,"HASMAS",,1,,211,179
2,"Arad",29,"29-IGNESTI",11307,201,2,338,289,254,35,287,2,"IGNESTI",,1,,154,133
2,"Arad",29,"29-IGNESTI",11307,202,2,321,226,201,25,225,1,"IGNESTI",,1,,119,106
2,"Arad",29,"29-IRATOS",11352,203,2,1423,1127,899,228,1126,1,"IRATOS",,1,,151,975
2,"Arad",29,"29-IRATOS",11352,204,2,323,281,217,64,281,0,"IRATOS",,1,,18,263
2,"Arad",29,"29-LIVADA",9333,205,2,1017,803,697,106,801,2,"LIVADA",,1,,319,482
2,"Arad",29,"29-LIVADA",9333,206,2,1089,828,705,123,826,2,"LIVADA",,1,,191,635
2,"Arad",29,"29-MACEA",11398,207,2,1531,1183,966,217,1179,4,"MACEA",,1,,326,853
2,"Arad",29,"29-MACEA",11398,208,2,1305,1135,950,185,1121,14,"MACEA",,1,,383,738
2,"Arad",29,"29-MACEA",11398,209,2,759,955,556,399,936,10,"MACEA",,1,,180,756
2,"Arad",29,"29-MISCA",11423,210,2,811,726,628,98,713,13,"MISCA",,1,,361,352
2,"Arad",29,"29-MISCA",11423,211,2,666,538,485,53,536,2,"MISCA",,1,,17,519
2,"Arad",29,"29-MISCA",11423,212,2,1035,904,810,94,896,8,"MISCA",,1,,216,680
2,"Arad",29,"29-MONEASA",11478,213,2,668,683,532,151,672,11,"MONEASA",,1,,218,454
2,"Arad",29,"29-MONEASA",11478,214,2,237,217,199,18,217,0,"MONEASA",,1,,78,139
2,"Arad",29,"29-OLARI",11502,215,2,1193,1065,956,109,1057,8,"OLARI",,1,,271,786
2,"Arad",29,"29-OLARI",11502,216,2,298,276,212,64,272,4,"OLARI",,1,,129,143
2,"Arad",29,"29-PAULIS",11539,217,2,1586,1139,913,226,1132,7,"PAULIS",,1,,387,745
2,"Arad",29,"29-PAULIS",11539,218,2,277,245,186,59,243,2,"PAULIS",,1,,107,136
2,"Arad",29,"29-PAULIS",11539,219,2,1187,965,778,187,960,5,"PAULIS",,1,,295,665
2,"Arad",29,"29-PECICA",11593,220,2,1837,1367,1188,179,1357,10,"PECICA",,1,,322,1035
2,"Arad",29,"29-PECICA",11593,221,2,1868,1372,1136,236,1364,8,"PECICA",,1,,387,977
2,"Arad",29,"29-PECICA",11593,222,2,1844,1277,1079,198,1264,13,"PECICA",,1,,246,1018
2,"Arad",29,"29-PECICA",11593,223,2,1452,1225,889,336,1217,8,"PECICA",,1,,98,1119
2,"Arad",29,"29-PECICA",11593,224,2,1560,1102,915,187,1097,5,"PECICA",,1,,48,1049
2,"Arad",29,"29-PECICA",11593,225,2,969,845,586,259,840,5,"PECICA",,1,,164,676
2,"Arad",29,"29-PECICA",11593,226,2,177,228,129,99,227,1,"PECICA",,1,,48,179
2,"Arad",29,"29-PEREGU MARE",11637,227,2,746,550,455,95,543,7,"PEREGU MARE",,1,,200,343
2,"Arad",29,"29-PEREGU MARE",11637,228,2,809,599,532,67,595,4,"PEREGU MARE",,1,,66,529
2,"Arad",29,"29-PETRIS",11664,229,2,518,437,373,64,432,5,"PETRIS",,1,,152,280
2,"Arad",29,"29-PETRIS",11664,230,2,242,221,185,36,214,7,"PETRIS",,1,,68,146
2,"Arad",29,"29-PETRIS",11664,231,2,201,153,127,26,148,5,"PETRIS",,1,,88,60
2,"Arad",29,"29-PETRIS",11664,232,2,420,277,254,23,274,3,"PETRIS",,1,,174,100
2,"Arad",29,"29-PILU",11735,233,2,725,593,515,78,591,2,"PILU",,1,,390,201
2,"Arad",29,"29-PILU",11735,234,2,643,606,483,123,595,11,"PILU",,1,,282,313
2,"Arad",29,"29-PLESCUTA",11762,235,2,940,590,509,81,585,5,"PLESCUTA",,1,,352,233
2,"Arad",29,"29-PLESCUTA",11762,236,2,520,383,337,46,380,3,"PLESCUTA",,1,,266,114
2,"Arad",29,"29-SAVARSIN",11842,237,2,1506,1276,1012,264,1266,10,"SAVARSIN",,1,,453,813
2,"Arad",29,"29-SAVARSIN",11842,238,2,204,187,174,13,182,5,"SAVARSIN",,1,,95,87
2,"Arad",29,"29-SAVARSIN",11842,239,2,181,161,147,14,157,4,"SAVARSIN",,1,,65,92
2,"Arad",29,"29-SAVARSIN",11842,240,2,448,353,326,27,351,2,"SAVARSIN",,1,,129,222
2,"Arad",29,"29-SAVARSIN",11842,241,2,274,247,201,46,244,3,"SAVARSIN",,1,,125,119
2,"Arad",29,"29-SECUSIGIU",11940,242,2,1432,1118,951,167,1115,3,"SECUSIGIU",,1,,476,639
2,"Arad",29,"29-SECUSIGIU",11940,243,2,619,548,422,126,546,2,"SECUSIGIU",,1,,195,351
2,"Arad",29,"29-SECUSIGIU",11940,244,2,382,363,300,63,363,0,"SECUSIGIU",,1,,169,194
2,"Arad",29,"29-SECUSIGIU",11940,245,2,1157,937,756,181,931,6,"SECUSIGIU",,1,,202,729
2,"Arad",29,"29-SELEUS",11995,246,2,1609,1169,1072,97,1168,1,"SELEUS",,1,,569,599
2,"Arad",29,"29-SELEUS",11995,247,2,897,701,556,145,697,4,"SELEUS",,1,,267,430
2,"Arad",29,"29-SEMLAC",12037,248,2,1274,919,741,178,916,3,"SEMLAC",,1,,225,691
2,"Arad",29,"29-SEMLAC",12037,249,2,1358,1023,801,222,1016,7,"SEMLAC",,1,,250,766
2,"Arad",29,"29-SINTEA MARE",12055,250,2,892,761,634,127,757,4,"SINTEA MARE",,1,,359,398
2,"Arad",29,"29-SINTEA MARE",12055,251,2,751,630,557,73,624,6,"SINTEA MARE",,1,,49,575
2,"Arad",29,"29-SINTEA MARE",12055,252,2,1077,902,779,123,898,4,"SINTEA MARE",,1,,146,752
2,"Arad",29,"29-SANTANA",12108,253,2,1787,1399,1260,139,1394,5,"SANTANA",,1,,662,732
2,"Arad",29,"29-SANTANA",12108,254,2,1929,1260,1142,118,1250,10,"SANTANA",,1,,212,1038
2,"Arad",29,"29-SANTANA",12108,255,2,2151,1487,1243,244,1483,4,"SANTANA",,1,,698,785
2,"Arad",29,"29-SANTANA",12108,256,2,1182,801,622,179,799,2,"SANTANA",,1,,281,518
2,"Arad",29,"29-SANTANA",12108,257,2,1253,941,740,201,938,3,"SANTANA",,1,,335,603
2,"Arad",29,"29-SANTANA",12108,258,2,895,719,624,95,716,3,"SANTANA",,1,,346,370
2,"Arad",29,"29-SOCODOR",12126,259,2,1660,1280,1106,174,1271,9,"SOCODOR",,1,,655,616
2,"Arad",29,"29-SAGU",12144,260,2,1479,1170,962,208,1162,8,"SAGU",,1,,409,753
2,"Arad",29,"29-SAGU",12144,261,2,402,367,294,73,360,7,"SAGU",,1,,137,223
2,"Arad",29,"29-SAGU",12144,262,2,336,284,236,48,282,2,"SAGU",,1,,118,164
2,"Arad",29,"29-SAGU",12144,263,2,317,348,261,87,344,4,"SAGU",,1,,191,153
2,"Arad",29,"29-SAGU",12144,264,2,224,175,146,29,174,1,"SAGU",,1,,68,106
2,"Arad",29,"29-SEITIN",12206,265,2,1052,847,680,167,839,8,"SEITIN",,1,,394,445
2,"Arad",29,"29-SEITIN",12206,266,2,934,707,603,104,701,6,"SEITIN",,1,,312,389
2,"Arad",29,"29-SEPREUS",12224,267,2,932,712,654,58,705,7,"SEPREUS",,1,,368,337
2,"Arad",29,"29-SEPREUS",12224,268,2,1136,823,768,55,813,10,"SEPREUS",,1,,326,487
2,"Arad",29,"29-SICULA",12242,269,2,1904,1342,1226,116,1336,6,"SICULA",,1,,669,667
2,"Arad",29,"29-SICULA",12242,270,2,820,616,561,55,613,3,"SICULA",,1,,355,258
2,"Arad",29,"29-SICULA",12242,271,2,998,817,718,99,813,4,"SICULA",,1,,474,339
2,"Arad",29,"29-SILINDIA",12288,272,2,679,494,401,93,491,3,"SILINDIA",,1,,222,269
2,"Arad",29,"29-SIMAND",12340,273,2,1498,1082,938,144,1076,6,"SIMAND",,1,,433,643
2,"Arad",29,"29-SIMAND",12340,274,2,1416,1077,917,160,1071,6,"SIMAND",,1,,470,601
2,"Arad",29,"29-SIRIA",12368,275,2,1799,1221,997,224,1221,0,"SIRIA",,1,,451,770
2,"Arad",29,"29-SIRIA",12368,276,2,1693,1274,1038,236,1267,7,"SIRIA",,1,,431,836
2,"Arad",29,"29-SIRIA",12368,277,2,1510,1242,1042,200,1229,13,"SIRIA",,1,,374,855
2,"Arad",29,"29-SIRIA",12368,278,2,740,637,562,75,636,1,"SIRIA",,1,,348,288
2,"Arad",29,"29-SISTAROVAT",12402,279,2,262,256,183,73,255,1,"SISTAROVAT",,1,,95,160
2,"Arad",29,"29-SOFRONEA",9360,280,2,1459,1116,925,191,1111,5,"SOFRONEA",,1,,262,849
2,"Arad",29,"29-SOFRONEA",9360,281,2,451,411,324,87,409,2,"SOFRONEA",,1,,13,396
2,"Arad",29,"29-TAUT",12457,282,2,740,566,454,112,565,1,"TAUT",,1,,290,275
2,"Arad",29,"29-TAUT",12457,283,2,216,154,135,19,150,4,"TAUT",,1,,82,68
2,"Arad",29,"29-TAUT",12457,284,2,158,147,109,38,142,5,"TAUT",,1,,72,70
2,"Arad",29,"29-TAUT",12457,285,2,792,524,449,75,520,4,"TAUT",,1,,170,350
2,"Arad",29,"29-TARNOVA",12509,286,2,1455,1212,1092,120,1207,5,"TARNOVA",,1,,493,714
2,"Arad",29,"29-TARNOVA",12509,287,2,728,618,550,68,609,9,"TARNOVA",,1,,212,397
2,"Arad",29,"29-TARNOVA",12509,288,2,329,288,234,54,286,2,"TARNOVA",,1,,140,146
2,"Arad",29,"29-TARNOVA",12509,289,2,870,632,534,98,627,5,"TARNOVA",,1,,267,360
2,"Arad",29,"29-TARNOVA",12509,290,2,870,628,575,53,613,15,"TARNOVA",,1,,284,329
2,"Arad",29,"29-TARNOVA",12509,291,2,446,356,297,59,345,11,"TARNOVA",,1,,197,148
2,"Arad",29,"29-USUSAU",10765,292,2,361,325,269,56,324,1,"USUSAU",,1,,120,204
2,"Arad",29,"29-USUSAU",10765,293,2,149,149,119,30,149,0,"USUSAU",,1,,59,90
2,"Arad",29,"29-USUSAU",10765,294,2,231,246,211,35,243,3,"USUSAU",,1,,100,143
2,"Arad",29,"29-USUSAU",10765,295,2,104,115,82,33,114,1,"USUSAU",,1,,62,52
2,"Arad",29,"29-USUSAU",10765,296,2,58,78,45,33,76,2,"USUSAU",,1,,36,40
2,"Arad",29,"29-VARADIA DE MURES",12572,297,2,564,456,350,106,454,2,"VARADIA DE MURES",,1,,165,289
2,"Arad",29,"29-VARADIA DE MURES",12572,298,2,356,314,244,70,312,2,"VARADIA DE MURES",,1,,99,213
2,"Arad",29,"29-VARADIA DE MURES",12572,299,2,289,231,211,20,231,0,"VARADIA DE MURES",,1,,125,106
2,"Arad",29,"29-VARADIA DE MURES",12572,300,2,197,214,160,54,213,1,"VARADIA DE MURES",,1,,93,120
2,"Arad",29,"29-VARADIA DE MURES",12572,301,2,150,129,119,10,127,2,"VARADIA DE MURES",,1,,59,68
2,"Arad",29,"29-VINGA",12643,302,2,1581,1201,1049,152,1194,7,"VINGA",,1,,187,1007
2,"Arad",29,"29-VINGA",12643,303,2,1337,1083,957,126,1076,7,"VINGA",,1,,195,881
2,"Arad",29,"29-VINGA",12643,304,2,824,713,619,94,708,5,"VINGA",,1,,18,690
2,"Arad",29,"29-VINGA",12643,305,2,822,689,600,89,686,3,"VINGA",,1,,192,494
2,"Arad",29,"29-VARFURILE",12689,306,2,1206,817,754,63,810,7,"VARFURILE",,1,,517,293
2,"Arad",29,"29-VARFURILE",12689,307,2,895,885,833,52,879,6,"VARFURILE",,1,,445,434
2,"Arad",29,"29-VARFURILE",12689,308,2,850,676,637,39,659,17,"VARFURILE",,1,,385,274
2,"Arad",29,"29-VLADIMIRESCU",9397,309,2,1185,993,768,225,991,2,"VLADIMIRESCU",,1,,250,741
2,"Arad",29,"29-VLADIMIRESCU",9397,310,2,1582,1263,1018,245,1256,7,"VLADIMIRESCU",,1,,355,901
2,"Arad",29,"29-VLADIMIRESCU",9397,311,2,1043,828,626,202,827,1,"VLADIMIRESCU",,1,,251,576
2,"Arad",29,"29-VLADIMIRESCU",9397,312,2,1461,1208,994,214,1199,9,"VLADIMIRESCU",,1,,518,681
2,"Arad",29,"29-VLADIMIRESCU",9397,313,2,830,609,522,87,607,2,"VLADIMIRESCU",,1,,241,366
2,"Arad",29,"29-VLADIMIRESCU",9397,314,2,800,504,417,87,500,4,"VLADIMIRESCU",,1,,168,332
2,"Arad",29,"29-VLADIMIRESCU",9397,315,2,0,297,0,297,293,4,"VLADIMIRESCU",,1,,94,199
2,"Arad",29,"29-ZABRANI",12778,316,2,1421,1146,957,189,1138,8,"ZABRANI",,1,,421,717
2,"Arad",29,"29-ZABRANI",12778,317,2,954,729,634,95,727,2,"ZABRANI",,1,,361,366
2,"Arad",29,"29-ZABRANI",12778,318,2,629,561,445,116,559,2,"ZABRANI",,1,,222,337
2,"Arad",29,"29-ZARAND",12812,319,2,1141,953,844,109,950,3,"ZARAND",,1,,429,521
2,"Arad",29,"29-ZARAND",12812,320,2,945,679,609,70,674,5,"ZARAND",,1,,399,275
2,"Arad",29,"29-ZERIND",12849,321,2,743,572,506,66,568,4,"ZERIND",,1,,40,528
2,"Arad",29,"29-ZERIND",12849,322,2,447,408,361,47,403,5,"ZERIND",,1,,28,375
2,"Arad",29,"29-ZIMANDU NOU",12876,323,2,2177,1582,1383,199,1572,10,"ZIMANDU NOU",,1,,324,1248
2,"Arad",29,"29-ZIMANDU NOU",12876,324,2,1103,768,672,96,765,3,"ZIMANDU NOU",,1,,122,643
3,"Argeș",38,"38-MUNICIPIUL PITESTI",13169,1,2,1887,1491,1328,163,1488,3,"MUNICIPIUL PITESTI",,5,,635,853
3,"Argeș",38,"38-MUNICIPIUL PITESTI",13169,2,2,1292,1020,919,101,1019,1,"MUNICIPIUL PITESTI",,5,,395,624
3,"Argeș",38,"38-MUNICIPIUL PITESTI",13169,3,2,1179,857,787,70,848,9,"MUNICIPIUL PITESTI",,5,,338,510
3,"Argeș",38,"38-MUNICIPIUL PITESTI",13169,4,2,1296,1038,912,126,1035,3,"MUNICIPIUL PITESTI",,5,,397,638
3,"Argeș",38,"38-MUNICIPIUL PITESTI",13169,5,2,1622,1136,1061,75,1133,3,"MUNICIPIUL PITESTI",,5,,543,590
3,"Argeș",38,"38-MUNICIPIUL PITESTI",13169,6,2,2075,1407,1298,109,1399,8,"MUNICIPIUL PITESTI",,5,,674,725
3,"Argeș",38,"38-MUNICIPIUL PITESTI",13169,7,2,1697,1039,969,70,1031,8,"MUNICIPIUL PITESTI",,5,,545,486
3,"Argeș",38,"38-MUNICIPIUL PITESTI",13169,8,2,1593,997,908,89,990,7,"MUNICIPIUL PITESTI",,5,,528,462
3,"Argeș",38,"38-MUNICIPIUL PITESTI",13169,9,2,1660,970,902,68,964,6,"MUNICIPIUL PITESTI",,5,,504,460
3,"Argeș",38,"38-MUNICIPIUL PITESTI",13169,10,2,1499,1047,985,62,1043,4,"MUNICIPIUL PITESTI",,5,,523,520
3,"Argeș",38,"38-MUNICIPIUL PITESTI",13169,11,2,2037,1408,1338,70,1403,5,"MUNICIPIUL PITESTI",,5,,687,716
3,"Argeș",38,"38-MUNICIPIUL PITESTI",13169,12,2,2146,1502,1442,60,1498,4,"MUNICIPIUL PITESTI",,5,,780,718
3,"Argeș",38,"38-MUNICIPIUL PITESTI",13169,13,2,1470,1072,1008,64,1072,0,"MUNICIPIUL PITESTI",,5,,490,582
3,"Argeș",38,"38-MUNICIPIUL PITESTI",13169,14,2,1694,1297,1215,82,1292,5,"MUNICIPIUL PITESTI",,5,,599,693
3,"Argeș",38,"38-MUNICIPIUL PITESTI",13169,15,2,1930,1372,1308,64,1365,7,"MUNICIPIUL PITESTI",,5,,625,740
3,"Argeș",38,"38-MUNICIPIUL PITESTI",13169,16,2,1580,1214,1113,101,1210,4,"MUNICIPIUL PITESTI",,5,,507,703
3,"Argeș",38,"38-MUNICIPIUL PITESTI",13169,17,2,1192,1081,785,296,1075,6,"MUNICIPIUL PITESTI",,5,,472,603
3,"Argeș",38,"38-MUNICIPIUL PITESTI",13169,18,2,1926,1567,1366,201,1560,7,"MUNICIPIUL PITESTI",,5,,724,836
3,"Argeș",38,"38-MUNICIPIUL PITESTI",13169,19,2,1761,1372,1244,128,1363,9,"MUNICIPIUL PITESTI",,5,,596,767
3,"Argeș",38,"38-MUNICIPIUL PITESTI",13169,20,2,1915,1283,1170,113,1277,6,"MUNICIPIUL PITESTI",,5,,686,591
3,"Argeș",38,"38-MUNICIPIUL PITESTI",13169,21,2,2196,1584,1504,80,1575,9,"MUNICIPIUL PITESTI",,5,,762,813
3,"Argeș",38,"38-MUNICIPIUL PITESTI",13169,22,2,1811,1205,1102,103,1194,11,"MUNICIPIUL PITESTI",,5,,637,557
3,"Argeș",38,"38-MUNICIPIUL PITESTI",13169,23,2,2069,1264,1158,106,1260,4,"MUNICIPIUL PITESTI",,5,,609,651
3,"Argeș",38,"38-MUNICIPIUL PITESTI",13169,24,2,2042,1312,1218,94,1302,10,"MUNICIPIUL PITESTI",,5,,682,620
3,"Argeș",38,"38-MUNICIPIUL PITESTI",13169,25,2,2062,1476,1370,106,1472,4,"MUNICIPIUL PITESTI",,5,,742,730
3,"Argeș",38,"38-MUNICIPIUL PITESTI",13169,26,2,2023,1476,1361,115,1470,6,"MUNICIPIUL PITESTI",,5,,780,690
3,"Argeș",38,"38-MUNICIPIUL PITESTI",13169,27,2,2370,1687,1556,131,1672,15,"MUNICIPIUL PITESTI",,5,,878,794
3,"Argeș",38,"38-MUNICIPIUL PITESTI",13169,28,2,1654,1221,1140,81,1217,4,"MUNICIPIUL PITESTI",,5,,623,594
3,"Argeș",38,"38-MUNICIPIUL PITESTI",13169,29,2,1193,932,856,76,928,4,"MUNICIPIUL PITESTI",,5,,521,407
3,"Argeș",38,"38-MUNICIPIUL PITESTI",13169,30,2,1917,1355,1258,97,1352,3,"MUNICIPIUL PITESTI",,5,,700,652
3,"Argeș",38,"38-MUNICIPIUL PITESTI",13169,31,2,908,981,612,369,977,4,"MUNICIPIUL PITESTI",,5,,534,443
3,"Argeș",38,"38-MUNICIPIUL PITESTI",13169,32,2,1700,1199,997,202,1193,6,"MUNICIPIUL PITESTI",,5,,607,586
3,"Argeș",38,"38-MUNICIPIUL PITESTI",13169,33,2,1847,1772,1283,489,1763,9,"MUNICIPIUL PITESTI",,5,,914,849
3,"Argeș",38,"38-MUNICIPIUL PITESTI",13169,34,2,1641,1196,1071,125,1191,5,"MUNICIPIUL PITESTI",,5,,592,599
3,"Argeș",38,"38-MUNICIPIUL PITESTI",13169,35,2,1881,1398,1295,103,1395,3,"MUNICIPIUL PITESTI",,5,,685,710
3,"Argeș",38,"38-MUNICIPIUL PITESTI",13169,36,2,1539,1028,961,67,1022,6,"MUNICIPIUL PITESTI",,5,,537,485
3,"Argeș",38,"38-MUNICIPIUL PITESTI",13169,37,2,2182,1708,1425,283,1701,7,"MUNICIPIUL PITESTI",,5,,743,958
3,"Argeș",38,"38-MUNICIPIUL PITESTI",13169,38,2,2027,1503,1401,102,1499,4,"MUNICIPIUL PITESTI",,5,,602,897
3,"Argeș",38,"38-MUNICIPIUL PITESTI",13169,39,2,1637,1216,1125,91,1214,2,"MUNICIPIUL PITESTI",,5,,521,693
3,"Argeș",38,"38-MUNICIPIUL PITESTI",13169,40,2,1761,1493,1269,224,1484,9,"MUNICIPIUL PITESTI",,5,,696,788
3,"Argeș",38,"38-MUNICIPIUL PITESTI",13169,41,2,1892,1511,1423,88,1507,4,"MUNICIPIUL PITESTI",,5,,704,803
3,"Argeș",38,"38-MUNICIPIUL PITESTI",13169,42,2,905,767,623,144,765,2,"MUNICIPIUL PITESTI",,5,,323,442
3,"Argeș",38,"38-MUNICIPIUL PITESTI",13169,43,2,1519,1274,1124,150,1269,5,"MUNICIPIUL PITESTI",,5,,546,723
3,"Argeș",38,"38-MUNICIPIUL PITESTI",13169,44,2,1046,854,785,69,846,8,"MUNICIPIUL PITESTI",,5,,385,461
3,"Argeș",38,"38-MUNICIPIUL PITESTI",13169,45,2,554,410,371,39,405,5,"MUNICIPIUL PITESTI",,5,,224,181
3,"Argeș",38,"38-MUNICIPIUL PITESTI",13169,46,2,1909,1372,1278,94,1365,7,"MUNICIPIUL PITESTI",,5,,578,787
3,"Argeș",38,"38-MUNICIPIUL PITESTI",13169,47,2,1673,1233,1170,63,1228,5,"MUNICIPIUL PITESTI",,5,,478,750
3,"Argeș",38,"38-MUNICIPIUL PITESTI",13169,48,2,1903,1521,1389,132,1518,3,"MUNICIPIUL PITESTI",,5,,577,941
3,"Argeș",38,"38-MUNICIPIUL PITESTI",13169,49,2,1599,1164,1081,83,1162,2,"MUNICIPIUL PITESTI",,5,,439,723
3,"Argeș",38,"38-MUNICIPIUL PITESTI",13169,50,2,1154,878,818,60,874,4,"MUNICIPIUL PITESTI",,5,,267,607
3,"Argeș",38,"38-MUNICIPIUL PITESTI",13169,51,2,2084,1392,1291,101,1387,5,"MUNICIPIUL PITESTI",,5,,663,724
3,"Argeș",38,"38-MUNICIPIUL PITESTI",13169,52,2,2374,1746,1596,150,1740,6,"MUNICIPIUL PITESTI",,5,,788,952
3,"Argeș",38,"38-MUNICIPIUL PITESTI",13169,53,2,2152,1473,1410,63,1466,7,"MUNICIPIUL PITESTI",,5,,763,703
3,"Argeș",38,"38-MUNICIPIUL PITESTI",13169,54,2,1541,1005,941,64,1003,2,"MUNICIPIUL PITESTI",,5,,544,459
3,"Argeș",38,"38-MUNICIPIUL PITESTI",13169,55,2,2517,1678,1507,171,1670,8,"MUNICIPIUL PITESTI",,5,,883,787
3,"Argeș",38,"38-MUNICIPIUL PITESTI",13169,56,2,2573,1762,1674,88,1751,11,"MUNICIPIUL PITESTI",,5,,846,905
3,"Argeș",38,"38-MUNICIPIUL PITESTI",13169,57,2,1691,1365,1216,149,1361,4,"MUNICIPIUL PITESTI",,5,,662,699
3,"Argeș",38,"38-MUNICIPIUL PITESTI",13169,58,2,2137,1551,1425,126,1545,6,"MUNICIPIUL PITESTI",,5,,798,747
3,"Argeș",38,"38-MUNICIPIUL PITESTI",13169,59,2,1985,1553,1394,159,1546,7,"MUNICIPIUL PITESTI",,5,,843,703
3,"Argeș",38,"38-MUNICIPIUL PITESTI",13169,60,2,1828,1567,1301,266,1563,4,"MUNICIPIUL PITESTI",,5,,765,798
3,"Argeș",38,"38-MUNICIPIUL PITESTI",13169,61,2,1745,1366,1202,164,1359,7,"MUNICIPIUL PITESTI",,5,,563,796
3,"Argeș",38,"38-MUNICIPIUL PITESTI",13169,62,2,1740,1215,1137,78,1210,5,"MUNICIPIUL PITESTI",,5,,544,666
3,"Argeș",38,"38-MUNICIPIUL PITESTI",13169,63,2,1530,1095,1017,78,1087,8,"MUNICIPIUL PITESTI",,5,,532,555
3,"Argeș",38,"38-MUNICIPIUL PITESTI",13169,64,2,1355,1051,995,56,1044,7,"MUNICIPIUL PITESTI",,5,,508,536
3,"Argeș",38,"38-MUNICIPIUL PITESTI",13169,65,2,1710,1188,1072,116,1182,6,"MUNICIPIUL PITESTI",,5,,578,604
3,"Argeș",38,"38-MUNICIPIUL PITESTI",13169,66,2,2137,1523,1434,89,1516,7,"MUNICIPIUL PITESTI",,5,,787,729
3,"Argeș",38,"38-MUNICIPIUL PITESTI",13169,67,2,2295,1463,1253,210,1448,15,"MUNICIPIUL PITESTI",,5,,804,644
3,"Argeș",38,"38-MUNICIPIUL PITESTI",13169,68,2,2135,1342,1267,75,1339,3,"MUNICIPIUL PITESTI",,5,,635,704
3,"Argeș",38,"38-MUNICIPIUL PITESTI",13169,69,2,2074,1520,1407,113,1514,6,"MUNICIPIUL PITESTI",,5,,752,762
3,"Argeș",38,"38-MUNICIPIUL PITESTI",13169,70,2,2045,1411,1285,126,1404,7,"MUNICIPIUL PITESTI",,5,,679,725
3,"Argeș",38,"38-MUNICIPIUL PITESTI",13169,71,2,1807,1123,1030,93,1115,8,"MUNICIPIUL PITESTI",,5,,568,547
3,"Argeș",38,"38-MUNICIPIUL PITESTI",13169,72,2,1825,1373,1308,65,1370,3,"MUNICIPIUL PITESTI",,5,,564,806
3,"Argeș",38,"38-MUNICIPIUL PITESTI",13169,73,2,2043,1435,1370,65,1432,3,"MUNICIPIUL PITESTI",,5,,645,787
3,"Argeș",38,"38-MUNICIPIUL PITESTI",13169,74,2,2345,1575,1495,80,1573,2,"MUNICIPIUL PITESTI",,5,,728,845
3,"Argeș",38,"38-MUNICIPIUL PITESTI",13169,75,2,1946,1508,1365,143,1499,9,"MUNICIPIUL PITESTI",,5,,687,812
3,"Argeș",38,"38-MUNICIPIUL PITESTI",13169,76,2,2148,1486,1389,97,1476,10,"MUNICIPIUL PITESTI",,5,,701,775
3,"Argeș",38,"38-MUNICIPIUL PITESTI",13169,77,2,2102,1371,1307,64,1365,6,"MUNICIPIUL PITESTI",,5,,679,686
3,"Argeș",38,"38-MUNICIPIUL PITESTI",13169,78,2,2086,1534,1448,86,1528,6,"MUNICIPIUL PITESTI",,5,,711,817
3,"Argeș",38,"38-MUNICIPIUL PITESTI",13169,79,2,1851,1524,1353,171,1510,14,"MUNICIPIUL PITESTI",,5,,712,798
3,"Argeș",38,"38-MUNICIPIUL PITESTI",13169,80,2,1221,813,600,213,810,3,"MUNICIPIUL PITESTI",,5,,368,442
3,"Argeș",38,"38-MUNICIPIUL PITESTI",13169,81,2,0,449,0,449,442,7,"MUNICIPIUL PITESTI",,5,,178,264
3,"Argeș",38,"38-MUNICIPIUL PITESTI",13169,82,2,0,581,0,581,564,17,"MUNICIPIUL PITESTI",,5,,306,258
3,"Argeș",38,"38-MUNICIPIUL PITESTI",13169,83,2,0,157,0,157,157,0,"MUNICIPIUL PITESTI",,5,,56,101
3,"Argeș",38,"38-MUNICIPIUL CAMPULUNG",13490,84,2,1330,1027,916,111,1024,3,"MUNICIPIUL CAMPULUNG",,5,,474,550
3,"Argeș",38,"38-MUNICIPIUL CAMPULUNG",13490,85,2,1381,980,933,47,976,4,"MUNICIPIUL CAMPULUNG",,5,,473,503
3,"Argeș",38,"38-MUNICIPIUL CAMPULUNG",13490,86,2,1661,1151,1028,123,1147,4,"MUNICIPIUL CAMPULUNG",,5,,494,653
3,"Argeș",38,"38-MUNICIPIUL CAMPULUNG",13490,87,2,1971,1403,1310,93,1403,0,"MUNICIPIUL CAMPULUNG",,5,,522,881
3,"Argeș",38,"38-MUNICIPIUL CAMPULUNG",13490,88,2,2173,1533,1461,72,1527,6,"MUNICIPIUL CAMPULUNG",,5,,616,911
3,"Argeș",38,"38-MUNICIPIUL CAMPULUNG",13490,89,2,1676,1168,1068,100,1164,4,"MUNICIPIUL CAMPULUNG",,5,,443,721
3,"Argeș",38,"38-MUNICIPIUL CAMPULUNG",13490,90,2,853,762,623,139,760,2,"MUNICIPIUL CAMPULUNG",,5,,382,378
3,"Argeș",38,"38-MUNICIPIUL CAMPULUNG",13490,91,2,956,755,707,48,752,3,"MUNICIPIUL CAMPULUNG",,5,,397,355
3,"Argeș",38,"38-MUNICIPIUL CAMPULUNG",13490,92,2,1375,1072,1021,51,1066,6,"MUNICIPIUL CAMPULUNG",,5,,464,602
3,"Argeș",38,"38-MUNICIPIUL CAMPULUNG",13490,93,2,2156,1446,1359,87,1439,7,"MUNICIPIUL CAMPULUNG",,5,,662,777
3,"Argeș",38,"38-MUNICIPIUL CAMPULUNG",13490,94,2,2080,1354,1271,83,1345,9,"MUNICIPIUL CAMPULUNG",,5,,651,694
3,"Argeș",38,"38-MUNICIPIUL CAMPULUNG",13490,95,2,2395,1698,1547,151,1692,6,"MUNICIPIUL CAMPULUNG",,5,,770,922
3,"Argeș",38,"38-MUNICIPIUL CAMPULUNG",13490,96,2,2476,1479,1378,101,1470,9,"MUNICIPIUL CAMPULUNG",,5,,779,691
3,"Argeș",38,"38-MUNICIPIUL CAMPULUNG",13490,97,2,1885,1338,1235,103,1333,5,"MUNICIPIUL CAMPULUNG",,5,,620,713
3,"Argeș",38,"38-MUNICIPIUL CAMPULUNG",13490,98,2,455,346,319,27,344,2,"MUNICIPIUL CAMPULUNG",,5,,238,106
3,"Argeș",38,"38-MUNICIPIUL CAMPULUNG",13490,99,2,1201,882,814,68,877,5,"MUNICIPIUL CAMPULUNG",,5,,392,485
3,"Argeș",38,"38-MUNICIPIUL CAMPULUNG",13490,100,2,840,606,547,59,601,5,"MUNICIPIUL CAMPULUNG",,5,,275,326
3,"Argeș",38,"38-MUNICIPIUL CAMPULUNG",13490,101,2,940,661,636,25,652,9,"MUNICIPIUL CAMPULUNG",,5,,355,297
3,"Argeș",38,"38-MUNICIPIUL CAMPULUNG",13490,102,2,1070,792,704,88,791,1,"MUNICIPIUL CAMPULUNG",,5,,498,293
3,"Argeș",38,"38-MUNICIPIUL CAMPULUNG",13490,103,2,975,728,670,58,725,3,"MUNICIPIUL CAMPULUNG",,5,,365,360
3,"Argeș",38,"38-MUNICIPIUL CAMPULUNG",13490,104,2,538,445,408,37,444,1,"MUNICIPIUL CAMPULUNG",,5,,290,154
3,"Argeș",38,"38-MUNICIPIUL CAMPULUNG",13490,105,2,1554,1198,1112,86,1186,12,"MUNICIPIUL CAMPULUNG",,5,,530,656
3,"Argeș",38,"38-MUNICIPIUL CAMPULUNG",13490,106,2,1318,1095,836,259,1091,4,"MUNICIPIUL CAMPULUNG",,5,,528,563
3,"Argeș",38,"38-MUNICIPIUL CAMPULUNG",13490,107,2,826,774,753,21,760,13,"MUNICIPIUL CAMPULUNG",,5,,319,441
3,"Argeș",38,"38-MUNICIPIUL CURTEA DE ARGES",13622,108,2,1792,1431,1200,231,1417,14,"MUNICIPIUL CURTEA DE ARGES",,5,,728,689
3,"Argeș",38,"38-MUNICIPIUL CURTEA DE ARGES",13622,109,2,1638,1355,1148,207,1349,6,"MUNICIPIUL CURTEA DE ARGES",,5,,740,609
3,"Argeș",38,"38-MUNICIPIUL CURTEA DE ARGES",13622,110,2,1368,993,896,97,982,11,"MUNICIPIUL CURTEA DE ARGES",,5,,531,451
3,"Argeș",38,"38-MUNICIPIUL CURTEA DE ARGES",13622,111,2,2492,1868,1512,356,1863,5,"MUNICIPIUL CURTEA DE ARGES",,5,,999,864
3,"Argeș",38,"38-MUNICIPIUL CURTEA DE ARGES",13622,112,2,2349,1501,1364,137,1498,3,"MUNICIPIUL CURTEA DE ARGES",,5,,796,702
3,"Argeș",38,"38-MUNICIPIUL CURTEA DE ARGES",13622,113,2,2059,1434,1186,248,1431,3,"MUNICIPIUL CURTEA DE ARGES",,5,,706,725
3,"Argeș",38,"38-MUNICIPIUL CURTEA DE ARGES",13622,114,2,1396,1015,874,141,1005,10,"MUNICIPIUL CURTEA DE ARGES",,5,,542,463
3,"Argeș",38,"38-MUNICIPIUL CURTEA DE ARGES",13622,115,2,2032,1499,1270,229,1494,5,"MUNICIPIUL CURTEA DE ARGES",,5,,719,775
3,"Argeș",38,"38-MUNICIPIUL CURTEA DE ARGES",13622,116,2,2266,1768,1492,276,1765,3,"MUNICIPIUL CURTEA DE ARGES",,5,,866,899
3,"Argeș",38,"38-MUNICIPIUL CURTEA DE ARGES",13622,117,2,2662,1909,1717,192,1893,16,"MUNICIPIUL CURTEA DE ARGES",,5,,1032,861
3,"Argeș",38,"38-MUNICIPIUL CURTEA DE ARGES",13622,118,2,2307,1721,1416,305,1709,12,"MUNICIPIUL CURTEA DE ARGES",,5,,850,859
3,"Argeș",38,"38-MUNICIPIUL CURTEA DE ARGES",13622,119,2,786,635,592,43,631,4,"MUNICIPIUL CURTEA DE ARGES",,5,,426,205
3,"Argeș",38,"38-MUNICIPIUL CURTEA DE ARGES",13622,120,2,1825,1228,1160,68,1221,7,"MUNICIPIUL CURTEA DE ARGES",,5,,720,501
3,"Argeș",38,"38-MUNICIPIUL CURTEA DE ARGES",13622,121,2,625,481,433,48,480,1,"MUNICIPIUL CURTEA DE ARGES",,5,,215,265
3,"Argeș",38,"38-MUNICIPIUL CURTEA DE ARGES",13622,122,2,902,735,627,108,727,8,"MUNICIPIUL CURTEA DE ARGES",,5,,475,252
3,"Argeș",38,"38-MUNICIPIUL CURTEA DE ARGES",13622,123,2,605,423,379,44,415,8,"MUNICIPIUL CURTEA DE ARGES",,5,,286,129
3,"Argeș",38,"38-MUNICIPIUL CURTEA DE ARGES",13622,124,2,0,397,0,397,395,2,"MUNICIPIUL CURTEA DE ARGES",,5,,245,150
3,"Argeș",38,"38-ORAS COSTESTI",13668,125,2,2030,1421,1198,223,1414,7,"ORAS COSTESTI",,5,,849,565
3,"Argeș",38,"38-ORAS COSTESTI",13668,126,2,536,447,298,149,446,1,"ORAS COSTESTI",,5,,274,172
3,"Argeș",38,"38-ORAS COSTESTI",13668,127,2,2143,1431,1283,148,1421,10,"ORAS COSTESTI",,5,,873,548
3,"Argeș",38,"38-ORAS COSTESTI",13668,128,2,846,573,508,65,571,2,"ORAS COSTESTI",,5,,356,215
3,"Argeș",38,"38-ORAS COSTESTI",13668,129,2,1204,756,629,127,751,5,"ORAS COSTESTI",,5,,486,265
3,"Argeș",38,"38-ORAS COSTESTI",13668,130,2,804,501,411,90,496,5,"ORAS COSTESTI",,5,,365,131
3,"Argeș",38,"38-ORAS COSTESTI",13668,131,2,487,412,285,127,410,2,"ORAS COSTESTI",,5,,225,185
3,"Argeș",38,"38-ORAS COSTESTI",13668,132,2,602,419,362,57,412,7,"ORAS COSTESTI",,5,,294,118
3,"Argeș",38,"38-ORAS MIOVENI",13301,133,2,2544,1762,1533,229,1753,9,"ORAS MIOVENI",,5,,880,873
3,"Argeș",38,"38-ORAS MIOVENI",13301,134,2,2465,1645,1351,294,1638,7,"ORAS MIOVENI",,5,,857,781
3,"Argeș",38,"38-ORAS MIOVENI",13301,135,2,2606,1692,1413,279,1682,10,"ORAS MIOVENI",,5,,898,784
3,"Argeș",38,"38-ORAS MIOVENI",13301,136,2,2068,1569,1255,314,1565,4,"ORAS MIOVENI",,5,,898,667
3,"Argeș",38,"38-ORAS MIOVENI",13301,137,2,2100,1590,1368,222,1582,8,"ORAS MIOVENI",,5,,866,716
3,"Argeș",38,"38-ORAS MIOVENI",13301,138,2,1247,1097,905,192,1095,2,"ORAS MIOVENI",,5,,566,529
3,"Argeș",38,"38-ORAS MIOVENI",13301,139,2,1419,1041,923,118,1038,3,"ORAS MIOVENI",,5,,562,476
3,"Argeș",38,"38-ORAS MIOVENI",13301,140,2,1764,1200,1036,164,1190,10,"ORAS MIOVENI",,5,,586,604
3,"Argeș",38,"38-ORAS MIOVENI",13301,141,2,1780,1348,1082,266,1340,8,"ORAS MIOVENI",,5,,670,670
3,"Argeș",38,"38-ORAS MIOVENI",13301,142,2,1258,980,786,194,973,7,"ORAS MIOVENI",,5,,681,292
3,"Argeș",38,"38-ORAS MIOVENI",13301,143,2,1530,1090,1012,78,1090,0,"ORAS MIOVENI",,5,,761,329
3,"Argeș",38,"38-ORAS MIOVENI",13301,144,2,894,771,726,45,768,3,"ORAS MIOVENI",,5,,180,588
3,"Argeș",38,"38-ORAS MIOVENI",13301,145,2,875,569,526,43,563,6,"ORAS MIOVENI",,5,,356,207
3,"Argeș",38,"38-ORAS TOPOLOVENI",13757,146,2,837,619,560,59,615,4,"ORAS TOPOLOVENI",,5,,289,326
3,"Argeș",38,"38-ORAS TOPOLOVENI",13757,147,2,2120,1480,1280,200,1474,6,"ORAS TOPOLOVENI",,5,,720,754
3,"Argeș",38,"38-ORAS TOPOLOVENI",13757,148,2,2742,1909,1719,190,1902,7,"ORAS TOPOLOVENI",,5,,895,1007
3,"Argeș",38,"38-ORAS TOPOLOVENI",13757,149,2,1396,1001,883,118,991,10,"ORAS TOPOLOVENI",,5,,562,429
3,"Argeș",38,"38-ALBESTII DE ARGES",13819,150,2,1691,1386,934,452,1374,12,"ALBESTII DE ARGES",,5,,819,555
3,"Argeș",38,"38-ALBESTII DE ARGES",13819,151,2,2027,1270,1017,253,1249,21,"ALBESTII DE ARGES",,5,,863,386
3,"Argeș",38,"38-ALBESTII DE ARGES",13819,152,2,699,434,326,108,429,5,"ALBESTII DE ARGES",,5,,282,147
3,"Argeș",38,"38-ALBESTII DE MUSCEL",13891,153,2,2113,1413,1266,147,1405,8,"ALBESTII DE MUSCEL",,5,,794,611
3,"Argeș",38,"38-ALBESTII DE MUSCEL",13891,154,2,926,748,650,98,740,8,"ALBESTII DE MUSCEL",,5,,365,375
3,"Argeș",38,"38-ALBESTII DE MUSCEL",13891,155,2,405,360,322,38,357,3,"ALBESTII DE MUSCEL",,5,,254,103
3,"Argeș",38,"38-ALBOTA",13935,156,2,1413,863,648,215,850,13,"ALBOTA",,5,,460,390
3,"Argeș",38,"38-ALBOTA",13935,157,2,887,543,373,170,534,9,"ALBOTA",,5,,347,187
3,"Argeș",38,"38-ALBOTA",13935,158,2,443,423,246,177,418,5,"ALBOTA",,5,,277,141
3,"Argeș",38,"38-ANINOASA",13999,159,2,1640,1236,1058,178,1231,5,"ANINOASA",,5,,872,359
3,"Argeș",38,"38-ANINOASA",13999,160,2,829,678,608,70,675,3,"ANINOASA",,5,,495,180
3,"Argeș",38,"38-AREF",14049,161,2,1159,785,722,63,779,6,"AREF",,5,,491,288
3,"Argeș",38,"38-AREF",14049,162,2,911,829,654,175,825,4,"AREF",,5,,554,271
3,"Argeș",38,"38-BASCOV",13187,163,2,1244,1001,772,229,1000,1,"BASCOV",,5,,530,470
3,"Argeș",38,"38-BASCOV",13187,164,2,1915,1196,944,252,1192,4,"BASCOV",,5,,678,514
3,"Argeș",38,"38-BASCOV",13187,165,2,821,532,423,109,525,7,"BASCOV",,5,,318,207
3,"Argeș",38,"38-BASCOV",13187,166,2,521,348,282,66,348,0,"BASCOV",,5,,185,163
3,"Argeș",38,"38-BASCOV",13187,167,2,1190,856,631,225,854,2,"BASCOV",,5,,513,341
3,"Argeș",38,"38-BASCOV",13187,168,2,620,344,314,30,342,2,"BASCOV",,5,,228,114
3,"Argeș",38,"38-BABANA",14085,169,2,1074,648,516,132,646,2,"BABANA",,5,,415,231
3,"Argeș",38,"38-BABANA",14085,170,2,338,269,188,81,265,4,"BABANA",,5,,166,99
3,"Argeș",38,"38-BABANA",14085,171,2,512,419,284,135,413,6,"BABANA",,5,,242,171
3,"Argeș",38,"38-BAICULESTI",14165,172,2,1751,1210,985,225,1206,4,"BAICULESTI",,5,,725,481
3,"Argeș",38,"38-BAICULESTI",14165,173,2,1584,978,859,119,972,6,"BAICULESTI",,5,,760,212
3,"Argeș",38,"38-BAICULESTI",14165,174,2,1433,945,784,161,938,7,"BAICULESTI",,5,,621,317
3,"Argeș",38,"38-BALILESTI",14272,175,2,939,713,619,94,711,2,"BALILESTI",,5,,567,144
3,"Argeș",38,"38-BALILESTI",14272,176,2,1079,819,773,46,814,5,"BALILESTI",,5,,640,174
3,"Argeș",38,"38-BALILESTI",14272,177,2,1669,1248,1153,95,1245,3,"BALILESTI",,5,,1071,174
3,"Argeș",38,"38-BELETI-NEGRESTI",14352,178,2,524,368,311,57,366,2,"BELETI-NEGRESTI",,5,,229,137
3,"Argeș",38,"38-BELETI-NEGRESTI",14352,179,2,1010,695,587,108,691,4,"BELETI-NEGRESTI",,5,,422,269
3,"Argeș",38,"38-BEREVOIESTI",14414,180,2,2435,1764,1583,181,1749,15,"BEREVOIESTI",,5,,1405,344
3,"Argeș",38,"38-BARLA",14450,181,2,1323,841,620,221,830,11,"BARLA",,5,,494,336
3,"Argeș",38,"38-BARLA",14450,182,2,761,508,358,150,502,6,"BARLA",,5,,301,201
3,"Argeș",38,"38-BARLA",14450,183,2,1152,735,552,183,727,8,"BARLA",,5,,461,266
3,"Argeș",38,"38-BARLA",14450,184,2,1573,855,731,124,842,13,"BARLA",,5,,586,256
3,"Argeș",38,"38-BOGATI",14584,185,2,635,417,334,83,416,1,"BOGATI",,5,,296,120
3,"Argeș",38,"38-BOGATI",14584,186,2,2053,1166,1014,152,1158,8,"BOGATI",,5,,664,494
3,"Argeș",38,"38-BOGATI",14584,187,2,1422,818,733,85,811,7,"BOGATI",,5,,525,286
3,"Argeș",38,"38-BOTENI",14673,188,2,2291,1665,1555,110,1652,13,"BOTENI",,5,,1227,425
3,"Argeș",38,"38-BOTESTI",14726,189,2,696,703,606,97,700,3,"BOTESTI",,5,,471,229
3,"Argeș",38,"38-BOTESTI",14726,190,2,368,345,311,34,343,2,"BOTESTI",,5,,205,138
3,"Argeș",38,"38-BRADU",13276,191,2,1022,746,519,227,744,2,"BRADU",,5,,391,353
3,"Argeș",38,"38-BRADU",13276,192,2,1331,767,627,140,762,5,"BRADU",,5,,449,313
3,"Argeș",38,"38-BRADU",13276,193,2,1211,895,636,259,891,4,"BRADU",,5,,533,358
3,"Argeș",38,"38-BRADULET",14753,194,2,565,443,373,70,441,2,"BRADULET",,5,,246,195
3,"Argeș",38,"38-BRADULET",14753,195,2,884,606,564,42,605,1,"BRADULET",,5,,450,155
3,"Argeș",38,"38-BRADULET",14753,196,2,414,537,328,209,534,3,"BRADULET",,5,,223,311
3,"Argeș",38,"38-BUDEASA",14851,197,2,1230,787,647,140,780,7,"BUDEASA",,5,,492,288
3,"Argeș",38,"38-BUDEASA",14851,198,2,760,524,431,93,519,5,"BUDEASA",,5,,327,192
3,"Argeș",38,"38-BUDEASA",14851,199,2,736,546,419,127,542,4,"BUDEASA",,5,,366,176
3,"Argeș",38,"38-BUGHEA DE JOS",14922,200,2,2203,1633,1509,124,1619,14,"BUGHEA DE JOS",,5,,1113,506
3,"Argeș",38,"38-BUZOIESTI",14976,201,2,1184,951,761,190,938,13,"BUZOIESTI",,5,,757,181
3,"Argeș",38,"38-BUZOIESTI",14976,202,2,1009,631,503,128,625,6,"BUZOIESTI",,5,,451,174
3,"Argeș",38,"38-BUZOIESTI",14976,203,2,1807,900,769,131,896,4,"BUZOIESTI",,5,,554,342
3,"Argeș",38,"38-BUZOIESTI",14976,204,2,1072,845,713,132,836,9,"BUZOIESTI",,5,,509,327
3,"Argeș",38,"38-CALDARARU",15064,205,2,857,643,530,113,639,4,"CALDARARU",,5,,453,186
3,"Argeș",38,"38-CALDARARU",15064,206,2,1080,724,611,113,717,7,"CALDARARU",,5,,561,156
3,"Argeș",38,"38-CALDARARU",15064,207,2,691,492,425,67,491,1,"CALDARARU",,5,,372,119
3,"Argeș",38,"38-CALINESTI",15108,208,2,1551,895,784,111,890,5,"CALINESTI",,5,,521,369
3,"Argeș",38,"38-CALINESTI",15108,209,2,1713,1025,821,204,1012,13,"CALINESTI",,5,,612,400
3,"Argeș",38,"38-CALINESTI",15108,210,2,788,512,369,143,510,2,"CALINESTI",,5,,243,267
3,"Argeș",38,"38-CALINESTI",15108,211,2,1562,948,698,250,944,4,"CALINESTI",,5,,569,375
3,"Argeș",38,"38-CALINESTI",15108,212,2,1201,698,573,125,694,4,"CALINESTI",,5,,419,275
3,"Argeș",38,"38-CALINESTI",15108,213,2,985,580,453,127,571,9,"CALINESTI",,5,,422,149
3,"Argeș",38,"38-CATEASCA",15233,214,2,729,591,499,92,587,4,"CATEASCA",,5,,348,239
3,"Argeș",38,"38-CATEASCA",15233,215,2,474,368,310,58,366,2,"CATEASCA",,5,,224,142
3,"Argeș",38,"38-CATEASCA",15233,216,2,1483,1047,872,175,1040,7,"CATEASCA",,5,,687,353
3,"Argeș",38,"38-CEPARI",15313,217,2,1024,680,597,83,674,6,"CEPARI",,5,,495,179
3,"Argeș",38,"38-CEPARI",15313,218,2,723,492,440,52,487,5,"CEPARI",,5,,317,170
3,"Argeș",38,"38-CEPARI",15313,219,2,285,242,203,39,240,2,"CEPARI",,5,,167,73
3,"Argeș",38,"38-CETATENI",15402,220,2,1618,1167,1049,118,1148,19,"CETATENI",,5,,811,337
3,"Argeș",38,"38-CETATENI",15402,221,2,718,554,496,58,553,1,"CETATENI",,5,,351,202
3,"Argeș",38,"38-CICANESTI",15448,222,2,1794,1093,971,122,1084,9,"CICANESTI",,5,,790,294
3,"Argeș",38,"38-CIOFRANGENI",15493,223,2,2027,1392,1155,237,1374,18,"CIOFRANGENI",,5,,828,546
3,"Argeș",38,"38-CIOMAGESTI",15554,224,2,448,370,262,108,365,5,"CIOMAGESTI",,5,,211,154
3,"Argeș",38,"38-CIOMAGESTI",15554,225,2,615,400,311,89,399,1,"CIOMAGESTI",,5,,275,124
3,"Argeș",38,"38-COCU",15652,226,2,958,600,434,166,596,4,"COCU",,5,,426,170
3,"Argeș",38,"38-COCU",15652,227,2,812,460,375,85,456,4,"COCU",,5,,335,121
3,"Argeș",38,"38-COCU",15652,228,2,533,368,275,93,362,6,"COCU",,5,,223,139
3,"Argeș",38,"38-CORBENI",15741,229,2,1761,1246,1010,236,1230,16,"CORBENI",,5,,961,269
3,"Argeș",38,"38-CORBENI",15741,230,2,1912,1330,1010,320,1329,1,"CORBENI",,5,,813,516
3,"Argeș",38,"38-CORBENI",15741,231,2,652,525,401,124,522,3,"CORBENI",,5,,411,111
3,"Argeș",38,"38-CORBI",15830,232,2,1662,940,841,99,922,18,"CORBI",,5,,550,372
3,"Argeș",38,"38-CORBI",15830,233,2,947,698,557,141,690,8,"CORBI",,5,,509,181
3,"Argeș",38,"38-CORBI",15830,234,2,662,724,611,113,721,3,"CORBI",,5,,510,211
3,"Argeș",38,"38-COSESTI",15901,235,2,850,606,466,140,602,4,"COSESTI",,5,,433,169
3,"Argeș",38,"38-COSESTI",15901,236,2,1553,1077,820,257,1074,3,"COSESTI",,5,,716,358
3,"Argeș",38,"38-COSESTI",15901,237,2,1900,1347,1013,334,1335,12,"COSESTI",,5,,995,340
3,"Argeș",38,"38-COTMEANA",15983,238,2,857,571,464,107,565,6,"COTMEANA",,5,,443,122
3,"Argeș",38,"38-COTMEANA",15983,239,2,446,296,240,56,294,2,"COTMEANA",,5,,211,83
3,"Argeș",38,"38-COTMEANA",15983,240,2,484,382,240,142,379,3,"COTMEANA",,5,,273,106
3,"Argeș",38,"38-CUCA",16132,241,2,1274,830,676,154,820,10,"CUCA",,5,,588,232
3,"Argeș",38,"38-CUCA",16132,242,2,566,397,297,100,389,8,"CUCA",,5,,288,101
3,"Argeș",38,"38-DAVIDESTI",16285,243,2,904,666,539,127,660,6,"DAVIDESTI",,5,,474,186
3,"Argeș",38,"38-DAVIDESTI",16285,244,2,1009,676,572,104,669,7,"DAVIDESTI",,5,,507,162
3,"Argeș",38,"38-DAMBOVICIOARA",16329,245,2,472,320,276,44,320,0,"DAMBOVICIOARA",,5,,168,152
3,"Argeș",38,"38-DAMBOVICIOARA",16329,246,2,446,469,387,82,467,2,"DAMBOVICIOARA",,5,,313,154
3,"Argeș",38,"38-DARMANESTI",16365,247,2,1588,1033,886,147,1026,7,"DARMANESTI",,5,,686,340
3,"Argeș",38,"38-DARMANESTI",16365,248,2,1189,875,731,144,867,8,"DARMANESTI",,5,,597,270
3,"Argeș",38,"38-DOBRESTI",16427,249,2,838,687,598,89,687,0,"DOBRESTI",,5,,398,289
3,"Argeș",38,"38-DOBRESTI",16427,250,2,599,469,404,65,467,2,"DOBRESTI",,5,,305,162
3,"Argeș",38,"38-DOMNESTI",16454,251,2,2599,2051,1820,231,2046,5,"DOMNESTI",,5,,1190,856
3,"Argeș",38,"38-DRAGOSLAVELE",16472,252,2,833,773,600,173,765,8,"DRAGOSLAVELE",,5,,521,244
3,"Argeș",38,"38-DRAGOSLAVELE",16472,253,2,866,677,634,43,673,4,"DRAGOSLAVELE",,5,,432,241
3,"Argeș",38,"38-DRAGANU",16506,254,2,1334,838,677,161,828,10,"DRAGANU",,5,,465,363
3,"Argeș",38,"38-GODENI",16551,255,2,1227,1042,953,89,1035,7,"GODENI",,5,,677,358
3,"Argeș",38,"38-GODENI",16551,256,2,1490,1156,1028,128,1152,4,"GODENI",,5,,764,388
3,"Argeș",38,"38-HARSESTI",16613,257,2,1915,1095,823,272,1080,15,"HARSESTI",,5,,688,392
3,"Argeș",38,"38-HARSESTI",16613,258,2,766,527,374,153,520,7,"HARSESTI",,5,,311,209
3,"Argeș",38,"38-HARTIESTI",16659,259,2,1477,1056,931,125,1044,12,"HARTIESTI",,5,,825,219
3,"Argeș",38,"38-HARTIESTI",16659,260,2,1319,974,843,131,967,7,"HARTIESTI",,5,,717,250
3,"Argeș",38,"38-HARTIESTI",16659,261,2,511,403,333,70,400,3,"HARTIESTI",,5,,275,125
3,"Argeș",38,"38-HARTIESTI",16659,262,2,180,173,135,38,173,0,"HARTIESTI",,5,,147,26
3,"Argeș",38,"38-IZVORU",16739,263,2,2179,1299,1124,175,1293,6,"IZVORU",,5,,985,308
3,"Argeș",38,"38-LEORDENI",16757,264,2,2260,1458,1122,336,1443,15,"LEORDENI",,5,,690,753
3,"Argeș",38,"38-LEORDENI",16757,265,2,1071,653,557,96,642,11,"LEORDENI",,5,,397,245
3,"Argeș",38,"38-LEORDENI",16757,266,2,1287,803,662,141,794,9,"LEORDENI",,5,,368,426
3,"Argeș",38,"38-LERESTI",16908,267,2,2591,1958,1732,226,1933,25,"LERESTI",,5,,1239,694
3,"Argeș",38,"38-LERESTI",16908,268,2,1476,1219,955,264,1215,4,"LERESTI",,5,,712,503
3,"Argeș",38,"38-LUNCA CORBULUI",16944,269,2,925,623,444,179,623,0,"LUNCA CORBULUI",,5,,437,186
3,"Argeș",38,"38-LUNCA CORBULUI",16944,270,2,273,190,115,75,189,1,"LUNCA CORBULUI",,5,,115,74
3,"Argeș",38,"38-LUNCA CORBULUI",16944,271,2,1145,653,484,169,649,4,"LUNCA CORBULUI",,5,,450,199
3,"Argeș",38,"38-LUNCA CORBULUI",16944,272,2,555,436,256,180,435,1,"LUNCA CORBULUI",,5,,325,110
3,"Argeș",38,"38-MALURENI",17049,273,2,582,423,333,90,413,10,"MALURENI",,5,,295,118
3,"Argeș",38,"38-MALURENI",17049,274,2,472,348,249,99,348,0,"MALURENI",,5,,245,103
3,"Argeș",38,"38-MALURENI",17049,275,2,370,257,173,84,254,3,"MALURENI",,5,,159,95
3,"Argeș",38,"38-MALURENI",17049,276,2,486,378,316,62,374,4,"MALURENI",,5,,287,87
3,"Argeș",38,"38-MALURENI",17049,277,2,731,551,400,151,545,6,"MALURENI",,5,,386,159
3,"Argeș",38,"38-MALURENI",17049,278,2,529,386,259,127,381,5,"MALURENI",,5,,220,161
3,"Argeș",38,"38-MALURENI",17049,279,2,397,243,193,50,241,2,"MALURENI",,5,,224,17
3,"Argeș",38,"38-MARACINENI",13365,280,2,1923,1441,1248,193,1431,10,"MARACINENI",,5,,813,618
3,"Argeș",38,"38-MARACINENI",13365,281,2,1077,840,693,147,835,5,"MARACINENI",,5,,520,315
3,"Argeș",38,"38-MERISANI",17101,282,2,817,631,435,196,623,8,"MERISANI",,5,,413,210
3,"Argeș",38,"38-MERISANI",17101,283,2,1297,780,578,202,774,6,"MERISANI",,5,,440,334
3,"Argeș",38,"38-MERISANI",17101,284,2,780,491,346,145,488,3,"MERISANI",,5,,294,194
3,"Argeș",38,"38-MICESTI",17209,285,2,1700,937,762,175,922,15,"MICESTI",,5,,644,278
3,"Argeș",38,"38-MICESTI",17209,286,2,1045,675,550,125,674,1,"MICESTI",,5,,470,204
3,"Argeș",38,"38-MIHAESTI",17254,287,2,1154,730,536,194,717,13,"MIHAESTI",,5,,489,228
3,"Argeș",38,"38-MIHAESTI",17254,288,2,886,695,468,227,685,10,"MIHAESTI",,5,,526,159
3,"Argeș",38,"38-MIHAESTI",17254,289,2,980,800,697,103,796,4,"MIHAESTI",,5,,563,233
3,"Argeș",38,"38-MIHAESTI",17254,290,2,1347,1154,948,206,1141,13,"MIHAESTI",,5,,838,303
3,"Argeș",38,"38-MIOARELE",15475,291,2,1111,664,584,80,661,3,"MIOARELE",,5,,458,203
3,"Argeș",38,"38-MIOARELE",15475,292,2,391,325,266,59,323,2,"MIOARELE",,5,,236,87
3,"Argeș",38,"38-MIROSI",17398,293,2,1561,1023,924,99,1021,2,"MIROSI",,5,,786,235
3,"Argeș",38,"38-MIROSI",17398,294,2,946,599,511,88,595,4,"MIROSI",,5,,406,189
3,"Argeș",38,"38-MORARESTI",17423,295,2,955,652,535,117,642,10,"MORARESTI",,5,,384,258
3,"Argeș",38,"38-MORARESTI",17423,296,2,787,521,432,89,519,2,"MORARESTI",,5,,363,156
3,"Argeș",38,"38-MOSOAIA",17496,297,2,1231,718,529,189,714,4,"MOSOAIA",,5,,386,328
3,"Argeș",38,"38-MOSOAIA",17496,298,2,1472,937,742,195,926,11,"MOSOAIA",,5,,512,414
3,"Argeș",38,"38-MUSATESTI",17619,299,2,483,351,268,83,347,4,"MUSATESTI",,5,,215,132
3,"Argeș",38,"38-MUSATESTI",17619,300,2,729,554,488,66,544,10,"MUSATESTI",,5,,436,108
3,"Argeș",38,"38-MUSATESTI",17619,301,2,1257,933,832,101,918,15,"MUSATESTI",,5,,570,348
3,"Argeș",38,"38-MUSATESTI",17619,302,2,910,620,531,89,610,10,"MUSATESTI",,5,,423,187
3,"Argeș",38,"38-MOZACENI",17575,303,2,1586,983,841,142,972,11,"MOZACENI",,5,,687,285
3,"Argeș",38,"38-MOZACENI",17575,304,2,713,534,417,117,525,9,"MOZACENI",,5,,320,205
3,"Argeș",38,"38-NEGRASI",17726,305,2,842,572,479,93,564,8,"NEGRASI",,5,,431,133
3,"Argeș",38,"38-NEGRASI",17726,306,2,366,274,216,58,267,7,"NEGRASI",,5,,203,64
3,"Argeș",38,"38-NEGRASI",17726,307,2,218,192,152,40,190,2,"NEGRASI",,5,,147,43
3,"Argeș",38,"38-NEGRASI",17726,308,2,934,608,458,150,603,5,"NEGRASI",,5,,421,182
3,"Argeș",38,"38-NUCSOARA",17771,309,2,1426,980,865,115,976,4,"NUCSOARA",,5,,756,220
3,"Argeș",38,"38-OARJA",17824,310,2,1500,1010,788,222,1005,5,"OARJA",,5,,647,358
3,"Argeș",38,"38-OARJA",17824,311,2,561,585,378,207,577,8,"OARJA",,5,,430,147
3,"Argeș",38,"38-PIETROSANI",17851,312,2,1573,1077,1005,72,1071,6,"PIETROSANI",,5,,859,212
3,"Argeș",38,"38-PIETROSANI",17851,313,2,1161,736,635,101,733,3,"PIETROSANI",,5,,545,188
3,"Argeș",38,"38-PIETROSANI",17851,314,2,1500,1065,1003,62,1058,7,"PIETROSANI",,5,,819,239
3,"Argeș",38,"38-PIETROSANI",17851,315,2,584,390,344,46,390,0,"PIETROSANI",,5,,286,104
3,"Argeș",38,"38-POIENARII DE ARGES",17913,316,2,959,668,616,52,662,6,"POIENARII DE ARGES",,5,,483,179
3,"Argeș",38,"38-POIENARII DE MUSCEL",17968,317,2,2079,1362,1247,115,1353,9,"POIENARII DE MUSCEL",,5,,862,491
3,"Argeș",38,"38-POIENARII DE MUSCEL",17968,318,2,1010,741,657,84,732,9,"POIENARII DE MUSCEL",,5,,512,220
3,"Argeș",38,"38-POIANA LACULUI",18028,319,2,1894,1260,928,332,1255,5,"POIANA LACULUI",,5,,673,582
3,"Argeș",38,"38-POIANA LACULUI",18028,320,2,1653,1065,785,280,1061,4,"POIANA LACULUI",,5,,682,379
3,"Argeș",38,"38-POIANA LACULUI",18028,321,2,1253,757,508,249,752,5,"POIANA LACULUI",,5,,437,315
3,"Argeș",38,"38-POPESTI",15723,322,2,696,612,479,133,606,6,"POPESTI",,5,,529,77
3,"Argeș",38,"38-POPESTI",15723,323,2,1190,926,670,256,919,7,"POPESTI",,5,,676,243
3,"Argeș",38,"38-POPESTI",15723,324,2,1611,1030,829,201,1023,7,"POPESTI",,5,,840,183
3,"Argeș",38,"38-PRIBOIENI",18242,325,2,2783,1978,1815,163,1959,19,"PRIBOIENI",,5,,1325,634
3,"Argeș",38,"38-RATESTI",18331,326,2,1610,1107,998,109,1101,6,"RATESTI",,5,,682,419
3,"Argeș",38,"38-RATESTI",18331,327,2,506,366,333,33,361,5,"RATESTI",,5,,232,129
3,"Argeș",38,"38-RATESTI",18331,328,2,723,508,443,65,499,9,"RATESTI",,5,,353,146
3,"Argeș",38,"38-RECEA",15297,329,2,1828,1301,1132,169,1289,12,"RECEA",,5,,901,388
3,"Argeș",38,"38-RECEA",15297,330,2,957,638,494,144,632,6,"RECEA",,5,,503,129
3,"Argeș",38,"38-ROCIU",18475,331,2,479,443,312,131,435,8,"ROCIU",,5,,346,89
3,"Argeș",38,"38-ROCIU",18475,332,2,505,482,345,137,479,3,"ROCIU",,5,,394,85
3,"Argeș",38,"38-ROCIU",18475,333,2,776,592,469,123,588,4,"ROCIU",,5,,459,129
3,"Argeș",38,"38-ROCIU",18475,334,2,912,654,537,117,650,4,"ROCIU",,5,,474,176
3,"Argeș",38,"38-RUCAR",18527,335,2,2489,1874,1605,269,1865,9,"RUCAR",,5,,1195,670
3,"Argeș",38,"38-RUCAR",18527,336,2,2111,1710,1357,353,1705,5,"RUCAR",,5,,1202,503
3,"Argeș",38,"38-RUCAR",18527,337,2,143,142,91,51,140,2,"RUCAR",,5,,101,39
3,"Argeș",38,"38-SALATRUCU",18554,338,2,1153,716,642,74,707,9,"SALATRUCU",,5,,499,208
3,"Argeș",38,"38-SALATRUCU",18554,339,2,455,370,278,92,365,5,"SALATRUCU",,5,,215,150
3,"Argeș",38,"38-SAPATA",18581,340,2,368,288,214,74,288,0,"SAPATA",,5,,191,97
3,"Argeș",38,"38-SAPATA",18581,341,2,776,537,446,91,532,5,"SAPATA",,5,,325,207
3,"Argeș",38,"38-SAPATA",18581,342,2,195,185,122,63,184,1,"SAPATA",,5,,126,58
3,"Argeș",38,"38-SAPATA",18581,343,2,289,276,189,87,273,3,"SAPATA",,5,,215,58
3,"Argeș",38,"38-SCHITU GOLESTI",18670,344,2,2201,1512,1409,103,1505,7,"SCHITU GOLESTI",,5,,1007,498
3,"Argeș",38,"38-SCHITU GOLESTI",18670,345,2,1480,1097,918,179,1084,13,"SCHITU GOLESTI",,5,,675,409
3,"Argeș",38,"38-SLOBOZIA",18233,346,2,2222,1094,915,179,1083,11,"SLOBOZIA",,5,,734,349
3,"Argeș",38,"38-SLOBOZIA",18233,347,2,1894,1117,889,228,1102,15,"SLOBOZIA",,5,,803,299
3,"Argeș",38,"38-STALPENI",18778,348,2,1428,1065,866,199,1058,7,"STALPENI",,5,,762,296
3,"Argeș",38,"38-STALPENI",18778,349,2,1106,864,753,111,859,5,"STALPENI",,5,,645,214
3,"Argeș",38,"38-STALPENI",18778,350,2,1362,984,843,141,977,7,"STALPENI",,5,,762,215
3,"Argeș",38,"38-STOENESTI",18858,351,2,1307,871,787,84,864,7,"STOENESTI",,5,,498,366
3,"Argeș",38,"38-STOENESTI",18858,352,2,1877,1249,1145,104,1242,7,"STOENESTI",,5,,844,398
3,"Argeș",38,"38-STOENESTI",18858,353,2,455,303,276,27,301,2,"STOENESTI",,5,,212,89
3,"Argeș",38,"38-SUSENI",14664,354,2,1186,931,756,175,925,6,"SUSENI",,5,,621,304
3,"Argeș",38,"38-SUSENI",14664,355,2,1571,1085,939,146,1081,4,"SUSENI",,5,,787,294
3,"Argeș",38,"38-STOLNICI",18938,356,2,1790,1121,867,254,1108,13,"STOLNICI",,5,,687,421
3,"Argeș",38,"38-STOLNICI",18938,357,2,1378,869,638,231,852,17,"STOLNICI",,5,,494,358
3,"Argeș",38,"38-STEFAN CEL MARE",19114,358,2,1850,1124,963,161,1110,14,"STEFAN CEL MARE",,5,,798,312
3,"Argeș",38,"38-STEFAN CEL MARE",19114,359,2,288,323,168,155,320,3,"STEFAN CEL MARE",,5,,256,64
3,"Argeș",38,"38-STEFANESTI",13409,360,2,1635,1115,722,393,1109,6,"STEFANESTI",,5,,557,552
3,"Argeș",38,"38-STEFANESTI",13409,361,2,2713,2101,961,1140,2085,16,"STEFANESTI",,5,,1057,1028
3,"Argeș",38,"38-STEFANESTI",13409,362,2,2564,1476,1102,374,1471,5,"STEFANESTI",,5,,781,690
3,"Argeș",38,"38-STEFANESTI",13409,363,2,1179,851,585,266,842,9,"STEFANESTI",,5,,437,405
3,"Argeș",38,"38-STEFANESTI",13409,364,2,472,290,193,97,287,3,"STEFANESTI",,5,,188,99
3,"Argeș",38,"38-SUICI",19141,365,2,1100,713,614,99,708,5,"SUICI",,5,,482,226
3,"Argeș",38,"38-SUICI",19141,366,2,664,494,414,80,489,5,"SUICI",,5,,337,152
3,"Argeș",38,"38-SUICI",19141,367,2,326,206,149,57,203,3,"SUICI",,5,,123,80
3,"Argeș",38,"38-SUICI",19141,368,2,113,99,66,33,99,0,"SUICI",,5,,63,36
3,"Argeș",38,"38-TEIU",19212,369,2,1652,1033,939,94,1021,12,"TEIU",,5,,659,362
3,"Argeș",38,"38-TIGVENI",18402,370,2,1070,803,659,144,788,15,"TIGVENI",,5,,586,202
3,"Argeș",38,"38-TIGVENI",18402,371,2,1028,748,612,136,741,7,"TIGVENI",,5,,560,181
3,"Argeș",38,"38-TIGVENI",18402,372,2,308,223,189,34,220,3,"TIGVENI",,5,,182,38
3,"Argeș",38,"38-TITESTI",19338,373,2,2372,1591,1404,187,1578,13,"TITESTI",,5,,1134,444
3,"Argeș",38,"38-TITESTI",19338,374,2,553,337,255,82,320,17,"TITESTI",,5,,182,138
3,"Argeș",38,"38-UDA",19392,375,2,544,382,254,128,381,1,"UDA",,5,,306,75
3,"Argeș",38,"38-UDA",19392,376,2,339,266,176,90,266,0,"UDA",,5,,192,74
3,"Argeș",38,"38-UDA",19392,377,2,835,518,342,176,516,2,"UDA",,5,,392,124
3,"Argeș",38,"38-UDA",19392,378,2,467,393,255,138,388,5,"UDA",,5,,304,84
3,"Argeș",38,"38-UNGHENI",19560,379,2,922,627,512,115,623,4,"UNGHENI",,5,,383,240
3,"Argeș",38,"38-UNGHENI",19560,380,2,880,583,448,135,575,8,"UNGHENI",,5,,424,151
3,"Argeș",38,"38-UNGHENI",19560,381,2,1598,1011,847,164,998,13,"UNGHENI",,5,,628,370
3,"Argeș",38,"38-VALEA DANULUI",19631,382,2,1522,991,902,89,980,11,"VALEA DANULUI",,5,,664,316
3,"Argeș",38,"38-VALEA DANULUI",19631,383,2,858,504,431,73,497,7,"VALEA DANULUI",,5,,339,158
3,"Argeș",38,"38-VALEA IASULUI",19695,384,2,1057,753,644,109,745,8,"VALEA IASULUI",,5,,493,252
3,"Argeș",38,"38-VALEA IASULUI",19695,385,2,1140,800,702,98,795,5,"VALEA IASULUI",,5,,546,249
3,"Argeș",38,"38-VALEA MARE PRAVAT",13524,386,2,1246,1022,833,189,1016,6,"VALEA MARE PRAVAT",,5,,599,417
3,"Argeș",38,"38-VALEA MARE PRAVAT",13524,387,2,967,840,708,132,825,15,"VALEA MARE PRAVAT",,5,,598,227
3,"Argeș",38,"38-VALEA MARE PRAVAT",13524,388,2,804,515,451,64,512,3,"VALEA MARE PRAVAT",,5,,295,217
3,"Argeș",38,"38-VEDEA",19793,389,2,1519,991,677,314,982,9,"VEDEA",,5,,673,309
3,"Argeș",38,"38-VEDEA",19793,390,2,1158,778,591,187,775,3,"VEDEA",,5,,582,193
3,"Argeș",38,"38-VEDEA",19793,391,2,758,484,325,159,480,4,"VEDEA",,5,,353,127
3,"Argeș",38,"38-VLADESTI",19329,392,2,763,550,482,68,544,6,"VLADESTI",,5,,413,131
3,"Argeș",38,"38-VLADESTI",19329,393,2,1632,1192,1055,137,1188,4,"VLADESTI",,5,,968,220
4,"Bacău",47,"47-MUNICIPIUL BACAU",20297,1,2,2143,1668,1525,143,1659,9,"MUNICIPIUL BACAU",,4,,723,936
4,"Bacău",47,"47-MUNICIPIUL BACAU",20297,2,2,2285,1851,1655,196,1844,6,"MUNICIPIUL BACAU",,4,,929,915
4,"Bacău",47,"47-MUNICIPIUL BACAU",20297,3,2,1893,1532,1396,136,1528,4,"MUNICIPIUL BACAU",,4,,562,966
4,"Bacău",47,"47-MUNICIPIUL BACAU",20297,4,2,2365,1818,1737,81,1810,8,"MUNICIPIUL BACAU",,4,,852,958
4,"Bacău",47,"47-MUNICIPIUL BACAU",20297,5,2,2266,1738,1598,140,1734,4,"MUNICIPIUL BACAU",,4,,708,1026
4,"Bacău",47,"47-MUNICIPIUL BACAU",20297,6,2,1941,1496,1405,91,1486,10,"MUNICIPIUL BACAU",,4,,614,872
4,"Bacău",47,"47-MUNICIPIUL BACAU",20297,7,2,2355,2041,1648,393,2020,21,"MUNICIPIUL BACAU",,4,,925,1095
4,"Bacău",47,"47-MUNICIPIUL BACAU",20297,8,2,2099,1746,1521,225,1722,24,"MUNICIPIUL BACAU",,4,,801,921
4,"Bacău",47,"47-MUNICIPIUL BACAU",20297,9,2,1990,1489,1352,137,1481,8,"MUNICIPIUL BACAU",,4,,573,908
4,"Bacău",47,"47-MUNICIPIUL BACAU",20297,10,2,2196,1621,1524,97,1604,13,"MUNICIPIUL BACAU",,4,,677,927
4,"Bacău",47,"47-MUNICIPIUL BACAU",20297,11,2,2047,1562,1429,133,1551,11,"MUNICIPIUL BACAU",,4,,660,891
4,"Bacău",47,"47-MUNICIPIUL BACAU",20297,12,2,2010,1438,1348,90,1432,6,"MUNICIPIUL BACAU",,4,,583,849
4,"Bacău",47,"47-MUNICIPIUL BACAU",20297,13,2,2140,1466,1381,85,1446,20,"MUNICIPIUL BACAU",,4,,473,973
4,"Bacău",47,"47-MUNICIPIUL BACAU",20297,14,2,2832,2140,1940,200,2126,14,"MUNICIPIUL BACAU",,4,,918,1208
4,"Bacău",47,"47-MUNICIPIUL BACAU",20297,15,2,2706,1900,1791,109,1893,7,"MUNICIPIUL BACAU",,4,,706,1187
4,"Bacău",47,"47-MUNICIPIUL BACAU",20297,16,2,2668,2019,1858,161,2010,9,"MUNICIPIUL BACAU",,4,,762,1248
4,"Bacău",47,"47-MUNICIPIUL BACAU",20297,17,2,2448,1955,1770,185,1939,16,"MUNICIPIUL BACAU",,4,,845,1094
4,"Bacău",47,"47-MUNICIPIUL BACAU",20297,18,2,2748,1971,1865,106,1960,11,"MUNICIPIUL BACAU",,4,,846,1114
4,"Bacău",47,"47-MUNICIPIUL BACAU",20297,19,2,2101,1547,1465,82,1539,8,"MUNICIPIUL BACAU",,4,,634,905
4,"Bacău",47,"47-MUNICIPIUL BACAU",20297,20,2,2206,1633,1513,120,1623,8,"MUNICIPIUL BACAU",,4,,745,878
4,"Bacău",47,"47-MUNICIPIUL BACAU",20297,21,2,2202,1680,1533,147,1670,10,"MUNICIPIUL BACAU",,4,,677,993
4,"Bacău",47,"47-MUNICIPIUL BACAU",20297,22,2,2647,2150,1893,257,2131,19,"MUNICIPIUL BACAU",,4,,733,1398
4,"Bacău",47,"47-MUNICIPIUL BACAU",20297,23,2,2347,1805,1594,211,1769,8,"MUNICIPIUL BACAU",,4,,647,1122
4,"Bacău",47,"47-MUNICIPIUL BACAU",20297,24,2,1778,1218,1159,59,1207,11,"MUNICIPIUL BACAU",,4,,399,808
4,"Bacău",47,"47-MUNICIPIUL BACAU",20297,25,2,1891,1393,1311,82,1383,10,"MUNICIPIUL BACAU",,4,,467,916
4,"Bacău",47,"47-MUNICIPIUL BACAU",20297,26,2,1192,874,817,57,870,4,"MUNICIPIUL BACAU",,4,,388,482
4,"Bacău",47,"47-MUNICIPIUL BACAU",20297,27,2,2409,1755,1593,162,1725,30,"MUNICIPIUL BACAU",,4,,858,867
4,"Bacău",47,"47-MUNICIPIUL BACAU",20297,28,2,2736,2091,1796,295,2062,29,"MUNICIPIUL BACAU",,4,,995,1067
4,"Bacău",47,"47-MUNICIPIUL BACAU",20297,29,2,2570,2252,1898,354,2241,11,"MUNICIPIUL BACAU",,4,,837,1404
4,"Bacău",47,"47-MUNICIPIUL BACAU",20297,30,2,2485,1989,1780,209,1980,9,"MUNICIPIUL BACAU",,4,,780,1200
4,"Bacău",47,"47-MUNICIPIUL BACAU",20297,31,2,2008,1662,1532,130,1656,6,"MUNICIPIUL BACAU",,4,,689,967
4,"Bacău",47,"47-MUNICIPIUL BACAU",20297,32,2,1991,1574,1499,75,1566,8,"MUNICIPIUL BACAU",,4,,654,912
4,"Bacău",47,"47-MUNICIPIUL BACAU",20297,33,2,2088,1597,1497,100,1589,8,"MUNICIPIUL BACAU",,4,,664,925
4,"Bacău",47,"47-MUNICIPIUL BACAU",20297,34,2,2373,1720,1633,87,1709,11,"MUNICIPIUL BACAU",,4,,682,1027
4,"Bacău",47,"47-MUNICIPIUL BACAU",20297,35,2,2341,1695,1556,139,1674,21,"MUNICIPIUL BACAU",,4,,737,937
4,"Bacău",47,"47-MUNICIPIUL BACAU",20297,36,2,1964,1586,1403,183,1568,18,"MUNICIPIUL BACAU",,4,,669,899
4,"Bacău",47,"47-MUNICIPIUL BACAU",20297,37,2,2473,1838,1711,127,1830,8,"MUNICIPIUL BACAU",,4,,794,1036
4,"Bacău",47,"47-MUNICIPIUL BACAU",20297,38,2,2178,1715,1445,270,1699,16,"MUNICIPIUL BACAU",,4,,738,961
4,"Bacău",47,"47-MUNICIPIUL BACAU",20297,39,2,2291,1714,1638,76,1709,5,"MUNICIPIUL BACAU",,4,,697,1012
4,"Bacău",47,"47-MUNICIPIUL BACAU",20297,40,2,2832,1994,1867,127,1984,10,"MUNICIPIUL BACAU",,4,,939,1045
4,"Bacău",47,"47-MUNICIPIUL BACAU",20297,41,2,2243,1694,1596,98,1685,9,"MUNICIPIUL BACAU",,4,,714,971
4,"Bacău",47,"47-MUNICIPIUL BACAU",20297,42,2,2504,1806,1678,128,1794,12,"MUNICIPIUL BACAU",,4,,744,1050
4,"Bacău",47,"47-MUNICIPIUL BACAU",20297,43,2,2397,1866,1654,212,1855,11,"MUNICIPIUL BACAU",,4,,866,989
4,"Bacău",47,"47-MUNICIPIUL BACAU",20297,44,2,2485,1904,1812,92,1900,4,"MUNICIPIUL BACAU",,4,,895,1005
4,"Bacău",47,"47-MUNICIPIUL BACAU",20297,45,2,2389,1832,1715,117,1824,8,"MUNICIPIUL BACAU",,4,,854,970
4,"Bacău",47,"47-MUNICIPIUL BACAU",20297,46,2,2398,1721,1600,121,1697,23,"MUNICIPIUL BACAU",,4,,753,944
4,"Bacău",47,"47-MUNICIPIUL BACAU",20297,47,2,2400,1605,1467,138,1601,4,"MUNICIPIUL BACAU",,4,,616,985
4,"Bacău",47,"47-MUNICIPIUL BACAU",20297,48,2,2470,1754,1661,93,1735,19,"MUNICIPIUL BACAU",,4,,796,939
4,"Bacău",47,"47-MUNICIPIUL BACAU",20297,49,2,1874,1618,1505,113,1609,9,"MUNICIPIUL BACAU",,4,,709,900
4,"Bacău",47,"47-MUNICIPIUL BACAU",20297,50,2,2139,1572,1471,101,1560,12,"MUNICIPIUL BACAU",,4,,729,831
4,"Bacău",47,"47-MUNICIPIUL BACAU",20297,51,2,1954,1475,1367,108,1466,9,"MUNICIPIUL BACAU",,4,,655,811
4,"Bacău",47,"47-MUNICIPIUL BACAU",20297,52,2,1911,1360,1196,164,1351,5,"MUNICIPIUL BACAU",,4,,532,819
4,"Bacău",47,"47-MUNICIPIUL BACAU",20297,53,2,2824,1948,1800,148,1934,14,"MUNICIPIUL BACAU",,4,,867,1067
4,"Bacău",47,"47-MUNICIPIUL BACAU",20297,54,2,2773,2007,1849,158,1992,15,"MUNICIPIUL BACAU",,4,,827,1165
4,"Bacău",47,"47-MUNICIPIUL BACAU",20297,55,2,2980,2174,2035,139,2162,12,"MUNICIPIUL BACAU",,4,,906,1256
4,"Bacău",47,"47-MUNICIPIUL BACAU",20297,56,2,2344,1716,1618,98,1701,15,"MUNICIPIUL BACAU",,4,,713,988
4,"Bacău",47,"47-MUNICIPIUL BACAU",20297,57,2,2530,1850,1731,119,1825,18,"MUNICIPIUL BACAU",,4,,805,1020
4,"Bacău",47,"47-MUNICIPIUL BACAU",20297,58,2,2645,1920,1777,143,1912,8,"MUNICIPIUL BACAU",,4,,731,1181
4,"Bacău",47,"47-MUNICIPIUL BACAU",20297,59,2,2216,1602,1475,127,1594,8,"MUNICIPIUL BACAU",,4,,634,960
4,"Bacău",47,"47-MUNICIPIUL BACAU",20297,60,2,2238,2041,1568,473,2036,5,"MUNICIPIUL BACAU",,4,,815,1221
4,"Bacău",47,"47-MUNICIPIUL BACAU",20297,61,2,2594,1887,1759,128,1879,8,"MUNICIPIUL BACAU",,4,,846,1033
4,"Bacău",47,"47-MUNICIPIUL BACAU",20297,62,2,2347,1849,1672,177,1829,20,"MUNICIPIUL BACAU",,4,,774,1055
4,"Bacău",47,"47-MUNICIPIUL BACAU",20297,63,2,2364,1767,1542,225,1756,11,"MUNICIPIUL BACAU",,4,,744,1012
4,"Bacău",47,"47-MUNICIPIUL BACAU",20297,64,2,2133,1673,1416,257,1664,9,"MUNICIPIUL BACAU",,4,,744,920
4,"Bacău",47,"47-MUNICIPIUL BACAU",20297,65,2,2376,1800,1685,115,1784,16,"MUNICIPIUL BACAU",,4,,807,977
4,"Bacău",47,"47-MUNICIPIUL BACAU",20297,66,2,0,947,0,947,941,6,"MUNICIPIUL BACAU",,4,,493,448
4,"Bacău",47,"47-MUNICIPIUL BACAU",20297,67,2,0,315,0,315,313,2,"MUNICIPIUL BACAU",,4,,97,216
4,"Bacău",47,"47-MUNICIPIUL BACAU",20297,68,2,0,363,0,363,361,2,"MUNICIPIUL BACAU",,4,,157,204
4,"Bacău",47,"47-MUNICIPIUL BACAU",20297,69,2,0,1449,0,1449,1429,20,"MUNICIPIUL BACAU",,4,,197,1232
4,"Bacău",47,"47-MUNICIPIUL BACAU",20297,70,2,0,509,0,509,496,13,"MUNICIPIUL BACAU",,4,,270,226
4,"Bacău",47,"47-MUNICIPIUL BACAU",20297,71,2,0,553,0,553,549,4,"MUNICIPIUL BACAU",,4,,277,272
4,"Bacău",47,"47-MUNICIPIUL ONESTI",20563,72,2,2523,1881,1740,141,1872,9,"MUNICIPIUL ONESTI",,4,,882,990
4,"Bacău",47,"47-MUNICIPIUL ONESTI",20563,73,2,2481,1785,1716,69,1769,16,"MUNICIPIUL ONESTI",,4,,950,819
4,"Bacău",47,"47-MUNICIPIUL ONESTI",20563,74,2,2397,1738,1644,94,1730,8,"MUNICIPIUL ONESTI",,4,,870,860
4,"Bacău",47,"47-MUNICIPIUL ONESTI",20563,75,2,2552,1745,1578,167,1727,14,"MUNICIPIUL ONESTI",,4,,828,899
4,"Bacău",47,"47-MUNICIPIUL ONESTI",20563,76,2,2856,1887,1794,93,1873,14,"MUNICIPIUL ONESTI",,4,,816,1057
4,"Bacău",47,"47-MUNICIPIUL ONESTI",20563,77,2,2381,1756,1573,183,1741,15,"MUNICIPIUL ONESTI",,4,,770,971
4,"Bacău",47,"47-MUNICIPIUL ONESTI",20563,78,2,2202,1642,1537,105,1637,5,"MUNICIPIUL ONESTI",,4,,635,1002
4,"Bacău",47,"47-MUNICIPIUL ONESTI",20563,79,2,2116,1702,1548,154,1696,6,"MUNICIPIUL ONESTI",,4,,739,957
4,"Bacău",47,"47-MUNICIPIUL ONESTI",20563,80,2,2159,1653,1528,125,1648,5,"MUNICIPIUL ONESTI",,4,,880,768
4,"Bacău",47,"47-MUNICIPIUL ONESTI",20563,81,2,1754,1299,1196,103,1289,10,"MUNICIPIUL ONESTI",,4,,639,650
4,"Bacău",47,"47-MUNICIPIUL ONESTI",20563,82,2,1866,1549,1425,124,1540,9,"MUNICIPIUL ONESTI",,4,,618,922
4,"Bacău",47,"47-MUNICIPIUL ONESTI",20563,83,2,2482,1802,1688,114,1788,14,"MUNICIPIUL ONESTI",,4,,909,879
4,"Bacău",47,"47-MUNICIPIUL ONESTI",20563,84,2,2524,1726,1599,127,1717,9,"MUNICIPIUL ONESTI",,4,,856,861
4,"Bacău",47,"47-MUNICIPIUL ONESTI",20563,85,2,2778,2232,1949,283,2220,12,"MUNICIPIUL ONESTI",,4,,891,1329
4,"Bacău",47,"47-MUNICIPIUL ONESTI",20563,86,2,2146,1778,1448,330,1772,6,"MUNICIPIUL ONESTI",,4,,805,967
4,"Bacău",47,"47-MUNICIPIUL ONESTI",20563,87,2,2226,1629,1519,110,1617,12,"MUNICIPIUL ONESTI",,4,,697,920
4,"Bacău",47,"47-MUNICIPIUL ONESTI",20563,88,2,1748,1363,1263,100,1353,10,"MUNICIPIUL ONESTI",,4,,621,732
4,"Bacău",47,"47-MUNICIPIUL ONESTI",20563,89,2,1442,1153,991,162,1148,5,"MUNICIPIUL ONESTI",,4,,473,675
4,"Bacău",47,"47-MUNICIPIUL ONESTI",20563,90,2,795,631,574,57,631,0,"MUNICIPIUL ONESTI",,4,,366,265
4,"Bacău",47,"47-MUNICIPIUL ONESTI",20563,91,2,488,509,354,155,507,2,"MUNICIPIUL ONESTI",,4,,259,248
4,"Bacău",47,"47-MUNICIPIUL ONESTI",20563,92,2,746,624,546,78,615,9,"MUNICIPIUL ONESTI",,4,,408,207
4,"Bacău",47,"47-MUNICIPIUL ONESTI",20563,93,2,2081,1581,1486,95,1558,23,"MUNICIPIUL ONESTI",,4,,743,815
4,"Bacău",47,"47-MUNICIPIUL ONESTI",20563,94,2,0,504,0,504,499,5,"MUNICIPIUL ONESTI",,4,,288,211
4,"Bacău",47,"47-ORAS BUHUSI",20778,95,2,2129,1514,1452,62,1506,8,"ORAS BUHUSI",,4,,819,687
4,"Bacău",47,"47-ORAS BUHUSI",20778,96,2,260,231,198,33,229,2,"ORAS BUHUSI",,4,,142,87
4,"Bacău",47,"47-ORAS BUHUSI",20778,97,2,2682,2053,1837,216,2036,17,"ORAS BUHUSI",,4,,1166,870
4,"Bacău",47,"47-ORAS BUHUSI",20778,98,2,2323,1643,1561,82,1625,18,"ORAS BUHUSI",,4,,917,708
4,"Bacău",47,"47-ORAS BUHUSI",20778,99,2,2803,2015,1951,64,2013,2,"ORAS BUHUSI",,4,,1123,890
4,"Bacău",47,"47-ORAS BUHUSI",20778,100,2,2607,1870,1712,158,1847,23,"ORAS BUHUSI",,4,,977,870
4,"Bacău",47,"47-ORAS BUHUSI",20778,101,2,2131,1451,1368,83,1438,13,"ORAS BUHUSI",,4,,867,571
4,"Bacău",47,"47-ORAS BUHUSI",20778,102,2,1593,1089,1050,39,1051,38,"ORAS BUHUSI",,4,,703,348
4,"Bacău",47,"47-ORAS COMANESTI",20821,103,2,1903,1472,1314,158,1458,14,"ORAS COMANESTI",,4,,826,632
4,"Bacău",47,"47-ORAS COMANESTI",20821,104,2,1446,1160,1016,144,1157,3,"ORAS COMANESTI",,4,,611,546
4,"Bacău",47,"47-ORAS COMANESTI",20821,105,2,1553,1246,1112,134,1235,11,"ORAS COMANESTI",,4,,623,612
4,"Bacău",47,"47-ORAS COMANESTI",20821,106,2,1461,1079,974,105,1075,4,"ORAS COMANESTI",,4,,517,558
4,"Bacău",47,"47-ORAS COMANESTI",20821,107,2,1116,874,769,105,871,3,"ORAS COMANESTI",,4,,371,500
4,"Bacău",47,"47-ORAS COMANESTI",20821,108,2,1659,1249,1184,65,1228,21,"ORAS COMANESTI",,4,,852,376
4,"Bacău",47,"47-ORAS COMANESTI",20821,109,2,1571,1249,1176,73,1238,11,"ORAS COMANESTI",,4,,928,310
4,"Bacău",47,"47-ORAS COMANESTI",20821,110,2,1248,1027,934,93,1017,10,"ORAS COMANESTI",,4,,705,312
4,"Bacău",47,"47-ORAS COMANESTI",20821,111,2,1094,841,783,58,823,18,"ORAS COMANESTI",,4,,519,304
4,"Bacău",47,"47-ORAS COMANESTI",20821,112,2,1077,817,735,82,813,4,"ORAS COMANESTI",,4,,526,287
4,"Bacău",47,"47-ORAS COMANESTI",20821,113,2,1373,1004,888,116,988,16,"ORAS COMANESTI",,4,,588,400
4,"Bacău",47,"47-ORAS COMANESTI",20821,114,2,968,742,685,57,730,12,"ORAS COMANESTI",,4,,456,274
4,"Bacău",47,"47-ORAS COMANESTI",20821,115,2,599,469,433,36,463,6,"ORAS COMANESTI",,4,,242,221
4,"Bacău",47,"47-ORAS COMANESTI",20821,116,2,1202,1108,887,221,1099,9,"ORAS COMANESTI",,4,,714,385
4,"Bacău",47,"47-ORAS DARMANESTI",22166,117,2,2058,1624,1458,166,1609,15,"ORAS DARMANESTI",,4,,1081,528
4,"Bacău",47,"47-ORAS DARMANESTI",22166,118,2,1219,1079,966,113,1068,11,"ORAS DARMANESTI",,4,,791,277
4,"Bacău",47,"47-ORAS DARMANESTI",22166,119,2,1759,1466,1325,141,1451,15,"ORAS DARMANESTI",,4,,975,476
4,"Bacău",47,"47-ORAS DARMANESTI",22166,120,2,2008,1555,1399,156,1525,30,"ORAS DARMANESTI",,4,,993,532
4,"Bacău",47,"47-ORAS DARMANESTI",22166,121,2,1015,912,860,52,899,13,"ORAS DARMANESTI",,4,,720,179
4,"Bacău",47,"47-ORAS DARMANESTI",22166,122,2,1160,944,845,99,934,10,"ORAS DARMANESTI",,4,,762,172
4,"Bacău",47,"47-ORAS DARMANESTI",22166,123,2,554,519,435,84,515,4,"ORAS DARMANESTI",,4,,345,170
4,"Bacău",47,"47-ORAS DARMANESTI",22166,124,2,278,230,215,15,227,3,"ORAS DARMANESTI",,4,,162,65
4,"Bacău",47,"47-ORAS MOINESTI",20876,125,2,1845,1422,1246,176,1413,9,"ORAS MOINESTI",,4,,688,725
4,"Bacău",47,"47-ORAS MOINESTI",20876,126,2,2386,1821,1563,258,1806,15,"ORAS MOINESTI",,4,,892,914
4,"Bacău",47,"47-ORAS MOINESTI",20876,127,2,1775,1392,1209,183,1378,14,"ORAS MOINESTI",,4,,742,636
4,"Bacău",47,"47-ORAS MOINESTI",20876,128,2,2539,1809,1632,177,1793,16,"ORAS MOINESTI",,4,,952,841
4,"Bacău",47,"47-ORAS MOINESTI",20876,129,2,2338,1657,1518,139,1638,19,"ORAS MOINESTI",,4,,851,787
4,"Bacău",47,"47-ORAS MOINESTI",20876,130,2,1364,1015,918,97,1005,10,"ORAS MOINESTI",,4,,624,381
4,"Bacău",47,"47-ORAS MOINESTI",20876,131,2,1048,914,740,174,909,5,"ORAS MOINESTI",,4,,479,430
4,"Bacău",47,"47-ORAS MOINESTI",20876,132,2,1467,1129,1022,107,1119,10,"ORAS MOINESTI",,4,,580,539
4,"Bacău",47,"47-ORAS MOINESTI",20876,133,2,947,747,665,82,733,14,"ORAS MOINESTI",,4,,397,336
4,"Bacău",47,"47-ORAS MOINESTI",20876,134,2,826,632,564,68,626,6,"ORAS MOINESTI",,4,,386,240
4,"Bacău",47,"47-ORAS MOINESTI",20876,135,2,1564,1207,1143,64,1194,13,"ORAS MOINESTI",,4,,905,289
4,"Bacău",47,"47-ORAS MOINESTI",20876,136,2,1073,875,791,84,861,14,"ORAS MOINESTI",,4,,634,227
4,"Bacău",47,"47-ORAS MOINESTI",20876,137,2,0,232,0,232,228,4,"ORAS MOINESTI",,4,,119,109
4,"Bacău",47,"47-ORAS SLANIC MOLDOVA",20910,138,2,1712,1529,1094,435,1524,5,"ORAS SLANIC MOLDOVA",,4,,797,727
4,"Bacău",47,"47-ORAS SLANIC MOLDOVA",20910,139,2,927,674,627,47,663,11,"ORAS SLANIC MOLDOVA",,4,,394,269
4,"Bacău",47,"47-ORAS SLANIC MOLDOVA",20910,140,2,1393,1050,988,62,1038,12,"ORAS SLANIC MOLDOVA",,4,,487,551
4,"Bacău",47,"47-ORAS TARGU OCNA",20965,141,2,1861,1588,1309,279,1573,15,"ORAS TARGU OCNA",,4,,871,702
4,"Bacău",47,"47-ORAS TARGU OCNA",20965,142,2,1710,1278,1197,81,1273,5,"ORAS TARGU OCNA",,4,,658,615
4,"Bacău",47,"47-ORAS TARGU OCNA",20965,143,2,2364,1799,1679,120,1795,4,"ORAS TARGU OCNA",,4,,923,872
4,"Bacău",47,"47-ORAS TARGU OCNA",20965,144,2,1673,1307,1211,96,1300,7,"ORAS TARGU OCNA",,4,,751,549
4,"Bacău",47,"47-ORAS TARGU OCNA",20965,145,2,1257,975,877,98,968,7,"ORAS TARGU OCNA",,4,,574,394
4,"Bacău",47,"47-ORAS TARGU OCNA",20965,146,2,732,596,529,67,593,3,"ORAS TARGU OCNA",,4,,312,281
4,"Bacău",47,"47-ORAS TARGU OCNA",20965,147,2,993,809,763,46,803,6,"ORAS TARGU OCNA",,4,,553,250
4,"Bacău",47,"47-ORAS TARGU OCNA",20965,148,2,0,171,0,171,169,2,"ORAS TARGU OCNA",,4,,32,137
4,"Bacău",47,"47-AGAS",21007,149,2,1851,1507,1222,285,1494,13,"AGAS",,4,,972,522
4,"Bacău",47,"47-AGAS",21007,150,2,987,807,652,155,800,7,"AGAS",,4,,557,243
4,"Bacău",47,"47-AGAS",21007,151,2,494,366,322,44,358,8,"AGAS",,4,,169,189
4,"Bacău",47,"47-AGAS",21007,152,2,1462,1134,962,172,1126,8,"AGAS",,4,,815,311
4,"Bacău",47,"47-ARDEOANI",21098,153,2,1285,879,807,72,871,8,"ARDEOANI",,4,,563,308
4,"Bacău",47,"47-ARDEOANI",21098,154,2,701,472,427,45,470,2,"ARDEOANI",,4,,290,180
4,"Bacău",47,"47-ASAU",21123,155,2,1835,1453,1336,117,1443,7,"ASAU",,4,,1122,321
4,"Bacău",47,"47-ASAU",21123,156,2,664,566,509,57,559,7,"ASAU",,4,,404,155
4,"Bacău",47,"47-ASAU",21123,157,2,1396,1030,935,95,1022,8,"ASAU",,4,,776,246
4,"Bacău",47,"47-ASAU",21123,158,2,1196,867,799,68,860,7,"ASAU",,4,,668,192
4,"Bacău",47,"47-ASAU",21123,159,2,455,461,394,67,461,0,"ASAU",,4,,360,101
4,"Bacău",47,"47-BALCANI",21196,160,2,1144,769,691,78,765,4,"BALCANI",,4,,416,349
4,"Bacău",47,"47-BALCANI",21196,161,2,2597,1680,1599,81,1661,19,"BALCANI",,4,,881,780
4,"Bacău",47,"47-BALCANI",21196,162,2,1559,944,886,58,940,4,"BALCANI",,4,,629,311
4,"Bacău",47,"47-BALCANI",21196,163,2,815,447,411,36,441,6,"BALCANI",,4,,252,189
4,"Bacău",47,"47-BERESTI-BISTRITA",21249,164,2,1523,1000,797,203,980,20,"BERESTI-BISTRITA",,4,,650,330
4,"Bacău",47,"47-BERESTI-BISTRITA",21249,165,2,838,640,491,149,635,5,"BERESTI-BISTRITA",,4,,441,194
4,"Bacău",47,"47-BERESTI-BISTRITA",21249,166,2,0,66,0,66,66,0,"BERESTI-BISTRITA",,4,,50,16
4,"Bacău",47,"47-BERESTI-TAZLAU",21338,167,2,1885,1098,988,110,1077,21,"BERESTI-TAZLAU",,4,,785,292
4,"Bacău",47,"47-BERESTI-TAZLAU",21338,168,2,986,693,612,81,688,5,"BERESTI-TAZLAU",,4,,516,172
4,"Bacău",47,"47-BERESTI-TAZLAU",21338,169,2,1248,926,751,175,908,18,"BERESTI-TAZLAU",,4,,601,307
4,"Bacău",47,"47-BERZUNTI",21418,170,2,2003,1371,1293,78,1354,17,"BERZUNTI",,4,,1000,354
4,"Bacău",47,"47-BERZUNTI",21418,171,2,1378,943,904,39,937,6,"BERZUNTI",,4,,703,234
4,"Bacău",47,"47-BERZUNTI",21418,172,2,388,310,267,43,309,1,"BERZUNTI",,4,,204,105
4,"Bacău",47,"47-BARSANESTI",21454,173,2,1391,996,872,124,991,5,"BARSANESTI",,4,,672,319
4,"Bacău",47,"47-BARSANESTI",21454,174,2,531,402,319,83,399,3,"BARSANESTI",,4,,261,138
4,"Bacău",47,"47-BARSANESTI",21454,175,2,1050,801,700,101,796,5,"BARSANESTI",,4,,586,210
4,"Bacău",47,"47-BARSANESTI",21454,176,2,1097,866,743,123,859,6,"BARSANESTI",,4,,541,318
4,"Bacău",47,"47-BLAGESTI",21506,177,2,1870,1270,1089,181,1256,14,"BLAGESTI",,4,,906,350
4,"Bacău",47,"47-BLAGESTI",21506,178,2,1554,1063,890,173,1055,8,"BLAGESTI",,4,,551,504
4,"Bacău",47,"47-BLAGESTI",21506,179,2,1060,824,622,202,815,9,"BLAGESTI",,4,,574,241
4,"Bacău",47,"47-BLAGESTI",21506,180,2,906,592,483,109,581,11,"BLAGESTI",,4,,384,197
4,"Bacău",47,"47-BOGDANESTI",21560,181,2,1649,1190,1102,88,1166,24,"BOGDANESTI",,4,,841,325
4,"Bacău",47,"47-BOGDANESTI",21560,182,2,395,381,320,61,375,6,"BOGDANESTI",,4,,253,122
4,"Bacău",47,"47-BRUSTUROASA",21597,183,2,1044,725,643,82,717,8,"BRUSTUROASA",,4,,474,243
4,"Bacău",47,"47-BRUSTUROASA",21597,184,2,1035,724,657,67,715,9,"BRUSTUROASA",,4,,431,284
4,"Bacău",47,"47-BRUSTUROASA",21597,185,2,676,512,430,82,505,7,"BRUSTUROASA",,4,,328,177
4,"Bacău",47,"47-BUHOCI",21668,186,2,1283,771,625,146,761,10,"BUHOCI",,4,,453,308
4,"Bacău",47,"47-BUHOCI",21668,187,2,1744,1043,876,167,1024,19,"BUHOCI",,4,,498,526
4,"Bacău",47,"47-BUHOCI",21668,188,2,556,385,300,85,376,9,"BUHOCI",,4,,210,166
4,"Bacău",47,"47-CASIN",21720,189,2,2003,1391,1253,138,1380,10,"CASIN",,4,,769,611
4,"Bacău",47,"47-CASIN",21720,190,2,709,566,525,41,556,10,"CASIN",,4,,370,186
4,"Bacău",47,"47-CAIUTI",21757,191,2,1309,977,775,202,970,7,"CAIUTI",,4,,652,318
4,"Bacău",47,"47-CAIUTI",21757,192,2,1172,865,756,109,853,12,"CAIUTI",,4,,616,237
4,"Bacău",47,"47-CAIUTI",21757,193,2,866,619,523,96,607,12,"CAIUTI",,4,,394,213
4,"Bacău",47,"47-CAIUTI",21757,194,2,567,454,417,37,453,1,"CAIUTI",,4,,260,193
4,"Bacău",47,"47-CLEJA",21855,195,2,2224,1513,1324,189,1465,48,"CLEJA",,4,,565,900
4,"Bacău",47,"47-CLEJA",21855,196,2,1444,1050,878,172,1020,30,"CLEJA",,4,,459,561
4,"Bacău",47,"47-CLEJA",21855,197,2,1266,722,683,39,674,48,"CLEJA",,4,,309,365
4,"Bacău",47,"47-COLONESTI",21891,198,2,1092,709,651,58,706,3,"COLONESTI",,4,,521,185
4,"Bacău",47,"47-COLONESTI",21891,199,2,569,352,309,43,346,6,"COLONESTI",,4,,263,83
4,"Bacău",47,"47-CORBASCA",21971,200,2,1063,748,635,113,743,5,"CORBASCA",,4,,558,185
4,"Bacău",47,"47-CORBASCA",21971,201,2,1115,680,595,85,668,12,"CORBASCA",,4,,505,163
4,"Bacău",47,"47-CORBASCA",21971,202,2,447,346,269,77,335,11,"CORBASCA",,4,,232,103
4,"Bacău",47,"47-CORBASCA",21971,203,2,1205,777,697,80,765,12,"CORBASCA",,4,,666,99
4,"Bacău",47,"47-COTOFANESTI",22059,204,2,1049,755,624,131,745,10,"COTOFANESTI",,4,,495,250
4,"Bacău",47,"47-COTOFANESTI",22059,205,2,1172,843,746,97,834,9,"COTOFANESTI",,4,,498,336
4,"Bacău",47,"47-DAMIENESTI",22111,206,2,827,577,486,91,566,11,"DAMIENESTI",,4,,394,172
4,"Bacău",47,"47-DAMIENESTI",22111,207,2,841,574,518,56,572,2,"DAMIENESTI",,4,,464,108
4,"Bacău",47,"47-DEALU MORII",22237,208,2,912,649,567,82,636,13,"DEALU MORII",,4,,438,198
4,"Bacău",47,"47-DEALU MORII",22237,209,2,379,305,240,65,298,7,"DEALU MORII",,4,,189,109
4,"Bacău",47,"47-DEALU MORII",22237,210,2,607,442,372,70,435,7,"DEALU MORII",,4,,320,115
4,"Bacău",47,"47-DEALU MORII",22237,211,2,587,403,353,50,393,10,"DEALU MORII",,4,,238,155
4,"Bacău",47,"47-DOFTEANA",22380,212,2,2391,1701,1656,45,1686,15,"DOFTEANA",,4,,980,706
4,"Bacău",47,"47-DOFTEANA",22380,213,2,1786,1350,1307,43,1331,19,"DOFTEANA",,4,,957,374
4,"Bacău",47,"47-DOFTEANA",22380,214,2,589,502,432,70,494,8,"DOFTEANA",,4,,358,136
4,"Bacău",47,"47-DOFTEANA",22380,215,2,1578,1281,1190,91,1266,15,"DOFTEANA",,4,,739,527
4,"Bacău",47,"47-DOFTEANA",22380,216,2,907,706,646,60,697,9,"DOFTEANA",,4,,431,266
4,"Bacău",47,"47-FARAOANI",22460,217,2,2377,1476,1371,105,1443,33,"FARAOANI",,4,,405,1038
4,"Bacău",47,"47-FARAOANI",22460,218,2,1886,1342,1176,166,1316,26,"FARAOANI",,4,,403,913
4,"Bacău",47,"47-FILIPENI",22488,219,2,780,606,543,63,599,7,"FILIPENI",,4,,449,150
4,"Bacău",47,"47-FILIPENI",22488,220,2,710,557,449,108,548,6,"FILIPENI",,4,,352,196
4,"Bacău",47,"47-FILIPENI",22488,221,2,632,445,365,80,440,5,"FILIPENI",,4,,308,132
4,"Bacău",47,"47-FILIPESTI",21588,222,2,777,553,374,179,550,3,"FILIPESTI",,4,,308,242
4,"Bacău",47,"47-FILIPESTI",21588,223,2,715,568,437,131,562,6,"FILIPESTI",,4,,360,202
4,"Bacău",47,"47-FILIPESTI",21588,224,2,970,667,579,88,663,4,"FILIPESTI",,4,,377,286
4,"Bacău",47,"47-FILIPESTI",21588,225,2,707,458,364,94,454,3,"FILIPESTI",,4,,316,138
4,"Bacău",47,"47-FILIPESTI",21588,226,2,452,373,273,100,368,5,"FILIPESTI",,4,,259,109
4,"Bacău",47,"47-GAICEANA",22665,227,2,925,535,430,105,521,14,"GAICEANA",,4,,353,168
4,"Bacău",47,"47-GAICEANA",22665,228,2,991,593,544,49,579,14,"GAICEANA",,4,,402,177
4,"Bacău",47,"47-GAICEANA",22665,229,2,536,389,305,84,379,10,"GAICEANA",,4,,284,95
4,"Bacău",47,"47-GHIMES-FAGET",22718,230,2,792,731,604,127,723,8,"GHIMES-FAGET",,4,,87,636
4,"Bacău",47,"47-GHIMES-FAGET",22718,231,2,2031,1232,1073,159,1214,18,"GHIMES-FAGET",,4,,183,1031
4,"Bacău",47,"47-GHIMES-FAGET",22718,232,2,752,555,510,45,551,4,"GHIMES-FAGET",,4,,278,273
4,"Bacău",47,"47-GHIMES-FAGET",22718,233,2,240,213,188,25,212,1,"GHIMES-FAGET",,4,,141,71
4,"Bacău",47,"47-GARLENI",22781,234,2,1068,664,535,129,658,6,"GARLENI",,4,,277,381
4,"Bacău",47,"47-GARLENI",22781,235,2,1906,1256,1023,233,1234,19,"GARLENI",,4,,553,681
4,"Bacău",47,"47-GARLENI",22781,236,2,1356,924,762,162,912,12,"GARLENI",,4,,365,547
4,"Bacău",47,"47-GLAVANESTI",22834,237,2,1808,1120,993,127,1102,18,"GLAVANESTI",,4,,862,240
4,"Bacău",47,"47-GLAVANESTI",22834,238,2,1544,967,864,103,946,21,"GLAVANESTI",,4,,670,276
4,"Bacău",47,"47-GURA VAII",20607,239,2,2014,1478,1356,122,1446,32,"GURA VAII",,4,,950,496
4,"Bacău",47,"47-GURA VAII",20607,240,2,940,567,538,29,560,6,"GURA VAII",,4,,290,270
4,"Bacău",47,"47-GURA VAII",20607,241,2,1276,893,828,65,878,15,"GURA VAII",,4,,503,375
4,"Bacău",47,"47-HELEGIU",22898,242,2,756,648,406,242,644,4,"HELEGIU",,4,,430,214
4,"Bacău",47,"47-HELEGIU",22898,243,2,1565,965,763,202,932,33,"HELEGIU",,4,,643,289
4,"Bacău",47,"47-HELEGIU",22898,244,2,1801,1163,971,192,1142,21,"HELEGIU",,4,,767,375
4,"Bacău",47,"47-HELEGIU",22898,245,2,660,656,494,162,646,10,"HELEGIU",,4,,438,208
4,"Bacău",47,"47-HELEGIU",22898,246,2,972,640,497,143,634,6,"HELEGIU",,4,,426,208
4,"Bacău",47,"47-HEMEIUS",20313,247,2,1111,794,647,147,789,5,"HEMEIUS",,4,,358,431
4,"Bacău",47,"47-HEMEIUS",20313,248,2,1300,872,750,122,857,15,"HEMEIUS",,4,,359,498
4,"Bacău",47,"47-HEMEIUS",20313,249,2,0,151,0,151,147,4,"HEMEIUS",,4,,83,64
4,"Bacău",47,"47-HORGESTI",22941,250,2,1561,958,862,96,934,21,"HORGESTI",,4,,473,461
4,"Bacău",47,"47-HORGESTI",22941,251,2,989,657,562,95,646,11,"HORGESTI",,4,,447,199
4,"Bacău",47,"47-HORGESTI",22941,252,2,757,521,393,128,516,5,"HORGESTI",,4,,362,154
4,"Bacău",47,"47-HURUIESTI",23047,253,2,1183,726,583,143,716,10,"HURUIESTI",,4,,562,154
4,"Bacău",47,"47-HURUIESTI",23047,254,2,383,334,247,87,331,3,"HURUIESTI",,4,,224,107
4,"Bacău",47,"47-HURUIESTI",23047,255,2,515,371,302,69,366,5,"HURUIESTI",,4,,261,105
4,"Bacău",47,"47-HURUIESTI",23047,256,2,226,182,137,45,180,2,"HURUIESTI",,4,,134,46
4,"Bacău",47,"47-IZVORU BERHECIULUI",23127,257,2,1269,802,678,124,788,14,"IZVORU BERHECIULUI",,4,,567,221
4,"Bacău",47,"47-LETEA VECHE",20359,258,2,1265,872,694,178,854,18,"LETEA VECHE",,4,,471,383
4,"Bacău",47,"47-LETEA VECHE",20359,259,2,1011,778,645,133,763,15,"LETEA VECHE",,4,,424,339
4,"Bacău",47,"47-LETEA VECHE",20359,260,2,643,480,349,131,465,15,"LETEA VECHE",,4,,239,226
4,"Bacău",47,"47-LIPOVA",23207,261,2,624,455,368,87,444,11,"LIPOVA",,4,,309,135
4,"Bacău",47,"47-LIPOVA",23207,262,2,577,401,343,58,394,7,"LIPOVA",,4,,262,132
4,"Bacău",47,"47-LIPOVA",23207,263,2,871,523,439,84,515,8,"LIPOVA",,4,,405,110
4,"Bacău",47,"47-LIVEZI",23289,264,2,830,533,427,106,528,5,"LIVEZI",,4,,351,177
4,"Bacău",47,"47-LIVEZI",23289,265,2,789,673,577,96,663,10,"LIVEZI",,4,,494,169
4,"Bacău",47,"47-LIVEZI",23289,266,2,600,565,428,137,558,7,"LIVEZI",,4,,417,141
4,"Bacău",47,"47-LIVEZI",23289,267,2,395,341,277,64,332,9,"LIVEZI",,4,,225,107
4,"Bacău",47,"47-LIVEZI",23289,268,2,702,551,462,89,544,7,"LIVEZI",,4,,352,192
4,"Bacău",47,"47-LIVEZI",23289,269,2,639,532,402,130,522,10,"LIVEZI",,4,,413,109
4,"Bacău",47,"47-LUIZI-CALUGARA",23350,270,2,2634,1716,1483,233,1665,51,"LUIZI-CALUGARA",,4,,580,1085
4,"Bacău",47,"47-LUIZI-CALUGARA",23350,271,2,1382,1064,993,71,1042,22,"LUIZI-CALUGARA",,4,,414,628
4,"Bacău",47,"47-MAGIRESTI",23387,272,2,1877,1418,1229,189,1394,24,"MAGIRESTI",,4,,944,450
4,"Bacău",47,"47-MAGIRESTI",23387,273,2,1474,1042,821,221,1021,21,"MAGIRESTI",,4,,652,369
4,"Bacău",47,"47-MAGURA",20411,274,2,2082,1442,1325,117,1423,19,"MAGURA",,4,,576,847
4,"Bacău",47,"47-MAGURA",20411,275,2,661,488,437,51,482,6,"MAGURA",,4,,155,327
4,"Bacău",47,"47-MANASTIREA CASIN",23449,276,2,2016,1472,1220,252,1462,10,"MANASTIREA CASIN",,4,,1104,358
4,"Bacău",47,"47-MANASTIREA CASIN",23449,277,2,1642,1179,970,209,1166,13,"MANASTIREA CASIN",,4,,937,229
4,"Bacău",47,"47-MANASTIREA CASIN",23449,278,2,547,448,337,111,444,4,"MANASTIREA CASIN",,4,,306,138
4,"Bacău",47,"47-MARGINENI",20466,279,2,2270,1545,1217,328,1521,24,"MARGINENI",,4,,407,1114
4,"Bacău",47,"47-MARGINENI",20466,280,2,1060,872,662,210,858,14,"MARGINENI",,4,,320,538
4,"Bacău",47,"47-MARGINENI",20466,281,2,1040,814,635,179,807,7,"MARGINENI",,4,,231,576
4,"Bacău",47,"47-MARGINENI",20466,282,2,941,769,589,180,756,13,"MARGINENI",,4,,398,358
4,"Bacău",47,"47-MOTOSENI",23494,283,2,1059,660,455,205,643,17,"MOTOSENI",,4,,515,128
4,"Bacău",47,"47-MOTOSENI",23494,284,2,606,396,327,69,389,7,"MOTOSENI",,4,,307,82
4,"Bacău",47,"47-MOTOSENI",23494,285,2,767,491,359,132,477,14,"MOTOSENI",,4,,393,84
4,"Bacău",47,"47-MOTOSENI",23494,286,2,598,482,297,185,471,11,"MOTOSENI",,4,,346,125
4,"Bacău",47,"47-MOTOSENI",23494,287,2,410,301,218,83,297,2,"MOTOSENI",,4,,216,81
4,"Bacău",47,"47-NICOLAE BALCESCU",23715,288,2,2679,1827,1606,221,1802,25,"NICOLAE BALCESCU",,4,,602,1200
4,"Bacău",47,"47-NICOLAE BALCESCU",23715,289,2,2038,1191,860,331,1164,27,"NICOLAE BALCESCU",,4,,365,799
4,"Bacău",47,"47-NICOLAE BALCESCU",23715,290,2,468,413,125,288,395,18,"NICOLAE BALCESCU",,4,,214,181
4,"Bacău",47,"47-NICOLAE BALCESCU",23715,291,2,1512,883,725,158,865,18,"NICOLAE BALCESCU",,4,,458,407
4,"Bacău",47,"47-NICOLAE BALCESCU",23715,292,2,1033,710,623,87,697,13,"NICOLAE BALCESCU",,4,,120,577
4,"Bacău",47,"47-NEGRI",23644,293,2,1201,805,683,122,795,10,"NEGRI",,4,,593,202
4,"Bacău",47,"47-NEGRI",23644,294,2,1348,807,737,70,782,25,"NEGRI",,4,,480,302
4,"Bacău",47,"47-OITUZ",23797,295,2,1766,1355,1217,138,1338,16,"OITUZ",,4,,991,347
4,"Bacău",47,"47-OITUZ",23797,296,2,1674,1168,1026,142,1155,13,"OITUZ",,4,,850,305
4,"Bacău",47,"47-OITUZ",23797,297,2,1439,915,842,73,905,10,"OITUZ",,4,,626,279
4,"Bacău",47,"47-OITUZ",23797,298,2,1119,743,695,48,733,10,"OITUZ",,4,,528,205
4,"Bacău",47,"47-OITUZ",23797,299,2,768,629,578,51,621,8,"OITUZ",,4,,405,216
4,"Bacău",47,"47-OITUZ",23797,300,2,351,380,301,79,378,2,"OITUZ",,4,,244,134
4,"Bacău",47,"47-OITUZ",23797,301,2,255,284,211,73,280,4,"OITUZ",,4,,171,109
4,"Bacău",47,"47-ONCESTI",23868,302,2,801,600,489,111,587,13,"ONCESTI",,4,,395,192
4,"Bacău",47,"47-ONCESTI",23868,303,2,522,400,358,42,396,4,"ONCESTI",,4,,322,74
4,"Bacău",47,"47-ORBENI",23948,304,2,1742,1068,987,81,1046,22,"ORBENI",,4,,629,417
4,"Bacău",47,"47-ORBENI",23948,305,2,1360,916,806,110,888,28,"ORBENI",,4,,591,297
4,"Bacău",47,"47-PALANCA",23975,306,2,1210,1099,882,217,1091,8,"PALANCA",,4,,903,188
4,"Bacău",47,"47-PALANCA",23975,307,2,1602,1191,1126,65,1176,15,"PALANCA",,4,,990,186
4,"Bacău",47,"47-PALANCA",23975,308,2,128,127,84,43,126,1,"PALANCA",,4,,67,59
4,"Bacău",47,"47-PARAVA",24034,309,2,880,626,520,106,614,12,"PARAVA",,4,,271,343
4,"Bacău",47,"47-PARAVA",24034,310,2,788,487,434,53,479,8,"PARAVA",,4,,265,214
4,"Bacău",47,"47-PARAVA",24034,311,2,627,335,282,53,330,5,"PARAVA",,4,,162,168
4,"Bacău",47,"47-PARINCEA",24089,312,2,692,470,388,82,466,4,"PARINCEA",,4,,242,224
4,"Bacău",47,"47-PARINCEA",24089,313,2,702,492,418,74,485,7,"PARINCEA",,4,,321,164
4,"Bacău",47,"47-PARINCEA",24089,314,2,795,493,442,51,487,6,"PARINCEA",,4,,386,101
4,"Bacău",47,"47-PARINCEA",24089,315,2,670,437,368,69,432,5,"PARINCEA",,4,,315,117
4,"Bacău",47,"47-PARINCEA",24089,316,2,223,189,143,46,180,9,"PARINCEA",,4,,126,54
4,"Bacău",47,"47-PARGARESTI",24276,317,2,1181,938,795,143,925,13,"PARGARESTI",,4,,562,363
4,"Bacău",47,"47-PARGARESTI",24276,318,2,1408,822,667,155,806,16,"PARGARESTI",,4,,390,416
4,"Bacău",47,"47-PARGARESTI",24276,319,2,916,692,598,94,674,18,"PARGARESTI",,4,,398,276
4,"Bacău",47,"47-PANCESTI",24187,320,2,2077,1210,1050,160,1183,25,"PANCESTI",,4,,734,449
4,"Bacău",47,"47-PANCESTI",24187,321,2,1311,862,732,130,851,11,"PANCESTI",,4,,539,312
4,"Bacău",47,"47-PARJOL",24338,322,2,886,690,508,182,687,3,"PARJOL",,4,,439,248
4,"Bacău",47,"47-PARJOL",24338,323,2,725,556,379,177,545,11,"PARJOL",,4,,319,226
4,"Bacău",47,"47-PARJOL",24338,324,2,684,473,428,45,471,2,"PARJOL",,4,,352,119
4,"Bacău",47,"47-PARJOL",24338,325,2,1556,1142,1021,121,1125,15,"PARJOL",,4,,462,663
4,"Bacău",47,"47-PARJOL",24338,326,2,805,642,556,86,631,11,"PARJOL",,4,,430,201
4,"Bacău",47,"47-PARJOL",24338,327,2,725,458,382,76,454,4,"PARJOL",,4,,364,90
4,"Bacău",47,"47-PLOPANA",24427,328,2,1367,816,673,143,806,10,"PLOPANA",,4,,540,266
4,"Bacău",47,"47-PLOPANA",24427,329,2,1371,864,730,134,846,18,"PLOPANA",,4,,631,215
4,"Bacău",47,"47-PODU TURCULUI",24524,330,2,2154,1642,1376,266,1625,17,"PODU TURCULUI",,4,,1100,525
4,"Bacău",47,"47-PODU TURCULUI",24524,331,2,940,640,514,126,624,16,"PODU TURCULUI",,4,,359,265
4,"Bacău",47,"47-PODU TURCULUI",24524,332,2,605,426,351,75,413,13,"PODU TURCULUI",,4,,259,154
4,"Bacău",47,"47-PODU TURCULUI",24524,333,2,426,348,293,55,341,7,"PODU TURCULUI",,4,,213,128
4,"Bacău",47,"47-PODURI",24631,334,2,1812,1253,975,278,1246,7,"PODURI",,4,,820,426
4,"Bacău",47,"47-PODURI",24631,335,2,831,666,399,267,664,2,"PODURI",,4,,418,246
4,"Bacău",47,"47-PODURI",24631,336,2,710,789,442,347,780,9,"PODURI",,4,,572,208
4,"Bacău",47,"47-PODURI",24631,337,2,1285,951,740,211,937,13,"PODURI",,4,,659,278
4,"Bacău",47,"47-PODURI",24631,338,2,947,969,905,64,965,4,"PODURI",,4,,771,194
4,"Bacău",47,"47-RACOVA",24711,339,2,1596,1206,1005,201,1199,7,"RACOVA",,4,,806,393
4,"Bacău",47,"47-RACOVA",24711,340,2,914,717,544,173,711,6,"RACOVA",,4,,512,199
4,"Bacău",47,"47-RACACIUNI",24766,341,2,2068,1451,1163,288,1430,21,"RACACIUNI",,4,,649,781
4,"Bacău",47,"47-RACACIUNI",24766,342,2,767,543,442,101,528,15,"RACACIUNI",,4,,211,317
4,"Bacău",47,"47-RACACIUNI",24766,343,2,544,396,307,89,386,10,"RACACIUNI",,4,,185,201
4,"Bacău",47,"47-RACACIUNI",24766,344,2,1675,1054,878,176,1029,25,"RACACIUNI",,4,,589,440
4,"Bacău",47,"47-RACHITOASA",24837,345,2,1599,897,778,119,886,11,"RACHITOASA",,4,,588,298
4,"Bacău",47,"47-RACHITOASA",24837,346,2,505,312,267,45,306,6,"RACHITOASA",,4,,234,72
4,"Bacău",47,"47-RACHITOASA",24837,347,2,715,542,399,143,537,5,"RACHITOASA",,4,,370,167
4,"Bacău",47,"47-RACHITOASA",24837,348,2,954,646,514,132,633,13,"RACHITOASA",,4,,489,144
4,"Bacău",47,"47-ROSIORI",24999,349,2,855,593,488,105,591,2,"ROSIORI",,4,,441,150
4,"Bacău",47,"47-ROSIORI",24999,350,2,288,243,194,49,243,0,"ROSIORI",,4,,183,60
4,"Bacău",47,"47-ROSIORI",24999,351,2,387,292,225,67,286,6,"ROSIORI",,4,,205,81
4,"Bacău",47,"47-SASCUT",25068,352,2,2003,1646,1142,504,1629,16,"SASCUT",,4,,740,889
4,"Bacău",47,"47-SASCUT",25068,353,2,1131,885,709,176,867,18,"SASCUT",,4,,269,598
4,"Bacău",47,"47-SASCUT",25068,354,2,440,449,277,172,444,5,"SASCUT",,4,,315,129
4,"Bacău",47,"47-SASCUT",25068,355,2,965,846,592,254,833,13,"SASCUT",,4,,398,435
4,"Bacău",47,"47-SASCUT",25068,356,2,1606,830,683,147,811,19,"SASCUT",,4,,424,387
4,"Bacău",47,"47-SASCUT",25068,357,2,2061,1457,1213,244,1430,27,"SASCUT",,4,,725,705
4,"Bacău",47,"47-SANDULENI",25148,358,2,1329,947,801,146,934,13,"SANDULENI",,4,,742,192
4,"Bacău",47,"47-SANDULENI",25148,359,2,699,544,479,65,538,6,"SANDULENI",,4,,433,105
4,"Bacău",47,"47-SANDULENI",25148,360,2,839,575,487,88,562,13,"SANDULENI",,4,,329,233
4,"Bacău",47,"47-SANDULENI",25148,361,2,276,237,186,51,234,3,"SANDULENI",,4,,137,97
4,"Bacău",47,"47-SAUCESTI",25228,362,2,1876,1276,1063,213,1252,24,"SAUCESTI",,4,,682,570
4,"Bacău",47,"47-SAUCESTI",25228,363,2,778,586,396,190,572,14,"SAUCESTI",,4,,354,218
4,"Bacău",47,"47-SCORTENI",25291,364,2,1662,1173,1041,132,1164,9,"SCORTENI",,4,,717,447
4,"Bacău",47,"47-SCORTENI",25291,365,2,805,645,552,93,640,5,"SCORTENI",,4,,380,260
4,"Bacău",47,"47-SECUIENI",25362,366,2,950,602,480,122,585,17,"SECUIENI",,4,,384,201
4,"Bacău",47,"47-SECUIENI",25362,367,2,469,334,234,100,331,3,"SECUIENI",,4,,222,109
4,"Bacău",47,"47-SECUIENI",25362,368,2,1166,776,644,132,763,13,"SECUIENI",,4,,580,183
4,"Bacău",47,"47-SECUIENI",25362,369,2,613,408,318,90,397,11,"SECUIENI",,4,,278,119
4,"Bacău",47,"47-SOLONT",25488,370,2,1263,1029,865,164,1009,20,"SOLONT",,4,,767,242
4,"Bacău",47,"47-SOLONT",25488,371,2,687,501,442,59,493,8,"SOLONT",,4,,344,149
4,"Bacău",47,"47-SOLONT",25488,372,2,1088,826,709,117,818,8,"SOLONT",,4,,533,285
4,"Bacău",47,"47-STANISESTI",25521,373,2,963,565,449,116,552,13,"STANISESTI",,4,,399,153
4,"Bacău",47,"47-STANISESTI",25521,374,2,420,342,287,55,342,0,"STANISESTI",,4,,187,155
4,"Bacău",47,"47-STANISESTI",25521,375,2,455,280,235,45,278,2,"STANISESTI",,4,,177,101
4,"Bacău",47,"47-STANISESTI",25521,376,2,1306,828,701,127,806,22,"STANISESTI",,4,,596,210
4,"Bacău",47,"47-STANISESTI",25521,377,2,406,277,215,62,271,6,"STANISESTI",,4,,187,84
4,"Bacău",47,"47-STRUGARI",25629,378,2,1139,794,705,89,785,9,"STRUGARI",,4,,540,245
4,"Bacău",47,"47-STRUGARI",25629,379,2,397,277,253,24,272,5,"STRUGARI",,4,,195,77
4,"Bacău",47,"47-STRUGARI",25629,380,2,601,475,388,87,467,8,"STRUGARI",,4,,376,91
4,"Bacău",47,"47-STEFAN CEL MARE",20670,381,2,801,501,362,139,497,4,"STEFAN CEL MARE",,4,,245,252
4,"Bacău",47,"47-STEFAN CEL MARE",20670,382,2,447,385,244,141,382,3,"STEFAN CEL MARE",,4,,190,192
4,"Bacău",47,"47-STEFAN CEL MARE",20670,383,2,457,392,264,128,390,2,"STEFAN CEL MARE",,4,,222,168
4,"Bacău",47,"47-STEFAN CEL MARE",20670,384,2,629,526,383,143,522,3,"STEFAN CEL MARE",,4,,210,312
4,"Bacău",47,"47-STEFAN CEL MARE",20670,385,2,462,469,338,131,468,1,"STEFAN CEL MARE",,4,,313,155
4,"Bacău",47,"47-STEFAN CEL MARE",20670,386,2,477,354,264,90,351,3,"STEFAN CEL MARE",,4,,225,126
4,"Bacău",47,"47-STEFAN CEL MARE",20670,387,2,766,652,494,158,644,8,"STEFAN CEL MARE",,4,,464,180
4,"Bacău",47,"47-STEFAN CEL MARE",20670,388,2,1129,899,717,182,885,14,"STEFAN CEL MARE",,4,,458,427
4,"Bacău",47,"47-TAMASI",25692,389,2,1978,1397,1230,167,1363,34,"TAMASI",,4,,940,423
4,"Bacău",47,"47-TAMASI",25692,390,2,2312,1576,1369,207,1557,19,"TAMASI",,4,,845,712
4,"Bacău",47,"47-TATARASTI",25745,391,2,639,518,450,68,509,9,"TATARASTI",,4,,367,142
4,"Bacău",47,"47-TATARASTI",25745,392,2,822,640,577,63,631,9,"TATARASTI",,4,,473,158
4,"Bacău",47,"47-TATARASTI",25745,393,2,689,570,497,73,553,17,"TATARASTI",,4,,381,172
4,"Bacău",47,"47-TARGU TROTUS",25825,394,2,1521,1201,1052,149,1196,5,"TARGU TROTUS",,4,,783,413
4,"Bacău",47,"47-TARGU TROTUS",25825,395,2,1419,1020,963,57,1005,14,"TARGU TROTUS",,4,,537,468
4,"Bacău",47,"47-TARGU TROTUS",25825,396,2,896,793,674,119,782,11,"TARGU TROTUS",,4,,404,378
4,"Bacău",47,"47-TRAIAN",25861,397,2,1694,1064,813,251,1046,18,"TRAIAN",,4,,506,540
4,"Bacău",47,"47-TRAIAN",25861,398,2,2078,1247,1011,236,1234,13,"TRAIAN",,4,,517,717
4,"Bacău",47,"47-TRAIAN",25861,399,2,440,292,230,62,281,11,"TRAIAN",,4,,108,173
4,"Bacău",47,"47-UNGURENI",25816,400,2,734,548,468,80,543,5,"UNGURENI",,4,,417,126
4,"Bacău",47,"47-UNGURENI",25816,401,2,664,491,379,112,484,7,"UNGURENI",,4,,331,153
4,"Bacău",47,"47-UNGURENI",25816,402,2,576,407,329,78,398,9,"UNGURENI",,4,,230,168
4,"Bacău",47,"47-UNGURENI",25816,403,2,515,409,306,103,401,8,"UNGURENI",,4,,207,194
4,"Bacău",47,"47-URECHESTI",26029,404,2,1820,1322,1156,166,1302,20,"URECHESTI",,4,,626,676
4,"Bacău",47,"47-URECHESTI",26029,405,2,1230,919,775,144,913,6,"URECHESTI",,4,,582,331
4,"Bacău",47,"47-VALEA SEACA",23788,406,2,835,547,360,187,538,9,"VALEA SEACA",,4,,274,264
4,"Bacău",47,"47-VALEA SEACA",23788,407,2,595,444,313,131,440,4,"VALEA SEACA",,4,,248,192
4,"Bacău",47,"47-VALEA SEACA",23788,408,2,799,498,365,133,491,7,"VALEA SEACA",,4,,287,204
4,"Bacău",47,"47-VALEA SEACA",23788,409,2,544,445,318,127,437,8,"VALEA SEACA",,4,,223,214
4,"Bacău",47,"47-VULTURENI",26118,410,2,454,297,238,59,295,2,"VULTURENI",,4,,175,120
4,"Bacău",47,"47-VULTURENI",26118,411,2,523,339,270,69,334,5,"VULTURENI",,4,,276,58
4,"Bacău",47,"47-VULTURENI",26118,412,2,639,384,330,54,379,5,"VULTURENI",,4,,247,132
4,"Bacău",47,"47-VULTURENI",26118,413,2,272,231,205,26,231,0,"VULTURENI",,4,,221,10
4,"Bacău",47,"47-ZEMES",26289,414,2,745,660,506,154,658,2,"ZEMES",,4,,344,314
4,"Bacău",47,"47-ZEMES",26289,415,2,1839,1580,1288,292,1570,10,"ZEMES",,4,,1004,566
4,"Bacău",47,"47-ZEMES",26289,416,2,694,560,487,73,552,8,"ZEMES",,4,,296,256
5,"Bihor",56,"56-MUNICIPIUL ORADEA",26564,1,2,861,697,561,136,694,3,"MUNICIPIUL ORADEA",,2,,113,581
5,"Bihor",56,"56-MUNICIPIUL ORADEA",26564,2,2,965,690,664,26,689,1,"MUNICIPIUL ORADEA",,2,,184,505
5,"Bihor",56,"56-MUNICIPIUL ORADEA",26564,3,2,1512,946,862,84,942,4,"MUNICIPIUL ORADEA",,2,,193,749
5,"Bihor",56,"56-MUNICIPIUL ORADEA",26564,4,2,1615,1077,1019,58,1074,3,"MUNICIPIUL ORADEA",,2,,253,821
5,"Bihor",56,"56-MUNICIPIUL ORADEA",26564,5,2,1233,894,849,45,892,2,"MUNICIPIUL ORADEA",,2,,238,654
5,"Bihor",56,"56-MUNICIPIUL ORADEA",26564,6,2,1090,827,783,44,826,1,"MUNICIPIUL ORADEA",,2,,192,634
5,"Bihor",56,"56-MUNICIPIUL ORADEA",26564,7,2,707,620,474,146,620,0,"MUNICIPIUL ORADEA",,2,,120,500
5,"Bihor",56,"56-MUNICIPIUL ORADEA",26564,8,2,1507,998,881,117,998,0,"MUNICIPIUL ORADEA",,2,,196,802
5,"Bihor",56,"56-MUNICIPIUL ORADEA",26564,9,2,1882,1436,1347,89,1434,2,"MUNICIPIUL ORADEA",,2,,323,1111
5,"Bihor",56,"56-MUNICIPIUL ORADEA",26564,10,2,1883,1443,1352,91,1442,1,"MUNICIPIUL ORADEA",,2,,342,1100
5,"Bihor",56,"56-MUNICIPIUL ORADEA",26564,11,2,785,518,451,67,516,2,"MUNICIPIUL ORADEA",,2,,115,401
5,"Bihor",56,"56-MUNICIPIUL ORADEA",26564,12,2,748,571,529,42,571,0,"MUNICIPIUL ORADEA",,2,,158,413
5,"Bihor",56,"56-MUNICIPIUL ORADEA",26564,13,2,883,919,577,342,916,3,"MUNICIPIUL ORADEA",,2,,203,713
5,"Bihor",56,"56-MUNICIPIUL ORADEA",26564,14,2,1513,1129,1087,42,1129,0,"MUNICIPIUL ORADEA",,2,,362,767
5,"Bihor",56,"56-MUNICIPIUL ORADEA",26564,15,2,1004,725,661,64,720,5,"MUNICIPIUL ORADEA",,2,,203,517
5,"Bihor",56,"56-MUNICIPIUL ORADEA",26564,16,2,908,665,636,29,664,1,"MUNICIPIUL ORADEA",,2,,130,534
5,"Bihor",56,"56-MUNICIPIUL ORADEA",26564,17,2,1194,936,870,66,933,3,"MUNICIPIUL ORADEA",,2,,327,606
5,"Bihor",56,"56-MUNICIPIUL ORADEA",26564,18,2,1194,905,815,90,903,2,"MUNICIPIUL ORADEA",,2,,284,619
5,"Bihor",56,"56-MUNICIPIUL ORADEA",26564,19,2,1594,1221,1137,84,1135,2,"MUNICIPIUL ORADEA",,2,,335,800
5,"Bihor",56,"56-MUNICIPIUL ORADEA",26564,20,2,1417,1064,1007,57,1061,3,"MUNICIPIUL ORADEA",,2,,282,779
5,"Bihor",56,"56-MUNICIPIUL ORADEA",26564,21,2,1628,1345,1132,213,1340,5,"MUNICIPIUL ORADEA",,2,,316,1024
5,"Bihor",56,"56-MUNICIPIUL ORADEA",26564,22,2,1164,939,819,120,934,5,"MUNICIPIUL ORADEA",,2,,252,682
5,"Bihor",56,"56-MUNICIPIUL ORADEA",26564,23,2,1632,1281,1211,70,1278,3,"MUNICIPIUL ORADEA",,2,,308,970
5,"Bihor",56,"56-MUNICIPIUL ORADEA",26564,24,2,2079,1461,1325,136,1456,5,"MUNICIPIUL ORADEA",,2,,301,1155
5,"Bihor",56,"56-MUNICIPIUL ORADEA",26564,25,2,1868,1516,1366,150,1514,2,"MUNICIPIUL ORADEA",,2,,408,1106
5,"Bihor",56,"56-MUNICIPIUL ORADEA",26564,26,2,1618,1241,1169,72,1238,3,"MUNICIPIUL ORADEA",,2,,350,888
5,"Bihor",56,"56-MUNICIPIUL ORADEA",26564,27,2,1739,1353,1297,56,1348,5,"MUNICIPIUL ORADEA",,2,,340,1008
5,"Bihor",56,"56-MUNICIPIUL ORADEA",26564,28,2,1259,1036,942,94,1036,0,"MUNICIPIUL ORADEA",,2,,255,781
5,"Bihor",56,"56-MUNICIPIUL ORADEA",26564,29,2,1541,1194,1147,47,1190,4,"MUNICIPIUL ORADEA",,2,,292,898
5,"Bihor",56,"56-MUNICIPIUL ORADEA",26564,30,2,1759,1318,1257,61,1316,2,"MUNICIPIUL ORADEA",,2,,320,996
5,"Bihor",56,"56-MUNICIPIUL ORADEA",26564,31,2,2060,1477,1367,110,1471,6,"MUNICIPIUL ORADEA",,2,,415,1056
5,"Bihor",56,"56-MUNICIPIUL ORADEA",26564,32,2,1912,1481,1402,79,1479,2,"MUNICIPIUL ORADEA",,2,,344,1135
5,"Bihor",56,"56-MUNICIPIUL ORADEA",26564,33,2,1767,1322,1242,80,1321,1,"MUNICIPIUL ORADEA",,2,,316,1005
5,"Bihor",56,"56-MUNICIPIUL ORADEA",26564,34,2,1530,1053,975,78,1051,2,"MUNICIPIUL ORADEA",,2,,219,832
5,"Bihor",56,"56-MUNICIPIUL ORADEA",26564,35,2,1374,958,890,68,955,3,"MUNICIPIUL ORADEA",,2,,217,738
5,"Bihor",56,"56-MUNICIPIUL ORADEA",26564,36,2,1457,1062,990,72,1062,0,"MUNICIPIUL ORADEA",,2,,239,823
5,"Bihor",56,"56-MUNICIPIUL ORADEA",26564,37,2,1731,1303,1216,87,1300,3,"MUNICIPIUL ORADEA",,2,,286,1014
5,"Bihor",56,"56-MUNICIPIUL ORADEA",26564,38,2,1138,883,777,106,880,3,"MUNICIPIUL ORADEA",,2,,193,687
5,"Bihor",56,"56-MUNICIPIUL ORADEA",26564,39,2,1702,1314,1265,49,1310,4,"MUNICIPIUL ORADEA",,2,,313,997
5,"Bihor",56,"56-MUNICIPIUL ORADEA",26564,40,2,1393,1022,961,61,1016,6,"MUNICIPIUL ORADEA",,2,,227,789
5,"Bihor",56,"56-MUNICIPIUL ORADEA",26564,41,2,1054,761,722,39,759,2,"MUNICIPIUL ORADEA",,2,,142,617
5,"Bihor",56,"56-MUNICIPIUL ORADEA",26564,42,2,1775,1230,1163,67,1228,2,"MUNICIPIUL ORADEA",,2,,291,937
5,"Bihor",56,"56-MUNICIPIUL ORADEA",26564,43,2,1755,1267,1217,50,1264,3,"MUNICIPIUL ORADEA",,2,,332,932
5,"Bihor",56,"56-MUNICIPIUL ORADEA",26564,44,2,1637,1240,1155,85,1236,4,"MUNICIPIUL ORADEA",,2,,344,892
5,"Bihor",56,"56-MUNICIPIUL ORADEA",26564,45,2,1179,897,823,74,895,2,"MUNICIPIUL ORADEA",,2,,206,689
5,"Bihor",56,"56-MUNICIPIUL ORADEA",26564,46,2,1764,1308,1216,92,1302,6,"MUNICIPIUL ORADEA",,2,,340,962
5,"Bihor",56,"56-MUNICIPIUL ORADEA",26564,47,2,1118,829,781,48,825,4,"MUNICIPIUL ORADEA",,2,,193,632
5,"Bihor",56,"56-MUNICIPIUL ORADEA",26564,48,2,1297,889,819,70,886,3,"MUNICIPIUL ORADEA",,2,,57,829
5,"Bihor",56,"56-MUNICIPIUL ORADEA",26564,49,2,1528,1115,1010,105,1112,3,"MUNICIPIUL ORADEA",,2,,83,1029
5,"Bihor",56,"56-MUNICIPIUL ORADEA",26564,50,2,917,661,618,43,659,2,"MUNICIPIUL ORADEA",,2,,122,537
5,"Bihor",56,"56-MUNICIPIUL ORADEA",26564,51,2,1096,795,746,49,792,3,"MUNICIPIUL ORADEA",,2,,247,545
5,"Bihor",56,"56-MUNICIPIUL ORADEA",26564,52,2,968,802,670,132,802,0,"MUNICIPIUL ORADEA",,2,,214,588
5,"Bihor",56,"56-MUNICIPIUL ORADEA",26564,53,2,967,738,674,64,735,3,"MUNICIPIUL ORADEA",,2,,186,549
5,"Bihor",56,"56-MUNICIPIUL ORADEA",26564,54,2,1088,1010,730,280,1007,3,"MUNICIPIUL ORADEA",,2,,232,775
5,"Bihor",56,"56-MUNICIPIUL ORADEA",26564,55,2,1003,765,726,39,762,3,"MUNICIPIUL ORADEA",,2,,154,608
5,"Bihor",56,"56-MUNICIPIUL ORADEA",26564,56,2,1336,940,910,30,937,3,"MUNICIPIUL ORADEA",,2,,194,743
5,"Bihor",56,"56-MUNICIPIUL ORADEA",26564,57,2,927,720,663,57,720,0,"MUNICIPIUL ORADEA",,2,,149,571
5,"Bihor",56,"56-MUNICIPIUL ORADEA",26564,58,2,1047,858,790,68,856,2,"MUNICIPIUL ORADEA",,2,,270,586
5,"Bihor",56,"56-MUNICIPIUL ORADEA",26564,59,2,1383,1070,975,95,1065,5,"MUNICIPIUL ORADEA",,2,,256,809
5,"Bihor",56,"56-MUNICIPIUL ORADEA",26564,60,2,1611,1264,1127,137,1256,8,"MUNICIPIUL ORADEA",,2,,382,874
5,"Bihor",56,"56-MUNICIPIUL ORADEA",26564,61,2,1624,1134,1049,85,1125,9,"MUNICIPIUL ORADEA",,2,,216,909
5,"Bihor",56,"56-MUNICIPIUL ORADEA",26564,62,2,866,797,610,187,792,5,"MUNICIPIUL ORADEA",,2,,183,609
5,"Bihor",56,"56-MUNICIPIUL ORADEA",26564,63,2,796,625,583,42,623,2,"MUNICIPIUL ORADEA",,2,,133,490
5,"Bihor",56,"56-MUNICIPIUL ORADEA",26564,64,2,822,698,564,134,693,5,"MUNICIPIUL ORADEA",,2,,174,519
5,"Bihor",56,"56-MUNICIPIUL ORADEA",26564,65,2,863,652,608,44,651,1,"MUNICIPIUL ORADEA",,2,,164,487
5,"Bihor",56,"56-MUNICIPIUL ORADEA",26564,66,2,976,819,678,141,815,4,"MUNICIPIUL ORADEA",,2,,228,587
5,"Bihor",56,"56-MUNICIPIUL ORADEA",26564,67,2,1195,1247,864,383,1237,10,"MUNICIPIUL ORADEA",,2,,262,975
5,"Bihor",56,"56-MUNICIPIUL ORADEA",26564,68,2,1567,1287,1198,89,1191,7,"MUNICIPIUL ORADEA",,2,,398,793
5,"Bihor",56,"56-MUNICIPIUL ORADEA",26564,69,2,1120,979,860,119,970,9,"MUNICIPIUL ORADEA",,2,,239,731
5,"Bihor",56,"56-MUNICIPIUL ORADEA",26564,70,2,1015,1076,707,369,1069,7,"MUNICIPIUL ORADEA",,2,,236,833
5,"Bihor",56,"56-MUNICIPIUL ORADEA",26564,71,2,1165,855,795,60,850,5,"MUNICIPIUL ORADEA",,2,,188,662
5,"Bihor",56,"56-MUNICIPIUL ORADEA",26564,72,2,1332,949,839,110,940,9,"MUNICIPIUL ORADEA",,2,,177,763
5,"Bihor",56,"56-MUNICIPIUL ORADEA",26564,73,2,1143,986,766,220,978,8,"MUNICIPIUL ORADEA",,2,,244,734
5,"Bihor",56,"56-MUNICIPIUL ORADEA",26564,74,2,1086,767,714,53,763,4,"MUNICIPIUL ORADEA",,2,,141,622
5,"Bihor",56,"56-MUNICIPIUL ORADEA",26564,75,2,1310,819,729,90,813,6,"MUNICIPIUL ORADEA",,2,,184,629
5,"Bihor",56,"56-MUNICIPIUL ORADEA",26564,76,2,796,567,509,58,560,7,"MUNICIPIUL ORADEA",,2,,186,374
5,"Bihor",56,"56-MUNICIPIUL ORADEA",26564,77,2,1594,1219,1113,106,1215,4,"MUNICIPIUL ORADEA",,2,,332,883
5,"Bihor",56,"56-MUNICIPIUL ORADEA",26564,78,2,1404,1215,964,251,1201,14,"MUNICIPIUL ORADEA",,2,,271,930
5,"Bihor",56,"56-MUNICIPIUL ORADEA",26564,79,2,1351,1016,903,113,1010,6,"MUNICIPIUL ORADEA",,2,,301,709
5,"Bihor",56,"56-MUNICIPIUL ORADEA",26564,80,2,1686,1276,1126,150,1269,7,"MUNICIPIUL ORADEA",,2,,357,912
5,"Bihor",56,"56-MUNICIPIUL ORADEA",26564,81,2,1722,1243,1160,83,1241,2,"MUNICIPIUL ORADEA",,2,,371,870
5,"Bihor",56,"56-MUNICIPIUL ORADEA",26564,82,2,1679,1160,1111,49,1158,2,"MUNICIPIUL ORADEA",,2,,217,941
5,"Bihor",56,"56-MUNICIPIUL ORADEA",26564,83,2,1791,1376,1264,112,1376,0,"MUNICIPIUL ORADEA",,2,,421,955
5,"Bihor",56,"56-MUNICIPIUL ORADEA",26564,84,2,1075,1149,1075,74,1143,6,"MUNICIPIUL ORADEA",,2,,382,761
5,"Bihor",56,"56-MUNICIPIUL ORADEA",26564,85,2,1660,1195,1111,84,1195,0,"MUNICIPIUL ORADEA",,2,,340,855
5,"Bihor",56,"56-MUNICIPIUL ORADEA",26564,86,2,1463,1137,1016,121,1135,2,"MUNICIPIUL ORADEA",,2,,286,849
5,"Bihor",56,"56-MUNICIPIUL ORADEA",26564,87,2,1610,1162,1102,60,1160,2,"MUNICIPIUL ORADEA",,2,,338,822
5,"Bihor",56,"56-MUNICIPIUL ORADEA",26564,88,2,1594,1009,938,71,1001,8,"MUNICIPIUL ORADEA",,2,,227,774
5,"Bihor",56,"56-MUNICIPIUL ORADEA",26564,89,2,1602,1164,1089,75,1161,3,"MUNICIPIUL ORADEA",,2,,331,830
5,"Bihor",56,"56-MUNICIPIUL ORADEA",26564,90,2,1477,1039,981,58,1039,0,"MUNICIPIUL ORADEA",,2,,276,763
5,"Bihor",56,"56-MUNICIPIUL ORADEA",26564,91,2,1193,840,794,46,838,2,"MUNICIPIUL ORADEA",,2,,186,652
5,"Bihor",56,"56-MUNICIPIUL ORADEA",26564,92,2,1178,903,841,62,903,0,"MUNICIPIUL ORADEA",,2,,262,641
5,"Bihor",56,"56-MUNICIPIUL ORADEA",26564,93,2,1839,1361,1289,72,1358,3,"MUNICIPIUL ORADEA",,2,,412,946
5,"Bihor",56,"56-MUNICIPIUL ORADEA",26564,94,2,1065,840,781,59,836,4,"MUNICIPIUL ORADEA",,2,,222,614
5,"Bihor",56,"56-MUNICIPIUL ORADEA",26564,95,2,806,734,598,136,730,4,"MUNICIPIUL ORADEA",,2,,263,467
5,"Bihor",56,"56-MUNICIPIUL ORADEA",26564,96,2,1303,958,886,72,956,2,"MUNICIPIUL ORADEA",,2,,279,677
5,"Bihor",56,"56-MUNICIPIUL ORADEA",26564,97,2,1627,1195,1120,75,1194,1,"MUNICIPIUL ORADEA",,2,,395,799
5,"Bihor",56,"56-MUNICIPIUL ORADEA",26564,98,2,1776,1343,1241,102,1337,6,"MUNICIPIUL ORADEA",,2,,429,908
5,"Bihor",56,"56-MUNICIPIUL ORADEA",26564,99,2,1197,1069,1001,68,1068,1,"MUNICIPIUL ORADEA",,2,,318,750
5,"Bihor",56,"56-MUNICIPIUL ORADEA",26564,100,2,1500,992,963,29,988,4,"MUNICIPIUL ORADEA",,2,,267,721
5,"Bihor",56,"56-MUNICIPIUL ORADEA",26564,101,2,1339,979,941,38,979,0,"MUNICIPIUL ORADEA",,2,,274,705
5,"Bihor",56,"56-MUNICIPIUL ORADEA",26564,102,2,1210,832,775,57,828,4,"MUNICIPIUL ORADEA",,2,,207,621
5,"Bihor",56,"56-MUNICIPIUL ORADEA",26564,103,2,1519,1224,1075,149,1220,4,"MUNICIPIUL ORADEA",,2,,278,942
5,"Bihor",56,"56-MUNICIPIUL ORADEA",26564,104,2,939,691,601,90,691,0,"MUNICIPIUL ORADEA",,2,,167,524
5,"Bihor",56,"56-MUNICIPIUL ORADEA",26564,105,2,969,754,698,56,754,0,"MUNICIPIUL ORADEA",,2,,205,549
5,"Bihor",56,"56-MUNICIPIUL ORADEA",26564,106,2,992,655,620,35,649,6,"MUNICIPIUL ORADEA",,2,,121,528
5,"Bihor",56,"56-MUNICIPIUL ORADEA",26564,107,2,936,667,609,58,660,7,"MUNICIPIUL ORADEA",,2,,140,520
5,"Bihor",56,"56-MUNICIPIUL ORADEA",26564,108,2,1025,789,676,113,785,4,"MUNICIPIUL ORADEA",,2,,147,638
5,"Bihor",56,"56-MUNICIPIUL ORADEA",26564,109,2,1126,763,721,42,761,2,"MUNICIPIUL ORADEA",,2,,155,606
5,"Bihor",56,"56-MUNICIPIUL ORADEA",26564,110,2,1394,986,931,55,986,0,"MUNICIPIUL ORADEA",,2,,187,799
5,"Bihor",56,"56-MUNICIPIUL ORADEA",26564,111,2,1677,1123,1078,45,1116,7,"MUNICIPIUL ORADEA",,2,,241,875
5,"Bihor",56,"56-MUNICIPIUL ORADEA",26564,112,2,1721,1390,1214,176,1385,5,"MUNICIPIUL ORADEA",,2,,359,1026
5,"Bihor",56,"56-MUNICIPIUL ORADEA",26564,113,2,1947,1333,1200,133,1333,0,"MUNICIPIUL ORADEA",,2,,351,982
5,"Bihor",56,"56-MUNICIPIUL ORADEA",26564,114,2,1845,1552,1338,214,1546,6,"MUNICIPIUL ORADEA",,2,,437,1109
5,"Bihor",56,"56-MUNICIPIUL ORADEA",26564,115,2,1465,1193,1145,48,1190,3,"MUNICIPIUL ORADEA",,2,,285,905
5,"Bihor",56,"56-MUNICIPIUL ORADEA",26564,116,2,2011,1599,1486,113,1597,2,"MUNICIPIUL ORADEA",,2,,391,1206
5,"Bihor",56,"56-MUNICIPIUL ORADEA",26564,117,2,1310,1034,966,68,1032,2,"MUNICIPIUL ORADEA",,2,,297,735
5,"Bihor",56,"56-MUNICIPIUL ORADEA",26564,118,2,1454,1126,982,144,1121,5,"MUNICIPIUL ORADEA",,2,,318,803
5,"Bihor",56,"56-MUNICIPIUL ORADEA",26564,119,2,1597,1128,1032,96,1126,2,"MUNICIPIUL ORADEA",,2,,300,826
5,"Bihor",56,"56-MUNICIPIUL ORADEA",26564,120,2,1509,1102,1050,52,1096,6,"MUNICIPIUL ORADEA",,2,,247,849
5,"Bihor",56,"56-MUNICIPIUL ORADEA",26564,121,2,838,655,619,36,652,3,"MUNICIPIUL ORADEA",,2,,215,437
5,"Bihor",56,"56-MUNICIPIUL ORADEA",26564,122,2,1240,926,885,41,924,2,"MUNICIPIUL ORADEA",,2,,368,556
5,"Bihor",56,"56-MUNICIPIUL ORADEA",26564,123,2,1072,853,809,44,852,1,"MUNICIPIUL ORADEA",,2,,436,416
5,"Bihor",56,"56-MUNICIPIUL ORADEA",26564,124,2,1021,789,764,25,787,2,"MUNICIPIUL ORADEA",,2,,321,466
5,"Bihor",56,"56-MUNICIPIUL ORADEA",26564,125,2,962,792,728,64,792,0,"MUNICIPIUL ORADEA",,2,,341,451
5,"Bihor",56,"56-MUNICIPIUL ORADEA",26564,126,2,978,853,753,100,851,2,"MUNICIPIUL ORADEA",,2,,383,468
5,"Bihor",56,"56-MUNICIPIUL ORADEA",26564,127,2,1275,888,826,62,888,0,"MUNICIPIUL ORADEA",,2,,219,669
5,"Bihor",56,"56-MUNICIPIUL ORADEA",26564,128,2,1113,695,661,34,695,0,"MUNICIPIUL ORADEA",,2,,253,442
5,"Bihor",56,"56-MUNICIPIUL ORADEA",26564,129,2,1103,837,754,83,834,3,"MUNICIPIUL ORADEA",,2,,266,568
5,"Bihor",56,"56-MUNICIPIUL ORADEA",26564,130,2,1441,1130,1037,93,1121,9,"MUNICIPIUL ORADEA",,2,,324,797
5,"Bihor",56,"56-MUNICIPIUL ORADEA",26564,131,2,297,196,169,27,195,1,"MUNICIPIUL ORADEA",,2,,17,178
5,"Bihor",56,"56-MUNICIPIUL ORADEA",26564,132,2,2718,2438,2408,30,2401,37,"MUNICIPIUL ORADEA",,2,,982,1419
5,"Bihor",56,"56-MUNICIPIUL ORADEA",26564,133,2,0,811,0,811,805,6,"MUNICIPIUL ORADEA",,2,,276,529
5,"Bihor",56,"56-MUNICIPIUL ORADEA",26564,134,2,0,1552,0,1552,1552,0,"MUNICIPIUL ORADEA",,2,,354,1198
5,"Bihor",56,"56-ORAS ALESD",26699,135,2,2882,2565,2178,387,2555,10,"ORAS ALESD",,2,,451,2104
5,"Bihor",56,"56-ORAS ALESD",26699,136,2,2823,2005,1761,244,1997,8,"ORAS ALESD",,2,,387,1610
5,"Bihor",56,"56-ORAS ALESD",26699,137,2,766,559,484,75,558,1,"ORAS ALESD",,2,,32,526
5,"Bihor",56,"56-ORAS ALESD",26699,138,2,1091,790,748,42,780,10,"ORAS ALESD",,2,,159,621
5,"Bihor",56,"56-ORAS ALESD",26699,139,2,591,490,452,38,488,2,"ORAS ALESD",,2,,114,374
5,"Bihor",56,"56-ORAS BEIUS",26804,140,2,1856,1388,1328,60,1383,5,"ORAS BEIUS",,2,,640,743
5,"Bihor",56,"56-ORAS BEIUS",26804,141,2,1910,1322,1182,140,1316,6,"ORAS BEIUS",,2,,583,733
5,"Bihor",56,"56-ORAS BEIUS",26804,142,2,1269,942,871,71,935,7,"ORAS BEIUS",,2,,373,562
5,"Bihor",56,"56-ORAS BEIUS",26804,143,2,1921,1493,1389,104,1488,5,"ORAS BEIUS",,2,,736,752
5,"Bihor",56,"56-ORAS BEIUS",26804,144,2,2226,1763,1604,159,1760,3,"ORAS BEIUS",,2,,884,876
5,"Bihor",56,"56-ORAS BEIUS",26804,145,2,308,248,230,18,247,1,"ORAS BEIUS",,2,,160,87
5,"Bihor",56,"56-ORAS BEIUS",26804,146,2,300,301,294,7,299,2,"ORAS BEIUS",,2,,162,137
5,"Bihor",56,"56-ORAS MARGHITA",26877,147,2,1833,1537,1230,307,1528,9,"ORAS MARGHITA",,2,,514,1014
5,"Bihor",56,"56-ORAS MARGHITA",26877,148,2,1713,1340,1099,241,1333,7,"ORAS MARGHITA",,2,,306,1027
5,"Bihor",56,"56-ORAS MARGHITA",26877,149,2,1561,1206,1096,110,1206,0,"ORAS MARGHITA",,2,,272,934
5,"Bihor",56,"56-ORAS MARGHITA",26877,150,2,1998,1393,1285,108,1383,10,"ORAS MARGHITA",,2,,257,1126
5,"Bihor",56,"56-ORAS MARGHITA",26877,151,2,1501,1203,1158,45,1199,4,"ORAS MARGHITA",,2,,254,945
5,"Bihor",56,"56-ORAS MARGHITA",26877,152,2,2100,1529,1420,109,1524,5,"ORAS MARGHITA",,2,,329,1195
5,"Bihor",56,"56-ORAS MARGHITA",26877,153,2,1976,1440,1358,82,1433,7,"ORAS MARGHITA",,2,,389,1044
5,"Bihor",56,"56-ORAS MARGHITA",26877,154,2,791,561,467,94,548,13,"ORAS MARGHITA",,2,,159,389
5,"Bihor",56,"56-ORAS MARGHITA",26877,155,2,606,488,420,68,485,3,"ORAS MARGHITA",,2,,278,207
5,"Bihor",56,"56-ORAS NUCET",26920,156,2,1075,918,804,114,914,4,"ORAS NUCET",,2,,513,401
5,"Bihor",56,"56-ORAS NUCET",26920,157,2,596,646,596,50,521,2,"ORAS NUCET",,2,,280,241
5,"Bihor",56,"56-ORAS SALONTA",26975,158,2,2587,1960,1822,138,1940,20,"ORAS SALONTA",,2,,192,1748
5,"Bihor",56,"56-ORAS SALONTA",26975,159,2,1637,1143,1091,52,1135,8,"ORAS SALONTA",,2,,108,1027
5,"Bihor",56,"56-ORAS SALONTA",26975,160,2,1973,1351,1277,74,1347,4,"ORAS SALONTA",,2,,276,1071
5,"Bihor",56,"56-ORAS SALONTA",26975,161,2,1996,1445,1352,93,1437,8,"ORAS SALONTA",,2,,212,1225
5,"Bihor",56,"56-ORAS SALONTA",26975,162,2,1230,977,870,107,969,8,"ORAS SALONTA",,2,,161,808
5,"Bihor",56,"56-ORAS SALONTA",26975,163,2,2193,1497,1400,97,1490,7,"ORAS SALONTA",,2,,390,1100
5,"Bihor",56,"56-ORAS SALONTA",26975,164,2,1931,1462,1304,158,1446,16,"ORAS SALONTA",,2,,298,1148
5,"Bihor",56,"56-ORAS SALONTA",26975,165,2,1602,1215,1108,107,1199,16,"ORAS SALONTA",,2,,360,839
5,"Bihor",56,"56-ORAS SALONTA",26975,166,2,677,537,496,41,530,7,"ORAS SALONTA",,2,,217,313
5,"Bihor",56,"56-ORAS SALONTA",26975,167,2,0,94,0,94,93,1,"ORAS SALONTA",,2,,38,55
5,"Bihor",56,"56-ORAS SALONTA",26975,168,2,0,301,0,301,297,4,"ORAS SALONTA",,2,,129,168
5,"Bihor",56,"56-ORAS STEI",26840,169,2,2033,1537,1300,237,1530,7,"ORAS STEI",,2,,786,744
5,"Bihor",56,"56-ORAS STEI",26840,170,2,1841,1420,1303,117,1412,8,"ORAS STEI",,2,,699,713
5,"Bihor",56,"56-ORAS STEI",26840,171,2,2953,2105,1839,266,2095,10,"ORAS STEI",,2,,975,1120
5,"Bihor",56,"56-ORAS VALEA LUI MIHAI",32027,172,2,2727,1852,1627,225,1838,14,"ORAS VALEA LUI MIHAI",,2,,153,1685
5,"Bihor",56,"56-ORAS VALEA LUI MIHAI",32027,173,2,1726,1809,1462,347,1769,40,"ORAS VALEA LUI MIHAI",,2,,173,1596
5,"Bihor",56,"56-ORAS VALEA LUI MIHAI",32027,174,2,1386,926,839,87,888,38,"ORAS VALEA LUI MIHAI",,2,,40,848
5,"Bihor",56,"56-ORAS VALEA LUI MIHAI",32027,175,2,1680,1132,1020,112,1103,29,"ORAS VALEA LUI MIHAI",,2,,76,1027
5,"Bihor",56,"56-ORAS VASCAU",27007,176,2,1893,1378,1281,97,1373,5,"ORAS VASCAU",,2,,706,667
5,"Bihor",56,"56-ORAS VASCAU",27007,177,2,666,449,394,55,445,4,"ORAS VASCAU",,2,,300,145
5,"Bihor",56,"56-ABRAM",27070,178,2,657,538,464,74,534,4,"ABRAM",,2,,140,394
5,"Bihor",56,"56-ABRAM",27070,179,2,340,225,177,48,224,1,"ABRAM",,2,,179,45
5,"Bihor",56,"56-ABRAM",27070,180,2,416,318,273,45,304,14,"ABRAM",,2,,224,80
5,"Bihor",56,"56-ABRAM",27070,181,2,748,551,495,56,542,9,"ABRAM",,2,,291,251
5,"Bihor",56,"56-ABRAM",27070,182,2,524,401,338,63,397,4,"ABRAM",,2,,183,214
5,"Bihor",56,"56-ABRAMUT",27178,183,2,697,492,444,48,474,18,"ABRAMUT",,2,,170,304
5,"Bihor",56,"56-ABRAMUT",27178,184,2,352,307,238,69,302,5,"ABRAMUT",,2,,17,285
5,"Bihor",56,"56-ABRAMUT",27178,185,2,1029,858,749,109,855,3,"ABRAMUT",,2,,40,815
5,"Bihor",56,"56-ASTILEU",26742,186,2,1697,1166,1071,95,1159,7,"ASTILEU",,2,,458,701
5,"Bihor",56,"56-ASTILEU",26742,187,2,459,444,350,94,442,2,"ASTILEU",,2,,190,252
5,"Bihor",56,"56-ASTILEU",26742,188,2,772,415,361,54,412,3,"ASTILEU",,2,,218,194
5,"Bihor",56,"56-AUSEU",27212,189,2,1416,937,827,110,922,15,"AUSEU",,2,,355,567
5,"Bihor",56,"56-AUSEU",27212,190,2,870,518,460,58,511,7,"AUSEU",,2,,229,282
5,"Bihor",56,"56-AVRAM IANCU",27285,191,2,1534,1287,1115,172,1280,7,"AVRAM IANCU",,2,,911,369
5,"Bihor",56,"56-AVRAM IANCU",27285,192,2,168,196,126,70,195,1,"AVRAM IANCU",,2,,29,166
5,"Bihor",56,"56-AVRAM IANCU",27285,193,2,749,615,474,141,602,13,"AVRAM IANCU",,2,,209,393
5,"Bihor",56,"56-BALC",27329,194,2,957,666,552,114,658,8,"BALC",,2,,55,603
5,"Bihor",56,"56-BALC",27329,195,2,767,523,480,43,512,11,"BALC",,2,,300,212
5,"Bihor",56,"56-BALC",27329,196,2,441,345,305,40,335,10,"BALC",,2,,226,109
5,"Bihor",56,"56-BALC",27329,197,2,597,527,431,96,510,17,"BALC",,2,,271,239
5,"Bihor",56,"56-BATAR",27383,198,2,1157,996,833,163,980,16,"BATAR",,2,,579,401
5,"Bihor",56,"56-BATAR",27383,199,2,641,417,397,20,417,0,"BATAR",,2,,41,376
5,"Bihor",56,"56-BATAR",27383,200,2,1224,954,833,121,943,11,"BATAR",,2,,729,214
5,"Bihor",56,"56-BATAR",27383,201,2,783,664,577,87,660,4,"BATAR",,2,,414,246
5,"Bihor",56,"56-BIHARIA",27436,202,2,2285,1723,1322,401,1715,8,"BIHARIA",,2,,77,1638
5,"Bihor",56,"56-BIHARIA",27436,203,2,448,373,321,52,372,1,"BIHARIA",,2,,20,352
5,"Bihor",56,"56-BIHARIA",27436,204,2,183,159,137,22,159,0,"BIHARIA",,2,,3,156
5,"Bihor",56,"56-BIHARIA",27436,205,2,371,339,230,109,331,5,"BIHARIA",,2,,52,279
5,"Bihor",56,"56-BIHARIA",27436,206,2,185,167,129,38,167,0,"BIHARIA",,2,,0,167
5,"Bihor",56,"56-BIHARIA",27436,207,2,691,642,524,118,639,3,"BIHARIA",,2,,34,605
5,"Bihor",56,"56-BOIANU MARE",27506,208,2,621,476,422,54,469,7,"BOIANU MARE",,2,,278,191
5,"Bihor",56,"56-BOIANU MARE",27506,209,2,535,503,384,119,496,7,"BOIANU MARE",,2,,276,220
5,"Bihor",56,"56-BOROD",27560,210,2,1322,825,726,99,816,9,"BOROD",,2,,327,489
5,"Bihor",56,"56-BOROD",27560,211,2,877,530,493,37,524,6,"BOROD",,2,,231,293
5,"Bihor",56,"56-BOROD",27560,212,2,834,568,496,72,562,6,"BOROD",,2,,259,303
5,"Bihor",56,"56-BOROD",27560,213,2,102,71,33,38,69,2,"BOROD",,2,,31,38
5,"Bihor",56,"56-BOROD",27560,214,2,352,164,104,60,161,3,"BOROD",,2,,23,138
5,"Bihor",56,"56-BORS",27631,215,2,899,657,554,103,655,2,"BORS",,2,,48,607
5,"Bihor",56,"56-BORS",27631,216,2,1104,779,705,74,772,7,"BORS",,2,,9,763
5,"Bihor",56,"56-BORS",27631,217,2,263,246,164,82,246,0,"BORS",,2,,25,221
5,"Bihor",56,"56-BORS",27631,218,2,310,327,239,88,326,1,"BORS",,2,,25,301
5,"Bihor",56,"56-BRATCA",27686,219,2,2195,1422,1337,85,1411,11,"BRATCA",,2,,827,584
5,"Bihor",56,"56-BRATCA",27686,220,2,726,397,376,21,396,1,"BRATCA",,2,,277,119
5,"Bihor",56,"56-BRATCA",27686,221,2,1178,867,812,55,858,9,"BRATCA",,2,,395,463
5,"Bihor",56,"56-BRATCA",27686,222,2,662,375,351,24,369,6,"BRATCA",,2,,175,194
5,"Bihor",56,"56-BRUSTURI",27757,223,2,1546,832,774,58,827,5,"BRUSTURI",,2,,380,447
5,"Bihor",56,"56-BRUSTURI",27757,224,2,896,397,382,15,394,3,"BRUSTURI",,2,,220,174
5,"Bihor",56,"56-BRUSTURI",27757,225,2,854,616,577,39,609,7,"BRUSTURI",,2,,270,339
5,"Bihor",56,"56-BRUSTURI",27757,226,2,525,290,267,23,287,3,"BRUSTURI",,2,,121,166
5,"Bihor",56,"56-BUDUREASA",27846,227,2,1521,1083,959,124,1061,22,"BUDUREASA",,2,,564,497
5,"Bihor",56,"56-BUDUREASA",27846,228,2,550,314,307,7,310,4,"BUDUREASA",,2,,184,126
5,"Bihor",56,"56-BUDUSLAU",27908,229,2,797,584,504,80,582,2,"BUDUSLAU",,2,,94,488
5,"Bihor",56,"56-BUDUSLAU",27908,230,2,813,538,479,59,532,6,"BUDUSLAU",,2,,19,513
5,"Bihor",56,"56-BULZ",27935,231,2,1327,745,683,62,742,3,"BULZ",,2,,281,461
5,"Bihor",56,"56-BULZ",27935,232,2,844,616,616,0,611,5,"BULZ",,2,,305,306
5,"Bihor",56,"56-BUNTESTI",27971,233,2,1270,884,836,48,875,9,"BUNTESTI",,2,,500,375
5,"Bihor",56,"56-BUNTESTI",27971,234,2,477,329,297,32,322,7,"BUNTESTI",,2,,220,102
5,"Bihor",56,"56-BUNTESTI",27971,235,2,1067,745,718,27,739,6,"BUNTESTI",,2,,239,500
5,"Bihor",56,"56-BUNTESTI",27971,236,2,1025,762,678,84,759,3,"BUNTESTI",,2,,450,309
5,"Bihor",56,"56-CABESTI",28077,237,2,1412,964,870,94,953,11,"CABESTI",,2,,588,365
5,"Bihor",56,"56-CABESTI",28077,238,2,298,242,224,18,239,3,"CABESTI",,2,,175,64
5,"Bihor",56,"56-CAPALNA",28139,239,2,418,378,344,34,378,0,"CAPALNA",,2,,269,109
5,"Bihor",56,"56-CAPALNA",28139,240,2,585,373,305,68,370,3,"CAPALNA",,2,,92,278
5,"Bihor",56,"56-CAPALNA",28139,241,2,525,473,370,103,468,5,"CAPALNA",,2,,319,149
5,"Bihor",56,"56-CAPALNA",28139,242,2,404,391,335,56,387,4,"CAPALNA",,2,,242,145
5,"Bihor",56,"56-CARPINET",28193,243,2,848,676,619,57,672,4,"CARPINET",,2,,478,194
5,"Bihor",56,"56-CARPINET",28193,244,2,1211,783,723,60,780,3,"CARPINET",,2,,492,288
5,"Bihor",56,"56-CEFA",28246,245,2,175,158,111,47,148,10,"CEFA",,2,,75,73
5,"Bihor",56,"56-CEFA",28246,246,2,901,720,592,128,712,8,"CEFA",,2,,376,336
5,"Bihor",56,"56-CEFA",28246,247,2,447,368,315,53,363,5,"CEFA",,2,,160,203
5,"Bihor",56,"56-CEFA",28246,248,2,773,590,483,107,569,21,"CEFA",,2,,303,266
5,"Bihor",56,"56-CEFA",28246,249,2,635,543,482,61,534,9,"CEFA",,2,,300,234
5,"Bihor",56,"56-CEFA",28246,250,2,414,364,282,82,360,4,"CEFA",,2,,159,201
5,"Bihor",56,"56-CEFA",28246,251,2,1135,927,756,171,923,4,"CEFA",,2,,625,298
5,"Bihor",56,"56-CEICA",28335,252,2,1397,1012,867,145,1010,2,"CEICA",,2,,579,431
5,"Bihor",56,"56-CEICA",28335,253,2,606,360,328,32,356,4,"CEICA",,2,,207,149
5,"Bihor",56,"56-CEICA",28335,254,2,506,454,419,35,452,2,"CEICA",,2,,388,64
5,"Bihor",56,"56-CEICA",28335,255,2,443,347,302,45,344,3,"CEICA",,2,,247,97
5,"Bihor",56,"56-CEICA",28335,256,2,336,305,214,91,302,3,"CEICA",,2,,186,116
5,"Bihor",56,"56-CETARIU",28415,257,2,850,458,458,0,454,4,"CETARIU",,2,,10,444
5,"Bihor",56,"56-CETARIU",28415,258,2,379,318,280,38,317,1,"CETARIU",,2,,5,312
5,"Bihor",56,"56-CETARIU",28415,259,2,350,422,336,86,422,0,"CETARIU",,2,,1,421
5,"Bihor",56,"56-CETARIU",28415,260,2,444,364,314,50,360,4,"CETARIU",,2,,11,349
5,"Bihor",56,"56-CETARIU",28415,261,2,179,176,147,29,175,1,"CETARIU",,2,,2,173
5,"Bihor",56,"56-CETARIU",28415,262,2,524,442,375,67,441,1,"CETARIU",,2,,16,425
5,"Bihor",56,"56-CETARIU",28415,263,2,299,204,162,42,202,2,"CETARIU",,2,,111,91
5,"Bihor",56,"56-CHERECHIU",28497,264,2,618,407,348,59,401,6,"CHERECHIU",,2,,18,383
5,"Bihor",56,"56-CHERECHIU",28497,265,2,882,650,566,84,645,5,"CHERECHIU",,2,,45,600
5,"Bihor",56,"56-CHERECHIU",28497,266,2,441,405,325,80,397,8,"CHERECHIU",,2,,9,388
5,"Bihor",56,"56-CHISLAZ",28530,267,2,454,389,321,68,381,8,"CHISLAZ",,2,,185,196
5,"Bihor",56,"56-CHISLAZ",28530,268,2,488,463,404,59,460,3,"CHISLAZ",,2,,230,230
5,"Bihor",56,"56-CHISLAZ",28530,269,2,748,692,628,64,687,5,"CHISLAZ",,2,,8,679
5,"Bihor",56,"56-CHISLAZ",28530,270,2,297,183,144,39,180,3,"CHISLAZ",,2,,19,161
5,"Bihor",56,"56-CHISLAZ",28530,271,2,358,338,259,79,332,6,"CHISLAZ",,2,,141,191
5,"Bihor",56,"56-CHISLAZ",28530,272,2,382,259,259,0,258,1,"CHISLAZ",,2,,129,129
5,"Bihor",56,"56-CIUHOI",28629,273,2,844,707,607,100,702,5,"CIUHOI",,2,,383,319
5,"Bihor",56,"56-CIUHOI",28629,274,2,973,809,702,107,797,12,"CIUHOI",,2,,39,758
5,"Bihor",56,"56-CIUMEGHIU",28665,275,2,1335,1002,860,142,986,16,"CIUMEGHIU",,2,,458,528
5,"Bihor",56,"56-CIUMEGHIU",28665,276,2,690,432,385,47,422,10,"CIUMEGHIU",,2,,122,300
5,"Bihor",56,"56-CIUMEGHIU",28665,277,2,1336,909,816,93,903,6,"CIUMEGHIU",,2,,322,581
5,"Bihor",56,"56-CAMPANI",28709,278,2,1293,1069,939,130,1062,7,"CAMPANI",,2,,671,391
5,"Bihor",56,"56-CAMPANI",28709,279,2,305,291,273,18,291,0,"CAMPANI",,2,,174,117
5,"Bihor",56,"56-CAMPANI",28709,280,2,326,286,264,22,286,0,"CAMPANI",,2,,124,162
5,"Bihor",56,"56-CAMPANI",28709,281,2,306,262,252,10,258,4,"CAMPANI",,2,,158,100
5,"Bihor",56,"56-COCIUBA MARE",28763,282,2,852,722,644,78,716,6,"COCIUBA MARE",,2,,471,245
5,"Bihor",56,"56-COCIUBA MARE",28763,283,2,678,554,501,53,549,5,"COCIUBA MARE",,2,,313,236
5,"Bihor",56,"56-COCIUBA MARE",28763,284,2,641,549,491,58,542,7,"COCIUBA MARE",,2,,225,317
5,"Bihor",56,"56-COCIUBA MARE",28763,285,2,572,527,469,58,523,4,"COCIUBA MARE",,2,,358,165
5,"Bihor",56,"56-COPACEL",28816,286,2,978,678,541,137,670,8,"COPACEL",,2,,364,306
5,"Bihor",56,"56-COPACEL",28816,287,2,616,400,350,50,393,7,"COPACEL",,2,,230,163
5,"Bihor",56,"56-COPACEL",28816,288,2,372,322,258,64,316,6,"COPACEL",,2,,176,140
5,"Bihor",56,"56-CRISTIORU DE JOS",28889,289,2,368,289,226,63,284,5,"CRISTIORU DE JOS",,2,,143,141
5,"Bihor",56,"56-CRISTIORU DE JOS",28889,290,2,220,192,192,0,192,0,"CRISTIORU DE JOS",,2,,141,51
5,"Bihor",56,"56-CRISTIORU DE JOS",28889,291,2,485,424,378,46,423,1,"CRISTIORU DE JOS",,2,,280,143
5,"Bihor",56,"56-CRISTIORU DE JOS",28889,292,2,428,373,314,59,368,5,"CRISTIORU DE JOS",,2,,255,113
5,"Bihor",56,"56-CURATELE",28941,293,2,2261,1459,1363,96,1433,26,"CURATELE",,2,,754,679
5,"Bihor",56,"56-CURTUISENI",29001,294,2,2010,1379,1293,86,1354,25,"CURTUISENI",,2,,69,1285
5,"Bihor",56,"56-CURTUISENI",29001,295,2,888,703,621,82,691,12,"CURTUISENI",,2,,393,298
5,"Bihor",56,"56-DERNA",29038,296,2,772,554,477,77,551,3,"DERNA",,2,,256,295
5,"Bihor",56,"56-DERNA",29038,297,2,611,399,396,3,393,6,"DERNA",,2,,240,153
5,"Bihor",56,"56-DERNA",29038,298,2,566,363,326,37,360,3,"DERNA",,2,,219,141
5,"Bihor",56,"56-DERNA",29038,299,2,321,197,174,23,194,3,"DERNA",,2,,64,130
5,"Bihor",56,"56-DERNA",29038,300,2,409,298,261,37,298,0,"DERNA",,2,,179,119
5,"Bihor",56,"56-DIOSIG",29092,301,2,1536,950,822,128,944,6,"DIOSIG",,2,,385,559
5,"Bihor",56,"56-DIOSIG",29092,302,2,2067,1145,937,208,1132,13,"DIOSIG",,2,,64,1068
5,"Bihor",56,"56-DIOSIG",29092,303,2,1445,911,741,170,896,15,"DIOSIG",,2,,119,777
5,"Bihor",56,"56-DIOSIG",29092,304,2,844,718,580,138,712,6,"DIOSIG",,2,,370,342
5,"Bihor",56,"56-DIOSIG",29092,305,2,916,590,505,85,589,1,"DIOSIG",,2,,25,564
5,"Bihor",56,"56-DIOSIG",29092,306,2,487,403,364,39,396,7,"DIOSIG",,2,,8,388
5,"Bihor",56,"56-DOBRESTI",29154,307,2,1237,959,931,28,938,21,"DOBRESTI",,2,,476,462
5,"Bihor",56,"56-DOBRESTI",29154,308,2,882,672,649,23,661,11,"DOBRESTI",,2,,419,242
5,"Bihor",56,"56-DOBRESTI",29154,309,2,1439,1005,959,46,995,10,"DOBRESTI",,2,,749,246
5,"Bihor",56,"56-DOBRESTI",29154,310,2,636,523,506,17,511,12,"DOBRESTI",,2,,394,117
5,"Bihor",56,"56-DRAGANESTI",29243,311,2,1083,826,763,63,820,6,"DRAGANESTI",,2,,381,439
5,"Bihor",56,"56-DRAGANESTI",29243,312,2,465,388,357,31,388,0,"DRAGANESTI",,2,,259,129
5,"Bihor",56,"56-DRAGANESTI",29243,313,2,534,413,375,38,411,2,"DRAGANESTI",,2,,258,153
5,"Bihor",56,"56-DRAGANESTI",29243,314,2,222,202,170,32,202,0,"DRAGANESTI",,2,,119,83
5,"Bihor",56,"56-DRAGESTI",29341,315,2,1026,662,574,88,644,18,"DRAGESTI",,2,,377,267
5,"Bihor",56,"56-DRAGESTI",29341,316,2,844,574,453,121,565,9,"DRAGESTI",,2,,205,360
5,"Bihor",56,"56-FINIS",29403,317,2,1618,1318,1128,190,1305,13,"FINIS",,2,,452,853
5,"Bihor",56,"56-FINIS",29403,318,2,1079,858,738,120,845,13,"FINIS",,2,,345,500
5,"Bihor",56,"56-GIRISU DE CRIS",29467,319,2,874,680,494,186,676,4,"GIRISU DE CRIS",,2,,361,315
5,"Bihor",56,"56-GIRISU DE CRIS",29467,320,2,821,629,510,119,622,7,"GIRISU DE CRIS",,2,,314,308
5,"Bihor",56,"56-GIRISU DE CRIS",29467,321,2,1275,893,638,255,885,8,"GIRISU DE CRIS",,2,,296,589
5,"Bihor",56,"56-GIRISU DE CRIS",29467,322,2,760,570,443,127,566,4,"GIRISU DE CRIS",,2,,283,283
5,"Bihor",56,"56-HIDISELU DE SUS",29519,323,2,1493,1041,915,126,1022,19,"HIDISELU DE SUS",,2,,665,357
5,"Bihor",56,"56-HIDISELU DE SUS",29519,324,2,645,625,569,56,620,5,"HIDISELU DE SUS",,2,,442,178
5,"Bihor",56,"56-HIDISELU DE SUS",29519,325,2,361,292,238,54,290,2,"HIDISELU DE SUS",,2,,189,101
5,"Bihor",56,"56-HOLOD",29573,326,2,745,548,484,64,539,9,"HOLOD",,2,,362,177
5,"Bihor",56,"56-HOLOD",29573,327,2,465,390,302,88,372,18,"HOLOD",,2,,173,199
5,"Bihor",56,"56-HOLOD",29573,328,2,731,439,392,47,436,3,"HOLOD",,2,,259,177
5,"Bihor",56,"56-HOLOD",29573,329,2,748,604,554,50,598,6,"HOLOD",,2,,429,169
5,"Bihor",56,"56-HUSASAU DE TINCA",29662,330,2,589,501,432,69,499,2,"HUSASAU DE TINCA",,2,,337,162
5,"Bihor",56,"56-HUSASAU DE TINCA",29662,331,2,148,136,103,33,134,2,"HUSASAU DE TINCA",,2,,70,64
5,"Bihor",56,"56-HUSASAU DE TINCA",29662,332,2,292,283,206,77,283,0,"HUSASAU DE TINCA",,2,,207,76
5,"Bihor",56,"56-HUSASAU DE TINCA",29662,333,2,361,304,253,51,303,1,"HUSASAU DE TINCA",,2,,198,105
5,"Bihor",56,"56-HUSASAU DE TINCA",29662,334,2,387,351,273,78,347,4,"HUSASAU DE TINCA",,2,,204,143
5,"Bihor",56,"56-INEU",29724,335,2,1504,963,913,50,949,14,"INEU",,2,,225,724
5,"Bihor",56,"56-INEU",29724,336,2,510,317,275,42,314,3,"INEU",,2,,164,150
5,"Bihor",56,"56-INEU",29724,337,2,597,519,375,144,510,9,"INEU",,2,,230,280
5,"Bihor",56,"56-LAZURI DE BEIUS",29760,338,2,493,376,324,52,376,0,"LAZURI DE BEIUS",,2,,220,156
5,"Bihor",56,"56-LAZURI DE BEIUS",29760,339,2,443,362,326,36,359,3,"LAZURI DE BEIUS",,2,,189,170
5,"Bihor",56,"56-LAZURI DE BEIUS",29760,340,2,678,471,429,42,471,0,"LAZURI DE BEIUS",,2,,204,267
5,"Bihor",56,"56-LAZARENI",29813,341,2,639,483,365,118,480,3,"LAZARENI",,2,,201,279
5,"Bihor",56,"56-LAZARENI",29813,342,2,535,379,340,39,375,4,"LAZARENI",,2,,239,136
5,"Bihor",56,"56-LAZARENI",29813,343,2,464,360,286,74,359,1,"LAZARENI",,2,,154,205
5,"Bihor",56,"56-LAZARENI",29813,344,2,471,402,301,101,394,8,"LAZARENI",,2,,222,172
5,"Bihor",56,"56-LAZARENI",29813,345,2,197,175,136,39,173,2,"LAZARENI",,2,,82,91
5,"Bihor",56,"56-LUGASU DE JOS",29902,346,2,1672,1111,1050,61,1100,11,"LUGASU DE JOS",,2,,458,642
5,"Bihor",56,"56-LUGASU DE JOS",29902,347,2,682,508,414,94,502,6,"LUGASU DE JOS",,2,,35,467
5,"Bihor",56,"56-LUNCA",29948,348,2,816,594,503,91,594,0,"LUNCA",,2,,349,245
5,"Bihor",56,"56-LUNCA",29948,349,2,379,289,259,30,287,2,"LUNCA",,2,,178,109
5,"Bihor",56,"56-LUNCA",29948,350,2,252,222,202,20,221,1,"LUNCA",,2,,110,111
5,"Bihor",56,"56-LUNCA",29948,351,2,397,342,311,31,340,2,"LUNCA",,2,,200,140
5,"Bihor",56,"56-LUNCA",29948,352,2,330,281,243,38,281,0,"LUNCA",,2,,187,94
5,"Bihor",56,"56-LUNCA",29948,353,2,565,400,348,52,396,4,"LUNCA",,2,,191,205
5,"Bihor",56,"56-MADARAS",30014,354,2,693,549,470,79,544,5,"MADARAS",,2,,297,247
5,"Bihor",56,"56-MADARAS",30014,355,2,159,152,99,53,149,3,"MADARAS",,2,,57,92
5,"Bihor",56,"56-MADARAS",30014,356,2,548,544,436,108,541,3,"MADARAS",,2,,319,222
5,"Bihor",56,"56-MADARAS",30014,357,2,887,839,707,132,835,4,"MADARAS",,2,,598,237
5,"Bihor",56,"56-MAGESTI",30069,358,2,834,621,570,51,618,3,"MAGESTI",,2,,227,391
5,"Bihor",56,"56-MAGESTI",30069,359,2,483,380,353,27,374,6,"MAGESTI",,2,,168,206
5,"Bihor",56,"56-MAGESTI",30069,360,2,284,203,187,16,203,0,"MAGESTI",,2,,59,144
5,"Bihor",56,"56-MAGESTI",30069,361,2,655,485,429,56,484,1,"MAGESTI",,2,,128,356
5,"Bihor",56,"56-NOJORID",30149,362,2,1156,874,667,207,869,5,"NOJORID",,2,,367,502
5,"Bihor",56,"56-NOJORID",30149,363,2,210,194,121,73,189,5,"NOJORID",,2,,85,104
5,"Bihor",56,"56-NOJORID",30149,364,2,105,105,59,46,105,0,"NOJORID",,2,,73,32
5,"Bihor",56,"56-NOJORID",30149,365,2,366,276,182,94,272,4,"NOJORID",,2,,100,172
5,"Bihor",56,"56-NOJORID",30149,366,2,686,690,528,162,687,3,"NOJORID",,2,,194,493
5,"Bihor",56,"56-NOJORID",30149,367,2,203,181,122,59,178,3,"NOJORID",,2,,122,56
5,"Bihor",56,"56-NOJORID",30149,368,2,272,220,157,63,215,5,"NOJORID",,2,,88,127
5,"Bihor",56,"56-OLCEA",30229,369,2,487,475,409,66,473,2,"OLCEA",,2,,358,115
5,"Bihor",56,"56-OLCEA",30229,370,2,915,727,667,60,719,8,"OLCEA",,2,,349,370
5,"Bihor",56,"56-OLCEA",30229,371,2,351,325,303,22,309,16,"OLCEA",,2,,249,60
5,"Bihor",56,"56-OLCEA",30229,372,2,408,452,346,106,447,5,"OLCEA",,2,,279,168
5,"Bihor",56,"56-OSORHEI",30274,373,2,1841,1367,1363,4,1354,13,"OSORHEI",,2,,297,1057
5,"Bihor",56,"56-OSORHEI",30274,374,2,711,638,491,147,633,5,"OSORHEI",,2,,368,265
5,"Bihor",56,"56-OSORHEI",30274,375,2,324,348,236,112,341,7,"OSORHEI",,2,,190,151
5,"Bihor",56,"56-OSORHEI",30274,376,2,282,299,204,95,294,5,"OSORHEI",,2,,195,99
5,"Bihor",56,"56-OSORHEI",30274,377,2,612,495,399,96,489,6,"OSORHEI",,2,,54,435
5,"Bihor",56,"56-PIETROASA",30336,378,2,1704,1298,1245,53,1287,11,"PIETROASA",,2,,698,589
5,"Bihor",56,"56-PIETROASA",30336,379,2,1098,1028,990,38,1023,5,"PIETROASA",,2,,733,290
5,"Bihor",56,"56-POCOLA",30416,380,2,1442,948,879,69,941,7,"POCOLA",,2,,559,382
5,"Bihor",56,"56-POMEZEU",30470,381,2,1160,729,672,57,721,8,"POMEZEU",,2,,523,198
5,"Bihor",56,"56-POMEZEU",30470,382,2,1004,872,797,75,869,3,"POMEZEU",,2,,639,230
5,"Bihor",56,"56-POMEZEU",30470,383,2,931,731,656,75,724,7,"POMEZEU",,2,,520,204
5,"Bihor",56,"56-POPESTI",30568,384,2,1810,1363,1250,113,1352,11,"POPESTI",,2,,640,712
5,"Bihor",56,"56-POPESTI",30568,385,2,797,501,434,67,496,5,"POPESTI",,2,,307,189
5,"Bihor",56,"56-POPESTI",30568,386,2,841,457,383,74,452,5,"POPESTI",,2,,176,276
5,"Bihor",56,"56-POPESTI",30568,387,2,966,666,626,40,656,10,"POPESTI",,2,,359,297
5,"Bihor",56,"56-POPESTI",30568,388,2,500,381,332,49,373,8,"POPESTI",,2,,222,151
5,"Bihor",56,"56-POPESTI",30568,389,2,291,217,187,30,210,7,"POPESTI",,2,,95,115
5,"Bihor",56,"56-POPESTI",30568,390,2,1409,986,843,143,972,14,"POPESTI",,2,,651,321
5,"Bihor",56,"56-RABAGAMI",30648,391,2,1015,686,606,80,683,3,"RABAGAMI",,2,,473,210
5,"Bihor",56,"56-RABAGAMI",30648,392,2,625,365,316,49,364,1,"RABAGAMI",,2,,279,85
5,"Bihor",56,"56-RABAGAMI",30648,393,2,406,338,299,39,334,4,"RABAGAMI",,2,,257,77
5,"Bihor",56,"56-REMETEA",30719,394,2,1096,824,738,86,821,3,"REMETEA",,2,,358,463
5,"Bihor",56,"56-REMETEA",30719,395,2,1017,639,585,54,625,14,"REMETEA",,2,,342,283
5,"Bihor",56,"56-REMETEA",30719,396,2,440,369,278,91,362,7,"REMETEA",,2,,249,113
5,"Bihor",56,"56-RIENI",30773,397,2,1270,839,779,60,828,11,"RIENI",,2,,405,423
5,"Bihor",56,"56-RIENI",30773,398,2,1282,818,794,24,813,5,"RIENI",,2,,434,379
5,"Bihor",56,"56-ROSIA",30844,399,2,2213,1763,1725,38,1738,25,"ROSIA",,2,,1236,502
5,"Bihor",56,"56-SACADAT",30871,400,2,913,722,585,137,719,3,"SACADAT",,2,,389,330
5,"Bihor",56,"56-SACADAT",30871,401,2,545,480,409,71,473,7,"SACADAT",,2,,183,290
5,"Bihor",56,"56-SACUIENI",30915,402,2,2096,1264,1081,183,1258,6,"SACUIENI",,2,,58,1200
5,"Bihor",56,"56-SACUIENI",30915,403,2,1431,1114,883,231,1102,12,"SACUIENI",,2,,43,1059
5,"Bihor",56,"56-SACUIENI",30915,404,2,1001,725,577,148,721,4,"SACUIENI",,2,,43,678
5,"Bihor",56,"56-SACUIENI",30915,405,2,942,572,493,79,566,6,"SACUIENI",,2,,53,513
5,"Bihor",56,"56-SACUIENI",30915,406,2,823,549,490,59,543,6,"SACUIENI",,2,,17,526
5,"Bihor",56,"56-SACUIENI",30915,407,2,735,564,524,40,554,10,"SACUIENI",,2,,33,521
5,"Bihor",56,"56-SACUIENI",30915,408,2,770,494,457,37,482,12,"SACUIENI",,2,,8,474
5,"Bihor",56,"56-SACUIENI",30915,409,2,236,265,243,22,262,3,"SACUIENI",,2,,12,250
5,"Bihor",56,"56-SACUIENI",30915,410,2,685,423,382,41,399,24,"SACUIENI",,2,,21,378
5,"Bihor",56,"56-SALACEA",30988,411,2,1939,952,876,76,947,5,"SALACEA",,2,,22,925
5,"Bihor",56,"56-SALACEA",30988,412,2,602,448,384,64,443,5,"SALACEA",,2,,26,417
5,"Bihor",56,"56-SALARD",31011,413,2,1980,1295,1079,216,1284,11,"SALARD",,2,,257,1027
5,"Bihor",56,"56-SALARD",31011,414,2,1073,548,510,38,544,4,"SALARD",,2,,13,531
5,"Bihor",56,"56-SAMBATA",31057,415,2,1463,1045,922,123,1032,13,"SAMBATA",,2,,650,382
5,"Bihor",56,"56-SANMARTIN",26582,416,2,1983,1530,1076,454,1527,3,"SANMARTIN",,2,,534,993
5,"Bihor",56,"56-SANMARTIN",26582,417,2,332,281,244,37,272,9,"SANMARTIN",,2,,147,125
5,"Bihor",56,"56-SANMARTIN",26582,418,2,658,533,460,73,533,0,"SANMARTIN",,2,,288,245
5,"Bihor",56,"56-SANMARTIN",26582,419,2,827,653,548,105,638,15,"SANMARTIN",,2,,270,368
5,"Bihor",56,"56-SANMARTIN",26582,420,2,399,1737,153,1584,1728,9,"SANMARTIN",,2,,731,997
5,"Bihor",56,"56-SANMARTIN",26582,421,2,1181,1074,771,303,1067,7,"SANMARTIN",,2,,487,580
5,"Bihor",56,"56-SANTANDREI",26653,422,2,2149,1726,1491,235,1720,6,"SANTANDREI",,2,,863,857
5,"Bihor",56,"56-SANTANDREI",26653,423,2,508,326,262,64,321,5,"SANTANDREI",,2,,23,298
5,"Bihor",56,"56-SARBI",31128,424,2,1425,1043,852,191,1039,4,"SARBI",,2,,499,540
5,"Bihor",56,"56-SARBI",31128,425,2,1087,743,662,81,736,7,"SARBI",,2,,275,461
5,"Bihor",56,"56-SPINUS",31208,426,2,813,519,445,74,517,2,"SPINUS",,2,,236,281
5,"Bihor",56,"56-SPINUS",31208,427,2,366,312,259,53,312,0,"SPINUS",,2,,134,178
5,"Bihor",56,"56-SUPLACU DE BARCAU",31262,428,2,2412,1581,1268,313,1573,8,"SUPLACU DE BARCAU",,2,,323,1250
5,"Bihor",56,"56-SUPLACU DE BARCAU",31262,429,2,855,507,431,76,490,17,"SUPLACU DE BARCAU",,2,,285,205
5,"Bihor",56,"56-SUPLACU DE BARCAU",31262,430,2,730,444,439,5,435,9,"SUPLACU DE BARCAU",,2,,98,337
5,"Bihor",56,"56-SIMIAN",31333,431,2,2010,1474,1186,288,1459,15,"SIMIAN",,2,,66,1393
5,"Bihor",56,"56-SIMIAN",31333,432,2,868,641,467,174,629,12,"SIMIAN",,2,,43,586
5,"Bihor",56,"56-SIMIAN",31333,433,2,400,339,225,114,334,5,"SIMIAN",,2,,89,245
5,"Bihor",56,"56-SINTEU",31379,434,2,1128,537,507,30,526,11,"SINTEU",,2,,55,471
5,"Bihor",56,"56-SOIMI",31422,435,2,591,452,376,76,444,8,"SOIMI",,2,,241,203
5,"Bihor",56,"56-SOIMI",31422,436,2,316,235,203,32,233,2,"SOIMI",,2,,145,88
5,"Bihor",56,"56-SOIMI",31422,437,2,246,167,157,10,167,0,"SOIMI",,2,,110,57
5,"Bihor",56,"56-SOIMI",31422,438,2,1040,689,613,76,682,7,"SOIMI",,2,,508,174
5,"Bihor",56,"56-SOIMI",31422,439,2,388,251,200,51,246,5,"SOIMI",,2,,160,86
5,"Bihor",56,"56-SUNCUIUS",31510,440,2,1319,1112,889,223,1102,10,"SUNCUIUS",,2,,600,502
5,"Bihor",56,"56-SUNCUIUS",31510,441,2,848,638,530,108,630,8,"SUNCUIUS",,2,,340,290
5,"Bihor",56,"56-SUNCUIUS",31510,442,2,153,89,65,24,89,0,"SUNCUIUS",,2,,45,44
5,"Bihor",56,"56-SUNCUIUS",31510,443,2,285,147,118,29,143,4,"SUNCUIUS",,2,,91,52
5,"Bihor",56,"56-SUNCUIUS",31510,444,2,230,185,108,77,182,3,"SUNCUIUS",,2,,111,71
5,"Bihor",56,"56-TARCEA",31565,445,2,729,518,423,95,512,6,"TARCEA",,2,,82,430
5,"Bihor",56,"56-TARCEA",31565,446,2,649,372,332,40,372,0,"TARCEA",,2,,23,349
5,"Bihor",56,"56-TARCEA",31565,447,2,815,511,432,79,507,4,"TARCEA",,2,,50,457
5,"Bihor",56,"56-TARCAIA",31609,448,2,1181,1036,977,59,1033,3,"TARCAIA",,2,,138,895
5,"Bihor",56,"56-TARCAIA",31609,449,2,564,357,303,54,351,6,"TARCAIA",,2,,153,198
5,"Bihor",56,"56-TAUTEU",31654,450,2,896,764,708,56,763,1,"TAUTEU",,2,,44,719
5,"Bihor",56,"56-TAUTEU",31654,451,2,657,526,362,164,498,28,"TAUTEU",,2,,226,272
5,"Bihor",56,"56-TAUTEU",31654,452,2,901,752,688,64,743,9,"TAUTEU",,2,,398,345
5,"Bihor",56,"56-TAUTEU",31654,453,2,715,552,514,38,547,5,"TAUTEU",,2,,232,315
5,"Bihor",56,"56-TILEAGD",31716,454,2,2600,1910,1227,683,1899,11,"TILEAGD",,2,,409,1490
5,"Bihor",56,"56-TILEAGD",31716,455,2,1124,660,510,150,651,9,"TILEAGD",,2,,105,546
5,"Bihor",56,"56-TILEAGD",31716,456,2,662,444,403,41,438,6,"TILEAGD",,2,,210,228
5,"Bihor",56,"56-TILEAGD",31716,457,2,745,651,557,94,644,7,"TILEAGD",,2,,294,350
5,"Bihor",56,"56-TINCA",31789,458,2,1396,1101,950,151,1097,4,"TINCA",,2,,369,728
5,"Bihor",56,"56-TINCA",31789,459,2,1761,1396,1216,180,1380,16,"TINCA",,2,,548,832
5,"Bihor",56,"56-TINCA",31789,460,2,994,709,612,97,704,5,"TINCA",,2,,334,370
5,"Bihor",56,"56-TINCA",31789,461,2,539,404,355,49,401,3,"TINCA",,2,,240,161
5,"Bihor",56,"56-TINCA",31789,462,2,383,284,227,57,279,5,"TINCA",,2,,18,261
5,"Bihor",56,"56-TINCA",31789,463,2,633,560,456,104,551,9,"TINCA",,2,,386,165
5,"Bihor",56,"56-TULCA",31841,464,2,1896,1471,1304,167,1457,14,"TULCA",,2,,815,642
5,"Bihor",56,"56-TULCA",31841,465,2,383,346,283,63,344,2,"TULCA",,2,,194,150
5,"Bihor",56,"56-TETCHEA",31878,466,2,1051,786,717,69,776,10,"TETCHEA",,2,,299,477
5,"Bihor",56,"56-TETCHEA",31878,467,2,1214,864,715,149,856,8,"TETCHEA",,2,,417,439
5,"Bihor",56,"56-UILEACU DE BEIUS",31921,468,2,594,495,435,60,494,1,"UILEACU DE BEIUS",,2,,122,372
5,"Bihor",56,"56-UILEACU DE BEIUS",31921,469,2,885,709,687,22,698,11,"UILEACU DE BEIUS",,2,,517,181
5,"Bihor",56,"56-UILEACU DE BEIUS",31921,470,2,478,416,416,0,416,0,"UILEACU DE BEIUS",,2,,330,86
5,"Bihor",56,"56-UILEACU DE BEIUS",31921,471,2,264,252,226,26,249,3,"UILEACU DE BEIUS",,2,,131,118
5,"Bihor",56,"56-VADU CRISULUI",31976,472,2,1770,1110,1078,32,1100,10,"VADU CRISULUI",,2,,277,823
5,"Bihor",56,"56-VADU CRISULUI",31976,473,2,1352,1081,872,209,1070,11,"VADU CRISULUI",,2,,358,712
5,"Bihor",56,"56-VADU CRISULUI",31976,474,2,336,174,160,14,174,0,"VADU CRISULUI",,2,,93,81
5,"Bihor",56,"56-VIISOARA",32045,475,2,829,591,557,34,588,3,"VIISOARA",,2,,89,499
5,"Bihor",56,"56-VIISOARA",32045,476,2,237,170,157,13,169,1,"VIISOARA",,2,,54,115
5,"Bihor",56,"56-VARCIOROG",32090,477,2,957,654,594,60,642,12,"VARCIOROG",,2,,341,301
5,"Bihor",56,"56-VARCIOROG",32090,478,2,473,370,337,33,367,3,"VARCIOROG",,2,,202,165
5,"Bihor",56,"56-VARCIOROG",32090,479,2,558,433,395,38,429,4,"VARCIOROG",,2,,262,167
6,"Bistrița-Năsăud",65,"65-MUNICIPIUL BISTRITA",32394,1,2,1701,1343,1229,114,1337,6,"MUNICIPIUL BISTRITA",,7,,389,948
6,"Bistrița-Năsăud",65,"65-MUNICIPIUL BISTRITA",32394,2,2,1960,1476,1288,188,1467,9,"MUNICIPIUL BISTRITA",,7,,330,1137
6,"Bistrița-Năsăud",65,"65-MUNICIPIUL BISTRITA",32394,3,2,1768,1268,1172,96,1264,4,"MUNICIPIUL BISTRITA",,7,,268,996
6,"Bistrița-Năsăud",65,"65-MUNICIPIUL BISTRITA",32394,4,2,2043,1522,1458,64,1517,5,"MUNICIPIUL BISTRITA",,7,,307,1210
6,"Bistrița-Năsăud",65,"65-MUNICIPIUL BISTRITA",32394,5,2,1701,1318,1176,142,1313,5,"MUNICIPIUL BISTRITA",,7,,276,1037
6,"Bistrița-Năsăud",65,"65-MUNICIPIUL BISTRITA",32394,6,2,2000,1413,1347,66,1412,1,"MUNICIPIUL BISTRITA",,7,,344,1068
6,"Bistrița-Năsăud",65,"65-MUNICIPIUL BISTRITA",32394,7,2,1378,949,866,83,942,7,"MUNICIPIUL BISTRITA",,7,,194,748
6,"Bistrița-Năsăud",65,"65-MUNICIPIUL BISTRITA",32394,8,2,1943,1341,1260,81,1337,4,"MUNICIPIUL BISTRITA",,7,,424,913
6,"Bistrița-Năsăud",65,"65-MUNICIPIUL BISTRITA",32394,9,2,1994,1480,1374,106,1477,3,"MUNICIPIUL BISTRITA",,7,,356,1121
6,"Bistrița-Năsăud",65,"65-MUNICIPIUL BISTRITA",32394,10,2,1025,751,697,54,747,4,"MUNICIPIUL BISTRITA",,7,,198,549
6,"Bistrița-Năsăud",65,"65-MUNICIPIUL BISTRITA",32394,11,2,997,748,687,61,748,0,"MUNICIPIUL BISTRITA",,7,,140,608
6,"Bistrița-Năsăud",65,"65-MUNICIPIUL BISTRITA",32394,12,2,1818,1583,1234,349,1578,5,"MUNICIPIUL BISTRITA",,7,,302,1276
6,"Bistrița-Năsăud",65,"65-MUNICIPIUL BISTRITA",32394,13,2,1925,1576,1353,223,1571,5,"MUNICIPIUL BISTRITA",,7,,433,1138
6,"Bistrița-Năsăud",65,"65-MUNICIPIUL BISTRITA",32394,14,2,1470,1224,1071,153,1221,3,"MUNICIPIUL BISTRITA",,7,,299,922
6,"Bistrița-Năsăud",65,"65-MUNICIPIUL BISTRITA",32394,15,2,1188,1088,866,222,1085,3,"MUNICIPIUL BISTRITA",,7,,280,805
6,"Bistrița-Năsăud",65,"65-MUNICIPIUL BISTRITA",32394,16,2,1611,1261,1059,202,1254,7,"MUNICIPIUL BISTRITA",,7,,284,970
6,"Bistrița-Năsăud",65,"65-MUNICIPIUL BISTRITA",32394,17,2,1527,1092,953,139,1088,4,"MUNICIPIUL BISTRITA",,7,,276,812
6,"Bistrița-Năsăud",65,"65-MUNICIPIUL BISTRITA",32394,18,2,1872,1250,1166,84,1247,3,"MUNICIPIUL BISTRITA",,7,,293,954
6,"Bistrița-Năsăud",65,"65-MUNICIPIUL BISTRITA",32394,19,2,1655,1257,1175,82,1254,3,"MUNICIPIUL BISTRITA",,7,,341,913
6,"Bistrița-Năsăud",65,"65-MUNICIPIUL BISTRITA",32394,20,2,1437,1115,967,148,1111,4,"MUNICIPIUL BISTRITA",,7,,330,781
6,"Bistrița-Năsăud",65,"65-MUNICIPIUL BISTRITA",32394,21,2,1911,1387,1269,118,1383,4,"MUNICIPIUL BISTRITA",,7,,298,1085
6,"Bistrița-Năsăud",65,"65-MUNICIPIUL BISTRITA",32394,22,2,1905,1538,1428,110,1534,4,"MUNICIPIUL BISTRITA",,7,,467,1067
6,"Bistrița-Năsăud",65,"65-MUNICIPIUL BISTRITA",32394,23,2,1923,1362,1264,98,1354,8,"MUNICIPIUL BISTRITA",,7,,294,1060
6,"Bistrița-Năsăud",65,"65-MUNICIPIUL BISTRITA",32394,24,2,1945,1507,1303,204,1505,2,"MUNICIPIUL BISTRITA",,7,,324,1181
6,"Bistrița-Năsăud",65,"65-MUNICIPIUL BISTRITA",32394,25,2,1890,1377,1283,94,1374,3,"MUNICIPIUL BISTRITA",,7,,399,975
6,"Bistrița-Năsăud",65,"65-MUNICIPIUL BISTRITA",32394,26,2,1840,1423,1372,51,1417,6,"MUNICIPIUL BISTRITA",,7,,394,1023
6,"Bistrița-Năsăud",65,"65-MUNICIPIUL BISTRITA",32394,27,2,2055,1533,1435,98,1528,5,"MUNICIPIUL BISTRITA",,7,,380,1148
6,"Bistrița-Năsăud",65,"65-MUNICIPIUL BISTRITA",32394,28,2,1959,1467,1365,102,1466,1,"MUNICIPIUL BISTRITA",,7,,359,1107
6,"Bistrița-Năsăud",65,"65-MUNICIPIUL BISTRITA",32394,29,2,1900,1313,1198,115,1310,3,"MUNICIPIUL BISTRITA",,7,,275,1035
6,"Bistrița-Năsăud",65,"65-MUNICIPIUL BISTRITA",32394,30,2,1965,1460,1347,113,1455,5,"MUNICIPIUL BISTRITA",,7,,316,1139
6,"Bistrița-Năsăud",65,"65-MUNICIPIUL BISTRITA",32394,31,2,2078,1880,1535,345,1873,7,"MUNICIPIUL BISTRITA",,7,,448,1425
6,"Bistrița-Năsăud",65,"65-MUNICIPIUL BISTRITA",32394,32,2,1801,1117,1021,96,1115,2,"MUNICIPIUL BISTRITA",,7,,248,867
6,"Bistrița-Năsăud",65,"65-MUNICIPIUL BISTRITA",32394,33,2,1999,1583,1412,171,1579,4,"MUNICIPIUL BISTRITA",,7,,329,1250
6,"Bistrița-Năsăud",65,"65-MUNICIPIUL BISTRITA",32394,34,2,290,201,153,48,200,1,"MUNICIPIUL BISTRITA",,7,,47,153
6,"Bistrița-Năsăud",65,"65-MUNICIPIUL BISTRITA",32394,35,2,0,999,0,999,961,38,"MUNICIPIUL BISTRITA",,7,,452,509
6,"Bistrița-Năsăud",65,"65-MUNICIPIUL BISTRITA",32394,36,2,0,553,0,553,550,3,"MUNICIPIUL BISTRITA",,7,,128,422
6,"Bistrița-Năsăud",65,"65-MUNICIPIUL BISTRITA",32394,37,2,1101,906,794,112,898,8,"MUNICIPIUL BISTRITA",,7,,213,685
6,"Bistrița-Năsăud",65,"65-MUNICIPIUL BISTRITA",32394,38,2,470,376,308,68,374,2,"MUNICIPIUL BISTRITA",,7,,92,282
6,"Bistrița-Năsăud",65,"65-MUNICIPIUL BISTRITA",32394,39,2,418,361,269,92,359,2,"MUNICIPIUL BISTRITA",,7,,108,251
6,"Bistrița-Năsăud",65,"65-MUNICIPIUL BISTRITA",32394,40,2,390,412,285,127,410,2,"MUNICIPIUL BISTRITA",,7,,117,293
6,"Bistrița-Năsăud",65,"65-MUNICIPIUL BISTRITA",32394,41,2,628,579,455,124,573,6,"MUNICIPIUL BISTRITA",,7,,116,457
6,"Bistrița-Năsăud",65,"65-MUNICIPIUL BISTRITA",32394,42,2,835,656,566,90,649,7,"MUNICIPIUL BISTRITA",,7,,198,451
6,"Bistrița-Năsăud",65,"65-ORAS BECLEAN",32483,43,2,1134,895,780,115,890,5,"ORAS BECLEAN",,7,,226,664
6,"Bistrița-Năsăud",65,"65-ORAS BECLEAN",32483,44,2,974,843,705,138,835,8,"ORAS BECLEAN",,7,,228,607
6,"Bistrița-Năsăud",65,"65-ORAS BECLEAN",32483,45,2,1632,1214,1109,105,1209,5,"ORAS BECLEAN",,7,,276,933
6,"Bistrița-Năsăud",65,"65-ORAS BECLEAN",32483,46,2,1426,1128,993,135,1123,5,"ORAS BECLEAN",,7,,333,790
6,"Bistrița-Năsăud",65,"65-ORAS BECLEAN",32483,47,2,1189,909,847,62,905,4,"ORAS BECLEAN",,7,,216,689
6,"Bistrița-Năsăud",65,"65-ORAS BECLEAN",32483,48,2,286,244,210,34,242,2,"ORAS BECLEAN",,7,,67,175
6,"Bistrița-Năsăud",65,"65-ORAS BECLEAN",32483,49,2,519,446,377,69,444,2,"ORAS BECLEAN",,7,,60,384
6,"Bistrița-Năsăud",65,"65-ORAS BECLEAN",32483,50,2,366,356,326,30,350,6,"ORAS BECLEAN",,7,,152,198
6,"Bistrița-Năsăud",65,"65-ORAS BECLEAN",32483,51,2,276,240,214,26,238,2,"ORAS BECLEAN",,7,,132,106
6,"Bistrița-Năsăud",65,"65-ORAS NASAUD",32544,52,2,2021,1476,1328,148,1467,9,"ORAS NASAUD",,7,,491,976
6,"Bistrița-Năsăud",65,"65-ORAS NASAUD",32544,53,2,2436,1586,1443,143,1578,8,"ORAS NASAUD",,7,,466,1112
6,"Bistrița-Năsăud",65,"65-ORAS NASAUD",32544,54,2,2325,1766,1574,192,1757,9,"ORAS NASAUD",,7,,517,1240
6,"Bistrița-Năsăud",65,"65-ORAS NASAUD",32544,55,2,495,401,352,49,399,2,"ORAS NASAUD",,7,,138,261
6,"Bistrița-Năsăud",65,"65-ORAS NASAUD",32544,56,2,908,655,613,42,651,4,"ORAS NASAUD",,7,,205,446
6,"Bistrița-Năsăud",65,"65-ORAS NASAUD",32544,57,2,621,564,508,56,557,7,"ORAS NASAUD",,7,,157,400
6,"Bistrița-Năsăud",65,"65-ORAS SANGEORZ-BAI",32599,58,2,1753,1270,1118,152,1263,7,"ORAS SANGEORZ-BAI",,7,,399,864
6,"Bistrița-Năsăud",65,"65-ORAS SANGEORZ-BAI",32599,59,2,1675,1162,1096,66,1159,3,"ORAS SANGEORZ-BAI",,7,,330,829
6,"Bistrița-Năsăud",65,"65-ORAS SANGEORZ-BAI",32599,60,2,1644,1389,996,393,1380,9,"ORAS SANGEORZ-BAI",,7,,446,934
6,"Bistrița-Năsăud",65,"65-ORAS SANGEORZ-BAI",32599,61,2,1631,1002,927,75,995,7,"ORAS SANGEORZ-BAI",,7,,367,628
6,"Bistrița-Năsăud",65,"65-ORAS SANGEORZ-BAI",32599,62,2,463,276,257,19,272,4,"ORAS SANGEORZ-BAI",,7,,121,151
6,"Bistrița-Năsăud",65,"65-BISTRITA BARGAULUI",32633,63,2,1280,1016,805,211,1006,10,"BISTRITA BARGAULUI",,7,,311,695
6,"Bistrița-Năsăud",65,"65-BISTRITA BARGAULUI",32633,64,2,1636,961,826,135,955,6,"BISTRITA BARGAULUI",,7,,245,710
6,"Bistrița-Năsăud",65,"65-BISTRITA BARGAULUI",32633,65,2,249,255,117,138,255,0,"BISTRITA BARGAULUI",,7,,106,149
6,"Bistrița-Năsăud",65,"65-BRANISTEA",32660,66,2,1000,828,754,74,822,6,"BRANISTEA",,7,,155,667
6,"Bistrița-Năsăud",65,"65-BRANISTEA",32660,67,2,1353,1126,1089,37,1123,3,"BRANISTEA",,7,,42,1081
6,"Bistrița-Năsăud",65,"65-BRANISTEA",32660,68,2,534,482,460,22,478,4,"BRANISTEA",,7,,204,274
6,"Bistrița-Năsăud",65,"65-BUDACU DE JOS",32704,69,2,1055,745,635,110,741,4,"BUDACU DE JOS",,7,,279,462
6,"Bistrița-Năsăud",65,"65-BUDACU DE JOS",32704,70,2,510,421,338,83,410,11,"BUDACU DE JOS",,7,,150,260
6,"Bistrița-Năsăud",65,"65-BUDACU DE JOS",32704,71,2,479,399,332,67,396,3,"BUDACU DE JOS",,7,,142,254
6,"Bistrița-Năsăud",65,"65-BUDESTI",32768,72,2,578,437,389,48,432,5,"BUDESTI",,7,,228,204
6,"Bistrița-Năsăud",65,"65-BUDESTI",32768,73,2,334,257,234,23,255,2,"BUDESTI",,7,,85,170
6,"Bistrița-Năsăud",65,"65-BUDESTI",32768,74,2,594,440,392,48,436,4,"BUDESTI",,7,,234,202
6,"Bistrița-Năsăud",65,"65-BUDESTI",32768,75,2,329,256,231,25,253,3,"BUDESTI",,7,,155,98
6,"Bistrița-Năsăud",65,"65-CAIANU MIC",32811,76,2,1156,801,725,76,795,6,"CAIANU MIC",,7,,459,336
6,"Bistrița-Năsăud",65,"65-CAIANU MIC",32811,77,2,532,383,314,69,372,11,"CAIANU MIC",,7,,206,166
6,"Bistrița-Năsăud",65,"65-CAIANU MIC",32811,78,2,761,519,461,58,512,7,"CAIANU MIC",,7,,299,213
6,"Bistrița-Năsăud",65,"65-CAIANU MIC",32811,79,2,697,530,482,48,527,3,"CAIANU MIC",,7,,190,337
6,"Bistrița-Năsăud",65,"65-CETATE",32884,80,2,1748,1198,1112,86,1189,9,"CETATE",,7,,250,939
6,"Bistrița-Năsăud",65,"65-CETATE",32884,81,2,818,546,473,73,541,5,"CETATE",,7,,76,465
6,"Bistrița-Năsăud",65,"65-CETATE",32884,82,2,1184,794,717,77,788,6,"CETATE",,7,,115,673
6,"Bistrița-Năsăud",65,"65-CICEU-GIURGESTI",32955,83,2,930,751,701,50,743,8,"CICEU-GIURGESTI",,7,,280,463
6,"Bistrița-Năsăud",65,"65-CICEU-GIURGESTI",32955,84,2,682,557,491,66,556,1,"CICEU-GIURGESTI",,7,,296,260
6,"Bistrița-Năsăud",65,"65-CICEU-GIURGESTI",32955,85,2,1255,1065,945,120,1054,11,"CICEU-GIURGESTI",,7,,510,544
6,"Bistrița-Năsăud",65,"65-CICEU-GIURGESTI",32955,86,2,853,719,684,35,718,1,"CICEU-GIURGESTI",,7,,326,392
6,"Bistrița-Năsăud",65,"65-CHIOCHIS",33015,87,2,1139,725,640,85,724,1,"CHIOCHIS",,7,,299,425
6,"Bistrița-Năsăud",65,"65-CHIOCHIS",33015,88,2,876,615,568,47,613,2,"CHIOCHIS",,7,,232,381
6,"Bistrița-Năsăud",65,"65-CHIOCHIS",33015,89,2,384,245,215,30,245,0,"CHIOCHIS",,7,,137,108
6,"Bistrița-Năsăud",65,"65-CHIOCHIS",33015,90,2,645,400,337,63,395,5,"CHIOCHIS",,7,,251,144
6,"Bistrița-Năsăud",65,"65-CHIUZA",33122,91,2,1244,1003,925,78,999,4,"CHIUZA",,7,,420,579
6,"Bistrița-Năsăud",65,"65-CHIUZA",33122,92,2,422,355,324,31,347,8,"CHIUZA",,7,,151,196
6,"Bistrița-Năsăud",65,"65-CHIUZA",33122,93,2,136,130,111,19,128,2,"CHIUZA",,7,,79,49
6,"Bistrița-Năsăud",65,"65-COSBUC",33177,94,2,1582,1155,1106,49,1148,7,"COSBUC",,7,,734,414
6,"Bistrița-Năsăud",65,"65-DUMITRA",33202,95,2,1727,1222,1137,85,1209,13,"DUMITRA",,7,,356,853
6,"Bistrița-Năsăud",65,"65-DUMITRA",33202,96,2,509,396,319,77,396,0,"DUMITRA",,7,,111,285
6,"Bistrița-Năsăud",65,"65-DUMITRA",33202,97,2,639,475,409,66,471,4,"DUMITRA",,7,,142,329
6,"Bistrița-Năsăud",65,"65-FELDRU",33248,98,2,1285,797,766,31,795,2,"FELDRU",,7,,164,631
6,"Bistrița-Năsăud",65,"65-FELDRU",33248,99,2,1550,871,842,29,867,4,"FELDRU",,7,,164,703
6,"Bistrița-Năsăud",65,"65-FELDRU",33248,100,2,1467,976,941,35,971,5,"FELDRU",,7,,233,738
6,"Bistrița-Năsăud",65,"65-FELDRU",33248,101,2,1210,921,811,110,913,8,"FELDRU",,7,,222,691
6,"Bistrița-Năsăud",65,"65-GALATII BISTRITEI",33275,102,2,502,404,357,47,403,1,"GALATII BISTRITEI",,7,,221,182
6,"Bistrița-Năsăud",65,"65-GALATII BISTRITEI",33275,103,2,613,512,455,57,510,2,"GALATII BISTRITEI",,7,,198,312
6,"Bistrița-Năsăud",65,"65-GALATII BISTRITEI",33275,104,2,351,343,281,62,342,1,"GALATII BISTRITEI",,7,,145,197
6,"Bistrița-Năsăud",65,"65-GALATII BISTRITEI",33275,105,2,144,128,110,18,128,0,"GALATII BISTRITEI",,7,,62,66
6,"Bistrița-Năsăud",65,"65-GALATII BISTRITEI",33275,106,2,235,228,211,17,228,0,"GALATII BISTRITEI",,7,,2,226
6,"Bistrița-Năsăud",65,"65-ILVA MARE",33337,107,2,1929,1091,992,99,1081,10,"ILVA MARE",,7,,428,653
6,"Bistrița-Năsăud",65,"65-ILVA MICA",33364,108,2,1276,812,682,130,808,4,"ILVA MICA",,7,,298,510
6,"Bistrița-Năsăud",65,"65-ILVA MICA",33364,109,2,1449,876,796,80,873,3,"ILVA MICA",,7,,214,659
6,"Bistrița-Năsăud",65,"65-JOSENII BARGAULUI",33382,110,2,2737,2013,1882,131,1990,23,"JOSENII BARGAULUI",,7,,671,1319
6,"Bistrița-Năsăud",65,"65-JOSENII BARGAULUI",33382,111,2,854,754,641,113,746,8,"JOSENII BARGAULUI",,7,,413,333
6,"Bistrița-Năsăud",65,"65-LECHINTA",33435,112,2,2051,1550,1348,202,1543,7,"LECHINTA",,7,,670,873
6,"Bistrița-Năsăud",65,"65-LECHINTA",33435,113,2,387,312,257,55,307,5,"LECHINTA",,7,,96,211
6,"Bistrița-Năsăud",65,"65-LECHINTA",33435,114,2,189,169,130,39,167,2,"LECHINTA",,7,,90,77
6,"Bistrița-Năsăud",65,"65-LECHINTA",33435,115,2,346,330,288,42,325,5,"LECHINTA",,7,,36,289
6,"Bistrița-Năsăud",65,"65-LECHINTA",33435,116,2,654,463,383,80,459,4,"LECHINTA",,7,,191,268
6,"Bistrița-Năsăud",65,"65-LECHINTA",33435,117,2,811,593,483,110,586,7,"LECHINTA",,7,,252,334
6,"Bistrița-Năsăud",65,"65-LESU",33514,118,2,2206,1134,1099,35,1130,4,"LESU",,7,,477,653
6,"Bistrița-Năsăud",65,"65-LIVEZILE",33541,119,2,1654,1267,1103,164,1260,7,"LIVEZILE",,7,,242,1018
6,"Bistrița-Năsăud",65,"65-LIVEZILE",33541,120,2,574,435,371,64,427,8,"LIVEZILE",,7,,150,277
6,"Bistrița-Năsăud",65,"65-LIVEZILE",33541,121,2,443,376,309,67,373,3,"LIVEZILE",,7,,98,275
6,"Bistrița-Năsăud",65,"65-LUNCA ILVEI",33603,122,2,2676,1588,1420,168,1577,11,"LUNCA ILVEI",,7,,654,923
6,"Bistrița-Năsăud",65,"65-LUNCA ILVEI",33603,123,2,0,130,0,130,130,0,"LUNCA ILVEI",,7,,62,68
6,"Bistrița-Năsăud",65,"65-MAIERU",33621,124,2,2384,1563,1478,85,1557,6,"MAIERU",,7,,664,893
6,"Bistrița-Năsăud",65,"65-MAIERU",33621,125,2,1759,1117,1034,83,1111,6,"MAIERU",,7,,498,613
6,"Bistrița-Năsăud",65,"65-MAIERU",33621,126,2,1134,789,726,63,786,3,"MAIERU",,7,,372,414
6,"Bistrița-Năsăud",65,"65-MATEI",33658,127,2,813,651,579,72,642,9,"MATEI",,7,,166,476
6,"Bistrița-Năsăud",65,"65-MATEI",33658,128,2,567,409,360,49,404,5,"MATEI",,7,,94,310
6,"Bistrița-Năsăud",65,"65-MATEI",33658,129,2,731,484,457,27,480,4,"MATEI",,7,,265,215
6,"Bistrița-Năsăud",65,"65-MATEI",33658,130,2,544,328,285,43,327,1,"MATEI",,7,,180,147
6,"Bistrița-Năsăud",65,"65-MAGURA ILVEI",33729,131,2,1406,804,750,54,800,4,"MAGURA ILVEI",,7,,261,539
6,"Bistrița-Năsăud",65,"65-MAGURA ILVEI",33729,132,2,1375,914,853,61,906,8,"MAGURA ILVEI",,7,,467,439
6,"Bistrița-Năsăud",65,"65-MAGURA ILVEI",33729,133,2,349,234,207,27,233,1,"MAGURA ILVEI",,7,,112,121
6,"Bistrița-Năsăud",65,"65-MARISELU",33765,134,2,482,470,384,86,468,2,"MARISELU",,7,,223,245
6,"Bistrița-Năsăud",65,"65-MARISELU",33765,135,2,562,505,441,64,500,5,"MARISELU",,7,,178,322
6,"Bistrița-Năsăud",65,"65-MARISELU",33765,136,2,115,158,104,54,156,2,"MARISELU",,7,,16,140
6,"Bistrița-Năsăud",65,"65-MARISELU",33765,137,2,779,648,600,48,646,2,"MARISELU",,7,,262,384
6,"Bistrița-Năsăud",65,"65-MICESTII DE CAMPIE",33845,138,2,369,329,292,37,325,4,"MICESTII DE CAMPIE",,7,,211,114
6,"Bistrița-Năsăud",65,"65-MICESTII DE CAMPIE",33845,139,2,460,329,299,30,327,2,"MICESTII DE CAMPIE",,7,,100,227
6,"Bistrița-Năsăud",65,"65-MICESTII DE CAMPIE",33845,140,2,474,321,292,29,320,1,"MICESTII DE CAMPIE",,7,,168,152
6,"Bistrița-Năsăud",65,"65-MILAS",33881,141,2,862,551,472,79,544,7,"MILAS",,7,,293,251
6,"Bistrița-Năsăud",65,"65-MILAS",33881,142,2,619,413,371,42,408,5,"MILAS",,7,,238,170
6,"Bistrița-Năsăud",65,"65-MONOR",33952,143,2,1480,1083,1037,46,1082,1,"MONOR",,7,,629,453
6,"Bistrița-Năsăud",65,"65-NIMIGEA",33989,144,2,1232,916,859,57,911,5,"NIMIGEA",,7,,244,667
6,"Bistrița-Năsăud",65,"65-NIMIGEA",33989,145,2,602,538,517,21,535,3,"NIMIGEA",,7,,306,229
6,"Bistrița-Năsăud",65,"65-NIMIGEA",33989,146,2,603,450,417,33,441,9,"NIMIGEA",,7,,278,163
6,"Bistrița-Năsăud",65,"65-NIMIGEA",33989,147,2,493,391,357,34,389,2,"NIMIGEA",,7,,184,205
6,"Bistrița-Năsăud",65,"65-NIMIGEA",33989,148,2,393,316,278,38,314,2,"NIMIGEA",,7,,121,193
6,"Bistrița-Năsăud",65,"65-NIMIGEA",33989,149,2,476,376,342,34,369,7,"NIMIGEA",,7,,228,141
6,"Bistrița-Năsăud",65,"65-NIMIGEA",33989,150,2,245,233,213,20,232,1,"NIMIGEA",,7,,80,152
6,"Bistrița-Năsăud",65,"65-NIMIGEA",33989,151,2,353,260,223,37,257,3,"NIMIGEA",,7,,141,116
6,"Bistrița-Năsăud",65,"65-NUSENI",34075,152,2,1024,687,625,62,684,3,"NUSENI",,7,,220,464
6,"Bistrița-Năsăud",65,"65-NUSENI",34075,153,2,452,365,327,38,357,8,"NUSENI",,7,,94,263
6,"Bistrița-Năsăud",65,"65-NUSENI",34075,154,2,350,254,226,28,252,2,"NUSENI",,7,,157,95
6,"Bistrița-Năsăud",65,"65-NUSENI",34075,155,2,599,457,426,31,450,7,"NUSENI",,7,,245,205
6,"Bistrița-Năsăud",65,"65-NUSENI",34075,156,2,381,281,262,19,279,2,"NUSENI",,7,,17,262
6,"Bistrița-Năsăud",65,"65-PARVA",34155,157,2,1930,1044,1017,27,1034,10,"PARVA",,7,,144,890
6,"Bistrița-Năsăud",65,"65-PETRU RARES",34173,158,2,2004,1772,1644,128,1765,7,"PETRU RARES",,7,,450,1315
6,"Bistrița-Năsăud",65,"65-PETRU RARES",34173,159,2,678,566,527,39,564,2,"PETRU RARES",,7,,157,407
6,"Bistrița-Năsăud",65,"65-PETRU RARES",34173,160,2,736,555,496,59,551,4,"PETRU RARES",,7,,283,268
6,"Bistrița-Năsăud",65,"65-PETRU RARES",34173,161,2,186,182,144,38,181,1,"PETRU RARES",,7,,68,113
6,"Bistrița-Năsăud",65,"65-PETRU RARES",34173,162,2,184,173,130,43,172,1,"PETRU RARES",,7,,115,57
6,"Bistrița-Năsăud",65,"65-PRUNDU BARGAULUI",34235,163,2,2372,1818,1598,220,1807,11,"PRUNDU BARGAULUI",,7,,545,1262
6,"Bistrița-Năsăud",65,"65-PRUNDU BARGAULUI",34235,164,2,0,358,0,358,354,4,"PRUNDU BARGAULUI",,7,,160,194
6,"Bistrița-Năsăud",65,"65-PRUNDU BARGAULUI",34235,165,2,1306,1015,932,83,1006,9,"PRUNDU BARGAULUI",,7,,420,586
6,"Bistrița-Năsăud",65,"65-PRUNDU BARGAULUI",34235,166,2,1122,845,794,51,844,1,"PRUNDU BARGAULUI",,7,,355,489
6,"Bistrița-Năsăud",65,"65-REBRA",34262,167,2,1819,1127,1087,40,1120,7,"REBRA",,7,,341,779
6,"Bistrița-Năsăud",65,"65-REBRISOARA",34280,168,2,1307,1351,1268,83,1325,26,"REBRISOARA",,7,,455,870
6,"Bistrița-Năsăud",65,"65-REBRISOARA",34280,169,2,1362,1228,1123,105,1226,2,"REBRISOARA",,7,,309,917
6,"Bistrița-Năsăud",65,"65-REBRISOARA",34280,170,2,787,666,624,42,663,3,"REBRISOARA",,7,,220,443
6,"Bistrița-Năsăud",65,"65-REBRISOARA",34280,171,2,262,230,200,30,223,7,"REBRISOARA",,7,,48,175
6,"Bistrița-Năsăud",65,"65-RODNA",34333,172,2,1749,1273,1154,119,1266,5,"RODNA",,7,,668,598
6,"Bistrița-Năsăud",65,"65-RODNA",34333,173,2,1280,929,834,95,924,5,"RODNA",,7,,570,354
6,"Bistrița-Năsăud",65,"65-RODNA",34333,174,2,1163,861,708,153,857,4,"RODNA",,7,,449,408
6,"Bistrița-Năsăud",65,"65-RODNA",34333,175,2,171,139,124,15,139,0,"RODNA",,7,,101,38
6,"Bistrița-Năsăud",65,"65-ROMULI",34360,176,2,1082,621,570,51,615,6,"ROMULI",,7,,363,252
6,"Bistrița-Năsăud",65,"65-ROMULI",34360,177,2,319,221,187,34,221,0,"ROMULI",,7,,103,118
6,"Bistrița-Năsăud",65,"65-SALVA",34397,178,2,1081,700,667,33,694,6,"SALVA",,7,,310,384
6,"Bistrița-Năsăud",65,"65-SALVA",34397,179,2,1215,822,771,51,819,3,"SALVA",,7,,443,376
6,"Bistrița-Năsăud",65,"65-SALVA",34397,180,2,1161,666,634,32,659,7,"SALVA",,7,,405,254
6,"Bistrița-Năsăud",65,"65-SILIVASU DE CAMPIE",34422,181,2,1074,771,708,63,761,10,"SILIVASU DE CAMPIE",,7,,521,240
6,"Bistrița-Năsăud",65,"65-SANMIHAIU DE CAMPIE",34477,182,2,577,456,388,68,450,6,"SANMIHAIU DE CAMPIE",,7,,230,220
6,"Bistrița-Năsăud",65,"65-SANMIHAIU DE CAMPIE",34477,183,2,132,115,95,20,113,2,"SANMIHAIU DE CAMPIE",,7,,55,58
6,"Bistrița-Năsăud",65,"65-SANMIHAIU DE CAMPIE",34477,184,2,148,125,90,35,122,3,"SANMIHAIU DE CAMPIE",,7,,38,84
6,"Bistrița-Năsăud",65,"65-SANMIHAIU DE CAMPIE",34477,185,2,280,199,164,35,190,9,"SANMIHAIU DE CAMPIE",,7,,65,125
6,"Bistrița-Năsăud",65,"65-SANMIHAIU DE CAMPIE",34477,186,2,330,240,208,32,238,2,"SANMIHAIU DE CAMPIE",,7,,137,101
6,"Bistrița-Năsăud",65,"65-SPERMEZEU",34547,187,2,1685,1041,966,75,1037,4,"SPERMEZEU",,7,,460,577
6,"Bistrița-Năsăud",65,"65-SPERMEZEU",34547,188,2,333,212,195,17,212,0,"SPERMEZEU",,7,,91,121
6,"Bistrița-Năsăud",65,"65-SPERMEZEU",34547,189,2,298,215,158,57,211,4,"SPERMEZEU",,7,,107,104
6,"Bistrița-Năsăud",65,"65-SPERMEZEU",34547,190,2,593,444,387,57,442,2,"SPERMEZEU",,7,,204,238
6,"Bistrița-Năsăud",65,"65-SPERMEZEU",34547,191,2,530,378,352,26,372,6,"SPERMEZEU",,7,,179,193
6,"Bistrița-Năsăud",65,"65-SANT",34618,192,2,2022,1548,1447,101,1542,6,"SANT",,7,,812,730
6,"Bistrița-Năsăud",65,"65-SANT",34618,193,2,173,172,125,47,172,0,"SANT",,7,,99,73
6,"Bistrița-Năsăud",65,"65-SIEU",34645,194,2,1050,868,819,49,864,4,"SIEU",,7,,364,500
6,"Bistrița-Năsăud",65,"65-SIEU",34645,195,2,667,430,415,15,430,0,"SIEU",,7,,150,280
6,"Bistrița-Năsăud",65,"65-SIEU",34645,196,2,573,531,517,14,527,4,"SIEU",,7,,207,320
6,"Bistrița-Năsăud",65,"65-SIEU",34645,197,2,138,129,116,13,129,0,"SIEU",,7,,51,78
6,"Bistrița-Năsăud",65,"65-SIEU MAGHERUS",34690,198,2,1165,821,703,118,816,5,"SIEU MAGHERUS",,7,,324,492
6,"Bistrița-Năsăud",65,"65-SIEU MAGHERUS",34690,199,2,471,383,327,56,381,2,"SIEU MAGHERUS",,7,,153,228
6,"Bistrița-Năsăud",65,"65-SIEU MAGHERUS",34690,200,2,320,257,207,50,255,2,"SIEU MAGHERUS",,7,,86,169
6,"Bistrița-Năsăud",65,"65-SIEU MAGHERUS",34690,201,2,477,420,361,59,417,3,"SIEU MAGHERUS",,7,,105,312
6,"Bistrița-Năsăud",65,"65-SIEU ODORHEI",34770,202,2,576,449,389,60,448,1,"SIEU ODORHEI",,7,,201,247
6,"Bistrița-Năsăud",65,"65-SIEU ODORHEI",34770,203,2,486,468,434,34,462,6,"SIEU ODORHEI",,7,,286,176
6,"Bistrița-Năsăud",65,"65-SIEU ODORHEI",34770,204,2,225,215,192,23,215,0,"SIEU ODORHEI",,7,,20,195
6,"Bistrița-Năsăud",65,"65-SIEU ODORHEI",34770,205,2,177,159,141,18,157,2,"SIEU ODORHEI",,7,,101,56
6,"Bistrița-Năsăud",65,"65-SIEU ODORHEI",34770,206,2,333,336,286,50,331,5,"SIEU ODORHEI",,7,,149,182
6,"Bistrița-Năsăud",65,"65-SIEU ODORHEI",34770,207,2,268,234,201,33,233,1,"SIEU ODORHEI",,7,,100,133
6,"Bistrița-Năsăud",65,"65-SIEUT",34850,208,2,1099,839,720,119,836,2,"SIEUT",,7,,408,428
6,"Bistrița-Năsăud",65,"65-SIEUT",34850,209,2,681,515,483,32,511,4,"SIEUT",,7,,279,232
6,"Bistrița-Năsăud",65,"65-SIEUT",34850,210,2,288,183,166,17,179,4,"SIEUT",,7,,92,87
6,"Bistrița-Năsăud",65,"65-SINTEREAG",34903,211,2,849,713,610,103,712,1,"SINTEREAG",,7,,230,482
6,"Bistrița-Năsăud",65,"65-SINTEREAG",34903,212,2,349,310,289,21,310,0,"SINTEREAG",,7,,98,212
6,"Bistrița-Năsăud",65,"65-SINTEREAG",34903,213,2,282,256,231,25,256,0,"SINTEREAG",,7,,121,135
6,"Bistrița-Năsăud",65,"65-SINTEREAG",34903,214,2,923,729,692,37,727,2,"SINTEREAG",,7,,280,447
6,"Bistrița-Năsăud",65,"65-SINTEREAG",34903,215,2,353,314,268,46,314,0,"SINTEREAG",,7,,124,190
6,"Bistrița-Năsăud",65,"65-SINTEREAG",34903,216,2,383,345,311,34,345,0,"SINTEREAG",,7,,160,185
6,"Bistrița-Năsăud",65,"65-TEACA",34985,217,2,729,532,477,55,526,6,"TEACA",,7,,275,251
6,"Bistrița-Năsăud",65,"65-TEACA",34985,218,2,1139,844,792,52,841,3,"TEACA",,7,,479,362
6,"Bistrița-Năsăud",65,"65-TEACA",34985,219,2,667,582,508,74,581,1,"TEACA",,7,,117,464
6,"Bistrița-Năsăud",65,"65-TEACA",34985,220,2,1518,1194,1015,179,1186,8,"TEACA",,7,,334,852
6,"Bistrița-Năsăud",65,"65-TEACA",34985,221,2,614,490,417,73,477,13,"TEACA",,7,,204,273
6,"Bistrița-Năsăud",65,"65-TELCIU",35054,222,2,1597,1026,823,203,1019,7,"TELCIU",,7,,442,577
6,"Bistrița-Năsăud",65,"65-TELCIU",35054,223,2,1609,1075,889,186,1071,4,"TELCIU",,7,,502,569
6,"Bistrița-Năsăud",65,"65-TELCIU",35054,224,2,947,368,330,38,363,5,"TELCIU",,7,,128,235
6,"Bistrița-Năsăud",65,"65-TELCIU",35054,225,2,288,146,120,26,144,2,"TELCIU",,7,,61,83
6,"Bistrița-Năsăud",65,"65-TELCIU",35054,226,2,977,518,487,31,514,4,"TELCIU",,7,,135,379
6,"Bistrița-Năsăud",65,"65-TIHA BARGAULUI",35090,227,2,1193,800,702,98,795,5,"TIHA BARGAULUI",,7,,250,545
6,"Bistrița-Năsăud",65,"65-TIHA BARGAULUI",35090,228,2,1755,1212,1103,109,1199,13,"TIHA BARGAULUI",,7,,285,914
6,"Bistrița-Năsăud",65,"65-TIHA BARGAULUI",35090,229,2,1204,893,818,75,887,6,"TIHA BARGAULUI",,7,,165,722
6,"Bistrița-Năsăud",65,"65-TIHA BARGAULUI",35090,230,2,311,239,143,96,234,5,"TIHA BARGAULUI",,7,,47,187
6,"Bistrița-Năsăud",65,"65-TARLISUA",35152,231,2,1723,955,891,64,948,7,"TARLISUA",,7,,259,689
6,"Bistrița-Năsăud",65,"65-TARLISUA",35152,232,2,446,297,274,23,293,4,"TARLISUA",,7,,96,197
6,"Bistrița-Năsăud",65,"65-TARLISUA",35152,233,2,1251,749,691,58,743,6,"TARLISUA",,7,,369,374
6,"Bistrița-Năsăud",65,"65-URIU",35269,234,2,1087,847,803,44,843,4,"URIU",,7,,122,721
6,"Bistrița-Năsăud",65,"65-URIU",35269,235,2,886,655,612,43,649,6,"URIU",,7,,323,326
6,"Bistrița-Năsăud",65,"65-URIU",35269,236,2,578,433,401,32,428,5,"URIU",,7,,156,272
6,"Bistrița-Năsăud",65,"65-URIU",35269,237,2,297,217,197,20,215,2,"URIU",,7,,76,139
6,"Bistrița-Năsăud",65,"65-URMENIS",35312,238,2,967,677,600,77,661,16,"URMENIS",,7,,223,438
6,"Bistrița-Năsăud",65,"65-URMENIS",35312,239,2,713,424,340,84,421,3,"URMENIS",,7,,199,222
6,"Bistrița-Năsăud",65,"65-URMENIS",35312,240,2,399,303,237,66,300,3,"URMENIS",,7,,173,127
6,"Bistrița-Năsăud",65,"65-ZAGRA",35429,241,2,899,682,624,58,677,5,"ZAGRA",,7,,355,322
6,"Bistrița-Năsăud",65,"65-ZAGRA",35429,242,2,605,334,296,38,330,4,"ZAGRA",,7,,163,167
6,"Bistrița-Năsăud",65,"65-ZAGRA",35429,243,2,589,415,351,64,413,2,"ZAGRA",,7,,158,255
6,"Bistrița-Năsăud",65,"65-ZAGRA",35429,244,2,598,376,347,29,369,7,"ZAGRA",,7,,244,125
6,"Bistrița-Năsăud",65,"65-ZAGRA",35429,245,2,306,229,200,29,229,0,"ZAGRA",,7,,154,75
7,"Botoșani",74,"74-MUNICIPIUL BOTOSANI",35731,1,2,2207,1763,1663,100,1757,6,"MUNICIPIUL BOTOSANI",,4,,979,778
7,"Botoșani",74,"74-MUNICIPIUL BOTOSANI",35731,2,2,2227,1719,1584,135,1710,9,"MUNICIPIUL BOTOSANI",,4,,877,833
7,"Botoșani",74,"74-MUNICIPIUL BOTOSANI",35731,3,2,2076,1763,1403,360,1758,5,"MUNICIPIUL BOTOSANI",,4,,887,871
7,"Botoșani",74,"74-MUNICIPIUL BOTOSANI",35731,4,2,1595,1186,1088,98,1180,6,"MUNICIPIUL BOTOSANI",,4,,614,566
7,"Botoșani",74,"74-MUNICIPIUL BOTOSANI",35731,5,2,1184,762,651,111,759,3,"MUNICIPIUL BOTOSANI",,4,,344,415
7,"Botoșani",74,"74-MUNICIPIUL BOTOSANI",35731,6,2,1348,999,862,137,993,6,"MUNICIPIUL BOTOSANI",,4,,536,457
7,"Botoșani",74,"74-MUNICIPIUL BOTOSANI",35731,7,2,1541,1125,971,154,1117,8,"MUNICIPIUL BOTOSANI",,4,,575,542
7,"Botoșani",74,"74-MUNICIPIUL BOTOSANI",35731,8,2,3017,2254,2111,143,2246,8,"MUNICIPIUL BOTOSANI",,4,,1235,1011
7,"Botoșani",74,"74-MUNICIPIUL BOTOSANI",35731,9,2,2284,1769,1463,306,1757,12,"MUNICIPIUL BOTOSANI",,4,,877,880
7,"Botoșani",74,"74-MUNICIPIUL BOTOSANI",35731,10,2,1842,1849,1683,166,1844,5,"MUNICIPIUL BOTOSANI",,4,,944,900
7,"Botoșani",74,"74-MUNICIPIUL BOTOSANI",35731,11,2,2058,1677,1427,250,1671,6,"MUNICIPIUL BOTOSANI",,4,,732,939
7,"Botoșani",74,"74-MUNICIPIUL BOTOSANI",35731,12,2,1154,1189,767,422,1183,6,"MUNICIPIUL BOTOSANI",,4,,569,614
7,"Botoșani",74,"74-MUNICIPIUL BOTOSANI",35731,13,2,1467,1106,1020,86,1102,4,"MUNICIPIUL BOTOSANI",,4,,663,439
7,"Botoșani",74,"74-MUNICIPIUL BOTOSANI",35731,14,2,1806,1331,1275,56,1314,17,"MUNICIPIUL BOTOSANI",,4,,672,642
7,"Botoșani",74,"74-MUNICIPIUL BOTOSANI",35731,15,2,2927,2120,1978,142,2111,9,"MUNICIPIUL BOTOSANI",,4,,1067,1044
7,"Botoșani",74,"74-MUNICIPIUL BOTOSANI",35731,16,2,2122,1532,1445,87,1519,13,"MUNICIPIUL BOTOSANI",,4,,746,773
7,"Botoșani",74,"74-MUNICIPIUL BOTOSANI",35731,17,2,2358,2211,1446,765,2189,22,"MUNICIPIUL BOTOSANI",,4,,1150,1039
7,"Botoșani",74,"74-MUNICIPIUL BOTOSANI",35731,18,2,1497,974,874,100,971,3,"MUNICIPIUL BOTOSANI",,4,,426,545
7,"Botoșani",74,"74-MUNICIPIUL BOTOSANI",35731,19,2,1454,1227,1006,221,1219,8,"MUNICIPIUL BOTOSANI",,4,,540,679
7,"Botoșani",74,"74-MUNICIPIUL BOTOSANI",35731,20,2,1977,1376,1206,170,1373,3,"MUNICIPIUL BOTOSANI",,4,,696,677
7,"Botoșani",74,"74-MUNICIPIUL BOTOSANI",35731,21,2,2213,1652,1479,173,1642,10,"MUNICIPIUL BOTOSANI",,4,,869,773
7,"Botoșani",74,"74-MUNICIPIUL BOTOSANI",35731,22,2,1983,1333,1199,134,1327,6,"MUNICIPIUL BOTOSANI",,4,,713,614
7,"Botoșani",74,"74-MUNICIPIUL BOTOSANI",35731,23,2,1431,1042,972,70,1036,6,"MUNICIPIUL BOTOSANI",,4,,567,469
7,"Botoșani",74,"74-MUNICIPIUL BOTOSANI",35731,24,2,1664,1282,1100,182,1276,6,"MUNICIPIUL BOTOSANI",,4,,715,561
7,"Botoșani",74,"74-MUNICIPIUL BOTOSANI",35731,25,2,2212,1699,1480,219,1690,9,"MUNICIPIUL BOTOSANI",,4,,935,755
7,"Botoșani",74,"74-MUNICIPIUL BOTOSANI",35731,26,2,2178,1557,1462,95,1544,13,"MUNICIPIUL BOTOSANI",,4,,854,690
7,"Botoșani",74,"74-MUNICIPIUL BOTOSANI",35731,27,2,1859,1337,1219,118,1333,4,"MUNICIPIUL BOTOSANI",,4,,709,624
7,"Botoșani",74,"74-MUNICIPIUL BOTOSANI",35731,28,2,1799,1381,1222,159,1367,14,"MUNICIPIUL BOTOSANI",,4,,724,643
7,"Botoșani",74,"74-MUNICIPIUL BOTOSANI",35731,29,2,1373,1003,932,71,999,4,"MUNICIPIUL BOTOSANI",,4,,537,462
7,"Botoșani",74,"74-MUNICIPIUL BOTOSANI",35731,30,2,2398,1699,1473,226,1689,10,"MUNICIPIUL BOTOSANI",,4,,861,828
7,"Botoșani",74,"74-MUNICIPIUL BOTOSANI",35731,31,2,1428,1069,986,83,1060,9,"MUNICIPIUL BOTOSANI",,4,,529,531
7,"Botoșani",74,"74-MUNICIPIUL BOTOSANI",35731,32,2,1759,1244,1137,107,1236,8,"MUNICIPIUL BOTOSANI",,4,,634,602
7,"Botoșani",74,"74-MUNICIPIUL BOTOSANI",35731,33,2,2031,1702,1370,332,1693,9,"MUNICIPIUL BOTOSANI",,4,,887,806
7,"Botoșani",74,"74-MUNICIPIUL BOTOSANI",35731,34,2,2178,1625,1554,71,1614,11,"MUNICIPIUL BOTOSANI",,4,,809,805
7,"Botoșani",74,"74-MUNICIPIUL BOTOSANI",35731,35,2,1898,1409,1345,64,1397,12,"MUNICIPIUL BOTOSANI",,4,,722,675
7,"Botoșani",74,"74-MUNICIPIUL BOTOSANI",35731,36,2,1370,1037,957,80,1032,5,"MUNICIPIUL BOTOSANI",,4,,502,530
7,"Botoșani",74,"74-MUNICIPIUL BOTOSANI",35731,37,2,1545,1239,1120,119,1235,4,"MUNICIPIUL BOTOSANI",,4,,569,666
7,"Botoșani",74,"74-MUNICIPIUL BOTOSANI",35731,38,2,605,493,412,81,488,5,"MUNICIPIUL BOTOSANI",,4,,293,195
7,"Botoșani",74,"74-MUNICIPIUL BOTOSANI",35731,39,2,1128,887,786,101,880,7,"MUNICIPIUL BOTOSANI",,4,,485,395
7,"Botoșani",74,"74-MUNICIPIUL BOTOSANI",35731,40,2,1026,779,721,58,775,4,"MUNICIPIUL BOTOSANI",,4,,395,380
7,"Botoșani",74,"74-MUNICIPIUL BOTOSANI",35731,41,2,2285,1716,1641,75,1696,20,"MUNICIPIUL BOTOSANI",,4,,964,732
7,"Botoșani",74,"74-MUNICIPIUL BOTOSANI",35731,42,2,2954,2054,1715,339,2035,19,"MUNICIPIUL BOTOSANI",,4,,1041,994
7,"Botoșani",74,"74-MUNICIPIUL BOTOSANI",35731,43,2,4029,1215,1138,77,1201,14,"MUNICIPIUL BOTOSANI",,4,,639,562
7,"Botoșani",74,"74-MUNICIPIUL BOTOSANI",35731,44,2,2699,2083,1878,205,2071,12,"MUNICIPIUL BOTOSANI",,4,,1087,984
7,"Botoșani",74,"74-MUNICIPIUL BOTOSANI",35731,45,2,2351,1838,1636,202,1825,13,"MUNICIPIUL BOTOSANI",,4,,948,877
7,"Botoșani",74,"74-MUNICIPIUL BOTOSANI",35731,46,2,1414,1126,983,143,1116,10,"MUNICIPIUL BOTOSANI",,4,,592,524
7,"Botoșani",74,"74-MUNICIPIUL BOTOSANI",35731,47,2,1620,1504,1025,479,1499,5,"MUNICIPIUL BOTOSANI",,4,,811,688
7,"Botoșani",74,"74-MUNICIPIUL BOTOSANI",35731,48,2,0,620,0,620,618,2,"MUNICIPIUL BOTOSANI",,4,,383,235
7,"Botoșani",74,"74-MUNICIPIUL BOTOSANI",35731,49,2,0,189,0,189,189,0,"MUNICIPIUL BOTOSANI",,4,,129,60
7,"Botoșani",74,"74-MUNICIPIUL BOTOSANI",35731,50,2,0,151,0,151,148,3,"MUNICIPIUL BOTOSANI",,4,,98,50
7,"Botoșani",74,"74-MUNICIPIUL BOTOSANI",35731,51,2,0,460,0,460,457,3,"MUNICIPIUL BOTOSANI",,4,,86,371
7,"Botoșani",74,"74-MUNICIPIUL BOTOSANI",35731,52,2,0,96,0,96,96,0,"MUNICIPIUL BOTOSANI",,4,,45,51
7,"Botoșani",74,"74-MUNICIPIUL BOTOSANI",35731,53,2,0,69,0,69,68,1,"MUNICIPIUL BOTOSANI",,4,,36,32
7,"Botoșani",74,"74-MUNICIPIUL BOTOSANI",35731,54,2,0,516,0,516,511,5,"MUNICIPIUL BOTOSANI",,4,,345,166
7,"Botoșani",74,"74-MUNICIPIUL BOTOSANI",35731,55,2,0,188,0,188,187,1,"MUNICIPIUL BOTOSANI",,4,,119,68
7,"Botoșani",74,"74-MUNICIPIUL BOTOSANI",35731,56,2,0,152,0,152,150,2,"MUNICIPIUL BOTOSANI",,4,,76,74
7,"Botoșani",74,"74-MUNICIPIUL DOROHOI",36006,57,2,2253,1733,1640,93,1729,4,"MUNICIPIUL DOROHOI",,4,,1030,699
7,"Botoșani",74,"74-MUNICIPIUL DOROHOI",36006,58,2,2229,1741,1581,160,1729,12,"MUNICIPIUL DOROHOI",,4,,1002,727
7,"Botoșani",74,"74-MUNICIPIUL DOROHOI",36006,59,2,2187,1695,1599,96,1678,17,"MUNICIPIUL DOROHOI",,4,,1051,627
7,"Botoșani",74,"74-MUNICIPIUL DOROHOI",36006,60,2,1151,988,858,130,980,8,"MUNICIPIUL DOROHOI",,4,,574,406
7,"Botoșani",74,"74-MUNICIPIUL DOROHOI",36006,61,2,1226,990,876,114,981,9,"MUNICIPIUL DOROHOI",,4,,551,430
7,"Botoșani",74,"74-MUNICIPIUL DOROHOI",36006,62,2,1916,1560,1390,170,1540,20,"MUNICIPIUL DOROHOI",,4,,928,612
7,"Botoșani",74,"74-MUNICIPIUL DOROHOI",36006,63,2,1863,1443,1280,163,1429,14,"MUNICIPIUL DOROHOI",,4,,891,538
7,"Botoșani",74,"74-MUNICIPIUL DOROHOI",36006,64,2,1949,1487,1359,128,1483,4,"MUNICIPIUL DOROHOI",,4,,882,601
7,"Botoșani",74,"74-MUNICIPIUL DOROHOI",36006,65,2,2197,1700,1592,108,1690,10,"MUNICIPIUL DOROHOI",,4,,1083,607
7,"Botoșani",74,"74-MUNICIPIUL DOROHOI",36006,66,2,1979,1862,1450,412,1854,6,"MUNICIPIUL DOROHOI",,4,,1111,743
7,"Botoșani",74,"74-MUNICIPIUL DOROHOI",36006,67,2,2076,1536,1453,83,1531,5,"MUNICIPIUL DOROHOI",,4,,971,560
7,"Botoșani",74,"74-MUNICIPIUL DOROHOI",36006,68,2,1677,1386,1310,76,1371,15,"MUNICIPIUL DOROHOI",,4,,879,492
7,"Botoșani",74,"74-MUNICIPIUL DOROHOI",36006,69,2,664,531,495,36,529,2,"MUNICIPIUL DOROHOI",,4,,390,139
7,"Botoșani",74,"74-MUNICIPIUL DOROHOI",36006,70,2,280,234,215,19,232,2,"MUNICIPIUL DOROHOI",,4,,174,58
7,"Botoșani",74,"74-MUNICIPIUL DOROHOI",36006,71,2,0,217,0,217,217,0,"MUNICIPIUL DOROHOI",,4,,107,110
7,"Botoșani",74,"74-MUNICIPIUL DOROHOI",36006,72,2,0,85,0,85,83,2,"MUNICIPIUL DOROHOI",,4,,47,36
7,"Botoșani",74,"74-ORAS DARABANI",35946,73,2,2810,2079,1956,123,2068,11,"ORAS DARABANI",,4,,1543,525
7,"Botoșani",74,"74-ORAS DARABANI",35946,74,2,2854,2195,2034,161,2170,25,"ORAS DARABANI",,4,,1559,611
7,"Botoșani",74,"74-ORAS DARABANI",35946,75,2,1474,1154,1108,46,1148,6,"ORAS DARABANI",,4,,907,241
7,"Botoșani",74,"74-ORAS DARABANI",35946,76,2,1190,841,802,39,835,6,"ORAS DARABANI",,4,,682,153
7,"Botoșani",74,"74-ORAS DARABANI",35946,77,2,474,376,359,17,371,5,"ORAS DARABANI",,4,,321,50
7,"Botoșani",74,"74-ORAS DARABANI",35946,78,2,286,246,217,29,246,0,"ORAS DARABANI",,4,,212,34
7,"Botoșani",74,"74-ORAS SAVENI",36060,79,2,1819,1386,1297,89,1383,3,"ORAS SAVENI",,4,,878,505
7,"Botoșani",74,"74-ORAS SAVENI",36060,80,2,1801,1376,1286,90,1370,6,"ORAS SAVENI",,4,,872,498
7,"Botoșani",74,"74-ORAS SAVENI",36060,81,2,1283,966,926,40,958,8,"ORAS SAVENI",,4,,646,312
7,"Botoșani",74,"74-ORAS SAVENI",36060,82,2,1208,896,839,57,886,10,"ORAS SAVENI",,4,,714,172
7,"Botoșani",74,"74-ORAS SAVENI",36060,83,2,318,294,261,33,291,3,"ORAS SAVENI",,4,,255,36
7,"Botoșani",74,"74-ORAS SAVENI",36060,84,2,0,105,0,105,105,0,"ORAS SAVENI",,4,,70,35
7,"Botoșani",74,"74-ALBESTI",36131,85,2,1670,1123,959,164,1119,4,"ALBESTI",,4,,891,228
7,"Botoșani",74,"74-ALBESTI",36131,86,2,677,478,358,120,475,3,"ALBESTI",,4,,386,89
7,"Botoșani",74,"74-ALBESTI",36131,87,2,506,350,276,74,344,6,"ALBESTI",,4,,295,49
7,"Botoșani",74,"74-ALBESTI",36131,88,2,548,369,298,71,365,4,"ALBESTI",,4,,293,72
7,"Botoșani",74,"74-ALBESTI",36131,89,2,287,231,181,50,227,4,"ALBESTI",,4,,169,58
7,"Botoșani",74,"74-ALBESTI",36131,90,2,939,666,577,89,657,6,"ALBESTI",,4,,591,66
7,"Botoșani",74,"74-AVRAMENI",36202,91,2,1167,868,751,117,861,7,"AVRAMENI",,4,,630,231
7,"Botoșani",74,"74-AVRAMENI",36202,92,2,867,577,484,93,566,11,"AVRAMENI",,4,,418,148
7,"Botoșani",74,"74-AVRAMENI",36202,93,2,1016,730,601,129,720,10,"AVRAMENI",,4,,555,165
7,"Botoșani",74,"74-AVRAMENI",36202,94,2,689,584,509,75,579,5,"AVRAMENI",,4,,407,172
7,"Botoșani",74,"74-AVRAMENI",36202,95,2,470,366,319,47,365,1,"AVRAMENI",,4,,289,76
7,"Botoșani",74,"74-AVRAMENI",36202,96,2,166,147,109,38,147,0,"AVRAMENI",,4,,93,54
7,"Botoșani",74,"74-BALUSENI",36300,97,2,1597,1023,860,163,1013,10,"BALUSENI",,4,,784,229
7,"Botoșani",74,"74-BALUSENI",36300,98,2,1767,1200,1035,165,1183,17,"BALUSENI",,4,,902,281
7,"Botoșani",74,"74-BALUSENI",36300,99,2,1116,686,524,162,668,18,"BALUSENI",,4,,416,252
7,"Botoșani",74,"74-BRAESTI",36373,100,2,1379,1095,951,144,1091,4,"BRAESTI",,4,,851,240
7,"Botoșani",74,"74-BRAESTI",36373,101,2,418,372,320,52,371,1,"BRAESTI",,4,,301,70
7,"Botoșani",74,"74-BROSCAUTI",36426,102,2,772,596,530,66,592,4,"BROSCAUTI",,4,,399,193
7,"Botoșani",74,"74-BROSCAUTI",36426,103,2,1931,1422,1327,95,1410,12,"BROSCAUTI",,4,,1001,409
7,"Botoșani",74,"74-BUCECEA",36462,104,2,2523,1867,1647,220,1851,16,"BUCECEA",,4,,1269,582
7,"Botoșani",74,"74-BUCECEA",36462,105,2,1397,1056,915,141,1046,10,"BUCECEA",,4,,757,289
7,"Botoșani",74,"74-CALARASI",36499,106,2,2423,1447,1290,157,1431,16,"CALARASI",,4,,1061,370
7,"Botoșani",74,"74-CALARASI",36499,107,2,954,648,576,72,605,43,"CALARASI",,4,,555,50
7,"Botoșani",74,"74-CONCESTI",36532,108,2,1706,1253,1151,102,1248,5,"CONCESTI",,4,,1094,154
7,"Botoșani",74,"74-COPALAU",36569,109,2,2205,1496,1307,189,1468,25,"COPALAU",,4,,1106,362
7,"Botoșani",74,"74-COPALAU",36569,110,2,1023,753,632,121,742,11,"COPALAU",,4,,579,163
7,"Botoșani",74,"74-COPALAU",36569,111,2,1528,831,680,151,813,18,"COPALAU",,4,,506,307
7,"Botoșani",74,"74-COPALAU",36569,112,2,930,773,500,273,752,21,"COPALAU",,4,,470,282
7,"Botoșani",74,"74-CORDARENI",36649,113,2,1449,1378,1287,91,1369,9,"CORDARENI",,4,,952,417
7,"Botoșani",74,"74-CORDARENI",36649,114,2,464,481,429,52,460,21,"CORDARENI",,4,,229,231
7,"Botoșani",74,"74-CORLATENI",36676,115,2,1603,907,801,106,900,7,"CORLATENI",,4,,724,176
7,"Botoșani",74,"74-CORLATENI",36676,116,2,898,757,526,231,747,10,"CORLATENI",,4,,610,137
7,"Botoșani",74,"74-CORLATENI",36676,117,2,1022,813,632,181,805,8,"CORLATENI",,4,,667,138
7,"Botoșani",74,"74-CORNI",36756,118,2,1591,1022,919,103,1010,12,"CORNI",,4,,702,308
7,"Botoșani",74,"74-CORNI",36756,119,2,1460,938,866,72,922,16,"CORNI",,4,,649,273
7,"Botoșani",74,"74-CORNI",36756,120,2,1483,1012,898,114,993,19,"CORNI",,4,,763,230
7,"Botoșani",74,"74-CORNI",36756,121,2,269,218,158,60,211,7,"CORNI",,4,,132,79
7,"Botoșani",74,"74-COTUSCA",36809,122,2,1582,1085,970,115,1074,11,"COTUSCA",,4,,823,251
7,"Botoșani",74,"74-COTUSCA",36809,123,2,625,437,377,60,428,9,"COTUSCA",,4,,346,82
7,"Botoșani",74,"74-COTUSCA",36809,124,2,772,569,471,98,565,4,"COTUSCA",,4,,453,112
7,"Botoșani",74,"74-COTUSCA",36809,125,2,636,496,432,64,494,2,"COTUSCA",,4,,386,108
7,"Botoșani",74,"74-COTUSCA",36809,126,2,453,385,324,61,381,4,"COTUSCA",,4,,267,114
7,"Botoșani",74,"74-COTUSCA",36809,127,2,672,577,493,84,571,6,"COTUSCA",,4,,446,125
7,"Botoșani",74,"74-CRISTESTI",36907,128,2,1682,1207,1001,206,1182,25,"CRISTESTI",,4,,768,414
7,"Botoșani",74,"74-CRISTESTI",36907,129,2,439,369,264,105,363,6,"CRISTESTI",,4,,249,114
7,"Botoșani",74,"74-CRISTESTI",36907,130,2,1323,988,840,148,974,14,"CRISTESTI",,4,,761,213
7,"Botoșani",74,"74-CRISTINESTI",36952,131,2,1332,1036,869,167,1022,14,"CRISTINESTI",,4,,749,273
7,"Botoșani",74,"74-CRISTINESTI",36952,132,2,438,453,331,122,451,2,"CRISTINESTI",,4,,350,101
7,"Botoșani",74,"74-CRISTINESTI",36952,133,2,1088,901,758,143,881,20,"CRISTINESTI",,4,,617,264
7,"Botoșani",74,"74-CURTESTI",35759,134,2,1074,747,620,127,741,6,"CURTESTI",,4,,572,169
7,"Botoșani",74,"74-CURTESTI",35759,135,2,1264,997,776,221,984,13,"CURTESTI",,4,,647,337
7,"Botoșani",74,"74-CURTESTI",35759,136,2,537,396,335,61,393,3,"CURTESTI",,4,,239,154
7,"Botoșani",74,"74-CURTESTI",35759,137,2,218,329,148,181,320,9,"CURTESTI",,4,,228,92
7,"Botoșani",74,"74-DERSCA",37011,138,2,2900,1940,1824,116,1923,17,"DERSCA",,4,,1417,506
7,"Botoșani",74,"74-DERSCA",37011,139,2,1468,1107,945,162,1085,22,"DERSCA",,4,,754,331
7,"Botoșani",74,"74-DANGENI",37057,140,2,1015,719,613,106,715,4,"DANGENI",,4,,497,218
7,"Botoșani",74,"74-DANGENI",37057,141,2,547,377,334,43,373,4,"DANGENI",,4,,262,111
7,"Botoșani",74,"74-DANGENI",37057,142,2,895,719,619,100,706,12,"DANGENI",,4,,497,209
7,"Botoșani",74,"74-DOBARCENI",37100,143,2,956,699,595,104,694,5,"DOBARCENI",,4,,531,163
7,"Botoșani",74,"74-DOBARCENI",37100,144,2,599,476,381,95,474,2,"DOBARCENI",,4,,309,165
7,"Botoșani",74,"74-DOBARCENI",37100,145,2,353,300,249,51,300,0,"DOBARCENI",,4,,249,51
7,"Botoșani",74,"74-DOBARCENI",37100,146,2,344,297,245,52,297,0,"DOBARCENI",,4,,245,52
7,"Botoșani",74,"74-DRAGUSENI",37173,147,2,1437,1063,975,88,1046,17,"DRAGUSENI",,4,,867,179
7,"Botoșani",74,"74-DRAGUSENI",37173,148,2,699,557,502,55,553,4,"DRAGUSENI",,4,,438,115
7,"Botoșani",74,"74-DURNESTI",37217,149,2,1670,1251,1037,214,1240,11,"DURNESTI",,4,,1015,225
7,"Botoșani",74,"74-DURNESTI",37217,150,2,872,615,525,90,611,4,"DURNESTI",,4,,499,112
7,"Botoșani",74,"74-DURNESTI",37217,151,2,0,77,0,77,77,0,"DURNESTI",,4,,56,21
7,"Botoșani",74,"74-DURNESTI",37217,152,2,595,455,393,62,451,4,"DURNESTI",,4,,354,97
7,"Botoșani",74,"74-FLAMANZI",37299,153,2,2065,970,758,212,957,13,"FLAMANZI",,4,,616,341
7,"Botoșani",74,"74-FLAMANZI",37299,154,2,1313,1402,813,589,1388,14,"FLAMANZI",,4,,1007,381
7,"Botoșani",74,"74-FLAMANZI",37299,155,2,1684,982,854,128,972,10,"FLAMANZI",,4,,772,200
7,"Botoșani",74,"74-FLAMANZI",37299,156,2,763,716,466,250,712,4,"FLAMANZI",,4,,530,182
7,"Botoșani",74,"74-FLAMANZI",37299,157,2,2474,1449,1241,208,1414,35,"FLAMANZI",,4,,1012,402
7,"Botoșani",74,"74-FLAMANZI",37299,158,2,945,657,520,137,651,6,"FLAMANZI",,4,,475,176
7,"Botoșani",74,"74-FRUMUSICA",37324,159,2,2223,1289,1121,168,1272,17,"FRUMUSICA",,4,,944,328
7,"Botoșani",74,"74-FRUMUSICA",37324,160,2,1210,939,707,232,921,18,"FRUMUSICA",,4,,707,214
7,"Botoșani",74,"74-FRUMUSICA",37324,161,2,1205,927,691,236,907,20,"FRUMUSICA",,4,,713,194
7,"Botoșani",74,"74-GEORGE ENESCU",37397,162,2,1040,825,672,153,820,5,"GEORGE ENESCU",,4,,581,239
7,"Botoșani",74,"74-GEORGE ENESCU",37397,163,2,1171,851,723,128,839,12,"GEORGE ENESCU",,4,,615,224
7,"Botoșani",74,"74-GEORGE ENESCU",37397,164,2,677,580,410,170,577,3,"GEORGE ENESCU",,4,,436,141
7,"Botoșani",74,"74-GORBANESTI",37459,165,2,1072,782,714,68,768,14,"GORBANESTI",,4,,674,94
7,"Botoșani",74,"74-GORBANESTI",37459,166,2,473,361,282,79,357,4,"GORBANESTI",,4,,302,55
7,"Botoșani",74,"74-GORBANESTI",37459,167,2,735,580,488,92,575,5,"GORBANESTI",,4,,491,84
7,"Botoșani",74,"74-GORBANESTI",37459,168,2,748,589,506,83,580,9,"GORBANESTI",,4,,464,116
7,"Botoșani",74,"74-HAVARNA",37547,169,2,3039,1999,1795,204,1984,15,"HAVARNA",,4,,1474,510
7,"Botoșani",74,"74-HAVARNA",37547,170,2,1434,947,818,129,938,9,"HAVARNA",,4,,736,202
7,"Botoșani",74,"74-HANESTI",37618,171,2,1289,919,823,96,915,4,"HANESTI",,4,,729,186
7,"Botoșani",74,"74-HANESTI",37618,172,2,687,467,435,32,462,5,"HANESTI",,4,,375,87
7,"Botoșani",74,"74-HILISEU-HORIA",37672,173,2,1722,1175,1014,161,1163,12,"HILISEU-HORIA",,4,,948,215
7,"Botoșani",74,"74-HILISEU-HORIA",37672,174,2,1086,886,760,126,877,9,"HILISEU-HORIA",,4,,698,179
7,"Botoșani",74,"74-HLIPICENI",37734,175,2,1917,1114,945,169,1102,12,"HLIPICENI",,4,,794,308
7,"Botoșani",74,"74-HLIPICENI",37734,176,2,1363,1201,871,330,1190,11,"HLIPICENI",,4,,981,209
7,"Botoșani",74,"74-HUDESTI",37770,177,2,971,810,596,214,803,7,"HUDESTI",,4,,617,186
7,"Botoșani",74,"74-HUDESTI",37770,178,2,1245,833,747,86,826,7,"HUDESTI",,4,,744,82
7,"Botoșani",74,"74-HUDESTI",37770,179,2,1318,986,890,96,979,7,"HUDESTI",,4,,796,183
7,"Botoșani",74,"74-HUDESTI",37770,180,2,1086,814,703,111,807,7,"HUDESTI",,4,,673,134
7,"Botoșani",74,"74-HUDESTI",37770,181,2,577,466,414,52,461,5,"HUDESTI",,4,,360,101
7,"Botoșani",74,"74-IBANESTI",37823,182,2,2117,1588,1431,157,1567,21,"IBANESTI",,4,,1211,356
7,"Botoșani",74,"74-IBANESTI",37823,183,2,1145,1034,861,173,1024,10,"IBANESTI",,4,,735,289
7,"Botoșani",74,"74-LEORDA",37850,184,2,1939,1413,1289,124,1399,14,"LEORDA",,4,,1048,351
7,"Botoșani",74,"74-LUNCA",37912,185,2,1545,1120,965,155,1116,4,"LUNCA",,4,,939,177
7,"Botoșani",74,"74-LUNCA",37912,186,2,889,642,558,84,637,5,"LUNCA",,4,,429,208
7,"Botoșani",74,"74-LUNCA",37912,187,2,2015,1313,1176,137,1291,22,"LUNCA",,4,,929,362
7,"Botoșani",74,"74-MANOLEASA",37958,188,2,535,493,417,76,488,5,"MANOLEASA",,4,,330,158
7,"Botoșani",74,"74-MANOLEASA",37958,189,2,379,393,331,62,392,1,"MANOLEASA",,4,,212,180
7,"Botoșani",74,"74-MANOLEASA",37958,190,2,866,737,638,99,734,3,"MANOLEASA",,4,,532,202
7,"Botoșani",74,"74-MANOLEASA",37958,191,2,412,373,333,40,370,3,"MANOLEASA",,4,,296,74
7,"Botoșani",74,"74-MANOLEASA",37958,192,2,420,434,389,45,425,9,"MANOLEASA",,4,,348,77
7,"Botoșani",74,"74-MIHAI EMINESCU",37495,193,2,973,760,620,140,749,11,"MIHAI EMINESCU",,4,,588,161
7,"Botoșani",74,"74-MIHAI EMINESCU",37495,194,2,655,542,457,85,532,10,"MIHAI EMINESCU",,4,,416,116
7,"Botoșani",74,"74-MIHAI EMINESCU",37495,195,2,664,561,475,86,554,7,"MIHAI EMINESCU",,4,,418,136
7,"Botoșani",74,"74-MIHAI EMINESCU",37495,196,2,1032,978,696,282,974,4,"MIHAI EMINESCU",,4,,662,312
7,"Botoșani",74,"74-MIHAI EMINESCU",37495,197,2,1077,787,708,79,779,8,"MIHAI EMINESCU",,4,,562,217
7,"Botoșani",74,"74-MIHAILENI",38161,198,2,1665,1166,949,217,1152,14,"MIHAILENI",,4,,805,347
7,"Botoșani",74,"74-MIHAILENI",38161,199,2,531,477,362,115,471,6,"MIHAILENI",,4,,208,263
7,"Botoșani",74,"74-MIHAILENI",38161,200,2,1307,922,780,142,912,10,"MIHAILENI",,4,,606,306
7,"Botoșani",74,"74-MIHAILENI",38161,201,2,499,431,334,97,427,4,"MIHAILENI",,4,,369,58
7,"Botoșani",74,"74-MIHALASENI",38241,202,2,971,651,593,58,638,13,"MIHALASENI",,4,,487,151
7,"Botoșani",74,"74-MIHALASENI",38241,203,2,698,556,488,68,543,13,"MIHALASENI",,4,,382,161
7,"Botoșani",74,"74-MIHALASENI",38241,204,2,434,366,319,47,364,2,"MIHALASENI",,4,,288,76
7,"Botoșani",74,"74-MILEANCA",38321,205,2,1621,1107,992,115,1089,18,"MILEANCA",,4,,907,182
7,"Botoșani",74,"74-MILEANCA",38321,206,2,648,375,323,52,372,3,"MILEANCA",,4,,307,65
7,"Botoșani",74,"74-MILEANCA",38321,207,2,308,261,214,47,261,0,"MILEANCA",,4,,211,50
7,"Botoșani",74,"74-MITOC",37903,208,2,1140,778,678,100,766,10,"MITOC",,4,,594,172
7,"Botoșani",74,"74-MITOC",37903,209,2,551,426,381,45,422,4,"MITOC",,4,,366,56
7,"Botoșani",74,"74-NICSENI",38456,210,2,1021,824,723,101,813,11,"NICSENI",,4,,649,164
7,"Botoșani",74,"74-NICSENI",38456,211,2,1225,1048,922,126,1041,7,"NICSENI",,4,,899,142
7,"Botoșani",74,"74-PALTINIS",38492,212,2,1494,950,815,135,941,9,"PALTINIS",,4,,703,238
7,"Botoșani",74,"74-PALTINIS",38492,213,2,373,624,211,413,619,5,"PALTINIS",,4,,501,118
7,"Botoșani",74,"74-PALTINIS",38492,214,2,1013,784,616,168,780,4,"PALTINIS",,4,,622,158
7,"Botoșani",74,"74-POMARLA",38544,215,2,1944,1416,1327,89,1406,10,"POMARLA",,4,,1111,295
7,"Botoșani",74,"74-POMARLA",38544,216,2,259,243,196,47,243,0,"POMARLA",,4,,180,63
7,"Botoșani",74,"74-PRAJENI",38580,217,2,2047,1281,1201,80,1268,13,"PRAJENI",,4,,1024,244
7,"Botoșani",74,"74-PRAJENI",38580,218,2,468,294,251,43,287,7,"PRAJENI",,4,,243,44
7,"Botoșani",74,"74-RADAUTI-PRUT",38633,219,2,737,680,526,154,675,5,"RADAUTI-PRUT",,4,,471,204
7,"Botoșani",74,"74-RADAUTI-PRUT",38633,220,2,982,755,651,104,747,8,"RADAUTI-PRUT",,4,,577,170
7,"Botoșani",74,"74-RADAUTI-PRUT",38633,221,2,1934,1588,1476,112,1576,12,"RADAUTI-PRUT",,4,,1352,224
7,"Botoșani",74,"74-RACHITI",35839,222,2,1143,711,609,102,705,6,"RACHITI",,4,,488,217
7,"Botoșani",74,"74-RACHITI",35839,223,2,1036,945,760,185,927,18,"RACHITI",,4,,711,216
7,"Botoșani",74,"74-RACHITI",35839,224,2,948,820,652,168,810,10,"RACHITI",,4,,602,208
7,"Botoșani",74,"74-RAUSENI",38679,225,2,1297,932,717,215,923,9,"RAUSENI",,4,,751,172
7,"Botoșani",74,"74-RAUSENI",38679,226,2,376,365,248,117,358,7,"RAUSENI",,4,,310,48
7,"Botoșani",74,"74-RAUSENI",38679,227,2,715,365,346,19,359,6,"RAUSENI",,4,,314,45
7,"Botoșani",74,"74-RIPICENI",38731,228,2,1847,1420,1256,164,1408,12,"RIPICENI",,4,,1021,387
7,"Botoșani",74,"74-ROMA",38811,229,2,1099,953,762,191,936,17,"ROMA",,4,,700,236
7,"Botoșani",74,"74-ROMA",38811,230,2,925,721,635,86,714,7,"ROMA",,4,,576,138
7,"Botoșani",74,"74-ROMA",38811,231,2,433,324,272,52,322,2,"ROMA",,4,,212,110
7,"Botoșani",74,"74-ROMANESTI",38848,232,2,1358,942,852,90,934,8,"ROMANESTI",,4,,729,205
7,"Botoșani",74,"74-ROMANESTI",38848,233,2,514,345,294,51,342,3,"ROMANESTI",,4,,274,68
7,"Botoșani",74,"74-SANTA MARE",38893,234,2,1199,808,694,114,796,12,"SANTA MARE",,4,,553,243
7,"Botoșani",74,"74-SANTA MARE",38893,235,2,184,177,135,42,176,1,"SANTA MARE",,4,,148,28
7,"Botoșani",74,"74-SANTA MARE",38893,236,2,804,527,467,60,517,10,"SANTA MARE",,4,,415,102
7,"Botoșani",74,"74-SANTA MARE",38893,237,2,274,362,187,175,359,3,"SANTA MARE",,4,,302,57
7,"Botoșani",74,"74-SUHARAU",38982,238,2,1483,846,702,144,838,8,"SUHARAU",,4,,683,155
7,"Botoșani",74,"74-SUHARAU",38982,239,2,616,522,407,115,517,5,"SUHARAU",,4,,449,68
7,"Botoșani",74,"74-SUHARAU",38982,240,2,736,641,511,130,635,6,"SUHARAU",,4,,490,145
7,"Botoșani",74,"74-SUHARAU",38982,241,2,714,636,481,155,633,3,"SUHARAU",,4,,478,155
7,"Botoșani",74,"74-SUHARAU",38982,242,2,998,729,633,96,719,10,"SUHARAU",,4,,562,157
7,"Botoșani",74,"74-SULITA",39051,243,2,1206,833,656,177,831,2,"SULITA",,4,,642,189
7,"Botoșani",74,"74-SULITA",39051,244,2,1476,1094,914,180,1080,14,"SULITA",,4,,790,290
7,"Botoșani",74,"74-SULITA",39051,245,2,1532,1126,948,178,1122,4,"SULITA",,4,,834,288
7,"Botoșani",74,"74-SULITA",39051,246,2,345,343,319,24,338,5,"SULITA",,4,,246,92
7,"Botoșani",74,"74-SENDRICENI",39122,247,2,947,698,596,102,693,5,"SENDRICENI",,4,,582,111
7,"Botoșani",74,"74-SENDRICENI",39122,248,2,522,452,343,109,449,3,"SENDRICENI",,4,,375,74
7,"Botoșani",74,"74-SENDRICENI",39122,249,2,438,336,277,59,334,2,"SENDRICENI",,4,,265,69
7,"Botoșani",74,"74-SENDRICENI",39122,250,2,857,646,556,90,644,2,"SENDRICENI",,4,,532,112
7,"Botoșani",74,"74-STAUCENI",35884,251,2,1292,1004,884,120,993,11,"STAUCENI",,4,,812,181
7,"Botoșani",74,"74-STAUCENI",35884,252,2,1059,914,744,170,900,14,"STAUCENI",,4,,594,306
7,"Botoșani",74,"74-STEFANESTI",39177,253,2,1074,867,734,133,856,11,"STEFANESTI",,4,,685,171
7,"Botoșani",74,"74-STEFANESTI",39177,254,2,2640,1772,1499,273,1760,12,"STEFANESTI",,4,,1021,739
7,"Botoșani",74,"74-STEFANESTI",39177,255,2,756,580,434,146,579,1,"STEFANESTI",,4,,376,203
7,"Botoșani",74,"74-STIUBIENI",39220,256,2,1612,1168,1026,142,1155,13,"STIUBIENI",,4,,891,264
7,"Botoșani",74,"74-STIUBIENI",39220,257,2,658,577,450,127,572,5,"STIUBIENI",,4,,413,159
7,"Botoșani",74,"74-TODIRENI",39266,258,2,1744,1183,982,201,1175,8,"TODIRENI",,4,,929,246
7,"Botoșani",74,"74-TODIRENI",39266,259,2,1149,845,693,152,839,6,"TODIRENI",,4,,719,120
7,"Botoșani",74,"74-TRUSESTI",39328,260,2,1870,1516,1275,241,1509,7,"TRUSESTI",,4,,1026,483
7,"Botoșani",74,"74-TRUSESTI",39328,261,2,672,515,450,65,508,7,"TRUSESTI",,4,,408,100
7,"Botoșani",74,"74-TRUSESTI",39328,262,2,877,640,575,65,628,12,"TRUSESTI",,4,,458,170
7,"Botoșani",74,"74-TRUSESTI",39328,263,2,1007,834,712,122,825,9,"TRUSESTI",,4,,691,134
7,"Botoșani",74,"74-TUDORA",39391,264,2,1704,1027,963,64,1014,13,"TUDORA",,4,,867,147
7,"Botoșani",74,"74-TUDORA",39391,265,2,1042,724,521,203,709,15,"TUDORA",,4,,567,142
7,"Botoșani",74,"74-TUDORA",39391,266,2,1440,775,730,45,772,3,"TUDORA",,4,,626,146
7,"Botoșani",74,"74-UNGURENI",39417,267,2,1059,876,639,237,863,13,"UNGURENI",,4,,601,262
7,"Botoșani",74,"74-UNGURENI",39417,268,2,1495,895,741,154,891,4,"UNGURENI",,4,,661,230
7,"Botoșani",74,"74-UNGURENI",39417,269,2,814,684,519,165,672,12,"UNGURENI",,4,,467,205
7,"Botoșani",74,"74-UNGURENI",39417,270,2,343,334,249,85,331,3,"UNGURENI",,4,,227,104
7,"Botoșani",74,"74-UNGURENI",39417,271,2,1192,821,661,160,812,9,"UNGURENI",,4,,638,174
7,"Botoșani",74,"74-UNGURENI",39417,272,2,466,494,303,191,487,7,"UNGURENI",,4,,368,119
7,"Botoșani",74,"74-UNTENI",39532,273,2,1121,815,749,66,810,5,"UNTENI",,4,,672,138
7,"Botoșani",74,"74-UNTENI",39532,274,2,683,580,510,70,578,2,"UNTENI",,4,,455,123
7,"Botoșani",74,"74-UNTENI",39532,275,2,744,623,516,107,614,9,"UNTENI",,4,,521,93
7,"Botoșani",74,"74-VACULESTI",39612,276,2,971,778,667,111,772,6,"VACULESTI",,4,,501,271
7,"Botoșani",74,"74-VACULESTI",39612,277,2,762,664,574,90,657,7,"VACULESTI",,4,,481,176
7,"Botoșani",74,"74-VIISOARA",39658,278,2,927,743,678,65,733,10,"VIISOARA",,4,,585,148
7,"Botoșani",74,"74-VIISOARA",39658,279,2,553,455,384,71,448,7,"VIISOARA",,4,,376,72
7,"Botoșani",74,"74-VIISOARA",39658,280,2,554,409,373,36,404,5,"VIISOARA",,4,,327,77
7,"Botoșani",74,"74-VARFU CAMPULUI",39694,281,2,1726,1341,1191,150,1323,16,"VARFU CAMPULUI",,4,,832,491
7,"Botoșani",74,"74-VARFU CAMPULUI",39694,282,2,673,553,469,84,550,3,"VARFU CAMPULUI",,4,,420,130
7,"Botoșani",74,"74-VARFU CAMPULUI",39694,283,2,591,541,399,142,529,12,"VARFU CAMPULUI",,4,,364,165
7,"Botoșani",74,"74-VLADENI",36747,284,2,1483,1114,988,126,1108,6,"VLADENI",,4,,794,314
7,"Botoșani",74,"74-VLADENI",36747,285,2,1227,873,759,114,858,15,"VLADENI",,4,,565,293
7,"Botoșani",74,"74-VLADENI",36747,286,2,1096,808,706,102,798,10,"VLADENI",,4,,655,143
7,"Botoșani",74,"74-VLASINESTI",39792,287,2,1541,1228,1095,133,1222,6,"VLASINESTI",,4,,941,281
7,"Botoșani",74,"74-VLASINESTI",39792,288,2,1217,940,805,135,932,8,"VLASINESTI",,4,,679,253
7,"Botoșani",74,"74-VORNICENI",39836,289,2,2285,1301,1196,105,1290,11,"VORNICENI",,4,,1064,226
7,"Botoșani",74,"74-VORNICENI",39836,290,2,1329,1008,940,68,992,16,"VORNICENI",,4,,817,175
7,"Botoșani",74,"74-VORONA",39872,291,2,720,532,362,170,525,7,"VORONA",,4,,368,157
7,"Botoșani",74,"74-VORONA",39872,292,2,1037,842,513,329,830,12,"VORONA",,4,,613,217
7,"Botoșani",74,"74-VORONA",39872,293,2,1103,653,525,128,647,6,"VORONA",,4,,522,125
7,"Botoșani",74,"74-VORONA",39872,294,2,1073,706,593,113,698,8,"VORONA",,4,,557,141
7,"Botoșani",74,"74-VORONA",39872,295,2,1092,793,623,170,789,4,"VORONA",,4,,635,154
7,"Botoșani",74,"74-VORONA",39872,296,2,1314,708,615,93,708,0,"VORONA",,4,,577,131
8,"Brașov",83,"83-MUNICIPIUL BRASOV",40198,1,2,504,751,320,431,747,4,"MUNICIPIUL BRASOV",,7,,138,609
8,"Brașov",83,"83-MUNICIPIUL BRASOV",40198,2,2,1344,1129,1038,91,1122,7,"MUNICIPIUL BRASOV",,7,,376,746
8,"Brașov",83,"83-MUNICIPIUL BRASOV",40198,3,2,1301,991,893,98,989,2,"MUNICIPIUL BRASOV",,7,,258,731
8,"Brașov",83,"83-MUNICIPIUL BRASOV",40198,4,2,1041,805,732,73,803,2,"MUNICIPIUL BRASOV",,7,,212,591
8,"Brașov",83,"83-MUNICIPIUL BRASOV",40198,5,2,1404,1116,973,143,1113,3,"MUNICIPIUL BRASOV",,7,,326,787
8,"Brașov",83,"83-MUNICIPIUL BRASOV",40198,6,2,820,768,611,157,766,2,"MUNICIPIUL BRASOV",,7,,211,555
8,"Brașov",83,"83-MUNICIPIUL BRASOV",40198,7,2,1088,833,748,85,832,1,"MUNICIPIUL BRASOV",,7,,248,584
8,"Brașov",83,"83-MUNICIPIUL BRASOV",40198,8,2,1582,1190,1068,122,1185,5,"MUNICIPIUL BRASOV",,7,,301,884
8,"Brașov",83,"83-MUNICIPIUL BRASOV",40198,9,2,1377,1072,971,101,1063,9,"MUNICIPIUL BRASOV",,7,,312,751
8,"Brașov",83,"83-MUNICIPIUL BRASOV",40198,10,2,1243,974,878,96,972,2,"MUNICIPIUL BRASOV",,7,,269,703
8,"Brașov",83,"83-MUNICIPIUL BRASOV",40198,11,2,1440,1086,1004,82,1079,7,"MUNICIPIUL BRASOV",,7,,328,751
8,"Brașov",83,"83-MUNICIPIUL BRASOV",40198,12,2,1660,1372,1155,217,1368,4,"MUNICIPIUL BRASOV",,7,,400,968
8,"Brașov",83,"83-MUNICIPIUL BRASOV",40198,13,2,1546,1235,1107,128,1229,6,"MUNICIPIUL BRASOV",,7,,355,874
8,"Brașov",83,"83-MUNICIPIUL BRASOV",40198,14,2,1169,1049,838,211,1042,7,"MUNICIPIUL BRASOV",,7,,306,736
8,"Brașov",83,"83-MUNICIPIUL BRASOV",40198,15,2,1374,1347,976,371,1343,4,"MUNICIPIUL BRASOV",,7,,461,882
8,"Brașov",83,"83-MUNICIPIUL BRASOV",40198,16,2,1446,1309,1064,245,1305,4,"MUNICIPIUL BRASOV",,7,,313,992
8,"Brașov",83,"83-MUNICIPIUL BRASOV",40198,17,2,1149,942,872,70,939,3,"MUNICIPIUL BRASOV",,7,,338,601
8,"Brașov",83,"83-MUNICIPIUL BRASOV",40198,18,2,1467,1203,1135,68,1202,1,"MUNICIPIUL BRASOV",,7,,300,902
8,"Brașov",83,"83-MUNICIPIUL BRASOV",40198,19,2,1078,1100,786,314,1096,4,"MUNICIPIUL BRASOV",,7,,362,734
8,"Brașov",83,"83-MUNICIPIUL BRASOV",40198,20,2,1249,985,903,82,982,3,"MUNICIPIUL BRASOV",,7,,295,687
8,"Brașov",83,"83-MUNICIPIUL BRASOV",40198,21,2,1148,945,863,82,942,3,"MUNICIPIUL BRASOV",,7,,208,734
8,"Brașov",83,"83-MUNICIPIUL BRASOV",40198,22,2,1370,1078,972,106,1075,3,"MUNICIPIUL BRASOV",,7,,292,783
8,"Brașov",83,"83-MUNICIPIUL BRASOV",40198,23,2,1320,1047,980,67,1044,3,"MUNICIPIUL BRASOV",,7,,288,756
8,"Brașov",83,"83-MUNICIPIUL BRASOV",40198,24,2,1200,947,872,75,945,2,"MUNICIPIUL BRASOV",,7,,197,748
8,"Brașov",83,"83-MUNICIPIUL BRASOV",40198,25,2,1448,1292,1074,218,1282,10,"MUNICIPIUL BRASOV",,7,,400,882
8,"Brașov",83,"83-MUNICIPIUL BRASOV",40198,26,2,803,613,565,48,613,0,"MUNICIPIUL BRASOV",,7,,135,478
8,"Brașov",83,"83-MUNICIPIUL BRASOV",40198,27,2,1214,980,837,143,974,6,"MUNICIPIUL BRASOV",,7,,277,697
8,"Brașov",83,"83-MUNICIPIUL BRASOV",40198,28,2,1580,1191,1115,76,1185,6,"MUNICIPIUL BRASOV",,7,,370,815
8,"Brașov",83,"83-MUNICIPIUL BRASOV",40198,29,2,1479,1207,1107,100,1203,4,"MUNICIPIUL BRASOV",,7,,326,877
8,"Brașov",83,"83-MUNICIPIUL BRASOV",40198,30,2,1362,1000,908,92,994,6,"MUNICIPIUL BRASOV",,7,,298,696
8,"Brașov",83,"83-MUNICIPIUL BRASOV",40198,31,2,1250,963,876,87,952,3,"MUNICIPIUL BRASOV",,7,,254,698
8,"Brașov",83,"83-MUNICIPIUL BRASOV",40198,32,2,966,760,662,98,757,3,"MUNICIPIUL BRASOV",,7,,168,589
8,"Brașov",83,"83-MUNICIPIUL BRASOV",40198,33,2,1251,924,812,112,921,3,"MUNICIPIUL BRASOV",,7,,246,675
8,"Brașov",83,"83-MUNICIPIUL BRASOV",40198,34,2,1285,908,811,97,906,2,"MUNICIPIUL BRASOV",,7,,293,613
8,"Brașov",83,"83-MUNICIPIUL BRASOV",40198,35,2,1070,885,734,151,880,5,"MUNICIPIUL BRASOV",,7,,159,721
8,"Brașov",83,"83-MUNICIPIUL BRASOV",40198,36,2,1773,1402,1221,181,1400,2,"MUNICIPIUL BRASOV",,7,,337,1063
8,"Brașov",83,"83-MUNICIPIUL BRASOV",40198,37,2,1580,1182,1073,109,1178,4,"MUNICIPIUL BRASOV",,7,,280,898
8,"Brașov",83,"83-MUNICIPIUL BRASOV",40198,38,2,1538,1104,959,145,1101,3,"MUNICIPIUL BRASOV",,7,,267,834
8,"Brașov",83,"83-MUNICIPIUL BRASOV",40198,39,2,697,524,426,98,523,1,"MUNICIPIUL BRASOV",,7,,79,444
8,"Brașov",83,"83-MUNICIPIUL BRASOV",40198,40,2,1599,1118,1067,51,1117,1,"MUNICIPIUL BRASOV",,7,,322,795
8,"Brașov",83,"83-MUNICIPIUL BRASOV",40198,41,2,855,629,572,57,627,2,"MUNICIPIUL BRASOV",,7,,141,486
8,"Brașov",83,"83-MUNICIPIUL BRASOV",40198,42,2,1632,1296,1197,99,1292,4,"MUNICIPIUL BRASOV",,7,,247,1045
8,"Brașov",83,"83-MUNICIPIUL BRASOV",40198,43,2,1278,1029,893,136,1025,4,"MUNICIPIUL BRASOV",,7,,225,800
8,"Brașov",83,"83-MUNICIPIUL BRASOV",40198,44,2,1734,1296,1096,200,1290,6,"MUNICIPIUL BRASOV",,7,,286,1004
8,"Brașov",83,"83-MUNICIPIUL BRASOV",40198,45,2,1038,795,741,54,787,8,"MUNICIPIUL BRASOV",,7,,221,566
8,"Brașov",83,"83-MUNICIPIUL BRASOV",40198,46,2,1581,1270,1182,88,1269,1,"MUNICIPIUL BRASOV",,7,,374,895
8,"Brașov",83,"83-MUNICIPIUL BRASOV",40198,47,2,1150,963,866,97,960,3,"MUNICIPIUL BRASOV",,7,,267,693
8,"Brașov",83,"83-MUNICIPIUL BRASOV",40198,48,2,2284,1790,1666,124,1786,4,"MUNICIPIUL BRASOV",,7,,474,1312
8,"Brașov",83,"83-MUNICIPIUL BRASOV",40198,49,2,1663,1322,1219,103,1316,6,"MUNICIPIUL BRASOV",,7,,406,910
8,"Brașov",83,"83-MUNICIPIUL BRASOV",40198,50,2,1738,1335,1264,71,1333,2,"MUNICIPIUL BRASOV",,7,,454,879
8,"Brașov",83,"83-MUNICIPIUL BRASOV",40198,51,2,1085,870,780,90,868,2,"MUNICIPIUL BRASOV",,7,,236,632
8,"Brașov",83,"83-MUNICIPIUL BRASOV",40198,52,2,1695,1329,1239,90,1322,7,"MUNICIPIUL BRASOV",,7,,338,984
8,"Brașov",83,"83-MUNICIPIUL BRASOV",40198,53,2,2428,1870,1799,71,1865,5,"MUNICIPIUL BRASOV",,7,,530,1335
8,"Brașov",83,"83-MUNICIPIUL BRASOV",40198,54,2,2002,1609,1526,83,1602,7,"MUNICIPIUL BRASOV",,7,,411,1191
8,"Brașov",83,"83-MUNICIPIUL BRASOV",40198,55,2,2257,1759,1661,98,1754,5,"MUNICIPIUL BRASOV",,7,,510,1244
8,"Brașov",83,"83-MUNICIPIUL BRASOV",40198,56,2,1555,1199,1111,88,1195,4,"MUNICIPIUL BRASOV",,7,,350,845
8,"Brașov",83,"83-MUNICIPIUL BRASOV",40198,57,2,1105,847,790,57,844,3,"MUNICIPIUL BRASOV",,7,,315,529
8,"Brașov",83,"83-MUNICIPIUL BRASOV",40198,58,2,1555,1193,1118,75,1190,3,"MUNICIPIUL BRASOV",,7,,356,834
8,"Brașov",83,"83-MUNICIPIUL BRASOV",40198,59,2,1039,894,756,138,890,4,"MUNICIPIUL BRASOV",,7,,315,575
8,"Brașov",83,"83-MUNICIPIUL BRASOV",40198,60,2,1024,825,770,55,825,0,"MUNICIPIUL BRASOV",,7,,276,549
8,"Brașov",83,"83-MUNICIPIUL BRASOV",40198,61,2,1699,1363,1296,67,1355,8,"MUNICIPIUL BRASOV",,7,,361,994
8,"Brașov",83,"83-MUNICIPIUL BRASOV",40198,62,2,2258,1750,1614,136,1735,6,"MUNICIPIUL BRASOV",,7,,568,1167
8,"Brașov",83,"83-MUNICIPIUL BRASOV",40198,63,2,1519,1124,1030,94,1119,5,"MUNICIPIUL BRASOV",,7,,343,776
8,"Brașov",83,"83-MUNICIPIUL BRASOV",40198,64,2,2566,2493,1837,656,2484,9,"MUNICIPIUL BRASOV",,7,,709,1775
8,"Brașov",83,"83-MUNICIPIUL BRASOV",40198,65,2,1745,1429,1229,200,1424,3,"MUNICIPIUL BRASOV",,7,,429,995
8,"Brașov",83,"83-MUNICIPIUL BRASOV",40198,66,2,1253,1521,824,697,1504,17,"MUNICIPIUL BRASOV",,7,,546,958
8,"Brașov",83,"83-MUNICIPIUL BRASOV",40198,67,2,1155,871,777,94,866,5,"MUNICIPIUL BRASOV",,7,,300,566
8,"Brașov",83,"83-MUNICIPIUL BRASOV",40198,68,2,2044,1688,1468,220,1684,3,"MUNICIPIUL BRASOV",,7,,533,1151
8,"Brașov",83,"83-MUNICIPIUL BRASOV",40198,69,2,1034,821,752,69,815,6,"MUNICIPIUL BRASOV",,7,,232,583
8,"Brașov",83,"83-MUNICIPIUL BRASOV",40198,70,2,886,706,650,56,705,1,"MUNICIPIUL BRASOV",,7,,201,504
8,"Brașov",83,"83-MUNICIPIUL BRASOV",40198,71,2,1131,936,820,116,932,4,"MUNICIPIUL BRASOV",,7,,257,675
8,"Brașov",83,"83-MUNICIPIUL BRASOV",40198,72,2,1614,1289,1170,119,1286,3,"MUNICIPIUL BRASOV",,7,,399,887
8,"Brașov",83,"83-MUNICIPIUL BRASOV",40198,73,2,1628,1267,1190,77,1265,2,"MUNICIPIUL BRASOV",,7,,428,837
8,"Brașov",83,"83-MUNICIPIUL BRASOV",40198,74,2,1175,1023,883,140,1021,2,"MUNICIPIUL BRASOV",,7,,378,643
8,"Brașov",83,"83-MUNICIPIUL BRASOV",40198,75,2,1860,1509,1419,90,1504,5,"MUNICIPIUL BRASOV",,7,,517,987
8,"Brașov",83,"83-MUNICIPIUL BRASOV",40198,76,2,522,451,395,56,450,1,"MUNICIPIUL BRASOV",,7,,110,340
8,"Brașov",83,"83-MUNICIPIUL BRASOV",40198,77,2,799,2164,497,1667,2154,10,"MUNICIPIUL BRASOV",,7,,576,1578
8,"Brașov",83,"83-MUNICIPIUL BRASOV",40198,78,2,1509,864,787,77,863,1,"MUNICIPIUL BRASOV",,7,,247,616
8,"Brașov",83,"83-MUNICIPIUL BRASOV",40198,79,2,2752,2260,1989,271,2246,14,"MUNICIPIUL BRASOV",,7,,622,1624
8,"Brașov",83,"83-MUNICIPIUL BRASOV",40198,80,2,2290,2152,1464,688,2133,19,"MUNICIPIUL BRASOV",,7,,635,1498
8,"Brașov",83,"83-MUNICIPIUL BRASOV",40198,81,2,1677,1310,1222,88,1306,4,"MUNICIPIUL BRASOV",,7,,386,920
8,"Brașov",83,"83-MUNICIPIUL BRASOV",40198,82,2,1843,1427,1338,89,1424,3,"MUNICIPIUL BRASOV",,7,,413,1011
8,"Brașov",83,"83-MUNICIPIUL BRASOV",40198,83,2,1685,1299,1216,83,1292,7,"MUNICIPIUL BRASOV",,7,,372,920
8,"Brașov",83,"83-MUNICIPIUL BRASOV",40198,84,2,1988,1534,1335,199,1526,8,"MUNICIPIUL BRASOV",,7,,457,1069
8,"Brașov",83,"83-MUNICIPIUL BRASOV",40198,85,2,1821,1417,1320,97,1408,9,"MUNICIPIUL BRASOV",,7,,379,1029
8,"Brașov",83,"83-MUNICIPIUL BRASOV",40198,86,2,1466,1139,1058,81,1137,2,"MUNICIPIUL BRASOV",,7,,354,783
8,"Brașov",83,"83-MUNICIPIUL BRASOV",40198,87,2,1940,1492,1404,88,1488,4,"MUNICIPIUL BRASOV",,7,,476,1012
8,"Brașov",83,"83-MUNICIPIUL BRASOV",40198,88,2,1388,1060,971,89,1056,4,"MUNICIPIUL BRASOV",,7,,313,743
8,"Brașov",83,"83-MUNICIPIUL BRASOV",40198,89,2,1225,945,905,40,943,2,"MUNICIPIUL BRASOV",,7,,242,701
8,"Brașov",83,"83-MUNICIPIUL BRASOV",40198,90,2,1962,1544,1480,64,1541,3,"MUNICIPIUL BRASOV",,7,,535,1006
8,"Brașov",83,"83-MUNICIPIUL BRASOV",40198,91,2,1527,1190,1130,60,1186,4,"MUNICIPIUL BRASOV",,7,,370,816
8,"Brașov",83,"83-MUNICIPIUL BRASOV",40198,92,2,1770,1257,1166,91,1253,4,"MUNICIPIUL BRASOV",,7,,361,892
8,"Brașov",83,"83-MUNICIPIUL BRASOV",40198,93,2,2829,2025,1908,117,2019,6,"MUNICIPIUL BRASOV",,7,,666,1353
8,"Brașov",83,"83-MUNICIPIUL BRASOV",40198,94,2,1345,999,870,129,997,2,"MUNICIPIUL BRASOV",,7,,249,748
8,"Brașov",83,"83-MUNICIPIUL BRASOV",40198,95,2,1742,1412,1329,83,1410,2,"MUNICIPIUL BRASOV",,7,,384,1026
8,"Brașov",83,"83-MUNICIPIUL BRASOV",40198,96,2,928,700,657,43,699,1,"MUNICIPIUL BRASOV",,7,,236,463
8,"Brașov",83,"83-MUNICIPIUL BRASOV",40198,97,2,1103,896,847,49,893,3,"MUNICIPIUL BRASOV",,7,,279,614
8,"Brașov",83,"83-MUNICIPIUL BRASOV",40198,98,2,1798,1461,1371,90,1456,5,"MUNICIPIUL BRASOV",,7,,414,1042
8,"Brașov",83,"83-MUNICIPIUL BRASOV",40198,99,2,1670,1292,1192,100,1290,2,"MUNICIPIUL BRASOV",,7,,331,959
8,"Brașov",83,"83-MUNICIPIUL BRASOV",40198,100,2,1860,1419,1283,136,1415,4,"MUNICIPIUL BRASOV",,7,,364,1051
8,"Brașov",83,"83-MUNICIPIUL BRASOV",40198,101,2,2000,1776,1434,342,1769,7,"MUNICIPIUL BRASOV",,7,,507,1262
8,"Brașov",83,"83-MUNICIPIUL BRASOV",40198,102,2,1524,1175,1063,112,1168,7,"MUNICIPIUL BRASOV",,7,,356,812
8,"Brașov",83,"83-MUNICIPIUL BRASOV",40198,103,2,734,607,512,95,607,0,"MUNICIPIUL BRASOV",,7,,177,430
8,"Brașov",83,"83-MUNICIPIUL BRASOV",40198,104,2,1715,1400,1190,210,1392,8,"MUNICIPIUL BRASOV",,7,,483,909
8,"Brașov",83,"83-MUNICIPIUL BRASOV",40198,105,2,1593,1256,1174,82,1252,4,"MUNICIPIUL BRASOV",,7,,525,727
8,"Brașov",83,"83-MUNICIPIUL BRASOV",40198,106,2,1371,1008,962,46,1002,6,"MUNICIPIUL BRASOV",,7,,284,718
8,"Brașov",83,"83-MUNICIPIUL BRASOV",40198,107,2,1562,1224,1170,54,1216,8,"MUNICIPIUL BRASOV",,7,,398,818
8,"Brașov",83,"83-MUNICIPIUL BRASOV",40198,108,2,1384,1100,1016,84,1100,0,"MUNICIPIUL BRASOV",,7,,323,777
8,"Brașov",83,"83-MUNICIPIUL BRASOV",40198,109,2,831,715,661,54,713,2,"MUNICIPIUL BRASOV",,7,,258,455
8,"Brașov",83,"83-MUNICIPIUL BRASOV",40198,110,2,852,681,653,28,681,0,"MUNICIPIUL BRASOV",,7,,238,443
8,"Brașov",83,"83-MUNICIPIUL BRASOV",40198,111,2,1559,1155,1087,68,1151,4,"MUNICIPIUL BRASOV",,7,,430,721
8,"Brașov",83,"83-MUNICIPIUL BRASOV",40198,112,2,1258,976,929,47,975,1,"MUNICIPIUL BRASOV",,7,,244,731
8,"Brașov",83,"83-MUNICIPIUL BRASOV",40198,113,2,925,707,670,37,707,0,"MUNICIPIUL BRASOV",,7,,240,467
8,"Brașov",83,"83-MUNICIPIUL BRASOV",40198,114,2,1744,1378,1307,71,1374,4,"MUNICIPIUL BRASOV",,7,,477,897
8,"Brașov",83,"83-MUNICIPIUL BRASOV",40198,115,2,1332,882,842,40,880,2,"MUNICIPIUL BRASOV",,7,,333,547
8,"Brașov",83,"83-MUNICIPIUL BRASOV",40198,116,2,918,725,663,62,722,3,"MUNICIPIUL BRASOV",,7,,241,481
8,"Brașov",83,"83-MUNICIPIUL BRASOV",40198,117,2,1032,874,784,90,870,4,"MUNICIPIUL BRASOV",,7,,302,568
8,"Brașov",83,"83-MUNICIPIUL BRASOV",40198,118,2,1261,1074,919,155,1070,4,"MUNICIPIUL BRASOV",,7,,326,744
8,"Brașov",83,"83-MUNICIPIUL BRASOV",40198,119,2,658,544,469,75,541,3,"MUNICIPIUL BRASOV",,7,,182,359
8,"Brașov",83,"83-MUNICIPIUL BRASOV",40198,120,2,1674,1373,1198,175,1368,5,"MUNICIPIUL BRASOV",,7,,502,866
8,"Brașov",83,"83-MUNICIPIUL BRASOV",40198,121,2,1032,927,756,171,923,4,"MUNICIPIUL BRASOV",,7,,254,669
8,"Brașov",83,"83-MUNICIPIUL BRASOV",40198,122,2,1313,1235,737,498,1228,7,"MUNICIPIUL BRASOV",,7,,338,890
8,"Brașov",83,"83-MUNICIPIUL BRASOV",40198,123,2,766,628,594,34,625,3,"MUNICIPIUL BRASOV",,7,,175,450
8,"Brașov",83,"83-MUNICIPIUL BRASOV",40198,124,2,1602,1234,1120,114,1226,8,"MUNICIPIUL BRASOV",,7,,455,771
8,"Brașov",83,"83-MUNICIPIUL BRASOV",40198,125,2,1784,1590,1226,364,1587,3,"MUNICIPIUL BRASOV",,7,,688,899
8,"Brașov",83,"83-MUNICIPIUL BRASOV",40198,126,2,1842,1382,1287,95,1374,8,"MUNICIPIUL BRASOV",,7,,463,911
8,"Brașov",83,"83-MUNICIPIUL BRASOV",40198,127,2,886,702,640,62,700,2,"MUNICIPIUL BRASOV",,7,,231,469
8,"Brașov",83,"83-MUNICIPIUL BRASOV",40198,128,2,1469,1116,1064,52,1112,4,"MUNICIPIUL BRASOV",,7,,352,760
8,"Brașov",83,"83-MUNICIPIUL BRASOV",40198,129,2,2060,1637,1540,97,1631,6,"MUNICIPIUL BRASOV",,7,,461,1170
8,"Brașov",83,"83-MUNICIPIUL BRASOV",40198,130,2,1887,1429,1387,42,1423,6,"MUNICIPIUL BRASOV",,7,,422,1001
8,"Brașov",83,"83-MUNICIPIUL BRASOV",40198,131,2,1855,1466,1325,141,1461,5,"MUNICIPIUL BRASOV",,7,,476,985
8,"Brașov",83,"83-MUNICIPIUL BRASOV",40198,132,2,1380,1008,1008,0,1004,4,"MUNICIPIUL BRASOV",,7,,305,699
8,"Brașov",83,"83-MUNICIPIUL BRASOV",40198,133,2,1096,914,859,55,913,1,"MUNICIPIUL BRASOV",,7,,269,644
8,"Brașov",83,"83-MUNICIPIUL BRASOV",40198,134,2,767,667,595,72,662,5,"MUNICIPIUL BRASOV",,7,,214,448
8,"Brașov",83,"83-MUNICIPIUL BRASOV",40198,135,2,2463,1931,1847,84,1919,9,"MUNICIPIUL BRASOV",,7,,583,1336
8,"Brașov",83,"83-MUNICIPIUL BRASOV",40198,136,2,0,146,0,146,145,1,"MUNICIPIUL BRASOV",,7,,45,100
8,"Brașov",83,"83-MUNICIPIUL BRASOV",40198,137,2,1500,1143,1087,56,1135,8,"MUNICIPIUL BRASOV",,7,,363,772
8,"Brașov",83,"83-MUNICIPIUL BRASOV",40198,138,2,1807,1400,1294,106,1395,5,"MUNICIPIUL BRASOV",,7,,429,966
8,"Brașov",83,"83-MUNICIPIUL BRASOV",40198,139,2,1016,733,690,43,729,4,"MUNICIPIUL BRASOV",,7,,208,521
8,"Brașov",83,"83-MUNICIPIUL BRASOV",40198,140,2,1657,1270,1170,100,1266,4,"MUNICIPIUL BRASOV",,7,,417,849
8,"Brașov",83,"83-MUNICIPIUL BRASOV",40198,141,2,1458,1082,1018,64,1076,6,"MUNICIPIUL BRASOV",,7,,365,711
8,"Brașov",83,"83-MUNICIPIUL BRASOV",40198,142,2,1618,1269,1211,58,1258,11,"MUNICIPIUL BRASOV",,7,,472,786
8,"Brașov",83,"83-MUNICIPIUL BRASOV",40198,143,2,835,693,612,81,689,4,"MUNICIPIUL BRASOV",,7,,231,458
8,"Brașov",83,"83-MUNICIPIUL BRASOV",40198,144,2,1149,894,824,70,890,4,"MUNICIPIUL BRASOV",,7,,291,599
8,"Brașov",83,"83-MUNICIPIUL BRASOV",40198,145,2,1355,1287,1011,276,1286,1,"MUNICIPIUL BRASOV",,7,,447,839
8,"Brașov",83,"83-MUNICIPIUL BRASOV",40198,146,2,1317,1058,980,78,1053,5,"MUNICIPIUL BRASOV",,7,,278,775
8,"Brașov",83,"83-MUNICIPIUL BRASOV",40198,147,2,1420,1177,1047,130,1174,3,"MUNICIPIUL BRASOV",,7,,323,851
8,"Brașov",83,"83-MUNICIPIUL BRASOV",40198,148,2,1452,1131,1072,59,1128,3,"MUNICIPIUL BRASOV",,7,,310,818
8,"Brașov",83,"83-MUNICIPIUL BRASOV",40198,149,2,1837,1410,1305,105,1402,8,"MUNICIPIUL BRASOV",,7,,390,1012
8,"Brașov",83,"83-MUNICIPIUL BRASOV",40198,150,2,2333,1866,1633,233,1855,11,"MUNICIPIUL BRASOV",,7,,525,1330
8,"Brașov",83,"83-MUNICIPIUL BRASOV",40198,151,2,1322,1052,997,55,1048,4,"MUNICIPIUL BRASOV",,7,,264,784
8,"Brașov",83,"83-MUNICIPIUL BRASOV",40198,152,2,1468,1123,1068,55,1122,1,"MUNICIPIUL BRASOV",,7,,338,784
8,"Brașov",83,"83-MUNICIPIUL BRASOV",40198,153,2,1888,1424,1346,78,1421,3,"MUNICIPIUL BRASOV",,7,,391,1030
8,"Brașov",83,"83-MUNICIPIUL BRASOV",40198,154,2,1698,1292,1224,68,1287,5,"MUNICIPIUL BRASOV",,7,,410,877
8,"Brașov",83,"83-MUNICIPIUL BRASOV",40198,155,2,2349,1798,1700,98,1793,5,"MUNICIPIUL BRASOV",,7,,572,1221
8,"Brașov",83,"83-MUNICIPIUL BRASOV",40198,156,2,2338,1782,1707,75,1777,5,"MUNICIPIUL BRASOV",,7,,527,1250
8,"Brașov",83,"83-MUNICIPIUL BRASOV",40198,157,2,2570,1995,1909,86,1988,7,"MUNICIPIUL BRASOV",,7,,632,1356
8,"Brașov",83,"83-MUNICIPIUL BRASOV",40198,158,2,1411,1099,1035,64,1090,9,"MUNICIPIUL BRASOV",,7,,367,723
8,"Brașov",83,"83-MUNICIPIUL BRASOV",40198,159,2,1875,1412,1325,87,1409,3,"MUNICIPIUL BRASOV",,7,,446,963
8,"Brașov",83,"83-MUNICIPIUL BRASOV",40198,160,2,1944,1532,1264,268,1524,8,"MUNICIPIUL BRASOV",,7,,599,925
8,"Brașov",83,"83-MUNICIPIUL BRASOV",40198,161,2,1447,1164,1058,106,1157,7,"MUNICIPIUL BRASOV",,7,,346,811
8,"Brașov",83,"83-MUNICIPIUL BRASOV",40198,162,2,2125,1649,1487,162,1643,6,"MUNICIPIUL BRASOV",,7,,635,1008
8,"Brașov",83,"83-MUNICIPIUL BRASOV",40198,163,2,1440,1130,1011,119,1125,5,"MUNICIPIUL BRASOV",,7,,464,661
8,"Brașov",83,"83-MUNICIPIUL BRASOV",40198,164,2,1790,1349,1259,90,1343,6,"MUNICIPIUL BRASOV",,7,,476,867
8,"Brașov",83,"83-MUNICIPIUL BRASOV",40198,165,2,1915,1382,1290,92,1382,0,"MUNICIPIUL BRASOV",,7,,566,816
8,"Brașov",83,"83-MUNICIPIUL BRASOV",40198,166,2,1068,882,780,102,880,2,"MUNICIPIUL BRASOV",,7,,307,573
8,"Brașov",83,"83-MUNICIPIUL BRASOV",40198,167,2,1487,1212,1101,111,1209,3,"MUNICIPIUL BRASOV",,7,,401,808
8,"Brașov",83,"83-MUNICIPIUL BRASOV",40198,168,2,506,454,436,18,450,4,"MUNICIPIUL BRASOV",,7,,108,342
8,"Brașov",83,"83-MUNICIPIUL BRASOV",40198,169,2,146,170,143,27,168,2,"MUNICIPIUL BRASOV",,7,,66,102
8,"Brașov",83,"83-MUNICIPIUL BRASOV",40198,170,2,0,0,0,0,0,0,"MUNICIPIUL BRASOV",,7,,0,0
8,"Brașov",83,"83-MUNICIPIUL BRASOV",40198,171,2,0,421,0,421,419,2,"MUNICIPIUL BRASOV",,7,,123,296
8,"Brașov",83,"83-MUNICIPIUL BRASOV",40198,172,2,0,220,0,220,218,2,"MUNICIPIUL BRASOV",,7,,62,156
8,"Brașov",83,"83-MUNICIPIUL BRASOV",40198,173,2,0,61,0,61,61,0,"MUNICIPIUL BRASOV",,7,,7,54
8,"Brașov",83,"83-MUNICIPIUL BRASOV",40198,174,2,0,800,0,800,800,0,"MUNICIPIUL BRASOV",,7,,262,538
8,"Brașov",83,"83-MUNICIPIUL BRASOV",40198,175,2,0,149,0,149,148,1,"MUNICIPIUL BRASOV",,7,,62,86
8,"Brașov",83,"83-MUNICIPIUL BRASOV",40198,176,2,0,1183,0,1183,1179,4,"MUNICIPIUL BRASOV",,7,,181,998
8,"Brașov",83,"83-MUNICIPIUL BRASOV",40198,177,2,0,635,0,635,629,6,"MUNICIPIUL BRASOV",,7,,108,521
8,"Brașov",83,"83-MUNICIPIUL FAGARAS",40278,178,2,1705,1251,1024,227,1246,5,"MUNICIPIUL FAGARAS",,7,,205,1041
8,"Brașov",83,"83-MUNICIPIUL FAGARAS",40278,179,2,1755,1110,1012,98,1105,5,"MUNICIPIUL FAGARAS",,7,,221,884
8,"Brașov",83,"83-MUNICIPIUL FAGARAS",40278,180,2,1456,1018,901,117,1013,5,"MUNICIPIUL FAGARAS",,7,,216,797
8,"Brașov",83,"83-MUNICIPIUL FAGARAS",40278,181,2,1497,1046,986,60,1045,1,"MUNICIPIUL FAGARAS",,7,,189,856
8,"Brașov",83,"83-MUNICIPIUL FAGARAS",40278,182,2,1062,840,754,86,834,6,"MUNICIPIUL FAGARAS",,7,,163,671
8,"Brașov",83,"83-MUNICIPIUL FAGARAS",40278,183,2,1263,865,743,122,859,6,"MUNICIPIUL FAGARAS",,7,,248,611
8,"Brașov",83,"83-MUNICIPIUL FAGARAS",40278,184,2,1652,1201,1103,98,1196,5,"MUNICIPIUL FAGARAS",,7,,269,927
8,"Brașov",83,"83-MUNICIPIUL FAGARAS",40278,185,2,962,841,638,203,838,3,"MUNICIPIUL FAGARAS",,7,,226,612
8,"Brașov",83,"83-MUNICIPIUL FAGARAS",40278,186,2,1539,1087,973,114,1083,4,"MUNICIPIUL FAGARAS",,7,,241,842
8,"Brașov",83,"83-MUNICIPIUL FAGARAS",40278,187,2,1468,988,855,133,985,3,"MUNICIPIUL FAGARAS",,7,,180,805
8,"Brașov",83,"83-MUNICIPIUL FAGARAS",40278,188,2,1091,769,699,70,759,10,"MUNICIPIUL FAGARAS",,7,,183,576
8,"Brașov",83,"83-MUNICIPIUL FAGARAS",40278,189,2,975,862,604,258,860,2,"MUNICIPIUL FAGARAS",,7,,144,716
8,"Brașov",83,"83-MUNICIPIUL FAGARAS",40278,190,2,1241,981,833,148,979,2,"MUNICIPIUL FAGARAS",,7,,199,780
8,"Brașov",83,"83-MUNICIPIUL FAGARAS",40278,191,2,1726,1102,987,115,1099,3,"MUNICIPIUL FAGARAS",,7,,229,870
8,"Brașov",83,"83-MUNICIPIUL FAGARAS",40278,192,2,1138,754,654,100,753,1,"MUNICIPIUL FAGARAS",,7,,157,596
8,"Brașov",83,"83-MUNICIPIUL FAGARAS",40278,193,2,1860,1143,1061,82,1136,7,"MUNICIPIUL FAGARAS",,7,,223,913
8,"Brașov",83,"83-MUNICIPIUL FAGARAS",40278,194,2,1290,839,786,53,838,1,"MUNICIPIUL FAGARAS",,7,,163,675
8,"Brașov",83,"83-MUNICIPIUL FAGARAS",40278,195,2,1011,710,608,102,710,0,"MUNICIPIUL FAGARAS",,7,,110,600
8,"Brașov",83,"83-MUNICIPIUL FAGARAS",40278,196,2,1023,889,589,300,886,3,"MUNICIPIUL FAGARAS",,7,,130,756
8,"Brașov",83,"83-MUNICIPIUL FAGARAS",40278,197,2,1327,1046,843,203,1041,5,"MUNICIPIUL FAGARAS",,7,,178,863
8,"Brașov",83,"83-MUNICIPIUL FAGARAS",40278,198,2,1314,878,789,89,867,11,"MUNICIPIUL FAGARAS",,7,,206,661
8,"Brașov",83,"83-MUNICIPIUL FAGARAS",40278,199,2,1519,1023,844,179,1017,6,"MUNICIPIUL FAGARAS",,7,,209,808
8,"Brașov",83,"83-MUNICIPIUL FAGARAS",40278,200,2,1142,895,703,192,890,5,"MUNICIPIUL FAGARAS",,7,,136,754
8,"Brașov",83,"83-MUNICIPIUL FAGARAS",40278,201,2,1545,1105,1003,102,1097,8,"MUNICIPIUL FAGARAS",,7,,197,900
8,"Brașov",83,"83-MUNICIPIUL FAGARAS",40278,202,2,1555,997,898,99,995,2,"MUNICIPIUL FAGARAS",,7,,298,697
8,"Brașov",83,"83-MUNICIPIUL FAGARAS",40278,203,2,0,250,0,250,247,3,"MUNICIPIUL FAGARAS",,7,,70,177
8,"Brașov",83,"83-MUNICIPIUL FAGARAS",40278,204,2,0,300,0,300,296,4,"MUNICIPIUL FAGARAS",,7,,62,234
8,"Brașov",83,"83-ORAS CODLEA",40241,205,2,1553,1717,1051,666,1709,8,"ORAS CODLEA",,7,,610,1099
8,"Brașov",83,"83-ORAS CODLEA",40241,206,2,1320,1091,984,107,1080,11,"ORAS CODLEA",,7,,434,646
8,"Brașov",83,"83-ORAS CODLEA",40241,207,2,1432,1434,1005,429,1428,6,"ORAS CODLEA",,7,,422,1006
8,"Brașov",83,"83-ORAS CODLEA",40241,208,2,1157,868,777,91,861,7,"ORAS CODLEA",,7,,291,570
8,"Brașov",83,"83-ORAS CODLEA",40241,209,2,1336,1033,943,90,1030,3,"ORAS CODLEA",,7,,358,672
8,"Brașov",83,"83-ORAS CODLEA",40241,210,2,1409,1128,983,145,1123,5,"ORAS CODLEA",,7,,403,720
8,"Brașov",83,"83-ORAS CODLEA",40241,211,2,1376,1007,901,106,995,12,"ORAS CODLEA",,7,,352,643
8,"Brașov",83,"83-ORAS CODLEA",40241,212,2,1362,1022,944,78,1018,4,"ORAS CODLEA",,7,,348,670
8,"Brașov",83,"83-ORAS CODLEA",40241,213,2,1537,1205,1141,64,1201,4,"ORAS CODLEA",,7,,423,778
8,"Brașov",83,"83-ORAS CODLEA",40241,214,2,1715,1284,1205,79,1277,7,"ORAS CODLEA",,7,,421,856
8,"Brașov",83,"83-ORAS CODLEA",40241,215,2,1500,1113,1033,80,1106,7,"ORAS CODLEA",,7,,347,759
8,"Brașov",83,"83-ORAS CODLEA",40241,216,2,1376,1115,1005,110,1106,9,"ORAS CODLEA",,7,,289,817
8,"Brașov",83,"83-ORAS PREDEAL",40303,217,2,1968,2154,1294,860,2139,15,"ORAS PREDEAL",,7,,787,1352
8,"Brașov",83,"83-ORAS PREDEAL",40303,218,2,2360,2162,1531,631,2143,19,"ORAS PREDEAL",,7,,783,1360
8,"Brașov",83,"83-ORAS PREDEAL",40303,219,2,216,334,124,210,329,5,"ORAS PREDEAL",,7,,100,229
8,"Brașov",83,"83-ORAS PREDEAL",40303,220,2,574,407,326,81,406,1,"ORAS PREDEAL",,7,,194,212
8,"Brașov",83,"83-ORAS PREDEAL",40303,221,2,0,0,0,0,0,0,"ORAS PREDEAL",,7,,0,0
8,"Brașov",83,"83-ORAS RASNOV",40367,222,2,1430,1078,964,114,1074,4,"ORAS RASNOV",,7,,340,734
8,"Brașov",83,"83-ORAS RASNOV",40367,223,2,811,654,545,109,646,8,"ORAS RASNOV",,7,,200,446
8,"Brașov",83,"83-ORAS RASNOV",40367,224,2,1163,950,891,59,946,4,"ORAS RASNOV",,7,,373,573
8,"Brașov",83,"83-ORAS RASNOV",40367,225,2,1307,1116,1040,76,1111,5,"ORAS RASNOV",,7,,417,694
8,"Brașov",83,"83-ORAS RASNOV",40367,226,2,626,618,484,134,617,1,"ORAS RASNOV",,7,,133,484
8,"Brașov",83,"83-ORAS RASNOV",40367,227,2,1255,1151,886,265,1146,5,"ORAS RASNOV",,7,,407,739
8,"Brașov",83,"83-ORAS RASNOV",40367,228,2,1651,1521,1360,161,1516,5,"ORAS RASNOV",,7,,462,1054
8,"Brașov",83,"83-ORAS RASNOV",40367,229,2,2006,1558,1409,149,1553,5,"ORAS RASNOV",,7,,523,1030
8,"Brașov",83,"83-ORAS RASNOV",40367,230,2,771,660,584,76,652,8,"ORAS RASNOV",,7,,246,406
8,"Brașov",83,"83-ORAS RASNOV",40367,231,2,244,255,236,19,254,1,"ORAS RASNOV",,7,,73,181
8,"Brașov",83,"83-ORAS RUPEA",40394,232,2,1242,897,812,85,894,3,"ORAS RUPEA",,7,,220,674
8,"Brașov",83,"83-ORAS RUPEA",40394,233,2,1269,908,775,133,904,4,"ORAS RUPEA",,7,,239,665
8,"Brașov",83,"83-ORAS RUPEA",40394,234,2,1362,983,890,93,980,3,"ORAS RUPEA",,7,,252,728
8,"Brașov",83,"83-ORAS RUPEA",40394,235,2,660,514,473,41,513,1,"ORAS RUPEA",,7,,128,385
8,"Brașov",83,"83-ORAS RUPEA",40394,236,2,276,280,196,84,277,3,"ORAS RUPEA",,7,,108,169
8,"Brașov",83,"83-ORAS SACELE",40438,237,2,1624,1318,1175,143,1313,5,"ORAS SACELE",,7,,209,1104
8,"Brașov",83,"83-ORAS SACELE",40438,238,2,1386,1106,1012,94,1101,5,"ORAS SACELE",,7,,290,811
8,"Brașov",83,"83-ORAS SACELE",40438,239,2,1055,872,765,107,864,8,"ORAS SACELE",,7,,204,660
8,"Brașov",83,"83-ORAS SACELE",40438,240,2,1291,973,900,73,970,3,"ORAS SACELE",,7,,128,842
8,"Brașov",83,"83-ORAS SACELE",40438,241,2,1314,1046,976,70,1038,8,"ORAS SACELE",,7,,139,899
8,"Brașov",83,"83-ORAS SACELE",40438,242,2,1563,1202,1110,92,1195,7,"ORAS SACELE",,7,,234,961
8,"Brașov",83,"83-ORAS SACELE",40438,243,2,1372,1174,1103,71,1103,5,"ORAS SACELE",,7,,401,702
8,"Brașov",83,"83-ORAS SACELE",40438,244,2,1064,854,782,72,845,9,"ORAS SACELE",,7,,320,525
8,"Brașov",83,"83-ORAS SACELE",40438,245,2,1582,1302,1206,96,1297,5,"ORAS SACELE",,7,,234,1063
8,"Brașov",83,"83-ORAS SACELE",40438,246,2,1436,1239,1154,85,1234,5,"ORAS SACELE",,7,,419,815
8,"Brașov",83,"83-ORAS SACELE",40438,247,2,506,700,396,304,695,5,"ORAS SACELE",,7,,241,454
8,"Brașov",83,"83-ORAS SACELE",40438,248,2,1251,995,933,62,988,7,"ORAS SACELE",,7,,353,635
8,"Brașov",83,"83-ORAS SACELE",40438,249,2,1453,1197,1131,66,1194,3,"ORAS SACELE",,7,,399,795
8,"Brașov",83,"83-ORAS SACELE",40438,250,2,1368,1199,1028,171,1193,6,"ORAS SACELE",,7,,469,724
8,"Brașov",83,"83-ORAS SACELE",40438,251,2,1018,873,815,58,873,0,"ORAS SACELE",,7,,339,534
8,"Brașov",83,"83-ORAS SACELE",40438,252,2,1322,1044,917,127,1034,10,"ORAS SACELE",,7,,151,883
8,"Brașov",83,"83-ORAS SACELE",40438,253,2,1324,1088,934,154,1073,15,"ORAS SACELE",,7,,163,910
8,"Brașov",83,"83-ORAS VICTORIA",40465,254,2,1309,971,876,95,969,2,"ORAS VICTORIA",,7,,215,754
8,"Brașov",83,"83-ORAS VICTORIA",40465,255,2,1184,885,766,119,883,2,"ORAS VICTORIA",,7,,267,616
8,"Brașov",83,"83-ORAS VICTORIA",40465,256,2,1300,1028,912,116,1022,6,"ORAS VICTORIA",,7,,172,850
8,"Brașov",83,"83-ORAS VICTORIA",40465,257,2,1125,920,819,101,915,5,"ORAS VICTORIA",,7,,306,609
8,"Brașov",83,"83-ORAS VICTORIA",40465,258,2,945,928,655,273,922,6,"ORAS VICTORIA",,7,,322,600
8,"Brașov",83,"83-ORAS VICTORIA",40465,259,2,1387,1088,963,125,1083,5,"ORAS VICTORIA",,7,,169,914
8,"Brașov",83,"83-ORAS ZARNESTI",40492,260,2,1302,987,912,75,982,5,"ORAS ZARNESTI",,7,,351,631
8,"Brașov",83,"83-ORAS ZARNESTI",40492,261,2,1716,1204,1109,95,1195,9,"ORAS ZARNESTI",,7,,555,640
8,"Brașov",83,"83-ORAS ZARNESTI",40492,262,2,1625,1278,1172,106,1267,11,"ORAS ZARNESTI",,7,,590,677
8,"Brașov",83,"83-ORAS ZARNESTI",40492,263,2,1367,1087,992,95,1081,6,"ORAS ZARNESTI",,7,,499,582
8,"Brașov",83,"83-ORAS ZARNESTI",40492,264,2,537,486,350,136,484,2,"ORAS ZARNESTI",,7,,206,278
8,"Brașov",83,"83-ORAS ZARNESTI",40492,265,2,1406,1152,1009,143,1145,7,"ORAS ZARNESTI",,7,,411,734
8,"Brașov",83,"83-ORAS ZARNESTI",40492,266,2,944,1045,923,122,921,2,"ORAS ZARNESTI",,7,,383,538
8,"Brașov",83,"83-ORAS ZARNESTI",40492,267,2,1938,1448,1372,76,1439,9,"ORAS ZARNESTI",,7,,639,800
8,"Brașov",83,"83-ORAS ZARNESTI",40492,268,2,1854,1441,1295,146,1440,1,"ORAS ZARNESTI",,7,,589,851
8,"Brașov",83,"83-ORAS ZARNESTI",40492,269,2,1949,1409,1332,77,1398,11,"ORAS ZARNESTI",,7,,643,755
8,"Brașov",83,"83-ORAS ZARNESTI",40492,270,2,1136,956,718,238,950,6,"ORAS ZARNESTI",,7,,366,584
8,"Brașov",83,"83-ORAS ZARNESTI",40492,271,2,912,691,593,98,685,6,"ORAS ZARNESTI",,7,,290,395
8,"Brașov",83,"83-ORAS ZARNESTI",40492,272,2,1512,1025,883,142,1011,13,"ORAS ZARNESTI",,7,,421,590
8,"Brașov",83,"83-ORAS ZARNESTI",40492,273,2,1152,898,752,146,893,5,"ORAS ZARNESTI",,7,,370,523
8,"Brașov",83,"83-APATA",40526,274,2,1355,1154,962,192,1141,13,"APATA",,7,,191,950
8,"Brașov",83,"83-APATA",40526,275,2,491,514,383,131,513,1,"APATA",,7,,48,465
8,"Brașov",83,"83-BECLEAN",40544,276,2,496,468,372,96,465,3,"BECLEAN",,7,,115,350
8,"Brașov",83,"83-BECLEAN",40544,277,2,188,176,130,46,175,1,"BECLEAN",,7,,33,142
8,"Brașov",83,"83-BECLEAN",40544,278,2,181,169,103,66,167,2,"BECLEAN",,7,,56,111
8,"Brașov",83,"83-BECLEAN",40544,279,2,352,335,268,67,332,3,"BECLEAN",,7,,78,254
8,"Brașov",83,"83-BOD",40606,280,2,1348,1085,906,179,1081,4,"BOD",,7,,551,530
8,"Brașov",83,"83-BOD",40606,281,2,1301,1256,944,312,1251,5,"BOD",,7,,303,948
8,"Brașov",83,"83-BRAN",40633,282,2,1941,1804,1338,466,1795,9,"BRAN",,7,,800,995
8,"Brașov",83,"83-BRAN",40633,283,2,1420,820,785,35,809,11,"BRAN",,7,,383,426
8,"Brașov",83,"83-BRAN",40633,284,2,1049,662,617,45,659,3,"BRAN",,7,,292,367
8,"Brașov",83,"83-BUDILA",40688,285,2,1029,895,789,106,877,18,"BUDILA",,7,,164,713
8,"Brașov",83,"83-BUDILA",40688,286,2,935,712,665,47,696,16,"BUDILA",,7,,146,550
8,"Brașov",83,"83-BUNESTI",40704,287,2,443,426,304,122,418,8,"BUNESTI",,7,,175,243
8,"Brașov",83,"83-BUNESTI",40704,288,2,312,334,200,134,328,6,"BUNESTI",,7,,206,122
8,"Brașov",83,"83-BUNESTI",40704,289,2,199,197,122,75,196,1,"BUNESTI",,7,,105,91
8,"Brașov",83,"83-BUNESTI",40704,290,2,110,140,76,64,138,2,"BUNESTI",,7,,47,91
8,"Brașov",83,"83-BUNESTI",40704,291,2,259,227,146,81,226,1,"BUNESTI",,7,,127,99
8,"Brașov",83,"83-CATA",40768,292,2,690,603,456,147,600,3,"CATA",,7,,193,407
8,"Brașov",83,"83-CATA",40768,293,2,211,247,151,96,245,2,"CATA",,7,,73,172
8,"Brașov",83,"83-CATA",40768,294,2,580,455,383,72,451,4,"CATA",,7,,53,398
8,"Brașov",83,"83-CATA",40768,295,2,252,227,165,62,224,3,"CATA",,7,,117,107
8,"Brașov",83,"83-CINCU",40820,296,2,997,832,721,111,821,11,"CINCU",,7,,356,465
8,"Brașov",83,"83-CINCU",40820,297,2,220,202,157,45,198,4,"CINCU",,7,,110,88
8,"Brașov",83,"83-CINCU",40820,298,2,182,179,162,17,170,7,"CINCU",,7,,102,68
8,"Brașov",83,"83-COMANA",40857,299,2,730,525,396,129,515,10,"COMANA",,7,,168,347
8,"Brașov",83,"83-COMANA",40857,300,2,226,257,139,118,256,1,"COMANA",,7,,53,203
8,"Brașov",83,"83-COMANA",40857,301,2,517,436,374,62,431,5,"COMANA",,7,,216,215
8,"Brașov",83,"83-COMANA",40857,302,2,403,342,277,65,339,3,"COMANA",,7,,138,201
8,"Brașov",83,"83-CRISTIAN",40900,303,2,1330,1230,987,243,1221,9,"CRISTIAN",,7,,380,841
8,"Brașov",83,"83-CRISTIAN",40900,304,2,1148,1155,842,313,1151,4,"CRISTIAN",,7,,419,732
8,"Brașov",83,"83-DUMBRAVITA",40928,305,2,1279,1162,940,222,1148,14,"DUMBRAVITA",,7,,296,852
8,"Brașov",83,"83-DUMBRAVITA",40928,306,2,1240,1042,943,99,1036,6,"DUMBRAVITA",,7,,285,751
8,"Brașov",83,"83-DUMBRAVITA",40928,307,2,581,635,411,224,631,4,"DUMBRAVITA",,7,,213,418
8,"Brașov",83,"83-FELDIOARA",40955,308,2,1456,1539,1218,321,1527,12,"FELDIOARA",,7,,472,1055
8,"Brașov",83,"83-FELDIOARA",40955,309,2,1636,968,823,145,958,10,"FELDIOARA",,7,,325,633
8,"Brașov",83,"83-FELDIOARA",40955,310,2,999,931,604,327,922,9,"FELDIOARA",,7,,228,694
8,"Brașov",83,"83-FUNDATA",40991,311,2,586,503,424,79,498,5,"FUNDATA",,7,,317,181
8,"Brașov",83,"83-FUNDATA",40991,312,2,337,270,216,54,266,4,"FUNDATA",,7,,138,128
8,"Brașov",83,"83-GHIMBAV",40223,313,2,801,694,616,78,685,9,"GHIMBAV",,7,,174,511
8,"Brașov",83,"83-GHIMBAV",40223,314,2,1842,1574,1422,152,1568,6,"GHIMBAV",,7,,471,1097
8,"Brașov",83,"83-GHIMBAV",40223,315,2,778,993,567,426,980,13,"GHIMBAV",,7,,281,699
8,"Brașov",83,"83-HALCHIU",41033,316,2,1058,925,768,157,918,7,"HALCHIU",,7,,344,574
8,"Brașov",83,"83-HALCHIU",41033,317,2,926,802,707,95,801,1,"HALCHIU",,7,,298,503
8,"Brașov",83,"83-HALCHIU",41033,318,2,1235,966,782,184,949,17,"HALCHIU",,7,,283,666
8,"Brașov",83,"83-HALCHIU",41033,319,2,786,648,582,66,644,4,"HALCHIU",,7,,90,554
8,"Brașov",83,"83-HARMAN",41088,320,2,1166,1058,717,341,1052,6,"HARMAN",,7,,416,636
8,"Brașov",83,"83-HARMAN",41088,321,2,1499,933,720,213,928,5,"HARMAN",,7,,399,529
8,"Brașov",83,"83-HARMAN",41088,322,2,376,323,242,81,321,2,"HARMAN",,7,,66,255
8,"Brașov",83,"83-HARSENI",41113,323,2,912,739,628,111,737,2,"HARSENI",,7,,161,576
8,"Brașov",83,"83-HARSENI",41113,324,2,773,685,488,197,682,3,"HARSENI",,7,,184,498
8,"Brașov",83,"83-HOGHIZ",41177,325,2,1688,1423,1081,342,1419,4,"HOGHIZ",,7,,264,1155
8,"Brașov",83,"83-HOGHIZ",41177,326,2,961,798,647,151,791,7,"HOGHIZ",,7,,248,543
8,"Brașov",83,"83-HOGHIZ",41177,327,2,655,551,442,109,548,3,"HOGHIZ",,7,,90,458
8,"Brașov",83,"83-HOMOROD",41248,328,2,930,745,627,118,739,6,"HOMOROD",,7,,200,539
8,"Brașov",83,"83-HOMOROD",41248,329,2,391,356,302,54,356,0,"HOMOROD",,7,,30,326
8,"Brașov",83,"83-HOMOROD",41248,330,2,346,334,265,69,329,4,"HOMOROD",,7,,121,208
8,"Brașov",83,"83-JIBERT",41284,331,2,606,401,342,59,398,3,"JIBERT",,7,,166,232
8,"Brașov",83,"83-JIBERT",41284,332,2,428,360,274,86,360,0,"JIBERT",,7,,176,184
8,"Brașov",83,"83-JIBERT",41284,333,2,393,323,294,29,317,6,"JIBERT",,7,,65,252
8,"Brașov",83,"83-JIBERT",41284,334,2,402,415,296,119,412,3,"JIBERT",,7,,192,220
8,"Brașov",83,"83-LISA",41346,335,2,802,683,558,125,677,6,"LISA",,7,,180,497
8,"Brașov",83,"83-LISA",41346,336,2,642,563,455,108,557,6,"LISA",,7,,96,461
8,"Brașov",83,"83-MAIERUS",41382,337,2,931,775,605,170,770,5,"MAIERUS",,7,,187,583
8,"Brașov",83,"83-MAIERUS",41382,338,2,454,332,266,66,325,7,"MAIERUS",,7,,130,195
8,"Brașov",83,"83-MANDRA",41417,339,2,737,739,441,298,737,2,"MANDRA",,7,,226,511
8,"Brașov",83,"83-MANDRA",41417,340,2,546,473,349,124,470,3,"MANDRA",,7,,125,345
8,"Brașov",83,"83-MANDRA",41417,341,2,290,278,190,88,274,4,"MANDRA",,7,,44,230
8,"Brașov",83,"83-MANDRA",41417,342,2,205,196,139,57,196,0,"MANDRA",,7,,86,110
8,"Brașov",83,"83-MANDRA",41417,343,2,273,267,183,84,266,1,"MANDRA",,7,,73,193
8,"Brașov",83,"83-MOIECIU",41471,344,2,685,535,504,31,533,2,"MOIECIU",,7,,284,249
8,"Brașov",83,"83-MOIECIU",41471,345,2,518,392,345,47,388,4,"MOIECIU",,7,,206,182
8,"Brașov",83,"83-MOIECIU",41471,346,2,2176,1630,1508,122,1616,14,"MOIECIU",,7,,837,779
8,"Brașov",83,"83-MOIECIU",41471,347,2,502,343,308,35,340,3,"MOIECIU",,7,,220,120
8,"Brașov",83,"83-ORMENIS",41541,348,2,1352,1157,1022,135,1146,11,"ORMENIS",,7,,217,929
8,"Brașov",83,"83-ORMENIS",41541,349,2,749,664,464,200,651,13,"ORMENIS",,7,,205,446
8,"Brașov",83,"83-PARAU",41578,350,2,436,359,291,68,357,2,"PARAU",,7,,173,184
8,"Brașov",83,"83-PARAU",41578,351,2,265,272,196,76,271,1,"PARAU",,7,,63,208
8,"Brașov",83,"83-PARAU",41578,352,2,534,484,377,107,477,7,"PARAU",,7,,122,355
8,"Brașov",83,"83-PARAU",41578,353,2,330,267,210,57,264,3,"PARAU",,7,,99,165
8,"Brașov",83,"83-POIANA MARULUI",41621,354,2,975,792,706,86,787,5,"POIANA MARULUI",,7,,376,411
8,"Brașov",83,"83-POIANA MARULUI",41621,355,2,1032,659,602,57,651,8,"POIANA MARULUI",,7,,265,386
8,"Brașov",83,"83-POIANA MARULUI",41621,356,2,306,205,173,32,201,4,"POIANA MARULUI",,7,,72,129
8,"Brașov",83,"83-POIANA MARULUI",41621,357,2,436,219,190,29,216,3,"POIANA MARULUI",,7,,85,131
8,"Brașov",83,"83-POIANA MARULUI",41621,358,2,1152,916,868,48,913,3,"POIANA MARULUI",,7,,284,629
8,"Brașov",83,"83-PREJMER",41667,359,2,1969,1401,1203,198,1390,11,"PREJMER",,7,,458,932
8,"Brașov",83,"83-PREJMER",41667,360,2,1130,790,729,61,787,3,"PREJMER",,7,,302,485
8,"Brașov",83,"83-PREJMER",41667,361,2,1121,931,768,163,925,6,"PREJMER",,7,,311,614
8,"Brașov",83,"83-PREJMER",41667,362,2,1820,1363,1221,142,1355,8,"PREJMER",,7,,478,877
8,"Brașov",83,"83-RACOS",41701,363,2,1692,1643,1506,137,1621,22,"RACOS",,7,,155,1466
8,"Brașov",83,"83-RACOS",41701,364,2,264,294,211,83,294,0,"RACOS",,7,,69,225
8,"Brașov",83,"83-RECEA",41738,365,2,1354,1171,906,265,1164,7,"RECEA",,7,,248,916
8,"Brașov",83,"83-RECEA",41738,366,2,496,520,364,156,510,10,"RECEA",,7,,186,324
8,"Brașov",83,"83-RECEA",41738,367,2,563,528,420,108,526,2,"RECEA",,7,,89,437
8,"Brașov",83,"83-SANPETRU",41925,368,2,1260,975,813,162,965,10,"SANPETRU",,7,,381,584
8,"Brașov",83,"83-SANPETRU",41925,369,2,1118,868,741,127,861,7,"SANPETRU",,7,,233,628
8,"Brașov",83,"83-SERCAIA",41818,370,2,1057,871,661,210,867,4,"SERCAIA",,7,,192,675
8,"Brașov",83,"83-SERCAIA",41818,371,2,363,368,289,79,366,2,"SERCAIA",,7,,27,339
8,"Brașov",83,"83-SERCAIA",41818,372,2,429,404,317,87,401,3,"SERCAIA",,7,,96,305
8,"Brașov",83,"83-SINCA",41854,373,2,1154,870,689,181,864,6,"SINCA",,7,,268,596
8,"Brașov",83,"83-SINCA",41854,374,2,703,601,435,166,599,2,"SINCA",,7,,209,390
8,"Brașov",83,"83-SINCA",41854,375,2,734,627,479,148,622,5,"SINCA",,7,,188,434
8,"Brașov",83,"83-SOARS",41943,376,2,395,296,231,65,291,5,"SOARS",,7,,70,221
8,"Brașov",83,"83-SOARS",41943,377,2,269,231,156,75,228,3,"SOARS",,7,,100,128
8,"Brașov",83,"83-SOARS",41943,378,2,359,292,227,65,289,3,"SOARS",,7,,104,185
8,"Brașov",83,"83-SOARS",41943,379,2,175,186,128,58,184,2,"SOARS",,7,,37,147
8,"Brașov",83,"83-SOARS",41943,380,2,138,133,96,37,133,0,"SOARS",,7,,60,73
8,"Brașov",83,"83-TARLUNGENI",42003,381,2,2270,1741,1408,333,1730,11,"TARLUNGENI",,7,,455,1275
8,"Brașov",83,"83-TARLUNGENI",42003,382,2,219,259,148,111,257,2,"TARLUNGENI",,7,,82,175
8,"Brașov",83,"83-TARLUNGENI",42003,383,2,1179,950,770,180,947,3,"TARLUNGENI",,7,,256,691
8,"Brașov",83,"83-TARLUNGENI",42003,384,2,1217,1029,806,223,1014,15,"TARLUNGENI",,7,,341,673
8,"Brașov",83,"83-TELIU",42058,385,2,1528,1253,995,258,1236,17,"TELIU",,7,,283,953
8,"Brașov",83,"83-TELIU",42058,386,2,670,542,480,62,540,2,"TELIU",,7,,305,235
8,"Brașov",83,"83-TICUS",42076,387,2,341,313,289,24,312,1,"TICUS",,7,,76,236
8,"Brașov",83,"83-TICUS",42076,388,2,165,157,146,11,157,0,"TICUS",,7,,15,142
8,"Brașov",83,"83-UCEA",42101,389,2,766,651,546,105,651,0,"UCEA",,7,,154,497
8,"Brașov",83,"83-UCEA",42101,390,2,184,187,132,55,186,1,"UCEA",,7,,57,129
8,"Brașov",83,"83-UCEA",42101,391,2,668,590,478,112,587,3,"UCEA",,7,,120,467
8,"Brașov",83,"83-UNGRA",42156,392,2,838,588,498,90,575,13,"UNGRA",,7,,267,308
8,"Brașov",83,"83-UNGRA",42156,393,2,482,460,414,46,456,4,"UNGRA",,7,,274,182
8,"Brașov",83,"83-VAMA BUZAULUI",42183,394,2,1274,852,807,45,840,12,"VAMA BUZAULUI",,7,,485,355
8,"Brașov",83,"83-VAMA BUZAULUI",42183,395,2,725,505,475,30,498,7,"VAMA BUZAULUI",,7,,298,200
8,"Brașov",83,"83-VAMA BUZAULUI",42183,396,2,391,275,227,48,269,6,"VAMA BUZAULUI",,7,,176,93
8,"Brașov",83,"83-VISTEA",42236,397,2,510,435,367,68,432,3,"VISTEA",,7,,121,311
8,"Brașov",83,"83-VISTEA",42236,398,2,938,748,691,57,743,5,"VISTEA",,7,,229,514
8,"Brașov",83,"83-VISTEA",42236,399,2,246,317,206,111,316,1,"VISTEA",,7,,83,233
8,"Brașov",83,"83-VISTEA",42236,400,2,333,258,213,45,256,2,"VISTEA",,7,,112,144
8,"Brașov",83,"83-VISTEA",42236,401,2,518,388,341,47,383,5,"VISTEA",,7,,161,222
8,"Brașov",83,"83-VOILA",42307,402,2,432,460,315,145,460,0,"VOILA",,7,,64,396
8,"Brașov",83,"83-VOILA",42307,403,2,378,358,288,70,358,0,"VOILA",,7,,58,300
8,"Brașov",83,"83-VOILA",42307,404,2,274,270,176,94,269,1,"VOILA",,7,,56,213
8,"Brașov",83,"83-VOILA",42307,405,2,174,171,132,39,166,0,"VOILA",,7,,24,142
8,"Brașov",83,"83-VOILA",42307,406,2,320,375,270,105,363,12,"VOILA",,7,,48,315
8,"Brașov",83,"83-VOILA",42307,407,2,1064,899,657,242,890,9,"VOILA",,7,,180,710
8,"Brașov",83,"83-VOILA",42307,408,2,402,423,344,79,415,8,"VOILA",,7,,52,363
8,"Brașov",83,"83-VULCAN",42398,409,2,2221,1786,1580,206,1774,12,"VULCAN",,7,,621,1153
8,"Brașov",83,"83-VULCAN",42398,410,2,1162,673,621,52,663,10,"VULCAN",,7,,286,377
8,"Brașov",83,"83-VULCAN",42398,411,2,397,357,270,87,357,0,"VULCAN",,7,,100,257
9,"Brăila",92,"92-MUNICIPIUL BRAILA",42682,1,2,2256,1641,1527,114,1635,6,"MUNICIPIUL BRAILA",,5,,929,706
9,"Brăila",92,"92-MUNICIPIUL BRAILA",42682,2,2,1989,1786,1412,374,1776,10,"MUNICIPIUL BRAILA",,5,,994,782
9,"Brăila",92,"92-MUNICIPIUL BRAILA",42682,3,2,1868,1470,1350,120,1461,9,"MUNICIPIUL BRAILA",,5,,774,687
9,"Brăila",92,"92-MUNICIPIUL BRAILA",42682,4,2,1481,1210,1114,96,1205,5,"MUNICIPIUL BRAILA",,5,,685,520
9,"Brăila",92,"92-MUNICIPIUL BRAILA",42682,5,2,2180,1709,1585,124,1704,5,"MUNICIPIUL BRAILA",,5,,928,776
9,"Brăila",92,"92-MUNICIPIUL BRAILA",42682,6,2,1861,1582,1322,260,1563,19,"MUNICIPIUL BRAILA",,5,,959,604
9,"Brăila",92,"92-MUNICIPIUL BRAILA",42682,7,2,2463,1964,1747,217,1955,9,"MUNICIPIUL BRAILA",,5,,942,1013
9,"Brăila",92,"92-MUNICIPIUL BRAILA",42682,8,2,2854,2362,2132,230,2344,18,"MUNICIPIUL BRAILA",,5,,1007,1337
9,"Brăila",92,"92-MUNICIPIUL BRAILA",42682,9,2,2083,1606,1446,160,1595,11,"MUNICIPIUL BRAILA",,5,,806,789
9,"Brăila",92,"92-MUNICIPIUL BRAILA",42682,10,2,2236,1809,1557,252,1789,20,"MUNICIPIUL BRAILA",,5,,1025,764
9,"Brăila",92,"92-MUNICIPIUL BRAILA",42682,11,2,1672,1268,1155,113,1262,6,"MUNICIPIUL BRAILA",,5,,636,626
9,"Brăila",92,"92-MUNICIPIUL BRAILA",42682,12,2,1393,1086,1000,86,1080,6,"MUNICIPIUL BRAILA",,5,,591,489
9,"Brăila",92,"92-MUNICIPIUL BRAILA",42682,13,2,2231,1731,1584,147,1720,11,"MUNICIPIUL BRAILA",,5,,923,797
9,"Brăila",92,"92-MUNICIPIUL BRAILA",42682,14,2,1843,1336,1284,52,1332,4,"MUNICIPIUL BRAILA",,5,,780,552
9,"Brăila",92,"92-MUNICIPIUL BRAILA",42682,15,2,1770,1324,1233,91,1313,11,"MUNICIPIUL BRAILA",,5,,742,571
9,"Brăila",92,"92-MUNICIPIUL BRAILA",42682,16,2,1835,1448,1334,114,1442,6,"MUNICIPIUL BRAILA",,5,,677,765
9,"Brăila",92,"92-MUNICIPIUL BRAILA",42682,17,2,1999,1455,1361,94,1453,2,"MUNICIPIUL BRAILA",,5,,687,766
9,"Brăila",92,"92-MUNICIPIUL BRAILA",42682,18,2,1937,1683,1362,321,1671,12,"MUNICIPIUL BRAILA",,5,,770,901
9,"Brăila",92,"92-MUNICIPIUL BRAILA",42682,19,2,2385,1975,1602,373,1968,7,"MUNICIPIUL BRAILA",,5,,890,1078
9,"Brăila",92,"92-MUNICIPIUL BRAILA",42682,20,2,1981,1505,1433,72,1500,5,"MUNICIPIUL BRAILA",,5,,710,790
9,"Brăila",92,"92-MUNICIPIUL BRAILA",42682,21,2,1755,1330,1250,80,1317,13,"MUNICIPIUL BRAILA",,5,,689,628
9,"Brăila",92,"92-MUNICIPIUL BRAILA",42682,22,2,1989,1366,1275,91,1358,8,"MUNICIPIUL BRAILA",,5,,686,672
9,"Brăila",92,"92-MUNICIPIUL BRAILA",42682,23,2,660,673,487,186,670,3,"MUNICIPIUL BRAILA",,5,,292,378
9,"Brăila",92,"92-MUNICIPIUL BRAILA",42682,24,2,1253,964,798,166,960,4,"MUNICIPIUL BRAILA",,5,,492,468
9,"Brăila",92,"92-MUNICIPIUL BRAILA",42682,25,2,849,957,483,474,952,5,"MUNICIPIUL BRAILA",,5,,458,494
9,"Brăila",92,"92-MUNICIPIUL BRAILA",42682,26,2,1795,1417,1187,230,1397,20,"MUNICIPIUL BRAILA",,5,,695,702
9,"Brăila",92,"92-MUNICIPIUL BRAILA",42682,27,2,1198,983,836,147,961,22,"MUNICIPIUL BRAILA",,5,,548,413
9,"Brăila",92,"92-MUNICIPIUL BRAILA",42682,28,2,1188,918,838,80,909,9,"MUNICIPIUL BRAILA",,5,,490,419
9,"Brăila",92,"92-MUNICIPIUL BRAILA",42682,29,2,1234,1036,926,110,1028,8,"MUNICIPIUL BRAILA",,5,,623,405
9,"Brăila",92,"92-MUNICIPIUL BRAILA",42682,30,2,2297,1688,1567,121,1665,23,"MUNICIPIUL BRAILA",,5,,1048,617
9,"Brăila",92,"92-MUNICIPIUL BRAILA",42682,31,2,1781,1340,1266,74,1333,7,"MUNICIPIUL BRAILA",,5,,802,531
9,"Brăila",92,"92-MUNICIPIUL BRAILA",42682,32,2,1133,894,800,94,876,18,"MUNICIPIUL BRAILA",,5,,560,316
9,"Brăila",92,"92-MUNICIPIUL BRAILA",42682,33,2,2359,1667,1515,152,1652,15,"MUNICIPIUL BRAILA",,5,,906,746
9,"Brăila",92,"92-MUNICIPIUL BRAILA",42682,34,2,2073,1645,1516,129,1633,12,"MUNICIPIUL BRAILA",,5,,950,683
9,"Brăila",92,"92-MUNICIPIUL BRAILA",42682,35,2,1927,1491,1421,70,1478,13,"MUNICIPIUL BRAILA",,5,,846,632
9,"Brăila",92,"92-MUNICIPIUL BRAILA",42682,36,2,1194,850,800,50,839,11,"MUNICIPIUL BRAILA",,5,,527,312
9,"Brăila",92,"92-MUNICIPIUL BRAILA",42682,37,2,1565,1214,1140,74,1204,10,"MUNICIPIUL BRAILA",,5,,656,548
9,"Brăila",92,"92-MUNICIPIUL BRAILA",42682,38,2,1329,987,919,68,980,7,"MUNICIPIUL BRAILA",,5,,486,494
9,"Brăila",92,"92-MUNICIPIUL BRAILA",42682,39,2,1463,1215,1092,123,1203,12,"MUNICIPIUL BRAILA",,5,,575,628
9,"Brăila",92,"92-MUNICIPIUL BRAILA",42682,40,2,1837,1425,1245,180,1406,19,"MUNICIPIUL BRAILA",,5,,707,699
9,"Brăila",92,"92-MUNICIPIUL BRAILA",42682,41,2,1691,1447,1114,333,1443,4,"MUNICIPIUL BRAILA",,5,,757,686
9,"Brăila",92,"92-MUNICIPIUL BRAILA",42682,42,2,1529,1171,1101,70,1166,5,"MUNICIPIUL BRAILA",,5,,701,465
9,"Brăila",92,"92-MUNICIPIUL BRAILA",42682,43,2,1395,1099,1016,83,1095,4,"MUNICIPIUL BRAILA",,5,,549,546
9,"Brăila",92,"92-MUNICIPIUL BRAILA",42682,44,2,1450,1175,1123,52,1166,9,"MUNICIPIUL BRAILA",,5,,636,530
9,"Brăila",92,"92-MUNICIPIUL BRAILA",42682,45,2,1251,970,904,66,950,20,"MUNICIPIUL BRAILA",,5,,537,413
9,"Brăila",92,"92-MUNICIPIUL BRAILA",42682,46,2,1471,1060,1009,51,1046,14,"MUNICIPIUL BRAILA",,5,,542,504
9,"Brăila",92,"92-MUNICIPIUL BRAILA",42682,47,2,1534,1283,1107,176,1273,10,"MUNICIPIUL BRAILA",,5,,620,653
9,"Brăila",92,"92-MUNICIPIUL BRAILA",42682,48,2,1716,1298,1224,74,1298,0,"MUNICIPIUL BRAILA",,5,,664,634
9,"Brăila",92,"92-MUNICIPIUL BRAILA",42682,49,2,1638,1279,1194,85,1273,6,"MUNICIPIUL BRAILA",,5,,610,663
9,"Brăila",92,"92-MUNICIPIUL BRAILA",42682,50,2,1373,996,943,53,989,7,"MUNICIPIUL BRAILA",,5,,565,424
9,"Brăila",92,"92-MUNICIPIUL BRAILA",42682,51,2,1457,1156,1097,59,1146,10,"MUNICIPIUL BRAILA",,5,,613,533
9,"Brăila",92,"92-MUNICIPIUL BRAILA",42682,52,2,1267,989,902,87,972,17,"MUNICIPIUL BRAILA",,5,,578,394
9,"Brăila",92,"92-MUNICIPIUL BRAILA",42682,53,2,1391,1080,1024,56,1075,5,"MUNICIPIUL BRAILA",,5,,647,428
9,"Brăila",92,"92-MUNICIPIUL BRAILA",42682,54,2,1457,1213,960,253,1205,8,"MUNICIPIUL BRAILA",,5,,635,570
9,"Brăila",92,"92-MUNICIPIUL BRAILA",42682,55,2,1035,800,730,70,795,5,"MUNICIPIUL BRAILA",,5,,384,411
9,"Brăila",92,"92-MUNICIPIUL BRAILA",42682,56,2,1287,1018,922,96,1011,7,"MUNICIPIUL BRAILA",,5,,564,447
9,"Brăila",92,"92-MUNICIPIUL BRAILA",42682,57,2,1161,980,812,168,974,6,"MUNICIPIUL BRAILA",,5,,488,486
9,"Brăila",92,"92-MUNICIPIUL BRAILA",42682,58,2,1706,1533,1096,437,1528,5,"MUNICIPIUL BRAILA",,5,,834,694
9,"Brăila",92,"92-MUNICIPIUL BRAILA",42682,59,2,1815,1470,1367,103,1464,6,"MUNICIPIUL BRAILA",,5,,675,789
9,"Brăila",92,"92-MUNICIPIUL BRAILA",42682,60,2,1505,1208,1110,98,1200,8,"MUNICIPIUL BRAILA",,5,,635,565
9,"Brăila",92,"92-MUNICIPIUL BRAILA",42682,61,2,2024,1625,1469,156,1616,9,"MUNICIPIUL BRAILA",,5,,829,787
9,"Brăila",92,"92-MUNICIPIUL BRAILA",42682,62,2,1888,1474,1373,101,1472,2,"MUNICIPIUL BRAILA",,5,,674,798
9,"Brăila",92,"92-MUNICIPIUL BRAILA",42682,63,2,2150,1710,1556,154,1702,8,"MUNICIPIUL BRAILA",,5,,829,873
9,"Brăila",92,"92-MUNICIPIUL BRAILA",42682,64,2,2069,1601,1486,115,1593,8,"MUNICIPIUL BRAILA",,5,,812,781
9,"Brăila",92,"92-MUNICIPIUL BRAILA",42682,65,2,2025,1594,1477,117,1586,8,"MUNICIPIUL BRAILA",,5,,816,770
9,"Brăila",92,"92-MUNICIPIUL BRAILA",42682,66,2,1960,1504,1371,133,1494,10,"MUNICIPIUL BRAILA",,5,,792,702
9,"Brăila",92,"92-MUNICIPIUL BRAILA",42682,67,2,2404,1915,1813,102,1902,13,"MUNICIPIUL BRAILA",,5,,985,917
9,"Brăila",92,"92-MUNICIPIUL BRAILA",42682,68,2,2186,1621,1505,116,1608,9,"MUNICIPIUL BRAILA",,5,,816,792
9,"Brăila",92,"92-MUNICIPIUL BRAILA",42682,69,2,2096,1629,1453,176,1617,12,"MUNICIPIUL BRAILA",,5,,833,784
9,"Brăila",92,"92-MUNICIPIUL BRAILA",42682,70,2,1805,1496,1256,240,1487,9,"MUNICIPIUL BRAILA",,5,,752,735
9,"Brăila",92,"92-MUNICIPIUL BRAILA",42682,71,2,2322,1902,1607,295,1891,11,"MUNICIPIUL BRAILA",,5,,894,997
9,"Brăila",92,"92-MUNICIPIUL BRAILA",42682,72,2,2175,1704,1573,131,1699,5,"MUNICIPIUL BRAILA",,5,,834,865
9,"Brăila",92,"92-MUNICIPIUL BRAILA",42682,73,2,2028,1556,1443,113,1554,2,"MUNICIPIUL BRAILA",,5,,825,729
9,"Brăila",92,"92-MUNICIPIUL BRAILA",42682,74,2,1602,1249,1140,109,1245,4,"MUNICIPIUL BRAILA",,5,,639,606
9,"Brăila",92,"92-MUNICIPIUL BRAILA",42682,75,2,1686,1368,1220,148,1363,5,"MUNICIPIUL BRAILA",,5,,674,689
9,"Brăila",92,"92-MUNICIPIUL BRAILA",42682,76,2,2162,1721,1582,139,1717,4,"MUNICIPIUL BRAILA",,5,,847,870
9,"Brăila",92,"92-MUNICIPIUL BRAILA",42682,77,2,1319,1013,925,88,1011,2,"MUNICIPIUL BRAILA",,5,,531,480
9,"Brăila",92,"92-MUNICIPIUL BRAILA",42682,78,2,1536,1206,1079,127,1199,7,"MUNICIPIUL BRAILA",,5,,551,648
9,"Brăila",92,"92-MUNICIPIUL BRAILA",42682,79,2,1476,1266,1128,138,1260,6,"MUNICIPIUL BRAILA",,5,,596,664
9,"Brăila",92,"92-MUNICIPIUL BRAILA",42682,80,2,1982,1675,1578,97,1670,5,"MUNICIPIUL BRAILA",,5,,767,903
9,"Brăila",92,"92-MUNICIPIUL BRAILA",42682,81,2,1842,1480,1344,136,1476,4,"MUNICIPIUL BRAILA",,5,,734,742
9,"Brăila",92,"92-MUNICIPIUL BRAILA",42682,82,2,2263,1828,1703,125,1818,10,"MUNICIPIUL BRAILA",,5,,876,942
9,"Brăila",92,"92-MUNICIPIUL BRAILA",42682,83,2,1855,1435,1317,118,1426,9,"MUNICIPIUL BRAILA",,5,,718,708
9,"Brăila",92,"92-MUNICIPIUL BRAILA",42682,84,2,1423,1208,1094,114,1206,2,"MUNICIPIUL BRAILA",,5,,574,632
9,"Brăila",92,"92-MUNICIPIUL BRAILA",42682,85,2,1941,1533,1390,143,1526,7,"MUNICIPIUL BRAILA",,5,,742,784
9,"Brăila",92,"92-MUNICIPIUL BRAILA",42682,86,2,1254,1006,918,88,999,7,"MUNICIPIUL BRAILA",,5,,539,460
9,"Brăila",92,"92-MUNICIPIUL BRAILA",42682,87,2,1511,1191,1088,103,1180,11,"MUNICIPIUL BRAILA",,5,,613,567
9,"Brăila",92,"92-MUNICIPIUL BRAILA",42682,88,2,1588,1408,1081,327,1397,11,"MUNICIPIUL BRAILA",,5,,657,740
9,"Brăila",92,"92-MUNICIPIUL BRAILA",42682,89,2,2167,1434,1260,174,1425,9,"MUNICIPIUL BRAILA",,5,,572,853
9,"Brăila",92,"92-MUNICIPIUL BRAILA",42682,90,2,1858,1551,1352,199,1548,3,"MUNICIPIUL BRAILA",,5,,652,896
9,"Brăila",92,"92-MUNICIPIUL BRAILA",42682,91,2,1442,1234,984,250,1227,7,"MUNICIPIUL BRAILA",,5,,615,612
9,"Brăila",92,"92-MUNICIPIUL BRAILA",42682,92,2,1836,1543,1295,248,1536,7,"MUNICIPIUL BRAILA",,5,,779,757
9,"Brăila",92,"92-MUNICIPIUL BRAILA",42682,93,2,2120,1621,1474,147,1615,6,"MUNICIPIUL BRAILA",,5,,764,851
9,"Brăila",92,"92-MUNICIPIUL BRAILA",42682,94,2,2253,1614,1463,151,1605,9,"MUNICIPIUL BRAILA",,5,,777,828
9,"Brăila",92,"92-MUNICIPIUL BRAILA",42682,95,2,2006,1434,1326,108,1427,7,"MUNICIPIUL BRAILA",,5,,731,696
9,"Brăila",92,"92-MUNICIPIUL BRAILA",42682,96,2,1488,1166,1018,148,1160,6,"MUNICIPIUL BRAILA",,5,,620,540
9,"Brăila",92,"92-MUNICIPIUL BRAILA",42682,97,2,1880,1438,1250,188,1433,5,"MUNICIPIUL BRAILA",,5,,688,745
9,"Brăila",92,"92-MUNICIPIUL BRAILA",42682,98,2,1746,1425,1245,180,1419,6,"MUNICIPIUL BRAILA",,5,,648,771
9,"Brăila",92,"92-MUNICIPIUL BRAILA",42682,99,2,1881,1410,1274,136,1402,8,"MUNICIPIUL BRAILA",,5,,661,741
9,"Brăila",92,"92-MUNICIPIUL BRAILA",42682,100,2,1731,1304,1222,82,1296,8,"MUNICIPIUL BRAILA",,5,,528,768
9,"Brăila",92,"92-MUNICIPIUL BRAILA",42682,101,2,1814,1321,1194,127,1314,7,"MUNICIPIUL BRAILA",,5,,624,690
9,"Brăila",92,"92-MUNICIPIUL BRAILA",42682,102,2,1766,1444,1208,236,1429,15,"MUNICIPIUL BRAILA",,5,,688,741
9,"Brăila",92,"92-MUNICIPIUL BRAILA",42682,103,2,1500,1068,966,102,1059,9,"MUNICIPIUL BRAILA",,5,,410,649
9,"Brăila",92,"92-MUNICIPIUL BRAILA",42682,104,2,0,429,0,429,429,0,"MUNICIPIUL BRAILA",,5,,244,185
9,"Brăila",92,"92-MUNICIPIUL BRAILA",42682,105,2,0,75,0,75,75,0,"MUNICIPIUL BRAILA",,5,,29,46
9,"Brăila",92,"92-MUNICIPIUL BRAILA",42682,106,2,0,187,0,187,187,0,"MUNICIPIUL BRAILA",,5,,83,104
9,"Brăila",92,"92-MUNICIPIUL BRAILA",42682,107,2,0,52,0,52,52,0,"MUNICIPIUL BRAILA",,5,,18,34
9,"Brăila",92,"92-MUNICIPIUL BRAILA",42682,108,2,0,395,0,395,393,2,"MUNICIPIUL BRAILA",,5,,173,220
9,"Brăila",92,"92-MUNICIPIUL BRAILA",42682,109,2,0,485,0,485,483,2,"MUNICIPIUL BRAILA",,5,,230,253
9,"Brăila",92,"92-MUNICIPIUL BRAILA",42682,110,2,0,217,0,217,212,5,"MUNICIPIUL BRAILA",,5,,92,120
9,"Brăila",92,"92-MUNICIPIUL BRAILA",42682,111,2,0,379,0,379,373,6,"MUNICIPIUL BRAILA",,5,,194,179
9,"Brăila",92,"92-MUNICIPIUL BRAILA",42682,112,2,201,212,184,28,208,4,"MUNICIPIUL BRAILA",,5,,75,133
9,"Brăila",92,"92-MUNICIPIUL BRAILA",42682,113,2,0,434,0,434,428,6,"MUNICIPIUL BRAILA",,5,,221,207
9,"Brăila",92,"92-ORAS FAUREI",42753,114,2,2286,1940,1802,138,1929,11,"ORAS FAUREI",,5,,1190,739
9,"Brăila",92,"92-ORAS FAUREI",42753,115,2,545,361,347,14,356,5,"ORAS FAUREI",,5,,237,119
9,"Brăila",92,"92-ORAS FAUREI",42753,116,2,0,362,0,362,360,2,"ORAS FAUREI",,5,,191,169
9,"Brăila",92,"92-ORAS IANCA",43331,117,2,2226,1707,1240,467,1700,7,"ORAS IANCA",,5,,990,710
9,"Brăila",92,"92-ORAS IANCA",43331,118,2,2279,1477,1084,393,1458,19,"ORAS IANCA",,5,,906,552
9,"Brăila",92,"92-ORAS IANCA",43331,119,2,583,623,553,70,621,2,"ORAS IANCA",,5,,393,228
9,"Brăila",92,"92-ORAS IANCA",43331,120,2,1293,954,877,77,943,11,"ORAS IANCA",,5,,723,220
9,"Brăila",92,"92-ORAS IANCA",43331,121,2,525,547,373,174,544,3,"ORAS IANCA",,5,,399,145
9,"Brăila",92,"92-ORAS IANCA",43331,122,2,847,713,674,39,700,13,"ORAS IANCA",,5,,505,195
9,"Brăila",92,"92-ORAS IANCA",43331,123,2,660,539,449,90,532,7,"ORAS IANCA",,5,,388,144
9,"Brăila",92,"92-ORAS IANCA",43331,124,2,364,333,280,53,329,4,"ORAS IANCA",,5,,215,114
9,"Brăila",92,"92-ORAS INSURATEI",43411,125,2,1701,1374,1161,213,1357,17,"ORAS INSURATEI",,5,,1016,341
9,"Brăila",92,"92-ORAS INSURATEI",43411,126,2,1998,1372,1211,161,1353,19,"ORAS INSURATEI",,5,,951,402
9,"Brăila",92,"92-ORAS INSURATEI",43411,127,2,1536,924,877,47,916,8,"ORAS INSURATEI",,5,,699,217
9,"Brăila",92,"92-ORAS INSURATEI",43411,128,2,361,299,244,55,296,3,"ORAS INSURATEI",,5,,197,99
9,"Brăila",92,"92-BARAGANUL",42824,129,2,1755,1425,1166,259,1418,7,"BARAGANUL",,5,,1064,354
9,"Brăila",92,"92-BARAGANUL",42824,130,2,934,711,606,105,707,4,"BARAGANUL",,5,,564,143
9,"Brăila",92,"92-BERTESTII DE JOS",42842,131,2,1285,971,869,102,954,16,"BERTESTII DE JOS",,5,,768,186
9,"Brăila",92,"92-BERTESTII DE JOS",42842,132,2,1153,884,790,94,873,11,"BERTESTII DE JOS",,5,,668,205
9,"Brăila",92,"92-BORDEI VERDE",42913,133,2,1254,892,804,88,882,10,"BORDEI VERDE",,5,,642,240
9,"Brăila",92,"92-BORDEI VERDE",42913,134,2,681,657,566,91,654,3,"BORDEI VERDE",,5,,521,133
9,"Brăila",92,"92-BORDEI VERDE",42913,135,2,444,339,268,71,334,5,"BORDEI VERDE",,5,,274,60
9,"Brăila",92,"92-CHISCANI",42708,136,2,1524,1070,926,144,1052,18,"CHISCANI",,5,,645,407
9,"Brăila",92,"92-CHISCANI",42708,137,2,1293,970,800,170,962,8,"CHISCANI",,5,,571,391
9,"Brăila",92,"92-CHISCANI",42708,138,2,734,611,437,174,599,12,"CHISCANI",,5,,368,231
9,"Brăila",92,"92-CIOCILE",42968,139,2,2054,1501,1371,130,1488,13,"CIOCILE",,5,,1280,208
9,"Brăila",92,"92-CIOCILE",42968,140,2,637,483,398,85,477,6,"CIOCILE",,5,,394,83
9,"Brăila",92,"92-CIRESU",43019,141,2,928,694,603,91,688,6,"CIRESU",,5,,510,178
9,"Brăila",92,"92-CIRESU",43019,142,2,658,520,426,94,517,3,"CIRESU",,5,,407,110
9,"Brăila",92,"92-CIRESU",43019,143,2,1381,959,859,100,945,14,"CIRESU",,5,,732,213
9,"Brăila",92,"92-DUDESTI",43073,144,2,1492,1054,804,250,1044,10,"DUDESTI",,5,,826,218
9,"Brăila",92,"92-DUDESTI",43073,145,2,1725,1353,1140,213,1325,28,"DUDESTI",,5,,1056,269
9,"Brăila",92,"92-FRECATEI",43117,146,2,334,254,184,70,249,5,"FRECATEI",,5,,184,65
9,"Brăila",92,"92-FRECATEI",43117,147,2,422,354,262,92,349,5,"FRECATEI",,5,,247,102
9,"Brăila",92,"92-FRECATEI",43117,148,2,367,293,214,79,288,5,"FRECATEI",,5,,184,104
9,"Brăila",92,"92-GALBENU",43180,149,2,961,812,671,141,808,4,"GALBENU",,5,,660,148
9,"Brăila",92,"92-GALBENU",43180,150,2,766,700,525,175,698,2,"GALBENU",,5,,541,157
9,"Brăila",92,"92-GALBENU",43180,151,2,1101,971,789,182,959,12,"GALBENU",,5,,788,171
9,"Brăila",92,"92-GEMENELE",43242,152,2,1571,1192,1069,123,1169,23,"GEMENELE",,5,,919,250
9,"Brăila",92,"92-GRADISTEA",43279,153,2,1173,774,639,135,758,16,"GRADISTEA",,5,,485,273
9,"Brăila",92,"92-GRADISTEA",43279,154,2,1001,758,643,115,746,12,"GRADISTEA",,5,,586,160
9,"Brăila",92,"92-GROPENI",43313,155,2,1264,899,726,173,877,22,"GROPENI",,5,,656,221
9,"Brăila",92,"92-GROPENI",43313,156,2,1764,1323,1091,232,1304,19,"GROPENI",,5,,1020,284
9,"Brăila",92,"92-JIRLAU",43466,157,2,1267,825,761,64,821,4,"JIRLAU",,5,,666,155
9,"Brăila",92,"92-JIRLAU",43466,158,2,1385,978,894,84,971,7,"JIRLAU",,5,,800,171
9,"Brăila",92,"92-MARASU",43493,159,2,872,536,413,123,530,6,"MARASU",,5,,385,145
9,"Brăila",92,"92-MARASU",43493,160,2,409,379,319,60,376,3,"MARASU",,5,,312,64
9,"Brăila",92,"92-MARASU",43493,161,2,448,321,240,81,320,1,"MARASU",,5,,184,136
9,"Brăila",92,"92-MARASU",43493,162,2,212,170,130,40,169,1,"MARASU",,5,,145,24
9,"Brăila",92,"92-MARASU",43493,163,2,623,440,348,92,431,9,"MARASU",,5,,309,122
9,"Brăila",92,"92-MAXINENI",43563,164,2,1263,966,819,147,956,10,"MAXINENI",,5,,751,205
9,"Brăila",92,"92-MAXINENI",43563,165,2,756,592,508,84,587,5,"MAXINENI",,5,,491,96
9,"Brăila",92,"92-MAXINENI",43563,166,2,218,191,145,46,190,1,"MAXINENI",,5,,150,40
9,"Brăila",92,"92-MAXINENI",43563,167,2,593,530,419,111,523,7,"MAXINENI",,5,,416,107
9,"Brăila",92,"92-MIRCEA VODA",43625,168,2,2055,1491,1337,154,1475,16,"MIRCEA VODA",,5,,1053,422
9,"Brăila",92,"92-MIRCEA VODA",43625,169,2,868,638,559,79,625,13,"MIRCEA VODA",,5,,447,178
9,"Brăila",92,"92-MOVILA MIRESEI",43652,170,2,1202,868,753,115,859,9,"MOVILA MIRESEI",,5,,650,209
9,"Brăila",92,"92-MOVILA MIRESEI",43652,171,2,1146,795,654,141,789,6,"MOVILA MIRESEI",,5,,564,225
9,"Brăila",92,"92-MOVILA MIRESEI",43652,172,2,637,521,415,106,513,8,"MOVILA MIRESEI",,5,,377,136
9,"Brăila",92,"92-MOVILA MIRESEI",43652,173,2,260,219,169,50,217,2,"MOVILA MIRESEI",,5,,158,59
9,"Brăila",92,"92-RACOVITA",43698,174,2,1268,977,885,92,961,16,"RACOVITA",,5,,756,205
9,"Brăila",92,"92-RAMNICELU",43732,175,2,1222,870,744,126,862,8,"RAMNICELU",,5,,584,278
9,"Brăila",92,"92-RAMNICELU",43732,176,2,327,264,214,50,256,8,"RAMNICELU",,5,,211,45
9,"Brăila",92,"92-RAMNICELU",43732,177,2,305,264,200,64,262,2,"RAMNICELU",,5,,207,55
9,"Brăila",92,"92-ROMANU",43787,178,2,1249,931,805,126,921,10,"ROMANU",,5,,702,219
9,"Brăila",92,"92-ROMANU",43787,179,2,331,326,268,58,322,4,"ROMANU",,5,,248,74
9,"Brăila",92,"92-ROSIORI",43812,180,2,1479,1075,976,99,1053,22,"ROSIORI",,5,,814,239
9,"Brăila",92,"92-ROSIORI",43812,181,2,928,749,645,104,747,2,"ROSIORI",,5,,616,131
9,"Brăila",92,"92-SALCIA TUDOR",43867,182,2,917,636,632,4,625,11,"SALCIA TUDOR",,5,,453,172
9,"Brăila",92,"92-SALCIA TUDOR",43867,183,2,894,678,564,114,668,10,"SALCIA TUDOR",,5,,527,141
9,"Brăila",92,"92-SALCIA TUDOR",43867,184,2,823,567,473,94,556,11,"SALCIA TUDOR",,5,,405,151
9,"Brăila",92,"92-SCORTARU NOU",43929,185,2,795,563,502,61,555,8,"SCORTARU NOU",,5,,469,86
9,"Brăila",92,"92-SCORTARU NOU",43929,186,2,457,412,345,67,406,6,"SCORTARU NOU",,5,,294,112
9,"Brăila",92,"92-SILISTEA",43992,187,2,994,765,605,160,758,7,"SILISTEA",,5,,497,261
9,"Brăila",92,"92-SILISTEA",43992,188,2,269,239,170,69,236,3,"SILISTEA",,5,,168,68
9,"Brăila",92,"92-STANCUTA",44060,189,2,1321,1067,909,158,1061,6,"STANCUTA",,5,,788,273
9,"Brăila",92,"92-STANCUTA",44060,190,2,1175,931,826,105,916,15,"STANCUTA",,5,,650,266
9,"Brăila",92,"92-STANCUTA",44060,191,2,430,388,330,58,382,6,"STANCUTA",,5,,308,74
9,"Brăila",92,"92-SURDILA-GAISEANCA",44113,192,2,1522,1137,1051,86,1124,13,"SURDILA-GAISEANCA",,5,,798,326
9,"Brăila",92,"92-SURDILA-GAISEANCA",44113,193,2,708,620,510,110,609,11,"SURDILA-GAISEANCA",,5,,470,139
9,"Brăila",92,"92-SURDILA-GRECI",42771,194,2,907,490,437,53,487,3,"SURDILA-GRECI",,5,,334,153
9,"Brăila",92,"92-SURDILA-GRECI",42771,195,2,161,250,109,141,242,8,"SURDILA-GRECI",,5,,189,53
9,"Brăila",92,"92-SURDILA-GRECI",42771,196,2,317,253,213,40,253,0,"SURDILA-GRECI",,5,,216,37
9,"Brăila",92,"92-SUTESTI",44140,197,2,1567,1368,1279,89,1352,16,"SUTESTI",,5,,918,434
9,"Brăila",92,"92-SUTESTI",44140,198,2,1701,948,872,76,939,9,"SUTESTI",,5,,620,319
9,"Brăila",92,"92-SUTESTI",44140,199,2,282,255,204,51,253,2,"SUTESTI",,5,,187,66
9,"Brăila",92,"92-TICHILESTI",44177,200,2,1407,1101,851,250,1092,9,"TICHILESTI",,5,,630,462
9,"Brăila",92,"92-TICHILESTI",44177,201,2,1348,1019,909,110,1001,18,"TICHILESTI",,5,,648,353
9,"Brăila",92,"92-TICHILESTI",44177,202,2,187,173,120,53,172,1,"TICHILESTI",,5,,131,41
9,"Brăila",92,"92-TRAIAN",44202,203,2,882,649,478,171,647,2,"TRAIAN",,5,,443,204
9,"Brăila",92,"92-TRAIAN",44202,204,2,594,527,367,160,523,4,"TRAIAN",,5,,428,95
9,"Brăila",92,"92-TRAIAN",44202,205,2,957,792,528,264,777,15,"TRAIAN",,5,,629,148
9,"Brăila",92,"92-TRAIAN",44202,206,2,148,139,103,36,137,2,"TRAIAN",,5,,109,28
9,"Brăila",92,"92-TUDOR VLADIMIRESCU",44257,207,2,972,661,590,71,653,8,"TUDOR VLADIMIRESCU",,5,,380,273
9,"Brăila",92,"92-TUDOR VLADIMIRESCU",44257,208,2,936,658,606,52,649,9,"TUDOR VLADIMIRESCU",,5,,474,175
9,"Brăila",92,"92-TUDOR VLADIMIRESCU",44257,209,2,190,185,131,54,185,0,"TUDOR VLADIMIRESCU",,5,,124,61
9,"Brăila",92,"92-TUDOR VLADIMIRESCU",44257,210,2,1308,1008,854,154,1001,7,"TUDOR VLADIMIRESCU",,5,,646,355
9,"Brăila",92,"92-TUDOR VLADIMIRESCU",44257,211,2,662,536,463,73,532,4,"TUDOR VLADIMIRESCU",,5,,306,226
9,"Brăila",92,"92-TUFESTI",44300,212,2,1649,1126,1018,108,1113,13,"TUFESTI",,5,,824,289
9,"Brăila",92,"92-TUFESTI",44300,213,2,1223,870,793,77,857,13,"TUFESTI",,5,,646,211
9,"Brăila",92,"92-TUFESTI",44300,214,2,1023,806,694,112,798,8,"TUFESTI",,5,,572,226
9,"Brăila",92,"92-TUFESTI",44300,215,2,883,702,594,108,693,9,"TUFESTI",,5,,518,175
9,"Brăila",92,"92-ULMU",44328,216,2,1673,1229,1042,187,1217,12,"ULMU",,5,,934,283
9,"Brăila",92,"92-ULMU",44328,217,2,1013,795,627,168,786,9,"ULMU",,5,,612,174
9,"Brăila",92,"92-ULMU",44328,218,2,1057,804,719,85,799,5,"ULMU",,5,,658,141
9,"Brăila",92,"92-UNIREA",44355,219,2,989,739,649,90,728,11,"UNIREA",,5,,511,217
9,"Brăila",92,"92-UNIREA",44355,220,2,1010,813,687,126,802,11,"UNIREA",,5,,492,310
9,"Brăila",92,"92-VADENI",44391,221,2,1818,1218,948,270,1200,18,"VADENI",,5,,771,429
9,"Brăila",92,"92-VADENI",44391,222,2,647,497,329,168,487,10,"VADENI",,5,,232,255
9,"Brăila",92,"92-VADENI",44391,223,2,139,291,74,217,287,4,"VADENI",,5,,121,166
9,"Brăila",92,"92-VICTORIA",44435,224,2,1778,1293,1141,152,1274,19,"VICTORIA",,5,,953,321
9,"Brăila",92,"92-VICTORIA",44435,225,2,1183,944,823,121,935,9,"VICTORIA",,5,,815,120
9,"Brăila",92,"92-VISANI",44462,226,2,1745,1262,1140,122,1251,11,"VISANI",,5,,967,284
9,"Brăila",92,"92-VISANI",44462,227,2,605,520,454,66,511,9,"VISANI",,5,,383,128
9,"Brăila",92,"92-VIZIRU",44505,228,2,1600,1113,874,239,1105,8,"VIZIRU",,5,,755,350
9,"Brăila",92,"92-VIZIRU",44505,229,2,1856,1241,979,262,1225,16,"VIZIRU",,5,,739,486
9,"Brăila",92,"92-VIZIRU",44505,230,2,1431,1318,1001,317,1293,25,"VIZIRU",,5,,871,422
9,"Brăila",92,"92-ZAVOAIA",44532,231,2,2056,1473,1320,153,1458,15,"ZAVOAIA",,5,,1096,362
9,"Brăila",92,"92-ZAVOAIA",44532,232,2,693,603,507,96,593,10,"ZAVOAIA",,5,,459,134
10,"Buzău",109,"109-MUNICIPIUL BUZAU",44818,1,2,1647,1251,1176,75,1246,5,"MUNICIPIUL BUZAU",,5,,571,675
10,"Buzău",109,"109-MUNICIPIUL BUZAU",44818,2,2,1697,1276,1134,142,1275,1,"MUNICIPIUL BUZAU",,5,,656,619
10,"Buzău",109,"109-MUNICIPIUL BUZAU",44818,3,2,2185,1634,1555,79,1626,8,"MUNICIPIUL BUZAU",,5,,794,832
10,"Buzău",109,"109-MUNICIPIUL BUZAU",44818,4,2,2192,1727,1478,249,1717,10,"MUNICIPIUL BUZAU",,5,,925,792
10,"Buzău",109,"109-MUNICIPIUL BUZAU",44818,5,2,2304,1663,1545,118,1659,4,"MUNICIPIUL BUZAU",,5,,915,744
10,"Buzău",109,"109-MUNICIPIUL BUZAU",44818,6,2,2661,1857,1745,112,1843,14,"MUNICIPIUL BUZAU",,5,,975,868
10,"Buzău",109,"109-MUNICIPIUL BUZAU",44818,7,2,2322,1716,1549,167,1702,14,"MUNICIPIUL BUZAU",,5,,835,867
10,"Buzău",109,"109-MUNICIPIUL BUZAU",44818,8,2,1852,1337,1271,66,1332,5,"MUNICIPIUL BUZAU",,5,,726,606
10,"Buzău",109,"109-MUNICIPIUL BUZAU",44818,9,2,1719,1222,1133,89,1213,9,"MUNICIPIUL BUZAU",,5,,641,572
10,"Buzău",109,"109-MUNICIPIUL BUZAU",44818,10,2,1854,1255,1162,93,1236,19,"MUNICIPIUL BUZAU",,5,,701,535
10,"Buzău",109,"109-MUNICIPIUL BUZAU",44818,11,2,1875,1309,1220,89,1301,8,"MUNICIPIUL BUZAU",,5,,717,584
10,"Buzău",109,"109-MUNICIPIUL BUZAU",44818,12,2,1742,1222,1164,58,1217,5,"MUNICIPIUL BUZAU",,5,,677,540
10,"Buzău",109,"109-MUNICIPIUL BUZAU",44818,13,2,2134,1709,1526,183,1702,7,"MUNICIPIUL BUZAU",,5,,976,726
10,"Buzău",109,"109-MUNICIPIUL BUZAU",44818,14,2,2144,1444,1377,67,1433,11,"MUNICIPIUL BUZAU",,5,,793,640
10,"Buzău",109,"109-MUNICIPIUL BUZAU",44818,15,2,2366,1657,1562,95,1649,8,"MUNICIPIUL BUZAU",,5,,932,717
10,"Buzău",109,"109-MUNICIPIUL BUZAU",44818,16,2,2156,1533,1452,81,1527,6,"MUNICIPIUL BUZAU",,5,,868,659
10,"Buzău",109,"109-MUNICIPIUL BUZAU",44818,17,2,2599,1879,1776,103,1876,3,"MUNICIPIUL BUZAU",,5,,1034,842
10,"Buzău",109,"109-MUNICIPIUL BUZAU",44818,18,2,1628,1249,1197,52,1238,11,"MUNICIPIUL BUZAU",,5,,687,551
10,"Buzău",109,"109-MUNICIPIUL BUZAU",44818,19,2,2036,1467,1356,111,1460,7,"MUNICIPIUL BUZAU",,5,,883,577
10,"Buzău",109,"109-MUNICIPIUL BUZAU",44818,20,2,1610,1155,1075,80,1147,8,"MUNICIPIUL BUZAU",,5,,604,543
10,"Buzău",109,"109-MUNICIPIUL BUZAU",44818,21,2,1421,1355,1008,347,1346,9,"MUNICIPIUL BUZAU",,5,,837,509
10,"Buzău",109,"109-MUNICIPIUL BUZAU",44818,22,2,1529,1232,1109,123,1223,9,"MUNICIPIUL BUZAU",,5,,808,415
10,"Buzău",109,"109-MUNICIPIUL BUZAU",44818,23,2,1908,1909,1339,570,1901,8,"MUNICIPIUL BUZAU",,5,,1166,735
10,"Buzău",109,"109-MUNICIPIUL BUZAU",44818,24,2,1512,1089,1001,88,1082,7,"MUNICIPIUL BUZAU",,5,,567,515
10,"Buzău",109,"109-MUNICIPIUL BUZAU",44818,25,2,1781,1357,1235,122,1350,7,"MUNICIPIUL BUZAU",,5,,676,674
10,"Buzău",109,"109-MUNICIPIUL BUZAU",44818,26,2,1673,1221,1159,62,1210,11,"MUNICIPIUL BUZAU",,5,,606,604
10,"Buzău",109,"109-MUNICIPIUL BUZAU",44818,27,2,2156,1514,1410,104,1510,4,"MUNICIPIUL BUZAU",,5,,797,713
10,"Buzău",109,"109-MUNICIPIUL BUZAU",44818,28,2,1748,1316,1210,106,1314,2,"MUNICIPIUL BUZAU",,5,,701,613
10,"Buzău",109,"109-MUNICIPIUL BUZAU",44818,29,2,2141,1463,1340,123,1458,5,"MUNICIPIUL BUZAU",,5,,753,705
10,"Buzău",109,"109-MUNICIPIUL BUZAU",44818,30,2,2016,1423,1249,174,1416,7,"MUNICIPIUL BUZAU",,5,,694,722
10,"Buzău",109,"109-MUNICIPIUL BUZAU",44818,31,2,1876,1410,1280,130,1404,6,"MUNICIPIUL BUZAU",,5,,742,662
10,"Buzău",109,"109-MUNICIPIUL BUZAU",44818,32,2,1807,1346,1207,139,1344,2,"MUNICIPIUL BUZAU",,5,,753,591
10,"Buzău",109,"109-MUNICIPIUL BUZAU",44818,33,2,2011,1535,1381,154,1525,10,"MUNICIPIUL BUZAU",,5,,789,736
10,"Buzău",109,"109-MUNICIPIUL BUZAU",44818,34,2,2039,1626,1403,223,1621,5,"MUNICIPIUL BUZAU",,5,,908,713
10,"Buzău",109,"109-MUNICIPIUL BUZAU",44818,35,2,1816,1275,1169,106,1270,5,"MUNICIPIUL BUZAU",,5,,693,577
10,"Buzău",109,"109-MUNICIPIUL BUZAU",44818,36,2,1642,1254,1151,103,1244,10,"MUNICIPIUL BUZAU",,5,,723,521
10,"Buzău",109,"109-MUNICIPIUL BUZAU",44818,37,2,1595,1264,1138,126,1260,4,"MUNICIPIUL BUZAU",,5,,566,694
10,"Buzău",109,"109-MUNICIPIUL BUZAU",44818,38,2,1820,1307,1184,123,1307,0,"MUNICIPIUL BUZAU",,5,,560,747
10,"Buzău",109,"109-MUNICIPIUL BUZAU",44818,39,2,1745,1336,1173,163,1330,6,"MUNICIPIUL BUZAU",,5,,680,650
10,"Buzău",109,"109-MUNICIPIUL BUZAU",44818,40,2,1620,1189,1101,88,1179,10,"MUNICIPIUL BUZAU",,5,,566,613
10,"Buzău",109,"109-MUNICIPIUL BUZAU",44818,41,2,1470,1192,1103,89,1190,2,"MUNICIPIUL BUZAU",,5,,521,669
10,"Buzău",109,"109-MUNICIPIUL BUZAU",44818,42,2,1393,1021,895,126,1005,16,"MUNICIPIUL BUZAU",,5,,494,511
10,"Buzău",109,"109-MUNICIPIUL BUZAU",44818,43,2,1670,1276,1186,90,1266,10,"MUNICIPIUL BUZAU",,5,,659,607
10,"Buzău",109,"109-MUNICIPIUL BUZAU",44818,44,2,1589,1191,1088,103,1186,5,"MUNICIPIUL BUZAU",,5,,554,632
10,"Buzău",109,"109-MUNICIPIUL BUZAU",44818,45,2,1559,1151,1103,48,1142,9,"MUNICIPIUL BUZAU",,5,,633,509
10,"Buzău",109,"109-MUNICIPIUL BUZAU",44818,46,2,2088,1412,1212,200,1409,3,"MUNICIPIUL BUZAU",,5,,771,638
10,"Buzău",109,"109-MUNICIPIUL BUZAU",44818,47,2,1958,1422,1301,121,1420,2,"MUNICIPIUL BUZAU",,5,,785,635
10,"Buzău",109,"109-MUNICIPIUL BUZAU",44818,48,2,2127,1585,1468,117,1573,12,"MUNICIPIUL BUZAU",,5,,849,724
10,"Buzău",109,"109-MUNICIPIUL BUZAU",44818,49,2,1880,1310,1181,129,1294,16,"MUNICIPIUL BUZAU",,5,,737,557
10,"Buzău",109,"109-MUNICIPIUL BUZAU",44818,50,2,2460,1700,1548,152,1687,13,"MUNICIPIUL BUZAU",,5,,919,768
10,"Buzău",109,"109-MUNICIPIUL BUZAU",44818,51,2,2345,1802,1596,206,1799,3,"MUNICIPIUL BUZAU",,5,,950,849
10,"Buzău",109,"109-MUNICIPIUL BUZAU",44818,52,2,2601,1945,1600,345,1939,6,"MUNICIPIUL BUZAU",,5,,992,947
10,"Buzău",109,"109-MUNICIPIUL BUZAU",44818,53,2,2188,1725,1355,370,1707,18,"MUNICIPIUL BUZAU",,5,,857,850
10,"Buzău",109,"109-MUNICIPIUL BUZAU",44818,54,2,1864,1387,1225,162,1381,6,"MUNICIPIUL BUZAU",,5,,670,711
10,"Buzău",109,"109-MUNICIPIUL BUZAU",44818,55,2,1801,1273,1192,81,1253,20,"MUNICIPIUL BUZAU",,5,,753,500
10,"Buzău",109,"109-MUNICIPIUL BUZAU",44818,56,2,2236,1731,1448,283,1716,15,"MUNICIPIUL BUZAU",,5,,928,788
10,"Buzău",109,"109-MUNICIPIUL BUZAU",44818,57,2,1708,1306,1185,121,1292,14,"MUNICIPIUL BUZAU",,5,,714,578
10,"Buzău",109,"109-MUNICIPIUL BUZAU",44818,58,2,2381,1580,1430,150,1553,27,"MUNICIPIUL BUZAU",,5,,921,632
10,"Buzău",109,"109-MUNICIPIUL BUZAU",44818,59,2,0,1008,0,1008,997,11,"MUNICIPIUL BUZAU",,5,,448,549
10,"Buzău",109,"109-MUNICIPIUL BUZAU",44818,60,2,0,533,0,533,531,2,"MUNICIPIUL BUZAU",,5,,288,243
10,"Buzău",109,"109-MUNICIPIUL BUZAU",44818,61,2,0,72,0,72,71,1,"MUNICIPIUL BUZAU",,5,,52,19
10,"Buzău",109,"109-MUNICIPIUL BUZAU",44818,62,2,0,117,0,117,116,1,"MUNICIPIUL BUZAU",,5,,62,54
10,"Buzău",109,"109-MUNICIPIUL BUZAU",44818,63,2,73,111,73,38,110,1,"MUNICIPIUL BUZAU",,5,,66,44
10,"Buzău",109,"109-MUNICIPIUL BUZAU",44818,64,2,0,62,0,62,61,1,"MUNICIPIUL BUZAU",,5,,34,27
10,"Buzău",109,"109-MUNICIPIUL BUZAU",44818,65,2,0,33,0,33,33,0,"MUNICIPIUL BUZAU",,5,,18,15
10,"Buzău",109,"109-MUNICIPIUL BUZAU",44818,66,2,310,310,275,35,306,4,"MUNICIPIUL BUZAU",,5,,157,149
10,"Buzău",109,"109-MUNICIPIUL BUZAU",44818,67,2,303,322,284,38,314,8,"MUNICIPIUL BUZAU",,5,,164,150
10,"Buzău",109,"109-MUNICIPIUL BUZAU",44818,68,2,604,594,552,42,578,16,"MUNICIPIUL BUZAU",,5,,274,304
10,"Buzău",109,"109-MUNICIPIUL BUZAU",44818,69,2,247,206,173,33,204,2,"MUNICIPIUL BUZAU",,5,,134,70
10,"Buzău",109,"109-MUNICIPIUL BUZAU",44818,70,2,95,118,89,29,117,1,"MUNICIPIUL BUZAU",,5,,74,43
10,"Buzău",109,"109-MUNICIPIUL RAMNICU SARAT",44845,71,2,1521,1065,993,72,1056,9,"MUNICIPIUL RAMNICU SARAT",,5,,637,419
10,"Buzău",109,"109-MUNICIPIUL RAMNICU SARAT",44845,72,2,1572,1052,963,89,1037,15,"MUNICIPIUL RAMNICU SARAT",,5,,574,463
10,"Buzău",109,"109-MUNICIPIUL RAMNICU SARAT",44845,73,2,1402,1042,938,104,1034,8,"MUNICIPIUL RAMNICU SARAT",,5,,576,458
10,"Buzău",109,"109-MUNICIPIUL RAMNICU SARAT",44845,74,2,1621,1173,1073,100,1167,6,"MUNICIPIUL RAMNICU SARAT",,5,,669,498
10,"Buzău",109,"109-MUNICIPIUL RAMNICU SARAT",44845,75,2,1595,1145,1046,99,1132,13,"MUNICIPIUL RAMNICU SARAT",,5,,651,481
10,"Buzău",109,"109-MUNICIPIUL RAMNICU SARAT",44845,76,2,1443,1072,1007,65,1070,2,"MUNICIPIUL RAMNICU SARAT",,5,,627,443
10,"Buzău",109,"109-MUNICIPIUL RAMNICU SARAT",44845,77,2,1376,1088,988,100,1084,4,"MUNICIPIUL RAMNICU SARAT",,5,,581,503
10,"Buzău",109,"109-MUNICIPIUL RAMNICU SARAT",44845,78,2,1477,1018,940,78,1017,1,"MUNICIPIUL RAMNICU SARAT",,5,,543,474
10,"Buzău",109,"109-MUNICIPIUL RAMNICU SARAT",44845,79,2,1488,1017,928,89,1012,5,"MUNICIPIUL RAMNICU SARAT",,5,,578,434
10,"Buzău",109,"109-MUNICIPIUL RAMNICU SARAT",44845,80,2,1540,1220,1059,161,1209,11,"MUNICIPIUL RAMNICU SARAT",,5,,719,490
10,"Buzău",109,"109-MUNICIPIUL RAMNICU SARAT",44845,81,2,1475,1031,975,56,1026,5,"MUNICIPIUL RAMNICU SARAT",,5,,562,464
10,"Buzău",109,"109-MUNICIPIUL RAMNICU SARAT",44845,82,2,1489,1131,1024,107,1124,7,"MUNICIPIUL RAMNICU SARAT",,5,,624,500
10,"Buzău",109,"109-MUNICIPIUL RAMNICU SARAT",44845,83,2,1480,1086,983,103,1078,8,"MUNICIPIUL RAMNICU SARAT",,5,,592,486
10,"Buzău",109,"109-MUNICIPIUL RAMNICU SARAT",44845,84,2,1521,1108,1015,93,1100,8,"MUNICIPIUL RAMNICU SARAT",,5,,648,452
10,"Buzău",109,"109-MUNICIPIUL RAMNICU SARAT",44845,85,2,1457,1132,1046,86,1125,7,"MUNICIPIUL RAMNICU SARAT",,5,,617,508
10,"Buzău",109,"109-MUNICIPIUL RAMNICU SARAT",44845,86,2,1767,1184,1082,102,1176,8,"MUNICIPIUL RAMNICU SARAT",,5,,612,564
10,"Buzău",109,"109-MUNICIPIUL RAMNICU SARAT",44845,87,2,1560,1216,1063,153,1208,8,"MUNICIPIUL RAMNICU SARAT",,5,,683,525
10,"Buzău",109,"109-MUNICIPIUL RAMNICU SARAT",44845,88,2,1736,1150,1096,54,1143,7,"MUNICIPIUL RAMNICU SARAT",,5,,626,517
10,"Buzău",109,"109-MUNICIPIUL RAMNICU SARAT",44845,89,2,1492,1108,998,110,1103,5,"MUNICIPIUL RAMNICU SARAT",,5,,556,547
10,"Buzău",109,"109-MUNICIPIUL RAMNICU SARAT",44845,90,2,1496,1068,1000,68,1064,4,"MUNICIPIUL RAMNICU SARAT",,5,,540,524
10,"Buzău",109,"109-MUNICIPIUL RAMNICU SARAT",44845,91,2,1352,965,884,81,964,1,"MUNICIPIUL RAMNICU SARAT",,5,,510,454
10,"Buzău",109,"109-MUNICIPIUL RAMNICU SARAT",44845,92,2,0,297,0,297,296,1,"MUNICIPIUL RAMNICU SARAT",,5,,197,99
10,"Buzău",109,"109-MUNICIPIUL RAMNICU SARAT",44845,93,2,133,152,124,28,150,2,"MUNICIPIUL RAMNICU SARAT",,5,,78,72
10,"Buzău",109,"109-MUNICIPIUL RAMNICU SARAT",44845,94,2,506,482,448,34,480,2,"MUNICIPIUL RAMNICU SARAT",,5,,264,216
10,"Buzău",109,"109-ORAS NEHOIU",47916,95,2,993,861,789,72,855,6,"ORAS NEHOIU",,5,,628,227
10,"Buzău",109,"109-ORAS NEHOIU",47916,96,2,157,141,124,17,141,0,"ORAS NEHOIU",,5,,98,43
10,"Buzău",109,"109-ORAS NEHOIU",47916,97,2,843,790,630,160,782,8,"ORAS NEHOIU",,5,,488,294
10,"Buzău",109,"109-ORAS NEHOIU",47916,98,2,362,298,267,31,297,1,"ORAS NEHOIU",,5,,232,65
10,"Buzău",109,"109-ORAS NEHOIU",47916,99,2,2295,2056,1749,307,2048,8,"ORAS NEHOIU",,5,,1245,803
10,"Buzău",109,"109-ORAS NEHOIU",47916,100,2,1081,888,846,42,884,4,"ORAS NEHOIU",,5,,711,173
10,"Buzău",109,"109-ORAS NEHOIU",47916,101,2,725,602,551,51,597,5,"ORAS NEHOIU",,5,,385,212
10,"Buzău",109,"109-ORAS NEHOIU",47916,102,2,351,271,256,15,271,0,"ORAS NEHOIU",,5,,194,77
10,"Buzău",109,"109-ORAS NEHOIU",47916,103,2,623,580,506,74,575,5,"ORAS NEHOIU",,5,,415,160
10,"Buzău",109,"109-ORAS NEHOIU",47916,104,2,535,509,478,31,507,2,"ORAS NEHOIU",,5,,407,100
10,"Buzău",109,"109-ORAS NEHOIU",47916,105,2,232,208,183,25,206,2,"ORAS NEHOIU",,5,,166,40
10,"Buzău",109,"109-ORAS NEHOIU",47916,106,2,740,620,559,61,611,9,"ORAS NEHOIU",,5,,453,158
10,"Buzău",109,"109-ORAS POGOANELE",48744,107,2,1368,1050,879,171,1021,29,"ORAS POGOANELE",,5,,523,498
10,"Buzău",109,"109-ORAS POGOANELE",48744,108,2,1520,1111,965,146,1102,9,"ORAS POGOANELE",,5,,706,396
10,"Buzău",109,"109-ORAS POGOANELE",48744,109,2,1367,1063,887,176,1047,16,"ORAS POGOANELE",,5,,658,389
10,"Buzău",109,"109-ORAS POGOANELE",48744,110,2,1705,1192,1026,166,1169,23,"ORAS POGOANELE",,5,,853,316
10,"Buzău",109,"109-AMARU",44863,111,2,1101,838,690,148,831,7,"AMARU",,5,,602,229
10,"Buzău",109,"109-AMARU",44863,112,2,319,378,218,160,372,6,"AMARU",,5,,320,52
10,"Buzău",109,"109-AMARU",44863,113,2,200,210,135,75,208,2,"AMARU",,5,,158,50
10,"Buzău",109,"109-AMARU",44863,114,2,358,340,230,110,338,2,"AMARU",,5,,276,62
10,"Buzău",109,"109-BALTA ALBA",44934,115,2,613,524,462,62,515,9,"BALTA ALBA",,5,,325,190
10,"Buzău",109,"109-BALTA ALBA",44934,116,2,500,462,347,115,458,4,"BALTA ALBA",,5,,268,190
10,"Buzău",109,"109-BALTA ALBA",44934,117,2,1604,1176,1063,113,1164,12,"BALTA ALBA",,5,,801,363
10,"Buzău",109,"109-BALACEANU",44989,118,2,1492,1068,971,97,1060,8,"BALACEANU",,5,,835,225
10,"Buzău",109,"109-BECENI",45003,119,2,882,633,424,209,628,5,"BECENI",,5,,457,171
10,"Buzău",109,"109-BECENI",45003,120,2,886,794,584,210,790,4,"BECENI",,5,,642,148
10,"Buzău",109,"109-BECENI",45003,121,2,335,221,175,46,221,0,"BECENI",,5,,183,38
10,"Buzău",109,"109-BECENI",45003,122,2,828,670,479,191,666,4,"BECENI",,5,,513,153
10,"Buzău",109,"109-BECENI",45003,123,2,1279,883,660,223,875,8,"BECENI",,5,,623,252
10,"Buzău",109,"109-BERCA",45101,124,2,2132,1686,1338,348,1678,8,"BERCA",,5,,1046,632
10,"Buzău",109,"109-BERCA",45101,125,2,1100,824,686,138,819,5,"BERCA",,5,,533,286
10,"Buzău",109,"109-BERCA",45101,126,2,1001,694,580,114,687,7,"BERCA",,5,,512,175
10,"Buzău",109,"109-BERCA",45101,127,2,220,208,172,36,204,4,"BERCA",,5,,142,62
10,"Buzău",109,"109-BERCA",45101,128,2,1532,1088,922,166,1084,4,"BERCA",,5,,750,334
10,"Buzău",109,"109-BERCA",45101,129,2,548,531,425,106,529,2,"BERCA",,5,,375,154
10,"Buzău",109,"109-BERCA",45101,130,2,726,599,487,112,593,6,"BERCA",,5,,435,158
10,"Buzău",109,"109-BISOCA",45245,131,2,1068,598,511,87,595,3,"BISOCA",,5,,509,86
10,"Buzău",109,"109-BISOCA",45245,132,2,1261,631,574,57,626,5,"BISOCA",,5,,538,88
10,"Buzău",109,"109-BLAJANI",45334,133,2,1158,743,672,71,733,10,"BLAJANI",,5,,552,181
10,"Buzău",109,"109-BOLDU",45361,134,2,1128,938,826,112,932,6,"BOLDU",,5,,560,372
10,"Buzău",109,"109-BOLDU",45361,135,2,984,823,729,94,816,7,"BOLDU",,5,,443,373
10,"Buzău",109,"109-BOZIORU",45389,136,2,696,512,464,48,502,10,"BOZIORU",,5,,292,210
10,"Buzău",109,"109-BOZIORU",45389,137,2,491,340,313,27,340,0,"BOZIORU",,5,,250,90
10,"Buzău",109,"109-BRADEANU",45496,138,2,1117,711,615,96,702,9,"BRADEANU",,5,,445,257
10,"Buzău",109,"109-BRADEANU",45496,139,2,945,713,613,100,704,9,"BRADEANU",,5,,580,124
10,"Buzău",109,"109-BRADEANU",45496,140,2,451,392,331,61,388,4,"BRADEANU",,5,,332,56
10,"Buzău",109,"109-BRAESTI",45539,141,2,946,657,551,106,651,6,"BRAESTI",,5,,512,139
10,"Buzău",109,"109-BRAESTI",45539,142,2,1208,817,743,74,810,7,"BRAESTI",,5,,707,103
10,"Buzău",109,"109-BREAZA",45619,143,2,1096,753,659,94,739,14,"BREAZA",,5,,529,210
10,"Buzău",109,"109-BREAZA",45619,144,2,1040,689,551,138,679,10,"BREAZA",,5,,424,255
10,"Buzău",109,"109-BREAZA",45619,145,2,761,556,467,89,548,8,"BREAZA",,5,,351,197
10,"Buzău",109,"109-BUDA",45673,146,2,1584,1134,1014,120,1123,11,"BUDA",,5,,873,250
10,"Buzău",109,"109-BUDA",45673,147,2,1125,620,528,92,611,9,"BUDA",,5,,475,136
10,"Buzău",109,"109-CALVINI",45753,148,2,1638,963,864,99,954,9,"CALVINI",,5,,626,328
10,"Buzău",109,"109-CALVINI",45753,149,2,1561,842,753,89,826,16,"CALVINI",,5,,568,258
10,"Buzău",109,"109-C.A.ROSETTI",45815,150,2,791,629,531,98,624,5,"C.A.ROSETTI",,5,,466,158
10,"Buzău",109,"109-C.A.ROSETTI",45815,151,2,181,172,138,34,169,3,"C.A.ROSETTI",,5,,121,48
10,"Buzău",109,"109-C.A.ROSETTI",45815,152,2,435,422,340,82,414,8,"C.A.ROSETTI",,5,,356,58
10,"Buzău",109,"109-C.A.ROSETTI",45815,153,2,530,512,415,97,508,4,"C.A.ROSETTI",,5,,358,150
10,"Buzău",109,"109-C.A.ROSETTI",45815,154,2,1244,1348,1244,104,1338,10,"C.A.ROSETTI",,5,,1092,246
10,"Buzău",109,"109-C.A.ROSETTI",45815,155,2,357,333,271,62,333,0,"C.A.ROSETTI",,5,,235,98
10,"Buzău",109,"109-CANESTI",45888,156,2,992,742,658,84,727,15,"CANESTI",,5,,544,183
10,"Buzău",109,"109-CATINA",45959,157,2,1493,884,805,79,799,6,"CATINA",,5,,647,152
10,"Buzău",109,"109-CATINA",45959,158,2,835,625,534,91,619,6,"CATINA",,5,,503,116
10,"Buzău",109,"109-CERNATESTI",46019,159,2,2174,1408,1203,205,1400,8,"CERNATESTI",,5,,1045,355
10,"Buzău",109,"109-CERNATESTI",46019,160,2,1133,763,600,163,752,11,"CERNATESTI",,5,,598,154
10,"Buzău",109,"109-CHILIILE",46108,161,2,805,656,586,70,653,3,"CHILIILE",,5,,558,95
10,"Buzău",109,"109-CHIOJDU",46180,162,2,908,673,552,121,666,7,"CHIOJDU",,5,,474,192
10,"Buzău",109,"109-CHIOJDU",46180,163,2,1198,777,712,65,771,6,"CHIOJDU",,5,,592,179
10,"Buzău",109,"109-CHIOJDU",46180,164,2,464,339,301,38,333,6,"CHIOJDU",,5,,312,21
10,"Buzău",109,"109-CHIOJDU",46180,165,2,440,321,282,39,319,2,"CHIOJDU",,5,,261,58
10,"Buzău",109,"109-CHIOJDU",46180,166,2,378,299,273,26,298,1,"CHIOJDU",,5,,239,59
10,"Buzău",109,"109-CILIBIA",46251,167,2,1039,645,560,85,634,11,"CILIBIA",,5,,393,241
10,"Buzău",109,"109-CILIBIA",46251,168,2,402,373,327,46,370,3,"CILIBIA",,5,,296,74
10,"Buzău",109,"109-CISLAU",46313,169,2,2076,1452,1158,294,1439,13,"CISLAU",,5,,956,483
10,"Buzău",109,"109-CISLAU",46313,170,2,704,490,402,88,481,9,"CISLAU",,5,,352,129
10,"Buzău",109,"109-CISLAU",46313,171,2,1095,865,670,195,861,4,"CISLAU",,5,,623,238
10,"Buzău",109,"109-COSTESTI",46484,172,2,1774,1089,1023,66,1074,15,"COSTESTI",,5,,729,345
10,"Buzău",109,"109-COSTESTI",46484,173,2,1024,731,607,124,718,13,"COSTESTI",,5,,509,209
10,"Buzău",109,"109-COSTESTI",46484,174,2,924,674,542,132,666,8,"COSTESTI",,5,,451,215
10,"Buzău",109,"109-COCHIRLEANCA",46377,175,2,1463,1028,979,49,1014,14,"COCHIRLEANCA",,5,,727,287
10,"Buzău",109,"109-COCHIRLEANCA",46377,176,2,758,552,491,61,548,4,"COCHIRLEANCA",,5,,415,133
10,"Buzău",109,"109-COCHIRLEANCA",46377,177,2,1458,1026,916,110,1013,13,"COCHIRLEANCA",,5,,736,277
10,"Buzău",109,"109-COCHIRLEANCA",46377,178,2,633,511,444,67,506,5,"COCHIRLEANCA",,5,,382,124
10,"Buzău",109,"109-COCHIRLEANCA",46377,179,2,425,392,344,48,385,7,"COCHIRLEANCA",,5,,155,230
10,"Buzău",109,"109-COZIENI",46554,180,2,656,435,374,61,434,1,"COZIENI",,5,,232,202
10,"Buzău",109,"109-COZIENI",46554,181,2,828,635,564,71,630,5,"COZIENI",,5,,447,183
10,"Buzău",109,"109-COZIENI",46554,182,2,388,300,232,68,298,2,"COZIENI",,5,,223,75
10,"Buzău",109,"109-COZIENI",46554,183,2,547,355,326,29,355,0,"COZIENI",,5,,258,97
10,"Buzău",109,"109-COLTI",46439,184,2,1225,845,773,72,842,3,"COLTI",,5,,684,158
10,"Buzău",109,"109-GALBINASI",46769,185,2,932,590,519,71,579,11,"GALBINASI",,5,,378,201
10,"Buzău",109,"109-GALBINASI",46769,186,2,689,552,477,75,540,12,"GALBINASI",,5,,399,141
10,"Buzău",109,"109-GALBINASI",46769,187,2,1410,956,831,125,943,13,"GALBINASI",,5,,701,242
10,"Buzău",109,"109-GHERASENI",46803,188,2,2070,1412,1258,154,1395,17,"GHERASENI",,5,,886,509
10,"Buzău",109,"109-GHERASENI",46803,189,2,906,668,573,95,657,11,"GHERASENI",,5,,419,238
10,"Buzău",109,"109-GHERGHEASA",46830,190,2,1346,1004,913,91,990,14,"GHERGHEASA",,5,,691,299
10,"Buzău",109,"109-GHERGHEASA",46830,191,2,1160,921,845,76,909,12,"GHERGHEASA",,5,,681,228
10,"Buzău",109,"109-GLODEANU-SILISTEA",46910,192,2,1433,1100,1008,92,1084,16,"GLODEANU-SILISTEA",,5,,685,399
10,"Buzău",109,"109-GLODEANU-SILISTEA",46910,193,2,888,684,600,84,675,9,"GLODEANU-SILISTEA",,5,,491,184
10,"Buzău",109,"109-GLODEANU-SILISTEA",46910,194,2,464,478,392,86,475,3,"GLODEANU-SILISTEA",,5,,337,138
10,"Buzău",109,"109-GLODEANU-SILISTEA",46910,195,2,675,483,408,75,472,11,"GLODEANU-SILISTEA",,5,,318,154
10,"Buzău",109,"109-GLODEANU-SILISTEA",46910,196,2,394,327,270,57,322,5,"GLODEANU-SILISTEA",,5,,220,102
10,"Buzău",109,"109-GLODEANU SARAT",46867,197,2,2268,1821,1640,181,1764,57,"GLODEANU SARAT",,5,,1256,508
10,"Buzău",109,"109-GLODEANU SARAT",46867,198,2,452,350,306,44,343,7,"GLODEANU SARAT",,5,,254,89
10,"Buzău",109,"109-GLODEANU SARAT",46867,199,2,882,620,584,36,613,7,"GLODEANU SARAT",,5,,451,162
10,"Buzău",109,"109-GLODEANU SARAT",46867,200,2,593,459,393,66,455,4,"GLODEANU SARAT",,5,,342,113
10,"Buzău",109,"109-GREBANU",47006,201,2,1602,960,805,155,950,10,"GREBANU",,5,,704,246
10,"Buzău",109,"109-GREBANU",47006,202,2,1023,814,683,131,809,5,"GREBANU",,5,,600,209
10,"Buzău",109,"109-GREBANU",47006,203,2,668,484,367,117,477,7,"GREBANU",,5,,360,117
10,"Buzău",109,"109-GREBANU",47006,204,2,833,567,457,110,560,7,"GREBANU",,5,,416,144
10,"Buzău",109,"109-GURA TEGHII",47079,205,2,600,475,430,45,472,3,"GURA TEGHII",,5,,365,107
10,"Buzău",109,"109-GURA TEGHII",47079,206,2,874,719,685,34,715,4,"GURA TEGHII",,5,,583,132
10,"Buzău",109,"109-GURA TEGHII",47079,207,2,1167,915,853,62,913,2,"GURA TEGHII",,5,,769,144
10,"Buzău",109,"109-GURA TEGHII",47079,208,2,635,464,433,31,463,1,"GURA TEGHII",,5,,404,59
10,"Buzău",109,"109-LARGU",47159,209,2,1537,1101,994,107,1086,15,"LARGU",,5,,882,204
10,"Buzău",109,"109-LOPATARI",47186,210,2,1163,912,728,184,900,12,"LOPATARI",,5,,539,361
10,"Buzău",109,"109-LOPATARI",47186,211,2,770,544,469,75,541,3,"LOPATARI",,5,,410,131
10,"Buzău",109,"109-LOPATARI",47186,212,2,957,600,510,90,587,13,"LOPATARI",,5,,495,92
10,"Buzău",109,"109-LOPATARI",47186,213,2,675,462,384,78,453,9,"LOPATARI",,5,,412,41
10,"Buzău",109,"109-LUCIU",47300,214,2,1532,1285,1203,82,1281,4,"LUCIU",,5,,857,424
10,"Buzău",109,"109-LUCIU",47300,215,2,730,665,585,80,661,4,"LUCIU",,5,,470,191
10,"Buzău",109,"109-MAGURA",47337,216,2,1207,958,755,203,942,16,"MAGURA",,5,,628,314
10,"Buzău",109,"109-MAGURA",47337,217,2,529,407,342,65,404,3,"MAGURA",,5,,296,108
10,"Buzău",109,"109-MAGURA",47337,218,2,832,617,536,81,610,7,"MAGURA",,5,,429,181
10,"Buzău",109,"109-MAGURA",47337,219,2,914,615,582,33,610,5,"MAGURA",,5,,409,201
10,"Buzău",109,"109-MAGURA",47337,220,2,73,98,67,31,96,2,"MAGURA",,5,,52,44
10,"Buzău",109,"109-MARACINENI",47373,221,2,1686,1121,982,139,1111,10,"MARACINENI",,5,,650,461
10,"Buzău",109,"109-MARACINENI",47373,222,2,2073,1328,1171,157,1317,11,"MARACINENI",,5,,880,437
10,"Buzău",109,"109-MARACINENI",47373,223,2,1383,947,868,79,942,5,"MARACINENI",,5,,669,273
10,"Buzău",109,"109-MARACINENI",47373,224,2,226,237,207,30,229,8,"MARACINENI",,5,,120,109
10,"Buzău",109,"109-MARGARITESTI",47417,225,2,864,569,500,69,562,7,"MARGARITESTI",,5,,401,161
10,"Buzău",109,"109-MIHAILESTI",47578,226,2,1133,785,585,200,775,10,"MIHAILESTI",,5,,511,264
10,"Buzău",109,"109-MIHAILESTI",47578,227,2,1461,1574,1434,140,1547,27,"MIHAILESTI",,5,,1053,494
10,"Buzău",109,"109-MIHAILESTI",47578,228,2,564,522,425,97,502,20,"MIHAILESTI",,5,,365,137
10,"Buzău",109,"109-MEREI",47453,229,2,1545,929,694,235,906,23,"MEREI",,5,,533,373
10,"Buzău",109,"109-MEREI",47453,230,2,1387,1048,850,198,1033,15,"MEREI",,5,,637,396
10,"Buzău",109,"109-MEREI",47453,231,2,665,569,352,217,564,5,"MEREI",,5,,356,208
10,"Buzău",109,"109-MEREI",47453,232,2,1120,722,566,156,713,9,"MEREI",,5,,475,238
10,"Buzău",109,"109-MEREI",47453,233,2,735,658,481,177,653,5,"MEREI",,5,,400,253
10,"Buzău",109,"109-MANZALESTI",47630,234,2,787,535,448,87,528,7,"MANZALESTI",,5,,423,105
10,"Buzău",109,"109-MANZALESTI",47630,235,2,833,611,505,106,603,8,"MANZALESTI",,5,,489,114
10,"Buzău",109,"109-MANZALESTI",47630,236,2,777,480,412,68,466,14,"MANZALESTI",,5,,380,86
10,"Buzău",109,"109-MOVILA BANULUI",47774,237,2,1451,952,841,111,944,8,"MOVILA BANULUI",,5,,712,232
10,"Buzău",109,"109-MOVILA BANULUI",47774,238,2,883,624,545,79,615,9,"MOVILA BANULUI",,5,,405,210
10,"Buzău",109,"109-MURGESTI",47818,239,2,1061,701,608,93,694,7,"MURGESTI",,5,,445,249
10,"Buzău",109,"109-NAENI",47854,240,2,1076,712,624,88,687,25,"NAENI",,5,,484,203
10,"Buzău",109,"109-NAENI",47854,241,2,633,459,391,68,449,10,"NAENI",,5,,282,167
10,"Buzău",109,"109-ODAILE",48021,242,2,1078,792,711,81,783,9,"ODAILE",,5,,640,143
10,"Buzău",109,"109-PADINA",48138,243,2,1336,1001,841,160,991,10,"PADINA",,5,,689,302
10,"Buzău",109,"109-PADINA",48138,244,2,1349,861,716,145,851,10,"PADINA",,5,,609,242
10,"Buzău",109,"109-PADINA",48138,245,2,1401,887,720,167,876,11,"PADINA",,5,,676,200
10,"Buzău",109,"109-PARDOSI",48165,246,2,560,365,295,70,362,3,"PARDOSI",,5,,270,92
10,"Buzău",109,"109-PANATAU",48227,247,2,1651,1255,1153,102,1235,20,"PANATAU",,5,,989,246
10,"Buzău",109,"109-PANATAU",48227,248,2,672,520,473,47,506,14,"PANATAU",,5,,426,80
10,"Buzău",109,"109-PATARLAGELE",48334,249,2,2130,1548,1396,152,1541,7,"PATARLAGELE",,5,,1017,524
10,"Buzău",109,"109-PATARLAGELE",48334,250,2,276,235,186,49,232,3,"PATARLAGELE",,5,,152,80
10,"Buzău",109,"109-PATARLAGELE",48334,251,2,1313,936,860,76,929,7,"PATARLAGELE",,5,,750,179
10,"Buzău",109,"109-PATARLAGELE",48334,252,2,425,358,316,42,358,0,"PATARLAGELE",,5,,242,116
10,"Buzău",109,"109-PATARLAGELE",48334,253,2,453,367,313,54,366,1,"PATARLAGELE",,5,,255,111
10,"Buzău",109,"109-PATARLAGELE",48334,254,2,86,74,54,20,74,0,"PATARLAGELE",,5,,60,14
10,"Buzău",109,"109-PATARLAGELE",48334,255,2,489,367,335,32,366,1,"PATARLAGELE",,5,,297,69
10,"Buzău",109,"109-PATARLAGELE",48334,256,2,695,486,450,36,480,6,"PATARLAGELE",,5,,383,97
10,"Buzău",109,"109-PATARLAGELE",48334,257,2,816,663,588,75,658,5,"PATARLAGELE",,5,,403,255
10,"Buzău",109,"109-PATARLAGELE",48334,258,2,254,227,201,26,226,1,"PATARLAGELE",,5,,160,66
10,"Buzău",109,"109-PIETROASELE",48487,259,2,1413,1201,947,254,1190,11,"PIETROASELE",,5,,716,474
10,"Buzău",109,"109-PIETROASELE",48487,260,2,1496,1031,826,205,1020,11,"PIETROASELE",,5,,669,351
10,"Buzău",109,"109-PARSCOV",48557,261,2,2578,1694,1371,323,1677,17,"PARSCOV",,5,,1069,608
10,"Buzău",109,"109-PARSCOV",48557,262,2,577,435,314,121,431,4,"PARSCOV",,5,,333,98
10,"Buzău",109,"109-PARSCOV",48557,263,2,1015,812,633,179,806,6,"PARSCOV",,5,,603,203
10,"Buzău",109,"109-PARSCOV",48557,264,2,555,432,339,93,424,8,"PARSCOV",,5,,324,100
10,"Buzău",109,"109-PARSCOV",48557,265,2,116,107,47,60,106,1,"PARSCOV",,5,,74,32
10,"Buzău",109,"109-PODGORIA",48682,266,2,1160,801,645,156,792,9,"PODGORIA",,5,,467,325
10,"Buzău",109,"109-PODGORIA",48682,267,2,1169,821,709,112,804,17,"PODGORIA",,5,,506,298
10,"Buzău",109,"109-PODGORIA",48682,268,2,400,284,208,76,281,3,"PODGORIA",,5,,147,134
10,"Buzău",109,"109-POSTA CALNAU",48771,269,2,1608,1108,1023,85,1103,5,"POSTA CALNAU",,5,,747,356
10,"Buzău",109,"109-POSTA CALNAU",48771,270,2,976,608,563,45,603,5,"POSTA CALNAU",,5,,408,195
10,"Buzău",109,"109-POSTA CALNAU",48771,271,2,2121,1528,1384,144,1515,13,"POSTA CALNAU",,5,,962,553
10,"Buzău",109,"109-PUIESTI",48842,272,2,1774,1223,1110,113,1212,11,"PUIESTI",,5,,871,341
10,"Buzău",109,"109-PUIESTI",48842,273,2,1852,1269,1183,86,1252,17,"PUIESTI",,5,,951,301
10,"Buzău",109,"109-PUIESTI",48842,274,2,706,537,462,75,532,5,"PUIESTI",,5,,350,182
10,"Buzău",109,"109-RACOVITENI",48922,275,2,1276,873,779,94,861,12,"RACOVITENI",,5,,643,218
10,"Buzău",109,"109-RAMNICELU",48968,276,2,2000,1157,1025,132,1136,21,"RAMNICELU",,5,,750,386
10,"Buzău",109,"109-RAMNICELU",48968,277,2,527,461,367,94,454,7,"RAMNICELU",,5,,349,105
10,"Buzău",109,"109-RAMNICELU",48968,278,2,478,361,285,76,359,2,"RAMNICELU",,5,,283,76
10,"Buzău",109,"109-ROBEASCA",49019,279,2,665,580,530,50,576,4,"ROBEASCA",,5,,451,125
10,"Buzău",109,"109-ROBEASCA",49019,280,2,437,398,337,61,397,1,"ROBEASCA",,5,,323,74
10,"Buzău",109,"109-RUSETU",49046,281,2,1223,1009,929,80,999,10,"RUSETU",,5,,796,203
10,"Buzău",109,"109-RUSETU",49046,282,2,1088,872,812,60,859,13,"RUSETU",,5,,620,239
10,"Buzău",109,"109-RUSETU",49046,283,2,1100,1024,950,74,1019,5,"RUSETU",,5,,750,269
10,"Buzău",109,"109-RUSETU",49046,284,2,262,272,256,16,271,1,"RUSETU",,5,,251,20
10,"Buzău",109,"109-SAGEATA",49073,285,2,956,800,701,99,786,14,"SAGEATA",,5,,563,223
10,"Buzău",109,"109-SAGEATA",49073,286,2,2075,1515,1326,189,1493,22,"SAGEATA",,5,,1156,337
10,"Buzău",109,"109-SAGEATA",49073,287,2,1477,1025,901,124,1021,4,"SAGEATA",,5,,778,243
10,"Buzău",109,"109-SAHATENI",49153,288,2,1497,1096,951,145,1088,8,"SAHATENI",,5,,769,319
10,"Buzău",109,"109-SAHATENI",49153,289,2,819,506,427,79,500,6,"SAHATENI",,5,,381,119
10,"Buzău",109,"109-SAHATENI",49153,290,2,365,289,247,42,288,1,"SAHATENI",,5,,207,81
10,"Buzău",109,"109-SAPOCA",49206,291,2,1303,1064,774,290,1050,14,"SAPOCA",,5,,744,306
10,"Buzău",109,"109-SAPOCA",49206,292,2,1099,765,672,93,757,8,"SAPOCA",,5,,538,219
10,"Buzău",109,"109-SARULESTI",49233,293,2,1375,899,800,99,883,16,"SARULESTI",,5,,754,129
10,"Buzău",109,"109-SCORTOASA",49313,294,2,1321,1066,932,134,1058,8,"SCORTOASA",,5,,753,305
10,"Buzău",109,"109-SCORTOASA",49313,295,2,291,286,202,84,283,3,"SCORTOASA",,5,,190,93
10,"Buzău",109,"109-SCORTOASA",49313,296,2,560,580,505,75,551,29,"SCORTOASA",,5,,507,44
10,"Buzău",109,"109-SCORTOASA",49313,297,2,370,312,262,50,305,7,"SCORTOASA",,5,,280,25
10,"Buzău",109,"109-SCORTOASA",49313,298,2,333,272,233,39,269,3,"SCORTOASA",,5,,234,35
10,"Buzău",109,"109-SCUTELNICI",49439,299,2,1020,797,664,133,794,3,"SCUTELNICI",,5,,487,307
10,"Buzău",109,"109-SCUTELNICI",49439,300,2,378,365,301,64,362,3,"SCUTELNICI",,5,,304,58
10,"Buzău",109,"109-SCUTELNICI",49439,301,2,601,533,452,81,530,3,"SCUTELNICI",,5,,343,187
10,"Buzău",109,"109-SIRIU",49484,302,2,2250,1860,1543,317,1846,14,"SIRIU",,5,,1198,648
10,"Buzău",109,"109-SMEENI",49545,303,2,2013,1495,1318,177,1471,24,"SMEENI",,5,,996,475
10,"Buzău",109,"109-SMEENI",49545,304,2,871,643,578,65,640,3,"SMEENI",,5,,454,186
10,"Buzău",109,"109-SMEENI",49545,305,2,676,666,597,69,645,21,"SMEENI",,5,,509,136
10,"Buzău",109,"109-SMEENI",49545,306,2,898,617,504,113,608,9,"SMEENI",,5,,451,157
10,"Buzău",109,"109-SMEENI",49545,307,2,603,466,380,86,459,7,"SMEENI",,5,,268,191
10,"Buzău",109,"109-STALPU",49625,308,2,1338,909,825,84,906,3,"STALPU",,5,,573,333
10,"Buzău",109,"109-STALPU",49625,309,2,1133,806,725,81,798,8,"STALPU",,5,,489,309
10,"Buzău",109,"109-TISAU",49643,310,2,1515,974,716,258,957,17,"TISAU",,5,,539,418
10,"Buzău",109,"109-TISAU",49643,311,2,1289,866,625,241,856,10,"TISAU",,5,,497,359
10,"Buzău",109,"109-TISAU",49643,312,2,1270,715,555,160,710,5,"TISAU",,5,,416,294
10,"Buzău",109,"109-TOPLICENI",49769,313,2,1454,974,831,143,962,12,"TOPLICENI",,5,,639,323
10,"Buzău",109,"109-TOPLICENI",49769,314,2,868,646,528,118,635,11,"TOPLICENI",,5,,414,221
10,"Buzău",109,"109-TOPLICENI",49769,315,2,969,789,659,130,780,9,"TOPLICENI",,5,,526,254
10,"Buzău",109,"109-TINTESTI",49849,316,2,1604,1195,979,216,1189,6,"TINTESTI",,5,,831,358
10,"Buzău",109,"109-TINTESTI",49849,317,2,1596,1212,999,213,1205,7,"TINTESTI",,5,,977,228
10,"Buzău",109,"109-ULMENI",49894,318,2,1264,919,789,130,906,13,"ULMENI",,5,,530,376
10,"Buzău",109,"109-ULMENI",49894,319,2,1350,1024,900,124,1014,10,"ULMENI",,5,,643,371
10,"Buzău",109,"109-VADU PASII",49956,320,2,1921,1547,1330,217,1536,11,"VADU PASII",,5,,997,539
10,"Buzău",109,"109-VADU PASII",49956,321,2,1131,872,827,45,862,10,"VADU PASII",,5,,617,245
10,"Buzău",109,"109-VADU PASII",49956,322,2,1837,1294,1245,49,1286,8,"VADU PASII",,5,,986,300
10,"Buzău",109,"109-VADU PASII",49956,323,2,1094,893,779,114,886,7,"VADU PASII",,5,,675,211
10,"Buzău",109,"109-VALEA RAMNICULUI",50022,324,2,1538,1149,988,161,1139,10,"VALEA RAMNICULUI",,5,,740,399
10,"Buzău",109,"109-VALEA RAMNICULUI",50022,325,2,1922,1415,1231,184,1397,18,"VALEA RAMNICULUI",,5,,926,471
10,"Buzău",109,"109-VALEA RAMNICULUI",50022,326,2,961,796,647,149,791,5,"VALEA RAMNICULUI",,5,,574,217
10,"Buzău",109,"109-VALEA SALCIEI",50068,327,2,805,571,537,34,561,10,"VALEA SALCIEI",,5,,399,162
10,"Buzău",109,"109-VERNESTI",50102,328,2,1490,1031,793,238,1026,5,"VERNESTI",,5,,614,412
10,"Buzău",109,"109-VERNESTI",50102,329,2,1895,1415,1059,356,1392,23,"VERNESTI",,5,,964,428
10,"Buzău",109,"109-VERNESTI",50102,330,2,1650,891,651,240,875,16,"VERNESTI",,5,,548,327
10,"Buzău",109,"109-VERNESTI",50102,331,2,986,743,561,182,733,10,"VERNESTI",,5,,518,215
10,"Buzău",109,"109-VERNESTI",50102,332,2,108,129,105,24,129,0,"VERNESTI",,5,,67,62
10,"Buzău",109,"109-VINTILA VODA",50228,333,2,1383,955,836,119,938,17,"VINTILA VODA",,5,,713,225
10,"Buzău",109,"109-VINTILA VODA",50228,334,2,1084,744,648,96,743,1,"VINTILA VODA",,5,,588,155
10,"Buzău",109,"109-VINTILA VODA",50228,335,2,345,178,138,40,177,1,"VINTILA VODA",,5,,80,97
10,"Buzău",109,"109-VIPERESTI",50326,336,2,1431,924,784,140,914,10,"VIPERESTI",,5,,519,395
10,"Buzău",109,"109-VIPERESTI",50326,337,2,1017,689,547,142,685,4,"VIPERESTI",,5,,457,228
10,"Buzău",109,"109-VIPERESTI",50326,338,2,252,178,124,54,176,2,"VIPERESTI",,5,,150,26
10,"Buzău",109,"109-VALCELELE",50399,339,2,1711,1261,1127,134,1240,21,"VALCELELE",,5,,912,328
10,"Buzău",109,"109-ZARNESTI",50415,340,2,1838,1130,1014,116,1120,10,"ZARNESTI",,5,,819,301
10,"Buzău",109,"109-ZARNESTI",50415,341,2,404,323,284,39,320,3,"ZARNESTI",,5,,243,77
10,"Buzău",109,"109-ZARNESTI",50415,342,2,1142,751,673,78,740,11,"ZARNESTI",,5,,568,172
10,"Buzău",109,"109-ZARNESTI",50415,343,2,972,667,598,69,662,5,"ZARNESTI",,5,,472,190
10,"Buzău",109,"109-ZIDURI",50479,344,2,743,677,585,92,674,3,"ZIDURI",,5,,461,213
10,"Buzău",109,"109-ZIDURI",50479,345,2,736,770,718,52,765,5,"ZIDURI",,5,,637,128
10,"Buzău",109,"109-ZIDURI",50479,346,2,880,724,647,77,717,7,"ZIDURI",,5,,559,158
10,"Buzău",109,"109-ZIDURI",50479,347,2,847,682,602,80,678,4,"ZIDURI",,5,,490,188
10,"Buzău",109,"109-ZIDURI",50479,348,2,703,563,535,28,557,6,"ZIDURI",,5,,408,149
11,"Caraș-Severin",118,"118-MUNICIPIUL RESITA",50790,1,2,290,257,203,54,256,1,"MUNICIPIUL RESITA",,1,,123,133
11,"Caraș-Severin",118,"118-MUNICIPIUL RESITA",50790,2,2,398,310,255,55,304,6,"MUNICIPIUL RESITA",,1,,84,220
11,"Caraș-Severin",118,"118-MUNICIPIUL RESITA",50790,3,2,1053,784,708,76,780,4,"MUNICIPIUL RESITA",,1,,266,514
11,"Caraș-Severin",118,"118-MUNICIPIUL RESITA",50790,4,2,0,149,0,149,147,2,"MUNICIPIUL RESITA",,1,,60,87
11,"Caraș-Severin",118,"118-MUNICIPIUL RESITA",50790,5,2,517,400,349,51,400,0,"MUNICIPIUL RESITA",,1,,84,316
11,"Caraș-Severin",118,"118-MUNICIPIUL RESITA",50790,6,2,973,667,589,78,663,4,"MUNICIPIUL RESITA",,1,,174,489
11,"Caraș-Severin",118,"118-MUNICIPIUL RESITA",50790,7,2,595,448,390,58,448,0,"MUNICIPIUL RESITA",,1,,128,320
11,"Caraș-Severin",118,"118-MUNICIPIUL RESITA",50790,8,2,987,729,651,78,726,3,"MUNICIPIUL RESITA",,1,,194,532
11,"Caraș-Severin",118,"118-MUNICIPIUL RESITA",50790,9,2,1300,910,806,104,904,6,"MUNICIPIUL RESITA",,1,,243,661
11,"Caraș-Severin",118,"118-MUNICIPIUL RESITA",50790,10,2,1285,871,756,115,869,2,"MUNICIPIUL RESITA",,1,,184,685
11,"Caraș-Severin",118,"118-MUNICIPIUL RESITA",50790,11,2,949,650,535,115,649,1,"MUNICIPIUL RESITA",,1,,137,512
11,"Caraș-Severin",118,"118-MUNICIPIUL RESITA",50790,12,2,938,680,589,91,676,4,"MUNICIPIUL RESITA",,1,,199,477
11,"Caraș-Severin",118,"118-MUNICIPIUL RESITA",50790,13,2,1230,905,834,71,897,8,"MUNICIPIUL RESITA",,1,,273,624
11,"Caraș-Severin",118,"118-MUNICIPIUL RESITA",50790,14,2,1070,800,738,62,798,2,"MUNICIPIUL RESITA",,1,,240,558
11,"Caraș-Severin",118,"118-MUNICIPIUL RESITA",50790,15,2,0,101,0,101,101,0,"MUNICIPIUL RESITA",,1,,40,61
11,"Caraș-Severin",118,"118-MUNICIPIUL RESITA",50790,16,2,467,415,295,120,412,3,"MUNICIPIUL RESITA",,1,,87,325
11,"Caraș-Severin",118,"118-MUNICIPIUL RESITA",50790,17,2,1004,799,709,90,792,7,"MUNICIPIUL RESITA",,1,,260,532
11,"Caraș-Severin",118,"118-MUNICIPIUL RESITA",50790,18,2,1376,1166,959,207,1163,3,"MUNICIPIUL RESITA",,1,,341,822
11,"Caraș-Severin",118,"118-MUNICIPIUL RESITA",50790,19,2,1144,845,711,134,842,3,"MUNICIPIUL RESITA",,1,,187,655
11,"Caraș-Severin",118,"118-MUNICIPIUL RESITA",50790,20,2,596,477,406,71,474,3,"MUNICIPIUL RESITA",,1,,152,322
11,"Caraș-Severin",118,"118-MUNICIPIUL RESITA",50790,21,2,1026,805,711,94,802,3,"MUNICIPIUL RESITA",,1,,255,547
11,"Caraș-Severin",118,"118-MUNICIPIUL RESITA",50790,22,2,0,159,0,159,157,2,"MUNICIPIUL RESITA",,1,,59,98
11,"Caraș-Severin",118,"118-MUNICIPIUL RESITA",50790,23,2,678,578,481,97,578,0,"MUNICIPIUL RESITA",,1,,237,341
11,"Caraș-Severin",118,"118-MUNICIPIUL RESITA",50790,24,2,1336,950,901,49,948,2,"MUNICIPIUL RESITA",,1,,346,602
11,"Caraș-Severin",118,"118-MUNICIPIUL RESITA",50790,25,2,1229,892,848,44,888,4,"MUNICIPIUL RESITA",,1,,336,552
11,"Caraș-Severin",118,"118-MUNICIPIUL RESITA",50790,26,2,1056,799,739,60,795,4,"MUNICIPIUL RESITA",,1,,249,546
11,"Caraș-Severin",118,"118-MUNICIPIUL RESITA",50790,27,2,1406,1002,902,100,996,6,"MUNICIPIUL RESITA",,1,,304,692
11,"Caraș-Severin",118,"118-MUNICIPIUL RESITA",50790,28,2,876,666,600,66,663,3,"MUNICIPIUL RESITA",,1,,309,354
11,"Caraș-Severin",118,"118-MUNICIPIUL RESITA",50790,29,2,1078,875,815,60,873,2,"MUNICIPIUL RESITA",,1,,349,524
11,"Caraș-Severin",118,"118-MUNICIPIUL RESITA",50790,30,2,916,672,614,58,669,3,"MUNICIPIUL RESITA",,1,,230,439
11,"Caraș-Severin",118,"118-MUNICIPIUL RESITA",50790,31,2,1033,782,654,128,775,7,"MUNICIPIUL RESITA",,1,,306,469
11,"Caraș-Severin",118,"118-MUNICIPIUL RESITA",50790,32,2,1333,965,904,61,958,7,"MUNICIPIUL RESITA",,1,,332,626
11,"Caraș-Severin",118,"118-MUNICIPIUL RESITA",50790,33,2,785,574,481,93,572,2,"MUNICIPIUL RESITA",,1,,220,352
11,"Caraș-Severin",118,"118-MUNICIPIUL RESITA",50790,34,2,1006,740,637,103,740,0,"MUNICIPIUL RESITA",,1,,247,493
11,"Caraș-Severin",118,"118-MUNICIPIUL RESITA",50790,35,2,535,539,360,179,532,7,"MUNICIPIUL RESITA",,1,,137,395
11,"Caraș-Severin",118,"118-MUNICIPIUL RESITA",50790,36,2,1129,779,571,208,777,2,"MUNICIPIUL RESITA",,1,,184,593
11,"Caraș-Severin",118,"118-MUNICIPIUL RESITA",50790,37,2,408,342,270,72,340,2,"MUNICIPIUL RESITA",,1,,115,225
11,"Caraș-Severin",118,"118-MUNICIPIUL RESITA",50790,38,2,1544,1597,792,805,1593,4,"MUNICIPIUL RESITA",,1,,342,1251
11,"Caraș-Severin",118,"118-MUNICIPIUL RESITA",50790,39,2,1293,865,762,103,858,7,"MUNICIPIUL RESITA",,1,,362,496
11,"Caraș-Severin",118,"118-MUNICIPIUL RESITA",50790,40,2,1625,1109,973,136,1103,6,"MUNICIPIUL RESITA",,1,,330,773
11,"Caraș-Severin",118,"118-MUNICIPIUL RESITA",50790,41,2,1323,923,862,61,922,1,"MUNICIPIUL RESITA",,1,,279,643
11,"Caraș-Severin",118,"118-MUNICIPIUL RESITA",50790,42,2,1257,862,775,87,859,3,"MUNICIPIUL RESITA",,1,,319,540
11,"Caraș-Severin",118,"118-MUNICIPIUL RESITA",50790,43,2,1206,822,748,74,820,2,"MUNICIPIUL RESITA",,1,,232,588
11,"Caraș-Severin",118,"118-MUNICIPIUL RESITA",50790,44,2,1132,780,731,49,776,4,"MUNICIPIUL RESITA",,1,,237,539
11,"Caraș-Severin",118,"118-MUNICIPIUL RESITA",50790,45,2,1286,946,876,70,941,5,"MUNICIPIUL RESITA",,1,,348,593
11,"Caraș-Severin",118,"118-MUNICIPIUL RESITA",50790,46,2,1068,753,676,77,748,5,"MUNICIPIUL RESITA",,1,,238,510
11,"Caraș-Severin",118,"118-MUNICIPIUL RESITA",50790,47,2,0,335,0,335,333,2,"MUNICIPIUL RESITA",,1,,115,218
11,"Caraș-Severin",118,"118-MUNICIPIUL RESITA",50790,48,2,1474,958,884,74,954,4,"MUNICIPIUL RESITA",,1,,337,617
11,"Caraș-Severin",118,"118-MUNICIPIUL RESITA",50790,49,2,1266,865,781,84,860,5,"MUNICIPIUL RESITA",,1,,281,579
11,"Caraș-Severin",118,"118-MUNICIPIUL RESITA",50790,50,2,1534,1076,997,79,1069,7,"MUNICIPIUL RESITA",,1,,393,676
11,"Caraș-Severin",118,"118-MUNICIPIUL RESITA",50790,51,2,1296,918,859,59,916,2,"MUNICIPIUL RESITA",,1,,317,599
11,"Caraș-Severin",118,"118-MUNICIPIUL RESITA",50790,52,2,1277,911,854,57,908,3,"MUNICIPIUL RESITA",,1,,308,600
11,"Caraș-Severin",118,"118-MUNICIPIUL RESITA",50790,53,2,1092,807,684,123,802,5,"MUNICIPIUL RESITA",,1,,266,536
11,"Caraș-Severin",118,"118-MUNICIPIUL RESITA",50790,54,2,1474,993,934,59,988,5,"MUNICIPIUL RESITA",,1,,318,670
11,"Caraș-Severin",118,"118-MUNICIPIUL RESITA",50790,55,2,1263,862,803,59,855,7,"MUNICIPIUL RESITA",,1,,303,552
11,"Caraș-Severin",118,"118-MUNICIPIUL RESITA",50790,56,2,1627,1125,1046,79,1119,6,"MUNICIPIUL RESITA",,1,,326,793
11,"Caraș-Severin",118,"118-MUNICIPIUL RESITA",50790,57,2,1214,850,782,68,844,6,"MUNICIPIUL RESITA",,1,,279,565
11,"Caraș-Severin",118,"118-MUNICIPIUL RESITA",50790,58,2,1284,861,790,71,861,0,"MUNICIPIUL RESITA",,1,,273,588
11,"Caraș-Severin",118,"118-MUNICIPIUL RESITA",50790,59,2,1600,1062,990,72,1056,6,"MUNICIPIUL RESITA",,1,,298,758
11,"Caraș-Severin",118,"118-MUNICIPIUL RESITA",50790,60,2,1338,912,822,90,911,1,"MUNICIPIUL RESITA",,1,,261,650
11,"Caraș-Severin",118,"118-MUNICIPIUL RESITA",50790,61,2,1540,989,900,89,985,4,"MUNICIPIUL RESITA",,1,,315,670
11,"Caraș-Severin",118,"118-MUNICIPIUL RESITA",50790,62,2,1014,681,612,69,679,2,"MUNICIPIUL RESITA",,1,,184,495
11,"Caraș-Severin",118,"118-MUNICIPIUL RESITA",50790,63,2,1293,873,807,66,873,0,"MUNICIPIUL RESITA",,1,,212,661
11,"Caraș-Severin",118,"118-MUNICIPIUL RESITA",50790,64,2,1507,1036,982,54,1035,1,"MUNICIPIUL RESITA",,1,,318,717
11,"Caraș-Severin",118,"118-MUNICIPIUL RESITA",50790,65,2,1260,870,816,54,868,2,"MUNICIPIUL RESITA",,1,,260,608
11,"Caraș-Severin",118,"118-MUNICIPIUL RESITA",50790,66,2,1283,914,849,65,912,2,"MUNICIPIUL RESITA",,1,,236,676
11,"Caraș-Severin",118,"118-MUNICIPIUL RESITA",50790,67,2,1417,1055,941,114,1053,2,"MUNICIPIUL RESITA",,1,,271,782
11,"Caraș-Severin",118,"118-MUNICIPIUL RESITA",50790,68,2,1299,836,769,67,831,5,"MUNICIPIUL RESITA",,1,,248,583
11,"Caraș-Severin",118,"118-MUNICIPIUL RESITA",50790,69,2,1043,732,681,51,729,3,"MUNICIPIUL RESITA",,1,,212,517
11,"Caraș-Severin",118,"118-MUNICIPIUL RESITA",50790,70,2,1262,1083,944,139,1080,3,"MUNICIPIUL RESITA",,1,,278,802
11,"Caraș-Severin",118,"118-MUNICIPIUL RESITA",50790,71,2,260,288,212,76,288,0,"MUNICIPIUL RESITA",,1,,81,207
11,"Caraș-Severin",118,"118-MUNICIPIUL RESITA",50790,72,2,0,373,0,373,366,7,"MUNICIPIUL RESITA",,1,,130,236
11,"Caraș-Severin",118,"118-MUNICIPIUL CARANSEBES",51010,73,2,451,735,306,429,732,3,"MUNICIPIUL CARANSEBES",,1,,260,472
11,"Caraș-Severin",118,"118-MUNICIPIUL CARANSEBES",51010,74,2,355,294,272,22,290,4,"MUNICIPIUL CARANSEBES",,1,,101,189
11,"Caraș-Severin",118,"118-MUNICIPIUL CARANSEBES",51010,75,2,349,321,255,66,320,1,"MUNICIPIUL CARANSEBES",,1,,109,211
11,"Caraș-Severin",118,"118-MUNICIPIUL CARANSEBES",51010,76,2,1547,1224,1079,145,1220,4,"MUNICIPIUL CARANSEBES",,1,,476,744
11,"Caraș-Severin",118,"118-MUNICIPIUL CARANSEBES",51010,77,2,1301,1168,1128,40,1162,6,"MUNICIPIUL CARANSEBES",,1,,532,630
11,"Caraș-Severin",118,"118-MUNICIPIUL CARANSEBES",51010,78,2,1017,805,713,92,803,2,"MUNICIPIUL CARANSEBES",,1,,318,485
11,"Caraș-Severin",118,"118-MUNICIPIUL CARANSEBES",51010,79,2,820,788,595,193,784,4,"MUNICIPIUL CARANSEBES",,1,,336,448
11,"Caraș-Severin",118,"118-MUNICIPIUL CARANSEBES",51010,80,2,1413,1039,1011,28,1038,1,"MUNICIPIUL CARANSEBES",,1,,388,650
11,"Caraș-Severin",118,"118-MUNICIPIUL CARANSEBES",51010,81,2,1174,947,783,164,945,2,"MUNICIPIUL CARANSEBES",,1,,359,586
11,"Caraș-Severin",118,"118-MUNICIPIUL CARANSEBES",51010,82,2,1509,1217,936,281,1214,3,"MUNICIPIUL CARANSEBES",,1,,437,777
11,"Caraș-Severin",118,"118-MUNICIPIUL CARANSEBES",51010,83,2,1355,1001,886,115,994,7,"MUNICIPIUL CARANSEBES",,1,,379,615
11,"Caraș-Severin",118,"118-MUNICIPIUL CARANSEBES",51010,84,2,1999,1385,1162,223,1379,6,"MUNICIPIUL CARANSEBES",,1,,441,938
11,"Caraș-Severin",118,"118-MUNICIPIUL CARANSEBES",51010,85,2,1945,1357,1162,195,1350,7,"MUNICIPIUL CARANSEBES",,1,,405,945
11,"Caraș-Severin",118,"118-MUNICIPIUL CARANSEBES",51010,86,2,2088,1349,1288,61,1344,5,"MUNICIPIUL CARANSEBES",,1,,464,880
11,"Caraș-Severin",118,"118-MUNICIPIUL CARANSEBES",51010,87,2,1858,1156,1042,114,1148,8,"MUNICIPIUL CARANSEBES",,1,,411,737
11,"Caraș-Severin",118,"118-MUNICIPIUL CARANSEBES",51010,88,2,870,745,667,78,735,10,"MUNICIPIUL CARANSEBES",,1,,278,457
11,"Caraș-Severin",118,"118-MUNICIPIUL CARANSEBES",51010,89,2,1590,1069,1004,65,1062,7,"MUNICIPIUL CARANSEBES",,1,,497,565
11,"Caraș-Severin",118,"118-MUNICIPIUL CARANSEBES",51010,90,2,392,389,321,68,386,3,"MUNICIPIUL CARANSEBES",,1,,154,232
11,"Caraș-Severin",118,"118-MUNICIPIUL CARANSEBES",51010,91,2,238,485,185,300,480,5,"MUNICIPIUL CARANSEBES",,1,,175,305
11,"Caraș-Severin",118,"118-MUNICIPIUL CARANSEBES",51010,92,2,699,703,680,23,689,14,"MUNICIPIUL CARANSEBES",,1,,353,336
11,"Caraș-Severin",118,"118-ORAS ANINA",50889,93,2,1822,1537,1175,362,1526,11,"ORAS ANINA",,1,,687,839
11,"Caraș-Severin",118,"118-ORAS ANINA",50889,94,2,887,863,608,255,857,6,"ORAS ANINA",,1,,274,583
11,"Caraș-Severin",118,"118-ORAS ANINA",50889,95,2,270,378,194,184,375,3,"ORAS ANINA",,1,,114,261
11,"Caraș-Severin",118,"118-ORAS ANINA",50889,96,2,1250,1072,805,267,1064,8,"ORAS ANINA",,1,,424,640
11,"Caraș-Severin",118,"118-ORAS ANINA",50889,97,2,1326,1207,944,263,1198,9,"ORAS ANINA",,1,,407,791
11,"Caraș-Severin",118,"118-ORAS ANINA",50889,98,2,220,205,152,53,205,0,"ORAS ANINA",,1,,115,90
11,"Caraș-Severin",118,"118-ORAS ANINA",50889,99,2,0,168,0,168,166,2,"ORAS ANINA",,1,,36,130
11,"Caraș-Severin",118,"118-ORAS ANINA",50889,100,2,43,54,34,20,54,0,"ORAS ANINA",,1,,9,45
11,"Caraș-Severin",118,"118-ORAS BAILE HERCULANE",50923,101,2,410,771,244,527,761,10,"ORAS BAILE HERCULANE",,1,,352,409
11,"Caraș-Severin",118,"118-ORAS BAILE HERCULANE",50923,102,2,1287,1549,688,861,1543,6,"ORAS BAILE HERCULANE",,1,,712,831
11,"Caraș-Severin",118,"118-ORAS BAILE HERCULANE",50923,103,2,2285,1707,1260,447,1700,7,"ORAS BAILE HERCULANE",,1,,615,1085
11,"Caraș-Severin",118,"118-ORAS BAILE HERCULANE",50923,104,2,500,416,331,85,411,5,"ORAS BAILE HERCULANE",,1,,161,250
11,"Caraș-Severin",118,"118-ORAS BOCSA",50969,105,2,1197,985,845,140,980,5,"ORAS BOCSA",,1,,323,657
11,"Caraș-Severin",118,"118-ORAS BOCSA",50969,106,2,1068,874,790,84,852,22,"ORAS BOCSA",,1,,284,568
11,"Caraș-Severin",118,"118-ORAS BOCSA",50969,107,2,936,789,702,87,781,8,"ORAS BOCSA",,1,,151,630
11,"Caraș-Severin",118,"118-ORAS BOCSA",50969,108,2,1078,884,798,86,880,4,"ORAS BOCSA",,1,,330,550
11,"Caraș-Severin",118,"118-ORAS BOCSA",50969,109,2,778,635,529,106,631,4,"ORAS BOCSA",,1,,206,425
11,"Caraș-Severin",118,"118-ORAS BOCSA",50969,110,2,1037,940,740,200,934,6,"ORAS BOCSA",,1,,256,678
11,"Caraș-Severin",118,"118-ORAS BOCSA",50969,111,2,1320,832,726,106,826,6,"ORAS BOCSA",,1,,250,576
11,"Caraș-Severin",118,"118-ORAS BOCSA",50969,112,2,862,642,568,74,634,8,"ORAS BOCSA",,1,,184,450
11,"Caraș-Severin",118,"118-ORAS BOCSA",50969,113,2,1350,1017,916,101,1008,9,"ORAS BOCSA",,1,,297,711
11,"Caraș-Severin",118,"118-ORAS BOCSA",50969,114,2,1205,981,856,125,977,4,"ORAS BOCSA",,1,,347,630
11,"Caraș-Severin",118,"118-ORAS BOCSA",50969,115,2,1119,912,808,104,906,6,"ORAS BOCSA",,1,,312,594
11,"Caraș-Severin",118,"118-ORAS BOCSA",50969,116,2,1104,870,806,64,865,5,"ORAS BOCSA",,1,,318,547
11,"Caraș-Severin",118,"118-ORAS MOLDOVA NOUA",51056,117,2,1062,979,806,173,974,5,"ORAS MOLDOVA NOUA",,1,,577,397
11,"Caraș-Severin",118,"118-ORAS MOLDOVA NOUA",51056,118,2,832,794,675,119,786,8,"ORAS MOLDOVA NOUA",,1,,516,270
11,"Caraș-Severin",118,"118-ORAS MOLDOVA NOUA",51056,119,2,540,504,437,67,501,3,"ORAS MOLDOVA NOUA",,1,,337,164
11,"Caraș-Severin",118,"118-ORAS MOLDOVA NOUA",51056,120,2,255,267,216,51,266,1,"ORAS MOLDOVA NOUA",,1,,224,42
11,"Caraș-Severin",118,"118-ORAS MOLDOVA NOUA",51056,121,2,522,401,352,49,398,3,"ORAS MOLDOVA NOUA",,1,,283,115
11,"Caraș-Severin",118,"118-ORAS MOLDOVA NOUA",51056,122,2,1240,1014,878,136,1009,5,"ORAS MOLDOVA NOUA",,1,,602,407
11,"Caraș-Severin",118,"118-ORAS MOLDOVA NOUA",51056,123,2,2173,1545,1381,164,1538,7,"ORAS MOLDOVA NOUA",,1,,893,645
11,"Caraș-Severin",118,"118-ORAS MOLDOVA NOUA",51056,124,2,2047,1609,1341,268,1596,13,"ORAS MOLDOVA NOUA",,1,,944,652
11,"Caraș-Severin",118,"118-ORAS MOLDOVA NOUA",51056,125,2,1387,1335,926,409,1327,8,"ORAS MOLDOVA NOUA",,1,,706,621
11,"Caraș-Severin",118,"118-ORAS ORAVITA",51118,126,2,72,228,43,185,225,3,"ORAS ORAVITA",,1,,70,155
11,"Caraș-Severin",118,"118-ORAS ORAVITA",51118,127,2,1230,844,729,115,837,7,"ORAS ORAVITA",,1,,339,498
11,"Caraș-Severin",118,"118-ORAS ORAVITA",51118,128,2,1271,880,795,85,874,6,"ORAS ORAVITA",,1,,321,553
11,"Caraș-Severin",118,"118-ORAS ORAVITA",51118,129,2,1004,688,611,77,683,5,"ORAS ORAVITA",,1,,206,477
11,"Caraș-Severin",118,"118-ORAS ORAVITA",51118,130,2,1103,867,659,208,862,5,"ORAS ORAVITA",,1,,287,575
11,"Caraș-Severin",118,"118-ORAS ORAVITA",51118,131,2,2165,1140,842,298,1134,6,"ORAS ORAVITA",,1,,449,685
11,"Caraș-Severin",118,"118-ORAS ORAVITA",51118,132,2,2201,1193,808,385,1189,4,"ORAS ORAVITA",,1,,405,784
11,"Caraș-Severin",118,"118-ORAS ORAVITA",51118,133,2,1080,930,416,514,927,3,"ORAS ORAVITA",,1,,262,665
11,"Caraș-Severin",118,"118-ORAS ORAVITA",51118,134,2,574,403,328,75,399,4,"ORAS ORAVITA",,1,,129,270
11,"Caraș-Severin",118,"118-ORAS ORAVITA",51118,135,2,472,414,316,98,413,1,"ORAS ORAVITA",,1,,97,316
11,"Caraș-Severin",118,"118-ORAS ORAVITA",51118,136,2,290,283,194,89,281,2,"ORAS ORAVITA",,1,,81,200
11,"Caraș-Severin",118,"118-ORAS ORAVITA",51118,137,2,448,366,277,89,360,6,"ORAS ORAVITA",,1,,130,230
11,"Caraș-Severin",118,"118-ORAS ORAVITA",51118,138,2,200,222,158,64,220,2,"ORAS ORAVITA",,1,,42,178
11,"Caraș-Severin",118,"118-ORAS OTELUL ROSU",51207,139,2,2065,1466,1348,118,1457,9,"ORAS OTELUL ROSU",,1,,484,973
11,"Caraș-Severin",118,"118-ORAS OTELUL ROSU",51207,140,2,1439,988,899,89,984,4,"ORAS OTELUL ROSU",,1,,329,655
11,"Caraș-Severin",118,"118-ORAS OTELUL ROSU",51207,141,2,2819,2006,1768,238,1997,9,"ORAS OTELUL ROSU",,1,,713,1284
11,"Caraș-Severin",118,"118-ORAS OTELUL ROSU",51207,142,2,2654,2043,1859,184,2031,12,"ORAS OTELUL ROSU",,1,,642,1389
11,"Caraș-Severin",118,"118-ORAS OTELUL ROSU",51207,143,2,648,525,458,67,523,2,"ORAS OTELUL ROSU",,1,,143,380
11,"Caraș-Severin",118,"118-ORAS OTELUL ROSU",51207,144,2,290,272,234,38,270,2,"ORAS OTELUL ROSU",,1,,123,147
11,"Caraș-Severin",118,"118-ARMENIS",51243,145,2,1390,970,884,86,953,17,"ARMENIS",,1,,332,621
11,"Caraș-Severin",118,"118-ARMENIS",51243,146,2,495,487,406,81,487,0,"ARMENIS",,1,,227,260
11,"Caraș-Severin",118,"118-ARMENIS",51243,147,2,414,274,251,23,271,3,"ARMENIS",,1,,89,182
11,"Caraș-Severin",118,"118-BANIA",51305,148,2,1048,851,798,53,845,6,"BANIA",,1,,365,480
11,"Caraș-Severin",118,"118-BANIA",51305,149,2,494,433,343,90,427,6,"BANIA",,1,,193,234
11,"Caraș-Severin",118,"118-BAUTAR",51332,150,2,751,616,577,39,615,1,"BAUTAR",,1,,334,281
11,"Caraș-Severin",118,"118-BAUTAR",51332,151,2,728,559,530,29,554,5,"BAUTAR",,1,,314,240
11,"Caraș-Severin",118,"118-BAUTAR",51332,152,2,795,585,531,54,574,11,"BAUTAR",,1,,276,298
11,"Caraș-Severin",118,"118-BERLISTE",51387,153,2,307,292,231,61,290,2,"BERLISTE",,1,,173,117
11,"Caraș-Severin",118,"118-BERLISTE",51387,154,2,236,279,210,69,279,0,"BERLISTE",,1,,125,154
11,"Caraș-Severin",118,"118-BERLISTE",51387,155,2,273,287,202,85,287,0,"BERLISTE",,1,,114,173
11,"Caraș-Severin",118,"118-BERLISTE",51387,156,2,126,173,92,81,173,0,"BERLISTE",,1,,73,100
11,"Caraș-Severin",118,"118-BERZASCA",51449,157,2,1188,1057,815,242,1050,7,"BERZASCA",,1,,759,291
11,"Caraș-Severin",118,"118-BERZASCA",51449,158,2,905,708,617,91,697,11,"BERZASCA",,1,,444,253
11,"Caraș-Severin",118,"118-BERZASCA",51449,159,2,222,226,207,19,215,11,"BERZASCA",,1,,135,80
11,"Caraș-Severin",118,"118-BERZASCA",51449,160,2,34,100,29,71,100,0,"BERZASCA",,1,,89,11
11,"Caraș-Severin",118,"118-BERZOVIA",51500,161,2,1509,1187,1036,151,1176,11,"BERZOVIA",,1,,428,748
11,"Caraș-Severin",118,"118-BERZOVIA",51500,162,2,746,640,527,113,636,4,"BERZOVIA",,1,,248,388
11,"Caraș-Severin",118,"118-BERZOVIA",51500,163,2,773,592,520,72,585,7,"BERZOVIA",,1,,159,426
11,"Caraș-Severin",118,"118-BOLVASNITA",51546,164,2,446,282,251,31,279,3,"BOLVASNITA",,1,,51,228
11,"Caraș-Severin",118,"118-BOLVASNITA",51546,165,2,780,463,396,67,458,5,"BOLVASNITA",,1,,106,352
11,"Caraș-Severin",118,"118-BOZOVICI",51573,166,2,1426,1089,858,231,1078,11,"BOZOVICI",,1,,482,596
11,"Caraș-Severin",118,"118-BOZOVICI",51573,167,2,670,672,452,220,669,3,"BOZOVICI",,1,,303,366
11,"Caraș-Severin",118,"118-BOZOVICI",51573,168,2,599,561,434,127,561,0,"BOZOVICI",,1,,169,392
11,"Caraș-Severin",118,"118-BREBU",51626,169,2,582,511,409,102,508,3,"BREBU",,1,,123,385
11,"Caraș-Severin",118,"118-BREBU",51626,170,2,214,240,152,88,238,2,"BREBU",,1,,46,192
11,"Caraș-Severin",118,"118-BREBU",51626,171,2,207,288,142,146,286,2,"BREBU",,1,,105,181
11,"Caraș-Severin",118,"118-BREBU NOU",51662,172,2,71,126,50,76,124,2,"BREBU NOU",,1,,30,94
11,"Caraș-Severin",118,"118-BUCOSNITA",51751,173,2,682,458,405,53,457,1,"BUCOSNITA",,1,,102,355
11,"Caraș-Severin",118,"118-BUCOSNITA",51751,174,2,497,484,432,52,484,0,"BUCOSNITA",,1,,27,457
11,"Caraș-Severin",118,"118-BUCOSNITA",51751,175,2,704,564,517,47,562,2,"BUCOSNITA",,1,,211,351
11,"Caraș-Severin",118,"118-BUCOSNITA",51751,176,2,586,434,383,51,433,1,"BUCOSNITA",,1,,181,252
11,"Caraș-Severin",118,"118-BUCHIN",51699,177,2,1031,733,625,108,724,9,"BUCHIN",,1,,166,558
11,"Caraș-Severin",118,"118-BUCHIN",51699,178,2,532,435,389,46,430,5,"BUCHIN",,1,,238,192
11,"Caraș-Severin",118,"118-CARASOVA",51804,179,2,2008,980,945,35,967,13,"CARASOVA",,1,,228,739
11,"Caraș-Severin",118,"118-CARASOVA",51804,180,2,493,322,311,11,316,6,"CARASOVA",,1,,42,274
11,"Caraș-Severin",118,"118-CARASOVA",51804,181,2,194,171,145,26,168,3,"CARASOVA",,1,,48,120
11,"Caraș-Severin",118,"118-CARBUNARI",51840,182,2,1027,942,840,102,935,7,"CARBUNARI",,1,,746,189
11,"Caraș-Severin",118,"118-CICLOVA ROMANA",51948,183,2,894,834,694,140,825,9,"CICLOVA ROMANA",,1,,272,553
11,"Caraș-Severin",118,"118-CICLOVA ROMANA",51948,184,2,215,312,193,119,304,8,"CICLOVA ROMANA",,1,,98,206
11,"Caraș-Severin",118,"118-CICLOVA ROMANA",51948,185,2,123,196,100,96,196,0,"CICLOVA ROMANA",,1,,107,89
11,"Caraș-Severin",118,"118-CIUCHICI",51984,186,2,463,412,321,91,409,3,"CIUCHICI",,1,,187,222
11,"Caraș-Severin",118,"118-CIUCHICI",51984,187,2,110,158,82,76,157,1,"CIUCHICI",,1,,74,83
11,"Caraș-Severin",118,"118-CIUCHICI",51984,188,2,189,274,154,120,273,1,"CIUCHICI",,1,,102,171
11,"Caraș-Severin",118,"118-CIUCHICI",51984,189,2,118,180,101,79,179,1,"CIUCHICI",,1,,73,106
11,"Caraș-Severin",118,"118-CIUDANOVITA",52035,190,2,528,427,385,42,424,3,"CIUDANOVITA",,1,,167,257
11,"Caraș-Severin",118,"118-CIUDANOVITA",52035,191,2,178,167,151,16,165,2,"CIUDANOVITA",,1,,92,73
11,"Caraș-Severin",118,"118-CONSTANTIN DAICOVICIU",51877,192,2,511,508,396,112,504,4,"CONSTANTIN DAICOVICIU",,1,,216,288
11,"Caraș-Severin",118,"118-CONSTANTIN DAICOVICIU",51877,193,2,349,258,228,30,256,2,"CONSTANTIN DAICOVICIU",,1,,93,163
11,"Caraș-Severin",118,"118-CONSTANTIN DAICOVICIU",51877,194,2,647,534,424,110,531,3,"CONSTANTIN DAICOVICIU",,1,,243,288
11,"Caraș-Severin",118,"118-CONSTANTIN DAICOVICIU",51877,195,2,567,411,365,46,410,1,"CONSTANTIN DAICOVICIU",,1,,179,231
11,"Caraș-Severin",118,"118-COPACELE",52062,196,2,372,273,234,39,270,3,"COPACELE",,1,,172,98
11,"Caraș-Severin",118,"118-COPACELE",52062,197,2,346,226,170,56,223,3,"COPACELE",,1,,81,142
11,"Caraș-Severin",118,"118-COPACELE",52062,198,2,534,332,302,30,329,3,"COPACELE",,1,,164,165
11,"Caraș-Severin",118,"118-CORNEA",52115,199,2,756,515,475,40,514,1,"CORNEA",,1,,170,344
11,"Caraș-Severin",118,"118-CORNEA",52115,200,2,607,506,456,50,504,2,"CORNEA",,1,,255,249
11,"Caraș-Severin",118,"118-CORNEA",52115,201,2,517,432,380,52,430,2,"CORNEA",,1,,159,271
11,"Caraș-Severin",118,"118-CORNEREVA",52160,202,2,360,276,256,20,273,3,"CORNEREVA",,1,,113,160
11,"Caraș-Severin",118,"118-CORNEREVA",52160,203,2,911,531,512,19,523,8,"CORNEREVA",,1,,80,443
11,"Caraș-Severin",118,"118-CORNEREVA",52160,204,2,799,489,461,28,485,4,"CORNEREVA",,1,,359,126
11,"Caraș-Severin",118,"118-CORNEREVA",52160,205,2,466,307,275,32,304,3,"CORNEREVA",,1,,168,136
11,"Caraș-Severin",118,"118-CORNEREVA",52160,206,2,153,67,50,17,65,2,"CORNEREVA",,1,,25,40
11,"Caraș-Severin",118,"118-CORNEREVA",52160,207,2,137,84,66,18,82,2,"CORNEREVA",,1,,66,16
11,"Caraș-Severin",118,"118-CORONINI",53489,208,2,974,852,752,100,851,1,"CORONINI",,1,,643,208
11,"Caraș-Severin",118,"118-CORONINI",53489,209,2,436,388,380,8,388,0,"CORONINI",,1,,310,78
11,"Caraș-Severin",118,"118-DALBOSET",52570,210,2,947,737,651,86,730,7,"DALBOSET",,1,,198,532
11,"Caraș-Severin",118,"118-DALBOSET",52570,211,2,634,571,522,49,568,3,"DALBOSET",,1,,335,233
11,"Caraș-Severin",118,"118-DOCLIN",52650,212,2,484,439,359,80,437,2,"DOCLIN",,1,,115,322
11,"Caraș-Severin",118,"118-DOCLIN",52650,213,2,639,533,466,67,525,8,"DOCLIN",,1,,164,361
11,"Caraș-Severin",118,"118-DOCLIN",52650,214,2,435,380,245,135,379,1,"DOCLIN",,1,,132,247
11,"Caraș-Severin",118,"118-DOGNECEA",52696,215,2,890,746,621,125,738,8,"DOGNECEA",,1,,270,468
11,"Caraș-Severin",118,"118-DOGNECEA",52696,216,2,438,374,335,39,372,2,"DOGNECEA",,1,,79,293
11,"Caraș-Severin",118,"118-DOGNECEA",52696,217,2,102,122,82,40,122,0,"DOGNECEA",,1,,48,74
11,"Caraș-Severin",118,"118-DOMASNEA",52721,218,2,912,790,679,111,785,5,"DOMASNEA",,1,,271,514
11,"Caraș-Severin",118,"118-DOMASNEA",52721,219,2,311,276,252,24,272,4,"DOMASNEA",,1,,75,197
11,"Caraș-Severin",118,"118-EFTIMIE MURGU",53700,220,2,1489,1279,1218,61,1271,8,"EFTIMIE MURGU",,1,,468,803
11,"Caraș-Severin",118,"118-EZERIS",52758,221,2,477,436,305,131,430,6,"EZERIS",,1,,162,268
11,"Caraș-Severin",118,"118-EZERIS",52758,222,2,504,467,366,101,461,6,"EZERIS",,1,,123,338
11,"Caraș-Severin",118,"118-FARLIUG",52785,223,2,759,549,457,92,545,4,"FARLIUG",,1,,137,408
11,"Caraș-Severin",118,"118-FARLIUG",52785,224,2,338,224,179,45,221,3,"FARLIUG",,1,,86,135
11,"Caraș-Severin",118,"118-FARLIUG",52785,225,2,172,251,136,115,251,0,"FARLIUG",,1,,84,167
11,"Caraș-Severin",118,"118-FARLIUG",52785,226,2,171,195,155,40,193,2,"FARLIUG",,1,,66,127
11,"Caraș-Severin",118,"118-FARLIUG",52785,227,2,173,180,147,33,178,2,"FARLIUG",,1,,73,105
11,"Caraș-Severin",118,"118-FARLIUG",52785,228,2,117,143,98,45,141,2,"FARLIUG",,1,,24,117
11,"Caraș-Severin",118,"118-FOROTIC",52856,229,2,521,474,390,84,472,2,"FOROTIC",,1,,143,329
11,"Caraș-Severin",118,"118-FOROTIC",52856,230,2,495,471,405,66,466,5,"FOROTIC",,1,,143,323
11,"Caraș-Severin",118,"118-FOROTIC",52856,231,2,350,364,274,90,361,3,"FOROTIC",,1,,118,243
11,"Caraș-Severin",118,"118-GARNIC",52909,232,2,559,419,402,17,412,7,"GARNIC",,1,,69,343
11,"Caraș-Severin",118,"118-GARNIC",52909,233,2,760,514,487,27,511,3,"GARNIC",,1,,227,284
11,"Caraș-Severin",118,"118-GLIMBOCA",52936,234,2,1414,1258,1075,183,1251,7,"GLIMBOCA",,1,,378,873
11,"Caraș-Severin",118,"118-GORUIA",52954,235,2,321,310,266,44,309,1,"GORUIA",,1,,78,231
11,"Caraș-Severin",118,"118-GORUIA",52954,236,2,326,344,248,96,341,3,"GORUIA",,1,,149,192
11,"Caraș-Severin",118,"118-GORUIA",52954,237,2,126,133,104,29,132,1,"GORUIA",,1,,72,60
11,"Caraș-Severin",118,"118-GRADINARI",52990,238,2,860,783,648,135,779,4,"GRADINARI",,1,,418,361
11,"Caraș-Severin",118,"118-GRADINARI",52990,239,2,706,635,561,74,634,1,"GRADINARI",,1,,190,444
11,"Caraș-Severin",118,"118-IABLANITA",53023,240,2,715,612,529,83,608,4,"IABLANITA",,1,,308,300
11,"Caraș-Severin",118,"118-IABLANITA",53023,241,2,712,553,495,58,544,9,"IABLANITA",,1,,252,292
11,"Caraș-Severin",118,"118-IABLANITA",53023,242,2,613,524,494,30,524,0,"IABLANITA",,1,,323,201
11,"Caraș-Severin",118,"118-LAPUSNICEL",53069,243,2,566,481,417,64,478,3,"LAPUSNICEL",,1,,241,237
11,"Caraș-Severin",118,"118-LAPUSNICEL",53069,244,2,464,463,283,180,457,6,"LAPUSNICEL",,1,,214,243
11,"Caraș-Severin",118,"118-LAPUSNICEL",53069,245,2,197,146,139,7,145,1,"LAPUSNICEL",,1,,80,65
11,"Caraș-Severin",118,"118-LAPUSNICU MARE",53103,246,2,1094,912,785,127,909,3,"LAPUSNICU MARE",,1,,414,495
11,"Caraș-Severin",118,"118-LAPUSNICU MARE",53103,247,2,563,417,362,55,416,1,"LAPUSNICU MARE",,1,,167,249
11,"Caraș-Severin",118,"118-LUNCAVITA",53130,248,2,846,499,478,21,496,3,"LUNCAVITA",,1,,213,283
11,"Caraș-Severin",118,"118-LUNCAVITA",53130,249,2,1518,700,653,47,692,8,"LUNCAVITA",,1,,133,559
11,"Caraș-Severin",118,"118-LUPAC",53167,250,2,727,427,368,59,419,8,"LUPAC",,1,,88,331
11,"Caraș-Severin",118,"118-LUPAC",53167,251,2,796,504,448,56,500,4,"LUPAC",,1,,61,439
11,"Caraș-Severin",118,"118-LUPAC",53167,252,2,423,297,257,40,289,8,"LUPAC",,1,,46,243
11,"Caraș-Severin",118,"118-LUPAC",53167,253,2,328,256,225,31,254,2,"LUPAC",,1,,55,199
11,"Caraș-Severin",118,"118-MARGA",53210,254,2,1060,875,811,64,866,9,"MARGA",,1,,430,436
11,"Caraș-Severin",118,"118-MAURENI",53247,255,2,1120,756,690,66,745,11,"MAURENI",,1,,177,568
11,"Caraș-Severin",118,"118-MAURENI",53247,256,2,627,522,466,56,518,4,"MAURENI",,1,,204,314
11,"Caraș-Severin",118,"118-MEHADIA",53274,257,2,1456,1289,1148,141,1285,4,"MEHADIA",,1,,646,639
11,"Caraș-Severin",118,"118-MEHADIA",53274,258,2,801,619,508,111,617,2,"MEHADIA",,1,,257,360
11,"Caraș-Severin",118,"118-MEHADIA",53274,259,2,743,560,441,119,559,1,"MEHADIA",,1,,288,271
11,"Caraș-Severin",118,"118-MEHADIA",53274,260,2,195,174,131,43,173,1,"MEHADIA",,1,,85,88
11,"Caraș-Severin",118,"118-MEHADICA",53327,261,2,752,581,467,114,578,3,"MEHADICA",,1,,309,269
11,"Caraș-Severin",118,"118-NAIDAS",53345,262,2,685,775,587,188,772,3,"NAIDAS",,1,,273,499
11,"Caraș-Severin",118,"118-NAIDAS",53345,263,2,315,337,223,114,331,6,"NAIDAS",,1,,159,172
11,"Caraș-Severin",118,"118-OBREJA",53372,264,2,1945,1510,1282,228,1503,7,"OBREJA",,1,,570,933
11,"Caraș-Severin",118,"118-OBREJA",53372,265,2,352,305,238,67,300,5,"OBREJA",,1,,170,130
11,"Caraș-Severin",118,"118-OCNA DE FIER",50987,266,2,646,532,490,42,526,6,"OCNA DE FIER",,1,,252,274
11,"Caraș-Severin",118,"118-PALTINIS",53425,267,2,496,549,444,105,544,5,"PALTINIS",,1,,221,323
11,"Caraș-Severin",118,"118-PALTINIS",53425,268,2,786,613,550,63,613,0,"PALTINIS",,1,,304,309
11,"Caraș-Severin",118,"118-PALTINIS",53425,269,2,509,509,442,67,509,0,"PALTINIS",,1,,147,362
11,"Caraș-Severin",118,"118-PALTINIS",53425,270,2,256,234,188,46,232,2,"PALTINIS",,1,,108,124
11,"Caraș-Severin",118,"118-POJEJENA",53513,271,2,1335,1118,953,165,1111,7,"POJEJENA",,1,,653,458
11,"Caraș-Severin",118,"118-POJEJENA",53513,272,2,1107,974,802,172,969,5,"POJEJENA",,1,,512,457
11,"Caraș-Severin",118,"118-PRIGOR",53577,273,2,921,669,632,37,665,4,"PRIGOR",,1,,266,399
11,"Caraș-Severin",118,"118-PRIGOR",53577,274,2,1031,744,656,88,741,3,"PRIGOR",,1,,274,467
11,"Caraș-Severin",118,"118-PRIGOR",53577,275,2,439,343,309,34,339,4,"PRIGOR",,1,,97,242
11,"Caraș-Severin",118,"118-PRIGOR",53577,276,2,151,124,105,19,122,2,"PRIGOR",,1,,47,75
11,"Caraș-Severin",118,"118-RAMNA",53639,277,2,971,711,618,93,705,6,"RAMNA",,1,,313,392
11,"Caraș-Severin",118,"118-RAMNA",53639,278,2,387,326,247,79,320,6,"RAMNA",,1,,141,179
11,"Caraș-Severin",118,"118-RAMNA",53639,279,2,48,61,31,30,60,1,"RAMNA",,1,,37,23
11,"Caraș-Severin",118,"118-RACASDIA",53675,280,2,1242,1055,881,174,1044,11,"RACASDIA",,1,,430,614
11,"Caraș-Severin",118,"118-RACASDIA",53675,281,2,322,285,196,89,285,0,"RACASDIA",,1,,95,190
11,"Caraș-Severin",118,"118-RUSCA MONTANA",53728,282,2,1122,966,822,144,959,7,"RUSCA MONTANA",,1,,541,418
11,"Caraș-Severin",118,"118-RUSCA MONTANA",53728,283,2,262,365,191,174,362,3,"RUSCA MONTANA",,1,,209,153
11,"Caraș-Severin",118,"118-SACU",53755,284,2,675,644,486,158,641,3,"SACU",,1,,249,392
11,"Caraș-Severin",118,"118-SACU",53755,285,2,357,289,259,30,288,1,"SACU",,1,,159,129
11,"Caraș-Severin",118,"118-SACU",53755,286,2,135,125,109,16,125,0,"SACU",,1,,22,103
11,"Caraș-Severin",118,"118-SASCA MONTANA",53791,287,2,538,438,321,117,436,2,"SASCA MONTANA",,1,,233,203
11,"Caraș-Severin",118,"118-SASCA MONTANA",53791,288,2,410,355,283,72,354,1,"SASCA MONTANA",,1,,211,143
11,"Caraș-Severin",118,"118-SASCA MONTANA",53791,289,2,255,294,200,94,292,2,"SASCA MONTANA",,1,,162,130
11,"Caraș-Severin",118,"118-SASCA MONTANA",53791,290,2,231,236,164,72,236,0,"SASCA MONTANA",,1,,108,128
11,"Caraș-Severin",118,"118-SASCA MONTANA",53791,291,2,144,176,111,65,170,6,"SASCA MONTANA",,1,,104,66
11,"Caraș-Severin",118,"118-SICHEVITA",53853,292,2,1291,974,845,129,972,2,"SICHEVITA",,1,,444,528
11,"Caraș-Severin",118,"118-SICHEVITA",53853,293,2,499,493,389,104,492,1,"SICHEVITA",,1,,282,210
11,"Caraș-Severin",118,"118-SICHEVITA",53853,294,2,314,105,90,15,105,0,"SICHEVITA",,1,,54,51
11,"Caraș-Severin",118,"118-SLATINA-TIMIS",54056,295,2,1445,943,862,81,940,3,"SLATINA-TIMIS",,1,,278,662
11,"Caraș-Severin",118,"118-SLATINA-TIMIS",54056,296,2,718,548,484,64,547,1,"SLATINA-TIMIS",,1,,301,246
11,"Caraș-Severin",118,"118-SLATINA-TIMIS",54056,297,2,429,309,193,116,308,1,"SLATINA-TIMIS",,1,,124,184
11,"Caraș-Severin",118,"118-SOCOL",54109,298,2,575,471,377,94,464,7,"SOCOL",,1,,228,236
11,"Caraș-Severin",118,"118-SOCOL",54109,299,2,36,72,32,40,72,0,"SOCOL",,1,,39,33
11,"Caraș-Severin",118,"118-SOCOL",54109,300,2,480,377,305,72,376,1,"SOCOL",,1,,127,249
11,"Caraș-Severin",118,"118-SOCOL",54109,301,2,541,559,442,117,548,11,"SOCOL",,1,,338,210
11,"Caraș-Severin",118,"118-SOPOTU NOU",54163,302,2,346,233,210,23,232,1,"SOPOTU NOU",,1,,79,153
11,"Caraș-Severin",118,"118-SOPOTU NOU",54163,303,2,331,166,143,23,164,2,"SOPOTU NOU",,1,,113,51
11,"Caraș-Severin",118,"118-SOPOTU NOU",54163,304,2,292,137,121,16,130,7,"SOPOTU NOU",,1,,50,80
11,"Caraș-Severin",118,"118-SOPOTU NOU",54163,305,2,229,110,101,9,108,2,"SOPOTU NOU",,1,,23,85
11,"Caraș-Severin",118,"118-TEREGOVA",54270,306,2,1274,859,796,63,857,2,"TEREGOVA",,1,,322,535
11,"Caraș-Severin",118,"118-TEREGOVA",54270,307,2,1266,853,775,78,847,6,"TEREGOVA",,1,,283,564
11,"Caraș-Severin",118,"118-TEREGOVA",54270,308,2,997,829,679,150,826,3,"TEREGOVA",,1,,432,394
11,"Caraș-Severin",118,"118-TICVANIU MARE",54305,309,2,553,475,394,81,466,9,"TICVANIU MARE",,1,,149,317
11,"Caraș-Severin",118,"118-TICVANIU MARE",54305,310,2,277,313,244,69,310,3,"TICVANIU MARE",,1,,56,254
11,"Caraș-Severin",118,"118-TICVANIU MARE",54305,311,2,287,312,215,97,308,4,"TICVANIU MARE",,1,,87,221
11,"Caraș-Severin",118,"118-TICVANIU MARE",54305,312,2,236,205,150,55,202,3,"TICVANIU MARE",,1,,47,155
11,"Caraș-Severin",118,"118-TARNOVA",54350,313,2,1563,1062,958,104,1053,9,"TARNOVA",,1,,248,805
11,"Caraș-Severin",118,"118-TOPLET",54387,314,2,1205,935,852,83,928,7,"TOPLET",,1,,330,598
11,"Caraș-Severin",118,"118-TOPLET",54387,315,2,1100,843,685,158,842,1,"TOPLET",,1,,324,518
11,"Caraș-Severin",118,"118-TURNU RUIENI",54412,316,2,723,609,506,103,604,5,"TURNU RUIENI",,1,,145,459
11,"Caraș-Severin",118,"118-TURNU RUIENI",54412,317,2,1077,864,776,88,856,8,"TURNU RUIENI",,1,,185,671
11,"Caraș-Severin",118,"118-TURNU RUIENI",54412,318,2,958,615,578,37,603,12,"TURNU RUIENI",,1,,232,371
11,"Caraș-Severin",118,"118-VALIUG",54485,319,2,715,662,499,163,658,4,"VALIUG",,1,,202,456
11,"Caraș-Severin",118,"118-VARADIA",54500,320,2,606,548,422,126,544,4,"VARADIA",,1,,110,434
11,"Caraș-Severin",118,"118-VARADIA",54500,321,2,391,374,289,85,369,5,"VARADIA",,1,,110,259
11,"Caraș-Severin",118,"118-VERMES",54537,322,2,968,744,640,104,739,5,"VERMES",,1,,240,499
11,"Caraș-Severin",118,"118-VERMES",54537,323,2,219,232,163,69,232,0,"VERMES",,1,,70,162
11,"Caraș-Severin",118,"118-VERMES",54537,324,2,297,230,170,60,229,1,"VERMES",,1,,109,120
11,"Caraș-Severin",118,"118-VRANI",54573,325,2,808,766,539,227,760,6,"VRANI",,1,,285,475
11,"Caraș-Severin",118,"118-ZAVOI",54617,326,2,1447,1064,946,118,1054,10,"ZAVOI",,1,,476,578
11,"Caraș-Severin",118,"118-ZAVOI",54617,327,2,478,430,382,48,428,2,"ZAVOI",,1,,173,255
11,"Caraș-Severin",118,"118-ZAVOI",54617,328,2,383,324,297,27,321,3,"ZAVOI",,1,,107,214
11,"Caraș-Severin",118,"118-ZAVOI",54617,329,2,877,910,459,451,899,11,"ZAVOI",,1,,343,556
11,"Caraș-Severin",118,"118-ZAVOI",54617,330,2,55,55,26,29,54,1,"ZAVOI",,1,,15,39
11,"Caraș-Severin",118,"118-ZORLENTU MARE",54699,331,2,761,582,402,180,577,5,"ZORLENTU MARE",,1,,134,443
11,"Caraș-Severin",118,"118-ZORLENTU MARE",54699,332,2,96,125,58,67,124,1,"ZORLENTU MARE",,1,,35,89
12,"Călărași",519,"519-MUNICIPIUL CALARASI",92569,1,2,1700,1151,954,197,1146,5,"MUNICIPIUL CALARASI",,5,,560,586
12,"Călărași",519,"519-MUNICIPIUL CALARASI",92569,2,2,2121,1573,1336,237,1566,7,"MUNICIPIUL CALARASI",,5,,810,756
12,"Călărași",519,"519-MUNICIPIUL CALARASI",92569,3,2,1694,1105,960,145,1100,5,"MUNICIPIUL CALARASI",,5,,518,582
12,"Călărași",519,"519-MUNICIPIUL CALARASI",92569,4,2,1833,1635,1129,506,1629,6,"MUNICIPIUL CALARASI",,5,,726,903
12,"Călărași",519,"519-MUNICIPIUL CALARASI",92569,5,2,1108,788,715,73,782,5,"MUNICIPIUL CALARASI",,5,,427,355
12,"Călărași",519,"519-MUNICIPIUL CALARASI",92569,6,2,1596,1082,931,151,1071,11,"MUNICIPIUL CALARASI",,5,,533,538
12,"Călărași",519,"519-MUNICIPIUL CALARASI",92569,7,2,2071,1614,1335,279,1605,9,"MUNICIPIUL CALARASI",,5,,879,726
12,"Călărași",519,"519-MUNICIPIUL CALARASI",92569,8,2,1947,1356,1071,285,1355,1,"MUNICIPIUL CALARASI",,5,,760,595
12,"Călărași",519,"519-MUNICIPIUL CALARASI",92569,9,2,1762,1404,924,480,1392,12,"MUNICIPIUL CALARASI",,5,,661,731
12,"Călărași",519,"519-MUNICIPIUL CALARASI",92569,10,2,1894,1357,877,480,1350,7,"MUNICIPIUL CALARASI",,5,,766,584
12,"Călărași",519,"519-MUNICIPIUL CALARASI",92569,11,2,1908,1331,1099,232,1318,13,"MUNICIPIUL CALARASI",,5,,661,657
12,"Călărași",519,"519-MUNICIPIUL CALARASI",92569,12,2,1909,1421,1119,302,1407,14,"MUNICIPIUL CALARASI",,5,,756,651
12,"Călărași",519,"519-MUNICIPIUL CALARASI",92569,13,2,1984,1422,1267,155,1405,17,"MUNICIPIUL CALARASI",,5,,819,586
12,"Călărași",519,"519-MUNICIPIUL CALARASI",92569,14,2,3564,2009,1217,792,1987,22,"MUNICIPIUL CALARASI",,5,,923,1064
12,"Călărași",519,"519-MUNICIPIUL CALARASI",92569,15,2,1125,841,719,122,839,2,"MUNICIPIUL CALARASI",,5,,471,368
12,"Călărași",519,"519-MUNICIPIUL CALARASI",92569,16,2,1827,1408,1085,323,1396,12,"MUNICIPIUL CALARASI",,5,,646,750
12,"Călărași",519,"519-MUNICIPIUL CALARASI",92569,17,2,2021,1283,836,447,1276,7,"MUNICIPIUL CALARASI",,5,,602,674
12,"Călărași",519,"519-MUNICIPIUL CALARASI",92569,18,2,1388,1088,630,458,1082,6,"MUNICIPIUL CALARASI",,5,,496,586
12,"Călărași",519,"519-MUNICIPIUL CALARASI",92569,19,2,1519,1182,861,321,1180,2,"MUNICIPIUL CALARASI",,5,,553,627
12,"Călărași",519,"519-MUNICIPIUL CALARASI",92569,20,2,1972,1394,1222,172,1391,3,"MUNICIPIUL CALARASI",,5,,625,766
12,"Călărași",519,"519-MUNICIPIUL CALARASI",92569,21,2,1648,1293,1060,233,1286,7,"MUNICIPIUL CALARASI",,5,,667,619
12,"Călărași",519,"519-MUNICIPIUL CALARASI",92569,22,2,2066,1417,1366,51,1400,17,"MUNICIPIUL CALARASI",,5,,904,496
12,"Călărași",519,"519-MUNICIPIUL CALARASI",92569,23,2,1976,1560,1250,310,1547,13,"MUNICIPIUL CALARASI",,5,,936,611
12,"Călărași",519,"519-MUNICIPIUL CALARASI",92569,24,2,1600,1085,930,155,1066,19,"MUNICIPIUL CALARASI",,5,,648,418
12,"Călărași",519,"519-MUNICIPIUL CALARASI",92569,25,2,1125,975,789,186,967,8,"MUNICIPIUL CALARASI",,5,,542,425
12,"Călărași",519,"519-MUNICIPIUL CALARASI",92569,26,2,1170,740,602,138,738,2,"MUNICIPIUL CALARASI",,5,,302,436
12,"Călărași",519,"519-MUNICIPIUL CALARASI",92569,27,2,1864,1312,1075,237,1307,5,"MUNICIPIUL CALARASI",,5,,741,566
12,"Călărași",519,"519-MUNICIPIUL CALARASI",92569,28,2,1810,1465,1237,228,1443,22,"MUNICIPIUL CALARASI",,5,,723,720
12,"Călărași",519,"519-MUNICIPIUL CALARASI",92569,29,2,1789,1211,1075,136,1208,3,"MUNICIPIUL CALARASI",,5,,689,519
12,"Călărași",519,"519-MUNICIPIUL CALARASI",92569,30,2,1541,1088,669,419,1079,9,"MUNICIPIUL CALARASI",,5,,490,589
12,"Călărași",519,"519-MUNICIPIUL CALARASI",92569,31,2,2014,1604,1258,346,1597,7,"MUNICIPIUL CALARASI",,5,,747,850
12,"Călărași",519,"519-MUNICIPIUL CALARASI",92569,32,2,2200,1340,1171,169,1324,16,"MUNICIPIUL CALARASI",,5,,632,692
12,"Călărași",519,"519-MUNICIPIUL CALARASI",92569,33,2,0,694,0,694,691,3,"MUNICIPIUL CALARASI",,5,,347,344
12,"Călărași",519,"519-MUNICIPIUL CALARASI",92569,34,2,0,496,0,496,488,8,"MUNICIPIUL CALARASI",,5,,252,236
12,"Călărași",519,"519-ORAS BUDESTI",101458,35,2,1149,1016,543,473,1006,10,"ORAS BUDESTI",,5,,731,275
12,"Călărași",519,"519-ORAS BUDESTI",101458,36,2,1551,1009,780,229,996,13,"ORAS BUDESTI",,5,,668,328
12,"Călărași",519,"519-ORAS BUDESTI",101458,37,2,1147,720,561,159,709,11,"ORAS BUDESTI",,5,,554,155
12,"Călărași",519,"519-ORAS BUDESTI",101458,38,2,878,598,441,157,591,7,"ORAS BUDESTI",,5,,380,211
12,"Călărași",519,"519-ORAS BUDESTI",101458,39,2,650,423,307,116,415,8,"ORAS BUDESTI",,5,,285,130
12,"Călărași",519,"519-ORAS BUDESTI",101458,40,2,1521,712,582,130,702,10,"ORAS BUDESTI",,5,,375,327
12,"Călărași",519,"519-ORAS BUDESTI",101458,41,2,1028,617,488,129,603,14,"ORAS BUDESTI",,5,,267,336
12,"Călărași",519,"519-ORAS FUNDULEA",103032,42,2,1092,742,665,77,723,19,"ORAS FUNDULEA",,5,,388,335
12,"Călărași",519,"519-ORAS FUNDULEA",103032,43,2,1028,754,633,121,741,13,"ORAS FUNDULEA",,5,,399,342
12,"Călărași",519,"519-ORAS FUNDULEA",103032,44,2,1040,783,640,143,763,20,"ORAS FUNDULEA",,5,,373,390
12,"Călărași",519,"519-ORAS FUNDULEA",103032,45,2,929,733,565,168,724,9,"ORAS FUNDULEA",,5,,302,422
12,"Călărași",519,"519-ORAS FUNDULEA",103032,46,2,623,538,425,113,528,10,"ORAS FUNDULEA",,5,,368,160
12,"Călărași",519,"519-ORAS LEHLIU GARA",93888,47,2,2865,2205,1840,365,2192,13,"ORAS LEHLIU GARA",,5,,1312,880
12,"Călărași",519,"519-ORAS LEHLIU GARA",93888,48,2,397,328,251,77,320,8,"ORAS LEHLIU GARA",,5,,169,151
12,"Călărași",519,"519-ORAS LEHLIU GARA",93888,49,2,1431,1151,935,216,1137,14,"ORAS LEHLIU GARA",,5,,636,501
12,"Călărași",519,"519-ORAS OLTENITA",100610,50,2,1982,1445,1369,76,1422,23,"ORAS OLTENITA",,5,,1033,389
12,"Călărași",519,"519-ORAS OLTENITA",100610,51,2,1484,1104,1012,92,1099,5,"ORAS OLTENITA",,5,,753,346
12,"Călărași",519,"519-ORAS OLTENITA",100610,52,2,1390,941,851,90,937,4,"ORAS OLTENITA",,5,,550,387
12,"Călărași",519,"519-ORAS OLTENITA",100610,53,2,1937,1266,1190,76,1258,8,"ORAS OLTENITA",,5,,873,385
12,"Călărași",519,"519-ORAS OLTENITA",100610,54,2,1673,1272,1116,156,1267,5,"ORAS OLTENITA",,5,,797,470
12,"Călărași",519,"519-ORAS OLTENITA",100610,55,2,1309,997,913,84,996,1,"ORAS OLTENITA",,5,,660,336
12,"Călărași",519,"519-ORAS OLTENITA",100610,56,2,1209,916,824,92,910,6,"ORAS OLTENITA",,5,,653,257
12,"Călărași",519,"519-ORAS OLTENITA",100610,57,2,1128,751,673,78,745,6,"ORAS OLTENITA",,5,,553,192
12,"Călărași",519,"519-ORAS OLTENITA",100610,58,2,1211,1093,816,277,1090,3,"ORAS OLTENITA",,5,,775,315
12,"Călărași",519,"519-ORAS OLTENITA",100610,59,2,1297,1338,892,446,1327,11,"ORAS OLTENITA",,5,,912,415
12,"Călărași",519,"519-ORAS OLTENITA",100610,60,2,2795,1818,1570,248,1810,8,"ORAS OLTENITA",,5,,1248,562
12,"Călărași",519,"519-ORAS OLTENITA",100610,61,2,1352,961,887,74,956,5,"ORAS OLTENITA",,5,,655,301
12,"Călărași",519,"519-ORAS OLTENITA",100610,62,2,2384,1521,1396,125,1512,9,"ORAS OLTENITA",,5,,1117,395
12,"Călărași",519,"519-ORAS OLTENITA",100610,63,2,1348,984,918,66,977,7,"ORAS OLTENITA",,5,,758,219
12,"Călărași",519,"519-ORAS OLTENITA",100610,64,2,1592,1237,1177,60,1226,11,"ORAS OLTENITA",,5,,931,295
12,"Călărași",519,"519-ORAS OLTENITA",100610,65,2,0,100,0,100,97,3,"ORAS OLTENITA",,5,,59,38
12,"Călărași",519,"519-ALEXANDRU ODOBESCU",94125,66,2,1098,979,840,139,970,9,"ALEXANDRU ODOBESCU",,5,,733,237
12,"Călărași",519,"519-ALEXANDRU ODOBESCU",94125,67,2,1322,1152,973,179,1145,7,"ALEXANDRU ODOBESCU",,5,,776,369
12,"Călărași",519,"519-BELCIUGATELE",101083,68,2,1148,1021,843,178,1008,13,"BELCIUGATELE",,5,,533,475
12,"Călărași",519,"519-BELCIUGATELE",101083,69,2,512,413,323,90,402,11,"BELCIUGATELE",,5,,245,157
12,"Călărași",519,"519-BORCEA",92961,70,2,1847,1503,1180,323,1482,21,"BORCEA",,5,,1181,301
12,"Călărași",519,"519-BORCEA",92961,71,2,1652,1321,1268,53,1301,20,"BORCEA",,5,,902,399
12,"Călărași",519,"519-BORCEA",92961,72,2,1840,1036,972,64,1028,8,"BORCEA",,5,,743,285
12,"Călărași",519,"519-BORCEA",92961,73,2,1779,1438,1360,78,1350,10,"BORCEA",,5,,920,430
12,"Călărași",519,"519-BORCEA",92961,74,2,21,485,11,474,479,6,"BORCEA",,5,,288,191
12,"Călărași",519,"519-CASCIOARELE",101724,75,2,1964,1222,1167,55,1208,14,"CASCIOARELE",,5,,652,556
12,"Călărași",519,"519-CHIRNOGI",94624,76,2,2135,1385,1256,129,1367,18,"CHIRNOGI",,5,,908,459
12,"Călărași",519,"519-CHIRNOGI",94624,77,2,2133,1355,1224,131,1346,9,"CHIRNOGI",,5,,908,438
12,"Călărași",519,"519-CHIRNOGI",94624,78,2,2109,1482,1342,140,1461,21,"CHIRNOGI",,5,,1006,455
12,"Călărași",519,"519-CHISELET",101822,79,2,2359,1321,1120,201,1308,13,"CHISELET",,5,,981,327
12,"Călărași",519,"519-CHISELET",101822,80,2,941,585,489,96,576,9,"CHISELET",,5,,429,147
12,"Călărași",519,"519-CIOCANESTI",93085,81,2,862,712,553,159,705,7,"CIOCANESTI",,5,,497,208
12,"Călărași",519,"519-CIOCANESTI",93085,82,2,1568,1226,1049,177,1214,12,"CIOCANESTI",,5,,957,257
12,"Călărași",519,"519-CIOCANESTI",93085,83,2,1651,1101,895,206,1091,10,"CIOCANESTI",,5,,821,270
12,"Călărași",519,"519-CURCANI",102419,84,2,1933,1197,1079,118,1186,11,"CURCANI",,5,,840,346
12,"Călărași",519,"519-CURCANI",102419,85,2,1960,1176,1073,103,1166,10,"CURCANI",,5,,785,381
12,"Călărași",519,"519-CUZA VODA",93281,86,2,1109,896,755,141,883,13,"CUZA VODA",,5,,627,256
12,"Călărași",519,"519-CUZA VODA",93281,87,2,1349,1302,1035,267,1286,16,"CUZA VODA",,5,,924,362
12,"Călărași",519,"519-CUZA VODA",93281,88,2,626,536,473,63,530,6,"CUZA VODA",,5,,406,124
12,"Călărași",519,"519-DICHISENI",93325,89,2,1502,1043,955,88,1033,10,"DICHISENI",,5,,742,291
12,"Călărași",519,"519-DOR MARUNT",93370,90,2,1698,1070,693,377,1054,16,"DOR MARUNT",,5,,644,410
12,"Călărași",519,"519-DOR MARUNT",93370,91,2,1380,1106,602,504,1089,17,"DOR MARUNT",,5,,725,364
12,"Călărași",519,"519-DOR MARUNT",93370,92,2,332,278,228,50,273,5,"DOR MARUNT",,5,,197,76
12,"Călărași",519,"519-DOR MARUNT",93370,93,2,161,108,40,68,107,1,"DOR MARUNT",,5,,78,29
12,"Călărași",519,"519-DOR MARUNT",93370,94,2,1425,958,629,329,947,11,"DOR MARUNT",,5,,476,471
12,"Călărași",519,"519-DOROBANTU",93441,95,2,1491,904,737,167,889,15,"DOROBANTU",,5,,582,307
12,"Călărași",519,"519-DOROBANTU",93441,96,2,1075,695,558,137,685,10,"DOROBANTU",,5,,424,261
12,"Călărași",519,"519-DOROBANTU",93441,97,2,510,322,246,76,319,3,"DOROBANTU",,5,,253,66
12,"Călărași",519,"519-DRAGALINA",93487,98,2,1972,1295,1190,105,1275,20,"DRAGALINA",,5,,821,454
12,"Călărași",519,"519-DRAGALINA",93487,99,2,2374,1636,1419,217,1618,18,"DRAGALINA",,5,,954,664
12,"Călărași",519,"519-DRAGALINA",93487,100,2,878,811,656,155,801,10,"DRAGALINA",,5,,489,312
12,"Călărași",519,"519-DRAGALINA",93487,101,2,835,570,501,69,559,11,"DRAGALINA",,5,,345,214
12,"Călărași",519,"519-DRAGOS VODA",93539,102,2,1813,1323,1041,282,1299,24,"DRAGOS VODA",,5,,839,460
12,"Călărași",519,"519-DRAGOS VODA",93539,103,2,317,230,191,39,224,6,"DRAGOS VODA",,5,,156,68
12,"Călărași",519,"519-FRASINET",102838,104,2,974,724,593,131,714,10,"FRASINET",,5,,465,249
12,"Călărași",519,"519-FRASINET",102838,105,2,670,411,347,64,404,7,"FRASINET",,5,,266,138
12,"Călărași",519,"519-FRUMUSANI",102945,106,2,2394,1270,948,322,1253,17,"FRUMUSANI",,5,,559,694
12,"Călărași",519,"519-FRUMUSANI",102945,107,2,1378,810,651,159,794,16,"FRUMUSANI",,5,,415,379
12,"Călărași",519,"519-FUNDENI",103014,108,2,2057,1202,1035,167,1187,15,"FUNDENI",,5,,685,502
12,"Călărași",519,"519-FUNDENI",103014,109,2,1755,1129,962,167,1104,25,"FUNDENI",,5,,741,363
12,"Călărași",519,"519-GRADISTEA",93664,110,2,1679,1336,1180,156,1324,12,"GRADISTEA",,5,,991,333
12,"Călărași",519,"519-GRADISTEA",93664,111,2,810,608,530,78,601,7,"GRADISTEA",,5,,441,160
12,"Călărași",519,"519-GRADISTEA",93664,112,2,985,791,645,146,788,3,"GRADISTEA",,5,,497,291
12,"Călărași",519,"519-GRADISTEA",93664,113,2,545,463,404,59,458,5,"GRADISTEA",,5,,290,168
12,"Călărași",519,"519-GURBANESTI",103568,114,2,987,689,550,139,672,17,"GURBANESTI",,5,,473,199
12,"Călărași",519,"519-GURBANESTI",103568,115,2,286,205,166,39,200,5,"GURBANESTI",,5,,154,46
12,"Călărași",519,"519-ILEANA",103764,116,2,987,633,481,152,630,3,"ILEANA",,5,,361,269
12,"Călărași",519,"519-ILEANA",103764,117,2,591,453,389,64,450,3,"ILEANA",,5,,295,155
12,"Călărași",519,"519-ILEANA",103764,118,2,743,600,376,224,592,8,"ILEANA",,5,,430,162
12,"Călărași",519,"519-ILEANA",103764,119,2,749,488,336,152,480,8,"ILEANA",,5,,380,100
12,"Călărași",519,"519-INDEPENDENTA",93771,120,2,1905,1460,1345,115,1440,20,"INDEPENDENTA",,5,,1120,320
12,"Călărași",519,"519-INDEPENDENTA",93771,121,2,758,646,561,85,636,10,"INDEPENDENTA",,5,,449,187
12,"Călărași",519,"519-INDEPENDENTA",93771,122,2,483,422,366,56,420,2,"INDEPENDENTA",,5,,290,130
12,"Călărași",519,"519-JEGALIA",93815,123,2,1868,1308,1202,106,1289,19,"JEGALIA",,5,,932,357
12,"Călărași",519,"519-JEGALIA",93815,124,2,1291,925,813,112,916,9,"JEGALIA",,5,,757,159
12,"Călărași",519,"519-JEGALIA",93815,125,2,871,725,616,109,716,9,"JEGALIA",,5,,562,154
12,"Călărași",519,"519-LEHLIU",93851,126,2,1466,1077,957,120,1053,24,"LEHLIU",,5,,666,387
12,"Călărași",519,"519-LEHLIU",93851,127,2,837,598,524,74,586,12,"LEHLIU",,5,,373,213
12,"Călărași",519,"519-LUICA",104083,128,2,1247,1117,965,152,1107,10,"LUICA",,5,,724,383
12,"Călărași",519,"519-LUICA",104083,129,2,519,486,428,58,483,3,"LUICA",,5,,353,130
12,"Călărași",519,"519-LUPSANU",93931,130,2,1146,837,732,105,825,12,"LUPSANU",,5,,659,166
12,"Călărași",519,"519-LUPSANU",93931,131,2,1117,905,723,182,901,4,"LUPSANU",,5,,708,193
12,"Călărași",519,"519-LUPSANU",93931,132,2,661,506,400,106,500,6,"LUPSANU",,5,,373,127
12,"Călărași",519,"519-MITRENI",100638,133,2,1357,1011,890,121,1000,11,"MITRENI",,5,,644,356
12,"Călărași",519,"519-MITRENI",100638,134,2,1820,1254,1136,118,1235,19,"MITRENI",,5,,916,319
12,"Călărași",519,"519-MITRENI",100638,135,2,659,461,418,43,455,6,"MITRENI",,5,,339,116
12,"Călărași",519,"519-MANASTIREA",104181,136,2,1234,898,721,177,882,16,"MANASTIREA",,5,,599,283
12,"Călărași",519,"519-MANASTIREA",104181,137,2,1653,1115,915,200,1100,15,"MANASTIREA",,5,,662,438
12,"Călărași",519,"519-MANASTIREA",104181,138,2,1007,688,529,159,675,13,"MANASTIREA",,5,,407,268
12,"Călărași",519,"519-MANASTIREA",104181,139,2,1016,665,524,141,645,20,"MANASTIREA",,5,,478,167
12,"Călărași",519,"519-MODELU",92587,140,2,1751,1443,1331,112,1426,17,"MODELU",,5,,822,604
12,"Călărași",519,"519-MODELU",92587,141,2,1540,1326,1240,86,1309,17,"MODELU",,5,,865,444
12,"Călărași",519,"519-MODELU",92587,142,2,1828,1315,1224,91,1289,26,"MODELU",,5,,803,486
12,"Călărași",519,"519-MODELU",92587,143,2,867,773,610,163,756,17,"MODELU",,5,,516,240
12,"Călărași",519,"519-NANA",104323,144,2,2166,1465,1304,161,1437,28,"NANA",,5,,941,496
12,"Călărași",519,"519-NICOLAE BALCESCU",94134,145,2,893,719,581,138,714,5,"NICOLAE BALCESCU",,5,,476,238
12,"Călărași",519,"519-NICOLAE BALCESCU",94134,146,2,328,286,238,48,284,2,"NICOLAE BALCESCU",,5,,211,73
12,"Călărași",519,"519-PERISORU",94223,147,2,1423,1108,909,199,1098,10,"PERISORU",,5,,805,293
12,"Călărași",519,"519-PERISORU",94223,148,2,1523,1024,857,167,1014,10,"PERISORU",,5,,716,298
12,"Călărași",519,"519-PERISORU",94223,149,2,698,649,452,197,639,10,"PERISORU",,5,,494,145
12,"Călărași",519,"519-PERISORU",94223,150,2,0,80,0,80,80,0,"PERISORU",,5,,46,34
12,"Călărași",519,"519-PLATARESTI",104635,151,2,1148,818,651,167,811,7,"PLATARESTI",,5,,432,379
12,"Călărași",519,"519-PLATARESTI",104635,152,2,974,627,467,160,620,7,"PLATARESTI",,5,,383,237
12,"Călărași",519,"519-PLATARESTI",104635,153,2,871,527,411,116,522,5,"PLATARESTI",,5,,281,241
12,"Călărași",519,"519-RADOVANU",104751,154,2,1186,823,736,87,819,4,"RADOVANU",,5,,526,293
12,"Călărași",519,"519-RADOVANU",104751,155,2,1217,823,737,86,806,17,"RADOVANU",,5,,407,399
12,"Călărași",519,"519-RADOVANU",104751,156,2,1311,954,865,89,948,6,"RADOVANU",,5,,609,339
12,"Călărași",519,"519-RADOVANU",104751,157,2,613,515,466,49,505,9,"RADOVANU",,5,,368,137
12,"Călărași",519,"519-ROSETI",94312,158,2,2480,1686,1497,189,1671,15,"ROSETI",,5,,1391,280
12,"Călărași",519,"519-ROSETI",94312,159,2,1681,1381,1225,156,1368,13,"ROSETI",,5,,1042,326
12,"Călărași",519,"519-SARULESTI",104886,160,2,1115,706,536,170,693,13,"SARULESTI",,5,,465,228
12,"Călărași",519,"519-SARULESTI",104886,161,2,765,526,437,89,514,12,"SARULESTI",,5,,288,226
12,"Călărași",519,"519-SARULESTI",104886,162,2,213,195,135,60,193,2,"SARULESTI",,5,,107,86
12,"Călărași",519,"519-SOHATU",105222,163,2,1762,1201,1024,177,1167,34,"SOHATU",,5,,662,505
12,"Călărași",519,"519-SOHATU",105222,164,2,1165,789,682,107,772,14,"SOHATU",,5,,490,282
12,"Călărași",519,"519-SPANTOV",105259,165,2,1658,1230,1021,209,1211,19,"SPANTOV",,5,,964,247
12,"Călărași",519,"519-SPANTOV",105259,166,2,1787,1320,1009,311,1304,16,"SPANTOV",,5,,1000,304
12,"Călărași",519,"519-SOLDANU",105384,167,2,1826,1217,1006,211,1196,20,"SOLDANU",,5,,794,402
12,"Călărași",519,"519-SOLDANU",105384,168,2,796,604,494,110,598,6,"SOLDANU",,5,,440,158
12,"Călărași",519,"519-STEFAN CEL MARE",94562,169,2,1285,1042,932,110,1031,11,"STEFAN CEL MARE",,5,,823,208
12,"Călărași",519,"519-STEFAN CEL MARE",94562,170,2,1065,870,724,146,863,7,"STEFAN CEL MARE",,5,,637,226
12,"Călărași",519,"519-STEFAN VODA",94580,171,2,1816,1337,1141,196,1321,16,"STEFAN VODA",,5,,783,538
12,"Călărași",519,"519-TAMADAU MARE",105455,172,2,1142,730,620,110,723,7,"TAMADAU MARE",,5,,392,331
12,"Călărași",519,"519-TAMADAU MARE",105455,173,2,768,514,420,94,509,5,"TAMADAU MARE",,5,,286,223
12,"Călărași",519,"519-ULMENI",105605,174,2,1460,1085,965,120,1077,8,"ULMENI",,5,,853,224
12,"Călărași",519,"519-ULMENI",105605,175,2,1356,998,865,133,990,8,"ULMENI",,5,,623,367
12,"Călărași",519,"519-ULMENI",105605,176,2,1470,1132,1062,70,1116,16,"ULMENI",,5,,852,264
12,"Călărași",519,"519-ULMU",94606,177,2,1011,826,741,85,812,14,"ULMU",,5,,601,211
12,"Călărași",519,"519-ULMU",94606,178,2,454,417,380,37,414,3,"ULMU",,5,,295,119
12,"Călărași",519,"519-ULMU",94606,179,2,157,170,126,44,169,1,"ULMU",,5,,123,46
12,"Călărași",519,"519-UNIREA",94651,180,2,1056,833,590,243,822,11,"UNIREA",,5,,561,261
12,"Călărași",519,"519-UNIREA",94651,181,2,1259,773,773,0,762,11,"UNIREA",,5,,583,179
12,"Călărași",519,"519-VALEA ARGOVEI",105712,182,2,1451,1131,998,133,1108,23,"VALEA ARGOVEI",,5,,805,303
12,"Călărași",519,"519-VALEA ARGOVEI",105712,183,2,590,520,457,63,509,11,"VALEA ARGOVEI",,5,,382,127
12,"Călărași",519,"519-VASILATI",105829,184,2,996,701,580,121,685,16,"VASILATI",,5,,366,319
12,"Călărași",519,"519-VASILATI",105829,185,2,1648,1217,1019,198,1190,27,"VASILATI",,5,,637,553
12,"Călărași",519,"519-VASILATI",105829,186,2,2228,1385,1092,293,1357,28,"VASILATI",,5,,766,591
12,"Călărași",519,"519-VASILATI",105829,187,2,305,269,214,55,267,2,"VASILATI",,5,,177,90
12,"Călărași",519,"519-VASILATI",105829,188,2,311,287,221,66,279,8,"VASILATI",,5,,168,111
12,"Călărași",519,"519-VALCELELE",94731,189,2,1113,874,741,133,863,11,"VALCELELE",,5,,632,231
12,"Călărași",519,"519-VALCELELE",94731,190,2,509,475,375,100,469,6,"VALCELELE",,5,,367,102
12,"Călărași",519,"519-VLAD TEPES",94768,191,2,1371,1010,866,144,999,11,"VLAD TEPES",,5,,712,287
12,"Călărași",519,"519-VLAD TEPES",94768,192,2,860,646,541,105,637,9,"VLAD TEPES",,5,,461,176
13,"Cluj",127,"127-MUNICIPIUL CLUJ-NAPOCA",54975,1,2,2522,1952,1803,149,1948,4,"MUNICIPIUL CLUJ-NAPOCA",,7,,387,1561
13,"Cluj",127,"127-MUNICIPIUL CLUJ-NAPOCA",54975,2,2,2397,1824,1686,138,1816,8,"MUNICIPIUL CLUJ-NAPOCA",,7,,393,1423
13,"Cluj",127,"127-MUNICIPIUL CLUJ-NAPOCA",54975,3,2,2194,1722,1615,107,1721,1,"MUNICIPIUL CLUJ-NAPOCA",,7,,362,1359
13,"Cluj",127,"127-MUNICIPIUL CLUJ-NAPOCA",54975,4,2,2113,1530,1378,152,1528,2,"MUNICIPIUL CLUJ-NAPOCA",,7,,315,1213
13,"Cluj",127,"127-MUNICIPIUL CLUJ-NAPOCA",54975,5,2,1907,1575,1361,214,1569,6,"MUNICIPIUL CLUJ-NAPOCA",,7,,273,1296
13,"Cluj",127,"127-MUNICIPIUL CLUJ-NAPOCA",54975,6,2,2235,1642,1536,106,1634,8,"MUNICIPIUL CLUJ-NAPOCA",,7,,290,1344
13,"Cluj",127,"127-MUNICIPIUL CLUJ-NAPOCA",54975,7,2,2062,1750,1565,185,1745,5,"MUNICIPIUL CLUJ-NAPOCA",,7,,358,1387
13,"Cluj",127,"127-MUNICIPIUL CLUJ-NAPOCA",54975,8,2,2290,1863,1663,200,1858,5,"MUNICIPIUL CLUJ-NAPOCA",,7,,525,1333
13,"Cluj",127,"127-MUNICIPIUL CLUJ-NAPOCA",54975,9,2,1845,1441,1223,218,1437,4,"MUNICIPIUL CLUJ-NAPOCA",,7,,315,1122
13,"Cluj",127,"127-MUNICIPIUL CLUJ-NAPOCA",54975,10,2,1964,1660,1454,206,1650,10,"MUNICIPIUL CLUJ-NAPOCA",,7,,530,1120
13,"Cluj",127,"127-MUNICIPIUL CLUJ-NAPOCA",54975,11,2,2357,1853,1657,196,1845,8,"MUNICIPIUL CLUJ-NAPOCA",,7,,425,1420
13,"Cluj",127,"127-MUNICIPIUL CLUJ-NAPOCA",54975,12,2,2251,1971,1581,390,1966,5,"MUNICIPIUL CLUJ-NAPOCA",,7,,589,1377
13,"Cluj",127,"127-MUNICIPIUL CLUJ-NAPOCA",54975,13,2,2263,1777,1575,202,1772,5,"MUNICIPIUL CLUJ-NAPOCA",,7,,427,1345
13,"Cluj",127,"127-MUNICIPIUL CLUJ-NAPOCA",54975,14,2,1582,1410,1156,254,1406,4,"MUNICIPIUL CLUJ-NAPOCA",,7,,369,1037
13,"Cluj",127,"127-MUNICIPIUL CLUJ-NAPOCA",54975,15,2,2224,1892,1698,194,1883,9,"MUNICIPIUL CLUJ-NAPOCA",,7,,466,1417
13,"Cluj",127,"127-MUNICIPIUL CLUJ-NAPOCA",54975,16,2,2504,2076,1864,212,2067,9,"MUNICIPIUL CLUJ-NAPOCA",,7,,468,1599
13,"Cluj",127,"127-MUNICIPIUL CLUJ-NAPOCA",54975,17,2,2151,1838,1712,126,1832,6,"MUNICIPIUL CLUJ-NAPOCA",,7,,477,1355
13,"Cluj",127,"127-MUNICIPIUL CLUJ-NAPOCA",54975,18,2,2197,1649,1473,176,1642,7,"MUNICIPIUL CLUJ-NAPOCA",,7,,362,1280
13,"Cluj",127,"127-MUNICIPIUL CLUJ-NAPOCA",54975,19,2,1998,1565,1415,150,1555,10,"MUNICIPIUL CLUJ-NAPOCA",,7,,430,1125
13,"Cluj",127,"127-MUNICIPIUL CLUJ-NAPOCA",54975,20,2,2535,1963,1837,126,1958,5,"MUNICIPIUL CLUJ-NAPOCA",,7,,557,1401
13,"Cluj",127,"127-MUNICIPIUL CLUJ-NAPOCA",54975,21,2,2248,1640,1500,140,1632,4,"MUNICIPIUL CLUJ-NAPOCA",,7,,436,1196
13,"Cluj",127,"127-MUNICIPIUL CLUJ-NAPOCA",54975,22,2,1918,1520,1345,175,1512,8,"MUNICIPIUL CLUJ-NAPOCA",,7,,315,1197
13,"Cluj",127,"127-MUNICIPIUL CLUJ-NAPOCA",54975,23,2,1852,1508,1352,156,1504,4,"MUNICIPIUL CLUJ-NAPOCA",,7,,321,1183
13,"Cluj",127,"127-MUNICIPIUL CLUJ-NAPOCA",54975,24,2,1885,1377,1240,137,1368,9,"MUNICIPIUL CLUJ-NAPOCA",,7,,294,1074
13,"Cluj",127,"127-MUNICIPIUL CLUJ-NAPOCA",54975,25,2,2207,1736,1621,115,1729,7,"MUNICIPIUL CLUJ-NAPOCA",,7,,513,1216
13,"Cluj",127,"127-MUNICIPIUL CLUJ-NAPOCA",54975,26,2,1799,1333,1240,93,1331,2,"MUNICIPIUL CLUJ-NAPOCA",,7,,382,949
13,"Cluj",127,"127-MUNICIPIUL CLUJ-NAPOCA",54975,27,2,1599,1312,1199,113,1306,6,"MUNICIPIUL CLUJ-NAPOCA",,7,,371,935
13,"Cluj",127,"127-MUNICIPIUL CLUJ-NAPOCA",54975,28,2,1718,1419,1186,233,1416,3,"MUNICIPIUL CLUJ-NAPOCA",,7,,429,987
13,"Cluj",127,"127-MUNICIPIUL CLUJ-NAPOCA",54975,29,2,1865,1514,1340,174,1510,4,"MUNICIPIUL CLUJ-NAPOCA",,7,,486,1024
13,"Cluj",127,"127-MUNICIPIUL CLUJ-NAPOCA",54975,30,2,1693,1396,1291,105,1392,2,"MUNICIPIUL CLUJ-NAPOCA",,7,,419,973
13,"Cluj",127,"127-MUNICIPIUL CLUJ-NAPOCA",54975,31,2,1766,1442,1353,89,1438,4,"MUNICIPIUL CLUJ-NAPOCA",,7,,446,992
13,"Cluj",127,"127-MUNICIPIUL CLUJ-NAPOCA",54975,32,2,1591,1297,1095,202,1284,7,"MUNICIPIUL CLUJ-NAPOCA",,7,,305,979
13,"Cluj",127,"127-MUNICIPIUL CLUJ-NAPOCA",54975,33,2,2024,1734,1510,224,1729,5,"MUNICIPIUL CLUJ-NAPOCA",,7,,398,1331
13,"Cluj",127,"127-MUNICIPIUL CLUJ-NAPOCA",54975,34,2,1846,1581,1413,168,1571,10,"MUNICIPIUL CLUJ-NAPOCA",,7,,387,1184
13,"Cluj",127,"127-MUNICIPIUL CLUJ-NAPOCA",54975,35,2,2040,1605,1455,150,1596,9,"MUNICIPIUL CLUJ-NAPOCA",,7,,376,1220
13,"Cluj",127,"127-MUNICIPIUL CLUJ-NAPOCA",54975,36,2,2069,1632,1541,91,1622,7,"MUNICIPIUL CLUJ-NAPOCA",,7,,382,1240
13,"Cluj",127,"127-MUNICIPIUL CLUJ-NAPOCA",54975,37,2,2357,1737,1618,119,1723,14,"MUNICIPIUL CLUJ-NAPOCA",,7,,430,1293
13,"Cluj",127,"127-MUNICIPIUL CLUJ-NAPOCA",54975,38,2,2088,1527,1432,95,1524,3,"MUNICIPIUL CLUJ-NAPOCA",,7,,293,1231
13,"Cluj",127,"127-MUNICIPIUL CLUJ-NAPOCA",54975,39,2,2804,2095,1961,134,2094,1,"MUNICIPIUL CLUJ-NAPOCA",,7,,411,1683
13,"Cluj",127,"127-MUNICIPIUL CLUJ-NAPOCA",54975,40,2,1914,1474,1379,95,1470,4,"MUNICIPIUL CLUJ-NAPOCA",,7,,283,1187
13,"Cluj",127,"127-MUNICIPIUL CLUJ-NAPOCA",54975,41,2,1731,1311,1212,99,1309,2,"MUNICIPIUL CLUJ-NAPOCA",,7,,272,1037
13,"Cluj",127,"127-MUNICIPIUL CLUJ-NAPOCA",54975,42,2,2656,2002,1847,155,1997,5,"MUNICIPIUL CLUJ-NAPOCA",,7,,494,1503
13,"Cluj",127,"127-MUNICIPIUL CLUJ-NAPOCA",54975,43,2,1841,1434,1339,95,1429,5,"MUNICIPIUL CLUJ-NAPOCA",,7,,325,1104
13,"Cluj",127,"127-MUNICIPIUL CLUJ-NAPOCA",54975,44,2,2103,1698,1512,186,1694,4,"MUNICIPIUL CLUJ-NAPOCA",,7,,434,1260
13,"Cluj",127,"127-MUNICIPIUL CLUJ-NAPOCA",54975,45,2,1709,1363,1274,89,1359,4,"MUNICIPIUL CLUJ-NAPOCA",,7,,331,1028
13,"Cluj",127,"127-MUNICIPIUL CLUJ-NAPOCA",54975,46,2,1814,1466,1289,177,1462,4,"MUNICIPIUL CLUJ-NAPOCA",,7,,316,1146
13,"Cluj",127,"127-MUNICIPIUL CLUJ-NAPOCA",54975,47,2,1719,1092,1011,81,1086,6,"MUNICIPIUL CLUJ-NAPOCA",,7,,237,849
13,"Cluj",127,"127-MUNICIPIUL CLUJ-NAPOCA",54975,48,2,1732,1705,1128,577,1694,11,"MUNICIPIUL CLUJ-NAPOCA",,7,,322,1372
13,"Cluj",127,"127-MUNICIPIUL CLUJ-NAPOCA",54975,49,2,1938,1453,1334,119,1449,4,"MUNICIPIUL CLUJ-NAPOCA",,7,,363,1086
13,"Cluj",127,"127-MUNICIPIUL CLUJ-NAPOCA",54975,50,2,2507,2019,1854,165,2012,7,"MUNICIPIUL CLUJ-NAPOCA",,7,,407,1605
13,"Cluj",127,"127-MUNICIPIUL CLUJ-NAPOCA",54975,51,2,2235,1836,1580,256,1827,9,"MUNICIPIUL CLUJ-NAPOCA",,7,,462,1365
13,"Cluj",127,"127-MUNICIPIUL CLUJ-NAPOCA",54975,52,2,1886,1516,1380,136,1512,4,"MUNICIPIUL CLUJ-NAPOCA",,7,,364,1148
13,"Cluj",127,"127-MUNICIPIUL CLUJ-NAPOCA",54975,53,2,1970,1609,1450,159,1607,2,"MUNICIPIUL CLUJ-NAPOCA",,7,,396,1211
13,"Cluj",127,"127-MUNICIPIUL CLUJ-NAPOCA",54975,54,2,2310,1798,1623,175,1789,9,"MUNICIPIUL CLUJ-NAPOCA",,7,,454,1335
13,"Cluj",127,"127-MUNICIPIUL CLUJ-NAPOCA",54975,55,2,1952,1574,1313,261,1571,3,"MUNICIPIUL CLUJ-NAPOCA",,7,,462,1109
13,"Cluj",127,"127-MUNICIPIUL CLUJ-NAPOCA",54975,56,2,2505,2272,1946,326,2266,4,"MUNICIPIUL CLUJ-NAPOCA",,7,,564,1702
13,"Cluj",127,"127-MUNICIPIUL CLUJ-NAPOCA",54975,57,2,2043,1661,1487,174,1659,2,"MUNICIPIUL CLUJ-NAPOCA",,7,,427,1232
13,"Cluj",127,"127-MUNICIPIUL CLUJ-NAPOCA",54975,58,2,1890,1524,1334,190,1520,4,"MUNICIPIUL CLUJ-NAPOCA",,7,,352,1168
13,"Cluj",127,"127-MUNICIPIUL CLUJ-NAPOCA",54975,59,2,1484,1130,1016,114,1129,1,"MUNICIPIUL CLUJ-NAPOCA",,7,,203,926
13,"Cluj",127,"127-MUNICIPIUL CLUJ-NAPOCA",54975,60,2,1265,875,770,105,872,3,"MUNICIPIUL CLUJ-NAPOCA",,7,,147,725
13,"Cluj",127,"127-MUNICIPIUL CLUJ-NAPOCA",54975,61,2,1621,1284,1126,158,1275,9,"MUNICIPIUL CLUJ-NAPOCA",,7,,276,999
13,"Cluj",127,"127-MUNICIPIUL CLUJ-NAPOCA",54975,62,2,1896,1547,1313,234,1541,6,"MUNICIPIUL CLUJ-NAPOCA",,7,,407,1134
13,"Cluj",127,"127-MUNICIPIUL CLUJ-NAPOCA",54975,63,2,1349,1078,993,85,1075,3,"MUNICIPIUL CLUJ-NAPOCA",,7,,320,755
13,"Cluj",127,"127-MUNICIPIUL CLUJ-NAPOCA",54975,64,2,1978,1665,1485,180,1659,6,"MUNICIPIUL CLUJ-NAPOCA",,7,,284,1375
13,"Cluj",127,"127-MUNICIPIUL CLUJ-NAPOCA",54975,65,2,2072,1700,1524,176,1696,4,"MUNICIPIUL CLUJ-NAPOCA",,7,,338,1358
13,"Cluj",127,"127-MUNICIPIUL CLUJ-NAPOCA",54975,66,2,2238,1817,1506,311,1812,5,"MUNICIPIUL CLUJ-NAPOCA",,7,,426,1386
13,"Cluj",127,"127-MUNICIPIUL CLUJ-NAPOCA",54975,67,2,2175,1735,1553,182,1729,6,"MUNICIPIUL CLUJ-NAPOCA",,7,,371,1358
13,"Cluj",127,"127-MUNICIPIUL CLUJ-NAPOCA",54975,68,2,1779,1411,1299,112,1402,9,"MUNICIPIUL CLUJ-NAPOCA",,7,,334,1068
13,"Cluj",127,"127-MUNICIPIUL CLUJ-NAPOCA",54975,69,2,1984,1600,1328,272,1592,8,"MUNICIPIUL CLUJ-NAPOCA",,7,,350,1242
13,"Cluj",127,"127-MUNICIPIUL CLUJ-NAPOCA",54975,70,2,1960,1470,1283,187,1464,6,"MUNICIPIUL CLUJ-NAPOCA",,7,,372,1092
13,"Cluj",127,"127-MUNICIPIUL CLUJ-NAPOCA",54975,71,2,1754,1262,1105,157,1257,5,"MUNICIPIUL CLUJ-NAPOCA",,7,,283,974
13,"Cluj",127,"127-MUNICIPIUL CLUJ-NAPOCA",54975,72,2,1449,1422,890,532,1415,6,"MUNICIPIUL CLUJ-NAPOCA",,7,,272,1143
13,"Cluj",127,"127-MUNICIPIUL CLUJ-NAPOCA",54975,73,2,1972,1434,1306,128,1422,12,"MUNICIPIUL CLUJ-NAPOCA",,7,,244,1178
13,"Cluj",127,"127-MUNICIPIUL CLUJ-NAPOCA",54975,74,2,1828,1547,1337,210,1539,8,"MUNICIPIUL CLUJ-NAPOCA",,7,,425,1114
13,"Cluj",127,"127-MUNICIPIUL CLUJ-NAPOCA",54975,75,2,1582,1322,1086,236,1304,18,"MUNICIPIUL CLUJ-NAPOCA",,7,,361,943
13,"Cluj",127,"127-MUNICIPIUL CLUJ-NAPOCA",54975,76,2,2197,1746,1627,119,1742,4,"MUNICIPIUL CLUJ-NAPOCA",,7,,430,1312
13,"Cluj",127,"127-MUNICIPIUL CLUJ-NAPOCA",54975,77,2,2402,1876,1748,128,1866,10,"MUNICIPIUL CLUJ-NAPOCA",,7,,536,1330
13,"Cluj",127,"127-MUNICIPIUL CLUJ-NAPOCA",54975,78,2,2424,1909,1768,141,1896,13,"MUNICIPIUL CLUJ-NAPOCA",,7,,481,1415
13,"Cluj",127,"127-MUNICIPIUL CLUJ-NAPOCA",54975,79,2,2347,1824,1645,179,1809,15,"MUNICIPIUL CLUJ-NAPOCA",,7,,423,1386
13,"Cluj",127,"127-MUNICIPIUL CLUJ-NAPOCA",54975,80,2,2061,1533,1392,141,1526,7,"MUNICIPIUL CLUJ-NAPOCA",,7,,371,1155
13,"Cluj",127,"127-MUNICIPIUL CLUJ-NAPOCA",54975,81,2,2192,1648,1543,105,1638,10,"MUNICIPIUL CLUJ-NAPOCA",,7,,433,1205
13,"Cluj",127,"127-MUNICIPIUL CLUJ-NAPOCA",54975,82,2,2134,1535,1443,92,1533,2,"MUNICIPIUL CLUJ-NAPOCA",,7,,388,1145
13,"Cluj",127,"127-MUNICIPIUL CLUJ-NAPOCA",54975,83,2,2205,1589,1473,116,1583,6,"MUNICIPIUL CLUJ-NAPOCA",,7,,365,1218
13,"Cluj",127,"127-MUNICIPIUL CLUJ-NAPOCA",54975,84,2,1759,1232,1126,106,1227,5,"MUNICIPIUL CLUJ-NAPOCA",,7,,301,926
13,"Cluj",127,"127-MUNICIPIUL CLUJ-NAPOCA",54975,85,2,2506,1973,1790,183,1964,9,"MUNICIPIUL CLUJ-NAPOCA",,7,,526,1438
13,"Cluj",127,"127-MUNICIPIUL CLUJ-NAPOCA",54975,86,2,1719,1309,1189,120,1304,5,"MUNICIPIUL CLUJ-NAPOCA",,7,,359,945
13,"Cluj",127,"127-MUNICIPIUL CLUJ-NAPOCA",54975,87,2,1768,1425,1336,89,1418,7,"MUNICIPIUL CLUJ-NAPOCA",,7,,358,1060
13,"Cluj",127,"127-MUNICIPIUL CLUJ-NAPOCA",54975,88,2,1855,1436,1380,56,1431,5,"MUNICIPIUL CLUJ-NAPOCA",,7,,375,1056
13,"Cluj",127,"127-MUNICIPIUL CLUJ-NAPOCA",54975,89,2,1904,1413,1326,87,1409,4,"MUNICIPIUL CLUJ-NAPOCA",,7,,346,1063
13,"Cluj",127,"127-MUNICIPIUL CLUJ-NAPOCA",54975,90,2,2108,1642,1509,133,1637,5,"MUNICIPIUL CLUJ-NAPOCA",,7,,365,1272
13,"Cluj",127,"127-MUNICIPIUL CLUJ-NAPOCA",54975,91,2,2323,1665,1495,170,1662,3,"MUNICIPIUL CLUJ-NAPOCA",,7,,362,1300
13,"Cluj",127,"127-MUNICIPIUL CLUJ-NAPOCA",54975,92,2,2218,1690,1516,174,1686,4,"MUNICIPIUL CLUJ-NAPOCA",,7,,440,1246
13,"Cluj",127,"127-MUNICIPIUL CLUJ-NAPOCA",54975,93,2,2231,1769,1636,133,1764,5,"MUNICIPIUL CLUJ-NAPOCA",,7,,480,1284
13,"Cluj",127,"127-MUNICIPIUL CLUJ-NAPOCA",54975,94,2,2083,1606,1470,136,1605,1,"MUNICIPIUL CLUJ-NAPOCA",,7,,386,1219
13,"Cluj",127,"127-MUNICIPIUL CLUJ-NAPOCA",54975,95,2,2828,2189,2017,172,2176,13,"MUNICIPIUL CLUJ-NAPOCA",,7,,513,1663
13,"Cluj",127,"127-MUNICIPIUL CLUJ-NAPOCA",54975,96,2,2297,1918,1689,229,1914,4,"MUNICIPIUL CLUJ-NAPOCA",,7,,540,1374
13,"Cluj",127,"127-MUNICIPIUL CLUJ-NAPOCA",54975,97,2,2161,1610,1537,73,1604,6,"MUNICIPIUL CLUJ-NAPOCA",,7,,362,1242
13,"Cluj",127,"127-MUNICIPIUL CLUJ-NAPOCA",54975,98,2,1960,1548,1411,137,1538,10,"MUNICIPIUL CLUJ-NAPOCA",,7,,362,1176
13,"Cluj",127,"127-MUNICIPIUL CLUJ-NAPOCA",54975,99,2,1779,1356,1229,127,1347,9,"MUNICIPIUL CLUJ-NAPOCA",,7,,309,1038
13,"Cluj",127,"127-MUNICIPIUL CLUJ-NAPOCA",54975,100,2,1807,1622,1302,320,1617,5,"MUNICIPIUL CLUJ-NAPOCA",,7,,393,1224
13,"Cluj",127,"127-MUNICIPIUL CLUJ-NAPOCA",54975,101,2,1600,1255,1177,78,1252,3,"MUNICIPIUL CLUJ-NAPOCA",,7,,302,950
13,"Cluj",127,"127-MUNICIPIUL CLUJ-NAPOCA",54975,102,2,1808,1414,1310,104,1409,5,"MUNICIPIUL CLUJ-NAPOCA",,7,,329,1080
13,"Cluj",127,"127-MUNICIPIUL CLUJ-NAPOCA",54975,103,2,2064,1596,1465,131,1589,7,"MUNICIPIUL CLUJ-NAPOCA",,7,,431,1158
13,"Cluj",127,"127-MUNICIPIUL CLUJ-NAPOCA",54975,104,2,2022,1601,1491,110,1595,6,"MUNICIPIUL CLUJ-NAPOCA",,7,,454,1141
13,"Cluj",127,"127-MUNICIPIUL CLUJ-NAPOCA",54975,105,2,2368,1829,1690,139,1819,10,"MUNICIPIUL CLUJ-NAPOCA",,7,,495,1324
13,"Cluj",127,"127-MUNICIPIUL CLUJ-NAPOCA",54975,106,2,2553,2102,1837,265,2098,4,"MUNICIPIUL CLUJ-NAPOCA",,7,,592,1506
13,"Cluj",127,"127-MUNICIPIUL CLUJ-NAPOCA",54975,107,2,2809,2173,1946,227,2163,10,"MUNICIPIUL CLUJ-NAPOCA",,7,,477,1686
13,"Cluj",127,"127-MUNICIPIUL CLUJ-NAPOCA",54975,108,2,2413,1996,1840,156,1990,6,"MUNICIPIUL CLUJ-NAPOCA",,7,,408,1582
13,"Cluj",127,"127-MUNICIPIUL CLUJ-NAPOCA",54975,109,2,1208,1031,876,155,1027,3,"MUNICIPIUL CLUJ-NAPOCA",,7,,218,809
13,"Cluj",127,"127-MUNICIPIUL CLUJ-NAPOCA",54975,110,2,2086,1692,1564,128,1688,4,"MUNICIPIUL CLUJ-NAPOCA",,7,,416,1272
13,"Cluj",127,"127-MUNICIPIUL CLUJ-NAPOCA",54975,111,2,2030,1508,1358,150,1502,6,"MUNICIPIUL CLUJ-NAPOCA",,7,,295,1207
13,"Cluj",127,"127-MUNICIPIUL CLUJ-NAPOCA",54975,112,2,1457,1185,1049,136,1180,5,"MUNICIPIUL CLUJ-NAPOCA",,7,,289,891
13,"Cluj",127,"127-MUNICIPIUL CLUJ-NAPOCA",54975,113,2,2115,1735,1593,142,1731,4,"MUNICIPIUL CLUJ-NAPOCA",,7,,367,1364
13,"Cluj",127,"127-MUNICIPIUL CLUJ-NAPOCA",54975,114,2,2080,1709,1595,114,1704,5,"MUNICIPIUL CLUJ-NAPOCA",,7,,459,1245
13,"Cluj",127,"127-MUNICIPIUL CLUJ-NAPOCA",54975,115,2,2359,1819,1610,209,1810,9,"MUNICIPIUL CLUJ-NAPOCA",,7,,473,1337
13,"Cluj",127,"127-MUNICIPIUL CLUJ-NAPOCA",54975,116,2,1307,1105,930,175,1100,5,"MUNICIPIUL CLUJ-NAPOCA",,7,,290,810
13,"Cluj",127,"127-MUNICIPIUL CLUJ-NAPOCA",54975,117,2,1959,1617,1447,170,1614,3,"MUNICIPIUL CLUJ-NAPOCA",,7,,485,1129
13,"Cluj",127,"127-MUNICIPIUL CLUJ-NAPOCA",54975,118,2,2581,2022,1877,145,2015,7,"MUNICIPIUL CLUJ-NAPOCA",,7,,499,1516
13,"Cluj",127,"127-MUNICIPIUL CLUJ-NAPOCA",54975,119,2,2415,2024,1839,185,2020,4,"MUNICIPIUL CLUJ-NAPOCA",,7,,492,1528
13,"Cluj",127,"127-MUNICIPIUL CLUJ-NAPOCA",54975,120,2,1541,1346,1263,83,1259,4,"MUNICIPIUL CLUJ-NAPOCA",,7,,323,936
13,"Cluj",127,"127-MUNICIPIUL CLUJ-NAPOCA",54975,121,2,2400,1932,1724,208,1928,4,"MUNICIPIUL CLUJ-NAPOCA",,7,,505,1423
13,"Cluj",127,"127-MUNICIPIUL CLUJ-NAPOCA",54975,122,2,968,953,920,33,949,4,"MUNICIPIUL CLUJ-NAPOCA",,7,,291,658
13,"Cluj",127,"127-MUNICIPIUL CLUJ-NAPOCA",54975,123,2,951,938,885,53,930,8,"MUNICIPIUL CLUJ-NAPOCA",,7,,355,575
13,"Cluj",127,"127-MUNICIPIUL CLUJ-NAPOCA",54975,124,2,0,858,0,858,852,6,"MUNICIPIUL CLUJ-NAPOCA",,7,,290,562
13,"Cluj",127,"127-MUNICIPIUL CLUJ-NAPOCA",54975,125,2,0,866,0,866,863,3,"MUNICIPIUL CLUJ-NAPOCA",,7,,227,636
13,"Cluj",127,"127-MUNICIPIUL CLUJ-NAPOCA",54975,126,2,0,1337,0,1337,1332,5,"MUNICIPIUL CLUJ-NAPOCA",,7,,376,956
13,"Cluj",127,"127-MUNICIPIUL CLUJ-NAPOCA",54975,127,2,0,1888,0,1888,1882,6,"MUNICIPIUL CLUJ-NAPOCA",,7,,348,1534
13,"Cluj",127,"127-MUNICIPIUL CLUJ-NAPOCA",54975,128,2,0,419,0,419,417,2,"MUNICIPIUL CLUJ-NAPOCA",,7,,58,359
13,"Cluj",127,"127-MUNICIPIUL CLUJ-NAPOCA",54975,129,2,0,987,0,987,980,7,"MUNICIPIUL CLUJ-NAPOCA",,7,,132,848
13,"Cluj",127,"127-MUNICIPIUL CLUJ-NAPOCA",54975,130,2,0,1605,0,1605,1601,4,"MUNICIPIUL CLUJ-NAPOCA",,7,,172,1429
13,"Cluj",127,"127-MUNICIPIUL CLUJ-NAPOCA",54975,131,2,0,826,0,826,815,11,"MUNICIPIUL CLUJ-NAPOCA",,7,,160,655
13,"Cluj",127,"127-MUNICIPIUL CLUJ-NAPOCA",54975,132,2,0,1961,0,1961,1951,10,"MUNICIPIUL CLUJ-NAPOCA",,7,,250,1701
13,"Cluj",127,"127-MUNICIPIUL CLUJ-NAPOCA",54975,133,2,0,966,0,966,960,6,"MUNICIPIUL CLUJ-NAPOCA",,7,,173,787
13,"Cluj",127,"127-MUNICIPIUL CLUJ-NAPOCA",54975,134,2,0,1637,0,1637,1629,8,"MUNICIPIUL CLUJ-NAPOCA",,7,,213,1416
13,"Cluj",127,"127-MUNICIPIUL DEJ",55008,135,2,975,718,624,94,714,4,"MUNICIPIUL DEJ",,7,,264,450
13,"Cluj",127,"127-MUNICIPIUL DEJ",55008,136,2,1179,1019,840,179,1016,3,"MUNICIPIUL DEJ",,7,,381,635
13,"Cluj",127,"127-MUNICIPIUL DEJ",55008,137,2,1534,1157,953,204,1154,3,"MUNICIPIUL DEJ",,7,,384,770
13,"Cluj",127,"127-MUNICIPIUL DEJ",55008,138,2,1504,1264,1082,182,1263,1,"MUNICIPIUL DEJ",,7,,421,842
13,"Cluj",127,"127-MUNICIPIUL DEJ",55008,139,2,1736,1261,1138,123,1254,7,"MUNICIPIUL DEJ",,7,,409,845
13,"Cluj",127,"127-MUNICIPIUL DEJ",55008,140,2,1124,970,875,95,962,8,"MUNICIPIUL DEJ",,7,,332,630
13,"Cluj",127,"127-MUNICIPIUL DEJ",55008,141,2,1651,1339,1201,138,1330,9,"MUNICIPIUL DEJ",,7,,434,896
13,"Cluj",127,"127-MUNICIPIUL DEJ",55008,142,2,1381,1203,1052,151,1201,2,"MUNICIPIUL DEJ",,7,,406,795
13,"Cluj",127,"127-MUNICIPIUL DEJ",55008,143,2,754,540,499,41,535,5,"MUNICIPIUL DEJ",,7,,249,286
13,"Cluj",127,"127-MUNICIPIUL DEJ",55008,144,2,1268,1038,933,105,1036,2,"MUNICIPIUL DEJ",,7,,393,643
13,"Cluj",127,"127-MUNICIPIUL DEJ",55008,145,2,1413,1197,1009,188,1194,3,"MUNICIPIUL DEJ",,7,,496,698
13,"Cluj",127,"127-MUNICIPIUL DEJ",55008,146,2,1270,1020,943,77,1014,6,"MUNICIPIUL DEJ",,7,,387,627
13,"Cluj",127,"127-MUNICIPIUL DEJ",55008,147,2,1210,1077,908,169,1069,8,"MUNICIPIUL DEJ",,7,,444,625
13,"Cluj",127,"127-MUNICIPIUL DEJ",55008,148,2,1373,1186,1001,185,1184,2,"MUNICIPIUL DEJ",,7,,448,736
13,"Cluj",127,"127-MUNICIPIUL DEJ",55008,149,2,985,865,738,127,864,1,"MUNICIPIUL DEJ",,7,,317,547
13,"Cluj",127,"127-MUNICIPIUL DEJ",55008,150,2,1094,880,722,158,878,2,"MUNICIPIUL DEJ",,7,,315,563
13,"Cluj",127,"127-MUNICIPIUL DEJ",55008,151,2,1312,1052,913,139,1050,2,"MUNICIPIUL DEJ",,7,,420,630
13,"Cluj",127,"127-MUNICIPIUL DEJ",55008,152,2,1244,1095,946,149,1093,2,"MUNICIPIUL DEJ",,7,,411,682
13,"Cluj",127,"127-MUNICIPIUL DEJ",55008,153,2,1365,1081,867,214,1076,5,"MUNICIPIUL DEJ",,7,,358,718
13,"Cluj",127,"127-MUNICIPIUL DEJ",55008,154,2,1390,1108,1016,92,1099,9,"MUNICIPIUL DEJ",,7,,381,718
13,"Cluj",127,"127-MUNICIPIUL DEJ",55008,155,2,1798,1288,1111,177,1274,14,"MUNICIPIUL DEJ",,7,,500,774
13,"Cluj",127,"127-MUNICIPIUL DEJ",55008,156,2,1163,1013,913,100,1009,4,"MUNICIPIUL DEJ",,7,,324,685
13,"Cluj",127,"127-MUNICIPIUL DEJ",55008,157,2,538,451,391,60,448,3,"MUNICIPIUL DEJ",,7,,258,190
13,"Cluj",127,"127-MUNICIPIUL DEJ",55008,158,2,398,278,249,29,273,5,"MUNICIPIUL DEJ",,7,,129,144
13,"Cluj",127,"127-MUNICIPIUL DEJ",55008,159,2,0,1013,0,1013,1003,10,"MUNICIPIUL DEJ",,7,,546,457
13,"Cluj",127,"127-MUNICIPIUL DEJ",55008,160,2,0,325,0,325,323,2,"MUNICIPIUL DEJ",,7,,138,185
13,"Cluj",127,"127-MUNICIPIUL TURDA",55259,161,2,1374,1103,975,128,1100,3,"MUNICIPIUL TURDA",,7,,405,695
13,"Cluj",127,"127-MUNICIPIUL TURDA",55259,162,2,1878,1494,1369,125,1482,12,"MUNICIPIUL TURDA",,7,,457,1025
13,"Cluj",127,"127-MUNICIPIUL TURDA",55259,163,2,1417,1166,1047,119,1162,4,"MUNICIPIUL TURDA",,7,,358,804
13,"Cluj",127,"127-MUNICIPIUL TURDA",55259,164,2,1158,908,814,94,903,5,"MUNICIPIUL TURDA",,7,,296,607
13,"Cluj",127,"127-MUNICIPIUL TURDA",55259,165,2,1079,855,775,80,849,6,"MUNICIPIUL TURDA",,7,,274,575
13,"Cluj",127,"127-MUNICIPIUL TURDA",55259,166,2,1218,925,862,63,920,5,"MUNICIPIUL TURDA",,7,,287,633
13,"Cluj",127,"127-MUNICIPIUL TURDA",55259,167,2,984,835,720,115,832,3,"MUNICIPIUL TURDA",,7,,253,579
13,"Cluj",127,"127-MUNICIPIUL TURDA",55259,168,2,909,677,633,44,674,3,"MUNICIPIUL TURDA",,7,,224,450
13,"Cluj",127,"127-MUNICIPIUL TURDA",55259,169,2,1045,834,774,60,825,9,"MUNICIPIUL TURDA",,7,,259,566
13,"Cluj",127,"127-MUNICIPIUL TURDA",55259,170,2,898,727,660,67,723,4,"MUNICIPIUL TURDA",,7,,195,528
13,"Cluj",127,"127-MUNICIPIUL TURDA",55259,171,2,805,658,592,66,652,6,"MUNICIPIUL TURDA",,7,,210,442
13,"Cluj",127,"127-MUNICIPIUL TURDA",55259,172,2,1880,1271,1104,167,1260,11,"MUNICIPIUL TURDA",,7,,408,852
13,"Cluj",127,"127-MUNICIPIUL TURDA",55259,173,2,1137,855,766,89,849,6,"MUNICIPIUL TURDA",,7,,205,644
13,"Cluj",127,"127-MUNICIPIUL TURDA",55259,174,2,1316,1013,908,105,1007,6,"MUNICIPIUL TURDA",,7,,343,664
13,"Cluj",127,"127-MUNICIPIUL TURDA",55259,175,2,1214,1047,767,280,1037,10,"MUNICIPIUL TURDA",,7,,318,719
13,"Cluj",127,"127-MUNICIPIUL TURDA",55259,176,2,854,814,627,187,809,5,"MUNICIPIUL TURDA",,7,,319,490
13,"Cluj",127,"127-MUNICIPIUL TURDA",55259,177,2,1159,934,841,93,931,3,"MUNICIPIUL TURDA",,7,,270,661
13,"Cluj",127,"127-MUNICIPIUL TURDA",55259,178,2,1685,1369,1199,170,1360,9,"MUNICIPIUL TURDA",,7,,362,998
13,"Cluj",127,"127-MUNICIPIUL TURDA",55259,179,2,997,868,743,125,865,3,"MUNICIPIUL TURDA",,7,,305,560
13,"Cluj",127,"127-MUNICIPIUL TURDA",55259,180,2,1562,1223,1134,89,1221,2,"MUNICIPIUL TURDA",,7,,428,793
13,"Cluj",127,"127-MUNICIPIUL TURDA",55259,181,2,1220,978,870,108,973,5,"MUNICIPIUL TURDA",,7,,353,620
13,"Cluj",127,"127-MUNICIPIUL TURDA",55259,182,2,981,787,720,67,784,3,"MUNICIPIUL TURDA",,7,,279,505
13,"Cluj",127,"127-MUNICIPIUL TURDA",55259,183,2,1259,982,928,54,980,2,"MUNICIPIUL TURDA",,7,,362,618
13,"Cluj",127,"127-MUNICIPIUL TURDA",55259,184,2,2057,1547,1432,115,1546,1,"MUNICIPIUL TURDA",,7,,481,1065
13,"Cluj",127,"127-MUNICIPIUL TURDA",55259,185,2,2163,1555,1459,96,1544,11,"MUNICIPIUL TURDA",,7,,465,1079
13,"Cluj",127,"127-MUNICIPIUL TURDA",55259,186,2,1616,1172,1108,64,1168,4,"MUNICIPIUL TURDA",,7,,344,824
13,"Cluj",127,"127-MUNICIPIUL TURDA",55259,187,2,1328,1033,951,82,1027,6,"MUNICIPIUL TURDA",,7,,256,771
13,"Cluj",127,"127-MUNICIPIUL TURDA",55259,188,2,1535,1134,1044,90,1129,5,"MUNICIPIUL TURDA",,7,,291,838
13,"Cluj",127,"127-MUNICIPIUL TURDA",55259,189,2,1616,1228,1128,100,1219,9,"MUNICIPIUL TURDA",,7,,294,925
13,"Cluj",127,"127-MUNICIPIUL TURDA",55259,190,2,943,764,633,131,758,6,"MUNICIPIUL TURDA",,7,,256,502
13,"Cluj",127,"127-MUNICIPIUL TURDA",55259,191,2,2373,1784,1635,149,1775,9,"MUNICIPIUL TURDA",,7,,445,1330
13,"Cluj",127,"127-MUNICIPIUL TURDA",55259,192,2,1494,1062,981,81,1059,3,"MUNICIPIUL TURDA",,7,,285,774
13,"Cluj",127,"127-MUNICIPIUL TURDA",55259,193,2,1482,1171,1050,121,1168,3,"MUNICIPIUL TURDA",,7,,317,851
13,"Cluj",127,"127-MUNICIPIUL TURDA",55259,194,2,913,741,684,57,738,3,"MUNICIPIUL TURDA",,7,,209,529
13,"Cluj",127,"127-MUNICIPIUL TURDA",55259,195,2,1011,911,770,141,905,6,"MUNICIPIUL TURDA",,7,,221,684
13,"Cluj",127,"127-MUNICIPIUL TURDA",55259,196,2,839,833,833,0,818,15,"MUNICIPIUL TURDA",,7,,353,465
13,"Cluj",127,"127-MUNICIPIUL TURDA",55259,197,2,0,248,0,248,248,0,"MUNICIPIUL TURDA",,7,,88,160
13,"Cluj",127,"127-ORAS CAMPIA TURZII",55357,198,2,1933,1504,1326,178,1494,10,"ORAS CAMPIA TURZII",,7,,604,890
13,"Cluj",127,"127-ORAS CAMPIA TURZII",55357,199,2,1919,1425,1291,134,1418,7,"ORAS CAMPIA TURZII",,7,,542,876
13,"Cluj",127,"127-ORAS CAMPIA TURZII",55357,200,2,1741,1267,1125,142,1249,18,"ORAS CAMPIA TURZII",,7,,553,696
13,"Cluj",127,"127-ORAS CAMPIA TURZII",55357,201,2,1615,1404,1205,199,1400,4,"ORAS CAMPIA TURZII",,7,,576,824
13,"Cluj",127,"127-ORAS CAMPIA TURZII",55357,202,2,1773,1403,1283,120,1398,5,"ORAS CAMPIA TURZII",,7,,565,833
13,"Cluj",127,"127-ORAS CAMPIA TURZII",55357,203,2,2265,1526,1353,173,1517,9,"ORAS CAMPIA TURZII",,7,,548,969
13,"Cluj",127,"127-ORAS CAMPIA TURZII",55357,204,2,1427,1038,925,113,1033,5,"ORAS CAMPIA TURZII",,7,,416,617
13,"Cluj",127,"127-ORAS CAMPIA TURZII",55357,205,2,1872,1377,1156,221,1374,3,"ORAS CAMPIA TURZII",,7,,387,987
13,"Cluj",127,"127-ORAS CAMPIA TURZII",55357,206,2,1670,1221,1058,163,1212,9,"ORAS CAMPIA TURZII",,7,,400,812
13,"Cluj",127,"127-ORAS CAMPIA TURZII",55357,207,2,2082,1634,1421,213,1633,1,"ORAS CAMPIA TURZII",,7,,641,992
13,"Cluj",127,"127-ORAS CAMPIA TURZII",55357,208,2,2038,1568,1413,155,1558,10,"ORAS CAMPIA TURZII",,7,,612,946
13,"Cluj",127,"127-ORAS CAMPIA TURZII",55357,209,2,2257,1730,1498,232,1720,10,"ORAS CAMPIA TURZII",,7,,649,1071
13,"Cluj",127,"127-ORAS GHERLA",55384,210,2,1610,1579,1134,445,1547,32,"ORAS GHERLA",,7,,527,1020
13,"Cluj",127,"127-ORAS GHERLA",55384,211,2,1482,1190,1084,106,1183,7,"ORAS GHERLA",,7,,406,777
13,"Cluj",127,"127-ORAS GHERLA",55384,212,2,1860,1346,1269,77,1343,3,"ORAS GHERLA",,7,,435,908
13,"Cluj",127,"127-ORAS GHERLA",55384,213,2,1829,1417,1337,80,1409,8,"ORAS GHERLA",,7,,482,927
13,"Cluj",127,"127-ORAS GHERLA",55384,214,2,1691,1403,1212,191,1396,7,"ORAS GHERLA",,7,,459,937
13,"Cluj",127,"127-ORAS GHERLA",55384,215,2,1690,1251,1156,95,1246,5,"ORAS GHERLA",,7,,372,874
13,"Cluj",127,"127-ORAS GHERLA",55384,216,2,1757,1518,1291,227,1510,8,"ORAS GHERLA",,7,,418,1092
13,"Cluj",127,"127-ORAS GHERLA",55384,217,2,2016,1499,1420,79,1496,3,"ORAS GHERLA",,7,,436,1060
13,"Cluj",127,"127-ORAS GHERLA",55384,218,2,1784,1414,1240,174,1408,6,"ORAS GHERLA",,7,,441,967
13,"Cluj",127,"127-ORAS GHERLA",55384,219,2,1718,1320,1248,72,1315,5,"ORAS GHERLA",,7,,348,967
13,"Cluj",127,"127-ORAS GHERLA",55384,220,2,326,291,218,73,287,4,"ORAS GHERLA",,7,,74,213
13,"Cluj",127,"127-ORAS GHERLA",55384,221,2,393,254,210,44,252,2,"ORAS GHERLA",,7,,88,164
13,"Cluj",127,"127-ORAS HUEDIN",55446,222,2,1896,1442,1302,140,1433,9,"ORAS HUEDIN",,7,,413,1020
13,"Cluj",127,"127-ORAS HUEDIN",55446,223,2,1499,1311,1064,247,1302,9,"ORAS HUEDIN",,7,,384,918
13,"Cluj",127,"127-ORAS HUEDIN",55446,224,2,1729,1626,1467,159,1460,7,"ORAS HUEDIN",,7,,473,987
13,"Cluj",127,"127-ORAS HUEDIN",55446,225,2,1314,1039,938,101,1027,12,"ORAS HUEDIN",,7,,270,757
13,"Cluj",127,"127-ORAS HUEDIN",55446,226,2,419,280,245,35,277,3,"ORAS HUEDIN",,7,,157,120
13,"Cluj",127,"127-ORAS HUEDIN",55446,227,2,411,372,340,32,369,3,"ORAS HUEDIN",,7,,11,358
13,"Cluj",127,"127-ORAS HUEDIN",55446,228,2,106,130,101,29,130,0,"ORAS HUEDIN",,7,,53,77
13,"Cluj",127,"127-AGHIRESU",55473,229,2,999,798,605,193,788,10,"AGHIRESU",,7,,249,539
13,"Cluj",127,"127-AGHIRESU",55473,230,2,1123,733,604,129,724,9,"AGHIRESU",,7,,199,525
13,"Cluj",127,"127-AGHIRESU",55473,231,2,1484,1000,856,144,997,3,"AGHIRESU",,7,,273,724
13,"Cluj",127,"127-AGHIRESU",55473,232,2,406,347,261,86,343,4,"AGHIRESU",,7,,15,328
13,"Cluj",127,"127-AGHIRESU",55473,233,2,382,348,325,23,348,0,"AGHIRESU",,7,,19,329
13,"Cluj",127,"127-AGHIRESU",55473,234,2,489,422,396,26,418,4,"AGHIRESU",,7,,11,407
13,"Cluj",127,"127-AGHIRESU",55473,235,2,636,505,469,36,502,3,"AGHIRESU",,7,,12,490
13,"Cluj",127,"127-AGHIRESU",55473,236,2,634,425,348,77,423,2,"AGHIRESU",,7,,284,139
13,"Cluj",127,"127-AITON",55598,237,2,644,549,488,61,542,7,"AITON",,7,,210,332
13,"Cluj",127,"127-AITON",55598,238,2,638,465,407,58,456,9,"AITON",,7,,130,326
13,"Cluj",127,"127-ALUNIS",55623,239,2,607,391,336,55,388,3,"ALUNIS",,7,,170,218
13,"Cluj",127,"127-ALUNIS",55623,240,2,436,238,209,29,236,2,"ALUNIS",,7,,116,120
13,"Cluj",127,"127-ALUNIS",55623,241,2,282,177,138,39,173,4,"ALUNIS",,7,,84,89
13,"Cluj",127,"127-APAHIDA",55687,242,2,1528,1135,920,215,1129,6,"APAHIDA",,7,,260,869
13,"Cluj",127,"127-APAHIDA",55687,243,2,1523,1071,848,223,1068,3,"APAHIDA",,7,,330,738
13,"Cluj",127,"127-APAHIDA",55687,244,2,421,294,257,37,290,4,"APAHIDA",,7,,137,153
13,"Cluj",127,"127-APAHIDA",55687,245,2,875,705,590,115,700,5,"APAHIDA",,7,,314,386
13,"Cluj",127,"127-APAHIDA",55687,246,2,484,449,343,106,449,0,"APAHIDA",,7,,159,290
13,"Cluj",127,"127-APAHIDA",55687,247,2,959,876,673,203,872,4,"APAHIDA",,7,,298,574
13,"Cluj",127,"127-ASCHILEU",55776,248,2,945,565,496,69,561,4,"ASCHILEU",,7,,275,286
13,"Cluj",127,"127-ASCHILEU",55776,249,2,309,244,195,49,242,2,"ASCHILEU",,7,,94,148
13,"Cluj",127,"127-ASCHILEU",55776,250,2,341,258,203,55,258,0,"ASCHILEU",,7,,101,157
13,"Cluj",127,"127-BACIU",55838,251,2,1706,1343,1094,249,1335,8,"BACIU",,7,,190,1145
13,"Cluj",127,"127-BACIU",55838,252,2,988,788,597,191,784,4,"BACIU",,7,,210,574
13,"Cluj",127,"127-BACIU",55838,253,2,658,523,438,85,516,7,"BACIU",,7,,215,301
13,"Cluj",127,"127-BACIU",55838,254,2,1167,1096,999,97,1094,2,"BACIU",,7,,57,1037
13,"Cluj",127,"127-BACIU",55838,255,2,494,387,345,42,380,7,"BACIU",,7,,153,227
13,"Cluj",127,"127-BACIU",55838,256,2,954,739,636,103,732,7,"BACIU",,7,,182,550
13,"Cluj",127,"127-BAISOARA",55918,257,2,839,634,581,53,626,8,"BAISOARA",,7,,327,299
13,"Cluj",127,"127-BAISOARA",55918,258,2,391,291,256,35,290,1,"BAISOARA",,7,,174,116
13,"Cluj",127,"127-BAISOARA",55918,259,2,488,286,262,24,280,6,"BAISOARA",,7,,119,161
13,"Cluj",127,"127-BAISOARA",55918,260,2,233,131,96,35,130,1,"BAISOARA",,7,,64,66
13,"Cluj",127,"127-BAISOARA",55918,261,2,27,84,22,62,84,0,"BAISOARA",,7,,23,61
13,"Cluj",127,"127-BELIS",56014,262,2,663,580,448,132,577,3,"BELIS",,7,,291,286
13,"Cluj",127,"127-BELIS",56014,263,2,72,69,53,16,68,1,"BELIS",,7,,32,36
13,"Cluj",127,"127-BELIS",56014,264,2,229,183,156,27,180,3,"BELIS",,7,,145,35
13,"Cluj",127,"127-BELIS",56014,265,2,336,296,239,57,296,0,"BELIS",,7,,225,71
13,"Cluj",127,"127-BOBALNA",56096,266,2,573,409,339,70,407,2,"BOBALNA",,7,,301,106
13,"Cluj",127,"127-BOBALNA",56096,267,2,482,382,329,53,378,4,"BOBALNA",,7,,254,124
13,"Cluj",127,"127-BOBALNA",56096,268,2,375,284,236,48,284,0,"BOBALNA",,7,,122,162
13,"Cluj",127,"127-BOBALNA",56096,269,2,280,183,108,75,180,3,"BOBALNA",,7,,121,59
13,"Cluj",127,"127-BONTIDA",56210,270,2,1873,1452,1200,252,1450,2,"BONTIDA",,7,,420,1030
13,"Cluj",127,"127-BONTIDA",56210,271,2,1099,910,773,137,903,7,"BONTIDA",,7,,353,550
13,"Cluj",127,"127-BONTIDA",56210,272,2,309,223,184,39,219,4,"BONTIDA",,7,,135,84
13,"Cluj",127,"127-BORSA",56265,273,2,1125,804,694,110,792,12,"BORSA",,7,,410,382
13,"Cluj",127,"127-BORSA",56265,274,2,201,185,148,37,183,2,"BORSA",,7,,99,84
13,"Cluj",127,"127-BORSA",56265,275,2,126,103,74,29,103,0,"BORSA",,7,,60,43
13,"Cluj",127,"127-BUZA",56327,276,2,1220,850,756,94,844,6,"BUZA",,7,,270,574
13,"Cluj",127,"127-CAIANU",56354,277,2,573,343,286,57,338,5,"CAIANU",,7,,161,177
13,"Cluj",127,"127-CAIANU",56354,278,2,254,183,143,40,175,8,"CAIANU",,7,,90,85
13,"Cluj",127,"127-CAIANU",56354,279,2,380,302,220,82,297,5,"CAIANU",,7,,136,161
13,"Cluj",127,"127-CAIANU",56354,280,2,796,751,668,83,743,8,"CAIANU",,7,,75,668
13,"Cluj",127,"127-CALARASI",56425,281,2,1087,876,788,88,869,7,"CALARASI",,7,,213,656
13,"Cluj",127,"127-CALARASI",56425,282,2,697,673,531,142,670,3,"CALARASI",,7,,346,324
13,"Cluj",127,"127-CALATELE",56461,283,2,980,723,626,97,712,11,"CALATELE",,7,,441,271
13,"Cluj",127,"127-CALATELE",56461,284,2,689,518,445,73,515,3,"CALATELE",,7,,192,323
13,"Cluj",127,"127-CALATELE",56461,285,2,615,471,353,118,469,2,"CALATELE",,7,,225,244
13,"Cluj",127,"127-CAMARASU",56522,286,2,1133,682,601,81,671,11,"CAMARASU",,7,,304,367
13,"Cluj",127,"127-CAMARASU",56522,287,2,510,384,345,39,378,6,"CAMARASU",,7,,279,99
13,"Cluj",127,"127-CAMARASU",56522,288,2,632,338,296,42,326,12,"CAMARASU",,7,,212,114
13,"Cluj",127,"127-CAPUSU MARE",56568,289,2,800,744,590,154,743,1,"CAPUSU MARE",,7,,80,663
13,"Cluj",127,"127-CAPUSU MARE",56568,290,2,719,563,482,81,558,5,"CAPUSU MARE",,7,,144,414
13,"Cluj",127,"127-CAPUSU MARE",56568,291,2,331,302,257,45,301,1,"CAPUSU MARE",,7,,71,230
13,"Cluj",127,"127-CAPUSU MARE",56568,292,2,345,278,228,50,271,7,"CAPUSU MARE",,7,,134,137
13,"Cluj",127,"127-CAPUSU MARE",56568,293,2,681,561,503,58,553,8,"CAPUSU MARE",,7,,361,192
13,"Cluj",127,"127-CAPUSU MARE",56568,294,2,506,416,375,41,413,3,"CAPUSU MARE",,7,,228,185
13,"Cluj",127,"127-CASEIU",56666,295,2,1362,945,838,107,939,6,"CASEIU",,7,,458,481
13,"Cluj",127,"127-CASEIU",56666,296,2,876,579,502,77,573,6,"CASEIU",,7,,230,343
13,"Cluj",127,"127-CASEIU",56666,297,2,288,250,206,44,249,1,"CASEIU",,7,,169,80
13,"Cluj",127,"127-CASEIU",56666,298,2,214,144,103,41,143,1,"CASEIU",,7,,51,92
13,"Cluj",127,"127-CASEIU",56666,299,2,180,130,73,57,125,5,"CASEIU",,7,,55,70
13,"Cluj",127,"127-CASEIU",56666,300,2,646,545,428,117,544,1,"CASEIU",,7,,285,259
13,"Cluj",127,"127-CATINA",56773,301,2,1193,823,751,72,813,10,"CATINA",,7,,495,318
13,"Cluj",127,"127-CATINA",56773,302,2,493,351,320,31,343,8,"CATINA",,7,,144,199
13,"Cluj",127,"127-CATINA",56773,303,2,152,122,109,13,119,3,"CATINA",,7,,69,50
13,"Cluj",127,"127-CEANU MARE",56844,304,2,1451,805,695,110,800,5,"CEANU MARE",,7,,319,481
13,"Cluj",127,"127-CEANU MARE",56844,305,2,893,622,544,78,618,4,"CEANU MARE",,7,,337,281
13,"Cluj",127,"127-CEANU MARE",56844,306,2,663,497,402,95,493,4,"CEANU MARE",,7,,302,191
13,"Cluj",127,"127-CEANU MARE",56844,307,2,649,407,348,59,402,5,"CEANU MARE",,7,,239,163
13,"Cluj",127,"127-CEANU MARE",56844,308,2,176,125,96,29,125,0,"CEANU MARE",,7,,82,43
13,"Cluj",127,"127-CHINTENI",56988,309,2,724,611,506,105,605,6,"CHINTENI",,7,,119,486
13,"Cluj",127,"127-CHINTENI",56988,310,2,668,654,531,123,639,15,"CHINTENI",,7,,241,398
13,"Cluj",127,"127-CHINTENI",56988,311,2,421,396,328,68,394,2,"CHINTENI",,7,,167,227
13,"Cluj",127,"127-CHINTENI",56988,312,2,530,391,289,102,385,6,"CHINTENI",,7,,196,189
13,"Cluj",127,"127-CHIUIESTI",57083,313,2,1312,903,796,107,899,4,"CHIUIESTI",,7,,403,496
13,"Cluj",127,"127-CHIUIESTI",57083,314,2,342,298,243,55,295,3,"CHIUIESTI",,7,,206,89
13,"Cluj",127,"127-CHIUIESTI",57083,315,2,520,339,270,69,337,2,"CHIUIESTI",,7,,219,118
13,"Cluj",127,"127-CIUCEA",57163,316,2,1080,701,579,122,696,5,"CIUCEA",,7,,398,298
13,"Cluj",127,"127-CIUCEA",57163,317,2,1523,953,830,123,944,9,"CIUCEA",,7,,484,460
13,"Cluj",127,"127-CIUCEA",57163,318,2,604,478,375,103,477,1,"CIUCEA",,7,,154,323
13,"Cluj",127,"127-CIUCEA",57163,319,2,413,284,248,36,282,2,"CIUCEA",,7,,113,169
13,"Cluj",127,"127-CIURILA",57225,320,2,188,156,118,38,153,3,"CIURILA",,7,,71,82
13,"Cluj",127,"127-CIURILA",57225,321,2,231,170,142,28,168,2,"CIURILA",,7,,83,85
13,"Cluj",127,"127-CIURILA",57225,322,2,354,253,194,59,250,3,"CIURILA",,7,,145,105
13,"Cluj",127,"127-CIURILA",57225,323,2,477,352,303,49,343,9,"CIURILA",,7,,216,127
13,"Cluj",127,"127-CIURILA",57225,324,2,119,117,84,33,116,1,"CIURILA",,7,,29,87
13,"Cluj",127,"127-CATCAU",57314,325,2,1171,993,791,202,981,12,"CATCAU",,7,,559,422
13,"Cluj",127,"127-CATCAU",57314,326,2,490,358,321,37,353,5,"CATCAU",,7,,162,191
13,"Cluj",127,"127-CATCAU",57314,327,2,227,166,138,28,165,1,"CATCAU",,7,,94,71
13,"Cluj",127,"127-COJOCNA",57350,328,2,1748,1348,1126,222,1323,25,"COJOCNA",,7,,292,1031
13,"Cluj",127,"127-COJOCNA",57350,329,2,629,445,385,60,442,3,"COJOCNA",,7,,234,208
13,"Cluj",127,"127-COJOCNA",57350,330,2,553,467,368,99,460,7,"COJOCNA",,7,,139,321
13,"Cluj",127,"127-COJOCNA",57350,331,2,529,354,319,35,352,2,"COJOCNA",,7,,181,171
13,"Cluj",127,"127-COJOCNA",57350,332,2,61,97,34,63,97,0,"COJOCNA",,7,,38,59
13,"Cluj",127,"127-CORNESTI",55302,333,2,403,341,247,94,340,1,"CORNESTI",,7,,179,161
13,"Cluj",127,"127-CORNESTI",55302,334,2,483,309,256,53,309,0,"CORNESTI",,7,,191,118
13,"Cluj",127,"127-CORNESTI",55302,335,2,491,270,234,36,267,3,"CORNESTI",,7,,147,120
13,"Cluj",127,"127-CORNESTI",55302,336,2,384,276,206,70,271,5,"CORNESTI",,7,,136,135
13,"Cluj",127,"127-CUZDRIOARA",55062,337,2,1670,1271,1186,85,1266,5,"CUZDRIOARA",,7,,564,702
13,"Cluj",127,"127-CUZDRIOARA",55062,338,2,495,374,337,37,371,3,"CUZDRIOARA",,7,,178,193
13,"Cluj",127,"127-DABACA",57546,339,2,736,547,462,85,540,7,"DABACA",,7,,323,217
13,"Cluj",127,"127-DABACA",57546,340,2,520,459,368,91,458,1,"DABACA",,7,,170,288
13,"Cluj",127,"127-DABACA",57546,341,2,153,152,121,31,149,3,"DABACA",,7,,76,73
13,"Cluj",127,"127-FELEACU",57582,342,2,1511,968,898,70,959,9,"FELEACU",,7,,334,625
13,"Cluj",127,"127-FELEACU",57582,343,2,985,769,684,85,769,0,"FELEACU",,7,,17,752
13,"Cluj",127,"127-FELEACU",57582,344,2,821,545,461,84,533,12,"FELEACU",,7,,153,380
13,"Cluj",127,"127-FIZESU GHERLII",57644,345,2,1088,836,736,100,824,12,"FIZESU GHERLII",,7,,162,662
13,"Cluj",127,"127-FIZESU GHERLII",57644,346,2,450,381,314,67,377,4,"FIZESU GHERLII",,7,,155,222
13,"Cluj",127,"127-FIZESU GHERLII",57644,347,2,306,232,187,45,226,6,"FIZESU GHERLII",,7,,78,148
13,"Cluj",127,"127-FIZESU GHERLII",57644,348,2,199,185,132,53,180,5,"FIZESU GHERLII",,7,,93,87
13,"Cluj",127,"127-FLORESTI",57706,349,2,2324,1815,1529,286,1801,14,"FLORESTI",,7,,432,1369
13,"Cluj",127,"127-FLORESTI",57706,350,2,772,633,496,137,630,3,"FLORESTI",,7,,197,433
13,"Cluj",127,"127-FLORESTI",57706,351,2,863,687,667,20,675,12,"FLORESTI",,7,,325,350
13,"Cluj",127,"127-FLORESTI",57706,352,2,1591,1255,1067,188,1246,9,"FLORESTI",,7,,182,1064
13,"Cluj",127,"127-FLORESTI",57706,353,2,163,149,96,53,147,2,"FLORESTI",,7,,54,93
13,"Cluj",127,"127-FRATA",57742,354,2,1772,1230,982,248,1215,15,"FRATA",,7,,651,564
13,"Cluj",127,"127-FRATA",57742,355,2,580,398,323,75,394,4,"FRATA",,7,,243,151
13,"Cluj",127,"127-FRATA",57742,356,2,239,157,118,39,157,0,"FRATA",,7,,74,83
13,"Cluj",127,"127-FRATA",57742,357,2,960,588,484,104,573,15,"FRATA",,7,,362,211
13,"Cluj",127,"127-GEACA",57831,358,2,595,434,383,51,420,14,"GEACA",,7,,205,215
13,"Cluj",127,"127-GEACA",57831,359,2,549,319,278,41,318,1,"GEACA",,7,,179,139
13,"Cluj",127,"127-GEACA",57831,360,2,304,251,213,38,251,0,"GEACA",,7,,81,170
13,"Cluj",127,"127-GEACA",57831,361,2,207,167,144,23,161,6,"GEACA",,7,,102,59
13,"Cluj",127,"127-GILAU",57902,362,2,1992,1332,1035,297,1325,7,"GILAU",,7,,497,828
13,"Cluj",127,"127-GILAU",57902,363,2,2071,1538,1018,520,1529,9,"GILAU",,7,,474,1055
13,"Cluj",127,"127-GILAU",57902,364,2,1053,884,583,301,879,5,"GILAU",,7,,445,434
13,"Cluj",127,"127-GILAU",57902,365,2,495,278,239,39,274,4,"GILAU",,7,,162,112
13,"Cluj",127,"127-GARBAU",57948,366,2,1128,865,754,111,860,5,"GARBAU",,7,,238,622
13,"Cluj",127,"127-GARBAU",57948,367,2,937,889,771,118,882,7,"GARBAU",,7,,169,713
13,"Cluj",127,"127-IARA",58008,368,2,1791,1090,1017,73,1083,7,"IARA",,7,,563,520
13,"Cluj",127,"127-IARA",58008,369,2,494,260,239,21,258,2,"IARA",,7,,117,141
13,"Cluj",127,"127-IARA",58008,370,2,282,203,176,27,199,4,"IARA",,7,,103,96
13,"Cluj",127,"127-IARA",58008,371,2,90,98,71,27,97,1,"IARA",,7,,78,19
13,"Cluj",127,"127-IARA",58008,372,2,730,553,523,30,551,2,"IARA",,7,,372,179
13,"Cluj",127,"127-IARA",58008,373,2,175,125,104,21,124,1,"IARA",,7,,31,93
13,"Cluj",127,"127-IARA",58008,374,2,409,256,225,31,251,5,"IARA",,7,,137,114
13,"Cluj",127,"127-ICLOD",58142,375,2,1550,1141,955,186,1126,15,"ICLOD",,7,,398,728
13,"Cluj",127,"127-ICLOD",58142,376,2,597,428,391,37,418,10,"ICLOD",,7,,207,211
13,"Cluj",127,"127-ICLOD",58142,377,2,636,498,411,87,494,4,"ICLOD",,7,,225,269
13,"Cluj",127,"127-ICLOD",58142,378,2,664,390,347,43,384,6,"ICLOD",,7,,122,262
13,"Cluj",127,"127-IZVORU CRISULUI",58204,379,2,1115,971,810,161,966,5,"IZVORU CRISULUI",,7,,21,945
13,"Cluj",127,"127-IZVORU CRISULUI",58204,380,2,278,287,230,57,286,1,"IZVORU CRISULUI",,7,,129,157
13,"Cluj",127,"127-JICHISU DE JOS",55106,381,2,505,361,317,44,358,3,"JICHISU DE JOS",,7,,197,161
13,"Cluj",127,"127-JICHISU DE JOS",55106,382,2,310,231,198,33,230,1,"JICHISU DE JOS",,7,,115,115
13,"Cluj",127,"127-JICHISU DE JOS",55106,383,2,332,278,248,30,277,1,"JICHISU DE JOS",,7,,159,118
13,"Cluj",127,"127-JUCU",58259,384,2,1266,1135,727,408,1127,8,"JUCU",,7,,529,598
13,"Cluj",127,"127-JUCU",58259,385,2,673,384,322,62,378,6,"JUCU",,7,,150,228
13,"Cluj",127,"127-JUCU",58259,386,2,604,434,350,84,428,6,"JUCU",,7,,229,199
13,"Cluj",127,"127-JUCU",58259,387,2,516,409,344,65,409,0,"JUCU",,7,,62,347
13,"Cluj",127,"127-LUNA",58311,388,2,2619,2167,1980,187,2149,18,"LUNA",,7,,1019,1130
13,"Cluj",127,"127-LUNA",58311,389,2,1047,928,741,187,924,4,"LUNA",,7,,377,547
13,"Cluj",127,"127-LUNA",58311,390,2,408,381,290,91,379,2,"LUNA",,7,,129,250
13,"Cluj",127,"127-MAGURI-RACATAU",58357,391,2,621,403,303,100,395,8,"MAGURI-RACATAU",,7,,214,181
13,"Cluj",127,"127-MAGURI-RACATAU",58357,392,2,743,429,354,75,426,3,"MAGURI-RACATAU",,7,,233,193
13,"Cluj",127,"127-MAGURI-RACATAU",58357,393,2,518,271,190,81,267,4,"MAGURI-RACATAU",,7,,162,105
13,"Cluj",127,"127-MANASTIRENI",58393,394,2,1121,867,721,146,864,3,"MANASTIRENI",,7,,357,507
13,"Cluj",127,"127-MANASTIRENI",58393,395,2,578,466,423,43,462,4,"MANASTIRENI",,7,,325,137
13,"Cluj",127,"127-MARGAU",58464,396,2,455,384,329,55,382,2,"MARGAU",,7,,139,243
13,"Cluj",127,"127-MARGAU",58464,397,2,756,540,430,110,538,2,"MARGAU",,7,,303,235
13,"Cluj",127,"127-MARGAU",58464,398,2,151,147,96,51,144,3,"MARGAU",,7,,55,89
13,"Cluj",127,"127-MARGAU",58464,399,2,252,173,131,42,171,2,"MARGAU",,7,,93,78
13,"Cluj",127,"127-MARISEL",58534,400,2,1205,579,495,84,575,4,"MARISEL",,7,,358,217
13,"Cluj",127,"127-MARISEL",58534,401,2,131,176,61,115,174,2,"MARISEL",,7,,70,104
13,"Cluj",127,"127-MICA",55160,402,2,710,628,544,84,621,7,"MICA",,7,,265,356
13,"Cluj",127,"127-MICA",55160,403,2,491,417,347,70,415,2,"MICA",,7,,248,167
13,"Cluj",127,"127-MICA",55160,404,2,955,710,580,130,699,11,"MICA",,7,,138,561
13,"Cluj",127,"127-MICA",55160,405,2,900,649,560,89,640,9,"MICA",,7,,207,433
13,"Cluj",127,"127-MIHAI VITEAZU",55277,406,2,2229,1674,1543,131,1659,15,"MIHAI VITEAZU",,7,,540,1119
13,"Cluj",127,"127-MIHAI VITEAZU",55277,407,2,1162,866,798,68,858,8,"MIHAI VITEAZU",,7,,228,630
13,"Cluj",127,"127-MIHAI VITEAZU",55277,408,2,448,369,314,55,360,9,"MIHAI VITEAZU",,7,,91,269
13,"Cluj",127,"127-MIHAI VITEAZU",55277,409,2,561,496,447,49,490,6,"MIHAI VITEAZU",,7,,111,379
13,"Cluj",127,"127-MINTIU GHERLII",58552,410,2,1615,1053,948,105,1045,8,"MINTIU GHERLII",,7,,583,462
13,"Cluj",127,"127-MINTIU GHERLII",58552,411,2,665,485,434,51,481,4,"MINTIU GHERLII",,7,,134,347
13,"Cluj",127,"127-MINTIU GHERLII",58552,412,2,601,484,414,70,478,6,"MINTIU GHERLII",,7,,226,252
13,"Cluj",127,"127-MOCIU",58623,413,2,1354,957,799,158,940,17,"MOCIU",,7,,475,465
13,"Cluj",127,"127-MOCIU",58623,414,2,292,154,120,34,148,6,"MOCIU",,7,,47,101
13,"Cluj",127,"127-MOCIU",58623,415,2,347,253,229,24,251,2,"MOCIU",,7,,19,232
13,"Cluj",127,"127-MOCIU",58623,416,2,262,201,168,33,199,2,"MOCIU",,7,,131,68
13,"Cluj",127,"127-MOCIU",58623,417,2,342,258,209,49,254,4,"MOCIU",,7,,128,126
13,"Cluj",127,"127-MOCIU",58623,418,2,181,149,122,27,148,1,"MOCIU",,7,,78,70
13,"Cluj",127,"127-MOCIU",58623,419,2,242,165,138,27,164,1,"MOCIU",,7,,81,83
13,"Cluj",127,"127-MOLDOVENESTI",58721,420,2,1091,977,886,91,967,10,"MOLDOVENESTI",,7,,116,851
13,"Cluj",127,"127-MOLDOVENESTI",58721,421,2,665,514,457,57,506,8,"MOLDOVENESTI",,7,,231,275
13,"Cluj",127,"127-MOLDOVENESTI",58721,422,2,430,487,408,79,482,5,"MOLDOVENESTI",,7,,20,462
13,"Cluj",127,"127-MOLDOVENESTI",58721,423,2,594,563,513,50,561,2,"MOLDOVENESTI",,7,,71,490
13,"Cluj",127,"127-MOLDOVENESTI",58721,424,2,182,178,156,22,177,1,"MOLDOVENESTI",,7,,26,151
13,"Cluj",127,"127-PALATCA",58794,425,2,957,598,518,80,593,5,"PALATCA",,7,,267,326
13,"Cluj",127,"127-PALATCA",58794,426,2,447,230,182,48,224,6,"PALATCA",,7,,158,66
13,"Cluj",127,"127-PANTICEU",58856,427,2,535,391,300,91,387,4,"PANTICEU",,7,,216,171
13,"Cluj",127,"127-PANTICEU",58856,428,2,195,191,143,48,191,0,"PANTICEU",,7,,87,104
13,"Cluj",127,"127-PANTICEU",58856,429,2,474,277,217,60,274,3,"PANTICEU",,7,,125,149
13,"Cluj",127,"127-PANTICEU",58856,430,2,341,176,125,51,170,6,"PANTICEU",,7,,41,129
13,"Cluj",127,"127-PETRESTII DE JOS",58918,431,2,1199,817,722,95,811,6,"PETRESTII DE JOS",,7,,344,467
13,"Cluj",127,"127-PETRESTII DE JOS",58918,432,2,211,174,128,46,171,3,"PETRESTII DE JOS",,7,,86,85
13,"Cluj",127,"127-PETRESTII DE JOS",58918,433,2,387,288,220,68,287,1,"PETRESTII DE JOS",,7,,122,165
13,"Cluj",127,"127-PLOSCOS",58990,434,2,707,419,340,79,414,5,"PLOSCOS",,7,,159,255
13,"Cluj",127,"127-POIENI",59041,435,2,1001,780,692,88,774,6,"POIENI",,7,,372,402
13,"Cluj",127,"127-POIENI",59041,436,2,593,517,430,87,515,2,"POIENI",,7,,330,185
13,"Cluj",127,"127-POIENI",59041,437,2,771,656,573,83,645,11,"POIENI",,7,,385,260
13,"Cluj",127,"127-POIENI",59041,438,2,449,332,263,69,328,4,"POIENI",,7,,135,193
13,"Cluj",127,"127-POIENI",59041,439,2,1524,1104,961,143,1094,10,"POIENI",,7,,722,372
13,"Cluj",127,"127-POIENI",59041,440,2,516,288,235,53,288,0,"POIENI",,7,,198,90
13,"Cluj",127,"127-POIENI",59041,441,2,282,197,153,44,196,1,"POIENI",,7,,141,55
13,"Cluj",127,"127-RECEA-CRISTUR",59130,442,2,785,492,409,83,484,8,"RECEA-CRISTUR",,7,,161,323
13,"Cluj",127,"127-RECEA-CRISTUR",59130,443,2,710,563,491,72,559,4,"RECEA-CRISTUR",,7,,366,193
13,"Cluj",127,"127-RISCA",59238,444,2,1265,648,594,54,641,7,"RISCA",,7,,335,306
13,"Cluj",127,"127-RISCA",59238,445,2,461,279,246,33,277,2,"RISCA",,7,,177,100
13,"Cluj",127,"127-SACUIEU",59283,446,2,413,288,252,36,284,4,"SACUIEU",,7,,194,90
13,"Cluj",127,"127-SACUIEU",59283,447,2,614,411,372,39,407,4,"SACUIEU",,7,,275,132
13,"Cluj",127,"127-SACUIEU",59283,448,2,334,231,205,26,226,5,"SACUIEU",,7,,139,87
13,"Cluj",127,"127-SANDULESTI",55311,449,2,455,434,368,66,428,6,"SANDULESTI",,7,,171,257
13,"Cluj",127,"127-SANDULESTI",55311,450,2,872,801,693,108,794,7,"SANDULESTI",,7,,300,494
13,"Cluj",127,"127-SAVADISLA",59327,451,2,848,831,698,133,826,5,"SAVADISLA",,7,,19,807
13,"Cluj",127,"127-SAVADISLA",59327,452,2,640,503,430,73,498,5,"SAVADISLA",,7,,288,210
13,"Cluj",127,"127-SAVADISLA",59327,453,2,508,392,343,49,389,3,"SAVADISLA",,7,,155,234
13,"Cluj",127,"127-SAVADISLA",59327,454,2,283,269,226,43,267,2,"SAVADISLA",,7,,114,153
13,"Cluj",127,"127-SAVADISLA",59327,455,2,403,358,334,24,357,1,"SAVADISLA",,7,,16,341
13,"Cluj",127,"127-SAVADISLA",59327,456,2,210,205,170,35,203,2,"SAVADISLA",,7,,94,109
13,"Cluj",127,"127-SAVADISLA",59327,457,2,98,110,90,20,109,1,"SAVADISLA",,7,,56,53
13,"Cluj",127,"127-SAVADISLA",59327,458,2,667,663,590,73,662,1,"SAVADISLA",,7,,16,646
13,"Cluj",127,"127-SIC",59416,459,2,2505,2455,2418,37,2439,16,"SIC",,7,,65,2374
13,"Cluj",127,"127-SANCRAIU",59434,460,2,1596,1239,1150,89,1236,3,"SANCRAIU",,7,,198,1038
13,"Cluj",127,"127-SANMARTIN",57065,461,2,599,412,346,66,409,3,"SANMARTIN",,7,,182,227
13,"Cluj",127,"127-SANMARTIN",57065,462,2,276,230,195,35,226,4,"SANMARTIN",,7,,117,109
13,"Cluj",127,"127-SANMARTIN",57065,463,2,499,362,327,35,359,3,"SANMARTIN",,7,,251,108
13,"Cluj",127,"127-SANMARTIN",57065,464,2,440,408,351,57,401,7,"SANMARTIN",,7,,274,127
13,"Cluj",127,"127-SANPAUL",59586,465,2,1115,772,669,103,767,5,"SANPAUL",,7,,257,510
13,"Cluj",127,"127-SANPAUL",59586,466,2,859,571,489,82,569,2,"SANPAUL",,7,,266,303
13,"Cluj",127,"127-SUATU",59657,467,2,1372,1064,922,142,1054,10,"SUATU",,7,,164,890
13,"Cluj",127,"127-SUATU",59657,468,2,443,303,250,53,294,9,"SUATU",,7,,179,115
13,"Cluj",127,"127-TRITENII DE JOS",59693,469,2,1720,1031,953,78,1021,10,"TRITENII DE JOS",,7,,429,592
13,"Cluj",127,"127-TRITENII DE JOS",59693,470,2,998,681,583,98,677,4,"TRITENII DE JOS",,7,,372,305
13,"Cluj",127,"127-TRITENII DE JOS",59693,471,2,1143,575,557,18,569,6,"TRITENII DE JOS",,7,,339,230
13,"Cluj",127,"127-TRITENII DE JOS",59693,472,2,392,329,292,37,329,0,"TRITENII DE JOS",,7,,40,289
13,"Cluj",127,"127-TURENI",59764,473,2,756,573,508,65,568,5,"TURENI",,7,,121,447
13,"Cluj",127,"127-TURENI",59764,474,2,404,283,262,21,279,4,"TURENI",,7,,131,148
13,"Cluj",127,"127-TURENI",59764,475,2,422,362,307,55,361,1,"TURENI",,7,,111,250
13,"Cluj",127,"127-TURENI",59764,476,2,432,326,279,47,324,2,"TURENI",,7,,110,214
13,"Cluj",127,"127-TAGA",59826,477,2,712,625,544,81,621,4,"TAGA",,7,,375,246
13,"Cluj",127,"127-TAGA",59826,478,2,481,388,342,46,383,5,"TAGA",,7,,229,154
13,"Cluj",127,"127-TAGA",59826,479,2,460,374,305,69,368,6,"TAGA",,7,,207,161
13,"Cluj",127,"127-TAGA",59826,480,2,318,211,178,33,208,3,"TAGA",,7,,112,96
13,"Cluj",127,"127-UNGURAS",59880,481,2,1695,1142,1088,54,1115,27,"UNGURAS",,7,,151,964
13,"Cluj",127,"127-UNGURAS",59880,482,2,834,536,483,53,524,12,"UNGURAS",,7,,215,309
13,"Cluj",127,"127-UNGURAS",59880,483,2,266,192,160,32,189,3,"UNGURAS",,7,,77,112
13,"Cluj",127,"127-VAD",59942,484,2,540,439,383,56,431,8,"VAD",,7,,250,181
13,"Cluj",127,"127-VAD",59942,485,2,876,585,546,39,583,2,"VAD",,7,,311,272
13,"Cluj",127,"127-VAD",59942,486,2,475,393,357,36,389,4,"VAD",,7,,240,149
13,"Cluj",127,"127-VALEA IERII",60026,487,2,789,573,505,68,570,3,"VALEA IERII",,7,,336,234
13,"Cluj",127,"127-VIISOARA",60062,488,2,1622,1269,1047,222,1262,7,"VIISOARA",,7,,219,1043
13,"Cluj",127,"127-VIISOARA",60062,489,2,1753,1650,1295,355,1632,18,"VIISOARA",,7,,661,971
13,"Cluj",127,"127-VIISOARA",60062,490,2,907,667,585,82,661,6,"VIISOARA",,7,,274,387
13,"Cluj",127,"127-VULTURENI",60099,491,2,358,281,240,41,280,1,"VULTURENI",,7,,142,138
13,"Cluj",127,"127-VULTURENI",60099,492,2,153,129,106,23,128,1,"VULTURENI",,7,,79,49
13,"Cluj",127,"127-VULTURENI",60099,493,2,151,215,145,70,214,1,"VULTURENI",,7,,10,204
13,"Cluj",127,"127-VULTURENI",60099,494,2,239,170,145,25,166,4,"VULTURENI",,7,,63,103
13,"Cluj",127,"127-VULTURENI",60099,495,2,488,445,360,85,443,2,"VULTURENI",,7,,256,187
14,"Constanța",136,"136-MUNICIPIUL CONSTANTA",60419,1,2,1032,860,790,70,858,2,"MUNICIPIUL CONSTANTA",,3,,369,489
14,"Constanța",136,"136-MUNICIPIUL CONSTANTA",60419,2,2,912,720,641,79,716,4,"MUNICIPIUL CONSTANTA",,3,,262,454
14,"Constanța",136,"136-MUNICIPIUL CONSTANTA",60419,3,2,1199,1075,843,232,1066,9,"MUNICIPIUL CONSTANTA",,3,,365,701
14,"Constanța",136,"136-MUNICIPIUL CONSTANTA",60419,4,2,1027,971,753,218,966,5,"MUNICIPIUL CONSTANTA",,3,,417,549
14,"Constanța",136,"136-MUNICIPIUL CONSTANTA",60419,5,2,781,666,576,90,665,1,"MUNICIPIUL CONSTANTA",,3,,206,459
14,"Constanța",136,"136-MUNICIPIUL CONSTANTA",60419,6,2,632,540,469,71,538,2,"MUNICIPIUL CONSTANTA",,3,,223,315
14,"Constanța",136,"136-MUNICIPIUL CONSTANTA",60419,7,2,1677,1243,1139,104,1235,8,"MUNICIPIUL CONSTANTA",,3,,348,887
14,"Constanța",136,"136-MUNICIPIUL CONSTANTA",60419,8,2,1198,945,866,79,942,3,"MUNICIPIUL CONSTANTA",,3,,316,626
14,"Constanța",136,"136-MUNICIPIUL CONSTANTA",60419,9,2,1832,1461,1311,150,1451,10,"MUNICIPIUL CONSTANTA",,3,,414,1037
14,"Constanța",136,"136-MUNICIPIUL CONSTANTA",60419,10,2,1686,1337,1219,118,1329,8,"MUNICIPIUL CONSTANTA",,3,,465,864
14,"Constanța",136,"136-MUNICIPIUL CONSTANTA",60419,11,2,1731,1505,1254,251,1496,9,"MUNICIPIUL CONSTANTA",,3,,620,876
14,"Constanța",136,"136-MUNICIPIUL CONSTANTA",60419,12,2,1619,1243,1101,142,1236,7,"MUNICIPIUL CONSTANTA",,3,,408,828
14,"Constanța",136,"136-MUNICIPIUL CONSTANTA",60419,13,2,923,824,742,82,823,1,"MUNICIPIUL CONSTANTA",,3,,412,411
14,"Constanța",136,"136-MUNICIPIUL CONSTANTA",60419,14,2,1039,889,816,73,886,3,"MUNICIPIUL CONSTANTA",,3,,341,545
14,"Constanța",136,"136-MUNICIPIUL CONSTANTA",60419,15,2,1190,962,860,102,956,6,"MUNICIPIUL CONSTANTA",,3,,444,512
14,"Constanța",136,"136-MUNICIPIUL CONSTANTA",60419,16,2,1017,724,669,55,719,5,"MUNICIPIUL CONSTANTA",,3,,291,428
14,"Constanța",136,"136-MUNICIPIUL CONSTANTA",60419,17,2,1033,861,786,75,786,3,"MUNICIPIUL CONSTANTA",,3,,228,558
14,"Constanța",136,"136-MUNICIPIUL CONSTANTA",60419,18,2,1159,984,795,189,975,9,"MUNICIPIUL CONSTANTA",,3,,302,673
14,"Constanța",136,"136-MUNICIPIUL CONSTANTA",60419,19,2,1485,1180,1011,169,1175,5,"MUNICIPIUL CONSTANTA",,3,,336,839
14,"Constanța",136,"136-MUNICIPIUL CONSTANTA",60419,20,2,1382,1255,1029,226,1252,3,"MUNICIPIUL CONSTANTA",,3,,396,856
14,"Constanța",136,"136-MUNICIPIUL CONSTANTA",60419,21,2,1507,1189,1091,98,1186,3,"MUNICIPIUL CONSTANTA",,3,,399,787
14,"Constanța",136,"136-MUNICIPIUL CONSTANTA",60419,22,2,1847,1202,1130,72,1201,1,"MUNICIPIUL CONSTANTA",,3,,340,861
14,"Constanța",136,"136-MUNICIPIUL CONSTANTA",60419,23,2,1345,1009,929,80,1006,3,"MUNICIPIUL CONSTANTA",,3,,378,628
14,"Constanța",136,"136-MUNICIPIUL CONSTANTA",60419,24,2,1583,1226,1144,82,1219,7,"MUNICIPIUL CONSTANTA",,3,,422,797
14,"Constanța",136,"136-MUNICIPIUL CONSTANTA",60419,25,2,1016,929,727,202,925,4,"MUNICIPIUL CONSTANTA",,3,,295,630
14,"Constanța",136,"136-MUNICIPIUL CONSTANTA",60419,26,2,1757,1442,1319,123,1440,2,"MUNICIPIUL CONSTANTA",,3,,443,997
14,"Constanța",136,"136-MUNICIPIUL CONSTANTA",60419,27,2,1856,1265,1178,87,1259,6,"MUNICIPIUL CONSTANTA",,3,,494,765
14,"Constanța",136,"136-MUNICIPIUL CONSTANTA",60419,28,2,1889,1346,1226,120,1340,6,"MUNICIPIUL CONSTANTA",,3,,524,816
14,"Constanța",136,"136-MUNICIPIUL CONSTANTA",60419,29,2,1354,1175,1000,175,1175,0,"MUNICIPIUL CONSTANTA",,3,,479,696
14,"Constanța",136,"136-MUNICIPIUL CONSTANTA",60419,30,2,722,885,507,378,884,1,"MUNICIPIUL CONSTANTA",,3,,272,612
14,"Constanța",136,"136-MUNICIPIUL CONSTANTA",60419,31,2,1148,933,799,134,930,3,"MUNICIPIUL CONSTANTA",,3,,293,637
14,"Constanța",136,"136-MUNICIPIUL CONSTANTA",60419,32,2,940,759,659,100,757,2,"MUNICIPIUL CONSTANTA",,3,,253,504
14,"Constanța",136,"136-MUNICIPIUL CONSTANTA",60419,33,2,1482,1196,987,209,1191,5,"MUNICIPIUL CONSTANTA",,3,,399,792
14,"Constanța",136,"136-MUNICIPIUL CONSTANTA",60419,34,2,1511,1255,1061,194,1238,17,"MUNICIPIUL CONSTANTA",,3,,502,736
14,"Constanța",136,"136-MUNICIPIUL CONSTANTA",60419,35,2,1465,1260,1003,257,1255,5,"MUNICIPIUL CONSTANTA",,3,,428,827
14,"Constanța",136,"136-MUNICIPIUL CONSTANTA",60419,36,2,1400,1159,1025,134,1153,6,"MUNICIPIUL CONSTANTA",,3,,376,777
14,"Constanța",136,"136-MUNICIPIUL CONSTANTA",60419,37,2,2015,1739,1239,500,1729,10,"MUNICIPIUL CONSTANTA",,3,,465,1264
14,"Constanța",136,"136-MUNICIPIUL CONSTANTA",60419,38,2,2049,876,678,198,869,7,"MUNICIPIUL CONSTANTA",,3,,241,628
14,"Constanța",136,"136-MUNICIPIUL CONSTANTA",60419,39,2,1688,1272,1154,118,1260,12,"MUNICIPIUL CONSTANTA",,3,,429,831
14,"Constanța",136,"136-MUNICIPIUL CONSTANTA",60419,40,2,1844,1689,1172,517,1683,6,"MUNICIPIUL CONSTANTA",,3,,497,1186
14,"Constanța",136,"136-MUNICIPIUL CONSTANTA",60419,41,2,1673,1301,1117,184,1288,13,"MUNICIPIUL CONSTANTA",,3,,424,864
14,"Constanța",136,"136-MUNICIPIUL CONSTANTA",60419,42,2,1460,1044,959,85,1036,8,"MUNICIPIUL CONSTANTA",,3,,323,713
14,"Constanța",136,"136-MUNICIPIUL CONSTANTA",60419,43,2,1231,845,773,72,841,4,"MUNICIPIUL CONSTANTA",,3,,276,565
14,"Constanța",136,"136-MUNICIPIUL CONSTANTA",60419,44,2,1396,981,918,63,974,7,"MUNICIPIUL CONSTANTA",,3,,306,668
14,"Constanța",136,"136-MUNICIPIUL CONSTANTA",60419,45,2,1746,1470,1261,209,1463,7,"MUNICIPIUL CONSTANTA",,3,,594,869
14,"Constanța",136,"136-MUNICIPIUL CONSTANTA",60419,46,2,1653,1307,1142,165,1288,19,"MUNICIPIUL CONSTANTA",,3,,441,847
14,"Constanța",136,"136-MUNICIPIUL CONSTANTA",60419,47,2,1991,1518,1333,185,1504,14,"MUNICIPIUL CONSTANTA",,3,,519,985
14,"Constanța",136,"136-MUNICIPIUL CONSTANTA",60419,48,2,2040,1492,1365,127,1482,10,"MUNICIPIUL CONSTANTA",,3,,514,968
14,"Constanța",136,"136-MUNICIPIUL CONSTANTA",60419,49,2,2095,1337,1189,148,1321,16,"MUNICIPIUL CONSTANTA",,3,,461,860
14,"Constanța",136,"136-MUNICIPIUL CONSTANTA",60419,50,2,1306,972,861,111,970,2,"MUNICIPIUL CONSTANTA",,3,,393,577
14,"Constanța",136,"136-MUNICIPIUL CONSTANTA",60419,51,2,1487,1159,1045,114,1158,1,"MUNICIPIUL CONSTANTA",,3,,421,737
14,"Constanța",136,"136-MUNICIPIUL CONSTANTA",60419,52,2,1434,1096,985,111,1092,4,"MUNICIPIUL CONSTANTA",,3,,413,679
14,"Constanța",136,"136-MUNICIPIUL CONSTANTA",60419,53,2,1170,886,840,46,883,3,"MUNICIPIUL CONSTANTA",,3,,361,522
14,"Constanța",136,"136-MUNICIPIUL CONSTANTA",60419,54,2,1222,1040,826,214,1022,9,"MUNICIPIUL CONSTANTA",,3,,353,669
14,"Constanța",136,"136-MUNICIPIUL CONSTANTA",60419,55,2,1486,1075,1000,75,1066,9,"MUNICIPIUL CONSTANTA",,3,,380,686
14,"Constanța",136,"136-MUNICIPIUL CONSTANTA",60419,56,2,1355,1045,903,142,1034,11,"MUNICIPIUL CONSTANTA",,3,,403,631
14,"Constanța",136,"136-MUNICIPIUL CONSTANTA",60419,57,2,1214,894,839,55,891,3,"MUNICIPIUL CONSTANTA",,3,,290,601
14,"Constanța",136,"136-MUNICIPIUL CONSTANTA",60419,58,2,1118,875,753,122,872,3,"MUNICIPIUL CONSTANTA",,3,,319,553
14,"Constanța",136,"136-MUNICIPIUL CONSTANTA",60419,59,2,952,576,478,98,573,3,"MUNICIPIUL CONSTANTA",,3,,188,385
14,"Constanța",136,"136-MUNICIPIUL CONSTANTA",60419,60,2,1610,1241,1120,121,1240,1,"MUNICIPIUL CONSTANTA",,3,,467,773
14,"Constanța",136,"136-MUNICIPIUL CONSTANTA",60419,61,2,2334,1670,1478,192,1660,10,"MUNICIPIUL CONSTANTA",,3,,522,1138
14,"Constanța",136,"136-MUNICIPIUL CONSTANTA",60419,62,2,1736,1275,1144,131,1272,3,"MUNICIPIUL CONSTANTA",,3,,456,816
14,"Constanța",136,"136-MUNICIPIUL CONSTANTA",60419,63,2,1573,1560,1059,501,1551,9,"MUNICIPIUL CONSTANTA",,3,,455,1096
14,"Constanța",136,"136-MUNICIPIUL CONSTANTA",60419,64,2,1928,1708,1153,555,1703,5,"MUNICIPIUL CONSTANTA",,3,,537,1166
14,"Constanța",136,"136-MUNICIPIUL CONSTANTA",60419,65,2,1342,1235,809,426,1227,8,"MUNICIPIUL CONSTANTA",,3,,420,807
14,"Constanța",136,"136-MUNICIPIUL CONSTANTA",60419,66,2,1553,1282,1017,265,1275,7,"MUNICIPIUL CONSTANTA",,3,,332,943
14,"Constanța",136,"136-MUNICIPIUL CONSTANTA",60419,67,2,1962,1255,1048,207,1245,10,"MUNICIPIUL CONSTANTA",,3,,451,794
14,"Constanța",136,"136-MUNICIPIUL CONSTANTA",60419,68,2,1208,1031,837,194,1020,11,"MUNICIPIUL CONSTANTA",,3,,418,602
14,"Constanța",136,"136-MUNICIPIUL CONSTANTA",60419,69,2,1034,844,740,104,840,4,"MUNICIPIUL CONSTANTA",,3,,378,462
14,"Constanța",136,"136-MUNICIPIUL CONSTANTA",60419,70,2,1296,1028,842,186,1024,4,"MUNICIPIUL CONSTANTA",,3,,450,574
14,"Constanța",136,"136-MUNICIPIUL CONSTANTA",60419,71,2,1127,1124,785,339,1112,12,"MUNICIPIUL CONSTANTA",,3,,418,694
14,"Constanța",136,"136-MUNICIPIUL CONSTANTA",60419,72,2,1223,977,808,169,969,8,"MUNICIPIUL CONSTANTA",,3,,409,560
14,"Constanța",136,"136-MUNICIPIUL CONSTANTA",60419,73,2,1330,1154,994,160,1138,16,"MUNICIPIUL CONSTANTA",,3,,581,557
14,"Constanța",136,"136-MUNICIPIUL CONSTANTA",60419,74,2,1543,1225,1087,138,1216,9,"MUNICIPIUL CONSTANTA",,3,,546,670
14,"Constanța",136,"136-MUNICIPIUL CONSTANTA",60419,75,2,1616,1303,1169,134,1292,11,"MUNICIPIUL CONSTANTA",,3,,545,747
14,"Constanța",136,"136-MUNICIPIUL CONSTANTA",60419,76,2,1042,891,762,129,882,9,"MUNICIPIUL CONSTANTA",,3,,304,578
14,"Constanța",136,"136-MUNICIPIUL CONSTANTA",60419,77,2,640,561,424,137,560,1,"MUNICIPIUL CONSTANTA",,3,,156,404
14,"Constanța",136,"136-MUNICIPIUL CONSTANTA",60419,78,2,1585,1290,974,316,1284,6,"MUNICIPIUL CONSTANTA",,3,,425,859
14,"Constanța",136,"136-MUNICIPIUL CONSTANTA",60419,79,2,1355,1042,919,123,1041,1,"MUNICIPIUL CONSTANTA",,3,,352,689
14,"Constanța",136,"136-MUNICIPIUL CONSTANTA",60419,80,2,1895,1039,968,71,1036,3,"MUNICIPIUL CONSTANTA",,3,,335,701
14,"Constanța",136,"136-MUNICIPIUL CONSTANTA",60419,81,2,1471,1092,1018,74,1087,5,"MUNICIPIUL CONSTANTA",,3,,362,725
14,"Constanța",136,"136-MUNICIPIUL CONSTANTA",60419,82,2,1284,1262,878,384,1257,5,"MUNICIPIUL CONSTANTA",,3,,427,830
14,"Constanța",136,"136-MUNICIPIUL CONSTANTA",60419,83,2,2338,1487,1246,241,1480,7,"MUNICIPIUL CONSTANTA",,3,,650,830
14,"Constanța",136,"136-MUNICIPIUL CONSTANTA",60419,84,2,2585,1470,1178,292,1459,11,"MUNICIPIUL CONSTANTA",,3,,562,897
14,"Constanța",136,"136-MUNICIPIUL CONSTANTA",60419,85,2,1510,1181,922,259,1170,11,"MUNICIPIUL CONSTANTA",,3,,467,703
14,"Constanța",136,"136-MUNICIPIUL CONSTANTA",60419,86,2,1526,1137,1026,111,1132,5,"MUNICIPIUL CONSTANTA",,3,,437,695
14,"Constanța",136,"136-MUNICIPIUL CONSTANTA",60419,87,2,2189,1599,1444,155,1595,4,"MUNICIPIUL CONSTANTA",,3,,522,1073
14,"Constanța",136,"136-MUNICIPIUL CONSTANTA",60419,88,2,1789,1382,1160,222,1375,7,"MUNICIPIUL CONSTANTA",,3,,413,962
14,"Constanța",136,"136-MUNICIPIUL CONSTANTA",60419,89,2,2262,1693,1555,138,1685,8,"MUNICIPIUL CONSTANTA",,3,,593,1092
14,"Constanța",136,"136-MUNICIPIUL CONSTANTA",60419,90,2,2252,1906,1484,422,1893,13,"MUNICIPIUL CONSTANTA",,3,,637,1256
14,"Constanța",136,"136-MUNICIPIUL CONSTANTA",60419,91,2,1534,1255,1033,222,1243,12,"MUNICIPIUL CONSTANTA",,3,,427,816
14,"Constanța",136,"136-MUNICIPIUL CONSTANTA",60419,92,2,1468,1184,1032,152,1168,16,"MUNICIPIUL CONSTANTA",,3,,432,736
14,"Constanța",136,"136-MUNICIPIUL CONSTANTA",60419,93,2,1616,1310,1088,222,1304,6,"MUNICIPIUL CONSTANTA",,3,,434,870
14,"Constanța",136,"136-MUNICIPIUL CONSTANTA",60419,94,2,1355,1029,941,88,1028,1,"MUNICIPIUL CONSTANTA",,3,,356,672
14,"Constanța",136,"136-MUNICIPIUL CONSTANTA",60419,95,2,1301,1035,953,82,1031,4,"MUNICIPIUL CONSTANTA",,3,,310,721
14,"Constanța",136,"136-MUNICIPIUL CONSTANTA",60419,96,2,1365,1138,956,182,1133,5,"MUNICIPIUL CONSTANTA",,3,,354,779
14,"Constanța",136,"136-MUNICIPIUL CONSTANTA",60419,97,2,1824,1457,1339,118,1451,6,"MUNICIPIUL CONSTANTA",,3,,522,929
14,"Constanța",136,"136-MUNICIPIUL CONSTANTA",60419,98,2,1620,1212,1109,103,1207,5,"MUNICIPIUL CONSTANTA",,3,,379,828
14,"Constanța",136,"136-MUNICIPIUL CONSTANTA",60419,99,2,1830,1186,1077,109,1184,2,"MUNICIPIUL CONSTANTA",,3,,381,803
14,"Constanța",136,"136-MUNICIPIUL CONSTANTA",60419,100,2,1905,1333,1261,72,1331,2,"MUNICIPIUL CONSTANTA",,3,,433,898
14,"Constanța",136,"136-MUNICIPIUL CONSTANTA",60419,101,2,2001,1417,1290,127,1406,11,"MUNICIPIUL CONSTANTA",,3,,501,905
14,"Constanța",136,"136-MUNICIPIUL CONSTANTA",60419,102,2,2028,1405,1338,67,1398,7,"MUNICIPIUL CONSTANTA",,3,,507,891
14,"Constanța",136,"136-MUNICIPIUL CONSTANTA",60419,103,2,1957,1565,1451,114,1555,10,"MUNICIPIUL CONSTANTA",,3,,449,1106
14,"Constanța",136,"136-MUNICIPIUL CONSTANTA",60419,104,2,1630,1313,1219,94,1300,13,"MUNICIPIUL CONSTANTA",,3,,435,865
14,"Constanța",136,"136-MUNICIPIUL CONSTANTA",60419,105,2,1335,1072,959,113,1062,10,"MUNICIPIUL CONSTANTA",,3,,323,739
14,"Constanța",136,"136-MUNICIPIUL CONSTANTA",60419,106,2,1387,978,894,84,977,1,"MUNICIPIUL CONSTANTA",,3,,297,680
14,"Constanța",136,"136-MUNICIPIUL CONSTANTA",60419,107,2,1531,1115,977,138,1109,6,"MUNICIPIUL CONSTANTA",,3,,402,707
14,"Constanța",136,"136-MUNICIPIUL CONSTANTA",60419,108,2,1666,1233,1167,66,1224,9,"MUNICIPIUL CONSTANTA",,3,,422,802
14,"Constanța",136,"136-MUNICIPIUL CONSTANTA",60419,109,2,1751,1272,1185,87,1264,8,"MUNICIPIUL CONSTANTA",,3,,460,804
14,"Constanța",136,"136-MUNICIPIUL CONSTANTA",60419,110,2,1884,1416,1304,112,1409,7,"MUNICIPIUL CONSTANTA",,3,,523,886
14,"Constanța",136,"136-MUNICIPIUL CONSTANTA",60419,111,2,1853,1321,1242,79,1318,3,"MUNICIPIUL CONSTANTA",,3,,413,905
14,"Constanța",136,"136-MUNICIPIUL CONSTANTA",60419,112,2,1694,1230,1151,79,1220,10,"MUNICIPIUL CONSTANTA",,3,,472,748
14,"Constanța",136,"136-MUNICIPIUL CONSTANTA",60419,113,2,1849,1421,1347,74,1416,5,"MUNICIPIUL CONSTANTA",,3,,500,916
14,"Constanța",136,"136-MUNICIPIUL CONSTANTA",60419,114,2,2064,1396,1316,80,1393,3,"MUNICIPIUL CONSTANTA",,3,,489,904
14,"Constanța",136,"136-MUNICIPIUL CONSTANTA",60419,115,2,1789,1389,1271,118,1382,7,"MUNICIPIUL CONSTANTA",,3,,451,931
14,"Constanța",136,"136-MUNICIPIUL CONSTANTA",60419,116,2,1805,1434,1330,104,1429,5,"MUNICIPIUL CONSTANTA",,3,,562,867
14,"Constanța",136,"136-MUNICIPIUL CONSTANTA",60419,117,2,1430,1164,1028,136,1162,2,"MUNICIPIUL CONSTANTA",,3,,412,750
14,"Constanța",136,"136-MUNICIPIUL CONSTANTA",60419,118,2,1369,1160,899,261,1151,9,"MUNICIPIUL CONSTANTA",,3,,378,773
14,"Constanța",136,"136-MUNICIPIUL CONSTANTA",60419,119,2,1183,1051,781,270,1037,14,"MUNICIPIUL CONSTANTA",,3,,355,682
14,"Constanța",136,"136-MUNICIPIUL CONSTANTA",60419,120,2,1401,1112,1014,98,1106,6,"MUNICIPIUL CONSTANTA",,3,,391,715
14,"Constanța",136,"136-MUNICIPIUL CONSTANTA",60419,121,2,1220,1018,880,138,1017,1,"MUNICIPIUL CONSTANTA",,3,,343,674
14,"Constanța",136,"136-MUNICIPIUL CONSTANTA",60419,122,2,1609,1162,1098,64,1160,2,"MUNICIPIUL CONSTANTA",,3,,431,729
14,"Constanța",136,"136-MUNICIPIUL CONSTANTA",60419,123,2,1094,857,816,41,854,3,"MUNICIPIUL CONSTANTA",,3,,309,545
14,"Constanța",136,"136-MUNICIPIUL CONSTANTA",60419,124,2,1375,1044,1005,39,1043,1,"MUNICIPIUL CONSTANTA",,3,,383,660
14,"Constanța",136,"136-MUNICIPIUL CONSTANTA",60419,125,2,1145,915,815,100,906,9,"MUNICIPIUL CONSTANTA",,3,,337,569
14,"Constanța",136,"136-MUNICIPIUL CONSTANTA",60419,126,2,1474,1088,1025,63,1084,4,"MUNICIPIUL CONSTANTA",,3,,355,729
14,"Constanța",136,"136-MUNICIPIUL CONSTANTA",60419,127,2,1168,958,869,89,955,3,"MUNICIPIUL CONSTANTA",,3,,402,553
14,"Constanța",136,"136-MUNICIPIUL CONSTANTA",60419,128,2,1612,1235,1069,166,1228,7,"MUNICIPIUL CONSTANTA",,3,,493,735
14,"Constanța",136,"136-MUNICIPIUL CONSTANTA",60419,129,2,796,646,581,65,643,3,"MUNICIPIUL CONSTANTA",,3,,250,393
14,"Constanța",136,"136-MUNICIPIUL CONSTANTA",60419,130,2,642,540,473,67,539,1,"MUNICIPIUL CONSTANTA",,3,,199,340
14,"Constanța",136,"136-MUNICIPIUL CONSTANTA",60419,131,2,1061,822,715,107,816,6,"MUNICIPIUL CONSTANTA",,3,,293,523
14,"Constanța",136,"136-MUNICIPIUL CONSTANTA",60419,132,2,844,648,582,66,645,3,"MUNICIPIUL CONSTANTA",,3,,262,383
14,"Constanța",136,"136-MUNICIPIUL CONSTANTA",60419,133,2,925,769,729,40,763,6,"MUNICIPIUL CONSTANTA",,3,,278,485
14,"Constanța",136,"136-MUNICIPIUL CONSTANTA",60419,134,2,1021,790,739,51,782,8,"MUNICIPIUL CONSTANTA",,3,,352,430
14,"Constanța",136,"136-MUNICIPIUL CONSTANTA",60419,135,2,1512,1205,1132,73,1200,5,"MUNICIPIUL CONSTANTA",,3,,466,734
14,"Constanța",136,"136-MUNICIPIUL CONSTANTA",60419,136,2,1318,1028,958,70,1022,6,"MUNICIPIUL CONSTANTA",,3,,309,713
14,"Constanța",136,"136-MUNICIPIUL CONSTANTA",60419,137,2,1157,870,752,118,868,2,"MUNICIPIUL CONSTANTA",,3,,304,564
14,"Constanța",136,"136-MUNICIPIUL CONSTANTA",60419,138,2,1698,1345,1235,110,1339,6,"MUNICIPIUL CONSTANTA",,3,,557,782
14,"Constanța",136,"136-MUNICIPIUL CONSTANTA",60419,139,2,1480,1274,1084,190,1267,7,"MUNICIPIUL CONSTANTA",,3,,513,754
14,"Constanța",136,"136-MUNICIPIUL CONSTANTA",60419,140,2,1424,1275,1193,82,1272,3,"MUNICIPIUL CONSTANTA",,3,,457,815
14,"Constanța",136,"136-MUNICIPIUL CONSTANTA",60419,141,2,1160,943,882,61,941,2,"MUNICIPIUL CONSTANTA",,3,,283,658
14,"Constanța",136,"136-MUNICIPIUL CONSTANTA",60419,142,2,1392,1045,970,75,1042,3,"MUNICIPIUL CONSTANTA",,3,,264,778
14,"Constanța",136,"136-MUNICIPIUL CONSTANTA",60419,143,2,1119,888,837,51,885,3,"MUNICIPIUL CONSTANTA",,3,,246,639
14,"Constanța",136,"136-MUNICIPIUL CONSTANTA",60419,144,2,1396,1168,1090,78,1160,8,"MUNICIPIUL CONSTANTA",,3,,450,710
14,"Constanța",136,"136-MUNICIPIUL CONSTANTA",60419,145,2,1373,1119,1037,82,1117,2,"MUNICIPIUL CONSTANTA",,3,,354,763
14,"Constanța",136,"136-MUNICIPIUL CONSTANTA",60419,146,2,1247,967,902,65,959,8,"MUNICIPIUL CONSTANTA",,3,,361,598
14,"Constanța",136,"136-MUNICIPIUL CONSTANTA",60419,147,2,1325,1083,1004,79,1079,4,"MUNICIPIUL CONSTANTA",,3,,289,790
14,"Constanța",136,"136-MUNICIPIUL CONSTANTA",60419,148,2,1248,1037,959,78,1034,3,"MUNICIPIUL CONSTANTA",,3,,295,739
14,"Constanța",136,"136-MUNICIPIUL CONSTANTA",60419,149,2,749,615,557,58,614,1,"MUNICIPIUL CONSTANTA",,3,,205,409
14,"Constanța",136,"136-MUNICIPIUL CONSTANTA",60419,150,2,1634,1143,1077,66,1138,5,"MUNICIPIUL CONSTANTA",,3,,334,804
14,"Constanța",136,"136-MUNICIPIUL CONSTANTA",60419,151,2,1354,977,914,63,971,6,"MUNICIPIUL CONSTANTA",,3,,274,697
14,"Constanța",136,"136-MUNICIPIUL CONSTANTA",60419,152,2,1344,1030,943,87,1025,5,"MUNICIPIUL CONSTANTA",,3,,284,741
14,"Constanța",136,"136-MUNICIPIUL CONSTANTA",60419,153,2,2584,2144,1624,520,2133,11,"MUNICIPIUL CONSTANTA",,3,,614,1519
14,"Constanța",136,"136-MUNICIPIUL CONSTANTA",60419,154,2,1759,1287,1032,255,1276,11,"MUNICIPIUL CONSTANTA",,3,,336,940
14,"Constanța",136,"136-MUNICIPIUL CONSTANTA",60419,155,2,1154,987,857,130,982,5,"MUNICIPIUL CONSTANTA",,3,,300,682
14,"Constanța",136,"136-MUNICIPIUL CONSTANTA",60419,156,2,1983,1601,1437,164,1596,5,"MUNICIPIUL CONSTANTA",,3,,494,1102
14,"Constanța",136,"136-MUNICIPIUL CONSTANTA",60419,157,2,1450,1306,1197,109,1301,5,"MUNICIPIUL CONSTANTA",,3,,428,873
14,"Constanța",136,"136-MUNICIPIUL CONSTANTA",60419,158,2,1241,1038,912,126,1036,2,"MUNICIPIUL CONSTANTA",,3,,371,665
14,"Constanța",136,"136-MUNICIPIUL CONSTANTA",60419,159,2,946,729,676,53,728,1,"MUNICIPIUL CONSTANTA",,3,,215,513
14,"Constanța",136,"136-MUNICIPIUL CONSTANTA",60419,160,2,1058,813,738,75,809,4,"MUNICIPIUL CONSTANTA",,3,,237,572
14,"Constanța",136,"136-MUNICIPIUL CONSTANTA",60419,161,2,1100,832,728,104,829,3,"MUNICIPIUL CONSTANTA",,3,,258,571
14,"Constanța",136,"136-MUNICIPIUL CONSTANTA",60419,162,2,909,779,653,126,777,2,"MUNICIPIUL CONSTANTA",,3,,243,534
14,"Constanța",136,"136-MUNICIPIUL CONSTANTA",60419,163,2,859,735,628,107,732,3,"MUNICIPIUL CONSTANTA",,3,,180,552
14,"Constanța",136,"136-MUNICIPIUL CONSTANTA",60419,164,2,1064,1114,736,378,1105,9,"MUNICIPIUL CONSTANTA",,3,,291,814
14,"Constanța",136,"136-MUNICIPIUL CONSTANTA",60419,165,2,1012,929,718,211,922,7,"MUNICIPIUL CONSTANTA",,3,,219,703
14,"Constanța",136,"136-MUNICIPIUL CONSTANTA",60419,166,2,1013,819,726,93,817,2,"MUNICIPIUL CONSTANTA",,3,,197,620
14,"Constanța",136,"136-MUNICIPIUL CONSTANTA",60419,167,2,1116,848,739,109,844,4,"MUNICIPIUL CONSTANTA",,3,,214,630
14,"Constanța",136,"136-MUNICIPIUL CONSTANTA",60419,168,2,897,783,688,95,781,2,"MUNICIPIUL CONSTANTA",,3,,224,557
14,"Constanța",136,"136-MUNICIPIUL CONSTANTA",60419,169,2,832,697,628,69,695,2,"MUNICIPIUL CONSTANTA",,3,,260,435
14,"Constanța",136,"136-MUNICIPIUL CONSTANTA",60419,170,2,832,768,634,134,765,3,"MUNICIPIUL CONSTANTA",,3,,339,426
14,"Constanța",136,"136-MUNICIPIUL CONSTANTA",60419,171,2,757,634,575,59,632,2,"MUNICIPIUL CONSTANTA",,3,,190,442
14,"Constanța",136,"136-MUNICIPIUL CONSTANTA",60419,172,2,1097,805,762,43,805,0,"MUNICIPIUL CONSTANTA",,3,,317,488
14,"Constanța",136,"136-MUNICIPIUL CONSTANTA",60419,173,2,754,647,595,52,641,3,"MUNICIPIUL CONSTANTA",,3,,209,432
14,"Constanța",136,"136-MUNICIPIUL CONSTANTA",60419,174,2,797,706,584,122,703,3,"MUNICIPIUL CONSTANTA",,3,,227,476
14,"Constanța",136,"136-MUNICIPIUL CONSTANTA",60419,175,2,1090,928,826,102,928,0,"MUNICIPIUL CONSTANTA",,3,,333,595
14,"Constanța",136,"136-MUNICIPIUL CONSTANTA",60419,176,2,990,862,804,58,861,1,"MUNICIPIUL CONSTANTA",,3,,336,525
14,"Constanța",136,"136-MUNICIPIUL CONSTANTA",60419,177,2,995,841,775,66,832,9,"MUNICIPIUL CONSTANTA",,3,,254,578
14,"Constanța",136,"136-MUNICIPIUL CONSTANTA",60419,178,2,1117,884,831,53,879,5,"MUNICIPIUL CONSTANTA",,3,,312,567
14,"Constanța",136,"136-MUNICIPIUL CONSTANTA",60419,179,2,1385,1304,1144,160,1300,4,"MUNICIPIUL CONSTANTA",,3,,462,838
14,"Constanța",136,"136-MUNICIPIUL CONSTANTA",60419,180,2,1561,1218,1070,148,1214,4,"MUNICIPIUL CONSTANTA",,3,,388,826
14,"Constanța",136,"136-MUNICIPIUL CONSTANTA",60419,181,2,1500,1190,1144,46,1187,3,"MUNICIPIUL CONSTANTA",,3,,299,888
14,"Constanța",136,"136-MUNICIPIUL CONSTANTA",60419,182,2,1654,1184,1105,79,1179,5,"MUNICIPIUL CONSTANTA",,3,,295,884
14,"Constanța",136,"136-MUNICIPIUL CONSTANTA",60419,183,2,1553,1017,944,73,1016,1,"MUNICIPIUL CONSTANTA",,3,,297,719
14,"Constanța",136,"136-MUNICIPIUL CONSTANTA",60419,184,2,1032,835,769,66,831,4,"MUNICIPIUL CONSTANTA",,3,,225,606
14,"Constanța",136,"136-MUNICIPIUL CONSTANTA",60419,185,2,1143,870,797,73,864,6,"MUNICIPIUL CONSTANTA",,3,,283,581
14,"Constanța",136,"136-MUNICIPIUL CONSTANTA",60419,186,2,998,665,601,64,664,1,"MUNICIPIUL CONSTANTA",,3,,237,427
14,"Constanța",136,"136-MUNICIPIUL CONSTANTA",60419,187,2,164,178,155,23,173,5,"MUNICIPIUL CONSTANTA",,3,,57,116
14,"Constanța",136,"136-MUNICIPIUL CONSTANTA",60419,188,2,766,760,741,19,756,4,"MUNICIPIUL CONSTANTA",,3,,343,413
14,"Constanța",136,"136-MUNICIPIUL CONSTANTA",60419,189,2,0,118,0,118,116,2,"MUNICIPIUL CONSTANTA",,3,,46,70
14,"Constanța",136,"136-MUNICIPIUL CONSTANTA",60419,190,2,468,464,414,50,458,6,"MUNICIPIUL CONSTANTA",,3,,186,272
14,"Constanța",136,"136-MUNICIPIUL CONSTANTA",60419,191,2,0,427,0,427,423,4,"MUNICIPIUL CONSTANTA",,3,,142,281
14,"Constanța",136,"136-MUNICIPIUL CONSTANTA",60419,192,2,512,543,476,67,537,6,"MUNICIPIUL CONSTANTA",,3,,287,250
14,"Constanța",136,"136-MUNICIPIUL CONSTANTA",60419,193,2,0,812,0,812,794,18,"MUNICIPIUL CONSTANTA",,3,,220,574
14,"Constanța",136,"136-MUNICIPIUL CONSTANTA",60419,194,2,0,295,0,295,293,2,"MUNICIPIUL CONSTANTA",,3,,115,178
14,"Constanța",136,"136-MUNICIPIUL CONSTANTA",60419,195,2,964,793,734,59,776,17,"MUNICIPIUL CONSTANTA",,3,,334,442
14,"Constanța",136,"136-MUNICIPIUL CONSTANTA",60419,196,2,0,232,0,232,229,3,"MUNICIPIUL CONSTANTA",,3,,79,150
14,"Constanța",136,"136-MUNICIPIUL CONSTANTA",60419,197,2,0,951,0,951,947,4,"MUNICIPIUL CONSTANTA",,3,,318,629
14,"Constanța",136,"136-MUNICIPIUL CONSTANTA",60419,198,2,0,134,0,134,134,0,"MUNICIPIUL CONSTANTA",,3,,38,96
14,"Constanța",136,"136-MUNICIPIUL CONSTANTA",60419,199,2,37,110,28,82,107,3,"MUNICIPIUL CONSTANTA",,3,,37,70
14,"Constanța",136,"136-MUNICIPIUL CONSTANTA",60419,200,2,0,462,0,462,459,3,"MUNICIPIUL CONSTANTA",,3,,46,413
14,"Constanța",136,"136-MUNICIPIUL CONSTANTA",60419,201,2,0,1042,0,1042,1038,4,"MUNICIPIUL CONSTANTA",,3,,266,772
14,"Constanța",136,"136-MUNICIPIUL CONSTANTA",60419,202,2,0,219,0,219,217,2,"MUNICIPIUL CONSTANTA",,3,,63,154
14,"Constanța",136,"136-MUNICIPIUL CONSTANTA",60419,203,2,0,309,0,309,304,5,"MUNICIPIUL CONSTANTA",,3,,99,205
14,"Constanța",136,"136-MUNICIPIUL CONSTANTA",60419,204,2,0,3504,0,3504,3452,52,"MUNICIPIUL CONSTANTA",,3,,189,3263
14,"Constanța",136,"136-MUNICIPIUL CONSTANTA",60419,205,2,0,54,0,54,54,0,"MUNICIPIUL CONSTANTA",,3,,19,35
14,"Constanța",136,"136-MUNICIPIUL MANGALIA",60482,206,2,1715,1321,1060,261,1309,12,"MUNICIPIUL MANGALIA",,3,,710,599
14,"Constanța",136,"136-MUNICIPIUL MANGALIA",60482,207,2,1337,1111,936,175,1109,2,"MUNICIPIUL MANGALIA",,3,,547,562
14,"Constanța",136,"136-MUNICIPIUL MANGALIA",60482,208,2,1357,1104,945,159,1096,8,"MUNICIPIUL MANGALIA",,3,,500,596
14,"Constanța",136,"136-MUNICIPIUL MANGALIA",60482,209,2,2732,1921,1550,371,1912,9,"MUNICIPIUL MANGALIA",,3,,833,1079
14,"Constanța",136,"136-MUNICIPIUL MANGALIA",60482,210,2,1680,1184,1112,72,1173,11,"MUNICIPIUL MANGALIA",,3,,537,636
14,"Constanța",136,"136-MUNICIPIUL MANGALIA",60482,211,2,1467,1215,851,364,1210,5,"MUNICIPIUL MANGALIA",,3,,602,608
14,"Constanța",136,"136-MUNICIPIUL MANGALIA",60482,212,2,1514,997,899,98,989,8,"MUNICIPIUL MANGALIA",,3,,450,539
14,"Constanța",136,"136-MUNICIPIUL MANGALIA",60482,213,2,1575,1091,904,187,1078,13,"MUNICIPIUL MANGALIA",,3,,476,602
14,"Constanța",136,"136-MUNICIPIUL MANGALIA",60482,214,2,1692,1132,937,195,1121,11,"MUNICIPIUL MANGALIA",,3,,501,620
14,"Constanța",136,"136-MUNICIPIUL MANGALIA",60482,215,2,1280,927,808,119,916,11,"MUNICIPIUL MANGALIA",,3,,436,480
14,"Constanța",136,"136-MUNICIPIUL MANGALIA",60482,216,2,1163,840,760,80,833,7,"MUNICIPIUL MANGALIA",,3,,335,498
14,"Constanța",136,"136-MUNICIPIUL MANGALIA",60482,217,2,1753,1368,1233,135,1349,19,"MUNICIPIUL MANGALIA",,3,,723,626
14,"Constanța",136,"136-MUNICIPIUL MANGALIA",60482,218,2,1494,1138,1009,129,1124,14,"MUNICIPIUL MANGALIA",,3,,563,561
14,"Constanța",136,"136-MUNICIPIUL MANGALIA",60482,219,2,1406,1050,938,112,1046,4,"MUNICIPIUL MANGALIA",,3,,402,644
14,"Constanța",136,"136-MUNICIPIUL MANGALIA",60482,220,2,1316,1036,869,167,1030,6,"MUNICIPIUL MANGALIA",,3,,447,583
14,"Constanța",136,"136-MUNICIPIUL MANGALIA",60482,221,2,1332,1048,931,117,1043,5,"MUNICIPIUL MANGALIA",,3,,461,582
14,"Constanța",136,"136-MUNICIPIUL MANGALIA",60482,222,2,1261,1172,971,201,1168,4,"MUNICIPIUL MANGALIA",,3,,554,614
14,"Constanța",136,"136-MUNICIPIUL MANGALIA",60482,223,2,1160,1055,792,263,1052,3,"MUNICIPIUL MANGALIA",,3,,462,590
14,"Constanța",136,"136-MUNICIPIUL MANGALIA",60482,224,2,806,775,496,279,770,5,"MUNICIPIUL MANGALIA",,3,,395,375
14,"Constanța",136,"136-MUNICIPIUL MANGALIA",60482,225,2,957,704,569,135,700,4,"MUNICIPIUL MANGALIA",,3,,301,399
14,"Constanța",136,"136-MUNICIPIUL MANGALIA",60482,226,2,2028,1445,1184,261,1432,13,"MUNICIPIUL MANGALIA",,3,,686,746
14,"Constanța",136,"136-MUNICIPIUL MANGALIA",60482,227,2,1146,1098,767,331,1090,8,"MUNICIPIUL MANGALIA",,3,,359,731
14,"Constanța",136,"136-MUNICIPIUL MANGALIA",60482,228,2,223,438,119,319,432,6,"MUNICIPIUL MANGALIA",,3,,197,235
14,"Constanța",136,"136-MUNICIPIUL MANGALIA",60482,229,2,0,550,510,40,535,15,"MUNICIPIUL MANGALIA",,3,,267,268
14,"Constanța",136,"136-MUNICIPIUL MANGALIA",60482,230,2,0,637,0,637,625,12,"MUNICIPIUL MANGALIA",,3,,293,332
14,"Constanța",136,"136-MUNICIPIUL MANGALIA",60482,231,2,305,331,293,38,326,5,"MUNICIPIUL MANGALIA",,3,,135,191
14,"Constanța",136,"136-MUNICIPIUL MANGALIA",60482,232,2,0,230,0,230,230,0,"MUNICIPIUL MANGALIA",,3,,81,149
14,"Constanța",136,"136-MUNICIPIUL MEDGIDIA",60847,233,2,1037,825,749,76,823,2,"MUNICIPIUL MEDGIDIA",,3,,463,360
14,"Constanța",136,"136-MUNICIPIUL MEDGIDIA",60847,234,2,685,497,414,83,490,7,"MUNICIPIUL MEDGIDIA",,3,,269,221
14,"Constanța",136,"136-MUNICIPIUL MEDGIDIA",60847,235,2,1056,763,671,92,754,9,"MUNICIPIUL MEDGIDIA",,3,,399,355
14,"Constanța",136,"136-MUNICIPIUL MEDGIDIA",60847,236,2,1004,744,660,84,736,8,"MUNICIPIUL MEDGIDIA",,3,,453,283
14,"Constanța",136,"136-MUNICIPIUL MEDGIDIA",60847,237,2,1241,789,656,133,775,14,"MUNICIPIUL MEDGIDIA",,3,,417,358
14,"Constanța",136,"136-MUNICIPIUL MEDGIDIA",60847,238,2,838,566,488,78,559,7,"MUNICIPIUL MEDGIDIA",,3,,289,270
14,"Constanța",136,"136-MUNICIPIUL MEDGIDIA",60847,239,2,1019,787,717,70,783,4,"MUNICIPIUL MEDGIDIA",,3,,382,401
14,"Constanța",136,"136-MUNICIPIUL MEDGIDIA",60847,240,2,1001,658,591,67,658,0,"MUNICIPIUL MEDGIDIA",,3,,346,312
14,"Constanța",136,"136-MUNICIPIUL MEDGIDIA",60847,241,2,1189,839,760,79,836,3,"MUNICIPIUL MEDGIDIA",,3,,422,414
14,"Constanța",136,"136-MUNICIPIUL MEDGIDIA",60847,242,2,800,589,504,85,579,10,"MUNICIPIUL MEDGIDIA",,3,,337,242
14,"Constanța",136,"136-MUNICIPIUL MEDGIDIA",60847,243,2,956,751,692,59,748,3,"MUNICIPIUL MEDGIDIA",,3,,428,320
14,"Constanța",136,"136-MUNICIPIUL MEDGIDIA",60847,244,2,803,654,548,106,652,2,"MUNICIPIUL MEDGIDIA",,3,,391,261
14,"Constanța",136,"136-MUNICIPIUL MEDGIDIA",60847,245,2,938,675,631,44,672,3,"MUNICIPIUL MEDGIDIA",,3,,388,284
14,"Constanța",136,"136-MUNICIPIUL MEDGIDIA",60847,246,2,1210,844,782,62,837,7,"MUNICIPIUL MEDGIDIA",,3,,480,357
14,"Constanța",136,"136-MUNICIPIUL MEDGIDIA",60847,247,2,1078,839,783,56,835,4,"MUNICIPIUL MEDGIDIA",,3,,504,331
14,"Constanța",136,"136-MUNICIPIUL MEDGIDIA",60847,248,2,960,764,689,75,762,2,"MUNICIPIUL MEDGIDIA",,3,,434,328
14,"Constanța",136,"136-MUNICIPIUL MEDGIDIA",60847,249,2,1094,772,728,44,769,3,"MUNICIPIUL MEDGIDIA",,3,,420,349
14,"Constanța",136,"136-MUNICIPIUL MEDGIDIA",60847,250,2,1019,747,690,57,742,5,"MUNICIPIUL MEDGIDIA",,3,,437,305
14,"Constanța",136,"136-MUNICIPIUL MEDGIDIA",60847,251,2,889,720,632,88,716,4,"MUNICIPIUL MEDGIDIA",,3,,371,345
14,"Constanța",136,"136-MUNICIPIUL MEDGIDIA",60847,252,2,1031,803,726,77,795,8,"MUNICIPIUL MEDGIDIA",,3,,455,340
14,"Constanța",136,"136-MUNICIPIUL MEDGIDIA",60847,253,2,961,752,643,109,740,12,"MUNICIPIUL MEDGIDIA",,3,,392,348
14,"Constanța",136,"136-MUNICIPIUL MEDGIDIA",60847,254,2,895,661,589,72,660,1,"MUNICIPIUL MEDGIDIA",,3,,367,293
14,"Constanța",136,"136-MUNICIPIUL MEDGIDIA",60847,255,2,1180,820,739,81,816,4,"MUNICIPIUL MEDGIDIA",,3,,449,367
14,"Constanța",136,"136-MUNICIPIUL MEDGIDIA",60847,256,2,773,591,547,44,591,0,"MUNICIPIUL MEDGIDIA",,3,,305,286
14,"Constanța",136,"136-MUNICIPIUL MEDGIDIA",60847,257,2,1032,825,726,99,820,5,"MUNICIPIUL MEDGIDIA",,3,,473,347
14,"Constanța",136,"136-MUNICIPIUL MEDGIDIA",60847,258,2,679,699,488,211,695,4,"MUNICIPIUL MEDGIDIA",,3,,316,379
14,"Constanța",136,"136-MUNICIPIUL MEDGIDIA",60847,259,2,977,712,650,62,711,1,"MUNICIPIUL MEDGIDIA",,3,,355,356
14,"Constanța",136,"136-MUNICIPIUL MEDGIDIA",60847,260,2,944,727,631,96,716,11,"MUNICIPIUL MEDGIDIA",,3,,343,373
14,"Constanța",136,"136-MUNICIPIUL MEDGIDIA",60847,261,2,1144,943,722,221,889,54,"MUNICIPIUL MEDGIDIA",,3,,441,448
14,"Constanța",136,"136-MUNICIPIUL MEDGIDIA",60847,262,2,1015,765,658,107,759,6,"MUNICIPIUL MEDGIDIA",,3,,408,351
14,"Constanța",136,"136-MUNICIPIUL MEDGIDIA",60847,263,2,1040,810,739,71,807,3,"MUNICIPIUL MEDGIDIA",,3,,422,385
14,"Constanța",136,"136-MUNICIPIUL MEDGIDIA",60847,264,2,908,751,616,135,747,4,"MUNICIPIUL MEDGIDIA",,3,,421,326
14,"Constanța",136,"136-MUNICIPIUL MEDGIDIA",60847,265,2,1297,992,865,127,980,12,"MUNICIPIUL MEDGIDIA",,3,,538,442
14,"Constanța",136,"136-MUNICIPIUL MEDGIDIA",60847,266,2,1169,927,825,102,919,8,"MUNICIPIUL MEDGIDIA",,3,,492,427
14,"Constanța",136,"136-MUNICIPIUL MEDGIDIA",60847,267,2,1296,967,882,85,963,4,"MUNICIPIUL MEDGIDIA",,3,,451,512
14,"Constanța",136,"136-MUNICIPIUL MEDGIDIA",60847,268,2,635,529,492,37,522,7,"MUNICIPIUL MEDGIDIA",,3,,246,276
14,"Constanța",136,"136-MUNICIPIUL MEDGIDIA",60847,269,2,0,321,0,321,321,0,"MUNICIPIUL MEDGIDIA",,3,,165,156
14,"Constanța",136,"136-MUNICIPIUL MEDGIDIA",60847,270,2,870,676,524,152,669,7,"MUNICIPIUL MEDGIDIA",,3,,407,262
14,"Constanța",136,"136-MUNICIPIUL MEDGIDIA",60847,271,2,234,191,147,44,190,1,"MUNICIPIUL MEDGIDIA",,3,,126,64
14,"Constanța",136,"136-ORAS BASARABI",62360,272,2,2383,1940,1383,557,1926,14,"ORAS BASARABI",,3,,792,1134
14,"Constanța",136,"136-ORAS BASARABI",62360,273,2,1871,1089,749,340,1075,14,"ORAS BASARABI",,3,,500,575
14,"Constanța",136,"136-ORAS BASARABI",62360,274,2,0,873,0,873,856,17,"ORAS BASARABI",,3,,406,450
14,"Constanța",136,"136-ORAS BASARABI",62360,275,2,2100,1541,994,547,1530,11,"ORAS BASARABI",,3,,770,760
14,"Constanța",136,"136-ORAS BASARABI",62360,276,2,503,547,286,261,541,6,"ORAS BASARABI",,3,,222,319
14,"Constanța",136,"136-ORAS BASARABI",62360,277,2,717,533,456,77,527,6,"ORAS BASARABI",,3,,250,277
14,"Constanța",136,"136-ORAS CERNAVODA",60776,278,2,1014,892,605,287,885,7,"ORAS CERNAVODA",,3,,247,638
14,"Constanța",136,"136-ORAS CERNAVODA",60776,279,2,1062,916,656,260,911,5,"ORAS CERNAVODA",,3,,290,621
14,"Constanța",136,"136-ORAS CERNAVODA",60776,280,2,1033,850,696,154,844,6,"ORAS CERNAVODA",,3,,358,486
14,"Constanța",136,"136-ORAS CERNAVODA",60776,281,2,1292,1073,917,156,1067,6,"ORAS CERNAVODA",,3,,558,509
14,"Constanța",136,"136-ORAS CERNAVODA",60776,282,2,1105,1045,748,297,1041,4,"ORAS CERNAVODA",,3,,381,660
14,"Constanța",136,"136-ORAS CERNAVODA",60776,283,2,1489,1352,1003,349,1346,6,"ORAS CERNAVODA",,3,,474,872
14,"Constanța",136,"136-ORAS CERNAVODA",60776,284,2,951,808,665,143,805,3,"ORAS CERNAVODA",,3,,380,425
14,"Constanța",136,"136-ORAS CERNAVODA",60776,285,2,795,631,540,91,629,2,"ORAS CERNAVODA",,3,,283,346
14,"Constanța",136,"136-ORAS CERNAVODA",60776,286,2,982,804,599,205,804,0,"ORAS CERNAVODA",,3,,221,583
14,"Constanța",136,"136-ORAS CERNAVODA",60776,287,2,764,747,467,280,745,2,"ORAS CERNAVODA",,3,,156,589
14,"Constanța",136,"136-ORAS CERNAVODA",60776,288,2,788,930,402,528,926,4,"ORAS CERNAVODA",,3,,198,728
14,"Constanța",136,"136-ORAS CERNAVODA",60776,289,2,277,262,247,15,254,8,"ORAS CERNAVODA",,3,,155,99
14,"Constanța",136,"136-ORAS EFORIE",60455,290,2,1396,1082,960,122,1077,5,"ORAS EFORIE",,3,,456,621
14,"Constanța",136,"136-ORAS EFORIE",60455,291,2,1519,1237,1053,184,1233,4,"ORAS EFORIE",,3,,559,674
14,"Constanța",136,"136-ORAS EFORIE",60455,292,2,862,774,601,173,772,2,"ORAS EFORIE",,3,,363,409
14,"Constanța",136,"136-ORAS EFORIE",60455,293,2,1296,1375,890,485,1372,3,"ORAS EFORIE",,3,,511,861
14,"Constanța",136,"136-ORAS EFORIE",60455,294,2,1022,1009,678,331,1007,2,"ORAS EFORIE",,3,,309,698
14,"Constanța",136,"136-ORAS EFORIE",60455,295,2,1247,1201,912,289,1198,3,"ORAS EFORIE",,3,,374,824
14,"Constanța",136,"136-ORAS HARSOVA",60801,296,2,1290,908,834,74,903,5,"ORAS HARSOVA",,3,,514,389
14,"Constanța",136,"136-ORAS HARSOVA",60801,297,2,1148,808,764,44,801,7,"ORAS HARSOVA",,3,,382,419
14,"Constanța",136,"136-ORAS HARSOVA",60801,298,2,1430,986,924,62,974,12,"ORAS HARSOVA",,3,,529,445
14,"Constanța",136,"136-ORAS HARSOVA",60801,299,2,1427,975,887,88,966,9,"ORAS HARSOVA",,3,,533,433
14,"Constanța",136,"136-ORAS HARSOVA",60801,300,2,1257,947,865,82,940,7,"ORAS HARSOVA",,3,,547,393
14,"Constanța",136,"136-ORAS HARSOVA",60801,301,2,913,675,627,48,674,1,"ORAS HARSOVA",,3,,347,327
14,"Constanța",136,"136-ORAS HARSOVA",60801,302,2,313,253,212,41,250,3,"ORAS HARSOVA",,3,,166,84
14,"Constanța",136,"136-ORAS NAVODARI",60507,303,2,1951,1473,1232,241,1467,6,"ORAS NAVODARI",,3,,378,1089
14,"Constanța",136,"136-ORAS NAVODARI",60507,304,2,1675,1249,1131,118,1244,5,"ORAS NAVODARI",,3,,319,925
14,"Constanța",136,"136-ORAS NAVODARI",60507,305,2,1447,1034,863,171,1027,7,"ORAS NAVODARI",,3,,246,781
14,"Constanța",136,"136-ORAS NAVODARI",60507,306,2,1242,974,816,158,970,4,"ORAS NAVODARI",,3,,270,700
14,"Constanța",136,"136-ORAS NAVODARI",60507,307,2,1296,1094,899,195,1089,5,"ORAS NAVODARI",,3,,341,748
14,"Constanța",136,"136-ORAS NAVODARI",60507,308,2,1258,996,832,164,994,2,"ORAS NAVODARI",,3,,238,756
14,"Constanța",136,"136-ORAS NAVODARI",60507,309,2,1745,1203,1048,155,1198,5,"ORAS NAVODARI",,3,,322,876
14,"Constanța",136,"136-ORAS NAVODARI",60507,310,2,1785,1192,1047,145,1184,8,"ORAS NAVODARI",,3,,379,805
14,"Constanța",136,"136-ORAS NAVODARI",60507,311,2,1326,1067,927,140,1060,7,"ORAS NAVODARI",,3,,308,752
14,"Constanța",136,"136-ORAS NAVODARI",60507,312,2,1510,1058,899,159,1052,6,"ORAS NAVODARI",,3,,329,723
14,"Constanța",136,"136-ORAS NAVODARI",60507,313,2,1839,1278,1139,139,1270,8,"ORAS NAVODARI",,3,,367,903
14,"Constanța",136,"136-ORAS NAVODARI",60507,314,2,1349,1018,851,167,1013,5,"ORAS NAVODARI",,3,,310,703
14,"Constanța",136,"136-ORAS NAVODARI",60507,315,2,1563,1121,978,143,1114,7,"ORAS NAVODARI",,3,,422,692
14,"Constanța",136,"136-ORAS NAVODARI",60507,316,2,913,1093,611,482,1090,3,"ORAS NAVODARI",,3,,245,845
14,"Constanța",136,"136-ORAS NAVODARI",60507,317,2,1551,1399,911,488,1391,8,"ORAS NAVODARI",,3,,337,1054
14,"Constanța",136,"136-ORAS NAVODARI",60507,318,2,73,80,63,17,79,1,"ORAS NAVODARI",,3,,27,52
14,"Constanța",136,"136-ORAS NAVODARI",60507,319,2,239,293,239,54,287,6,"ORAS NAVODARI",,3,,76,211
14,"Constanța",136,"136-ORAS NAVODARI",60507,320,2,220,226,201,25,225,1,"ORAS NAVODARI",,3,,106,119
14,"Constanța",136,"136-ORAS NEGRU VODA",62397,321,2,1229,1424,1229,195,1414,10,"ORAS NEGRU VODA",,3,,875,539
14,"Constanța",136,"136-ORAS NEGRU VODA",62397,322,2,1168,967,828,139,962,5,"ORAS NEGRU VODA",,3,,593,369
14,"Constanța",136,"136-ORAS NEGRU VODA",62397,323,2,846,533,455,78,527,6,"ORAS NEGRU VODA",,3,,288,239
14,"Constanța",136,"136-ORAS OVIDIU",60687,324,2,1681,1296,1205,91,1284,12,"ORAS OVIDIU",,3,,606,678
14,"Constanța",136,"136-ORAS OVIDIU",60687,325,2,1458,1152,1005,147,1146,6,"ORAS OVIDIU",,3,,407,739
14,"Constanța",136,"136-ORAS OVIDIU",60687,326,2,2188,1745,1616,129,1723,22,"ORAS OVIDIU",,3,,617,1106
14,"Constanța",136,"136-ORAS OVIDIU",60687,327,2,2349,1933,1756,177,1923,10,"ORAS OVIDIU",,3,,709,1214
14,"Constanța",136,"136-ORAS OVIDIU",60687,328,2,434,410,314,96,408,2,"ORAS OVIDIU",,3,,145,263
14,"Constanța",136,"136-ORAS OVIDIU",60687,329,2,643,595,457,138,584,11,"ORAS OVIDIU",,3,,327,257
14,"Constanța",136,"136-ORAS OVIDIU",60687,330,2,0,111,0,111,111,0,"ORAS OVIDIU",,3,,33,78
14,"Constanța",136,"136-ORAS TECHIRGHIOL",60534,331,2,1587,1245,1140,105,1239,6,"ORAS TECHIRGHIOL",,3,,415,824
14,"Constanța",136,"136-ORAS TECHIRGHIOL",60534,332,2,1485,1086,990,96,1080,6,"ORAS TECHIRGHIOL",,3,,375,705
14,"Constanța",136,"136-ORAS TECHIRGHIOL",60534,333,2,1186,913,824,89,904,9,"ORAS TECHIRGHIOL",,3,,325,579
14,"Constanța",136,"136-ORAS TECHIRGHIOL",60534,334,2,959,801,692,109,795,6,"ORAS TECHIRGHIOL",,3,,325,470
14,"Constanța",136,"136-ORAS TECHIRGHIOL",60534,335,2,12,371,7,364,368,3,"ORAS TECHIRGHIOL",,3,,190,178
14,"Constanța",136,"136-ADAMCLISI",60883,336,2,945,645,550,95,638,7,"ADAMCLISI",,3,,336,302
14,"Constanța",136,"136-ADAMCLISI",60883,337,2,471,329,300,29,320,9,"ADAMCLISI",,3,,160,160
14,"Constanța",136,"136-ADAMCLISI",60883,338,2,228,167,140,27,162,5,"ADAMCLISI",,3,,80,82
14,"Constanța",136,"136-ADAMCLISI",60883,339,2,109,97,44,53,97,0,"ADAMCLISI",,3,,40,57
14,"Constanța",136,"136-AGIGEA",60570,340,2,1867,1270,1097,173,1263,7,"AGIGEA",,3,,435,828
14,"Constanța",136,"136-AGIGEA",60570,341,2,1342,1186,995,191,1177,9,"AGIGEA",,3,,523,654
14,"Constanța",136,"136-AGIGEA",60570,342,2,219,463,142,321,459,4,"AGIGEA",,3,,140,319
14,"Constanța",136,"136-ALBESTI",60945,343,2,1192,747,592,155,744,3,"ALBESTI",,3,,494,250
14,"Constanța",136,"136-ALBESTI",60945,344,2,697,500,377,123,496,4,"ALBESTI",,3,,295,201
14,"Constanța",136,"136-ALBESTI",60945,345,2,154,170,95,75,170,0,"ALBESTI",,3,,119,51
14,"Constanța",136,"136-ALBESTI",60945,346,2,114,137,62,75,136,1,"ALBESTI",,3,,82,54
14,"Constanța",136,"136-ALBESTI",60945,347,2,218,265,150,115,263,2,"ALBESTI",,3,,148,115
14,"Constanța",136,"136-ALIMAN",61005,348,2,1081,730,593,137,712,18,"ALIMAN",,3,,434,278
14,"Constanța",136,"136-ALIMAN",61005,349,2,1225,819,734,85,803,16,"ALIMAN",,3,,603,200
14,"Constanța",136,"136-AMZACEA",63090,350,2,785,592,464,128,582,10,"AMZACEA",,3,,358,224
14,"Constanța",136,"136-AMZACEA",63090,351,2,729,490,410,80,478,12,"AMZACEA",,3,,305,173
14,"Constanța",136,"136-AMZACEA",63090,352,2,367,261,215,46,260,1,"AMZACEA",,3,,117,143
14,"Constanța",136,"136-BANEASA",61069,353,2,881,746,574,172,730,16,"BANEASA",,3,,446,284
14,"Constanța",136,"136-BANEASA",61069,354,2,1755,1367,1075,292,1356,11,"BANEASA",,3,,880,476
14,"Constanța",136,"136-BANEASA",61069,355,2,587,474,406,68,464,10,"BANEASA",,3,,325,139
14,"Constanța",136,"136-BANEASA",61069,356,2,645,461,333,128,448,13,"BANEASA",,3,,292,156
14,"Constanța",136,"136-CASTELU",61121,357,2,954,715,583,132,699,16,"CASTELU",,3,,415,284
14,"Constanța",136,"136-CASTELU",61121,358,2,874,684,545,139,676,8,"CASTELU",,3,,383,293
14,"Constanța",136,"136-CASTELU",61121,359,2,806,642,479,163,637,5,"CASTELU",,3,,389,248
14,"Constanța",136,"136-CASTELU",61121,360,2,956,705,562,143,691,14,"CASTELU",,3,,479,212
14,"Constanța",136,"136-CASTELU",61121,361,2,1097,746,541,205,741,5,"CASTELU",,3,,340,401
14,"Constanța",136,"136-CERCHEZU",61167,362,2,543,390,300,90,385,5,"CERCHEZU",,3,,221,164
14,"Constanța",136,"136-CERCHEZU",61167,363,2,576,438,334,104,427,11,"CERCHEZU",,3,,278,149
14,"Constanța",136,"136-CHIRNOGENI",61210,364,2,1375,1112,927,185,1094,18,"CHIRNOGENI",,3,,699,395
14,"Constanța",136,"136-CHIRNOGENI",61210,365,2,191,186,140,46,184,2,"CHIRNOGENI",,3,,111,73
14,"Constanța",136,"136-CHIRNOGENI",61210,366,2,982,675,588,87,671,4,"CHIRNOGENI",,3,,335,336
14,"Constanța",136,"136-CIOBANU",61256,367,2,1117,785,711,74,778,7,"CIOBANU",,3,,468,310
14,"Constanța",136,"136-CIOBANU",61256,368,2,1202,920,860,60,918,2,"CIOBANU",,3,,553,365
14,"Constanța",136,"136-CIOBANU",61256,369,2,287,245,201,44,245,0,"CIOBANU",,3,,163,82
14,"Constanța",136,"136-CIOCARLIA",61283,370,2,1469,958,792,166,936,22,"CIOCARLIA",,3,,530,406
14,"Constanța",136,"136-CIOCARLIA",61283,371,2,648,528,384,144,527,1,"CIOCARLIA",,3,,285,242
14,"Constanța",136,"136-COBADIN",61318,372,2,1623,1374,1161,213,1161,8,"COBADIN",,3,,700,461
14,"Constanța",136,"136-COBADIN",61318,373,2,1527,1122,935,187,1113,9,"COBADIN",,3,,619,494
14,"Constanța",136,"136-COBADIN",61318,374,2,1443,1034,858,176,1025,9,"COBADIN",,3,,590,435
14,"Constanța",136,"136-COBADIN",61318,375,2,271,244,169,75,238,6,"COBADIN",,3,,155,83
14,"Constanța",136,"136-COBADIN",61318,376,2,413,334,245,89,330,4,"COBADIN",,3,,252,78
14,"Constanța",136,"136-COBADIN",61318,377,2,1042,871,650,221,858,13,"COBADIN",,3,,423,435
14,"Constanța",136,"136-COGEALAC",61372,378,2,1411,993,804,189,983,10,"COGEALAC",,3,,664,319
14,"Constanța",136,"136-COGEALAC",61372,379,2,1363,951,800,151,946,5,"COGEALAC",,3,,560,386
14,"Constanța",136,"136-COGEALAC",61372,380,2,768,616,472,144,608,8,"COGEALAC",,3,,308,300
14,"Constanța",136,"136-COGEALAC",61372,381,2,1266,835,699,136,828,7,"COGEALAC",,3,,571,257
14,"Constanța",136,"136-COGEALAC",61372,382,2,589,455,361,94,452,3,"COGEALAC",,3,,255,197
14,"Constanța",136,"136-COMANA",61452,383,2,647,528,439,89,522,6,"COMANA",,3,,332,190
14,"Constanța",136,"136-COMANA",61452,384,2,443,337,290,47,333,4,"COMANA",,3,,208,125
14,"Constanța",136,"136-COMANA",61452,385,2,227,173,130,43,171,1,"COMANA",,3,,105,66
14,"Constanța",136,"136-CORBU",61513,386,2,1433,1178,888,290,1170,8,"CORBU",,3,,396,774
14,"Constanța",136,"136-CORBU",61513,387,2,1139,927,713,214,923,4,"CORBU",,3,,412,511
14,"Constanța",136,"136-CORBU",61513,388,2,444,421,280,141,416,5,"CORBU",,3,,161,255
14,"Constanța",136,"136-CRUCEA",61559,389,2,914,688,538,150,685,3,"CRUCEA",,3,,457,228
14,"Constanța",136,"136-CRUCEA",61559,390,2,223,211,166,45,211,0,"CRUCEA",,3,,115,96
14,"Constanța",136,"136-CRUCEA",61559,391,2,357,293,240,53,286,7,"CRUCEA",,3,,230,56
14,"Constanța",136,"136-CRUCEA",61559,392,2,521,408,328,80,403,5,"CRUCEA",,3,,318,85
14,"Constanța",136,"136-CRUCEA",61559,393,2,490,313,259,54,311,2,"CRUCEA",,3,,197,114
14,"Constanța",136,"136-CUMPANA",61620,394,2,1949,1446,1232,214,1437,9,"CUMPANA",,3,,544,893
14,"Constanța",136,"136-CUMPANA",61620,395,2,1860,1441,1225,216,1427,14,"CUMPANA",,3,,531,896
14,"Constanța",136,"136-CUMPANA",61620,396,2,1781,1294,1134,160,1274,20,"CUMPANA",,3,,477,797
14,"Constanța",136,"136-DELENI",61675,397,2,267,233,171,62,229,4,"DELENI",,3,,142,87
14,"Constanța",136,"136-DELENI",61675,398,2,383,349,274,75,344,5,"DELENI",,3,,205,139
14,"Constanța",136,"136-DELENI",61675,399,2,427,361,272,89,359,2,"DELENI",,3,,248,111
14,"Constanța",136,"136-DELENI",61675,400,2,494,411,279,132,405,6,"DELENI",,3,,238,167
14,"Constanța",136,"136-DOBROMIR",61737,401,2,710,324,237,87,319,5,"DOBROMIR",,3,,186,133
14,"Constanța",136,"136-DOBROMIR",61737,402,2,326,257,185,72,255,2,"DOBROMIR",,3,,166,89
14,"Constanța",136,"136-DOBROMIR",61737,403,2,196,226,116,110,222,4,"DOBROMIR",,3,,87,135
14,"Constanța",136,"136-DOBROMIR",61737,404,2,472,345,191,154,344,1,"DOBROMIR",,3,,236,108
14,"Constanța",136,"136-DOBROMIR",61737,405,2,84,110,46,64,107,3,"DOBROMIR",,3,,64,43
14,"Constanța",136,"136-23 AUGUST",60598,406,2,2425,1455,1170,285,1443,12,"23 AUGUST",,3,,773,670
14,"Constanța",136,"136-23 AUGUST",60598,407,2,698,680,393,287,671,9,"23 AUGUST",,3,,436,235
14,"Constanța",136,"136-23 AUGUST",60598,408,2,607,805,402,403,802,3,"23 AUGUST",,3,,440,362
14,"Constanța",136,"136-DUMBRAVENI",61899,409,2,427,324,250,74,320,4,"DUMBRAVENI",,3,,164,156
14,"Constanța",136,"136-GHINDARESTI",61826,410,2,1120,754,682,72,750,4,"GHINDARESTI",,3,,282,468
14,"Constanța",136,"136-GHINDARESTI",61826,411,2,1000,794,745,49,789,5,"GHINDARESTI",,3,,172,617
14,"Constanța",136,"136-GHINDARESTI",61826,412,2,331,248,212,36,248,0,"GHINDARESTI",,3,,178,70
14,"Constanța",136,"136-GHINDARESTI",61826,413,2,693,469,395,74,463,6,"GHINDARESTI",,3,,327,136
14,"Constanța",136,"136-GARLICIU",61808,414,2,1482,1061,975,86,1053,8,"GARLICIU",,3,,717,336
14,"Constanța",136,"136-INDEPENDENTA",61871,415,2,969,648,564,84,641,7,"INDEPENDENTA",,3,,454,187
14,"Constanța",136,"136-INDEPENDENTA",61871,416,2,433,370,302,68,362,8,"INDEPENDENTA",,3,,169,193
14,"Constanța",136,"136-INDEPENDENTA",61871,417,2,362,283,239,44,280,3,"INDEPENDENTA",,3,,129,151
14,"Constanța",136,"136-INDEPENDENTA",61871,418,2,280,214,182,32,212,2,"INDEPENDENTA",,3,,145,67
14,"Constanța",136,"136-INDEPENDENTA",61871,419,2,253,220,188,32,218,2,"INDEPENDENTA",,3,,189,29
14,"Constanța",136,"136-ION CORVIN",61951,420,2,368,370,258,112,363,7,"ION CORVIN",,3,,246,117
14,"Constanța",136,"136-ION CORVIN",61951,421,2,765,584,523,61,571,13,"ION CORVIN",,3,,312,259
14,"Constanța",136,"136-ION CORVIN",61951,422,2,167,158,118,40,149,9,"ION CORVIN",,3,,96,53
14,"Constanța",136,"136-ION CORVIN",61951,423,2,116,148,102,46,140,8,"ION CORVIN",,3,,72,68
14,"Constanța",136,"136-ISTRIA",62020,424,2,970,730,588,142,727,3,"ISTRIA",,3,,372,355
14,"Constanța",136,"136-ISTRIA",62020,425,2,740,549,431,118,542,7,"ISTRIA",,3,,286,256
14,"Constanța",136,"136-LIMANU",60632,426,2,1396,1104,865,239,1094,10,"LIMANU",,3,,649,445
14,"Constanța",136,"136-LIMANU",60632,427,2,1521,1312,1050,262,1301,11,"LIMANU",,3,,675,626
14,"Constanța",136,"136-LIPNITA",62057,428,2,790,636,472,164,623,13,"LIPNITA",,3,,495,128
14,"Constanța",136,"136-LIPNITA",62057,429,2,650,467,368,99,456,11,"LIPNITA",,3,,333,123
14,"Constanța",136,"136-LIPNITA",62057,430,2,498,392,305,87,386,6,"LIPNITA",,3,,240,146
14,"Constanța",136,"136-LIPNITA",62057,431,2,141,115,91,24,101,7,"LIPNITA",,3,,57,44
14,"Constanța",136,"136-LIPNITA",62057,432,2,181,112,84,28,112,0,"LIPNITA",,3,,72,40
14,"Constanța",136,"136-LIPNITA",62057,433,2,467,330,254,76,324,6,"LIPNITA",,3,,214,110
14,"Constanța",136,"136-LIPNITA",62057,434,2,118,109,69,40,109,0,"LIPNITA",,3,,76,33
14,"Constanța",136,"136-LUMINA",60703,435,2,1761,1507,1000,507,1483,24,"LUMINA",,3,,429,1054
14,"Constanța",136,"136-LUMINA",60703,436,2,1416,1409,945,464,1402,7,"LUMINA",,3,,473,929
14,"Constanța",136,"136-LUMINA",60703,437,2,396,334,267,67,331,3,"LUMINA",,3,,41,290
14,"Constanța",136,"136-LUMINA",60703,438,2,282,263,227,36,262,1,"LUMINA",,3,,139,123
14,"Constanța",136,"136-MERENI",62137,439,2,862,590,498,92,579,11,"MERENI",,3,,362,217
14,"Constanța",136,"136-MERENI",62137,440,2,626,496,418,78,493,3,"MERENI",,3,,320,173
14,"Constanța",136,"136-MERENI",62137,441,2,703,477,392,85,469,8,"MERENI",,3,,306,163
14,"Constanța",136,"136-MERENI",62137,442,2,431,278,224,54,276,2,"MERENI",,3,,125,151
14,"Constanța",136,"136-MERENI",62137,443,2,255,216,175,41,216,0,"MERENI",,3,,143,73
14,"Constanța",136,"136-MIHAIL KOGALNICEANU",62191,444,2,1850,1443,1210,233,1437,6,"MIHAIL KOGALNICEANU",,3,,557,880
14,"Constanța",136,"136-MIHAIL KOGALNICEANU",62191,445,2,1823,1529,1153,376,1521,8,"MIHAIL KOGALNICEANU",,3,,725,796
14,"Constanța",136,"136-MIHAIL KOGALNICEANU",62191,446,2,1269,1106,800,306,1101,5,"MIHAIL KOGALNICEANU",,3,,507,594
14,"Constanța",136,"136-MIHAIL KOGALNICEANU",62191,447,2,322,254,212,42,253,1,"MIHAIL KOGALNICEANU",,3,,125,128
14,"Constanța",136,"136-MIHAIL KOGALNICEANU",62191,448,2,235,232,90,142,232,0,"MIHAIL KOGALNICEANU",,3,,140,92
14,"Constanța",136,"136-MIHAIL KOGALNICEANU",62191,449,2,574,442,365,77,438,4,"MIHAIL KOGALNICEANU",,3,,221,217
14,"Constanța",136,"136-MIHAIL KOGALNICEANU",62191,450,2,206,195,161,34,192,3,"MIHAIL KOGALNICEANU",,3,,47,145
14,"Constanța",136,"136-MIHAIL KOGALNICEANU",62191,451,2,981,765,719,46,755,10,"MIHAIL KOGALNICEANU",,3,,349,406
14,"Constanța",136,"136-MIHAI VITEAZU",62253,452,2,1288,882,788,94,869,13,"MIHAI VITEAZU",,3,,409,460
14,"Constanța",136,"136-MIHAI VITEAZU",62253,453,2,861,615,489,126,605,10,"MIHAI VITEAZU",,3,,259,346
14,"Constanța",136,"136-MIRCEA VODA",62280,454,2,1354,841,651,190,823,18,"MIRCEA VODA",,3,,546,277
14,"Constanța",136,"136-MIRCEA VODA",62280,455,2,1537,1370,975,395,1311,59,"MIRCEA VODA",,3,,934,377
14,"Constanța",136,"136-MIRCEA VODA",62280,456,2,452,553,267,286,547,6,"MIRCEA VODA",,3,,280,267
14,"Constanța",136,"136-MIRCEA VODA",62280,457,2,784,436,299,137,429,7,"MIRCEA VODA",,3,,242,187
14,"Constanța",136,"136-MIRCEA VODA",62280,458,2,222,281,139,142,281,0,"MIRCEA VODA",,3,,126,155
14,"Constanța",136,"136-MIRCEA VODA",62280,459,2,87,88,52,36,81,7,"MIRCEA VODA",,3,,48,33
14,"Constanța",136,"136-NICOLAE BALCESCU",62440,460,2,1014,748,551,197,733,15,"NICOLAE BALCESCU",,3,,474,259
14,"Constanța",136,"136-NICOLAE BALCESCU",62440,461,2,1235,864,648,216,855,9,"NICOLAE BALCESCU",,3,,516,339
14,"Constanța",136,"136-NICOLAE BALCESCU",62440,462,2,1465,879,719,160,864,15,"NICOLAE BALCESCU",,3,,534,330
14,"Constanța",136,"136-OLTINA",62486,463,2,1614,1263,1169,94,1247,16,"OLTINA",,3,,829,418
14,"Constanța",136,"136-OLTINA",62486,464,2,501,461,430,31,454,7,"OLTINA",,3,,338,116
14,"Constanța",136,"136-OLTINA",62486,465,2,260,241,217,24,240,1,"OLTINA",,3,,182,58
14,"Constanța",136,"136-OSTROV",62538,466,2,2245,1724,1331,393,1710,14,"OSTROV",,3,,1101,609
14,"Constanța",136,"136-OSTROV",62538,467,2,740,667,482,185,659,8,"OSTROV",,3,,541,118
14,"Constanța",136,"136-OSTROV",62538,468,2,295,230,175,55,228,2,"OSTROV",,3,,177,51
14,"Constanța",136,"136-OSTROV",62538,469,2,291,213,143,70,209,4,"OSTROV",,3,,122,87
14,"Constanța",136,"136-OSTROV",62538,470,2,374,368,265,103,363,5,"OSTROV",,3,,245,118
14,"Constanța",136,"136-OSTROV",62538,471,2,158,195,113,82,195,0,"OSTROV",,3,,100,95
14,"Constanța",136,"136-PANTELIMON",62609,472,2,474,431,351,80,425,6,"PANTELIMON",,3,,211,214
14,"Constanța",136,"136-PANTELIMON",62609,473,2,169,157,122,35,157,0,"PANTELIMON",,3,,83,74
14,"Constanța",136,"136-PANTELIMON",62609,474,2,255,252,203,49,247,5,"PANTELIMON",,3,,165,82
14,"Constanța",136,"136-PANTELIMON",62609,475,2,213,169,121,48,166,3,"PANTELIMON",,3,,78,88
14,"Constanța",136,"136-PECINEAGA",62672,476,2,2000,1455,1234,221,1430,25,"PECINEAGA",,3,,840,590
14,"Constanța",136,"136-PESTERA",62707,477,2,1273,839,711,128,831,8,"PESTERA",,3,,619,212
14,"Constanța",136,"136-PESTERA",62707,478,2,691,452,382,70,437,15,"PESTERA",,3,,349,88
14,"Constanța",136,"136-PESTERA",62707,479,2,472,322,273,49,319,3,"PESTERA",,3,,208,111
14,"Constanța",136,"136-POARTA ALBA",62761,480,2,2022,1378,1178,200,1360,18,"POARTA ALBA",,3,,738,622
14,"Constanța",136,"136-POARTA ALBA",62761,481,2,719,1392,405,987,1377,15,"POARTA ALBA",,3,,602,775
14,"Constanța",136,"136-POARTA ALBA",62761,482,2,277,235,169,66,231,4,"POARTA ALBA",,3,,106,125
14,"Constanța",136,"136-RASOVA",62798,483,2,1938,1363,1104,259,1328,35,"RASOVA",,3,,929,399
14,"Constanța",136,"136-RASOVA",62798,484,2,795,646,514,132,627,19,"RASOVA",,3,,451,176
14,"Constanța",136,"136-SARAIU",62823,485,2,750,578,516,62,570,8,"SARAIU",,3,,473,97
14,"Constanța",136,"136-SARAIU",62823,486,2,460,340,290,50,336,4,"SARAIU",,3,,191,145
14,"Constanța",136,"136-SACELE",62878,487,2,1448,1124,932,192,1113,11,"SACELE",,3,,750,363
14,"Constanța",136,"136-SEIMENI",62903,488,2,572,434,348,86,424,10,"SEIMENI",,3,,205,219
14,"Constanța",136,"136-SEIMENI",62903,489,2,371,314,226,88,308,6,"SEIMENI",,3,,206,102
14,"Constanța",136,"136-SEIMENI",62903,490,2,562,464,378,86,460,4,"SEIMENI",,3,,298,162
14,"Constanța",136,"136-SILISTEA",62949,491,2,435,392,298,94,388,4,"SILISTEA",,3,,268,120
14,"Constanța",136,"136-SILISTEA",62949,492,2,461,450,366,84,444,6,"SILISTEA",,3,,318,126
14,"Constanța",136,"136-TARGUSOR",62985,493,2,223,216,164,52,214,2,"TARGUSOR",,3,,173,41
14,"Constanța",136,"136-TARGUSOR",62985,494,2,995,790,674,116,784,6,"TARGUSOR",,3,,500,284
14,"Constanța",136,"136-TARGUSOR",62985,495,2,221,214,148,66,213,1,"TARGUSOR",,3,,92,121
14,"Constanța",136,"136-TARGUSOR",62985,496,2,627,464,406,58,459,5,"TARGUSOR",,3,,276,183
14,"Constanța",136,"136-TOPALU",63045,497,2,1545,999,870,129,986,13,"TOPALU",,3,,703,283
14,"Constanța",136,"136-TOPRAISAR",63072,498,2,1085,833,593,240,822,11,"TOPRAISAR",,3,,574,248
14,"Constanța",136,"136-TOPRAISAR",63072,499,2,1245,907,755,152,903,4,"TOPRAISAR",,3,,512,391
14,"Constanța",136,"136-TOPRAISAR",63072,500,2,1326,1197,1184,13,1174,23,"TOPRAISAR",,3,,812,362
14,"Constanța",136,"136-TOPRAISAR",63072,501,2,449,376,304,72,371,5,"TOPRAISAR",,3,,240,131
14,"Constanța",136,"136-TOPRAISAR",63072,502,2,515,433,278,155,425,8,"TOPRAISAR",,3,,261,164
14,"Constanța",136,"136-TOPRAISAR",63072,503,2,238,256,162,94,253,3,"TOPRAISAR",,3,,174,79
14,"Constanța",136,"136-TORTOMAN",62967,504,2,1081,913,722,191,901,12,"TORTOMAN",,3,,705,196
14,"Constanța",136,"136-TUZLA",60721,505,2,1173,899,727,172,891,8,"TUZLA",,3,,350,541
14,"Constanța",136,"136-TUZLA",60721,506,2,1565,1237,1026,211,1223,14,"TUZLA",,3,,588,635
14,"Constanța",136,"136-TUZLA",60721,507,2,1309,1068,826,242,1054,14,"TUZLA",,3,,417,637
14,"Constanța",136,"136-TUZLA",60721,508,2,93,106,88,18,105,1,"TUZLA",,3,,33,72
14,"Constanța",136,"136-TUZLA",60721,509,2,212,231,209,22,228,3,"TUZLA",,3,,121,107
14,"Constanța",136,"136-TUZLA",60721,510,2,1338,1302,922,380,1288,14,"TUZLA",,3,,484,804
14,"Constanța",136,"136-VALU LUI TRAIAN",63125,511,2,2515,1821,1430,391,1807,14,"VALU LUI TRAIAN",,3,,941,866
14,"Constanța",136,"136-VALU LUI TRAIAN",63125,512,2,2006,1205,1041,164,1194,11,"VALU LUI TRAIAN",,3,,606,588
14,"Constanța",136,"136-VALU LUI TRAIAN",63125,513,2,1538,1171,966,205,1162,9,"VALU LUI TRAIAN",,3,,540,622
14,"Constanța",136,"136-VALU LUI TRAIAN",63125,514,2,0,138,0,138,137,1,"VALU LUI TRAIAN",,3,,61,76
14,"Constanța",136,"136-VULTURU",62663,515,2,459,322,281,41,319,3,"VULTURU",,3,,228,91
15,"Covasna",145,"145-MUNICIPIUL SFANTU GHEORGHE",63394,1,2,1283,997,941,56,995,2,"MUNICIPIUL SFANTU GHEORGHE",,7,,94,901
15,"Covasna",145,"145-MUNICIPIUL SFANTU GHEORGHE",63394,2,2,1200,945,777,168,940,5,"MUNICIPIUL SFANTU GHEORGHE",,7,,88,852
15,"Covasna",145,"145-MUNICIPIUL SFANTU GHEORGHE",63394,3,2,1402,1052,986,66,1049,3,"MUNICIPIUL SFANTU GHEORGHE",,7,,62,987
15,"Covasna",145,"145-MUNICIPIUL SFANTU GHEORGHE",63394,4,2,1337,1138,974,164,1130,8,"MUNICIPIUL SFANTU GHEORGHE",,7,,130,1000
15,"Covasna",145,"145-MUNICIPIUL SFANTU GHEORGHE",63394,5,2,1480,1169,1068,101,1167,2,"MUNICIPIUL SFANTU GHEORGHE",,7,,138,1029
15,"Covasna",145,"145-MUNICIPIUL SFANTU GHEORGHE",63394,6,2,1848,1520,1392,128,1515,5,"MUNICIPIUL SFANTU GHEORGHE",,7,,182,1333
15,"Covasna",145,"145-MUNICIPIUL SFANTU GHEORGHE",63394,7,2,1475,1240,1177,63,1237,3,"MUNICIPIUL SFANTU GHEORGHE",,7,,78,1159
15,"Covasna",145,"145-MUNICIPIUL SFANTU GHEORGHE",63394,8,2,1411,1142,1103,39,1139,3,"MUNICIPIUL SFANTU GHEORGHE",,7,,37,1102
15,"Covasna",145,"145-MUNICIPIUL SFANTU GHEORGHE",63394,9,2,1211,971,922,49,970,1,"MUNICIPIUL SFANTU GHEORGHE",,7,,25,945
15,"Covasna",145,"145-MUNICIPIUL SFANTU GHEORGHE",63394,10,2,1472,1141,1057,84,1135,6,"MUNICIPIUL SFANTU GHEORGHE",,7,,63,1072
15,"Covasna",145,"145-MUNICIPIUL SFANTU GHEORGHE",63394,11,2,1900,1336,1264,72,1335,1,"MUNICIPIUL SFANTU GHEORGHE",,7,,82,1253
15,"Covasna",145,"145-MUNICIPIUL SFANTU GHEORGHE",63394,12,2,1548,1219,1138,81,1217,2,"MUNICIPIUL SFANTU GHEORGHE",,7,,69,1148
15,"Covasna",145,"145-MUNICIPIUL SFANTU GHEORGHE",63394,13,2,1434,1360,1023,337,1359,1,"MUNICIPIUL SFANTU GHEORGHE",,7,,73,1286
15,"Covasna",145,"145-MUNICIPIUL SFANTU GHEORGHE",63394,14,2,1380,1076,1002,74,1076,0,"MUNICIPIUL SFANTU GHEORGHE",,7,,84,992
15,"Covasna",145,"145-MUNICIPIUL SFANTU GHEORGHE",63394,15,2,1567,1301,1237,64,1298,3,"MUNICIPIUL SFANTU GHEORGHE",,7,,50,1248
15,"Covasna",145,"145-MUNICIPIUL SFANTU GHEORGHE",63394,16,2,1299,1096,955,141,1086,10,"MUNICIPIUL SFANTU GHEORGHE",,7,,24,1062
15,"Covasna",145,"145-MUNICIPIUL SFANTU GHEORGHE",63394,17,2,931,792,730,62,787,5,"MUNICIPIUL SFANTU GHEORGHE",,7,,60,727
15,"Covasna",145,"145-MUNICIPIUL SFANTU GHEORGHE",63394,18,2,1033,818,772,46,813,5,"MUNICIPIUL SFANTU GHEORGHE",,7,,35,778
15,"Covasna",145,"145-MUNICIPIUL SFANTU GHEORGHE",63394,19,2,1252,958,844,114,956,2,"MUNICIPIUL SFANTU GHEORGHE",,7,,53,903
15,"Covasna",145,"145-MUNICIPIUL SFANTU GHEORGHE",63394,20,2,1843,1313,1208,105,1307,6,"MUNICIPIUL SFANTU GHEORGHE",,7,,54,1253
15,"Covasna",145,"145-MUNICIPIUL SFANTU GHEORGHE",63394,21,2,1530,1116,1008,108,1110,6,"MUNICIPIUL SFANTU GHEORGHE",,7,,63,1047
15,"Covasna",145,"145-MUNICIPIUL SFANTU GHEORGHE",63394,22,2,1687,1087,968,119,1082,5,"MUNICIPIUL SFANTU GHEORGHE",,7,,105,977
15,"Covasna",145,"145-MUNICIPIUL SFANTU GHEORGHE",63394,23,2,1181,903,838,65,903,0,"MUNICIPIUL SFANTU GHEORGHE",,7,,89,814
15,"Covasna",145,"145-MUNICIPIUL SFANTU GHEORGHE",63394,24,2,1467,1198,995,203,1196,2,"MUNICIPIUL SFANTU GHEORGHE",,7,,116,1080
15,"Covasna",145,"145-MUNICIPIUL SFANTU GHEORGHE",63394,25,2,1662,1246,1148,98,1245,1,"MUNICIPIUL SFANTU GHEORGHE",,7,,111,1134
15,"Covasna",145,"145-MUNICIPIUL SFANTU GHEORGHE",63394,26,2,1902,1576,1334,242,1572,4,"MUNICIPIUL SFANTU GHEORGHE",,7,,173,1399
15,"Covasna",145,"145-MUNICIPIUL SFANTU GHEORGHE",63394,27,2,1388,1045,980,65,1043,2,"MUNICIPIUL SFANTU GHEORGHE",,7,,98,945
15,"Covasna",145,"145-MUNICIPIUL SFANTU GHEORGHE",63394,28,2,1551,1149,1064,85,1146,3,"MUNICIPIUL SFANTU GHEORGHE",,7,,93,1053
15,"Covasna",145,"145-MUNICIPIUL SFANTU GHEORGHE",63394,29,2,1075,1436,1329,107,1430,6,"MUNICIPIUL SFANTU GHEORGHE",,7,,142,1288
15,"Covasna",145,"145-MUNICIPIUL SFANTU GHEORGHE",63394,30,2,2039,1521,1363,158,1516,5,"MUNICIPIUL SFANTU GHEORGHE",,7,,120,1396
15,"Covasna",145,"145-MUNICIPIUL SFANTU GHEORGHE",63394,31,2,1749,1285,1215,70,1281,4,"MUNICIPIUL SFANTU GHEORGHE",,7,,154,1127
15,"Covasna",145,"145-MUNICIPIUL SFANTU GHEORGHE",63394,32,2,1375,1044,936,108,1041,3,"MUNICIPIUL SFANTU GHEORGHE",,7,,124,917
15,"Covasna",145,"145-MUNICIPIUL SFANTU GHEORGHE",63394,33,2,1234,962,844,118,959,3,"MUNICIPIUL SFANTU GHEORGHE",,7,,105,854
15,"Covasna",145,"145-MUNICIPIUL SFANTU GHEORGHE",63394,34,2,1053,759,686,73,756,3,"MUNICIPIUL SFANTU GHEORGHE",,7,,56,700
15,"Covasna",145,"145-MUNICIPIUL SFANTU GHEORGHE",63394,35,2,482,447,392,55,447,0,"MUNICIPIUL SFANTU GHEORGHE",,7,,6,441
15,"Covasna",145,"145-MUNICIPIUL SFANTU GHEORGHE",63394,36,2,344,346,300,46,345,1,"MUNICIPIUL SFANTU GHEORGHE",,7,,10,335
15,"Covasna",145,"145-MUNICIPIUL SFANTU GHEORGHE",63394,37,2,346,364,330,34,360,4,"MUNICIPIUL SFANTU GHEORGHE",,7,,134,226
15,"Covasna",145,"145-ORAS TARGU SECUIESC",63740,38,2,1371,1122,1041,81,1116,6,"ORAS TARGU SECUIESC",,7,,32,1084
15,"Covasna",145,"145-ORAS TARGU SECUIESC",63740,39,2,991,791,715,76,787,4,"ORAS TARGU SECUIESC",,7,,17,770
15,"Covasna",145,"145-ORAS TARGU SECUIESC",63740,40,2,1694,1293,1234,59,1286,7,"ORAS TARGU SECUIESC",,7,,65,1221
15,"Covasna",145,"145-ORAS TARGU SECUIESC",63740,41,2,1586,1270,1177,93,1269,1,"ORAS TARGU SECUIESC",,7,,39,1230
15,"Covasna",145,"145-ORAS TARGU SECUIESC",63740,42,2,1800,1236,1063,173,1234,2,"ORAS TARGU SECUIESC",,7,,64,1170
15,"Covasna",145,"145-ORAS TARGU SECUIESC",63740,43,2,1567,1237,1131,106,1234,3,"ORAS TARGU SECUIESC",,7,,48,1186
15,"Covasna",145,"145-ORAS TARGU SECUIESC",63740,44,2,1319,1103,1019,84,1101,2,"ORAS TARGU SECUIESC",,7,,36,1065
15,"Covasna",145,"145-ORAS TARGU SECUIESC",63740,45,2,1903,1452,1362,90,1446,6,"ORAS TARGU SECUIESC",,7,,31,1415
15,"Covasna",145,"145-ORAS TARGU SECUIESC",63740,46,2,1619,1448,1161,287,1443,5,"ORAS TARGU SECUIESC",,7,,94,1349
15,"Covasna",145,"145-ORAS TARGU SECUIESC",63740,47,2,1473,1188,1121,67,1188,0,"ORAS TARGU SECUIESC",,7,,31,1157
15,"Covasna",145,"145-ORAS TARGU SECUIESC",63740,48,2,397,346,315,31,345,1,"ORAS TARGU SECUIESC",,7,,6,339
15,"Covasna",145,"145-ORAS TARGU SECUIESC",63740,49,2,142,268,116,152,266,2,"ORAS TARGU SECUIESC",,7,,2,264
15,"Covasna",145,"145-ORAS TARGU SECUIESC",63740,50,2,1099,763,711,52,757,6,"ORAS TARGU SECUIESC",,7,,12,745
15,"Covasna",145,"145-ORAS TARGU SECUIESC",63740,51,2,0,156,0,156,156,0,"ORAS TARGU SECUIESC",,7,,14,142
15,"Covasna",145,"145-ORAS COVASNA",63526,52,2,1559,1301,1122,179,1300,1,"ORAS COVASNA",,7,,106,1194
15,"Covasna",145,"145-ORAS COVASNA",63526,53,2,1645,1376,1147,229,1372,4,"ORAS COVASNA",,7,,120,1252
15,"Covasna",145,"145-ORAS COVASNA",63526,54,2,1473,1247,1054,193,1244,3,"ORAS COVASNA",,7,,95,1149
15,"Covasna",145,"145-ORAS COVASNA",63526,55,2,1866,1331,1213,118,1327,4,"ORAS COVASNA",,7,,90,1237
15,"Covasna",145,"145-ORAS COVASNA",63526,56,2,1298,998,894,104,990,8,"ORAS COVASNA",,7,,250,740
15,"Covasna",145,"145-ORAS COVASNA",63526,57,2,1334,1060,1005,55,1058,2,"ORAS COVASNA",,7,,630,428
15,"Covasna",145,"145-ORAS COVASNA",63526,58,2,0,379,0,379,377,2,"ORAS COVASNA",,7,,188,189
15,"Covasna",145,"145-ORAS COVASNA",63526,59,2,0,602,0,602,598,4,"ORAS COVASNA",,7,,314,284
15,"Covasna",145,"145-ORAS COVASNA",63526,60,2,0,414,0,414,414,0,"ORAS COVASNA",,7,,160,254
15,"Covasna",145,"145-ORAS COVASNA",63526,61,2,0,317,0,317,316,1,"ORAS COVASNA",,7,,140,176
15,"Covasna",145,"145-ORAS BARAOLT",63447,62,2,1523,1302,1119,183,1299,3,"ORAS BARAOLT",,7,,31,1268
15,"Covasna",145,"145-ORAS BARAOLT",63447,63,2,1672,1421,1263,158,1417,4,"ORAS BARAOLT",,7,,43,1374
15,"Covasna",145,"145-ORAS BARAOLT",63447,64,2,1472,1122,1041,81,1115,7,"ORAS BARAOLT",,7,,21,1094
15,"Covasna",145,"145-ORAS BARAOLT",63447,65,2,637,605,564,41,602,3,"ORAS BARAOLT",,7,,7,595
15,"Covasna",145,"145-ORAS BARAOLT",63447,66,2,319,302,271,31,297,5,"ORAS BARAOLT",,7,,6,291
15,"Covasna",145,"145-ORAS BARAOLT",63447,67,2,895,829,734,95,824,5,"ORAS BARAOLT",,7,,15,809
15,"Covasna",145,"145-ORAS BARAOLT",63447,68,2,406,370,343,27,368,2,"ORAS BARAOLT",,7,,11,357
15,"Covasna",145,"145-ORAS BARAOLT",63447,69,2,734,647,578,69,641,6,"ORAS BARAOLT",,7,,19,622
15,"Covasna",145,"145-ORAS INTORSURA BUZAULUI",63580,70,2,1693,1249,1161,88,1240,9,"ORAS INTORSURA BUZAULUI",,7,,717,523
15,"Covasna",145,"145-ORAS INTORSURA BUZAULUI",63580,71,2,1491,1035,935,100,1034,1,"ORAS INTORSURA BUZAULUI",,7,,475,559
15,"Covasna",145,"145-ORAS INTORSURA BUZAULUI",63580,72,2,1470,1055,983,72,1048,7,"ORAS INTORSURA BUZAULUI",,7,,730,318
15,"Covasna",145,"145-ORAS INTORSURA BUZAULUI",63580,73,2,883,695,643,52,690,5,"ORAS INTORSURA BUZAULUI",,7,,372,318
15,"Covasna",145,"145-ORAS INTORSURA BUZAULUI",63580,74,2,962,743,665,78,741,2,"ORAS INTORSURA BUZAULUI",,7,,445,296
15,"Covasna",145,"145-AITA MARE",63777,75,2,685,628,535,93,625,3,"AITA MARE",,7,,31,594
15,"Covasna",145,"145-AITA MARE",63777,76,2,628,611,528,83,608,3,"AITA MARE",,7,,21,587
15,"Covasna",145,"145-BARCANI",63633,77,2,1678,1215,1180,35,1200,15,"BARCANI",,7,,791,409
15,"Covasna",145,"145-BARCANI",63633,78,2,499,410,371,39,406,4,"BARCANI",,7,,348,58
15,"Covasna",145,"145-BARCANI",63633,79,2,515,470,431,39,468,2,"BARCANI",,7,,390,78
15,"Covasna",145,"145-BARCANI",63633,80,2,796,708,671,37,703,5,"BARCANI",,7,,600,103
15,"Covasna",145,"145-BATANI",63802,81,2,1839,1467,1299,168,1455,12,"BATANI",,7,,25,1430
15,"Covasna",145,"145-BATANI",63802,82,2,703,599,550,49,594,5,"BATANI",,7,,9,585
15,"Covasna",145,"145-BATANI",63802,83,2,749,668,630,38,659,9,"BATANI",,7,,29,630
15,"Covasna",145,"145-BELIN",63866,84,2,1154,936,861,75,932,4,"BELIN",,7,,62,870
15,"Covasna",145,"145-BELIN",63866,85,2,636,411,388,23,404,7,"BELIN",,7,,274,130
15,"Covasna",145,"145-BODOC",63893,86,2,1264,1180,1070,110,1165,15,"BODOC",,7,,20,1145
15,"Covasna",145,"145-BODOC",63893,87,2,476,426,406,20,425,1,"BODOC",,7,,11,414
15,"Covasna",145,"145-BODOC",63893,88,2,97,110,91,19,110,0,"BODOC",,7,,58,52
15,"Covasna",145,"145-BOROSNEU MARE",63937,89,2,1120,832,711,121,825,7,"BOROSNEU MARE",,7,,18,807
15,"Covasna",145,"145-BOROSNEU MARE",63937,90,2,297,258,220,38,256,2,"BOROSNEU MARE",,7,,30,226
15,"Covasna",145,"145-BOROSNEU MARE",63937,91,2,143,187,126,61,184,3,"BOROSNEU MARE",,7,,11,173
15,"Covasna",145,"145-BOROSNEU MARE",63937,92,2,428,431,330,101,431,0,"BOROSNEU MARE",,7,,35,396
15,"Covasna",145,"145-BRATES",64005,93,2,1231,1040,956,84,1037,3,"BRATES",,7,,8,1029
15,"Covasna",145,"145-BRADUT",64041,94,2,742,638,608,30,636,2,"BRADUT",,7,,12,624
15,"Covasna",145,"145-BRADUT",64041,95,2,603,564,538,26,562,2,"BRADUT",,7,,14,548
15,"Covasna",145,"145-BRADUT",64041,96,2,908,783,724,59,773,10,"BRADUT",,7,,36,737
15,"Covasna",145,"145-BRADUT",64041,97,2,903,906,822,84,883,23,"BRADUT",,7,,7,876
15,"Covasna",145,"145-BRETCU",64096,98,2,2241,1830,1660,170,1643,17,"BRETCU",,7,,345,1298
15,"Covasna",145,"145-BRETCU",64096,99,2,641,599,554,45,590,9,"BRETCU",,7,,97,493
15,"Covasna",145,"145-BRETCU",64096,100,2,290,242,207,35,237,5,"BRETCU",,7,,25,212
15,"Covasna",145,"145-BRETCU",64096,101,2,245,234,203,31,231,3,"BRETCU",,7,,144,87
15,"Covasna",145,"145-CATALINA",64130,102,2,1313,1148,1092,56,1144,4,"CATALINA",,7,,77,1067
15,"Covasna",145,"145-CATALINA",64130,103,2,1223,1117,1066,51,1091,26,"CATALINA",,7,,23,1068
15,"Covasna",145,"145-CERNAT",64194,104,2,1641,1606,1511,95,1604,2,"CERNAT",,7,,18,1586
15,"Covasna",145,"145-CERNAT",64194,105,2,859,731,696,35,718,13,"CERNAT",,7,,14,704
15,"Covasna",145,"145-CERNAT",64194,106,2,318,297,273,24,295,2,"CERNAT",,7,,7,288
15,"Covasna",145,"145-CERNAT",64194,107,2,224,224,204,20,223,1,"CERNAT",,7,,0,223
15,"Covasna",145,"145-CHICHIS",64238,108,2,846,750,689,61,747,3,"CHICHIS",,7,,44,703
15,"Covasna",145,"145-CHICHIS",64238,109,2,480,392,330,62,388,4,"CHICHIS",,7,,136,252
15,"Covasna",145,"145-COMANDAU",63553,110,2,807,777,639,138,772,5,"COMANDAU",,7,,85,687
15,"Covasna",145,"145-DOBARLAU",64265,111,2,1007,706,651,55,700,6,"DOBARLAU",,7,,309,391
15,"Covasna",145,"145-DOBARLAU",64265,112,2,653,508,451,57,507,1,"DOBARLAU",,7,,158,349
15,"Covasna",145,"145-GHELINTA",64318,113,2,1996,1604,1451,153,1600,4,"GHELINTA",,7,,53,1547
15,"Covasna",145,"145-GHELINTA",64318,114,2,1438,1062,891,171,1036,26,"GHELINTA",,7,,86,950
15,"Covasna",145,"145-GHIDFALAU",64345,115,2,1357,1044,991,53,1033,11,"GHIDFALAU",,7,,15,1018
15,"Covasna",145,"145-GHIDFALAU",64345,116,2,478,447,399,48,440,7,"GHIDFALAU",,7,,6,434
15,"Covasna",145,"145-HAGHIG",64390,117,2,1091,907,719,188,900,7,"HAGHIG",,7,,338,562
15,"Covasna",145,"145-HAGHIG",64390,118,2,354,288,229,59,282,6,"HAGHIG",,7,,168,114
15,"Covasna",145,"145-ILIENI",64425,119,2,1368,1274,1153,121,1268,6,"ILIENI",,7,,99,1169
15,"Covasna",145,"145-LEMNIA",64461,120,2,1665,1500,1384,116,1491,9,"LEMNIA",,7,,14,1477
15,"Covasna",145,"145-LEMNIA",64461,121,2,1132,1086,1012,74,1075,11,"LEMNIA",,7,,25,1050
15,"Covasna",145,"145-MALNAS",64504,122,2,1450,1266,1166,100,1262,4,"MALNAS",,7,,21,1241
15,"Covasna",145,"145-MALNAS",64504,123,2,1378,1262,1133,129,1256,6,"MALNAS",,7,,32,1224
15,"Covasna",145,"145-MALNAS",64504,124,2,727,716,613,103,713,3,"MALNAS",,7,,32,681
15,"Covasna",145,"145-MALNAS",64504,125,2,152,143,126,17,138,5,"MALNAS",,7,,10,128
15,"Covasna",145,"145-MOACSA",64568,126,2,816,729,632,97,725,4,"MOACSA",,7,,44,681
15,"Covasna",145,"145-MOACSA",64568,127,2,674,583,468,115,577,6,"MOACSA",,7,,36,541
15,"Covasna",145,"145-OJDULA",64602,128,2,1320,1001,940,61,985,16,"OJDULA",,7,,69,916
15,"Covasna",145,"145-OJDULA",64602,129,2,1241,1040,986,54,1039,1,"OJDULA",,7,,32,1007
15,"Covasna",145,"145-OZUN",64639,130,2,2105,1740,1662,78,1734,6,"OZUN",,7,,82,1652
15,"Covasna",145,"145-OZUN",64639,131,2,605,579,501,78,576,3,"OZUN",,7,,12,564
15,"Covasna",145,"145-OZUN",64639,132,2,542,430,400,30,429,1,"OZUN",,7,,14,415
15,"Covasna",145,"145-OZUN",64639,133,2,311,306,253,53,302,3,"OZUN",,7,,10,292
15,"Covasna",145,"145-POIAN",64719,134,2,1414,1140,1054,86,1136,4,"POIAN",,7,,19,1117
15,"Covasna",145,"145-POIAN",64719,135,2,855,773,684,89,766,7,"POIAN",,7,,28,738
15,"Covasna",145,"145-RECI",64773,136,2,1053,788,753,35,783,5,"RECI",,7,,22,761
15,"Covasna",145,"145-RECI",64773,137,2,658,517,508,9,516,1,"RECI",,7,,1,515
15,"Covasna",145,"145-SANZIENI",64826,138,2,1243,960,921,39,953,7,"SANZIENI",,7,,12,941
15,"Covasna",145,"145-SANZIENI",64826,139,2,1108,846,801,45,842,4,"SANZIENI",,7,,15,827
15,"Covasna",145,"145-SANZIENI",64826,140,2,662,500,482,18,497,3,"SANZIENI",,7,,7,490
15,"Covasna",145,"145-SANZIENI",64826,141,2,464,439,428,11,438,1,"SANZIENI",,7,,1,437
15,"Covasna",145,"145-SITA BUZAULUI",63688,142,2,1024,853,775,78,844,9,"SITA BUZAULUI",,7,,513,331
15,"Covasna",145,"145-SITA BUZAULUI",63688,143,2,740,536,483,53,534,2,"SITA BUZAULUI",,7,,353,181
15,"Covasna",145,"145-SITA BUZAULUI",63688,144,2,741,586,516,70,584,2,"SITA BUZAULUI",,7,,477,107
15,"Covasna",145,"145-SITA BUZAULUI",63688,145,2,788,603,534,69,602,1,"SITA BUZAULUI",,7,,382,220
15,"Covasna",145,"145-TURIA",64871,146,2,1645,1323,1260,63,1313,10,"TURIA",,7,,43,1270
15,"Covasna",145,"145-TURIA",64871,147,2,1084,888,817,71,868,20,"TURIA",,7,,12,856
15,"Covasna",145,"145-TURIA",64871,148,2,291,287,258,29,286,1,"TURIA",,7,,7,279
15,"Covasna",145,"145-VALEA CRISULUI",64906,149,2,1455,1208,1085,123,1199,9,"VALEA CRISULUI",,7,,17,1182
15,"Covasna",145,"145-VALEA CRISULUI",64906,150,2,942,811,685,126,807,4,"VALEA CRISULUI",,7,,29,778
15,"Covasna",145,"145-VALEA CRISULUI",64906,151,2,218,244,212,32,240,4,"VALEA CRISULUI",,7,,165,75
15,"Covasna",145,"145-VALCELE",64942,152,2,648,666,439,227,656,10,"VALCELE",,7,,345,311
15,"Covasna",145,"145-VALCELE",64942,153,2,1079,762,665,97,743,19,"VALCELE",,7,,263,480
15,"Covasna",145,"145-VALCELE",64942,154,2,360,335,298,37,331,4,"VALCELE",,7,,111,220
15,"Covasna",145,"145-VARGHIS",64997,155,2,1571,1337,1265,72,1334,3,"VARGHIS",,7,,21,1313
15,"Covasna",145,"145-ZAGON",65011,156,2,1758,1737,1574,163,1401,10,"ZAGON",,7,,70,1331
15,"Covasna",145,"145-ZAGON",65011,157,2,1394,1093,961,132,1077,16,"ZAGON",,7,,841,236
15,"Covasna",145,"145-ZAGON",65011,158,2,959,805,671,134,799,6,"ZAGON",,7,,344,455
15,"Covasna",145,"145-ZABALA",65048,159,2,1978,1382,1225,157,1364,18,"ZABALA",,7,,308,1056
15,"Covasna",145,"145-ZABALA",65048,160,2,589,453,364,89,443,10,"ZABALA",,7,,60,383
15,"Covasna",145,"145-ZABALA",65048,161,2,534,573,482,91,569,4,"ZABALA",,7,,4,565
15,"Covasna",145,"145-ZABALA",65048,162,2,495,482,421,61,481,1,"ZABALA",,7,,9,472
16,"Dâmbovița",154,"154-MUNICIPIUL TARGOVISTE",65342,1,2,1292,1104,958,146,1100,4,"MUNICIPIUL TARGOVISTE",,5,,444,656
16,"Dâmbovița",154,"154-MUNICIPIUL TARGOVISTE",65342,2,2,1764,1292,1079,213,1290,2,"MUNICIPIUL TARGOVISTE",,5,,534,756
16,"Dâmbovița",154,"154-MUNICIPIUL TARGOVISTE",65342,3,2,1762,1183,1052,131,1173,10,"MUNICIPIUL TARGOVISTE",,5,,478,695
16,"Dâmbovița",154,"154-MUNICIPIUL TARGOVISTE",65342,4,2,1896,1251,1095,156,1249,2,"MUNICIPIUL TARGOVISTE",,5,,482,767
16,"Dâmbovița",154,"154-MUNICIPIUL TARGOVISTE",65342,5,2,2014,1408,1284,124,1394,14,"MUNICIPIUL TARGOVISTE",,5,,611,783
16,"Dâmbovița",154,"154-MUNICIPIUL TARGOVISTE",65342,6,2,1972,1326,1195,131,1321,5,"MUNICIPIUL TARGOVISTE",,5,,510,811
16,"Dâmbovița",154,"154-MUNICIPIUL TARGOVISTE",65342,7,2,1794,1186,1073,113,1180,6,"MUNICIPIUL TARGOVISTE",,5,,458,722
16,"Dâmbovița",154,"154-MUNICIPIUL TARGOVISTE",65342,8,2,1687,1218,1072,146,1214,4,"MUNICIPIUL TARGOVISTE",,5,,470,744
16,"Dâmbovița",154,"154-MUNICIPIUL TARGOVISTE",65342,9,2,1054,857,739,118,853,4,"MUNICIPIUL TARGOVISTE",,5,,324,529
16,"Dâmbovița",154,"154-MUNICIPIUL TARGOVISTE",65342,10,2,1200,918,731,187,907,11,"MUNICIPIUL TARGOVISTE",,5,,398,509
16,"Dâmbovița",154,"154-MUNICIPIUL TARGOVISTE",65342,11,2,1300,1185,868,317,1179,6,"MUNICIPIUL TARGOVISTE",,5,,449,730
16,"Dâmbovița",154,"154-MUNICIPIUL TARGOVISTE",65342,12,2,1218,598,535,63,596,2,"MUNICIPIUL TARGOVISTE",,5,,205,391
16,"Dâmbovița",154,"154-MUNICIPIUL TARGOVISTE",65342,13,2,1601,1005,920,85,997,8,"MUNICIPIUL TARGOVISTE",,5,,431,566
16,"Dâmbovița",154,"154-MUNICIPIUL TARGOVISTE",65342,14,2,1345,972,895,77,971,1,"MUNICIPIUL TARGOVISTE",,5,,436,535
16,"Dâmbovița",154,"154-MUNICIPIUL TARGOVISTE",65342,15,2,1476,972,843,129,965,7,"MUNICIPIUL TARGOVISTE",,5,,423,542
16,"Dâmbovița",154,"154-MUNICIPIUL TARGOVISTE",65342,16,2,1596,1126,953,173,1118,8,"MUNICIPIUL TARGOVISTE",,5,,480,638
16,"Dâmbovița",154,"154-MUNICIPIUL TARGOVISTE",65342,17,2,1993,1262,1109,153,1255,7,"MUNICIPIUL TARGOVISTE",,5,,536,719
16,"Dâmbovița",154,"154-MUNICIPIUL TARGOVISTE",65342,18,2,1694,1191,975,216,1179,12,"MUNICIPIUL TARGOVISTE",,5,,488,691
16,"Dâmbovița",154,"154-MUNICIPIUL TARGOVISTE",65342,19,2,1571,1121,1013,108,1115,6,"MUNICIPIUL TARGOVISTE",,5,,479,636
16,"Dâmbovița",154,"154-MUNICIPIUL TARGOVISTE",65342,20,2,1932,1524,1322,202,1520,4,"MUNICIPIUL TARGOVISTE",,5,,588,932
16,"Dâmbovița",154,"154-MUNICIPIUL TARGOVISTE",65342,21,2,1662,1306,1126,180,1299,7,"MUNICIPIUL TARGOVISTE",,5,,437,862
16,"Dâmbovița",154,"154-MUNICIPIUL TARGOVISTE",65342,22,2,1491,1124,948,176,1118,6,"MUNICIPIUL TARGOVISTE",,5,,396,722
16,"Dâmbovița",154,"154-MUNICIPIUL TARGOVISTE",65342,23,2,1938,1562,1312,250,1558,4,"MUNICIPIUL TARGOVISTE",,5,,597,961
16,"Dâmbovița",154,"154-MUNICIPIUL TARGOVISTE",65342,24,2,1200,1160,724,436,1155,5,"MUNICIPIUL TARGOVISTE",,5,,454,701
16,"Dâmbovița",154,"154-MUNICIPIUL TARGOVISTE",65342,25,2,1663,1274,1147,127,1268,6,"MUNICIPIUL TARGOVISTE",,5,,596,672
16,"Dâmbovița",154,"154-MUNICIPIUL TARGOVISTE",65342,26,2,1078,834,699,135,831,3,"MUNICIPIUL TARGOVISTE",,5,,314,517
16,"Dâmbovița",154,"154-MUNICIPIUL TARGOVISTE",65342,27,2,2049,1639,1412,227,1635,4,"MUNICIPIUL TARGOVISTE",,5,,638,997
16,"Dâmbovița",154,"154-MUNICIPIUL TARGOVISTE",65342,28,2,1400,782,647,135,775,7,"MUNICIPIUL TARGOVISTE",,5,,296,479
16,"Dâmbovița",154,"154-MUNICIPIUL TARGOVISTE",65342,29,2,1597,1230,1044,186,1222,8,"MUNICIPIUL TARGOVISTE",,5,,461,761
16,"Dâmbovița",154,"154-MUNICIPIUL TARGOVISTE",65342,30,2,1441,1029,825,204,1015,14,"MUNICIPIUL TARGOVISTE",,5,,427,588
16,"Dâmbovița",154,"154-MUNICIPIUL TARGOVISTE",65342,31,2,1572,1062,921,141,1057,5,"MUNICIPIUL TARGOVISTE",,5,,433,624
16,"Dâmbovița",154,"154-MUNICIPIUL TARGOVISTE",65342,32,2,1943,1394,1298,96,1393,1,"MUNICIPIUL TARGOVISTE",,5,,576,817
16,"Dâmbovița",154,"154-MUNICIPIUL TARGOVISTE",65342,33,2,1653,1231,1011,220,1225,6,"MUNICIPIUL TARGOVISTE",,5,,540,685
16,"Dâmbovița",154,"154-MUNICIPIUL TARGOVISTE",65342,34,2,1350,1057,832,225,1052,5,"MUNICIPIUL TARGOVISTE",,5,,484,568
16,"Dâmbovița",154,"154-MUNICIPIUL TARGOVISTE",65342,35,2,1844,1003,846,157,996,7,"MUNICIPIUL TARGOVISTE",,5,,403,593
16,"Dâmbovița",154,"154-MUNICIPIUL TARGOVISTE",65342,36,2,1603,1429,975,454,1418,11,"MUNICIPIUL TARGOVISTE",,5,,459,959
16,"Dâmbovița",154,"154-MUNICIPIUL TARGOVISTE",65342,37,2,1014,762,607,155,754,8,"MUNICIPIUL TARGOVISTE",,5,,314,440
16,"Dâmbovița",154,"154-MUNICIPIUL TARGOVISTE",65342,38,2,1782,1271,1065,206,1265,6,"MUNICIPIUL TARGOVISTE",,5,,460,805
16,"Dâmbovița",154,"154-MUNICIPIUL TARGOVISTE",65342,39,2,1870,1325,923,402,1319,6,"MUNICIPIUL TARGOVISTE",,5,,571,748
16,"Dâmbovița",154,"154-MUNICIPIUL TARGOVISTE",65342,40,2,1719,1174,1010,164,1170,4,"MUNICIPIUL TARGOVISTE",,5,,422,748
16,"Dâmbovița",154,"154-MUNICIPIUL TARGOVISTE",65342,41,2,1657,1090,981,109,1084,6,"MUNICIPIUL TARGOVISTE",,5,,412,672
16,"Dâmbovița",154,"154-MUNICIPIUL TARGOVISTE",65342,42,2,1534,1131,930,201,1128,3,"MUNICIPIUL TARGOVISTE",,5,,440,688
16,"Dâmbovița",154,"154-MUNICIPIUL TARGOVISTE",65342,43,2,1615,1269,1016,253,1257,12,"MUNICIPIUL TARGOVISTE",,5,,520,737
16,"Dâmbovița",154,"154-MUNICIPIUL TARGOVISTE",65342,44,2,1385,1226,939,287,1220,6,"MUNICIPIUL TARGOVISTE",,5,,423,797
16,"Dâmbovița",154,"154-MUNICIPIUL TARGOVISTE",65342,45,2,1485,1130,957,173,1123,7,"MUNICIPIUL TARGOVISTE",,5,,442,681
16,"Dâmbovița",154,"154-MUNICIPIUL TARGOVISTE",65342,46,2,1487,1145,1064,81,1127,18,"MUNICIPIUL TARGOVISTE",,5,,656,471
16,"Dâmbovița",154,"154-MUNICIPIUL TARGOVISTE",65342,47,2,558,519,404,115,512,7,"MUNICIPIUL TARGOVISTE",,5,,260,252
16,"Dâmbovița",154,"154-MUNICIPIUL TARGOVISTE",65342,48,2,0,685,0,685,674,11,"MUNICIPIUL TARGOVISTE",,5,,366,308
16,"Dâmbovița",154,"154-MUNICIPIUL TARGOVISTE",65342,49,2,679,695,641,54,635,6,"MUNICIPIUL TARGOVISTE",,5,,287,348
16,"Dâmbovița",154,"154-MUNICIPIUL TARGOVISTE",65342,50,2,0,601,0,601,596,5,"MUNICIPIUL TARGOVISTE",,5,,287,309
16,"Dâmbovița",154,"154-MUNICIPIUL TARGOVISTE",65342,51,2,0,139,0,139,139,0,"MUNICIPIUL TARGOVISTE",,5,,49,90
16,"Dâmbovița",154,"154-ORAS FIENI",65609,52,2,695,552,495,57,546,6,"ORAS FIENI",,5,,404,142
16,"Dâmbovița",154,"154-ORAS FIENI",65609,53,2,786,697,570,127,693,4,"ORAS FIENI",,5,,466,227
16,"Dâmbovița",154,"154-ORAS FIENI",65609,54,2,1157,1005,827,178,996,9,"ORAS FIENI",,5,,580,416
16,"Dâmbovița",154,"154-ORAS FIENI",65609,55,2,2418,1700,1521,179,1691,9,"ORAS FIENI",,5,,911,780
16,"Dâmbovița",154,"154-ORAS FIENI",65609,56,2,1026,815,707,108,811,4,"ORAS FIENI",,5,,399,412
16,"Dâmbovița",154,"154-ORAS GAESTI",65681,57,2,1642,1332,1200,132,1320,12,"ORAS GAESTI",,5,,645,675
16,"Dâmbovița",154,"154-ORAS GAESTI",65681,58,2,1328,1055,965,90,1049,6,"ORAS GAESTI",,5,,639,410
16,"Dâmbovița",154,"154-ORAS GAESTI",65681,59,2,1398,1051,981,70,1043,8,"ORAS GAESTI",,5,,538,505
16,"Dâmbovița",154,"154-ORAS GAESTI",65681,60,2,1848,1336,1201,135,1324,12,"ORAS GAESTI",,5,,664,660
16,"Dâmbovița",154,"154-ORAS GAESTI",65681,61,2,1982,1294,1167,127,1286,8,"ORAS GAESTI",,5,,621,665
16,"Dâmbovița",154,"154-ORAS GAESTI",65681,62,2,1664,1127,1094,33,1126,1,"ORAS GAESTI",,5,,595,531
16,"Dâmbovița",154,"154-ORAS GAESTI",65681,63,2,1507,1169,1033,136,1164,5,"ORAS GAESTI",,5,,567,597
16,"Dâmbovița",154,"154-ORAS GAESTI",65681,64,2,1485,1221,1023,198,1214,7,"ORAS GAESTI",,5,,579,635
16,"Dâmbovița",154,"154-ORAS GAESTI",65681,65,2,280,350,280,70,345,5,"ORAS GAESTI",,5,,92,253
16,"Dâmbovița",154,"154-ORAS MORENI",65841,66,2,1378,1143,910,233,1126,17,"ORAS MORENI",,5,,569,557
16,"Dâmbovița",154,"154-ORAS MORENI",65841,67,2,300,280,230,50,280,0,"ORAS MORENI",,5,,126,154
16,"Dâmbovița",154,"154-ORAS MORENI",65841,68,2,2280,1881,1623,258,1873,8,"ORAS MORENI",,5,,917,956
16,"Dâmbovița",154,"154-ORAS MORENI",65841,69,2,1820,1464,1320,144,1458,6,"ORAS MORENI",,5,,707,751
16,"Dâmbovița",154,"154-ORAS MORENI",65841,70,2,2511,1813,1700,113,1810,3,"ORAS MORENI",,5,,777,1033
16,"Dâmbovița",154,"154-ORAS MORENI",65841,71,2,2382,1788,1664,124,1781,7,"ORAS MORENI",,5,,774,1007
16,"Dâmbovița",154,"154-ORAS MORENI",65841,72,2,1817,1543,1355,188,1528,15,"ORAS MORENI",,5,,672,856
16,"Dâmbovița",154,"154-ORAS MORENI",65841,73,2,1695,1607,1177,430,1600,7,"ORAS MORENI",,5,,765,835
16,"Dâmbovița",154,"154-ORAS MORENI",65841,74,2,1959,1790,1350,440,1787,3,"ORAS MORENI",,5,,921,866
16,"Dâmbovița",154,"154-ORAS PUCIOASA",65921,75,2,1228,953,862,91,945,8,"ORAS PUCIOASA",,5,,481,464
16,"Dâmbovița",154,"154-ORAS PUCIOASA",65921,76,2,833,622,559,63,618,4,"ORAS PUCIOASA",,5,,376,242
16,"Dâmbovița",154,"154-ORAS PUCIOASA",65921,77,2,1352,1166,973,193,1160,6,"ORAS PUCIOASA",,5,,449,711
16,"Dâmbovița",154,"154-ORAS PUCIOASA",65921,78,2,1431,1154,1028,126,1150,4,"ORAS PUCIOASA",,5,,471,679
16,"Dâmbovița",154,"154-ORAS PUCIOASA",65921,79,2,1644,1106,1021,85,1101,5,"ORAS PUCIOASA",,5,,475,626
16,"Dâmbovița",154,"154-ORAS PUCIOASA",65921,80,2,0,99,99,0,99,0,"ORAS PUCIOASA",,5,,49,50
16,"Dâmbovița",154,"154-ORAS PUCIOASA",65921,81,2,0,223,0,223,221,2,"ORAS PUCIOASA",,5,,111,110
16,"Dâmbovița",154,"154-ORAS PUCIOASA",65921,82,2,1194,1021,786,235,1019,2,"ORAS PUCIOASA",,5,,383,636
16,"Dâmbovița",154,"154-ORAS PUCIOASA",65921,83,2,1319,975,873,102,968,7,"ORAS PUCIOASA",,5,,411,557
16,"Dâmbovița",154,"154-ORAS PUCIOASA",65921,84,2,1175,876,789,87,876,0,"ORAS PUCIOASA",,5,,417,459
16,"Dâmbovița",154,"154-ORAS PUCIOASA",65921,85,2,1074,944,766,178,937,7,"ORAS PUCIOASA",,5,,496,441
16,"Dâmbovița",154,"154-ORAS PUCIOASA",65921,86,2,864,704,622,82,701,3,"ORAS PUCIOASA",,5,,410,291
16,"Dâmbovița",154,"154-ORAS PUCIOASA",65921,87,2,163,115,87,28,114,1,"ORAS PUCIOASA",,5,,65,49
16,"Dâmbovița",154,"154-ORAS TITU",66081,88,2,1329,822,726,96,810,12,"ORAS TITU",,5,,457,353
16,"Dâmbovița",154,"154-ORAS TITU",66081,89,2,835,603,531,72,590,13,"ORAS TITU",,5,,331,259
16,"Dâmbovița",154,"154-ORAS TITU",66081,90,2,1250,803,683,120,796,7,"ORAS TITU",,5,,465,331
16,"Dâmbovița",154,"154-ORAS TITU",66081,91,2,1174,806,621,185,803,3,"ORAS TITU",,5,,406,397
16,"Dâmbovița",154,"154-ORAS TITU",66081,92,2,1870,1161,1041,120,1156,5,"ORAS TITU",,5,,542,614
16,"Dâmbovița",154,"154-ORAS TITU",66081,93,2,1905,1213,1044,169,1207,6,"ORAS TITU",,5,,568,639
16,"Dâmbovița",154,"154-ORAS TITU",66081,94,2,361,372,337,35,366,6,"ORAS TITU",,5,,162,204
16,"Dâmbovița",154,"154-ANINOASA",65379,95,2,2233,1262,1240,22,1254,8,"ANINOASA",,5,,672,582
16,"Dâmbovița",154,"154-ANINOASA",65379,96,2,828,836,547,289,826,10,"ANINOASA",,5,,572,254
16,"Dâmbovița",154,"154-ANINOASA",65379,97,2,1136,1155,750,405,1147,8,"ANINOASA",,5,,600,547
16,"Dâmbovița",154,"154-ANINOASA",65379,98,2,65,155,41,114,155,0,"ANINOASA",,5,,75,80
16,"Dâmbovița",154,"154-ANINOASA",65379,99,2,10,272,5,267,266,6,"ANINOASA",,5,,140,126
16,"Dâmbovița",154,"154-BALENI",66198,100,2,1908,1501,1292,209,1501,0,"BALENI",,5,,1030,471
16,"Dâmbovița",154,"154-BALENI",66198,101,2,1735,1033,929,104,1020,13,"BALENI",,5,,750,270
16,"Dâmbovița",154,"154-BALENI",66198,102,2,2095,1250,1214,36,1225,25,"BALENI",,5,,832,393
16,"Dâmbovița",154,"154-BARBULETU",66223,103,2,805,547,411,136,538,9,"BARBULETU",,5,,364,174
16,"Dâmbovița",154,"154-BARBULETU",66223,104,2,1457,953,802,151,944,9,"BARBULETU",,5,,567,377
16,"Dâmbovița",154,"154-BARBULETU",66223,105,2,1511,1017,945,72,995,22,"BARBULETU",,5,,725,270
16,"Dâmbovița",154,"154-BARBULETU",66223,106,2,1650,908,687,221,898,10,"BARBULETU",,5,,573,325
16,"Dâmbovița",154,"154-BEZDEAD",66330,107,2,1645,1207,1004,203,1197,10,"BEZDEAD",,5,,759,438
16,"Dâmbovița",154,"154-BEZDEAD",66330,108,2,1526,1016,871,145,1005,11,"BEZDEAD",,5,,675,330
16,"Dâmbovița",154,"154-BEZDEAD",66330,109,2,957,764,648,116,757,7,"BEZDEAD",,5,,546,211
16,"Dâmbovița",154,"154-BILCIURESTI",66401,110,2,1291,1107,913,194,1094,13,"BILCIURESTI",,5,,658,436
16,"Dâmbovița",154,"154-BRANISTEA",66152,111,2,168,164,118,46,163,1,"BRANISTEA",,5,,36,127
16,"Dâmbovița",154,"154-BRANISTEA",66152,112,2,853,621,518,103,616,5,"BRANISTEA",,5,,274,342
16,"Dâmbovița",154,"154-BRANISTEA",66152,113,2,1265,913,811,102,906,7,"BRANISTEA",,5,,373,533
16,"Dâmbovița",154,"154-BRANISTEA",66152,114,2,1208,877,788,89,870,7,"BRANISTEA",,5,,438,432
16,"Dâmbovița",154,"154-BRANESTI",66009,115,2,1281,1114,968,146,1105,9,"BRANESTI",,5,,605,500
16,"Dâmbovița",154,"154-BRANESTI",66009,116,2,1251,907,763,144,900,7,"BRANESTI",,5,,553,347
16,"Dâmbovița",154,"154-BRANESTI",66009,117,2,2054,1505,1434,71,1489,16,"BRANESTI",,5,,919,570
16,"Dâmbovița",154,"154-BRANESTI",66009,118,2,1615,1328,1077,251,1324,4,"BRANESTI",,5,,858,466
16,"Dâmbovița",154,"154-BRANESTI",66009,119,2,509,739,371,368,737,2,"BRANESTI",,5,,439,298
16,"Dâmbovița",154,"154-BREZOAELE",101341,120,2,1338,806,685,121,792,14,"BREZOAELE",,5,,303,489
16,"Dâmbovița",154,"154-BREZOAELE",101341,121,2,1874,965,843,122,952,13,"BREZOAELE",,5,,491,461
16,"Dâmbovița",154,"154-BUCIUMENI",66438,122,2,1384,1055,951,104,1051,4,"BUCIUMENI",,5,,590,461
16,"Dâmbovița",154,"154-BUCIUMENI",66438,123,2,1161,962,882,80,955,7,"BUCIUMENI",,5,,653,302
16,"Dâmbovița",154,"154-BUCIUMENI",66438,124,2,1222,772,715,57,770,2,"BUCIUMENI",,5,,450,320
16,"Dâmbovița",154,"154-BUCSANI",66474,125,2,2958,2131,1881,250,2122,9,"BUCSANI",,5,,1310,812
16,"Dâmbovița",154,"154-BUCSANI",66474,126,2,1200,840,708,132,832,8,"BUCSANI",,5,,461,371
16,"Dâmbovița",154,"154-BUCSANI",66474,127,2,709,703,473,230,699,4,"BUCSANI",,5,,432,267
16,"Dâmbovița",154,"154-BUCSANI",66474,128,2,362,328,230,98,326,2,"BUCSANI",,5,,255,71
16,"Dâmbovița",154,"154-BUTIMANU",101564,129,2,1353,751,615,136,743,8,"BUTIMANU",,5,,428,315
16,"Dâmbovița",154,"154-BUTIMANU",101564,130,2,375,313,233,80,310,3,"BUTIMANU",,5,,201,109
16,"Dâmbovița",154,"154-CIOCANESTI",101840,131,2,2058,1372,1220,152,1351,21,"CIOCANESTI",,5,,637,714
16,"Dâmbovița",154,"154-CIOCANESTI",101840,132,2,1262,840,691,149,820,20,"CIOCANESTI",,5,,493,327
16,"Dâmbovița",154,"154-CIOCANESTI",101840,133,2,667,504,339,165,496,8,"CIOCANESTI",,5,,236,260
16,"Dâmbovița",154,"154-CANDESTI",66526,134,2,1005,706,580,126,698,8,"CANDESTI",,5,,435,263
16,"Dâmbovița",154,"154-CANDESTI",66526,135,2,285,215,151,64,212,3,"CANDESTI",,5,,128,84
16,"Dâmbovița",154,"154-CANDESTI",66526,136,2,1140,747,660,87,737,10,"CANDESTI",,5,,541,196
16,"Dâmbovița",154,"154-CANDESTI",66526,137,2,166,185,106,79,185,0,"CANDESTI",,5,,140,45
16,"Dâmbovița",154,"154-COBIA",66580,138,2,1295,864,774,90,861,3,"COBIA",,5,,437,424
16,"Dâmbovița",154,"154-COBIA",66580,139,2,638,501,438,63,499,2,"COBIA",,5,,304,195
16,"Dâmbovița",154,"154-COBIA",66580,140,2,622,519,426,93,517,2,"COBIA",,5,,316,201
16,"Dâmbovița",154,"154-COJASCA",66697,141,2,1040,766,608,158,745,21,"COJASCA",,5,,508,237
16,"Dâmbovița",154,"154-COJASCA",66697,142,2,1550,776,610,166,741,35,"COJASCA",,5,,450,291
16,"Dâmbovița",154,"154-COJASCA",66697,143,2,1351,825,575,250,817,8,"COJASCA",,5,,462,355
16,"Dâmbovița",154,"154-COMISANI",66731,144,2,2700,1937,1807,130,1926,11,"COMISANI",,5,,1234,692
16,"Dâmbovița",154,"154-COMISANI",66731,145,2,1457,1084,1027,57,1077,7,"COMISANI",,5,,602,475
16,"Dâmbovița",154,"154-CONTESTI",66768,146,2,1845,1135,964,171,1124,11,"CONTESTI",,5,,519,605
16,"Dâmbovița",154,"154-CONTESTI",66768,147,2,1288,781,625,156,760,21,"CONTESTI",,5,,450,310
16,"Dâmbovița",154,"154-CORBII MARI",66857,148,2,1710,1091,744,347,1079,12,"CORBII MARI",,5,,795,284
16,"Dâmbovița",154,"154-CORBII MARI",66857,149,2,1119,710,488,222,692,18,"CORBII MARI",,5,,467,225
16,"Dâmbovița",154,"154-CORBII MARI",66857,150,2,1024,608,448,160,605,3,"CORBII MARI",,5,,422,183
16,"Dâmbovița",154,"154-CORBII MARI",66857,151,2,1876,1150,845,305,1124,26,"CORBII MARI",,5,,641,483
16,"Dâmbovița",154,"154-CORNATELU",66955,152,2,406,414,263,151,413,1,"CORNATELU",,5,,245,168
16,"Dâmbovița",154,"154-CORNATELU",66955,153,2,689,554,402,152,544,10,"CORNATELU",,5,,307,237
16,"Dâmbovița",154,"154-CORNATELU",66955,154,2,262,261,200,61,256,5,"CORNATELU",,5,,140,116
16,"Dâmbovița",154,"154-CORNESTI",67014,155,2,2200,1395,1116,279,1383,12,"CORNESTI",,5,,383,1000
16,"Dâmbovița",154,"154-CORNESTI",67014,156,2,1323,1030,738,292,1022,8,"CORNESTI",,5,,549,473
16,"Dâmbovița",154,"154-CORNESTI",67014,157,2,1885,1246,997,249,1234,12,"CORNESTI",,5,,431,803
16,"Dâmbovița",154,"154-COSTESTI VALE",67121,158,2,1443,944,863,81,941,3,"COSTESTI VALE",,5,,443,498
16,"Dâmbovița",154,"154-COSTESTI VALE",67121,159,2,1059,754,668,86,752,2,"COSTESTI VALE",,5,,440,312
16,"Dâmbovița",154,"154-CREVEDIA",102286,160,2,2032,1182,810,372,1163,19,"CREVEDIA",,5,,678,485
16,"Dâmbovița",154,"154-CREVEDIA",102286,161,2,1300,1000,681,319,989,11,"CREVEDIA",,5,,478,511
16,"Dâmbovița",154,"154-CREVEDIA",102286,162,2,799,712,383,329,702,10,"CREVEDIA",,5,,244,458
16,"Dâmbovița",154,"154-CREVEDIA",102286,163,2,280,292,138,154,284,8,"CREVEDIA",,5,,163,121
16,"Dâmbovița",154,"154-CRANGURILE",67167,164,2,1154,874,679,195,866,8,"CRANGURILE",,5,,508,358
16,"Dâmbovița",154,"154-CRANGURILE",67167,165,2,1100,766,583,183,754,12,"CRANGURILE",,5,,505,249
16,"Dâmbovița",154,"154-DARMANESTI",67256,166,2,2988,2099,1959,140,2088,11,"DARMANESTI",,5,,972,1116
16,"Dâmbovița",154,"154-DARMANESTI",67256,167,2,858,719,686,33,707,12,"DARMANESTI",,5,,328,379
16,"Dâmbovița",154,"154-DARMANESTI",67256,168,2,2155,1678,1618,60,1669,9,"DARMANESTI",,5,,746,923
16,"Dâmbovița",154,"154-DOBRA",67292,169,2,1564,1136,1005,131,1130,6,"DOBRA",,5,,647,483
16,"Dâmbovița",154,"154-DOBRA",67292,170,2,1408,1170,1003,167,1165,5,"DOBRA",,5,,791,374
16,"Dâmbovița",154,"154-DOICESTI",65413,171,2,1541,1104,987,117,1097,7,"DOICESTI",,5,,779,318
16,"Dâmbovița",154,"154-DOICESTI",65413,172,2,1949,1527,1288,239,1523,4,"DOICESTI",,5,,924,599
16,"Dâmbovița",154,"154-DRAGODANA",67327,173,2,1294,1005,872,133,998,7,"DRAGODANA",,5,,502,496
16,"Dâmbovița",154,"154-DRAGODANA",67327,174,2,1035,719,603,116,708,11,"DRAGODANA",,5,,366,342
16,"Dâmbovița",154,"154-DRAGODANA",67327,175,2,1598,1031,892,139,1021,10,"DRAGODANA",,5,,543,478
16,"Dâmbovița",154,"154-DRAGODANA",67327,176,2,1048,753,671,82,745,8,"DRAGODANA",,5,,463,282
16,"Dâmbovița",154,"154-DRAGOMIRESTI",67407,177,2,1248,1041,874,167,1025,16,"DRAGOMIRESTI",,5,,487,538
16,"Dâmbovița",154,"154-DRAGOMIRESTI",67407,178,2,1680,1203,1103,100,1193,10,"DRAGOMIRESTI",,5,,636,557
16,"Dâmbovița",154,"154-DRAGOMIRESTI",67407,179,2,1569,1088,965,123,1077,11,"DRAGOMIRESTI",,5,,664,413
16,"Dâmbovița",154,"154-DRAGOMIRESTI",67407,180,2,1253,791,682,109,780,11,"DRAGOMIRESTI",,5,,355,425
16,"Dâmbovița",154,"154-FINTA",67470,181,2,1153,775,650,125,772,3,"FINTA",,5,,320,452
16,"Dâmbovița",154,"154-FINTA",67470,182,2,720,632,500,132,623,9,"FINTA",,5,,368,255
16,"Dâmbovița",154,"154-FINTA",67470,183,2,1780,1380,1226,154,1371,9,"FINTA",,5,,928,443
16,"Dâmbovița",154,"154-GLODENI",65967,184,2,1340,1037,965,72,1029,8,"GLODENI",,5,,613,416
16,"Dâmbovița",154,"154-GLODENI",65967,185,2,1251,831,752,79,815,16,"GLODENI",,5,,452,363
16,"Dâmbovița",154,"154-GLODENI",65967,186,2,699,621,542,79,617,4,"GLODENI",,5,,403,214
16,"Dâmbovița",154,"154-GURA FOII",65707,187,2,1813,1217,1095,122,1211,6,"GURA FOII",,5,,817,394
16,"Dâmbovița",154,"154-GURA OCNITEI",67595,188,2,2545,1880,1611,269,1870,10,"GURA OCNITEI",,5,,814,1056
16,"Dâmbovița",154,"154-GURA OCNITEI",67595,189,2,1564,1221,1059,162,1213,8,"GURA OCNITEI",,5,,750,463
16,"Dâmbovița",154,"154-GURA OCNITEI",67595,190,2,1389,1080,946,134,1072,8,"GURA OCNITEI",,5,,532,540
16,"Dâmbovița",154,"154-GURA SUTII",67648,191,2,2583,1533,1383,150,1521,12,"GURA SUTII",,5,,658,863
16,"Dâmbovița",154,"154-GURA SUTII",67648,192,2,1428,1124,1038,86,1119,5,"GURA SUTII",,5,,670,449
16,"Dâmbovița",154,"154-HULUBESTI",67675,193,2,1286,811,696,115,797,14,"HULUBESTI",,5,,393,404
16,"Dâmbovița",154,"154-HULUBESTI",67675,194,2,1258,940,818,122,934,6,"HULUBESTI",,5,,695,239
16,"Dâmbovița",154,"154-IEDERA",65869,195,2,1445,1138,1064,74,1131,7,"IEDERA",,5,,670,461
16,"Dâmbovița",154,"154-IEDERA",65869,196,2,1409,1154,1038,116,1149,5,"IEDERA",,5,,757,392
16,"Dâmbovița",154,"154-I. L. CARAGIALE",67737,197,2,1376,1189,858,331,1186,3,"I. L. CARAGIALE",,5,,750,436
16,"Dâmbovița",154,"154-I. L. CARAGIALE",67737,198,2,1346,1105,835,270,1104,1,"I. L. CARAGIALE",,5,,712,392
16,"Dâmbovița",154,"154-I. L. CARAGIALE",67737,199,2,2434,1857,1507,350,1849,8,"I. L. CARAGIALE",,5,,1052,797
16,"Dâmbovița",154,"154-I. L. CARAGIALE",67737,200,2,0,865,0,865,860,5,"I. L. CARAGIALE",,5,,180,680
16,"Dâmbovița",154,"154-LUCIENI",67773,201,2,1950,1393,1290,103,1385,8,"LUCIENI",,5,,837,548
16,"Dâmbovița",154,"154-LUCIENI",67773,202,2,1000,800,734,66,797,3,"LUCIENI",,5,,402,395
16,"Dâmbovița",154,"154-LUCIENI",67773,203,2,1417,769,752,17,758,11,"LUCIENI",,5,,474,284
16,"Dâmbovița",154,"154-LUCIENI",67773,204,2,428,497,314,183,495,2,"LUCIENI",,5,,352,143
16,"Dâmbovița",154,"154-LUDESTI",67835,205,2,1784,1076,916,160,1065,11,"LUDESTI",,5,,664,401
16,"Dâmbovița",154,"154-LUDESTI",67835,206,2,1676,1218,1126,92,1187,31,"LUDESTI",,5,,662,525
16,"Dâmbovița",154,"154-LUNGULETU",67906,207,2,1316,728,550,178,725,3,"LUNGULETU",,5,,305,420
16,"Dâmbovița",154,"154-LUNGULETU",67906,208,2,1805,1095,884,211,1086,9,"LUNGULETU",,5,,336,750
16,"Dâmbovița",154,"154-LUNGULETU",67906,209,2,984,669,525,144,650,19,"LUNGULETU",,5,,335,315
16,"Dâmbovița",154,"154-MALU CU FLORI",67942,210,2,1310,977,817,160,965,12,"MALU CU FLORI",,5,,720,245
16,"Dâmbovița",154,"154-MALU CU FLORI",67942,211,2,923,584,489,95,579,5,"MALU CU FLORI",,5,,434,145
16,"Dâmbovița",154,"154-MANESTI",68002,212,2,997,848,707,141,839,9,"MANESTI",,5,,543,296
16,"Dâmbovița",154,"154-MANESTI",68002,213,2,690,583,446,137,581,2,"MANESTI",,5,,372,209
16,"Dâmbovița",154,"154-MANESTI",68002,214,2,1122,762,630,132,755,7,"MANESTI",,5,,489,266
16,"Dâmbovița",154,"154-MATASARU",68048,215,2,974,747,569,178,743,4,"MATASARU",,5,,464,279
16,"Dâmbovița",154,"154-MATASARU",68048,216,2,1793,1175,986,189,1169,6,"MATASARU",,5,,737,432
16,"Dâmbovița",154,"154-MATASARU",68048,217,2,1539,984,911,73,971,13,"MATASARU",,5,,637,334
16,"Dâmbovița",154,"154-MOGOSANI",68128,218,2,1378,889,759,130,881,8,"MOGOSANI",,5,,549,332
16,"Dâmbovița",154,"154-MOGOSANI",68128,219,2,1313,916,702,214,906,10,"MOGOSANI",,5,,591,315
16,"Dâmbovița",154,"154-MOGOSANI",68128,220,2,818,617,539,78,614,3,"MOGOSANI",,5,,390,224
16,"Dâmbovița",154,"154-MOROENI",68182,221,2,946,723,628,95,723,0,"MOROENI",,5,,423,300
16,"Dâmbovița",154,"154-MOROENI",68182,222,2,1341,961,871,90,955,6,"MOROENI",,5,,562,393
16,"Dâmbovița",154,"154-MOROENI",68182,223,2,1197,901,791,110,888,13,"MOROENI",,5,,417,471
16,"Dâmbovița",154,"154-MOROENI",68182,224,2,76,76,66,10,74,2,"MOROENI",,5,,42,32
16,"Dâmbovița",154,"154-MOROENI",68182,225,2,41,397,25,372,395,2,"MOROENI",,5,,138,257
16,"Dâmbovița",154,"154-MORTENI",68253,226,2,2385,1645,1525,120,1632,13,"MORTENI",,5,,1065,567
16,"Dâmbovița",154,"154-MOTAIENI",65645,227,2,1282,990,895,95,983,7,"MOTAIENI",,5,,557,426
16,"Dâmbovița",154,"154-MOTAIENI",65645,228,2,541,414,380,34,412,2,"MOTAIENI",,5,,220,192
16,"Dâmbovița",154,"154-NICULESTI",104387,229,2,2352,1156,1018,138,1143,13,"NICULESTI",,5,,493,650
16,"Dâmbovița",154,"154-NICULESTI",104387,230,2,735,587,445,142,568,19,"NICULESTI",,5,,213,355
16,"Dâmbovița",154,"154-NUCET",68280,231,2,1641,1060,922,138,1049,11,"NUCET",,5,,638,411
16,"Dâmbovița",154,"154-NUCET",68280,232,2,1254,859,833,26,854,5,"NUCET",,5,,531,323
16,"Dâmbovița",154,"154-NUCET",68280,233,2,386,322,254,68,321,1,"NUCET",,5,,141,180
16,"Dâmbovița",154,"154-OCNITA",68324,234,2,2107,1510,1236,274,1505,5,"OCNITA",,5,,566,939
16,"Dâmbovița",154,"154-OCNITA",68324,235,2,982,653,454,199,642,11,"OCNITA",,5,,232,410
16,"Dâmbovița",154,"154-ODOBESTI",68342,236,2,1313,896,754,142,880,16,"ODOBESTI",,5,,497,383
16,"Dâmbovița",154,"154-ODOBESTI",68342,237,2,902,627,424,203,621,6,"ODOBESTI",,5,,485,136
16,"Dâmbovița",154,"154-ODOBESTI",68342,238,2,1765,1162,939,223,1151,11,"ODOBESTI",,5,,836,315
16,"Dâmbovița",154,"154-PETRESTI",65752,239,2,2205,1402,1264,138,1384,18,"PETRESTI",,5,,942,442
16,"Dâmbovița",154,"154-PETRESTI",65752,240,2,764,596,577,19,592,4,"PETRESTI",,5,,425,167
16,"Dâmbovița",154,"154-PETRESTI",65752,241,2,2263,1464,1381,83,1447,17,"PETRESTI",,5,,966,481
16,"Dâmbovița",154,"154-PIETROSITA",68404,242,2,1752,1448,1231,217,1444,4,"PIETROSITA",,5,,857,587
16,"Dâmbovița",154,"154-PIETROSITA",68404,243,2,809,604,522,82,603,1,"PIETROSITA",,5,,338,265
16,"Dâmbovița",154,"154-POIANA",68431,244,2,1993,1175,1040,135,1160,15,"POIANA",,5,,486,674
16,"Dâmbovița",154,"154-POIANA",68431,245,2,988,683,608,75,669,14,"POIANA",,5,,314,355
16,"Dâmbovița",154,"154-POTLOGI",68468,246,2,2555,1699,1470,229,1689,10,"POTLOGI",,5,,935,754
16,"Dâmbovița",154,"154-POTLOGI",68468,247,2,798,576,425,151,575,1,"POTLOGI",,5,,375,200
16,"Dâmbovița",154,"154-POTLOGI",68468,248,2,624,568,381,187,564,4,"POTLOGI",,5,,379,185
16,"Dâmbovița",154,"154-POTLOGI",68468,249,2,1885,1285,1032,253,1275,10,"POTLOGI",,5,,511,764
16,"Dâmbovița",154,"154-PRODULESTI",68529,250,2,2081,1206,1070,136,1193,13,"PRODULESTI",,5,,654,539
16,"Dâmbovița",154,"154-PRODULESTI",68529,251,2,748,566,434,132,561,5,"PRODULESTI",,5,,318,243
16,"Dâmbovița",154,"154-PUCHENI",68244,252,2,1903,1399,1307,92,1390,9,"PUCHENI",,5,,1064,326
16,"Dâmbovița",154,"154-RACARI",68636,253,2,1800,1188,980,208,1182,6,"RACARI",,5,,516,666
16,"Dâmbovița",154,"154-RACARI",68636,254,2,593,431,315,116,428,3,"RACARI",,5,,209,219
16,"Dâmbovița",154,"154-RACARI",68636,255,2,795,457,391,66,450,7,"RACARI",,5,,202,248
16,"Dâmbovița",154,"154-RACARI",68636,256,2,756,660,554,106,655,5,"RACARI",,5,,364,291
16,"Dâmbovița",154,"154-RACARI",68636,257,2,970,659,564,95,648,11,"RACARI",,5,,317,331
16,"Dâmbovița",154,"154-RACARI",68636,258,2,675,541,378,163,535,6,"RACARI",,5,,302,233
16,"Dâmbovița",154,"154-RAZVAD",65431,259,2,1343,1059,884,175,1053,6,"RAZVAD",,5,,528,525
16,"Dâmbovița",154,"154-RAZVAD",65431,260,2,1079,831,704,127,827,4,"RAZVAD",,5,,453,374
16,"Dâmbovița",154,"154-RAZVAD",65431,261,2,1091,774,730,44,771,3,"RAZVAD",,5,,385,386
16,"Dâmbovița",154,"154-RAZVAD",65431,262,2,992,709,607,102,699,10,"RAZVAD",,5,,368,331
16,"Dâmbovița",154,"154-RAZVAD",65431,263,2,1708,1329,1194,135,1323,6,"RAZVAD",,5,,658,665
16,"Dâmbovița",154,"154-RUNCU",68716,264,2,2154,1627,1456,171,1623,4,"RUNCU",,5,,1126,497
16,"Dâmbovița",154,"154-RUNCU",68716,265,2,789,613,576,37,610,3,"RUNCU",,5,,407,203
16,"Dâmbovița",154,"154-RUNCU",68716,266,2,517,506,468,38,502,4,"RUNCU",,5,,399,103
16,"Dâmbovița",154,"154-SALCIOARA",68119,267,2,1105,600,522,78,590,10,"SALCIOARA",,5,,311,279
16,"Dâmbovița",154,"154-SALCIOARA",68119,268,2,1122,719,554,165,709,10,"SALCIOARA",,5,,423,286
16,"Dâmbovița",154,"154-SALCIOARA",68119,269,2,907,619,548,71,608,11,"SALCIOARA",,5,,418,190
16,"Dâmbovița",154,"154-SLOBOZIA MOARA",105142,270,2,1734,1131,1005,126,1117,14,"SLOBOZIA MOARA",,5,,438,679
16,"Dâmbovița",154,"154-SELARU",68887,271,2,1054,728,603,125,714,14,"SELARU",,5,,328,386
16,"Dâmbovița",154,"154-SELARU",68887,272,2,1253,942,793,149,920,22,"SELARU",,5,,700,220
16,"Dâmbovița",154,"154-SELARU",68887,273,2,667,498,412,86,491,7,"SELARU",,5,,278,213
16,"Dâmbovița",154,"154-SOTANGA",65477,274,2,2246,1629,1441,188,1622,7,"SOTANGA",,5,,1171,451
16,"Dâmbovița",154,"154-SOTANGA",65477,275,2,1688,1391,1254,137,1378,13,"SOTANGA",,5,,857,521
16,"Dâmbovița",154,"154-SOTANGA",65477,276,2,1100,824,704,120,822,2,"SOTANGA",,5,,575,247
16,"Dâmbovița",154,"154-TARTASESTI",105534,277,2,1577,1090,970,120,1068,22,"TARTASESTI",,5,,517,551
16,"Dâmbovița",154,"154-TARTASESTI",105534,278,2,1588,963,858,105,951,12,"TARTASESTI",,5,,475,476
16,"Dâmbovița",154,"154-TARTASESTI",105534,279,2,791,577,529,48,569,8,"TARTASESTI",,5,,322,247
16,"Dâmbovița",154,"154-TATARANI",68921,280,2,956,772,624,148,767,5,"TATARANI",,5,,579,188
16,"Dâmbovița",154,"154-TATARANI",68921,281,2,1132,967,763,204,965,2,"TATARANI",,5,,655,310
16,"Dâmbovița",154,"154-TATARANI",68921,282,2,1237,915,764,151,911,4,"TATARANI",,5,,605,306
16,"Dâmbovița",154,"154-TATARANI",68921,283,2,852,653,533,120,650,3,"TATARANI",,5,,470,180
16,"Dâmbovița",154,"154-ULIESTI",68976,284,2,1146,826,711,115,820,6,"ULIESTI",,5,,569,251
16,"Dâmbovița",154,"154-ULIESTI",68976,285,2,1052,786,673,113,785,1,"ULIESTI",,5,,610,175
16,"Dâmbovița",154,"154-ULIESTI",68976,286,2,1457,1004,938,66,996,8,"ULIESTI",,5,,761,235
16,"Dâmbovița",154,"154-ULMI",65501,287,2,1264,909,788,121,906,3,"ULMI",,5,,536,370
16,"Dâmbovița",154,"154-ULMI",65501,288,2,1481,1100,912,188,1089,11,"ULMI",,5,,667,422
16,"Dâmbovița",154,"154-VALEA LUNGA",69063,289,2,1054,840,718,122,838,2,"VALEA LUNGA",,5,,477,361
16,"Dâmbovița",154,"154-VALEA LUNGA",69063,290,2,420,333,297,36,330,3,"VALEA LUNGA",,5,,169,161
16,"Dâmbovița",154,"154-VALEA LUNGA",69063,291,2,1102,829,718,111,820,9,"VALEA LUNGA",,5,,490,330
16,"Dâmbovița",154,"154-VALEA LUNGA",69063,292,2,1054,795,708,87,786,9,"VALEA LUNGA",,5,,512,274
16,"Dâmbovița",154,"154-VALEA LUNGA",69063,293,2,382,323,274,49,318,5,"VALEA LUNGA",,5,,229,89
16,"Dâmbovița",154,"154-VALEA MARE",66571,294,2,1248,859,671,188,857,2,"VALEA MARE",,5,,528,329
16,"Dâmbovița",154,"154-VALEA MARE",66571,295,2,666,541,421,120,537,4,"VALEA MARE",,5,,316,221
16,"Dâmbovița",154,"154-VACARESTI",69250,296,2,1063,795,682,113,792,3,"VACARESTI",,5,,455,337
16,"Dâmbovița",154,"154-VACARESTI",69250,297,2,1111,834,679,155,831,3,"VACARESTI",,5,,481,350
16,"Dâmbovița",154,"154-VACARESTI",69250,298,2,1070,631,566,65,626,5,"VACARESTI",,5,,373,253
16,"Dâmbovița",154,"154-VACARESTI",69250,299,2,1150,806,763,43,796,10,"VACARESTI",,5,,508,288
16,"Dâmbovița",154,"154-VACARESTI",69250,300,2,1012,765,730,35,755,10,"VACARESTI",,5,,478,277
16,"Dâmbovița",154,"154-VACARESTI",69250,301,2,435,342,268,74,337,5,"VACARESTI",,5,,187,150
16,"Dâmbovița",154,"154-VALENI-DAMBOVITA",69303,302,2,2239,1535,1404,131,1529,6,"VALENI-DAMBOVITA",,5,,1032,497
16,"Dâmbovița",154,"154-VALENI-DAMBOVITA",69303,303,2,263,199,144,55,198,1,"VALENI-DAMBOVITA",,5,,165,33
16,"Dâmbovița",154,"154-VISINA",69330,304,2,1003,668,554,114,658,10,"VISINA",,5,,473,185
16,"Dâmbovița",154,"154-VISINA",69330,305,2,1471,1040,843,197,1022,18,"VISINA",,5,,755,267
16,"Dâmbovița",154,"154-VISINA",69330,306,2,1000,711,540,171,704,7,"VISINA",,5,,560,144
16,"Dâmbovița",154,"154-VISINA",69330,307,2,1850,1521,1386,135,1502,19,"VISINA",,5,,712,790
16,"Dâmbovița",154,"154-VISINESTI",69394,308,2,996,763,658,105,757,6,"VISINESTI",,5,,412,345
16,"Dâmbovița",154,"154-VISINESTI",69394,309,2,727,544,486,58,535,9,"VISINESTI",,5,,302,233
16,"Dâmbovița",154,"154-VISINESTI",69394,310,2,313,244,197,47,243,1,"VISINESTI",,5,,142,101
16,"Dâmbovița",154,"154-VARFURI",69447,311,2,1702,1269,1240,29,1257,12,"VARFURI",,5,,839,418
16,"Dâmbovița",154,"154-VOINESTI",69526,312,2,1437,910,744,166,908,2,"VOINESTI",,5,,564,344
16,"Dâmbovița",154,"154-VOINESTI",69526,313,2,1424,988,808,180,983,5,"VOINESTI",,5,,684,299
16,"Dâmbovița",154,"154-VOINESTI",69526,314,2,1401,989,816,173,984,5,"VOINESTI",,5,,664,320
16,"Dâmbovița",154,"154-VOINESTI",69526,315,2,415,450,260,190,444,6,"VOINESTI",,5,,298,146
16,"Dâmbovița",154,"154-VULCANA-BAI",69615,316,2,1120,1175,1095,80,1167,8,"VULCANA-BAI",,5,,682,485
16,"Dâmbovița",154,"154-VULCANA-BAI",69615,317,2,994,1035,976,59,1028,7,"VULCANA-BAI",,5,,581,447
17,"Dolj",163,"163-MUNICIPIUL CRAIOVA",69900,1,2,1930,1544,1422,122,1539,5,"MUNICIPIUL CRAIOVA",,6,,683,856
17,"Dolj",163,"163-MUNICIPIUL CRAIOVA",69900,2,2,2139,1542,1413,129,1536,6,"MUNICIPIUL CRAIOVA",,6,,703,833
17,"Dolj",163,"163-MUNICIPIUL CRAIOVA",69900,3,2,1863,1327,1237,90,1324,3,"MUNICIPIUL CRAIOVA",,6,,625,699
17,"Dolj",163,"163-MUNICIPIUL CRAIOVA",69900,4,2,2015,1435,1353,82,1426,9,"MUNICIPIUL CRAIOVA",,6,,550,876
17,"Dolj",163,"163-MUNICIPIUL CRAIOVA",69900,5,2,2104,1538,1410,128,1527,11,"MUNICIPIUL CRAIOVA",,6,,673,854
17,"Dolj",163,"163-MUNICIPIUL CRAIOVA",69900,6,2,2101,1626,1531,95,1617,9,"MUNICIPIUL CRAIOVA",,6,,592,1025
17,"Dolj",163,"163-MUNICIPIUL CRAIOVA",69900,7,2,1903,1595,1505,90,1590,5,"MUNICIPIUL CRAIOVA",,6,,631,959
17,"Dolj",163,"163-MUNICIPIUL CRAIOVA",69900,8,2,2100,1817,1518,299,1812,5,"MUNICIPIUL CRAIOVA",,6,,727,1085
17,"Dolj",163,"163-MUNICIPIUL CRAIOVA",69900,9,2,1649,1244,1163,81,1239,5,"MUNICIPIUL CRAIOVA",,6,,459,780
17,"Dolj",163,"163-MUNICIPIUL CRAIOVA",69900,10,2,1796,1373,1263,110,1372,1,"MUNICIPIUL CRAIOVA",,6,,562,810
17,"Dolj",163,"163-MUNICIPIUL CRAIOVA",69900,11,2,2262,1566,1417,149,1554,12,"MUNICIPIUL CRAIOVA",,6,,695,859
17,"Dolj",163,"163-MUNICIPIUL CRAIOVA",69900,12,2,1448,1398,975,423,1396,2,"MUNICIPIUL CRAIOVA",,6,,568,828
17,"Dolj",163,"163-MUNICIPIUL CRAIOVA",69900,13,2,1574,1427,1077,350,1422,5,"MUNICIPIUL CRAIOVA",,6,,524,898
17,"Dolj",163,"163-MUNICIPIUL CRAIOVA",69900,14,2,2063,1583,1416,167,1568,15,"MUNICIPIUL CRAIOVA",,6,,742,826
17,"Dolj",163,"163-MUNICIPIUL CRAIOVA",69900,15,2,2302,1747,1660,87,1742,5,"MUNICIPIUL CRAIOVA",,6,,750,992
17,"Dolj",163,"163-MUNICIPIUL CRAIOVA",69900,16,2,1891,1333,1247,86,1330,3,"MUNICIPIUL CRAIOVA",,6,,525,805
17,"Dolj",163,"163-MUNICIPIUL CRAIOVA",69900,17,2,1886,1386,1297,89,1381,5,"MUNICIPIUL CRAIOVA",,6,,572,809
17,"Dolj",163,"163-MUNICIPIUL CRAIOVA",69900,18,2,2025,1451,1251,200,1445,6,"MUNICIPIUL CRAIOVA",,6,,592,853
17,"Dolj",163,"163-MUNICIPIUL CRAIOVA",69900,19,2,1011,688,608,80,683,5,"MUNICIPIUL CRAIOVA",,6,,289,394
17,"Dolj",163,"163-MUNICIPIUL CRAIOVA",69900,20,2,2162,1621,1374,247,1617,4,"MUNICIPIUL CRAIOVA",,6,,738,879
17,"Dolj",163,"163-MUNICIPIUL CRAIOVA",69900,21,2,1741,1303,1205,98,1301,2,"MUNICIPIUL CRAIOVA",,6,,556,745
17,"Dolj",163,"163-MUNICIPIUL CRAIOVA",69900,22,2,1350,1051,969,82,1044,7,"MUNICIPIUL CRAIOVA",,6,,472,572
17,"Dolj",163,"163-MUNICIPIUL CRAIOVA",69900,23,2,1958,1304,1159,145,1293,11,"MUNICIPIUL CRAIOVA",,6,,586,707
17,"Dolj",163,"163-MUNICIPIUL CRAIOVA",69900,24,2,2139,1514,1401,113,1506,8,"MUNICIPIUL CRAIOVA",,6,,600,906
17,"Dolj",163,"163-MUNICIPIUL CRAIOVA",69900,25,2,2024,1479,1381,98,1470,9,"MUNICIPIUL CRAIOVA",,6,,581,889
17,"Dolj",163,"163-MUNICIPIUL CRAIOVA",69900,26,2,2567,1615,1440,175,1584,31,"MUNICIPIUL CRAIOVA",,6,,696,888
17,"Dolj",163,"163-MUNICIPIUL CRAIOVA",69900,27,2,1763,1227,1065,162,1216,11,"MUNICIPIUL CRAIOVA",,6,,517,699
17,"Dolj",163,"163-MUNICIPIUL CRAIOVA",69900,28,2,711,645,498,147,640,5,"MUNICIPIUL CRAIOVA",,6,,332,308
17,"Dolj",163,"163-MUNICIPIUL CRAIOVA",69900,29,2,698,634,469,165,630,4,"MUNICIPIUL CRAIOVA",,6,,390,240
17,"Dolj",163,"163-MUNICIPIUL CRAIOVA",69900,30,2,2299,1540,1454,86,1534,6,"MUNICIPIUL CRAIOVA",,6,,688,846
17,"Dolj",163,"163-MUNICIPIUL CRAIOVA",69900,31,2,2165,1516,1432,84,1510,6,"MUNICIPIUL CRAIOVA",,6,,609,901
17,"Dolj",163,"163-MUNICIPIUL CRAIOVA",69900,32,2,1948,1285,1189,96,1281,4,"MUNICIPIUL CRAIOVA",,6,,536,745
17,"Dolj",163,"163-MUNICIPIUL CRAIOVA",69900,33,2,2303,1578,1412,166,1575,3,"MUNICIPIUL CRAIOVA",,6,,594,981
17,"Dolj",163,"163-MUNICIPIUL CRAIOVA",69900,34,2,1800,1365,1267,98,1364,1,"MUNICIPIUL CRAIOVA",,6,,539,825
17,"Dolj",163,"163-MUNICIPIUL CRAIOVA",69900,35,2,1634,1453,1077,376,1442,11,"MUNICIPIUL CRAIOVA",,6,,460,982
17,"Dolj",163,"163-MUNICIPIUL CRAIOVA",69900,36,2,1647,1331,1236,95,1324,4,"MUNICIPIUL CRAIOVA",,6,,524,800
17,"Dolj",163,"163-MUNICIPIUL CRAIOVA",69900,37,2,1310,1043,953,90,1039,4,"MUNICIPIUL CRAIOVA",,6,,330,709
17,"Dolj",163,"163-MUNICIPIUL CRAIOVA",69900,38,2,1334,996,906,90,988,7,"MUNICIPIUL CRAIOVA",,6,,392,596
17,"Dolj",163,"163-MUNICIPIUL CRAIOVA",69900,39,2,1855,1060,876,184,1057,3,"MUNICIPIUL CRAIOVA",,6,,428,629
17,"Dolj",163,"163-MUNICIPIUL CRAIOVA",69900,40,2,2637,1911,1766,145,1906,5,"MUNICIPIUL CRAIOVA",,6,,738,1168
17,"Dolj",163,"163-MUNICIPIUL CRAIOVA",69900,41,2,2064,1491,1384,107,1478,13,"MUNICIPIUL CRAIOVA",,6,,645,833
17,"Dolj",163,"163-MUNICIPIUL CRAIOVA",69900,42,2,2365,1610,1528,82,1595,15,"MUNICIPIUL CRAIOVA",,6,,789,806
17,"Dolj",163,"163-MUNICIPIUL CRAIOVA",69900,43,2,996,832,618,214,820,12,"MUNICIPIUL CRAIOVA",,6,,393,427
17,"Dolj",163,"163-MUNICIPIUL CRAIOVA",69900,44,2,1924,1101,971,130,1078,23,"MUNICIPIUL CRAIOVA",,6,,444,634
17,"Dolj",163,"163-MUNICIPIUL CRAIOVA",69900,45,2,1531,922,848,74,908,14,"MUNICIPIUL CRAIOVA",,6,,384,524
17,"Dolj",163,"163-MUNICIPIUL CRAIOVA",69900,46,2,1998,1463,1360,103,1455,8,"MUNICIPIUL CRAIOVA",,6,,545,910
17,"Dolj",163,"163-MUNICIPIUL CRAIOVA",69900,47,2,619,733,453,280,731,2,"MUNICIPIUL CRAIOVA",,6,,300,431
17,"Dolj",163,"163-MUNICIPIUL CRAIOVA",69900,48,2,1937,1499,1263,236,1489,10,"MUNICIPIUL CRAIOVA",,6,,594,895
17,"Dolj",163,"163-MUNICIPIUL CRAIOVA",69900,49,2,1883,1425,1340,85,1415,10,"MUNICIPIUL CRAIOVA",,6,,449,966
17,"Dolj",163,"163-MUNICIPIUL CRAIOVA",69900,50,2,2161,1573,1461,112,1568,5,"MUNICIPIUL CRAIOVA",,6,,609,959
17,"Dolj",163,"163-MUNICIPIUL CRAIOVA",69900,51,2,2254,1699,1482,217,1690,9,"MUNICIPIUL CRAIOVA",,6,,697,993
17,"Dolj",163,"163-MUNICIPIUL CRAIOVA",69900,52,2,1900,1228,1119,109,1220,8,"MUNICIPIUL CRAIOVA",,6,,563,657
17,"Dolj",163,"163-MUNICIPIUL CRAIOVA",69900,53,2,1696,1195,1035,160,1185,10,"MUNICIPIUL CRAIOVA",,6,,502,683
17,"Dolj",163,"163-MUNICIPIUL CRAIOVA",69900,54,2,1937,1340,1215,125,1321,19,"MUNICIPIUL CRAIOVA",,6,,621,700
17,"Dolj",163,"163-MUNICIPIUL CRAIOVA",69900,55,2,992,695,634,61,690,5,"MUNICIPIUL CRAIOVA",,6,,363,327
17,"Dolj",163,"163-MUNICIPIUL CRAIOVA",69900,56,2,1954,1362,1270,92,1356,5,"MUNICIPIUL CRAIOVA",,6,,611,745
17,"Dolj",163,"163-MUNICIPIUL CRAIOVA",69900,57,2,2374,1616,1502,114,1602,14,"MUNICIPIUL CRAIOVA",,6,,664,938
17,"Dolj",163,"163-MUNICIPIUL CRAIOVA",69900,58,2,2613,1662,1448,214,1657,5,"MUNICIPIUL CRAIOVA",,6,,729,928
17,"Dolj",163,"163-MUNICIPIUL CRAIOVA",69900,59,2,2438,1683,1572,111,1671,11,"MUNICIPIUL CRAIOVA",,6,,756,915
17,"Dolj",163,"163-MUNICIPIUL CRAIOVA",69900,60,2,2450,1705,1631,74,1704,1,"MUNICIPIUL CRAIOVA",,6,,804,900
17,"Dolj",163,"163-MUNICIPIUL CRAIOVA",69900,61,2,2410,1651,1542,109,1645,6,"MUNICIPIUL CRAIOVA",,6,,782,863
17,"Dolj",163,"163-MUNICIPIUL CRAIOVA",69900,62,2,2157,1463,1368,95,1457,6,"MUNICIPIUL CRAIOVA",,6,,674,783
17,"Dolj",163,"163-MUNICIPIUL CRAIOVA",69900,63,2,2263,1648,1562,86,1640,8,"MUNICIPIUL CRAIOVA",,6,,691,949
17,"Dolj",163,"163-MUNICIPIUL CRAIOVA",69900,64,2,1863,1205,1162,43,1198,7,"MUNICIPIUL CRAIOVA",,6,,567,631
17,"Dolj",163,"163-MUNICIPIUL CRAIOVA",69900,65,2,2388,1580,1440,140,1574,6,"MUNICIPIUL CRAIOVA",,6,,751,823
17,"Dolj",163,"163-MUNICIPIUL CRAIOVA",69900,66,2,2295,1572,1446,126,1565,7,"MUNICIPIUL CRAIOVA",,6,,595,970
17,"Dolj",163,"163-MUNICIPIUL CRAIOVA",69900,67,2,2728,1822,1679,143,1810,12,"MUNICIPIUL CRAIOVA",,6,,812,998
17,"Dolj",163,"163-MUNICIPIUL CRAIOVA",69900,68,2,2002,1308,1242,66,1299,9,"MUNICIPIUL CRAIOVA",,6,,552,747
17,"Dolj",163,"163-MUNICIPIUL CRAIOVA",69900,69,2,1906,1254,1153,101,1247,7,"MUNICIPIUL CRAIOVA",,6,,582,665
17,"Dolj",163,"163-MUNICIPIUL CRAIOVA",69900,70,2,2109,1398,1333,65,1392,6,"MUNICIPIUL CRAIOVA",,6,,715,677
17,"Dolj",163,"163-MUNICIPIUL CRAIOVA",69900,71,2,1936,1382,1284,98,1373,9,"MUNICIPIUL CRAIOVA",,6,,642,731
17,"Dolj",163,"163-MUNICIPIUL CRAIOVA",69900,72,2,2367,1783,1614,169,1771,12,"MUNICIPIUL CRAIOVA",,6,,752,1019
17,"Dolj",163,"163-MUNICIPIUL CRAIOVA",69900,73,2,2519,1813,1715,98,1808,5,"MUNICIPIUL CRAIOVA",,6,,776,1032
17,"Dolj",163,"163-MUNICIPIUL CRAIOVA",69900,74,2,2416,1740,1634,106,1733,7,"MUNICIPIUL CRAIOVA",,6,,800,933
17,"Dolj",163,"163-MUNICIPIUL CRAIOVA",69900,75,2,2109,1520,1371,149,1514,6,"MUNICIPIUL CRAIOVA",,6,,668,846
17,"Dolj",163,"163-MUNICIPIUL CRAIOVA",69900,76,2,2312,1434,1338,96,1423,11,"MUNICIPIUL CRAIOVA",,6,,593,830
17,"Dolj",163,"163-MUNICIPIUL CRAIOVA",69900,77,2,1921,1537,1248,289,1523,14,"MUNICIPIUL CRAIOVA",,6,,631,892
17,"Dolj",163,"163-MUNICIPIUL CRAIOVA",69900,78,2,2562,1812,1707,105,1811,1,"MUNICIPIUL CRAIOVA",,6,,703,1108
17,"Dolj",163,"163-MUNICIPIUL CRAIOVA",69900,79,2,2359,1664,1559,105,1662,2,"MUNICIPIUL CRAIOVA",,6,,627,1035
17,"Dolj",163,"163-MUNICIPIUL CRAIOVA",69900,80,2,2271,1641,1527,114,1630,11,"MUNICIPIUL CRAIOVA",,6,,661,969
17,"Dolj",163,"163-MUNICIPIUL CRAIOVA",69900,81,2,1938,1387,1258,129,1380,7,"MUNICIPIUL CRAIOVA",,6,,557,823
17,"Dolj",163,"163-MUNICIPIUL CRAIOVA",69900,82,2,2223,1399,1275,124,1394,5,"MUNICIPIUL CRAIOVA",,6,,565,829
17,"Dolj",163,"163-MUNICIPIUL CRAIOVA",69900,83,2,1380,981,930,51,976,5,"MUNICIPIUL CRAIOVA",,6,,415,561
17,"Dolj",163,"163-MUNICIPIUL CRAIOVA",69900,84,2,1990,1238,1090,148,1230,8,"MUNICIPIUL CRAIOVA",,6,,525,705
17,"Dolj",163,"163-MUNICIPIUL CRAIOVA",69900,85,2,1715,1261,1188,73,1254,7,"MUNICIPIUL CRAIOVA",,6,,524,730
17,"Dolj",163,"163-MUNICIPIUL CRAIOVA",69900,86,2,1734,1233,1178,55,1231,2,"MUNICIPIUL CRAIOVA",,6,,493,738
17,"Dolj",163,"163-MUNICIPIUL CRAIOVA",69900,87,2,1970,1437,1329,108,1432,5,"MUNICIPIUL CRAIOVA",,6,,560,872
17,"Dolj",163,"163-MUNICIPIUL CRAIOVA",69900,88,2,1730,1281,1200,81,1279,2,"MUNICIPIUL CRAIOVA",,6,,559,720
17,"Dolj",163,"163-MUNICIPIUL CRAIOVA",69900,89,2,1385,1042,924,118,1038,4,"MUNICIPIUL CRAIOVA",,6,,441,597
17,"Dolj",163,"163-MUNICIPIUL CRAIOVA",69900,90,2,2375,1909,1652,257,1900,9,"MUNICIPIUL CRAIOVA",,6,,764,1136
17,"Dolj",163,"163-MUNICIPIUL CRAIOVA",69900,91,2,1705,1342,1206,136,1335,7,"MUNICIPIUL CRAIOVA",,6,,546,789
17,"Dolj",163,"163-MUNICIPIUL CRAIOVA",69900,92,2,1312,1060,966,94,1058,2,"MUNICIPIUL CRAIOVA",,6,,449,609
17,"Dolj",163,"163-MUNICIPIUL CRAIOVA",69900,93,2,1387,1127,991,136,1125,2,"MUNICIPIUL CRAIOVA",,6,,398,727
17,"Dolj",163,"163-MUNICIPIUL CRAIOVA",69900,94,2,1835,1435,1290,145,1424,11,"MUNICIPIUL CRAIOVA",,6,,595,829
17,"Dolj",163,"163-MUNICIPIUL CRAIOVA",69900,95,2,1370,1208,1019,189,1207,1,"MUNICIPIUL CRAIOVA",,6,,490,717
17,"Dolj",163,"163-MUNICIPIUL CRAIOVA",69900,96,2,1457,1043,885,158,1040,3,"MUNICIPIUL CRAIOVA",,6,,453,587
17,"Dolj",163,"163-MUNICIPIUL CRAIOVA",69900,97,2,1938,1602,1411,191,1600,2,"MUNICIPIUL CRAIOVA",,6,,695,905
17,"Dolj",163,"163-MUNICIPIUL CRAIOVA",69900,98,2,2033,1499,1418,81,1496,3,"MUNICIPIUL CRAIOVA",,6,,625,871
17,"Dolj",163,"163-MUNICIPIUL CRAIOVA",69900,99,2,1926,1361,1226,135,1356,5,"MUNICIPIUL CRAIOVA",,6,,615,741
17,"Dolj",163,"163-MUNICIPIUL CRAIOVA",69900,100,2,1731,1256,1079,177,1248,8,"MUNICIPIUL CRAIOVA",,6,,550,698
17,"Dolj",163,"163-MUNICIPIUL CRAIOVA",69900,101,2,1206,889,784,105,881,8,"MUNICIPIUL CRAIOVA",,6,,371,510
17,"Dolj",163,"163-MUNICIPIUL CRAIOVA",69900,102,2,1366,1175,993,182,1160,15,"MUNICIPIUL CRAIOVA",,6,,486,674
17,"Dolj",163,"163-MUNICIPIUL CRAIOVA",69900,103,2,752,630,552,78,625,5,"MUNICIPIUL CRAIOVA",,6,,321,304
17,"Dolj",163,"163-MUNICIPIUL CRAIOVA",69900,104,2,1198,894,813,81,887,7,"MUNICIPIUL CRAIOVA",,6,,445,442
17,"Dolj",163,"163-MUNICIPIUL CRAIOVA",69900,105,2,977,745,666,79,736,9,"MUNICIPIUL CRAIOVA",,6,,346,390
17,"Dolj",163,"163-MUNICIPIUL CRAIOVA",69900,106,2,1453,1654,1080,574,1650,4,"MUNICIPIUL CRAIOVA",,6,,613,1037
17,"Dolj",163,"163-MUNICIPIUL CRAIOVA",69900,107,2,1823,1779,1325,454,1765,14,"MUNICIPIUL CRAIOVA",,6,,759,1006
17,"Dolj",163,"163-MUNICIPIUL CRAIOVA",69900,108,2,1997,1528,1422,106,1527,1,"MUNICIPIUL CRAIOVA",,6,,586,941
17,"Dolj",163,"163-MUNICIPIUL CRAIOVA",69900,109,2,1800,1303,1229,74,1299,4,"MUNICIPIUL CRAIOVA",,6,,518,781
17,"Dolj",163,"163-MUNICIPIUL CRAIOVA",69900,110,2,1620,1263,1171,92,1260,3,"MUNICIPIUL CRAIOVA",,6,,516,744
17,"Dolj",163,"163-MUNICIPIUL CRAIOVA",69900,111,2,2006,1560,1419,141,1552,8,"MUNICIPIUL CRAIOVA",,6,,646,906
17,"Dolj",163,"163-MUNICIPIUL CRAIOVA",69900,112,2,1318,1134,958,176,1129,5,"MUNICIPIUL CRAIOVA",,6,,495,634
17,"Dolj",163,"163-MUNICIPIUL CRAIOVA",69900,113,2,1721,1225,1131,94,1220,5,"MUNICIPIUL CRAIOVA",,6,,558,662
17,"Dolj",163,"163-MUNICIPIUL CRAIOVA",69900,114,2,1658,1273,1188,85,1269,4,"MUNICIPIUL CRAIOVA",,6,,515,754
17,"Dolj",163,"163-MUNICIPIUL CRAIOVA",69900,115,2,2125,1518,1455,63,1512,6,"MUNICIPIUL CRAIOVA",,6,,646,866
17,"Dolj",163,"163-MUNICIPIUL CRAIOVA",69900,116,2,2013,1519,1414,105,1512,7,"MUNICIPIUL CRAIOVA",,6,,612,900
17,"Dolj",163,"163-MUNICIPIUL CRAIOVA",69900,117,2,2170,1570,1520,50,1566,4,"MUNICIPIUL CRAIOVA",,6,,691,875
17,"Dolj",163,"163-MUNICIPIUL CRAIOVA",69900,118,2,1969,1404,1357,47,1396,8,"MUNICIPIUL CRAIOVA",,6,,621,775
17,"Dolj",163,"163-MUNICIPIUL CRAIOVA",69900,119,2,2229,1673,1528,145,1671,2,"MUNICIPIUL CRAIOVA",,6,,772,899
17,"Dolj",163,"163-MUNICIPIUL CRAIOVA",69900,120,2,2058,1478,1385,93,1473,5,"MUNICIPIUL CRAIOVA",,6,,644,829
17,"Dolj",163,"163-MUNICIPIUL CRAIOVA",69900,121,2,1862,1380,1249,131,1375,5,"MUNICIPIUL CRAIOVA",,6,,617,758
17,"Dolj",163,"163-MUNICIPIUL CRAIOVA",69900,122,2,1425,1441,962,479,1431,10,"MUNICIPIUL CRAIOVA",,6,,533,898
17,"Dolj",163,"163-MUNICIPIUL CRAIOVA",69900,123,2,1420,1090,1011,79,1088,2,"MUNICIPIUL CRAIOVA",,6,,449,639
17,"Dolj",163,"163-MUNICIPIUL CRAIOVA",69900,124,2,1660,1118,1057,61,1113,5,"MUNICIPIUL CRAIOVA",,6,,449,664
17,"Dolj",163,"163-MUNICIPIUL CRAIOVA",69900,125,2,1715,1202,1124,78,1196,6,"MUNICIPIUL CRAIOVA",,6,,484,712
17,"Dolj",163,"163-MUNICIPIUL CRAIOVA",69900,126,2,1460,972,895,77,968,4,"MUNICIPIUL CRAIOVA",,6,,403,565
17,"Dolj",163,"163-MUNICIPIUL CRAIOVA",69900,127,2,1640,1394,1060,334,1386,8,"MUNICIPIUL CRAIOVA",,6,,540,846
17,"Dolj",163,"163-MUNICIPIUL CRAIOVA",69900,128,2,1385,1156,941,215,1149,7,"MUNICIPIUL CRAIOVA",,6,,471,678
17,"Dolj",163,"163-MUNICIPIUL CRAIOVA",69900,129,2,1422,903,828,75,899,4,"MUNICIPIUL CRAIOVA",,6,,434,465
17,"Dolj",163,"163-MUNICIPIUL CRAIOVA",69900,130,2,1158,790,645,145,782,8,"MUNICIPIUL CRAIOVA",,6,,359,423
17,"Dolj",163,"163-MUNICIPIUL CRAIOVA",69900,131,2,762,597,435,162,593,4,"MUNICIPIUL CRAIOVA",,6,,328,265
17,"Dolj",163,"163-MUNICIPIUL CRAIOVA",69900,132,2,0,1148,0,1148,1130,18,"MUNICIPIUL CRAIOVA",,6,,556,574
17,"Dolj",163,"163-MUNICIPIUL CRAIOVA",69900,133,2,0,283,0,283,277,6,"MUNICIPIUL CRAIOVA",,6,,120,157
17,"Dolj",163,"163-MUNICIPIUL CRAIOVA",69900,134,2,0,343,0,343,341,2,"MUNICIPIUL CRAIOVA",,6,,163,178
17,"Dolj",163,"163-MUNICIPIUL CRAIOVA",69900,135,2,228,258,220,38,256,2,"MUNICIPIUL CRAIOVA",,6,,121,135
17,"Dolj",163,"163-MUNICIPIUL CRAIOVA",69900,136,2,0,681,0,681,671,10,"MUNICIPIUL CRAIOVA",,6,,325,346
17,"Dolj",163,"163-MUNICIPIUL CRAIOVA",69900,137,2,389,420,379,41,416,4,"MUNICIPIUL CRAIOVA",,6,,201,215
17,"Dolj",163,"163-MUNICIPIUL CRAIOVA",69900,138,2,0,209,0,209,206,3,"MUNICIPIUL CRAIOVA",,6,,89,117
17,"Dolj",163,"163-MUNICIPIUL CRAIOVA",69900,139,2,0,139,0,139,138,1,"MUNICIPIUL CRAIOVA",,6,,74,64
17,"Dolj",163,"163-MUNICIPIUL CRAIOVA",69900,140,2,100,120,99,21,120,0,"MUNICIPIUL CRAIOVA",,6,,60,60
17,"Dolj",163,"163-MUNICIPIUL CRAIOVA",69900,141,2,503,580,500,80,576,4,"MUNICIPIUL CRAIOVA",,6,,257,319
17,"Dolj",163,"163-MUNICIPIUL CRAIOVA",69900,142,2,0,576,0,576,568,8,"MUNICIPIUL CRAIOVA",,6,,302,266
17,"Dolj",163,"163-MUNICIPIUL CRAIOVA",69900,143,2,0,807,0,807,796,11,"MUNICIPIUL CRAIOVA",,6,,169,627
17,"Dolj",163,"163-ORAS BAILESTI",70316,144,2,1413,1004,916,88,990,14,"ORAS BAILESTI",,6,,447,543
17,"Dolj",163,"163-ORAS BAILESTI",70316,145,2,1438,945,845,100,940,5,"ORAS BAILESTI",,6,,474,466
17,"Dolj",163,"163-ORAS BAILESTI",70316,146,2,1320,663,589,74,659,4,"ORAS BAILESTI",,6,,343,316
17,"Dolj",163,"163-ORAS BAILESTI",70316,147,2,1604,1024,914,110,1019,5,"ORAS BAILESTI",,6,,506,513
17,"Dolj",163,"163-ORAS BAILESTI",70316,148,2,1292,840,752,88,831,9,"ORAS BAILESTI",,6,,483,348
17,"Dolj",163,"163-ORAS BAILESTI",70316,149,2,1016,675,650,25,666,9,"ORAS BAILESTI",,6,,329,337
17,"Dolj",163,"163-ORAS BAILESTI",70316,150,2,1448,1001,908,93,994,7,"ORAS BAILESTI",,6,,553,441
17,"Dolj",163,"163-ORAS BAILESTI",70316,151,2,1254,875,777,98,869,6,"ORAS BAILESTI",,6,,441,428
17,"Dolj",163,"163-ORAS BAILESTI",70316,152,2,1317,908,815,93,901,7,"ORAS BAILESTI",,6,,443,458
17,"Dolj",163,"163-ORAS BAILESTI",70316,153,2,1455,1015,913,102,998,16,"ORAS BAILESTI",,6,,569,429
17,"Dolj",163,"163-ORAS BAILESTI",70316,154,2,1372,910,854,56,903,7,"ORAS BAILESTI",,6,,479,424
17,"Dolj",163,"163-ORAS BAILESTI",70316,155,2,1407,998,843,155,987,11,"ORAS BAILESTI",,6,,503,484
17,"Dolj",163,"163-ORAS BAILESTI",70316,156,2,495,392,332,60,389,3,"ORAS BAILESTI",,6,,234,155
17,"Dolj",163,"163-ORAS CALAFAT",70352,157,2,515,433,334,99,429,4,"ORAS CALAFAT",,6,,272,157
17,"Dolj",163,"163-ORAS CALAFAT",70352,158,2,1059,802,693,109,787,15,"ORAS CALAFAT",,6,,510,277
17,"Dolj",163,"163-ORAS CALAFAT",70352,159,2,2085,1551,1426,125,1542,9,"ORAS CALAFAT",,6,,1016,526
17,"Dolj",163,"163-ORAS CALAFAT",70352,160,2,2407,1500,1298,202,1495,5,"ORAS CALAFAT",,6,,772,723
17,"Dolj",163,"163-ORAS CALAFAT",70352,161,2,2040,1435,1328,107,1424,11,"ORAS CALAFAT",,6,,882,542
17,"Dolj",163,"163-ORAS CALAFAT",70352,162,2,1654,1141,980,161,1129,12,"ORAS CALAFAT",,6,,642,487
17,"Dolj",163,"163-ORAS CALAFAT",70352,163,2,2012,1250,1147,103,1247,3,"ORAS CALAFAT",,6,,617,630
17,"Dolj",163,"163-ORAS CALAFAT",70352,164,2,2206,1218,1106,112,1211,7,"ORAS CALAFAT",,6,,516,695
17,"Dolj",163,"163-ORAS CALAFAT",70352,165,2,2448,1433,1274,159,1432,1,"ORAS CALAFAT",,6,,674,758
17,"Dolj",163,"163-ORAS FILIASI",70414,166,2,2203,1487,1396,91,1478,9,"ORAS FILIASI",,6,,833,645
17,"Dolj",163,"163-ORAS FILIASI",70414,167,2,2483,1702,1509,193,1690,12,"ORAS FILIASI",,6,,888,802
17,"Dolj",163,"163-ORAS FILIASI",70414,168,2,2134,1506,1272,234,1498,8,"ORAS FILIASI",,6,,804,694
17,"Dolj",163,"163-ORAS FILIASI",70414,169,2,2816,1911,1663,248,1900,11,"ORAS FILIASI",,6,,1048,852
17,"Dolj",163,"163-ORAS FILIASI",70414,170,2,981,726,667,59,722,4,"ORAS FILIASI",,6,,542,180
17,"Dolj",163,"163-ORAS FILIASI",70414,171,2,1858,1254,1125,129,1233,21,"ORAS FILIASI",,6,,777,456
17,"Dolj",163,"163-ORAS FILIASI",70414,172,2,835,697,619,78,681,16,"ORAS FILIASI",,6,,385,296
17,"Dolj",163,"163-ORAS FILIASI",70414,173,2,73,90,71,19,88,2,"ORAS FILIASI",,6,,54,34
17,"Dolj",163,"163-ORAS SEGARCEA",70502,174,2,1974,1315,1224,91,1299,16,"ORAS SEGARCEA",,6,,896,403
17,"Dolj",163,"163-ORAS SEGARCEA",70502,175,2,1299,897,796,101,894,3,"ORAS SEGARCEA",,6,,552,342
17,"Dolj",163,"163-ORAS SEGARCEA",70502,176,2,1704,1145,1071,74,1122,22,"ORAS SEGARCEA",,6,,719,403
17,"Dolj",163,"163-ORAS SEGARCEA",70502,177,2,1422,1022,937,85,1010,12,"ORAS SEGARCEA",,6,,689,321
17,"Dolj",163,"163-AFUMATI",70520,178,2,1234,935,835,100,930,5,"AFUMATI",,6,,642,288
17,"Dolj",163,"163-AFUMATI",70520,179,2,1046,814,687,127,800,14,"AFUMATI",,6,,437,363
17,"Dolj",163,"163-AFUMATI",70520,180,2,535,438,359,79,429,9,"AFUMATI",,6,,257,172
17,"Dolj",163,"163-ALMAJ",70566,181,2,1691,1106,945,161,1101,5,"ALMAJ",,6,,545,556
17,"Dolj",163,"163-ALMAJ",70566,182,2,1327,960,744,216,954,6,"ALMAJ",,6,,655,299
17,"Dolj",163,"163-AMARASTII DE JOS",70637,183,2,1514,955,832,123,949,6,"AMARASTII DE JOS",,6,,472,477
17,"Dolj",163,"163-AMARASTII DE JOS",70637,184,2,1138,838,541,297,835,3,"AMARASTII DE JOS",,6,,537,298
17,"Dolj",163,"163-AMARASTII DE JOS",70637,185,2,1362,1001,933,68,990,11,"AMARASTII DE JOS",,6,,649,341
17,"Dolj",163,"163-AMARASTII DE JOS",70637,186,2,522,422,362,60,411,11,"AMARASTII DE JOS",,6,,388,23
17,"Dolj",163,"163-AMARASTII DE SUS",70673,187,2,2037,1260,1059,201,1248,12,"AMARASTII DE SUS",,6,,779,469
17,"Dolj",163,"163-AMARASTII DE SUS",70673,188,2,1164,1056,828,228,1046,10,"AMARASTII DE SUS",,6,,437,609
17,"Dolj",163,"163-APELE VII",70726,189,2,2051,1376,1137,239,1359,17,"APELE VII",,6,,869,490
17,"Dolj",163,"163-ARGETOAIA",70744,190,2,1824,1176,924,252,1157,19,"ARGETOAIA",,6,,866,291
17,"Dolj",163,"163-ARGETOAIA",70744,191,2,1071,760,671,89,740,20,"ARGETOAIA",,6,,398,342
17,"Dolj",163,"163-ARGETOAIA",70744,192,2,482,305,242,63,301,4,"ARGETOAIA",,6,,189,112
17,"Dolj",163,"163-ARGETOAIA",70744,193,2,356,289,217,72,276,13,"ARGETOAIA",,6,,184,92
17,"Dolj",163,"163-BECHET",70888,194,2,696,564,387,177,560,4,"BECHET",,6,,373,187
17,"Dolj",163,"163-BECHET",70888,195,2,2330,1396,1144,252,1389,7,"BECHET",,6,,905,484
17,"Dolj",163,"163-BISTRET",70897,196,2,1435,842,662,180,828,14,"BISTRET",,6,,524,304
17,"Dolj",163,"163-BISTRET",70897,197,2,1404,803,597,206,794,9,"BISTRET",,6,,447,347
17,"Dolj",163,"163-BISTRET",70897,198,2,892,595,486,109,587,8,"BISTRET",,6,,448,139
17,"Dolj",163,"163-BARCA",70940,199,2,1923,1260,1063,197,1250,10,"BARCA",,6,,958,292
17,"Dolj",163,"163-BARCA",70940,200,2,1753,1068,883,185,1062,6,"BARCA",,6,,759,303
17,"Dolj",163,"163-BOTOSESTI-PAIA",70968,201,2,924,712,610,102,698,14,"BOTOSESTI-PAIA",,6,,483,215
17,"Dolj",163,"163-BRABOVA",70986,202,2,597,445,354,91,442,3,"BRABOVA",,6,,372,70
17,"Dolj",163,"163-BRABOVA",70986,203,2,491,393,345,48,387,6,"BRABOVA",,6,,270,117
17,"Dolj",163,"163-BRABOVA",70986,204,2,446,397,341,56,386,11,"BRABOVA",,6,,288,98
17,"Dolj",163,"163-BRABOVA",70986,205,2,240,204,174,30,203,1,"BRABOVA",,6,,138,65
17,"Dolj",163,"163-BRADESTI",71055,206,2,1317,929,659,270,918,11,"BRADESTI",,6,,555,363
17,"Dolj",163,"163-BRADESTI",71055,207,2,407,325,220,105,319,6,"BRADESTI",,6,,198,121
17,"Dolj",163,"163-BRADESTI",71055,208,2,751,514,398,116,507,7,"BRADESTI",,6,,350,157
17,"Dolj",163,"163-BRADESTI",71055,209,2,666,605,469,136,600,5,"BRADESTI",,6,,377,223
17,"Dolj",163,"163-BRADESTI",71055,210,2,214,136,77,59,134,2,"BRADESTI",,6,,96,38
17,"Dolj",163,"163-BRALOSTITA",71126,211,2,1794,1208,1073,135,1191,17,"BRALOSTITA",,6,,942,249
17,"Dolj",163,"163-BRALOSTITA",71126,212,2,940,615,528,87,605,5,"BRALOSTITA",,6,,404,201
17,"Dolj",163,"163-BRATOVOESTI",71199,213,2,1049,746,549,197,732,14,"BRATOVOESTI",,6,,491,241
17,"Dolj",163,"163-BRATOVOESTI",71199,214,2,736,533,385,148,524,9,"BRATOVOESTI",,6,,377,147
17,"Dolj",163,"163-BRATOVOESTI",71199,215,2,519,399,312,87,397,2,"BRATOVOESTI",,6,,322,75
17,"Dolj",163,"163-BRATOVOESTI",71199,216,2,518,425,347,78,424,1,"BRATOVOESTI",,6,,306,118
17,"Dolj",163,"163-BRATOVOESTI",71199,217,2,1405,964,782,182,938,26,"BRATOVOESTI",,6,,726,212
17,"Dolj",163,"163-BRATOVOESTI",71199,218,2,439,467,301,166,461,6,"BRATOVOESTI",,6,,321,140
17,"Dolj",163,"163-BREASTA",71260,219,2,1503,900,776,124,888,12,"BREASTA",,6,,444,444
17,"Dolj",163,"163-BREASTA",71260,220,2,1297,803,688,115,784,19,"BREASTA",,6,,390,394
17,"Dolj",163,"163-BUCOVAT",69964,221,2,1255,887,693,194,878,9,"BUCOVAT",,6,,406,472
17,"Dolj",163,"163-BUCOVAT",69964,222,2,407,417,223,194,415,2,"BUCOVAT",,6,,201,214
17,"Dolj",163,"163-BUCOVAT",69964,223,2,662,465,357,108,458,7,"BUCOVAT",,6,,214,244
17,"Dolj",163,"163-BUCOVAT",69964,224,2,682,464,359,105,451,13,"BUCOVAT",,6,,265,186
17,"Dolj",163,"163-BULZESTI",71340,225,2,802,615,470,145,605,10,"BULZESTI",,6,,441,164
17,"Dolj",163,"163-BULZESTI",71340,226,2,916,587,461,126,579,7,"BULZESTI",,6,,357,222
17,"Dolj",163,"163-CALOPAR",71457,227,2,1158,740,609,131,734,6,"CALOPAR",,6,,396,338
17,"Dolj",163,"163-CALOPAR",71457,228,2,634,500,410,90,481,19,"CALOPAR",,6,,303,178
17,"Dolj",163,"163-CALOPAR",71457,229,2,1149,700,573,127,684,16,"CALOPAR",,6,,366,318
17,"Dolj",163,"163-CARAULA",71518,230,2,2040,1442,1271,171,1434,8,"CARAULA",,6,,885,549
17,"Dolj",163,"163-CARPEN",71536,231,2,1150,1271,1146,125,1263,8,"CARPEN",,6,,1014,249
17,"Dolj",163,"163-CARPEN",71536,232,2,1453,1060,925,135,1007,53,"CARPEN",,6,,802,205
17,"Dolj",163,"163-CASTRANOVA",71572,233,2,1589,1069,887,182,1049,20,"CASTRANOVA",,6,,617,432
17,"Dolj",163,"163-CASTRANOVA",71572,234,2,1214,961,782,179,946,15,"CASTRANOVA",,6,,616,330
17,"Dolj",163,"163-CALARASI",71607,235,2,2146,1331,1166,165,1324,7,"CALARASI",,6,,756,568
17,"Dolj",163,"163-CALARASI",71607,236,2,1587,1203,1042,161,1197,6,"CALARASI",,6,,605,592
17,"Dolj",163,"163-CALARASI",71607,237,2,1687,1261,1084,177,1246,15,"CALARASI",,6,,737,509
17,"Dolj",163,"163-CELARU",71634,238,2,1084,651,570,81,641,10,"CELARU",,6,,450,191
17,"Dolj",163,"163-CELARU",71634,239,2,1309,726,628,98,715,11,"CELARU",,6,,462,253
17,"Dolj",163,"163-CELARU",71634,240,2,1472,994,807,187,965,29,"CELARU",,6,,609,356
17,"Dolj",163,"163-CELARU",71634,241,2,680,504,394,110,493,11,"CELARU",,6,,357,136
17,"Dolj",163,"163-CERAT",71698,242,2,1892,1384,1223,161,1365,19,"CERAT",,6,,908,457
17,"Dolj",163,"163-CERAT",71698,243,2,1068,793,645,148,777,16,"CERAT",,6,,415,362
17,"Dolj",163,"163-CERNATESTI",71723,244,2,662,451,384,67,446,5,"CERNATESTI",,6,,329,117
17,"Dolj",163,"163-CERNATESTI",71723,245,2,472,456,333,123,451,5,"CERNATESTI",,6,,308,143
17,"Dolj",163,"163-CERNATESTI",71723,246,2,818,545,477,68,539,6,"CERNATESTI",,6,,315,224
17,"Dolj",163,"163-CETATE",71787,247,2,1767,1160,1001,159,1139,21,"CETATE",,6,,686,453
17,"Dolj",163,"163-CETATE",71787,248,2,1519,1073,815,258,1059,14,"CETATE",,6,,620,439
17,"Dolj",163,"163-CETATE",71787,249,2,955,700,565,135,692,8,"CETATE",,6,,431,261
17,"Dolj",163,"163-CETATE",71787,250,2,637,494,432,62,483,11,"CETATE",,6,,350,133
17,"Dolj",163,"163-CIOROIASI",71812,251,2,1187,781,645,136,769,12,"CIOROIASI",,6,,300,469
17,"Dolj",163,"163-CIOROIASI",71812,252,2,574,440,351,89,436,4,"CIOROIASI",,6,,303,133
17,"Dolj",163,"163-CIUPERCENII NOI",71858,253,2,1989,1467,1254,213,1452,15,"CIUPERCENII NOI",,6,,855,597
17,"Dolj",163,"163-CIUPERCENII NOI",71858,254,2,1628,1089,912,177,1073,16,"CIUPERCENII NOI",,6,,665,408
17,"Dolj",163,"163-CIUPERCENII NOI",71858,255,2,1230,996,840,156,991,5,"CIUPERCENII NOI",,6,,659,332
17,"Dolj",163,"163-COSOVENI",71885,256,2,1767,1339,1132,207,1313,26,"COSOVENI",,6,,650,663
17,"Dolj",163,"163-COSOVENI",71885,257,2,634,572,384,188,561,11,"COSOVENI",,6,,272,289
17,"Dolj",163,"163-COSOVENI",71885,258,2,1188,883,736,147,867,16,"COSOVENI",,6,,489,378
17,"Dolj",163,"163-COTOFENII DIN DOS",71910,259,2,989,754,689,65,740,14,"COTOFENII DIN DOS",,6,,454,286
17,"Dolj",163,"163-COTOFENII DIN DOS",71910,260,2,1130,840,765,75,828,12,"COTOFENII DIN DOS",,6,,516,312
17,"Dolj",163,"163-DANETI",71956,261,2,2014,1056,922,134,1044,12,"DANETI",,6,,555,489
17,"Dolj",163,"163-DANETI",71956,262,2,1757,920,789,131,910,10,"DANETI",,6,,492,418
17,"Dolj",163,"163-DANETI",71956,263,2,1209,881,685,196,866,15,"DANETI",,6,,537,329
17,"Dolj",163,"163-DANETI",71956,264,2,983,722,551,171,714,8,"DANETI",,6,,463,251
17,"Dolj",163,"163-DABULENI",72016,265,2,1775,1282,1120,162,1267,15,"DABULENI",,6,,858,409
17,"Dolj",163,"163-DABULENI",72016,266,2,2207,1477,1257,220,1466,11,"DABULENI",,6,,937,529
17,"Dolj",163,"163-DABULENI",72016,267,2,1315,1040,792,248,1022,18,"DABULENI",,6,,678,344
17,"Dolj",163,"163-DABULENI",72016,268,2,1907,1298,1106,192,1279,19,"DABULENI",,6,,888,391
17,"Dolj",163,"163-DABULENI",72016,269,2,1531,1101,939,162,1090,11,"DABULENI",,6,,716,374
17,"Dolj",163,"163-DABULENI",72016,270,2,1553,1131,917,214,1121,10,"DABULENI",,6,,743,378
17,"Dolj",163,"163-DABULENI",72016,271,2,1354,991,795,196,977,14,"DABULENI",,6,,666,311
17,"Dolj",163,"163-DESA",72034,272,2,2004,1114,1049,65,1104,10,"DESA",,6,,755,349
17,"Dolj",163,"163-DESA",72034,273,2,1750,1171,1085,86,1164,7,"DESA",,6,,860,304
17,"Dolj",163,"163-DIOSTI",72052,274,2,1046,825,723,102,813,12,"DIOSTI",,6,,401,412
17,"Dolj",163,"163-DIOSTI",72052,275,2,671,539,449,90,524,15,"DIOSTI",,6,,320,204
17,"Dolj",163,"163-DIOSTI",72052,276,2,914,770,645,125,764,6,"DIOSTI",,6,,556,208
17,"Dolj",163,"163-DOBRESTI",72098,277,2,917,655,536,119,647,8,"DOBRESTI",,6,,439,208
17,"Dolj",163,"163-DOBRESTI",72098,278,2,485,427,313,114,421,6,"DOBRESTI",,6,,318,103
17,"Dolj",163,"163-DOBRESTI",72098,279,2,857,594,482,112,581,13,"DOBRESTI",,6,,433,148
17,"Dolj",163,"163-DRAGOTESTI",72150,280,2,1301,1034,859,175,1017,17,"DRAGOTESTI",,6,,758,259
17,"Dolj",163,"163-DRAGOTESTI",72150,281,2,704,674,499,175,667,7,"DRAGOTESTI",,6,,464,203
17,"Dolj",163,"163-DRANIC",72221,282,2,1404,928,787,141,925,3,"DRANIC",,6,,574,351
17,"Dolj",163,"163-DRANIC",72221,283,2,933,651,572,79,644,7,"DRANIC",,6,,411,233
17,"Dolj",163,"163-DRANIC",72221,284,2,430,292,258,34,284,8,"DRANIC",,6,,204,80
17,"Dolj",163,"163-FARCAS",72276,285,2,1586,977,796,181,960,17,"FARCAS",,6,,679,281
17,"Dolj",163,"163-FARCAS",72276,286,2,889,661,460,201,648,13,"FARCAS",,6,,419,229
17,"Dolj",163,"163-GALICEA MARE",72383,287,2,1420,948,825,123,931,17,"GALICEA MARE",,6,,501,430
17,"Dolj",163,"163-GALICEA MARE",72383,288,2,1158,728,655,73,722,6,"GALICEA MARE",,6,,376,346
17,"Dolj",163,"163-GALICEA MARE",72383,289,2,1427,917,816,101,905,12,"GALICEA MARE",,6,,501,404
17,"Dolj",163,"163-GHERCESTI",72409,290,2,1036,859,743,116,843,16,"GHERCESTI",,6,,392,451
17,"Dolj",163,"163-GHERCESTI",72409,291,2,468,379,318,61,379,0,"GHERCESTI",,6,,255,124
17,"Dolj",163,"163-GIGHERA",72463,292,2,1157,790,598,192,784,6,"GIGHERA",,6,,512,272
17,"Dolj",163,"163-GIGHERA",72463,293,2,1147,886,710,176,881,5,"GIGHERA",,6,,647,234
17,"Dolj",163,"163-GIGHERA",72463,294,2,872,649,523,126,635,14,"GIGHERA",,6,,386,249
17,"Dolj",163,"163-GIUBEGA",72506,295,2,990,736,614,122,731,5,"GIUBEGA",,6,,409,322
17,"Dolj",163,"163-GIUBEGA",72506,296,2,1106,785,656,129,779,6,"GIUBEGA",,6,,490,289
17,"Dolj",163,"163-GIUBEGA",72506,297,2,1414,939,785,154,929,10,"GIUBEGA",,6,,512,417
17,"Dolj",163,"163-GIURGITA",72533,298,2,545,645,367,278,635,10,"GIURGITA",,6,,449,186
17,"Dolj",163,"163-GIURGITA",72533,299,2,1626,905,757,148,902,3,"GIURGITA",,6,,663,239
17,"Dolj",163,"163-GIURGITA",72533,300,2,610,444,332,112,439,5,"GIURGITA",,6,,304,135
17,"Dolj",163,"163-GANGIOVA",72579,301,2,1567,943,830,113,925,18,"GANGIOVA",,6,,625,300
17,"Dolj",163,"163-GANGIOVA",72579,302,2,1003,707,570,137,705,2,"GANGIOVA",,6,,498,207
17,"Dolj",163,"163-GOGOSU",72604,303,2,719,518,414,104,514,4,"GOGOSU",,6,,317,197
17,"Dolj",163,"163-GOGOSU",72604,304,2,349,283,235,48,280,3,"GOGOSU",,6,,193,87
17,"Dolj",163,"163-GOICEA",72640,305,2,1059,841,624,217,831,10,"GOICEA",,6,,537,294
17,"Dolj",163,"163-GOICEA",72640,306,2,1902,1101,959,142,1089,12,"GOICEA",,6,,745,344
17,"Dolj",163,"163-GOICEA",72640,307,2,1425,957,825,132,936,21,"GOICEA",,6,,649,287
17,"Dolj",163,"163-GOIESTI",72677,308,2,1458,919,682,237,905,14,"GOIESTI",,6,,549,356
17,"Dolj",163,"163-GOIESTI",72677,309,2,545,449,283,166,438,11,"GOIESTI",,6,,298,140
17,"Dolj",163,"163-GOIESTI",72677,310,2,658,439,315,124,430,9,"GOIESTI",,6,,263,167
17,"Dolj",163,"163-GRECESTI",72819,311,2,983,625,509,116,613,12,"GRECESTI",,6,,349,264
17,"Dolj",163,"163-GRECESTI",72819,312,2,770,496,356,140,484,12,"GRECESTI",,6,,334,150
17,"Dolj",163,"163-ISALNITA",70094,313,2,1515,1095,958,137,1082,13,"ISALNITA",,6,,502,580
17,"Dolj",163,"163-ISALNITA",70094,314,2,1443,1106,973,133,1086,20,"ISALNITA",,6,,496,590
17,"Dolj",163,"163-IZVOARE",72882,315,2,1432,919,785,134,908,11,"IZVOARE",,6,,552,356
17,"Dolj",163,"163-IZVOARE",72882,316,2,371,328,255,73,324,4,"IZVOARE",,6,,177,147
17,"Dolj",163,"163-LEU",72926,317,2,1798,1218,1102,116,1197,21,"LEU",,6,,783,414
17,"Dolj",163,"163-LEU",72926,318,2,1817,1152,1055,97,1120,32,"LEU",,6,,760,360
17,"Dolj",163,"163-LEU",72926,319,2,1128,828,716,112,816,12,"LEU",,6,,411,405
17,"Dolj",163,"163-LIPOVU",72953,320,2,1273,609,529,80,600,9,"LIPOVU",,6,,318,282
17,"Dolj",163,"163-LIPOVU",72953,321,2,1058,601,477,124,598,3,"LIPOVU",,6,,303,295
17,"Dolj",163,"163-MACESU DE JOS",72980,322,2,1149,873,772,101,861,12,"MACESU DE JOS",,6,,638,223
17,"Dolj",163,"163-MACESU DE JOS",72980,323,2,400,342,284,58,341,1,"MACESU DE JOS",,6,,239,102
17,"Dolj",163,"163-MACESU DE SUS",73013,324,2,1620,1121,995,126,1109,9,"MACESU DE SUS",,6,,584,525
17,"Dolj",163,"163-MAGLAVIT",73031,325,2,1373,1437,1321,116,1420,17,"MAGLAVIT",,6,,914,506
17,"Dolj",163,"163-MAGLAVIT",73031,326,2,1993,1855,1798,57,1844,11,"MAGLAVIT",,6,,1203,641
17,"Dolj",163,"163-MAGLAVIT",73031,327,2,1435,1141,884,257,1135,6,"MAGLAVIT",,6,,776,359
17,"Dolj",163,"163-MALU MARE",73068,328,2,1367,881,703,178,866,15,"MALU MARE",,6,,450,416
17,"Dolj",163,"163-MALU MARE",73068,329,2,693,662,485,177,659,3,"MALU MARE",,6,,334,325
17,"Dolj",163,"163-MALU MARE",73068,330,2,1558,1375,1171,204,1345,30,"MALU MARE",,6,,655,690
17,"Dolj",163,"163-MELINESTI",73102,331,2,783,870,414,456,864,6,"MELINESTI",,6,,598,266
17,"Dolj",163,"163-MELINESTI",73102,332,2,1511,965,707,258,951,14,"MELINESTI",,6,,697,254
17,"Dolj",163,"163-MELINESTI",73102,333,2,950,524,379,145,518,6,"MELINESTI",,6,,313,205
17,"Dolj",163,"163-MISCHII",73246,334,2,1056,740,634,106,722,18,"MISCHII",,6,,332,390
17,"Dolj",163,"163-MISCHII",73246,335,2,581,459,341,118,451,8,"MISCHII",,6,,234,217
17,"Dolj",163,"163-MARSANI",73317,336,2,1576,998,962,36,988,10,"MARSANI",,6,,693,295
17,"Dolj",163,"163-MARSANI",73317,337,2,1664,959,905,54,954,5,"MARSANI",,6,,635,319
17,"Dolj",163,"163-MARSANI",73317,338,2,1294,1130,1058,72,1122,8,"MARSANI",,6,,783,339
17,"Dolj",163,"163-MOTATEI",73335,339,2,763,600,515,85,593,7,"MOTATEI",,6,,351,242
17,"Dolj",163,"163-MOTATEI",73335,340,2,1988,1311,1206,105,1296,15,"MOTATEI",,6,,822,474
17,"Dolj",163,"163-MOTATEI",73335,341,2,1628,1049,964,85,1046,3,"MOTATEI",,6,,645,401
17,"Dolj",163,"163-MOTATEI",73335,342,2,1853,1270,1192,78,1247,23,"MOTATEI",,6,,639,608
17,"Dolj",163,"163-MOTATEI",73335,343,2,771,598,513,85,590,8,"MOTATEI",,6,,404,186
17,"Dolj",163,"163-MURGASI",73371,344,2,1004,796,655,141,788,8,"MURGASI",,6,,489,299
17,"Dolj",163,"163-MURGASI",73371,345,2,856,499,427,72,493,6,"MURGASI",,6,,362,131
17,"Dolj",163,"163-MURGASI",73371,346,2,511,384,268,116,382,2,"MURGASI",,6,,183,199
17,"Dolj",163,"163-NEGOI",73460,347,2,976,678,570,108,672,6,"NEGOI",,6,,533,139
17,"Dolj",163,"163-NEGOI",73460,348,2,827,547,419,128,535,12,"NEGOI",,6,,391,144
17,"Dolj",163,"163-NEGOI",73460,349,2,1523,919,787,132,902,17,"NEGOI",,6,,574,328
17,"Dolj",163,"163-ORODEL",73503,350,2,849,656,561,95,647,9,"ORODEL",,6,,388,259
17,"Dolj",163,"163-ORODEL",73503,351,2,743,439,344,95,427,12,"ORODEL",,6,,271,156
17,"Dolj",163,"163-ORODEL",73503,352,2,1040,760,597,163,748,12,"ORODEL",,6,,534,214
17,"Dolj",163,"163-OSTROVENI",73567,353,2,1505,1383,1089,294,1355,28,"OSTROVENI",,6,,1107,248
17,"Dolj",163,"163-OSTROVENI",73567,354,2,1555,1223,930,293,1212,11,"OSTROVENI",,6,,905,307
17,"Dolj",163,"163-OSTROVENI",73567,355,2,650,509,370,139,507,2,"OSTROVENI",,6,,379,128
17,"Dolj",163,"163-OSTROVENI",73567,356,2,1466,908,708,200,892,16,"OSTROVENI",,6,,464,428
17,"Dolj",163,"163-PERISOR",73594,357,2,1334,857,680,177,843,14,"PERISOR",,6,,460,383
17,"Dolj",163,"163-PERISOR",73594,358,2,245,199,131,68,198,1,"PERISOR",,6,,82,116
17,"Dolj",163,"163-PIELESTI",73629,359,2,1200,880,734,146,873,7,"PIELESTI",,6,,438,435
17,"Dolj",163,"163-PIELESTI",73629,360,2,918,654,511,143,645,9,"PIELESTI",,6,,351,294
17,"Dolj",163,"163-PIELESTI",73629,361,2,722,677,579,98,651,26,"PIELESTI",,6,,468,183
17,"Dolj",163,"163-PISCU VECHI",73665,362,2,2092,1430,1225,205,1404,26,"PISCU VECHI",,6,,826,578
17,"Dolj",163,"163-PISCU VECHI",73665,363,2,1843,1177,965,212,1168,9,"PISCU VECHI",,6,,585,583
17,"Dolj",163,"163-PISCU VECHI",73665,364,2,270,221,177,44,217,4,"PISCU VECHI",,6,,183,34
17,"Dolj",163,"163-PLENITA",73709,365,2,2017,1320,1024,296,1309,11,"PLENITA",,6,,589,720
17,"Dolj",163,"163-PLENITA",73709,366,2,1529,898,668,230,884,14,"PLENITA",,6,,412,472
17,"Dolj",163,"163-PLENITA",73709,367,2,792,603,457,146,596,7,"PLENITA",,6,,413,183
17,"Dolj",163,"163-PLENITA",73709,368,2,0,256,0,256,251,5,"PLENITA",,6,,150,101
17,"Dolj",163,"163-POIANA MARE",73736,369,2,2218,1596,1335,261,1596,0,"POIANA MARE",,6,,1131,465
17,"Dolj",163,"163-POIANA MARE",73736,370,2,1162,822,628,194,816,6,"POIANA MARE",,6,,543,273
17,"Dolj",163,"163-POIANA MARE",73736,371,2,1529,891,678,213,887,4,"POIANA MARE",,6,,591,296
17,"Dolj",163,"163-POIANA MARE",73736,372,2,1472,1058,823,235,1052,6,"POIANA MARE",,6,,743,309
17,"Dolj",163,"163-POIANA MARE",73736,373,2,2057,1485,1212,273,1474,11,"POIANA MARE",,6,,1057,417
17,"Dolj",163,"163-POIANA MARE",73736,374,2,1200,938,753,185,930,8,"POIANA MARE",,6,,640,290
17,"Dolj",163,"163-POIANA MARE",73736,375,2,456,411,310,101,409,2,"POIANA MARE",,6,,316,93
17,"Dolj",163,"163-PODARI",70110,376,2,794,559,423,136,551,8,"PODARI",,6,,290,261
17,"Dolj",163,"163-PODARI",70110,377,2,1237,987,837,150,974,13,"PODARI",,6,,538,436
17,"Dolj",163,"163-PODARI",70110,378,2,1621,1162,893,269,1152,10,"PODARI",,6,,555,597
17,"Dolj",163,"163-PODARI",70110,379,2,954,695,520,175,686,9,"PODARI",,6,,436,250
17,"Dolj",163,"163-PREDESTI",73772,380,2,1777,1227,1096,131,1210,17,"PREDESTI",,6,,780,430
17,"Dolj",163,"163-PREDESTI",73772,381,2,1232,747,618,129,737,10,"PREDESTI",,6,,437,300
17,"Dolj",163,"163-RADOVAN",73852,382,2,863,750,576,174,735,15,"RADOVAN",,6,,447,288
17,"Dolj",163,"163-RADOVAN",73852,383,2,1489,1034,840,194,1011,23,"RADOVAN",,6,,600,411
17,"Dolj",163,"163-RADOVAN",73852,384,2,216,303,162,141,296,7,"RADOVAN",,6,,179,117
17,"Dolj",163,"163-RAST",73905,385,2,1506,910,822,88,900,10,"RAST",,6,,481,419
17,"Dolj",163,"163-RAST",73905,386,2,1606,1039,933,106,1019,20,"RAST",,6,,542,477
17,"Dolj",163,"163-ROBANESTI",73923,387,2,947,700,566,134,694,6,"ROBANESTI",,6,,470,224
17,"Dolj",163,"163-ROBANESTI",73923,388,2,1405,829,696,133,815,14,"ROBANESTI",,6,,491,324
17,"Dolj",163,"163-SADOVA",73996,389,2,1232,779,588,191,772,7,"SADOVA",,6,,573,199
17,"Dolj",163,"163-SADOVA",73996,390,2,2291,1684,1401,283,1627,57,"SADOVA",,6,,1160,467
17,"Dolj",163,"163-SADOVA",73996,391,2,1292,1065,810,255,1043,22,"SADOVA",,6,,581,462
17,"Dolj",163,"163-SADOVA",73996,392,2,1105,885,653,232,873,12,"SADOVA",,6,,633,240
17,"Dolj",163,"163-SALCUTA",71509,393,2,1211,733,592,141,725,8,"SALCUTA",,6,,459,266
17,"Dolj",163,"163-SALCUTA",71509,394,2,807,486,473,13,469,17,"SALCUTA",,6,,335,134
17,"Dolj",163,"163-SCAESTI",74073,395,2,1064,759,644,115,752,7,"SCAESTI",,6,,466,286
17,"Dolj",163,"163-SCAESTI",74073,396,2,733,600,527,73,591,9,"SCAESTI",,6,,422,169
17,"Dolj",163,"163-SEACA DE CAMP",74108,397,2,1003,863,741,122,859,4,"SEACA DE CAMP",,6,,559,300
17,"Dolj",163,"163-SEACA DE CAMP",74108,398,2,993,731,587,144,717,14,"SEACA DE CAMP",,6,,509,208
17,"Dolj",163,"163-SEACA DE PADURE",74135,399,2,812,478,399,79,470,8,"SEACA DE PADURE",,6,,362,108
17,"Dolj",163,"163-SEACA DE PADURE",74135,400,2,620,385,328,57,376,9,"SEACA DE PADURE",,6,,289,87
17,"Dolj",163,"163-SECU",74171,401,2,1162,673,576,97,663,10,"SECU",,6,,391,272
17,"Dolj",163,"163-SILISTEA CRUCII",74224,402,2,1593,1176,998,178,1163,13,"SILISTEA CRUCII",,6,,497,666
17,"Dolj",163,"163-SOPOT",74242,403,2,608,461,422,39,454,7,"SOPOT",,6,,358,96
17,"Dolj",163,"163-SOPOT",74242,404,2,142,145,121,24,141,4,"SOPOT",,6,,93,48
17,"Dolj",163,"163-SOPOT",74242,405,2,900,559,498,61,543,16,"SOPOT",,6,,378,165
17,"Dolj",163,"163-SOPOT",74242,406,2,354,306,237,69,301,4,"SOPOT",,6,,216,85
17,"Dolj",163,"163-SIMNICU DE SUS",70174,407,2,1415,893,751,142,881,12,"SIMNICU DE SUS",,6,,420,461
17,"Dolj",163,"163-SIMNICU DE SUS",70174,408,2,1910,1364,1168,196,1345,19,"SIMNICU DE SUS",,6,,791,554
17,"Dolj",163,"163-TEASC",74322,409,2,1534,1169,979,190,1159,10,"TEASC",,6,,678,481
17,"Dolj",163,"163-TEASC",74322,410,2,1090,818,725,93,800,18,"TEASC",,6,,396,404
17,"Dolj",163,"163-TERPEZITA",74359,411,2,347,301,213,88,298,3,"TERPEZITA",,6,,149,149
17,"Dolj",163,"163-TERPEZITA",74359,412,2,1006,714,574,140,705,9,"TERPEZITA",,6,,434,271
17,"Dolj",163,"163-TERPEZITA",74359,413,2,441,342,267,75,338,4,"TERPEZITA",,6,,205,133
17,"Dolj",163,"163-TESLUI",74411,414,2,1205,907,760,147,895,12,"TESLUI",,6,,628,267
17,"Dolj",163,"163-TESLUI",74411,415,2,864,652,574,78,646,6,"TESLUI",,6,,491,155
17,"Dolj",163,"163-TESLUI",74411,416,2,340,317,242,75,312,5,"TESLUI",,6,,180,132
17,"Dolj",163,"163-TUGLUI",74509,417,2,2100,1511,1364,147,1495,16,"TUGLUI",,6,,862,633
17,"Dolj",163,"163-TUGLUI",74509,418,2,201,205,155,50,204,1,"TUGLUI",,6,,166,38
17,"Dolj",163,"163-UNIREA",74536,419,2,1652,1116,927,189,1097,19,"UNIREA",,6,,540,557
17,"Dolj",163,"163-UNIREA",74536,420,2,1425,983,824,159,976,7,"UNIREA",,6,,482,494
17,"Dolj",163,"163-URZICUTA",74554,421,2,2010,1287,1097,190,1276,11,"URZICUTA",,6,,849,427
17,"Dolj",163,"163-URZICUTA",74554,422,2,514,454,378,76,440,14,"URZICUTA",,6,,285,155
17,"Dolj",163,"163-VALEA STANCIULUI",74581,423,2,774,552,448,104,545,7,"VALEA STANCIULUI",,6,,337,208
17,"Dolj",163,"163-VALEA STANCIULUI",74581,424,2,825,491,383,108,486,5,"VALEA STANCIULUI",,6,,327,159
17,"Dolj",163,"163-VALEA STANCIULUI",74581,425,2,1599,1000,814,186,994,6,"VALEA STANCIULUI",,6,,611,383
17,"Dolj",163,"163-VALEA STANCIULUI",74581,426,2,1540,928,796,132,923,5,"VALEA STANCIULUI",,6,,657,266
17,"Dolj",163,"163-VALEA STANCIULUI",74581,427,2,827,591,462,129,587,4,"VALEA STANCIULUI",,6,,420,167
17,"Dolj",163,"163-VELA",74616,428,2,704,428,361,67,419,9,"VELA",,6,,296,123
17,"Dolj",163,"163-VELA",74616,429,2,611,412,330,82,403,9,"VELA",,6,,264,139
17,"Dolj",163,"163-VELA",74616,430,2,601,374,287,87,368,6,"VELA",,6,,145,223
17,"Dolj",163,"163-VERBITA",74705,431,2,1382,864,762,102,854,10,"VERBITA",,6,,564,290
17,"Dolj",163,"163-VARTOP",74732,432,2,1587,1132,1026,106,1124,8,"VARTOP",,6,,763,361
17,"Dolj",163,"163-VARVORU DE JOS",74750,433,2,826,548,399,149,544,4,"VARVORU DE JOS",,6,,389,155
17,"Dolj",163,"163-VARVORU DE JOS",74750,434,2,771,587,504,83,576,11,"VARVORU DE JOS",,6,,365,211
17,"Dolj",163,"163-VARVORU DE JOS",74750,435,2,1254,765,598,167,745,20,"VARVORU DE JOS",,6,,583,162
18,"Galați",172,"172-MUNICIPIUL GALATI",75098,1,2,1581,1320,1205,115,1317,3,"MUNICIPIUL GALATI",,4,,609,708
18,"Galați",172,"172-MUNICIPIUL GALATI",75098,2,2,1427,1265,1135,130,1260,5,"MUNICIPIUL GALATI",,4,,566,694
18,"Galați",172,"172-MUNICIPIUL GALATI",75098,3,2,1550,1260,1199,61,1259,1,"MUNICIPIUL GALATI",,4,,465,794
18,"Galați",172,"172-MUNICIPIUL GALATI",75098,4,2,1382,1118,1016,102,1117,1,"MUNICIPIUL GALATI",,4,,425,692
18,"Galați",172,"172-MUNICIPIUL GALATI",75098,5,2,1667,1354,1264,90,1351,2,"MUNICIPIUL GALATI",,4,,523,828
18,"Galați",172,"172-MUNICIPIUL GALATI",75098,6,2,1506,1251,1142,109,1240,11,"MUNICIPIUL GALATI",,4,,506,734
18,"Galați",172,"172-MUNICIPIUL GALATI",75098,7,2,1891,1576,1431,145,1572,4,"MUNICIPIUL GALATI",,4,,533,1039
18,"Galați",172,"172-MUNICIPIUL GALATI",75098,8,2,1750,1415,1360,55,1410,5,"MUNICIPIUL GALATI",,4,,454,956
18,"Galați",172,"172-MUNICIPIUL GALATI",75098,9,2,1905,1505,1462,43,1502,3,"MUNICIPIUL GALATI",,4,,536,966
18,"Galați",172,"172-MUNICIPIUL GALATI",75098,10,2,1993,1512,1436,76,1504,8,"MUNICIPIUL GALATI",,4,,540,964
18,"Galați",172,"172-MUNICIPIUL GALATI",75098,11,2,1499,1190,1105,85,1182,8,"MUNICIPIUL GALATI",,4,,518,664
18,"Galați",172,"172-MUNICIPIUL GALATI",75098,12,2,1303,1026,966,60,1021,5,"MUNICIPIUL GALATI",,4,,391,630
18,"Galați",172,"172-MUNICIPIUL GALATI",75098,13,2,1823,1020,910,110,1014,6,"MUNICIPIUL GALATI",,4,,409,605
18,"Galați",172,"172-MUNICIPIUL GALATI",75098,14,2,1299,1020,938,82,1016,4,"MUNICIPIUL GALATI",,4,,385,631
18,"Galați",172,"172-MUNICIPIUL GALATI",75098,15,2,1332,1018,944,74,1016,2,"MUNICIPIUL GALATI",,4,,436,580
18,"Galați",172,"172-MUNICIPIUL GALATI",75098,16,2,1377,994,935,59,991,3,"MUNICIPIUL GALATI",,4,,386,605
18,"Galați",172,"172-MUNICIPIUL GALATI",75098,17,2,1463,1200,1120,80,1199,1,"MUNICIPIUL GALATI",,4,,419,780
18,"Galați",172,"172-MUNICIPIUL GALATI",75098,18,2,1637,1279,1188,91,1274,5,"MUNICIPIUL GALATI",,4,,524,750
18,"Galați",172,"172-MUNICIPIUL GALATI",75098,19,2,1761,1323,1267,56,1321,2,"MUNICIPIUL GALATI",,4,,530,791
18,"Galați",172,"172-MUNICIPIUL GALATI",75098,20,2,1508,1087,1015,72,1082,5,"MUNICIPIUL GALATI",,4,,478,604
18,"Galați",172,"172-MUNICIPIUL GALATI",75098,21,2,1748,1565,1196,369,1554,11,"MUNICIPIUL GALATI",,4,,650,904
18,"Galați",172,"172-MUNICIPIUL GALATI",75098,22,2,1733,1157,1041,116,1153,4,"MUNICIPIUL GALATI",,4,,529,624
18,"Galați",172,"172-MUNICIPIUL GALATI",75098,23,2,1531,1096,980,116,1090,6,"MUNICIPIUL GALATI",,4,,476,614
18,"Galați",172,"172-MUNICIPIUL GALATI",75098,24,2,1991,1487,1370,117,1479,8,"MUNICIPIUL GALATI",,4,,627,852
18,"Galați",172,"172-MUNICIPIUL GALATI",75098,25,2,2056,1607,1491,116,1599,8,"MUNICIPIUL GALATI",,4,,678,921
18,"Galați",172,"172-MUNICIPIUL GALATI",75098,26,2,1707,1254,1188,66,1241,12,"MUNICIPIUL GALATI",,4,,546,695
18,"Galați",172,"172-MUNICIPIUL GALATI",75098,27,2,1499,1142,1005,137,1135,7,"MUNICIPIUL GALATI",,4,,432,703
18,"Galați",172,"172-MUNICIPIUL GALATI",75098,28,2,1372,1074,973,101,1067,7,"MUNICIPIUL GALATI",,4,,461,606
18,"Galați",172,"172-MUNICIPIUL GALATI",75098,29,2,2185,1647,1541,106,1632,15,"MUNICIPIUL GALATI",,4,,657,975
18,"Galați",172,"172-MUNICIPIUL GALATI",75098,30,2,1873,1383,1323,60,1376,7,"MUNICIPIUL GALATI",,4,,594,782
18,"Galați",172,"172-MUNICIPIUL GALATI",75098,31,2,1593,1342,1162,180,1330,12,"MUNICIPIUL GALATI",,4,,586,744
18,"Galați",172,"172-MUNICIPIUL GALATI",75098,32,2,1582,1248,1114,134,1243,5,"MUNICIPIUL GALATI",,4,,524,719
18,"Galați",172,"172-MUNICIPIUL GALATI",75098,33,2,1804,1384,1226,158,1378,6,"MUNICIPIUL GALATI",,4,,581,797
18,"Galați",172,"172-MUNICIPIUL GALATI",75098,34,2,283,282,190,92,280,2,"MUNICIPIUL GALATI",,4,,109,171
18,"Galați",172,"172-MUNICIPIUL GALATI",75098,35,2,2421,1946,1736,210,1940,6,"MUNICIPIUL GALATI",,4,,856,1084
18,"Galați",172,"172-MUNICIPIUL GALATI",75098,36,2,2233,1721,1596,125,1717,4,"MUNICIPIUL GALATI",,4,,705,1012
18,"Galați",172,"172-MUNICIPIUL GALATI",75098,37,2,2126,1675,1545,130,1667,8,"MUNICIPIUL GALATI",,4,,620,1047
18,"Galați",172,"172-MUNICIPIUL GALATI",75098,38,2,2093,1630,1550,80,1629,1,"MUNICIPIUL GALATI",,4,,668,961
18,"Galați",172,"172-MUNICIPIUL GALATI",75098,39,2,1666,1322,1205,117,1312,10,"MUNICIPIUL GALATI",,4,,520,792
18,"Galați",172,"172-MUNICIPIUL GALATI",75098,40,2,1666,1316,1245,71,1311,5,"MUNICIPIUL GALATI",,4,,558,753
18,"Galați",172,"172-MUNICIPIUL GALATI",75098,41,2,1752,1371,1299,72,1366,5,"MUNICIPIUL GALATI",,4,,569,797
18,"Galați",172,"172-MUNICIPIUL GALATI",75098,42,2,1581,1233,1166,67,1226,7,"MUNICIPIUL GALATI",,4,,421,805
18,"Galați",172,"172-MUNICIPIUL GALATI",75098,43,2,1924,1617,1365,252,1608,9,"MUNICIPIUL GALATI",,4,,794,814
18,"Galați",172,"172-MUNICIPIUL GALATI",75098,44,2,1685,1361,1243,118,1350,11,"MUNICIPIUL GALATI",,4,,500,850
18,"Galați",172,"172-MUNICIPIUL GALATI",75098,45,2,1656,1225,1115,110,1217,8,"MUNICIPIUL GALATI",,4,,508,709
18,"Galați",172,"172-MUNICIPIUL GALATI",75098,46,2,1499,1161,1101,60,1158,3,"MUNICIPIUL GALATI",,4,,544,614
18,"Galați",172,"172-MUNICIPIUL GALATI",75098,47,2,2005,1549,1472,77,1542,7,"MUNICIPIUL GALATI",,4,,639,903
18,"Galați",172,"172-MUNICIPIUL GALATI",75098,48,2,2106,1410,1345,65,1404,6,"MUNICIPIUL GALATI",,4,,552,852
18,"Galați",172,"172-MUNICIPIUL GALATI",75098,49,2,1564,1219,1155,64,1216,3,"MUNICIPIUL GALATI",,4,,456,760
18,"Galați",172,"172-MUNICIPIUL GALATI",75098,50,2,1708,1280,1178,102,1271,9,"MUNICIPIUL GALATI",,4,,522,749
18,"Galați",172,"172-MUNICIPIUL GALATI",75098,51,2,1832,1314,1201,113,1309,5,"MUNICIPIUL GALATI",,4,,594,715
18,"Galați",172,"172-MUNICIPIUL GALATI",75098,52,2,1535,1460,1051,409,1454,6,"MUNICIPIUL GALATI",,4,,536,918
18,"Galați",172,"172-MUNICIPIUL GALATI",75098,53,2,1687,1271,1110,161,1265,6,"MUNICIPIUL GALATI",,4,,489,776
18,"Galați",172,"172-MUNICIPIUL GALATI",75098,54,2,1954,1517,1384,133,1514,3,"MUNICIPIUL GALATI",,4,,599,915
18,"Galați",172,"172-MUNICIPIUL GALATI",75098,55,2,1995,1461,1296,165,1454,7,"MUNICIPIUL GALATI",,4,,614,840
18,"Galați",172,"172-MUNICIPIUL GALATI",75098,56,2,2200,1571,1401,170,1568,3,"MUNICIPIUL GALATI",,4,,540,1028
18,"Galați",172,"172-MUNICIPIUL GALATI",75098,57,2,1794,1381,1262,119,1376,5,"MUNICIPIUL GALATI",,4,,529,847
18,"Galați",172,"172-MUNICIPIUL GALATI",75098,58,2,1795,1353,1273,80,1343,8,"MUNICIPIUL GALATI",,4,,558,785
18,"Galați",172,"172-MUNICIPIUL GALATI",75098,59,2,1919,1436,1362,74,1426,10,"MUNICIPIUL GALATI",,4,,625,801
18,"Galați",172,"172-MUNICIPIUL GALATI",75098,60,2,2042,1550,1420,130,1544,6,"MUNICIPIUL GALATI",,4,,663,881
18,"Galați",172,"172-MUNICIPIUL GALATI",75098,61,2,1990,1535,1428,107,1529,6,"MUNICIPIUL GALATI",,4,,651,878
18,"Galați",172,"172-MUNICIPIUL GALATI",75098,62,2,1834,1360,1241,119,1352,8,"MUNICIPIUL GALATI",,4,,542,810
18,"Galați",172,"172-MUNICIPIUL GALATI",75098,63,2,1855,1333,1282,51,1325,8,"MUNICIPIUL GALATI",,4,,537,788
18,"Galați",172,"172-MUNICIPIUL GALATI",75098,64,2,1649,1294,1179,115,1290,4,"MUNICIPIUL GALATI",,4,,533,757
18,"Galați",172,"172-MUNICIPIUL GALATI",75098,65,2,1697,1317,1209,108,1314,3,"MUNICIPIUL GALATI",,4,,544,770
18,"Galați",172,"172-MUNICIPIUL GALATI",75098,66,2,1572,1248,1124,124,1244,4,"MUNICIPIUL GALATI",,4,,478,766
18,"Galați",172,"172-MUNICIPIUL GALATI",75098,67,2,1843,1352,1216,136,1342,10,"MUNICIPIUL GALATI",,4,,596,746
18,"Galați",172,"172-MUNICIPIUL GALATI",75098,68,2,2467,1888,1744,144,1874,12,"MUNICIPIUL GALATI",,4,,737,1137
18,"Galați",172,"172-MUNICIPIUL GALATI",75098,69,2,1575,1195,1107,88,1191,4,"MUNICIPIUL GALATI",,4,,479,712
18,"Galați",172,"172-MUNICIPIUL GALATI",75098,70,2,1681,1317,1192,125,1311,6,"MUNICIPIUL GALATI",,4,,469,842
18,"Galați",172,"172-MUNICIPIUL GALATI",75098,71,2,1581,1189,1115,74,1182,7,"MUNICIPIUL GALATI",,4,,462,720
18,"Galați",172,"172-MUNICIPIUL GALATI",75098,72,2,1895,1517,1437,80,1514,3,"MUNICIPIUL GALATI",,4,,534,980
18,"Galați",172,"172-MUNICIPIUL GALATI",75098,73,2,1536,1143,1089,54,1137,6,"MUNICIPIUL GALATI",,4,,475,662
18,"Galați",172,"172-MUNICIPIUL GALATI",75098,74,2,1893,1428,1286,142,1425,3,"MUNICIPIUL GALATI",,4,,574,851
18,"Galați",172,"172-MUNICIPIUL GALATI",75098,75,2,629,1428,388,1040,1421,7,"MUNICIPIUL GALATI",,4,,617,804
18,"Galați",172,"172-MUNICIPIUL GALATI",75098,76,2,1984,1556,1448,108,1548,8,"MUNICIPIUL GALATI",,4,,630,918
18,"Galați",172,"172-MUNICIPIUL GALATI",75098,77,2,1557,1171,1058,113,1167,4,"MUNICIPIUL GALATI",,4,,529,638
18,"Galați",172,"172-MUNICIPIUL GALATI",75098,78,2,2221,1710,1612,98,1695,8,"MUNICIPIUL GALATI",,4,,742,953
18,"Galați",172,"172-MUNICIPIUL GALATI",75098,79,2,1598,1213,1079,134,1205,8,"MUNICIPIUL GALATI",,4,,548,657
18,"Galați",172,"172-MUNICIPIUL GALATI",75098,80,2,1468,1229,1119,110,1216,13,"MUNICIPIUL GALATI",,4,,499,717
18,"Galați",172,"172-MUNICIPIUL GALATI",75098,81,2,1718,1212,1145,67,1206,6,"MUNICIPIUL GALATI",,4,,579,627
18,"Galați",172,"172-MUNICIPIUL GALATI",75098,82,2,1493,1099,1026,73,1092,7,"MUNICIPIUL GALATI",,4,,480,612
18,"Galați",172,"172-MUNICIPIUL GALATI",75098,83,2,242,245,137,108,241,4,"MUNICIPIUL GALATI",,4,,127,114
18,"Galați",172,"172-MUNICIPIUL GALATI",75098,84,2,1672,1243,1084,159,1234,9,"MUNICIPIUL GALATI",,4,,521,713
18,"Galați",172,"172-MUNICIPIUL GALATI",75098,85,2,1836,1305,1236,69,1294,11,"MUNICIPIUL GALATI",,4,,584,710
18,"Galați",172,"172-MUNICIPIUL GALATI",75098,86,2,1664,1304,1205,99,1296,8,"MUNICIPIUL GALATI",,4,,581,715
18,"Galați",172,"172-MUNICIPIUL GALATI",75098,87,2,1833,1336,1241,95,1327,9,"MUNICIPIUL GALATI",,4,,578,749
18,"Galați",172,"172-MUNICIPIUL GALATI",75098,88,2,1828,1378,1293,85,1377,1,"MUNICIPIUL GALATI",,4,,618,759
18,"Galați",172,"172-MUNICIPIUL GALATI",75098,89,2,1642,1433,1114,319,1423,10,"MUNICIPIUL GALATI",,4,,622,801
18,"Galați",172,"172-MUNICIPIUL GALATI",75098,90,2,2201,1919,1511,408,1902,17,"MUNICIPIUL GALATI",,4,,884,1018
18,"Galați",172,"172-MUNICIPIUL GALATI",75098,91,2,2054,1549,1453,96,1540,9,"MUNICIPIUL GALATI",,4,,656,884
18,"Galați",172,"172-MUNICIPIUL GALATI",75098,92,2,1783,1347,1233,114,1344,3,"MUNICIPIUL GALATI",,4,,591,753
18,"Galați",172,"172-MUNICIPIUL GALATI",75098,93,2,1554,1289,1061,228,1282,7,"MUNICIPIUL GALATI",,4,,478,804
18,"Galați",172,"172-MUNICIPIUL GALATI",75098,94,2,1810,1293,1168,125,1282,11,"MUNICIPIUL GALATI",,4,,528,754
18,"Galați",172,"172-MUNICIPIUL GALATI",75098,95,2,1907,1352,1170,182,1346,6,"MUNICIPIUL GALATI",,4,,512,834
18,"Galați",172,"172-MUNICIPIUL GALATI",75098,96,2,2117,2176,1359,817,2159,17,"MUNICIPIUL GALATI",,4,,963,1196
18,"Galați",172,"172-MUNICIPIUL GALATI",75098,97,2,1864,1660,1043,617,1638,22,"MUNICIPIUL GALATI",,4,,658,980
18,"Galați",172,"172-MUNICIPIUL GALATI",75098,98,2,2083,1505,1401,104,1494,11,"MUNICIPIUL GALATI",,4,,626,868
18,"Galați",172,"172-MUNICIPIUL GALATI",75098,99,2,2015,1467,1378,89,1457,10,"MUNICIPIUL GALATI",,4,,558,899
18,"Galați",172,"172-MUNICIPIUL GALATI",75098,100,2,2261,1701,140,1561,1694,7,"MUNICIPIUL GALATI",,4,,699,995
18,"Galați",172,"172-MUNICIPIUL GALATI",75098,101,2,1830,1506,1337,169,1500,6,"MUNICIPIUL GALATI",,4,,601,899
18,"Galați",172,"172-MUNICIPIUL GALATI",75098,102,2,1927,1499,1368,131,1492,6,"MUNICIPIUL GALATI",,4,,575,917
18,"Galați",172,"172-MUNICIPIUL GALATI",75098,103,2,1914,1433,1324,109,1425,8,"MUNICIPIUL GALATI",,4,,545,880
18,"Galați",172,"172-MUNICIPIUL GALATI",75098,104,2,1990,1542,1424,118,1533,9,"MUNICIPIUL GALATI",,4,,617,916
18,"Galați",172,"172-MUNICIPIUL GALATI",75098,105,2,2279,1635,1548,87,1628,7,"MUNICIPIUL GALATI",,4,,623,1005
18,"Galați",172,"172-MUNICIPIUL GALATI",75098,106,2,2271,1599,1490,109,1596,3,"MUNICIPIUL GALATI",,4,,626,970
18,"Galați",172,"172-MUNICIPIUL GALATI",75098,107,2,1874,1425,1249,176,1422,3,"MUNICIPIUL GALATI",,4,,503,919
18,"Galați",172,"172-MUNICIPIUL GALATI",75098,108,2,2088,1642,1487,155,1632,9,"MUNICIPIUL GALATI",,4,,576,1056
18,"Galați",172,"172-MUNICIPIUL GALATI",75098,109,2,1367,1097,1014,83,1095,2,"MUNICIPIUL GALATI",,4,,436,659
18,"Galați",172,"172-MUNICIPIUL GALATI",75098,110,2,1727,1387,1245,142,1384,3,"MUNICIPIUL GALATI",,4,,572,812
18,"Galați",172,"172-MUNICIPIUL GALATI",75098,111,2,2222,1511,1418,93,1502,9,"MUNICIPIUL GALATI",,4,,676,826
18,"Galați",172,"172-MUNICIPIUL GALATI",75098,112,2,1719,1287,1218,69,1286,1,"MUNICIPIUL GALATI",,4,,523,763
18,"Galați",172,"172-MUNICIPIUL GALATI",75098,113,2,1865,1479,1359,120,1475,4,"MUNICIPIUL GALATI",,4,,546,929
18,"Galați",172,"172-MUNICIPIUL GALATI",75098,114,2,2124,1474,1379,95,1469,5,"MUNICIPIUL GALATI",,4,,565,904
18,"Galați",172,"172-MUNICIPIUL GALATI",75098,115,2,1835,1406,1325,81,1400,5,"MUNICIPIUL GALATI",,4,,592,808
18,"Galați",172,"172-MUNICIPIUL GALATI",75098,116,2,1424,1144,1037,107,1142,2,"MUNICIPIUL GALATI",,4,,409,733
18,"Galați",172,"172-MUNICIPIUL GALATI",75098,117,2,1439,1175,1027,148,1173,2,"MUNICIPIUL GALATI",,4,,385,788
18,"Galați",172,"172-MUNICIPIUL GALATI",75098,118,2,1682,1260,1076,184,1255,5,"MUNICIPIUL GALATI",,4,,513,742
18,"Galați",172,"172-MUNICIPIUL GALATI",75098,119,2,1572,1190,1082,108,1178,12,"MUNICIPIUL GALATI",,4,,415,763
18,"Galați",172,"172-MUNICIPIUL GALATI",75098,120,2,1103,892,722,170,888,4,"MUNICIPIUL GALATI",,4,,308,580
18,"Galați",172,"172-MUNICIPIUL GALATI",75098,121,2,1580,1218,1091,127,1210,8,"MUNICIPIUL GALATI",,4,,456,754
18,"Galați",172,"172-MUNICIPIUL GALATI",75098,122,2,2211,1730,1538,192,1728,2,"MUNICIPIUL GALATI",,4,,654,1074
18,"Galați",172,"172-MUNICIPIUL GALATI",75098,123,2,2683,1798,1551,247,1772,26,"MUNICIPIUL GALATI",,4,,672,1100
18,"Galați",172,"172-MUNICIPIUL GALATI",75098,124,2,1393,1094,968,126,1090,4,"MUNICIPIUL GALATI",,4,,413,677
18,"Galați",172,"172-MUNICIPIUL GALATI",75098,125,2,1442,1130,1024,106,1123,7,"MUNICIPIUL GALATI",,4,,384,739
18,"Galați",172,"172-MUNICIPIUL GALATI",75098,126,2,2300,1828,1581,247,1817,11,"MUNICIPIUL GALATI",,4,,696,1121
18,"Galați",172,"172-MUNICIPIUL GALATI",75098,127,2,1695,1237,938,299,1228,9,"MUNICIPIUL GALATI",,4,,471,757
18,"Galați",172,"172-MUNICIPIUL GALATI",75098,128,2,2233,1763,1563,200,1752,11,"MUNICIPIUL GALATI",,4,,640,1112
18,"Galați",172,"172-MUNICIPIUL GALATI",75098,129,2,1376,1012,893,119,1001,11,"MUNICIPIUL GALATI",,4,,402,599
18,"Galați",172,"172-MUNICIPIUL GALATI",75098,130,2,1372,1043,880,163,1038,5,"MUNICIPIUL GALATI",,4,,343,695
18,"Galați",172,"172-MUNICIPIUL GALATI",75098,131,2,1943,1873,1317,556,1857,16,"MUNICIPIUL GALATI",,4,,624,1233
18,"Galați",172,"172-MUNICIPIUL GALATI",75098,132,2,1285,1770,928,842,1761,9,"MUNICIPIUL GALATI",,4,,642,1119
18,"Galați",172,"172-MUNICIPIUL GALATI",75098,133,2,1869,1712,1269,443,1701,11,"MUNICIPIUL GALATI",,4,,747,954
18,"Galați",172,"172-MUNICIPIUL GALATI",75098,134,2,1538,1131,1010,121,1118,13,"MUNICIPIUL GALATI",,4,,444,674
18,"Galați",172,"172-MUNICIPIUL GALATI",75098,135,2,2028,1645,1526,119,1640,5,"MUNICIPIUL GALATI",,4,,588,1052
18,"Galați",172,"172-MUNICIPIUL GALATI",75098,136,2,1405,1493,676,817,1488,5,"MUNICIPIUL GALATI",,4,,487,1001
18,"Galați",172,"172-MUNICIPIUL GALATI",75098,137,2,1941,1529,1305,224,1520,9,"MUNICIPIUL GALATI",,4,,482,1038
18,"Galați",172,"172-MUNICIPIUL GALATI",75098,138,2,0,1001,0,1001,1001,0,"MUNICIPIUL GALATI",,4,,443,558
18,"Galați",172,"172-MUNICIPIUL GALATI",75098,139,2,0,283,0,283,276,7,"MUNICIPIUL GALATI",,4,,119,157
18,"Galați",172,"172-MUNICIPIUL GALATI",75098,140,2,0,194,0,194,192,2,"MUNICIPIUL GALATI",,4,,69,123
18,"Galați",172,"172-MUNICIPIUL GALATI",75098,141,2,0,110,0,110,107,3,"MUNICIPIUL GALATI",,4,,32,75
18,"Galați",172,"172-MUNICIPIUL GALATI",75098,142,2,0,141,0,141,140,1,"MUNICIPIUL GALATI",,4,,61,79
18,"Galați",172,"172-MUNICIPIUL GALATI",75098,143,2,868,816,745,71,812,4,"MUNICIPIUL GALATI",,4,,291,521
18,"Galați",172,"172-MUNICIPIUL GALATI",75098,144,2,454,465,427,38,459,6,"MUNICIPIUL GALATI",,4,,166,293
18,"Galați",172,"172-MUNICIPIUL GALATI",75098,145,2,0,1226,0,1226,1223,3,"MUNICIPIUL GALATI",,4,,422,801
18,"Galați",172,"172-MUNICIPIUL TECUCI",75203,146,2,1846,1254,1143,111,1245,9,"MUNICIPIUL TECUCI",,4,,654,591
18,"Galați",172,"172-MUNICIPIUL TECUCI",75203,147,2,1524,1011,924,87,998,13,"MUNICIPIUL TECUCI",,4,,501,497
18,"Galați",172,"172-MUNICIPIUL TECUCI",75203,148,2,1659,1286,1111,175,1267,19,"MUNICIPIUL TECUCI",,4,,707,560
18,"Galați",172,"172-MUNICIPIUL TECUCI",75203,149,2,1950,1370,1256,114,1357,13,"MUNICIPIUL TECUCI",,4,,749,608
18,"Galați",172,"172-MUNICIPIUL TECUCI",75203,150,2,1249,923,800,123,910,13,"MUNICIPIUL TECUCI",,4,,455,455
18,"Galați",172,"172-MUNICIPIUL TECUCI",75203,151,2,2046,1636,1299,337,1622,14,"MUNICIPIUL TECUCI",,4,,866,756
18,"Galați",172,"172-MUNICIPIUL TECUCI",75203,152,2,2261,1535,1367,168,1528,7,"MUNICIPIUL TECUCI",,4,,775,753
18,"Galați",172,"172-MUNICIPIUL TECUCI",75203,153,2,1586,1077,925,152,1072,5,"MUNICIPIUL TECUCI",,4,,582,490
18,"Galați",172,"172-MUNICIPIUL TECUCI",75203,154,2,1218,923,788,135,918,5,"MUNICIPIUL TECUCI",,4,,490,428
18,"Galați",172,"172-MUNICIPIUL TECUCI",75203,155,2,1963,1504,1251,253,1490,14,"MUNICIPIUL TECUCI",,4,,773,717
18,"Galați",172,"172-MUNICIPIUL TECUCI",75203,156,2,1845,1342,1171,171,1339,3,"MUNICIPIUL TECUCI",,4,,601,738
18,"Galați",172,"172-MUNICIPIUL TECUCI",75203,157,2,1761,1303,1183,120,1295,7,"MUNICIPIUL TECUCI",,4,,686,609
18,"Galați",172,"172-MUNICIPIUL TECUCI",75203,158,2,2087,1489,1323,166,1475,14,"MUNICIPIUL TECUCI",,4,,836,639
18,"Galați",172,"172-MUNICIPIUL TECUCI",75203,159,2,1313,961,861,100,939,22,"MUNICIPIUL TECUCI",,4,,526,413
18,"Galați",172,"172-MUNICIPIUL TECUCI",75203,160,2,1286,940,839,101,931,9,"MUNICIPIUL TECUCI",,4,,519,412
18,"Galați",172,"172-MUNICIPIUL TECUCI",75203,161,2,2478,1784,1622,162,1776,8,"MUNICIPIUL TECUCI",,4,,880,896
18,"Galați",172,"172-MUNICIPIUL TECUCI",75203,162,2,2153,1604,1364,240,1598,6,"MUNICIPIUL TECUCI",,4,,791,807
18,"Galați",172,"172-MUNICIPIUL TECUCI",75203,163,2,2170,1468,1295,173,1460,8,"MUNICIPIUL TECUCI",,4,,727,733
18,"Galați",172,"172-MUNICIPIUL TECUCI",75203,164,2,2330,1549,1312,237,1544,5,"MUNICIPIUL TECUCI",,4,,829,715
18,"Galați",172,"172-MUNICIPIUL TECUCI",75203,165,2,838,690,633,57,670,20,"MUNICIPIUL TECUCI",,4,,324,346
18,"Galați",172,"172-MUNICIPIUL TECUCI",75203,166,2,0,818,0,818,807,11,"MUNICIPIUL TECUCI",,4,,495,312
18,"Galați",172,"172-MUNICIPIUL TECUCI",75203,167,2,0,115,0,115,115,0,"MUNICIPIUL TECUCI",,4,,75,40
18,"Galați",172,"172-ORAS BERESTI",75338,168,2,1273,784,698,86,783,1,"ORAS BERESTI",,4,,467,316
18,"Galați",172,"172-ORAS BERESTI",75338,169,2,1764,1223,1072,151,1204,19,"ORAS BERESTI",,4,,800,404
18,"Galați",172,"172-ORAS TARGU BUJOR",75472,170,2,1400,956,846,110,940,16,"ORAS TARGU BUJOR",,4,,515,425
18,"Galați",172,"172-ORAS TARGU BUJOR",75472,171,2,2363,1560,1428,132,1552,8,"ORAS TARGU BUJOR",,4,,727,825
18,"Galați",172,"172-ORAS TARGU BUJOR",75472,172,2,1080,764,666,98,748,16,"ORAS TARGU BUJOR",,4,,445,303
18,"Galați",172,"172-ORAS TARGU BUJOR",75472,173,2,974,635,586,49,616,19,"ORAS TARGU BUJOR",,4,,314,302
18,"Galați",172,"172-BARCEA",75515,174,2,1967,1328,1155,173,1317,11,"BARCEA",,4,,696,621
18,"Galați",172,"172-BARCEA",75515,175,2,2253,1369,1197,172,1365,4,"BARCEA",,4,,701,664
18,"Galați",172,"172-BALABANESTI",75542,176,2,939,463,377,86,459,4,"BALABANESTI",,4,,326,133
18,"Galați",172,"172-BALABANESTI",75542,177,2,380,363,210,153,359,4,"BALABANESTI",,4,,235,124
18,"Galați",172,"172-BALABANESTI",75542,178,2,153,132,71,61,130,2,"BALABANESTI",,4,,104,26
18,"Galați",172,"172-BALABANESTI",75542,179,2,402,332,218,114,329,3,"BALABANESTI",,4,,233,96
18,"Galați",172,"172-BALABANESTI",75542,180,2,1437,651,557,94,641,10,"BALABANESTI",,4,,453,188
18,"Galați",172,"172-BALASESTI",75613,181,2,1235,701,609,92,691,10,"BALASESTI",,4,,433,258
18,"Galați",172,"172-BALASESTI",75613,182,2,492,338,282,56,335,3,"BALASESTI",,4,,261,74
18,"Galați",172,"172-BALASESTI",75613,183,2,426,292,229,63,281,11,"BALASESTI",,4,,201,80
18,"Galați",172,"172-BALENI",75668,184,2,2353,1331,1201,130,1310,21,"BALENI",,4,,883,427
18,"Galați",172,"172-BANEASA",75686,185,2,1193,795,692,103,784,11,"BANEASA",,4,,392,392
18,"Galați",172,"172-BANEASA",75686,186,2,546,383,312,71,379,4,"BANEASA",,4,,171,208
18,"Galați",172,"172-BERESTI-MERIA",75356,187,2,535,370,297,73,367,3,"BERESTI-MERIA",,4,,226,141
18,"Galați",172,"172-BERESTI-MERIA",75356,188,2,618,448,395,53,439,9,"BERESTI-MERIA",,4,,299,140
18,"Galați",172,"172-BERESTI-MERIA",75356,189,2,510,300,228,72,289,11,"BERESTI-MERIA",,4,,191,98
18,"Galați",172,"172-BERESTI-MERIA",75356,190,2,652,425,352,73,416,9,"BERESTI-MERIA",,4,,277,139
18,"Galați",172,"172-BERESTI-MERIA",75356,191,2,891,630,518,112,623,7,"BERESTI-MERIA",,4,,376,247
18,"Galați",172,"172-BERESTI-MERIA",75356,192,2,535,275,243,32,274,1,"BERESTI-MERIA",,4,,193,81
18,"Galați",172,"172-BRANISTEA",75711,193,2,2099,1492,1281,211,1471,21,"BRANISTEA",,4,,829,642
18,"Galați",172,"172-BRANISTEA",75711,194,2,617,518,436,82,512,6,"BRANISTEA",,4,,268,244
18,"Galați",172,"172-BRAHASESTI",75766,195,2,1770,1625,1307,318,1615,10,"BRAHASESTI",,4,,1132,483
18,"Galați",172,"172-BRAHASESTI",75766,196,2,3042,1805,1650,155,1772,33,"BRAHASESTI",,4,,1471,301
18,"Galați",172,"172-BUCIUMENI",75819,197,2,1055,767,633,134,751,16,"BUCIUMENI",,4,,399,352
18,"Galați",172,"172-BUCIUMENI",75819,198,2,730,503,366,137,488,15,"BUCIUMENI",,4,,259,229
18,"Galați",172,"172-CAVADINESTI",75864,199,2,1383,830,731,99,818,12,"CAVADINESTI",,4,,480,338
18,"Galați",172,"172-CAVADINESTI",75864,200,2,1002,562,460,102,546,16,"CAVADINESTI",,4,,299,247
18,"Galați",172,"172-CAVADINESTI",75864,201,2,545,409,339,70,402,7,"CAVADINESTI",,4,,287,115
18,"Galați",172,"172-CERTESTI",75917,202,2,744,500,405,95,490,10,"CERTESTI",,4,,341,149
18,"Galați",172,"172-CERTESTI",75917,203,2,584,396,325,71,395,1,"CERTESTI",,4,,226,169
18,"Galați",172,"172-CERTESTI",75917,204,2,689,550,472,78,543,7,"CERTESTI",,4,,282,261
18,"Galați",172,"172-CORNI",76004,205,2,736,554,474,80,550,4,"CORNI",,4,,394,156
18,"Galați",172,"172-CORNI",76004,206,2,688,562,468,94,559,3,"CORNI",,4,,308,251
18,"Galați",172,"172-CORNI",76004,207,2,417,329,282,47,326,3,"CORNI",,4,,240,86
18,"Galați",172,"172-COROD",75953,208,2,2327,1302,1187,115,1286,16,"COROD",,4,,711,575
18,"Galați",172,"172-COROD",75953,209,2,2045,1102,923,179,1089,13,"COROD",,4,,653,436
18,"Galați",172,"172-COROD",75953,210,2,1344,728,649,79,715,13,"COROD",,4,,469,246
18,"Galați",172,"172-COROD",75953,211,2,554,338,239,99,332,6,"COROD",,4,,234,98
18,"Galați",172,"172-COSMESTI",76040,212,2,1797,1296,1042,254,1291,5,"COSMESTI",,4,,739,552
18,"Galați",172,"172-COSMESTI",76040,213,2,898,695,556,139,689,6,"COSMESTI",,4,,381,308
18,"Galați",172,"172-COSMESTI",76040,214,2,1051,719,565,154,715,4,"COSMESTI",,4,,361,354
18,"Galați",172,"172-COSMESTI",76040,215,2,1109,775,633,142,773,2,"COSMESTI",,4,,380,393
18,"Galați",172,"172-COSTACHE NEGRI",76111,216,2,1801,1229,1051,178,1204,25,"COSTACHE NEGRI",,4,,848,356
18,"Galați",172,"172-CUCA",76139,217,2,1195,754,683,71,736,18,"CUCA",,4,,424,312
18,"Galați",172,"172-CUCA",76139,218,2,1181,722,675,47,717,5,"CUCA",,4,,431,286
18,"Galați",172,"172-CUDALBI",76157,219,2,1686,1163,1071,92,1145,18,"CUDALBI",,4,,810,335
18,"Galați",172,"172-CUDALBI",76157,220,2,1429,1058,959,99,1052,6,"CUDALBI",,4,,654,398
18,"Galați",172,"172-CUDALBI",76157,221,2,1501,970,897,73,952,16,"CUDALBI",,4,,639,313
18,"Galați",172,"172-CUDALBI",76157,222,2,1567,1128,1001,127,1108,20,"CUDALBI",,4,,778,330
18,"Galați",172,"172-DRAGANESTI",75221,223,2,2137,1618,1474,144,1606,12,"DRAGANESTI",,4,,777,829
18,"Galați",172,"172-DRAGANESTI",75221,224,2,1783,1371,1260,111,1354,17,"DRAGANESTI",,4,,672,682
18,"Galați",172,"172-DRAGUSENI",76175,225,2,1967,857,744,113,850,7,"DRAGUSENI",,4,,454,396
18,"Galați",172,"172-DRAGUSENI",76175,226,2,630,720,370,350,714,6,"DRAGUSENI",,4,,370,344
18,"Galați",172,"172-DRAGUSENI",76175,227,2,940,474,353,121,471,3,"DRAGUSENI",,4,,268,203
18,"Galați",172,"172-DRAGUSENI",76175,228,2,432,443,205,238,438,5,"DRAGUSENI",,4,,256,182
18,"Galați",172,"172-FARTANESTI",76255,229,2,2803,1397,1244,153,1380,17,"FARTANESTI",,4,,673,707
18,"Galați",172,"172-FARTANESTI",76255,230,2,1335,869,734,135,852,17,"FARTANESTI",,4,,601,251
18,"Galați",172,"172-FOLTESTI",76282,231,2,1715,1073,902,171,1058,15,"FOLTESTI",,4,,560,498
18,"Galați",172,"172-FOLTESTI",76282,232,2,784,528,434,94,521,7,"FOLTESTI",,4,,288,233
18,"Galați",172,"172-FRUMUSITA",76317,233,2,2478,1411,1224,187,1383,28,"FRUMUSITA",,4,,679,704
18,"Galați",172,"172-FRUMUSITA",76317,234,2,802,546,430,116,527,19,"FRUMUSITA",,4,,276,251
18,"Galați",172,"172-FRUMUSITA",76317,235,2,745,458,395,63,446,12,"FRUMUSITA",,4,,258,188
18,"Galați",172,"172-FUNDENI",76353,236,2,1875,1241,1060,181,1232,9,"FUNDENI",,4,,768,464
18,"Galați",172,"172-FUNDENI",76353,237,2,1276,799,694,105,793,6,"FUNDENI",,4,,503,290
18,"Galați",172,"172-GHIDICENI",76406,238,2,2120,1407,1174,233,1397,10,"GHIDICENI",,4,,842,555
18,"Galați",172,"172-GHIDICENI",76406,239,2,1926,1223,1085,138,1198,25,"GHIDICENI",,4,,783,415
18,"Galați",172,"172-GOHOR",76497,240,2,1544,957,787,170,941,16,"GOHOR",,4,,561,380
18,"Galați",172,"172-GOHOR",76497,241,2,293,239,167,72,236,3,"GOHOR",,4,,122,114
18,"Galați",172,"172-GOHOR",76497,242,2,697,544,444,100,540,4,"GOHOR",,4,,308,232
18,"Galați",172,"172-GOHOR",76497,243,2,565,413,300,113,410,3,"GOHOR",,4,,254,156
18,"Galați",172,"172-GRIVITA",76558,244,2,1510,949,835,114,935,14,"GRIVITA",,4,,628,307
18,"Galați",172,"172-GRIVITA",76558,245,2,901,618,536,82,609,9,"GRIVITA",,4,,401,208
18,"Galați",172,"172-GRIVITA",76558,246,2,481,320,264,56,313,7,"GRIVITA",,4,,193,120
18,"Galați",172,"172-INDEPENDENTA",76585,247,2,1944,1326,1131,195,1312,14,"INDEPENDENTA",,4,,712,600
18,"Galați",172,"172-INDEPENDENTA",76585,248,2,1499,1077,878,199,1072,5,"INDEPENDENTA",,4,,622,450
18,"Galați",172,"172-IVESTI",76601,249,2,1964,1094,910,184,1057,37,"IVESTI",,4,,599,458
18,"Galați",172,"172-IVESTI",76601,250,2,1523,1010,770,240,991,19,"IVESTI",,4,,523,468
18,"Galați",172,"172-IVESTI",76601,251,2,1792,1115,898,217,1100,15,"IVESTI",,4,,676,424
18,"Galați",172,"172-IVESTI",76601,252,2,1710,1100,903,197,1083,17,"IVESTI",,4,,542,541
18,"Galați",172,"172-JORASTI",76638,253,2,1139,601,521,80,592,9,"JORASTI",,4,,421,171
18,"Galați",172,"172-JORASTI",76638,254,2,223,171,144,27,166,5,"JORASTI",,4,,131,35
18,"Galați",172,"172-JORASTI",76638,255,2,283,218,174,44,214,4,"JORASTI",,4,,135,79
18,"Galați",172,"172-LIESTI",76674,256,2,1834,1143,1022,121,1129,14,"LIESTI",,4,,534,595
18,"Galați",172,"172-LIESTI",76674,257,2,1207,894,727,167,888,6,"LIESTI",,4,,381,507
18,"Galați",172,"172-LIESTI",76674,258,2,1735,1165,1037,128,1147,18,"LIESTI",,4,,561,586
18,"Galați",172,"172-LIESTI",76674,259,2,1980,1269,1171,98,1256,13,"LIESTI",,4,,633,623
18,"Galați",172,"172-LIESTI",76674,260,2,1667,1064,971,93,1049,15,"LIESTI",,4,,462,587
18,"Galați",172,"172-MATCA",76692,261,2,2137,1125,920,205,1120,5,"MATCA",,4,,667,453
18,"Galați",172,"172-MATCA",76692,262,2,1876,1106,852,254,1086,20,"MATCA",,4,,571,515
18,"Galați",172,"172-MATCA",76692,263,2,2187,1379,1136,243,1371,8,"MATCA",,4,,743,628
18,"Galați",172,"172-MATCA",76692,264,2,1764,1082,784,298,1075,7,"MATCA",,4,,601,474
18,"Galați",172,"172-MASTACANI",76718,265,2,2084,994,884,110,975,19,"MASTACANI",,4,,455,520
18,"Galați",172,"172-MASTACANI",76718,266,2,1260,711,670,41,705,6,"MASTACANI",,4,,332,373
18,"Galați",172,"172-MASTACANI",76718,267,2,929,588,410,178,578,10,"MASTACANI",,4,,261,317
18,"Galați",172,"172-MOVILENI",75132,268,2,1305,825,722,103,817,8,"MOVILENI",,4,,488,329
18,"Galați",172,"172-MOVILENI",75132,269,2,1132,756,652,104,742,14,"MOVILENI",,4,,325,417
18,"Galați",172,"172-MUNTENI",75258,270,2,1311,1002,827,175,986,16,"MUNTENI",,4,,586,400
18,"Galați",172,"172-MUNTENI",75258,271,2,1859,1086,939,147,1078,8,"MUNTENI",,4,,703,375
18,"Galați",172,"172-MUNTENI",75258,272,2,1444,1123,821,302,1108,15,"MUNTENI",,4,,524,584
18,"Galați",172,"172-MUNTENI",75258,273,2,1917,1228,1013,215,1200,28,"MUNTENI",,4,,614,586
18,"Galați",172,"172-NAMOLOASA",76763,274,2,1122,701,625,76,690,11,"NAMOLOASA",,4,,485,205
18,"Galați",172,"172-NAMOLOASA",76763,275,2,1252,866,784,82,854,12,"NAMOLOASA",,4,,658,196
18,"Galați",172,"172-NICORESTI",76807,276,2,1275,892,731,161,877,15,"NICORESTI",,4,,478,399
18,"Galați",172,"172-NICORESTI",76807,277,2,535,499,394,105,492,7,"NICORESTI",,4,,297,195
18,"Galați",172,"172-NICORESTI",76807,278,2,583,329,259,70,322,7,"NICORESTI",,4,,181,141
18,"Galați",172,"172-NICORESTI",76807,279,2,668,505,422,83,494,11,"NICORESTI",,4,,200,294
18,"Galați",172,"172-NICORESTI",76807,280,2,1561,1213,989,224,1201,12,"NICORESTI",,4,,789,412
18,"Galați",172,"172-OANCEA",76932,281,2,1301,967,757,210,937,30,"OANCEA",,4,,453,484
18,"Galați",172,"172-PECHEA",76969,282,2,1785,1139,1040,99,1126,13,"PECHEA",,4,,792,334
18,"Galați",172,"172-PECHEA",76969,283,2,2330,1484,1405,79,1470,14,"PECHEA",,4,,1016,454
18,"Galați",172,"172-PECHEA",76969,284,2,2014,1215,1141,74,1199,16,"PECHEA",,4,,853,346
18,"Galați",172,"172-PECHEA",76969,285,2,2316,1421,1308,113,1410,11,"PECHEA",,4,,1015,395
18,"Galați",172,"172-PISCU",76996,286,2,1941,1376,1181,195,1356,20,"PISCU",,4,,886,470
18,"Galați",172,"172-PISCU",76996,287,2,1726,1234,1105,129,1223,11,"PISCU",,4,,826,397
18,"Galați",172,"172-PRIPONESTI",77028,288,2,1086,738,554,184,721,17,"PRIPONESTI",,4,,395,326
18,"Galați",172,"172-PRIPONESTI",77028,289,2,975,638,530,108,636,2,"PRIPONESTI",,4,,502,134
18,"Galați",172,"172-REDIU",77082,290,2,2102,1407,1249,158,1384,23,"REDIU",,4,,877,507
18,"Galați",172,"172-REDIU",77082,291,2,1340,818,743,75,811,7,"REDIU",,4,,484,327
18,"Galați",172,"172-SCHELA",77153,292,2,1861,1439,1234,205,1431,8,"SCHELA",,4,,679,752
18,"Galați",172,"172-SCHELA",77153,293,2,472,393,325,68,389,4,"SCHELA",,4,,230,159
18,"Galați",172,"172-SCANTEIESTI",77126,294,2,1492,830,765,65,810,20,"SCANTEIESTI",,4,,550,260
18,"Galați",172,"172-SCANTEIESTI",77126,295,2,861,558,462,96,544,14,"SCANTEIESTI",,4,,330,214
18,"Galați",172,"172-SLOBOZIA CONACHI",77180,296,2,1425,927,815,112,921,6,"SLOBOZIA CONACHI",,4,,638,283
18,"Galați",172,"172-SLOBOZIA CONACHI",77180,297,2,1275,757,667,90,751,6,"SLOBOZIA CONACHI",,4,,519,232
18,"Galați",172,"172-SLOBOZIA CONACHI",77180,298,2,2274,1547,1410,137,1527,20,"SLOBOZIA CONACHI",,4,,1198,329
18,"Galați",172,"172-SLOBOZIA CONACHI",77180,299,2,790,534,459,75,528,6,"SLOBOZIA CONACHI",,4,,327,201
18,"Galați",172,"172-SMARDAN",77224,300,2,1012,773,619,154,771,2,"SMARDAN",,4,,534,237
18,"Galați",172,"172-SMARDAN",77224,301,2,393,437,244,193,434,3,"SMARDAN",,4,,314,120
18,"Galați",172,"172-SMARDAN",77224,302,2,675,529,454,75,522,7,"SMARDAN",,4,,350,172
18,"Galați",172,"172-SMULTI",77260,303,2,1508,1169,1050,119,1150,19,"SMULTI",,4,,746,404
18,"Galați",172,"172-SUCEVENI",77288,304,2,1303,831,701,130,821,10,"SUCEVENI",,4,,585,236
18,"Galați",172,"172-SUCEVENI",77288,305,2,461,456,291,165,450,6,"SUCEVENI",,4,,290,160
18,"Galați",172,"172-SENDRENI",75114,306,2,1640,1234,1042,192,1227,7,"SENDRENI",,4,,715,512
18,"Galați",172,"172-SENDRENI",75114,307,2,326,400,213,187,397,3,"SENDRENI",,4,,271,126
18,"Galați",172,"172-TUDOR VLADIMIRESCU",77313,308,2,2117,1599,1228,371,1590,9,"TUDOR VLADIMIRESCU",,4,,744,846
18,"Galați",172,"172-TUDOR VLADIMIRESCU",77313,309,2,1744,1444,1245,199,1431,13,"TUDOR VLADIMIRESCU",,4,,925,506
18,"Galați",172,"172-TULUCESTI",77331,310,2,1874,1255,1117,138,1239,16,"TULUCESTI",,4,,700,539
18,"Galați",172,"172-TULUCESTI",77331,311,2,1339,907,749,158,897,10,"TULUCESTI",,4,,506,391
18,"Galați",172,"172-TULUCESTI",77331,312,2,1749,926,777,149,909,17,"TULUCESTI",,4,,460,449
18,"Galați",172,"172-TULUCESTI",77331,313,2,1124,735,622,113,720,15,"TULUCESTI",,4,,360,360
18,"Galați",172,"172-TEPU",77377,314,2,2074,1426,1280,146,1414,12,"TEPU",,4,,887,527
18,"Galați",172,"172-UMBRARESTI",75506,315,2,1700,1233,992,241,1222,11,"UMBRARESTI",,4,,793,429
18,"Galați",172,"172-UMBRARESTI",75506,316,2,1874,1178,963,215,1158,20,"UMBRARESTI",,4,,695,463
18,"Galați",172,"172-UMBRARESTI",75506,317,2,1443,828,701,127,812,16,"UMBRARESTI",,4,,485,327
18,"Galați",172,"172-VALEA MARULUI",77475,318,2,2081,1251,1168,83,1230,21,"VALEA MARULUI",,4,,730,500
18,"Galați",172,"172-VALEA MARULUI",77475,319,2,904,603,512,91,584,19,"VALEA MARULUI",,4,,391,193
18,"Galați",172,"172-VINATORI",75150,320,2,1594,1165,1038,127,1159,6,"VINATORI",,4,,678,481
18,"Galați",172,"172-VINATORI",75150,321,2,1187,814,736,78,809,5,"VINATORI",,4,,514,295
18,"Galați",172,"172-VARLEZI",77509,322,2,1087,757,657,100,749,8,"VARLEZI",,4,,417,332
18,"Galați",172,"172-VARLEZI",77509,323,2,788,543,463,80,535,8,"VARLEZI",,4,,271,264
18,"Galați",172,"172-VLADESTI",77536,324,2,1216,743,649,94,726,17,"VLADESTI",,4,,503,223
18,"Galați",172,"172-VLADESTI",77536,325,2,849,600,504,96,593,7,"VLADESTI",,4,,402,191
19,"Giurgiu",528,"528-MUNICIPIUL GIURGIU",100521,1,2,1860,1331,1223,108,1326,5,"MUNICIPIUL GIURGIU",,5,,693,633
19,"Giurgiu",528,"528-MUNICIPIUL GIURGIU",100521,2,2,2184,1519,1362,157,1515,4,"MUNICIPIUL GIURGIU",,5,,670,845
19,"Giurgiu",528,"528-MUNICIPIUL GIURGIU",100521,3,2,1419,949,896,53,940,9,"MUNICIPIUL GIURGIU",,5,,516,424
19,"Giurgiu",528,"528-MUNICIPIUL GIURGIU",100521,4,2,1320,978,907,71,967,11,"MUNICIPIUL GIURGIU",,5,,513,454
19,"Giurgiu",528,"528-MUNICIPIUL GIURGIU",100521,5,2,1227,1017,758,259,1004,13,"MUNICIPIUL GIURGIU",,5,,508,496
19,"Giurgiu",528,"528-MUNICIPIUL GIURGIU",100521,6,2,1609,996,964,32,991,5,"MUNICIPIUL GIURGIU",,5,,587,404
19,"Giurgiu",528,"528-MUNICIPIUL GIURGIU",100521,7,2,1408,1050,962,88,1043,7,"MUNICIPIUL GIURGIU",,5,,563,480
19,"Giurgiu",528,"528-MUNICIPIUL GIURGIU",100521,8,2,1579,1032,978,54,1028,4,"MUNICIPIUL GIURGIU",,5,,592,436
19,"Giurgiu",528,"528-MUNICIPIUL GIURGIU",100521,9,2,1453,985,946,39,974,11,"MUNICIPIUL GIURGIU",,5,,615,359
19,"Giurgiu",528,"528-MUNICIPIUL GIURGIU",100521,10,2,2142,1414,1386,28,1404,10,"MUNICIPIUL GIURGIU",,5,,782,622
19,"Giurgiu",528,"528-MUNICIPIUL GIURGIU",100521,11,2,2211,1288,1218,70,1264,24,"MUNICIPIUL GIURGIU",,5,,668,596
19,"Giurgiu",528,"528-MUNICIPIUL GIURGIU",100521,12,2,1374,871,806,65,865,6,"MUNICIPIUL GIURGIU",,5,,489,376
19,"Giurgiu",528,"528-MUNICIPIUL GIURGIU",100521,13,2,1580,991,872,119,983,8,"MUNICIPIUL GIURGIU",,5,,532,451
19,"Giurgiu",528,"528-MUNICIPIUL GIURGIU",100521,14,2,1934,1370,1108,262,1361,9,"MUNICIPIUL GIURGIU",,5,,656,705
19,"Giurgiu",528,"528-MUNICIPIUL GIURGIU",100521,15,2,2466,1672,1517,155,1669,3,"MUNICIPIUL GIURGIU",,5,,816,853
19,"Giurgiu",528,"528-MUNICIPIUL GIURGIU",100521,16,2,2402,1603,1517,86,1596,7,"MUNICIPIUL GIURGIU",,5,,801,795
19,"Giurgiu",528,"528-MUNICIPIUL GIURGIU",100521,17,2,2099,1425,1302,123,1415,10,"MUNICIPIUL GIURGIU",,5,,673,742
19,"Giurgiu",528,"528-MUNICIPIUL GIURGIU",100521,18,2,1299,896,832,64,892,4,"MUNICIPIUL GIURGIU",,5,,377,515
19,"Giurgiu",528,"528-MUNICIPIUL GIURGIU",100521,19,2,1974,1285,1206,79,1282,3,"MUNICIPIUL GIURGIU",,5,,605,677
19,"Giurgiu",528,"528-MUNICIPIUL GIURGIU",100521,20,2,2584,1586,1419,167,1580,6,"MUNICIPIUL GIURGIU",,5,,782,798
19,"Giurgiu",528,"528-MUNICIPIUL GIURGIU",100521,21,2,2111,1392,1135,257,1387,5,"MUNICIPIUL GIURGIU",,5,,625,762
19,"Giurgiu",528,"528-MUNICIPIUL GIURGIU",100521,22,2,2159,1471,1187,284,1465,6,"MUNICIPIUL GIURGIU",,5,,707,758
19,"Giurgiu",528,"528-MUNICIPIUL GIURGIU",100521,23,2,1113,820,692,128,815,5,"MUNICIPIUL GIURGIU",,5,,420,395
19,"Giurgiu",528,"528-MUNICIPIUL GIURGIU",100521,24,2,2373,1387,1301,86,1380,7,"MUNICIPIUL GIURGIU",,5,,692,688
19,"Giurgiu",528,"528-MUNICIPIUL GIURGIU",100521,25,2,2070,1194,1024,170,1188,6,"MUNICIPIUL GIURGIU",,5,,558,630
19,"Giurgiu",528,"528-MUNICIPIUL GIURGIU",100521,26,2,1899,1271,1172,99,1262,9,"MUNICIPIUL GIURGIU",,5,,618,644
19,"Giurgiu",528,"528-MUNICIPIUL GIURGIU",100521,27,2,1690,1338,1163,175,1335,3,"MUNICIPIUL GIURGIU",,5,,666,669
19,"Giurgiu",528,"528-MUNICIPIUL GIURGIU",100521,28,2,1629,1210,1102,108,1208,2,"MUNICIPIUL GIURGIU",,5,,597,611
19,"Giurgiu",528,"528-MUNICIPIUL GIURGIU",100521,29,2,1365,1017,922,95,1007,10,"MUNICIPIUL GIURGIU",,5,,463,544
19,"Giurgiu",528,"528-MUNICIPIUL GIURGIU",100521,30,2,1708,1199,1131,68,1178,21,"MUNICIPIUL GIURGIU",,5,,664,514
19,"Giurgiu",528,"528-MUNICIPIUL GIURGIU",100521,31,2,2112,1220,1136,84,1210,10,"MUNICIPIUL GIURGIU",,5,,676,534
19,"Giurgiu",528,"528-MUNICIPIUL GIURGIU",100521,32,2,1568,1153,992,161,1146,7,"MUNICIPIUL GIURGIU",,5,,630,516
19,"Giurgiu",528,"528-MUNICIPIUL GIURGIU",100521,33,2,0,1482,0,1482,1461,21,"MUNICIPIUL GIURGIU",,5,,788,673
19,"Giurgiu",528,"528-MUNICIPIUL GIURGIU",100521,34,2,0,265,0,265,259,6,"MUNICIPIUL GIURGIU",,5,,159,100
19,"Giurgiu",528,"528-MUNICIPIUL GIURGIU",100521,35,2,0,260,0,260,259,1,"MUNICIPIUL GIURGIU",,5,,98,161
19,"Giurgiu",528,"528-MUNICIPIUL GIURGIU",100521,36,2,0,183,0,183,182,1,"MUNICIPIUL GIURGIU",,5,,39,143
19,"Giurgiu",528,"528-MUNICIPIUL GIURGIU",100521,37,2,0,186,0,186,185,1,"MUNICIPIUL GIURGIU",,5,,87,98
19,"Giurgiu",528,"528-ORAS BOLINTIN-VALE",101190,38,2,1125,744,639,105,742,2,"ORAS BOLINTIN-VALE",,5,,354,388
19,"Giurgiu",528,"528-ORAS BOLINTIN-VALE",101190,39,2,1690,591,525,66,572,19,"ORAS BOLINTIN-VALE",,5,,327,245
19,"Giurgiu",528,"528-ORAS BOLINTIN-VALE",101190,40,2,780,475,417,58,470,5,"ORAS BOLINTIN-VALE",,5,,233,237
19,"Giurgiu",528,"528-ORAS BOLINTIN-VALE",101190,41,2,1583,734,635,99,729,5,"ORAS BOLINTIN-VALE",,5,,321,408
19,"Giurgiu",528,"528-ORAS BOLINTIN-VALE",101190,42,2,1360,706,656,50,691,15,"ORAS BOLINTIN-VALE",,5,,385,306
19,"Giurgiu",528,"528-ORAS BOLINTIN-VALE",101190,43,2,1280,666,604,62,652,14,"ORAS BOLINTIN-VALE",,5,,372,280
19,"Giurgiu",528,"528-ORAS BOLINTIN-VALE",101190,44,2,645,450,361,89,447,3,"ORAS BOLINTIN-VALE",,5,,272,175
19,"Giurgiu",528,"528-ORAS MIHAILESTI",104136,45,2,2033,1344,1024,320,1334,10,"ORAS MIHAILESTI",,5,,641,693
19,"Giurgiu",528,"528-ORAS MIHAILESTI",104136,46,2,1069,639,438,201,626,13,"ORAS MIHAILESTI",,5,,278,348
19,"Giurgiu",528,"528-ORAS MIHAILESTI",104136,47,2,397,273,227,46,267,6,"ORAS MIHAILESTI",,5,,167,100
19,"Giurgiu",528,"528-ORAS MIHAILESTI",104136,48,2,889,607,514,93,580,27,"ORAS MIHAILESTI",,5,,264,316
19,"Giurgiu",528,"528-ORAS MIHAILESTI",104136,49,2,1099,659,576,83,635,24,"ORAS MIHAILESTI",,5,,280,355
19,"Giurgiu",528,"528-ADUNATII-COPACENI",100781,50,2,1197,796,607,189,789,7,"ADUNATII-COPACENI",,5,,318,471
19,"Giurgiu",528,"528-ADUNATII-COPACENI",100781,51,2,1350,750,631,119,743,7,"ADUNATII-COPACENI",,5,,340,403
19,"Giurgiu",528,"528-ADUNATII-COPACENI",100781,52,2,1983,985,760,225,961,24,"ADUNATII-COPACENI",,5,,472,489
19,"Giurgiu",528,"528-ADUNATII-COPACENI",100781,53,2,477,325,288,37,318,7,"ADUNATII-COPACENI",,5,,173,145
19,"Giurgiu",528,"528-ADUNATII-COPACENI",100781,54,2,408,299,243,56,293,6,"ADUNATII-COPACENI",,5,,105,188
19,"Giurgiu",528,"528-BANEASA",101001,55,2,1914,1076,876,200,1062,14,"BANEASA",,5,,562,500
19,"Giurgiu",528,"528-BANEASA",101001,56,2,817,579,353,226,578,1,"BANEASA",,5,,258,320
19,"Giurgiu",528,"528-BANEASA",101001,57,2,1229,768,662,106,759,9,"BANEASA",,5,,607,152
19,"Giurgiu",528,"528-BANEASA",101001,58,2,756,489,366,123,480,9,"BANEASA",,5,,252,228
19,"Giurgiu",528,"528-BOLINTIN-DEAL",101163,59,2,1289,758,620,138,752,6,"BOLINTIN-DEAL",,5,,405,347
19,"Giurgiu",528,"528-BOLINTIN-DEAL",101163,60,2,1887,1059,915,144,1047,12,"BOLINTIN-DEAL",,5,,408,639
19,"Giurgiu",528,"528-BOLINTIN-DEAL",101163,61,2,1459,980,836,144,974,6,"BOLINTIN-DEAL",,5,,491,483
19,"Giurgiu",528,"528-BUCSANI",101378,62,2,723,540,379,161,529,11,"BUCSANI",,5,,274,255
19,"Giurgiu",528,"528-BUCSANI",101378,63,2,659,483,365,118,479,4,"BUCSANI",,5,,275,204
19,"Giurgiu",528,"528-BUCSANI",101378,64,2,485,375,312,63,374,1,"BUCSANI",,5,,233,141
19,"Giurgiu",528,"528-BUCSANI",101378,65,2,384,274,215,59,271,3,"BUCSANI",,5,,168,103
19,"Giurgiu",528,"528-BUCSANI",101378,66,2,363,257,226,31,254,3,"BUCSANI",,5,,168,86
19,"Giurgiu",528,"528-BUCSANI",101378,67,2,487,353,297,56,349,4,"BUCSANI",,5,,224,125
19,"Giurgiu",528,"528-BULBUCATA",101519,68,2,1257,806,675,131,786,20,"BULBUCATA",,5,,480,306
19,"Giurgiu",528,"528-BUTURUGENI",101617,69,2,1579,1143,1021,122,1132,11,"BUTURUGENI",,5,,417,715
19,"Giurgiu",528,"528-BUTURUGENI",101617,70,2,1116,856,733,123,841,15,"BUTURUGENI",,5,,398,443
19,"Giurgiu",528,"528-BUTURUGENI",101617,71,2,261,265,195,70,263,2,"BUTURUGENI",,5,,134,129
19,"Giurgiu",528,"528-CALUGARENI",101662,72,2,1510,833,640,193,817,16,"CALUGARENI",,5,,446,371
19,"Giurgiu",528,"528-CALUGARENI",101662,73,2,918,659,473,186,658,1,"CALUGARENI",,5,,430,228
19,"Giurgiu",528,"528-CALUGARENI",101662,74,2,1175,826,646,180,814,12,"CALUGARENI",,5,,545,269
19,"Giurgiu",528,"528-CALUGARENI",101662,75,2,1553,943,775,168,919,24,"CALUGARENI",,5,,476,443
19,"Giurgiu",528,"528-CLEJANI",101984,76,2,1466,991,824,167,973,17,"CLEJANI",,5,,395,578
19,"Giurgiu",528,"528-CLEJANI",101984,77,2,1026,704,595,109,699,5,"CLEJANI",,5,,468,231
19,"Giurgiu",528,"528-COLIBASI",102071,78,2,1061,629,539,90,610,19,"COLIBASI",,5,,252,358
19,"Giurgiu",528,"528-COLIBASI",102071,79,2,1085,691,602,89,678,13,"COLIBASI",,5,,339,339
19,"Giurgiu",528,"528-COLIBASI",102071,80,2,893,575,481,94,568,7,"COLIBASI",,5,,264,304
19,"Giurgiu",528,"528-COMANA",102106,81,2,1511,1041,805,236,1036,5,"COMANA",,5,,448,588
19,"Giurgiu",528,"528-COMANA",102106,82,2,733,533,408,125,510,23,"COMANA",,5,,229,281
19,"Giurgiu",528,"528-COMANA",102106,83,2,1354,769,592,177,748,21,"COMANA",,5,,406,342
19,"Giurgiu",528,"528-COMANA",102106,84,2,728,497,331,166,491,6,"COMANA",,5,,286,205
19,"Giurgiu",528,"528-COMANA",102106,85,2,1410,1072,896,176,1055,17,"COMANA",,5,,588,467
19,"Giurgiu",528,"528-COMANA",102106,86,2,0,380,0,380,377,3,"COMANA",,5,,196,181
19,"Giurgiu",528,"528-CREVEDIA MARE",102348,87,2,1235,878,736,142,867,11,"CREVEDIA MARE",,5,,608,259
19,"Giurgiu",528,"528-CREVEDIA MARE",102348,88,2,763,566,473,93,557,9,"CREVEDIA MARE",,5,,311,246
19,"Giurgiu",528,"528-CREVEDIA MARE",102348,89,2,1572,876,734,142,867,9,"CREVEDIA MARE",,5,,573,294
19,"Giurgiu",528,"528-DAIA",102446,90,2,1011,777,641,136,762,15,"DAIA",,5,,414,348
19,"Giurgiu",528,"528-DAIA",102446,91,2,1644,1099,921,178,1081,18,"DAIA",,5,,521,560
19,"Giurgiu",528,"528-FLORESTI-STOENESTI",102794,92,2,3045,2054,1787,267,2024,30,"FLORESTI-STOENESTI",,5,,1153,871
19,"Giurgiu",528,"528-FLORESTI-STOENESTI",102794,93,2,1522,725,583,142,711,14,"FLORESTI-STOENESTI",,5,,320,391
19,"Giurgiu",528,"528-FLORESTI-STOENESTI",102794,94,2,1810,1173,1049,124,1161,12,"FLORESTI-STOENESTI",,5,,383,778
19,"Giurgiu",528,"528-FRATESTI",102909,95,2,2136,1260,1100,160,1247,13,"FRATESTI",,5,,803,444
19,"Giurgiu",528,"528-FRATESTI",102909,96,2,1218,1001,723,278,992,9,"FRATESTI",,5,,689,303
19,"Giurgiu",528,"528-FRATESTI",102909,97,2,831,496,380,116,492,4,"FRATESTI",,5,,343,149
19,"Giurgiu",528,"528-GAISENI",103087,98,2,1296,839,665,174,830,9,"GAISENI",,5,,521,309
19,"Giurgiu",528,"528-GAISENI",103087,99,2,1766,975,801,174,955,20,"GAISENI",,5,,571,384
19,"Giurgiu",528,"528-GAISENI",103087,100,2,495,446,343,103,443,3,"GAISENI",,5,,288,155
19,"Giurgiu",528,"528-GAUJANI",103194,101,2,1291,905,749,156,899,6,"GAUJANI",,5,,517,382
19,"Giurgiu",528,"528-GAUJANI",103194,102,2,218,193,141,52,193,0,"GAUJANI",,5,,134,59
19,"Giurgiu",528,"528-GAUJANI",103194,103,2,811,552,460,92,544,8,"GAUJANI",,5,,374,170
19,"Giurgiu",528,"528-GHIMPATI",103238,104,2,1371,810,577,233,752,58,"GHIMPATI",,5,,464,288
19,"Giurgiu",528,"528-GHIMPATI",103238,105,2,700,383,280,103,370,13,"GHIMPATI",,5,,252,118
19,"Giurgiu",528,"528-GHIMPATI",103238,106,2,854,607,463,144,588,19,"GHIMPATI",,5,,429,159
19,"Giurgiu",528,"528-GHIMPATI",103238,107,2,1467,1063,856,207,1043,20,"GHIMPATI",,5,,709,334
19,"Giurgiu",528,"528-GHIMPATI",103238,108,2,432,338,259,79,335,3,"GHIMPATI",,5,,224,111
19,"Giurgiu",528,"528-GOGOSARI",103309,109,2,1122,732,562,170,718,14,"GOGOSARI",,5,,489,229
19,"Giurgiu",528,"528-GOGOSARI",103309,110,2,688,499,364,135,493,6,"GOGOSARI",,5,,207,286
19,"Giurgiu",528,"528-GOSTINARI",103372,111,2,1523,983,819,164,957,26,"GOSTINARI",,5,,563,394
19,"Giurgiu",528,"528-GOSTINARI",103372,112,2,607,469,335,134,464,5,"GOSTINARI",,5,,323,141
19,"Giurgiu",528,"528-GOSTINU",103354,113,2,1108,823,786,37,814,9,"GOSTINU",,5,,523,291
19,"Giurgiu",528,"528-GOSTINU",103354,114,2,1065,719,671,48,716,3,"GOSTINU",,5,,413,303
19,"Giurgiu",528,"528-GRADINARI",103407,115,2,799,659,558,101,644,15,"GRADINARI",,5,,253,391
19,"Giurgiu",528,"528-GRADINARI",103407,116,2,688,595,505,90,591,4,"GRADINARI",,5,,277,314
19,"Giurgiu",528,"528-GRADINARI",103407,117,2,866,751,609,142,747,4,"GRADINARI",,5,,283,464
19,"Giurgiu",528,"528-GREACA",103470,118,2,1761,1263,1072,191,1242,21,"GREACA",,5,,594,648
19,"Giurgiu",528,"528-GREACA",103470,119,2,373,321,260,61,317,4,"GREACA",,5,,244,73
19,"Giurgiu",528,"528-GREACA",103470,120,2,325,232,184,48,229,3,"GREACA",,5,,173,56
19,"Giurgiu",528,"528-HOTARELE",103639,121,2,1303,906,763,143,889,17,"HOTARELE",,5,,417,472
19,"Giurgiu",528,"528-HOTARELE",103639,122,2,1537,1023,845,178,1016,7,"HOTARELE",,5,,550,466
19,"Giurgiu",528,"528-HOTARELE",103639,123,2,736,551,449,102,545,6,"HOTARELE",,5,,304,241
19,"Giurgiu",528,"528-HOTARELE",103639,124,2,1613,1109,906,203,1073,36,"HOTARELE",,5,,605,468
19,"Giurgiu",528,"528-HOTARELE",103639,125,2,1160,1192,908,284,1180,12,"HOTARELE",,5,,496,684
19,"Giurgiu",528,"528-IEPURESTI",103693,126,2,1160,756,630,126,747,9,"IEPURESTI",,5,,499,248
19,"Giurgiu",528,"528-IEPURESTI",103693,127,2,711,530,436,94,525,5,"IEPURESTI",,5,,261,264
19,"Giurgiu",528,"528-IZVOARELE",103899,128,2,1431,768,714,54,753,15,"IZVOARELE",,5,,560,193
19,"Giurgiu",528,"528-IZVOARELE",103899,129,2,1496,780,689,91,772,8,"IZVOARELE",,5,,554,218
19,"Giurgiu",528,"528-IZVOARELE",103899,130,2,170,166,97,69,162,4,"IZVOARELE",,5,,120,42
19,"Giurgiu",528,"528-IZVOARELE",103899,131,2,526,372,296,76,364,8,"IZVOARELE",,5,,270,94
19,"Giurgiu",528,"528-IZVOARELE",103899,132,2,291,226,180,46,225,1,"IZVOARELE",,5,,149,76
19,"Giurgiu",528,"528-IZVOARELE",103899,133,2,314,201,162,39,193,8,"IZVOARELE",,5,,99,94
19,"Giurgiu",528,"528-JOITA",103997,134,2,1557,956,818,138,947,9,"JOITA",,5,,268,679
19,"Giurgiu",528,"528-JOITA",103997,135,2,954,681,588,93,675,6,"JOITA",,5,,302,373
19,"Giurgiu",528,"528-JOITA",103997,136,2,1727,979,853,126,965,14,"JOITA",,5,,492,473
19,"Giurgiu",528,"528-JOITA",103997,137,2,1828,1314,1179,135,1288,26,"JOITA",,5,,586,702
19,"Giurgiu",528,"528-LETCA NOUA",104047,138,2,889,639,519,120,618,21,"LETCA NOUA",,5,,471,147
19,"Giurgiu",528,"528-LETCA NOUA",104047,139,2,1067,819,699,120,804,15,"LETCA NOUA",,5,,518,286
19,"Giurgiu",528,"528-LETCA NOUA",104047,140,2,1041,685,591,94,673,12,"LETCA NOUA",,5,,452,221
19,"Giurgiu",528,"528-MARSA",104225,141,2,992,569,569,0,562,7,"MARSA",,5,,430,132
19,"Giurgiu",528,"528-MARSA",104225,142,2,1023,763,636,127,755,8,"MARSA",,5,,513,242
19,"Giurgiu",528,"528-MIHAI BRAVU",104118,143,2,1045,560,476,84,550,10,"MIHAI BRAVU",,5,,331,219
19,"Giurgiu",528,"528-MIHAI BRAVU",104118,144,2,1122,669,558,111,651,18,"MIHAI BRAVU",,5,,346,305
19,"Giurgiu",528,"528-MIHAI BRAVU",104118,145,2,0,592,0,592,575,17,"MIHAI BRAVU",,5,,337,238
19,"Giurgiu",528,"528-OGREZENI",104485,146,2,856,655,555,100,647,8,"OGREZENI",,5,,405,242
19,"Giurgiu",528,"528-OGREZENI",104485,147,2,1076,659,556,103,657,2,"OGREZENI",,5,,359,298
19,"Giurgiu",528,"528-OGREZENI",104485,148,2,807,581,490,91,576,5,"OGREZENI",,5,,325,251
19,"Giurgiu",528,"528-OGREZENI",104485,149,2,684,565,495,70,558,7,"OGREZENI",,5,,358,200
19,"Giurgiu",528,"528-OINACU",104519,150,2,1778,1113,1000,113,1100,13,"OINACU",,5,,677,423
19,"Giurgiu",528,"528-OINACU",104519,151,2,1005,707,549,158,700,7,"OINACU",,5,,364,336
19,"Giurgiu",528,"528-OINACU",104519,152,2,531,419,271,148,409,10,"OINACU",,5,,208,201
19,"Giurgiu",528,"528-PRUNDU",104680,153,2,1668,840,772,68,824,16,"PRUNDU",,5,,537,287
19,"Giurgiu",528,"528-PRUNDU",104680,154,2,1604,861,772,89,851,10,"PRUNDU",,5,,506,345
19,"Giurgiu",528,"528-PRUNDU",104680,155,2,788,512,457,55,502,10,"PRUNDU",,5,,318,184
19,"Giurgiu",528,"528-PUTINEIU",104715,156,2,1173,867,744,123,850,17,"PUTINEIU",,5,,516,334
19,"Giurgiu",528,"528-PUTINEIU",104715,157,2,390,347,291,56,339,8,"PUTINEIU",,5,,159,180
19,"Giurgiu",528,"528-PUTINEIU",104715,158,2,804,710,614,96,672,38,"PUTINEIU",,5,,355,317
19,"Giurgiu",528,"528-RASUCENI",104788,159,2,1121,752,664,88,723,29,"RASUCENI",,5,,471,252
19,"Giurgiu",528,"528-RASUCENI",104788,160,2,585,466,362,104,456,10,"RASUCENI",,5,,353,103
19,"Giurgiu",528,"528-RASUCENI",104788,161,2,1128,852,703,149,816,32,"RASUCENI",,5,,611,205
19,"Giurgiu",528,"528-ROATA DE JOS",104831,162,2,2386,1365,1171,194,1335,30,"ROATA DE JOS",,5,,981,354
19,"Giurgiu",528,"528-ROATA DE JOS",104831,163,2,870,582,462,120,570,12,"ROATA DE JOS",,5,,401,169
19,"Giurgiu",528,"528-ROATA DE JOS",104831,164,2,947,592,537,55,581,11,"ROATA DE JOS",,5,,385,196
19,"Giurgiu",528,"528-ROATA DE JOS",104831,165,2,933,605,556,49,598,7,"ROATA DE JOS",,5,,414,184
19,"Giurgiu",528,"528-ROATA DE JOS",104831,166,2,927,509,471,38,500,9,"ROATA DE JOS",,5,,360,140
19,"Giurgiu",528,"528-SCHITU",104975,167,2,317,207,170,37,199,8,"SCHITU",,5,,150,49
19,"Giurgiu",528,"528-SCHITU",104975,168,2,500,398,333,65,388,10,"SCHITU",,5,,253,135
19,"Giurgiu",528,"528-SCHITU",104975,169,2,661,411,335,76,402,9,"SCHITU",,5,,264,138
19,"Giurgiu",528,"528-SCHITU",104975,170,2,519,399,343,56,392,7,"SCHITU",,5,,298,94
19,"Giurgiu",528,"528-SINGURENI",105106,171,2,1536,810,699,111,800,10,"SINGURENI",,5,,470,330
19,"Giurgiu",528,"528-SINGURENI",105106,172,2,646,438,357,81,430,8,"SINGURENI",,5,,268,162
19,"Giurgiu",528,"528-SINGURENI",105106,173,2,733,480,436,44,479,1,"SINGURENI",,5,,274,205
19,"Giurgiu",528,"528-SLOBOZIA",100549,174,2,738,523,425,98,516,7,"SLOBOZIA",,5,,316,200
19,"Giurgiu",528,"528-SLOBOZIA",100549,175,2,1183,772,605,167,765,7,"SLOBOZIA",,5,,480,285
19,"Giurgiu",528,"528-STANESTI",105295,176,2,1225,824,700,124,812,12,"STANESTI",,5,,474,338
19,"Giurgiu",528,"528-STANESTI",105295,177,2,528,412,348,64,407,5,"STANESTI",,5,,288,119
19,"Giurgiu",528,"528-STANESTI",105295,178,2,363,304,205,99,295,9,"STANESTI",,5,,204,91
19,"Giurgiu",528,"528-STANESTI",105295,179,2,375,306,249,57,302,4,"STANESTI",,5,,210,92
19,"Giurgiu",528,"528-STOENESTI",102801,180,2,1540,849,746,103,835,14,"STOENESTI",,5,,568,267
19,"Giurgiu",528,"528-STOENESTI",102801,181,2,773,663,556,107,642,21,"STOENESTI",,5,,477,165
19,"Giurgiu",528,"528-TOPORU",154709,182,2,1525,1017,893,124,1007,10,"TOPORU",,5,,754,253
19,"Giurgiu",528,"528-TOPORU",154709,183,2,724,480,357,123,469,11,"TOPORU",,5,,318,151
19,"Giurgiu",528,"528-ULMI",105623,184,2,1725,989,826,163,976,13,"ULMI",,5,,491,485
19,"Giurgiu",528,"528-ULMI",105623,185,2,1120,705,547,158,696,9,"ULMI",,5,,370,326
19,"Giurgiu",528,"528-ULMI",105623,186,2,1962,1075,890,185,1067,8,"ULMI",,5,,549,518
19,"Giurgiu",528,"528-ULMI",105623,187,2,421,435,243,192,429,6,"ULMI",,5,,267,162
19,"Giurgiu",528,"528-VALEA DRAGULUI",105776,188,2,1750,1019,873,146,1001,18,"VALEA DRAGULUI",,5,,586,415
19,"Giurgiu",528,"528-VALEA DRAGULUI",105776,189,2,862,705,556,149,693,12,"VALEA DRAGULUI",,5,,425,268
19,"Giurgiu",528,"528-VARASTI",105874,190,2,1227,864,761,103,853,11,"VARASTI",,5,,453,400
19,"Giurgiu",528,"528-VARASTI",105874,191,2,1041,720,635,85,711,9,"VARASTI",,5,,392,319
19,"Giurgiu",528,"528-VARASTI",105874,192,2,1027,700,590,110,689,11,"VARASTI",,5,,419,270
19,"Giurgiu",528,"528-VARASTI",105874,193,2,1607,1025,882,143,1003,22,"VARASTI",,5,,535,468
19,"Giurgiu",528,"528-VEDEA",105909,194,2,1342,960,798,162,949,11,"VEDEA",,5,,628,321
19,"Giurgiu",528,"528-VEDEA",105909,195,2,1292,906,793,113,893,13,"VEDEA",,5,,598,295
19,"Giurgiu",528,"528-VEDEA",105909,196,2,928,690,576,114,686,4,"VEDEA",,5,,529,157
19,"Giurgiu",528,"528-VEDEA",105909,197,2,1388,924,815,109,908,16,"VEDEA",,5,,694,214
19,"Giurgiu",528,"528-VANATORII MICI",105972,198,2,880,586,496,90,578,8,"VANATORII MICI",,5,,409,169
19,"Giurgiu",528,"528-VANATORII MICI",105972,199,2,1085,698,582,116,672,26,"VANATORII MICI",,5,,503,169
19,"Giurgiu",528,"528-VANATORII MICI",105972,200,2,1392,864,749,115,851,13,"VANATORII MICI",,5,,674,177
19,"Giurgiu",528,"528-VANATORII MICI",105972,201,2,492,357,297,60,357,0,"VANATORII MICI",,5,,248,109
20,"Gorj",181,"181-MUNICIPIUL TARGU JIU",77812,1,2,1954,1439,1229,210,1439,0,"MUNICIPIUL TARGU JIU",,6,,647,792
20,"Gorj",181,"181-MUNICIPIUL TARGU JIU",77812,2,2,2244,1578,1318,260,1577,1,"MUNICIPIUL TARGU JIU",,6,,718,859
20,"Gorj",181,"181-MUNICIPIUL TARGU JIU",77812,3,2,1526,1128,986,142,1127,1,"MUNICIPIUL TARGU JIU",,6,,542,585
20,"Gorj",181,"181-MUNICIPIUL TARGU JIU",77812,4,2,1442,1016,897,119,1012,4,"MUNICIPIUL TARGU JIU",,6,,537,475
20,"Gorj",181,"181-MUNICIPIUL TARGU JIU",77812,5,2,726,518,449,69,512,6,"MUNICIPIUL TARGU JIU",,6,,277,235
20,"Gorj",181,"181-MUNICIPIUL TARGU JIU",77812,6,2,1326,868,785,83,861,7,"MUNICIPIUL TARGU JIU",,6,,470,391
20,"Gorj",181,"181-MUNICIPIUL TARGU JIU",77812,7,2,879,630,557,73,625,5,"MUNICIPIUL TARGU JIU",,6,,341,284
20,"Gorj",181,"181-MUNICIPIUL TARGU JIU",77812,8,2,1077,802,700,102,792,10,"MUNICIPIUL TARGU JIU",,6,,473,319
20,"Gorj",181,"181-MUNICIPIUL TARGU JIU",77812,9,2,1029,760,646,114,757,3,"MUNICIPIUL TARGU JIU",,6,,484,273
20,"Gorj",181,"181-MUNICIPIUL TARGU JIU",77812,10,2,1572,1021,950,71,1016,5,"MUNICIPIUL TARGU JIU",,6,,514,502
20,"Gorj",181,"181-MUNICIPIUL TARGU JIU",77812,11,2,1379,918,891,27,915,3,"MUNICIPIUL TARGU JIU",,6,,501,414
20,"Gorj",181,"181-MUNICIPIUL TARGU JIU",77812,12,2,936,688,578,110,683,5,"MUNICIPIUL TARGU JIU",,6,,372,311
20,"Gorj",181,"181-MUNICIPIUL TARGU JIU",77812,13,2,1992,1286,1158,128,1276,10,"MUNICIPIUL TARGU JIU",,6,,664,612
20,"Gorj",181,"181-MUNICIPIUL TARGU JIU",77812,14,2,1948,1303,1148,155,1292,11,"MUNICIPIUL TARGU JIU",,6,,689,603
20,"Gorj",181,"181-MUNICIPIUL TARGU JIU",77812,15,2,1944,1161,1013,148,1156,5,"MUNICIPIUL TARGU JIU",,6,,667,489
20,"Gorj",181,"181-MUNICIPIUL TARGU JIU",77812,16,2,1792,1094,957,137,1091,3,"MUNICIPIUL TARGU JIU",,6,,585,506
20,"Gorj",181,"181-MUNICIPIUL TARGU JIU",77812,17,2,1248,699,647,52,697,2,"MUNICIPIUL TARGU JIU",,6,,398,299
20,"Gorj",181,"181-MUNICIPIUL TARGU JIU",77812,18,2,1636,940,852,88,937,3,"MUNICIPIUL TARGU JIU",,6,,545,392
20,"Gorj",181,"181-MUNICIPIUL TARGU JIU",77812,19,2,1542,1015,903,112,1013,2,"MUNICIPIUL TARGU JIU",,6,,578,435
20,"Gorj",181,"181-MUNICIPIUL TARGU JIU",77812,20,2,1474,848,776,72,843,5,"MUNICIPIUL TARGU JIU",,6,,477,366
20,"Gorj",181,"181-MUNICIPIUL TARGU JIU",77812,21,2,1402,868,788,80,864,4,"MUNICIPIUL TARGU JIU",,6,,465,399
20,"Gorj",181,"181-MUNICIPIUL TARGU JIU",77812,22,2,1334,851,763,88,849,2,"MUNICIPIUL TARGU JIU",,6,,459,390
20,"Gorj",181,"181-MUNICIPIUL TARGU JIU",77812,23,2,1642,1067,954,113,1062,5,"MUNICIPIUL TARGU JIU",,6,,602,460
20,"Gorj",181,"181-MUNICIPIUL TARGU JIU",77812,24,2,1971,1164,1073,91,1159,5,"MUNICIPIUL TARGU JIU",,6,,666,493
20,"Gorj",181,"181-MUNICIPIUL TARGU JIU",77812,25,2,1825,1030,937,93,1024,6,"MUNICIPIUL TARGU JIU",,6,,584,440
20,"Gorj",181,"181-MUNICIPIUL TARGU JIU",77812,26,2,1827,1205,1097,108,1201,4,"MUNICIPIUL TARGU JIU",,6,,671,530
20,"Gorj",181,"181-MUNICIPIUL TARGU JIU",77812,27,2,1804,1150,967,183,1144,6,"MUNICIPIUL TARGU JIU",,6,,615,529
20,"Gorj",181,"181-MUNICIPIUL TARGU JIU",77812,28,2,1312,886,793,93,882,4,"MUNICIPIUL TARGU JIU",,6,,439,443
20,"Gorj",181,"181-MUNICIPIUL TARGU JIU",77812,29,2,1351,885,797,88,881,4,"MUNICIPIUL TARGU JIU",,6,,437,444
20,"Gorj",181,"181-MUNICIPIUL TARGU JIU",77812,30,2,777,553,422,131,553,0,"MUNICIPIUL TARGU JIU",,6,,259,294
20,"Gorj",181,"181-MUNICIPIUL TARGU JIU",77812,31,2,717,540,446,94,540,0,"MUNICIPIUL TARGU JIU",,6,,292,248
20,"Gorj",181,"181-MUNICIPIUL TARGU JIU",77812,32,2,1514,1063,994,69,1057,6,"MUNICIPIUL TARGU JIU",,6,,537,520
20,"Gorj",181,"181-MUNICIPIUL TARGU JIU",77812,33,2,1415,895,852,43,890,5,"MUNICIPIUL TARGU JIU",,6,,471,419
20,"Gorj",181,"181-MUNICIPIUL TARGU JIU",77812,34,2,1362,809,768,41,804,5,"MUNICIPIUL TARGU JIU",,6,,467,337
20,"Gorj",181,"181-MUNICIPIUL TARGU JIU",77812,35,2,1248,866,768,98,865,1,"MUNICIPIUL TARGU JIU",,6,,403,462
20,"Gorj",181,"181-MUNICIPIUL TARGU JIU",77812,36,2,1729,1429,1109,320,1428,1,"MUNICIPIUL TARGU JIU",,6,,600,828
20,"Gorj",181,"181-MUNICIPIUL TARGU JIU",77812,37,2,1357,828,746,82,822,6,"MUNICIPIUL TARGU JIU",,6,,422,400
20,"Gorj",181,"181-MUNICIPIUL TARGU JIU",77812,38,2,1194,792,702,90,792,0,"MUNICIPIUL TARGU JIU",,6,,425,367
20,"Gorj",181,"181-MUNICIPIUL TARGU JIU",77812,39,2,1562,1129,967,162,1124,5,"MUNICIPIUL TARGU JIU",,6,,547,577
20,"Gorj",181,"181-MUNICIPIUL TARGU JIU",77812,40,2,1249,794,711,83,778,16,"MUNICIPIUL TARGU JIU",,6,,555,223
20,"Gorj",181,"181-MUNICIPIUL TARGU JIU",77812,41,2,1544,1099,898,201,1092,7,"MUNICIPIUL TARGU JIU",,6,,627,465
20,"Gorj",181,"181-MUNICIPIUL TARGU JIU",77812,42,2,1229,816,718,98,815,1,"MUNICIPIUL TARGU JIU",,6,,405,410
20,"Gorj",181,"181-MUNICIPIUL TARGU JIU",77812,43,2,1073,682,575,107,678,4,"MUNICIPIUL TARGU JIU",,6,,357,321
20,"Gorj",181,"181-MUNICIPIUL TARGU JIU",77812,44,2,1247,1230,524,706,1225,5,"MUNICIPIUL TARGU JIU",,6,,570,655
20,"Gorj",181,"181-MUNICIPIUL TARGU JIU",77812,45,2,1392,1140,905,235,1129,11,"MUNICIPIUL TARGU JIU",,6,,672,457
20,"Gorj",181,"181-MUNICIPIUL TARGU JIU",77812,46,2,1187,975,785,190,971,4,"MUNICIPIUL TARGU JIU",,6,,569,402
20,"Gorj",181,"181-MUNICIPIUL TARGU JIU",77812,47,2,2082,1420,1261,159,1405,15,"MUNICIPIUL TARGU JIU",,6,,896,509
20,"Gorj",181,"181-MUNICIPIUL TARGU JIU",77812,48,2,1841,1299,1128,171,1291,8,"MUNICIPIUL TARGU JIU",,6,,775,516
20,"Gorj",181,"181-MUNICIPIUL TARGU JIU",77812,49,2,1372,939,792,147,933,6,"MUNICIPIUL TARGU JIU",,6,,640,293
20,"Gorj",181,"181-MUNICIPIUL TARGU JIU",77812,50,2,0,324,0,324,323,1,"MUNICIPIUL TARGU JIU",,6,,215,108
20,"Gorj",181,"181-MUNICIPIUL TARGU JIU",77812,51,2,0,386,0,386,383,3,"MUNICIPIUL TARGU JIU",,6,,224,159
20,"Gorj",181,"181-MUNICIPIUL TARGU JIU",77812,52,2,0,221,0,221,220,1,"MUNICIPIUL TARGU JIU",,6,,133,87
20,"Gorj",181,"181-MUNICIPIUL TARGU JIU",77812,53,2,0,716,0,716,713,3,"MUNICIPIUL TARGU JIU",,6,,320,393
20,"Gorj",181,"181-MUNICIPIUL TARGU JIU",77812,54,2,0,367,0,367,363,4,"MUNICIPIUL TARGU JIU",,6,,236,127
20,"Gorj",181,"181-MUNICIPIUL TARGU JIU",77812,55,2,0,369,0,369,367,2,"MUNICIPIUL TARGU JIU",,6,,267,100
20,"Gorj",181,"181-ORAS BUMBESTI-JIU",79308,56,2,1921,1187,775,412,1180,7,"ORAS BUMBESTI-JIU",,6,,778,402
20,"Gorj",181,"181-ORAS BUMBESTI-JIU",79308,57,2,1561,1169,842,327,1163,6,"ORAS BUMBESTI-JIU",,6,,680,483
20,"Gorj",181,"181-ORAS BUMBESTI-JIU",79308,58,2,1843,1426,973,453,1417,9,"ORAS BUMBESTI-JIU",,6,,861,556
20,"Gorj",181,"181-ORAS BUMBESTI-JIU",79308,59,2,949,640,438,202,635,5,"ORAS BUMBESTI-JIU",,6,,377,258
20,"Gorj",181,"181-ORAS BUMBESTI-JIU",79308,60,2,847,698,525,173,694,4,"ORAS BUMBESTI-JIU",,6,,401,293
20,"Gorj",181,"181-ORAS BUMBESTI-JIU",79308,61,2,552,518,429,89,515,3,"ORAS BUMBESTI-JIU",,6,,361,154
20,"Gorj",181,"181-ORAS BUMBESTI-JIU",79308,62,2,0,154,0,154,152,2,"ORAS BUMBESTI-JIU",,6,,92,60
20,"Gorj",181,"181-ORAS BUMBESTI-JIU",79308,63,2,364,383,363,20,381,2,"ORAS BUMBESTI-JIU",,6,,253,128
20,"Gorj",181,"181-ORAS MOTRU",78141,64,2,2102,1807,1132,675,1800,7,"ORAS MOTRU",,6,,1006,794
20,"Gorj",181,"181-ORAS MOTRU",78141,65,2,3831,2406,2125,281,2396,10,"ORAS MOTRU",,6,,1322,1074
20,"Gorj",181,"181-ORAS MOTRU",78141,66,2,1801,1134,999,135,1130,4,"ORAS MOTRU",,6,,653,477
20,"Gorj",181,"181-ORAS MOTRU",78141,67,2,3685,2266,2032,234,2251,15,"ORAS MOTRU",,6,,1395,856
20,"Gorj",181,"181-ORAS MOTRU",78141,68,2,3740,2342,1934,408,2336,6,"ORAS MOTRU",,6,,1518,818
20,"Gorj",181,"181-ORAS MOTRU",78141,69,2,393,303,247,56,300,3,"ORAS MOTRU",,6,,192,108
20,"Gorj",181,"181-ORAS MOTRU",78141,70,2,561,409,298,111,406,3,"ORAS MOTRU",,6,,282,124
20,"Gorj",181,"181-ORAS MOTRU",78141,71,2,1114,827,676,151,814,13,"ORAS MOTRU",,6,,582,232
20,"Gorj",181,"181-ORAS MOTRU",78141,72,2,709,512,378,134,508,4,"ORAS MOTRU",,6,,400,108
20,"Gorj",181,"181-ORAS MOTRU",78141,73,2,317,263,224,39,263,0,"ORAS MOTRU",,6,,185,78
20,"Gorj",181,"181-ORAS NOVACI",78258,74,2,1634,1069,970,99,1061,8,"ORAS NOVACI",,6,,483,578
20,"Gorj",181,"181-ORAS NOVACI",78258,75,2,1788,1008,891,117,998,10,"ORAS NOVACI",,6,,586,412
20,"Gorj",181,"181-ORAS NOVACI",78258,76,2,1497,999,904,95,984,15,"ORAS NOVACI",,6,,581,403
20,"Gorj",181,"181-ORAS NOVACI",78258,77,2,0,90,0,90,90,0,"ORAS NOVACI",,6,,50,40
20,"Gorj",181,"181-ORAS ROVINARI",82895,78,2,1700,1580,848,732,1568,12,"ORAS ROVINARI",,6,,687,881
20,"Gorj",181,"181-ORAS ROVINARI",82895,79,2,1686,1574,876,698,1563,11,"ORAS ROVINARI",,6,,674,889
20,"Gorj",181,"181-ORAS ROVINARI",82895,80,2,2200,1786,1169,617,1780,6,"ORAS ROVINARI",,6,,754,1026
20,"Gorj",181,"181-ORAS ROVINARI",82895,81,2,253,213,166,47,212,1,"ORAS ROVINARI",,6,,136,76
20,"Gorj",181,"181-ORAS ROVINARI",82895,82,2,208,243,127,116,239,4,"ORAS ROVINARI",,6,,163,76
20,"Gorj",181,"181-ORAS TARGU CARBUNESTI",78329,83,2,2923,1954,1479,475,1945,9,"ORAS TARGU CARBUNESTI",,6,,1071,874
20,"Gorj",181,"181-ORAS TARGU CARBUNESTI",78329,84,2,856,568,342,226,566,2,"ORAS TARGU CARBUNESTI",,6,,381,185
20,"Gorj",181,"181-ORAS TARGU CARBUNESTI",78329,85,2,979,421,334,87,420,1,"ORAS TARGU CARBUNESTI",,6,,264,156
20,"Gorj",181,"181-ORAS TARGU CARBUNESTI",78329,86,2,876,447,369,78,443,4,"ORAS TARGU CARBUNESTI",,6,,259,184
20,"Gorj",181,"181-ORAS TARGU CARBUNESTI",78329,87,2,469,390,290,100,390,0,"ORAS TARGU CARBUNESTI",,6,,289,101
20,"Gorj",181,"181-ORAS TARGU CARBUNESTI",78329,88,2,573,465,352,113,462,3,"ORAS TARGU CARBUNESTI",,6,,349,113
20,"Gorj",181,"181-ORAS TARGU CARBUNESTI",78329,89,2,181,190,174,16,190,0,"ORAS TARGU CARBUNESTI",,6,,116,74
20,"Gorj",181,"181-ORAS TARGU CARBUNESTI",78329,90,2,0,94,0,94,94,0,"ORAS TARGU CARBUNESTI",,6,,64,30
20,"Gorj",181,"181-ORAS TICLENI",78454,91,2,715,594,452,142,587,7,"ORAS TICLENI",,6,,389,198
20,"Gorj",181,"181-ORAS TICLENI",78454,92,2,2076,1507,1208,299,1497,10,"ORAS TICLENI",,6,,953,544
20,"Gorj",181,"181-ORAS TICLENI",78454,93,2,807,562,434,128,559,3,"ORAS TICLENI",,6,,405,154
20,"Gorj",181,"181-ALBENI",78472,94,2,1350,804,673,131,797,7,"ALBENI",,6,,594,203
20,"Gorj",181,"181-ALBENI",78472,95,2,672,467,345,122,464,3,"ALBENI",,6,,374,90
20,"Gorj",181,"181-ALIMPESTI",78542,96,2,1008,724,633,91,719,5,"ALIMPESTI",,6,,492,227
20,"Gorj",181,"181-ALIMPESTI",78542,97,2,762,588,531,57,584,4,"ALIMPESTI",,6,,397,187
20,"Gorj",181,"181-ANINOASA",78604,98,2,1226,773,626,147,763,10,"ANINOASA",,6,,568,195
20,"Gorj",181,"181-ANINOASA",78604,99,2,813,463,379,84,461,2,"ANINOASA",,6,,326,135
20,"Gorj",181,"181-ANINOASA",78604,100,2,771,556,457,99,535,21,"ANINOASA",,6,,446,89
20,"Gorj",181,"181-ANINOASA",78604,101,2,502,428,324,104,421,7,"ANINOASA",,6,,339,82
20,"Gorj",181,"181-ARCANI",78668,102,2,1098,785,620,165,779,6,"ARCANI",,6,,456,323
20,"Gorj",181,"181-BAIA DE FIER",78711,103,2,2812,1981,1874,107,1974,7,"BAIA DE FIER",,6,,1549,425
20,"Gorj",181,"181-BAIA DE FIER",78711,104,2,692,482,399,83,480,2,"BAIA DE FIER",,6,,310,170
20,"Gorj",181,"181-BALANESTI",78748,105,2,546,390,283,107,385,5,"BALANESTI",,6,,269,116
20,"Gorj",181,"181-BALANESTI",78748,106,2,516,397,293,104,396,1,"BALANESTI",,6,,291,105
20,"Gorj",181,"181-BALANESTI",78748,107,2,740,533,413,120,529,4,"BALANESTI",,6,,355,174
20,"Gorj",181,"181-BALESTI",77910,108,2,1854,1093,839,254,1087,6,"BALESTI",,6,,702,385
20,"Gorj",181,"181-BALESTI",77910,109,2,2305,1389,1151,238,1384,5,"BALESTI",,6,,963,421
20,"Gorj",181,"181-BALESTI",77910,110,2,1259,739,540,199,735,4,"BALESTI",,6,,543,192
20,"Gorj",181,"181-BARBATESTI",78828,111,2,1421,901,744,157,892,9,"BARBATESTI",,6,,538,354
20,"Gorj",181,"181-BENGESTI-CIOCADIA",78873,112,2,1154,746,604,142,737,9,"BENGESTI-CIOCADIA",,6,,510,227
20,"Gorj",181,"181-BENGESTI-CIOCADIA",78873,113,2,863,551,441,110,546,5,"BENGESTI-CIOCADIA",,6,,392,154
20,"Gorj",181,"181-BENGESTI-CIOCADIA",78873,114,2,662,548,410,138,546,2,"BENGESTI-CIOCADIA",,6,,409,137
20,"Gorj",181,"181-BERLESTI",78926,115,2,1147,583,455,128,581,2,"BERLESTI",,6,,440,141
20,"Gorj",181,"181-BERLESTI",78926,116,2,783,341,269,72,339,2,"BERLESTI",,6,,228,111
20,"Gorj",181,"181-BALTENI",79004,117,2,1605,1139,844,295,1135,4,"BALTENI",,6,,618,517
20,"Gorj",181,"181-BALTENI",79004,118,2,2418,1437,1278,159,1393,44,"BALTENI",,6,,962,431
20,"Gorj",181,"181-BALTENI",79004,119,2,1458,915,784,131,911,4,"BALTENI",,6,,563,348
20,"Gorj",181,"181-BOLBOSI",79077,120,2,1320,750,635,115,741,9,"BOLBOSI",,6,,572,169
20,"Gorj",181,"181-BOLBOSI",79077,121,2,858,547,451,96,534,11,"BOLBOSI",,6,,423,111
20,"Gorj",181,"181-BORASCU",79157,122,2,1636,844,728,116,840,4,"BORASCU",,6,,532,308
20,"Gorj",181,"181-BORASCU",79157,123,2,1068,606,522,84,596,10,"BORASCU",,6,,434,162
20,"Gorj",181,"181-BRANESTI",79237,124,2,737,517,439,78,511,6,"BRANESTI",,6,,346,165
20,"Gorj",181,"181-BRANESTI",79237,125,2,580,361,297,64,356,5,"BRANESTI",,6,,200,156
20,"Gorj",181,"181-BRANESTI",79237,126,2,479,355,283,72,353,2,"BRANESTI",,6,,299,54
20,"Gorj",181,"181-BRANESTI",79237,127,2,248,182,128,54,179,3,"BRANESTI",,6,,121,58
20,"Gorj",181,"181-BUMBESTI-PITIC",79362,128,2,2053,1200,1057,143,1189,11,"BUMBESTI-PITIC",,6,,807,382
20,"Gorj",181,"181-BUSTUCHIN",79406,129,2,1048,759,557,202,757,2,"BUSTUCHIN",,6,,561,196
20,"Gorj",181,"181-BUSTUCHIN",79406,130,2,697,483,384,99,479,4,"BUSTUCHIN",,6,,329,150
20,"Gorj",181,"181-BUSTUCHIN",79406,131,2,416,358,249,109,352,6,"BUSTUCHIN",,6,,325,27
20,"Gorj",181,"181-BUSTUCHIN",79406,132,2,360,282,219,63,279,3,"BUSTUCHIN",,6,,194,85
20,"Gorj",181,"181-CAPRENI",79497,133,2,1559,1016,789,227,1009,7,"CAPRENI",,6,,702,307
20,"Gorj",181,"181-CAPRENI",79497,134,2,497,296,204,92,291,5,"CAPRENI",,6,,142,149
20,"Gorj",181,"181-CATUNELE",79585,135,2,989,636,538,98,626,10,"CATUNELE",,6,,477,149
20,"Gorj",181,"181-CATUNELE",79585,136,2,887,766,636,130,756,10,"CATUNELE",,6,,541,215
20,"Gorj",181,"181-CIUPERCENI",79656,137,2,357,333,235,98,330,3,"CIUPERCENI",,6,,222,108
20,"Gorj",181,"181-CIUPERCENI",79656,138,2,244,237,167,70,235,2,"CIUPERCENI",,6,,175,60
20,"Gorj",181,"181-CIUPERCENI",79656,139,2,277,288,219,69,288,0,"CIUPERCENI",,6,,189,99
20,"Gorj",181,"181-CIUPERCENI",79656,140,2,293,291,207,84,287,4,"CIUPERCENI",,6,,214,73
20,"Gorj",181,"181-CALNIC",79736,141,2,722,544,385,159,540,4,"CALNIC",,6,,350,190
20,"Gorj",181,"181-CALNIC",79736,142,2,373,345,266,79,342,3,"CALNIC",,6,,265,77
20,"Gorj",181,"181-CALNIC",79736,143,2,596,353,280,73,348,5,"CALNIC",,6,,245,103
20,"Gorj",181,"181-CRASNA",79834,144,2,2501,1635,1466,169,1617,18,"CRASNA",,6,,1188,429
20,"Gorj",181,"181-CRASNA",79834,145,2,1950,1322,1129,193,1316,6,"CRASNA",,6,,957,359
20,"Gorj",181,"181-CRUSET",79932,146,2,1385,957,705,252,949,8,"CRUSET",,6,,598,351
20,"Gorj",181,"181-CRUSET",79932,147,2,919,465,397,68,462,3,"CRUSET",,6,,349,113
20,"Gorj",181,"181-CRUSET",79932,148,2,719,449,382,67,446,3,"CRUSET",,6,,274,172
20,"Gorj",181,"181-DANCIULESTI",80043,149,2,850,661,506,155,653,8,"DANCIULESTI",,6,,387,266
20,"Gorj",181,"181-DANCIULESTI",80043,150,2,1295,784,701,83,768,16,"DANCIULESTI",,6,,410,358
20,"Gorj",181,"181-DANESTI",80123,151,2,888,574,433,141,569,5,"DANESTI",,6,,370,199
20,"Gorj",181,"181-DANESTI",80123,152,2,543,370,286,84,367,3,"DANESTI",,6,,235,132
20,"Gorj",181,"181-DANESTI",80123,153,2,512,375,266,109,367,8,"DANESTI",,6,,218,149
20,"Gorj",181,"181-DANESTI",80123,154,2,782,434,348,86,427,7,"DANESTI",,6,,299,128
20,"Gorj",181,"181-DRAGOTESTI",80249,155,2,916,659,549,110,653,6,"DRAGOTESTI",,6,,441,212
20,"Gorj",181,"181-DRAGOTESTI",80249,156,2,957,645,554,91,641,4,"DRAGOTESTI",,6,,494,147
20,"Gorj",181,"181-DRAGUTESTI",78016,157,2,1307,1115,879,236,1109,6,"DRAGUTESTI",,6,,727,382
20,"Gorj",181,"181-DRAGUTESTI",78016,158,2,640,479,385,94,475,4,"DRAGUTESTI",,6,,263,212
20,"Gorj",181,"181-DRAGUTESTI",78016,159,2,1496,1007,886,121,998,9,"DRAGUTESTI",,6,,741,257
20,"Gorj",181,"181-DRAGUTESTI",78016,160,2,54,62,53,9,62,0,"DRAGUTESTI",,6,,39,23
20,"Gorj",181,"181-FARCASESTI",80285,161,2,770,501,404,97,497,4,"FARCASESTI",,6,,357,140
20,"Gorj",181,"181-FARCASESTI",80285,162,2,536,431,335,96,423,8,"FARCASESTI",,6,,233,190
20,"Gorj",181,"181-FARCASESTI",80285,163,2,584,388,294,94,386,2,"FARCASESTI",,6,,253,133
20,"Gorj",181,"181-FARCASESTI",80285,164,2,862,639,412,227,636,3,"FARCASESTI",,6,,411,225
20,"Gorj",181,"181-FARCASESTI",80285,165,2,282,193,124,69,187,6,"FARCASESTI",,6,,88,99
20,"Gorj",181,"181-GLOGOVA",80365,166,2,1342,907,729,178,894,13,"GLOGOVA",,6,,649,245
20,"Gorj",181,"181-GODINESTI",80427,167,2,972,733,574,159,724,9,"GODINESTI",,6,,491,233
20,"Gorj",181,"181-GODINESTI",80427,168,2,799,595,451,144,588,7,"GODINESTI",,6,,419,169
20,"Gorj",181,"181-HUREZANI",80506,169,2,1151,763,577,186,758,5,"HUREZANI",,6,,504,254
20,"Gorj",181,"181-HUREZANI",80506,170,2,248,169,132,37,166,3,"HUREZANI",,6,,115,51
20,"Gorj",181,"181-IONESTI",80560,171,2,2009,1226,1102,124,1214,12,"IONESTI",,6,,868,346
20,"Gorj",181,"181-JUPANESTI",80613,172,2,1099,632,517,115,628,4,"JUPANESTI",,6,,455,173
20,"Gorj",181,"181-JUPANESTI",80613,173,2,748,419,314,105,410,9,"JUPANESTI",,6,,280,130
20,"Gorj",181,"181-LELESTI",80677,174,2,1409,993,845,148,982,11,"LELESTI",,6,,570,412
20,"Gorj",181,"181-LICURICI",80711,175,2,715,397,298,99,393,4,"LICURICI",,6,,247,146
20,"Gorj",181,"181-LICURICI",80711,176,2,619,385,260,125,378,7,"LICURICI",,6,,272,106
20,"Gorj",181,"181-LICURICI",80711,177,2,667,274,197,77,269,5,"LICURICI",,6,,185,84
20,"Gorj",181,"181-LOGRESTI",80766,178,2,624,383,237,146,376,7,"LOGRESTI",,6,,261,115
20,"Gorj",181,"181-LOGRESTI",80766,179,2,944,521,375,146,518,3,"LOGRESTI",,6,,349,169
20,"Gorj",181,"181-LOGRESTI",80766,180,2,304,266,195,71,265,1,"LOGRESTI",,6,,199,66
20,"Gorj",181,"181-LOGRESTI",80766,181,2,418,305,216,89,252,53,"LOGRESTI",,6,,173,79
20,"Gorj",181,"181-MATASARI",80846,182,2,1922,1983,903,1080,1972,11,"MATASARI",,6,,1131,841
20,"Gorj",181,"181-MATASARI",80846,183,2,519,395,266,129,392,3,"MATASARI",,6,,267,125
20,"Gorj",181,"181-MATASARI",80846,184,2,334,284,208,76,279,5,"MATASARI",,6,,227,52
20,"Gorj",181,"181-MATASARI",80846,185,2,326,242,197,45,237,5,"MATASARI",,6,,176,61
20,"Gorj",181,"181-MUSETESTI",80908,186,2,1290,836,690,146,833,3,"MUSETESTI",,6,,605,228
20,"Gorj",181,"181-MUSETESTI",80908,187,2,566,334,280,54,332,2,"MUSETESTI",,6,,249,83
20,"Gorj",181,"181-NEGOMIR",80980,188,2,1159,725,609,116,719,6,"NEGOMIR",,6,,523,196
20,"Gorj",181,"181-NEGOMIR",80980,189,2,822,462,393,69,450,12,"NEGOMIR",,6,,347,103
20,"Gorj",181,"181-NEGOMIR",80980,190,2,741,561,458,103,559,2,"NEGOMIR",,6,,371,188
20,"Gorj",181,"181-PADES",81095,191,2,1159,774,618,156,768,6,"PADES",,6,,540,228
20,"Gorj",181,"181-PADES",81095,192,2,2423,1546,1352,194,1526,20,"PADES",,6,,1026,500
20,"Gorj",181,"181-PADES",81095,193,2,210,127,56,71,127,0,"PADES",,6,,58,69
20,"Gorj",181,"181-PESTISANI",81184,194,2,1233,919,671,248,913,6,"PESTISANI",,6,,591,322
20,"Gorj",181,"181-PESTISANI",81184,195,2,1626,1086,824,262,1075,11,"PESTISANI",,6,,685,390
20,"Gorj",181,"181-PLOPSORU",81264,196,2,1996,996,870,126,991,5,"PLOPSORU",,6,,651,340
20,"Gorj",181,"181-PLOPSORU",81264,197,2,811,457,365,92,452,5,"PLOPSORU",,6,,277,175
20,"Gorj",181,"181-PLOPSORU",81264,198,2,1153,688,616,72,684,4,"PLOPSORU",,6,,473,211
20,"Gorj",181,"181-PLOPSORU",81264,199,2,702,439,377,62,435,4,"PLOPSORU",,6,,252,183
20,"Gorj",181,"181-POLOVRAGI",81380,200,2,1902,1577,1448,129,1569,8,"POLOVRAGI",,6,,1123,446
20,"Gorj",181,"181-POLOVRAGI",81380,201,2,450,399,377,22,397,2,"POLOVRAGI",,6,,316,81
20,"Gorj",181,"181-PRIGORIA",81415,202,2,1711,1055,908,147,1050,5,"PRIGORIA",,6,,807,243
20,"Gorj",181,"181-PRIGORIA",81415,203,2,966,552,494,58,542,10,"PRIGORIA",,6,,429,113
20,"Gorj",181,"181-ROSIA DE AMARADIA",81497,204,2,2401,1423,1208,215,1409,14,"ROSIA DE AMARADIA",,6,,917,492
20,"Gorj",181,"181-RUNCU",81576,205,2,1098,747,573,174,737,10,"RUNCU",,6,,441,296
20,"Gorj",181,"181-RUNCU",81576,206,2,1200,841,660,181,830,11,"RUNCU",,6,,562,268
20,"Gorj",181,"181-RUNCU",81576,207,2,750,471,350,121,466,5,"RUNCU",,6,,302,164
20,"Gorj",181,"181-RUNCU",81576,208,2,1034,893,816,77,883,10,"RUNCU",,6,,582,301
20,"Gorj",181,"181-RUNCU",81576,209,2,220,246,162,84,246,0,"RUNCU",,6,,159,87
20,"Gorj",181,"181-RUNCU",81576,210,2,0,199,0,199,197,2,"RUNCU",,6,,90,107
20,"Gorj",181,"181-RUNCU",81576,211,2,0,39,0,39,39,0,"RUNCU",,6,,35,4
20,"Gorj",181,"181-SAMARINESTI",81656,212,2,889,698,562,136,695,3,"SAMARINESTI",,6,,536,159
20,"Gorj",181,"181-SAMARINESTI",81656,213,2,425,289,219,70,283,6,"SAMARINESTI",,6,,212,71
20,"Gorj",181,"181-SACELU",81754,214,2,1542,903,718,185,895,8,"SACELU",,6,,609,286
20,"Gorj",181,"181-SAULESTI",81816,215,2,1991,883,727,156,879,4,"SAULESTI",,6,,545,334
20,"Gorj",181,"181-SCOARTA",81861,216,2,796,758,397,361,745,13,"SCOARTA",,6,,515,230
20,"Gorj",181,"181-SCOARTA",81861,217,2,595,427,241,186,423,4,"SCOARTA",,6,,246,177
20,"Gorj",181,"181-SCOARTA",81861,218,2,870,498,325,173,490,8,"SCOARTA",,6,,305,185
20,"Gorj",181,"181-SCOARTA",81861,219,2,804,776,527,249,770,6,"SCOARTA",,6,,552,218
20,"Gorj",181,"181-SCHELA",81987,220,2,552,411,356,55,405,6,"SCHELA",,6,,256,149
20,"Gorj",181,"181-SCHELA",81987,221,2,584,410,386,24,405,5,"SCHELA",,6,,304,101
20,"Gorj",181,"181-SCHELA",81987,222,2,702,461,393,68,458,3,"SCHELA",,6,,326,132
20,"Gorj",181,"181-SLIVILESTI",82047,223,2,762,604,443,161,594,10,"SLIVILESTI",,6,,377,217
20,"Gorj",181,"181-SLIVILESTI",82047,224,2,878,585,465,120,584,1,"SLIVILESTI",,6,,450,134
20,"Gorj",181,"181-SLIVILESTI",82047,225,2,527,296,233,63,293,3,"SLIVILESTI",,6,,197,96
20,"Gorj",181,"181-SLIVILESTI",82047,226,2,435,239,180,59,237,2,"SLIVILESTI",,6,,156,81
20,"Gorj",181,"181-STANESTI",82136,227,2,1203,754,617,137,749,5,"STANESTI",,6,,455,294
20,"Gorj",181,"181-STANESTI",82136,228,2,966,606,443,163,595,11,"STANESTI",,6,,357,238
20,"Gorj",181,"181-STEJARI",82243,229,2,969,564,440,124,559,5,"STEJARI",,6,,386,173
20,"Gorj",181,"181-STEJARI",82243,230,2,454,332,245,87,330,2,"STEJARI",,6,,236,94
20,"Gorj",181,"181-STEJARI",82243,231,2,863,461,381,80,458,3,"STEJARI",,6,,289,169
20,"Gorj",181,"181-STOINA",82314,232,2,1852,1481,989,492,1466,15,"STOINA",,6,,915,551
20,"Gorj",181,"181-TELESTI",82396,233,2,1854,1129,959,170,1078,51,"TELESTI",,6,,668,410
20,"Gorj",181,"181-TISMANA",82449,234,2,1691,1200,924,276,1192,8,"TISMANA",,6,,597,595
20,"Gorj",181,"181-TISMANA",82449,235,2,1107,823,640,183,817,6,"TISMANA",,6,,449,368
20,"Gorj",181,"181-TISMANA",82449,236,2,998,700,634,66,692,8,"TISMANA",,6,,511,181
20,"Gorj",181,"181-TISMANA",82449,237,2,1345,758,540,218,752,6,"TISMANA",,6,,439,313
20,"Gorj",181,"181-TISMANA",82449,238,2,995,548,479,69,545,3,"TISMANA",,6,,358,187
20,"Gorj",181,"181-TURBUREA",82555,239,2,1086,854,647,207,845,9,"TURBUREA",,6,,608,237
20,"Gorj",181,"181-TURBUREA",82555,240,2,705,471,365,106,465,6,"TURBUREA",,6,,346,119
20,"Gorj",181,"181-TURBUREA",82555,241,2,1615,917,778,139,909,8,"TURBUREA",,6,,631,278
20,"Gorj",181,"181-TURCENI",82626,242,2,2760,2140,1306,834,2121,19,"TURCENI",,6,,1122,999
20,"Gorj",181,"181-TURCENI",82626,243,2,1243,827,710,117,822,5,"TURCENI",,6,,599,223
20,"Gorj",181,"181-TURCENI",82626,244,2,1125,796,648,148,794,2,"TURCENI",,6,,571,223
20,"Gorj",181,"181-TURCINESTI",78089,245,2,1149,840,712,128,832,8,"TURCINESTI",,6,,561,271
20,"Gorj",181,"181-TURCINESTI",78089,246,2,645,425,347,78,424,1,"TURCINESTI",,6,,273,151
20,"Gorj",181,"181-TINTARENI",82680,247,2,1644,1210,1062,148,1197,13,"TINTARENI",,6,,750,447
20,"Gorj",181,"181-TINTARENI",82680,248,2,873,605,472,133,602,3,"TINTARENI",,6,,364,238
20,"Gorj",181,"181-TINTARENI",82680,249,2,1215,805,667,138,792,13,"TINTARENI",,6,,501,291
20,"Gorj",181,"181-TINTARENI",82680,250,2,278,185,127,58,184,1,"TINTARENI",,6,,143,41
20,"Gorj",181,"181-URDARI",82733,251,2,2526,1464,1323,141,1456,8,"URDARI",,6,,1140,316
20,"Gorj",181,"181-VAGIULESTI",82779,252,2,1140,721,628,93,715,6,"VAGIULESTI",,6,,528,187
20,"Gorj",181,"181-VAGIULESTI",82779,253,2,1194,755,658,97,739,16,"VAGIULESTI",,6,,541,198
20,"Gorj",181,"181-VLADIMIR",82831,254,2,1161,720,543,177,716,4,"VLADIMIR",,6,,527,189
20,"Gorj",181,"181-VLADIMIR",82831,255,2,1137,580,436,144,572,8,"VLADIMIR",,6,,427,145
20,"Gorj",181,"181-VLADIMIR",82831,256,2,432,280,213,67,279,1,"VLADIMIR",,6,,195,84
21,"Harghita",190,"190-MUNICIPIUL MIERCUREA CIUC",83320,1,2,1979,1426,1278,148,1424,2,"MUNICIPIUL MIERCUREA CIUC",,7,,118,1306
21,"Harghita",190,"190-MUNICIPIUL MIERCUREA CIUC",83320,2,2,2160,1715,1466,249,1709,6,"MUNICIPIUL MIERCUREA CIUC",,7,,185,1524
21,"Harghita",190,"190-MUNICIPIUL MIERCUREA CIUC",83320,3,2,1588,1289,1065,224,1287,2,"MUNICIPIUL MIERCUREA CIUC",,7,,105,1182
21,"Harghita",190,"190-MUNICIPIUL MIERCUREA CIUC",83320,4,2,2475,1696,1656,40,1690,6,"MUNICIPIUL MIERCUREA CIUC",,7,,184,1506
21,"Harghita",190,"190-MUNICIPIUL MIERCUREA CIUC",83320,5,2,2149,1607,1447,160,1607,0,"MUNICIPIUL MIERCUREA CIUC",,7,,207,1400
21,"Harghita",190,"190-MUNICIPIUL MIERCUREA CIUC",83320,6,2,2059,1581,1434,147,1577,4,"MUNICIPIUL MIERCUREA CIUC",,7,,153,1424
21,"Harghita",190,"190-MUNICIPIUL MIERCUREA CIUC",83320,7,2,1904,1545,1293,252,1542,3,"MUNICIPIUL MIERCUREA CIUC",,7,,97,1445
21,"Harghita",190,"190-MUNICIPIUL MIERCUREA CIUC",83320,8,2,982,855,675,180,854,1,"MUNICIPIUL MIERCUREA CIUC",,7,,29,825
21,"Harghita",190,"190-MUNICIPIUL MIERCUREA CIUC",83320,9,2,1800,1425,1160,265,1422,3,"MUNICIPIUL MIERCUREA CIUC",,7,,106,1316
21,"Harghita",190,"190-MUNICIPIUL MIERCUREA CIUC",83320,10,2,889,788,668,120,787,1,"MUNICIPIUL MIERCUREA CIUC",,7,,14,773
21,"Harghita",190,"190-MUNICIPIUL MIERCUREA CIUC",83320,11,2,2494,1886,1711,175,1884,2,"MUNICIPIUL MIERCUREA CIUC",,7,,207,1677
21,"Harghita",190,"190-MUNICIPIUL MIERCUREA CIUC",83320,12,2,2429,1809,1675,134,1809,0,"MUNICIPIUL MIERCUREA CIUC",,7,,104,1705
21,"Harghita",190,"190-MUNICIPIUL MIERCUREA CIUC",83320,13,2,1695,1489,1090,399,1487,2,"MUNICIPIUL MIERCUREA CIUC",,7,,214,1273
21,"Harghita",190,"190-MUNICIPIUL MIERCUREA CIUC",83320,14,2,3130,2230,1941,289,2225,5,"MUNICIPIUL MIERCUREA CIUC",,7,,230,1995
21,"Harghita",190,"190-MUNICIPIUL MIERCUREA CIUC",83320,15,2,842,638,586,52,637,1,"MUNICIPIUL MIERCUREA CIUC",,7,,34,603
21,"Harghita",190,"190-MUNICIPIUL MIERCUREA CIUC",83320,16,2,2435,1892,1638,254,1888,4,"MUNICIPIUL MIERCUREA CIUC",,7,,162,1726
21,"Harghita",190,"190-MUNICIPIUL MIERCUREA CIUC",83320,17,2,1491,1276,1139,137,1268,8,"MUNICIPIUL MIERCUREA CIUC",,7,,22,1246
21,"Harghita",190,"190-MUNICIPIUL MIERCUREA CIUC",83320,18,2,1228,1076,991,85,1074,2,"MUNICIPIUL MIERCUREA CIUC",,7,,10,1064
21,"Harghita",190,"190-MUNICIPIUL MIERCUREA CIUC",83320,19,2,121,192,72,120,192,0,"MUNICIPIUL MIERCUREA CIUC",,7,,11,181
21,"Harghita",190,"190-MUNICIPIUL MIERCUREA CIUC",83320,20,2,0,563,0,563,554,9,"MUNICIPIUL MIERCUREA CIUC",,7,,309,245
21,"Harghita",190,"190-MUNICIPIUL MIERCUREA CIUC",83320,21,2,0,525,0,525,523,2,"MUNICIPIUL MIERCUREA CIUC",,7,,34,489
21,"Harghita",190,"190-MUNICIPIUL MIERCUREA CIUC",83320,22,2,57,80,54,26,80,0,"MUNICIPIUL MIERCUREA CIUC",,7,,25,55
21,"Harghita",190,"190-MUNICIPIUL MIERCUREA CIUC",83320,23,2,240,248,221,27,248,0,"MUNICIPIUL MIERCUREA CIUC",,7,,131,117
21,"Harghita",190,"190-MUNICIPIUL ODORHEIU SECUIESC",83133,24,2,1309,1341,1068,273,1340,1,"MUNICIPIUL ODORHEIU SECUIESC",,7,,22,1318
21,"Harghita",190,"190-MUNICIPIUL ODORHEIU SECUIESC",83133,25,2,1554,1456,1214,242,1452,4,"MUNICIPIUL ODORHEIU SECUIESC",,7,,27,1425
21,"Harghita",190,"190-MUNICIPIUL ODORHEIU SECUIESC",83133,26,2,1536,1456,1177,279,1453,3,"MUNICIPIUL ODORHEIU SECUIESC",,7,,23,1430
21,"Harghita",190,"190-MUNICIPIUL ODORHEIU SECUIESC",83133,27,2,1279,1211,998,213,1206,5,"MUNICIPIUL ODORHEIU SECUIESC",,7,,49,1157
21,"Harghita",190,"190-MUNICIPIUL ODORHEIU SECUIESC",83133,28,2,1114,1145,905,240,1143,2,"MUNICIPIUL ODORHEIU SECUIESC",,7,,18,1125
21,"Harghita",190,"190-MUNICIPIUL ODORHEIU SECUIESC",83133,29,2,1210,1340,1008,332,1337,3,"MUNICIPIUL ODORHEIU SECUIESC",,7,,17,1320
21,"Harghita",190,"190-MUNICIPIUL ODORHEIU SECUIESC",83133,30,2,1157,1225,933,292,1221,4,"MUNICIPIUL ODORHEIU SECUIESC",,7,,22,1199
21,"Harghita",190,"190-MUNICIPIUL ODORHEIU SECUIESC",83133,31,2,1800,1553,1384,169,1553,0,"MUNICIPIUL ODORHEIU SECUIESC",,7,,26,1527
21,"Harghita",190,"190-MUNICIPIUL ODORHEIU SECUIESC",83133,32,2,1869,1643,1439,204,1641,2,"MUNICIPIUL ODORHEIU SECUIESC",,7,,18,1623
21,"Harghita",190,"190-MUNICIPIUL ODORHEIU SECUIESC",83133,33,2,1892,1663,1459,204,1661,2,"MUNICIPIUL ODORHEIU SECUIESC",,7,,19,1642
21,"Harghita",190,"190-MUNICIPIUL ODORHEIU SECUIESC",83133,34,2,1486,1270,1169,101,1268,2,"MUNICIPIUL ODORHEIU SECUIESC",,7,,10,1258
21,"Harghita",190,"190-MUNICIPIUL ODORHEIU SECUIESC",83133,35,2,1650,1537,1348,189,1537,0,"MUNICIPIUL ODORHEIU SECUIESC",,7,,12,1525
21,"Harghita",190,"190-MUNICIPIUL ODORHEIU SECUIESC",83133,36,2,1357,1116,924,192,1113,3,"MUNICIPIUL ODORHEIU SECUIESC",,7,,25,1088
21,"Harghita",190,"190-MUNICIPIUL ODORHEIU SECUIESC",83133,37,2,1941,1771,1464,307,1769,2,"MUNICIPIUL ODORHEIU SECUIESC",,7,,23,1746
21,"Harghita",190,"190-MUNICIPIUL ODORHEIU SECUIESC",83133,38,2,1232,935,810,125,933,2,"MUNICIPIUL ODORHEIU SECUIESC",,7,,7,926
21,"Harghita",190,"190-MUNICIPIUL ODORHEIU SECUIESC",83133,39,2,1857,1627,1522,105,1623,4,"MUNICIPIUL ODORHEIU SECUIESC",,7,,18,1605
21,"Harghita",190,"190-MUNICIPIUL ODORHEIU SECUIESC",83133,40,2,994,1108,813,295,1102,6,"MUNICIPIUL ODORHEIU SECUIESC",,7,,15,1087
21,"Harghita",190,"190-MUNICIPIUL ODORHEIU SECUIESC",83133,41,2,0,263,0,263,263,0,"MUNICIPIUL ODORHEIU SECUIESC",,7,,155,108
21,"Harghita",190,"190-MUNICIPIUL ODORHEIU SECUIESC",83133,42,2,65,333,58,275,333,0,"MUNICIPIUL ODORHEIU SECUIESC",,7,,28,305
21,"Harghita",190,"190-ORAS BAILE TUSNAD",83428,43,2,1509,1353,1113,240,1348,5,"ORAS BAILE TUSNAD",,7,,105,1243
21,"Harghita",190,"190-ORAS BALAN",83464,44,2,2252,1715,1320,395,1711,4,"ORAS BALAN",,7,,553,1158
21,"Harghita",190,"190-ORAS BALAN",83464,45,2,2156,1401,1156,245,1388,13,"ORAS BALAN",,7,,568,820
21,"Harghita",190,"190-ORAS BALAN",83464,46,2,2669,1615,1310,305,1605,10,"ORAS BALAN",,7,,757,848
21,"Harghita",190,"190-ORAS BORSEC",83491,47,2,2243,2041,1829,212,2033,8,"ORAS BORSEC",,7,,226,1807
21,"Harghita",190,"190-ORAS CRISTURU SECUIESC",83525,48,2,1140,973,900,73,970,3,"ORAS CRISTURU SECUIESC",,7,,8,962
21,"Harghita",190,"190-ORAS CRISTURU SECUIESC",83525,49,2,1099,926,881,45,926,0,"ORAS CRISTURU SECUIESC",,7,,15,911
21,"Harghita",190,"190-ORAS CRISTURU SECUIESC",83525,50,2,1301,1161,1014,147,1161,0,"ORAS CRISTURU SECUIESC",,7,,20,1141
21,"Harghita",190,"190-ORAS CRISTURU SECUIESC",83525,51,2,1357,1215,1146,69,1211,4,"ORAS CRISTURU SECUIESC",,7,,14,1197
21,"Harghita",190,"190-ORAS CRISTURU SECUIESC",83525,52,2,2068,1712,1647,65,1704,8,"ORAS CRISTURU SECUIESC",,7,,15,1689
21,"Harghita",190,"190-ORAS CRISTURU SECUIESC",83525,53,2,750,719,689,30,716,3,"ORAS CRISTURU SECUIESC",,7,,6,710
21,"Harghita",190,"190-ORAS GHEORGHENI",83561,54,2,3261,2511,2234,277,2508,3,"ORAS GHEORGHENI",,7,,196,2312
21,"Harghita",190,"190-ORAS GHEORGHENI",83561,55,2,2219,1686,1544,142,1681,5,"ORAS GHEORGHENI",,7,,59,1622
21,"Harghita",190,"190-ORAS GHEORGHENI",83561,56,2,3121,2373,2035,338,2371,2,"ORAS GHEORGHENI",,7,,117,2254
21,"Harghita",190,"190-ORAS GHEORGHENI",83561,57,2,2506,2163,1800,363,2153,10,"ORAS GHEORGHENI",,7,,102,2051
21,"Harghita",190,"190-ORAS GHEORGHENI",83561,58,2,2468,2223,1840,383,2211,12,"ORAS GHEORGHENI",,7,,69,2142
21,"Harghita",190,"190-ORAS GHEORGHENI",83561,59,2,2211,1865,1723,142,1852,13,"ORAS GHEORGHENI",,7,,18,1834
21,"Harghita",190,"190-ORAS GHEORGHENI",83561,60,2,63,149,52,97,148,1,"ORAS GHEORGHENI",,7,,45,103
21,"Harghita",190,"190-ORAS GHEORGHENI",83561,61,2,0,375,0,375,372,3,"ORAS GHEORGHENI",,7,,198,174
21,"Harghita",190,"190-ORAS TOPLITA",83632,62,2,1859,1490,1330,160,1482,8,"ORAS TOPLITA",,7,,490,992
21,"Harghita",190,"190-ORAS TOPLITA",83632,63,2,1134,1033,797,236,1022,11,"ORAS TOPLITA",,7,,382,640
21,"Harghita",190,"190-ORAS TOPLITA",83632,64,2,2259,1706,1519,187,1688,18,"ORAS TOPLITA",,7,,589,1099
21,"Harghita",190,"190-ORAS TOPLITA",83632,65,2,1371,966,913,53,961,5,"ORAS TOPLITA",,7,,396,565
21,"Harghita",190,"190-ORAS TOPLITA",83632,66,2,1533,1249,1154,95,1246,3,"ORAS TOPLITA",,7,,693,553
21,"Harghita",190,"190-ORAS TOPLITA",83632,67,2,2073,1550,1373,177,1541,9,"ORAS TOPLITA",,7,,464,1077
21,"Harghita",190,"190-ORAS TOPLITA",83632,68,2,1328,889,754,135,882,7,"ORAS TOPLITA",,7,,237,645
21,"Harghita",190,"190-ORAS TOPLITA",83632,69,2,915,746,690,56,739,7,"ORAS TOPLITA",,7,,488,251
21,"Harghita",190,"190-ORAS TOPLITA",83632,70,2,59,115,47,68,114,1,"ORAS TOPLITA",,7,,51,63
21,"Harghita",190,"190-ORAS VLAHITA",83749,71,2,1128,912,856,56,912,0,"ORAS VLAHITA",,7,,11,901
21,"Harghita",190,"190-ORAS VLAHITA",83749,72,2,1347,1269,1203,66,1261,8,"ORAS VLAHITA",,7,,5,1256
21,"Harghita",190,"190-ORAS VLAHITA",83749,73,2,1873,1624,1533,91,1621,3,"ORAS VLAHITA",,7,,20,1601
21,"Harghita",190,"190-ORAS VLAHITA",83749,74,2,1173,1038,952,86,1038,0,"ORAS VLAHITA",,7,,13,1025
21,"Harghita",190,"190-ATID",83785,75,2,824,764,711,53,762,2,"ATID",,7,,12,750
21,"Harghita",190,"190-ATID",83785,76,2,589,432,397,35,428,4,"ATID",,7,,10,418
21,"Harghita",190,"190-ATID",83785,77,2,381,364,330,34,364,0,"ATID",,7,,0,364
21,"Harghita",190,"190-ATID",83785,78,2,328,288,264,24,288,0,"ATID",,7,,1,287
21,"Harghita",190,"190-ATID",83785,79,2,210,191,181,10,191,0,"ATID",,7,,1,190
21,"Harghita",190,"190-AVRAMESTI",83847,80,2,743,680,655,25,676,4,"AVRAMESTI",,7,,9,667
21,"Harghita",190,"190-AVRAMESTI",83847,81,2,370,347,335,12,345,2,"AVRAMESTI",,7,,3,342
21,"Harghita",190,"190-AVRAMESTI",83847,82,2,459,434,421,13,434,0,"AVRAMESTI",,7,,0,434
21,"Harghita",190,"190-AVRAMESTI",83847,83,2,255,221,209,12,221,0,"AVRAMESTI",,7,,2,219
21,"Harghita",190,"190-BILBOR",83936,84,2,2132,1587,1516,71,1584,3,"BILBOR",,7,,1236,348
21,"Harghita",190,"190-BRADESTI",83151,85,2,664,668,620,48,667,1,"BRADESTI",,7,,2,665
21,"Harghita",190,"190-BRADESTI",83151,86,2,505,530,490,40,524,6,"BRADESTI",,7,,3,521
21,"Harghita",190,"190-BRADESTI",83151,87,2,1366,1326,1195,131,1319,7,"BRADESTI",,7,,43,1276
21,"Harghita",190,"190-CAPALNITA",83963,88,2,1443,1415,1379,36,1414,1,"CAPALNITA",,7,,5,1409
21,"Harghita",190,"190-CIUCSANGEORGIU",83981,89,2,1466,1288,1244,44,1271,17,"CIUCSANGEORGIU",,7,,19,1252
21,"Harghita",190,"190-CIUCSANGEORGIU",83981,90,2,1026,961,913,48,946,15,"CIUCSANGEORGIU",,7,,18,928
21,"Harghita",190,"190-CIUCSANGEORGIU",83981,91,2,1312,1117,1065,52,1111,6,"CIUCSANGEORGIU",,7,,23,1088
21,"Harghita",190,"190-CIUMANI",84086,92,2,2082,1774,1674,100,1772,2,"CIUMANI",,7,,11,1761
21,"Harghita",190,"190-CIUMANI",84086,93,2,1552,1295,1202,93,1286,9,"CIUMANI",,7,,32,1254
21,"Harghita",190,"190-CARTA",84102,94,2,2295,2215,2151,64,2211,4,"CARTA",,7,,8,2203
21,"Harghita",190,"190-CARTA",84102,95,2,2049,2066,2019,47,2058,8,"CARTA",,7,,5,2053
21,"Harghita",190,"190-CORBU",84148,96,2,804,630,580,50,624,6,"CORBU",,7,,376,248
21,"Harghita",190,"190-CORBU",84148,97,2,408,332,308,24,327,5,"CORBU",,7,,211,116
21,"Harghita",190,"190-CORUND",84175,98,2,1674,1370,1321,49,1361,9,"CORUND",,7,,16,1345
21,"Harghita",190,"190-CORUND",84175,99,2,1643,1359,1316,43,1354,5,"CORUND",,7,,3,1351
21,"Harghita",190,"190-CORUND",84175,100,2,250,253,216,37,253,0,"CORUND",,7,,1,252
21,"Harghita",190,"190-CORUND",84175,101,2,271,233,216,17,233,0,"CORUND",,7,,0,233
21,"Harghita",190,"190-CORUND",84175,102,2,312,260,253,7,260,0,"CORUND",,7,,1,259
21,"Harghita",190,"190-DANESTI",84237,103,2,1843,1730,1691,39,1723,7,"DANESTI",,7,,11,1712
21,"Harghita",190,"190-DANESTI",84237,104,2,1717,1687,1646,41,1678,9,"DANESTI",,7,,25,1653
21,"Harghita",190,"190-DEALU",84264,105,2,1384,1328,1296,32,1326,2,"DEALU",,7,,14,1312
21,"Harghita",190,"190-DEALU",84264,106,2,929,814,798,16,813,1,"DEALU",,7,,7,806
21,"Harghita",190,"190-DEALU",84264,107,2,486,491,450,41,485,6,"DEALU",,7,,14,471
21,"Harghita",190,"190-DITRAU",84344,108,2,1503,1362,1226,136,1356,6,"DITRAU",,7,,14,1342
21,"Harghita",190,"190-DITRAU",84344,109,2,849,795,722,73,794,1,"DITRAU",,7,,2,792
21,"Harghita",190,"190-DITRAU",84344,110,2,956,835,760,75,835,0,"DITRAU",,7,,4,831
21,"Harghita",190,"190-DITRAU",84344,111,2,888,663,626,37,659,4,"DITRAU",,7,,3,656
21,"Harghita",190,"190-DITRAU",84344,112,2,448,408,362,46,406,2,"DITRAU",,7,,4,402
21,"Harghita",190,"190-DARJIU",84380,113,2,638,636,589,47,636,0,"DARJIU",,7,,7,629
21,"Harghita",190,"190-DARJIU",84380,114,2,347,345,323,22,344,1,"DARJIU",,7,,8,336
21,"Harghita",190,"190-FELICENI",83197,115,2,646,644,606,38,644,0,"FELICENI",,7,,2,642
21,"Harghita",190,"190-FELICENI",83197,116,2,499,503,457,46,499,4,"FELICENI",,7,,4,495
21,"Harghita",190,"190-FELICENI",83197,117,2,632,649,611,38,649,0,"FELICENI",,7,,3,646
21,"Harghita",190,"190-FELICENI",83197,118,2,243,249,209,40,249,0,"FELICENI",,7,,2,247
21,"Harghita",190,"190-FELICENI",83197,119,2,215,221,202,19,221,0,"FELICENI",,7,,0,221
21,"Harghita",190,"190-FRUMOASA",84415,120,2,1385,1370,1312,58,1368,2,"FRUMOASA",,7,,19,1349
21,"Harghita",190,"190-FRUMOASA",84415,121,2,1418,1282,1226,56,1277,5,"FRUMOASA",,7,,3,1274
21,"Harghita",190,"190-FRUMOASA",84415,122,2,119,114,104,10,114,0,"FRUMOASA",,7,,5,109
21,"Harghita",190,"190-GALAUTAS",84460,123,2,1839,1560,1417,143,1548,12,"GALAUTAS",,7,,722,826
21,"Harghita",190,"190-JOSENI",84558,124,2,1904,1725,1623,102,1722,3,"JOSENI",,7,,20,1702
21,"Harghita",190,"190-JOSENI",84558,125,2,2147,1967,1849,118,1956,11,"JOSENI",,7,,38,1918
21,"Harghita",190,"190-JOSENI",84558,126,2,640,566,510,56,563,3,"JOSENI",,7,,8,555
21,"Harghita",190,"190-LAZAREA",84594,127,2,1120,962,893,69,959,3,"LAZAREA",,7,,9,950
21,"Harghita",190,"190-LAZAREA",84594,128,2,814,743,633,110,743,0,"LAZAREA",,7,,9,734
21,"Harghita",190,"190-LAZAREA",84594,129,2,863,856,775,81,855,1,"LAZAREA",,7,,14,841
21,"Harghita",190,"190-LAZAREA",84594,130,2,113,110,79,31,110,0,"LAZAREA",,7,,2,108
21,"Harghita",190,"190-LUETA",84629,131,2,1489,1048,990,58,1046,2,"LUETA",,7,,9,1037
21,"Harghita",190,"190-LUETA",84629,132,2,1485,1054,985,69,1054,0,"LUETA",,7,,11,1043
21,"Harghita",190,"190-LUNCA DE JOS",84656,133,2,1244,1239,1215,24,1237,2,"LUNCA DE JOS",,7,,8,1229
21,"Harghita",190,"190-LUNCA DE JOS",84656,134,2,1287,1217,1159,58,1196,21,"LUNCA DE JOS",,7,,6,1190
21,"Harghita",190,"190-LUNCA DE JOS",84656,135,2,1167,1187,1113,74,1180,7,"LUNCA DE JOS",,7,,5,1175
21,"Harghita",190,"190-LUNCA DE SUS",84754,136,2,1632,1643,1591,52,1634,9,"LUNCA DE SUS",,7,,49,1585
21,"Harghita",190,"190-LUNCA DE SUS",84754,137,2,776,714,689,25,709,5,"LUNCA DE SUS",,7,,6,703
21,"Harghita",190,"190-LUNCA DE SUS",84754,138,2,474,390,338,52,379,11,"LUNCA DE SUS",,7,,233,146
21,"Harghita",190,"190-LUPENI",84825,139,2,1759,1653,1625,28,1649,4,"LUPENI",,7,,11,1638
21,"Harghita",190,"190-LUPENI",84825,140,2,1217,1248,1188,60,1248,0,"LUPENI",,7,,3,1245
21,"Harghita",190,"190-LUPENI",84825,141,2,311,326,295,31,326,0,"LUPENI",,7,,2,324
21,"Harghita",190,"190-MARTINIS",84923,142,2,586,615,561,54,613,2,"MARTINIS",,7,,17,596
21,"Harghita",190,"190-MARTINIS",84923,143,2,415,409,377,32,407,2,"MARTINIS",,7,,2,405
21,"Harghita",190,"190-MARTINIS",84923,144,2,192,212,190,22,212,0,"MARTINIS",,7,,3,209
21,"Harghita",190,"190-MARTINIS",84923,145,2,188,182,178,4,180,2,"MARTINIS",,7,,3,177
21,"Harghita",190,"190-MARTINIS",84923,146,2,641,651,617,34,651,0,"MARTINIS",,7,,9,642
21,"Harghita",190,"190-MARTINIS",84923,147,2,250,265,246,19,264,1,"MARTINIS",,7,,2,262
21,"Harghita",190,"190-MERESTI",85056,148,2,1148,1054,979,75,1054,0,"MERESTI",,7,,15,1039
21,"Harghita",190,"190-MIHAILENI",85074,149,2,1498,1498,1410,88,1490,8,"MIHAILENI",,7,,9,1481
21,"Harghita",190,"190-MIHAILENI",85074,150,2,442,447,411,36,444,3,"MIHAILENI",,7,,356,88
21,"Harghita",190,"190-MUGENI",85127,151,2,951,861,789,72,861,0,"MUGENI",,7,,19,842
21,"Harghita",190,"190-MUGENI",85127,152,2,1010,952,884,68,949,3,"MUGENI",,7,,2,947
21,"Harghita",190,"190-MUGENI",85127,153,2,720,691,645,46,690,1,"MUGENI",,7,,15,675
21,"Harghita",190,"190-MUGENI",85127,154,2,903,829,748,81,827,2,"MUGENI",,7,,10,817
21,"Harghita",190,"190-MUGENI",85127,155,2,339,349,304,45,346,3,"MUGENI",,7,,2,344
21,"Harghita",190,"190-MUGENI",85127,156,2,467,438,402,36,435,3,"MUGENI",,7,,8,427
21,"Harghita",190,"190-OCLAND",85243,157,2,610,623,594,29,623,0,"OCLAND",,7,,12,611
21,"Harghita",190,"190-OCLAND",85243,158,2,379,377,343,34,377,0,"OCLAND",,7,,8,369
21,"Harghita",190,"190-PAULENI-CIUC",83375,159,2,455,421,389,32,420,1,"PAULENI-CIUC",,7,,8,412
21,"Harghita",190,"190-PAULENI-CIUC",83375,160,2,453,417,373,44,416,1,"PAULENI-CIUC",,7,,2,414
21,"Harghita",190,"190-PAULENI-CIUC",83375,161,2,369,374,326,48,373,1,"PAULENI-CIUC",,7,,7,366
21,"Harghita",190,"190-PLAIESII DE JOS",85289,162,2,1217,1148,998,150,1136,12,"PLAIESII DE JOS",,7,,62,1074
21,"Harghita",190,"190-PLAIESII DE JOS",85289,163,2,359,321,312,9,312,9,"PLAIESII DE JOS",,7,,60,252
21,"Harghita",190,"190-PLAIESII DE JOS",85289,164,2,646,650,612,38,646,4,"PLAIESII DE JOS",,7,,13,633
21,"Harghita",190,"190-PRAID",85341,165,2,1286,1239,1183,56,1235,4,"PRAID",,7,,18,1217
21,"Harghita",190,"190-PRAID",85341,166,2,1405,1394,1333,61,1378,16,"PRAID",,7,,7,1371
21,"Harghita",190,"190-PRAID",85341,167,2,1260,1191,1150,41,1176,15,"PRAID",,7,,6,1170
21,"Harghita",190,"190-PRAID",85341,168,2,999,979,942,37,972,7,"PRAID",,7,,7,965
21,"Harghita",190,"190-PRAID",85341,169,2,113,79,73,6,79,0,"PRAID",,7,,0,79
21,"Harghita",190,"190-REMETEA",85412,170,2,1504,1403,1376,27,1396,7,"REMETEA",,7,,12,1384
21,"Harghita",190,"190-REMETEA",85412,171,2,1758,1549,1483,66,1545,4,"REMETEA",,7,,15,1530
21,"Harghita",190,"190-REMETEA",85412,172,2,1512,1321,1295,26,1319,2,"REMETEA",,7,,16,1303
21,"Harghita",190,"190-SACEL",85467,173,2,133,137,118,19,135,2,"SACEL",,7,,89,46
21,"Harghita",190,"190-SACEL",85467,174,2,222,216,196,20,213,3,"SACEL",,7,,50,163
21,"Harghita",190,"190-SACEL",85467,175,2,401,367,357,10,365,2,"SACEL",,7,,21,344
21,"Harghita",190,"190-SACEL",85467,176,2,301,270,257,13,268,2,"SACEL",,7,,10,258
21,"Harghita",190,"190-SACEL",85467,177,2,781,757,706,51,752,5,"SACEL",,7,,8,744
21,"Harghita",190,"190-SARMAS",85528,178,2,1566,1303,1197,106,1298,5,"SARMAS",,7,,770,528
21,"Harghita",190,"190-SARMAS",85528,179,2,383,362,314,48,362,0,"SARMAS",,7,,267,95
21,"Harghita",190,"190-SARMAS",85528,180,2,1120,938,806,132,927,11,"SARMAS",,7,,366,561
21,"Harghita",190,"190-SECUIENI",85582,181,2,1054,928,878,50,925,3,"SECUIENI",,7,,21,904
21,"Harghita",190,"190-SICULENI",85626,182,2,822,814,734,80,810,4,"SICULENI",,7,,62,748
21,"Harghita",190,"190-SICULENI",85626,183,2,1242,939,918,21,934,5,"SICULENI",,7,,7,927
21,"Harghita",190,"190-SICULENI",85626,184,2,1978,1750,1716,34,1748,2,"SICULENI",,7,,17,1731
21,"Harghita",190,"190-SICULENI",85626,185,2,817,737,694,43,733,4,"SICULENI",,7,,11,722
21,"Harghita",190,"190-SICULENI",85626,186,2,341,335,324,11,335,0,"SICULENI",,7,,3,332
21,"Harghita",190,"190-SANCRAIENI",85680,187,2,1841,1661,1578,83,1644,17,"SANCRAIENI",,7,,27,1617
21,"Harghita",190,"190-SANCRAIENI",85680,188,2,1457,1254,1180,74,1250,4,"SANCRAIENI",,7,,7,1243
21,"Harghita",190,"190-SANCRAIENI",85680,189,2,734,647,598,49,646,1,"SANCRAIENI",,7,,6,640
21,"Harghita",190,"190-SANCRAIENI",85680,190,2,448,458,396,62,457,1,"SANCRAIENI",,7,,2,455
21,"Harghita",190,"190-SANDOMINIC",85760,191,2,2925,2580,2509,71,2557,23,"SANDOMINIC",,7,,17,2540
21,"Harghita",190,"190-SANDOMINIC",85760,192,2,2040,1910,1850,60,1893,17,"SANDOMINIC",,7,,6,1887
21,"Harghita",190,"190-SANMARTIN",85788,193,2,1676,1642,1532,110,1640,2,"SANMARTIN",,7,,16,1624
21,"Harghita",190,"190-SANMARTIN",85788,194,2,976,946,865,81,942,4,"SANMARTIN",,7,,14,928
21,"Harghita",190,"190-SANMARTIN",85788,195,2,446,452,422,30,450,2,"SANMARTIN",,7,,14,436
21,"Harghita",190,"190-SANSIMION",85840,196,2,2519,2361,2247,114,2356,5,"SANSIMION",,7,,17,2339
21,"Harghita",190,"190-SUBCETATE",85877,197,2,1778,1271,1160,111,1260,11,"SUBCETATE",,7,,738,522
21,"Harghita",190,"190-SUSENI",85920,198,2,1642,1575,1537,38,1572,3,"SUSENI",,7,,24,1548
21,"Harghita",190,"190-SUSENI",85920,199,2,715,675,663,12,672,3,"SUSENI",,7,,7,665
21,"Harghita",190,"190-SUSENI",85920,200,2,650,578,543,35,569,9,"SUSENI",,7,,12,557
21,"Harghita",190,"190-SUSENI",85920,201,2,1145,1071,1017,54,1052,19,"SUSENI",,7,,14,1038
21,"Harghita",190,"190-SIMONESTI",85984,202,2,1049,867,791,76,863,4,"SIMONESTI",,7,,17,846
21,"Harghita",190,"190-SIMONESTI",85984,203,2,407,414,381,33,413,1,"SIMONESTI",,7,,1,412
21,"Harghita",190,"190-SIMONESTI",85984,204,2,579,591,537,54,589,2,"SIMONESTI",,7,,2,587
21,"Harghita",190,"190-SIMONESTI",85984,205,2,381,388,354,34,388,0,"SIMONESTI",,7,,3,385
21,"Harghita",190,"190-SIMONESTI",85984,206,2,450,444,410,34,444,0,"SIMONESTI",,7,,2,442
21,"Harghita",190,"190-TULGHES",86133,207,2,1316,1165,945,220,1159,6,"TULGHES",,7,,405,754
21,"Harghita",190,"190-TULGHES",86133,208,2,395,366,338,28,361,5,"TULGHES",,7,,249,112
21,"Harghita",190,"190-TULGHES",86133,209,2,255,211,192,19,210,1,"TULGHES",,7,,69,141
21,"Harghita",190,"190-TULGHES",86133,210,2,593,523,489,34,514,9,"TULGHES",,7,,261,253
21,"Harghita",190,"190-TUSNAD",86188,211,2,850,734,676,58,730,4,"TUSNAD",,7,,11,719
21,"Harghita",190,"190-TUSNAD",86188,212,2,749,674,596,78,671,3,"TUSNAD",,7,,9,662
21,"Harghita",190,"190-ULIES",86222,213,2,263,283,243,40,283,0,"ULIES",,7,,0,283
21,"Harghita",190,"190-ULIES",86222,214,2,261,262,222,40,262,0,"ULIES",,7,,4,258
21,"Harghita",190,"190-ULIES",86222,215,2,173,176,141,35,173,3,"ULIES",,7,,1,172
21,"Harghita",190,"190-ULIES",86222,216,2,222,250,188,62,249,1,"ULIES",,7,,0,249
21,"Harghita",190,"190-VARSAG",86311,217,2,1264,1047,1010,37,1046,1,"VARSAG",,7,,6,1040
21,"Harghita",190,"190-VOSLOBENI",86339,218,2,960,768,676,92,763,5,"VOSLOBENI",,7,,383,380
21,"Harghita",190,"190-VOSLOBENI",86339,219,2,624,523,418,105,520,3,"VOSLOBENI",,7,,193,327
21,"Harghita",190,"190-ZETEA",86366,220,2,2008,1821,1761,60,1817,4,"ZETEA",,7,,5,1812
21,"Harghita",190,"190-ZETEA",86366,221,2,1434,1303,1281,22,1301,2,"ZETEA",,7,,3,1298
21,"Harghita",190,"190-ZETEA",86366,222,2,515,501,452,49,501,0,"ZETEA",,7,,10,491
21,"Harghita",190,"190-ZETEA",86366,223,2,146,183,143,40,183,0,"ZETEA",,7,,3,180
21,"Harghita",190,"190-ZETEA",86366,224,2,312,288,250,38,287,1,"ZETEA",,7,,0,287
22,"Hunedoara",207,"207-MUNICIPIUL DEVA",86687,1,2,1709,1395,1166,229,1390,5,"MUNICIPIUL DEVA",,7,,537,853
22,"Hunedoara",207,"207-MUNICIPIUL DEVA",86687,2,2,1728,1168,1058,110,1164,4,"MUNICIPIUL DEVA",,7,,504,660
22,"Hunedoara",207,"207-MUNICIPIUL DEVA",86687,3,2,1236,960,903,57,958,2,"MUNICIPIUL DEVA",,7,,335,623
22,"Hunedoara",207,"207-MUNICIPIUL DEVA",86687,4,2,1497,1192,1063,129,1190,2,"MUNICIPIUL DEVA",,7,,425,765
22,"Hunedoara",207,"207-MUNICIPIUL DEVA",86687,5,2,1417,1166,1051,115,1163,3,"MUNICIPIUL DEVA",,7,,420,743
22,"Hunedoara",207,"207-MUNICIPIUL DEVA",86687,6,2,1693,1280,1114,166,1273,7,"MUNICIPIUL DEVA",,7,,412,861
22,"Hunedoara",207,"207-MUNICIPIUL DEVA",86687,7,2,1955,1505,1354,151,1502,3,"MUNICIPIUL DEVA",,7,,518,984
22,"Hunedoara",207,"207-MUNICIPIUL DEVA",86687,8,2,1700,1377,1201,176,1373,4,"MUNICIPIUL DEVA",,7,,546,827
22,"Hunedoara",207,"207-MUNICIPIUL DEVA",86687,9,2,1718,1353,1231,122,1352,1,"MUNICIPIUL DEVA",,7,,487,865
22,"Hunedoara",207,"207-MUNICIPIUL DEVA",86687,10,2,1713,1382,1190,192,1378,4,"MUNICIPIUL DEVA",,7,,483,895
22,"Hunedoara",207,"207-MUNICIPIUL DEVA",86687,11,2,1585,1235,1148,87,1233,2,"MUNICIPIUL DEVA",,7,,377,856
22,"Hunedoara",207,"207-MUNICIPIUL DEVA",86687,12,2,1263,1120,740,380,1115,5,"MUNICIPIUL DEVA",,7,,257,858
22,"Hunedoara",207,"207-MUNICIPIUL DEVA",86687,13,2,1582,1295,1009,286,1291,4,"MUNICIPIUL DEVA",,7,,442,849
22,"Hunedoara",207,"207-MUNICIPIUL DEVA",86687,14,2,1829,1249,1112,137,1238,11,"MUNICIPIUL DEVA",,7,,430,808
22,"Hunedoara",207,"207-MUNICIPIUL DEVA",86687,15,2,1604,1642,1170,472,1636,6,"MUNICIPIUL DEVA",,7,,597,1039
22,"Hunedoara",207,"207-MUNICIPIUL DEVA",86687,16,2,1655,1273,1202,71,1269,4,"MUNICIPIUL DEVA",,7,,406,863
22,"Hunedoara",207,"207-MUNICIPIUL DEVA",86687,17,2,1354,1016,916,100,1012,4,"MUNICIPIUL DEVA",,7,,335,677
22,"Hunedoara",207,"207-MUNICIPIUL DEVA",86687,18,2,1527,1127,1008,119,1123,4,"MUNICIPIUL DEVA",,7,,400,723
22,"Hunedoara",207,"207-MUNICIPIUL DEVA",86687,19,2,1657,1249,1152,97,1242,7,"MUNICIPIUL DEVA",,7,,397,845
22,"Hunedoara",207,"207-MUNICIPIUL DEVA",86687,20,2,2007,1494,1386,108,1488,6,"MUNICIPIUL DEVA",,7,,565,923
22,"Hunedoara",207,"207-MUNICIPIUL DEVA",86687,21,2,1099,1050,704,346,1036,14,"MUNICIPIUL DEVA",,7,,342,694
22,"Hunedoara",207,"207-MUNICIPIUL DEVA",86687,22,2,1275,1176,934,242,1171,5,"MUNICIPIUL DEVA",,7,,289,882
22,"Hunedoara",207,"207-MUNICIPIUL DEVA",86687,23,2,1536,1243,1016,227,1241,2,"MUNICIPIUL DEVA",,7,,487,754
22,"Hunedoara",207,"207-MUNICIPIUL DEVA",86687,24,2,1507,1142,1063,79,1142,0,"MUNICIPIUL DEVA",,7,,307,835
22,"Hunedoara",207,"207-MUNICIPIUL DEVA",86687,25,2,1936,1326,1165,161,1317,9,"MUNICIPIUL DEVA",,7,,410,907
22,"Hunedoara",207,"207-MUNICIPIUL DEVA",86687,26,2,1659,1256,910,346,1250,6,"MUNICIPIUL DEVA",,7,,353,897
22,"Hunedoara",207,"207-MUNICIPIUL DEVA",86687,27,2,1605,1025,889,136,1020,5,"MUNICIPIUL DEVA",,7,,314,706
22,"Hunedoara",207,"207-MUNICIPIUL DEVA",86687,28,2,1894,1628,1110,518,1624,4,"MUNICIPIUL DEVA",,7,,494,1130
22,"Hunedoara",207,"207-MUNICIPIUL DEVA",86687,29,2,1391,1105,989,116,1102,3,"MUNICIPIUL DEVA",,7,,338,764
22,"Hunedoara",207,"207-MUNICIPIUL DEVA",86687,30,2,1689,1268,1083,185,1264,4,"MUNICIPIUL DEVA",,7,,532,732
22,"Hunedoara",207,"207-MUNICIPIUL DEVA",86687,31,2,1897,1312,1120,192,1307,5,"MUNICIPIUL DEVA",,7,,392,915
22,"Hunedoara",207,"207-MUNICIPIUL DEVA",86687,32,2,1565,1133,879,254,1129,4,"MUNICIPIUL DEVA",,7,,301,828
22,"Hunedoara",207,"207-MUNICIPIUL DEVA",86687,33,2,2072,1346,1140,206,1338,8,"MUNICIPIUL DEVA",,7,,400,938
22,"Hunedoara",207,"207-MUNICIPIUL DEVA",86687,34,2,1876,992,759,233,985,7,"MUNICIPIUL DEVA",,7,,254,731
22,"Hunedoara",207,"207-MUNICIPIUL DEVA",86687,35,2,1835,1232,1038,194,1225,5,"MUNICIPIUL DEVA",,7,,334,891
22,"Hunedoara",207,"207-MUNICIPIUL DEVA",86687,36,2,2132,1389,1166,223,1386,3,"MUNICIPIUL DEVA",,7,,498,888
22,"Hunedoara",207,"207-MUNICIPIUL DEVA",86687,37,2,1605,1368,1085,283,1358,10,"MUNICIPIUL DEVA",,7,,455,903
22,"Hunedoara",207,"207-MUNICIPIUL DEVA",86687,38,2,1114,953,768,185,950,3,"MUNICIPIUL DEVA",,7,,181,769
22,"Hunedoara",207,"207-MUNICIPIUL DEVA",86687,39,2,419,396,307,89,395,1,"MUNICIPIUL DEVA",,7,,189,206
22,"Hunedoara",207,"207-MUNICIPIUL DEVA",86687,40,2,184,380,110,270,375,5,"MUNICIPIUL DEVA",,7,,93,282
22,"Hunedoara",207,"207-MUNICIPIUL DEVA",86687,41,2,70,86,55,31,85,1,"MUNICIPIUL DEVA",,7,,34,51
22,"Hunedoara",207,"207-MUNICIPIUL DEVA",86687,42,2,244,258,241,17,250,8,"MUNICIPIUL DEVA",,7,,86,164
22,"Hunedoara",207,"207-MUNICIPIUL DEVA",86687,43,2,0,482,0,482,476,6,"MUNICIPIUL DEVA",,7,,176,300
22,"Hunedoara",207,"207-MUNICIPIU BRAD",87291,44,2,1233,1000,875,125,996,4,"MUNICIPIU BRAD",,7,,437,559
22,"Hunedoara",207,"207-MUNICIPIU BRAD",87291,45,2,1381,1081,989,92,1076,5,"MUNICIPIU BRAD",,7,,454,622
22,"Hunedoara",207,"207-MUNICIPIU BRAD",87291,46,2,1566,1125,1036,89,1122,3,"MUNICIPIU BRAD",,7,,541,581
22,"Hunedoara",207,"207-MUNICIPIU BRAD",87291,47,2,1764,1260,1179,81,1252,8,"MUNICIPIU BRAD",,7,,581,671
22,"Hunedoara",207,"207-MUNICIPIU BRAD",87291,48,2,1569,1149,1045,104,1145,4,"MUNICIPIU BRAD",,7,,511,634
22,"Hunedoara",207,"207-MUNICIPIU BRAD",87291,49,2,1401,964,902,62,962,2,"MUNICIPIU BRAD",,7,,487,475
22,"Hunedoara",207,"207-MUNICIPIU BRAD",87291,50,2,959,671,639,32,668,3,"MUNICIPIU BRAD",,7,,364,304
22,"Hunedoara",207,"207-MUNICIPIU BRAD",87291,51,2,1006,691,630,61,686,5,"MUNICIPIU BRAD",,7,,328,358
22,"Hunedoara",207,"207-MUNICIPIU BRAD",87291,52,2,1133,850,766,84,845,5,"MUNICIPIU BRAD",,7,,406,439
22,"Hunedoara",207,"207-MUNICIPIU BRAD",87291,53,2,1211,811,782,29,808,3,"MUNICIPIU BRAD",,7,,431,377
22,"Hunedoara",207,"207-MUNICIPIU BRAD",87291,54,2,799,583,542,41,575,8,"MUNICIPIU BRAD",,7,,258,317
22,"Hunedoara",207,"207-MUNICIPIU BRAD",87291,55,2,658,521,487,34,518,3,"MUNICIPIU BRAD",,7,,256,262
22,"Hunedoara",207,"207-MUNICIPIU BRAD",87291,56,2,484,371,327,44,364,7,"MUNICIPIU BRAD",,7,,219,145
22,"Hunedoara",207,"207-MUNICIPIU BRAD",87291,57,2,192,173,131,42,170,3,"MUNICIPIU BRAD",,7,,67,103
22,"Hunedoara",207,"207-MUNICIPIU BRAD",87291,58,2,0,309,0,309,306,3,"MUNICIPIU BRAD",,7,,153,153
22,"Hunedoara",207,"207-MUNICIPIU BRAD",87291,59,2,0,135,0,135,135,0,"MUNICIPIU BRAD",,7,,55,80
22,"Hunedoara",207,"207-MUNICIPIU BRAD",87291,60,2,0,171,0,171,171,0,"MUNICIPIU BRAD",,7,,61,110
22,"Hunedoara",207,"207-MUNICIPIUL HUNEDOARA",86810,61,2,1585,1158,1050,108,1147,11,"MUNICIPIUL HUNEDOARA",,7,,385,762
22,"Hunedoara",207,"207-MUNICIPIUL HUNEDOARA",86810,62,2,585,449,408,41,444,5,"MUNICIPIUL HUNEDOARA",,7,,126,318
22,"Hunedoara",207,"207-MUNICIPIUL HUNEDOARA",86810,63,2,443,379,338,41,377,2,"MUNICIPIUL HUNEDOARA",,7,,134,243
22,"Hunedoara",207,"207-MUNICIPIUL HUNEDOARA",86810,64,2,1723,1248,1198,50,1242,6,"MUNICIPIUL HUNEDOARA",,7,,364,878
22,"Hunedoara",207,"207-MUNICIPIUL HUNEDOARA",86810,65,2,1006,753,712,41,751,2,"MUNICIPIUL HUNEDOARA",,7,,207,544
22,"Hunedoara",207,"207-MUNICIPIUL HUNEDOARA",86810,66,2,1780,1197,1139,58,1191,5,"MUNICIPIUL HUNEDOARA",,7,,357,834
22,"Hunedoara",207,"207-MUNICIPIUL HUNEDOARA",86810,67,2,1420,1061,998,63,1055,6,"MUNICIPIUL HUNEDOARA",,7,,296,759
22,"Hunedoara",207,"207-MUNICIPIUL HUNEDOARA",86810,68,2,2253,1393,1301,92,1385,8,"MUNICIPIUL HUNEDOARA",,7,,412,973
22,"Hunedoara",207,"207-MUNICIPIUL HUNEDOARA",86810,69,2,1727,1206,1099,107,1200,6,"MUNICIPIUL HUNEDOARA",,7,,454,746
22,"Hunedoara",207,"207-MUNICIPIUL HUNEDOARA",86810,70,2,636,450,417,33,447,3,"MUNICIPIUL HUNEDOARA",,7,,183,264
22,"Hunedoara",207,"207-MUNICIPIUL HUNEDOARA",86810,71,2,1376,1009,918,91,1004,5,"MUNICIPIUL HUNEDOARA",,7,,372,632
22,"Hunedoara",207,"207-MUNICIPIUL HUNEDOARA",86810,72,2,1100,1099,995,104,1094,5,"MUNICIPIUL HUNEDOARA",,7,,373,721
22,"Hunedoara",207,"207-MUNICIPIUL HUNEDOARA",86810,73,2,1600,1056,996,60,1048,8,"MUNICIPIUL HUNEDOARA",,7,,441,607
22,"Hunedoara",207,"207-MUNICIPIUL HUNEDOARA",86810,74,2,1404,1029,901,128,1022,7,"MUNICIPIUL HUNEDOARA",,7,,364,658
22,"Hunedoara",207,"207-MUNICIPIUL HUNEDOARA",86810,75,2,1300,890,825,65,887,3,"MUNICIPIUL HUNEDOARA",,7,,332,555
22,"Hunedoara",207,"207-MUNICIPIUL HUNEDOARA",86810,76,2,1359,940,841,99,938,2,"MUNICIPIUL HUNEDOARA",,7,,327,611
22,"Hunedoara",207,"207-MUNICIPIUL HUNEDOARA",86810,77,2,1280,942,846,96,939,3,"MUNICIPIUL HUNEDOARA",,7,,380,559
22,"Hunedoara",207,"207-MUNICIPIUL HUNEDOARA",86810,78,2,1651,1205,1124,81,1199,6,"MUNICIPIUL HUNEDOARA",,7,,416,783
22,"Hunedoara",207,"207-MUNICIPIUL HUNEDOARA",86810,79,2,1258,914,816,98,907,7,"MUNICIPIUL HUNEDOARA",,7,,354,553
22,"Hunedoara",207,"207-MUNICIPIUL HUNEDOARA",86810,80,2,1521,1124,1053,71,1122,2,"MUNICIPIUL HUNEDOARA",,7,,482,640
22,"Hunedoara",207,"207-MUNICIPIUL HUNEDOARA",86810,81,2,1843,1251,1169,82,1242,9,"MUNICIPIUL HUNEDOARA",,7,,501,741
22,"Hunedoara",207,"207-MUNICIPIUL HUNEDOARA",86810,82,2,1471,1049,974,75,1048,1,"MUNICIPIUL HUNEDOARA",,7,,344,704
22,"Hunedoara",207,"207-MUNICIPIUL HUNEDOARA",86810,83,2,1152,841,755,86,840,1,"MUNICIPIUL HUNEDOARA",,7,,319,521
22,"Hunedoara",207,"207-MUNICIPIUL HUNEDOARA",86810,84,2,1650,1291,1096,195,1286,5,"MUNICIPIUL HUNEDOARA",,7,,542,744
22,"Hunedoara",207,"207-MUNICIPIUL HUNEDOARA",86810,85,2,1568,1220,1155,65,1217,3,"MUNICIPIUL HUNEDOARA",,7,,415,802
22,"Hunedoara",207,"207-MUNICIPIUL HUNEDOARA",86810,86,2,1457,1129,955,174,1126,3,"MUNICIPIUL HUNEDOARA",,7,,412,714
22,"Hunedoara",207,"207-MUNICIPIUL HUNEDOARA",86810,87,2,0,586,0,586,580,6,"MUNICIPIUL HUNEDOARA",,7,,239,341
22,"Hunedoara",207,"207-MUNICIPIUL HUNEDOARA",86810,88,2,1264,881,792,89,875,4,"MUNICIPIUL HUNEDOARA",,7,,309,566
22,"Hunedoara",207,"207-MUNICIPIUL HUNEDOARA",86810,89,2,1737,1240,1155,85,1237,3,"MUNICIPIUL HUNEDOARA",,7,,464,773
22,"Hunedoara",207,"207-MUNICIPIUL HUNEDOARA",86810,90,2,1950,1402,1321,81,1378,15,"MUNICIPIUL HUNEDOARA",,7,,487,891
22,"Hunedoara",207,"207-MUNICIPIUL HUNEDOARA",86810,91,2,935,520,483,37,516,4,"MUNICIPIUL HUNEDOARA",,7,,166,350
22,"Hunedoara",207,"207-MUNICIPIUL HUNEDOARA",86810,92,2,828,986,564,422,982,4,"MUNICIPIUL HUNEDOARA",,7,,319,663
22,"Hunedoara",207,"207-MUNICIPIUL HUNEDOARA",86810,93,2,982,844,725,119,837,7,"MUNICIPIUL HUNEDOARA",,7,,307,530
22,"Hunedoara",207,"207-MUNICIPIUL HUNEDOARA",86810,94,2,1222,926,884,42,919,7,"MUNICIPIUL HUNEDOARA",,7,,373,546
22,"Hunedoara",207,"207-MUNICIPIUL HUNEDOARA",86810,95,2,1576,1269,1126,143,1262,7,"MUNICIPIUL HUNEDOARA",,7,,497,765
22,"Hunedoara",207,"207-MUNICIPIUL HUNEDOARA",86810,96,2,1810,1359,1192,167,1351,8,"MUNICIPIUL HUNEDOARA",,7,,508,843
22,"Hunedoara",207,"207-MUNICIPIUL HUNEDOARA",86810,97,2,1475,1038,862,176,1034,4,"MUNICIPIUL HUNEDOARA",,7,,407,627
22,"Hunedoara",207,"207-MUNICIPIUL HUNEDOARA",86810,98,2,1591,1186,1046,140,1179,7,"MUNICIPIUL HUNEDOARA",,7,,384,795
22,"Hunedoara",207,"207-MUNICIPIUL HUNEDOARA",86810,99,2,1373,933,874,59,928,5,"MUNICIPIUL HUNEDOARA",,7,,371,557
22,"Hunedoara",207,"207-MUNICIPIUL HUNEDOARA",86810,100,2,1356,944,881,63,936,8,"MUNICIPIUL HUNEDOARA",,7,,335,601
22,"Hunedoara",207,"207-MUNICIPIUL HUNEDOARA",86810,101,2,1513,1010,943,67,1004,6,"MUNICIPIUL HUNEDOARA",,7,,287,717
22,"Hunedoara",207,"207-MUNICIPIUL HUNEDOARA",86810,102,2,1637,1135,1084,51,1129,6,"MUNICIPIUL HUNEDOARA",,7,,334,795
22,"Hunedoara",207,"207-MUNICIPIUL HUNEDOARA",86810,103,2,1376,908,843,65,903,5,"MUNICIPIUL HUNEDOARA",,7,,294,609
22,"Hunedoara",207,"207-MUNICIPIUL HUNEDOARA",86810,104,2,1441,912,839,73,906,6,"MUNICIPIUL HUNEDOARA",,7,,255,651
22,"Hunedoara",207,"207-MUNICIPIUL HUNEDOARA",86810,105,2,1207,828,729,99,827,1,"MUNICIPIUL HUNEDOARA",,7,,210,617
22,"Hunedoara",207,"207-MUNICIPIUL HUNEDOARA",86810,106,2,1515,1010,946,64,1002,8,"MUNICIPIUL HUNEDOARA",,7,,281,721
22,"Hunedoara",207,"207-MUNICIPIUL HUNEDOARA",86810,107,2,343,262,216,46,259,3,"MUNICIPIUL HUNEDOARA",,7,,76,183
22,"Hunedoara",207,"207-MUNICIPIUL HUNEDOARA",86810,108,2,454,352,298,54,349,3,"MUNICIPIUL HUNEDOARA",,7,,75,274
22,"Hunedoara",207,"207-MUNICIPIUL HUNEDOARA",86810,109,2,407,307,260,47,304,3,"MUNICIPIUL HUNEDOARA",,7,,155,149
22,"Hunedoara",207,"207-MUNICIPIUL HUNEDOARA",86810,110,2,449,395,328,67,368,27,"MUNICIPIUL HUNEDOARA",,7,,177,191
22,"Hunedoara",207,"207-MUNICIPIUL HUNEDOARA",86810,111,2,970,777,670,107,775,2,"MUNICIPIUL HUNEDOARA",,7,,286,489
22,"Hunedoara",207,"207-MUNICIPIUL HUNEDOARA",86810,112,2,229,231,210,21,227,4,"MUNICIPIUL HUNEDOARA",,7,,110,117
22,"Hunedoara",207,"207-MUNICIPIUL ORASTIE",87638,113,2,1825,1417,1293,124,1404,13,"MUNICIPIUL ORASTIE",,7,,571,833
22,"Hunedoara",207,"207-MUNICIPIUL ORASTIE",87638,114,2,1794,1334,1199,135,1323,11,"MUNICIPIUL ORASTIE",,7,,352,971
22,"Hunedoara",207,"207-MUNICIPIUL ORASTIE",87638,115,2,1814,1356,1086,270,1347,9,"MUNICIPIUL ORASTIE",,7,,355,992
22,"Hunedoara",207,"207-MUNICIPIUL ORASTIE",87638,116,2,1763,1314,1212,102,1310,4,"MUNICIPIUL ORASTIE",,7,,480,830
22,"Hunedoara",207,"207-MUNICIPIUL ORASTIE",87638,117,2,1660,1230,1121,109,1222,8,"MUNICIPIUL ORASTIE",,7,,348,874
22,"Hunedoara",207,"207-MUNICIPIUL ORASTIE",87638,118,2,1224,1002,905,97,998,4,"MUNICIPIUL ORASTIE",,7,,360,638
22,"Hunedoara",207,"207-MUNICIPIUL ORASTIE",87638,119,2,1609,1177,1041,136,1168,9,"MUNICIPIUL ORASTIE",,7,,481,687
22,"Hunedoara",207,"207-MUNICIPIUL ORASTIE",87638,120,2,1215,957,878,79,954,3,"MUNICIPIUL ORASTIE",,7,,390,564
22,"Hunedoara",207,"207-MUNICIPIUL ORASTIE",87638,121,2,1925,1410,1245,165,1398,12,"MUNICIPIUL ORASTIE",,7,,456,942
22,"Hunedoara",207,"207-MUNICIPIUL ORASTIE",87638,122,2,1558,1221,1092,129,1210,11,"MUNICIPIUL ORASTIE",,7,,362,848
22,"Hunedoara",207,"207-MUNICIPIUL ORASTIE",87638,123,2,1725,1537,1459,78,1516,21,"MUNICIPIUL ORASTIE",,7,,765,751
22,"Hunedoara",207,"207-MUNICIPIUL ORASTIE",87638,124,2,0,810,0,810,800,10,"MUNICIPIUL ORASTIE",,7,,320,480
22,"Hunedoara",207,"207-MUNICIPIUL ORASTIE",87638,125,2,135,145,106,39,143,2,"MUNICIPIUL ORASTIE",,7,,61,82
22,"Hunedoara",207,"207-MUNICIPIUL PETROSANI",86990,126,2,1944,1616,1482,134,1479,3,"MUNICIPIUL PETROSANI",,7,,889,590
22,"Hunedoara",207,"207-MUNICIPIUL PETROSANI",86990,127,2,1614,1193,1101,92,1185,8,"MUNICIPIUL PETROSANI",,7,,728,457
22,"Hunedoara",207,"207-MUNICIPIUL PETROSANI",86990,128,2,1778,1392,1262,130,1383,9,"MUNICIPIUL PETROSANI",,7,,839,544
22,"Hunedoara",207,"207-MUNICIPIUL PETROSANI",86990,129,2,1845,1409,1269,140,1408,1,"MUNICIPIUL PETROSANI",,7,,865,543
22,"Hunedoara",207,"207-MUNICIPIUL PETROSANI",86990,130,2,0,324,0,324,321,3,"MUNICIPIUL PETROSANI",,7,,169,152
22,"Hunedoara",207,"207-MUNICIPIUL PETROSANI",86990,131,2,1284,1019,891,128,1011,8,"MUNICIPIUL PETROSANI",,7,,585,426
22,"Hunedoara",207,"207-MUNICIPIUL PETROSANI",86990,132,2,1287,1005,898,107,1004,1,"MUNICIPIUL PETROSANI",,7,,606,398
22,"Hunedoara",207,"207-MUNICIPIUL PETROSANI",86990,133,2,1723,1222,1120,102,1216,6,"MUNICIPIUL PETROSANI",,7,,725,491
22,"Hunedoara",207,"207-MUNICIPIUL PETROSANI",86990,134,2,1928,1400,1229,171,1382,18,"MUNICIPIUL PETROSANI",,7,,924,458
22,"Hunedoara",207,"207-MUNICIPIUL PETROSANI",86990,135,2,1196,912,865,47,908,3,"MUNICIPIUL PETROSANI",,7,,532,376
22,"Hunedoara",207,"207-MUNICIPIUL PETROSANI",86990,136,2,1694,1255,1157,98,1245,10,"MUNICIPIUL PETROSANI",,7,,748,497
22,"Hunedoara",207,"207-MUNICIPIUL PETROSANI",86990,137,2,1807,1322,1248,74,1318,4,"MUNICIPIUL PETROSANI",,7,,865,453
22,"Hunedoara",207,"207-MUNICIPIUL PETROSANI",86990,138,2,1663,1293,1101,192,1287,6,"MUNICIPIUL PETROSANI",,7,,854,433
22,"Hunedoara",207,"207-MUNICIPIUL PETROSANI",86990,139,2,1857,1349,1248,101,1340,9,"MUNICIPIUL PETROSANI",,7,,865,475
22,"Hunedoara",207,"207-MUNICIPIUL PETROSANI",86990,140,2,2190,1693,1470,223,1685,8,"MUNICIPIUL PETROSANI",,7,,1130,555
22,"Hunedoara",207,"207-MUNICIPIUL PETROSANI",86990,141,2,1710,1152,947,205,1144,8,"MUNICIPIUL PETROSANI",,7,,785,359
22,"Hunedoara",207,"207-MUNICIPIUL PETROSANI",86990,142,2,985,719,670,49,667,3,"MUNICIPIUL PETROSANI",,7,,494,173
22,"Hunedoara",207,"207-MUNICIPIUL PETROSANI",86990,143,2,1670,1179,1091,88,1176,3,"MUNICIPIUL PETROSANI",,7,,831,345
22,"Hunedoara",207,"207-MUNICIPIUL PETROSANI",86990,144,2,1241,1062,834,228,1060,2,"MUNICIPIUL PETROSANI",,7,,758,302
22,"Hunedoara",207,"207-MUNICIPIUL PETROSANI",86990,145,2,1764,1266,1009,257,1253,13,"MUNICIPIUL PETROSANI",,7,,878,375
22,"Hunedoara",207,"207-MUNICIPIUL PETROSANI",86990,146,2,2218,1572,1403,169,1565,7,"MUNICIPIUL PETROSANI",,7,,1063,502
22,"Hunedoara",207,"207-MUNICIPIUL PETROSANI",86990,147,2,620,432,380,52,427,5,"MUNICIPIUL PETROSANI",,7,,208,219
22,"Hunedoara",207,"207-MUNICIPIUL PETROSANI",86990,148,2,1821,1443,1200,243,1431,12,"MUNICIPIUL PETROSANI",,7,,869,562
22,"Hunedoara",207,"207-MUNICIPIUL PETROSANI",86990,149,2,1197,903,712,191,893,10,"MUNICIPIUL PETROSANI",,7,,552,341
22,"Hunedoara",207,"207-MUNICIPIUL PETROSANI",86990,150,2,1744,1185,1070,115,1168,17,"MUNICIPIUL PETROSANI",,7,,718,450
22,"Hunedoara",207,"207-MUNICIPIUL PETROSANI",86990,151,2,224,174,150,24,170,4,"MUNICIPIUL PETROSANI",,7,,161,9
22,"Hunedoara",207,"207-MUNICIPIUL PETROSANI",86990,152,2,353,379,347,32,369,10,"MUNICIPIUL PETROSANI",,7,,228,141
22,"Hunedoara",207,"207-MUNICIPIUL PETROSANI",86990,153,2,0,423,0,423,419,4,"MUNICIPIUL PETROSANI",,7,,302,117
22,"Hunedoara",207,"207-MUNICIPIUL PETROSANI",86990,154,2,0,283,0,283,281,2,"MUNICIPIUL PETROSANI",,7,,136,145
22,"Hunedoara",207,"207-ORAS ANINOASA",87219,155,2,2103,1883,1558,325,1874,9,"ORAS ANINOASA",,7,,1595,279
22,"Hunedoara",207,"207-ORAS ANINOASA",87219,156,2,1589,1278,1004,274,1272,6,"ORAS ANINOASA",,7,,965,307
22,"Hunedoara",207,"207-ORAS CALAN",87424,157,2,1163,824,708,116,812,12,"ORAS CALAN",,7,,318,494
22,"Hunedoara",207,"207-ORAS CALAN",87424,158,2,1638,1141,1047,94,1138,3,"ORAS CALAN",,7,,481,657
22,"Hunedoara",207,"207-ORAS CALAN",87424,159,2,1555,1158,972,186,1145,13,"ORAS CALAN",,7,,364,781
22,"Hunedoara",207,"207-ORAS CALAN",87424,160,2,2865,1950,1773,177,1940,10,"ORAS CALAN",,7,,681,1259
22,"Hunedoara",207,"207-ORAS CALAN",87424,161,2,1051,808,718,90,805,3,"ORAS CALAN",,7,,256,549
22,"Hunedoara",207,"207-ORAS CALAN",87424,162,2,304,243,203,40,243,0,"ORAS CALAN",,7,,99,144
22,"Hunedoara",207,"207-ORAS CALAN",87424,163,2,495,393,321,72,392,1,"ORAS CALAN",,7,,169,223
22,"Hunedoara",207,"207-ORAS CALAN",87424,164,2,459,360,330,30,357,3,"ORAS CALAN",,7,,140,217
22,"Hunedoara",207,"207-ORAS CALAN",87424,165,2,310,226,193,33,225,1,"ORAS CALAN",,7,,107,118
22,"Hunedoara",207,"207-ORAS CALAN",87424,166,2,140,135,104,31,133,2,"ORAS CALAN",,7,,48,85
22,"Hunedoara",207,"207-ORAS CALAN",87424,167,2,170,141,121,20,140,1,"ORAS CALAN",,7,,62,78
22,"Hunedoara",207,"207-ORAS CALAN",87424,168,2,600,532,494,38,529,3,"ORAS CALAN",,7,,230,299
22,"Hunedoara",207,"207-ORAS CALAN",87424,169,2,260,219,197,22,218,1,"ORAS CALAN",,7,,70,148
22,"Hunedoara",207,"207-ORAS CALAN",87424,170,2,270,245,211,34,242,3,"ORAS CALAN",,7,,173,69
22,"Hunedoara",207,"207-ORAS HATEG",87576,171,2,2124,1747,1600,147,1735,12,"ORAS HATEG",,7,,729,1006
22,"Hunedoara",207,"207-ORAS HATEG",87576,172,2,2054,1485,1402,83,1475,10,"ORAS HATEG",,7,,695,780
22,"Hunedoara",207,"207-ORAS HATEG",87576,173,2,1938,1580,1370,210,1569,11,"ORAS HATEG",,7,,624,945
22,"Hunedoara",207,"207-ORAS HATEG",87576,174,2,2173,1594,1388,206,1589,5,"ORAS HATEG",,7,,573,1016
22,"Hunedoara",207,"207-ORAS HATEG",87576,175,2,708,523,423,100,521,2,"ORAS HATEG",,7,,242,279
22,"Hunedoara",207,"207-ORAS HATEG",87576,176,2,0,91,0,91,91,0,"ORAS HATEG",,7,,53,38
22,"Hunedoara",207,"207-ORAS HATEG",87576,177,2,167,150,138,12,145,5,"ORAS HATEG",,7,,58,87
22,"Hunedoara",207,"207-ORAS LUPENI",87059,178,2,1986,1377,1216,161,1360,17,"ORAS LUPENI",,7,,1013,347
22,"Hunedoara",207,"207-ORAS LUPENI",87059,179,2,1981,1419,1219,200,1415,4,"ORAS LUPENI",,7,,957,458
22,"Hunedoara",207,"207-ORAS LUPENI",87059,180,2,2307,1466,1249,217,1459,7,"ORAS LUPENI",,7,,1052,407
22,"Hunedoara",207,"207-ORAS LUPENI",87059,181,2,1679,1505,1122,383,1491,14,"ORAS LUPENI",,7,,1133,358
22,"Hunedoara",207,"207-ORAS LUPENI",87059,182,2,1908,1473,1322,151,1470,3,"ORAS LUPENI",,7,,968,502
22,"Hunedoara",207,"207-ORAS LUPENI",87059,183,2,1765,1320,1168,152,1304,16,"ORAS LUPENI",,7,,910,394
22,"Hunedoara",207,"207-ORAS LUPENI",87059,184,2,2050,1706,1410,296,1695,11,"ORAS LUPENI",,7,,1232,463
22,"Hunedoara",207,"207-ORAS LUPENI",87059,185,2,1854,1575,1090,485,1564,11,"ORAS LUPENI",,7,,1196,368
22,"Hunedoara",207,"207-ORAS LUPENI",87059,186,2,2051,1606,1148,458,1593,13,"ORAS LUPENI",,7,,1130,463
22,"Hunedoara",207,"207-ORAS LUPENI",87059,187,2,2725,1952,1805,147,1943,9,"ORAS LUPENI",,7,,1411,532
22,"Hunedoara",207,"207-ORAS LUPENI",87059,188,2,2075,1461,1240,221,1450,11,"ORAS LUPENI",,7,,1036,414
22,"Hunedoara",207,"207-ORAS LUPENI",87059,189,2,1814,1424,1095,329,1419,5,"ORAS LUPENI",,7,,961,458
22,"Hunedoara",207,"207-ORAS PETRILA",87077,190,2,1559,1320,1054,266,1311,9,"ORAS PETRILA",,7,,985,326
22,"Hunedoara",207,"207-ORAS PETRILA",87077,191,2,1524,1150,1066,84,1147,3,"ORAS PETRILA",,7,,860,287
22,"Hunedoara",207,"207-ORAS PETRILA",87077,192,2,1229,897,809,88,895,2,"ORAS PETRILA",,7,,670,225
22,"Hunedoara",207,"207-ORAS PETRILA",87077,193,2,1447,1176,986,190,1171,5,"ORAS PETRILA",,7,,854,317
22,"Hunedoara",207,"207-ORAS PETRILA",87077,194,2,1259,1110,1025,85,1102,8,"ORAS PETRILA",,7,,816,286
22,"Hunedoara",207,"207-ORAS PETRILA",87077,195,2,1357,993,924,69,991,2,"ORAS PETRILA",,7,,754,237
22,"Hunedoara",207,"207-ORAS PETRILA",87077,196,2,1267,912,845,67,904,8,"ORAS PETRILA",,7,,666,238
22,"Hunedoara",207,"207-ORAS PETRILA",87077,197,2,1518,1092,1030,62,1084,8,"ORAS PETRILA",,7,,795,289
22,"Hunedoara",207,"207-ORAS PETRILA",87077,198,2,1442,982,915,67,979,3,"ORAS PETRILA",,7,,704,275
22,"Hunedoara",207,"207-ORAS PETRILA",87077,199,2,1544,1095,917,178,1081,14,"ORAS PETRILA",,7,,777,304
22,"Hunedoara",207,"207-ORAS PETRILA",87077,200,2,1092,761,697,64,758,3,"ORAS PETRILA",,7,,559,199
22,"Hunedoara",207,"207-ORAS PETRILA",87077,201,2,915,716,591,125,708,8,"ORAS PETRILA",,7,,537,171
22,"Hunedoara",207,"207-ORAS PETRILA",87077,202,2,1810,1336,1087,249,1328,8,"ORAS PETRILA",,7,,1037,291
22,"Hunedoara",207,"207-ORAS PETRILA",87077,203,2,1323,1053,936,117,1043,10,"ORAS PETRILA",,7,,823,220
22,"Hunedoara",207,"207-ORAS PETRILA",87077,204,2,1556,1288,1181,107,1278,10,"ORAS PETRILA",,7,,1093,185
22,"Hunedoara",207,"207-ORAS PETRILA",87077,205,2,618,494,435,59,492,2,"ORAS PETRILA",,7,,399,93
22,"Hunedoara",207,"207-ORAS SIMERIA",87665,206,2,2028,1587,1321,266,1581,6,"ORAS SIMERIA",,7,,532,1049
22,"Hunedoara",207,"207-ORAS SIMERIA",87665,207,2,2110,1660,1345,315,1644,16,"ORAS SIMERIA",,7,,633,1011
22,"Hunedoara",207,"207-ORAS SIMERIA",87665,208,2,1560,1144,991,153,1140,4,"ORAS SIMERIA",,7,,374,766
22,"Hunedoara",207,"207-ORAS SIMERIA",87665,209,2,1184,843,740,103,834,9,"ORAS SIMERIA",,7,,333,501
22,"Hunedoara",207,"207-ORAS SIMERIA",87665,210,2,1476,1136,1045,91,1131,5,"ORAS SIMERIA",,7,,487,644
22,"Hunedoara",207,"207-ORAS SIMERIA",87665,211,2,1578,1198,1022,176,1188,10,"ORAS SIMERIA",,7,,453,735
22,"Hunedoara",207,"207-ORAS SIMERIA",87665,212,2,715,953,471,482,945,8,"ORAS SIMERIA",,7,,357,588
22,"Hunedoara",207,"207-ORAS SIMERIA",87665,213,2,782,658,521,137,654,4,"ORAS SIMERIA",,7,,304,350
22,"Hunedoara",207,"207-ORAS URICANI",87139,214,2,2015,1421,1119,302,1403,18,"ORAS URICANI",,7,,984,419
22,"Hunedoara",207,"207-ORAS URICANI",87139,215,2,2257,1552,1263,289,1545,7,"ORAS URICANI",,7,,1052,493
22,"Hunedoara",207,"207-ORAS URICANI",87139,216,2,1861,1499,940,559,1496,3,"ORAS URICANI",,7,,1024,472
22,"Hunedoara",207,"207-ORAS URICANI",87139,217,2,1936,1325,1092,233,1316,9,"ORAS URICANI",,7,,919,397
22,"Hunedoara",207,"207-ORAS URICANI",87139,218,2,421,403,245,158,397,6,"ORAS URICANI",,7,,249,148
22,"Hunedoara",207,"207-ORAS VULCAN",87175,219,2,1313,985,759,226,981,4,"ORAS VULCAN",,7,,722,259
22,"Hunedoara",207,"207-ORAS VULCAN",87175,220,2,1588,1194,984,210,1186,8,"ORAS VULCAN",,7,,878,308
22,"Hunedoara",207,"207-ORAS VULCAN",87175,221,2,1707,1298,1097,201,1282,16,"ORAS VULCAN",,7,,999,283
22,"Hunedoara",207,"207-ORAS VULCAN",87175,222,2,676,480,425,55,477,3,"ORAS VULCAN",,7,,365,112
22,"Hunedoara",207,"207-ORAS VULCAN",87175,223,2,1511,1070,975,95,1052,18,"ORAS VULCAN",,7,,746,306
22,"Hunedoara",207,"207-ORAS VULCAN",87175,224,2,1091,825,733,92,823,2,"ORAS VULCAN",,7,,607,216
22,"Hunedoara",207,"207-ORAS VULCAN",87175,225,2,983,831,658,173,829,2,"ORAS VULCAN",,7,,627,202
22,"Hunedoara",207,"207-ORAS VULCAN",87175,226,2,1565,1178,986,192,1175,3,"ORAS VULCAN",,7,,910,265
22,"Hunedoara",207,"207-ORAS VULCAN",87175,227,2,1797,1265,961,304,1260,5,"ORAS VULCAN",,7,,965,295
22,"Hunedoara",207,"207-ORAS VULCAN",87175,228,2,1700,1090,959,131,1084,6,"ORAS VULCAN",,7,,800,284
22,"Hunedoara",207,"207-ORAS VULCAN",87175,229,2,1977,1371,1016,355,1364,7,"ORAS VULCAN",,7,,1136,228
22,"Hunedoara",207,"207-ORAS VULCAN",87175,230,2,2511,1715,1425,290,1704,11,"ORAS VULCAN",,7,,1382,322
22,"Hunedoara",207,"207-ORAS VULCAN",87175,231,2,1773,1314,906,408,1308,6,"ORAS VULCAN",,7,,1030,278
22,"Hunedoara",207,"207-ORAS VULCAN",87175,232,2,1334,907,792,115,895,12,"ORAS VULCAN",,7,,693,202
22,"Hunedoara",207,"207-ORAS VULCAN",87175,233,2,991,756,656,100,752,4,"ORAS VULCAN",,7,,557,195
22,"Hunedoara",207,"207-ORAS VULCAN",87175,234,2,1051,894,659,235,885,9,"ORAS VULCAN",,7,,616,269
22,"Hunedoara",207,"207-ORAS VULCAN",87175,235,2,955,668,578,90,662,6,"ORAS VULCAN",,7,,518,144
22,"Hunedoara",207,"207-ORAS VULCAN",87175,236,2,1633,1231,1105,126,1216,15,"ORAS VULCAN",,7,,816,400
22,"Hunedoara",207,"207-ORAS VULCAN",87175,237,2,0,48,0,48,48,0,"ORAS VULCAN",,7,,24,24
22,"Hunedoara",207,"207-BAIA DE CRIS",87745,238,2,981,788,679,109,786,2,"BAIA DE CRIS",,7,,406,380
22,"Hunedoara",207,"207-BAIA DE CRIS",87745,239,2,504,357,324,33,355,2,"BAIA DE CRIS",,7,,162,193
22,"Hunedoara",207,"207-BAIA DE CRIS",87745,240,2,575,406,372,34,401,5,"BAIA DE CRIS",,7,,239,162
22,"Hunedoara",207,"207-BAIA DE CRIS",87745,241,2,673,591,515,76,589,2,"BAIA DE CRIS",,7,,363,226
22,"Hunedoara",207,"207-BALSA",87843,242,2,365,228,177,51,227,1,"BALSA",,7,,104,123
22,"Hunedoara",207,"207-BALSA",87843,243,2,94,74,58,16,73,1,"BALSA",,7,,38,35
22,"Hunedoara",207,"207-BALSA",87843,244,2,60,73,46,27,72,1,"BALSA",,7,,35,37
22,"Hunedoara",207,"207-BALSA",87843,245,2,184,109,78,31,109,0,"BALSA",,7,,38,71
22,"Hunedoara",207,"207-BALSA",87843,246,2,324,217,177,40,215,2,"BALSA",,7,,122,93
22,"Hunedoara",207,"207-BALSA",87843,247,2,98,97,77,20,95,1,"BALSA",,7,,64,31
22,"Hunedoara",207,"207-BALSA",87843,248,2,151,147,119,28,145,2,"BALSA",,7,,74,71
22,"Hunedoara",207,"207-BARU",87996,249,2,1475,1175,945,230,1162,13,"BARU",,7,,644,518
22,"Hunedoara",207,"207-BARU",87996,250,2,849,598,515,83,597,1,"BARU",,7,,357,240
22,"Hunedoara",207,"207-BACIA",88047,251,2,1257,982,811,171,974,8,"BACIA",,7,,373,601
22,"Hunedoara",207,"207-BAITA",88092,252,2,1606,1078,944,134,1065,13,"BAITA",,7,,597,468
22,"Hunedoara",207,"207-BAITA",88092,253,2,839,580,497,83,570,10,"BAITA",,7,,354,216
22,"Hunedoara",207,"207-BAITA",88092,254,2,618,375,329,46,374,1,"BAITA",,7,,194,180
22,"Hunedoara",207,"207-BAITA",88092,255,2,563,421,339,82,417,4,"BAITA",,7,,227,190
22,"Hunedoara",207,"207-BANITA",87246,256,2,993,766,643,123,758,8,"BANITA",,7,,394,364
22,"Hunedoara",207,"207-BATRANA",88216,257,2,187,154,133,21,153,1,"BATRANA",,7,,79,74
22,"Hunedoara",207,"207-BERIU",88261,258,2,624,459,413,46,456,3,"BERIU",,7,,190,266
22,"Hunedoara",207,"207-BERIU",88261,259,2,911,620,587,33,613,7,"BERIU",,7,,215,398
22,"Hunedoara",207,"207-BERIU",88261,260,2,647,469,447,22,467,2,"BERIU",,7,,228,239
22,"Hunedoara",207,"207-BERIU",88261,261,2,140,103,92,11,103,0,"BERIU",,7,,59,44
22,"Hunedoara",207,"207-BERIU",88261,262,2,277,247,220,27,245,2,"BERIU",,7,,89,156
22,"Hunedoara",207,"207-BLAJENI",88350,263,2,864,457,440,17,453,4,"BLAJENI",,7,,244,209
22,"Hunedoara",207,"207-BLAJENI",88350,264,2,410,235,217,18,230,5,"BLAJENI",,7,,146,84
22,"Hunedoara",207,"207-BLAJENI",88350,265,2,160,114,87,27,114,0,"BLAJENI",,7,,56,58
22,"Hunedoara",207,"207-BOSOROD",88449,266,2,784,596,552,44,588,8,"BOSOROD",,7,,359,229
22,"Hunedoara",207,"207-BOSOROD",88449,267,2,477,360,324,36,355,5,"BOSOROD",,7,,185,170
22,"Hunedoara",207,"207-BOSOROD",88449,268,2,303,125,113,12,124,1,"BOSOROD",,7,,78,46
22,"Hunedoara",207,"207-BOSOROD",88449,269,2,246,211,177,34,207,4,"BOSOROD",,7,,175,32
22,"Hunedoara",207,"207-BRANISCA",88546,270,2,553,565,373,192,563,2,"BRANISCA",,7,,267,296
22,"Hunedoara",207,"207-BRANISCA",88546,271,2,552,373,306,67,372,1,"BRANISCA",,7,,177,195
22,"Hunedoara",207,"207-BRANISCA",88546,272,2,186,108,77,31,108,0,"BRANISCA",,7,,47,61
22,"Hunedoara",207,"207-BRANISCA",88546,273,2,156,68,50,18,67,1,"BRANISCA",,7,,43,24
22,"Hunedoara",207,"207-BRETEA ROMANA",88644,274,2,384,319,293,26,318,1,"BRETEA ROMANA",,7,,183,135
22,"Hunedoara",207,"207-BRETEA ROMANA",88644,275,2,538,366,316,50,364,2,"BRETEA ROMANA",,7,,173,191
22,"Hunedoara",207,"207-BRETEA ROMANA",88644,276,2,436,324,303,21,317,7,"BRETEA ROMANA",,7,,150,167
22,"Hunedoara",207,"207-BRETEA ROMANA",88644,277,2,308,279,254,25,276,3,"BRETEA ROMANA",,7,,178,98
22,"Hunedoara",207,"207-BRETEA ROMANA",88644,278,2,218,205,167,38,204,1,"BRETEA ROMANA",,7,,102,102
22,"Hunedoara",207,"207-BRETEA ROMANA",88644,279,2,700,391,370,21,390,1,"BRETEA ROMANA",,7,,158,232
22,"Hunedoara",207,"207-BUCES",88788,280,2,904,603,550,53,598,5,"BUCES",,7,,333,265
22,"Hunedoara",207,"207-BUCES",88788,281,2,399,324,288,36,322,2,"BUCES",,7,,157,165
22,"Hunedoara",207,"207-BUCES",88788,282,2,870,484,433,51,480,4,"BUCES",,7,,279,201
22,"Hunedoara",207,"207-BUCURESCI",88868,283,2,585,393,354,39,390,3,"BUCURESCI",,7,,217,173
22,"Hunedoara",207,"207-BUCURESCI",88868,284,2,388,251,228,23,251,0,"BUCURESCI",,7,,147,104
22,"Hunedoara",207,"207-BUCURESCI",88868,285,2,84,96,62,34,96,0,"BUCURESCI",,7,,54,42
22,"Hunedoara",207,"207-BUCURESCI",88868,286,2,234,146,138,8,144,2,"BUCURESCI",,7,,91,53
22,"Hunedoara",207,"207-BUCURESCI",88868,287,2,431,276,254,22,270,6,"BUCURESCI",,7,,149,121
22,"Hunedoara",207,"207-BULZESTII DE SUS",88920,288,2,284,174,146,28,170,4,"BULZESTII DE SUS",,7,,94,76
22,"Hunedoara",207,"207-BULZESTII DE SUS",88920,289,2,193,100,83,17,100,0,"BULZESTII DE SUS",,7,,68,32
22,"Hunedoara",207,"207-BUNILA",89026,290,2,90,100,70,30,99,1,"BUNILA",,7,,83,16
22,"Hunedoara",207,"207-BUNILA",89026,291,2,40,53,31,22,53,0,"BUNILA",,7,,45,8
22,"Hunedoara",207,"207-BUNILA",89026,292,2,90,112,86,26,112,0,"BUNILA",,7,,89,23
22,"Hunedoara",207,"207-BUNILA",89026,293,2,178,206,151,55,206,0,"BUNILA",,7,,99,107
22,"Hunedoara",207,"207-BUNILA",89026,294,2,39,90,34,56,89,1,"BUNILA",,7,,42,47
22,"Hunedoara",207,"207-BURJUC",89080,295,2,125,144,95,49,142,2,"BURJUC",,7,,90,52
22,"Hunedoara",207,"207-BURJUC",89080,296,2,128,147,96,51,144,3,"BURJUC",,7,,68,76
22,"Hunedoara",207,"207-BURJUC",89080,297,2,132,184,110,74,183,1,"BURJUC",,7,,103,80
22,"Hunedoara",207,"207-BURJUC",89080,298,2,187,168,137,31,167,1,"BURJUC",,7,,53,114
22,"Hunedoara",207,"207-BURJUC",89080,299,2,189,173,149,24,172,1,"BURJUC",,7,,78,94
22,"Hunedoara",207,"207-CERBAL",89151,300,2,296,200,165,35,199,1,"CERBAL",,7,,129,70
22,"Hunedoara",207,"207-CERBAL",89151,301,2,230,198,178,20,196,2,"CERBAL",,7,,146,50
22,"Hunedoara",207,"207-CERBAL",89151,302,2,160,126,111,15,125,1,"CERBAL",,7,,98,27
22,"Hunedoara",207,"207-CERTEJU DE SUS",89240,303,2,1111,1023,840,183,1018,5,"CERTEJU DE SUS",,7,,593,425
22,"Hunedoara",207,"207-CERTEJU DE SUS",89240,304,2,513,463,378,85,460,3,"CERTEJU DE SUS",,7,,242,218
22,"Hunedoara",207,"207-CERTEJU DE SUS",89240,305,2,191,166,119,47,165,1,"CERTEJU DE SUS",,7,,61,104
22,"Hunedoara",207,"207-CERTEJU DE SUS",89240,306,2,260,248,201,47,246,2,"CERTEJU DE SUS",,7,,172,74
22,"Hunedoara",207,"207-CERTEJU DE SUS",89240,307,2,364,293,253,40,290,3,"CERTEJU DE SUS",,7,,173,117
22,"Hunedoara",207,"207-CERTEJU DE SUS",89240,308,2,197,185,154,31,182,3,"CERTEJU DE SUS",,7,,137,45
22,"Hunedoara",207,"207-CARJITI",86749,309,2,356,203,163,40,203,0,"CARJITI",,7,,111,92
22,"Hunedoara",207,"207-CARJITI",86749,310,2,164,180,149,31,180,0,"CARJITI",,7,,97,83
22,"Hunedoara",207,"207-CARJITI",86749,311,2,160,176,141,35,172,4,"CARJITI",,7,,73,99
22,"Hunedoara",207,"207-CRISCIOR",87362,312,2,1480,1088,1005,83,1082,6,"CRISCIOR",,7,,613,469
22,"Hunedoara",207,"207-CRISCIOR",87362,313,2,1120,1038,787,251,1027,11,"CRISCIOR",,7,,475,552
22,"Hunedoara",207,"207-CRISCIOR",87362,314,2,865,699,670,29,691,8,"CRISCIOR",,7,,423,268
22,"Hunedoara",207,"207-DENSUS",89348,315,2,584,381,341,40,375,6,"DENSUS",,7,,209,166
22,"Hunedoara",207,"207-DENSUS",89348,316,2,611,432,381,51,428,4,"DENSUS",,7,,152,276
22,"Hunedoara",207,"207-DENSUS",89348,317,2,408,224,208,16,223,1,"DENSUS",,7,,109,114
22,"Hunedoara",207,"207-DOBRA",89428,318,2,1355,1077,901,176,1067,10,"DOBRA",,7,,590,477
22,"Hunedoara",207,"207-DOBRA",89428,319,2,340,280,198,82,276,4,"DOBRA",,7,,103,173
22,"Hunedoara",207,"207-DOBRA",89428,320,2,312,218,179,39,218,0,"DOBRA",,7,,139,79
22,"Hunedoara",207,"207-DOBRA",89428,321,2,599,481,403,78,473,8,"DOBRA",,7,,304,169
22,"Hunedoara",207,"207-DOBRA",89428,322,2,234,189,163,26,184,5,"DOBRA",,7,,60,124
22,"Hunedoara",207,"207-GEOAGIU",89570,323,2,1058,799,653,146,795,4,"GEOAGIU",,7,,330,465
22,"Hunedoara",207,"207-GEOAGIU",89570,324,2,909,720,627,93,713,7,"GEOAGIU",,7,,204,509
22,"Hunedoara",207,"207-GEOAGIU",89570,325,2,579,505,378,127,502,3,"GEOAGIU",,7,,237,265
22,"Hunedoara",207,"207-GEOAGIU",89570,326,2,230,160,142,18,159,1,"GEOAGIU",,7,,95,64
22,"Hunedoara",207,"207-GEOAGIU",89570,327,2,107,98,77,21,97,1,"GEOAGIU",,7,,59,38
22,"Hunedoara",207,"207-GEOAGIU",89570,328,2,432,510,266,244,510,0,"GEOAGIU",,7,,201,309
22,"Hunedoara",207,"207-GEOAGIU",89570,329,2,359,243,208,35,242,1,"GEOAGIU",,7,,126,116
22,"Hunedoara",207,"207-GEOAGIU",89570,330,2,393,264,234,30,260,4,"GEOAGIU",,7,,111,149
22,"Hunedoara",207,"207-GEOAGIU",89570,331,2,267,168,137,31,168,0,"GEOAGIU",,7,,61,107
22,"Hunedoara",207,"207-GEOAGIU",89570,332,2,80,46,26,20,46,0,"GEOAGIU",,7,,16,30
22,"Hunedoara",207,"207-GEOAGIU",89570,333,2,78,193,48,145,193,0,"GEOAGIU",,7,,62,131
22,"Hunedoara",207,"207-GHELARI",86883,334,2,786,680,571,109,675,5,"GHELARI",,7,,445,230
22,"Hunedoara",207,"207-GHELARI",86883,335,2,1245,979,805,174,974,5,"GHELARI",,7,,643,331
22,"Hunedoara",207,"207-GHELARI",86883,336,2,99,119,66,53,119,0,"GHELARI",,7,,56,63
22,"Hunedoara",207,"207-GURASADA",89687,337,2,760,568,439,129,566,2,"GURASADA",,7,,287,279
22,"Hunedoara",207,"207-GURASADA",89687,338,2,370,310,247,63,308,2,"GURASADA",,7,,154,154
22,"Hunedoara",207,"207-GURASADA",89687,339,2,191,157,145,12,155,2,"GURASADA",,7,,68,87
22,"Hunedoara",207,"207-GURASADA",89687,340,2,191,92,84,8,89,3,"GURASADA",,7,,40,49
22,"Hunedoara",207,"207-HARAU",89801,341,2,894,622,520,102,616,6,"HARAU",,7,,272,344
22,"Hunedoara",207,"207-HARAU",89801,342,2,718,488,424,64,478,10,"HARAU",,7,,185,293
22,"Hunedoara",207,"207-ILIA",89856,343,2,2114,1551,1304,247,1545,6,"ILIA",,7,,896,649
22,"Hunedoara",207,"207-ILIA",89856,344,2,534,416,354,62,410,6,"ILIA",,7,,166,244
22,"Hunedoara",207,"207-ILIA",89856,345,2,506,425,342,83,421,4,"ILIA",,7,,245,176
22,"Hunedoara",207,"207-LAPUGIU DE JOS",89954,346,2,467,430,335,95,400,30,"LAPUGIU DE JOS",,7,,220,180
22,"Hunedoara",207,"207-LAPUGIU DE JOS",89954,347,2,362,276,244,32,272,4,"LAPUGIU DE JOS",,7,,175,97
22,"Hunedoara",207,"207-LAPUGIU DE JOS",89954,348,2,463,300,257,43,294,6,"LAPUGIU DE JOS",,7,,142,152
22,"Hunedoara",207,"207-LELESE",90066,349,2,204,159,122,37,158,1,"LELESE",,7,,123,35
22,"Hunedoara",207,"207-LELESE",90066,350,2,116,97,58,39,97,0,"LELESE",,7,,75,22
22,"Hunedoara",207,"207-LELESE",90066,351,2,140,90,70,20,88,2,"LELESE",,7,,50,38
22,"Hunedoara",207,"207-LUNCA CERNII DE JOS",90119,352,2,525,335,284,51,332,3,"LUNCA CERNII DE JOS",,7,,213,119
22,"Hunedoara",207,"207-LUNCA CERNII DE JOS",90119,353,2,304,147,140,7,147,0,"LUNCA CERNII DE JOS",,7,,79,68
22,"Hunedoara",207,"207-LUNCA CERNII DE JOS",90119,354,2,227,116,80,36,113,3,"LUNCA CERNII DE JOS",,7,,71,42
22,"Hunedoara",207,"207-LUNCOIU DE JOS",90208,355,2,1246,823,779,44,814,9,"LUNCOIU DE JOS",,7,,391,423
22,"Hunedoara",207,"207-LUNCOIU DE JOS",90208,356,2,506,324,292,32,319,5,"LUNCOIU DE JOS",,7,,215,104
22,"Hunedoara",207,"207-MARTINESTI",90262,357,2,190,163,134,29,163,0,"MARTINESTI",,7,,76,87
22,"Hunedoara",207,"207-MARTINESTI",90262,358,2,239,221,167,54,218,3,"MARTINESTI",,7,,97,121
22,"Hunedoara",207,"207-MARTINESTI",90262,359,2,115,128,80,48,125,3,"MARTINESTI",,7,,45,80
22,"Hunedoara",207,"207-MARTINESTI",90262,360,2,231,158,128,30,158,0,"MARTINESTI",,7,,45,113
22,"Hunedoara",207,"207-MARTINESTI",90262,361,2,109,118,88,30,117,1,"MARTINESTI",,7,,62,55
22,"Hunedoara",207,"207-ORASTIOARA DE SUS",90342,362,2,444,335,301,34,335,0,"ORASTIOARA DE SUS",,7,,218,117
22,"Hunedoara",207,"207-ORASTIOARA DE SUS",90342,363,2,292,223,211,12,221,2,"ORASTIOARA DE SUS",,7,,124,97
22,"Hunedoara",207,"207-ORASTIOARA DE SUS",90342,364,2,322,216,189,27,216,0,"ORASTIOARA DE SUS",,7,,79,137
22,"Hunedoara",207,"207-ORASTIOARA DE SUS",90342,365,2,482,332,304,28,327,5,"ORASTIOARA DE SUS",,7,,195,132
22,"Hunedoara",207,"207-ORASTIOARA DE SUS",90342,366,2,204,168,134,34,166,2,"ORASTIOARA DE SUS",,7,,113,53
22,"Hunedoara",207,"207-ORASTIOARA DE SUS",90342,367,2,359,261,228,33,260,1,"ORASTIOARA DE SUS",,7,,82,178
22,"Hunedoara",207,"207-PESTISU MIC",90431,368,2,283,293,229,64,292,1,"PESTISU MIC",,7,,163,129
22,"Hunedoara",207,"207-PESTISU MIC",90431,369,2,224,223,188,35,222,1,"PESTISU MIC",,7,,118,104
22,"Hunedoara",207,"207-PESTISU MIC",90431,370,2,53,79,37,42,79,0,"PESTISU MIC",,7,,34,45
22,"Hunedoara",207,"207-PESTISU MIC",90431,371,2,266,262,201,61,262,0,"PESTISU MIC",,7,,169,93
22,"Hunedoara",207,"207-PESTISU MIC",90431,372,2,84,115,65,50,115,0,"PESTISU MIC",,7,,71,44
22,"Hunedoara",207,"207-PUI",90538,373,2,703,554,416,138,548,6,"PUI",,7,,213,335
22,"Hunedoara",207,"207-PUI",90538,374,2,417,215,193,22,212,3,"PUI",,7,,100,112
22,"Hunedoara",207,"207-PUI",90538,375,2,310,110,95,15,109,1,"PUI",,7,,69,40
22,"Hunedoara",207,"207-PUI",90538,376,2,366,291,235,56,287,4,"PUI",,7,,134,153
22,"Hunedoara",207,"207-PUI",90538,377,2,245,136,102,34,136,0,"PUI",,7,,105,31
22,"Hunedoara",207,"207-PUI",90538,378,2,364,284,215,69,284,0,"PUI",,7,,161,123
22,"Hunedoara",207,"207-PUI",90538,379,2,461,355,281,74,352,3,"PUI",,7,,189,163
22,"Hunedoara",207,"207-PUI",90538,380,2,151,144,101,43,143,1,"PUI",,7,,63,80
22,"Hunedoara",207,"207-PUI",90538,381,2,471,269,242,27,266,3,"PUI",,7,,121,145
22,"Hunedoara",207,"207-PUI",90538,382,2,392,303,244,59,300,3,"PUI",,7,,144,156
22,"Hunedoara",207,"207-RAPOLTU MARE",90663,383,2,847,688,576,112,684,4,"RAPOLTU MARE",,7,,283,401
22,"Hunedoara",207,"207-RAPOLTU MARE",90663,384,2,393,349,295,54,345,4,"RAPOLTU MARE",,7,,197,148
22,"Hunedoara",207,"207-RAPOLTU MARE",90663,385,2,314,254,207,47,251,3,"RAPOLTU MARE",,7,,117,134
22,"Hunedoara",207,"207-RACHITOVA",90725,386,2,758,422,394,28,414,8,"RACHITOVA",,7,,211,203
22,"Hunedoara",207,"207-RACHITOVA",90725,387,2,429,255,221,34,254,1,"RACHITOVA",,7,,108,146
22,"Hunedoara",207,"207-RACHITOVA",90725,388,2,249,177,159,18,176,1,"RACHITOVA",,7,,91,85
22,"Hunedoara",207,"207-RIBITA",90805,389,2,643,447,420,27,443,4,"RIBITA",,7,,297,146
22,"Hunedoara",207,"207-RIBITA",90805,390,2,486,334,315,19,330,4,"RIBITA",,7,,224,106
22,"Hunedoara",207,"207-RIBITA",90805,391,2,263,182,148,34,180,2,"RIBITA",,7,,130,50
22,"Hunedoara",207,"207-RIBITA",90805,392,2,109,59,46,13,58,1,"RIBITA",,7,,45,13
22,"Hunedoara",207,"207-RAU DE MORI",90878,393,2,804,831,508,323,824,7,"RAU DE MORI",,7,,329,495
22,"Hunedoara",207,"207-RAU DE MORI",90878,394,2,740,572,508,64,568,4,"RAU DE MORI",,7,,217,351
22,"Hunedoara",207,"207-RAU DE MORI",90878,395,2,475,383,365,18,381,2,"RAU DE MORI",,7,,130,251
22,"Hunedoara",207,"207-RAU DE MORI",90878,396,2,154,130,109,21,130,0,"RAU DE MORI",,7,,51,79
22,"Hunedoara",207,"207-RAU DE MORI",90878,397,2,297,226,213,13,226,0,"RAU DE MORI",,7,,54,172
22,"Hunedoara",207,"207-RAU DE MORI",90878,398,2,354,202,184,18,198,3,"RAU DE MORI",,7,,73,125
22,"Hunedoara",207,"207-ROMOS",90994,399,2,948,716,668,48,712,4,"ROMOS",,7,,206,506
22,"Hunedoara",207,"207-ROMOS",90994,400,2,679,426,373,53,422,4,"ROMOS",,7,,123,299
22,"Hunedoara",207,"207-ROMOS",90994,401,2,534,402,345,57,396,6,"ROMOS",,7,,181,215
22,"Hunedoara",207,"207-ROMOS",90994,402,2,205,191,160,31,190,1,"ROMOS",,7,,119,71
22,"Hunedoara",207,"207-SARMIZEGETUSA",91054,403,2,1036,741,687,54,740,1,"SARMIZEGETUSA",,7,,393,347
22,"Hunedoara",207,"207-SARMIZEGETUSA",91054,404,2,168,123,103,20,123,0,"SARMIZEGETUSA",,7,,46,77
22,"Hunedoara",207,"207-SALASU DE SUS",91116,405,2,1043,663,595,68,661,2,"SALASU DE SUS",,7,,337,324
22,"Hunedoara",207,"207-SALASU DE SUS",91116,406,2,463,356,307,49,355,1,"SALASU DE SUS",,7,,146,209
22,"Hunedoara",207,"207-SALASU DE SUS",91116,407,2,575,336,307,29,334,2,"SALASU DE SUS",,7,,174,160
22,"Hunedoara",207,"207-SALASU DE SUS",91116,408,2,467,282,266,16,273,9,"SALASU DE SUS",,7,,107,166
22,"Hunedoara",207,"207-SANTAMARIA-ORLEA",91232,409,2,803,781,491,290,774,7,"SANTAMARIA-ORLEA",,7,,310,464
22,"Hunedoara",207,"207-SANTAMARIA-ORLEA",91232,410,2,800,701,587,114,686,15,"SANTAMARIA-ORLEA",,7,,346,340
22,"Hunedoara",207,"207-SANTAMARIA-ORLEA",91232,411,2,821,727,656,71,719,8,"SANTAMARIA-ORLEA",,7,,355,364
22,"Hunedoara",207,"207-SOIMUS",91330,412,2,1126,942,824,118,931,11,"SOIMUS",,7,,480,451
22,"Hunedoara",207,"207-SOIMUS",91330,413,2,250,275,230,45,273,2,"SOIMUS",,7,,134,139
22,"Hunedoara",207,"207-SOIMUS",91330,414,2,784,653,544,109,653,0,"SOIMUS",,7,,306,347
22,"Hunedoara",207,"207-SOIMUS",91330,415,2,224,200,158,42,197,3,"SOIMUS",,7,,112,85
22,"Hunedoara",207,"207-SOIMUS",91330,416,2,288,281,235,46,278,3,"SOIMUS",,7,,154,124
22,"Hunedoara",207,"207-TELIUCU INFERIOR",86936,417,2,1125,931,727,204,921,10,"TELIUCU INFERIOR",,7,,499,422
22,"Hunedoara",207,"207-TELIUCU INFERIOR",86936,418,2,580,482,404,78,477,5,"TELIUCU INFERIOR",,7,,272,205
22,"Hunedoara",207,"207-TELIUCU INFERIOR",86936,419,2,145,138,102,36,138,0,"TELIUCU INFERIOR",,7,,94,44
22,"Hunedoara",207,"207-TELIUCU INFERIOR",86936,420,2,280,198,162,36,193,5,"TELIUCU INFERIOR",,7,,129,64
22,"Hunedoara",207,"207-TOMESTI",91447,421,2,751,454,418,36,451,3,"TOMESTI",,7,,243,208
22,"Hunedoara",207,"207-TOMESTI",91447,422,2,443,373,332,41,371,2,"TOMESTI",,7,,211,160
22,"Hunedoara",207,"207-TOPLITA",91535,423,2,309,206,157,49,204,2,"TOPLITA",,7,,121,83
22,"Hunedoara",207,"207-TOPLITA",91535,424,2,201,160,137,23,159,1,"TOPLITA",,7,,119,40
22,"Hunedoara",207,"207-TOPLITA",91535,425,2,343,277,247,30,276,1,"TOPLITA",,7,,160,116
22,"Hunedoara",207,"207-TOTESTI",91624,426,2,346,307,291,16,307,0,"TOTESTI",,7,,198,109
22,"Hunedoara",207,"207-TOTESTI",91624,427,2,422,352,328,24,349,3,"TOTESTI",,7,,159,190
22,"Hunedoara",207,"207-TOTESTI",91624,428,2,290,260,234,26,260,0,"TOTESTI",,7,,133,127
22,"Hunedoara",207,"207-TOTESTI",91624,429,2,395,377,345,32,374,3,"TOTESTI",,7,,179,195
22,"Hunedoara",207,"207-TURDAS",91688,430,2,349,338,262,76,336,2,"TURDAS",,7,,124,212
22,"Hunedoara",207,"207-TURDAS",91688,431,2,758,724,588,136,718,6,"TURDAS",,7,,324,394
22,"Hunedoara",207,"207-TURDAS",91688,432,2,220,198,151,47,197,1,"TURDAS",,7,,78,119
22,"Hunedoara",207,"207-UNIREA",91731,433,2,855,519,478,41,513,6,"UNIREA",,7,,260,253
22,"Hunedoara",207,"207-VATA DE JOS",91795,434,2,1876,1249,1162,87,1244,5,"VATA DE JOS",,7,,855,389
22,"Hunedoara",207,"207-VATA DE JOS",91795,435,2,662,442,406,36,441,1,"VATA DE JOS",,7,,315,126
22,"Hunedoara",207,"207-VATA DE JOS",91795,436,2,210,170,148,22,170,0,"VATA DE JOS",,7,,101,69
22,"Hunedoara",207,"207-VATA DE JOS",91795,437,2,300,167,156,11,167,0,"VATA DE JOS",,7,,142,25
22,"Hunedoara",207,"207-VATA DE JOS",91795,438,2,324,213,194,19,210,3,"VATA DE JOS",,7,,129,81
22,"Hunedoara",207,"207-VATA DE JOS",91795,439,2,517,312,284,28,309,3,"VATA DE JOS",,7,,190,119
22,"Hunedoara",207,"207-VALISOARA",87978,440,2,716,512,435,77,507,5,"VALISOARA",,7,,234,273
22,"Hunedoara",207,"207-VALISOARA",87978,441,2,206,251,162,89,250,1,"VALISOARA",,7,,119,131
22,"Hunedoara",207,"207-VALISOARA",87978,442,2,275,220,195,25,214,6,"VALISOARA",,7,,91,123
22,"Hunedoara",207,"207-VETEL",91982,443,2,614,540,446,94,538,1,"VETEL",,7,,233,305
22,"Hunedoara",207,"207-VETEL",91982,444,2,141,132,101,31,129,3,"VETEL",,7,,29,100
22,"Hunedoara",207,"207-VETEL",91982,445,2,339,331,257,74,329,2,"VETEL",,7,,142,187
22,"Hunedoara",207,"207-VETEL",91982,446,2,487,469,295,174,466,3,"VETEL",,7,,172,294
22,"Hunedoara",207,"207-VETEL",91982,447,2,157,171,80,91,168,3,"VETEL",,7,,75,93
22,"Hunedoara",207,"207-VETEL",91982,448,2,123,99,78,21,99,0,"VETEL",,7,,22,77
22,"Hunedoara",207,"207-VORTA",92097,449,2,222,163,142,21,162,1,"VORTA",,7,,112,50
22,"Hunedoara",207,"207-VORTA",92097,450,2,225,137,120,17,133,4,"VORTA",,7,,92,41
22,"Hunedoara",207,"207-VORTA",92097,451,2,622,376,354,22,374,2,"VORTA",,7,,302,72
22,"Hunedoara",207,"207-ZAM",92177,452,2,579,516,413,103,513,3,"ZAM",,7,,238,275
22,"Hunedoara",207,"207-ZAM",92177,453,2,348,256,210,46,255,1,"ZAM",,7,,139,116
22,"Hunedoara",207,"207-ZAM",92177,454,2,244,160,139,21,157,3,"ZAM",,7,,48,109
22,"Hunedoara",207,"207-ZAM",92177,455,2,380,375,294,81,372,3,"ZAM",,7,,177,195
22,"Hunedoara",207,"207-ZAM",92177,456,2,194,129,120,9,127,2,"ZAM",,7,,54,73
22,"Hunedoara",207,"207-ZAM",92177,457,2,0,168,0,168,161,7,"ZAM",,7,,49,112
23,"Ialomița",216,"216-MUNICIPIUL SLOBOZIA",92658,1,2,1701,1252,1125,127,1245,7,"MUNICIPIUL SLOBOZIA",,5,,616,629
23,"Ialomița",216,"216-MUNICIPIUL SLOBOZIA",92658,2,2,1665,1154,1069,85,1142,12,"MUNICIPIUL SLOBOZIA",,5,,538,604
23,"Ialomița",216,"216-MUNICIPIUL SLOBOZIA",92658,3,2,1694,1199,1107,92,1186,13,"MUNICIPIUL SLOBOZIA",,5,,580,606
23,"Ialomița",216,"216-MUNICIPIUL SLOBOZIA",92658,4,2,1727,1230,1125,105,1222,8,"MUNICIPIUL SLOBOZIA",,5,,610,612
23,"Ialomița",216,"216-MUNICIPIUL SLOBOZIA",92658,5,2,1156,808,752,56,802,6,"MUNICIPIUL SLOBOZIA",,5,,396,406
23,"Ialomița",216,"216-MUNICIPIUL SLOBOZIA",92658,6,2,1600,1237,1179,58,1232,5,"MUNICIPIUL SLOBOZIA",,5,,602,630
23,"Ialomița",216,"216-MUNICIPIUL SLOBOZIA",92658,7,2,1387,1123,985,138,1120,3,"MUNICIPIUL SLOBOZIA",,5,,528,592
23,"Ialomița",216,"216-MUNICIPIUL SLOBOZIA",92658,8,2,1643,1185,1116,69,1184,1,"MUNICIPIUL SLOBOZIA",,5,,589,595
23,"Ialomița",216,"216-MUNICIPIUL SLOBOZIA",92658,9,2,1450,1083,976,107,1078,5,"MUNICIPIUL SLOBOZIA",,5,,545,533
23,"Ialomița",216,"216-MUNICIPIUL SLOBOZIA",92658,10,2,1092,810,732,78,809,1,"MUNICIPIUL SLOBOZIA",,5,,410,399
23,"Ialomița",216,"216-MUNICIPIUL SLOBOZIA",92658,11,2,1224,912,836,76,907,5,"MUNICIPIUL SLOBOZIA",,5,,423,484
23,"Ialomița",216,"216-MUNICIPIUL SLOBOZIA",92658,12,2,1400,929,853,76,927,2,"MUNICIPIUL SLOBOZIA",,5,,511,416
23,"Ialomița",216,"216-MUNICIPIUL SLOBOZIA",92658,13,2,1649,1129,1006,123,1113,16,"MUNICIPIUL SLOBOZIA",,5,,502,611
23,"Ialomița",216,"216-MUNICIPIUL SLOBOZIA",92658,14,2,1287,896,800,96,894,2,"MUNICIPIUL SLOBOZIA",,5,,407,487
23,"Ialomița",216,"216-MUNICIPIUL SLOBOZIA",92658,15,2,1722,1201,1119,82,1195,6,"MUNICIPIUL SLOBOZIA",,5,,535,660
23,"Ialomița",216,"216-MUNICIPIUL SLOBOZIA",92658,16,2,1522,1037,925,112,1032,5,"MUNICIPIUL SLOBOZIA",,5,,498,534
23,"Ialomița",216,"216-MUNICIPIUL SLOBOZIA",92658,17,2,1754,1159,1035,124,1144,15,"MUNICIPIUL SLOBOZIA",,5,,514,630
23,"Ialomița",216,"216-MUNICIPIUL SLOBOZIA",92658,18,2,1790,1311,1215,96,1304,7,"MUNICIPIUL SLOBOZIA",,5,,647,657
23,"Ialomița",216,"216-MUNICIPIUL SLOBOZIA",92658,19,2,1055,806,740,66,799,7,"MUNICIPIUL SLOBOZIA",,5,,369,430
23,"Ialomița",216,"216-MUNICIPIUL SLOBOZIA",92658,20,2,1511,1164,1112,52,1159,5,"MUNICIPIUL SLOBOZIA",,5,,610,549
23,"Ialomița",216,"216-MUNICIPIUL SLOBOZIA",92658,21,2,1299,1027,922,105,1024,3,"MUNICIPIUL SLOBOZIA",,5,,488,536
23,"Ialomița",216,"216-MUNICIPIUL SLOBOZIA",92658,22,2,360,1012,945,67,1005,7,"MUNICIPIUL SLOBOZIA",,5,,458,547
23,"Ialomița",216,"216-MUNICIPIUL SLOBOZIA",92658,23,2,1545,1168,1101,67,1161,7,"MUNICIPIUL SLOBOZIA",,5,,521,640
23,"Ialomița",216,"216-MUNICIPIUL SLOBOZIA",92658,24,2,1476,1114,1016,98,1107,7,"MUNICIPIUL SLOBOZIA",,5,,509,598
23,"Ialomița",216,"216-MUNICIPIUL SLOBOZIA",92658,25,2,1036,847,756,91,845,2,"MUNICIPIUL SLOBOZIA",,5,,415,430
23,"Ialomița",216,"216-MUNICIPIUL SLOBOZIA",92658,26,2,555,482,423,59,481,1,"MUNICIPIUL SLOBOZIA",,5,,189,292
23,"Ialomița",216,"216-MUNICIPIUL SLOBOZIA",92658,27,2,1453,988,902,86,974,14,"MUNICIPIUL SLOBOZIA",,5,,515,459
23,"Ialomița",216,"216-MUNICIPIUL SLOBOZIA",92658,28,2,1015,787,604,183,768,19,"MUNICIPIUL SLOBOZIA",,5,,383,385
23,"Ialomița",216,"216-MUNICIPIUL SLOBOZIA",92658,29,2,1433,1081,973,108,1072,9,"MUNICIPIUL SLOBOZIA",,5,,600,472
23,"Ialomița",216,"216-MUNICIPIUL SLOBOZIA",92658,30,2,397,472,305,167,470,2,"MUNICIPIUL SLOBOZIA",,5,,247,223
23,"Ialomița",216,"216-MUNICIPIUL SLOBOZIA",92658,31,2,282,284,262,22,278,6,"MUNICIPIUL SLOBOZIA",,5,,117,161
23,"Ialomița",216,"216-MUNICIPIUL SLOBOZIA",92658,32,2,88,98,86,12,98,0,"MUNICIPIUL SLOBOZIA",,5,,58,40
23,"Ialomița",216,"216-MUNICIPIUL SLOBOZIA",92658,33,2,543,540,540,0,533,7,"MUNICIPIUL SLOBOZIA",,5,,97,436
23,"Ialomița",216,"216-MUNICIPIUL FETESTI",92701,34,2,947,764,684,80,761,3,"MUNICIPIUL FETESTI",,5,,581,180
23,"Ialomița",216,"216-MUNICIPIUL FETESTI",92701,35,2,1621,1221,1107,114,1207,14,"MUNICIPIUL FETESTI",,5,,809,398
23,"Ialomița",216,"216-MUNICIPIUL FETESTI",92701,36,2,1686,1233,1100,133,1229,4,"MUNICIPIUL FETESTI",,5,,847,382
23,"Ialomița",216,"216-MUNICIPIUL FETESTI",92701,37,2,892,776,634,142,765,11,"MUNICIPIUL FETESTI",,5,,496,269
23,"Ialomița",216,"216-MUNICIPIUL FETESTI",92701,38,2,1932,1508,1257,251,1496,12,"MUNICIPIUL FETESTI",,5,,1032,464
23,"Ialomița",216,"216-MUNICIPIUL FETESTI",92701,39,2,1491,1095,974,121,1081,14,"MUNICIPIUL FETESTI",,5,,754,327
23,"Ialomița",216,"216-MUNICIPIUL FETESTI",92701,40,2,1641,1184,1072,112,1178,6,"MUNICIPIUL FETESTI",,5,,713,465
23,"Ialomița",216,"216-MUNICIPIUL FETESTI",92701,41,2,2074,1485,1286,199,1472,13,"MUNICIPIUL FETESTI",,5,,803,669
23,"Ialomița",216,"216-MUNICIPIUL FETESTI",92701,42,2,2080,1553,1284,269,1550,3,"MUNICIPIUL FETESTI",,5,,859,691
23,"Ialomița",216,"216-MUNICIPIUL FETESTI",92701,43,2,1968,1451,1338,113,1445,6,"MUNICIPIUL FETESTI",,5,,904,541
23,"Ialomița",216,"216-MUNICIPIUL FETESTI",92701,44,2,1009,851,707,144,847,4,"MUNICIPIUL FETESTI",,5,,587,260
23,"Ialomița",216,"216-MUNICIPIUL FETESTI",92701,45,2,1582,1236,1087,149,1234,2,"MUNICIPIUL FETESTI",,5,,697,537
23,"Ialomița",216,"216-MUNICIPIUL FETESTI",92701,46,2,1610,1172,1045,127,1170,2,"MUNICIPIUL FETESTI",,5,,682,488
23,"Ialomița",216,"216-MUNICIPIUL FETESTI",92701,47,2,1489,1157,1044,113,1151,6,"MUNICIPIUL FETESTI",,5,,653,498
23,"Ialomița",216,"216-MUNICIPIUL FETESTI",92701,48,2,1317,990,920,70,980,10,"MUNICIPIUL FETESTI",,5,,667,313
23,"Ialomița",216,"216-MUNICIPIUL FETESTI",92701,49,2,1338,1012,914,98,1001,11,"MUNICIPIUL FETESTI",,5,,679,322
23,"Ialomița",216,"216-MUNICIPIUL FETESTI",92701,50,2,1818,1387,1282,105,1365,22,"MUNICIPIUL FETESTI",,5,,895,470
23,"Ialomița",216,"216-MUNICIPIUL FETESTI",92701,51,2,449,464,418,46,454,10,"MUNICIPIUL FETESTI",,5,,315,139
23,"Ialomița",216,"216-MUNICIPIUL URZICENI",100683,52,2,1522,1033,925,108,1018,15,"MUNICIPIUL URZICENI",,5,,534,484
23,"Ialomița",216,"216-MUNICIPIUL URZICENI",100683,53,2,1542,1085,997,88,1083,2,"MUNICIPIUL URZICENI",,5,,488,595
23,"Ialomița",216,"216-MUNICIPIUL URZICENI",100683,54,2,747,586,498,88,581,5,"MUNICIPIUL URZICENI",,5,,283,298
23,"Ialomița",216,"216-MUNICIPIUL URZICENI",100683,55,2,990,771,703,68,768,3,"MUNICIPIUL URZICENI",,5,,354,414
23,"Ialomița",216,"216-MUNICIPIUL URZICENI",100683,56,2,1208,892,860,32,890,2,"MUNICIPIUL URZICENI",,5,,434,456
23,"Ialomița",216,"216-MUNICIPIUL URZICENI",100683,57,2,1376,1052,944,108,1047,5,"MUNICIPIUL URZICENI",,5,,468,579
23,"Ialomița",216,"216-MUNICIPIUL URZICENI",100683,58,2,1445,1120,1019,101,1114,6,"MUNICIPIUL URZICENI",,5,,569,545
23,"Ialomița",216,"216-MUNICIPIUL URZICENI",100683,59,2,1396,996,937,59,989,7,"MUNICIPIUL URZICENI",,5,,462,527
23,"Ialomița",216,"216-MUNICIPIUL URZICENI",100683,60,2,1420,959,909,50,948,11,"MUNICIPIUL URZICENI",,5,,502,446
23,"Ialomița",216,"216-MUNICIPIUL URZICENI",100683,61,2,1357,1010,918,92,999,11,"MUNICIPIUL URZICENI",,5,,501,498
23,"Ialomița",216,"216-MUNICIPIUL URZICENI",100683,62,2,1194,816,710,106,802,14,"MUNICIPIUL URZICENI",,5,,398,404
23,"Ialomița",216,"216-ORAS TANDAREI",92765,63,2,1595,1164,1058,106,1155,9,"ORAS TANDAREI",,5,,632,523
23,"Ialomița",216,"216-ORAS TANDAREI",92765,64,2,254,903,842,61,893,10,"ORAS TANDAREI",,5,,560,333
23,"Ialomița",216,"216-ORAS TANDAREI",92765,65,2,1938,1281,1214,67,1277,4,"ORAS TANDAREI",,5,,658,619
23,"Ialomița",216,"216-ORAS TANDAREI",92765,66,2,1212,882,837,45,871,11,"ORAS TANDAREI",,5,,595,276
23,"Ialomița",216,"216-ORAS TANDAREI",92765,67,2,1149,1138,1053,85,1125,13,"ORAS TANDAREI",,5,,677,448
23,"Ialomița",216,"216-ORAS TANDAREI",92765,68,2,1387,1114,934,180,1105,9,"ORAS TANDAREI",,5,,711,394
23,"Ialomița",216,"216-ORAS TANDAREI",92765,69,2,1275,810,728,82,795,15,"ORAS TANDAREI",,5,,554,241
23,"Ialomița",216,"216-ADANCATA",100754,70,2,1800,1314,1154,160,1301,13,"ADANCATA",,5,,863,438
23,"Ialomița",216,"216-ADANCATA",100754,71,2,893,708,563,145,687,21,"ADANCATA",,5,,377,310
23,"Ialomița",216,"216-ADANCATA",100754,72,2,39,53,39,14,53,0,"ADANCATA",,5,,26,27
23,"Ialomița",216,"216-ALBESTI",92783,73,2,675,441,342,99,436,5,"ALBESTI",,5,,247,189
23,"Ialomița",216,"216-ALBESTI",92783,74,2,1023,703,599,104,695,8,"ALBESTI",,5,,384,311
23,"Ialomița",216,"216-ALBESTI",92783,75,2,538,432,334,98,425,7,"ALBESTI",,5,,276,149
23,"Ialomița",216,"216-ALEXENI",100852,76,2,1930,1204,1115,89,1191,13,"ALEXENI",,5,,742,449
23,"Ialomița",216,"216-ALEXENI",100852,77,2,181,170,170,0,168,2,"ALEXENI",,5,,90,78
23,"Ialomița",216,"216-AMARA",92845,78,2,1880,1221,1096,125,1210,11,"AMARA",,5,,666,544
23,"Ialomița",216,"216-AMARA",92845,79,2,1932,1252,1122,130,1236,16,"AMARA",,5,,683,553
23,"Ialomița",216,"216-AMARA",92845,80,2,1695,1050,951,99,1040,10,"AMARA",,5,,541,499
23,"Ialomița",216,"216-AMARA",92845,81,2,0,189,0,189,186,3,"AMARA",,5,,128,58
23,"Ialomița",216,"216-AMARA",92845,82,2,0,223,0,223,220,3,"AMARA",,5,,143,77
23,"Ialomița",216,"216-ANDRASESTI",92872,83,2,1729,1206,1021,185,1191,15,"ANDRASESTI",,5,,701,490
23,"Ialomița",216,"216-ARMASESTI",100870,84,2,545,390,317,73,382,8,"ARMASESTI",,5,,248,134
23,"Ialomița",216,"216-ARMASESTI",100870,85,2,1120,620,571,49,604,16,"ARMASESTI",,5,,466,138
23,"Ialomița",216,"216-ARMASESTI",100870,86,2,1190,731,676,55,583,148,"ARMASESTI",,5,,324,259
23,"Ialomița",216,"216-ARMASESTI",100870,87,2,1517,1419,1310,109,1389,30,"ARMASESTI",,5,,421,968
23,"Ialomița",216,"216-AXINTELE",100923,88,2,747,486,386,100,475,11,"AXINTELE",,5,,373,102
23,"Ialomița",216,"216-AXINTELE",100923,89,2,993,671,568,103,663,8,"AXINTELE",,5,,378,285
23,"Ialomița",216,"216-AXINTELE",100923,90,2,611,466,377,89,463,3,"AXINTELE",,5,,364,99
23,"Ialomița",216,"216-BALACIU",92907,91,2,957,674,520,154,659,15,"BALACIU",,5,,409,250
23,"Ialomița",216,"216-BALACIU",92907,92,2,1127,868,675,193,855,13,"BALACIU",,5,,584,271
23,"Ialomița",216,"216-BALACIU",92907,93,2,862,521,431,90,509,12,"BALACIU",,5,,298,211
23,"Ialomița",216,"216-BARCANESTI",101056,94,2,1975,1236,1054,182,1223,13,"BARCANESTI",,5,,867,356
23,"Ialomița",216,"216-BARCANESTI",101056,95,2,1279,913,658,255,899,14,"BARCANESTI",,5,,617,282
23,"Ialomița",216,"216-BORDUSANI",92989,96,2,1696,1087,955,132,1078,9,"BORDUSANI",,5,,666,412
23,"Ialomița",216,"216-BORDUSANI",92989,97,2,1285,689,628,61,675,14,"BORDUSANI",,5,,403,272
23,"Ialomița",216,"216-BORDUSANI",92989,98,2,972,786,677,109,775,11,"BORDUSANI",,5,,449,326
23,"Ialomița",216,"216-BRAZII",101252,99,2,1303,811,726,85,790,21,"BRAZII",,5,,482,308
23,"Ialomița",216,"216-BRAZII",101252,100,2,1677,1140,1048,92,1123,17,"BRAZII",,5,,736,387
23,"Ialomița",216,"216-BUCU",93021,101,2,1884,1321,1129,192,1313,8,"BUCU",,5,,809,504
23,"Ialomița",216,"216-BUCU",93021,102,2,1851,1395,1096,299,1375,20,"BUCU",,5,,739,636
23,"Ialomița",216,"216-CAZANESTI",93076,103,2,1543,1105,908,197,1091,14,"CAZANESTI",,5,,612,479
23,"Ialomița",216,"216-CAZANESTI",93076,104,2,1122,834,713,121,829,5,"CAZANESTI",,5,,517,312
23,"Ialomița",216,"216-CIOCHINA",93101,105,2,482,914,759,155,906,8,"CIOCHINA",,5,,557,349
23,"Ialomița",216,"216-CIOCHINA",93101,106,2,751,563,467,96,553,10,"CIOCHINA",,5,,360,193
23,"Ialomița",216,"216-CIOCHINA",93101,107,2,750,566,499,67,560,6,"CIOCHINA",,5,,381,179
23,"Ialomița",216,"216-CIOCARLIA",100709,108,2,728,520,450,70,511,9,"CIOCARLIA",,5,,314,197
23,"Ialomița",216,"216-CIULNITA",93156,109,2,1018,766,649,117,752,14,"CIULNITA",,5,,489,263
23,"Ialomița",216,"216-CIULNITA",93156,110,2,787,532,442,90,529,3,"CIULNITA",,5,,358,171
23,"Ialomița",216,"216-COCORA",93209,111,2,2042,1235,1112,123,1216,19,"COCORA",,5,,880,336
23,"Ialomița",216,"216-COCORA",93209,112,2,1135,803,657,146,797,6,"COCORA",,5,,568,229
23,"Ialomița",216,"216-COSAMBESTI",93236,113,2,757,534,449,85,525,9,"COSAMBESTI",,5,,323,202
23,"Ialomița",216,"216-COSAMBESTI",93236,114,2,700,526,456,70,518,8,"COSAMBESTI",,5,,328,190
23,"Ialomița",216,"216-COSAMBESTI",93236,115,2,1240,937,791,146,930,7,"COSAMBESTI",,5,,668,262
23,"Ialomița",216,"216-COSERENI",102240,116,2,1579,1363,1094,269,1355,8,"COSERENI",,5,,776,579
23,"Ialomița",216,"216-COSERENI",102240,117,2,1108,864,730,134,849,15,"COSERENI",,5,,622,227
23,"Ialomița",216,"216-COSERENI",102240,118,2,990,848,706,142,843,5,"COSERENI",,5,,577,266
23,"Ialomița",216,"216-COSERENI",102240,119,2,1681,1197,986,211,1153,44,"COSERENI",,5,,686,467
23,"Ialomița",216,"216-DRAGOESTI",102641,120,2,900,533,417,116,517,16,"DRAGOESTI",,5,,282,235
23,"Ialomița",216,"216-DRIDU",102703,121,2,2059,1398,1135,263,1383,15,"DRIDU",,5,,702,681
23,"Ialomița",216,"216-DRIDU",102703,122,2,849,528,430,98,524,4,"DRIDU",,5,,272,252
23,"Ialomița",216,"216-DRIDU",102703,123,2,415,289,257,32,287,2,"DRIDU",,5,,183,104
23,"Ialomița",216,"216-DRIDU",102703,124,2,180,835,723,112,826,9,"DRIDU",,5,,510,316
23,"Ialomița",216,"216-FACAENI",93575,125,2,2150,1563,1317,246,1542,21,"FACAENI",,5,,1098,444
23,"Ialomița",216,"216-FACAENI",93575,126,2,2002,1469,1236,233,1455,14,"FACAENI",,5,,1078,377
23,"Ialomița",216,"216-FACAENI",93575,127,2,455,406,295,111,403,3,"FACAENI",,5,,293,110
23,"Ialomița",216,"216-FIERBINTI-TARG",102758,128,2,1569,868,685,183,859,9,"FIERBINTI-TARG",,5,,421,438
23,"Ialomița",216,"216-FIERBINTI-TARG",102758,129,2,1598,1062,934,128,1052,10,"FIERBINTI-TARG",,5,,649,403
23,"Ialomița",216,"216-FIERBINTI-TARG",102758,130,2,1042,797,712,85,780,17,"FIERBINTI-TARG",,5,,501,279
23,"Ialomița",216,"216-GHEORGHE DOJA",93600,131,2,1379,1036,937,99,1025,11,"GHEORGHE DOJA",,5,,675,350
23,"Ialomița",216,"216-GHEORGHE DOJA",93600,132,2,1031,754,681,73,746,8,"GHEORGHE DOJA",,5,,501,245
23,"Ialomița",216,"216-GHEORGHE LAZAR",93628,133,2,1951,1373,1229,144,1355,18,"GHEORGHE LAZAR",,5,,795,560
23,"Ialomița",216,"216-GIURGENI",93646,134,2,1220,937,802,135,931,6,"GIURGENI",,5,,643,288
23,"Ialomița",216,"216-GARBOVI",103283,135,2,2072,1240,1143,97,1228,12,"GARBOVI",,5,,737,491
23,"Ialomița",216,"216-GARBOVI",103283,136,2,1805,1080,1004,76,1056,24,"GARBOVI",,5,,750,306
23,"Ialomița",216,"216-GRINDU",93717,137,2,2042,1407,1294,113,1397,10,"GRINDU",,5,,1076,321
23,"Ialomița",216,"216-GRIVITA",93735,138,2,1243,730,637,93,722,8,"GRIVITA",,5,,480,242
23,"Ialomița",216,"216-GRIVITA",93735,139,2,1339,689,622,67,682,7,"GRIVITA",,5,,435,247
23,"Ialomița",216,"216-GRIVITA",93735,140,2,1100,779,640,139,767,12,"GRIVITA",,5,,518,249
23,"Ialomița",216,"216-GRIVITA",93735,141,2,1145,930,745,185,910,20,"GRIVITA",,5,,623,287
23,"Ialomița",216,"216-GRIVITA",93735,142,2,874,708,530,178,694,14,"GRIVITA",,5,,455,239
23,"Ialomița",216,"216-ION ROATA",103862,143,2,948,747,583,164,737,10,"ION ROATA",,5,,436,301
23,"Ialomița",216,"216-ION ROATA",103862,144,2,995,655,528,127,652,3,"ION ROATA",,5,,435,217
23,"Ialomița",216,"216-ION ROATA",103862,145,2,1027,760,650,110,752,8,"ION ROATA",,5,,476,276
23,"Ialomița",216,"216-JILAVELE",103960,146,2,1597,1097,1018,79,1088,9,"JILAVELE",,5,,816,272
23,"Ialomița",216,"216-JILAVELE",103960,147,2,1654,1055,991,64,1041,14,"JILAVELE",,5,,764,277
23,"Ialomița",216,"216-MANASIA",100736,148,2,1818,1237,1063,174,1224,13,"MANASIA",,5,,810,414
23,"Ialomița",216,"216-MANASIA",100736,149,2,1629,1118,976,142,1105,13,"MANASIA",,5,,692,413
23,"Ialomița",216,"216-MIHAIL KOGALNICEANU",93995,150,2,1354,1015,862,153,1004,11,"MIHAIL KOGALNICEANU",,5,,715,289
23,"Ialomița",216,"216-MIHAIL KOGALNICEANU",93995,151,2,1474,996,812,184,987,9,"MIHAIL KOGALNICEANU",,5,,750,237
23,"Ialomița",216,"216-MIHAIL KOGALNICEANU",93995,152,2,1112,913,779,134,903,10,"MIHAIL KOGALNICEANU",,5,,723,180
23,"Ialomița",216,"216-MIHAIL KOGALNICEANU",93995,153,2,1006,823,693,130,801,22,"MIHAIL KOGALNICEANU",,5,,624,177
23,"Ialomița",216,"216-MILOSESTI",94045,154,2,1696,1153,1059,94,1140,13,"MILOSESTI",,5,,890,250
23,"Ialomița",216,"216-MILOSESTI",94045,155,2,472,301,252,49,299,2,"MILOSESTI",,5,,207,92
23,"Ialomița",216,"216-MILOSESTI",94045,156,2,410,341,253,88,335,6,"MILOSESTI",,5,,204,131
23,"Ialomița",216,"216-MOVILA",94081,157,2,1537,1093,986,107,1079,14,"MOVILA",,5,,735,344
23,"Ialomița",216,"216-MOVILITA",104270,158,2,1104,797,683,114,775,22,"MOVILITA",,5,,535,240
23,"Ialomița",216,"216-MOVILITA",104270,159,2,908,485,408,77,478,7,"MOVILITA",,5,,277,201
23,"Ialomița",216,"216-MOVILITA",104270,160,2,1634,1282,1099,183,1272,10,"MOVILITA",,5,,970,302
23,"Ialomița",216,"216-MUNTENI-BUZAU",94107,161,2,1727,1061,904,157,1048,13,"MUNTENI-BUZAU",,5,,701,347
23,"Ialomița",216,"216-MUNTENI-BUZAU",94107,162,2,1516,1022,891,131,1009,13,"MUNTENI-BUZAU",,5,,672,337
23,"Ialomița",216,"216-PERIETI",94161,163,2,1696,1039,898,141,1028,11,"PERIETI",,5,,716,312
23,"Ialomița",216,"216-PERIETI",94161,164,2,688,464,357,107,459,5,"PERIETI",,5,,290,169
23,"Ialomița",216,"216-PERIETI",94161,165,2,203,220,106,114,214,6,"PERIETI",,5,,79,135
23,"Ialomița",216,"216-REVIGA",94269,166,2,1540,959,753,206,941,18,"REVIGA",,5,,647,294
23,"Ialomița",216,"216-REVIGA",94269,167,2,926,782,664,118,768,14,"REVIGA",,5,,507,261
23,"Ialomița",216,"216-REVIGA",94269,168,2,558,477,375,102,469,8,"REVIGA",,5,,300,169
23,"Ialomița",216,"216-SALCIOARA",94330,169,2,947,669,568,101,654,15,"SALCIOARA",,5,,397,257
23,"Ialomița",216,"216-SALCIOARA",94330,170,2,1100,794,711,83,778,16,"SALCIOARA",,5,,534,244
23,"Ialomița",216,"216-SAVENI",94376,171,2,1342,853,781,72,842,11,"SAVENI",,5,,613,229
23,"Ialomița",216,"216-SAVENI",94376,172,2,1348,922,830,92,915,7,"SAVENI",,5,,662,253
23,"Ialomița",216,"216-SAVENI",94376,173,2,380,410,321,89,410,0,"SAVENI",,5,,238,172
23,"Ialomița",216,"216-SAVENI",94376,174,2,1460,1119,950,169,1103,16,"SAVENI",,5,,869,234
23,"Ialomița",216,"216-SCANTEIA",94429,175,2,2528,1691,1505,186,1680,11,"SCANTEIA",,5,,1337,343
23,"Ialomița",216,"216-SCANTEIA",94429,176,2,834,756,588,168,747,9,"SCANTEIA",,5,,606,141
23,"Ialomița",216,"216-SFANTU GHEORGHE",94456,177,2,779,603,508,95,595,8,"SFANTU GHEORGHE",,5,,392,203
23,"Ialomița",216,"216-SFANTU GHEORGHE",94456,178,2,961,754,608,146,748,6,"SFANTU GHEORGHE",,5,,502,246
23,"Ialomița",216,"216-SINESTI",105026,179,2,1098,703,576,127,698,5,"SINESTI",,5,,259,439
23,"Ialomița",216,"216-SINESTI",105026,180,2,937,585,386,199,581,4,"SINESTI",,5,,317,264
23,"Ialomița",216,"216-STELNICA",94492,181,2,1400,971,855,116,955,16,"STELNICA",,5,,676,279
23,"Ialomița",216,"216-SUDITI",94535,182,2,1837,1336,1253,83,1331,5,"SUDITI",,5,,1027,304
23,"Ialomița",216,"216-VALEA CIORII",94688,183,2,1440,1001,860,141,987,14,"VALEA CIORII",,5,,680,307
23,"Ialomița",216,"216-VALEA MACRISULUI",105794,184,2,1325,963,873,90,955,8,"VALEA MACRISULUI",,5,,761,194
23,"Ialomița",216,"216-VALEA MACRISULUI",105794,185,2,538,462,378,84,461,1,"VALEA MACRISULUI",,5,,324,137
23,"Ialomița",216,"216-VLADENI",94795,186,2,1706,1338,1158,180,1323,15,"VLADENI",,5,,888,435
24,"Iași",225,"225-MUNICIPIUL IASI",95060,1,2,1912,1382,1233,149,1376,6,"MUNICIPIUL IASI",,4,,550,826
24,"Iași",225,"225-MUNICIPIUL IASI",95060,2,2,1471,1142,1044,98,1139,3,"MUNICIPIUL IASI",,4,,510,629
24,"Iași",225,"225-MUNICIPIUL IASI",95060,3,2,1166,1000,886,114,996,4,"MUNICIPIUL IASI",,4,,372,624
24,"Iași",225,"225-MUNICIPIUL IASI",95060,4,2,1581,1189,1100,89,1179,10,"MUNICIPIUL IASI",,4,,538,641
24,"Iași",225,"225-MUNICIPIUL IASI",95060,5,2,1516,1262,1060,202,1256,6,"MUNICIPIUL IASI",,4,,527,729
24,"Iași",225,"225-MUNICIPIUL IASI",95060,6,2,1376,1042,934,108,1035,7,"MUNICIPIUL IASI",,4,,487,548
24,"Iași",225,"225-MUNICIPIUL IASI",95060,7,2,1204,1123,862,261,1117,6,"MUNICIPIUL IASI",,4,,453,664
24,"Iași",225,"225-MUNICIPIUL IASI",95060,8,2,1209,981,843,138,976,5,"MUNICIPIUL IASI",,4,,399,577
24,"Iași",225,"225-MUNICIPIUL IASI",95060,9,2,1452,1223,956,267,1215,8,"MUNICIPIUL IASI",,4,,605,610
24,"Iași",225,"225-MUNICIPIUL IASI",95060,10,2,1260,975,899,76,972,3,"MUNICIPIUL IASI",,4,,422,550
24,"Iași",225,"225-MUNICIPIUL IASI",95060,11,2,1643,1400,1097,303,1388,12,"MUNICIPIUL IASI",,4,,560,828
24,"Iași",225,"225-MUNICIPIUL IASI",95060,12,2,1177,934,840,94,929,5,"MUNICIPIUL IASI",,4,,352,577
24,"Iași",225,"225-MUNICIPIUL IASI",95060,13,2,1080,925,832,93,922,3,"MUNICIPIUL IASI",,4,,356,566
24,"Iași",225,"225-MUNICIPIUL IASI",95060,14,2,1184,922,865,57,915,7,"MUNICIPIUL IASI",,4,,351,564
24,"Iași",225,"225-MUNICIPIUL IASI",95060,15,2,1001,940,730,210,931,9,"MUNICIPIUL IASI",,4,,346,585
24,"Iași",225,"225-MUNICIPIUL IASI",95060,16,2,1162,922,834,88,917,5,"MUNICIPIUL IASI",,4,,340,577
24,"Iași",225,"225-MUNICIPIUL IASI",95060,17,2,1210,1106,933,173,1102,4,"MUNICIPIUL IASI",,4,,410,692
24,"Iași",225,"225-MUNICIPIUL IASI",95060,18,2,1363,1096,987,109,1093,3,"MUNICIPIUL IASI",,4,,439,654
24,"Iași",225,"225-MUNICIPIUL IASI",95060,19,2,1064,926,854,72,908,18,"MUNICIPIUL IASI",,4,,335,573
24,"Iași",225,"225-MUNICIPIUL IASI",95060,20,2,1319,1086,958,128,1084,2,"MUNICIPIUL IASI",,4,,363,721
24,"Iași",225,"225-MUNICIPIUL IASI",95060,21,2,1209,1038,855,183,1035,3,"MUNICIPIUL IASI",,4,,385,650
24,"Iași",225,"225-MUNICIPIUL IASI",95060,22,2,1374,1153,1063,90,1149,4,"MUNICIPIUL IASI",,4,,430,719
24,"Iași",225,"225-MUNICIPIUL IASI",95060,23,2,1375,1088,972,116,1084,4,"MUNICIPIUL IASI",,4,,445,639
24,"Iași",225,"225-MUNICIPIUL IASI",95060,24,2,1077,971,843,128,968,3,"MUNICIPIUL IASI",,4,,454,514
24,"Iași",225,"225-MUNICIPIUL IASI",95060,25,2,1340,1235,1133,102,1129,4,"MUNICIPIUL IASI",,4,,547,582
24,"Iași",225,"225-MUNICIPIUL IASI",95060,26,2,971,758,634,124,754,4,"MUNICIPIUL IASI",,4,,329,425
24,"Iași",225,"225-MUNICIPIUL IASI",95060,27,2,1037,881,714,167,877,4,"MUNICIPIUL IASI",,4,,370,507
24,"Iași",225,"225-MUNICIPIUL IASI",95060,28,2,1000,905,763,142,900,5,"MUNICIPIUL IASI",,4,,421,479
24,"Iași",225,"225-MUNICIPIUL IASI",95060,29,2,1038,885,828,57,883,2,"MUNICIPIUL IASI",,4,,370,513
24,"Iași",225,"225-MUNICIPIUL IASI",95060,30,2,1002,889,799,90,885,4,"MUNICIPIUL IASI",,4,,408,477
24,"Iași",225,"225-MUNICIPIUL IASI",95060,31,2,809,759,649,110,756,3,"MUNICIPIUL IASI",,4,,271,485
24,"Iași",225,"225-MUNICIPIUL IASI",95060,32,2,1090,937,839,98,936,1,"MUNICIPIUL IASI",,4,,339,597
24,"Iași",225,"225-MUNICIPIUL IASI",95060,33,2,952,849,703,146,844,5,"MUNICIPIUL IASI",,4,,329,515
24,"Iași",225,"225-MUNICIPIUL IASI",95060,34,2,1148,960,894,66,953,7,"MUNICIPIUL IASI",,4,,346,607
24,"Iași",225,"225-MUNICIPIUL IASI",95060,35,2,1101,955,854,101,955,0,"MUNICIPIUL IASI",,4,,352,603
24,"Iași",225,"225-MUNICIPIUL IASI",95060,36,2,1136,1005,870,135,1001,4,"MUNICIPIUL IASI",,4,,347,654
24,"Iași",225,"225-MUNICIPIUL IASI",95060,37,2,1277,1084,1019,65,1080,4,"MUNICIPIUL IASI",,4,,359,721
24,"Iași",225,"225-MUNICIPIUL IASI",95060,38,2,1293,979,866,113,975,4,"MUNICIPIUL IASI",,4,,392,583
24,"Iași",225,"225-MUNICIPIUL IASI",95060,39,2,937,819,693,126,819,0,"MUNICIPIUL IASI",,4,,305,514
24,"Iași",225,"225-MUNICIPIUL IASI",95060,40,2,1016,883,815,68,883,0,"MUNICIPIUL IASI",,4,,357,526
24,"Iași",225,"225-MUNICIPIUL IASI",95060,41,2,1406,1086,991,95,1085,1,"MUNICIPIUL IASI",,4,,472,613
24,"Iași",225,"225-MUNICIPIUL IASI",95060,42,2,1219,937,739,198,929,8,"MUNICIPIUL IASI",,4,,344,585
24,"Iași",225,"225-MUNICIPIUL IASI",95060,43,2,1025,724,642,82,723,1,"MUNICIPIUL IASI",,4,,264,459
24,"Iași",225,"225-MUNICIPIUL IASI",95060,44,2,964,765,696,69,761,4,"MUNICIPIUL IASI",,4,,290,471
24,"Iași",225,"225-MUNICIPIUL IASI",95060,45,2,1299,1007,937,70,993,14,"MUNICIPIUL IASI",,4,,431,562
24,"Iași",225,"225-MUNICIPIUL IASI",95060,46,2,1300,1080,939,141,1071,9,"MUNICIPIUL IASI",,4,,455,616
24,"Iași",225,"225-MUNICIPIUL IASI",95060,47,2,1188,904,808,96,896,8,"MUNICIPIUL IASI",,4,,378,518
24,"Iași",225,"225-MUNICIPIUL IASI",95060,48,2,1092,984,854,130,979,5,"MUNICIPIUL IASI",,4,,389,590
24,"Iași",225,"225-MUNICIPIUL IASI",95060,49,2,1036,848,772,76,847,1,"MUNICIPIUL IASI",,4,,333,514
24,"Iași",225,"225-MUNICIPIUL IASI",95060,50,2,1224,1037,908,129,1031,6,"MUNICIPIUL IASI",,4,,485,546
24,"Iași",225,"225-MUNICIPIUL IASI",95060,51,2,880,695,608,87,688,7,"MUNICIPIUL IASI",,4,,311,377
24,"Iași",225,"225-MUNICIPIUL IASI",95060,52,2,1561,1176,1062,114,1169,7,"MUNICIPIUL IASI",,4,,519,650
24,"Iași",225,"225-MUNICIPIUL IASI",95060,53,2,1089,852,793,59,849,3,"MUNICIPIUL IASI",,4,,397,452
24,"Iași",225,"225-MUNICIPIUL IASI",95060,54,2,1167,966,919,47,962,4,"MUNICIPIUL IASI",,4,,418,544
24,"Iași",225,"225-MUNICIPIUL IASI",95060,55,2,1308,1204,945,259,1194,10,"MUNICIPIUL IASI",,4,,559,635
24,"Iași",225,"225-MUNICIPIUL IASI",95060,56,2,1258,977,808,169,972,5,"MUNICIPIUL IASI",,4,,406,566
24,"Iași",225,"225-MUNICIPIUL IASI",95060,57,2,1491,1180,1070,110,1172,8,"MUNICIPIUL IASI",,4,,531,641
24,"Iași",225,"225-MUNICIPIUL IASI",95060,58,2,1390,1101,974,127,1089,12,"MUNICIPIUL IASI",,4,,449,640
24,"Iași",225,"225-MUNICIPIUL IASI",95060,59,2,1791,1323,1181,142,1313,10,"MUNICIPIUL IASI",,4,,540,773
24,"Iași",225,"225-MUNICIPIUL IASI",95060,60,2,1205,822,712,110,814,8,"MUNICIPIUL IASI",,4,,374,440
24,"Iași",225,"225-MUNICIPIUL IASI",95060,61,2,905,726,616,110,721,5,"MUNICIPIUL IASI",,4,,339,382
24,"Iași",225,"225-MUNICIPIUL IASI",95060,62,2,1003,820,708,112,816,4,"MUNICIPIUL IASI",,4,,400,416
24,"Iași",225,"225-MUNICIPIUL IASI",95060,63,2,1077,888,779,109,883,5,"MUNICIPIUL IASI",,4,,380,503
24,"Iași",225,"225-MUNICIPIUL IASI",95060,64,2,1788,1367,1189,178,1361,6,"MUNICIPIUL IASI",,4,,610,751
24,"Iași",225,"225-MUNICIPIUL IASI",95060,65,2,1276,1040,940,100,1036,4,"MUNICIPIUL IASI",,4,,450,586
24,"Iași",225,"225-MUNICIPIUL IASI",95060,66,2,941,1043,624,419,1035,8,"MUNICIPIUL IASI",,4,,424,611
24,"Iași",225,"225-MUNICIPIUL IASI",95060,67,2,1300,1076,960,116,1071,5,"MUNICIPIUL IASI",,4,,426,645
24,"Iași",225,"225-MUNICIPIUL IASI",95060,68,2,1305,1074,960,114,1070,4,"MUNICIPIUL IASI",,4,,490,580
24,"Iași",225,"225-MUNICIPIUL IASI",95060,69,2,1533,1290,1209,81,1286,4,"MUNICIPIUL IASI",,4,,490,796
24,"Iași",225,"225-MUNICIPIUL IASI",95060,70,2,1017,828,617,211,816,12,"MUNICIPIUL IASI",,4,,306,510
24,"Iași",225,"225-MUNICIPIUL IASI",95060,71,2,1029,1200,818,382,1196,4,"MUNICIPIUL IASI",,4,,523,673
24,"Iași",225,"225-MUNICIPIUL IASI",95060,72,2,1034,836,647,189,831,5,"MUNICIPIUL IASI",,4,,358,473
24,"Iași",225,"225-MUNICIPIUL IASI",95060,73,2,1284,1024,884,140,1016,8,"MUNICIPIUL IASI",,4,,426,590
24,"Iași",225,"225-MUNICIPIUL IASI",95060,74,2,1159,983,921,62,979,4,"MUNICIPIUL IASI",,4,,397,582
24,"Iași",225,"225-MUNICIPIUL IASI",95060,75,2,1453,1240,1166,74,1237,3,"MUNICIPIUL IASI",,4,,402,835
24,"Iași",225,"225-MUNICIPIUL IASI",95060,76,2,919,875,728,147,870,5,"MUNICIPIUL IASI",,4,,323,547
24,"Iași",225,"225-MUNICIPIUL IASI",95060,77,2,1299,1143,1053,90,1140,3,"MUNICIPIUL IASI",,4,,487,653
24,"Iași",225,"225-MUNICIPIUL IASI",95060,78,2,1205,939,911,28,937,2,"MUNICIPIUL IASI",,4,,395,542
24,"Iași",225,"225-MUNICIPIUL IASI",95060,79,2,1380,1130,1029,101,1123,7,"MUNICIPIUL IASI",,4,,381,742
24,"Iași",225,"225-MUNICIPIUL IASI",95060,80,2,1227,1070,975,95,1064,6,"MUNICIPIUL IASI",,4,,449,615
24,"Iași",225,"225-MUNICIPIUL IASI",95060,81,2,1265,912,851,61,909,3,"MUNICIPIUL IASI",,4,,378,531
24,"Iași",225,"225-MUNICIPIUL IASI",95060,82,2,1026,834,771,63,831,3,"MUNICIPIUL IASI",,4,,376,455
24,"Iași",225,"225-MUNICIPIUL IASI",95060,83,2,1251,1030,936,94,1028,2,"MUNICIPIUL IASI",,4,,487,541
24,"Iași",225,"225-MUNICIPIUL IASI",95060,84,2,1331,1008,932,76,1000,6,"MUNICIPIUL IASI",,4,,365,635
24,"Iași",225,"225-MUNICIPIUL IASI",95060,85,2,1267,1073,959,114,1069,4,"MUNICIPIUL IASI",,4,,499,570
24,"Iași",225,"225-MUNICIPIUL IASI",95060,86,2,1199,1014,849,165,1002,12,"MUNICIPIUL IASI",,4,,446,556
24,"Iași",225,"225-MUNICIPIUL IASI",95060,87,2,1114,875,790,85,870,5,"MUNICIPIUL IASI",,4,,360,510
24,"Iași",225,"225-MUNICIPIUL IASI",95060,88,2,1357,1181,1019,162,1177,4,"MUNICIPIUL IASI",,4,,517,660
24,"Iași",225,"225-MUNICIPIUL IASI",95060,89,2,1324,1092,994,98,1088,4,"MUNICIPIUL IASI",,4,,487,601
24,"Iași",225,"225-MUNICIPIUL IASI",95060,90,2,1285,982,912,70,974,8,"MUNICIPIUL IASI",,4,,380,594
24,"Iași",225,"225-MUNICIPIUL IASI",95060,91,2,867,786,670,116,780,6,"MUNICIPIUL IASI",,4,,345,435
24,"Iași",225,"225-MUNICIPIUL IASI",95060,92,2,1261,1048,954,94,1045,3,"MUNICIPIUL IASI",,4,,469,576
24,"Iași",225,"225-MUNICIPIUL IASI",95060,93,2,877,753,677,76,749,4,"MUNICIPIUL IASI",,4,,333,416
24,"Iași",225,"225-MUNICIPIUL IASI",95060,94,2,1754,1477,1375,102,1471,6,"MUNICIPIUL IASI",,4,,585,886
24,"Iași",225,"225-MUNICIPIUL IASI",95060,95,2,1109,886,756,130,878,8,"MUNICIPIUL IASI",,4,,388,490
24,"Iași",225,"225-MUNICIPIUL IASI",95060,96,2,1018,829,737,92,825,4,"MUNICIPIUL IASI",,4,,334,491
24,"Iași",225,"225-MUNICIPIUL IASI",95060,97,2,900,733,646,87,730,3,"MUNICIPIUL IASI",,4,,348,382
24,"Iași",225,"225-MUNICIPIUL IASI",95060,98,2,799,679,596,83,679,0,"MUNICIPIUL IASI",,4,,305,374
24,"Iași",225,"225-MUNICIPIUL IASI",95060,99,2,849,696,621,75,688,8,"MUNICIPIUL IASI",,4,,323,365
24,"Iași",225,"225-MUNICIPIUL IASI",95060,100,2,1090,967,847,120,962,5,"MUNICIPIUL IASI",,4,,461,501
24,"Iași",225,"225-MUNICIPIUL IASI",95060,101,2,924,769,681,88,766,3,"MUNICIPIUL IASI",,4,,355,411
24,"Iași",225,"225-MUNICIPIUL IASI",95060,102,2,1102,857,775,82,850,7,"MUNICIPIUL IASI",,4,,371,479
24,"Iași",225,"225-MUNICIPIUL IASI",95060,103,2,1146,927,734,193,916,11,"MUNICIPIUL IASI",,4,,429,487
24,"Iași",225,"225-MUNICIPIUL IASI",95060,104,2,1743,1934,1234,700,1925,9,"MUNICIPIUL IASI",,4,,738,1187
24,"Iași",225,"225-MUNICIPIUL IASI",95060,105,2,590,644,557,87,626,18,"MUNICIPIUL IASI",,4,,361,265
24,"Iași",225,"225-MUNICIPIUL IASI",95060,106,2,1340,1717,820,897,1706,11,"MUNICIPIUL IASI",,4,,637,1069
24,"Iași",225,"225-MUNICIPIUL IASI",95060,107,2,0,372,0,372,368,4,"MUNICIPIUL IASI",,4,,165,203
24,"Iași",225,"225-MUNICIPIUL IASI",95060,108,2,1609,1442,1164,278,1437,5,"MUNICIPIUL IASI",,4,,663,774
24,"Iași",225,"225-MUNICIPIUL IASI",95060,109,2,1697,1304,1119,185,1284,20,"MUNICIPIUL IASI",,4,,536,748
24,"Iași",225,"225-MUNICIPIUL IASI",95060,110,2,1258,1490,842,648,1480,10,"MUNICIPIUL IASI",,4,,628,852
24,"Iași",225,"225-MUNICIPIUL IASI",95060,111,2,1501,1413,1053,360,1390,23,"MUNICIPIUL IASI",,4,,703,687
24,"Iași",225,"225-MUNICIPIUL IASI",95060,112,2,1699,1285,1027,258,1282,3,"MUNICIPIUL IASI",,4,,471,811
24,"Iași",225,"225-MUNICIPIUL IASI",95060,113,2,1339,1270,805,465,1206,44,"MUNICIPIUL IASI",,4,,429,777
24,"Iași",225,"225-MUNICIPIUL IASI",95060,114,2,1362,1192,948,244,1184,8,"MUNICIPIUL IASI",,4,,463,721
24,"Iași",225,"225-MUNICIPIUL IASI",95060,115,2,1689,1333,1200,133,1330,3,"MUNICIPIUL IASI",,4,,482,848
24,"Iași",225,"225-MUNICIPIUL IASI",95060,116,2,753,730,672,58,721,9,"MUNICIPIUL IASI",,4,,328,393
24,"Iași",225,"225-MUNICIPIUL IASI",95060,117,2,1470,1209,1031,178,1206,3,"MUNICIPIUL IASI",,4,,513,693
24,"Iași",225,"225-MUNICIPIUL IASI",95060,118,2,1407,1187,1053,134,1184,3,"MUNICIPIUL IASI",,4,,506,678
24,"Iași",225,"225-MUNICIPIUL IASI",95060,119,2,1443,1137,1017,120,1134,3,"MUNICIPIUL IASI",,4,,459,675
24,"Iași",225,"225-MUNICIPIUL IASI",95060,120,2,1142,905,804,101,898,7,"MUNICIPIUL IASI",,4,,411,487
24,"Iași",225,"225-MUNICIPIUL IASI",95060,121,2,1554,1227,1127,100,1217,10,"MUNICIPIUL IASI",,4,,464,753
24,"Iași",225,"225-MUNICIPIUL IASI",95060,122,2,1666,1265,1195,70,1259,6,"MUNICIPIUL IASI",,4,,479,780
24,"Iași",225,"225-MUNICIPIUL IASI",95060,123,2,1059,810,741,69,807,3,"MUNICIPIUL IASI",,4,,273,534
24,"Iași",225,"225-MUNICIPIUL IASI",95060,124,2,1514,1169,1064,105,1161,8,"MUNICIPIUL IASI",,4,,433,728
24,"Iași",225,"225-MUNICIPIUL IASI",95060,125,2,1698,1276,1191,85,1268,8,"MUNICIPIUL IASI",,4,,406,862
24,"Iași",225,"225-MUNICIPIUL IASI",95060,126,2,1192,991,873,118,988,3,"MUNICIPIUL IASI",,4,,314,674
24,"Iași",225,"225-MUNICIPIUL IASI",95060,127,2,1358,1038,928,110,1035,3,"MUNICIPIUL IASI",,4,,356,679
24,"Iași",225,"225-MUNICIPIUL IASI",95060,128,2,1610,1245,1095,150,1239,6,"MUNICIPIUL IASI",,4,,410,829
24,"Iași",225,"225-MUNICIPIUL IASI",95060,129,2,1720,1286,1170,116,1284,2,"MUNICIPIUL IASI",,4,,411,873
24,"Iași",225,"225-MUNICIPIUL IASI",95060,130,2,1794,1213,1157,56,1210,3,"MUNICIPIUL IASI",,4,,379,831
24,"Iași",225,"225-MUNICIPIUL IASI",95060,131,2,1195,1034,865,169,1029,5,"MUNICIPIUL IASI",,4,,339,690
24,"Iași",225,"225-MUNICIPIUL IASI",95060,132,2,1715,1320,1198,122,1313,7,"MUNICIPIUL IASI",,4,,549,764
24,"Iași",225,"225-MUNICIPIUL IASI",95060,133,2,1655,1306,1194,112,1301,5,"MUNICIPIUL IASI",,4,,534,767
24,"Iași",225,"225-MUNICIPIUL IASI",95060,134,2,1369,1042,987,55,1039,3,"MUNICIPIUL IASI",,4,,404,635
24,"Iași",225,"225-MUNICIPIUL IASI",95060,135,2,1156,979,828,151,974,5,"MUNICIPIUL IASI",,4,,375,599
24,"Iași",225,"225-MUNICIPIUL IASI",95060,136,2,1296,1031,941,90,1027,4,"MUNICIPIUL IASI",,4,,374,653
24,"Iași",225,"225-MUNICIPIUL IASI",95060,137,2,1795,1122,1122,0,1107,15,"MUNICIPIUL IASI",,4,,449,658
24,"Iași",225,"225-MUNICIPIUL IASI",95060,138,2,1337,1130,985,145,1125,5,"MUNICIPIUL IASI",,4,,474,651
24,"Iași",225,"225-MUNICIPIUL IASI",95060,139,2,1298,1107,1010,97,1097,10,"MUNICIPIUL IASI",,4,,523,574
24,"Iași",225,"225-MUNICIPIUL IASI",95060,140,2,1435,1126,1025,101,1119,7,"MUNICIPIUL IASI",,4,,496,623
24,"Iași",225,"225-MUNICIPIUL IASI",95060,141,2,1172,869,824,45,866,3,"MUNICIPIUL IASI",,4,,410,456
24,"Iași",225,"225-MUNICIPIUL IASI",95060,142,2,1386,939,824,115,927,12,"MUNICIPIUL IASI",,4,,400,527
24,"Iași",225,"225-MUNICIPIUL IASI",95060,143,2,1108,825,687,138,821,4,"MUNICIPIUL IASI",,4,,361,460
24,"Iași",225,"225-MUNICIPIUL IASI",95060,144,2,1216,972,897,75,970,2,"MUNICIPIUL IASI",,4,,369,601
24,"Iași",225,"225-MUNICIPIUL IASI",95060,145,2,1377,1107,1002,105,1100,7,"MUNICIPIUL IASI",,4,,466,634
24,"Iași",225,"225-MUNICIPIUL IASI",95060,146,2,1345,1110,1004,106,1108,2,"MUNICIPIUL IASI",,4,,434,674
24,"Iași",225,"225-MUNICIPIUL IASI",95060,147,2,1520,1193,1074,119,1190,3,"MUNICIPIUL IASI",,4,,523,667
24,"Iași",225,"225-MUNICIPIUL IASI",95060,148,2,1175,858,795,63,855,3,"MUNICIPIUL IASI",,4,,376,479
24,"Iași",225,"225-MUNICIPIUL IASI",95060,149,2,762,527,490,37,517,10,"MUNICIPIUL IASI",,4,,59,458
24,"Iași",225,"225-MUNICIPIUL IASI",95060,150,2,1291,1200,923,277,1198,2,"MUNICIPIUL IASI",,4,,508,690
24,"Iași",225,"225-MUNICIPIUL IASI",95060,151,2,1401,1136,850,286,1127,9,"MUNICIPIUL IASI",,4,,485,642
24,"Iași",225,"225-MUNICIPIUL IASI",95060,152,2,1796,1218,1069,149,1212,6,"MUNICIPIUL IASI",,4,,482,730
24,"Iași",225,"225-MUNICIPIUL IASI",95060,153,2,1251,918,865,53,910,8,"MUNICIPIUL IASI",,4,,364,546
24,"Iași",225,"225-MUNICIPIUL IASI",95060,154,2,1864,1378,1249,129,1369,8,"MUNICIPIUL IASI",,4,,624,745
24,"Iași",225,"225-MUNICIPIUL IASI",95060,155,2,1344,966,897,69,963,3,"MUNICIPIUL IASI",,4,,409,554
24,"Iași",225,"225-MUNICIPIUL IASI",95060,156,2,1411,1064,997,67,1058,6,"MUNICIPIUL IASI",,4,,449,609
24,"Iași",225,"225-MUNICIPIUL IASI",95060,157,2,1383,1055,952,103,1053,2,"MUNICIPIUL IASI",,4,,435,618
24,"Iași",225,"225-MUNICIPIUL IASI",95060,158,2,1575,1259,1182,77,1255,4,"MUNICIPIUL IASI",,4,,519,736
24,"Iași",225,"225-MUNICIPIUL IASI",95060,159,2,1406,1116,1034,82,1110,6,"MUNICIPIUL IASI",,4,,452,658
24,"Iași",225,"225-MUNICIPIUL IASI",95060,160,2,1361,1086,969,117,1075,9,"MUNICIPIUL IASI",,4,,470,605
24,"Iași",225,"225-MUNICIPIUL IASI",95060,161,2,1268,991,903,88,982,9,"MUNICIPIUL IASI",,4,,420,562
24,"Iași",225,"225-MUNICIPIUL IASI",95060,162,2,1443,1135,1040,95,1125,10,"MUNICIPIUL IASI",,4,,488,637
24,"Iași",225,"225-MUNICIPIUL IASI",95060,163,2,1753,1313,1183,130,1306,7,"MUNICIPIUL IASI",,4,,537,769
24,"Iași",225,"225-MUNICIPIUL IASI",95060,164,2,1721,1153,1027,126,1144,9,"MUNICIPIUL IASI",,4,,538,606
24,"Iași",225,"225-MUNICIPIUL IASI",95060,165,2,1268,1062,949,113,1053,9,"MUNICIPIUL IASI",,4,,430,623
24,"Iași",225,"225-MUNICIPIUL IASI",95060,166,2,1649,1305,1200,105,1296,9,"MUNICIPIUL IASI",,4,,567,729
24,"Iași",225,"225-MUNICIPIUL IASI",95060,167,2,1869,1538,1407,131,1531,7,"MUNICIPIUL IASI",,4,,705,826
24,"Iași",225,"225-MUNICIPIUL IASI",95060,168,2,1541,1138,1043,95,1133,5,"MUNICIPIUL IASI",,4,,545,588
24,"Iași",225,"225-MUNICIPIUL IASI",95060,169,2,1598,1198,1132,66,1187,11,"MUNICIPIUL IASI",,4,,499,688
24,"Iași",225,"225-MUNICIPIUL IASI",95060,170,2,1923,1509,1398,111,1502,7,"MUNICIPIUL IASI",,4,,606,896
24,"Iași",225,"225-MUNICIPIUL IASI",95060,171,2,1902,1409,1325,84,1403,6,"MUNICIPIUL IASI",,4,,675,728
24,"Iași",225,"225-MUNICIPIUL IASI",95060,172,2,1938,1483,1382,101,1476,7,"MUNICIPIUL IASI",,4,,634,842
24,"Iași",225,"225-MUNICIPIUL IASI",95060,173,2,1336,1125,996,129,1119,3,"MUNICIPIUL IASI",,4,,406,713
24,"Iași",225,"225-MUNICIPIUL IASI",95060,174,2,1606,1307,1219,88,1302,5,"MUNICIPIUL IASI",,4,,511,791
24,"Iași",225,"225-MUNICIPIUL IASI",95060,175,2,1138,901,829,72,894,7,"MUNICIPIUL IASI",,4,,371,523
24,"Iași",225,"225-MUNICIPIUL IASI",95060,176,2,1336,1044,951,93,1037,7,"MUNICIPIUL IASI",,4,,426,611
24,"Iași",225,"225-MUNICIPIUL IASI",95060,177,2,2131,1316,1180,136,1308,8,"MUNICIPIUL IASI",,4,,523,785
24,"Iași",225,"225-MUNICIPIUL IASI",95060,178,2,1705,1331,1093,238,1327,4,"MUNICIPIUL IASI",,4,,603,724
24,"Iași",225,"225-MUNICIPIUL IASI",95060,179,2,1532,1093,1000,93,1087,6,"MUNICIPIUL IASI",,4,,461,626
24,"Iași",225,"225-MUNICIPIUL IASI",95060,180,2,1559,1200,1064,136,1193,7,"MUNICIPIUL IASI",,4,,544,649
24,"Iași",225,"225-MUNICIPIUL IASI",95060,181,2,1496,1156,1091,65,1151,5,"MUNICIPIUL IASI",,4,,465,686
24,"Iași",225,"225-MUNICIPIUL IASI",95060,182,2,0,193,0,193,187,6,"MUNICIPIUL IASI",,4,,107,80
24,"Iași",225,"225-MUNICIPIUL IASI",95060,183,2,1574,1180,1118,62,1179,1,"MUNICIPIUL IASI",,4,,535,644
24,"Iași",225,"225-MUNICIPIUL IASI",95060,184,2,1369,1181,1055,126,1173,8,"MUNICIPIUL IASI",,4,,437,736
24,"Iași",225,"225-MUNICIPIUL IASI",95060,185,2,110,136,105,31,135,1,"MUNICIPIUL IASI",,4,,103,32
24,"Iași",225,"225-MUNICIPIUL IASI",95060,186,2,0,958,0,958,957,1,"MUNICIPIUL IASI",,4,,232,725
24,"Iași",225,"225-MUNICIPIUL IASI",95060,187,2,0,977,0,977,972,5,"MUNICIPIUL IASI",,4,,247,725
24,"Iași",225,"225-MUNICIPIUL IASI",95060,188,2,0,888,0,888,882,6,"MUNICIPIUL IASI",,4,,191,691
24,"Iași",225,"225-MUNICIPIUL IASI",95060,189,2,0,906,0,906,906,0,"MUNICIPIUL IASI",,4,,152,754
24,"Iași",225,"225-MUNICIPIUL IASI",95060,190,2,0,552,0,552,550,2,"MUNICIPIUL IASI",,4,,102,448
24,"Iași",225,"225-MUNICIPIUL IASI",95060,191,2,0,874,0,874,873,1,"MUNICIPIUL IASI",,4,,299,574
24,"Iași",225,"225-MUNICIPIUL IASI",95060,192,2,0,1099,0,1099,1091,8,"MUNICIPIUL IASI",,4,,255,836
24,"Iași",225,"225-MUNICIPIUL IASI",95060,193,2,0,793,0,793,792,1,"MUNICIPIUL IASI",,4,,103,689
24,"Iași",225,"225-MUNICIPIUL IASI",95060,194,2,0,1244,0,1244,1233,11,"MUNICIPIUL IASI",,4,,367,866
24,"Iași",225,"225-MUNICIPIUL IASI",95060,195,2,0,1019,0,1019,1017,2,"MUNICIPIUL IASI",,4,,160,857
24,"Iași",225,"225-MUNICIPIUL IASI",95060,196,2,0,284,0,284,283,1,"MUNICIPIUL IASI",,4,,113,170
24,"Iași",225,"225-MUNICIPIUL IASI",95060,197,2,0,172,0,172,171,1,"MUNICIPIUL IASI",,4,,86,85
24,"Iași",225,"225-MUNICIPIUL IASI",95060,198,2,0,149,0,149,148,1,"MUNICIPIUL IASI",,4,,42,106
24,"Iași",225,"225-MUNICIPIUL IASI",95060,199,2,0,277,0,277,275,2,"MUNICIPIUL IASI",,4,,74,201
24,"Iași",225,"225-MUNICIPIUL IASI",95060,200,2,0,208,0,208,206,2,"MUNICIPIUL IASI",,4,,108,98
24,"Iași",225,"225-MUNICIPIUL IASI",95060,201,2,0,179,0,179,178,1,"MUNICIPIUL IASI",,4,,54,124
24,"Iași",225,"225-MUNICIPIUL IASI",95060,202,2,0,442,0,442,440,2,"MUNICIPIUL IASI",,4,,207,233
24,"Iași",225,"225-MUNICIPIUL IASI",95060,203,2,0,127,0,127,126,1,"MUNICIPIUL IASI",,4,,60,66
24,"Iași",225,"225-MUNICIPIUL IASI",95060,204,2,0,109,0,109,109,0,"MUNICIPIUL IASI",,4,,62,47
24,"Iași",225,"225-MUNICIPIUL IASI",95060,205,2,0,785,0,785,779,6,"MUNICIPIUL IASI",,4,,430,349
24,"Iași",225,"225-MUNICIPIUL IASI",95060,206,2,0,272,0,272,270,2,"MUNICIPIUL IASI",,4,,129,141
24,"Iași",225,"225-MUNICIPIUL IASI",95060,207,2,0,107,0,107,106,1,"MUNICIPIUL IASI",,4,,58,48
24,"Iași",225,"225-MUNICIPIUL IASI",95060,208,2,0,513,0,513,510,3,"MUNICIPIUL IASI",,4,,244,266
24,"Iași",225,"225-MUNICIPIUL IASI",95060,209,2,0,337,0,337,329,8,"MUNICIPIUL IASI",,4,,161,168
24,"Iași",225,"225-MUNICIPIUL IASI",95060,210,2,0,520,0,520,515,5,"MUNICIPIUL IASI",,4,,292,223
24,"Iași",225,"225-MUNICIPIUL IASI",95060,211,2,0,78,0,78,77,1,"MUNICIPIUL IASI",,4,,31,46
24,"Iași",225,"225-MUNICIPIUL IASI",95060,212,2,0,1886,0,1886,1879,7,"MUNICIPIUL IASI",,4,,637,1242
24,"Iași",225,"225-MUNICIPIUL IASI",95060,213,2,0,149,0,149,147,2,"MUNICIPIUL IASI",,4,,51,96
24,"Iași",225,"225-MUNICIPIUL IASI",95060,214,2,522,542,507,35,541,1,"MUNICIPIUL IASI",,4,,326,215
24,"Iași",225,"225-MUNICIPIUL PASCANI",95391,215,2,1103,953,810,143,949,4,"MUNICIPIUL PASCANI",,4,,492,457
24,"Iași",225,"225-MUNICIPIUL PASCANI",95391,216,2,1627,1261,1161,100,1254,7,"MUNICIPIUL PASCANI",,4,,679,575
24,"Iași",225,"225-MUNICIPIUL PASCANI",95391,217,2,1088,854,767,87,847,7,"MUNICIPIUL PASCANI",,4,,481,366
24,"Iași",225,"225-MUNICIPIUL PASCANI",95391,218,2,1314,1025,935,90,1019,6,"MUNICIPIUL PASCANI",,4,,594,425
24,"Iași",225,"225-MUNICIPIUL PASCANI",95391,219,2,1645,1358,1119,239,1348,10,"MUNICIPIUL PASCANI",,4,,767,581
24,"Iași",225,"225-MUNICIPIUL PASCANI",95391,220,2,1188,1088,883,205,1080,8,"MUNICIPIUL PASCANI",,4,,637,443
24,"Iași",225,"225-MUNICIPIUL PASCANI",95391,221,2,1790,1366,1265,101,1358,8,"MUNICIPIUL PASCANI",,4,,782,576
24,"Iași",225,"225-MUNICIPIUL PASCANI",95391,222,2,787,689,535,154,682,7,"MUNICIPIUL PASCANI",,4,,351,331
24,"Iași",225,"225-MUNICIPIUL PASCANI",95391,223,2,1663,1353,1148,205,1348,5,"MUNICIPIUL PASCANI",,4,,677,671
24,"Iași",225,"225-MUNICIPIUL PASCANI",95391,224,2,1242,1067,965,102,1062,5,"MUNICIPIUL PASCANI",,4,,424,638
24,"Iași",225,"225-MUNICIPIUL PASCANI",95391,225,2,1191,903,816,87,898,5,"MUNICIPIUL PASCANI",,4,,497,401
24,"Iași",225,"225-MUNICIPIUL PASCANI",95391,226,2,1231,997,855,142,994,3,"MUNICIPIUL PASCANI",,4,,565,429
24,"Iași",225,"225-MUNICIPIUL PASCANI",95391,227,2,1270,1029,894,135,1025,4,"MUNICIPIUL PASCANI",,4,,547,478
24,"Iași",225,"225-MUNICIPIUL PASCANI",95391,228,2,2140,1661,1454,207,1648,13,"MUNICIPIUL PASCANI",,4,,864,784
24,"Iași",225,"225-MUNICIPIUL PASCANI",95391,229,2,2283,1701,1473,228,1690,11,"MUNICIPIUL PASCANI",,4,,921,769
24,"Iași",225,"225-MUNICIPIUL PASCANI",95391,230,2,1155,991,895,96,984,7,"MUNICIPIUL PASCANI",,4,,503,481
24,"Iași",225,"225-MUNICIPIUL PASCANI",95391,231,2,1184,939,833,106,938,1,"MUNICIPIUL PASCANI",,4,,500,438
24,"Iași",225,"225-MUNICIPIUL PASCANI",95391,232,2,1084,827,762,65,811,16,"MUNICIPIUL PASCANI",,4,,461,350
24,"Iași",225,"225-MUNICIPIUL PASCANI",95391,233,2,1024,814,764,50,803,11,"MUNICIPIUL PASCANI",,4,,421,382
24,"Iași",225,"225-MUNICIPIUL PASCANI",95391,234,2,812,627,594,33,621,6,"MUNICIPIUL PASCANI",,4,,332,289
24,"Iași",225,"225-MUNICIPIUL PASCANI",95391,235,2,852,650,588,62,647,3,"MUNICIPIUL PASCANI",,4,,316,331
24,"Iași",225,"225-MUNICIPIUL PASCANI",95391,236,2,1210,1007,944,63,993,14,"MUNICIPIUL PASCANI",,4,,552,441
24,"Iași",225,"225-MUNICIPIUL PASCANI",95391,237,2,889,760,707,53,760,0,"MUNICIPIUL PASCANI",,4,,519,241
24,"Iași",225,"225-MUNICIPIUL PASCANI",95391,238,2,988,846,770,76,835,11,"MUNICIPIUL PASCANI",,4,,552,283
24,"Iași",225,"225-MUNICIPIUL PASCANI",95391,239,2,0,485,0,485,479,6,"MUNICIPIUL PASCANI",,4,,225,254
24,"Iași",225,"225-ORAS HARLAU",95355,240,2,1875,1338,1237,101,1332,6,"ORAS HARLAU",,4,,875,457
24,"Iași",225,"225-ORAS HARLAU",95355,241,2,1903,1474,1369,105,1467,7,"ORAS HARLAU",,4,,1005,462
24,"Iași",225,"225-ORAS HARLAU",95355,242,2,1911,1406,1339,67,1403,3,"ORAS HARLAU",,4,,962,441
24,"Iași",225,"225-ORAS HARLAU",95355,243,2,2351,1650,1583,67,1628,22,"ORAS HARLAU",,4,,1104,524
24,"Iași",225,"225-ORAS TARGU FRUMOS",95471,244,2,1234,958,825,133,947,11,"ORAS TARGU FRUMOS",,4,,539,408
24,"Iași",225,"225-ORAS TARGU FRUMOS",95471,245,2,1439,1063,957,106,1056,7,"ORAS TARGU FRUMOS",,4,,653,403
24,"Iași",225,"225-ORAS TARGU FRUMOS",95471,246,2,1137,887,768,119,879,8,"ORAS TARGU FRUMOS",,4,,506,373
24,"Iași",225,"225-ORAS TARGU FRUMOS",95471,247,2,1604,1155,1027,128,1140,15,"ORAS TARGU FRUMOS",,4,,676,464
24,"Iași",225,"225-ORAS TARGU FRUMOS",95471,248,2,1600,1194,958,236,1189,5,"ORAS TARGU FRUMOS",,4,,697,492
24,"Iași",225,"225-ORAS TARGU FRUMOS",95471,249,2,1440,1096,974,122,1090,6,"ORAS TARGU FRUMOS",,4,,649,441
24,"Iași",225,"225-ALEXANDRU I. CUZA",95612,250,2,530,470,402,68,468,2,"ALEXANDRU I. CUZA",,4,,358,110
24,"Iași",225,"225-ALEXANDRU I. CUZA",95612,251,2,656,605,546,59,601,4,"ALEXANDRU I. CUZA",,4,,498,103
24,"Iași",225,"225-ALEXANDRU I. CUZA",95612,252,2,956,914,841,73,899,15,"ALEXANDRU I. CUZA",,4,,564,335
24,"Iași",225,"225-ANDRIESENI",95667,253,2,1573,945,843,102,926,19,"ANDRIESENI",,4,,634,292
24,"Iași",225,"225-ANDRIESENI",95667,254,2,585,395,360,35,391,4,"ANDRIESENI",,4,,258,133
24,"Iași",225,"225-ANDRIESENI",95667,255,2,936,592,530,62,581,11,"ANDRIESENI",,4,,406,175
24,"Iași",225,"225-ANDRIESENI",95667,256,2,704,498,439,59,495,3,"ANDRIESENI",,4,,398,97
24,"Iași",225,"225-ARONEANU",95747,257,2,845,629,553,76,620,9,"ARONEANU",,4,,348,272
24,"Iași",225,"225-ARONEANU",95747,258,2,705,530,492,38,522,7,"ARONEANU",,4,,286,236
24,"Iași",225,"225-ARONEANU",95747,259,2,280,220,203,17,217,3,"ARONEANU",,4,,147,70
24,"Iași",225,"225-ARONEANU",95747,260,2,111,127,86,41,127,0,"ARONEANU",,4,,59,68
24,"Iași",225,"225-BALTATI",95792,261,2,1189,857,785,72,846,11,"BALTATI",,4,,599,247
24,"Iași",225,"225-BALTATI",95792,262,2,638,488,446,42,484,4,"BALTATI",,4,,337,147
24,"Iași",225,"225-BALTATI",95792,263,2,779,602,561,41,595,7,"BALTATI",,4,,441,154
24,"Iași",225,"225-BALTATI",95792,264,2,427,335,321,14,332,3,"BALTATI",,4,,269,63
24,"Iași",225,"225-BALTATI",95792,265,2,539,406,376,30,403,3,"BALTATI",,4,,278,125
24,"Iași",225,"225-BELCESTI",95872,266,2,979,656,565,91,637,19,"BELCESTI",,4,,475,162
24,"Iași",225,"225-BELCESTI",95872,267,2,1316,908,708,200,898,10,"BELCESTI",,4,,696,202
24,"Iași",225,"225-BELCESTI",95872,268,2,1362,870,722,148,861,9,"BELCESTI",,4,,712,149
24,"Iași",225,"225-BELCESTI",95872,269,2,1550,840,719,121,834,6,"BELCESTI",,4,,612,222
24,"Iași",225,"225-BELCESTI",95872,270,2,947,836,768,68,816,20,"BELCESTI",,4,,631,185
24,"Iași",225,"225-BELCESTI",95872,271,2,803,565,447,118,556,9,"BELCESTI",,4,,428,128
24,"Iași",225,"225-BELCESTI",95872,272,2,903,698,592,106,683,15,"BELCESTI",,4,,584,99
24,"Iași",225,"225-BELCESTI",95872,273,2,595,491,408,83,480,11,"BELCESTI",,4,,392,88
24,"Iași",225,"225-BARNOVA",95088,274,2,1496,1000,823,177,986,14,"BARNOVA",,4,,639,347
24,"Iași",225,"225-BARNOVA",95088,275,2,570,436,354,82,427,9,"BARNOVA",,4,,231,196
24,"Iași",225,"225-BIVOLARI",95943,276,2,2356,1533,1288,245,1512,21,"BIVOLARI",,4,,885,627
24,"Iași",225,"225-BIVOLARI",95943,277,2,937,748,571,177,729,19,"BIVOLARI",,4,,502,227
24,"Iași",225,"225-UNGHENI",96003,278,2,1312,900,799,101,886,14,"UNGHENI",,4,,506,380
24,"Iași",225,"225-UNGHENI",96003,279,2,544,421,330,91,419,2,"UNGHENI",,4,,254,165
24,"Iași",225,"225-UNGHENI",96003,280,2,1000,651,545,106,643,8,"UNGHENI",,4,,399,244
24,"Iași",225,"225-BRAESTI",96058,281,2,1182,925,797,128,903,22,"BRAESTI",,4,,642,261
24,"Iași",225,"225-BRAESTI",96058,282,2,1486,1032,957,75,1009,23,"BRAESTI",,4,,785,224
24,"Iași",225,"225-BUTEA",96110,283,2,1658,1054,988,66,1035,19,"BUTEA",,4,,451,584
24,"Iași",225,"225-BUTEA",96110,284,2,1171,676,633,43,670,6,"BUTEA",,4,,317,353
24,"Iași",225,"225-BUTEA",96110,285,2,304,281,214,67,277,4,"BUTEA",,4,,169,108
24,"Iași",225,"225-CEPLENITA",96147,286,2,1108,853,757,96,838,15,"CEPLENITA",,4,,635,203
24,"Iași",225,"225-CEPLENITA",96147,287,2,1207,800,704,96,781,19,"CEPLENITA",,4,,541,240
24,"Iași",225,"225-CEPLENITA",96147,288,2,763,488,424,64,470,18,"CEPLENITA",,4,,337,133
24,"Iași",225,"225-CEPLENITA",96147,289,2,247,189,162,27,187,2,"CEPLENITA",,4,,133,54
24,"Iași",225,"225-CIORTESTI",96192,290,2,1664,1008,842,166,984,24,"CIORTESTI",,4,,725,259
24,"Iași",225,"225-CIORTESTI",96192,291,2,1125,758,641,117,749,9,"CIORTESTI",,4,,614,135
24,"Iași",225,"225-CIORTESTI",96192,292,2,671,598,521,77,493,105,"CIORTESTI",,4,,418,75
24,"Iași",225,"225-CIUREA",96254,293,2,1511,899,801,98,891,8,"CIUREA",,4,,445,446
24,"Iași",225,"225-CIUREA",96254,294,2,2103,1758,1249,509,1735,23,"CIUREA",,4,,841,894
24,"Iași",225,"225-CIUREA",96254,295,2,855,618,521,97,609,9,"CIUREA",,4,,249,360
24,"Iași",225,"225-CIUREA",96254,296,2,677,447,397,50,438,9,"CIUREA",,4,,275,163
24,"Iași",225,"225-CIUREA",96254,297,2,392,342,293,49,339,3,"CIUREA",,4,,227,112
24,"Iași",225,"225-COARNELE CAPREI",96334,298,2,1942,1253,1160,93,1228,25,"COARNELE CAPREI",,4,,984,244
24,"Iași",225,"225-COARNELE CAPREI",96334,299,2,619,401,341,60,392,9,"COARNELE CAPREI",,4,,301,91
24,"Iași",225,"225-COMARNA",96370,300,2,1327,902,840,62,883,19,"COMARNA",,4,,434,449
24,"Iași",225,"225-COMARNA",96370,301,2,1086,728,611,117,699,20,"COMARNA",,4,,461,238
24,"Iași",225,"225-COMARNA",96370,302,2,894,609,562,47,589,20,"COMARNA",,4,,423,166
24,"Iași",225,"225-COMARNA",96370,303,2,140,132,105,27,129,3,"COMARNA",,4,,80,49
24,"Iași",225,"225-COSTULENI",96423,304,2,1280,851,734,117,834,17,"COSTULENI",,4,,570,264
24,"Iași",225,"225-COSTULENI",96423,305,2,1129,823,624,199,799,24,"COSTULENI",,4,,590,209
24,"Iași",225,"225-COSTULENI",96423,306,2,917,674,565,109,655,19,"COSTULENI",,4,,416,239
24,"Iași",225,"225-COSTULENI",96423,307,2,682,510,412,98,492,18,"COSTULENI",,4,,251,241
24,"Iași",225,"225-COTNARI",96478,308,2,1477,981,857,124,973,8,"COTNARI",,4,,633,340
24,"Iași",225,"225-COTNARI",96478,309,2,1193,770,725,45,763,7,"COTNARI",,4,,573,190
24,"Iași",225,"225-COTNARI",96478,310,2,780,499,400,99,491,8,"COTNARI",,4,,320,171
24,"Iași",225,"225-COTNARI",96478,311,2,1835,1057,950,107,1038,19,"COTNARI",,4,,659,379
24,"Iași",225,"225-COTNARI",96478,312,2,642,476,410,66,471,5,"COTNARI",,4,,378,93
24,"Iași",225,"225-COZMESTI",96593,313,2,1220,749,633,116,738,11,"COZMESTI",,4,,451,287
24,"Iași",225,"225-COZMESTI",96593,314,2,753,511,411,100,503,8,"COZMESTI",,4,,336,167
24,"Iași",225,"225-COZMESTI",96593,315,2,282,200,184,16,194,6,"COZMESTI",,4,,120,74
24,"Iași",225,"225-CRISTESTI",95177,316,2,2258,1611,1501,110,1594,17,"CRISTESTI",,4,,1367,227
24,"Iași",225,"225-CRISTESTI",95177,317,2,603,502,409,93,490,12,"CRISTESTI",,4,,411,79
24,"Iași",225,"225-CRISTESTI",95177,318,2,372,272,237,35,271,1,"CRISTESTI",,4,,213,58
24,"Iași",225,"225-CUCUTENI",96664,319,2,1124,671,603,68,655,16,"CUCUTENI",,4,,438,217
24,"Iași",225,"225-DAGATA",96717,320,2,2127,1368,1120,248,1352,16,"DAGATA",,4,,902,450
24,"Iași",225,"225-DAGATA",96717,321,2,1195,835,696,139,827,8,"DAGATA",,4,,696,131
24,"Iași",225,"225-DELENI",96227,322,2,1707,1096,884,212,1088,8,"DELENI",,4,,752,336
24,"Iași",225,"225-DELENI",96227,323,2,1114,832,644,188,820,12,"DELENI",,4,,611,209
24,"Iași",225,"225-DELENI",96227,324,2,947,775,523,252,760,15,"DELENI",,4,,528,232
24,"Iași",225,"225-DELENI",96227,325,2,714,501,347,154,496,5,"DELENI",,4,,365,131
24,"Iași",225,"225-DELENI",96227,326,2,873,625,518,107,617,8,"DELENI",,4,,426,191
24,"Iași",225,"225-DELENI",96227,327,2,695,478,411,67,471,7,"DELENI",,4,,344,127
24,"Iași",225,"225-DELENI",96227,328,2,845,662,559,103,653,9,"DELENI",,4,,483,170
24,"Iași",225,"225-DOBROVAT",96888,329,2,1339,814,723,91,794,20,"DOBROVAT",,4,,491,303
24,"Iași",225,"225-DOBROVAT",96888,330,2,836,599,506,93,580,19,"DOBROVAT",,4,,422,158
24,"Iași",225,"225-DOLHESTI",96904,331,2,578,458,413,45,451,7,"DOLHESTI",,4,,304,147
24,"Iași",225,"225-DOLHESTI",96904,332,2,950,701,625,76,689,12,"DOLHESTI",,4,,563,126
24,"Iași",225,"225-DOLHESTI",96904,333,2,622,445,391,54,440,5,"DOLHESTI",,4,,211,229
24,"Iași",225,"225-DUMESTI",96940,334,2,1668,874,744,130,868,6,"DUMESTI",,4,,490,378
24,"Iași",225,"225-DUMESTI",96940,335,2,1419,785,714,71,774,11,"DUMESTI",,4,,599,175
24,"Iași",225,"225-DUMESTI",96940,336,2,535,430,307,123,429,1,"DUMESTI",,4,,276,153
24,"Iași",225,"225-ERBICENI",97009,337,2,2033,1198,1069,129,1175,23,"ERBICENI",,4,,777,398
24,"Iași",225,"225-ERBICENI",97009,338,2,1236,830,725,105,803,27,"ERBICENI",,4,,561,242
24,"Iași",225,"225-ERBICENI",97009,339,2,232,214,162,52,206,8,"ERBICENI",,4,,132,74
24,"Iași",225,"225-ERBICENI",97009,340,2,457,440,312,128,431,9,"ERBICENI",,4,,274,157
24,"Iași",225,"225-FOCURI",97063,341,2,1643,944,818,126,934,10,"FOCURI",,4,,669,265
24,"Iași",225,"225-FOCURI",97063,342,2,1416,871,794,77,859,12,"FOCURI",,4,,638,221
24,"Iași",225,"225-FOCURI",97063,343,2,1529,1023,944,79,1007,16,"FOCURI",,4,,779,228
24,"Iași",225,"225-GOLAIESTI",97090,344,2,1474,917,775,142,904,13,"GOLAIESTI",,4,,552,352
24,"Iași",225,"225-GOLAIESTI",97090,345,2,949,570,490,80,556,14,"GOLAIESTI",,4,,360,196
24,"Iași",225,"225-GOLAIESTI",97090,346,2,348,267,222,45,262,5,"GOLAIESTI",,4,,205,57
24,"Iași",225,"225-GORBAN",97189,347,2,632,498,394,104,489,9,"GORBAN",,4,,353,136
24,"Iași",225,"225-GORBAN",97189,348,2,606,412,351,61,406,6,"GORBAN",,4,,294,112
24,"Iași",225,"225-GORBAN",97189,349,2,497,381,319,62,379,2,"GORBAN",,4,,239,140
24,"Iași",225,"225-GORBAN",97189,350,2,511,435,352,83,432,3,"GORBAN",,4,,286,146
24,"Iași",225,"225-GRAJDURI",97241,351,2,1288,813,640,173,799,14,"GRAJDURI",,4,,421,378
24,"Iași",225,"225-GRAJDURI",97241,352,2,534,456,246,210,451,5,"GRAJDURI",,4,,257,194
24,"Iași",225,"225-GROPNITA",97321,353,2,899,622,558,64,614,8,"GROPNITA",,4,,395,219
24,"Iași",225,"225-GROPNITA",97321,354,2,712,628,547,81,616,12,"GROPNITA",,4,,354,262
24,"Iași",225,"225-GROPNITA",97321,355,2,778,556,477,79,552,4,"GROPNITA",,4,,383,169
24,"Iași",225,"225-GROZESTI",97394,356,2,1028,738,672,66,731,7,"GROZESTI",,4,,589,142
24,"Iași",225,"225-GROZESTI",97394,357,2,566,357,327,30,347,10,"GROZESTI",,4,,277,70
24,"Iași",225,"225-HALAUCESTI",97438,358,2,1761,1100,1025,75,1088,12,"HALAUCESTI",,4,,497,591
24,"Iași",225,"225-HALAUCESTI",97438,359,2,1794,1121,1025,96,1106,15,"HALAUCESTI",,4,,507,599
24,"Iași",225,"225-HALAUCESTI",97438,360,2,772,520,455,65,515,5,"HALAUCESTI",,4,,240,275
24,"Iași",225,"225-HELESTENI",97465,361,2,804,648,588,60,638,10,"HELESTENI",,4,,443,195
24,"Iași",225,"225-HELESTENI",97465,362,2,634,451,420,31,437,14,"HELESTENI",,4,,275,162
24,"Iași",225,"225-HELESTENI",97465,363,2,644,486,456,30,477,9,"HELESTENI",,4,,359,118
24,"Iași",225,"225-HOLBOCA",95159,364,2,2030,1276,1063,213,1263,13,"HOLBOCA",,4,,649,614
24,"Iași",225,"225-HOLBOCA",95159,365,2,905,640,529,111,626,14,"HOLBOCA",,4,,375,251
24,"Iași",225,"225-HOLBOCA",95159,366,2,1005,673,497,176,667,6,"HOLBOCA",,4,,324,343
24,"Iași",225,"225-HOLBOCA",95159,367,2,1498,1124,927,197,1117,7,"HOLBOCA",,4,,546,571
24,"Iași",225,"225-HOLBOCA",95159,368,2,1500,1260,1067,193,1257,3,"HOLBOCA",,4,,564,693
24,"Iași",225,"225-HORLESTI",95266,369,2,1621,985,883,102,975,10,"HORLESTI",,4,,575,400
24,"Iași",225,"225-HORLESTI",95266,370,2,490,354,263,91,352,2,"HORLESTI",,4,,266,86
24,"Iași",225,"225-HORLESTI",95266,371,2,231,165,146,19,163,2,"HORLESTI",,4,,127,36
24,"Iași",225,"225-IPATELE",97553,372,2,647,426,387,39,422,4,"IPATELE",,4,,322,100
24,"Iași",225,"225-IPATELE",97553,373,2,542,389,347,42,385,4,"IPATELE",,4,,290,95
24,"Iași",225,"225-IPATELE",97553,374,2,406,335,267,68,332,3,"IPATELE",,4,,240,92
24,"Iași",225,"225-LESPEZI",97606,375,2,1017,526,437,89,513,13,"LESPEZI",,4,,357,156
24,"Iași",225,"225-LESPEZI",97606,376,2,556,665,556,109,658,7,"LESPEZI",,4,,441,217
24,"Iași",225,"225-LESPEZI",97606,377,2,1649,1183,1010,173,1176,7,"LESPEZI",,4,,863,313
24,"Iași",225,"225-LESPEZI",97606,378,2,677,513,380,133,505,8,"LESPEZI",,4,,344,161
24,"Iași",225,"225-LESPEZI",97606,379,2,428,403,245,158,401,2,"LESPEZI",,4,,300,101
24,"Iași",225,"225-LETCANI",97679,380,2,2070,1381,1150,231,1349,32,"LETCANI",,4,,777,572
24,"Iași",225,"225-LETCANI",97679,381,2,1331,754,689,65,737,17,"LETCANI",,4,,559,178
24,"Iași",225,"225-LETCANI",97679,382,2,400,274,226,48,272,2,"LETCANI",,4,,207,65
24,"Iași",225,"225-LETCANI",97679,383,2,445,320,263,57,319,1,"LETCANI",,4,,256,63
24,"Iași",225,"225-LUNGANI",97722,384,2,755,528,455,73,522,6,"LUNGANI",,4,,378,144
24,"Iași",225,"225-LUNGANI",97722,385,2,853,559,502,57,555,4,"LUNGANI",,4,,431,124
24,"Iași",225,"225-LUNGANI",97722,386,2,925,631,541,90,628,3,"LUNGANI",,4,,506,122
24,"Iași",225,"225-LUNGANI",97722,387,2,841,551,472,79,539,12,"LUNGANI",,4,,408,131
24,"Iași",225,"225-MADARJAC",97777,388,2,1271,802,719,83,797,5,"MADARJAC",,4,,616,181
24,"Iași",225,"225-MIRCESTI",97811,389,2,1062,733,644,89,727,6,"MIRCESTI",,4,,375,352
24,"Iași",225,"225-MIRCESTI",97811,390,2,1366,955,889,66,944,11,"MIRCESTI",,4,,313,631
24,"Iași",225,"225-MIRCESTI",97811,391,2,1082,676,577,99,659,17,"MIRCESTI",,4,,378,281
24,"Iași",225,"225-MIRCESTI",97811,392,2,1456,948,816,132,931,13,"MIRCESTI",,4,,544,387
24,"Iași",225,"225-MIRONEASA",97875,393,2,1203,755,666,89,729,26,"MIRONEASA",,4,,520,209
24,"Iași",225,"225-MIRONEASA",97875,394,2,1007,562,517,45,545,17,"MIRONEASA",,4,,358,187
24,"Iași",225,"225-MIRONEASA",97875,395,2,398,262,218,44,259,3,"MIRONEASA",,4,,164,95
24,"Iași",225,"225-MIROSLAVA",97919,396,2,1157,843,658,185,832,11,"MIROSLAVA",,4,,494,338
24,"Iași",225,"225-MIROSLAVA",97919,397,2,699,470,396,74,466,4,"MIROSLAVA",,4,,305,161
24,"Iași",225,"225-MIROSLAVA",97919,398,2,685,429,370,59,422,7,"MIROSLAVA",,4,,287,135
24,"Iași",225,"225-MIROSLAVA",97919,399,2,698,449,339,110,442,7,"MIROSLAVA",,4,,138,304
24,"Iași",225,"225-MIROSLAVA",97919,400,2,968,613,496,117,601,12,"MIROSLAVA",,4,,322,279
24,"Iași",225,"225-MIROSLOVESTI",98051,401,2,1705,1120,1018,102,1109,11,"MIROSLOVESTI",,4,,855,254
24,"Iași",225,"225-MIROSLOVESTI",98051,402,2,1480,1052,963,89,1039,13,"MIROSLOVESTI",,4,,836,203
24,"Iași",225,"225-MIROSLOVESTI",98051,403,2,1202,953,890,63,946,7,"MIROSLOVESTI",,4,,753,193
24,"Iași",225,"225-MIROSLOVESTI",98051,404,2,985,693,594,99,683,10,"MIROSLOVESTI",,4,,523,160
24,"Iași",225,"225-MOGOSESTI-IASI",98113,405,2,1776,1145,1015,130,1129,16,"MOGOSESTI-IASI",,4,,670,459
24,"Iași",225,"225-MOGOSESTI-IASI",98113,406,2,770,452,398,54,440,12,"MOGOSESTI-IASI",,4,,272,168
24,"Iași",225,"225-MOGOSESTI-IASI",98113,407,2,799,525,467,58,516,9,"MOGOSESTI-IASI",,4,,298,218
24,"Iași",225,"225-MOGOSESTI-SIRET",98168,408,2,1375,1118,945,173,1101,17,"MOGOSESTI-SIRET",,4,,798,303
24,"Iași",225,"225-MOGOSESTI-SIRET",98168,409,2,1651,1215,1069,146,1207,8,"MOGOSESTI-SIRET",,4,,981,226
24,"Iași",225,"225-MOSNA",98202,410,2,1598,976,899,77,948,28,"MOSNA",,4,,629,319
24,"Iași",225,"225-MOTCA",98220,411,2,2502,2205,2103,102,2174,31,"MOTCA",,4,,1816,358
24,"Iași",225,"225-MOTCA",98220,412,2,1057,801,750,51,784,17,"MOTCA",,4,,568,216
24,"Iași",225,"225-MOVILENI",97492,413,2,979,679,597,82,658,21,"MOVILENI",,4,,439,219
24,"Iași",225,"225-MOVILENI",97492,414,2,664,545,494,51,537,8,"MOVILENI",,4,,382,155
24,"Iași",225,"225-MOVILENI",97492,415,2,770,507,456,51,495,12,"MOVILENI",,4,,343,152
24,"Iași",225,"225-OTELENI",98300,416,2,2126,1144,1050,94,1121,23,"OTELENI",,4,,769,352
24,"Iași",225,"225-OTELENI",98300,417,2,1024,635,564,71,624,11,"OTELENI",,4,,347,277
24,"Iași",225,"225-PLUGARI",98337,418,2,1401,945,913,32,940,5,"PLUGARI",,4,,761,179
24,"Iași",225,"225-PLUGARI",98337,419,2,1189,823,755,68,808,15,"PLUGARI",,4,,628,180
24,"Iași",225,"225-PODU ILOAIEI",98382,420,2,1219,977,711,266,972,5,"PODU ILOAIEI",,4,,537,435
24,"Iași",225,"225-PODU ILOAIEI",98382,421,2,1258,941,648,293,936,5,"PODU ILOAIEI",,4,,593,343
24,"Iași",225,"225-PODU ILOAIEI",98382,422,2,1072,760,506,254,755,5,"PODU ILOAIEI",,4,,416,339
24,"Iași",225,"225-PODU ILOAIEI",98382,423,2,1041,794,571,223,778,16,"PODU ILOAIEI",,4,,477,301
24,"Iași",225,"225-PODU ILOAIEI",98382,424,2,923,654,533,121,644,10,"PODU ILOAIEI",,4,,432,212
24,"Iași",225,"225-POPESTI",98435,425,2,917,617,538,79,613,4,"POPESTI",,4,,384,229
24,"Iași",225,"225-POPESTI",98435,426,2,790,508,460,48,498,10,"POPESTI",,4,,313,185
24,"Iași",225,"225-POPESTI",98435,427,2,511,339,294,45,328,11,"POPESTI",,4,,211,117
24,"Iași",225,"225-POPESTI",98435,428,2,608,409,356,53,404,5,"POPESTI",,4,,329,75
24,"Iași",225,"225-POPRICANI",98505,429,2,1377,1074,913,161,1064,10,"POPRICANI",,4,,716,348
24,"Iași",225,"225-POPRICANI",98505,430,2,768,568,441,127,558,10,"POPRICANI",,4,,393,165
24,"Iași",225,"225-POPRICANI",98505,431,2,1188,822,653,169,815,7,"POPRICANI",,4,,440,375
24,"Iași",225,"225-POPRICANI",98505,432,2,328,328,224,104,324,4,"POPRICANI",,4,,149,175
24,"Iași",225,"225-POPRICANI",98505,433,2,299,292,222,70,291,1,"POPRICANI",,4,,186,105
24,"Iași",225,"225-PRISACANI",98603,434,2,1612,1093,1023,70,1071,22,"PRISACANI",,4,,847,224
24,"Iași",225,"225-PRISACANI",98603,435,2,576,397,328,69,385,12,"PRISACANI",,4,,289,96
24,"Iași",225,"225-PRISACANI",98603,436,2,745,540,493,47,531,9,"PRISACANI",,4,,406,125
24,"Iași",225,"225-PROBOTA",98649,437,2,1011,576,496,80,569,7,"PROBOTA",,4,,331,238
24,"Iași",225,"225-PROBOTA",98649,438,2,444,357,270,87,349,8,"PROBOTA",,4,,192,157
24,"Iași",225,"225-PROBOTA",98649,439,2,1352,788,671,117,773,15,"PROBOTA",,4,,470,303
24,"Iași",225,"225-RADUCANENI",98685,440,2,1142,794,718,76,779,15,"RADUCANENI",,4,,489,290
24,"Iași",225,"225-RADUCANENI",98685,441,2,1931,1296,1199,97,1289,7,"RADUCANENI",,4,,616,673
24,"Iași",225,"225-RADUCANENI",98685,442,2,910,636,552,84,629,7,"RADUCANENI",,4,,278,351
24,"Iași",225,"225-RADUCANENI",98685,443,2,469,304,263,41,297,7,"RADUCANENI",,4,,259,38
24,"Iași",225,"225-RADUCANENI",98685,444,2,1213,789,727,62,778,11,"RADUCANENI",,4,,542,236
24,"Iași",225,"225-RADUCANENI",98685,445,2,274,221,188,33,221,0,"RADUCANENI",,4,,127,94
24,"Iași",225,"225-REDIU",95239,446,2,1450,932,797,135,924,8,"REDIU",,4,,677,247
24,"Iași",225,"225-REDIU",95239,447,2,1836,1344,1039,305,1330,14,"REDIU",,4,,741,589
24,"Iași",225,"225-REDIU",95239,448,2,598,441,303,138,436,5,"REDIU",,4,,275,161
24,"Iași",225,"225-ROMANESTI",98738,449,2,807,603,538,65,592,11,"ROMANESTI",,4,,447,145
24,"Iași",225,"225-ROMANESTI",98738,450,2,478,387,316,71,380,7,"ROMANESTI",,4,,271,109
24,"Iași",225,"225-ROMANESTI",98738,451,2,333,279,154,125,277,2,"ROMANESTI",,4,,181,96
24,"Iași",225,"225-RUGINOASA",98774,452,2,1532,1004,784,220,992,12,"RUGINOASA",,4,,675,317
24,"Iași",225,"225-RUGINOASA",98774,453,2,868,598,500,98,585,13,"RUGINOASA",,4,,435,150
24,"Iași",225,"225-RUGINOASA",98774,454,2,728,564,454,110,562,2,"RUGINOASA",,4,,400,162
24,"Iași",225,"225-RUGINOASA",98774,455,2,379,292,233,59,288,4,"RUGINOASA",,4,,214,74
24,"Iași",225,"225-RUGINOASA",98774,456,2,780,528,389,139,521,7,"RUGINOASA",,4,,352,169
24,"Iași",225,"225-SCHEIA",95649,457,2,1448,982,798,184,972,10,"SCHEIA",,4,,724,248
24,"Iași",225,"225-SCHEIA",95649,458,2,1145,681,597,84,674,7,"SCHEIA",,4,,534,140
24,"Iași",225,"225-SCHEIA",95649,459,2,673,440,352,88,433,7,"SCHEIA",,4,,298,135
24,"Iași",225,"225-SCHITU DUCA",98827,460,2,1661,856,719,137,842,14,"SCHITU DUCA",,4,,469,373
24,"Iași",225,"225-SCHITU DUCA",98827,461,2,888,597,493,104,589,8,"SCHITU DUCA",,4,,393,196
24,"Iași",225,"225-SCHITU DUCA",98827,462,2,800,488,394,94,482,6,"SCHITU DUCA",,4,,301,181
24,"Iași",225,"225-SCANTEIA",98916,463,2,1181,821,701,120,808,13,"SCANTEIA",,4,,437,371
24,"Iași",225,"225-SCANTEIA",98916,464,2,977,602,544,58,590,12,"SCANTEIA",,4,,295,295
24,"Iași",225,"225-SCANTEIA",98916,465,2,706,592,547,45,583,9,"SCANTEIA",,4,,258,325
24,"Iași",225,"225-SCOBINTI",98998,466,2,1298,786,696,90,777,9,"SCOBINTI",,4,,578,199
24,"Iași",225,"225-SCOBINTI",98998,467,2,1030,739,687,52,730,9,"SCOBINTI",,4,,560,170
24,"Iași",225,"225-SCOBINTI",98998,468,2,1236,836,769,67,827,9,"SCOBINTI",,4,,588,239
24,"Iași",225,"225-SCOBINTI",98998,469,2,1780,1107,1006,101,1091,16,"SCOBINTI",,4,,748,343
24,"Iași",225,"225-SINESTI",99058,470,2,1381,946,816,130,936,10,"SINESTI",,4,,711,225
24,"Iași",225,"225-SINESTI",99058,471,2,838,547,444,103,546,1,"SINESTI",,4,,428,118
24,"Iași",225,"225-SINESTI",99058,472,2,617,290,127,163,285,5,"SINESTI",,4,,260,25
24,"Iași",225,"225-SIPOTE",99370,473,2,1521,1001,900,101,987,14,"SIPOTE",,4,,632,355
24,"Iași",225,"225-SIPOTE",99370,474,2,1415,911,809,102,900,11,"SIPOTE",,4,,667,233
24,"Iași",225,"225-SIPOTE",99370,475,2,1199,877,798,79,859,18,"SIPOTE",,4,,629,230
24,"Iași",225,"225-SIRETEL",99101,476,2,1601,844,783,61,831,13,"SIRETEL",,4,,531,300
24,"Iași",225,"225-SIRETEL",99101,477,2,661,367,326,41,364,3,"SIRETEL",,4,,232,132
24,"Iași",225,"225-SIRETEL",99101,478,2,514,367,326,41,357,10,"SIRETEL",,4,,258,99
24,"Iași",225,"225-STOLNICENI-PRAJESCU",99165,479,2,1172,772,654,118,760,12,"STOLNICENI-PRAJESCU",,4,,563,197
24,"Iași",225,"225-STOLNICENI-PRAJESCU",99165,480,2,1460,1021,925,96,1003,18,"STOLNICENI-PRAJESCU",,4,,706,297
24,"Iași",225,"225-STOLNICENI-PRAJESCU",99165,481,2,1540,1056,893,163,1043,13,"STOLNICENI-PRAJESCU",,4,,593,450
24,"Iași",225,"225-STRUNGA",99209,482,2,506,427,347,80,425,2,"STRUNGA",,4,,304,121
24,"Iași",225,"225-STRUNGA",99209,483,2,736,563,487,76,544,19,"STRUNGA",,4,,437,107
24,"Iași",225,"225-STRUNGA",99209,484,2,306,281,218,63,280,1,"STRUNGA",,4,,201,79
24,"Iași",225,"225-STRUNGA",99209,485,2,1400,919,840,79,900,19,"STRUNGA",,4,,526,374
24,"Iași",225,"225-STRUNGA",99209,486,2,391,334,295,39,332,2,"STRUNGA",,4,,263,69
24,"Iași",225,"225-TANSA",95925,487,2,1494,1065,928,137,1055,10,"TANSA",,4,,755,300
24,"Iași",225,"225-TANSA",95925,488,2,1219,863,725,138,851,12,"TANSA",,4,,547,304
24,"Iași",225,"225-TATARUSI",99478,489,2,1684,986,851,135,976,10,"TATARUSI",,4,,776,200
24,"Iași",225,"225-TATARUSI",99478,490,2,1114,833,651,182,824,9,"TATARUSI",,4,,593,231
24,"Iași",225,"225-TATARUSI",99478,491,2,649,516,411,105,513,3,"TATARUSI",,4,,423,90
24,"Iași",225,"225-TATARUSI",99478,492,2,1009,776,603,173,769,7,"TATARUSI",,4,,562,207
24,"Iași",225,"225-TIBANA",99673,493,2,2192,1124,942,182,1103,21,"TIBANA",,4,,725,378
24,"Iași",225,"225-TIBANA",99673,494,2,1894,919,792,127,911,8,"TIBANA",,4,,599,312
24,"Iași",225,"225-TIBANA",99673,495,2,476,359,278,81,348,11,"TIBANA",,4,,182,166
24,"Iași",225,"225-TIBANESTI",99780,496,2,1513,1088,950,138,1076,12,"TIBANESTI",,4,,603,473
24,"Iași",225,"225-TIBANESTI",99780,497,2,592,502,432,70,498,4,"TIBANESTI",,4,,426,72
24,"Iași",225,"225-TIBANESTI",99780,498,2,1238,946,803,143,930,16,"TIBANESTI",,4,,748,182
24,"Iași",225,"225-TIBANESTI",99780,499,2,794,539,452,87,529,10,"TIBANESTI",,4,,373,156
24,"Iași",225,"225-TIBANESTI",99780,500,2,834,642,530,112,636,6,"TIBANESTI",,4,,450,186
24,"Iași",225,"225-TIGANASI",99879,501,2,817,646,551,95,640,6,"TIGANASI",,4,,452,188
24,"Iași",225,"225-TIGANASI",99879,502,2,964,705,618,87,690,15,"TIGANASI",,4,,519,171
24,"Iași",225,"225-TIGANASI",99879,503,2,652,475,425,50,467,8,"TIGANASI",,4,,330,137
24,"Iași",225,"225-TIGANASI",99879,504,2,287,242,202,40,240,2,"TIGANASI",,4,,175,65
24,"Iași",225,"225-TARGU FRUMOS",95480,505,2,886,736,621,115,729,7,"TARGU FRUMOS",,4,,527,202
24,"Iași",225,"225-TARGU FRUMOS",95480,506,2,691,429,382,47,424,5,"TARGU FRUMOS",,4,,337,87
24,"Iași",225,"225-TARGU FRUMOS",95480,507,2,779,659,514,145,653,6,"TARGU FRUMOS",,4,,476,177
24,"Iași",225,"225-TARGU FRUMOS",95480,508,2,773,440,389,51,428,12,"TARGU FRUMOS",,4,,362,66
24,"Iași",225,"225-TARGU FRUMOS",95480,509,2,964,649,533,116,631,18,"TARGU FRUMOS",,4,,507,124
24,"Iași",225,"225-TARGU FRUMOS",95480,510,2,367,258,189,69,254,4,"TARGU FRUMOS",,4,,201,53
24,"Iași",225,"225-TARGU FRUMOS",95480,511,2,1038,759,653,106,733,26,"TARGU FRUMOS",,4,,555,178
24,"Iași",225,"225-TARGU FRUMOS",95480,512,2,983,695,595,100,683,12,"TARGU FRUMOS",,4,,470,213
24,"Iași",225,"225-TARGU FRUMOS",95480,513,2,178,151,115,36,150,1,"TARGU FRUMOS",,4,,90,60
24,"Iași",225,"225-TARGU FRUMOS",95480,514,2,195,140,116,24,135,5,"TARGU FRUMOS",,4,,100,35
24,"Iași",225,"225-TODIRESTI",99539,515,2,1810,1075,984,91,1070,5,"TODIRESTI",,4,,779,291
24,"Iași",225,"225-TODIRESTI",99539,516,2,1255,776,686,90,768,8,"TODIRESTI",,4,,551,217
24,"Iași",225,"225-TODIRESTI",99539,517,2,766,504,480,24,495,9,"TODIRESTI",,4,,328,167
24,"Iași",225,"225-TODIRESTI",99539,518,2,528,378,333,45,372,6,"TODIRESTI",,4,,246,126
24,"Iași",225,"225-TODIRESTI",99539,519,2,667,444,411,33,437,7,"TODIRESTI",,4,,284,153
24,"Iași",225,"225-TOMESTI",95293,520,2,1080,647,647,0,647,0,"TOMESTI",,4,,273,374
24,"Iași",225,"225-TOMESTI",95293,521,2,1293,860,830,30,858,2,"TOMESTI",,4,,404,454
24,"Iași",225,"225-TOMESTI",95293,522,2,1242,1067,829,238,1062,5,"TOMESTI",,4,,440,622
24,"Iași",225,"225-TOMESTI",95293,523,2,876,657,587,70,653,4,"TOMESTI",,4,,281,372
24,"Iași",225,"225-TOMESTI",95293,524,2,1193,858,810,48,857,1,"TOMESTI",,4,,360,497
24,"Iași",225,"225-TOMESTI",95293,525,2,873,660,600,60,652,8,"TOMESTI",,4,,314,338
24,"Iași",225,"225-TOMESTI",95293,526,2,671,467,346,121,460,7,"TOMESTI",,4,,250,210
24,"Iași",225,"225-TRIFESTI",99600,527,2,1739,1107,971,136,1100,7,"TRIFESTI",,4,,768,332
24,"Iași",225,"225-TRIFESTI",99600,528,2,867,594,480,114,580,14,"TRIFESTI",,4,,298,282
24,"Iași",225,"225-TRIFESTI",99600,529,2,536,397,345,52,383,14,"TRIFESTI",,4,,250,133
24,"Iași",225,"225-TRIFESTI",99600,530,2,582,463,390,73,453,10,"TRIFESTI",,4,,287,166
24,"Iași",225,"225-TUTORA",99922,531,2,1730,1121,1035,86,1098,23,"TUTORA",,4,,711,387
24,"Iași",225,"225-VALEA SEACA",99968,532,2,1322,1003,914,89,992,11,"VALEA SEACA",,4,,646,346
24,"Iași",225,"225-VALEA SEACA",99968,533,2,1559,1073,975,98,1063,10,"VALEA SEACA",,4,,685,378
24,"Iași",225,"225-VALEA SEACA",99968,534,2,1176,926,906,20,915,11,"VALEA SEACA",,4,,610,305
24,"Iași",225,"225-SCULENI",100059,535,2,1804,1156,954,202,1146,10,"SCULENI",,4,,824,322
24,"Iași",225,"225-SCULENI",100059,536,2,949,573,478,95,555,18,"SCULENI",,4,,451,104
24,"Iași",225,"225-SCULENI",100059,537,2,404,318,226,92,314,4,"SCULENI",,4,,170,144
24,"Iași",225,"225-VANATORI",98587,538,2,998,710,636,74,704,6,"VANATORI",,4,,506,198
24,"Iași",225,"225-VANATORI",98587,539,2,1118,840,770,70,833,7,"VANATORI",,4,,645,188
24,"Iași",225,"225-VANATORI",98587,540,2,453,403,351,52,400,3,"VANATORI",,4,,309,91
24,"Iași",225,"225-VANATORI",98587,541,2,1032,754,684,70,749,5,"VANATORI",,4,,517,232
24,"Iași",225,"225-VLADENI",100148,542,2,1436,946,863,83,932,14,"VLADENI",,4,,638,294
24,"Iași",225,"225-VLADENI",100148,543,2,1047,720,631,89,714,6,"VLADENI",,4,,562,152
24,"Iași",225,"225-VLADENI",100148,544,2,989,578,501,77,569,9,"VLADENI",,4,,441,128
24,"Iași",225,"225-VOINESTI",100219,545,2,959,586,513,73,580,6,"VOINESTI",,4,,351,229
24,"Iași",225,"225-VOINESTI",100219,546,2,1167,710,609,101,705,5,"VOINESTI",,4,,450,255
24,"Iași",225,"225-VOINESTI",100219,547,2,333,297,251,46,294,3,"VOINESTI",,4,,234,60
24,"Iași",225,"225-VOINESTI",100219,548,2,892,444,388,56,443,1,"VOINESTI",,4,,377,66
24,"Iași",225,"225-VOINESTI",100219,549,2,295,238,185,53,237,1,"VOINESTI",,4,,205,32
24,"Iași",225,"225-VOINESTI",100219,550,2,147,106,76,30,104,2,"VOINESTI",,4,,63,41
25,"Maramureș",243,"243-MUNICIPIUL BAIA MARE",106318,1,2,1092,866,811,55,861,5,"MUNICIPIUL BAIA MARE",,2,,395,466
25,"Maramureș",243,"243-MUNICIPIUL BAIA MARE",106318,2,2,2268,1661,1445,216,1658,3,"MUNICIPIUL BAIA MARE",,2,,530,1128
25,"Maramureș",243,"243-MUNICIPIUL BAIA MARE",106318,3,2,2052,1351,1249,102,1344,7,"MUNICIPIUL BAIA MARE",,2,,379,965
25,"Maramureș",243,"243-MUNICIPIUL BAIA MARE",106318,4,2,2033,1458,1384,74,1454,4,"MUNICIPIUL BAIA MARE",,2,,404,1050
25,"Maramureș",243,"243-MUNICIPIUL BAIA MARE",106318,5,2,2332,1680,1594,86,1675,5,"MUNICIPIUL BAIA MARE",,2,,500,1175
25,"Maramureș",243,"243-MUNICIPIUL BAIA MARE",106318,6,2,2258,1574,1484,90,1567,7,"MUNICIPIUL BAIA MARE",,2,,515,1052
25,"Maramureș",243,"243-MUNICIPIUL BAIA MARE",106318,7,2,2264,1638,1579,59,1632,6,"MUNICIPIUL BAIA MARE",,2,,466,1166
25,"Maramureș",243,"243-MUNICIPIUL BAIA MARE",106318,8,2,2416,1755,1679,76,1747,8,"MUNICIPIUL BAIA MARE",,2,,519,1228
25,"Maramureș",243,"243-MUNICIPIUL BAIA MARE",106318,9,2,2131,1619,1518,101,1614,5,"MUNICIPIUL BAIA MARE",,2,,497,1117
25,"Maramureș",243,"243-MUNICIPIUL BAIA MARE",106318,10,2,2571,1994,1857,137,1989,5,"MUNICIPIUL BAIA MARE",,2,,547,1442
25,"Maramureș",243,"243-MUNICIPIUL BAIA MARE",106318,11,2,2079,1536,1454,82,1532,4,"MUNICIPIUL BAIA MARE",,2,,361,1171
25,"Maramureș",243,"243-MUNICIPIUL BAIA MARE",106318,12,2,1108,798,723,75,794,4,"MUNICIPIUL BAIA MARE",,2,,184,610
25,"Maramureș",243,"243-MUNICIPIUL BAIA MARE",106318,13,2,1731,1304,1193,111,1299,5,"MUNICIPIUL BAIA MARE",,2,,359,940
25,"Maramureș",243,"243-MUNICIPIUL BAIA MARE",106318,14,2,1999,1550,1412,138,1534,16,"MUNICIPIUL BAIA MARE",,2,,553,981
25,"Maramureș",243,"243-MUNICIPIUL BAIA MARE",106318,15,2,1774,1350,1245,105,1339,11,"MUNICIPIUL BAIA MARE",,2,,755,584
25,"Maramureș",243,"243-MUNICIPIUL BAIA MARE",106318,16,2,1219,975,846,129,966,9,"MUNICIPIUL BAIA MARE",,2,,606,360
25,"Maramureș",243,"243-MUNICIPIUL BAIA MARE",106318,17,2,2082,1619,1468,151,1604,15,"MUNICIPIUL BAIA MARE",,2,,378,1226
25,"Maramureș",243,"243-MUNICIPIUL BAIA MARE",106318,18,2,2034,1601,1409,192,1593,8,"MUNICIPIUL BAIA MARE",,2,,440,1153
25,"Maramureș",243,"243-MUNICIPIUL BAIA MARE",106318,19,2,2135,1547,1471,76,1544,3,"MUNICIPIUL BAIA MARE",,2,,493,1051
25,"Maramureș",243,"243-MUNICIPIUL BAIA MARE",106318,20,2,1871,1395,1296,99,1392,3,"MUNICIPIUL BAIA MARE",,2,,441,951
25,"Maramureș",243,"243-MUNICIPIUL BAIA MARE",106318,21,2,1765,1395,1297,98,1394,1,"MUNICIPIUL BAIA MARE",,2,,384,1010
25,"Maramureș",243,"243-MUNICIPIUL BAIA MARE",106318,22,2,2148,1647,1523,124,1639,8,"MUNICIPIUL BAIA MARE",,2,,511,1128
25,"Maramureș",243,"243-MUNICIPIUL BAIA MARE",106318,23,2,1623,1142,893,249,1139,3,"MUNICIPIUL BAIA MARE",,2,,276,863
25,"Maramureș",243,"243-MUNICIPIUL BAIA MARE",106318,24,2,1091,916,722,194,913,3,"MUNICIPIUL BAIA MARE",,2,,238,675
25,"Maramureș",243,"243-MUNICIPIUL BAIA MARE",106318,25,2,1375,1047,997,50,1041,6,"MUNICIPIUL BAIA MARE",,2,,261,780
25,"Maramureș",243,"243-MUNICIPIUL BAIA MARE",106318,26,2,1135,733,705,28,730,3,"MUNICIPIUL BAIA MARE",,2,,154,576
25,"Maramureș",243,"243-MUNICIPIUL BAIA MARE",106318,27,2,1449,860,806,54,856,4,"MUNICIPIUL BAIA MARE",,2,,162,694
25,"Maramureș",243,"243-MUNICIPIUL BAIA MARE",106318,28,2,1567,1009,909,100,1003,6,"MUNICIPIUL BAIA MARE",,2,,207,796
25,"Maramureș",243,"243-MUNICIPIUL BAIA MARE",106318,29,2,2123,1429,1287,142,1418,11,"MUNICIPIUL BAIA MARE",,2,,271,1147
25,"Maramureș",243,"243-MUNICIPIUL BAIA MARE",106318,30,2,2088,1414,1269,145,1405,9,"MUNICIPIUL BAIA MARE",,2,,337,1068
25,"Maramureș",243,"243-MUNICIPIUL BAIA MARE",106318,31,2,1602,986,881,105,986,0,"MUNICIPIUL BAIA MARE",,2,,227,759
25,"Maramureș",243,"243-MUNICIPIUL BAIA MARE",106318,32,2,1289,833,733,100,825,8,"MUNICIPIUL BAIA MARE",,2,,165,660
25,"Maramureș",243,"243-MUNICIPIUL BAIA MARE",106318,33,2,1599,1098,1003,95,1089,9,"MUNICIPIUL BAIA MARE",,2,,256,833
25,"Maramureș",243,"243-MUNICIPIUL BAIA MARE",106318,34,2,2010,1199,1061,138,1194,5,"MUNICIPIUL BAIA MARE",,2,,318,876
25,"Maramureș",243,"243-MUNICIPIUL BAIA MARE",106318,35,2,1448,1064,1007,57,1062,2,"MUNICIPIUL BAIA MARE",,2,,315,747
25,"Maramureș",243,"243-MUNICIPIUL BAIA MARE",106318,36,2,2286,1486,1328,158,1482,4,"MUNICIPIUL BAIA MARE",,2,,424,1058
25,"Maramureș",243,"243-MUNICIPIUL BAIA MARE",106318,37,2,1992,1258,1174,84,1255,3,"MUNICIPIUL BAIA MARE",,2,,398,857
25,"Maramureș",243,"243-MUNICIPIUL BAIA MARE",106318,38,2,2029,1413,1300,113,1406,7,"MUNICIPIUL BAIA MARE",,2,,456,950
25,"Maramureș",243,"243-MUNICIPIUL BAIA MARE",106318,39,2,2348,1686,1613,73,1681,5,"MUNICIPIUL BAIA MARE",,2,,693,988
25,"Maramureș",243,"243-MUNICIPIUL BAIA MARE",106318,40,2,2005,1510,1367,143,1495,15,"MUNICIPIUL BAIA MARE",,2,,442,1053
25,"Maramureș",243,"243-MUNICIPIUL BAIA MARE",106318,41,2,2429,1698,1545,153,1692,6,"MUNICIPIUL BAIA MARE",,2,,537,1155
25,"Maramureș",243,"243-MUNICIPIUL BAIA MARE",106318,42,2,1381,892,834,58,891,1,"MUNICIPIUL BAIA MARE",,2,,276,615
25,"Maramureș",243,"243-MUNICIPIUL BAIA MARE",106318,43,2,1615,1086,990,96,1081,5,"MUNICIPIUL BAIA MARE",,2,,361,720
25,"Maramureș",243,"243-MUNICIPIUL BAIA MARE",106318,44,2,1586,1235,1157,78,1230,5,"MUNICIPIUL BAIA MARE",,2,,400,830
25,"Maramureș",243,"243-MUNICIPIUL BAIA MARE",106318,45,2,1426,989,917,72,986,3,"MUNICIPIUL BAIA MARE",,2,,300,686
25,"Maramureș",243,"243-MUNICIPIUL BAIA MARE",106318,46,2,1429,1048,986,62,1042,6,"MUNICIPIUL BAIA MARE",,2,,318,724
25,"Maramureș",243,"243-MUNICIPIUL BAIA MARE",106318,47,2,1734,1146,1029,117,1143,3,"MUNICIPIUL BAIA MARE",,2,,367,776
25,"Maramureș",243,"243-MUNICIPIUL BAIA MARE",106318,48,2,1524,1048,985,63,1046,2,"MUNICIPIUL BAIA MARE",,2,,337,709
25,"Maramureș",243,"243-MUNICIPIUL BAIA MARE",106318,49,2,2970,1963,1830,133,1953,10,"MUNICIPIUL BAIA MARE",,2,,650,1303
25,"Maramureș",243,"243-MUNICIPIUL BAIA MARE",106318,50,2,2752,1945,1796,149,1938,7,"MUNICIPIUL BAIA MARE",,2,,640,1298
25,"Maramureș",243,"243-MUNICIPIUL BAIA MARE",106318,51,2,2811,1835,1648,187,1830,5,"MUNICIPIUL BAIA MARE",,2,,628,1202
25,"Maramureș",243,"243-MUNICIPIUL BAIA MARE",106318,52,2,2545,1777,1579,198,1772,5,"MUNICIPIUL BAIA MARE",,2,,636,1136
25,"Maramureș",243,"243-MUNICIPIUL BAIA MARE",106318,53,2,2557,1690,1579,111,1685,5,"MUNICIPIUL BAIA MARE",,2,,571,1114
25,"Maramureș",243,"243-MUNICIPIUL BAIA MARE",106318,54,2,2332,1591,1456,135,1587,4,"MUNICIPIUL BAIA MARE",,2,,530,1057
25,"Maramureș",243,"243-MUNICIPIUL BAIA MARE",106318,55,2,1921,1332,1276,56,1328,3,"MUNICIPIUL BAIA MARE",,2,,453,875
25,"Maramureș",243,"243-MUNICIPIUL BAIA MARE",106318,56,2,1510,1147,995,152,1143,4,"MUNICIPIUL BAIA MARE",,2,,372,771
25,"Maramureș",243,"243-MUNICIPIUL BAIA MARE",106318,57,2,1818,1436,1105,331,1426,10,"MUNICIPIUL BAIA MARE",,2,,422,1004
25,"Maramureș",243,"243-MUNICIPIUL BAIA MARE",106318,58,2,2548,1744,1650,94,1741,3,"MUNICIPIUL BAIA MARE",,2,,597,1144
25,"Maramureș",243,"243-MUNICIPIUL BAIA MARE",106318,59,2,2781,2029,1526,503,2023,6,"MUNICIPIUL BAIA MARE",,2,,569,1454
25,"Maramureș",243,"243-MUNICIPIUL BAIA MARE",106318,60,2,1654,970,785,185,969,1,"MUNICIPIUL BAIA MARE",,2,,312,657
25,"Maramureș",243,"243-MUNICIPIUL BAIA MARE",106318,61,2,0,683,0,683,681,2,"MUNICIPIUL BAIA MARE",,2,,284,397
25,"Maramureș",243,"243-MUNICIPIUL BAIA MARE",106318,62,2,0,130,0,130,129,1,"MUNICIPIUL BAIA MARE",,2,,44,85
25,"Maramureș",243,"243-MUNICIPIUL BAIA MARE",106318,63,2,0,163,0,163,162,1,"MUNICIPIUL BAIA MARE",,2,,60,102
25,"Maramureș",243,"243-MUNICIPIUL BAIA MARE",106318,64,2,0,89,0,89,88,1,"MUNICIPIUL BAIA MARE",,2,,28,60
25,"Maramureș",243,"243-MUNICIPIUL BAIA MARE",106318,65,2,0,731,0,731,723,8,"MUNICIPIUL BAIA MARE",,2,,332,391
25,"Maramureș",243,"243-MUNICIPIUL SIGHETU MARMATIEI",106559,66,2,1267,787,744,43,780,7,"MUNICIPIUL SIGHETU MARMATIEI",,2,,451,329
25,"Maramureș",243,"243-MUNICIPIUL SIGHETU MARMATIEI",106559,67,2,1176,723,688,35,715,8,"MUNICIPIUL SIGHETU MARMATIEI",,2,,390,325
25,"Maramureș",243,"243-MUNICIPIUL SIGHETU MARMATIEI",106559,68,2,966,641,590,51,637,4,"MUNICIPIUL SIGHETU MARMATIEI",,2,,269,368
25,"Maramureș",243,"243-MUNICIPIUL SIGHETU MARMATIEI",106559,69,2,1472,1024,964,60,1018,6,"MUNICIPIUL SIGHETU MARMATIEI",,2,,275,743
25,"Maramureș",243,"243-MUNICIPIUL SIGHETU MARMATIEI",106559,70,2,1903,1646,1239,407,1632,14,"MUNICIPIUL SIGHETU MARMATIEI",,2,,508,1124
25,"Maramureș",243,"243-MUNICIPIUL SIGHETU MARMATIEI",106559,71,2,1892,1314,1160,154,1307,7,"MUNICIPIUL SIGHETU MARMATIEI",,2,,421,886
25,"Maramureș",243,"243-MUNICIPIUL SIGHETU MARMATIEI",106559,72,2,1602,1102,1036,66,1098,4,"MUNICIPIUL SIGHETU MARMATIEI",,2,,377,721
25,"Maramureș",243,"243-MUNICIPIUL SIGHETU MARMATIEI",106559,73,2,1299,947,812,135,945,2,"MUNICIPIUL SIGHETU MARMATIEI",,2,,291,654
25,"Maramureș",243,"243-MUNICIPIUL SIGHETU MARMATIEI",106559,74,2,1385,960,849,111,955,5,"MUNICIPIUL SIGHETU MARMATIEI",,2,,254,701
25,"Maramureș",243,"243-MUNICIPIUL SIGHETU MARMATIEI",106559,75,2,2197,1571,1378,193,1567,4,"MUNICIPIUL SIGHETU MARMATIEI",,2,,510,1057
25,"Maramureș",243,"243-MUNICIPIUL SIGHETU MARMATIEI",106559,76,2,1512,1071,978,93,1070,1,"MUNICIPIUL SIGHETU MARMATIEI",,2,,239,831
25,"Maramureș",243,"243-MUNICIPIUL SIGHETU MARMATIEI",106559,77,2,1488,1135,1013,122,1129,6,"MUNICIPIUL SIGHETU MARMATIEI",,2,,383,746
25,"Maramureș",243,"243-MUNICIPIUL SIGHETU MARMATIEI",106559,78,2,1471,1016,884,132,1013,3,"MUNICIPIUL SIGHETU MARMATIEI",,2,,338,675
25,"Maramureș",243,"243-MUNICIPIUL SIGHETU MARMATIEI",106559,79,2,1548,1188,990,198,1180,8,"MUNICIPIUL SIGHETU MARMATIEI",,2,,428,752
25,"Maramureș",243,"243-MUNICIPIUL SIGHETU MARMATIEI",106559,80,2,1314,898,809,89,893,5,"MUNICIPIUL SIGHETU MARMATIEI",,2,,367,526
25,"Maramureș",243,"243-MUNICIPIUL SIGHETU MARMATIEI",106559,81,2,1487,1067,925,142,1059,8,"MUNICIPIUL SIGHETU MARMATIEI",,2,,381,678
25,"Maramureș",243,"243-MUNICIPIUL SIGHETU MARMATIEI",106559,82,2,1794,1221,1096,125,1208,13,"MUNICIPIUL SIGHETU MARMATIEI",,2,,369,839
25,"Maramureș",243,"243-MUNICIPIUL SIGHETU MARMATIEI",106559,83,2,1771,1116,982,134,1112,4,"MUNICIPIUL SIGHETU MARMATIEI",,2,,374,738
25,"Maramureș",243,"243-MUNICIPIUL SIGHETU MARMATIEI",106559,84,2,2190,1406,1347,59,1402,4,"MUNICIPIUL SIGHETU MARMATIEI",,2,,474,928
25,"Maramureș",243,"243-MUNICIPIUL SIGHETU MARMATIEI",106559,85,2,1724,1215,1115,100,1191,24,"MUNICIPIUL SIGHETU MARMATIEI",,2,,456,735
25,"Maramureș",243,"243-MUNICIPIUL SIGHETU MARMATIEI",106559,86,2,2182,1395,1309,86,1390,5,"MUNICIPIUL SIGHETU MARMATIEI",,2,,732,658
25,"Maramureș",243,"243-MUNICIPIUL SIGHETU MARMATIEI",106559,87,2,835,493,446,47,491,2,"MUNICIPIUL SIGHETU MARMATIEI",,2,,246,245
25,"Maramureș",243,"243-MUNICIPIUL SIGHETU MARMATIEI",106559,88,2,336,318,0,318,317,1,"MUNICIPIUL SIGHETU MARMATIEI",,2,,184,133
25,"Maramureș",243,"243-ORAS BAIA SPRIE",106684,89,2,2768,2114,1920,194,2103,11,"ORAS BAIA SPRIE",,2,,435,1668
25,"Maramureș",243,"243-ORAS BAIA SPRIE",106684,90,2,3378,2414,2130,284,2409,5,"ORAS BAIA SPRIE",,2,,609,1800
25,"Maramureș",243,"243-ORAS BAIA SPRIE",106684,91,2,2803,1853,1624,229,1832,21,"ORAS BAIA SPRIE",,2,,540,1292
25,"Maramureș",243,"243-ORAS BAIA SPRIE",106684,92,2,588,541,485,56,536,5,"ORAS BAIA SPRIE",,2,,366,170
25,"Maramureș",243,"243-ORAS BAIA SPRIE",106684,93,2,1881,1412,1260,152,1403,9,"ORAS BAIA SPRIE",,2,,550,853
25,"Maramureș",243,"243-ORAS BAIA SPRIE",106684,94,2,1067,979,871,108,975,4,"ORAS BAIA SPRIE",,2,,305,670
25,"Maramureș",243,"243-ORAS BORSA",106746,95,2,1089,733,677,56,729,4,"ORAS BORSA",,2,,339,390
25,"Maramureș",243,"243-ORAS BORSA",106746,96,2,969,624,584,40,619,5,"ORAS BORSA",,2,,342,277
25,"Maramureș",243,"243-ORAS BORSA",106746,97,2,793,663,480,183,656,7,"ORAS BORSA",,2,,300,356
25,"Maramureș",243,"243-ORAS BORSA",106746,98,2,1800,1056,985,71,1043,13,"ORAS BORSA",,2,,482,561
25,"Maramureș",243,"243-ORAS BORSA",106746,99,2,1566,960,888,72,954,6,"ORAS BORSA",,2,,333,621
25,"Maramureș",243,"243-ORAS BORSA",106746,100,2,2292,1692,1405,287,1688,4,"ORAS BORSA",,2,,663,1025
25,"Maramureș",243,"243-ORAS BORSA",106746,101,2,835,493,478,15,492,1,"ORAS BORSA",,2,,273,219
25,"Maramureș",243,"243-ORAS BORSA",106746,102,2,755,485,443,42,479,6,"ORAS BORSA",,2,,215,264
25,"Maramureș",243,"243-ORAS BORSA",106746,103,2,1483,951,916,35,948,3,"ORAS BORSA",,2,,416,532
25,"Maramureș",243,"243-ORAS BORSA",106746,104,2,1471,834,809,25,829,5,"ORAS BORSA",,2,,322,507
25,"Maramureș",243,"243-ORAS BORSA",106746,105,2,986,658,614,44,652,6,"ORAS BORSA",,2,,243,409
25,"Maramureș",243,"243-ORAS BORSA",106746,106,2,889,578,520,58,567,11,"ORAS BORSA",,2,,171,396
25,"Maramureș",243,"243-ORAS BORSA",106746,107,2,1592,976,931,45,974,2,"ORAS BORSA",,2,,575,399
25,"Maramureș",243,"243-ORAS BORSA",106746,108,2,1576,980,937,43,975,5,"ORAS BORSA",,2,,492,483
25,"Maramureș",243,"243-ORAS BORSA",106746,109,2,1647,1092,962,130,1086,6,"ORAS BORSA",,2,,589,497
25,"Maramureș",243,"243-ORAS CAVNIC",106782,110,2,2254,1545,1462,83,1536,9,"ORAS CAVNIC",,2,,713,823
25,"Maramureș",243,"243-ORAS CAVNIC",106782,111,2,1322,1036,960,76,1031,5,"ORAS CAVNIC",,2,,576,455
25,"Maramureș",243,"243-ORAS CAVNIC",106782,112,2,899,606,544,62,602,4,"ORAS CAVNIC",,2,,117,485
25,"Maramureș",243,"243-ORAS SEINI",108963,113,2,2165,1539,1418,121,1529,10,"ORAS SEINI",,2,,569,960
25,"Maramureș",243,"243-ORAS SEINI",108963,114,2,1867,1380,1270,110,1363,17,"ORAS SEINI",,2,,342,1021
25,"Maramureș",243,"243-ORAS SEINI",108963,115,2,1692,1298,1143,155,1290,8,"ORAS SEINI",,2,,401,889
25,"Maramureș",243,"243-ORAS SEINI",108963,116,2,566,424,370,54,420,4,"ORAS SEINI",,2,,253,167
25,"Maramureș",243,"243-ORAS SEINI",108963,117,2,469,358,313,45,356,2,"ORAS SEINI",,2,,120,236
25,"Maramureș",243,"243-ORAS TARGU LAPUS",106817,118,2,1886,1265,1165,100,1262,3,"ORAS TARGU LAPUS",,2,,574,688
25,"Maramureș",243,"243-ORAS TARGU LAPUS",106817,119,2,1617,1124,1028,96,1120,4,"ORAS TARGU LAPUS",,2,,507,613
25,"Maramureș",243,"243-ORAS TARGU LAPUS",106817,120,2,1329,905,845,60,896,9,"ORAS TARGU LAPUS",,2,,373,523
25,"Maramureș",243,"243-ORAS TARGU LAPUS",106817,121,2,441,344,302,42,338,6,"ORAS TARGU LAPUS",,2,,178,160
25,"Maramureș",243,"243-ORAS TARGU LAPUS",106817,122,2,429,348,323,25,345,3,"ORAS TARGU LAPUS",,2,,154,191
25,"Maramureș",243,"243-ORAS TARGU LAPUS",106817,123,2,190,163,142,21,163,0,"ORAS TARGU LAPUS",,2,,55,108
25,"Maramureș",243,"243-ORAS TARGU LAPUS",106817,124,2,792,532,502,30,525,7,"ORAS TARGU LAPUS",,2,,31,494
25,"Maramureș",243,"243-ORAS TARGU LAPUS",106817,125,2,384,280,246,34,277,3,"ORAS TARGU LAPUS",,2,,97,180
25,"Maramureș",243,"243-ORAS TARGU LAPUS",106817,126,2,192,173,151,22,172,1,"ORAS TARGU LAPUS",,2,,108,64
25,"Maramureș",243,"243-ORAS TARGU LAPUS",106817,127,2,287,196,178,18,193,3,"ORAS TARGU LAPUS",,2,,120,73
25,"Maramureș",243,"243-ORAS TARGU LAPUS",106817,128,2,258,172,150,22,171,1,"ORAS TARGU LAPUS",,2,,64,107
25,"Maramureș",243,"243-ORAS TARGU LAPUS",106817,129,2,1095,668,623,45,667,1,"ORAS TARGU LAPUS",,2,,479,188
25,"Maramureș",243,"243-ORAS TARGU LAPUS",106817,130,2,1257,973,896,77,969,4,"ORAS TARGU LAPUS",,2,,590,379
25,"Maramureș",243,"243-ORAS TARGU LAPUS",106817,131,2,674,421,373,48,420,1,"ORAS TARGU LAPUS",,2,,168,252
25,"Maramureș",243,"243-ORAS TARGU LAPUS",106817,132,2,251,219,200,19,218,1,"ORAS TARGU LAPUS",,2,,119,99
25,"Maramureș",243,"243-ORAS VISEU DE SUS",106979,133,2,2410,1437,1384,53,1426,11,"ORAS VISEU DE SUS",,2,,608,818
25,"Maramureș",243,"243-ORAS VISEU DE SUS",106979,134,2,1960,1453,1177,276,1444,9,"ORAS VISEU DE SUS",,2,,546,898
25,"Maramureș",243,"243-ORAS VISEU DE SUS",106979,135,2,3090,2008,1880,128,1989,19,"ORAS VISEU DE SUS",,2,,887,1102
25,"Maramureș",243,"243-ORAS VISEU DE SUS",106979,136,2,783,523,468,55,519,4,"ORAS VISEU DE SUS",,2,,147,372
25,"Maramureș",243,"243-ORAS VISEU DE SUS",106979,137,2,2036,1459,1396,63,1452,7,"ORAS VISEU DE SUS",,2,,840,612
25,"Maramureș",243,"243-ORAS VISEU DE SUS",106979,138,2,2461,1479,1397,82,1473,6,"ORAS VISEU DE SUS",,2,,571,902
25,"Maramureș",243,"243-ORAS VISEU DE SUS",106979,139,2,1918,1132,1046,86,1116,16,"ORAS VISEU DE SUS",,2,,772,344
25,"Maramureș",243,"243-ARDUSAT",107001,140,2,1410,1017,853,164,1007,10,"ARDUSAT",,2,,560,447
25,"Maramureș",243,"243-ARDUSAT",107001,141,2,365,320,280,40,318,2,"ARDUSAT",,2,,185,133
25,"Maramureș",243,"243-ARINIS",107047,142,2,656,553,481,72,549,4,"ARINIS",,2,,242,307
25,"Maramureș",243,"243-ARINIS",107047,143,2,277,248,189,59,248,0,"ARINIS",,2,,133,115
25,"Maramureș",243,"243-ASUAJU DE SUS",107083,144,2,950,838,769,69,818,20,"ASUAJU DE SUS",,2,,454,364
25,"Maramureș",243,"243-ASUAJU DE SUS",107083,145,2,388,360,312,48,359,1,"ASUAJU DE SUS",,2,,181,178
25,"Maramureș",243,"243-BAITA DE SUB CODRU",107118,146,2,1113,864,725,139,856,8,"BAITA DE SUB CODRU",,2,,551,305
25,"Maramureș",243,"243-BAITA DE SUB CODRU",107118,147,2,451,350,295,55,345,5,"BAITA DE SUB CODRU",,2,,210,135
25,"Maramureș",243,"243-BAITA DE SUB CODRU",107118,148,2,297,249,215,34,247,2,"BAITA DE SUB CODRU",,2,,132,115
25,"Maramureș",243,"243-BAIUT",107154,149,2,1466,1108,1031,77,1102,6,"BAIUT",,2,,417,685
25,"Maramureș",243,"243-BAIUT",107154,150,2,627,492,469,23,489,3,"BAIUT",,2,,262,227
25,"Maramureș",243,"243-BAIUT",107154,151,2,277,241,212,29,239,2,"BAIUT",,2,,167,72
25,"Maramureș",243,"243-BASESTI",107190,152,2,659,592,506,86,585,7,"BASESTI",,2,,309,276
25,"Maramureș",243,"243-BASESTI",107190,153,2,287,241,183,58,241,0,"BASESTI",,2,,97,144
25,"Maramureș",243,"243-BICAZ",107234,154,2,562,358,321,37,356,2,"BICAZ",,2,,234,122
25,"Maramureș",243,"243-BICAZ",107234,155,2,239,219,195,24,217,2,"BICAZ",,2,,124,93
25,"Maramureș",243,"243-BICAZ",107234,156,2,410,328,295,33,325,3,"BICAZ",,2,,203,122
25,"Maramureș",243,"243-BISTRA",107270,157,2,828,472,404,68,462,10,"BISTRA",,2,,229,233
25,"Maramureș",243,"243-BISTRA",107270,158,2,1495,1285,1197,88,1277,8,"BISTRA",,2,,516,761
25,"Maramureș",243,"243-BISTRA",107270,159,2,1217,823,782,41,805,18,"BISTRA",,2,,195,610
25,"Maramureș",243,"243-BIRSANA",107314,160,2,2933,1595,1469,126,1582,13,"BIRSANA",,2,,1032,550
25,"Maramureș",243,"243-BIRSANA",107314,161,2,593,353,333,20,349,4,"BIRSANA",,2,,275,74
25,"Maramureș",243,"243-BIRSANA",107314,162,2,1393,928,872,56,921,7,"BIRSANA",,2,,534,387
25,"Maramureș",243,"243-BIRSANA",107314,163,2,648,444,417,27,444,0,"BIRSANA",,2,,357,87
25,"Maramureș",243,"243-BOCICOIU MARE",107350,164,2,430,390,305,85,389,1,"BOCICOIU MARE",,2,,110,279
25,"Maramureș",243,"243-BOCICOIU MARE",107350,165,2,777,604,545,59,599,5,"BOCICOIU MARE",,2,,255,344
25,"Maramureș",243,"243-BOCICOIU MARE",107350,166,2,1155,758,693,65,751,7,"BOCICOIU MARE",,2,,203,548
25,"Maramureș",243,"243-BOCICOIU MARE",107350,167,2,996,662,585,77,657,5,"BOCICOIU MARE",,2,,241,416
25,"Maramureș",243,"243-BOGDAN VODA",107403,168,2,2139,1330,1253,77,1326,4,"BOGDAN VODA",,2,,847,479
25,"Maramureș",243,"243-BOGDAN VODA",107403,169,2,843,589,506,83,583,6,"BOGDAN VODA",,2,,422,161
25,"Maramureș",243,"243-BOIU MARE",107430,170,2,688,464,421,43,462,2,"BOIU MARE",,2,,306,156
25,"Maramureș",243,"243-BOIU MARE",107430,171,2,383,315,285,30,314,1,"BOIU MARE",,2,,220,94
25,"Maramureș",243,"243-BOTIZA",107485,172,2,2244,1825,1772,53,1822,3,"BOTIZA",,2,,1621,201
25,"Maramureș",243,"243-BUDESTI",107519,173,2,1302,913,894,19,908,5,"BUDESTI",,2,,640,268
25,"Maramureș",243,"243-BUDESTI",107519,174,2,793,559,539,20,558,1,"BUDESTI",,2,,479,79
25,"Maramureș",243,"243-BUDESTI",107519,175,2,776,495,465,30,490,5,"BUDESTI",,2,,322,168
25,"Maramureș",243,"243-CALINESTI",107546,176,2,1301,875,820,55,875,0,"CALINESTI",,2,,376,499
25,"Maramureș",243,"243-CALINESTI",107546,177,2,387,239,214,25,238,1,"CALINESTI",,2,,165,73
25,"Maramureș",243,"243-CALINESTI",107546,178,2,1128,675,616,59,671,4,"CALINESTI",,2,,517,154
25,"Maramureș",243,"243-CERNESTI",107582,179,2,974,808,753,55,798,10,"CERNESTI",,2,,543,255
25,"Maramureș",243,"243-CERNESTI",107582,180,2,895,814,766,48,809,5,"CERNESTI",,2,,408,401
25,"Maramureș",243,"243-CERNESTI",107582,181,2,564,451,432,19,449,2,"CERNESTI",,2,,258,191
25,"Maramureș",243,"243-CERNESTI",107582,182,2,537,471,436,35,470,1,"CERNESTI",,2,,341,129
25,"Maramureș",243,"243-CICIRLAU",107662,183,2,1441,1151,1060,91,1142,9,"CICIRLAU",,2,,579,563
25,"Maramureș",243,"243-CICIRLAU",107662,184,2,1325,993,890,103,982,11,"CICIRLAU",,2,,571,411
25,"Maramureș",243,"243-CIMPULUNG LA TISA",107715,185,2,1923,1240,1151,89,1234,6,"CIMPULUNG LA TISA",,2,,143,1091
25,"Maramureș",243,"243-COPALNIC-MANASTUR",107733,186,2,613,486,408,78,481,5,"COPALNIC-MANASTUR",,2,,205,276
25,"Maramureș",243,"243-COPALNIC-MANASTUR",107733,187,2,257,269,229,40,269,0,"COPALNIC-MANASTUR",,2,,170,99
25,"Maramureș",243,"243-COPALNIC-MANASTUR",107733,188,2,743,501,374,127,496,5,"COPALNIC-MANASTUR",,2,,233,263
25,"Maramureș",243,"243-COPALNIC-MANASTUR",107733,189,2,1231,846,681,165,844,2,"COPALNIC-MANASTUR",,2,,356,488
25,"Maramureș",243,"243-COPALNIC-MANASTUR",107733,190,2,623,479,410,69,476,3,"COPALNIC-MANASTUR",,2,,266,210
25,"Maramureș",243,"243-COPALNIC-MANASTUR",107733,191,2,420,352,305,47,347,5,"COPALNIC-MANASTUR",,2,,209,138
25,"Maramureș",243,"243-COPALNIC-MANASTUR",107733,192,2,275,195,148,47,192,3,"COPALNIC-MANASTUR",,2,,116,76
25,"Maramureș",243,"243-COPALNIC-MANASTUR",107733,193,2,299,281,245,36,280,1,"COPALNIC-MANASTUR",,2,,140,140
25,"Maramureș",243,"243-COROIENI",107868,194,2,583,384,360,24,378,6,"COROIENI",,2,,246,132
25,"Maramureș",243,"243-COROIENI",107868,195,2,483,329,317,12,327,2,"COROIENI",,2,,169,158
25,"Maramureș",243,"243-COROIENI",107868,196,2,309,234,222,12,232,2,"COROIENI",,2,,174,58
25,"Maramureș",243,"243-COROIENI",107868,197,2,509,391,365,26,386,5,"COROIENI",,2,,246,140
25,"Maramureș",243,"243-CUPSENI",107920,198,2,689,555,533,22,552,3,"CUPSENI",,2,,408,144
25,"Maramureș",243,"243-CUPSENI",107920,199,2,411,329,316,13,327,2,"CUPSENI",,2,,51,276
25,"Maramureș",243,"243-CUPSENI",107920,200,2,963,815,794,21,807,8,"CUPSENI",,2,,542,265
25,"Maramureș",243,"243-CUPSENI",107920,201,2,1122,1099,1077,22,1097,2,"CUPSENI",,2,,911,186
25,"Maramureș",243,"243-DESESTI",107975,202,2,814,694,673,21,689,5,"DESESTI",,2,,355,334
25,"Maramureș",243,"243-DESESTI",107975,203,2,825,743,705,38,738,5,"DESESTI",,2,,358,380
25,"Maramureș",243,"243-DESESTI",107975,204,2,503,370,349,21,370,0,"DESESTI",,2,,197,173
25,"Maramureș",243,"243-DRAGOMIRESTI",108026,205,2,2661,1770,1663,107,1765,5,"DRAGOMIRESTI",,2,,1069,696
25,"Maramureș",243,"243-DUMBRAVITA",108035,206,2,896,828,804,24,817,11,"DUMBRAVITA",,2,,337,480
25,"Maramureș",243,"243-DUMBRAVITA",108035,207,2,743,630,594,36,624,6,"DUMBRAVITA",,2,,391,233
25,"Maramureș",243,"243-DUMBRAVITA",108035,208,2,454,327,311,16,326,1,"DUMBRAVITA",,2,,185,141
25,"Maramureș",243,"243-DUMBRAVITA",108035,209,2,1342,1014,961,53,1013,1,"DUMBRAVITA",,2,,495,518
25,"Maramureș",243,"243-FARCASA",108106,210,2,1667,1266,1174,92,1260,6,"FARCASA",,2,,773,487
25,"Maramureș",243,"243-FARCASA",108106,211,2,1225,1128,1077,51,1120,8,"FARCASA",,2,,637,483
25,"Maramureș",243,"243-GIULESTI",108151,212,2,1589,900,837,63,894,6,"GIULESTI",,2,,580,314
25,"Maramureș",243,"243-GIULESTI",108151,213,2,1301,736,659,77,725,11,"GIULESTI",,2,,504,221
25,"Maramureș",243,"243-GROSI",106363,214,2,973,677,624,53,670,7,"GROSI",,2,,277,393
25,"Maramureș",243,"243-GROSI",106363,215,2,403,193,161,32,190,3,"GROSI",,2,,99,91
25,"Maramureș",243,"243-GROSI",106363,216,2,611,457,433,24,453,4,"GROSI",,2,,211,242
25,"Maramureș",243,"243-IEUD",108204,217,2,3103,1838,1715,123,1829,9,"IEUD",,2,,952,877
25,"Maramureș",243,"243-LAPUS",108222,218,2,1516,1204,1166,38,1199,5,"LAPUS",,2,,849,350
25,"Maramureș",243,"243-LAPUS",108222,219,2,1516,1115,1066,49,1107,8,"LAPUS",,2,,630,477
25,"Maramureș",243,"243-LEORDINA",108240,220,2,1962,1390,1285,105,1382,8,"LEORDINA",,2,,947,435
25,"Maramureș",243,"243-MIRESU MARE",108268,221,2,2086,1420,1232,188,1411,9,"MIRESU MARE",,2,,715,696
25,"Maramureș",243,"243-MIRESU MARE",108268,222,2,828,703,646,57,699,4,"MIRESU MARE",,2,,381,318
25,"Maramureș",243,"243-MIRESU MARE",108268,223,2,847,620,556,64,613,7,"MIRESU MARE",,2,,375,238
25,"Maramureș",243,"243-MOISEI",108348,224,2,2150,1490,1323,167,1482,8,"MOISEI",,2,,1102,380
25,"Maramureș",243,"243-MOISEI",108348,225,2,2065,1548,1355,193,1538,10,"MOISEI",,2,,1112,426
25,"Maramureș",243,"243-MOISEI",108348,226,2,2054,1414,1210,204,1406,8,"MOISEI",,2,,959,447
25,"Maramureș",243,"243-OARTA DE JOS",108366,227,2,502,415,397,18,414,1,"OARTA DE JOS",,2,,314,100
25,"Maramureș",243,"243-OARTA DE JOS",108366,228,2,695,640,572,68,631,9,"OARTA DE JOS",,2,,340,291
25,"Maramureș",243,"243-OCNA SUGATAG",108400,229,2,939,870,598,272,866,4,"OCNA SUGATAG",,2,,276,590
25,"Maramureș",243,"243-OCNA SUGATAG",108400,230,2,949,759,712,47,754,5,"OCNA SUGATAG",,2,,396,358
25,"Maramureș",243,"243-OCNA SUGATAG",108400,231,2,295,252,229,23,250,2,"OCNA SUGATAG",,2,,66,184
25,"Maramureș",243,"243-OCNA SUGATAG",108400,232,2,905,678,617,61,674,4,"OCNA SUGATAG",,2,,418,256
25,"Maramureș",243,"243-PETROVA",108455,233,2,2248,1333,1238,95,1319,14,"PETROVA",,2,,944,375
25,"Maramureș",243,"243-POIENILE IZEI",107500,234,2,865,800,778,22,798,2,"POIENILE IZEI",,2,,632,166
25,"Maramureș",243,"243-POIENILE DE SUB MUNTE",108473,235,2,1984,1370,1230,140,1354,16,"POIENILE DE SUB MUNTE",,2,,828,526
25,"Maramureș",243,"243-POIENILE DE SUB MUNTE",108473,236,2,2063,1241,1176,65,1225,16,"POIENILE DE SUB MUNTE",,2,,901,324
25,"Maramureș",243,"243-POIENILE DE SUB MUNTE",108473,237,2,821,464,425,39,457,7,"POIENILE DE SUB MUNTE",,2,,319,138
25,"Maramureș",243,"243-POIENILE DE SUB MUNTE",108473,238,2,1692,974,876,98,963,11,"POIENILE DE SUB MUNTE",,2,,622,341
25,"Maramureș",243,"243-RECEA",106407,239,2,780,674,594,80,666,6,"RECEA",,2,,384,282
25,"Maramureș",243,"243-RECEA",106407,240,2,296,293,252,41,292,1,"RECEA",,2,,143,149
25,"Maramureș",243,"243-RECEA",106407,241,2,922,894,806,88,891,3,"RECEA",,2,,370,521
25,"Maramureș",243,"243-RECEA",106407,242,2,547,504,455,49,503,1,"RECEA",,2,,265,238
25,"Maramureș",243,"243-RECEA",106407,243,2,1309,1160,1094,66,1157,3,"RECEA",,2,,634,523
25,"Maramureș",243,"243-REMETEA CHIOARULUI",108491,244,2,1417,1029,938,91,1020,9,"REMETEA CHIOARULUI",,2,,519,501
25,"Maramureș",243,"243-REMETEA CHIOARULUI",108491,245,2,324,232,216,16,232,0,"REMETEA CHIOARULUI",,2,,136,96
25,"Maramureș",243,"243-REMETEA CHIOARULUI",108491,246,2,414,232,203,29,231,1,"REMETEA CHIOARULUI",,2,,127,104
25,"Maramureș",243,"243-REMETI",108552,247,2,1791,1250,1203,47,1241,9,"REMETI",,2,,689,552
25,"Maramureș",243,"243-REMETI",108552,248,2,468,299,266,33,296,3,"REMETI",,2,,73,223
25,"Maramureș",243,"243-REPEDEA",108598,249,2,2133,1282,1149,133,1265,17,"REPEDEA",,2,,917,348
25,"Maramureș",243,"243-REPEDEA",108598,250,2,868,543,434,109,533,10,"REPEDEA",,2,,251,282
25,"Maramureș",243,"243-RONA DE JOS",108614,251,2,1786,984,874,110,977,7,"RONA DE JOS",,2,,605,372
25,"Maramureș",243,"243-RONA DE SUS",108632,252,2,3156,1537,1504,33,1524,13,"RONA DE SUS",,2,,1128,396
25,"Maramureș",243,"243-RONA DE SUS",108632,253,2,617,437,404,33,433,4,"RONA DE SUS",,2,,92,341
25,"Maramureș",243,"243-ROZAVLEA",108669,254,2,2699,1796,1694,102,1789,7,"ROZAVLEA",,2,,1468,321
25,"Maramureș",243,"243-ROZAVLEA",108669,255,2,1948,1355,1226,129,1354,1,"ROZAVLEA",,2,,1048,306
25,"Maramureș",243,"243-RUSCOVA",108696,256,2,2568,1435,1324,111,1421,14,"RUSCOVA",,2,,548,873
25,"Maramureș",243,"243-RUSCOVA",108696,257,2,846,525,481,44,522,3,"RUSCOVA",,2,,285,237
25,"Maramureș",243,"243-SARASAU",106620,258,2,1727,1373,1295,78,1365,5,"SARASAU",,2,,497,868
25,"Maramureș",243,"243-SATULUNG",108712,259,2,1098,794,697,97,792,2,"SATULUNG",,2,,458,334
25,"Maramureș",243,"243-SATULUNG",108712,260,2,166,158,115,43,157,1,"SATULUNG",,2,,76,81
25,"Maramureș",243,"243-SATULUNG",108712,261,2,562,475,414,61,475,0,"SATULUNG",,2,,235,240
25,"Maramureș",243,"243-SATULUNG",108712,262,2,482,415,343,72,414,1,"SATULUNG",,2,,191,223
25,"Maramureș",243,"243-SATULUNG",108712,263,2,385,318,268,50,317,1,"SATULUNG",,2,,181,136
25,"Maramureș",243,"243-SATULUNG",108712,264,2,523,402,339,63,398,4,"SATULUNG",,2,,231,167
25,"Maramureș",243,"243-SATULUNG",108712,265,2,507,406,338,68,402,4,"SATULUNG",,2,,241,161
25,"Maramureș",243,"243-SACALASENI",108794,266,2,1639,928,772,156,923,5,"SACALASENI",,2,,488,435
25,"Maramureș",243,"243-SACALASENI",108794,267,2,1036,900,837,63,895,5,"SACALASENI",,2,,390,505
25,"Maramureș",243,"243-SACALASENI",108794,268,2,1297,1300,1197,103,1294,6,"SACALASENI",,2,,23,1271
25,"Maramureș",243,"243-SACALASENI",108794,269,2,55,78,45,33,77,1,"SACALASENI",,2,,62,15
25,"Maramureș",243,"243-SACEL",108874,270,2,1583,1112,1044,68,1102,10,"SACEL",,2,,818,284
25,"Maramureș",243,"243-SACEL",108874,271,2,1340,803,739,64,796,7,"SACEL",,2,,579,217
25,"Maramureș",243,"243-SALISTEA DE SUS",108909,272,2,2309,1631,1543,88,1613,18,"SALISTEA DE SUS",,2,,938,675
25,"Maramureș",243,"243-SALISTEA DE SUS",108909,273,2,1943,1391,1296,95,1377,14,"SALISTEA DE SUS",,2,,929,448
25,"Maramureș",243,"243-SALSIG",108918,274,2,1136,928,807,121,919,9,"SALSIG",,2,,478,441
25,"Maramureș",243,"243-SALSIG",108918,275,2,1069,908,785,123,899,9,"SALSIG",,2,,506,393
25,"Maramureș",243,"243-SAPINTA",108945,276,2,2376,2093,1825,268,2086,7,"SAPINTA",,2,,1118,968
25,"Maramureș",243,"243-STRIMTURA",109005,277,2,1892,1148,1101,47,1141,7,"STRIMTURA",,2,,581,560
25,"Maramureș",243,"243-STRIMTURA",109005,278,2,571,373,351,22,371,2,"STRIMTURA",,2,,182,189
25,"Maramureș",243,"243-STRIMTURA",109005,279,2,534,276,252,24,271,5,"STRIMTURA",,2,,193,78
25,"Maramureș",243,"243-STRIMTURA",109005,280,2,643,352,339,13,351,1,"STRIMTURA",,2,,270,81
25,"Maramureș",243,"243-SUCIU DE SUS",109041,281,2,1378,919,885,34,912,7,"SUCIU DE SUS",,2,,575,337
25,"Maramureș",243,"243-SUCIU DE SUS",109041,282,2,712,494,459,35,493,1,"SUCIU DE SUS",,2,,349,144
25,"Maramureș",243,"243-SUCIU DE SUS",109041,283,2,1281,959,930,29,954,5,"SUCIU DE SUS",,2,,679,275
25,"Maramureș",243,"243-SUCIU DE SUS",109041,284,2,545,396,363,33,395,1,"SUCIU DE SUS",,2,,269,126
25,"Maramureș",243,"243-SUCIU DE SUS",109041,285,2,1075,716,682,34,712,4,"SUCIU DE SUS",,2,,431,281
25,"Maramureș",243,"243-SUCIU DE SUS",109041,286,2,314,215,201,14,215,0,"SUCIU DE SUS",,2,,131,84
25,"Maramureș",243,"243-SISESTI",109096,287,2,1175,930,909,21,925,5,"SISESTI",,2,,342,583
25,"Maramureș",243,"243-SISESTI",109096,288,2,651,490,451,39,487,3,"SISESTI",,2,,186,301
25,"Maramureș",243,"243-SISESTI",109096,289,2,1084,781,756,25,773,8,"SISESTI",,2,,320,453
25,"Maramureș",243,"243-SISESTI",109096,290,2,567,477,456,21,475,2,"SISESTI",,2,,208,267
25,"Maramureș",243,"243-SISESTI",109096,291,2,405,331,327,4,328,3,"SISESTI",,2,,110,218
25,"Maramureș",243,"243-SISESTI",109096,292,2,367,320,314,6,317,3,"SISESTI",,2,,166,151
25,"Maramureș",243,"243-SOMCUTA MARE",109185,293,2,1487,1184,1033,151,1181,3,"SOMCUTA MARE",,2,,517,664
25,"Maramureș",243,"243-SOMCUTA MARE",109185,294,2,1212,935,835,100,932,3,"SOMCUTA MARE",,2,,451,481
25,"Maramureș",243,"243-SOMCUTA MARE",109185,295,2,926,777,760,17,769,8,"SOMCUTA MARE",,2,,550,219
25,"Maramureș",243,"243-SOMCUTA MARE",109185,296,2,798,817,796,21,808,9,"SOMCUTA MARE",,2,,518,290
25,"Maramureș",243,"243-SOMCUTA MARE",109185,297,2,570,515,476,39,515,0,"SOMCUTA MARE",,2,,333,182
25,"Maramureș",243,"243-SOMCUTA MARE",109185,298,2,457,304,287,17,303,1,"SOMCUTA MARE",,2,,175,128
25,"Maramureș",243,"243-SOMCUTA MARE",109185,299,2,316,262,251,11,262,0,"SOMCUTA MARE",,2,,152,110
25,"Maramureș",243,"243-SOMCUTA MARE",109185,300,2,236,212,199,13,208,4,"SOMCUTA MARE",,2,,73,135
25,"Maramureș",243,"243-TAUTII-MAGHERAUS",106470,301,2,1449,1253,1068,185,1244,9,"TAUTII-MAGHERAUS",,2,,482,762
25,"Maramureș",243,"243-TAUTII-MAGHERAUS",106470,302,2,1476,1191,1130,61,1186,5,"TAUTII-MAGHERAUS",,2,,373,813
25,"Maramureș",243,"243-TAUTII-MAGHERAUS",106470,303,2,661,593,502,91,588,5,"TAUTII-MAGHERAUS",,2,,185,403
25,"Maramureș",243,"243-TAUTII-MAGHERAUS",106470,304,2,573,569,505,64,566,3,"TAUTII-MAGHERAUS",,2,,270,296
25,"Maramureș",243,"243-TAUTII-MAGHERAUS",106470,305,2,448,360,331,29,357,3,"TAUTII-MAGHERAUS",,2,,267,90
25,"Maramureș",243,"243-ULMENI",109274,306,2,1898,1334,1227,107,1326,8,"ULMENI",,2,,648,678
25,"Maramureș",243,"243-ULMENI",109274,307,2,1021,681,618,63,675,6,"ULMENI",,2,,129,546
25,"Maramureș",243,"243-ULMENI",109274,308,2,818,640,592,48,639,1,"ULMENI",,2,,368,271
25,"Maramureș",243,"243-ULMENI",109274,309,2,912,668,617,51,661,7,"ULMENI",,2,,207,454
25,"Maramureș",243,"243-ULMENI",109274,310,2,705,585,435,150,582,3,"ULMENI",,2,,296,286
25,"Maramureș",243,"243-VADU IZEI",106648,311,2,1723,1289,1092,197,1281,8,"VADU IZEI",,2,,773,508
25,"Maramureș",243,"243-VADU IZEI",106648,312,2,439,314,289,25,313,1,"VADU IZEI",,2,,204,109
25,"Maramureș",243,"243-VALEA CHIOARULUI",109354,313,2,1261,1049,981,68,1042,7,"VALEA CHIOARULUI",,2,,543,499
25,"Maramureș",243,"243-VALEA CHIOARULUI",109354,314,2,695,696,635,61,692,4,"VALEA CHIOARULUI",,2,,385,307
25,"Maramureș",243,"243-VIMA MICA",109425,315,2,554,409,337,72,406,3,"VIMA MICA",,2,,288,118
25,"Maramureș",243,"243-VIMA MICA",109425,316,2,370,276,195,81,276,0,"VIMA MICA",,2,,143,133
25,"Maramureș",243,"243-VIMA MICA",109425,317,2,472,259,220,39,259,0,"VIMA MICA",,2,,156,103
25,"Maramureș",243,"243-VISEU DE JOS",109504,318,2,1365,907,831,76,902,5,"VISEU DE JOS",,2,,545,357
25,"Maramureș",243,"243-VISEU DE JOS",109504,319,2,1960,1341,1271,70,1338,3,"VISEU DE JOS",,2,,865,473
25,"Maramureș",243,"243-VISEU DE JOS",109504,320,2,1187,757,714,43,750,7,"VISEU DE JOS",,2,,517,233
26,"Mehedinți",252,"252-MUNICIPIUL DROBETA TURNU SEVERIN",109773,1,2,1635,1088,1005,83,1085,3,"MUNICIPIUL DROBETA TURNU SEVERIN",,6,,559,526
26,"Mehedinți",252,"252-MUNICIPIUL DROBETA TURNU SEVERIN",109773,2,2,1416,937,861,76,924,13,"MUNICIPIUL DROBETA TURNU SEVERIN",,6,,438,486
26,"Mehedinți",252,"252-MUNICIPIUL DROBETA TURNU SEVERIN",109773,3,2,1760,1320,1109,211,1315,5,"MUNICIPIUL DROBETA TURNU SEVERIN",,6,,624,691
26,"Mehedinți",252,"252-MUNICIPIUL DROBETA TURNU SEVERIN",109773,4,2,1646,1184,1022,162,1176,8,"MUNICIPIUL DROBETA TURNU SEVERIN",,6,,526,650
26,"Mehedinți",252,"252-MUNICIPIUL DROBETA TURNU SEVERIN",109773,5,2,1545,1139,1004,135,1134,5,"MUNICIPIUL DROBETA TURNU SEVERIN",,6,,461,673
26,"Mehedinți",252,"252-MUNICIPIUL DROBETA TURNU SEVERIN",109773,6,2,1896,1464,1291,173,1459,5,"MUNICIPIUL DROBETA TURNU SEVERIN",,6,,704,755
26,"Mehedinți",252,"252-MUNICIPIUL DROBETA TURNU SEVERIN",109773,7,2,1965,1404,1210,194,1398,6,"MUNICIPIUL DROBETA TURNU SEVERIN",,6,,646,752
26,"Mehedinți",252,"252-MUNICIPIUL DROBETA TURNU SEVERIN",109773,8,2,1716,1278,1188,90,1274,4,"MUNICIPIUL DROBETA TURNU SEVERIN",,6,,635,639
26,"Mehedinți",252,"252-MUNICIPIUL DROBETA TURNU SEVERIN",109773,9,2,1677,1276,1071,205,1268,6,"MUNICIPIUL DROBETA TURNU SEVERIN",,6,,587,681
26,"Mehedinți",252,"252-MUNICIPIUL DROBETA TURNU SEVERIN",109773,10,2,2207,1358,1214,144,1352,6,"MUNICIPIUL DROBETA TURNU SEVERIN",,6,,603,749
26,"Mehedinți",252,"252-MUNICIPIUL DROBETA TURNU SEVERIN",109773,11,2,2010,1402,1225,177,1392,10,"MUNICIPIUL DROBETA TURNU SEVERIN",,6,,681,711
26,"Mehedinți",252,"252-MUNICIPIUL DROBETA TURNU SEVERIN",109773,12,2,2083,1301,1224,77,1294,7,"MUNICIPIUL DROBETA TURNU SEVERIN",,6,,697,597
26,"Mehedinți",252,"252-MUNICIPIUL DROBETA TURNU SEVERIN",109773,13,2,2177,1417,1249,168,1407,10,"MUNICIPIUL DROBETA TURNU SEVERIN",,6,,633,774
26,"Mehedinți",252,"252-MUNICIPIUL DROBETA TURNU SEVERIN",109773,14,2,1700,1064,1000,64,1056,8,"MUNICIPIUL DROBETA TURNU SEVERIN",,6,,519,537
26,"Mehedinți",252,"252-MUNICIPIUL DROBETA TURNU SEVERIN",109773,15,2,1950,1472,1289,183,1463,9,"MUNICIPIUL DROBETA TURNU SEVERIN",,6,,765,698
26,"Mehedinți",252,"252-MUNICIPIUL DROBETA TURNU SEVERIN",109773,16,2,1926,1199,1093,106,1192,7,"MUNICIPIUL DROBETA TURNU SEVERIN",,6,,586,606
26,"Mehedinți",252,"252-MUNICIPIUL DROBETA TURNU SEVERIN",109773,17,2,1818,1364,966,398,1358,6,"MUNICIPIUL DROBETA TURNU SEVERIN",,6,,612,746
26,"Mehedinți",252,"252-MUNICIPIUL DROBETA TURNU SEVERIN",109773,18,2,1794,1192,1090,102,1189,3,"MUNICIPIUL DROBETA TURNU SEVERIN",,6,,548,641
26,"Mehedinți",252,"252-MUNICIPIUL DROBETA TURNU SEVERIN",109773,19,2,1323,889,706,183,886,3,"MUNICIPIUL DROBETA TURNU SEVERIN",,6,,403,483
26,"Mehedinți",252,"252-MUNICIPIUL DROBETA TURNU SEVERIN",109773,20,2,1828,1017,866,151,1016,1,"MUNICIPIUL DROBETA TURNU SEVERIN",,6,,445,571
26,"Mehedinți",252,"252-MUNICIPIUL DROBETA TURNU SEVERIN",109773,21,2,1515,1041,785,256,1037,4,"MUNICIPIUL DROBETA TURNU SEVERIN",,6,,507,530
26,"Mehedinți",252,"252-MUNICIPIUL DROBETA TURNU SEVERIN",109773,22,2,1780,1053,992,61,1049,4,"MUNICIPIUL DROBETA TURNU SEVERIN",,6,,528,521
26,"Mehedinți",252,"252-MUNICIPIUL DROBETA TURNU SEVERIN",109773,23,2,1915,1190,1096,94,1184,6,"MUNICIPIUL DROBETA TURNU SEVERIN",,6,,518,666
26,"Mehedinți",252,"252-MUNICIPIUL DROBETA TURNU SEVERIN",109773,24,2,1679,1095,971,124,1092,3,"MUNICIPIUL DROBETA TURNU SEVERIN",,6,,534,558
26,"Mehedinți",252,"252-MUNICIPIUL DROBETA TURNU SEVERIN",109773,25,2,1185,830,737,93,826,4,"MUNICIPIUL DROBETA TURNU SEVERIN",,6,,371,455
26,"Mehedinți",252,"252-MUNICIPIUL DROBETA TURNU SEVERIN",109773,26,2,1179,1007,913,94,1005,2,"MUNICIPIUL DROBETA TURNU SEVERIN",,6,,557,448
26,"Mehedinți",252,"252-MUNICIPIUL DROBETA TURNU SEVERIN",109773,27,2,1728,1005,915,90,999,6,"MUNICIPIUL DROBETA TURNU SEVERIN",,6,,516,483
26,"Mehedinți",252,"252-MUNICIPIUL DROBETA TURNU SEVERIN",109773,28,2,1930,1150,1064,86,1145,5,"MUNICIPIUL DROBETA TURNU SEVERIN",,6,,579,566
26,"Mehedinți",252,"252-MUNICIPIUL DROBETA TURNU SEVERIN",109773,29,2,1654,1092,1005,87,1088,4,"MUNICIPIUL DROBETA TURNU SEVERIN",,6,,560,528
26,"Mehedinți",252,"252-MUNICIPIUL DROBETA TURNU SEVERIN",109773,30,2,1865,1210,1144,66,1206,4,"MUNICIPIUL DROBETA TURNU SEVERIN",,6,,600,606
26,"Mehedinți",252,"252-MUNICIPIUL DROBETA TURNU SEVERIN",109773,31,2,1881,1200,1090,110,1200,0,"MUNICIPIUL DROBETA TURNU SEVERIN",,6,,666,534
26,"Mehedinți",252,"252-MUNICIPIUL DROBETA TURNU SEVERIN",109773,32,2,1994,1225,1079,146,1224,1,"MUNICIPIUL DROBETA TURNU SEVERIN",,6,,579,645
26,"Mehedinți",252,"252-MUNICIPIUL DROBETA TURNU SEVERIN",109773,33,2,1479,1421,842,579,1415,6,"MUNICIPIUL DROBETA TURNU SEVERIN",,6,,716,699
26,"Mehedinți",252,"252-MUNICIPIUL DROBETA TURNU SEVERIN",109773,34,2,1142,741,577,164,738,3,"MUNICIPIUL DROBETA TURNU SEVERIN",,6,,332,406
26,"Mehedinți",252,"252-MUNICIPIUL DROBETA TURNU SEVERIN",109773,35,2,1441,861,781,80,858,3,"MUNICIPIUL DROBETA TURNU SEVERIN",,6,,425,433
26,"Mehedinți",252,"252-MUNICIPIUL DROBETA TURNU SEVERIN",109773,36,2,1558,929,834,95,928,1,"MUNICIPIUL DROBETA TURNU SEVERIN",,6,,468,460
26,"Mehedinți",252,"252-MUNICIPIUL DROBETA TURNU SEVERIN",109773,37,2,1998,1307,1194,113,1305,2,"MUNICIPIUL DROBETA TURNU SEVERIN",,6,,655,650
26,"Mehedinți",252,"252-MUNICIPIUL DROBETA TURNU SEVERIN",109773,38,2,1987,1389,1248,141,1384,5,"MUNICIPIUL DROBETA TURNU SEVERIN",,6,,748,636
26,"Mehedinți",252,"252-MUNICIPIUL DROBETA TURNU SEVERIN",109773,39,2,1929,1185,1066,119,1180,5,"MUNICIPIUL DROBETA TURNU SEVERIN",,6,,566,614
26,"Mehedinți",252,"252-MUNICIPIUL DROBETA TURNU SEVERIN",109773,40,2,1589,1022,898,124,1018,4,"MUNICIPIUL DROBETA TURNU SEVERIN",,6,,512,506
26,"Mehedinți",252,"252-MUNICIPIUL DROBETA TURNU SEVERIN",109773,41,2,1933,1367,1269,98,1363,4,"MUNICIPIUL DROBETA TURNU SEVERIN",,6,,648,715
26,"Mehedinți",252,"252-MUNICIPIUL DROBETA TURNU SEVERIN",109773,42,2,2025,1368,1220,148,1361,7,"MUNICIPIUL DROBETA TURNU SEVERIN",,6,,695,666
26,"Mehedinți",252,"252-MUNICIPIUL DROBETA TURNU SEVERIN",109773,43,2,1776,1084,1011,73,1077,7,"MUNICIPIUL DROBETA TURNU SEVERIN",,6,,457,620
26,"Mehedinți",252,"252-MUNICIPIUL DROBETA TURNU SEVERIN",109773,44,2,1997,1406,1144,262,1403,3,"MUNICIPIUL DROBETA TURNU SEVERIN",,6,,720,683
26,"Mehedinți",252,"252-MUNICIPIUL DROBETA TURNU SEVERIN",109773,45,2,1895,1270,1144,126,1263,7,"MUNICIPIUL DROBETA TURNU SEVERIN",,6,,614,649
26,"Mehedinți",252,"252-MUNICIPIUL DROBETA TURNU SEVERIN",109773,46,2,1688,1001,880,121,996,5,"MUNICIPIUL DROBETA TURNU SEVERIN",,6,,509,487
26,"Mehedinți",252,"252-MUNICIPIUL DROBETA TURNU SEVERIN",109773,47,2,1901,1274,1120,154,1267,7,"MUNICIPIUL DROBETA TURNU SEVERIN",,6,,630,637
26,"Mehedinți",252,"252-MUNICIPIUL DROBETA TURNU SEVERIN",109773,48,2,2969,2083,2083,0,2079,4,"MUNICIPIUL DROBETA TURNU SEVERIN",,6,,1003,1076
26,"Mehedinți",252,"252-MUNICIPIUL DROBETA TURNU SEVERIN",109773,49,2,1261,919,828,91,906,13,"MUNICIPIUL DROBETA TURNU SEVERIN",,6,,578,328
26,"Mehedinți",252,"252-MUNICIPIUL DROBETA TURNU SEVERIN",109773,50,2,739,887,464,423,883,4,"MUNICIPIUL DROBETA TURNU SEVERIN",,6,,314,569
26,"Mehedinți",252,"252-MUNICIPIUL DROBETA TURNU SEVERIN",109773,51,2,0,607,0,607,605,2,"MUNICIPIUL DROBETA TURNU SEVERIN",,6,,249,356
26,"Mehedinți",252,"252-ORAS BAIA DE ARAMA",109924,52,2,1447,985,848,137,982,3,"ORAS BAIA DE ARAMA",,6,,611,371
26,"Mehedinți",252,"252-ORAS BAIA DE ARAMA",109924,53,2,913,566,493,73,564,2,"ORAS BAIA DE ARAMA",,6,,356,208
26,"Mehedinți",252,"252-ORAS BAIA DE ARAMA",109924,54,2,659,495,428,67,493,2,"ORAS BAIA DE ARAMA",,6,,374,119
26,"Mehedinți",252,"252-ORAS BAIA DE ARAMA",109924,55,2,1168,706,659,47,702,4,"ORAS BAIA DE ARAMA",,6,,413,289
26,"Mehedinți",252,"252-ORAS ORSOVA",110063,56,2,1607,1168,1085,83,1164,4,"ORAS ORSOVA",,6,,423,741
26,"Mehedinți",252,"252-ORAS ORSOVA",110063,57,2,2586,1575,1437,138,1566,9,"ORAS ORSOVA",,6,,576,990
26,"Mehedinți",252,"252-ORAS ORSOVA",110063,58,2,1163,840,781,59,837,3,"ORAS ORSOVA",,6,,291,546
26,"Mehedinți",252,"252-ORAS ORSOVA",110063,59,2,1110,776,682,94,765,11,"ORAS ORSOVA",,6,,229,536
26,"Mehedinți",252,"252-ORAS ORSOVA",110063,60,2,1937,1340,1166,174,1335,5,"ORAS ORSOVA",,6,,515,820
26,"Mehedinți",252,"252-ORAS ORSOVA",110063,61,2,1606,1095,974,121,1088,7,"ORAS ORSOVA",,6,,444,644
26,"Mehedinți",252,"252-ORAS ORSOVA",110063,62,2,1588,1163,1069,94,1152,11,"ORAS ORSOVA",,6,,454,698
26,"Mehedinți",252,"252-ORAS ORSOVA",110063,63,2,278,220,195,25,220,0,"ORAS ORSOVA",,6,,74,146
26,"Mehedinți",252,"252-ORAS STREHAIA",110116,64,2,1358,956,821,135,950,6,"ORAS STREHAIA",,6,,575,375
26,"Mehedinți",252,"252-ORAS STREHAIA",110116,65,2,1526,988,878,110,983,5,"ORAS STREHAIA",,6,,532,451
26,"Mehedinți",252,"252-ORAS STREHAIA",110116,66,2,1479,1016,848,168,1005,11,"ORAS STREHAIA",,6,,572,433
26,"Mehedinți",252,"252-ORAS STREHAIA",110116,67,2,1297,853,744,109,850,3,"ORAS STREHAIA",,6,,439,411
26,"Mehedinți",252,"252-ORAS STREHAIA",110116,68,2,1077,706,596,110,700,6,"ORAS STREHAIA",,6,,403,297
26,"Mehedinți",252,"252-ORAS STREHAIA",110116,69,2,395,272,222,50,269,3,"ORAS STREHAIA",,6,,160,109
26,"Mehedinți",252,"252-ORAS STREHAIA",110116,70,2,573,378,324,54,374,4,"ORAS STREHAIA",,6,,236,138
26,"Mehedinți",252,"252-ORAS STREHAIA",110116,71,2,919,644,544,100,640,4,"ORAS STREHAIA",,6,,397,243
26,"Mehedinți",252,"252-ORAS STREHAIA",110116,72,2,301,159,128,31,154,5,"ORAS STREHAIA",,6,,108,46
26,"Mehedinți",252,"252-ORAS VANJU MARE",110232,73,2,1356,930,807,123,925,5,"ORAS VANJU MARE",,6,,579,346
26,"Mehedinți",252,"252-ORAS VANJU MARE",110232,74,2,1728,1119,1032,87,1115,4,"ORAS VANJU MARE",,6,,733,382
26,"Mehedinți",252,"252-ORAS VANJU MARE",110232,75,2,285,237,177,60,233,4,"ORAS VANJU MARE",,6,,100,133
26,"Mehedinți",252,"252-ORAS VANJU MARE",110232,76,2,787,547,464,83,540,7,"ORAS VANJU MARE",,6,,358,182
26,"Mehedinți",252,"252-ORAS VANJU MARE",110232,77,2,936,578,466,112,576,2,"ORAS VANJU MARE",,6,,439,137
26,"Mehedinți",252,"252-ORAS VANJU MARE",110232,78,2,493,410,302,108,405,5,"ORAS VANJU MARE",,6,,234,171
26,"Mehedinți",252,"252-BALA",110296,79,2,833,718,464,254,709,9,"BALA",,6,,541,168
26,"Mehedinți",252,"252-BALA",110296,80,2,597,414,324,90,408,6,"BALA",,6,,271,137
26,"Mehedinți",252,"252-BALA",110296,81,2,652,426,346,80,420,6,"BALA",,6,,269,151
26,"Mehedinți",252,"252-BALA",110296,82,2,389,285,193,92,285,0,"BALA",,6,,212,73
26,"Mehedinți",252,"252-BALA",110296,83,2,881,611,477,134,608,3,"BALA",,6,,476,132
26,"Mehedinți",252,"252-BALTA",110456,84,2,534,377,321,56,373,4,"BALTA",,6,,142,231
26,"Mehedinți",252,"252-BALTA",110456,85,2,820,501,401,100,495,6,"BALTA",,6,,315,180
26,"Mehedinți",252,"252-BALACITA",110535,86,2,1318,905,772,133,899,6,"BALACITA",,6,,506,393
26,"Mehedinți",252,"252-BALACITA",110535,87,2,1321,776,630,146,768,8,"BALACITA",,6,,446,322
26,"Mehedinți",252,"252-BALACITA",110535,88,2,523,399,305,94,396,3,"BALACITA",,6,,315,81
26,"Mehedinți",252,"252-BACLES",110571,89,2,728,458,317,141,445,13,"BACLES",,6,,262,183
26,"Mehedinți",252,"252-BACLES",110571,90,2,521,352,290,62,349,3,"BACLES",,6,,197,152
26,"Mehedinți",252,"252-BACLES",110571,91,2,475,440,354,86,435,5,"BACLES",,6,,338,97
26,"Mehedinți",252,"252-BACLES",110571,92,2,668,391,311,80,389,2,"BACLES",,6,,211,178
26,"Mehedinți",252,"252-BALVANESTI",110688,93,2,943,532,424,108,525,7,"BALVANESTI",,6,,329,196
26,"Mehedinți",252,"252-BREZNITA-MOTRU",110740,94,2,1085,825,696,129,822,3,"BREZNITA-MOTRU",,6,,512,310
26,"Mehedinți",252,"252-BREZNITA-MOTRU",110740,95,2,431,260,194,66,254,6,"BREZNITA-MOTRU",,6,,175,79
26,"Mehedinți",252,"252-BREZNITA-OCOL",110820,96,2,1468,863,799,64,854,9,"BREZNITA-OCOL",,6,,357,497
26,"Mehedinți",252,"252-BREZNITA-OCOL",110820,97,2,560,380,298,82,376,4,"BREZNITA-OCOL",,6,,159,217
26,"Mehedinți",252,"252-BREZNITA-OCOL",110820,98,2,957,586,459,127,582,4,"BREZNITA-OCOL",,6,,286,296
26,"Mehedinți",252,"252-BROSTENI",110875,99,2,1048,771,562,209,766,5,"BROSTENI",,6,,480,286
26,"Mehedinți",252,"252-BROSTENI",110875,100,2,1048,636,488,148,630,6,"BROSTENI",,6,,468,162
26,"Mehedinți",252,"252-BURILA MARE",110946,101,2,604,479,365,114,472,7,"BURILA MARE",,6,,312,160
26,"Mehedinți",252,"252-BURILA MARE",110946,102,2,641,527,342,185,521,6,"BURILA MARE",,6,,273,248
26,"Mehedinți",252,"252-BURILA MARE",110946,103,2,548,406,288,118,398,8,"BURILA MARE",,6,,222,176
26,"Mehedinți",252,"252-BURILA MARE",110946,104,2,187,208,120,88,204,4,"BURILA MARE",,6,,129,75
26,"Mehedinți",252,"252-BUTOIESTI",111006,105,2,1258,776,590,186,767,9,"BUTOIESTI",,6,,445,322
26,"Mehedinți",252,"252-BUTOIESTI",111006,106,2,804,442,339,103,434,8,"BUTOIESTI",,6,,229,205
26,"Mehedinți",252,"252-BUTOIESTI",111006,107,2,237,247,189,58,244,3,"BUTOIESTI",,6,,188,56
26,"Mehedinți",252,"252-BUTOIESTI",111006,108,2,301,250,186,64,245,5,"BUTOIESTI",,6,,151,94
26,"Mehedinți",252,"252-CAZANESTI",111097,109,2,944,524,382,142,514,10,"CAZANESTI",,6,,356,158
26,"Mehedinți",252,"252-CAZANESTI",111097,110,2,1126,698,533,165,690,8,"CAZANESTI",,6,,467,223
26,"Mehedinți",252,"252-CIRESU",111220,111,2,655,353,284,69,343,10,"CIRESU",,6,,201,142
26,"Mehedinți",252,"252-CORCOVA",111275,112,2,1459,976,776,200,966,10,"CORCOVA",,6,,694,272
26,"Mehedinți",252,"252-CORCOVA",111275,113,2,809,533,406,127,527,6,"CORCOVA",,6,,428,99
26,"Mehedinți",252,"252-CORCOVA",111275,114,2,1387,890,731,159,878,12,"CORCOVA",,6,,594,284
26,"Mehedinți",252,"252-CORCOVA",111275,115,2,441,319,221,98,314,5,"CORCOVA",,6,,180,134
26,"Mehedinți",252,"252-CORLATEL",111417,116,2,1198,888,703,185,882,6,"CORLATEL",,6,,572,310
26,"Mehedinți",252,"252-CUJMIR",111444,117,2,1024,676,533,143,671,5,"CUJMIR",,6,,358,313
26,"Mehedinți",252,"252-CUJMIR",111444,118,2,1024,638,533,105,636,2,"CUJMIR",,6,,332,304
26,"Mehedinți",252,"252-CUJMIR",111444,119,2,1124,703,586,117,697,6,"CUJMIR",,6,,361,336
26,"Mehedinți",252,"252-DEVESEL",111480,120,2,1013,982,662,320,978,4,"DEVESEL",,6,,596,382
26,"Mehedinți",252,"252-DEVESEL",111480,121,2,488,497,313,184,493,4,"DEVESEL",,6,,264,229
26,"Mehedinți",252,"252-DEVESEL",111480,122,2,496,571,378,193,567,4,"DEVESEL",,6,,448,119
26,"Mehedinți",252,"252-DEVESEL",111480,123,2,593,625,442,183,618,7,"DEVESEL",,6,,399,219
26,"Mehedinți",252,"252-DARVARI",111550,124,2,1470,913,808,105,898,15,"DARVARI",,6,,343,555
26,"Mehedinți",252,"252-DARVARI",111550,125,2,1087,771,673,98,766,5,"DARVARI",,6,,317,449
26,"Mehedinți",252,"252-DUBOVA",112904,126,2,478,368,306,62,363,5,"DUBOVA",,6,,138,225
26,"Mehedinți",252,"252-DUBOVA",112904,127,2,408,362,285,77,358,4,"DUBOVA",,6,,250,108
26,"Mehedinți",252,"252-DUMBRAVA",111587,128,2,553,379,274,105,373,6,"DUMBRAVA",,6,,253,120
26,"Mehedinți",252,"252-DUMBRAVA",111587,129,2,822,610,487,123,607,3,"DUMBRAVA",,6,,407,200
26,"Mehedinți",252,"252-DUMBRAVA",111587,130,2,264,258,154,104,255,3,"DUMBRAVA",,6,,189,66
26,"Mehedinți",252,"252-FLORESTI",111685,131,2,1178,756,640,116,747,9,"FLORESTI",,6,,583,164
26,"Mehedinți",252,"252-FLORESTI",111685,132,2,919,586,498,88,578,8,"FLORESTI",,6,,412,166
26,"Mehedinți",252,"252-GARLA MARE",111783,133,2,1566,859,768,91,852,7,"GARLA MARE",,6,,514,338
26,"Mehedinți",252,"252-GARLA MARE",111783,134,2,1278,759,654,105,746,13,"GARLA MARE",,6,,468,278
26,"Mehedinți",252,"252-GARLA MARE",111783,135,2,1298,1011,766,245,1002,9,"GARLA MARE",,6,,591,411
26,"Mehedinți",252,"252-GODEANU",110045,136,2,582,339,234,105,330,9,"GODEANU",,6,,199,131
26,"Mehedinți",252,"252-GOGOSU",111863,137,2,939,804,652,152,797,7,"GOGOSU",,6,,493,304
26,"Mehedinți",252,"252-GOGOSU",111863,138,2,956,770,646,124,762,8,"GOGOSU",,6,,329,433
26,"Mehedinți",252,"252-GOGOSU",111863,139,2,612,410,337,73,406,4,"GOGOSU",,6,,220,186
26,"Mehedinți",252,"252-GOGOSU",111863,140,2,395,480,264,216,473,7,"GOGOSU",,6,,170,303
26,"Mehedinți",252,"252-GOGOSU",111863,141,2,0,761,0,761,758,3,"GOGOSU",,6,,145,613
26,"Mehedinți",252,"252-GRECI",111916,142,2,721,584,481,103,580,4,"GRECI",,6,,414,166
26,"Mehedinți",252,"252-GRECI",111916,143,2,365,308,246,62,306,2,"GRECI",,6,,147,159
26,"Mehedinți",252,"252-GRECI",111916,144,2,247,232,191,41,232,0,"GRECI",,6,,153,79
26,"Mehedinți",252,"252-GROZESTI",111989,145,2,1099,567,505,62,552,15,"GROZESTI",,6,,381,171
26,"Mehedinți",252,"252-GROZESTI",111989,146,2,567,479,405,74,470,9,"GROZESTI",,6,,320,150
26,"Mehedinți",252,"252-GRUIA",112030,147,2,1400,1027,901,126,1018,9,"GRUIA",,6,,695,323
26,"Mehedinți",252,"252-GRUIA",112030,148,2,1025,723,609,114,720,3,"GRUIA",,6,,404,316
26,"Mehedinți",252,"252-GRUIA",112030,149,2,250,241,206,35,240,1,"GRUIA",,6,,198,42
26,"Mehedinți",252,"252-HINOVA",112076,150,2,777,553,468,85,550,3,"HINOVA",,6,,382,168
26,"Mehedinți",252,"252-HINOVA",112076,151,2,982,703,586,117,694,9,"HINOVA",,6,,289,405
26,"Mehedinți",252,"252-HINOVA",112076,152,2,387,365,294,71,362,3,"HINOVA",,6,,153,209
26,"Mehedinți",252,"252-HUSNICIOARA",112129,153,2,715,441,323,118,435,6,"HUSNICIOARA",,6,,278,157
26,"Mehedinți",252,"252-HUSNICIOARA",112129,154,2,584,349,234,115,344,5,"HUSNICIOARA",,6,,172,172
26,"Mehedinți",252,"252-ESELNITA",112245,155,2,992,774,676,98,769,5,"ESELNITA",,6,,242,527
26,"Mehedinți",252,"252-ESELNITA",112245,156,2,1144,824,763,61,816,8,"ESELNITA",,6,,269,547
26,"Mehedinți",252,"252-ILOVAT",112263,157,2,1312,1072,805,267,1061,11,"ILOVAT",,6,,787,274
26,"Mehedinți",252,"252-ILOVITA",112334,158,2,719,450,388,62,448,2,"ILOVITA",,6,,198,250
26,"Mehedinți",252,"252-ILOVITA",112334,159,2,481,276,227,49,268,8,"ILOVITA",,6,,165,103
26,"Mehedinți",252,"252-ISVERNA",112370,160,2,1457,651,589,62,643,8,"ISVERNA",,6,,346,297
26,"Mehedinți",252,"252-ISVERNA",112370,161,2,632,362,310,52,354,8,"ISVERNA",,6,,252,102
26,"Mehedinți",252,"252-IZVORU BARZII",112469,162,2,986,644,573,71,629,15,"IZVORU BARZII",,6,,327,302
26,"Mehedinți",252,"252-IZVORU BARZII",112469,163,2,501,257,197,60,249,8,"IZVORU BARZII",,6,,155,94
26,"Mehedinți",252,"252-IZVORU BARZII",112469,164,2,628,638,282,356,636,2,"IZVORU BARZII",,6,,293,343
26,"Mehedinți",252,"252-JIANA",112548,165,2,618,465,375,90,457,8,"JIANA",,6,,271,186
26,"Mehedinți",252,"252-JIANA",112548,166,2,1479,1012,874,138,997,15,"JIANA",,6,,610,387
26,"Mehedinți",252,"252-JIANA",112548,167,2,1055,785,686,99,776,9,"JIANA",,6,,456,320
26,"Mehedinți",252,"252-JIANA",112548,168,2,710,572,463,109,566,6,"JIANA",,6,,295,271
26,"Mehedinți",252,"252-LIVEZILE",112600,169,2,935,746,556,190,738,8,"LIVEZILE",,6,,517,221
26,"Mehedinți",252,"252-LIVEZILE",112600,170,2,544,438,332,106,435,0,"LIVEZILE",,6,,258,177
26,"Mehedinți",252,"252-LIVEZILE",112600,171,2,233,209,137,72,201,8,"LIVEZILE",,6,,119,82
26,"Mehedinți",252,"252-MALOVAT",112664,172,2,959,554,423,131,548,6,"MALOVAT",,6,,337,211
26,"Mehedinți",252,"252-MALOVAT",112664,173,2,675,375,290,85,368,7,"MALOVAT",,6,,237,131
26,"Mehedinți",252,"252-MALOVAT",112664,174,2,681,424,342,82,417,7,"MALOVAT",,6,,245,172
26,"Mehedinți",252,"252-OBARSIA DE CAMP",112744,175,2,965,615,520,95,612,3,"OBARSIA DE CAMP",,6,,320,292
26,"Mehedinți",252,"252-OBARSIA DE CAMP",112744,176,2,1076,729,628,101,723,6,"OBARSIA DE CAMP",,6,,496,227
26,"Mehedinți",252,"252-OBARSIA CLOSANI",110027,177,2,825,509,459,50,505,4,"OBARSIA CLOSANI",,6,,236,269
26,"Mehedinți",252,"252-OPRISOR",112771,178,2,1074,772,695,77,766,6,"OPRISOR",,6,,487,279
26,"Mehedinți",252,"252-OPRISOR",112771,179,2,1163,804,703,101,792,12,"OPRISOR",,6,,478,314
26,"Mehedinți",252,"252-OPRISOR",112771,180,2,534,496,372,124,489,7,"OPRISOR",,6,,281,208
26,"Mehedinți",252,"252-PADINA",112806,181,2,306,229,140,89,226,3,"PADINA",,6,,151,75
26,"Mehedinți",252,"252-PADINA",112806,182,2,423,268,211,57,262,6,"PADINA",,6,,145,117
26,"Mehedinți",252,"252-PADINA",112806,183,2,407,297,204,93,294,3,"PADINA",,6,,216,78
26,"Mehedinți",252,"252-PADINA",112806,184,2,717,511,407,104,505,6,"PADINA",,6,,314,191
26,"Mehedinți",252,"252-PATULELE",112879,185,2,1533,1039,918,121,1025,14,"PATULELE",,6,,373,652
26,"Mehedinți",252,"252-PATULELE",112879,186,2,1501,919,846,73,903,16,"PATULELE",,6,,325,578
26,"Mehedinți",252,"252-PATULELE",112879,187,2,535,371,296,75,367,4,"PATULELE",,6,,242,125
26,"Mehedinți",252,"252-PODENI",112959,188,2,999,760,657,103,748,12,"PODENI",,6,,420,328
26,"Mehedinți",252,"252-PONOARELE",112995,189,2,1027,503,429,74,496,7,"PONOARELE",,6,,308,188
26,"Mehedinți",252,"252-PONOARELE",112995,190,2,597,395,341,54,384,11,"PONOARELE",,6,,308,76
26,"Mehedinți",252,"252-PONOARELE",112995,191,2,454,382,301,81,379,3,"PONOARELE",,6,,256,123
26,"Mehedinți",252,"252-POROINA MARE",113153,192,2,731,464,367,97,460,4,"POROINA MARE",,6,,283,177
26,"Mehedinți",252,"252-POROINA MARE",113153,193,2,507,468,351,117,464,4,"POROINA MARE",,6,,355,109
26,"Mehedinți",252,"252-PRISTOL",113206,194,2,1154,977,841,136,970,7,"PRISTOL",,6,,612,358
26,"Mehedinți",252,"252-PRISTOL",113206,195,2,599,491,425,66,487,4,"PRISTOL",,6,,298,189
26,"Mehedinți",252,"252-PRUNISOR",113233,196,2,600,471,335,136,469,2,"PRUNISOR",,6,,276,193
26,"Mehedinți",252,"252-PRUNISOR",113233,197,2,450,325,240,85,321,4,"PRUNISOR",,6,,202,119
26,"Mehedinți",252,"252-PRUNISOR",113233,198,2,502,372,247,125,367,5,"PRUNISOR",,6,,195,172
26,"Mehedinți",252,"252-PRUNISOR",113233,199,2,331,259,178,81,256,3,"PRUNISOR",,6,,161,95
26,"Mehedinți",252,"252-PRUNISOR",113233,200,2,287,299,178,121,297,1,"PRUNISOR",,6,,155,142
26,"Mehedinți",252,"252-PUNGHINA",113395,201,2,1066,732,595,137,722,10,"PUNGHINA",,6,,457,265
26,"Mehedinți",252,"252-PUNGHINA",113395,202,2,559,475,349,126,473,2,"PUNGHINA",,6,,281,192
26,"Mehedinți",252,"252-PUNGHINA",113395,203,2,696,491,419,72,483,8,"PUNGHINA",,6,,361,122
26,"Mehedinți",252,"252-ROGOVA",113466,204,2,1219,944,777,167,935,9,"ROGOVA",,6,,534,401
26,"Mehedinți",252,"252-SALCIA",113493,205,2,1510,884,806,78,880,4,"SALCIA",,6,,431,449
26,"Mehedinți",252,"252-SALCIA",113493,206,2,1642,946,850,96,936,9,"SALCIA",,6,,381,555
26,"Mehedinți",252,"252-STANGACEAUA",113518,207,2,857,514,436,78,508,6,"STANGACEAUA",,6,,302,206
26,"Mehedinți",252,"252-STANGACEAUA",113518,208,2,432,297,228,69,292,5,"STANGACEAUA",,6,,176,116
26,"Mehedinți",252,"252-SVINITA",113607,209,2,994,669,620,49,660,9,"SVINITA",,6,,377,283
26,"Mehedinți",252,"252-SIMIAN",109826,210,2,1345,958,698,260,951,7,"SIMIAN",,6,,437,514
26,"Mehedinți",252,"252-SIMIAN",109826,211,2,1295,938,771,167,936,2,"SIMIAN",,6,,496,440
26,"Mehedinți",252,"252-SIMIAN",109826,212,2,1062,888,727,161,878,10,"SIMIAN",,6,,349,529
26,"Mehedinți",252,"252-SIMIAN",109826,213,2,1160,884,718,166,872,12,"SIMIAN",,6,,450,422
26,"Mehedinți",252,"252-SIMIAN",109826,214,2,582,475,300,175,463,12,"SIMIAN",,6,,199,264
26,"Mehedinți",252,"252-SIMIAN",109826,215,2,650,405,291,114,401,4,"SIMIAN",,6,,255,146
26,"Mehedinți",252,"252-SISESTI",113625,216,2,1117,789,594,195,786,3,"SISESTI",,6,,500,286
26,"Mehedinți",252,"252-SISESTI",113625,217,2,677,600,446,154,591,9,"SISESTI",,6,,446,145
26,"Mehedinți",252,"252-SISESTI",113625,218,2,718,733,644,89,726,7,"SISESTI",,6,,554,172
26,"Mehedinți",252,"252-SOVARNA",113698,219,2,1155,846,709,137,840,6,"SOVARNA",,6,,626,214
26,"Mehedinți",252,"252-TAMNA",113732,220,2,972,512,358,154,508,4,"TAMNA",,6,,269,239
26,"Mehedinți",252,"252-TAMNA",113732,221,2,679,461,329,132,456,5,"TAMNA",,6,,323,133
26,"Mehedinți",252,"252-TAMNA",113732,222,2,393,301,214,87,291,10,"TAMNA",,6,,204,87
26,"Mehedinți",252,"252-TAMNA",113732,223,2,559,411,307,104,409,2,"TAMNA",,6,,286,123
26,"Mehedinți",252,"252-VANATORI",113849,224,2,1079,758,655,103,753,5,"VANATORI",,6,,424,329
26,"Mehedinți",252,"252-VANATORI",113849,225,2,942,681,605,76,678,3,"VANATORI",,6,,326,352
26,"Mehedinți",252,"252-VANATORI",113849,226,2,489,395,359,36,393,2,"VANATORI",,6,,213,180
26,"Mehedinți",252,"252-VANATORI",113849,227,2,1341,978,907,71,971,7,"VANATORI",,6,,198,773
26,"Mehedinți",252,"252-VANJULET",113894,228,2,1364,967,698,269,954,13,"VANJULET",,6,,494,460
26,"Mehedinți",252,"252-VLADAIA",113929,229,2,1045,764,646,118,756,8,"VLADAIA",,6,,606,150
26,"Mehedinți",252,"252-VLADAIA",113929,230,2,652,446,373,73,442,4,"VLADAIA",,6,,300,142
26,"Mehedinți",252,"252-VLADAIA",113929,231,2,325,238,197,41,235,3,"VLADAIA",,6,,124,111
26,"Mehedinți",252,"252-VOLOIAC",113974,232,2,1031,709,573,136,702,7,"VOLOIAC",,6,,445,257
26,"Mehedinți",252,"252-VOLOIAC",113974,233,2,501,344,260,84,338,6,"VOLOIAC",,6,,209,129
26,"Mehedinți",252,"252-MUNICIPIUL DROBETA TURNU SEVERIN",109773,234,2,173,195,171,24,193,2,"MUNICIPIUL DROBETA TURNU SEVERIN",,6,,109,84
26,"Mehedinți",252,"252-MUNICIPIUL DROBETA TURNU SEVERIN",109773,235,2,0,777,0,777,773,4,"MUNICIPIUL DROBETA TURNU SEVERIN",,6,,433,340
26,"Mehedinți",252,"252-MUNICIPIUL DROBETA TURNU SEVERIN",109773,236,2,279,290,276,14,289,1,"MUNICIPIUL DROBETA TURNU SEVERIN",,6,,148,141
26,"Mehedinți",252,"252-MUNICIPIUL DROBETA TURNU SEVERIN",109773,237,2,136,139,129,10,138,0,"MUNICIPIUL DROBETA TURNU SEVERIN",,6,,18,120
26,"Mehedinți",252,"252-ORAS ORSOVA",110063,238,2,87,124,85,39,122,2,"ORAS ORSOVA",,6,,57,65
26,"Mehedinți",252,"252-ORAS VANJU MARE",110232,239,2,0,372,0,372,367,5,"ORAS VANJU MARE",,6,,193,174
27,"Mureș",261,"261-MUNICIPIUL TARGU MURES",114319,1,2,1931,1530,1368,162,1524,6,"MUNICIPIUL TARGU MURES",,7,,346,1178
27,"Mureș",261,"261-MUNICIPIUL TARGU MURES",114319,2,2,1844,1430,1323,107,1428,2,"MUNICIPIUL TARGU MURES",,7,,288,1140
27,"Mureș",261,"261-MUNICIPIUL TARGU MURES",114319,3,2,1906,1489,1340,149,1481,8,"MUNICIPIUL TARGU MURES",,7,,284,1197
27,"Mureș",261,"261-MUNICIPIUL TARGU MURES",114319,4,2,1909,1506,1340,166,1503,3,"MUNICIPIUL TARGU MURES",,7,,345,1158
27,"Mureș",261,"261-MUNICIPIUL TARGU MURES",114319,5,2,1848,1419,1331,88,1412,7,"MUNICIPIUL TARGU MURES",,7,,301,1111
27,"Mureș",261,"261-MUNICIPIUL TARGU MURES",114319,6,2,1094,772,666,106,769,3,"MUNICIPIUL TARGU MURES",,7,,228,541
27,"Mureș",261,"261-MUNICIPIUL TARGU MURES",114319,7,2,1231,942,864,78,939,3,"MUNICIPIUL TARGU MURES",,7,,260,679
27,"Mureș",261,"261-MUNICIPIUL TARGU MURES",114319,8,2,1977,1520,1393,127,1512,8,"MUNICIPIUL TARGU MURES",,7,,245,1267
27,"Mureș",261,"261-MUNICIPIUL TARGU MURES",114319,9,2,1817,1209,1087,122,1202,7,"MUNICIPIUL TARGU MURES",,7,,267,935
27,"Mureș",261,"261-MUNICIPIUL TARGU MURES",114319,10,2,1921,1514,1392,122,1511,3,"MUNICIPIUL TARGU MURES",,7,,237,1274
27,"Mureș",261,"261-MUNICIPIUL TARGU MURES",114319,11,2,1573,1270,1175,95,1263,6,"MUNICIPIUL TARGU MURES",,7,,232,1031
27,"Mureș",261,"261-MUNICIPIUL TARGU MURES",114319,12,2,1672,1293,1194,99,1289,4,"MUNICIPIUL TARGU MURES",,7,,299,990
27,"Mureș",261,"261-MUNICIPIUL TARGU MURES",114319,13,2,1529,1263,1169,94,1260,3,"MUNICIPIUL TARGU MURES",,7,,386,874
27,"Mureș",261,"261-MUNICIPIUL TARGU MURES",114319,14,2,1657,1365,1260,105,1362,3,"MUNICIPIUL TARGU MURES",,7,,431,931
27,"Mureș",261,"261-MUNICIPIUL TARGU MURES",114319,15,2,1816,1359,1205,154,1351,8,"MUNICIPIUL TARGU MURES",,7,,352,999
27,"Mureș",261,"261-MUNICIPIUL TARGU MURES",114319,16,2,1577,1312,1129,183,1299,13,"MUNICIPIUL TARGU MURES",,7,,245,1054
27,"Mureș",261,"261-MUNICIPIUL TARGU MURES",114319,17,2,1905,1441,1390,51,1435,6,"MUNICIPIUL TARGU MURES",,7,,468,967
27,"Mureș",261,"261-MUNICIPIUL TARGU MURES",114319,18,2,1549,1225,1108,117,1222,3,"MUNICIPIUL TARGU MURES",,7,,306,916
27,"Mureș",261,"261-MUNICIPIUL TARGU MURES",114319,19,2,1540,1225,1157,68,1220,5,"MUNICIPIUL TARGU MURES",,7,,252,968
27,"Mureș",261,"261-MUNICIPIUL TARGU MURES",114319,20,2,1756,1347,1196,151,1339,8,"MUNICIPIUL TARGU MURES",,7,,204,1135
27,"Mureș",261,"261-MUNICIPIUL TARGU MURES",114319,21,2,1910,1483,1406,77,1474,9,"MUNICIPIUL TARGU MURES",,7,,338,1136
27,"Mureș",261,"261-MUNICIPIUL TARGU MURES",114319,22,2,1437,1208,1090,118,1203,5,"MUNICIPIUL TARGU MURES",,7,,267,936
27,"Mureș",261,"261-MUNICIPIUL TARGU MURES",114319,23,2,1155,1264,865,399,1261,3,"MUNICIPIUL TARGU MURES",,7,,289,972
27,"Mureș",261,"261-MUNICIPIUL TARGU MURES",114319,24,2,1883,1486,1377,109,1475,11,"MUNICIPIUL TARGU MURES",,7,,327,1148
27,"Mureș",261,"261-MUNICIPIUL TARGU MURES",114319,25,2,1164,1139,813,326,1131,8,"MUNICIPIUL TARGU MURES",,7,,262,869
27,"Mureș",261,"261-MUNICIPIUL TARGU MURES",114319,26,2,1524,1139,1078,61,1130,9,"MUNICIPIUL TARGU MURES",,7,,231,899
27,"Mureș",261,"261-MUNICIPIUL TARGU MURES",114319,27,2,1938,1612,1353,259,1610,2,"MUNICIPIUL TARGU MURES",,7,,389,1221
27,"Mureș",261,"261-MUNICIPIUL TARGU MURES",114319,28,2,1264,1327,985,342,1325,2,"MUNICIPIUL TARGU MURES",,7,,228,1097
27,"Mureș",261,"261-MUNICIPIUL TARGU MURES",114319,29,2,1868,1467,1344,123,1463,4,"MUNICIPIUL TARGU MURES",,7,,304,1159
27,"Mureș",261,"261-MUNICIPIUL TARGU MURES",114319,30,2,1797,1337,1269,68,1333,4,"MUNICIPIUL TARGU MURES",,7,,392,941
27,"Mureș",261,"261-MUNICIPIUL TARGU MURES",114319,31,2,1898,1401,1303,98,1396,5,"MUNICIPIUL TARGU MURES",,7,,401,995
27,"Mureș",261,"261-MUNICIPIUL TARGU MURES",114319,32,2,1919,1503,1426,77,1500,3,"MUNICIPIUL TARGU MURES",,7,,466,1034
27,"Mureș",261,"261-MUNICIPIUL TARGU MURES",114319,33,2,1959,1509,1458,51,1506,3,"MUNICIPIUL TARGU MURES",,7,,504,1002
27,"Mureș",261,"261-MUNICIPIUL TARGU MURES",114319,34,2,1998,1465,1404,61,1460,5,"MUNICIPIUL TARGU MURES",,7,,437,1023
27,"Mureș",261,"261-MUNICIPIUL TARGU MURES",114319,35,2,1906,1398,1339,59,1393,5,"MUNICIPIUL TARGU MURES",,7,,412,981
27,"Mureș",261,"261-MUNICIPIUL TARGU MURES",114319,36,2,1922,1446,1400,46,1440,6,"MUNICIPIUL TARGU MURES",,7,,457,983
27,"Mureș",261,"261-MUNICIPIUL TARGU MURES",114319,37,2,1696,1349,1277,72,1345,4,"MUNICIPIUL TARGU MURES",,7,,396,949
27,"Mureș",261,"261-MUNICIPIUL TARGU MURES",114319,38,2,1950,1524,1459,65,1522,2,"MUNICIPIUL TARGU MURES",,7,,462,1060
27,"Mureș",261,"261-MUNICIPIUL TARGU MURES",114319,39,2,1550,1208,1114,94,1202,6,"MUNICIPIUL TARGU MURES",,7,,350,852
27,"Mureș",261,"261-MUNICIPIUL TARGU MURES",114319,40,2,1679,1297,1226,71,1296,1,"MUNICIPIUL TARGU MURES",,7,,405,891
27,"Mureș",261,"261-MUNICIPIUL TARGU MURES",114319,41,2,1837,1387,1279,108,1387,0,"MUNICIPIUL TARGU MURES",,7,,475,912
27,"Mureș",261,"261-MUNICIPIUL TARGU MURES",114319,42,2,1785,1389,1330,59,1388,1,"MUNICIPIUL TARGU MURES",,7,,498,890
27,"Mureș",261,"261-MUNICIPIUL TARGU MURES",114319,43,2,1935,1458,1393,65,1451,7,"MUNICIPIUL TARGU MURES",,7,,451,1000
27,"Mureș",261,"261-MUNICIPIUL TARGU MURES",114319,44,2,1559,1240,1175,65,1234,6,"MUNICIPIUL TARGU MURES",,7,,407,827
27,"Mureș",261,"261-MUNICIPIUL TARGU MURES",114319,45,2,1860,1455,1375,80,1453,2,"MUNICIPIUL TARGU MURES",,7,,470,983
27,"Mureș",261,"261-MUNICIPIUL TARGU MURES",114319,46,2,1754,1350,1257,93,1348,2,"MUNICIPIUL TARGU MURES",,7,,267,1081
27,"Mureș",261,"261-MUNICIPIUL TARGU MURES",114319,47,2,1617,1259,1184,75,1258,1,"MUNICIPIUL TARGU MURES",,7,,222,1036
27,"Mureș",261,"261-MUNICIPIUL TARGU MURES",114319,48,2,1720,1304,1219,85,1296,8,"MUNICIPIUL TARGU MURES",,7,,316,980
27,"Mureș",261,"261-MUNICIPIUL TARGU MURES",114319,49,2,1954,1460,1350,110,1453,7,"MUNICIPIUL TARGU MURES",,7,,407,1046
27,"Mureș",261,"261-MUNICIPIUL TARGU MURES",114319,50,2,1457,1155,1081,74,1152,3,"MUNICIPIUL TARGU MURES",,7,,327,825
27,"Mureș",261,"261-MUNICIPIUL TARGU MURES",114319,51,2,1870,1516,1346,170,1503,13,"MUNICIPIUL TARGU MURES",,7,,240,1263
27,"Mureș",261,"261-MUNICIPIUL TARGU MURES",114319,52,2,1933,1487,1406,81,1483,4,"MUNICIPIUL TARGU MURES",,7,,477,1006
27,"Mureș",261,"261-MUNICIPIUL TARGU MURES",114319,53,2,1985,1525,1455,70,1523,2,"MUNICIPIUL TARGU MURES",,7,,361,1162
27,"Mureș",261,"261-MUNICIPIUL TARGU MURES",114319,54,2,1646,1301,1194,107,1299,2,"MUNICIPIUL TARGU MURES",,7,,251,1048
27,"Mureș",261,"261-MUNICIPIUL TARGU MURES",114319,55,2,1950,1472,1370,102,1465,7,"MUNICIPIUL TARGU MURES",,7,,361,1104
27,"Mureș",261,"261-MUNICIPIUL TARGU MURES",114319,56,2,1944,1475,1405,70,1471,4,"MUNICIPIUL TARGU MURES",,7,,306,1165
27,"Mureș",261,"261-MUNICIPIUL TARGU MURES",114319,57,2,1886,1479,1394,85,1476,3,"MUNICIPIUL TARGU MURES",,7,,437,1039
27,"Mureș",261,"261-MUNICIPIUL TARGU MURES",114319,58,2,1943,1497,1409,88,1492,5,"MUNICIPIUL TARGU MURES",,7,,353,1139
27,"Mureș",261,"261-MUNICIPIUL TARGU MURES",114319,59,2,1958,1530,1461,69,1527,3,"MUNICIPIUL TARGU MURES",,7,,359,1168
27,"Mureș",261,"261-MUNICIPIUL TARGU MURES",114319,60,2,1776,1422,1352,70,1422,0,"MUNICIPIUL TARGU MURES",,7,,324,1098
27,"Mureș",261,"261-MUNICIPIUL TARGU MURES",114319,61,2,1607,1224,1174,50,1217,7,"MUNICIPIUL TARGU MURES",,7,,341,876
27,"Mureș",261,"261-MUNICIPIUL TARGU MURES",114319,62,2,1598,1252,1169,83,1247,5,"MUNICIPIUL TARGU MURES",,7,,316,931
27,"Mureș",261,"261-MUNICIPIUL TARGU MURES",114319,63,2,1649,1331,1238,93,1327,4,"MUNICIPIUL TARGU MURES",,7,,367,960
27,"Mureș",261,"261-MUNICIPIUL TARGU MURES",114319,64,2,1704,1324,1277,47,1320,4,"MUNICIPIUL TARGU MURES",,7,,290,1030
27,"Mureș",261,"261-MUNICIPIUL TARGU MURES",114319,65,2,1963,1444,1372,72,1440,4,"MUNICIPIUL TARGU MURES",,7,,411,1029
27,"Mureș",261,"261-MUNICIPIUL TARGU MURES",114319,66,2,1843,1331,1210,121,1328,3,"MUNICIPIUL TARGU MURES",,7,,271,1057
27,"Mureș",261,"261-MUNICIPIUL TARGU MURES",114319,67,2,1743,1283,1242,41,1278,5,"MUNICIPIUL TARGU MURES",,7,,304,974
27,"Mureș",261,"261-MUNICIPIUL TARGU MURES",114319,68,2,1706,1268,1172,96,1264,4,"MUNICIPIUL TARGU MURES",,7,,347,917
27,"Mureș",261,"261-MUNICIPIUL TARGU MURES",114319,69,2,1760,1330,1241,89,1328,2,"MUNICIPIUL TARGU MURES",,7,,226,1102
27,"Mureș",261,"261-MUNICIPIUL TARGU MURES",114319,70,2,1726,1163,1093,70,1158,5,"MUNICIPIUL TARGU MURES",,7,,344,814
27,"Mureș",261,"261-MUNICIPIUL TARGU MURES",114319,71,2,1541,1285,1009,276,1284,1,"MUNICIPIUL TARGU MURES",,7,,400,884
27,"Mureș",261,"261-MUNICIPIUL TARGU MURES",114319,72,2,2002,1416,1280,136,1405,11,"MUNICIPIUL TARGU MURES",,7,,329,1076
27,"Mureș",261,"261-MUNICIPIUL TARGU MURES",114319,73,2,1627,1183,1055,128,1178,5,"MUNICIPIUL TARGU MURES",,7,,303,875
27,"Mureș",261,"261-MUNICIPIUL TARGU MURES",114319,74,2,1466,1169,952,217,1166,3,"MUNICIPIUL TARGU MURES",,7,,381,785
27,"Mureș",261,"261-MUNICIPIUL TARGU MURES",114319,75,2,0,223,0,223,220,3,"MUNICIPIUL TARGU MURES",,7,,94,126
27,"Mureș",261,"261-MUNICIPIUL TARGU MURES",114319,76,2,0,549,0,549,540,9,"MUNICIPIUL TARGU MURES",,7,,294,246
27,"Mureș",261,"261-MUNICIPIUL TARGU MURES",114319,77,2,0,632,0,632,625,7,"MUNICIPIUL TARGU MURES",,7,,203,422
27,"Mureș",261,"261-MUNICIPIUL TARGU MURES",114319,78,2,319,322,300,22,316,6,"MUNICIPIUL TARGU MURES",,7,,148,168
27,"Mureș",261,"261-MUNICIPIUL TARGU MURES",114319,79,2,0,177,0,177,175,2,"MUNICIPIUL TARGU MURES",,7,,55,120
27,"Mureș",261,"261-MUNICIPIUL TARGU MURES",114319,80,2,0,1118,0,1118,1106,12,"MUNICIPIUL TARGU MURES",,7,,356,750
27,"Mureș",261,"261-MUNICIPIUL TARGU MURES",114319,81,2,0,510,0,510,508,2,"MUNICIPIUL TARGU MURES",,7,,162,346
27,"Mureș",261,"261-MUNICIPIUL TARGU MURES",114319,82,2,0,724,0,724,720,4,"MUNICIPIUL TARGU MURES",,7,,189,531
27,"Mureș",261,"261-MUNICIPIUL REGHIN",114809,83,2,2334,1786,1710,76,1781,5,"MUNICIPIUL REGHIN",,7,,612,1169
27,"Mureș",261,"261-MUNICIPIUL REGHIN",114809,84,2,1031,956,748,208,952,4,"MUNICIPIUL REGHIN",,7,,337,615
27,"Mureș",261,"261-MUNICIPIUL REGHIN",114809,85,2,1891,1564,1342,222,1560,4,"MUNICIPIUL REGHIN",,7,,471,1089
27,"Mureș",261,"261-MUNICIPIUL REGHIN",114809,86,2,1149,944,885,59,942,2,"MUNICIPIUL REGHIN",,7,,335,607
27,"Mureș",261,"261-MUNICIPIUL REGHIN",114809,87,2,1951,1545,1500,45,1541,4,"MUNICIPIUL REGHIN",,7,,510,1031
27,"Mureș",261,"261-MUNICIPIUL REGHIN",114809,88,2,1478,1124,1049,75,1116,8,"MUNICIPIUL REGHIN",,7,,354,762
27,"Mureș",261,"261-MUNICIPIUL REGHIN",114809,89,2,2264,1701,1603,98,1697,4,"MUNICIPIUL REGHIN",,7,,592,1105
27,"Mureș",261,"261-MUNICIPIUL REGHIN",114809,90,2,1346,1053,975,78,1046,7,"MUNICIPIUL REGHIN",,7,,301,745
27,"Mureș",261,"261-MUNICIPIUL REGHIN",114809,91,2,1662,1428,1170,258,1419,9,"MUNICIPIUL REGHIN",,7,,477,942
27,"Mureș",261,"261-MUNICIPIUL REGHIN",114809,92,2,1281,969,911,58,964,5,"MUNICIPIUL REGHIN",,7,,291,673
27,"Mureș",261,"261-MUNICIPIUL REGHIN",114809,93,2,1702,1446,1280,166,1411,35,"MUNICIPIUL REGHIN",,7,,406,1005
27,"Mureș",261,"261-MUNICIPIUL REGHIN",114809,94,2,2400,1745,1520,225,1741,4,"MUNICIPIUL REGHIN",,7,,618,1123
27,"Mureș",261,"261-MUNICIPIUL REGHIN",114809,95,2,1852,1354,1226,128,1350,4,"MUNICIPIUL REGHIN",,7,,389,961
27,"Mureș",261,"261-MUNICIPIUL REGHIN",114809,96,2,1872,1383,1240,143,1375,8,"MUNICIPIUL REGHIN",,7,,455,920
27,"Mureș",261,"261-MUNICIPIUL REGHIN",114809,97,2,2083,1682,1550,132,1672,10,"MUNICIPIUL REGHIN",,7,,601,1071
27,"Mureș",261,"261-MUNICIPIUL REGHIN",114809,98,2,2020,1484,1424,60,1479,5,"MUNICIPIUL REGHIN",,7,,500,979
27,"Mureș",261,"261-MUNICIPIUL REGHIN",114809,99,2,1722,1369,1256,113,1360,9,"MUNICIPIUL REGHIN",,7,,428,932
27,"Mureș",261,"261-MUNICIPIUL REGHIN",114809,100,2,0,56,0,56,56,0,"MUNICIPIUL REGHIN",,7,,32,24
27,"Mureș",261,"261-MUNICIPIUL SIGHISOARA",114514,101,2,1483,1205,1119,86,1198,7,"MUNICIPIUL SIGHISOARA",,7,,382,816
27,"Mureș",261,"261-MUNICIPIUL SIGHISOARA",114514,102,2,2029,1501,1374,127,1492,9,"MUNICIPIUL SIGHISOARA",,7,,387,1105
27,"Mureș",261,"261-MUNICIPIUL SIGHISOARA",114514,103,2,1641,1243,1091,152,1238,5,"MUNICIPIUL SIGHISOARA",,7,,266,972
27,"Mureș",261,"261-MUNICIPIUL SIGHISOARA",114514,104,2,508,410,349,61,408,2,"MUNICIPIUL SIGHISOARA",,7,,92,316
27,"Mureș",261,"261-MUNICIPIUL SIGHISOARA",114514,105,2,1773,1339,1212,127,1332,7,"MUNICIPIUL SIGHISOARA",,7,,356,976
27,"Mureș",261,"261-MUNICIPIUL SIGHISOARA",114514,106,2,1306,1011,959,52,1009,2,"MUNICIPIUL SIGHISOARA",,7,,231,778
27,"Mureș",261,"261-MUNICIPIUL SIGHISOARA",114514,107,2,1168,827,762,65,822,5,"MUNICIPIUL SIGHISOARA",,7,,181,641
27,"Mureș",261,"261-MUNICIPIUL SIGHISOARA",114514,108,2,1160,862,822,40,857,5,"MUNICIPIUL SIGHISOARA",,7,,187,670
27,"Mureș",261,"261-MUNICIPIUL SIGHISOARA",114514,109,2,1546,1165,1052,113,1156,9,"MUNICIPIUL SIGHISOARA",,7,,210,946
27,"Mureș",261,"261-MUNICIPIUL SIGHISOARA",114514,110,2,1516,1198,1022,176,1194,4,"MUNICIPIUL SIGHISOARA",,7,,291,903
27,"Mureș",261,"261-MUNICIPIUL SIGHISOARA",114514,111,2,1321,1041,983,58,1038,3,"MUNICIPIUL SIGHISOARA",,7,,168,870
27,"Mureș",261,"261-MUNICIPIUL SIGHISOARA",114514,112,2,1828,1345,1238,107,1341,4,"MUNICIPIUL SIGHISOARA",,7,,190,1151
27,"Mureș",261,"261-MUNICIPIUL SIGHISOARA",114514,113,2,1157,1014,911,103,1010,4,"MUNICIPIUL SIGHISOARA",,7,,112,898
27,"Mureș",261,"261-MUNICIPIUL SIGHISOARA",114514,114,2,1338,1049,855,194,1043,6,"MUNICIPIUL SIGHISOARA",,7,,167,876
27,"Mureș",261,"261-MUNICIPIUL SIGHISOARA",114514,115,2,1092,927,809,118,919,8,"MUNICIPIUL SIGHISOARA",,7,,178,741
27,"Mureș",261,"261-MUNICIPIUL SIGHISOARA",114514,116,2,1047,857,741,116,853,4,"MUNICIPIUL SIGHISOARA",,7,,194,659
27,"Mureș",261,"261-MUNICIPIUL SIGHISOARA",114514,117,2,1914,1493,1329,164,1486,7,"MUNICIPIUL SIGHISOARA",,7,,311,1175
27,"Mureș",261,"261-MUNICIPIUL SIGHISOARA",114514,118,2,1684,1272,1177,95,1269,3,"MUNICIPIUL SIGHISOARA",,7,,387,882
27,"Mureș",261,"261-MUNICIPIUL SIGHISOARA",114514,119,2,1091,935,815,120,926,9,"MUNICIPIUL SIGHISOARA",,7,,261,665
27,"Mureș",261,"261-MUNICIPIUL SIGHISOARA",114514,120,2,1018,787,618,169,782,5,"MUNICIPIUL SIGHISOARA",,7,,194,588
27,"Mureș",261,"261-MUNICIPIUL SIGHISOARA",114514,121,2,632,590,405,185,585,5,"MUNICIPIUL SIGHISOARA",,7,,246,339
27,"Mureș",261,"261-MUNICIPIUL SIGHISOARA",114514,122,2,114,146,114,32,145,1,"MUNICIPIUL SIGHISOARA",,7,,95,50
27,"Mureș",261,"261-MUNICIPIUL SIGHISOARA",114514,123,2,0,128,0,128,128,0,"MUNICIPIUL SIGHISOARA",,7,,26,102
27,"Mureș",261,"261-ORAS IERNUT",117827,124,2,1025,902,738,164,901,1,"ORAS IERNUT",,7,,378,523
27,"Mureș",261,"261-ORAS IERNUT",117827,125,2,1663,1250,1085,165,1247,3,"ORAS IERNUT",,7,,470,777
27,"Mureș",261,"261-ORAS IERNUT",117827,126,2,1886,1458,1314,144,1443,15,"ORAS IERNUT",,7,,732,711
27,"Mureș",261,"261-ORAS IERNUT",117827,127,2,722,591,454,137,586,5,"ORAS IERNUT",,7,,325,261
27,"Mureș",261,"261-ORAS IERNUT",117827,128,2,399,305,258,47,299,6,"ORAS IERNUT",,7,,228,71
27,"Mureș",261,"261-ORAS IERNUT",117827,129,2,653,510,427,83,504,6,"ORAS IERNUT",,7,,347,157
27,"Mureș",261,"261-ORAS IERNUT",117827,130,2,201,128,107,21,128,0,"ORAS IERNUT",,7,,103,25
27,"Mureș",261,"261-ORAS IERNUT",117827,131,2,802,588,544,44,579,9,"ORAS IERNUT",,7,,445,134
27,"Mureș",261,"261-ORAS IERNUT",117827,132,2,247,214,179,35,212,2,"ORAS IERNUT",,7,,94,118
27,"Mureș",261,"261-ORAS LUDUS",114710,133,2,1083,891,798,93,889,2,"ORAS LUDUS",,7,,329,560
27,"Mureș",261,"261-ORAS LUDUS",114710,134,2,817,710,594,116,709,1,"ORAS LUDUS",,7,,279,430
27,"Mureș",261,"261-ORAS LUDUS",114710,135,2,1175,908,819,89,895,13,"ORAS LUDUS",,7,,423,472
27,"Mureș",261,"261-ORAS LUDUS",114710,136,2,1425,1113,1035,78,1112,1,"ORAS LUDUS",,7,,485,627
27,"Mureș",261,"261-ORAS LUDUS",114710,137,2,1571,1197,1108,89,1191,6,"ORAS LUDUS",,7,,527,664
27,"Mureș",261,"261-ORAS LUDUS",114710,138,2,1624,1181,1111,70,1173,8,"ORAS LUDUS",,7,,540,633
27,"Mureș",261,"261-ORAS LUDUS",114710,139,2,1673,1317,1214,103,1312,5,"ORAS LUDUS",,7,,569,743
27,"Mureș",261,"261-ORAS LUDUS",114710,140,2,1710,1298,1205,93,1294,4,"ORAS LUDUS",,7,,600,694
27,"Mureș",261,"261-ORAS LUDUS",114710,141,2,1323,987,968,19,982,5,"ORAS LUDUS",,7,,416,566
27,"Mureș",261,"261-ORAS LUDUS",114710,142,2,1146,968,858,110,955,13,"ORAS LUDUS",,7,,581,374
27,"Mureș",261,"261-ORAS LUDUS",114710,143,2,908,662,626,36,656,6,"ORAS LUDUS",,7,,80,576
27,"Mureș",261,"261-ORAS SOVATA",114854,144,2,912,679,597,82,674,5,"ORAS SOVATA",,7,,52,622
27,"Mureș",261,"261-ORAS SOVATA",114854,145,2,1502,1151,994,157,1149,2,"ORAS SOVATA",,7,,55,1094
27,"Mureș",261,"261-ORAS SOVATA",114854,146,2,1677,1452,1325,127,1449,3,"ORAS SOVATA",,7,,97,1352
27,"Mureș",261,"261-ORAS SOVATA",114854,147,2,1266,1363,788,575,1355,8,"ORAS SOVATA",,7,,257,1098
27,"Mureș",261,"261-ORAS SOVATA",114854,148,2,1160,918,839,79,916,2,"ORAS SOVATA",,7,,31,885
27,"Mureș",261,"261-ORAS SOVATA",114854,149,2,1237,879,780,99,864,15,"ORAS SOVATA",,7,,21,843
27,"Mureș",261,"261-ORAS SOVATA",114854,150,2,287,281,198,83,276,5,"ORAS SOVATA",,7,,27,249
27,"Mureș",261,"261-ORAS SOVATA",114854,151,2,1219,960,870,90,946,14,"ORAS SOVATA",,7,,7,939
27,"Mureș",261,"261-ORAS TARNAVENI",114925,152,2,1513,1422,1138,284,1409,13,"ORAS TARNAVENI",,7,,547,862
27,"Mureș",261,"261-ORAS TARNAVENI",114925,153,2,1211,982,915,67,979,3,"ORAS TARNAVENI",,7,,385,594
27,"Mureș",261,"261-ORAS TARNAVENI",114925,154,2,1289,1000,937,63,994,6,"ORAS TARNAVENI",,7,,414,580
27,"Mureș",261,"261-ORAS TARNAVENI",114925,155,2,1445,1227,1017,210,1219,8,"ORAS TARNAVENI",,7,,526,693
27,"Mureș",261,"261-ORAS TARNAVENI",114925,156,2,1363,1078,993,85,1067,11,"ORAS TARNAVENI",,7,,547,520
27,"Mureș",261,"261-ORAS TARNAVENI",114925,157,2,1509,1199,1064,135,1196,3,"ORAS TARNAVENI",,7,,500,696
27,"Mureș",261,"261-ORAS TARNAVENI",114925,158,2,989,796,724,72,793,3,"ORAS TARNAVENI",,7,,331,462
27,"Mureș",261,"261-ORAS TARNAVENI",114925,159,2,1090,799,721,78,795,4,"ORAS TARNAVENI",,7,,291,504
27,"Mureș",261,"261-ORAS TARNAVENI",114925,160,2,878,611,542,69,606,5,"ORAS TARNAVENI",,7,,287,319
27,"Mureș",261,"261-ORAS TARNAVENI",114925,161,2,1382,1272,1027,245,1267,5,"ORAS TARNAVENI",,7,,530,737
27,"Mureș",261,"261-ORAS TARNAVENI",114925,162,2,1524,1143,1051,92,1136,7,"ORAS TARNAVENI",,7,,452,684
27,"Mureș",261,"261-ORAS TARNAVENI",114925,163,2,1494,1056,947,109,1050,6,"ORAS TARNAVENI",,7,,281,769
27,"Mureș",261,"261-ORAS TARNAVENI",114925,164,2,1364,911,825,86,909,2,"ORAS TARNAVENI",,7,,279,630
27,"Mureș",261,"261-ORAS TARNAVENI",114925,165,2,1150,914,857,57,906,8,"ORAS TARNAVENI",,7,,513,393
27,"Mureș",261,"261-ORAS TARNAVENI",114925,166,2,1306,1006,930,76,1000,6,"ORAS TARNAVENI",,7,,352,648
27,"Mureș",261,"261-ORAS TARNAVENI",114925,167,2,875,701,648,53,699,2,"ORAS TARNAVENI",,7,,262,437
27,"Mureș",261,"261-ORAS TARNAVENI",114925,168,2,294,284,224,60,282,2,"ORAS TARNAVENI",,7,,127,155
27,"Mureș",261,"261-ORAS TARNAVENI",114925,169,2,1097,858,787,71,850,8,"ORAS TARNAVENI",,7,,487,363
27,"Mureș",261,"261-ORAS TARNAVENI",114925,170,2,1189,908,818,90,902,6,"ORAS TARNAVENI",,7,,382,520
27,"Mureș",261,"261-ACATARI",114970,171,2,1420,1156,1061,95,1145,11,"ACATARI",,7,,51,1094
27,"Mureș",261,"261-ACATARI",114970,172,2,284,290,234,56,290,0,"ACATARI",,7,,0,290
27,"Mureș",261,"261-ACATARI",114970,173,2,677,650,614,36,644,6,"ACATARI",,7,,7,637
27,"Mureș",261,"261-ACATARI",114970,174,2,237,254,230,24,253,1,"ACATARI",,7,,3,250
27,"Mureș",261,"261-ACATARI",114970,175,2,889,733,686,47,732,1,"ACATARI",,7,,4,728
27,"Mureș",261,"261-ADAMUS",115076,176,2,1666,1328,1166,162,1312,16,"ADAMUS",,7,,383,929
27,"Mureș",261,"261-ADAMUS",115076,177,2,985,870,783,87,855,15,"ADAMUS",,7,,396,459
27,"Mureș",261,"261-ADAMUS",115076,178,2,1214,858,738,120,853,5,"ADAMUS",,7,,210,643
27,"Mureș",261,"261-ADAMUS",115076,179,2,944,831,737,94,826,5,"ADAMUS",,7,,204,622
27,"Mureș",261,"261-ALBESTI",114603,180,2,1066,987,783,204,981,6,"ALBESTI",,7,,272,709
27,"Mureș",261,"261-ALBESTI",114603,181,2,1365,1113,954,159,1109,4,"ALBESTI",,7,,368,741
27,"Mureș",261,"261-ALBESTI",114603,182,2,1364,1131,941,190,1117,14,"ALBESTI",,7,,395,722
27,"Mureș",261,"261-ALUNIS",115147,183,2,1689,1482,1426,56,1463,19,"ALUNIS",,7,,210,1253
27,"Mureș",261,"261-ALUNIS",115147,184,2,402,387,365,22,380,7,"ALUNIS",,7,,25,355
27,"Mureș",261,"261-ALUNIS",115147,185,2,603,573,528,45,570,3,"ALUNIS",,7,,44,526
27,"Mureș",261,"261-APOLD",115183,186,2,503,409,286,123,408,1,"APOLD",,7,,95,313
27,"Mureș",261,"261-APOLD",115183,187,2,395,356,243,113,354,2,"APOLD",,7,,85,269
27,"Mureș",261,"261-APOLD",115183,188,2,639,589,427,162,580,9,"APOLD",,7,,178,402
27,"Mureș",261,"261-ATINTIS",115236,189,2,621,524,437,87,518,6,"ATINTIS",,7,,317,201
27,"Mureș",261,"261-ATINTIS",115236,190,2,166,137,115,22,136,1,"ATINTIS",,7,,64,72
27,"Mureș",261,"261-ATINTIS",115236,191,2,362,272,233,39,271,1,"ATINTIS",,7,,89,182
27,"Mureș",261,"261-ATINTIS",115236,192,2,177,155,134,21,154,1,"ATINTIS",,7,,7,147
27,"Mureș",261,"261-BAGACIU",115575,193,2,710,655,512,143,650,5,"BAGACIU",,7,,212,438
27,"Mureș",261,"261-BAGACIU",115575,194,2,968,885,820,65,880,5,"BAGACIU",,7,,116,764
27,"Mureș",261,"261-BAHNEA",115307,195,2,1328,1084,917,167,1078,6,"BAHNEA",,7,,257,821
27,"Mureș",261,"261-BAHNEA",115307,196,2,139,164,112,52,163,1,"BAHNEA",,7,,96,67
27,"Mureș",261,"261-BAHNEA",115307,197,2,92,117,44,73,116,1,"BAHNEA",,7,,44,72
27,"Mureș",261,"261-BAHNEA",115307,198,2,203,162,143,19,159,3,"BAHNEA",,7,,40,119
27,"Mureș",261,"261-BAHNEA",115307,199,2,591,451,400,51,448,3,"BAHNEA",,7,,65,383
27,"Mureș",261,"261-BAHNEA",115307,200,2,259,232,188,44,231,1,"BAHNEA",,7,,93,138
27,"Mureș",261,"261-BAHNEA",115307,201,2,250,184,164,20,184,0,"BAHNEA",,7,,106,78
27,"Mureș",261,"261-BALA",115600,202,2,739,559,502,57,552,7,"BALA",,7,,433,119
27,"Mureș",261,"261-BALA",115600,203,2,233,171,149,22,167,4,"BALA",,7,,102,65
27,"Mureș",261,"261-BALAUSERI",115637,204,2,920,750,653,97,746,4,"BALAUSERI",,7,,18,728
27,"Mureș",261,"261-BALAUSERI",115637,205,2,463,425,357,68,415,10,"BALAUSERI",,7,,36,379
27,"Mureș",261,"261-BALAUSERI",115637,206,2,1167,993,981,12,991,2,"BALAUSERI",,7,,17,974
27,"Mureș",261,"261-BALAUSERI",115637,207,2,451,457,390,67,457,0,"BALAUSERI",,7,,2,455
27,"Mureș",261,"261-BALAUSERI",115637,208,2,175,179,139,40,178,1,"BALAUSERI",,7,,42,136
27,"Mureș",261,"261-BALAUSERI",115637,209,2,481,502,442,60,495,7,"BALAUSERI",,7,,121,374
27,"Mureș",261,"261-BAND",115389,210,2,2561,2025,1936,89,1991,34,"BAND",,7,,511,1480
27,"Mureș",261,"261-BAND",115389,211,2,1273,933,833,100,906,27,"BAND",,7,,189,717
27,"Mureș",261,"261-BAND",115389,212,2,146,104,83,21,103,1,"BAND",,7,,69,34
27,"Mureș",261,"261-BAND",115389,213,2,259,281,168,113,276,5,"BAND",,7,,203,73
27,"Mureș",261,"261-BAND",115389,214,2,350,380,317,63,379,1,"BAND",,7,,270,109
27,"Mureș",261,"261-BAND",115389,215,2,353,236,203,33,235,1,"BAND",,7,,201,34
27,"Mureș",261,"261-BAND",115389,216,2,729,548,495,53,545,3,"BAND",,7,,442,103
27,"Mureș",261,"261-BAND",115389,217,2,201,220,166,54,220,0,"BAND",,7,,149,71
27,"Mureș",261,"261-BATOS",115520,218,2,946,828,705,123,822,6,"BATOS",,7,,254,568
27,"Mureș",261,"261-BATOS",115520,219,2,966,822,695,127,813,9,"BATOS",,7,,318,495
27,"Mureș",261,"261-BATOS",115520,220,2,514,492,444,48,490,2,"BATOS",,7,,204,286
27,"Mureș",261,"261-BATOS",115520,221,2,422,421,334,87,418,3,"BATOS",,7,,118,300
27,"Mureș",261,"261-BEICA DE JOS",115708,222,2,1075,948,808,140,938,10,"BEICA DE JOS",,7,,527,411
27,"Mureș",261,"261-BEICA DE JOS",115708,223,2,738,668,572,96,666,2,"BEICA DE JOS",,7,,430,236
27,"Mureș",261,"261-BICHIS",115771,224,2,347,292,257,35,287,5,"BICHIS",,7,,79,208
27,"Mureș",261,"261-BICHIS",115771,225,2,353,323,292,31,313,10,"BICHIS",,7,,25,288
27,"Mureș",261,"261-BICHIS",115771,226,2,167,163,140,23,159,4,"BICHIS",,7,,119,40
27,"Mureș",261,"261-BOGATA",115824,227,2,1471,1108,1000,108,1101,7,"BOGATA",,7,,315,786
27,"Mureș",261,"261-BREAZA",115851,228,2,892,765,692,73,757,8,"BREAZA",,7,,193,564
27,"Mureș",261,"261-BREAZA",115851,229,2,670,539,480,59,528,11,"BREAZA",,7,,271,257
27,"Mureș",261,"261-BREAZA",115851,230,2,399,332,323,9,329,3,"BREAZA",,7,,124,205
27,"Mureș",261,"261-BRANCOVENESTI",115897,231,2,1092,966,868,98,960,6,"BRANCOVENESTI",,7,,79,881
27,"Mureș",261,"261-BRANCOVENESTI",115897,232,2,390,337,289,48,332,5,"BRANCOVENESTI",,7,,232,100
27,"Mureș",261,"261-BRANCOVENESTI",115897,233,2,578,515,476,39,513,2,"BRANCOVENESTI",,7,,316,197
27,"Mureș",261,"261-BRANCOVENESTI",115897,234,2,374,363,311,52,350,13,"BRANCOVENESTI",,7,,245,105
27,"Mureș",261,"261-BRANCOVENESTI",115897,235,2,1075,1022,942,80,1022,0,"BRANCOVENESTI",,7,,74,948
27,"Mureș",261,"261-CEUASU DE CAMPIE",115959,236,2,1902,1517,1387,130,1506,11,"CEUASU DE CAMPIE",,7,,358,1148
27,"Mureș",261,"261-CEUASU DE CAMPIE",115959,237,2,309,279,231,48,278,1,"CEUASU DE CAMPIE",,7,,67,211
27,"Mureș",261,"261-CEUASU DE CAMPIE",115959,238,2,728,609,515,94,604,5,"CEUASU DE CAMPIE",,7,,123,481
27,"Mureș",261,"261-CEUASU DE CAMPIE",115959,239,2,981,910,792,118,908,2,"CEUASU DE CAMPIE",,7,,473,435
27,"Mureș",261,"261-CHETANI",116046,240,2,1024,823,753,70,817,6,"CHETANI",,7,,530,287
27,"Mureș",261,"261-CHETANI",116046,241,2,575,432,393,39,430,2,"CHETANI",,7,,229,201
27,"Mureș",261,"261-CHETANI",116046,242,2,617,525,425,100,520,5,"CHETANI",,7,,251,269
27,"Mureș",261,"261-CHIHERU DE JOS",116126,243,2,773,597,527,70,595,2,"CHIHERU DE JOS",,7,,434,161
27,"Mureș",261,"261-CHIHERU DE JOS",116126,244,2,884,671,622,49,665,6,"CHIHERU DE JOS",,7,,519,146
27,"Mureș",261,"261-COROISANMARTIN",116171,245,2,794,640,538,102,640,0,"COROISANMARTIN",,7,,260,380
27,"Mureș",261,"261-COROISANMARTIN",116171,246,2,424,365,326,39,362,3,"COROISANMARTIN",,7,,232,130
27,"Mureș",261,"261-COZMA",116224,247,2,398,275,242,33,274,1,"COZMA",,7,,192,82
27,"Mureș",261,"261-COZMA",116224,248,2,196,149,123,26,145,4,"COZMA",,7,,94,51
27,"Mureș",261,"261-CRACIUNESTI",116288,249,2,1798,1514,1389,125,1506,8,"CRACIUNESTI",,7,,57,1449
27,"Mureș",261,"261-CRACIUNESTI",116288,250,2,686,582,535,47,578,4,"CRACIUNESTI",,7,,24,554
27,"Mureș",261,"261-CRACIUNESTI",116288,251,2,425,372,329,43,368,4,"CRACIUNESTI",,7,,26,342
27,"Mureș",261,"261-CRACIUNESTI",116288,252,2,310,154,119,35,152,2,"CRACIUNESTI",,7,,7,145
27,"Mureș",261,"261-CRAIESTI",115110,253,2,564,436,378,58,432,4,"CRAIESTI",,7,,292,140
27,"Mureș",261,"261-CRAIESTI",115110,254,2,325,267,247,20,262,5,"CRAIESTI",,7,,208,54
27,"Mureș",261,"261-CRISTESTI",114355,255,2,1940,1592,1397,195,1583,9,"CRISTESTI",,7,,502,1081
27,"Mureș",261,"261-CRISTESTI",114355,256,2,1398,1125,971,154,1115,10,"CRISTESTI",,7,,300,815
27,"Mureș",261,"261-CRISTESTI",114355,257,2,828,482,437,45,477,5,"CRISTESTI",,7,,18,459
27,"Mureș",261,"261-CUCERDEA",116395,258,2,889,624,570,54,620,4,"CUCERDEA",,7,,361,259
27,"Mureș",261,"261-CUCERDEA",116395,259,2,722,531,461,70,525,6,"CUCERDEA",,7,,305,220
27,"Mureș",261,"261-CUCI",116439,260,2,870,752,633,119,747,5,"CUCI",,7,,340,407
27,"Mureș",261,"261-CUCI",116439,261,2,380,290,242,48,288,2,"CUCI",,7,,182,106
27,"Mureș",261,"261-CUCI",116439,262,2,608,478,438,40,473,5,"CUCI",,7,,377,96
27,"Mureș",261,"261-DANES",116493,263,2,1622,1317,1090,227,1309,8,"DANES",,7,,395,914
27,"Mureș",261,"261-DANES",116493,264,2,1049,929,733,196,922,7,"DANES",,7,,216,706
27,"Mureș",261,"261-DANES",116493,265,2,386,335,247,88,333,2,"DANES",,7,,204,129
27,"Mureș",261,"261-DANES",116493,266,2,221,161,99,62,158,3,"DANES",,7,,69,89
27,"Mureș",261,"261-DEDA",116545,267,2,1397,1279,1142,137,1266,13,"DEDA",,7,,782,484
27,"Mureș",261,"261-DEDA",116545,268,2,800,723,644,79,714,9,"DEDA",,7,,416,298
27,"Mureș",261,"261-DEDA",116545,269,2,627,506,451,55,504,2,"DEDA",,7,,291,213
27,"Mureș",261,"261-DEDA",116545,270,2,435,377,327,50,373,2,"DEDA",,7,,225,148
27,"Mureș",261,"261-EREMITU",116590,271,2,1298,1167,1013,154,1161,6,"EREMITU",,7,,37,1124
27,"Mureș",261,"261-EREMITU",116590,272,2,434,470,346,124,470,0,"EREMITU",,7,,10,460
27,"Mureș",261,"261-EREMITU",116590,273,2,358,289,259,30,288,1,"EREMITU",,7,,4,284
27,"Mureș",261,"261-EREMITU",116590,274,2,216,214,177,37,214,0,"EREMITU",,7,,4,210
27,"Mureș",261,"261-EREMITU",116590,275,2,543,483,385,98,478,5,"EREMITU",,7,,6,472
27,"Mureș",261,"261-ERNEI",116652,276,2,1384,1098,979,119,1093,5,"ERNEI",,7,,67,1026
27,"Mureș",261,"261-ERNEI",116652,277,2,1109,855,745,110,844,11,"ERNEI",,7,,23,821
27,"Mureș",261,"261-ERNEI",116652,278,2,419,290,240,50,285,5,"ERNEI",,7,,4,281
27,"Mureș",261,"261-ERNEI",116652,279,2,479,424,368,56,422,2,"ERNEI",,7,,4,418
27,"Mureș",261,"261-ERNEI",116652,280,2,218,215,153,62,214,1,"ERNEI",,7,,88,126
27,"Mureș",261,"261-FARAGAU",116723,281,2,562,411,376,35,405,6,"FARAGAU",,7,,248,157
27,"Mureș",261,"261-FARAGAU",116723,282,2,293,207,180,27,202,5,"FARAGAU",,7,,112,90
27,"Mureș",261,"261-FARAGAU",116723,283,2,526,431,379,52,420,11,"FARAGAU",,7,,42,378
27,"Mureș",261,"261-FANTANELE",116796,284,2,994,850,793,57,846,4,"FANTANELE",,7,,21,825
27,"Mureș",261,"261-FANTANELE",116796,285,2,1014,912,845,67,910,2,"FANTANELE",,7,,11,899
27,"Mureș",261,"261-FANTANELE",116796,286,2,439,385,342,43,385,0,"FANTANELE",,7,,4,381
27,"Mureș",261,"261-FANTANELE",116796,287,2,680,682,616,66,674,8,"FANTANELE",,7,,16,658
27,"Mureș",261,"261-FANTANELE",116796,288,2,341,319,287,32,318,1,"FANTANELE",,7,,9,309
27,"Mureș",261,"261-FANTANELE",116796,289,2,669,664,589,75,659,5,"FANTANELE",,7,,5,654
27,"Mureș",261,"261-GALESTI",116867,290,2,990,835,763,72,826,9,"GALESTI",,7,,4,822
27,"Mureș",261,"261-GALESTI",116867,291,2,847,819,739,80,813,6,"GALESTI",,7,,5,808
27,"Mureș",261,"261-GALESTI",116867,292,2,265,263,217,46,263,0,"GALESTI",,7,,0,263
27,"Mureș",261,"261-GALESTI",116867,293,2,166,174,143,31,173,1,"GALESTI",,7,,0,173
27,"Mureș",261,"261-GANESTI",116938,294,2,1057,1162,890,272,1150,12,"GANESTI",,7,,170,980
27,"Mureș",261,"261-GANESTI",116938,295,2,716,538,443,95,537,1,"GANESTI",,7,,119,418
27,"Mureș",261,"261-GANESTI",116938,296,2,1123,877,719,158,866,11,"GANESTI",,7,,225,641
27,"Mureș",261,"261-GANESTI",116938,297,2,464,436,359,77,436,0,"GANESTI",,7,,268,168
27,"Mureș",261,"261-GHEORGHE DOJA",116983,298,2,1520,1207,1078,129,1194,13,"GHEORGHE DOJA",,7,,39,1155
27,"Mureș",261,"261-GHEORGHE DOJA",116983,299,2,573,495,412,83,492,3,"GHEORGHE DOJA",,7,,219,273
27,"Mureș",261,"261-GHINDARI",117042,300,2,1322,1055,931,124,1053,2,"GHINDARI",,7,,4,1049
27,"Mureș",261,"261-GHINDARI",117042,301,2,172,168,149,19,168,0,"GHINDARI",,7,,6,162
27,"Mureș",261,"261-GHINDARI",117042,302,2,1438,1238,1148,90,1235,3,"GHINDARI",,7,,5,1230
27,"Mureș",261,"261-GHINDARI",117042,303,2,373,365,291,74,365,0,"GHINDARI",,7,,2,363
27,"Mureș",261,"261-GHINDARI",117042,304,2,956,874,725,149,873,1,"GHINDARI",,7,,15,858
27,"Mureș",261,"261-GLODENI",117113,305,2,1635,1108,1017,91,1102,6,"GLODENI",,7,,21,1081
27,"Mureș",261,"261-GLODENI",117113,306,2,225,219,189,30,216,3,"GLODENI",,7,,157,59
27,"Mureș",261,"261-GLODENI",117113,307,2,317,280,243,37,275,5,"GLODENI",,7,,111,164
27,"Mureș",261,"261-GLODENI",117113,308,2,227,208,177,31,207,1,"GLODENI",,7,,5,202
27,"Mureș",261,"261-GLODENI",117113,309,2,414,340,309,31,334,6,"GLODENI",,7,,41,293
27,"Mureș",261,"261-GORNESTI",117177,310,2,1453,1215,1086,129,1213,2,"GORNESTI",,7,,140,1073
27,"Mureș",261,"261-GORNESTI",117177,311,2,382,352,286,66,350,2,"GORNESTI",,7,,6,344
27,"Mureș",261,"261-GORNESTI",117177,312,2,340,295,259,36,292,3,"GORNESTI",,7,,13,279
27,"Mureș",261,"261-GORNESTI",117177,313,2,1315,1240,1136,104,1235,5,"GORNESTI",,7,,72,1163
27,"Mureș",261,"261-GORNESTI",117177,314,2,397,345,321,24,341,4,"GORNESTI",,7,,62,279
27,"Mureș",261,"261-GORNESTI",117177,315,2,470,412,365,47,410,2,"GORNESTI",,7,,300,110
27,"Mureș",261,"261-GORNESTI",117177,316,2,0,96,0,96,96,0,"GORNESTI",,7,,39,57
27,"Mureș",261,"261-GREBENISU DE CAMPIE",117275,317,2,1147,761,681,80,756,5,"GREBENISU DE CAMPIE",,7,,552,204
27,"Mureș",261,"261-GURGHIU",117319,318,2,1351,1089,937,152,1083,6,"GURGHIU",,7,,412,671
27,"Mureș",261,"261-GURGHIU",117319,319,2,236,193,170,23,193,0,"GURGHIU",,7,,126,67
27,"Mureș",261,"261-GURGHIU",117319,320,2,707,599,533,66,594,5,"GURGHIU",,7,,383,211
27,"Mureș",261,"261-GURGHIU",117319,321,2,247,227,215,12,224,3,"GURGHIU",,7,,151,73
27,"Mureș",261,"261-GURGHIU",117319,322,2,1365,1007,938,69,1000,7,"GURGHIU",,7,,132,868
27,"Mureș",261,"261-GURGHIU",117319,323,2,186,151,118,33,150,1,"GURGHIU",,7,,105,45
27,"Mureș",261,"261-GURGHIU",117319,324,2,850,647,594,53,641,6,"GURGHIU",,7,,376,265
27,"Mureș",261,"261-HODAC",117426,325,2,1896,1440,1289,151,1427,13,"HODAC",,7,,1034,393
27,"Mureș",261,"261-HODAC",117426,326,2,1844,1252,1140,112,1236,16,"HODAC",,7,,852,384
27,"Mureș",261,"261-HODOSA",117505,327,2,275,293,246,47,290,3,"HODOSA",,7,,0,290
27,"Mureș",261,"261-HODOSA",117505,328,2,275,243,218,25,241,2,"HODOSA",,7,,7,234
27,"Mureș",261,"261-HODOSA",117505,329,2,666,594,562,32,591,3,"HODOSA",,7,,12,579
27,"Mureș",261,"261-IBANESTI",117550,330,2,1358,1093,1008,85,1089,4,"IBANESTI",,7,,727,362
27,"Mureș",261,"261-IBANESTI",117550,331,2,464,390,337,53,382,8,"IBANESTI",,7,,266,116
27,"Mureș",261,"261-IBANESTI",117550,332,2,805,651,582,69,646,5,"IBANESTI",,7,,496,150
27,"Mureș",261,"261-IBANESTI",117550,333,2,873,662,595,67,656,6,"IBANESTI",,7,,421,235
27,"Mureș",261,"261-ICLANZEL",117667,334,2,1136,956,828,128,953,3,"ICLANZEL",,7,,804,149
27,"Mureș",261,"261-ICLANZEL",117667,335,2,603,430,322,108,425,5,"ICLANZEL",,7,,347,78
27,"Mureș",261,"261-IDECIU DE JOS",117783,336,2,705,622,469,153,617,5,"IDECIU DE JOS",,7,,268,349
27,"Mureș",261,"261-IDECIU DE JOS",117783,337,2,535,455,412,43,454,1,"IDECIU DE JOS",,7,,242,212
27,"Mureș",261,"261-IDECIU DE JOS",117783,338,2,318,273,256,17,271,2,"IDECIU DE JOS",,7,,173,98
27,"Mureș",261,"261-LIVEZENI",117925,339,2,942,769,676,93,748,21,"LIVEZENI",,7,,120,628
27,"Mureș",261,"261-LIVEZENI",117925,340,2,1233,1091,953,138,1082,9,"LIVEZENI",,7,,66,1016
27,"Mureș",261,"261-LIVEZENI",117925,341,2,337,301,239,62,295,6,"LIVEZENI",,7,,60,235
27,"Mureș",261,"261-LUNCA",117998,342,2,541,454,438,16,453,1,"LUNCA",,7,,222,231
27,"Mureș",261,"261-LUNCA",117998,343,2,727,557,531,26,552,5,"LUNCA",,7,,336,216
27,"Mureș",261,"261-LUNCA",117998,344,2,392,320,297,23,317,3,"LUNCA",,7,,146,171
27,"Mureș",261,"261-LUNCA",117998,345,2,423,387,345,42,386,1,"LUNCA",,7,,252,134
27,"Mureș",261,"261-LUNCA",117998,346,2,349,337,311,26,336,1,"LUNCA",,7,,201,135
27,"Mureș",261,"261-LUNCA BRADULUI",118058,347,2,1282,1078,933,145,1067,11,"LUNCA BRADULUI",,7,,450,617
27,"Mureș",261,"261-LUNCA BRADULUI",118058,348,2,410,322,282,40,319,3,"LUNCA BRADULUI",,7,,220,99
27,"Mureș",261,"261-MAGHERANI",118094,349,2,811,625,576,49,621,4,"MAGHERANI",,7,,14,607
27,"Mureș",261,"261-MAGHERANI",118094,350,2,619,528,490,38,520,8,"MAGHERANI",,7,,13,507
27,"Mureș",261,"261-MAGHERANI",118094,351,2,523,491,452,39,490,1,"MAGHERANI",,7,,3,487
27,"Mureș",261,"261-MAGHERANI",118094,352,2,475,374,347,27,371,3,"MAGHERANI",,7,,6,365
27,"Mureș",261,"261-MICA",118209,353,2,889,689,608,81,679,10,"MICA",,7,,160,519
27,"Mureș",261,"261-MICA",118209,354,2,1039,877,797,80,876,1,"MICA",,7,,108,768
27,"Mureș",261,"261-MICA",118209,355,2,643,590,532,58,585,5,"MICA",,7,,104,481
27,"Mureș",261,"261-MICA",118209,356,2,646,597,543,54,590,7,"MICA",,7,,11,579
27,"Mureș",261,"261-MICA",118209,357,2,223,212,167,45,210,2,"MICA",,7,,134,76
27,"Mureș",261,"261-MIERCUREA NIRAJULUI",118290,358,2,1228,813,729,84,804,9,"MIERCUREA NIRAJULUI",,7,,17,787
27,"Mureș",261,"261-MIERCUREA NIRAJULUI",118290,359,2,1924,1508,1372,136,1501,7,"MIERCUREA NIRAJULUI",,7,,48,1453
27,"Mureș",261,"261-MIERCUREA NIRAJULUI",118290,360,2,805,514,413,101,510,4,"MIERCUREA NIRAJULUI",,7,,94,416
27,"Mureș",261,"261-MIERCUREA NIRAJULUI",118290,361,2,423,289,221,68,286,3,"MIERCUREA NIRAJULUI",,7,,144,142
27,"Mureș",261,"261-MIHESU DE CAMPIE",118370,362,2,1243,847,718,129,838,9,"MIHESU DE CAMPIE",,7,,539,299
27,"Mureș",261,"261-MIHESU DE CAMPIE",118370,363,2,791,478,385,93,474,4,"MIHESU DE CAMPIE",,7,,325,149
27,"Mureș",261,"261-NADES",118469,364,2,840,704,569,135,700,4,"NADES",,7,,150,550
27,"Mureș",261,"261-NADES",118469,365,2,519,465,342,123,459,6,"NADES",,7,,147,312
27,"Mureș",261,"261-NADES",118469,366,2,151,116,91,25,116,0,"NADES",,7,,66,50
27,"Mureș",261,"261-NEAUA",118511,367,2,942,814,729,85,805,9,"NEAUA",,7,,7,798
27,"Mureș",261,"261-NEAUA",118511,368,2,318,284,255,29,283,1,"NEAUA",,7,,0,283
27,"Mureș",261,"261-OGRA",118575,369,2,1076,935,828,107,925,10,"OGRA",,7,,287,638
27,"Mureș",261,"261-OGRA",118575,370,2,220,167,144,23,165,2,"OGRA",,7,,60,105
27,"Mureș",261,"261-OGRA",118575,371,2,195,180,152,28,170,10,"OGRA",,7,,147,23
27,"Mureș",261,"261-OGRA",118575,372,2,178,190,134,56,190,0,"OGRA",,7,,100,90
27,"Mureș",261,"261-OGRA",118575,373,2,151,159,125,34,159,0,"OGRA",,7,,129,30
27,"Mureș",261,"261-PANET",118691,374,2,1779,1521,1400,121,1516,5,"PANET",,7,,40,1476
27,"Mureș",261,"261-PANET",118691,375,2,880,776,695,81,773,3,"PANET",,7,,189,584
27,"Mureș",261,"261-PANET",118691,376,2,527,388,362,26,375,13,"PANET",,7,,53,322
27,"Mureș",261,"261-PANET",118691,377,2,250,173,136,37,173,0,"PANET",,7,,44,129
27,"Mureș",261,"261-PANET",118691,378,2,1016,915,789,126,907,8,"PANET",,7,,104,803
27,"Mureș",261,"261-PAPIU ILARIAN",118637,379,2,821,573,515,58,564,9,"PAPIU ILARIAN",,7,,222,342
27,"Mureș",261,"261-PASARENI",118753,380,2,910,862,783,79,859,3,"PASARENI",,7,,51,808
27,"Mureș",261,"261-PASARENI",118753,381,2,597,636,573,63,636,0,"PASARENI",,7,,0,636
27,"Mureș",261,"261-PETELEA",118799,382,2,1629,1315,1159,156,1295,20,"PETELEA",,7,,702,593
27,"Mureș",261,"261-PETELEA",118799,383,2,295,269,222,47,264,5,"PETELEA",,7,,179,85
27,"Mureș",261,"261-POGACEAUA",118824,384,2,1047,725,639,86,714,11,"POGACEAUA",,7,,548,166
27,"Mureș",261,"261-POGACEAUA",118824,385,2,503,383,307,76,377,4,"POGACEAUA",,7,,278,99
27,"Mureș",261,"261-RASTOLITA",118931,386,2,1316,1361,942,419,1357,4,"RASTOLITA",,7,,392,965
27,"Mureș",261,"261-RACIU",118995,387,2,1300,1045,872,173,1036,9,"RACIU",,7,,770,266
27,"Mureș",261,"261-RACIU",118995,388,2,227,173,143,30,172,1,"RACIU",,7,,108,64
27,"Mureș",261,"261-RACIU",118995,389,2,766,629,535,94,624,5,"RACIU",,7,,462,162
27,"Mureș",261,"261-RACIU",118995,390,2,681,495,416,79,488,7,"RACIU",,7,,333,155
27,"Mureș",261,"261-RUSII-MUNTI",119153,391,2,1789,1598,1489,109,1593,5,"RUSII-MUNTI",,7,,1013,580
27,"Mureș",261,"261-SARMASU",119251,392,2,1822,1373,1272,101,1363,10,"SARMASU",,7,,402,961
27,"Mureș",261,"261-SARMASU",119251,393,2,1398,888,809,79,875,13,"SARMASU",,7,,357,518
27,"Mureș",261,"261-SARMASU",119251,394,2,871,713,613,100,712,1,"SARMASU",,7,,382,330
27,"Mureș",261,"261-SARMASU",119251,395,2,598,486,385,101,485,1,"SARMASU",,7,,224,261
27,"Mureș",261,"261-SARMASU",119251,396,2,550,430,351,79,423,7,"SARMASU",,7,,224,199
27,"Mureș",261,"261-SARMASU",119251,397,2,512,438,383,55,435,3,"SARMASU",,7,,335,100
27,"Mureș",261,"261-SASCHIZ",119206,398,2,1010,799,621,178,793,6,"SASCHIZ",,7,,324,469
27,"Mureș",261,"261-SASCHIZ",119206,399,2,348,353,241,112,346,7,"SASCHIZ",,7,,161,185
27,"Mureș",261,"261-SAULIA",119750,400,2,1587,1169,1036,133,1155,14,"SAULIA",,7,,720,435
27,"Mureș",261,"261-SINCAI",119803,401,2,984,748,674,74,739,9,"SINCAI",,7,,282,457
27,"Mureș",261,"261-SINCAI",119803,402,2,359,310,261,49,303,7,"SINCAI",,7,,242,61
27,"Mureș",261,"261-SANCRAIU DE MURES",114382,403,2,1785,1323,1079,244,1315,8,"SANCRAIU DE MURES",,7,,402,913
27,"Mureș",261,"261-SANCRAIU DE MURES",114382,404,2,1467,1214,973,241,1209,5,"SANCRAIU DE MURES",,7,,311,898
27,"Mureș",261,"261-SANCRAIU DE MURES",114382,405,2,1380,1250,960,290,1245,5,"SANCRAIU DE MURES",,7,,759,486
27,"Mureș",261,"261-SANGEORGIU DE MURES",114417,406,2,2354,1617,1410,207,1600,17,"SANGEORGIU DE MURES",,7,,242,1358
27,"Mureș",261,"261-SANGEORGIU DE MURES",114417,407,2,1311,1332,1026,306,1328,4,"SANGEORGIU DE MURES",,7,,214,1114
27,"Mureș",261,"261-SANGEORGIU DE MURES",114417,408,2,1670,1215,1069,146,1200,15,"SANGEORGIU DE MURES",,7,,376,824
27,"Mureș",261,"261-SANGEORGIU DE MURES",114417,409,2,205,194,149,45,192,2,"SANGEORGIU DE MURES",,7,,7,185
27,"Mureș",261,"261-SANGEORGIU DE PADURE",119340,410,2,1193,997,799,198,991,6,"SANGEORGIU DE PADURE",,7,,92,899
27,"Mureș",261,"261-SANGEORGIU DE PADURE",119340,411,2,2276,1614,1409,205,1600,14,"SANGEORGIU DE PADURE",,7,,232,1368
27,"Mureș",261,"261-SANGEORGIU DE PADURE",119340,412,2,698,394,339,55,384,10,"SANGEORGIU DE PADURE",,7,,19,365
27,"Mureș",261,"261-SANGER",119386,413,2,1127,800,692,108,792,8,"SANGER",,7,,406,386
27,"Mureș",261,"261-SANGER",119386,414,2,784,537,470,67,533,4,"SANGER",,7,,416,117
27,"Mureș",261,"261-SANPAUL",119466,415,2,1182,998,855,143,989,9,"SANPAUL",,7,,274,715
27,"Mureș",261,"261-SANPAUL",119466,416,2,592,568,451,117,557,11,"SANPAUL",,7,,368,189
27,"Mureș",261,"261-SANPAUL",119466,417,2,771,760,660,100,752,8,"SANPAUL",,7,,113,639
27,"Mureș",261,"261-SANPETRU DE CAMPIE",119527,418,2,968,698,569,129,691,7,"SANPETRU DE CAMPIE",,7,,493,198
27,"Mureș",261,"261-SANPETRU DE CAMPIE",119527,419,2,742,494,432,62,490,4,"SANPETRU DE CAMPIE",,7,,320,170
27,"Mureș",261,"261-SANPETRU DE CAMPIE",119527,420,2,363,292,266,26,286,6,"SANPETRU DE CAMPIE",,7,,217,69
27,"Mureș",261,"261-SANPETRU DE CAMPIE",119527,421,2,610,418,365,53,415,3,"SANPETRU DE CAMPIE",,7,,253,162
27,"Mureș",261,"261-SANTANA DE MURES",114453,422,2,1461,1176,1026,150,1163,13,"SANTANA DE MURES",,7,,482,681
27,"Mureș",261,"261-SANTANA DE MURES",114453,423,2,666,616,529,87,613,3,"SANTANA DE MURES",,7,,21,592
27,"Mureș",261,"261-SANTANA DE MURES",114453,424,2,412,387,307,80,378,9,"SANTANA DE MURES",,7,,113,265
27,"Mureș",261,"261-SANTANA DE MURES",114453,425,2,245,254,204,50,252,2,"SANTANA DE MURES",,7,,176,76
27,"Mureș",261,"261-SOLOVASTRU",119590,426,2,1220,976,896,80,974,2,"SOLOVASTRU",,7,,632,342
27,"Mureș",261,"261-SOLOVASTRU",119590,427,2,910,793,703,90,790,3,"SOLOVASTRU",,7,,507,283
27,"Mureș",261,"261-STANCENI",119625,428,2,1153,909,797,112,905,4,"STANCENI",,7,,429,476
27,"Mureș",261,"261-SUPLAC",119661,429,2,667,555,455,100,547,8,"SUPLAC",,7,,143,404
27,"Mureș",261,"261-SUPLAC",119661,430,2,557,530,469,61,529,1,"SUPLAC",,7,,17,512
27,"Mureș",261,"261-SUPLAC",119661,431,2,650,577,443,134,569,8,"SUPLAC",,7,,345,224
27,"Mureș",261,"261-SUSENI",119723,432,2,1083,935,855,80,929,6,"SUSENI",,7,,250,679
27,"Mureș",261,"261-SUSENI",119723,433,2,639,582,534,48,581,1,"SUSENI",,7,,401,180
27,"Mureș",261,"261-TAURENI",119858,434,2,877,574,490,84,571,3,"TAURENI",,7,,376,195
27,"Mureș",261,"261-UNGHENI",119901,435,2,1182,870,712,158,866,4,"UNGHENI",,7,,425,441
27,"Mureș",261,"261-UNGHENI",119901,436,2,1460,1180,1055,125,1172,8,"UNGHENI",,7,,652,520
27,"Mureș",261,"261-UNGHENI",119901,437,2,397,355,275,80,354,1,"UNGHENI",,7,,280,74
27,"Mureș",261,"261-UNGHENI",119901,438,2,330,321,261,60,319,2,"UNGHENI",,7,,243,76
27,"Mureș",261,"261-UNGHENI",119901,439,2,484,445,380,65,436,9,"UNGHENI",,7,,231,205
27,"Mureș",261,"261-UNGHENI",119901,440,2,172,172,141,31,172,0,"UNGHENI",,7,,129,43
27,"Mureș",261,"261-UNGHENI",119901,441,2,658,641,513,128,635,6,"UNGHENI",,7,,443,192
27,"Mureș",261,"261-VALEA LARGA",119974,442,2,2156,877,813,64,869,8,"VALEA LARGA",,7,,567,302
27,"Mureș",261,"261-VALEA LARGA",119974,443,2,630,226,220,6,224,2,"VALEA LARGA",,7,,109,115
27,"Mureș",261,"261-VARGATA",120076,444,2,1131,959,837,122,956,3,"VARGATA",,7,,13,943
27,"Mureș",261,"261-VARGATA",120076,445,2,152,166,148,18,166,0,"VARGATA",,7,,3,163
27,"Mureș",261,"261-VARGATA",120076,446,2,214,206,173,33,204,2,"VARGATA",,7,,7,197
27,"Mureș",261,"261-VATAVA",120138,447,2,732,537,517,20,534,3,"VATAVA",,7,,321,213
27,"Mureș",261,"261-VATAVA",120138,448,2,662,536,517,19,533,3,"VATAVA",,7,,344,189
27,"Mureș",261,"261-VATAVA",120138,449,2,452,385,334,51,378,7,"VATAVA",,7,,219,159
27,"Mureș",261,"261-VETCA",120174,450,2,463,381,340,41,379,2,"VETCA",,7,,9,370
27,"Mureș",261,"261-VETCA",120174,451,2,244,253,214,39,249,4,"VETCA",,7,,7,242
27,"Mureș",261,"261-VIISOARA",120218,452,2,489,329,279,50,327,2,"VIISOARA",,7,,81,246
27,"Mureș",261,"261-VIISOARA",120218,453,2,216,222,143,79,219,3,"VIISOARA",,7,,91,128
27,"Mureș",261,"261-VIISOARA",120218,454,2,378,359,294,65,356,3,"VIISOARA",,7,,113,243
27,"Mureș",261,"261-VANATORI",120254,455,2,1111,891,754,137,880,11,"VANATORI",,7,,165,715
27,"Mureș",261,"261-VANATORI",120254,456,2,439,402,294,108,398,4,"VANATORI",,7,,156,242
27,"Mureș",261,"261-VANATORI",120254,457,2,198,195,162,33,195,0,"VANATORI",,7,,126,69
27,"Mureș",261,"261-VANATORI",120254,458,2,290,239,208,31,236,3,"VANATORI",,7,,13,223
27,"Mureș",261,"261-VANATORI",120254,459,2,422,367,301,66,363,4,"VANATORI",,7,,96,267
27,"Mureș",261,"261-VOIVODENI",120316,460,2,1335,939,866,73,930,9,"VOIVODENI",,7,,138,792
27,"Mureș",261,"261-VOIVODENI",120316,461,2,267,224,188,36,221,3,"VOIVODENI",,7,,99,122
27,"Mureș",261,"261-ZAGAR",120343,462,2,694,645,533,112,640,5,"ZAGAR",,7,,340,300
27,"Mureș",261,"261-ZAU DE CAMPIE",120370,463,2,2118,1356,1188,168,1346,10,"ZAU DE CAMPIE",,7,,939,407
27,"Mureș",261,"261-ZAU DE CAMPIE",120370,464,2,415,291,247,44,290,1,"ZAU DE CAMPIE",,7,,215,75
28,"Neamț",270,"270-MUNICIPIUL PIATRA NEAMT",120726,1,2,1389,1096,981,115,1095,1,"MUNICIPIUL PIATRA NEAMT",,4,,521,574
28,"Neamț",270,"270-MUNICIPIUL PIATRA NEAMT",120726,2,2,1349,1041,972,69,1039,2,"MUNICIPIUL PIATRA NEAMT",,4,,484,555
28,"Neamț",270,"270-MUNICIPIUL PIATRA NEAMT",120726,3,2,1293,966,904,62,963,3,"MUNICIPIUL PIATRA NEAMT",,4,,422,541
28,"Neamț",270,"270-MUNICIPIUL PIATRA NEAMT",120726,4,2,1591,1183,1100,83,1178,5,"MUNICIPIUL PIATRA NEAMT",,4,,410,768
28,"Neamț",270,"270-MUNICIPIUL PIATRA NEAMT",120726,5,2,1236,959,907,52,954,5,"MUNICIPIUL PIATRA NEAMT",,4,,349,605
28,"Neamț",270,"270-MUNICIPIUL PIATRA NEAMT",120726,6,2,2290,1654,1525,129,1642,12,"MUNICIPIUL PIATRA NEAMT",,4,,656,986
28,"Neamț",270,"270-MUNICIPIUL PIATRA NEAMT",120726,7,2,1505,1124,1000,124,1120,4,"MUNICIPIUL PIATRA NEAMT",,4,,504,616
28,"Neamț",270,"270-MUNICIPIUL PIATRA NEAMT",120726,8,2,1199,949,858,91,947,2,"MUNICIPIUL PIATRA NEAMT",,4,,343,604
28,"Neamț",270,"270-MUNICIPIUL PIATRA NEAMT",120726,9,2,1486,1244,1010,234,1240,4,"MUNICIPIUL PIATRA NEAMT",,4,,480,760
28,"Neamț",270,"270-MUNICIPIUL PIATRA NEAMT",120726,10,2,1571,1237,1118,119,1225,12,"MUNICIPIUL PIATRA NEAMT",,4,,481,744
28,"Neamț",270,"270-MUNICIPIUL PIATRA NEAMT",120726,11,2,1316,1075,965,110,1064,7,"MUNICIPIUL PIATRA NEAMT",,4,,340,724
28,"Neamț",270,"270-MUNICIPIUL PIATRA NEAMT",120726,12,2,1746,1298,1202,96,1289,9,"MUNICIPIUL PIATRA NEAMT",,4,,445,844
28,"Neamț",270,"270-MUNICIPIUL PIATRA NEAMT",120726,13,2,1589,1261,1153,108,1256,5,"MUNICIPIUL PIATRA NEAMT",,4,,472,784
28,"Neamț",270,"270-MUNICIPIUL PIATRA NEAMT",120726,14,2,1449,1047,980,67,1041,6,"MUNICIPIUL PIATRA NEAMT",,4,,376,665
28,"Neamț",270,"270-MUNICIPIUL PIATRA NEAMT",120726,15,2,1924,1460,1358,102,1449,11,"MUNICIPIUL PIATRA NEAMT",,4,,538,911
28,"Neamț",270,"270-MUNICIPIUL PIATRA NEAMT",120726,16,2,1593,1199,1152,47,1185,14,"MUNICIPIUL PIATRA NEAMT",,4,,416,769
28,"Neamț",270,"270-MUNICIPIUL PIATRA NEAMT",120726,17,2,1213,1039,906,133,1031,8,"MUNICIPIUL PIATRA NEAMT",,4,,464,567
28,"Neamț",270,"270-MUNICIPIUL PIATRA NEAMT",120726,18,2,1400,1089,1028,61,1084,5,"MUNICIPIUL PIATRA NEAMT",,4,,512,572
28,"Neamț",270,"270-MUNICIPIUL PIATRA NEAMT",120726,19,2,889,655,622,33,654,1,"MUNICIPIUL PIATRA NEAMT",,4,,282,372
28,"Neamț",270,"270-MUNICIPIUL PIATRA NEAMT",120726,20,2,1683,1351,1187,164,1345,6,"MUNICIPIUL PIATRA NEAMT",,4,,490,855
28,"Neamț",270,"270-MUNICIPIUL PIATRA NEAMT",120726,21,2,1516,1153,1102,51,1148,5,"MUNICIPIUL PIATRA NEAMT",,4,,420,728
28,"Neamț",270,"270-MUNICIPIUL PIATRA NEAMT",120726,22,2,1378,1081,996,85,1077,4,"MUNICIPIUL PIATRA NEAMT",,4,,421,656
28,"Neamț",270,"270-MUNICIPIUL PIATRA NEAMT",120726,23,2,1105,882,795,87,878,4,"MUNICIPIUL PIATRA NEAMT",,4,,319,559
28,"Neamț",270,"270-MUNICIPIUL PIATRA NEAMT",120726,24,2,1629,1145,1068,77,1141,4,"MUNICIPIUL PIATRA NEAMT",,4,,431,710
28,"Neamț",270,"270-MUNICIPIUL PIATRA NEAMT",120726,25,2,1292,1006,906,100,1000,6,"MUNICIPIUL PIATRA NEAMT",,4,,383,617
28,"Neamț",270,"270-MUNICIPIUL PIATRA NEAMT",120726,26,2,1338,942,906,36,937,5,"MUNICIPIUL PIATRA NEAMT",,4,,354,583
28,"Neamț",270,"270-MUNICIPIUL PIATRA NEAMT",120726,27,2,1284,967,891,76,958,9,"MUNICIPIUL PIATRA NEAMT",,4,,335,623
28,"Neamț",270,"270-MUNICIPIUL PIATRA NEAMT",120726,28,2,1477,1127,1044,83,1123,4,"MUNICIPIUL PIATRA NEAMT",,4,,423,700
28,"Neamț",270,"270-MUNICIPIUL PIATRA NEAMT",120726,29,2,1845,1309,1159,150,1304,5,"MUNICIPIUL PIATRA NEAMT",,4,,580,724
28,"Neamț",270,"270-MUNICIPIUL PIATRA NEAMT",120726,30,2,1563,1111,1051,60,1107,4,"MUNICIPIUL PIATRA NEAMT",,4,,448,659
28,"Neamț",270,"270-MUNICIPIUL PIATRA NEAMT",120726,31,2,2404,1642,1458,184,1638,4,"MUNICIPIUL PIATRA NEAMT",,4,,670,968
28,"Neamț",270,"270-MUNICIPIUL PIATRA NEAMT",120726,32,2,1422,1028,970,58,1019,9,"MUNICIPIUL PIATRA NEAMT",,4,,467,552
28,"Neamț",270,"270-MUNICIPIUL PIATRA NEAMT",120726,33,2,949,1001,644,357,996,5,"MUNICIPIUL PIATRA NEAMT",,4,,399,597
28,"Neamț",270,"270-MUNICIPIUL PIATRA NEAMT",120726,34,2,1461,1023,908,115,1017,6,"MUNICIPIUL PIATRA NEAMT",,4,,432,585
28,"Neamț",270,"270-MUNICIPIUL PIATRA NEAMT",120726,35,2,1759,1179,1085,94,1172,7,"MUNICIPIUL PIATRA NEAMT",,4,,448,724
28,"Neamț",270,"270-MUNICIPIUL PIATRA NEAMT",120726,36,2,2214,1409,1257,152,1404,5,"MUNICIPIUL PIATRA NEAMT",,4,,586,818
28,"Neamț",270,"270-MUNICIPIUL PIATRA NEAMT",120726,37,2,603,520,302,218,517,3,"MUNICIPIUL PIATRA NEAMT",,4,,222,295
28,"Neamț",270,"270-MUNICIPIUL PIATRA NEAMT",120726,38,2,1463,1087,999,88,1081,6,"MUNICIPIUL PIATRA NEAMT",,4,,477,604
28,"Neamț",270,"270-MUNICIPIUL PIATRA NEAMT",120726,39,2,1491,1029,970,59,1026,3,"MUNICIPIUL PIATRA NEAMT",,4,,475,551
28,"Neamț",270,"270-MUNICIPIUL PIATRA NEAMT",120726,40,2,1448,1042,958,84,1030,12,"MUNICIPIUL PIATRA NEAMT",,4,,418,612
28,"Neamț",270,"270-MUNICIPIUL PIATRA NEAMT",120726,41,2,1846,1245,1192,53,1229,16,"MUNICIPIUL PIATRA NEAMT",,4,,572,657
28,"Neamț",270,"270-MUNICIPIUL PIATRA NEAMT",120726,42,2,1949,1451,1272,179,1435,16,"MUNICIPIUL PIATRA NEAMT",,4,,561,874
28,"Neamț",270,"270-MUNICIPIUL PIATRA NEAMT",120726,43,2,879,744,612,132,735,9,"MUNICIPIUL PIATRA NEAMT",,4,,276,459
28,"Neamț",270,"270-MUNICIPIUL PIATRA NEAMT",120726,44,2,1421,1075,1009,66,1067,8,"MUNICIPIUL PIATRA NEAMT",,4,,421,646
28,"Neamț",270,"270-MUNICIPIUL PIATRA NEAMT",120726,45,2,1805,1290,1158,132,1284,6,"MUNICIPIUL PIATRA NEAMT",,4,,462,822
28,"Neamț",270,"270-MUNICIPIUL PIATRA NEAMT",120726,46,2,1737,1118,1000,118,1112,6,"MUNICIPIUL PIATRA NEAMT",,4,,384,728
28,"Neamț",270,"270-MUNICIPIUL PIATRA NEAMT",120726,47,2,1549,1185,1103,82,1177,8,"MUNICIPIUL PIATRA NEAMT",,4,,439,738
28,"Neamț",270,"270-MUNICIPIUL PIATRA NEAMT",120726,48,2,1723,1363,1288,75,1283,5,"MUNICIPIUL PIATRA NEAMT",,4,,513,770
28,"Neamț",270,"270-MUNICIPIUL PIATRA NEAMT",120726,49,2,1803,1236,1123,113,1228,8,"MUNICIPIUL PIATRA NEAMT",,4,,518,710
28,"Neamț",270,"270-MUNICIPIUL PIATRA NEAMT",120726,50,2,1487,1196,1125,71,1194,2,"MUNICIPIUL PIATRA NEAMT",,4,,438,756
28,"Neamț",270,"270-MUNICIPIUL PIATRA NEAMT",120726,51,2,1699,1298,1096,202,1289,9,"MUNICIPIUL PIATRA NEAMT",,4,,436,853
28,"Neamț",270,"270-MUNICIPIUL PIATRA NEAMT",120726,52,2,1307,1051,945,106,1046,5,"MUNICIPIUL PIATRA NEAMT",,4,,360,686
28,"Neamț",270,"270-MUNICIPIUL PIATRA NEAMT",120726,53,2,1826,1358,1253,105,1344,14,"MUNICIPIUL PIATRA NEAMT",,4,,631,713
28,"Neamț",270,"270-MUNICIPIUL PIATRA NEAMT",120726,54,2,2053,1361,1286,75,1342,19,"MUNICIPIUL PIATRA NEAMT",,4,,653,689
28,"Neamț",270,"270-MUNICIPIUL PIATRA NEAMT",120726,55,2,1881,1173,1093,80,1165,8,"MUNICIPIUL PIATRA NEAMT",,4,,394,771
28,"Neamț",270,"270-MUNICIPIUL PIATRA NEAMT",120726,56,2,1574,1257,1033,224,1243,14,"MUNICIPIUL PIATRA NEAMT",,4,,412,831
28,"Neamț",270,"270-MUNICIPIUL PIATRA NEAMT",120726,57,2,1143,873,679,194,872,1,"MUNICIPIUL PIATRA NEAMT",,4,,315,557
28,"Neamț",270,"270-MUNICIPIUL PIATRA NEAMT",120726,58,2,957,756,686,70,751,5,"MUNICIPIUL PIATRA NEAMT",,4,,272,479
28,"Neamț",270,"270-MUNICIPIUL PIATRA NEAMT",120726,59,2,2424,1781,1647,134,1773,8,"MUNICIPIUL PIATRA NEAMT",,4,,672,1101
28,"Neamț",270,"270-MUNICIPIUL PIATRA NEAMT",120726,60,2,1722,1198,1136,62,1197,1,"MUNICIPIUL PIATRA NEAMT",,4,,460,737
28,"Neamț",270,"270-MUNICIPIUL PIATRA NEAMT",120726,61,2,1411,1154,1037,117,1145,9,"MUNICIPIUL PIATRA NEAMT",,4,,487,658
28,"Neamț",270,"270-MUNICIPIUL PIATRA NEAMT",120726,62,2,1398,1265,1169,96,1261,4,"MUNICIPIUL PIATRA NEAMT",,4,,489,772
28,"Neamț",270,"270-MUNICIPIUL PIATRA NEAMT",120726,63,2,988,790,654,136,784,6,"MUNICIPIUL PIATRA NEAMT",,4,,320,464
28,"Neamț",270,"270-MUNICIPIUL PIATRA NEAMT",120726,64,2,0,474,0,474,471,3,"MUNICIPIUL PIATRA NEAMT",,4,,167,304
28,"Neamț",270,"270-MUNICIPIUL PIATRA NEAMT",120726,65,2,0,739,0,739,734,5,"MUNICIPIUL PIATRA NEAMT",,4,,352,382
28,"Neamț",270,"270-MUNICIPIUL ROMAN",120860,66,2,1191,926,857,69,923,3,"MUNICIPIUL ROMAN",,4,,479,444
28,"Neamț",270,"270-MUNICIPIUL ROMAN",120860,67,2,1858,1378,1281,97,1374,4,"MUNICIPIUL ROMAN",,4,,686,688
28,"Neamț",270,"270-MUNICIPIUL ROMAN",120860,68,2,946,857,701,156,852,5,"MUNICIPIUL ROMAN",,4,,455,397
28,"Neamț",270,"270-MUNICIPIUL ROMAN",120860,69,2,1724,1257,1180,77,1253,4,"MUNICIPIUL ROMAN",,4,,640,613
28,"Neamț",270,"270-MUNICIPIUL ROMAN",120860,70,2,1263,1009,932,77,1004,5,"MUNICIPIUL ROMAN",,4,,555,449
28,"Neamț",270,"270-MUNICIPIUL ROMAN",120860,71,2,1286,1063,917,146,1058,5,"MUNICIPIUL ROMAN",,4,,638,420
28,"Neamț",270,"270-MUNICIPIUL ROMAN",120860,72,2,1947,1625,1292,333,1621,4,"MUNICIPIUL ROMAN",,4,,833,788
28,"Neamț",270,"270-MUNICIPIUL ROMAN",120860,73,2,2164,1505,1315,190,1488,17,"MUNICIPIUL ROMAN",,4,,689,799
28,"Neamț",270,"270-MUNICIPIUL ROMAN",120860,74,2,1631,1224,1029,195,1219,5,"MUNICIPIUL ROMAN",,4,,678,541
28,"Neamț",270,"270-MUNICIPIUL ROMAN",120860,75,2,1133,823,745,78,810,13,"MUNICIPIUL ROMAN",,4,,442,368
28,"Neamț",270,"270-MUNICIPIUL ROMAN",120860,76,2,1347,949,835,114,930,19,"MUNICIPIUL ROMAN",,4,,518,412
28,"Neamț",270,"270-MUNICIPIUL ROMAN",120860,77,2,1380,1069,960,109,1059,10,"MUNICIPIUL ROMAN",,4,,531,528
28,"Neamț",270,"270-MUNICIPIUL ROMAN",120860,78,2,1253,1006,826,180,1001,5,"MUNICIPIUL ROMAN",,4,,542,459
28,"Neamț",270,"270-MUNICIPIUL ROMAN",120860,79,2,1561,1108,1024,84,1103,5,"MUNICIPIUL ROMAN",,4,,613,490
28,"Neamț",270,"270-MUNICIPIUL ROMAN",120860,80,2,1376,1040,983,57,1030,10,"MUNICIPIUL ROMAN",,4,,569,461
28,"Neamț",270,"270-MUNICIPIUL ROMAN",120860,81,2,1602,1096,1022,74,1089,7,"MUNICIPIUL ROMAN",,4,,571,518
28,"Neamț",270,"270-MUNICIPIUL ROMAN",120860,82,2,1641,1166,1045,121,1162,4,"MUNICIPIUL ROMAN",,4,,646,516
28,"Neamț",270,"270-MUNICIPIUL ROMAN",120860,83,2,2000,1446,1335,111,1436,10,"MUNICIPIUL ROMAN",,4,,766,670
28,"Neamț",270,"270-MUNICIPIUL ROMAN",120860,84,2,2013,1427,1332,95,1419,8,"MUNICIPIUL ROMAN",,4,,771,648
28,"Neamț",270,"270-MUNICIPIUL ROMAN",120860,85,2,1341,1016,916,100,1010,6,"MUNICIPIUL ROMAN",,4,,570,440
28,"Neamț",270,"270-MUNICIPIUL ROMAN",120860,86,2,1828,1297,1137,160,1281,16,"MUNICIPIUL ROMAN",,4,,664,617
28,"Neamț",270,"270-MUNICIPIUL ROMAN",120860,87,2,1290,1013,938,75,1009,4,"MUNICIPIUL ROMAN",,4,,528,481
28,"Neamț",270,"270-MUNICIPIUL ROMAN",120860,88,2,1636,1241,1163,78,1240,1,"MUNICIPIUL ROMAN",,4,,729,511
28,"Neamț",270,"270-MUNICIPIUL ROMAN",120860,89,2,1163,950,808,142,941,9,"MUNICIPIUL ROMAN",,4,,589,352
28,"Neamț",270,"270-MUNICIPIUL ROMAN",120860,90,2,1180,941,878,63,932,9,"MUNICIPIUL ROMAN",,4,,551,381
28,"Neamț",270,"270-MUNICIPIUL ROMAN",120860,91,2,1363,1031,910,121,1028,3,"MUNICIPIUL ROMAN",,4,,540,488
28,"Neamț",270,"270-MUNICIPIUL ROMAN",120860,92,2,1522,1129,1072,57,1126,3,"MUNICIPIUL ROMAN",,4,,596,530
28,"Neamț",270,"270-MUNICIPIUL ROMAN",120860,93,2,356,1011,961,50,1005,6,"MUNICIPIUL ROMAN",,4,,524,481
28,"Neamț",270,"270-MUNICIPIUL ROMAN",120860,94,2,1337,1009,932,77,1004,5,"MUNICIPIUL ROMAN",,4,,557,447
28,"Neamț",270,"270-MUNICIPIUL ROMAN",120860,95,2,1232,1046,933,113,1043,3,"MUNICIPIUL ROMAN",,4,,438,605
28,"Neamț",270,"270-MUNICIPIUL ROMAN",120860,96,2,1673,1261,1143,118,1254,7,"MUNICIPIUL ROMAN",,4,,622,632
28,"Neamț",270,"270-MUNICIPIUL ROMAN",120860,97,2,1210,956,888,68,946,10,"MUNICIPIUL ROMAN",,4,,559,387
28,"Neamț",270,"270-MUNICIPIUL ROMAN",120860,98,2,1420,1125,1023,102,1117,8,"MUNICIPIUL ROMAN",,4,,496,621
28,"Neamț",270,"270-MUNICIPIUL ROMAN",120860,99,2,977,760,705,55,758,2,"MUNICIPIUL ROMAN",,4,,349,409
28,"Neamț",270,"270-MUNICIPIUL ROMAN",120860,100,2,2065,1524,1445,79,1520,4,"MUNICIPIUL ROMAN",,4,,763,757
28,"Neamț",270,"270-MUNICIPIUL ROMAN",120860,101,2,1277,956,916,40,953,3,"MUNICIPIUL ROMAN",,4,,513,440
28,"Neamț",270,"270-MUNICIPIUL ROMAN",120860,102,2,1881,1427,1316,111,1418,9,"MUNICIPIUL ROMAN",,4,,751,667
28,"Neamț",270,"270-MUNICIPIUL ROMAN",120860,103,2,1425,1072,931,141,1061,11,"MUNICIPIUL ROMAN",,4,,501,560
28,"Neamț",270,"270-MUNICIPIUL ROMAN",120860,104,2,1152,870,738,132,860,10,"MUNICIPIUL ROMAN",,4,,501,359
28,"Neamț",270,"270-MUNICIPIUL ROMAN",120860,105,2,941,789,666,123,786,3,"MUNICIPIUL ROMAN",,4,,499,287
28,"Neamț",270,"270-MUNICIPIUL ROMAN",120860,106,2,0,458,0,458,450,8,"MUNICIPIUL ROMAN",,4,,241,209
28,"Neamț",270,"270-MUNICIPIUL ROMAN",120860,107,2,119,494,68,426,493,1,"MUNICIPIUL ROMAN",,4,,175,318
28,"Neamț",270,"270-MUNICIPIUL ROMAN",120860,108,2,553,548,484,64,541,7,"MUNICIPIUL ROMAN",,4,,214,327
28,"Neamț",270,"270-MUNICIPIUL ROMAN",120860,109,2,337,331,298,33,331,0,"MUNICIPIUL ROMAN",,4,,152,179
28,"Neamț",270,"270-MUNICIPIUL ROMAN",120860,110,2,0,91,0,91,90,1,"MUNICIPIUL ROMAN",,4,,31,59
28,"Neamț",270,"270-ORAS BICAZ",120968,111,2,1273,927,859,68,922,5,"ORAS BICAZ",,4,,434,488
28,"Neamț",270,"270-ORAS BICAZ",120968,112,2,713,524,482,42,519,5,"ORAS BICAZ",,4,,283,236
28,"Neamț",270,"270-ORAS BICAZ",120968,113,2,1463,1040,939,101,1034,6,"ORAS BICAZ",,4,,463,571
28,"Neamț",270,"270-ORAS BICAZ",120968,114,2,453,339,301,38,337,2,"ORAS BICAZ",,4,,198,139
28,"Neamț",270,"270-ORAS BICAZ",120968,115,2,669,528,478,50,521,7,"ORAS BICAZ",,4,,273,248
28,"Neamț",270,"270-ORAS BICAZ",120968,116,2,1657,1207,1013,194,1203,4,"ORAS BICAZ",,4,,486,717
28,"Neamț",270,"270-ORAS BICAZ",120968,117,2,385,288,246,42,287,1,"ORAS BICAZ",,4,,142,145
28,"Neamț",270,"270-ORAS BICAZ",120968,118,2,243,177,156,21,176,1,"ORAS BICAZ",,4,,107,69
28,"Neamț",270,"270-ORAS BICAZ",120968,119,2,259,191,169,22,186,5,"ORAS BICAZ",,4,,113,73
28,"Neamț",270,"270-ORAS BICAZ",120968,120,2,94,100,69,31,99,1,"ORAS BICAZ",,4,,77,22
28,"Neamț",270,"270-ORAS TARGU NEAMT",121055,121,2,1451,1073,980,93,1063,10,"ORAS TARGU NEAMT",,4,,629,434
28,"Neamț",270,"270-ORAS TARGU NEAMT",121055,122,2,1487,1150,1059,91,1149,1,"ORAS TARGU NEAMT",,4,,608,541
28,"Neamț",270,"270-ORAS TARGU NEAMT",121055,123,2,1585,1135,1035,100,1130,5,"ORAS TARGU NEAMT",,4,,541,589
28,"Neamț",270,"270-ORAS TARGU NEAMT",121055,124,2,1633,1122,1045,77,1115,7,"ORAS TARGU NEAMT",,4,,548,567
28,"Neamț",270,"270-ORAS TARGU NEAMT",121055,125,2,1829,1279,1162,117,1274,5,"ORAS TARGU NEAMT",,4,,671,603
28,"Neamț",270,"270-ORAS TARGU NEAMT",121055,126,2,1725,1275,1189,86,1264,11,"ORAS TARGU NEAMT",,4,,730,534
28,"Neamț",270,"270-ORAS TARGU NEAMT",121055,127,2,1695,1277,1151,126,1268,9,"ORAS TARGU NEAMT",,4,,676,592
28,"Neamț",270,"270-ORAS TARGU NEAMT",121055,128,2,1657,1369,1123,246,1358,11,"ORAS TARGU NEAMT",,4,,739,619
28,"Neamț",270,"270-ORAS TARGU NEAMT",121055,129,2,703,566,515,51,559,7,"ORAS TARGU NEAMT",,4,,367,192
28,"Neamț",270,"270-ORAS TARGU NEAMT",121055,130,2,1385,1067,993,74,1056,11,"ORAS TARGU NEAMT",,4,,598,458
28,"Neamț",270,"270-ORAS TARGU NEAMT",121055,131,2,1378,1018,945,73,1002,16,"ORAS TARGU NEAMT",,4,,625,377
28,"Neamț",270,"270-ORAS TARGU NEAMT",121055,132,2,385,323,288,35,319,4,"ORAS TARGU NEAMT",,4,,221,98
28,"Neamț",270,"270-ORAS TARGU NEAMT",121055,133,2,0,233,0,233,229,4,"ORAS TARGU NEAMT",,4,,142,87
28,"Neamț",270,"270-AGAPIA",121108,134,2,1495,1036,838,198,1008,28,"AGAPIA",,4,,657,351
28,"Neamț",270,"270-AGAPIA",121108,135,2,824,661,608,53,660,1,"AGAPIA",,4,,424,236
28,"Neamț",270,"270-AGAPIA",121108,136,2,530,409,352,57,405,4,"AGAPIA",,4,,221,184
28,"Neamț",270,"270-AGAPIA",121108,137,2,770,618,523,95,609,9,"AGAPIA",,4,,457,152
28,"Neamț",270,"270-BAHNA",121153,138,2,751,474,439,35,468,6,"BAHNA",,4,,313,155
28,"Neamț",270,"270-BAHNA",121153,139,2,576,405,372,33,401,4,"BAHNA",,4,,297,104
28,"Neamț",270,"270-BAHNA",121153,140,2,330,241,210,31,238,3,"BAHNA",,4,,172,66
28,"Neamț",270,"270-BAHNA",121153,141,2,1450,954,862,92,946,8,"BAHNA",,4,,712,234
28,"Neamț",270,"270-BALTATESTI",121242,142,2,1623,1400,1079,321,1392,8,"BALTATESTI",,4,,898,494
28,"Neamț",270,"270-BALTATESTI",121242,143,2,1411,984,790,194,976,8,"BALTATESTI",,4,,746,230
28,"Neamț",270,"270-BALTATESTI",121242,144,2,651,465,341,124,461,4,"BALTATESTI",,4,,359,102
28,"Neamț",270,"270-BALTATESTI",121242,145,2,1366,926,861,65,917,9,"BALTATESTI",,4,,664,253
28,"Neamț",270,"270-BALTATESTI",121242,146,2,548,393,361,32,390,3,"BALTATESTI",,4,,280,110
28,"Neamț",270,"270-BICAZ-CHEI",121297,147,2,1949,1273,1076,197,1257,15,"BICAZ-CHEI",,4,,683,574
28,"Neamț",270,"270-BICAZ-CHEI",121297,148,2,803,553,452,101,547,6,"BICAZ-CHEI",,4,,273,274
28,"Neamț",270,"270-BICAZ-CHEI",121297,149,2,604,490,380,110,482,8,"BICAZ-CHEI",,4,,299,183
28,"Neamț",270,"270-BICAZU ARDELEAN",121340,150,2,282,218,197,21,216,2,"BICAZU ARDELEAN",,4,,98,118
28,"Neamț",270,"270-BICAZU ARDELEAN",121340,151,2,1331,937,845,92,927,10,"BICAZU ARDELEAN",,4,,459,468
28,"Neamț",270,"270-BICAZU ARDELEAN",121340,152,2,1252,822,791,31,815,7,"BICAZU ARDELEAN",,4,,531,284
28,"Neamț",270,"270-BICAZU ARDELEAN",121340,153,2,462,344,316,28,338,6,"BICAZU ARDELEAN",,4,,235,103
28,"Neamț",270,"270-BARA",121386,154,2,798,562,472,90,557,5,"BARA",,4,,331,226
28,"Neamț",270,"270-BARA",121386,155,2,746,477,436,41,472,5,"BARA",,4,,270,202
28,"Neamț",270,"270-BARA",121386,156,2,1162,819,669,150,813,6,"BARA",,4,,561,252
28,"Neamț",270,"270-BARA",121386,157,2,750,518,437,81,514,4,"BARA",,4,,375,139
28,"Neamț",270,"270-BARGAUANI",121466,158,2,1309,883,798,85,878,5,"BARGAUANI",,4,,563,315
28,"Neamț",270,"270-BARGAUANI",121466,159,2,767,722,605,117,710,12,"BARGAUANI",,4,,458,252
28,"Neamț",270,"270-BARGAUANI",121466,160,2,876,682,613,69,678,4,"BARGAUANI",,4,,406,272
28,"Neamț",270,"270-BARGAUANI",121466,161,2,585,479,407,72,470,9,"BARGAUANI",,4,,359,111
28,"Neamț",270,"270-BODESTI",121607,162,2,1740,1250,1058,192,1236,14,"BODESTI",,4,,934,302
28,"Neamț",270,"270-BODESTI",121607,163,2,593,421,351,70,415,6,"BODESTI",,4,,318,97
28,"Neamț",270,"270-BODESTI",121607,164,2,1011,696,587,109,683,13,"BODESTI",,4,,542,141
28,"Neamț",270,"270-BODESTI",121607,165,2,746,630,482,148,618,12,"BODESTI",,4,,498,120
28,"Neamț",270,"270-BORCA",121652,166,2,816,657,566,91,655,2,"BORCA",,4,,368,287
28,"Neamț",270,"270-BORCA",121652,167,2,905,760,688,72,752,8,"BORCA",,4,,517,235
28,"Neamț",270,"270-BORCA",121652,168,2,580,428,395,33,425,3,"BORCA",,4,,265,160
28,"Neamț",270,"270-BORCA",121652,169,2,1542,1207,1048,159,1200,6,"BORCA",,4,,719,481
28,"Neamț",270,"270-BORCA",121652,170,2,448,410,349,61,408,2,"BORCA",,4,,266,142
28,"Neamț",270,"270-BORCA",121652,171,2,677,494,437,57,493,1,"BORCA",,4,,288,205
28,"Neamț",270,"270-BORLESTI",121732,172,2,1443,996,917,79,988,8,"BORLESTI",,4,,610,378
28,"Neamț",270,"270-BORLESTI",121732,173,2,828,556,518,38,544,12,"BORLESTI",,4,,319,225
28,"Neamț",270,"270-BORLESTI",121732,174,2,1440,951,879,72,944,7,"BORLESTI",,4,,482,462
28,"Neamț",270,"270-BORLESTI",121732,175,2,221,169,145,24,168,1,"BORLESTI",,4,,100,68
28,"Neamț",270,"270-BORLESTI",121732,176,2,1436,966,853,113,957,9,"BORLESTI",,4,,584,373
28,"Neamț",270,"270-BORLESTI",121732,177,2,1150,740,639,101,726,14,"BORLESTI",,4,,431,295
28,"Neamț",270,"270-BORLESTI",121732,178,2,511,321,282,39,318,3,"BORLESTI",,4,,180,138
28,"Neamț",270,"270-BOTESTI",121796,179,2,468,455,371,84,447,8,"BOTESTI",,4,,349,98
28,"Neamț",270,"270-BOTESTI",121796,180,2,1540,1080,976,104,1070,10,"BOTESTI",,4,,379,691
28,"Neamț",270,"270-BOTESTI",121796,181,2,1631,1029,934,95,1013,16,"BOTESTI",,4,,489,524
28,"Neamț",270,"270-BOTESTI",121796,182,2,449,395,295,100,392,3,"BOTESTI",,4,,307,85
28,"Neamț",270,"270-BOTESTI",121796,183,2,772,567,488,79,565,2,"BOTESTI",,4,,487,78
28,"Neamț",270,"270-BOZIENI",121876,184,2,937,622,565,57,617,5,"BOZIENI",,4,,481,136
28,"Neamț",270,"270-BOZIENI",121876,185,2,693,519,447,72,513,6,"BOZIENI",,4,,389,124
28,"Neamț",270,"270-BOZIENI",121876,186,2,721,571,476,95,566,5,"BOZIENI",,4,,455,111
28,"Neamț",270,"270-BRUSTURI-DRAGANESTI",121938,187,2,1539,1030,937,93,1024,6,"BRUSTURI-DRAGANESTI",,4,,776,248
28,"Neamț",270,"270-BRUSTURI-DRAGANESTI",121938,188,2,891,647,587,60,643,4,"BRUSTURI-DRAGANESTI",,4,,434,209
28,"Neamț",270,"270-BRUSTURI-DRAGANESTI",121938,189,2,388,268,218,50,265,3,"BRUSTURI-DRAGANESTI",,4,,162,103
28,"Neamț",270,"270-BRUSTURI-DRAGANESTI",121938,190,2,602,476,417,59,471,5,"BRUSTURI-DRAGANESTI",,4,,370,101
28,"Neamț",270,"270-BRUSTURI-DRAGANESTI",121938,191,2,411,318,258,60,314,4,"BRUSTURI-DRAGANESTI",,4,,216,98
28,"Neamț",270,"270-BRUSTURI-DRAGANESTI",121938,192,2,572,371,320,51,369,2,"BRUSTURI-DRAGANESTI",,4,,285,84
28,"Neamț",270,"270-CEAHLAU",122025,193,2,1417,1090,984,106,1087,3,"CEAHLAU",,4,,769,318
28,"Neamț",270,"270-CEAHLAU",122025,194,2,619,495,432,63,492,3,"CEAHLAU",,4,,326,166
28,"Neamț",270,"270-CANDESTI",122061,195,2,1243,789,675,114,779,10,"CANDESTI",,4,,489,290
28,"Neamț",270,"270-CANDESTI",122061,196,2,912,617,543,74,609,8,"CANDESTI",,4,,415,194
28,"Neamț",270,"270-CANDESTI",122061,197,2,761,451,402,49,448,3,"CANDESTI",,4,,276,172
28,"Neamț",270,"270-CANDESTI",122061,198,2,318,221,199,22,220,1,"CANDESTI",,4,,126,94
28,"Neamț",270,"270-COSTISA",122132,199,2,1267,896,802,94,892,4,"COSTISA",,4,,636,256
28,"Neamț",270,"270-COSTISA",122132,200,2,769,554,499,55,553,1,"COSTISA",,4,,386,167
28,"Neamț",270,"270-COSTISA",122132,201,2,494,335,295,40,333,2,"COSTISA",,4,,175,158
28,"Neamț",270,"270-COSTISA",122132,202,2,253,232,178,54,228,4,"COSTISA",,4,,180,48
28,"Neamț",270,"270-CORDUN",120888,203,2,1223,914,758,156,909,5,"CORDUN",,4,,652,257
28,"Neamț",270,"270-CORDUN",120888,204,2,695,622,456,166,617,5,"CORDUN",,4,,459,158
28,"Neamț",270,"270-CORDUN",120888,205,2,565,502,387,115,497,5,"CORDUN",,4,,365,132
28,"Neamț",270,"270-CORDUN",120888,206,2,1518,1042,967,75,1034,8,"CORDUN",,4,,299,735
28,"Neamț",270,"270-CORDUN",120888,207,2,1344,850,803,47,844,6,"CORDUN",,4,,265,579
28,"Neamț",270,"270-CRACAOANI",122187,208,2,1667,1172,1056,116,1156,16,"CRACAOANI",,4,,785,371
28,"Neamț",270,"270-CRACAOANI",122187,209,2,541,481,418,63,479,2,"CRACAOANI",,4,,364,115
28,"Neamț",270,"270-CRACAOANI",122187,210,2,981,845,791,54,836,9,"CRACAOANI",,4,,664,172
28,"Neamț",270,"270-CRACAOANI",122187,211,2,275,225,204,21,224,1,"CRACAOANI",,4,,189,35
28,"Neamț",270,"270-DAMUC",122249,212,2,1244,692,640,52,679,13,"DAMUC",,4,,382,297
28,"Neamț",270,"270-DAMUC",122249,213,2,553,316,284,32,310,6,"DAMUC",,4,,214,96
28,"Neamț",270,"270-DAMUC",122249,214,2,566,330,292,38,325,5,"DAMUC",,4,,263,62
28,"Neamț",270,"270-DOBRENI",122285,215,2,1288,1069,925,144,1060,9,"DOBRENI",,4,,721,339
28,"Neamț",270,"270-DOBRENI",122285,216,2,1287,946,812,134,938,8,"DOBRENI",,4,,659,279
28,"Neamț",270,"270-DOBRENI",122285,217,2,278,243,202,41,238,5,"DOBRENI",,4,,170,68
28,"Neamț",270,"270-DOLJESTI",122347,218,2,1011,949,903,46,901,48,"DOLJESTI",,4,,771,130
28,"Neamț",270,"270-DOLJESTI",122347,219,2,432,289,244,45,286,3,"DOLJESTI",,4,,126,160
28,"Neamț",270,"270-DOLJESTI",122347,220,2,1148,823,762,61,813,10,"DOLJESTI",,4,,341,472
28,"Neamț",270,"270-DOLJESTI",122347,221,2,987,609,551,58,600,9,"DOLJESTI",,4,,173,427
28,"Neamț",270,"270-DOLJESTI",122347,222,2,1451,840,792,48,826,14,"DOLJESTI",,4,,216,610
28,"Neamț",270,"270-DRAGOMIRESTI",122392,223,2,1056,795,659,136,787,8,"DRAGOMIRESTI",,4,,590,197
28,"Neamț",270,"270-DRAGOMIRESTI",122392,224,2,939,563,496,67,560,3,"DRAGOMIRESTI",,4,,395,165
28,"Neamț",270,"270-DULCESTI",122463,225,2,790,765,599,166,720,45,"DULCESTI",,4,,561,159
28,"Neamț",270,"270-DULCESTI",122463,226,2,219,205,162,43,204,1,"DULCESTI",,4,,146,58
28,"Neamț",270,"270-DULCESTI",122463,227,2,193,296,146,150,295,1,"DULCESTI",,4,,261,34
28,"Neamț",270,"270-DULCESTI",122463,228,2,591,487,440,47,483,4,"DULCESTI",,4,,291,192
28,"Neamț",270,"270-DULCESTI",122463,229,2,580,559,458,101,553,6,"DULCESTI",,4,,426,127
28,"Neamț",270,"270-DULCESTI",122463,230,2,1613,1229,1087,142,1223,6,"DULCESTI",,4,,937,286
28,"Neamț",270,"270-DUMBRAVA ROSIE",120771,231,2,454,394,301,93,392,2,"DUMBRAVA ROSIE",,4,,171,221
28,"Neamț",270,"270-DUMBRAVA ROSIE",120771,232,2,1947,1302,1071,231,1281,21,"DUMBRAVA ROSIE",,4,,502,779
28,"Neamț",270,"270-DUMBRAVA ROSIE",120771,233,2,1557,1192,822,370,1182,10,"DUMBRAVA ROSIE",,4,,545,637
28,"Neamț",270,"270-DUMBRAVA ROSIE",120771,234,2,877,667,542,125,660,7,"DUMBRAVA ROSIE",,4,,304,356
28,"Neamț",270,"270-FARCASA",122551,235,2,1065,810,742,68,804,6,"FARCASA",,4,,440,364
28,"Neamț",270,"270-FARCASA",122551,236,2,797,642,564,78,638,4,"FARCASA",,4,,394,244
28,"Neamț",270,"270-FARCASA",122551,237,2,614,496,455,41,491,5,"FARCASA",,4,,262,229
28,"Neamț",270,"270-FAUREI",122613,238,2,741,541,447,94,533,8,"FAUREI",,4,,403,130
28,"Neamț",270,"270-FAUREI",122613,239,2,979,736,647,89,733,3,"FAUREI",,4,,549,184
28,"Neamț",270,"270-FAUREI",122613,240,2,305,235,196,39,233,2,"FAUREI",,4,,182,51
28,"Neamț",270,"270-GHERAESTI",122668,241,2,1841,1182,1089,93,1174,8,"GHERAESTI",,4,,664,510
28,"Neamț",270,"270-GHERAESTI",122668,242,2,1744,1109,1056,53,1098,11,"GHERAESTI",,4,,644,454
28,"Neamț",270,"270-GHERAESTI",122668,243,2,467,351,301,50,346,5,"GHERAESTI",,4,,235,111
28,"Neamț",270,"270-GHERAESTI",122668,244,2,698,454,389,65,450,4,"GHERAESTI",,4,,226,224
28,"Neamț",270,"270-GIROV",122702,245,2,1145,884,506,378,875,9,"GIROV",,4,,484,391
28,"Neamț",270,"270-GIROV",122702,246,2,1654,1341,955,386,1326,15,"GIROV",,4,,891,435
28,"Neamț",270,"270-GIROV",122702,247,2,596,372,330,42,370,2,"GIROV",,4,,223,147
28,"Neamț",270,"270-GIROV",122702,248,2,795,521,367,154,516,5,"GIROV",,4,,296,220
28,"Neamț",270,"270-GIROV",122702,249,2,675,473,341,132,464,9,"GIROV",,4,,311,153
28,"Neamț",270,"270-GIROV",122702,250,2,211,199,120,79,197,2,"GIROV",,4,,128,69
28,"Neamț",270,"270-GIROV",122702,251,2,342,249,187,62,246,3,"GIROV",,4,,154,92
28,"Neamț",270,"270-GIROV",122702,252,2,239,277,173,104,271,6,"GIROV",,4,,204,67
28,"Neamț",270,"270-GARCINA",122828,253,2,1005,822,723,99,819,3,"GARCINA",,4,,496,323
28,"Neamț",270,"270-GARCINA",122828,254,2,856,705,606,99,696,9,"GARCINA",,4,,441,255
28,"Neamț",270,"270-GARCINA",122828,255,2,448,427,352,75,421,6,"GARCINA",,4,,251,170
28,"Neamț",270,"270-GARCINA",122828,256,2,955,733,651,82,720,13,"GARCINA",,4,,383,337
28,"Neamț",270,"270-GRINTIES",122864,257,2,1453,1006,894,112,988,18,"GRINTIES",,4,,522,466
28,"Neamț",270,"270-GRINTIES",122864,258,2,616,506,460,46,499,7,"GRINTIES",,4,,242,257
28,"Neamț",270,"270-GRUMAZESTI",122908,259,2,1384,920,881,39,916,4,"GRUMAZESTI",,4,,662,254
28,"Neamț",270,"270-GRUMAZESTI",122908,260,2,1111,828,751,77,819,9,"GRUMAZESTI",,4,,629,190
28,"Neamț",270,"270-GRUMAZESTI",122908,261,2,549,401,371,30,399,2,"GRUMAZESTI",,4,,300,99
28,"Neamț",270,"270-GRUMAZESTI",122908,262,2,1326,1036,986,50,1027,9,"GRUMAZESTI",,4,,754,273
28,"Neamț",270,"270-HANGU",122953,263,2,1528,985,879,106,969,16,"HANGU",,4,,614,355
28,"Neamț",270,"270-HANGU",122953,264,2,531,399,330,69,396,3,"HANGU",,4,,253,143
28,"Neamț",270,"270-HANGU",122953,265,2,1023,738,677,61,726,12,"HANGU",,4,,470,256
28,"Neamț",270,"270-HANGU",122953,266,2,435,293,252,41,289,4,"HANGU",,4,,191,98
28,"Neamț",270,"270-HORIA",120922,267,2,1355,1088,939,149,1080,8,"HORIA",,4,,652,428
28,"Neamț",270,"270-HORIA",120922,268,2,1329,947,869,78,938,9,"HORIA",,4,,628,310
28,"Neamț",270,"270-HORIA",120922,269,2,1244,938,867,71,925,13,"HORIA",,4,,625,300
28,"Neamț",270,"270-HORIA",120922,270,2,1249,954,860,94,947,7,"HORIA",,4,,594,353
28,"Neamț",270,"270-ICUSESTI",123013,271,2,743,519,433,86,509,10,"ICUSESTI",,4,,332,177
28,"Neamț",270,"270-ICUSESTI",123013,272,2,698,508,386,122,505,3,"ICUSESTI",,4,,331,174
28,"Neamț",270,"270-ICUSESTI",123013,273,2,1036,756,671,85,751,5,"ICUSESTI",,4,,400,351
28,"Neamț",270,"270-ICUSESTI",123013,274,2,378,311,275,36,271,4,"ICUSESTI",,4,,189,82
28,"Neamț",270,"270-ICUSESTI",123013,275,2,441,367,266,101,360,7,"ICUSESTI",,4,,254,106
28,"Neamț",270,"270-ICUSESTI",123013,276,2,233,216,167,49,214,2,"ICUSESTI",,4,,173,41
28,"Neamț",270,"270-ION CREANGA",123102,277,2,1762,1348,1196,152,1331,17,"ION CREANGA",,4,,922,409
28,"Neamț",270,"270-ION CREANGA",123102,278,2,1074,966,853,113,948,18,"ION CREANGA",,4,,712,236
28,"Neamț",270,"270-ION CREANGA",123102,279,2,562,480,388,92,479,1,"ION CREANGA",,4,,358,121
28,"Neamț",270,"270-ION CREANGA",123102,280,2,688,541,481,60,539,2,"ION CREANGA",,4,,415,124
28,"Neamț",270,"270-MARGINENI",123175,281,2,1974,1272,1076,196,1258,14,"MARGINENI",,4,,1044,214
28,"Neamț",270,"270-MARGINENI",123175,282,2,929,617,512,105,604,13,"MARGINENI",,4,,479,125
28,"Neamț",270,"270-MARGINENI",123175,283,2,204,196,128,68,194,2,"MARGINENI",,4,,162,32
28,"Neamț",270,"270-MARGINENI",123175,284,2,304,228,165,63,223,5,"MARGINENI",,4,,190,33
28,"Neamț",270,"270-MOLDOVENI",123228,285,2,1208,846,746,100,832,14,"MOLDOVENI",,4,,540,292
28,"Neamț",270,"270-MOLDOVENI",123228,286,2,1020,689,594,95,678,11,"MOLDOVENI",,4,,433,245
28,"Neamț",270,"270-ONICENI",123255,287,2,660,402,337,65,399,3,"ONICENI",,4,,302,97
28,"Neamț",270,"270-ONICENI",123255,288,2,384,293,243,50,291,2,"ONICENI",,4,,250,41
28,"Neamț",270,"270-ONICENI",123255,289,2,738,494,451,43,487,7,"ONICENI",,4,,390,97
28,"Neamț",270,"270-ONICENI",123255,290,2,541,377,330,47,372,5,"ONICENI",,4,,320,52
28,"Neamț",270,"270-PASTRAVENI",123371,291,2,1324,950,841,109,946,4,"PASTRAVENI",,4,,782,164
28,"Neamț",270,"270-PASTRAVENI",123371,292,2,1339,832,745,87,822,10,"PASTRAVENI",,4,,638,184
28,"Neamț",270,"270-PASTRAVENI",123371,293,2,238,222,168,54,221,1,"PASTRAVENI",,4,,182,39
28,"Neamț",270,"270-PETRICANI",123424,294,2,1464,949,819,130,939,10,"PETRICANI",,4,,696,243
28,"Neamț",270,"270-PETRICANI",123424,295,2,706,561,518,43,555,6,"PETRICANI",,4,,467,88
28,"Neamț",270,"270-PETRICANI",123424,296,2,997,759,654,105,750,9,"PETRICANI",,4,,503,247
28,"Neamț",270,"270-PETRICANI",123424,297,2,811,567,468,99,560,7,"PETRICANI",,4,,453,107
28,"Neamț",270,"270-PIATRA SOIMULUI",123479,298,2,1320,1008,892,116,1002,6,"PIATRA SOIMULUI",,4,,542,460
28,"Neamț",270,"270-PIATRA SOIMULUI",123479,299,2,1399,1044,962,82,1035,9,"PIATRA SOIMULUI",,4,,494,541
28,"Neamț",270,"270-PIATRA SOIMULUI",123479,300,2,1992,1431,1330,101,1424,7,"PIATRA SOIMULUI",,4,,818,606
28,"Neamț",270,"270-PIATRA SOIMULUI",123479,301,2,484,398,363,35,394,4,"PIATRA SOIMULUI",,4,,208,186
28,"Neamț",270,"270-PIATRA SOIMULUI",123479,302,2,994,669,631,38,657,12,"PIATRA SOIMULUI",,4,,439,218
28,"Neamț",270,"270-PIPIRIG",123521,303,2,1986,1347,1267,80,1341,6,"PIPIRIG",,4,,895,446
28,"Neamț",270,"270-PIPIRIG",123521,304,2,799,514,491,23,511,3,"PIPIRIG",,4,,352,159
28,"Neamț",270,"270-PIPIRIG",123521,305,2,1273,835,811,24,830,5,"PIPIRIG",,4,,619,211
28,"Neamț",270,"270-PIPIRIG",123521,306,2,386,297,258,39,297,0,"PIPIRIG",,4,,208,89
28,"Neamț",270,"270-PIPIRIG",123521,307,2,836,527,481,46,521,6,"PIPIRIG",,4,,303,218
28,"Neamț",270,"270-PIPIRIG",123521,308,2,797,493,459,34,480,13,"PIPIRIG",,4,,307,173
28,"Neamț",270,"270-PANGARATI",123601,309,2,1270,938,766,172,930,8,"PANGARATI",,4,,618,312
28,"Neamț",270,"270-PANGARATI",123601,310,2,515,478,378,100,476,2,"PANGARATI",,4,,269,207
28,"Neamț",270,"270-PANGARATI",123601,311,2,730,680,541,139,673,7,"PANGARATI",,4,,336,337
28,"Neamț",270,"270-PANGARATI",123601,312,2,1200,845,710,135,841,4,"PANGARATI",,4,,472,369
28,"Neamț",270,"270-PODOLENI",123674,313,2,1810,1348,1163,185,1341,7,"PODOLENI",,4,,856,485
28,"Neamț",270,"270-PODOLENI",123674,314,2,1218,829,762,67,826,3,"PODOLENI",,4,,510,316
28,"Neamț",270,"270-PODOLENI",123674,315,2,1005,712,637,75,708,4,"PODOLENI",,4,,457,251
28,"Neamț",270,"270-PODOLENI",123674,316,2,386,293,266,27,291,2,"PODOLENI",,4,,213,78
28,"Neamț",270,"270-POIENARI",123709,317,2,1082,714,612,102,710,4,"POIENARI",,4,,604,106
28,"Neamț",270,"270-POIENARI",123709,318,2,1005,658,578,80,651,7,"POIENARI",,4,,498,153
28,"Neamț",270,"270-POIENARI",123709,319,2,320,262,224,38,258,4,"POIENARI",,4,,203,55
28,"Neamț",270,"270-POIENARI",123709,320,2,356,278,225,53,277,1,"POIENARI",,4,,215,62
28,"Neamț",270,"270-POIANA TEIULUI",123790,321,2,1237,1126,960,166,1113,13,"POIANA TEIULUI",,4,,631,482
28,"Neamț",270,"270-POIANA TEIULUI",123790,322,2,1026,839,734,105,834,5,"POIANA TEIULUI",,4,,560,274
28,"Neamț",270,"270-POIANA TEIULUI",123790,323,2,781,648,557,91,640,8,"POIANA TEIULUI",,4,,441,199
28,"Neamț",270,"270-POIANA TEIULUI",123790,324,2,807,634,561,73,630,4,"POIANA TEIULUI",,4,,471,159
28,"Neamț",270,"270-RAUCESTI",123914,325,2,1110,862,740,122,853,9,"RAUCESTI",,4,,693,160
28,"Neamț",270,"270-RAUCESTI",123914,326,2,1219,895,796,99,889,6,"RAUCESTI",,4,,704,185
28,"Neamț",270,"270-RAUCESTI",123914,327,2,705,579,483,96,577,2,"RAUCESTI",,4,,461,116
28,"Neamț",270,"270-RAUCESTI",123914,328,2,1690,1313,1160,153,1300,13,"RAUCESTI",,4,,1066,234
28,"Neamț",270,"270-RAUCESTI",123914,329,2,390,316,271,45,312,4,"RAUCESTI",,4,,261,51
28,"Neamț",270,"270-RAUCESTI",123914,330,2,452,417,352,65,413,4,"RAUCESTI",,4,,327,86
28,"Neamț",270,"270-RAZBOIENI",123969,331,2,1114,776,589,187,761,15,"RAZBOIENI",,4,,554,207
28,"Neamț",270,"270-RAZBOIENI",123969,332,2,803,732,576,156,721,11,"RAZBOIENI",,4,,563,158
28,"Neamț",270,"270-REDIU",121448,333,2,1654,1029,860,169,1013,16,"REDIU",,4,,612,401
28,"Neamț",270,"270-REDIU",121448,334,2,1013,642,501,141,638,4,"REDIU",,4,,295,343
28,"Neamț",270,"270-REDIU",121448,335,2,567,423,331,92,421,2,"REDIU",,4,,268,153
28,"Neamț",270,"270-REDIU",121448,336,2,632,391,304,87,384,7,"REDIU",,4,,267,117
28,"Neamț",270,"270-ROMANI",124073,337,2,813,674,581,93,663,11,"ROMANI",,4,,475,188
28,"Neamț",270,"270-ROMANI",124073,338,2,1048,777,691,86,769,8,"ROMANI",,4,,608,161
28,"Neamț",270,"270-ROMANI",124073,339,2,752,588,523,65,584,4,"ROMANI",,4,,415,169
28,"Neamț",270,"270-ROMANI",124073,340,2,946,717,641,76,705,12,"ROMANI",,4,,572,133
28,"Neamț",270,"270-ROZNOV",124126,341,2,1327,974,742,232,967,7,"ROZNOV",,4,,516,451
28,"Neamț",270,"270-ROZNOV",124126,342,2,1093,837,637,200,827,10,"ROZNOV",,4,,445,382
28,"Neamț",270,"270-ROZNOV",124126,343,2,1044,802,627,175,787,14,"ROZNOV",,4,,499,288
28,"Neamț",270,"270-ROZNOV",124126,344,2,881,617,541,76,604,13,"ROZNOV",,4,,331,273
28,"Neamț",270,"270-ROZNOV",124126,345,2,1560,1125,984,141,1108,17,"ROZNOV",,4,,644,464
28,"Neamț",270,"270-ROZNOV",124126,346,2,935,742,587,155,738,4,"ROZNOV",,4,,432,306
28,"Neamț",270,"270-SAGNA",124153,347,2,1330,933,866,67,928,5,"SAGNA",,4,,288,640
28,"Neamț",270,"270-SAGNA",124153,348,2,1193,944,857,87,939,5,"SAGNA",,4,,370,569
28,"Neamț",270,"270-SAGNA",124153,349,2,1624,1283,1146,137,1272,11,"SAGNA",,4,,785,487
28,"Neamț",270,"270-SAGNA",124153,350,2,316,294,244,50,294,0,"SAGNA",,4,,214,80
28,"Neamț",270,"270-SAGNA",124153,351,2,664,542,439,103,538,4,"SAGNA",,4,,415,123
28,"Neamț",270,"270-SABAOANI",124206,352,2,1924,1166,1127,39,1157,9,"SABAOANI",,4,,435,722
28,"Neamț",270,"270-SABAOANI",124206,353,2,2078,1350,1260,90,1327,23,"SABAOANI",,4,,441,886
28,"Neamț",270,"270-SABAOANI",124206,354,2,1549,944,896,48,926,18,"SABAOANI",,4,,323,603
28,"Neamț",270,"270-SABAOANI",124206,355,2,1800,1114,1077,37,1096,18,"SABAOANI",,4,,329,767
28,"Neamț",270,"270-SABAOANI",124206,356,2,795,637,577,60,627,10,"SABAOANI",,4,,315,312
28,"Neamț",270,"270-SAVINESTI",120824,357,2,2037,1552,1159,393,1543,9,"SAVINESTI",,4,,665,878
28,"Neamț",270,"270-SAVINESTI",120824,358,2,1388,1065,870,195,1055,10,"SAVINESTI",,4,,487,568
28,"Neamț",270,"270-SAVINESTI",120824,359,2,994,848,689,159,836,12,"SAVINESTI",,4,,439,397
28,"Neamț",270,"270-SAVINESTI",120824,360,2,352,293,247,46,291,2,"SAVINESTI",,4,,165,126
28,"Neamț",270,"270-SECUIENI",124233,361,2,1006,756,619,137,751,5,"SECUIENI",,4,,511,240
28,"Neamț",270,"270-SECUIENI",124233,362,2,503,435,359,76,430,5,"SECUIENI",,4,,274,156
28,"Neamț",270,"270-SECUIENI",124233,363,2,1081,822,684,138,817,5,"SECUIENI",,4,,659,158
28,"Neamț",270,"270-SECUIENI",124233,364,2,309,205,152,53,204,1,"SECUIENI",,4,,159,45
28,"Neamț",270,"270-STANITA",124331,365,2,978,720,617,103,712,8,"STANITA",,4,,398,314
28,"Neamț",270,"270-STANITA",124331,366,2,991,625,534,91,612,13,"STANITA",,4,,421,191
28,"Neamț",270,"270-STEFAN CEL MARE",124411,367,2,1353,1156,1025,131,1150,6,"STEFAN CEL MARE",,4,,909,241
28,"Neamț",270,"270-STEFAN CEL MARE",124411,368,2,521,439,366,73,432,7,"STEFAN CEL MARE",,4,,290,142
28,"Neamț",270,"270-STEFAN CEL MARE",124411,369,2,767,524,424,100,522,2,"STEFAN CEL MARE",,4,,367,155
28,"Neamț",270,"270-TARCAU",124493,370,2,1489,1146,996,150,1142,4,"TARCAU",,4,,560,582
28,"Neamț",270,"270-TARCAU",124493,371,2,531,430,343,87,425,5,"TARCAU",,4,,225,200
28,"Neamț",270,"270-TARCAU",124493,372,2,390,333,254,79,330,3,"TARCAU",,4,,148,182
28,"Neamț",270,"270-TARCAU",124493,373,2,290,255,175,80,252,3,"TARCAU",,4,,72,180
28,"Neamț",270,"270-TASCA",124563,374,2,1342,1130,1027,103,1123,7,"TASCA",,4,,569,554
28,"Neamț",270,"270-TASCA",124563,375,2,685,543,473,70,539,4,"TASCA",,4,,311,228
28,"Neamț",270,"270-TAZLAU",124616,376,2,1060,790,750,40,786,4,"TAZLAU",,4,,538,248
28,"Neamț",270,"270-TAZLAU",124616,377,2,1273,995,935,60,985,10,"TAZLAU",,4,,682,303
28,"Neamț",270,"270-TAMASENI",124634,378,2,1128,820,741,79,805,15,"TAMASENI",,4,,344,461
28,"Neamț",270,"270-TAMASENI",124634,379,2,689,480,435,45,474,6,"TAMASENI",,4,,185,289
28,"Neamț",270,"270-TAMASENI",124634,380,2,1057,711,654,57,703,8,"TAMASENI",,4,,322,381
28,"Neamț",270,"270-TAMASENI",124634,381,2,1306,844,743,101,830,14,"TAMASENI",,4,,208,622
28,"Neamț",270,"270-TAMASENI",124634,382,2,898,514,462,52,506,8,"TAMASENI",,4,,111,395
28,"Neamț",270,"270-TAMASENI",124634,383,2,884,559,482,77,555,4,"TAMASENI",,4,,169,386
28,"Neamț",270,"270-TIMISESTI",124661,384,2,1092,849,762,87,839,10,"TIMISESTI",,4,,563,276
28,"Neamț",270,"270-TIMISESTI",124661,385,2,830,699,594,105,694,5,"TIMISESTI",,4,,544,150
28,"Neamț",270,"270-TIMISESTI",124661,386,2,585,479,439,40,475,4,"TIMISESTI",,4,,346,129
28,"Neamț",270,"270-TIMISESTI",124661,387,2,482,388,342,46,386,2,"TIMISESTI",,4,,301,85
28,"Neamț",270,"270-TRIFESTI",124723,388,2,1824,1264,1092,172,1256,8,"TRIFESTI",,4,,982,274
28,"Neamț",270,"270-TRIFESTI",124723,389,2,668,608,418,190,594,14,"TRIFESTI",,4,,422,172
28,"Neamț",270,"270-TRIFESTI",124723,390,2,833,776,597,179,766,10,"TRIFESTI",,4,,603,163
28,"Neamț",270,"270-TRIFESTI",124723,391,2,827,589,476,113,583,6,"TRIFESTI",,4,,466,117
28,"Neamț",270,"270-TUPILATI",124750,392,2,1631,1153,991,162,1143,10,"TUPILATI",,4,,813,330
28,"Neamț",270,"270-TUPILATI",124750,393,2,330,264,184,80,259,5,"TUPILATI",,4,,181,78
28,"Neamț",270,"270-TIBUCANI",124803,394,2,1356,1000,812,188,982,18,"TIBUCANI",,4,,724,258
28,"Neamț",270,"270-TIBUCANI",124803,395,2,965,724,569,155,713,11,"TIBUCANI",,4,,559,154
28,"Neamț",270,"270-TIBUCANI",124803,396,2,412,339,256,83,336,3,"TIBUCANI",,4,,234,102
28,"Neamț",270,"270-TIBUCANI",124803,397,2,823,657,527,130,650,7,"TIBUCANI",,4,,479,171
28,"Neamț",270,"270-URECHENI",124849,398,2,1713,1142,880,262,1117,25,"URECHENI",,4,,855,262
28,"Neamț",270,"270-URECHENI",124849,399,2,653,562,304,258,553,9,"URECHENI",,4,,483,70
28,"Neamț",270,"270-URECHENI",124849,400,2,742,658,572,86,653,5,"URECHENI",,4,,474,179
28,"Neamț",270,"270-VALEA URSULUI",124885,401,2,678,417,328,89,411,6,"VALEA URSULUI",,4,,329,82
28,"Neamț",270,"270-VALEA URSULUI",124885,402,2,483,431,352,79,428,3,"VALEA URSULUI",,4,,343,85
28,"Neamț",270,"270-VALEA URSULUI",124885,403,2,796,565,469,96,559,6,"VALEA URSULUI",,4,,365,194
28,"Neamț",270,"270-VALEA URSULUI",124885,404,2,605,411,358,53,407,4,"VALEA URSULUI",,4,,245,162
28,"Neamț",270,"270-VALEA URSULUI",124885,405,2,287,293,190,103,293,0,"VALEA URSULUI",,4,,215,78
28,"Neamț",270,"270-VIISOARA",124947,406,2,756,438,386,52,436,2,"VIISOARA",,4,,220,216
28,"Neamț",270,"270-VIISOARA",124947,407,2,1283,1008,866,142,995,13,"VIISOARA",,4,,511,484
28,"Neamț",270,"270-VIISOARA",124947,408,2,651,568,486,82,562,6,"VIISOARA",,4,,311,251
28,"Neamț",270,"270-VIISOARA",124947,409,2,1018,856,792,64,846,10,"VIISOARA",,4,,522,324
28,"Neamț",270,"270-VIISOARA",124947,410,2,53,369,31,338,364,5,"VIISOARA",,4,,200,164
28,"Neamț",270,"270-VANATORI-NEAMT",125016,411,2,1194,1015,839,176,1005,10,"VANATORI-NEAMT",,4,,623,382
28,"Neamț",270,"270-VANATORI-NEAMT",125016,412,2,1078,848,736,112,837,11,"VANATORI-NEAMT",,4,,570,267
28,"Neamț",270,"270-VANATORI-NEAMT",125016,413,2,1242,1000,918,82,988,12,"VANATORI-NEAMT",,4,,683,305
28,"Neamț",270,"270-VANATORI-NEAMT",125016,414,2,929,755,714,41,751,4,"VANATORI-NEAMT",,4,,492,259
28,"Neamț",270,"270-VANATORI-NEAMT",125016,415,2,257,282,186,96,279,3,"VANATORI-NEAMT",,4,,183,96
28,"Neamț",270,"270-VANATORI-NEAMT",125016,416,2,1127,967,822,145,960,7,"VANATORI-NEAMT",,4,,677,283
28,"Neamț",270,"270-VANATORI-NEAMT",125016,417,2,197,260,101,159,249,11,"VANATORI-NEAMT",,4,,87,162
28,"Neamț",270,"270-ZANESTI",125061,418,2,1514,1135,959,176,1109,26,"ZANESTI",,4,,728,381
28,"Neamț",270,"270-ZANESTI",125061,419,2,1396,1036,857,179,1029,7,"ZANESTI",,4,,681,348
28,"Neamț",270,"270-ZANESTI",125061,420,2,996,734,617,117,723,11,"ZANESTI",,4,,494,229
28,"Neamț",270,"270-ZANESTI",125061,421,2,748,669,535,134,664,5,"ZANESTI",,4,,519,145
29,"Olt",289,"289-MUNICIPIUL SLATINA",125347,1,2,2150,1474,1370,104,1465,9,"MUNICIPIUL SLATINA",,6,,687,778
29,"Olt",289,"289-MUNICIPIUL SLATINA",125347,2,2,1626,1094,986,108,1078,16,"MUNICIPIUL SLATINA",,6,,567,511
29,"Olt",289,"289-MUNICIPIUL SLATINA",125347,3,2,1776,1280,1126,154,1275,5,"MUNICIPIUL SLATINA",,6,,636,639
29,"Olt",289,"289-MUNICIPIUL SLATINA",125347,4,2,2270,1333,1213,120,1327,6,"MUNICIPIUL SLATINA",,6,,676,651
29,"Olt",289,"289-MUNICIPIUL SLATINA",125347,5,2,2463,1596,1471,125,1587,9,"MUNICIPIUL SLATINA",,6,,712,875
29,"Olt",289,"289-MUNICIPIUL SLATINA",125347,6,2,1930,1254,1147,107,1243,11,"MUNICIPIUL SLATINA",,6,,699,544
29,"Olt",289,"289-MUNICIPIUL SLATINA",125347,7,2,1834,1084,1009,75,1080,4,"MUNICIPIUL SLATINA",,6,,557,523
29,"Olt",289,"289-MUNICIPIUL SLATINA",125347,8,2,2452,1554,1255,299,1550,4,"MUNICIPIUL SLATINA",,6,,759,791
29,"Olt",289,"289-MUNICIPIUL SLATINA",125347,9,2,2397,1739,1482,257,1732,7,"MUNICIPIUL SLATINA",,6,,879,853
29,"Olt",289,"289-MUNICIPIUL SLATINA",125347,10,2,2008,1289,1115,174,1286,3,"MUNICIPIUL SLATINA",,6,,684,602
29,"Olt",289,"289-MUNICIPIUL SLATINA",125347,11,2,1712,1191,1101,90,1185,6,"MUNICIPIUL SLATINA",,6,,613,572
29,"Olt",289,"289-MUNICIPIUL SLATINA",125347,12,2,2323,1486,1310,176,1472,14,"MUNICIPIUL SLATINA",,6,,784,688
29,"Olt",289,"289-MUNICIPIUL SLATINA",125347,13,2,2406,1531,1399,132,1525,6,"MUNICIPIUL SLATINA",,6,,826,699
29,"Olt",289,"289-MUNICIPIUL SLATINA",125347,14,2,2587,1607,1465,142,1595,12,"MUNICIPIUL SLATINA",,6,,834,761
29,"Olt",289,"289-MUNICIPIUL SLATINA",125347,15,2,2434,1554,1431,123,1544,10,"MUNICIPIUL SLATINA",,6,,906,638
29,"Olt",289,"289-MUNICIPIUL SLATINA",125347,16,2,2122,1290,1176,114,1283,7,"MUNICIPIUL SLATINA",,6,,652,631
29,"Olt",289,"289-MUNICIPIUL SLATINA",125347,17,2,1408,1113,866,247,1106,7,"MUNICIPIUL SLATINA",,6,,612,494
29,"Olt",289,"289-MUNICIPIUL SLATINA",125347,18,2,1386,885,707,178,880,5,"MUNICIPIUL SLATINA",,6,,423,457
29,"Olt",289,"289-MUNICIPIUL SLATINA",125347,19,2,3008,1946,1694,252,1945,1,"MUNICIPIUL SLATINA",,6,,1070,875
29,"Olt",289,"289-MUNICIPIUL SLATINA",125347,20,2,2600,1696,1374,322,1692,4,"MUNICIPIUL SLATINA",,6,,850,842
29,"Olt",289,"289-MUNICIPIUL SLATINA",125347,21,2,2088,1222,1131,91,1213,9,"MUNICIPIUL SLATINA",,6,,640,573
29,"Olt",289,"289-MUNICIPIUL SLATINA",125347,22,2,2529,1668,1386,282,1664,4,"MUNICIPIUL SLATINA",,6,,879,785
29,"Olt",289,"289-MUNICIPIUL SLATINA",125347,23,2,506,464,304,160,461,3,"MUNICIPIUL SLATINA",,6,,217,244
29,"Olt",289,"289-MUNICIPIUL SLATINA",125347,24,2,2829,1733,1543,190,1719,14,"MUNICIPIUL SLATINA",,6,,807,912
29,"Olt",289,"289-MUNICIPIUL SLATINA",125347,25,2,2605,1745,1529,216,1732,13,"MUNICIPIUL SLATINA",,6,,799,933
29,"Olt",289,"289-MUNICIPIUL SLATINA",125347,26,2,1916,1241,1141,100,1235,6,"MUNICIPIUL SLATINA",,6,,570,665
29,"Olt",289,"289-MUNICIPIUL SLATINA",125347,27,2,2096,1251,1183,68,1241,10,"MUNICIPIUL SLATINA",,6,,596,645
29,"Olt",289,"289-MUNICIPIUL SLATINA",125347,28,2,954,646,584,62,636,10,"MUNICIPIUL SLATINA",,6,,404,232
29,"Olt",289,"289-MUNICIPIUL SLATINA",125347,29,2,913,793,508,285,789,4,"MUNICIPIUL SLATINA",,6,,350,439
29,"Olt",289,"289-MUNICIPIUL SLATINA",125347,30,2,2824,1581,1478,103,1578,3,"MUNICIPIUL SLATINA",,6,,760,818
29,"Olt",289,"289-MUNICIPIUL SLATINA",125347,31,2,933,615,559,56,608,7,"MUNICIPIUL SLATINA",,6,,404,204
29,"Olt",289,"289-MUNICIPIUL SLATINA",125347,32,2,1368,1073,825,248,1061,12,"MUNICIPIUL SLATINA",,6,,536,525
29,"Olt",289,"289-MUNICIPIUL SLATINA",125347,33,2,0,793,0,793,784,9,"MUNICIPIUL SLATINA",,6,,450,334
29,"Olt",289,"289-MUNICIPIUL SLATINA",125347,34,2,0,248,0,248,244,4,"MUNICIPIUL SLATINA",,6,,154,90
29,"Olt",289,"289-MUNICIPIUL SLATINA",125347,35,2,0,305,0,305,301,4,"MUNICIPIUL SLATINA",,6,,180,121
29,"Olt",289,"289-MUNICIPIUL CARACAL",125472,36,2,1680,1138,1046,92,1131,7,"MUNICIPIUL CARACAL",,6,,660,471
29,"Olt",289,"289-MUNICIPIUL CARACAL",125472,37,2,1520,1182,1045,137,1167,15,"MUNICIPIUL CARACAL",,6,,695,472
29,"Olt",289,"289-MUNICIPIUL CARACAL",125472,38,2,1775,1298,1098,200,1294,4,"MUNICIPIUL CARACAL",,6,,763,531
29,"Olt",289,"289-MUNICIPIUL CARACAL",125472,39,2,1802,1112,1008,104,1101,11,"MUNICIPIUL CARACAL",,6,,650,451
29,"Olt",289,"289-MUNICIPIUL CARACAL",125472,40,2,1410,1165,806,359,1156,9,"MUNICIPIUL CARACAL",,6,,615,541
29,"Olt",289,"289-MUNICIPIUL CARACAL",125472,41,2,1928,1016,823,193,1011,5,"MUNICIPIUL CARACAL",,6,,585,426
29,"Olt",289,"289-MUNICIPIUL CARACAL",125472,42,2,1797,1030,888,142,1024,6,"MUNICIPIUL CARACAL",,6,,582,442
29,"Olt",289,"289-MUNICIPIUL CARACAL",125472,43,2,1530,1192,916,276,1186,6,"MUNICIPIUL CARACAL",,6,,680,506
29,"Olt",289,"289-MUNICIPIUL CARACAL",125472,44,2,1838,1222,938,284,1217,5,"MUNICIPIUL CARACAL",,6,,742,475
29,"Olt",289,"289-MUNICIPIUL CARACAL",125472,45,2,1632,1227,1034,193,1207,20,"MUNICIPIUL CARACAL",,6,,644,563
29,"Olt",289,"289-MUNICIPIUL CARACAL",125472,46,2,2108,1305,1157,148,1298,7,"MUNICIPIUL CARACAL",,6,,745,553
29,"Olt",289,"289-MUNICIPIUL CARACAL",125472,47,2,2270,1399,1290,109,1377,22,"MUNICIPIUL CARACAL",,6,,840,537
29,"Olt",289,"289-MUNICIPIUL CARACAL",125472,48,2,1485,1192,959,233,1190,2,"MUNICIPIUL CARACAL",,6,,609,581
29,"Olt",289,"289-MUNICIPIUL CARACAL",125472,49,2,1721,1265,1202,63,1256,9,"MUNICIPIUL CARACAL",,6,,804,452
29,"Olt",289,"289-MUNICIPIUL CARACAL",125472,50,2,1675,1232,1145,87,1222,10,"MUNICIPIUL CARACAL",,6,,656,566
29,"Olt",289,"289-MUNICIPIUL CARACAL",125472,51,2,1750,1264,1188,76,1253,11,"MUNICIPIUL CARACAL",,6,,831,422
29,"Olt",289,"289-MUNICIPIUL CARACAL",125472,52,2,1600,1230,1155,75,1227,3,"MUNICIPIUL CARACAL",,6,,750,477
29,"Olt",289,"289-MUNICIPIUL CARACAL",125472,53,2,0,258,0,258,254,4,"MUNICIPIUL CARACAL",,6,,124,130
29,"Olt",289,"289-MUNICIPIUL CARACAL",125472,54,2,0,393,0,393,385,8,"MUNICIPIUL CARACAL",,6,,135,250
29,"Olt",289,"289-MUNICIPIUL CARACAL",125472,55,2,422,431,407,24,427,4,"MUNICIPIUL CARACAL",,6,,226,201
29,"Olt",289,"289-MUNICIPIUL CARACAL",125472,56,2,0,179,0,179,177,2,"MUNICIPIUL CARACAL",,6,,58,119
29,"Olt",289,"289-ORAS BALS",125418,57,2,1005,699,663,36,686,13,"ORAS BALS",,6,,428,258
29,"Olt",289,"289-ORAS BALS",125418,58,2,1240,916,844,72,908,8,"ORAS BALS",,6,,579,329
29,"Olt",289,"289-ORAS BALS",125418,59,2,907,671,627,44,664,7,"ORAS BALS",,6,,416,248
29,"Olt",289,"289-ORAS BALS",125418,60,2,1798,1271,1174,97,1256,15,"ORAS BALS",,6,,788,468
29,"Olt",289,"289-ORAS BALS",125418,61,2,2994,1990,1729,261,1979,11,"ORAS BALS",,6,,1070,909
29,"Olt",289,"289-ORAS BALS",125418,62,2,2793,1851,1641,210,1839,12,"ORAS BALS",,6,,876,963
29,"Olt",289,"289-ORAS BALS",125418,63,2,2930,1688,1314,374,1673,15,"ORAS BALS",,6,,839,834
29,"Olt",289,"289-ORAS BALS",125418,64,2,3242,1974,1665,309,1966,8,"ORAS BALS",,6,,982,984
29,"Olt",289,"289-ORAS CORABIA",125542,65,2,1755,1123,1033,90,1114,9,"ORAS CORABIA",,6,,690,424
29,"Olt",289,"289-ORAS CORABIA",125542,66,2,1308,1060,865,195,1051,9,"ORAS CORABIA",,6,,666,385
29,"Olt",289,"289-ORAS CORABIA",125542,67,2,1851,1172,964,208,1168,4,"ORAS CORABIA",,6,,682,486
29,"Olt",289,"289-ORAS CORABIA",125542,68,2,1884,1102,991,111,1091,11,"ORAS CORABIA",,6,,631,460
29,"Olt",289,"289-ORAS CORABIA",125542,69,2,2100,1358,1193,165,1346,12,"ORAS CORABIA",,6,,773,573
29,"Olt",289,"289-ORAS CORABIA",125542,70,2,2415,1478,1375,103,1463,15,"ORAS CORABIA",,6,,913,550
29,"Olt",289,"289-ORAS CORABIA",125542,71,2,2100,1201,1065,136,1196,5,"ORAS CORABIA",,6,,638,558
29,"Olt",289,"289-ORAS CORABIA",125542,72,2,1704,1080,986,94,1072,8,"ORAS CORABIA",,6,,732,340
29,"Olt",289,"289-ORAS CORABIA",125542,73,2,552,390,333,57,386,4,"ORAS CORABIA",,6,,195,191
29,"Olt",289,"289-ORAS CORABIA",125542,74,2,558,401,326,75,396,5,"ORAS CORABIA",,6,,240,156
29,"Olt",289,"289-ORAS CORABIA",125542,75,2,559,397,364,33,392,5,"ORAS CORABIA",,6,,252,140
29,"Olt",289,"289-ORAS DRAGANESTI-OLT",125622,76,2,3289,2160,2022,138,2139,21,"ORAS DRAGANESTI-OLT",,6,,1210,929
29,"Olt",289,"289-ORAS DRAGANESTI-OLT",125622,77,2,2131,1448,1236,212,1427,21,"ORAS DRAGANESTI-OLT",,6,,775,652
29,"Olt",289,"289-ORAS DRAGANESTI-OLT",125622,78,2,1638,1249,1095,154,1231,18,"ORAS DRAGANESTI-OLT",,6,,814,417
29,"Olt",289,"289-ORAS DRAGANESTI-OLT",125622,79,2,2687,1888,1700,188,1868,20,"ORAS DRAGANESTI-OLT",,6,,1117,751
29,"Olt",289,"289-ORAS PIATRA-OLT",128105,80,2,1546,1242,1045,197,1235,7,"ORAS PIATRA-OLT",,6,,813,422
29,"Olt",289,"289-ORAS PIATRA-OLT",128105,81,2,1810,1453,1302,151,1448,5,"ORAS PIATRA-OLT",,6,,927,521
29,"Olt",289,"289-ORAS PIATRA-OLT",128105,82,2,938,716,616,100,708,8,"ORAS PIATRA-OLT",,6,,477,231
29,"Olt",289,"289-ORAS PIATRA-OLT",128105,83,2,536,453,410,43,448,5,"ORAS PIATRA-OLT",,6,,304,144
29,"Olt",289,"289-ORAS SCORNICESTI",128711,84,2,3372,1768,1274,494,1751,17,"ORAS SCORNICESTI",,6,,922,829
29,"Olt",289,"289-ORAS SCORNICESTI",128711,85,2,1467,914,726,188,908,6,"ORAS SCORNICESTI",,6,,439,469
29,"Olt",289,"289-ORAS SCORNICESTI",128711,86,2,981,768,559,209,760,8,"ORAS SCORNICESTI",,6,,404,356
29,"Olt",289,"289-ORAS SCORNICESTI",128711,87,2,1044,706,581,125,701,5,"ORAS SCORNICESTI",,6,,395,306
29,"Olt",289,"289-ORAS SCORNICESTI",128711,88,2,429,350,259,91,346,4,"ORAS SCORNICESTI",,6,,240,106
29,"Olt",289,"289-ORAS SCORNICESTI",128711,89,2,1203,635,514,121,627,8,"ORAS SCORNICESTI",,6,,396,231
29,"Olt",289,"289-ORAS SCORNICESTI",128711,90,2,384,317,196,121,311,6,"ORAS SCORNICESTI",,6,,161,150
29,"Olt",289,"289-ORAS SCORNICESTI",128711,91,2,241,176,130,46,176,0,"ORAS SCORNICESTI",,6,,94,82
29,"Olt",289,"289-BALDOVINESTI",125677,92,2,909,593,523,70,576,17,"BALDOVINESTI",,6,,374,202
29,"Olt",289,"289-BALDOVINESTI",125677,93,2,788,577,516,61,568,9,"BALDOVINESTI",,6,,399,169
29,"Olt",289,"289-BALDOVINESTI",125677,94,2,925,613,517,96,600,13,"BALDOVINESTI",,6,,362,238
29,"Olt",289,"289-BABICIU",125659,95,2,2014,1365,1175,190,1354,11,"BABICIU",,6,,922,432
29,"Olt",289,"289-BARASTI",125757,96,2,1032,777,604,173,771,6,"BARASTI",,6,,442,329
29,"Olt",289,"289-BARASTI",125757,97,2,692,509,404,105,506,3,"BARASTI",,6,,315,191
29,"Olt",289,"289-BARASTI",125757,98,2,124,131,87,44,127,4,"BARASTI",,6,,86,41
29,"Olt",289,"289-BARZA",125846,99,2,1200,988,892,96,978,10,"BARZA",,6,,565,413
29,"Olt",289,"289-BARZA",125846,100,2,742,572,449,123,569,3,"BARZA",,6,,336,233
29,"Olt",289,"289-BOBICESTI",125873,101,2,1387,802,696,106,791,11,"BOBICESTI",,6,,472,319
29,"Olt",289,"289-BOBICESTI",125873,102,2,1204,1109,985,124,1100,9,"BOBICESTI",,6,,599,501
29,"Olt",289,"289-BRASTAVATU",125962,103,2,1611,844,764,80,841,3,"BRASTAVATU",,6,,404,437
29,"Olt",289,"289-BRASTAVATU",125962,104,2,1611,936,808,128,926,10,"BRASTAVATU",,6,,515,411
29,"Olt",289,"289-BRASTAVATU",125962,105,2,1166,723,655,68,716,7,"BRASTAVATU",,6,,493,223
29,"Olt",289,"289-BREBENI",125999,106,2,2203,1731,1451,280,1709,22,"BREBENI",,6,,1259,450
29,"Olt",289,"289-BRANCOVENI",126022,107,2,1450,1150,928,222,1115,35,"BRANCOVENI",,6,,907,208
29,"Olt",289,"289-BRANCOVENI",126022,108,2,1298,932,868,64,929,3,"BRANCOVENI",,6,,710,219
29,"Olt",289,"289-BUCINISU",126077,109,2,1942,1352,1107,245,1336,16,"BUCINISU",,6,,946,390
29,"Olt",289,"289-CEZIENI",126102,110,2,1282,1062,951,111,1052,10,"CEZIENI",,6,,827,225
29,"Olt",289,"289-CEZIENI",126102,111,2,617,479,427,52,473,6,"CEZIENI",,6,,328,145
29,"Olt",289,"289-CILIENI",126148,112,2,3023,1896,1725,171,1878,18,"CILIENI",,6,,1339,539
29,"Olt",289,"289-CARLOGANI",126166,113,2,1302,877,701,176,868,9,"CARLOGANI",,6,,551,317
29,"Olt",289,"289-CARLOGANI",126166,114,2,984,701,526,175,692,9,"CARLOGANI",,6,,491,201
29,"Olt",289,"289-COLONESTI",126228,115,2,649,621,495,126,614,7,"COLONESTI",,6,,336,278
29,"Olt",289,"289-COLONESTI",126228,116,2,599,682,566,116,617,65,"COLONESTI",,6,,467,150
29,"Olt",289,"289-COLONESTI",126228,117,2,405,533,384,149,530,3,"COLONESTI",,6,,398,132
29,"Olt",289,"289-CORBU",126326,118,2,864,602,463,139,595,7,"CORBU",,6,,328,267
29,"Olt",289,"289-CORBU",126326,119,2,1045,726,601,125,721,5,"CORBU",,6,,408,313
29,"Olt",289,"289-COTEANA",126380,120,2,2280,1765,1542,223,1743,22,"COTEANA",,6,,1227,516
29,"Olt",289,"289-CRAMPOIA",126406,121,2,1765,1597,1130,467,1567,30,"CRAMPOIA",,6,,977,590
29,"Olt",289,"289-CRAMPOIA",126406,122,2,406,424,292,132,415,9,"CRAMPOIA",,6,,213,202
29,"Olt",289,"289-CUNGREA",126503,123,2,908,597,462,135,590,7,"CUNGREA",,6,,438,152
29,"Olt",289,"289-CUNGREA",126503,124,2,282,305,195,110,304,1,"CUNGREA",,6,,211,93
29,"Olt",289,"289-CUNGREA",126503,125,2,886,517,422,95,515,2,"CUNGREA",,6,,363,152
29,"Olt",289,"289-CURTISOARA",126433,126,2,1299,1056,952,104,1040,16,"CURTISOARA",,6,,795,245
29,"Olt",289,"289-CURTISOARA",126433,127,2,1287,958,882,76,936,22,"CURTISOARA",,6,,661,275
29,"Olt",289,"289-CURTISOARA",126433,128,2,870,656,589,67,651,5,"CURTISOARA",,6,,454,197
29,"Olt",289,"289-DANEASA",126585,129,2,986,855,688,167,844,11,"DANEASA",,6,,537,307
29,"Olt",289,"289-DANEASA",126585,130,2,967,941,815,126,933,8,"DANEASA",,6,,725,208
29,"Olt",289,"289-DANEASA",126585,131,2,458,417,352,65,414,3,"DANEASA",,6,,306,108
29,"Olt",289,"289-DANEASA",126585,132,2,354,329,280,49,328,1,"DANEASA",,6,,256,72
29,"Olt",289,"289-DEVESELU",126647,133,2,1388,1005,922,83,989,16,"DEVESELU",,6,,476,513
29,"Olt",289,"289-DEVESELU",126647,134,2,995,825,737,88,821,4,"DEVESELU",,6,,509,312
29,"Olt",289,"289-DEVESELU",126647,135,2,0,311,0,311,305,6,"DEVESELU",,6,,140,165
29,"Olt",289,"289-DOBRETU",126674,136,2,1218,742,575,167,739,3,"DOBRETU",,6,,502,237
29,"Olt",289,"289-DOBROSLOVENI",126718,137,2,2088,1362,1275,87,1351,11,"DOBROSLOVENI",,6,,905,446
29,"Olt",289,"289-DOBROSLOVENI",126718,138,2,992,739,654,85,725,14,"DOBROSLOVENI",,6,,512,213
29,"Olt",289,"289-DOBROTEASA",126772,139,2,1655,1146,938,208,1137,9,"DOBROTEASA",,6,,860,277
29,"Olt",289,"289-DOBRUN",126825,140,2,1398,1073,959,114,1063,10,"DOBRUN",,6,,784,279
29,"Olt",289,"289-DOBRUN",126825,141,2,1253,941,820,121,931,10,"DOBRUN",,6,,703,228
29,"Olt",289,"289-DRAGHICENI",125490,142,2,1514,1134,1022,112,1134,0,"DRAGHICENI",,6,,909,225
29,"Olt",289,"289-FAGETELU",126905,143,2,667,692,550,142,683,9,"FAGETELU",,6,,497,186
29,"Olt",289,"289-FAGETELU",126905,144,2,404,447,327,120,438,9,"FAGETELU",,6,,353,85
29,"Olt",289,"289-FALCOIU",126978,145,2,1982,1353,1193,160,1327,26,"FALCOIU",,6,,936,391
29,"Olt",289,"289-FALCOIU",126978,146,2,1196,1080,947,133,1069,11,"FALCOIU",,6,,838,231
29,"Olt",289,"289-FARCASELE",127019,147,2,2240,1507,1426,81,1488,19,"FARCASELE",,6,,1145,343
29,"Olt",289,"289-FARCASELE",127019,148,2,1400,967,886,81,957,10,"FARCASELE",,6,,644,313
29,"Olt",289,"289-GANEASA",127064,149,2,1330,1073,898,175,1061,12,"GANEASA",,6,,653,408
29,"Olt",289,"289-GANEASA",127064,150,2,948,631,485,146,625,6,"GANEASA",,6,,368,257
29,"Olt",289,"289-GANEASA",127064,151,2,970,594,477,117,585,9,"GANEASA",,6,,355,230
29,"Olt",289,"289-GIUVARASTI",127126,152,2,2206,1548,1366,182,1533,15,"GIUVARASTI",,6,,1038,495
29,"Olt",289,"289-GARCOV",125588,153,2,1300,927,837,90,914,13,"GARCOV",,6,,684,230
29,"Olt",289,"289-GARCOV",125588,154,2,847,670,600,70,654,16,"GARCOV",,6,,471,183
29,"Olt",289,"289-GOSTAVATU",127144,155,2,1557,1074,895,179,1064,10,"GOSTAVATU",,6,,788,276
29,"Olt",289,"289-GOSTAVATU",127144,156,2,1248,923,815,108,909,14,"GOSTAVATU",,6,,675,234
29,"Olt",289,"289-GRADINARI",127171,157,2,1607,1092,906,186,1084,8,"GRADINARI",,6,,829,255
29,"Olt",289,"289-GRADINARI",127171,158,2,0,35,0,35,35,0,"GRADINARI",,6,,29,6
29,"Olt",289,"289-GROJDIBODU",127224,159,2,1773,1454,1285,169,1444,10,"GROJDIBODU",,6,,994,450
29,"Olt",289,"289-GROJDIBODU",127224,160,2,941,770,643,127,762,8,"GROJDIBODU",,6,,519,243
29,"Olt",289,"289-IANCA",127251,161,2,2606,1858,1620,238,1831,27,"IANCA",,6,,838,993
29,"Olt",289,"289-IANCA",127251,162,2,1246,938,806,132,926,12,"IANCA",,6,,583,343
29,"Olt",289,"289-IANCU JIANU",127288,163,2,1463,1022,940,82,1014,8,"IANCU JIANU",,6,,624,390
29,"Olt",289,"289-IANCU JIANU",127288,164,2,1210,829,749,80,823,6,"IANCU JIANU",,6,,435,388
29,"Olt",289,"289-IANCU JIANU",127288,165,2,784,591,503,88,583,8,"IANCU JIANU",,6,,347,236
29,"Olt",289,"289-ICOANA",127322,166,2,1224,740,570,170,735,5,"ICOANA",,6,,455,280
29,"Olt",289,"289-ICOANA",127322,167,2,628,490,377,113,482,8,"ICOANA",,6,,201,281
29,"Olt",289,"289-IZBICENI",127368,168,2,2053,1496,1429,67,1496,0,"IZBICENI",,6,,937,559
29,"Olt",289,"289-IZBICENI",127368,169,2,2033,1660,1583,77,1644,16,"IZBICENI",,6,,967,677
29,"Olt",289,"289-IZVOARELE",127386,170,2,1058,855,626,229,842,13,"IZVOARELE",,6,,570,272
29,"Olt",289,"289-IZVOARELE",127386,171,2,1974,1604,1419,185,1579,25,"IZVOARELE",,6,,951,628
29,"Olt",289,"289-LELEASCA",127411,172,2,556,519,436,83,516,3,"LELEASCA",,6,,398,118
29,"Olt",289,"289-LELEASCA",127411,173,2,593,598,450,148,586,12,"LELEASCA",,6,,327,259
29,"Olt",289,"289-LELEASCA",127411,174,2,458,380,297,83,379,1,"LELEASCA",,6,,233,146
29,"Olt",289,"289-MARUNTEI",126291,175,2,2280,1530,1322,208,1518,12,"MARUNTEI",,6,,1022,496
29,"Olt",289,"289-MARUNTEI",126291,176,2,1236,960,723,237,943,17,"MARUNTEI",,6,,529,414
29,"Olt",289,"289-MIHAESTI",127536,177,2,956,728,644,84,720,8,"MIHAESTI",,6,,501,219
29,"Olt",289,"289-MIHAESTI",127536,178,2,872,620,548,72,607,13,"MIHAESTI",,6,,379,228
29,"Olt",289,"289-MILCOV",127563,179,2,1206,659,595,64,653,6,"MILCOV",,6,,453,200
29,"Olt",289,"289-MILCOV",127563,180,2,1150,818,758,60,804,14,"MILCOV",,6,,568,236
29,"Olt",289,"289-MORUNGLAV",127625,181,2,1346,870,764,106,858,12,"MORUNGLAV",,6,,556,302
29,"Olt",289,"289-MORUNGLAV",127625,182,2,570,355,292,63,348,7,"MORUNGLAV",,6,,276,72
29,"Olt",289,"289-MORUNGLAV",127625,183,2,321,260,202,58,254,6,"MORUNGLAV",,6,,189,65
29,"Olt",289,"289-MOVILENI",127689,184,2,1808,1157,1006,151,1142,15,"MOVILENI",,6,,721,421
29,"Olt",289,"289-MOVILENI",127689,185,2,1205,796,726,70,784,12,"MOVILENI",,6,,467,317
29,"Olt",289,"289-NICOLAE TITULESCU",127714,186,2,1195,1006,880,126,994,12,"NICOLAE TITULESCU",,6,,698,296
29,"Olt",289,"289-NICOLAE TITULESCU",127714,187,2,1313,1145,1019,126,1135,10,"NICOLAE TITULESCU",,6,,762,373
29,"Olt",289,"289-OBARSIA",127750,188,2,1546,969,885,84,951,18,"OBARSIA",,6,,669,282
29,"Olt",289,"289-OBARSIA",127750,189,2,1165,828,729,99,820,8,"OBARSIA",,6,,441,379
29,"Olt",289,"289-OBOGA",127812,190,2,1305,895,751,144,887,8,"OBOGA",,6,,479,408
29,"Olt",289,"289-OBOGA",127812,191,2,1384,926,751,175,889,37,"OBOGA",,6,,506,383
29,"Olt",289,"289-OPORELU",127858,192,2,1169,727,531,196,721,6,"OPORELU",,6,,494,227
29,"Olt",289,"289-OPTASI-MAGURA",127901,193,2,1303,942,772,170,929,13,"OPTASI-MAGURA",,6,,706,223
29,"Olt",289,"289-OPTASI-MAGURA",127901,194,2,940,696,498,198,685,11,"OPTASI-MAGURA",,6,,524,161
29,"Olt",289,"289-OPTASI-MAGURA",127901,195,2,815,726,506,220,718,8,"OPTASI-MAGURA",,6,,475,243
29,"Olt",289,"289-ORLEA",127938,196,2,2267,1431,1262,169,1418,13,"ORLEA",,6,,872,546
29,"Olt",289,"289-ORLEA",127938,197,2,1521,1160,1007,153,1148,12,"ORLEA",,6,,795,353
29,"Olt",289,"289-OSICA DE SUS",127983,198,2,2839,1864,1717,147,1843,21,"OSICA DE SUS",,6,,1175,668
29,"Olt",289,"289-OSICA DE SUS",127983,199,2,1395,890,801,89,884,6,"OSICA DE SUS",,6,,611,273
29,"Olt",289,"289-PERIETI",128052,200,2,1861,1900,1773,127,1863,37,"PERIETI",,6,,1250,613
29,"Olt",289,"289-PERIETI",128052,201,2,1461,1318,1232,86,1308,10,"PERIETI",,6,,946,362
29,"Olt",289,"289-PARSCOVENI",128178,202,2,1494,1163,1053,110,1144,19,"PARSCOVENI",,6,,723,421
29,"Olt",289,"289-PARSCOVENI",128178,203,2,1194,876,773,103,865,11,"PARSCOVENI",,6,,505,360
29,"Olt",289,"289-PARSCOVENI",128178,204,2,982,743,707,36,735,8,"PARSCOVENI",,6,,484,251
29,"Olt",289,"289-PLESOIU",128221,205,2,1414,1037,919,118,1027,10,"PLESOIU",,6,,707,320
29,"Olt",289,"289-PLESOIU",128221,206,2,1491,1743,1491,252,1725,18,"PLESOIU",,6,,1376,349
29,"Olt",289,"289-POBORU",128301,207,2,705,520,438,82,512,8,"POBORU",,6,,343,169
29,"Olt",289,"289-POBORU",128301,208,2,1059,825,667,158,819,6,"POBORU",,6,,627,192
29,"Olt",289,"289-POTCOAVA",128383,209,2,2750,1622,1449,173,1609,13,"POTCOAVA",,6,,1036,573
29,"Olt",289,"289-POTCOAVA",128383,210,2,1750,1108,925,183,1096,12,"POTCOAVA",,6,,647,449
29,"Olt",289,"289-PRISEACA",128436,211,2,1728,1339,1230,109,1328,11,"PRISEACA",,6,,785,543
29,"Olt",289,"289-RADOMIRESTI",128472,212,2,1653,1074,946,128,1057,17,"RADOMIRESTI",,6,,661,396
29,"Olt",289,"289-RADOMIRESTI",128472,213,2,895,627,556,71,619,8,"RADOMIRESTI",,6,,413,206
29,"Olt",289,"289-RADOMIRESTI",128472,214,2,406,338,271,67,336,2,"RADOMIRESTI",,6,,221,115
29,"Olt",289,"289-RADOMIRESTI",128472,215,2,1227,735,662,73,728,7,"RADOMIRESTI",,6,,459,269
29,"Olt",289,"289-REDEA",128524,216,2,2080,1171,1060,111,1151,20,"REDEA",,6,,716,435
29,"Olt",289,"289-REDEA",128524,217,2,780,394,300,94,391,3,"REDEA",,6,,308,83
29,"Olt",289,"289-ROTUNDA",128560,218,2,2563,1694,1541,153,1677,17,"ROTUNDA",,6,,1138,539
29,"Olt",289,"289-RUSANESTI",128588,219,2,973,700,610,90,692,8,"RUSANESTI",,6,,478,214
29,"Olt",289,"289-RUSANESTI",128588,220,2,1482,1015,906,109,1006,9,"RUSANESTI",,6,,718,288
29,"Olt",289,"289-RUSANESTI",128588,221,2,1400,962,867,95,954,8,"RUSANESTI",,6,,741,213
29,"Olt",289,"289-SCARISOARA",128613,222,2,1813,1255,1072,183,1230,25,"SCARISOARA",,6,,885,345
29,"Olt",289,"289-SCARISOARA",128613,223,2,577,498,394,104,495,3,"SCARISOARA",,6,,343,152
29,"Olt",289,"289-SCHITU",128659,224,2,1754,942,842,100,929,13,"SCHITU",,6,,593,336
29,"Olt",289,"289-SCHITU",128659,225,2,804,553,463,90,550,3,"SCHITU",,6,,356,194
29,"Olt",289,"289-SEACA",128356,226,2,2264,1491,1382,109,1479,12,"SEACA",,6,,1092,387
29,"Olt",289,"289-SAMBURESTI",128882,227,2,1036,581,500,81,568,13,"SAMBURESTI",,6,,387,181
29,"Olt",289,"289-SLATIOARA",125374,228,2,2056,1592,1424,168,1570,22,"SLATIOARA",,6,,882,688
29,"Olt",289,"289-SPINENI",128962,229,2,550,442,316,126,436,6,"SPINENI",,6,,314,122
29,"Olt",289,"289-SPINENI",128962,230,2,590,419,296,123,419,0,"SPINENI",,6,,297,122
29,"Olt",289,"289-SPINENI",128962,231,2,739,547,404,143,540,7,"SPINENI",,6,,384,156
29,"Olt",289,"289-SPRANCENATA",129040,232,2,1959,1110,972,138,1100,10,"SPRANCENATA",,6,,775,325
29,"Olt",289,"289-SPRANCENATA",129040,233,2,632,538,398,140,536,2,"SPRANCENATA",,6,,392,144
29,"Olt",289,"289-STOENESTI",129095,234,2,1866,1414,1185,229,1402,12,"STOENESTI",,6,,962,440
29,"Olt",289,"289-STOICANESTI",129111,235,2,2836,2074,1913,161,2058,16,"STOICANESTI",,6,,1579,479
29,"Olt",289,"289-STREJESTI",129139,236,2,1357,969,824,145,946,23,"STREJESTI",,6,,679,267
29,"Olt",289,"289-STREJESTI",129139,237,2,1420,1082,935,147,1072,10,"STREJESTI",,6,,852,220
29,"Olt",289,"289-STUDINA",129184,238,2,1398,1010,926,84,1000,10,"STUDINA",,6,,645,355
29,"Olt",289,"289-STUDINA",129184,239,2,1038,1057,922,135,1052,5,"STUDINA",,6,,630,422
29,"Olt",289,"289-STUDINA",129184,240,2,945,678,596,82,667,11,"STUDINA",,6,,496,171
29,"Olt",289,"289-SERBANESTI",129246,241,2,2453,1638,1467,171,1612,26,"SERBANESTI",,6,,935,677
29,"Olt",289,"289-STEFAN CEL MARE",129282,242,2,1976,1287,1174,113,1276,11,"STEFAN CEL MARE",,6,,708,568
29,"Olt",289,"289-TATULESTI",129317,243,2,587,406,287,119,398,8,"TATULESTI",,6,,231,167
29,"Olt",289,"289-TATULESTI",129317,244,2,199,193,135,58,192,1,"TATULESTI",,6,,113,79
29,"Olt",289,"289-TATULESTI",129317,245,2,320,236,173,63,236,0,"TATULESTI",,6,,167,69
29,"Olt",289,"289-TESLUI",129380,246,2,1335,892,795,97,881,11,"TESLUI",,6,,647,234
29,"Olt",289,"289-TESLUI",129380,247,2,894,708,583,125,705,3,"TESLUI",,6,,542,163
29,"Olt",289,"289-TIA MARE",129460,248,2,1102,705,616,89,698,7,"TIA MARE",,6,,481,217
29,"Olt",289,"289-TIA MARE",129460,249,2,1371,1020,920,100,1015,0,"TIA MARE",,6,,881,134
29,"Olt",289,"289-TIA MARE",129460,250,2,1223,886,757,129,878,8,"TIA MARE",,6,,687,191
29,"Olt",289,"289-TOPANA",129503,251,2,697,490,357,133,484,6,"TOPANA",,6,,295,189
29,"Olt",289,"289-TOPANA",129503,252,2,350,282,229,53,279,3,"TOPANA",,6,,161,118
29,"Olt",289,"289-TRAIAN",129567,253,2,2775,1962,1833,129,1946,16,"TRAIAN",,6,,1421,525
29,"Olt",289,"289-TUFENI",129585,254,2,1531,969,829,140,951,18,"TUFENI",,6,,635,316
29,"Olt",289,"289-TUFENI",129585,255,2,1027,722,624,98,711,11,"TUFENI",,6,,465,246
29,"Olt",289,"289-URZICA",129629,256,2,1361,975,839,136,962,13,"URZICA",,6,,586,376
29,"Olt",289,"289-URZICA",129629,257,2,811,632,548,84,627,5,"URZICA",,6,,437,190
29,"Olt",289,"289-VALEA MARE",129656,258,2,2075,1074,967,107,1066,8,"VALEA MARE",,6,,626,440
29,"Olt",289,"289-VALEA MARE",129656,259,2,1047,593,501,92,588,5,"VALEA MARE",,6,,388,200
29,"Olt",289,"289-VADASTRA",129718,260,2,1475,977,813,164,968,9,"VADASTRA",,6,,697,271
29,"Olt",289,"289-VADASTRA",129718,261,2,1640,1095,903,192,1087,8,"VADASTRA",,6,,814,273
29,"Olt",289,"289-VADASTRITA",129745,262,2,3160,1952,1815,137,1933,19,"VADASTRITA",,6,,1379,554
29,"Olt",289,"289-VALENI",126068,263,2,2343,1374,1211,163,1342,32,"VALENI",,6,,984,358
29,"Olt",289,"289-VALENI",126068,264,2,744,516,449,67,506,10,"VALENI",,6,,340,166
29,"Olt",289,"289-VERGULEASA",129816,265,2,834,566,485,81,564,2,"VERGULEASA",,6,,389,175
29,"Olt",289,"289-VERGULEASA",129816,266,2,1032,763,654,109,758,5,"VERGULEASA",,6,,536,222
29,"Olt",289,"289-VERGULEASA",129816,267,2,702,692,511,181,683,9,"VERGULEASA",,6,,464,219
29,"Olt",289,"289-VISINA",129898,268,2,2804,1910,1763,147,1891,19,"VISINA",,6,,1014,877
29,"Olt",289,"289-VITOMIRESTI",129914,269,2,1185,705,597,108,700,5,"VITOMIRESTI",,6,,392,308
29,"Olt",289,"289-VITOMIRESTI",129914,270,2,1096,754,681,73,743,11,"VITOMIRESTI",,6,,596,147
29,"Olt",289,"289-VALCELE",129987,271,2,1601,1192,918,274,1172,20,"VALCELE",,6,,768,404
29,"Olt",289,"289-VALCELE",129987,272,2,719,555,459,96,550,5,"VALCELE",,6,,343,207
29,"Olt",289,"289-VLADILA",130026,273,2,1725,1163,1073,90,1146,17,"VLADILA",,6,,735,411
29,"Olt",289,"289-VOINEASA",130062,274,2,809,528,480,48,517,11,"VOINEASA",,6,,354,163
29,"Olt",289,"289-VOINEASA",130062,275,2,934,778,661,117,768,10,"VOINEASA",,6,,544,224
29,"Olt",289,"289-VULPENI",130124,276,2,1357,1031,906,125,1011,20,"VULPENI",,6,,490,521
29,"Olt",289,"289-VULPENI",130124,277,2,814,550,478,72,540,10,"VULPENI",,6,,260,280
29,"Olt",289,"289-VULTURESTI",130231,278,2,1244,909,791,118,908,1,"VULTURESTI",,6,,709,199
29,"Olt",289,"289-VULTURESTI",130231,279,2,977,706,588,118,703,3,"VULTURESTI",,6,,547,156
29,"Olt",289,"289-GRADINARI",127171,280,2,216,347,185,162,343,4,"GRADINARI",,6,,174,169
30,"Prahova",298,"298-MUNICIPIUL PLOIESTI",130534,1,2,1461,1281,1094,187,1276,5,"MUNICIPIUL PLOIESTI",,5,,487,789
30,"Prahova",298,"298-MUNICIPIUL PLOIESTI",130534,2,2,1889,1316,1134,182,1313,3,"MUNICIPIUL PLOIESTI",,5,,534,779
30,"Prahova",298,"298-MUNICIPIUL PLOIESTI",130534,3,2,1663,1494,1167,327,1489,5,"MUNICIPIUL PLOIESTI",,5,,539,950
30,"Prahova",298,"298-MUNICIPIUL PLOIESTI",130534,4,2,999,771,712,59,769,2,"MUNICIPIUL PLOIESTI",,5,,256,513
30,"Prahova",298,"298-MUNICIPIUL PLOIESTI",130534,5,2,1894,1581,1393,188,1572,9,"MUNICIPIUL PLOIESTI",,5,,552,1020
30,"Prahova",298,"298-MUNICIPIUL PLOIESTI",130534,6,2,1756,1309,1215,94,1308,1,"MUNICIPIUL PLOIESTI",,5,,416,892
30,"Prahova",298,"298-MUNICIPIUL PLOIESTI",130534,7,2,1771,1305,1216,89,1302,3,"MUNICIPIUL PLOIESTI",,5,,530,772
30,"Prahova",298,"298-MUNICIPIUL PLOIESTI",130534,8,2,1833,1403,1148,255,1398,5,"MUNICIPIUL PLOIESTI",,5,,510,888
30,"Prahova",298,"298-MUNICIPIUL PLOIESTI",130534,9,2,825,634,571,63,629,5,"MUNICIPIUL PLOIESTI",,5,,178,451
30,"Prahova",298,"298-MUNICIPIUL PLOIESTI",130534,10,2,946,1089,644,445,1085,4,"MUNICIPIUL PLOIESTI",,5,,387,698
30,"Prahova",298,"298-MUNICIPIUL PLOIESTI",130534,11,2,1586,1272,1128,144,1265,7,"MUNICIPIUL PLOIESTI",,5,,425,840
30,"Prahova",298,"298-MUNICIPIUL PLOIESTI",130534,12,2,1055,1027,914,113,1018,9,"MUNICIPIUL PLOIESTI",,5,,438,580
30,"Prahova",298,"298-MUNICIPIUL PLOIESTI",130534,13,2,1178,1035,802,233,1029,6,"MUNICIPIUL PLOIESTI",,5,,403,626
30,"Prahova",298,"298-MUNICIPIUL PLOIESTI",130534,14,2,1012,913,769,144,911,2,"MUNICIPIUL PLOIESTI",,5,,328,583
30,"Prahova",298,"298-MUNICIPIUL PLOIESTI",130534,15,2,1038,940,768,172,939,1,"MUNICIPIUL PLOIESTI",,5,,316,623
30,"Prahova",298,"298-MUNICIPIUL PLOIESTI",130534,16,2,824,688,633,55,686,2,"MUNICIPIUL PLOIESTI",,5,,250,436
30,"Prahova",298,"298-MUNICIPIUL PLOIESTI",130534,17,2,1074,874,798,76,871,3,"MUNICIPIUL PLOIESTI",,5,,285,586
30,"Prahova",298,"298-MUNICIPIUL PLOIESTI",130534,18,2,1184,991,877,114,984,7,"MUNICIPIUL PLOIESTI",,5,,296,688
30,"Prahova",298,"298-MUNICIPIUL PLOIESTI",130534,19,2,1556,1198,1096,102,1191,7,"MUNICIPIUL PLOIESTI",,5,,370,821
30,"Prahova",298,"298-MUNICIPIUL PLOIESTI",130534,20,2,1467,1103,1023,80,1096,7,"MUNICIPIUL PLOIESTI",,5,,351,745
30,"Prahova",298,"298-MUNICIPIUL PLOIESTI",130534,21,2,1627,1357,1280,77,1355,2,"MUNICIPIUL PLOIESTI",,5,,474,881
30,"Prahova",298,"298-MUNICIPIUL PLOIESTI",130534,22,2,1402,1218,1087,131,1213,5,"MUNICIPIUL PLOIESTI",,5,,401,812
30,"Prahova",298,"298-MUNICIPIUL PLOIESTI",130534,23,2,953,746,667,79,742,4,"MUNICIPIUL PLOIESTI",,5,,249,493
30,"Prahova",298,"298-MUNICIPIUL PLOIESTI",130534,24,2,1568,1197,1101,96,1188,9,"MUNICIPIUL PLOIESTI",,5,,338,850
30,"Prahova",298,"298-MUNICIPIUL PLOIESTI",130534,25,2,1964,1568,1461,107,1557,11,"MUNICIPIUL PLOIESTI",,5,,558,999
30,"Prahova",298,"298-MUNICIPIUL PLOIESTI",130534,26,2,1592,1348,1111,237,1341,7,"MUNICIPIUL PLOIESTI",,5,,512,829
30,"Prahova",298,"298-MUNICIPIUL PLOIESTI",130534,27,2,1896,1405,1312,93,1384,21,"MUNICIPIUL PLOIESTI",,5,,542,842
30,"Prahova",298,"298-MUNICIPIUL PLOIESTI",130534,28,2,2165,1561,1374,187,1541,20,"MUNICIPIUL PLOIESTI",,5,,659,882
30,"Prahova",298,"298-MUNICIPIUL PLOIESTI",130534,29,2,1662,1272,1169,103,1265,7,"MUNICIPIUL PLOIESTI",,5,,486,779
30,"Prahova",298,"298-MUNICIPIUL PLOIESTI",130534,30,2,1554,1191,1075,116,1190,1,"MUNICIPIUL PLOIESTI",,5,,503,687
30,"Prahova",298,"298-MUNICIPIUL PLOIESTI",130534,31,2,2035,1728,1355,373,1722,6,"MUNICIPIUL PLOIESTI",,5,,574,1148
30,"Prahova",298,"298-MUNICIPIUL PLOIESTI",130534,32,2,2100,1435,1202,233,1418,17,"MUNICIPIUL PLOIESTI",,5,,541,877
30,"Prahova",298,"298-MUNICIPIUL PLOIESTI",130534,33,2,2081,1586,1424,162,1570,16,"MUNICIPIUL PLOIESTI",,5,,568,1002
30,"Prahova",298,"298-MUNICIPIUL PLOIESTI",130534,34,2,754,616,570,46,615,1,"MUNICIPIUL PLOIESTI",,5,,232,383
30,"Prahova",298,"298-MUNICIPIUL PLOIESTI",130534,35,2,1910,1370,1273,97,1362,8,"MUNICIPIUL PLOIESTI",,5,,595,767
30,"Prahova",298,"298-MUNICIPIUL PLOIESTI",130534,36,2,1128,950,859,91,947,3,"MUNICIPIUL PLOIESTI",,5,,328,619
30,"Prahova",298,"298-MUNICIPIUL PLOIESTI",130534,37,2,1597,1238,1156,82,1233,5,"MUNICIPIUL PLOIESTI",,5,,408,825
30,"Prahova",298,"298-MUNICIPIUL PLOIESTI",130534,38,2,1808,1467,1379,88,1460,7,"MUNICIPIUL PLOIESTI",,5,,480,980
30,"Prahova",298,"298-MUNICIPIUL PLOIESTI",130534,39,2,1443,1101,1017,84,1098,3,"MUNICIPIUL PLOIESTI",,5,,390,708
30,"Prahova",298,"298-MUNICIPIUL PLOIESTI",130534,40,2,1441,1161,1093,68,1156,5,"MUNICIPIUL PLOIESTI",,5,,470,686
30,"Prahova",298,"298-MUNICIPIUL PLOIESTI",130534,41,2,1408,1129,1049,80,1121,8,"MUNICIPIUL PLOIESTI",,5,,388,733
30,"Prahova",298,"298-MUNICIPIUL PLOIESTI",130534,42,2,1254,992,914,78,988,4,"MUNICIPIUL PLOIESTI",,5,,374,614
30,"Prahova",298,"298-MUNICIPIUL PLOIESTI",130534,43,2,1552,1182,1117,65,1173,9,"MUNICIPIUL PLOIESTI",,5,,541,632
30,"Prahova",298,"298-MUNICIPIUL PLOIESTI",130534,44,2,1548,1201,1094,107,1190,11,"MUNICIPIUL PLOIESTI",,5,,537,653
30,"Prahova",298,"298-MUNICIPIUL PLOIESTI",130534,45,2,1666,1260,1136,124,1252,8,"MUNICIPIUL PLOIESTI",,5,,449,803
30,"Prahova",298,"298-MUNICIPIUL PLOIESTI",130534,46,2,1887,1385,1286,99,1378,7,"MUNICIPIUL PLOIESTI",,5,,436,942
30,"Prahova",298,"298-MUNICIPIUL PLOIESTI",130534,47,2,1577,1200,1037,163,1186,14,"MUNICIPIUL PLOIESTI",,5,,457,729
30,"Prahova",298,"298-MUNICIPIUL PLOIESTI",130534,48,2,1578,1294,1183,111,1288,6,"MUNICIPIUL PLOIESTI",,5,,429,859
30,"Prahova",298,"298-MUNICIPIUL PLOIESTI",130534,49,2,1280,989,927,62,986,3,"MUNICIPIUL PLOIESTI",,5,,364,622
30,"Prahova",298,"298-MUNICIPIUL PLOIESTI",130534,50,2,758,538,376,162,527,11,"MUNICIPIUL PLOIESTI",,5,,145,382
30,"Prahova",298,"298-MUNICIPIUL PLOIESTI",130534,51,2,1276,1015,970,45,1008,7,"MUNICIPIUL PLOIESTI",,5,,382,626
30,"Prahova",298,"298-MUNICIPIUL PLOIESTI",130534,52,2,1231,997,932,65,995,2,"MUNICIPIUL PLOIESTI",,5,,342,653
30,"Prahova",298,"298-MUNICIPIUL PLOIESTI",130534,53,2,1400,1191,1028,163,1189,2,"MUNICIPIUL PLOIESTI",,5,,372,817
30,"Prahova",298,"298-MUNICIPIUL PLOIESTI",130534,54,2,856,708,659,49,704,4,"MUNICIPIUL PLOIESTI",,5,,232,472
30,"Prahova",298,"298-MUNICIPIUL PLOIESTI",130534,55,2,713,771,549,222,763,8,"MUNICIPIUL PLOIESTI",,5,,275,488
30,"Prahova",298,"298-MUNICIPIUL PLOIESTI",130534,56,2,1478,996,917,79,994,2,"MUNICIPIUL PLOIESTI",,5,,410,584
30,"Prahova",298,"298-MUNICIPIUL PLOIESTI",130534,57,2,2200,1344,1193,151,1339,5,"MUNICIPIUL PLOIESTI",,5,,517,822
30,"Prahova",298,"298-MUNICIPIUL PLOIESTI",130534,58,2,1720,1271,1170,101,1267,4,"MUNICIPIUL PLOIESTI",,5,,467,800
30,"Prahova",298,"298-MUNICIPIUL PLOIESTI",130534,59,2,586,666,395,271,663,3,"MUNICIPIUL PLOIESTI",,5,,255,408
30,"Prahova",298,"298-MUNICIPIUL PLOIESTI",130534,60,2,1137,1373,794,579,1368,5,"MUNICIPIUL PLOIESTI",,5,,452,916
30,"Prahova",298,"298-MUNICIPIUL PLOIESTI",130534,61,2,2041,1562,1441,121,1550,12,"MUNICIPIUL PLOIESTI",,5,,485,1065
30,"Prahova",298,"298-MUNICIPIUL PLOIESTI",130534,62,2,1280,928,858,70,924,4,"MUNICIPIUL PLOIESTI",,5,,306,618
30,"Prahova",298,"298-MUNICIPIUL PLOIESTI",130534,63,2,1743,1261,1210,51,1256,5,"MUNICIPIUL PLOIESTI",,5,,414,842
30,"Prahova",298,"298-MUNICIPIUL PLOIESTI",130534,64,2,1718,1446,1192,254,1441,5,"MUNICIPIUL PLOIESTI",,5,,492,949
30,"Prahova",298,"298-MUNICIPIUL PLOIESTI",130534,65,2,1801,1370,1295,75,1358,12,"MUNICIPIUL PLOIESTI",,5,,496,862
30,"Prahova",298,"298-MUNICIPIUL PLOIESTI",130534,66,2,1606,1200,1136,64,1199,1,"MUNICIPIUL PLOIESTI",,5,,500,699
30,"Prahova",298,"298-MUNICIPIUL PLOIESTI",130534,67,2,1666,1244,1123,121,1236,8,"MUNICIPIUL PLOIESTI",,5,,446,790
30,"Prahova",298,"298-MUNICIPIUL PLOIESTI",130534,68,2,1822,1351,1279,72,1344,7,"MUNICIPIUL PLOIESTI",,5,,554,790
30,"Prahova",298,"298-MUNICIPIUL PLOIESTI",130534,69,2,1473,1116,1047,69,1113,3,"MUNICIPIUL PLOIESTI",,5,,415,698
30,"Prahova",298,"298-MUNICIPIUL PLOIESTI",130534,70,2,1462,1140,1084,56,1134,6,"MUNICIPIUL PLOIESTI",,5,,418,716
30,"Prahova",298,"298-MUNICIPIUL PLOIESTI",130534,71,2,1360,1171,1109,62,1168,3,"MUNICIPIUL PLOIESTI",,5,,418,750
30,"Prahova",298,"298-MUNICIPIUL PLOIESTI",130534,72,2,1667,1219,1159,60,1213,6,"MUNICIPIUL PLOIESTI",,5,,482,731
30,"Prahova",298,"298-MUNICIPIUL PLOIESTI",130534,73,2,1670,1100,1054,46,1097,3,"MUNICIPIUL PLOIESTI",,5,,448,649
30,"Prahova",298,"298-MUNICIPIUL PLOIESTI",130534,74,2,1920,1437,1287,150,1432,5,"MUNICIPIUL PLOIESTI",,5,,533,899
30,"Prahova",298,"298-MUNICIPIUL PLOIESTI",130534,75,2,1764,1219,1100,119,1212,7,"MUNICIPIUL PLOIESTI",,5,,438,774
30,"Prahova",298,"298-MUNICIPIUL PLOIESTI",130534,76,2,1887,1250,1161,89,1248,2,"MUNICIPIUL PLOIESTI",,5,,486,762
30,"Prahova",298,"298-MUNICIPIUL PLOIESTI",130534,77,2,1684,1211,1110,101,1204,7,"MUNICIPIUL PLOIESTI",,5,,367,837
30,"Prahova",298,"298-MUNICIPIUL PLOIESTI",130534,78,2,1836,1142,1071,71,1132,10,"MUNICIPIUL PLOIESTI",,5,,479,653
30,"Prahova",298,"298-MUNICIPIUL PLOIESTI",130534,79,2,1271,924,845,79,918,6,"MUNICIPIUL PLOIESTI",,5,,309,609
30,"Prahova",298,"298-MUNICIPIUL PLOIESTI",130534,80,2,1811,1340,1244,96,1331,9,"MUNICIPIUL PLOIESTI",,5,,544,787
30,"Prahova",298,"298-MUNICIPIUL PLOIESTI",130534,81,2,1934,1450,1364,86,1438,12,"MUNICIPIUL PLOIESTI",,5,,541,897
30,"Prahova",298,"298-MUNICIPIUL PLOIESTI",130534,82,2,1964,1328,1231,97,1326,2,"MUNICIPIUL PLOIESTI",,5,,492,834
30,"Prahova",298,"298-MUNICIPIUL PLOIESTI",130534,83,2,1933,1353,1261,92,1347,6,"MUNICIPIUL PLOIESTI",,5,,487,860
30,"Prahova",298,"298-MUNICIPIUL PLOIESTI",130534,84,2,2152,1512,1442,70,1504,8,"MUNICIPIUL PLOIESTI",,5,,574,930
30,"Prahova",298,"298-MUNICIPIUL PLOIESTI",130534,85,2,1211,902,855,47,899,3,"MUNICIPIUL PLOIESTI",,5,,343,556
30,"Prahova",298,"298-MUNICIPIUL PLOIESTI",130534,86,2,1666,1316,1201,115,1312,4,"MUNICIPIUL PLOIESTI",,5,,484,828
30,"Prahova",298,"298-MUNICIPIUL PLOIESTI",130534,87,2,2202,1483,1391,92,1480,3,"MUNICIPIUL PLOIESTI",,5,,523,957
30,"Prahova",298,"298-MUNICIPIUL PLOIESTI",130534,88,2,1656,1235,1172,63,1229,4,"MUNICIPIUL PLOIESTI",,5,,415,814
30,"Prahova",298,"298-MUNICIPIUL PLOIESTI",130534,89,2,2078,1536,1462,74,1532,4,"MUNICIPIUL PLOIESTI",,5,,551,981
30,"Prahova",298,"298-MUNICIPIUL PLOIESTI",130534,90,2,1559,1187,1104,83,1172,6,"MUNICIPIUL PLOIESTI",,5,,411,761
30,"Prahova",298,"298-MUNICIPIUL PLOIESTI",130534,91,2,1760,1295,1177,118,1290,5,"MUNICIPIUL PLOIESTI",,5,,505,785
30,"Prahova",298,"298-MUNICIPIUL PLOIESTI",130534,92,2,1568,1186,1082,104,1186,0,"MUNICIPIUL PLOIESTI",,5,,466,720
30,"Prahova",298,"298-MUNICIPIUL PLOIESTI",130534,93,2,914,688,635,53,685,3,"MUNICIPIUL PLOIESTI",,5,,273,412
30,"Prahova",298,"298-MUNICIPIUL PLOIESTI",130534,94,2,829,685,607,78,682,3,"MUNICIPIUL PLOIESTI",,5,,231,451
30,"Prahova",298,"298-MUNICIPIUL PLOIESTI",130534,95,2,657,434,391,43,433,1,"MUNICIPIUL PLOIESTI",,5,,149,284
30,"Prahova",298,"298-MUNICIPIUL PLOIESTI",130534,96,2,2016,1550,1468,82,1541,9,"MUNICIPIUL PLOIESTI",,5,,590,951
30,"Prahova",298,"298-MUNICIPIUL PLOIESTI",130534,97,2,1950,1582,1463,119,1572,10,"MUNICIPIUL PLOIESTI",,5,,606,966
30,"Prahova",298,"298-MUNICIPIUL PLOIESTI",130534,98,2,1996,1344,1250,94,1337,7,"MUNICIPIUL PLOIESTI",,5,,512,825
30,"Prahova",298,"298-MUNICIPIUL PLOIESTI",130534,99,2,1658,1112,1026,86,1104,8,"MUNICIPIUL PLOIESTI",,5,,388,716
30,"Prahova",298,"298-MUNICIPIUL PLOIESTI",130534,100,2,1185,1117,884,233,1114,3,"MUNICIPIUL PLOIESTI",,5,,431,683
30,"Prahova",298,"298-MUNICIPIUL PLOIESTI",130534,101,2,1856,1219,1137,82,1212,7,"MUNICIPIUL PLOIESTI",,5,,451,761
30,"Prahova",298,"298-MUNICIPIUL PLOIESTI",130534,102,2,1520,1109,1034,75,1105,4,"MUNICIPIUL PLOIESTI",,5,,439,666
30,"Prahova",298,"298-MUNICIPIUL PLOIESTI",130534,103,2,1654,1288,1129,159,1281,7,"MUNICIPIUL PLOIESTI",,5,,494,787
30,"Prahova",298,"298-MUNICIPIUL PLOIESTI",130534,104,2,2071,1640,1507,133,1634,6,"MUNICIPIUL PLOIESTI",,5,,630,1004
30,"Prahova",298,"298-MUNICIPIUL PLOIESTI",130534,105,2,1209,977,870,107,968,7,"MUNICIPIUL PLOIESTI",,5,,358,610
30,"Prahova",298,"298-MUNICIPIUL PLOIESTI",130534,106,2,1857,1488,1382,106,1483,4,"MUNICIPIUL PLOIESTI",,5,,521,962
30,"Prahova",298,"298-MUNICIPIUL PLOIESTI",130534,107,2,1707,1397,1286,111,1392,5,"MUNICIPIUL PLOIESTI",,5,,411,981
30,"Prahova",298,"298-MUNICIPIUL PLOIESTI",130534,108,2,1650,1389,1307,82,1384,5,"MUNICIPIUL PLOIESTI",,5,,445,939
30,"Prahova",298,"298-MUNICIPIUL PLOIESTI",130534,109,2,1587,1238,1168,70,1232,6,"MUNICIPIUL PLOIESTI",,5,,436,796
30,"Prahova",298,"298-MUNICIPIUL PLOIESTI",130534,110,2,1299,1029,930,99,1028,1,"MUNICIPIUL PLOIESTI",,5,,423,605
30,"Prahova",298,"298-MUNICIPIUL PLOIESTI",130534,111,2,1176,928,863,65,924,4,"MUNICIPIUL PLOIESTI",,5,,382,542
30,"Prahova",298,"298-MUNICIPIUL PLOIESTI",130534,112,2,1499,1255,1089,166,1253,2,"MUNICIPIUL PLOIESTI",,5,,412,841
30,"Prahova",298,"298-MUNICIPIUL PLOIESTI",130534,113,2,1570,1271,1208,63,1267,4,"MUNICIPIUL PLOIESTI",,5,,471,796
30,"Prahova",298,"298-MUNICIPIUL PLOIESTI",130534,114,2,1214,893,848,45,890,3,"MUNICIPIUL PLOIESTI",,5,,360,530
30,"Prahova",298,"298-MUNICIPIUL PLOIESTI",130534,115,2,1113,899,776,123,896,3,"MUNICIPIUL PLOIESTI",,5,,365,531
30,"Prahova",298,"298-MUNICIPIUL PLOIESTI",130534,116,2,1119,865,813,52,861,4,"MUNICIPIUL PLOIESTI",,5,,313,548
30,"Prahova",298,"298-MUNICIPIUL PLOIESTI",130534,117,2,1412,993,923,70,977,16,"MUNICIPIUL PLOIESTI",,5,,430,547
30,"Prahova",298,"298-MUNICIPIUL PLOIESTI",130534,118,2,1369,1045,978,67,1039,6,"MUNICIPIUL PLOIESTI",,5,,415,624
30,"Prahova",298,"298-MUNICIPIUL PLOIESTI",130534,119,2,1114,869,818,51,868,1,"MUNICIPIUL PLOIESTI",,5,,380,488
30,"Prahova",298,"298-MUNICIPIUL PLOIESTI",130534,120,2,1094,864,798,66,860,4,"MUNICIPIUL PLOIESTI",,5,,350,510
30,"Prahova",298,"298-MUNICIPIUL PLOIESTI",130534,121,2,1703,1227,1126,101,1225,2,"MUNICIPIUL PLOIESTI",,5,,433,792
30,"Prahova",298,"298-MUNICIPIUL PLOIESTI",130534,122,2,1409,1146,1064,82,1140,5,"MUNICIPIUL PLOIESTI",,5,,431,709
30,"Prahova",298,"298-MUNICIPIUL PLOIESTI",130534,123,2,1110,908,847,61,903,5,"MUNICIPIUL PLOIESTI",,5,,346,557
30,"Prahova",298,"298-MUNICIPIUL PLOIESTI",130534,124,2,1358,1108,1020,88,1104,4,"MUNICIPIUL PLOIESTI",,5,,429,675
30,"Prahova",298,"298-MUNICIPIUL PLOIESTI",130534,125,2,1629,1224,1144,80,1219,5,"MUNICIPIUL PLOIESTI",,5,,450,769
30,"Prahova",298,"298-MUNICIPIUL PLOIESTI",130534,126,2,1418,1159,1049,110,1155,4,"MUNICIPIUL PLOIESTI",,5,,397,758
30,"Prahova",298,"298-MUNICIPIUL PLOIESTI",130534,127,2,1611,1209,1147,62,1204,5,"MUNICIPIUL PLOIESTI",,5,,519,685
30,"Prahova",298,"298-MUNICIPIUL PLOIESTI",130534,128,2,1779,1381,1303,78,1371,10,"MUNICIPIUL PLOIESTI",,5,,645,726
30,"Prahova",298,"298-MUNICIPIUL PLOIESTI",130534,129,2,1848,1366,1241,125,1362,4,"MUNICIPIUL PLOIESTI",,5,,539,823
30,"Prahova",298,"298-MUNICIPIUL PLOIESTI",130534,130,2,819,615,525,90,607,8,"MUNICIPIUL PLOIESTI",,5,,233,374
30,"Prahova",298,"298-MUNICIPIUL PLOIESTI",130534,131,2,0,330,0,330,329,1,"MUNICIPIUL PLOIESTI",,5,,129,200
30,"Prahova",298,"298-MUNICIPIUL PLOIESTI",130534,132,2,0,209,0,209,208,1,"MUNICIPIUL PLOIESTI",,5,,119,89
30,"Prahova",298,"298-MUNICIPIUL PLOIESTI",130534,133,2,0,291,0,291,289,2,"MUNICIPIUL PLOIESTI",,5,,89,200
30,"Prahova",298,"298-MUNICIPIUL PLOIESTI",130534,134,2,0,266,0,266,265,1,"MUNICIPIUL PLOIESTI",,5,,125,140
30,"Prahova",298,"298-MUNICIPIUL PLOIESTI",130534,135,2,0,171,0,171,171,0,"MUNICIPIUL PLOIESTI",,5,,63,108
30,"Prahova",298,"298-MUNICIPIUL PLOIESTI",130534,136,2,0,119,0,119,119,0,"MUNICIPIUL PLOIESTI",,5,,37,82
30,"Prahova",298,"298-MUNICIPIUL PLOIESTI",130534,137,2,0,527,0,527,518,9,"MUNICIPIUL PLOIESTI",,5,,172,346
30,"Prahova",298,"298-MUNICIPIUL PLOIESTI",130534,138,2,0,202,0,202,200,2,"MUNICIPIUL PLOIESTI",,5,,121,79
30,"Prahova",298,"298-MUNICIPIUL PLOIESTI",130534,139,2,0,707,0,707,698,9,"MUNICIPIUL PLOIESTI",,5,,283,415
30,"Prahova",298,"298-MUNICIPIUL PLOIESTI",130534,140,2,0,276,0,276,275,1,"MUNICIPIUL PLOIESTI",,5,,74,201
30,"Prahova",298,"298-MUNICIPIUL PLOIESTI",130534,141,2,0,1139,0,1139,1133,6,"MUNICIPIUL PLOIESTI",,5,,400,733
30,"Prahova",298,"298-MUNICIPIUL PLOIESTI",130534,142,2,0,376,0,376,374,2,"MUNICIPIUL PLOIESTI",,5,,98,276
30,"Prahova",298,"298-MUNICIPIUL CAMPINA",131256,143,2,1501,1223,1160,63,1218,5,"MUNICIPIUL CAMPINA",,5,,423,795
30,"Prahova",298,"298-MUNICIPIUL CAMPINA",131256,144,2,917,780,712,68,776,4,"MUNICIPIUL CAMPINA",,5,,297,479
30,"Prahova",298,"298-MUNICIPIUL CAMPINA",131256,145,2,1889,1758,1418,340,1751,7,"MUNICIPIUL CAMPINA",,5,,639,1112
30,"Prahova",298,"298-MUNICIPIUL CAMPINA",131256,146,2,1138,938,829,109,931,7,"MUNICIPIUL CAMPINA",,5,,333,598
30,"Prahova",298,"298-MUNICIPIUL CAMPINA",131256,147,2,1249,1044,914,130,1038,6,"MUNICIPIUL CAMPINA",,5,,377,661
30,"Prahova",298,"298-MUNICIPIUL CAMPINA",131256,148,2,1408,1118,999,119,1115,3,"MUNICIPIUL CAMPINA",,5,,407,708
30,"Prahova",298,"298-MUNICIPIUL CAMPINA",131256,149,2,1679,1257,1176,81,1246,11,"MUNICIPIUL CAMPINA",,5,,436,810
30,"Prahova",298,"298-MUNICIPIUL CAMPINA",131256,150,2,1178,916,859,57,909,7,"MUNICIPIUL CAMPINA",,5,,331,578
30,"Prahova",298,"298-MUNICIPIUL CAMPINA",131256,151,2,1606,1168,1131,37,1164,4,"MUNICIPIUL CAMPINA",,5,,476,688
30,"Prahova",298,"298-MUNICIPIUL CAMPINA",131256,152,2,1134,880,826,54,875,5,"MUNICIPIUL CAMPINA",,5,,320,555
30,"Prahova",298,"298-MUNICIPIUL CAMPINA",131256,153,2,1439,1117,1017,100,1110,7,"MUNICIPIUL CAMPINA",,5,,409,701
30,"Prahova",298,"298-MUNICIPIUL CAMPINA",131256,154,2,1356,1100,1007,93,1099,1,"MUNICIPIUL CAMPINA",,5,,370,729
30,"Prahova",298,"298-MUNICIPIUL CAMPINA",131256,155,2,1309,1053,936,117,1051,2,"MUNICIPIUL CAMPINA",,5,,394,657
30,"Prahova",298,"298-MUNICIPIUL CAMPINA",131256,156,2,2142,1546,1435,111,1541,5,"MUNICIPIUL CAMPINA",,5,,525,1016
30,"Prahova",298,"298-MUNICIPIUL CAMPINA",131256,157,2,1447,1089,1034,55,1085,4,"MUNICIPIUL CAMPINA",,5,,373,712
30,"Prahova",298,"298-MUNICIPIUL CAMPINA",131256,158,2,1783,1499,1319,180,1489,10,"MUNICIPIUL CAMPINA",,5,,494,995
30,"Prahova",298,"298-MUNICIPIUL CAMPINA",131256,159,2,895,868,649,219,856,12,"MUNICIPIUL CAMPINA",,5,,344,512
30,"Prahova",298,"298-MUNICIPIUL CAMPINA",131256,160,2,1313,1044,963,81,1038,6,"MUNICIPIUL CAMPINA",,5,,353,685
30,"Prahova",298,"298-MUNICIPIUL CAMPINA",131256,161,2,1378,1132,1049,83,1129,3,"MUNICIPIUL CAMPINA",,5,,427,702
30,"Prahova",298,"298-MUNICIPIUL CAMPINA",131256,162,2,1538,1377,1129,248,1373,4,"MUNICIPIUL CAMPINA",,5,,550,823
30,"Prahova",298,"298-MUNICIPIUL CAMPINA",131256,163,2,1346,1223,956,267,1215,8,"MUNICIPIUL CAMPINA",,5,,479,736
30,"Prahova",298,"298-MUNICIPIUL CAMPINA",131256,164,2,1403,1114,914,200,1103,11,"MUNICIPIUL CAMPINA",,5,,371,732
30,"Prahova",298,"298-MUNICIPIUL CAMPINA",131256,165,2,1657,1282,1219,63,1274,8,"MUNICIPIUL CAMPINA",,5,,488,786
30,"Prahova",298,"298-MUNICIPIUL CAMPINA",131256,166,2,0,939,0,939,931,8,"MUNICIPIUL CAMPINA",,5,,565,366
30,"Prahova",298,"298-MUNICIPIUL CAMPINA",131256,167,2,0,546,0,546,543,3,"MUNICIPIUL CAMPINA",,5,,260,283
30,"Prahova",298,"298-MUNICIPIUL CAMPINA",131256,168,2,0,51,0,51,48,3,"MUNICIPIUL CAMPINA",,5,,17,31
30,"Prahova",298,"298-ORAS AZUGA",130954,169,2,1700,1446,1211,235,1438,8,"ORAS AZUGA",,5,,587,851
30,"Prahova",298,"298-ORAS AZUGA",130954,170,2,1083,956,716,240,946,10,"ORAS AZUGA",,5,,417,529
30,"Prahova",298,"298-ORAS AZUGA",130954,171,2,1531,1285,1072,213,1280,5,"ORAS AZUGA",,5,,547,733
30,"Prahova",298,"298-ORAS BAICOI",130981,172,2,1816,1376,1237,139,1372,4,"ORAS BAICOI",,5,,666,706
30,"Prahova",298,"298-ORAS BAICOI",130981,173,2,1874,1459,1346,113,1451,8,"ORAS BAICOI",,5,,633,818
30,"Prahova",298,"298-ORAS BAICOI",130981,174,2,1066,1178,759,419,1170,8,"ORAS BAICOI",,5,,507,663
30,"Prahova",298,"298-ORAS BAICOI",130981,175,2,1181,865,795,70,865,0,"ORAS BAICOI",,5,,378,487
30,"Prahova",298,"298-ORAS BAICOI",130981,176,2,2404,1760,1611,149,1755,5,"ORAS BAICOI",,5,,658,1097
30,"Prahova",298,"298-ORAS BAICOI",130981,177,2,1575,1149,1075,74,1140,9,"ORAS BAICOI",,5,,510,630
30,"Prahova",298,"298-ORAS BAICOI",130981,178,2,1282,1045,867,178,1040,5,"ORAS BAICOI",,5,,437,603
30,"Prahova",298,"298-ORAS BAICOI",130981,179,2,1106,786,745,41,778,8,"ORAS BAICOI",,5,,349,429
30,"Prahova",298,"298-ORAS BAICOI",130981,180,2,1264,945,863,82,939,5,"ORAS BAICOI",,5,,507,432
30,"Prahova",298,"298-ORAS BAICOI",130981,181,2,1091,888,820,68,880,8,"ORAS BAICOI",,5,,471,409
30,"Prahova",298,"298-ORAS BAICOI",130981,182,2,1073,772,699,73,770,2,"ORAS BAICOI",,5,,432,338
30,"Prahova",298,"298-ORAS BAICOI",130981,183,2,0,68,0,68,68,0,"ORAS BAICOI",,5,,26,42
30,"Prahova",298,"298-ORAS BOLDESTI-SCAENI",131069,184,2,1186,925,803,122,917,8,"ORAS BOLDESTI-SCAENI",,5,,355,562
30,"Prahova",298,"298-ORAS BOLDESTI-SCAENI",131069,185,2,1657,1225,1159,66,1220,5,"ORAS BOLDESTI-SCAENI",,5,,424,796
30,"Prahova",298,"298-ORAS BOLDESTI-SCAENI",131069,186,2,1470,1013,949,64,1008,5,"ORAS BOLDESTI-SCAENI",,5,,329,679
30,"Prahova",298,"298-ORAS BOLDESTI-SCAENI",131069,187,2,1245,944,836,108,937,7,"ORAS BOLDESTI-SCAENI",,5,,358,579
30,"Prahova",298,"298-ORAS BOLDESTI-SCAENI",131069,188,2,1128,869,765,104,866,3,"ORAS BOLDESTI-SCAENI",,5,,330,536
30,"Prahova",298,"298-ORAS BOLDESTI-SCAENI",131069,189,2,1122,832,762,70,828,4,"ORAS BOLDESTI-SCAENI",,5,,341,487
30,"Prahova",298,"298-ORAS BOLDESTI-SCAENI",131069,190,2,890,594,527,67,591,3,"ORAS BOLDESTI-SCAENI",,5,,244,347
30,"Prahova",298,"298-ORAS BOLDESTI-SCAENI",131069,191,2,0,270,0,270,270,0,"ORAS BOLDESTI-SCAENI",,5,,155,115
30,"Prahova",298,"298-ORAS BREAZA",131103,192,2,1533,1189,1062,127,1181,8,"ORAS BREAZA",,5,,531,650
30,"Prahova",298,"298-ORAS BREAZA",131103,193,2,1040,854,759,95,848,6,"ORAS BREAZA",,5,,410,438
30,"Prahova",298,"298-ORAS BREAZA",131103,194,2,1092,878,765,113,873,5,"ORAS BREAZA",,5,,444,429
30,"Prahova",298,"298-ORAS BREAZA",131103,195,2,1433,1180,1053,127,1175,5,"ORAS BREAZA",,5,,559,616
30,"Prahova",298,"298-ORAS BREAZA",131103,196,2,1600,1091,893,198,1084,7,"ORAS BREAZA",,5,,457,627
30,"Prahova",298,"298-ORAS BREAZA",131103,197,2,1633,1278,1111,167,1274,4,"ORAS BREAZA",,5,,633,641
30,"Prahova",298,"298-ORAS BREAZA",131103,198,2,1089,833,739,94,828,5,"ORAS BREAZA",,5,,319,509
30,"Prahova",298,"298-ORAS BREAZA",131103,199,2,1050,810,745,65,804,6,"ORAS BREAZA",,5,,304,500
30,"Prahova",298,"298-ORAS BREAZA",131103,200,2,1321,1084,988,96,1081,3,"ORAS BREAZA",,5,,509,572
30,"Prahova",298,"298-ORAS BREAZA",131103,201,2,1028,824,702,122,815,9,"ORAS BREAZA",,5,,410,405
30,"Prahova",298,"298-ORAS BREAZA",131103,202,2,1118,888,763,125,878,10,"ORAS BREAZA",,5,,478,400
30,"Prahova",298,"298-ORAS BREAZA",131103,203,2,1147,835,765,70,826,9,"ORAS BREAZA",,5,,452,374
30,"Prahova",298,"298-ORAS BREAZA",131103,204,2,0,153,0,153,152,1,"ORAS BREAZA",,5,,36,116
30,"Prahova",298,"298-ORAS BUSTENI",131210,205,2,1233,1033,837,196,1029,4,"ORAS BUSTENI",,5,,351,678
30,"Prahova",298,"298-ORAS BUSTENI",131210,206,2,1162,1129,809,320,1123,6,"ORAS BUSTENI",,5,,411,712
30,"Prahova",298,"298-ORAS BUSTENI",131210,207,2,900,836,673,163,831,5,"ORAS BUSTENI",,5,,300,531
30,"Prahova",298,"298-ORAS BUSTENI",131210,208,2,1153,990,842,148,984,6,"ORAS BUSTENI",,5,,310,674
30,"Prahova",298,"298-ORAS BUSTENI",131210,209,2,1156,984,772,212,982,2,"ORAS BUSTENI",,5,,399,583
30,"Prahova",298,"298-ORAS BUSTENI",131210,210,2,1241,1191,875,316,1184,7,"ORAS BUSTENI",,5,,474,710
30,"Prahova",298,"298-ORAS BUSTENI",131210,211,2,1292,1040,875,165,1037,3,"ORAS BUSTENI",,5,,411,626
30,"Prahova",298,"298-ORAS BUSTENI",131210,212,2,1324,1125,964,161,1121,4,"ORAS BUSTENI",,5,,441,680
30,"Prahova",298,"298-ORAS COMARNIC",131336,213,2,1585,1223,1015,208,1217,6,"ORAS COMARNIC",,5,,625,592
30,"Prahova",298,"298-ORAS COMARNIC",131336,214,2,917,685,629,56,678,7,"ORAS COMARNIC",,5,,372,306
30,"Prahova",298,"298-ORAS COMARNIC",131336,215,2,1404,917,860,57,907,10,"ORAS COMARNIC",,5,,473,434
30,"Prahova",298,"298-ORAS COMARNIC",131336,216,2,1547,1026,950,76,1012,14,"ORAS COMARNIC",,5,,584,428
30,"Prahova",298,"298-ORAS COMARNIC",131336,217,2,861,671,612,59,665,6,"ORAS COMARNIC",,5,,387,278
30,"Prahova",298,"298-ORAS COMARNIC",131336,218,2,508,407,387,20,406,1,"ORAS COMARNIC",,5,,234,172
30,"Prahova",298,"298-ORAS COMARNIC",131336,219,2,1579,1050,990,60,1043,7,"ORAS COMARNIC",,5,,514,529
30,"Prahova",298,"298-ORAS COMARNIC",131336,220,2,1130,799,722,77,796,3,"ORAS COMARNIC",,5,,493,303
30,"Prahova",298,"298-ORAS COMARNIC",131336,221,2,1091,851,721,130,845,6,"ORAS COMARNIC",,5,,467,378
30,"Prahova",298,"298-ORAS MIZIL",131407,222,2,1727,1352,1058,294,1345,7,"ORAS MIZIL",,5,,727,618
30,"Prahova",298,"298-ORAS MIZIL",131407,223,2,2190,1605,1411,194,1585,20,"ORAS MIZIL",,5,,988,597
30,"Prahova",298,"298-ORAS MIZIL",131407,224,2,2404,1355,1211,144,1347,8,"ORAS MIZIL",,5,,710,637
30,"Prahova",298,"298-ORAS MIZIL",131407,225,2,1889,1353,1216,137,1347,6,"ORAS MIZIL",,5,,682,665
30,"Prahova",298,"298-ORAS MIZIL",131407,226,2,1871,1325,1175,150,1319,6,"ORAS MIZIL",,5,,705,614
30,"Prahova",298,"298-ORAS MIZIL",131407,227,2,1346,992,869,123,987,5,"ORAS MIZIL",,5,,503,484
30,"Prahova",298,"298-ORAS MIZIL",131407,228,2,1263,918,860,58,918,0,"ORAS MIZIL",,5,,492,426
30,"Prahova",298,"298-ORAS MIZIL",131407,229,2,0,0,0,0,0,0,"ORAS MIZIL",,5,,0,0
30,"Prahova",298,"298-ORAS PLOPENI",131443,230,2,1335,1192,1019,173,1187,5,"ORAS PLOPENI",,5,,668,519
30,"Prahova",298,"298-ORAS PLOPENI",131443,231,2,1511,1411,1127,284,1406,5,"ORAS PLOPENI",,5,,832,574
30,"Prahova",298,"298-ORAS PLOPENI",131443,232,2,1503,1181,1102,79,1178,3,"ORAS PLOPENI",,5,,626,552
30,"Prahova",298,"298-ORAS PLOPENI",131443,233,2,1517,1089,977,112,1080,9,"ORAS PLOPENI",,5,,655,425
30,"Prahova",298,"298-ORAS PLOPENI",131443,234,2,1430,1094,1029,65,1091,3,"ORAS PLOPENI",,5,,611,480
30,"Prahova",298,"298-ORAS PLOPENI",131443,235,2,0,77,0,77,76,1,"ORAS PLOPENI",,5,,35,41
30,"Prahova",298,"298-ORAS SINAIA",131540,236,2,1250,1680,887,793,1673,7,"ORAS SINAIA",,5,,602,1071
30,"Prahova",298,"298-ORAS SINAIA",131540,237,2,1270,1330,953,377,1324,6,"ORAS SINAIA",,5,,459,865
30,"Prahova",298,"298-ORAS SINAIA",131540,238,2,1003,1106,729,377,1100,6,"ORAS SINAIA",,5,,355,745
30,"Prahova",298,"298-ORAS SINAIA",131540,239,2,1179,956,831,125,947,9,"ORAS SINAIA",,5,,349,598
30,"Prahova",298,"298-ORAS SINAIA",131540,240,2,1068,943,796,147,938,5,"ORAS SINAIA",,5,,401,537
30,"Prahova",298,"298-ORAS SINAIA",131540,241,2,1019,875,764,111,864,11,"ORAS SINAIA",,5,,353,511
30,"Prahova",298,"298-ORAS SINAIA",131540,242,2,1497,1309,1113,196,1302,7,"ORAS SINAIA",,5,,468,834
30,"Prahova",298,"298-ORAS SINAIA",131540,243,2,1595,1317,1179,138,1311,6,"ORAS SINAIA",,5,,463,848
30,"Prahova",298,"298-ORAS SINAIA",131540,244,2,1114,890,796,94,885,5,"ORAS SINAIA",,5,,259,626
30,"Prahova",298,"298-ORAS SINAIA",131540,245,2,756,646,560,86,640,6,"ORAS SINAIA",,5,,230,410
30,"Prahova",298,"298-ORAS SINAIA",131540,246,2,0,458,0,458,454,4,"ORAS SINAIA",,5,,181,273
30,"Prahova",298,"298-ORAS SLANIC",131577,247,2,1297,1034,968,66,1024,10,"ORAS SLANIC",,5,,695,329
30,"Prahova",298,"298-ORAS SLANIC",131577,248,2,1314,1157,973,184,1148,9,"ORAS SLANIC",,5,,574,574
30,"Prahova",298,"298-ORAS SLANIC",131577,249,2,1869,1406,1305,101,1394,12,"ORAS SLANIC",,5,,800,594
30,"Prahova",298,"298-ORAS SLANIC",131577,250,2,1534,1254,1162,92,1247,7,"ORAS SLANIC",,5,,944,303
30,"Prahova",298,"298-ORAS URLATI",131620,251,2,1186,829,782,47,822,7,"ORAS URLATI",,5,,342,480
30,"Prahova",298,"298-ORAS URLATI",131620,252,2,1524,1153,1041,112,1144,9,"ORAS URLATI",,5,,557,587
30,"Prahova",298,"298-ORAS URLATI",131620,253,2,1280,901,798,103,896,5,"ORAS URLATI",,5,,424,472
30,"Prahova",298,"298-ORAS URLATI",131620,254,2,1318,919,832,87,909,10,"ORAS URLATI",,5,,493,416
30,"Prahova",298,"298-ORAS URLATI",131620,255,2,1522,972,887,85,965,7,"ORAS URLATI",,5,,459,506
30,"Prahova",298,"298-ORAS URLATI",131620,256,2,1183,827,741,86,821,6,"ORAS URLATI",,5,,400,421
30,"Prahova",298,"298-ORAS URLATI",131620,257,2,875,526,425,101,516,10,"ORAS URLATI",,5,,267,249
30,"Prahova",298,"298-ORAS VALENII DE MUNTE",131817,258,2,1534,1160,1048,112,1153,7,"ORAS VALENII DE MUNTE",,5,,596,557
30,"Prahova",298,"298-ORAS VALENII DE MUNTE",131817,259,2,1535,1155,1027,128,1145,10,"ORAS VALENII DE MUNTE",,5,,588,557
30,"Prahova",298,"298-ORAS VALENII DE MUNTE",131817,260,2,1453,1083,1025,58,1077,6,"ORAS VALENII DE MUNTE",,5,,618,459
30,"Prahova",298,"298-ORAS VALENII DE MUNTE",131817,261,2,1598,1333,1170,163,1326,7,"ORAS VALENII DE MUNTE",,5,,702,624
30,"Prahova",298,"298-ORAS VALENII DE MUNTE",131817,262,2,979,747,704,43,742,4,"ORAS VALENII DE MUNTE",,5,,420,322
30,"Prahova",298,"298-ORAS VALENII DE MUNTE",131817,263,2,1241,860,794,66,858,2,"ORAS VALENII DE MUNTE",,5,,451,407
30,"Prahova",298,"298-ORAS VALENII DE MUNTE",131817,264,2,1387,1087,994,93,1078,9,"ORAS VALENII DE MUNTE",,5,,550,528
30,"Prahova",298,"298-ORAS VALENII DE MUNTE",131817,265,2,790,608,552,56,600,8,"ORAS VALENII DE MUNTE",,5,,363,237
30,"Prahova",298,"298-ADUNATI",131899,266,2,1813,1411,1346,65,1397,14,"ADUNATI",,5,,856,541
30,"Prahova",298,"298-ALBESTI-PALEOLOGU",131933,267,2,1576,1077,907,170,1061,16,"ALBESTI-PALEOLOGU",,5,,469,592
30,"Prahova",298,"298-ALBESTI-PALEOLOGU",131933,268,2,1694,1120,915,205,1108,12,"ALBESTI-PALEOLOGU",,5,,459,649
30,"Prahova",298,"298-ALBESTI-PALEOLOGU",131933,269,2,816,656,520,136,653,3,"ALBESTI-PALEOLOGU",,5,,243,410
30,"Prahova",298,"298-ALBESTI-PALEOLOGU",131933,270,2,624,536,465,71,532,4,"ALBESTI-PALEOLOGU",,5,,280,252
30,"Prahova",298,"298-ALUNIS",131988,271,2,1467,1151,935,216,1145,6,"ALUNIS",,5,,735,410
30,"Prahova",298,"298-ALUNIS",131988,272,2,752,576,461,115,567,9,"ALUNIS",,5,,360,207
30,"Prahova",298,"298-ALUNIS",131988,273,2,838,676,497,179,671,5,"ALUNIS",,5,,435,236
30,"Prahova",298,"298-APOSTOLACHE",132011,274,2,1885,1068,948,120,1052,16,"APOSTOLACHE",,5,,594,458
30,"Prahova",298,"298-ARICESTII RAHTIVANI",132075,275,2,1065,769,676,93,760,9,"ARICESTII RAHTIVANI",,5,,310,450
30,"Prahova",298,"298-ARICESTII RAHTIVANI",132075,276,2,1056,725,624,101,720,5,"ARICESTII RAHTIVANI",,5,,261,459
30,"Prahova",298,"298-ARICESTII RAHTIVANI",132075,277,2,1854,1356,1211,145,1344,12,"ARICESTII RAHTIVANI",,5,,698,646
30,"Prahova",298,"298-ARICESTII RAHTIVANI",132075,278,2,219,276,146,130,275,1,"ARICESTII RAHTIVANI",,5,,165,110
30,"Prahova",298,"298-ARICESTII RAHTIVANI",132075,279,2,950,715,598,117,710,5,"ARICESTII RAHTIVANI",,5,,381,329
30,"Prahova",298,"298-ARICESTII RAHTIVANI",132075,280,2,982,791,683,108,781,10,"ARICESTII RAHTIVANI",,5,,434,347
30,"Prahova",298,"298-ARICESTII RAHTIVANI",132075,281,2,62,70,58,12,70,0,"ARICESTII RAHTIVANI",,5,,33,37
30,"Prahova",298,"298-ARICESTII ZELETIN",132137,282,2,1246,739,645,94,734,4,"ARICESTII ZELETIN",,5,,493,241
30,"Prahova",298,"298-BABA ANA",132164,283,2,1633,1120,1024,96,1111,8,"BABA ANA",,5,,717,394
30,"Prahova",298,"298-BABA ANA",132164,284,2,1006,780,702,78,771,9,"BABA ANA",,5,,554,217
30,"Prahova",298,"298-BABA ANA",132164,285,2,761,511,455,56,505,6,"BABA ANA",,5,,340,165
30,"Prahova",298,"298-BALTA DOAMNEI",132226,286,2,1195,992,916,76,976,16,"BALTA DOAMNEI",,5,,519,457
30,"Prahova",298,"298-BALTA DOAMNEI",132226,287,2,953,673,580,93,661,12,"BALTA DOAMNEI",,5,,446,215
30,"Prahova",298,"298-BALTESTI",132271,288,2,1188,869,737,132,858,11,"BALTESTI",,5,,320,538
30,"Prahova",298,"298-BALTESTI",132271,289,2,1492,989,918,71,978,11,"BALTESTI",,5,,431,547
30,"Prahova",298,"298-BANESTI",132315,290,2,1205,1014,844,170,1002,12,"BANESTI",,5,,444,558
30,"Prahova",298,"298-BANESTI",132315,291,2,1103,975,786,189,971,4,"BANESTI",,5,,373,598
30,"Prahova",298,"298-BANESTI",132315,292,2,936,802,662,140,797,5,"BANESTI",,5,,397,400
30,"Prahova",298,"298-BANESTI",132315,293,2,875,850,675,175,844,6,"BANESTI",,5,,463,381
30,"Prahova",298,"298-BARCANESTI",130552,294,2,1188,631,504,127,620,11,"BARCANESTI",,5,,229,391
30,"Prahova",298,"298-BARCANESTI",130552,295,2,1001,776,574,202,768,8,"BARCANESTI",,5,,300,468
30,"Prahova",298,"298-BARCANESTI",130552,296,2,1685,1143,935,208,1133,10,"BARCANESTI",,5,,448,685
30,"Prahova",298,"298-BARCANESTI",130552,297,2,1282,872,751,121,863,9,"BARCANESTI",,5,,305,558
30,"Prahova",298,"298-BARCANESTI",130552,298,2,1103,856,706,150,846,10,"BARCANESTI",,5,,350,496
30,"Prahova",298,"298-BARCANESTI",130552,299,2,490,402,312,90,399,3,"BARCANESTI",,5,,199,200
30,"Prahova",298,"298-BERCENI",130614,300,2,1223,661,563,98,655,6,"BERCENI",,5,,303,352
30,"Prahova",298,"298-BERCENI",130614,301,2,662,662,576,86,654,8,"BERCENI",,5,,256,398
30,"Prahova",298,"298-BERCENI",130614,302,2,1035,831,725,106,821,10,"BERCENI",,5,,316,505
30,"Prahova",298,"298-BERCENI",130614,303,2,346,314,269,45,310,4,"BERCENI",,5,,130,180
30,"Prahova",298,"298-BERCENI",130614,304,2,446,378,264,114,371,7,"BERCENI",,5,,185,186
30,"Prahova",298,"298-BERCENI",130614,305,2,527,479,367,112,475,4,"BERCENI",,5,,200,275
30,"Prahova",298,"298-BERCENI",130614,306,2,0,149,0,149,147,2,"BERCENI",,5,,69,78
30,"Prahova",298,"298-BERTEA",132342,307,2,1595,1060,972,88,1051,9,"BERTEA",,5,,854,197
30,"Prahova",298,"298-BERTEA",132342,308,2,1268,823,770,53,821,2,"BERTEA",,5,,706,115
30,"Prahova",298,"298-BLEJOI",130678,309,2,1427,1010,771,239,1000,10,"BLEJOI",,5,,365,635
30,"Prahova",298,"298-BLEJOI",130678,310,2,1412,960,668,292,949,11,"BLEJOI",,5,,352,597
30,"Prahova",298,"298-BLEJOI",130678,311,2,1121,736,585,151,729,7,"BLEJOI",,5,,285,444
30,"Prahova",298,"298-BLEJOI",130678,312,2,1076,771,577,194,763,8,"BLEJOI",,5,,252,511
30,"Prahova",298,"298-BLEJOI",130678,313,2,934,884,454,430,879,5,"BLEJOI",,5,,392,487
30,"Prahova",298,"298-BOLDESTI-GRADISTEA",132379,314,2,934,717,667,50,705,12,"BOLDESTI-GRADISTEA",,5,,480,225
30,"Prahova",298,"298-BOLDESTI-GRADISTEA",132379,315,2,913,675,623,52,668,7,"BOLDESTI-GRADISTEA",,5,,476,192
30,"Prahova",298,"298-BRAZI",130712,316,2,1615,1181,969,212,1177,4,"BRAZI",,5,,487,690
30,"Prahova",298,"298-BRAZI",130712,317,2,1275,983,857,126,977,6,"BRAZI",,5,,450,527
30,"Prahova",298,"298-BRAZI",130712,318,2,1400,980,862,118,972,8,"BRAZI",,5,,404,568
30,"Prahova",298,"298-BRAZI",130712,319,2,449,307,246,61,300,7,"BRAZI",,5,,133,167
30,"Prahova",298,"298-BRAZI",130712,320,2,1428,1138,981,157,1124,14,"BRAZI",,5,,648,476
30,"Prahova",298,"298-BRAZI",130712,321,2,0,621,0,621,616,5,"BRAZI",,5,,257,359
30,"Prahova",298,"298-BREBU",132404,322,2,864,632,600,32,626,6,"BREBU",,5,,357,269
30,"Prahova",298,"298-BREBU",132404,323,2,1452,1024,957,67,1019,5,"BREBU",,5,,532,487
30,"Prahova",298,"298-BREBU",132404,324,2,1571,1093,1018,75,1083,10,"BREBU",,5,,603,480
30,"Prahova",298,"298-BREBU",132404,325,2,1258,909,853,56,900,9,"BREBU",,5,,529,371
30,"Prahova",298,"298-BREBU",132404,326,2,1092,674,636,38,669,5,"BREBU",,5,,474,195
30,"Prahova",298,"298-BUCOV",130785,327,2,1600,1107,924,183,1097,10,"BUCOV",,5,,459,638
30,"Prahova",298,"298-BUCOV",130785,328,2,2039,1135,946,189,1135,0,"BUCOV",,5,,439,696
30,"Prahova",298,"298-BUCOV",130785,329,2,1045,800,662,138,795,5,"BUCOV",,5,,321,474
30,"Prahova",298,"298-BUCOV",130785,330,2,1076,848,702,146,839,9,"BUCOV",,5,,316,523
30,"Prahova",298,"298-BUCOV",130785,331,2,984,737,572,165,726,11,"BUCOV",,5,,320,406
30,"Prahova",298,"298-BUCOV",130785,332,2,840,690,449,241,682,8,"BUCOV",,5,,158,524
30,"Prahova",298,"298-BUCOV",130785,333,2,0,108,0,108,104,4,"BUCOV",,5,,54,50
30,"Prahova",298,"298-CALUGARENI",132459,334,2,1173,818,689,129,807,11,"CALUGARENI",,5,,455,352
30,"Prahova",298,"298-CARBUNESTI",132486,335,2,1550,984,896,88,973,11,"CARBUNESTI",,5,,639,334
30,"Prahova",298,"298-CEPTURA",132510,336,2,2174,1396,1262,134,1380,16,"CEPTURA",,5,,881,499
30,"Prahova",298,"298-CEPTURA",132510,337,2,690,482,363,119,480,2,"CEPTURA",,5,,341,139
30,"Prahova",298,"298-CEPTURA",132510,338,2,793,480,419,61,476,4,"CEPTURA",,5,,324,152
30,"Prahova",298,"298-CEPTURA",132510,339,2,1001,619,549,70,610,9,"CEPTURA",,5,,357,253
30,"Prahova",298,"298-CERASU",132574,340,2,2044,1474,1362,112,1465,9,"CERASU",,5,,1031,434
30,"Prahova",298,"298-CERASU",132574,341,2,1740,1220,1137,83,1208,12,"CERASU",,5,,989,219
30,"Prahova",298,"298-CHIOJDEANCA",132645,342,2,1079,681,620,61,669,12,"CHIOJDEANCA",,5,,356,313
30,"Prahova",298,"298-CHIOJDEANCA",132645,343,2,483,397,265,132,391,6,"CHIOJDEANCA",,5,,240,151
30,"Prahova",298,"298-CIORANI",132681,344,2,1023,771,725,46,766,5,"CIORANI",,5,,518,248
30,"Prahova",298,"298-CIORANI",132681,345,2,1742,1172,1067,105,1149,23,"CIORANI",,5,,763,386
30,"Prahova",298,"298-CIORANI",132681,346,2,1033,789,690,99,776,13,"CIORANI",,5,,553,223
30,"Prahova",298,"298-CIORANI",132681,347,2,904,769,706,63,760,9,"CIORANI",,5,,518,242
30,"Prahova",298,"298-CIORANI",132681,348,2,1011,795,717,78,790,5,"CIORANI",,5,,544,246
30,"Prahova",298,"298-CIORANI",132681,349,2,0,94,0,94,94,0,"CIORANI",,5,,76,18
30,"Prahova",298,"298-COCORASTII MISLII",132716,350,2,1678,1263,1180,83,1259,4,"COCORASTII MISLII",,5,,881,378
30,"Prahova",298,"298-COCORASTII MISLII",132716,351,2,1211,1024,874,150,1015,9,"COCORASTII MISLII",,5,,744,271
30,"Prahova",298,"298-COLCEAG",132752,352,2,2175,1212,1095,117,1203,9,"COLCEAG",,5,,756,447
30,"Prahova",298,"298-COLCEAG",132752,353,2,1938,1164,1071,93,1153,11,"COLCEAG",,5,,680,473
30,"Prahova",298,"298-COLCEAG",132752,354,2,1139,777,699,78,766,11,"COLCEAG",,5,,600,166
30,"Prahova",298,"298-CORNU",132805,355,2,1352,958,879,79,954,4,"CORNU",,5,,443,511
30,"Prahova",298,"298-CORNU",132805,356,2,1292,1017,937,80,1014,3,"CORNU",,5,,504,510
30,"Prahova",298,"298-CORNU",132805,357,2,838,676,616,60,668,8,"CORNU",,5,,358,310
30,"Prahova",298,"298-COSMINELE",132841,358,2,1127,828,741,87,822,6,"COSMINELE",,5,,514,308
30,"Prahova",298,"298-DRAJNA",132896,359,2,1230,823,710,113,821,2,"DRAJNA",,5,,438,383
30,"Prahova",298,"298-DRAJNA",132896,360,2,1098,703,587,116,698,5,"DRAJNA",,5,,398,300
30,"Prahova",298,"298-DRAJNA",132896,361,2,653,500,436,64,497,3,"DRAJNA",,5,,342,155
30,"Prahova",298,"298-DRAJNA",132896,362,2,1700,1143,1022,121,1132,11,"DRAJNA",,5,,784,348
30,"Prahova",298,"298-DRAJNA",132896,363,2,0,171,0,171,169,2,"DRAJNA",,5,,68,101
30,"Prahova",298,"298-DRAGANESTI",133018,364,2,929,658,548,110,649,9,"DRAGANESTI",,5,,282,367
30,"Prahova",298,"298-DRAGANESTI",133018,365,2,753,640,564,76,631,9,"DRAGANESTI",,5,,291,340
30,"Prahova",298,"298-DRAGANESTI",133018,366,2,757,634,568,66,630,4,"DRAGANESTI",,5,,370,260
30,"Prahova",298,"298-DRAGANESTI",133018,367,2,516,412,337,75,401,11,"DRAGANESTI",,5,,206,195
30,"Prahova",298,"298-DRAGANESTI",133018,368,2,493,440,333,107,436,4,"DRAGANESTI",,5,,212,224
30,"Prahova",298,"298-DRAGANESTI",133018,369,2,488,414,363,51,411,3,"DRAGANESTI",,5,,208,203
30,"Prahova",298,"298-DUMBRAVA",133090,370,2,1507,1007,877,130,999,8,"DUMBRAVA",,5,,559,440
30,"Prahova",298,"298-DUMBRAVA",133090,371,2,660,549,432,117,545,4,"DUMBRAVA",,5,,279,266
30,"Prahova",298,"298-DUMBRAVA",133090,372,2,1249,831,657,174,819,12,"DUMBRAVA",,5,,354,465
30,"Prahova",298,"298-DUMBRAVESTI",131461,373,2,1622,1155,964,191,1148,7,"DUMBRAVESTI",,5,,703,445
30,"Prahova",298,"298-DUMBRAVESTI",131461,374,2,1203,937,801,136,927,10,"DUMBRAVESTI",,5,,525,402
30,"Prahova",298,"298-FILIPESTII DE PADURE",133161,375,2,1100,670,551,119,665,5,"FILIPESTII DE PADURE",,5,,306,359
30,"Prahova",298,"298-FILIPESTII DE PADURE",133161,376,2,1391,869,718,151,862,7,"FILIPESTII DE PADURE",,5,,471,391
30,"Prahova",298,"298-FILIPESTII DE PADURE",133161,377,2,1789,1312,1137,175,1302,10,"FILIPESTII DE PADURE",,5,,624,678
30,"Prahova",298,"298-FILIPESTII DE PADURE",133161,378,2,1113,749,565,184,743,6,"FILIPESTII DE PADURE",,5,,303,440
30,"Prahova",298,"298-FILIPESTII DE PADURE",133161,379,2,1544,1053,775,278,1047,6,"FILIPESTII DE PADURE",,5,,336,711
30,"Prahova",298,"298-FILIPESTII DE PADURE",133161,380,2,1019,711,542,169,706,5,"FILIPESTII DE PADURE",,5,,418,288
30,"Prahova",298,"298-FILIPESTII DE TARG",133214,381,2,1110,743,594,149,738,5,"FILIPESTII DE TARG",,5,,332,406
30,"Prahova",298,"298-FILIPESTII DE TARG",133214,382,2,1006,707,589,118,701,6,"FILIPESTII DE TARG",,5,,324,377
30,"Prahova",298,"298-FILIPESTII DE TARG",133214,383,2,1359,997,843,154,990,7,"FILIPESTII DE TARG",,5,,438,552
30,"Prahova",298,"298-FILIPESTII DE TARG",133214,384,2,738,550,424,126,548,2,"FILIPESTII DE TARG",,5,,237,311
30,"Prahova",298,"298-FILIPESTII DE TARG",133214,385,2,1498,864,686,178,846,18,"FILIPESTII DE TARG",,5,,418,428
30,"Prahova",298,"298-FANTANELE",133278,386,2,1836,1201,1097,104,1191,10,"FANTANELE",,5,,675,516
30,"Prahova",298,"298-FANTANELE",133278,387,2,1440,1040,900,140,1028,12,"FANTANELE",,5,,519,509
30,"Prahova",298,"298-FLORESTI",133330,388,2,1092,907,616,291,902,5,"FLORESTI",,5,,338,564
30,"Prahova",298,"298-FLORESTI",133330,389,2,1442,1135,823,312,1120,15,"FLORESTI",,5,,490,630
30,"Prahova",298,"298-FLORESTI",133330,390,2,992,797,644,153,796,1,"FLORESTI",,5,,389,407
30,"Prahova",298,"298-FLORESTI",133330,391,2,813,601,490,111,596,5,"FLORESTI",,5,,308,288
30,"Prahova",298,"298-FLORESTI",133330,392,2,876,712,598,114,706,6,"FLORESTI",,5,,377,329
30,"Prahova",298,"298-FULGA",133394,393,2,1454,1036,918,118,1026,10,"FULGA",,5,,744,282
30,"Prahova",298,"298-FULGA",133394,394,2,1796,1429,1287,142,1409,20,"FULGA",,5,,1041,368
30,"Prahova",298,"298-GHERGHITA",133429,395,2,1200,733,590,143,717,16,"GHERGHITA",,5,,409,308
30,"Prahova",298,"298-GHERGHITA",133429,396,2,366,311,252,59,308,3,"GHERGHITA",,5,,176,132
30,"Prahova",298,"298-GHERGHITA",133429,397,2,771,535,331,204,529,6,"GHERGHITA",,5,,305,224
30,"Prahova",298,"298-GHERGHITA",133429,398,2,941,645,440,205,639,6,"GHERGHITA",,5,,387,252
30,"Prahova",298,"298-GORGOTA",133508,399,2,1012,757,623,134,750,7,"GORGOTA",,5,,330,420
30,"Prahova",298,"298-GORGOTA",133508,400,2,1294,872,720,152,865,7,"GORGOTA",,5,,380,485
30,"Prahova",298,"298-GORGOTA",133508,401,2,1235,851,738,113,843,8,"GORGOTA",,5,,334,509
30,"Prahova",298,"298-GORGOTA",133508,402,2,852,675,570,105,670,5,"GORGOTA",,5,,274,396
30,"Prahova",298,"298-GORNET",133562,403,2,932,563,530,33,558,5,"GORNET",,5,,252,306
30,"Prahova",298,"298-GORNET",133562,404,2,1025,721,666,55,714,7,"GORNET",,5,,330,384
30,"Prahova",298,"298-GORNET",133562,405,2,370,266,235,31,262,4,"GORNET",,5,,112,150
30,"Prahova",298,"298-GORNET",133562,406,2,220,171,147,24,167,4,"GORNET",,5,,54,113
30,"Prahova",298,"298-GORNET-CRICOV",133615,407,2,969,612,538,74,604,8,"GORNET-CRICOV",,5,,309,295
30,"Prahova",298,"298-GORNET-CRICOV",133615,408,2,1228,650,598,52,646,4,"GORNET-CRICOV",,5,,316,330
30,"Prahova",298,"298-GURA VADULUI",133688,409,2,1249,857,699,158,846,11,"GURA VADULUI",,5,,455,391
30,"Prahova",298,"298-GURA VADULUI",133688,410,2,820,597,511,86,588,9,"GURA VADULUI",,5,,332,256
30,"Prahova",298,"298-GURA VITIOAREI",131835,411,2,1548,1042,925,117,1035,7,"GURA VITIOAREI",,5,,601,434
30,"Prahova",298,"298-GURA VITIOAREI",131835,412,2,746,484,429,55,477,7,"GURA VITIOAREI",,5,,243,234
30,"Prahova",298,"298-GURA VITIOAREI",131835,413,2,594,474,431,43,468,6,"GURA VITIOAREI",,5,,237,231
30,"Prahova",298,"298-GURA VITIOAREI",131835,414,2,973,660,599,61,646,14,"GURA VITIOAREI",,5,,372,274
30,"Prahova",298,"298-GURA VITIOAREI",131835,415,2,742,611,548,63,597,14,"GURA VITIOAREI",,5,,371,226
30,"Prahova",298,"298-IORDACHEANU",133722,416,2,924,584,502,82,578,6,"IORDACHEANU",,5,,305,273
30,"Prahova",298,"298-IORDACHEANU",133722,417,2,877,540,440,100,537,3,"IORDACHEANU",,5,,248,289
30,"Prahova",298,"298-IORDACHEANU",133722,418,2,1017,699,607,92,694,5,"IORDACHEANU",,5,,427,267
30,"Prahova",298,"298-IORDACHEANU",133722,419,2,995,576,480,96,561,15,"IORDACHEANU",,5,,199,362
30,"Prahova",298,"298-IZVOARELE",133795,420,2,1920,1391,1249,142,1388,3,"IZVOARELE",,5,,840,548
30,"Prahova",298,"298-IZVOARELE",133795,421,2,1818,1239,1089,150,1232,7,"IZVOARELE",,5,,761,471
30,"Prahova",298,"298-IZVOARELE",133795,422,2,580,531,381,150,529,2,"IZVOARELE",,5,,310,219
30,"Prahova",298,"298-IZVOARELE",133795,423,2,987,800,728,72,795,5,"IZVOARELE",,5,,616,179
30,"Prahova",298,"298-JUGURENI",133866,424,2,689,514,443,71,509,5,"JUGURENI",,5,,321,188
30,"Prahova",298,"298-LAPOS",133919,425,2,1208,672,614,58,664,8,"LAPOS",,5,,450,214
30,"Prahova",298,"298-LIPANESTI",133964,426,2,1093,795,635,160,790,5,"LIPANESTI",,5,,290,500
30,"Prahova",298,"298-LIPANESTI",133964,427,2,969,755,639,116,746,9,"LIPANESTI",,5,,372,374
30,"Prahova",298,"298-LIPANESTI",133964,428,2,1596,1226,943,283,1218,8,"LIPANESTI",,5,,460,758
30,"Prahova",298,"298-MAGURELE",134014,429,2,1719,1324,1145,179,1316,8,"MAGURELE",,5,,538,778
30,"Prahova",298,"298-MAGURELE",134014,430,2,1294,911,840,71,907,4,"MAGURELE",,5,,417,490
30,"Prahova",298,"298-MAGURELE",134014,431,2,608,506,445,61,498,8,"MAGURELE",,5,,293,205
30,"Prahova",298,"298-MAGURENI",134050,432,2,1363,957,858,99,954,3,"MAGURENI",,5,,513,441
30,"Prahova",298,"298-MAGURENI",134050,433,2,965,712,643,69,703,9,"MAGURENI",,5,,387,316
30,"Prahova",298,"298-MAGURENI",134050,434,2,1515,897,836,61,890,7,"MAGURENI",,5,,475,415
30,"Prahova",298,"298-MAGURENI",134050,435,2,737,606,508,98,598,8,"MAGURENI",,5,,328,270
30,"Prahova",298,"298-MAGURENI",134050,436,2,665,515,431,84,511,4,"MAGURENI",,5,,212,299
30,"Prahova",298,"298-MANECIU",134096,437,2,1361,1069,803,266,1061,8,"MANECIU",,5,,792,269
30,"Prahova",298,"298-MANECIU",134096,438,2,934,1109,576,533,1102,7,"MANECIU",,5,,699,403
30,"Prahova",298,"298-MANECIU",134096,439,2,748,700,492,208,692,8,"MANECIU",,5,,499,193
30,"Prahova",298,"298-MANECIU",134096,440,2,1226,1036,678,358,1032,4,"MANECIU",,5,,649,383
30,"Prahova",298,"298-MANECIU",134096,441,2,1362,1111,683,428,1100,11,"MANECIU",,5,,742,358
30,"Prahova",298,"298-MANECIU",134096,442,2,1878,1032,978,54,1027,5,"MANECIU",,5,,600,427
30,"Prahova",298,"298-MANECIU",134096,443,2,246,428,182,246,424,4,"MANECIU",,5,,259,165
30,"Prahova",298,"298-MANESTI",134194,444,2,1640,947,819,128,939,8,"MANESTI",,5,,443,496
30,"Prahova",298,"298-MANESTI",134194,445,2,783,513,451,62,499,14,"MANESTI",,5,,255,244
30,"Prahova",298,"298-MANESTI",134194,446,2,829,516,459,57,512,4,"MANESTI",,5,,302,210
30,"Prahova",298,"298-MANESTI",134194,447,2,1018,702,629,73,688,14,"MANESTI",,5,,317,371
30,"Prahova",298,"298-MANESTI",134194,448,2,1426,962,820,142,946,16,"MANESTI",,5,,369,577
30,"Prahova",298,"298-PACURETI",134336,449,2,1122,646,514,132,640,6,"PACURETI",,5,,384,256
30,"Prahova",298,"298-PACURETI",134336,450,2,674,485,388,97,479,6,"PACURETI",,5,,229,250
30,"Prahova",298,"298-PAULESTI",130847,451,2,1025,700,607,93,694,6,"PAULESTI",,5,,275,419
30,"Prahova",298,"298-PAULESTI",130847,452,2,789,736,562,174,728,8,"PAULESTI",,5,,289,439
30,"Prahova",298,"298-PAULESTI",130847,453,2,600,451,377,74,448,3,"PAULESTI",,5,,160,288
30,"Prahova",298,"298-PAULESTI",130847,454,2,815,597,516,81,593,4,"PAULESTI",,5,,280,313
30,"Prahova",298,"298-PAULESTI",130847,455,2,737,679,510,169,675,4,"PAULESTI",,5,,329,346
30,"Prahova",298,"298-PLOPU",134390,456,2,963,543,463,80,534,9,"PLOPU",,5,,294,240
30,"Prahova",298,"298-PLOPU",134390,457,2,789,438,394,44,433,5,"PLOPU",,5,,243,190
30,"Prahova",298,"298-PODENII NOI",134443,458,2,1083,641,521,120,635,6,"PODENII NOI",,5,,273,362
30,"Prahova",298,"298-PODENII NOI",134443,459,2,1343,990,836,154,981,9,"PODENII NOI",,5,,446,535
30,"Prahova",298,"298-PODENII NOI",134443,460,2,1089,703,557,146,703,0,"PODENII NOI",,5,,328,375
30,"Prahova",298,"298-POIANA CAMPINA",131274,461,2,1079,961,706,255,956,5,"POIANA CAMPINA",,5,,482,474
30,"Prahova",298,"298-POIANA CAMPINA",131274,462,2,1668,1348,990,358,1347,1,"POIANA CAMPINA",,5,,596,751
30,"Prahova",298,"298-POIANA CAMPINA",131274,463,2,464,414,327,87,411,3,"POIANA CAMPINA",,5,,198,213
30,"Prahova",298,"298-POIANA CAMPINA",131274,464,2,684,617,411,206,615,2,"POIANA CAMPINA",,5,,250,365
30,"Prahova",298,"298-POIENARII BURCHII",134559,465,2,1200,783,610,173,769,14,"POIENARII BURCHII",,5,,329,440
30,"Prahova",298,"298-POIENARII BURCHII",134559,466,2,482,489,227,262,485,4,"POIENARII BURCHII",,5,,192,293
30,"Prahova",298,"298-POIENARII BURCHII",134559,467,2,1007,839,640,199,832,7,"POIENARII BURCHII",,5,,388,444
30,"Prahova",298,"298-POIENARII BURCHII",134559,468,2,1295,826,666,160,811,15,"POIENARII BURCHII",,5,,492,319
30,"Prahova",298,"298-POIENARII BURCHII",134559,469,2,370,370,223,147,368,2,"POIENARII BURCHII",,5,,214,154
30,"Prahova",298,"298-POSESTI",134648,470,2,839,610,524,86,601,9,"POSESTI",,5,,320,281
30,"Prahova",298,"298-POSESTI",134648,471,2,1250,885,816,69,880,5,"POSESTI",,5,,579,301
30,"Prahova",298,"298-POSESTI",134648,472,2,672,488,455,33,483,5,"POSESTI",,5,,360,123
30,"Prahova",298,"298-POSESTI",134648,473,2,599,458,418,40,453,5,"POSESTI",,5,,309,144
30,"Prahova",298,"298-PREDEAL-SARARI",134755,474,2,851,647,549,98,639,8,"PREDEAL-SARARI",,5,,309,330
30,"Prahova",298,"298-PREDEAL-SARARI",134755,475,2,204,167,120,47,166,1,"PREDEAL-SARARI",,5,,125,41
30,"Prahova",298,"298-PREDEAL-SARARI",134755,476,2,988,691,609,82,684,7,"PREDEAL-SARARI",,5,,401,283
30,"Prahova",298,"298-PROVITA DE JOS",134853,477,2,1062,791,689,102,781,10,"PROVITA DE JOS",,5,,378,403
30,"Prahova",298,"298-PROVITA DE JOS",134853,478,2,963,712,619,93,705,7,"PROVITA DE JOS",,5,,364,341
30,"Prahova",298,"298-PROVITA DE SUS",134899,479,2,1695,1204,1085,119,1187,17,"PROVITA DE SUS",,5,,609,578
30,"Prahova",298,"298-PROVITA DE SUS",134899,480,2,391,320,263,57,313,7,"PROVITA DE SUS",,5,,193,120
30,"Prahova",298,"298-PUCHENII MARI",134942,481,2,1258,888,750,138,878,10,"PUCHENII MARI",,5,,409,469
30,"Prahova",298,"298-PUCHENII MARI",134942,482,2,1022,681,622,59,674,7,"PUCHENII MARI",,5,,339,335
30,"Prahova",298,"298-PUCHENII MARI",134942,483,2,939,742,646,96,737,5,"PUCHENII MARI",,5,,364,373
30,"Prahova",298,"298-PUCHENII MARI",134942,484,2,1172,855,658,197,847,8,"PUCHENII MARI",,5,,475,372
30,"Prahova",298,"298-PUCHENII MARI",134942,485,2,1477,1242,995,247,1227,15,"PUCHENII MARI",,5,,636,591
30,"Prahova",298,"298-PUCHENII MARI",134942,486,2,1348,973,821,152,963,10,"PUCHENII MARI",,5,,473,490
30,"Prahova",298,"298-RAFOV",135020,487,2,907,589,525,64,583,6,"RAFOV",,5,,298,285
30,"Prahova",298,"298-RAFOV",135020,488,2,738,556,490,66,551,5,"RAFOV",,5,,260,291
30,"Prahova",298,"298-RAFOV",135020,489,2,875,585,507,78,579,6,"RAFOV",,5,,249,330
30,"Prahova",298,"298-RAFOV",135020,490,2,866,620,537,83,613,7,"RAFOV",,5,,262,351
30,"Prahova",298,"298-RAFOV",135020,491,2,482,374,323,51,372,2,"RAFOV",,5,,168,204
30,"Prahova",298,"298-RAFOV",135020,492,2,359,272,212,60,268,4,"RAFOV",,5,,126,142
30,"Prahova",298,"298-SALCIA",135128,493,2,1093,703,668,35,695,8,"SALCIA",,5,,467,228
30,"Prahova",298,"298-SALCIILE",135146,494,2,1131,758,699,59,739,19,"SALCIILE",,5,,524,215
30,"Prahova",298,"298-SALCIILE",135146,495,2,987,677,631,46,666,11,"SALCIILE",,5,,461,205
30,"Prahova",298,"298-SCORTENI",135164,496,2,1189,879,637,242,873,6,"SCORTENI",,5,,419,454
30,"Prahova",298,"298-SCORTENI",135164,497,2,1378,1000,702,298,993,7,"SCORTENI",,5,,569,424
30,"Prahova",298,"298-SCORTENI",135164,498,2,846,598,437,161,591,7,"SCORTENI",,5,,297,294
30,"Prahova",298,"298-SCORTENI",135164,499,2,1228,896,645,251,885,11,"SCORTENI",,5,,474,411
30,"Prahova",298,"298-SECARIA",135226,500,2,1060,734,690,44,725,9,"SECARIA",,5,,333,392
30,"Prahova",298,"298-SANGERU",135244,501,2,2600,1467,1308,159,1440,27,"SANGERU",,5,,850,590
30,"Prahova",298,"298-SANGERU",135244,502,2,1734,1095,1020,75,1075,20,"SANGERU",,5,,697,378
30,"Prahova",298,"298-STARCHIOJD",135315,503,2,1666,1035,865,170,1029,6,"STARCHIOJD",,5,,720,309
30,"Prahova",298,"298-STARCHIOJD",135315,504,2,1185,791,680,111,784,7,"STARCHIOJD",,5,,577,207
30,"Prahova",298,"298-STARCHIOJD",135315,505,2,611,453,371,82,451,2,"STARCHIOJD",,5,,347,104
30,"Prahova",298,"298-STARCHIOJD",135315,506,2,1689,1284,1174,110,1273,11,"STARCHIOJD",,5,,995,278
30,"Prahova",298,"298-SURANI",135404,507,2,1427,898,802,96,889,9,"SURANI",,5,,528,361
30,"Prahova",298,"298-SIRNA",135431,508,2,804,599,483,116,595,4,"SIRNA",,5,,232,363
30,"Prahova",298,"298-SIRNA",135431,509,2,895,556,497,59,551,5,"SIRNA",,5,,201,350
30,"Prahova",298,"298-SIRNA",135431,510,2,1628,973,780,193,961,12,"SIRNA",,5,,339,622
30,"Prahova",298,"298-SIRNA",135431,511,2,1207,784,643,141,781,3,"SIRNA",,5,,323,458
30,"Prahova",298,"298-SOIMARI",135501,512,2,1329,941,770,171,927,14,"SOIMARI",,5,,464,463
30,"Prahova",298,"298-SOIMARI",135501,513,2,580,386,330,56,380,6,"SOIMARI",,5,,186,194
30,"Prahova",298,"298-SOIMARI",135501,514,2,467,329,273,56,328,1,"SOIMARI",,5,,199,129
30,"Prahova",298,"298-SOIMARI",135501,515,2,0,50,0,50,50,0,"SOIMARI",,5,,13,37
30,"Prahova",298,"298-SOTRILE",135547,516,2,1243,758,667,91,749,9,"SOTRILE",,5,,380,369
30,"Prahova",298,"298-SOTRILE",135547,517,2,1183,691,568,123,682,9,"SOTRILE",,5,,346,336
30,"Prahova",298,"298-STEFESTI",135618,518,2,1888,1244,1192,52,1234,10,"STEFESTI",,5,,767,467
30,"Prahova",298,"298-TALEA",135654,519,2,990,859,814,45,853,6,"TALEA",,5,,521,332
30,"Prahova",298,"298-TATARU",135681,520,2,1059,683,603,80,673,10,"TATARU",,5,,300,373
30,"Prahova",298,"298-TEISANI",135725,521,2,1483,1185,1040,145,1176,9,"TEISANI",,5,,686,490
30,"Prahova",298,"298-TEISANI",135725,522,2,1607,1180,1072,108,1175,5,"TEISANI",,5,,675,500
30,"Prahova",298,"298-TEISANI",135725,523,2,93,88,65,23,88,0,"TEISANI",,5,,55,33
30,"Prahova",298,"298-TELEGA",135789,524,2,1470,912,818,94,905,7,"TELEGA",,5,,387,518
30,"Prahova",298,"298-TELEGA",135789,525,2,1275,949,844,105,941,8,"TELEGA",,5,,410,531
30,"Prahova",298,"298-TELEGA",135789,526,2,1553,1143,1006,137,1131,12,"TELEGA",,5,,516,615
30,"Prahova",298,"298-TELEGA",135789,527,2,612,466,392,74,460,6,"TELEGA",,5,,243,217
30,"Prahova",298,"298-TELEGA",135789,528,2,499,331,297,34,331,0,"TELEGA",,5,,149,182
30,"Prahova",298,"298-TINOSU",135850,529,2,1540,1021,882,139,1013,8,"TINOSU",,5,,508,505
30,"Prahova",298,"298-TINOSU",135850,530,2,551,464,390,74,460,4,"TINOSU",,5,,227,233
30,"Prahova",298,"298-TARGSORU VECHI",130892,531,2,1585,1231,949,282,1220,11,"TARGSORU VECHI",,5,,539,681
30,"Prahova",298,"298-TARGSORU VECHI",130892,532,2,1577,1146,982,164,1135,11,"TARGSORU VECHI",,5,,522,613
30,"Prahova",298,"298-TARGSORU VECHI",130892,533,2,2356,1090,862,228,1082,8,"TARGSORU VECHI",,5,,612,470
30,"Prahova",298,"298-TARGSORU VECHI",130892,534,2,354,499,212,287,495,4,"TARGSORU VECHI",,5,,267,228
30,"Prahova",298,"298-TARGSORU VECHI",130892,535,2,0,241,0,241,238,3,"TARGSORU VECHI",,5,,114,124
30,"Prahova",298,"298-TOMSANI",135896,536,2,1155,788,721,67,782,6,"TOMSANI",,5,,435,347
30,"Prahova",298,"298-TOMSANI",135896,537,2,1098,793,700,93,783,10,"TOMSANI",,5,,420,363
30,"Prahova",298,"298-TOMSANI",135896,538,2,1170,792,704,88,788,4,"TOMSANI",,5,,384,404
30,"Prahova",298,"298-VALEA CALUGAREASCA",135949,539,2,2502,1310,886,424,1299,11,"VALEA CALUGAREASCA",,5,,635,664
30,"Prahova",298,"298-VALEA CALUGAREASCA",135949,540,2,946,681,446,235,672,9,"VALEA CALUGAREASCA",,5,,324,348
30,"Prahova",298,"298-VALEA CALUGAREASCA",135949,541,2,910,695,466,229,687,8,"VALEA CALUGAREASCA",,5,,316,371
30,"Prahova",298,"298-VALEA CALUGAREASCA",135949,542,2,1389,814,690,124,811,3,"VALEA CALUGAREASCA",,5,,401,410
30,"Prahova",298,"298-VALEA CALUGAREASCA",135949,543,2,793,641,447,194,631,10,"VALEA CALUGAREASCA",,5,,327,304
30,"Prahova",298,"298-VALEA CALUGAREASCA",135949,544,2,1627,939,655,284,932,7,"VALEA CALUGAREASCA",,5,,388,544
30,"Prahova",298,"298-VALEA CALUGAREASCA",135949,545,2,75,66,17,49,65,1,"VALEA CALUGAREASCA",,5,,29,36
30,"Prahova",298,"298-VALEA DOFTANEI",136107,546,2,1197,817,743,74,815,2,"VALEA DOFTANEI",,5,,391,424
30,"Prahova",298,"298-VALEA DOFTANEI",136107,547,2,975,663,644,19,657,6,"VALEA DOFTANEI",,5,,357,300
30,"Prahova",298,"298-VALEA DOFTANEI",136107,548,2,1418,911,873,38,902,9,"VALEA DOFTANEI",,5,,400,502
30,"Prahova",298,"298-VALEA DOFTANEI",136107,549,2,1127,788,739,49,779,9,"VALEA DOFTANEI",,5,,507,272
30,"Prahova",298,"298-VALEA DOFTANEI",136107,550,2,1066,782,761,21,782,0,"VALEA DOFTANEI",,5,,528,254
30,"Prahova",298,"298-VARBILAU",136134,551,2,1576,1328,1197,131,1314,14,"VARBILAU",,5,,1009,305
30,"Prahova",298,"298-VARBILAU",136134,552,2,1283,945,817,128,937,8,"VARBILAU",,5,,693,244
30,"Prahova",298,"298-VARBILAU",136134,553,2,907,741,658,83,728,13,"VARBILAU",,5,,523,205
30,"Prahova",298,"298-VARBILAU",136134,554,2,938,720,589,131,703,17,"VARBILAU",,5,,404,299
30,"Prahova",298,"298-VARBILAU",136134,555,2,728,593,518,75,586,7,"VARBILAU",,5,,397,189
30,"Prahova",298,"298-VALCANESTI",136198,556,2,1347,1000,938,62,986,14,"VALCANESTI",,5,,607,379
30,"Prahova",298,"298-VALCANESTI",136198,557,2,858,697,676,21,692,5,"VALCANESTI",,5,,507,185
30,"Prahova",298,"298-VALCANESTI",136198,558,2,609,488,454,34,488,0,"VALCANESTI",,5,,333,155
30,"Prahova",298,"298-VALCANESTI",136198,559,2,450,348,330,18,347,1,"VALCANESTI",,5,,222,125
31,"Satu Mare",305,"305-MUNICIPIUL SATU MARE",136483,1,2,2082,1541,1448,93,1530,11,"MUNICIPIUL SATU MARE",,2,,86,1444
31,"Satu Mare",305,"305-MUNICIPIUL SATU MARE",136483,2,2,1250,900,844,56,900,0,"MUNICIPIUL SATU MARE",,2,,82,818
31,"Satu Mare",305,"305-MUNICIPIUL SATU MARE",136483,3,2,1750,1345,1284,61,1339,6,"MUNICIPIUL SATU MARE",,2,,102,1237
31,"Satu Mare",305,"305-MUNICIPIUL SATU MARE",136483,4,2,1229,954,891,63,951,3,"MUNICIPIUL SATU MARE",,2,,81,870
31,"Satu Mare",305,"305-MUNICIPIUL SATU MARE",136483,5,2,1783,1178,1104,74,1173,5,"MUNICIPIUL SATU MARE",,2,,176,997
31,"Satu Mare",305,"305-MUNICIPIUL SATU MARE",136483,6,2,1363,1109,881,228,1104,5,"MUNICIPIUL SATU MARE",,2,,146,958
31,"Satu Mare",305,"305-MUNICIPIUL SATU MARE",136483,7,2,1010,782,706,76,778,4,"MUNICIPIUL SATU MARE",,2,,104,674
31,"Satu Mare",305,"305-MUNICIPIUL SATU MARE",136483,8,2,1659,1237,1140,97,1234,3,"MUNICIPIUL SATU MARE",,2,,180,1054
31,"Satu Mare",305,"305-MUNICIPIUL SATU MARE",136483,9,2,1601,1262,1132,130,1262,0,"MUNICIPIUL SATU MARE",,2,,214,1048
31,"Satu Mare",305,"305-MUNICIPIUL SATU MARE",136483,10,2,1802,1231,1152,79,1228,3,"MUNICIPIUL SATU MARE",,2,,190,1038
31,"Satu Mare",305,"305-MUNICIPIUL SATU MARE",136483,11,2,1760,1369,1200,169,1360,9,"MUNICIPIUL SATU MARE",,2,,269,1091
31,"Satu Mare",305,"305-MUNICIPIUL SATU MARE",136483,12,2,1709,1295,1228,67,1292,3,"MUNICIPIUL SATU MARE",,2,,156,1136
31,"Satu Mare",305,"305-MUNICIPIUL SATU MARE",136483,13,2,1283,1241,929,312,1236,5,"MUNICIPIUL SATU MARE",,2,,205,1031
31,"Satu Mare",305,"305-MUNICIPIUL SATU MARE",136483,14,2,1648,1336,1140,196,1331,5,"MUNICIPIUL SATU MARE",,2,,305,1026
31,"Satu Mare",305,"305-MUNICIPIUL SATU MARE",136483,15,2,2318,1578,1368,210,1569,9,"MUNICIPIUL SATU MARE",,2,,377,1192
31,"Satu Mare",305,"305-MUNICIPIUL SATU MARE",136483,16,2,804,597,546,51,596,1,"MUNICIPIUL SATU MARE",,2,,126,470
31,"Satu Mare",305,"305-MUNICIPIUL SATU MARE",136483,17,2,1066,1118,720,398,1118,0,"MUNICIPIUL SATU MARE",,2,,177,941
31,"Satu Mare",305,"305-MUNICIPIUL SATU MARE",136483,18,2,1294,958,901,57,953,5,"MUNICIPIUL SATU MARE",,2,,136,817
31,"Satu Mare",305,"305-MUNICIPIUL SATU MARE",136483,19,2,1271,922,873,49,919,3,"MUNICIPIUL SATU MARE",,2,,129,790
31,"Satu Mare",305,"305-MUNICIPIUL SATU MARE",136483,20,2,1425,1061,988,73,1054,7,"MUNICIPIUL SATU MARE",,2,,184,870
31,"Satu Mare",305,"305-MUNICIPIUL SATU MARE",136483,21,2,1891,1697,1316,381,1685,12,"MUNICIPIUL SATU MARE",,2,,428,1257
31,"Satu Mare",305,"305-MUNICIPIUL SATU MARE",136483,22,2,2182,1534,1338,196,1527,7,"MUNICIPIUL SATU MARE",,2,,294,1233
31,"Satu Mare",305,"305-MUNICIPIUL SATU MARE",136483,23,2,1105,969,767,202,960,9,"MUNICIPIUL SATU MARE",,2,,194,766
31,"Satu Mare",305,"305-MUNICIPIUL SATU MARE",136483,24,2,2279,1626,1516,110,1620,6,"MUNICIPIUL SATU MARE",,2,,222,1398
31,"Satu Mare",305,"305-MUNICIPIUL SATU MARE",136483,25,2,1033,775,676,99,771,4,"MUNICIPIUL SATU MARE",,2,,130,641
31,"Satu Mare",305,"305-MUNICIPIUL SATU MARE",136483,26,2,1619,1433,899,534,1429,4,"MUNICIPIUL SATU MARE",,2,,261,1168
31,"Satu Mare",305,"305-MUNICIPIUL SATU MARE",136483,27,2,1675,1107,716,391,1104,3,"MUNICIPIUL SATU MARE",,2,,191,913
31,"Satu Mare",305,"305-MUNICIPIUL SATU MARE",136483,28,2,1836,1409,1057,352,1406,3,"MUNICIPIUL SATU MARE",,2,,240,1166
31,"Satu Mare",305,"305-MUNICIPIUL SATU MARE",136483,29,2,1780,1453,1214,239,1449,4,"MUNICIPIUL SATU MARE",,2,,232,1217
31,"Satu Mare",305,"305-MUNICIPIUL SATU MARE",136483,30,2,2698,1682,1589,93,1681,1,"MUNICIPIUL SATU MARE",,2,,287,1394
31,"Satu Mare",305,"305-MUNICIPIUL SATU MARE",136483,31,2,1445,1086,1011,75,1079,7,"MUNICIPIUL SATU MARE",,2,,162,917
31,"Satu Mare",305,"305-MUNICIPIUL SATU MARE",136483,32,2,1353,1017,887,130,1012,5,"MUNICIPIUL SATU MARE",,2,,193,819
31,"Satu Mare",305,"305-MUNICIPIUL SATU MARE",136483,33,2,2506,1266,1161,105,1264,2,"MUNICIPIUL SATU MARE",,2,,152,1112
31,"Satu Mare",305,"305-MUNICIPIUL SATU MARE",136483,34,2,1571,1399,412,987,1398,1,"MUNICIPIUL SATU MARE",,2,,264,1134
31,"Satu Mare",305,"305-MUNICIPIUL SATU MARE",136483,35,2,2509,1451,996,455,1449,2,"MUNICIPIUL SATU MARE",,2,,295,1154
31,"Satu Mare",305,"305-MUNICIPIUL SATU MARE",136483,36,2,2502,1760,1338,422,1754,6,"MUNICIPIUL SATU MARE",,2,,303,1451
31,"Satu Mare",305,"305-MUNICIPIUL SATU MARE",136483,37,2,1293,809,641,168,804,5,"MUNICIPIUL SATU MARE",,2,,189,615
31,"Satu Mare",305,"305-MUNICIPIUL SATU MARE",136483,38,2,1242,1150,817,333,1140,10,"MUNICIPIUL SATU MARE",,2,,266,874
31,"Satu Mare",305,"305-MUNICIPIUL SATU MARE",136483,39,2,1254,1380,412,968,1375,5,"MUNICIPIUL SATU MARE",,2,,234,1141
31,"Satu Mare",305,"305-MUNICIPIUL SATU MARE",136483,40,2,2348,1132,1061,71,1128,4,"MUNICIPIUL SATU MARE",,2,,279,849
31,"Satu Mare",305,"305-MUNICIPIUL SATU MARE",136483,41,2,1902,1471,930,541,1464,7,"MUNICIPIUL SATU MARE",,2,,296,1168
31,"Satu Mare",305,"305-MUNICIPIUL SATU MARE",136483,42,2,3200,1043,929,114,1036,7,"MUNICIPIUL SATU MARE",,2,,197,839
31,"Satu Mare",305,"305-MUNICIPIUL SATU MARE",136483,43,2,1758,2192,1758,434,2180,12,"MUNICIPIUL SATU MARE",,2,,305,1875
31,"Satu Mare",305,"305-MUNICIPIUL SATU MARE",136483,44,2,2045,1655,1417,238,1651,4,"MUNICIPIUL SATU MARE",,2,,298,1353
31,"Satu Mare",305,"305-MUNICIPIUL SATU MARE",136483,45,2,1898,1669,1165,504,1663,6,"MUNICIPIUL SATU MARE",,2,,260,1403
31,"Satu Mare",305,"305-MUNICIPIUL SATU MARE",136483,46,2,2095,1591,1441,150,1586,5,"MUNICIPIUL SATU MARE",,2,,325,1261
31,"Satu Mare",305,"305-MUNICIPIUL SATU MARE",136483,47,2,1627,1209,1126,83,1203,6,"MUNICIPIUL SATU MARE",,2,,214,989
31,"Satu Mare",305,"305-MUNICIPIUL SATU MARE",136483,48,2,2288,1552,1412,140,1545,7,"MUNICIPIUL SATU MARE",,2,,192,1353
31,"Satu Mare",305,"305-MUNICIPIUL SATU MARE",136483,49,2,2124,1489,1311,178,1483,6,"MUNICIPIUL SATU MARE",,2,,151,1332
31,"Satu Mare",305,"305-MUNICIPIUL SATU MARE",136483,50,2,2002,1287,1132,155,1281,6,"MUNICIPIUL SATU MARE",,2,,264,1017
31,"Satu Mare",305,"305-MUNICIPIUL SATU MARE",136483,51,2,2331,1650,1354,296,1645,5,"MUNICIPIUL SATU MARE",,2,,290,1355
31,"Satu Mare",305,"305-MUNICIPIUL SATU MARE",136483,52,2,2451,1840,1567,273,1834,6,"MUNICIPIUL SATU MARE",,2,,414,1420
31,"Satu Mare",305,"305-MUNICIPIUL SATU MARE",136483,53,2,2424,1385,1238,147,1384,1,"MUNICIPIUL SATU MARE",,2,,250,1134
31,"Satu Mare",305,"305-MUNICIPIUL SATU MARE",136483,54,2,2861,1973,1681,292,1970,3,"MUNICIPIUL SATU MARE",,2,,413,1557
31,"Satu Mare",305,"305-MUNICIPIUL SATU MARE",136483,55,2,2812,1626,1348,278,1621,5,"MUNICIPIUL SATU MARE",,2,,287,1334
31,"Satu Mare",305,"305-MUNICIPIUL SATU MARE",136483,56,2,2854,1980,1845,135,1977,3,"MUNICIPIUL SATU MARE",,2,,346,1631
31,"Satu Mare",305,"305-MUNICIPIUL SATU MARE",136483,57,2,1552,1147,1087,60,1146,1,"MUNICIPIUL SATU MARE",,2,,197,949
31,"Satu Mare",305,"305-MUNICIPIUL SATU MARE",136483,58,2,1022,914,791,123,910,4,"MUNICIPIUL SATU MARE",,2,,282,628
31,"Satu Mare",305,"305-MUNICIPIUL CAREI",136526,59,2,1485,1074,931,143,1068,6,"MUNICIPIUL CAREI",,2,,149,919
31,"Satu Mare",305,"305-MUNICIPIUL CAREI",136526,60,2,1521,1055,973,82,1048,7,"MUNICIPIUL CAREI",,2,,224,824
31,"Satu Mare",305,"305-MUNICIPIUL CAREI",136526,61,2,1925,1293,1208,85,1285,8,"MUNICIPIUL CAREI",,2,,175,1110
31,"Satu Mare",305,"305-MUNICIPIUL CAREI",136526,62,2,2021,1088,811,277,1083,5,"MUNICIPIUL CAREI",,2,,162,921
31,"Satu Mare",305,"305-MUNICIPIUL CAREI",136526,63,2,1565,1065,341,724,1060,5,"MUNICIPIUL CAREI",,2,,159,901
31,"Satu Mare",305,"305-MUNICIPIUL CAREI",136526,64,2,1329,980,535,445,977,3,"MUNICIPIUL CAREI",,2,,175,802
31,"Satu Mare",305,"305-MUNICIPIUL CAREI",136526,65,2,1272,1251,566,685,1247,4,"MUNICIPIUL CAREI",,2,,209,1038
31,"Satu Mare",305,"305-MUNICIPIUL CAREI",136526,66,2,1409,1141,938,203,1138,3,"MUNICIPIUL CAREI",,2,,255,883
31,"Satu Mare",305,"305-MUNICIPIUL CAREI",136526,67,2,2134,1633,1244,389,1625,8,"MUNICIPIUL CAREI",,2,,241,1384
31,"Satu Mare",305,"305-MUNICIPIUL CAREI",136526,68,2,1595,1187,911,276,1175,12,"MUNICIPIUL CAREI",,2,,181,994
31,"Satu Mare",305,"305-MUNICIPIUL CAREI",136526,69,2,1887,1189,1041,148,1186,3,"MUNICIPIUL CAREI",,2,,175,1011
31,"Satu Mare",305,"305-MUNICIPIUL CAREI",136526,70,2,2935,1487,1346,141,1481,6,"MUNICIPIUL CAREI",,2,,231,1250
31,"Satu Mare",305,"305-MUNICIPIUL CAREI",136526,71,2,866,824,801,23,814,10,"MUNICIPIUL CAREI",,2,,463,351
31,"Satu Mare",305,"305-MUNICIPIUL CAREI",136526,72,2,378,390,292,98,389,1,"MUNICIPIUL CAREI",,2,,253,136
31,"Satu Mare",305,"305-ORAS NEGRESTI-OAS",136599,73,2,3620,1977,1727,250,1972,5,"ORAS NEGRESTI-OAS",,2,,519,1453
31,"Satu Mare",305,"305-ORAS NEGRESTI-OAS",136599,74,2,1752,784,731,53,775,9,"ORAS NEGRESTI-OAS",,2,,236,539
31,"Satu Mare",305,"305-ORAS NEGRESTI-OAS",136599,75,2,2309,1357,1109,248,1351,6,"ORAS NEGRESTI-OAS",,2,,454,897
31,"Satu Mare",305,"305-ORAS NEGRESTI-OAS",136599,76,2,2900,1584,1394,190,1577,7,"ORAS NEGRESTI-OAS",,2,,436,1141
31,"Satu Mare",305,"305-ORAS NEGRESTI-OAS",136599,77,2,1395,668,616,52,663,5,"ORAS NEGRESTI-OAS",,2,,303,360
31,"Satu Mare",305,"305-ORAS TASNAD",136642,78,2,1380,992,902,90,987,5,"ORAS TASNAD",,2,,247,740
31,"Satu Mare",305,"305-ORAS TASNAD",136642,79,2,1604,1117,996,121,1114,3,"ORAS TASNAD",,2,,296,818
31,"Satu Mare",305,"305-ORAS TASNAD",136642,80,2,1778,1228,1145,83,1227,1,"ORAS TASNAD",,2,,273,954
31,"Satu Mare",305,"305-ORAS TASNAD",136642,81,2,1549,1145,1015,130,1134,11,"ORAS TASNAD",,2,,234,900
31,"Satu Mare",305,"305-ORAS TASNAD",136642,82,2,192,164,135,29,164,0,"ORAS TASNAD",,2,,80,84
31,"Satu Mare",305,"305-ORAS TASNAD",136642,83,2,430,321,256,65,318,3,"ORAS TASNAD",,2,,175,143
31,"Satu Mare",305,"305-ORAS TASNAD",136642,84,2,775,611,498,113,595,16,"ORAS TASNAD",,2,,306,289
31,"Satu Mare",305,"305-ORAS TASNAD",136642,85,2,152,152,116,36,149,3,"ORAS TASNAD",,2,,64,85
31,"Satu Mare",305,"305-ORAS TASNAD",136642,86,2,420,414,414,0,413,1,"ORAS TASNAD",,2,,184,229
31,"Satu Mare",305,"305-ACIS",136713,87,2,1260,941,786,155,928,13,"ACIS",,2,,134,794
31,"Satu Mare",305,"305-ACIS",136713,88,2,420,331,256,75,328,3,"ACIS",,2,,28,300
31,"Satu Mare",305,"305-ACIS",136713,89,2,508,384,291,93,381,3,"ACIS",,2,,225,156
31,"Satu Mare",305,"305-ANDRID",136768,90,2,1152,799,671,128,789,10,"ANDRID",,2,,210,579
31,"Satu Mare",305,"305-ANDRID",136768,91,2,602,490,371,119,486,4,"ANDRID",,2,,167,319
31,"Satu Mare",305,"305-ANDRID",136768,92,2,400,275,201,74,269,6,"ANDRID",,2,,8,261
31,"Satu Mare",305,"305-APA",136802,93,2,1746,1525,1407,118,1520,5,"APA",,2,,561,959
31,"Satu Mare",305,"305-APA",136802,94,2,272,278,240,38,278,0,"APA",,2,,171,107
31,"Satu Mare",305,"305-ARDUD",136857,95,2,1747,1158,1088,70,1152,6,"ARDUD",,2,,356,796
31,"Satu Mare",305,"305-ARDUD",136857,96,2,1408,926,859,67,921,5,"ARDUD",,2,,78,843
31,"Satu Mare",305,"305-ARDUD",136857,97,2,535,436,383,53,427,9,"ARDUD",,2,,232,195
31,"Satu Mare",305,"305-ARDUD",136857,98,2,509,482,458,24,479,3,"ARDUD",,2,,219,260
31,"Satu Mare",305,"305-ARDUD",136857,99,2,819,706,669,37,702,4,"ARDUD",,2,,365,337
31,"Satu Mare",305,"305-BATARCI",136919,100,2,1994,1091,986,105,1081,10,"BATARCI",,2,,459,622
31,"Satu Mare",305,"305-BATARCI",136919,101,2,827,630,538,92,628,2,"BATARCI",,2,,282,346
31,"Satu Mare",305,"305-BELTIUG",136964,102,2,1123,953,870,83,945,8,"BELTIUG",,2,,202,743
31,"Satu Mare",305,"305-BELTIUG",136964,103,2,137,120,99,21,116,4,"BELTIUG",,2,,72,44
31,"Satu Mare",305,"305-BELTIUG",136964,104,2,517,477,430,47,475,2,"BELTIUG",,2,,46,429
31,"Satu Mare",305,"305-BELTIUG",136964,105,2,161,174,134,40,171,3,"BELTIUG",,2,,48,123
31,"Satu Mare",305,"305-BELTIUG",136964,106,2,581,454,358,96,442,12,"BELTIUG",,2,,90,352
31,"Satu Mare",305,"305-BERVENI",137032,107,2,1969,1745,1675,70,1737,8,"BERVENI",,2,,58,1679
31,"Satu Mare",305,"305-BERVENI",137032,108,2,822,639,594,45,632,7,"BERVENI",,2,,406,226
31,"Satu Mare",305,"305-BIXAD",137069,109,2,2083,1310,1223,87,1303,7,"BIXAD",,2,,250,1053
31,"Satu Mare",305,"305-BIXAD",137069,110,2,1149,629,559,70,627,2,"BIXAD",,2,,199,428
31,"Satu Mare",305,"305-BIXAD",137069,111,2,2073,1174,1005,169,1164,10,"BIXAD",,2,,333,831
31,"Satu Mare",305,"305-BARSAU",137103,112,2,634,490,454,36,485,5,"BARSAU",,2,,246,239
31,"Satu Mare",305,"305-BARSAU",137103,113,2,1395,1102,1025,77,1094,8,"BARSAU",,2,,404,690
31,"Satu Mare",305,"305-BOGDAND",137130,114,2,941,665,624,41,662,3,"BOGDAND",,2,,16,646
31,"Satu Mare",305,"305-BOGDAND",137130,115,2,807,599,537,62,590,9,"BOGDAND",,2,,366,224
31,"Satu Mare",305,"305-BOGDAND",137130,116,2,449,379,353,26,365,7,"BOGDAND",,2,,245,120
31,"Satu Mare",305,"305-BOGDAND",137130,117,2,663,473,445,28,463,10,"BOGDAND",,2,,34,429
31,"Satu Mare",305,"305-BOTIZ",137185,118,2,714,592,518,74,590,2,"BOTIZ",,2,,20,570
31,"Satu Mare",305,"305-BOTIZ",137185,119,2,1176,985,918,67,979,6,"BOTIZ",,2,,83,896
31,"Satu Mare",305,"305-BOTIZ",137185,120,2,1023,910,790,120,905,5,"BOTIZ",,2,,60,845
31,"Satu Mare",305,"305-BOTIZ",137185,121,2,338,296,253,43,294,2,"BOTIZ",,2,,24,270
31,"Satu Mare",305,"305-CALINESTI-OAS",137229,122,2,2102,1140,1059,81,1138,2,"CALINESTI-OAS",,2,,188,950
31,"Satu Mare",305,"305-CALINESTI-OAS",137229,123,2,592,394,360,34,393,1,"CALINESTI-OAS",,2,,81,312
31,"Satu Mare",305,"305-CALINESTI-OAS",137229,124,2,877,483,455,28,478,5,"CALINESTI-OAS",,2,,68,410
31,"Satu Mare",305,"305-CAPLENI",136553,125,2,2369,1747,1715,32,1737,10,"CAPLENI",,2,,20,1717
31,"Satu Mare",305,"305-CAPLENI",136553,126,2,1101,993,965,28,989,4,"CAPLENI",,2,,31,958
31,"Satu Mare",305,"305-CAMARZANA",137274,127,2,1045,598,570,28,593,5,"CAMARZANA",,2,,50,543
31,"Satu Mare",305,"305-CAMARZANA",137274,128,2,884,515,479,36,514,1,"CAMARZANA",,2,,44,470
31,"Satu Mare",305,"305-CAUAS",137292,129,2,464,360,295,65,355,5,"CAUAS",,2,,139,216
31,"Satu Mare",305,"305-CAUAS",137292,130,2,930,665,582,83,655,10,"CAUAS",,2,,64,591
31,"Satu Mare",305,"305-CAUAS",137292,131,2,185,180,136,44,177,3,"CAUAS",,2,,79,98
31,"Satu Mare",305,"305-CAUAS",137292,132,2,148,122,97,25,122,0,"CAUAS",,2,,33,89
31,"Satu Mare",305,"305-CAUAS",137292,133,2,121,97,81,16,97,0,"CAUAS",,2,,45,52
31,"Satu Mare",305,"305-CAUAS",137292,134,2,100,104,73,31,103,1,"CAUAS",,2,,53,50
31,"Satu Mare",305,"305-CEHAL",137363,135,2,962,584,518,66,577,7,"CEHAL",,2,,301,276
31,"Satu Mare",305,"305-CEHAL",137363,136,2,646,453,404,49,448,5,"CEHAL",,2,,48,400
31,"Satu Mare",305,"305-CEHAL",137363,137,2,346,285,238,47,284,1,"CEHAL",,2,,172,112
31,"Satu Mare",305,"305-CERTEZE",137407,138,2,2535,911,757,154,904,7,"CERTEZE",,2,,507,397
31,"Satu Mare",305,"305-CERTEZE",137407,139,2,831,561,480,81,558,3,"CERTEZE",,2,,155,403
31,"Satu Mare",305,"305-CERTEZE",137407,140,2,924,486,396,90,478,8,"CERTEZE",,2,,174,304
31,"Satu Mare",305,"305-CRAIDOROLT",137443,141,2,1077,839,678,161,833,6,"CRAIDOROLT",,2,,270,563
31,"Satu Mare",305,"305-CRAIDOROLT",137443,142,2,716,480,369,111,475,5,"CRAIDOROLT",,2,,217,258
31,"Satu Mare",305,"305-CRUCISOR",137504,143,2,558,497,472,25,494,3,"CRUCISOR",,2,,198,296
31,"Satu Mare",305,"305-CRUCISOR",137504,144,2,466,434,393,41,433,1,"CRUCISOR",,2,,209,224
31,"Satu Mare",305,"305-CRUCISOR",137504,145,2,1067,879,759,120,875,4,"CRUCISOR",,2,,457,418
31,"Satu Mare",305,"305-CULCIU",137540,146,2,1108,657,559,98,647,10,"CULCIU",,2,,174,473
31,"Satu Mare",305,"305-CULCIU",137540,147,2,929,763,646,117,757,6,"CULCIU",,2,,90,667
31,"Satu Mare",305,"305-CULCIU",137540,148,2,607,428,353,75,424,4,"CULCIU",,2,,73,351
31,"Satu Mare",305,"305-CULCIU",137540,149,2,518,461,356,105,454,7,"CULCIU",,2,,211,243
31,"Satu Mare",305,"305-DOBA",137611,150,2,1169,954,757,197,945,9,"DOBA",,2,,289,656
31,"Satu Mare",305,"305-DOBA",137611,151,2,803,587,466,121,583,4,"DOBA",,2,,155,428
31,"Satu Mare",305,"305-DOROLT",137675,152,2,1526,1102,939,163,1097,5,"DOROLT",,2,,41,1056
31,"Satu Mare",305,"305-DOROLT",137675,153,2,862,753,735,18,752,1,"DOROLT",,2,,6,746
31,"Satu Mare",305,"305-FOIENI",137728,154,2,1508,1258,1227,31,1249,9,"FOIENI",,2,,21,1228
31,"Satu Mare",305,"305-GHERTA MICA",137746,155,2,900,565,486,79,560,5,"GHERTA MICA",,2,,174,386
31,"Satu Mare",305,"305-GHERTA MICA",137746,156,2,914,478,432,46,474,4,"GHERTA MICA",,2,,173,301
31,"Satu Mare",305,"305-HALMEU",137764,157,2,292,239,206,33,235,4,"HALMEU",,2,,16,219
31,"Satu Mare",305,"305-HALMEU",137764,158,2,714,573,546,27,571,2,"HALMEU",,2,,8,563
31,"Satu Mare",305,"305-HALMEU",137764,159,2,262,209,192,17,206,3,"HALMEU",,2,,9,197
31,"Satu Mare",305,"305-HALMEU",137764,160,2,1124,798,742,56,788,10,"HALMEU",,2,,113,675
31,"Satu Mare",305,"305-HALMEU",137764,161,2,1340,967,896,71,958,9,"HALMEU",,2,,80,878
31,"Satu Mare",305,"305-HALMEU",137764,162,2,312,200,174,26,199,1,"HALMEU",,2,,114,85
31,"Satu Mare",305,"305-HALMEU",137764,163,2,1156,915,896,19,907,8,"HALMEU",,2,,12,895
31,"Satu Mare",305,"305-HODOD",137844,164,2,709,539,503,36,538,1,"HODOD",,2,,30,508
31,"Satu Mare",305,"305-HODOD",137844,165,2,683,632,578,54,617,15,"HODOD",,2,,517,100
31,"Satu Mare",305,"305-HODOD",137844,166,2,548,375,358,17,363,12,"HODOD",,2,,34,329
31,"Satu Mare",305,"305-HODOD",137844,167,2,600,478,425,53,473,5,"HODOD",,2,,13,460
31,"Satu Mare",305,"305-HOMOROADE",137899,168,2,987,779,702,77,769,10,"HOMOROADE",,2,,416,353
31,"Satu Mare",305,"305-HOMOROADE",137899,169,2,365,323,293,30,319,4,"HOMOROADE",,2,,206,113
31,"Satu Mare",305,"305-HOMOROADE",137899,170,2,522,407,331,76,395,12,"HOMOROADE",,2,,216,179
31,"Satu Mare",305,"305-LAZURI",137960,171,2,464,312,278,34,310,2,"LAZURI",,2,,12,298
31,"Satu Mare",305,"305-LAZURI",137960,172,2,1594,1204,1031,173,1196,8,"LAZURI",,2,,81,1115
31,"Satu Mare",305,"305-LAZURI",137960,173,2,590,461,438,23,456,5,"LAZURI",,2,,7,449
31,"Satu Mare",305,"305-LAZURI",137960,174,2,227,187,172,15,186,1,"LAZURI",,2,,13,173
31,"Satu Mare",305,"305-LAZURI",137960,175,2,609,436,411,25,433,3,"LAZURI",,2,,32,401
31,"Satu Mare",305,"305-LAZURI",137960,176,2,171,163,130,33,163,0,"LAZURI",,2,,3,160
31,"Satu Mare",305,"305-LIVADA",138048,177,2,2002,1454,1406,48,1436,18,"LIVADA",,2,,110,1326
31,"Satu Mare",305,"305-LIVADA",138048,178,2,1492,1088,1045,43,1077,11,"LIVADA",,2,,78,999
31,"Satu Mare",305,"305-LIVADA",138048,179,2,673,509,459,50,507,2,"LIVADA",,2,,155,352
31,"Satu Mare",305,"305-LIVADA",138048,180,2,375,363,346,17,359,4,"LIVADA",,2,,10,349
31,"Satu Mare",305,"305-LIVADA",138048,181,2,240,214,197,17,210,4,"LIVADA",,2,,105,105
31,"Satu Mare",305,"305-MEDIESU AURIT",138084,182,2,1967,1428,1344,84,1415,13,"MEDIESU AURIT",,2,,537,878
31,"Satu Mare",305,"305-MEDIESU AURIT",138084,183,2,653,459,430,29,454,5,"MEDIESU AURIT",,2,,112,342
31,"Satu Mare",305,"305-MEDIESU AURIT",138084,184,2,508,411,376,35,408,3,"MEDIESU AURIT",,2,,228,180
31,"Satu Mare",305,"305-MEDIESU AURIT",138084,185,2,675,625,431,194,620,5,"MEDIESU AURIT",,2,,213,407
31,"Satu Mare",305,"305-MEDIESU AURIT",138084,186,2,832,646,576,70,638,8,"MEDIESU AURIT",,2,,124,514
31,"Satu Mare",305,"305-MEDIESU AURIT",138084,187,2,442,292,256,36,291,1,"MEDIESU AURIT",,2,,70,221
31,"Satu Mare",305,"305-MICULA",138164,188,2,2104,1500,1283,217,1492,8,"MICULA",,2,,144,1348
31,"Satu Mare",305,"305-MICULA",138164,189,2,504,375,289,86,373,2,"MICULA",,2,,124,249
31,"Satu Mare",305,"305-MOFTIN",138208,190,2,914,701,604,97,698,3,"MOFTIN",,2,,173,525
31,"Satu Mare",305,"305-MOFTIN",138208,191,2,790,626,576,50,615,11,"MOFTIN",,2,,44,571
31,"Satu Mare",305,"305-MOFTIN",138208,192,2,993,832,696,136,824,8,"MOFTIN",,2,,133,691
31,"Satu Mare",305,"305-MOFTIN",138208,193,2,342,366,213,153,359,7,"MOFTIN",,2,,198,161
31,"Satu Mare",305,"305-ODOREU",138280,194,2,1867,1124,1114,10,1121,3,"ODOREU",,2,,165,956
31,"Satu Mare",305,"305-ODOREU",138280,195,2,2130,1231,1177,54,1226,5,"ODOREU",,2,,202,1024
31,"Satu Mare",305,"305-ORASU NOU",138351,196,2,1612,1209,1163,46,1203,6,"ORASU NOU",,2,,35,1168
31,"Satu Mare",305,"305-ORASU NOU",138351,197,2,535,507,468,39,501,6,"ORASU NOU",,2,,291,210
31,"Satu Mare",305,"305-ORASU NOU",138351,198,2,762,440,418,22,435,5,"ORASU NOU",,2,,92,343
31,"Satu Mare",305,"305-ORASU NOU",138351,199,2,1905,1211,1159,52,1198,13,"ORASU NOU",,2,,752,446
31,"Satu Mare",305,"305-ORASU NOU",138351,200,2,469,457,443,14,454,3,"ORASU NOU",,2,,14,440
31,"Satu Mare",305,"305-PAULESTI",138431,201,2,593,502,458,44,500,2,"PAULESTI",,2,,72,428
31,"Satu Mare",305,"305-PAULESTI",138431,202,2,770,539,511,28,532,7,"PAULESTI",,2,,7,525
31,"Satu Mare",305,"305-PAULESTI",138431,203,2,462,436,384,52,436,0,"PAULESTI",,2,,7,429
31,"Satu Mare",305,"305-PAULESTI",138431,204,2,632,531,490,41,525,6,"PAULESTI",,2,,91,434
31,"Satu Mare",305,"305-PAULESTI",138431,205,2,234,216,188,28,214,2,"PAULESTI",,2,,99,115
31,"Satu Mare",305,"305-PAULESTI",138431,206,2,445,340,306,34,338,2,"PAULESTI",,2,,58,280
31,"Satu Mare",305,"305-PETRESTI",138501,207,2,1128,991,878,113,976,15,"PETRESTI",,2,,58,918
31,"Satu Mare",305,"305-PIR",138538,208,2,1465,972,923,49,959,13,"PIR",,2,,289,670
31,"Satu Mare",305,"305-PISCOLT",138574,209,2,1545,1190,1124,66,1174,16,"PISCOLT",,2,,241,933
31,"Satu Mare",305,"305-PISCOLT",138574,210,2,332,322,280,42,318,4,"PISCOLT",,2,,115,203
31,"Satu Mare",305,"305-PISCOLT",138574,211,2,398,413,329,84,406,7,"PISCOLT",,2,,276,130
31,"Satu Mare",305,"305-POMI",138618,212,2,1051,625,549,76,620,5,"POMI",,2,,320,300
31,"Satu Mare",305,"305-POMI",138618,213,2,741,535,410,125,528,7,"POMI",,2,,211,317
31,"Satu Mare",305,"305-SANISLAU",138663,214,2,1164,896,824,72,886,10,"SANISLAU",,2,,52,834
31,"Satu Mare",305,"305-SANISLAU",138663,215,2,1425,1000,876,124,992,8,"SANISLAU",,2,,270,722
31,"Satu Mare",305,"305-SANISLAU",138663,216,2,1218,955,807,148,952,3,"SANISLAU",,2,,86,866
31,"Satu Mare",305,"305-SANISLAU",138663,217,2,197,237,167,70,212,25,"SANISLAU",,2,,132,80
31,"Satu Mare",305,"305-SANISLAU",138663,218,2,248,227,186,41,224,3,"SANISLAU",,2,,170,54
31,"Satu Mare",305,"305-SANTAU",138734,219,2,1438,1177,1042,135,1169,8,"SANTAU",,2,,457,712
31,"Satu Mare",305,"305-SANTAU",138734,220,2,540,480,356,124,476,4,"SANTAU",,2,,196,280
31,"Satu Mare",305,"305-SANTAU",138734,221,2,174,170,126,44,170,0,"SANTAU",,2,,59,111
31,"Satu Mare",305,"305-SACASENI",138770,222,2,282,238,184,54,236,2,"SACASENI",,2,,106,130
31,"Satu Mare",305,"305-SACASENI",138770,223,2,842,621,534,87,611,10,"SACASENI",,2,,70,541
31,"Satu Mare",305,"305-SAUCA",138805,224,2,444,386,351,35,386,0,"SAUCA",,2,,35,351
31,"Satu Mare",305,"305-SAUCA",138805,225,2,266,214,176,38,212,2,"SAUCA",,2,,99,113
31,"Satu Mare",305,"305-SAUCA",138805,226,2,499,406,337,69,405,1,"SAUCA",,2,,210,195
31,"Satu Mare",305,"305-SOCOND",138869,227,2,277,211,134,77,206,5,"SOCOND",,2,,84,122
31,"Satu Mare",305,"305-SOCOND",138869,228,2,473,336,302,34,332,4,"SOCOND",,2,,165,167
31,"Satu Mare",305,"305-SOCOND",138869,229,2,346,295,236,59,294,1,"SOCOND",,2,,155,139
31,"Satu Mare",305,"305-SOCOND",138869,230,2,791,583,520,63,576,7,"SOCOND",,2,,190,386
31,"Satu Mare",305,"305-SOCOND",138869,231,2,415,259,220,39,252,7,"SOCOND",,2,,77,175
31,"Satu Mare",305,"305-SUPUR",138921,232,2,1418,933,770,163,919,14,"SUPUR",,2,,389,530
31,"Satu Mare",305,"305-SUPUR",138921,233,2,1014,769,731,38,761,8,"SUPUR",,2,,13,748
31,"Satu Mare",305,"305-SUPUR",138921,234,2,662,459,409,50,454,5,"SUPUR",,2,,220,234
31,"Satu Mare",305,"305-SUPUR",138921,235,2,654,496,397,99,491,5,"SUPUR",,2,,227,264
31,"Satu Mare",305,"305-TARNA MARE",139009,236,2,1428,1022,901,121,1011,11,"TARNA MARE",,2,,470,541
31,"Satu Mare",305,"305-TARNA MARE",139009,237,2,828,560,520,40,550,10,"TARNA MARE",,2,,212,338
31,"Satu Mare",305,"305-TARNA MARE",139009,238,2,449,338,327,11,333,5,"TARNA MARE",,2,,154,179
31,"Satu Mare",305,"305-TEREBESTI",139054,239,2,499,456,386,70,451,5,"TEREBESTI",,2,,89,362
31,"Satu Mare",305,"305-TEREBESTI",139054,240,2,364,351,285,66,349,2,"TEREBESTI",,2,,201,148
31,"Satu Mare",305,"305-TEREBESTI",139054,241,2,397,373,320,53,373,0,"TEREBESTI",,2,,217,156
31,"Satu Mare",305,"305-TIREAM",139107,242,2,1176,1054,947,107,1040,14,"TIREAM",,2,,183,857
31,"Satu Mare",305,"305-TIREAM",139107,243,2,604,502,412,90,499,3,"TIREAM",,2,,230,269
31,"Satu Mare",305,"305-TARSOLT",139143,244,2,2086,957,913,44,943,14,"TARSOLT",,2,,133,810
31,"Satu Mare",305,"305-TURT",139170,245,2,2048,1281,1249,32,1273,8,"TURT",,2,,417,856
31,"Satu Mare",305,"305-TURT",139170,246,2,1144,712,694,18,709,3,"TURT",,2,,181,528
31,"Satu Mare",305,"305-TURT",139170,247,2,833,554,532,22,551,3,"TURT",,2,,202,349
31,"Satu Mare",305,"305-TURT",139170,248,2,1086,666,627,39,656,10,"TURT",,2,,194,462
31,"Satu Mare",305,"305-TURULUNG",139214,249,2,925,797,765,32,792,5,"TURULUNG",,2,,7,785
31,"Satu Mare",305,"305-TURULUNG",139214,250,2,1229,824,769,55,817,7,"TURULUNG",,2,,27,790
31,"Satu Mare",305,"305-TURULUNG",139214,251,2,748,611,544,67,607,4,"TURULUNG",,2,,246,361
31,"Satu Mare",305,"305-URZICENI",139250,252,2,1192,1045,982,63,1043,2,"URZICENI",,2,,40,1003
31,"Satu Mare",305,"305-VALEA VINULUI",139287,253,2,743,532,458,74,530,2,"VALEA VINULUI",,2,,201,329
31,"Satu Mare",305,"305-VALEA VINULUI",139287,254,2,273,243,195,48,239,4,"VALEA VINULUI",,2,,87,152
31,"Satu Mare",305,"305-VALEA VINULUI",139287,255,2,485,402,361,41,397,5,"VALEA VINULUI",,2,,207,190
31,"Satu Mare",305,"305-VALEA VINULUI",139287,256,2,337,318,214,104,314,4,"VALEA VINULUI",,2,,192,122
31,"Satu Mare",305,"305-VAMA",139330,257,2,1952,1214,1153,61,1204,10,"VAMA",,2,,370,834
31,"Satu Mare",305,"305-VAMA",139330,258,2,574,304,280,24,301,3,"VAMA",,2,,86,215
31,"Satu Mare",305,"305-VETIS",139358,259,2,1260,949,848,101,940,9,"VETIS",,2,,83,857
31,"Satu Mare",305,"305-VETIS",139358,260,2,1119,943,883,60,938,5,"VETIS",,2,,18,920
31,"Satu Mare",305,"305-VETIS",139358,261,2,751,627,556,71,617,10,"VETIS",,2,,225,392
31,"Satu Mare",305,"305-VIILE SATU MARE",139394,262,2,1456,997,751,246,986,11,"VIILE SATU MARE",,2,,58,928
31,"Satu Mare",305,"305-VIILE SATU MARE",139394,263,2,726,409,325,84,395,14,"VIILE SATU MARE",,2,,207,188
31,"Satu Mare",305,"305-VIILE SATU MARE",139394,264,2,256,208,170,38,206,2,"VIILE SATU MARE",,2,,158,48
31,"Satu Mare",305,"305-VIILE SATU MARE",139394,265,2,122,135,97,38,134,1,"VIILE SATU MARE",,2,,52,82
32,"Sălaj",314,"314-MUNICIPIUL ZALAU",139704,1,2,1805,1468,1371,97,1463,5,"MUNICIPIUL ZALAU",,7,,232,1231
32,"Sălaj",314,"314-MUNICIPIUL ZALAU",139704,2,2,2195,1694,1620,74,1690,4,"MUNICIPIUL ZALAU",,7,,470,1220
32,"Sălaj",314,"314-MUNICIPIUL ZALAU",139704,3,2,2300,1908,1745,163,1904,4,"MUNICIPIUL ZALAU",,7,,483,1421
32,"Sălaj",314,"314-MUNICIPIUL ZALAU",139704,4,2,2068,1563,1469,94,1562,1,"MUNICIPIUL ZALAU",,7,,403,1159
32,"Sălaj",314,"314-MUNICIPIUL ZALAU",139704,5,2,2100,1738,1656,82,1732,6,"MUNICIPIUL ZALAU",,7,,492,1240
32,"Sălaj",314,"314-MUNICIPIUL ZALAU",139704,6,2,2015,1719,1520,199,1716,3,"MUNICIPIUL ZALAU",,7,,590,1126
32,"Sălaj",314,"314-MUNICIPIUL ZALAU",139704,7,2,2147,1623,1472,151,1617,6,"MUNICIPIUL ZALAU",,7,,518,1099
32,"Sălaj",314,"314-MUNICIPIUL ZALAU",139704,8,2,2078,1592,1454,138,1589,3,"MUNICIPIUL ZALAU",,7,,465,1124
32,"Sălaj",314,"314-MUNICIPIUL ZALAU",139704,9,2,2362,1715,1591,124,1709,6,"MUNICIPIUL ZALAU",,7,,483,1226
32,"Sălaj",314,"314-MUNICIPIUL ZALAU",139704,10,2,2134,1470,1272,198,1463,7,"MUNICIPIUL ZALAU",,7,,431,1032
32,"Sălaj",314,"314-MUNICIPIUL ZALAU",139704,11,2,2098,1520,1400,120,1514,6,"MUNICIPIUL ZALAU",,7,,455,1059
32,"Sălaj",314,"314-MUNICIPIUL ZALAU",139704,12,2,1996,1386,1244,142,1383,3,"MUNICIPIUL ZALAU",,7,,424,959
32,"Sălaj",314,"314-MUNICIPIUL ZALAU",139704,13,2,2188,1668,1572,96,1660,5,"MUNICIPIUL ZALAU",,7,,384,1276
32,"Sălaj",314,"314-MUNICIPIUL ZALAU",139704,14,2,2332,1842,1690,152,1840,2,"MUNICIPIUL ZALAU",,7,,410,1430
32,"Sălaj",314,"314-MUNICIPIUL ZALAU",139704,15,2,1898,1583,1468,115,1583,0,"MUNICIPIUL ZALAU",,7,,368,1215
32,"Sălaj",314,"314-MUNICIPIUL ZALAU",139704,16,2,1868,1553,1346,207,1550,3,"MUNICIPIUL ZALAU",,7,,349,1201
32,"Sălaj",314,"314-MUNICIPIUL ZALAU",139704,17,2,1713,1351,1182,169,1345,6,"MUNICIPIUL ZALAU",,7,,333,1012
32,"Sălaj",314,"314-MUNICIPIUL ZALAU",139704,18,2,2152,1596,1479,117,1596,0,"MUNICIPIUL ZALAU",,7,,470,1126
32,"Sălaj",314,"314-MUNICIPIUL ZALAU",139704,19,2,2273,1549,1386,163,1544,5,"MUNICIPIUL ZALAU",,7,,440,1104
32,"Sălaj",314,"314-MUNICIPIUL ZALAU",139704,20,2,2223,1625,1491,134,1623,2,"MUNICIPIUL ZALAU",,7,,493,1130
32,"Sălaj",314,"314-MUNICIPIUL ZALAU",139704,21,2,2072,1663,1506,157,1658,5,"MUNICIPIUL ZALAU",,7,,506,1152
32,"Sălaj",314,"314-MUNICIPIUL ZALAU",139704,22,2,1988,1617,1500,117,1615,2,"MUNICIPIUL ZALAU",,7,,495,1120
32,"Sălaj",314,"314-MUNICIPIUL ZALAU",139704,23,2,1190,819,771,48,813,6,"MUNICIPIUL ZALAU",,7,,293,520
32,"Sălaj",314,"314-MUNICIPIUL ZALAU",139704,24,2,323,292,237,55,288,4,"MUNICIPIUL ZALAU",,7,,172,116
32,"Sălaj",314,"314-MUNICIPIUL ZALAU",139704,25,2,0,493,0,493,493,0,"MUNICIPIUL ZALAU",,7,,153,340
32,"Sălaj",314,"314-MUNICIPIUL ZALAU",139704,26,2,0,1212,0,1212,1201,11,"MUNICIPIUL ZALAU",,7,,552,649
32,"Sălaj",314,"314-ORAS CEHU SILVANIEI",139740,27,2,1535,1120,1036,84,1118,2,"ORAS CEHU SILVANIEI",,7,,204,914
32,"Sălaj",314,"314-ORAS CEHU SILVANIEI",139740,28,2,1421,1019,968,51,1015,4,"ORAS CEHU SILVANIEI",,7,,205,810
32,"Sălaj",314,"314-ORAS CEHU SILVANIEI",139740,29,2,1571,1145,1079,66,1144,1,"ORAS CEHU SILVANIEI",,7,,237,907
32,"Sălaj",314,"314-ORAS CEHU SILVANIEI",139740,30,2,179,196,149,47,196,0,"ORAS CEHU SILVANIEI",,7,,116,80
32,"Sălaj",314,"314-ORAS CEHU SILVANIEI",139740,31,2,552,485,434,51,482,3,"ORAS CEHU SILVANIEI",,7,,355,127
32,"Sălaj",314,"314-ORAS CEHU SILVANIEI",139740,32,2,540,467,414,53,461,6,"ORAS CEHU SILVANIEI",,7,,241,220
32,"Sălaj",314,"314-ORAS CEHU SILVANIEI",139740,33,2,819,611,554,57,609,2,"ORAS CEHU SILVANIEI",,7,,141,468
32,"Sălaj",314,"314-ORAS CEHU SILVANIEI",139740,34,2,0,60,0,60,59,1,"ORAS CEHU SILVANIEI",,7,,18,41
32,"Sălaj",314,"314-ORAS JIBOU",139811,35,2,2008,1464,1314,150,1457,7,"ORAS JIBOU",,7,,600,857
32,"Sălaj",314,"314-ORAS JIBOU",139811,36,2,1791,1163,1074,89,1157,6,"ORAS JIBOU",,7,,541,616
32,"Sălaj",314,"314-ORAS JIBOU",139811,37,2,1709,1267,1141,126,1261,6,"ORAS JIBOU",,7,,624,637
32,"Sălaj",314,"314-ORAS JIBOU",139811,38,2,1959,1311,1232,79,1295,16,"ORAS JIBOU",,7,,475,820
32,"Sălaj",314,"314-ORAS JIBOU",139811,39,2,431,318,272,46,318,0,"ORAS JIBOU",,7,,148,170
32,"Sălaj",314,"314-ORAS JIBOU",139811,40,2,543,354,316,38,347,7,"ORAS JIBOU",,7,,253,94
32,"Sălaj",314,"314-ORAS JIBOU",139811,41,2,456,361,334,27,359,2,"ORAS JIBOU",,7,,230,129
32,"Sălaj",314,"314-ORAS SIMLEU SILVANIEI",139884,42,2,1426,1082,1016,66,1070,12,"ORAS SIMLEU SILVANIEI",,7,,329,741
32,"Sălaj",314,"314-ORAS SIMLEU SILVANIEI",139884,43,2,1532,1177,1095,82,1167,10,"ORAS SIMLEU SILVANIEI",,7,,251,916
32,"Sălaj",314,"314-ORAS SIMLEU SILVANIEI",139884,44,2,1492,1200,1072,128,1198,2,"ORAS SIMLEU SILVANIEI",,7,,231,967
32,"Sălaj",314,"314-ORAS SIMLEU SILVANIEI",139884,45,2,1414,1154,1025,129,1151,3,"ORAS SIMLEU SILVANIEI",,7,,246,905
32,"Sălaj",314,"314-ORAS SIMLEU SILVANIEI",139884,46,2,1738,1346,1130,216,1337,9,"ORAS SIMLEU SILVANIEI",,7,,254,1083
32,"Sălaj",314,"314-ORAS SIMLEU SILVANIEI",139884,47,2,1627,1251,1129,122,1250,1,"ORAS SIMLEU SILVANIEI",,7,,231,1019
32,"Sălaj",314,"314-ORAS SIMLEU SILVANIEI",139884,48,2,1728,1129,1018,111,1126,3,"ORAS SIMLEU SILVANIEI",,7,,200,926
32,"Sălaj",314,"314-ORAS SIMLEU SILVANIEI",139884,49,2,784,643,590,53,634,9,"ORAS SIMLEU SILVANIEI",,7,,187,447
32,"Sălaj",314,"314-ORAS SIMLEU SILVANIEI",139884,50,2,765,611,550,61,593,18,"ORAS SIMLEU SILVANIEI",,7,,379,214
32,"Sălaj",314,"314-ORAS SIMLEU SILVANIEI",139884,51,2,434,448,432,16,440,8,"ORAS SIMLEU SILVANIEI",,7,,208,232
32,"Sălaj",314,"314-AGRIJ",139937,52,2,724,605,528,77,601,4,"AGRIJ",,7,,238,363
32,"Sălaj",314,"314-AGRIJ",139937,53,2,331,304,247,57,301,3,"AGRIJ",,7,,106,195
32,"Sălaj",314,"314-ALMASU",139982,54,2,965,745,628,117,742,3,"ALMASU",,7,,322,420
32,"Sălaj",314,"314-ALMASU",139982,55,2,593,472,411,61,468,4,"ALMASU",,7,,229,239
32,"Sălaj",314,"314-ALMASU",139982,56,2,403,369,326,43,367,2,"ALMASU",,7,,43,324
32,"Sălaj",314,"314-ALMASU",139982,57,2,433,440,381,59,439,1,"ALMASU",,7,,58,381
32,"Sălaj",314,"314-ALMASU",139982,58,2,215,220,184,36,217,3,"ALMASU",,7,,66,151
32,"Sălaj",314,"314-BABENI",140084,59,2,840,599,528,71,596,3,"BABENI",,7,,314,282
32,"Sălaj",314,"314-BABENI",140084,60,2,634,489,404,85,481,8,"BABENI",,7,,241,240
32,"Sălaj",314,"314-BABENI",140084,61,2,203,210,172,38,210,0,"BABENI",,7,,165,45
32,"Sălaj",314,"314-BABENI",140084,62,2,345,312,273,39,307,5,"BABENI",,7,,239,68
32,"Sălaj",314,"314-BALAN",140146,63,2,965,617,554,63,611,6,"BALAN",,7,,315,296
32,"Sălaj",314,"314-BALAN",140146,64,2,575,450,347,103,450,0,"BALAN",,7,,234,216
32,"Sălaj",314,"314-BALAN",140146,65,2,710,515,477,38,510,5,"BALAN",,7,,336,174
32,"Sălaj",314,"314-BALAN",140146,66,2,489,415,374,41,414,1,"BALAN",,7,,291,123
32,"Sălaj",314,"314-BALAN",140146,67,2,782,549,449,100,547,2,"BALAN",,7,,350,197
32,"Sălaj",314,"314-BANISOR",140208,68,2,1177,793,692,101,780,13,"BANISOR",,7,,363,417
32,"Sălaj",314,"314-BANISOR",140208,69,2,866,642,604,38,638,4,"BANISOR",,7,,222,416
32,"Sălaj",314,"314-BENESAT",140244,70,2,445,340,298,42,340,0,"BENESAT",,7,,144,196
32,"Sălaj",314,"314-BENESAT",140244,71,2,585,519,460,59,517,2,"BENESAT",,7,,294,223
32,"Sălaj",314,"314-BENESAT",140244,72,2,476,318,289,29,315,3,"BENESAT",,7,,97,218
32,"Sălaj",314,"314-BOBOTA",140280,73,2,1243,1043,893,150,1028,15,"BOBOTA",,7,,510,518
32,"Sălaj",314,"314-BOBOTA",140280,74,2,1275,963,810,153,945,18,"BOBOTA",,7,,452,493
32,"Sălaj",314,"314-BOBOTA",140280,75,2,576,385,333,52,380,5,"BOBOTA",,7,,193,187
32,"Sălaj",314,"314-BOCSA",140324,76,2,790,599,535,64,595,4,"BOCSA",,7,,279,316
32,"Sălaj",314,"314-BOCSA",140324,77,2,1163,900,875,25,896,4,"BOCSA",,7,,9,887
32,"Sălaj",314,"314-BOCSA",140324,78,2,711,562,491,71,558,4,"BOCSA",,7,,301,257
32,"Sălaj",314,"314-BUCIUMI",140379,79,2,1403,1059,932,127,1047,12,"BUCIUMI",,7,,319,728
32,"Sălaj",314,"314-BUCIUMI",140379,80,2,359,362,253,109,357,5,"BUCIUMI",,7,,180,177
32,"Sălaj",314,"314-BUCIUMI",140379,81,2,393,344,253,91,340,4,"BUCIUMI",,7,,110,230
32,"Sălaj",314,"314-BUCIUMI",140379,82,2,277,216,175,41,211,5,"BUCIUMI",,7,,91,120
32,"Sălaj",314,"314-CAMAR",140440,83,2,1587,1248,1217,31,1242,6,"CAMAR",,7,,57,1185
32,"Sălaj",314,"314-CARASTELEC",140477,84,2,957,936,837,99,924,12,"CARASTELEC",,7,,23,901
32,"Sălaj",314,"314-CARASTELEC",140477,85,2,129,103,93,10,100,3,"CARASTELEC",,7,,37,63
32,"Sălaj",314,"314-CHIESD",140501,86,2,1461,937,858,79,922,15,"CHIESD",,7,,376,546
32,"Sălaj",314,"314-CHIESD",140501,87,2,544,392,316,76,390,2,"CHIESD",,7,,223,167
32,"Sălaj",314,"314-CIZER",140547,88,2,1582,1107,918,189,1092,15,"CIZER",,7,,349,743
32,"Sălaj",314,"314-CIZER",140547,89,2,470,364,251,113,356,8,"CIZER",,7,,133,223
32,"Sălaj",314,"314-COSEIU",140583,90,2,434,363,309,54,361,2,"COSEIU",,7,,154,207
32,"Sălaj",314,"314-COSEIU",140583,91,2,394,333,306,27,331,2,"COSEIU",,7,,4,327
32,"Sălaj",314,"314-COSEIU",140583,92,2,296,334,215,119,333,1,"COSEIU",,7,,172,161
32,"Sălaj",314,"314-CRASNA",140627,93,2,2000,1558,1292,266,1554,4,"CRASNA",,7,,71,1483
32,"Sălaj",314,"314-CRASNA",140627,94,2,1395,1200,1121,79,1190,10,"CRASNA",,7,,36,1154
32,"Sălaj",314,"314-CRASNA",140627,95,2,870,609,511,98,601,8,"CRASNA",,7,,210,391
32,"Sălaj",314,"314-CRASNA",140627,96,2,657,500,446,54,491,9,"CRASNA",,7,,170,321
32,"Sălaj",314,"314-CREACA",140672,97,2,626,485,402,83,478,7,"CREACA",,7,,233,245
32,"Sălaj",314,"314-CREACA",140672,98,2,462,367,307,60,365,2,"CREACA",,7,,138,227
32,"Sălaj",314,"314-CREACA",140672,99,2,164,197,125,72,196,1,"CREACA",,7,,109,87
32,"Sălaj",314,"314-CREACA",140672,100,2,165,174,119,55,173,0,"CREACA",,7,,72,101
32,"Sălaj",314,"314-CREACA",140672,101,2,595,504,424,80,500,4,"CREACA",,7,,175,325
32,"Sălaj",314,"314-CREACA",140672,102,2,417,304,275,29,302,2,"CREACA",,7,,163,139
32,"Sălaj",314,"314-CRISTOLT",140770,103,2,781,526,488,38,521,5,"CRISTOLT",,7,,285,236
32,"Sălaj",314,"314-CRISTOLT",140770,104,2,232,216,188,28,216,0,"CRISTOLT",,7,,104,112
32,"Sălaj",314,"314-CRISTOLT",140770,105,2,482,327,295,32,322,5,"CRISTOLT",,7,,192,130
32,"Sălaj",314,"314-CRISENI",140823,106,2,865,655,585,70,649,6,"CRISENI",,7,,365,284
32,"Sălaj",314,"314-CRISENI",140823,107,2,310,292,227,65,288,4,"CRISENI",,7,,7,281
32,"Sălaj",314,"314-CRISENI",140823,108,2,508,433,342,91,428,5,"CRISENI",,7,,124,304
32,"Sălaj",314,"314-CUZAPLAC",140869,109,2,902,738,679,59,729,9,"CUZAPLAC",,7,,373,356
32,"Sălaj",314,"314-CUZAPLAC",140869,110,2,170,146,117,29,145,1,"CUZAPLAC",,7,,49,96
32,"Sălaj",314,"314-CUZAPLAC",140869,111,2,197,169,152,17,167,2,"CUZAPLAC",,7,,140,27
32,"Sălaj",314,"314-CUZAPLAC",140869,112,2,486,399,357,42,391,8,"CUZAPLAC",,7,,151,240
32,"Sălaj",314,"314-CUZAPLAC",140869,113,2,173,129,99,30,128,1,"CUZAPLAC",,7,,75,53
32,"Sălaj",314,"314-DOBRIN",140958,114,2,392,359,314,45,358,1,"DOBRIN",,7,,127,231
32,"Sălaj",314,"314-DOBRIN",140958,115,2,154,184,130,54,184,0,"DOBRIN",,7,,47,137
32,"Sălaj",314,"314-DOBRIN",140958,116,2,573,502,466,36,496,6,"DOBRIN",,7,,16,480
32,"Sălaj",314,"314-DOBRIN",140958,117,2,366,327,303,24,324,3,"DOBRIN",,7,,3,321
32,"Sălaj",314,"314-DRAGU",141027,118,2,511,447,330,117,444,3,"DRAGU",,7,,302,142
32,"Sălaj",314,"314-DRAGU",141027,119,2,170,170,102,68,170,0,"DRAGU",,7,,105,65
32,"Sălaj",314,"314-DRAGU",141027,120,2,77,80,47,33,80,0,"DRAGU",,7,,26,54
32,"Sălaj",314,"314-DRAGU",141027,121,2,316,298,185,113,294,4,"DRAGU",,7,,176,118
32,"Sălaj",314,"314-FILDU DE JOS",141081,122,2,527,455,392,63,454,1,"FILDU DE JOS",,7,,113,341
32,"Sălaj",314,"314-FILDU DE JOS",141081,123,2,803,649,572,77,637,12,"FILDU DE JOS",,7,,245,392
32,"Sălaj",314,"314-GALGAU",141134,124,2,929,743,604,139,740,3,"GALGAU",,7,,455,285
32,"Sălaj",314,"314-GALGAU",141134,125,2,634,527,423,104,519,8,"GALGAU",,7,,294,225
32,"Sălaj",314,"314-GALGAU",141134,126,2,640,541,428,113,539,2,"GALGAU",,7,,241,298
32,"Sălaj",314,"314-GARBOU",141232,127,2,742,503,445,58,497,6,"GARBOU",,7,,241,256
32,"Sălaj",314,"314-GARBOU",141232,128,2,233,225,188,37,223,2,"GARBOU",,7,,162,61
32,"Sălaj",314,"314-GARBOU",141232,129,2,385,337,285,52,333,4,"GARBOU",,7,,187,146
32,"Sălaj",314,"314-GARBOU",141232,130,2,248,220,184,36,215,5,"GARBOU",,7,,118,97
32,"Sălaj",314,"314-GARBOU",141232,131,2,379,230,204,26,229,1,"GARBOU",,7,,100,129
32,"Sălaj",314,"314-GARBOU",141232,132,2,447,360,327,33,359,1,"GARBOU",,7,,231,128
32,"Sălaj",314,"314-HALMASD",141312,133,2,1003,756,676,80,750,6,"HALMASD",,7,,351,399
32,"Sălaj",314,"314-HALMASD",141312,134,2,334,227,201,26,226,1,"HALMASD",,7,,121,105
32,"Sălaj",314,"314-HALMASD",141312,135,2,457,332,292,40,327,5,"HALMASD",,7,,146,181
32,"Sălaj",314,"314-HALMASD",141312,136,2,465,318,282,36,311,7,"HALMASD",,7,,124,187
32,"Sălaj",314,"314-HERECLEAN",141376,137,2,884,644,581,63,638,6,"HERECLEAN",,7,,307,331
32,"Sălaj",314,"314-HERECLEAN",141376,138,2,891,620,508,112,613,7,"HERECLEAN",,7,,39,574
32,"Sălaj",314,"314-HERECLEAN",141376,139,2,469,347,318,29,340,7,"HERECLEAN",,7,,27,313
32,"Sălaj",314,"314-HERECLEAN",141376,140,2,650,567,536,31,561,6,"HERECLEAN",,7,,36,525
32,"Sălaj",314,"314-HIDA",141447,141,2,1127,850,746,104,846,4,"HIDA",,7,,464,382
32,"Sălaj",314,"314-HIDA",141447,142,2,526,377,329,48,374,3,"HIDA",,7,,195,179
32,"Sălaj",314,"314-HIDA",141447,143,2,829,683,543,140,671,12,"HIDA",,7,,434,237
32,"Sălaj",314,"314-HIDA",141447,144,2,314,243,214,29,241,2,"HIDA",,7,,165,76
32,"Sălaj",314,"314-HOROATU CRASNEI",141535,145,2,788,638,557,81,632,6,"HOROATU CRASNEI",,7,,143,489
32,"Sălaj",314,"314-HOROATU CRASNEI",141535,146,2,377,266,206,60,261,5,"HOROATU CRASNEI",,7,,110,151
32,"Sălaj",314,"314-HOROATU CRASNEI",141535,147,2,844,646,502,144,635,11,"HOROATU CRASNEI",,7,,236,399
32,"Sălaj",314,"314-HOROATU CRASNEI",141535,148,2,374,235,181,54,232,3,"HOROATU CRASNEI",,7,,101,131
32,"Sălaj",314,"314-ILEANDA",141580,149,2,1033,818,640,178,808,10,"ILEANDA",,7,,390,418
32,"Sălaj",314,"314-ILEANDA",141580,150,2,170,165,104,61,163,2,"ILEANDA",,7,,95,68
32,"Sălaj",314,"314-ILEANDA",141580,151,2,110,118,91,27,115,3,"ILEANDA",,7,,60,55
32,"Sălaj",314,"314-ILEANDA",141580,152,2,164,152,121,31,152,0,"ILEANDA",,7,,72,80
32,"Sălaj",314,"314-ILEANDA",141580,153,2,256,158,126,32,158,0,"ILEANDA",,7,,52,106
32,"Sălaj",314,"314-ILEANDA",141580,154,2,276,263,212,51,263,0,"ILEANDA",,7,,148,115
32,"Sălaj",314,"314-ILEANDA",141580,155,2,100,98,77,21,95,3,"ILEANDA",,7,,44,51
32,"Sălaj",314,"314-IP",141722,156,2,1418,1006,920,86,998,8,"IP",,7,,140,858
32,"Sălaj",314,"314-IP",141722,157,2,907,711,632,79,706,5,"IP",,7,,22,684
32,"Sălaj",314,"314-IP",141722,158,2,912,644,582,62,633,11,"IP",,7,,253,380
32,"Sălaj",314,"314-LETCA",141786,159,2,840,737,663,74,731,6,"LETCA",,7,,530,201
32,"Sălaj",314,"314-LETCA",141786,160,2,614,388,344,44,383,5,"LETCA",,7,,264,119
32,"Sălaj",314,"314-LETCA",141786,161,2,590,461,425,36,458,3,"LETCA",,7,,289,169
32,"Sălaj",314,"314-LETCA",141786,162,2,229,184,141,43,181,3,"LETCA",,7,,129,52
32,"Sălaj",314,"314-LOZNA",141884,163,2,620,566,466,100,565,1,"LOZNA",,7,,362,203
32,"Sălaj",314,"314-LOZNA",141884,164,2,268,220,173,47,219,1,"LOZNA",,7,,170,49
32,"Sălaj",314,"314-LOZNA",141884,165,2,182,180,154,26,179,1,"LOZNA",,7,,133,46
32,"Sălaj",314,"314-MARCA",141946,166,2,1515,957,888,69,948,9,"MARCA",,7,,508,440
32,"Sălaj",314,"314-MARCA",141946,167,2,968,581,542,39,572,9,"MARCA",,7,,184,388
32,"Sălaj",314,"314-MAERISTE",142006,168,2,691,529,483,46,524,5,"MAERISTE",,7,,299,225
32,"Sălaj",314,"314-MAERISTE",142006,169,2,510,482,438,44,477,5,"MAERISTE",,7,,288,189
32,"Sălaj",314,"314-MAERISTE",142006,170,2,262,209,183,26,209,0,"MAERISTE",,7,,142,67
32,"Sălaj",314,"314-MAERISTE",142006,171,2,893,622,544,78,617,5,"MAERISTE",,7,,205,412
32,"Sălaj",314,"314-MAERISTE",142006,172,2,258,158,133,25,156,2,"MAERISTE",,7,,51,105
32,"Sălaj",314,"314-MAERISTE",142006,173,2,407,382,324,58,379,3,"MAERISTE",,7,,28,351
32,"Sălaj",314,"314-MESESENII DE JOS",142079,174,2,557,417,381,36,413,4,"MESESENII DE JOS",,7,,111,302
32,"Sălaj",314,"314-MESESENII DE JOS",142079,175,2,867,705,626,79,699,6,"MESESENII DE JOS",,7,,172,527
32,"Sălaj",314,"314-MESESENII DE JOS",142079,176,2,85,107,52,55,104,3,"MESESENII DE JOS",,7,,62,42
32,"Sălaj",314,"314-MESESENII DE JOS",142079,177,2,772,576,459,117,566,10,"MESESENII DE JOS",,7,,142,424
32,"Sălaj",314,"314-MIRSID",142122,178,2,698,443,410,33,438,5,"MIRSID",,7,,200,238
32,"Sălaj",314,"314-MIRSID",142122,179,2,388,231,197,34,231,0,"MIRSID",,7,,81,150
32,"Sălaj",314,"314-MIRSID",142122,180,2,645,380,339,41,375,5,"MIRSID",,7,,165,210
32,"Sălaj",314,"314-NAPRADEA",142177,181,2,788,628,553,75,624,4,"NAPRADEA",,7,,415,209
32,"Sălaj",314,"314-NAPRADEA",142177,182,2,659,500,413,87,493,7,"NAPRADEA",,7,,339,154
32,"Sălaj",314,"314-NAPRADEA",142177,183,2,388,348,282,66,344,4,"NAPRADEA",,7,,218,126
32,"Sălaj",314,"314-NAPRADEA",142177,184,2,522,415,352,63,415,0,"NAPRADEA",,7,,261,154
32,"Sălaj",314,"314-NUSFALAU",142239,185,2,2462,2023,1681,342,2010,13,"NUSFALAU",,7,,149,1861
32,"Sălaj",314,"314-NUSFALAU",142239,186,2,1395,1200,1093,107,1196,4,"NUSFALAU",,7,,46,1150
32,"Sălaj",314,"314-NUSFALAU",142239,187,2,407,396,358,38,395,1,"NUSFALAU",,7,,3,392
32,"Sălaj",314,"314-PERICEI",142284,188,2,2232,1868,1774,94,1859,9,"PERICEI",,7,,140,1719
32,"Sălaj",314,"314-PERICEI",142284,189,2,625,588,495,93,579,9,"PERICEI",,7,,138,441
32,"Sălaj",314,"314-PERICEI",142284,190,2,257,247,184,63,242,5,"PERICEI",,7,,92,150
32,"Sălaj",314,"314-PLOPIS",142337,191,2,897,635,547,88,631,4,"PLOPIS",,7,,255,376
32,"Sălaj",314,"314-PLOPIS",142337,192,2,646,378,325,53,368,10,"PLOPIS",,7,,153,215
32,"Sălaj",314,"314-PLOPIS",142337,193,2,596,372,312,60,369,3,"PLOPIS",,7,,36,333
32,"Sălaj",314,"314-POIANA BLENCHII",142373,194,2,759,513,467,46,513,0,"POIANA BLENCHII",,7,,292,221
32,"Sălaj",314,"314-POIANA BLENCHII",142373,195,2,491,360,318,42,358,2,"POIANA BLENCHII",,7,,223,135
32,"Sălaj",314,"314-ROMANASI",142426,196,2,1017,881,760,121,871,10,"ROMANASI",,7,,494,377
32,"Sălaj",314,"314-ROMANASI",142426,197,2,443,375,318,57,375,0,"ROMANASI",,7,,255,120
32,"Sălaj",314,"314-ROMANASI",142426,198,2,381,336,287,49,332,4,"ROMANASI",,7,,161,171
32,"Sălaj",314,"314-ROMANASI",142426,199,2,480,366,313,53,363,3,"ROMANASI",,7,,209,154
32,"Sălaj",314,"314-RUS",142499,200,2,1102,829,722,107,823,6,"RUS",,7,,537,286
32,"Sălaj",314,"314-RUS",142499,201,2,423,346,314,32,340,6,"RUS",,7,,191,149
32,"Sălaj",314,"314-RUS",142499,202,2,955,698,610,88,691,7,"RUS",,7,,447,244
32,"Sălaj",314,"314-SALATIG",142550,203,2,408,334,290,44,334,0,"SALATIG",,7,,104,230
32,"Sălaj",314,"314-SALATIG",142550,204,2,228,209,189,20,201,8,"SALATIG",,7,,83,118
32,"Sălaj",314,"314-SALATIG",142550,205,2,1040,846,824,22,844,2,"SALATIG",,7,,15,829
32,"Sălaj",314,"314-SALATIG",142550,206,2,356,322,272,50,320,2,"SALATIG",,7,,136,184
32,"Sălaj",314,"314-SALATIG",142550,207,2,629,450,417,33,443,7,"SALATIG",,7,,268,175
32,"Sălaj",314,"314-SAG",142612,208,2,1088,772,695,77,768,4,"SAG",,7,,308,460
32,"Sălaj",314,"314-SAG",142612,209,2,836,596,539,57,593,3,"SAG",,7,,250,343
32,"Sălaj",314,"314-SAG",142612,210,2,946,450,413,37,441,9,"SAG",,7,,195,246
32,"Sălaj",314,"314-SANMIHAIU ALMASULUI",142676,211,2,939,666,564,102,660,6,"SANMIHAIU ALMASULUI",,7,,327,333
32,"Sălaj",314,"314-SANMIHAIU ALMASULUI",142676,212,2,509,427,371,56,418,9,"SANMIHAIU ALMASULUI",,7,,221,197
32,"Sălaj",314,"314-SOMES-ODORHEI",142710,213,2,1076,847,752,95,839,8,"SOMES-ODORHEI",,7,,450,389
32,"Sălaj",314,"314-SOMES-ODORHEI",142710,214,2,470,365,260,105,358,7,"SOMES-ODORHEI",,7,,187,171
32,"Sălaj",314,"314-SOMES-ODORHEI",142710,215,2,607,481,415,66,473,8,"SOMES-ODORHEI",,7,,242,231
32,"Sălaj",314,"314-SOMES-ODORHEI",142710,216,2,342,326,264,62,322,4,"SOMES-ODORHEI",,7,,215,107
32,"Sălaj",314,"314-SURDUC",142774,217,2,1075,860,786,74,855,5,"SURDUC",,7,,565,290
32,"Sălaj",314,"314-SURDUC",142774,218,2,895,672,608,64,669,3,"SURDUC",,7,,397,272
32,"Sălaj",314,"314-SURDUC",142774,219,2,415,349,308,41,346,3,"SURDUC",,7,,232,114
32,"Sălaj",314,"314-SURDUC",142774,220,2,334,203,166,37,199,4,"SURDUC",,7,,162,37
32,"Sălaj",314,"314-SURDUC",142774,221,2,338,285,258,27,284,1,"SURDUC",,7,,203,81
32,"Sălaj",314,"314-SURDUC",142774,222,2,378,337,307,30,335,2,"SURDUC",,7,,250,85
32,"Sălaj",314,"314-SAMSUD",142854,223,2,1257,1074,1006,68,1065,9,"SAMSUD",,7,,26,1039
32,"Sălaj",314,"314-SARMASAG",142881,224,2,1962,1846,1775,71,1843,3,"SARMASAG",,7,,27,1816
32,"Sălaj",314,"314-SARMASAG",142881,225,2,1487,1232,1147,85,1220,12,"SARMASAG",,7,,229,991
32,"Sălaj",314,"314-SARMASAG",142881,226,2,617,496,472,24,496,0,"SARMASAG",,7,,6,490
32,"Sălaj",314,"314-SARMASAG",142881,227,2,675,583,549,34,581,2,"SARMASAG",,7,,73,508
32,"Sălaj",314,"314-SARMASAG",142881,228,2,190,176,160,16,175,1,"SARMASAG",,7,,83,92
32,"Sălaj",314,"314-TREZNEA",139973,229,2,522,454,340,114,449,5,"TREZNEA",,7,,238,211
32,"Sălaj",314,"314-TREZNEA",139973,230,2,254,250,199,51,248,2,"TREZNEA",,7,,102,146
32,"Sălaj",314,"314-VALCAU DE JOS",142952,231,2,1832,1117,1023,94,1107,10,"VALCAU DE JOS",,7,,466,641
32,"Sălaj",314,"314-VALCAU DE JOS",142952,232,2,843,432,399,33,428,4,"VALCAU DE JOS",,7,,228,200
32,"Sălaj",314,"314-VARSOLT",143021,233,2,1338,1038,974,64,1028,10,"VARSOLT",,7,,103,925
32,"Sălaj",314,"314-VARSOLT",143021,234,2,679,517,432,85,511,6,"VARSOLT",,7,,240,271
32,"Sălaj",314,"314-ZALHA",143067,235,2,516,417,340,77,416,1,"ZALHA",,7,,226,190
32,"Sălaj",314,"314-ZALHA",143067,236,2,309,283,231,52,283,0,"ZALHA",,7,,114,169
32,"Sălaj",314,"314-ZALHA",143067,237,2,183,132,100,32,128,4,"ZALHA",,7,,49,79
32,"Sălaj",314,"314-ZALHA",143067,238,2,168,145,114,31,139,6,"ZALHA",,7,,77,62
32,"Sălaj",314,"314-ZIMBOR",143147,239,2,769,569,494,75,562,7,"ZIMBOR",,7,,373,189
32,"Sălaj",314,"314-ZIMBOR",143147,240,2,107,119,73,46,116,3,"ZIMBOR",,7,,60,56
32,"Sălaj",314,"314-ZIMBOR",143147,241,2,234,236,168,68,232,4,"ZIMBOR",,7,,129,103
33,"Sibiu",323,"323-MUNICIPIUL SIBIU",143450,1,2,1394,1113,999,114,1107,6,"MUNICIPIUL SIBIU",,7,,215,892
33,"Sibiu",323,"323-MUNICIPIUL SIBIU",143450,2,2,1378,1169,1027,142,1152,17,"MUNICIPIUL SIBIU",,7,,275,877
33,"Sibiu",323,"323-MUNICIPIUL SIBIU",143450,3,2,1892,1465,1371,94,1461,4,"MUNICIPIUL SIBIU",,7,,292,1169
33,"Sibiu",323,"323-MUNICIPIUL SIBIU",143450,4,2,1067,918,815,103,913,5,"MUNICIPIUL SIBIU",,7,,229,684
33,"Sibiu",323,"323-MUNICIPIUL SIBIU",143450,5,2,1221,1039,952,87,1038,1,"MUNICIPIUL SIBIU",,7,,291,747
33,"Sibiu",323,"323-MUNICIPIUL SIBIU",143450,6,2,1190,1010,945,65,1008,2,"MUNICIPIUL SIBIU",,7,,317,691
33,"Sibiu",323,"323-MUNICIPIUL SIBIU",143450,7,2,1336,1104,853,251,1103,1,"MUNICIPIUL SIBIU",,7,,302,801
33,"Sibiu",323,"323-MUNICIPIUL SIBIU",143450,8,2,1144,962,858,104,955,7,"MUNICIPIUL SIBIU",,7,,280,675
33,"Sibiu",323,"323-MUNICIPIUL SIBIU",143450,9,2,1472,1155,1023,132,1153,2,"MUNICIPIUL SIBIU",,7,,321,832
33,"Sibiu",323,"323-MUNICIPIUL SIBIU",143450,10,2,1191,969,905,64,962,7,"MUNICIPIUL SIBIU",,7,,208,754
33,"Sibiu",323,"323-MUNICIPIUL SIBIU",143450,11,2,1832,1355,1258,97,1349,6,"MUNICIPIUL SIBIU",,7,,272,1077
33,"Sibiu",323,"323-MUNICIPIUL SIBIU",143450,12,2,1481,1492,1051,441,1480,12,"MUNICIPIUL SIBIU",,7,,315,1165
33,"Sibiu",323,"323-MUNICIPIUL SIBIU",143450,13,2,1459,1244,1136,108,1242,2,"MUNICIPIUL SIBIU",,7,,331,911
33,"Sibiu",323,"323-MUNICIPIUL SIBIU",143450,14,2,1828,1544,1391,153,1540,4,"MUNICIPIUL SIBIU",,7,,398,1142
33,"Sibiu",323,"323-MUNICIPIUL SIBIU",143450,15,2,1557,1275,1178,97,1269,6,"MUNICIPIUL SIBIU",,7,,338,931
33,"Sibiu",323,"323-MUNICIPIUL SIBIU",143450,16,2,1705,1395,1175,220,1391,4,"MUNICIPIUL SIBIU",,7,,321,1070
33,"Sibiu",323,"323-MUNICIPIUL SIBIU",143450,17,2,1165,971,898,73,967,4,"MUNICIPIUL SIBIU",,7,,220,747
33,"Sibiu",323,"323-MUNICIPIUL SIBIU",143450,18,2,1277,1087,979,108,1078,9,"MUNICIPIUL SIBIU",,7,,267,811
33,"Sibiu",323,"323-MUNICIPIUL SIBIU",143450,19,2,1263,1030,957,73,1025,5,"MUNICIPIUL SIBIU",,7,,297,728
33,"Sibiu",323,"323-MUNICIPIUL SIBIU",143450,20,2,1848,1787,1379,408,1782,5,"MUNICIPIUL SIBIU",,7,,249,1533
33,"Sibiu",323,"323-MUNICIPIUL SIBIU",143450,21,2,1346,1076,1030,46,1073,3,"MUNICIPIUL SIBIU",,7,,248,825
33,"Sibiu",323,"323-MUNICIPIUL SIBIU",143450,22,2,1452,1187,1080,107,1181,6,"MUNICIPIUL SIBIU",,7,,279,902
33,"Sibiu",323,"323-MUNICIPIUL SIBIU",143450,23,2,1356,1096,989,107,1088,8,"MUNICIPIUL SIBIU",,7,,275,813
33,"Sibiu",323,"323-MUNICIPIUL SIBIU",143450,24,2,1386,1141,1040,101,1137,4,"MUNICIPIUL SIBIU",,7,,271,866
33,"Sibiu",323,"323-MUNICIPIUL SIBIU",143450,25,2,1578,1403,1212,191,1396,7,"MUNICIPIUL SIBIU",,7,,296,1100
33,"Sibiu",323,"323-MUNICIPIUL SIBIU",143450,26,2,1725,1453,1338,115,1450,3,"MUNICIPIUL SIBIU",,7,,314,1136
33,"Sibiu",323,"323-MUNICIPIUL SIBIU",143450,27,2,996,788,704,84,776,12,"MUNICIPIUL SIBIU",,7,,218,558
33,"Sibiu",323,"323-MUNICIPIUL SIBIU",143450,28,2,1591,1348,1174,174,1341,4,"MUNICIPIUL SIBIU",,7,,447,894
33,"Sibiu",323,"323-MUNICIPIUL SIBIU",143450,29,2,1030,841,756,85,835,6,"MUNICIPIUL SIBIU",,7,,222,613
33,"Sibiu",323,"323-MUNICIPIUL SIBIU",143450,30,2,1579,1264,1159,105,1259,5,"MUNICIPIUL SIBIU",,7,,363,896
33,"Sibiu",323,"323-MUNICIPIUL SIBIU",143450,31,2,1508,1288,1144,144,1280,8,"MUNICIPIUL SIBIU",,7,,373,907
33,"Sibiu",323,"323-MUNICIPIUL SIBIU",143450,32,2,1280,1206,986,220,1201,5,"MUNICIPIUL SIBIU",,7,,386,815
33,"Sibiu",323,"323-MUNICIPIUL SIBIU",143450,33,2,1256,1069,928,141,1061,8,"MUNICIPIUL SIBIU",,7,,318,743
33,"Sibiu",323,"323-MUNICIPIUL SIBIU",143450,34,2,1527,1299,1149,150,1293,6,"MUNICIPIUL SIBIU",,7,,371,922
33,"Sibiu",323,"323-MUNICIPIUL SIBIU",143450,35,2,1342,1119,1027,92,1115,4,"MUNICIPIUL SIBIU",,7,,346,769
33,"Sibiu",323,"323-MUNICIPIUL SIBIU",143450,36,2,1328,1175,1001,174,1171,4,"MUNICIPIUL SIBIU",,7,,311,860
33,"Sibiu",323,"323-MUNICIPIUL SIBIU",143450,37,2,1720,1442,1332,110,1437,5,"MUNICIPIUL SIBIU",,7,,271,1166
33,"Sibiu",323,"323-MUNICIPIUL SIBIU",143450,38,2,1288,1065,998,67,1064,1,"MUNICIPIUL SIBIU",,7,,193,871
33,"Sibiu",323,"323-MUNICIPIUL SIBIU",143450,39,2,1657,1397,1321,76,1392,5,"MUNICIPIUL SIBIU",,7,,290,1102
33,"Sibiu",323,"323-MUNICIPIUL SIBIU",143450,40,2,1880,1540,1445,95,1533,7,"MUNICIPIUL SIBIU",,7,,364,1169
33,"Sibiu",323,"323-MUNICIPIUL SIBIU",143450,41,2,1600,1267,1212,55,1264,3,"MUNICIPIUL SIBIU",,7,,359,905
33,"Sibiu",323,"323-MUNICIPIUL SIBIU",143450,42,2,1687,1399,1311,88,1394,5,"MUNICIPIUL SIBIU",,7,,300,1094
33,"Sibiu",323,"323-MUNICIPIUL SIBIU",143450,43,2,1783,1402,1348,54,1398,4,"MUNICIPIUL SIBIU",,7,,271,1127
33,"Sibiu",323,"323-MUNICIPIUL SIBIU",143450,44,2,1729,1447,1326,121,1440,7,"MUNICIPIUL SIBIU",,7,,312,1128
33,"Sibiu",323,"323-MUNICIPIUL SIBIU",143450,45,2,1700,1398,1314,84,1394,4,"MUNICIPIUL SIBIU",,7,,238,1156
33,"Sibiu",323,"323-MUNICIPIUL SIBIU",143450,46,2,1126,971,894,77,968,3,"MUNICIPIUL SIBIU",,7,,246,722
33,"Sibiu",323,"323-MUNICIPIUL SIBIU",143450,47,2,1033,856,750,106,853,3,"MUNICIPIUL SIBIU",,7,,200,653
33,"Sibiu",323,"323-MUNICIPIUL SIBIU",143450,48,2,1264,1091,1027,64,1089,2,"MUNICIPIUL SIBIU",,7,,265,824
33,"Sibiu",323,"323-MUNICIPIUL SIBIU",143450,49,2,1636,1377,1233,144,1371,6,"MUNICIPIUL SIBIU",,7,,469,902
33,"Sibiu",323,"323-MUNICIPIUL SIBIU",143450,50,2,1780,1433,1305,128,1428,5,"MUNICIPIUL SIBIU",,7,,402,1026
33,"Sibiu",323,"323-MUNICIPIUL SIBIU",143450,51,2,1552,1229,1151,78,1225,4,"MUNICIPIUL SIBIU",,7,,296,929
33,"Sibiu",323,"323-MUNICIPIUL SIBIU",143450,52,2,1247,1039,947,92,1039,0,"MUNICIPIUL SIBIU",,7,,303,736
33,"Sibiu",323,"323-MUNICIPIUL SIBIU",143450,53,2,1546,1220,1120,100,1210,10,"MUNICIPIUL SIBIU",,7,,352,858
33,"Sibiu",323,"323-MUNICIPIUL SIBIU",143450,54,2,1248,992,904,88,990,2,"MUNICIPIUL SIBIU",,7,,291,699
33,"Sibiu",323,"323-MUNICIPIUL SIBIU",143450,55,2,950,815,742,73,812,3,"MUNICIPIUL SIBIU",,7,,306,506
33,"Sibiu",323,"323-MUNICIPIUL SIBIU",143450,56,2,1483,1255,1111,144,1248,6,"MUNICIPIUL SIBIU",,7,,273,975
33,"Sibiu",323,"323-MUNICIPIUL SIBIU",143450,57,2,1526,1265,1191,74,1260,5,"MUNICIPIUL SIBIU",,7,,369,891
33,"Sibiu",323,"323-MUNICIPIUL SIBIU",143450,58,2,1726,1142,1016,126,1137,5,"MUNICIPIUL SIBIU",,7,,307,830
33,"Sibiu",323,"323-MUNICIPIUL SIBIU",143450,59,2,1956,1959,1472,487,1953,6,"MUNICIPIUL SIBIU",,7,,332,1621
33,"Sibiu",323,"323-MUNICIPIUL SIBIU",143450,60,2,1427,1321,973,348,1320,1,"MUNICIPIUL SIBIU",,7,,283,1037
33,"Sibiu",323,"323-MUNICIPIUL SIBIU",143450,61,2,1941,1547,1448,99,1543,4,"MUNICIPIUL SIBIU",,7,,350,1193
33,"Sibiu",323,"323-MUNICIPIUL SIBIU",143450,62,2,1995,1598,1523,75,1589,9,"MUNICIPIUL SIBIU",,7,,318,1271
33,"Sibiu",323,"323-MUNICIPIUL SIBIU",143450,63,2,1956,1510,1443,67,1509,1,"MUNICIPIUL SIBIU",,7,,294,1215
33,"Sibiu",323,"323-MUNICIPIUL SIBIU",143450,64,2,1859,1418,1320,98,1417,1,"MUNICIPIUL SIBIU",,7,,299,1118
33,"Sibiu",323,"323-MUNICIPIUL SIBIU",143450,65,2,1818,1470,1362,108,1467,3,"MUNICIPIUL SIBIU",,7,,355,1112
33,"Sibiu",323,"323-MUNICIPIUL SIBIU",143450,66,2,1960,1579,1446,133,1576,3,"MUNICIPIUL SIBIU",,7,,300,1276
33,"Sibiu",323,"323-MUNICIPIUL SIBIU",143450,67,2,1834,1459,1379,80,1452,6,"MUNICIPIUL SIBIU",,7,,451,1001
33,"Sibiu",323,"323-MUNICIPIUL SIBIU",143450,68,2,1585,1280,1186,94,1273,7,"MUNICIPIUL SIBIU",,7,,388,885
33,"Sibiu",323,"323-MUNICIPIUL SIBIU",143450,69,2,1607,1243,1135,108,1240,3,"MUNICIPIUL SIBIU",,7,,365,875
33,"Sibiu",323,"323-MUNICIPIUL SIBIU",143450,70,2,1162,915,863,52,913,2,"MUNICIPIUL SIBIU",,7,,271,642
33,"Sibiu",323,"323-MUNICIPIUL SIBIU",143450,71,2,1805,1396,1317,79,1391,5,"MUNICIPIUL SIBIU",,7,,394,997
33,"Sibiu",323,"323-MUNICIPIUL SIBIU",143450,72,2,1805,1394,1304,90,1386,8,"MUNICIPIUL SIBIU",,7,,321,1065
33,"Sibiu",323,"323-MUNICIPIUL SIBIU",143450,73,2,1434,1142,1071,71,1140,2,"MUNICIPIUL SIBIU",,7,,301,839
33,"Sibiu",323,"323-MUNICIPIUL SIBIU",143450,74,2,1354,1089,1003,86,1087,2,"MUNICIPIUL SIBIU",,7,,304,783
33,"Sibiu",323,"323-MUNICIPIUL SIBIU",143450,75,2,1879,1550,1410,140,1543,7,"MUNICIPIUL SIBIU",,7,,330,1213
33,"Sibiu",323,"323-MUNICIPIUL SIBIU",143450,76,2,1518,1197,1097,100,1194,3,"MUNICIPIUL SIBIU",,7,,279,915
33,"Sibiu",323,"323-MUNICIPIUL SIBIU",143450,77,2,1274,1037,974,63,1037,0,"MUNICIPIUL SIBIU",,7,,303,734
33,"Sibiu",323,"323-MUNICIPIUL SIBIU",143450,78,2,1922,1501,1417,84,1492,9,"MUNICIPIUL SIBIU",,7,,379,1113
33,"Sibiu",323,"323-MUNICIPIUL SIBIU",143450,79,2,2040,1607,1536,71,1600,7,"MUNICIPIUL SIBIU",,7,,452,1148
33,"Sibiu",323,"323-MUNICIPIUL SIBIU",143450,80,2,1402,1095,1008,87,1087,8,"MUNICIPIUL SIBIU",,7,,190,897
33,"Sibiu",323,"323-MUNICIPIUL SIBIU",143450,81,2,1541,1216,1150,66,1216,0,"MUNICIPIUL SIBIU",,7,,369,847
33,"Sibiu",323,"323-MUNICIPIUL SIBIU",143450,82,2,1889,1435,1339,96,1432,3,"MUNICIPIUL SIBIU",,7,,290,1142
33,"Sibiu",323,"323-MUNICIPIUL SIBIU",143450,83,2,1679,1296,1166,130,1290,6,"MUNICIPIUL SIBIU",,7,,262,1028
33,"Sibiu",323,"323-MUNICIPIUL SIBIU",143450,84,2,31,142,21,121,139,3,"MUNICIPIUL SIBIU",,7,,16,123
33,"Sibiu",323,"323-MUNICIPIUL SIBIU",143450,85,2,0,273,0,273,272,1,"MUNICIPIUL SIBIU",,7,,59,213
33,"Sibiu",323,"323-MUNICIPIUL SIBIU",143450,86,2,0,955,0,955,947,8,"MUNICIPIUL SIBIU",,7,,365,582
33,"Sibiu",323,"323-MUNICIPIUL SIBIU",143450,87,2,0,471,0,471,466,5,"MUNICIPIUL SIBIU",,7,,109,357
33,"Sibiu",323,"323-MUNICIPIUL SIBIU",143450,88,2,0,366,0,366,358,8,"MUNICIPIUL SIBIU",,7,,73,285
33,"Sibiu",323,"323-MUNICIPIUL SIBIU",143450,89,2,0,405,0,405,401,4,"MUNICIPIUL SIBIU",,7,,90,311
33,"Sibiu",323,"323-MUNICIPIUL SIBIU",143450,90,2,0,63,0,63,63,0,"MUNICIPIUL SIBIU",,7,,24,39
33,"Sibiu",323,"323-MUNICIPIUL SIBIU",143450,91,2,230,243,219,24,240,3,"MUNICIPIUL SIBIU",,7,,56,184
33,"Sibiu",323,"323-MUNICIPIUL SIBIU",143450,92,2,0,459,0,459,458,1,"MUNICIPIUL SIBIU",,7,,197,261
33,"Sibiu",323,"323-MUNICIPIUL SIBIU",143450,93,2,0,626,0,626,622,4,"MUNICIPIUL SIBIU",,7,,134,488
33,"Sibiu",323,"323-MUNICIPIUL SIBIU",143450,94,2,0,724,0,724,723,1,"MUNICIPIUL SIBIU",,7,,183,540
33,"Sibiu",323,"323-MUNICIPIUL SIBIU",143450,95,2,0,112,0,112,110,2,"MUNICIPIUL SIBIU",,7,,15,95
33,"Sibiu",323,"323-MUNICIPIUL SIBIU",143450,96,2,0,185,0,185,185,0,"MUNICIPIUL SIBIU",,7,,20,165
33,"Sibiu",323,"323-MUNICIPIUL SIBIU",143450,97,2,0,109,0,109,109,0,"MUNICIPIUL SIBIU",,7,,13,96
33,"Sibiu",323,"323-MUNICIPIUL SIBIU",143450,98,2,0,110,0,110,105,5,"MUNICIPIUL SIBIU",,7,,46,59
33,"Sibiu",323,"323-MUNICIPIUL SIBIU",143450,99,2,0,127,0,127,126,1,"MUNICIPIUL SIBIU",,7,,16,110
33,"Sibiu",323,"323-MUNICIPIUL MEDIAS",143619,100,2,924,733,658,75,730,3,"MUNICIPIUL MEDIAS",,7,,203,527
33,"Sibiu",323,"323-MUNICIPIUL MEDIAS",143619,101,2,1283,1001,888,113,994,7,"MUNICIPIUL MEDIAS",,7,,278,716
33,"Sibiu",323,"323-MUNICIPIUL MEDIAS",143619,102,2,1193,892,848,44,890,2,"MUNICIPIUL MEDIAS",,7,,172,718
33,"Sibiu",323,"323-MUNICIPIUL MEDIAS",143619,103,2,1267,1075,991,84,1071,4,"MUNICIPIUL MEDIAS",,7,,241,830
33,"Sibiu",323,"323-MUNICIPIUL MEDIAS",143619,104,2,753,624,579,45,619,5,"MUNICIPIUL MEDIAS",,7,,125,494
33,"Sibiu",323,"323-MUNICIPIUL MEDIAS",143619,105,2,910,711,650,61,707,4,"MUNICIPIUL MEDIAS",,7,,116,591
33,"Sibiu",323,"323-MUNICIPIUL MEDIAS",143619,106,2,1124,861,817,44,857,4,"MUNICIPIUL MEDIAS",,7,,190,667
33,"Sibiu",323,"323-MUNICIPIUL MEDIAS",143619,107,2,930,723,673,50,720,3,"MUNICIPIUL MEDIAS",,7,,183,537
33,"Sibiu",323,"323-MUNICIPIUL MEDIAS",143619,108,2,1210,952,926,26,950,2,"MUNICIPIUL MEDIAS",,7,,211,739
33,"Sibiu",323,"323-MUNICIPIUL MEDIAS",143619,109,2,1161,895,852,43,895,0,"MUNICIPIUL MEDIAS",,7,,188,707
33,"Sibiu",323,"323-MUNICIPIUL MEDIAS",143619,110,2,1077,789,749,40,787,2,"MUNICIPIUL MEDIAS",,7,,160,627
33,"Sibiu",323,"323-MUNICIPIUL MEDIAS",143619,111,2,1025,775,736,39,774,1,"MUNICIPIUL MEDIAS",,7,,139,635
33,"Sibiu",323,"323-MUNICIPIUL MEDIAS",143619,112,2,1159,888,853,35,886,2,"MUNICIPIUL MEDIAS",,7,,183,703
33,"Sibiu",323,"323-MUNICIPIUL MEDIAS",143619,113,2,966,742,685,57,738,4,"MUNICIPIUL MEDIAS",,7,,161,577
33,"Sibiu",323,"323-MUNICIPIUL MEDIAS",143619,114,2,876,661,639,22,660,1,"MUNICIPIUL MEDIAS",,7,,187,473
33,"Sibiu",323,"323-MUNICIPIUL MEDIAS",143619,115,2,1243,966,936,30,958,8,"MUNICIPIUL MEDIAS",,7,,279,679
33,"Sibiu",323,"323-MUNICIPIUL MEDIAS",143619,116,2,1230,974,925,49,971,3,"MUNICIPIUL MEDIAS",,7,,159,812
33,"Sibiu",323,"323-MUNICIPIUL MEDIAS",143619,117,2,1259,923,881,42,918,5,"MUNICIPIUL MEDIAS",,7,,198,720
33,"Sibiu",323,"323-MUNICIPIUL MEDIAS",143619,118,2,1355,1039,897,142,1029,10,"MUNICIPIUL MEDIAS",,7,,204,825
33,"Sibiu",323,"323-MUNICIPIUL MEDIAS",143619,119,2,1182,900,844,56,892,8,"MUNICIPIUL MEDIAS",,7,,262,630
33,"Sibiu",323,"323-MUNICIPIUL MEDIAS",143619,120,2,806,588,541,47,582,6,"MUNICIPIUL MEDIAS",,7,,164,418
33,"Sibiu",323,"323-MUNICIPIUL MEDIAS",143619,121,2,879,641,607,34,640,1,"MUNICIPIUL MEDIAS",,7,,156,484
33,"Sibiu",323,"323-MUNICIPIUL MEDIAS",143619,122,2,1017,814,759,55,811,3,"MUNICIPIUL MEDIAS",,7,,220,591
33,"Sibiu",323,"323-MUNICIPIUL MEDIAS",143619,123,2,1003,830,734,96,827,3,"MUNICIPIUL MEDIAS",,7,,123,704
33,"Sibiu",323,"323-MUNICIPIUL MEDIAS",143619,124,2,910,758,696,62,755,3,"MUNICIPIUL MEDIAS",,7,,289,466
33,"Sibiu",323,"323-MUNICIPIUL MEDIAS",143619,125,2,1058,887,825,62,884,3,"MUNICIPIUL MEDIAS",,7,,206,678
33,"Sibiu",323,"323-MUNICIPIUL MEDIAS",143619,126,2,1400,1118,1050,68,1116,2,"MUNICIPIUL MEDIAS",,7,,303,813
33,"Sibiu",323,"323-MUNICIPIUL MEDIAS",143619,127,2,950,757,706,51,751,6,"MUNICIPIUL MEDIAS",,7,,193,558
33,"Sibiu",323,"323-MUNICIPIUL MEDIAS",143619,128,2,1397,1085,1034,51,1079,6,"MUNICIPIUL MEDIAS",,7,,225,854
33,"Sibiu",323,"323-MUNICIPIUL MEDIAS",143619,129,2,1667,1294,1237,57,1285,9,"MUNICIPIUL MEDIAS",,7,,282,1003
33,"Sibiu",323,"323-MUNICIPIUL MEDIAS",143619,130,2,1131,843,749,94,839,4,"MUNICIPIUL MEDIAS",,7,,208,631
33,"Sibiu",323,"323-MUNICIPIUL MEDIAS",143619,131,2,977,753,702,51,751,2,"MUNICIPIUL MEDIAS",,7,,206,545
33,"Sibiu",323,"323-MUNICIPIUL MEDIAS",143619,132,2,832,677,599,78,675,2,"MUNICIPIUL MEDIAS",,7,,137,538
33,"Sibiu",323,"323-MUNICIPIUL MEDIAS",143619,133,2,713,561,514,47,560,1,"MUNICIPIUL MEDIAS",,7,,141,419
33,"Sibiu",323,"323-MUNICIPIUL MEDIAS",143619,134,2,945,739,700,39,737,2,"MUNICIPIUL MEDIAS",,7,,190,547
33,"Sibiu",323,"323-MUNICIPIUL MEDIAS",143619,135,2,1128,831,801,30,830,1,"MUNICIPIUL MEDIAS",,7,,139,691
33,"Sibiu",323,"323-MUNICIPIUL MEDIAS",143619,136,2,1790,1298,1244,54,1294,4,"MUNICIPIUL MEDIAS",,7,,178,1116
33,"Sibiu",323,"323-MUNICIPIUL MEDIAS",143619,137,2,1058,802,761,41,801,1,"MUNICIPIUL MEDIAS",,7,,134,667
33,"Sibiu",323,"323-MUNICIPIUL MEDIAS",143619,138,2,1288,994,938,56,993,1,"MUNICIPIUL MEDIAS",,7,,119,874
33,"Sibiu",323,"323-MUNICIPIUL MEDIAS",143619,139,2,1403,1060,978,82,1058,2,"MUNICIPIUL MEDIAS",,7,,132,926
33,"Sibiu",323,"323-MUNICIPIUL MEDIAS",143619,140,2,1010,775,713,62,773,2,"MUNICIPIUL MEDIAS",,7,,116,657
33,"Sibiu",323,"323-MUNICIPIUL MEDIAS",143619,141,2,1061,815,781,34,812,3,"MUNICIPIUL MEDIAS",,7,,134,678
33,"Sibiu",323,"323-MUNICIPIUL MEDIAS",143619,142,2,1294,1006,949,57,1001,5,"MUNICIPIUL MEDIAS",,7,,131,870
33,"Sibiu",323,"323-MUNICIPIUL MEDIAS",143619,143,2,1079,825,786,39,818,7,"MUNICIPIUL MEDIAS",,7,,117,701
33,"Sibiu",323,"323-MUNICIPIUL MEDIAS",143619,144,2,951,755,655,100,745,10,"MUNICIPIUL MEDIAS",,7,,98,647
33,"Sibiu",323,"323-MUNICIPIUL MEDIAS",143619,145,2,0,615,0,615,609,6,"MUNICIPIUL MEDIAS",,7,,224,385
33,"Sibiu",323,"323-MUNICIPIUL MEDIAS",143619,146,2,0,367,0,367,366,1,"MUNICIPIUL MEDIAS",,7,,81,285
33,"Sibiu",323,"323-MUNICIPIUL MEDIAS",143619,147,2,0,277,0,277,276,1,"MUNICIPIUL MEDIAS",,7,,56,220
33,"Sibiu",323,"323-ORAS AGNITA",143682,148,2,916,743,635,108,741,2,"ORAS AGNITA",,7,,186,555
33,"Sibiu",323,"323-ORAS AGNITA",143682,149,2,902,793,662,131,793,0,"ORAS AGNITA",,7,,185,608
33,"Sibiu",323,"323-ORAS AGNITA",143682,150,2,1178,996,879,117,994,2,"ORAS AGNITA",,7,,242,752
33,"Sibiu",323,"323-ORAS AGNITA",143682,151,2,934,801,730,71,801,0,"ORAS AGNITA",,7,,283,518
33,"Sibiu",323,"323-ORAS AGNITA",143682,152,2,893,729,653,76,727,2,"ORAS AGNITA",,7,,246,481
33,"Sibiu",323,"323-ORAS AGNITA",143682,153,2,1089,862,769,93,859,3,"ORAS AGNITA",,7,,304,555
33,"Sibiu",323,"323-ORAS AGNITA",143682,154,2,961,786,701,85,783,3,"ORAS AGNITA",,7,,306,477
33,"Sibiu",323,"323-ORAS AGNITA",143682,155,2,460,488,363,125,486,2,"ORAS AGNITA",,7,,181,305
33,"Sibiu",323,"323-ORAS AGNITA",143682,156,2,656,564,450,114,556,8,"ORAS AGNITA",,7,,174,382
33,"Sibiu",323,"323-ORAS AVRIG",144054,157,2,1216,1101,792,309,1093,8,"ORAS AVRIG",,7,,350,743
33,"Sibiu",323,"323-ORAS AVRIG",144054,158,2,1126,903,802,101,894,9,"ORAS AVRIG",,7,,316,578
33,"Sibiu",323,"323-ORAS AVRIG",144054,159,2,1006,752,690,62,750,2,"ORAS AVRIG",,7,,290,460
33,"Sibiu",323,"323-ORAS AVRIG",144054,160,2,1514,1145,1000,145,1131,14,"ORAS AVRIG",,7,,366,765
33,"Sibiu",323,"323-ORAS AVRIG",144054,161,2,1510,1063,942,121,1060,3,"ORAS AVRIG",,7,,234,826
33,"Sibiu",323,"323-ORAS AVRIG",144054,162,2,998,891,601,290,888,3,"ORAS AVRIG",,7,,289,599
33,"Sibiu",323,"323-ORAS AVRIG",144054,163,2,896,715,605,110,713,2,"ORAS AVRIG",,7,,211,502
33,"Sibiu",323,"323-ORAS AVRIG",144054,164,2,0,137,0,137,135,2,"ORAS AVRIG",,7,,28,107
33,"Sibiu",323,"323-ORAS AVRIG",144054,165,2,703,573,476,97,568,5,"ORAS AVRIG",,7,,216,352
33,"Sibiu",323,"323-ORAS AVRIG",144054,166,2,483,461,377,84,459,2,"ORAS AVRIG",,7,,148,311
33,"Sibiu",323,"323-ORAS AVRIG",144054,167,2,199,175,137,38,174,1,"ORAS AVRIG",,7,,36,138
33,"Sibiu",323,"323-ORAS CISNADIE",143735,168,2,237,202,150,52,200,2,"ORAS CISNADIE",,7,,34,166
33,"Sibiu",323,"323-ORAS CISNADIE",143735,169,2,1251,965,893,72,961,4,"ORAS CISNADIE",,7,,183,778
33,"Sibiu",323,"323-ORAS CISNADIE",143735,170,2,1316,1061,993,68,1054,7,"ORAS CISNADIE",,7,,235,819
33,"Sibiu",323,"323-ORAS CISNADIE",143735,171,2,1202,1006,911,95,999,7,"ORAS CISNADIE",,7,,205,794
33,"Sibiu",323,"323-ORAS CISNADIE",143735,172,2,1124,1016,845,171,1010,6,"ORAS CISNADIE",,7,,336,674
33,"Sibiu",323,"323-ORAS CISNADIE",143735,173,2,1393,1117,1003,114,1110,7,"ORAS CISNADIE",,7,,305,805
33,"Sibiu",323,"323-ORAS CISNADIE",143735,174,2,1080,966,821,145,954,12,"ORAS CISNADIE",,7,,259,695
33,"Sibiu",323,"323-ORAS CISNADIE",143735,175,2,1185,960,909,51,944,16,"ORAS CISNADIE",,7,,280,664
33,"Sibiu",323,"323-ORAS CISNADIE",143735,176,2,1446,1241,1039,202,1234,4,"ORAS CISNADIE",,7,,317,917
33,"Sibiu",323,"323-ORAS CISNADIE",143735,177,2,1511,1284,1117,167,1275,9,"ORAS CISNADIE",,7,,352,923
33,"Sibiu",323,"323-ORAS COPSA MICA",143771,178,2,1067,991,806,185,983,8,"ORAS COPSA MICA",,7,,161,822
33,"Sibiu",323,"323-ORAS COPSA MICA",143771,179,2,420,462,326,136,460,2,"ORAS COPSA MICA",,7,,124,336
33,"Sibiu",323,"323-ORAS COPSA MICA",143771,180,2,1430,1301,1166,135,1295,6,"ORAS COPSA MICA",,7,,256,1039
33,"Sibiu",323,"323-ORAS DUMBRAVENI",143806,181,2,1184,1025,932,93,1021,4,"ORAS DUMBRAVENI",,7,,215,806
33,"Sibiu",323,"323-ORAS DUMBRAVENI",143806,182,2,1013,840,777,63,831,9,"ORAS DUMBRAVENI",,7,,197,634
33,"Sibiu",323,"323-ORAS DUMBRAVENI",143806,183,2,1155,948,877,71,938,10,"ORAS DUMBRAVENI",,7,,236,702
33,"Sibiu",323,"323-ORAS DUMBRAVENI",143806,184,2,1120,909,818,91,906,3,"ORAS DUMBRAVENI",,7,,126,780
33,"Sibiu",323,"323-ORAS DUMBRAVENI",143806,185,2,172,177,110,67,175,2,"ORAS DUMBRAVENI",,7,,42,133
33,"Sibiu",323,"323-ORAS DUMBRAVENI",143806,186,2,358,288,251,37,280,8,"ORAS DUMBRAVENI",,7,,109,171
33,"Sibiu",323,"323-ORAS DUMBRAVENI",143806,187,2,1028,923,790,133,919,4,"ORAS DUMBRAVENI",,7,,94,825
33,"Sibiu",323,"323-ORAS OCNA SIBIULUI",143851,188,2,812,610,506,104,604,6,"ORAS OCNA SIBIULUI",,7,,182,422
33,"Sibiu",323,"323-ORAS OCNA SIBIULUI",143851,189,2,874,678,590,88,672,6,"ORAS OCNA SIBIULUI",,7,,157,515
33,"Sibiu",323,"323-ORAS OCNA SIBIULUI",143851,190,2,1377,1117,980,137,1106,11,"ORAS OCNA SIBIULUI",,7,,247,859
33,"Sibiu",323,"323-ORAS OCNA SIBIULUI",143851,191,2,157,166,101,65,166,0,"ORAS OCNA SIBIULUI",,7,,35,131
33,"Sibiu",323,"323-ORAS TALMACIU",145827,192,2,978,675,520,155,662,13,"ORAS TALMACIU",,7,,229,433
33,"Sibiu",323,"323-ORAS TALMACIU",145827,193,2,1233,1132,877,255,1128,4,"ORAS TALMACIU",,7,,329,799
33,"Sibiu",323,"323-ORAS TALMACIU",145827,194,2,1049,816,701,115,812,4,"ORAS TALMACIU",,7,,280,532
33,"Sibiu",323,"323-ORAS TALMACIU",145827,195,2,858,717,602,115,716,1,"ORAS TALMACIU",,7,,214,502
33,"Sibiu",323,"323-ORAS TALMACIU",145827,196,2,1183,901,794,107,898,3,"ORAS TALMACIU",,7,,145,753
33,"Sibiu",323,"323-ORAS TALMACIU",145827,197,2,994,756,669,87,747,9,"ORAS TALMACIU",,7,,233,514
33,"Sibiu",323,"323-ALTINA",143888,198,2,796,643,525,118,639,4,"ALTINA",,7,,187,452
33,"Sibiu",323,"323-ALTINA",143888,199,2,162,175,115,60,174,1,"ALTINA",,7,,74,100
33,"Sibiu",323,"323-ALTINA",143888,200,2,166,194,130,64,192,2,"ALTINA",,7,,107,85
33,"Sibiu",323,"323-APOLDU DE JOS",143922,201,2,900,747,632,115,743,4,"APOLDU DE JOS",,7,,283,460
33,"Sibiu",323,"323-APOLDU DE JOS",143922,202,2,289,266,223,43,263,3,"APOLDU DE JOS",,7,,119,144
33,"Sibiu",323,"323-ARPASU DE JOS",143959,203,2,815,704,579,125,697,7,"ARPASU DE JOS",,7,,163,534
33,"Sibiu",323,"323-ARPASU DE JOS",143959,204,2,912,770,631,139,767,3,"ARPASU DE JOS",,7,,249,518
33,"Sibiu",323,"323-ARPASU DE JOS",143959,205,2,323,318,257,61,317,1,"ARPASU DE JOS",,7,,189,128
33,"Sibiu",323,"323-ATEL",143995,206,2,763,734,560,174,732,2,"ATEL",,7,,183,549
33,"Sibiu",323,"323-ATEL",143995,207,2,123,152,93,59,150,2,"ATEL",,7,,58,92
33,"Sibiu",323,"323-ATEL",143995,208,2,601,589,487,102,582,7,"ATEL",,7,,171,411
33,"Sibiu",323,"323-ATEL",143995,209,2,249,225,190,35,224,1,"ATEL",,7,,102,122
33,"Sibiu",323,"323-ATEL",143995,210,2,717,641,577,64,636,5,"ATEL",,7,,189,447
33,"Sibiu",323,"323-AXENTE SEVER",144116,211,2,1568,1255,1064,191,1249,6,"AXENTE SEVER",,7,,396,853
33,"Sibiu",323,"323-AXENTE SEVER",144116,212,2,890,861,663,198,858,3,"AXENTE SEVER",,7,,236,622
33,"Sibiu",323,"323-AXENTE SEVER",144116,213,2,198,201,140,61,200,1,"AXENTE SEVER",,7,,38,162
33,"Sibiu",323,"323-BAZNA",144152,214,2,1046,944,702,242,939,5,"BAZNA",,7,,208,731
33,"Sibiu",323,"323-BAZNA",144152,215,2,1105,853,741,112,844,9,"BAZNA",,7,,231,613
33,"Sibiu",323,"323-BAZNA",144152,216,2,414,389,287,102,380,9,"BAZNA",,7,,109,271
33,"Sibiu",323,"323-BIERTAN",144198,217,2,956,873,757,116,866,7,"BIERTAN",,7,,204,662
33,"Sibiu",323,"323-BIERTAN",144198,218,2,540,432,301,131,430,2,"BIERTAN",,7,,129,301
33,"Sibiu",323,"323-BIERTAN",144198,219,2,276,299,216,83,297,2,"BIERTAN",,7,,68,229
33,"Sibiu",323,"323-BARGHIS",144232,220,2,565,518,418,100,517,1,"BARGHIS",,7,,176,341
33,"Sibiu",323,"323-BARGHIS",144232,221,2,111,115,72,43,115,0,"BARGHIS",,7,,50,65
33,"Sibiu",323,"323-BARGHIS",144232,222,2,306,311,231,80,308,3,"BARGHIS",,7,,149,159
33,"Sibiu",323,"323-BARGHIS",144232,223,2,99,138,83,55,135,3,"BARGHIS",,7,,70,65
33,"Sibiu",323,"323-BARGHIS",144232,224,2,268,237,201,36,235,2,"BARGHIS",,7,,116,119
33,"Sibiu",323,"323-BARGHIS",144232,225,2,110,122,92,30,122,0,"BARGHIS",,7,,67,55
33,"Sibiu",323,"323-BLAJEL",144303,226,2,1441,1174,1027,147,1158,16,"BLAJEL",,7,,284,874
33,"Sibiu",323,"323-BLAJEL",144303,227,2,349,349,286,63,347,2,"BLAJEL",,7,,95,252
33,"Sibiu",323,"323-BRATEIU",144349,228,2,1152,1058,841,217,1041,17,"BRATEIU",,7,,154,887
33,"Sibiu",323,"323-BRATEIU",144349,229,2,431,428,307,121,427,1,"BRATEIU",,7,,49,378
33,"Sibiu",323,"323-BRADENI",144376,230,2,370,385,281,104,385,0,"BRADENI",,7,,98,287
33,"Sibiu",323,"323-BRADENI",144376,231,2,477,408,363,45,406,2,"BRADENI",,7,,252,154
33,"Sibiu",323,"323-BRADENI",144376,232,2,104,108,84,24,106,2,"BRADENI",,7,,43,63
33,"Sibiu",323,"323-BRUIU",144410,233,2,479,432,345,87,430,2,"BRUIU",,7,,189,241
33,"Sibiu",323,"323-CHIRPAR",144456,234,2,433,374,293,81,370,4,"CHIRPAR",,7,,131,239
33,"Sibiu",323,"323-CHIRPAR",144456,235,2,117,143,91,52,140,3,"CHIRPAR",,7,,63,77
33,"Sibiu",323,"323-CHIRPAR",144456,236,2,162,203,126,77,201,2,"CHIRPAR",,7,,45,156
33,"Sibiu",323,"323-CHIRPAR",144456,237,2,82,75,39,36,74,1,"CHIRPAR",,7,,18,56
33,"Sibiu",323,"323-CARTA",144508,238,2,676,521,444,77,513,8,"CARTA",,7,,270,243
33,"Sibiu",323,"323-CARTISOARA",144535,239,2,896,820,653,167,818,2,"CARTISOARA",,7,,278,540
33,"Sibiu",323,"323-CRISTIAN",143487,240,2,1068,910,703,207,906,4,"CRISTIAN",,7,,142,764
33,"Sibiu",323,"323-CRISTIAN",143487,241,2,848,764,590,174,762,2,"CRISTIAN",,7,,185,577
33,"Sibiu",323,"323-DARLOS",144553,242,2,1564,1386,1235,151,1380,6,"DARLOS",,7,,405,975
33,"Sibiu",323,"323-DARLOS",144553,243,2,462,427,375,52,411,16,"DARLOS",,7,,155,256
33,"Sibiu",323,"323-GURA RAULUI",144599,244,2,1383,994,915,79,983,11,"GURA RAULUI",,7,,342,641
33,"Sibiu",323,"323-GURA RAULUI",144599,245,2,1234,885,785,100,874,11,"GURA RAULUI",,7,,261,613
33,"Sibiu",323,"323-HOGHILAG",144615,246,2,627,557,464,93,555,2,"HOGHILAG",,7,,136,419
33,"Sibiu",323,"323-HOGHILAG",144615,247,2,246,198,168,30,196,2,"HOGHILAG",,7,,103,93
33,"Sibiu",323,"323-HOGHILAG",144615,248,2,355,378,274,104,377,1,"HOGHILAG",,7,,46,331
33,"Sibiu",323,"323-IACOBENI",144651,249,2,398,351,289,62,347,4,"IACOBENI",,7,,93,254
33,"Sibiu",323,"323-IACOBENI",144651,250,2,275,261,211,50,257,4,"IACOBENI",,7,,124,133
33,"Sibiu",323,"323-IACOBENI",144651,251,2,229,228,171,57,226,2,"IACOBENI",,7,,111,115
33,"Sibiu",323,"323-IACOBENI",144651,252,2,225,225,160,65,224,1,"IACOBENI",,7,,75,149
33,"Sibiu",323,"323-IACOBENI",144651,253,2,189,187,142,45,186,1,"IACOBENI",,7,,74,112
33,"Sibiu",323,"323-JINA",144713,254,2,1169,642,592,50,625,17,"JINA",,7,,174,451
33,"Sibiu",323,"323-JINA",144713,255,2,1622,827,755,72,816,11,"JINA",,7,,250,566
33,"Sibiu",323,"323-LASLEA",144731,256,2,780,714,534,180,707,7,"LASLEA",,7,,193,514
33,"Sibiu",323,"323-LASLEA",144731,257,2,88,92,65,27,91,1,"LASLEA",,7,,22,69
33,"Sibiu",323,"323-LASLEA",144731,258,2,640,506,456,50,500,6,"LASLEA",,7,,198,302
33,"Sibiu",323,"323-LASLEA",144731,259,2,323,293,258,35,289,4,"LASLEA",,7,,160,129
33,"Sibiu",323,"323-LASLEA",144731,260,2,88,120,62,58,117,3,"LASLEA",,7,,51,66
33,"Sibiu",323,"323-LOAMNES",144795,261,2,770,628,565,63,627,1,"LOAMNES",,7,,311,316
33,"Sibiu",323,"323-LOAMNES",144795,262,2,786,577,534,43,568,9,"LOAMNES",,7,,283,285
33,"Sibiu",323,"323-LOAMNES",144795,263,2,640,398,368,30,397,1,"LOAMNES",,7,,85,312
33,"Sibiu",323,"323-LOAMNES",144795,264,2,382,361,287,74,360,1,"LOAMNES",,7,,139,221
33,"Sibiu",323,"323-LUDOS",144866,265,2,730,536,452,84,523,13,"LUDOS",,7,,224,299
33,"Sibiu",323,"323-MARPOD",144893,266,2,462,523,299,224,519,4,"MARPOD",,7,,204,315
33,"Sibiu",323,"323-MERGHINDEAL",144964,267,2,473,424,325,99,401,23,"MERGHINDEAL",,7,,68,333
33,"Sibiu",323,"323-MERGHINDEAL",144964,268,2,330,298,203,95,295,3,"MERGHINDEAL",,7,,95,200
33,"Sibiu",323,"323-MICASASA",144991,269,2,1188,976,890,86,973,3,"MICASASA",,7,,280,693
33,"Sibiu",323,"323-MICASASA",144991,270,2,559,502,455,47,495,7,"MICASASA",,7,,184,311
33,"Sibiu",323,"323-MICASASA",144991,271,2,155,135,112,23,135,0,"MICASASA",,7,,78,57
33,"Sibiu",323,"323-MIERCUREA SIBIULUI",144937,272,2,1389,1147,970,177,1139,8,"MIERCUREA SIBIULUI",,7,,402,737
33,"Sibiu",323,"323-MIERCUREA SIBIULUI",144937,273,2,1031,746,659,87,739,7,"MIERCUREA SIBIULUI",,7,,378,361
33,"Sibiu",323,"323-MIERCUREA SIBIULUI",144937,274,2,401,309,251,58,308,1,"MIERCUREA SIBIULUI",,7,,75,233
33,"Sibiu",323,"323-MIHAILENI",145042,275,2,374,385,319,66,384,1,"MIHAILENI",,7,,125,259
33,"Sibiu",323,"323-MIHAILENI",145042,276,2,230,207,147,60,206,1,"MIHAILENI",,7,,63,143
33,"Sibiu",323,"323-MOSNA",145104,277,2,1269,1100,910,190,1094,6,"MOSNA",,7,,276,818
33,"Sibiu",323,"323-MOSNA",145104,278,2,335,315,263,52,311,4,"MOSNA",,7,,51,260
33,"Sibiu",323,"323-MOSNA",145104,279,2,196,204,150,54,201,3,"MOSNA",,7,,55,146
33,"Sibiu",323,"323-NOCRICH",145140,280,2,715,623,493,130,616,7,"NOCRICH",,7,,185,431
33,"Sibiu",323,"323-NOCRICH",145140,281,2,424,436,314,122,432,4,"NOCRICH",,7,,128,304
33,"Sibiu",323,"323-NOCRICH",145140,282,2,200,246,165,81,246,0,"NOCRICH",,7,,61,185
33,"Sibiu",323,"323-NOCRICH",145140,283,2,98,98,67,31,97,1,"NOCRICH",,7,,26,71
33,"Sibiu",323,"323-NOCRICH",145140,284,2,108,93,59,34,93,0,"NOCRICH",,7,,8,85
33,"Sibiu",323,"323-ORLAT",145202,285,2,1251,1014,886,128,1011,3,"ORLAT",,7,,156,855
33,"Sibiu",323,"323-ORLAT",145202,286,2,994,748,697,51,741,7,"ORLAT",,7,,149,592
33,"Sibiu",323,"323-PAUCA",145220,287,2,594,473,421,52,470,3,"PAUCA",,7,,231,239
33,"Sibiu",323,"323-PAUCA",145220,288,2,632,399,368,31,391,8,"PAUCA",,7,,165,226
33,"Sibiu",323,"323-PAUCA",145220,289,2,371,340,309,31,323,17,"PAUCA",,7,,113,210
33,"Sibiu",323,"323-PAUCA",145220,290,2,448,352,311,41,347,5,"PAUCA",,7,,181,166
33,"Sibiu",323,"323-POIANA SIBIULUI",145275,291,2,859,477,404,73,466,11,"POIANA SIBIULUI",,7,,171,295
33,"Sibiu",323,"323-POIANA SIBIULUI",145275,292,2,1061,560,464,96,557,3,"POIANA SIBIULUI",,7,,210,347
33,"Sibiu",323,"323-POPLACA",143502,293,2,1183,911,788,123,897,14,"POPLACA",,7,,169,728
33,"Sibiu",323,"323-PORUMBACU DE JOS",145293,294,2,833,661,507,154,651,10,"PORUMBACU DE JOS",,7,,268,383
33,"Sibiu",323,"323-PORUMBACU DE JOS",145293,295,2,625,648,470,178,642,6,"PORUMBACU DE JOS",,7,,206,436
33,"Sibiu",323,"323-PORUMBACU DE JOS",145293,296,2,475,504,322,182,497,7,"PORUMBACU DE JOS",,7,,176,321
33,"Sibiu",323,"323-PORUMBACU DE JOS",145293,297,2,287,306,224,82,300,6,"PORUMBACU DE JOS",,7,,65,235
33,"Sibiu",323,"323-PORUMBACU DE JOS",145293,298,2,133,137,69,68,137,0,"PORUMBACU DE JOS",,7,,53,84
33,"Sibiu",323,"323-RACOVITA",145355,299,2,1608,1334,1222,112,1319,15,"RACOVITA",,7,,349,970
33,"Sibiu",323,"323-RACOVITA",145355,300,2,546,518,458,60,516,2,"RACOVITA",,7,,111,405
33,"Sibiu",323,"323-RASINARI",143520,301,2,1391,902,753,149,892,10,"RASINARI",,7,,123,769
33,"Sibiu",323,"323-RASINARI",143520,302,2,1252,992,814,178,989,3,"RASINARI",,7,,188,801
33,"Sibiu",323,"323-RASINARI",143520,303,2,1167,897,697,200,885,12,"RASINARI",,7,,146,739
33,"Sibiu",323,"323-RAU SADULUI",145382,304,2,537,325,288,37,320,5,"RAU SADULUI",,7,,92,228
33,"Sibiu",323,"323-ROSIA",145408,305,2,755,627,460,167,624,3,"ROSIA",,7,,212,412
33,"Sibiu",323,"323-ROSIA",145408,306,2,890,700,576,124,692,8,"ROSIA",,7,,229,463
33,"Sibiu",323,"323-ROSIA",145408,307,2,474,430,339,91,428,2,"ROSIA",,7,,136,292
33,"Sibiu",323,"323-ROSIA",145408,308,2,411,335,248,87,330,5,"ROSIA",,7,,131,199
33,"Sibiu",323,"323-ROSIA",145408,309,2,257,287,188,99,287,0,"ROSIA",,7,,92,195
33,"Sibiu",323,"323-ROSIA",145408,310,2,87,100,66,34,98,2,"ROSIA",,7,,38,60
33,"Sibiu",323,"323-SADU",145471,311,2,1853,1503,1373,130,1494,9,"SADU",,7,,377,1117
33,"Sibiu",323,"323-SALISTEA",145499,312,2,930,738,567,171,731,7,"SALISTEA",,7,,220,511
33,"Sibiu",323,"323-SALISTEA",145499,313,2,1034,834,691,143,828,6,"SALISTEA",,7,,288,540
33,"Sibiu",323,"323-SALISTEA",145499,314,2,240,235,171,64,234,1,"SALISTEA",,7,,95,139
33,"Sibiu",323,"323-SALISTEA",145499,315,2,296,269,210,59,268,1,"SALISTEA",,7,,137,131
33,"Sibiu",323,"323-SALISTEA",145499,316,2,317,294,242,52,294,0,"SALISTEA",,7,,82,212
33,"Sibiu",323,"323-SALISTEA",145499,317,2,251,217,185,32,211,6,"SALISTEA",,7,,86,125
33,"Sibiu",323,"323-SALISTEA",145499,318,2,392,319,281,38,318,1,"SALISTEA",,7,,77,241
33,"Sibiu",323,"323-SALISTEA",145499,319,2,251,218,169,49,217,1,"SALISTEA",,7,,45,172
33,"Sibiu",323,"323-SALISTEA",145499,320,2,227,227,165,62,226,1,"SALISTEA",,7,,64,162
33,"Sibiu",323,"323-SALISTEA",145499,321,2,307,285,238,47,282,3,"SALISTEA",,7,,81,201
33,"Sibiu",323,"323-SELIMBAR",143557,322,2,1208,1006,825,181,1001,5,"SELIMBAR",,7,,243,758
33,"Sibiu",323,"323-SELIMBAR",143557,323,2,1156,972,841,131,966,6,"SELIMBAR",,7,,324,642
33,"Sibiu",323,"323-SELIMBAR",143557,324,2,501,437,352,85,430,7,"SELIMBAR",,7,,122,308
33,"Sibiu",323,"323-SELIMBAR",143557,325,2,355,305,233,72,304,1,"SELIMBAR",,7,,74,230
33,"Sibiu",323,"323-SEICA MARE",145667,326,2,1692,1277,1027,250,1261,16,"SEICA MARE",,7,,331,930
33,"Sibiu",323,"323-SEICA MARE",145667,327,2,780,837,570,267,826,11,"SEICA MARE",,7,,174,652
33,"Sibiu",323,"323-SEICA MARE",145667,328,2,341,303,243,60,303,0,"SEICA MARE",,7,,73,230
33,"Sibiu",323,"323-SEICA MARE",145667,329,2,472,475,371,104,475,0,"SEICA MARE",,7,,118,357
33,"Sibiu",323,"323-SEICA MARE",145667,330,2,62,71,34,37,69,2,"SEICA MARE",,7,,20,49
33,"Sibiu",323,"323-SEICA MARE",145667,331,2,142,156,113,43,156,0,"SEICA MARE",,7,,79,77
33,"Sibiu",323,"323-SEICA MICA",145738,332,2,715,669,534,135,663,6,"SEICA MICA",,7,,138,525
33,"Sibiu",323,"323-SEICA MICA",145738,333,2,476,388,324,64,386,2,"SEICA MICA",,7,,172,214
33,"Sibiu",323,"323-SLIMNIC",145603,334,2,791,534,448,86,530,4,"SLIMNIC",,7,,166,364
33,"Sibiu",323,"323-SLIMNIC",145603,335,2,940,606,531,75,602,4,"SLIMNIC",,7,,126,476
33,"Sibiu",323,"323-SLIMNIC",145603,336,2,527,508,357,151,500,8,"SLIMNIC",,7,,191,309
33,"Sibiu",323,"323-SLIMNIC",145603,337,2,212,192,142,50,189,3,"SLIMNIC",,7,,74,115
33,"Sibiu",323,"323-SURA MARE",145765,338,2,1454,1148,877,271,1144,4,"SURA MARE",,7,,294,850
33,"Sibiu",323,"323-SURA MARE",145765,339,2,381,365,263,102,360,5,"SURA MARE",,7,,83,277
33,"Sibiu",323,"323-SURA MICA",145792,340,2,952,849,679,170,843,6,"SURA MICA",,7,,204,639
33,"Sibiu",323,"323-SURA MICA",145792,341,2,359,315,265,50,314,1,"SURA MICA",,7,,33,281
33,"Sibiu",323,"323-TILISCA",145907,342,2,934,587,534,53,583,4,"TILISCA",,7,,279,304
33,"Sibiu",323,"323-TILISCA",145907,343,2,390,328,272,56,323,5,"TILISCA",,7,,141,182
33,"Sibiu",323,"323-TARNAVA",143646,344,2,974,735,635,100,731,4,"TARNAVA",,7,,144,587
33,"Sibiu",323,"323-TARNAVA",143646,345,2,856,791,650,141,779,12,"TARNAVA",,7,,140,639
33,"Sibiu",323,"323-TURNU ROSU",145934,346,2,1275,1109,946,163,1099,10,"TURNU ROSU",,7,,287,812
33,"Sibiu",323,"323-TURNU ROSU",145934,347,2,590,574,484,90,569,5,"TURNU ROSU",,7,,162,407
33,"Sibiu",323,"323-VALEA VIILOR",145961,348,2,1071,926,822,104,914,12,"VALEA VIILOR",,7,,226,688
33,"Sibiu",323,"323-VALEA VIILOR",145961,349,2,229,299,183,116,298,1,"VALEA VIILOR",,7,,50,248
33,"Sibiu",323,"323-VURPAR",145998,350,2,1453,1053,922,131,1040,13,"VURPAR",,7,,318,722
34,"Suceava",332,"332-MUNICIPIUL SUCEAVA",146263,1,2,1328,1176,1013,163,1168,8,"MUNICIPIUL SUCEAVA",,4,,516,652
34,"Suceava",332,"332-MUNICIPIUL SUCEAVA",146263,2,2,1361,1087,1009,78,1081,6,"MUNICIPIUL SUCEAVA",,4,,393,688
34,"Suceava",332,"332-MUNICIPIUL SUCEAVA",146263,3,2,1269,1118,949,169,1113,5,"MUNICIPIUL SUCEAVA",,4,,500,613
34,"Suceava",332,"332-MUNICIPIUL SUCEAVA",146263,4,2,1510,1197,1107,90,1192,5,"MUNICIPIUL SUCEAVA",,4,,505,687
34,"Suceava",332,"332-MUNICIPIUL SUCEAVA",146263,5,2,1393,1083,1013,70,1079,4,"MUNICIPIUL SUCEAVA",,4,,444,635
34,"Suceava",332,"332-MUNICIPIUL SUCEAVA",146263,6,2,1529,1213,1151,62,1205,8,"MUNICIPIUL SUCEAVA",,4,,523,682
34,"Suceava",332,"332-MUNICIPIUL SUCEAVA",146263,7,2,1314,1071,1014,57,1066,5,"MUNICIPIUL SUCEAVA",,4,,504,562
34,"Suceava",332,"332-MUNICIPIUL SUCEAVA",146263,8,2,1154,941,876,65,938,3,"MUNICIPIUL SUCEAVA",,4,,415,523
34,"Suceava",332,"332-MUNICIPIUL SUCEAVA",146263,9,2,1227,998,884,114,994,4,"MUNICIPIUL SUCEAVA",,4,,444,550
34,"Suceava",332,"332-MUNICIPIUL SUCEAVA",146263,10,2,1284,1024,947,77,1018,6,"MUNICIPIUL SUCEAVA",,4,,388,630
34,"Suceava",332,"332-MUNICIPIUL SUCEAVA",146263,11,2,1334,1047,906,141,1045,2,"MUNICIPIUL SUCEAVA",,4,,452,593
34,"Suceava",332,"332-MUNICIPIUL SUCEAVA",146263,12,2,1295,1133,949,184,1128,5,"MUNICIPIUL SUCEAVA",,4,,469,659
34,"Suceava",332,"332-MUNICIPIUL SUCEAVA",146263,13,2,1798,1324,1248,76,1317,7,"MUNICIPIUL SUCEAVA",,4,,516,801
34,"Suceava",332,"332-MUNICIPIUL SUCEAVA",146263,14,2,1528,1116,978,138,1110,6,"MUNICIPIUL SUCEAVA",,4,,466,644
34,"Suceava",332,"332-MUNICIPIUL SUCEAVA",146263,15,2,1627,1567,1088,479,1557,10,"MUNICIPIUL SUCEAVA",,4,,598,959
34,"Suceava",332,"332-MUNICIPIUL SUCEAVA",146263,16,2,1866,1413,1322,91,1404,9,"MUNICIPIUL SUCEAVA",,4,,587,817
34,"Suceava",332,"332-MUNICIPIUL SUCEAVA",146263,17,2,1759,1316,1203,113,1307,9,"MUNICIPIUL SUCEAVA",,4,,504,803
34,"Suceava",332,"332-MUNICIPIUL SUCEAVA",146263,18,2,1848,1361,1297,64,1353,8,"MUNICIPIUL SUCEAVA",,4,,571,782
34,"Suceava",332,"332-MUNICIPIUL SUCEAVA",146263,19,2,1676,1286,1226,60,1283,3,"MUNICIPIUL SUCEAVA",,4,,435,848
34,"Suceava",332,"332-MUNICIPIUL SUCEAVA",146263,20,2,1236,992,894,98,988,4,"MUNICIPIUL SUCEAVA",,4,,330,658
34,"Suceava",332,"332-MUNICIPIUL SUCEAVA",146263,21,2,1332,982,902,80,978,4,"MUNICIPIUL SUCEAVA",,4,,341,637
34,"Suceava",332,"332-MUNICIPIUL SUCEAVA",146263,22,2,1362,1115,1030,85,1106,9,"MUNICIPIUL SUCEAVA",,4,,381,725
34,"Suceava",332,"332-MUNICIPIUL SUCEAVA",146263,23,2,1433,1129,1050,79,1126,3,"MUNICIPIUL SUCEAVA",,4,,360,766
34,"Suceava",332,"332-MUNICIPIUL SUCEAVA",146263,24,2,1805,1408,1320,88,1402,6,"MUNICIPIUL SUCEAVA",,4,,436,966
34,"Suceava",332,"332-MUNICIPIUL SUCEAVA",146263,25,2,1362,995,922,73,993,2,"MUNICIPIUL SUCEAVA",,4,,278,715
34,"Suceava",332,"332-MUNICIPIUL SUCEAVA",146263,26,2,2095,1566,1450,116,1562,4,"MUNICIPIUL SUCEAVA",,4,,627,935
34,"Suceava",332,"332-MUNICIPIUL SUCEAVA",146263,27,2,1554,1184,1088,96,1177,7,"MUNICIPIUL SUCEAVA",,4,,478,699
34,"Suceava",332,"332-MUNICIPIUL SUCEAVA",146263,28,2,1915,1364,1314,50,1352,12,"MUNICIPIUL SUCEAVA",,4,,581,771
34,"Suceava",332,"332-MUNICIPIUL SUCEAVA",146263,29,2,1995,1501,1440,61,1491,10,"MUNICIPIUL SUCEAVA",,4,,664,827
34,"Suceava",332,"332-MUNICIPIUL SUCEAVA",146263,30,2,1684,1219,1147,72,1212,7,"MUNICIPIUL SUCEAVA",,4,,495,717
34,"Suceava",332,"332-MUNICIPIUL SUCEAVA",146263,31,2,1764,1321,1247,74,1313,8,"MUNICIPIUL SUCEAVA",,4,,522,791
34,"Suceava",332,"332-MUNICIPIUL SUCEAVA",146263,32,2,1319,1081,1004,77,1076,5,"MUNICIPIUL SUCEAVA",,4,,387,689
34,"Suceava",332,"332-MUNICIPIUL SUCEAVA",146263,33,2,1909,1469,1365,104,1463,6,"MUNICIPIUL SUCEAVA",,4,,558,905
34,"Suceava",332,"332-MUNICIPIUL SUCEAVA",146263,34,2,1565,1299,1152,147,1293,6,"MUNICIPIUL SUCEAVA",,4,,520,773
34,"Suceava",332,"332-MUNICIPIUL SUCEAVA",146263,35,2,1927,1516,1425,91,1510,6,"MUNICIPIUL SUCEAVA",,4,,580,930
34,"Suceava",332,"332-MUNICIPIUL SUCEAVA",146263,36,2,1719,1392,1179,213,1386,6,"MUNICIPIUL SUCEAVA",,4,,457,929
34,"Suceava",332,"332-MUNICIPIUL SUCEAVA",146263,37,2,1328,995,880,115,984,11,"MUNICIPIUL SUCEAVA",,4,,416,568
34,"Suceava",332,"332-MUNICIPIUL SUCEAVA",146263,38,2,1504,1221,1013,208,1212,9,"MUNICIPIUL SUCEAVA",,4,,655,557
34,"Suceava",332,"332-MUNICIPIUL SUCEAVA",146263,39,2,1644,1216,1107,109,1205,11,"MUNICIPIUL SUCEAVA",,4,,590,615
34,"Suceava",332,"332-MUNICIPIUL SUCEAVA",146263,40,2,1203,848,768,80,836,12,"MUNICIPIUL SUCEAVA",,4,,359,477
34,"Suceava",332,"332-MUNICIPIUL SUCEAVA",146263,41,2,2079,2160,1378,782,2148,12,"MUNICIPIUL SUCEAVA",,4,,860,1288
34,"Suceava",332,"332-MUNICIPIUL SUCEAVA",146263,42,2,1376,1031,958,73,1026,5,"MUNICIPIUL SUCEAVA",,4,,461,565
34,"Suceava",332,"332-MUNICIPIUL SUCEAVA",146263,43,2,1330,1004,951,53,1000,4,"MUNICIPIUL SUCEAVA",,4,,389,611
34,"Suceava",332,"332-MUNICIPIUL SUCEAVA",146263,44,2,1436,1005,948,57,999,6,"MUNICIPIUL SUCEAVA",,4,,400,599
34,"Suceava",332,"332-MUNICIPIUL SUCEAVA",146263,45,2,1408,1002,945,57,996,6,"MUNICIPIUL SUCEAVA",,4,,460,536
34,"Suceava",332,"332-MUNICIPIUL SUCEAVA",146263,46,2,1483,1135,1050,85,1123,12,"MUNICIPIUL SUCEAVA",,4,,471,652
34,"Suceava",332,"332-MUNICIPIUL SUCEAVA",146263,47,2,1437,1012,927,85,1006,6,"MUNICIPIUL SUCEAVA",,4,,392,614
34,"Suceava",332,"332-MUNICIPIUL SUCEAVA",146263,48,2,1301,986,871,115,978,8,"MUNICIPIUL SUCEAVA",,4,,394,584
34,"Suceava",332,"332-MUNICIPIUL SUCEAVA",146263,49,2,1528,1122,1047,75,1117,5,"MUNICIPIUL SUCEAVA",,4,,455,662
34,"Suceava",332,"332-MUNICIPIUL SUCEAVA",146263,50,2,1830,1328,1240,88,1318,10,"MUNICIPIUL SUCEAVA",,4,,502,816
34,"Suceava",332,"332-MUNICIPIUL SUCEAVA",146263,51,2,1388,1104,999,105,1095,9,"MUNICIPIUL SUCEAVA",,4,,396,699
34,"Suceava",332,"332-MUNICIPIUL SUCEAVA",146263,52,2,1609,1189,1085,104,1182,7,"MUNICIPIUL SUCEAVA",,4,,469,713
34,"Suceava",332,"332-MUNICIPIUL SUCEAVA",146263,53,2,1301,1030,948,82,1026,4,"MUNICIPIUL SUCEAVA",,4,,466,560
34,"Suceava",332,"332-MUNICIPIUL SUCEAVA",146263,54,2,1094,794,729,65,784,10,"MUNICIPIUL SUCEAVA",,4,,439,345
34,"Suceava",332,"332-MUNICIPIUL SUCEAVA",146263,55,2,1437,995,923,72,976,19,"MUNICIPIUL SUCEAVA",,4,,495,481
34,"Suceava",332,"332-MUNICIPIUL SUCEAVA",146263,56,2,0,216,0,216,214,2,"MUNICIPIUL SUCEAVA",,4,,99,115
34,"Suceava",332,"332-MUNICIPIUL SUCEAVA",146263,57,2,0,768,0,768,755,13,"MUNICIPIUL SUCEAVA",,4,,368,387
34,"Suceava",332,"332-MUNICIPIUL CAMPULUNG MOLDOVENESC",146502,58,2,1398,1196,1099,97,1190,6,"MUNICIPIUL CAMPULUNG MOLDOVENESC",,4,,455,735
34,"Suceava",332,"332-MUNICIPIUL CAMPULUNG MOLDOVENESC",146502,59,2,997,816,714,102,813,3,"MUNICIPIUL CAMPULUNG MOLDOVENESC",,4,,329,484
34,"Suceava",332,"332-MUNICIPIUL CAMPULUNG MOLDOVENESC",146502,60,2,1323,1055,989,66,1053,2,"MUNICIPIUL CAMPULUNG MOLDOVENESC",,4,,546,507
34,"Suceava",332,"332-MUNICIPIUL CAMPULUNG MOLDOVENESC",146502,61,2,938,733,664,69,729,4,"MUNICIPIUL CAMPULUNG MOLDOVENESC",,4,,326,403
34,"Suceava",332,"332-MUNICIPIUL CAMPULUNG MOLDOVENESC",146502,62,2,1072,801,745,56,798,3,"MUNICIPIUL CAMPULUNG MOLDOVENESC",,4,,336,462
34,"Suceava",332,"332-MUNICIPIUL CAMPULUNG MOLDOVENESC",146502,63,2,1826,1422,1309,113,1415,7,"MUNICIPIUL CAMPULUNG MOLDOVENESC",,4,,551,864
34,"Suceava",332,"332-MUNICIPIUL CAMPULUNG MOLDOVENESC",146502,64,2,1655,1335,1176,159,1330,5,"MUNICIPIUL CAMPULUNG MOLDOVENESC",,4,,453,877
34,"Suceava",332,"332-MUNICIPIUL CAMPULUNG MOLDOVENESC",146502,65,2,614,532,473,59,526,6,"MUNICIPIUL CAMPULUNG MOLDOVENESC",,4,,192,334
34,"Suceava",332,"332-MUNICIPIUL CAMPULUNG MOLDOVENESC",146502,66,2,2073,1477,1364,113,1468,9,"MUNICIPIUL CAMPULUNG MOLDOVENESC",,4,,546,922
34,"Suceava",332,"332-MUNICIPIUL CAMPULUNG MOLDOVENESC",146502,67,2,2160,1690,1609,81,1684,6,"MUNICIPIUL CAMPULUNG MOLDOVENESC",,4,,650,1034
34,"Suceava",332,"332-MUNICIPIUL CAMPULUNG MOLDOVENESC",146502,68,2,1013,842,800,42,834,8,"MUNICIPIUL CAMPULUNG MOLDOVENESC",,4,,387,447
34,"Suceava",332,"332-MUNICIPIUL CAMPULUNG MOLDOVENESC",146502,69,2,980,839,779,60,830,9,"MUNICIPIUL CAMPULUNG MOLDOVENESC",,4,,403,427
34,"Suceava",332,"332-MUNICIPIUL CAMPULUNG MOLDOVENESC",146502,70,2,1069,878,792,86,871,7,"MUNICIPIUL CAMPULUNG MOLDOVENESC",,4,,421,450
34,"Suceava",332,"332-MUNICIPIUL CAMPULUNG MOLDOVENESC",146502,71,2,0,175,0,175,172,3,"MUNICIPIUL CAMPULUNG MOLDOVENESC",,4,,85,87
34,"Suceava",332,"332-MUNICIPIUL CAMPULUNG MOLDOVENESC",146502,72,2,0,225,0,225,222,3,"MUNICIPIUL CAMPULUNG MOLDOVENESC",,4,,94,128
34,"Suceava",332,"332-MUNICIPIUL FALTICENI",146539,73,2,1320,1115,979,136,1109,6,"MUNICIPIUL FALTICENI",,4,,641,468
34,"Suceava",332,"332-MUNICIPIUL FALTICENI",146539,74,2,1310,1095,959,136,1086,9,"MUNICIPIUL FALTICENI",,4,,653,433
34,"Suceava",332,"332-MUNICIPIUL FALTICENI",146539,75,2,1296,1128,975,153,1118,10,"MUNICIPIUL FALTICENI",,4,,664,454
34,"Suceava",332,"332-MUNICIPIUL FALTICENI",146539,76,2,1244,1075,958,117,1064,11,"MUNICIPIUL FALTICENI",,4,,618,446
34,"Suceava",332,"332-MUNICIPIUL FALTICENI",146539,77,2,1069,995,778,217,989,6,"MUNICIPIUL FALTICENI",,4,,543,446
34,"Suceava",332,"332-MUNICIPIUL FALTICENI",146539,78,2,1380,1220,1064,156,1210,10,"MUNICIPIUL FALTICENI",,4,,634,576
34,"Suceava",332,"332-MUNICIPIUL FALTICENI",146539,79,2,1514,1290,1092,198,1285,5,"MUNICIPIUL FALTICENI",,4,,678,607
34,"Suceava",332,"332-MUNICIPIUL FALTICENI",146539,80,2,1139,1018,852,166,1009,9,"MUNICIPIUL FALTICENI",,4,,567,442
34,"Suceava",332,"332-MUNICIPIUL FALTICENI",146539,81,2,1860,1530,1318,212,1514,16,"MUNICIPIUL FALTICENI",,4,,870,644
34,"Suceava",332,"332-MUNICIPIUL FALTICENI",146539,82,2,1004,916,755,161,904,12,"MUNICIPIUL FALTICENI",,4,,538,366
34,"Suceava",332,"332-MUNICIPIUL FALTICENI",146539,83,2,1167,976,817,159,970,6,"MUNICIPIUL FALTICENI",,4,,531,439
34,"Suceava",332,"332-MUNICIPIUL FALTICENI",146539,84,2,1540,1198,1038,160,1191,7,"MUNICIPIUL FALTICENI",,4,,699,492
34,"Suceava",332,"332-MUNICIPIUL FALTICENI",146539,85,2,1509,1271,1132,139,1262,9,"MUNICIPIUL FALTICENI",,4,,804,458
34,"Suceava",332,"332-MUNICIPIUL FALTICENI",146539,86,2,1073,806,728,78,804,2,"MUNICIPIUL FALTICENI",,4,,484,320
34,"Suceava",332,"332-MUNICIPIUL FALTICENI",146539,87,2,1246,1003,911,92,998,5,"MUNICIPIUL FALTICENI",,4,,753,245
34,"Suceava",332,"332-MUNICIPIUL FALTICENI",146539,88,2,594,448,416,32,443,5,"MUNICIPIUL FALTICENI",,4,,240,203
34,"Suceava",332,"332-MUNICIPIUL FALTICENI",146539,89,2,1278,1109,933,176,1100,9,"MUNICIPIUL FALTICENI",,4,,677,423
34,"Suceava",332,"332-MUNICIPIUL FALTICENI",146539,90,2,0,610,0,610,605,5,"MUNICIPIUL FALTICENI",,4,,317,288
34,"Suceava",332,"332-MUNICIPIUL FALTICENI",146539,91,2,0,222,0,222,219,3,"MUNICIPIUL FALTICENI",,4,,159,60
34,"Suceava",332,"332-MUNICIPIUL RADAUTI",146628,92,2,2149,1588,1494,94,1577,11,"MUNICIPIUL RADAUTI",,4,,558,1019
34,"Suceava",332,"332-MUNICIPIUL RADAUTI",146628,93,2,2276,1826,1719,107,1815,11,"MUNICIPIUL RADAUTI",,4,,789,1026
34,"Suceava",332,"332-MUNICIPIUL RADAUTI",146628,94,2,2086,1547,1477,70,1541,6,"MUNICIPIUL RADAUTI",,4,,654,887
34,"Suceava",332,"332-MUNICIPIUL RADAUTI",146628,95,2,1984,1384,1197,187,1374,10,"MUNICIPIUL RADAUTI",,4,,520,854
34,"Suceava",332,"332-MUNICIPIUL RADAUTI",146628,96,2,2641,1599,1386,213,1588,11,"MUNICIPIUL RADAUTI",,4,,537,1051
34,"Suceava",332,"332-MUNICIPIUL RADAUTI",146628,97,2,1626,1577,1018,559,1570,7,"MUNICIPIUL RADAUTI",,4,,593,977
34,"Suceava",332,"332-MUNICIPIUL RADAUTI",146628,98,2,2054,1468,1349,119,1459,9,"MUNICIPIUL RADAUTI",,4,,507,952
34,"Suceava",332,"332-MUNICIPIUL RADAUTI",146628,99,2,1941,1387,1299,88,1383,4,"MUNICIPIUL RADAUTI",,4,,503,880
34,"Suceava",332,"332-MUNICIPIUL RADAUTI",146628,100,2,2160,1650,1423,227,1631,19,"MUNICIPIUL RADAUTI",,4,,640,991
34,"Suceava",332,"332-MUNICIPIUL RADAUTI",146628,101,2,2249,1581,1485,96,1566,15,"MUNICIPIUL RADAUTI",,4,,645,921
34,"Suceava",332,"332-MUNICIPIUL RADAUTI",146628,102,2,2203,1589,1533,56,1578,11,"MUNICIPIUL RADAUTI",,4,,645,933
34,"Suceava",332,"332-MUNICIPIUL RADAUTI",146628,103,2,303,319,286,33,310,9,"MUNICIPIUL RADAUTI",,4,,173,137
34,"Suceava",332,"332-ORAS GURA HUMORULUI",146584,104,2,2390,1924,1735,189,1911,13,"ORAS GURA HUMORULUI",,4,,943,968
34,"Suceava",332,"332-ORAS GURA HUMORULUI",146584,105,2,1878,1407,1341,66,1398,9,"ORAS GURA HUMORULUI",,4,,723,675
34,"Suceava",332,"332-ORAS GURA HUMORULUI",146584,106,2,1056,807,732,75,796,11,"ORAS GURA HUMORULUI",,4,,375,421
34,"Suceava",332,"332-ORAS GURA HUMORULUI",146584,107,2,2846,2028,1865,163,2023,5,"ORAS GURA HUMORULUI",,4,,953,1070
34,"Suceava",332,"332-ORAS GURA HUMORULUI",146584,108,2,2069,1485,1320,165,1481,4,"ORAS GURA HUMORULUI",,4,,683,798
34,"Suceava",332,"332-ORAS GURA HUMORULUI",146584,109,2,1647,1272,1129,143,1268,4,"ORAS GURA HUMORULUI",,4,,644,624
34,"Suceava",332,"332-ORAS GURA HUMORULUI",146584,110,2,590,535,462,73,529,6,"ORAS GURA HUMORULUI",,4,,294,235
34,"Suceava",332,"332-ORAS SIRET",146655,111,2,1668,1374,1190,184,1372,2,"ORAS SIRET",,4,,533,839
34,"Suceava",332,"332-ORAS SIRET",146655,112,2,1417,1021,945,76,1016,5,"ORAS SIRET",,4,,321,695
34,"Suceava",332,"332-ORAS SIRET",146655,113,2,1705,1176,1115,61,1171,5,"ORAS SIRET",,4,,406,765
34,"Suceava",332,"332-ORAS SIRET",146655,114,2,1001,830,718,112,823,7,"ORAS SIRET",,4,,251,572
34,"Suceava",332,"332-ORAS SIRET",146655,115,2,411,355,311,44,351,4,"ORAS SIRET",,4,,223,128
34,"Suceava",332,"332-ORAS SIRET",146655,116,2,447,389,353,36,387,2,"ORAS SIRET",,4,,271,116
34,"Suceava",332,"332-ORAS SOLCA",146708,117,2,1986,1619,1424,195,1606,13,"ORAS SOLCA",,4,,1017,589
34,"Suceava",332,"332-ORAS SOLCA",146708,118,2,1528,1167,1036,131,1158,9,"ORAS SOLCA",,4,,903,255
34,"Suceava",332,"332-ORAS VATRA DORNEI",146744,119,2,1738,1468,1162,306,1454,14,"ORAS VATRA DORNEI",,4,,655,799
34,"Suceava",332,"332-ORAS VATRA DORNEI",146744,120,2,2019,1943,1336,607,1937,6,"ORAS VATRA DORNEI",,4,,870,1067
34,"Suceava",332,"332-ORAS VATRA DORNEI",146744,121,2,1050,864,767,97,860,4,"ORAS VATRA DORNEI",,4,,341,519
34,"Suceava",332,"332-ORAS VATRA DORNEI",146744,122,2,1193,916,829,87,913,3,"ORAS VATRA DORNEI",,4,,390,523
34,"Suceava",332,"332-ORAS VATRA DORNEI",146744,123,2,547,412,379,33,409,3,"ORAS VATRA DORNEI",,4,,173,236
34,"Suceava",332,"332-ORAS VATRA DORNEI",146744,124,2,1503,1217,1031,186,1209,8,"ORAS VATRA DORNEI",,4,,510,699
34,"Suceava",332,"332-ORAS VATRA DORNEI",146744,125,2,2155,1649,1485,164,1641,8,"ORAS VATRA DORNEI",,4,,724,917
34,"Suceava",332,"332-ORAS VATRA DORNEI",146744,126,2,970,727,658,69,718,9,"ORAS VATRA DORNEI",,4,,322,396
34,"Suceava",332,"332-ORAS VATRA DORNEI",146744,127,2,1880,1382,1282,100,1367,15,"ORAS VATRA DORNEI",,4,,516,851
34,"Suceava",332,"332-ORAS VATRA DORNEI",146744,128,2,885,719,579,140,717,2,"ORAS VATRA DORNEI",,4,,251,466
34,"Suceava",332,"332-ORAS VATRA DORNEI",146744,129,2,575,480,414,66,476,4,"ORAS VATRA DORNEI",,4,,245,231
34,"Suceava",332,"332-ORAS VATRA DORNEI",146744,130,2,0,380,0,380,379,1,"ORAS VATRA DORNEI",,4,,131,248
34,"Suceava",332,"332-ADANCATA",146799,131,2,2197,1655,1530,125,1641,14,"ADANCATA",,4,,1040,601
34,"Suceava",332,"332-ADANCATA",146799,132,2,523,414,361,53,412,2,"ADANCATA",,4,,300,112
34,"Suceava",332,"332-ADANCATA",146799,133,2,539,450,380,70,441,9,"ADANCATA",,4,,282,159
34,"Suceava",332,"332-ADANCATA",146799,134,2,445,354,309,45,347,7,"ADANCATA",,4,,212,135
34,"Suceava",332,"332-ADANCATA",146799,135,2,2283,2060,1870,190,2039,21,"ADANCATA",,4,,1597,442
34,"Suceava",332,"332-ARBORE",146860,136,2,1297,956,888,68,947,9,"ARBORE",,4,,420,527
34,"Suceava",332,"332-ARBORE",146860,137,2,1688,1297,1209,88,1290,7,"ARBORE",,4,,640,650
34,"Suceava",332,"332-ARBORE",146860,138,2,1357,999,934,65,993,6,"ARBORE",,4,,600,393
34,"Suceava",332,"332-ARBORE",146860,139,2,904,766,669,97,766,0,"ARBORE",,4,,525,241
34,"Suceava",332,"332-BAIA",146904,140,2,1908,1494,1372,122,1471,23,"BAIA",,4,,1188,283
34,"Suceava",332,"332-BAIA",146904,141,2,1772,1377,1317,60,1369,8,"BAIA",,4,,1101,268
34,"Suceava",332,"332-BAIA",146904,142,2,980,733,689,44,731,2,"BAIA",,4,,592,139
34,"Suceava",332,"332-BALCAUTI",146995,143,2,1499,1020,869,151,1005,15,"BALCAUTI",,4,,628,377
34,"Suceava",332,"332-BALCAUTI",146995,144,2,958,807,674,133,800,7,"BALCAUTI",,4,,516,284
34,"Suceava",332,"332-BILCA",147036,145,2,714,514,503,11,513,1,"BILCA",,4,,361,152
34,"Suceava",332,"332-BILCA",147036,146,2,1013,802,777,25,790,12,"BILCA",,4,,528,262
34,"Suceava",332,"332-BILCA",147036,147,2,924,780,756,24,772,8,"BILCA",,4,,441,331
34,"Suceava",332,"332-BOGDANESTI",147054,148,2,1667,1206,1119,87,1201,5,"BOGDANESTI",,4,,904,297
34,"Suceava",332,"332-BOGDANESTI",147054,149,2,1223,947,830,117,939,8,"BOGDANESTI",,4,,698,241
34,"Suceava",332,"332-BOROAIA",147072,150,2,1463,1142,1041,101,1131,11,"BOROAIA",,4,,847,284
34,"Suceava",332,"332-BOROAIA",147072,151,2,438,418,370,48,414,4,"BOROAIA",,4,,295,119
34,"Suceava",332,"332-BOROAIA",147072,152,2,673,616,550,66,604,12,"BOROAIA",,4,,458,146
34,"Suceava",332,"332-BOROAIA",147072,153,2,1032,823,725,98,816,7,"BOROAIA",,4,,596,220
34,"Suceava",332,"332-BOSANCI",147134,154,2,1787,1030,943,87,1018,12,"BOSANCI",,4,,609,409
34,"Suceava",332,"332-BOSANCI",147134,155,2,1033,1079,1033,46,681,8,"BOSANCI",,4,,370,311
34,"Suceava",332,"332-BOSANCI",147134,156,2,1590,991,924,67,975,16,"BOSANCI",,4,,544,431
34,"Suceava",332,"332-BOSANCI",147134,157,2,179,140,116,24,134,6,"BOSANCI",,4,,83,51
34,"Suceava",332,"332-BOTOSANA",147161,158,2,2046,1654,1571,83,1649,5,"BOTOSANA",,4,,1012,637
34,"Suceava",332,"332-BOTOSANA",147161,159,2,1023,861,783,78,851,10,"BOTOSANA",,4,,575,276
34,"Suceava",332,"332-BOTOSANA",147161,160,2,745,615,544,71,607,8,"BOTOSANA",,4,,350,257
34,"Suceava",332,"332-BREAZA",147205,161,2,1454,1093,984,109,1082,11,"BREAZA",,4,,673,409
34,"Suceava",332,"332-BRODINA",147241,162,2,1105,778,664,114,770,8,"BRODINA",,4,,380,390
34,"Suceava",332,"332-BRODINA",147241,163,2,723,345,309,36,343,2,"BRODINA",,4,,113,230
34,"Suceava",332,"332-BRODINA",147241,164,2,922,779,616,163,777,2,"BRODINA",,4,,383,394
34,"Suceava",332,"332-BROSTENI",147367,165,2,1029,825,733,92,818,7,"BROSTENI",,4,,527,291
34,"Suceava",332,"332-BROSTENI",147367,166,2,1255,986,870,116,982,4,"BROSTENI",,4,,574,408
34,"Suceava",332,"332-BROSTENI",147367,167,2,1243,1046,656,390,1040,6,"BROSTENI",,4,,587,453
34,"Suceava",332,"332-BROSTENI",147367,168,2,1305,979,911,68,976,3,"BROSTENI",,4,,518,458
34,"Suceava",332,"332-BROSTENI",147367,169,2,120,148,92,56,147,1,"BROSTENI",,4,,88,59
34,"Suceava",332,"332-BUNESTI",147465,170,2,807,668,621,47,664,4,"BUNESTI",,4,,506,158
34,"Suceava",332,"332-BUNESTI",147465,171,2,716,488,460,28,485,3,"BUNESTI",,4,,401,84
34,"Suceava",332,"332-BUNESTI",147465,172,2,586,419,373,46,411,8,"BUNESTI",,4,,302,109
34,"Suceava",332,"332-CACICA",147526,173,2,1476,1204,1155,49,1183,21,"CACICA",,4,,630,553
34,"Suceava",332,"332-CACICA",147526,174,2,1078,891,803,88,883,8,"CACICA",,4,,539,344
34,"Suceava",332,"332-CACICA",147526,175,2,786,578,546,32,571,7,"CACICA",,4,,236,335
34,"Suceava",332,"332-CAJVANA",147642,176,2,2627,1686,1652,34,1673,13,"CAJVANA",,4,,809,864
34,"Suceava",332,"332-CAJVANA",147642,177,2,2111,1138,1103,35,1132,6,"CAJVANA",,4,,515,617
34,"Suceava",332,"332-CALAFINDESTI",147580,178,2,1764,1346,1304,42,1330,16,"CALAFINDESTI",,4,,750,580
34,"Suceava",332,"332-CALAFINDESTI",147580,179,2,296,264,238,26,260,4,"CALAFINDESTI",,4,,179,81
34,"Suceava",332,"332-CALAFINDESTI",147580,180,2,1523,1103,1063,40,1090,13,"CALAFINDESTI",,4,,680,410
34,"Suceava",332,"332-CALAFINDESTI",147580,181,2,843,604,576,28,598,6,"CALAFINDESTI",,4,,424,174
34,"Suceava",332,"332-CIPRIAN PORUMBESCU",147704,182,2,1871,1460,1227,233,1452,8,"CIPRIAN PORUMBESCU",,4,,851,601
34,"Suceava",332,"332-CIPRIAN PORUMBESCU",147704,183,2,1290,1020,854,166,1012,8,"CIPRIAN PORUMBESCU",,4,,674,338
34,"Suceava",332,"332-CIPRIAN PORUMBESCU",147704,184,2,1343,1335,1101,234,1272,63,"CIPRIAN PORUMBESCU",,4,,561,711
34,"Suceava",332,"332-CARLIBABA",147713,185,2,1395,1031,903,128,1024,7,"CARLIBABA",,4,,443,581
34,"Suceava",332,"332-CORNU LUNCII",147786,186,2,1082,931,767,164,926,5,"CORNU LUNCII",,4,,627,299
34,"Suceava",332,"332-CORNU LUNCII",147786,187,2,1229,952,913,39,947,5,"CORNU LUNCII",,4,,613,334
34,"Suceava",332,"332-CORNU LUNCII",147786,188,2,916,783,675,108,779,4,"CORNU LUNCII",,4,,428,351
34,"Suceava",332,"332-CORNU LUNCII",147786,189,2,607,533,425,108,527,6,"CORNU LUNCII",,4,,318,209
34,"Suceava",332,"332-CORNU LUNCII",147786,190,2,1171,798,687,111,790,8,"CORNU LUNCII",,4,,549,241
34,"Suceava",332,"332-CRUCEA",147884,191,2,1145,968,765,203,964,4,"CRUCEA",,4,,538,426
34,"Suceava",332,"332-CRUCEA",147884,192,2,446,389,339,50,384,5,"CRUCEA",,4,,209,175
34,"Suceava",332,"332-DARMANESTI",147937,193,2,972,762,698,64,758,4,"DARMANESTI",,4,,527,231
34,"Suceava",332,"332-DARMANESTI",147937,194,2,655,540,480,60,537,3,"DARMANESTI",,4,,355,182
34,"Suceava",332,"332-DARMANESTI",147937,195,2,1291,1047,970,77,1042,5,"DARMANESTI",,4,,633,409
34,"Suceava",332,"332-DARMANESTI",147937,196,2,592,505,454,51,501,4,"DARMANESTI",,4,,372,129
34,"Suceava",332,"332-DARMANESTI",147937,197,2,766,607,536,71,606,1,"DARMANESTI",,4,,356,250
34,"Suceava",332,"332-DOLHASCA",148015,198,2,2159,1155,1038,117,1144,11,"DOLHASCA",,4,,646,498
34,"Suceava",332,"332-DOLHASCA",148015,199,2,1438,1158,1000,158,1146,12,"DOLHASCA",,4,,707,439
34,"Suceava",332,"332-DOLHASCA",148015,200,2,424,307,271,36,305,2,"DOLHASCA",,4,,184,121
34,"Suceava",332,"332-DOLHASCA",148015,201,2,1298,932,865,67,922,10,"DOLHASCA",,4,,706,216
34,"Suceava",332,"332-DOLHASCA",148015,202,2,1865,1238,1092,146,1234,4,"DOLHASCA",,4,,885,349
34,"Suceava",332,"332-DOLHASCA",148015,203,2,1062,774,698,76,766,8,"DOLHASCA",,4,,621,145
34,"Suceava",332,"332-DOLHASCA",148015,204,2,632,409,378,31,404,5,"DOLHASCA",,4,,323,81
34,"Suceava",332,"332-DOLHESTI",148097,205,2,1661,1318,1210,108,1305,13,"DOLHESTI",,4,,909,396
34,"Suceava",332,"332-DOLHESTI",148097,206,2,990,754,674,80,744,10,"DOLHESTI",,4,,433,311
34,"Suceava",332,"332-DOLHESTI",148097,207,2,626,550,486,64,547,3,"DOLHESTI",,4,,420,127
34,"Suceava",332,"332-DORNA-ARINI",148131,208,2,1726,1357,1231,126,1351,6,"DORNA-ARINI",,4,,577,774
34,"Suceava",332,"332-DORNA-ARINI",148131,209,2,705,632,560,72,632,0,"DORNA-ARINI",,4,,278,354
34,"Suceava",332,"332-DORNA CANDRENILOR",148202,210,2,1625,1241,1108,133,1240,1,"DORNA CANDRENILOR",,4,,640,600
34,"Suceava",332,"332-DORNA CANDRENILOR",148202,211,2,1219,1003,861,142,999,4,"DORNA CANDRENILOR",,4,,513,486
34,"Suceava",332,"332-DORNA CANDRENILOR",148202,212,2,652,569,496,73,565,4,"DORNA CANDRENILOR",,4,,210,355
34,"Suceava",332,"332-DORNESTI",148293,213,2,1797,1394,1212,182,1383,11,"DORNESTI",,4,,735,648
34,"Suceava",332,"332-DORNESTI",148293,214,2,1288,853,724,129,847,6,"DORNESTI",,4,,535,312
34,"Suceava",332,"332-DRAGOIESTI",148328,215,2,805,570,508,62,564,6,"DRAGOIESTI",,4,,360,204
34,"Suceava",332,"332-DRAGOIESTI",148328,216,2,1558,1150,1033,117,1140,10,"DRAGOIESTI",,4,,592,548
34,"Suceava",332,"332-DRAGOIESTI",148328,217,2,419,331,288,43,329,2,"DRAGOIESTI",,4,,211,118
34,"Suceava",332,"332-DRAGOIESTI",148328,218,2,1524,1026,945,81,1010,16,"DRAGOIESTI",,4,,638,372
34,"Suceava",332,"332-DRAGUSENI",148382,219,2,1854,1168,1047,121,1153,15,"DRAGUSENI",,4,,788,365
34,"Suceava",332,"332-DRAGUSENI",148382,220,2,269,278,174,104,277,1,"DRAGUSENI",,4,,213,64
34,"Suceava",332,"332-DUMBRAVENI",148426,221,2,2605,1615,1429,186,1603,12,"DUMBRAVENI",,4,,1009,594
34,"Suceava",332,"332-DUMBRAVENI",148426,222,2,1323,1055,869,186,1046,9,"DUMBRAVENI",,4,,720,326
34,"Suceava",332,"332-DUMBRAVENI",148426,223,2,1183,962,834,128,952,10,"DUMBRAVENI",,4,,670,282
34,"Suceava",332,"332-DUMBRAVENI",148426,224,2,416,316,268,48,310,6,"DUMBRAVENI",,4,,190,120
34,"Suceava",332,"332-FANTANELE",148453,225,2,1197,842,764,78,838,4,"FANTANELE",,4,,562,276
34,"Suceava",332,"332-FANTANELE",148453,226,2,1052,830,751,79,824,6,"FANTANELE",,4,,598,226
34,"Suceava",332,"332-FANTANELE",148453,227,2,1590,1220,1144,76,1163,57,"FANTANELE",,4,,868,295
34,"Suceava",332,"332-FORASTI",148514,228,2,1344,922,822,100,913,9,"FORASTI",,4,,778,135
34,"Suceava",332,"332-FORASTI",148514,229,2,1067,861,754,107,859,2,"FORASTI",,4,,676,183
34,"Suceava",332,"332-FORASTI",148514,230,2,1664,1591,1485,106,1452,139,"FORASTI",,4,,1199,253
34,"Suceava",332,"332-FRASIN",147394,231,2,2238,1618,1348,270,1608,10,"FRASIN",,4,,765,843
34,"Suceava",332,"332-FRASIN",147394,232,2,1132,942,742,200,934,8,"FRASIN",,4,,558,376
34,"Suceava",332,"332-FRASIN",147394,233,2,1576,1246,1068,178,1236,10,"FRASIN",,4,,795,441
34,"Suceava",332,"332-FRATAUTII NOI",148667,234,2,1640,1124,1017,107,1113,11,"FRATAUTII NOI",,4,,663,450
34,"Suceava",332,"332-FRATAUTII NOI",148667,235,2,1202,868,783,85,857,11,"FRATAUTII NOI",,4,,575,282
34,"Suceava",332,"332-FRATAUTII NOI",148667,236,2,1246,845,736,109,836,9,"FRATAUTII NOI",,4,,516,320
34,"Suceava",332,"332-FRATAUTII VECHI",148694,237,2,2088,1305,1218,87,1295,10,"FRATAUTII VECHI",,4,,762,533
34,"Suceava",332,"332-FRATAUTII VECHI",148694,238,2,1373,931,869,62,923,8,"FRATAUTII VECHI",,4,,537,386
34,"Suceava",332,"332-FRUMOSU",148729,239,2,1757,1414,1325,89,1407,7,"FRUMOSU",,4,,861,546
34,"Suceava",332,"332-FRUMOSU",148729,240,2,695,582,562,20,577,5,"FRUMOSU",,4,,298,279
34,"Suceava",332,"332-FRUMOSU",148729,241,2,297,276,254,22,276,0,"FRUMOSU",,4,,112,164
34,"Suceava",332,"332-FUNDU MOLDOVEI",148765,242,2,1414,1194,1100,94,1188,6,"FUNDU MOLDOVEI",,4,,714,474
34,"Suceava",332,"332-FUNDU MOLDOVEI",148765,243,2,792,651,590,61,648,3,"FUNDU MOLDOVEI",,4,,448,200
34,"Suceava",332,"332-FUNDU MOLDOVEI",148765,244,2,953,788,702,86,786,2,"FUNDU MOLDOVEI",,4,,520,266
34,"Suceava",332,"332-GALANESTI",148872,245,2,1809,1341,1225,116,1335,6,"GALANESTI",,4,,817,518
34,"Suceava",332,"332-GALANESTI",148872,246,2,2114,1384,1271,113,1367,17,"GALANESTI",,4,,713,654
34,"Suceava",332,"332-GRAMESTI",148916,247,2,1668,1282,1153,129,1266,16,"GRAMESTI",,4,,822,444
34,"Suceava",332,"332-GRAMESTI",148916,248,2,755,650,560,90,552,8,"GRAMESTI",,4,,342,210
34,"Suceava",332,"332-GRANICESTI",148970,249,2,1884,1182,1112,70,1172,10,"GRANICESTI",,4,,668,504
34,"Suceava",332,"332-GRANICESTI",148970,250,2,906,672,601,71,664,8,"GRANICESTI",,4,,379,285
34,"Suceava",332,"332-GRANICESTI",148970,251,2,761,576,499,77,573,3,"GRANICESTI",,4,,377,196
34,"Suceava",332,"332-HORODNIC",149101,252,2,1262,797,780,17,789,8,"HORODNIC",,4,,387,402
34,"Suceava",332,"332-HORODNIC",149101,253,2,784,594,585,9,590,4,"HORODNIC",,4,,363,227
34,"Suceava",332,"332-HORODNIC",149101,254,2,1334,966,951,15,958,8,"HORODNIC",,4,,514,444
34,"Suceava",332,"332-HORODNIC",149101,255,2,689,492,492,0,485,7,"HORODNIC",,4,,243,242
34,"Suceava",332,"332-HORODNIC",149101,256,2,938,737,720,17,728,9,"HORODNIC",,4,,448,280
34,"Suceava",332,"332-HORODNICENI",149049,257,2,1466,1021,900,121,1008,13,"HORODNICENI",,4,,758,250
34,"Suceava",332,"332-HORODNICENI",149049,258,2,1873,1216,1124,92,1208,8,"HORODNICENI",,4,,1019,189
34,"Suceava",332,"332-IACOBENI",149138,259,2,1834,1446,1283,163,1434,12,"IACOBENI",,4,,825,609
34,"Suceava",332,"332-IACOBENI",149138,260,2,1177,1044,990,54,1038,6,"IACOBENI",,4,,520,518
34,"Suceava",332,"332-IPOTESTI",146281,261,2,2255,1660,1516,144,1643,17,"IPOTESTI",,4,,642,1001
34,"Suceava",332,"332-IPOTESTI",146281,262,2,621,500,417,83,495,5,"IPOTESTI",,4,,321,174
34,"Suceava",332,"332-IPOTESTI",146281,263,2,578,502,418,84,494,8,"IPOTESTI",,4,,257,237
34,"Suceava",332,"332-IZVOARELE SUCEVEI",149183,264,2,778,513,449,64,502,11,"IZVOARELE SUCEVEI",,4,,230,272
34,"Suceava",332,"332-IZVOARELE SUCEVEI",149183,265,2,374,267,218,49,261,6,"IZVOARELE SUCEVEI",,4,,125,136
34,"Suceava",332,"332-IZVOARELE SUCEVEI",149183,266,2,572,442,356,86,437,5,"IZVOARELE SUCEVEI",,4,,55,382
34,"Suceava",332,"332-LITENI",149236,267,2,1418,1043,897,146,1035,8,"LITENI",,4,,618,417
34,"Suceava",332,"332-LITENI",149236,268,2,1999,1271,1136,135,1266,5,"LITENI",,4,,783,483
34,"Suceava",332,"332-LITENI",149236,269,2,1569,1051,948,103,1042,9,"LITENI",,4,,680,362
34,"Suceava",332,"332-LITENI",149236,270,2,1080,775,685,90,757,18,"LITENI",,4,,490,267
34,"Suceava",332,"332-LITENI",149236,271,2,626,508,436,72,503,5,"LITENI",,4,,285,218
34,"Suceava",332,"332-LITENI",149236,272,2,615,442,367,75,438,4,"LITENI",,4,,287,151
34,"Suceava",332,"332-MALINI",149316,273,2,1173,874,780,94,866,8,"MALINI",,4,,505,361
34,"Suceava",332,"332-MALINI",149316,274,2,1183,974,830,144,968,6,"MALINI",,4,,727,241
34,"Suceava",332,"332-MALINI",149316,275,2,1254,866,803,63,858,8,"MALINI",,4,,468,390
34,"Suceava",332,"332-MALINI",149316,276,2,912,634,579,55,629,5,"MALINI",,4,,480,149
34,"Suceava",332,"332-MALINI",149316,277,2,590,520,464,56,517,3,"MALINI",,4,,395,122
34,"Suceava",332,"332-MANASTIREA HUMORULUI",149370,278,2,1989,1491,1396,95,1481,10,"MANASTIREA HUMORULUI",,4,,533,948
34,"Suceava",332,"332-MANASTIREA HUMORULUI",149370,279,2,696,581,559,22,580,1,"MANASTIREA HUMORULUI",,4,,221,359
34,"Suceava",332,"332-MARGINEA",149290,280,2,1777,1090,1051,39,1081,9,"MARGINEA",,4,,367,714
34,"Suceava",332,"332-MARGINEA",149290,281,2,777,502,478,24,498,4,"MARGINEA",,4,,197,301
34,"Suceava",332,"332-MARGINEA",149290,282,2,1716,1067,1027,40,1053,14,"MARGINEA",,4,,434,619
34,"Suceava",332,"332-MARGINEA",149290,283,2,1523,1093,1039,54,1087,6,"MARGINEA",,4,,426,661
34,"Suceava",332,"332-MILISAUTI",146986,284,2,2827,2005,1917,88,1984,21,"MILISAUTI",,4,,809,1175
34,"Suceava",332,"332-MILISAUTI",146986,285,2,1106,784,765,19,775,9,"MILISAUTI",,4,,414,361
34,"Suceava",332,"332-MILISAUTI",146986,286,2,2238,1529,1438,91,1511,18,"MILISAUTI",,4,,788,723
34,"Suceava",332,"332-MITOCU DRAGOMIRNEI",146325,287,2,1268,916,800,116,908,8,"MITOCU DRAGOMIRNEI",,4,,527,381
34,"Suceava",332,"332-MITOCU DRAGOMIRNEI",146325,288,2,1009,838,664,174,816,22,"MITOCU DRAGOMIRNEI",,4,,565,251
34,"Suceava",332,"332-MITOCU DRAGOMIRNEI",146325,289,2,328,274,231,43,272,2,"MITOCU DRAGOMIRNEI",,4,,138,134
34,"Suceava",332,"332-MOARA",149414,290,2,1561,1174,1088,86,1161,13,"MOARA",,4,,822,339
34,"Suceava",332,"332-MOARA",149414,291,2,568,508,475,33,506,2,"MOARA",,4,,412,94
34,"Suceava",332,"332-MOARA",149414,292,2,852,656,563,93,652,4,"MOARA",,4,,355,297
34,"Suceava",332,"332-MOLDOVA-SULITA",149502,293,2,1074,739,669,70,727,12,"MOLDOVA-SULITA",,4,,457,270
34,"Suceava",332,"332-MOLDOVA-SULITA",149502,294,2,526,425,350,75,423,2,"MOLDOVA-SULITA",,4,,188,235
34,"Suceava",332,"332-MOLDOVITA",149539,295,2,1960,1579,1421,158,1565,14,"MOLDOVITA",,4,,575,990
34,"Suceava",332,"332-MOLDOVITA",149539,296,2,943,724,667,57,717,7,"MOLDOVITA",,4,,213,504
34,"Suceava",332,"332-MOLDOVITA",149539,297,2,731,657,605,52,654,3,"MOLDOVITA",,4,,160,494
34,"Suceava",332,"332-MUSENITA",149584,298,2,1011,755,675,80,749,6,"MUSENITA",,4,,440,309
34,"Suceava",332,"332-MUSENITA",149584,299,2,767,623,547,76,620,3,"MUSENITA",,4,,376,244
34,"Suceava",332,"332-OSTRA",149655,300,2,2069,1657,1279,378,1648,9,"OSTRA",,4,,821,827
34,"Suceava",332,"332-PALTINOASA",149753,301,2,2265,1755,1629,126,1748,5,"PALTINOASA",,4,,967,781
34,"Suceava",332,"332-PALTINOASA",149753,302,2,1871,1501,1384,117,1494,7,"PALTINOASA",,4,,950,544
34,"Suceava",332,"332-PANACI",149682,303,2,1258,992,896,96,985,7,"PANACI",,4,,461,524
34,"Suceava",332,"332-PANACI",149682,304,2,610,420,388,32,417,3,"PANACI",,4,,191,226
34,"Suceava",332,"332-PATRAUTI",149833,305,2,1426,1079,960,119,1075,4,"PATRAUTI",,4,,714,361
34,"Suceava",332,"332-PATRAUTI",149833,306,2,1011,786,726,60,774,12,"PATRAUTI",,4,,578,196
34,"Suceava",332,"332-PARTESTII DE JOS",149780,307,2,1589,1201,1086,115,1199,2,"PARTESTII DE JOS",,4,,692,507
34,"Suceava",332,"332-PARTESTII DE JOS",149780,308,2,689,571,521,50,562,9,"PARTESTII DE JOS",,4,,324,238
34,"Suceava",332,"332-POIANA STAMPEI",149851,309,2,1474,1037,925,112,1028,9,"POIANA STAMPEI",,4,,527,501
34,"Suceava",332,"332-POIANA STAMPEI",149851,310,2,212,253,142,111,248,5,"POIANA STAMPEI",,4,,175,73
34,"Suceava",332,"332-POJORATA",149931,311,2,807,770,622,148,768,2,"POJORATA",,4,,444,324
34,"Suceava",332,"332-POJORATA",149931,312,2,1141,1007,925,82,1004,3,"POJORATA",,4,,592,412
34,"Suceava",332,"332-POJORATA",149931,313,2,233,259,182,77,258,1,"POJORATA",,4,,118,140
34,"Suceava",332,"332-PREUTESTI",149968,314,2,1508,1498,1384,114,1490,8,"PREUTESTI",,4,,1053,437
34,"Suceava",332,"332-PREUTESTI",149968,315,2,1475,1474,1309,165,1467,7,"PREUTESTI",,4,,1085,382
34,"Suceava",332,"332-PREUTESTI",149968,316,2,853,696,592,104,687,6,"PREUTESTI",,4,,425,262
34,"Suceava",332,"332-PREUTESTI",149968,317,2,1252,829,739,90,824,5,"PREUTESTI",,4,,618,206
34,"Suceava",332,"332-PREUTESTI",149968,318,2,693,761,662,99,750,11,"PREUTESTI",,4,,550,200
34,"Suceava",332,"332-PREUTESTI",149968,319,2,513,447,376,71,444,3,"PREUTESTI",,4,,397,47
34,"Suceava",332,"332-PUTNA",150043,320,2,1965,1504,1394,110,1488,16,"PUTNA",,4,,964,524
34,"Suceava",332,"332-PUTNA",150043,321,2,891,698,666,32,690,8,"PUTNA",,4,,454,236
34,"Suceava",332,"332-RADASENI",150070,322,2,2051,1605,1471,134,1600,5,"RADASENI",,4,,933,667
34,"Suceava",332,"332-RADASENI",150070,323,2,1158,900,861,39,895,5,"RADASENI",,4,,621,274
34,"Suceava",332,"332-RADASENI",150070,324,2,188,158,136,22,154,4,"RADASENI",,4,,108,46
34,"Suceava",332,"332-RASCA",149575,325,2,2232,1603,1544,59,1587,16,"RASCA",,4,,1052,535
34,"Suceava",332,"332-RASCA",149575,326,2,1274,885,763,122,878,7,"RASCA",,4,,674,204
34,"Suceava",332,"332-SADOVA",150178,327,2,1795,1412,1336,76,1402,10,"SADOVA",,4,,794,608
34,"Suceava",332,"332-SALCEA",146389,328,2,1919,1489,1259,230,1474,15,"SALCEA",,4,,845,629
34,"Suceava",332,"332-SALCEA",146389,329,2,2199,1467,1343,124,1452,15,"SALCEA",,4,,896,556
34,"Suceava",332,"332-SALCEA",146389,330,2,874,679,619,60,666,13,"SALCEA",,4,,353,313
34,"Suceava",332,"332-SALCEA",146389,331,2,1024,777,697,80,762,15,"SALCEA",,4,,446,316
34,"Suceava",332,"332-SATU MARE",147928,332,2,886,645,622,23,639,6,"SATU MARE",,4,,396,243
34,"Suceava",332,"332-SATU MARE",147928,333,2,1121,831,795,36,824,7,"SATU MARE",,4,,496,328
34,"Suceava",332,"332-SATU MARE",147928,334,2,960,669,615,54,663,6,"SATU MARE",,4,,386,277
34,"Suceava",332,"332-SIMINICEA",150221,335,2,1316,960,904,56,941,19,"SIMINICEA",,4,,469,472
34,"Suceava",332,"332-SIMINICEA",150221,336,2,1188,930,849,81,919,11,"SIMINICEA",,4,,538,381
34,"Suceava",332,"332-SLATINA",150258,337,2,1380,947,858,89,936,11,"SLATINA",,4,,734,202
34,"Suceava",332,"332-SLATINA",150258,338,2,1582,1160,1060,100,1153,7,"SLATINA",,4,,975,178
34,"Suceava",332,"332-SLATINA",150258,339,2,955,653,608,45,641,12,"SLATINA",,4,,473,168
34,"Suceava",332,"332-STRAJA",150294,340,2,1887,1245,1180,65,1236,9,"STRAJA",,4,,606,630
34,"Suceava",332,"332-STRAJA",150294,341,2,2316,1340,1276,64,1328,12,"STRAJA",,4,,609,719
34,"Suceava",332,"332-STROIESTI",150310,342,2,2031,1448,1374,74,1439,9,"STROIESTI",,4,,864,575
34,"Suceava",332,"332-STROIESTI",150310,343,2,716,556,517,39,553,3,"STROIESTI",,4,,334,219
34,"Suceava",332,"332-STULPICANI",150356,344,2,2487,1544,1479,65,1533,11,"STULPICANI",,4,,948,585
34,"Suceava",332,"332-STULPICANI",150356,345,2,746,685,660,25,682,3,"STULPICANI",,4,,403,279
34,"Suceava",332,"332-STULPICANI",150356,346,2,407,358,318,40,357,1,"STULPICANI",,4,,233,124
34,"Suceava",332,"332-STULPICANI",150356,347,2,732,640,618,22,637,3,"STULPICANI",,4,,430,207
34,"Suceava",332,"332-STULPICANI",150356,348,2,473,433,417,16,429,4,"STULPICANI",,4,,306,123
34,"Suceava",332,"332-SUCEVITA",150418,349,2,1035,852,799,53,843,9,"SUCEVITA",,4,,443,400
34,"Suceava",332,"332-SUCEVITA",150418,350,2,785,642,614,28,635,7,"SUCEVITA",,4,,296,339
34,"Suceava",332,"332-SARU DORNEI",150445,351,2,1851,1450,1276,174,1441,9,"SARU DORNEI",,4,,733,708
34,"Suceava",332,"332-SARU DORNEI",150445,352,2,1282,1021,895,126,1018,3,"SARU DORNEI",,4,,520,498
34,"Suceava",332,"332-SCHEIA",146432,353,2,1489,1222,1053,169,1209,13,"SCHEIA",,4,,595,614
34,"Suceava",332,"332-SCHEIA",146432,354,2,1778,1314,1195,119,1296,18,"SCHEIA",,4,,655,641
34,"Suceava",332,"332-SCHEIA",146432,355,2,1811,1316,1166,150,1303,13,"SCHEIA",,4,,644,659
34,"Suceava",332,"332-TODIRESTI",150524,356,2,1208,1059,960,99,1053,6,"TODIRESTI",,4,,755,298
34,"Suceava",332,"332-TODIRESTI",150524,357,2,847,719,624,95,713,6,"TODIRESTI",,4,,492,221
34,"Suceava",332,"332-TODIRESTI",150524,358,2,1007,848,749,99,840,8,"TODIRESTI",,4,,564,276
34,"Suceava",332,"332-TODIRESTI",150524,359,2,1336,1100,1028,72,1089,11,"TODIRESTI",,4,,691,398
34,"Suceava",332,"332-UDESTI",150588,360,2,1739,1465,1331,134,1453,12,"UDESTI",,4,,1063,390
34,"Suceava",332,"332-UDESTI",150588,361,2,1428,1231,1039,192,1212,19,"UDESTI",,4,,883,329
34,"Suceava",332,"332-UDESTI",150588,362,2,1977,1475,1327,148,1459,16,"UDESTI",,4,,1014,445
34,"Suceava",332,"332-ULMA",150702,363,2,1004,634,576,58,630,4,"ULMA",,4,,396,234
34,"Suceava",332,"332-ULMA",150702,364,2,722,524,475,49,518,6,"ULMA",,4,,284,234
34,"Suceava",332,"332-VADU MOLDOVEI",150766,365,2,1152,909,733,176,904,5,"VADU MOLDOVEI",,4,,721,183
34,"Suceava",332,"332-VADU MOLDOVEI",150766,366,2,1766,1383,1197,186,1375,8,"VADU MOLDOVEI",,4,,963,412
34,"Suceava",332,"332-VADU MOLDOVEI",150766,367,2,1152,815,679,136,805,10,"VADU MOLDOVEI",,4,,621,184
34,"Suceava",332,"332-VADU MOLDOVEI",150766,368,2,1129,941,812,129,933,8,"VADU MOLDOVEI",,4,,717,216
34,"Suceava",332,"332-VALEA MOLDOVEI",150891,369,2,2125,1511,1386,125,1490,21,"VALEA MOLDOVEI",,4,,752,738
34,"Suceava",332,"332-VALEA MOLDOVEI",150891,370,2,1709,1357,1277,80,1345,12,"VALEA MOLDOVEI",,4,,664,681
34,"Suceava",332,"332-VAMA",150935,371,2,2456,1936,1739,197,1929,7,"VAMA",,4,,738,1191
34,"Suceava",332,"332-VAMA",150935,372,2,827,682,581,101,676,6,"VAMA",,4,,283,393
34,"Suceava",332,"332-VAMA",150935,373,2,465,449,379,70,447,2,"VAMA",,4,,141,306
34,"Suceava",332,"332-VAMA",150935,374,2,611,561,440,121,556,5,"VAMA",,4,,241,315
34,"Suceava",332,"332-VATRA MOLDOVITEI",150980,375,2,660,535,479,56,533,2,"VATRA MOLDOVITEI",,4,,263,270
34,"Suceava",332,"332-VATRA MOLDOVITEI",150980,376,2,1156,924,820,104,919,5,"VATRA MOLDOVITEI",,4,,365,554
34,"Suceava",332,"332-VATRA MOLDOVITEI",150980,377,2,1261,866,816,50,851,15,"VATRA MOLDOVITEI",,4,,492,359
34,"Suceava",332,"332-VATRA MOLDOVITEI",150980,378,2,377,281,258,23,274,7,"VATRA MOLDOVITEI",,4,,102,172
34,"Suceava",332,"332-VERESTI",151022,379,2,1731,1359,1156,203,1334,25,"VERESTI",,4,,815,519
34,"Suceava",332,"332-VERESTI",151022,380,2,2070,1454,1337,117,1424,30,"VERESTI",,4,,879,545
34,"Suceava",332,"332-VERESTI",151022,381,2,1123,868,802,66,849,19,"VERESTI",,4,,449,400
34,"Suceava",332,"332-VICOVU DE JOS",151077,382,2,2337,1685,1560,125,1677,8,"VICOVU DE JOS",,4,,998,679
34,"Suceava",332,"332-VICOVU DE JOS",151077,383,2,1727,1255,1168,87,1239,16,"VICOVU DE JOS",,4,,706,533
34,"Suceava",332,"332-VICOVU DE SUS",151102,384,2,2010,1311,1266,45,1296,15,"VICOVU DE SUS",,4,,873,423
34,"Suceava",332,"332-VICOVU DE SUS",151102,385,2,2202,1625,1618,7,1606,19,"VICOVU DE SUS",,4,,943,663
34,"Suceava",332,"332-VICOVU DE SUS",151102,386,2,1674,1075,1042,33,1057,18,"VICOVU DE SUS",,4,,680,377
34,"Suceava",332,"332-VICOVU DE SUS",151102,387,2,1895,1302,1282,20,1293,9,"VICOVU DE SUS",,4,,791,502
34,"Suceava",332,"332-VICOVU DE SUS",151102,388,2,1812,1078,1078,0,1064,14,"VICOVU DE SUS",,4,,639,425
34,"Suceava",332,"332-VOLOVAT",151120,389,2,1554,1083,1063,20,1068,15,"VOLOVAT",,4,,438,630
34,"Suceava",332,"332-VOLOVAT",151120,390,2,1437,1007,971,36,988,19,"VOLOVAT",,4,,445,543
34,"Suceava",332,"332-VOLOVAT",151120,391,2,1348,978,926,52,966,12,"VOLOVAT",,4,,464,502
34,"Suceava",332,"332-VULTURESTI",151157,392,2,732,567,492,75,563,4,"VULTURESTI",,4,,399,164
34,"Suceava",332,"332-VULTURESTI",151157,393,2,1071,802,724,78,790,12,"VULTURESTI",,4,,586,204
34,"Suceava",332,"332-VULTURESTI",151157,394,2,591,509,440,69,508,1,"VULTURESTI",,4,,419,89
34,"Suceava",332,"332-VULTURESTI",151157,395,2,245,250,197,53,248,2,"VULTURESTI",,4,,181,67
34,"Suceava",332,"332-VULTURESTI",151157,396,2,331,291,252,39,290,1,"VULTURESTI",,4,,215,75
34,"Suceava",332,"332-ZAMOSTEA",151246,397,2,1944,1455,1321,134,1441,14,"ZAMOSTEA",,4,,908,533
34,"Suceava",332,"332-ZAMOSTEA",151246,398,2,438,352,332,20,349,3,"ZAMOSTEA",,4,,247,102
34,"Suceava",332,"332-ZVORISTEA",151344,399,2,683,536,489,47,529,7,"ZVORISTEA",,4,,360,169
34,"Suceava",332,"332-ZVORISTEA",151344,400,2,1408,1115,996,119,1106,9,"ZVORISTEA",,4,,765,341
34,"Suceava",332,"332-ZVORISTEA",151344,401,2,497,427,379,48,423,4,"ZVORISTEA",,4,,306,117
34,"Suceava",332,"332-ZVORISTEA",151344,402,2,503,495,430,65,489,6,"ZVORISTEA",,4,,335,154
34,"Suceava",332,"332-ZVORISTEA",151344,403,2,523,461,414,47,449,12,"ZVORISTEA",,4,,346,103
34,"Suceava",332,"332-ZVORISTEA",151344,404,2,845,688,637,51,681,7,"ZVORISTEA",,4,,485,196
35,"Teleorman",341,"341-MUNICIPIUL ALEXANDRIA",151790,1,2,1577,1035,952,83,1030,5,"MUNICIPIUL ALEXANDRIA",,5,,642,388
35,"Teleorman",341,"341-MUNICIPIUL ALEXANDRIA",151790,2,2,1268,799,702,97,795,4,"MUNICIPIUL ALEXANDRIA",,5,,479,316
35,"Teleorman",341,"341-MUNICIPIUL ALEXANDRIA",151790,3,2,1377,1027,925,102,1012,15,"MUNICIPIUL ALEXANDRIA",,5,,559,453
35,"Teleorman",341,"341-MUNICIPIUL ALEXANDRIA",151790,4,2,1568,1179,1094,85,1167,12,"MUNICIPIUL ALEXANDRIA",,5,,677,490
35,"Teleorman",341,"341-MUNICIPIUL ALEXANDRIA",151790,5,2,1687,1243,1106,137,1240,3,"MUNICIPIUL ALEXANDRIA",,5,,738,502
35,"Teleorman",341,"341-MUNICIPIUL ALEXANDRIA",151790,6,2,1612,1149,1089,60,1141,8,"MUNICIPIUL ALEXANDRIA",,5,,709,432
35,"Teleorman",341,"341-MUNICIPIUL ALEXANDRIA",151790,7,2,1715,1243,1143,100,1237,6,"MUNICIPIUL ALEXANDRIA",,5,,722,515
35,"Teleorman",341,"341-MUNICIPIUL ALEXANDRIA",151790,8,2,1740,1249,1169,80,1240,9,"MUNICIPIUL ALEXANDRIA",,5,,669,571
35,"Teleorman",341,"341-MUNICIPIUL ALEXANDRIA",151790,9,2,1588,1134,1034,100,1128,6,"MUNICIPIUL ALEXANDRIA",,5,,655,473
35,"Teleorman",341,"341-MUNICIPIUL ALEXANDRIA",151790,10,2,1754,1365,1167,198,1360,5,"MUNICIPIUL ALEXANDRIA",,5,,782,578
35,"Teleorman",341,"341-MUNICIPIUL ALEXANDRIA",151790,11,2,1483,1099,1007,92,1094,5,"MUNICIPIUL ALEXANDRIA",,5,,610,484
35,"Teleorman",341,"341-MUNICIPIUL ALEXANDRIA",151790,12,2,1260,928,860,68,923,5,"MUNICIPIUL ALEXANDRIA",,5,,479,444
35,"Teleorman",341,"341-MUNICIPIUL ALEXANDRIA",151790,13,2,1016,732,672,60,727,5,"MUNICIPIUL ALEXANDRIA",,5,,418,309
35,"Teleorman",341,"341-MUNICIPIUL ALEXANDRIA",151790,14,2,1480,1069,936,133,1056,13,"MUNICIPIUL ALEXANDRIA",,5,,619,437
35,"Teleorman",341,"341-MUNICIPIUL ALEXANDRIA",151790,15,2,1421,1026,904,122,1021,5,"MUNICIPIUL ALEXANDRIA",,5,,533,488
35,"Teleorman",341,"341-MUNICIPIUL ALEXANDRIA",151790,16,2,1186,921,828,93,917,4,"MUNICIPIUL ALEXANDRIA",,5,,524,393
35,"Teleorman",341,"341-MUNICIPIUL ALEXANDRIA",151790,17,2,1769,1183,1089,94,1181,2,"MUNICIPIUL ALEXANDRIA",,5,,712,469
35,"Teleorman",341,"341-MUNICIPIUL ALEXANDRIA",151790,18,2,1363,971,873,98,968,3,"MUNICIPIUL ALEXANDRIA",,5,,538,430
35,"Teleorman",341,"341-MUNICIPIUL ALEXANDRIA",151790,19,2,1156,846,790,56,840,6,"MUNICIPIUL ALEXANDRIA",,5,,518,322
35,"Teleorman",341,"341-MUNICIPIUL ALEXANDRIA",151790,20,2,1206,914,838,76,913,1,"MUNICIPIUL ALEXANDRIA",,5,,584,329
35,"Teleorman",341,"341-MUNICIPIUL ALEXANDRIA",151790,21,2,1158,808,737,71,805,3,"MUNICIPIUL ALEXANDRIA",,5,,491,314
35,"Teleorman",341,"341-MUNICIPIUL ALEXANDRIA",151790,22,2,939,659,617,42,657,2,"MUNICIPIUL ALEXANDRIA",,5,,412,245
35,"Teleorman",341,"341-MUNICIPIUL ALEXANDRIA",151790,23,2,1165,789,714,75,784,5,"MUNICIPIUL ALEXANDRIA",,5,,462,322
35,"Teleorman",341,"341-MUNICIPIUL ALEXANDRIA",151790,24,2,1624,1140,1056,84,1136,4,"MUNICIPIUL ALEXANDRIA",,5,,638,498
35,"Teleorman",341,"341-MUNICIPIUL ALEXANDRIA",151790,25,2,1282,906,814,92,901,5,"MUNICIPIUL ALEXANDRIA",,5,,551,350
35,"Teleorman",341,"341-MUNICIPIUL ALEXANDRIA",151790,26,2,1669,1096,1001,95,1081,15,"MUNICIPIUL ALEXANDRIA",,5,,727,354
35,"Teleorman",341,"341-MUNICIPIUL ALEXANDRIA",151790,27,2,1288,916,852,64,905,11,"MUNICIPIUL ALEXANDRIA",,5,,549,356
35,"Teleorman",341,"341-MUNICIPIUL ALEXANDRIA",151790,28,2,1334,819,751,68,817,2,"MUNICIPIUL ALEXANDRIA",,5,,533,284
35,"Teleorman",341,"341-MUNICIPIUL ALEXANDRIA",151790,29,2,2253,1599,1530,69,1566,33,"MUNICIPIUL ALEXANDRIA",,5,,1058,508
35,"Teleorman",341,"341-MUNICIPIUL ALEXANDRIA",151790,30,2,2274,1491,1327,164,1458,33,"MUNICIPIUL ALEXANDRIA",,5,,992,466
35,"Teleorman",341,"341-MUNICIPIUL ALEXANDRIA",151790,31,2,0,358,0,358,349,9,"MUNICIPIUL ALEXANDRIA",,5,,201,148
35,"Teleorman",341,"341-MUNICIPIUL ALEXANDRIA",151790,32,2,0,504,0,504,504,0,"MUNICIPIUL ALEXANDRIA",,5,,344,160
35,"Teleorman",341,"341-MUNICIPIUL ROSIORI DE VEDE",151870,33,2,1262,952,848,104,948,4,"MUNICIPIUL ROSIORI DE VEDE",,5,,518,430
35,"Teleorman",341,"341-MUNICIPIUL ROSIORI DE VEDE",151870,34,2,1283,906,834,72,894,12,"MUNICIPIUL ROSIORI DE VEDE",,5,,504,390
35,"Teleorman",341,"341-MUNICIPIUL ROSIORI DE VEDE",151870,35,2,1162,1112,1004,108,1111,1,"MUNICIPIUL ROSIORI DE VEDE",,5,,536,575
35,"Teleorman",341,"341-MUNICIPIUL ROSIORI DE VEDE",151870,36,2,1418,1068,993,75,1065,3,"MUNICIPIUL ROSIORI DE VEDE",,5,,555,510
35,"Teleorman",341,"341-MUNICIPIUL ROSIORI DE VEDE",151870,37,2,1217,919,848,71,916,3,"MUNICIPIUL ROSIORI DE VEDE",,5,,524,392
35,"Teleorman",341,"341-MUNICIPIUL ROSIORI DE VEDE",151870,38,2,1367,949,886,63,945,4,"MUNICIPIUL ROSIORI DE VEDE",,5,,515,430
35,"Teleorman",341,"341-MUNICIPIUL ROSIORI DE VEDE",151870,39,2,1131,768,666,102,767,1,"MUNICIPIUL ROSIORI DE VEDE",,5,,419,348
35,"Teleorman",341,"341-MUNICIPIUL ROSIORI DE VEDE",151870,40,2,1104,851,747,104,851,0,"MUNICIPIUL ROSIORI DE VEDE",,5,,471,380
35,"Teleorman",341,"341-MUNICIPIUL ROSIORI DE VEDE",151870,41,2,1450,907,824,83,902,5,"MUNICIPIUL ROSIORI DE VEDE",,5,,560,342
35,"Teleorman",341,"341-MUNICIPIUL ROSIORI DE VEDE",151870,42,2,1435,1080,1003,77,1070,10,"MUNICIPIUL ROSIORI DE VEDE",,5,,662,408
35,"Teleorman",341,"341-MUNICIPIUL ROSIORI DE VEDE",151870,43,2,1496,961,912,49,953,8,"MUNICIPIUL ROSIORI DE VEDE",,5,,565,388
35,"Teleorman",341,"341-MUNICIPIUL ROSIORI DE VEDE",151870,44,2,1450,1076,1002,74,1061,15,"MUNICIPIUL ROSIORI DE VEDE",,5,,653,408
35,"Teleorman",341,"341-MUNICIPIUL ROSIORI DE VEDE",151870,45,2,1126,800,758,42,789,11,"MUNICIPIUL ROSIORI DE VEDE",,5,,459,330
35,"Teleorman",341,"341-MUNICIPIUL ROSIORI DE VEDE",151870,46,2,1320,985,923,62,982,3,"MUNICIPIUL ROSIORI DE VEDE",,5,,576,406
35,"Teleorman",341,"341-MUNICIPIUL ROSIORI DE VEDE",151870,47,2,1576,1038,967,71,1032,6,"MUNICIPIUL ROSIORI DE VEDE",,5,,649,383
35,"Teleorman",341,"341-MUNICIPIUL ROSIORI DE VEDE",151870,48,2,1231,845,792,53,840,5,"MUNICIPIUL ROSIORI DE VEDE",,5,,476,364
35,"Teleorman",341,"341-MUNICIPIUL ROSIORI DE VEDE",151870,49,2,1353,1008,871,137,1003,5,"MUNICIPIUL ROSIORI DE VEDE",,5,,547,456
35,"Teleorman",341,"341-MUNICIPIUL ROSIORI DE VEDE",151870,50,2,1659,1141,1037,104,1133,8,"MUNICIPIUL ROSIORI DE VEDE",,5,,678,455
35,"Teleorman",341,"341-MUNICIPIUL ROSIORI DE VEDE",151870,51,2,1547,1049,858,191,1042,7,"MUNICIPIUL ROSIORI DE VEDE",,5,,626,416
35,"Teleorman",341,"341-MUNICIPIUL ROSIORI DE VEDE",151870,52,2,1174,794,704,90,792,2,"MUNICIPIUL ROSIORI DE VEDE",,5,,473,319
35,"Teleorman",341,"341-MUNICIPIUL ROSIORI DE VEDE",151870,53,2,1404,936,874,62,931,5,"MUNICIPIUL ROSIORI DE VEDE",,5,,570,361
35,"Teleorman",341,"341-MUNICIPIUL ROSIORI DE VEDE",151870,54,2,0,358,0,358,354,4,"MUNICIPIUL ROSIORI DE VEDE",,5,,233,121
35,"Teleorman",341,"341-MUNICIPIUL TURNU MAGURELE",151683,55,2,1737,1154,1086,68,1138,16,"MUNICIPIUL TURNU MAGURELE",,5,,782,356
35,"Teleorman",341,"341-MUNICIPIUL TURNU MAGURELE",151683,56,2,1245,862,780,82,852,10,"MUNICIPIUL TURNU MAGURELE",,5,,529,323
35,"Teleorman",341,"341-MUNICIPIUL TURNU MAGURELE",151683,57,2,1770,1257,1025,232,1249,8,"MUNICIPIUL TURNU MAGURELE",,5,,713,536
35,"Teleorman",341,"341-MUNICIPIUL TURNU MAGURELE",151683,58,2,1559,1063,894,169,1054,9,"MUNICIPIUL TURNU MAGURELE",,5,,602,452
35,"Teleorman",341,"341-MUNICIPIUL TURNU MAGURELE",151683,59,2,2082,1354,1238,116,1349,5,"MUNICIPIUL TURNU MAGURELE",,5,,789,560
35,"Teleorman",341,"341-MUNICIPIUL TURNU MAGURELE",151683,60,2,1689,1098,928,170,1096,2,"MUNICIPIUL TURNU MAGURELE",,5,,650,446
35,"Teleorman",341,"341-MUNICIPIUL TURNU MAGURELE",151683,61,2,1565,1076,931,145,1060,16,"MUNICIPIUL TURNU MAGURELE",,5,,614,446
35,"Teleorman",341,"341-MUNICIPIUL TURNU MAGURELE",151683,62,2,1173,841,751,90,840,1,"MUNICIPIUL TURNU MAGURELE",,5,,440,400
35,"Teleorman",341,"341-MUNICIPIUL TURNU MAGURELE",151683,63,2,1711,1129,1064,65,1126,3,"MUNICIPIUL TURNU MAGURELE",,5,,527,599
35,"Teleorman",341,"341-MUNICIPIUL TURNU MAGURELE",151683,64,2,1432,927,841,86,917,10,"MUNICIPIUL TURNU MAGURELE",,5,,514,403
35,"Teleorman",341,"341-MUNICIPIUL TURNU MAGURELE",151683,65,2,1806,1301,1075,226,1299,2,"MUNICIPIUL TURNU MAGURELE",,5,,623,676
35,"Teleorman",341,"341-MUNICIPIUL TURNU MAGURELE",151683,66,2,1266,864,802,62,862,2,"MUNICIPIUL TURNU MAGURELE",,5,,465,397
35,"Teleorman",341,"341-MUNICIPIUL TURNU MAGURELE",151683,67,2,1123,793,687,106,789,4,"MUNICIPIUL TURNU MAGURELE",,5,,407,382
35,"Teleorman",341,"341-MUNICIPIUL TURNU MAGURELE",151683,68,2,1503,1030,966,64,1021,9,"MUNICIPIUL TURNU MAGURELE",,5,,609,412
35,"Teleorman",341,"341-MUNICIPIUL TURNU MAGURELE",151683,69,2,1107,793,701,92,792,1,"MUNICIPIUL TURNU MAGURELE",,5,,392,400
35,"Teleorman",341,"341-MUNICIPIUL TURNU MAGURELE",151683,70,2,1449,912,831,81,891,21,"MUNICIPIUL TURNU MAGURELE",,5,,515,376
35,"Teleorman",341,"341-MUNICIPIUL TURNU MAGURELE",151683,71,2,1632,1058,988,70,1044,14,"MUNICIPIUL TURNU MAGURELE",,5,,607,437
35,"Teleorman",341,"341-MUNICIPIUL TURNU MAGURELE",151683,72,2,1589,1145,1067,78,1130,15,"MUNICIPIUL TURNU MAGURELE",,5,,675,455
35,"Teleorman",341,"341-MUNICIPIUL TURNU MAGURELE",151683,73,2,0,241,0,241,240,1,"MUNICIPIUL TURNU MAGURELE",,5,,147,93
35,"Teleorman",341,"341-MUNICIPIUL TURNU MAGURELE",151683,74,2,0,211,0,211,207,4,"MUNICIPIUL TURNU MAGURELE",,5,,115,92
35,"Teleorman",341,"341-ORAS VIDELE",151905,75,2,1657,1229,942,287,1224,5,"ORAS VIDELE",,5,,616,608
35,"Teleorman",341,"341-ORAS VIDELE",151905,76,2,1244,907,722,185,902,5,"ORAS VIDELE",,5,,508,394
35,"Teleorman",341,"341-ORAS VIDELE",151905,77,2,1677,1152,1018,134,1148,4,"ORAS VIDELE",,5,,613,535
35,"Teleorman",341,"341-ORAS VIDELE",151905,78,2,840,714,518,196,705,9,"ORAS VIDELE",,5,,460,245
35,"Teleorman",341,"341-ORAS VIDELE",151905,79,2,1456,934,836,98,923,11,"ORAS VIDELE",,5,,615,308
35,"Teleorman",341,"341-ORAS VIDELE",151905,80,2,728,564,477,87,559,5,"ORAS VIDELE",,5,,354,205
35,"Teleorman",341,"341-ORAS VIDELE",151905,81,2,1319,712,632,80,706,6,"ORAS VIDELE",,5,,371,335
35,"Teleorman",341,"341-ORAS VIDELE",151905,82,2,412,279,221,58,276,3,"ORAS VIDELE",,5,,178,98
35,"Teleorman",341,"341-ORAS ZIMNICEA",151978,83,2,1492,1055,991,64,1046,9,"ORAS ZIMNICEA",,5,,699,347
35,"Teleorman",341,"341-ORAS ZIMNICEA",151978,84,2,1704,1190,1126,64,1180,10,"ORAS ZIMNICEA",,5,,807,373
35,"Teleorman",341,"341-ORAS ZIMNICEA",151978,85,2,1586,1078,1011,67,1069,9,"ORAS ZIMNICEA",,5,,704,365
35,"Teleorman",341,"341-ORAS ZIMNICEA",151978,86,2,1671,1110,954,156,1101,9,"ORAS ZIMNICEA",,5,,562,539
35,"Teleorman",341,"341-ORAS ZIMNICEA",151978,87,2,1534,946,838,108,943,3,"ORAS ZIMNICEA",,5,,472,471
35,"Teleorman",341,"341-ORAS ZIMNICEA",151978,88,2,1309,965,764,201,961,4,"ORAS ZIMNICEA",,5,,499,462
35,"Teleorman",341,"341-ORAS ZIMNICEA",151978,89,2,1581,1091,1042,49,1071,20,"ORAS ZIMNICEA",,5,,658,413
35,"Teleorman",341,"341-ORAS ZIMNICEA",151978,90,2,1626,1127,1063,64,1109,18,"ORAS ZIMNICEA",,5,,636,473
35,"Teleorman",341,"341-ORAS ZIMNICEA",151978,91,2,1471,1045,954,91,1040,5,"ORAS ZIMNICEA",,5,,588,452
35,"Teleorman",341,"341-BALACI",151996,92,2,1263,956,839,117,946,10,"BALACI",,5,,754,192
35,"Teleorman",341,"341-BALACI",151996,93,2,951,736,572,164,728,8,"BALACI",,5,,525,203
35,"Teleorman",341,"341-BABAITA",152038,94,2,1717,1016,927,89,996,20,"BABAITA",,5,,611,385
35,"Teleorman",341,"341-BABAITA",152038,95,2,1806,1060,952,108,1046,14,"BABAITA",,5,,682,364
35,"Teleorman",341,"341-BABAITA",152038,96,2,956,710,657,53,695,15,"BABAITA",,5,,516,179
35,"Teleorman",341,"341-BABAITA",152038,97,2,727,524,459,65,519,5,"BABAITA",,5,,273,246
35,"Teleorman",341,"341-BLEJESTI",152083,98,2,2084,1218,1033,185,1202,16,"BLEJESTI",,5,,855,347
35,"Teleorman",341,"341-BLEJESTI",152083,99,2,887,696,544,152,685,11,"BLEJESTI",,5,,429,256
35,"Teleorman",341,"341-BLEJESTI",152083,100,2,322,244,188,56,243,1,"BLEJESTI",,5,,168,75
35,"Teleorman",341,"341-BOGDANA",152127,101,2,1047,805,584,221,803,2,"BOGDANA",,5,,628,175
35,"Teleorman",341,"341-BOGDANA",152127,102,2,759,600,449,151,591,9,"BOGDANA",,5,,429,162
35,"Teleorman",341,"341-BOGDANA",152127,103,2,755,642,476,166,639,3,"BOGDANA",,5,,474,165
35,"Teleorman",341,"341-BOTOROAGA",152172,104,2,1323,927,858,69,917,10,"BOTOROAGA",,5,,609,308
35,"Teleorman",341,"341-BOTOROAGA",152172,105,2,981,593,569,24,585,8,"BOTOROAGA",,5,,441,144
35,"Teleorman",341,"341-BOTOROAGA",152172,106,2,1625,1113,1038,75,1089,24,"BOTOROAGA",,5,,783,306
35,"Teleorman",341,"341-BOTOROAGA",152172,107,2,248,200,195,5,194,6,"BOTOROAGA",,5,,136,58
35,"Teleorman",341,"341-BOTOROAGA",152172,108,2,1558,948,845,103,940,8,"BOTOROAGA",,5,,607,333
35,"Teleorman",341,"341-BRAGADIRU",152234,109,2,1440,747,603,144,743,4,"BRAGADIRU",,5,,480,263
35,"Teleorman",341,"341-BRAGADIRU",152234,110,2,1607,803,587,216,798,5,"BRAGADIRU",,5,,533,265
35,"Teleorman",341,"341-BRAGADIRU",152234,111,2,1223,691,572,119,687,4,"BRAGADIRU",,5,,516,171
35,"Teleorman",341,"341-BRANCENI",152252,112,2,1280,926,852,74,908,18,"BRANCENI",,5,,696,212
35,"Teleorman",341,"341-BRANCENI",152252,113,2,1117,870,807,63,863,7,"BRANCENI",,5,,563,300
35,"Teleorman",341,"341-BUJORENI",152270,114,2,653,574,472,102,568,6,"BUJORENI",,5,,401,167
35,"Teleorman",341,"341-BUJORENI",152270,115,2,411,404,323,81,395,9,"BUJORENI",,5,,259,136
35,"Teleorman",341,"341-BUJORU",152314,116,2,889,541,469,72,537,4,"BUJORU",,5,,330,207
35,"Teleorman",341,"341-BUJORU",152314,117,2,874,638,516,122,632,6,"BUJORU",,5,,399,233
35,"Teleorman",341,"341-BUZESCU",152332,118,2,1098,768,685,83,757,11,"BUZESCU",,5,,525,232
35,"Teleorman",341,"341-BUZESCU",152332,119,2,1306,744,712,32,739,5,"BUZESCU",,5,,543,196
35,"Teleorman",341,"341-BUZESCU",152332,120,2,1068,724,671,53,714,10,"BUZESCU",,5,,539,175
35,"Teleorman",341,"341-CALINESTI",152350,121,2,1593,1310,1188,122,1294,16,"CALINESTI",,5,,1058,236
35,"Teleorman",341,"341-CALINESTI",152350,122,2,1036,837,734,103,828,9,"CALINESTI",,5,,630,198
35,"Teleorman",341,"341-CALINESTI",152350,123,2,952,789,650,139,780,9,"CALINESTI",,5,,584,196
35,"Teleorman",341,"341-CALMATUIUL",152412,124,2,851,593,503,90,584,9,"CALMATUIUL",,5,,411,173
35,"Teleorman",341,"341-CALMATUIUL",152412,125,2,394,314,268,46,313,1,"CALMATUIUL",,5,,230,83
35,"Teleorman",341,"341-CALMATUIUL",152412,126,2,497,393,317,76,388,5,"CALMATUIUL",,5,,283,105
35,"Teleorman",341,"341-CALMATUIUL",152412,127,2,869,619,523,96,607,12,"CALMATUIUL",,5,,394,213
35,"Teleorman",341,"341-CALMATUIUL DE SUS",152467,128,2,1422,841,737,104,829,12,"CALMATUIUL DE SUS",,5,,476,353
35,"Teleorman",341,"341-CALMATUIUL DE SUS",152467,129,2,1133,750,640,110,736,14,"CALMATUIUL DE SUS",,5,,417,319
35,"Teleorman",341,"341-CERVENIA",152500,130,2,1492,1173,985,188,1161,12,"CERVENIA",,5,,760,401
35,"Teleorman",341,"341-CERVENIA",152500,131,2,1363,1021,850,171,1012,9,"CERVENIA",,5,,609,403
35,"Teleorman",341,"341-CIOLANESTI",152528,132,2,1223,719,573,146,709,10,"CIOLANESTI",,5,,511,198
35,"Teleorman",341,"341-CIOLANESTI",152528,133,2,990,650,520,130,639,11,"CIOLANESTI",,5,,493,146
35,"Teleorman",341,"341-CIOLANESTI",152528,134,2,760,616,541,75,610,6,"CIOLANESTI",,5,,492,118
35,"Teleorman",341,"341-CIOLANESTI",152528,135,2,459,331,274,57,327,4,"CIOLANESTI",,5,,241,86
35,"Teleorman",341,"341-CIUPERCENI",151709,136,2,1048,681,607,74,674,7,"CIUPERCENI",,5,,423,251
35,"Teleorman",341,"341-CIUPERCENI",151709,137,2,820,551,448,103,545,6,"CIUPERCENI",,5,,335,210
35,"Teleorman",341,"341-CONTESTI",152564,138,2,1632,1137,912,225,1135,2,"CONTESTI",,5,,850,285
35,"Teleorman",341,"341-CONTESTI",152564,139,2,1502,1101,919,182,1097,4,"CONTESTI",,5,,785,312
35,"Teleorman",341,"341-COSMESTI",152582,140,2,948,614,555,59,610,4,"COSMESTI",,5,,459,151
35,"Teleorman",341,"341-COSMESTI",152582,141,2,1298,1068,947,121,1054,14,"COSMESTI",,5,,763,291
35,"Teleorman",341,"341-CRANGENI",152617,142,2,1917,1519,1500,19,1513,6,"CRANGENI",,5,,1108,405
35,"Teleorman",341,"341-CRANGENI",152617,143,2,783,600,498,102,586,14,"CRANGENI",,5,,454,132
35,"Teleorman",341,"341-CRANGENI",152617,144,2,480,420,306,114,414,6,"CRANGENI",,5,,273,141
35,"Teleorman",341,"341-CRANGU",152662,145,2,1410,1018,837,181,1001,17,"CRANGU",,5,,729,272
35,"Teleorman",341,"341-CRANGU",152662,146,2,1269,815,663,152,804,11,"CRANGU",,5,,558,246
35,"Teleorman",341,"341-CRANGU",152662,147,2,427,335,254,81,332,3,"CRANGU",,5,,246,86
35,"Teleorman",341,"341-CREVENICU",151932,148,2,1025,791,712,79,780,11,"CREVENICU",,5,,567,213
35,"Teleorman",341,"341-CREVENICU",151932,149,2,518,444,359,85,435,9,"CREVENICU",,5,,280,155
35,"Teleorman",341,"341-DIDESTI",152724,150,2,1323,984,855,129,974,10,"DIDESTI",,5,,682,292
35,"Teleorman",341,"341-DOBROTESTI",152760,151,2,1601,1119,934,185,1099,20,"DOBROTESTI",,5,,607,492
35,"Teleorman",341,"341-DOBROTESTI",152760,152,2,1548,990,873,117,979,11,"DOBROTESTI",,5,,632,347
35,"Teleorman",341,"341-DOBROTESTI",152760,153,2,1205,937,809,128,927,10,"DOBROTESTI",,5,,671,256
35,"Teleorman",341,"341-DRACSENEI",152797,154,2,1359,957,857,100,953,4,"DRACSENEI",,5,,725,228
35,"Teleorman",341,"341-DRACSENEI",152797,155,2,1200,799,700,99,791,8,"DRACSENEI",,5,,483,308
35,"Teleorman",341,"341-DRACSENEI",152797,156,2,445,409,330,79,405,4,"DRACSENEI",,5,,343,62
35,"Teleorman",341,"341-DRACSENEI",152797,157,2,252,292,246,46,287,5,"DRACSENEI",,5,,116,171
35,"Teleorman",341,"341-DRAGANESTI DE VEDE",152868,158,2,1223,846,711,135,841,5,"DRAGANESTI DE VEDE",,5,,635,206
35,"Teleorman",341,"341-DRAGANESTI DE VEDE",152868,159,2,498,387,282,105,385,2,"DRAGANESTI DE VEDE",,5,,271,114
35,"Teleorman",341,"341-DRAGANESTI-VLASCA",152902,160,2,2096,1403,1224,179,1396,7,"DRAGANESTI-VLASCA",,5,,1102,294
35,"Teleorman",341,"341-DRAGANESTI-VLASCA",152902,161,2,1191,818,627,191,809,9,"DRAGANESTI-VLASCA",,5,,603,206
35,"Teleorman",341,"341-DRAGANESTI-VLASCA",152902,162,2,325,253,198,55,248,5,"DRAGANESTI-VLASCA",,5,,180,68
35,"Teleorman",341,"341-DRAGANESTI-VLASCA",152902,163,2,687,510,425,85,496,14,"DRAGANESTI-VLASCA",,5,,372,124
35,"Teleorman",341,"341-FURCULESTI",152948,164,2,1556,1175,936,239,1162,13,"FURCULESTI",,5,,875,287
35,"Teleorman",341,"341-FURCULESTI",152948,165,2,1085,943,755,188,939,4,"FURCULESTI",,5,,708,231
35,"Teleorman",341,"341-FURCULESTI",152948,166,2,713,633,523,110,628,5,"FURCULESTI",,5,,429,199
35,"Teleorman",341,"341-FRUMOASA",152993,167,2,1724,1187,1093,94,1182,5,"FRUMOASA",,5,,871,311
35,"Teleorman",341,"341-FRUMOASA",152993,168,2,589,449,390,59,444,5,"FRUMOASA",,5,,306,138
35,"Teleorman",341,"341-GALATENI",153026,169,2,1547,952,820,132,941,11,"GALATENI",,5,,456,485
35,"Teleorman",341,"341-GALATENI",153026,170,2,1249,718,573,145,706,12,"GALATENI",,5,,500,206
35,"Teleorman",341,"341-GRATIA",153062,171,2,1074,752,590,162,746,6,"GRATIA",,5,,530,216
35,"Teleorman",341,"341-GRATIA",153062,172,2,1394,788,634,154,779,9,"GRATIA",,5,,487,292
35,"Teleorman",341,"341-ISLAZ",151736,173,2,1794,1124,1012,112,1110,14,"ISLAZ",,5,,740,370
35,"Teleorman",341,"341-ISLAZ",151736,174,2,1563,1012,898,114,997,15,"ISLAZ",,5,,661,336
35,"Teleorman",341,"341-ISLAZ",151736,175,2,1028,655,523,132,652,3,"ISLAZ",,5,,443,209
35,"Teleorman",341,"341-ISLAZ",151736,176,2,1043,712,646,66,699,13,"ISLAZ",,5,,451,248
35,"Teleorman",341,"341-IZVOARELE",153106,177,2,1240,1146,1020,126,1139,7,"IZVOARELE",,5,,702,437
35,"Teleorman",341,"341-IZVOARELE",153106,178,2,1203,1145,1018,127,1139,6,"IZVOARELE",,5,,734,405
35,"Teleorman",341,"341-LISA",153124,179,2,1543,1047,948,99,1034,13,"LISA",,5,,754,280
35,"Teleorman",341,"341-LISA",153124,180,2,764,575,515,60,569,6,"LISA",,5,,340,229
35,"Teleorman",341,"341-LITA",151763,181,2,1575,961,792,169,952,9,"LITA",,5,,558,394
35,"Teleorman",341,"341-LITA",151763,182,2,1373,990,758,232,975,15,"LITA",,5,,611,364
35,"Teleorman",341,"341-LUNCA",153151,183,2,1420,839,557,282,833,6,"LUNCA",,5,,519,314
35,"Teleorman",341,"341-LUNCA",153151,184,2,763,549,249,300,538,11,"LUNCA",,5,,328,210
35,"Teleorman",341,"341-LUNCA",153151,185,2,685,527,386,141,508,19,"LUNCA",,5,,380,128
35,"Teleorman",341,"341-LUNCA",153151,186,2,975,623,405,218,613,10,"LUNCA",,5,,408,205
35,"Teleorman",341,"341-LUNCA",153151,187,2,885,618,298,320,609,9,"LUNCA",,5,,368,241
35,"Teleorman",341,"341-LUNCA",153151,188,2,809,564,306,258,564,0,"LUNCA",,5,,335,229
35,"Teleorman",341,"341-MAVRODIN",153204,189,2,1275,892,790,102,885,7,"MAVRODIN",,5,,725,160
35,"Teleorman",341,"341-MAVRODIN",153204,190,2,1020,901,774,127,769,5,"MAVRODIN",,5,,616,153
35,"Teleorman",341,"341-MAVRODIN",153204,191,2,1679,1227,1039,188,1210,17,"MAVRODIN",,5,,908,302
35,"Teleorman",341,"341-MAVRODIN",153204,192,2,555,385,303,82,380,5,"MAVRODIN",,5,,295,85
35,"Teleorman",341,"341-MAGURA",153240,193,2,1750,1199,1083,116,1181,18,"MAGURA",,5,,770,411
35,"Teleorman",341,"341-MAGURA",153240,194,2,949,665,577,88,661,4,"MAGURA",,5,,464,197
35,"Teleorman",341,"341-MALDAENI",153277,195,2,1247,819,777,42,812,7,"MALDAENI",,5,,531,281
35,"Teleorman",341,"341-MALDAENI",153277,196,2,1096,764,716,48,758,6,"MALDAENI",,5,,479,279
35,"Teleorman",341,"341-MALDAENI",153277,197,2,1473,1047,987,60,1036,11,"MALDAENI",,5,,641,395
35,"Teleorman",341,"341-MARZANESTI",153339,198,2,996,731,603,128,712,19,"MARZANESTI",,5,,458,254
35,"Teleorman",341,"341-MARZANESTI",153339,199,2,646,571,445,126,564,7,"MARZANESTI",,5,,400,164
35,"Teleorman",341,"341-MARZANESTI",153339,200,2,837,687,558,129,679,8,"MARZANESTI",,5,,428,251
35,"Teleorman",341,"341-MARZANESTI",153339,201,2,1149,1009,820,189,1003,6,"MARZANESTI",,5,,762,241
35,"Teleorman",341,"341-MERENI",153295,202,2,1567,1087,899,188,1068,19,"MERENI",,5,,666,402
35,"Teleorman",341,"341-MERENI",153295,203,2,1146,884,685,199,872,12,"MERENI",,5,,672,200
35,"Teleorman",341,"341-MOSTENI",152966,204,2,1488,911,830,81,901,10,"MOSTENI",,5,,551,350
35,"Teleorman",341,"341-NANOV",151816,205,2,1422,1034,960,74,1022,12,"NANOV",,5,,758,264
35,"Teleorman",341,"341-NANOV",151816,206,2,1342,975,931,44,960,15,"NANOV",,5,,713,247
35,"Teleorman",341,"341-NASTURELU",153400,207,2,1351,998,898,100,985,13,"NASTURELU",,5,,710,275
35,"Teleorman",341,"341-NASTURELU",153400,208,2,986,784,702,82,774,10,"NASTURELU",,5,,528,246
35,"Teleorman",341,"341-NECSESTI",153437,209,2,773,545,483,62,538,7,"NECSESTI",,5,,418,120
35,"Teleorman",341,"341-NECSESTI",153437,210,2,818,546,433,113,529,17,"NECSESTI",,5,,367,162
35,"Teleorman",341,"341-OLTENI",153473,211,2,1705,1254,1029,225,1242,12,"OLTENI",,5,,866,376
35,"Teleorman",341,"341-OLTENI",153473,212,2,899,688,522,166,679,9,"OLTENI",,5,,433,246
35,"Teleorman",341,"341-ORBEASCA",153507,213,2,926,823,566,257,818,5,"ORBEASCA",,5,,589,229
35,"Teleorman",341,"341-ORBEASCA",153507,214,2,1244,850,663,187,842,8,"ORBEASCA",,5,,620,222
35,"Teleorman",341,"341-ORBEASCA",153507,215,2,1320,802,664,138,796,6,"ORBEASCA",,5,,502,294
35,"Teleorman",341,"341-ORBEASCA",153507,216,2,1425,1008,728,280,994,14,"ORBEASCA",,5,,678,316
35,"Teleorman",341,"341-ORBEASCA",153507,217,2,1997,1494,1207,287,1480,14,"ORBEASCA",,5,,1222,258
35,"Teleorman",341,"341-PERETU",153543,218,2,1095,808,703,105,803,5,"PERETU",,5,,621,182
35,"Teleorman",341,"341-PERETU",153543,219,2,1400,963,836,127,953,10,"PERETU",,5,,640,313
35,"Teleorman",341,"341-PERETU",153543,220,2,1504,939,844,95,937,2,"PERETU",,5,,683,254
35,"Teleorman",341,"341-PERETU",153543,221,2,1309,960,850,110,953,7,"PERETU",,5,,709,244
35,"Teleorman",341,"341-PERETU",153543,222,2,1208,878,768,110,865,13,"PERETU",,5,,567,298
35,"Teleorman",341,"341-PIATRA",153561,223,2,1236,883,797,86,873,10,"PIATRA",,5,,622,251
35,"Teleorman",341,"341-PIATRA",153561,224,2,1105,800,709,91,795,5,"PIATRA",,5,,521,274
35,"Teleorman",341,"341-PIATRA",153561,225,2,1075,726,660,66,725,1,"PIATRA",,5,,521,204
35,"Teleorman",341,"341-PIETROSANI",153589,226,2,1377,955,784,171,942,13,"PIETROSANI",,5,,539,403
35,"Teleorman",341,"341-PIETROSANI",153589,227,2,1453,1048,902,146,1044,4,"PIETROSANI",,5,,585,459
35,"Teleorman",341,"341-PLOPII-SLAVITESTI",153623,228,2,785,564,461,103,560,4,"PLOPII-SLAVITESTI",,5,,363,197
35,"Teleorman",341,"341-PLOPII-SLAVITESTI",153623,229,2,997,667,518,149,663,4,"PLOPII-SLAVITESTI",,5,,521,142
35,"Teleorman",341,"341-PLOPII-SLAVITESTI",153623,230,2,748,562,453,109,559,3,"PLOPII-SLAVITESTI",,5,,374,185
35,"Teleorman",341,"341-PLOPII-SLAVITESTI",153623,231,2,1321,636,504,132,625,11,"PLOPII-SLAVITESTI",,5,,385,240
35,"Teleorman",341,"341-PLOPII-SLAVITESTI",153623,232,2,401,326,185,141,322,4,"PLOPII-SLAVITESTI",,5,,194,128
35,"Teleorman",341,"341-PLOSCA",153605,233,2,1382,992,641,351,984,8,"PLOSCA",,5,,757,227
35,"Teleorman",341,"341-PLOSCA",153605,234,2,1112,737,474,263,731,6,"PLOSCA",,5,,548,183
35,"Teleorman",341,"341-PLOSCA",153605,235,2,1276,900,716,184,894,6,"PLOSCA",,5,,591,303
35,"Teleorman",341,"341-PLOSCA",153605,236,2,1315,993,733,260,988,5,"PLOSCA",,5,,745,243
35,"Teleorman",341,"341-POENI",153696,237,2,1144,795,588,207,788,7,"POENI",,5,,568,220
35,"Teleorman",341,"341-POENI",153696,238,2,977,611,518,93,605,6,"POENI",,5,,364,241
35,"Teleorman",341,"341-POENI",153696,239,2,441,352,278,74,346,6,"POENI",,5,,262,84
35,"Teleorman",341,"341-POROSCHIA",151834,240,2,1431,1042,930,112,1032,10,"POROSCHIA",,5,,747,285
35,"Teleorman",341,"341-POROSCHIA",151834,241,2,1324,1084,969,115,1077,7,"POROSCHIA",,5,,714,363
35,"Teleorman",341,"341-POROSCHIA",151834,242,2,919,862,708,154,848,14,"POROSCHIA",,5,,564,284
35,"Teleorman",341,"341-PUTINEIU",153829,243,2,2549,1191,1005,186,1175,16,"PUTINEIU",,5,,798,377
35,"Teleorman",341,"341-PUTINEIU",153829,244,2,927,783,601,182,774,9,"PUTINEIU",,5,,572,202
35,"Teleorman",341,"341-RADOIESTI",153865,245,2,1248,847,749,98,835,12,"RADOIESTI",,5,,654,181
35,"Teleorman",341,"341-RADOIESTI",153865,246,2,1052,731,635,96,717,14,"RADOIESTI",,5,,474,243
35,"Teleorman",341,"341-RASMIRESTI",153909,247,2,992,684,537,147,671,13,"RASMIRESTI",,5,,456,215
35,"Teleorman",341,"341-SALCIA",153936,248,2,1123,734,607,127,726,8,"SALCIA",,5,,450,276
35,"Teleorman",341,"341-SALCIA",153936,249,2,931,686,525,161,673,13,"SALCIA",,5,,490,183
35,"Teleorman",341,"341-SALCIA",153936,250,2,972,773,599,174,764,9,"SALCIA",,5,,547,217
35,"Teleorman",341,"341-SACENI",153972,251,2,837,642,585,57,638,4,"SACENI",,5,,459,179
35,"Teleorman",341,"341-SACENI",153972,252,2,750,522,453,69,514,8,"SACENI",,5,,362,152
35,"Teleorman",341,"341-SARBENI",154308,253,2,727,444,376,68,438,6,"SARBENI",,5,,306,132
35,"Teleorman",341,"341-SARBENI",154308,254,2,888,539,483,56,536,3,"SARBENI",,5,,412,124
35,"Teleorman",341,"341-SCRIOASTEA",154013,255,2,2049,1577,1404,173,1569,8,"SCRIOASTEA",,5,,1023,546
35,"Teleorman",341,"341-SCRIOASTEA",154013,256,2,711,567,473,94,563,4,"SCRIOASTEA",,5,,423,140
35,"Teleorman",341,"341-SCRIOASTEA",154013,257,2,760,626,506,120,620,6,"SCRIOASTEA",,5,,463,157
35,"Teleorman",341,"341-SCURTU MARE",154068,258,2,1240,1219,1110,109,1215,4,"SCURTU MARE",,5,,1037,178
35,"Teleorman",341,"341-SCURTU MARE",154068,259,2,420,362,318,44,359,3,"SCURTU MARE",,5,,247,112
35,"Teleorman",341,"341-SCURTU MARE",154068,260,2,314,350,290,60,346,4,"SCURTU MARE",,5,,286,60
35,"Teleorman",341,"341-SEACA",154139,261,2,1469,968,868,100,956,12,"SEACA",,5,,670,286
35,"Teleorman",341,"341-SEACA",154139,262,2,986,698,601,97,692,6,"SEACA",,5,,503,189
35,"Teleorman",341,"341-SEGARCEA-VALE",154184,263,2,1239,754,641,113,751,3,"SEGARCEA-VALE",,5,,504,247
35,"Teleorman",341,"341-SEGARCEA-VALE",154184,264,2,1008,692,573,119,685,7,"SEGARCEA-VALE",,5,,469,216
35,"Teleorman",341,"341-SEGARCEA-VALE",154184,265,2,1380,819,707,112,804,15,"SEGARCEA-VALE",,5,,353,451
35,"Teleorman",341,"341-SFINTESTI",154166,266,2,1343,884,789,95,880,4,"SFINTESTI",,5,,636,244
35,"Teleorman",341,"341-SILISTEA",153801,267,2,1534,995,882,113,990,5,"SILISTEA",,5,,731,259
35,"Teleorman",341,"341-SILISTEA",153801,268,2,1347,946,832,114,937,9,"SILISTEA",,5,,567,370
35,"Teleorman",341,"341-SILISTEA",153801,269,2,727,654,576,78,653,1,"SILISTEA",,5,,524,129
35,"Teleorman",341,"341-SILISTEA GUMESTI",154282,270,2,1491,1046,892,154,1031,15,"SILISTEA GUMESTI",,5,,701,330
35,"Teleorman",341,"341-SILISTEA GUMESTI",154282,271,2,1117,837,767,70,828,9,"SILISTEA GUMESTI",,5,,634,194
35,"Teleorman",341,"341-SILISTEA GUMESTI",154282,272,2,0,107,0,107,105,2,"SILISTEA GUMESTI",,5,,55,50
35,"Teleorman",341,"341-SLOBOZIA MANDRA",154344,273,2,1087,806,613,193,795,11,"SLOBOZIA MANDRA",,5,,671,124
35,"Teleorman",341,"341-SLOBOZIA MANDRA",154344,274,2,1097,866,683,183,862,4,"SLOBOZIA MANDRA",,5,,708,154
35,"Teleorman",341,"341-SLOBOZIA MANDRA",154344,275,2,949,658,587,71,651,7,"SLOBOZIA MANDRA",,5,,444,207
35,"Teleorman",341,"341-SLOBOZIA MANDRA",154344,276,2,1035,623,536,87,618,5,"SLOBOZIA MANDRA",,5,,355,263
35,"Teleorman",341,"341-SMARDIOASA",154380,277,2,1573,1311,1080,231,1296,15,"SMARDIOASA",,5,,841,455
35,"Teleorman",341,"341-SMARDIOASA",154380,278,2,490,450,370,80,432,18,"SMARDIOASA",,5,,287,145
35,"Teleorman",341,"341-STEJARU",152653,279,2,953,677,590,87,675,2,"STEJARU",,5,,542,133
35,"Teleorman",341,"341-STEJARU",152653,280,2,909,674,582,92,667,7,"STEJARU",,5,,515,152
35,"Teleorman",341,"341-STEJARU",152653,281,2,191,174,140,34,173,1,"STEJARU",,5,,128,45
35,"Teleorman",341,"341-SUHAIA",154460,282,2,1345,943,820,123,937,6,"SUHAIA",,5,,716,221
35,"Teleorman",341,"341-SUHAIA",154460,283,2,1381,929,839,90,914,15,"SUHAIA",,5,,696,218
35,"Teleorman",341,"341-SUHAIA",154460,284,2,1799,1200,1081,119,1196,4,"SUHAIA",,5,,952,244
35,"Teleorman",341,"341-STOROBANEASA",154497,285,2,1691,1310,1211,99,1291,19,"STOROBANEASA",,5,,986,305
35,"Teleorman",341,"341-STOROBANEASA",154497,286,2,1615,1257,1173,84,1239,18,"STOROBANEASA",,5,,927,312
35,"Teleorman",341,"341-TALPA",154521,287,2,1116,900,729,171,890,10,"TALPA",,5,,612,278
35,"Teleorman",341,"341-TALPA",154521,288,2,988,708,615,93,696,12,"TALPA",,5,,562,134
35,"Teleorman",341,"341-TATARASTII DE JOS",154585,289,2,1769,1268,1110,158,1240,28,"TATARASTII DE JOS",,5,,908,332
35,"Teleorman",341,"341-TATARASTII DE JOS",154585,290,2,968,699,676,23,688,11,"TATARASTII DE JOS",,5,,472,216
35,"Teleorman",341,"341-TATARASTII DE JOS",154585,291,2,1140,895,777,118,872,23,"TATARASTII DE JOS",,5,,633,239
35,"Teleorman",341,"341-TATARASTII DE SUS",154665,292,2,1299,940,778,162,931,9,"TATARASTII DE SUS",,5,,720,211
35,"Teleorman",341,"341-TATARASTII DE SUS",154665,293,2,1435,1017,830,187,1007,10,"TATARASTII DE SUS",,5,,791,216
35,"Teleorman",341,"341-TRAIAN",154736,294,2,953,749,653,96,738,11,"TRAIAN",,5,,393,345
35,"Teleorman",341,"341-TRAIAN",154736,295,2,1073,852,742,110,843,9,"TRAIAN",,5,,453,390
35,"Teleorman",341,"341-TRIVALEA-MOSTENI",154754,296,2,995,518,420,98,514,4,"TRIVALEA-MOSTENI",,5,,301,213
35,"Teleorman",341,"341-TRIVALEA-MOSTENI",154754,297,2,719,458,357,101,456,2,"TRIVALEA-MOSTENI",,5,,354,102
35,"Teleorman",341,"341-TRIVALEA-MOSTENI",154754,298,2,1182,783,600,183,775,8,"TRIVALEA-MOSTENI",,5,,549,226
35,"Teleorman",341,"341-TROIANUL",154790,299,2,1869,1408,1150,258,1393,15,"TROIANUL",,5,,1039,354
35,"Teleorman",341,"341-TROIANUL",154790,300,2,1184,953,812,141,942,11,"TROIANUL",,5,,756,186
35,"Teleorman",341,"341-TROIANUL",154790,301,2,258,258,207,51,258,0,"TROIANUL",,5,,214,44
35,"Teleorman",341,"341-TIGANESTI",154834,302,2,1664,1188,1038,150,1181,7,"TIGANESTI",,5,,887,294
35,"Teleorman",341,"341-TIGANESTI",154834,303,2,1511,1088,916,172,1085,3,"TIGANESTI",,5,,793,292
35,"Teleorman",341,"341-TIGANESTI",154834,304,2,1553,1573,1288,285,1566,7,"TIGANESTI",,5,,1038,528
35,"Teleorman",341,"341-VARTOAPE",154932,305,2,1283,839,699,140,824,15,"VARTOAPE",,5,,568,256
35,"Teleorman",341,"341-VARTOAPE",154932,306,2,1004,716,596,120,707,9,"VARTOAPE",,5,,475,232
35,"Teleorman",341,"341-VARTOAPE",154932,307,2,783,502,419,83,486,16,"VARTOAPE",,5,,359,127
35,"Teleorman",341,"341-VEDEA",154852,308,2,1023,756,681,75,748,8,"VEDEA",,5,,557,191
35,"Teleorman",341,"341-VEDEA",154852,309,2,1238,1008,918,90,1000,8,"VEDEA",,5,,782,218
35,"Teleorman",341,"341-VEDEA",154852,310,2,432,396,303,93,391,5,"VEDEA",,5,,206,185
35,"Teleorman",341,"341-VIISOARA",154914,311,2,1087,801,702,99,785,16,"VIISOARA",,5,,508,277
35,"Teleorman",341,"341-VIISOARA",154914,312,2,890,719,640,79,708,11,"VIISOARA",,5,,439,269
35,"Teleorman",341,"341-VITANESTI",153776,313,2,659,557,459,98,549,8,"VITANESTI",,5,,366,183
35,"Teleorman",341,"341-VITANESTI",153776,314,2,1087,843,698,145,835,8,"VITANESTI",,5,,582,253
35,"Teleorman",341,"341-VITANESTI",153776,315,2,934,754,631,123,748,6,"VITANESTI",,5,,577,171
35,"Teleorman",341,"341-ZAMBREASCA",154978,316,2,1187,961,845,116,948,13,"ZAMBREASCA",,5,,665,283
35,"Teleorman",341,"341-ZAMBREASCA",154978,317,2,595,399,364,35,397,2,"ZAMBREASCA",,5,,325,72
36,"Timiș",350,"350-MUNICIPIUL TIMISOARA",155243,1,2,1452,1435,1059,376,1433,2,"MUNICIPIUL TIMISOARA",,1,,487,946
36,"Timiș",350,"350-MUNICIPIUL TIMISOARA",155243,2,2,1422,1218,956,262,1217,1,"MUNICIPIUL TIMISOARA",,1,,420,797
36,"Timiș",350,"350-MUNICIPIUL TIMISOARA",155243,3,2,1162,896,815,81,892,4,"MUNICIPIUL TIMISOARA",,1,,227,665
36,"Timiș",350,"350-MUNICIPIUL TIMISOARA",155243,4,2,1178,951,845,106,945,6,"MUNICIPIUL TIMISOARA",,1,,418,527
36,"Timiș",350,"350-MUNICIPIUL TIMISOARA",155243,5,2,1230,1075,856,219,1071,4,"MUNICIPIUL TIMISOARA",,1,,393,678
36,"Timiș",350,"350-MUNICIPIUL TIMISOARA",155243,6,2,908,670,562,108,670,0,"MUNICIPIUL TIMISOARA",,1,,173,497
36,"Timiș",350,"350-MUNICIPIUL TIMISOARA",155243,7,2,1313,878,808,70,872,6,"MUNICIPIUL TIMISOARA",,1,,218,654
36,"Timiș",350,"350-MUNICIPIUL TIMISOARA",155243,8,2,170,130,112,18,129,1,"MUNICIPIUL TIMISOARA",,1,,18,111
36,"Timiș",350,"350-MUNICIPIUL TIMISOARA",155243,9,2,1042,851,669,182,848,3,"MUNICIPIUL TIMISOARA",,1,,264,584
36,"Timiș",350,"350-MUNICIPIUL TIMISOARA",155243,10,2,1210,982,768,214,981,1,"MUNICIPIUL TIMISOARA",,1,,267,714
36,"Timiș",350,"350-MUNICIPIUL TIMISOARA",155243,11,2,1359,1157,968,189,1154,3,"MUNICIPIUL TIMISOARA",,1,,397,757
36,"Timiș",350,"350-MUNICIPIUL TIMISOARA",155243,12,2,1027,986,708,278,984,2,"MUNICIPIUL TIMISOARA",,1,,382,602
36,"Timiș",350,"350-MUNICIPIUL TIMISOARA",155243,13,2,874,732,647,85,729,3,"MUNICIPIUL TIMISOARA",,1,,221,508
36,"Timiș",350,"350-MUNICIPIUL TIMISOARA",155243,14,2,1455,1494,1027,467,1492,2,"MUNICIPIUL TIMISOARA",,1,,468,1024
36,"Timiș",350,"350-MUNICIPIUL TIMISOARA",155243,15,2,570,472,414,58,470,2,"MUNICIPIUL TIMISOARA",,1,,167,303
36,"Timiș",350,"350-MUNICIPIUL TIMISOARA",155243,16,2,1113,891,826,65,879,12,"MUNICIPIUL TIMISOARA",,1,,324,555
36,"Timiș",350,"350-MUNICIPIUL TIMISOARA",155243,17,2,1167,906,777,129,899,7,"MUNICIPIUL TIMISOARA",,1,,273,626
36,"Timiș",350,"350-MUNICIPIUL TIMISOARA",155243,18,2,1107,860,741,119,856,4,"MUNICIPIUL TIMISOARA",,1,,187,669
36,"Timiș",350,"350-MUNICIPIUL TIMISOARA",155243,19,2,977,695,589,106,692,3,"MUNICIPIUL TIMISOARA",,1,,104,588
36,"Timiș",350,"350-MUNICIPIUL TIMISOARA",155243,20,2,1421,1089,893,196,1085,4,"MUNICIPIUL TIMISOARA",,1,,179,906
36,"Timiș",350,"350-MUNICIPIUL TIMISOARA",155243,21,2,1313,1021,868,153,1020,1,"MUNICIPIUL TIMISOARA",,1,,193,827
36,"Timiș",350,"350-MUNICIPIUL TIMISOARA",155243,22,2,1510,1160,976,184,1158,2,"MUNICIPIUL TIMISOARA",,1,,286,872
36,"Timiș",350,"350-MUNICIPIUL TIMISOARA",155243,23,2,1745,1268,1127,141,1263,5,"MUNICIPIUL TIMISOARA",,1,,282,981
36,"Timiș",350,"350-MUNICIPIUL TIMISOARA",155243,24,2,1107,846,764,82,843,3,"MUNICIPIUL TIMISOARA",,1,,159,684
36,"Timiș",350,"350-MUNICIPIUL TIMISOARA",155243,25,2,869,542,513,29,540,2,"MUNICIPIUL TIMISOARA",,1,,101,439
36,"Timiș",350,"350-MUNICIPIUL TIMISOARA",155243,26,2,1797,1429,1093,336,1426,3,"MUNICIPIUL TIMISOARA",,1,,277,1149
36,"Timiș",350,"350-MUNICIPIUL TIMISOARA",155243,27,2,534,732,699,33,726,6,"MUNICIPIUL TIMISOARA",,1,,120,606
36,"Timiș",350,"350-MUNICIPIUL TIMISOARA",155243,28,2,1275,932,707,225,927,5,"MUNICIPIUL TIMISOARA",,1,,213,714
36,"Timiș",350,"350-MUNICIPIUL TIMISOARA",155243,29,2,1972,1326,973,353,1324,2,"MUNICIPIUL TIMISOARA",,1,,247,1077
36,"Timiș",350,"350-MUNICIPIUL TIMISOARA",155243,30,2,625,976,229,747,975,1,"MUNICIPIUL TIMISOARA",,1,,160,815
36,"Timiș",350,"350-MUNICIPIUL TIMISOARA",155243,31,2,1015,784,203,581,784,0,"MUNICIPIUL TIMISOARA",,1,,150,634
36,"Timiș",350,"350-MUNICIPIUL TIMISOARA",155243,32,2,2010,1429,1000,429,1418,11,"MUNICIPIUL TIMISOARA",,1,,290,1128
36,"Timiș",350,"350-MUNICIPIUL TIMISOARA",155243,33,2,1643,1453,784,669,1444,9,"MUNICIPIUL TIMISOARA",,1,,353,1091
36,"Timiș",350,"350-MUNICIPIUL TIMISOARA",155243,34,2,1437,1116,940,176,1116,0,"MUNICIPIUL TIMISOARA",,1,,238,878
36,"Timiș",350,"350-MUNICIPIUL TIMISOARA",155243,35,2,980,845,546,299,843,2,"MUNICIPIUL TIMISOARA",,1,,158,685
36,"Timiș",350,"350-MUNICIPIUL TIMISOARA",155243,36,2,985,770,610,160,767,3,"MUNICIPIUL TIMISOARA",,1,,143,624
36,"Timiș",350,"350-MUNICIPIUL TIMISOARA",155243,37,2,654,472,343,129,468,4,"MUNICIPIUL TIMISOARA",,1,,92,376
36,"Timiș",350,"350-MUNICIPIUL TIMISOARA",155243,38,2,1240,914,658,256,909,5,"MUNICIPIUL TIMISOARA",,1,,181,728
36,"Timiș",350,"350-MUNICIPIUL TIMISOARA",155243,39,2,1284,956,860,96,950,6,"MUNICIPIUL TIMISOARA",,1,,194,756
36,"Timiș",350,"350-MUNICIPIUL TIMISOARA",155243,40,2,1515,1275,1058,217,1275,0,"MUNICIPIUL TIMISOARA",,1,,238,1037
36,"Timiș",350,"350-MUNICIPIUL TIMISOARA",155243,41,2,1172,845,755,90,828,17,"MUNICIPIUL TIMISOARA",,1,,172,656
36,"Timiș",350,"350-MUNICIPIUL TIMISOARA",155243,42,2,979,671,600,71,667,4,"MUNICIPIUL TIMISOARA",,1,,110,557
36,"Timiș",350,"350-MUNICIPIUL TIMISOARA",155243,43,2,1861,1509,1303,206,1502,7,"MUNICIPIUL TIMISOARA",,1,,366,1136
36,"Timiș",350,"350-MUNICIPIUL TIMISOARA",155243,44,2,1197,269,96,173,268,1,"MUNICIPIUL TIMISOARA",,1,,64,204
36,"Timiș",350,"350-MUNICIPIUL TIMISOARA",155243,45,2,1536,1168,1052,116,1166,2,"MUNICIPIUL TIMISOARA",,1,,295,871
36,"Timiș",350,"350-MUNICIPIUL TIMISOARA",155243,46,2,791,709,606,103,708,1,"MUNICIPIUL TIMISOARA",,1,,167,541
36,"Timiș",350,"350-MUNICIPIUL TIMISOARA",155243,47,2,2531,1776,1759,17,1770,6,"MUNICIPIUL TIMISOARA",,1,,398,1372
36,"Timiș",350,"350-MUNICIPIUL TIMISOARA",155243,48,2,1294,1021,907,114,1018,3,"MUNICIPIUL TIMISOARA",,1,,242,776
36,"Timiș",350,"350-MUNICIPIUL TIMISOARA",155243,49,2,1295,1014,912,102,1012,2,"MUNICIPIUL TIMISOARA",,1,,222,790
36,"Timiș",350,"350-MUNICIPIUL TIMISOARA",155243,50,2,1133,914,814,100,912,2,"MUNICIPIUL TIMISOARA",,1,,188,724
36,"Timiș",350,"350-MUNICIPIUL TIMISOARA",155243,51,2,1277,856,719,137,852,4,"MUNICIPIUL TIMISOARA",,1,,200,652
36,"Timiș",350,"350-MUNICIPIUL TIMISOARA",155243,52,2,1170,986,719,267,986,0,"MUNICIPIUL TIMISOARA",,1,,190,796
36,"Timiș",350,"350-MUNICIPIUL TIMISOARA",155243,53,2,1554,1195,1102,93,1193,2,"MUNICIPIUL TIMISOARA",,1,,335,858
36,"Timiș",350,"350-MUNICIPIUL TIMISOARA",155243,54,2,1692,1243,1195,48,1238,5,"MUNICIPIUL TIMISOARA",,1,,340,898
36,"Timiș",350,"350-MUNICIPIUL TIMISOARA",155243,55,2,886,721,610,111,720,1,"MUNICIPIUL TIMISOARA",,1,,243,477
36,"Timiș",350,"350-MUNICIPIUL TIMISOARA",155243,56,2,1059,832,740,92,831,1,"MUNICIPIUL TIMISOARA",,1,,209,622
36,"Timiș",350,"350-MUNICIPIUL TIMISOARA",155243,57,2,1217,862,761,101,860,2,"MUNICIPIUL TIMISOARA",,1,,205,655
36,"Timiș",350,"350-MUNICIPIUL TIMISOARA",155243,58,2,802,637,545,92,636,1,"MUNICIPIUL TIMISOARA",,1,,141,495
36,"Timiș",350,"350-MUNICIPIUL TIMISOARA",155243,59,2,1543,969,848,121,965,4,"MUNICIPIUL TIMISOARA",,1,,188,777
36,"Timiș",350,"350-MUNICIPIUL TIMISOARA",155243,60,2,1663,1013,959,54,1013,0,"MUNICIPIUL TIMISOARA",,1,,209,804
36,"Timiș",350,"350-MUNICIPIUL TIMISOARA",155243,61,2,1135,713,690,23,711,2,"MUNICIPIUL TIMISOARA",,1,,194,517
36,"Timiș",350,"350-MUNICIPIUL TIMISOARA",155243,62,2,1710,1287,1111,176,1286,1,"MUNICIPIUL TIMISOARA",,1,,408,878
36,"Timiș",350,"350-MUNICIPIUL TIMISOARA",155243,63,2,1172,872,819,53,867,5,"MUNICIPIUL TIMISOARA",,1,,228,639
36,"Timiș",350,"350-MUNICIPIUL TIMISOARA",155243,64,2,1101,880,823,57,879,1,"MUNICIPIUL TIMISOARA",,1,,248,631
36,"Timiș",350,"350-MUNICIPIUL TIMISOARA",155243,65,2,1534,1180,1047,133,1178,2,"MUNICIPIUL TIMISOARA",,1,,279,899
36,"Timiș",350,"350-MUNICIPIUL TIMISOARA",155243,66,2,1395,1102,992,110,1090,12,"MUNICIPIUL TIMISOARA",,1,,358,732
36,"Timiș",350,"350-MUNICIPIUL TIMISOARA",155243,67,2,1419,1153,1010,143,1149,4,"MUNICIPIUL TIMISOARA",,1,,344,805
36,"Timiș",350,"350-MUNICIPIUL TIMISOARA",155243,68,2,1026,813,751,62,811,2,"MUNICIPIUL TIMISOARA",,1,,264,547
36,"Timiș",350,"350-MUNICIPIUL TIMISOARA",155243,69,2,1350,950,886,64,945,5,"MUNICIPIUL TIMISOARA",,1,,261,684
36,"Timiș",350,"350-MUNICIPIUL TIMISOARA",155243,70,2,800,695,606,89,692,3,"MUNICIPIUL TIMISOARA",,1,,186,506
36,"Timiș",350,"350-MUNICIPIUL TIMISOARA",155243,71,2,1313,1026,901,125,1023,3,"MUNICIPIUL TIMISOARA",,1,,268,755
36,"Timiș",350,"350-MUNICIPIUL TIMISOARA",155243,72,2,1083,752,722,30,749,3,"MUNICIPIUL TIMISOARA",,1,,180,569
36,"Timiș",350,"350-MUNICIPIUL TIMISOARA",155243,73,2,1376,1070,938,132,1064,6,"MUNICIPIUL TIMISOARA",,1,,253,811
36,"Timiș",350,"350-MUNICIPIUL TIMISOARA",155243,74,2,1756,1362,1101,261,1356,6,"MUNICIPIUL TIMISOARA",,1,,277,1079
36,"Timiș",350,"350-MUNICIPIUL TIMISOARA",155243,75,2,2290,1213,1038,175,1208,5,"MUNICIPIUL TIMISOARA",,1,,283,925
36,"Timiș",350,"350-MUNICIPIUL TIMISOARA",155243,76,2,1369,997,902,95,991,6,"MUNICIPIUL TIMISOARA",,1,,282,709
36,"Timiș",350,"350-MUNICIPIUL TIMISOARA",155243,77,2,1242,892,823,69,885,7,"MUNICIPIUL TIMISOARA",,1,,196,689
36,"Timiș",350,"350-MUNICIPIUL TIMISOARA",155243,78,2,1169,886,798,88,884,2,"MUNICIPIUL TIMISOARA",,1,,221,663
36,"Timiș",350,"350-MUNICIPIUL TIMISOARA",155243,79,2,1028,787,696,91,787,0,"MUNICIPIUL TIMISOARA",,1,,206,581
36,"Timiș",350,"350-MUNICIPIUL TIMISOARA",155243,80,2,1017,749,647,102,744,5,"MUNICIPIUL TIMISOARA",,1,,205,539
36,"Timiș",350,"350-MUNICIPIUL TIMISOARA",155243,81,2,1458,1135,1058,77,1130,5,"MUNICIPIUL TIMISOARA",,1,,289,841
36,"Timiș",350,"350-MUNICIPIUL TIMISOARA",155243,82,2,988,848,634,214,845,3,"MUNICIPIUL TIMISOARA",,1,,153,692
36,"Timiș",350,"350-MUNICIPIUL TIMISOARA",155243,83,2,1208,701,641,60,695,6,"MUNICIPIUL TIMISOARA",,1,,147,548
36,"Timiș",350,"350-MUNICIPIUL TIMISOARA",155243,84,2,1071,645,525,120,642,3,"MUNICIPIUL TIMISOARA",,1,,106,536
36,"Timiș",350,"350-MUNICIPIUL TIMISOARA",155243,85,2,1422,1208,988,220,1200,8,"MUNICIPIUL TIMISOARA",,1,,179,1021
36,"Timiș",350,"350-MUNICIPIUL TIMISOARA",155243,86,2,2646,994,803,191,990,4,"MUNICIPIUL TIMISOARA",,1,,172,818
36,"Timiș",350,"350-MUNICIPIUL TIMISOARA",155243,87,2,1149,978,838,140,973,5,"MUNICIPIUL TIMISOARA",,1,,198,775
36,"Timiș",350,"350-MUNICIPIUL TIMISOARA",155243,88,2,1373,1142,945,197,1140,2,"MUNICIPIUL TIMISOARA",,1,,246,894
36,"Timiș",350,"350-MUNICIPIUL TIMISOARA",155243,89,2,934,733,648,85,728,5,"MUNICIPIUL TIMISOARA",,1,,144,584
36,"Timiș",350,"350-MUNICIPIUL TIMISOARA",155243,90,2,1102,777,710,67,776,1,"MUNICIPIUL TIMISOARA",,1,,178,598
36,"Timiș",350,"350-MUNICIPIUL TIMISOARA",155243,91,2,830,652,592,60,649,3,"MUNICIPIUL TIMISOARA",,1,,138,511
36,"Timiș",350,"350-MUNICIPIUL TIMISOARA",155243,92,2,2235,1574,1374,200,1567,7,"MUNICIPIUL TIMISOARA",,1,,285,1282
36,"Timiș",350,"350-MUNICIPIUL TIMISOARA",155243,93,2,1211,972,848,124,969,3,"MUNICIPIUL TIMISOARA",,1,,312,657
36,"Timiș",350,"350-MUNICIPIUL TIMISOARA",155243,94,2,780,609,493,116,606,3,"MUNICIPIUL TIMISOARA",,1,,126,480
36,"Timiș",350,"350-MUNICIPIUL TIMISOARA",155243,95,2,1594,1166,1047,119,1161,5,"MUNICIPIUL TIMISOARA",,1,,332,829
36,"Timiș",350,"350-MUNICIPIUL TIMISOARA",155243,96,2,1213,777,704,73,771,6,"MUNICIPIUL TIMISOARA",,1,,193,578
36,"Timiș",350,"350-MUNICIPIUL TIMISOARA",155243,97,2,1124,906,707,199,902,4,"MUNICIPIUL TIMISOARA",,1,,280,622
36,"Timiș",350,"350-MUNICIPIUL TIMISOARA",155243,98,2,1159,847,719,128,844,3,"MUNICIPIUL TIMISOARA",,1,,168,676
36,"Timiș",350,"350-MUNICIPIUL TIMISOARA",155243,99,2,1055,885,706,179,883,2,"MUNICIPIUL TIMISOARA",,1,,252,631
36,"Timiș",350,"350-MUNICIPIUL TIMISOARA",155243,100,2,1187,855,763,92,852,3,"MUNICIPIUL TIMISOARA",,1,,230,622
36,"Timiș",350,"350-MUNICIPIUL TIMISOARA",155243,101,2,1622,1031,907,124,1024,7,"MUNICIPIUL TIMISOARA",,1,,207,817
36,"Timiș",350,"350-MUNICIPIUL TIMISOARA",155243,102,2,831,558,458,100,556,2,"MUNICIPIUL TIMISOARA",,1,,116,440
36,"Timiș",350,"350-MUNICIPIUL TIMISOARA",155243,103,2,1743,1319,1222,97,1316,3,"MUNICIPIUL TIMISOARA",,1,,344,972
36,"Timiș",350,"350-MUNICIPIUL TIMISOARA",155243,104,2,1074,806,739,67,804,2,"MUNICIPIUL TIMISOARA",,1,,291,513
36,"Timiș",350,"350-MUNICIPIUL TIMISOARA",155243,105,2,1267,950,827,123,946,4,"MUNICIPIUL TIMISOARA",,1,,316,630
36,"Timiș",350,"350-MUNICIPIUL TIMISOARA",155243,106,2,1346,996,862,134,994,2,"MUNICIPIUL TIMISOARA",,1,,239,755
36,"Timiș",350,"350-MUNICIPIUL TIMISOARA",155243,107,2,1248,870,764,106,870,0,"MUNICIPIUL TIMISOARA",,1,,208,662
36,"Timiș",350,"350-MUNICIPIUL TIMISOARA",155243,108,2,1463,1083,1010,73,1079,4,"MUNICIPIUL TIMISOARA",,1,,286,793
36,"Timiș",350,"350-MUNICIPIUL TIMISOARA",155243,109,2,1113,855,781,74,850,5,"MUNICIPIUL TIMISOARA",,1,,295,555
36,"Timiș",350,"350-MUNICIPIUL TIMISOARA",155243,110,2,1160,749,707,42,747,2,"MUNICIPIUL TIMISOARA",,1,,188,559
36,"Timiș",350,"350-MUNICIPIUL TIMISOARA",155243,111,2,680,511,436,75,509,2,"MUNICIPIUL TIMISOARA",,1,,115,394
36,"Timiș",350,"350-MUNICIPIUL TIMISOARA",155243,112,2,1136,991,813,178,989,2,"MUNICIPIUL TIMISOARA",,1,,232,757
36,"Timiș",350,"350-MUNICIPIUL TIMISOARA",155243,113,2,809,679,566,113,677,2,"MUNICIPIUL TIMISOARA",,1,,205,472
36,"Timiș",350,"350-MUNICIPIUL TIMISOARA",155243,114,2,1405,991,900,91,983,8,"MUNICIPIUL TIMISOARA",,1,,145,838
36,"Timiș",350,"350-MUNICIPIUL TIMISOARA",155243,115,2,1329,1051,984,67,1048,3,"MUNICIPIUL TIMISOARA",,1,,171,877
36,"Timiș",350,"350-MUNICIPIUL TIMISOARA",155243,116,2,1283,963,921,42,959,4,"MUNICIPIUL TIMISOARA",,1,,207,752
36,"Timiș",350,"350-MUNICIPIUL TIMISOARA",155243,117,2,1075,680,620,60,678,2,"MUNICIPIUL TIMISOARA",,1,,139,539
36,"Timiș",350,"350-MUNICIPIUL TIMISOARA",155243,118,2,1299,636,540,96,634,2,"MUNICIPIUL TIMISOARA",,1,,150,484
36,"Timiș",350,"350-MUNICIPIUL TIMISOARA",155243,119,2,1245,911,865,46,909,2,"MUNICIPIUL TIMISOARA",,1,,202,707
36,"Timiș",350,"350-MUNICIPIUL TIMISOARA",155243,120,2,1128,922,698,224,918,4,"MUNICIPIUL TIMISOARA",,1,,154,764
36,"Timiș",350,"350-MUNICIPIUL TIMISOARA",155243,121,2,1079,1418,673,745,1413,5,"MUNICIPIUL TIMISOARA",,1,,246,1167
36,"Timiș",350,"350-MUNICIPIUL TIMISOARA",155243,122,2,1128,905,769,136,898,7,"MUNICIPIUL TIMISOARA",,1,,208,690
36,"Timiș",350,"350-MUNICIPIUL TIMISOARA",155243,123,2,995,741,635,106,737,4,"MUNICIPIUL TIMISOARA",,1,,192,545
36,"Timiș",350,"350-MUNICIPIUL TIMISOARA",155243,124,2,990,808,705,103,807,1,"MUNICIPIUL TIMISOARA",,1,,262,545
36,"Timiș",350,"350-MUNICIPIUL TIMISOARA",155243,125,2,1026,807,743,64,806,1,"MUNICIPIUL TIMISOARA",,1,,227,579
36,"Timiș",350,"350-MUNICIPIUL TIMISOARA",155243,126,2,1086,817,729,88,811,6,"MUNICIPIUL TIMISOARA",,1,,120,691
36,"Timiș",350,"350-MUNICIPIUL TIMISOARA",155243,127,2,1101,777,650,127,770,7,"MUNICIPIUL TIMISOARA",,1,,117,653
36,"Timiș",350,"350-MUNICIPIUL TIMISOARA",155243,128,2,1026,776,712,64,773,3,"MUNICIPIUL TIMISOARA",,1,,157,616
36,"Timiș",350,"350-MUNICIPIUL TIMISOARA",155243,129,2,1074,715,596,119,708,7,"MUNICIPIUL TIMISOARA",,1,,95,613
36,"Timiș",350,"350-MUNICIPIUL TIMISOARA",155243,130,2,1296,903,804,99,898,5,"MUNICIPIUL TIMISOARA",,1,,151,747
36,"Timiș",350,"350-MUNICIPIUL TIMISOARA",155243,131,2,1542,1123,964,159,1122,1,"MUNICIPIUL TIMISOARA",,1,,208,914
36,"Timiș",350,"350-MUNICIPIUL TIMISOARA",155243,132,2,793,608,551,57,608,0,"MUNICIPIUL TIMISOARA",,1,,153,455
36,"Timiș",350,"350-MUNICIPIUL TIMISOARA",155243,133,2,942,713,651,62,713,0,"MUNICIPIUL TIMISOARA",,1,,215,498
36,"Timiș",350,"350-MUNICIPIUL TIMISOARA",155243,134,2,983,765,643,122,761,4,"MUNICIPIUL TIMISOARA",,1,,111,650
36,"Timiș",350,"350-MUNICIPIUL TIMISOARA",155243,135,2,1071,889,724,165,883,6,"MUNICIPIUL TIMISOARA",,1,,219,664
36,"Timiș",350,"350-MUNICIPIUL TIMISOARA",155243,136,2,1142,847,784,63,844,3,"MUNICIPIUL TIMISOARA",,1,,157,687
36,"Timiș",350,"350-MUNICIPIUL TIMISOARA",155243,137,2,1787,1364,1194,170,1360,4,"MUNICIPIUL TIMISOARA",,1,,249,1111
36,"Timiș",350,"350-MUNICIPIUL TIMISOARA",155243,138,2,1229,987,901,86,983,4,"MUNICIPIUL TIMISOARA",,1,,191,792
36,"Timiș",350,"350-MUNICIPIUL TIMISOARA",155243,139,2,1235,889,838,51,886,3,"MUNICIPIUL TIMISOARA",,1,,207,679
36,"Timiș",350,"350-MUNICIPIUL TIMISOARA",155243,140,2,1118,779,720,59,777,2,"MUNICIPIUL TIMISOARA",,1,,151,626
36,"Timiș",350,"350-MUNICIPIUL TIMISOARA",155243,141,2,2276,1774,1532,242,1767,7,"MUNICIPIUL TIMISOARA",,1,,382,1385
36,"Timiș",350,"350-MUNICIPIUL TIMISOARA",155243,142,2,1229,1018,870,148,1013,5,"MUNICIPIUL TIMISOARA",,1,,206,807
36,"Timiș",350,"350-MUNICIPIUL TIMISOARA",155243,143,2,1202,1002,826,176,997,5,"MUNICIPIUL TIMISOARA",,1,,214,783
36,"Timiș",350,"350-MUNICIPIUL TIMISOARA",155243,144,2,1402,1076,912,164,1072,4,"MUNICIPIUL TIMISOARA",,1,,201,871
36,"Timiș",350,"350-MUNICIPIUL TIMISOARA",155243,145,2,1758,1324,1212,112,1322,2,"MUNICIPIUL TIMISOARA",,1,,219,1103
36,"Timiș",350,"350-MUNICIPIUL TIMISOARA",155243,146,2,1333,1050,942,108,1050,0,"MUNICIPIUL TIMISOARA",,1,,196,854
36,"Timiș",350,"350-MUNICIPIUL TIMISOARA",155243,147,2,1335,1041,913,128,1039,2,"MUNICIPIUL TIMISOARA",,1,,214,825
36,"Timiș",350,"350-MUNICIPIUL TIMISOARA",155243,148,2,1648,1237,1152,85,1230,7,"MUNICIPIUL TIMISOARA",,1,,262,968
36,"Timiș",350,"350-MUNICIPIUL TIMISOARA",155243,149,2,1371,975,905,70,972,3,"MUNICIPIUL TIMISOARA",,1,,200,772
36,"Timiș",350,"350-MUNICIPIUL TIMISOARA",155243,150,2,1590,1132,1012,120,1131,1,"MUNICIPIUL TIMISOARA",,1,,245,886
36,"Timiș",350,"350-MUNICIPIUL TIMISOARA",155243,151,2,498,459,305,154,458,1,"MUNICIPIUL TIMISOARA",,1,,90,368
36,"Timiș",350,"350-MUNICIPIUL TIMISOARA",155243,152,2,727,550,473,77,547,3,"MUNICIPIUL TIMISOARA",,1,,113,434
36,"Timiș",350,"350-MUNICIPIUL TIMISOARA",155243,153,2,1136,825,758,67,822,3,"MUNICIPIUL TIMISOARA",,1,,156,666
36,"Timiș",350,"350-MUNICIPIUL TIMISOARA",155243,154,2,1461,803,731,72,798,5,"MUNICIPIUL TIMISOARA",,1,,177,621
36,"Timiș",350,"350-MUNICIPIUL TIMISOARA",155243,155,2,668,560,390,170,558,2,"MUNICIPIUL TIMISOARA",,1,,99,459
36,"Timiș",350,"350-MUNICIPIUL TIMISOARA",155243,156,2,1041,680,588,92,677,3,"MUNICIPIUL TIMISOARA",,1,,148,529
36,"Timiș",350,"350-MUNICIPIUL TIMISOARA",155243,157,2,1021,761,683,78,756,5,"MUNICIPIUL TIMISOARA",,1,,177,579
36,"Timiș",350,"350-MUNICIPIUL TIMISOARA",155243,158,2,1444,1099,959,140,1095,4,"MUNICIPIUL TIMISOARA",,1,,244,851
36,"Timiș",350,"350-MUNICIPIUL TIMISOARA",155243,159,2,1851,1305,1221,84,1303,2,"MUNICIPIUL TIMISOARA",,1,,372,931
36,"Timiș",350,"350-MUNICIPIUL TIMISOARA",155243,160,2,1367,1003,932,71,998,5,"MUNICIPIUL TIMISOARA",,1,,186,812
36,"Timiș",350,"350-MUNICIPIUL TIMISOARA",155243,161,2,1577,1169,1094,75,1166,3,"MUNICIPIUL TIMISOARA",,1,,212,954
36,"Timiș",350,"350-MUNICIPIUL TIMISOARA",155243,162,2,1289,929,790,139,925,4,"MUNICIPIUL TIMISOARA",,1,,228,697
36,"Timiș",350,"350-MUNICIPIUL TIMISOARA",155243,163,2,1334,964,908,56,961,3,"MUNICIPIUL TIMISOARA",,1,,179,782
36,"Timiș",350,"350-MUNICIPIUL TIMISOARA",155243,164,2,1006,729,669,60,728,1,"MUNICIPIUL TIMISOARA",,1,,151,577
36,"Timiș",350,"350-MUNICIPIUL TIMISOARA",155243,165,2,1400,859,785,74,857,2,"MUNICIPIUL TIMISOARA",,1,,165,692
36,"Timiș",350,"350-MUNICIPIUL TIMISOARA",155243,166,2,1130,893,721,172,890,3,"MUNICIPIUL TIMISOARA",,1,,166,724
36,"Timiș",350,"350-MUNICIPIUL TIMISOARA",155243,167,2,1289,810,694,116,806,4,"MUNICIPIUL TIMISOARA",,1,,173,633
36,"Timiș",350,"350-MUNICIPIUL TIMISOARA",155243,168,2,1193,946,716,230,945,1,"MUNICIPIUL TIMISOARA",,1,,216,729
36,"Timiș",350,"350-MUNICIPIUL TIMISOARA",155243,169,2,1195,898,810,88,895,3,"MUNICIPIUL TIMISOARA",,1,,242,653
36,"Timiș",350,"350-MUNICIPIUL TIMISOARA",155243,170,2,876,696,609,87,693,3,"MUNICIPIUL TIMISOARA",,1,,151,542
36,"Timiș",350,"350-MUNICIPIUL TIMISOARA",155243,171,2,1100,820,742,78,818,1,"MUNICIPIUL TIMISOARA",,1,,187,631
36,"Timiș",350,"350-MUNICIPIUL TIMISOARA",155243,172,2,1452,1274,928,346,1258,16,"MUNICIPIUL TIMISOARA",,1,,243,1015
36,"Timiș",350,"350-MUNICIPIUL TIMISOARA",155243,173,2,1216,939,832,107,931,8,"MUNICIPIUL TIMISOARA",,1,,123,808
36,"Timiș",350,"350-MUNICIPIUL TIMISOARA",155243,174,2,865,659,551,108,659,0,"MUNICIPIUL TIMISOARA",,1,,159,500
36,"Timiș",350,"350-MUNICIPIUL TIMISOARA",155243,175,2,1433,1027,921,106,1025,2,"MUNICIPIUL TIMISOARA",,1,,226,799
36,"Timiș",350,"350-MUNICIPIUL TIMISOARA",155243,176,2,1459,1013,910,103,997,16,"MUNICIPIUL TIMISOARA",,1,,178,819
36,"Timiș",350,"350-MUNICIPIUL TIMISOARA",155243,177,2,1276,920,741,179,913,7,"MUNICIPIUL TIMISOARA",,1,,162,751
36,"Timiș",350,"350-MUNICIPIUL TIMISOARA",155243,178,2,1568,1174,971,203,1174,0,"MUNICIPIUL TIMISOARA",,1,,210,964
36,"Timiș",350,"350-MUNICIPIUL TIMISOARA",155243,179,2,2448,1839,1569,270,1835,4,"MUNICIPIUL TIMISOARA",,1,,249,1586
36,"Timiș",350,"350-MUNICIPIUL TIMISOARA",155243,180,2,1370,869,636,233,863,6,"MUNICIPIUL TIMISOARA",,1,,122,741
36,"Timiș",350,"350-MUNICIPIUL TIMISOARA",155243,181,2,807,568,412,156,564,4,"MUNICIPIUL TIMISOARA",,1,,89,475
36,"Timiș",350,"350-MUNICIPIUL TIMISOARA",155243,182,2,1347,1108,1008,100,1105,3,"MUNICIPIUL TIMISOARA",,1,,257,848
36,"Timiș",350,"350-MUNICIPIUL TIMISOARA",155243,183,2,739,407,329,78,406,1,"MUNICIPIUL TIMISOARA",,1,,97,309
36,"Timiș",350,"350-MUNICIPIUL TIMISOARA",155243,184,2,745,550,480,70,547,3,"MUNICIPIUL TIMISOARA",,1,,83,464
36,"Timiș",350,"350-MUNICIPIUL TIMISOARA",155243,185,2,1339,1028,911,117,1027,1,"MUNICIPIUL TIMISOARA",,1,,304,723
36,"Timiș",350,"350-MUNICIPIUL TIMISOARA",155243,186,2,1249,1000,826,174,995,5,"MUNICIPIUL TIMISOARA",,1,,221,774
36,"Timiș",350,"350-MUNICIPIUL TIMISOARA",155243,187,2,1854,1344,1235,109,1336,8,"MUNICIPIUL TIMISOARA",,1,,350,986
36,"Timiș",350,"350-MUNICIPIUL TIMISOARA",155243,188,2,1287,971,824,147,968,3,"MUNICIPIUL TIMISOARA",,1,,241,727
36,"Timiș",350,"350-MUNICIPIUL TIMISOARA",155243,189,2,1419,1028,933,95,1026,2,"MUNICIPIUL TIMISOARA",,1,,248,778
36,"Timiș",350,"350-MUNICIPIUL TIMISOARA",155243,190,2,1504,1076,975,101,1076,0,"MUNICIPIUL TIMISOARA",,1,,277,799
36,"Timiș",350,"350-MUNICIPIUL TIMISOARA",155243,191,2,1188,938,747,191,936,2,"MUNICIPIUL TIMISOARA",,1,,252,684
36,"Timiș",350,"350-MUNICIPIUL TIMISOARA",155243,192,2,1276,966,841,125,960,6,"MUNICIPIUL TIMISOARA",,1,,231,729
36,"Timiș",350,"350-MUNICIPIUL TIMISOARA",155243,193,2,1492,1201,1058,143,1196,5,"MUNICIPIUL TIMISOARA",,1,,269,927
36,"Timiș",350,"350-MUNICIPIUL TIMISOARA",155243,194,2,1125,783,637,146,783,0,"MUNICIPIUL TIMISOARA",,1,,167,616
36,"Timiș",350,"350-MUNICIPIUL TIMISOARA",155243,195,2,1177,911,784,127,907,4,"MUNICIPIUL TIMISOARA",,1,,150,757
36,"Timiș",350,"350-MUNICIPIUL TIMISOARA",155243,196,2,1159,831,765,66,828,3,"MUNICIPIUL TIMISOARA",,1,,131,697
36,"Timiș",350,"350-MUNICIPIUL TIMISOARA",155243,197,2,1191,884,754,130,882,2,"MUNICIPIUL TIMISOARA",,1,,110,772
36,"Timiș",350,"350-MUNICIPIUL TIMISOARA",155243,198,2,942,740,624,116,737,3,"MUNICIPIUL TIMISOARA",,1,,123,614
36,"Timiș",350,"350-MUNICIPIUL TIMISOARA",155243,199,2,1096,964,671,293,960,4,"MUNICIPIUL TIMISOARA",,1,,135,825
36,"Timiș",350,"350-MUNICIPIUL TIMISOARA",155243,200,2,1052,882,780,102,876,6,"MUNICIPIUL TIMISOARA",,1,,97,779
36,"Timiș",350,"350-MUNICIPIUL TIMISOARA",155243,201,2,1060,840,745,95,831,9,"MUNICIPIUL TIMISOARA",,1,,125,706
36,"Timiș",350,"350-MUNICIPIUL TIMISOARA",155243,202,2,667,626,464,162,623,3,"MUNICIPIUL TIMISOARA",,1,,81,542
36,"Timiș",350,"350-MUNICIPIUL TIMISOARA",155243,203,2,1060,883,791,92,880,3,"MUNICIPIUL TIMISOARA",,1,,133,747
36,"Timiș",350,"350-MUNICIPIUL TIMISOARA",155243,204,2,1048,814,733,81,810,4,"MUNICIPIUL TIMISOARA",,1,,198,612
36,"Timiș",350,"350-MUNICIPIUL TIMISOARA",155243,205,2,1489,1273,973,300,1271,2,"MUNICIPIUL TIMISOARA",,1,,160,1111
36,"Timiș",350,"350-MUNICIPIUL TIMISOARA",155243,206,2,1001,733,651,82,730,3,"MUNICIPIUL TIMISOARA",,1,,161,569
36,"Timiș",350,"350-MUNICIPIUL TIMISOARA",155243,207,2,1707,1318,1077,241,1313,5,"MUNICIPIUL TIMISOARA",,1,,236,1077
36,"Timiș",350,"350-MUNICIPIUL TIMISOARA",155243,208,2,1555,1174,1067,107,1171,3,"MUNICIPIUL TIMISOARA",,1,,259,912
36,"Timiș",350,"350-MUNICIPIUL TIMISOARA",155243,209,2,1553,1196,1098,98,1191,5,"MUNICIPIUL TIMISOARA",,1,,222,969
36,"Timiș",350,"350-MUNICIPIUL TIMISOARA",155243,210,2,1361,1021,941,80,1017,4,"MUNICIPIUL TIMISOARA",,1,,184,833
36,"Timiș",350,"350-MUNICIPIUL TIMISOARA",155243,211,2,387,775,277,498,768,7,"MUNICIPIUL TIMISOARA",,1,,189,579
36,"Timiș",350,"350-MUNICIPIUL TIMISOARA",155243,212,2,980,838,811,27,803,35,"MUNICIPIUL TIMISOARA",,1,,267,536
36,"Timiș",350,"350-MUNICIPIUL TIMISOARA",155243,213,2,726,712,690,22,701,11,"MUNICIPIUL TIMISOARA",,1,,239,462
36,"Timiș",350,"350-MUNICIPIUL TIMISOARA",155243,214,2,0,717,0,717,711,6,"MUNICIPIUL TIMISOARA",,1,,275,436
36,"Timiș",350,"350-MUNICIPIUL TIMISOARA",155243,215,2,1271,1150,1125,25,1137,13,"MUNICIPIUL TIMISOARA",,1,,463,674
36,"Timiș",350,"350-MUNICIPIUL TIMISOARA",155243,216,2,592,522,442,80,516,6,"MUNICIPIUL TIMISOARA",,1,,172,344
36,"Timiș",350,"350-MUNICIPIUL TIMISOARA",155243,217,2,0,717,0,717,715,2,"MUNICIPIUL TIMISOARA",,1,,113,602
36,"Timiș",350,"350-MUNICIPIUL TIMISOARA",155243,218,2,0,1298,0,1298,1290,8,"MUNICIPIUL TIMISOARA",,1,,218,1072
36,"Timiș",350,"350-MUNICIPIUL TIMISOARA",155243,219,2,0,1677,0,1677,1674,3,"MUNICIPIUL TIMISOARA",,1,,294,1380
36,"Timiș",350,"350-MUNICIPIUL TIMISOARA",155243,220,2,0,637,0,637,634,3,"MUNICIPIUL TIMISOARA",,1,,118,516
36,"Timiș",350,"350-MUNICIPIUL TIMISOARA",155243,221,2,150,28,5,23,28,0,"MUNICIPIUL TIMISOARA",,1,,8,20
36,"Timiș",350,"350-MUNICIPIUL TIMISOARA",155243,222,2,0,704,0,704,698,6,"MUNICIPIUL TIMISOARA",,1,,161,537
36,"Timiș",350,"350-MUNICIPIUL TIMISOARA",155243,223,2,0,222,0,222,222,0,"MUNICIPIUL TIMISOARA",,1,,35,187
36,"Timiș",350,"350-MUNICIPIUL TIMISOARA",155243,224,2,371,437,287,150,431,6,"MUNICIPIUL TIMISOARA",,1,,101,330
36,"Timiș",350,"350-MUNICIPIUL TIMISOARA",155243,225,2,0,204,0,204,202,2,"MUNICIPIUL TIMISOARA",,1,,64,138
36,"Timiș",350,"350-MUNICIPIUL TIMISOARA",155243,226,2,0,257,0,257,254,3,"MUNICIPIUL TIMISOARA",,1,,54,200
36,"Timiș",350,"350-MUNICIPIUL TIMISOARA",155243,227,2,0,159,0,159,156,3,"MUNICIPIUL TIMISOARA",,1,,19,137
36,"Timiș",350,"350-MUNICIPIUL TIMISOARA",155243,228,2,0,132,0,132,132,0,"MUNICIPIUL TIMISOARA",,1,,35,97
36,"Timiș",350,"350-MUNICIPIUL TIMISOARA",155243,229,2,0,1770,0,1770,1767,3,"MUNICIPIUL TIMISOARA",,1,,411,1356
36,"Timiș",350,"350-MUNICIPIUL TIMISOARA",155243,230,2,0,70,0,70,69,1,"MUNICIPIUL TIMISOARA",,1,,18,51
36,"Timiș",350,"350-MUNICIPIUL LUGOJ",155350,231,2,1565,1184,1041,143,1173,11,"MUNICIPIUL LUGOJ",,1,,402,771
36,"Timiș",350,"350-MUNICIPIUL LUGOJ",155350,232,2,1910,1383,1272,111,1372,11,"MUNICIPIUL LUGOJ",,1,,441,931
36,"Timiș",350,"350-MUNICIPIUL LUGOJ",155350,233,2,1472,1038,945,93,1027,11,"MUNICIPIUL LUGOJ",,1,,288,739
36,"Timiș",350,"350-MUNICIPIUL LUGOJ",155350,234,2,2485,1793,1685,108,1784,9,"MUNICIPIUL LUGOJ",,1,,621,1163
36,"Timiș",350,"350-MUNICIPIUL LUGOJ",155350,235,2,1281,937,837,100,929,8,"MUNICIPIUL LUGOJ",,1,,278,651
36,"Timiș",350,"350-MUNICIPIUL LUGOJ",155350,236,2,3001,2030,1876,154,2016,14,"MUNICIPIUL LUGOJ",,1,,599,1417
36,"Timiș",350,"350-MUNICIPIUL LUGOJ",155350,237,2,1514,1169,954,215,1159,10,"MUNICIPIUL LUGOJ",,1,,301,858
36,"Timiș",350,"350-MUNICIPIUL LUGOJ",155350,238,2,936,715,552,163,711,4,"MUNICIPIUL LUGOJ",,1,,153,558
36,"Timiș",350,"350-MUNICIPIUL LUGOJ",155350,239,2,1663,1233,1138,95,1225,8,"MUNICIPIUL LUGOJ",,1,,354,871
36,"Timiș",350,"350-MUNICIPIUL LUGOJ",155350,240,2,2315,1706,1595,111,1695,11,"MUNICIPIUL LUGOJ",,1,,465,1230
36,"Timiș",350,"350-MUNICIPIUL LUGOJ",155350,241,2,1456,1126,1007,119,1123,3,"MUNICIPIUL LUGOJ",,1,,279,844
36,"Timiș",350,"350-MUNICIPIUL LUGOJ",155350,242,2,1081,833,727,106,825,8,"MUNICIPIUL LUGOJ",,1,,207,618
36,"Timiș",350,"350-MUNICIPIUL LUGOJ",155350,243,2,2722,1944,1746,198,1939,5,"MUNICIPIUL LUGOJ",,1,,444,1495
36,"Timiș",350,"350-MUNICIPIUL LUGOJ",155350,244,2,1874,1347,1241,106,1339,8,"MUNICIPIUL LUGOJ",,1,,437,902
36,"Timiș",350,"350-MUNICIPIUL LUGOJ",155350,245,2,777,849,542,307,848,1,"MUNICIPIUL LUGOJ",,1,,207,641
36,"Timiș",350,"350-MUNICIPIUL LUGOJ",155350,246,2,1678,1312,1073,239,1299,13,"MUNICIPIUL LUGOJ",,1,,347,952
36,"Timiș",350,"350-MUNICIPIUL LUGOJ",155350,247,2,1358,893,813,80,888,5,"MUNICIPIUL LUGOJ",,1,,250,638
36,"Timiș",350,"350-MUNICIPIUL LUGOJ",155350,248,2,1359,1092,869,223,1088,4,"MUNICIPIUL LUGOJ",,1,,371,717
36,"Timiș",350,"350-MUNICIPIUL LUGOJ",155350,249,2,1346,918,823,95,911,7,"MUNICIPIUL LUGOJ",,1,,304,607
36,"Timiș",350,"350-MUNICIPIUL LUGOJ",155350,250,2,1376,1009,925,84,1005,4,"MUNICIPIUL LUGOJ",,1,,253,752
36,"Timiș",350,"350-MUNICIPIUL LUGOJ",155350,251,2,2654,1920,1688,232,1909,11,"MUNICIPIUL LUGOJ",,1,,469,1440
36,"Timiș",350,"350-MUNICIPIUL LUGOJ",155350,252,2,1581,1043,968,75,1034,9,"MUNICIPIUL LUGOJ",,1,,301,733
36,"Timiș",350,"350-MUNICIPIUL LUGOJ",155350,253,2,1565,1134,1015,119,1117,17,"MUNICIPIUL LUGOJ",,1,,261,856
36,"Timiș",350,"350-MUNICIPIUL LUGOJ",155350,254,2,293,219,169,50,217,2,"MUNICIPIUL LUGOJ",,1,,70,147
36,"Timiș",350,"350-MUNICIPIUL LUGOJ",155350,255,2,593,506,441,65,504,2,"MUNICIPIUL LUGOJ",,1,,84,420
36,"Timiș",350,"350-MUNICIPIUL LUGOJ",155350,256,2,0,336,0,336,333,3,"MUNICIPIUL LUGOJ",,1,,160,173
36,"Timiș",350,"350-MUNICIPIUL LUGOJ",155350,257,2,738,738,714,24,727,11,"MUNICIPIUL LUGOJ",,1,,298,429
36,"Timiș",350,"350-ORAS BUZIAS",155403,258,2,2317,2119,1447,672,2110,9,"ORAS BUZIAS",,1,,998,1112
36,"Timiș",350,"350-ORAS BUZIAS",155403,259,2,1990,1505,1304,201,1498,7,"ORAS BUZIAS",,1,,679,819
36,"Timiș",350,"350-ORAS BUZIAS",155403,260,2,676,575,452,123,568,7,"ORAS BUZIAS",,1,,259,309
36,"Timiș",350,"350-ORAS BUZIAS",155403,261,2,973,696,503,193,690,6,"ORAS BUZIAS",,1,,239,451
36,"Timiș",350,"350-ORAS BUZIAS",155403,262,2,0,222,0,222,221,1,"ORAS BUZIAS",,1,,134,87
36,"Timiș",350,"350-ORAS DETA",155458,263,2,1644,1266,1105,161,1262,4,"ORAS DETA",,1,,268,994
36,"Timiș",350,"350-ORAS DETA",155458,264,2,1954,1545,1339,206,1530,15,"ORAS DETA",,1,,341,1189
36,"Timiș",350,"350-ORAS DETA",155458,265,2,1322,935,835,100,930,5,"ORAS DETA",,1,,193,737
36,"Timiș",350,"350-ORAS DETA",155458,266,2,456,353,308,45,351,2,"ORAS DETA",,1,,113,238
36,"Timiș",350,"350-ORAS DETA",155458,267,2,128,142,123,19,142,0,"ORAS DETA",,1,,45,97
36,"Timiș",350,"350-ORAS FAGET",156801,268,2,1860,1550,1209,341,1544,6,"ORAS FAGET",,1,,650,894
36,"Timiș",350,"350-ORAS FAGET",156801,269,2,1297,1065,916,149,1056,9,"ORAS FAGET",,1,,456,600
36,"Timiș",350,"350-ORAS FAGET",156801,270,2,309,269,225,44,267,2,"ORAS FAGET",,1,,172,95
36,"Timiș",350,"350-ORAS FAGET",156801,271,2,357,329,281,48,324,5,"ORAS FAGET",,1,,129,195
36,"Timiș",350,"350-ORAS FAGET",156801,272,2,605,438,373,65,435,3,"ORAS FAGET",,1,,153,282
36,"Timiș",350,"350-ORAS FAGET",156801,273,2,603,480,430,50,474,6,"ORAS FAGET",,1,,288,186
36,"Timiș",350,"350-ORAS FAGET",156801,274,2,238,216,177,39,206,10,"ORAS FAGET",,1,,120,86
36,"Timiș",350,"350-ORAS FAGET",156801,275,2,456,391,349,42,385,6,"ORAS FAGET",,1,,271,114
36,"Timiș",350,"350-ORAS JIMBOLIA",155494,276,2,1487,1278,1052,226,1274,4,"ORAS JIMBOLIA",,1,,243,1031
36,"Timiș",350,"350-ORAS JIMBOLIA",155494,277,2,1160,1096,804,292,1093,3,"ORAS JIMBOLIA",,1,,204,889
36,"Timiș",350,"350-ORAS JIMBOLIA",155494,278,2,1866,1668,1293,375,1664,4,"ORAS JIMBOLIA",,1,,356,1308
36,"Timiș",350,"350-ORAS JIMBOLIA",155494,279,2,1339,1100,955,145,1096,4,"ORAS JIMBOLIA",,1,,245,851
36,"Timiș",350,"350-ORAS JIMBOLIA",155494,280,2,1581,1453,1130,323,1443,10,"ORAS JIMBOLIA",,1,,207,1236
36,"Timiș",350,"350-ORAS JIMBOLIA",155494,281,2,137,152,134,18,152,0,"ORAS JIMBOLIA",,1,,46,106
36,"Timiș",350,"350-ORAS SANNICOLAU MARE",155528,282,2,2070,1915,1709,206,1911,4,"ORAS SANNICOLAU MARE",,1,,490,1421
36,"Timiș",350,"350-ORAS SANNICOLAU MARE",155528,283,2,2021,1601,1448,153,1589,12,"ORAS SANNICOLAU MARE",,1,,436,1153
36,"Timiș",350,"350-ORAS SANNICOLAU MARE",155528,284,2,2000,1676,1548,128,1668,8,"ORAS SANNICOLAU MARE",,1,,538,1130
36,"Timiș",350,"350-ORAS SANNICOLAU MARE",155528,285,2,1489,1238,1035,203,1235,3,"ORAS SANNICOLAU MARE",,1,,351,884
36,"Timiș",350,"350-ORAS SANNICOLAU MARE",155528,286,2,1405,1170,1007,163,1158,12,"ORAS SANNICOLAU MARE",,1,,294,864
36,"Timiș",350,"350-BALINT",155546,287,2,797,635,513,122,631,4,"BALINT",,1,,267,364
36,"Timiș",350,"350-BALINT",155546,288,2,408,341,267,74,338,3,"BALINT",,1,,29,309
36,"Timiș",350,"350-BALINT",155546,289,2,211,214,182,32,209,5,"BALINT",,1,,66,143
36,"Timiș",350,"350-BANLOC",155591,290,2,1506,1006,827,179,1003,3,"BANLOC",,1,,494,509
36,"Timiș",350,"350-BANLOC",155591,291,2,803,602,494,108,599,2,"BANLOC",,1,,304,295
36,"Timiș",350,"350-BANLOC",155591,292,2,458,289,188,101,288,1,"BANLOC",,1,,95,193
36,"Timiș",350,"350-BANLOC",155591,293,2,329,281,201,80,279,2,"BANLOC",,1,,128,151
36,"Timiș",350,"350-BANLOC",155591,294,2,378,301,244,57,291,10,"BANLOC",,1,,158,133
36,"Timiș",350,"350-BARA",155662,295,2,119,152,101,51,150,2,"BARA",,1,,50,100
36,"Timiș",350,"350-BARA",155662,296,2,31,50,25,25,50,0,"BARA",,1,,11,39
36,"Timiș",350,"350-BARA",155662,297,2,53,63,42,21,61,2,"BARA",,1,,21,40
36,"Timiș",350,"350-BARA",155662,298,2,58,68,43,25,68,0,"BARA",,1,,24,44
36,"Timiș",350,"350-BEBA VECHE",155724,299,2,832,601,482,119,596,5,"BEBA VECHE",,1,,288,308
36,"Timiș",350,"350-BEBA VECHE",155724,300,2,421,320,264,56,317,3,"BEBA VECHE",,1,,45,272
36,"Timiș",350,"350-BECICHERECU MIC",155760,301,2,1892,1270,1045,225,1262,8,"BECICHERECU MIC",,1,,379,883
36,"Timiș",350,"350-BECICHERECU MIC",155760,302,2,1379,1084,787,297,1075,9,"BECICHERECU MIC",,1,,316,759
36,"Timiș",350,"350-BELINT",155797,303,2,1252,1115,909,206,1109,6,"BELINT",,1,,372,737
36,"Timiș",350,"350-BELINT",155797,304,2,692,636,523,113,634,2,"BELINT",,1,,172,462
36,"Timiș",350,"350-BELINT",155797,305,2,223,198,157,41,197,1,"BELINT",,1,,104,93
36,"Timiș",350,"350-BELINT",155797,306,2,251,253,206,47,253,0,"BELINT",,1,,114,139
36,"Timiș",350,"350-BETHAUSEN",155840,307,2,510,447,348,99,445,2,"BETHAUSEN",,1,,166,279
36,"Timiș",350,"350-BETHAUSEN",155840,308,2,358,286,276,10,284,2,"BETHAUSEN",,1,,114,170
36,"Timiș",350,"350-BETHAUSEN",155840,309,2,397,353,302,51,351,2,"BETHAUSEN",,1,,121,230
36,"Timiș",350,"350-BETHAUSEN",155840,310,2,293,277,236,41,274,3,"BETHAUSEN",,1,,135,139
36,"Timiș",350,"350-BETHAUSEN",155840,311,2,415,322,269,53,321,1,"BETHAUSEN",,1,,132,189
36,"Timiș",350,"350-BETHAUSEN",155840,312,2,200,130,97,33,128,2,"BETHAUSEN",,1,,45,83
36,"Timiș",350,"350-BILED",155911,313,2,1268,1060,686,374,1049,11,"BILED",,1,,393,656
36,"Timiș",350,"350-BILED",155911,314,2,1085,904,609,295,889,15,"BILED",,1,,240,649
36,"Timiș",350,"350-BILED",155911,315,2,1403,1209,946,263,1195,14,"BILED",,1,,547,648
36,"Timiș",350,"350-BILED",155911,316,2,298,263,193,70,262,1,"BILED",,1,,116,146
36,"Timiș",350,"350-BARNA",155957,317,2,473,347,293,54,342,5,"BARNA",,1,,125,217
36,"Timiș",350,"350-BARNA",155957,318,2,307,212,174,38,212,0,"BARNA",,1,,71,141
36,"Timiș",350,"350-BARNA",155957,319,2,354,292,236,56,289,3,"BARNA",,1,,140,149
36,"Timiș",350,"350-BOGDA",156035,320,2,214,212,131,81,212,0,"BOGDA",,1,,59,153
36,"Timiș",350,"350-BOGDA",156035,321,2,205,196,142,54,196,0,"BOGDA",,1,,100,96
36,"Timiș",350,"350-BOLDUR",156106,322,2,492,498,403,95,494,4,"BOLDUR",,1,,174,320
36,"Timiș",350,"350-BOLDUR",156106,323,2,360,346,277,69,345,1,"BOLDUR",,1,,198,147
36,"Timiș",350,"350-BOLDUR",156106,324,2,644,556,448,108,551,5,"BOLDUR",,1,,175,376
36,"Timiș",350,"350-BOLDUR",156106,325,2,472,444,359,85,439,5,"BOLDUR",,1,,164,275
36,"Timiș",350,"350-BRESTOVAT",156151,326,2,239,239,198,41,236,3,"BRESTOVAT",,1,,63,173
36,"Timiș",350,"350-BRESTOVAT",156151,327,2,131,158,118,40,156,2,"BRESTOVAT",,1,,79,77
36,"Timiș",350,"350-BRESTOVAT",156151,328,2,215,202,163,39,199,3,"BRESTOVAT",,1,,68,131
36,"Timiș",350,"350-CARPINIS",156213,329,2,1479,1027,885,142,1021,6,"CARPINIS",,1,,302,719
36,"Timiș",350,"350-CARPINIS",156213,330,2,1341,853,712,141,847,6,"CARPINIS",,1,,317,530
36,"Timiș",350,"350-CARPINIS",156213,331,2,515,635,379,256,635,0,"CARPINIS",,1,,142,493
36,"Timiș",350,"350-CARPINIS",156213,332,2,1589,1092,843,249,1083,9,"CARPINIS",,1,,436,647
36,"Timiș",350,"350-CENAD",156259,333,2,1477,1222,984,238,1211,11,"CENAD",,1,,351,860
36,"Timiș",350,"350-CENAD",156259,334,2,1437,1007,811,196,1002,5,"CENAD",,1,,303,699
36,"Timiș",350,"350-CENEI",156277,335,2,1479,1219,980,239,1208,11,"CENEI",,1,,322,886
36,"Timiș",350,"350-CENEI",156277,336,2,1157,1007,788,219,992,15,"CENEI",,1,,310,682
36,"Timiș",350,"350-CENEI",156277,337,2,553,595,409,186,589,6,"CENEI",,1,,250,339
36,"Timiș",350,"350-CHEVERESU MARE",156311,338,2,779,532,410,122,523,9,"CHEVERESU MARE",,1,,217,306
36,"Timiș",350,"350-CHEVERESU MARE",156311,339,2,339,362,219,143,358,4,"CHEVERESU MARE",,1,,83,275
36,"Timiș",350,"350-CHEVERESU MARE",156311,340,2,324,292,237,55,292,0,"CHEVERESU MARE",,1,,153,139
36,"Timiș",350,"350-CIACOVA",156366,341,2,1164,902,758,144,894,8,"CIACOVA",,1,,299,595
36,"Timiș",350,"350-CIACOVA",156366,342,2,814,704,503,201,700,4,"CIACOVA",,1,,242,458
36,"Timiș",350,"350-CIACOVA",156366,343,2,587,424,331,93,420,4,"CIACOVA",,1,,188,232
36,"Timiș",350,"350-CIACOVA",156366,344,2,199,147,113,34,147,0,"CIACOVA",,1,,54,93
36,"Timiș",350,"350-CIACOVA",156366,345,2,1415,1004,863,141,996,8,"CIACOVA",,1,,194,802
36,"Timiș",350,"350-CIACOVA",156366,346,2,307,304,250,54,300,4,"CIACOVA",,1,,134,166
36,"Timiș",350,"350-CIACOVA",156366,347,2,411,315,267,48,309,6,"CIACOVA",,1,,104,205
36,"Timiș",350,"350-CIACOVA",156366,348,2,525,418,310,108,414,4,"CIACOVA",,1,,145,269
36,"Timiș",350,"350-COMLOSU MARE",156437,349,2,1502,1239,1105,134,1229,10,"COMLOSU MARE",,1,,485,744
36,"Timiș",350,"350-COMLOSU MARE",156437,350,2,1338,985,885,100,976,9,"COMLOSU MARE",,1,,298,678
36,"Timiș",350,"350-COMLOSU MARE",156437,351,2,603,549,477,72,546,3,"COMLOSU MARE",,1,,94,452
36,"Timiș",350,"350-COSTEIU",156473,352,2,1760,1293,1137,156,1284,9,"COSTEIU",,1,,345,939
36,"Timiș",350,"350-COSTEIU",156473,353,2,723,599,493,106,593,6,"COSTEIU",,1,,89,504
36,"Timiș",350,"350-COSTEIU",156473,354,2,304,285,245,40,284,1,"COSTEIU",,1,,70,214
36,"Timiș",350,"350-CRICIOVA",156534,355,2,547,496,431,65,492,4,"CRICIOVA",,1,,245,247
36,"Timiș",350,"350-CRICIOVA",156534,356,2,508,401,334,67,400,1,"CRICIOVA",,1,,94,306
36,"Timiș",350,"350-CRICIOVA",156534,357,2,312,287,245,42,286,1,"CRICIOVA",,1,,100,186
36,"Timiș",350,"350-CURTEA",156589,358,2,604,530,478,52,528,2,"CURTEA",,1,,260,268
36,"Timiș",350,"350-CURTEA",156589,359,2,456,374,312,62,370,4,"CURTEA",,1,,157,213
36,"Timiș",350,"350-DAROVA",156623,360,2,901,734,600,134,725,9,"DAROVA",,1,,187,538
36,"Timiș",350,"350-DAROVA",156623,361,2,317,276,240,36,272,4,"DAROVA",,1,,73,199
36,"Timiș",350,"350-DAROVA",156623,362,2,873,630,533,97,626,4,"DAROVA",,1,,195,431
36,"Timiș",350,"350-DENTA",156669,363,2,1644,1198,1019,179,1189,9,"DENTA",,1,,318,871
36,"Timiș",350,"350-DENTA",156669,364,2,454,422,342,80,413,9,"DENTA",,1,,99,314
36,"Timiș",350,"350-DENTA",156669,365,2,339,295,243,52,295,0,"DENTA",,1,,36,259
36,"Timiș",350,"350-DUDESTII VECHI",156712,366,2,1814,1200,1049,151,1194,6,"DUDESTII VECHI",,1,,260,934
36,"Timiș",350,"350-DUDESTII VECHI",156712,367,2,1617,1160,963,197,1146,14,"DUDESTII VECHI",,1,,162,984
36,"Timiș",350,"350-DUDESTII VECHI",156712,368,2,1082,802,702,100,794,8,"DUDESTII VECHI",,1,,298,496
36,"Timiș",350,"350-DUDESTII VECHI",156712,369,2,402,365,226,139,359,6,"DUDESTII VECHI",,1,,75,284
36,"Timiș",350,"350-DUMBRAVA",156767,370,2,698,575,520,55,572,3,"DUMBRAVA",,1,,89,483
36,"Timiș",350,"350-DUMBRAVA",156767,371,2,925,586,527,59,581,5,"DUMBRAVA",,1,,191,390
36,"Timiș",350,"350-DUMBRAVA",156767,372,2,425,332,282,50,329,3,"DUMBRAVA",,1,,113,216
36,"Timiș",350,"350-DUMBRAVITA",155261,373,2,1914,1518,1386,132,1511,7,"DUMBRAVITA",,1,,217,1294
36,"Timiș",350,"350-FARDEA",156927,374,2,855,657,576,81,654,3,"FARDEA",,1,,197,457
36,"Timiș",350,"350-FARDEA",156927,375,2,300,254,180,74,254,0,"FARDEA",,1,,125,129
36,"Timiș",350,"350-FARDEA",156927,376,2,571,420,354,66,417,3,"FARDEA",,1,,264,153
36,"Timiș",350,"350-FOENI",157004,377,2,840,718,611,107,711,7,"FOENI",,1,,157,554
36,"Timiș",350,"350-FOENI",157004,378,2,363,374,280,94,371,3,"FOENI",,1,,24,347
36,"Timiș",350,"350-GAVOJDIA",157031,379,2,975,729,640,89,727,2,"GAVOJDIA",,1,,328,399
36,"Timiș",350,"350-GAVOJDIA",157031,380,2,545,446,377,69,443,3,"GAVOJDIA",,1,,132,311
36,"Timiș",350,"350-GAVOJDIA",157031,381,2,412,353,288,65,349,4,"GAVOJDIA",,1,,143,206
36,"Timiș",350,"350-GAVOJDIA",157031,382,2,266,200,169,31,198,2,"GAVOJDIA",,1,,82,116
36,"Timiș",350,"350-GATAIA",157095,383,2,930,1001,613,388,994,7,"GATAIA",,1,,188,806
36,"Timiș",350,"350-GATAIA",157095,384,2,900,740,531,209,733,7,"GATAIA",,1,,200,533
36,"Timiș",350,"350-GATAIA",157095,385,2,1353,1148,847,301,1140,8,"GATAIA",,1,,205,935
36,"Timiș",350,"350-GATAIA",157095,386,2,707,571,410,161,568,3,"GATAIA",,1,,91,477
36,"Timiș",350,"350-GATAIA",157095,387,2,303,276,175,101,273,3,"GATAIA",,1,,70,203
36,"Timiș",350,"350-GATAIA",157095,388,2,357,346,258,88,340,6,"GATAIA",,1,,97,243
36,"Timiș",350,"350-GATAIA",157095,389,2,314,252,188,64,247,5,"GATAIA",,1,,107,140
36,"Timiș",350,"350-GATAIA",157095,390,2,153,140,96,44,139,1,"GATAIA",,1,,91,48
36,"Timiș",350,"350-GATAIA",157095,391,2,367,279,226,53,274,5,"GATAIA",,1,,82,192
36,"Timiș",350,"350-GATAIA",157095,392,2,260,238,171,67,234,4,"GATAIA",,1,,89,145
36,"Timiș",350,"350-GHIRODA",155289,393,2,2653,1929,1706,223,1916,13,"GHIRODA",,1,,435,1481
36,"Timiș",350,"350-GHIRODA",155289,394,2,1025,817,661,156,809,8,"GHIRODA",,1,,229,580
36,"Timiș",350,"350-GHIZELA",157193,395,2,306,305,223,82,303,2,"GHIZELA",,1,,80,223
36,"Timiș",350,"350-GHIZELA",157193,396,2,229,232,183,49,231,1,"GHIZELA",,1,,122,109
36,"Timiș",350,"350-GHIZELA",157193,397,2,415,350,311,39,344,6,"GHIZELA",,1,,159,185
36,"Timiș",350,"350-GIARMATA",157246,398,2,1491,1179,1021,158,1171,8,"GIARMATA",,1,,311,860
36,"Timiș",350,"350-GIARMATA",157246,399,2,1225,979,812,167,969,10,"GIARMATA",,1,,287,682
36,"Timiș",350,"350-GIARMATA",157246,400,2,527,485,379,106,480,5,"GIARMATA",,1,,181,299
36,"Timiș",350,"350-GIERA",157273,401,2,458,413,325,88,407,6,"GIERA",,1,,67,340
36,"Timiș",350,"350-GIERA",157273,402,2,136,154,92,62,152,2,"GIERA",,1,,28,124
36,"Timiș",350,"350-GIERA",157273,403,2,254,286,190,96,284,2,"GIERA",,1,,65,219
36,"Timiș",350,"350-GIROC",155314,404,2,1652,1175,991,184,1170,5,"GIROC",,1,,216,954
36,"Timiș",350,"350-GIROC",155314,405,2,1262,1111,847,264,1103,8,"GIROC",,1,,288,815
36,"Timiș",350,"350-GIULVAZ",157317,406,2,838,588,580,8,583,5,"GIULVAZ",,1,,271,312
36,"Timiș",350,"350-GIULVAZ",157317,407,2,407,294,234,60,291,3,"GIULVAZ",,1,,85,206
36,"Timiș",350,"350-GIULVAZ",157317,408,2,468,411,296,115,405,6,"GIULVAZ",,1,,98,307
36,"Timiș",350,"350-GIULVAZ",157317,409,2,393,348,269,79,345,3,"GIULVAZ",,1,,62,283
36,"Timiș",350,"350-JAMU MARE",157362,410,2,1128,842,667,175,836,6,"JAMU MARE",,1,,300,536
36,"Timiș",350,"350-JAMU MARE",157362,411,2,502,457,365,92,453,4,"JAMU MARE",,1,,110,343
36,"Timiș",350,"350-JAMU MARE",157362,412,2,474,366,289,77,364,2,"JAMU MARE",,1,,109,255
36,"Timiș",350,"350-JAMU MARE",157362,413,2,269,222,177,45,222,0,"JAMU MARE",,1,,76,146
36,"Timiș",350,"350-JAMU MARE",157362,414,2,237,239,169,70,237,2,"JAMU MARE",,1,,84,153
36,"Timiș",350,"350-JEBEL",157424,415,2,1049,1071,733,338,1064,7,"JEBEL",,1,,232,832
36,"Timiș",350,"350-JEBEL",157424,416,2,1040,995,761,234,988,7,"JEBEL",,1,,276,712
36,"Timiș",350,"350-JEBEL",157424,417,2,1062,949,717,232,940,9,"JEBEL",,1,,277,663
36,"Timiș",350,"350-LENAUHEIM",157451,418,2,997,881,653,228,874,7,"LENAUHEIM",,1,,193,681
36,"Timiș",350,"350-LENAUHEIM",157451,419,2,1142,937,709,228,926,11,"LENAUHEIM",,1,,316,610
36,"Timiș",350,"350-LENAUHEIM",157451,420,2,1030,1004,738,266,989,15,"LENAUHEIM",,1,,353,636
36,"Timiș",350,"350-LIEBLING",157497,421,2,2147,1655,1434,221,1646,9,"LIEBLING",,1,,776,870
36,"Timiș",350,"350-LIEBLING",157497,422,2,194,257,177,80,252,2,"LIEBLING",,1,,56,196
36,"Timiș",350,"350-LIEBLING",157497,423,2,172,203,124,79,200,3,"LIEBLING",,1,,25,175
36,"Timiș",350,"350-LOVRIN",157530,424,2,2833,1792,1481,311,1779,13,"LOVRIN",,1,,805,974
36,"Timiș",350,"350-LOVRIN",157530,425,2,2020,1586,1418,168,1571,15,"LOVRIN",,1,,512,1059
36,"Timiș",350,"350-LOVRIN",157530,426,2,1396,986,904,82,979,7,"LOVRIN",,1,,433,546
36,"Timiș",350,"350-LOVRIN",157530,427,2,191,176,106,70,172,4,"LOVRIN",,1,,55,117
36,"Timiș",350,"350-MARGINA",157585,428,2,922,670,599,71,665,5,"MARGINA",,1,,339,326
36,"Timiș",350,"350-MARGINA",157585,429,2,407,403,362,41,400,3,"MARGINA",,1,,164,236
36,"Timiș",350,"350-MARGINA",157585,430,2,193,190,167,23,188,2,"MARGINA",,1,,91,97
36,"Timiș",350,"350-MARGINA",157585,431,2,213,242,202,40,241,1,"MARGINA",,1,,99,142
36,"Timiș",350,"350-MARGINA",157585,432,2,154,169,138,31,169,0,"MARGINA",,1,,67,102
36,"Timiș",350,"350-MASLOC",157683,433,2,671,383,284,99,380,3,"MASLOC",,1,,132,248
36,"Timiș",350,"350-MASLOC",157683,434,2,653,492,388,104,487,5,"MASLOC",,1,,158,329
36,"Timiș",350,"350-MASLOC",157683,435,2,1137,974,712,262,964,10,"MASLOC",,1,,286,678
36,"Timiș",350,"350-MASLOC",157683,436,2,330,275,196,79,273,2,"MASLOC",,1,,61,212
36,"Timiș",350,"350-MANASTIUR",157736,437,2,792,707,588,119,701,6,"MANASTIUR",,1,,282,419
36,"Timiș",350,"350-MANASTIUR",157736,438,2,125,94,60,34,94,0,"MANASTIUR",,1,,38,56
36,"Timiș",350,"350-MANASTIUR",157736,439,2,323,274,226,48,271,3,"MANASTIUR",,1,,120,151
36,"Timiș",350,"350-MORAVITA",157781,440,2,711,631,476,155,626,5,"MORAVITA",,1,,169,457
36,"Timiș",350,"350-MORAVITA",157781,441,2,461,508,329,179,503,5,"MORAVITA",,1,,169,334
36,"Timiș",350,"350-MORAVITA",157781,442,2,126,191,152,39,189,2,"MORAVITA",,1,,84,105
36,"Timiș",350,"350-MORAVITA",157781,443,2,161,158,127,31,158,0,"MORAVITA",,1,,70,88
36,"Timiș",350,"350-MOSNITA NOUA",157834,444,2,1069,806,649,157,801,5,"MOSNITA NOUA",,1,,180,621
36,"Timiș",350,"350-MOSNITA NOUA",157834,445,2,785,639,488,151,637,2,"MOSNITA NOUA",,1,,174,463
36,"Timiș",350,"350-MOSNITA NOUA",157834,446,2,873,756,575,181,749,7,"MOSNITA NOUA",,1,,140,609
36,"Timiș",350,"350-MOSNITA NOUA",157834,447,2,210,227,162,65,227,0,"MOSNITA NOUA",,1,,102,125
36,"Timiș",350,"350-NADRAG",157898,448,2,1203,916,853,63,915,1,"NADRAG",,1,,483,432
36,"Timiș",350,"350-NADRAG",157898,449,2,1167,815,764,51,810,5,"NADRAG",,1,,370,440
36,"Timiș",350,"350-NADRAG",157898,450,2,254,240,207,33,235,5,"NADRAG",,1,,136,99
36,"Timiș",350,"350-NITCHIDORF",157923,451,2,672,535,449,86,532,3,"NITCHIDORF",,1,,182,350
36,"Timiș",350,"350-NITCHIDORF",157923,452,2,156,139,118,21,136,3,"NITCHIDORF",,1,,66,70
36,"Timiș",350,"350-NITCHIDORF",157923,453,2,189,170,142,28,170,0,"NITCHIDORF",,1,,66,104
36,"Timiș",350,"350-OHABA LUNGA",157969,454,2,286,249,197,52,247,2,"OHABA LUNGA",,1,,137,110
36,"Timiș",350,"350-OHABA LUNGA",157969,455,2,231,171,150,21,165,6,"OHABA LUNGA",,1,,67,98
36,"Timiș",350,"350-OHABA LUNGA",157969,456,2,175,160,128,32,157,3,"OHABA LUNGA",,1,,115,42
36,"Timiș",350,"350-OHABA LUNGA",157969,457,2,244,266,214,52,263,3,"OHABA LUNGA",,1,,96,167
36,"Timiș",350,"350-ORTISOARA",158010,458,2,1510,1179,979,200,1172,7,"ORTISOARA",,1,,418,754
36,"Timiș",350,"350-ORTISOARA",158010,459,2,509,415,333,82,411,4,"ORTISOARA",,1,,151,260
36,"Timiș",350,"350-ORTISOARA",158010,460,2,373,342,264,78,339,3,"ORTISOARA",,1,,101,238
36,"Timiș",350,"350-ORTISOARA",158010,461,2,455,427,291,136,423,4,"ORTISOARA",,1,,267,156
36,"Timiș",350,"350-PECIU NOU",158065,462,2,1142,898,568,330,896,2,"PECIU NOU",,1,,345,551
36,"Timiș",350,"350-PECIU NOU",158065,463,2,938,847,494,353,840,7,"PECIU NOU",,1,,285,555
36,"Timiș",350,"350-PECIU NOU",158065,464,2,720,607,450,157,602,5,"PECIU NOU",,1,,239,363
36,"Timiș",350,"350-PECIU NOU",158065,465,2,730,570,437,133,569,1,"PECIU NOU",,1,,143,426
36,"Timiș",350,"350-PERIAM",158109,466,2,2005,1309,1086,223,1302,7,"PERIAM",,1,,348,954
36,"Timiș",350,"350-PERIAM",158109,467,2,1715,1164,975,189,1161,3,"PERIAM",,1,,366,795
36,"Timiș",350,"350-PERIAM",158109,468,2,1389,1124,929,195,1111,13,"PERIAM",,1,,443,668
36,"Timiș",350,"350-PIETROASA",158136,469,2,429,343,293,50,342,1,"PIETROASA",,1,,209,133
36,"Timiș",350,"350-PIETROASA",158136,470,2,237,181,161,20,179,2,"PIETROASA",,1,,127,52
36,"Timiș",350,"350-PIETROASA",158136,471,2,214,166,146,20,162,4,"PIETROASA",,1,,80,82
36,"Timiș",350,"350-PISCHIA",158181,472,2,768,639,484,155,636,3,"PISCHIA",,1,,205,431
36,"Timiș",350,"350-PISCHIA",158181,473,2,600,434,359,75,429,5,"PISCHIA",,1,,140,289
36,"Timiș",350,"350-PISCHIA",158181,474,2,318,249,180,69,248,1,"PISCHIA",,1,,113,135
36,"Timiș",350,"350-PISCHIA",158181,475,2,420,379,302,77,376,3,"PISCHIA",,1,,98,278
36,"Timiș",350,"350-RACOVITA",158243,476,2,1017,825,712,113,820,5,"RACOVITA",,1,,385,435
36,"Timiș",350,"350-RACOVITA",158243,477,2,695,544,370,174,538,6,"RACOVITA",,1,,192,346
36,"Timiș",350,"350-RACOVITA",158243,478,2,847,697,570,127,692,5,"RACOVITA",,1,,378,314
36,"Timiș",350,"350-RECAS",158323,479,2,2073,1523,1339,184,1504,19,"RECAS",,1,,450,1054
36,"Timiș",350,"350-RECAS",158323,480,2,1317,1054,890,164,1049,5,"RECAS",,1,,310,739
36,"Timiș",350,"350-RECAS",158323,481,2,1015,885,717,168,874,11,"RECAS",,1,,251,623
36,"Timiș",350,"350-RECAS",158323,482,2,624,606,454,152,600,6,"RECAS",,1,,156,444
36,"Timiș",350,"350-RECAS",158323,483,2,276,273,230,43,271,2,"RECAS",,1,,114,157
36,"Timiș",350,"350-RECAS",158323,484,2,331,301,263,38,293,8,"RECAS",,1,,141,152
36,"Timiș",350,"350-RECAS",158323,485,2,290,308,228,80,303,5,"RECAS",,1,,109,194
36,"Timiș",350,"350-REMETEA MARE",158396,486,2,748,718,551,167,714,4,"REMETEA MARE",,1,,270,444
36,"Timiș",350,"350-REMETEA MARE",158396,487,2,692,678,421,257,670,8,"REMETEA MARE",,1,,152,518
36,"Timiș",350,"350-REMETEA MARE",158396,488,2,188,200,116,84,199,1,"REMETEA MARE",,1,,103,96
36,"Timiș",350,"350-REMETEA MARE",158396,489,2,606,475,377,98,471,4,"REMETEA MARE",,1,,180,291
36,"Timiș",350,"350-SACOSU TURCESC",158449,490,2,543,465,328,137,464,1,"SACOSU TURCESC",,1,,126,338
36,"Timiș",350,"350-SACOSU TURCESC",158449,491,2,368,271,196,75,264,7,"SACOSU TURCESC",,1,,97,167
36,"Timiș",350,"350-SACOSU TURCESC",158449,492,2,203,223,134,89,223,0,"SACOSU TURCESC",,1,,52,171
36,"Timiș",350,"350-SACOSU TURCESC",158449,493,2,185,220,147,73,220,0,"SACOSU TURCESC",,1,,21,199
36,"Timiș",350,"350-SACOSU TURCESC",158449,494,2,257,276,177,99,274,2,"SACOSU TURCESC",,1,,69,205
36,"Timiș",350,"350-SACOSU TURCESC",158449,495,2,435,420,325,95,417,3,"SACOSU TURCESC",,1,,103,314
36,"Timiș",350,"350-SACOSU TURCESC",158449,496,2,177,200,127,73,200,0,"SACOSU TURCESC",,1,,79,121
36,"Timiș",350,"350-SATCHINEZ",158528,497,2,1939,1471,1226,245,1467,4,"SATCHINEZ",,1,,573,894
36,"Timiș",350,"350-SATCHINEZ",158528,498,2,797,626,520,106,622,4,"SATCHINEZ",,1,,157,465
36,"Timiș",350,"350-SATCHINEZ",158528,499,2,393,343,258,85,341,2,"SATCHINEZ",,1,,124,217
36,"Timiș",350,"350-SACALAZ",158564,500,2,1498,924,785,139,916,8,"SACALAZ",,1,,275,641
36,"Timiș",350,"350-SACALAZ",158564,501,2,1050,913,561,352,907,6,"SACALAZ",,1,,200,707
36,"Timiș",350,"350-SACALAZ",158564,502,2,1273,976,733,243,967,9,"SACALAZ",,1,,236,731
36,"Timiș",350,"350-SACALAZ",158564,503,2,465,447,284,163,444,3,"SACALAZ",,1,,137,307
36,"Timiș",350,"350-SACALAZ",158564,504,2,487,505,485,20,498,7,"SACALAZ",,1,,197,301
36,"Timiș",350,"350-SECAS",158608,505,2,214,208,164,44,207,1,"SECAS",,1,,102,105
36,"Timiș",350,"350-SANANDREI",158653,506,2,902,708,538,170,705,3,"SANANDREI",,1,,158,547
36,"Timiș",350,"350-SANANDREI",158653,507,2,882,693,571,122,690,3,"SANANDREI",,1,,160,530
36,"Timiș",350,"350-SANANDREI",158653,508,2,1073,878,625,253,873,5,"SANANDREI",,1,,229,644
36,"Timiș",350,"350-SANANDREI",158653,509,2,448,365,292,73,362,3,"SANANDREI",,1,,73,289
36,"Timiș",350,"350-SANMIHAIU ROMAN",158699,510,2,1293,888,666,222,878,10,"SANMIHAIU ROMAN",,1,,300,578
36,"Timiș",350,"350-SANMIHAIU ROMAN",158699,511,2,416,363,265,98,363,0,"SANMIHAIU ROMAN",,1,,65,298
36,"Timiș",350,"350-SANMIHAIU ROMAN",158699,512,2,1212,937,673,264,930,7,"SANMIHAIU ROMAN",,1,,184,746
36,"Timiș",350,"350-SANPETRU MARE",158733,513,2,1527,1034,907,127,1021,13,"SANPETRU MARE",,1,,359,662
36,"Timiș",350,"350-SANPETRU MARE",158733,514,2,1039,840,747,93,816,24,"SANPETRU MARE",,1,,219,597
36,"Timiș",350,"350-SANPETRU MARE",158733,515,2,1703,1352,1219,133,1335,17,"SANPETRU MARE",,1,,286,1049
36,"Timiș",350,"350-SAG",158779,516,2,1790,1390,1078,312,1387,3,"SAG",,1,,287,1100
36,"Timiș",350,"350-SAG",158779,517,2,1119,885,664,221,875,10,"SAG",,1,,227,648
36,"Timiș",350,"350-STIUCA",158804,518,2,399,366,293,73,361,5,"STIUCA",,1,,89,272
36,"Timiș",350,"350-STIUCA",158804,519,2,285,209,186,23,206,3,"STIUCA",,1,,79,127
36,"Timiș",350,"350-STIUCA",158804,520,2,196,251,175,76,249,2,"STIUCA",,1,,78,171
36,"Timiș",350,"350-STIUCA",158804,521,2,223,245,184,61,245,0,"STIUCA",,1,,124,121
36,"Timiș",350,"350-TEREMIA MARE",158859,522,2,1504,1197,952,245,1183,14,"TEREMIA MARE",,1,,369,814
36,"Timiș",350,"350-TEREMIA MARE",158859,523,2,319,266,165,101,261,1,"TEREMIA MARE",,1,,69,192
36,"Timiș",350,"350-TEREMIA MARE",158859,524,2,680,578,471,107,571,7,"TEREMIA MARE",,1,,185,386
36,"Timiș",350,"350-TOMESTI",158895,525,2,813,604,555,49,600,4,"TOMESTI",,1,,341,259
36,"Timiș",350,"350-TOMESTI",158895,526,2,468,370,340,30,368,2,"TOMESTI",,1,,198,170
36,"Timiș",350,"350-TOMESTI",158895,527,2,543,411,382,29,408,3,"TOMESTI",,1,,187,221
36,"Timiș",350,"350-TOMESTI",158895,528,2,421,320,282,38,319,1,"TOMESTI",,1,,187,132
36,"Timiș",350,"350-TOPOLOVATU MARE",158966,529,2,958,844,655,189,842,2,"TOPOLOVATU MARE",,1,,190,652
36,"Timiș",350,"350-TOPOLOVATU MARE",158966,530,2,393,384,290,94,384,0,"TOPOLOVATU MARE",,1,,93,291
36,"Timiș",350,"350-TOPOLOVATU MARE",158966,531,2,373,341,259,82,337,4,"TOPOLOVATU MARE",,1,,105,232
36,"Timiș",350,"350-TOPOLOVATU MARE",158966,532,2,217,184,141,43,183,1,"TOPOLOVATU MARE",,1,,74,109
36,"Timiș",350,"350-TOPOLOVATU MARE",158966,533,2,360,287,215,72,287,0,"TOPOLOVATU MARE",,1,,97,190
36,"Timiș",350,"350-TORMAC",159035,534,2,230,229,173,56,225,4,"TORMAC",,1,,110,115
36,"Timiș",350,"350-TORMAC",159035,535,2,624,560,481,79,553,7,"TORMAC",,1,,358,195
36,"Timiș",350,"350-TORMAC",159035,536,2,1197,1000,861,139,993,7,"TORMAC",,1,,76,917
36,"Timiș",350,"350-TRAIAN VUIA",159071,537,2,586,451,403,48,447,4,"TRAIAN VUIA",,1,,170,277
36,"Timiș",350,"350-TRAIAN VUIA",159071,538,2,312,263,220,43,261,2,"TRAIAN VUIA",,1,,65,196
36,"Timiș",350,"350-TRAIAN VUIA",159071,539,2,350,318,272,46,316,2,"TRAIAN VUIA",,1,,124,192
36,"Timiș",350,"350-TRAIAN VUIA",159071,540,2,339,265,234,31,265,0,"TRAIAN VUIA",,1,,85,180
36,"Timiș",350,"350-TRAIAN VUIA",159071,541,2,162,186,141,45,186,0,"TRAIAN VUIA",,1,,67,119
36,"Timiș",350,"350-UIVAR",159142,542,2,1254,813,662,151,806,7,"UIVAR",,1,,163,643
36,"Timiș",350,"350-UIVAR",159142,543,2,370,321,237,84,318,3,"UIVAR",,1,,32,286
36,"Timiș",350,"350-UIVAR",159142,544,2,480,476,334,142,473,3,"UIVAR",,1,,129,344
36,"Timiș",350,"350-UIVAR",159142,545,2,603,551,426,125,550,1,"UIVAR",,1,,14,536
36,"Timiș",350,"350-UIVAR",159142,546,2,599,520,392,128,516,4,"UIVAR",,1,,62,454
36,"Timiș",350,"350-VARIAS",159213,547,2,1488,1161,978,183,1156,5,"VARIAS",,1,,505,651
36,"Timiș",350,"350-VARIAS",159213,548,2,1257,1124,981,143,1117,7,"VARIAS",,1,,388,729
36,"Timiș",350,"350-VARIAS",159213,549,2,1006,799,687,112,795,4,"VARIAS",,1,,283,512
36,"Timiș",350,"350-VARIAS",159213,550,2,351,210,185,25,209,1,"VARIAS",,1,,72,137
36,"Timiș",350,"350-VICTOR VLAD DELAMARINA",159259,551,2,667,513,390,123,509,4,"VICTOR VLAD DELAMARINA",,1,,182,327
36,"Timiș",350,"350-VICTOR VLAD DELAMARINA",159259,552,2,397,397,316,81,395,2,"VICTOR VLAD DELAMARINA",,1,,97,298
36,"Timiș",350,"350-VICTOR VLAD DELAMARINA",159259,553,2,400,325,221,104,321,4,"VICTOR VLAD DELAMARINA",,1,,100,221
36,"Timiș",350,"350-VICTOR VLAD DELAMARINA",159259,554,2,207,193,137,56,191,2,"VICTOR VLAD DELAMARINA",,1,,41,150
36,"Timiș",350,"350-VICTOR VLAD DELAMARINA",159259,555,2,348,342,240,102,340,2,"VICTOR VLAD DELAMARINA",,1,,72,268
36,"Timiș",350,"350-VOITEG",159339,556,2,1342,1072,904,168,1067,5,"VOITEG",,1,,357,710
36,"Timiș",350,"350-VOITEG",159339,557,2,380,318,249,69,313,5,"VOITEG",,1,,139,174
37,"Tulcea",369,"369-MUNICIPIUL TULCEA",159614,1,2,1531,1149,1001,148,1142,7,"MUNICIPIUL TULCEA",,3,,569,573
37,"Tulcea",369,"369-MUNICIPIUL TULCEA",159614,2,2,2322,1637,1488,149,1622,15,"MUNICIPIUL TULCEA",,3,,724,898
37,"Tulcea",369,"369-MUNICIPIUL TULCEA",159614,3,2,2083,1484,1311,173,1473,11,"MUNICIPIUL TULCEA",,3,,654,819
37,"Tulcea",369,"369-MUNICIPIUL TULCEA",159614,4,2,2359,1627,1472,155,1608,19,"MUNICIPIUL TULCEA",,3,,740,868
37,"Tulcea",369,"369-MUNICIPIUL TULCEA",159614,5,2,2307,1607,1491,116,1597,10,"MUNICIPIUL TULCEA",,3,,780,817
37,"Tulcea",369,"369-MUNICIPIUL TULCEA",159614,6,2,2420,1759,1553,206,1753,6,"MUNICIPIUL TULCEA",,3,,716,1037
37,"Tulcea",369,"369-MUNICIPIUL TULCEA",159614,7,2,2336,1618,1512,106,1610,8,"MUNICIPIUL TULCEA",,3,,785,825
37,"Tulcea",369,"369-MUNICIPIUL TULCEA",159614,8,2,2208,1512,1369,143,1500,12,"MUNICIPIUL TULCEA",,3,,692,808
37,"Tulcea",369,"369-MUNICIPIUL TULCEA",159614,9,2,2577,1573,1450,123,1559,14,"MUNICIPIUL TULCEA",,3,,666,893
37,"Tulcea",369,"369-MUNICIPIUL TULCEA",159614,10,2,2708,1741,1610,131,1732,9,"MUNICIPIUL TULCEA",,3,,754,978
37,"Tulcea",369,"369-MUNICIPIUL TULCEA",159614,11,2,2087,1390,1247,143,1381,9,"MUNICIPIUL TULCEA",,3,,610,771
37,"Tulcea",369,"369-MUNICIPIUL TULCEA",159614,12,2,1332,995,880,115,991,4,"MUNICIPIUL TULCEA",,3,,487,504
37,"Tulcea",369,"369-MUNICIPIUL TULCEA",159614,13,2,1983,1371,1271,100,1366,5,"MUNICIPIUL TULCEA",,3,,592,774
37,"Tulcea",369,"369-MUNICIPIUL TULCEA",159614,14,2,2020,1516,1271,245,1511,5,"MUNICIPIUL TULCEA",,3,,588,923
37,"Tulcea",369,"369-MUNICIPIUL TULCEA",159614,15,2,2315,1611,1509,102,1599,12,"MUNICIPIUL TULCEA",,3,,670,929
37,"Tulcea",369,"369-MUNICIPIUL TULCEA",159614,16,2,2354,1567,1462,105,1564,3,"MUNICIPIUL TULCEA",,3,,529,1035
37,"Tulcea",369,"369-MUNICIPIUL TULCEA",159614,17,2,2153,1534,1451,83,1527,7,"MUNICIPIUL TULCEA",,3,,601,926
37,"Tulcea",369,"369-MUNICIPIUL TULCEA",159614,18,2,2191,1728,1566,162,1727,1,"MUNICIPIUL TULCEA",,3,,837,890
37,"Tulcea",369,"369-MUNICIPIUL TULCEA",159614,19,2,2383,1667,1534,133,1659,8,"MUNICIPIUL TULCEA",,3,,687,972
37,"Tulcea",369,"369-MUNICIPIUL TULCEA",159614,20,2,1406,976,897,79,962,14,"MUNICIPIUL TULCEA",,3,,373,589
37,"Tulcea",369,"369-MUNICIPIUL TULCEA",159614,21,2,965,792,646,146,788,4,"MUNICIPIUL TULCEA",,3,,326,462
37,"Tulcea",369,"369-MUNICIPIUL TULCEA",159614,22,2,2242,1662,1511,151,1648,14,"MUNICIPIUL TULCEA",,3,,686,962
37,"Tulcea",369,"369-MUNICIPIUL TULCEA",159614,23,2,2916,2005,1856,149,2005,0,"MUNICIPIUL TULCEA",,3,,625,1380
37,"Tulcea",369,"369-MUNICIPIUL TULCEA",159614,24,2,2649,1941,1822,119,1929,12,"MUNICIPIUL TULCEA",,3,,672,1257
37,"Tulcea",369,"369-MUNICIPIUL TULCEA",159614,25,2,2357,1614,1463,151,1611,3,"MUNICIPIUL TULCEA",,3,,652,959
37,"Tulcea",369,"369-MUNICIPIUL TULCEA",159614,26,2,3125,1992,1806,186,1986,6,"MUNICIPIUL TULCEA",,3,,879,1107
37,"Tulcea",369,"369-MUNICIPIUL TULCEA",159614,27,2,2230,1359,1251,108,1349,10,"MUNICIPIUL TULCEA",,3,,527,822
37,"Tulcea",369,"369-MUNICIPIUL TULCEA",159614,28,2,2568,1963,1485,478,1956,7,"MUNICIPIUL TULCEA",,3,,722,1234
37,"Tulcea",369,"369-MUNICIPIUL TULCEA",159614,29,2,1785,1223,1065,158,1215,8,"MUNICIPIUL TULCEA",,3,,520,695
37,"Tulcea",369,"369-MUNICIPIUL TULCEA",159614,30,2,1670,1338,1149,189,1333,5,"MUNICIPIUL TULCEA",,3,,560,773
37,"Tulcea",369,"369-MUNICIPIUL TULCEA",159614,31,2,2159,1930,1079,851,1920,10,"MUNICIPIUL TULCEA",,3,,638,1282
37,"Tulcea",369,"369-MUNICIPIUL TULCEA",159614,32,2,2023,1618,1361,257,1609,9,"MUNICIPIUL TULCEA",,3,,708,901
37,"Tulcea",369,"369-MUNICIPIUL TULCEA",159614,33,2,0,558,0,558,554,4,"MUNICIPIUL TULCEA",,3,,273,281
37,"Tulcea",369,"369-MUNICIPIUL TULCEA",159614,34,2,0,1072,0,1072,1050,22,"MUNICIPIUL TULCEA",,3,,483,567
37,"Tulcea",369,"369-ORAS BABADAG",159650,35,2,1867,1314,1159,155,1289,25,"ORAS BABADAG",,3,,739,550
37,"Tulcea",369,"369-ORAS BABADAG",159650,36,2,1550,1240,1010,230,1235,5,"ORAS BABADAG",,3,,661,574
37,"Tulcea",369,"369-ORAS BABADAG",159650,37,2,1353,936,771,165,911,25,"ORAS BABADAG",,3,,575,336
37,"Tulcea",369,"369-ORAS BABADAG",159650,38,2,1606,1053,904,149,1040,13,"ORAS BABADAG",,3,,610,430
37,"Tulcea",369,"369-ORAS BABADAG",159650,39,2,1062,749,630,119,744,5,"ORAS BABADAG",,3,,339,405
37,"Tulcea",369,"369-ORAS BABADAG",159650,40,2,448,338,315,23,331,7,"ORAS BABADAG",,3,,190,141
37,"Tulcea",369,"369-ORAS ISACCEA",159687,41,2,1800,1270,1151,119,1259,11,"ORAS ISACCEA",,3,,548,711
37,"Tulcea",369,"369-ORAS ISACCEA",159687,42,2,1602,1183,1086,97,1156,27,"ORAS ISACCEA",,3,,519,637
37,"Tulcea",369,"369-ORAS ISACCEA",159687,43,2,473,370,308,62,366,4,"ORAS ISACCEA",,3,,223,143
37,"Tulcea",369,"369-ORAS ISACCEA",159687,44,2,23,50,21,29,50,0,"ORAS ISACCEA",,3,,27,23
37,"Tulcea",369,"369-ORAS MACIN",159730,45,2,2225,1587,1481,106,1577,10,"ORAS MACIN",,3,,856,721
37,"Tulcea",369,"369-ORAS MACIN",159730,46,2,2140,1625,1484,141,1619,6,"ORAS MACIN",,3,,856,763
37,"Tulcea",369,"369-ORAS MACIN",159730,47,2,2688,1904,1771,133,1893,11,"ORAS MACIN",,3,,946,947
37,"Tulcea",369,"369-ORAS MACIN",159730,48,2,2215,1535,1427,108,1521,14,"ORAS MACIN",,3,,867,654
37,"Tulcea",369,"369-ORAS SULINA",159767,49,2,2060,1595,1357,238,1586,9,"ORAS SULINA",,3,,934,652
37,"Tulcea",369,"369-ORAS SULINA",159767,50,2,1748,1284,1175,109,1280,4,"ORAS SULINA",,3,,790,490
37,"Tulcea",369,"369-ORAS SULINA",159767,51,2,64,72,62,10,72,0,"ORAS SULINA",,3,,37,35
37,"Tulcea",369,"369-BAIA",159785,52,2,2220,1687,1491,196,1669,18,"BAIA",,3,,1089,580
37,"Tulcea",369,"369-BAIA",159785,53,2,463,364,317,47,361,3,"BAIA",,3,,101,260
37,"Tulcea",369,"369-BAIA",159785,54,2,148,127,90,37,125,2,"BAIA",,3,,66,59
37,"Tulcea",369,"369-BAIA",159785,55,2,717,575,498,77,568,7,"BAIA",,3,,150,418
37,"Tulcea",369,"369-BAIA",159785,56,2,322,254,197,57,250,4,"BAIA",,3,,113,137
37,"Tulcea",369,"369-BEIDAUD",159847,57,2,456,358,290,68,351,7,"BEIDAUD",,3,,180,171
37,"Tulcea",369,"369-BEIDAUD",159847,58,2,415,289,201,88,283,6,"BEIDAUD",,3,,140,143
37,"Tulcea",369,"369-BEIDAUD",159847,59,2,388,340,224,116,337,3,"BEIDAUD",,3,,177,160
37,"Tulcea",369,"369-C.A.ROSETTI",159883,60,2,258,195,152,43,194,1,"C.A.ROSETTI",,3,,145,49
37,"Tulcea",369,"369-C.A.ROSETTI",159883,61,2,337,276,223,53,271,5,"C.A.ROSETTI",,3,,210,61
37,"Tulcea",369,"369-C.A.ROSETTI",159883,62,2,250,200,146,54,193,7,"C.A.ROSETTI",,3,,142,51
37,"Tulcea",369,"369-C.A.ROSETTI",159883,63,2,166,108,84,24,106,2,"C.A.ROSETTI",,3,,85,21
37,"Tulcea",369,"369-CARCALIU",159945,64,2,1767,1019,948,71,1005,14,"CARCALIU",,3,,689,316
37,"Tulcea",369,"369-CARCALIU",159945,65,2,1493,801,737,64,789,12,"CARCALIU",,3,,541,248
37,"Tulcea",369,"369-CASIMCEA",159963,66,2,1102,769,627,142,765,4,"CASIMCEA",,3,,509,256
37,"Tulcea",369,"369-CASIMCEA",159963,67,2,308,288,248,40,282,6,"CASIMCEA",,3,,197,85
37,"Tulcea",369,"369-CASIMCEA",159963,68,2,574,461,371,90,458,3,"CASIMCEA",,3,,274,184
37,"Tulcea",369,"369-CASIMCEA",159963,69,2,310,324,243,81,324,0,"CASIMCEA",,3,,268,56
37,"Tulcea",369,"369-CEAMURLIA DE JOS",160092,70,2,905,624,520,104,615,9,"CEAMURLIA DE JOS",,3,,346,269
37,"Tulcea",369,"369-CEAMURLIA DE JOS",160092,71,2,1009,771,651,120,761,10,"CEAMURLIA DE JOS",,3,,399,362
37,"Tulcea",369,"369-CERNA",160127,72,2,1924,1344,1238,106,1331,13,"CERNA",,3,,725,606
37,"Tulcea",369,"369-CERNA",160127,73,2,1033,741,658,83,735,6,"CERNA",,3,,500,235
37,"Tulcea",369,"369-CERNA",160127,74,2,554,433,360,73,431,2,"CERNA",,3,,236,195
37,"Tulcea",369,"369-CEATALCHIOI",160047,75,2,286,336,158,178,332,4,"CEATALCHIOI",,3,,197,135
37,"Tulcea",369,"369-CEATALCHIOI",160047,76,2,78,138,55,83,136,2,"CEATALCHIOI",,3,,66,70
37,"Tulcea",369,"369-CHILIA VECHE",160172,77,2,1434,1034,881,153,1026,8,"CHILIA VECHE",,3,,807,219
37,"Tulcea",369,"369-CHILIA VECHE",160172,78,2,505,432,294,138,424,8,"CHILIA VECHE",,3,,322,102
37,"Tulcea",369,"369-CIUCUROVA",160225,79,2,1018,674,552,122,662,12,"CIUCUROVA",,3,,336,326
37,"Tulcea",369,"369-CIUCUROVA",160225,80,2,160,93,68,25,92,1,"CIUCUROVA",,3,,31,61
37,"Tulcea",369,"369-CIUCUROVA",160225,81,2,467,275,218,57,271,4,"CIUCUROVA",,3,,167,104
37,"Tulcea",369,"369-CRISAN",160261,82,2,298,363,254,109,363,0,"CRISAN",,3,,221,142
37,"Tulcea",369,"369-CRISAN",160261,83,2,363,390,339,51,390,0,"CRISAN",,3,,344,46
37,"Tulcea",369,"369-CRISAN",160261,84,2,224,279,167,112,275,4,"CRISAN",,3,,152,123
37,"Tulcea",369,"369-DAENI",160305,85,2,2139,1453,1360,93,1423,30,"DAENI",,3,,1076,347
37,"Tulcea",369,"369-DOROBANTU",160323,86,2,763,500,459,41,496,4,"DOROBANTU",,3,,323,173
37,"Tulcea",369,"369-DOROBANTU",160323,87,2,416,294,255,39,288,6,"DOROBANTU",,3,,221,67
37,"Tulcea",369,"369-DOROBANTU",160323,88,2,152,119,97,22,119,0,"DOROBANTU",,3,,65,54
37,"Tulcea",369,"369-DOROBANTU",160323,89,2,92,75,57,18,74,1,"DOROBANTU",,3,,66,8
37,"Tulcea",369,"369-FRECATEI",160387,90,2,975,656,574,82,641,15,"FRECATEI",,3,,381,260
37,"Tulcea",369,"369-FRECATEI",160387,91,2,963,729,587,142,718,11,"FRECATEI",,3,,302,416
37,"Tulcea",369,"369-FRECATEI",160387,92,2,634,415,288,127,403,12,"FRECATEI",,3,,177,226
37,"Tulcea",369,"369-FRECATEI",160387,93,2,498,374,306,68,368,6,"FRECATEI",,3,,208,160
37,"Tulcea",369,"369-GRECI",160430,94,2,2006,1233,1077,156,1224,9,"GRECI",,3,,625,599
37,"Tulcea",369,"369-GRECI",160430,95,2,2240,1286,1189,97,1273,13,"GRECI",,3,,680,593
37,"Tulcea",369,"369-GRINDU",160458,96,2,1078,759,638,121,750,9,"GRINDU",,3,,351,399
37,"Tulcea",369,"369-HAMCEARCA",160476,97,2,355,237,177,60,234,3,"HAMCEARCA",,3,,129,105
37,"Tulcea",369,"369-HAMCEARCA",160476,98,2,337,265,193,72,263,2,"HAMCEARCA",,3,,133,130
37,"Tulcea",369,"369-HAMCEARCA",160476,99,2,636,452,365,87,444,8,"HAMCEARCA",,3,,281,163
37,"Tulcea",369,"369-HORIA",160528,100,2,943,685,623,62,683,2,"HORIA",,3,,470,213
37,"Tulcea",369,"369-HORIA",160528,101,2,328,211,159,52,210,1,"HORIA",,3,,107,103
37,"Tulcea",369,"369-I.C.BRATIANU",161525,102,2,917,692,552,140,690,2,"I.C.BRATIANU",,3,,305,385
37,"Tulcea",369,"369-IZVOARELE",160564,103,2,1433,922,836,86,911,11,"IZVOARELE",,3,,333,578
37,"Tulcea",369,"369-IZVOARELE",160564,104,2,240,204,126,78,200,4,"IZVOARELE",,3,,116,84
37,"Tulcea",369,"369-IZVOARELE",160564,105,2,1269,780,668,112,772,8,"IZVOARELE",,3,,509,263
37,"Tulcea",369,"369-IZVOARELE",160564,106,2,252,185,149,36,184,1,"IZVOARELE",,3,,117,67
37,"Tulcea",369,"369-JIJILA",160617,107,2,1500,1121,1053,68,1112,9,"JIJILA",,3,,722,390
37,"Tulcea",369,"369-JIJILA",160617,108,2,1663,1286,1227,59,1279,7,"JIJILA",,3,,843,436
37,"Tulcea",369,"369-JIJILA",160617,109,2,1184,877,839,38,869,8,"JIJILA",,3,,538,331
37,"Tulcea",369,"369-JURILOVCA",160644,110,2,1334,980,853,127,969,11,"JURILOVCA",,3,,729,240
37,"Tulcea",369,"369-JURILOVCA",160644,111,2,1157,849,774,75,829,20,"JURILOVCA",,3,,599,230
37,"Tulcea",369,"369-JURILOVCA",160644,112,2,691,485,415,70,481,4,"JURILOVCA",,3,,337,144
37,"Tulcea",369,"369-JURILOVCA",160644,113,2,1112,814,705,109,800,14,"JURILOVCA",,3,,445,355
37,"Tulcea",369,"369-LUNCAVITA",160680,114,2,2916,1990,1665,325,1974,16,"LUNCAVITA",,3,,886,1088
37,"Tulcea",369,"369-LUNCAVITA",160680,115,2,1848,1279,1077,202,1256,23,"LUNCAVITA",,3,,579,677
37,"Tulcea",369,"369-LUNCAVITA",160680,116,2,785,616,501,115,607,9,"LUNCAVITA",,3,,346,261
37,"Tulcea",369,"369-MAHMUDIA",160724,117,2,2082,1543,1237,306,1533,10,"MAHMUDIA",,3,,870,663
37,"Tulcea",369,"369-MAHMUDIA",160724,118,2,1762,1099,966,133,1089,10,"MAHMUDIA",,3,,743,346
37,"Tulcea",369,"369-MALIUC",160779,119,2,198,232,122,110,228,4,"MALIUC",,3,,93,135
37,"Tulcea",369,"369-MALIUC",160779,120,2,352,263,204,59,260,3,"MALIUC",,3,,109,151
37,"Tulcea",369,"369-MALIUC",160779,121,2,111,128,79,49,123,5,"MALIUC",,3,,65,58
37,"Tulcea",369,"369-MIHAI BRAVU",160831,122,2,535,349,290,59,343,6,"MIHAI BRAVU",,3,,150,193
37,"Tulcea",369,"369-MIHAI BRAVU",160831,123,2,577,464,391,73,461,3,"MIHAI BRAVU",,3,,246,215
37,"Tulcea",369,"369-MIHAI BRAVU",160831,124,2,950,640,579,61,629,11,"MIHAI BRAVU",,3,,449,180
37,"Tulcea",369,"369-MIHAIL KOGALNICEANU",160877,125,2,1419,980,841,139,972,8,"MIHAIL KOGALNICEANU",,3,,603,369
37,"Tulcea",369,"369-MIHAIL KOGALNICEANU",160877,126,2,454,371,295,76,368,3,"MIHAIL KOGALNICEANU",,3,,195,173
37,"Tulcea",369,"369-MIHAIL KOGALNICEANU",160877,127,2,491,337,297,40,331,6,"MIHAIL KOGALNICEANU",,3,,201,130
37,"Tulcea",369,"369-MURIGHIOL",160911,128,2,1106,856,649,207,852,4,"MURIGHIOL",,3,,463,389
37,"Tulcea",369,"369-MURIGHIOL",160911,129,2,634,477,315,162,476,1,"MURIGHIOL",,3,,281,195
37,"Tulcea",369,"369-MURIGHIOL",160911,130,2,520,436,310,126,434,2,"MURIGHIOL",,3,,262,172
37,"Tulcea",369,"369-MURIGHIOL",160911,131,2,545,413,314,99,408,5,"MURIGHIOL",,3,,283,125
37,"Tulcea",369,"369-NALBANT",160993,132,2,801,525,424,101,511,14,"NALBANT",,3,,273,238
37,"Tulcea",369,"369-NALBANT",160993,133,2,599,439,322,117,429,10,"NALBANT",,3,,218,211
37,"Tulcea",369,"369-NALBANT",160993,134,2,316,227,155,72,225,2,"NALBANT",,3,,72,153
37,"Tulcea",369,"369-NICULITEL",161035,135,2,2174,1464,1317,147,1436,28,"NICULITEL",,3,,693,743
37,"Tulcea",369,"369-NICULITEL",161035,136,2,1848,1190,1073,117,1177,13,"NICULITEL",,3,,635,542
37,"Tulcea",369,"369-NUFARU",161053,137,2,866,743,565,178,734,9,"NUFARU",,3,,408,326
37,"Tulcea",369,"369-NUFARU",161053,138,2,763,611,504,107,601,10,"NUFARU",,3,,317,284
37,"Tulcea",369,"369-NUFARU",161053,139,2,111,108,53,55,106,2,"NUFARU",,3,,60,46
37,"Tulcea",369,"369-OSTROV",161106,140,2,1766,1118,1028,90,1094,24,"OSTROV",,3,,820,274
37,"Tulcea",369,"369-PARDINA",161133,141,2,327,334,174,160,332,2,"PARDINA",,3,,183,149
37,"Tulcea",369,"369-PECENEAGA",161151,142,2,1630,1191,1064,127,1183,8,"PECENEAGA",,3,,921,262
37,"Tulcea",369,"369-SARICHIOI",161179,143,2,1540,1099,997,102,1078,21,"SARICHIOI",,3,,617,461
37,"Tulcea",369,"369-SARICHIOI",161179,144,2,1535,1120,1024,96,1107,13,"SARICHIOI",,3,,725,382
37,"Tulcea",369,"369-SARICHIOI",161179,145,2,564,406,353,53,401,5,"SARICHIOI",,3,,272,129
37,"Tulcea",369,"369-SARICHIOI",161179,146,2,1314,957,850,107,937,20,"SARICHIOI",,3,,633,304
37,"Tulcea",369,"369-SARICHIOI",161179,147,2,950,690,612,78,680,10,"SARICHIOI",,3,,504,176
37,"Tulcea",369,"369-SARICHIOI",161179,148,2,371,312,255,57,308,4,"SARICHIOI",,3,,186,122
37,"Tulcea",369,"369-SFANTU GHEORGHE",161231,149,2,899,688,608,80,683,5,"SFANTU GHEORGHE",,3,,501,182
37,"Tulcea",369,"369-SLAVA CERCHEZA",161259,150,2,1324,772,677,95,771,1,"SLAVA CERCHEZA",,3,,467,304
37,"Tulcea",369,"369-SLAVA CERCHEZA",161259,151,2,1151,629,534,95,603,26,"SLAVA CERCHEZA",,3,,329,274
37,"Tulcea",369,"369-SMARDAN",161286,152,2,724,660,515,145,653,7,"SMARDAN",,3,,352,301
37,"Tulcea",369,"369-SOMOVA",161302,153,2,1724,1167,896,271,1150,17,"SOMOVA",,3,,625,525
37,"Tulcea",369,"369-SOMOVA",161302,154,2,946,745,585,160,741,4,"SOMOVA",,3,,336,405
37,"Tulcea",369,"369-SOMOVA",161302,155,2,645,428,334,94,417,11,"SOMOVA",,3,,244,173
37,"Tulcea",369,"369-STEJARU",161348,156,2,761,509,423,86,506,3,"STEJARU",,3,,239,267
37,"Tulcea",369,"369-STEJARU",161348,157,2,437,391,233,158,391,0,"STEJARU",,3,,217,174
37,"Tulcea",369,"369-STEJARU",161348,158,2,473,323,249,74,322,1,"STEJARU",,3,,127,195
37,"Tulcea",369,"369-TOPOLOG",161384,159,2,1774,1238,1112,126,1223,15,"TOPOLOG",,3,,857,366
37,"Tulcea",369,"369-TOPOLOG",161384,160,2,138,117,89,28,114,3,"TOPOLOG",,3,,70,44
37,"Tulcea",369,"369-TOPOLOG",161384,161,2,225,178,122,56,176,2,"TOPOLOG",,3,,108,68
37,"Tulcea",369,"369-TOPOLOG",161384,162,2,585,438,357,81,436,2,"TOPOLOG",,3,,304,132
37,"Tulcea",369,"369-TOPOLOG",161384,163,2,232,161,133,28,160,1,"TOPOLOG",,3,,91,69
37,"Tulcea",369,"369-TOPOLOG",161384,164,2,282,201,165,36,197,4,"TOPOLOG",,3,,133,64
37,"Tulcea",369,"369-TOPOLOG",161384,165,2,475,332,277,55,330,2,"TOPOLOG",,3,,219,111
37,"Tulcea",369,"369-TURCOAIA",161464,166,2,1655,1210,1120,90,1205,5,"TURCOAIA",,3,,741,464
37,"Tulcea",369,"369-TURCOAIA",161464,167,2,1411,930,892,38,924,6,"TURCOAIA",,3,,601,323
37,"Tulcea",369,"369-VALEA NUCARILOR",161482,168,2,1054,688,581,107,682,6,"VALEA NUCARILOR",,3,,396,286
37,"Tulcea",369,"369-VALEA NUCARILOR",161482,169,2,408,532,489,43,521,11,"VALEA NUCARILOR",,3,,333,188
37,"Tulcea",369,"369-VALEA NUCARILOR",161482,170,2,1791,915,814,101,899,16,"VALEA NUCARILOR",,3,,563,336
38,"Vaslui",378,"378-MUNICIPIUL VASLUI",161945,1,2,2387,1671,1568,103,1666,5,"MUNICIPIUL VASLUI",,4,,847,819
38,"Vaslui",378,"378-MUNICIPIUL VASLUI",161945,2,2,1244,926,851,75,919,7,"MUNICIPIUL VASLUI",,4,,512,407
38,"Vaslui",378,"378-MUNICIPIUL VASLUI",161945,3,2,1732,1358,1209,149,1347,11,"MUNICIPIUL VASLUI",,4,,731,616
38,"Vaslui",378,"378-MUNICIPIUL VASLUI",161945,4,2,1399,1038,987,51,1032,6,"MUNICIPIUL VASLUI",,4,,641,391
38,"Vaslui",378,"378-MUNICIPIUL VASLUI",161945,5,2,1580,1231,1171,60,1225,6,"MUNICIPIUL VASLUI",,4,,543,682
38,"Vaslui",378,"378-MUNICIPIUL VASLUI",161945,6,2,1798,1309,1148,161,1299,8,"MUNICIPIUL VASLUI",,4,,749,550
38,"Vaslui",378,"378-MUNICIPIUL VASLUI",161945,7,2,2067,1628,1434,194,1610,18,"MUNICIPIUL VASLUI",,4,,890,720
38,"Vaslui",378,"378-MUNICIPIUL VASLUI",161945,8,2,1558,1081,1011,70,1068,13,"MUNICIPIUL VASLUI",,4,,621,447
38,"Vaslui",378,"378-MUNICIPIUL VASLUI",161945,9,2,1567,1038,970,68,1028,10,"MUNICIPIUL VASLUI",,4,,563,465
38,"Vaslui",378,"378-MUNICIPIUL VASLUI",161945,10,2,1305,1395,870,525,1374,21,"MUNICIPIUL VASLUI",,4,,786,588
38,"Vaslui",378,"378-MUNICIPIUL VASLUI",161945,11,2,1324,972,933,39,964,8,"MUNICIPIUL VASLUI",,4,,497,467
38,"Vaslui",378,"378-MUNICIPIUL VASLUI",161945,12,2,1137,841,789,52,838,3,"MUNICIPIUL VASLUI",,4,,424,414
38,"Vaslui",378,"378-MUNICIPIUL VASLUI",161945,13,2,1284,922,873,49,921,1,"MUNICIPIUL VASLUI",,4,,475,446
38,"Vaslui",378,"378-MUNICIPIUL VASLUI",161945,14,2,1277,939,899,40,934,5,"MUNICIPIUL VASLUI",,4,,481,453
38,"Vaslui",378,"378-MUNICIPIUL VASLUI",161945,15,2,1708,1115,999,116,1106,9,"MUNICIPIUL VASLUI",,4,,613,493
38,"Vaslui",378,"378-MUNICIPIUL VASLUI",161945,16,2,1335,1073,875,198,1062,11,"MUNICIPIUL VASLUI",,4,,625,437
38,"Vaslui",378,"378-MUNICIPIUL VASLUI",161945,17,2,1641,1199,1066,133,1195,4,"MUNICIPIUL VASLUI",,4,,715,480
38,"Vaslui",378,"378-MUNICIPIUL VASLUI",161945,18,2,1681,1314,1127,187,1308,6,"MUNICIPIUL VASLUI",,4,,731,577
38,"Vaslui",378,"378-MUNICIPIUL VASLUI",161945,19,2,1830,1147,1034,113,1139,8,"MUNICIPIUL VASLUI",,4,,680,459
38,"Vaslui",378,"378-MUNICIPIUL VASLUI",161945,20,2,1785,1251,1186,65,1241,10,"MUNICIPIUL VASLUI",,4,,676,565
38,"Vaslui",378,"378-MUNICIPIUL VASLUI",161945,21,2,1534,1097,1035,62,1088,9,"MUNICIPIUL VASLUI",,4,,609,479
38,"Vaslui",378,"378-MUNICIPIUL VASLUI",161945,22,2,1485,987,946,41,976,11,"MUNICIPIUL VASLUI",,4,,532,444
38,"Vaslui",378,"378-MUNICIPIUL VASLUI",161945,23,2,1337,1064,981,83,1061,3,"MUNICIPIUL VASLUI",,4,,565,496
38,"Vaslui",378,"378-MUNICIPIUL VASLUI",161945,24,2,1602,1019,933,86,1012,7,"MUNICIPIUL VASLUI",,4,,489,523
38,"Vaslui",378,"378-MUNICIPIUL VASLUI",161945,25,2,1400,1135,959,176,1125,10,"MUNICIPIUL VASLUI",,4,,581,544
38,"Vaslui",378,"378-MUNICIPIUL VASLUI",161945,26,2,1715,1194,1113,81,1185,9,"MUNICIPIUL VASLUI",,4,,610,575
38,"Vaslui",378,"378-MUNICIPIUL VASLUI",161945,27,2,1809,1440,1226,214,1432,8,"MUNICIPIUL VASLUI",,4,,719,713
38,"Vaslui",378,"378-MUNICIPIUL VASLUI",161945,28,2,1711,1215,1185,30,1206,9,"MUNICIPIUL VASLUI",,4,,668,538
38,"Vaslui",378,"378-MUNICIPIUL VASLUI",161945,29,2,1759,1299,1210,89,1292,7,"MUNICIPIUL VASLUI",,4,,684,608
38,"Vaslui",378,"378-MUNICIPIUL VASLUI",161945,30,2,1545,1163,1087,76,1157,6,"MUNICIPIUL VASLUI",,4,,551,606
38,"Vaslui",378,"378-MUNICIPIUL VASLUI",161945,31,2,1834,1480,1275,205,1469,11,"MUNICIPIUL VASLUI",,4,,779,690
38,"Vaslui",378,"378-MUNICIPIUL VASLUI",161945,32,2,2032,1483,1349,134,1470,13,"MUNICIPIUL VASLUI",,4,,783,687
38,"Vaslui",378,"378-MUNICIPIUL VASLUI",161945,33,2,443,335,214,121,327,8,"MUNICIPIUL VASLUI",,4,,232,95
38,"Vaslui",378,"378-MUNICIPIUL VASLUI",161945,34,2,520,427,336,91,419,8,"MUNICIPIUL VASLUI",,4,,299,120
38,"Vaslui",378,"378-MUNICIPIUL VASLUI",161945,35,2,933,658,577,81,651,7,"MUNICIPIUL VASLUI",,4,,394,257
38,"Vaslui",378,"378-MUNICIPIUL VASLUI",161945,36,2,1066,932,748,184,916,16,"MUNICIPIUL VASLUI",,4,,453,463
38,"Vaslui",378,"378-MUNICIPIUL VASLUI",161945,37,2,801,607,479,128,595,12,"MUNICIPIUL VASLUI",,4,,356,239
38,"Vaslui",378,"378-MUNICIPIUL VASLUI",161945,38,2,416,424,398,26,416,8,"MUNICIPIUL VASLUI",,4,,127,289
38,"Vaslui",378,"378-MUNICIPIUL BARLAD",161794,39,2,1837,1301,1210,91,1283,18,"MUNICIPIUL BARLAD",,4,,798,485
38,"Vaslui",378,"378-MUNICIPIUL BARLAD",161794,40,2,1761,1348,1178,170,1330,18,"MUNICIPIUL BARLAD",,4,,807,523
38,"Vaslui",378,"378-MUNICIPIUL BARLAD",161794,41,2,1866,1340,1257,83,1332,8,"MUNICIPIUL BARLAD",,4,,785,547
38,"Vaslui",378,"378-MUNICIPIUL BARLAD",161794,42,2,1477,1085,997,88,1081,4,"MUNICIPIUL BARLAD",,4,,564,517
38,"Vaslui",378,"378-MUNICIPIUL BARLAD",161794,43,2,2154,1532,1422,110,1515,17,"MUNICIPIUL BARLAD",,4,,942,573
38,"Vaslui",378,"378-MUNICIPIUL BARLAD",161794,44,2,2201,1617,1500,117,1610,7,"MUNICIPIUL BARLAD",,4,,897,713
38,"Vaslui",378,"378-MUNICIPIUL BARLAD",161794,45,2,1932,1400,1295,105,1398,2,"MUNICIPIUL BARLAD",,4,,807,591
38,"Vaslui",378,"378-MUNICIPIUL BARLAD",161794,46,2,2023,1411,1293,118,1406,5,"MUNICIPIUL BARLAD",,4,,768,638
38,"Vaslui",378,"378-MUNICIPIUL BARLAD",161794,47,2,1534,1129,1007,122,1123,6,"MUNICIPIUL BARLAD",,4,,624,499
38,"Vaslui",378,"378-MUNICIPIUL BARLAD",161794,48,2,1986,1453,1253,200,1445,8,"MUNICIPIUL BARLAD",,4,,898,547
38,"Vaslui",378,"378-MUNICIPIUL BARLAD",161794,49,2,2324,1770,1462,308,1770,0,"MUNICIPIUL BARLAD",,4,,967,803
38,"Vaslui",378,"378-MUNICIPIUL BARLAD",161794,50,2,1944,1447,1277,170,1442,5,"MUNICIPIUL BARLAD",,4,,761,681
38,"Vaslui",378,"378-MUNICIPIUL BARLAD",161794,51,2,2022,1428,1205,223,1418,10,"MUNICIPIUL BARLAD",,4,,812,606
38,"Vaslui",378,"378-MUNICIPIUL BARLAD",161794,52,2,1954,1455,1226,229,1453,2,"MUNICIPIUL BARLAD",,4,,830,623
38,"Vaslui",378,"378-MUNICIPIUL BARLAD",161794,53,2,2346,1626,1457,169,1619,7,"MUNICIPIUL BARLAD",,4,,951,668
38,"Vaslui",378,"378-MUNICIPIUL BARLAD",161794,54,2,1630,1180,1106,74,1169,11,"MUNICIPIUL BARLAD",,4,,744,425
38,"Vaslui",378,"378-MUNICIPIUL BARLAD",161794,55,2,1519,1121,1045,76,1116,5,"MUNICIPIUL BARLAD",,4,,650,466
38,"Vaslui",378,"378-MUNICIPIUL BARLAD",161794,56,2,1558,1065,997,68,1049,16,"MUNICIPIUL BARLAD",,4,,621,428
38,"Vaslui",378,"378-MUNICIPIUL BARLAD",161794,57,2,1629,1108,1057,51,1097,11,"MUNICIPIUL BARLAD",,4,,631,466
38,"Vaslui",378,"378-MUNICIPIUL BARLAD",161794,58,2,1593,1160,1082,78,1155,5,"MUNICIPIUL BARLAD",,4,,635,520
38,"Vaslui",378,"378-MUNICIPIUL BARLAD",161794,59,2,1707,1305,1182,123,1299,6,"MUNICIPIUL BARLAD",,4,,656,643
38,"Vaslui",378,"378-MUNICIPIUL BARLAD",161794,60,2,1567,1186,1064,122,1183,3,"MUNICIPIUL BARLAD",,4,,597,586
38,"Vaslui",378,"378-MUNICIPIUL BARLAD",161794,61,2,1527,1081,1043,38,1076,5,"MUNICIPIUL BARLAD",,4,,550,526
38,"Vaslui",378,"378-MUNICIPIUL BARLAD",161794,62,2,2011,1505,1338,167,1496,9,"MUNICIPIUL BARLAD",,4,,775,721
38,"Vaslui",378,"378-MUNICIPIUL BARLAD",161794,63,2,2204,1567,1469,98,1555,12,"MUNICIPIUL BARLAD",,4,,815,740
38,"Vaslui",378,"378-MUNICIPIUL BARLAD",161794,64,2,1949,1349,1260,89,1343,6,"MUNICIPIUL BARLAD",,4,,756,587
38,"Vaslui",378,"378-MUNICIPIUL BARLAD",161794,65,2,1599,1133,1037,96,1129,4,"MUNICIPIUL BARLAD",,4,,580,549
38,"Vaslui",378,"378-MUNICIPIUL BARLAD",161794,66,2,1635,1131,1040,91,1125,6,"MUNICIPIUL BARLAD",,4,,578,547
38,"Vaslui",378,"378-MUNICIPIUL BARLAD",161794,67,2,1723,1340,1175,165,1340,0,"MUNICIPIUL BARLAD",,4,,742,598
38,"Vaslui",378,"378-MUNICIPIUL BARLAD",161794,68,2,2060,1490,1362,128,1478,12,"MUNICIPIUL BARLAD",,4,,804,674
38,"Vaslui",378,"378-MUNICIPIUL BARLAD",161794,69,2,2192,1626,1522,104,1622,4,"MUNICIPIUL BARLAD",,4,,740,882
38,"Vaslui",378,"378-MUNICIPIUL BARLAD",161794,70,2,0,465,0,465,457,8,"MUNICIPIUL BARLAD",,4,,304,153
38,"Vaslui",378,"378-MUNICIPIUL BARLAD",161794,71,2,612,600,575,25,593,7,"MUNICIPIUL BARLAD",,4,,363,230
38,"Vaslui",378,"378-MUNICIPIUL HUSI",161829,72,2,1428,1034,960,74,1033,1,"MUNICIPIUL HUSI",,4,,519,514
38,"Vaslui",378,"378-MUNICIPIUL HUSI",161829,73,2,1803,1336,1176,160,1327,9,"MUNICIPIUL HUSI",,4,,711,616
38,"Vaslui",378,"378-MUNICIPIUL HUSI",161829,74,2,1611,1180,1071,109,1176,4,"MUNICIPIUL HUSI",,4,,583,593
38,"Vaslui",378,"378-MUNICIPIUL HUSI",161829,75,2,1424,1008,936,72,1000,8,"MUNICIPIUL HUSI",,4,,461,539
38,"Vaslui",378,"378-MUNICIPIUL HUSI",161829,76,2,2025,1456,1200,256,1447,9,"MUNICIPIUL HUSI",,4,,700,747
38,"Vaslui",378,"378-MUNICIPIUL HUSI",161829,77,2,1155,871,767,104,862,9,"MUNICIPIUL HUSI",,4,,458,404
38,"Vaslui",378,"378-MUNICIPIUL HUSI",161829,78,2,1222,977,713,264,972,5,"MUNICIPIUL HUSI",,4,,491,481
38,"Vaslui",378,"378-MUNICIPIUL HUSI",161829,79,2,1798,1241,1070,171,1236,5,"MUNICIPIUL HUSI",,4,,689,547
38,"Vaslui",378,"378-MUNICIPIUL HUSI",161829,80,2,1341,978,874,104,973,5,"MUNICIPIUL HUSI",,4,,517,456
38,"Vaslui",378,"378-MUNICIPIUL HUSI",161829,81,2,939,668,621,47,660,8,"MUNICIPIUL HUSI",,4,,242,418
38,"Vaslui",378,"378-MUNICIPIUL HUSI",161829,82,2,1639,1318,1151,167,1305,13,"MUNICIPIUL HUSI",,4,,454,851
38,"Vaslui",378,"378-MUNICIPIUL HUSI",161829,83,2,1805,1376,1174,202,1363,13,"MUNICIPIUL HUSI",,4,,692,671
38,"Vaslui",378,"378-MUNICIPIUL HUSI",161829,84,2,2057,1582,1451,131,1560,22,"MUNICIPIUL HUSI",,4,,852,708
38,"Vaslui",378,"378-MUNICIPIUL HUSI",161829,85,2,1860,1327,1169,158,1321,6,"MUNICIPIUL HUSI",,4,,654,667
38,"Vaslui",378,"378-MUNICIPIUL HUSI",161829,86,2,487,337,261,76,334,3,"MUNICIPIUL HUSI",,4,,141,193
38,"Vaslui",378,"378-MUNICIPIUL HUSI",161829,87,2,0,151,0,151,150,1,"MUNICIPIUL HUSI",,4,,74,76
38,"Vaslui",378,"378-MUNICIPIUL HUSI",161829,88,2,109,152,99,53,149,3,"MUNICIPIUL HUSI",,4,,99,50
38,"Vaslui",378,"378-ORAS NEGRESTI",161856,89,2,2387,1823,1613,210,1816,7,"ORAS NEGRESTI",,4,,932,884
38,"Vaslui",378,"378-ORAS NEGRESTI",161856,90,2,1452,1135,961,174,1120,15,"ORAS NEGRESTI",,4,,641,479
38,"Vaslui",378,"378-ORAS NEGRESTI",161856,91,2,836,567,525,42,561,6,"ORAS NEGRESTI",,4,,332,229
38,"Vaslui",378,"378-ORAS NEGRESTI",161856,92,2,1010,686,615,71,676,10,"ORAS NEGRESTI",,4,,441,235
38,"Vaslui",378,"378-ORAS NEGRESTI",161856,93,2,707,562,504,58,553,9,"ORAS NEGRESTI",,4,,366,187
38,"Vaslui",378,"378-ORAS NEGRESTI",161856,94,2,373,278,239,39,275,3,"ORAS NEGRESTI",,4,,200,75
38,"Vaslui",378,"378-ORAS NEGRESTI",161856,95,2,0,88,0,88,88,0,"ORAS NEGRESTI",,4,,54,34
38,"Vaslui",378,"378-ALBESTI",162014,96,2,1187,911,797,114,902,9,"ALBESTI",,4,,612,290
38,"Vaslui",378,"378-ALBESTI",162014,97,2,1250,877,748,129,861,16,"ALBESTI",,4,,511,350
38,"Vaslui",378,"378-ALEXANDRU VLAHUTA",162069,98,2,962,485,335,150,481,4,"ALEXANDRU VLAHUTA",,4,,364,117
38,"Vaslui",378,"378-ALEXANDRU VLAHUTA",162069,99,2,503,406,337,69,399,7,"ALEXANDRU VLAHUTA",,4,,351,48
38,"Vaslui",378,"378-ALEXANDRU VLAHUTA",162069,100,2,590,461,310,151,449,12,"ALEXANDRU VLAHUTA",,4,,349,100
38,"Vaslui",378,"378-ALEXANDRU VLAHUTA",162069,101,2,792,410,326,84,403,7,"ALEXANDRU VLAHUTA",,4,,215,188
38,"Vaslui",378,"378-ALEXANDRU VLAHUTA",162069,102,2,369,351,164,187,342,9,"ALEXANDRU VLAHUTA",,4,,263,79
38,"Vaslui",378,"378-ARSURA",162149,103,2,626,605,528,77,599,6,"ARSURA",,4,,467,132
38,"Vaslui",378,"378-ARSURA",162149,104,2,771,665,542,123,658,7,"ARSURA",,4,,412,246
38,"Vaslui",378,"378-BANCA",162194,105,2,941,736,549,187,727,9,"BANCA",,4,,550,177
38,"Vaslui",378,"378-BANCA",162194,106,2,527,332,278,54,324,8,"BANCA",,4,,269,55
38,"Vaslui",378,"378-BANCA",162194,107,2,1024,603,520,83,584,19,"BANCA",,4,,395,189
38,"Vaslui",378,"378-BANCA",162194,108,2,683,428,369,59,416,12,"BANCA",,4,,330,86
38,"Vaslui",378,"378-BANCA",162194,109,2,578,343,303,40,332,11,"BANCA",,4,,250,82
38,"Vaslui",378,"378-BANCA",162194,110,2,615,421,326,95,413,8,"BANCA",,4,,286,127
38,"Vaslui",378,"378-BACANI",162327,111,2,485,350,304,46,346,4,"BACANI",,4,,203,143
38,"Vaslui",378,"378-BACANI",162327,112,2,1339,770,698,72,748,22,"BACANI",,4,,528,220
38,"Vaslui",378,"378-BACESTI",162381,113,2,2234,1498,1268,230,1461,37,"BACESTI",,4,,944,517
38,"Vaslui",378,"378-BACESTI",162381,114,2,518,376,302,74,371,5,"BACESTI",,4,,271,100
38,"Vaslui",378,"378-BACESTI",162381,115,2,38,62,37,25,62,0,"BACESTI",,4,,39,23
38,"Vaslui",378,"378-BALTENI",162452,116,2,1293,883,790,93,870,13,"BALTENI",,4,,612,258
38,"Vaslui",378,"378-BEREZENI",162498,117,2,2087,1464,1396,68,1439,25,"BEREZENI",,4,,1144,295
38,"Vaslui",378,"378-BEREZENI",162498,118,2,1064,854,794,60,850,4,"BEREZENI",,4,,708,142
38,"Vaslui",378,"378-BEREZENI",162498,119,2,931,534,449,85,530,4,"BEREZENI",,4,,420,110
38,"Vaslui",378,"378-BEREZENI",162498,120,2,326,303,193,110,299,4,"BEREZENI",,4,,249,50
38,"Vaslui",378,"378-BLAGESTI",162559,121,2,1232,705,563,142,682,23,"BLAGESTI",,4,,505,177
38,"Vaslui",378,"378-BLAGESTI",162559,122,2,507,254,188,66,246,8,"BLAGESTI",,4,,171,75
38,"Vaslui",378,"378-BOGDANA",162595,123,2,1098,666,571,95,658,8,"BOGDANA",,4,,419,239
38,"Vaslui",378,"378-BOGDANA",162595,124,2,298,193,165,28,191,2,"BOGDANA",,4,,146,45
38,"Vaslui",378,"378-BOGDANESTI",162693,125,2,1114,776,632,144,770,6,"BOGDANESTI",,4,,609,161
38,"Vaslui",378,"378-BOGDANESTI",162693,126,2,310,231,168,63,228,3,"BOGDANESTI",,4,,169,59
38,"Vaslui",378,"378-BOGDANESTI",162693,127,2,1157,755,613,142,742,13,"BOGDANESTI",,4,,570,172
38,"Vaslui",378,"378-BOGDANITA",162791,128,2,768,399,324,75,396,3,"BOGDANITA",,4,,292,104
38,"Vaslui",378,"378-BOGDANITA",162791,129,2,460,310,251,59,304,6,"BOGDANITA",,4,,181,123
38,"Vaslui",378,"378-BOTESTI",162871,130,2,980,699,577,122,687,12,"BOTESTI",,4,,516,171
38,"Vaslui",378,"378-BOTESTI",162871,131,2,968,730,626,104,673,7,"BOTESTI",,4,,500,173
38,"Vaslui",378,"378-BUNESTI-AVERESTI",162924,132,2,1254,804,685,119,798,6,"BUNESTI-AVERESTI",,4,,643,155
38,"Vaslui",378,"378-BUNESTI-AVERESTI",162924,133,2,1168,797,648,149,793,4,"BUNESTI-AVERESTI",,4,,590,203
38,"Vaslui",378,"378-CODAESTI",163002,134,2,1269,835,732,103,826,9,"CODAESTI",,4,,593,233
38,"Vaslui",378,"378-CODAESTI",163002,135,2,1162,674,592,82,669,5,"CODAESTI",,4,,475,194
38,"Vaslui",378,"378-CODAESTI",163002,136,2,1051,701,624,77,691,10,"CODAESTI",,4,,529,162
38,"Vaslui",378,"378-CODAESTI",163002,137,2,392,290,260,30,282,8,"CODAESTI",,4,,217,65
38,"Vaslui",378,"378-COROIESTI",162835,138,2,847,571,446,125,563,8,"COROIESTI",,4,,412,151
38,"Vaslui",378,"378-COROIESTI",162835,139,2,899,612,511,101,605,7,"COROIESTI",,4,,417,188
38,"Vaslui",378,"378-COSTESTI",163137,140,2,1693,1133,970,163,1113,20,"COSTESTI",,4,,610,503
38,"Vaslui",378,"378-COSTESTI",163137,141,2,583,434,334,100,412,11,"COSTESTI",,4,,275,137
38,"Vaslui",378,"378-COSTESTI",163137,142,2,250,257,196,61,252,5,"COSTESTI",,4,,160,92
38,"Vaslui",378,"378-CRETESTI",163208,143,2,1577,979,796,183,956,23,"CRETESTI",,4,,630,326
38,"Vaslui",378,"378-DANESTI",163253,144,2,620,372,294,78,365,7,"DANESTI",,4,,223,142
38,"Vaslui",378,"378-DANESTI",163253,145,2,991,583,539,44,579,4,"DANESTI",,4,,411,168
38,"Vaslui",378,"378-DANESTI",163253,146,2,329,240,182,58,234,6,"DANESTI",,4,,176,58
38,"Vaslui",378,"378-DANESTI",163253,147,2,211,137,98,39,135,2,"DANESTI",,4,,92,43
38,"Vaslui",378,"378-DELENI",163324,148,2,1383,959,816,143,936,23,"DELENI",,4,,574,362
38,"Vaslui",378,"378-DELENI",163324,149,2,527,400,338,62,395,5,"DELENI",,4,,272,123
38,"Vaslui",378,"378-DELESTI",163379,150,2,961,611,505,106,601,10,"DELESTI",,4,,446,155
38,"Vaslui",378,"378-DELESTI",163379,151,2,1193,741,646,95,721,20,"DELESTI",,4,,542,179
38,"Vaslui",378,"378-DELESTI",163379,152,2,336,236,190,46,232,4,"DELESTI",,4,,152,80
38,"Vaslui",378,"378-DELESTI",163379,153,2,658,494,406,88,485,9,"DELESTI",,4,,268,217
38,"Vaslui",378,"378-DELESTI",163379,154,2,875,517,419,98,508,9,"DELESTI",,4,,328,180
38,"Vaslui",378,"378-DIMITRIE CANTEMIR",164277,155,2,597,448,376,72,446,2,"DIMITRIE CANTEMIR",,4,,326,120
38,"Vaslui",378,"378-DIMITRIE CANTEMIR",164277,156,2,613,395,335,60,387,8,"DIMITRIE CANTEMIR",,4,,246,141
38,"Vaslui",378,"378-DIMITRIE CANTEMIR",164277,157,2,686,460,420,40,451,9,"DIMITRIE CANTEMIR",,4,,338,113
38,"Vaslui",378,"378-DIMITRIE CANTEMIR",164277,158,2,601,341,292,49,339,2,"DIMITRIE CANTEMIR",,4,,229,110
38,"Vaslui",378,"378-DRAGOMIRESTI",163486,159,2,915,549,459,90,545,4,"DRAGOMIRESTI",,4,,405,140
38,"Vaslui",378,"378-DRAGOMIRESTI",163486,160,2,508,354,260,94,350,4,"DRAGOMIRESTI",,4,,219,131
38,"Vaslui",378,"378-DRAGOMIRESTI",163486,161,2,1203,820,694,126,814,6,"DRAGOMIRESTI",,4,,728,86
38,"Vaslui",378,"378-DRAGOMIRESTI",163486,162,2,710,448,373,75,440,8,"DRAGOMIRESTI",,4,,294,146
38,"Vaslui",378,"378-DRANCENI",163618,163,2,1874,1191,1017,174,1173,18,"DRANCENI",,4,,712,461
38,"Vaslui",378,"378-DRANCENI",163618,164,2,1412,987,804,183,983,4,"DRANCENI",,4,,685,298
38,"Vaslui",378,"378-DRANCENI",163618,165,2,437,360,279,81,350,10,"DRANCENI",,4,,230,120
38,"Vaslui",378,"378-DUDA-EPURENI",163681,166,2,1465,933,867,66,911,22,"DUDA-EPURENI",,4,,635,276
38,"Vaslui",378,"378-DUDA-EPURENI",163681,167,2,1326,918,817,101,905,13,"DUDA-EPURENI",,4,,557,348
38,"Vaslui",378,"378-DUDA-EPURENI",163681,168,2,1099,780,693,87,770,9,"DUDA-EPURENI",,4,,340,430
38,"Vaslui",378,"378-DUMESTI",163734,169,2,1808,1056,933,123,1042,14,"DUMESTI",,4,,657,385
38,"Vaslui",378,"378-DUMESTI",163734,170,2,891,577,499,78,573,4,"DUMESTI",,4,,391,182
38,"Vaslui",378,"378-EPURENI",163690,171,2,1977,1118,906,212,1104,14,"EPURENI",,4,,806,298
38,"Vaslui",378,"378-EPURENI",163690,172,2,693,406,313,93,398,8,"EPURENI",,4,,270,128
38,"Vaslui",378,"378-FALCIU",163832,173,2,1106,711,596,115,708,3,"FALCIU",,4,,408,300
38,"Vaslui",378,"378-FALCIU",163832,174,2,1238,877,713,164,860,17,"FALCIU",,4,,552,308
38,"Vaslui",378,"378-FALCIU",163832,175,2,549,372,305,67,363,4,"FALCIU",,4,,253,110
38,"Vaslui",378,"378-FALCIU",163832,176,2,921,718,610,108,707,11,"FALCIU",,4,,519,188
38,"Vaslui",378,"378-FALCIU",163832,177,2,483,360,329,31,351,9,"FALCIU",,4,,255,96
38,"Vaslui",378,"378-FALCIU",163832,178,2,571,425,360,65,420,5,"FALCIU",,4,,256,164
38,"Vaslui",378,"378-GAGESTI",163903,179,2,466,310,275,35,309,1,"GAGESTI",,4,,204,105
38,"Vaslui",378,"378-GAGESTI",163903,180,2,933,582,522,60,579,3,"GAGESTI",,4,,403,176
38,"Vaslui",378,"378-GAGESTI",163903,181,2,336,298,251,47,291,7,"GAGESTI",,4,,202,89
38,"Vaslui",378,"378-GHERGHESTI",163967,182,2,990,546,402,144,540,6,"GHERGHESTI",,4,,395,145
38,"Vaslui",378,"378-GHERGHESTI",163967,183,2,317,215,179,36,211,4,"GHERGHESTI",,4,,158,53
38,"Vaslui",378,"378-GHERGHESTI",163967,184,2,281,198,142,56,195,3,"GHERGHESTI",,4,,155,40
38,"Vaslui",378,"378-GHERGHESTI",163967,185,2,570,433,305,128,429,4,"GHERGHESTI",,4,,312,117
38,"Vaslui",378,"378-GARCENI",164062,186,2,1185,772,661,111,764,8,"GARCENI",,4,,495,269
38,"Vaslui",378,"378-GARCENI",164062,187,2,782,568,461,107,562,5,"GARCENI",,4,,438,124
38,"Vaslui",378,"378-GRIVITA",164133,188,2,1088,770,653,117,757,13,"GRIVITA",,4,,484,273
38,"Vaslui",378,"378-GRIVITA",164133,189,2,896,613,518,95,604,9,"GRIVITA",,4,,413,191
38,"Vaslui",378,"378-GRIVITA",164133,190,2,484,355,264,91,351,4,"GRIVITA",,4,,277,74
38,"Vaslui",378,"378-GRIVITA",164133,191,2,669,616,546,70,607,9,"GRIVITA",,4,,460,147
38,"Vaslui",378,"378-GRIVITA",164133,192,2,587,390,308,82,382,6,"GRIVITA",,4,,246,136
38,"Vaslui",378,"378-HOCENI",164197,193,2,486,388,289,99,378,10,"HOCENI",,4,,306,72
38,"Vaslui",378,"378-HOCENI",164197,194,2,491,380,308,72,375,5,"HOCENI",,4,,298,77
38,"Vaslui",378,"378-HOCENI",164197,195,2,649,409,347,62,395,14,"HOCENI",,4,,322,73
38,"Vaslui",378,"378-HOCENI",164197,196,2,491,352,275,77,347,5,"HOCENI",,4,,267,80
38,"Vaslui",378,"378-HOCENI",164197,197,2,660,500,398,102,494,6,"HOCENI",,4,,368,126
38,"Vaslui",378,"378-IANA",164339,198,2,2120,1083,909,174,1061,18,"IANA",,4,,643,418
38,"Vaslui",378,"378-IANA",164339,199,2,603,602,324,278,594,8,"IANA",,4,,477,117
38,"Vaslui",378,"378-IVANESTI",164393,200,2,1336,801,629,172,786,15,"IVANESTI",,4,,583,203
38,"Vaslui",378,"378-IVANESTI",164393,201,2,921,764,538,226,754,10,"IVANESTI",,4,,613,141
38,"Vaslui",378,"378-IVANESTI",164393,202,2,674,457,287,170,449,8,"IVANESTI",,4,,359,90
38,"Vaslui",378,"378-IVANESTI",164393,203,2,950,587,445,142,571,16,"IVANESTI",,4,,444,127
38,"Vaslui",378,"378-IVESTI",164543,204,2,2341,1466,1451,15,1446,20,"IVESTI",,4,,1108,338
38,"Vaslui",378,"378-IVESTI",164543,205,2,1374,951,909,42,937,14,"IVESTI",,4,,673,264
38,"Vaslui",378,"378-LAZA",164598,206,2,1826,1072,937,135,1058,14,"LAZA",,4,,746,312
38,"Vaslui",378,"378-LAZA",164598,207,2,813,615,500,115,605,10,"LAZA",,4,,457,148
38,"Vaslui",378,"378-LAZA",164598,208,2,1759,1091,908,183,1075,16,"LAZA",,4,,714,361
38,"Vaslui",378,"378-LAZA",164598,209,2,342,221,184,37,210,11,"LAZA",,4,,169,41
38,"Vaslui",378,"378-LIPOVAT",164687,210,2,1683,1271,1136,135,1257,14,"LIPOVAT",,4,,883,374
38,"Vaslui",378,"378-LIPOVAT",164687,211,2,822,598,540,58,585,13,"LIPOVAT",,4,,361,224
38,"Vaslui",378,"378-LIPOVAT",164687,212,2,581,390,343,47,382,8,"LIPOVAT",,4,,250,132
38,"Vaslui",378,"378-LUNCA BANULUI",164749,213,2,1689,1256,1122,134,1107,15,"LUNCA BANULUI",,4,,774,333
38,"Vaslui",378,"378-LUNCA BANULUI",164749,214,2,845,504,450,54,497,7,"LUNCA BANULUI",,4,,327,170
38,"Vaslui",378,"378-LUNCA BANULUI",164749,215,2,447,323,260,63,320,3,"LUNCA BANULUI",,4,,187,133
38,"Vaslui",378,"378-MALUSTENI",164829,216,2,842,513,419,94,506,7,"MALUSTENI",,4,,347,159
38,"Vaslui",378,"378-MALUSTENI",164829,217,2,798,562,479,83,551,11,"MALUSTENI",,4,,345,206
38,"Vaslui",378,"378-MALUSTENI",164829,218,2,913,561,481,80,557,4,"MALUSTENI",,4,,402,155
38,"Vaslui",378,"378-MICLESTI",162238,219,2,962,641,454,187,632,9,"MICLESTI",,4,,476,156
38,"Vaslui",378,"378-MICLESTI",162238,220,2,1094,742,600,142,730,12,"MICLESTI",,4,,515,215
38,"Vaslui",378,"378-MICLESTI",162238,221,2,374,315,241,74,312,3,"MICLESTI",,4,,250,62
38,"Vaslui",378,"378-MUNTENII DE JOS",164936,222,2,1930,1319,1114,205,1311,8,"MUNTENII DE JOS",,4,,912,399
38,"Vaslui",378,"378-MUNTENII DE JOS",164936,223,2,848,626,527,99,611,15,"MUNTENII DE JOS",,4,,453,158
38,"Vaslui",378,"378-MURGENI",164990,224,2,2510,1666,1395,271,1648,18,"MURGENI",,4,,896,752
38,"Vaslui",378,"378-MURGENI",164990,225,2,531,441,347,94,434,7,"MURGENI",,4,,304,130
38,"Vaslui",378,"378-MURGENI",164990,226,2,480,397,297,100,394,3,"MURGENI",,4,,209,185
38,"Vaslui",378,"378-MURGENI",164990,227,2,866,370,312,58,362,8,"MURGENI",,4,,237,125
38,"Vaslui",378,"378-MURGENI",164990,228,2,327,366,127,239,363,3,"MURGENI",,4,,221,142
38,"Vaslui",378,"378-OLTENESTI",165069,229,2,740,429,335,94,420,9,"OLTENESTI",,4,,227,193
38,"Vaslui",378,"378-OLTENESTI",165069,230,2,620,517,413,104,513,4,"OLTENESTI",,4,,395,118
38,"Vaslui",378,"378-OLTENESTI",165069,231,2,1016,786,699,87,780,6,"OLTENESTI",,4,,588,192
38,"Vaslui",378,"378-OSESTI",165130,232,2,1336,900,783,117,886,14,"OSESTI",,4,,583,303
38,"Vaslui",378,"378-OSESTI",165130,233,2,1010,627,544,83,616,11,"OSESTI",,4,,436,180
38,"Vaslui",378,"378-PADURENI",165167,234,2,2152,1254,1131,123,1237,17,"PADURENI",,4,,748,489
38,"Vaslui",378,"378-PADURENI",165167,235,2,493,359,323,36,354,5,"PADURENI",,4,,226,128
38,"Vaslui",378,"378-PADURENI",165167,236,2,1288,751,696,55,734,17,"PADURENI",,4,,419,315
38,"Vaslui",378,"378-PERIENI",165274,237,2,2620,1523,1355,168,1496,27,"PERIENI",,4,,1241,255
38,"Vaslui",378,"378-PERIENI",165274,238,2,692,527,359,168,519,8,"PERIENI",,4,,372,147
38,"Vaslui",378,"378-PERIENI",165274,239,2,324,270,188,82,260,10,"PERIENI",,4,,133,127
38,"Vaslui",378,"378-POIENESTI",165336,240,2,1099,644,571,73,636,8,"POIENESTI",,4,,495,141
38,"Vaslui",378,"378-POIENESTI",165336,241,2,608,499,385,114,491,8,"POIENESTI",,4,,359,132
38,"Vaslui",378,"378-POGANA",165416,242,2,1174,572,485,87,565,7,"POGANA",,4,,439,126
38,"Vaslui",378,"378-POGANA",165416,243,2,1160,405,315,90,397,8,"POGANA",,4,,271,126
38,"Vaslui",378,"378-PUIESTI",165470,244,2,1590,1050,840,210,1028,22,"PUIESTI",,4,,806,222
38,"Vaslui",378,"378-PUIESTI",165470,245,2,403,301,216,85,297,4,"PUIESTI",,4,,248,49
38,"Vaslui",378,"378-PUIESTI",165470,246,2,135,279,79,200,274,5,"PUIESTI",,4,,232,42
38,"Vaslui",378,"378-PUIESTI",165470,247,2,948,514,382,132,506,8,"PUIESTI",,4,,431,75
38,"Vaslui",378,"378-PUIESTI",165470,248,2,430,332,243,89,322,10,"PUIESTI",,4,,268,54
38,"Vaslui",378,"378-PUIESTI",165470,249,2,321,226,167,59,221,5,"PUIESTI",,4,,174,47
38,"Vaslui",378,"378-PUNGESTI",165611,250,2,1100,655,546,109,648,7,"PUNGESTI",,4,,431,217
38,"Vaslui",378,"378-PUNGESTI",165611,251,2,582,455,344,111,448,7,"PUNGESTI",,4,,282,166
38,"Vaslui",378,"378-PUNGESTI",165611,252,2,363,333,190,143,323,10,"PUNGESTI",,4,,175,148
38,"Vaslui",378,"378-PUNGESTI",165611,253,2,567,332,254,78,325,7,"PUNGESTI",,4,,239,86
38,"Vaslui",378,"378-REBRICEA",165719,254,2,1602,878,656,222,865,13,"REBRICEA",,4,,589,276
38,"Vaslui",378,"378-REBRICEA",165719,255,2,1183,699,562,137,694,5,"REBRICEA",,4,,502,192
38,"Vaslui",378,"378-ROSIESTI",165817,256,2,1128,723,619,104,712,11,"ROSIESTI",,4,,480,232
38,"Vaslui",378,"378-ROSIESTI",165817,257,2,585,438,375,63,433,5,"ROSIESTI",,4,,354,79
38,"Vaslui",378,"378-ROSIESTI",165817,258,2,606,416,352,64,409,7,"ROSIESTI",,4,,324,85
38,"Vaslui",378,"378-ROSIESTI",165817,259,2,397,289,242,47,281,8,"ROSIESTI",,4,,208,73
38,"Vaslui",378,"378-ROSIESTI",165817,260,2,257,250,180,70,248,2,"ROSIESTI",,4,,178,70
38,"Vaslui",378,"378-SOLESTI",165899,261,2,1080,787,682,105,780,7,"SOLESTI",,4,,632,148
38,"Vaslui",378,"378-SOLESTI",165899,262,2,873,569,421,148,561,8,"SOLESTI",,4,,367,194
38,"Vaslui",378,"378-SOLESTI",165899,263,2,628,327,258,69,323,4,"SOLESTI",,4,,216,107
38,"Vaslui",378,"378-SOLESTI",165899,264,2,546,376,172,204,372,4,"SOLESTI",,4,,281,91
38,"Vaslui",378,"378-STANILESTI",165979,265,2,2866,1712,1563,149,1691,21,"STANILESTI",,4,,1181,510
38,"Vaslui",378,"378-STANILESTI",165979,266,2,455,260,218,42,258,2,"STANILESTI",,4,,191,67
38,"Vaslui",378,"378-STANILESTI",165979,267,2,1208,820,684,136,806,14,"STANILESTI",,4,,534,272
38,"Vaslui",378,"378-STEFAN CEL MARE",166057,268,2,1491,936,806,130,923,13,"STEFAN CEL MARE",,4,,650,273
38,"Vaslui",378,"378-STEFAN CEL MARE",166057,269,2,1027,740,546,194,726,14,"STEFAN CEL MARE",,4,,492,234
38,"Vaslui",378,"378-SULETEA",166137,270,2,1538,885,714,171,872,13,"SULETEA",,4,,554,318
38,"Vaslui",378,"378-SULETEA",166137,271,2,520,404,315,89,400,4,"SULETEA",,4,,307,93
38,"Vaslui",378,"378-TANACU",166182,272,2,1990,1225,1037,188,1204,21,"TANACU",,4,,809,395
38,"Vaslui",378,"378-TANACU",166182,273,2,981,686,576,110,673,13,"TANACU",,4,,419,254
38,"Vaslui",378,"378-TANACU",166182,274,2,1339,962,827,135,954,8,"TANACU",,4,,626,328
38,"Vaslui",378,"378-TACUTA",166235,275,2,751,497,424,73,493,4,"TACUTA",,4,,381,112
38,"Vaslui",378,"378-TACUTA",166235,276,2,291,220,166,54,218,2,"TACUTA",,4,,172,46
38,"Vaslui",378,"378-TACUTA",166235,277,2,500,432,369,63,430,2,"TACUTA",,4,,340,90
38,"Vaslui",378,"378-TACUTA",166235,278,2,391,286,236,50,280,6,"TACUTA",,4,,226,54
38,"Vaslui",378,"378-TACUTA",166235,279,2,745,444,389,55,439,5,"TACUTA",,4,,318,121
38,"Vaslui",378,"378-TATARANI",163315,280,2,1005,688,578,110,681,7,"TATARANI",,4,,492,189
38,"Vaslui",378,"378-TATARANI",163315,281,2,590,362,308,54,355,7,"TATARANI",,4,,279,76
38,"Vaslui",378,"378-TATARANI",163315,282,2,572,412,366,46,406,6,"TATARANI",,4,,337,69
38,"Vaslui",378,"378-TODIRESTI",166413,283,2,1771,1051,922,129,1032,19,"TODIRESTI",,4,,740,292
38,"Vaslui",378,"378-TODIRESTI",166413,284,2,790,530,474,56,527,3,"TODIRESTI",,4,,424,103
38,"Vaslui",378,"378-TODIRESTI",166413,285,2,1472,822,751,71,796,26,"TODIRESTI",,4,,506,290
38,"Vaslui",378,"378-TUTOVA",166529,286,2,1289,964,698,266,953,11,"TUTOVA",,4,,636,317
38,"Vaslui",378,"378-TUTOVA",166529,287,2,625,584,453,131,579,5,"TUTOVA",,4,,450,129
38,"Vaslui",378,"378-TUTOVA",166529,288,2,802,610,515,95,599,11,"TUTOVA",,4,,431,168
38,"Vaslui",378,"378-TUTOVA",166529,289,2,549,495,460,35,488,7,"TUTOVA",,4,,355,133
38,"Vaslui",378,"378-TUTOVA",166529,290,2,816,549,517,32,537,12,"TUTOVA",,4,,324,213
38,"Vaslui",378,"378-VALENI",165265,291,2,2292,1493,1310,183,1475,18,"VALENI",,4,,1070,405
38,"Vaslui",378,"378-VALENI",165265,292,2,1750,881,721,160,871,10,"VALENI",,4,,709,162
38,"Vaslui",378,"378-VALENI",165265,293,2,865,640,475,165,630,10,"VALENI",,4,,454,176
38,"Vaslui",378,"378-VETRISOAIA",166672,294,2,1886,1264,1133,131,1257,7,"VETRISOAIA",,4,,1011,246
38,"Vaslui",378,"378-VETRISOAIA",166672,295,2,1017,726,636,90,715,11,"VETRISOAIA",,4,,556,159
38,"Vaslui",378,"378-VETRISOAIA",166672,296,2,201,184,145,39,180,4,"VETRISOAIA",,4,,131,49
38,"Vaslui",378,"378-VIISOARA",162005,297,2,1117,763,606,157,752,11,"VIISOARA",,4,,604,148
38,"Vaslui",378,"378-VIISOARA",162005,298,2,518,421,314,107,421,0,"VIISOARA",,4,,341,80
38,"Vaslui",378,"378-VIISOARA",162005,299,2,1593,1071,919,152,1054,17,"VIISOARA",,4,,838,216
38,"Vaslui",378,"378-VINDEREI",166770,300,2,1397,807,700,107,797,10,"VINDEREI",,4,,398,399
38,"Vaslui",378,"378-VINDEREI",166770,301,2,555,354,306,48,350,4,"VINDEREI",,4,,241,109
38,"Vaslui",378,"378-VINDEREI",166770,302,2,547,346,284,62,341,5,"VINDEREI",,4,,264,77
38,"Vaslui",378,"378-VINDEREI",166770,303,2,399,254,206,48,251,3,"VINDEREI",,4,,163,88
38,"Vaslui",378,"378-VINDEREI",166770,304,2,953,580,529,51,559,21,"VINDEREI",,4,,394,165
38,"Vaslui",378,"378-VOINESTI",166869,305,2,275,252,233,19,249,3,"VOINESTI",,4,,188,61
38,"Vaslui",378,"378-VOINESTI",166869,306,2,948,598,489,109,596,2,"VOINESTI",,4,,511,85
38,"Vaslui",378,"378-VOINESTI",166869,307,2,490,361,287,74,359,2,"VOINESTI",,4,,337,22
38,"Vaslui",378,"378-VOINESTI",166869,308,2,147,149,96,53,149,0,"VOINESTI",,4,,117,32
38,"Vaslui",378,"378-VOINESTI",166869,309,2,212,192,129,63,187,5,"VOINESTI",,4,,149,38
38,"Vaslui",378,"378-VOINESTI",166869,310,2,647,459,351,108,450,9,"VOINESTI",,4,,335,115
38,"Vaslui",378,"378-VULTURESTI",166985,311,2,934,740,606,134,727,13,"VULTURESTI",,4,,466,261
38,"Vaslui",378,"378-VULTURESTI",166985,312,2,780,614,510,104,611,3,"VULTURESTI",,4,,385,226
38,"Vaslui",378,"378-VUTCANI",167035,313,2,1011,673,513,160,665,8,"VUTCANI",,4,,475,190
38,"Vaslui",378,"378-VUTCANI",167035,314,2,1015,654,557,97,645,9,"VUTCANI",,4,,483,162
38,"Vaslui",378,"378-ZAPODENI",167071,315,2,1777,1095,968,127,1074,21,"ZAPODENI",,4,,837,237
38,"Vaslui",378,"378-ZAPODENI",167071,316,2,711,499,396,103,487,12,"ZAPODENI",,4,,340,147
38,"Vaslui",378,"378-ZAPODENI",167071,317,2,1009,922,804,118,896,26,"ZAPODENI",,4,,723,173
38,"Vaslui",378,"378-ZORLENI",167179,318,2,3126,2134,1871,263,2114,20,"ZORLENI",,4,,1389,725
38,"Vaslui",378,"378-ZORLENI",167179,319,2,1144,855,666,189,845,10,"ZORLENI",,4,,572,273
38,"Vaslui",378,"378-ZORLENI",167179,320,2,1998,1417,1248,169,1400,17,"ZORLENI",,4,,990,410
38,"Vaslui",378,"378-ZORLENI",167179,321,2,184,141,107,34,140,1,"ZORLENI",,4,,82,58
38,"Vaslui",378,"378-MURGENI",164990,322,2,900,745,531,214,734,11,"MURGENI",,4,,568,166
39,"Vâlcea",387,"387-MUNICIPIUL RAMNICU VALCEA",167473,1,2,1652,1067,879,188,1052,14,"MUNICIPIUL RAMNICU VALCEA",,6,,504,548
39,"Vâlcea",387,"387-MUNICIPIUL RAMNICU VALCEA",167473,2,2,1871,1430,1209,221,1420,10,"MUNICIPIUL RAMNICU VALCEA",,6,,593,827
39,"Vâlcea",387,"387-MUNICIPIUL RAMNICU VALCEA",167473,3,2,1557,1051,938,113,1043,8,"MUNICIPIUL RAMNICU VALCEA",,6,,470,573
39,"Vâlcea",387,"387-MUNICIPIUL RAMNICU VALCEA",167473,4,2,1952,1344,1265,79,1343,1,"MUNICIPIUL RAMNICU VALCEA",,6,,582,761
39,"Vâlcea",387,"387-MUNICIPIUL RAMNICU VALCEA",167473,5,2,1318,893,793,100,890,3,"MUNICIPIUL RAMNICU VALCEA",,6,,400,490
39,"Vâlcea",387,"387-MUNICIPIUL RAMNICU VALCEA",167473,6,2,1335,896,796,100,892,4,"MUNICIPIUL RAMNICU VALCEA",,6,,357,535
39,"Vâlcea",387,"387-MUNICIPIUL RAMNICU VALCEA",167473,7,2,954,677,609,68,676,1,"MUNICIPIUL RAMNICU VALCEA",,6,,262,414
39,"Vâlcea",387,"387-MUNICIPIUL RAMNICU VALCEA",167473,8,2,1700,1235,1091,144,1232,3,"MUNICIPIUL RAMNICU VALCEA",,6,,552,680
39,"Vâlcea",387,"387-MUNICIPIUL RAMNICU VALCEA",167473,9,2,1336,924,835,89,921,3,"MUNICIPIUL RAMNICU VALCEA",,6,,430,491
39,"Vâlcea",387,"387-MUNICIPIUL RAMNICU VALCEA",167473,10,2,1560,1046,906,140,1040,6,"MUNICIPIUL RAMNICU VALCEA",,6,,417,623
39,"Vâlcea",387,"387-MUNICIPIUL RAMNICU VALCEA",167473,11,2,1580,1142,999,143,1142,0,"MUNICIPIUL RAMNICU VALCEA",,6,,473,669
39,"Vâlcea",387,"387-MUNICIPIUL RAMNICU VALCEA",167473,12,2,1357,968,804,164,961,7,"MUNICIPIUL RAMNICU VALCEA",,6,,397,564
39,"Vâlcea",387,"387-MUNICIPIUL RAMNICU VALCEA",167473,13,2,1450,1035,944,91,1031,4,"MUNICIPIUL RAMNICU VALCEA",,6,,433,598
39,"Vâlcea",387,"387-MUNICIPIUL RAMNICU VALCEA",167473,14,2,1717,1331,1185,146,1320,11,"MUNICIPIUL RAMNICU VALCEA",,6,,535,785
39,"Vâlcea",387,"387-MUNICIPIUL RAMNICU VALCEA",167473,15,2,1886,1424,1178,246,1416,8,"MUNICIPIUL RAMNICU VALCEA",,6,,626,790
39,"Vâlcea",387,"387-MUNICIPIUL RAMNICU VALCEA",167473,16,2,2023,1426,1249,177,1418,8,"MUNICIPIUL RAMNICU VALCEA",,6,,607,811
39,"Vâlcea",387,"387-MUNICIPIUL RAMNICU VALCEA",167473,17,2,1465,1084,931,153,1082,2,"MUNICIPIUL RAMNICU VALCEA",,6,,447,635
39,"Vâlcea",387,"387-MUNICIPIUL RAMNICU VALCEA",167473,18,2,1222,947,821,126,943,4,"MUNICIPIUL RAMNICU VALCEA",,6,,374,569
39,"Vâlcea",387,"387-MUNICIPIUL RAMNICU VALCEA",167473,19,2,1973,1431,1281,150,1426,5,"MUNICIPIUL RAMNICU VALCEA",,6,,579,847
39,"Vâlcea",387,"387-MUNICIPIUL RAMNICU VALCEA",167473,20,2,1503,1338,985,353,1329,9,"MUNICIPIUL RAMNICU VALCEA",,6,,576,753
39,"Vâlcea",387,"387-MUNICIPIUL RAMNICU VALCEA",167473,21,2,1754,1235,1082,153,1232,3,"MUNICIPIUL RAMNICU VALCEA",,6,,488,744
39,"Vâlcea",387,"387-MUNICIPIUL RAMNICU VALCEA",167473,22,2,1809,1449,1229,220,1427,4,"MUNICIPIUL RAMNICU VALCEA",,6,,652,775
39,"Vâlcea",387,"387-MUNICIPIUL RAMNICU VALCEA",167473,23,2,1401,1220,943,277,1214,6,"MUNICIPIUL RAMNICU VALCEA",,6,,472,742
39,"Vâlcea",387,"387-MUNICIPIUL RAMNICU VALCEA",167473,24,2,1625,1255,1146,109,1249,6,"MUNICIPIUL RAMNICU VALCEA",,6,,503,746
39,"Vâlcea",387,"387-MUNICIPIUL RAMNICU VALCEA",167473,25,2,1605,1177,1086,91,1168,9,"MUNICIPIUL RAMNICU VALCEA",,6,,533,635
39,"Vâlcea",387,"387-MUNICIPIUL RAMNICU VALCEA",167473,26,2,1039,768,676,92,767,1,"MUNICIPIUL RAMNICU VALCEA",,6,,299,468
39,"Vâlcea",387,"387-MUNICIPIUL RAMNICU VALCEA",167473,27,2,1357,1046,948,98,1046,0,"MUNICIPIUL RAMNICU VALCEA",,6,,426,620
39,"Vâlcea",387,"387-MUNICIPIUL RAMNICU VALCEA",167473,28,2,1629,1296,1150,146,1290,6,"MUNICIPIUL RAMNICU VALCEA",,6,,547,743
39,"Vâlcea",387,"387-MUNICIPIUL RAMNICU VALCEA",167473,29,2,1513,1028,914,114,1010,18,"MUNICIPIUL RAMNICU VALCEA",,6,,514,496
39,"Vâlcea",387,"387-MUNICIPIUL RAMNICU VALCEA",167473,30,2,1797,1161,1030,131,1152,9,"MUNICIPIUL RAMNICU VALCEA",,6,,517,635
39,"Vâlcea",387,"387-MUNICIPIUL RAMNICU VALCEA",167473,31,2,1800,1315,1199,116,1307,8,"MUNICIPIUL RAMNICU VALCEA",,6,,617,690
39,"Vâlcea",387,"387-MUNICIPIUL RAMNICU VALCEA",167473,32,2,1671,1347,1162,185,1342,5,"MUNICIPIUL RAMNICU VALCEA",,6,,541,801
39,"Vâlcea",387,"387-MUNICIPIUL RAMNICU VALCEA",167473,33,2,1823,1391,1245,146,1388,3,"MUNICIPIUL RAMNICU VALCEA",,6,,611,777
39,"Vâlcea",387,"387-MUNICIPIUL RAMNICU VALCEA",167473,34,2,1301,959,858,101,956,3,"MUNICIPIUL RAMNICU VALCEA",,6,,419,537
39,"Vâlcea",387,"387-MUNICIPIUL RAMNICU VALCEA",167473,35,2,1490,1093,976,117,1090,3,"MUNICIPIUL RAMNICU VALCEA",,6,,458,632
39,"Vâlcea",387,"387-MUNICIPIUL RAMNICU VALCEA",167473,36,2,2009,1298,1201,97,1294,4,"MUNICIPIUL RAMNICU VALCEA",,6,,661,633
39,"Vâlcea",387,"387-MUNICIPIUL RAMNICU VALCEA",167473,37,2,1533,1066,996,70,1061,5,"MUNICIPIUL RAMNICU VALCEA",,6,,502,559
39,"Vâlcea",387,"387-MUNICIPIUL RAMNICU VALCEA",167473,38,2,1439,974,884,90,969,5,"MUNICIPIUL RAMNICU VALCEA",,6,,531,438
39,"Vâlcea",387,"387-MUNICIPIUL RAMNICU VALCEA",167473,39,2,1945,1247,1144,103,1242,5,"MUNICIPIUL RAMNICU VALCEA",,6,,611,631
39,"Vâlcea",387,"387-MUNICIPIUL RAMNICU VALCEA",167473,40,2,1355,878,770,108,874,4,"MUNICIPIUL RAMNICU VALCEA",,6,,381,493
39,"Vâlcea",387,"387-MUNICIPIUL RAMNICU VALCEA",167473,41,2,1948,1341,1243,98,1333,8,"MUNICIPIUL RAMNICU VALCEA",,6,,617,716
39,"Vâlcea",387,"387-MUNICIPIUL RAMNICU VALCEA",167473,42,2,1956,1173,1064,109,1167,6,"MUNICIPIUL RAMNICU VALCEA",,6,,516,651
39,"Vâlcea",387,"387-MUNICIPIUL RAMNICU VALCEA",167473,43,2,1949,1340,1224,116,1330,10,"MUNICIPIUL RAMNICU VALCEA",,6,,566,764
39,"Vâlcea",387,"387-MUNICIPIUL RAMNICU VALCEA",167473,44,2,1984,1316,1172,144,1309,7,"MUNICIPIUL RAMNICU VALCEA",,6,,582,727
39,"Vâlcea",387,"387-MUNICIPIUL RAMNICU VALCEA",167473,45,2,1943,1371,1277,94,1368,3,"MUNICIPIUL RAMNICU VALCEA",,6,,648,720
39,"Vâlcea",387,"387-MUNICIPIUL RAMNICU VALCEA",167473,46,2,1908,1259,1181,78,1255,4,"MUNICIPIUL RAMNICU VALCEA",,6,,538,717
39,"Vâlcea",387,"387-MUNICIPIUL RAMNICU VALCEA",167473,47,2,1665,1091,986,105,1087,4,"MUNICIPIUL RAMNICU VALCEA",,6,,528,559
39,"Vâlcea",387,"387-MUNICIPIUL RAMNICU VALCEA",167473,48,2,1882,1310,1190,120,1299,11,"MUNICIPIUL RAMNICU VALCEA",,6,,595,704
39,"Vâlcea",387,"387-MUNICIPIUL RAMNICU VALCEA",167473,49,2,1139,830,738,92,826,4,"MUNICIPIUL RAMNICU VALCEA",,6,,365,461
39,"Vâlcea",387,"387-MUNICIPIUL RAMNICU VALCEA",167473,50,2,1228,847,771,76,844,3,"MUNICIPIUL RAMNICU VALCEA",,6,,389,455
39,"Vâlcea",387,"387-MUNICIPIUL RAMNICU VALCEA",167473,51,2,956,553,421,132,548,5,"MUNICIPIUL RAMNICU VALCEA",,6,,324,224
39,"Vâlcea",387,"387-MUNICIPIUL RAMNICU VALCEA",167473,52,2,1014,885,485,400,873,12,"MUNICIPIUL RAMNICU VALCEA",,6,,538,335
39,"Vâlcea",387,"387-MUNICIPIUL RAMNICU VALCEA",167473,53,2,1041,1022,678,344,1013,9,"MUNICIPIUL RAMNICU VALCEA",,6,,608,405
39,"Vâlcea",387,"387-MUNICIPIUL RAMNICU VALCEA",167473,54,2,502,494,322,172,491,3,"MUNICIPIUL RAMNICU VALCEA",,6,,295,196
39,"Vâlcea",387,"387-MUNICIPIUL RAMNICU VALCEA",167473,55,2,1282,784,621,163,775,9,"MUNICIPIUL RAMNICU VALCEA",,6,,455,320
39,"Vâlcea",387,"387-MUNICIPIUL RAMNICU VALCEA",167473,56,2,1153,836,621,215,825,11,"MUNICIPIUL RAMNICU VALCEA",,6,,473,352
39,"Vâlcea",387,"387-MUNICIPIUL RAMNICU VALCEA",167473,57,2,170,170,170,0,169,1,"MUNICIPIUL RAMNICU VALCEA",,6,,110,59
39,"Vâlcea",387,"387-MUNICIPIUL RAMNICU VALCEA",167473,58,2,553,575,549,26,563,12,"MUNICIPIUL RAMNICU VALCEA",,6,,218,345
39,"Vâlcea",387,"387-MUNICIPIUL RAMNICU VALCEA",167473,59,2,387,400,375,25,395,5,"MUNICIPIUL RAMNICU VALCEA",,6,,185,210
39,"Vâlcea",387,"387-MUNICIPIUL RAMNICU VALCEA",167473,60,2,0,792,0,792,784,8,"MUNICIPIUL RAMNICU VALCEA",,6,,411,373
39,"Vâlcea",387,"387-MUNICIPIUL DRAGASANI",167981,61,2,1443,1095,938,157,1093,2,"MUNICIPIUL DRAGASANI",,6,,604,489
39,"Vâlcea",387,"387-MUNICIPIUL DRAGASANI",167981,62,2,1369,859,747,112,855,4,"MUNICIPIUL DRAGASANI",,6,,450,405
39,"Vâlcea",387,"387-MUNICIPIUL DRAGASANI",167981,63,2,1779,1206,1102,104,1193,13,"MUNICIPIUL DRAGASANI",,6,,712,481
39,"Vâlcea",387,"387-MUNICIPIUL DRAGASANI",167981,64,2,1671,1101,1026,75,1094,7,"MUNICIPIUL DRAGASANI",,6,,647,447
39,"Vâlcea",387,"387-MUNICIPIUL DRAGASANI",167981,65,2,1357,923,853,70,918,5,"MUNICIPIUL DRAGASANI",,6,,524,394
39,"Vâlcea",387,"387-MUNICIPIUL DRAGASANI",167981,66,2,1382,911,839,72,909,2,"MUNICIPIUL DRAGASANI",,6,,535,374
39,"Vâlcea",387,"387-MUNICIPIUL DRAGASANI",167981,67,2,968,715,647,68,709,6,"MUNICIPIUL DRAGASANI",,6,,416,293
39,"Vâlcea",387,"387-MUNICIPIUL DRAGASANI",167981,68,2,1419,950,903,47,940,10,"MUNICIPIUL DRAGASANI",,6,,656,284
39,"Vâlcea",387,"387-MUNICIPIUL DRAGASANI",167981,69,2,1404,952,854,98,949,3,"MUNICIPIUL DRAGASANI",,6,,542,407
39,"Vâlcea",387,"387-MUNICIPIUL DRAGASANI",167981,70,2,1476,1072,969,103,1071,1,"MUNICIPIUL DRAGASANI",,6,,570,501
39,"Vâlcea",387,"387-MUNICIPIUL DRAGASANI",167981,71,2,1482,1072,1002,70,1056,16,"MUNICIPIUL DRAGASANI",,6,,731,325
39,"Vâlcea",387,"387-MUNICIPIUL DRAGASANI",167981,72,2,1370,1011,935,76,997,14,"MUNICIPIUL DRAGASANI",,6,,701,296
39,"Vâlcea",387,"387-MUNICIPIUL DRAGASANI",167981,73,2,0,198,0,198,197,1,"MUNICIPIUL DRAGASANI",,6,,144,53
39,"Vâlcea",387,"387-MUNICIPIUL DRAGASANI",167981,74,2,418,365,353,12,359,6,"MUNICIPIUL DRAGASANI",,6,,201,158
39,"Vâlcea",387,"387-ORAS BAILE GOVORA",167641,75,2,2193,2193,1606,587,2173,20,"ORAS BAILE GOVORA",,6,,1198,975
39,"Vâlcea",387,"387-ORAS BAILE GOVORA",167641,76,2,277,270,230,40,269,1,"ORAS BAILE GOVORA",,6,,196,73
39,"Vâlcea",387,"387-ORAS BAILE OLANESTI",167696,77,2,1650,1253,1170,83,1246,7,"ORAS BAILE OLANESTI",,6,,745,501
39,"Vâlcea",387,"387-ORAS BAILE OLANESTI",167696,78,2,1188,928,841,87,920,8,"ORAS BAILE OLANESTI",,6,,606,314
39,"Vâlcea",387,"387-ORAS BAILE OLANESTI",167696,79,2,807,637,566,71,629,8,"ORAS BAILE OLANESTI",,6,,443,186
39,"Vâlcea",387,"387-ORAS BAILE OLANESTI",167696,80,2,0,1017,0,1017,1008,9,"ORAS BAILE OLANESTI",,6,,585,423
39,"Vâlcea",387,"387-ORAS BREZOI",167794,81,2,1989,1464,1274,190,1456,8,"ORAS BREZOI",,6,,696,760
39,"Vâlcea",387,"387-ORAS BREZOI",167794,82,2,1312,1068,853,215,1058,10,"ORAS BREZOI",,6,,592,466
39,"Vâlcea",387,"387-ORAS BREZOI",167794,83,2,667,444,373,71,440,4,"ORAS BREZOI",,6,,270,170
39,"Vâlcea",387,"387-ORAS BREZOI",167794,84,2,850,803,730,73,793,10,"ORAS BREZOI",,6,,423,370
39,"Vâlcea",387,"387-ORAS BREZOI",167794,85,2,365,293,241,52,289,4,"ORAS BREZOI",,6,,159,130
39,"Vâlcea",387,"387-ORAS CALIMANESTI",167909,86,2,445,375,341,34,371,4,"ORAS CALIMANESTI",,6,,246,125
39,"Vâlcea",387,"387-ORAS CALIMANESTI",167909,87,2,1612,1281,1155,126,1271,10,"ORAS CALIMANESTI",,6,,672,599
39,"Vâlcea",387,"387-ORAS CALIMANESTI",167909,88,2,973,816,752,64,815,1,"ORAS CALIMANESTI",,6,,484,331
39,"Vâlcea",387,"387-ORAS CALIMANESTI",167909,89,2,1020,1007,697,310,999,8,"ORAS CALIMANESTI",,6,,538,461
39,"Vâlcea",387,"387-ORAS CALIMANESTI",167909,90,2,328,874,204,670,870,4,"ORAS CALIMANESTI",,6,,442,428
39,"Vâlcea",387,"387-ORAS CALIMANESTI",167909,91,2,1619,1099,1005,94,1090,9,"ORAS CALIMANESTI",,6,,588,502
39,"Vâlcea",387,"387-ORAS CALIMANESTI",167909,92,2,694,535,493,42,525,10,"ORAS CALIMANESTI",,6,,278,247
39,"Vâlcea",387,"387-ORAS HOREZU",168041,93,2,1431,1080,957,123,1076,4,"ORAS HOREZU",,6,,526,550
39,"Vâlcea",387,"387-ORAS HOREZU",168041,94,2,1890,1300,1181,119,1293,7,"ORAS HOREZU",,6,,673,620
39,"Vâlcea",387,"387-ORAS HOREZU",168041,95,2,1281,886,790,96,867,19,"ORAS HOREZU",,6,,620,247
39,"Vâlcea",387,"387-ORAS HOREZU",168041,96,2,395,287,256,31,287,0,"ORAS HOREZU",,6,,192,95
39,"Vâlcea",387,"387-ORAS HOREZU",168041,97,2,520,344,300,44,344,0,"ORAS HOREZU",,6,,201,143
39,"Vâlcea",387,"387-ORAS OCNELE MARI",168130,98,2,1271,995,870,125,982,13,"ORAS OCNELE MARI",,6,,602,380
39,"Vâlcea",387,"387-ORAS OCNELE MARI",168130,99,2,1524,1073,991,82,1063,10,"ORAS OCNELE MARI",,6,,641,422
39,"Vâlcea",387,"387-ALUNU",168229,100,2,1692,1030,906,124,1021,9,"ALUNU",,6,,694,327
39,"Vâlcea",387,"387-ALUNU",168229,101,2,1659,1050,874,176,1040,10,"ALUNU",,6,,795,245
39,"Vâlcea",387,"387-AMARASTI",168309,102,2,1176,770,637,133,762,8,"AMARASTI",,6,,525,237
39,"Vâlcea",387,"387-AMARASTI",168309,103,2,732,530,427,103,518,12,"AMARASTI",,6,,358,160
39,"Vâlcea",387,"387-BABENI",168381,104,2,1489,1566,1005,561,1556,10,"BABENI",,6,,869,687
39,"Vâlcea",387,"387-BABENI",168381,105,2,1458,755,380,375,749,6,"BABENI",,6,,490,259
39,"Vâlcea",387,"387-BABENI",168381,106,2,730,901,344,557,892,9,"BABENI",,6,,645,247
39,"Vâlcea",387,"387-BABENI",168381,107,2,205,410,100,310,408,2,"BABENI",,6,,266,142
39,"Vâlcea",387,"387-BABENI",168381,108,2,1095,974,268,706,960,14,"BABENI",,6,,615,345
39,"Vâlcea",387,"387-BALCESTI",168461,109,2,2326,1420,1173,247,1402,18,"BALCESTI",,6,,911,491
39,"Vâlcea",387,"387-BALCESTI",168461,110,2,865,575,412,163,571,4,"BALCESTI",,6,,405,166
39,"Vâlcea",387,"387-BALCESTI",168461,111,2,965,628,482,146,620,8,"BALCESTI",,6,,430,190
39,"Vâlcea",387,"387-BALCESTI",168461,112,2,756,724,515,209,713,11,"BALCESTI",,6,,489,224
39,"Vâlcea",387,"387-BARBATESTI",168559,113,2,1740,1203,1072,131,1191,12,"BARBATESTI",,6,,821,370
39,"Vâlcea",387,"387-BARBATESTI",168559,114,2,1481,1170,1040,130,1158,12,"BARBATESTI",,6,,898,260
39,"Vâlcea",387,"387-BERBESTI",168611,115,2,1439,949,849,100,940,9,"BERBESTI",,6,,729,211
39,"Vâlcea",387,"387-BERBESTI",168611,116,2,1490,851,604,247,849,2,"BERBESTI",,6,,536,313
39,"Vâlcea",387,"387-BERBESTI",168611,117,2,1146,835,679,156,817,18,"BERBESTI",,6,,574,243
39,"Vâlcea",387,"387-BERISLAVESTI",168675,118,2,1121,633,562,71,629,4,"BERISLAVESTI",,6,,385,244
39,"Vâlcea",387,"387-BERISLAVESTI",168675,119,2,392,286,252,34,285,1,"BERISLAVESTI",,6,,180,105
39,"Vâlcea",387,"387-BERISLAVESTI",168675,120,2,286,219,182,37,215,4,"BERISLAVESTI",,6,,120,95
39,"Vâlcea",387,"387-BERISLAVESTI",168675,121,2,690,400,361,39,394,6,"BERISLAVESTI",,6,,167,227
39,"Vâlcea",387,"387-BOISOARA",168755,122,2,1654,889,846,43,875,14,"BOISOARA",,6,,416,459
39,"Vâlcea",387,"387-BUDESTI",168791,123,2,2520,1593,1387,206,1579,14,"BUDESTI",,6,,972,607
39,"Vâlcea",387,"387-BUDESTI",168791,124,2,1286,906,780,126,898,8,"BUDESTI",,6,,572,326
39,"Vâlcea",387,"387-BUJORENI",168880,125,2,1015,775,646,129,772,3,"BUJORENI",,6,,390,382
39,"Vâlcea",387,"387-BUJORENI",168880,126,2,1450,1037,872,165,1024,13,"BUJORENI",,6,,622,402
39,"Vâlcea",387,"387-BUNESTI",168960,127,2,1656,1182,1023,159,1169,13,"BUNESTI",,6,,841,328
39,"Vâlcea",387,"387-BUNESTI",168960,128,2,474,333,257,76,327,6,"BUNESTI",,6,,255,72
39,"Vâlcea",387,"387-CERNISOARA",169039,129,2,1324,884,840,44,868,16,"CERNISOARA",,6,,596,272
39,"Vâlcea",387,"387-CERNISOARA",169039,130,2,840,675,570,105,655,20,"CERNISOARA",,6,,416,239
39,"Vâlcea",387,"387-CERNISOARA",169039,131,2,1131,1089,922,167,1074,15,"CERNISOARA",,6,,856,218
39,"Vâlcea",387,"387-CAINENI",169119,132,2,1077,802,652,150,792,10,"CAINENI",,6,,327,465
39,"Vâlcea",387,"387-CAINENI",169119,133,2,807,479,390,89,471,8,"CAINENI",,6,,227,244
39,"Vâlcea",387,"387-CAINENI",169119,134,2,209,191,128,63,189,2,"CAINENI",,6,,106,83
39,"Vâlcea",387,"387-COPACENI",169182,135,2,1387,1028,832,196,1016,12,"COPACENI",,6,,691,325
39,"Vâlcea",387,"387-COPACENI",169182,136,2,686,600,456,144,591,9,"COPACENI",,6,,437,154
39,"Vâlcea",387,"387-COSTESTI",169253,137,2,1710,1357,1290,67,1346,11,"COSTESTI",,6,,878,468
39,"Vâlcea",387,"387-COSTESTI",169253,138,2,554,503,418,85,499,4,"COSTESTI",,6,,292,207
39,"Vâlcea",387,"387-COSTESTI",169253,139,2,605,492,430,62,488,4,"COSTESTI",,6,,357,131
39,"Vâlcea",387,"387-CRETENI",169306,140,2,1100,719,616,103,706,13,"CRETENI",,6,,464,242
39,"Vâlcea",387,"387-CRETENI",169306,141,2,1171,792,667,125,782,10,"CRETENI",,6,,478,304
39,"Vâlcea",387,"387-DAESTI",169351,142,2,1380,920,797,123,908,12,"DAESTI",,6,,547,361
39,"Vâlcea",387,"387-DAESTI",169351,143,2,657,478,400,78,473,5,"DAESTI",,6,,276,197
39,"Vâlcea",387,"387-DANICEI",169404,144,2,1264,674,510,164,670,4,"DANICEI",,6,,505,165
39,"Vâlcea",387,"387-DANICEI",169404,145,2,809,563,469,94,560,3,"DANICEI",,6,,410,150
39,"Vâlcea",387,"387-DRAGOESTI",169547,146,2,1230,862,752,110,850,12,"DRAGOESTI",,6,,573,277
39,"Vâlcea",387,"387-DRAGOESTI",169547,147,2,797,550,520,30,545,5,"DRAGOESTI",,6,,414,131
39,"Vâlcea",387,"387-FAURESTI",169583,148,2,1420,906,720,186,898,8,"FAURESTI",,6,,493,405
39,"Vâlcea",387,"387-FAURESTI",169583,149,2,1519,937,861,76,929,8,"FAURESTI",,6,,587,342
39,"Vâlcea",387,"387-FARTATESTI",169681,150,2,421,310,246,64,305,5,"FARTATESTI",,6,,201,104
39,"Vâlcea",387,"387-FARTATESTI",169681,151,2,548,452,338,114,446,6,"FARTATESTI",,6,,327,119
39,"Vâlcea",387,"387-FARTATESTI",169681,152,2,467,294,214,80,288,6,"FARTATESTI",,6,,227,61
39,"Vâlcea",387,"387-FARTATESTI",169681,153,2,983,518,434,84,508,10,"FARTATESTI",,6,,386,122
39,"Vâlcea",387,"387-FARTATESTI",169681,154,2,377,271,192,79,267,4,"FARTATESTI",,6,,143,124
39,"Vâlcea",387,"387-FARTATESTI",169681,155,2,1081,629,547,82,619,10,"FARTATESTI",,6,,410,209
39,"Vâlcea",387,"387-FRANCESTI",169896,156,2,2138,1186,967,219,1179,7,"FRANCESTI",,6,,942,237
39,"Vâlcea",387,"387-FRANCESTI",169896,157,2,1157,808,593,215,802,6,"FRANCESTI",,6,,535,267
39,"Vâlcea",387,"387-FRANCESTI",169896,158,2,1081,788,553,235,770,18,"FRANCESTI",,6,,555,215
39,"Vâlcea",387,"387-FRANCESTI",169896,159,2,57,73,56,17,73,0,"FRANCESTI",,6,,43,30
39,"Vâlcea",387,"387-GALICEA",169994,160,2,1794,1085,1033,52,1073,12,"GALICEA",,6,,757,316
39,"Vâlcea",387,"387-GALICEA",169994,161,2,938,686,528,158,685,1,"GALICEA",,6,,485,200
39,"Vâlcea",387,"387-GALICEA",169994,162,2,639,512,456,56,509,3,"GALICEA",,6,,352,157
39,"Vâlcea",387,"387-GHIOROIU",170097,163,2,1162,744,566,178,732,12,"GHIOROIU",,6,,420,312
39,"Vâlcea",387,"387-GHIOROIU",170097,164,2,637,511,381,130,502,9,"GHIOROIU",,6,,325,177
39,"Vâlcea",387,"387-GLAVILE",170168,165,2,1063,701,610,91,682,19,"GLAVILE",,6,,429,253
39,"Vâlcea",387,"387-GLAVILE",170168,166,2,329,292,245,47,285,7,"GLAVILE",,6,,198,87
39,"Vâlcea",387,"387-GOLESTI",170220,167,2,661,511,422,89,502,9,"GOLESTI",,6,,364,138
39,"Vâlcea",387,"387-GOLESTI",170220,168,2,662,584,479,105,574,10,"GOLESTI",,6,,388,186
39,"Vâlcea",387,"387-GOLESTI",170220,169,2,695,536,459,77,525,11,"GOLESTI",,6,,375,150
39,"Vâlcea",387,"387-GRADISTEA",170346,170,2,673,391,285,106,384,7,"GRADISTEA",,6,,251,133
39,"Vâlcea",387,"387-GRADISTEA",170346,171,2,797,565,410,155,559,6,"GRADISTEA",,6,,402,157
39,"Vâlcea",387,"387-GRADISTEA",170346,172,2,1195,653,599,54,644,9,"GRADISTEA",,6,,401,243
39,"Vâlcea",387,"387-GUSOENI",170444,173,2,1041,684,619,65,675,9,"GUSOENI",,6,,484,191
39,"Vâlcea",387,"387-GUSOENI",170444,174,2,649,545,509,36,471,74,"GUSOENI",,6,,335,136
39,"Vâlcea",387,"387-IONESTI",170514,175,2,1344,836,660,176,825,11,"IONESTI",,6,,508,317
39,"Vâlcea",387,"387-IONESTI",170514,176,2,1251,700,581,119,689,11,"IONESTI",,6,,447,242
39,"Vâlcea",387,"387-IONESTI",170514,177,2,928,619,518,101,608,11,"IONESTI",,6,,364,244
39,"Vâlcea",387,"387-LALOSU",170612,178,2,722,510,416,94,500,10,"LALOSU",,6,,340,160
39,"Vâlcea",387,"387-LALOSU",170612,179,2,563,350,298,52,346,4,"LALOSU",,6,,197,149
39,"Vâlcea",387,"387-LALOSU",170612,180,2,683,481,432,49,478,3,"LALOSU",,6,,337,141
39,"Vâlcea",387,"387-LADESTI",170685,181,2,1213,888,625,263,878,10,"LADESTI",,6,,640,238
39,"Vâlcea",387,"387-LADESTI",170685,182,2,715,482,377,105,472,10,"LADESTI",,6,,371,101
39,"Vâlcea",387,"387-LAPUSATA",170792,183,2,1344,884,833,51,875,9,"LAPUSATA",,6,,538,337
39,"Vâlcea",387,"387-LAPUSATA",170792,184,2,642,427,400,27,422,5,"LAPUSATA",,6,,324,98
39,"Vâlcea",387,"387-LIVEZI",170872,185,2,1051,548,423,125,542,6,"LIVEZI",,6,,396,146
39,"Vâlcea",387,"387-LIVEZI",170872,186,2,935,563,468,95,558,5,"LIVEZI",,6,,422,136
39,"Vâlcea",387,"387-LUNGESTI",170952,187,2,1888,1254,1075,179,1242,12,"LUNGESTI",,6,,868,374
39,"Vâlcea",387,"387-LUNGESTI",170952,188,2,1224,780,658,122,775,5,"LUNGESTI",,6,,642,133
39,"Vâlcea",387,"387-MALAIA",171021,189,2,886,640,588,52,632,8,"MALAIA",,6,,283,349
39,"Vâlcea",387,"387-MALAIA",171021,190,2,379,309,235,74,304,5,"MALAIA",,6,,129,175
39,"Vâlcea",387,"387-MALAIA",171021,191,2,227,207,174,33,207,0,"MALAIA",,6,,116,91
39,"Vâlcea",387,"387-MATEESTI",171067,192,2,1488,1070,962,108,1062,8,"MATEESTI",,6,,764,298
39,"Vâlcea",387,"387-MATEESTI",171067,193,2,928,702,621,81,694,8,"MATEESTI",,6,,507,187
39,"Vâlcea",387,"387-MACIUCA",171101,194,2,1327,877,716,161,866,11,"MACIUCA",,6,,600,266
39,"Vâlcea",387,"387-MACIUCA",171101,195,2,537,398,310,88,391,7,"MACIUCA",,6,,267,124
39,"Vâlcea",387,"387-MADULARI",169075,196,2,837,573,484,89,568,5,"MADULARI",,6,,406,162
39,"Vâlcea",387,"387-MADULARI",169075,197,2,492,362,319,43,358,4,"MADULARI",,6,,275,83
39,"Vâlcea",387,"387-MADULARI",169075,198,2,349,273,238,35,271,2,"MADULARI",,6,,218,53
39,"Vâlcea",387,"387-MALDARESTI",170756,199,2,1698,1174,1062,112,1164,10,"MALDARESTI",,6,,851,313
39,"Vâlcea",387,"387-MIHAESTI",171325,200,2,1922,1216,969,247,1194,22,"MIHAESTI",,6,,733,461
39,"Vâlcea",387,"387-MIHAESTI",171325,201,2,1337,969,805,164,954,15,"MIHAESTI",,6,,611,343
39,"Vâlcea",387,"387-MIHAESTI",171325,202,2,1440,1030,751,279,1024,6,"MIHAESTI",,6,,634,390
39,"Vâlcea",387,"387-MIHAESTI",171325,203,2,0,117,0,117,116,1,"MIHAESTI",,6,,86,30
39,"Vâlcea",387,"387-MILCOIU",171469,204,2,1036,695,591,104,683,12,"MILCOIU",,6,,454,229
39,"Vâlcea",387,"387-MUEREASCA",171539,205,2,861,580,524,56,576,4,"MUEREASCA",,6,,361,215
39,"Vâlcea",387,"387-MUEREASCA",171539,206,2,1246,886,820,66,869,17,"MUEREASCA",,6,,509,360
39,"Vâlcea",387,"387-NICOLAE BALCESCU",171628,207,2,1323,1005,837,168,1000,5,"NICOLAE BALCESCU",,6,,747,253
39,"Vâlcea",387,"387-NICOLAE BALCESCU",171628,208,2,1824,1215,1070,145,1202,13,"NICOLAE BALCESCU",,6,,869,333
39,"Vâlcea",387,"387-OLANU",171806,209,2,1806,1281,1220,61,1271,10,"OLANU",,6,,870,401
39,"Vâlcea",387,"387-OLANU",171806,210,2,989,686,652,34,671,15,"OLANU",,6,,450,221
39,"Vâlcea",387,"387-ORLESTI",171879,211,2,1486,1103,969,134,1076,27,"ORLESTI",,6,,678,398
39,"Vâlcea",387,"387-ORLESTI",171879,212,2,1453,959,883,76,948,11,"ORLESTI",,6,,612,336
39,"Vâlcea",387,"387-OTESANI",171931,213,2,1293,873,811,62,858,15,"OTESANI",,6,,518,340
39,"Vâlcea",387,"387-OTESANI",171931,214,2,1233,839,714,125,835,4,"OTESANI",,6,,590,245
39,"Vâlcea",387,"387-PAUSESTI",171995,215,2,1468,1212,1121,91,1191,21,"PAUSESTI",,6,,821,370
39,"Vâlcea",387,"387-PAUSESTI",171995,216,2,1106,859,789,70,835,24,"PAUSESTI",,6,,574,261
39,"Vâlcea",387,"387-PAUSESTI-MAGLASI",172082,217,2,1869,1472,1145,327,1447,25,"PAUSESTI-MAGLASI",,6,,892,555
39,"Vâlcea",387,"387-PAUSESTI-MAGLASI",172082,218,2,652,539,391,148,529,10,"PAUSESTI-MAGLASI",,6,,312,217
39,"Vâlcea",387,"387-PERISANI",172153,219,2,1031,686,638,48,682,4,"PERISANI",,6,,520,162
39,"Vâlcea",387,"387-PERISANI",172153,220,2,629,502,462,40,493,9,"PERISANI",,6,,386,107
39,"Vâlcea",387,"387-PERISANI",172153,221,2,541,457,443,14,454,3,"PERISANI",,6,,351,103
39,"Vâlcea",387,"387-PERISANI",172153,222,2,1089,585,508,77,571,14,"PERISANI",,6,,285,286
39,"Vâlcea",387,"387-PESCEANA",172279,223,2,1709,1358,1178,180,1344,14,"PESCEANA",,6,,893,451
39,"Vâlcea",387,"387-PIETRARI",172117,224,2,1485,1153,988,165,1139,14,"PIETRARI",,6,,846,293
39,"Vâlcea",387,"387-PIETRARI",172117,225,2,1264,890,776,114,884,6,"PIETRARI",,6,,670,214
39,"Vâlcea",387,"387-POPESTI",169823,226,2,1239,848,653,195,836,12,"POPESTI",,6,,598,238
39,"Vâlcea",387,"387-POPESTI",169823,227,2,1370,973,794,179,968,5,"POPESTI",,6,,645,323
39,"Vâlcea",387,"387-PRUNDENI",172457,228,2,1909,1160,1068,92,1144,16,"PRUNDENI",,6,,777,367
39,"Vâlcea",387,"387-PRUNDENI",172457,229,2,1414,1089,949,140,1069,20,"PRUNDENI",,6,,777,292
39,"Vâlcea",387,"387-PRUNDENI",172457,230,2,1308,829,770,59,824,5,"PRUNDENI",,6,,561,263
39,"Vâlcea",387,"387-RACOVITA",168862,231,2,847,637,473,164,624,13,"RACOVITA",,6,,304,320
39,"Vâlcea",387,"387-RACOVITA",168862,232,2,295,214,150,64,208,6,"RACOVITA",,6,,125,83
39,"Vâlcea",387,"387-RACOVITA",168862,233,2,221,251,208,43,247,4,"RACOVITA",,6,,177,70
39,"Vâlcea",387,"387-ROESTI",172322,234,2,1116,783,677,106,774,7,"ROESTI",,6,,557,217
39,"Vâlcea",387,"387-ROESTI",172322,235,2,652,474,392,82,471,3,"ROESTI",,6,,373,98
39,"Vâlcea",387,"387-ROSIILE",172698,236,2,1374,759,498,261,751,8,"ROSIILE",,6,,412,339
39,"Vâlcea",387,"387-ROSIILE",172698,237,2,1363,759,550,209,749,10,"ROSIILE",,6,,567,182
39,"Vâlcea",387,"387-RUNCU",172812,238,2,1056,610,519,91,596,14,"RUNCU",,6,,391,205
39,"Vâlcea",387,"387-SALATRUCEL",172894,239,2,1135,757,676,81,748,9,"SALATRUCEL",,6,,410,338
39,"Vâlcea",387,"387-SALATRUCEL",172894,240,2,696,421,390,31,416,5,"SALATRUCEL",,6,,287,129
39,"Vâlcea",387,"387-SCUNDU",172947,241,2,1240,822,692,130,816,6,"SCUNDU",,6,,459,357
39,"Vâlcea",387,"387-SCUNDU",172947,242,2,779,502,451,51,495,7,"SCUNDU",,6,,265,230
39,"Vâlcea",387,"387-SINESTI",172992,243,2,1121,926,786,140,919,7,"SINESTI",,6,,752,167
39,"Vâlcea",387,"387-SINESTI",172992,244,2,767,630,529,101,625,5,"SINESTI",,6,,446,179
39,"Vâlcea",387,"387-SLATIOARA",173061,245,2,2520,1390,1338,52,1382,8,"SLATIOARA",,6,,989,393
39,"Vâlcea",387,"387-SLATIOARA",173061,246,2,757,465,383,82,460,5,"SLATIOARA",,6,,324,136
39,"Vâlcea",387,"387-STANESTI",173132,247,2,1396,772,642,130,758,14,"STANESTI",,6,,576,182
39,"Vâlcea",387,"387-STOENESTI",168684,248,2,1362,1012,876,136,1007,5,"STOENESTI",,6,,682,325
39,"Vâlcea",387,"387-STOENESTI",168684,249,2,1087,784,692,92,774,10,"STOENESTI",,6,,589,185
39,"Vâlcea",387,"387-STOENESTI",168684,250,2,838,611,547,64,602,9,"STOENESTI",,6,,392,210
39,"Vâlcea",387,"387-STOILESTI",173374,251,2,1006,511,403,108,510,1,"STOILESTI",,6,,392,118
39,"Vâlcea",387,"387-STOILESTI",173374,252,2,749,433,259,174,431,2,"STOILESTI",,6,,285,146
39,"Vâlcea",387,"387-STOILESTI",173374,253,2,1171,614,436,178,609,5,"STOILESTI",,6,,436,173
39,"Vâlcea",387,"387-STOILESTI",173374,254,2,641,492,375,117,488,4,"STOILESTI",,6,,246,242
39,"Vâlcea",387,"387-STROESTI",173533,255,2,1078,744,570,174,736,8,"STROESTI",,6,,465,271
39,"Vâlcea",387,"387-STROESTI",173533,256,2,922,687,584,103,673,14,"STROESTI",,6,,429,244
39,"Vâlcea",387,"387-STROESTI",173533,257,2,542,376,313,63,371,5,"STROESTI",,6,,306,65
39,"Vâlcea",387,"387-SUTESTI",173597,258,2,1645,1334,1066,268,1319,15,"SUTESTI",,6,,729,590
39,"Vâlcea",387,"387-SUTESTI",173597,259,2,727,440,369,71,434,6,"SUTESTI",,6,,327,107
39,"Vâlcea",387,"387-SUTESTI",173597,260,2,344,252,188,64,251,1,"SUTESTI",,6,,183,68
39,"Vâlcea",387,"387-SUTESTI",173597,261,2,505,365,310,55,359,6,"SUTESTI",,6,,252,107
39,"Vâlcea",387,"387-SIRINEASA",173686,262,2,1474,871,770,101,857,14,"SIRINEASA",,6,,571,286
39,"Vâlcea",387,"387-SIRINEASA",173686,263,2,578,448,386,62,445,3,"SIRINEASA",,6,,330,115
39,"Vâlcea",387,"387-STEFANESTI",171183,264,2,1834,1306,1075,231,1280,26,"STEFANESTI",,6,,973,307
39,"Vâlcea",387,"387-STEFANESTI",171183,265,2,1209,992,787,205,986,6,"STEFANESTI",,6,,735,251
39,"Vâlcea",387,"387-SUSANI",173793,266,2,651,454,330,124,451,3,"SUSANI",,6,,240,211
39,"Vâlcea",387,"387-SUSANI",173793,267,2,1307,870,640,230,859,11,"SUSANI",,6,,615,244
39,"Vâlcea",387,"387-SUSANI",173793,268,2,1481,1011,785,226,997,14,"SUSANI",,6,,749,248
39,"Vâlcea",387,"387-TETOIU",173855,269,2,1079,678,527,151,667,11,"TETOIU",,6,,461,206
39,"Vâlcea",387,"387-TETOIU",173855,270,2,870,648,479,169,640,8,"TETOIU",,6,,397,243
39,"Vâlcea",387,"387-TETOIU",173855,271,2,545,413,271,142,400,13,"TETOIU",,6,,232,168
39,"Vâlcea",387,"387-TOMSANI",173935,272,2,1608,1157,1000,157,1146,11,"TOMSANI",,6,,870,276
39,"Vâlcea",387,"387-TOMSANI",173935,273,2,810,582,421,161,578,4,"TOMSANI",,6,,455,123
39,"Vâlcea",387,"387-TOMSANI",173935,274,2,1087,858,616,242,853,5,"TOMSANI",,6,,671,182
39,"Vâlcea",387,"387-VAIDEENI",174021,275,2,2237,1276,1151,125,1266,10,"VAIDEENI",,6,,658,608
39,"Vâlcea",387,"387-VAIDEENI",174021,276,2,723,491,438,53,487,4,"VAIDEENI",,6,,304,183
39,"Vâlcea",387,"387-VAIDEENI",174021,277,2,531,438,355,83,430,8,"VAIDEENI",,6,,338,92
39,"Vâlcea",387,"387-VALEA MARE",168443,278,2,1152,864,617,247,863,1,"VALEA MARE",,6,,647,216
39,"Vâlcea",387,"387-VALEA MARE",168443,279,2,956,594,529,65,583,11,"VALEA MARE",,6,,401,182
39,"Vâlcea",387,"387-VALEA MARE",168443,280,2,568,460,364,96,459,1,"VALEA MARE",,6,,351,108
39,"Vâlcea",387,"387-VLADESTI",174156,281,2,1686,1242,1061,181,1227,15,"VLADESTI",,6,,716,511
39,"Vâlcea",387,"387-VOICESTI",174218,282,2,1439,1000,918,82,990,10,"VOICESTI",,6,,767,223
39,"Vâlcea",387,"387-VOINEASA",174254,283,2,1297,1261,935,326,1249,12,"VOINEASA",,6,,651,598
39,"Vâlcea",387,"387-ZATRENI",174290,284,2,572,420,337,83,414,6,"ZATRENI",,6,,271,143
39,"Vâlcea",387,"387-ZATRENI",174290,285,2,476,319,278,41,313,6,"ZATRENI",,6,,232,81
39,"Vâlcea",387,"387-ZATRENI",174290,286,2,533,387,323,64,375,12,"ZATRENI",,6,,295,80
39,"Vâlcea",387,"387-ZATRENI",174290,287,2,767,523,434,89,516,7,"ZATRENI",,6,,348,168
39,"Vâlcea",387,"387-ZATRENI",174290,288,2,487,414,300,114,405,9,"ZATRENI",,6,,240,165
39,"Vâlcea",387,"387-ZATRENI",174290,289,2,472,319,260,59,316,3,"ZATRENI",,6,,178,138
39,"Vâlcea",387,"387-ZATRENI",174290,290,2,445,273,210,63,268,5,"ZATRENI",,6,,161,107
39,"Vâlcea",387,"387-ZATRENI",174290,291,2,0,106,0,106,100,6,"ZATRENI",,6,,66,34
39,"Vâlcea",387,"387-GLAVILE",170168,292,2,885,588,510,78,582,6,"GLAVILE",,6,,420,162
40,"Vrancea",396,"396-MUNICIPIUL FOCSANI",174744,1,2,2319,1719,1534,185,1715,4,"MUNICIPIUL FOCSANI",,4,,731,984
40,"Vrancea",396,"396-MUNICIPIUL FOCSANI",174744,2,2,1447,1116,1011,105,1108,8,"MUNICIPIUL FOCSANI",,4,,499,609
40,"Vrancea",396,"396-MUNICIPIUL FOCSANI",174744,3,2,1770,1323,1271,52,1319,4,"MUNICIPIUL FOCSANI",,4,,558,761
40,"Vrancea",396,"396-MUNICIPIUL FOCSANI",174744,4,2,1302,1081,791,290,1078,3,"MUNICIPIUL FOCSANI",,4,,484,594
40,"Vrancea",396,"396-MUNICIPIUL FOCSANI",174744,5,2,1515,1116,978,138,1112,4,"MUNICIPIUL FOCSANI",,4,,503,609
40,"Vrancea",396,"396-MUNICIPIUL FOCSANI",174744,6,2,1061,798,757,41,794,4,"MUNICIPIUL FOCSANI",,4,,335,459
40,"Vrancea",396,"396-MUNICIPIUL FOCSANI",174744,7,2,2111,1150,1127,23,1144,6,"MUNICIPIUL FOCSANI",,4,,506,638
40,"Vrancea",396,"396-MUNICIPIUL FOCSANI",174744,8,2,1502,1079,1031,48,1076,3,"MUNICIPIUL FOCSANI",,4,,458,618
40,"Vrancea",396,"396-MUNICIPIUL FOCSANI",174744,9,2,918,664,599,65,660,4,"MUNICIPIUL FOCSANI",,4,,347,313
40,"Vrancea",396,"396-MUNICIPIUL FOCSANI",174744,10,2,1601,1231,1088,143,1227,4,"MUNICIPIUL FOCSANI",,4,,601,626
40,"Vrancea",396,"396-MUNICIPIUL FOCSANI",174744,11,2,1321,887,770,117,883,4,"MUNICIPIUL FOCSANI",,4,,386,497
40,"Vrancea",396,"396-MUNICIPIUL FOCSANI",174744,12,2,2525,1737,1687,50,1727,10,"MUNICIPIUL FOCSANI",,4,,848,879
40,"Vrancea",396,"396-MUNICIPIUL FOCSANI",174744,13,2,850,586,549,37,579,7,"MUNICIPIUL FOCSANI",,4,,302,277
40,"Vrancea",396,"396-MUNICIPIUL FOCSANI",174744,14,2,1595,1107,1074,33,1099,8,"MUNICIPIUL FOCSANI",,4,,512,587
40,"Vrancea",396,"396-MUNICIPIUL FOCSANI",174744,15,2,1664,1099,918,181,1086,13,"MUNICIPIUL FOCSANI",,4,,544,542
40,"Vrancea",396,"396-MUNICIPIUL FOCSANI",174744,16,2,2579,1828,1770,58,1825,3,"MUNICIPIUL FOCSANI",,4,,721,1104
40,"Vrancea",396,"396-MUNICIPIUL FOCSANI",174744,17,2,1348,985,895,90,982,3,"MUNICIPIUL FOCSANI",,4,,416,566
40,"Vrancea",396,"396-MUNICIPIUL FOCSANI",174744,18,2,2049,1545,1319,226,1540,5,"MUNICIPIUL FOCSANI",,4,,609,931
40,"Vrancea",396,"396-MUNICIPIUL FOCSANI",174744,19,2,660,1070,436,634,1063,7,"MUNICIPIUL FOCSANI",,4,,502,561
40,"Vrancea",396,"396-MUNICIPIUL FOCSANI",174744,20,2,1691,1105,986,119,1095,10,"MUNICIPIUL FOCSANI",,4,,526,569
40,"Vrancea",396,"396-MUNICIPIUL FOCSANI",174744,21,2,1270,772,702,70,763,9,"MUNICIPIUL FOCSANI",,4,,389,374
40,"Vrancea",396,"396-MUNICIPIUL FOCSANI",174744,22,2,1056,773,773,0,767,6,"MUNICIPIUL FOCSANI",,4,,398,369
40,"Vrancea",396,"396-MUNICIPIUL FOCSANI",174744,23,2,2886,1770,1691,79,1770,0,"MUNICIPIUL FOCSANI",,4,,793,977
40,"Vrancea",396,"396-MUNICIPIUL FOCSANI",174744,24,2,2195,1448,1112,336,1439,9,"MUNICIPIUL FOCSANI",,4,,737,702
40,"Vrancea",396,"396-MUNICIPIUL FOCSANI",174744,25,2,1618,1177,1011,166,1171,6,"MUNICIPIUL FOCSANI",,4,,572,599
40,"Vrancea",396,"396-MUNICIPIUL FOCSANI",174744,26,2,2212,1506,1275,231,1503,3,"MUNICIPIUL FOCSANI",,4,,706,797
40,"Vrancea",396,"396-MUNICIPIUL FOCSANI",174744,27,2,1909,1232,1168,64,1226,6,"MUNICIPIUL FOCSANI",,4,,555,671
40,"Vrancea",396,"396-MUNICIPIUL FOCSANI",174744,28,2,2082,1495,1429,66,1493,2,"MUNICIPIUL FOCSANI",,4,,595,898
40,"Vrancea",396,"396-MUNICIPIUL FOCSANI",174744,29,2,905,988,585,403,985,3,"MUNICIPIUL FOCSANI",,4,,468,517
40,"Vrancea",396,"396-MUNICIPIUL FOCSANI",174744,30,2,1524,1124,1082,42,1119,5,"MUNICIPIUL FOCSANI",,4,,437,682
40,"Vrancea",396,"396-MUNICIPIUL FOCSANI",174744,31,2,1692,1157,1110,47,1152,5,"MUNICIPIUL FOCSANI",,4,,515,637
40,"Vrancea",396,"396-MUNICIPIUL FOCSANI",174744,32,2,2460,1525,1288,237,1521,4,"MUNICIPIUL FOCSANI",,4,,720,801
40,"Vrancea",396,"396-MUNICIPIUL FOCSANI",174744,33,2,1761,1256,1147,109,1256,0,"MUNICIPIUL FOCSANI",,4,,541,715
40,"Vrancea",396,"396-MUNICIPIUL FOCSANI",174744,34,2,1712,1254,1220,34,1254,0,"MUNICIPIUL FOCSANI",,4,,545,709
40,"Vrancea",396,"396-MUNICIPIUL FOCSANI",174744,35,2,2125,1538,1423,115,1534,4,"MUNICIPIUL FOCSANI",,4,,666,868
40,"Vrancea",396,"396-MUNICIPIUL FOCSANI",174744,36,2,1471,1056,919,137,1052,4,"MUNICIPIUL FOCSANI",,4,,425,627
40,"Vrancea",396,"396-MUNICIPIUL FOCSANI",174744,37,2,1081,763,673,90,763,0,"MUNICIPIUL FOCSANI",,4,,276,487
40,"Vrancea",396,"396-MUNICIPIUL FOCSANI",174744,38,2,1399,870,802,68,868,2,"MUNICIPIUL FOCSANI",,4,,411,457
40,"Vrancea",396,"396-MUNICIPIUL FOCSANI",174744,39,2,2456,1562,1448,114,1554,8,"MUNICIPIUL FOCSANI",,4,,809,745
40,"Vrancea",396,"396-MUNICIPIUL FOCSANI",174744,40,2,1962,1371,1194,177,1366,5,"MUNICIPIUL FOCSANI",,4,,722,644
40,"Vrancea",396,"396-MUNICIPIUL FOCSANI",174744,41,2,773,703,446,257,698,5,"MUNICIPIUL FOCSANI",,4,,281,417
40,"Vrancea",396,"396-MUNICIPIUL FOCSANI",174744,42,2,1288,1010,724,286,1001,9,"MUNICIPIUL FOCSANI",,4,,465,536
40,"Vrancea",396,"396-MUNICIPIUL FOCSANI",174744,43,2,2407,1621,1371,250,1616,5,"MUNICIPIUL FOCSANI",,4,,787,829
40,"Vrancea",396,"396-MUNICIPIUL FOCSANI",174744,44,2,1037,846,631,215,838,8,"MUNICIPIUL FOCSANI",,4,,453,385
40,"Vrancea",396,"396-MUNICIPIUL FOCSANI",174744,45,2,1242,725,700,25,723,2,"MUNICIPIUL FOCSANI",,4,,357,366
40,"Vrancea",396,"396-MUNICIPIUL FOCSANI",174744,46,2,914,589,527,62,587,2,"MUNICIPIUL FOCSANI",,4,,306,281
40,"Vrancea",396,"396-MUNICIPIUL FOCSANI",174744,47,2,1412,993,964,29,986,7,"MUNICIPIUL FOCSANI",,4,,446,540
40,"Vrancea",396,"396-MUNICIPIUL FOCSANI",174744,48,2,0,457,0,457,455,2,"MUNICIPIUL FOCSANI",,4,,193,262
40,"Vrancea",396,"396-MUNICIPIUL FOCSANI",174744,49,2,0,398,0,398,341,4,"MUNICIPIUL FOCSANI",,4,,174,167
40,"Vrancea",396,"396-MUNICIPIUL FOCSANI",174744,50,2,0,341,0,341,332,9,"MUNICIPIUL FOCSANI",,4,,177,155
40,"Vrancea",396,"396-MUNICIPIUL FOCSANI",174744,51,2,0,427,0,427,423,4,"MUNICIPIUL FOCSANI",,4,,206,217
40,"Vrancea",396,"396-MUNICIPIUL FOCSANI",174744,52,2,0,98,0,98,97,1,"MUNICIPIUL FOCSANI",,4,,42,55
40,"Vrancea",396,"396-MUNICIPIUL FOCSANI",174744,53,2,0,657,0,657,653,4,"MUNICIPIUL FOCSANI",,4,,89,564
40,"Vrancea",396,"396-ORAS ADJUD",174860,54,2,1644,1310,1159,151,1301,9,"ORAS ADJUD",,4,,627,674
40,"Vrancea",396,"396-ORAS ADJUD",174860,55,2,1537,1217,1089,128,1206,11,"ORAS ADJUD",,4,,655,551
40,"Vrancea",396,"396-ORAS ADJUD",174860,56,2,1498,1155,1043,112,1147,8,"ORAS ADJUD",,4,,567,580
40,"Vrancea",396,"396-ORAS ADJUD",174860,57,2,1536,1177,1068,109,1168,9,"ORAS ADJUD",,4,,573,595
40,"Vrancea",396,"396-ORAS ADJUD",174860,58,2,1491,1324,1028,296,1320,4,"ORAS ADJUD",,4,,562,758
40,"Vrancea",396,"396-ORAS ADJUD",174860,59,2,1051,868,752,116,863,5,"ORAS ADJUD",,4,,421,442
40,"Vrancea",396,"396-ORAS ADJUD",174860,60,2,1566,1200,1066,134,1195,5,"ORAS ADJUD",,4,,590,605
40,"Vrancea",396,"396-ORAS ADJUD",174860,61,2,1054,817,699,118,811,6,"ORAS ADJUD",,4,,407,404
40,"Vrancea",396,"396-ORAS ADJUD",174860,62,2,398,397,328,69,390,7,"ORAS ADJUD",,4,,194,196
40,"Vrancea",396,"396-ORAS ADJUD",174860,63,2,577,490,444,46,478,12,"ORAS ADJUD",,4,,269,209
40,"Vrancea",396,"396-ORAS ADJUD",174860,64,2,1234,965,866,99,955,10,"ORAS ADJUD",,4,,483,472
40,"Vrancea",396,"396-ORAS MARASESTI",174922,65,2,1598,1091,1053,38,1083,8,"ORAS MARASESTI",,4,,682,401
40,"Vrancea",396,"396-ORAS MARASESTI",174922,66,2,1542,1140,1096,44,1119,21,"ORAS MARASESTI",,4,,505,614
40,"Vrancea",396,"396-ORAS MARASESTI",174922,67,2,2612,1887,1756,131,1868,19,"ORAS MARASESTI",,4,,939,929
40,"Vrancea",396,"396-ORAS MARASESTI",174922,68,2,2164,1398,1281,117,1390,8,"ORAS MARASESTI",,4,,710,680
40,"Vrancea",396,"396-ORAS MARASESTI",174922,69,2,1322,879,687,192,876,3,"ORAS MARASESTI",,4,,516,360
40,"Vrancea",396,"396-ORAS MARASESTI",174922,70,2,0,307,0,307,306,1,"ORAS MARASESTI",,4,,120,186
40,"Vrancea",396,"396-ORAS ODOBESTI",175019,71,2,1921,1579,1346,233,1562,17,"ORAS ODOBESTI",,4,,857,705
40,"Vrancea",396,"396-ORAS ODOBESTI",175019,72,2,1848,1540,1300,240,1523,17,"ORAS ODOBESTI",,4,,1059,464
40,"Vrancea",396,"396-ORAS ODOBESTI",175019,73,2,1050,794,700,94,777,17,"ORAS ODOBESTI",,4,,440,337
40,"Vrancea",396,"396-ORAS ODOBESTI",175019,74,2,1111,807,695,112,803,4,"ORAS ODOBESTI",,4,,408,395
40,"Vrancea",396,"396-ORAS PANCIU",175055,75,2,2447,1831,1549,282,1821,10,"ORAS PANCIU",,4,,938,883
40,"Vrancea",396,"396-ORAS PANCIU",175055,76,2,2255,1507,1337,170,1493,14,"ORAS PANCIU",,4,,700,793
40,"Vrancea",396,"396-ORAS PANCIU",175055,77,2,798,603,522,81,593,10,"ORAS PANCIU",,4,,336,257
40,"Vrancea",396,"396-ORAS PANCIU",175055,78,2,758,514,453,61,510,4,"ORAS PANCIU",,4,,246,264
40,"Vrancea",396,"396-ORAS PANCIU",175055,79,2,731,557,496,61,553,4,"ORAS PANCIU",,4,,304,249
40,"Vrancea",396,"396-ORAS PANCIU",175055,80,2,537,419,366,53,411,8,"ORAS PANCIU",,4,,223,188
40,"Vrancea",396,"396-ANDREIASU DE JOS",175126,81,2,550,471,425,46,470,1,"ANDREIASU DE JOS",,4,,381,89
40,"Vrancea",396,"396-ANDREIASU DE JOS",175126,82,2,552,419,353,66,415,4,"ANDREIASU DE JOS",,4,,340,75
40,"Vrancea",396,"396-ANDREIASU DE JOS",175126,83,2,440,381,333,48,376,5,"ANDREIASU DE JOS",,4,,321,55
40,"Vrancea",396,"396-BALESTI",175206,84,2,2026,1474,1357,117,1463,11,"BALESTI",,4,,1081,382
40,"Vrancea",396,"396-BARSESTI",175224,85,2,1281,965,889,76,953,12,"BARSESTI",,4,,562,391
40,"Vrancea",396,"396-BARSESTI",175224,86,2,1660,1033,921,112,1029,4,"BARSESTI",,4,,791,238
40,"Vrancea",396,"396-BOGHESTI",175260,87,2,981,711,633,78,704,7,"BOGHESTI",,4,,459,245
40,"Vrancea",396,"396-BOGHESTI",175260,88,2,586,510,455,55,505,5,"BOGHESTI",,4,,382,123
40,"Vrancea",396,"396-BOLOTESTI",175368,89,2,1127,837,684,153,810,27,"BOLOTESTI",,4,,545,265
40,"Vrancea",396,"396-BOLOTESTI",175368,90,2,361,248,200,48,245,3,"BOLOTESTI",,4,,171,74
40,"Vrancea",396,"396-BOLOTESTI",175368,91,2,1639,1104,913,191,1090,14,"BOLOTESTI",,4,,698,392
40,"Vrancea",396,"396-BOLOTESTI",175368,92,2,544,420,341,79,416,4,"BOLOTESTI",,4,,273,143
40,"Vrancea",396,"396-BORDESTI",175439,93,2,1550,940,857,83,923,17,"BORDESTI",,4,,556,367
40,"Vrancea",396,"396-BROSTENI",175466,94,2,1580,1124,959,165,1113,11,"BROSTENI",,4,,806,307
40,"Vrancea",396,"396-CHIOJDENI",175509,95,2,1263,865,805,60,849,16,"CHIOJDENI",,4,,599,250
40,"Vrancea",396,"396-CHIOJDENI",175509,96,2,440,293,268,25,291,2,"CHIOJDENI",,4,,210,81
40,"Vrancea",396,"396-CIORASTI",175590,97,2,1034,775,714,61,765,10,"CIORASTI",,4,,539,226
40,"Vrancea",396,"396-CIORASTI",175590,98,2,281,251,221,30,246,5,"CIORASTI",,4,,194,52
40,"Vrancea",396,"396-CIORASTI",175590,99,2,836,676,596,80,667,9,"CIORASTI",,4,,531,136
40,"Vrancea",396,"396-CIORASTI",175590,100,2,549,427,400,27,420,7,"CIORASTI",,4,,361,59
40,"Vrancea",396,"396-CIORASTI",175590,101,2,311,299,276,23,294,5,"CIORASTI",,4,,251,43
40,"Vrancea",396,"396-CIORASTI",175590,102,2,267,226,208,18,220,6,"CIORASTI",,4,,149,71
40,"Vrancea",396,"396-CIORASTI",175590,103,2,270,239,215,24,238,1,"CIORASTI",,4,,201,37
40,"Vrancea",396,"396-CAMPINEANCA",174780,104,2,2243,1520,1323,197,1502,18,"CAMPINEANCA",,4,,867,635
40,"Vrancea",396,"396-CAMPURI",175670,105,2,862,615,542,73,605,10,"CAMPURI",,4,,372,233
40,"Vrancea",396,"396-CAMPURI",175670,106,2,1135,718,657,61,697,21,"CAMPURI",,4,,474,223
40,"Vrancea",396,"396-CAMPURI",175670,107,2,581,487,456,31,481,6,"CAMPURI",,4,,349,132
40,"Vrancea",396,"396-CAMPURI",175670,108,2,753,525,442,83,521,4,"CAMPURI",,4,,320,201
40,"Vrancea",396,"396-CARLIGELE",175732,109,2,923,717,559,158,711,6,"CARLIGELE",,4,,449,262
40,"Vrancea",396,"396-CARLIGELE",175732,110,2,866,678,608,70,672,6,"CARLIGELE",,4,,408,264
40,"Vrancea",396,"396-CARLIGELE",175732,111,2,529,402,329,73,399,3,"CARLIGELE",,4,,246,153
40,"Vrancea",396,"396-CORBITA",175787,112,2,725,571,490,81,566,5,"CORBITA",,4,,375,191
40,"Vrancea",396,"396-CORBITA",175787,113,2,341,319,258,61,316,3,"CORBITA",,4,,184,132
40,"Vrancea",396,"396-CORBITA",175787,114,2,503,409,355,54,405,4,"CORBITA",,4,,266,139
40,"Vrancea",396,"396-COTESTI",175885,115,2,2003,1439,1208,231,1432,7,"COTESTI",,4,,1007,425
40,"Vrancea",396,"396-COTESTI",175885,116,2,1109,1042,881,161,1031,11,"COTESTI",,4,,655,376
40,"Vrancea",396,"396-DUMBRAVENI",175938,117,2,2088,1503,1166,337,1479,24,"DUMBRAVENI",,4,,999,480
40,"Vrancea",396,"396-DUMBRAVENI",175938,118,2,1027,749,598,151,745,4,"DUMBRAVENI",,4,,395,350
40,"Vrancea",396,"396-DUMITRESTI",175983,119,2,1538,911,858,53,902,9,"DUMITRESTI",,4,,593,309
40,"Vrancea",396,"396-DUMITRESTI",175983,120,2,821,627,522,105,621,6,"DUMITRESTI",,4,,365,256
40,"Vrancea",396,"396-DUMITRESTI",175983,121,2,530,354,318,36,345,9,"DUMITRESTI",,4,,139,206
40,"Vrancea",396,"396-DUMITRESTI",175983,122,2,905,598,568,30,592,6,"DUMITRESTI",,4,,372,220
40,"Vrancea",396,"396-DUMITRESTI",175983,123,2,249,177,155,22,175,2,"DUMITRESTI",,4,,90,85
40,"Vrancea",396,"396-FITIONESTI",176150,124,2,1466,996,889,107,988,8,"FITIONESTI",,4,,458,530
40,"Vrancea",396,"396-FITIONESTI",176150,125,2,1036,757,656,101,750,7,"FITIONESTI",,4,,356,394
40,"Vrancea",396,"396-GAROAFA",176212,126,2,1805,1189,978,211,1182,7,"GAROAFA",,4,,588,594
40,"Vrancea",396,"396-GAROAFA",176212,127,2,472,300,231,69,299,1,"GAROAFA",,4,,179,120
40,"Vrancea",396,"396-GAROAFA",176212,128,2,1188,907,704,203,899,8,"GAROAFA",,4,,580,319
40,"Vrancea",396,"396-GOLESTI",174824,129,2,2251,1581,1308,273,1564,17,"GOLESTI",,4,,787,777
40,"Vrancea",396,"396-GUGESTI",176301,130,2,1915,1266,1170,96,1257,9,"GUGESTI",,4,,755,502
40,"Vrancea",396,"396-GUGESTI",176301,131,2,840,667,584,83,663,4,"GUGESTI",,4,,363,300
40,"Vrancea",396,"396-GUGESTI",176301,132,2,2152,1462,1305,157,1451,11,"GUGESTI",,4,,784,667
40,"Vrancea",396,"396-GURA CALITEI",176338,133,2,900,610,533,77,599,11,"GURA CALITEI",,4,,325,274
40,"Vrancea",396,"396-GURA CALITEI",176338,134,2,812,517,439,78,513,4,"GURA CALITEI",,4,,347,166
40,"Vrancea",396,"396-GURA CALITEI",176338,135,2,758,450,358,92,448,2,"GURA CALITEI",,4,,378,70
40,"Vrancea",396,"396-HOMOCEA",176445,136,2,3014,1697,1519,178,1669,28,"HOMOCEA",,4,,1181,488
40,"Vrancea",396,"396-HOMOCEA",176445,137,2,2099,1438,1311,127,1412,26,"HOMOCEA",,4,,742,670
40,"Vrancea",396,"396-HOMOCEA",176445,138,2,1286,865,765,100,850,15,"HOMOCEA",,4,,523,327
40,"Vrancea",396,"396-JARISTEA",176506,139,2,2350,1641,1398,243,1631,10,"JARISTEA",,4,,973,658
40,"Vrancea",396,"396-JARISTEA",176506,140,2,898,649,558,91,638,11,"JARISTEA",,4,,388,250
40,"Vrancea",396,"396-JARISTEA",176506,141,2,203,190,136,54,189,1,"JARISTEA",,4,,141,48
40,"Vrancea",396,"396-JITIA",176551,142,2,915,697,605,92,689,8,"JITIA",,4,,487,202
40,"Vrancea",396,"396-JITIA",176551,143,2,320,247,227,20,243,4,"JITIA",,4,,200,43
40,"Vrancea",396,"396-MAICANESTI",176613,144,2,1814,1512,1274,238,1497,15,"MAICANESTI",,4,,1023,474
40,"Vrancea",396,"396-MAICANESTI",176613,145,2,1528,1233,1100,133,1226,7,"MAICANESTI",,4,,980,246
40,"Vrancea",396,"396-MAICANESTI",176613,146,2,615,471,412,59,464,7,"MAICANESTI",,4,,380,84
40,"Vrancea",396,"396-MAICANESTI",176613,147,2,394,335,285,50,328,7,"MAICANESTI",,4,,255,73
40,"Vrancea",396,"396-MERA",176686,148,2,1346,905,752,153,889,16,"MERA",,4,,649,240
40,"Vrancea",396,"396-MERA",176686,149,2,1445,875,763,112,864,11,"MERA",,4,,589,275
40,"Vrancea",396,"396-MILCOVUL",176748,150,2,2176,1651,1446,205,1635,16,"MILCOVUL",,4,,1113,522
40,"Vrancea",396,"396-MILCOVUL",176748,151,2,2023,1704,1529,175,1692,12,"MILCOVUL",,4,,1136,556
40,"Vrancea",396,"396-MILCOVUL",176748,152,2,2767,1867,1704,163,1832,28,"MILCOVUL",,4,,1182,650
40,"Vrancea",396,"396-MILCOVUL",176748,153,2,677,567,466,101,557,10,"MILCOVUL",,4,,339,218
40,"Vrancea",396,"396-MOVILITA",176793,154,2,641,475,402,73,471,4,"MOVILITA",,4,,301,170
40,"Vrancea",396,"396-MOVILITA",176793,155,2,1300,825,673,152,813,12,"MOVILITA",,4,,465,348
40,"Vrancea",396,"396-MOVILITA",176793,156,2,1136,662,556,106,649,13,"MOVILITA",,4,,365,284
40,"Vrancea",396,"396-MOVILITA",176793,157,2,378,280,246,34,276,4,"MOVILITA",,4,,194,82
40,"Vrancea",396,"396-NANESTI",176855,158,2,1192,800,739,61,786,14,"NANESTI",,4,,477,309
40,"Vrancea",396,"396-NANESTI",176855,159,2,1149,747,693,54,731,16,"NANESTI",,4,,496,235
40,"Vrancea",396,"396-NARUJA",176891,160,2,1563,1393,1239,154,1370,23,"NARUJA",,4,,1005,365
40,"Vrancea",396,"396-NEREJU",176944,161,2,1253,950,870,80,898,52,"NEREJU",,4,,681,217
40,"Vrancea",396,"396-NEREJU",176944,162,2,1563,1029,923,106,1021,8,"NEREJU",,4,,646,375
40,"Vrancea",396,"396-NISTORESTI",177003,163,2,1089,632,591,41,620,12,"NISTORESTI",,4,,470,150
40,"Vrancea",396,"396-NISTORESTI",177003,164,2,926,632,592,40,623,9,"NISTORESTI",,4,,509,114
40,"Vrancea",396,"396-PALTIN",177101,165,2,1149,766,697,69,758,8,"PALTIN",,4,,535,223
40,"Vrancea",396,"396-PALTIN",177101,166,2,608,436,405,31,431,5,"PALTIN",,4,,326,105
40,"Vrancea",396,"396-PALTIN",177101,167,2,996,659,603,56,654,5,"PALTIN",,4,,516,138
40,"Vrancea",396,"396-PAUNESTI",177236,168,2,734,531,482,49,528,3,"PAUNESTI",,4,,372,156
40,"Vrancea",396,"396-PAUNESTI",177236,169,2,1476,1051,1005,46,1034,17,"PAUNESTI",,4,,690,344
40,"Vrancea",396,"396-PAUNESTI",177236,170,2,1176,914,843,71,902,12,"PAUNESTI",,4,,651,251
40,"Vrancea",396,"396-PAUNESTI",177236,171,2,1533,990,965,25,977,13,"PAUNESTI",,4,,680,297
40,"Vrancea",396,"396-POIANA CRISTEI",177263,172,2,1607,969,928,41,957,12,"POIANA CRISTEI",,4,,770,187
40,"Vrancea",396,"396-POIANA CRISTEI",177263,173,2,510,348,335,13,342,6,"POIANA CRISTEI",,4,,302,40
40,"Vrancea",396,"396-POIANA CRISTEI",177263,174,2,233,161,149,12,161,0,"POIANA CRISTEI",,4,,127,34
40,"Vrancea",396,"396-PUFESTI",177352,175,2,1843,1425,1192,233,1394,31,"PUFESTI",,4,,732,662
40,"Vrancea",396,"396-PUFESTI",177352,176,2,947,739,626,113,732,7,"PUFESTI",,4,,426,306
40,"Vrancea",396,"396-RACOASA",177405,177,2,1017,761,681,80,751,10,"RACOASA",,4,,440,311
40,"Vrancea",396,"396-RACOASA",177405,178,2,774,541,475,66,531,10,"RACOASA",,4,,318,213
40,"Vrancea",396,"396-RACOASA",177405,179,2,681,500,459,41,494,6,"RACOASA",,4,,229,265
40,"Vrancea",396,"396-RACOASA",177405,180,2,419,351,292,59,342,9,"RACOASA",,4,,278,64
40,"Vrancea",396,"396-REGHIU",177469,181,2,1196,759,718,41,733,26,"REGHIU",,4,,546,187
40,"Vrancea",396,"396-REGHIU",177469,182,2,494,366,343,23,359,7,"REGHIU",,4,,253,106
40,"Vrancea",396,"396-REGHIU",177469,183,2,461,363,349,14,353,10,"REGHIU",,4,,198,155
40,"Vrancea",396,"396-RUGINESTI",177557,184,2,2024,1253,1132,121,1238,15,"RUGINESTI",,4,,691,547
40,"Vrancea",396,"396-RUGINESTI",177557,185,2,946,605,569,36,601,4,"RUGINESTI",,4,,382,219
40,"Vrancea",396,"396-RUGINESTI",177557,186,2,688,536,513,23,526,10,"RUGINESTI",,4,,358,168
40,"Vrancea",396,"396-SIHLEA",177600,187,2,1887,1169,1008,161,1150,19,"SIHLEA",,4,,661,489
40,"Vrancea",396,"396-SIHLEA",177600,188,2,575,434,370,64,429,5,"SIHLEA",,4,,323,106
40,"Vrancea",396,"396-SIHLEA",177600,189,2,988,724,589,135,712,12,"SIHLEA",,4,,512,200
40,"Vrancea",396,"396-SIHLEA",177600,190,2,1063,785,674,111,780,5,"SIHLEA",,4,,582,198
40,"Vrancea",396,"396-SIHLEA",177600,191,2,0,127,0,127,125,2,"SIHLEA",,4,,59,66
40,"Vrancea",396,"396-SLOBOZIA BRADULUI",177655,192,2,1017,688,630,58,678,10,"SLOBOZIA BRADULUI",,4,,467,211
40,"Vrancea",396,"396-SLOBOZIA BRADULUI",177655,193,2,817,679,552,127,667,12,"SLOBOZIA BRADULUI",,4,,453,214
40,"Vrancea",396,"396-SLOBOZIA BRADULUI",177655,194,2,1020,681,523,158,661,20,"SLOBOZIA BRADULUI",,4,,499,162
40,"Vrancea",396,"396-SLOBOZIA CIORASTI",177726,195,2,1078,822,726,96,818,4,"SLOBOZIA CIORASTI",,4,,607,211
40,"Vrancea",396,"396-SLOBOZIA CIORASTI",177726,196,2,515,421,375,46,415,6,"SLOBOZIA CIORASTI",,4,,254,161
40,"Vrancea",396,"396-SOVEJA",177762,197,2,1375,1034,939,95,1022,12,"SOVEJA",,4,,636,386
40,"Vrancea",396,"396-SOVEJA",177762,198,2,1054,796,735,61,785,11,"SOVEJA",,4,,497,288
40,"Vrancea",396,"396-STRAOANE",177799,199,2,1283,960,819,141,948,12,"STRAOANE",,4,,443,505
40,"Vrancea",396,"396-STRAOANE",177799,200,2,970,701,598,103,687,14,"STRAOANE",,4,,395,292
40,"Vrancea",396,"396-STRAOANE",177799,201,2,331,273,229,44,270,3,"STRAOANE",,4,,181,89
40,"Vrancea",396,"396-STRAOANE",177799,202,2,870,583,483,100,575,8,"STRAOANE",,4,,363,212
40,"Vrancea",396,"396-SURAIA",177842,203,2,2650,1533,1455,78,1526,7,"SURAIA",,4,,683,843
40,"Vrancea",396,"396-SURAIA",177842,204,2,1795,1180,1122,58,1174,6,"SURAIA",,4,,570,604
40,"Vrancea",396,"396-SURAIA",177842,205,2,1814,1219,1060,159,1204,15,"SURAIA",,4,,682,522
40,"Vrancea",396,"396-TANASOAIA",177879,206,2,1137,986,897,89,971,15,"TANASOAIA",,4,,755,216
40,"Vrancea",396,"396-TANASOAIA",177879,207,2,755,497,441,56,488,9,"TANASOAIA",,4,,346,142
40,"Vrancea",396,"396-TATARANU",177986,208,2,1191,841,765,76,823,18,"TATARANU",,4,,559,264
40,"Vrancea",396,"396-TATARANU",177986,209,2,890,718,565,153,712,6,"TATARANU",,4,,516,196
40,"Vrancea",396,"396-TATARANU",177986,210,2,1114,888,671,217,870,18,"TATARANU",,4,,651,219
40,"Vrancea",396,"396-TATARANU",177986,211,2,916,646,578,68,634,12,"TATARANU",,4,,433,201
40,"Vrancea",396,"396-TAMBOIESTI",178046,212,2,917,593,436,157,585,8,"TAMBOIESTI",,4,,358,227
40,"Vrancea",396,"396-TAMBOIESTI",178046,213,2,970,805,626,179,795,10,"TAMBOIESTI",,4,,486,309
40,"Vrancea",396,"396-TAMBOIESTI",178046,214,2,1062,802,657,145,786,16,"TAMBOIESTI",,4,,442,344
40,"Vrancea",396,"396-TULNICI",178117,215,2,1918,1303,1203,100,1288,15,"TULNICI",,4,,804,484
40,"Vrancea",396,"396-TULNICI",178117,216,2,739,547,500,47,534,13,"TULNICI",,4,,398,136
40,"Vrancea",396,"396-TULNICI",178117,217,2,1041,686,640,46,683,3,"TULNICI",,4,,484,199
40,"Vrancea",396,"396-TULNICI",178117,218,2,679,647,607,40,639,8,"TULNICI",,4,,417,222
40,"Vrancea",396,"396-TULNICI",178117,219,2,273,288,170,118,282,6,"TULNICI",,4,,184,98
40,"Vrancea",396,"396-TIFESTI",178180,220,2,1674,1134,944,190,1119,15,"TIFESTI",,4,,690,429
40,"Vrancea",396,"396-TIFESTI",178180,221,2,1250,811,696,115,792,19,"TIFESTI",,4,,529,263
40,"Vrancea",396,"396-TIFESTI",178180,222,2,697,553,435,118,548,5,"TIFESTI",,4,,372,176
40,"Vrancea",396,"396-TIFESTI",178180,223,2,741,510,424,86,506,4,"TIFESTI",,4,,341,165
40,"Vrancea",396,"396-URECHESTI",178279,224,2,2040,1382,1255,127,1366,16,"URECHESTI",,4,,707,659
40,"Vrancea",396,"396-URECHESTI",178279,225,2,1614,1096,1000,96,1081,15,"URECHESTI",,4,,559,522
40,"Vrancea",396,"396-URECHESTI",178279,226,2,649,481,409,72,473,8,"URECHESTI",,4,,224,249
40,"Vrancea",396,"396-VALEA SARII",178313,227,2,765,611,563,48,605,6,"VALEA SARII",,4,,416,189
40,"Vrancea",396,"396-VALEA SARII",178313,228,2,946,800,734,66,794,6,"VALEA SARII",,4,,580,214
40,"Vrancea",396,"396-VIDRA",178377,229,2,2056,1573,1304,269,1551,22,"VIDRA",,4,,1067,484
40,"Vrancea",396,"396-VIDRA",178377,230,2,1485,882,795,87,870,12,"VIDRA",,4,,559,311
40,"Vrancea",396,"396-VIDRA",178377,231,2,1109,793,698,95,781,12,"VIDRA",,4,,583,198
40,"Vrancea",396,"396-VIDRA",178377,232,2,702,520,480,40,513,7,"VIDRA",,4,,335,178
40,"Vrancea",396,"396-VIDRA",178377,233,2,716,469,437,32,461,8,"VIDRA",,4,,319,142
40,"Vrancea",396,"396-VINTILEASCA",178475,234,2,994,703,658,45,698,5,"VINTILEASCA",,4,,529,169
40,"Vrancea",396,"396-VINTILEASCA",178475,235,2,624,402,366,36,399,3,"VINTILEASCA",,4,,331,68
40,"Vrancea",396,"396-VIZANTEA-LIVEZI",178545,236,2,634,539,463,76,532,7,"VIZANTEA-LIVEZI",,4,,198,334
40,"Vrancea",396,"396-VIZANTEA-LIVEZI",178545,237,2,344,247,228,19,242,5,"VIZANTEA-LIVEZI",,4,,163,79
40,"Vrancea",396,"396-VIZANTEA-LIVEZI",178545,238,2,416,350,322,28,348,2,"VIZANTEA-LIVEZI",,4,,156,192
40,"Vrancea",396,"396-VIZANTEA-LIVEZI",178545,239,2,767,503,456,47,490,13,"VIZANTEA-LIVEZI",,4,,299,191
40,"Vrancea",396,"396-VIZANTEA-LIVEZI",178545,240,2,1233,890,836,54,882,8,"VIZANTEA-LIVEZI",,4,,628,254
40,"Vrancea",396,"396-VANATORI",178607,241,2,1300,816,763,53,812,4,"VANATORI",,4,,444,368
40,"Vrancea",396,"396-VANATORI",178607,242,2,1171,897,797,100,879,18,"VANATORI",,4,,533,346
40,"Vrancea",396,"396-VANATORI",178607,243,2,1079,729,636,93,715,14,"VANATORI",,4,,443,272
40,"Vrancea",396,"396-VANATORI",178607,244,2,676,504,435,69,500,4,"VANATORI",,4,,228,272
40,"Vrancea",396,"396-VARTESCOIU",178689,245,2,1643,1163,1004,159,1152,11,"VARTESCOIU",,4,,772,380
40,"Vrancea",396,"396-VARTESCOIU",178689,246,2,808,659,547,112,654,5,"VARTESCOIU",,4,,511,143
40,"Vrancea",396,"396-VRANCIOAIA",178750,247,2,593,359,328,31,354,5,"VRANCIOAIA",,4,,270,84
40,"Vrancea",396,"396-VRANCIOAIA",178750,248,2,583,369,348,21,361,8,"VRANCIOAIA",,4,,255,106
40,"Vrancea",396,"396-VRANCIOAIA",178750,249,2,700,644,622,22,631,13,"VRANCIOAIA",,4,,522,109
40,"Vrancea",396,"396-VRANCIOAIA",178750,250,2,648,450,419,31,440,10,"VRANCIOAIA",,4,,232,208
40,"Vrancea",396,"396-VULTURU",178821,251,2,3427,2071,1721,350,2050,21,"VULTURU",,4,,1422,628
40,"Vrancea",396,"396-VULTURU",178821,252,2,1012,700,627,73,694,6,"VULTURU",,4,,466,228
40,"Vrancea",396,"396-VULTURU",178821,253,2,1076,885,677,208,880,5,"VULTURU",,4,,727,153
40,"Vrancea",396,"396-VULTURU",178821,254,2,758,526,488,38,521,5,"VULTURU",,4,,433,88
40,"Vrancea",396,"396-VULTURU",178821,255,2,1159,551,530,21,538,13,"VULTURU",,4,,367,171
41,"București",403,"403-SECTORUL 1",179141,1,2,1222,1457,805,652,1452,5,"SECTORUL 1",,0,,534,918
41,"București",403,"403-SECTORUL 1",179141,2,2,1685,1256,1097,159,1248,8,"SECTORUL 1",,0,,432,816
41,"București",403,"403-SECTORUL 1",179141,3,2,1784,1357,1104,253,1349,8,"SECTORUL 1",,0,,570,779
41,"București",403,"403-SECTORUL 1",179141,4,2,1429,1302,987,315,1195,9,"SECTORUL 1",,0,,441,754
41,"București",403,"403-SECTORUL 1",179141,5,2,1741,1364,1159,205,1358,6,"SECTORUL 1",,0,,543,815
41,"București",403,"403-SECTORUL 1",179141,6,2,1816,1363,1099,264,1357,6,"SECTORUL 1",,0,,467,890
41,"București",403,"403-SECTORUL 1",179141,7,2,2003,1422,1259,163,1414,7,"SECTORUL 1",,0,,598,816
41,"București",403,"403-SECTORUL 1",179141,8,2,1170,1132,777,355,1130,2,"SECTORUL 1",,0,,415,715
41,"București",403,"403-SECTORUL 1",179141,9,2,1715,1306,1111,195,1306,0,"SECTORUL 1",,0,,419,887
41,"București",403,"403-SECTORUL 1",179141,10,2,1788,1201,1056,145,1196,5,"SECTORUL 1",,0,,379,817
41,"București",403,"403-SECTORUL 1",179141,11,2,1335,1131,836,295,1129,2,"SECTORUL 1",,0,,411,718
41,"București",403,"403-SECTORUL 1",179141,12,2,1338,991,870,121,987,4,"SECTORUL 1",,0,,399,588
41,"București",403,"403-SECTORUL 1",179141,13,2,1514,1100,972,128,1095,5,"SECTORUL 1",,0,,470,625
41,"București",403,"403-SECTORUL 1",179141,14,2,1843,1299,1185,114,1296,3,"SECTORUL 1",,0,,654,642
41,"București",403,"403-SECTORUL 1",179141,15,2,1805,1212,1096,116,1198,14,"SECTORUL 1",,0,,373,825
41,"București",403,"403-SECTORUL 1",179141,16,2,1509,1232,995,237,1228,4,"SECTORUL 1",,0,,483,745
41,"București",403,"403-SECTORUL 1",179141,17,2,1395,1186,919,267,1182,4,"SECTORUL 1",,0,,483,699
41,"București",403,"403-SECTORUL 1",179141,18,2,1861,1307,1148,159,1298,9,"SECTORUL 1",,0,,504,794
41,"București",403,"403-SECTORUL 1",179141,19,2,1581,1106,995,111,1095,11,"SECTORUL 1",,0,,430,665
41,"București",403,"403-SECTORUL 1",179141,20,2,1487,1101,948,153,1092,9,"SECTORUL 1",,0,,359,733
41,"București",403,"403-SECTORUL 1",179141,21,2,1623,1023,890,133,1018,5,"SECTORUL 1",,0,,327,691
41,"București",403,"403-SECTORUL 1",179141,22,2,1299,996,856,140,993,3,"SECTORUL 1",,0,,389,604
41,"București",403,"403-SECTORUL 1",179141,23,2,1804,1359,1208,151,1357,2,"SECTORUL 1",,0,,512,845
41,"București",403,"403-SECTORUL 1",179141,24,2,1377,910,755,155,906,4,"SECTORUL 1",,0,,324,582
41,"București",403,"403-SECTORUL 1",179141,25,2,1868,1203,1059,144,1195,8,"SECTORUL 1",,0,,447,748
41,"București",403,"403-SECTORUL 1",179141,26,2,1385,1004,858,146,999,5,"SECTORUL 1",,0,,424,575
41,"București",403,"403-SECTORUL 1",179141,27,2,1178,940,815,125,932,8,"SECTORUL 1",,0,,437,495
41,"București",403,"403-SECTORUL 1",179141,28,2,1434,1069,994,75,1061,8,"SECTORUL 1",,0,,510,551
41,"București",403,"403-SECTORUL 1",179141,29,2,1951,1395,1229,166,1393,2,"SECTORUL 1",,0,,596,797
41,"București",403,"403-SECTORUL 1",179141,30,2,1311,931,804,127,927,4,"SECTORUL 1",,0,,409,518
41,"București",403,"403-SECTORUL 1",179141,31,2,1794,1317,1180,137,1307,10,"SECTORUL 1",,0,,451,856
41,"București",403,"403-SECTORUL 1",179141,32,2,1730,1200,1023,177,1190,10,"SECTORUL 1",,0,,423,767
41,"București",403,"403-SECTORUL 1",179141,33,2,1019,813,642,171,811,2,"SECTORUL 1",,0,,298,513
41,"București",403,"403-SECTORUL 1",179141,34,2,1694,1404,1248,156,1396,8,"SECTORUL 1",,0,,461,935
41,"București",403,"403-SECTORUL 1",179141,35,2,1710,1368,1241,127,1362,6,"SECTORUL 1",,0,,494,868
41,"București",403,"403-SECTORUL 1",179141,36,2,1599,1272,1172,100,1266,6,"SECTORUL 1",,0,,482,784
41,"București",403,"403-SECTORUL 1",179141,37,2,1917,1526,1402,124,1521,5,"SECTORUL 1",,0,,575,946
41,"București",403,"403-SECTORUL 1",179141,38,2,1392,1025,871,154,1019,6,"SECTORUL 1",,0,,307,712
41,"București",403,"403-SECTORUL 1",179141,39,2,1772,1309,1186,123,1307,2,"SECTORUL 1",,0,,433,874
41,"București",403,"403-SECTORUL 1",179141,40,2,1730,1220,1102,118,1208,12,"SECTORUL 1",,0,,424,784
41,"București",403,"403-SECTORUL 1",179141,41,2,1483,994,887,107,987,7,"SECTORUL 1",,0,,359,628
41,"București",403,"403-SECTORUL 1",179141,42,2,1518,1155,1037,118,1149,6,"SECTORUL 1",,0,,525,624
41,"București",403,"403-SECTORUL 1",179141,43,2,1725,1335,1161,174,1332,3,"SECTORUL 1",,0,,558,774
41,"București",403,"403-SECTORUL 1",179141,44,2,1661,1240,1116,124,1238,2,"SECTORUL 1",,0,,473,765
41,"București",403,"403-SECTORUL 1",179141,45,2,1684,1188,1081,107,1184,4,"SECTORUL 1",,0,,334,850
41,"București",403,"403-SECTORUL 1",179141,46,2,1550,1285,1119,166,1275,10,"SECTORUL 1",,0,,474,801
41,"București",403,"403-SECTORUL 1",179141,47,2,1497,1190,1102,88,1183,7,"SECTORUL 1",,0,,345,838
41,"București",403,"403-SECTORUL 1",179141,48,2,1690,1212,1082,130,1205,7,"SECTORUL 1",,0,,415,790
41,"București",403,"403-SECTORUL 1",179141,49,2,1832,1262,1133,129,1260,2,"SECTORUL 1",,0,,393,867
41,"București",403,"403-SECTORUL 1",179141,50,2,1654,1344,1217,127,1340,4,"SECTORUL 1",,0,,428,912
41,"București",403,"403-SECTORUL 1",179141,51,2,1824,1462,1302,160,1458,4,"SECTORUL 1",,0,,525,933
41,"București",403,"403-SECTORUL 1",179141,52,2,1087,851,760,91,846,5,"SECTORUL 1",,0,,357,489
41,"București",403,"403-SECTORUL 1",179141,53,2,1434,1102,1007,95,1092,10,"SECTORUL 1",,0,,482,610
41,"București",403,"403-SECTORUL 1",179141,54,2,1652,1244,1135,109,1239,5,"SECTORUL 1",,0,,559,680
41,"București",403,"403-SECTORUL 1",179141,55,2,1599,1189,1090,99,1182,7,"SECTORUL 1",,0,,529,653
41,"București",403,"403-SECTORUL 1",179141,56,2,1684,1236,1080,156,1228,8,"SECTORUL 1",,0,,390,838
41,"București",403,"403-SECTORUL 1",179141,57,2,1814,1382,1219,163,1376,6,"SECTORUL 1",,0,,474,902
41,"București",403,"403-SECTORUL 1",179141,58,2,1815,1253,1168,85,1244,9,"SECTORUL 1",,0,,408,836
41,"București",403,"403-SECTORUL 1",179141,59,2,1887,1326,1158,168,1320,6,"SECTORUL 1",,0,,447,873
41,"București",403,"403-SECTORUL 1",179141,60,2,1415,1098,979,119,1092,6,"SECTORUL 1",,0,,435,657
41,"București",403,"403-SECTORUL 1",179141,61,2,1575,1102,1012,90,1096,6,"SECTORUL 1",,0,,487,609
41,"București",403,"403-SECTORUL 1",179141,62,2,1624,1328,1125,203,1321,7,"SECTORUL 1",,0,,532,789
41,"București",403,"403-SECTORUL 1",179141,63,2,1951,1487,1197,290,1475,12,"SECTORUL 1",,0,,565,910
41,"București",403,"403-SECTORUL 1",179141,64,2,1861,1335,1134,201,1325,10,"SECTORUL 1",,0,,545,780
41,"București",403,"403-SECTORUL 1",179141,65,2,1585,1264,1111,153,1248,12,"SECTORUL 1",,0,,489,759
41,"București",403,"403-SECTORUL 1",179141,66,2,1671,1266,1111,155,1255,11,"SECTORUL 1",,0,,430,825
41,"București",403,"403-SECTORUL 1",179141,67,2,1676,1107,1011,96,1102,5,"SECTORUL 1",,0,,384,718
41,"București",403,"403-SECTORUL 1",179141,68,2,1877,1196,1039,157,1191,5,"SECTORUL 1",,0,,456,735
41,"București",403,"403-SECTORUL 1",179141,69,2,1789,1294,1131,163,1264,30,"SECTORUL 1",,0,,501,763
41,"București",403,"403-SECTORUL 1",179141,70,2,1792,1327,1218,109,1326,1,"SECTORUL 1",,0,,496,830
41,"București",403,"403-SECTORUL 1",179141,71,2,1603,1246,1029,217,1240,6,"SECTORUL 1",,0,,473,767
41,"București",403,"403-SECTORUL 1",179141,72,2,682,529,341,188,524,5,"SECTORUL 1",,0,,218,306
41,"București",403,"403-SECTORUL 1",179141,73,2,1826,1146,1013,133,1132,14,"SECTORUL 1",,0,,444,688
41,"București",403,"403-SECTORUL 1",179141,74,2,1680,1173,1030,143,1167,6,"SECTORUL 1",,0,,411,756
41,"București",403,"403-SECTORUL 1",179141,75,2,1687,1200,1097,103,1195,5,"SECTORUL 1",,0,,488,707
41,"București",403,"403-SECTORUL 1",179141,76,2,1917,1388,1237,151,1382,6,"SECTORUL 1",,0,,597,785
41,"București",403,"403-SECTORUL 1",179141,77,2,1776,1230,1072,158,1220,10,"SECTORUL 1",,0,,488,732
41,"București",403,"403-SECTORUL 1",179141,78,2,1135,960,729,231,948,12,"SECTORUL 1",,0,,424,524
41,"București",403,"403-SECTORUL 1",179141,79,2,953,762,591,171,754,7,"SECTORUL 1",,0,,284,470
41,"București",403,"403-SECTORUL 1",179141,80,2,1102,756,693,63,752,4,"SECTORUL 1",,0,,267,485
41,"București",403,"403-SECTORUL 1",179141,81,2,1374,905,813,92,898,3,"SECTORUL 1",,0,,380,518
41,"București",403,"403-SECTORUL 1",179141,82,2,1678,1251,1100,151,1245,6,"SECTORUL 1",,0,,411,834
41,"București",403,"403-SECTORUL 1",179141,83,2,1728,1357,1126,231,1342,7,"SECTORUL 1",,0,,465,877
41,"București",403,"403-SECTORUL 1",179141,84,2,1408,1149,908,241,1138,11,"SECTORUL 1",,0,,411,727
41,"București",403,"403-SECTORUL 1",179141,85,2,1900,1544,1236,308,1514,17,"SECTORUL 1",,0,,591,923
41,"București",403,"403-SECTORUL 1",179141,86,2,1679,1283,1038,245,1276,7,"SECTORUL 1",,0,,488,788
41,"București",403,"403-SECTORUL 1",179141,87,2,1670,1401,1191,210,1398,3,"SECTORUL 1",,0,,558,840
41,"București",403,"403-SECTORUL 1",179141,88,2,1682,1263,1053,210,1257,6,"SECTORUL 1",,0,,496,761
41,"București",403,"403-SECTORUL 1",179141,89,2,1456,1300,1076,224,1288,12,"SECTORUL 1",,0,,524,764
41,"București",403,"403-SECTORUL 1",179141,90,2,1224,1019,881,138,1013,6,"SECTORUL 1",,0,,401,612
41,"București",403,"403-SECTORUL 1",179141,91,2,1156,851,684,167,847,4,"SECTORUL 1",,0,,258,589
41,"București",403,"403-SECTORUL 1",179141,92,2,988,663,570,93,659,4,"SECTORUL 1",,0,,223,436
41,"București",403,"403-SECTORUL 1",179141,93,2,1107,789,664,125,780,9,"SECTORUL 1",,0,,250,530
41,"București",403,"403-SECTORUL 1",179141,94,2,1251,962,817,145,951,11,"SECTORUL 1",,0,,282,669
41,"București",403,"403-SECTORUL 1",179141,95,2,1670,1241,948,293,1224,11,"SECTORUL 1",,0,,512,712
41,"București",403,"403-SECTORUL 1",179141,96,2,1533,1152,878,274,1139,13,"SECTORUL 1",,0,,408,731
41,"București",403,"403-SECTORUL 1",179141,97,2,2219,1809,1502,307,1804,5,"SECTORUL 1",,0,,632,1172
41,"București",403,"403-SECTORUL 1",179141,98,2,2004,1580,1434,146,1573,7,"SECTORUL 1",,0,,417,1156
41,"București",403,"403-SECTORUL 1",179141,99,2,1678,1284,1181,103,1282,2,"SECTORUL 1",,0,,404,878
41,"București",403,"403-SECTORUL 1",179141,100,2,1033,822,741,81,821,1,"SECTORUL 1",,0,,230,591
41,"București",403,"403-SECTORUL 1",179141,101,2,1702,1275,1120,155,1267,7,"SECTORUL 1",,0,,361,906
41,"București",403,"403-SECTORUL 1",179141,102,2,1788,1428,1236,192,1423,5,"SECTORUL 1",,0,,396,1027
41,"București",403,"403-SECTORUL 1",179141,103,2,1555,1238,1116,122,1237,1,"SECTORUL 1",,0,,357,880
41,"București",403,"403-SECTORUL 1",179141,104,2,2081,1509,1381,128,1503,6,"SECTORUL 1",,0,,489,1014
41,"București",403,"403-SECTORUL 1",179141,105,2,1968,1569,1416,153,1564,5,"SECTORUL 1",,0,,431,1133
41,"București",403,"403-SECTORUL 1",179141,106,2,1936,1516,1268,248,1513,3,"SECTORUL 1",,0,,470,1043
41,"București",403,"403-SECTORUL 1",179141,107,2,2051,1553,1404,149,1547,6,"SECTORUL 1",,0,,491,1056
41,"București",403,"403-SECTORUL 1",179141,108,2,1560,1104,937,167,1097,7,"SECTORUL 1",,0,,367,730
41,"București",403,"403-SECTORUL 1",179141,109,2,1935,1529,1354,175,1522,6,"SECTORUL 1",,0,,514,1008
41,"București",403,"403-SECTORUL 1",179141,110,2,1512,1264,1106,158,1261,3,"SECTORUL 1",,0,,506,755
41,"București",403,"403-SECTORUL 1",179141,111,2,1503,1151,1057,94,1144,7,"SECTORUL 1",,0,,419,725
41,"București",403,"403-SECTORUL 1",179141,112,2,1648,1269,1126,143,1260,9,"SECTORUL 1",,0,,572,688
41,"București",403,"403-SECTORUL 1",179141,113,2,1575,1226,1139,87,1218,8,"SECTORUL 1",,0,,411,807
41,"București",403,"403-SECTORUL 1",179141,114,2,1875,1432,1316,116,1429,3,"SECTORUL 1",,0,,455,974
41,"București",403,"403-SECTORUL 1",179141,115,2,1580,1321,1048,273,1314,7,"SECTORUL 1",,0,,562,752
41,"București",403,"403-SECTORUL 1",179141,116,2,1927,1446,1249,197,1439,7,"SECTORUL 1",,0,,710,729
41,"București",403,"403-SECTORUL 1",179141,117,2,1543,1185,1088,97,1183,2,"SECTORUL 1",,0,,529,654
41,"București",403,"403-SECTORUL 1",179141,118,2,1831,1454,1297,157,1447,7,"SECTORUL 1",,0,,563,884
41,"București",403,"403-SECTORUL 1",179141,119,2,2035,1632,1449,183,1624,8,"SECTORUL 1",,0,,573,1051
41,"București",403,"403-SECTORUL 1",179141,120,2,1951,1473,1330,143,1466,7,"SECTORUL 1",,0,,809,657
41,"București",403,"403-SECTORUL 1",179141,121,2,1919,1518,1382,136,1514,4,"SECTORUL 1",,0,,581,933
41,"București",403,"403-SECTORUL 1",179141,122,2,1687,1225,1102,123,1220,5,"SECTORUL 1",,0,,469,751
41,"București",403,"403-SECTORUL 1",179141,123,2,1529,1195,1014,181,1192,3,"SECTORUL 1",,0,,402,790
41,"București",403,"403-SECTORUL 1",179141,124,2,1748,1303,1182,121,1299,4,"SECTORUL 1",,0,,494,805
41,"București",403,"403-SECTORUL 1",179141,125,2,1803,1376,1239,137,1368,8,"SECTORUL 1",,0,,538,830
41,"București",403,"403-SECTORUL 1",179141,126,2,1850,1342,1246,96,1341,1,"SECTORUL 1",,0,,579,762
41,"București",403,"403-SECTORUL 1",179141,127,2,2045,1531,1343,188,1529,2,"SECTORUL 1",,0,,696,833
41,"București",403,"403-SECTORUL 1",179141,128,2,1840,1317,1174,143,1311,6,"SECTORUL 1",,0,,449,862
41,"București",403,"403-SECTORUL 1",179141,129,2,1854,1358,1256,102,1348,10,"SECTORUL 1",,0,,507,841
41,"București",403,"403-SECTORUL 1",179141,130,2,970,707,590,117,704,3,"SECTORUL 1",,0,,244,460
41,"București",403,"403-SECTORUL 1",179141,131,2,1081,725,677,48,725,0,"SECTORUL 1",,0,,274,451
41,"București",403,"403-SECTORUL 1",179141,132,2,0,237,0,237,237,0,"SECTORUL 1",,0,,100,137
41,"București",403,"403-SECTORUL 1",179141,133,2,0,132,0,132,132,0,"SECTORUL 1",,0,,45,87
41,"București",403,"403-SECTORUL 1",179141,134,2,0,184,0,184,183,1,"SECTORUL 1",,0,,77,106
41,"București",403,"403-SECTORUL 1",179141,135,2,0,367,0,367,366,1,"SECTORUL 1",,0,,196,170
41,"București",403,"403-SECTORUL 1",179141,136,2,0,159,0,159,159,0,"SECTORUL 1",,0,,62,97
41,"București",403,"403-SECTORUL 1",179141,137,2,0,208,0,208,206,2,"SECTORUL 1",,0,,85,121
41,"București",403,"403-SECTORUL 1",179141,138,2,0,348,0,348,346,2,"SECTORUL 1",,0,,136,210
41,"București",403,"403-SECTORUL 1",179141,139,2,0,856,0,856,853,0,"SECTORUL 1",,0,,323,530
41,"București",403,"403-SECTORUL 1",179141,140,2,0,205,0,205,204,1,"SECTORUL 1",,0,,83,121
41,"București",403,"403-SECTORUL 1",179141,141,2,0,194,0,194,192,2,"SECTORUL 1",,0,,56,136
41,"București",403,"403-SECTORUL 1",179141,142,2,0,1845,0,1845,1833,10,"SECTORUL 1",,0,,393,1440
41,"București",403,"403-SECTORUL 1",179141,143,2,0,617,0,617,613,4,"SECTORUL 1",,0,,106,507
41,"București",403,"403-SECTORUL 1",179141,144,2,0,3688,0,3688,3658,13,"SECTORUL 1",,0,,918,2740
41,"București",403,"403-SECTORUL 1",179141,145,2,0,1761,0,1761,1748,5,"SECTORUL 1",,0,,409,1339
41,"București",403,"403-SECTORUL 1",179141,146,2,0,149,0,149,149,0,"SECTORUL 1",,0,,52,97
41,"București",403,"403-SECTORUL 2",179150,147,2,1896,1369,1167,202,1367,2,"SECTORUL 2",,0,,463,904
41,"București",403,"403-SECTORUL 2",179150,148,2,1649,1165,1028,137,1148,7,"SECTORUL 2",,0,,383,765
41,"București",403,"403-SECTORUL 2",179150,149,2,1876,1454,1180,274,1447,7,"SECTORUL 2",,0,,484,963
41,"București",403,"403-SECTORUL 2",179150,150,2,1798,1249,1123,126,1242,7,"SECTORUL 2",,0,,418,824
41,"București",403,"403-SECTORUL 2",179150,151,2,1565,1092,957,135,1089,3,"SECTORUL 2",,0,,386,703
41,"București",403,"403-SECTORUL 2",179150,152,2,2555,1490,1126,364,1486,4,"SECTORUL 2",,0,,537,949
41,"București",403,"403-SECTORUL 2",179150,153,2,1619,1172,1027,145,1168,4,"SECTORUL 2",,0,,391,777
41,"București",403,"403-SECTORUL 2",179150,154,2,1919,1396,1227,169,1390,6,"SECTORUL 2",,0,,444,946
41,"București",403,"403-SECTORUL 2",179150,155,2,2072,1443,1267,176,1429,14,"SECTORUL 2",,0,,572,857
41,"București",403,"403-SECTORUL 2",179150,156,2,1965,1472,1305,167,1463,9,"SECTORUL 2",,0,,526,937
41,"București",403,"403-SECTORUL 2",179150,157,2,1882,1470,1349,121,1463,7,"SECTORUL 2",,0,,513,950
41,"București",403,"403-SECTORUL 2",179150,158,2,1423,1084,984,100,1078,6,"SECTORUL 2",,0,,281,797
41,"București",403,"403-SECTORUL 2",179150,159,2,1968,1488,1367,121,1481,7,"SECTORUL 2",,0,,756,725
41,"București",403,"403-SECTORUL 2",179150,160,2,1481,1008,879,129,1003,5,"SECTORUL 2",,0,,349,654
41,"București",403,"403-SECTORUL 2",179150,161,2,1616,1149,1036,113,1147,2,"SECTORUL 2",,0,,380,767
41,"București",403,"403-SECTORUL 2",179150,162,2,1259,792,711,81,788,4,"SECTORUL 2",,0,,265,523
41,"București",403,"403-SECTORUL 2",179150,163,2,1564,1133,1039,94,1128,5,"SECTORUL 2",,0,,389,739
41,"București",403,"403-SECTORUL 2",179150,164,2,1561,1095,943,152,1090,5,"SECTORUL 2",,0,,370,720
41,"București",403,"403-SECTORUL 2",179150,165,2,1465,992,893,99,989,2,"SECTORUL 2",,0,,331,658
41,"București",403,"403-SECTORUL 2",179150,166,2,1283,1065,910,155,1063,2,"SECTORUL 2",,0,,311,752
41,"București",403,"403-SECTORUL 2",179150,167,2,1432,1139,954,185,1134,5,"SECTORUL 2",,0,,499,635
41,"București",403,"403-SECTORUL 2",179150,168,2,1663,1314,1194,120,1311,3,"SECTORUL 2",,0,,447,864
41,"București",403,"403-SECTORUL 2",179150,169,2,1856,1514,1104,410,1494,20,"SECTORUL 2",,0,,572,922
41,"București",403,"403-SECTORUL 2",179150,170,2,1971,1441,1304,137,1435,6,"SECTORUL 2",,0,,536,899
41,"București",403,"403-SECTORUL 2",179150,171,2,1816,1296,1181,115,1286,4,"SECTORUL 2",,0,,464,822
41,"București",403,"403-SECTORUL 2",179150,172,2,1519,1013,941,72,1005,8,"SECTORUL 2",,0,,337,668
41,"București",403,"403-SECTORUL 2",179150,173,2,1576,1110,1000,110,1106,4,"SECTORUL 2",,0,,371,735
41,"București",403,"403-SECTORUL 2",179150,174,2,1481,1043,933,110,1032,11,"SECTORUL 2",,0,,347,685
41,"București",403,"403-SECTORUL 2",179150,175,2,2036,1424,1279,145,1423,1,"SECTORUL 2",,0,,462,961
41,"București",403,"403-SECTORUL 2",179150,176,2,2107,1522,1364,158,1508,14,"SECTORUL 2",,0,,496,1012
41,"București",403,"403-SECTORUL 2",179150,177,2,1844,1324,1226,98,1308,16,"SECTORUL 2",,0,,454,854
41,"București",403,"403-SECTORUL 2",179150,178,2,1390,1054,972,82,1054,0,"SECTORUL 2",,0,,404,650
41,"București",403,"403-SECTORUL 2",179150,179,2,1379,953,894,59,948,5,"SECTORUL 2",,0,,377,571
41,"București",403,"403-SECTORUL 2",179150,180,2,1462,1186,1058,128,1183,3,"SECTORUL 2",,0,,517,666
41,"București",403,"403-SECTORUL 2",179150,181,2,1525,1193,1021,172,1188,5,"SECTORUL 2",,0,,532,656
41,"București",403,"403-SECTORUL 2",179150,182,2,1702,1291,1197,94,1289,2,"SECTORUL 2",,0,,518,771
41,"București",403,"403-SECTORUL 2",179150,183,2,1755,1191,1112,79,1184,7,"SECTORUL 2",,0,,354,830
41,"București",403,"403-SECTORUL 2",179150,184,2,1814,1235,1046,189,1226,9,"SECTORUL 2",,0,,452,774
41,"București",403,"403-SECTORUL 2",179150,185,2,1567,1035,937,98,1032,3,"SECTORUL 2",,0,,361,671
41,"București",403,"403-SECTORUL 2",179150,186,2,2040,1635,1500,135,1626,9,"SECTORUL 2",,0,,467,1159
41,"București",403,"403-SECTORUL 2",179150,187,2,1631,1227,1091,136,1219,8,"SECTORUL 2",,0,,500,719
41,"București",403,"403-SECTORUL 2",179150,188,2,1940,1258,1155,103,1249,9,"SECTORUL 2",,0,,461,788
41,"București",403,"403-SECTORUL 2",179150,189,2,1767,1281,1144,137,1267,14,"SECTORUL 2",,0,,424,843
41,"București",403,"403-SECTORUL 2",179150,190,2,1897,1399,1209,190,1392,7,"SECTORUL 2",,0,,472,920
41,"București",403,"403-SECTORUL 2",179150,191,2,1692,1342,1125,217,1338,4,"SECTORUL 2",,0,,477,861
41,"București",403,"403-SECTORUL 2",179150,192,2,2013,1653,1530,123,1643,10,"SECTORUL 2",,0,,443,1200
41,"București",403,"403-SECTORUL 2",179150,193,2,1913,1354,1213,141,1340,14,"SECTORUL 2",,0,,505,835
41,"București",403,"403-SECTORUL 2",179150,194,2,1566,1082,940,142,1078,4,"SECTORUL 2",,0,,410,668
41,"București",403,"403-SECTORUL 2",179150,195,2,1979,1260,1159,101,1253,7,"SECTORUL 2",,0,,427,826
41,"București",403,"403-SECTORUL 2",179150,196,2,1773,1184,1078,106,1179,5,"SECTORUL 2",,0,,436,743
41,"București",403,"403-SECTORUL 2",179150,197,2,1938,1380,1288,92,1380,0,"SECTORUL 2",,0,,494,886
41,"București",403,"403-SECTORUL 2",179150,198,2,1923,1267,1198,69,1266,1,"SECTORUL 2",,0,,404,862
41,"București",403,"403-SECTORUL 2",179150,199,2,2018,1205,1080,125,1193,12,"SECTORUL 2",,0,,433,760
41,"București",403,"403-SECTORUL 2",179150,200,2,1760,1211,1106,105,1204,7,"SECTORUL 2",,0,,305,899
41,"București",403,"403-SECTORUL 2",179150,201,2,1971,1426,1329,97,1421,5,"SECTORUL 2",,0,,417,1004
41,"București",403,"403-SECTORUL 2",179150,202,2,1903,1356,1238,118,1355,1,"SECTORUL 2",,0,,457,898
41,"București",403,"403-SECTORUL 2",179150,203,2,1395,974,890,84,972,2,"SECTORUL 2",,0,,334,638
41,"București",403,"403-SECTORUL 2",179150,204,2,1985,1387,1220,167,1373,14,"SECTORUL 2",,0,,512,861
41,"București",403,"403-SECTORUL 2",179150,205,2,1999,1560,1419,141,1550,10,"SECTORUL 2",,0,,532,1018
41,"București",403,"403-SECTORUL 2",179150,206,2,1476,1107,1000,107,1102,5,"SECTORUL 2",,0,,375,727
41,"București",403,"403-SECTORUL 2",179150,207,2,1801,1201,1097,104,1191,10,"SECTORUL 2",,0,,435,756
41,"București",403,"403-SECTORUL 2",179150,208,2,1747,1412,1305,107,1406,6,"SECTORUL 2",,0,,514,892
41,"București",403,"403-SECTORUL 2",179150,209,2,1606,1303,1204,99,1295,8,"SECTORUL 2",,0,,398,897
41,"București",403,"403-SECTORUL 2",179150,210,2,501,651,263,388,649,2,"SECTORUL 2",,0,,206,443
41,"București",403,"403-SECTORUL 2",179150,211,2,1663,1290,1168,122,1284,6,"SECTORUL 2",,0,,423,861
41,"București",403,"403-SECTORUL 2",179150,212,2,1640,1274,1134,140,1272,2,"SECTORUL 2",,0,,397,875
41,"București",403,"403-SECTORUL 2",179150,213,2,1266,813,728,85,809,4,"SECTORUL 2",,0,,296,513
41,"București",403,"403-SECTORUL 2",179150,214,2,1912,1325,1225,100,1316,9,"SECTORUL 2",,0,,499,817
41,"București",403,"403-SECTORUL 2",179150,215,2,1722,1389,1216,173,1381,8,"SECTORUL 2",,0,,489,892
41,"București",403,"403-SECTORUL 2",179150,216,2,1362,1027,921,106,1021,6,"SECTORUL 2",,0,,364,657
41,"București",403,"403-SECTORUL 2",179150,217,2,1708,1188,1121,67,1183,5,"SECTORUL 2",,0,,457,726
41,"București",403,"403-SECTORUL 2",179150,218,2,1711,1082,953,129,1078,4,"SECTORUL 2",,0,,427,651
41,"București",403,"403-SECTORUL 2",179150,219,2,1587,1021,945,76,1011,10,"SECTORUL 2",,0,,377,634
41,"București",403,"403-SECTORUL 2",179150,220,2,1700,1183,1023,160,1170,13,"SECTORUL 2",,0,,447,723
41,"București",403,"403-SECTORUL 2",179150,221,2,1396,1040,903,137,1037,3,"SECTORUL 2",,0,,358,679
41,"București",403,"403-SECTORUL 2",179150,222,2,1605,978,863,115,973,5,"SECTORUL 2",,0,,418,555
41,"București",403,"403-SECTORUL 2",179150,223,2,1231,838,724,114,825,13,"SECTORUL 2",,0,,379,446
41,"București",403,"403-SECTORUL 2",179150,224,2,1455,1037,882,155,1025,12,"SECTORUL 2",,0,,453,572
41,"București",403,"403-SECTORUL 2",179150,225,2,1510,1047,967,80,1038,9,"SECTORUL 2",,0,,435,603
41,"București",403,"403-SECTORUL 2",179150,226,2,1438,1039,913,126,1031,8,"SECTORUL 2",,0,,384,647
41,"București",403,"403-SECTORUL 2",179150,227,2,1575,1076,975,101,1069,0,"SECTORUL 2",,0,,453,616
41,"București",403,"403-SECTORUL 2",179150,228,2,1604,1050,955,95,1046,4,"SECTORUL 2",,0,,402,644
41,"București",403,"403-SECTORUL 2",179150,229,2,1999,1355,1176,179,1345,10,"SECTORUL 2",,0,,510,835
41,"București",403,"403-SECTORUL 2",179150,230,2,1804,1030,920,110,1025,5,"SECTORUL 2",,0,,362,663
41,"București",403,"403-SECTORUL 2",179150,231,2,2051,1358,1153,205,1348,10,"SECTORUL 2",,0,,484,864
41,"București",403,"403-SECTORUL 2",179150,232,2,1946,1232,1129,103,1219,13,"SECTORUL 2",,0,,407,812
41,"București",403,"403-SECTORUL 2",179150,233,2,1438,952,841,111,945,7,"SECTORUL 2",,0,,325,620
41,"București",403,"403-SECTORUL 2",179150,234,2,1976,1376,1203,173,1360,16,"SECTORUL 2",,0,,501,859
41,"București",403,"403-SECTORUL 2",179150,235,2,1348,975,819,156,973,2,"SECTORUL 2",,0,,341,632
41,"București",403,"403-SECTORUL 2",179150,236,2,1856,1277,1117,160,1270,7,"SECTORUL 2",,0,,418,852
41,"București",403,"403-SECTORUL 2",179150,237,2,1639,1116,1029,87,1108,8,"SECTORUL 2",,0,,402,706
41,"București",403,"403-SECTORUL 2",179150,238,2,1471,839,719,120,820,19,"SECTORUL 2",,0,,353,467
41,"București",403,"403-SECTORUL 2",179150,239,2,1964,1304,1113,191,1300,4,"SECTORUL 2",,0,,422,878
41,"București",403,"403-SECTORUL 2",179150,240,2,2130,1347,1247,100,1341,6,"SECTORUL 2",,0,,457,884
41,"București",403,"403-SECTORUL 2",179150,241,2,1803,1179,1073,106,1173,6,"SECTORUL 2",,0,,393,780
41,"București",403,"403-SECTORUL 2",179150,242,2,1476,805,720,85,798,7,"SECTORUL 2",,0,,303,495
41,"București",403,"403-SECTORUL 2",179150,243,2,1388,893,758,135,887,6,"SECTORUL 2",,0,,345,542
41,"București",403,"403-SECTORUL 2",179150,244,2,1934,1547,1404,143,1541,6,"SECTORUL 2",,0,,565,976
41,"București",403,"403-SECTORUL 2",179150,245,2,1752,1268,1164,104,1260,8,"SECTORUL 2",,0,,506,754
41,"București",403,"403-SECTORUL 2",179150,246,2,1713,1263,1145,118,1257,6,"SECTORUL 2",,0,,485,772
41,"București",403,"403-SECTORUL 2",179150,247,2,1219,941,824,117,932,9,"SECTORUL 2",,0,,353,579
41,"București",403,"403-SECTORUL 2",179150,248,2,1413,990,861,129,981,9,"SECTORUL 2",,0,,355,626
41,"București",403,"403-SECTORUL 2",179150,249,2,1182,838,691,147,831,7,"SECTORUL 2",,0,,356,475
41,"București",403,"403-SECTORUL 2",179150,250,2,1618,1110,997,113,1106,4,"SECTORUL 2",,0,,410,696
41,"București",403,"403-SECTORUL 2",179150,251,2,1822,1438,1324,114,1431,7,"SECTORUL 2",,0,,550,881
41,"București",403,"403-SECTORUL 2",179150,252,2,1751,1305,1194,111,1295,10,"SECTORUL 2",,0,,491,804
41,"București",403,"403-SECTORUL 2",179150,253,2,1691,1327,1255,72,1320,7,"SECTORUL 2",,0,,454,866
41,"București",403,"403-SECTORUL 2",179150,254,2,1356,1027,943,84,1026,1,"SECTORUL 2",,0,,298,728
41,"București",403,"403-SECTORUL 2",179150,255,2,2301,1247,1095,152,1240,7,"SECTORUL 2",,0,,508,732
41,"București",403,"403-SECTORUL 2",179150,256,2,1914,1506,1358,148,1498,8,"SECTORUL 2",,0,,551,947
41,"București",403,"403-SECTORUL 2",179150,257,2,1738,1304,1217,87,1294,10,"SECTORUL 2",,0,,429,865
41,"București",403,"403-SECTORUL 2",179150,258,2,1768,1436,1250,186,1434,2,"SECTORUL 2",,0,,538,896
41,"București",403,"403-SECTORUL 2",179150,259,2,1916,1461,1269,192,1450,11,"SECTORUL 2",,0,,627,823
41,"București",403,"403-SECTORUL 2",179150,260,2,1810,1386,1266,120,1384,2,"SECTORUL 2",,0,,556,828
41,"București",403,"403-SECTORUL 2",179150,261,2,1729,1419,1298,121,1412,7,"SECTORUL 2",,0,,469,943
41,"București",403,"403-SECTORUL 2",179150,262,2,1869,1403,1326,77,1399,4,"SECTORUL 2",,0,,583,816
41,"București",403,"403-SECTORUL 2",179150,263,2,1938,1451,1278,173,1438,8,"SECTORUL 2",,0,,496,942
41,"București",403,"403-SECTORUL 2",179150,264,2,1439,1201,1025,176,1196,5,"SECTORUL 2",,0,,448,748
41,"București",403,"403-SECTORUL 2",179150,265,2,1687,1173,1076,97,1169,4,"SECTORUL 2",,0,,453,716
41,"București",403,"403-SECTORUL 2",179150,266,2,1340,1077,921,156,1074,3,"SECTORUL 2",,0,,421,653
41,"București",403,"403-SECTORUL 2",179150,267,2,1811,1321,1201,120,1317,4,"SECTORUL 2",,0,,412,905
41,"București",403,"403-SECTORUL 2",179150,268,2,1932,1419,1232,187,1411,8,"SECTORUL 2",,0,,431,980
41,"București",403,"403-SECTORUL 2",179150,269,2,1902,1511,1173,338,1502,9,"SECTORUL 2",,0,,504,998
41,"București",403,"403-SECTORUL 2",179150,270,2,1760,1492,1192,300,1483,9,"SECTORUL 2",,0,,477,1006
41,"București",403,"403-SECTORUL 2",179150,271,2,1635,1313,1131,182,1304,9,"SECTORUL 2",,0,,469,835
41,"București",403,"403-SECTORUL 2",179150,272,2,1278,1026,928,98,1021,5,"SECTORUL 2",,0,,405,616
41,"București",403,"403-SECTORUL 2",179150,273,2,1637,1041,959,82,1037,4,"SECTORUL 2",,0,,396,641
41,"București",403,"403-SECTORUL 2",179150,274,2,1478,1047,954,93,1043,4,"SECTORUL 2",,0,,449,594
41,"București",403,"403-SECTORUL 2",179150,275,2,1339,1035,921,114,1033,2,"SECTORUL 2",,0,,377,656
41,"București",403,"403-SECTORUL 2",179150,276,2,1539,1315,1088,227,1310,5,"SECTORUL 2",,0,,454,856
41,"București",403,"403-SECTORUL 2",179150,277,2,1597,1225,1086,139,1217,8,"SECTORUL 2",,0,,468,749
41,"București",403,"403-SECTORUL 2",179150,278,2,1563,1113,1047,66,1110,3,"SECTORUL 2",,0,,435,675
41,"București",403,"403-SECTORUL 2",179150,279,2,1757,1399,1270,129,1394,5,"SECTORUL 2",,0,,466,928
41,"București",403,"403-SECTORUL 2",179150,280,2,1569,1163,1076,87,1159,4,"SECTORUL 2",,0,,396,763
41,"București",403,"403-SECTORUL 2",179150,281,2,1459,1155,1076,79,1153,2,"SECTORUL 2",,0,,378,775
41,"București",403,"403-SECTORUL 2",179150,282,2,1387,890,790,100,887,3,"SECTORUL 2",,0,,377,510
41,"București",403,"403-SECTORUL 2",179150,283,2,1543,1111,963,148,1104,7,"SECTORUL 2",,0,,401,703
41,"București",403,"403-SECTORUL 2",179150,284,2,1748,1436,1255,181,1429,7,"SECTORUL 2",,0,,566,863
41,"București",403,"403-SECTORUL 2",179150,285,2,1392,1081,960,121,1073,7,"SECTORUL 2",,0,,347,726
41,"București",403,"403-SECTORUL 2",179150,286,2,1869,1309,1198,111,1306,3,"SECTORUL 2",,0,,443,863
41,"București",403,"403-SECTORUL 2",179150,287,2,1659,1266,1172,94,1263,3,"SECTORUL 2",,0,,471,792
41,"București",403,"403-SECTORUL 2",179150,288,2,1390,1101,999,102,1098,3,"SECTORUL 2",,0,,300,798
41,"București",403,"403-SECTORUL 2",179150,289,2,1939,1501,1391,110,1490,9,"SECTORUL 2",,0,,492,998
41,"București",403,"403-SECTORUL 2",179150,290,2,1511,1230,1091,139,1229,1,"SECTORUL 2",,0,,377,852
41,"București",403,"403-SECTORUL 2",179150,291,2,1430,1162,1031,131,1158,4,"SECTORUL 2",,0,,395,763
41,"București",403,"403-SECTORUL 2",179150,292,2,1944,1510,1334,176,1506,4,"SECTORUL 2",,0,,491,1015
41,"București",403,"403-SECTORUL 2",179150,293,2,1664,1223,1147,76,1218,4,"SECTORUL 2",,0,,357,861
41,"București",403,"403-SECTORUL 2",179150,294,2,1337,974,897,77,972,2,"SECTORUL 2",,0,,333,639
41,"București",403,"403-SECTORUL 2",179150,295,2,1815,1271,1182,89,1267,4,"SECTORUL 2",,0,,512,755
41,"București",403,"403-SECTORUL 2",179150,296,2,1740,1318,1192,126,1315,3,"SECTORUL 2",,0,,582,733
41,"București",403,"403-SECTORUL 2",179150,297,2,1840,1423,1348,75,1419,4,"SECTORUL 2",,0,,540,879
41,"București",403,"403-SECTORUL 2",179150,298,2,1526,1219,1128,91,1214,5,"SECTORUL 2",,0,,491,723
41,"București",403,"403-SECTORUL 2",179150,299,2,1982,1556,1428,128,1550,6,"SECTORUL 2",,0,,511,1039
41,"București",403,"403-SECTORUL 2",179150,300,2,1692,1336,1212,124,1329,7,"SECTORUL 2",,0,,436,893
41,"București",403,"403-SECTORUL 2",179150,301,2,1420,891,777,114,888,3,"SECTORUL 2",,0,,359,529
41,"București",403,"403-SECTORUL 2",179150,302,2,1442,1060,970,90,1057,3,"SECTORUL 2",,0,,437,620
41,"București",403,"403-SECTORUL 2",179150,303,2,1814,1333,1174,159,1327,6,"SECTORUL 2",,0,,601,726
41,"București",403,"403-SECTORUL 2",179150,304,2,1515,858,740,118,848,10,"SECTORUL 2",,0,,380,468
41,"București",403,"403-SECTORUL 2",179150,305,2,1632,1223,1112,111,1217,6,"SECTORUL 2",,0,,441,776
41,"București",403,"403-SECTORUL 2",179150,306,2,1458,1044,982,62,1040,4,"SECTORUL 2",,0,,427,613
41,"București",403,"403-SECTORUL 2",179150,307,2,1532,1049,898,151,1049,0,"SECTORUL 2",,0,,361,688
41,"București",403,"403-SECTORUL 2",179150,308,2,1454,1149,1030,119,1144,5,"SECTORUL 2",,0,,482,662
41,"București",403,"403-SECTORUL 2",179150,309,2,1501,1166,1055,111,1163,3,"SECTORUL 2",,0,,357,806
41,"București",403,"403-SECTORUL 2",179150,310,2,1851,1231,1141,90,1222,9,"SECTORUL 2",,0,,463,759
41,"București",403,"403-SECTORUL 2",179150,311,2,1341,980,840,140,975,5,"SECTORUL 2",,0,,374,601
41,"București",403,"403-SECTORUL 2",179150,312,2,1538,1237,1121,116,1233,4,"SECTORUL 2",,0,,395,838
41,"București",403,"403-SECTORUL 2",179150,313,2,1637,1172,1095,77,1170,2,"SECTORUL 2",,0,,438,732
41,"București",403,"403-SECTORUL 2",179150,314,2,1638,1294,1150,144,1289,5,"SECTORUL 2",,0,,498,791
41,"București",403,"403-SECTORUL 2",179150,315,2,1543,1050,963,87,1042,8,"SECTORUL 2",,0,,432,610
41,"București",403,"403-SECTORUL 2",179150,316,2,1720,1274,1184,90,1271,3,"SECTORUL 2",,0,,477,794
41,"București",403,"403-SECTORUL 2",179150,317,2,1674,1172,1068,104,1164,8,"SECTORUL 2",,0,,436,728
41,"București",403,"403-SECTORUL 2",179150,318,2,1727,1286,864,422,1262,24,"SECTORUL 2",,0,,547,715
41,"București",403,"403-SECTORUL 2",179150,319,2,1677,1176,1036,140,1173,3,"SECTORUL 2",,0,,412,761
41,"București",403,"403-SECTORUL 2",179150,320,2,1470,1042,900,142,1033,9,"SECTORUL 2",,0,,403,630
41,"București",403,"403-SECTORUL 2",179150,321,2,1313,1002,907,95,992,10,"SECTORUL 2",,0,,371,621
41,"București",403,"403-SECTORUL 2",179150,322,2,2003,1388,1231,157,1384,4,"SECTORUL 2",,0,,545,839
41,"București",403,"403-SECTORUL 2",179150,323,2,1773,1364,1221,143,1354,10,"SECTORUL 2",,0,,566,788
41,"București",403,"403-SECTORUL 2",179150,324,2,1914,1298,1170,128,1288,10,"SECTORUL 2",,0,,529,759
41,"București",403,"403-SECTORUL 2",179150,325,2,1991,1436,1311,125,1424,12,"SECTORUL 2",,0,,509,915
41,"București",403,"403-SECTORUL 2",179150,326,2,2256,1603,1421,182,1594,9,"SECTORUL 2",,0,,709,885
41,"București",403,"403-SECTORUL 2",179150,327,2,1404,1167,943,224,1164,3,"SECTORUL 2",,0,,466,698
41,"București",403,"403-SECTORUL 2",179150,328,2,1315,1004,834,170,998,6,"SECTORUL 2",,0,,428,570
41,"București",403,"403-SECTORUL 2",179150,329,2,1453,1063,930,133,1054,9,"SECTORUL 2",,0,,467,587
41,"București",403,"403-SECTORUL 2",179150,330,2,1809,1360,1216,144,1357,3,"SECTORUL 2",,0,,573,784
41,"București",403,"403-SECTORUL 2",179150,331,2,2014,1427,1346,81,1423,4,"SECTORUL 2",,0,,533,890
41,"București",403,"403-SECTORUL 2",179150,332,2,1948,1412,1293,119,1406,6,"SECTORUL 2",,0,,580,826
41,"București",403,"403-SECTORUL 2",179150,333,2,2400,1544,1425,119,1538,6,"SECTORUL 2",,0,,629,909
41,"București",403,"403-SECTORUL 2",179150,334,2,1621,1222,1107,115,1220,2,"SECTORUL 2",,0,,449,771
41,"București",403,"403-SECTORUL 2",179150,335,2,1793,1268,1183,85,1262,6,"SECTORUL 2",,0,,488,774
41,"București",403,"403-SECTORUL 2",179150,336,2,1978,1365,1281,84,1356,9,"SECTORUL 2",,0,,508,848
41,"București",403,"403-SECTORUL 2",179150,337,2,1608,1177,1067,110,1154,23,"SECTORUL 2",,0,,469,685
41,"București",403,"403-SECTORUL 2",179150,338,2,1512,1069,1007,62,1063,6,"SECTORUL 2",,0,,394,669
41,"București",403,"403-SECTORUL 2",179150,339,2,0,1323,0,1323,1318,5,"SECTORUL 2",,0,,172,1146
41,"București",403,"403-SECTORUL 2",179150,340,2,0,105,0,105,105,0,"SECTORUL 2",,0,,52,53
41,"București",403,"403-SECTORUL 2",179150,341,2,0,399,0,399,396,3,"SECTORUL 2",,0,,150,246
41,"București",403,"403-SECTORUL 2",179150,342,2,0,385,0,385,383,2,"SECTORUL 2",,0,,155,228
41,"București",403,"403-SECTORUL 2",179150,343,2,0,180,0,180,180,0,"SECTORUL 2",,0,,78,102
41,"București",403,"403-SECTORUL 2",179150,344,2,0,483,0,483,479,4,"SECTORUL 2",,0,,192,287
41,"București",403,"403-SECTORUL 2",179150,345,2,0,222,0,222,222,0,"SECTORUL 2",,0,,143,79
41,"București",403,"403-SECTORUL 2",179150,346,2,0,265,0,265,262,3,"SECTORUL 2",,0,,81,181
41,"București",403,"403-SECTORUL 2",179150,347,2,0,607,0,607,594,13,"SECTORUL 2",,0,,282,312
41,"București",403,"403-SECTORUL 2",179150,348,2,0,1092,0,1092,1086,6,"SECTORUL 2",,0,,465,621
41,"București",403,"403-SECTORUL 2",179150,349,2,0,244,0,244,243,1,"SECTORUL 2",,0,,119,124
41,"București",403,"403-SECTORUL 2",179150,350,2,0,124,0,124,121,3,"SECTORUL 2",,0,,44,77
41,"București",403,"403-SECTORUL 2",179150,351,2,0,84,0,84,82,2,"SECTORUL 2",,0,,31,51
41,"București",403,"403-SECTORUL 2",179150,352,2,0,128,0,128,126,2,"SECTORUL 2",,0,,74,52
41,"București",403,"403-SECTORUL 2",179150,353,2,0,73,0,73,71,2,"SECTORUL 2",,0,,7,64
41,"București",403,"403-SECTORUL 2",179150,354,2,0,91,0,91,91,0,"SECTORUL 2",,0,,36,55
41,"București",403,"403-SECTORUL 3",179169,355,2,1550,1096,939,157,1093,3,"SECTORUL 3",,0,,522,571
41,"București",403,"403-SECTORUL 3",179169,356,2,1493,1073,782,291,1070,3,"SECTORUL 3",,0,,437,633
41,"București",403,"403-SECTORUL 3",179169,357,2,1643,1056,957,99,1047,9,"SECTORUL 3",,0,,381,666
41,"București",403,"403-SECTORUL 3",179169,358,2,1629,1087,950,137,1084,3,"SECTORUL 3",,0,,436,648
41,"București",403,"403-SECTORUL 3",179169,359,2,1743,1028,944,84,1023,5,"SECTORUL 3",,0,,367,656
41,"București",403,"403-SECTORUL 3",179169,360,2,1690,1126,961,165,1123,3,"SECTORUL 3",,0,,411,712
41,"București",403,"403-SECTORUL 3",179169,361,2,1335,1130,850,280,1126,4,"SECTORUL 3",,0,,457,669
41,"București",403,"403-SECTORUL 3",179169,362,2,1213,890,724,166,885,5,"SECTORUL 3",,0,,343,542
41,"București",403,"403-SECTORUL 3",179169,363,2,1539,1248,925,323,1239,9,"SECTORUL 3",,0,,475,764
41,"București",403,"403-SECTORUL 3",179169,364,2,1593,1087,860,227,1082,5,"SECTORUL 3",,0,,380,702
41,"București",403,"403-SECTORUL 3",179169,365,2,1501,1023,901,122,1017,6,"SECTORUL 3",,0,,366,651
41,"București",403,"403-SECTORUL 3",179169,366,2,1023,883,636,247,880,3,"SECTORUL 3",,0,,288,592
41,"București",403,"403-SECTORUL 3",179169,367,2,1217,919,729,190,910,9,"SECTORUL 3",,0,,288,622
41,"București",403,"403-SECTORUL 3",179169,368,2,1701,911,747,164,904,7,"SECTORUL 3",,0,,356,548
41,"București",403,"403-SECTORUL 3",179169,369,2,1868,1154,1008,146,1145,8,"SECTORUL 3",,0,,378,767
41,"București",403,"403-SECTORUL 3",179169,370,2,1266,786,665,121,776,10,"SECTORUL 3",,0,,275,501
41,"București",403,"403-SECTORUL 3",179169,371,2,2019,1796,1182,614,1788,8,"SECTORUL 3",,0,,610,1178
41,"București",403,"403-SECTORUL 3",179169,372,2,1281,1086,917,169,1083,3,"SECTORUL 3",,0,,381,702
41,"București",403,"403-SECTORUL 3",179169,373,2,1179,909,857,52,909,0,"SECTORUL 3",,0,,283,626
41,"București",403,"403-SECTORUL 3",179169,374,2,1693,1365,1233,132,1360,5,"SECTORUL 3",,0,,517,843
41,"București",403,"403-SECTORUL 3",179169,375,2,1672,1040,953,87,1038,2,"SECTORUL 3",,0,,328,710
41,"București",403,"403-SECTORUL 3",179169,376,2,1572,1159,1093,66,1152,7,"SECTORUL 3",,0,,377,775
41,"București",403,"403-SECTORUL 3",179169,377,2,2074,1679,1414,265,1673,6,"SECTORUL 3",,0,,564,1109
41,"București",403,"403-SECTORUL 3",179169,378,2,1443,1060,870,190,1053,7,"SECTORUL 3",,0,,429,624
41,"București",403,"403-SECTORUL 3",179169,379,2,1411,1140,1002,138,1140,0,"SECTORUL 3",,0,,446,694
41,"București",403,"403-SECTORUL 3",179169,380,2,1515,1179,1034,145,1175,4,"SECTORUL 3",,0,,403,772
41,"București",403,"403-SECTORUL 3",179169,381,2,1272,948,870,78,945,3,"SECTORUL 3",,0,,326,619
41,"București",403,"403-SECTORUL 3",179169,382,2,1611,1084,1004,80,1078,6,"SECTORUL 3",,0,,361,717
41,"București",403,"403-SECTORUL 3",179169,383,2,1952,1325,1151,174,1315,10,"SECTORUL 3",,0,,457,858
41,"București",403,"403-SECTORUL 3",179169,384,2,1181,780,641,139,780,0,"SECTORUL 3",,0,,289,491
41,"București",403,"403-SECTORUL 3",179169,385,2,2103,1423,1182,241,1419,4,"SECTORUL 3",,0,,457,962
41,"București",403,"403-SECTORUL 3",179169,386,2,1689,1141,976,165,1137,3,"SECTORUL 3",,0,,387,750
41,"București",403,"403-SECTORUL 3",179169,387,2,1498,1073,914,159,1065,6,"SECTORUL 3",,0,,356,709
41,"București",403,"403-SECTORUL 3",179169,388,2,2214,1400,1200,200,1394,6,"SECTORUL 3",,0,,429,965
41,"București",403,"403-SECTORUL 3",179169,389,2,1035,855,556,299,854,1,"SECTORUL 3",,0,,293,561
41,"București",403,"403-SECTORUL 3",179169,390,2,1292,900,726,174,895,5,"SECTORUL 3",,0,,288,607
41,"București",403,"403-SECTORUL 3",179169,391,2,1973,1023,800,223,1018,5,"SECTORUL 3",,0,,328,690
41,"București",403,"403-SECTORUL 3",179169,392,2,1483,1018,809,209,1015,3,"SECTORUL 3",,0,,336,679
41,"București",403,"403-SECTORUL 3",179169,393,2,957,875,414,461,863,12,"SECTORUL 3",,0,,313,550
41,"București",403,"403-SECTORUL 3",179169,394,2,1221,844,722,122,842,2,"SECTORUL 3",,0,,287,555
41,"București",403,"403-SECTORUL 3",179169,395,2,1503,1154,899,255,1145,9,"SECTORUL 3",,0,,455,690
41,"București",403,"403-SECTORUL 3",179169,396,2,1321,975,836,139,965,10,"SECTORUL 3",,0,,332,633
41,"București",403,"403-SECTORUL 3",179169,397,2,1011,809,676,133,805,4,"SECTORUL 3",,0,,268,537
41,"București",403,"403-SECTORUL 3",179169,398,2,1262,765,651,114,763,2,"SECTORUL 3",,0,,270,493
41,"București",403,"403-SECTORUL 3",179169,399,2,2002,1372,1182,190,1362,10,"SECTORUL 3",,0,,415,947
41,"București",403,"403-SECTORUL 3",179169,400,2,1318,903,800,103,895,8,"SECTORUL 3",,0,,287,608
41,"București",403,"403-SECTORUL 3",179169,401,2,1683,1103,1047,56,1100,3,"SECTORUL 3",,0,,403,697
41,"București",403,"403-SECTORUL 3",179169,402,2,1990,1195,1058,137,1188,6,"SECTORUL 3",,0,,484,704
41,"București",403,"403-SECTORUL 3",179169,403,2,1060,723,598,125,717,6,"SECTORUL 3",,0,,288,429
41,"București",403,"403-SECTORUL 3",179169,404,2,1663,1286,1029,257,1278,8,"SECTORUL 3",,0,,373,905
41,"București",403,"403-SECTORUL 3",179169,405,2,1140,831,742,89,828,3,"SECTORUL 3",,0,,278,550
41,"București",403,"403-SECTORUL 3",179169,406,2,919,707,629,78,704,3,"SECTORUL 3",,0,,285,419
41,"București",403,"403-SECTORUL 3",179169,407,2,1358,1061,973,88,1060,1,"SECTORUL 3",,0,,374,686
41,"București",403,"403-SECTORUL 3",179169,408,2,1155,868,815,53,868,0,"SECTORUL 3",,0,,359,509
41,"București",403,"403-SECTORUL 3",179169,409,2,1365,1035,935,100,1031,4,"SECTORUL 3",,0,,444,587
41,"București",403,"403-SECTORUL 3",179169,410,2,1011,742,678,64,740,2,"SECTORUL 3",,0,,273,467
41,"București",403,"403-SECTORUL 3",179169,411,2,1452,1027,926,101,1022,5,"SECTORUL 3",,0,,360,662
41,"București",403,"403-SECTORUL 3",179169,412,2,853,780,564,216,775,5,"SECTORUL 3",,0,,294,481
41,"București",403,"403-SECTORUL 3",179169,413,2,1437,975,852,123,971,4,"SECTORUL 3",,0,,360,611
41,"București",403,"403-SECTORUL 3",179169,414,2,1400,1018,899,119,1011,7,"SECTORUL 3",,0,,420,591
41,"București",403,"403-SECTORUL 3",179169,415,2,1147,884,822,62,878,6,"SECTORUL 3",,0,,367,511
41,"București",403,"403-SECTORUL 3",179169,416,2,1230,949,844,105,942,7,"SECTORUL 3",,0,,371,571
41,"București",403,"403-SECTORUL 3",179169,417,2,1548,1167,1049,118,1163,4,"SECTORUL 3",,0,,479,684
41,"București",403,"403-SECTORUL 3",179169,418,2,1557,1103,1030,73,1098,5,"SECTORUL 3",,0,,449,649
41,"București",403,"403-SECTORUL 3",179169,419,2,1435,1102,984,118,1091,11,"SECTORUL 3",,0,,399,692
41,"București",403,"403-SECTORUL 3",179169,420,2,1054,799,695,104,796,3,"SECTORUL 3",,0,,309,487
41,"București",403,"403-SECTORUL 3",179169,421,2,1291,964,895,69,957,6,"SECTORUL 3",,0,,384,573
41,"București",403,"403-SECTORUL 3",179169,422,2,1304,906,770,136,904,2,"SECTORUL 3",,0,,357,547
41,"București",403,"403-SECTORUL 3",179169,423,2,1175,941,811,130,935,6,"SECTORUL 3",,0,,359,576
41,"București",403,"403-SECTORUL 3",179169,424,2,1181,857,774,83,847,10,"SECTORUL 3",,0,,311,536
41,"București",403,"403-SECTORUL 3",179169,425,2,1422,1006,930,76,999,7,"SECTORUL 3",,0,,416,583
41,"București",403,"403-SECTORUL 3",179169,426,2,1223,866,805,61,865,1,"SECTORUL 3",,0,,308,557
41,"București",403,"403-SECTORUL 3",179169,427,2,1131,819,724,95,816,3,"SECTORUL 3",,0,,270,546
41,"București",403,"403-SECTORUL 3",179169,428,2,1547,1243,1104,139,1239,4,"SECTORUL 3",,0,,442,797
41,"București",403,"403-SECTORUL 3",179169,429,2,1480,1164,1064,100,1159,5,"SECTORUL 3",,0,,384,775
41,"București",403,"403-SECTORUL 3",179169,430,2,922,718,671,47,713,5,"SECTORUL 3",,0,,307,406
41,"București",403,"403-SECTORUL 3",179169,431,2,1618,1247,1149,98,1244,3,"SECTORUL 3",,0,,450,794
41,"București",403,"403-SECTORUL 3",179169,432,2,1477,1196,988,208,1193,3,"SECTORUL 3",,0,,421,772
41,"București",403,"403-SECTORUL 3",179169,433,2,1374,1076,899,177,1073,3,"SECTORUL 3",,0,,386,687
41,"București",403,"403-SECTORUL 3",179169,434,2,1286,995,908,87,988,7,"SECTORUL 3",,0,,346,642
41,"București",403,"403-SECTORUL 3",179169,435,2,1671,1183,1080,103,1178,5,"SECTORUL 3",,0,,355,823
41,"București",403,"403-SECTORUL 3",179169,436,2,1070,916,791,125,913,1,"SECTORUL 3",,0,,253,660
41,"București",403,"403-SECTORUL 3",179169,437,2,1507,1144,1070,74,1138,6,"SECTORUL 3",,0,,400,738
41,"București",403,"403-SECTORUL 3",179169,438,2,1449,1090,1022,68,1087,3,"SECTORUL 3",,0,,445,642
41,"București",403,"403-SECTORUL 3",179169,439,2,1282,864,779,85,861,3,"SECTORUL 3",,0,,351,510
41,"București",403,"403-SECTORUL 3",179169,440,2,1364,1024,883,141,1021,3,"SECTORUL 3",,0,,393,628
41,"București",403,"403-SECTORUL 3",179169,441,2,1365,1088,981,107,1081,7,"SECTORUL 3",,0,,374,707
41,"București",403,"403-SECTORUL 3",179169,442,2,1117,792,751,41,790,2,"SECTORUL 3",,0,,296,494
41,"București",403,"403-SECTORUL 3",179169,443,2,1189,901,827,74,899,2,"SECTORUL 3",,0,,319,580
41,"București",403,"403-SECTORUL 3",179169,444,2,1520,1087,996,91,1085,2,"SECTORUL 3",,0,,452,633
41,"București",403,"403-SECTORUL 3",179169,445,2,1543,1165,1046,119,1157,8,"SECTORUL 3",,0,,465,692
41,"București",403,"403-SECTORUL 3",179169,446,2,1204,954,834,120,951,2,"SECTORUL 3",,0,,399,552
41,"București",403,"403-SECTORUL 3",179169,447,2,1141,930,822,108,927,3,"SECTORUL 3",,0,,336,591
41,"București",403,"403-SECTORUL 3",179169,448,2,1808,1085,976,109,1080,5,"SECTORUL 3",,0,,380,700
41,"București",403,"403-SECTORUL 3",179169,449,2,1566,1083,964,119,1077,6,"SECTORUL 3",,0,,379,698
41,"București",403,"403-SECTORUL 3",179169,450,2,1697,1312,1185,127,1308,4,"SECTORUL 3",,0,,519,789
41,"București",403,"403-SECTORUL 3",179169,451,2,1519,1252,1080,172,1247,5,"SECTORUL 3",,0,,481,766
41,"București",403,"403-SECTORUL 3",179169,452,2,1533,1281,1139,142,1265,16,"SECTORUL 3",,0,,465,800
41,"București",403,"403-SECTORUL 3",179169,453,2,1748,1357,1247,110,1354,3,"SECTORUL 3",,0,,511,843
41,"București",403,"403-SECTORUL 3",179169,454,2,1313,972,854,118,970,2,"SECTORUL 3",,0,,362,608
41,"București",403,"403-SECTORUL 3",179169,455,2,983,706,493,213,701,5,"SECTORUL 3",,0,,225,476
41,"București",403,"403-SECTORUL 3",179169,456,2,1383,959,871,88,954,5,"SECTORUL 3",,0,,367,587
41,"București",403,"403-SECTORUL 3",179169,457,2,1316,989,825,164,984,5,"SECTORUL 3",,0,,392,592
41,"București",403,"403-SECTORUL 3",179169,458,2,981,728,629,99,723,5,"SECTORUL 3",,0,,274,449
41,"București",403,"403-SECTORUL 3",179169,459,2,1316,977,820,157,967,10,"SECTORUL 3",,0,,372,595
41,"București",403,"403-SECTORUL 3",179169,460,2,1791,1218,1047,171,1214,4,"SECTORUL 3",,0,,474,740
41,"București",403,"403-SECTORUL 3",179169,461,2,1135,743,625,118,741,2,"SECTORUL 3",,0,,217,524
41,"București",403,"403-SECTORUL 3",179169,462,2,1309,931,815,116,928,3,"SECTORUL 3",,0,,360,568
41,"București",403,"403-SECTORUL 3",179169,463,2,1391,1042,956,86,1037,5,"SECTORUL 3",,0,,371,666
41,"București",403,"403-SECTORUL 3",179169,464,2,1141,898,805,93,891,6,"SECTORUL 3",,0,,321,570
41,"București",403,"403-SECTORUL 3",179169,465,2,858,612,561,51,612,0,"SECTORUL 3",,0,,196,416
41,"București",403,"403-SECTORUL 3",179169,466,2,1035,739,590,149,734,5,"SECTORUL 3",,0,,247,487
41,"București",403,"403-SECTORUL 3",179169,467,2,1366,1086,855,231,1080,6,"SECTORUL 3",,0,,404,676
41,"București",403,"403-SECTORUL 3",179169,468,2,1075,695,655,40,692,3,"SECTORUL 3",,0,,248,444
41,"București",403,"403-SECTORUL 3",179169,469,2,1566,960,706,254,952,8,"SECTORUL 3",,0,,364,588
41,"București",403,"403-SECTORUL 3",179169,470,2,1080,797,670,127,793,4,"SECTORUL 3",,0,,353,440
41,"București",403,"403-SECTORUL 3",179169,471,2,1086,759,673,86,759,0,"SECTORUL 3",,0,,289,470
41,"București",403,"403-SECTORUL 3",179169,472,2,892,711,583,128,709,2,"SECTORUL 3",,0,,241,468
41,"București",403,"403-SECTORUL 3",179169,473,2,1103,704,651,53,702,2,"SECTORUL 3",,0,,268,434
41,"București",403,"403-SECTORUL 3",179169,474,2,1082,600,554,46,595,5,"SECTORUL 3",,0,,251,344
41,"București",403,"403-SECTORUL 3",179169,475,2,1010,692,491,201,691,1,"SECTORUL 3",,0,,252,439
41,"București",403,"403-SECTORUL 3",179169,476,2,1655,1343,1126,217,1328,12,"SECTORUL 3",,0,,519,809
41,"București",403,"403-SECTORUL 3",179169,477,2,1828,1288,1073,215,1279,9,"SECTORUL 3",,0,,492,787
41,"București",403,"403-SECTORUL 3",179169,478,2,1466,1036,816,220,1032,4,"SECTORUL 3",,0,,317,715
41,"București",403,"403-SECTORUL 3",179169,479,2,1602,1167,930,237,1162,5,"SECTORUL 3",,0,,432,730
41,"București",403,"403-SECTORUL 3",179169,480,2,1918,1172,1037,135,1163,9,"SECTORUL 3",,0,,441,722
41,"București",403,"403-SECTORUL 3",179169,481,2,1587,1248,1126,122,1244,4,"SECTORUL 3",,0,,446,798
41,"București",403,"403-SECTORUL 3",179169,482,2,1538,1129,1028,101,1124,5,"SECTORUL 3",,0,,402,722
41,"București",403,"403-SECTORUL 3",179169,483,2,1556,1261,1101,160,1256,5,"SECTORUL 3",,0,,499,757
41,"București",403,"403-SECTORUL 3",179169,484,2,1260,1024,905,119,1015,9,"SECTORUL 3",,0,,481,534
41,"București",403,"403-SECTORUL 3",179169,485,2,1599,1157,1037,120,1147,10,"SECTORUL 3",,0,,345,802
41,"București",403,"403-SECTORUL 3",179169,486,2,1016,814,681,133,812,2,"SECTORUL 3",,0,,342,470
41,"București",403,"403-SECTORUL 3",179169,487,2,1299,1128,871,257,1124,4,"SECTORUL 3",,0,,459,665
41,"București",403,"403-SECTORUL 3",179169,488,2,1630,1286,1156,130,1278,5,"SECTORUL 3",,0,,350,928
41,"București",403,"403-SECTORUL 3",179169,489,2,1407,1121,977,144,1118,3,"SECTORUL 3",,0,,336,782
41,"București",403,"403-SECTORUL 3",179169,490,2,1260,1007,841,166,991,2,"SECTORUL 3",,0,,409,582
41,"București",403,"403-SECTORUL 3",179169,491,2,1128,847,765,82,844,3,"SECTORUL 3",,0,,330,514
41,"București",403,"403-SECTORUL 3",179169,492,2,1168,870,798,72,868,2,"SECTORUL 3",,0,,319,549
41,"București",403,"403-SECTORUL 3",179169,493,2,1454,1058,962,96,1045,13,"SECTORUL 3",,0,,403,642
41,"București",403,"403-SECTORUL 3",179169,494,2,1061,1015,741,274,1011,4,"SECTORUL 3",,0,,395,616
41,"București",403,"403-SECTORUL 3",179169,495,2,1215,772,689,83,769,3,"SECTORUL 3",,0,,291,478
41,"București",403,"403-SECTORUL 3",179169,496,2,1332,1031,874,157,1023,8,"SECTORUL 3",,0,,374,649
41,"București",403,"403-SECTORUL 3",179169,497,2,1477,1016,847,169,1013,3,"SECTORUL 3",,0,,397,616
41,"București",403,"403-SECTORUL 3",179169,498,2,938,941,649,292,935,6,"SECTORUL 3",,0,,384,551
41,"București",403,"403-SECTORUL 3",179169,499,2,939,1343,578,765,1333,10,"SECTORUL 3",,0,,439,894
41,"București",403,"403-SECTORUL 3",179169,500,2,1445,1112,970,142,1102,10,"SECTORUL 3",,0,,409,693
41,"București",403,"403-SECTORUL 3",179169,501,2,1290,935,789,146,931,4,"SECTORUL 3",,0,,391,540
41,"București",403,"403-SECTORUL 3",179169,502,2,1022,752,701,51,749,3,"SECTORUL 3",,0,,297,452
41,"București",403,"403-SECTORUL 3",179169,503,2,1554,1119,1008,111,1114,5,"SECTORUL 3",,0,,375,739
41,"București",403,"403-SECTORUL 3",179169,504,2,1637,1183,1062,121,1177,6,"SECTORUL 3",,0,,499,678
41,"București",403,"403-SECTORUL 3",179169,505,2,1476,1170,698,472,1162,8,"SECTORUL 3",,0,,464,698
41,"București",403,"403-SECTORUL 3",179169,506,2,1409,1090,978,112,1087,3,"SECTORUL 3",,0,,352,735
41,"București",403,"403-SECTORUL 3",179169,507,2,1473,1053,972,81,1045,8,"SECTORUL 3",,0,,362,683
41,"București",403,"403-SECTORUL 3",179169,508,2,1520,1132,1035,97,1118,14,"SECTORUL 3",,0,,405,713
41,"București",403,"403-SECTORUL 3",179169,509,2,1364,1057,922,135,1052,5,"SECTORUL 3",,0,,416,636
41,"București",403,"403-SECTORUL 3",179169,510,2,1321,1041,888,153,1033,8,"SECTORUL 3",,0,,379,654
41,"București",403,"403-SECTORUL 3",179169,511,2,1071,920,728,192,916,4,"SECTORUL 3",,0,,290,626
41,"București",403,"403-SECTORUL 3",179169,512,2,800,764,461,303,761,3,"SECTORUL 3",,0,,243,518
41,"București",403,"403-SECTORUL 3",179169,513,2,1287,1025,827,198,1012,13,"SECTORUL 3",,0,,368,644
41,"București",403,"403-SECTORUL 3",179169,514,2,1571,1135,1002,133,1123,12,"SECTORUL 3",,0,,416,707
41,"București",403,"403-SECTORUL 3",179169,515,2,1244,860,792,68,856,3,"SECTORUL 3",,0,,327,529
41,"București",403,"403-SECTORUL 3",179169,516,2,1448,1489,1077,412,1482,7,"SECTORUL 3",,0,,578,904
41,"București",403,"403-SECTORUL 3",179169,517,2,1697,1203,1130,73,1200,3,"SECTORUL 3",,0,,434,766
41,"București",403,"403-SECTORUL 3",179169,518,2,1307,898,809,89,893,5,"SECTORUL 3",,0,,325,568
41,"București",403,"403-SECTORUL 3",179169,519,2,1446,1024,950,74,1021,3,"SECTORUL 3",,0,,408,613
41,"București",403,"403-SECTORUL 3",179169,520,2,1437,916,810,106,910,6,"SECTORUL 3",,0,,364,546
41,"București",403,"403-SECTORUL 3",179169,521,2,1571,1321,1106,215,1308,13,"SECTORUL 3",,0,,485,823
41,"București",403,"403-SECTORUL 3",179169,522,2,939,933,627,306,927,6,"SECTORUL 3",,0,,352,575
41,"București",403,"403-SECTORUL 3",179169,523,2,1582,1097,1023,74,1092,5,"SECTORUL 3",,0,,381,711
41,"București",403,"403-SECTORUL 3",179169,524,2,1386,1031,958,73,1025,6,"SECTORUL 3",,0,,390,635
41,"București",403,"403-SECTORUL 3",179169,525,2,1472,1140,949,191,1137,3,"SECTORUL 3",,0,,419,718
41,"București",403,"403-SECTORUL 3",179169,526,2,1851,1199,923,276,1197,2,"SECTORUL 3",,0,,457,740
41,"București",403,"403-SECTORUL 3",179169,527,2,1353,955,861,94,952,3,"SECTORUL 3",,0,,395,557
41,"București",403,"403-SECTORUL 3",179169,528,2,858,974,575,399,971,3,"SECTORUL 3",,0,,337,634
41,"București",403,"403-SECTORUL 3",179169,529,2,967,859,618,241,856,3,"SECTORUL 3",,0,,264,592
41,"București",403,"403-SECTORUL 3",179169,530,2,1197,1069,738,331,1067,2,"SECTORUL 3",,0,,406,661
41,"București",403,"403-SECTORUL 3",179169,531,2,1420,1082,879,203,1081,1,"SECTORUL 3",,0,,442,639
41,"București",403,"403-SECTORUL 3",179169,532,2,1839,1251,1171,80,1241,10,"SECTORUL 3",,0,,450,791
41,"București",403,"403-SECTORUL 3",179169,533,2,1829,1207,1116,91,1198,9,"SECTORUL 3",,0,,474,724
41,"București",403,"403-SECTORUL 3",179169,534,2,2063,1219,837,382,1216,3,"SECTORUL 3",,0,,454,762
41,"București",403,"403-SECTORUL 3",179169,535,2,1451,1101,949,152,1101,0,"SECTORUL 3",,0,,409,692
41,"București",403,"403-SECTORUL 3",179169,536,2,1715,919,791,128,910,9,"SECTORUL 3",,0,,430,480
41,"București",403,"403-SECTORUL 3",179169,537,2,1212,921,796,125,918,3,"SECTORUL 3",,0,,381,537
41,"București",403,"403-SECTORUL 3",179169,538,2,1601,1166,1029,137,1163,3,"SECTORUL 3",,0,,442,721
41,"București",403,"403-SECTORUL 3",179169,539,2,1387,952,885,67,942,10,"SECTORUL 3",,0,,395,547
41,"București",403,"403-SECTORUL 3",179169,540,2,1498,1079,969,110,1069,10,"SECTORUL 3",,0,,380,689
41,"București",403,"403-SECTORUL 3",179169,541,2,1645,1110,958,152,1099,11,"SECTORUL 3",,0,,477,622
41,"București",403,"403-SECTORUL 3",179169,542,2,1592,1182,981,201,1175,7,"SECTORUL 3",,0,,502,673
41,"București",403,"403-SECTORUL 3",179169,543,2,1590,1262,1098,164,1260,2,"SECTORUL 3",,0,,483,777
41,"București",403,"403-SECTORUL 3",179169,544,2,1223,951,738,213,945,5,"SECTORUL 3",,0,,269,676
41,"București",403,"403-SECTORUL 3",179169,545,2,1093,859,744,115,859,0,"SECTORUL 3",,0,,348,511
41,"București",403,"403-SECTORUL 3",179169,546,2,1972,1149,1008,141,1137,10,"SECTORUL 3",,0,,434,703
41,"București",403,"403-SECTORUL 3",179169,547,2,1498,1090,980,110,1084,6,"SECTORUL 3",,0,,452,632
41,"București",403,"403-SECTORUL 3",179169,548,2,1975,996,848,148,991,5,"SECTORUL 3",,0,,359,632
41,"București",403,"403-SECTORUL 3",179169,549,2,557,579,221,358,575,4,"SECTORUL 3",,0,,222,353
41,"București",403,"403-SECTORUL 3",179169,550,2,1408,1033,914,119,1024,9,"SECTORUL 3",,0,,429,595
41,"București",403,"403-SECTORUL 3",179169,551,2,1393,1058,975,83,1045,13,"SECTORUL 3",,0,,400,645
41,"București",403,"403-SECTORUL 3",179169,552,2,1477,1120,1030,90,1116,4,"SECTORUL 3",,0,,463,653
41,"București",403,"403-SECTORUL 3",179169,553,2,1195,923,863,60,916,7,"SECTORUL 3",,0,,388,528
41,"București",403,"403-SECTORUL 3",179169,554,2,1193,854,737,117,845,9,"SECTORUL 3",,0,,288,557
41,"București",403,"403-SECTORUL 3",179169,555,2,1739,1268,1188,80,1261,7,"SECTORUL 3",,0,,449,812
41,"București",403,"403-SECTORUL 3",179169,556,2,2020,1526,1402,124,1519,7,"SECTORUL 3",,0,,541,978
41,"București",403,"403-SECTORUL 3",179169,557,2,1443,1011,934,77,1006,5,"SECTORUL 3",,0,,404,602
41,"București",403,"403-SECTORUL 3",179169,558,2,1353,1100,961,139,1096,4,"SECTORUL 3",,0,,353,743
41,"București",403,"403-SECTORUL 3",179169,559,2,1253,1010,913,97,1010,0,"SECTORUL 3",,0,,350,660
41,"București",403,"403-SECTORUL 3",179169,560,2,1502,1120,1053,67,1114,6,"SECTORUL 3",,0,,468,646
41,"București",403,"403-SECTORUL 3",179169,561,2,1910,1439,1292,147,1427,8,"SECTORUL 3",,0,,515,912
41,"București",403,"403-SECTORUL 3",179169,562,2,1301,995,893,102,994,1,"SECTORUL 3",,0,,366,628
41,"București",403,"403-SECTORUL 3",179169,563,2,1405,1023,907,116,1017,6,"SECTORUL 3",,0,,390,627
41,"București",403,"403-SECTORUL 3",179169,564,2,1734,1150,1060,90,1144,6,"SECTORUL 3",,0,,439,705
41,"București",403,"403-SECTORUL 3",179169,565,2,1997,1328,1199,129,1317,11,"SECTORUL 3",,0,,511,806
41,"București",403,"403-SECTORUL 3",179169,566,2,1557,1189,1041,148,1182,7,"SECTORUL 3",,0,,449,733
41,"București",403,"403-SECTORUL 3",179169,567,2,1090,887,744,143,879,8,"SECTORUL 3",,0,,310,569
41,"București",403,"403-SECTORUL 3",179169,568,2,1300,999,890,109,991,8,"SECTORUL 3",,0,,451,540
41,"București",403,"403-SECTORUL 3",179169,569,2,1396,833,679,154,828,5,"SECTORUL 3",,0,,328,500
41,"București",403,"403-SECTORUL 3",179169,570,2,1260,1091,771,320,1082,9,"SECTORUL 3",,0,,500,582
41,"București",403,"403-SECTORUL 3",179169,571,2,1427,1005,955,50,999,6,"SECTORUL 3",,0,,533,466
41,"București",403,"403-SECTORUL 3",179169,572,2,1421,1013,951,62,1008,5,"SECTORUL 3",,0,,551,457
41,"București",403,"403-SECTORUL 3",179169,573,2,1380,1040,880,160,1035,5,"SECTORUL 3",,0,,492,543
41,"București",403,"403-SECTORUL 3",179169,574,2,1241,1018,787,231,1007,11,"SECTORUL 3",,0,,486,521
41,"București",403,"403-SECTORUL 3",179169,575,2,1200,871,700,171,866,5,"SECTORUL 3",,0,,439,427
41,"București",403,"403-SECTORUL 3",179169,576,2,1396,920,811,109,910,10,"SECTORUL 3",,0,,509,401
41,"București",403,"403-SECTORUL 3",179169,577,2,1316,977,785,192,968,9,"SECTORUL 3",,0,,447,521
41,"București",403,"403-SECTORUL 3",179169,578,2,1381,1099,859,240,1071,28,"SECTORUL 3",,0,,450,621
41,"București",403,"403-SECTORUL 3",179169,579,2,1010,711,612,99,700,11,"SECTORUL 3",,0,,355,345
41,"București",403,"403-SECTORUL 3",179169,580,2,1272,884,792,92,871,13,"SECTORUL 3",,0,,458,413
41,"București",403,"403-SECTORUL 3",179169,581,2,1942,1517,1244,273,1511,6,"SECTORUL 3",,0,,550,961
41,"București",403,"403-SECTORUL 3",179169,582,2,1669,1289,1058,231,1278,11,"SECTORUL 3",,0,,628,650
41,"București",403,"403-SECTORUL 3",179169,583,2,1639,1223,1022,201,1217,6,"SECTORUL 3",,0,,474,743
41,"București",403,"403-SECTORUL 3",179169,584,2,1595,1197,1028,169,1190,7,"SECTORUL 3",,0,,520,670
41,"București",403,"403-SECTORUL 3",179169,585,2,1220,936,850,86,933,3,"SECTORUL 3",,0,,392,541
41,"București",403,"403-SECTORUL 3",179169,586,2,1602,1253,1110,143,1249,4,"SECTORUL 3",,0,,464,785
41,"București",403,"403-SECTORUL 3",179169,587,2,0,317,0,317,313,4,"SECTORUL 3",,0,,126,187
41,"București",403,"403-SECTORUL 3",179169,588,2,0,278,0,278,277,1,"SECTORUL 3",,0,,116,161
41,"București",403,"403-SECTORUL 3",179169,589,2,0,70,0,70,68,2,"SECTORUL 3",,0,,36,32
41,"București",403,"403-SECTORUL 3",179169,590,2,0,270,0,270,266,4,"SECTORUL 3",,0,,98,168
41,"București",403,"403-SECTORUL 3",179169,591,2,0,124,0,124,123,1,"SECTORUL 3",,0,,57,66
41,"București",403,"403-SECTORUL 3",179169,592,2,0,105,0,105,104,1,"SECTORUL 3",,0,,43,61
41,"București",403,"403-SECTORUL 3",179169,593,2,72,76,61,15,68,8,"SECTORUL 3",,0,,45,23
41,"București",403,"403-SECTORUL 4",179178,594,2,1508,1127,1015,112,1125,2,"SECTORUL 4",,0,,504,621
41,"București",403,"403-SECTORUL 4",179178,595,2,1168,881,656,225,879,2,"SECTORUL 4",,0,,286,593
41,"București",403,"403-SECTORUL 4",179178,596,2,1669,1079,967,112,1072,7,"SECTORUL 4",,0,,399,673
41,"București",403,"403-SECTORUL 4",179178,597,2,1293,926,811,115,918,8,"SECTORUL 4",,0,,282,636
41,"București",403,"403-SECTORUL 4",179178,598,2,1424,992,877,115,989,3,"SECTORUL 4",,0,,328,661
41,"București",403,"403-SECTORUL 4",179178,599,2,1623,1271,1111,160,1268,3,"SECTORUL 4",,0,,453,815
41,"București",403,"403-SECTORUL 4",179178,600,2,1606,1219,1072,147,1211,8,"SECTORUL 4",,0,,431,780
41,"București",403,"403-SECTORUL 4",179178,601,2,1231,925,835,90,919,6,"SECTORUL 4",,0,,416,503
41,"București",403,"403-SECTORUL 4",179178,602,2,1392,996,898,98,990,6,"SECTORUL 4",,0,,357,633
41,"București",403,"403-SECTORUL 4",179178,603,2,1403,1041,966,75,1036,5,"SECTORUL 4",,0,,449,587
41,"București",403,"403-SECTORUL 4",179178,604,2,1196,954,869,85,954,0,"SECTORUL 4",,0,,414,540
41,"București",403,"403-SECTORUL 4",179178,605,2,1605,953,813,140,945,8,"SECTORUL 4",,0,,334,611
41,"București",403,"403-SECTORUL 4",179178,606,2,1340,983,793,190,977,6,"SECTORUL 4",,0,,311,666
41,"București",403,"403-SECTORUL 4",179178,607,2,1224,891,849,42,889,2,"SECTORUL 4",,0,,425,464
41,"București",403,"403-SECTORUL 4",179178,608,2,1523,1220,1078,142,1216,4,"SECTORUL 4",,0,,420,796
41,"București",403,"403-SECTORUL 4",179178,609,2,996,711,590,121,709,2,"SECTORUL 4",,0,,266,443
41,"București",403,"403-SECTORUL 4",179178,610,2,1594,1165,960,205,1162,3,"SECTORUL 4",,0,,360,802
41,"București",403,"403-SECTORUL 4",179178,611,2,1148,826,654,172,824,2,"SECTORUL 4",,0,,279,545
41,"București",403,"403-SECTORUL 4",179178,612,2,1583,1262,1189,73,1257,5,"SECTORUL 4",,0,,501,756
41,"București",403,"403-SECTORUL 4",179178,613,2,1464,1189,1111,78,1186,2,"SECTORUL 4",,0,,531,655
41,"București",403,"403-SECTORUL 4",179178,614,2,920,776,641,135,775,1,"SECTORUL 4",,0,,348,427
41,"București",403,"403-SECTORUL 4",179178,615,2,1798,1520,1188,332,1517,3,"SECTORUL 4",,0,,562,955
41,"București",403,"403-SECTORUL 4",179178,616,2,1530,1275,1135,140,1270,5,"SECTORUL 4",,0,,380,890
41,"București",403,"403-SECTORUL 4",179178,617,2,1233,1027,909,118,1023,4,"SECTORUL 4",,0,,322,701
41,"București",403,"403-SECTORUL 4",179178,618,2,1334,1037,943,94,1035,2,"SECTORUL 4",,0,,347,688
41,"București",403,"403-SECTORUL 4",179178,619,2,1395,1107,908,199,1102,5,"SECTORUL 4",,0,,394,708
41,"București",403,"403-SECTORUL 4",179178,620,2,1024,574,506,68,570,4,"SECTORUL 4",,0,,244,326
41,"București",403,"403-SECTORUL 4",179178,621,2,1158,889,795,94,887,2,"SECTORUL 4",,0,,297,590
41,"București",403,"403-SECTORUL 4",179178,622,2,1403,1136,979,157,1135,1,"SECTORUL 4",,0,,451,684
41,"București",403,"403-SECTORUL 4",179178,623,2,1040,781,719,62,778,3,"SECTORUL 4",,0,,278,500
41,"București",403,"403-SECTORUL 4",179178,624,2,1445,1140,1020,120,1139,1,"SECTORUL 4",,0,,426,713
41,"București",403,"403-SECTORUL 4",179178,625,2,1324,1014,921,93,1010,4,"SECTORUL 4",,0,,344,666
41,"București",403,"403-SECTORUL 4",179178,626,2,1382,953,857,96,949,4,"SECTORUL 4",,0,,366,583
41,"București",403,"403-SECTORUL 4",179178,627,2,1512,1323,1110,213,1318,5,"SECTORUL 4",,0,,464,854
41,"București",403,"403-SECTORUL 4",179178,628,2,1328,998,923,75,995,3,"SECTORUL 4",,0,,391,604
41,"București",403,"403-SECTORUL 4",179178,629,2,1600,1189,997,192,1179,10,"SECTORUL 4",,0,,519,660
41,"București",403,"403-SECTORUL 4",179178,630,2,1442,1051,950,101,1046,5,"SECTORUL 4",,0,,488,558
41,"București",403,"403-SECTORUL 4",179178,631,2,1083,713,638,75,709,4,"SECTORUL 4",,0,,326,383
41,"București",403,"403-SECTORUL 4",179178,632,2,1355,917,830,87,910,7,"SECTORUL 4",,0,,328,582
41,"București",403,"403-SECTORUL 4",179178,633,2,1925,1382,1268,114,1379,3,"SECTORUL 4",,0,,548,831
41,"București",403,"403-SECTORUL 4",179178,634,2,1255,920,815,105,920,0,"SECTORUL 4",,0,,389,531
41,"București",403,"403-SECTORUL 4",179178,635,2,1229,892,802,90,891,1,"SECTORUL 4",,0,,277,614
41,"București",403,"403-SECTORUL 4",179178,636,2,1930,1476,1170,306,1474,2,"SECTORUL 4",,0,,482,992
41,"București",403,"403-SECTORUL 4",179178,637,2,1798,1303,1126,177,1303,0,"SECTORUL 4",,0,,558,745
41,"București",403,"403-SECTORUL 4",179178,638,2,2054,1339,1220,119,1334,5,"SECTORUL 4",,0,,454,880
41,"București",403,"403-SECTORUL 4",179178,639,2,1572,1091,970,121,1085,6,"SECTORUL 4",,0,,380,705
41,"București",403,"403-SECTORUL 4",179178,640,2,1546,1085,985,100,1080,5,"SECTORUL 4",,0,,404,676
41,"București",403,"403-SECTORUL 4",179178,641,2,1387,1124,976,148,1118,6,"SECTORUL 4",,0,,456,662
41,"București",403,"403-SECTORUL 4",179178,642,2,1417,1007,885,122,1005,2,"SECTORUL 4",,0,,436,569
41,"București",403,"403-SECTORUL 4",179178,643,2,1887,1332,1131,201,1329,3,"SECTORUL 4",,0,,450,879
41,"București",403,"403-SECTORUL 4",179178,644,2,1421,1041,963,78,1038,3,"SECTORUL 4",,0,,368,670
41,"București",403,"403-SECTORUL 4",179178,645,2,2067,1166,1037,129,1163,3,"SECTORUL 4",,0,,454,709
41,"București",403,"403-SECTORUL 4",179178,646,2,1308,881,650,231,872,9,"SECTORUL 4",,0,,325,547
41,"București",403,"403-SECTORUL 4",179178,647,2,1246,925,838,87,923,2,"SECTORUL 4",,0,,436,487
41,"București",403,"403-SECTORUL 4",179178,648,2,1854,1326,1200,126,1326,0,"SECTORUL 4",,0,,454,872
41,"București",403,"403-SECTORUL 4",179178,649,2,1405,911,831,80,905,6,"SECTORUL 4",,0,,312,593
41,"București",403,"403-SECTORUL 4",179178,650,2,731,568,470,98,567,1,"SECTORUL 4",,0,,237,330
41,"București",403,"403-SECTORUL 4",179178,651,2,1489,1143,948,195,1138,5,"SECTORUL 4",,0,,490,648
41,"București",403,"403-SECTORUL 4",179178,652,2,2398,1724,1389,335,1717,7,"SECTORUL 4",,0,,796,921
41,"București",403,"403-SECTORUL 4",179178,653,2,1029,763,684,79,761,2,"SECTORUL 4",,0,,272,489
41,"București",403,"403-SECTORUL 4",179178,654,2,1178,904,694,210,903,1,"SECTORUL 4",,0,,350,553
41,"București",403,"403-SECTORUL 4",179178,655,2,814,574,494,80,573,1,"SECTORUL 4",,0,,205,368
41,"București",403,"403-SECTORUL 4",179178,656,2,1632,1270,1044,226,1260,9,"SECTORUL 4",,0,,518,742
41,"București",403,"403-SECTORUL 4",179178,657,2,1737,1284,1173,111,1277,5,"SECTORUL 4",,0,,514,763
41,"București",403,"403-SECTORUL 4",179178,658,2,1506,860,760,100,847,13,"SECTORUL 4",,0,,315,532
41,"București",403,"403-SECTORUL 4",179178,659,2,1510,931,841,90,924,7,"SECTORUL 4",,0,,367,557
41,"București",403,"403-SECTORUL 4",179178,660,2,1618,1196,1077,119,1189,7,"SECTORUL 4",,0,,471,718
41,"București",403,"403-SECTORUL 4",179178,661,2,1184,913,787,126,906,7,"SECTORUL 4",,0,,338,568
41,"București",403,"403-SECTORUL 4",179178,662,2,1633,1245,1098,147,1240,5,"SECTORUL 4",,0,,465,775
41,"București",403,"403-SECTORUL 4",179178,663,2,1423,1044,935,109,1039,4,"SECTORUL 4",,0,,427,612
41,"București",403,"403-SECTORUL 4",179178,664,2,1167,813,739,74,809,4,"SECTORUL 4",,0,,320,489
41,"București",403,"403-SECTORUL 4",179178,665,2,1653,1089,982,107,1073,16,"SECTORUL 4",,0,,399,674
41,"București",403,"403-SECTORUL 4",179178,666,2,1262,1047,783,264,1044,3,"SECTORUL 4",,0,,421,623
41,"București",403,"403-SECTORUL 4",179178,667,2,1466,974,899,75,968,6,"SECTORUL 4",,0,,341,627
41,"București",403,"403-SECTORUL 4",179178,668,2,746,537,491,46,536,1,"SECTORUL 4",,0,,276,260
41,"București",403,"403-SECTORUL 4",179178,669,2,1844,1306,1182,124,1303,3,"SECTORUL 4",,0,,531,772
41,"București",403,"403-SECTORUL 4",179178,670,2,1485,1004,885,119,992,12,"SECTORUL 4",,0,,409,583
41,"București",403,"403-SECTORUL 4",179178,671,2,1227,1011,783,228,1007,4,"SECTORUL 4",,0,,375,632
41,"București",403,"403-SECTORUL 4",179178,672,2,1577,1099,988,111,1096,3,"SECTORUL 4",,0,,411,685
41,"București",403,"403-SECTORUL 4",179178,673,2,1702,1011,889,122,1001,10,"SECTORUL 4",,0,,439,562
41,"București",403,"403-SECTORUL 4",179178,674,2,1254,916,793,123,911,5,"SECTORUL 4",,0,,379,532
41,"București",403,"403-SECTORUL 4",179178,675,2,1632,1189,1106,83,1180,6,"SECTORUL 4",,0,,417,763
41,"București",403,"403-SECTORUL 4",179178,676,2,1769,1291,1175,116,1286,5,"SECTORUL 4",,0,,493,793
41,"București",403,"403-SECTORUL 4",179178,677,2,1747,1276,1147,129,1263,13,"SECTORUL 4",,0,,550,713
41,"București",403,"403-SECTORUL 4",179178,678,2,1595,1279,1140,139,1276,3,"SECTORUL 4",,0,,502,774
41,"București",403,"403-SECTORUL 4",179178,679,2,1518,1099,913,186,1094,5,"SECTORUL 4",,0,,417,677
41,"București",403,"403-SECTORUL 4",179178,680,2,1619,1240,1061,179,1231,9,"SECTORUL 4",,0,,566,665
41,"București",403,"403-SECTORUL 4",179178,681,2,1358,923,819,104,923,0,"SECTORUL 4",,0,,344,579
41,"București",403,"403-SECTORUL 4",179178,682,2,1385,1035,943,92,1032,3,"SECTORUL 4",,0,,433,599
41,"București",403,"403-SECTORUL 4",179178,683,2,1929,1361,1202,159,1354,7,"SECTORUL 4",,0,,537,817
41,"București",403,"403-SECTORUL 4",179178,684,2,1570,1152,1069,83,1151,1,"SECTORUL 4",,0,,524,627
41,"București",403,"403-SECTORUL 4",179178,685,2,1595,1265,1063,202,1259,6,"SECTORUL 4",,0,,468,791
41,"București",403,"403-SECTORUL 4",179178,686,2,1406,938,863,75,935,3,"SECTORUL 4",,0,,313,622
41,"București",403,"403-SECTORUL 4",179178,687,2,2200,1623,1359,264,1617,6,"SECTORUL 4",,0,,618,999
41,"București",403,"403-SECTORUL 4",179178,688,2,1676,1060,700,360,1041,5,"SECTORUL 4",,0,,397,644
41,"București",403,"403-SECTORUL 4",179178,689,2,1329,1151,704,447,1148,3,"SECTORUL 4",,0,,382,766
41,"București",403,"403-SECTORUL 4",179178,690,2,1043,1095,632,463,1091,4,"SECTORUL 4",,0,,506,585
41,"București",403,"403-SECTORUL 4",179178,691,2,1109,744,424,320,739,5,"SECTORUL 4",,0,,312,427
41,"București",403,"403-SECTORUL 4",179178,692,2,1734,938,696,242,936,2,"SECTORUL 4",,0,,362,574
41,"București",403,"403-SECTORUL 4",179178,693,2,1430,891,768,123,885,6,"SECTORUL 4",,0,,409,476
41,"București",403,"403-SECTORUL 4",179178,694,2,1324,1171,848,323,1166,5,"SECTORUL 4",,0,,431,735
41,"București",403,"403-SECTORUL 4",179178,695,2,1410,976,720,256,969,7,"SECTORUL 4",,0,,383,586
41,"București",403,"403-SECTORUL 4",179178,696,2,1390,1132,797,335,1127,5,"SECTORUL 4",,0,,456,671
41,"București",403,"403-SECTORUL 4",179178,697,2,1690,1085,920,165,1078,7,"SECTORUL 4",,0,,464,614
41,"București",403,"403-SECTORUL 4",179178,698,2,1584,1035,911,124,1031,4,"SECTORUL 4",,0,,419,612
41,"București",403,"403-SECTORUL 4",179178,699,2,1385,1210,923,287,1209,1,"SECTORUL 4",,0,,485,724
41,"București",403,"403-SECTORUL 4",179178,700,2,1198,948,856,92,942,6,"SECTORUL 4",,0,,395,547
41,"București",403,"403-SECTORUL 4",179178,701,2,1518,1184,1069,115,1180,4,"SECTORUL 4",,0,,466,714
41,"București",403,"403-SECTORUL 4",179178,702,2,1785,1117,921,196,1112,5,"SECTORUL 4",,0,,384,728
41,"București",403,"403-SECTORUL 4",179178,703,2,1555,1131,1063,68,1127,4,"SECTORUL 4",,0,,467,660
41,"București",403,"403-SECTORUL 4",179178,704,2,1818,1264,1125,139,1261,3,"SECTORUL 4",,0,,387,874
41,"București",403,"403-SECTORUL 4",179178,705,2,1655,1241,1094,147,1238,3,"SECTORUL 4",,0,,473,765
41,"București",403,"403-SECTORUL 4",179178,706,2,2042,1502,1362,140,1497,5,"SECTORUL 4",,0,,580,917
41,"București",403,"403-SECTORUL 4",179178,707,2,1545,826,729,97,820,5,"SECTORUL 4",,0,,338,482
41,"București",403,"403-SECTORUL 4",179178,708,2,1347,1079,929,150,1077,2,"SECTORUL 4",,0,,382,695
41,"București",403,"403-SECTORUL 4",179178,709,2,1404,1157,965,192,1152,5,"SECTORUL 4",,0,,482,670
41,"București",403,"403-SECTORUL 4",179178,710,2,1428,1145,753,392,1137,8,"SECTORUL 4",,0,,428,709
41,"București",403,"403-SECTORUL 4",179178,711,2,1712,1005,893,112,995,10,"SECTORUL 4",,0,,410,585
41,"București",403,"403-SECTORUL 4",179178,712,2,2552,1082,770,312,1077,5,"SECTORUL 4",,0,,456,621
41,"București",403,"403-SECTORUL 4",179178,713,2,1977,1140,995,145,1135,5,"SECTORUL 4",,0,,452,683
41,"București",403,"403-SECTORUL 4",179178,714,2,1582,1097,912,185,1093,4,"SECTORUL 4",,0,,439,654
41,"București",403,"403-SECTORUL 4",179178,715,2,1837,1034,914,120,1021,13,"SECTORUL 4",,0,,403,618
41,"București",403,"403-SECTORUL 4",179178,716,2,1651,1126,965,161,1115,11,"SECTORUL 4",,0,,456,659
41,"București",403,"403-SECTORUL 4",179178,717,2,1489,1037,961,76,1033,4,"SECTORUL 4",,0,,429,604
41,"București",403,"403-SECTORUL 4",179178,718,2,1350,958,818,140,953,5,"SECTORUL 4",,0,,365,588
41,"București",403,"403-SECTORUL 4",179178,719,2,1121,871,645,226,865,6,"SECTORUL 4",,0,,322,543
41,"București",403,"403-SECTORUL 4",179178,720,2,1591,1155,935,220,1150,5,"SECTORUL 4",,0,,530,620
41,"București",403,"403-SECTORUL 4",179178,721,2,1158,825,701,124,820,5,"SECTORUL 4",,0,,375,445
41,"București",403,"403-SECTORUL 4",179178,722,2,1044,743,627,116,738,4,"SECTORUL 4",,0,,317,421
41,"București",403,"403-SECTORUL 4",179178,723,2,1142,696,579,117,691,5,"SECTORUL 4",,0,,284,407
41,"București",403,"403-SECTORUL 4",179178,724,2,1172,918,796,122,917,1,"SECTORUL 4",,0,,363,554
41,"București",403,"403-SECTORUL 4",179178,725,2,1264,945,793,152,939,6,"SECTORUL 4",,0,,351,588
41,"București",403,"403-SECTORUL 4",179178,726,2,1760,1064,839,225,1057,7,"SECTORUL 4",,0,,416,641
41,"București",403,"403-SECTORUL 4",179178,727,2,1046,685,580,105,680,5,"SECTORUL 4",,0,,286,394
41,"București",403,"403-SECTORUL 4",179178,728,2,1091,847,566,281,841,6,"SECTORUL 4",,0,,357,484
41,"București",403,"403-SECTORUL 4",179178,729,2,1204,952,630,322,949,3,"SECTORUL 4",,0,,411,538
41,"București",403,"403-SECTORUL 4",179178,730,2,1663,1243,1116,127,1240,3,"SECTORUL 4",,0,,467,773
41,"București",403,"403-SECTORUL 4",179178,731,2,1561,1153,1026,127,1143,10,"SECTORUL 4",,0,,416,727
41,"București",403,"403-SECTORUL 4",179178,732,2,2646,1722,1570,152,1714,8,"SECTORUL 4",,0,,708,1006
41,"București",403,"403-SECTORUL 4",179178,733,2,1378,949,831,118,943,6,"SECTORUL 4",,0,,334,609
41,"București",403,"403-SECTORUL 4",179178,734,2,1609,1082,992,90,1076,6,"SECTORUL 4",,0,,417,659
41,"București",403,"403-SECTORUL 4",179178,735,2,1513,1042,950,92,1037,5,"SECTORUL 4",,0,,351,686
41,"București",403,"403-SECTORUL 4",179178,736,2,1443,1070,972,98,1067,3,"SECTORUL 4",,0,,414,653
41,"București",403,"403-SECTORUL 4",179178,737,2,1605,1066,996,70,1059,7,"SECTORUL 4",,0,,370,689
41,"București",403,"403-SECTORUL 4",179178,738,2,1455,1175,974,201,1173,2,"SECTORUL 4",,0,,419,754
41,"București",403,"403-SECTORUL 4",179178,739,2,2007,1312,1187,125,1310,2,"SECTORUL 4",,0,,442,868
41,"București",403,"403-SECTORUL 4",179178,740,2,1650,1109,947,162,1105,4,"SECTORUL 4",,0,,484,621
41,"București",403,"403-SECTORUL 4",179178,741,2,1099,779,679,100,773,6,"SECTORUL 4",,0,,293,480
41,"București",403,"403-SECTORUL 4",179178,742,2,1505,1129,921,208,1127,2,"SECTORUL 4",,0,,449,678
41,"București",403,"403-SECTORUL 4",179178,743,2,1184,1012,789,223,1009,3,"SECTORUL 4",,0,,372,637
41,"București",403,"403-SECTORUL 4",179178,744,2,1638,1284,840,444,1279,5,"SECTORUL 4",,0,,426,853
41,"București",403,"403-SECTORUL 4",179178,745,2,1390,1122,758,364,1117,5,"SECTORUL 4",,0,,362,755
41,"București",403,"403-SECTORUL 4",179178,746,2,1557,1108,1003,105,1101,7,"SECTORUL 4",,0,,426,675
41,"București",403,"403-SECTORUL 4",179178,747,2,964,716,578,138,711,5,"SECTORUL 4",,0,,291,420
41,"București",403,"403-SECTORUL 4",179178,748,2,1451,1111,1016,95,1106,5,"SECTORUL 4",,0,,440,666
41,"București",403,"403-SECTORUL 4",179178,749,2,1455,1120,986,134,1113,7,"SECTORUL 4",,0,,417,696
41,"București",403,"403-SECTORUL 4",179178,750,2,1502,1149,1028,121,1144,5,"SECTORUL 4",,0,,420,724
41,"București",403,"403-SECTORUL 4",179178,751,2,1711,1206,1114,92,1201,5,"SECTORUL 4",,0,,460,741
41,"București",403,"403-SECTORUL 4",179178,752,2,1576,1169,1034,135,1163,6,"SECTORUL 4",,0,,411,752
41,"București",403,"403-SECTORUL 4",179178,753,2,1561,1081,1016,65,1077,4,"SECTORUL 4",,0,,460,617
41,"București",403,"403-SECTORUL 4",179178,754,2,1372,966,897,69,961,5,"SECTORUL 4",,0,,396,565
41,"București",403,"403-SECTORUL 4",179178,755,2,1183,878,825,53,874,4,"SECTORUL 4",,0,,380,494
41,"București",403,"403-SECTORUL 4",179178,756,2,1042,947,713,234,939,8,"SECTORUL 4",,0,,413,526
41,"București",403,"403-SECTORUL 4",179178,757,2,1087,837,716,121,834,3,"SECTORUL 4",,0,,331,503
41,"București",403,"403-SECTORUL 4",179178,758,2,1617,1066,929,137,1055,8,"SECTORUL 4",,0,,437,618
41,"București",403,"403-SECTORUL 4",179178,759,2,1663,1201,1038,163,1196,5,"SECTORUL 4",,0,,479,717
41,"București",403,"403-SECTORUL 4",179178,760,2,1590,989,851,138,980,9,"SECTORUL 4",,0,,421,559
41,"București",403,"403-SECTORUL 4",179178,761,2,1021,809,700,109,808,1,"SECTORUL 4",,0,,300,508
41,"București",403,"403-SECTORUL 4",179178,762,2,1247,952,869,83,940,12,"SECTORUL 4",,0,,367,573
41,"București",403,"403-SECTORUL 4",179178,763,2,1455,1089,953,136,1086,3,"SECTORUL 4",,0,,453,633
41,"București",403,"403-SECTORUL 4",179178,764,2,1281,976,872,104,970,6,"SECTORUL 4",,0,,315,655
41,"București",403,"403-SECTORUL 4",179178,765,2,1911,1414,1318,96,1407,7,"SECTORUL 4",,0,,599,808
41,"București",403,"403-SECTORUL 4",179178,766,2,1744,1239,1163,76,1234,5,"SECTORUL 4",,0,,483,751
41,"București",403,"403-SECTORUL 4",179178,767,2,1424,1009,931,78,1002,7,"SECTORUL 4",,0,,392,610
41,"București",403,"403-SECTORUL 4",179178,768,2,1607,1130,1034,96,1125,5,"SECTORUL 4",,0,,420,705
41,"București",403,"403-SECTORUL 4",179178,769,2,0,462,0,462,458,4,"SECTORUL 4",,0,,203,255
41,"București",403,"403-SECTORUL 4",179178,770,2,0,970,0,970,960,10,"SECTORUL 4",,0,,405,555
41,"București",403,"403-SECTORUL 4",179178,771,2,0,429,0,429,418,11,"SECTORUL 4",,0,,134,284
41,"București",403,"403-SECTORUL 4",179178,772,2,0,162,0,162,162,0,"SECTORUL 4",,0,,64,98
41,"București",403,"403-SECTORUL 4",179178,773,2,0,195,0,195,138,57,"SECTORUL 4",,0,,54,84
41,"București",403,"403-SECTORUL 5",179187,774,2,1016,607,526,81,601,6,"SECTORUL 5",,0,,283,318
41,"București",403,"403-SECTORUL 5",179187,775,2,1166,793,709,84,791,2,"SECTORUL 5",,0,,335,456
41,"București",403,"403-SECTORUL 5",179187,776,2,1063,708,642,66,697,11,"SECTORUL 5",,0,,327,370
41,"București",403,"403-SECTORUL 5",179187,777,2,917,468,374,94,465,3,"SECTORUL 5",,0,,154,311
41,"București",403,"403-SECTORUL 5",179187,778,2,1127,795,635,160,789,6,"SECTORUL 5",,0,,336,453
41,"București",403,"403-SECTORUL 5",179187,779,2,1511,994,894,100,981,13,"SECTORUL 5",,0,,420,561
41,"București",403,"403-SECTORUL 5",179187,780,2,1165,666,555,111,657,8,"SECTORUL 5",,0,,286,371
41,"București",403,"403-SECTORUL 5",179187,781,2,1336,834,706,128,822,12,"SECTORUL 5",,0,,376,446
41,"București",403,"403-SECTORUL 5",179187,782,2,1378,693,573,120,684,9,"SECTORUL 5",,0,,263,421
41,"București",403,"403-SECTORUL 5",179187,783,2,1383,670,530,140,666,4,"SECTORUL 5",,0,,269,397
41,"București",403,"403-SECTORUL 5",179187,784,2,824,505,405,100,501,4,"SECTORUL 5",,0,,195,306
41,"București",403,"403-SECTORUL 5",179187,785,2,1113,901,697,204,897,4,"SECTORUL 5",,0,,369,528
41,"București",403,"403-SECTORUL 5",179187,786,2,1391,1155,951,204,1144,11,"SECTORUL 5",,0,,590,554
41,"București",403,"403-SECTORUL 5",179187,787,2,1056,850,709,141,849,1,"SECTORUL 5",,0,,308,541
41,"București",403,"403-SECTORUL 5",179187,788,2,1145,963,766,197,954,9,"SECTORUL 5",,0,,368,586
41,"București",403,"403-SECTORUL 5",179187,789,2,1051,750,505,245,743,7,"SECTORUL 5",,0,,270,473
41,"București",403,"403-SECTORUL 5",179187,790,2,916,632,478,154,618,14,"SECTORUL 5",,0,,222,396
41,"București",403,"403-SECTORUL 5",179187,791,2,1005,587,419,168,585,2,"SECTORUL 5",,0,,210,375
41,"București",403,"403-SECTORUL 5",179187,792,2,1071,684,580,104,678,6,"SECTORUL 5",,0,,258,420
41,"București",403,"403-SECTORUL 5",179187,793,2,1250,758,668,90,747,11,"SECTORUL 5",,0,,277,470
41,"București",403,"403-SECTORUL 5",179187,794,2,1132,752,607,145,742,10,"SECTORUL 5",,0,,265,477
41,"București",403,"403-SECTORUL 5",179187,795,2,961,670,527,143,664,4,"SECTORUL 5",,0,,273,391
41,"București",403,"403-SECTORUL 5",179187,796,2,998,653,583,70,649,4,"SECTORUL 5",,0,,218,431
41,"București",403,"403-SECTORUL 5",179187,797,2,959,665,559,106,655,10,"SECTORUL 5",,0,,313,342
41,"București",403,"403-SECTORUL 5",179187,798,2,1121,663,599,64,653,10,"SECTORUL 5",,0,,279,374
41,"București",403,"403-SECTORUL 5",179187,799,2,998,503,428,75,500,3,"SECTORUL 5",,0,,219,281
41,"București",403,"403-SECTORUL 5",179187,800,2,923,582,498,84,576,6,"SECTORUL 5",,0,,244,332
41,"București",403,"403-SECTORUL 5",179187,801,2,997,698,594,104,696,2,"SECTORUL 5",,0,,330,366
41,"București",403,"403-SECTORUL 5",179187,802,2,973,659,563,96,652,7,"SECTORUL 5",,0,,253,399
41,"București",403,"403-SECTORUL 5",179187,803,2,996,746,656,90,743,3,"SECTORUL 5",,0,,280,463
41,"București",403,"403-SECTORUL 5",179187,804,2,1016,775,624,151,773,2,"SECTORUL 5",,0,,304,469
41,"București",403,"403-SECTORUL 5",179187,805,2,751,473,433,40,473,0,"SECTORUL 5",,0,,181,292
41,"București",403,"403-SECTORUL 5",179187,806,2,932,707,619,88,699,8,"SECTORUL 5",,0,,223,476
41,"București",403,"403-SECTORUL 5",179187,807,2,948,593,480,113,588,5,"SECTORUL 5",,0,,183,405
41,"București",403,"403-SECTORUL 5",179187,808,2,982,734,599,135,725,9,"SECTORUL 5",,0,,276,449
41,"București",403,"403-SECTORUL 5",179187,809,2,1164,853,777,76,853,0,"SECTORUL 5",,0,,382,471
41,"București",403,"403-SECTORUL 5",179187,810,2,957,622,522,100,620,2,"SECTORUL 5",,0,,232,388
41,"București",403,"403-SECTORUL 5",179187,811,2,895,714,572,142,710,3,"SECTORUL 5",,0,,302,408
41,"București",403,"403-SECTORUL 5",179187,812,2,1043,742,636,106,741,1,"SECTORUL 5",,0,,249,492
41,"București",403,"403-SECTORUL 5",179187,813,2,1026,771,601,170,771,0,"SECTORUL 5",,0,,331,440
41,"București",403,"403-SECTORUL 5",179187,814,2,999,659,571,88,655,4,"SECTORUL 5",,0,,220,435
41,"București",403,"403-SECTORUL 5",179187,815,2,1166,864,735,129,858,6,"SECTORUL 5",,0,,371,487
41,"București",403,"403-SECTORUL 5",179187,816,2,1293,1002,843,159,999,3,"SECTORUL 5",,0,,369,630
41,"București",403,"403-SECTORUL 5",179187,817,2,1110,900,724,176,897,3,"SECTORUL 5",,0,,392,505
41,"București",403,"403-SECTORUL 5",179187,818,2,826,606,542,64,602,4,"SECTORUL 5",,0,,242,360
41,"București",403,"403-SECTORUL 5",179187,819,2,1052,769,648,121,768,1,"SECTORUL 5",,0,,289,479
41,"București",403,"403-SECTORUL 5",179187,820,2,1125,640,556,84,636,4,"SECTORUL 5",,0,,199,437
41,"București",403,"403-SECTORUL 5",179187,821,2,1453,1208,960,248,1200,8,"SECTORUL 5",,0,,496,704
41,"București",403,"403-SECTORUL 5",179187,822,2,1180,788,700,88,786,2,"SECTORUL 5",,0,,302,484
41,"București",403,"403-SECTORUL 5",179187,823,2,1162,796,696,100,791,5,"SECTORUL 5",,0,,288,503
41,"București",403,"403-SECTORUL 5",179187,824,2,1004,643,556,87,640,3,"SECTORUL 5",,0,,242,398
41,"București",403,"403-SECTORUL 5",179187,825,2,996,681,627,54,677,4,"SECTORUL 5",,0,,267,410
41,"București",403,"403-SECTORUL 5",179187,826,2,934,634,591,43,628,6,"SECTORUL 5",,0,,207,421
41,"București",403,"403-SECTORUL 5",179187,827,2,1337,977,845,132,966,11,"SECTORUL 5",,0,,382,584
41,"București",403,"403-SECTORUL 5",179187,828,2,1174,851,763,88,849,2,"SECTORUL 5",,0,,353,496
41,"București",403,"403-SECTORUL 5",179187,829,2,1172,831,755,76,823,8,"SECTORUL 5",,0,,337,486
41,"București",403,"403-SECTORUL 5",179187,830,2,1130,730,637,93,728,2,"SECTORUL 5",,0,,225,503
41,"București",403,"403-SECTORUL 5",179187,831,2,1264,839,749,90,834,5,"SECTORUL 5",,0,,289,545
41,"București",403,"403-SECTORUL 5",179187,832,2,1214,830,754,76,823,7,"SECTORUL 5",,0,,299,524
41,"București",403,"403-SECTORUL 5",179187,833,2,1188,925,772,153,922,3,"SECTORUL 5",,0,,331,591
41,"București",403,"403-SECTORUL 5",179187,834,2,1167,835,726,109,828,7,"SECTORUL 5",,0,,329,499
41,"București",403,"403-SECTORUL 5",179187,835,2,1141,773,669,104,767,6,"SECTORUL 5",,0,,284,483
41,"București",403,"403-SECTORUL 5",179187,836,2,1042,698,622,76,692,6,"SECTORUL 5",,0,,259,433
41,"București",403,"403-SECTORUL 5",179187,837,2,1189,879,792,87,876,3,"SECTORUL 5",,0,,324,552
41,"București",403,"403-SECTORUL 5",179187,838,2,1078,785,719,66,784,1,"SECTORUL 5",,0,,299,485
41,"București",403,"403-SECTORUL 5",179187,839,2,1011,834,698,136,834,0,"SECTORUL 5",,0,,342,492
41,"București",403,"403-SECTORUL 5",179187,840,2,1097,781,708,73,781,0,"SECTORUL 5",,0,,334,447
41,"București",403,"403-SECTORUL 5",179187,841,2,1183,826,716,110,822,4,"SECTORUL 5",,0,,374,448
41,"București",403,"403-SECTORUL 5",179187,842,2,1131,823,703,120,817,6,"SECTORUL 5",,0,,333,484
41,"București",403,"403-SECTORUL 5",179187,843,2,1215,818,657,161,812,6,"SECTORUL 5",,0,,352,460
41,"București",403,"403-SECTORUL 5",179187,844,2,1138,936,724,212,929,7,"SECTORUL 5",,0,,313,616
41,"București",403,"403-SECTORUL 5",179187,845,2,1219,809,684,125,804,5,"SECTORUL 5",,0,,326,478
41,"București",403,"403-SECTORUL 5",179187,846,2,1021,729,662,67,724,5,"SECTORUL 5",,0,,313,411
41,"București",403,"403-SECTORUL 5",179187,847,2,1046,768,695,73,766,2,"SECTORUL 5",,0,,286,480
41,"București",403,"403-SECTORUL 5",179187,848,2,948,694,625,69,692,2,"SECTORUL 5",,0,,287,405
41,"București",403,"403-SECTORUL 5",179187,849,2,1270,877,800,77,873,4,"SECTORUL 5",,0,,355,518
41,"București",403,"403-SECTORUL 5",179187,850,2,1001,654,588,66,649,5,"SECTORUL 5",,0,,270,379
41,"București",403,"403-SECTORUL 5",179187,851,2,1037,699,631,68,688,10,"SECTORUL 5",,0,,269,419
41,"București",403,"403-SECTORUL 5",179187,852,2,1085,756,656,100,753,3,"SECTORUL 5",,0,,262,491
41,"București",403,"403-SECTORUL 5",179187,853,2,697,521,340,181,517,4,"SECTORUL 5",,0,,189,328
41,"București",403,"403-SECTORUL 5",179187,854,2,1415,811,675,136,803,8,"SECTORUL 5",,0,,348,455
41,"București",403,"403-SECTORUL 5",179187,855,2,1066,681,622,59,672,9,"SECTORUL 5",,0,,272,400
41,"București",403,"403-SECTORUL 5",179187,856,2,966,684,638,46,680,4,"SECTORUL 5",,0,,265,415
41,"București",403,"403-SECTORUL 5",179187,857,2,1035,681,610,71,678,3,"SECTORUL 5",,0,,288,390
41,"București",403,"403-SECTORUL 5",179187,858,2,1034,741,616,125,736,5,"SECTORUL 5",,0,,291,445
41,"București",403,"403-SECTORUL 5",179187,859,2,1039,716,634,82,713,3,"SECTORUL 5",,0,,286,427
41,"București",403,"403-SECTORUL 5",179187,860,2,1053,679,585,94,670,9,"SECTORUL 5",,0,,304,366
41,"București",403,"403-SECTORUL 5",179187,861,2,1159,778,687,91,776,2,"SECTORUL 5",,0,,316,460
41,"București",403,"403-SECTORUL 5",179187,862,2,1185,785,702,83,771,14,"SECTORUL 5",,0,,307,464
41,"București",403,"403-SECTORUL 5",179187,863,2,1111,704,600,104,699,5,"SECTORUL 5",,0,,318,381
41,"București",403,"403-SECTORUL 5",179187,864,2,1157,805,662,143,798,7,"SECTORUL 5",,0,,375,423
41,"București",403,"403-SECTORUL 5",179187,865,2,1045,717,544,173,710,7,"SECTORUL 5",,0,,308,402
41,"București",403,"403-SECTORUL 5",179187,866,2,986,666,583,83,661,5,"SECTORUL 5",,0,,286,375
41,"București",403,"403-SECTORUL 5",179187,867,2,973,667,578,89,667,0,"SECTORUL 5",,0,,307,360
41,"București",403,"403-SECTORUL 5",179187,868,2,1067,726,637,89,721,5,"SECTORUL 5",,0,,326,395
41,"București",403,"403-SECTORUL 5",179187,869,2,1039,487,397,90,477,10,"SECTORUL 5",,0,,164,313
41,"București",403,"403-SECTORUL 5",179187,870,2,1009,677,605,72,671,6,"SECTORUL 5",,0,,280,391
41,"București",403,"403-SECTORUL 5",179187,871,2,1068,710,648,62,706,4,"SECTORUL 5",,0,,322,384
41,"București",403,"403-SECTORUL 5",179187,872,2,1124,717,622,95,708,8,"SECTORUL 5",,0,,344,364
41,"București",403,"403-SECTORUL 5",179187,873,2,1054,708,613,95,703,5,"SECTORUL 5",,0,,337,366
41,"București",403,"403-SECTORUL 5",179187,874,2,1303,950,817,133,942,8,"SECTORUL 5",,0,,484,458
41,"București",403,"403-SECTORUL 5",179187,875,2,1184,814,716,98,804,10,"SECTORUL 5",,0,,390,414
41,"București",403,"403-SECTORUL 5",179187,876,2,1203,843,757,86,839,4,"SECTORUL 5",,0,,385,454
41,"București",403,"403-SECTORUL 5",179187,877,2,1006,758,625,133,749,9,"SECTORUL 5",,0,,391,358
41,"București",403,"403-SECTORUL 5",179187,878,2,1050,718,633,85,708,9,"SECTORUL 5",,0,,363,345
41,"București",403,"403-SECTORUL 5",179187,879,2,971,694,569,125,683,11,"SECTORUL 5",,0,,363,320
41,"București",403,"403-SECTORUL 5",179187,880,2,1016,654,562,92,644,10,"SECTORUL 5",,0,,290,354
41,"București",403,"403-SECTORUL 5",179187,881,2,1035,650,580,70,639,11,"SECTORUL 5",,0,,334,305
41,"București",403,"403-SECTORUL 5",179187,882,2,966,629,562,67,622,7,"SECTORUL 5",,0,,354,268
41,"București",403,"403-SECTORUL 5",179187,883,2,932,562,490,72,557,5,"SECTORUL 5",,0,,247,310
41,"București",403,"403-SECTORUL 5",179187,884,2,1039,692,627,65,679,13,"SECTORUL 5",,0,,365,314
41,"București",403,"403-SECTORUL 5",179187,885,2,1321,841,719,122,828,10,"SECTORUL 5",,0,,389,439
41,"București",403,"403-SECTORUL 5",179187,886,2,1358,1018,920,98,1012,6,"SECTORUL 5",,0,,374,638
41,"București",403,"403-SECTORUL 5",179187,887,2,1245,892,801,91,880,12,"SECTORUL 5",,0,,366,514
41,"București",403,"403-SECTORUL 5",179187,888,2,1225,890,810,80,881,9,"SECTORUL 5",,0,,420,461
41,"București",403,"403-SECTORUL 5",179187,889,2,1257,743,647,96,741,2,"SECTORUL 5",,0,,315,426
41,"București",403,"403-SECTORUL 5",179187,890,2,1063,790,741,49,785,5,"SECTORUL 5",,0,,320,465
41,"București",403,"403-SECTORUL 5",179187,891,2,1000,807,647,160,806,1,"SECTORUL 5",,0,,335,471
41,"București",403,"403-SECTORUL 5",179187,892,2,1115,866,810,56,863,3,"SECTORUL 5",,0,,285,578
41,"București",403,"403-SECTORUL 5",179187,893,2,1083,807,761,46,805,2,"SECTORUL 5",,0,,330,475
41,"București",403,"403-SECTORUL 5",179187,894,2,1108,766,710,56,765,1,"SECTORUL 5",,0,,326,439
41,"București",403,"403-SECTORUL 5",179187,895,2,1090,802,741,61,798,4,"SECTORUL 5",,0,,340,458
41,"București",403,"403-SECTORUL 5",179187,896,2,1043,800,694,106,796,4,"SECTORUL 5",,0,,400,396
41,"București",403,"403-SECTORUL 5",179187,897,2,1179,856,787,69,851,5,"SECTORUL 5",,0,,345,506
41,"București",403,"403-SECTORUL 5",179187,898,2,1378,922,797,125,911,11,"SECTORUL 5",,0,,350,561
41,"București",403,"403-SECTORUL 5",179187,899,2,1081,847,704,143,843,4,"SECTORUL 5",,0,,395,448
41,"București",403,"403-SECTORUL 5",179187,900,2,703,528,482,46,524,4,"SECTORUL 5",,0,,265,259
41,"București",403,"403-SECTORUL 5",179187,901,2,1066,754,676,78,751,3,"SECTORUL 5",,0,,334,417
41,"București",403,"403-SECTORUL 5",179187,902,2,1182,809,753,56,805,4,"SECTORUL 5",,0,,327,478
41,"București",403,"403-SECTORUL 5",179187,903,2,1013,717,643,74,711,6,"SECTORUL 5",,0,,267,444
41,"București",403,"403-SECTORUL 5",179187,904,2,1144,772,702,70,766,6,"SECTORUL 5",,0,,332,434
41,"București",403,"403-SECTORUL 5",179187,905,2,762,541,470,71,536,5,"SECTORUL 5",,0,,257,279
41,"București",403,"403-SECTORUL 5",179187,906,2,787,567,466,101,565,2,"SECTORUL 5",,0,,230,335
41,"București",403,"403-SECTORUL 5",179187,907,2,1171,824,671,153,815,8,"SECTORUL 5",,0,,377,438
41,"București",403,"403-SECTORUL 5",179187,908,2,1069,742,638,104,733,9,"SECTORUL 5",,0,,336,397
41,"București",403,"403-SECTORUL 5",179187,909,2,1062,716,656,60,715,1,"SECTORUL 5",,0,,335,380
41,"București",403,"403-SECTORUL 5",179187,910,2,1127,805,719,86,797,8,"SECTORUL 5",,0,,373,424
41,"București",403,"403-SECTORUL 5",179187,911,2,1062,701,626,75,691,5,"SECTORUL 5",,0,,317,374
41,"București",403,"403-SECTORUL 5",179187,912,2,1125,787,692,95,784,3,"SECTORUL 5",,0,,312,472
41,"București",403,"403-SECTORUL 5",179187,913,2,934,684,613,71,680,4,"SECTORUL 5",,0,,264,416
41,"București",403,"403-SECTORUL 5",179187,914,2,1173,828,766,62,820,8,"SECTORUL 5",,0,,368,452
41,"București",403,"403-SECTORUL 5",179187,915,2,1120,795,736,59,789,6,"SECTORUL 5",,0,,364,425
41,"București",403,"403-SECTORUL 5",179187,916,2,1148,682,622,60,680,2,"SECTORUL 5",,0,,239,441
41,"București",403,"403-SECTORUL 5",179187,917,2,1113,768,695,73,768,0,"SECTORUL 5",,0,,279,489
41,"București",403,"403-SECTORUL 5",179187,918,2,1101,756,655,101,752,4,"SECTORUL 5",,0,,294,458
41,"București",403,"403-SECTORUL 5",179187,919,2,1091,735,674,61,727,7,"SECTORUL 5",,0,,267,460
41,"București",403,"403-SECTORUL 5",179187,920,2,941,584,509,75,579,5,"SECTORUL 5",,0,,233,346
41,"București",403,"403-SECTORUL 5",179187,921,2,1034,644,577,67,632,12,"SECTORUL 5",,0,,236,396
41,"București",403,"403-SECTORUL 5",179187,922,2,1024,744,684,60,735,8,"SECTORUL 5",,0,,374,361
41,"București",403,"403-SECTORUL 5",179187,923,2,1381,949,822,127,945,4,"SECTORUL 5",,0,,387,558
41,"București",403,"403-SECTORUL 5",179187,924,2,1015,674,554,120,674,0,"SECTORUL 5",,0,,320,354
41,"București",403,"403-SECTORUL 5",179187,925,2,1370,854,750,104,848,6,"SECTORUL 5",,0,,333,515
41,"București",403,"403-SECTORUL 5",179187,926,2,1086,745,593,152,744,1,"SECTORUL 5",,0,,253,491
41,"București",403,"403-SECTORUL 5",179187,927,2,1204,848,736,112,844,4,"SECTORUL 5",,0,,298,546
41,"București",403,"403-SECTORUL 5",179187,928,2,992,662,603,59,658,4,"SECTORUL 5",,0,,212,446
41,"București",403,"403-SECTORUL 5",179187,929,2,1062,759,673,86,756,3,"SECTORUL 5",,0,,275,481
41,"București",403,"403-SECTORUL 5",179187,930,2,1175,826,733,93,825,1,"SECTORUL 5",,0,,323,502
41,"București",403,"403-SECTORUL 5",179187,931,2,1033,661,595,66,655,6,"SECTORUL 5",,0,,244,411
41,"București",403,"403-SECTORUL 5",179187,932,2,1036,741,688,53,739,2,"SECTORUL 5",,0,,292,447
41,"București",403,"403-SECTORUL 5",179187,933,2,1060,784,688,96,783,1,"SECTORUL 5",,0,,265,518
41,"București",403,"403-SECTORUL 5",179187,934,2,1031,675,599,76,669,6,"SECTORUL 5",,0,,229,440
41,"București",403,"403-SECTORUL 5",179187,935,2,1197,865,755,110,865,0,"SECTORUL 5",,0,,331,534
41,"București",403,"403-SECTORUL 5",179187,936,2,1162,799,722,77,797,2,"SECTORUL 5",,0,,266,531
41,"București",403,"403-SECTORUL 5",179187,937,2,1117,835,648,187,831,4,"SECTORUL 5",,0,,252,579
41,"București",403,"403-SECTORUL 5",179187,938,2,1178,793,747,46,792,1,"SECTORUL 5",,0,,320,472
41,"București",403,"403-SECTORUL 5",179187,939,2,1041,738,671,67,733,5,"SECTORUL 5",,0,,270,463
41,"București",403,"403-SECTORUL 5",179187,940,2,932,729,555,174,725,4,"SECTORUL 5",,0,,288,437
41,"București",403,"403-SECTORUL 5",179187,941,2,1345,997,910,87,993,4,"SECTORUL 5",,0,,338,655
41,"București",403,"403-SECTORUL 5",179187,942,2,944,779,652,127,777,2,"SECTORUL 5",,0,,302,475
41,"București",403,"403-SECTORUL 5",179187,943,2,1146,868,758,110,863,4,"SECTORUL 5",,0,,387,476
41,"București",403,"403-SECTORUL 5",179187,944,2,898,694,575,119,693,1,"SECTORUL 5",,0,,247,446
41,"București",403,"403-SECTORUL 5",179187,945,2,929,790,691,99,787,3,"SECTORUL 5",,0,,277,510
41,"București",403,"403-SECTORUL 5",179187,946,2,1018,763,663,100,758,5,"SECTORUL 5",,0,,299,459
41,"București",403,"403-SECTORUL 5",179187,947,2,1106,829,747,82,825,4,"SECTORUL 5",,0,,387,438
41,"București",403,"403-SECTORUL 5",179187,948,2,1160,786,695,91,785,1,"SECTORUL 5",,0,,260,525
41,"București",403,"403-SECTORUL 5",179187,949,2,1073,795,715,80,788,7,"SECTORUL 5",,0,,240,548
41,"București",403,"403-SECTORUL 5",179187,950,2,1098,802,696,106,798,4,"SECTORUL 5",,0,,316,482
41,"București",403,"403-SECTORUL 5",179187,951,2,1170,899,822,77,895,4,"SECTORUL 5",,0,,272,623
41,"București",403,"403-SECTORUL 5",179187,952,2,1214,751,669,82,748,3,"SECTORUL 5",,0,,234,514
41,"București",403,"403-SECTORUL 5",179187,953,2,1183,721,635,86,721,0,"SECTORUL 5",,0,,284,437
41,"București",403,"403-SECTORUL 5",179187,954,2,1200,810,715,95,806,4,"SECTORUL 5",,0,,321,485
41,"București",403,"403-SECTORUL 5",179187,955,2,1081,644,557,87,636,8,"SECTORUL 5",,0,,244,392
41,"București",403,"403-SECTORUL 5",179187,956,2,616,386,298,88,383,3,"SECTORUL 5",,0,,152,231
41,"București",403,"403-SECTORUL 5",179187,957,2,911,598,536,62,597,1,"SECTORUL 5",,0,,231,366
41,"București",403,"403-SECTORUL 5",179187,958,2,1000,791,729,62,787,4,"SECTORUL 5",,0,,471,316
41,"București",403,"403-SECTORUL 5",179187,959,2,973,798,735,63,796,2,"SECTORUL 5",,0,,431,365
41,"București",403,"403-SECTORUL 5",179187,960,2,1330,1063,989,74,1053,10,"SECTORUL 5",,0,,627,426
41,"București",403,"403-SECTORUL 5",179187,961,2,996,766,723,43,764,2,"SECTORUL 5",,0,,404,360
41,"București",403,"403-SECTORUL 5",179187,962,2,1048,729,667,62,729,0,"SECTORUL 5",,0,,270,459
41,"București",403,"403-SECTORUL 5",179187,963,2,954,656,561,95,649,7,"SECTORUL 5",,0,,261,388
41,"București",403,"403-SECTORUL 5",179187,964,2,910,727,556,171,723,4,"SECTORUL 5",,0,,256,467
41,"București",403,"403-SECTORUL 5",179187,965,2,0,326,0,326,326,0,"SECTORUL 5",,0,,50,276
41,"București",403,"403-SECTORUL 5",179187,966,2,0,414,0,414,414,0,"SECTORUL 5",,0,,64,350
41,"București",403,"403-SECTORUL 5",179187,967,2,1074,920,745,175,917,3,"SECTORUL 5",,0,,351,566
41,"București",403,"403-SECTORUL 5",179187,968,2,1135,738,597,141,736,2,"SECTORUL 5",,0,,274,462
41,"București",403,"403-SECTORUL 5",179187,969,2,1138,811,717,94,810,1,"SECTORUL 5",,0,,325,485
41,"București",403,"403-SECTORUL 5",179187,970,2,1524,1032,844,188,1029,3,"SECTORUL 5",,0,,419,610
41,"București",403,"403-SECTORUL 5",179187,971,2,1200,837,695,142,834,3,"SECTORUL 5",,0,,323,511
41,"București",403,"403-SECTORUL 5",179187,972,2,0,526,0,526,521,5,"SECTORUL 5",,0,,210,311
41,"București",403,"403-SECTORUL 5",179187,973,2,0,568,0,568,565,3,"SECTORUL 5",,0,,252,313
41,"București",403,"403-SECTORUL 5",179187,974,2,0,275,0,275,274,1,"SECTORUL 5",,0,,104,170
41,"București",403,"403-SECTORUL 5",179187,975,2,0,197,0,197,197,0,"SECTORUL 5",,0,,86,111
41,"București",403,"403-SECTORUL 5",179187,976,2,0,215,0,215,212,3,"SECTORUL 5",,0,,79,133
41,"București",403,"403-SECTORUL 6",179196,977,2,1177,868,790,78,861,7,"SECTORUL 6",,0,,377,484
41,"București",403,"403-SECTORUL 6",179196,978,2,1342,954,870,84,947,7,"SECTORUL 6",,0,,318,629
41,"București",403,"403-SECTORUL 6",179196,979,2,1529,1166,1033,133,1161,5,"SECTORUL 6",,0,,454,707
41,"București",403,"403-SECTORUL 6",179196,980,2,1457,1064,964,100,1061,3,"SECTORUL 6",,0,,498,563
41,"București",403,"403-SECTORUL 6",179196,981,2,1404,1056,986,70,1053,3,"SECTORUL 6",,0,,388,665
41,"București",403,"403-SECTORUL 6",179196,982,2,1524,1114,1055,59,1103,11,"SECTORUL 6",,0,,390,713
41,"București",403,"403-SECTORUL 6",179196,983,2,1326,962,891,71,959,3,"SECTORUL 6",,0,,397,562
41,"București",403,"403-SECTORUL 6",179196,984,2,1371,1097,948,149,1095,2,"SECTORUL 6",,0,,549,546
41,"București",403,"403-SECTORUL 6",179196,985,2,1092,936,798,138,931,5,"SECTORUL 6",,0,,418,513
41,"București",403,"403-SECTORUL 6",179196,986,2,1164,942,839,103,938,4,"SECTORUL 6",,0,,356,582
41,"București",403,"403-SECTORUL 6",179196,987,2,1256,892,828,64,889,3,"SECTORUL 6",,0,,365,524
41,"București",403,"403-SECTORUL 6",179196,988,2,1364,950,879,71,946,4,"SECTORUL 6",,0,,332,614
41,"București",403,"403-SECTORUL 6",179196,989,2,1186,921,858,63,920,1,"SECTORUL 6",,0,,319,601
41,"București",403,"403-SECTORUL 6",179196,990,2,1247,928,870,58,924,4,"SECTORUL 6",,0,,364,560
41,"București",403,"403-SECTORUL 6",179196,991,2,1487,1156,1029,127,1143,9,"SECTORUL 6",,0,,527,616
41,"București",403,"403-SECTORUL 6",179196,992,2,1643,1279,1115,164,1275,4,"SECTORUL 6",,0,,422,853
41,"București",403,"403-SECTORUL 6",179196,993,2,1185,788,708,80,779,9,"SECTORUL 6",,0,,370,409
41,"București",403,"403-SECTORUL 6",179196,994,2,1646,1262,1171,91,1256,6,"SECTORUL 6",,0,,554,702
41,"București",403,"403-SECTORUL 6",179196,995,2,1750,1280,1172,108,1272,8,"SECTORUL 6",,0,,497,775
41,"București",403,"403-SECTORUL 6",179196,996,2,1316,988,870,118,983,5,"SECTORUL 6",,0,,385,598
41,"București",403,"403-SECTORUL 6",179196,997,2,1694,1257,1156,101,1249,8,"SECTORUL 6",,0,,505,744
41,"București",403,"403-SECTORUL 6",179196,998,2,1599,1178,1099,79,1164,14,"SECTORUL 6",,0,,512,652
41,"București",403,"403-SECTORUL 6",179196,999,2,1438,1074,1015,59,1070,4,"SECTORUL 6",,0,,423,647
41,"București",403,"403-SECTORUL 6",179196,1000,2,1642,1280,1225,55,1279,1,"SECTORUL 6",,0,,584,695
41,"București",403,"403-SECTORUL 6",179196,1001,2,1455,1100,1013,87,1092,8,"SECTORUL 6",,0,,403,689
41,"București",403,"403-SECTORUL 6",179196,1002,2,1378,1104,1022,82,1100,4,"SECTORUL 6",,0,,469,631
41,"București",403,"403-SECTORUL 6",179196,1003,2,1332,1028,904,124,1023,5,"SECTORUL 6",,0,,404,619
41,"București",403,"403-SECTORUL 6",179196,1004,2,1569,1285,1125,160,1276,9,"SECTORUL 6",,0,,676,600
41,"București",403,"403-SECTORUL 6",179196,1005,2,1356,1055,951,104,1050,5,"SECTORUL 6",,0,,444,606
41,"București",403,"403-SECTORUL 6",179196,1006,2,1422,1141,1041,100,1139,2,"SECTORUL 6",,0,,490,649
41,"București",403,"403-SECTORUL 6",179196,1007,2,1325,990,920,70,987,3,"SECTORUL 6",,0,,488,499
41,"București",403,"403-SECTORUL 6",179196,1008,2,1567,1145,1052,93,1138,7,"SECTORUL 6",,0,,437,701
41,"București",403,"403-SECTORUL 6",179196,1009,2,1410,1127,928,199,1120,7,"SECTORUL 6",,0,,520,600
41,"București",403,"403-SECTORUL 6",179196,1010,2,1502,1196,1098,98,1186,10,"SECTORUL 6",,0,,534,652
41,"București",403,"403-SECTORUL 6",179196,1011,2,1405,1073,980,93,1069,4,"SECTORUL 6",,0,,408,661
41,"București",403,"403-SECTORUL 6",179196,1012,2,1422,1129,1025,104,1127,2,"SECTORUL 6",,0,,417,710
41,"București",403,"403-SECTORUL 6",179196,1013,2,1431,1107,1005,102,1104,3,"SECTORUL 6",,0,,427,677
41,"București",403,"403-SECTORUL 6",179196,1014,2,1498,1167,1067,100,1166,1,"SECTORUL 6",,0,,487,679
41,"București",403,"403-SECTORUL 6",179196,1015,2,1469,1120,1050,70,1117,3,"SECTORUL 6",,0,,499,618
41,"București",403,"403-SECTORUL 6",179196,1016,2,1615,1244,1161,83,1239,5,"SECTORUL 6",,0,,504,735
41,"București",403,"403-SECTORUL 6",179196,1017,2,1390,1077,940,137,1069,8,"SECTORUL 6",,0,,395,674
41,"București",403,"403-SECTORUL 6",179196,1018,2,1389,1106,1018,88,1104,2,"SECTORUL 6",,0,,439,665
41,"București",403,"403-SECTORUL 6",179196,1019,2,1453,1149,1039,110,1141,8,"SECTORUL 6",,0,,426,715
41,"București",403,"403-SECTORUL 6",179196,1020,2,1321,1045,907,138,1034,11,"SECTORUL 6",,0,,423,611
41,"București",403,"403-SECTORUL 6",179196,1021,2,1508,1092,1000,92,1089,3,"SECTORUL 6",,0,,424,665
41,"București",403,"403-SECTORUL 6",179196,1022,2,1376,1113,985,128,1108,5,"SECTORUL 6",,0,,458,650
41,"București",403,"403-SECTORUL 6",179196,1023,2,1567,1257,1147,110,1252,5,"SECTORUL 6",,0,,482,770
41,"București",403,"403-SECTORUL 6",179196,1024,2,1335,870,764,106,866,4,"SECTORUL 6",,0,,311,555
41,"București",403,"403-SECTORUL 6",179196,1025,2,1254,949,864,85,946,3,"SECTORUL 6",,0,,394,552
41,"București",403,"403-SECTORUL 6",179196,1026,2,1424,998,914,84,991,7,"SECTORUL 6",,0,,402,589
41,"București",403,"403-SECTORUL 6",179196,1027,2,1389,1186,1052,134,1179,7,"SECTORUL 6",,0,,401,778
41,"București",403,"403-SECTORUL 6",179196,1028,2,1267,937,881,56,937,0,"SECTORUL 6",,0,,341,596
41,"București",403,"403-SECTORUL 6",179196,1029,2,1463,1102,1026,76,1096,6,"SECTORUL 6",,0,,356,740
41,"București",403,"403-SECTORUL 6",179196,1030,2,1600,1218,1154,64,1213,5,"SECTORUL 6",,0,,443,770
41,"București",403,"403-SECTORUL 6",179196,1031,2,1480,1126,1077,49,1121,5,"SECTORUL 6",,0,,426,695
41,"București",403,"403-SECTORUL 6",179196,1032,2,1670,1273,1178,95,1260,13,"SECTORUL 6",,0,,475,785
41,"București",403,"403-SECTORUL 6",179196,1033,2,1418,1139,1019,120,1138,1,"SECTORUL 6",,0,,380,758
41,"București",403,"403-SECTORUL 6",179196,1034,2,1357,1012,935,77,1007,5,"SECTORUL 6",,0,,309,698
41,"București",403,"403-SECTORUL 6",179196,1035,2,1443,1062,986,76,1059,3,"SECTORUL 6",,0,,498,561
41,"București",403,"403-SECTORUL 6",179196,1036,2,1397,1078,974,104,1074,4,"SECTORUL 6",,0,,413,661
41,"București",403,"403-SECTORUL 6",179196,1037,2,1315,1030,948,82,1029,1,"SECTORUL 6",,0,,347,682
41,"București",403,"403-SECTORUL 6",179196,1038,2,1354,1005,939,66,1002,3,"SECTORUL 6",,0,,319,683
41,"București",403,"403-SECTORUL 6",179196,1039,2,1157,902,851,51,900,2,"SECTORUL 6",,0,,321,579
41,"București",403,"403-SECTORUL 6",179196,1040,2,1492,1203,1096,107,1197,6,"SECTORUL 6",,0,,428,769
41,"București",403,"403-SECTORUL 6",179196,1041,2,1494,1128,1012,116,1126,2,"SECTORUL 6",,0,,366,760
41,"București",403,"403-SECTORUL 6",179196,1042,2,1664,1283,1155,128,1276,7,"SECTORUL 6",,0,,430,846
41,"București",403,"403-SECTORUL 6",179196,1043,2,1649,1244,1179,65,1237,7,"SECTORUL 6",,0,,506,731
41,"București",403,"403-SECTORUL 6",179196,1044,2,1687,1336,1241,95,1329,7,"SECTORUL 6",,0,,518,811
41,"București",403,"403-SECTORUL 6",179196,1045,2,1441,1087,1015,72,1084,1,"SECTORUL 6",,0,,494,590
41,"București",403,"403-SECTORUL 6",179196,1046,2,1386,1048,980,68,1045,3,"SECTORUL 6",,0,,415,630
41,"București",403,"403-SECTORUL 6",179196,1047,2,1405,1088,1035,53,1086,2,"SECTORUL 6",,0,,433,653
41,"București",403,"403-SECTORUL 6",179196,1048,2,1019,797,727,70,792,5,"SECTORUL 6",,0,,275,517
41,"București",403,"403-SECTORUL 6",179196,1049,2,1532,1141,1068,73,1136,5,"SECTORUL 6",,0,,436,700
41,"București",403,"403-SECTORUL 6",179196,1050,2,1527,1141,1065,76,1137,4,"SECTORUL 6",,0,,449,688
41,"București",403,"403-SECTORUL 6",179196,1051,2,1593,1270,1090,180,1263,7,"SECTORUL 6",,0,,517,746
41,"București",403,"403-SECTORUL 6",179196,1052,2,1673,1270,1178,92,1263,7,"SECTORUL 6",,0,,441,822
41,"București",403,"403-SECTORUL 6",179196,1053,2,1493,1128,1064,64,1121,7,"SECTORUL 6",,0,,417,704
41,"București",403,"403-SECTORUL 6",179196,1054,2,1686,1105,1042,63,1099,6,"SECTORUL 6",,0,,410,689
41,"București",403,"403-SECTORUL 6",179196,1055,2,1406,1082,980,102,1078,4,"SECTORUL 6",,0,,381,697
41,"București",403,"403-SECTORUL 6",179196,1056,2,1497,1098,1004,94,1088,0,"SECTORUL 6",,0,,409,679
41,"București",403,"403-SECTORUL 6",179196,1057,2,1505,1096,992,104,1091,5,"SECTORUL 6",,0,,387,704
41,"București",403,"403-SECTORUL 6",179196,1058,2,1647,1230,1116,114,1225,5,"SECTORUL 6",,0,,427,798
41,"București",403,"403-SECTORUL 6",179196,1059,2,1679,1298,1201,97,1293,3,"SECTORUL 6",,0,,389,904
41,"București",403,"403-SECTORUL 6",179196,1060,2,1701,1290,1179,111,1282,8,"SECTORUL 6",,0,,496,786
41,"București",403,"403-SECTORUL 6",179196,1061,2,1223,978,894,84,976,2,"SECTORUL 6",,0,,275,701
41,"București",403,"403-SECTORUL 6",179196,1062,2,1561,1164,1080,84,1157,7,"SECTORUL 6",,0,,458,699
41,"București",403,"403-SECTORUL 6",179196,1063,2,1703,1336,1240,96,1332,4,"SECTORUL 6",,0,,404,928
41,"București",403,"403-SECTORUL 6",179196,1064,2,1453,1072,1016,56,1064,8,"SECTORUL 6",,0,,353,711
41,"București",403,"403-SECTORUL 6",179196,1065,2,1381,1087,959,128,1081,6,"SECTORUL 6",,0,,414,667
41,"București",403,"403-SECTORUL 6",179196,1066,2,1750,1228,1150,78,1223,5,"SECTORUL 6",,0,,495,728
41,"București",403,"403-SECTORUL 6",179196,1067,2,1597,1132,1064,68,1124,8,"SECTORUL 6",,0,,389,735
41,"București",403,"403-SECTORUL 6",179196,1068,2,1474,1093,1021,72,1092,1,"SECTORUL 6",,0,,400,692
41,"București",403,"403-SECTORUL 6",179196,1069,2,1630,1181,1115,66,1177,4,"SECTORUL 6",,0,,453,724
41,"București",403,"403-SECTORUL 6",179196,1070,2,1663,1261,1188,73,1257,4,"SECTORUL 6",,0,,439,818
41,"București",403,"403-SECTORUL 6",179196,1071,2,1464,1048,967,81,1042,6,"SECTORUL 6",,0,,375,667
41,"București",403,"403-SECTORUL 6",179196,1072,2,1558,1185,1069,116,1175,10,"SECTORUL 6",,0,,421,754
41,"București",403,"403-SECTORUL 6",179196,1073,2,1311,1005,934,71,1003,2,"SECTORUL 6",,0,,348,655
41,"București",403,"403-SECTORUL 6",179196,1074,2,1373,1110,1054,56,1106,4,"SECTORUL 6",,0,,345,761
41,"București",403,"403-SECTORUL 6",179196,1075,2,1587,1172,1096,76,1172,0,"SECTORUL 6",,0,,423,749
41,"București",403,"403-SECTORUL 6",179196,1076,2,1063,616,547,69,610,6,"SECTORUL 6",,0,,240,370
41,"București",403,"403-SECTORUL 6",179196,1077,2,1483,1247,954,293,1240,6,"SECTORUL 6",,0,,478,762
41,"București",403,"403-SECTORUL 6",179196,1078,2,1240,1158,815,343,1155,3,"SECTORUL 6",,0,,431,724
41,"București",403,"403-SECTORUL 6",179196,1079,2,1241,944,872,72,936,8,"SECTORUL 6",,0,,340,596
41,"București",403,"403-SECTORUL 6",179196,1080,2,1412,1028,979,49,1024,4,"SECTORUL 6",,0,,351,673
41,"București",403,"403-SECTORUL 6",179196,1081,2,1589,1227,1090,137,1219,8,"SECTORUL 6",,0,,485,734
41,"București",403,"403-SECTORUL 6",179196,1082,2,1417,1031,964,67,1027,4,"SECTORUL 6",,0,,418,609
41,"București",403,"403-SECTORUL 6",179196,1083,2,1498,1105,998,107,1099,6,"SECTORUL 6",,0,,487,612
41,"București",403,"403-SECTORUL 6",179196,1084,2,1347,840,763,77,833,7,"SECTORUL 6",,0,,360,473
41,"București",403,"403-SECTORUL 6",179196,1085,2,1561,1130,1040,90,1122,8,"SECTORUL 6",,0,,434,688
41,"București",403,"403-SECTORUL 6",179196,1086,2,1524,1105,1046,59,1098,5,"SECTORUL 6",,0,,336,762
41,"București",403,"403-SECTORUL 6",179196,1087,2,1611,1089,977,112,1081,8,"SECTORUL 6",,0,,432,649
41,"București",403,"403-SECTORUL 6",179196,1088,2,1622,1099,1002,97,1090,9,"SECTORUL 6",,0,,433,657
41,"București",403,"403-SECTORUL 6",179196,1089,2,1723,1187,1072,115,1177,10,"SECTORUL 6",,0,,444,733
41,"București",403,"403-SECTORUL 6",179196,1090,2,1565,1060,942,118,1054,6,"SECTORUL 6",,0,,401,653
41,"București",403,"403-SECTORUL 6",179196,1091,2,1456,1032,943,89,1027,5,"SECTORUL 6",,0,,467,560
41,"București",403,"403-SECTORUL 6",179196,1092,2,1716,1111,1033,78,1102,9,"SECTORUL 6",,0,,475,627
41,"București",403,"403-SECTORUL 6",179196,1093,2,1566,1129,1043,86,1128,1,"SECTORUL 6",,0,,459,669
41,"București",403,"403-SECTORUL 6",179196,1094,2,1498,1099,1016,83,1094,5,"SECTORUL 6",,0,,409,685
41,"București",403,"403-SECTORUL 6",179196,1095,2,1442,1020,915,105,1018,2,"SECTORUL 6",,0,,395,623
41,"București",403,"403-SECTORUL 6",179196,1096,2,1096,747,689,58,740,7,"SECTORUL 6",,0,,359,381
41,"București",403,"403-SECTORUL 6",179196,1097,2,1044,769,665,104,763,6,"SECTORUL 6",,0,,282,481
41,"București",403,"403-SECTORUL 6",179196,1098,2,1470,1054,988,66,1051,3,"SECTORUL 6",,0,,431,620
41,"București",403,"403-SECTORUL 6",179196,1099,2,1394,926,879,47,920,6,"SECTORUL 6",,0,,362,558
41,"București",403,"403-SECTORUL 6",179196,1100,2,1511,1112,1032,80,1110,2,"SECTORUL 6",,0,,492,618
41,"București",403,"403-SECTORUL 6",179196,1101,2,1359,878,815,63,874,4,"SECTORUL 6",,0,,368,506
41,"București",403,"403-SECTORUL 6",179196,1102,2,1421,946,859,87,942,4,"SECTORUL 6",,0,,388,554
41,"București",403,"403-SECTORUL 6",179196,1103,2,1471,1041,974,67,1038,3,"SECTORUL 6",,0,,421,617
41,"București",403,"403-SECTORUL 6",179196,1104,2,1645,1113,1038,75,1108,5,"SECTORUL 6",,0,,489,619
41,"București",403,"403-SECTORUL 6",179196,1105,2,1423,968,879,89,959,9,"SECTORUL 6",,0,,404,555
41,"București",403,"403-SECTORUL 6",179196,1106,2,1776,1281,1133,148,1274,7,"SECTORUL 6",,0,,462,812
41,"București",403,"403-SECTORUL 6",179196,1107,2,1657,1288,1078,210,1278,10,"SECTORUL 6",,0,,569,709
41,"București",403,"403-SECTORUL 6",179196,1108,2,1082,806,650,156,804,2,"SECTORUL 6",,0,,281,523
41,"București",403,"403-SECTORUL 6",179196,1109,2,1417,1100,970,130,1097,3,"SECTORUL 6",,0,,422,675
41,"București",403,"403-SECTORUL 6",179196,1110,2,1054,884,485,399,875,9,"SECTORUL 6",,0,,335,540
41,"București",403,"403-SECTORUL 6",179196,1111,2,1475,960,870,90,960,0,"SECTORUL 6",,0,,324,636
41,"București",403,"403-SECTORUL 6",179196,1112,2,1440,975,841,134,959,16,"SECTORUL 6",,0,,368,591
41,"București",403,"403-SECTORUL 6",179196,1113,2,1499,1004,920,84,999,5,"SECTORUL 6",,0,,368,631
41,"București",403,"403-SECTORUL 6",179196,1114,2,1235,945,848,97,939,6,"SECTORUL 6",,0,,381,558
41,"București",403,"403-SECTORUL 6",179196,1115,2,1404,1031,977,54,1024,7,"SECTORUL 6",,0,,391,633
41,"București",403,"403-SECTORUL 6",179196,1116,2,1944,1289,1198,91,1287,2,"SECTORUL 6",,0,,430,857
41,"București",403,"403-SECTORUL 6",179196,1117,2,1549,1162,1080,82,1152,10,"SECTORUL 6",,0,,439,713
41,"București",403,"403-SECTORUL 6",179196,1118,2,1108,800,686,114,793,5,"SECTORUL 6",,0,,299,494
41,"București",403,"403-SECTORUL 6",179196,1119,2,1714,1140,1034,106,1131,9,"SECTORUL 6",,0,,476,655
41,"București",403,"403-SECTORUL 6",179196,1120,2,1526,1058,962,96,1055,3,"SECTORUL 6",,0,,411,644
41,"București",403,"403-SECTORUL 6",179196,1121,2,1555,1100,1004,96,1093,7,"SECTORUL 6",,0,,413,680
41,"București",403,"403-SECTORUL 6",179196,1122,2,1492,1056,986,70,1052,4,"SECTORUL 6",,0,,399,653
41,"București",403,"403-SECTORUL 6",179196,1123,2,1625,1132,1062,70,1127,5,"SECTORUL 6",,0,,440,687
41,"București",403,"403-SECTORUL 6",179196,1124,2,1390,1025,941,84,1023,2,"SECTORUL 6",,0,,402,621
41,"București",403,"403-SECTORUL 6",179196,1125,2,1497,1141,1018,123,1136,5,"SECTORUL 6",,0,,457,679
41,"București",403,"403-SECTORUL 6",179196,1126,2,1668,1339,1163,176,1337,2,"SECTORUL 6",,0,,593,744
41,"București",403,"403-SECTORUL 6",179196,1127,2,1474,1130,1041,89,1123,7,"SECTORUL 6",,0,,501,622
41,"București",403,"403-SECTORUL 6",179196,1128,2,1535,1128,1070,58,1122,6,"SECTORUL 6",,0,,478,644
41,"București",403,"403-SECTORUL 6",179196,1129,2,1468,1149,1014,135,1142,7,"SECTORUL 6",,0,,421,721
41,"București",403,"403-SECTORUL 6",179196,1130,2,1182,837,787,50,836,1,"SECTORUL 6",,0,,333,503
41,"București",403,"403-SECTORUL 6",179196,1131,2,1130,851,803,48,848,3,"SECTORUL 6",,0,,294,554
41,"București",403,"403-SECTORUL 6",179196,1132,2,1084,803,761,42,803,0,"SECTORUL 6",,0,,330,473
41,"București",403,"403-SECTORUL 6",179196,1133,2,912,654,622,32,654,0,"SECTORUL 6",,0,,235,419
41,"București",403,"403-SECTORUL 6",179196,1134,2,927,706,672,34,699,7,"SECTORUL 6",,0,,256,443
41,"București",403,"403-SECTORUL 6",179196,1135,2,1247,937,835,102,933,4,"SECTORUL 6",,0,,299,634
41,"București",403,"403-SECTORUL 6",179196,1136,2,1495,1110,1020,90,1103,7,"SECTORUL 6",,0,,400,703
41,"București",403,"403-SECTORUL 6",179196,1137,2,1199,837,763,74,833,4,"SECTORUL 6",,0,,330,503
41,"București",403,"403-SECTORUL 6",179196,1138,2,1068,792,733,59,787,5,"SECTORUL 6",,0,,294,493
41,"București",403,"403-SECTORUL 6",179196,1139,2,1575,1156,1103,53,1148,8,"SECTORUL 6",,0,,416,732
41,"București",403,"403-SECTORUL 6",179196,1140,2,1685,1235,1164,71,1232,3,"SECTORUL 6",,0,,463,769
41,"București",403,"403-SECTORUL 6",179196,1141,2,1525,1168,1097,71,1165,3,"SECTORUL 6",,0,,437,728
41,"București",403,"403-SECTORUL 6",179196,1142,2,1213,939,879,60,935,4,"SECTORUL 6",,0,,337,598
41,"București",403,"403-SECTORUL 6",179196,1143,2,1311,955,881,74,948,7,"SECTORUL 6",,0,,371,577
41,"București",403,"403-SECTORUL 6",179196,1144,2,1533,1198,1142,56,1196,2,"SECTORUL 6",,0,,441,755
41,"București",403,"403-SECTORUL 6",179196,1145,2,1078,875,809,66,869,6,"SECTORUL 6",,0,,334,535
41,"București",403,"403-SECTORUL 6",179196,1146,2,1839,1178,1034,144,1171,7,"SECTORUL 6",,0,,504,667
41,"București",403,"403-SECTORUL 6",179196,1147,2,1799,1218,1113,105,1216,2,"SECTORUL 6",,0,,454,762
41,"București",403,"403-SECTORUL 6",179196,1148,2,1219,922,826,96,918,4,"SECTORUL 6",,0,,335,583
41,"București",403,"403-SECTORUL 6",179196,1149,2,1592,1147,1041,106,1136,11,"SECTORUL 6",,0,,389,747
41,"București",403,"403-SECTORUL 6",179196,1150,2,2097,1484,1363,121,1478,6,"SECTORUL 6",,0,,554,924
41,"București",403,"403-SECTORUL 6",179196,1151,2,1515,1101,977,124,1094,7,"SECTORUL 6",,0,,447,647
41,"București",403,"403-SECTORUL 6",179196,1152,2,1725,1274,1114,160,1267,7,"SECTORUL 6",,0,,537,730
41,"București",403,"403-SECTORUL 6",179196,1153,2,1367,905,807,98,897,8,"SECTORUL 6",,0,,329,568
41,"București",403,"403-SECTORUL 6",179196,1154,2,1528,1107,977,130,1103,4,"SECTORUL 6",,0,,401,702
41,"București",403,"403-SECTORUL 6",179196,1155,2,1300,880,767,113,875,5,"SECTORUL 6",,0,,353,522
41,"București",403,"403-SECTORUL 6",179196,1156,2,1563,999,902,97,999,0,"SECTORUL 6",,0,,370,629
41,"București",403,"403-SECTORUL 6",179196,1157,2,1291,980,913,67,973,5,"SECTORUL 6",,0,,353,620
41,"București",403,"403-SECTORUL 6",179196,1158,2,1515,1180,1067,113,1174,6,"SECTORUL 6",,0,,394,780
41,"București",403,"403-SECTORUL 6",179196,1159,2,1277,948,891,57,945,3,"SECTORUL 6",,0,,316,629
41,"București",403,"403-SECTORUL 6",179196,1160,2,1698,1297,1178,119,1292,5,"SECTORUL 6",,0,,395,897
41,"București",403,"403-SECTORUL 6",179196,1161,2,1137,901,808,93,897,4,"SECTORUL 6",,0,,282,615
41,"București",403,"403-SECTORUL 6",179196,1162,2,1527,1128,1052,76,1124,4,"SECTORUL 6",,0,,442,682
41,"București",403,"403-SECTORUL 6",179196,1163,2,1335,1077,868,209,1070,7,"SECTORUL 6",,0,,356,714
41,"București",403,"403-SECTORUL 6",179196,1164,2,634,536,281,255,534,2,"SECTORUL 6",,0,,164,370
41,"București",403,"403-SECTORUL 6",179196,1165,2,1583,1124,881,243,1117,7,"SECTORUL 6",,0,,388,729
41,"București",403,"403-SECTORUL 6",179196,1166,2,1451,1024,943,81,1018,6,"SECTORUL 6",,0,,349,669
41,"București",403,"403-SECTORUL 6",179196,1167,2,1200,879,778,101,875,4,"SECTORUL 6",,0,,313,562
41,"București",403,"403-SECTORUL 6",179196,1168,2,1294,918,811,107,915,3,"SECTORUL 6",,0,,381,534
41,"București",403,"403-SECTORUL 6",179196,1169,2,1644,1294,1039,255,1285,9,"SECTORUL 6",,0,,427,858
41,"București",403,"403-SECTORUL 6",179196,1170,2,1346,963,768,195,960,3,"SECTORUL 6",,0,,305,655
41,"București",403,"403-SECTORUL 6",179196,1171,2,1453,1189,930,259,1186,3,"SECTORUL 6",,0,,463,723
41,"București",403,"403-SECTORUL 6",179196,1172,2,1444,1038,975,63,1032,6,"SECTORUL 6",,0,,409,623
41,"București",403,"403-SECTORUL 6",179196,1173,2,1554,1002,931,71,997,5,"SECTORUL 6",,0,,334,663
41,"București",403,"403-SECTORUL 6",179196,1174,2,1567,1091,1013,78,1087,4,"SECTORUL 6",,0,,373,714
41,"București",403,"403-SECTORUL 6",179196,1175,2,1665,1180,1075,105,1170,10,"SECTORUL 6",,0,,383,787
41,"București",403,"403-SECTORUL 6",179196,1176,2,1412,971,901,70,968,3,"SECTORUL 6",,0,,371,597
41,"București",403,"403-SECTORUL 6",179196,1177,2,1346,956,857,99,950,6,"SECTORUL 6",,0,,349,601
41,"București",403,"403-SECTORUL 6",179196,1178,2,1142,819,741,78,816,3,"SECTORUL 6",,0,,326,490
41,"București",403,"403-SECTORUL 6",179196,1179,2,1385,1006,928,78,1003,3,"SECTORUL 6",,0,,331,672
41,"București",403,"403-SECTORUL 6",179196,1180,2,1181,833,744,89,831,2,"SECTORUL 6",,0,,258,573
41,"București",403,"403-SECTORUL 6",179196,1181,2,1525,1157,1071,86,1152,5,"SECTORUL 6",,0,,448,704
41,"București",403,"403-SECTORUL 6",179196,1182,2,1547,1131,1032,99,1128,3,"SECTORUL 6",,0,,371,757
41,"București",403,"403-SECTORUL 6",179196,1183,2,1216,851,775,76,848,3,"SECTORUL 6",,0,,238,610
41,"București",403,"403-SECTORUL 6",179196,1184,2,1114,784,717,67,782,2,"SECTORUL 6",,0,,249,533
41,"București",403,"403-SECTORUL 6",179196,1185,2,1282,921,855,66,915,6,"SECTORUL 6",,0,,415,500
41,"București",403,"403-SECTORUL 6",179196,1186,2,1178,831,766,65,826,5,"SECTORUL 6",,0,,300,526
41,"București",403,"403-SECTORUL 6",179196,1187,2,1529,1088,1019,69,1084,4,"SECTORUL 6",,0,,475,609
41,"București",403,"403-SECTORUL 6",179196,1188,2,1232,912,855,57,912,0,"SECTORUL 6",,0,,380,532
41,"București",403,"403-SECTORUL 6",179196,1189,2,1420,1097,993,104,1097,0,"SECTORUL 6",,0,,377,720
41,"București",403,"403-SECTORUL 6",179196,1190,2,1377,993,907,86,988,5,"SECTORUL 6",,0,,409,579
41,"București",403,"403-SECTORUL 6",179196,1191,2,1469,1072,1006,66,1068,4,"SECTORUL 6",,0,,442,626
41,"București",403,"403-SECTORUL 6",179196,1192,2,1130,826,763,63,822,4,"SECTORUL 6",,0,,313,509
41,"București",403,"403-SECTORUL 6",179196,1193,2,1162,849,785,64,846,3,"SECTORUL 6",,0,,270,576
41,"București",403,"403-SECTORUL 6",179196,1194,2,1053,717,652,65,714,3,"SECTORUL 6",,0,,271,443
41,"București",403,"403-SECTORUL 6",179196,1195,2,1054,801,736,65,794,6,"SECTORUL 6",,0,,240,554
41,"București",403,"403-SECTORUL 6",179196,1196,2,1338,1001,910,91,998,3,"SECTORUL 6",,0,,358,640
41,"București",403,"403-SECTORUL 6",179196,1197,2,1098,803,715,88,798,4,"SECTORUL 6",,0,,262,536
41,"București",403,"403-SECTORUL 6",179196,1198,2,1101,719,651,68,716,3,"SECTORUL 6",,0,,242,474
41,"București",403,"403-SECTORUL 6",179196,1199,2,1135,822,751,71,817,5,"SECTORUL 6",,0,,294,523
41,"București",403,"403-SECTORUL 6",179196,1200,2,1571,1112,971,141,1101,11,"SECTORUL 6",,0,,410,691
41,"București",403,"403-SECTORUL 6",179196,1201,2,1815,1306,1025,281,1287,19,"SECTORUL 6",,0,,529,758
41,"București",403,"403-SECTORUL 6",179196,1202,2,1183,833,677,156,828,5,"SECTORUL 6",,0,,324,504
41,"București",403,"403-SECTORUL 6",179196,1203,2,0,122,0,122,121,1,"SECTORUL 6",,0,,48,73
41,"București",403,"403-SECTORUL 6",179196,1204,2,0,902,0,902,899,3,"SECTORUL 6",,0,,156,743
41,"București",403,"403-SECTORUL 6",179196,1205,2,0,1046,0,1046,1045,1,"SECTORUL 6",,0,,191,854
41,"București",403,"403-SECTORUL 6",179196,1206,2,0,836,0,836,833,3,"SECTORUL 6",,0,,131,702
41,"București",403,"403-SECTORUL 6",179196,1207,2,0,1188,0,1188,1184,4,"SECTORUL 6",,0,,200,984
41,"București",403,"403-SECTORUL 6",179196,1208,2,0,935,0,935,932,3,"SECTORUL 6",,0,,156,776
41,"București",403,"403-SECTORUL 6",179196,1209,2,0,963,0,963,959,4,"SECTORUL 6",,0,,139,820
41,"București",403,"403-SECTORUL 6",179196,1210,2,0,1591,0,1591,1590,1,"SECTORUL 6",,0,,172,1418
41,"București",403,"403-SECTORUL 6",179196,1211,2,0,1007,0,1007,1006,1,"SECTORUL 6",,0,,135,871
41,"București",403,"403-SECTORUL 6",179196,1212,2,0,295,0,295,295,0,"SECTORUL 6",,0,,35,260
41,"București",403,"403-SECTORUL 1",179141,1213,2,0,638,0,638,627,11,"SECTORUL 1",,0,,248,379
41,"București",403,"403-SECTORUL 1",179141,1214,2,0,209,0,209,207,2,"SECTORUL 1",,0,,90,117
41,"București",403,"403-SECTORUL 1",179141,1215,2,1126,1136,695,441,1124,12,"SECTORUL 1",,0,,510,614
41,"București",403,"403-SECTORUL 1",179141,1216,2,451,430,376,54,422,8,"SECTORUL 1",,0,,112,310
41,"București",403,"403-SECTORUL 1",179141,1217,2,0,439,0,439,435,4,"SECTORUL 1",,0,,118,317
41,"București",403,"403-SECTORUL 1",179141,1218,2,2000,1991,1966,25,1971,20,"SECTORUL 1",,0,,816,1155
41,"București",403,"403-SECTORUL 1",179141,1219,2,3150,3128,2961,167,3058,55,"SECTORUL 1",,0,,1637,1421
41,"București",403,"403-SECTORUL 1",179141,1220,2,138,152,134,18,149,3,"SECTORUL 1",,0,,66,83
41,"București",403,"403-SECTORUL 2",179150,1221,2,0,204,0,204,202,2,"SECTORUL 2",,0,,104,98
41,"București",403,"403-SECTORUL 3",179169,1222,2,0,79,0,79,79,0,"SECTORUL 3",,0,,33,46
41,"București",403,"403-SECTORUL 4",179178,1223,2,0,679,0,679,662,17,"SECTORUL 4",,0,,289,373
41,"București",403,"403-SECTORUL 4",179178,1224,2,235,287,229,58,282,5,"SECTORUL 4",,0,,97,185
41,"București",403,"403-SECTORUL 4",179178,1225,2,0,106,0,106,106,0,"SECTORUL 4",,0,,47,59
41,"București",403,"403-SECTORUL 4",179178,1226,2,641,606,589,17,601,5,"SECTORUL 4",,0,,350,251
41,"București",403,"403-SECTORUL 5",179187,1227,2,0,576,0,576,564,12,"SECTORUL 5",,0,,255,309
41,"București",403,"403-SECTORUL 5",179187,1228,2,0,0,0,0,0,0,"SECTORUL 5",,0,,0,0
41,"București",403,"403-SECTORUL 5",179187,1229,2,0,1406,0,1406,1382,24,"SECTORUL 5",,0,,625,757
41,"București",403,"403-SECTORUL 5",179187,1230,2,0,576,0,576,561,15,"SECTORUL 5",,0,,233,328
41,"București",403,"403-SECTORUL 5",179187,1231,2,0,441,0,441,435,6,"SECTORUL 5",,0,,195,240
41,"București",403,"403-SECTORUL 5",179187,1232,2,411,412,403,9,411,1,"SECTORUL 5",,0,,207,204
41,"București",403,"403-SECTORUL 5",179187,1233,2,0,545,0,545,536,9,"SECTORUL 5",,0,,163,373
41,"București",403,"403-SECTORUL 5",179187,1234,2,0,456,0,456,453,3,"SECTORUL 5",,0,,247,206
41,"București",403,"403-SECTORUL 6",179196,1235,2,0,1660,0,1660,1646,14,"SECTORUL 6",,0,,734,912
41,"București",403,"403-SECTORUL 6",179196,1236,2,0,233,0,233,230,3,"SECTORUL 6",,0,,98,132
41,"București",403,"403-SECTORUL 6",179196,1237,2,0,972,0,972,961,11,"SECTORUL 6",,0,,499,462
41,"București",403,"403-SECTORUL 6",179196,1238,2,0,76,0,76,74,2,"SECTORUL 6",,0,,38,36
41,"București",403,"403-SECTORUL 1",179141,1239,2,0,116,0,116,116,0,"SECTORUL 1",,0,,29,87
41,"București",403,"403-SECTORUL 1",179141,1240,2,0,28,0,28,28,0,"SECTORUL 1",,0,,17,11
41,"București",403,"403-SECTORUL 1",179141,1241,2,0,858,0,858,840,18,"SECTORUL 1",,0,,209,631
41,"București",403,"403-SECTORUL 1",179141,1242,2,0,35,0,35,35,0,"SECTORUL 1",,0,,12,23
41,"București",403,"403-SECTORUL 1",179141,1243,2,0,480,0,480,479,1,"SECTORUL 1",,0,,50,429
41,"București",403,"403-SECTORUL 1",179141,1244,2,0,51,0,51,51,0,"SECTORUL 1",,0,,21,30
41,"București",403,"403-SECTORUL 1",179141,1245,2,0,489,0,489,487,2,"SECTORUL 1",,0,,38,449
41,"București",403,"403-SECTORUL 1",179141,1246,2,0,1098,0,1098,1093,5,"SECTORUL 1",,0,,93,1000
41,"București",403,"403-SECTORUL 1",179141,1247,2,0,0,0,0,0,0,"SECTORUL 1",,0,,0,0
41,"București",403,"403-SECTORUL 1",179141,1248,2,0,18,0,18,18,0,"SECTORUL 1",,0,,11,7
41,"București",403,"403-SECTORUL 1",179141,1249,2,0,672,0,672,672,0,"SECTORUL 1",,0,,95,577
41,"București",403,"403-SECTORUL 1",179141,1250,2,0,10,0,10,9,1,"SECTORUL 1",,0,,4,5
41,"București",403,"403-SECTORUL 1",179141,1251,2,0,15,0,15,15,0,"SECTORUL 1",,0,,7,8
41,"București",403,"403-SECTORUL 1",179141,1252,2,0,64,0,64,64,0,"SECTORUL 1",,0,,27,37
41,"București",403,"403-SECTORUL 1",179141,1253,2,0,100,0,100,100,0,"SECTORUL 1",,0,,30,70
41,"București",403,"403-SECTORUL 1",179141,1254,2,0,0,0,0,0,0,"SECTORUL 1",,0,,0,0
41,"București",403,"403-SECTORUL 1",179141,1255,2,0,3239,0,3239,3239,0,"SECTORUL 1",,0,,119,3120
41,"București",403,"403-SECTORUL 1",179141,1256,2,0,215,0,215,215,0,"SECTORUL 1",,0,,41,174
41,"București",403,"403-SECTORUL 1",179141,1257,2,0,52,0,52,52,0,"SECTORUL 1",,0,,12,40
41,"București",403,"403-SECTORUL 1",179141,1258,2,0,166,0,166,165,1,"SECTORUL 1",,0,,81,84
41,"București",403,"403-SECTORUL 1",179141,1259,2,0,434,0,434,430,4,"SECTORUL 1",,0,,74,356
41,"București",403,"403-SECTORUL 1",179141,1260,2,0,45,0,45,45,0,"SECTORUL 1",,0,,20,25
41,"București",403,"403-SECTORUL 1",179141,1261,2,0,47,0,47,46,1,"SECTORUL 1",,0,,11,35
41,"București",403,"403-SECTORUL 1",179141,1262,2,0,9,0,9,9,0,"SECTORUL 1",,0,,6,3
41,"București",403,"403-SECTORUL 1",179141,1263,2,0,20,0,20,20,0,"SECTORUL 1",,0,,4,16
41,"București",403,"403-SECTORUL 1",179141,1264,2,0,27,0,27,27,0,"SECTORUL 1",,0,,13,14
41,"București",403,"403-SECTORUL 1",179141,1265,2,0,19,0,19,19,0,"SECTORUL 1",,0,,10,9
41,"București",403,"403-SECTORUL 1",179141,1266,2,0,150,0,150,150,0,"SECTORUL 1",,0,,26,124
41,"București",403,"403-SECTORUL 1",179141,1267,2,0,33,0,33,33,0,"SECTORUL 1",,0,,10,23
41,"București",403,"403-SECTORUL 1",179141,1268,2,0,123,0,123,123,0,"SECTORUL 1",,0,,61,62
41,"București",403,"403-SECTORUL 1",179141,1269,2,0,669,0,669,664,5,"SECTORUL 1",,0,,83,581
41,"București",403,"403-SECTORUL 1",179141,1270,2,0,132,0,132,132,0,"SECTORUL 1",,0,,25,107
41,"București",403,"403-SECTORUL 1",179141,1271,2,0,7,0,7,7,0,"SECTORUL 1",,0,,7,0
41,"București",403,"403-SECTORUL 1",179141,1272,2,0,31,0,31,31,0,"SECTORUL 1",,0,,12,19
41,"București",403,"403-SECTORUL 1",179141,1273,2,0,103,0,103,103,0,"SECTORUL 1",,0,,24,79
41,"București",403,"403-SECTORUL 1",179141,1274,2,0,2378,0,2378,2364,14,"SECTORUL 1",,0,,247,2117
41,"București",403,"403-SECTORUL 1",179141,1275,2,0,23,0,23,23,0,"SECTORUL 1",,0,,4,19
41,"București",403,"403-SECTORUL 1",179141,1276,2,0,1674,0,1674,1672,2,"SECTORUL 1",,0,,130,1542
41,"București",403,"403-SECTORUL 1",179141,1277,2,0,7,0,7,7,0,"SECTORUL 1",,0,,3,4
41,"București",403,"403-SECTORUL 1",179141,1278,2,0,875,0,875,866,9,"SECTORUL 1",,0,,255,611
41,"București",403,"403-SECTORUL 1",179141,1279,2,0,18,0,18,18,0,"SECTORUL 1",,0,,9,9
41,"București",403,"403-SECTORUL 1",179141,1280,2,0,60,0,60,60,0,"SECTORUL 1",,0,,32,28
41,"București",403,"403-SECTORUL 1",179141,1281,2,0,13,0,13,13,0,"SECTORUL 1",,0,,11,2
41,"București",403,"403-SECTORUL 1",179141,1282,2,0,309,0,309,309,0,"SECTORUL 1",,0,,102,207
41,"București",403,"403-SECTORUL 1",179141,1283,2,0,28,0,28,28,0,"SECTORUL 1",,0,,24,4
41,"București",403,"403-SECTORUL 1",179141,1284,2,0,49,0,49,49,0,"SECTORUL 1",,0,,26,23
41,"București",403,"403-SECTORUL 1",179141,1285,2,0,43,0,43,43,0,"SECTORUL 1",,0,,2,41
41,"București",403,"403-SECTORUL 1",179141,1286,2,0,5899,0,5899,5841,58,"SECTORUL 1",,0,,963,4878
41,"București",403,"403-SECTORUL 1",179141,1287,2,0,1592,0,1592,1582,10,"SECTORUL 1",,0,,180,1402
41,"București",403,"403-SECTORUL 1",179141,1288,2,0,302,0,302,301,1,"SECTORUL 1",,0,,126,175
41,"București",403,"403-SECTORUL 1",179141,1289,2,0,75,0,75,75,0,"SECTORUL 1",,0,,26,49
41,"București",403,"403-SECTORUL 1",179141,1290,2,0,4,0,4,4,0,"SECTORUL 1",,0,,3,1
41,"București",403,"403-SECTORUL 1",179141,1291,2,0,4,0,4,3,1,"SECTORUL 1",,0,,1,2
41,"București",403,"403-SECTORUL 1",179141,1292,2,0,288,0,288,287,1,"SECTORUL 1",,0,,36,251
41,"București",403,"403-SECTORUL 1",179141,1293,2,0,144,0,144,144,0,"SECTORUL 1",,0,,34,110
41,"București",403,"403-SECTORUL 1",179141,1294,2,0,240,0,240,237,3,"SECTORUL 1",,0,,58,179
41,"București",403,"403-SECTORUL 1",179141,1295,2,0,0,0,0,0,0,"SECTORUL 1",,0,,0,0
41,"București",403,"403-SECTORUL 1",179141,1296,2,0,134,0,134,134,0,"SECTORUL 1",,0,,20,114
41,"București",403,"403-SECTORUL 1",179141,1297,2,0,30,0,30,30,0,"SECTORUL 1",,0,,15,15
41,"București",403,"403-SECTORUL 1",179141,1298,2,0,7,0,7,7,0,"SECTORUL 1",,0,,5,2
41,"București",403,"403-SECTORUL 1",179141,1299,2,0,212,0,212,211,1,"SECTORUL 1",,0,,34,177
41,"București",403,"403-SECTORUL 1",179141,1300,2,0,0,0,0,0,0,"SECTORUL 1",,0,,0,0
41,"București",403,"403-SECTORUL 1",179141,1301,2,0,43,0,43,43,0,"SECTORUL 1",,0,,18,25
41,"București",403,"403-SECTORUL 1",179141,1302,2,0,995,0,995,994,1,"SECTORUL 1",,0,,230,764
41,"București",403,"403-SECTORUL 1",179141,1303,2,0,13,0,13,13,0,"SECTORUL 1",,0,,7,6
41,"București",403,"403-SECTORUL 1",179141,1304,2,0,10,0,10,10,0,"SECTORUL 1",,0,,4,6
41,"București",403,"403-SECTORUL 1",179141,1305,2,0,95,0,95,95,0,"SECTORUL 1",,0,,9,86
41,"București",403,"403-SECTORUL 1",179141,1306,2,0,31,0,31,31,0,"SECTORUL 1",,0,,17,14
41,"București",403,"403-SECTORUL 1",179141,1307,2,0,279,0,279,279,0,"SECTORUL 1",,0,,44,235
41,"București",403,"403-SECTORUL 1",179141,1308,2,0,27,0,27,26,1,"SECTORUL 1",,0,,14,12
41,"București",403,"403-SECTORUL 1",179141,1309,2,0,31,0,31,31,0,"SECTORUL 1",,0,,9,22
41,"București",403,"403-SECTORUL 1",179141,1310,2,0,87,0,87,87,0,"SECTORUL 1",,0,,36,51
41,"București",403,"403-SECTORUL 1",179141,1311,2,0,104,0,104,104,0,"SECTORUL 1",,0,,14,90
41,"București",403,"403-SECTORUL 1",179141,1312,2,237,179,179,0,178,1,"SECTORUL 1",,0,,16,162
41,"București",403,"403-SECTORUL 1",179141,1313,2,0,2414,0,2414,2362,52,"SECTORUL 1",,0,,865,1497
41,"București",403,"403-SECTORUL 1",179141,1314,2,0,9162,0,9162,9133,29,"SECTORUL 1",,0,,286,8847
41,"București",403,"403-SECTORUL 1",179141,1315,2,0,25,0,25,25,0,"SECTORUL 1",,0,,6,19
41,"București",403,"403-SECTORUL 1",179141,1316,2,0,15,0,15,15,0,"SECTORUL 1",,0,,3,12
41,"București",403,"403-SECTORUL 1",179141,1317,2,0,190,0,190,190,0,"SECTORUL 1",,0,,62,128
41,"București",403,"403-SECTORUL 1",179141,1318,2,0,27,0,27,27,0,"SECTORUL 1",,0,,11,16
41,"București",403,"403-SECTORUL 1",179141,1319,2,0,60,0,60,60,0,"SECTORUL 1",,0,,17,43
41,"București",403,"403-SECTORUL 1",179141,1320,2,0,232,0,232,231,1,"SECTORUL 1",,0,,51,180
41,"București",403,"403-SECTORUL 1",179141,1321,2,0,4,0,4,4,0,"SECTORUL 1",,0,,1,3
41,"București",403,"403-SECTORUL 1",179141,1322,2,0,21,0,21,21,0,"SECTORUL 1",,0,,11,10
41,"București",403,"403-SECTORUL 1",179141,1323,2,0,135,0,135,135,0,"SECTORUL 1",,0,,28,107
41,"București",403,"403-SECTORUL 1",179141,1324,2,0,71,0,71,71,0,"SECTORUL 1",,0,,25,46
41,"București",403,"403-SECTORUL 1",179141,1325,2,0,7,0,7,7,0,"SECTORUL 1",,0,,4,3
41,"București",403,"403-SECTORUL 1",179141,1326,2,0,42,0,42,42,0,"SECTORUL 1",,0,,18,24
41,"București",403,"403-SECTORUL 1",179141,1327,2,0,694,0,694,686,8,"SECTORUL 1",,0,,307,379
41,"București",403,"403-SECTORUL 1",179141,1328,2,0,150,0,150,150,0,"SECTORUL 1",,0,,67,83
41,"București",403,"403-SECTORUL 1",179141,1329,2,0,1480,0,1480,1455,25,"SECTORUL 1",,0,,522,933
41,"București",403,"403-SECTORUL 1",179141,1330,2,0,3549,0,3549,3543,6,"SECTORUL 1",,0,,123,3420
41,"București",403,"403-SECTORUL 1",179141,1331,2,0,10,0,10,10,0,"SECTORUL 1",,0,,2,8
41,"București",403,"403-SECTORUL 1",179141,1332,2,0,12,0,12,12,0,"SECTORUL 1",,0,,9,3
41,"București",403,"403-SECTORUL 1",179141,1333,2,0,38,0,38,38,0,"SECTORUL 1",,0,,12,26
41,"București",403,"403-SECTORUL 1",179141,1334,2,0,0,0,0,0,0,"SECTORUL 1",,0,,0,0
41,"București",403,"403-SECTORUL 1",179141,1335,2,0,60,0,60,59,1,"SECTORUL 1",,0,,3,56
41,"București",403,"403-SECTORUL 1",179141,1336,2,0,14,0,14,14,0,"SECTORUL 1",,0,,0,14
41,"București",403,"403-SECTORUL 1",179141,1337,2,0,13,0,13,13,0,"SECTORUL 1",,0,,5,8
41,"București",403,"403-SECTORUL 1",179141,1338,2,0,16,0,16,16,0,"SECTORUL 1",,0,,9,7
42,"Ilfov",234,"234-ORAS BUFTEA",100576,1,2,1488,933,869,64,924,9,"ORAS BUFTEA",,5,,375,549
42,"Ilfov",234,"234-ORAS BUFTEA",100576,2,2,1673,1029,982,47,1020,9,"ORAS BUFTEA",,5,,463,557
42,"Ilfov",234,"234-ORAS BUFTEA",100576,3,2,1663,1146,1004,142,1130,16,"ORAS BUFTEA",,5,,445,685
42,"Ilfov",234,"234-ORAS BUFTEA",100576,4,2,2377,1424,1302,122,1411,13,"ORAS BUFTEA",,5,,550,861
42,"Ilfov",234,"234-ORAS BUFTEA",100576,5,2,1746,1033,959,74,1030,3,"ORAS BUFTEA",,5,,332,698
42,"Ilfov",234,"234-ORAS BUFTEA",100576,6,2,1796,1182,1121,61,1175,7,"ORAS BUFTEA",,5,,493,682
42,"Ilfov",234,"234-ORAS BUFTEA",100576,7,2,1440,1022,895,127,1015,7,"ORAS BUFTEA",,5,,366,649
42,"Ilfov",234,"234-ORAS BUFTEA",100576,8,2,1462,814,719,95,801,13,"ORAS BUFTEA",,5,,251,550
42,"Ilfov",234,"234-ORAS BUFTEA",100576,9,2,1195,709,666,43,706,3,"ORAS BUFTEA",,5,,253,453
42,"Ilfov",234,"234-ORAS BUFTEA",100576,10,2,1574,970,904,66,964,6,"ORAS BUFTEA",,5,,418,546
42,"Ilfov",234,"234-AFUMATI",100834,11,2,1549,996,837,159,982,14,"AFUMATI",,5,,349,633
42,"Ilfov",234,"234-AFUMATI",100834,12,2,1441,814,681,133,807,7,"AFUMATI",,5,,325,482
42,"Ilfov",234,"234-AFUMATI",100834,13,2,2010,875,726,149,871,4,"AFUMATI",,5,,238,633
42,"Ilfov",234,"234-BALOTESTI",100969,14,2,2115,1538,1221,317,1530,8,"BALOTESTI",,5,,614,916
42,"Ilfov",234,"234-BALOTESTI",100969,15,2,1266,874,732,142,863,11,"BALOTESTI",,5,,433,430
42,"Ilfov",234,"234-BALOTESTI",100969,16,2,722,659,440,219,648,11,"BALOTESTI",,5,,316,332
42,"Ilfov",234,"234-BERCENI",101145,17,2,1782,1217,1055,162,1180,37,"BERCENI",,5,,481,699
42,"Ilfov",234,"234-BERCENI",101145,18,2,1465,863,730,133,846,17,"BERCENI",,5,,371,475
42,"Ilfov",234,"234-BRAGADIRU",179230,19,2,1507,876,718,158,866,10,"BRAGADIRU",,5,,396,470
42,"Ilfov",234,"234-BRAGADIRU",179230,20,2,1941,1341,1150,191,1327,14,"BRAGADIRU",,5,,475,852
42,"Ilfov",234,"234-BRAGADIRU",179230,21,2,1758,1057,932,125,1046,11,"BRAGADIRU",,5,,407,639
42,"Ilfov",234,"234-BRANESTI",101298,22,2,1382,851,711,140,844,7,"BRANESTI",,5,,306,538
42,"Ilfov",234,"234-BRANESTI",101298,23,2,2018,1496,1219,277,1478,18,"BRANESTI",,5,,673,805
42,"Ilfov",234,"234-BRANESTI",101298,24,2,2172,1391,1209,182,1366,25,"BRANESTI",,5,,573,793
42,"Ilfov",234,"234-BRANESTI",101298,25,2,1049,844,765,79,834,10,"BRANESTI",,5,,457,377
42,"Ilfov",234,"234-CERNICA",101742,26,2,1587,1144,1051,93,1123,21,"CERNICA",,5,,510,613
42,"Ilfov",234,"234-CERNICA",101742,27,2,1650,1185,994,191,1172,13,"CERNICA",,5,,677,495
42,"Ilfov",234,"234-CERNICA",101742,28,2,1700,1178,962,216,1164,14,"CERNICA",,5,,548,616
42,"Ilfov",234,"234-CERNICA",101742,29,2,815,606,508,98,600,6,"CERNICA",,5,,327,273
42,"Ilfov",234,"234-CHIAJNA",179249,30,2,1950,1302,1211,91,1286,16,"CHIAJNA",,5,,508,778
42,"Ilfov",234,"234-CHIAJNA",179249,31,2,1745,1198,1077,121,1179,19,"CHIAJNA",,5,,488,691
42,"Ilfov",234,"234-CHIAJNA",179249,32,2,1023,740,660,80,735,5,"CHIAJNA",,5,,299,436
42,"Ilfov",234,"234-CHIAJNA",179249,33,2,1096,866,762,104,859,7,"CHIAJNA",,5,,395,464
42,"Ilfov",234,"234-CHITILA",179294,34,2,2271,1760,1416,344,1742,18,"CHITILA",,5,,718,1024
42,"Ilfov",234,"234-CHITILA",179294,35,2,1860,1403,1183,220,1394,9,"CHITILA",,5,,643,751
42,"Ilfov",234,"234-CHITILA",179294,36,2,2052,1438,1198,240,1415,23,"CHITILA",,5,,496,919
42,"Ilfov",234,"234-CHITILA",179294,37,2,1644,1268,991,277,1259,9,"CHITILA",,5,,550,709
42,"Ilfov",234,"234-CHITILA",179294,38,2,820,575,421,154,560,15,"CHITILA",,5,,215,345
42,"Ilfov",234,"234-CIOLPANI",101902,39,2,1580,1166,985,181,1149,17,"CIOLPANI",,5,,536,613
42,"Ilfov",234,"234-CIOLPANI",101902,40,2,666,553,495,58,545,8,"CIOLPANI",,5,,317,228
42,"Ilfov",234,"234-CIOLPANI",101902,41,2,431,361,263,98,356,5,"CIOLPANI",,5,,160,196
42,"Ilfov",234,"234-CIOLPANI",101902,42,2,715,580,451,129,572,8,"CIOLPANI",,5,,251,321
42,"Ilfov",234,"234-CIOROGARLA",101957,43,2,830,698,565,133,693,5,"CIOROGARLA",,5,,407,286
42,"Ilfov",234,"234-CIOROGARLA",101957,44,2,1041,857,692,165,852,5,"CIOROGARLA",,5,,472,380
42,"Ilfov",234,"234-CIOROGARLA",101957,45,2,884,773,529,244,759,14,"CIOROGARLA",,5,,424,335
42,"Ilfov",234,"234-CLINCENI",102035,46,2,1055,776,664,112,762,14,"CLINCENI",,5,,340,422
42,"Ilfov",234,"234-CLINCENI",102035,47,2,1616,1084,927,157,1075,9,"CLINCENI",,5,,550,525
42,"Ilfov",234,"234-CLINCENI",102035,48,2,729,524,422,102,520,4,"CLINCENI",,5,,196,324
42,"Ilfov",234,"234-CORBEANCA",102160,49,2,1123,761,605,156,752,9,"CORBEANCA",,5,,412,340
42,"Ilfov",234,"234-CORBEANCA",102160,50,2,1234,828,672,156,804,24,"CORBEANCA",,5,,376,428
42,"Ilfov",234,"234-CORNETU",102213,51,2,1713,1177,1064,113,1158,19,"CORNETU",,5,,538,620
42,"Ilfov",234,"234-CORNETU",102213,52,2,1275,854,754,100,848,6,"CORNETU",,5,,380,468
42,"Ilfov",234,"234-DASCALU",102473,53,2,1389,954,809,145,926,28,"DASCALU",,5,,517,409
42,"Ilfov",234,"234-DASCALU",102473,54,2,432,298,245,53,293,5,"DASCALU",,5,,176,117
42,"Ilfov",234,"234-DARASTI - ILFOV",102525,55,2,1065,711,631,80,698,13,"DARASTI - ILFOV",,5,,308,390
42,"Ilfov",234,"234-DARASTI - ILFOV",102525,56,2,1216,817,735,82,800,17,"DARASTI - ILFOV",,5,,444,356
42,"Ilfov",234,"234-DOBROESTI",179310,57,2,1225,1048,909,139,1033,15,"DOBROESTI",,5,,417,616
42,"Ilfov",234,"234-DOBROESTI",179310,58,2,1376,849,705,144,842,7,"DOBROESTI",,5,,359,483
42,"Ilfov",234,"234-DOBROESTI",179310,59,2,2135,1456,1240,216,1437,19,"DOBROESTI",,5,,630,807
42,"Ilfov",234,"234-DOMNESTI",102570,60,2,2010,1219,999,220,1209,10,"DOMNESTI",,5,,593,616
42,"Ilfov",234,"234-DOMNESTI",102570,61,2,1919,1167,967,200,1149,18,"DOMNESTI",,5,,573,576
42,"Ilfov",234,"234-DOMNESTI",102570,62,2,348,223,167,56,219,4,"DOMNESTI",,5,,123,96
42,"Ilfov",234,"234-DRAGOMIRESTI-VALE",102605,63,2,719,550,437,113,537,13,"DRAGOMIRESTI-VALE",,5,,249,288
42,"Ilfov",234,"234-DRAGOMIRESTI-VALE",102605,64,2,1562,1169,1000,169,1157,12,"DRAGOMIRESTI-VALE",,5,,580,577
42,"Ilfov",234,"234-DRAGOMIRESTI-VALE",102605,65,2,531,482,376,106,478,4,"DRAGOMIRESTI-VALE",,5,,235,243
42,"Ilfov",234,"234-GANEASA",103130,66,2,476,303,267,36,300,3,"GANEASA",,5,,144,156
42,"Ilfov",234,"234-GANEASA",103130,67,2,460,339,277,62,337,2,"GANEASA",,5,,149,188
42,"Ilfov",234,"234-GANEASA",103130,68,2,476,300,263,37,297,3,"GANEASA",,5,,115,182
42,"Ilfov",234,"234-GANEASA",103130,69,2,637,408,356,52,400,8,"GANEASA",,5,,166,234
42,"Ilfov",234,"234-GANEASA",103130,70,2,898,724,630,94,718,6,"GANEASA",,5,,190,528
42,"Ilfov",234,"234-GLINA",179347,71,2,1711,1152,959,193,1129,23,"GLINA",,5,,475,654
42,"Ilfov",234,"234-GLINA",179347,72,2,1047,738,581,157,727,11,"GLINA",,5,,215,512
42,"Ilfov",234,"234-GLINA",179347,73,2,1657,1394,1078,316,1376,18,"GLINA",,5,,535,841
42,"Ilfov",234,"234-GRADISTEA",103443,74,2,1312,1102,947,155,1085,17,"GRADISTEA",,5,,710,375
42,"Ilfov",234,"234-GRADISTEA",103443,75,2,673,687,581,106,673,14,"GRADISTEA",,5,,414,259
42,"Ilfov",234,"234-GRUIU",103513,76,2,1556,1034,888,146,1017,17,"GRUIU",,5,,565,452
42,"Ilfov",234,"234-GRUIU",103513,77,2,1687,1155,1012,143,1131,24,"GRUIU",,5,,697,434
42,"Ilfov",234,"234-GRUIU",103513,78,2,1903,1227,1057,170,1209,18,"GRUIU",,5,,581,628
42,"Ilfov",234,"234-GRUIU",103513,79,2,469,322,267,55,319,3,"GRUIU",,5,,229,90
42,"Ilfov",234,"234-JILAVA",179383,80,2,1651,2005,923,1082,1974,31,"JILAVA",,5,,626,1348
42,"Ilfov",234,"234-JILAVA",179383,81,2,1290,1701,789,912,1690,11,"JILAVA",,5,,458,1232
42,"Ilfov",234,"234-JILAVA",179383,82,2,1657,1815,986,829,1787,28,"JILAVA",,5,,581,1206
42,"Ilfov",234,"234-JILAVA",179383,83,2,1808,2152,998,1154,2122,30,"JILAVA",,5,,563,1559
42,"Ilfov",234,"234-MAGURELE",179418,84,2,1582,1116,907,209,1103,13,"MAGURELE",,5,,499,604
42,"Ilfov",234,"234-MAGURELE",179418,85,2,1552,1124,1049,75,1116,8,"MAGURELE",,5,,390,726
42,"Ilfov",234,"234-MAGURELE",179418,86,2,1328,927,826,101,911,16,"MAGURELE",,5,,404,507
42,"Ilfov",234,"234-MAGURELE",179418,87,2,688,488,441,47,476,12,"MAGURELE",,5,,312,164
42,"Ilfov",234,"234-MAGURELE",179418,88,2,936,564,514,50,550,14,"MAGURELE",,5,,241,309
42,"Ilfov",234,"234-MAGURELE",179418,89,2,0,495,0,495,492,3,"MAGURELE",,5,,99,393
42,"Ilfov",234,"234-MOARA VLASIEI",104243,90,2,1076,845,673,172,820,25,"MOARA VLASIEI",,5,,427,393
42,"Ilfov",234,"234-MOARA VLASIEI",104243,91,2,1738,1106,996,110,1090,16,"MOARA VLASIEI",,5,,656,434
42,"Ilfov",234,"234-MOARA VLASIEI",104243,92,2,1105,784,668,116,774,9,"MOARA VLASIEI",,5,,402,372
42,"Ilfov",234,"234-MOGOSOAIA",179463,93,2,1989,1405,1203,202,1385,20,"MOGOSOAIA",,5,,481,904
42,"Ilfov",234,"234-MOGOSOAIA",179463,94,2,1696,1289,1098,191,1271,18,"MOGOSOAIA",,5,,489,782
42,"Ilfov",234,"234-NUCI",104421,95,2,1390,1208,1042,166,1188,20,"NUCI",,5,,693,495
42,"Ilfov",234,"234-NUCI",104421,96,2,1023,837,732,105,828,9,"NUCI",,5,,534,294
42,"Ilfov",234,"234-OTOPENI",179490,97,2,825,647,489,158,639,7,"OTOPENI",,5,,331,308
42,"Ilfov",234,"234-OTOPENI",179490,98,2,1353,928,796,132,918,10,"OTOPENI",,5,,352,566
42,"Ilfov",234,"234-OTOPENI",179490,99,2,1804,1223,1011,212,1210,13,"OTOPENI",,5,,471,739
42,"Ilfov",234,"234-OTOPENI",179490,100,2,1270,917,759,158,909,8,"OTOPENI",,5,,350,559
42,"Ilfov",234,"234-OTOPENI",179490,101,2,964,692,610,82,680,12,"OTOPENI",,5,,254,426
42,"Ilfov",234,"234-OTOPENI",179490,102,2,783,507,406,101,498,9,"OTOPENI",,5,,223,275
42,"Ilfov",234,"234-OTOPENI",179490,103,2,441,497,260,237,494,3,"OTOPENI",,5,,208,286
42,"Ilfov",234,"234-OTOPENI",179490,104,2,0,751,0,751,749,2,"OTOPENI",,5,,195,554
42,"Ilfov",234,"234-PANTELIMON",179524,105,2,1434,1027,802,225,1012,15,"PANTELIMON",,5,,490,522
42,"Ilfov",234,"234-PANTELIMON",179524,106,2,1553,1021,953,68,1011,9,"PANTELIMON",,5,,467,544
42,"Ilfov",234,"234-PANTELIMON",179524,107,2,340,235,158,77,233,2,"PANTELIMON",,5,,114,119
42,"Ilfov",234,"234-PANTELIMON",179524,108,2,1203,912,726,186,908,4,"PANTELIMON",,5,,385,523
42,"Ilfov",234,"234-PANTELIMON",179524,109,2,1181,946,707,239,942,4,"PANTELIMON",,5,,450,492
42,"Ilfov",234,"234-PANTELIMON",179524,110,2,1240,877,689,188,872,5,"PANTELIMON",,5,,377,495
42,"Ilfov",234,"234-PANTELIMON",179524,111,2,1846,1174,955,219,1157,17,"PANTELIMON",,5,,585,572
42,"Ilfov",234,"234-PANTELIMON",179524,112,2,1740,1164,947,217,1151,13,"PANTELIMON",,5,,537,614
42,"Ilfov",234,"234-PANTELIMON",179524,113,2,18,85,13,72,83,2,"PANTELIMON",,5,,14,69
42,"Ilfov",234,"234-PERIS",104546,114,2,1523,1130,902,228,1118,12,"PERIS",,5,,572,546
42,"Ilfov",234,"234-PERIS",104546,115,2,1756,1073,724,349,1063,10,"PERIS",,5,,501,562
42,"Ilfov",234,"234-PERIS",104546,116,2,543,413,333,80,411,2,"PERIS",,5,,166,245
42,"Ilfov",234,"234-PERIS",104546,117,2,254,288,173,115,288,0,"PERIS",,5,,122,166
42,"Ilfov",234,"234-PERIS",104546,118,2,1293,733,522,211,722,11,"PERIS",,5,,397,325
42,"Ilfov",234,"234-PETRACHIOAIA",104582,119,2,1913,1017,894,123,998,19,"PETRACHIOAIA",,5,,447,551
42,"Ilfov",234,"234-POPESTI LEORDENI",179533,120,2,1577,1258,1073,185,1251,7,"POPESTI LEORDENI",,5,,307,944
42,"Ilfov",234,"234-POPESTI LEORDENI",179533,121,2,1352,1094,905,189,1083,11,"POPESTI LEORDENI",,5,,277,806
42,"Ilfov",234,"234-POPESTI LEORDENI",179533,122,2,1073,723,688,35,715,8,"POPESTI LEORDENI",,5,,205,510
42,"Ilfov",234,"234-POPESTI LEORDENI",179533,123,2,931,912,696,216,908,4,"POPESTI LEORDENI",,5,,219,689
42,"Ilfov",234,"234-POPESTI LEORDENI",179533,124,2,2033,1619,1492,127,1589,30,"POPESTI LEORDENI",,5,,617,972
42,"Ilfov",234,"234-POPESTI LEORDENI",179533,125,2,983,1079,514,565,1069,10,"POPESTI LEORDENI",,5,,463,606
42,"Ilfov",234,"234-POPESTI LEORDENI",179533,126,2,1727,1266,1054,212,1253,13,"POPESTI LEORDENI",,5,,515,738
42,"Ilfov",234,"234-SNAGOV",105160,127,2,1273,884,633,251,872,12,"SNAGOV",,5,,319,553
42,"Ilfov",234,"234-SNAGOV",105160,128,2,1386,1016,708,308,1005,11,"SNAGOV",,5,,445,560
42,"Ilfov",234,"234-SNAGOV",105160,129,2,722,573,422,151,571,2,"SNAGOV",,5,,241,330
42,"Ilfov",234,"234-SNAGOV",105160,130,2,941,742,488,254,724,18,"SNAGOV",,5,,311,413
42,"Ilfov",234,"234-STEFANESTII DE JOS",105419,131,2,1623,1015,823,192,998,17,"STEFANESTII DE JOS",,5,,390,608
42,"Ilfov",234,"234-STEFANESTII DE JOS",105419,132,2,1300,845,668,177,831,14,"STEFANESTII DE JOS",,5,,435,396
42,"Ilfov",234,"234-TUNARI",105570,133,2,1092,884,716,168,870,14,"TUNARI",,5,,365,505
42,"Ilfov",234,"234-TUNARI",105570,134,2,1213,833,679,154,822,11,"TUNARI",,5,,294,528
42,"Ilfov",234,"234-VIDRA",105936,135,2,1222,828,721,107,822,6,"VIDRA",,5,,327,495
42,"Ilfov",234,"234-VIDRA",105936,136,2,1536,940,840,100,923,17,"VIDRA",,5,,369,554
42,"Ilfov",234,"234-VIDRA",105936,137,2,1397,795,666,129,782,13,"VIDRA",,5,,308,474
42,"Ilfov",234,"234-VIDRA",105936,138,2,654,412,341,71,405,7,"VIDRA",,5,,170,235
42,"Ilfov",234,"234-VIDRA",105936,139,2,1556,970,756,214,951,19,"VIDRA",,5,,415,536
42,"Ilfov",234,"234-VOLUNTARI",179560,140,2,1278,911,807,104,909,2,"VOLUNTARI",,5,,389,520
42,"Ilfov",234,"234-VOLUNTARI",179560,141,2,1208,826,736,90,819,7,"VOLUNTARI",,5,,338,481
42,"Ilfov",234,"234-VOLUNTARI",179560,142,2,1190,820,740,80,808,12,"VOLUNTARI",,5,,341,467
42,"Ilfov",234,"234-VOLUNTARI",179560,143,2,1222,921,818,103,916,5,"VOLUNTARI",,5,,424,492
42,"Ilfov",234,"234-VOLUNTARI",179560,144,2,1128,757,677,80,748,9,"VOLUNTARI",,5,,314,434
42,"Ilfov",234,"234-VOLUNTARI",179560,145,2,1229,843,728,115,833,10,"VOLUNTARI",,5,,379,454
42,"Ilfov",234,"234-VOLUNTARI",179560,146,2,1356,928,872,56,914,14,"VOLUNTARI",,5,,432,482
42,"Ilfov",234,"234-VOLUNTARI",179560,147,2,1564,1092,999,93,1084,8,"VOLUNTARI",,5,,416,668
42,"Ilfov",234,"234-VOLUNTARI",179560,148,2,1278,987,840,147,957,30,"VOLUNTARI",,5,,376,581
42,"Ilfov",234,"234-VOLUNTARI",179560,149,2,1235,899,816,83,898,0,"VOLUNTARI",,5,,371,527
42,"Ilfov",234,"234-VOLUNTARI",179560,150,2,1341,948,830,118,938,10,"VOLUNTARI",,5,,415,523
42,"Ilfov",234,"234-VOLUNTARI",179560,151,2,1143,828,707,121,823,5,"VOLUNTARI",,5,,349,474
42,"Ilfov",234,"234-VOLUNTARI",179560,152,2,1440,921,860,61,918,3,"VOLUNTARI",,5,,403,515
42,"Ilfov",234,"234-VOLUNTARI",179560,153,2,1321,948,812,136,935,13,"VOLUNTARI",,5,,486,449
42,"Ilfov",234,"234-VOLUNTARI",179560,154,2,1382,936,809,127,926,10,"VOLUNTARI",,5,,331,595
42,"Ilfov",234,"234-VOLUNTARI",179560,155,2,1181,929,793,136,923,6,"VOLUNTARI",,5,,300,623
42,"Ilfov",234,"234-1 DECEMBRIE",102543,156,2,2365,1490,1307,183,1476,14,"1 DECEMBRIE",,5,,542,934
42,"Ilfov",234,"234-1 DECEMBRIE",102543,157,2,1813,1149,1021,128,1142,7,"1 DECEMBRIE",,5,,521,621
42,"Ilfov",234,"234-1 DECEMBRIE",102543,158,2,1259,994,906,88,979,15,"1 DECEMBRIE",,5,,424,555
42,"Ilfov",234,"234-1 DECEMBRIE",102543,159,2,1042,721,670,51,709,12,"1 DECEMBRIE",,5,,385,324
42,"Ilfov",234,"234-CHITILA",179294,160,2,0,586,0,586,581,5,"CHITILA",,5,,267,314
42,"Ilfov",234,"234-CIOLPANI",101902,161,2,0,255,0,255,250,5,"CIOLPANI",,5,,107,143
42,"Ilfov",234,"234-CLINCENI",102035,162,2,0,366,0,366,357,9,"CLINCENI",,5,,99,258
42,"Ilfov",234,"234-DOMNESTI",102570,163,2,0,117,0,117,113,4,"DOMNESTI",,5,,50,63
42,"Ilfov",234,"234-OTOPENI",179490,164,2,0,297,0,297,293,4,"OTOPENI",,5,,111,182
42,"Ilfov",234,"234-OTOPENI",179490,165,2,0,368,0,368,351,17,"OTOPENI",,5,,154,197
42,"Ilfov",234,"234-PANTELIMON",179524,166,2,0,269,0,269,261,8,"PANTELIMON",,5,,133,128
42,"Ilfov",234,"234-PANTELIMON",179524,167,2,0,356,0,356,354,2,"PANTELIMON",,5,,96,258
42,"Ilfov",234,"234-PANTELIMON",179524,168,2,0,467,0,467,462,5,"PANTELIMON",,5,,194,268
42,"Ilfov",234,"234-TUNARI",105570,169,2,0,232,0,232,229,3,"TUNARI",,5,,95,134
42,"Ilfov",234,"234-CHIAJNA",179249,170,2,0,1510,0,1510,1476,34,"CHIAJNA",,5,,757,719
42,"Ilfov",234,"234-MAGURELE",179418,171,2,0,585,0,585,571,14,"MAGURELE",,5,,260,311
42,"Ilfov",234,"234-BRANESTI",101298,172,2,0,75,0,75,75,0,"BRANESTI",,5,,46,29
42,"Ilfov",234,"234-OTOPENI",179490,173,2,0,420,0,420,413,7,"OTOPENI",,5,,192,221
