"NCE","JUDET","SIRUTA","CountyId","LocalityId","CountryId","DENLOC","SV","ADRESA","A","B","B1","B2","B3","C","D","E","F","P1","P2","MEDIU","SORTARE","SPEC"
1,"Alba",1017,10,1017,,"MUNICIPIUL ALBA IULIA",1,"Gradinita nr. 3, Str. Marasesti nr. 55 Tel:0258835164",1419,928,919,9,0,919,9,1600,672,493,426,1,2,0
1,"Alba",1017,10,1017,,"MUNICIPIUL ALBA IULIA",2,"Scoala cu clasele I-VIII(nr.1) Vasile Goldis ,Str. Calarasi (N. Filipescu),  nr. 2   Sala IIIA Tel:0258811737",1188,725,708,16,1,716,9,1300,575,412,304,1,2,0
1,"Alba",1017,10,1017,,"MUNICIPIUL ALBA IULIA",3,"Scoala cu clasele I-VIII(nr. 3) Avram Iancu Str. Moldovei, nr. 2  Sala 5C Tel:258811548",1401,901,878,8,15,886,15,1553,652,491,395,1,2,0
1,"Alba",1017,10,1017,,"MUNICIPIUL ALBA IULIA",4,"Scoala cu clasele I-VIII(nr.1) Vasile Goldis Str. Calarasi (N. Filipescu),  nr. 2  Sala IIIDTel:258811737",1527,940,923,17,0,934,6,1701,761,482,452,1,2,0
1,"Alba",1017,10,1017,,"MUNICIPIUL ALBA IULIA",5,"Casa de Cultura a Studentilor Str. Ardealului nr. 1 Sala de dans Tel:0285812692",748,491,479,12,0,488,3,830,339,230,258,1,2,0
1,"Alba",1017,10,1017,,"MUNICIPIUL ALBA IULIA",6,"Scoala cu clasele I-VIII (nr. 3) Avram Iancu Str. Moldovei, nr. 2  Sala 26 Tel:258811548",900,577,564,12,1,571,6,1001,424,325,246,1,2,0
1,"Alba",1017,10,1017,,"MUNICIPIUL ALBA IULIA",7,"Colegiul Economic Dionisie Pop Martian  Str. Octavian Goga  (B-dul incoronarii), nr. 11 Tel:0258811161
",1163,821,799,22,0,810,11,1302,481,465,345,1,2,0
1,"Alba",1017,10,1017,,"MUNICIPIUL ALBA IULIA",8,"Colegiul  National Horea, Closca si Crisan B-dul 1 Decembrie 1918, nr. 11 Sala 8 Tel:0258835164",1242,734,725,8,1,723,11,1353,619,325,398,1,2,0
1,"Alba",1017,10,1017,,"MUNICIPIUL ALBA IULIA",9,"Colegiul  National Horea, Closca si Crisan B-dul 1 Decembrie 1918, nr. 11 Sala 10 Tel:0258835164",1551,969,943,25,1,959,10,1710,741,500,459,1,2,0
1,"Alba",1017,10,1017,,"MUNICIPIUL ALBA IULIA",10,"Colegiul  National Horea, Closca si Crisan B-dul 1 Decembrie 1918, nr. 11 Sala 11 Tel:0258835164",1631,893,872,21,0,882,11,1800,907,523,359,1,2,0
1,"Alba",1017,10,1017,,"MUNICIPIUL ALBA IULIA",11,"Colegiul tehnic Apulum (Scoala cu clasele I-VIII nr. 2 ) Str. Gh. Pop de Basesti, nr. 2 , sala 10Tel:0258830271",1337,631,622,9,0,623,8,1504,873,417,206,1,2,0
1,"Alba",1017,10,1017,,"MUNICIPIUL ALBA IULIA",12,"Colegiul  National Horea, Closca si Crisan B-dul 1 Decembrie 1918, nr. 11 Sala 12 Tel:0258835164",1109,516,507,9,0,514,2,1218,702,354,160,1,2,0
1,"Alba",1017,10,1017,,"MUNICIPIUL ALBA IULIA",13,"Colegiul tehnic Apulum (Scoala cu clasele I-VIII nr. 2 ) Str. Gh. Pop de Basesti, nr. 2, sala 11 Tel:0258830271",1156,634,617,17,0,629,5,1300,666,413,216,1,2,0
1,"Alba",1017,10,1017,,"MUNICIPIUL ALBA IULIA",14,"Gradinita nr. 9  Str. Vasile Goldis, nr. 7  Sala grupa mica Tel:258835031",1540,786,765,21,0,774,12,1706,920,519,255,1,2,0
1,"Alba",1017,10,1017,,"MUNICIPIUL ALBA IULIA",15,"Colegiul tehnic Apulum (Scoala cu clasele I-VIII nr. 2 ) Str. Gh. Pop de Basesti, nr. 2, sala 5 Tel:0258830271",1237,617,613,3,1,611,6,1360,743,378,233,1,2,0
1,"Alba",1017,10,1017,,"MUNICIPIUL ALBA IULIA",16,"Cinematograful Dacia  B-dul Transilvaniei nr.25A              holul cinematografului Tel:258821656",1669,925,914,11,0,920,5,1847,922,562,358,1,2,0
1,"Alba",1017,10,1017,,"MUNICIPIUL ALBA IULIA",17,"Scoala cu clasele I-VIII (nr. 6) Ion Agarbiceanu Str. Vasile Goldis, nr. 14  Sala 4 Tel:258821875",1052,620,609,11,0,609,11,1160,540,351,258,1,2,0
1,"Alba",1017,10,1017,,"MUNICIPIUL ALBA IULIA",18,"Scoala cu clasele I-VIII (nr. 6) Ion Agarbiceanu Str. Vasile Goldis, nr. 14  Sala 3 Tel:258821875",1016,632,616,15,1,621,11,1100,468,314,307,1,2,0
1,"Alba",1017,10,1017,,"MUNICIPIUL ALBA IULIA",19,"Gradinita nr. 11 Str. Vasile Goldis, nr. 14B   Sala grupa mare Tel:258834395",1468,746,729,14,3,738,8,1601,855,459,279,1,2,0
1,"Alba",1017,10,1017,,"MUNICIPIUL ALBA IULIA",20,"Gradinita nr. 12  Str. Stefan cel Mare (Mesteacanului), nr. 11 Sala grupa stelute Tel:0258821303",1234,719,702,17,0,710,9,1363,644,402,308,1,2,0
1,"Alba",1017,10,1017,,"MUNICIPIUL ALBA IULIA",21,"Gradinita nr. 12  Str. Stefan cel Mare (Mesteacanului), nr. 11 Sala sedinte, Tel:0258821303",1200,768,753,15,0,762,6,1309,541,430,332,1,2,0
1,"Alba",1017,10,1017,,"MUNICIPIUL ALBA IULIA",22,"Scoala cu clasele I-VIII (nr.7) Mihai Eminescu Str. Toporasilor (Petru Rares), nr. 18 ,sala 14Tel:258835093",1360,843,826,16,1,831,12,1500,657,537,294,1,2,0
1,"Alba",1017,10,1017,,"MUNICIPIUL ALBA IULIA",23,"Scoala cu clasele I-VIII (nr. 7) Mihai Eminescu Str. Toporasilor (Petru Rares),  nr. 18 , sala15,Tel:258835093",1667,986,968,18,0,980,6,1800,814,591,389,1,2,0
1,"Alba",1017,10,1017,,"MUNICIPIUL ALBA IULIA",24,"Gradinita nr. 13 Str. Energiei (Maresal Ion Antonescu), nr. 1  Sala Bobocilor Tel:258820057",1141,695,682,13,0,691,4,1260,565,428,263,1,2,0
1,"Alba",1017,10,1017,,"MUNICIPIUL ALBA IULIA",25,"Gradinita nr. 13 Str. Energiei (Maresal Ion Antonescu), nr. 1 Sala Fluturilor Tel:258820057",1383,817,803,14,0,811,6,1502,685,503,308,1,2,0
1,"Alba",1017,10,1017,,"MUNICIPIUL ALBA IULIA",26,"Liceul Sportiv  Str. Stefan cel Mare (Mesteacanului), nr. 25 Sala 2 Tel:258835346",1686,973,963,10,0,960,13,1800,827,588,372,1,2,0
1,"Alba",1017,10,1017,,"MUNICIPIUL ALBA IULIA",27,"Bazin Olimpic B-dul Republicii(Victoriei), nr. 3  Hol Tel:258835947",1477,860,850,10,0,851,9,1603,743,526,325,1,2,0
1,"Alba",1017,10,1017,,"MUNICIPIUL ALBA IULIA",28,"Liceul Sportiv Str. Stefan cel Mare (Mesteacanului), nr. 25Sala 3 Tel:258835346",1248,700,690,10,0,690,10,1401,701,402,288,1,2,0
1,"Alba",1017,10,1017,,"MUNICIPIUL ALBA IULIA",29,"Liceul Sportiv Str. Stefan cel Mare (Mesteacanului), nr. 25Sala 4 Tel:258835346",1552,931,922,9,0,924,7,1699,768,551,373,1,2,0
1,"Alba",1017,10,1017,,"MUNICIPIUL ALBA IULIA",30,"Liceul Sportiv Str. Stefan cel Mare (Mesteacanului), nr. 25Sala 5 Tel:258835346",1563,977,966,11,0,972,5,1699,722,555,417,1,2,0
1,"Alba",1017,10,1017,,"MUNICIPIUL ALBA IULIA",31,"Club Sportiv Unirea Str. Septimius Severus nr.53 Birou Director Tel:258819086",1540,896,885,11,0,886,10,1700,804,545,341,1,2,0
1,"Alba",1017,10,1017,,"MUNICIPIUL ALBA IULIA",32,"S. C. Apa Canal B-dul Republicii (Victoriei), nr.70 Hol Tel:258816403",1626,906,892,12,2,892,14,1784,878,578,314,1,2,0
1,"Alba",1017,10,1017,,"MUNICIPIUL ALBA IULIA",33,"AUTOSOF S.R.L.(in sediul FLIPS) Str. Gheorghe Sincai(Muncii), nr. 2A Sala cursuri Tel:",1380,755,741,14,0,748,7,1500,745,467,281,1,2,0
1,"Alba",1017,10,1017,,"MUNICIPIUL ALBA IULIA",34,"Bazin Olimpic B-dul Republicii(Victoriei), nr. 3  Hol Tel:258835947",1583,733,718,15,0,731,2,1700,967,516,215,1,2,0
1,"Alba",1017,10,1017,,"MUNICIPIUL ALBA IULIA",35,"Colegiul tehnic  Dorin Pavel  (Scoala Generala nr.9)  str. Tudor Vladimirescu (B-dul Regele Carol I) nr 39, sala IVA",1134,698,680,15,3,694,4,1250,552,356,338,1,2,0
1,"Alba",1017,10,1017,,"MUNICIPIUL ALBA IULIA",36,"Colegiul tehnic  Dorin Pavel   str. Tudor Vladimirescu (B-dul Regele Carol I) nr 39, sala XD",983,530,522,8,0,529,1,1093,563,329,200,1,2,0
1,"Alba",1017,10,1017,,"MUNICIPIUL ALBA IULIA",37,"Gradinita nr.16 str. Tudor Vladimirescu (B-dul Regele Carol I), nr. 143   Sala grupa mijlocie Tel:258815596",1590,857,836,21,0,848,9,1700,843,613,235,1,2,0
1,"Alba",1017,10,1017,,"MUNICIPIUL ALBA IULIA",38,"Colegiul tehnic Alexandru Domsa str. Tudor Vladimirescu (B-dul Regele Carol I), nr. 143, sala 1 Tel:258816065",992,507,495,12,0,503,4,1102,595,339,164,1,2,0
1,"Alba",1017,10,1017,,"MUNICIPIUL ALBA IULIA",39,"Colegiul tehnic Alexandru Domsa str. Tudor Vladimirescu (B-dul Regele Carol I), nr. 143, sala 2 Tel:258816065",1511,722,709,12,1,715,7,1670,948,497,218,1,2,0
1,"Alba",1017,10,1017,,"MUNICIPIUL ALBA IULIA",40,"Colegiul tehnic Alexandru Domsa str. Tudor Vladimirescu (B-dul Regele Carol I), nr. 143, sala 3 Tel:258816065",1666,901,891,10,0,894,7,1800,899,590,304,1,2,0
1,"Alba",1017,10,1017,,"MUNICIPIUL ALBA IULIA",41,"Gradinita Barabant  Str. Muresului nr.138  Sala grupa mica-mijlocie Tel:258811121",968,611,600,10,1,603,8,1071,460,427,176,1,2,0
1,"Alba",1017,10,1017,,"MUNICIPIUL ALBA IULIA",42,"Gradinita Barabant  Str. Muresului nr.138  Sala de festivitati Tel:258811121",1087,647,639,7,1,642,5,1200,553,420,222,1,2,0
1,"Alba",1017,10,1017,,"MUNICIPIUL ALBA IULIA",43,"Scoala cu clasele I-VIII Micesti Str. Scarisoarei,  nr. 17 Sala de sport Tel:258826076",792,509,496,13,0,506,3,884,375,344,162,1,2,0
1,"Alba",1017,10,1017,,"MUNICIPIUL ALBA IULIA",44,"Scoala cu clasele I-VIII Micesti  Str. Scarisoarei,  nr. 17  Tel:258826076",979,677,667,7,3,670,7,1100,423,432,238,1,2,0
1,"Alba",1017,10,1017,,"MUNICIPIUL ALBA IULIA",45,"Scoala cu clasele I-IV Paclisa  Str. Carpenului, nr. 133  Sala 2 Tel:258835041",773,477,468,9,0,470,7,863,386,324,146,1,2,0
1,"Alba",1017,10,1017,,"MUNICIPIUL ALBA IULIA",46,"Gradinita nr. 5  Partos Str. Liliacului, nr. 8 Tel:258810251",770,499,491,8,0,492,7,850,351,348,144,1,2,0
1,"Alba",1017,10,1017,,"MUNICIPIUL ALBA IULIA",47,"Camin Cultural  Oarda de Jos Str. Biruintei, nr.14",1131,768,752,16,0,759,9,1254,486,543,216,1,2,0
1,"Alba",1017,10,1017,,"MUNICIPIUL ALBA IULIA",48,"Scoala cu clasele I-IV Oarda de Sus  Str. Victoriei,  nr. 87  Tel:258812843",685,426,417,9,0,423,3,763,337,324,99,1,2,0
1,"Alba",1017,10,1017,,"MUNICIPIUL ALBA IULIA",49,"Sala de protocol a statiei CFR din Bd.Incoronarii nr.1 Alba Iulia",0,1080,0,1080,0,1068,12,1500,420,653,415,1,2,1
1,"Alba",1017,10,1017,,"MUNICIPIUL ALBA IULIA",50,"Sala de lectura a Caminului studentesc nr.2 al Universitatii 1 Decembrie 1918 str. Vasile Alecsandri, nr 102",0,812,0,812,0,806,6,1499,687,483,323,1,2,1
1,"Alba",1213,10,1213,,"MUNICIPIUL AIUD",51,"Centrul Cultural Liviu Rebreanu Strada Transilvaniei, nr. 31, Aiud, Sala Mica de conferinte Tel:",1547,788,780,8,0,784,4,1700,912,373,411,1,8,0
1,"Alba",1213,10,1213,,"MUNICIPIUL AIUD",52,"Fostul Grup Scolar Agricol, Aiud, strada Tribun Tudoran, nr.5, Etaj I sala nr. 3 partea dreapta",1131,572,559,12,1,565,7,1250,678,271,294,1,8,0
1,"Alba",1213,10,1213,,"MUNICIPIUL AIUD",53,"Fostul Grup Scolar Agricol Aiud, Strada Tribun Tudoran, nr.5, Etaj I, sala nr. 4 partea dreapta",944,850,532,9,309,840,10,1040,190,430,410,1,8,0
1,"Alba",1213,10,1213,,"MUNICIPIUL AIUD",54,"Cresa de copii Micro III Aiud, Strada Unirii, nr. 26, Parter, sala nr. 2 partea stanga",1407,793,778,15,0,783,10,1550,757,406,377,1,8,0
1,"Alba",1213,10,1213,,"MUNICIPIUL AIUD",55,"Gradinita cu Program Prelungit nr.2 Aiud, parter, Sala nr. 1,  Strada Unirii nr. 24,",1488,844,833,11,0,838,6,1640,796,405,433,1,8,0
1,"Alba",1213,10,1213,,"MUNICIPIUL AIUD",56,"Scoala Generala nr. 3 Axente Sever, Strada Unirii, nr. 22, Aiud, parter, Sala nr. 1, partea stanga",1484,725,716,9,0,722,3,1600,875,407,315,1,8,0
1,"Alba",1213,10,1213,,"MUNICIPIUL AIUD",57,"Scoala Generala nr. 3 Axente Sever Strada Unirii, nr. 22 Aiud parter, Sala nr. 2, partea  stanga",1399,669,666,3,0,667,2,1540,871,356,311,1,8,0
1,"Alba",1213,10,1213,,"MUNICIPIUL AIUD",58,"Scoala Generala nr. 3 Axente Sever  Strada Unirii, Nr.22 Aiud, parter, Sala nr. 4, partea stanga",1244,650,643,7,0,647,3,1370,720,350,297,1,8,0
1,"Alba",1213,10,1213,,"MUNICIPIUL AIUD",59,"Colegiul Titu Maiorescu Strada Ec.Varga,nr.8 Aiud, parter, Sala nr. 5, partea dreapta",1477,737,728,9,0,734,3,1600,863,398,336,1,8,0
1,"Alba",1213,10,1213,,"MUNICIPIUL AIUD",60,"Colegiul Tehnic Aiud, Strada Ion Creanga, nr. 24, Aiud, parter, Sala nr. 8, partea stanga",855,460,454,6,0,457,3,940,480,188,269,1,8,0
1,"Alba",1213,10,1213,,"MUNICIPIUL AIUD",61,"Colegiul Tehnic Aiud, Strada. Ion Creanga, nr. 24 Aiud, parter, Sala nr. 9, partea stanga",831,403,397,6,0,401,2,920,517,206,195,1,8,0
1,"Alba",1213,10,1213,,"MUNICIPIUL AIUD",62,"Strada Simion Barnutiu, nr. 20 Aiud (Fosta Gradinita nr.1) Sala nr. 1",1441,751,741,10,0,742,9,1590,839,364,378,1,8,0
1,"Alba",1213,10,1213,,"MUNICIPIUL AIUD",63,"Scoala Generala nr. 1 Ovidiu Hulea Strada Cuza Voda, Nr. 35 Aiud, parter, Sala Profesorala",1108,537,529,8,0,530,7,1201,664,261,269,1,8,0
1,"Alba",1213,10,1213,,"MUNICIPIUL AIUD",64,"Scoala Generala nr. 1 Ovidiu Hulea Strada Cuza Voda, Nr. 35 Aiud, parter, Sala nr 4, partea stanga",1330,644,634,10,0,632,12,1474,830,313,319,1,8,0
1,"Alba",1213,10,1213,,"MUNICIPIUL AIUD",65,"Scoala Generala nr. 2 Strada Gheorghe Lazar, nr. 17,  Aiudul de Sus, parter, Sala de clasa III",889,422,414,8,0,416,6,980,558,233,183,1,8,0
1,"Alba",1213,10,1213,,"MUNICIPIUL AIUD",66,"Scoala Generala nr. 2 Strada Gheorghe Lazar, nr. 17,  Aiudul de Sus, parter, Sala de clasa V",1129,515,509,6,0,509,6,1250,735,255,254,1,8,0
1,"Alba",1213,10,1213,,"MUNICIPIUL AIUD",67,"Scoala Generala Magina Strada Pandurilor, nr.50, Sala nr. 3",489,280,267,13,0,274,6,542,262,149,125,1,8,0
1,"Alba",1213,10,1213,,"MUNICIPIUL AIUD",68,"Scoala Generala Gambas, Strada Baba Novac, nr. 9, Sala nr. 3, partea dreapta",425,280,274,6,0,277,3,470,190,166,111,1,8,0
1,"Alba",1213,10,1213,,"MUNICIPIUL AIUD",69,"Camin Cultural Pagida, Strada Dealului, nr. 12, Sala Mica, nr. 1, partea stanga",100,75,68,7,0,75,0,110,35,50,25,1,8,0
1,"Alba",1213,10,1213,,"MUNICIPIUL AIUD",70,"Scoala Generala Ciumbrud, Strada Vasile Lucaciu, nr. 18, Sala - Cabinet Geografie",1074,593,589,4,0,589,4,1190,597,311,278,1,8,0
1,"Alba",1213,10,1213,,"MUNICIPIUL AIUD",71,"Scoala Generala Sancrai, Strada Andrei Muresanu, nr. 60, Sala nr. 1, partea dreapta",585,343,335,8,0,337,6,650,307,187,150,1,8,0
1,"Alba",1213,10,1213,,"MUNICIPIUL AIUD",72,"Scoala Generala Garbova de Jos, Strada Gheorghe Asachi, nr. 24, sala nr. 1, partea dreapta",457,236,227,9,0,235,1,502,266,162,73,1,8,0
1,"Alba",1213,10,1213,,"MUNICIPIUL AIUD",73,"Scoala Generala Garbovita,nr. 66, Sala nr. 1, partea stanga",99,60,52,8,0,60,0,110,50,28,32,1,8,0
1,"Alba",1213,10,1213,,"MUNICIPIUL AIUD",74,"Scoala Generala Garbova de Sus, Strada Gruisoarei, nr. 2, Sala nr. 1, partea stanga",259,171,161,10,0,167,4,291,120,90,77,1,8,0
1,"Alba",1213,10,1213,,"MUNICIPIUL AIUD",75,"Colegiul National Bethlen Gabor, Strada Bethlen Gabor, nr. 1, clasa 12 A parter",0,288,0,288,0,284,4,700,412,151,133,1,8,1
1,"Alba",1348,10,1348,,"MUNICIPIUL BLAJ",76,"Strada Garii (Piata Mica Agroalimentara) - Sala administratie piata",1150,608,604,4,0,603,5,1270,662,376,227,1,20,0
1,"Alba",1348,10,1348,,"MUNICIPIUL BLAJ",77,"Strada Iuliu Maniu, nr. 101 (sediul SC APA CTTA) - Sala nr. 1 Tel:258711340",601,410,399,11,0,407,3,670,260,316,91,1,20,0
1,"Alba",1348,10,1348,,"MUNICIPIUL BLAJ",78,"Gradinita de copii cu program prelungit nr. 3, Strada Eroilor, nr. 22 - Sala 1 Tel:258712838",1312,711,702,9,0,707,4,1450,739,437,270,1,20,0
1,"Alba",1348,10,1348,,"MUNICIPIUL BLAJ",79,"Scoala Generala nr. 1, B-dul Republicii, nr.48 - Cancelarie - Sala nr. 1 Tel:258711933",1356,725,714,11,0,714,11,1500,775,427,287,1,20,0
1,"Alba",1348,10,1348,,"MUNICIPIUL BLAJ",80,"Casa de Cultura a municipiului Blaj, B-dul Republicii, nr. 36 - Holul Casei de Cultura Tel:258711020",923,539,522,13,4,534,5,1000,461,291,243,1,20,0
1,"Alba",1348,10,1348,,"MUNICIPIUL BLAJ",81,"Grupul Scolar Agricol, Piata 1848, nr. 3 - Sala nr. 40 Tel:258710655",696,362,350,11,1,360,2,770,408,219,141,1,20,0
1,"Alba",1348,10,1348,,"MUNICIPIUL BLAJ",82,"Universitatea ""Spiru Haret"" Blaj, str. Tudor Vladimirescu, nr. 80 (fostul sediu Agromec Blaj), sala nr 1 Tel:258711231",534,353,342,11,0,349,4,590,237,220,129,1,20,0
1,"Alba",1348,10,1348,,"MUNICIPIUL BLAJ",83,"Piata Mare Agroalimentara - Sala administratie piata Tel:Nu dispune",660,380,369,10,1,379,1,730,350,252,127,1,20,0
1,"Alba",1348,10,1348,,"MUNICIPIUL BLAJ",84,"AJVPS Blaj (fostul CET Blaj), str. George Baritiu, nr. 5 - Sala nr. 1 Tel:Nu dispune",315,200,188,12,0,198,2,350,150,141,57,1,20,0
1,"Alba",1348,10,1348,,"MUNICIPIUL BLAJ",85,"Grupul Scolar pentru Industrializarea lemnului Blaj, strada dr. Vasile Suciu, nr. 29 - Sala nr 4 Tel:258713630",1603,980,973,6,1,970,10,1770,790,556,414,1,20,0
1,"Alba",1348,10,1348,,"MUNICIPIUL BLAJ",86,"Colegiul National ""I.I. Micu Clain"" Blaj, strada Simion Barnutiu, nr. 2 - Sala nr. 15 Tel:258711208",1449,860,852,8,0,853,7,1600,740,517,336,1,20,0
1,"Alba",1348,10,1348,,"MUNICIPIUL BLAJ",87,"Scoala Generala nr. 4 Veza - Blaj, strada Pacii, nr. 1 - Sala nr. 1 Tel:258711405",1604,933,923,7,3,922,11,1770,837,649,273,1,20,0
1,"Alba",1348,10,1348,,"MUNICIPIUL BLAJ",88,"Scoala Generala nr. 2 Izvoarele - Blaj, strada Pacii, nr. 144 - Sala Sport Tel:258711813",1232,707,689,18,0,693,14,1360,653,537,156,1,20,0
1,"Alba",1348,10,1348,,"MUNICIPIUL BLAJ",89,"Gradinita de Copii Blaj, strada Pacii, nr. 81 - Sala nr. 1 Tel:Nu dispune",1288,765,755,10,0,757,8,1420,655,546,211,1,20,0
1,"Alba",1348,10,1348,,"MUNICIPIUL BLAJ",90,"Scoala Generala Tiur - Sala nr. 7 Tel:258713591",1393,886,879,7,0,880,6,1540,654,663,217,1,20,0
1,"Alba",1348,10,1348,,"MUNICIPIUL BLAJ",91,"Scoala Generala Manarade - Sala nr. 1 Tel:258717149",845,507,495,12,0,503,4,930,423,365,138,1,20,0
1,"Alba",1348,10,1348,,"MUNICIPIUL BLAJ",92,"Scoala Generala Petrisat  - Sala nr. 1 Tel:258713467",477,311,304,7,0,310,1,530,219,265,45,1,20,0
1,"Alba",1348,10,1348,,"MUNICIPIUL BLAJ",93,"Gara Mare, str. Garii, nr. 3 -  Statia CFR Blaj Tel:Nu dispune",0,294,0,294,0,291,3,700,406,179,112,1,20,1
1,"Alba",1874,10,1874,,"MUNICIPIUL SEBES",94,"S.C. ARGOS S.A. Sebes - Strada Viilor nr.28 - Sala de sedinte Tel:0258-731125",1552,915,906,8,1,911,4,1711,796,580,331,1,30,0
1,"Alba",1874,10,1874,,"MUNICIPIUL SEBES",95,"GRUPUL SCOLAR INDUSTRIAL Sebes - Strada Viilor nr.2 - Cantina Tel:0358-401796",1356,786,766,20,0,774,12,1503,717,488,286,1,30,0
1,"Alba",1874,10,1874,,"MUNICIPIUL SEBES",96,"SCOALA GENERALA NR.3 Sebes - Strada Lucian Blaga nr.76- Sala nr.21 Tel:0258-731220",1562,877,867,10,0,873,4,1718,841,542,331,1,30,0
1,"Alba",1874,10,1874,,"MUNICIPIUL SEBES",97,"CASA DE CULTURA LUCIAN BLAGA Sebes - Strada Lucian Blaga nr.45 - Holul principal Tel:0258-732939",1557,889,879,9,1,885,4,1710,821,515,370,1,30,0
1,"Alba",1874,10,1874,,"MUNICIPIUL SEBES",98,"CLUBUL COPIILOR SI ELEVILOR Sebes - Strada Lucian Blaga nr.31 - Sala de coregrafie Tel:0258-731948",1569,856,845,9,2,839,17,1730,874,484,355,1,30,0
1,"Alba",1874,10,1874,,"MUNICIPIUL SEBES",99,"SCOALA GENERALA NR.2 Sebes - Strada Piata Libertatii nr.1- Sala nr.3 Tel:0258-731922",1500,873,865,7,1,871,2,1650,777,566,305,1,30,0
1,"Alba",1874,10,1874,,"MUNICIPIUL SEBES",100,"GRUPUL SCOLAR INDUSTRIAL Sebes - Strada Dorin Pavel nr.1- Sala nr.2 Tel:0258-731010",1553,878,872,5,1,873,5,1712,834,508,365,1,30,0
1,"Alba",1874,10,1874,,"MUNICIPIUL SEBES",101,"COLEGIUL NATIONAL LUCIAN BLAGA Sebes - Strada Calugareni nr.39 - Sala nr.13 Tel:0258-731217",1035,587,580,6,1,579,8,1140,553,325,254,1,30,0
1,"Alba",1874,10,1874,,"MUNICIPIUL SEBES",102,"COLEGIUL NATIONAL LUCIAN BLAGA Sebes - Strada Calugareni nr.39 - Sala nr.15 Tel:0258-731217",1338,769,752,17,0,764,5,1470,701,479,285,1,30,0
1,"Alba",1874,10,1874,,"MUNICIPIUL SEBES",103,"SCOALA GENERALA NR.1 Sebes - Strada Stefan cel Mare - Sala de sport Tel:0258-731923",1093,643,634,8,1,637,6,1200,557,388,249,1,30,0
1,"Alba",1874,10,1874,,"MUNICIPIUL SEBES",104,"SCOALA GENERALA NR.1 Sebes -Strada Stefan cel Mare - Sala nr.6 Tel.0258-731923",870,451,445,6,0,447,4,959,508,334,113,1,30,0
1,"Alba",1874,10,1874,,"MUNICIPIUL SEBES",105,"GRADINITA NR.8 - CARTIER MIHAIL KOGALNICEANU Sebes - Sala de festivittati Tel:0258-730436",1207,577,569,8,0,573,4,1330,753,382,191,1,30,0
1,"Alba",1874,10,1874,,"MUNICIPIUL SEBES",106,"SCOALA GENERALA NR.4 MIHAIL KOGALNICEANU - Sebes - Sala nr.2 Tel:0258-731506",1224,613,602,11,0,609,4,1350,737,435,174,1,30,0
1,"Alba",1874,10,1874,,"MUNICIPIUL SEBES",107,"SCOALA GENERALA NR.4 MIHAIL KOGALNICEANU - Sebes - Sala nr.3 Tel:0258-731506",1220,596,584,12,0,593,3,1340,744,392,201,1,30,0
1,"Alba",1874,10,1874,,"MUNICIPIUL SEBES",108,"SCOALA GENERALA NR.4 MIHAIL KOGALNICEANU - Sebes - Sala nr.4 Tel:0258-731506",1034,502,497,5,0,499,3,1140,638,330,169,1,30,0
1,"Alba",1874,10,1874,,"MUNICIPIUL SEBES",109,"SCOALA GENERALA LANCRAM - Strada Veche nr.121 - Sala nr.2 Tel:0258-887232",1369,807,802,5,0,807,0,1510,703,558,249,1,30,0
1,"Alba",1874,10,1874,,"MUNICIPIUL SEBES",110,"SCOALA GENERALA RAHAU - Strada Scolii nr. 65 - Sala mica Tel:0258-735867",815,459,452,7,0,458,1,900,441,313,145,1,30,0
1,"Alba",1874,10,1874,,"MUNICIPIUL SEBES",111,"SCOALA GENERALA PETRESTI -Strada Mihai Viteazu nr. 3 - Sala nr.4 Tel:0258-743112",1442,768,763,5,0,759,9,1590,822,525,234,1,30,0
1,"Alba",1874,10,1874,,"MUNICIPIUL SEBES",112,"SCOALA GENERALA PETRESTI -Strada Mihai Viteazu nr. 3 - Sala nr.5 Tel:0258-743112",1208,618,611,5,2,610,8,1330,712,461,149,1,30,0
1,"Alba",1874,10,1874,,"MUNICIPIUL SEBES",113,"SCOALA GENERALA PETRESTI -Strada Mihai Viteazu nr. 3 - Sala nr.6 Tel:0258-743112",1096,556,544,10,2,553,3,1210,654,388,165,1,30,0
1,"Alba",1874,10,1874,,"MUNICIPIUL SEBES",114,"AUTOGARA MUN.SEBES - Strada Vanatori nr.24 D - Sala de asteptare",0,464,0,464,0,458,6,700,236,297,161,1,30,1
1,"Alba",1151,10,1151,,"ORAS ABRUD",115,"Scoala Generala cu clasele I-VIII Abrud,Sala mica de sport, Piata Eroilor nr.17",1213,680,667,12,1,667,13,1330,650,283,384,1,35,0
1,"Alba",1151,10,1151,,"ORAS ABRUD",116,"Scoala Generala de aplicatie,Strada Detunata nr.2",1188,683,680,3,0,675,8,1317,634,282,393,1,35,0
1,"Alba",1151,10,1151,,"ORAS ABRUD",117,"Gradinita cu program prelungit,Strada Republicii nr.12 Tel:258-780543",1326,721,712,9,0,719,2,1460,739,273,446,1,35,0
1,"Alba",1151,10,1151,,"ORAS ABRUD",118,"Grup Scolar HCC Abrud,Strada Republicii nr.16 Tel:258-780623",1181,644,638,6,0,636,8,1300,656,280,356,1,35,0
1,"Alba",1151,10,1151,,"ORAS ABRUD",119,"Scoala Generala de aplicatie, Sala nr.2,Strada Detunata nr.2",0,158,0,158,0,150,8,400,242,74,76,1,35,1
1,"Alba",2915,10,2915,,"ORAS BAIA DE ARIES",120,"Scoala Generala cls V-VIII, strada Piata Baii, nr. 3, sala nr. 1",970,506,501,5,0,503,3,1070,564,280,223,1,40,0
1,"Alba",2915,10,2915,,"ORAS BAIA DE ARIES",121,"Primaria- sala de sedinte , strada Piata Baii, nr. 1 Tel:775002",842,452,452,0,0,451,1,930,478,221,230,1,40,0
1,"Alba",2915,10,2915,,"ORAS BAIA DE ARIES",122,"Sala de Sport, strada Piata Baii, nr.4",824,398,394,1,3,396,2,910,512,225,171,1,40,0
1,"Alba",2915,10,2915,,"ORAS BAIA DE ARIES",123,"Scoala primara, sala nr.2, Sat Brazesti",224,143,137,6,0,141,2,250,107,68,73,1,40,0
1,"Alba",2915,10,2915,,"ORAS BAIA DE ARIES",124,"Scoala primara, sala nr.1 , satul Cioara de Sus",218,125,118,7,0,125,0,240,115,75,50,1,40,0
1,"Alba",2915,10,2915,,"ORAS BAIA DE ARIES",125,"Scoala primara, sala nr.1, satul Muncelul",340,187,182,5,0,186,1,370,183,113,73,1,40,0
1,"Alba",2915,10,2915,,"ORAS BAIA DE ARIES",126,"Caminul cultural, sala nr.1,etaj 1., satul Sartas",332,186,183,3,0,185,1,370,184,98,87,1,40,0
1,"Alba",2915,10,2915,,"ORAS BAIA DE ARIES",127,"Scoala Generala cls V-VIII, str. Piata Baii, nr. 3, Sala nr. 2 :",0,99,0,99,0,97,2,400,301,63,34,1,40,1
1,"Alba",1455,10,1455,,"ORAS CAMPENI",128,"Primaria orasului Campeni,strada Avram Iancu Nr.5,sala de sedinta Tel:0258771215",1255,673,662,11,0,662,11,1380,707,316,346,1,47,0
1,"Alba",1455,10,1455,,"ORAS CAMPENI",129,"Scoala cu Clasele I-VIII Cimpeni Str Motilor nr. 29,sala 6 Tel:0258771560",938,542,525,17,0,537,5,1030,488,268,269,1,47,0
1,"Alba",1455,10,1455,,"ORAS CAMPENI",130,"Colegiul National Avram Iancu Cimpeni - Cantina, strada. Oituz, nr. 6 Tel:0258771935",987,560,553,7,0,556,4,1090,530,277,279,1,47,0
1,"Alba",1455,10,1455,,"ORAS CAMPENI",131,"Colegiul National Avram Iancu Cimpeni - Sala Nr.7  - strada Oituz nr. 6 Tel:0258771232",891,531,517,14,0,528,3,980,449,272,256,1,47,0
1,"Alba",1455,10,1455,,"ORAS CAMPENI",132,"Ocolul Silvic Valea Ariesului (fost APIA), strada Horea, nr.4 Tel:0258771722",878,539,527,12,0,534,5,970,431,265,269,1,47,0
1,"Alba",1455,10,1455,,"ORAS CAMPENI",133,"Scoala Varsi,  strada Garii nr 42 sala 1 Tel:0258774288",656,343,334,9,0,340,3,720,377,165,175,1,47,0
1,"Alba",1455,10,1455,,"ORAS CAMPENI",134,"Scoala Valea Bistrii, fn sala 1",414,260,252,8,0,258,2,460,200,165,93,1,47,0
1,"Alba",1455,10,1455,,"ORAS CAMPENI",135,"Scoala Certege, fn, sala 1 Tel:0258774386",446,163,155,8,0,163,0,490,327,94,69,1,47,0
1,"Alba",1455,10,1455,,"ORAS CAMPENI",136,"Scoala Mihoiesti,fn, sala 1 Tel:0258771296",277,156,148,8,0,154,2,300,144,77,77,1,47,0
1,"Alba",1455,10,1455,,"ORAS CAMPENI",137,"Casa de cultura  Avram Iancu ,strada Avram Iancu  nr.3,sala -hol intrare Tel:0258771215",0,236,0,236,0,234,2,400,164,121,113,1,47,1
1,"Alba",1696,10,1696,,"ORAS CUGIR",138,"Scoala Generala nr.3 Cugir-local vechi, Strada Doinei, nr.3, sala nr.1",1192,648,642,5,1,644,4,1309,661,308,336,1,70,0
1,"Alba",1696,10,1696,,"ORAS CUGIR",139,"Scoala Generala nr.3 Cugir-local vechi, Strada Doinei, nr.3, sala nr.2",1443,712,701,11,0,708,4,1625,913,323,385,1,70,0
1,"Alba",1696,10,1696,,"ORAS CUGIR",140,"Gradinita nr.5 Cugir, Strada Doinei, nr.10, sala nr.1",1213,602,593,9,0,599,3,1325,723,250,349,1,70,0
1,"Alba",1696,10,1696,,"ORAS CUGIR",141,"Scoala Generala nr.3 Cugir-local nou, Strada Aleea Constructorului, nr.1, sala nr.1",1434,635,626,8,1,630,5,1580,945,312,318,1,70,0
1,"Alba",1696,10,1696,,"ORAS CUGIR",142,"Scoala Generala nr.3 Cugir-local nou, Strada Aleea Constructorului, nr.1, sala nr.2",1311,629,620,9,0,625,4,1438,809,274,351,1,70,0
1,"Alba",1696,10,1696,,"ORAS CUGIR",143,"Colegiul ""David Prodan"" Cugir, Strada Victoriei, nr.15, hol parter corp principal",1211,563,551,12,0,562,1,1330,767,295,267,1,70,0
1,"Alba",1696,10,1696,,"ORAS CUGIR",144,"Colegiul ""David Prodan"" Cugir, Strada Victoriei, nr.15, sala de sport",1244,659,652,7,0,652,7,1370,711,307,345,1,70,0
1,"Alba",1696,10,1696,,"ORAS CUGIR",145,"Scoala Generala Nr.4 Cugir, Strada Alexandru Sahia, nr.16, sala nr.1",1387,701,694,7,0,695,6,1529,828,319,376,1,70,0
1,"Alba",1696,10,1696,,"ORAS CUGIR",146,"Gradinita nr.6 Cugir, Strada Alexandru Sahia, nr.14, sala nr.1",1324,735,722,13,0,727,8,1460,725,321,406,1,70,0
1,"Alba",1696,10,1696,,"ORAS CUGIR",147,"Colegiul ""I.D.Lazarescu"" Cugir, Strada Victoriei, nr.9, sala profesorala",1140,585,574,10,1,582,3,1264,679,242,340,1,70,0
1,"Alba",1696,10,1696,,"ORAS CUGIR",148,"Scoala Generala Nr.2 Cugir-local vechi, Strada Nicolae Balcescu, nr.6, sala nr.1",1505,810,791,19,0,804,6,1656,846,351,453,1,70,0
1,"Alba",1696,10,1696,,"ORAS CUGIR",149,"Scoala Generala Nr.2 Cugir-local nou, Strada Gheorghe Asachi, nr.15 A, sala nr.1",1192,573,558,15,0,559,14,1309,736,275,284,1,70,0
1,"Alba",1696,10,1696,,"ORAS CUGIR",150,"Casa de Cultura a orasului Cugir, Strada Ion Luca Caragiale, nr.5, hol parter",1487,787,772,12,3,777,10,1640,853,341,436,1,70,0
1,"Alba",1696,10,1696,,"ORAS CUGIR",151,"Gradinita nr.2 Cugir, Strada 21 Decembrie 1989, nr.17, sala nr.1",1325,695,687,7,1,690,5,1460,765,311,379,1,70,0
1,"Alba",1696,10,1696,,"ORAS CUGIR",152,"Scoala Generala Nr.1 Cugir-local vechi, Strada 21 Decembrie 1989, nr.27, sala nr.1",1213,693,684,7,2,686,7,1340,647,305,381,1,70,0
1,"Alba",1696,10,1696,,"ORAS CUGIR",153,"Scoala Generala Nr.1 Cugir-local nou, Strada 21 Decembrie 1989, nr.157, sala nr.1",1278,643,636,7,0,640,3,1402,759,326,314,1,70,0
1,"Alba",1696,10,1696,,"ORAS CUGIR",154,"Gradinita Nr.1 Cugir, Strada Raul Mic, nr.105, sala nr.1",1223,635,625,10,0,629,6,1353,718,300,329,1,70,0
1,"Alba",1696,10,1696,,"ORAS CUGIR",155,"Scoala Generala ""Dr.Ioan Mihu"" Vinerea, Strada Principala, nr.178, sala de sport",1079,595,585,10,0,585,10,1190,595,296,289,1,70,0
1,"Alba",1696,10,1696,,"ORAS CUGIR",156,"Scoala Generala ""Dr.Ioan Mihu"" Vinerea, Strada Principala, nr.178, sala nr.1 corp principal",938,526,516,10,0,523,3,1027,501,233,290,1,70,0
1,"Alba",1696,10,1696,,"ORAS CUGIR",157,"Scoala Generala Bucuru, sala nr.1",125,59,49,10,0,58,1,140,81,38,20,1,70,0
1,"Alba",1696,10,1696,,"ORAS CUGIR",158,"Scoala Generala Calene, sala nr.1",47,36,27,9,0,36,0,50,14,17,19,1,70,0
1,"Alba",1696,10,1696,,"ORAS CUGIR",159,"Scoala Generala Mugesti, sala nr.1",97,48,40,8,0,47,1,110,62,31,16,1,70,0
1,"Alba",1696,10,1696,,"ORAS CUGIR",160,"Casa de Cultura a orasului Cugir, Strada Ion Luca Caragiale, nr.5, parter, sala de repetitii",0,245,0,245,0,243,2,500,255,133,110,1,70,1
1,"Alba",1794,10,1794,,"ORAS OCNA MURES",161,"Gradinita de copii nr.5,  Ocna Mures, str.Aleea Independentei, f.n., sala nr.2",1525,795,788,7,0,785,10,1679,884,530,255,1,79,0
1,"Alba",1794,10,1794,,"ORAS OCNA MURES",162,"Scoala generala ""Lucian Blaga"" Ocna Mures, strada Brazilor,nr.2,cladirea veche Tel:0258 - 871141",1195,605,599,6,0,602,3,1310,705,350,252,1,79,0
1,"Alba",1794,10,1794,,"ORAS OCNA MURES",163,"Casa de Cultura a orasului Ocna Mures,str.Nicolae Iorga,nr.34, holul mare, parter",1474,738,730,8,0,732,6,1610,872,448,284,1,79,0
1,"Alba",1794,10,1794,,"ORAS OCNA MURES",164,"Clubul Vanatorilor, Ocna Mures, str. 9 Mai, nr.7, sala principala",1180,600,593,7,0,592,8,1300,700,324,268,1,79,0
1,"Alba",1794,10,1794,,"ORAS OCNA MURES",165,"Liceul Teoretic ""Petru Maior"" Ocna Mures, str.Vadului, nr.1, sala de clasa nr.1, parter Tel:0258 - 870559",1434,706,696,9,1,700,6,1580,874,477,223,1,79,0
1,"Alba",1794,10,1794,,"ORAS OCNA MURES",166,"Gradinita de copii nr.3,Ocna Mures,str Malinului, f.n., sala de clasa nr.1,parter",1517,790,783,7,0,785,5,1670,880,504,281,1,79,0
1,"Alba",1794,10,1794,,"ORAS OCNA MURES",167,"Caminul cultural din localitatea componenta Uioara de Sus, str.Lunga, nr.79, sala mare",1405,708,699,9,0,703,5,1547,839,412,291,1,79,0
1,"Alba",1794,10,1794,,"ORAS OCNA MURES",168,"Caminul cultural din localitatea componenta Uioara de Jos, strada Piata Izvor, nr.1, sala  mica",987,514,507,7,0,509,5,1090,576,337,172,1,79,0
1,"Alba",1794,10,1794,,"ORAS OCNA MURES",169,"Scoala generala de 8 ani, satul apartinator Cisteiu de Mures, nr.81, sala de sport Tel:0258 - 879615",557,278,270,8,0,278,0,610,332,226,52,1,79,0
1,"Alba",1794,10,1794,,"ORAS OCNA MURES",170,"Gradinita cu program normal, satul apartinator Micoslaca,nr.122, sala de clasa nr.1",252,158,148,10,0,157,1,280,122,73,84,1,79,0
1,"Alba",1794,10,1794,,"ORAS OCNA MURES",171,"Caminul cultural, satul apartinator Razboieni Cetate, nr.142, sala nr.2",1198,616,608,8,0,612,4,1320,704,325,287,1,79,0
1,"Alba",1794,10,1794,,"ORAS OCNA MURES",172,"Gradinita cu program normal nr. 2 Ocna Mures, strada Nicolae Iorga, nr.20,  sala nr. 1, parter",0,156,0,156,0,154,2,400,244,89,65,1,79,1
1,"Alba",8096,10,8096,,"ORAS TEIUS",173,"Casa de cultura,strada Decebal,nr.29,sala nr.1",1618,946,934,7,5,937,9,1791,845,525,412,1,86,0
1,"Alba",8096,10,8096,,"ORAS TEIUS",174,"Liceul Teoretic Teius Scoala generala,strada Decebal,nr.49,cabinet religie Tel:258851128",1394,719,708,10,1,713,6,1530,811,342,371,1,86,0
1,"Alba",8096,10,8096,,"ORAS TEIUS",175,"Liceul Teoretic Teius,liceu teoretic,strada Decebal,nr.22,sala clasa XI Real Tel:258851157",1544,937,917,11,9,926,11,1699,762,518,408,1,86,0
1,"Alba",8096,10,8096,,"ORAS TEIUS",176,"Gara CFR Teius,strada Decebal,nr.148,sala scolii personalului",1086,598,588,8,2,593,5,1190,592,316,277,1,86,0
1,"Alba",8096,10,8096,,"ORAS TEIUS",177,"Sat Beldiu,Scoala generala,nr.15,sala 1",214,137,131,6,0,133,4,240,103,64,69,1,86,0
1,"Alba",8096,10,8096,,"ORAS TEIUS",178,"Sat Capud,camin cultural,nr.51A",273,175,168,7,0,174,1,300,125,138,36,1,86,0
1,"Alba",8096,10,8096,,"ORAS TEIUS",179,"Sat Petelca,Scoala generala,nr.64,sala 1",147,107,99,8,0,107,0,160,53,44,63,1,86,0
1,"Alba",8096,10,8096,,"ORAS TEIUS",180,"Gara CFR Teius,strada Decebal,nr.148,sala apel",0,182,0,182,0,180,2,501,319,123,57,1,86,1
1,"Alba",1936,10,1936,,"ORAS ZLATNA",181,"Scoala generala cu clasele I - VIII ""Horea"" Zlatna, Strada Piata Unirii, nr. 4, sala clasa 4b,Tel:0258856509",1276,735,728,7,0,724,11,1400,665,373,351,1,92,0
1,"Alba",1936,10,1936,,"ORAS ZLATNA",182,"Grup Scolar ""Avram Iancu "", Strada Tudor Vladimirescu, nr. 14, Cantina liceului, sala de mese Tel:0258856521",1371,705,693,11,1,703,2,1510,805,367,336,1,92,0
1,"Alba",1936,10,1936,,"ORAS ZLATNA",183,"Scoala generala cu clasele I - VIII ""Horea"" Zlatna, Strada Piata Unirii, nr. 4, sala clasa a I-a A",954,585,582,3,0,574,11,1050,465,335,239,1,92,0
1,"Alba",1936,10,1936,,"ORAS ZLATNA",184,"Scoala generala sat Fenes, sala a V a pe dreapta Tel:0258859132",810,522,512,6,4,517,5,890,368,235,282,1,92,0
1,"Alba",1936,10,1936,,"ORAS ZLATNA",185,"Camin Cultural sat Izvorul Ampoiului, strada principala, FN, Sala mare",490,301,292,6,3,293,8,544,243,159,134,1,92,0
1,"Alba",1936,10,1936,,"ORAS ZLATNA",186,"Scoala generala sat Patringeni, sala clase I - IV",532,337,330,7,0,333,4,590,253,156,177,1,92,0
1,"Alba",1936,10,1936,,"ORAS ZLATNA",187,"Scoala generala sat Trimpoiele, sala gradinita",392,231,222,9,0,230,1,430,199,158,72,1,92,0
1,"Alba",1936,10,1936,,"ORAS ZLATNA",188,"Scoala generala sat Valea Mica, sala clase I - IV",377,254,247,7,0,254,0,410,156,144,110,1,92,0
1,"Alba",1936,10,1936,,"ORAS ZLATNA",189,"Camin Cultural sat Viltori, strada Principala, FN, Sala mare",202,135,126,9,0,133,2,220,85,91,42,1,92,0
1,"Alba",1936,10,1936,,"ORAS ZLATNA",190,"Scoala generala sat Pirita, sala clasele I - IV",330,232,223,9,0,228,4,360,128,154,74,1,92,0
1,"Alba",1936,10,1936,,"ORAS ZLATNA",191,"Scoala generala sat Galati, sala clasele I - IV",315,178,170,8,0,175,3,350,172,122,53,1,92,0
1,"Alba",1936,10,1936,,"ORAS ZLATNA",192,"Scoala generala cu clasele I - VIII ""Horea"" Zlatna, Strada Piata Unirii, nr. 4, sala clasa a II -a",0,163,0,163,0,160,3,398,235,82,78,1,92,1
1,"Alba",2130,10,2130,,"ALBAC",193,"Caminul cultural Albac, strada Closca, nr. 9, Sala nr. 1",755,517,494,7,16,516,1,830,313,357,159,3,112,0
1,"Alba",2130,10,2130,,"ALBAC",194,"Scoala cu clasele I - IV Cionesti, sat. Cionesti, Sala nr. 1",553,418,405,13,0,416,2,610,192,340,76,3,112,0
1,"Alba",2130,10,2130,,"ALBAC",195,"Scoala cu clasele I - IV Costesti, sat. Costesti, Sala nr. 1",113,65,54,7,4,64,1,130,65,56,8,3,112,0
1,"Alba",2130,10,2130,,"ALBAC",196,"Scoala cu clasele I - IV Rogoz, sat. Rogoz, Sala nr. 1",232,158,150,8,0,158,0,260,102,103,55,3,112,0
1,"Alba",2130,10,2130,,"ALBAC",197,"Scoala cu clasele I - IV Potionci, sat. Potionci, Sala nr. 1",119,88,72,12,4,88,0,130,42,54,34,3,112,0
1,"Alba",2130,10,2130,,"ALBAC",198,"Caminul cultural, strada Closca, nr. 9, Sala nr. 2",0,76,0,76,0,76,0,150,74,46,30,3,112,1
1,"Alba",2309,10,2309,,"ALMASU MARE",199,"Primaria Almasu Mare,nr.204,sala de sedinte Tel:258850105",366,211,203,8,0,208,3,400,189,141,67,3,129,0
1,"Alba",2309,10,2309,,"ALMASU MARE",200,"Scoala primara ,sala de clasa, sat Suseni",253,131,119,6,6,131,0,280,149,70,61,3,129,0
1,"Alba",2309,10,2309,,"ALMASU MARE",201,"Scoala primara,sala de clasa sat Almasu de Mijloc",147,87,78,9,0,84,3,160,73,60,24,3,129,0
1,"Alba",2309,10,2309,,"ALMASU MARE",202,"Scoala primara,sala de clasa sat Cib",256,175,170,5,0,175,0,280,105,153,22,3,129,0
1,"Alba",2309,10,2309,,"ALMASU MARE",203,"Scoala primara,sala de clasa Sat Glod",163,116,109,7,0,114,2,180,64,98,16,3,129,0
1,"Alba",2309,10,2309,,"ALMASU MARE",204,"Caminul Cultural Almasu Mare - Centru,strada Principala ,nr. 204, holul central",0,77,0,77,0,76,1,150,73,65,11,3,129,1
1,"Alba",2381,10,2381,,"ARIESENI",205,"GRUP SCOLAR DE TURISM ARIESENI, Sala clasei I-a Tel:0258 779 066",1169,823,801,4,18,813,10,1290,467,369,444,3,137,0
1,"Alba",2381,10,2381,,"ARIESENI",206,"SCOALA CU CLASELE I-IV Casa de Piatra, Sala mare",95,83,71,10,2,83,0,100,17,58,25,3,137,0
1,"Alba",2381,10,2381,,"ARIESENI",207,"SCOALA CU CLASELE I-IV Cobles, Sala mare",202,147,133,9,5,147,0,220,73,80,67,3,137,0
1,"Alba",2381,10,2381,,"ARIESENI",208,"GRUP SCOLAR DE TURISM ARIESENI, sat arieseni, nr.8, Sala clasei  a IV-a Tel:0258 779 066",0,119,0,119,0,118,1,200,81,61,57,3,137,1
1,"Alba",2577,10,2577,,"AVRAM IANCU",209,"Scoala Generala cu clasele I-VIII Avram Iancu, nr. 27E, sala nr.1 Tel:258786063",753,634,622,9,3,628,6,830,196,564,64,3,156,0
1,"Alba",2577,10,2577,,"AVRAM IANCU",210,"Scoala Generala cu clasele I-VIII Tirsa , sala nr. 2 Tel:258786158",676,499,485,11,3,490,9,740,241,394,96,3,156,0
1,"Alba",2577,10,2577,,"AVRAM IANCU",211,"Scoala Generala cu clasele I-VIII Avram Iancu, nr. 27E, sala nr. 2",0,66,0,66,0,66,0,120,54,54,12,3,156,1
1,"Alba",2988,10,2988,,"BERGHIN",212,"Scoala generala cu clasele I-VIII, sala nr.2, Berghin Tel:258854113",702,396,383,8,5,393,3,780,384,311,82,3,190,0
1,"Alba",2988,10,2988,,"BERGHIN",213,"Scoala generala cu clasele I-IV,sala nr.1,Ghirbom Tel:258854102",483,346,336,5,5,344,2,540,194,262,82,3,190,0
1,"Alba",2988,10,2988,,"BERGHIN",214,"Scoala generala cu clasele I-IV,sala nr.1, Henig",277,202,187,9,6,200,2,310,108,147,53,3,190,0
1,"Alba",2988,10,2988,,"BERGHIN",215,"Scoala generala cu clasele I-IV,sala nr.1,Straja",319,194,184,10,0,193,1,350,156,146,47,3,190,0
1,"Alba",2988,10,2988,,"BERGHIN",216,"Scoala generala cu clasele I-VIII, sala nr.1, sat Berghin, str. morii , nr.34",0,75,0,75,0,73,2,120,45,57,16,3,190,1
1,"Alba",3039,10,3039,,"BISTRA",217,"Scoala Nicodim Ganea - cladirea nr. 1, strada Petru Pavel Aron, nr. 6, sala clasei a VI-a A Tel:258773106",934,488,477,11,0,480,8,1030,542,218,262,3,195,0
1,"Alba",3039,10,3039,,"BISTRA",218,"Scoala Nicodim Ganea, strada Petru Pavel Aron, nr. 2-A,sala de sport",857,479,471,8,0,478,1,940,461,240,238,3,195,0
1,"Alba",3039,10,3039,,"BISTRA",219,"Scoala Nicodim Ganea - cladirea nr. 2, strada Ganea, nr. 2, sala clasei a IV-a A. :",885,385,375,10,0,378,7,970,585,202,176,3,195,0
1,"Alba",3039,10,3039,,"BISTRA",220,"Scoala cu clasele I - VIII- Garde, nr. 40-B, sala ""Cabinet istorie"" Tel:258773021",697,373,366,7,0,371,2,770,397,173,198,3,195,0
1,"Alba",3039,10,3039,,"BISTRA",221,"Scoala cu clasele I - IV- Ciuldesti, nr. 44-A, sala nr. 2",638,328,318,10,0,326,2,700,372,174,152,3,195,0
1,"Alba",3039,10,3039,,"BISTRA",222,"Gradinita cu program normal - sala de activitati a grupei mici-, str. P.P. Aron. Nr. 6",0,49,0,49,0,49,0,200,151,27,22,3,195,1
1,"Alba",3397,10,3397,,"BLANDIANA",223,"Primaria comunei Blandiana, sat Blandiana, nr.15, sala de sedinte Tel:258760811",510,341,334,7,0,330,11,560,219,234,96,3,231,0
1,"Alba",3397,10,3397,,"BLANDIANA",224,"Scoala cu clasele I-IV Acmariu, sat Acamriu, nr.173, sala 3 Tel:258760806",333,207,198,9,0,207,0,370,163,100,107,3,231,0
1,"Alba",3397,10,3397,,"BLANDIANA",225,"Scoala cu clasele I-IV Racatau, sat Racatau, nr.11, sala 1",35,35,26,9,0,35,0,40,5,22,13,3,231,0
1,"Alba",3397,10,3397,,"BLANDIANA",226,"Scoala cu clasele I-VIII Blandiana, nr. 204A, sala de sport",0,76,0,76,0,76,0,120,44,56,20,3,231,1
1,"Alba",9026,10,9026,,"BUCERDEA GRANOASA",227,"Caminul cultural Bucerdea Granoasa, cladire administrativa, sala de sedinte Bucerdea Granoasa, Str. Ioan Maiorescu,nr53",959,642,630,3,9,632,10,1050,408,309,323,3,237,0
1,"Alba",9026,10,9026,,"BUCERDEA GRANOASA",228,"Gradinita Bucerdea Granoasa, Str.Potvechiului, nr.2, Sala nr. 1 Tel:0258883011",907,572,544,7,21,562,10,1000,428,266,296,3,237,0
1,"Alba",9026,10,9026,,"BUCERDEA GRANOASA",229,"Gradinita cu program normal Bucerdea Granoasa str. Potvechiului, nr. 2, Sala nr. 2",0,38,0,38,0,37,1,120,82,16,21,3,237,1
1,"Alba",3459,10,3459,,"BUCIUM",230,"Scoala cu clasele I-IV Bucium, sala 1",417,223,219,3,1,222,1,460,237,80,142,3,242,0
1,"Alba",3459,10,3459,,"BUCIUM",231,"Scoala cu clasele I-IV Bucium-Sat, sala 3",435,245,239,5,1,242,3,480,235,96,146,3,242,0
1,"Alba",3459,10,3459,,"BUCIUM",232,"Scoala cu clasele I-IV Bucium-Cerbu, sala 2",289,173,165,7,1,173,0,320,147,74,99,3,242,0
1,"Alba",3459,10,3459,,"BUCIUM",233,"Scoala cu clasele I-IV Bucium-Poieni, sala 1",306,182,173,3,6,179,3,340,158,70,109,3,242,0
1,"Alba",3459,10,3459,,"BUCIUM",234,"Primaria comunei Bucium, Sala de consiliu, sat Bucium, str. principala, CP517165 Tel:0258/784112",0,39,0,39,0,38,1,121,82,14,24,3,242,1
1,"Alba",3761,10,3761,,"CENADE",235,"Primaria Cenade, strada Principala, nr. 372, Sala de sedinte Tel:258789104",768,454,440,5,9,446,8,840,386,316,130,3,276,0
1,"Alba",3761,10,3761,,"CENADE",236,"Scoala Generala Ion Agarbiceanu cu clasele I-IV, strada Principala, nr. 250, Sala nr. 1 Tel:258789008",0,47,0,47,0,47,0,120,73,35,12,3,276,1
1,"Alba",3805,10,3805,,"CERGAU",237,"Scoala cu clasele I- VIII ""Aron Cotru"", Sala - clasa a IV a, Cergau Mare, str principala,nr. 166 Tel:258719125",801,590,563,1,26,585,5,878,288,384,201,3,280,0
1,"Alba",3805,10,3805,,"CERGAU",238,"Scoala cu clasele I- IV. Sala- clasa a II a Cergau Mic , nr. 67 Tel:258719046",264,188,165,6,17,186,2,290,102,118,68,3,280,0
1,"Alba",3805,10,3805,,"CERGAU",239,"Scoala cu clasele I-IV, Sala- clasa a III a Lupu, nr. 126 Tel:258716064",227,171,152,5,14,164,7,250,79,128,36,3,280,0
1,"Alba",3805,10,3805,,"CERGAU",240,"Scoala cu clasele I-VIII ""Aron Cotrus"", Sala - clasa a II a, Strada Principala, nr. 166 Tel:258719125",0,77,0,77,0,77,0,120,43,54,23,3,280,1
1,"Alba",3841,10,3841,,"CERU-BACAINTI",241,"Ceru Bacainti, Caminul cultural, nr. 28",261,139,137,2,0,136,3,290,151,95,41,3,284,0
1,"Alba",3841,10,3841,,"CERU-BACAINTI",242,"Ceru Bacainti, Scoala cu clasele V-VIII sala de clasa VIII, nr. 23",0,48,0,48,0,48,0,100,52,35,13,3,284,1
1,"Alba",3958,10,3958,,"CETATEA DE BALTA",243,"Camin cultural Cetatea de Balta , sala de nunti",683,388,364,8,16,376,12,750,362,237,139,3,295,0
1,"Alba",3958,10,3958,,"CETATEA DE BALTA",244,"Camin cultural Cetatea de Balta , sala festiva",840,516,477,2,37,511,5,920,404,311,200,3,295,0
1,"Alba",3958,10,3958,,"CETATEA DE BALTA",245,"Scoala Craciunelu de Sus , sala nr.1",140,110,87,13,10,110,0,150,40,89,21,3,295,0
1,"Alba",3958,10,3958,,"CETATEA DE BALTA",246,"Scoala Sintamarie , sala nr.1",236,144,131,9,4,144,0,260,116,117,27,3,295,0
1,"Alba",3958,10,3958,,"CETATEA DE BALTA",247,"Caminul cultural Tatirlaua",573,307,282,8,17,305,2,630,323,175,130,3,295,0
1,"Alba",3958,10,3958,,"CETATEA DE BALTA",248,"Camin cultural Cetatea de Balta , strada Cetatii, sala de sedinte",0,58,0,58,0,58,0,150,92,43,15,3,295,1
1,"Alba",1071,10,1071,,"CIUGUD",249,"Scoala cu clasele I-VIII Ciugud, strada Principala nr.127  - Sala nr. 5 Tel:0258/841383",438,297,285,6,6,293,4,480,183,136,157,3,300,0
1,"Alba",1071,10,1071,,"CIUGUD",250,"Scoala cu clasele I-IV Limba, strada Principala nr.46 - Sala nr.1",285,213,195,5,13,209,4,310,97,92,117,3,300,0
1,"Alba",1071,10,1071,,"CIUGUD",251,"Scoala cu clasele I-IV Seusa, strada Principala nr. 37A - Sala nr.1",565,393,371,7,15,390,3,620,227,200,190,3,300,0
1,"Alba",1071,10,1071,,"CIUGUD",252,"Gradinita Drambar, strada Principala nr.87-Sala nr.1",310,230,218,6,6,229,1,340,110,98,131,3,300,0
1,"Alba",1071,10,1071,,"CIUGUD",253,"Gradinita Teleac, strada Principala  nr. 7-Sala nr.2",315,255,236,6,13,251,4,350,95,137,114,3,300,0
1,"Alba",1071,10,1071,,"CIUGUD",254,"Scoala cu clasele I-VIII Hapria, strada Principala nr.201 - Sala nr.1 Tel:0258/840388",450,340,321,3,16,335,5,500,160,169,166,3,300,0
1,"Alba",1071,10,1071,,"CIUGUD",255,"Scoala cu clasele I-VIII Ciugud, strada Principala nr.127  - Sala nr.4 Tel:0258/841383",0,98,0,98,0,97,1,200,102,35,62,3,300,1
1,"Alba",4008,10,4008,,"CIURULEASA",256,"Primaria comunei Ciuruleasa, nr. 1, Sala de sedinte Tel:258780605",647,414,407,7,0,408,6,710,296,158,250,3,307,0
1,"Alba",4008,10,4008,,"CIURULEASA",257,"Scoala generala cu claesele I-IV, sat Buninginea nr. 300 A Tel:258784410",410,276,271,5,0,274,2,450,174,139,135,3,307,0
1,"Alba",4008,10,4008,,"CIURULEASA",258,"Scoala generala cu clasele I -VIII, nr. 1A, Laborator matematica",0,65,0,65,0,65,0,120,55,21,44,3,307,1
1,"Alba",4106,10,4106,,"CALNIC",259,"Primaria comunei Cilnic, sala nr.2, strada Principala, nr.20 Tel:258747050",1032,635,627,8,0,624,11,1142,507,429,195,3,273,0
1,"Alba",4106,10,4106,,"CALNIC",260,"Scoala generala Deal, sala nr.2,  nr.132 Tel:258747040",295,183,174,9,0,182,1,320,137,153,29,3,273,0
1,"Alba",4106,10,4106,,"CALNIC",261,"Scoala generala Cilnic, sala ""clasa a VII A"", strada Principala, nr.329, Tel:258747116",0,53,0,53,0,53,0,150,97,38,15,3,273,1
1,"Alba",4188,10,4188,,"CRACIUNELU DE JOS",262,"Primaria Craciunelu de Jos,  cladire administrativa - sala de sedinte Craciunelu de Jos, str 6 Martie, nr. 135",920,652,630,14,8,646,6,1010,358,438,208,3,317,0
1,"Alba",4188,10,4188,,"CRACIUNELU DE JOS",263,"Caminul cultural Craciunelu de Jos, situat in Craciunelu de Jos, strada 6 Martie, nr.192, sala mare",799,614,586,17,11,608,6,880,266,460,148,3,317,0
1,"Alba",4188,10,4188,,"CRACIUNELU DE JOS",264,"Caminul cultural Craciunelu de Jos, situat in Craciunelu de Jos, strada 6 Martie, nr. 192, sala de sedinte",0,74,0,74,0,73,1,150,76,55,18,3,317,1
1,"Alba",4142,10,4142,,"CRICAU",265,"Caminul Cultural Cricau, nr. 318, sala nr. 1 Tel:0258845283",1080,756,728,5,23,752,4,1190,434,423,329,3,319,0
1,"Alba",4142,10,4142,,"CRICAU",266,"Scoala Primara cu cls. I-IV Craiva, nr. 71, sala nr. 1 Tel:0258845007",300,219,214,5,0,219,0,330,111,149,70,3,319,0
1,"Alba",4142,10,4142,,"CRICAU",267,"Scoala Primara cu cls. I-IV Tibru, nr. 98, sala nr. 1 Tel:0258845011",336,233,219,6,8,230,3,371,138,170,60,3,319,0
1,"Alba",4142,10,4142,,"CRICAU",268,"Caminul Cultural Cricau, nr. 318, sala nr. 2",0,80,0,80,0,79,1,120,40,50,29,3,319,1
1,"Alba",9019,10,9019,,"CUT",269,"Scoala Generala cu cls.I-VIII, ,,Septimiu Albini"", strada Principala, nr.226, sala nr.1 Tel:0258745256",1061,614,609,5,0,604,10,1171,557,438,166,3,323,0
1,"Alba",9019,10,9019,,"CUT",270,"Scoala Generala cu cls.I-VIII, ,,Septimiu Albini"", stada Principala, nr.226, sala nr.2",0,41,0,41,0,41,0,120,79,26,15,3,323,1
1,"Alba",4240,10,4240,,"DAIA ROMANA",271,"Primaria comunei Daia Romana, nr.326 - Camera Agricola Tel:0258/763101",1070,544,539,1,4,540,4,1182,638,354,186,3,325,0
1,"Alba",4240,10,4240,,"DAIA ROMANA",272,"Primaria, comunei Daia Romana, nr.326 - Sala de Sedinte Tel:0258/763489",1459,753,747,0,6,748,5,1598,845,465,283,3,325,0
1,"Alba",4240,10,4240,,"DAIA ROMANA",273,"Gradinita de copii, sala, Grupa Mare, nr. 37",0,32,0,32,0,32,0,121,89,17,15,3,325,1
1,"Alba",4268,10,4268,,"DOSTAT",274,"Scoala cu clasele I-VIII Dostat, nr. 235, sala 1 Tel:0258764601",453,254,254,0,0,252,2,500,246,160,92,3,327,0
1,"Alba",4268,10,4268,,"DOSTAT",275,"Scoala cu clasele I-IV Boz, nr. 42, sala 2 Tel:0258764304",323,180,175,5,0,176,4,360,180,110,66,3,327,0
1,"Alba",4268,10,4268,,"DOSTAT",276,"Scoala cu clasele I-VIII Dostat ,  nr. 235, sala 2",0,42,0,42,0,42,0,120,78,22,20,3,327,1
1,"Alba",4302,10,4302,,"FARAU",277,"Gradinita cu program normal, sala 1, Sat Farau",493,304,291,5,8,301,3,540,236,224,77,3,331,0
1,"Alba",4302,10,4302,,"FARAU",278,"Scoala cu clasele I-IV, sala 1, Sat Heria",236,164,152,7,5,162,2,270,106,123,39,3,331,0
1,"Alba",4302,10,4302,,"FARAU",279,"Scoala cu clasele I-IV, sala 1, Sat Sinbenedic",218,160,140,7,13,157,3,250,90,111,46,3,331,0
1,"Alba",4302,10,4302,,"FARAU",280,"Scoala cu clasele I-IV, sala 1, Sat Medves",168,100,92,4,4,99,1,180,80,73,26,3,331,0
1,"Alba",4302,10,4302,,"FARAU",281,"Scoala cu clasele I-IV, Sat Silea",292,195,175,8,12,193,2,330,135,139,54,3,331,0
1,"Alba",4302,10,4302,,"FARAU",282,"Scoala cu clasele I-VIII, sala 1, Sat Farau , str. bisericii,nr 274,Tel:258867113",0,68,0,68,0,68,0,150,82,41,27,3,331,1
1,"Alba",4366,10,4366,,"GALDA DE JOS",283,"Caminul cultural Galda de Jos, sat Galda de Jos, nr. 90",1455,882,875,7,0,877,5,1600,718,513,364,3,337,0
1,"Alba",4366,10,4366,,"GALDA DE JOS",284,"Scoala romana Oiejdea, sat Oiejdea, nr. 291, sala nr. 1",709,345,342,3,0,344,1,780,435,235,109,3,337,0
1,"Alba",4366,10,4366,,"GALDA DE JOS",285,"Scoala generala Mesentea, sat Mesentea, nr. 60, sala nr. 1",184,102,95,7,0,102,0,200,98,62,40,3,337,0
1,"Alba",4366,10,4366,,"GALDA DE JOS",286,"Scoala generala Benic, sat Benic, nr. 32, sala nr. 1",439,309,300,9,0,306,3,480,171,187,119,3,337,0
1,"Alba",4366,10,4366,,"GALDA DE JOS",287,"Scoala generala Cetea, sat Cetea, nr. 3, sala nr. 1",398,233,225,8,0,232,1,443,210,135,97,3,337,0
1,"Alba",4366,10,4366,,"GALDA DE JOS",288,"Scoala generala Galda de Sus, sat Galda de Sus, nr. 89, sala nr. 1",392,198,192,6,0,196,2,430,232,138,58,3,337,0
1,"Alba",4366,10,4366,,"GALDA DE JOS",289,"Scoala generala Poiana Galdei, sat Poiana Galdei, nr. 27, sala nr. 1",139,89,80,9,0,88,1,150,61,73,15,3,337,0
1,"Alba",4366,10,4366,,"GALDA DE JOS",290,"Scoala generala Galda de Jos, sat Galda de Jos, nr. 247, sala nr. 1",0,90,0,90,0,88,2,200,110,55,33,3,337,1
1,"Alba",4482,10,4482,,"GARBOVA",291,"Primaria comunei Girbova , Sala de sedinte, Sat Girbova Tel:258748118",1154,754,714,18,22,742,12,1270,516,520,222,3,349,0
1,"Alba",4482,10,4482,,"GARBOVA",292,"Sediul fostului CAP, Sat Carpinis",243,160,145,8,7,159,1,270,110,79,80,3,349,0
1,"Alba",4482,10,4482,,"GARBOVA",293,"Sediul fostului CAP, Sat Reciu",254,159,150,8,1,157,2,282,123,110,47,3,349,0
1,"Alba",4482,10,4482,,"GARBOVA",294,"Scoala cu clasele I-VIII  Girbova, sala nr.2, Sat GIrbova, cladirea noua, str scolii,nr 79 Tel:258748114",0,59,0,59,0,59,0,120,61,38,21,3,349,1
1,"Alba",4525,10,4525,,"GARDA DE SUS",295,"Scoala generala nr. 1 Girda de Sus, nr. 50A, sala nr. 1 Tel:258778141",907,507,500,7,0,497,10,1000,493,235,262,3,353,0
1,"Alba",4525,10,4525,,"GARDA DE SUS",296,"Scoala generala nr. 2 Ghetar, nr. 228, sala nr. 1 Tel:258778166",446,278,267,11,0,273,5,490,212,191,82,3,353,0
1,"Alba",4525,10,4525,,"GARDA DE SUS",297,"Scoala generala Biharia, nr. 531, sala nr. 1 Tel:258778123",145,91,81,10,0,91,0,161,70,53,38,3,353,0
1,"Alba",4525,10,4525,,"GARDA DE SUS",298,"Scoala generala nr. 1 Girda de Sus, nr. 50A, sala nr. 2",0,42,0,42,0,40,2,150,108,20,20,3,353,1
1,"Alba",4703,10,4703,,"HOPARTA",299,"Caminul Cultural,nr.159,Sala festivitati Tel:0258875713",264,139,133,6,0,136,3,290,151,103,33,3,371,0
1,"Alba",4703,10,4703,,"HOPARTA",300,"Scoala Primara, nr.234,sala nr.1 Spalnaca",181,103,96,7,0,101,2,200,97,61,40,3,371,0
1,"Alba",4703,10,4703,,"HOPARTA",301,"Caminul Cultural,nr.72,Sala festivitati Turdas",184,106,100,6,0,105,1,200,94,68,37,3,371,0
1,"Alba",4703,10,4703,,"HOPARTA",302,"Caminul Cultural,nr.27,Sala festivitati Vama Seaca",166,113,106,7,0,113,0,180,67,82,31,3,371,0
1,"Alba",4703,10,4703,,"HOPARTA",303,"Caminul Cultural, nr.102,Sala festivitati Silivas",177,110,101,9,0,106,4,190,80,79,27,3,371,0
1,"Alba",4703,10,4703,,"HOPARTA",304,"Scoala cu  clasele I-VIII, nr. 22, Laboratorul  informatica",0,50,0,50,0,50,0,120,70,29,21,3,371,1
1,"Alba",4767,10,4767,,"HOREA",305,"Centrul  Cultural ""HCC"" Horea , strada Nicola Vasile Ursu nr.27  -sala mare",667,414,405,7,2,413,1,730,316,310,103,3,377,0
1,"Alba",4767,10,4767,,"HOREA",306,"Caminul cultural  Matisesti",357,280,274,5,1,278,2,390,110,221,57,3,377,0
1,"Alba",4767,10,4767,,"HOREA",307,"Scoala cu clasele I-IV  Dirlesti",376,325,319,6,0,321,4,410,85,260,61,3,377,0
1,"Alba",4767,10,4767,,"HOREA",308,"Scoala cu clasele  I-IV  Giurgiut",119,99,90,9,0,99,0,130,31,82,17,3,377,0
1,"Alba",4767,10,4767,,"HOREA",309,"Scoala cu clasele I-IV  Patrusesti",142,108,100,8,0,108,0,160,52,87,21,3,377,0
1,"Alba",4767,10,4767,,"HOREA",310,"Scoala cu clasele I-IV  Preluca",68,63,52,11,0,63,0,70,7,42,21,3,377,0
1,"Alba",4767,10,4767,,"HOREA",311,"Centrul cultural "" HCC"" Horea, strada Nicola Vasile Ursu nr.27 -sala mica",0,66,0,66,0,65,1,120,54,55,10,3,377,1
1,"Alba",4927,10,4927,,"IGHIU",312,"Primaria Ighiu, Strada Principala, nr. 369, birou fond funciar Tel:0258844103",1092,659,652,7,0,654,5,1200,541,486,168,3,393,0
1,"Alba",4927,10,4927,,"IGHIU",313,"Scoala Generala Ighiel,   nr. 50,  sala clasa a I-a Tel:0258844793",812,457,448,9,0,452,5,890,433,332,120,3,393,0
1,"Alba",4927,10,4927,,"IGHIU",314,"Scoala Generala Bucerdea Vinoasa,nr. 303,  sala de clasa libera Tel:0258844326",792,511,504,5,2,505,6,870,359,391,114,3,393,0
1,"Alba",4927,10,4927,,"IGHIU",315,"Scoala Generala Sard, nr. 386, sala de clasa a II-a A Tel:0258843186",870,551,547,4,0,538,13,959,408,337,201,3,393,0
1,"Alba",4927,10,4927,,"IGHIU",316,"Scoala Generala Sard, nr. 386, sala cu clasa a II-a B Tel:0258843186",932,574,566,8,0,572,2,1028,454,391,181,3,393,0
1,"Alba",4927,10,4927,,"IGHIU",317,"Scoala Generala Telna, nr. 266,  sala cu clasa a II -a si a III-a Tel:0258843692",895,492,481,11,0,486,6,980,488,355,131,3,393,0
1,"Alba",4927,10,4927,,"IGHIU",318,"Scoala Generala nr. 2 Sard,  nr. 386, sala de clasa a III-a Tel:0258843186",0,123,0,123,0,122,1,200,77,81,41,3,393,1
1,"Alba",4981,10,4981,,"INTREGALDE",319,"Scoala generala Intregalde, sala 1",275,125,123,2,0,125,0,300,175,67,58,3,399,0
1,"Alba",4981,10,4981,,"INTREGALDE",320,"Scoala primara Necrilesti, sala 1",176,97,94,3,0,96,1,192,95,61,35,3,399,0
1,"Alba",4981,10,4981,,"INTREGALDE",321,"Scoala primara Dealu-Geoagiului, sala 1",123,48,43,5,0,48,0,140,92,37,11,3,399,0
1,"Alba",4981,10,4981,,"INTREGALDE",322,"Scoala primara Ghioncani, sala 1",79,41,37,4,0,41,0,90,49,20,21,3,399,0
1,"Alba",4981,10,4981,,"INTREGALDE",323,"Caminul cultural Intregalde, nr. 3",0,24,0,24,0,24,0,100,76,7,17,3,399,1
1,"Alba",5103,10,5103,,"JIDVEI",324,"Caminul Cultural Jidvei, sala nr. 1,sat. Jidvei, str. Perilor, nr. 17, Tel:258881270",1004,521,508,11,2,520,1,1100,579,282,238,3,411,0
1,"Alba",5103,10,5103,,"JIDVEI",325,"Scoala Balcaciu sat. Balcaciu, sala nr. 1, str. 1 Decembrie, nr. 65 Tel:258881901",1058,425,418,7,0,421,4,1161,736,257,164,3,411,0
1,"Alba",5103,10,5103,,"JIDVEI",326,"Scoala Capalna de Jos, nr. 28, sala nr. 1 Tel:258881134",657,373,363,10,0,369,4,720,347,213,156,3,411,0
1,"Alba",5103,10,5103,,"JIDVEI",327,"Caminul cultural Feisa, sala nr. 1, nr. 189 Tel:258881508",725,415,407,8,0,407,8,800,385,210,197,3,411,0
1,"Alba",5103,10,5103,,"JIDVEI",328,"Caminul cultural Veseus,  sala nr. 1, nr. 27 Tel:258881585",796,442,432,10,0,426,16,883,441,281,145,3,411,0
1,"Alba",5103,10,5103,,"JIDVEI",329,"Biblioteca comunei Jidvei, sala nr. 1,str. Unirii, nr. 2D",0,69,0,69,0,67,2,200,131,42,25,3,411,1
1,"Alba",5167,10,5167,,"LIVEZILE",330,"Caminul cultural, nr. 59, sala nr. 1, sat Livezile",641,412,406,6,0,405,7,710,298,196,209,3,417,0
1,"Alba",5167,10,5167,,"LIVEZILE",331,"Scoala primara, nr. 26, sala nr. 2, sat Izvoarele",157,85,78,7,0,83,2,169,84,64,19,3,417,0
1,"Alba",5167,10,5167,,"LIVEZILE",332,"Caminul cultural, nr. 141/A, sala nr. 1, sat Poiana Aiudului",329,174,169,5,0,171,3,360,186,83,88,3,417,0
1,"Alba",5167,10,5167,,"LIVEZILE",333,"Scoala primara, nr. 41, sala nr. 1, sat Valisoara",153,85,76,8,1,84,1,170,85,32,52,3,417,0
1,"Alba",5167,10,5167,,"LIVEZILE",334,"Scoala cu clasele I-VIII, Livezile , principala,nr. 186 sala de matematica",0,53,0,53,0,50,3,120,67,19,31,3,417,1
1,"Alba",5210,10,5210,,"LOPADEA NOUA",335,"Sala de sedinte a Primariei, Sala nr.1, Sat  Lopadea Noua",860,411,392,5,14,406,5,950,539,271,135,3,422,0
1,"Alba",5210,10,5210,,"LOPADEA NOUA",336,"Camin Satesc, Sala Nr.1, Sat Asinip",131,86,70,7,9,84,2,140,54,66,18,3,422,0
1,"Alba",5210,10,5210,,"LOPADEA NOUA",337,"Cladirea Primariei, Sala Nr.2, Sat Bagau",484,293,278,9,6,291,2,530,237,216,75,3,422,0
1,"Alba",5210,10,5210,,"LOPADEA NOUA",338,"Scoala Generala I-VIII, Sala Nr. 3, Sat Beta",352,193,179,8,6,191,2,390,197,152,39,3,422,0
1,"Alba",5210,10,5210,,"LOPADEA NOUA",339,"Cladirea Primariei, Sala Nr. 3, Sat Ciuguzel",559,418,398,8,12,414,4,610,192,326,88,3,422,0
1,"Alba",5210,10,5210,,"LOPADEA NOUA",340,"Cladirea Primariei, Sala Nr. 1, Sat Odverem",56,45,34,9,2,44,1,60,15,32,12,3,422,0
1,"Alba",5210,10,5210,,"LOPADEA NOUA",341,"Camin Cultural, Sala Nr. 2, Sat  Lopadea Noua, str principala, nr. 238",0,48,0,48,0,48,0,120,72,41,7,3,422,1
1,"Alba",5309,10,5309,,"LUNCA MURESULUI",342,"Scoala cu clasele I - VIII  "" Simion Lazar""  Lunca Muresului, str. Garii nr. 241 a, sala Tel:258878134",807,419,417,1,1,414,5,892,473,267,147,3,431,0
1,"Alba",5309,10,5309,,"LUNCA MURESULUI",343,"Scoala cu clasele  I - VIII "" Simion Lazar"" Lunca Muresului, str. Garii nr. 241 a, sala 3 Tel:258878134",843,450,445,4,1,440,10,930,480,296,144,3,431,0
1,"Alba",5309,10,5309,,"LUNCA MURESULUI",344,"Scoala Generala cls. I - IV, Gura Ariesului nr. 84, sala nr.4 Tel:258878038",414,259,247,12,0,256,3,460,201,141,115,3,431,0
1,"Alba",5309,10,5309,,"LUNCA MURESULUI",345,"Scoala cu cls. I - VIII "" Simion Lazar"" Lunca Muresului, str. Garii nr. 241 a, sala 4",0,77,0,77,0,77,0,120,43,45,32,3,431,1
1,"Alba",5336,10,5336,,"LUPSA",346,"Caminul Cultural Lupsa, nr. 10, Sala nr.1",681,411,406,5,0,410,1,750,339,217,193,3,434,0
1,"Alba",5336,10,5336,,"LUPSA",347,"Primaria Lupsa (sediul fostei primarii Musca),  nr.28, Sala nr. 1 Tel:258769434",1018,478,469,9,0,474,4,1120,642,243,231,3,434,0
1,"Alba",5336,10,5336,,"LUPSA",348,"Scoala primara Valea Lupsii, nr. 14 Sala nr. 3",764,422,414,8,0,420,2,840,418,258,162,3,434,0
1,"Alba",5336,10,5336,,"LUPSA",349,"Scoala primara Hadarau, sat Hadarau, nr. 19, Sala nr. 1",347,193,187,6,0,191,2,380,187,117,74,3,434,0
1,"Alba",5336,10,5336,,"LUPSA",350,"Caminul Cultural Lupsa, nr. 10, Sala nr.2",0,50,0,50,0,50,0,120,70,17,33,3,434,1
1,"Alba",5577,10,5577,,"METES",351,"Scoala cu clasele I-VIII Metes, Strada Principala nr. 51, Sala 1 Tel:",568,365,360,5,0,361,4,620,255,223,138,3,458,0
1,"Alba",5577,10,5577,,"METES",352,"Scoala cu clasele I-IV  Ampoita, Strada Principala nr. 127, Sala 1 Tel",569,345,331,10,4,342,3,632,287,202,140,3,458,0
1,"Alba",5577,10,5577,,"METES",353,"Scoala cu clasele I-IV Lunca Ampoitei, Strada Principala, nr. 45, Sala 1",214,145,133,12,0,144,1,241,96,127,17,3,458,0
1,"Alba",5577,10,5577,,"METES",354,"Scoala cu clasele I-IV Poiana Ampoiului, Strada Principala, nr. 122, Sala 1 Tel:242",244,143,137,6,0,142,1,273,130,105,37,3,458,0
1,"Alba",5577,10,5577,,"METES",355,"Scoala cu clasele I-IV Presaca Ampoiului, Strada Principala nr. 32, Sala 1 Tel:342",333,253,241,6,6,251,2,370,117,190,61,3,458,0
1,"Alba",5577,10,5577,,"METES",356,"Scoala cu clasele I-VIII Tauti, Strada Principala, nr. 143, Sala 1 Tel:584",577,370,355,9,6,367,3,630,260,238,129,3,458,0
1,"Alba",5577,10,5577,,"METES",357,"Primaria Metes, Strada Principala, nr. 43, Sala de sedinte",0,57,0,57,0,57,0,150,93,33,24,3,458,1
1,"Alba",5700,10,5700,,"MIHALT",358,"Camin cultural Mihalt, nr.368 - hol partea dreapta",1056,656,650,4,2,654,2,1160,504,383,271,3,471,0
1,"Alba",5700,10,5700,,"MIHALT",359,"Camin cultural Mihalt, nr.368 - hol partea stinga",837,537,526,9,2,534,3,920,383,323,211,3,471,0
1,"Alba",5700,10,5700,,"MIHALT",360,"Scoala Generala Cistei, nr.143, sala nr.4 Tel:258718733",519,377,367,10,0,374,3,570,193,119,255,3,471,0
1,"Alba",5700,10,5700,,"MIHALT",361,"Scoala Generala Obreja, nr.169, sala nr.4 Tel:258718031",490,348,333,10,5,347,1,540,192,165,182,3,471,0
1,"Alba",5700,10,5700,,"MIHALT",362,"Camin cultural Mihalt, nr.368, Sala mica",0,108,0,108,0,108,0,200,92,63,45,3,471,1
1,"Alba",5755,10,5755,,"MIRASLAU",363,"Gradinita Miraslau, str. Principala, nr. 29, sala 1",752,409,401,6,2,406,3,830,421,241,165,3,476,0
1,"Alba",5755,10,5755,,"MIRASLAU",364,"Scoala Primara Decea, str. Principala, nr. 18, sala 1",670,374,366,8,0,372,2,740,366,289,83,3,476,0
1,"Alba",5755,10,5755,,"MIRASLAU",365,"Scoala Primara Lopadea Veche, nr. 207, sala 1",278,189,181,8,0,185,4,310,121,125,60,3,476,0
1,"Alba",5755,10,5755,,"MIRASLAU",366,"Scoala Primara Cicau, nr. 109, sala1",129,95,89,6,0,95,0,140,45,71,24,3,476,0
1,"Alba",5755,10,5755,,"MIRASLAU",367,"Scoala Primara Ormenis, nr. 54, sala 1",86,57,50,7,0,56,1,90,33,34,22,3,476,0
1,"Alba",5755,10,5755,,"MIRASLAU",368,"Scoala cu Clasele I-VIII Miraslau, str. Principala, nr. 29, sala 1 Tel:258879042",0,53,0,53,0,53,0,150,97,32,21,3,476,1
1,"Alba",5826,10,5826,,"MOGOS",369,"Primaria comunei Mogos,  nr. 3A , Etajul I, Sala de sedinte",574,263,257,5,1,260,3,630,367,125,135,3,483,0
1,"Alba",5826,10,5826,,"MOGOS",370,"Scoala generala Butesti , nr. 568, Sala de cursuri",77,41,31,10,0,40,1,80,39,24,16,3,483,0
1,"Alba",5826,10,5826,,"MOGOS",371,"Camin cultural  Valea Barnii, nr.377, Sala de spectacole",194,73,66,7,0,71,2,210,137,43,28,3,483,0
1,"Alba",5826,10,5826,,"MOGOS",372,"Camin cultural Mogos, nr. 7A  Sala club",0,40,0,40,0,40,0,120,80,23,17,3,483,1
1,"Alba",6048,10,6048,,"NOSLAC",373,"Primaria Noslac,sala de sedinte,camera nr. 1, Sat Noslac Tel:889101",988,525,511,10,4,518,7,1090,565,361,157,3,505,0
1,"Alba",6048,10,6048,,"NOSLAC",374,"Scoala generala, camera nr. 1, Sat Stina de Mures",357,176,166,10,0,175,1,390,214,122,53,3,505,0
1,"Alba",6048,10,6048,,"NOSLAC",375,"Scoala generala Gabud, camera 3, sat Gabud",208,118,107,11,0,114,4,230,112,76,38,3,505,0
1,"Alba",6048,10,6048,,"NOSLAC",376,"Primaria Noslac, str. principala,nr.78 sala2, Sat Noslac",0,67,0,67,0,67,0,120,53,39,28,3,505,1
1,"Alba",6119,10,6119,,"OCOLIS",377,"Internatul Scolar - Ocolis, sala 1",339,186,169,6,11,184,2,372,186,115,69,3,512,0
1,"Alba",6119,10,6119,,"OCOLIS",378,"Scoala cu clasele I-IV Runc , sala nr. 2",127,95,85,9,1,94,1,140,45,70,24,3,512,0
1,"Alba",6119,10,6119,,"OCOLIS",379,"Tabara de Odihna si Creatie Avram Iancu  ,  bucatarie, sat Lunca Larga",70,57,46,11,0,55,2,80,23,35,20,3,512,0
1,"Alba",6119,10,6119,,"OCOLIS",380,"Scoala cu clasele I-IV Vidolm , sala nr. 1",80,61,56,5,0,59,2,90,29,33,26,3,512,0
1,"Alba",6119,10,6119,,"OCOLIS",381,"Scoala cu clasele I-IV  Vidolm  , sala nr. 2",0,51,0,51,0,51,0,120,69,37,14,3,512,1
1,"Alba",6164,10,6164,,"OHABA",382,"Sediul Consiliului Local Ohaba, strada Viilor, nr.188 , sala de sedinte, camera nr. 1",451,305,260,6,39,298,7,501,196,169,129,3,517,0
1,"Alba",6164,10,6164,,"OHABA",383,"Sediul fostului CAP Secasel, nr. 123 - fara destinatie, Intrarea principala, sala tempora de lucru nr.1",208,151,131,9,11,147,4,230,79,111,36,3,517,0
1,"Alba",6164,10,6164,,"OHABA",384,"Scoala Generala Colibi, nr.10, sala nr.1",40,37,26,10,1,36,1,50,13,28,8,3,517,0
1,"Alba",6164,10,6164,,"OHABA",385,"Scoala Generala Ohaba, clasele I-VIII , nr.305, sala de clasa nr. 1",0,108,0,108,0,108,0,150,42,78,30,3,517,1
1,"Alba",6217,10,6217,,"PIANU",386,"Caminul cultural, Strada Principala, NR.237, Sala de Club Tel:0258/761208",1367,760,748,2,10,751,9,1500,740,569,182,3,522,0
1,"Alba",6217,10,6217,,"PIANU",387,"Scoala generala I-IV, Strada Horea, Nr. 165A, Sala Nr. 1 Tel:0258/761208, sat Pianu de Jos",1038,517,507,9,1,517,0,1140,623,297,220,3,522,0
1,"Alba",6217,10,6217,,"PIANU",388,"Scoala generala , Strada Principala, NR.22, Sala Nr. 1 Tel:0258/761208 Sat Strungari",174,129,119,10,0,128,1,190,61,89,39,3,522,0
1,"Alba",6217,10,6217,,"PIANU",389,"Scoala generala, Strada Principala, NR.36, Sala Nr. 1 Tel:0258/761208 Sat Purcareti",247,105,98,7,0,105,0,271,166,88,17,3,522,0
1,"Alba",6217,10,6217,,"PIANU",390,"Scoala generala, Strada Principala, Nr. 11, Sala Nr. 1 Tel:0258/761208 , sat Plaiuri",48,34,25,9,0,33,1,50,16,24,9,3,522,0
1,"Alba",6217,10,6217,,"PIANU",391,"Caminul cultural, Strada Principala, NR.237,  Sala mare Tel:0258/761208",0,82,0,82,0,82,0,150,68,55,27,3,522,1
1,"Alba",6271,10,6271,,"POIANA VADULUI",392,"Caminul Cultural Poiana Vadului,  nr.27B, Sala 1, partea dreapta, Tel:0258/785647",956,497,477,7,13,492,5,1050,553,354,138,3,528,0
1,"Alba",6271,10,6271,,"POIANA VADULUI",393,"Caminul Cultural  Poiana Vadului, nr.27B, Sala 1",0,29,0,29,0,29,0,120,91,17,12,3,528,1
1,"Alba",6397,10,6397,,"PONOR",394,"Primaria comunei Ponor, str. Principala, nr.84 - Camera Viceprimar Tel:0258/867503",322,218,203,4,11,214,4,350,132,114,100,3,540,0
1,"Alba",6397,10,6397,,"PONOR",395,"Camin cultural, sala spectacol, sat Geogel",200,130,116,8,6,130,0,220,90,74,56,3,540,0
1,"Alba",6397,10,6397,,"PONOR",396,"Scoala generala cu clasele I-VIII , nr. 83, sala nr.1",0,88,0,88,0,88,0,120,32,54,34,3,540,1
1,"Alba",6468,10,6468,,"POSAGA",397,"Caminul cultural Posaga de Jos, sala 1",407,201,197,3,1,197,4,450,249,118,79,3,547,0
1,"Alba",6468,10,6468,,"POSAGA",398,"Scoala generala Lunca Ariesului, sala nr.1",142,75,68,7,0,74,1,160,85,44,30,3,547,0
1,"Alba",6468,10,6468,,"POSAGA",399,"Scoala generala Orasti,sala nr. 1",111,60,52,8,0,59,1,120,60,31,28,3,547,0
1,"Alba",6468,10,6468,,"POSAGA",400,"Caminul cultural Posaga de Sus, sala nr.1",159,85,80,5,0,84,1,170,85,38,46,3,547,0
1,"Alba",6468,10,6468,,"POSAGA",401,"Scoala generala Sagagea, sala nr.1",239,143,134,9,0,142,1,260,117,101,41,3,547,0
1,"Alba",6468,10,6468,,"POSAGA",402,"Caminul cultural Posaga de Jos, sala nr.3",0,35,0,35,0,34,1,120,85,20,14,3,547,1
1,"Alba",6547,10,6547,,"RADESTI",403,"Scoala generala cu clasele I-VIII, satul Radesti, nr.22, sala nr.2",607,385,377,5,3,380,5,671,286,90,290,3,555,0
1,"Alba",6547,10,6547,,"RADESTI",404,"Scoala generala cu claseleI-IV, satul Leorint, nr.25, sala nr.1",263,184,175,9,0,182,2,290,106,105,77,3,555,0
1,"Alba",6547,10,6547,,"RADESTI",405,"Scoala cu clasele I-IV, satul Mescreac, nr.125, sala nr.1",265,167,157,10,0,166,1,290,123,115,51,3,555,0
1,"Alba",6547,10,6547,,"RADESTI",406,"Scoala generala cu clasele I-VIII, satul Radesti, nr.22, sala nr.1",0,83,0,83,0,83,0,120,37,30,53,3,555,1
1,"Alba",6592,10,6592,,"RAMETEA",407,"Caminul Cultural Rimetea, nr. 286, sala "" TELE HAZS """,489,186,183,3,0,181,5,540,354,134,47,3,574,0
1,"Alba",6592,10,6592,,"RAMETEA",408,"Scoala generala Coltesti, sat Coltesti, nr. 215, Sala de clasa nr. 2",487,212,206,6,0,210,2,540,328,159,51,3,574,0
1,"Alba",6592,10,6592,,"RAMETEA",409,"Scoala generala Coltesti,  sat Coltesti, nr. 215, Sala de clasa nr. 1",0,25,0,25,0,25,0,120,95,17,8,3,574,1
1,"Alba",6627,10,6627,,"RAMET",410,"Primaria comunei Rimet,Strada Principala,nr.1,Sala de sedinte Tel:0258/880010",226,132,118,5,9,127,5,250,118,67,60,3,560,0
1,"Alba",6627,10,6627,,"RAMET",411,"Scoala generala cu clasele I-VIII, Strada Principala, nr.1, Sala de clasa nr.1, sat Bradesti",114,86,72,9,5,84,2,130,44,11,73,3,560,0
1,"Alba",6627,10,6627,,"RAMET",412,"Scoala generala cu clasele I-VIII , Strada Principala, nr.1, Sala de clasa nr.1 sat Valea Inzelului",107,75,59,5,11,75,0,120,45,41,34,3,560,0
1,"Alba",6627,10,6627,,"RAMET",413,"Scoala generala cu clasele I-VIII , Strada Principala, nr.1, Sala de clasa nr.1, sat Valea Manastirii",168,139,116,7,16,128,11,180,41,83,45,3,560,0
1,"Alba",6627,10,6627,,"RAMET",414,"Scoala generala cu clasele I-VIII , Strada Principala, nr.3, Sala de clasa nr.1, sat Ramet",0,37,0,37,0,37,0,150,113,21,16,3,560,1
1,"Alba",6761,10,6761,,"ROSIA MONTANA",415,"Cladirea Primariei  - sala de sedinte, camera 1, Sat Rosia Montana",885,447,437,8,2,444,3,972,525,278,166,3,581,0
1,"Alba",6761,10,6761,,"ROSIA MONTANA",416,"Cladirea Locuinte sociale, camera 1, Sat Carpinis",1240,845,833,9,3,833,12,1360,515,536,297,3,581,0
1,"Alba",6761,10,6761,,"ROSIA MONTANA",417,"Cladirea scolii cu clasele I-IV, camera 1, Sat Corna",229,149,141,8,0,148,1,250,101,71,77,3,581,0
1,"Alba",6761,10,6761,,"ROSIA MONTANA",418,"Sala Caminului Cultural Virtop, camera 1, Sat Virtop",180,103,95,8,0,103,0,200,97,55,48,3,581,0
1,"Alba",6761,10,6761,,"ROSIA MONTANA",419,"Cladire Locuinte sociale, Sat Carpinis",0,78,0,78,0,77,1,150,72,41,36,3,581,1
1,"Alba",6930,10,6930,,"ROSIA DE SECAS",420,"Caminul Cultural, Bucatarie, Sat Rosia de Secas nr.119",619,391,367,9,15,388,3,680,289,261,127,3,577,0
1,"Alba",6930,10,6930,,"ROSIA DE SECAS",421,"Sediul Primariei Rosia de Secas,  Sala 1, Sat Tau nr.357",387,204,190,7,7,202,2,430,226,108,94,3,577,0
1,"Alba",6930,10,6930,,"ROSIA DE SECAS",422,"Caminul Cultural, Sala 1, Sat Ungurei nr.217",265,158,151,7,0,157,1,290,132,87,70,3,577,0
1,"Alba",6930,10,6930,,"ROSIA DE SECAS",423,"Caminul Cultural, sat Rosia de Secas nr.119, etaj 1, Sala de protocol",0,56,0,56,0,56,0,120,64,32,24,3,577,1
1,"Alba",6976,10,6976,,"SALCIUA",424,"Scoala primara cu clasele  I - IV,  sat Salciua de Jos nr. 130, sala nr.1",795,503,487,8,8,495,8,872,369,245,250,3,598,0
1,"Alba",6976,10,6976,,"SALCIUA",425,"Scoala primara cu  clasele I -I V,   sat  Salciua de Sus nr. 318, sala nr.1",635,388,373,6,9,384,4,700,312,253,131,3,598,0
1,"Alba",6976,10,6976,,"SALCIUA",426,"Scoala primara cu clasele  I-IV -  sat Salciua de Jos nr. 130,Sala nr.2",0,125,0,125,0,125,0,220,95,101,24,3,598,1
1,"Alba",7044,10,7044,,"SALISTEA",427,"Caminul Cultural Salistea, Str Joseni nr. 449, sala nr. 1 Tel:258762167",1022,674,640,9,25,667,7,1120,446,334,333,3,605,0
1,"Alba",7044,10,7044,,"SALISTEA",428,"Scoala Generala Tartaria., Str. Principala, nr. 34, sala nr. 1 Tel:258762402",579,410,392,5,13,410,0,640,230,207,203,3,605,0
1,"Alba",7044,10,7044,,"SALISTEA",429,"Scoala Generala , Margineni  , sala nr. 1, SAT Margineni",59,35,26,9,0,35,0,60,25,27,8,3,605,0
1,"Alba",7044,10,7044,,"SALISTEA",430,"Scoala Generala Salistea Deal,  nr. 80, sala nr. 1",219,142,131,11,0,140,2,240,98,59,81,3,605,0
1,"Alba",7044,10,7044,,"SALISTEA",431,"Primaria Salistea,  str. Joseni, nr. 447, camera agricola",0,94,0,94,0,93,1,151,57,55,38,3,605,1
1,"Alba",7099,10,7099,,"SASCIORI",432,"Scoala Sasciori ,nr.380, sala nr.1 Tel:0258/741213",1310,728,719,9,0,720,8,1440,712,490,230,3,620,0
1,"Alba",7099,10,7099,,"SASCIORI",433,"Scoala Capilna, nr.12, sala nr.1 Tel:0258/741597",674,387,379,8,0,387,0,740,353,315,72,3,620,0
1,"Alba",7099,10,7099,,"SASCIORI",434,"Scoala Laz nr.49,sala nr. 1",341,213,205,8,0,210,3,380,167,153,57,3,620,0
1,"Alba",7099,10,7099,,"SASCIORI",435,"Fosta Primarie Loman nr.24, actualmente gradinita",698,337,327,10,0,333,4,770,433,284,49,3,620,0
1,"Alba",7099,10,7099,,"SASCIORI",436,"Scoala Rachita nr.31, sala nr. 1 Tel:0258/741007",622,474,465,9,0,471,3,680,206,398,73,3,620,0
1,"Alba",7099,10,7099,,"SASCIORI",437,"Scoala Sebesel nr.264, sala nr. 1",953,597,588,9,0,589,8,1050,453,466,123,3,620,0
1,"Alba",7099,10,7099,,"SASCIORI",438,"Scoala Sasciori , strada Principala, nr.380,sala de clasa a-VIII-a Tel:0258/741213",0,51,0,51,0,51,0,120,69,31,20,3,620,1
1,"Alba",7197,10,7197,,"SCARISOARA",439,"Camin cultural Scarisoara, Sat Scarisoara nr.202 Tel:258778503",680,397,376,7,14,391,6,760,363,153,238,3,630,0
1,"Alba",7197,10,7197,,"SCARISOARA",440,"Scoala Generala clasele I-IV, sala nr.1, Sat Stiuleti",137,103,90,11,2,100,3,150,47,53,47,3,630,0
1,"Alba",7197,10,7197,,"SCARISOARA",441,"Scoala Generala clasele I-IV, sala nr.1, Sat Runc",166,120,105,10,5,118,2,190,70,56,62,3,630,0
1,"Alba",7197,10,7197,,"SCARISOARA",442,"Scoala Generala clasele I-IV ,sala nr.1,  Sat Negesti",160,111,98,12,1,111,0,180,69,57,54,3,630,0
1,"Alba",7197,10,7197,,"SCARISOARA",443,"Scoala Generala clasele I-VIII, sala nr.1, Sat  Lazesti Tel:258778588",169,120,105,11,4,119,1,190,70,65,54,3,630,0
1,"Alba",7197,10,7197,,"SCARISOARA",444,"Scoala Generala clasele I-IV, sala nr.1, Sat Fata Lazesti",72,55,46,8,1,55,0,80,25,22,33,3,630,0
1,"Alba",7197,10,7197,,"SCARISOARA",445,"Scoala Generala clasele I-IV,  sala nr.1, Sat Sfoartea",54,54,45,8,1,54,0,60,6,18,36,3,630,0
1,"Alba",7197,10,7197,,"SCARISOARA",446,"Scoala Generala , sala nr.1, Sat Scarisoara, nr.194",0,51,0,51,0,51,0,150,99,15,36,3,630,1
1,"Alba",7348,10,7348,,"SANCEL",447,"Caminul Cultural Sincel,strada.M.Eminescu, nr.49-sala nr.1 Tel:258885254",1364,828,808,4,16,821,7,1500,672,542,279,3,610,0
1,"Alba",7348,10,7348,,"SANCEL",448,"Scoala Generala Iclod, nr. 85 ,sala nr. 1 Tel:258885340",333,151,146,5,0,149,2,370,219,105,44,3,610,0
1,"Alba",7348,10,7348,,"SANCEL",449,"Scoala Generala Panade, nr. 293, sala nr. 2 Tel:258885485",527,348,342,3,3,347,1,580,232,228,119,3,610,0
1,"Alba",7348,10,7348,,"SANCEL",450,"Caminul Cultural Sincel,strada M.Eminescu nr.49-sala nr.2",0,52,0,52,0,52,0,120,68,27,25,3,610,1
1,"Alba",7384,10,7384,,"SANTIMBRU",451,"Caminul Cultural Sintimbru, strada  Blajului, nr. 187, Sala 1 Tel:0258/842101",1517,911,874,7,30,903,8,1702,791,686,217,3,614,0
1,"Alba",7384,10,7384,,"SANTIMBRU",452,"Scoala Primara Coslariu, strada  Blajului, nr. 85, Sala 1",337,233,210,9,14,233,0,371,138,141,92,3,614,0
1,"Alba",7384,10,7384,,"SANTIMBRU",453,"Scoala Primara Totoi, nr. 168A, Sala 2 Tel:0258/842440",441,265,248,4,13,263,2,490,225,174,89,3,614,0
1,"Alba",7384,10,7384,,"SANTIMBRU",454,"Scoala Primara Dumitra, nr. 97, Sala 1",95,74,64,10,0,73,1,100,26,51,22,3,614,0
1,"Alba",7384,10,7384,,"SANTIMBRU",455,"Caminul Cultural Sintimbru, strada  Blajului, nr. 187, Sala 1",0,70,0,70,0,70,0,150,80,46,24,3,614,1
1,"Alba",7446,10,7446,,"SOHODOL",456,"Caminul Cultural Sohodol, sat Sohodol, nr. 1, Corp  B camin",1031,526,525,1,0,517,9,1130,604,246,271,3,650,0
1,"Alba",7446,10,7446,,"SOHODOL",457,"Scoala Generala cu clasele I - IV Peles, sat Peles, sala 1",407,209,200,9,0,206,3,450,241,125,81,3,650,0
1,"Alba",7446,10,7446,,"SOHODOL",458,"Scoala Generala cu clasele I - IV Poiana, sala 1",158,63,53,10,0,61,2,171,108,33,28,3,650,0
1,"Alba",7446,10,7446,,"SOHODOL",459,"Scola Generala cu clasele I - VIII Sohodol, nr. 2 sala de sport",0,34,0,34,0,34,0,120,86,15,19,3,650,1
1,"Alba",7767,10,7767,,"STREMT",460,"Scoala cu clasele I-VIII Stremt, Strada Principala, nr. 97, sala 1 Tel:0258/848123",1156,714,700,5,9,707,7,1270,556,375,332,3,697,0
1,"Alba",7767,10,7767,,"STREMT",461,"Scoala cu clasele  I-VIII Geoagiu de Sus,  nr. 276, sala 1 Tel:0258/848218",686,383,374,9,0,380,3,750,367,183,197,3,697,0
1,"Alba",7767,10,7767,,"STREMT",462,"Scoala cu clasele I-IV Geomal,  nr. 183, sala 1 Tel:0258/848210",330,228,222,5,1,227,1,360,132,112,115,3,697,0
1,"Alba",7767,10,7767,,"STREMT",463,"Scoala cu clasele I-VIII Stremt, str. Principala nr. 97, sala 2 Tel:0258/848123",0,127,0,127,0,127,0,250,123,61,66,3,697,1
1,"Alba",7810,10,7810,,"SIBOT",464,"Camunul Cultural, str. Principala, nr. 38 A, sala mare",1151,737,685,9,43,726,11,1270,533,438,288,3,645,0
1,"Alba",7810,10,7810,,"SIBOT",465,"Camunul Cultural, str. Principala, nr. 85, sala mare, sat Balomir",546,327,319,3,5,323,4,600,273,200,123,3,645,0
1,"Alba",7810,10,7810,,"SIBOT",466,"Camunul Cultural, str. Principala, nr. 81, sala mare, sat Bacainti",240,147,129,5,13,146,1,260,113,88,58,3,645,0
1,"Alba",7810,10,7810,,"SIBOT",467,"Scoala clasele I - IV, str. Principala, sala nr. 1, sat Saracsau",176,101,96,5,0,101,0,190,89,74,27,3,645,0
1,"Alba",7810,10,7810,,"SIBOT",468,"Scoala cu cls I - VIII Iosif Sirbu  str. Principala, nr. 151, sala mare",0,126,0,126,0,125,1,200,74,77,48,3,645,1
1,"Alba",7865,10,7865,,"SONA",469,"Scoala cu clasele I-VIII, sala nr.1, Sona,  STRADA 23 August, nr 2,",1007,497,488,9,0,490,7,1110,613,292,198,3,682,0
1,"Alba",7865,10,7865,,"SONA",470,"Sala de sport, Biia",995,599,590,9,0,592,7,1090,491,393,199,3,682,0
1,"Alba",7865,10,7865,,"SONA",471,"Gradinita GPM sala nr.1, Sinmiclaus,  STRADA Principala, nr.5",1133,576,565,11,0,566,10,1250,674,413,153,3,682,0
1,"Alba",7865,10,7865,,"SONA",472,"Scoala cu clasele I-IV,  sala nr.1, Lunca  Tirnavei, nr.40",359,207,202,5,0,204,3,390,183,120,84,3,682,0
1,"Alba",7865,10,7865,,"SONA",473,"Caminul cultural Alecus",160,61,52,9,0,59,2,180,119,28,31,3,682,0
1,"Alba",7865,10,7865,,"SONA",474,"Scoala cu clasele I-VIII, sala nr.2, Sona, STRADA 23 August, nr 2",0,41,0,41,0,41,0,120,79,27,14,3,682,1
1,"Alba",7945,10,7945,,"SPRING",475,"Primaria comunei Spring, str.Dostatului,nr.94, sala de sedinte Tel:258765019",591,455,422,3,30,449,6,680,225,263,186,3,690,0
1,"Alba",7945,10,7945,,"SPRING",476,"Scoala cu clasele I-VIII Cunta, str. Principala nr. 32,sala nr.1 Tel:258764224",473,325,307,6,12,323,2,520,195,221,102,3,690,0
1,"Alba",7945,10,7945,,"SPRING",477,"Scoala cu clasele I-VIII Drasov, str.Principala, nr. 98,sala nr.2 Tel:258764020",428,287,269,7,11,285,2,470,183,152,133,3,690,0
1,"Alba",7945,10,7945,,"SPRING",478,"Primaria comunei Spring, sediu administrativ Vingard,str.Principala nr.393, birou agricol Tel:258766112",580,334,310,9,15,327,7,640,306,196,131,3,690,0
1,"Alba",7945,10,7945,,"SPRING",479,"Scoala cu clasele I-VIII Spring, str.Principala, nr. 334, sala nr.1 Tel:258765125",0,138,0,138,0,138,0,200,62,80,58,3,690,1
1,"Alba",8014,10,8014,,"SUGAG",480,"Primaria comunei Sugag, nr. 232, Sala de sedinte a C.L. Sugag Tel:0258/746177",1483,885,882,3,0,871,14,1600,715,627,244,3,702,0
1,"Alba",8014,10,8014,,"SUGAG",481,"Scoala cu clasele I-IV Dobra, nr. 63, Sala nr. 3",452,276,269,7,0,274,2,500,224,220,54,3,702,0
1,"Alba",8014,10,8014,,"SUGAG",482,"Scoala cu clasele I-IV Martinie, nr. 19, Sala nr. 1",418,299,291,8,0,298,1,460,161,238,60,3,702,0
1,"Alba",8014,10,8014,,"SUGAG",483,"Cladire Expozitie etnografica,Sugag, nr. 232 B, Sala nr. 1",0,93,0,93,0,91,2,200,107,60,31,3,702,1
1,"Alba",8158,10,8158,,"UNIREA",484,"Scoala Generala ""Avram Iancu"" , str.Avram Iancu nr.76, Sala nr.1",1089,454,448,5,1,451,3,1200,746,258,193,3,710,0
1,"Alba",8158,10,8158,,"UNIREA",485,"Scoala Generala "" Avram Iancu"" , str.Avram Iancu nr.76, sala nr.4",836,374,360,10,4,369,5,920,546,227,142,3,710,0
1,"Alba",8158,10,8158,,"UNIREA",486,"Scoala Generala  ""Gheorghe Maier"" , str.Scolii nr.1142, sala nr.1, sat Unirea",1209,648,620,28,0,635,13,1330,682,402,233,3,710,0
1,"Alba",8158,10,8158,,"UNIREA",487,"Scoala Generala, Sala nr.1, Satul Inoc",196,105,96,9,0,104,1,220,115,59,45,3,710,0
1,"Alba",8158,10,8158,,"UNIREA",488,"Scoala Generala, Sala nr.1, Satul Ciugudul de Jos",289,157,149,8,0,156,1,320,163,98,58,3,710,0
1,"Alba",8158,10,8158,,"UNIREA",489,"Scoala Generala, Sala nr.1 , Satul Ciugudul de Sus",136,91,77,14,0,89,2,150,59,61,28,3,710,0
1,"Alba",8158,10,8158,,"UNIREA",490,"Scoala Generala, Sala nr.1 , Satul Dumbrava",292,172,162,10,0,169,3,320,148,95,74,3,710,0
1,"Alba",8158,10,8158,,"UNIREA",491,"Scoala Generala, Sala nr.1 , Satul Mahaceni",280,123,112,9,2,122,1,280,157,90,32,3,710,0
1,"Alba",8158,10,8158,,"UNIREA",492,"Scoala Generala ""Avram Iancu"" str.Avram Iancu nr.76, Sala nr.3",0,129,0,129,0,126,3,200,71,72,54,3,710,1
1,"Alba",8229,10,8229,,"VADU MOTILOR",493,"Camin cultural, Sala de spectacole, nr.1, Sat Vadu Motilor Tel:258777505",1160,659,659,0,0,651,8,1280,621,365,286,3,717,0
1,"Alba",8229,10,8229,,"VADU MOTILOR",494,"Camin cultural, Sala de spectacole, nr.2, Sat Vadu Motilor",0,41,0,41,0,41,0,150,109,20,21,3,717,1
1,"Alba",8354,10,8354,,"VALEA LUNGA",495,"Sediul Primariei, strada Victoriei, nr. 328 B, Sala-Registrul agricol Tel:0258/888102",1513,816,804,11,1,806,10,1600,784,553,253,3,730,0
1,"Alba",8354,10,8354,,"VALEA LUNGA",496,"Camin cultural, strada  Principala, nr. 16, sala mare, Stul Lunca",363,239,227,12,0,238,1,400,161,163,75,3,730,0
1,"Alba",8354,10,8354,,"VALEA LUNGA",497,"Scoala, nr. 56, sala nr. 1, Satul Lodroman",186,133,122,11,0,132,1,201,68,103,29,3,730,0
1,"Alba",8354,10,8354,,"VALEA LUNGA",498,"Scoala, strada  Principala, nr. 9, sala nr. 1 , Satul Glogovet",145,100,90,10,0,99,1,160,60,74,25,3,730,0
1,"Alba",8354,10,8354,,"VALEA LUNGA",499,"Scoala, nr. 118, sala nr. 1 Stul Tauni",289,218,204,14,0,216,2,320,102,172,44,3,730,0
1,"Alba",8354,10,8354,,"VALEA LUNGA",500,"Scoala, nr. 54, sala nr .1 , satul Faget",36,32,22,10,0,32,0,40,8,26,6,3,730,0
1,"Alba",8354,10,8354,,"VALEA LUNGA",501,"Sediul Caminului cultural, strada  Victoriei, nr. 305, sala mare",0,76,0,76,0,76,0,120,44,47,29,3,730,1
1,"Alba",8425,10,8425,,"VIDRA",502,"Sediul Primariei Vidra ,Localitatea  Vidra, sat  Vidra, nr.1, Sala 1 Tel:0258/785615",357,229,223,6,0,223,6,390,161,162,61,3,737,0
1,"Alba",8425,10,8425,,"VIDRA",503,"Scoala Primara Goiesti , Localitatea  Vidra, sat Goiesti, nr.251,Sala 1 Tel:0258/786583",319,197,191,6,0,197,0,350,153,152,45,3,737,0
1,"Alba",8425,10,8425,,"VIDRA",504,"Fostul sediu al Primariei Ponorel (sala de sedinte publice), Localitatea Vidra, sat Ponorel, nr. 699A, Sala 1,Tel:786712",834,547,542,5,0,538,9,920,373,284,254,3,737,0
1,"Alba",8425,10,8425,,"VIDRA",505,"Camin Cultural ,Localitatea Vidra, sat Lunca Bisericii, nr. 35, Sala 1, CP 517848",0,61,0,61,0,61,0,120,59,35,26,3,737,1
1,"Alba",8826,10,8826,,"VINTU DE JOS",506,"Camin cultural Vintu de Jos,Strada Lucian Blaga, nr. 20; sala de festivittai;",1061,613,598,14,1,610,3,1150,537,372,238,3,777,0
1,"Alba",8826,10,8826,,"VINTU DE JOS",507,"Scoala cu clasele I-IV Iuliu Maniu, Vintu de Jos, Strada Mihai Eminescu, nr. 12, sala clasei a IV;",1225,639,626,13,0,634,5,1350,711,409,225,3,777,0
1,"Alba",8826,10,8826,,"VINTU DE JOS",508,"Casa Parohiala Sibiseni, Strada  Sibiseni, nr. 51;sala mare;",569,312,304,7,1,308,4,630,318,200,108,3,777,0
1,"Alba",8826,10,8826,,"VINTU DE JOS",509,"Camin cultural Vurpar,sat Vurpar, nr. 112;sala de festivitati;",838,491,477,14,0,487,4,920,429,354,133,3,777,0
1,"Alba",8826,10,8826,,"VINTU DE JOS",510,"Camin Cultural Mereteu,sat Mereteu, nr. 23;sala de festivitati;",161,120,111,9,0,120,0,180,60,86,34,3,777,0
1,"Alba",8826,10,8826,,"VINTU DE JOS",511,"Scoala Generala Valea Vintului,sat Valea Vintului, nr.117;sala clasei a III-a;",315,178,170,8,0,176,2,351,173,115,61,3,777,0
1,"Alba",8826,10,8826,,"VINTU DE JOS",512,"Scoala Primara Inuri, sat Inuri nr. 121;sala 1;",205,66,56,10,0,65,1,226,160,47,18,3,777,0
1,"Alba",8826,10,8826,,"VINTU DE JOS",513,"Gara CFR, Vintu de Jos, sala de asteptare, clasa I, Strada Garii nr. 105",0,121,0,121,0,121,0,300,179,72,49,3,777,1
2,"Arad",9262,29,9262,,"MUNICIPIUL ARAD",1,"COLEGIUL ECONOMIC,  STR.GEORGE ENESCU, NR.2",1086,567,552,15,0,562,5,1200,633,319,243,1,797,0
2,"Arad",9262,29,9262,,"MUNICIPIUL ARAD",2,"HOLUL POLICLINICII MUNICIPALE, B-DUL REVOLUTIEI, NR.45 ( B-DUL REPUBLICII)",1443,800,790,10,0,795,5,1600,800,414,381,1,797,0
2,"Arad",9262,29,9262,,"MUNICIPIUL ARAD",3,"SPITALUL CLINIC MUNICIPAL ARAD, SECTIA ORL,  SALA DE SEDINTE, STR. TUDOR VLADIMIRESCU, NR.1",1405,779,764,15,0,768,11,1598,819,365,403,1,797,0
2,"Arad",9262,29,9262,,"MUNICIPIUL ARAD",4,"SCOALA GENERALA NR.4 , B-DUL STEFAN AUGUSTIN DOINAS, NR.33-37",1500,841,837,4,0,834,7,1701,860,451,383,1,797,0
2,"Arad",9262,29,9262,,"MUNICIPIUL ARAD",5,"SCOALA GENERALA NR.4 , B-DUL STEFAN AUGUSTIN DOINAS, NR.33-37",1355,774,763,11,0,767,7,1500,726,393,374,1,797,0
2,"Arad",9262,29,9262,,"MUNICIPIUL ARAD",6,"SCOALA GENERALA NR.4 , B-DUL STEFAN AUGUSTIN DOINAS, NR.33-37",1112,646,633,13,0,640,6,1200,554,365,275,1,797,0
2,"Arad",9262,29,9262,,"MUNICIPIUL ARAD",7,"SCOALA GENERALA NR.4 , B-DUL STEFAN AUGUSTIN DOINAS, NR.33-37",1141,629,617,12,0,616,13,1301,672,310,306,1,797,0
2,"Arad",9262,29,9262,,"MUNICIPIUL ARAD",8,"LICEUL TEORETIC ""VASILE GOLDIS"", CALEA VICTORIEI, NR. 3-5",1634,931,923,6,2,915,16,1800,869,478,437,1,797,0
2,"Arad",9262,29,9262,,"MUNICIPIUL ARAD",9,"LICEUL DE ARTA ""SABIN DRAGOI"", B-DUL REVOLUTIEI 20-22 (B-DUL REPUBLICII)",1164,649,642,7,0,644,5,1300,651,349,295,1,797,0
2,"Arad",9262,29,9262,,"MUNICIPIUL ARAD",10,"LICEUL DE ARTA ""SABIN DRAGOI"", B-DUL REVOLUTIEI 20-22 (B-DUL REPUBLICII)",1403,762,749,12,1,756,6,1600,838,385,371,1,797,0
2,"Arad",9262,29,9262,,"MUNICIPIUL ARAD",11,"GRUP SCOLAR INDUSTRIAL TRANSPORTURI CAI FERATE, PIATA ACADEMICIAN CAIUS IACOB, NR.1 (V.ROAITA)",1511,851,828,23,0,844,7,1700,849,443,401,1,797,0
2,"Arad",9262,29,9262,,"MUNICIPIUL ARAD",12,"LICEUL BAPTIST, STR. DR. I. SUCIU, NR.7-9 (MAIAKOVSKI)",999,595,587,8,0,586,9,1100,505,293,293,1,797,0
2,"Arad",9262,29,9262,,"MUNICIPIUL ARAD",13,"LICEUL BAPTIST, STR. DR. I. SUCIU, NR.7-9 (MAIAKOVSKI)",1168,647,638,9,0,635,12,1300,653,306,329,1,797,0
2,"Arad",9262,29,9262,,"MUNICIPIUL ARAD",14,"GRUP SCOLAR INDUSTIRIAL ""IULIU MANIU"", B-DUL IULIU MANIU, NR. 39-41 (CALEA ARMATEI ROSII, CALEA RADNEI)",1610,892,874,18,0,883,9,1800,908,503,380,1,797,0
2,"Arad",9262,29,9262,,"MUNICIPIUL ARAD",15,"SALA POLIVALENTA, PIATA SPORTURILOR",1052,665,656,9,0,662,3,1200,535,339,323,1,797,0
2,"Arad",9262,29,9262,,"MUNICIPIUL ARAD",16,"SALA POLIVALENTA, PIATA SPORTURILOR",1024,641,633,8,0,629,12,1100,459,361,268,1,797,0
2,"Arad",9262,29,9262,,"MUNICIPIUL ARAD",17,"UNIVERSITATEA ""AUREL VLAICU"", MICALACA, ZONA 300",1356,727,715,12,0,718,9,1500,773,455,263,1,797,0
2,"Arad",9262,29,9262,,"MUNICIPIUL ARAD",18,"UNIVERSITATEA ""AUREL VLAICU"", MICALACA, ZONA 300",1556,882,874,8,0,874,8,1700,818,505,369,1,797,0
2,"Arad",9262,29,9262,,"MUNICIPIUL ARAD",19,"UNIVERSITATEA ""AUREL VLAICU"", MICALACA, ZONA 300",1614,829,824,5,0,825,4,1800,971,522,303,1,797,0
2,"Arad",9262,29,9262,,"MUNICIPIUL ARAD",20,"UNIVERSITATEA ""AUREL VLAICU"", MICALACA, ZONA 300",1406,813,808,4,1,807,6,1600,787,499,308,1,797,0
2,"Arad",9262,29,9262,,"MUNICIPIUL ARAD",21,"GRADINITA PN  NR.18, CALEA RADNEI, NR.120 (CALEA ARMATEI ROSII)",1743,1018,1010,7,1,1002,16,1900,882,589,413,1,797,0
2,"Arad",9262,29,9262,,"MUNICIPIUL ARAD",22,"SCOALA GENERALA NR.12, STR.MIORITEI",1658,912,903,9,0,902,10,1900,988,539,363,1,797,0
2,"Arad",9262,29,9262,,"MUNICIPIUL ARAD",23,"SCOALA GENERALA NR.12, STR.MIORITEI",1523,761,755,6,0,751,10,1700,939,448,303,1,797,0
2,"Arad",9262,29,9262,,"MUNICIPIUL ARAD",24,"SCOALA GENERALA NR.12, STR.MIORITEI",1629,916,908,8,0,908,8,1800,884,524,384,1,797,0
2,"Arad",9262,29,9262,,"MUNICIPIUL ARAD",25,"SCOALA GENERALA NR.22, STR.NUCET, NR.3",1582,858,853,5,0,855,3,1800,942,567,288,1,797,0
2,"Arad",9262,29,9262,,"MUNICIPIUL ARAD",26,"SCOALA GENERALA NR.22, STR.NUCET, NR.3",1448,720,714,6,0,708,12,1600,880,468,240,1,797,0
2,"Arad",9262,29,9262,,"MUNICIPIUL ARAD",27,"SCOALA GENERALA NR.22, STR.NUCET, NR.3",1687,950,934,16,0,945,5,1900,950,602,343,1,797,0
2,"Arad",9262,29,9262,,"MUNICIPIUL ARAD",28,"SCOALA GENERALA NR.22, STR.NUCET, NR.3",1907,1004,996,8,0,1003,1,2100,1096,694,309,1,797,0
2,"Arad",9262,29,9262,,"MUNICIPIUL ARAD",29,"SCOALA GENERALA NR.22, STR.NUCET, NR.3",1865,1041,1029,12,0,1034,7,2100,1059,657,377,1,797,0
2,"Arad",9262,29,9262,,"MUNICIPIUL ARAD",30,"LICEUL SPORTIV,  CALEA RADNEI, NR.250 (CALEA ARMATEI ROSII)",1950,1192,1166,26,0,1179,13,2100,908,797,382,1,797,0
2,"Arad",9262,29,9262,,"MUNICIPIUL ARAD",31,"GRADINITA PP, NR.7, CALEA RADNEI NR.143 (CALEA ARMATEI ROSII)",1473,814,800,14,0,805,9,1600,786,451,354,1,797,0
2,"Arad",9262,29,9262,,"MUNICIPIUL ARAD",32,"GRADINITA PP, NR.7, CALEA RADNEI NR.143 (CALEA ARMATEI ROSII)",1705,789,783,6,0,787,2,1900,1111,507,280,1,797,0
2,"Arad",9262,29,9262,,"MUNICIPIUL ARAD",33,"GRADINITA PN 18, STR. FABIUS, NR.8",1493,862,851,11,0,853,9,1700,838,535,318,1,797,0
2,"Arad",9262,29,9262,,"MUNICIPIUL ARAD",34,"SCOALA GENERALA NR.13, STR.ARDEALULUI, NR.8",1097,631,621,9,1,623,8,1200,569,404,219,1,797,0
2,"Arad",9262,29,9262,,"MUNICIPIUL ARAD",35,"GRADINITA PP , NR.11, STR. CRASNA , NR.44",1353,732,726,6,0,718,14,1500,768,472,246,1,797,0
2,"Arad",9262,29,9262,,"MUNICIPIUL ARAD",36,"SCOALA  SCOALA GENERALA NR.13, STR.PETRU RARES, NR.20",936,472,465,7,0,467,5,1000,528,293,174,1,797,0
2,"Arad",9262,29,9262,,"MUNICIPIUL ARAD",37,"SCOALA  SCOALA GENERALA NR.13, STR.PETRU RARES, NR.20",1831,1028,1009,19,0,1013,15,2000,972,608,405,1,797,0
2,"Arad",9262,29,9262,,"MUNICIPIUL ARAD",38,"SCOALA  SCOALA GENERALA NR.13, STR.PETRU RARES, NR.21",1901,1120,1110,10,0,1115,5,2100,980,700,415,1,797,0
2,"Arad",9262,29,9262,,"MUNICIPIUL ARAD",39,"SCOALA  SCOALA GENERALA NR.13, STR.PETRU RARES, NR.21",1972,1140,1133,7,0,1124,16,2200,1060,740,384,1,797,0
2,"Arad",9262,29,9262,,"MUNICIPIUL ARAD",40,"SCOALA  SCOALA GENERALA NR.13, STR.PETRU RARES, NR.21",1404,787,761,22,4,782,5,1500,713,475,307,1,797,0
2,"Arad",9262,29,9262,,"MUNICIPIUL ARAD",41,"SCOALA GENERALA NR.15, STR. 6 VANATORI, NR.55",734,538,348,13,177,529,9,800,262,393,136,1,797,0
2,"Arad",9262,29,9262,,"MUNICIPIUL ARAD",42,"GRADINITA PS NR.1, STR.IZOI, NR.1",1201,651,583,68,0,647,4,1300,649,449,198,1,797,0
2,"Arad",9262,29,9262,,"MUNICIPIUL ARAD",43,"SCOALA GENERALA NR.21, STR.FULGERULUI, NR.2-4",1439,775,762,13,0,768,7,1600,825,489,279,1,797,0
2,"Arad",9262,29,9262,,"MUNICIPIUL ARAD",44,"SCOALA GENERALA NR.21, STR.FULGERULUI, NR.2-4",1485,883,869,14,0,878,5,1600,717,524,354,1,797,0
2,"Arad",9262,29,9262,,"MUNICIPIUL ARAD",45,"SCOALA GENERALA NR.21, STR.FULGERULUI, NR.2-4",1141,673,665,8,0,661,12,1300,627,399,262,1,797,0
2,"Arad",9262,29,9262,,"MUNICIPIUL ARAD",46,"SCOALA GENERALA NR.11, STR.POETULUI, NR.85/A",1812,922,913,9,0,919,3,2000,1078,555,364,1,797,0
2,"Arad",9262,29,9262,,"MUNICIPIUL ARAD",47,"SCOALA GENERALA NR.11, STR.POETULUI, NR.85/A",1783,831,814,17,0,826,5,2000,1169,539,287,1,797,0
2,"Arad",9262,29,9262,,"MUNICIPIUL ARAD",48,"SCOALA GENERALA NR.11, STR.POETULUI, NR.85/A",1386,696,686,10,0,692,4,1500,804,485,207,1,797,0
2,"Arad",9262,29,9262,,"MUNICIPIUL ARAD",49,"GRADINITA PP NR.17, STR. STEFAN LUCHIAN, FN",1723,971,963,7,1,963,8,1900,929,553,410,1,797,0
2,"Arad",9262,29,9262,,"MUNICIPIUL ARAD",50,"GRADINITA PP NR.17, STR. STEFAN LUCHIAN, FN",1726,900,894,5,1,892,8,1900,1000,591,301,1,797,0
2,"Arad",9262,29,9262,,"MUNICIPIUL ARAD",51,"CENTRU DE VARSTNICI, CALEA AUREL VLAICU, NR.227",1669,839,829,10,0,831,8,1800,961,519,312,1,797,0
2,"Arad",9262,29,9262,,"MUNICIPIUL ARAD",52,"GRADINITA PN NR.8, STR.POETULUI, NR.72",1756,879,874,5,0,874,5,1900,1021,612,262,1,797,0
2,"Arad",9262,29,9262,,"MUNICIPIUL ARAD",53,"SCOALA GENERALA NR.10, STR.FAURILOR, NR.94",1451,725,718,7,0,720,5,1600,875,558,162,1,797,0
2,"Arad",9262,29,9262,,"MUNICIPIUL ARAD",54,"SCOALA GENERALA NR.10, STR.GRADINARILOR, NR.1-15",1196,539,525,14,0,538,1,1300,761,391,147,1,797,0
2,"Arad",9262,29,9262,,"MUNICIPIUL ARAD",55,"SCOALA GENERALA NR.10, STR.GRADINARILOR, NR.1-15",1386,740,732,8,0,733,7,1500,760,494,239,1,797,0
2,"Arad",9262,29,9262,,"MUNICIPIUL ARAD",56,"SCOALA GENERALA NR.9, STR.INDEPENDENTEI, NR.3",1658,866,858,7,1,858,8,1800,934,691,167,1,797,0
2,"Arad",9262,29,9262,,"MUNICIPIUL ARAD",57,"SCOALA GENERALA NR.9, STR.INDEPENDENTEI, NR.3",1616,818,810,8,0,813,5,1800,982,646,167,1,797,0
2,"Arad",9262,29,9262,,"MUNICIPIUL ARAD",58,"SCOALA GENERALA NR.9, STR.INDEPENDENTEI, NR.3",1709,829,818,11,0,822,7,1900,1071,661,161,1,797,0
2,"Arad",9262,29,9262,,"MUNICIPIUL ARAD",59,"GRADINITA PP NR.16, STR.PREDEAL, FN",1941,952,946,6,0,940,12,2100,1148,635,305,1,797,0
2,"Arad",9262,29,9262,,"MUNICIPIUL ARAD",60,"GRADINITA PP NR.16, STR.PREDEAL, FN",1631,797,785,12,0,787,10,1802,1005,537,250,1,797,0
2,"Arad",9262,29,9262,,"MUNICIPIUL ARAD",61,"SCOALA GENERALA NR.6, STR.HATEG, NR.3",1583,843,834,8,1,832,11,1801,958,538,294,1,797,0
2,"Arad",9262,29,9262,,"MUNICIPIUL ARAD",62,"SCOALA GENERALA NR.6, STR.HATEG, NR.3",1702,904,892,12,0,901,3,1900,996,570,331,1,797,0
2,"Arad",9262,29,9262,,"MUNICIPIUL ARAD",63,"GRADINITA PP NR.10, CALEA AUREL VLAICU, FN",1242,621,613,8,0,616,5,1700,1079,400,216,1,797,0
2,"Arad",9262,29,9262,,"MUNICIPIUL ARAD",64,"GRADINITA PP NR.10, CALEA AUREL VLAICU, FN",2066,1148,1133,15,0,1142,6,2000,852,704,438,1,797,0
2,"Arad",9262,29,9262,,"MUNICIPIUL ARAD",65,"SCOALA GENERALA NR.18, STR.VASILE CONTA, NR.2B",1307,751,734,16,1,741,10,1400,649,438,303,1,797,0
2,"Arad",9262,29,9262,,"MUNICIPIUL ARAD",66,"SCOALA GENERALA NR.18, STR.VASILE CONTA, NR.2B",1588,883,874,9,0,878,5,1805,922,526,352,1,797,0
2,"Arad",9262,29,9262,,"MUNICIPIUL ARAD",67,"GRADINITA PN NR.16, STR.TIBERIU, NR.4",1678,820,808,12,0,812,8,1900,1080,585,227,1,797,0
2,"Arad",9262,29,9262,,"MUNICIPIUL ARAD",68,"COLEGIUL TEHNIC DE CONSTRUCTII SI PROTECTIA MEDIULUI, STR. I.FLUIERAS, NR.10C (FANULUI)",1510,704,694,9,1,695,9,1700,996,463,232,1,797,0
2,"Arad",9262,29,9262,,"MUNICIPIUL ARAD",69,"COLEGIUL TEHNIC DE CONSTRUCTII SI PROTECTIA MEDIULUI, STR. I.FLUIERAS, NR.10C (FANULUI)",1467,672,662,10,0,666,6,1600,928,451,215,1,797,0
2,"Arad",9262,29,9262,,"MUNICIPIUL ARAD",70,"SCOALA GENERALA NR.8, STR.PROF.DR.ILARION FELEA (MESTECANIS), NR.7-13",1138,539,527,12,0,533,6,1200,661,432,101,1,797,0
2,"Arad",9262,29,9262,,"MUNICIPIUL ARAD",71,"ANAF, GARDA FINANCIARA, SECTIA ARAD, STR.FRATII NEUMANN NR.10 (COLONIA UTA)",1467,748,736,12,0,738,10,1600,852,412,326,1,797,0
2,"Arad",9262,29,9262,,"MUNICIPIUL ARAD",72," GRADINITA PN NR.12, STR.RODNEI, NR.3-5, BLOC 5",1600,822,804,18,0,812,10,1801,979,604,208,1,797,0
2,"Arad",9262,29,9262,,"MUNICIPIUL ARAD",73," GRADINITA PN NR.12, STR.RODNEI, NR.3-5, BLOC 5",1490,753,745,8,0,744,9,1600,847,537,207,1,797,0
2,"Arad",9262,29,9262,,"MUNICIPIUL ARAD",74,"CENTRU PENTRU ACORDAREA AJUTOARELOR BANESTI PENTRU INCALZIREA LOCUINTELOR, STR.RODNEI, NR.3-5, BLOC 5",1628,788,720,9,59,783,5,1800,1012,543,240,1,797,0
2,"Arad",9262,29,9262,,"MUNICIPIUL ARAD",75,"SCOALA GENERALA NR.3, STR.EP.ROMAN CIOROGARIU (HALMAGEAN), NR.18-22",1526,804,792,11,1,791,13,1700,896,474,317,1,797,0
2,"Arad",9262,29,9262,,"MUNICIPIUL ARAD",76,"SCOALA GENERALA NR.3, STR.OITUZ, NR.108-114",1617,762,750,12,0,754,8,1800,1038,479,275,1,797,0
2,"Arad",9262,29,9262,,"MUNICIPIUL ARAD",77,"GRADINITA PN NR.24, STR.DOROBANTILOR, NR.41",1685,825,815,10,0,813,12,1900,1075,559,254,1,797,0
2,"Arad",9262,29,9262,,"MUNICIPIUL ARAD",78,"SCOALA GENERALA NR.3, STR.CONDURASILOR, NR.48-50",1358,743,735,7,1,736,7,1500,757,516,220,1,797,0
2,"Arad",9262,29,9262,,"MUNICIPIUL ARAD",79,"SCOALA GENERALA NR.3, STR.CONDURASILOR, NR.48-50",1249,699,688,11,0,695,4,1400,701,463,232,1,797,0
2,"Arad",9262,29,9262,,"MUNICIPIUL ARAD",80,"SCOALA GENERALA NR.3, STR.CONDURASILOR, NR.48-50",1448,795,774,21,0,790,5,1600,805,562,228,1,797,0
2,"Arad",9262,29,9262,,"MUNICIPIUL ARAD",81,"CAMINUL SOCIAL, STR.CONDURASILOR, BLOC 61B",1922,997,990,7,0,990,7,2100,1103,737,253,1,797,0
2,"Arad",9262,29,9262,,"MUNICIPIUL ARAD",82,"GRADINITA PP NR.9, STR.CONDURASILOR, NR.13",1056,510,502,8,0,507,3,1200,690,377,130,1,797,0
2,"Arad",9262,29,9262,,"MUNICIPIUL ARAD",83,"GRADINITA PP NR.9, STR.CONDURASILOR, NR.13",1535,733,724,9,0,728,5,1700,967,491,237,1,797,0
2,"Arad",9262,29,9262,,"MUNICIPIUL ARAD",84,"SCPCB MURESUL, CALEA BODROGULUI, FN",346,161,152,9,0,161,0,400,239,113,48,1,797,0
2,"Arad",9262,29,9262,,"MUNICIPIUL ARAD",85,"GRUPUL SCOLAR INDUSTRIAL ""HENRI COANDA"", STR.MARASESTI, NR.34",1125,585,574,11,0,581,4,1300,715,384,197,1,797,0
2,"Arad",9262,29,9262,,"MUNICIPIUL ARAD",86,"SCOALA GENERALA NR.1, STR.EPISCOPIEI (7 NOIEMBRIE), NR.40-42",1710,865,846,19,0,854,11,1880,1015,542,312,1,797,0
2,"Arad",9262,29,9262,,"MUNICIPIUL ARAD",87,"GRUPUL SCOLAR DE INDUSTRIE ALIMENTARA, STR.LUCIAN BLAGA (MIRON CONSTANTINESCU), NR.15",1754,853,837,16,0,844,9,2000,1147,539,305,1,797,0
2,"Arad",9262,29,9262,,"MUNICIPIUL ARAD",88,"GRUPUL SCOLAR INDUSTRIAL ""CSIKY GERGELY"", STR.VARFUL CU DOR, NR.22",1855,909,878,11,20,899,10,2000,1091,553,346,1,797,0
2,"Arad",9262,29,9262,,"MUNICIPIUL ARAD",89,"GRUP SCOLAR DE INDUSTRIE USOARA (LICEUL FRANCISC NEUMANN), STR.S.TEKELJA, NR.1 (AGRISELOR)",2000,760,745,15,0,751,9,2200,1440,539,212,1,797,0
2,"Arad",9262,29,9262,,"MUNICIPIUL ARAD",90,"GRUP SCOLAR DE INDUSTRIE USOARA (LICEUL FRANCISC NEUMANN), STR.S.TEKELJA, NR.1 (AGRISELOR)",1570,730,713,17,0,719,11,1700,970,488,231,1,797,0
2,"Arad",9262,29,9262,,"MUNICIPIUL ARAD",91,"LOCAL S.C.RECONS S.A., STR.MUCIUS SCAEVOLA, NR.9-11",1670,773,765,7,1,770,3,1900,1127,491,279,1,797,0
2,"Arad",9262,29,9262,,"MUNICIPIUL ARAD",92,"GRUPUL SCOLAR DE INDUSTRIE ALIMENTARA, STR.LUCIAN BLAGA, NR.15 (M.CONSTANTINESCU)",1232,552,537,14,1,548,4,1400,848,357,191,1,797,0
2,"Arad",9262,29,9262,,"MUNICIPIUL ARAD",93,"GRUPUL SCOLAR INDUSTRIAL ""AUREL VLAICU"", B-DUL DECEBAL, NR.31A (B-DUL ARMATA POPORULUI)",1229,665,654,11,0,658,7,1400,735,368,290,1,797,0
2,"Arad",9262,29,9262,,"MUNICIPIUL ARAD",94,"GRUPUL SCOLAR DE INDUSTRIE USOARA (LICEUL FRANCISC NEUMANN)-INTERNAT, STR.LABIRINT, NR.6",1125,701,683,18,0,689,12,1300,599,385,304,1,797,0
2,"Arad",9262,29,9262,,"MUNICIPIUL ARAD",95,"GRADINITA PP NR.14 , STR. PATRIA, NR 2-6",1262,653,638,15,0,647,6,1400,747,405,242,1,797,0
2,"Arad",9262,29,9262,,"MUNICIPIUL ARAD",96,"SCOALA GENERALA NR.20, STR.SPARTACUS, NR.1",541,283,274,9,0,280,3,600,317,196,84,1,797,0
2,"Arad",9262,29,9262,,"MUNICIPIUL ARAD",97,"PATINOARUL MUNICIPAL ARAD, STR. RADU DE LA AFUMATI, FN",604,363,347,16,0,362,1,700,337,224,138,1,797,0
2,"Arad",9262,29,9262,,"MUNICIPIUL ARAD",98,"SCOALA GENERALA NR.20, STR.POSADA, NR.19",1606,908,897,11,0,900,8,1800,892,593,307,1,797,0
2,"Arad",9262,29,9262,,"MUNICIPIUL ARAD",99,"GRADINITA PN 25, STR. CAMPIA TURZII, NR. 43",720,498,489,9,0,492,6,802,304,374,118,1,797,0
2,"Arad",9262,29,9262,,"MUNICIPIUL ARAD",100,"LICEUL ""A.M.GUTTENBRUNN"", CALEA TIMISORII (K.MARX), NR.88",1016,529,517,12,0,529,0,1100,571,405,124,1,797,0
2,"Arad",9262,29,9262,,"MUNICIPIUL ARAD",101,"LICEUL ""A.M.GUTTENBRUNN"", CALEA TIMISORII (K.MARX), NR.88",1776,928,904,24,0,917,11,2000,1072,676,241,1,797,0
2,"Arad",9262,29,9262,,"MUNICIPIUL ARAD",102,"LICEUL ""A.M.GUTTENBRUNN"", CALEA TIMISORII (K.MARX), NR.93",937,505,495,10,0,503,2,1000,495,366,137,1,797,0
2,"Arad",9262,29,9262,,"MUNICIPIUL ARAD",103,"GRUPUL SCOLAR FORESTIER, CALEA TIMISORII (K.MARX), NR.29-31",1652,757,748,9,0,751,6,1800,1043,557,194,1,797,0
2,"Arad",9262,29,9262,,"MUNICIPIUL ARAD",104,"GRADINITA PN NR.26, STR. A.M.GUTTENBRUNN (SCHMELTZER), NR.114",1143,577,572,5,0,573,4,1300,723,391,182,1,797,0
2,"Arad",9262,29,9262,,"MUNICIPIUL ARAD",105,"GRADINITA PN NR.26, STR. A.M.GUTTENBRUNN ( SCHMELTZER), NR.114",962,473,464,9,0,469,4,1102,629,294,175,1,797,0
2,"Arad",9262,29,9262,,"MUNICIPIUL ARAD",106,"SCOALA GENERALA NR.7, STR.STEAGULUI, NR.25-27",1949,995,989,6,0,987,8,2200,1205,730,257,1,797,0
2,"Arad",9262,29,9262,,"MUNICIPIUL ARAD",107,"SCOALA GENERALA NR.7, STR.STEAGULUI, NR.25-27",1776,859,845,13,1,855,4,1900,1041,670,185,1,797,0
2,"Arad",9262,29,9262,,"MUNICIPIUL ARAD",108,"CAMINUL STUDENTESC AL UNIVERSITATII DE VEST "" VASILE GOLDIS ""  STRADA COCORILOR NR. 57",0,442,0,442,0,440,2,1450,1008,303,137,1,797,1
2,"Arad",9262,29,9262,,"MUNICIPIUL ARAD",109,"CAMINUL STUDENTESC AL UNIVERSITATII ""AUREL VLAICU""  STRADA URSULUI NR. 2-4",0,347,0,347,0,344,3,1450,1103,210,134,1,797,1
2,"Arad",9262,29,9262,,"MUNICIPIUL ARAD",110,"STATIA CFR ARAD  PIATA GARII NR. 2 - 4",0,1354,0,1354,0,1322,32,2850,1496,843,479,1,797,1
2,"Arad",9262,29,9262,,"MUNICIPIUL ARAD",111,"STATIA CFR ARADUL  NOU  STRADA PIATA GARA ARADUL  NOU",0,261,0,261,0,257,4,1750,1489,141,116,1,797,1
2,"Arad",9262,29,9262,,"MUNICIPIUL ARAD",112,"AUTOGARA ARAD  STRADA 6 VANATORI NR. 14",0,767,0,767,0,761,6,1350,583,480,281,1,797,1
2,"Arad",9459,29,9459,,"ORAS CHISINEU-CRIS",113,"LICEUL TEORETIC ""MIHAI VELICIU"",  CHISINEU-CRIS, STR.PRIMAVERII, NR.3",1436,789,781,8,0,784,5,1600,811,468,316,1,799,0
2,"Arad",9459,29,9459,,"ORAS CHISINEU-CRIS",114,"LICEUL TEORETIC ""MIHAI VELICIU"",  CHISINEU-CRIS, STR.PRIMAVERII, NR.3",1001,582,573,9,0,574,8,1100,518,307,267,1,799,0
2,"Arad",9459,29,9459,,"ORAS CHISINEU-CRIS",115,"SCOALA GENERALA CHISINEU CRIS CLASEL I-IV, STR.OITUZ, NR.4",1523,888,883,5,0,876,12,1700,812,483,393,1,799,0
2,"Arad",9459,29,9459,,"ORAS CHISINEU-CRIS",116,"GRADINITA CU PN PADURENI, STR.INFRATIRII, NR.14",1672,776,764,11,1,769,7,1800,1024,445,324,1,799,0
2,"Arad",9459,29,9459,,"ORAS CHISINEU-CRIS",117,"SCOALA GENERALA CLASELE I-VIII, SAT NADAB, NR.313",1451,906,887,19,0,900,6,1600,694,506,394,1,799,0
2,"Arad",9459,29,9459,,"ORAS CHISINEU-CRIS",118,"PRIMARIA ORASULUI CHISINEU-CRIS  STRADA INFRATIRII NR. 97 SALA MARE",0,254,0,254,0,254,0,350,96,140,114,1,799,1
2,"Arad",9495,29,9495,,"ORAS CURTICI",119,"CASA DE CULTURA CURTICI, STR.HOREA, NR.1",1689,843,832,11,0,836,7,1900,1057,559,277,1,802,0
2,"Arad",9495,29,9495,,"ORAS CURTICI",120,"GRUP SCOLAR ""ION CREANGA"", CURTICI, STR.REVOLUTIEI, NR.37",1741,826,815,11,0,820,6,1900,1074,597,223,1,802,0
2,"Arad",9495,29,9495,,"ORAS CURTICI",121,"GRUP SCOLAR ""ION CREANGA"", CURTICI, STR.REVOLUTIEI, NR.37",1609,710,703,7,0,706,4,1800,1090,520,186,1,802,0
2,"Arad",9495,29,9495,,"ORAS CURTICI",122,"CLUBUL ELEVILOR CURTICI, STR.PRIMARIEI, NR.89",1701,629,617,12,0,619,10,1900,1271,471,148,1,802,0
2,"Arad",9495,29,9495,,"ORAS CURTICI",123,"CASA DE CULTURA  STRADA HOREA NR.1",0,180,0,180,0,174,6,250,70,124,50,1,802,1
2,"Arad",9538,29,9538,,"ORAS INEU",124,"SCOALA GENERALA CLASELE V-VIII INEU, CALEA REPUBLICII, NR.3",1541,931,919,9,3,923,8,1600,669,426,497,1,804,0
2,"Arad",9538,29,9538,,"ORAS INEU",125,"GRADINITA PN INEU, STR.HOREA, NR.11",1471,919,906,7,6,913,6,1500,581,523,390,1,804,0
2,"Arad",9538,29,9538,,"ORAS INEU",126,"GRUPUL SCOLAR INDUSTRIAL ""MIHAI VITEAZUL"", INEU, STR.C.TRAIAN, NR.7",1651,1003,981,11,11,998,5,1700,697,579,419,1,804,0
2,"Arad",9538,29,9538,,"ORAS INEU",127,"SCOALA GENERALA CU CLASELE I-IV, CARTIER TRAIAN, STR.MARASESTI, NR.17",1401,931,920,4,7,922,9,1480,549,600,322,1,804,0
2,"Arad",9538,29,9538,,"ORAS INEU",128,"SALA DE SPORT INEU, CALEA REPUBLICII, NR.3",1494,915,903,12,0,912,3,1500,585,503,409,1,804,0
2,"Arad",9538,29,9538,,"ORAS INEU",129,"SCOALA GENERALA CU CLASELE I-IV, SAT MOCREA",663,423,412,8,3,415,8,700,277,272,143,1,804,0
2,"Arad",9538,29,9538,,"ORAS INEU",130,"AUTOGARA "" TRANSDARA""  STRADA MIHAI EMINESCU NR. 129",0,316,0,316,0,308,8,550,234,179,129,1,804,1
2,"Arad",9574,29,9574,,"ORAS LIPOVA",131,"SCOALA GENERALA CU CLASELE I-IV,LIPOVA , STR.IANCU JIANU, NR.25B",981,551,540,11,0,549,2,1000,449,348,201,1,807,0
2,"Arad",9574,29,9574,,"ORAS LIPOVA",132,"SEDIU AS CARITAS BSG LIPOVA , STR. B.P. HASDEU, NR.55",1180,667,649,18,0,661,6,1200,533,439,222,1,807,0
2,"Arad",9574,29,9574,,"ORAS LIPOVA",133,"SCOALA GENERALA CU CLASELE I-IV,  LIPOVA, STR.N.BALCESCU, NR.52",1081,610,606,4,0,601,9,1100,490,380,221,1,807,0
2,"Arad",9574,29,9574,,"ORAS LIPOVA",134,"SCOALA GENERALA CU CLASELE I-IV, LIPOVA, STR.9 MAI, NR.1",1048,550,542,8,0,547,3,1100,550,358,189,1,807,0
2,"Arad",9574,29,9574,,"ORAS LIPOVA",135,"CLADIREA FOSTEI JUDECATORII, LIPOVA, STR.BUGARIU, NR.6",1009,521,515,6,0,516,5,1100,579,290,226,1,807,0
2,"Arad",9574,29,9574,,"ORAS LIPOVA",136,"PALATUL COPIILOR, LIPOVA, STR.BUGARIU, NR.12",1790,921,910,11,0,914,7,1800,879,620,294,1,807,0
2,"Arad",9574,29,9574,,"ORAS LIPOVA",137,"SCOALA CU CLASELE I-IV, LIPOVA, STR.PRINCIPALA, NR.132",564,340,328,12,0,337,3,600,260,240,97,1,807,0
2,"Arad",9574,29,9574,,"ORAS LIPOVA",138,"SEDIUL APIA, LIPOVA, STR. CALEA ARDEALULUI, NR.446",1151,640,627,13,0,638,2,1300,660,472,166,1,807,0
2,"Arad",9574,29,9574,,"ORAS LIPOVA",139,"SCOALA GENERALA CU CLASELE I-VIII, LIPOVA, STR.DET.PAULIS, NR.23",997,546,537,9,0,541,5,1100,554,346,195,1,807,0
2,"Arad",9574,29,9574,,"ORAS LIPOVA",140,"PRIMARIA ORASULUI LIPOVA  SALA MICA  STRADA NICOLAE BALCESCU NR. 26",0,317,0,317,0,311,6,800,483,207,104,1,807,1
2,"Arad",9627,29,9627,,"ORAS NADLAC",141,"GRUPUL SCOLAR  INDUSTRIAL ""J.G.TAJOVSKY"", STR.PIATA UNIRII, NR.2",1675,911,899,12,0,899,12,1700,789,743,156,1,811,0
2,"Arad",9627,29,9627,,"ORAS NADLAC",142,"CASA DE CULTURA, NADLAC, STR.1 DECEMBRIE, NR.26",1577,856,840,14,2,848,8,1600,744,628,220,1,811,0
2,"Arad",9627,29,9627,,"ORAS NADLAC",143,"SCOALA GENERALA NR.3 ,GRUPUL SCOLAR INDUSTRIAL ""J.G.TAJOVSKY"", NADLAC,  STR.1 DECEMBRIE, NR.9",1832,986,974,10,2,983,3,1900,914,775,208,1,811,0
2,"Arad",9627,29,9627,,"ORAS NADLAC",144,"PICHET GRANICERI, NADLAC, STR. GRANICERILOR, NR.10",1741,935,927,8,0,930,5,1800,865,733,197,1,811,0
2,"Arad",9627,29,9627,,"ORAS NADLAC",145,"CLADIRE STATIE DEZINFECTIE  ZONA PUNCTULUI DE TRECERE A FRONTIEREI FN (INCINTA VAMII NADLAC)",0,231,0,231,0,230,1,300,69,172,58,1,811,1
2,"Arad",11584,29,11584,,"ORAS PECICA",146,"CAMIN CULTURAL, PECICA, STR.2,  NR.66",1108,725,704,15,6,714,11,1200,475,493,221,1,816,0
2,"Arad",11584,29,11584,,"ORAS PECICA",147,"GRUPUL SCOLAR ""GHEORGHE LAZAR"", PECICA, STR.2, NR.37",1688,979,954,22,3,970,9,1700,721,721,249,1,816,0
2,"Arad",11584,29,11584,,"ORAS PECICA",148,"SC AGROINDUSTRIALA SA (IAS), PECICA,  STR.3, NR.105",1399,720,707,12,1,712,8,1500,780,512,200,1,816,0
2,"Arad",11584,29,11584,,"ORAS PECICA",149,"PRIMARIA ORASULUI PECICA, STR.2, NR.150",1267,667,633,24,10,658,9,1300,633,408,250,1,816,0
2,"Arad",11584,29,11584,,"ORAS PECICA",150,"SCOALA PRIMARA NR.2 (ZAGONI), PECICA, STR.401, NR.128",1414,789,757,28,4,775,14,1500,711,533,242,1,816,0
2,"Arad",11584,29,11584,,"ORAS PECICA",151,"SCOALA PRIMARA NR.3 CLASELE I-IV , PECICA,  STR.1, NR.218",1521,720,697,23,0,705,15,1600,880,403,302,1,816,0
2,"Arad",11584,29,11584,,"ORAS PECICA",152,"SCOALA PRIMARA NR.1CLASELE I-IV , PECICA, STR.304, NR.45",1639,1034,1022,10,2,1026,8,1700,666,801,225,1,816,0
2,"Arad",11584,29,11584,,"ORAS PECICA",153,"PRIMARIA TURNU,SAT TURNU, NR.245",1041,532,520,4,8,529,3,1100,568,392,137,1,816,0
2,"Arad",11584,29,11584,,"ORAS PECICA",154,"SAT SEDERHART,SCOALA PRIMARA CLASELWE I-IV",279,190,177,9,4,188,2,300,110,155,33,1,816,0
2,"Arad",11584,29,11584,,"ORAS PECICA",155,"SCOALA PRIMARA NR. 3  STRADA 1 NR. 218",0,190,0,190,0,190,0,450,260,118,72,1,816,1
2,"Arad",11584,29,11584,,"ORAS PECICA",156,"SEDIUL FOSTEI PRIMARII  SAT TURNU  NR. 245",0,115,0,115,0,113,2,400,285,65,48,1,816,1
2,"Arad",9654,29,9654,,"ORAS PANCOTA",157,"CLADIRE ""BUCURIA COPIILOR"", PINCOTA, STR.TUDOR VLADIMIRESCU, NR.22",1641,1024,1010,13,1,1009,15,2100,1076,719,290,1,813,0
2,"Arad",9654,29,9654,,"ORAS PANCOTA",158,"GRUP SCOLAR PINCOTA , STR.VASILE GOLDIS, NR.67",1507,721,711,10,0,717,4,1600,879,497,220,1,813,0
2,"Arad",9654,29,9654,,"ORAS PANCOTA",159,"GRUP SCOLAR  PINCOTA , STR.VASILE GOLDIS, NR.67",1495,716,701,14,1,709,7,1600,884,503,206,1,813,0
2,"Arad",9654,29,9654,,"ORAS PANCOTA",160,"SCOALA CLASELE I-VIII, SAT MADERAT, NR.336",1229,584,572,12,0,578,6,1300,716,371,207,1,813,0
2,"Arad",9654,29,9654,,"ORAS PANCOTA",161,"PRIMARIA ORASULUI PINCOTA  STRADA TUDOR VLADIMIRESCU NR. 68",0,128,0,128,0,127,1,300,172,81,46,1,813,1
2,"Arad",9690,29,9690,,"ORAS SEBIS",162,"UNIVERSITATEA DE VEST ""VASILE GOLDIS"" FILIALA SEBIS, B-DUL VICTORIEI, NR.7D",1596,854,837,17,0,846,8,1701,847,499,347,1,824,0
2,"Arad",9690,29,9690,,"ORAS SEBIS",163,"LICEUL SEBIS, B-DUL VICTORIEI, NR.7",1562,873,863,6,4,864,9,1600,727,529,335,1,824,0
2,"Arad",9690,29,9690,,"ORAS SEBIS",164,"SCOALA GENERALA, SEBIS, B-DUL VICTORIEI, NR.7",1386,744,736,8,0,734,10,1400,656,470,264,1,824,0
2,"Arad",9690,29,9690,,"ORAS SEBIS",165,"SCOALA CU CLASELE I-IV, CARTIER PRAJESTI, STR.CODRULUI, NR.2",213,138,128,10,0,138,0,250,112,103,35,1,824,0
2,"Arad",9690,29,9690,,"ORAS SEBIS",166,"SCOALA GENERALA CU CLASELE I-IV, SAT PRUNISOR, NR.78",506,343,329,7,7,338,5,600,257,262,76,1,824,0
2,"Arad",9690,29,9690,,"ORAS SEBIS",167,"SCOALA GENERALA CU CLASELE I-IV,SAT DONCENI, NR.67",142,100,94,6,0,97,3,200,100,81,16,1,824,0
2,"Arad",9690,29,9690,,"ORAS SEBIS",168,"SCOALA GENERALA CU CLASELE I-IV, SAT SALAJENI, NR.106",177,133,124,9,0,130,3,200,67,117,13,1,824,0
2,"Arad",9690,29,9690,,"ORAS SEBIS",169,"UNIVERSITATEA DE VEST "" VASILE GOLDIS""  FILIALA SEBIS  BULEVARDUL VICTORIEI NR. 7 D",0,182,0,182,0,181,1,350,168,118,63,1,824,1
2,"Arad",12091,29,12091,,"ORAS SANTANA",170,"SCOALA GENERALA ""SFANTA ANA""CU CKLASELE I-IV,SECTIA GERMANA, STR.MUNCII, NR.56",1461,590,579,11,0,586,4,1500,910,373,213,1,821,0
2,"Arad",12091,29,12091,,"ORAS SANTANA",171,"GRADINITA PN SANTANA, STR ROZELOR, NR.13",1295,510,497,13,0,505,5,1300,790,317,188,1,821,0
2,"Arad",12091,29,12091,,"ORAS SANTANA",172,"CAMINUL CULTURAL ""V.ROAITA"", SANTANA , STR.BUCEGI, NR.25",1321,494,482,12,0,486,8,1400,906,293,193,1,821,0
2,"Arad",12091,29,12091,,"ORAS SANTANA",173,"SCOALA GENERALA NR.2,CLASELE I-VIII, SANTANA , STR.1 DECEMBRIE, NR.36",1472,685,677,8,0,680,5,1500,815,475,205,1,821,0
2,"Arad",12091,29,12091,,"ORAS SANTANA",174,"GRADINITA PN , SAT COMLAUS, STR.1 DECEMBRIE, NR.39",1085,508,493,15,0,504,4,1100,592,338,166,1,821,0
2,"Arad",12091,29,12091,,"ORAS SANTANA",175,"SCOALA GENERALA NR.2 CLASELE I-IV, SANTANA, STR.MUNCII, NR.117",1306,442,433,9,0,432,10,1400,958,256,176,1,821,0
2,"Arad",12091,29,12091,,"ORAS SANTANA",176,"GRADINITA PN ,ORAS SANTANA , STR.MUNCII, NR.178",1083,343,328,15,0,335,8,1100,757,245,90,1,821,0
2,"Arad",12091,29,12091,,"ORAS SANTANA",177,"CAMINUL CULTURAL, SATU NOU",1087,611,606,5,0,609,2,1100,489,349,260,1,821,0
2,"Arad",12091,29,12091,,"ORAS SANTANA",178,"GRADINITA PN, SANTANA,  STR.UNIRII, NR.1 BIS",919,484,477,7,0,482,2,1000,516,246,236,1,821,0
2,"Arad",12091,29,12091,,"ORAS SANTANA",179,"CAMINUL CULTURAL CAPORAL ALEXA, SAT CAPORAL ALEXA, NR.195",1054,515,498,17,0,511,4,1100,585,340,171,1,821,0
2,"Arad",12091,29,12091,,"ORAS SANTANA",180,"SCOALA GENERALA NR.1 SFANTA ANA  STRADA CAMPULUI NR. 107",0,185,0,185,0,183,2,450,265,125,58,1,821,1
2,"Arad",9743,29,9743,,"ALMAS",181,"CAMIN CULTURAL, LOCALITATEA ALMAS, NR.613",1202,748,699,11,38,740,8,1300,552,493,247,3,829,0
2,"Arad",9743,29,9743,,"ALMAS",182,"CAMIN CULTURAL, SAT CIL, NR.183/B",501,322,314,7,1,320,2,600,278,201,119,3,829,0
2,"Arad",9743,29,9743,,"ALMAS",183,"CAMIN CULTURAL, SAT RADESTI, NR.128",379,262,237,7,18,255,7,400,138,189,66,3,829,0
2,"Arad",9743,29,9743,,"ALMAS",184,"CAMIN CULTURAL, SAT JOIA MARE, NR.79/A",162,111,107,4,0,110,1,200,89,91,19,3,829,0
2,"Arad",9743,29,9743,,"ALMAS",185,"PRIMARIA COMUNEI ALMAS NR.605",0,80,0,80,0,78,2,150,70,48,30,3,829,1
2,"Arad",9798,29,9798,,"APATEU",186,"SCOALA GENERALA, APATEU, NR.329",950,596,575,6,15,593,3,1000,404,455,138,3,834,0
2,"Arad",9798,29,9798,,"APATEU",187,"SCOALA GENERALA, APATEU, NR.425",972,598,564,7,27,596,2,1100,502,456,140,3,834,0
2,"Arad",9798,29,9798,,"APATEU",188,"SCOALA GENERALA ,SAT BERECHIU, NR.594",683,432,409,3,20,428,4,800,368,224,204,3,834,0
2,"Arad",9798,29,9798,,"APATEU",189,"SCOALA GENERALA ,SAT  MOTIORI, NR. 75",276,206,203,3,0,205,1,300,94,106,99,3,834,0
2,"Arad",9798,29,9798,,"APATEU",190,"PRIMARIA COMUNEI APATEU  NR.364",0,73,0,73,0,73,0,100,27,50,23,3,834,1
2,"Arad",9832,29,9832,,"ARCHIS",191,"PRIMARIA, ARCHIS, STR. PRINCIPALA, NR.97",331,244,242,2,0,243,1,400,156,102,141,3,838,0
2,"Arad",9832,29,9832,,"ARCHIS",192,"SCOALA GENERALA CU CLASELE I-IV, SAT NERMIS, NR.68",160,130,124,6,0,130,0,200,70,65,65,3,838,0
2,"Arad",9832,29,9832,,"ARCHIS",193,"SCOALA GENERALA CU CLASELE I-IV,SAT BARZESTI, NR.29",136,108,102,6,0,108,0,200,92,46,62,3,838,0
2,"Arad",9832,29,9832,,"ARCHIS",194,"SCOALA GENERALA CU CLASELE I-VIII,SAT GROSENI, NR.269",655,435,428,7,0,431,4,700,265,154,277,3,838,0
2,"Arad",9832,29,9832,,"ARCHIS",195,"PRIMARIA COMUNEI ARCHIS  NR.97",0,60,0,60,0,60,0,100,40,32,28,3,838,1
2,"Arad",9887,29,9887,,"BATA",196,"PRIMARIA COMUNEI BATA  NR.166",352,247,225,5,17,247,0,400,153,159,88,3,857,0
2,"Arad",9887,29,9887,,"BATA",197,"SCOALA CU CLASELE I-IV, SAT TELA",270,127,110,9,8,125,2,300,173,80,45,3,857,0
2,"Arad",9887,29,9887,,"BATA",198,"SCOALA CU CLASELE I-IV,  SAT BACAU DE MIJLOC",148,92,84,5,3,92,0,200,108,73,19,3,857,0
2,"Arad",9887,29,9887,,"BATA",199,"CAMINUL CULTURAL, SAT BULCI",106,78,62,10,6,77,1,150,72,42,35,3,857,0
2,"Arad",9887,29,9887,,"BATA",200,"PRIMARIA COMUNEI BATA  NR.166",0,115,0,115,0,114,1,200,85,82,32,3,857,1
2,"Arad",9930,29,9930,,"BELIU",201,"CONSILIUL LOCAL, BELIU, NR.632",1533,1000,977,12,11,985,15,1700,700,646,339,3,862,0
2,"Arad",9930,29,9930,,"BELIU",202,"CAMIN CULTURAL, SAT TAGADAU, NR.197",413,258,254,4,0,258,0,500,242,150,108,3,862,0
2,"Arad",9930,29,9930,,"BELIU",203,"SCOALA CU CLASELE I-IV, SAT BENESTI, NR.72",88,70,60,10,0,70,0,100,30,47,23,3,862,0
2,"Arad",9930,29,9930,,"BELIU",204,"SCOALA CU CLASELE I-IV,SAT BOCHIA, NR.95",64,53,45,8,0,52,1,100,47,35,17,3,862,0
2,"Arad",9930,29,9930,,"BELIU",205,"CAMIN CULTURAL SAT SECACI",142,108,101,7,0,107,1,199,91,79,28,3,862,0
2,"Arad",9930,29,9930,,"BELIU",206,"CAMIN CULTURAL , SAT VASILE GOLDIS, NR.59",410,280,254,10,16,279,1,500,220,215,64,3,862,0
2,"Arad",9930,29,9930,,"BELIU",207,"GRUP SCOLAR BELIU  STRADA PRINCIPALA NR. 459",0,99,0,99,0,98,1,200,101,59,39,3,862,1
2,"Arad",10006,29,10006,,"BIRCHIS",208,"CAMIN CULTURAL BIRCHIS, NR.162",560,327,315,12,0,323,4,600,273,212,111,3,869,0
2,"Arad",10006,29,10006,,"BIRCHIS",209,"SCOALA GENERALA, SAT CAPALNAS, NR.208",737,403,400,3,0,400,3,800,397,186,214,3,869,0
2,"Arad",10006,29,10006,,"BIRCHIS",210,"CAMIN CULTURAL, SAT OSTROV, NR.113",215,165,156,9,0,164,1,250,85,96,68,3,869,0
2,"Arad",10006,29,10006,,"BIRCHIS",211,"PRIMARIA COMUNEI BIRCHIS  STRADA PRINCIPALA NR. 162",0,122,0,122,0,122,0,200,78,62,60,3,869,1
2,"Arad",10051,29,10051,,"BARSA",212,"GRADINITA PN, NR.122/A, LOCALITATEA BARSA",836,595,576,10,9,591,4,900,305,421,170,3,843,0
2,"Arad",10051,29,10051,,"BARSA",213,"CAMIN CULTURAL, SAT ALDESTI, NR.197",458,298,293,5,0,297,1,503,205,159,138,3,843,0
2,"Arad",10051,29,10051,,"BARSA",214,"SCOALA CU CLASELE I-IV, SAT HODIS, NR.72",143,96,86,10,0,94,2,200,104,70,24,3,843,0
2,"Arad",10051,29,10051,,"BARSA",215,"SCOALA CU CLASELE I-IV, SAT VOIVODENI, NR.56",132,93,86,7,0,91,2,150,57,58,33,3,843,0
2,"Arad",10051,29,10051,,"BARSA",216,"CAMINUL CULTURAL BARSA COMUNA BARSA NR.380 A",0,69,0,69,0,68,1,151,82,45,23,3,843,1
2,"Arad",10104,29,10104,,"BARZAVA",217,"PRIMARIA, BARZAVA, NR.314",783,409,401,8,0,407,2,900,491,243,164,3,848,0
2,"Arad",10104,29,10104,,"BARZAVA",218,"SCOALA, SAT MONOROSTIA, NR.99",261,143,139,4,0,143,0,300,157,78,65,3,848,0
2,"Arad",10104,29,10104,,"BARZAVA",219,"SCOALA GENERALA, SAT CAPRUTA, NR.26",229,126,120,6,0,126,0,300,174,72,54,3,848,0
2,"Arad",10104,29,10104,,"BARZAVA",220,"SCOALA GENERALA, SAT DUMBRAVITA, NR.131",258,164,154,10,0,163,1,300,136,80,83,3,848,0
2,"Arad",10104,29,10104,,"BARZAVA",221,"SCOALA GENERALA , SAT GROSII NOI, NR.147",214,129,117,8,4,127,2,250,121,65,62,3,848,0
2,"Arad",10104,29,10104,,"BARZAVA",222,"CAMINUL CULTURAL, SAT SLATINA DE MURES, NR.12",155,97,95,2,0,94,3,200,103,45,49,3,848,0
2,"Arad",10104,29,10104,,"BARZAVA",223,"SCOALA, SAT BATUTA, NR.9",70,42,33,9,0,42,0,100,58,20,22,3,848,0
2,"Arad",10104,29,10104,,"BARZAVA",224,"SCOALA GENERALA , SAT LALASINT, NR.123",331,167,160,7,0,164,3,400,233,117,47,3,848,0
2,"Arad",10104,29,10104,,"BARZAVA",225,"SCOALA GENERALA I-VIII BIRZAVA  NR.151",0,126,0,126,0,126,0,350,224,70,56,3,848,1
2,"Arad",10195,29,10195,,"BOCSIG",226,"CAMIN CULTURAL, BOCSIG, NR.566",1573,906,896,10,0,892,14,1700,794,581,311,3,874,0
2,"Arad",10195,29,10195,,"BOCSIG",227,"SCOALA CU CLASELE I-IV, BOCSIG CARTIER, NR 913",370,234,218,16,0,232,2,400,166,165,67,3,874,0
2,"Arad",10195,29,10195,,"BOCSIG",228,"CAMIN CULTURAL, SAT MANERAU, NR.219",308,195,181,14,0,191,4,350,155,85,106,3,874,0
2,"Arad",10195,29,10195,,"BOCSIG",229,"SCOALA VECHE, SAT RAPSIG, NR.219",619,363,354,9,0,360,3,700,337,238,122,3,874,0
2,"Arad",10195,29,10195,,"BOCSIG",230,"CAMINUL CULTURAL BOCSIG  NR.566",0,91,0,91,0,91,0,200,109,50,41,3,874,1
2,"Arad",10239,29,10239,,"BRAZII",231,"CONSILIUL LOCAL, BRAZII, NR.26 SALA DE SEDINTE",74,45,37,8,0,44,1,100,55,19,25,3,878,0
2,"Arad",10239,29,10239,,"BRAZII",232,"CAMIN CULTURAL,SAT IACOBINI, NR.108",177,97,92,5,0,96,1,200,103,45,51,3,878,0
2,"Arad",10239,29,10239,,"BRAZII",233,"CAMIN CULTURAL, SAT SECAS, NR.114",377,245,241,4,0,243,2,401,156,170,73,3,878,0
2,"Arad",10239,29,10239,,"BRAZII",234,"CAMIN CULTURAL, SAT BUCEAVA, NR.82",86,55,45,10,0,54,1,101,46,34,20,3,878,0
2,"Arad",10239,29,10239,,"BRAZII",235,"SCOALA CU CLASELE I-IV, SAT SOIMUS, NR.68",72,55,41,14,0,55,0,100,45,34,21,3,878,0
2,"Arad",10239,29,10239,,"BRAZII",236,"CAMIN CULTURAL, SAT MADRIGESTI, NR.99",222,149,142,7,0,145,4,250,101,56,89,3,878,0
2,"Arad",10239,29,10239,,"BRAZII",237,"PRIMARIA COMUNEI BRAZII NR.26",0,47,0,47,0,47,0,150,103,31,16,3,878,1
2,"Arad",10293,29,10293,,"BUTENI",238,"PRIMARIA, BUTENI, NR.78 SALA DE SEDINTA",798,508,492,4,12,503,5,900,392,280,223,3,884,0
2,"Arad",10293,29,10293,,"BUTENI",239,"CAMIN CULTURAL, BUTENI, NR.1",950,625,597,11,17,618,7,1100,475,305,313,3,884,0
2,"Arad",10293,29,10293,,"BUTENI",240,"PRIMARIA VECHE, SAT CUIED, NR.378",600,329,313,11,5,328,1,701,372,201,127,3,884,0
2,"Arad",10293,29,10293,,"BUTENI",241,"CAMIN CULTURAL, SAT PAULIAN, NR.8",280,150,145,5,0,147,3,300,150,108,39,3,884,0
2,"Arad",10293,29,10293,,"BUTENI",242,"CAMIN CULTURAL, SAT BERINDIA, NR.11",178,135,124,5,6,134,1,200,65,76,58,3,884,0
2,"Arad",10293,29,10293,,"BUTENI",243,"PRIMARIA COMUNEI BUTENI  NR.78",0,86,0,86,0,86,0,200,114,52,34,3,884,1
2,"Arad",10346,29,10346,,"CARAND",244,"CAMIN CULTURAL, LOCALITATEA CARAND, NR.71/A",575,382,381,1,0,374,8,601,219,236,138,3,889,0
2,"Arad",10346,29,10346,,"CARAND",245,"CAMIN CULTURAL, SAT SELISTEA, NR.134",425,286,282,0,4,285,1,500,214,181,104,3,889,0
2,"Arad",10346,29,10346,,"CARAND",246,"SCOALA CU CLASELE I-IV CARAND  NR. 71 C",0,43,0,43,0,43,0,101,58,28,15,3,889,1
2,"Arad",10373,29,10373,,"CERMEI",247,"PRIMARIA, LOCALITATEA CERMEI, NR. 304, SALA DE CASATORII",1483,800,788,9,3,781,19,1700,900,330,451,3,892,0
2,"Arad",10373,29,10373,,"CERMEI",248,"SEDIUL AUXILIAR AL PRIMARIEI COMUNEI CERMEI, SAT SOMOSCHES, NR.339",728,391,377,14,0,386,5,801,410,192,194,3,892,0
2,"Arad",10373,29,10373,,"CERMEI",249,"PRIMARIA COMUNEI CERMEI NR.304 SALA NR.1",0,82,0,82,0,79,3,300,218,40,39,3,892,1
2,"Arad",10417,29,10417,,"CHISINDIA",250,"PRIMARIA COMUNEI CHISINDIA, NR.191/A",783,495,488,4,3,487,8,900,405,349,138,3,896,0
2,"Arad",10417,29,10417,,"CHISINDIA",251,"CAMIN CULTURAL, SAT PAIUSENI, NR.93",354,257,250,7,0,256,1,400,143,143,113,3,896,0
2,"Arad",10417,29,10417,,"CHISINDIA",252,"CAMIN CULTURAL, SAT VASOAIA, NR.64",67,34,25,9,0,34,0,100,66,13,21,3,896,0
2,"Arad",10417,29,10417,,"CHISINDIA",253,"SCOALA GENERALA CHISINDIA  NR.89",0,60,0,60,0,60,0,103,43,36,24,3,896,1
2,"Arad",10453,29,10453,,"CONOP",254,"SCOALA GENERALA, LOCALITATEA CONOP, NR.3",470,280,270,9,1,278,2,500,220,159,119,3,900,0
2,"Arad",10453,29,10453,,"CONOP",255,"SCOALA  CU CLASELE I-IV, SAT BELOTINT, NR.210",272,154,146,8,0,154,0,300,146,107,47,3,900,0
2,"Arad",10453,29,10453,,"CONOP",256,"SCOALA CU CLASELE I-IV, SAT CHELMAC, NR.50",280,157,150,7,0,154,3,300,143,100,54,3,900,0
2,"Arad",10453,29,10453,,"CONOP",257,"SCOALA CU CLASELE I-IV,SAT  MILOVA, NR.177",434,249,236,13,0,241,8,499,250,165,76,3,900,0
2,"Arad",10453,29,10453,,"CONOP",258,"SCOALA CU CLASELE I-IV, SAT ODVOS, NR.220",393,210,201,9,0,209,1,400,190,151,58,3,900,0
2,"Arad",10453,29,10453,,"CONOP",259,"STATIA CFR CONOP (GARA )  FN",0,92,0,92,0,92,0,250,158,63,29,3,900,1
2,"Arad",10514,29,10514,,"COVASINT",260,"CAMIN CULTURAL , LOCALITATEA COVASANT, NR.320B SALA MICA",1048,582,556,7,19,578,4,1200,618,464,114,3,906,0
2,"Arad",10514,29,10514,,"COVASINT",261,"PRIMARIA COMUNEI, COVASANT ,  NR 319 SALA DE SEDINTA",1030,448,430,6,12,445,3,1100,652,315,130,3,906,0
2,"Arad",10514,29,10514,,"COVASINT",262,"SCOALA CU CLASELE I-VIII CORNELIU MIKLOSI CORP A NR 320/A",0,67,0,67,0,67,0,150,83,54,13,3,906,1
2,"Arad",10532,29,10532,,"CRAIVA",263,"CONSILIUL LOCAL, CRAIVA, NR.108",485,264,259,4,1,262,2,500,236,69,193,3,908,0
2,"Arad",10532,29,10532,,"CRAIVA",264,"SCOALA ,SAT CHISLACA, NR.382",586,359,354,5,0,357,2,600,241,133,224,3,908,0
2,"Arad",10532,29,10532,,"CRAIVA",265,"SCOALA ,SAT MARAUS, NR.90/A",257,170,165,5,0,168,2,300,130,71,97,3,908,0
2,"Arad",10532,29,10532,,"CRAIVA",266,"SCOALA ,SAT STOINESTI, NR.84/A",155,118,114,4,0,117,1,200,82,60,57,3,908,0
2,"Arad",10532,29,10532,,"CRAIVA",267,"SCOALA,SAT SUSAG, NR.56",344,229,226,3,0,228,1,400,171,83,145,3,908,0
2,"Arad",10532,29,10532,,"CRAIVA",268,"CAMIN CULTURAL, SAT COROI, NR.35",119,79,75,4,0,78,1,150,71,45,33,3,908,0
2,"Arad",10532,29,10532,,"CRAIVA",269,"SCOALA , SAT SIAD, NR.136",233,182,173,9,0,178,4,300,118,66,112,3,908,0
2,"Arad",10532,29,10532,,"CRAIVA",270,"SCOALA , SAT ROGOZ, NR.51",133,99,95,4,0,99,0,150,51,32,67,3,908,0
2,"Arad",10532,29,10532,,"CRAIVA",271,"SCOALA , SAT CIUNTESTI, NR.70",141,95,93,2,0,94,1,200,105,42,52,3,908,0
2,"Arad",10532,29,10532,,"CRAIVA",272,"CAMINUL CULTURAL CRAIVA NR. 198",0,105,0,105,0,105,0,250,145,47,58,3,908,1
2,"Arad",10649,29,10649,,"DEZNA",273,"CAMIN CULTURAL, DEZNA, CALEA LAZULUI, NR.1",715,510,496,5,9,506,4,800,290,238,268,3,919,0
2,"Arad",10649,29,10649,,"DEZNA",274,"CAMIN CULTURAL, SAT BUHANI",147,111,103,7,1,110,1,200,89,62,48,3,919,0
2,"Arad",10649,29,10649,,"DEZNA",275,"CAMIN CULTURAL, SAT NEAGRA",106,76,68,8,0,76,0,150,74,40,36,3,919,0
2,"Arad",10649,29,10649,,"DEZNA",276,"SCOALA GENERALA, SAT SLATINA DE CRIS",143,115,105,9,1,114,1,200,85,60,54,3,919,0
2,"Arad",10649,29,10649,,"DEZNA",277,"CAMIN CULTURAL, SAT LAZ",60,33,27,6,0,33,0,100,67,20,13,3,919,0
2,"Arad",10649,29,10649,,"DEZNA",278,"CLUBUL TINERETULUI DIN SAT DEZNA STRADA CALEA LAZULUI NR. 1",0,95,0,95,0,95,0,200,105,47,48,3,919,1
2,"Arad",10701,29,10701,,"DIECI",279,"CAMIN CULTURAL, LOCALITATEA DIECI, NR.139B",649,469,432,3,34,468,1,700,231,267,201,3,925,0
2,"Arad",10701,29,10701,,"DIECI",280,"CAMIN CULTURAL, SAT CROCNA, NR.44",369,255,223,5,27,253,2,400,145,119,134,3,925,0
2,"Arad",10701,29,10701,,"DIECI",281,"CAMIN CULTURAL, SAT REVETIS, NR.69",316,205,192,5,8,205,0,350,145,135,70,3,925,0
2,"Arad",10701,29,10701,,"DIECI",282,"PRIMARIA COMUNEI DIECI NR.139 A",0,57,0,57,0,56,1,150,93,37,19,3,925,1
2,"Arad",12912,29,12912,,"DOROBANTI",283,"CAMIN CULTURAL, DOROBANTI, NR.91",1403,535,524,11,0,527,8,1500,965,276,251,3,931,0
2,"Arad",12912,29,12912,,"DOROBANTI",284,"PRIMARIA COMUNEI DOROBANTI  NR.410",0,36,0,36,0,36,0,150,114,15,21,3,931,1
2,"Arad",10827,29,10827,,"FELNAC",285,"SCOALA GENERALA CLASELE I-VIII, LOCAL 1,  FELNAC, NR.397",1105,679,623,17,39,672,7,1200,521,464,208,3,936,0
2,"Arad",10827,29,10827,,"FELNAC",286,"SCOALA GENERALA CLASELE I-VIII, LOCAL 2,  FELNAC, NR.398",1088,714,669,8,37,705,9,1100,386,475,230,3,936,0
2,"Arad",10827,29,10827,,"FELNAC",287,"SCOALA CU CLASELE I-V,SAT CALUGARENI, NR 11",184,129,118,9,2,128,1,200,71,75,53,3,936,0
2,"Arad",10827,29,10827,,"FELNAC",288,"PRIMARIA COMUNEI FELNAC NR.330",0,97,0,97,0,97,0,150,53,66,31,3,936,1
2,"Arad",9280,29,9280,,"FANTINELE",289,"PRIMARIA, FANTINELE, NR.115",1214,602,598,4,0,599,3,1400,798,421,178,3,933,0
2,"Arad",9280,29,9280,,"FANTINELE",290,"SCOALA FANTINELE, LOCALITATEA FANTINELE, NR.124",894,454,444,10,0,445,9,1000,546,251,194,3,933,0
2,"Arad",9280,29,9280,,"FANTINELE",291,"CAMIN CUTURAL, SAT TISA NOUA, NR.248",800,431,421,10,0,430,1,900,469,249,181,3,933,0
2,"Arad",9280,29,9280,,"FANTINELE",292,"PRIMARIA COMUNEI FANTINELE  NR. 115",0,77,0,77,0,77,0,150,73,36,41,3,933,1
2,"Arad",12920,29,12920,,"FRUMUSENI",293,"SCOALA GENERALA FRUMUSENI, LOCALITATEA FRUMUSENI, NR.184",1442,848,836,12,0,842,6,1600,752,571,271,3,939,0
2,"Arad",12920,29,12920,,"FRUMUSENI",294,"CAMIN CULTURAL, SAT ALUNIS, NR.379",790,483,477,6,0,482,1,900,417,409,73,3,939,0
2,"Arad",12920,29,12920,,"FRUMUSENI",295,"SCOALA GENERALA FRUMUSENI  NR.184",0,100,0,100,0,99,1,100,0,75,24,3,939,1
2,"Arad",10872,29,10872,,"GHIOROC",296,"PRIMARIA COMUNEI, GHIOROC, NR.89",1552,769,745,23,1,764,5,1700,931,539,225,3,942,0
2,"Arad",10872,29,10872,,"GHIOROC",297,"CAMIN CULTURAL, SAT CUVIN, NR.98",1335,660,641,17,2,651,9,1500,840,466,185,3,942,0
2,"Arad",10872,29,10872,,"GHIOROC",298,"CAMIN CULTURAL, SAT MINIS, NR.163",552,323,311,12,0,322,1,600,277,217,105,3,942,0
2,"Arad",10872,29,10872,,"GHIOROC",299,"PRIMARIA COMUNEI GHIOROC NR.89 CORP A",0,123,0,123,0,123,0,300,177,79,44,3,942,1
2,"Arad",10916,29,10916,,"GRANICERI",300,"PRIMARIA COMUNEI, GRANICERI, NR.10",1061,509,498,11,0,504,5,1200,691,240,264,3,946,0
2,"Arad",10916,29,10916,,"GRANICERI",301,"SCOALA GENERALA, SAT  SICLAU, NR.137",971,403,391,12,0,395,8,1100,697,226,169,3,946,0
2,"Arad",10916,29,10916,,"GRANICERI",302,"SCOALA GENERALA GRANICERI NR.10",0,66,0,66,0,66,0,150,84,30,36,3,946,1
2,"Arad",10943,29,10943,,"GURAHONT",303,"PRIMARIA COMUNEI, GURAHONT, STR. AVRAM IANCU,  NR.29",820,457,446,11,0,453,4,901,444,230,223,3,949,0
2,"Arad",10943,29,10943,,"GURAHONT",304,"PRIMARIA COMUNEI, GURAHONT, STR. AVRAM IANCU,  NR.29",773,443,434,6,3,437,6,900,457,201,236,3,949,0
2,"Arad",10943,29,10943,,"GURAHONT",305,"CAMIN CULTURAL, SAT BONTESTI, NR.242",509,285,279,6,0,281,4,602,317,156,125,3,949,0
2,"Arad",10943,29,10943,,"GURAHONT",306,"CAMIN CULTURAL, SAT DULCELE, NR.13",69,52,44,8,0,52,0,100,48,14,38,3,949,0
2,"Arad",10943,29,10943,,"GURAHONT",307,"CAMIN CULTURAL, SAT FENIS, NR.68",120,91,84,7,0,90,1,150,59,34,56,3,949,0
2,"Arad",10943,29,10943,,"GURAHONT",308,"CAMIN CULTURAL, SAT HONTISOR, NR.117",260,191,184,7,0,188,3,302,111,86,102,3,949,0
2,"Arad",10943,29,10943,,"GURAHONT",309,"CAMIN CULTURAL, SAT IOSAS, NR.50",215,142,138,4,0,139,3,248,106,62,77,3,949,0
2,"Arad",10943,29,10943,,"GURAHONT",310,"CAMIN CULTURAL, SAT MUSTESTI, NR.55",55,28,20,8,0,28,0,101,73,15,13,3,949,0
2,"Arad",10943,29,10943,,"GURAHONT",311,"CAMIN CULTURAL, SAT PESCARI, NR.151",238,144,135,9,0,140,4,300,156,83,57,3,949,0
2,"Arad",10943,29,10943,,"GURAHONT",312,"CAMIN CULTURAL, SAT VALEA MARE, NR.62",77,67,58,9,0,67,0,100,33,26,41,3,949,0
2,"Arad",10943,29,10943,,"GURAHONT",313,"TELECENTRU , SAT ZIMBRU, NR.112",312,196,189,7,0,196,0,350,154,79,117,3,949,0
2,"Arad",10943,29,10943,,"GURAHONT",314,"GARA CFR GURAHONT  STRADA GARII NR. 23",0,125,0,125,0,124,1,350,225,60,64,3,949,1
2,"Arad",11058,29,11058,,"HALMAGIU",315,"PRIMARIA COMUNEI, HALMAGIU, STR. PRIMARIEI, NR.9",1134,588,580,8,0,582,6,1300,712,311,271,3,966,0
2,"Arad",11058,29,11058,,"HALMAGIU",316,"SCOALA GENERALA, SAT POIENARI, NR.6",193,120,114,6,0,120,0,200,80,78,42,3,966,0
2,"Arad",11058,29,11058,,"HALMAGIU",317,"CAMIN CULTURAL, SAT TARMURE, NR.28",343,198,190,8,0,198,0,400,202,96,102,3,966,0
2,"Arad",11058,29,11058,,"HALMAGIU",318,"SCOALA GENERALA, SAT TISA, NR.45",218,141,135,6,0,141,0,250,109,54,87,3,966,0
2,"Arad",11058,29,11058,,"HALMAGIU",319,"SCOALA GENERALA, SAT LEASA, NR.45",207,135,128,7,0,135,0,250,115,76,59,3,966,0
2,"Arad",11058,29,11058,,"HALMAGIU",320,"SCOALA GENERALA, SAT BANESTI, NR.54",313,210,201,5,4,208,2,350,140,131,77,3,966,0
2,"Arad",11058,29,11058,,"HALMAGIU",321,"SCOALA GENERALA, SAT BRUSTURI, NR.54",376,217,211,6,0,214,3,400,183,155,59,3,966,0
2,"Arad",11058,29,11058,,"HALMAGIU",322,"PRIMARIA COMUNEI HALMAGIU  STRADA PRIMARIEI NR. 9",0,73,0,73,0,73,0,200,127,40,33,3,966,1
2,"Arad",11174,29,11174,,"HALMAGEL",323,"PRIMARIA COMUNEI HALMAGEL, HALMAGEL, NR.1 SALA DE SEDINTE",578,362,357,5,0,358,4,613,251,183,175,3,960,0
2,"Arad",11174,29,11174,,"HALMAGEL",324,"SCOALA CU CLASELE I-IV, SAT LUNCSOARA, NR.14/B",387,236,230,6,0,232,4,400,164,184,48,3,960,0
2,"Arad",11174,29,11174,,"HALMAGEL",325,"SCOALA  CU CLASELE I-IV, SAT  SARBI, NR.18/B",115,77,67,10,0,76,1,150,73,47,29,3,960,0
2,"Arad",11174,29,11174,,"HALMAGEL",326,"SCOALA CU CLASELE I-IV, SAT TARNAVITA, NR.21/B",165,123,114,9,0,123,0,200,77,45,78,3,960,0
2,"Arad",11174,29,11174,,"HALMAGEL",327,"PRIMARIA COMUNEI HALMAGEL NR. 1",0,81,0,81,0,81,0,100,19,36,45,3,960,1
2,"Arad",11236,29,11236,,"HASMAS",328,"CAMIN CULTURAL, LOCALITATEA HASMAS, NR.216",386,298,289,0,9,296,2,400,102,184,112,3,978,0
2,"Arad",11236,29,11236,,"HASMAS",329,"CAMIN CULTURAL, SAT COMANESTI FN",101,78,72,5,1,78,0,100,22,41,37,3,978,0
2,"Arad",11236,29,11236,,"HASMAS",330,"CAMIN CULTURAL, SAT AGRISU MIC, FN",143,110,106,2,2,109,1,200,90,71,38,3,978,0
2,"Arad",11236,29,11236,,"HASMAS",331,"CAMIN CULTURAL, SAT BOTFEI, FN",206,160,152,4,4,160,0,252,92,121,39,3,978,0
2,"Arad",11236,29,11236,,"HASMAS",332,"CAMIN CULTURAL, SAT CLIT, FN",68,60,54,5,1,60,0,100,40,39,21,3,978,0
2,"Arad",11236,29,11236,,"HASMAS",333,"CAMIN CULTURAL, SAT URVIS DE BELIU FN",190,160,150,8,2,159,1,200,40,108,51,3,978,0
2,"Arad",11236,29,11236,,"HASMAS",334,"CAMINUL CULTURAL HASMAS NR.216",0,67,0,67,0,67,0,150,83,44,23,3,978,1
2,"Arad",11307,29,11307,,"IGNESTI",335,"CAMIN CULTURAL, LOCALITATEA  IGNESTI, NR.25",218,156,153,2,1,154,2,200,44,77,77,3,985,0
2,"Arad",11307,29,11307,,"IGNESTI",336,"CAMIN CULTURAL, SAT MINEAD, NR.39",99,74,69,5,0,72,2,100,26,28,44,3,985,0
2,"Arad",11307,29,11307,,"IGNESTI",337,"SCOALA GENERALA , SAT NADALBESTI, NR.9",115,64,57,7,0,64,0,150,86,44,20,3,985,0
2,"Arad",11307,29,11307,,"IGNESTI",338,"SCOALA GENERALA , SAT SUSANI, NR.86",195,93,87,6,0,93,0,200,107,54,39,3,985,0
2,"Arad",11307,29,11307,,"IGNESTI",339,"PRIMARIA COMUNEI IGNESTI  NR.24",0,31,0,31,0,31,0,50,19,15,16,3,985,1
2,"Arad",11352,29,11352,,"IRATOSU",340,"CONSILIUL LOCAL, IRATOSU, NR.1",1580,652,642,7,3,644,8,1700,1048,415,229,3,990,0
2,"Arad",11352,29,11352,,"IRATOSU",341,"SCOALA GENERALA, SAT VARIASUL MARE, NR.117",374,165,152,13,0,163,2,400,235,123,40,3,990,0
2,"Arad",11352,29,11352,,"IRATOSU",342,"SCOALA GENERALA, SAT VARIASUL MIC, NR.47",100,44,35,9,0,44,0,150,106,33,11,3,990,0
2,"Arad",11352,29,11352,,"IRATOSU",343,"PRIMARIA COMUNEI IRATOSU NR.1",0,67,0,67,0,66,1,200,133,45,21,3,990,1
2,"Arad",9333,29,9333,,"LIVADA",344,"SCOALA GENERALA, LOCALITATEA LIVADA, NR.62",1340,708,702,6,0,704,4,1500,792,494,210,3,994,0
2,"Arad",9333,29,9333,,"LIVADA",345,"SCOALA CU CLASELE I-IV , SAT SANLEANI, NR.120",1424,769,757,12,0,767,2,1600,831,508,259,3,994,0
2,"Arad",9333,29,9333,,"LIVADA",346,"SCOALA GENERALA , LIVADA NR.62",0,68,0,68,0,68,0,100,32,45,23,3,994,1
2,"Arad",11398,29,11398,,"MACEA",347,"LOCALUL NR.1 AL SCOALII GENERALE, MACEA, NR.528",1792,889,869,9,11,881,8,2000,1111,587,294,3,997,0
2,"Arad",11398,29,11398,,"MACEA",348,"LOCALUL NR.2 AL SCOALII GENERALE, MACEA, NR.985",1766,828,798,23,7,822,6,1900,1072,522,300,3,997,0
2,"Arad",11398,29,11398,,"MACEA",349,"SCOALA GENERALA, SAT SANMARTIN, NR.3-6",2012,760,745,15,0,753,7,2200,1440,583,170,3,997,0
2,"Arad",11398,29,11398,,"MACEA",350,"PRIMARIA COMUNEI MACEA NR. 262",0,100,0,100,0,98,2,250,150,66,32,3,997,1
2,"Arad",11423,29,11423,,"MISCA",351,"PRIMARIA COMUNEI, MISCA, NR.116, SALA DE SEDINTE",951,548,545,3,0,539,9,1000,452,297,242,3,1000,0
2,"Arad",11423,29,11423,,"MISCA",352,"SEDIUL FOSTEI PRIMARII, SAT SATU NOU, NR.318",670,331,316,10,5,324,7,700,369,124,200,3,1000,0
2,"Arad",11423,29,11423,,"MISCA",353,"SEDIUL FOSTEI PRIMARII, SAT VANATORI, NR 539",909,494,480,14,0,484,10,1000,506,340,144,3,1000,0
2,"Arad",11423,29,11423,,"MISCA",354,"SCOALA GENERALA, SAT ZERINDU MIC, NR.33",161,91,82,9,0,90,1,200,109,65,25,3,1000,0
2,"Arad",11423,29,11423,,"MISCA",355,"SEDIUL PRIMARIEI COMUNEI MISCA NR. 116",0,73,0,73,0,71,2,250,177,39,32,3,1000,1
2,"Arad",11478,29,11478,,"MONEASA",356,"CAMIN CULTURAL, LOCALITATEA MONEASA, NR.117",666,444,432,0,12,443,1,700,256,267,176,3,1005,0
2,"Arad",11478,29,11478,,"MONEASA",357,"SCOALA RANUSA, SAT RANUSA, NR.98",214,145,143,2,0,144,1,250,105,80,64,3,1005,0
2,"Arad",11478,29,11478,,"MONEASA",358,"PRIMARIA COMUNEI MONEASA SAT MONEASA NR.72",0,211,0,211,0,210,1,251,40,107,103,3,1005,1
2,"Arad",11502,29,11502,,"OLARI",359,"CONSILIUL LOCAL, OLARI",1290,620,596,5,19,610,10,1400,780,335,275,3,1008,0
2,"Arad",11502,29,11502,,"OLARI",360,"SCOALA CU CLASELE I-IV, SAT SINTEA MICA, NR.85",322,214,206,8,0,214,0,400,186,159,55,3,1008,0
2,"Arad",11502,29,11502,,"OLARI",361,"SEDIUL CONSILIULUI LOCAL AL COMUNEI OLARI NR. 315",0,79,0,79,0,78,1,150,71,42,36,3,1008,1
2,"Arad",11539,29,11539,,"PAULIS",362,"CAMIN CULTURAL, LOCALITATEA  PAULIS, NR.1",1523,799,784,14,1,789,10,1700,901,523,266,3,1011,0
2,"Arad",11539,29,11539,,"PAULIS",363,"CAMIN CULTURAL, SAT SAMBATENI, NR.95",1404,814,774,6,34,808,6,1600,786,603,205,3,1011,0
2,"Arad",11539,29,11539,,"PAULIS",364,"CAMIN CULTURAL, SAT CLADOVA, NR.1",271,174,164,10,0,172,2,300,126,136,36,3,1011,0
2,"Arad",11539,29,11539,,"PAULIS",365,"FOSTUL MAGAZIN SATESC, SAT BARATCA , NR.630/D",202,123,114,9,0,122,1,248,125,84,38,3,1011,0
2,"Arad",11539,29,11539,,"PAULIS",366,"PRIMARIA COMUNEI PAULIS NR.1",0,137,0,137,0,137,0,300,163,83,54,3,1011,1
2,"Arad",11637,29,11637,,"PEREGU MARE",367,"PRIMARIA COMUNEI, PEREGU MARE, NR.137, SALA DE SEDINTE",825,365,348,3,14,358,7,900,535,222,136,3,1016,0
2,"Arad",11637,29,11637,,"PEREGU MARE",368,"CLADIREA PRIMARIEI, SAT PEREGU MIC, NR. 323, SALA DE SEDINTE",796,359,322,5,32,355,4,900,541,147,208,3,1016,0
2,"Arad",11637,29,11637,,"PEREGU MARE",369,"SCOALA GENERALA PEREGU MARE, NR.234",0,29,0,29,0,29,0,100,71,15,14,3,1016,1
2,"Arad",11664,29,11664,,"PETRIS",370,"CONSILIUL LOCAL, LOCALITATEA PETRIS, NR.253",391,208,204,4,0,206,2,400,192,143,63,3,1019,0
2,"Arad",11664,29,11664,,"PETRIS",371,"CAMIN CULTURAL, SAT ILTEU, NR.55",217,118,112,6,0,117,1,250,132,70,47,3,1019,0
2,"Arad",11664,29,11664,,"PETRIS",372,"CAMIN CULTURAL, SAT SELISTE, NR.60",100,85,73,12,0,83,2,100,15,62,21,3,1019,0
2,"Arad",11664,29,11664,,"PETRIS",373,"CAMIN CULTURAL, SAT CORBESTI, NR.46",163,99,95,4,0,97,2,200,101,56,41,3,1019,0
2,"Arad",11664,29,11664,,"PETRIS",374,"CAMIN CULTURAL,  SAT ROSIA NOUA, NR.186",254,136,134,2,0,133,3,300,164,55,78,3,1019,0
2,"Arad",11664,29,11664,,"PETRIS",375,"CAMIN CULTURAL, SAT OBARSIA, NR.47",104,73,68,5,0,69,4,150,77,45,24,3,1019,0
2,"Arad",11664,29,11664,,"PETRIS",376,"SEDIUL CONSILIULUI LOCAL AL COMUNEI PETRIS,  NR.253",0,78,0,78,0,78,0,250,172,48,30,3,1019,1
2,"Arad",11735,29,11735,,"PILU",377,"PRIMARIA COMUNEI PILU, LOCALITATEA PILU, NR.69",821,587,557,12,18,584,3,900,313,339,245,3,1026,0
2,"Arad",11735,29,11735,,"PILU",378,"SCOALA GENERALA CU CLASELE I-IV, SAT VARSAND, NR.30/A",726,389,373,7,9,387,2,800,411,249,138,3,1026,0
2,"Arad",11735,29,11735,,"PILU",379,"PRIMARIA COMUNEI PILU NR.69",0,95,0,95,0,95,0,150,55,61,34,3,1026,1
2,"Arad",11762,29,11762,,"PLESCUTA",380,"CONSILIUL LOCAL PLESCUTA, NR.63",298,182,178,4,0,180,2,298,116,83,97,3,1029,0
2,"Arad",11762,29,11762,,"PLESCUTA",381,"CAMIN CULTURAL, SAT TALAGIU, NR.63",400,221,218,3,0,218,3,450,229,74,144,3,1029,0
2,"Arad",11762,29,11762,,"PLESCUTA",382,"CAMIN CULTURAL, SAT ACIUTA, NR.125",187,119,110,9,0,117,2,200,81,76,41,3,1029,0
2,"Arad",11762,29,11762,,"PLESCUTA",383,"CAMIN CULTURAL, SAT GURA VAII, NR.5",259,126,125,1,0,126,0,300,174,62,64,3,1029,0
2,"Arad",11762,29,11762,,"PLESCUTA",384,"CAMINUL CULTURAL PLESCUTA  NR.34",0,62,0,62,0,62,0,100,38,28,34,3,1029,1
2,"Arad",11842,29,11842,,"SAVARSIN",385,"PRIMARIA COMUNEI SAVARSIN, LOCALITATEA SAVARSIN, NR.37",1240,741,725,3,13,738,3,1400,659,406,332,3,1043,0
2,"Arad",11842,29,11842,,"SAVARSIN",386,"SCOALA PRIMARA, CLADIRE NOUA ,SAT PARNESTI, NR.82/A",162,122,115,7,0,120,2,200,78,82,38,3,1043,0
2,"Arad",11842,29,11842,,"SAVARSIN",387,"SCOALA PRIMARA, SAT TROAS, NR.28/C",146,92,84,8,0,92,0,200,108,60,32,3,1043,0
2,"Arad",11842,29,11842,,"SAVARSIN",388,"CAMIN CULTURAL, SAT  TEMESESTI, NR.51/A",129,97,92,5,0,97,0,150,53,49,48,3,1043,0
2,"Arad",11842,29,11842,,"SAVARSIN",389,"SCOALA PRIMARA, SAT TOC, NR.88/A",395,266,258,6,2,261,5,400,134,75,186,3,1043,0
2,"Arad",11842,29,11842,,"SAVARSIN",390,"SCOALA PRIMARA, SAT CAPRIOARA, NR.156/B",267,185,161,5,19,185,0,300,115,112,73,3,1043,0
2,"Arad",11842,29,11842,,"SAVARSIN",391,"CAMIN CULTURAL, SAT VALEA MARE, NR.68/A",181,122,117,5,0,122,0,200,78,67,55,3,1043,0
2,"Arad",11842,29,11842,,"SAVARSIN",392,"PRIMARIA COMUNEI SAVARSIN  NR.37",0,227,0,227,0,226,1,450,223,125,101,3,1043,1
2,"Arad",11940,29,11940,,"SECUSIGIU",393,"PRIMARIA COMUNEI SECUSIGIU, SALA DE CONSILIU,LOCALITATEA SECUSUGIU, NR.275",1800,873,862,10,1,865,8,1900,1027,602,263,3,1053,0
2,"Arad",11940,29,11940,,"SECUSIGIU",394,"FOSTUL SEDIU CAP, SAT SATU MARE, NR.200",795,405,393,12,0,401,4,900,495,305,96,3,1053,0
2,"Arad",11940,29,11940,,"SECUSIGIU",395,"CAMIN CULTURAL, SAT MUNAR, NR.92",417,281,272,9,0,277,4,500,219,200,77,3,1053,0
2,"Arad",11940,29,11940,,"SECUSIGIU",396,"REMIZA PSI, SAT SANPETRU GERMAN, NR.25",1715,846,835,11,0,835,11,1800,954,653,182,3,1053,0
2,"Arad",11940,29,11940,,"SECUSIGIU",397,"SEDIUL PRIMARIEI COMUNEI SECUSIGIU (BIROU AGRICOL)  NR. 275",0,126,0,126,0,126,0,300,174,96,30,3,1053,1
2,"Arad",11995,29,11995,,"SELEUS",398,"PRIMARIA COMUNEI SELEUS, LOCALITATEA SELEUS, NR. 200",1566,925,849,7,69,920,5,1700,775,470,450,3,1060,0
2,"Arad",11995,29,11995,,"SELEUS",399,"SCOALA GENERALA, SAT IERMATA, NR.14",323,237,224,13,0,236,1,400,163,166,70,3,1060,0
2,"Arad",11995,29,11995,,"SELEUS",400,"SEDIUL SECUNDAR AL PRIMARIEI SELEUS, SAT MORODA, NR.331",565,328,303,19,6,326,2,600,272,203,123,3,1060,0
2,"Arad",11995,29,11995,,"SELEUS",401,"CAMINUL CULTURAL SELEUS NR.197",0,71,0,71,0,71,0,200,129,48,23,3,1060,1
2,"Arad",12037,29,12037,,"SEMLAC",402,"SCOALA GENERALA NR.1, SEMLAC, NR.648",1671,860,834,17,9,855,5,1700,840,680,175,3,1064,0
2,"Arad",12037,29,12037,,"SEMLAC",403,"SCOALA GENERALA NR.2, SEMLAC, NR.737",1614,807,781,22,4,795,12,1700,893,599,196,3,1064,0
2,"Arad",12037,29,12037,,"SEMLAC",404,"SCOALA GENERALA NR. 3 NR. 659",0,101,0,101,0,101,0,150,49,70,31,3,1064,1
2,"Arad",12055,29,12055,,"SINTEA MARE",405,"GRADINITA DE COPII, SINTEA MARE, NR.281",965,594,586,8,0,588,6,1098,504,382,206,3,1080,0
2,"Arad",12055,29,12055,,"SINTEA MARE",406,"CAMIN CULTURAL, SAT ADEA, NR.88",828,419,412,7,0,412,7,900,481,274,138,3,1080,0
2,"Arad",12055,29,12055,,"SINTEA MARE",407,"CLADIREA ADMINISTRATIVA A PRIMARIEI SINTEA MARE, SAT TIPARI, NR.346",1143,582,572,10,0,574,8,1300,718,400,174,3,1080,0
2,"Arad",12055,29,12055,,"SINTEA MARE",408,"SEDIUL FOSTEI AUTOGARI SINTEA MARE  NR.277",0,80,0,80,0,79,1,200,120,56,23,3,1080,1
2,"Arad",12126,29,12126,,"SOCODOR",409,"PRIMARIA COMUNEI, SALA DE SEDINTE, SOCODOR, NR.1",1811,1045,964,21,60,1039,6,2001,956,504,535,3,1093,0
2,"Arad",12126,29,12126,,"SOCODOR",410,"CAMINUL CULTURAL SOCODOR,  NR.337",0,67,0,67,0,67,0,103,36,36,31,3,1093,1
2,"Arad",12144,29,12144,,"SAGU",411,"PRIMARIA COMUNEI, SAGU, NR.219",1794,1198,1151,7,40,1181,15,1900,702,937,244,3,1037,0
2,"Arad",12144,29,12144,,"SAGU",412,"SCOALA GENERALA, SAT CRUCENI, NR.178",583,345,322,9,14,343,2,601,256,270,73,3,1037,0
2,"Arad",12144,29,12144,,"SAGU",413,"SCOALA GENERALA, SAT FIRITEAZ, NR.156",371,235,222,3,10,234,1,400,165,177,57,3,1037,0
2,"Arad",12144,29,12144,,"SAGU",414,"SCOALA GENERALA, SAT  FISCUT, NR.157",393,254,245,6,3,253,1,400,146,201,52,3,1037,0
2,"Arad",12144,29,12144,,"SAGU",415,"SCOALA GENERALA, SAT HUNEDOARA TIMISANA, NR.10",185,114,105,7,2,113,1,200,86,96,17,3,1037,0
2,"Arad",12144,29,12144,,"SAGU",416,"PRIMARIA COMUNEI SAGU NR. 219",0,113,0,113,0,113,0,200,87,85,28,3,1037,1
2,"Arad",12144,29,12144,,"SAGU",417,"SCOALA GENERALA FIRITEAZ SAT FIRITEAZ NR.156",0,45,0,45,0,45,0,100,55,28,17,3,1037,1
2,"Arad",12144,29,12144,,"SAGU",418,"SCOALA GENERALA FISCUT SAT FISCUT NR. 157",0,38,0,38,0,38,0,100,62,18,20,3,1037,1
2,"Arad",12206,29,12206,,"SEITIN",419,"PRIMARIA COMUNEI, SEITIN, STR.REVOLUTIEI, NR.47",1231,576,563,13,0,574,2,1300,724,333,241,3,1058,0
2,"Arad",12206,29,12206,,"SEITIN",420,"SCOALA GENERALA  LOCAL II - CLASELE I-IV , SEITIN, STR.REVOLUTIEI, NR.40",1162,556,542,14,0,546,10,1200,644,355,191,3,1058,0
2,"Arad",12206,29,12206,,"SEITIN",421,"PRIMARIA COMUNEI SEITIN  STRADA REVOLUTIEI NR. 47",0,69,0,69,0,68,1,150,81,45,23,3,1058,1
2,"Arad",12224,29,12224,,"SEPREUS",422,"SCOALA GENERALA CU CLASELE V-VIII, INTRAREA 1, SEPREUS, NR.404",979,586,558,9,19,580,6,1100,514,343,237,3,1066,0
2,"Arad",12224,29,12224,,"SEPREUS",423,"SCOALA GENERALA CU CLASELE V-VIII, INTRAREA 2 , SEPREUS, NR.404",1126,590,569,9,12,586,4,1200,610,387,199,3,1066,0
2,"Arad",12224,29,12224,,"SEPREUS",424,"PRIMARIA COMUNEI SEPREUS SALA DE SEDINTE  NR. 298",0,90,0,90,0,89,1,100,10,65,24,3,1066,1
2,"Arad",12242,29,12242,,"SICULA",425,"CLUB CAMIN CULTURAL, LOCALITATEA SICULA, NR.271",978,558,546,6,6,554,4,1100,542,312,242,3,1068,0
2,"Arad",12242,29,12242,,"SICULA",426,"SCOALA GENERALA, LOCALITATEA  SICULA, NR.271",966,477,468,7,2,472,5,1100,623,318,154,3,1068,0
2,"Arad",12242,29,12242,,"SICULA",427,"SCOALA GENERALA, SAT GURBA, NR.385",961,640,626,12,2,637,3,1100,460,420,217,3,1068,0
2,"Arad",12242,29,12242,,"SICULA",428,"CAMIN CULTURAL, SAT CHERELUS, NR.213",789,530,521,8,1,524,6,900,370,345,179,3,1068,0
2,"Arad",12242,29,12242,,"SICULA",429,"PRIMARIA COMUNEI SICULA, SALA DE SEDINTE, NR.200",0,85,0,85,0,85,0,200,115,62,23,3,1068,1
2,"Arad",12288,29,12288,,"SILINDIA",430,"CAMIN CULTURAL, SILINDIA, NR.192",688,533,498,4,31,527,6,800,267,319,208,3,1072,0
2,"Arad",12288,29,12288,,"SILINDIA",431,"CAMINUL CULTURAL SILINDIA NR.192",0,99,0,99,0,99,0,100,1,64,35,3,1072,1
2,"Arad",12340,29,12340,,"SIMAND",432,"SCOALA GENERALA CU CLASELE I-IV, SIMAND, NR.1202",1379,652,642,9,1,646,6,1500,848,395,251,3,1078,0
2,"Arad",12340,29,12340,,"SIMAND",433,"SCOALA GENERALA CU CLASELE I-IV, SIMAND, NR.693",1132,615,602,13,0,609,6,1200,585,360,249,3,1078,0
2,"Arad",12340,29,12340,,"SIMAND",434,"SCOALA GENERALA CU CLASELE I-IV, SIMAND, NR.93",794,378,369,9,0,377,1,900,522,254,123,3,1078,0
2,"Arad",12340,29,12340,,"SIMAND",435,"SCOALA GENERALA SIMAND,  NR.1083",0,96,0,96,0,96,0,100,4,61,35,3,1078,1
2,"Arad",12368,29,12368,,"SIRIA",436,"CAMIN CULTURAL, SIRIA, NR.162",2223,916,906,10,0,908,8,2300,1384,605,303,3,1084,0
2,"Arad",12368,29,12368,,"SIRIA",437,"SCOALA GENERALA CLASELE I-IV, LOCALITATEA SIRIA, STR.TUDOR VLADIMIRESCU,  NR.286",2162,794,780,14,0,783,11,2200,1406,583,200,3,1084,0
2,"Arad",12368,29,12368,,"SIRIA",438,"CAMIN CULTURAL, SAT GALSA, NR.136/A",1837,875,869,6,0,867,8,1900,1025,602,265,3,1084,0
2,"Arad",12368,29,12368,,"SIRIA",439,"SCOALA GENERALA CU CLASELE I-IV, SAT MASCA, NR.2",787,464,451,13,0,464,0,900,436,313,151,3,1084,0
2,"Arad",12368,29,12368,,"SIRIA",440,"PRIMARIA COMUNEI SIRIA SALA DE CASATORII SAT SIRIA STRADA REGIMENT 85 INFANTERIE NR.184",0,157,0,157,0,157,0,350,193,113,44,3,1084,1
2,"Arad",12402,29,12402,,"SISTAROVAT",441,"PRIMARIA COMUNEI, SISTAROVAT, NR.116",263,187,183,4,0,184,3,300,113,73,111,3,1088,0
2,"Arad",12402,29,12402,,"SISTAROVAT",442,"PRIMARIA COMUNEI SISTAROVAT  NR. 116",0,53,0,53,0,52,1,100,47,23,29,3,1088,1
2,"Arad",9360,29,9360,,"SOFRONEA",443,"CAMIN CULTURAL, LOCALITATEA SOFRONEA, NR.223",1655,905,894,9,2,899,6,1800,895,576,323,3,1095,0
2,"Arad",9360,29,9360,,"SOFRONEA",444,"SCOALA GENERALA CU CLASELE I-IV, SAT SANPAUL, NR.252",530,301,278,14,9,297,4,600,299,136,161,3,1095,0
2,"Arad",9360,29,9360,,"SOFRONEA",445,"PRIMARIA COMUNEI SOFRONEA NR.187",0,86,0,86,0,84,2,150,64,39,45,3,1095,1
2,"Arad",12457,29,12457,,"TAUT",446,"CAMIN CULTURAL, LOCALITATEA TAUT",649,420,366,10,44,415,5,700,280,279,136,3,1105,0
2,"Arad",12457,29,12457,,"TAUT",447,"CAMIN CULTURAL , SAT NADAS",702,468,439,8,21,465,3,800,332,294,171,3,1105,0
2,"Arad",12457,29,12457,,"TAUT",448,"SCOALA GENERALA, SAT MINISEL",145,120,112,8,0,116,4,200,80,72,44,3,1105,0
2,"Arad",12457,29,12457,,"TAUT",449,"CAMIN CULTURAL, SAT MINISU DE SUS",88,70,60,6,4,70,0,100,30,53,17,3,1105,0
2,"Arad",12457,29,12457,,"TAUT",450,"PRIMARIA COMUNEI TAUT  NR.613",0,128,0,128,0,128,0,250,122,85,43,3,1105,1
2,"Arad",12509,29,12509,,"TARNOVA",451,"CAMIN CULTURAL, LOCALITATEA TARNOVA, NR.488",1524,902,833,18,51,891,11,1700,798,470,421,3,1098,0
2,"Arad",12509,29,12509,,"TARNOVA",452,"SCOALA GENERALA, SAT CHIER, NR.141",937,465,458,7,0,460,5,1000,535,233,227,3,1098,0
2,"Arad",12509,29,12509,,"TARNOVA",453,"CAMIN CULTURAL, SAT AGRISU MARE, NR.808",826,571,542,12,17,563,8,900,329,329,234,3,1098,0
2,"Arad",12509,29,12509,,"TARNOVA",454,"CAMIN CULTURAL, SAT ARANEAG, NR.11",309,231,213,10,8,227,4,351,120,102,125,3,1098,0
2,"Arad",12509,29,12509,,"TARNOVA",455,"CAMIN CULTURAL, SAT DRAUT, NR.545",718,521,495,16,10,517,4,800,279,241,276,3,1098,0
2,"Arad",12509,29,12509,,"TARNOVA",456,"CAMIN CULTURAL, SAT DUD, NR.344",491,373,350,12,11,371,2,500,127,216,155,3,1098,0
2,"Arad",12509,29,12509,,"TARNOVA",457,"PRIMARIA COMUNEI TARNOVA NR.734",0,211,0,211,0,210,1,400,189,102,108,3,1098,1
2,"Arad",10765,29,10765,,"USUSAU",458,"SCOALA GENERALA, LOCALITATEA  USUSAU, NR.312",451,282,278,3,1,280,2,498,216,191,89,3,1110,0
2,"Arad",10765,29,10765,,"USUSAU",459,"SCOALA GENERALA, SAT DORGOS, NR.31",186,124,117,7,0,124,0,200,76,80,44,3,1110,0
2,"Arad",10765,29,10765,,"USUSAU",460,"SCOALA GENERALA, SAT PATARS, NR.43",48,42,31,11,0,41,1,100,58,25,16,3,1110,0
2,"Arad",10765,29,10765,,"USUSAU",461,"SCOALA GENERALA, SAT ZABALT, NR.37",229,150,136,12,2,150,0,300,150,79,71,3,1110,0
2,"Arad",10765,29,10765,,"USUSAU",462,"SCOALA GENERALA, SAT BRUZNIC, NR.143",97,59,49,8,2,59,0,100,41,38,21,3,1110,0
2,"Arad",10765,29,10765,,"USUSAU",463,"SCOALA GENERALA USUSAU  NR.312",0,57,0,57,0,57,0,200,143,43,14,3,1110,1
2,"Arad",12572,29,12572,,"VARADIA DE MURES",464,"CAMIN CULTURAL, LOCALITATEA VARADIA DE MURES, NR.138",484,227,215,12,0,225,2,500,273,109,116,3,1116,0
2,"Arad",12572,29,12572,,"VARADIA DE MURES",465,"SCOALA GENERALA , SAT JULITA, NR.53",334,212,206,6,0,211,1,400,188,98,113,3,1116,0
2,"Arad",12572,29,12572,,"VARADIA DE MURES",466,"CAMIN CULTURAL, SAT LUPESTI, NR.117",240,152,151,1,0,151,1,300,148,77,74,3,1116,0
2,"Arad",12572,29,12572,,"VARADIA DE MURES",467,"SCOALA GENERALA , SAT N.BALCESCU, NR.158",221,103,99,4,0,102,1,250,147,63,39,3,1116,0
2,"Arad",12572,29,12572,,"VARADIA DE MURES",468,"CAMIN CULTURAL, SAT BAIA, NR.156/A",117,86,79,7,0,85,1,150,64,42,43,3,1116,0
2,"Arad",12572,29,12572,,"VARADIA DE MURES",469,"SCOALA CU CLASELE I-IV, SAT STEJAR, NR.33",125,79,73,6,0,79,0,150,71,36,43,3,1116,0
2,"Arad",12572,29,12572,,"VARADIA DE MURES",470,"PRIMARIA COMUNEI VARADIA DE MURES NR.126",0,87,0,87,0,87,0,250,163,39,48,3,1116,1
2,"Arad",12643,29,12643,,"VINGA",471,"PRIMARIA COMUNEI, VINGA, NR.27",1751,924,911,13,0,916,8,1900,976,666,250,3,1132,0
2,"Arad",12643,29,12643,,"VINGA",472,"SCOALA NR.2, VINGA, NR.415",1777,825,811,14,0,816,9,2000,1175,596,220,3,1132,0
2,"Arad",12643,29,12643,,"VINGA",473,"SCOALA MAILAT, SAT MAILAT, NR.608",842,352,346,6,0,348,4,900,548,170,178,3,1132,0
2,"Arad",12643,29,12643,,"VINGA",474,"SCOALA MANASTUR, SAT MANASTUR, FN",907,507,493,14,0,495,12,1000,493,414,81,3,1132,0
2,"Arad",12643,29,12643,,"VINGA",475,"GRUP SCOLAR VINGA  NR.88",0,203,0,203,0,201,2,400,197,131,70,3,1132,1
2,"Arad",12689,29,12689,,"VARFURILE",476,"PRIMARIA COMUNEI, STRADA PRIMARIEI,VARFURILE, NR.286",929,608,594,10,4,600,8,1000,392,323,277,3,1123,0
2,"Arad",12689,29,12689,,"VARFURILE",477,"SCOALA GENERALA CU CLASELE I-IV, SAT AVRAM IANCU, NR.267",724,510,491,5,14,505,5,800,290,356,149,3,1123,0
2,"Arad",12689,29,12689,,"VARFURILE",478,"CAMIN CULTURAL, SAT MAGULICEA, NR.97",422,293,277,5,11,290,3,500,207,183,107,3,1123,0
2,"Arad",12689,29,12689,,"VARFURILE",479,"CAMIN CULTURAL, SAT LAZURI, NR.38",432,279,272,7,0,276,3,500,221,140,136,3,1123,0
2,"Arad",12689,29,12689,,"VARFURILE",480,"CAMINUL CULTURAL VARFURILE  STRADA PRIMARIEI NR.286",0,133,0,133,0,133,0,150,17,72,61,3,1123,1
2,"Arad",9397,29,9397,,"VLADIMIRESCU",481,"PRIMARIA COMUNEI, VLADIMIRESCU, STR.REVOLUTIEI, NR.4",1523,733,723,10,0,727,6,1600,867,499,228,3,1136,0
2,"Arad",9397,29,9397,,"VLADIMIRESCU",482,"CAMIN CULTURAL, VLADIMIRESCU,  STR. STEFAN CEL MARE, NR.5",1488,682,671,10,1,677,5,1500,818,518,159,3,1136,0
2,"Arad",9397,29,9397,,"VLADIMIRESCU",483,"CENTRUL DE ZI PENTRU VARSTNICI, VLADIMIRESCU, STR.GEN. V. MILEA, NR.64",1448,726,707,19,0,718,8,1500,774,450,268,3,1136,0
2,"Arad",9397,29,9397,,"VLADIMIRESCU",484,"SCOALA GENERALA, VLADIMIRESCU, STR. GARII, NR.59",1448,711,697,14,0,705,6,1500,789,519,186,3,1136,0
2,"Arad",9397,29,9397,,"VLADIMIRESCU",485,"SCOALA GENERALA, SAT HOREA, NR.253",1094,600,590,10,0,596,4,1100,500,366,230,3,1136,0
2,"Arad",9397,29,9397,,"VLADIMIRESCU",486,"CLADIRE NOUA TAXE SI IMPOZITE , SAT HOREA, NR.524",1017,509,494,15,0,506,3,1100,591,356,150,3,1136,0
2,"Arad",9397,29,9397,,"VLADIMIRESCU",487,"SCOALA GENERALA , SAT MANDRULOC, NR.267",1014,585,579,6,0,577,8,1100,515,380,197,3,1136,0
2,"Arad",9397,29,9397,,"VLADIMIRESCU",488,"SCOALA GENERALA, SAT CICIR, NR.242",767,458,443,15,0,455,3,800,342,310,145,3,1136,0
2,"Arad",9397,29,9397,,"VLADIMIRESCU",489,"PRIMARIA COMUNEI VLADIMIRESCU  STRADA REVOLUTIEI NR.4 CAMERA 12",0,232,0,232,0,231,1,600,368,144,87,3,1136,1
2,"Arad",12778,29,12778,,"ZABRANI",490,"CAMIN CULTURAL, LOCALITATEA ZABRANI, NR.648",1914,1149,1132,16,1,1145,4,2200,1051,835,310,3,1141,0
2,"Arad",12778,29,12778,,"ZABRANI",491,"CAMIN CULTURAL , SAT CHESINT, NR.488",958,552,544,8,0,551,1,1098,546,411,140,3,1141,0
2,"Arad",12778,29,12778,,"ZABRANI",492,"CAMIN CULTURAL, SAT NEUDORF, NR.146",878,502,490,12,0,499,3,1002,500,288,211,3,1141,0
2,"Arad",12778,29,12778,,"ZABRANI",493,"PRIMARIA COMUNEI ZABRANI  NR.95",0,120,0,120,0,119,1,300,180,85,34,3,1141,1
2,"Arad",12938,29,12938,,"ZADARENI",494,"PRIMARIA COMUNEI, ZADARENI, NR.28, SALA DE SEDINTE",1208,619,606,12,1,616,3,1200,581,422,194,3,1145,0
2,"Arad",12938,29,12938,,"ZADARENI",495,"PRIMARIA COMUNEI, ZADARENI, NR.28, REMIZA PSI",776,455,446,9,0,454,1,1000,545,307,147,3,1145,0
2,"Arad",12938,29,12938,,"ZADARENI",496,"SCOALA GENERALA, SAT BODROGUL NOU, FN",195,128,118,10,0,127,1,200,72,86,41,3,1145,0
2,"Arad",12938,29,12938,,"ZADARENI",497,"CAMINUL CULTURAL ZADARENI  NR. 262",0,100,0,100,0,100,0,200,100,62,38,3,1145,1
2,"Arad",12812,29,12812,,"ZARAND",498,"PRIMARIA COMUNEI, ZARAND, NR.512",1076,696,689,7,0,694,2,1200,504,455,239,3,1148,0
2,"Arad",12812,29,12812,,"ZARAND",499,"SCOALA GENERALA, SAT CINTEI, NR.89",942,783,753,8,22,780,3,981,198,660,120,3,1148,0
2,"Arad",12812,29,12812,,"ZARAND",500,"PRIMARIA COMUNEI ZARAND  NR.512",0,102,0,102,0,101,1,150,48,74,27,3,1148,1
2,"Arad",12849,29,12849,,"ZERIND",501,"PRIMARIA COMUNEI, ZERIND, NR.1",715,297,293,4,0,292,5,800,503,183,109,3,1151,0
2,"Arad",12849,29,12849,,"ZERIND",502,"SCOALA GENERALA CU CLASELE I-IV, SAT IERMATA NEAGRA, NR.1",473,217,209,8,0,215,2,500,283,134,81,3,1151,0
2,"Arad",12849,29,12849,,"ZERIND",503,"PRIMARIA COMUNEI ZERIND NR. 1",0,35,0,35,0,35,0,100,65,19,16,3,1151,1
2,"Arad",12876,29,12876,,"ZIMANDU NOU",504,"CAMIN CULTURAL, LOCALITATEA  ZIMANDU NOU, NR.339",1370,606,587,13,6,599,7,1500,894,395,204,3,1154,0
2,"Arad",12876,29,12876,,"ZIMANDU NOU",505,"CAMIN CULTURAL, SAT ANDREI SAGUNA, NR.165",1260,773,744,6,23,764,9,1400,627,493,271,3,1154,0
2,"Arad",12876,29,12876,,"ZIMANDU NOU",506,"CAMIN CULTURAL, SAT ZIMAND-CUZ, NR.246",1124,495,489,6,0,488,7,1200,705,327,161,3,1154,0
2,"Arad",12876,29,12876,,"ZIMANDU NOU",507,"SCOALA GENERALA CU CLASELE I-IV SAT UTVINIS",221,139,133,6,0,137,2,300,161,80,57,3,1154,0
2,"Arad",12876,29,12876,,"ZIMANDU NOU",508,"CAMINUL CULTURAL ZIMAND CUZ SAT ZIMAND CUZ NR. 246",0,98,0,98,0,98,0,200,102,62,36,3,1154,1
3,"Arges",13169,38,13169,,"MUNICIPIUL PITESTI",1,"BIBLIOTECA JUDETEANA ARGES  DINICU GOLESCU   STR. VICTORIEI NR.18",1455,963,900,25,38,955,8,1500,537,389,566,1,1159,0
3,"Arges",13169,38,13169,,"MUNICIPIUL PITESTI",2,"COLEGIUL ECONOMIC  MARIA TEIULEANU   B-DUL REPUBLICII NR. 63.",1241,820,788,32,0,807,13,1300,480,328,479,1,1159,0
3,"Arges",13169,38,13169,,"MUNICIPIUL PITESTI",3,"SCOALA NR. 3  ION PILLAT   INTRAREA RAHOVEI NR. 6",1099,664,648,16,0,658,6,1200,536,296,362,1,1159,0
3,"Arges",13169,38,13169,,"MUNICIPIUL PITESTI",4,"GRUP SCOLAR INDUSTRIAL DE CONSTRUCTII NR. 2 B-DUL  EROILOR NR.26",1654,1035,1021,14,0,1021,14,1756,721,424,597,1,1159,0
3,"Arges",13169,38,13169,,"MUNICIPIUL PITESTI",5,"SCOALA NR. 12 (INTRAREA A) STR. BRADULUI NR. 13 - CARTIER TRIVALE",1896,1072,1061,11,0,1059,13,2000,928,432,627,1,1159,0
3,"Arges",13169,38,13169,,"MUNICIPIUL PITESTI",6,"SCOALA NR. 12 (INTRAREA B) STR. BRADULUI NR. 13 - CARTIER TRIVALE",1785,911,892,19,0,899,12,1900,989,412,487,1,1159,0
3,"Arges",13169,38,13169,,"MUNICIPIUL PITESTI",7,"SCOALA NR. 12 (INTRAREA C) STR. BRADULUI NR. 13 - CARTIER TRIVALE",1940,956,927,29,0,949,7,2100,1144,398,551,1,1159,0
3,"Arges",13169,38,13169,,"MUNICIPIUL PITESTI",8,"SCOALA NR. 12 (INTRAREA D) STR. BRADULUI NR. 13 - CARTIER TRIVALE",1975,976,955,21,0,970,6,2100,1124,399,571,1,1159,0
3,"Arges",13169,38,13169,,"MUNICIPIUL PITESTI",9,"GRADINITA  CU PROGRAM PRELUNGIT NR. 13 STR. CAMPULUI NR. 1 - CARTIER TRIVALE",2009,972,954,18,0,964,8,2100,1128,406,558,1,1159,0
3,"Arges",13169,38,13169,,"MUNICIPIUL PITESTI",10,"SCOALA  NR. 13  MIRCEA CEL BATRAN  (INTRAREA A) STR. ZIMBRULUI NR. 3 - CARTIER TRIVALE",1897,1053,1036,17,0,1041,12,2000,947,436,605,1,1159,0
3,"Arges",13169,38,13169,,"MUNICIPIUL PITESTI",11,"SCOALA  NR. 13  MIRCEA CEL BATRAN  (INTRAREA B) STR. ZIMBRULUI NR. 3 - CARTIER TRIVALE",1948,1078,1053,24,1,1068,10,2100,1022,418,650,1,1159,0
3,"Arges",13169,38,13169,,"MUNICIPIUL PITESTI",12,"SCOALA NR. 13  MIRCEA CEL BATRAN   (INTRAREA C) STR. ZIMBRULUI NR. 3 - CARTIER TRIVALE",2006,1183,1163,19,1,1178,5,2100,917,450,728,1,1159,0
3,"Arges",13169,38,13169,,"MUNICIPIUL PITESTI",13,"SCOALA NR. 13  MIRCEA CEL BATRAN   (INTRAREA D) STR. ZIMBRULUI NR. 3 - CARTIER TRIVALE",1892,1094,1075,19,0,1080,14,2000,906,470,610,1,1159,0
3,"Arges",13169,38,13169,,"MUNICIPIUL PITESTI",14,"GRADINITA CU PROGRAM PRELUNGIT SI  CRESA NR. 6 (INTRAREA A) STR. FRASINULUI NR. 10 - CARTIER TRIVALE",1561,974,958,16,0,957,17,1700,726,376,581,1,1159,0
3,"Arges",13169,38,13169,,"MUNICIPIUL PITESTI",15,"GRADINITA CU PROGRAM PRELUNGIT SI CRESA NR. 6 (INTRAREA B) STR. FRASINULUI NR. 10 - CARTIER TRIVALE",1797,1049,1034,15,0,1043,6,1901,852,465,578,1,1159,0
3,"Arges",13169,38,13169,,"MUNICIPIUL PITESTI",16,"GRUPUL SCOLAR INDUSTRIAL CONSTRUCTII MASINI  DACIA   STR. HENRI COANDA NR. 4",1566,948,931,17,0,934,14,1700,752,374,560,1,1159,0
3,"Arges",13169,38,13169,,"MUNICIPIUL PITESTI",17,"COLEGIUL NATIONAL  I.C. BRATIANU   STR. ARMAND CALINESCU NR. 14",1071,621,597,24,0,611,10,1200,579,284,327,1,1159,0
3,"Arges",13169,38,13169,,"MUNICIPIUL PITESTI",18,"SCOALA NR. 9 (INTRAREA A) STR. NEGRU VODA NR. 33",1688,1009,992,17,0,994,15,1800,791,373,621,1,1159,0
3,"Arges",13169,38,13169,,"MUNICIPIUL PITESTI",19,"SCOALA NR. 9 (INTRAREA B) STR. NEGRU VODA NR. 33",1767,1074,1056,18,0,1065,9,1900,826,436,629,1,1159,0
3,"Arges",13169,38,13169,,"MUNICIPIUL PITESTI",20,"DISPENSARUL UMAN - ZONA NORD ALEEA DR. STEFAN ODOBLEJA NR.3",2171,1141,1104,37,0,1123,18,2300,1159,449,674,1,1159,0
3,"Arges",13169,38,13169,,"MUNICIPIUL PITESTI",21,"SC GROSMETCHIM SA B-DUL NICOLAE BALCESCU NR.48",1946,1079,1069,10,0,1069,10,2100,1021,392,677,1,1159,0
3,"Arges",13169,38,13169,,"MUNICIPIUL PITESTI",22,"SCOALA NR. 6 (INTRAREA A) B-DUL NICOLAE BALCESCU NR. 141- CARTIER GAVANA",2003,1082,1062,20,0,1067,15,2100,1018,435,632,1,1159,0
3,"Arges",13169,38,13169,,"MUNICIPIUL PITESTI",23,"SCOALA NR. 6 (INTRAREA B) B-DUL NICOLAE BALCESCU NR. 141- CARTIER GAVANA",1935,968,955,13,0,960,8,2100,1132,403,557,1,1159,0
3,"Arges",13169,38,13169,,"MUNICIPIUL PITESTI",24,"GRADINITA CU PROGRAM PRELUNGIT SI CRESA NR. 10 ALEEA EFTIMIE ANTONESCU NR.4 - CARTIER GAVANA",1988,997,984,13,0,983,14,1002,5,396,587,1,1159,0
3,"Arges",13169,38,13169,,"MUNICIPIUL PITESTI",25,"SCOALA NR. 15  ADRIAN PAUNESCU   (INTRAREA A) STR. PALTINULUI NR. 9 - CARTIER  GAVANA",1932,1070,1060,9,1,1064,6,2100,1030,416,648,1,1159,0
3,"Arges",13169,38,13169,,"MUNICIPIUL PITESTI",26,"SCOALA NR. 15  ADRIAN PAUNESCU   (INTRAREA B) STR. PALTINULUI NR. 9 - CARTIER  GAVANA",1884,1027,1008,18,1,1018,9,1999,972,372,646,1,1159,0
3,"Arges",13169,38,13169,,"MUNICIPIUL PITESTI",27,"SCOALA NR. 6 (INTRAREA C) B-DUL NICOLAE BALCESCU NR. 141- CARTIER GAVANA",1784,957,941,16,0,951,6,1900,943,353,598,1,1159,0
3,"Arges",13169,38,13169,,"MUNICIPIUL PITESTI",28,"SCOALA NR. 6 (INTRAREA D) B-DUL NICOLAE BALCESCU NR. 141- CARTIER GAVANA",1973,1127,1119,8,0,1120,7,2100,973,471,649,1,1159,0
3,"Arges",13169,38,13169,,"MUNICIPIUL PITESTI",29,"GRADINITA CU PROGRAM NORMAL NR. 22 B-DUL NICOLAE BALCESCU, BL.S5, SC.F, PARTER (VIS-A-VIS DE S.C.  LISA DRAXLMAIER  SA)",1480,859,837,22,0,850,9,1600,741,365,485,1,1159,0
3,"Arges",13169,38,13169,,"MUNICIPIUL PITESTI",30,"S.C.  LISA DRAXLMAIER  S.A. (INTRAREA A) B-DUL NICOLAE BALCESCU NR. 186",1993,1083,1068,15,0,1072,11,2100,1017,467,605,1,1159,0
3,"Arges",13169,38,13169,,"MUNICIPIUL PITESTI",31,"S.C.  LISA DRAXLMAIER  S.A. (INTRAREA B) B-DUL NICOLAE BALCESCU NR. 186",2131,1166,1140,26,0,1156,10,2300,1134,474,682,1,1159,0
3,"Arges",13169,38,13169,,"MUNICIPIUL PITESTI",32,"POLICLINICA SPITALULUI JUDETEAN (INTRAREA A) ALEEA SPITALULUI NR. 32 - CARTIER GAVANA",2055,1115,1097,18,0,1096,19,2197,1082,446,650,1,1159,0
3,"Arges",13169,38,13169,,"MUNICIPIUL PITESTI",33,"POLICLINICA SPITALULUI JUDETEAN (INTRAREA B) ALEEA SPITALULUI NR. 32 - CARTIER GAVANA",2040,1146,1115,31,0,1129,17,2200,1054,440,689,1,1159,0
3,"Arges",13169,38,13169,,"MUNICIPIUL PITESTI",34,"GRUPUL  SCOLAR  ION  CANTACUZINO   (INTRAREA A) STR. DR. CAROL DAVILA NR.1",1946,1119,1104,15,0,1107,12,2100,981,467,640,1,1159,0
3,"Arges",13169,38,13169,,"MUNICIPIUL PITESTI",35,"SCOALA NR. 19 (INTRAREA A) STR. GHEORGHE IONESCU-GION NR.8 - CARTIER GAVANA",2072,1271,1240,31,0,1255,16,2200,929,498,757,1,1159,0
3,"Arges",13169,38,13169,,"MUNICIPIUL PITESTI",36,"SCOALA NR. 19 (INTRAREA B) STR. GHEORGHE IONESCU-GION NR.8 - CARTIER GAVANA",2168,1254,1241,13,0,1243,11,2300,1046,455,788,1,1159,0
3,"Arges",13169,38,13169,,"MUNICIPIUL PITESTI",37,"UNIVERSITATEA  CONSTANTIN BRANCOVEANU   CALEA BASCOVULUI NR.4",2074,1154,1134,20,0,1142,12,2200,1046,464,678,1,1159,0
3,"Arges",13169,38,13169,,"MUNICIPIUL PITESTI",38,"SCOALA NR. 14  ALEXANDRU DAVILA   STR. FAGARAS NR. 10",2037,1187,1176,11,0,1171,16,2200,1013,459,712,1,1159,0
3,"Arges",13169,38,13169,,"MUNICIPIUL PITESTI",39,"SCOALA NR. 10  MARIN PREDA   (INTRAREA B) STR. PICTOR NICOLAE GRIGORESCU NR. 37",1677,1049,1037,11,1,1035,14,1800,751,396,639,1,1159,0
3,"Arges",13169,38,13169,,"MUNICIPIUL PITESTI",40,"SCOALA NR. 10  MARIN PREDA   (INTRAREA A) STR. PICTOR NICOLAE GRIGORESCU NR. 37",1900,1172,1145,27,0,1159,13,2000,828,450,709,1,1159,0
3,"Arges",13169,38,13169,,"MUNICIPIUL PITESTI",41,"SCOALA NR. 10  MARIN PREDA   (INTRAREA B) STR. PICTOR NICOLAE GRIGORESCU NR. 37",1816,1165,1144,21,0,1147,18,2000,835,454,693,1,1159,0
3,"Arges",13169,38,13169,,"MUNICIPIUL PITESTI",42,"GRADINITA CU PROGRAM PRELUNGIT NR. 3 B-DUL I.C. BRATIANU NR. 50",845,526,513,13,0,520,6,1000,474,237,283,1,1159,0
3,"Arges",13169,38,13169,,"MUNICIPIUL PITESTI",43,"SCOALA NR. 1  NICOLAE SIMONIDE   (INTRAREA A) STR. 9 MAI NR. 50",1330,852,843,9,0,839,13,1500,648,284,555,1,1159,0
3,"Arges",13169,38,13169,,"MUNICIPIUL PITESTI",44,"SCOALA NR. 1  NICOLAE SIMONIDE   (INTRAREA B) STR. 9 MAI NR. 50",1731,1025,989,36,0,1014,11,1900,875,442,572,1,1159,0
3,"Arges",13169,38,13169,,"MUNICIPIUL PITESTI",45,"SCOALA NR. 1  NICOLAE SIMONIDE   (INTRAREA C) STR. 9 MAI NR. 50",1025,655,643,12,0,646,9,1100,445,219,427,1,1159,0
3,"Arges",13169,38,13169,,"MUNICIPIUL PITESTI",46,"DIRECTIA APELOR ARGES- VEDEA CALEA CAMPULUNG NR. 6",870,467,455,12,0,459,8,1000,533,209,250,1,1159,0
3,"Arges",13169,38,13169,,"MUNICIPIUL PITESTI",47,"DISPENSARUL NR. 16 (IN CLADIREA CRESEI NR. 9) STR. MIHAI EMINESCU NR.1",1947,1208,1193,14,1,1193,15,2100,892,523,670,1,1159,0
3,"Arges",13169,38,13169,,"MUNICIPIUL PITESTI",48,"GRUPUL SCOLAR DE INDUSTRIE USOARA  ARMAND CALINESCU   B-DUL I.C. BRATIANU NR. 44",1633,1042,1028,14,0,1027,12,1800,758,437,590,1,1159,0
3,"Arges",13169,38,13169,,"MUNICIPIUL PITESTI",49,"SCOALA NR. 5  NICOLAE IORGA  (INTRAREA A) STR. RAURILOR NR. 5",1603,950,936,14,0,939,11,1700,750,385,554,1,1159,0
3,"Arges",13169,38,13169,,"MUNICIPIUL PITESTI",50,"SCOALA NR. 5  NICOLAE IORGA   (INTRAREA B) STR. RAURILOR NR. 5",1107,650,635,15,0,639,11,1200,550,294,345,1,1159,0
3,"Arges",13169,38,13169,,"MUNICIPIUL PITESTI",51,"SCOALA NR. 20 (INTRAREA A) CARTIER TUDOR VLADIMIRESCU",1413,820,793,27,0,811,9,1500,680,314,497,1,1159,0
3,"Arges",13169,38,13169,,"MUNICIPIUL PITESTI",52,"SCOALA NR. 20 (INTRAREA B) CARTIER TUDOR VLADIMIRESCU",2003,1069,1056,13,0,1053,16,2100,1031,448,605,1,1159,0
3,"Arges",13169,38,13169,,"MUNICIPIUL PITESTI",53,"SCOALA NR. 18 (INTRAREA A) B-DUL PETROCHIMISTILOR NR.31 - CARTIER PRUNDU",1893,1015,1002,13,0,997,18,2000,985,394,603,1,1159,0
3,"Arges",13169,38,13169,,"MUNICIPIUL PITESTI",54,"SCOALA NR. 18 (INTRAREA B) B-DUL PETROCHIMISTILOR NR.31 - CARTIER PRUNDU",1908,966,952,14,0,957,9,2000,1034,379,578,1,1159,0
3,"Arges",13169,38,13169,,"MUNICIPIUL PITESTI",55,"SCOALA NR. 7 (INTRAREA A) STR. HORIA, CLOSCA SI CRISAN NR.7 - CARTIER PRUNDU",2000,1023,1006,17,0,1014,9,2100,1077,429,585,1,1159,0
3,"Arges",13169,38,13169,,"MUNICIPIUL PITESTI",56,"SCOALA NR. 7 (INTRAREA B) STR. HORIA, CLOSCA SI CRISAN NR.7 - CARTIER PRUNDU",1977,1071,1053,18,0,1060,11,2100,1029,404,656,1,1159,0
3,"Arges",13169,38,13169,,"MUNICIPIUL PITESTI",57,"SCOALA NR. 7 (INTRAREA C) STR. HORIA, CLOSCA SI CRISAN NR.7 - CARTIER PRUNDU",2083,1222,1196,26,0,1209,13,2200,978,429,780,1,1159,0
3,"Arges",13169,38,13169,,"MUNICIPIUL PITESTI",58,"GRUPUL SCOLAR DE CHIMIE INDUSTRIALA (INTRAREA A) B-DUL  PETROCHIMISTILOR NR.33 - CARTIER PRUNDU",2338,1219,1205,14,0,1212,7,2500,1281,480,732,1,1159,0
3,"Arges",13169,38,13169,,"MUNICIPIUL PITESTI",59,"GRUPUL SCOLAR DE CHIMIE INDUSTRIALA (INTRAREA B) B-DUL  PETROCHIMISTILOR NR.33 - CARTIER PRUNDU",2111,1222,1207,15,0,1214,8,2300,1078,499,715,1,1159,0
3,"Arges",13169,38,13169,,"MUNICIPIUL PITESTI",60,"SCOALA NR. 8 B-DUL REPUBLICII NR. 226",2047,1320,1305,15,0,1301,19,2200,880,535,766,1,1159,0
3,"Arges",13169,38,13169,,"MUNICIPIUL PITESTI",61,"CLUBUL PENSIONARILOR B-DUL REPUBLICII, BL.D5 PARTER",1934,1124,1113,11,0,1114,10,2100,976,424,690,1,1159,0
3,"Arges",13169,38,13169,,"MUNICIPIUL PITESTI",62,"SCOALA NR. 11  MIHAI EMINESCU   (INTRAREA A) STR. TINERETULUI NR. 4",1649,965,950,15,0,955,10,1800,835,358,597,1,1159,0
3,"Arges",13169,38,13169,,"MUNICIPIUL PITESTI",63,"SCOALA NR. 11  MIHAI EMINESCU   (INTRAREA B) STR. TINERETULUI NR. 4",1457,861,835,26,0,850,11,1600,739,360,490,1,1159,0
3,"Arges",13169,38,13169,,"MUNICIPIUL PITESTI",64,"GRADINITA CU PROGRAM PRELUNGIT SI CRESA NR. 5. STR. TINERETULUI NR. 2A",1217,748,737,11,0,738,10,1290,542,286,452,1,1159,0
3,"Arges",13169,38,13169,,"MUNICIPIUL PITESTI",65,"UNIVERSITATEA PITESTI ALEEA SCOLII NORMALE NR.7",1722,1000,978,22,0,989,11,1500,500,375,614,1,1159,0
3,"Arges",13169,38,13169,,"MUNICIPIUL PITESTI",66,"COLEGIUL NATIONAL LICEAL  ALEXANDRU ODOBESCU   (INTRAREA A) STR. BUREBISTA NR. 20",1654,935,895,40,0,929,6,1800,865,378,551,1,1159,0
3,"Arges",13169,38,13169,,"MUNICIPIUL PITESTI",67,"GRADINITA CU PROGRAM PRELUNGIT SI CRESA NR. 8 STR. DECENEU NR.1 - CARTIER RAZBOIENI",1999,874,849,25,0,864,10,2100,1226,379,485,1,1159,0
3,"Arges",13169,38,13169,,"MUNICIPIUL PITESTI",68,"SCOALA NR. 2  ION MINULESCU   (INTRAREA A) STR. EXERCITIU NR. 206",1598,845,833,12,0,838,7,1700,855,379,459,1,1159,0
3,"Arges",13169,38,13169,,"MUNICIPIUL PITESTI",69,"SCOALA NR. 2  ION MINULESCU   (INTRAREA B) STR. EXERCITIU NR. 206",1899,1114,1099,15,0,1106,8,2000,886,413,693,1,1159,0
3,"Arges",13169,38,13169,,"MUNICIPIUL PITESTI",70,"COLEGIUL TEHNIC  DIMITRIE DIMA     (INTRAREA A) STR. DECEBAL NR.2 - CARTIER RAZBOIENI",1811,1026,1008,18,0,1015,11,2000,974,439,576,1,1159,0
3,"Arges",13169,38,13169,,"MUNICIPIUL PITESTI",71,"COLEGIUL TEHNIC  DIMITRIE DIMA     (INTRAREA B) STR. DECEBAL NR.2 - CARTIER RAZBOIENI",1849,874,792,82,0,870,4,2000,1126,363,507,1,1159,0
3,"Arges",13169,38,13169,,"MUNICIPIUL PITESTI",72,"SCOALA NR. 17 STR. VASILE PARVAN NR. 1",1982,983,976,7,0,971,12,2100,1117,430,541,1,1159,0
3,"Arges",13169,38,13169,,"MUNICIPIUL PITESTI",73,"GRUPUL SCOLAR DE INDUSTRIALIZAREA LEMNULUI (INTRAREA A) STR. PATRASCU VODA NR. 4",1932,1126,1111,15,0,1105,21,2100,974,409,696,1,1159,0
3,"Arges",13169,38,13169,,"MUNICIPIUL PITESTI",74,"GRUPUL SCOLAR DE INDUSTRIALIZAREA LEMNULUI (INTRAREA B) STR. PATRASCU VODA NR. 4",1855,1095,1080,15,0,1086,9,2000,905,470,616,1,1159,0
3,"Arges",13169,38,13169,,"MUNICIPIUL PITESTI",75,"GRADINITA CU PROGRAM NORMAL NR.4 STR. AL.D. XENOPOL NR. 2A - CARTIER BANAT",1952,1072,1053,19,0,1062,10,2100,1028,397,665,1,1159,0
3,"Arges",13169,38,13169,,"MUNICIPIUL PITESTI",76,"GRADINITA CU PROGRAM PRELUNGIT SI CRESA NR. 14 ALEEA FRATII TRIFONESCU NR. 6 - CARTIER BANAT",1814,1026,999,27,0,1009,17,2000,974,358,651,1,1159,0
3,"Arges",13169,38,13169,,"MUNICIPIUL PITESTI",77,"SCOALA NR. 16  I. L. CARAGIALE   (INTRAREA A) INTRAREA PETRACHE POENARU NR.2 - CARTIER BANAT",1773,963,941,22,0,951,12,1900,937,367,584,1,1159,0
3,"Arges",13169,38,13169,,"MUNICIPIUL PITESTI",78,"SCOALA NR. 16  I. L. CARAGIALE   (INTRAREA B) INTRAREA PETRACHE POENARU NR.2 - CARTIER BANAT",1904,1016,1000,16,0,1009,7,2000,984,385,624,1,1159,0
3,"Arges",13169,38,13169,,"MUNICIPIUL PITESTI",79,"SCOALA NR. 4 (INTRAREA A) STR. TRAIAN NR. 35",1592,1005,976,28,1,997,8,1700,695,375,622,1,1159,0
3,"Arges",13169,38,13169,,"MUNICIPIUL PITESTI",80,"SCOALA NR. 4 (INTRAREA B) STR. TRAIAN NR. 35",1874,1125,1109,16,0,1114,11,2000,875,469,645,1,1159,0
3,"Arges",13169,38,13169,,"MUNICIPIUL PITESTI",81,"GRUPUL  SCOLAR  ION  CANTACUZINO   (INTRAREA B) STR. DR. CAROL DAVILA NR.1",1975,1017,1004,13,0,1011,6,2100,1083,406,605,1,1159,0
3,"Arges",13169,38,13169,,"MUNICIPIUL PITESTI",82,"SCOALA NR.20 (INTRAREA C) CARTIER TUDOR VLADIMIRESCU",1962,1151,1137,14,0,1136,15,2100,949,472,664,1,1159,0
3,"Arges",13169,38,13169,,"MUNICIPIUL PITESTI",83,"SCOALA NR. 7 (INTRAREA D) STR. HORIA, CLOSCA SI CRISAN NR.7 - CARTIER PRUNDU",1896,1033,1018,15,0,1019,14,2100,1067,368,651,1,1159,0
3,"Arges",13169,38,13169,,"MUNICIPIUL PITESTI",84,"COLEGIUL NATIONAL LICEAL  ALEXANDRU ODOBESCU   (INTRAREA B) STR. BUREBISTA NR. 20",1845,923,903,20,0,910,13,2000,1077,399,511,1,1159,0
3,"Arges",13169,38,13169,,"MUNICIPIUL PITESTI",85,"SCOALA NR. 16  I. L. CARAGIALE   (INTRAREA C) INTRAREA PETRACHE POENARU NR.2 - CARTIER BANAT",1897,1091,1075,16,0,1077,14,2000,909,452,625,1,1159,0
3,"Arges",13169,38,13169,,"MUNICIPIUL PITESTI",86,"UNIVERSITATEA PITESTI, ALEEA SCOLII NORMALE NR. 7, CP 110254, MUN. PITESTI",0,1220,0,1220,0,1206,14,1299,79,624,582,1,1159,1
3,"Arges",13169,38,13169,,"MUNICIPIUL PITESTI",87,"CENTRUL DE INGRIJIRE SI ASISTENTA PITESTI, ALEEA SPITALULUI NR.2, CP 110254, MUN. PITESTI",0,258,0,258,0,256,2,1000,742,109,147,1,1159,1
3,"Arges",13169,38,13169,,"MUNICIPIUL PITESTI",88,"SPITALUL JUDETEAN ARGES, ALEEA SPITALULUI NR. 36, CP 110254,  MUN. PITESTI",0,806,0,806,0,800,6,1000,194,417,383,1,1159,1
3,"Arges",13490,38,13490,,"MUNICIPIUL CAMPULUNG",89,"SCOALA GENERALA NR.1 - I  STR. GENERAL POSOIU NR.1, MUN. CAMPULUNG",980,528,522,6,0,526,2,1100,572,219,307,1,1161,0
3,"Arges",13490,38,13490,,"MUNICIPIUL CAMPULUNG",90,"SCOALA GENERALA NR.1 - II STR. GENERAL POSOIU NR.1, MUN. CAMPULUNG",1069,645,635,10,0,633,12,1200,555,239,394,1,1161,0
3,"Arges",13490,38,13490,,"MUNICIPIUL CAMPULUNG",91,"LICEUL INDUSTRIAL NR.1  STR. NEGRU VODA NR.145, MUN. CAMPULUNG",1364,770,754,16,0,763,7,1500,730,321,442,1,1161,0
3,"Arges",13490,38,13490,,"MUNICIPIUL CAMPULUNG",92,"BIBLIOTECA GRUI, STR. CARPATI, BL. D22, MUN. CAMPULUNG",1820,835,825,10,0,831,4,2000,1165,403,428,1,1161,0
3,"Arges",13490,38,13490,,"MUNICIPIUL CAMPULUNG",93,"GRADINITA CU PROGRAM NORMAL NR.12-I  STR. CARPATI NR.91, BL. D22, MUN. CAMPULUNG",1834,870,866,4,0,859,11,2000,1130,401,458,1,1161,0
3,"Arges",13490,38,13490,,"MUNICIPIUL CAMPULUNG",94,"GRADINITA CU PROGRAM NORMAL NR.12-II STR. CARPATI NR.91, BL. D22, MUN. CAMPULUNG",1594,737,724,13,0,730,7,1700,963,349,381,1,1161,0
3,"Arges",13490,38,13490,,"MUNICIPIUL CAMPULUNG",95,"GRADINITA CU PROGRAM NORMAL NR.12-III  STR. CARPATI NR.91, BL. D22, MUN. CAMPULUNG",1693,806,801,5,0,793,13,1800,994,366,427,1,1161,0
3,"Arges",13490,38,13490,,"MUNICIPIUL CAMPULUNG",96,"SCOALA GENERALA NR.5  STR. NEGRU VODA NR. 282, MUN. CAMPULUNG",895,501,489,12,0,496,5,1000,499,223,273,1,1161,0
3,"Arges",13490,38,13490,,"MUNICIPIUL CAMPULUNG",97,"SCOALA GENERALA NR.6 VISOI  STR. C. VODA NR. 30, MUN. CAMPULUNG",1007,590,578,12,0,586,4,1100,510,217,369,1,1161,0
3,"Arges",13490,38,13490,,"MUNICIPIUL CAMPULUNG",98,"SCOALA GENERALA NR.7  VISOI - I STR.G. TOPARCEANU NR. 6, MUN. CAMPULUNG",1608,770,762,8,0,762,8,1700,930,405,357,1,1161,0
3,"Arges",13490,38,13490,,"MUNICIPIUL CAMPULUNG",99,"SCOALA GENERALA NR.7  VISOI - II  STR.G. TOPARCEANU NR. 6 , MUN. CAMPULUNG",1275,643,635,8,0,634,9,1400,757,292,342,1,1161,0
3,"Arges",13490,38,13490,,"MUNICIPIUL CAMPULUNG",100,"SCOALA GENERALA NR.7  VISOI - III STR.G. TOPARCEANU NR. 6, MUN. CAMPULUNG",1481,716,711,5,0,711,5,1600,884,383,328,1,1161,0
3,"Arges",13490,38,13490,,"MUNICIPIUL CAMPULUNG",101,"CAMINUL DE COPII NR.2 - I    STR. G. TOPARCEANU, MUN. CAMPULUNG",1598,731,719,11,1,727,4,1700,969,341,386,1,1161,0
3,"Arges",13490,38,13490,,"MUNICIPIUL CAMPULUNG",102,"CAMINUL DE COPII NR.2 - II    STR. G. TOPARCEANU, MUN. CAMPULUNG",1468,683,675,8,0,679,4,1600,917,349,330,1,1161,0
3,"Arges",13490,38,13490,,"MUNICIPIUL CAMPULUNG",103,"CAMINUL DE COPII NR.2 - III   STR. G. TOPARCEANU, MUN. CAMPULUNG",1830,737,727,10,0,727,10,2000,1263,365,362,1,1161,0
3,"Arges",13490,38,13490,,"MUNICIPIUL CAMPULUNG",104,"GRADINITA CU PROGRAM NORMAL NR.13 - I    STR. C. CONSTANTINESCU , MUN. CAMPULUNG",1811,740,731,9,0,731,9,2000,1260,344,387,1,1161,0
3,"Arges",13490,38,13490,,"MUNICIPIUL CAMPULUNG",105,"GRADINITA CU PROGRAM NORMAL NR.13 - II   STR. C. CONSTANTINESCU, MUN. CAMPULUNG",1693,915,909,6,0,907,8,1800,885,407,500,1,1161,0
3,"Arges",13490,38,13490,,"MUNICIPIUL CAMPULUNG",106,"SCOALA GENERALA VALEA ROMANESTILOR   STR. VALEA ROMANESTILOR , MUN. CAMPULUNG",414,239,234,5,0,236,3,509,270,131,105,1,1161,0
3,"Arges",13490,38,13490,,"MUNICIPIUL CAMPULUNG",107,"LICEUL DAN BARBILIAN   STR. MAIOR GILDAU NR. 12C, MUN. CAMPULUNG",1161,667,662,5,0,661,6,1300,633,251,410,1,1161,0
3,"Arges",13490,38,13490,,"MUNICIPIUL CAMPULUNG",108,"SCOALA NORMALA CAROL I   STR. MARASESTI, MUN. CAMPULUNG",801,447,440,7,0,442,5,900,453,177,265,1,1161,0
3,"Arges",13490,38,13490,,"MUNICIPIUL CAMPULUNG",109,"SEDIUL CONCIFOR STR. MARASTI NR.1, MUN. CAMPULUNG",993,507,498,9,0,505,2,1100,593,222,283,1,1161,0
3,"Arges",13490,38,13490,,"MUNICIPIUL CAMPULUNG",110,"LICEUL MINIER NR.2 STR. SOSEAUA NATIONALA NR.108, MUN. CAMPULUNG",1266,575,567,8,0,572,3,1300,725,250,322,1,1161,0
3,"Arges",13490,38,13490,,"MUNICIPIUL CAMPULUNG",111,"SCOALA GENERALA NR.4  APA SARATA  STR. SOSEAUA NATIONALA , MUN. CAMPULUNG",919,423,414,9,0,419,4,1100,677,192,227,1,1161,0
3,"Arges",13490,38,13490,,"MUNICIPIUL CAMPULUNG",112,"SCOALA GENERALA  MARCUSI    STR. DRACESTI, MUN. CAMPULUNG",572,289,282,7,0,288,1,700,411,142,146,1,1161,0
3,"Arges",13490,38,13490,,"MUNICIPIUL CAMPULUNG",113,"LICEUL  DINICU  GOLESCU    STR. NEGRU VODA NR. 66, MUN. CAMPULUNG",1490,881,872,9,0,869,12,1600,719,393,476,1,1161,0
3,"Arges",13490,38,13490,,"MUNICIPIUL CAMPULUNG",114,"SCOALA GENERALA NR. 2  STR. REPUBLICII NR.3, MUN. CAMPULUNG",1046,596,585,11,0,596,0,1200,604,232,364,1,1161,0
3,"Arges",13490,38,13490,,"MUNICIPIUL CAMPULUNG",115,"LICEUL DINICU GOLESCU, STR. NEGRU VODA NR.66, CP 115100, MUN. CAMPULUNG",0,594,0,594,0,585,9,1500,906,310,275,1,1161,1
3,"Arges",13622,38,13622,,"MUNICIPIUL CURTEA DE ARGES",116,"SCOALA GENERALA NR. 2 - I    STR. PROGRESULUI NR.1 , MUN. CURTEA DE ARGES",2532,1276,1268,8,0,1271,5,2700,1424,554,717,1,1164,0
3,"Arges",13622,38,13622,,"MUNICIPIUL CURTEA DE ARGES",117,"SCOALA GENERALA NR. 2 - II   STR. PROGRESULUI NR.1 MUN. CURTEA DE ARGES",1991,1054,1041,13,0,1047,7,2100,1046,439,608,1,1164,0
3,"Arges",13622,38,13622,,"MUNICIPIUL CURTEA DE ARGES",118,"GRUP SCOLAR FERDINAND I   STR.ALBESTI NR.10, MUN. CURTEA DE ARGES",1655,808,797,11,0,803,5,1800,992,347,456,1,1164,0
3,"Arges",13622,38,13622,,"MUNICIPIUL CURTEA DE ARGES",119,"GRUP SCOLAR  CONSTANTIN DOBRESCU-ARGES    B-DUL BASARABILOR NR.15, MUN. CURTEA DE ARGES",2640,1296,1279,17,0,1287,9,2800,1504,531,756,1,1164,0
3,"Arges",13622,38,13622,,"MUNICIPIUL CURTEA DE ARGES",120,"SCOALA GENERALA NR.6    STR. POSADA NR.1, MUN. CURTEA DE ARGES",2450,1126,1117,9,0,1118,8,2600,1474,509,609,1,1164,0
3,"Arges",13622,38,13622,,"MUNICIPIUL CURTEA DE ARGES",121,"GRUP SCOLAR FORESTIER - I B-DUL BASARABILOR NR.21, MUN. CURTEA DE ARGES",2101,982,969,13,0,975,7,2200,1218,459,516,1,1164,0
3,"Arges",13622,38,13622,,"MUNICIPIUL CURTEA DE ARGES",122,"GRUP SCOLAR FORESTIER - II  B-DUL BASARABILOR NR.21, MUN. CURTEA DE ARGES",1350,694,683,11,0,688,6,1500,806,251,437,1,1164,0
3,"Arges",13622,38,13622,,"MUNICIPIUL CURTEA DE ARGES",123,"CASA DE CULTURA   B-DUL BASARABILOR NR.59, MUN. CURTEA DE ARGES",2030,1152,1143,9,0,1147,5,2100,948,463,684,1,1164,0
3,"Arges",13622,38,13622,,"MUNICIPIUL CURTEA DE ARGES",124,"SCOALA GENERALA NR.4    STR. BANU MARACINE NR.3, MUN. CURTEA DE ARGES",2188,1208,1192,16,0,1198,10,2300,1092,469,729,1,1164,0
3,"Arges",13622,38,13622,,"MUNICIPIUL CURTEA DE ARGES",125,"SCOALA GENERALA NR.1 STR. ARMAND CALINESCU NR.6, MUN. CURTEA DE ARGES",2866,1411,1399,12,0,1393,18,3000,1589,652,741,1,1164,0
3,"Arges",13622,38,13622,,"MUNICIPIUL CURTEA DE ARGES",126,"SCOALA GENERALA NR.5    STR. NEGRU VODA NR.76, MUN. CURTEA DE ARGES",2641,1305,1296,9,0,1298,7,2800,1495,599,699,1,1164,0
3,"Arges",13622,38,13622,,"MUNICIPIUL CURTEA DE ARGES",127,"SCOALA GENERALA VALEA SASULUI   STR. VALEA SASULUI NR. 2, MUN. CURTEA DE ARGES",881,507,500,7,0,496,11,1000,493,195,301,1,1164,0
3,"Arges",13622,38,13622,,"MUNICIPIUL CURTEA DE ARGES",128,"GRUP SCOLAR AUTO STR. RM. VALCEA NR.41, MUN. CURTEA DE ARGES",1631,831,822,9,0,811,20,1800,969,349,462,1,1164,0
3,"Arges",13622,38,13622,,"MUNICIPIUL CURTEA DE ARGES",129,"CASA DE CULTURA   B-DUL BASARABILOR NR.59, MUN. CURTEA DE ARGES",644,338,330,8,0,337,1,800,462,158,179,1,1164,0
3,"Arges",13622,38,13622,,"MUNICIPIUL CURTEA DE ARGES",130,"SCOALA GENERALA NR.3    STR. RM. VALCEA NR 141, MUN. CURTEA DE ARGES",1472,740,729,11,0,723,17,1600,860,330,393,1,1164,0
3,"Arges",13622,38,13622,,"MUNICIPIUL CURTEA DE ARGES",131,"SCOALA GENERALA NOAPTES STR. LINIEI NR.13, MUN. CURTEA DE ARGES",703,397,386,11,0,396,1,800,403,197,199,1,1164,0
3,"Arges",13622,38,13622,,"MUNICIPIUL CURTEA DE ARGES",132,"SCOALA GENERALA NR.1, STR. TRAIAN NR.21, CP. 115300, MUN. CURTEA DE ARGES",0,550,0,550,0,546,4,1500,950,284,262,1,1164,1
3,"Arges",13668,38,13668,,"ORAS COSTESTI",133,"SEDIUL PRIMARIEI COSTESTI,  STRADA  VICTORIEI NR.49 , ORASUL COSTESTI",1959,1112,1104,8,0,1102,10,2200,1088,515,587,1,1167,0
3,"Arges",13668,38,13668,,"ORAS COSTESTI",134,"CASA DE CULTURA COSTESTI, STRADA  VICTORIEI NR.44, ORASUL COSTESTI",1954,1115,1104,11,0,1103,12,2200,1085,473,630,1,1167,0
3,"Arges",13668,38,13668,,"ORAS COSTESTI",135,"LICEUL TEORETIC COSTESTI, STRADA VICTORIEI NR.105, ORASUL COSTESTI",1574,880,871,9,0,875,5,1700,820,402,473,1,1167,0
3,"Arges",13668,38,13668,,"ORAS COSTESTI",136,"SCOALA GENERALA TELESTI, STRADA TELESTI NR.116, ORASUL COSTESTI",830,462,455,7,0,459,3,1000,538,213,246,1,1167,0
3,"Arges",13668,38,13668,,"ORAS COSTESTI",137,"SCOALA GENERALA ZORILE, STRADA ZORILOR NR. 92, ORASUL COSTESTI",904,581,572,9,0,579,2,1000,419,286,293,1,1167,0
3,"Arges",13668,38,13668,,"ORAS COSTESTI",138,"SCOALA GENERALA BROSTENI, SATUL BROSTENI, ORASUL COSTESTI",732,428,415,13,0,427,1,900,472,148,279,1,1167,0
3,"Arges",13668,38,13668,,"ORAS COSTESTI",139,"SCOALA GENERALA PODU BROSTENI, SATUL BROSTENI, ORASUL COSTESTI",515,312,295,17,0,306,6,700,388,131,175,1,1167,0
3,"Arges",13668,38,13668,,"ORAS COSTESTI",140,"SCOALA GENERALA PIRVU ROSU, SATUL PIRVUL ROSU, ORASUL COSTESTI",527,361,350,11,0,351,10,700,339,108,243,1,1167,0
3,"Arges",13668,38,13668,,"ORAS COSTESTI",141,"SCOALA GENERALA STIRCI, SATUL STIRCI, ORASUL COSTESTI",208,115,108,7,0,115,0,300,185,57,58,1,1167,0
3,"Arges",13668,38,13668,,"ORAS COSTESTI",142,"PRIMARIA ORASULUI COSTESTI, STR. VICTORIE, NR.49, CP 115200, ORAS COSTESTI",0,240,0,240,0,240,0,500,260,107,133,1,1167,1
3,"Arges",13301,38,13301,,"ORAS MIOVENI",143,"GRADINITA DIN BLOCUL A1  STRADA LOGOFAT STANCIU MIHOVEANU , ORASUL MIOVENI",2004,1136,1127,9,0,1131,5,2100,964,508,623,1,1175,0
3,"Arges",13301,38,13301,,"ORAS MIOVENI",144,"LICEUL  IULIA ZAMFIRESCU -INTRAREA C  STRADA PETRE ZUGRAVU, ORASUL MIOVENI",2028,1148,1134,14,0,1131,17,2200,1052,495,636,1,1175,0
3,"Arges",13301,38,13301,,"ORAS MIOVENI",145,"GRADINITA DIN BLOCUL M6    STRADA CARANESTI , ORASUL MIOVENI",1951,978,967,11,0,973,5,2100,1122,399,574,1,1175,0
3,"Arges",13301,38,13301,,"ORAS MIOVENI",146,"DISPENSAR UMAN ,  STRADA CARANESTI, ORASUL MIOVENI",1614,881,871,10,0,872,9,1800,919,336,536,1,1175,0
3,"Arges",13301,38,13301,,"ORAS MIOVENI",147,"CAMIN- SCOALA- CORP B, STRADA EROILOR NR.3, ORASUL MIOVENI",1712,892,882,10,0,886,6,1900,1008,383,503,1,1175,0
3,"Arges",13301,38,13301,,"ORAS MIOVENI",148,"LICEUL  IULIA ZAMFIRESCU -INTRAREA B,  STRADA PETRE ZUGRAVU, ORASUL MIOVENI",1924,1000,987,13,0,991,9,2100,1100,401,590,1,1175,0
3,"Arges",13301,38,13301,,"ORAS MIOVENI",149,"SCOALA LIVIU REBREANU   - INTRARE ELEVI,  STRADA EROILOR NR. 3, ORASUL MIOVENI",996,542,533,9,0,537,5,1100,558,265,272,1,1175,0
3,"Arges",13301,38,13301,,"ORAS MIOVENI",150,"SCOALA LIVIU REBREANU  - INTRARE PROFESORI,  STRADA EROILOR NR.3, ORASUL MIOVENI",1278,695,687,8,0,686,9,1400,705,297,389,1,1175,0
3,"Arges",13301,38,13301,,"ORAS MIOVENI",151,"CRESA MIOVENI,   STRADA ALEEA CAMINULUI, ORASUL MIOVENI",1135,687,677,10,0,681,6,1200,513,326,355,1,1175,0
3,"Arges",13301,38,13301,,"ORAS MIOVENI",152,"GRADINITA DIN BLOCUL F9, BULEVARDUL DACIA, ORASUL MIOVENI",1287,721,713,8,0,716,5,1400,679,275,441,1,1175,0
3,"Arges",13301,38,13301,,"ORAS MIOVENI",153,"SEDIUL SOCIETATII  CONSTRUCTII- REPARATII  MIOVENI  SRL - MIOVENI,  BULEVARDUL DACIA, ORASUL MIOVENI",1575,913,906,7,0,908,5,1700,787,414,494,1,1175,0
3,"Arges",13301,38,13301,,"ORAS MIOVENI",154,"CASA DE CULTURA A SINDICATELOR, STRADA  RADU CEL FRUMOS NR.1, ORASUL MIOVENI",1333,814,805,9,0,807,7,1500,686,300,507,1,1175,0
3,"Arges",13301,38,13301,,"ORAS MIOVENI",155,"GRADINITA DIN BLOCUL T6, STRADA FRATII GOLESTI, ORASUL MIOVENI",1615,921,915,6,0,915,6,1800,879,411,504,1,1175,0
3,"Arges",13301,38,13301,,"ORAS MIOVENI",156,"GRADINITA DIN BLOCUL T2A, STRADA UNIRII,  ORASUL MIOVENI",1439,816,806,10,0,810,6,1600,784,331,479,1,1175,0
3,"Arges",13301,38,13301,,"ORAS MIOVENI",157,"GRADINITA DIN BLOCUL P19,  STRADA 7 SEPTEMBRIE 1485, ORASUL MIOVENI",1832,1007,991,16,0,1003,4,2000,993,427,576,1,1175,0
3,"Arges",13301,38,13301,,"ORAS MIOVENI",158,"SCOALA  GEORGE TOPARCEANU ,  STRADA PARASTI NR. 26, ORASUL MIOVENI",880,775,483,8,284,760,15,1000,225,391,369,1,1175,0
3,"Arges",13301,38,13301,,"ORAS MIOVENI",159,"SCOALA GENERALA  MARIN SORESCU ,  BULEVARDUL DACIA , ORASUL MIOVENI",804,508,499,9,0,504,4,900,392,113,391,1,1175,0
3,"Arges",13301,38,13301,,"ORAS MIOVENI",160,"SCOALA RACOVITA DE SUS, STRADA NICOLAE RACOVICEANU, ORASUL MIOVENI",645,390,381,9,0,386,4,800,410,112,274,1,1175,0
3,"Arges",13301,38,13301,,"ORAS MIOVENI",161,"CAMINUL CULTURAL COLIBASI, STRADA COLIBASI, ORASUL  MIOVENI",1706,1080,1072,8,0,1075,5,1900,820,379,696,1,1175,0
3,"Arges",13301,38,13301,,"ORAS MIOVENI",162,"SCOALA CLUCEREASA,  STRADA GARII, ORASUL MIOVENI",275,172,166,6,0,171,1,400,228,46,125,1,1175,0
3,"Arges",13301,38,13301,,"ORAS MIOVENI",163,"SCOALA FAGET, STRADA  MANASTIRII, ORASUL MIOVENI",650,459,447,12,0,449,10,799,340,115,334,1,1175,0
3,"Arges",13301,38,13301,,"ORAS MIOVENI",164,"CAMINUL CULTURAL FAGET, ORAS MIOVENI",271,221,214,7,0,221,0,300,79,82,139,1,1175,0
3,"Arges",13301,38,13301,,"ORAS MIOVENI",165,"CENTRUL CULTURAL MIOVENI, STR. TUDOR MUSATESCU, BL. V2B PARTER, CP 115400, ORAS MIOVENI",0,521,0,521,0,517,4,1000,479,233,284,1,1175,1
3,"Arges",13392,38,13392,,"ORAS STEFANESTI",166,"CASA DE CULTURA STEFANESTI   (FOSTUL CAMIN CULTURAL STEFANESTI), ORAS STEFANESTI ( SAT STEFANESTI)",1748,1038,946,91,1,1033,5,1900,862,524,509,1,1181,0
3,"Arges",13392,38,13392,,"ORAS STEFANESTI",167,"SCOALA PROFESIONALA AUTO STEFANESTI, ORAS STEFANESTI ( SAT STEFANESTII NOI ) - (CARTIERUL BLOCURI)",2142,1155,1126,29,0,1142,13,2400,1245,530,612,1,1181,0
3,"Arges",13392,38,13392,,"ORAS STEFANESTI",168,"SCOALA PROFESIONALA AUTO STEFANESTI, ORAS STEFANESTI (SAT STEFANESTII NOI ) - (CARTIERUL BLOCURI)  -INTAREA DIN SPATE",579,433,317,116,0,430,3,700,267,197,233,1,1181,0
3,"Arges",13392,38,13392,,"ORAS STEFANESTI",169,"SCOALA GENERALA VALEA MARE, ORAS STEFANESTI (SAT VALEA MARE)",2515,1441,1334,106,1,1416,25,2800,1359,738,678,1,1181,0
3,"Arges",13392,38,13392,,"ORAS STEFANESTI",170,"I.M.E.P. VALEA MARE, ORAS STEFANESTI (SAT VALEA MARE)",1418,648,638,10,0,631,17,1600,952,298,333,1,1181,0
3,"Arges",13392,38,13392,,"ORAS STEFANESTI",171,"SCOALA GENERALA GOLESTI, ORAS STEFANESTI (SAT GOLESTI)",980,573,558,15,0,569,4,1100,527,220,349,1,1181,0
3,"Arges",13392,38,13392,,"ORAS STEFANESTI",172,"SCOALA PRIMARA STEFANESTI VALE, ORAS STEFANESTI ( SAT STEFANESTI VALE)",1467,848,795,53,0,839,9,1600,752,369,470,1,1181,0
3,"Arges",13392,38,13392,,"ORAS STEFANESTI",173,"SCOALA PRIMARA  ENCULESTI, ORAS STEFANESTI (SAT ENCULESTI)",403,272,209,63,0,266,6,500,228,129,137,1,1181,0
3,"Arges",13392,38,13392,,"ORAS STEFANESTI",174,"GRADINITA DIN INCINTA SCOLII GENERALE NR.1 STEFANESTI, CALEA BUCURESTI, CP 117715, ORAS STEFANESTI",0,360,0,360,0,357,3,1000,640,188,169,1,1181,1
3,"Arges",13757,38,13757,,"ORAS TOPOLOVENI",175,"SCOALA PRIMARA GOLESTII-BADII, - STR CALEA BUCURESTI NR. 249, ORAS TOTPOLOVENI",915,570,562,8,0,564,6,1000,430,270,294,1,1190,0
3,"Arges",13757,38,13757,,"ORAS TOPOLOVENI",176," LICEUL TEORETIC  ION MIHALACHE  TOPOLOVENI  (CLADIREA VECHE), STR CALEA BUCURESTI NR.131, ORAS TOPOLOVENI",1622,935,919,16,0,923,12,1800,865,412,511,1,1190,0
3,"Arges",13757,38,13757,,"ORAS TOPOLOVENI",177," LICEUL TEORETIC  ION MIHALACHE  TOPOLOVENI  CLADIREA NOUA, STR CALEA BUCURESTI NR.131,  ORAS TOPOLOVENI",1042,652,635,17,0,646,6,1200,548,267,379,1,1190,0
3,"Arges",13757,38,13757,,"ORAS TOPOLOVENI",178,"SCOALA GENERALA NR.1 TOPOLOVENI , CAMERA 1, STR. CALEA BUCURESTI NR. 62,  ORAS TOPOLOVENI   (INTRAREA DIN FATA)",1702,1030,1014,15,1,1024,6,1900,870,472,552,1,1190,0
3,"Arges",13757,38,13757,,"ORAS TOPOLOVENI",179,"SCOALA GENERALA NR.1 TOPOLOVENI, STR CALEA BUCURESTI NR.62, ORAS TOPOLOVENI  (INTRAREA DIN SPATE)",1245,683,673,10,0,678,5,1400,717,288,390,1,1190,0
3,"Arges",13757,38,13757,,"ORAS TOPOLOVENI",180,"SCOALA PRIMARA INURI, STR. SUBLT. MIHAI MIHAIL NR. 51, ORAS TOPOLOVENI (SAT INURI)",236,158,151,7,0,155,3,300,142,60,95,1,1190,0
3,"Arges",13757,38,13757,,"ORAS TOPOLOVENI",181,"SCOALA  PRIMARA TIGANESTI- LINIE, STR. ION MIHALACHE NR. 368, ORAS TOPOLOVENI",629,427,419,8,0,424,3,700,273,171,253,1,1190,0
3,"Arges",13757,38,13757,,"ORAS TOPOLOVENI",182,"SCOALA GENERALA TIGANESTI - CENTRU, SAT TIGANESTI NR. 104,  ORAS TOPOLOVENI",728,446,440,6,0,440,6,800,354,190,250,1,1190,0
3,"Arges",13757,38,13757,,"ORAS TOPOLOVENI",183,"SCOALA GENERALA NR.1 TOPOLOVENI, INTRAREA DIN FATA, CALEA BUCURESTI NR.62, CP, ORAS TOPOLOVENI",0,204,0,204,0,203,1,500,296,80,123,1,1190,1
3,"Arges",13819,38,13819,,"ALBESTII DE ARGES",184,"CASA DE CULTURA ALBESTII DE ARGES, COMUNA ALBESTII DE ARGES (SAT ALBESTI PAMANTENI)",1573,908,869,39,0,895,13,1700,792,440,455,3,1196,0
3,"Arges",13819,38,13819,,"ALBESTII DE ARGES",185,"SCOALA GENERALA ALBESTI -UNGURENI, COMUNA ALBESTII DE ARGES (SAT ALBESTI UNGURENI)",1862,1062,997,65,0,1050,12,2000,938,502,548,3,1196,0
3,"Arges",13819,38,13819,,"ALBESTII DE ARGES",186,"SCOALA GENERALA BRATESTI, COMUNA ALBESTII DE ARGES ( SAT BRATESTI)",648,384,369,15,0,379,5,796,412,110,269,3,1196,0
3,"Arges",13819,38,13819,,"ALBESTII DE ARGES",187,"CAMINUL CULTURAL DOBROTU, COMUNA ALBESTII DE ARGES (SAT  ALBESTI  DOBROTU)",847,518,503,15,0,512,6,1000,482,278,234,3,1196,0
3,"Arges",13819,38,13819,,"ALBESTII DE ARGES",188,"CAMINUL CULTURAL PAMANTENI, SAT PAMANTENI, CP 117005, COMUNA ALBESTII DE ARGES",0,131,0,131,0,129,2,500,369,72,57,3,1196,1
3,"Arges",13891,38,13891,,"ALBESTII DE MUSCEL",189,"SCOALA GENERALA CU CLASELE I-VIII ALBESTI, COMUNA ALBESTII DE MUSCEL (SAT ALBESTI)",971,683,664,6,13,678,5,1100,417,386,292,3,1204,0
3,"Arges",13891,38,13891,,"ALBESTII DE MUSCEL",190,"SCOALA GENERALA CU CLASELE  I-IV CINDESTI, COMUNA ALBESTII DE MUSCEL (SAT CINDESTI)",397,293,281,6,6,290,3,500,207,179,111,3,1204,0
3,"Arges",13891,38,13891,,"ALBESTII DE MUSCEL",191,"SCOALA GENERALA CU CLASELE I-VIII ALBESTI, SAT ALBESTI, CP 117025, COMUNA ALBESTII DE MUSCEL",0,118,0,118,0,118,0,500,382,79,39,3,1204,1
3,"Arges",13935,38,13935,,"ALBOTA",192,"SCOALA GENERALA ALBOTA, COMUNA ALBOTA ( SAT ALBOTA)",1486,801,786,15,0,785,16,1600,799,340,445,3,1207,0
3,"Arges",13935,38,13935,,"ALBOTA",193,"SCOALA GENERALA MARES, COMUNA ALBOTA (SAT MARES)",879,517,506,11,0,512,5,1000,483,166,346,3,1207,0
3,"Arges",13935,38,13935,,"ALBOTA",194,"SCOALA PRIMARA CERBU,  COMUNA ALBOTA (SAT CERBU)",708,443,430,13,0,438,5,800,357,163,275,3,1207,0
3,"Arges",13935,38,13935,,"ALBOTA",195,"SCOALA CU CLASELE I-VIII ALBOTA, SAT ALBOTA NR. 473, CP 117030, COMUNA ALBOTA",0,124,0,124,0,124,0,500,376,68,56,3,1207,1
3,"Arges",13999,38,13999,,"ANINOASA",196,"SCOALA GENERALA CU CLASELE I-IV ANINOASA, COMUNA ANINOASA (SAT ANINOASA)",1218,721,707,12,2,712,9,1400,679,254,458,3,1213,0
3,"Arges",13999,38,13999,,"ANINOASA",197,"CAMIN CULTURAL  VALEA SILISTII, COMUNA ANINOASA (SAT VALEA SILISTII)",572,340,331,9,0,337,3,700,360,137,200,3,1213,0
3,"Arges",13999,38,13999,,"ANINOASA",198,"CAMIN CULTURAL SLANIC, COMUNA ANINOASA (SAT SLANIC)",886,583,576,7,0,577,6,1000,417,237,340,3,1213,0
3,"Arges",13999,38,13999,,"ANINOASA",199,"CAMINUL CULTURAL ANINOASA, SAT ANINOASA, CP 117035, COMUNA ANINOASA",0,94,0,94,0,94,0,500,406,45,49,3,1213,1
3,"Arges",14049,38,14049,,"AREFU",200,"GRADINITA AREFU, COMUNA AREFU (SAT AREFU)",1167,584,575,8,1,580,4,1300,716,254,326,3,1218,0
3,"Arges",14049,38,14049,,"AREFU",201,"SCOALA GENERALA  CAPATINENI, COMUNA AREFU (SAT CAPATINENI)",993,532,520,11,1,526,6,1100,568,283,243,3,1218,0
3,"Arges",14049,38,14049,,"AREFU",202,"SCOALA CU CLASELE I-VIII, SAT CAPATANENI PAMANTENI, CP 117040, COMUNA AREFU",0,96,0,96,0,96,0,500,404,53,43,3,1218,1
3,"Arges",13187,38,13187,,"BASCOV",203,"GRADINITA NR.1 BASCOV, COMUNA BASCOV",1629,960,945,15,0,951,9,1800,840,429,522,3,1262,0
3,"Arges",13187,38,13187,,"BASCOV",204,"SCOALA GENERALA BASCOV, COMUNA BASCOV - CLADIREA VECHE",1536,893,840,53,0,885,8,1700,807,288,597,3,1262,0
3,"Arges",13187,38,13187,,"BASCOV",205,"SCOALA GENERALA BASCOV, COMUNA BASCOV -  CLADIREA NOUA",1003,625,579,46,0,617,8,1100,475,222,395,3,1262,0
3,"Arges",13187,38,13187,,"BASCOV",206,"SCOALA GENERALA SCHIAU, COMUNA BASCOV (SAT SCHIAU)",1218,734,714,20,0,726,8,1300,566,321,405,3,1262,0
3,"Arges",13187,38,13187,,"BASCOV",207,"SCOALA GENERALA GLIMBOC, COMUNA BASCOV (SAT GLIMBOC)",646,452,435,17,0,449,3,800,348,206,243,3,1262,0
3,"Arges",13187,38,13187,,"BASCOV",208,"SCOALA GENERALA VALEA URSULUI, COMUNA BASCOV (SAT VALEA URSULUI)",1481,879,833,46,0,873,6,1600,721,361,512,3,1262,0
3,"Arges",13187,38,13187,,"BASCOV",209,"SCOALA GENERALA MICA, COMUNA BASCOV ( SAT MICA)",483,352,338,14,0,348,4,600,248,109,239,3,1262,0
3,"Arges",13187,38,13187,,"BASCOV",210,"PRIMARIA COMUNEI BASCOV, STR. PAISESTI, DN NR.125, CP 117045, COMUNA BASCOV",0,277,0,277,0,276,1,500,223,113,163,3,1262,1
3,"Arges",14085,38,14085,,"BABANA",211,"SCOALA BABANA, COMUNA BABANA (SAT BABANA)",781,410,402,8,0,408,2,900,490,161,247,3,1222,0
3,"Arges",14085,38,14085,,"BABANA",212,"SCOALA SLATIOARELE, COMUNA BABANA (SAT SLATIOARELE)",680,392,382,10,0,389,3,800,408,111,278,3,1222,0
3,"Arges",14085,38,14085,,"BABANA",213,"BIBLIOTECA COMUNALA, COMUNA BABANA (SAT BABANA)",504,334,284,50,0,328,6,598,264,138,190,3,1222,0
3,"Arges",14085,38,14085,,"BABANA",214,"SCOALA GROSI, COMUNA BABANA (SAT GROSI)",381,218,210,8,0,216,2,501,283,94,122,3,1222,0
3,"Arges",14085,38,14085,,"BABANA",215,"PRIMARIA COMUNEI BABANA, INTRAREA A, SAT BABANA CENTRU, STR. PRINCIPALA NR.10, CP 117055, COMUNA BABANA",0,197,0,197,0,197,0,501,304,72,125,3,1222,1
3,"Arges",14165,38,14165,,"BAICULESTI",216,"PRIMARIA BAICULESTI, COMUNA BAICULESTI ( SAT BAICULESTI)",1377,656,628,28,0,652,4,1500,844,206,446,3,1230,0
3,"Arges",14165,38,14165,,"BAICULESTI",217,"SCOALA MANICESTI,  COMUNA BAICULESTI (SAT MANICESTI)",592,312,304,8,0,310,2,700,388,92,218,3,1230,0
3,"Arges",14165,38,14165,,"BAICULESTI",218,"SCOALA ZIGONENI,  COMUNA BAICULESTI (SATUL ZIGONENI)",780,478,460,18,0,478,0,900,422,226,252,3,1230,0
3,"Arges",14165,38,14165,,"BAICULESTI",219,"SCOALA VALEA LUI ENACHE,  COMUNA BAICULESTI (SATUL VALEA LUI ENACHE)",740,473,460,13,0,467,6,900,427,181,286,3,1230,0
3,"Arges",14165,38,14165,,"BAICULESTI",220,"SCOALA TUTANA,  COMUNA BAICULESTI (SAT TUTANA)",1570,824,808,16,0,819,5,1700,876,338,481,3,1230,0
3,"Arges",14165,38,14165,,"BAICULESTI",221,"SCOALA CU CLASELE I-VIII BAICULESTI, SAT BAICULESTI, CP 117065, COMUNA BAICULESTI",0,137,0,137,0,136,1,500,363,74,62,3,1230,1
3,"Arges",14272,38,14272,,"BALILESTI",222,"PRIMARIA COMUNEI  BALILESTI - CORP CAMIN CULTURAL, SAT BALILESTI, COMUNA BALILESTI, JUDETUL ARGES",926,529,520,9,0,524,5,1000,471,192,332,3,1241,0
3,"Arges",14272,38,14272,,"BALILESTI",223,"CAMIN CULTURAL BAJESTI, COMUNA BALILESTI ( SAT BAJESTI)",971,603,588,15,0,593,10,1100,497,217,376,3,1241,0
3,"Arges",14272,38,14272,,"BALILESTI",224,"CAMIN CULTURAL POIENITA, COMUNA BALILESTI  (SAT POIENITA)",1023,639,621,18,0,625,14,1100,461,234,391,3,1241,0
3,"Arges",14272,38,14272,,"BALILESTI",225,"SCOALA GOLESTI,  COMUNA BALILESTI ( SATUL GOLESTI)",595,362,353,9,0,361,1,700,338,164,197,3,1241,0
3,"Arges",14272,38,14272,,"BALILESTI",226,"PRIMARIA COMUNEI BALILESTI, SAT BALILESTI, CP 117080, COMUNA BALILESTI",0,113,0,113,0,112,1,500,387,40,72,3,1241,1
3,"Arges",14352,38,14352,,"BELETI-NEGRESTI",227,"CAMIN CULTURAL BELETI, COMUNA BELETI- NEGRESTI ( SAT BELETI)",559,348,346,2,0,346,2,600,252,149,197,3,1271,0
3,"Arges",14352,38,14352,,"BELETI-NEGRESTI",228,"CAMIN CULTURAL NEGRESTI,  COMUNA BELETI- NEGRESTI (SAT NEGRESTI)",1018,618,611,7,0,612,6,1100,482,264,348,3,1271,0
3,"Arges",14352,38,14352,,"BELETI-NEGRESTI",229,"CAMINUL CULTURAL ZGRIPCESTI, SAT ZGRIPCESTI, CP 117110, COMUNA BELETI-NEGRESTI",0,60,0,60,0,59,1,500,440,28,31,3,1271,1
3,"Arges",14405,38,14405,,"BEREVOESTI",230,"CAMIN CULTURAL BEREVOESTI-PAMINTENI, COMUNA  BEREVOESTI ( SAT BEREVOESTI)",1773,1018,1013,5,0,1007,11,1900,882,322,685,3,1276,0
3,"Arges",14405,38,14405,,"BEREVOESTI",231,"SCOALA GAMACESTI, COMUNA BEREVOESTI (SAT GAMACESTI)",763,477,466,11,0,450,27,900,423,275,175,3,1276,0
3,"Arges",14405,38,14405,,"BEREVOESTI",232,"SCOALA BRATIA,  COMUNA BEREVOESTI  (SAT BRATIA)",186,130,116,14,0,126,4,300,170,30,96,3,1276,0
3,"Arges",14405,38,14405,,"BEREVOESTI",233,"PRIMARIA COMUNEI BEREVOIESTI, SAT BEREVOIESTI, CP 117115, COMUNA BEREVOIESTI",0,94,0,94,0,91,3,500,406,34,57,3,1276,1
3,"Arges",14450,38,14450,,"BARLA",234,"SCOALA URLUIENI, COMUNA BIRLA (SAT URLUIENI)",1168,587,567,20,0,581,6,1300,713,241,340,3,1249,0
3,"Arges",14450,38,14450,,"BARLA",235,"SCOALA MINDRA, COMUNA BIRLA (SAT MINDRA)",725,388,376,12,0,381,7,800,412,166,215,3,1249,0
3,"Arges",14450,38,14450,,"BARLA",236,"SCOALA BIRLA, COMUNA BIRLA (SAT BIRLA)",1010,534,522,12,0,524,10,1100,566,157,367,3,1249,0
3,"Arges",14450,38,14450,,"BARLA",237,"SCOALA MOZACENI-VALE, COMUNA BIRLA (SAT MOZACENI VALE)",1092,514,501,13,0,507,7,1200,686,230,277,3,1249,0
3,"Arges",14450,38,14450,,"BARLA",238,"SCOALA BADESTI, COMUNA BIRLA (SAT BADESTI)",296,209,198,11,0,205,4,400,191,113,92,3,1249,0
3,"Arges",14450,38,14450,,"BARLA",239,"SCOALA CU CLASELE I-VIII BARLA, SAT BARLA, STR. PRINCIPALA NR. 110, CP 117090, COMUNA BARLA",0,256,0,256,0,255,1,500,244,103,152,3,1249,1
3,"Arges",14584,38,14584,,"BOGATI",240," SCOALA GLIMBOCELU, COMUNA BOGATI (SAT GLIMBOCELU)",605,403,390,7,6,402,1,700,297,198,204,3,1281,0
3,"Arges",14584,38,14584,,"BOGATI",241," SCOALA CHITESTI, COMUNA BOGATI (SAT CHITESTI)",249,155,148,7,0,153,2,300,145,71,82,3,1281,0
3,"Arges",14584,38,14584,,"BOGATI",242,"SCOALA  BOGATI (SCOALA NOUA), COMUNA BOGATI (SAT BOGATI)",1496,852,835,17,0,842,10,1600,748,397,445,3,1281,0
3,"Arges",14584,38,14584,,"BOGATI",243,"GRADINITA BUJOI, COMUNA BOGATI (SAT BUJOI)",595,384,373,11,0,381,3,700,316,237,144,3,1281,0
3,"Arges",14584,38,14584,,"BOGATI",244,"SCOALA SUSENI, COMUNA BOGATI (SAT SUSENI)",831,544,533,8,3,536,8,1000,456,301,235,3,1281,0
3,"Arges",14584,38,14584,,"BOGATI",245,"SCOALA GLIMBOCEL, COMUNA BOGATI (SAT GLIMBOCEL)",166,126,118,8,0,124,2,300,174,90,34,3,1281,0
3,"Arges",14584,38,14584,,"BOGATI",246,"SCOALA CU CLASELE I-VIII BOGATI, CLADIRE CORP B, SAT BOGATI, CP 117120, COMUNA BOGATI",0,165,0,165,0,160,5,500,335,81,79,3,1281,1
3,"Arges",14673,38,14673,,"BOTENI",247,"CAMIN CULTURAL BOTENI, COMUNA BOTENI (SAT BOTENI)",1635,1071,1055,4,12,1059,12,1800,729,430,629,3,1290,0
3,"Arges",14673,38,14673,,"BOTENI",248,"SCOALA PRIMARA LUNCA, COMUNA BOTENI (SAT LUNCA)",535,345,338,7,0,344,1,600,255,87,257,3,1290,0
3,"Arges",14673,38,14673,,"BOTENI",249,"GRADINITA CU PROGRAM PRELUNGIT, SAT BOTENI, CP 117130, COMUNA BOTENI",0,108,0,108,0,107,1,500,392,47,60,3,1290,1
3,"Arges",14726,38,14726,,"BOTESTI",250,"SCOALA GIMNAZIALA BOTESTI, COMUNA BOTESTI (SAT BOTESTI)",716,555,530,2,23,551,4,800,245,190,361,3,1295,0
3,"Arges",14726,38,14726,,"BOTESTI",251,"SCOALA PRIMARA MOSTENI-GRECI, COMUNA BOTESTI (SAT MOSTENI - GRECI)",295,200,193,7,0,199,1,400,200,61,138,3,1295,0
3,"Arges",14726,38,14726,,"BOTESTI",252,"PRIMARIA COMUNEI BOTESTI, SAT BOTESTI, CP 117135, COMUNA BOTESTI",0,109,0,109,0,109,0,499,390,38,71,3,1295,1
3,"Arges",13276,38,13276,,"BRADU",253,"SCOALA PRIMARA GEAMANA, COMUNA BRADU STR. PRINCIPALA NR. 310 (SAT GEAMANA)",1968,1332,1293,39,0,1319,13,2200,868,710,609,3,1298,0
3,"Arges",13276,38,13276,,"BRADU",254,"CAMIN CULTURAL BRADU, COMUNA BRADU, STR. PRINCIPALA NR. 50 (SAT BRADU DE SUS)",1950,1250,1225,25,0,1239,11,2100,850,601,638,3,1298,0
3,"Arges",13276,38,13276,,"BRADU",255,"GRADINITA DE LA SCOALA GENERALA  NR.2 BRADU, COMUNA BRADU , STR. SCOLII NR. 1(SAT BRADU DE JOS)",1453,1042,1017,25,0,1031,11,1600,558,467,564,3,1298,0
3,"Arges",13276,38,13276,,"BRADU",256,"PRIMARIA COMUNEI BRADU, SAT BRADU, STR. PRINCIPALA NR.79, CP 117140, COMUNA BRADU",0,496,0,496,0,495,1,496,0,340,155,3,1298,1
3,"Arges",14753,38,14753,,"BRADULET",257,"CAMIN CULTURAL BRADULET, COMUNA BRADULET (SAT BRADULET)",518,344,343,0,1,342,2,600,256,189,153,3,1301,0
3,"Arges",14753,38,14753,,"BRADULET",258,"CAMINUL CULTURAL GALESU, COMUNA BRADULET (SAT GALESU)",782,471,466,5,0,466,5,900,429,167,299,3,1301,0
3,"Arges",14753,38,14753,,"BRADULET",259,"SCOALA PRIMARA BRADETU, COMUNA BRADULET (SAT BRADETU)",358,228,225,2,1,226,2,400,172,124,102,3,1301,0
3,"Arges",14753,38,14753,,"BRADULET",260,"SCOALA GENERAL GALESU, SAT GALESU, CP 117146, COMUNA BRADULET",0,161,0,161,0,161,0,488,327,73,88,3,1301,1
3,"Arges",14851,38,14851,,"BUDEASA",261,"SCOALA BUDEASA MARE, COMUNA BUDEASA ( SAT BUDEASA MARE)",1031,509,501,8,0,501,8,1100,591,231,270,3,1311,0
3,"Arges",14851,38,14851,,"BUDEASA",262,"SCOALA BUDEASA MICA, COMUNA BUDEASA ( SAT BUDEASA MICA)",616,334,324,10,0,330,4,800,466,120,210,3,1311,0
3,"Arges",14851,38,14851,,"BUDEASA",263,"SCOALA GALESESTI, COMUNA BUDEASA (SAT GALESESTI)",699,391,383,8,0,386,5,800,409,150,236,3,1311,0
3,"Arges",14851,38,14851,,"BUDEASA",264,"SCOALA CALOTESTI, COMUNA BUDEASA (SAT CALOTESTI)",686,434,423,11,0,430,4,1000,566,181,249,3,1311,0
3,"Arges",14851,38,14851,,"BUDEASA",265,"SCOALA BUDEASA MARE, SAT BUDEASA MARE, CP 117155, COMUNA BUDEASA",0,104,0,104,0,103,1,500,396,44,59,3,1311,1
3,"Arges",14922,38,14922,,"BUGHEA DE JOS",266,"SCOALA GENERALA BUGHEA DE JOS, COMUNA BUGHEA DE JOS (SAT BUGHEA DE JOS)",1471,856,840,16,0,851,5,1600,744,409,442,3,1318,0
3,"Arges",14922,38,14922,,"BUGHEA DE JOS",267,"SCOALA PRIMARA MLACI, COMUNA BUGHEA DE JOS (SAT MLACI)",452,314,289,25,0,310,4,500,186,148,162,3,1318,0
3,"Arges",14922,38,14922,,"BUGHEA DE JOS",268,"SCOALA PRIMARA HULUBESTI, COMUNA BUGHEA DE JOS (SAT HULUBESTI)",482,276,259,17,0,275,1,600,324,112,163,3,1318,0
3,"Arges",14922,38,14922,,"BUGHEA DE JOS",269,"SCOALA GENERALA CU CLASELE I-VIII, CENTRU, SAT BUGHEA DE JOS, CP 117165, COMUNA BUGHEA DE JOS",0,38,0,38,0,38,0,500,462,18,20,3,1318,1
3,"Arges",20063,38,20063,,"BUGHEA DE SUS",270,"SCOALA GENERALA CU CLASELE I-VIII BUGHEA DE SUS, SALA 2, COMUNA BUGHEA DE SUS",1710,914,905,9,0,901,13,1900,986,389,512,3,1320,0
3,"Arges",20063,38,20063,,"BUGHEA DE SUS",271,"GRADINITA GRUI, COMUNA BUGHEA DE SUS",669,436,428,8,0,436,0,800,364,178,258,3,1320,0
3,"Arges",20063,38,20063,,"BUGHEA DE SUS",272,"SCOALA CU CLASELE I-VIII BUGHEA DE SUS, SALA 2, SAT BUGHEA DE SUS, CP 117027, COMUNA BUGHEA DE SUS",0,57,0,57,0,55,2,500,443,22,33,3,1320,1
3,"Arges",14940,38,14940,,"BUZOESTI",273,"SCOALA GENERALA  SERBOIENI, COMUNA BUZOESTI (SAT SERBOIENI)",1304,691,680,11,0,678,13,1400,709,260,418,3,1322,0
3,"Arges",14940,38,14940,,"BUZOESTI",274,"GRADINITA IONESTI, COMUNA BUZOESTI (SAT IONESTI)",620,363,346,17,0,356,7,700,337,133,223,3,1322,0
3,"Arges",14940,38,14940,,"BUZOESTI",275,"SCOALA TOMSANCA, COMUNA BUZOESTI (SAT TOMSANCA)",301,184,177,7,0,180,4,400,216,45,135,3,1322,0
3,"Arges",14940,38,14940,,"BUZOESTI",276,"SCOALA VULPESTI, COMUNA BUZOESTI (SAT VULPESTI)",857,489,480,9,0,486,3,1000,511,203,283,3,1322,0
3,"Arges",14940,38,14940,,"BUZOESTI",277,"SCOALA CORNATEL, COMUNA BUZOESTI (SAT CORNATEL)",867,502,485,17,0,496,6,1000,498,199,297,3,1322,0
3,"Arges",14940,38,14940,,"BUZOESTI",278,"GRADINITA BUZOESTI, COMUNA BUZOESTI (SAT BUZOESTI)",963,487,477,10,0,485,2,1100,613,207,278,3,1322,0
3,"Arges",14940,38,14940,,"BUZOESTI",279,"CENTRUL DE PROTECTIA PLANTELOR, SAT VULPESTI, CP 117170, COMUNA BUZOESTI",0,244,0,244,0,243,1,500,256,96,147,3,1322,1
3,"Arges",15064,38,15064,,"CALDARARU",280,"SCOALA CU CLASELE I-VIII CALDARARU, COMUNA CALDARARU (SAT CALDARARU)",800,389,383,6,0,382,7,900,511,147,235,3,1334,0
3,"Arges",15064,38,15064,,"CALDARARU",281,"SCOALA CU CLASELE I-IV STRIMBENI, COMUNA CALDARARU (SAT STRIMBENI)",835,478,470,8,0,473,5,1000,522,191,282,3,1334,0
3,"Arges",15064,38,15064,,"CALDARARU",282,"SCOALA CU CLASELE I-VIII BURDEA, COMUNA CALDARARU (SAT BURDEA)",569,333,317,16,0,330,3,700,367,104,226,3,1334,0
3,"Arges",15064,38,15064,,"CALDARARU",283,"SCOALA CU CLASELE I-VIII CALDARARU, SALA 2, SAT CALDARARU, NR. 342, CP 117190, COMUNA CALDARARU",0,150,0,150,0,149,1,500,350,48,101,3,1334,1
3,"Arges",15108,38,15108,,"CALINESTI",284,"SCOALA  CIOCANESTI, COMUNA CALINESTI (SAT CIOCANESTI)",700,400,395,5,0,394,6,800,400,197,197,3,1338,0
3,"Arges",15108,38,15108,,"CALINESTI",285,"SCOALA  VALENI, COMUNA CALINESTI (SAT VALENI)",929,544,536,8,0,537,7,1000,456,279,258,3,1338,0
3,"Arges",15108,38,15108,,"CALINESTI",286,"SCOALA  VRANESTI, COMUNA CALINESTI (SAT VRANESTI)",1556,830,820,10,0,821,9,1700,870,365,456,3,1338,0
3,"Arges",15108,38,15108,,"CALINESTI",287,"SCOALA RADU NEGRU, COMUNA CALINESTI (SAT RADU NEGRU)",448,270,260,10,0,264,6,500,230,125,139,3,1338,0
3,"Arges",15108,38,15108,,"CALINESTI",288,"SCOALA  CALINESTI VALE, COMUNA CALINESTI (CALINESTI)",1678,861,838,23,0,853,8,1800,939,385,468,3,1338,0
3,"Arges",15108,38,15108,,"CALINESTI",289,"SCOALA  GORGANU, COMUNA CALINESTI (SAT GORGANU)",874,437,430,7,0,434,3,1000,563,185,249,3,1338,0
3,"Arges",15108,38,15108,,"CALINESTI",290,"SCOALA  GLODU, COMUNA CALINESTI (SAT GLODU)",675,346,333,13,0,344,2,800,454,131,213,3,1338,0
3,"Arges",15108,38,15108,,"CALINESTI",291,"SCOALA  CIRSTIENI, COMUNA CALINESTI (SAT CIRSTIENI)",1189,562,551,11,0,557,5,1300,738,230,327,3,1338,0
3,"Arges",15108,38,15108,,"CALINESTI",292,"SCOALA VALEA CORBULUI, COMUNA CALINESTI (SAT VALEA CORBULUI)",699,512,504,8,0,485,27,800,288,195,290,3,1338,0
3,"Arges",15108,38,15108,,"CALINESTI",293,"SCOALA GENERALA VRANESTI, SAT VRANESTI, CP 117210, COMUNA CALINESTI",0,172,0,172,0,172,0,500,328,77,95,3,1338,1
3,"Arges",15233,38,15233,,"CATEASCA",294,"CAMINUL CULTURAL CATEASCA, COMUNA CATEASCA (SAT CATEASCA)",764,504,488,15,1,500,4,900,396,217,283,3,1351,0
3,"Arges",15233,38,15233,,"CATEASCA",295,"CAMINUL CULTURAL SILISTEA, COMUNA CATEASCA (SAT SILISTEA)",1549,919,910,9,0,912,7,1600,681,326,586,3,1351,0
3,"Arges",15233,38,15233,,"CATEASCA",296,"CAMINUL CULTURAL CATANELE, COMUNA CATEASCA (SAT CATANELE)",677,438,430,8,0,434,4,800,362,218,216,3,1351,0
3,"Arges",15233,38,15233,,"CATEASCA",297,"PRIMARIA COMUNEI CATEASCA, SAT CATEASCA, CP 117220, COMUNA CATEASCA",0,274,0,274,0,270,4,501,227,147,123,3,1351,1
3,"Arges",15313,38,15313,,"CEPARI",298,"CAMINUL CULTURAL CEPARI, COMUNA CEPARI (SAT CEPARI PAMANTENI)",744,363,350,13,0,358,5,800,437,154,204,3,1359,0
3,"Arges",15313,38,15313,,"CEPARI",299,"SCOALA CARPENIS, COMUNA CEPARI (SAT CARPENIS)",635,322,315,6,1,313,9,700,378,131,182,3,1359,0
3,"Arges",15313,38,15313,,"CEPARI",300,"SCOALA URLUIESTI, COMUNA CEPARI (SAT URLUIESTI)",283,180,171,3,6,176,4,300,120,69,107,3,1359,0
3,"Arges",15313,38,15313,,"CEPARI",301,"SCOALA CEPARI UNGURENI, COMUNA CEPARI (SAT CEPARI UNGURENI)",295,182,169,13,0,176,6,400,218,57,119,3,1359,0
3,"Arges",15313,38,15313,,"CEPARI",302,"SCOALA CU CLASELE I-IV CEPARI PAMANTENI, SAT CEPARI PAMANTENI, CP 117230, COMUNA CEPARI",0,104,0,104,0,103,1,500,396,44,59,3,1359,1
3,"Arges",15402,38,15402,,"CETATENI",303,"CAMIN CULTURAL CETATENI, COMUNA CETATENI (SAT CETATENI)",1085,639,630,9,0,635,4,1200,561,228,407,3,1368,0
3,"Arges",15402,38,15402,,"CETATENI",304,"GRADINITA LAICAI, STR. PRIMAVERII NR.2, COMUNA CETATENI (SAT LAICAI)",776,459,451,8,0,454,5,900,441,204,250,3,1368,0
3,"Arges",15402,38,15402,,"CETATENI",305,"SCOALA  CU CLASELE I-IV VALEA CETATUIA, COMUNA CETATENI (SAT VALEA CETATUIA)",554,366,354,12,0,359,7,600,234,227,132,3,1368,0
3,"Arges",15402,38,15402,,"CETATENI",306,"CONSILIUL LOCAL CETATENI, SALA DE SEDINTE, SAT CETATENI, STR. NEGRU VODA NR.119, CP 117240, COMUNA CETATENI",0,84,0,84,0,84,0,500,416,40,44,3,1368,1
3,"Arges",15448,38,15448,,"CICANESTI",307,"SCOALA GENERALA CICANESTI, COMUNA CICANESTI",1802,1243,1235,8,0,1233,10,1900,657,338,895,3,1372,0
3,"Arges",15448,38,15448,,"CICANESTI",308,"SCOALA GENERALA CICANESTI, SAT CICANESTI, CP 117245, COMUNA CICANESTI",0,50,0,50,0,50,0,500,450,9,41,3,1372,1
3,"Arges",15493,38,15493,,"CIOFRANGENI",309,"CAMIN CULTURAL CIOFRINGENI, COMUNA CIOFRINGENI ( SAT CIOFRINGENI)",1568,931,918,13,0,914,17,1700,769,294,620,3,1377,0
3,"Arges",15493,38,15493,,"CIOFRANGENI",310,"CAMIN CULTURAL LACURILE, COMUNA CIOFRINGENI (SAT LACURILE)",570,419,399,20,0,413,6,696,277,139,274,3,1377,0
3,"Arges",15493,38,15493,,"CIOFRANGENI",311,"CAMINUL CULTURAL CIOFRANGENI, SAT CIOFRANGENI, CP 117250, COMUNA CIOFRANGENI",0,164,0,164,0,164,0,500,336,51,113,3,1377,1
3,"Arges",15554,38,15554,,"CIOMAGESTI",312,"SCOALA GENERALA CU CLASELE I-VIII BRATIA, COMUNA CIOMAGESTI (SAT BRATIA)",408,246,223,7,16,239,7,500,254,89,150,3,1383,0
3,"Arges",15554,38,15554,,"CIOMAGESTI",313,"SCOALA GENERALA CU CLASELE I-VIII CIOMAGESTI-SAT, COMUNA CIOMAGESTI (SAT CIOMAGESTI)",384,227,216,7,4,219,8,500,273,78,141,3,1383,0
3,"Arges",15554,38,15554,,"CIOMAGESTI",314,"SCOALA DOGARI, COMUNA CIOMAGESTI (SAT DOGARI)",214,122,111,9,2,121,1,300,178,46,75,3,1383,0
3,"Arges",15554,38,15554,,"CIOMAGESTI",315,"CAMINUL CULTURAL CIOMAGESTI, SAT RADUTESTI, CP 117255, COMUNA CIOMAGESTI",0,113,0,113,0,113,0,500,387,47,66,3,1383,1
3,"Arges",15652,38,15652,,"COCU",316,"SCOALA GENERALA COCU, COMUNA COCU (SAT COCU)",578,255,248,7,0,250,5,700,445,91,159,3,1393,0
3,"Arges",15652,38,15652,,"COCU",317,"SCOALA GENERALA  CRUCISOARA, COMUNA COCU (SAT CRUCISOARA)",257,170,159,11,0,168,2,300,130,63,105,3,1393,0
3,"Arges",15652,38,15652,,"COCU",318,"SCOALA GENERALA RICHITELE DE JOS, COMUNA COCU (SAT RICHITELE DE JOS)",337,181,170,11,0,173,8,400,219,62,111,3,1393,0
3,"Arges",15652,38,15652,,"COCU",319,"SCOALA GENERALA  RICHITELE DE SUS, COMUNA COCU (SAT RICHITELE DE SUS)",329,160,147,13,0,156,4,400,240,73,83,3,1393,0
3,"Arges",15652,38,15652,,"COCU",320,"SCOALA GENERALA BARBATESTI, COMUNA COCU (SAT BARBATESTI)",493,220,207,13,0,217,3,600,380,58,159,3,1393,0
3,"Arges",15652,38,15652,,"COCU",321,"SCOALA CU CLASELE I-VIII COCU, SAT COCU, CP 117265, COMUNA COCU",0,168,0,168,0,165,3,500,332,67,98,3,1393,1
3,"Arges",15741,38,15741,,"CORBENI",322,"CAMIN CULTURAL  OESTI,  COMUNA CORBENI (SAT OESTII PAMANTENI)",1182,654,646,8,0,644,10,1300,646,222,422,3,1402,0
3,"Arges",15741,38,15741,,"CORBENI",323,"SCOALA GENERALA OESTI,  COMUNA CORBENI ( SAT OESTII UNGURENI)",826,431,423,7,1,427,4,900,469,180,247,3,1402,0
3,"Arges",15741,38,15741,,"CORBENI",324,"SCOALA CU CLASELE  I-IV ROTUNDA, COMUNA CORBENI ( SAT ROTUNDA)",593,304,293,11,0,295,9,700,396,106,189,3,1402,0
3,"Arges",15741,38,15741,,"CORBENI",325,"GRUP SCOLAR CORBENI, COMUNA CORBENI ( SAT CORBENI)",1492,700,682,18,0,695,5,1600,900,348,347,3,1402,0
3,"Arges",15741,38,15741,,"CORBENI",326,"SCOALA CU CLASELE I-IV BERINDESTI, COMUNA  CORBENI ( SAT BERINDESTI)",614,351,316,35,0,348,3,700,349,152,196,3,1402,0
3,"Arges",15741,38,15741,,"CORBENI",327,"GRUP SCOLAR CORBENI, SAT CORBENI, CP 117275, COMUNA CORBENI",0,106,0,106,0,106,0,500,394,59,47,3,1402,1
3,"Arges",15830,38,15830,,"CORBI",328,"CAMIN CULTURAL CORBI, COMUNA CORBI (SAT CORBI)",1727,1024,992,11,21,1001,23,1900,876,509,492,3,1411,0
3,"Arges",15830,38,15830,,"CORBI",329,"CAMIN CULTURAL CORBSORI, COMUNA CORBI (SAT CORBSORI)",851,531,505,14,12,528,3,1000,469,231,297,3,1411,0
3,"Arges",15830,38,15830,,"CORBI",330,"CAMIN CULTURAL STANESTI, COMUNA CORBI (SAT STANESTI)",894,620,590,11,19,615,5,1000,380,212,403,3,1411,0
3,"Arges",15830,38,15830,,"CORBI",331,"CAMINUL CULTURAL CORBI, SALA ANEXA, SAT CORBI, STR. VOICU CORVIN NR.233, CP 115278, COMUNA CORBI",0,97,0,97,0,97,0,500,403,45,52,3,1411,1
3,"Arges",15901,38,15901,,"COSESTI",332,"SCOALA PETRESTI, COMUNA COSESTI ( SAT PETRESTI)",769,447,431,16,0,445,2,900,453,131,314,3,1418,0
3,"Arges",15901,38,15901,,"COSESTI",333,"CAMIN CULTURAL COSESTI, COMUNA COSESTI (SAT COSESTI)",887,521,511,10,0,515,6,1000,479,208,307,3,1418,0
3,"Arges",15901,38,15901,,"COSESTI",334,"CAMIN CULTURAL LEICESTI, COMUNA LEICESTI ( SAT LEICESTI)",1620,923,891,32,0,903,20,1700,777,389,514,3,1418,0
3,"Arges",15901,38,15901,,"COSESTI",335,"CAMIN CULTURAL JUPANESTI, COMUNA COSESTI (SAT JUPANESTI)",878,537,514,23,0,520,17,1000,463,258,262,3,1418,0
3,"Arges",15901,38,15901,,"COSESTI",336,"CAMIN CULTURAL LEICESTI, COMUNA COSESTI ( SAT LAPUSANI)",313,202,189,13,0,198,4,400,198,82,116,3,1418,0
3,"Arges",15901,38,15901,,"COSESTI",337,"SCOALA GENERALA CU CLASELE I-VIII, SAT COSESTI, CP 117295, COMUNA COSESTI",0,122,0,122,0,121,1,500,378,64,57,3,1418,1
3,"Arges",15983,38,15983,,"COTMEANA",338,"CAMIN CULTURAL COTMEANA, COMUNA COTMEANA (SAT  COTMEANA)",839,624,608,16,0,622,2,1000,376,102,520,3,1426,0
3,"Arges",15983,38,15983,,"COTMEANA",339,"SCOALA LINTESTI,  COMUNA COTMEANA (SATUL LINTESTI)",406,269,258,11,0,268,1,500,231,95,173,3,1426,0
3,"Arges",15983,38,15983,,"COTMEANA",340,"SCOALA BASCOVELE, COMUNA COTMEANA (SAT BASCOVELE)",468,286,280,6,0,284,2,500,214,87,197,3,1426,0
3,"Arges",15983,38,15983,,"COTMEANA",341,"SCOALA GENERALA CU CLASELE I-VIII COTMEANA, SAT COTMEANA, STR. PRINCIPALA, CP 117305, COMUNA COTMEANA",0,162,0,162,0,157,5,500,338,58,99,3,1426,1
3,"Arges",16132,38,16132,,"CUCA",342,"SCOALA GENERALA CUCA, SALA 1, COMUNA CUCA (SAT CUCA)",450,267,259,8,0,264,3,500,233,108,156,3,1441,0
3,"Arges",16132,38,16132,,"CUCA",343,"SCOALA GENERALA TEODORESTI, COMUNA CUCA (SAT TEODORESTI)",554,295,288,7,0,288,7,600,305,101,187,3,1441,0
3,"Arges",16132,38,16132,,"CUCA",344,"SCOALA PRIMARA MACAI, COMUNA CUCA (SAT MACAI)",526,281,273,8,0,276,5,600,319,104,172,3,1441,0
3,"Arges",16132,38,16132,,"CUCA",345,"SCOALA PRIMARA CIRCESTI, COMUNA CUCA (SAT CIRCESTI)",273,183,175,8,0,181,2,300,117,44,137,3,1441,0
3,"Arges",16132,38,16132,,"CUCA",346,"SCOALA GENERALA CUCA, SAT CUCA, CP 117330, COMUNA CUCA",0,119,0,119,0,118,1,492,373,44,74,3,1441,1
3,"Arges",16285,38,16285,,"DAVIDESTI",347,"SCOALA DAVIDESTI, COMUNA DAVIDESTI (SAT DAVIDESTI)",506,340,326,14,0,337,3,600,260,113,224,3,1466,0
3,"Arges",16285,38,16285,,"DAVIDESTI",348,"SCOALA CONTESTI NR. 1, COMUNA DAVIDESTI (SAT CONTESTI) - SALA NR.1",1344,764,757,7,0,751,13,1500,736,193,558,3,1466,0
3,"Arges",16285,38,16285,,"DAVIDESTI",349,"SCOALA VOROVENI, COMUNA DAVIDESTI (SAT VOROVENI) -  SALA NR.1",454,310,303,7,0,308,2,500,190,102,206,3,1466,0
3,"Arges",16285,38,16285,,"DAVIDESTI",350,"SCOALA CU CLASELE I-IV DAVIDESTI, CORP VECHI, SALA 2, SAT DAVIDESTI, NR. 43, CP 117350, COMUNA DAVIDESTI",0,74,0,74,0,74,0,500,426,14,60,3,1466,1
3,"Arges",16329,38,16329,,"DAMBOVICIOARA",351,"SEDIUL ADMINSTRATIV PODU DAMBOVITEI, SALA NR. 4, COMUNA DAMBOVICIOARA (SAT PODU DAMBOVITEI)",484,369,359,10,0,369,0,600,231,155,214,3,1456,0
3,"Arges",16329,38,16329,,"DAMBOVICIOARA",352,"PRIMARIA COMUNEI DIMBOVICIOARA, COMUNA DIMBOVICIOARA ( SAT DAMBOVICIOARA)",292,193,186,7,0,192,1,400,207,78,114,3,1456,0
3,"Arges",16329,38,16329,,"DAMBOVICIOARA",353,"SCOALA GENERALA CU CLASELE  I -IV CIOCANU, COMUNA DIMBOVICIOARA ( SAT CIOCANU)",70,66,54,12,0,65,1,100,34,22,43,3,1456,0
3,"Arges",16329,38,16329,,"DAMBOVICIOARA",354,"SEDIUL ADMINISTRATIV PODU DAMBOVITEI, SAT PODU DAMBOVITEI, CP 117355, COMUNA DAMBOVICIOARA",0,154,0,154,0,153,1,496,342,58,95,3,1456,1
3,"Arges",16365,38,16365,,"DARMANESTI",355,"SCOALA PISCANI, COMUNA DIRMANESTI (SAT PISCANI)",1299,653,640,13,0,648,5,1400,747,289,359,3,1460,0
3,"Arges",16365,38,16365,,"DARMANESTI",356,"SCOALA DIRMANESTI, COMUNA DIRMANESTI ( SAT DIRMANESTI)",1134,624,602,22,0,622,2,1200,576,229,393,3,1460,0
3,"Arges",16365,38,16365,,"DARMANESTI",357,"SCOALA VALEA NANDRII, COMUNA DIRMANESTI (SAT VALEA NANDRII)",582,347,328,19,0,344,3,700,353,101,243,3,1460,0
3,"Arges",16365,38,16365,,"DARMANESTI",358,"PRIMARIA COMUNEI DARMANESTI, SAT DARMANESTI, STR. PRINCIPALA NR. 150, CP 117366, COMUNA DARMANESTI",0,58,0,58,0,58,0,500,442,11,47,3,1460,1
3,"Arges",16427,38,16427,,"DOBRESTI",359,"CAMIN CULTURAL DOBRESTI, SALA MICA, COMUNA DOBRESTI (SAT DOBRESTI)",786,464,458,4,2,463,1,900,436,189,274,3,1470,0
3,"Arges",16427,38,16427,,"DOBRESTI",360,"SCOALA GENERALA CU CLASELE  I-IV FURESTI, COMUNA DOBRESTI (SAT FURESTI)",698,419,414,5,0,411,8,800,381,160,251,3,1470,0
3,"Arges",16427,38,16427,,"DOBRESTI",361,"CAMINUL CULTURAL DOBRESTI, SALA MARE, SAT DOBRESTI, NR. 104, CP 117365, COMUNA DOBRESTI",0,119,0,119,0,119,0,500,381,53,66,3,1470,1
3,"Arges",16454,38,16454,,"DOMNESTI",362,"CASA DE CULTURA  PETRE IONESCU MUSCEL   -  HOLUL NR.1-   B.DUL ALEXANDRU IOAN CUZA NR.3, COMUNA DOMNESTI",1206,824,789,15,20,816,8,1300,476,257,559,3,1473,0
3,"Arges",16454,38,16454,,"DOMNESTI",363,"CASA DE CULTURA  PETRE IONESCU MUSCEL   -  HOLUL NR.2   B.DUL ALEXANDRU IOAN CUZA NR.3, COMUNA DOMNESTI",1497,1054,1015,17,22,1040,14,1600,546,343,697,3,1473,0
3,"Arges",16454,38,16454,,"DOMNESTI",364,"CAMIN CULT. DOMNESTI, HOL INTRARE IN BIBLIOTECA PUBLICA LUCA PAUL, SAT DOMNESTI, BD AL I CUZA,NR.3,CP117370,COM DOMNESTI",0,211,0,211,0,211,0,500,289,93,118,3,1473,1
3,"Arges",16472,38,16472,,"DRAGOSLAVELE",365,"SCOALA CU CLASELE V-VIII DRAGOSLAVELE, COMUNA DRAGOSLAVELE (SAT DRAGOSLAVELE)",725,505,495,10,0,499,6,800,295,169,330,3,1480,0
3,"Arges",16472,38,16472,,"DRAGOSLAVELE",366,"SCOALA CU CLASELE  I-IV DRAGOSLAVELE, COMUNA DRAGOSLAVELE (SAT DRAGOSLAVELE)",925,592,588,4,0,586,6,1000,408,211,375,3,1480,0
3,"Arges",16472,38,16472,,"DRAGOSLAVELE",367,"SCOALA VALEA HOTARULUI, COMUNA DRAGOSLAVELE (SAT VALEA HOTARULUI)",431,341,327,14,0,337,4,500,159,87,250,3,1480,0
3,"Arges",16472,38,16472,,"DRAGOSLAVELE",368,"SCOALA CU CLASELE I-IV DRAGOSLAVELE, SAT DRAGOSLAVELE, CP 117375, COMUNA DRAGOSLAVELE",0,94,0,94,0,92,2,500,406,43,49,3,1480,1
3,"Arges",16506,38,16506,,"DRAGANU",369,"CAMIN CULTURAL DRAGANU, COMUNA DRAGANU (SAT DRAGANU)",1597,840,832,8,0,830,10,1700,860,320,510,3,1475,0
3,"Arges",16506,38,16506,,"DRAGANU",370,"CAMINUL CULTURAL DRAGANU, CAMERA 3, SAT DRAGANU, CP 117380, COMUNA DRAGANU",0,121,0,121,0,120,1,500,379,54,66,3,1475,1
3,"Arges",16551,38,16551,,"GODENI",371,"SCOALA GENERALA  GODENI, COMUNA GODENI  ( SAT GODENI)",1179,748,742,4,2,738,10,1300,552,187,551,3,1483,0
3,"Arges",16551,38,16551,,"GODENI",372,"SCOALA GENERALA COTESTI, COMUNA GODENI (SAT COTESTI)",1541,917,897,11,9,907,10,1698,781,351,556,3,1483,0
3,"Arges",16551,38,16551,,"GODENI",373,"SCOALA GENERALA GODENI, SAT GODENI, STR. ALINIERE NR. 26, CP 117385, COMUNA GODENI",0,123,0,123,0,123,0,500,377,33,90,3,1483,1
3,"Arges",16613,38,16613,,"HARSESTI",374,"SCOALA CU CLASELE I-VIII HARSESTI, COMUNA HARSESTI (SAT HARSESTI)",1467,763,757,6,0,754,9,1600,837,310,444,3,1489,0
3,"Arges",16613,38,16613,,"HARSESTI",375,"SCOALA  MARTALOGI, COMUNA HIRSESTI (SAT MARTALOGI)",678,370,364,6,0,366,4,800,430,117,249,3,1489,0
3,"Arges",16613,38,16613,,"HARSESTI",376,"GRADINITA NR.1 HARSESTI, SAT HARSESTI, CP 117390, COMUNA HARSESTI",0,202,0,202,0,201,0,500,298,84,117,3,1489,1
3,"Arges",16659,38,16659,,"HARTIESTI",377,"CAMIN CULTURAL HIRTIESTI, COMUNA HIRTIESTI ( SAT HIRTIESTI)",798,541,532,9,0,539,2,900,359,129,410,3,1493,0
3,"Arges",16659,38,16659,,"HARTIESTI",378,"PRIMARIA VECHE HIRTIESTI, COMUNA HIRTIESTI ( SAT  DEALU) -SALA MARE",269,182,174,8,0,180,2,300,118,45,135,3,1493,0
3,"Arges",16659,38,16659,,"HARTIESTI",379,"SCOALA LUCIENI, COMUNA HIRTIESTI (SAT LUCIENI)",277,213,203,10,0,212,1,400,187,48,164,3,1493,0
3,"Arges",16659,38,16659,,"HARTIESTI",380,"CENTRUL DE ZI LESPEZI, COMUNA HIRTIESTI ( SAT LESPEZI)",310,238,230,8,0,227,11,400,162,47,180,3,1493,0
3,"Arges",16659,38,16659,,"HARTIESTI",381,"SEDIUL FOSTEI PRIMARII, SAT HARTIESTI, CP 117395, COMUNA HARTIESTI",0,79,0,79,0,79,0,500,421,22,57,3,1493,1
3,"Arges",16739,38,16739,,"IZVORU",382,"SCOALA CU CLASELE I-VIII IZVORU - SALA NR. 4, COMUNA IZVORU (SAT IZVORU)",688,358,351,7,0,354,4,800,442,165,189,3,1498,0
3,"Arges",16739,38,16739,,"IZVORU",383,"SCOALA CU CLASELE  I-VIII IZVORU - SALA NR. 3, COMUNA IZVORU (SAT IZVORU)",1331,627,624,3,0,615,12,1400,773,334,281,3,1498,0
3,"Arges",16739,38,16739,,"IZVORU",384,"SCOALA GENERALA CU CLASELE I-VIII IZVORU, SALA 1, SAT IZVORU, CP 117405, COMUNA IZVORU",0,92,0,92,0,91,1,500,408,52,39,3,1498,1
3,"Arges",16757,38,16757,,"LEORDENI",385,"PRIMARIA LEORDENI, COMUNA LEORDENI",1478,853,848,5,0,843,10,1600,747,349,494,3,1500,0
3,"Arges",16757,38,16757,,"LEORDENI",386,"CAMIN CULTURAL BUDISTENI, COMUNA LEORDENI (SAT BUDISTENI)",1083,639,627,12,0,626,13,1200,561,198,428,3,1500,0
3,"Arges",16757,38,16757,,"LEORDENI",387,"SCOALA CU CLASELE  I-VIII GLIMBOCATA, COMUNA LEORDENI (SAT GLIMBOCATA)",1006,530,524,6,0,521,9,1100,570,216,305,3,1500,0
3,"Arges",16757,38,16757,,"LEORDENI",388,"SCOALA CU CLASELE I-IV CIULNITA, COMUNA LEORDENI ( SAT CIULNITA)",980,574,563,11,0,569,5,1100,526,228,341,3,1500,0
3,"Arges",16757,38,16757,,"LEORDENI",389,"SCOALA CU CLASELE  I-IV COTU MALULUI, COMUNA LERODENI (SAT COTU- MALULUI)",388,266,253,11,2,261,5,500,234,53,208,3,1500,0
3,"Arges",16757,38,16757,,"LEORDENI",390,"SCOALA LEORDENI, SAT LEORDENI, CP 117410, COMUNA LEORDENI",0,270,0,270,0,268,2,500,230,111,157,3,1500,1
3,"Arges",16908,38,16908,,"LERESTI",391,"SCOALA GENERALA CU CLASELE I-IV - CORP B, COMUNA LERESTI (SAT LERESTI)",1180,661,653,8,0,658,3,1300,639,214,444,3,1515,0
3,"Arges",16908,38,16908,,"LERESTI",392,"CAMIN CULTURAL VOINESTI (ATENEU), COMUNA LERESTI (SAT VOINESTI)",1396,853,846,7,0,841,12,1500,647,344,497,3,1515,0
3,"Arges",16908,38,16908,,"LERESTI",393,"CAMIN CULTURAL LERESTI. COMUNA LERESTI (SAT LERESTI)",1537,966,959,7,0,959,7,1600,634,350,609,3,1515,0
3,"Arges",16908,38,16908,,"LERESTI",394,"SCOALA CU CLASELE I-VIII LERESTI, STR. PRINCIPALA NR. 228, CP 117430, COMUNA LERESTI",0,117,0,117,0,116,1,500,383,36,80,3,1515,1
3,"Arges",16944,38,16944,,"LUNCA CORBULUI",395,"SCOALA LUNCA CORBULUI, COMUNA LUNCA CORBULUI (SAT LUNCA CORBULUI)",862,498,486,12,0,496,2,1000,502,271,225,3,1519,0
3,"Arges",16944,38,16944,,"LUNCA CORBULUI",396,"SCOALA SILISTENI, COMUNA LUNCA CORBULUI (SAT SILISTENI)",233,157,146,11,0,157,0,300,143,102,55,3,1519,0
3,"Arges",16944,38,16944,,"LUNCA CORBULUI",397,"SCOALA PADURETI, COMUNA LUNCA CORBULUI (SAT PADURETI)",955,478,471,7,0,473,5,1100,622,194,279,3,1519,0
3,"Arges",16944,38,16944,,"LUNCA CORBULUI",398,"SCOALA MIRGHIA DE SUS, COMUNA LUNCA CORBULUI (SAT MIRGHIA DE SUS)",420,293,285,8,0,287,6,500,207,103,184,3,1519,0
3,"Arges",16944,38,16944,,"LUNCA CORBULUI",399,"SCOALA GENERALA CU CLASELE I-VIII LUNCA CORBULUI, SAT LUNCA CORBULUI, CP 117435, COMUNA LUNCA CORBULUI",0,294,0,294,0,292,2,495,201,119,173,3,1519,1
3,"Arges",17049,38,17049,,"MALURENI",400,"SCOALA MALURENI , COMUNA MALURENI (SAT MALURENI)",578,334,315,18,1,328,6,700,366,95,233,3,1529,0
3,"Arges",17049,38,17049,,"MALURENI",401,"CAMIN CULTURAL BADICENI, COMUNA MALURENI (SAT BADICENI)",407,236,197,39,0,232,4,500,264,101,131,3,1529,0
3,"Arges",17049,38,17049,,"MALURENI",402,"SCOALA  BOHARI, COMUNA MALURENI (SAT BOHARI)",301,182,146,36,0,181,1,400,218,87,94,3,1529,0
3,"Arges",17049,38,17049,,"MALURENI",403,"SCOALA TOPLITA, COMUNA MALURENI (SAT TOPLITA)",409,226,203,23,0,224,2,500,274,92,132,3,1529,0
3,"Arges",17049,38,17049,,"MALURENI",404,"SCOALA  ZARNESTI, COMUNA MALURENI (SAT ZARNESTI)",773,447,418,29,0,440,7,900,453,161,279,3,1529,0
3,"Arges",17049,38,17049,,"MALURENI",405,"SCOALA BUNESTI, COMUNA MALURENI (SAT BUNESTI)",564,288,270,18,0,281,7,700,412,88,193,3,1529,0
3,"Arges",17049,38,17049,,"MALURENI",406,"TABARA PAULEASCA, COMUNA MALURENI (SAT PAULEASCA)",520,343,333,10,0,328,15,600,257,189,139,3,1529,0
3,"Arges",17049,38,17049,,"MALURENI",407,"CAMINUL CULTURAL BADICENI, SAT MALURENI, CATUN BADICENI, CP 117445, COMUNA MALURENI",0,310,0,310,0,309,1,500,190,122,187,3,1529,1
3,"Arges",13365,38,13365,,"MARACINENI",408,"SCOALA GENERALA NR.1 MARACINENI - SALA 1, COMUNA MARACINENI",1851,1090,1063,27,0,1083,7,2000,910,417,666,3,1535,0
3,"Arges",13365,38,13365,,"MARACINENI",409,"SCOALA GENERALA NR.1 MARACINENI - SALA 2, COMUNA MARACINENI",685,404,390,14,0,399,5,800,396,178,221,3,1535,0
3,"Arges",13365,38,13365,,"MARACINENI",410,"SCOALA GENERALA NR.2 ARGESELU - SALA 1, COMUNA MARACINENI ( SAT ARGESELU)",1487,934,916,18,0,927,7,1600,666,337,590,3,1535,0
3,"Arges",13365,38,13365,,"MARACINENI",411,"SEDIUL FOSTEI PRIMARII MARACINENI, SAT MARACINENI, NR. 469, CP 117450, COMUNA MARACINENI",0,307,0,307,0,304,3,499,192,170,134,3,1535,1
3,"Arges",17101,38,17101,,"MERISANI",412,"SCOALA GENERALA DOBROGOSTEA, COMUNA MERISANI (SAT DOBROGOSTEA)",963,544,527,17,0,540,4,1100,556,198,342,3,1538,0
3,"Arges",17101,38,17101,,"MERISANI",413,"SCOALA GENERALA BORLESTI, COMUNA MERISANI( SAT BORLESTI)",495,299,290,9,0,295,4,600,301,177,118,3,1538,0
3,"Arges",17101,38,17101,,"MERISANI",414,"SCOALA GENERALA MERISANI, COMUNA MERISANI (SAT MERISANI)",1113,665,650,15,0,654,11,1200,535,259,395,3,1538,0
3,"Arges",17101,38,17101,,"MERISANI",415,"CAMINUL CULTURAL VILCELE, COMUNA MERISANI (SAT VILCELE)",849,500,492,8,0,495,5,1000,500,161,334,3,1538,0
3,"Arges",17101,38,17101,,"MERISANI",416,"SCOALA GENERALA MERISANI, SAT MERISANI, CP 117455 COMUNA MERISANI",0,169,0,169,0,169,0,500,331,57,112,3,1538,1
3,"Arges",17209,38,17209,,"MICESTI",417,"SCOALA MICESTI, COMUNA MICESTI (SAT MICESTI)",1410,793,778,15,0,782,11,1500,707,331,451,3,1548,0
3,"Arges",17209,38,17209,,"MICESTI",418,"CAMIN CULTURAL PURCARENI, COMUNA MICESTI (SAT PURCARENI)",1289,768,741,27,0,758,10,1400,632,296,462,3,1548,0
3,"Arges",17209,38,17209,,"MICESTI",419,"SCOALA PAULEASCA, COMUNA MICESTI (SAT PAULEASCA)",652,371,358,13,0,358,13,700,329,145,213,3,1548,0
3,"Arges",17209,38,17209,,"MICESTI",420,"GRADINITA MICESTI, SAT MICESTI, CP 117465, COMUNA MICESTI",0,88,0,88,0,86,2,500,412,34,52,3,1548,1
3,"Arges",17254,38,17254,,"MIHAESTI",421,"CAMIN CULTURAL MIHAESTI, COMUNA MIHAESTI (SAT MIHAESTI)",1900,958,900,58,0,942,16,1900,942,324,618,3,1553,0
3,"Arges",17254,38,17254,,"MIHAESTI",422,"CAMIN CULTURAL VALEA POPII, COMUNA MIHAESTI (SAT VALEA POPII)",824,573,560,13,0,570,3,900,327,153,417,3,1553,0
3,"Arges",17254,38,17254,,"MIHAESTI",423,"SCOALA GENERALA DRAGHICI, COMUNA MIHAESTI (SAT DRAGHICI)",935,576,569,7,0,567,9,997,421,150,417,3,1553,0
3,"Arges",17254,38,17254,,"MIHAESTI",424,"SCOALA GENERALA  VACAREA, COMUNA MIHAESTI (SAT VACAREA)",499,356,353,3,0,356,0,600,244,82,274,3,1553,0
3,"Arges",17254,38,17254,,"MIHAESTI",425,"CAMIN CULTURAL FURNICOSI, COMUNA MIHAESTI (SAT FURNICOSI)",723,462,443,19,0,451,11,800,338,186,265,3,1553,0
3,"Arges",17254,38,17254,,"MIHAESTI",426,"GRADINITA MIHAESTI, CENTRU, SAT MIHAESTI, CP 117470, COMUNA MIHAESTI",0,126,0,126,0,122,4,500,374,64,58,3,1553,1
3,"Arges",17334,38,17334,,"MIOARELE",427,"SCOALA GENERALA CU CLASELE I-VIII MIOARELE, COMUNA MIOARELE (SAT MATAU)",1065,606,602,4,0,599,7,1200,594,213,386,3,1561,0
3,"Arges",17334,38,17334,,"MIOARELE",428,"SCOALA GENERALA CU CLASELE I-IV SUSLANESTI, COMUNA MIOARELE (SAT SUSLANESTI)",349,217,212,5,0,217,0,400,183,110,107,3,1561,0
3,"Arges",17334,38,17334,,"MIOARELE",429,"CAMINUL CULTURAL MATAU, SAT MATAU, CP 117480, COMUNA MIOARELE",0,50,0,50,0,49,1,500,450,21,28,3,1561,1
3,"Arges",17398,38,17398,,"MIROSI",430,"SCOALA MIROSI, COMUNA MIROSI (SAT MIROSI)",1038,669,666,2,1,661,8,1500,831,188,473,3,1567,0
3,"Arges",17398,38,17398,,"MIROSI",431,"SCOALA SURDULESTI, COMUNA MIROSI (SAT SURDULESTI)",818,375,369,6,0,368,7,900,525,135,233,3,1567,0
3,"Arges",17398,38,17398,,"MIROSI",432,"SCOALA MIROSI, SAT MIROSI, CP 117490, COMUNA MIROSI",0,98,0,98,0,98,0,500,402,37,61,3,1567,1
3,"Arges",17423,38,17423,,"MORARESTI",433,"SCOALA CU CLASELE I-VIII MORARESTI, COMUNA MORARESTI (SAT MORARESTI)",526,364,354,6,4,360,4,600,236,193,167,3,1570,0
3,"Arges",17423,38,17423,,"MORARESTI",434,"SCOALA CU CLASELE I-IV SAPUNARI, COMUNA MORARESTI  (SAT SAPUNARI)",440,277,271,6,0,272,5,500,223,116,156,3,1570,0
3,"Arges",17423,38,17423,,"MORARESTI",435,"SCOALA CU CLASELE I-IV DEDULESTI, COMUNA MORARESTI (SAT DEDULESTI)",702,406,399,7,0,401,5,800,394,158,243,3,1570,0
3,"Arges",17423,38,17423,,"MORARESTI",436,"SCOALA DE CENTRU MORARESTI, SAT MORARESTI, CP 117495, COMUNA MORARESTI",0,193,0,193,0,191,2,500,307,79,112,3,1570,1
3,"Arges",17496,38,17496,,"MOSOAIA",437,"CAMIN CULTURAL MOSOAIA, COMUNA MOSOAIA (SAT MOSOAIA)",1327,822,804,18,0,817,5,1400,578,317,500,3,1577,0
3,"Arges",17496,38,17496,,"MOSOAIA",438,"SCOALA CU CLASELE  I-VIII HINTESTI, COMUNA MOSOAIA  (SAT HINTESTI)",795,492,480,12,0,485,7,900,408,159,326,3,1577,0
3,"Arges",17496,38,17496,,"MOSOAIA",439,"SCOALA CU CLASELE  I-IV SMEURA, COMUNA MOSOAIA (SAT SMEURA)",1310,761,737,24,0,753,8,1400,639,300,453,3,1577,0
3,"Arges",17496,38,17496,,"MOSOAIA",440,"SCOALA CU CLASELE I-IV CIOCANAI, COMUNA MOSOAIA (SAT CIOCANAI)",504,294,287,7,0,292,2,600,306,113,179,3,1577,0
3,"Arges",17496,38,17496,,"MOSOAIA",441,"SCOALA MOSOAIA, SAT MOSOAIA, CP 117505, COMUNA MOSOAIA",0,103,0,103,0,101,2,500,397,29,72,3,1577,1
3,"Arges",17575,38,17575,,"MOZACENI",442,"GRUPUL SCOLAR MOZACENI, COMUNA MOZACENI",1388,729,728,1,0,717,12,1500,771,165,552,3,1585,0
3,"Arges",17575,38,17575,,"MOZACENI",443,"SCOALA CU CLASELE  I-VIII NR. 2 MOZACENI, COMUNA MOZACENI (SAT MOZACENI)",582,297,278,19,0,295,2,700,403,97,198,3,1585,0
3,"Arges",17575,38,17575,,"MOZACENI",444,"COMPLEXUL CULTURAL SPORTIV, SAT MOZACENI, CP 117515, COMUNA MOZACENI",0,95,0,95,0,95,0,500,405,27,68,3,1585,1
3,"Arges",17619,38,17619,,"MUSATESTI",445,"SCOALA  CU CLASELE I- VIII MUSATESTI , COMUNA MUSATESTI (SAT ROBAIA)",1322,673,655,12,6,664,9,1400,727,253,411,3,1589,0
3,"Arges",17619,38,17619,,"MUSATESTI",446,"CLADIREA VECHE A PRIMARIEI, COMUNA MUSATESTI (SAT VILSANESTI)",439,261,239,22,0,260,1,500,239,99,161,3,1589,0
3,"Arges",17619,38,17619,,"MUSATESTI",447,"SCOALA CU CLASELE I-VIII COSTESTI - VILSAN, COMUNA MUSATESTI (SAT COSTESTI)",627,373,361,12,0,371,2,700,327,163,208,3,1589,0
3,"Arges",17619,38,17619,,"MUSATESTI",448,"SCOALA CU CLASELE I-VIII STROESTI, COMUNA MUSATESTI (SAT STROESTI)",905,510,502,8,0,506,4,1000,490,218,288,3,1589,0
3,"Arges",17619,38,17619,,"MUSATESTI",449,"SCOALA GENERALA CU CLASELE I-VIII VALSANESTI, SAT VALSANESTI, NR. 108, CP 117531, COMUNA MUSATESTI",0,122,0,122,0,121,1,500,378,52,69,3,1589,1
3,"Arges",17726,38,17726,,"NEGRASI",450,"SCOALA GENERALA CU CLASELE  I-VIII NEGRASI, COMUNA NEGRASI (SAT NEGRASI)",735,413,407,6,0,402,11,800,387,124,278,3,1600,0
3,"Arges",17726,38,17726,,"NEGRASI",451,"SCOALA GENERALA CU CLASELE I-VIII  BIRLOGU, COMUNA NEGRASI (SAT BIRLOGU)",779,400,383,17,0,390,10,900,500,180,210,3,1600,0
3,"Arges",17726,38,17726,,"NEGRASI",452,"SCOALA GENERALA CU CLASELE I-IV MOZACU, COMUNA NEGRASI ( SAT MOZACU)",284,158,152,6,0,153,5,400,242,46,107,3,1600,0
3,"Arges",17726,38,17726,,"NEGRASI",453,"SCOALA CU CLASELE  I-IV BUTA, COMUNA NEGRASI (SAT BUTA)",188,128,119,8,1,125,3,300,172,44,81,3,1600,0
3,"Arges",17726,38,17726,,"NEGRASI",454,"CAMINUL CULTURAL NEGRASI, SAT NEGRASI, CP 117535, COMUNA NEGRASI",0,188,0,188,0,187,1,500,312,72,115,3,1600,1
3,"Arges",17771,38,17771,,"NUCSOARA",455,"CAMIN CULTURAL NUCSOARA, COMUNA NUCSOARA (SAT NUCSOARA)",467,325,303,5,17,319,6,600,275,150,169,3,1605,0
3,"Arges",17771,38,17771,,"NUCSOARA",456,"CAMIN CULTURAL SBOGHITESTI, COMUNA NUCSOARA (SAT SBOGHITESTI)",841,558,543,6,9,551,7,900,342,217,334,3,1605,0
3,"Arges",17771,38,17771,,"NUCSOARA",457,"SCOALA PRIMARA ALEXANDRU MOLDOVEANU, SAT SBOGHITESTI, CP 117540, COMUNA NUCSOARA",0,104,0,104,0,103,1,500,396,49,54,3,1605,1
3,"Arges",17824,38,17824,,"OARJA",458,"SCOALA CU CLASELE I-VIII  D.RADULESCU , COMUNA OARJA",1371,944,914,14,16,937,7,1497,553,513,424,3,1610,0
3,"Arges",17824,38,17824,,"OARJA",459,"SCOALA CU CLASELE  I-IV, COMUNA OARJA (SAT OARJA)",837,619,587,20,12,614,5,1000,381,362,252,3,1610,0
3,"Arges",17824,38,17824,,"OARJA",460,"SCOALA CU CLASELE I-VIII D. RADULESCU, SAT OARJA, CP 117545, COMUNA OARJA",0,193,0,193,0,192,1,500,307,116,76,3,1610,1
3,"Arges",17851,38,17851,,"PIETROSANI",461,"SALA DE SPORT PIETROSANI, COMUNA PIETROSANI (SAT PIETROSANI)",1540,958,926,32,0,946,12,1700,742,365,581,3,1613,0
3,"Arges",17851,38,17851,,"PIETROSANI",462,"CAMIN CULTURAL BADESTI, COMUNA PIETROSANI (SAT BADESTI)",1240,725,698,27,0,715,10,1300,575,365,350,3,1613,0
3,"Arges",17851,38,17851,,"PIETROSANI",463,"SCOALA GENERALA  CU CLASELE I- IV  RETEVOIESTI, COMUNA PIETROSANI (SAT RETEVOIESTI)",1459,791,773,18,0,785,6,1600,809,292,493,3,1613,0
3,"Arges",17851,38,17851,,"PIETROSANI",464,"SCOALA GENERALA CU CLASELE  I-IV GANESTI, COMUNA PIETROSANI (SAT GANESTI)",594,328,317,11,0,322,6,700,372,164,158,3,1613,0
3,"Arges",17851,38,17851,,"PIETROSANI",465,"SCOALA CU CLASELE I-IV RETEVOIESTI, SAT RETEVOIESTI, CP 117550, COMUNA PIETROSANI",0,85,0,85,0,85,0,500,415,39,46,3,1613,1
3,"Arges",18028,38,18028,,"POIANA LACULUI",466,"SCOALA CU CLASELE I-VIII POIANA LACULUI, COMUNA POIANA LACULUI (SAT POIANA LACULUI)",1459,817,786,31,0,814,3,1600,783,354,460,3,1619,0
3,"Arges",18028,38,18028,,"POIANA LACULUI",467,"SCOALA CU CLASELE I-IV DINCULESTI, COMUNA POIANA LACULUI ( SAT DINCULESTI)",318,223,214,9,0,221,2,400,177,107,114,3,1619,0
3,"Arges",18028,38,18028,,"POIANA LACULUI",468,"SCOALA CU CLASELE  I-IV CATUNASI, COMUNA POIANA LACULUI (SAT CATUNASI)",393,269,253,16,0,265,4,477,208,132,133,3,1619,0
3,"Arges",18028,38,18028,,"POIANA LACULUI",469,"SCOALA CU CLASELE I-VIII SAMARA, COMUNA POIANA LACULUI (SAT SAMARA)",711,475,425,50,0,471,4,800,325,289,182,3,1619,0
3,"Arges",18028,38,18028,,"POIANA LACULUI",470,"SCOALA CU CLASELE  I-IV METOFU, COMUNA POIANA LACULUI (SAT METOFU)",298,217,209,8,0,214,3,400,183,124,90,3,1619,0
3,"Arges",18028,38,18028,,"POIANA LACULUI",471,"SCOALA CU CLASELE I-IV DEALUL VIILOR, COMUNA POIANA LACULUI (SAT DEALUL VIILOR)",314,216,189,27,0,212,4,400,184,134,78,3,1619,0
3,"Arges",18028,38,18028,,"POIANA LACULUI",472,"GRADINITA PADUROIU  DIN DEAL, COMUNA POIANA LACULUI, SAT PADUROIU DIN DEAL)",631,336,324,12,0,330,6,700,364,135,195,3,1619,0
3,"Arges",18028,38,18028,,"POIANA LACULUI",473,"GRADINITA PADUROIU  DIN VALE, COMUNA POIANA LACULUI (SAT PADUROIU DIN VALE)",804,391,377,14,0,385,6,900,509,202,183,3,1619,0
3,"Arges",18028,38,18028,,"POIANA LACULUI",474,"SCOALA CU CLASELE I-IV GARDINESTI, COMUNA POIANA LACULUI (SAT GARDINESTI)",404,231,214,17,0,230,1,500,269,124,106,3,1619,0
3,"Arges",18028,38,18028,,"POIANA LACULUI",475,"SCOALA CU CLASELE I-VIII POIANA LACULUI, SAT POIANA LACULUI, CP 117555, COMUNA POIANA LACULUI",0,186,0,186,0,184,2,500,314,91,93,3,1619,1
3,"Arges",17913,38,17913,,"POIENARII DE ARGES",476,"SCOALA GENERALA CU CLASELE I-IV POIENARI, COMUNA POIENARII DE ARGES ( SAT POIENARI)",713,439,433,6,0,435,4,800,361,184,251,3,1633,0
3,"Arges",17913,38,17913,,"POIENARII DE ARGES",477,"SCOALA GENERALA CU CLASELE  I-IV IOANICESTI, COMUNA POIENARII DE ARGES ( SAT IOANICESTI)",206,124,116,8,0,123,1,300,176,27,96,3,1633,0
3,"Arges",17913,38,17913,,"POIENARII DE ARGES",478,"SCOALA GENERALA CU CLASELE I-IV, SAT POIENARI, CP 117555, COMUNA POIENARII DE ARGES",0,86,0,86,0,86,0,500,414,38,48,3,1633,1
3,"Arges",17968,38,17968,,"POIENARII DE MUSCEL",479,"SCOALA GENERALA CU CLASELE I-VIII POIENARII DE MUSCEL, COMUNA POIENARII DE MUSCEL (SAT POIENARI)",1429,656,639,17,0,652,4,1600,944,339,313,3,1638,0
3,"Arges",17968,38,17968,,"POIENARII DE MUSCEL",480,"SCOALA GENERALA CU CLASELE I-VIII JUGUR, COMUNA POIENARII DE MUSCEL (SAT JUGUR)",983,475,467,8,0,471,4,1100,625,248,223,3,1638,0
3,"Arges",17968,38,17968,,"POIENARII DE MUSCEL",481,"SCOALA GENERALA CU CLASELE I-IV GROSANI, COMUNA POIENARII DE MUSCEL (SAT GROSANI)",555,336,293,43,0,326,10,600,264,177,149,3,1638,0
3,"Arges",17968,38,17968,,"POIENARII DE MUSCEL",482,"SCOALA CU CLASELE I-VIII POIENARI, SAT POIENARI, CP 117578, COMUNA POIENARII DE MUSCEL",0,69,0,69,0,69,0,500,431,47,22,3,1638,1
3,"Arges",18162,38,18162,,"POPESTI",483,"SCOALA POPESTI, COMUNA POPESTI (SAT POPESTI-PALANGA)",639,367,352,15,0,361,6,691,324,72,289,3,1644,0
3,"Arges",18162,38,18162,,"POPESTI",484,"SCOALA SLOBOZIA, COMUNA POPESTI (SAT SLOBOZIA)",667,320,290,30,0,316,4,800,480,65,251,3,1644,0
3,"Arges",18162,38,18162,,"POPESTI",485,"SCOALA PURCARENI, COMUNA POPESTI (SAT PURCARENI)",659,400,370,30,0,392,8,800,400,105,287,3,1644,0
3,"Arges",18162,38,18162,,"POPESTI",486,"SCOALA GENERALA CU CLASELE I-VIII SLOBOZIA, SAT SLOBOZIA, CP 117590, COMUNA POPESTI",0,124,0,124,0,122,2,400,276,40,82,3,1644,1
3,"Arges",18242,38,18242,,"PRIBOIENI",487,"CLUBUL TINERETULUI, COMUNA PRIBOIENI (SAT PRIBOIENI)",1507,1100,1079,21,0,1090,10,1600,500,345,745,3,1649,0
3,"Arges",18242,38,18242,,"PRIBOIENI",488,"SCOALA CU CLASELE I-VIII PRIBOIENI, COMUNA PRIBOIENI (SAT PARASCHIVESTI)",1477,974,954,20,0,969,5,1600,626,262,707,3,1649,0
3,"Arges",18242,38,18242,,"PRIBOIENI",489,"SEDIUL FOSTEI PRIMARII, NR. 28, SAT PRIBOIENI, CP 117600, COMUNA PRIBOIENI",0,95,0,95,0,94,1,498,403,24,70,3,1649,1
3,"Arges",18331,38,18331,,"RATESTI",490,"CAMINUL CULTURAL TIGVENI,  COMUNA RATESTI (SAT TIGVENI)",1499,794,789,5,0,787,7,1600,806,298,489,3,1662,0
3,"Arges",18331,38,18331,,"RATESTI",491,"SCOALA CU CLASELE  I-IV NEJLOVELU,  COMUNA RATESTI (SAT NEJLOVELU)",597,307,299,8,0,301,6,700,393,122,179,3,1662,0
3,"Arges",18331,38,18331,,"RATESTI",492,"SCOALA CU CLASELE  I-IV FURDUIESTI, COMUNA RATESTI (SATUL FURDUIESTI)",453,277,268,9,0,276,1,500,223,103,173,3,1662,0
3,"Arges",18331,38,18331,,"RATESTI",493,"CAMINUL CULTURAL TIGVENI, SAT TIGVENI, CP 117610, COMUNA RATESTI",0,167,0,167,0,165,2,500,333,71,94,3,1662,1
3,"Arges",20048,38,20048,,"RACA",494,"SCOALA CU CLASELE I-VIII RACA - SALA DE SPORT, COMUNA RACA (SAT RACA)",1005,612,603,9,0,598,14,1100,488,120,478,3,1658,0
3,"Arges",20048,38,20048,,"RACA",495,"SCOALA VECHE RACA, SAT RACA, CP 117596, COMUNA RACA",0,182,0,182,0,181,1,500,318,37,144,3,1658,1
3,"Arges",18411,38,18411,,"RECEA",496,"SCOALA VECHE RECEA, COMUNA RECEA (SAT RECEA)",1660,918,891,27,0,905,13,1800,882,408,497,3,1670,0
3,"Arges",18411,38,18411,,"RECEA",497,"SCOALA GENERALA CU CLASELE I-VIII DEAGURILE, COMUNA RECEA (SAT DEAGU DE SUS)",709,411,392,19,0,400,11,800,389,128,272,3,1670,0
3,"Arges",18411,38,18411,,"RECEA",498,"SCOALA GENERALA GOLEASCA,COMUNA RECEA ( SAT GOLEASCA)",166,106,94,12,0,105,1,201,95,44,61,3,1670,0
3,"Arges",18411,38,18411,,"RECEA",499,"SEDIUL FOSTEI PRIMARII RECEA, SAT RECEA, CP 117620, COMUNA RECEA",0,132,0,132,0,130,2,500,368,44,86,3,1670,1
3,"Arges",18475,38,18475,,"ROCIU",500,"SCOALA GENERALA ROCIU, SALA DE CURSURI PENTRU CLASELE I-IV SIMULTAN, COMUNA ROCIU (SAT ROCIU)",431,266,253,13,0,263,3,500,234,65,198,3,1676,0
3,"Arges",18475,38,18475,,"ROCIU",501,"SCOALA GENERALA GLIGANU DE JOS, SALA DE CURSURI PENTRU CLASELE I-IV SIMULTAN, COMUNA ROCIU (SAT GLIGANU DE JOS)",417,274,251,23,0,274,0,500,226,52,222,3,1676,0
3,"Arges",18475,38,18475,,"ROCIU",502,"SCOALA GENERALA GLIGANU DE SUS, SALA DE CURSURI PENTRU CLASELE I-IV SIMULTAN, COMUNA ROCIU (SAT GLIGANU DE SUS)",657,463,447,16,0,454,9,700,237,137,317,3,1676,0
3,"Arges",18475,38,18475,,"ROCIU",503,"SCOALA GENERALA SERBANESTI, SALA DE CURSURI PENTRU CLASA A VIII-A,COMUNA ROCIU (SAT SERBANESTI)",847,567,562,5,0,561,6,900,333,174,387,3,1676,0
3,"Arges",18475,38,18475,,"ROCIU",504,"CAMINUL CULTURAL GLIGANU DE SUS, SAT GLIGANU DE SUS, CP 117627, COMUNA ROCIU",0,250,0,250,0,248,2,500,250,80,168,3,1676,1
3,"Arges",18527,38,18527,,"RUCAR",505,"GRUPUL SCOLAR FORESTIER, COMUNA RUCAR , (SAT RUCAR) - SALA DE SPORT",1332,871,788,83,0,862,9,1400,529,395,467,3,1681,0
3,"Arges",18527,38,18527,,"RUCAR",506,"SCOALA GENERALA NR.2, COMUNA RUCAR (SAT RUCAR) CLASA NR.1",1320,950,855,95,0,935,15,1400,450,350,585,3,1681,0
3,"Arges",18527,38,18527,,"RUCAR",507,"SCOALA GENERALA NR.1, COMUNA RUCAR (SAT RUCAR) CLASA NR.2",2206,1549,1383,166,0,1534,15,2400,851,731,803,3,1681,0
3,"Arges",18527,38,18527,,"RUCAR",508,"SCOALA  SATIC, COMUNA RUCAR (SAT SATIC) CLASA NR. 2",111,97,66,31,0,97,0,300,203,38,59,3,1681,0
3,"Arges",18527,38,18527,,"RUCAR",509,"GRUPUL SCOLAR FORESTIER RUCAR, CLASA NR.2, SAT RUCAR, STR. BRASOVULUI, NR.92, CP 117630, COMUNA RUCAR",0,222,0,222,0,220,2,500,278,100,120,3,1681,1
3,"Arges",18554,38,18554,,"SALATRUCU",510,"CAMINUL CULTURAL SALATRUCU CENTRU, COMUNA SALATRUCU ( SAT SALATRUCU)",1264,682,674,8,0,673,9,1400,718,227,446,3,1684,0
3,"Arges",18554,38,18554,,"SALATRUCU",511,"SCOALA  CU CLASELE I-IV VALENI, COMUNA SALATRUCU ( SAT VALENI)",585,331,326,5,0,328,3,700,369,158,170,3,1684,0
3,"Arges",18554,38,18554,,"SALATRUCU",512,"CAMINUL CULTURAL SALATRUCU CENTRU, SAT SALATRUCU, CP 117635, COMUNA SALATRUCU",0,56,0,56,0,56,0,500,444,23,33,3,1684,1
3,"Arges",18581,38,18581,,"SAPATA",513,"GRADINITA MIRTESTI, COMUNA SAPATA (SAT MIRTESTI)",253,159,151,8,0,156,3,300,141,52,104,3,1687,0
3,"Arges",18581,38,18581,,"SAPATA",514,"SCOALA SAPATA DE JOS, COMUNA SAPATA (SAT BANARESTI)",350,197,186,11,0,193,4,400,203,97,96,3,1687,0
3,"Arges",18581,38,18581,,"SAPATA",515,"SCOALA DEALUL BRADULUI, COMUNA SAPATA (SAT DEALUL BRADULUI)",199,128,123,5,0,126,2,300,172,68,58,3,1687,0
3,"Arges",18581,38,18581,,"SAPATA",516,"PRIMARIA COMUNEI SAPATA, COMUNA SAPATA (SAT POPESTI)",710,457,448,9,0,454,3,800,343,207,247,3,1687,0
3,"Arges",18581,38,18581,,"SAPATA",517,"CAMINUL CULTURAL POPESTI, SAT POPESTI, CP 117640, COMUNA SAPATA",0,145,0,145,0,144,1,500,355,64,80,3,1687,1
3,"Arges",18670,38,18670,,"SCHITU GOLESTI",518,"SCOALA CU CLASELE  V-VIII LAZARESTI, SATUL LAZARESTI, COMUNA SCHITU- GOLESTI, JUDETUL ARGES",1174,607,591,16,0,595,12,1300,693,233,362,3,1696,0
3,"Arges",18670,38,18670,,"SCHITU GOLESTI",519,"CAMIN CULTURAL SCHITU GOLESTI, COMUNA  SCHITU- GOLESTI (SAT SCHITU- GOLESTI)",1162,600,575,25,0,598,2,1300,700,205,393,3,1696,0
3,"Arges",18670,38,18670,,"SCHITU GOLESTI",520,"CAMIN CULTURAL LAZARESTI,COMUNA SCHITU- GOLESTI ( SAT LAZARESTI)",1667,793,782,11,0,786,7,1800,1007,330,456,3,1696,0
3,"Arges",18670,38,18670,,"SCHITU GOLESTI",521,"CENTRUL SOCIAL MULTIFUNCTIONAL SCHITU GOLESTI,SAT SCHITU GOLESTI, DN73 PIT-C-LUNG NR.414,CP117650, COMUNA SCHITU GOLESTI",0,76,0,76,0,75,1,500,424,28,47,3,1696,1
3,"Arges",18741,38,18741,,"SLOBOZIA",522,"SCOALA GENERALA NR.1 SLOBOZIA, COMUNA SLOBOZIA (SAT SLOBOZIA DE JOS)",2078,976,889,87,0,963,13,2200,1224,300,663,3,1703,0
3,"Arges",18741,38,18741,,"SLOBOZIA",523,"SCOALA GENERALA NR.2 SLOBOZIA, COMUNA SLOBOZIA (SAT SLOBOZIA DE SUS)",1794,1040,894,146,0,1010,30,1900,860,317,693,3,1703,0
3,"Arges",18741,38,18741,,"SLOBOZIA",524,"SCOALA NEGRISOARA, COMUNA SLOBOZIA (SAT NEGRISOARA)",199,164,122,42,0,160,4,300,136,82,78,3,1703,0
3,"Arges",18741,38,18741,,"SLOBOZIA",525,"CAMINUL CULTURAL, STR. CONSTANTIN BRANCOVEANU NR.2, CP 117660, COMUNA SLOBOZIA",0,110,0,110,0,107,3,500,390,41,66,3,1703,1
3,"Arges",18778,38,18778,,"STALPENI",526,"GRADINITA CU PROGRAM PRELUNGIT STILPENI, COMUNA STILPENI (SAT STILPENI)",1661,1009,994,15,0,999,10,1701,692,258,741,3,1706,0
3,"Arges",18778,38,18778,,"STALPENI",527,"SCOALA CU CLASELE I-VIII  LIVEZENI, COMUNA STILPENI (SATUL LIVEZENI)",1182,708,700,8,0,704,4,1300,592,240,464,3,1706,0
3,"Arges",18778,38,18778,,"STALPENI",528,"CAMIN CULTURAL RADESTI,  COMUNA STILPENI (SATUL RADESTI)",1421,878,858,20,0,869,9,1500,622,195,674,3,1706,0
3,"Arges",18778,38,18778,,"STALPENI",529,"PRIMARIA COMUNEI STALPENI, SAT STALPENI, CP 117665, COMUNA STALPENI",0,180,0,180,0,180,0,500,320,52,128,3,1706,1
3,"Arges",18858,38,18858,,"STOENESTI",530,"CAMIN CULTURAL STOENESTI, COMUNA STOENESTI ( SAT STOENESTI)",1159,643,635,8,0,637,6,1300,657,295,342,3,1717,0
3,"Arges",18858,38,18858,,"STOENESTI",531,"CAMIN CULTURAL BADENI, COMUNA STOENESTI (SAT BADENI)",1529,797,779,18,0,792,5,1700,903,344,448,3,1717,0
3,"Arges",18858,38,18858,,"STOENESTI",532,"CAMIN CULTURAL PIATRA, COMUNA STOENESTI (SAT PIATRA)",444,239,231,8,0,237,2,500,261,74,163,3,1717,0
3,"Arges",18858,38,18858,,"STOENESTI",533,"SCOALA GENERALA VALEA BADENILOR, COMUNA STOENESTI (SAT VALEA BADENILOR)",589,420,408,12,0,410,10,700,280,110,300,3,1717,0
3,"Arges",18858,38,18858,,"STOENESTI",534,"SCOALA GENERALA STOENESTI, SAT STOENESTI, CP 117675, COMUNA STOENESTI",0,69,0,69,0,68,1,500,431,33,35,3,1717,1
3,"Arges",18938,38,18938,,"STOLNICI",535,"SCOALA GENERALA STOLNICI, COMUNA STOLNICI (SAT STOLNICI)",1600,773,762,11,0,756,17,1800,1027,220,536,3,1725,0
3,"Arges",18938,38,18938,,"STOLNICI",536,"CAMIN CULTURAL FILFANI, COMUNA STOLNICI (SAT FILFANI)",1171,487,480,7,0,481,6,1299,812,177,304,3,1725,0
3,"Arges",18938,38,18938,,"STOLNICI",537,"SCOALA GENERALA STOLNICI, SAT STOLNICI, STR. PRINCIPALA, NR. 157, CP 117685, COMUNA STOLNICI",0,223,0,223,0,220,3,500,277,81,139,3,1725,1
3,"Arges",19007,38,19007,,"SUSENI",538,"SCOALA GENERALA CU CLASELE I-IV CERSANI, COMUNA SUSENI (SAT CERSANI)",638,360,359,1,0,357,3,700,340,130,227,3,1739,0
3,"Arges",19007,38,19007,,"SUSENI",539,"SCOALA GENERALA CU CLASELE  I-VIII SUSENI, COMUNA SUSENI (SAT SUSENI)",913,463,453,10,0,461,2,1000,537,151,310,3,1739,0
3,"Arges",19007,38,19007,,"SUSENI",540,"SCOALA GENERALA CU CLASELE I-IV TUTULESTI, COMUNA SUSENI (SAT TUTULESTI)",1153,595,587,8,0,586,9,1300,705,222,364,3,1739,0
3,"Arges",19007,38,19007,,"SUSENI",541,"SCOALA CU CLASELE I-VIII SUSENI, SAT SUSENI, NR. 280, CP 117695, COMUNA SUSENI",0,168,0,168,0,165,3,500,332,79,86,3,1739,1
3,"Arges",19114,38,19114,,"STEFAN CEL MARE",542,"SCOALA CU CLASELE  I-VIII  STEFAN CEL MARE, COMUNA STEFAN CEL MARE (SAT STEFAN CEL MARE) - SALA 1",820,407,395,12,0,398,9,902,495,126,272,3,1714,0
3,"Arges",19114,38,19114,,"STEFAN CEL MARE",543,"SCOALA CU CLASELE I-VIII  STEFAN CEL MARE, COMUNA STEFAN CEL MARE (SAT STEFAN CEL MARE) - SALA 2",852,462,441,21,0,456,6,997,535,197,259,3,1714,0
3,"Arges",19114,38,19114,,"STEFAN CEL MARE",544,"SCOALA GLAVACIOC, COMUNA STEFAN CEL MARE (SAT GLAVACIOC)",368,172,149,23,0,166,6,400,228,57,109,3,1714,0
3,"Arges",19114,38,19114,,"STEFAN CEL MARE",545,"SCOALA CU CLASELE I-VIII, SALA DE SPORT, SAT STEFAN CEL MARE, CP 117710, COMUNA STEFAN CEL MARE",0,116,0,116,0,115,1,500,384,40,75,3,1714,1
3,"Arges",19141,38,19141,,"SUICI",546,"CAMIN CULTURAL SUICI, COMUNA SUICI (SAT SUICI)",1142,690,675,15,0,677,13,1300,610,240,437,3,1732,0
3,"Arges",19141,38,19141,,"SUICI",547,"SCOALA GENERALA  RUDENI, COMUNA SUICI  (SAT RUDENI)",744,480,475,5,0,473,7,900,420,171,302,3,1732,0
3,"Arges",19141,38,19141,,"SUICI",548,"SCOALA GENERALA IANCULESTI, COMUNA SUICI ( SAT IANCULESTI)",289,153,142,11,0,151,2,400,247,78,73,3,1732,0
3,"Arges",19141,38,19141,,"SUICI",549,"SCOALA GENERALA VALEA CALULUI, COMUNA SUICI (SAT VALEA CALULUI)",89,55,45,10,0,54,1,100,45,22,32,3,1732,0
3,"Arges",19141,38,19141,,"SUICI",550,"SCOALA RUDENI, SAT RUDENI, CP 117785, COMUNA SUICI",0,75,0,75,0,74,1,500,425,32,42,3,1732,1
3,"Arges",19212,38,19212,,"TEIU",551,"CAMIN CULTURAL TEIU,  COMUNA TEIU (SAT TEIU VALE)",1096,584,582,2,0,574,10,1200,616,207,367,3,1750,0
3,"Arges",19212,38,19212,,"TEIU",552,"SCOALA GENERALA LESILE,  COMUNA TEIU (SAT LESILE)",208,128,114,14,0,125,3,300,172,39,86,3,1750,0
3,"Arges",19212,38,19212,,"TEIU",553,"CAMINUL CULTURAL, SAT TEIU VALE, CP 117735, COMUNA TEIU",0,154,0,154,0,154,0,500,346,72,82,3,1750,1
3,"Arges",19249,38,19249,,"TIGVENI",554,"PRIMARIA TIGVENI, COMUNA TIGVENI (SAT TIGVENI)",1657,869,854,15,0,835,34,1800,931,218,617,3,1753,0
3,"Arges",19249,38,19249,,"TIGVENI",555,"CAMIN CULTURAL BIRSESTII DE JOS, COMUNA TIGVENI (SAT BIRSESTII DE JOS)",1077,536,530,6,0,528,8,1200,664,171,357,3,1753,0
3,"Arges",19249,38,19249,,"TIGVENI",556,"PRIMARIA COMUNEI TIGVENI, SAT TIGVENI, CP 117740, COMUNA TIGVENI",0,110,0,110,0,108,2,500,390,21,87,3,1753,1
3,"Arges",19338,38,19338,,"TITESTI",557,"PRIMARIA COMUNEI  TITESTI, COMUNA TITESTI ( SAT TITESTI)",1150,633,622,11,0,629,4,1300,667,235,394,3,1762,0
3,"Arges",19338,38,19338,,"TITESTI",558,"SCOALA CU CLASELE I-IV TITESTI, COMUNA TITESTI ( SAT TITESTI)",936,492,485,7,0,490,2,1000,508,121,369,3,1762,0
3,"Arges",19338,38,19338,,"TITESTI",559,"SCOALA VALEA STINII, COMUNA TITESTI (SAT VALEA STINII)",814,523,515,8,0,522,1,900,377,160,362,3,1762,0
3,"Arges",19338,38,19338,,"TITESTI",560,"SCOALA CU CLASELE  I-IV VALEA MINASTIRII, COMUNA TITESTI (SAT VALEA MANASTIRII)",681,396,383,13,0,388,8,796,400,52,336,3,1762,0
3,"Arges",19338,38,19338,,"TITESTI",561,"SCOALA GENERALA CU CLASELE V-VIII I.C. LAZARESCU, SAT TITESTI, CP 117750, COMUNA TITESTI",0,60,0,60,0,58,2,500,440,24,34,3,1762,1
3,"Arges",19392,38,19392,,"UDA",562,"SCOALA CU CLASEIE I-VIII UDA DE JOS, COMUNA UDA",648,330,320,10,0,325,5,700,370,118,207,3,1768,0
3,"Arges",19392,38,19392,,"UDA",563,"SCOALA CU CLASELE  I-IV UDA DE SUS, COMUNA UDA",287,192,180,12,0,188,4,400,208,80,108,3,1768,0
3,"Arges",19392,38,19392,,"UDA",564,"SCOALA CU CLASELE I-VIII SALISTEA, COMUNA UDA (SAT SALISTEA)",572,312,302,10,0,308,4,700,388,163,145,3,1768,0
3,"Arges",19392,38,19392,,"UDA",565,"CAMIN CULTURAL GOVORA, COMUNA UDA (SAT RIJLETU  GOVORA)",450,244,223,21,0,243,1,500,256,90,153,3,1768,0
3,"Arges",19392,38,19392,,"UDA",566,"CONSILIUL LOCAL UDA, SAT UDA, CP 117755, COMUNA UDA",0,202,0,202,0,202,0,500,298,97,105,3,1768,1
3,"Arges",19560,38,19560,,"UNGHENI",567,"SCOALA UNGHENI, COMUNA UNGHENI (SAT UNGHENI)",690,418,418,0,0,413,5,800,382,243,170,3,1785,0
3,"Arges",19560,38,19560,,"UNGHENI",568,"SCOALA COLTU, COMUNA UNGHENI (SAT COLTU)",732,465,448,17,0,464,1,800,335,285,179,3,1785,0
3,"Arges",19560,38,19560,,"UNGHENI",569,"SOCIETATEA AGRICOLA ALBINA, COMUNA UNGHENI",1322,737,727,10,0,727,10,1400,663,446,281,3,1785,0
3,"Arges",19560,38,19560,,"UNGHENI",570,"SCOALA CU CLASELE I-VIII UNGHENI, SAT UNGHENI, CP 117780, COMUNA UNGHENI",0,242,0,242,0,242,0,500,258,134,108,3,1785,1
3,"Arges",19631,38,19631,,"VALEA DANULUI",571,"CAMIN CULTURAL VALEA DANULUI, COMUNA VALEA DANULUI (SAT VALEA DANULUI)",1700,988,978,7,3,976,12,1901,913,547,429,3,1792,0
3,"Arges",19631,38,19631,,"VALEA DANULUI",572,"CAMIN CULTURAL VERNESTI, COMUNA VALEA DANULUI (SAT VERNESTI)",862,579,557,22,0,570,9,980,401,326,244,3,1792,0
3,"Arges",19631,38,19631,,"VALEA DANULUI",573,"PRIMARIA COMUNEI VALEA DANULUI, SAT VALEA DANULUI, CP 117790, COMUNA VALEA DANULUI",0,104,0,104,0,104,0,520,416,48,56,3,1792,1
3,"Arges",19695,38,19695,,"VALEA IASULUI",574,"SCOALA VALEA IASULUI - SAT UNGURENI, COMUNA VALEA IASULUI",853,429,425,4,0,426,3,900,471,166,260,3,1798,0
3,"Arges",19695,38,19695,,"VALEA IASULUI",575,"GRADINITA BOROVINESTI, COMUNA VALEA IASULUI ( SAT BOROVINESTI)",191,107,99,8,0,106,1,200,93,27,79,3,1798,0
3,"Arges",19695,38,19695,,"VALEA IASULUI",576,"SCOALA MUSTATESTI, COMUNA VALEA  IASULUI (SAT MUSTATESTI)",895,490,481,9,0,487,3,1000,510,209,278,3,1798,0
3,"Arges",19695,38,19695,,"VALEA IASULUI",577,"GRADINITA CERBURENI, COMUNA VALEA IASULUI (SAT CERBURENI)",381,188,181,7,0,187,1,400,212,77,110,3,1798,0
3,"Arges",19695,38,19695,,"VALEA IASULUI",578,"PRIMARIA COMUNEI VALEA IASULUI, SALA DE SEDINTE, SAT VALEA IASULUI, CP 117795, COMUNA VALEA IASULUI",0,59,0,59,0,59,0,500,441,25,34,3,1798,1
3,"Arges",13524,38,13524,,"VALEA MARE PRAVAT",579,"CAMIN CULTURAL VALEA MARE PRAVAT, COMUNA VALEA MARE PRAVAT ( SAT VALEA MARE)",1267,830,813,17,0,818,12,1400,570,415,403,3,1808,0
3,"Arges",13524,38,13524,,"VALEA MARE PRAVAT",580,"CAMIN CULTURAL NAMAESTI, COMUNA VALEA MARE PRAVAT ( SAT NAMAESTI)",535,366,349,17,0,358,8,600,234,197,161,3,1808,0
3,"Arges",13524,38,13524,,"VALEA MARE PRAVAT",581,"SCOALA GENERALA  BILCESTI, COMUNA VALEA MARE PRAVAT ( SAT BILCESTI)",777,455,446,9,0,452,3,900,445,268,184,3,1808,0
3,"Arges",13524,38,13524,,"VALEA MARE PRAVAT",582,"SCOALA GENERALA  GURA PRAVAT, COMUNA VALEA MARE PRAVAT ( SAT GURA PRAVAT)",706,527,513,14,0,509,18,800,273,365,144,3,1808,0
3,"Arges",13524,38,13524,,"VALEA MARE PRAVAT",583,"SCOALA CU CLASELE I-VIII VALEA MARE, CORP A, SAT VALEA MARE, SOS. BRASOVULUI, NR.195,CP117805, COMUNA VALEA MARE PRAVAT",0,170,0,170,0,168,2,494,324,123,45,3,1808,1
3,"Arges",19793,38,19793,,"VEDEA",584,"GRUPUL SCOLAR  I. GHE. DUCA -VEDEA, COMUNA VEDEA (SAT VEDEA)",847,429,412,17,0,425,4,900,471,161,264,3,1817,0
3,"Arges",19793,38,19793,,"VEDEA",585,"SCOALA VATA, COMUNA VEDEA ( SAT VATA)",610,342,334,8,0,336,6,700,358,155,181,3,1817,0
3,"Arges",19793,38,19793,,"VEDEA",586,"SCOALA PRODANI,  COMUNA VEDEA (SAT PRODANI)",624,338,334,4,0,336,2,694,356,132,204,3,1817,0
3,"Arges",19793,38,19793,,"VEDEA",587,"SCOALA FATA, COMUNA VEDEA (SATUL FATA)",537,271,262,9,0,266,5,600,329,128,138,3,1817,0
3,"Arges",19793,38,19793,,"VEDEA",588,"SCOALA IZVORU DE SUS, COMUNA VEDEA (SAT IZVORUL DE SUS)",333,204,196,8,0,203,1,400,196,74,129,3,1817,0
3,"Arges",19793,38,19793,,"VEDEA",589,"SCOALA FRATICI, COMUNA VEDEA (SAT FRATICI)",383,238,234,4,0,237,1,400,162,103,134,3,1817,0
3,"Arges",19793,38,19793,,"VEDEA",590,"GRUPUL SCOAL I.GHE.DUCA, SAT VEDEA, CP 117815, COMUNA VEDEA",0,211,0,211,0,209,2,500,289,88,121,3,1817,1
3,"Arges",19999,38,19999,,"VLADESTI",591,"GRADINITA DE COPII NR. 3 VLADESTI, COMUNA VLADESTI ( SAT VLADESTI)",1707,1069,1054,15,0,1058,11,1800,731,503,555,3,1837,0
3,"Arges",19999,38,19999,,"VLADESTI",592,"SCOALA PRIMARA NR .2 VLADESTII DE SUS, COMUNA VLADESTI (SAT VLADESTI)",812,518,496,22,0,507,11,900,382,259,248,3,1837,0
3,"Arges",19999,38,19999,,"VLADESTI",593,"GRADINITA NR.3, SAT VLADESTI, NR. 676, CP 117840, COMUNA VLADESTI",0,68,0,68,0,68,0,500,432,32,36,3,1837,1
3,"Arges",20055,38,20055,,"VULTURESTI",594,"PRIMARIA VULTURESTI, COMUNA VULTURESTI",1545,754,748,6,0,739,15,1600,846,342,397,3,1842,0
3,"Arges",20055,38,20055,,"VULTURESTI",595,"CAMIN CULTURAL BIRZESTI, COMUNA VULTURESTI (SATUL BIRZESTI)",492,331,317,14,0,328,3,600,269,159,169,3,1842,0
3,"Arges",20055,38,20055,,"VULTURESTI",596,"SCOALA HULUBA,  COMUNA VULTURESTI (SAT HULUBA )",194,142,133,9,0,140,2,298,156,60,80,3,1842,0
3,"Arges",20055,38,20055,,"VULTURESTI",597,"PRIMARIA COMUNEI VULTURESTI, SAT VULTURESTI, CP 117402, COMUNA VULTURESTI",0,92,0,92,0,89,3,500,408,42,47,3,1842,1
4,"Bacau",20297,47,20297,,"MUNICIPIUL BACAU",1,"Scoala nr.9 Calea Moldovei nr.136",1753,907,883,24,0,886,21,1900,993,539,347,1,1847,0
4,"Bacau",20297,47,20297,,"MUNICIPIUL BACAU",2,"Serviciul Public de Asistenta Sociala str.Stefan cel Mare 17A",1678,721,709,12,0,710,11,1800,1079,453,257,1,1847,0
4,"Bacau",20297,47,20297,,"MUNICIPIUL BACAU",3,"Serviciul Public de Asistenta Sociala str.Stefan cel Mare 17A",1236,613,593,20,0,596,17,1400,787,362,234,1,1847,0
4,"Bacau",20297,47,20297,,"MUNICIPIUL BACAU",4,"S.C. E-ON ELECTRICA (parter) str.Stefan cel Mare 22",1548,722,711,11,0,712,10,1700,978,431,281,1,1847,0
4,"Bacau",20297,47,20297,,"MUNICIPIUL BACAU",5,"Gradinita Crai Nou nr.37 str.Aprodu Purice nr.11A",1129,456,446,10,0,452,4,1200,744,273,179,1,1847,0
4,"Bacau",20297,47,20297,,"MUNICIPIUL BACAU",6,"Gradinita Crai Nou nr.37 str.Aprodu Purice nr.11A",1183,493,482,11,0,485,8,1303,810,325,160,1,1847,0
4,"Bacau",20297,47,20297,,"MUNICIPIUL BACAU",7,"Scoala Mihail Sadoveanu str.Venus nr.1 ",1243,547,535,10,2,537,10,1400,853,323,214,1,1847,0
4,"Bacau",20297,47,20297,,"MUNICIPIUL BACAU",8,"Scoala Mihail Sadoveanu str.Venus nr.1 ",1673,741,734,7,0,733,8,1801,1060,471,262,1,1847,0
4,"Bacau",20297,47,20297,,"MUNICIPIUL BACAU",9,"Scoala Mihail Sadoveanu str.Venus nr.1 ",1454,654,637,16,1,643,11,1600,946,387,256,1,1847,0
4,"Bacau",20297,47,20297,,"MUNICIPIUL BACAU",10,"Scoala Mihail Sadoveanu str.Venus nr.1 ",1271,534,523,11,0,524,10,1400,866,323,201,1,1847,0
4,"Bacau",20297,47,20297,,"MUNICIPIUL BACAU",11,"Scoala Georgeta M.Cancicov str.Prieteniei nr.73 ",1586,737,720,17,0,725,12,1701,964,399,326,1,1847,0
4,"Bacau",20297,47,20297,,"MUNICIPIUL BACAU",12,"Scoala Georgeta M.Cancicov str.Prieteniei nr.73 ",1460,710,701,9,0,704,6,1600,890,420,284,1,1847,0
4,"Bacau",20297,47,20297,,"MUNICIPIUL BACAU",13,"Gradinita Georgeta M.Cancicov str.Prieteniei nr.73",1505,715,702,13,0,708,7,1701,986,382,326,1,1847,0
4,"Bacau",20297,47,20297,,"MUNICIPIUL BACAU",14,"Gradinita Georgeta M.Cancicov str.Prieteniei nr.73",1052,458,452,6,0,457,1,1190,732,246,211,1,1847,0
4,"Bacau",20297,47,20297,,"MUNICIPIUL BACAU",15,"Scoala Mihai Dragan str.Logofat Tautu nr.7",1932,990,981,9,0,982,8,2100,1110,582,400,1,1847,0
4,"Bacau",20297,47,20297,,"MUNICIPIUL BACAU",16,"Scoala Mihai Dragan str.Logofat Tautu nr.7",1512,741,730,11,0,731,10,1701,960,390,341,1,1847,0
4,"Bacau",20297,47,20297,,"MUNICIPIUL BACAU",17,"Gradinita nr.35 str.Costache Negri nr.1",1164,583,573,10,0,573,10,1301,718,301,272,1,1847,0
4,"Bacau",20297,47,20297,,"MUNICIPIUL BACAU",18,"Gradinita nr.35 str.Costache Negri nr.1",1549,739,726,12,1,728,11,1701,962,357,371,1,1847,0
4,"Bacau",20297,47,20297,,"MUNICIPIUL BACAU",19,"Administratia Finantelor Publice (BANCOREX) str.9 Mai nr.33",1595,750,733,17,0,741,9,1400,650,411,330,1,1847,0
4,"Bacau",20297,47,20297,,"MUNICIPIUL BACAU",20,"Colegiul National Gheorghe Vranceanu str.L.Patrascanu nr.30",1354,847,838,9,0,835,12,1500,653,416,419,1,1847,0
4,"Bacau",20297,47,20297,,"MUNICIPIUL BACAU",21,"Colegiul National Gheorghe Vranceanu str.L.Patrascanu nr.30",1023,519,509,10,0,513,6,1103,584,300,213,1,1847,0
4,"Bacau",20297,47,20297,,"MUNICIPIUL BACAU",22,"Scoala Alexandru Ioan Cuza str.Oituz nr.14",1314,834,824,10,0,829,5,1400,566,377,452,1,1847,0
4,"Bacau",20297,47,20297,,"MUNICIPIUL BACAU",23,"Colegiul National Ferdinand I str.George Bacovia nr.45",1448,696,675,21,0,681,15,1600,904,357,324,1,1847,0
4,"Bacau",20297,47,20297,,"MUNICIPIUL BACAU",24,"Colegiul National Ferdinand I str.George Bacovia nr.45",1006,582,569,13,0,575,7,1100,518,296,279,1,1847,0
4,"Bacau",20297,47,20297,,"MUNICIPIUL BACAU",25,"Colegiul National Ferdinand I str.George Bacovia nr.45",1713,899,882,17,0,891,8,1900,1001,493,398,1,1847,0
4,"Bacau",20297,47,20297,,"MUNICIPIUL BACAU",26,"Directia Agricola str.George Bacovia nr.20",1573,846,834,12,0,827,19,1700,854,429,398,1,1847,0
4,"Bacau",20297,47,20297,,"MUNICIPIUL BACAU",27,"Gradinita nr.29 str.Radu Negru nr.3",1731,841,822,19,0,832,9,1900,1059,449,383,1,1847,0
4,"Bacau",20297,47,20297,,"MUNICIPIUL BACAU",28,"Gradinita nr.29 str.Radu Negru nr.3",1956,962,948,14,0,953,9,2101,1139,538,415,1,1847,0
4,"Bacau",20297,47,20297,,"MUNICIPIUL BACAU",29,"Gradinita nr.40 str.Cuza Voda nr.10",1650,807,785,22,0,800,7,1800,993,431,369,1,1847,0
4,"Bacau",20297,47,20297,,"MUNICIPIUL BACAU",30,"Gradinita nr.40 str.Cuza Voda nr.10",1783,962,941,21,0,947,15,1900,938,506,441,1,1847,0
4,"Bacau",20297,47,20297,,"MUNICIPIUL BACAU",31,"Scoala Ion Creanga str.Tipografilor nr.11",2057,1018,1004,14,0,996,22,2200,1182,572,424,1,1847,0
4,"Bacau",20297,47,20297,,"MUNICIPIUL BACAU",32,"Scoala Ion Creanga str.Tipografilor nr.11",1910,867,853,14,0,851,16,2100,1233,514,337,1,1847,0
4,"Bacau",20297,47,20297,,"MUNICIPIUL BACAU",33,"Grup Scolar Posta si Telecomunicatii N.V.Karpen str.Mioritei nr.76",1281,687,676,10,1,674,13,1400,713,358,316,1,1847,0
4,"Bacau",20297,47,20297,,"MUNICIPIUL BACAU",34,"Grup Scolar Posta si Telecomunicatii N.V.Karpen str.Mioritei nr.76",1257,574,561,13,0,570,4,1408,834,284,286,1,1847,0
4,"Bacau",20297,47,20297,,"MUNICIPIUL BACAU",35,"Grup Scolar Posta si Telecomunicatii N.V.Karpen str.Mioritei nr.76",1297,589,579,10,0,583,6,1801,1212,341,242,1,1847,0
4,"Bacau",20297,47,20297,,"MUNICIPIUL BACAU",36,"Grup Scolar Posta si Telecomunicatii N.V.Karpen str.Mioritei nr.76",1616,798,790,8,0,782,16,1800,1002,463,319,1,1847,0
4,"Bacau",20297,47,20297,,"MUNICIPIUL BACAU",37,"Scoala Dimitrie Leonida nr.6 str.Vasile Parvan nr.22",1299,1150,666,14,470,1120,30,1400,250,607,513,1,1847,0
4,"Bacau",20297,47,20297,,"MUNICIPIUL BACAU",38,"Scoala Dimitrie Leonida nr.6 str.Vasile Parvan nr.22",1172,645,631,14,0,636,9,1300,655,305,331,1,1847,0
4,"Bacau",20297,47,20297,,"MUNICIPIUL BACAU",39,"Grup Scolar Mihai Eminescu str.M.Eminescu nr.35 ",1228,693,679,14,0,687,6,1400,707,336,351,1,1847,0
4,"Bacau",20297,47,20297,,"MUNICIPIUL BACAU",40,"Grup Scolar Mihai Eminescu str.M.Eminescu nr.35 ",1318,641,629,12,0,629,12,1500,859,327,302,1,1847,0
4,"Bacau",20297,47,20297,,"MUNICIPIUL BACAU",41,"Scoala Alexandru cel Bun str.I.S.Sturdza nr.80",1443,895,871,22,2,883,12,1600,705,454,429,1,1847,0
4,"Bacau",20297,47,20297,,"MUNICIPIUL BACAU",42,"Gradinita cu program prelungit nr.12 str.9 Mai nr.11 ",1184,672,661,11,0,662,10,1300,628,284,378,1,1847,0
4,"Bacau",20297,47,20297,,"MUNICIPIUL BACAU",43,"Colegiul National Vasile Alecsandri str.Vasile Alecsandri nr.37",1923,1165,1149,16,0,1148,17,2104,939,564,584,1,1847,0
4,"Bacau",20297,47,20297,,"MUNICIPIUL BACAU",44,"Scoala de Arte George Apostu str.Razboieni nr.24",985,645,627,12,6,635,10,1100,455,297,338,1,1847,0
4,"Bacau",20297,47,20297,,"MUNICIPIUL BACAU",45,"Colegiul Pedagogic Stefan cel Mare str.Spiru Haret nr.6",1545,796,786,10,0,780,16,1700,904,432,348,1,1847,0
4,"Bacau",20297,47,20297,,"MUNICIPIUL BACAU",46,"Colegiul Pedagogic Stefan cel Mare str.Spiru Haret nr.6",1638,823,774,14,35,816,7,1800,977,443,373,1,1847,0
4,"Bacau",20297,47,20297,,"MUNICIPIUL BACAU",47,"Scoala George Bacovia str.Carpati nr.12A",1413,713,692,20,1,707,6,1600,887,399,308,1,1847,0
4,"Bacau",20297,47,20297,,"MUNICIPIUL BACAU",48,"Scoala George Bacovia str.Carpati nr.12A",1443,720,710,9,1,706,14,1600,880,363,343,1,1847,0
4,"Bacau",20297,47,20297,,"MUNICIPIUL BACAU",49,"Gradinita cu program prelungit nr.28 str.Carpati nr.8 ",1210,698,687,9,2,688,10,1302,604,389,299,1,1847,0
4,"Bacau",20297,47,20297,,"MUNICIPIUL BACAU",50,"Gradinita cu program prelungit nr.28 str.Carpati nr.8 ",1399,603,591,12,0,598,5,1500,897,323,275,1,1847,0
4,"Bacau",20297,47,20297,,"MUNICIPIUL BACAU",51,"Gradinita cu program prelungit nr.28 str.Carpati nr.8 ",1378,611,601,10,0,599,12,1501,890,342,257,1,1847,0
4,"Bacau",20297,47,20297,,"MUNICIPIUL BACAU",52,"Scoala Domnita Maria str.Bicaz nr.126",1365,756,739,17,0,749,7,1501,745,402,347,1,1847,0
4,"Bacau",20297,47,20297,,"MUNICIPIUL BACAU",53,"Scoala Domnita Maria str.Bicaz nr.126",1285,617,604,13,0,612,5,1420,803,354,258,1,1847,0
4,"Bacau",20297,47,20297,,"MUNICIPIUL BACAU",54,"Scoala Domnita Maria str.Bicaz nr.126",1549,769,753,16,0,763,6,1700,931,474,289,1,1847,0
4,"Bacau",20297,47,20297,,"MUNICIPIUL BACAU",55,"Scoala Domnita Maria str.Bicaz nr.126",1404,679,663,16,0,671,8,1503,824,335,336,1,1847,0
4,"Bacau",20297,47,20297,,"MUNICIPIUL BACAU",56,"Scoala Domnita Maria str.Bicaz nr.126",1145,612,592,20,0,599,13,1300,688,320,279,1,1847,0
4,"Bacau",20297,47,20297,,"MUNICIPIUL BACAU",57,"Scoala nr.15 str.Henri Coanda 1",1491,580,567,13,0,572,8,1601,1021,301,271,1,1847,0
4,"Bacau",20297,47,20297,,"MUNICIPIUL BACAU",58,"Scoala nr.15 str.Henri Coanda nr.1",1509,826,806,20,0,815,11,1701,875,438,377,1,1847,0
4,"Bacau",20297,47,20297,,"MUNICIPIUL BACAU",59,"Gradinita cu program prelungit nr.24 str.Aviatori nr.6",1639,851,839,11,1,840,11,1800,949,423,417,1,1847,0
4,"Bacau",20297,47,20297,,"MUNICIPIUL BACAU",60,"Grup Scolar Chimie Industriala str.Henri Coanda nr.7",1519,714,698,16,0,705,9,1700,986,389,316,1,1847,0
4,"Bacau",20297,47,20297,,"MUNICIPIUL BACAU",61,"Grup Scolar Chimie Industriala str.Henri Coanda nr.7",1582,727,720,7,0,713,14,1700,973,377,336,1,1847,0
4,"Bacau",20297,47,20297,,"MUNICIPIUL BACAU",62,"Grup Scolar Industrial Constructii de Masini Dumitru Mangeron str.Aeroportului nr.5",1045,455,429,26,0,451,4,1201,746,226,225,1,1847,0
4,"Bacau",20297,47,20297,,"MUNICIPIUL BACAU",63,"Grup Scolar Industrial Constructii de Masini Dumitru Mangeron str.Aeroportului nr.5",1297,600,589,11,0,595,5,1400,800,346,249,1,1847,0
4,"Bacau",20297,47,20297,,"MUNICIPIUL BACAU",64,"Scoala din cartierul Izvoare (fosta 17) str.Ciprian Porumbescu  nr.2",1818,826,811,14,1,817,9,2000,1174,453,364,1,1847,0
4,"Bacau",20297,47,20297,,"MUNICIPIUL BACAU",65,"Scoala nr.1 Octavian Voicu str.Bicaz nr.17",1215,502,493,9,0,496,6,1300,798,252,244,1,1847,0
4,"Bacau",20297,47,20297,,"MUNICIPIUL BACAU",66,"Scoala nr.1 Octavian Voicu str.Bicaz nr.17",1103,485,475,10,0,474,11,1200,715,260,214,1,1847,0
4,"Bacau",20297,47,20297,,"MUNICIPIUL BACAU",67,"Scoala nr.1 Octavian Voicu str.Bicaz nr.17",1372,609,601,8,0,602,7,1502,893,326,276,1,1847,0
4,"Bacau",20297,47,20297,,"MUNICIPIUL BACAU",68,"Scoala nr.1 Octavian Voicu str.Bicaz nr.17",1318,540,526,14,0,538,2,1500,960,324,214,1,1847,0
4,"Bacau",20297,47,20297,,"MUNICIPIUL BACAU",69,"Gradinita cu program prelungit nr.32 str.Bicaz nr.17",1386,615,604,11,0,608,7,1498,883,333,275,1,1847,0
4,"Bacau",20297,47,20297,,"MUNICIPIUL BACAU",70,"Gradinita cu program prelungit nr.32 str.Bicaz nr.17 ",1084,474,459,15,0,466,8,1199,725,265,201,1,1847,0
4,"Bacau",20297,47,20297,,"MUNICIPIUL BACAU",71,"Gradinita cu program prelungit nr.31 str.Bicaz nr.13 ",1176,569,556,13,0,555,14,1301,732,317,238,1,1847,0
4,"Bacau",20297,47,20297,,"MUNICIPIUL BACAU",72,"Scoala nr.21 Nicolae Iorga str.Bicaz nr.3",1414,610,595,15,0,600,10,1600,990,322,278,1,1847,0
4,"Bacau",20297,47,20297,,"MUNICIPIUL BACAU",73,"Scoala nr.21 Nicolae Iorga   str.Bicaz nr.3",1565,699,690,9,0,689,10,1700,1001,368,321,1,1847,0
4,"Bacau",20297,47,20297,,"MUNICIPIUL BACAU",74,"Scoala nr.21 Nicolae Iorga   str.Bicaz nr.3",1654,758,746,12,0,749,9,1800,1042,404,345,1,1847,0
4,"Bacau",20297,47,20297,,"MUNICIPIUL BACAU",75,"Scoala nr.21 Nicolae Iorga str.Bicaz nr.3 ",1274,587,573,14,0,578,9,1400,813,315,263,1,1847,0
4,"Bacau",20297,47,20297,,"MUNICIPIUL BACAU",76,"Grup Scolar Industrial Letea str.Letea nr.24",1724,853,835,17,1,843,10,1901,1048,442,401,1,1847,0
4,"Bacau",20297,47,20297,,"MUNICIPIUL BACAU",77,"Grup Scolar Industrial Letea str.Letea nr.24",1621,815,802,13,0,801,14,1800,985,414,387,1,1847,0
4,"Bacau",20297,47,20297,,"MUNICIPIUL BACAU",78,"Grup Scolar Industrial Letea str.Letea nr.24",1792,808,798,10,0,800,8,1900,1092,468,332,1,1847,0
4,"Bacau",20297,47,20297,,"MUNICIPIUL BACAU",79,"Scoala nr.10 str.Pictor Andreescu nr.1",1082,645,630,15,0,636,9,1200,555,290,346,1,1847,0
4,"Bacau",20297,47,20297,,"MUNICIPIUL BACAU",80,"Scoala nr.10 str.Pictor Andreescu nr.1",1408,795,781,14,0,778,17,1501,706,358,420,1,1847,0
4,"Bacau",20297,47,20297,,"MUNICIPIUL BACAU",81,"Scoala nr.10 str.Pictor Andreescu nr.1",1124,657,636,21,0,647,10,1200,543,325,322,1,1847,0
4,"Bacau",20297,47,20297,,"MUNICIPIUL BACAU",82,"Gradinita cu Program Prelungit nr.21 (Corpul I) str.Pictor Andreescu 5",2051,1157,1137,19,1,1144,12,2200,1043,532,612,1,1847,0
4,"Bacau",20297,47,20297,,"MUNICIPIUL BACAU",83,"Universitatea Bacau (Corpul A) Calea Marasesti nr.157 ",1069,604,596,8,0,590,14,1201,597,295,295,1,1847,0
4,"Bacau",20297,47,20297,,"MUNICIPIUL BACAU",84,"Gradinita cu program prelungit nr.30 str.Alecu Russo nr.23",1262,560,550,10,0,554,6,1400,840,313,241,1,1847,0
4,"Bacau",20297,47,20297,,"MUNICIPIUL BACAU",85,"Gradinita cu program prelungit nr.30 str.Alecu Russo nr.23 ",1098,554,544,10,0,539,15,1200,646,275,264,1,1847,0
4,"Bacau",20297,47,20297,,"MUNICIPIUL BACAU",86,"Scoala Ion Luca str.Alecu Russo 37",1048,471,463,8,0,467,4,1200,729,236,231,1,1847,0
4,"Bacau",20297,47,20297,,"MUNICIPIUL BACAU",87,"Scoala Ion Luca str.Alecu Russo 37",1252,583,574,9,0,574,9,1401,818,285,289,1,1847,0
4,"Bacau",20297,47,20297,,"MUNICIPIUL BACAU",88,"Scoala Ion Luca str.Alecu Russo 37",1488,708,697,11,0,699,9,1601,893,377,322,1,1847,0
4,"Bacau",20297,47,20297,,"MUNICIPIUL BACAU",89,"Scoala Ion Luca str.Alecu Russo 37",1465,649,640,9,0,641,8,1601,952,391,250,1,1847,0
4,"Bacau",20297,47,20297,,"MUNICIPIUL BACAU",90,"Gradinita cu program prelungit nr.27 str.Alecu Russo nr.59 ",1436,668,654,14,0,658,10,1600,932,343,315,1,1847,0
4,"Bacau",20297,47,20297,,"MUNICIPIUL BACAU",91,"Gradinita cu program prelungit nr.27 str.Alecu Russo nr.59",1106,608,487,121,0,600,8,1200,592,355,245,1,1847,0
4,"Bacau",20297,47,20297,,"MUNICIPIUL BACAU",92,"Scoala Alecu Russo str.Alecu Russo nr.5",1796,814,802,12,0,804,10,1900,1086,434,370,1,1847,0
4,"Bacau",20297,47,20297,,"MUNICIPIUL BACAU",93,"Scoala Alecu Russo str.Alecu Russo nr.5",1268,536,525,11,0,525,11,1401,865,301,224,1,1847,0
4,"Bacau",20297,47,20297,,"MUNICIPIUL BACAU",94,"Scoala Alecu Russo str.Alecu Russo nr.5",1603,626,615,11,0,616,10,1800,1174,341,275,1,1847,0
4,"Bacau",20297,47,20297,,"MUNICIPIUL BACAU",95,"Bazinul de inot acoperit Al.Ghioceilor 12",1351,600,586,14,0,587,13,1498,898,311,276,1,1847,0
4,"Bacau",20297,47,20297,,"MUNICIPIUL BACAU",96,"Bazinul de inot acoperit Al.Ghioceilor 12",1153,481,469,12,0,473,8,1296,815,252,221,1,1847,0
4,"Bacau",20297,47,20297,,"MUNICIPIUL BACAU",97,"Universitatea George Bacovia str.Pictor Th.Aman 96 Sala BS1, Corp B, parter ",1921,923,907,16,0,918,5,2100,1177,498,420,1,1847,0
4,"Bacau",20297,47,20297,,"MUNICIPIUL BACAU",98,"Caminul pentru Persoane Varstnice Aleea Ghioceilor nr.2 ",1540,855,842,13,0,848,7,1700,845,401,447,1,1847,0
4,"Bacau",20297,47,20297,,"MUNICIPIUL BACAU",99,"Scoala Miron Costin str.Miron Costin nr.64",1386,586,577,9,0,579,7,1500,914,331,248,1,1847,0
4,"Bacau",20297,47,20297,,"MUNICIPIUL BACAU",100,"Scoala Miron Costin str.Miron Costin nr.64",1534,733,720,13,0,723,10,1700,967,426,297,1,1847,0
4,"Bacau",20297,47,20297,,"MUNICIPIUL BACAU",101,"Scoala Miron Costin str.Miron Costin nr.64",1500,829,817,11,1,818,11,1701,872,385,433,1,1847,0
4,"Bacau",20297,47,20297,,"MUNICIPIUL BACAU",102,"Gradinita cu program prelungit nr.23 str.Mircea Eliade nr.6 ",1286,594,581,13,0,584,10,1400,806,317,267,1,1847,0
4,"Bacau",20297,47,20297,,"MUNICIPIUL BACAU",103,"Gradinita cu program prelungit nr.23 str.Mircea Eliade nr.6 ",1354,653,644,9,0,645,8,1501,848,336,309,1,1847,0
4,"Bacau",20297,47,20297,,"MUNICIPIUL BACAU",104,"Gradinita cu program prelungit nr.33 str.Alexandru cel Bun nr.10",1499,732,720,12,0,725,7,1601,869,373,352,1,1847,0
4,"Bacau",20297,47,20297,,"MUNICIPIUL BACAU",105,"Liceul cu program sportiv str.Alexandru cel Bun nr.43",1252,702,693,9,0,695,7,1428,726,337,358,1,1847,0
4,"Bacau",20297,47,20297,,"MUNICIPIUL BACAU",106,"Liceul cu program sportiv str.Alexandru cel Bun nr.43",1337,731,711,20,0,723,8,1500,769,396,327,1,1847,0
4,"Bacau",20297,47,20297,,"MUNICIPIUL BACAU",107,"Liceul cu program sportiv str.Alexandru cel Bun nr.43",1301,718,704,14,0,713,5,1400,682,359,354,1,1847,0
4,"Bacau",20297,47,20297,,"MUNICIPIUL BACAU",108,"Scoala nr.2 str.9 Mai nr.64 ",1687,866,851,14,1,856,10,1800,934,403,453,1,1847,0
4,"Bacau",20297,47,20297,,"MUNICIPIUL BACAU",109,"Scoala nr.2 str.9 Mai nr.64",1459,770,758,11,1,757,13,1600,830,378,379,1,1847,0
4,"Bacau",20297,47,20297,,"MUNICIPIUL BACAU",110,"Scoala nr.2 str.9 Mai nr.64",1548,915,898,15,2,906,9,1700,785,421,485,1,1847,0
4,"Bacau",20297,47,20297,,"MUNICIPIUL BACAU",111,"Colegiul Economic Ion Ghica str.9 Mai nr.104",1828,905,890,14,1,890,15,2000,1095,490,400,1,1847,0
4,"Bacau",20297,47,20297,,"MUNICIPIUL BACAU",112,"Scoala de Arte si Meserii str.Tecuciului nr.17",1425,696,681,15,0,689,7,1601,905,361,328,1,1847,0
4,"Bacau",20297,47,20297,,"MUNICIPIUL BACAU",113,"Scoala de Arte si Meserii str.Tecuciului nr.17",1208,570,549,21,0,562,8,1300,730,245,317,1,1847,0
4,"Bacau",20297,47,20297,,"MUNICIPIUL BACAU",114,"Scoala Nicu Enea Calea Romanului nr.144",1085,530,518,11,1,523,7,1200,670,284,239,1,1847,0
4,"Bacau",20297,47,20297,,"MUNICIPIUL BACAU",115,"Scoala Nicu Enea Calea Romanului nr.144",1027,518,509,9,0,508,10,1094,576,274,234,1,1847,0
4,"Bacau",20297,47,20297,,"MUNICIPIUL BACAU",116,"Scoala Nicu Enea Calea Romanului nr.144",1184,627,616,11,0,612,15,1197,570,370,242,1,1847,0
4,"Bacau",20297,47,20297,,"MUNICIPIUL BACAU",117,"Grup scolar Mihai Eminescu str.Mihai Eminescu nr.35 ",0,1928,0,1928,0,1908,20,9600,7672,1176,732,1,1847,1
4,"Bacau",20876,47,20876,,"MUNICIPIUL MOINESTI",118,"Liceul Spiru Haret str.Vasile Alecsandri nr.10",1074,537,522,14,1,529,8,1204,667,220,309,1,1849,0
4,"Bacau",20876,47,20876,,"MUNICIPIUL MOINESTI",119,"Liceul Spiru Haret str.Vasile Alecsandri nr.10",1156,531,519,11,1,527,4,1299,768,260,267,1,1849,0
4,"Bacau",20876,47,20876,,"MUNICIPIUL MOINESTI",120,"Sala de sport a Liceului Spiru Haret str.Zorilor nr.18",1374,677,665,12,0,671,6,1499,822,302,369,1,1849,0
4,"Bacau",20876,47,20876,,"MUNICIPIUL MOINESTI",121,"Scoala Stefan Luchian str.Zorilor nr.20 (intrarea principala)",1318,648,640,8,0,641,7,1500,852,295,346,1,1849,0
4,"Bacau",20876,47,20876,,"MUNICIPIUL MOINESTI",122,"Scoala Stefan Luchian str.Zorilor nr.20 (scoala veche)",349,190,184,6,0,189,1,400,210,92,97,1,1849,0
4,"Bacau",20876,47,20876,,"MUNICIPIUL MOINESTI",123,"Biblioteca municipala str.T.Vladimirescu nr.100",1356,694,670,22,2,689,5,1500,806,361,328,1,1849,0
4,"Bacau",20876,47,20876,,"MUNICIPIUL MOINESTI",124,"Scoala George Enescu str.Schelei nr.1 (scoala veche - intrarea principala)",1524,752,739,13,0,737,15,1700,948,359,378,1,1849,0
4,"Bacau",20876,47,20876,,"MUNICIPIUL MOINESTI",125,"Scoala George Enescu str.Schelei nr.1 (scoala veche - intrarea secundara) ",1357,630,600,30,0,624,6,1500,870,268,356,1,1849,0
4,"Bacau",20876,47,20876,,"MUNICIPIUL MOINESTI",126,"Scoala George Enescu str.Schelei nr.1 (scoala noua)   ",1334,674,650,24,0,666,8,1503,829,323,343,1,1849,0
4,"Bacau",20876,47,20876,,"MUNICIPIUL MOINESTI",127,"Scoala Nicu Ene str.Lucacesti",1413,741,718,23,0,729,12,1600,859,326,403,1,1849,0
4,"Bacau",20876,47,20876,,"MUNICIPIUL MOINESTI",128,"Scoala generala nr.4 str.Luminii nr.2",1262,630,612,18,0,621,9,1402,772,290,331,1,1849,0
4,"Bacau",20876,47,20876,,"MUNICIPIUL MOINESTI",129,"Scoala generala nr.4 str.Luminii nr.2",1359,665,651,14,0,654,11,1492,827,330,324,1,1849,0
4,"Bacau",20876,47,20876,,"MUNICIPIUL MOINESTI",130,"Scoala Tristan Tzara str.Mihai Eminescu nr.237",1032,510,501,9,0,502,8,1107,597,210,292,1,1849,0
4,"Bacau",20876,47,20876,,"MUNICIPIUL MOINESTI",131,"Gradinita nr.10 str.Micleasca",792,437,425,12,0,433,4,900,463,183,250,1,1849,0
4,"Bacau",20876,47,20876,,"MUNICIPIUL MOINESTI",132,"Scoala de Arte si Meserii str.Lunca nr.45",1060,507,492,15,0,498,9,1201,694,246,252,1,1849,0
4,"Bacau",20876,47,20876,,"MUNICIPIUL MOINESTI",133,"Scoala generala nr.6 str.1 Mai nr.2 (sala din dreapta)",657,389,381,8,0,379,10,706,317,160,219,1,1849,0
4,"Bacau",20876,47,20876,,"MUNICIPIUL MOINESTI",134,"Scoala generala nr.6 str.1 Mai nr.2 (sala din stanga)",1058,612,599,10,3,603,9,1205,593,255,348,1,1849,0
4,"Bacau",20876,47,20876,,"MUNICIPIUL MOINESTI",135,"Scoala generala nr.7 str.Avram Iancu nr.1",1149,643,636,7,0,625,18,1301,658,221,404,1,1849,0
4,"Bacau",20876,47,20876,,"MUNICIPIUL MOINESTI",136,"Primaria mun.Moinesti str.V.Alecsandri nr.14",0,260,0,260,0,256,4,1199,939,135,121,1,1849,1
4,"Bacau",20563,47,20563,,"MUNICIPIUL ONESTI",137,"Liceul Gr.C.Moisil str.Tineretului nr.14",1911,1031,1021,9,1,1017,14,2121,1090,372,645,1,1852,0
4,"Bacau",20563,47,20563,,"MUNICIPIUL ONESTI",138,"Liceul Gr.C.Moisil str.Tineretului nr.14",1828,935,924,11,0,914,21,2000,1065,325,589,1,1852,0
4,"Bacau",20563,47,20563,,"MUNICIPIUL ONESTI",139,"Scoala gen.cl.I-VIII nr.3 Sfantul Voievod Stefan cel Mare  (fosta nr.9) Bd.Oituz nr.7 bis ",1602,797,788,9,0,790,7,1800,1003,320,470,1,1852,0
4,"Bacau",20563,47,20563,,"MUNICIPIUL ONESTI",140,"Scoala gen.cl.I-VIII nr.3 Sfantul Voievod Stefan cel Mare (fosta nr.9) Bd.Oituz nr.7 bis ",1268,681,667,14,0,669,12,1401,720,271,398,1,1852,0
4,"Bacau",20563,47,20563,,"MUNICIPIUL ONESTI",141,"Scoala generala cl.I-VIII nr.4 Emil Racovita (fosta nr.10) str.Venus nr.2 ",1946,906,885,19,2,898,8,2100,1194,334,564,1,1852,0
4,"Bacau",20563,47,20563,,"MUNICIPIUL ONESTI",142,"Scoala generala cl.I-VIII nr.4 Emil Racovita (fosta nr.10) str.Venus nr.2 ",1952,865,856,9,0,852,13,2100,1235,372,480,1,1852,0
4,"Bacau",20563,47,20563,,"MUNICIPIUL ONESTI",143,"Scoala generala cl.I-VIII nr.7 str.Aurora nr.2",1976,756,745,11,0,746,10,2100,1344,364,382,1,1852,0
4,"Bacau",20563,47,20563,,"MUNICIPIUL ONESTI",144,"Scoala generala cl.I-VIII nr.7 str.Aurora nr.2",2012,840,832,8,0,830,10,2200,1360,354,476,1,1852,0
4,"Bacau",20563,47,20563,,"MUNICIPIUL ONESTI",145,"Casa de cultura str.Culturii nr.2",1913,860,850,10,0,849,11,2101,1241,341,508,1,1852,0
4,"Bacau",20563,47,20563,,"MUNICIPIUL ONESTI",146,"Casa de cultura str.Culturii nr.2",1863,944,935,9,0,929,15,1991,1047,376,553,1,1852,0
4,"Bacau",20563,47,20563,,"MUNICIPIUL ONESTI",147,"Scoala generala cl.I-VIII nr.5 Ghita Mocanu str.1 Mai nr.7",1721,939,928,11,0,927,12,1900,961,357,570,1,1852,0
4,"Bacau",20563,47,20563,,"MUNICIPIUL ONESTI",148,"Scoala generala cl.I-VIII nr.5 Ghita Mocanu str.1 Mai nr.7 ",1657,795,778,17,0,787,8,1800,1005,295,492,1,1852,0
4,"Bacau",20563,47,20563,,"MUNICIPIUL ONESTI",149,"Scoala generala cl.I-VIII nr.1 str.Casinului nr.15",1951,962,956,6,0,954,8,2100,1138,358,596,1,1852,0
4,"Bacau",20563,47,20563,,"MUNICIPIUL ONESTI",150,"Scoala generala cl.I-VIII nr.1 str.Casinului nr.15",2055,1010,995,15,0,1000,10,2200,1190,494,506,1,1852,0
4,"Bacau",20563,47,20563,,"MUNICIPIUL ONESTI",151,"Liceul Nadia Comaneci str.Perchiului nr.4",2001,984,974,10,0,970,14,2200,1216,418,552,1,1852,0
4,"Bacau",20563,47,20563,,"MUNICIPIUL ONESTI",152,"Liceul Nadia Comaneci str.Perchiului nr.4",2059,1086,1074,11,1,1079,7,2200,1114,418,661,1,1852,0
4,"Bacau",20563,47,20563,,"MUNICIPIUL ONESTI",153,"Liceul Dimitrie Cantemir str.Dr.Victor Babes nr.12",2020,909,893,16,0,901,8,2200,1291,417,484,1,1852,0
4,"Bacau",20563,47,20563,,"MUNICIPIUL ONESTI",154,"Liceul Dimitrie Cantemir str.Dr.Victor Babes nr.12",2057,975,961,12,2,961,14,2200,1225,507,454,1,1852,0
4,"Bacau",20563,47,20563,,"MUNICIPIUL ONESTI",155,"Colegiul Petru Poni Bd.Republicii nr.60",2050,851,837,14,0,845,6,2200,1349,378,467,1,1852,0
4,"Bacau",20563,47,20563,,"MUNICIPIUL ONESTI",156,"Scoala generala cl.I-VIII nr.2 George Calinescu (fosta nr.8) str.Armoniei nr.4",1947,905,895,9,1,897,8,2100,1195,388,509,1,1852,0
4,"Bacau",20563,47,20563,,"MUNICIPIUL ONESTI",157,"Scoala generala cl.I-VIII nr.2 George Calinescu (fosta nr.8) str.Armoniei nr.4",1934,917,907,10,0,900,17,2100,1183,424,476,1,1852,0
4,"Bacau",20563,47,20563,,"MUNICIPIUL ONESTI",158,"Grupul Scolar Gheorghe Asachi (fosta constructii) Bulevardul Republicii nr.45",1942,911,902,9,0,901,10,2100,1189,400,501,1,1852,0
4,"Bacau",20563,47,20563,,"MUNICIPIUL ONESTI",159,"Grup Scolar profesional auto (TCR) str.Avantului nr.5",918,460,452,8,0,453,7,1002,542,201,252,1,1852,0
4,"Bacau",20563,47,20563,,"MUNICIPIUL ONESTI",160,"Sera Borzesti",829,356,347,9,0,351,5,900,544,156,195,1,1852,0
4,"Bacau",20563,47,20563,,"MUNICIPIUL ONESTI",161,"Scoala Slobozia str.Victoriei nr.44",987,552,541,11,0,544,8,1098,546,221,323,1,1852,0
4,"Bacau",20563,47,20563,,"MUNICIPIUL ONESTI",162,"Gradinita Sfantul Paul str.Flacara nr.2",911,456,447,9,0,435,21,1000,544,162,273,1,1852,0
4,"Bacau",20563,47,20563,,"MUNICIPIUL ONESTI",163,"Gradinita Sfantul Paul str.Flacara nr.2",1596,798,787,11,0,786,12,1698,900,358,428,1,1852,0
4,"Bacau",20563,47,20563,,"MUNICIPIUL ONESTI",164,"Muzeul de Istorie Onesti Bd.Republicii nr.45",0,575,0,575,0,572,3,2800,2225,325,247,1,1852,1
4,"Bacau",20778,47,20778,,"ORAS BUHUSI",165,"Primaria oras Buhusi str.Republicii nr.5",1405,671,663,8,0,666,5,1501,830,272,394,1,1856,0
4,"Bacau",20778,47,20778,,"ORAS BUHUSI",166,"Colegiul tehnic Ion Borcea str.Tineretului nr.3",1580,651,643,8,0,639,12,1701,1050,250,389,1,1856,0
4,"Bacau",20778,47,20778,,"ORAS BUHUSI",167,"Colegiul Tehnic Ion Borcea str.Tineretului nr.3",1073,422,413,9,0,416,6,1201,779,208,208,1,1856,0
4,"Bacau",20778,47,20778,,"ORAS BUHUSI",168,"Casa de Cultura str.N.Balcescu nr.2",1278,493,486,7,0,489,4,1400,907,230,259,1,1856,0
4,"Bacau",20778,47,20778,,"ORAS BUHUSI",169,"Scoala generala cl.I-VIII M.Eminescu str.Tineretului nr.1 bis",1313,553,546,7,0,546,7,1378,825,203,343,1,1856,0
4,"Bacau",20778,47,20778,,"ORAS BUHUSI",170,"Directia de Gospodarie Comunala str.N.Balcescu nr.4",1393,636,632,4,0,625,11,1501,865,275,350,1,1856,0
4,"Bacau",20778,47,20778,,"ORAS BUHUSI",171,"Biblioteca oraseneasca George Bacovia str.Republicii blocul 18 parter",1230,552,542,10,0,546,6,1400,848,202,344,1,1856,0
4,"Bacau",20778,47,20778,,"ORAS BUHUSI",172,"Scoala generala cl.I-VIII nr.2 str.Florilor nr.7 ",1325,552,543,9,0,543,9,1500,948,226,317,1,1856,0
4,"Bacau",20778,47,20778,,"ORAS BUHUSI",173,"Complexul de Servicii Comunitare str.Republicii nr.70 ",1270,477,466,11,0,471,6,1405,928,191,280,1,1856,0
4,"Bacau",20778,47,20778,,"ORAS BUHUSI",174,"Scoala generala cl.I-VIII nr.5 str.Libertatii nr.225 ",1119,458,446,12,0,451,7,1200,742,213,238,1,1856,0
4,"Bacau",20778,47,20778,,"ORAS BUHUSI",175,"Scoala generala cl.I-VIII Mihail Andrei str.Libertatii nr.143",1366,535,522,13,0,517,18,1500,965,169,348,1,1856,0
4,"Bacau",20778,47,20778,,"ORAS BUHUSI",176,"Sala Polivalenta Moldova str.Libertatii nr.105",1585,689,677,12,0,680,9,1701,1012,311,369,1,1856,0
4,"Bacau",20778,47,20778,,"ORAS BUHUSI",177,"Sc.de Arte si Meserii str.Orbic nr.246",1691,647,639,8,0,629,18,1800,1153,233,396,1,1856,0
4,"Bacau",20778,47,20778,,"ORAS BUHUSI",178,"Scoala generala cl.I-VIII nr.5 str.Libertatii nr.225 ",0,153,0,153,0,149,4,1100,947,82,67,1,1856,1
4,"Bacau",20821,47,20821,,"ORAS COMANESTI",179,"Scoala nr.1 str.Republicii nr.86",1415,665,652,13,0,653,12,1600,935,236,417,1,1860,0
4,"Bacau",20821,47,20821,,"ORAS COMANESTI",180,"Scoala nr.1 str.Republicii nr.86",1335,774,688,12,74,751,23,1501,727,299,452,1,1860,0
4,"Bacau",20821,47,20821,,"ORAS COMANESTI",181,"Biblioteca orasului str.Republicii nr.21",1595,778,741,37,0,759,19,1700,922,341,418,1,1860,0
4,"Bacau",20821,47,20821,,"ORAS COMANESTI",182,"Clubul elevilor str.Garii nr.1",1060,567,555,12,0,559,8,1201,634,243,316,1,1860,0
4,"Bacau",20821,47,20821,,"ORAS COMANESTI",183,"Scoala nr.7 str.Sperantei nr.11",1736,765,739,26,0,752,13,1905,1140,328,424,1,1860,0
4,"Bacau",20821,47,20821,,"ORAS COMANESTI",184,"Scoala nr.7 str.Sperantei nr.11",997,427,413,14,0,418,9,1101,674,185,233,1,1860,0
4,"Bacau",20821,47,20821,,"ORAS COMANESTI",185,"Scoala nr.7 str.Sperantei nr.11",709,290,280,10,0,281,9,795,505,129,152,1,1860,0
4,"Bacau",20821,47,20821,,"ORAS COMANESTI",186,"Primaria oraseneasca str.Ciobanus nr.2",1562,674,661,13,0,666,8,1700,1026,259,407,1,1860,0
4,"Bacau",20821,47,20821,,"ORAS COMANESTI",187,"Scoala nr.4 Supan str.Soimului nr.35",1406,781,769,12,0,766,15,1504,723,269,497,1,1860,0
4,"Bacau",20821,47,20821,,"ORAS COMANESTI",188,"Scoala nr.5 Laloaia str.Cuza Voda nr.7",1255,696,688,8,0,689,7,1400,704,221,468,1,1860,0
4,"Bacau",20821,47,20821,,"ORAS COMANESTI",189,"Scoala nr.5 bis Sublaloaia str.Libertatii nr.98",1464,761,740,21,0,746,15,1600,839,291,455,1,1860,0
4,"Bacau",20821,47,20821,,"ORAS COMANESTI",190,"Scoala Petru Rares Laloaia str.Petru Rares",729,374,367,7,0,372,2,799,425,105,267,1,1860,0
4,"Bacau",20821,47,20821,,"ORAS COMANESTI",191,"Scoala nr.3 Leorda str.Progresului nr.43",1261,680,671,9,0,668,12,1400,720,223,445,1,1860,0
4,"Bacau",20821,47,20821,,"ORAS COMANESTI",192,"Scoala Dimitrie Ghica Zavoi str.Liceului nr.35",1408,722,714,8,0,715,7,1500,778,267,448,1,1860,0
4,"Bacau",20821,47,20821,,"ORAS COMANESTI",193,"Scoala nr.6 Vermesti str.Ciresoaia nr.68",1041,497,486,11,0,481,16,1065,568,187,294,1,1860,0
4,"Bacau",20821,47,20821,,"ORAS COMANESTI",194,"Scoala Sipoteni str.Moldovei nr.55",641,341,331,10,0,338,3,694,353,204,134,1,1860,0
4,"Bacau",20821,47,20821,,"ORAS COMANESTI",195,"Scoala Podei str.Podeiului nr.20",450,232,218,14,0,226,6,500,268,93,133,1,1860,0
4,"Bacau",20821,47,20821,,"ORAS COMANESTI",196,"Scoala nr.1 str.Republicii nr.86",0,238,0,238,0,238,0,1201,963,107,131,1,1860,1
4,"Bacau",22166,47,22166,,"ORAS DARMANESTI",197,"Grup Scolar Constructii de Masini str.Muncii nr.11",970,558,537,20,1,554,4,1100,542,247,307,1,1864,0
4,"Bacau",22166,47,22166,,"ORAS DARMANESTI",198,"Grup Scolar Constructii de Masini str.Muncii nr.11",568,337,299,35,3,333,4,600,263,118,215,1,1864,0
4,"Bacau",22166,47,22166,,"ORAS DARMANESTI",199,"Scoala nr.2 str.Chimiei nr.62",1366,797,779,18,0,780,17,1500,703,344,436,1,1864,0
4,"Bacau",22166,47,22166,,"ORAS DARMANESTI",200,"Club S.C. BETACOM SRL str.Chimiei nr.148",1868,1058,1035,19,4,1044,14,2000,942,478,566,1,1864,0
4,"Bacau",22166,47,22166,,"ORAS DARMANESTI",201,"Scoala nr.3 str.Tineretului nr.1",811,464,444,18,2,451,13,881,417,219,232,1,1864,0
4,"Bacau",22166,47,22166,,"ORAS DARMANESTI",202,"Scoala nr.3 str.Tineretului nr.1",811,489,474,15,0,447,42,900,411,226,221,1,1864,0
4,"Bacau",22166,47,22166,,"ORAS DARMANESTI",203,"Scoala cu clasele I-VIII sat Lapos",845,554,539,4,11,547,7,900,346,170,377,1,1864,0
4,"Bacau",22166,47,22166,,"ORAS DARMANESTI",204,"Scoala cu clasele I-VIII sat Plopu",1264,653,643,10,0,638,15,1400,747,223,415,1,1864,0
4,"Bacau",22166,47,22166,,"ORAS DARMANESTI",205,"Gradinita Salatruc str.Uzinei nr.111",619,366,356,10,0,361,5,700,334,177,184,1,1864,0
4,"Bacau",22166,47,22166,,"ORAS DARMANESTI",206,"Scoala cu clasele I-IV Pagubeni str.Plopului nr.12 ",315,237,214,12,11,233,4,400,163,53,180,1,1864,0
4,"Bacau",22166,47,22166,,"ORAS DARMANESTI",207,"Punct de lucru Primarie str.Buciumului nr.1A",1267,684,668,16,0,672,12,1400,716,283,389,1,1864,0
4,"Bacau",22166,47,22166,,"ORAS DARMANESTI",208,"Scoala cu clasele I-IV Darmaneasca Calea Trotusului",645,384,376,8,0,375,9,700,316,153,222,1,1864,0
4,"Bacau",22166,47,22166,,"ORAS DARMANESTI",209,"Primaria Darmanesti str.Muncii nr.16",0,115,0,115,0,111,4,700,585,42,69,1,1864,1
4,"Bacau",20910,47,20910,,"ORAS SLANIC MOLDOVA",210,"Scoala cu cl.I-VIII nr.1 Slanic Moldova str.N.Balcescu nr.13",1576,857,849,4,4,854,3,1700,843,377,477,1,1871,0
4,"Bacau",20910,47,20910,,"ORAS SLANIC MOLDOVA",211,"Scoala cu cl.I-VIII nr.3 Slanic Moldova (localitatea componenta Cerdac) str.Libertatii nr.21",1049,626,605,10,11,619,7,1100,474,298,321,1,1871,0
4,"Bacau",20910,47,20910,,"ORAS SLANIC MOLDOVA",212,"Scoala nr.2 Slanic-Moldova (localitatea componenta Ciresoaia) str.Lalelelor nr.100  ",1555,909,892,3,14,904,5,1697,788,340,564,1,1871,0
4,"Bacau",20910,47,20910,,"ORAS SLANIC MOLDOVA",213,"Fostul sediu al Primariei Slanic str.V.Alecsandri nr.2",0,270,0,270,0,269,1,400,130,114,155,1,1871,1
4,"Bacau",20965,47,20965,,"ORAS TARGU OCNA",214,"Scoala nr.1 str.Nicolae Arbanas nr.4",1389,770,736,18,16,762,8,1500,730,445,317,1,1875,0
4,"Bacau",20965,47,20965,,"ORAS TARGU OCNA",215,"Casa de Cultura str.Trandafirilor nr.1",1457,789,778,11,0,775,14,1600,811,407,368,1,1875,0
4,"Bacau",20965,47,20965,,"ORAS TARGU OCNA",216,"Colegiul National Costache Negri (sala de sport) str.C.Negri nr.43",1657,904,898,4,2,889,15,1800,896,471,418,1,1875,0
4,"Bacau",20965,47,20965,,"ORAS TARGU OCNA",217,"Scoala nr.2 str.Oituz nr.13",1675,808,791,17,0,792,16,1800,992,449,343,1,1875,0
4,"Bacau",20965,47,20965,,"ORAS TARGU OCNA",218,"Scoala nr.3 str.Costache Negri nr.123",1905,1002,991,10,1,992,10,2100,1098,533,459,1,1875,0
4,"Bacau",20965,47,20965,,"ORAS TARGU OCNA",219,"Scoala nr.4 str.Tisesti nr.67",1255,723,712,11,0,715,8,1400,677,363,352,1,1875,0
4,"Bacau",20965,47,20965,,"ORAS TARGU OCNA",220,"Scoala nr.5 str.Poieni nr.33",795,440,421,19,0,439,1,900,460,251,188,1,1875,0
4,"Bacau",20965,47,20965,,"ORAS TARGU OCNA",221,"Scoala nr.6 str.Vilcele nr.27",1015,579,572,7,0,573,6,1100,521,304,269,1,1875,0
4,"Bacau",20965,47,20965,,"ORAS TARGU OCNA",222,"Colegiul National C.Negri str.C.Negri nr.39",0,457,0,457,0,456,1,698,241,254,202,1,1875,1
4,"Bacau",21007,47,21007,,"AGAS",223,"Consiliul local Agas",1076,598,588,10,0,594,4,1200,602,277,317,3,1879,0
4,"Bacau",21007,47,21007,,"AGAS",224,"Scoala generala cl.I-IV satul Cotumba (scoala noua)",1064,610,596,14,0,600,10,1200,590,319,281,3,1879,0
4,"Bacau",21007,47,21007,,"AGAS",225,"Scoala generala satul Sulta ",883,486,475,11,0,483,3,1000,514,278,205,3,1879,0
4,"Bacau",21007,47,21007,,"AGAS",226,"Caminul Cultural satul Cosnea",416,262,253,9,0,260,2,500,238,140,120,3,1879,0
4,"Bacau",21007,47,21007,,"AGAS",227,"Scoala generala satul Preluci",962,499,493,6,0,492,7,1100,601,199,293,3,1879,0
4,"Bacau",21007,47,21007,,"AGAS",228,"Scoala generala satul Goioasa",721,360,349,11,0,355,5,800,440,151,204,3,1879,0
4,"Bacau",21007,47,21007,,"AGAS",229,"Scoala de arte si meserii com.Agas",0,118,0,118,0,117,1,300,182,56,61,3,1879,1
4,"Bacau",21098,47,21098,,"ARDEOANI",230,"Scoala nr.1 satul Ardeoani",1355,799,779,2,18,783,16,1300,501,385,398,3,1888,0
4,"Bacau",21098,47,21098,,"ARDEOANI",231,"Scoala satul Leontinesti",694,433,409,8,16,432,1,800,367,220,212,3,1888,0
4,"Bacau",21098,47,21098,,"ARDEOANI",232,"Caminul cultural nr.1 com.Ardeoani",0,202,0,202,0,202,0,299,97,135,67,3,1888,1
4,"Bacau",21123,47,21123,,"ASAU",233,"Scoala generala cl.I-VIII sala 1 satul Asau",936,495,488,7,0,485,10,1000,505,187,298,3,1891,0
4,"Bacau",21123,47,21123,,"ASAU",234,"Scoala generala cl.I-VIII sala 2 satul Asau",929,518,506,12,0,508,10,1000,482,216,292,3,1891,0
4,"Bacau",21123,47,21123,,"ASAU",235,"Scoala cu cl.I-IV satul Lunca Asau",637,391,381,10,0,379,12,700,309,142,237,3,1891,0
4,"Bacau",21123,47,21123,,"ASAU",236,"Scoala cu cl I-IV satul Straja",1052,485,476,9,0,475,10,1200,715,219,256,3,1891,0
4,"Bacau",21123,47,21123,,"ASAU",237,"Scoala cu cl. I-IV satul Ciobanus",464,242,236,6,0,241,1,507,265,99,142,3,1891,0
4,"Bacau",21123,47,21123,,"ASAU",238,"Scoala generala nr.1 cl.I-VIII sala 1 satul Apa-Asau ",651,340,334,6,0,339,1,700,360,160,179,3,1891,0
4,"Bacau",21123,47,21123,,"ASAU",239,"Scoala generala nr.1 cl.I-VIII sala 2 satul Apa-Asau ",642,333,326,7,0,332,1,700,367,144,188,3,1891,0
4,"Bacau",21123,47,21123,,"ASAU",240,"Scoala cu cl. I-IV satul Paltinis",528,293,288,5,0,286,7,598,305,129,157,3,1891,0
4,"Bacau",21123,47,21123,,"ASAU",241,"Primaria com.Asau satul Asau",0,75,0,75,0,70,5,300,225,31,39,3,1891,1
4,"Bacau",21196,47,21196,,"BALCANI",242,"Primaria comunei Balcani",1221,619,594,13,12,604,15,1300,681,190,414,3,1898,0
4,"Bacau",21196,47,21196,,"BALCANI",243,"Gradinita nr.1 sala nr.1 satul Frumoasa",1579,710,687,9,14,692,18,1700,990,248,444,3,1898,0
4,"Bacau",21196,47,21196,,"BALCANI",244,"Gradinita nr.1 sala nr.2 satul Frumoasa",1260,595,587,4,4,578,17,1400,805,165,413,3,1898,0
4,"Bacau",21196,47,21196,,"BALCANI",245,"Scoala clasele I-VIII satul Schitu-Frumoasa",1020,545,521,11,13,535,10,1100,555,143,392,3,1898,0
4,"Bacau",21196,47,21196,,"BALCANI",246,"Scoala clasele I-IV satul Schitu-Frumoasa",574,353,322,19,12,348,5,600,247,79,269,3,1898,0
4,"Bacau",21196,47,21196,,"BALCANI",247,"Scoala clasele I-VIII satul Ludasi",792,415,389,12,14,402,13,900,485,63,339,3,1898,0
4,"Bacau",21196,47,21196,,"BALCANI",248,"Primaria com.Balcani (cladirea anexa 2) satul Balcani",0,79,0,79,0,77,2,400,321,19,58,3,1898,1
4,"Bacau",21249,47,21249,,"BERESTI-BISTRITA",249,"Caminul cultural satul Beresti-Bistrita",894,460,445,13,2,456,4,903,443,165,291,3,1908,0
4,"Bacau",21249,47,21249,,"BERESTI-BISTRITA",250,"Scoala generala cl.I-IV satul Padureni",360,214,206,8,0,209,5,396,182,52,157,3,1908,0
4,"Bacau",21249,47,21249,,"BERESTI-BISTRITA",251,"Scoala generala cl.I-IV satul Climesti",245,161,150,10,1,161,0,300,139,35,126,3,1908,0
4,"Bacau",21249,47,21249,,"BERESTI-BISTRITA",252,"Scoala generala cl.I-IV satul Brad",138,90,84,6,0,89,1,201,111,24,65,3,1908,0
4,"Bacau",21249,47,21249,,"BERESTI-BISTRITA",253,"Consiliul local (sala de sedinte) com.Beresti-Bistrita",0,165,0,165,0,164,1,200,35,60,104,3,1908,1
4,"Bacau",21338,47,21338,,"BERESTI-TAZLAU",254,"Scoala  de Arte si Meserii satul Beresti-Tazlau",1040,516,510,6,0,506,10,1100,584,98,408,3,1913,0
4,"Bacau",21338,47,21338,,"BERESTI-TAZLAU",255,"Scoala generala satul Bosoteni",351,237,229,8,0,233,4,400,163,69,164,3,1913,0
4,"Bacau",21338,47,21338,,"BERESTI-TAZLAU",256,"Scoala Enachesti satul Enachesti",656,394,382,12,0,389,5,700,306,95,294,3,1913,0
4,"Bacau",21338,47,21338,,"BERESTI-TAZLAU",257,"Scoala generala satul Prisaca",422,223,213,10,0,223,0,500,277,83,140,3,1913,0
4,"Bacau",21338,47,21338,,"BERESTI-TAZLAU",258,"Scoala generala satul Romanesti",371,242,234,7,1,238,4,398,156,67,171,3,1913,0
4,"Bacau",21338,47,21338,,"BERESTI-TAZLAU",259,"Scoala generala satul Tescani",593,382,373,7,2,375,7,700,318,103,272,3,1913,0
4,"Bacau",21338,47,21338,,"BERESTI-TAZLAU",260,"Scoala Turluianu satul Turluianu",921,446,436,10,0,438,8,1000,554,107,331,3,1913,0
4,"Bacau",21338,47,21338,,"BERESTI-TAZLAU",261,"Primaria com.Beresti-Tazlau com.Beresti-Tazlau ",0,77,0,77,0,77,0,300,223,19,58,3,1913,1
4,"Bacau",21418,47,21418,,"BERZUNTI",262,"Scoala cu cl.I-VIII Alexandru cel Bun sala ""A"" satul Berzunti",1114,552,547,5,0,542,10,1200,648,177,365,3,1921,0
4,"Bacau",21418,47,21418,,"BERZUNTI",263,"Scoala cu cl.I-VIII Alexandru cel Bun sala ""B"" satul Berzunti",1121,589,588,1,0,578,11,1200,611,196,382,3,1921,0
4,"Bacau",21418,47,21418,,"BERZUNTI",264,"Scoala cu cl.I-IV nr.1 satul Dragomir",1562,664,657,7,0,650,14,1700,1036,182,468,3,1921,0
4,"Bacau",21418,47,21418,,"BERZUNTI",265,"Scoala cu cl.I-IV satul Buda",438,218,213,4,1,216,2,491,273,73,143,3,1921,0
4,"Bacau",21418,47,21418,,"BERZUNTI",266,"Primaria com.Berzunti (sala de sedinta a consiliului local) com.Berzunti ",0,73,0,73,0,73,0,300,227,26,47,3,1921,1
4,"Bacau",21454,47,21454,,"BARSANESTI",267,"Primaria com.Birsanesti (sala de sedinte a consiliului local)",1507,843,841,2,0,839,4,1700,857,279,560,3,1903,0
4,"Bacau",21454,47,21454,,"BARSANESTI",268,"Scoala generala cl.I-VIII satul Albele",544,289,281,8,0,286,3,601,312,73,213,3,1903,0
4,"Bacau",21454,47,21454,,"BARSANESTI",269,"Scoala generala cl.I-VIII satul Bratesti",982,640,636,4,0,630,10,1100,460,158,472,3,1903,0
4,"Bacau",21454,47,21454,,"BARSANESTI",270,"Gradinita satul Caraclau ",1023,641,633,8,0,639,2,1104,463,146,493,3,1903,0
4,"Bacau",21454,47,21454,,"BARSANESTI",271,"Primaria com.Birsanesti satul Birsanesti",0,94,0,94,0,92,2,200,106,24,68,3,1903,1
4,"Bacau",21506,47,21506,,"BLAGESTI",272,"Scoala cu cl.I-VIII nr.1 sala 1 satul Blagesti",965,393,388,5,0,386,7,1100,707,167,219,3,1925,0
4,"Bacau",21506,47,21506,,"BLAGESTI",273,"Scoala cu cl.I-VIII nr.1 sala 2 satul Blagesti",911,428,414,14,0,412,16,1000,572,167,245,3,1925,0
4,"Bacau",21506,47,21506,,"BLAGESTI",274,"Scoala cu cl.I-VIII nr.1 sala 1 satul Buda",860,380,374,6,0,368,12,898,518,173,195,3,1925,0
4,"Bacau",21506,47,21506,,"BLAGESTI",275,"Scoala cu cl.I-VIII nr.1 sala 2 satul Buda",791,335,330,5,0,327,8,900,565,154,173,3,1925,0
4,"Bacau",21506,47,21506,,"BLAGESTI",276,"Scoala cu cl.I-VIII nr.1 satul Valea lui Ion",1144,534,495,39,0,519,15,1300,766,201,318,3,1925,0
4,"Bacau",21506,47,21506,,"BLAGESTI",277,"Scoala cu cl.I-IV nr.1 satul Tirdenii Mari",594,292,278,14,0,285,7,700,408,109,176,3,1925,0
4,"Bacau",21506,47,21506,,"BLAGESTI",278,"Scoala cu cls.I-IV nr.1 satul Poiana Negustorului",398,264,254,10,0,224,40,401,137,66,158,3,1925,0
4,"Bacau",21506,47,21506,,"BLAGESTI",279,"Gradinita nr.1 satul Blagesti ",0,58,0,58,0,58,0,300,242,22,36,3,1925,1
4,"Bacau",21560,47,21560,,"BOGDANESTI",280,"Scoala generala sala cl.a VIII-a satul Bogdanesti",892,437,428,8,1,435,2,985,548,166,269,3,1931,0
4,"Bacau",21560,47,21560,,"BOGDANESTI",281,"Scoala generala sala cl.a IV-a satul Bogdanesti",887,484,477,7,0,480,4,1000,516,190,290,3,1931,0
4,"Bacau",21560,47,21560,,"BOGDANESTI",282,"Scoala generala sala cl.I-IV satul Filipesti",505,290,282,8,0,289,1,600,310,129,160,3,1931,0
4,"Bacau",21560,47,21560,,"BOGDANESTI",283,"Casa comunei (caminul cultural) satul Bogdanesti",0,63,0,63,0,63,0,100,37,31,32,3,1931,1
4,"Bacau",21597,47,21597,,"BRUSTUROASA",284,"Scoala de Arte si Meserii Ioana R.Rosetti sala 1 Brusturoasa",1367,771,762,4,5,766,5,1500,729,391,375,3,1934,0
4,"Bacau",21597,47,21597,,"BRUSTUROASA",285,"Scoala cl.I.-IV satul Camenca",799,550,542,6,2,544,6,899,349,343,201,3,1934,0
4,"Bacau",21597,47,21597,,"BRUSTUROASA",286,"Scoala cl.I-IV satul Cuchinis",602,381,367,5,9,375,6,700,319,183,192,3,1934,0
4,"Bacau",21597,47,21597,,"BRUSTUROASA",287,"SAM ""Ioana R.Rosetti"" satul Brusturoasa",0,68,0,68,0,68,0,200,132,41,27,3,1934,1
4,"Bacau",26338,47,26338,,"BUCIUMI",288,"Scoala generala cl.I-VIII sala 1 satul Buciumi",1222,715,705,10,0,711,4,1292,577,222,489,3,1941,0
4,"Bacau",26338,47,26338,,"BUCIUMI",289,"Scoala generala cl.I-VIII satul Racauti",1108,707,700,7,0,690,17,1198,491,153,537,3,1941,0
4,"Bacau",26338,47,26338,,"BUCIUMI",290,"Scoala cl.I-VIII com.Buciumi str.Principala ",0,82,0,82,0,82,0,100,18,29,53,3,1941,1
4,"Bacau",21668,47,21668,,"BUHOCI",291,"Scoala generala sala 1 satul Buhoci",1347,701,689,12,0,695,6,1500,799,317,378,3,1944,0
4,"Bacau",21668,47,21668,,"BUHOCI",292,"Scoala noua sala 1 satul Bijghir",1076,456,446,10,0,446,10,1207,751,242,204,3,1944,0
4,"Bacau",21668,47,21668,,"BUHOCI",293,"Scoala noua sala 2 satul Bijghir ",931,360,350,10,0,349,11,1001,641,180,169,3,1944,0
4,"Bacau",21668,47,21668,,"BUHOCI",294,"Scoala generala satul Coteni ",626,381,368,13,0,370,11,701,320,130,240,3,1944,0
4,"Bacau",21668,47,21668,,"BUHOCI",295,"Scoala generala cl.I-VIII com.Buhoci",0,122,0,122,0,120,2,200,78,54,66,3,1944,1
4,"Bacau",21720,47,21720,,"CASIN",296,"Scoala cl.I-VIII sala 1 sat Casin",1284,610,610,0,0,599,11,1399,789,293,306,3,1960,0
4,"Bacau",21720,47,21720,,"CASIN",297,"Scoala cl.I-VIII sala 2 satul Casin",1108,559,559,0,0,541,18,1198,639,286,255,3,1960,0
4,"Bacau",21720,47,21720,,"CASIN",298,"Gradinita de copii satul Curita ",659,405,391,14,0,394,11,700,295,217,177,3,1960,0
4,"Bacau",21720,47,21720,,"CASIN",299,"Caminul cultural satul Casin, str.Principala ",0,106,0,106,0,106,0,200,94,54,52,3,1960,1
4,"Bacau",21757,47,21757,,"CAIUTI",300,"Primaria Caiuti",1334,755,741,13,1,731,24,1500,745,254,477,3,1950,0
4,"Bacau",21757,47,21757,,"CAIUTI",301,"Scoala satul Popeni",652,398,394,4,0,394,4,700,302,180,214,3,1950,0
4,"Bacau",21757,47,21757,,"CAIUTI",302,"Scoala satul Blidari",642,344,336,8,0,340,4,700,356,121,219,3,1950,0
4,"Bacau",21757,47,21757,,"CAIUTI",303,"Scoala satul Pralea",686,466,459,7,0,463,3,799,333,126,337,3,1950,0
4,"Bacau",21757,47,21757,,"CAIUTI",304,"Scoala satul Boistea",146,102,91,11,0,100,2,201,99,26,74,3,1950,0
4,"Bacau",21757,47,21757,,"CAIUTI",305,"Scoala satul Heltiu",339,203,195,8,0,200,3,400,197,103,97,3,1950,0
4,"Bacau",21757,47,21757,,"CAIUTI",306,"Scoala satul Vrinceni",322,145,137,8,0,144,1,397,252,57,87,3,1950,0
4,"Bacau",21757,47,21757,,"CAIUTI",307,"Scoala satul Marcesti",101,60,49,11,0,59,1,101,41,12,47,3,1950,0
4,"Bacau",21757,47,21757,,"CAIUTI",308,"Scoala generala cl.I-VIII satul Caiuti nr.441",0,151,0,151,0,145,6,302,151,44,101,3,1950,1
4,"Bacau",21855,47,21855,,"CLEJA",309,"Scoala nr.1 sala 1 satul Cleja",1251,504,486,17,1,473,31,1400,896,279,194,3,1963,0
4,"Bacau",21855,47,21855,,"CLEJA",310,"Scoala nr.1 sala 2 satul Cleja",1260,544,529,15,0,530,14,1400,856,303,227,3,1963,0
4,"Bacau",21855,47,21855,,"CLEJA",311,"Scoala nr.2 satul Cleja (Buda)",1102,574,517,57,0,566,8,1200,626,318,248,3,1963,0
4,"Bacau",21855,47,21855,,"CLEJA",312,"Scoala satul Somusca",1248,631,595,36,0,603,28,1400,769,315,288,3,1963,0
4,"Bacau",21855,47,21855,,"CLEJA",313,"Scoala satul Valea Mica",540,262,252,10,0,253,9,601,339,112,141,3,1963,0
4,"Bacau",21855,47,21855,,"CLEJA",314,"Scoala nr.1 com.Cleja",0,69,0,69,0,69,0,301,232,33,36,3,1963,1
4,"Bacau",21891,47,21891,,"COLONESTI",315,"Scoala generala cl.I-VIII sala 1 satul Colonesti",1063,604,600,4,0,591,13,1200,596,211,380,3,1967,0
4,"Bacau",21891,47,21891,,"COLONESTI",316,"Scoala generala cl.I-VIII satul Spria",518,304,304,0,0,295,9,600,296,168,127,3,1967,0
4,"Bacau",21891,47,21891,,"COLONESTI",317,"Scoala cl.I-VIII satul Colonesti",0,99,0,99,0,99,0,102,3,45,54,3,1967,1
4,"Bacau",21971,47,21971,,"CORBASCA",318,"Camin cultural sala 1 satul Corbasca",627,279,271,8,0,278,1,700,421,146,132,3,1975,0
4,"Bacau",21971,47,21971,,"CORBASCA",319,"Scoala generala cl.I-VIII satul Scarisoara",670,314,306,8,0,305,9,700,386,147,158,3,1975,0
4,"Bacau",21971,47,21971,,"CORBASCA",320,"Scoala generala cl.I-IV satul Marvila",497,199,188,11,0,196,3,500,301,64,132,3,1975,0
4,"Bacau",21971,47,21971,,"CORBASCA",321,"Scoala generala cl.I-IV satul Vilcele",451,193,182,11,0,188,5,503,310,87,101,3,1975,0
4,"Bacau",21971,47,21971,,"CORBASCA",322,"Scoala generala cl.I-VIII satul Bacioiu",1419,433,421,12,0,412,21,1600,1167,198,214,3,1975,0
4,"Bacau",21971,47,21971,,"CORBASCA",323,"Scoala generala cl.I-IV satul Rogoaza",291,149,138,11,0,147,2,284,135,71,76,3,1975,0
4,"Bacau",21971,47,21971,,"CORBASCA",324,"Caminul cultural satul Corbasca",0,84,0,84,0,83,1,200,116,45,38,3,1975,1
4,"Bacau",22059,47,22059,,"COTOFANESTI",325,"Primaria comunei Cotofanesti sala 1",973,617,607,8,2,593,24,1000,383,160,433,3,1983,0
4,"Bacau",22059,47,22059,,"COTOFANESTI",326,"Scoala generala cl.I-VIII satul Borsani",597,405,398,2,5,396,9,700,295,147,249,3,1983,0
4,"Bacau",22059,47,22059,,"COTOFANESTI",327,"Scoala cu cl.I-IV satul Bilca",527,309,301,5,3,302,7,599,290,70,232,3,1983,0
4,"Bacau",22059,47,22059,,"COTOFANESTI",328,"Scoala generala cl.I-IV sat Tamasoaia",301,200,190,10,0,197,3,300,100,18,179,3,1983,0
4,"Bacau",22059,47,22059,,"COTOFANESTI",329,"Primaria Cotofanesti satul Cotofanesti",0,129,0,129,0,128,1,201,72,43,85,3,1983,1
4,"Bacau",22111,47,22111,,"DAMIENESTI",330,"Scoala generala sala 1 satul Damienesti",496,296,293,3,0,292,4,499,203,68,224,3,1989,0
4,"Bacau",22111,47,22111,,"DAMIENESTI",331,"Scoala generala satul Calugareni",836,473,468,5,0,468,5,900,427,161,307,3,1989,0
4,"Bacau",22111,47,22111,,"DAMIENESTI",332,"Scoala generala satul Dragesti",235,160,152,8,0,158,2,300,140,27,131,3,1989,0
4,"Bacau",22111,47,22111,,"DAMIENESTI",333,"Scoala generala com.Damienesti",0,67,0,67,0,65,2,100,33,21,44,3,1989,1
4,"Bacau",22237,47,22237,,"DEALU MORII",334,"Scoala cl.I-VIII satul Dealu Morii",971,580,558,8,14,567,13,1050,470,212,355,3,1994,0
4,"Bacau",22237,47,22237,,"DEALU MORII",335,"Scoala cu cl.I-IV satul Cauia",568,354,328,13,13,349,5,600,246,145,204,3,1994,0
4,"Bacau",22237,47,22237,,"DEALU MORII",336,"Scoala cu cl.I-VIII satul Negulesti",518,286,269,8,9,278,8,600,314,100,178,3,1994,0
4,"Bacau",22237,47,22237,,"DEALU MORII",337,"Scoala satul Tavadaresti",356,248,227,11,10,245,3,402,154,82,163,3,1994,0
4,"Bacau",22237,47,22237,,"DEALU MORII",338,"Gradinita Dealu Morii satul Dealu Morii",0,128,0,128,0,127,1,150,22,49,78,3,1994,1
4,"Bacau",22380,47,22380,,"DOFTEANA",339,"SAM Scarlat Longhin sala 1 satul Dofteana",1178,554,544,10,0,542,12,1300,746,339,203,3,2009,0
4,"Bacau",22380,47,22380,,"DOFTEANA",340,"SAM Scarlat Longhin sala 2 satul Dofteana",1122,522,518,4,0,512,10,1200,678,317,195,3,2009,0
4,"Bacau",22380,47,22380,,"DOFTEANA",341,"Scoala generala cl.I-VIII satul Haghiac ",1217,661,646,15,0,647,14,1300,639,430,217,3,2009,0
4,"Bacau",22380,47,22380,,"DOFTEANA",342,"Scoala generala cl.I-VIII satul Bogata ",699,410,397,13,0,403,7,800,390,159,244,3,2009,0
4,"Bacau",22380,47,22380,,"DOFTEANA",343,"Scoala generala cl.I-VIII sala 1 satul Cucuieti",858,491,483,8,0,485,6,900,409,262,223,3,2009,0
4,"Bacau",22380,47,22380,,"DOFTEANA",344,"Scoala generala cl.I-VIII sala .2 satul Cucuieti",1047,611,601,10,0,596,15,1200,589,327,269,3,2009,0
4,"Bacau",22380,47,22380,,"DOFTEANA",345,"Scoala generala cl.I-VIII satul Larga",1045,500,492,8,0,488,12,1200,700,303,185,3,2009,0
4,"Bacau",22380,47,22380,,"DOFTEANA",346,"Scoala generala cl.I-VIII satul Stefan Voda",921,498,488,10,0,481,17,1000,502,289,192,3,2009,0
4,"Bacau",22380,47,22380,,"DOFTEANA",347,"Scoala generala cl.I-VIII satul Seaca",495,258,246,12,0,255,3,500,242,180,75,3,2009,0
4,"Bacau",22380,47,22380,,"DOFTEANA",348,"SAM Scarlat Longhin com.Dofteana",0,96,0,96,0,96,0,500,404,52,44,3,2009,1
4,"Bacau",22460,47,22460,,"FARAOANI",349,"Scoala cu cl.I-VIII nr.1-sala 1 satul Faraoani",1276,559,553,6,0,553,6,1400,841,326,227,3,2017,0
4,"Bacau",22460,47,22460,,"FARAOANI",350,"Scoala cu cl.I-VIII nr.1-sala 2 satul Faraoani",1083,482,470,12,0,473,9,1197,715,250,223,3,2017,0
4,"Bacau",22460,47,22460,,"FARAOANI",351,"Scoala cu cl.I-VIII nr.2-sala 1 satul Faraoani",1071,485,474,11,0,474,11,1200,715,220,254,3,2017,0
4,"Bacau",22460,47,22460,,"FARAOANI",352,"Scoala cu cl.I-VIII nr.2-sala 2 satul Faraoani",919,413,401,12,0,403,10,1005,592,162,241,3,2017,0
4,"Bacau",22460,47,22460,,"FARAOANI",353,"Scoala cu cl.I-VIII nr.2 (sala de sport) com.Faraoani",0,79,0,79,0,78,1,298,219,47,31,3,2017,1
4,"Bacau",22488,47,22488,,"FILIPENI",354,"Primaria Filipeni sala 1",617,355,352,3,0,347,8,600,245,121,226,3,2019,0
4,"Bacau",22488,47,22488,,"FILIPENI",355,"Scoala cu cl.I-IV satul Marasti",615,345,332,13,0,339,6,700,355,142,197,3,2019,0
4,"Bacau",22488,47,22488,,"FILIPENI",356,"Scoala cu cl.I-IV satul Fruntesti",638,352,349,3,0,349,3,700,348,101,248,3,2019,0
4,"Bacau",22488,47,22488,,"FILIPENI",357,"Primaria Filipeni satul Filipeni",0,143,0,143,0,143,0,200,57,78,65,3,2019,1
4,"Bacau",22576,47,22576,,"FILIPESTI",358,"Scoala satul Filipesti",826,424,411,13,0,416,8,901,477,232,184,3,2028,0
4,"Bacau",22576,47,22576,,"FILIPESTI",359,"Scoala satul Galbeni",709,396,374,22,0,391,5,800,404,167,224,3,2028,0
4,"Bacau",22576,47,22576,,"FILIPESTI",360,"Gradinita satul Cirligi",929,524,511,13,0,515,9,1000,476,261,254,3,2028,0
4,"Bacau",22576,47,22576,,"FILIPESTI",361,"Scoala satul Oniscani",414,183,172,11,0,181,2,498,315,94,87,3,2028,0
4,"Bacau",22576,47,22576,,"FILIPESTI",362,"Scoala satul Boanta",265,155,140,15,0,153,2,300,145,71,82,3,2028,0
4,"Bacau",22576,47,22576,,"FILIPESTI",363,"Scoala satul Hirlesti",549,377,349,28,0,371,6,600,223,207,164,3,2028,0
4,"Bacau",22576,47,22576,,"FILIPESTI",364,"Gradinita Filipesti satul Filipesti",0,180,0,180,0,179,1,199,19,77,102,3,2028,1
4,"Bacau",22665,47,22665,,"GAICEANA",365,"Primaria Gaiceana sala 2",765,406,400,6,0,397,9,796,390,186,211,3,2037,0
4,"Bacau",22665,47,22665,,"GAICEANA",366,"Scoala satul Arini sala 2",1058,568,562,6,0,556,12,1200,632,141,415,3,2037,0
4,"Bacau",22665,47,22665,,"GAICEANA",367,"Scoala satul Hutu sala 2  ",531,368,360,8,0,355,13,600,232,142,213,3,2037,0
4,"Bacau",22665,47,22665,,"GAICEANA",368,"Primaria Gaiceana satul Gaiceana",0,59,0,59,0,59,0,100,41,25,34,3,2037,1
4,"Bacau",22718,47,22718,,"GHIMES-FAGET",369,"Sediul vechi al Primariei satul Faget",1083,544,538,6,0,536,8,1200,656,417,119,3,2047,0
4,"Bacau",22718,47,22718,,"GHIMES-FAGET",370,"Scoala generala cl.I-VIII satul Tarhausi",632,361,356,5,0,356,5,700,339,263,93,3,2047,0
4,"Bacau",22718,47,22718,,"GHIMES-FAGET",371,"Scoala generala cl.I-VIII satul Ghimes",870,446,440,6,0,438,8,1000,554,292,146,3,2047,0
4,"Bacau",22718,47,22718,,"GHIMES-FAGET",372,"Scoala generala cl.I-IV satul Fagetul de Sus",209,95,86,9,0,92,3,298,203,60,32,3,2047,0
4,"Bacau",22718,47,22718,,"GHIMES-FAGET",373,"Scoala generala cl.I-VIII satul Bolovanis",772,373,366,7,0,362,11,799,426,275,87,3,2047,0
4,"Bacau",22718,47,22718,,"GHIMES-FAGET",374,"Scoala cu cl.I-IV satul Rachitis",206,137,130,7,0,136,1,298,161,65,71,3,2047,0
4,"Bacau",22718,47,22718,,"GHIMES-FAGET",375,"Primaria Ghimes-Faget satul Faget",0,100,0,100,0,97,3,198,98,57,40,3,2047,1
4,"Bacau",26346,47,26346,,"GIOSENI",376,"Caminul cultural al Primariei satul Gioseni",1015,518,509,9,0,507,11,1100,582,277,230,3,2054,0
4,"Bacau",26346,47,26346,,"GIOSENI",377,"Scoala generala ""Ion Strat"" cl.nr.2 satul Gioseni ",976,445,439,5,1,437,8,1100,655,234,203,3,2054,0
4,"Bacau",26346,47,26346,,"GIOSENI",378,"Scoala generala ""Ion Strat"" cl.nr.3 satul Gioseni ",912,437,433,4,0,427,10,1000,563,218,209,3,2054,0
4,"Bacau",26346,47,26346,,"GIOSENI",379,"Scoala generala ""Ion Strat"" satul Gioseni",0,88,0,88,0,88,0,200,112,50,38,3,2054,1
4,"Bacau",22781,47,22781,,"GARLENI",380,"Scoala cu cl.I-VIII satul Girlenii de Sus",1262,597,585,12,0,593,4,1400,803,396,197,3,2042,0
4,"Bacau",22781,47,22781,,"GARLENI",381,"Scoala cu cl.I-VIII sala 1 satul Girleni",892,409,400,9,0,406,3,1000,591,233,173,3,2042,0
4,"Bacau",22781,47,22781,,"GARLENI",382,"Scoala cu cl.I-VIII sala 2 satul Girleni",848,392,382,10,0,389,3,900,508,189,200,3,2042,0
4,"Bacau",22781,47,22781,,"GARLENI",383,"Scoala cu cl.I-VIII sala 1 satul Lespezi",1044,459,453,6,0,455,4,1101,642,301,154,3,2042,0
4,"Bacau",22781,47,22781,,"GARLENI",384,"Scoala cu cl.I-VIII sala 2 satul Lespezi",1257,575,566,9,0,572,3,1400,825,354,218,3,2042,0
4,"Bacau",22781,47,22781,,"GARLENI",385,"Scoala generala cl.I-VIII satul Lespezi, str.D.N.15",0,105,0,105,0,104,1,301,196,42,62,3,2042,1
4,"Bacau",22834,47,22834,,"GLAVANESTI",386,"Caminul cultural satul Glavanesti",1628,836,815,21,0,814,22,1800,964,331,483,3,2056,0
4,"Bacau",22834,47,22834,,"GLAVANESTI",387,"Scoala cu cl.I-IV satul Frumuselu",1408,749,739,10,0,738,11,1500,751,240,498,3,2056,0
4,"Bacau",22834,47,22834,,"GLAVANESTI",388,"Consiliul local Glavanesti (sala de sedinta) satul Glavanesti",0,133,0,133,0,130,3,200,67,58,72,3,2056,1
4,"Bacau",20607,47,20607,,"GURA VAII",389,"Primaria Gura Vaii",1446,746,722,24,0,738,8,1600,854,410,328,3,2062,0
4,"Bacau",20607,47,20607,,"GURA VAII",390,"Gradinita Patrascani",306,223,189,34,0,217,6,400,177,125,92,3,2062,0
4,"Bacau",20607,47,20607,,"GURA VAII",391,"Institutie de cult (Casa Praznicala Biserica Ortodoxa Sfanta Treime) satul Motocesti",123,78,72,6,0,77,1,200,122,32,45,3,2062,0
4,"Bacau",20607,47,20607,,"GURA VAII",392,"Scoala satul Temelia",669,342,327,12,3,337,5,700,358,211,126,3,2062,0
4,"Bacau",20607,47,20607,,"GURA VAII",393,"Scoala satul Paltinata",411,269,260,9,0,265,4,500,231,200,65,3,2062,0
4,"Bacau",20607,47,20607,,"GURA VAII",394,"Scoala satul Dumbrava",1075,583,567,9,7,566,17,1200,617,282,284,3,2062,0
4,"Bacau",20607,47,20607,,"GURA VAII",395,"Scoala satul Capata",256,164,155,9,0,158,6,296,132,68,90,3,2062,0
4,"Bacau",20607,47,20607,,"GURA VAII",396,"Scoala generala cl.I-VIII satul Gura Vaii",0,107,0,107,0,106,1,300,193,50,56,3,2062,1
4,"Bacau",22898,47,22898,,"HELEGIU",397,"Scoala de Arte si Meserii satul Helegiu",956,426,409,17,0,423,3,1100,674,151,272,3,2069,0
4,"Bacau",22898,47,22898,,"HELEGIU",398,"Scoala generala nr.1 satul Bratila",973,447,435,12,0,435,12,1101,654,134,301,3,2069,0
4,"Bacau",22898,47,22898,,"HELEGIU",399,"Scoala generala nr.2 satul Bratila",630,335,296,39,0,329,6,700,365,79,250,3,2069,0
4,"Bacau",22898,47,22898,,"HELEGIU",400,"Scoala generala nr.1 satul Deleni",1504,558,551,7,0,539,19,1700,1142,138,401,3,2069,0
4,"Bacau",22898,47,22898,,"HELEGIU",401,"Scoala generala nr.1 satul Dragugesti",1334,536,508,26,2,522,14,1500,964,216,306,3,2069,0
4,"Bacau",22898,47,22898,,"HELEGIU",402,"Scoala generala nr.2 satul Dragugesti",343,154,143,11,0,149,5,400,246,61,88,3,2069,0
4,"Bacau",22898,47,22898,,"HELEGIU",403,"Primaria Helegiu com.Helegiu str.Principala nr.1 ",0,65,0,65,0,64,1,300,235,24,40,3,2069,1
4,"Bacau",20313,47,20313,,"HEMEIUS",404,"Caminul cultural satul Hemeius",1594,865,853,12,0,858,7,1800,935,437,421,3,2074,0
4,"Bacau",20313,47,20313,,"HEMEIUS",405,"Scoala generala Ion Simionescu satul Lilieci",1905,973,959,14,0,963,10,2100,1127,547,416,3,2074,0
4,"Bacau",20313,47,20313,,"HEMEIUS",406,"Scoala generala Grigore Tabacaru satul Hemeius str.Garii nr.94",0,178,0,178,0,178,0,200,22,98,80,3,2074,1
4,"Bacau",22941,47,22941,,"HORGESTI",407,"Caminul cultural Horgesti sala 1",1478,616,609,7,0,603,13,1600,984,287,316,3,2078,0
4,"Bacau",22941,47,22941,,"HORGESTI",408,"Scoala Sohodor",676,418,411,7,0,416,2,700,282,289,127,3,2078,0
4,"Bacau",22941,47,22941,,"HORGESTI",409,"Scoala Recea",632,348,338,10,0,344,4,700,352,173,171,3,2078,0
4,"Bacau",22941,47,22941,,"HORGESTI",410,"Scoala Racatau",828,453,446,7,0,441,12,900,447,190,251,3,2078,0
4,"Bacau",22941,47,22941,,"HORGESTI",411,"Caminul cultural satul Horgesti",0,73,0,73,0,72,1,200,127,43,29,3,2078,1
4,"Bacau",23047,47,23047,,"HURUIESTI",412,"Primaria Huruiesti",624,288,267,21,0,273,15,701,413,132,141,3,2087,0
4,"Bacau",23047,47,23047,,"HURUIESTI",413,"Scoala cl.I-IV satul Perchiu ",138,82,71,11,0,80,2,199,117,34,46,3,2087,0
4,"Bacau",23047,47,23047,,"HURUIESTI",414,"Scoala cl.I-IV satul Pradais ",270,149,140,9,0,146,3,301,152,50,96,3,2087,0
4,"Bacau",23047,47,23047,,"HURUIESTI",415,"Scoala cl.I-IV satul Capotesti ",231,114,102,12,0,110,4,300,186,26,84,3,2087,0
4,"Bacau",23047,47,23047,,"HURUIESTI",416,"Scoala cl.I-IV satul Ocheni ",327,193,186,7,0,180,13,401,208,45,135,3,2087,0
4,"Bacau",23047,47,23047,,"HURUIESTI",417,"Scoala cl.I-V satul Floresti ",168,99,89,10,0,96,3,201,102,33,63,3,2087,0
4,"Bacau",23047,47,23047,,"HURUIESTI",418,"Scoala cl.I-V satul Fundoaia ",375,225,214,11,0,213,12,401,176,56,157,3,2087,0
4,"Bacau",23047,47,23047,,"HURUIESTI",419,"Consiliul local Huruiesti satul Huruiesti",0,100,0,100,0,96,4,100,0,61,35,3,2087,1
4,"Bacau",26379,47,26379,,"ITESTI",420,"Scoala generala Itesti Corp B",674,435,409,11,15,431,4,646,211,104,327,3,2095,0
4,"Bacau",26379,47,26379,,"ITESTI",421,"Scoala generala Dumbrava",301,194,188,6,0,190,4,300,106,89,101,3,2095,0
4,"Bacau",26379,47,26379,,"ITESTI",422,"Scoala generala Ciumasi",151,84,71,12,1,83,1,201,117,35,48,3,2095,0
4,"Bacau",26379,47,26379,,"ITESTI",423,"Scoala cl.I-VIII satul Itesti",0,128,0,128,0,126,2,148,20,49,77,3,2095,1
4,"Bacau",23127,47,23127,,"IZVORU BERHECIULUI",424,"Scoala cl.I-VIII satul Izvoru Berheciului (sala claselor simultane II-IV din satul Izv.Berheciului ) ",668,342,340,2,0,331,11,703,361,157,174,3,2100,0
4,"Bacau",23127,47,23127,,"IZVORU BERHECIULUI",425,"Scoala generala satul Antohesti",318,189,182,7,0,185,4,400,211,69,116,3,2100,0
4,"Bacau",23127,47,23127,,"IZVORU BERHECIULUI",426,"Scoala generala satul Obirsia",329,183,177,6,0,183,0,400,217,62,121,3,2100,0
4,"Bacau",23127,47,23127,,"IZVORU BERHECIULUI",427,"Scoala cl.I-VIII (sala cl.simultane I-III) satul Izv.Berheciului str.Principala nr.122",0,77,0,77,0,77,0,98,21,38,39,3,2100,1
4,"Bacau",20359,47,20359,,"LETEA VECHE",428,"Scoala generala sala 1 Letea Veche",1115,567,559,8,0,560,7,1200,633,303,257,3,2108,0
4,"Bacau",20359,47,20359,,"LETEA VECHE",429,"Caminul cultural Letea Veche",1329,751,728,23,0,741,10,1500,749,410,331,3,2108,0
4,"Bacau",20359,47,20359,,"LETEA VECHE",430,"Scoala  satul Holt",1304,733,722,11,0,725,8,1400,667,459,266,3,2108,0
4,"Bacau",20359,47,20359,,"LETEA VECHE",431,"Scoala satul Radomiresti",268,155,146,9,0,153,2,300,145,73,80,3,2108,0
4,"Bacau",20359,47,20359,,"LETEA VECHE",432,"Scoala satul Rusi-Ciutea",790,457,443,14,0,448,9,900,443,235,213,3,2108,0
4,"Bacau",20359,47,20359,,"LETEA VECHE",433,"Scoala generala com.Letea Veche str.Al.I.Cuza nr.216",0,138,0,138,0,136,2,300,162,86,50,3,2108,1
4,"Bacau",23207,47,23207,,"LIPOVA",434,"S.A.M. M.Eminescu satul Lipova",563,337,332,5,0,325,12,599,262,71,254,3,2114,0
4,"Bacau",23207,47,23207,,"LIPOVA",435,"Scoala cl.I-IV Acad.Gh.Vranceanu sala 1 satul Valea Hogei",231,141,134,7,0,137,4,267,126,45,92,3,2114,0
4,"Bacau",23207,47,23207,,"LIPOVA",436,"Scoala cl.I-VIII satul Satu Nou",379,263,253,10,0,253,10,400,137,39,214,3,2114,0
4,"Bacau",23207,47,23207,,"LIPOVA",437,"Scoala cl.I-IV satul Valea Caselor",338,231,218,13,0,223,8,400,169,73,150,3,2114,0
4,"Bacau",23207,47,23207,,"LIPOVA",438,"Scoala cl.I-VIII satul Milosu",667,383,377,6,0,365,18,699,316,52,313,3,2114,0
4,"Bacau",23207,47,23207,,"LIPOVA",439,"Scoala cl.I-IV Acad.Gh.Vranceanu satul Valea Hogei",0,130,0,130,0,124,6,135,5,31,93,3,2114,1
4,"Bacau",23289,47,23289,,"LIVEZI",440,"Scoala nr.1 satul Livezi",767,352,347,5,0,349,3,802,450,160,189,3,2122,0
4,"Bacau",23289,47,23289,,"LIVEZI",441,"Scoala generala satul Orasa ",767,433,426,7,0,424,9,807,374,154,270,3,2122,0
4,"Bacau",23289,47,23289,,"LIVEZI",442,"Scoala generala satul Prajoaia ",752,389,381,8,0,379,10,800,411,138,241,3,2122,0
4,"Bacau",23289,47,23289,,"LIVEZI",443,"Scoala generala satul Scariga ",430,272,262,10,0,270,2,490,218,125,145,3,2122,0
4,"Bacau",23289,47,23289,,"LIVEZI",444,"Scoala generala satul Poiana ",722,375,365,10,0,371,4,800,425,195,176,3,2122,0
4,"Bacau",23289,47,23289,,"LIVEZI",445,"Scoala generala nr.1 sat Balaneasa",840,423,414,9,0,416,7,899,476,149,267,3,2122,0
4,"Bacau",23289,47,23289,,"LIVEZI",446,"Biblioteca com.Livezi (sala de lectura) satul Livezi nr.307",0,84,0,84,0,83,1,300,216,39,44,3,2122,1
4,"Bacau",23350,47,23350,,"LUIZI-CALUGARA",447,"Caminul cultural satul Luizi Calugara",1349,572,562,10,0,547,25,1500,928,312,235,3,2129,0
4,"Bacau",23350,47,23350,,"LUIZI-CALUGARA",448,"Scoala de Arte si Meserii satul Luizi Calugara",1366,520,514,6,0,503,17,1500,980,321,182,3,2129,0
4,"Bacau",23350,47,23350,,"LUIZI-CALUGARA",449,"Scoala Andrei Lupu sala 1 satul Osebiti ",763,303,296,7,0,286,17,801,498,185,101,3,2129,0
4,"Bacau",23350,47,23350,,"LUIZI-CALUGARA",450,"Scoala Andrei Lupu sala 2 satul Osebiti",735,305,293,12,0,294,11,799,494,188,106,3,2129,0
4,"Bacau",23350,47,23350,,"LUIZI-CALUGARA",451,"Scoala cl.I-VIII Andrei Lupu satul Osebiti ",0,136,0,136,0,135,1,300,164,66,69,3,2129,1
4,"Bacau",23387,47,23387,,"MAGIRESTI",452,"Scoala generala satul Valea Arinilor",1449,767,751,16,0,762,5,1600,833,312,450,3,2132,0
4,"Bacau",23387,47,23387,,"MAGIRESTI",453,"Scoala generala cl.I-IV satul Stanesti",537,332,311,21,0,324,8,612,280,82,242,3,2132,0
4,"Bacau",23387,47,23387,,"MAGIRESTI",454,"Scoala Magiresti (scoala noua)",1497,725,705,20,0,711,14,1601,876,307,404,3,2132,0
4,"Bacau",23387,47,23387,,"MAGIRESTI",455,"Scoala generala cl.V-VIII satul Magiresti str.Principala ",0,36,0,36,0,36,0,201,165,18,18,3,2132,1
4,"Bacau",20411,47,20411,,"MAGURA",456,"Scoala nr.2 sala 1 satul Magura",1292,661,653,8,0,656,5,1400,739,375,281,3,2138,0
4,"Bacau",20411,47,20411,,"MAGURA",457,"Scoala generala nr.1 Emil Braiescu satul Magura",1392,641,631,10,0,638,3,1500,859,405,233,3,2138,0
4,"Bacau",20411,47,20411,,"MAGURA",458,"Scoala generala satul Crihan ",846,424,413,11,0,418,6,900,476,290,128,3,2138,0
4,"Bacau",20411,47,20411,,"MAGURA",459,"Scoala nr.2 satul Magura ",0,139,0,139,0,138,1,200,61,64,74,3,2138,1
4,"Bacau",23449,47,23449,,"MANASTIREA CASIN",460,"Caminul cultural sala 1 satul Manastirea Casin",1844,750,714,32,4,743,7,2000,1250,293,450,3,2143,0
4,"Bacau",23449,47,23449,,"MANASTIREA CASIN",461,"Caminul cultural sala 2 satul Manastirea Casin",554,261,233,28,0,258,3,600,339,101,157,3,2143,0
4,"Bacau",23449,47,23449,,"MANASTIREA CASIN",462,"Scoala generala nr.2 satul Manastirea Casin",1498,679,607,71,1,664,15,1600,921,270,394,3,2143,0
4,"Bacau",23449,47,23449,,"MANASTIREA CASIN",463,"Scoala satul Lupesti",653,326,294,28,4,316,10,705,379,128,188,3,2143,0
4,"Bacau",23449,47,23449,,"MANASTIREA CASIN",464,"Primaria Manastirea Casin (sala de sedinte) satul Manastirea Casin str.Principala nr.1027",0,87,0,87,0,86,1,300,213,50,36,3,2143,1
4,"Bacau",20466,47,20466,,"MARGINENI",465,"Scoala Margineni sala 1",1639,740,714,26,0,728,12,1800,1060,455,273,3,2148,0
4,"Bacau",20466,47,20466,,"MARGINENI",466,"Scoala Margineni sala 2",1400,624,607,17,0,611,13,1500,876,364,247,3,2148,0
4,"Bacau",20466,47,20466,,"MARGINENI",467,"Scoala Barati",1425,712,698,14,0,702,10,1600,888,321,381,3,2148,0
4,"Bacau",20466,47,20466,,"MARGINENI",468,"Scoala Trebes",1309,639,616,23,0,625,14,1397,758,336,289,3,2148,0
4,"Bacau",20466,47,20466,,"MARGINENI",469,"Scoala Luncani",1238,679,658,21,0,665,14,1379,700,310,355,3,2148,0
4,"Bacau",20466,47,20466,,"MARGINENI",470,"Primaria Margineni satul Margineni nr.568",0,195,0,195,0,194,1,406,211,97,97,3,2148,1
4,"Bacau",23494,47,23494,,"MOTOSENI",471,"Primaria Motoseni",895,446,438,8,0,429,17,1000,554,164,265,3,2157,0
4,"Bacau",23494,47,23494,,"MOTOSENI",472,"Scoala generala satul Tepoaia",534,320,309,11,0,313,7,576,256,170,143,3,2157,0
4,"Bacau",23494,47,23494,,"MOTOSENI",473,"Scoala generala satul Cociu",299,145,137,8,0,140,5,301,156,49,91,3,2157,0
4,"Bacau",23494,47,23494,,"MOTOSENI",474,"Scoala cl.I-IV satul Poiana",363,218,207,11,0,208,10,400,182,58,150,3,2157,0
4,"Bacau",23494,47,23494,,"MOTOSENI",475,"Scoala generala satul Fantanele",589,365,331,34,0,360,5,600,235,114,246,3,2157,0
4,"Bacau",23494,47,23494,,"MOTOSENI",476,"Scoala generala satul Sendresti",349,222,210,12,0,217,5,400,178,99,118,3,2157,0
4,"Bacau",23494,47,23494,,"MOTOSENI",477,"Scoala generala cl.I-VIII satul Motoseni",0,170,0,170,0,169,1,200,30,72,97,3,2157,1
4,"Bacau",23644,47,23644,,"NEGRI",478,"Scoala Costache Negri satul Negri",1154,611,605,6,0,602,9,1270,659,224,378,3,2172,0
4,"Bacau",23644,47,23644,,"NEGRI",479,"Scoala Ion Ionescu de la Brad satul Poiana",1275,588,586,2,0,575,13,1400,812,244,331,3,2172,0
4,"Bacau",23644,47,23644,,"NEGRI",480,"Primaria Negri satul Negri ",0,114,0,114,0,113,1,131,17,40,73,3,2172,1
4,"Bacau",23715,47,23715,,"NICOLAE BALCESCU",481,"Scoala Nicolae Balcescu sala 1",1588,702,679,23,0,697,5,1700,998,432,265,3,2179,0
4,"Bacau",23715,47,23715,,"NICOLAE BALCESCU",482,"Scoala Nicolae Balcescu sala 2",1657,779,748,31,0,766,13,1800,1021,433,333,3,2179,0
4,"Bacau",23715,47,23715,,"NICOLAE BALCESCU",483,"Scoala Nicolae Balcescu sala 3",551,252,243,9,0,243,9,600,348,139,104,3,2179,0
4,"Bacau",23715,47,23715,,"NICOLAE BALCESCU",484,"Scoala satul Galbeni",1102,563,542,19,2,550,13,1200,637,357,193,3,2179,0
4,"Bacau",23715,47,23715,,"NICOLAE BALCESCU",485,"Gradinita nr.1 satul Valea-Seaca",1961,882,822,56,4,860,22,2100,1218,538,322,3,2179,0
4,"Bacau",23715,47,23715,,"NICOLAE BALCESCU",486,"Scoala nr.2 satul Valea-Seaca",384,248,171,77,0,240,8,400,152,176,64,3,2179,0
4,"Bacau",23715,47,23715,,"NICOLAE BALCESCU",487,"Scoala satul Larguta",182,133,109,24,0,129,3,200,67,53,76,3,2179,0
4,"Bacau",23715,47,23715,,"NICOLAE BALCESCU",488,"Scoala generala com.Nicolae Balcescu str.Ferdinand nr.128A",0,141,0,141,0,137,4,400,259,48,89,3,2179,1
4,"Bacau",26353,47,26353,,"ODOBESTI",489,"Scoala cu cl.I-IV Odobesti",368,264,257,7,0,263,1,400,136,146,117,3,2185,0
4,"Bacau",26353,47,26353,,"ODOBESTI",490,"Scoala cu cl.I-VIII Tisa Silvestri",813,533,525,8,0,524,9,900,367,235,289,3,2185,0
4,"Bacau",26353,47,26353,,"ODOBESTI",491,"Scoala cu cl.I-VIII Ciuturesti",612,386,385,1,0,375,11,700,314,178,197,3,2185,0
4,"Bacau",26353,47,26353,,"ODOBESTI",492,"Caminul cultural satul Odobesti",0,168,0,168,0,160,8,200,32,94,66,3,2185,1
4,"Bacau",23797,47,23797,,"OITUZ",493,"Scoala generala nr.2 Oituz sala 1",680,221,205,16,0,217,4,700,479,97,120,3,2190,0
4,"Bacau",23797,47,23797,,"OITUZ",494,"Scoala generala nr.1 Oituz",1434,640,615,25,0,633,7,1600,960,236,397,3,2190,0
4,"Bacau",23797,47,23797,,"OITUZ",495,"Gradinita nr.1 Oituz",1322,709,647,62,0,701,8,1500,791,284,417,3,2190,0
4,"Bacau",23797,47,23797,,"OITUZ",496,"Gradinita nr.2 Oituz",1012,465,424,40,1,461,4,1100,635,152,309,3,2190,0
4,"Bacau",23797,47,23797,,"OITUZ",497,"Scoala generala nr.3 Oituz",1023,439,413,26,0,428,11,1100,661,137,291,3,2190,0
4,"Bacau",23797,47,23797,,"OITUZ",498,"Scoala satul Marginea",597,280,266,14,0,275,5,705,425,83,192,3,2190,0
4,"Bacau",23797,47,23797,,"OITUZ",499,"Gradinita satul Calcii",373,199,189,10,0,195,4,400,201,120,75,3,2190,0
4,"Bacau",23797,47,23797,,"OITUZ",500,"Scoala generala satul Ferestrau-Oituz",883,463,453,9,1,461,2,1000,537,223,238,3,2190,0
4,"Bacau",23797,47,23797,,"OITUZ",501,"Asezamantul filantropic Sfantul Voievod Stefan cel Mare satul Hirja",305,159,152,7,0,154,5,400,241,53,101,3,2190,0
4,"Bacau",23797,47,23797,,"OITUZ",502,"Scoala generala satul Poiana-Sarata",231,139,133,5,1,138,1,300,161,57,81,3,2190,0
4,"Bacau",23797,47,23797,,"OITUZ",503,"Scoala nr.2 satul Oituz nr.90",0,84,0,84,0,84,0,500,416,44,40,3,2190,1
4,"Bacau",23868,47,23868,,"ONCESTI",504,"Biblioteca comunala satul Oncesti",785,466,457,9,0,460,6,860,394,143,317,3,2197,0
4,"Bacau",23868,47,23868,,"ONCESTI",505,"Scoala generala satul Tarnita",563,342,339,3,0,337,5,600,258,67,270,3,2197,0
4,"Bacau",23868,47,23868,,"ONCESTI",506,"Caminul cultural satul Oncesti ",0,139,0,139,0,138,1,143,4,70,68,3,2197,1
4,"Bacau",23948,47,23948,,"ORBENI",507,"Scoala nr.1 satul Orbeni",1049,459,428,31,0,450,9,1200,741,198,252,3,2205,0
4,"Bacau",23948,47,23948,,"ORBENI",508,"Scoala nr.2 satul Orbeni",635,313,251,62,0,307,6,700,387,130,177,3,2205,0
4,"Bacau",23948,47,23948,,"ORBENI",509,"Scoala veche satul Scurta",1445,665,635,30,0,642,23,1600,935,341,301,3,2205,0
4,"Bacau",23948,47,23948,,"ORBENI",510,"Primaria Orbeni satul Orbeni str.Principala",0,77,0,77,0,77,0,202,125,39,38,3,2205,1
4,"Bacau",23975,47,23975,,"PALANCA",511,"Primaria Palanca",1291,631,624,7,0,617,14,1409,778,215,402,3,2208,0
4,"Bacau",23975,47,23975,,"PALANCA",512,"Caminul cultural satul Ciughes",1521,864,854,10,0,851,13,1700,836,152,699,3,2208,0
4,"Bacau",23975,47,23975,,"PALANCA",513,"Scoala generala satul Cadarasti",102,59,51,8,0,59,0,100,41,29,30,3,2208,0
4,"Bacau",23975,47,23975,,"PALANCA",514,"Primaria Palanca (sala de sedinte a consiliului local) com.Palanca )",0,98,0,98,0,97,1,198,100,38,59,3,2208,1
4,"Bacau",24034,47,24034,,"PARAVA",515,"Biblioteca comunala Parava",724,351,343,8,0,340,11,801,450,182,158,3,2223,0
4,"Bacau",24034,47,24034,,"PARAVA",516,"Scoala cu cl.I-IV satul Teius ",197,146,130,16,0,145,1,200,54,73,72,3,2223,0
4,"Bacau",24034,47,24034,,"PARAVA",517,"Scoala cu cl.I-VIII satul Dragusani",750,375,367,8,0,369,6,800,425,205,164,3,2223,0
4,"Bacau",24034,47,24034,,"PARAVA",518,"Scoala cu cl.I-VIII satul Radoaia",865,336,326,10,0,317,19,1000,664,157,160,3,2223,0
4,"Bacau",24034,47,24034,,"PARAVA",519,"Gradinita com.Parava satul Parava",0,117,0,117,0,115,2,199,82,69,46,3,2223,1
4,"Bacau",24089,47,24089,,"PARINCEA",520,"Primaria Parincea corp A",771,381,372,9,0,370,11,898,517,208,162,3,2234,0
4,"Bacau",24089,47,24089,,"PARINCEA",521,"Scoala Valeni",485,214,209,5,0,209,5,501,287,114,95,3,2234,0
4,"Bacau",24089,47,24089,,"PARINCEA",522,"Scoala Vladnic",688,380,372,8,0,368,12,801,421,183,185,3,2234,0
4,"Bacau",24089,47,24089,,"PARINCEA",523,"Caminul cultural Nanesti",608,319,312,7,0,317,2,700,381,123,194,3,2234,0
4,"Bacau",24089,47,24089,,"PARINCEA",524,"Scoala Poieni",237,150,137,13,0,148,2,301,151,69,79,3,2234,0
4,"Bacau",24089,47,24089,,"PARINCEA",525,"Scoala Milestii de Jos",210,130,122,8,0,129,1,298,168,79,50,3,2234,0
4,"Bacau",24089,47,24089,,"PARINCEA",526,"Primaria Parincea satul Parincea",0,125,0,125,0,124,1,201,76,61,63,3,2234,1
4,"Bacau",24187,47,24187,,"PANCESTI",527,"Scoala nr.1 Pincesti",1265,519,510,9,0,510,9,1400,881,202,308,3,2214,0
4,"Bacau",24187,47,24187,,"PANCESTI",528,"Scoala cl.I-IV satul Dienet",521,214,214,0,0,210,4,600,386,75,135,3,2214,0
4,"Bacau",24187,47,24187,,"PANCESTI",529,"Scoala cl.I-VIII satul Petresti",654,329,305,24,0,324,5,700,371,124,200,3,2214,0
4,"Bacau",24187,47,24187,,"PANCESTI",530,"Scoala cl.I-VIII satul Soci",607,336,330,6,0,332,4,700,364,154,178,3,2214,0
4,"Bacau",24187,47,24187,,"PANCESTI",531,"Scoala cl.I-VIII satul Fulgeris ",340,141,132,9,0,137,4,400,259,45,92,3,2214,0
4,"Bacau",24187,47,24187,,"PANCESTI",532,"Primaria Pincesti com.Pincesti",0,79,0,79,0,76,3,200,121,28,48,3,2214,1
4,"Bacau",24276,47,24276,,"PARGARESTI",533,"Scoala cl.I-IV satul Paraul Boghii",339,184,177,7,0,180,4,400,216,90,90,3,2228,0
4,"Bacau",24276,47,24276,,"PARGARESTI",534,"Scoala cl.I-VIII sala 1 satul Pirgaresti",892,356,352,4,0,348,8,1000,644,156,192,3,2228,0
4,"Bacau",24276,47,24276,,"PARGARESTI",535,"Scoala de Arte si Meserii satul Satu Nou",1394,606,602,4,0,591,15,1500,894,290,301,3,2228,0
4,"Bacau",24276,47,24276,,"PARGARESTI",536,"Scoala cl.I-VIII satul Nicoresti",751,330,323,7,0,327,3,800,470,158,169,3,2228,0
4,"Bacau",24276,47,24276,,"PARGARESTI",537,"Scoala cl.I-IV satul Bahna",497,243,235,8,0,239,4,500,257,104,135,3,2228,0
4,"Bacau",24276,47,24276,,"PARGARESTI",538,"Scoala cl.I-VIII satul Pirgaresti",0,38,0,38,0,38,0,200,162,14,24,3,2228,1
4,"Bacau",24338,47,24338,,"PARJOL",539,"Scoala satul Pirjol sala 1",758,348,319,29,0,347,1,802,454,148,199,3,2245,0
4,"Bacau",24338,47,24338,,"PARJOL",540,"Scoala satul Tarita",803,369,348,21,0,367,2,900,531,132,235,3,2245,0
4,"Bacau",24338,47,24338,,"PARJOL",541,"Scoala satul Bahnaseni",730,385,363,22,0,379,6,800,415,77,302,3,2245,0
4,"Bacau",24338,47,24338,,"PARJOL",542,"Scoala satul Barnesti",172,116,94,22,0,112,4,198,82,44,68,3,2245,0
4,"Bacau",24338,47,24338,,"PARJOL",543,"Scoala satul Basesti",525,242,219,23,0,238,4,598,356,82,156,3,2245,0
4,"Bacau",24338,47,24338,,"PARJOL",544,"Scoala satul Haineala",225,133,102,31,0,131,2,300,167,38,93,3,2245,0
4,"Bacau",24338,47,24338,,"PARJOL",545,"Scoala satul Cimpeni",572,301,281,20,0,293,8,600,299,126,167,3,2245,0
4,"Bacau",24338,47,24338,,"PARJOL",546,"Gradinita Pustiana",691,332,319,13,0,325,7,800,468,109,216,3,2245,0
4,"Bacau",24338,47,24338,,"PARJOL",547,"Scoala cl.I-VIII Pustiana",916,412,403,9,0,408,4,1000,588,150,258,3,2245,0
4,"Bacau",24338,47,24338,,"PARJOL",548,"Scoala generala cl.I-VIII com.Pirjol",0,82,0,82,0,82,0,300,218,28,54,3,2245,1
4,"Bacau",24427,47,24427,,"PLOPANA",549,"Consiliul local comunal Plopana (sala de sedinte)",801,414,396,0,18,410,4,900,486,208,202,3,2255,0
4,"Bacau",24427,47,24427,,"PLOPANA",550,"Scoala cl.I-IV satul Fundu Tutovei",465,288,271,16,1,283,5,504,216,159,124,3,2255,0
4,"Bacau",24427,47,24427,,"PLOPANA",551,"Scoala cl.I-IV satul Itcani ",627,410,391,8,11,401,8,700,290,288,113,3,2255,0
4,"Bacau",24427,47,24427,,"PLOPANA",552,"Scoala cl.I-VIII satul Rusenii-Razesi",335,235,215,8,12,229,6,400,165,110,119,3,2255,0
4,"Bacau",24427,47,24427,,"PLOPANA",553,"Scoala cl.I-IV satul Straminoasa",379,251,246,3,2,242,9,400,149,133,109,3,2255,0
4,"Bacau",24427,47,24427,,"PLOPANA",554,"Consiliul local Plopana com.Plopana",0,122,0,122,0,122,0,204,82,72,50,3,2255,1
4,"Bacau",24524,47,24524,,"PODU TURCULUI",555,"Primaria Podu Turcului",1898,1037,1029,8,0,1021,16,2100,1063,476,545,3,2265,0
4,"Bacau",24524,47,24524,,"PODU TURCULUI",556,"Scoala generala nr.3 satul Podu Turcului sector ""Danceni""",483,394,340,54,0,388,6,500,106,187,201,3,2265,0
4,"Bacau",24524,47,24524,,"PODU TURCULUI",557,"Scoala generala satul Cabesti",835,472,462,10,0,455,17,901,429,241,214,3,2265,0
4,"Bacau",24524,47,24524,,"PODU TURCULUI",558,"Scoala generala satul Lehancea",564,308,303,5,0,303,5,602,294,162,141,3,2265,0
4,"Bacau",24524,47,24524,,"PODU TURCULUI",559,"Scoala generala Sirbi",420,221,215,6,0,215,6,497,276,78,137,3,2265,0
4,"Bacau",24524,47,24524,,"PODU TURCULUI",560,"Caminul cultural com.Podu Turcului, str. Tudor Vladimirescu nr.89",0,233,0,233,0,231,2,304,71,101,130,3,2265,1
4,"Bacau",24631,47,24631,,"PODURI",561,"Scoala Poduri sala 1",1145,565,538,27,0,555,10,1300,735,248,307,3,2276,0
4,"Bacau",24631,47,24631,,"PODURI",562,"Scoala Poduri sala 2",925,463,429,34,0,449,14,1000,537,184,265,3,2276,0
4,"Bacau",24631,47,24631,,"PODURI",563,"Scoala  satul Valea Sosii",916,465,429,36,0,452,13,1000,535,206,246,3,2276,0
4,"Bacau",24631,47,24631,,"PODURI",564,"Scoala satul Prohozesti",837,449,429,20,0,444,5,1000,551,170,274,3,2276,0
4,"Bacau",24631,47,24631,,"PODURI",565,"Scoala satul Bucsesti",1319,732,678,54,0,721,11,1500,768,397,324,3,2276,0
4,"Bacau",24631,47,24631,,"PODURI",566,"Scoala satul Cernu",1088,592,534,58,0,578,14,1197,605,219,359,3,2276,0
4,"Bacau",24631,47,24631,,"PODURI",567,"Scoala Poduri satul Poduri ",0,81,0,81,0,80,1,400,319,36,44,3,2276,1
4,"Bacau",26361,47,26361,,"PRAJESTI",568,"Scoala generala cl.I-VIII Gheorghe Avramescu sala 1 Prajesti",1662,664,651,11,2,648,16,1800,1136,315,333,3,2284,0
4,"Bacau",26361,47,26361,,"PRAJESTI",569,"Scoala generala cl.I-IV Prajesti",303,164,142,22,0,161,3,400,236,65,96,3,2284,0
4,"Bacau",26361,47,26361,,"PRAJESTI",570,"Scoala generala cl.I-VIII Gheorghe Avramescu com.Prajesti",0,95,0,95,0,95,0,101,6,45,50,3,2284,1
4,"Bacau",24711,47,24711,,"RACOVA",571,"Scoala generala nr.1 satul Racova",1336,637,621,16,0,630,7,1500,863,249,381,3,2309,0
4,"Bacau",24711,47,24711,,"RACOVA",572,"Scoala generala nr.2 satul Racova",529,311,284,27,0,307,4,600,289,104,203,3,2309,0
4,"Bacau",24711,47,24711,,"RACOVA",573,"Scoala generala satul Gura Vaii",965,472,455,17,0,468,4,1100,628,206,262,3,2309,0
4,"Bacau",24711,47,24711,,"RACOVA",574,"Primaria Racova com.Racova",0,113,0,113,0,111,2,200,87,46,65,3,2309,1
4,"Bacau",24766,47,24766,,"RACACIUNI",575,"Casa de cultura Nicolae Stroe satul Racaciuni",1281,561,542,19,0,550,11,1397,836,286,264,3,2286,0
4,"Bacau",24766,47,24766,,"RACACIUNI",576,"Gradinita nr.2 satul Racaciuni ",1253,525,511,14,0,518,7,1400,875,261,257,3,2286,0
4,"Bacau",24766,47,24766,,"RACACIUNI",577,"Scoala cl.I-VIII satul Gheorghe Doja",925,415,399,16,0,409,6,1000,585,250,159,3,2286,0
4,"Bacau",24766,47,24766,,"RACACIUNI",578,"Scoala cl.I-VIII satul Gisteni ",674,363,346,17,0,355,8,700,337,201,154,3,2286,0
4,"Bacau",24766,47,24766,,"RACACIUNI",579,"Scoala cl.I-VIII satul Fundu Racaciuni",1497,750,739,11,0,733,17,1600,850,422,311,3,2286,0
4,"Bacau",24766,47,24766,,"RACACIUNI",580,"Scoala cl.I-IV satul Ciucani ",402,254,231,17,6,251,3,400,146,161,90,3,2286,0
4,"Bacau",24766,47,24766,,"RACACIUNI",581,"Scoala generala cl.I-IV nr.2 satul Racaciuni",0,104,0,104,0,104,0,401,297,51,53,3,2286,1
4,"Bacau",24837,47,24837,,"RACHITOASA",582,"Caminul cultural satul Rachitoasa",1237,551,543,7,1,537,14,1395,844,212,325,3,2293,0
4,"Bacau",24837,47,24837,,"RACHITOASA",583,"Scoala generala satul Fundatura-Rachitoasa",251,120,114,6,0,120,0,300,180,48,72,3,2293,0
4,"Bacau",24837,47,24837,,"RACHITOASA",584,"Scoala generala satul Dumbrava",517,278,269,9,0,271,7,600,322,66,205,3,2293,0
4,"Bacau",24837,47,24837,,"RACHITOASA",585,"Scoala generala satul Burdusaci",756,381,370,11,0,374,7,800,419,149,225,3,2293,0
4,"Bacau",24837,47,24837,,"RACHITOASA",586,"Scoala generala satul Barcana",499,241,231,10,0,238,3,500,259,104,134,3,2293,0
4,"Bacau",24837,47,24837,,"RACHITOASA",587,"Scoala generala satul Buda",563,303,293,10,0,299,4,600,297,87,212,3,2293,0
4,"Bacau",24837,47,24837,,"RACHITOASA",588,"Primaria Rachitoasa satul Rachitoasa",0,160,0,160,0,160,0,200,40,69,91,3,2293,1
4,"Bacau",24999,47,24999,,"ROSIORI",589,"Scoala generala sala 1 satul Rosiori",944,511,483,10,18,503,8,1100,589,135,368,3,2314,0
4,"Bacau",24999,47,24999,,"ROSIORI",590,"Scoala generala satul Poieni",295,183,173,6,4,181,2,300,117,42,139,3,2314,0
4,"Bacau",24999,47,24999,,"ROSIORI",591,"Scoala generala satul Valea Mare",430,255,241,6,8,251,4,500,245,75,176,3,2314,0
4,"Bacau",24999,47,24999,,"ROSIORI",592,"Scoala generala nr.1 com.Rosiori",0,80,0,80,0,80,0,100,20,40,40,3,2314,1
4,"Bacau",25068,47,25068,,"SASCUT",593,"Scoala cl.I-VIII sala 1 satul Sascut",1267,694,671,20,3,684,10,1400,706,352,332,3,2332,0
4,"Bacau",25068,47,25068,,"SASCUT",594,"Scoala cl.I-VIII sala 2 satul Sascut",1270,704,690,12,2,700,4,1399,695,368,332,3,2332,0
4,"Bacau",25068,47,25068,,"SASCUT",595,"Caminul cultural satul Beresti",1176,767,746,10,11,750,17,1300,533,445,305,3,2332,0
4,"Bacau",25068,47,25068,,"SASCUT",596,"Scoala cl.I-IV satul Contesti ",474,313,299,14,0,305,8,500,187,155,150,3,2332,0
4,"Bacau",25068,47,25068,,"SASCUT",597,"Scoala cl.I-VIII nr.1 sala 1 satul Pancesti",1402,717,657,53,7,704,13,1500,783,322,382,3,2332,0
4,"Bacau",25068,47,25068,,"SASCUT",598,"Scoala cl.I-IV nr.2 sala 2 satul Pancesti",907,573,484,76,13,563,10,996,423,238,325,3,2332,0
4,"Bacau",25068,47,25068,,"SASCUT",599,"Scoala cl.I-VIII sala 1 satul Sascut-Sat",1006,610,602,8,0,600,10,1100,490,321,279,3,2332,0
4,"Bacau",25068,47,25068,,"SASCUT",600,"Scoala cl.I-VIII sala 2 satul Sascut-Sat",897,565,550,15,0,551,14,1000,435,296,255,3,2332,0
4,"Bacau",25068,47,25068,,"SASCUT",601,"Scoala generala cl.I-VIII satul Sascut Targ",0,201,0,201,0,200,1,501,300,91,109,3,2332,1
4,"Bacau",25148,47,25148,,"SANDULENI",602,"Scoala generala cl.I-VIII satul Sanduleni clasa nr.1",1514,719,711,8,0,707,12,1700,981,241,466,3,2321,0
4,"Bacau",25148,47,25148,,"SANDULENI",603,"Scoala generala cl.I-VIII satul Versesti",690,363,357,6,0,355,8,801,438,101,254,3,2321,0
4,"Bacau",25148,47,25148,,"SANDULENI",604,"Scoala generala cl.I-VIII satul Coman",1009,456,452,4,0,450,6,1100,644,140,310,3,2321,0
4,"Bacau",25148,47,25148,,"SANDULENI",605,"Scoala generala cl.I-IV satul Stufu",309,159,153,6,0,153,6,400,241,79,74,3,2321,0
4,"Bacau",25148,47,25148,,"SANDULENI",606,"Scoala generala cl.I-VIII satul Sanduleni",0,79,0,79,0,79,0,200,121,40,39,3,2321,1
4,"Bacau",26320,47,26320,,"SARATA",607,"Scoala nr.1 Sarata sala 1",433,257,231,26,0,248,9,463,206,127,121,3,2329,0
4,"Bacau",26320,47,26320,,"SARATA",608,"Scoala nr.2 Sarata",751,414,394,20,0,396,18,801,387,227,169,3,2329,0
4,"Bacau",26320,47,26320,,"SARATA",609,"Scoala nr.3 Sarata",432,210,198,12,0,207,3,500,290,91,116,3,2329,0
4,"Bacau",26320,47,26320,,"SARATA",610,"Scoala nr.1 com.Sarata",0,108,0,108,0,108,0,129,21,42,66,3,2329,1
4,"Bacau",25228,47,25228,,"SAUCESTI",611,"Scoala cl.I-VIII sala 1 satul Saucesti",1690,891,873,16,2,876,15,1900,1009,474,402,3,2340,0
4,"Bacau",25228,47,25228,,"SAUCESTI",612,"Scoala cl.I-IV Schineni satul Schineni",649,333,321,12,0,329,4,700,367,145,184,3,2340,0
4,"Bacau",25228,47,25228,,"SAUCESTI",613,"Scoala cl.I-VIII Siretu satul Siretu",1008,501,474,27,0,494,7,1098,597,223,271,3,2340,0
4,"Bacau",25228,47,25228,,"SAUCESTI",614,"Scoala cl.I-IV Bogdan Voda satul Bogdan Voda ",400,235,224,11,0,227,8,400,165,159,68,3,2340,0
4,"Bacau",25228,47,25228,,"SAUCESTI",615,"Scoala cl.I-VIII satul Saucesti ",0,169,0,169,0,169,0,200,31,80,89,3,2340,1
4,"Bacau",25291,47,25291,,"SCORTENI",616,"Scoala noua satul Scorteni",1286,677,663,13,1,669,8,1400,723,298,371,3,2347,0
4,"Bacau",25291,47,25291,,"SCORTENI",617,"Scoala veche satul Grigoreni",723,401,388,13,0,389,12,817,416,157,232,3,2347,0
4,"Bacau",25291,47,25291,,"SCORTENI",618,"Scoala cu cl.I-IV satul Floresti ",531,261,254,7,0,258,3,600,339,106,152,3,2347,0
4,"Bacau",25291,47,25291,,"SCORTENI",619,"Scoala veche satul Scorteni ",0,68,0,68,0,68,0,200,132,28,40,3,2347,1
4,"Bacau",25362,47,25362,,"SECUIENI",620,"Scoala Secuieni satul Secuieni sala clasei I",977,598,582,16,0,586,12,1000,402,263,323,3,2354,0
4,"Bacau",25362,47,25362,,"SECUIENI",621,"Scoala Fundeni satul Fundeni",344,196,191,5,0,194,2,401,205,71,123,3,2354,0
4,"Bacau",25362,47,25362,,"SECUIENI",622,"Scoala Chiticeni satul Chiticeni",143,105,97,8,0,104,1,198,93,23,81,3,2354,0
4,"Bacau",25362,47,25362,,"SECUIENI",623,"Scoala Glodisoarele satul Glodisoarele",177,134,127,7,0,134,0,200,66,35,99,3,2354,0
4,"Bacau",25362,47,25362,,"SECUIENI",624,"Scoala cl.I-VII satul Secuieni ",0,160,0,160,0,158,2,204,44,83,75,3,2354,1
4,"Bacau",25488,47,25488,,"SOLONT",625,"Scoala cl.I-VIII sala 1 satul Solont",1345,706,698,8,0,698,8,1500,794,164,534,3,2362,0
4,"Bacau",25488,47,25488,,"SOLONT",626,"Scoala cl.I-IV satul Sarata",671,311,309,2,0,304,7,700,389,108,196,3,2362,0
4,"Bacau",25488,47,25488,,"SOLONT",627,"Scoala cl.I-VIII satul Cucuieti ",1057,572,568,4,0,558,14,1200,628,209,349,3,2362,0
4,"Bacau",25488,47,25488,,"SOLONT",628,"Scoala cl.I-VIII satul Solont",0,83,0,83,0,83,0,200,117,26,57,3,2362,1
4,"Bacau",25521,47,25521,,"STANISESTI",629,"Primaria Stanisesti",832,423,412,11,0,416,7,907,484,179,237,3,2366,0
4,"Bacau",25521,47,25521,,"STANISESTI",630,"Scoala satul Benesti",417,241,227,13,1,237,4,500,259,132,105,3,2366,0
4,"Bacau",25521,47,25521,,"STANISESTI",631,"Scoala satul Craiesti",401,224,207,17,0,213,11,400,176,90,123,3,2366,0
4,"Bacau",25521,47,25521,,"STANISESTI",632,"Scoala satul Slobozia nr.1",1318,577,572,5,0,562,15,1500,923,235,327,3,2366,0
4,"Bacau",25521,47,25521,,"STANISESTI",633,"Scoala satul Slobozia Noua",510,246,239,7,0,240,6,601,355,107,133,3,2366,0
4,"Bacau",25521,47,25521,,"STANISESTI",634,"Primaria veche satul Stanisesti",0,107,0,107,0,107,0,200,93,44,63,3,2366,1
4,"Bacau",25629,47,25629,,"STRUGARI",635,"Scoala generala satul Strugari",1111,622,588,14,20,619,3,1200,578,183,436,3,2383,0
4,"Bacau",25629,47,25629,,"STRUGARI",636,"Scoala generala satul Rachitis",354,213,197,8,8,206,7,400,187,65,141,3,2383,0
4,"Bacau",25629,47,25629,,"STRUGARI",637,"Scoala generala satul Petricica",561,299,283,10,6,290,9,600,301,75,215,3,2383,0
4,"Bacau",25629,47,25629,,"STRUGARI",638,"Consiliul local com.Strugari ",0,100,0,100,0,98,2,100,0,31,67,3,2383,1
4,"Bacau",20670,47,20670,,"STEFAN CEL MARE",639,"Scoala generala satul Stefan cel Mare",658,357,341,16,0,353,4,701,344,167,186,3,2376,0
4,"Bacau",20670,47,20670,,"STEFAN CEL MARE",640,"Scoala generala satul Bogdana",636,373,359,14,0,369,4,700,327,174,195,3,2376,0
4,"Bacau",20670,47,20670,,"STEFAN CEL MARE",641,"Scoala satul Radeana",949,721,680,41,0,711,10,1000,279,144,567,3,2376,0
4,"Bacau",20670,47,20670,,"STEFAN CEL MARE",642,"Scoala satul Viisoara",547,291,275,16,0,289,2,600,309,137,152,3,2376,0
4,"Bacau",20670,47,20670,,"STEFAN CEL MARE",643,"Scoala satul Gutinas",399,234,219,15,0,228,6,400,166,74,154,3,2376,0
4,"Bacau",20670,47,20670,,"STEFAN CEL MARE",644,"Biblioteca comunala satul Negoiesti",724,427,411,16,0,423,4,800,373,200,223,3,2376,0
4,"Bacau",20670,47,20670,,"STEFAN CEL MARE",645,"Caminul cultural (fosta primarie) com.Stefan cel Mare",0,168,0,168,0,159,9,200,32,50,109,3,2376,1
4,"Bacau",25692,47,25692,,"TAMASI",646,"Centrul educational Înv.Dumitru Nedita sala 1 Tamasi",1167,705,683,22,0,688,17,1306,601,328,360,3,2390,0
4,"Bacau",25692,47,25692,,"TAMASI",647,"Scoala cu cl.I-VIII satul Chetris",589,338,335,3,0,333,5,600,262,109,224,3,2390,0
4,"Bacau",25692,47,25692,,"TAMASI",648,"Scoala cu cl.I-IV satul Furnicari",459,265,260,5,0,256,9,400,135,139,117,3,2390,0
4,"Bacau",25692,47,25692,,"TAMASI",649,"Centrul de Educatie Inv.Dumitru Nedita com.Tamasi",0,164,0,164,0,161,3,200,36,93,68,3,2390,1
4,"Bacau",25745,47,25745,,"TATARASTI",650,"Caminul cultural Tatarasti - corp comun cu sediul primariei",391,211,202,9,0,201,10,400,189,80,121,3,2398,0
4,"Bacau",25745,47,25745,,"TATARASTI",651,"Scoala generala de 8 ani satul Cornii de Sus",699,332,322,10,0,322,10,800,468,187,135,3,2398,0
4,"Bacau",25745,47,25745,,"TATARASTI",652,"Scoala generala de 4 ani satul Cornii de Jos",107,76,65,11,0,73,3,200,124,32,41,3,2398,0
4,"Bacau",25745,47,25745,,"TATARASTI",653,"Scoala generala de 4 ani satul Giurgeni",194,116,108,8,0,114,2,200,84,45,69,3,2398,0
4,"Bacau",25745,47,25745,,"TATARASTI",654,"Scoala generala de 4 ani satul Dragesti",327,176,169,7,0,175,1,400,224,81,94,3,2398,0
4,"Bacau",25745,47,25745,,"TATARASTI",655,"Scoala generala de 8 ani satul Gherdana",313,139,131,8,0,135,4,400,261,61,74,3,2398,0
4,"Bacau",25745,47,25745,,"TATARASTI",656,"Primaria Tatarasti com.Tatarasti",0,67,0,67,0,65,2,100,33,34,31,3,2398,1
4,"Bacau",25825,47,25825,,"TARGU TROTUS",657,"Gradinita de copii satul Tg.Trotus",1788,912,897,15,0,895,17,2000,1088,465,430,3,2394,0
4,"Bacau",25825,47,25825,,"TARGU TROTUS",658,"Gradinita de copii satul Tuta ",1675,887,877,10,0,876,11,1800,913,284,592,3,2394,0
4,"Bacau",25825,47,25825,,"TARGU TROTUS",659,"Scoala cl.I-IV Mihai Dragan satul Viisoara",964,520,513,7,0,516,4,1100,580,259,257,3,2394,0
4,"Bacau",25825,47,25825,,"TARGU TROTUS",660,"Consiliul local com.Tg.Trotus ",0,76,0,76,0,75,1,300,224,23,52,3,2394,1
4,"Bacau",25861,47,25861,,"TRAIAN",661,"Scoala generala cl.V-VIII sala 1 satul Traian",1288,565,552,8,5,550,15,1303,738,273,277,3,2406,0
4,"Bacau",25861,47,25861,,"TRAIAN",662,"Scoala generala cl.I-IV satul Bogdanesti",439,227,219,6,2,224,3,499,272,141,83,3,2406,0
4,"Bacau",25861,47,25861,,"TRAIAN",663,"Scoala generala cl.I-IV satul Zapodia",482,229,220,9,0,227,2,500,271,127,100,3,2406,0
4,"Bacau",25861,47,25861,,"TRAIAN",664,"Scoala generala cl.I-IV satul Hertioana",179,101,88,9,4,99,2,200,99,64,35,3,2406,0
4,"Bacau",25861,47,25861,,"TRAIAN",665,"Scoala cl.V-VIII satul Traian ",0,145,0,145,0,142,3,201,56,89,53,3,2406,1
4,"Bacau",25932,47,25932,,"UNGURENI",666,"Caminul cultural satul Ungureni",817,415,395,16,4,405,10,900,485,101,304,3,2412,0
4,"Bacau",25932,47,25932,,"UNGURENI",667,"Scoala satul Viforeni",385,195,189,6,0,192,3,400,205,67,125,3,2412,0
4,"Bacau",25932,47,25932,,"UNGURENI",668,"Scoala satul Bartasesti",243,141,130,11,0,138,3,300,159,39,99,3,2412,0
4,"Bacau",25932,47,25932,,"UNGURENI",669,"Caminul cultural Botesti",637,290,284,6,0,283,7,700,410,92,191,3,2412,0
4,"Bacau",25932,47,25932,,"UNGURENI",670,"Scoala Bibiresti II",701,395,388,7,0,384,11,772,377,183,201,3,2412,0
4,"Bacau",25932,47,25932,,"UNGURENI",671,"Caminul cultural sala 2 com.Ungureni",0,133,0,133,0,128,5,200,67,53,75,3,2412,1
4,"Bacau",26029,47,26029,,"URECHESTI",672,"Sala de ceremonii Primaria Urechesti",1471,800,795,3,2,789,11,1600,800,478,311,3,2421,0
4,"Bacau",26029,47,26029,,"URECHESTI",673,"Camin Cultural satul Cornatel",697,399,391,7,1,393,6,800,401,228,165,3,2421,0
4,"Bacau",26029,47,26029,,"URECHESTI",674,"Gradinita satul Slobozia",420,247,240,7,0,243,4,499,252,140,103,3,2421,0
4,"Bacau",26029,47,26029,,"URECHESTI",675,"Scoala generala cl.I-IV Satu Nou",276,166,160,5,1,162,4,299,133,59,103,3,2421,0
4,"Bacau",26029,47,26029,,"URECHESTI",676,"Scoala generala cl.I-IV Lunca Dochiei",296,157,149,8,0,151,6,299,142,96,55,3,2421,0
4,"Bacau",26029,47,26029,,"URECHESTI",677,"Scoala cl.V-VIII com.Urechesti",0,111,0,111,0,111,0,200,89,59,52,3,2421,1
4,"Bacau",26083,47,26083,,"VALEA SEACA",678,"Scoala cl.I-VIII nr.1 satul Valea Seaca",1105,417,380,37,0,409,8,1200,783,148,261,3,2427,0
4,"Bacau",26083,47,26083,,"VALEA SEACA",679,"Scoala cl.I-IV nr.2 satul Valea Seaca",542,386,309,76,1,373,13,600,214,145,228,3,2427,0
4,"Bacau",26083,47,26083,,"VALEA SEACA",680,"Scoala cl.I-IV nr.3 satul Valea Seaca",672,385,300,84,1,376,9,700,315,126,250,3,2427,0
4,"Bacau",26083,47,26083,,"VALEA SEACA",681,"Scoala clasele  I-IV satul Cucova",572,316,284,32,0,308,8,600,284,137,171,3,2427,0
4,"Bacau",26083,47,26083,,"VALEA SEACA",682,"Primaria Valea Seaca satul Valea Seaca",0,143,0,143,0,142,1,200,57,62,80,3,2427,1
4,"Bacau",26118,47,26118,,"VULTURENI",683,"Scoala Vultureni",408,228,223,5,0,221,7,450,222,112,109,3,2430,0
4,"Bacau",26118,47,26118,,"VULTURENI",684,"Scoala Lichitiseni",500,278,268,6,4,272,6,600,322,164,108,3,2430,0
4,"Bacau",26118,47,26118,,"VULTURENI",685,"Scoala Godinestii de Jos",356,220,208,4,8,215,5,400,180,142,73,3,2430,0
4,"Bacau",26118,47,26118,,"VULTURENI",686,"Scoala Medeleni",177,118,110,8,0,113,5,200,82,63,50,3,2430,0
4,"Bacau",26118,47,26118,,"VULTURENI",687,"Scoala Ghilavesti",247,179,168,7,4,175,4,300,121,107,68,3,2430,0
4,"Bacau",26118,47,26118,,"VULTURENI",688,"Primaria Vultureni satul Vultureni str.Principala",0,115,0,115,0,112,3,150,35,50,62,3,2430,1
4,"Bacau",26289,47,26289,,"ZEMES",689,"Scoala Mihai Eminescu satul Zemes",1069,476,462,14,0,471,5,1203,727,220,251,3,2447,0
4,"Bacau",26289,47,26289,,"ZEMES",690,"Primaria Zemes sala 1 satul Zemes",1932,1149,1073,76,0,1136,13,2100,951,547,589,3,2447,0
4,"Bacau",26289,47,26289,,"ZEMES",691,"Scoala nr.1 Ion Creanga satul Bolatau",848,441,428,12,1,429,12,901,460,171,258,3,2447,0
4,"Bacau",26289,47,26289,,"ZEMES",692,"Primaria Zemes satul Zemes nr.617",0,77,0,77,0,76,1,201,124,51,25,3,2447,1
5,"Bihor",26564,56,26564,,"MUNICIPIUL ORADEA",1,"Universitatea Partium  fostul Seminar  Liceal Reformat ""Lorantffy Zsuzsana"") Str. Mihai Viteazul nr. 3",1123,534,523,11,0,525,9,1235,701,265,260,1,2451,0
5,"Bihor",26564,56,26564,,"MUNICIPIUL ORADEA",2,"Scoala cu clasele I-VIII ""Lucretia Suciu""  fosta nr.7)   Str. Grivitei nr. 2",1387,588,570,18,0,577,11,1526,938,297,280,1,2451,0
5,"Bihor",26564,56,26564,,"MUNICIPIUL ORADEA",3,"Scoala cu clasele I-VIII  ""Alexandru  Roman"" Calea Clujului nr. 66    intrarea A)",1366,642,631,11,0,637,5,1503,861,355,282,1,2451,0
5,"Bihor",26564,56,26564,,"MUNICIPIUL ORADEA",4,"Scoala cu clasele I-VIII ""Alexandru Roman"" Calea Clujului nr. 66    intrarea B)",1278,548,532,16,0,544,4,1406,858,344,200,1,2451,0
5,"Bihor",26564,56,26564,,"MUNICIPIUL ORADEA",5,"Scoala cu clasele I-VIII ""Alexandru  Roman "" Calea Clujului nr. 106",1585,587,572,15,0,584,3,1746,1159,401,183,1,2451,0
5,"Bihor",26564,56,26564,,"MUNICIPIUL ORADEA",6,"Scoala cu clasele I-VIII ""Alexandru Roman "" Calea Clujului nr. 106",994,477,462,15,0,474,3,1093,616,231,243,1,2451,0
5,"Bihor",26564,56,26564,,"MUNICIPIUL ORADEA",7,"Scoala cu clasele I-VIII ""Ioan Slavici""  fosta nr.1)  Calea Clujului nr. 188   intrarea A)",1315,715,700,15,0,712,3,1447,732,350,362,1,2451,0
5,"Bihor",26564,56,26564,,"MUNICIPIUL ORADEA",8,"Scoala cu clasele I-VIII ""Ioan Slavici""   fosta nr.1)  Calea Clujului nr. 188  intrarea A)",1550,831,816,15,0,805,26,1705,874,455,350,1,2451,0
5,"Bihor",26564,56,26564,,"MUNICIPIUL ORADEA",9,"Scoala cu clasele I-VIII ""Ioan Slavici""  fosta nr.1)   Calea Clujului nr. 188  intrarea B)",1275,526,507,19,0,521,5,1403,877,336,185,1,2451,0
5,"Bihor",26564,56,26564,,"MUNICIPIUL ORADEA",10,"Scoala cu clasele I-VIII ""Ioan Slavici""   fosta nr.1)  Calea Clujului nr. 229",1013,596,575,21,0,592,4,1114,518,358,234,1,2451,0
5,"Bihor",26564,56,26564,,"MUNICIPIUL ORADEA",11,"Scoala cu clasele I-VIII ""Alexandru Roman "" Calea Clujului nr. 106",1326,635,621,14,0,630,5,1438,803,374,256,1,2451,0
5,"Bihor",26564,56,26564,,"MUNICIPIUL ORADEA",12,"Scoala cu clasele I-VIII ""Alexandru Roman "" Calea Clujului  nr. 106",1214,542,529,13,0,537,5,1327,785,308,229,1,2451,0
5,"Bihor",26564,56,26564,,"MUNICIPIUL ORADEA",13,"Scoala cu clasele I-VIII ""Alexandru Roman "" Calea Clujului nr. 106",1520,796,787,9,0,792,4,1675,879,465,327,1,2451,0
5,"Bihor",26564,56,26564,,"MUNICIPIUL ORADEA",14,"Gradinita de copii nr. 25 Str. Zalaului nr. 11",700,312,300,12,0,308,4,770,458,169,139,1,2451,0
5,"Bihor",26564,56,26564,,"MUNICIPIUL ORADEA",15,"Gradinita de copii nr. 25 Str. Zalaului nr. 11",1152,430,420,10,0,427,3,1267,837,258,169,1,2451,0
5,"Bihor",26564,56,26564,,"MUNICIPIUL ORADEA",16,"Scoala cu clasele I-VIII ""Dimitrie Cantemir""    Str. Dimitrie Cantemir nr.32",747,371,360,11,0,368,3,822,451,178,190,1,2451,0
5,"Bihor",26564,56,26564,,"MUNICIPIUL ORADEA",17,"Scoala cu clasele I-VIII ""Dimitrie Cantemir""    Str. Dimitrie Cantemir nr.32",1185,629,620,9,0,611,18,1306,677,305,306,1,2451,0
5,"Bihor",26564,56,26564,,"MUNICIPIUL ORADEA",18,"Gradinita de copii nr. 24 Str. Dimitrie Cantemir nr. 84",1548,798,779,18,1,783,15,1703,905,396,387,1,2451,0
5,"Bihor",26564,56,26564,,"MUNICIPIUL ORADEA",19,"Caminul de batrani ""Sfantul Martin""  Str. Bumbacului nr.1",1554,746,727,19,0,742,4,1709,963,398,344,1,2451,0
5,"Bihor",26564,56,26564,,"MUNICIPIUL ORADEA",20,"Gradinita de copii nr. 2  Str. Ialomitei nr. 3  bl. AN7 sc. C  intrarea  A)",1856,934,902,32,0,928,6,2045,1111,525,403,1,2451,0
5,"Bihor",26564,56,26564,,"MUNICIPIUL ORADEA",21,"Liceul teoretic ""Onisifor Ghibu""    Aleea Profesor Onisifor Ghibu nr.3      cladirea noua, intrarea A)",1099,547,537,10,0,537,10,1209,662,281,256,1,2451,0
5,"Bihor",26564,56,26564,,"MUNICIPIUL ORADEA",22,"Liceul teoretic ""Onisifor Ghibu""  Aleea Profesor Onisifor Ghibu nr.3   cladirea noua, intrarea A)",1720,834,824,10,0,830,4,1892,1058,438,392,1,2451,0
5,"Bihor",26564,56,26564,,"MUNICIPIUL ORADEA",23,"Liceul teoretic  ""Onisifor Ghibu""  Aleea Profesor Onisifor Ghibu nr. 3  cladirea noua, intrarea B)",1372,533,519,14,0,531,2,1511,978,312,219,1,2451,0
5,"Bihor",26564,56,26564,,"MUNICIPIUL ORADEA",24,"Gradinita de copii nr. 28 Aleea Profesor Onisifor Ghibu nr. 16   intrarea A)",1602,823,808,15,0,814,9,1762,939,459,355,1,2451,0
5,"Bihor",26564,56,26564,,"MUNICIPIUL ORADEA",25,"Gradinita de copii nr. 28 Aleea Profesor Onisifor Ghibu nr. 16    intrarea B )",1599,758,740,18,0,754,4,1759,1001,393,361,1,2451,0
5,"Bihor",26564,56,26564,,"MUNICIPIUL ORADEA",26,"Liceul teoretic  ""Onisifor Ghibu""   Aleea Profesor Onisifor Ghibu nr. 3  cladirea veche  intrarea A)",1320,602,589,13,0,596,6,1452,850,335,261,1,2451,0
5,"Bihor",26564,56,26564,,"MUNICIPIUL ORADEA",27,"Liceul teoretic  ""Onisifor Ghibu""  Aleea Profesor Onisifor Ghibu nr. 3   cladirea veche, intrarea A)",1684,788,772,16,0,784,4,1855,1067,442,342,1,2451,0
5,"Bihor",26564,56,26564,,"MUNICIPIUL ORADEA",28,"Liceul teoretic  ""Onisifor Ghibu""  Aleea Profesor Onisifor Ghibu nr.3 cladirea veche, intrarea A)",1534,760,749,11,0,759,1,1687,927,405,354,1,2451,0
5,"Bihor",26564,56,26564,,"MUNICIPIUL ORADEA",29,"Gradinita de copii nr. 2 Str. Ialomitei nr.3 bl.AN7 sc.C  intrarea B)",1678,931,913,18,0,926,5,1846,915,523,403,1,2451,0
5,"Bihor",26564,56,26564,,"MUNICIPIUL ORADEA",30,"Gradinita de copii nr. 56 Str. Bumbacului nr. 22",1330,747,737,10,0,742,5,1459,712,403,339,1,2451,0
5,"Bihor",26564,56,26564,,"MUNICIPIUL ORADEA",31,"Gradinita de copii nr. 56 Str. Bumbacului nr.22",1425,760,745,15,0,756,4,1569,809,382,374,1,2451,0
5,"Bihor",26564,56,26564,,"MUNICIPIUL ORADEA",32,"Liceul teoretic ""Onisifor Ghibu"" Aleea Profesor Onisifor Ghibu nr.3  cladirea veche, intrarea A)",1704,834,821,13,0,830,4,1878,1044,423,407,1,2451,0
5,"Bihor",26564,56,26564,,"MUNICIPIUL ORADEA",33,"Liceul  teoretic ""Onisifor Ghibu""  Aleea Profesor Onisifor Ghibu nr.3   cladirea noua, intrarea B)",1567,735,723,12,0,722,13,1726,991,375,347,1,2451,0
5,"Bihor",26564,56,26564,,"MUNICIPIUL ORADEA",34,"Scoala cu clasele I-VIII ""Dimitrie Cantemir""    Str. Sextil Puscariu nr. 2     intrarea A)",1292,656,636,20,0,650,6,1423,767,365,285,1,2451,0
5,"Bihor",26564,56,26564,,"MUNICIPIUL ORADEA",35,"Scoala cu clasele I-VIII ""Dimitrie  Cantemir""   Str. Sextil Puscariu nr. 2   intrarea B)",1387,676,661,15,0,668,8,1526,850,373,295,1,2451,0
5,"Bihor",26564,56,26564,,"MUNICIPIUL ORADEA",36,"Gradinita de copii nr.46, Str. Feldioarei nr. 17   intrarea A)",1528,720,701,18,1,711,9,1681,961,365,346,1,2451,0
5,"Bihor",26564,56,26564,,"MUNICIPIUL ORADEA",37,"Gradinita de copii nr. 46  Str. Feldioarei nr. 17  intrarea B)",1266,522,512,9,1,517,5,1393,871,305,212,1,2451,0
5,"Bihor",26564,56,26564,,"MUNICIPIUL ORADEA",38,"Scoala cu clasele I-VIII ""Dimitrie Cantemir""   Str. Dimitrie Cantemir nr.32",1624,792,774,18,0,784,8,1786,994,406,378,1,2451,0
5,"Bihor",26564,56,26564,,"MUNICIPIUL ORADEA",39,"Scoala cu clasele I-VIII ""Nicolae Balcescu""  Str. Erou Marius Cosma nr.8   intrarea A)",909,478,465,13,0,474,4,1000,522,234,240,1,2451,0
5,"Bihor",26564,56,26564,,"MUNICIPIUL ORADEA",40,"Scoala cu clasele I-VIII ""Nicolae Balcescu"" Str.Erou Marius Cosma nr.8  intrarea B)",904,475,459,16,0,470,5,997,522,195,275,1,2451,0
5,"Bihor",26564,56,26564,,"MUNICIPIUL ORADEA",41,"Scoala cu clasele I-VIII ""Oltea Doamna""     fosta nr. 4)  Cartier Podgoria",374,120,107,13,0,117,3,411,291,60,57,1,2451,0
5,"Bihor",26564,56,26564,,"MUNICIPIUL ORADEA",42,"Gradinita de copii nr. 53 Str. Calugareni   nr. 4/A   intrarea A)",899,408,398,10,0,406,2,990,582,242,164,1,2451,0
5,"Bihor",26564,56,26564,,"MUNICIPIUL ORADEA",43,"Gradinita de copii nr. 53 Str. Calugareni nr. 4/A  intrarea B)",933,438,428,10,0,438,0,1026,588,234,204,1,2451,0
5,"Bihor",26564,56,26564,,"MUNICIPIUL ORADEA",44,"Gradinita de copii nr. 52 Str. Calugareni nr. 8/A   intrarea A)",935,363,352,11,0,357,6,1031,668,213,144,1,2451,0
5,"Bihor",26564,56,26564,,"MUNICIPIUL ORADEA",45,"Gradinita de copii nr. 52 Str.Calugareni, nr. 8/A   intrarea B)",1392,598,583,14,1,592,6,1511,913,342,250,1,2451,0
5,"Bihor",26564,56,26564,,"MUNICIPIUL ORADEA",46,"Gradinita de copii nr. 52  Str.Calugareni, nr. 8/A  intrarea B)",1082,430,419,11,0,426,4,1190,760,232,194,1,2451,0
5,"Bihor",26564,56,26564,,"MUNICIPIUL ORADEA",47,"Scoala cu clasele I-VIII nr. 16 Str. Calugareni nr. 4  intrarea A)",1173,600,591,9,0,593,7,1291,691,301,292,1,2451,0
5,"Bihor",26564,56,26564,,"MUNICIPIUL ORADEA",48,"Scoala cu clasele I-VIII nr. 16 Str. Calugareni nr.4   intrarea B)",1108,545,533,12,0,541,4,1221,676,285,256,1,2451,0
5,"Bihor",26564,56,26564,,"MUNICIPIUL ORADEA",49,"Liceul ""Lucian Blaga""  Aleea Posada nr. 1   intrarea A)",1363,666,655,11,0,662,4,1499,833,313,349,1,2451,0
5,"Bihor",26564,56,26564,,"MUNICIPIUL ORADEA",50,"Gradinita de copii   nr. 41   fosta nr. 17)Str. Transilvaniei nr. 21",1775,865,849,16,0,851,14,1947,1082,418,433,1,2451,0
5,"Bihor",26564,56,26564,,"MUNICIPIUL ORADEA",51,"Gradinita de copii nr. 20  Aleea Posada nr. 20  intrarea A)",1533,700,684,15,1,694,6,1686,986,383,311,1,2451,0
5,"Bihor",26564,56,26564,,"MUNICIPIUL ORADEA",52,"Liceul ""Lucian Blaga""  Aleea Posada nr. 1   intrarea B)",1663,788,768,20,0,779,9,1830,1042,356,423,1,2451,0
5,"Bihor",26564,56,26564,,"MUNICIPIUL ORADEA",53,"Liceul ""Lucian Blaga""  Aleea Posada nr. 1  intrarea C)",1426,696,688,8,0,693,3,1569,873,360,333,1,2451,0
5,"Bihor",26564,56,26564,,"MUNICIPIUL ORADEA",54,"Scoala cu clasele I-VIII ""Andrei Muresanu""  Fosta nr. 17) Str. Aluminei nr. 88  corp A,  intrarea A.)",902,408,396,12,0,407,1,992,584,200,207,1,2451,0
5,"Bihor",26564,56,26564,,"MUNICIPIUL ORADEA",55,"Scoala cu clasele I-VIII ""Andrei Muresanu""  Fosta nr. 17)  Str. Aluminei nr. 88  corp A, intrarea A)",865,443,430,11,2,438,5,954,511,205,233,1,2451,0
5,"Bihor",26564,56,26564,,"MUNICIPIUL ORADEA",56,"Gradinita de copii nr. 54  Bulevardul  Dacia nr.110  intrarea A)",1095,637,622,14,1,631,6,1206,569,294,337,1,2451,0
5,"Bihor",26564,56,26564,,"MUNICIPIUL ORADEA",57,"Gradinita de copii nr. 54 Bulevardul Dacia nr. 110   intrarea B)",1118,588,575,12,1,578,10,1230,642,292,286,1,2451,0
5,"Bihor",26564,56,26564,,"MUNICIPIUL ORADEA",58,"Scoala cu clasele I-VIII ""Andrei Muresanu""  Fosta nr. 17)Str. Aluminei nr. 88  corp B, intrarea A)",1568,782,768,14,0,779,3,1725,943,397,382,1,2451,0
5,"Bihor",26564,56,26564,,"MUNICIPIUL ORADEA",59,"Scoala cu clasele I-VIII ""Andrei Muresanu""  Fosta nr. 17)  Str. Aluminei nr.88  corp B, intrarea A)",1415,707,696,11,0,704,3,1559,852,329,375,1,2451,0
5,"Bihor",26564,56,26564,,"MUNICIPIUL ORADEA",60,"Gradinita ""Metalica""  Str. Nicolae Gane nr.1   intrarea A)",1477,740,729,11,0,730,10,1625,885,376,354,1,2451,0
5,"Bihor",26564,56,26564,,"MUNICIPIUL ORADEA",61,"Gradinita ""Metalica""   Str. Nicolae Gane nr.1   intrarea B)",1627,833,820,13,0,820,13,1790,957,417,403,1,2451,0
5,"Bihor",26564,56,26564,,"MUNICIPIUL ORADEA",62,"Gradinita  ""Metalica"" Str. Nicolae Gane nr.1   intrarea C)",1538,771,763,8,0,766,5,1693,922,346,420,1,2451,0
5,"Bihor",26564,56,26564,,"MUNICIPIUL ORADEA",63,"Scoala cu clasele I-VIII ""Andrei Muresanu""  Fosta nr. 17) Str. Aluminei nr.88  corp A, intarea A)",997,477,467,10,0,476,1,1098,621,262,214,1,2451,0
5,"Bihor",26564,56,26564,,"MUNICIPIUL ORADEA",64,"Scoala cu clasele I-VIII ""Andrei Muresanu""  Fosta nr. 17)  Str. Aluminei nr.88   corp A, intarea A)",1342,658,642,16,0,650,8,1476,818,357,293,1,2451,0
5,"Bihor",26564,56,26564,,"MUNICIPIUL ORADEA",65,"Gradinita de copii nr. 45 Str. Aluminei nr. 100/A  intrarea A)",1148,633,619,14,0,626,7,1264,631,339,287,1,2451,0
5,"Bihor",26564,56,26564,,"MUNICIPIUL ORADEA",66,"Gradinita de copii nr. 45 Str. Aluminei nr. 100/A  intrarea A)",1469,784,772,12,0,770,14,1616,832,364,406,1,2451,0
5,"Bihor",26564,56,26564,,"MUNICIPIUL ORADEA",67,"Gradinita de copii nr. 45 Str. Aluminei nr.100/A  intrarea B)",1546,747,737,10,0,739,8,1701,954,365,374,1,2451,0
5,"Bihor",26564,56,26564,,"MUNICIPIUL ORADEA",68,"Gradinita de copii nr. 45  Str. Aluminei nr. 100/A  intrarea B)",1308,707,697,10,0,701,6,1439,732,358,343,1,2451,0
5,"Bihor",26564,56,26564,,"MUNICIPIUL ORADEA",69,"Colegiu Tehnic ""Constantin Brancusi""  Str. Menumorut nr. 33  intrarea A)",1466,767,754,13,0,760,7,1613,846,406,354,1,2451,0
5,"Bihor",26564,56,26564,,"MUNICIPIUL ORADEA",70,"Colegiu Tehnic ""Constantin Brancusi""   Str. Menumorut nr. 33    intrarea B)",1700,915,906,9,0,902,13,1870,955,485,417,1,2451,0
5,"Bihor",26564,56,26564,,"MUNICIPIUL ORADEA",71,"Grup Scolar Economic ""Partenie Cosma""  Str. Partenie Cosma  fosta Orsovei) nr. 5",1735,912,896,16,0,904,8,1909,997,457,447,1,2451,0
5,"Bihor",26564,56,26564,,"MUNICIPIUL ORADEA",72,"Scoala cu clasele I-VIII ""Dacia"" Bulevardul Dacia nr.25 intrarea A)",1396,710,693,17,0,703,7,1536,826,318,385,1,2451,0
5,"Bihor",26564,56,26564,,"MUNICIPIUL ORADEA",73,"Scoala cu clasele I-VIII ""Dacia"" Bulevardul Dacia nr.25   intrarea A)",1614,799,787,12,0,793,6,1774,975,408,385,1,2451,0
5,"Bihor",26564,56,26564,,"MUNICIPIUL ORADEA",74,"Scoala cu clasele I-VIII ""Dacia"" Bulevardul Dacia nr.25   intrarea B)",1207,631,619,12,0,625,6,1328,697,302,323,1,2451,0
5,"Bihor",26564,56,26564,,"MUNICIPIUL ORADEA",75,"Policlinica de copii nr. 2  Str. Corneliu Coposu nr.12",1514,640,618,22,0,632,8,1665,1025,340,292,1,2451,0
5,"Bihor",26564,56,26564,,"MUNICIPIUL ORADEA",76,"Cabinete medicale individuale  fosta Policlinica nr.3) Str. Corneliu Coposu nr.14",1716,856,836,20,0,842,14,1888,1032,463,379,1,2451,0
5,"Bihor",26564,56,26564,,"MUNICIPIUL ORADEA",77,"Scoala cu clasele I-VIII nr. 16 Str. Calugareni nr. 4     intrarea B)",1373,663,649,14,0,659,4,1510,847,379,280,1,2451,0
5,"Bihor",26564,56,26564,,"MUNICIPIUL ORADEA",78,"Casa minunata Str. Cosminului nr.1   corp B)",1574,773,760,13,0,766,7,1731,958,431,335,1,2451,0
5,"Bihor",26564,56,26564,,"MUNICIPIUL ORADEA",79,"Gradinita de copii nr. 15   Str. Matei Corvin nr. 231",1618,565,547,18,0,557,8,1780,1215,347,210,1,2451,0
5,"Bihor",26564,56,26564,,"MUNICIPIUL ORADEA",80,"Scoala cu clasele I-VIII ""Juhasz Gyula""      fosta nr. 5) Str. Matei Corvin nr.106/A",812,289,273,16,0,286,3,893,604,163,123,1,2451,0
5,"Bihor",26564,56,26564,,"MUNICIPIUL ORADEA",81,"Scoala cu clasele I-VIII ""Juhasz Gyula""  fosta nr. 5)  Str. Matei Corvin nr.106/A",1108,361,351,10,0,360,1,1219,858,195,165,1,2451,0
5,"Bihor",26564,56,26564,,"MUNICIPIUL ORADEA",82,"Sala Sporturilor  Str. Cazaban nr.3  Intrarea A",1690,898,876,22,0,890,8,1860,962,482,408,1,2451,0
5,"Bihor",26564,56,26564,,"MUNICIPIUL ORADEA",83,"Sala Sporturilor  Str. Cazaban nr.3   Intrarea B",993,468,457,11,0,461,7,1092,624,258,203,1,2451,0
5,"Bihor",26564,56,26564,,"MUNICIPIUL ORADEA",84,"Sala Sporturilor  Str. Cazaban nr.3 Intrarea C",1227,613,596,17,0,606,7,1354,741,343,263,1,2451,0
5,"Bihor",26564,56,26564,,"MUNICIPIUL ORADEA",85,"Strand Termal Iosia-Nord  Str. A. Cazaban  intrarea A)",1564,802,795,7,0,797,5,1720,918,467,330,1,2451,0
5,"Bihor",26564,56,26564,,"MUNICIPIUL ORADEA",86,"Strand Termal Iosia-Nord  Str. A. Cazaban  intrarea B)",1548,759,734,24,1,756,3,1703,944,417,339,1,2451,0
5,"Bihor",26564,56,26564,,"MUNICIPIUL ORADEA",87,"Grup Scolar ""Transilvania""  Str. A. Cazaban nr. 48 - fostul Grup Scolar ""Sinteza""   intrarea A)",1674,794,779,15,0,793,1,1844,1050,458,335,1,2451,0
5,"Bihor",26564,56,26564,,"MUNICIPIUL ORADEA",88,"Grup Scolar ""Transilvania"" Str. Cazaban nr. 48 - fostul Grup Scolar ""Sinteza""  intrarea B)",1695,829,814,15,0,824,5,1865,1036,514,310,1,2451,0
5,"Bihor",26564,56,26564,,"MUNICIPIUL ORADEA",89,"Drumuri Bihor S.A. Str. Tudor Vladimirescu nr. 84 parter",994,485,468,17,0,483,2,1093,608,270,213,1,2451,0
5,"Bihor",26564,56,26564,,"MUNICIPIUL ORADEA",90,"Gradinita de copii nr. 55  Str. Hategului nr. 32",1190,686,675,11,0,679,7,1310,624,350,329,1,2451,0
5,"Bihor",26564,56,26564,,"MUNICIPIUL ORADEA",91,"Fundatia de scleroza multipla    Str. Buzaului nr. 2/A",1234,552,527,25,0,545,7,1357,805,315,230,1,2451,0
5,"Bihor",26564,56,26564,,"MUNICIPIUL ORADEA",92,"Gradinita de copii nr. 35   Str. Mihail Sadoveanu nr. 10   intrarea A )",1258,566,551,15,0,565,1,1384,818,354,211,1,2451,0
5,"Bihor",26564,56,26564,,"MUNICIPIUL ORADEA",93,"Gradinita de copii nr. 35 Str. Mihail Sadoveanu nr. 10  intrarea B)",1093,568,551,17,0,559,9,1202,634,293,266,1,2451,0
5,"Bihor",26564,56,26564,,"MUNICIPIUL ORADEA",94,"Centrul de Ingrijire de Zi  Str. Traian Lalescu nr. 3C  Langa  Stadion)",1640,792,780,12,0,788,4,1804,1012,449,339,1,2451,0
5,"Bihor",26564,56,26564,,"MUNICIPIUL ORADEA",95,"Centrul de Ingrijire de Zi  Str. Traian Lalescu nr. 3C   Langa Stadion)",1359,617,586,31,0,611,6,1495,878,337,274,1,2451,0
5,"Bihor",26564,56,26564,,"MUNICIPIUL ORADEA",96,"Scoala cu clasele I-VIII ""Ioan Slavici""  fosta nr.1)  Calea Clujului nr. 229",749,357,346,11,0,352,5,824,467,238,114,1,2451,0
5,"Bihor",26564,56,26564,,"MUNICIPIUL ORADEA",97,"Scoala ajutatoare nr. 2 Str. Traian Lalescu nr.1",1548,696,671,25,0,693,3,1703,1007,375,318,1,2451,0
5,"Bihor",26564,56,26564,,"MUNICIPIUL ORADEA",98,"Policlinica de copii nr. 2  Str. Corneliu Coposu nr.12",1126,531,521,10,0,527,4,1239,708,303,224,1,2451,0
5,"Bihor",26564,56,26564,,"MUNICIPIUL ORADEA",99,"Spitalul Clinic de copii  Str. Corneliu Coposu nr.12",1684,830,813,17,0,821,9,1852,1022,430,391,1,2451,0
5,"Bihor",26564,56,26564,,"MUNICIPIUL ORADEA",100,"Scoala cu clasele I - VIII Nr.11 Str. Moldovei nr. 55    intrarea A, cladirea veche)",1374,685,674,11,0,681,4,1511,826,364,317,1,2451,0
5,"Bihor",26564,56,26564,,"MUNICIPIUL ORADEA",101,"Scoala cu clasele I - VIII Nr.11 Str. Moldovei nr. 55   intrarea A, cladirea veche)",1152,504,487,16,1,502,2,1264,760,251,251,1,2451,0
5,"Bihor",26564,56,26564,,"MUNICIPIUL ORADEA",102,"Gradinita de copii nr. 41  Str. Prof. dr. Ioan Cantacuzino nr. 68",1429,685,670,15,0,680,5,1574,889,391,289,1,2451,0
5,"Bihor",26564,56,26564,,"MUNICIPIUL ORADEA",103,"Gradinita de copii nr. 41 Str. Prof. dr. Ioan Cantacuzino nr. 68",1510,774,755,19,0,768,6,1662,888,490,278,1,2451,0
5,"Bihor",26564,56,26564,,"MUNICIPIUL ORADEA",104,"Scoala cu clasele I - VIII Nr.11 Str. Moldovei nr. 55    intrarea A, cladirea noua )",858,444,432,12,0,441,3,946,502,263,178,1,2451,0
5,"Bihor",26564,56,26564,,"MUNICIPIUL ORADEA",105,"Scoala cu clasele I - VIII Nr.11  Str. Moldovei nr.55  intrarea A, cladirea noua)",1644,839,825,14,0,830,9,1808,969,409,421,1,2451,0
5,"Bihor",26564,56,26564,,"MUNICIPIUL ORADEA",106,"Scoala cu clasele I - VIII Nr.11  Str. Moldovei nr.55    intrarea B, cladirea noua)",1447,801,778,23,0,793,8,1592,791,434,359,1,2451,0
5,"Bihor",26564,56,26564,,"MUNICIPIUL ORADEA",107,"Casa Minunata Str. Cosminului nr.1  corp A)",1481,754,742,12,0,751,3,1629,875,383,368,1,2451,0
5,"Bihor",26564,56,26564,,"MUNICIPIUL ORADEA",108,"Scoala cu clasele I-VIII nr. 13   Str. Ion Bogdan nr.20",1458,771,752,19,0,769,2,1604,833,448,321,1,2451,0
5,"Bihor",26564,56,26564,,"MUNICIPIUL ORADEA",109,"Scoala cu clasele I-VIII nr. 13  Str. Ion Bogdan nr.20",1535,772,753,18,1,768,4,1684,912,409,359,1,2451,0
5,"Bihor",26564,56,26564,,"MUNICIPIUL ORADEA",110,"Scoala cu clasele I-VIII ""Dacia"" Str. Calimanestilor nr. 10  intrarea A)",1141,591,576,15,0,587,4,1247,656,332,255,1,2451,0
5,"Bihor",26564,56,26564,,"MUNICIPIUL ORADEA",111,"Scoala cu clasele I-VIII ""Dacia"" Str. Calimanestilor nr. 10   intrarea B)",1171,559,549,10,0,550,9,1288,729,277,273,1,2451,0
5,"Bihor",26564,56,26564,,"MUNICIPIUL ORADEA",112,"Centrul de Recoltare a Sangelui  Str. Louis Pasteur nr. 30",1153,582,571,10,1,566,16,1268,686,293,273,1,2451,0
5,"Bihor",26564,56,26564,,"MUNICIPIUL ORADEA",113,"Centrul de Recoltare a Sangelui Str. Louis Pasteur nr. 30",1522,802,782,20,0,797,5,1675,873,366,431,1,2451,0
5,"Bihor",26564,56,26564,,"MUNICIPIUL ORADEA",114,"Dispensar TBC   Aleea Strandului nr. 18",1692,880,859,21,0,866,14,1866,986,485,381,1,2451,0
5,"Bihor",26564,56,26564,,"MUNICIPIUL ORADEA",115,"Universitatea din Oradea Facultatea de Textile - Pielarie    fost Grup Scolar ""Roman Ciorogariu"")  Str.Barbu Stefanescu",1194,555,541,14,0,546,9,1315,760,263,283,1,2451,0
5,"Bihor",26564,56,26564,,"MUNICIPIUL ORADEA",116,"Universitatea din Oradea Facultatea de Textile - Pielarie    fost Grup Scolar ""Roman Ciorogariu"")  Str.Barbu Stefanescu",957,592,586,6,0,586,6,1055,463,229,357,1,2451,0
5,"Bihor",26564,56,26564,,"MUNICIPIUL ORADEA",117,"Liceul de arta  Parcul  Petofi nr.26",1245,583,565,18,0,573,10,1370,787,273,300,1,2451,0
5,"Bihor",26564,56,26564,,"MUNICIPIUL ORADEA",118,"Palatul Copiilor si al Elevilor    Str.Muzeului nr.2",1508,737,722,15,0,727,10,1659,922,348,379,1,2451,0
5,"Bihor",26564,56,26564,,"MUNICIPIUL ORADEA",119,"Colegiul National "" Mihai Eminescu "" Str. Roman Ciorogariu nr. 18",1547,639,622,17,0,630,9,1702,1063,338,292,1,2451,0
5,"Bihor",26564,56,26564,,"MUNICIPIUL ORADEA",120,"Scoala cu clasele I-VIII ""George Cosbuc""   fosta nr.9) Str. Mihai Eminescu nr. 28   intrarea A)",1480,772,752,19,1,753,19,1628,856,342,411,1,2451,0
5,"Bihor",26564,56,26564,,"MUNICIPIUL ORADEA",121,"Liceul Teoretic ""Ady Endre"" str. Moscovei nr. 1    intrarea A)",1465,686,674,12,0,683,3,1614,928,299,384,1,2451,0
5,"Bihor",26564,56,26564,,"MUNICIPIUL ORADEA",122,"Liceul Teoretic Reformat ""Lorantffy Zsuzsana""  fost Grup Scolar""Andrei Saguna"") Str. Andrei Saguna nr. 1  intrarea A)",1692,1163,876,13,274,1140,23,1866,703,595,545,1,2451,0
5,"Bihor",26564,56,26564,,"MUNICIPIUL ORADEA",123,"Casa de Cultura a Sindicatelor, Parcul 1 Decembrie  intrarea A)",1328,706,690,16,0,700,6,1462,756,320,380,1,2451,0
5,"Bihor",26564,56,26564,,"MUNICIPIUL ORADEA",124,"Casa de Cultura a Sindicatelor, Parcul 1 Decembrie  intrarea B)",1032,557,547,10,0,553,4,1135,578,232,321,1,2451,0
5,"Bihor",26564,56,26564,,"MUNICIPIUL ORADEA",125,"Liceul ""Aurel Lazar"" Str. Avram Iancu nr. 10",1068,415,404,11,0,411,4,1223,808,231,180,1,2451,0
5,"Bihor",26564,56,26564,,"MUNICIPIUL ORADEA",126,"Liceul Greco-Catolic  Str. Iuliu Maniu nr. 5   intrarea A)",1144,481,461,20,0,473,8,1259,778,287,186,1,2451,0
5,"Bihor",26564,56,26564,,"MUNICIPIUL ORADEA",127,"Liceul Greco-Catolic Str. Iuliu Maniu nr. 5  intrarea B)",1065,417,400,17,0,413,4,1172,755,215,198,1,2451,0
5,"Bihor",26564,56,26564,,"MUNICIPIUL ORADEA",128,"Liceul Pedagogic ""Iosif Vulcan""  Str. Jean Calvin nr.3  intrarea A)",941,414,400,14,0,410,4,1035,621,226,184,1,2451,0
5,"Bihor",26564,56,26564,,"MUNICIPIUL ORADEA",129,"Liceul Pedagogic ""Iosif Vulcan"" Str. Jean Calvin nr.3  intrarea B)",798,396,322,74,0,391,5,877,481,203,188,1,2451,0
5,"Bihor",26564,56,26564,,"MUNICIPIUL ORADEA",130,"Scoala cu clasele I-VIII  ""Decebal""  Piata Cazarmii nr. 7  intrarea A)",1481,686,671,15,0,678,8,1629,943,371,307,1,2451,0
5,"Bihor",26564,56,26564,,"MUNICIPIUL ORADEA",131,"Scoala cu clasele I-VIII  ""Decebal"" Piata Cazarmii nr.7  intrarea B)",1606,700,681,19,0,691,9,1767,1067,365,326,1,2451,0
5,"Bihor",26564,56,26564,,"MUNICIPIUL ORADEA",132,"Grup scolar ""Andrei Saguna""   fosta Scoala  cu clasele I-VIII ""Decebal"") Bulevardul Decebal nr. 60   intrarea A)",1214,564,558,6,0,561,3,1335,771,315,246,1,2451,0
5,"Bihor",26564,56,26564,,"MUNICIPIUL ORADEA",133,"Grup scolar ""Andrei Saguna""  fosta Scoala  cu clasele I-VIII ""Decebal"") Bulevardul Decebal nr. 60   intrarea A)",1347,752,732,20,0,747,5,1482,730,388,359,1,2451,0
5,"Bihor",26564,56,26564,,"MUNICIPIUL ORADEA",134,"Grup scolar ""Andrei Saguna""  fosta Scoala  cu clasele I-VIII ""Decebal"") Bulevardul Decebal nr. 60   intrarea A)",1252,659,646,13,0,656,3,1377,718,364,292,1,2451,0
5,"Bihor",26564,56,26564,,"MUNICIPIUL ORADEA",135,"Scoala cu clasele I-VIII  ""Decebal""   Str. William Shakespeare nr. 22",779,384,373,11,0,380,4,858,474,200,180,1,2451,0
5,"Bihor",26564,56,26564,,"MUNICIPIUL ORADEA",136,"Scoala cu clasele I-VIII  ""Decebal"" Str. William Shakespeare nr. 22",1102,625,614,11,0,618,7,1212,587,263,355,1,2451,0
5,"Bihor",26564,56,26564,,"MUNICIPIUL ORADEA",137,"Scoala cu clasele I-VIII ""Avram Iancu""   fosta nr.12) Str. Gheorghe Pop de Basesti nr. 3-5",1150,635,624,11,0,632,3,1263,628,292,340,1,2451,0
5,"Bihor",26564,56,26564,,"MUNICIPIUL ORADEA",138,"Scoala cu clasele I-VIII ""Avram Iancu""    fosta nr.12)   Str. Gheorghe Pop de Basesti nr. 3-5  intrarea B)",1114,598,589,9,0,589,9,1225,627,290,299,1,2451,0
5,"Bihor",26564,56,26564,,"MUNICIPIUL ORADEA",139,"Gradinita de copii nr. 44 Str. Aviatorilor nr. 2   intrarea A)",1263,785,762,23,0,779,6,1389,604,383,396,1,2451,0
5,"Bihor",26564,56,26564,,"MUNICIPIUL ORADEA",140,"Gradinita de copii nr. 44  Str. Aviatorilor nr.2  intrarea B)",1481,858,838,20,0,849,9,1629,771,401,448,1,2451,0
5,"Bihor",26564,56,26564,,"MUNICIPIUL ORADEA",141,"Fundatia de scleroza multipla   Str. Buzaului nr. 2/A",1442,595,579,16,0,593,2,1586,991,388,205,1,2451,0
5,"Bihor",26564,56,26564,,"MUNICIPIUL ORADEA",142,"Dispensarul Urban nr. 25  Str. Alexandru Roman Nr.2",1191,641,623,18,0,635,6,1310,669,341,294,1,2451,0
5,"Bihor",26564,56,26564,,"MUNICIPIUL ORADEA",143,"Imprimeria de Vest str. Calea Aradului  fosta Maresal Ion Antonescu ) nr. 105 numar vechi",2069,1042,1020,22,0,1034,8,2275,1233,543,491,1,2451,0
5,"Bihor",26564,56,26564,,"MUNICIPIUL ORADEA",144,"Spitalul Clinic Judetean 1 str. Gheorghe Doja nr. 65",0,289,0,289,0,282,7,500,211,162,120,1,2451,1
5,"Bihor",26564,56,26564,,"MUNICIPIUL ORADEA",145,"Universitatea din Oradea str. Universitatii nr.1",0,960,0,960,0,949,11,1300,340,559,390,1,2451,1
5,"Bihor",26564,56,26564,,"MUNICIPIUL ORADEA",146,"Campus Universitar Emanuel  str. Nufarului nr.87",0,585,0,585,0,578,7,642,57,396,182,1,2451,1
5,"Bihor",26564,56,26564,,"MUNICIPIUL ORADEA",147,"Gara C.F.R., sala de asteptare Piata Bucuresti nr.3",0,1680,0,1680,0,1663,17,2000,320,1080,583,1,2451,1
5,"Bihor",26804,56,26804,,"MUNICIPIUL BEIUS",148,"Primaria Beius str. Piata Samuil Vulcan nr. 14 - 16",1320,797,782,15,0,784,13,1452,655,353,431,1,2453,0
5,"Bihor",26804,56,26804,,"MUNICIPIUL BEIUS",149,"Liceul Pedagogic str Mihai Eminescu nr. 4",1333,831,819,12,0,821,10,1466,635,352,469,1,2453,0
5,"Bihor",26804,56,26804,,"MUNICIPIUL BEIUS",150,"Gradinita cu Program prelungit str. Romana nr. 4",1412,814,809,5,0,809,5,1554,740,352,457,1,2453,0
5,"Bihor",26804,56,26804,,"MUNICIPIUL BEIUS",151,"Colegiul tehnic Ioan Ciordas  str. Ioan Ciordas nr. 5",1361,838,825,13,0,828,10,1498,660,396,432,1,2453,0
5,"Bihor",26804,56,26804,,"MUNICIPIUL BEIUS",152,"Scoala generala str. Calea Bihorului nr.13",1431,897,883,14,0,887,10,1574,677,377,510,1,2453,0
5,"Bihor",26804,56,26804,,"MUNICIPIUL BEIUS",153,"Gradinita de copii str. Aleea Independentei nr. 8",1471,879,869,9,1,870,9,1537,658,376,494,1,2453,0
5,"Bihor",26804,56,26804,,"MUNICIPIUL BEIUS",154,"S.C. Candore S.R.L. Str. Traian nr. 14 B - parter",1049,684,667,16,1,677,7,1235,551,272,405,1,2453,0
5,"Bihor",26804,56,26804,,"MUNICIPIUL BEIUS",155,"Caminul cultural",311,216,209,5,2,214,2,342,126,114,100,1,2453,0
5,"Bihor",26804,56,26804,,"MUNICIPIUL BEIUS",156,"Scoala cu clasele I-VIII Nicolae Popoviciu str. Calea Bihorului nr. 13",0,336,0,336,0,334,2,400,64,170,164,1,2453,1
5,"Bihor",26877,56,26877,,"MUNICIPIUL MARGHITA",157,"Scoala cu clasele I-VIII  Piata Independentei nr. 1     sala 2",1535,724,708,13,3,720,4,1683,959,380,340,1,2456,0
5,"Bihor",26877,56,26877,,"MUNICIPIUL MARGHITA",158,"Scoala cu clasele I-VIII  Piata Independentei    nr. 1 sala 5",1495,698,682,16,0,692,6,1645,947,396,296,1,2456,0
5,"Bihor",26877,56,26877,,"MUNICIPIUL MARGHITA",159,"Casa de Cultura  Piata Inependentei nr. 20",1425,608,597,11,0,605,3,1573,965,371,234,1,2456,0
5,"Bihor",26877,56,26877,,"MUNICIPIUL MARGHITA",160,"Clubul Copiilor   Calea Republicii  nr. 9",1480,575,567,8,0,573,2,1628,1053,354,219,1,2456,0
5,"Bihor",26877,56,26877,,"MUNICIPIUL MARGHITA",161,"Scoala cu clasele I-VIII  str. Tudor  Vladimirescu  nr. 2 sala nr. 4",1401,624,606,17,1,614,10,1541,917,352,262,1,2456,0
5,"Bihor",26877,56,26877,,"MUNICIPIUL MARGHITA",162,"SC MARCOMF S.A. str. Liliacului nr. 22 Camin de nefamilisti - camera 1",1112,475,466,9,0,472,3,1223,748,271,201,1,2456,0
5,"Bihor",26877,56,26877,,"MUNICIPIUL MARGHITA",163,"SC MARCOMF S.A. str. Liliacului nr. 22 Camin de nefamilisti - camera 3",1141,533,525,8,0,521,12,1255,722,250,271,1,2456,0
5,"Bihor",26877,56,26877,,"MUNICIPIUL MARGHITA",164,"Colegiul National Octavian Goga str. Nicolae Balcescu nr. 80, sala 5",1439,628,624,3,1,620,8,1583,955,346,274,1,2456,0
5,"Bihor",26877,56,26877,,"MUNICIPIUL MARGHITA",165,"Colegiul National Octavian Goga str. Nicolae Balcescu nr. 80 sala 7",1407,646,642,4,0,643,3,1548,902,331,312,1,2456,0
5,"Bihor",26877,56,26877,,"MUNICIPIUL MARGHITA",166,"Colegiul National Octavian Goga str. Nicolae Balcescu nr. 80 sala 9",1443,615,609,5,1,609,6,1587,972,367,242,1,2456,0
5,"Bihor",26877,56,26877,,"MUNICIPIUL MARGHITA",167,"Scoala cu clasele I-VIII, Sat Chet",895,498,482,15,1,490,8,985,487,277,213,1,2456,0
5,"Bihor",26877,56,26877,,"MUNICIPIUL MARGHITA",168,"Scoala cu clasele I-VIII, Sat Ghenetea",619,305,294,11,0,304,1,681,376,185,119,1,2456,0
5,"Bihor",26877,56,26877,,"MUNICIPIUL MARGHITA",169,"Scoala cu clasele I-VIII str. Tudor  Vladimirescu  nr. 2 sala nr. 1",0,193,0,193,0,190,3,300,107,115,75,1,2456,1
5,"Bihor",26975,56,26975,,"MUNICIPIUL SALONTA",170,"Gradinita Toldi str. Republicii nr. 2",1551,715,699,16,0,708,7,1707,992,305,403,1,2460,0
5,"Bihor",26975,56,26975,,"MUNICIPIUL SALONTA",171,"Gradinita Floarea Soarelui str. Kulin  fosta Muncii) nr. 62",1403,605,586,19,0,587,18,1543,938,226,361,1,2460,0
5,"Bihor",26975,56,26975,,"MUNICIPIUL SALONTA",172,"Gradinita SCAZ - Micul Print str. Bocskai Istvan  fosta Crisului) nr. 21/A",1331,529,520,9,0,513,16,1464,935,186,327,1,2460,0
5,"Bihor",26975,56,26975,,"MUNICIPIUL SALONTA",173,"Gradinita Curcubeu str. Batthyanyi Lajos  fosta Portile de Fier) nr. 30",735,284,275,9,0,280,4,809,525,81,199,1,2460,0
5,"Bihor",26975,56,26975,,"MUNICIPIUL SALONTA",174,"Casa de cultura  Zilahy Lajos str. Iuliu Maniu  fosta 1 Mai) nr. 10",1523,565,559,6,0,559,6,1675,1110,218,341,1,2460,0
5,"Bihor",26975,56,26975,,"MUNICIPIUL SALONTA",175,"Gradinita Toldi str. Republicii nr. 2",1361,528,511,17,0,520,8,1497,969,219,301,1,2460,0
5,"Bihor",26975,56,26975,,"MUNICIPIUL SALONTA",176,"Colegiul National Arany Janos str. Republicii nr. 90",761,305,291,14,0,299,6,832,527,123,176,1,2460,0
5,"Bihor",26975,56,26975,,"MUNICIPIUL SALONTA",177,"Gradinita Ursulet str. Republicii nr. 113",1484,676,648,28,0,670,6,1632,956,303,367,1,2460,0
5,"Bihor",26975,56,26975,,"MUNICIPIUL SALONTA",178,"Gradinita Ursulet str. Republicii nr. 113",672,248,238,10,0,246,2,739,491,110,136,1,2460,0
5,"Bihor",26975,56,26975,,"MUNICIPIUL SALONTA",179,"Casa Sfantul Anton str. Republicii nr. 72",511,218,208,10,0,217,1,562,344,91,126,1,2460,0
5,"Bihor",26975,56,26975,,"MUNICIPIUL SALONTA",180,"Scoala generala str. Ion Creanga nr. 1",1196,500,487,13,0,489,11,1316,816,259,230,1,2460,0
5,"Bihor",26975,56,26975,,"MUNICIPIUL SALONTA",181,"Gradinita Alba ca Zapada str. Bihorului nr. 49",1708,746,730,16,0,740,6,1879,1133,275,465,1,2460,0
5,"Bihor",26975,56,26975,,"MUNICIPIUL SALONTA",182,"Grupul Scolar Agricol str. Sarcadului   nr. 1",811,450,423,27,0,447,3,893,443,223,224,1,2460,0
5,"Bihor",26975,56,26975,,"MUNICIPIUL SALONTA",183,"Gradinita Prichindel str. Olimpiadei  fosta Steagul Rosu) nr. 32",868,386,377,9,0,384,2,955,569,121,263,1,2460,0
5,"Bihor",26975,56,26975,,"MUNICIPIUL SALONTA",184,"Scoala generala Fuvaskert str. Andrei Muresan  fosta Crangului) nr. 1",748,414,404,10,0,410,4,823,409,192,218,1,2460,0
5,"Bihor",26975,56,26975,,"MUNICIPIUL SALONTA",185,"Spitalul Municipal Salonta",0,218,0,218,0,214,4,300,82,96,118,1,2460,1
5,"Bihor",26699,56,26699,,"ORAS ALESD",186,"Primarie - sala mare str. Bobalna nr. 3",1572,886,873,10,3,882,4,1729,843,401,481,1,2462,0
5,"Bihor",26699,56,26699,,"ORAS ALESD",187,"Scoala cu clasele I-VIII Constantin Serban - Cartier Soimul nr. 1 bis",1914,894,881,13,0,882,12,2105,1211,488,394,1,2462,0
5,"Bihor",26699,56,26699,,"ORAS ALESD",188,"Colegiul Alexandru Roman str. Ciocarliei nr. 4",1319,667,645,22,0,661,6,1451,784,379,282,1,2462,0
5,"Bihor",26699,56,26699,,"ORAS ALESD",189,"Scoala clasele I-IV str. Avram Iancu     nr. 5",1665,1060,1045,15,0,1044,16,1832,772,610,434,1,2462,0
5,"Bihor",26699,56,26699,,"ORAS ALESD",190,"Scoala generala, Sat Padurea Neagra",710,311,308,3,0,307,4,782,471,186,121,1,2462,0
5,"Bihor",26699,56,26699,,"ORAS ALESD",191,"Scoala cu clasele I-IV, Sat Pestis",1173,680,674,6,0,670,10,1290,610,424,246,1,2462,0
5,"Bihor",26699,56,26699,,"ORAS ALESD",192,"Gradinita, Sat Tinaud",655,389,382,7,0,386,3,721,332,198,188,1,2462,0
5,"Bihor",26699,56,26699,,"ORAS ALESD",193,"Sediul fostei case de bilete Autobazei  actualmente fara destinatie) str. Paraului      nr.1-3",0,206,0,206,0,206,0,250,44,117,89,1,2462,1
5,"Bihor",26920,56,26920,,"ORAS NUCET",194,"Scoala cu clasele I-VIII",1115,835,819,9,7,823,12,1227,392,469,354,1,2467,0
5,"Bihor",26920,56,26920,,"ORAS NUCET",195,"Caminul cultural, Sat Baita",557,378,362,8,8,372,6,613,235,197,175,1,2467,0
5,"Bihor",26920,56,26920,,"ORAS NUCET",196,"Scoala cu clasele I-VIII",0,62,0,62,0,60,2,100,38,33,27,1,2467,1
5,"Bihor",30915,56,30915,,"ORAS SACUENI",197,"Scoala generala str. Petofi Sandor nr. 19",1012,341,328,13,0,336,5,1113,772,132,204,1,2471,0
5,"Bihor",30915,56,30915,,"ORAS SACUENI",198,"Fosta librarie  actualmente sala de sport), Piata Libertatii nr. 32",1128,404,392,12,0,388,16,1241,837,120,268,1,2471,0
5,"Bihor",30915,56,30915,,"ORAS SACUENI",199,"Cladirea fostului liceu Petofi Sandor  actualmente domeniul privat al orasului Sacueni) str. Irinyi Janos nr. 1",1630,812,732,80,0,773,39,1793,981,178,595,1,2471,0
5,"Bihor",30915,56,30915,,"ORAS SACUENI",200,"Gradinita cu program prelungit str. Morii nr. 58",1252,371,360,11,0,361,10,1377,1006,144,217,1,2471,0
5,"Bihor",30915,56,30915,,"ORAS SACUENI",201,"Scoala generala str. Infratirii nr. 4",955,301,289,12,0,296,5,1051,750,101,195,1,2471,0
5,"Bihor",30915,56,30915,,"ORAS SACUENI",202,"Scoala generala, Sat Cadea",929,233,224,9,0,218,15,1022,789,105,113,1,2471,0
5,"Bihor",30915,56,30915,,"ORAS SACUENI",203,"Fostul sediu al primariei  actualmente Clubul Tineretului), Sat Ciocaia",764,233,223,10,0,223,10,842,609,66,157,1,2471,0
5,"Bihor",30915,56,30915,,"ORAS SACUENI",204,"Scoala generala Noua  actualmente Dispensar Veterinar), Sat Cubulcut",737,259,249,10,0,225,34,811,552,125,100,1,2471,0
5,"Bihor",30915,56,30915,,"ORAS SACUENI",205,"Scoala generala, Sat Olosig",437,114,105,9,0,107,7,481,367,60,47,1,2471,0
5,"Bihor",30915,56,30915,,"ORAS SACUENI",206,"Scoala generala, Sat Sinnicolau de Munte",670,284,264,20,0,271,13,737,453,108,163,1,2471,0
5,"Bihor",30915,56,30915,,"ORAS SACUENI",207,"Scoala generala str. Libertatii nr. 33",0,56,0,56,0,53,3,200,144,18,35,1,2471,1
5,"Bihor",26840,56,26840,,"ORAS STEI",208,"Casa de cultura ""Miron Pompiliu"" str. Cuza Voda nr. 11",1289,703,689,13,1,696,7,1318,615,354,342,1,2478,0
5,"Bihor",26840,56,26840,,"ORAS STEI",209,"Scoala cu clasele I-IV str. Tineretului nr. 2",1093,639,629,10,0,633,6,1202,563,248,385,1,2478,0
5,"Bihor",26840,56,26840,,"ORAS STEI",210,"Colegiu Tehnic  Unirea str. Independentei nr. 19 A",1455,826,809,17,0,820,6,1601,775,386,434,1,2478,0
5,"Bihor",26840,56,26840,,"ORAS STEI",211,"Colegiu Tehnic Unirea Scoala Profesionala  Auto str. Independentei nr. 31",1503,801,787,14,0,791,10,1653,852,451,340,1,2478,0
5,"Bihor",26840,56,26840,,"ORAS STEI",212,"Scoala cu clasele I-VIII Miron Pompiliu  str. Nicolae Iorga     nr. 28",1470,878,867,8,3,873,5,1617,739,383,490,1,2478,0
5,"Bihor",26840,56,26840,,"ORAS STEI",213,"Case de cultura ""Miron Pompiliu"" - Biroul Managerului Casei de Cultura str. Cuza Voda nr. 11",0,258,0,258,0,255,3,350,92,163,92,1,2478,1
5,"Bihor",32027,56,32027,,"ORAS VALEA LUI MIHAI",214,"Scoala generala str. Marton Aron nr. 38",1482,393,382,11,0,389,4,1630,1237,140,249,1,2480,0
5,"Bihor",32027,56,32027,,"ORAS VALEA LUI MIHAI",215,"Centrul de sanatate  Calea Revolutiei nr. 50",1080,262,251,11,0,259,3,1188,926,90,169,1,2480,0
5,"Bihor",32027,56,32027,,"ORAS VALEA LUI MIHAI",216,"Scoala generala str. Kalvin Janos nr. 5",1498,421,409,11,1,416,5,1647,1226,162,254,1,2480,0
5,"Bihor",32027,56,32027,,"ORAS VALEA LUI MIHAI",217,"Scoala generala str. Republicii nr. 47 Sala nr. 1",1342,401,388,12,1,395,6,1480,1079,144,251,1,2480,0
5,"Bihor",32027,56,32027,,"ORAS VALEA LUI MIHAI",218,"Scoala generala str. Apaczai-Csere Janos nr. 2",1356,290,281,9,0,285,5,1492,1202,139,146,1,2480,0
5,"Bihor",32027,56,32027,,"ORAS VALEA LUI MIHAI",219,"Scoala generala  str. II Rakoczi Ferenc nr. 32- sala nr. 1",1129,296,282,14,0,285,11,1242,946,108,177,1,2480,0
5,"Bihor",32027,56,32027,,"ORAS VALEA LUI MIHAI",220,"Scoala generala  str. II Rakoczi Ferenc nr. 32- sala nr. 2",1242,263,252,11,0,259,4,1366,1103,119,140,1,2480,0
5,"Bihor",32027,56,32027,,"ORAS VALEA LUI MIHAI",221,"Scoala generala str. Republicii nr. 47 Sala nr. 2",0,59,0,59,0,58,1,200,141,29,29,1,2480,1
5,"Bihor",27007,56,27007,,"ORAS VASCAU",222,"Casa de cultura str. Unirii nr.75",1505,1035,1024,2,9,1016,19,1656,621,470,546,1,2482,0
5,"Bihor",27007,56,27007,,"ORAS VASCAU",223,"Caminul cultural, Sat Cimp",244,182,172,8,2,180,2,268,86,72,108,1,2482,0
5,"Bihor",27007,56,27007,,"ORAS VASCAU",224,"Scoala generala, Sat Cimp Moti",68,49,37,8,4,48,1,76,27,27,21,1,2482,0
5,"Bihor",27007,56,27007,,"ORAS VASCAU",225,"Camin cultural, Sat Colesti",142,110,102,4,4,110,0,156,46,38,72,1,2482,0
5,"Bihor",27007,56,27007,,"ORAS VASCAU",226,"Camin cultural, Sat Varzarii de Jos",218,152,148,3,1,152,0,240,88,86,66,1,2482,0
5,"Bihor",27007,56,27007,,"ORAS VASCAU",227,"Camin cultural, Sat Varzarii de Sus",118,78,72,6,0,78,0,130,52,40,38,1,2482,0
5,"Bihor",27007,56,27007,,"ORAS VASCAU",228,"Sala de sport - corp A,",0,206,0,206,0,206,0,250,44,139,67,1,2482,1
5,"Bihor",27070,56,27070,,"ABRAM",229,"Primaria, Sat Abram",731,436,414,22,0,432,4,804,368,223,209,3,2489,0
5,"Bihor",27070,56,27070,,"ABRAM",230,"Camin cultural, Sat Cohani",109,68,62,6,0,66,2,120,52,31,35,3,2489,0
5,"Bihor",27070,56,27070,,"ABRAM",231,"Scoala clasele I-IV, Sat Dijir",241,147,139,8,0,146,1,265,118,51,95,3,2489,0
5,"Bihor",27070,56,27070,,"ABRAM",232,"Camin cultural, Sat Iteu",398,216,209,7,0,214,2,438,222,83,131,3,2489,0
5,"Bihor",27070,56,27070,,"ABRAM",233,"Scoala clasele I-IV, Sat Margine",435,298,291,7,0,295,3,479,181,190,105,3,2489,0
5,"Bihor",27070,56,27070,,"ABRAM",234,"Scoala clasele I-IV, Sat Satu Barba",217,139,132,7,0,139,0,239,100,79,60,3,2489,0
5,"Bihor",27070,56,27070,,"ABRAM",235,"Scoala clasele I-IV, Sat Suiug",370,232,227,5,0,224,8,409,177,80,144,3,2489,0
5,"Bihor",27070,56,27070,,"ABRAM",236,"Scoala cu clasele I-VIII Abram, Sat Abram",0,82,0,82,0,82,0,150,68,33,49,3,2489,1
5,"Bihor",27169,56,27169,,"ABRAMUT",237,"Scoala generala, Sat Abramut",367,171,161,10,0,169,2,404,233,128,41,3,2498,0
5,"Bihor",27169,56,27169,,"ABRAMUT",238,"Scoala generala, Sat Fancica",274,134,127,7,0,132,2,301,167,96,36,3,2498,0
5,"Bihor",27169,56,27169,,"ABRAMUT",239,"Scoala generala, Sat Crestur",367,151,144,7,0,145,6,404,253,94,51,3,2498,0
5,"Bihor",27169,56,27169,,"ABRAMUT",240,"Gradinita de copii, Sala A, Sat Petreu",1325,542,528,14,0,526,16,1458,916,288,238,3,2498,0
5,"Bihor",27169,56,27169,,"ABRAMUT",241,"Gradinita de copii, Sala B, Sat Petreu",0,27,0,27,0,27,0,50,23,23,4,3,2498,1
5,"Bihor",26742,56,26742,,"ASTILEU",242,"Scoala Noua, Sat Astileu",1256,734,726,8,0,724,10,1382,648,371,353,3,2503,0
5,"Bihor",26742,56,26742,,"ASTILEU",243,"Scoala generala, Sat Calatea",379,201,195,6,0,199,2,417,216,80,119,3,2503,0
5,"Bihor",26742,56,26742,,"ASTILEU",244,"Bloc Cornet, Sat Calatea",264,148,143,5,0,146,2,290,142,65,81,3,2503,0
5,"Bihor",26742,56,26742,,"ASTILEU",245,"Camin cultural, Sat Chistag",498,324,314,10,0,321,3,548,224,132,189,3,2503,0
5,"Bihor",26742,56,26742,,"ASTILEU",246,"Scoala clasele I-IV , sala de sport, Sat Pestere",663,445,441,4,0,439,6,729,284,203,236,3,2503,0
5,"Bihor",26742,56,26742,,"ASTILEU",247,"Scoala cu clasele I-VII - cladirea veche, Sat Astileu",0,102,0,102,0,102,0,150,48,48,54,3,2503,1
5,"Bihor",27212,56,27212,,"AUSEU",248,"Primaria, Sat Auseu",781,434,419,4,11,429,5,859,425,274,155,3,2508,0
5,"Bihor",27212,56,27212,,"AUSEU",249,"Scoala cu clasele I-IV, Sat Grosi",828,428,417,11,0,423,5,928,500,225,198,3,2508,0
5,"Bihor",27212,56,27212,,"AUSEU",250,"Camin cultural, Sat Luncsoara",752,459,450,9,0,454,5,827,368,202,252,3,2508,0
5,"Bihor",27212,56,27212,,"AUSEU",251,"Scoala cu clasele I-VIII,",0,63,0,63,0,60,3,150,87,36,24,3,2508,1
5,"Bihor",27285,56,27285,,"AVRAM IANCU",252,"Scoala veche, sala de sport, Sat Avram Iancu",1553,977,962,10,5,965,12,1708,731,292,673,3,2515,0
5,"Bihor",27285,56,27285,,"AVRAM IANCU",253,"Birou primarie, Sat Ant",159,98,91,7,0,98,0,175,77,34,64,3,2515,0
5,"Bihor",27285,56,27285,,"AVRAM IANCU",254,"Gradinita, Sat Tamasda",855,517,508,9,0,497,20,941,424,189,308,3,2515,0
5,"Bihor",27285,56,27285,,"AVRAM IANCU",255,"Scoala cu clasele I-IV, Sat Avram Iancu",0,88,0,88,0,88,0,200,112,38,50,3,2515,1
5,"Bihor",27329,56,27329,,"BALC",256,"Camin cultural, Sat Balc",1059,473,461,12,0,465,8,1167,694,300,165,3,2519,0
5,"Bihor",27329,56,27329,,"BALC",257,"Scoala cu clasele I-VIII, Sat Almasu Mare",685,357,351,6,0,346,11,754,397,211,135,3,2519,0
5,"Bihor",27329,56,27329,,"BALC",258,"Scoala cu clasele I-IV, Sat Almasu Mic",319,192,186,6,0,188,4,351,159,128,60,3,2519,0
5,"Bihor",27329,56,27329,,"BALC",259,"Scoala cu clasele I-VIII, Sat Saldabagiu de Barcau",422,244,238,6,0,243,1,464,220,174,69,3,2519,0
5,"Bihor",27329,56,27329,,"BALC",260,"Scoala cu clasele I-IV, Sat Ghida",126,75,69,6,0,72,3,139,64,43,29,3,2519,0
5,"Bihor",27329,56,27329,,"BALC",261,"Scoala cu clasele I-VIII, Sat Balc",0,53,0,53,0,53,0,200,147,36,17,3,2519,1
5,"Bihor",27383,56,27383,,"BATAR",262,"Scoala generala, Sat Batar",1293,639,628,11,0,629,10,1422,783,260,369,3,2525,0
5,"Bihor",27383,56,27383,,"BATAR",263,"Scoala generala, Sat Arpasel",724,203,197,6,0,199,4,796,593,81,118,3,2525,0
5,"Bihor",27383,56,27383,,"BATAR",264,"Gradinita, Sat Talpos",1233,608,591,17,0,600,8,1356,748,350,250,3,2525,0
5,"Bihor",27383,56,27383,,"BATAR",265,"Gradinita, Sat Taut",770,403,399,4,0,395,8,847,444,113,282,3,2525,0
5,"Bihor",27383,56,27383,,"BATAR",266,"Scoala cu clasele I-VIII, Sat Batar",0,82,0,82,0,82,0,100,18,37,45,3,2525,1
5,"Bihor",27436,56,27436,,"BIHARIA",267,"Camin cultural, Sat Biharia",1495,396,389,7,0,392,4,1645,1249,210,182,3,2530,0
5,"Bihor",27436,56,27436,,"BIHARIA",268,"Gradinita, Sat Biharia",1388,422,411,11,0,418,4,1527,1105,219,199,3,2530,0
5,"Bihor",27436,56,27436,,"BIHARIA",269,"Casa Comunala nr.203, Sat Cauaceu",594,213,207,6,0,204,9,653,440,97,107,3,2530,0
5,"Bihor",27436,56,27436,,"BIHARIA",270,"Scoala cu clasele I-VIII Gaspar Andras, Sat Biharia",0,55,0,55,0,54,1,150,95,20,34,3,2530,1
5,"Bihor",27506,56,27506,,"BOIANU MARE",271,"Scoala cu clasele I-IV, Sat Boianu Mare",521,279,272,7,0,269,10,573,294,147,122,3,2533,0
5,"Bihor",27506,56,27506,,"BOIANU MARE",272,"Scoala cu clasele I-VIII, Sat Pagaia",573,334,325,9,0,330,4,630,296,152,178,3,2533,0
5,"Bihor",27506,56,27506,,"BOIANU MARE",273,"Camin cultural, Sat Pagaia",0,37,0,37,0,36,1,50,13,25,11,3,2533,1
5,"Bihor",27560,56,27560,,"BOROD",274,"Camin cultural, Sat Borod",1252,796,783,13,0,784,12,1377,581,603,181,3,2539,0
5,"Bihor",27560,56,27560,,"BOROD",275,"Scoala generala, Sat Borozel",511,352,347,5,0,343,9,562,210,207,136,3,2539,0
5,"Bihor",27560,56,27560,,"BOROD",276,"Gradinita, Sat Cetea",211,158,151,7,0,154,4,232,74,98,56,3,2539,0
5,"Bihor",27560,56,27560,,"BOROD",277,"Scoala clasele I-IV, Sat Cornitel",430,267,263,4,0,264,3,473,206,165,99,3,2539,0
5,"Bihor",27560,56,27560,,"BOROD",278,"Scoala clasele I-IV, Sat Valea Mare",389,271,268,3,0,267,4,428,157,209,58,3,2539,0
5,"Bihor",27560,56,27560,,"BOROD",279,"Scoala clasele I-IV, Sat Serani I",175,122,109,13,0,122,0,193,71,90,32,3,2539,0
5,"Bihor",27560,56,27560,,"BOROD",280,"Scoala generala, Sat Serani II",191,121,112,9,0,119,2,210,89,87,32,3,2539,0
5,"Bihor",27560,56,27560,,"BOROD",281,"Scoala cu clasele I-VIII, Sat Borod",0,124,0,124,0,123,1,300,176,90,33,3,2539,1
5,"Bihor",27631,56,27631,,"BORS",282,"Camin cultural, Sat Bors",1103,438,413,9,16,431,7,1213,775,200,231,3,2546,0
5,"Bihor",27631,56,27631,,"BORS",283,"Gradinita, Sat Sintion",1396,506,488,8,10,500,6,1536,1030,226,274,3,2546,0
5,"Bihor",27631,56,27631,,"BORS",284,"Scoala generala, Sat Santaul Mare",316,136,125,9,2,133,3,350,214,69,64,3,2546,0
5,"Bihor",27631,56,27631,,"BORS",285,"Scoala generala, Sat Santaul Mic",393,158,140,11,7,158,0,433,275,69,89,3,2546,0
5,"Bihor",27631,56,27631,,"BORS",286,"Punct de Trecere Frontiera Bors, Sat Bors",0,228,0,228,0,228,0,500,272,140,88,3,2546,1
5,"Bihor",27686,56,27686,,"BRATCA",287,"Primaria, sala de sedinta, Sat Bratca",1263,816,799,11,6,811,5,1389,573,318,493,3,2551,0
5,"Bihor",27686,56,27686,,"BRATCA",288,"Camin cultural, Sat Beznea",1120,628,617,10,1,618,10,1232,604,298,320,3,2551,0
5,"Bihor",27686,56,27686,,"BRATCA",289,"Scoala generala, Sat Damis",518,355,347,8,0,353,2,570,215,171,182,3,2551,0
5,"Bihor",27686,56,27686,,"BRATCA",290,"Scoala generala, Sat Ponoara",537,356,348,8,0,351,5,591,235,258,93,3,2551,0
5,"Bihor",27686,56,27686,,"BRATCA",291,"Camin cultural, Sat Lorau",377,215,208,7,0,212,3,415,200,113,99,3,2551,0
5,"Bihor",27686,56,27686,,"BRATCA",292,"Camin cultural, Sat Valea Crisului",391,263,254,9,0,261,2,430,167,137,124,3,2551,0
5,"Bihor",27686,56,27686,,"BRATCA",293,"Statia CFR Bratca, Sat Bratca",0,136,0,136,0,134,2,200,64,62,72,3,2551,1
5,"Bihor",27757,56,27757,,"BRUSTURI",294,"Scoala generala, Sala A, Sat Brusturi",995,557,545,12,0,553,4,1095,538,325,228,3,2558,0
5,"Bihor",27757,56,27757,,"BRUSTURI",295,"Scoala generala, Sat Cuiesd",415,261,250,11,0,260,1,457,196,102,158,3,2558,0
5,"Bihor",27757,56,27757,,"BRUSTURI",296,"Scoala generala, Sat Orvisele",388,232,220,10,2,231,1,427,195,104,127,3,2558,0
5,"Bihor",27757,56,27757,,"BRUSTURI",297,"Scoala generala, Sat Paulesti",281,176,163,9,4,176,0,310,134,96,80,3,2558,0
5,"Bihor",27757,56,27757,,"BRUSTURI",298,"Scoala generala, Sat Picleu",738,454,444,10,0,452,2,812,358,230,222,3,2558,0
5,"Bihor",27757,56,27757,,"BRUSTURI",299,"Scoala generala, Sat Tiganesti de Cris",280,160,151,9,0,158,2,308,148,61,97,3,2558,0
5,"Bihor",27757,56,27757,,"BRUSTURI",300,"Scoala generala, Sala B, Sat Brusturi",0,177,0,177,0,177,0,200,23,94,83,3,2558,1
5,"Bihor",27846,56,27846,,"BUDUREASA",301,"Camin cultural, Sat Budureasa",875,596,593,3,0,591,5,963,367,326,265,3,2567,0
5,"Bihor",27846,56,27846,,"BUDUREASA",302,"Scoala clasele I-IV, Sat Grui",297,261,249,12,0,260,1,327,66,106,154,3,2567,0
5,"Bihor",27846,56,27846,,"BUDUREASA",303,"Camin cultural, Sat Burda",331,231,225,6,0,231,0,364,133,131,100,3,2567,0
5,"Bihor",27846,56,27846,,"BUDUREASA",304,"Camin cultural, Sat Saca",165,115,111,4,0,113,2,182,67,69,44,3,2567,0
5,"Bihor",27846,56,27846,,"BUDUREASA",305,"Camin cultural, Sat Teleac",142,110,103,7,0,110,0,156,46,49,61,3,2567,0
5,"Bihor",27846,56,27846,,"BUDUREASA",306,"Camin cultural, Sat Saliste de Beius",225,151,146,5,0,151,0,248,97,89,62,3,2567,0
5,"Bihor",27846,56,27846,,"BUDUREASA",307,"Scoala cu clasele I-VIII, Sat Budureasa",0,45,0,45,0,45,0,150,105,26,19,3,2567,1
5,"Bihor",27908,56,27908,,"BUDUSLAU",308,"Primarie, Sat Buduslau",810,208,201,7,0,203,5,891,683,110,93,3,2573,0
5,"Bihor",27908,56,27908,,"BUDUSLAU",309,"Scoala generala, Sat Albis",761,118,114,4,0,116,2,837,719,47,69,3,2573,0
5,"Bihor",27908,56,27908,,"BUDUSLAU",310,"Scoala generala, Sat Buduslau",0,19,0,19,0,19,0,50,31,12,7,3,2573,1
5,"Bihor",27935,56,27935,,"BULZ",311,"Primaria, Sat Bulz",752,464,456,4,4,462,2,827,363,249,213,3,2576,0
5,"Bihor",27935,56,27935,,"BULZ",312,"Scoala clasele I-IV, Sat Munteni",438,283,267,16,0,281,2,482,199,185,96,3,2576,0
5,"Bihor",27935,56,27935,,"BULZ",313,"Scoala generala, Sat Remeti",667,451,443,6,2,448,3,734,283,259,189,3,2576,0
5,"Bihor",27935,56,27935,,"BULZ",314,"Scoala cu clasele I-VIII Remeti, Sat Remeti",0,135,0,135,0,135,0,200,65,80,55,3,2576,1
5,"Bihor",27971,56,27971,,"BUNTESTI",315,"Primaria, Sat Buntesti",473,365,343,7,15,364,1,520,155,240,124,3,2580,0
5,"Bihor",27971,56,27971,,"BUNTESTI",316,"Scoala cu clasele I-IV, Sat Bradet",579,425,413,6,6,423,2,637,212,285,138,3,2580,0
5,"Bihor",27971,56,27971,,"BUNTESTI",317,"Camin cultural, Sat Dumbravani",265,200,191,9,0,200,0,292,92,78,122,3,2580,0
5,"Bihor",27971,56,27971,,"BUNTESTI",318,"Scoala cu clasele I-IV, Sat Ferice",417,300,287,7,6,300,0,459,159,229,71,3,2580,0
5,"Bihor",27971,56,27971,,"BUNTESTI",319,"Scoala cu clasele I-IV, Sat Lelesti",377,302,296,6,0,301,1,415,113,191,110,3,2580,0
5,"Bihor",27971,56,27971,,"BUNTESTI",320,"Scoala cu clasele I-IV, Sat Poieni de Jos",517,351,342,9,0,348,3,569,218,181,167,3,2580,0
5,"Bihor",27971,56,27971,,"BUNTESTI",321,"Scoala cu clasele I-IV, Sat Poieni de Sus",565,423,413,5,5,422,1,622,199,271,151,3,2580,0
5,"Bihor",27971,56,27971,,"BUNTESTI",322,"Scoala cu clasele I-IV, Sat Saud",337,256,248,4,4,256,0,371,115,163,93,3,2580,0
5,"Bihor",27971,56,27971,,"BUNTESTI",323,"Scoala generala, Sat Stincesti",273,211,207,4,0,208,3,300,89,116,92,3,2580,0
5,"Bihor",27971,56,27971,,"BUNTESTI",324,"Scoala cu clasele I-VIII, Sat Buntesti",0,180,0,180,0,179,1,400,220,113,66,3,2580,1
5,"Bihor",28077,56,28077,,"CABESTI",325,"Camin cultural, Sat Cabesti",760,432,430,2,0,430,2,837,405,245,185,3,2590,0
5,"Bihor",28077,56,28077,,"CABESTI",326,"Scoala cu clasele I-IV, Sat Josani",412,239,235,4,0,238,1,459,220,109,129,3,2590,0
5,"Bihor",28077,56,28077,,"CABESTI",327,"Camin cultural, Sat Goila",171,106,99,7,0,106,0,188,82,51,55,3,2590,0
5,"Bihor",28077,56,28077,,"CABESTI",328,"Camin cultural, Sat Sohodol",255,173,168,5,0,170,3,283,110,79,91,3,2590,0
5,"Bihor",28077,56,28077,,"CABESTI",329,"Gradinita, Sat Cabesti",0,69,0,69,0,69,0,150,81,38,31,3,2590,1
5,"Bihor",28139,56,28139,,"CAPALNA",330,"Primaria, Sat Capilna",295,230,211,6,13,230,0,325,95,57,173,3,2602,0
5,"Bihor",28139,56,28139,,"CAPALNA",331,"Cladirea fostei scoli clasele I-IV, Sat Rohani",109,71,62,4,5,71,0,120,49,22,49,3,2602,0
5,"Bihor",28139,56,28139,,"CAPALNA",332,"Scoala cu clasele I-IV, Sat Ginta",252,133,115,8,10,132,1,277,144,38,94,3,2602,0
5,"Bihor",28139,56,28139,,"CAPALNA",333,"Scoala cu clasele I-IV, Sat Saldabagiu Mic",420,322,286,4,32,318,4,462,140,167,151,3,2602,0
5,"Bihor",28139,56,28139,,"CAPALNA",334,"Scoala cu clasele I-IV, Sat Suplacu de Tinca",359,236,222,7,7,228,8,395,159,67,161,3,2602,0
5,"Bihor",28139,56,28139,,"CAPALNA",335,"Scoala cu clasele I-IV, Sat Capilna",0,191,0,191,0,191,0,250,59,73,118,3,2602,1
5,"Bihor",28193,56,28193,,"CARPINET",336,"Camin cultural, Sat Carpinet",440,330,325,4,1,326,4,584,254,152,174,3,2608,0
5,"Bihor",28193,56,28193,,"CARPINET",337,"Camin cultural, Sat Calugari",467,310,302,4,4,308,2,514,204,165,143,3,2608,0
5,"Bihor",28193,56,28193,,"CARPINET",338,"Camin cultural, Sat Izbuc",483,360,352,3,5,356,4,530,170,177,179,3,2608,0
5,"Bihor",28193,56,28193,,"CARPINET",339,"Camin cultural, Sat Leheceni",328,225,224,1,0,225,0,361,136,137,88,3,2608,0
5,"Bihor",28193,56,28193,,"CARPINET",340,"Gradinita, Sat Carpinet",0,82,0,82,0,82,0,150,68,41,41,3,2608,1
5,"Bihor",28246,56,28246,,"CEFA",341,"Centru de asistenta in afaceri, Sat Cefa",1054,734,688,11,35,730,4,1159,425,241,489,3,2613,0
5,"Bihor",28246,56,28246,,"CEFA",342,"Gradinita, Sat Ateas",156,123,116,7,0,122,1,172,49,68,54,3,2613,0
5,"Bihor",28246,56,28246,,"CEFA",343,"Camin cultural, Sat Inand",676,456,445,11,0,449,7,744,288,246,203,3,2613,0
5,"Bihor",28246,56,28246,,"CEFA",344,"Scoala cu clasele I-IV, Sat Inand",0,115,0,115,0,113,2,200,85,48,65,3,2613,1
5,"Bihor",28335,56,28335,,"CEICA",345,"Primaria, Sat Ceica",751,431,423,7,1,428,3,826,395,228,200,3,2617,0
5,"Bihor",28335,56,28335,,"CEICA",346,"Scoala generala, Sat Bucium",187,129,121,8,0,129,0,206,77,49,80,3,2617,0
5,"Bihor",28335,56,28335,,"CEICA",347,"Scoala generala, Sat Ceisoara",505,288,276,12,0,286,2,556,268,165,121,3,2617,0
5,"Bihor",28335,56,28335,,"CEICA",348,"Scoala generala, Sat Corbesti",429,234,229,5,0,231,3,473,239,141,90,3,2617,0
5,"Bihor",28335,56,28335,,"CEICA",349,"Scoala generala, Sat Cotiglet",364,223,213,10,0,221,2,400,177,105,116,3,2617,0
5,"Bihor",28335,56,28335,,"CEICA",350,"Camin cultural, Sat Dusesti",436,265,257,8,0,262,3,480,215,143,119,3,2617,0
5,"Bihor",28335,56,28335,,"CEICA",351,"Scoala generala, Sat Incesti",323,164,158,6,0,163,1,355,191,81,82,3,2617,0
5,"Bihor",28335,56,28335,,"CEICA",352,"Scoala generala, Sat Ceica",0,111,0,111,0,111,0,300,189,59,52,3,2617,1
5,"Bihor",28415,56,28415,,"CETARIU",353,"Gradinita, Sala A, Sat Cetariu",912,316,308,8,0,313,3,1005,689,100,213,3,2625,0
5,"Bihor",28415,56,28415,,"CETARIU",354,"Camin cultural, Sat Tautelec",192,150,142,8,0,143,7,213,63,19,124,3,2625,0
5,"Bihor",28415,56,28415,,"CETARIU",355,"Gradinita, Sat Sisterea",495,168,161,7,0,166,2,547,379,51,115,3,2625,0
5,"Bihor",28415,56,28415,,"CETARIU",356,"Scoala generala, Sat Susturogiu",207,98,87,11,0,95,3,228,130,43,52,3,2625,0
5,"Bihor",28415,56,28415,,"CETARIU",357,"Gradinita, Sala B, Sat Cetariu",0,42,0,42,0,42,0,150,108,12,30,3,2625,1
5,"Bihor",28497,56,28497,,"CHERECHIU",358,"Scoala cu clasele I-VIII, corp gradinita, Sat Cherechiu",614,168,161,7,0,166,2,675,507,50,116,3,2630,0
5,"Bihor",28497,56,28497,,"CHERECHIU",359,"Scoala generala, Sat Chesereu",826,214,201,13,0,205,9,909,695,69,136,3,2630,0
5,"Bihor",28497,56,28497,,"CHERECHIU",360,"Camin cultural, Sat Tirgusor",441,199,186,13,0,185,14,485,286,77,108,3,2630,0
5,"Bihor",28497,56,28497,,"CHERECHIU",361,"Sala de spectacole, Sat Cherechiu",0,17,0,17,0,17,0,50,33,7,10,3,2630,1
5,"Bihor",28530,56,28530,,"CHISLAZ",362,"Scoala generala, Sat Chislaz",422,187,177,10,0,185,2,464,277,100,85,3,2634,0
5,"Bihor",28530,56,28530,,"CHISLAZ",363,"Scoala generala, Sat Chiraleu",499,281,271,10,0,278,3,549,268,155,123,3,2634,0
5,"Bihor",28530,56,28530,,"CHISLAZ",364,"Scoala generala, Sat Haucesti",34,30,20,10,0,29,1,37,7,12,17,3,2634,0
5,"Bihor",28530,56,28530,,"CHISLAZ",365,"Scoala generala, Sat Misca",770,296,288,8,0,288,8,847,551,113,175,3,2634,0
5,"Bihor",28530,56,28530,,"CHISLAZ",366,"Scoala generala, Sat Poclusa de Barcau",302,140,131,9,0,139,1,332,192,82,57,3,2634,0
5,"Bihor",28530,56,28530,,"CHISLAZ",367,"Scoala generala, Sat Sarsig",235,145,138,7,0,145,0,259,114,77,68,3,2634,0
5,"Bihor",28530,56,28530,,"CHISLAZ",368,"Scoala generala, Sat Sinlazar",357,193,183,10,0,192,1,393,200,116,76,3,2634,0
5,"Bihor",28530,56,28530,,"CHISLAZ",369,"Camin cultural, Sat Chislaz",0,63,0,63,0,63,0,150,87,37,26,3,2634,1
5,"Bihor",28610,56,28610,,"CIUHOI",370,"Scoala generala, Sat Ciuhoi",306,162,158,4,0,161,1,337,175,100,61,3,2642,0
5,"Bihor",28610,56,28610,,"CIUHOI",371,"Scoala clasele I-IV, Sat Cenalos",228,121,114,7,0,117,4,251,130,79,38,3,2642,0
5,"Bihor",28610,56,28610,,"CIUHOI",372,"Scoala clasele I-IV, Sat Sfirnas",226,115,106,9,0,114,1,249,134,72,42,3,2642,0
5,"Bihor",28610,56,28610,,"CIUHOI",373,"Fost sediul CAP, actualmente punct de lucru a primariei, Sat Siniob",1006,423,417,6,0,415,8,1107,684,160,255,3,2642,0
5,"Bihor",28610,56,28610,,"CIUHOI",374,"Camin cultural, Sat Ciuhoi",0,54,0,54,0,54,0,100,46,31,23,3,2642,1
5,"Bihor",28665,56,28665,,"CIUMEGHIU",375,"Primaria, Sat Ciumeghiu",1406,894,860,7,27,884,10,1547,653,632,252,3,2647,0
5,"Bihor",28665,56,28665,,"CIUMEGHIU",376,"Scoala generala, Sat  Boiu",636,258,246,12,0,256,2,700,442,148,108,3,2647,0
5,"Bihor",28665,56,28665,,"CIUMEGHIU",377,"Scoala generala, Sat Ghiorac",1378,622,612,10,0,611,11,1516,894,323,288,3,2647,0
5,"Bihor",28665,56,28665,,"CIUMEGHIU",378,"Scoala generala, Sat Ciumeghiu",0,129,0,129,0,129,0,150,21,73,56,3,2647,1
5,"Bihor",28709,56,28709,,"CAMPANI",379,"Camin cultural, Sat Campani",726,507,500,6,1,496,11,804,297,234,262,3,2596,0
5,"Bihor",28709,56,28709,,"CAMPANI",380,"Scoala generala, Sat Finate",558,403,401,2,0,402,1,614,211,159,243,3,2596,0
5,"Bihor",28709,56,28709,,"CAMPANI",381,"Scoala generala, Sat Hirsesti",294,197,189,8,0,194,3,323,126,106,88,3,2596,0
5,"Bihor",28709,56,28709,,"CAMPANI",382,"Scoala generala, Sat Sighistel",296,215,211,4,0,214,1,326,111,120,94,3,2596,0
5,"Bihor",28709,56,28709,,"CAMPANI",383,"Scoala generala, Sat Valea de Sus",275,211,205,6,0,209,2,303,92,75,134,3,2596,0
5,"Bihor",28709,56,28709,,"CAMPANI",384,"Scoala generala, Sat Campani",0,65,0,65,0,65,0,150,85,28,37,3,2596,1
5,"Bihor",28763,56,28763,,"COCIUBA MARE",385,"Scoala generala, Sat Cociuba Mare",782,563,530,4,29,561,2,860,297,374,187,3,2651,0
5,"Bihor",28763,56,28763,,"COCIUBA MARE",386,"Scoala generala, Sat Chesa",528,347,327,12,8,342,5,581,234,185,157,3,2651,0
5,"Bihor",28763,56,28763,,"COCIUBA MARE",387,"Scoala generala ,cladirea noua, Sat Carasau",573,345,320,5,20,338,7,630,285,172,166,3,2651,0
5,"Bihor",28763,56,28763,,"COCIUBA MARE",388,"Scoala generala, cladirea noua, Sat Petid",523,391,364,5,22,387,4,575,184,125,262,3,2651,0
5,"Bihor",28763,56,28763,,"COCIUBA MARE",389,"Baza sportiva, Sat Cociuba Mare",0,165,0,165,0,165,0,200,35,104,61,3,2651,1
5,"Bihor",28816,56,28816,,"COPACEL",390,"Gradinita, Sat Copacel",320,177,168,6,3,170,7,352,175,100,70,3,2656,0
5,"Bihor",28816,56,28816,,"COPACEL",391,"Scoala generala, Sat Bucuroaia",341,191,183,8,0,185,6,375,184,111,74,3,2656,0
5,"Bihor",28816,56,28816,,"COPACEL",392,"Gradinita, Sat Chijic",217,145,135,10,0,143,2,240,95,75,68,3,2656,0
5,"Bihor",28816,56,28816,,"COPACEL",393,"Scoala generala, Sat Poiana Tasad",152,105,97,8,0,105,0,167,62,61,44,3,2656,0
5,"Bihor",28816,56,28816,,"COPACEL",394,"Scoala generala, Sat Sarand",410,224,211,13,0,217,7,452,228,129,88,3,2656,0
5,"Bihor",28816,56,28816,,"COPACEL",395,"Scoala generala, Sat Surduc",372,185,177,8,0,184,1,409,224,101,83,3,2656,0
5,"Bihor",28816,56,28816,,"COPACEL",396,"Scoala cu clasele I-IV, Sat Copacel",0,125,0,125,0,125,0,150,25,61,64,3,2656,1
5,"Bihor",28889,56,28889,,"CRISTIORU DE JOS",397,"Scoala clasele I-IV, Sat Cristioru de Jos",317,181,174,4,3,180,1,349,168,86,94,3,2663,0
5,"Bihor",28889,56,28889,,"CRISTIORU DE JOS",398,"Camin cultural, Sat Cristioru de Sus",109,57,48,9,0,57,0,120,63,32,25,3,2663,0
5,"Bihor",28889,56,28889,,"CRISTIORU DE JOS",399,"Scoala cu clasele I-IV, Sala A, Sat Poiana",435,282,275,6,1,279,3,479,197,123,156,3,2663,0
5,"Bihor",28889,56,28889,,"CRISTIORU DE JOS",400,"Scoala generala, Sat Saliste de Vascau",379,261,248,6,7,258,3,417,156,135,123,3,2663,0
5,"Bihor",28889,56,28889,,"CRISTIORU DE JOS",401,"Scoala cu clasele I-IV, Sala B, Sat Cristioru de Jos",0,58,0,58,0,58,0,150,92,32,26,3,2663,1
5,"Bihor",28941,56,28941,,"CURATELE",402,"Scoala generala, Sat Curatele",660,408,396,7,5,405,3,726,318,210,195,3,2669,0
5,"Bihor",28941,56,28941,,"CURATELE",403,"Scoala cu clasele I-IV, Sat Beiusele",397,332,312,8,12,325,7,437,105,240,85,3,2669,0
5,"Bihor",28941,56,28941,,"CURATELE",404,"Scoala cu clasele I-IV, Sat Cresuia",401,315,301,6,8,315,0,441,126,212,103,3,2669,0
5,"Bihor",28941,56,28941,,"CURATELE",405,"Camin cultural, Sat Nimaiesti",703,456,449,7,0,455,1,773,317,232,223,3,2669,0
5,"Bihor",28941,56,28941,,"CURATELE",406,"Scoala generala, sala de sport, Sat Curatele",0,71,0,71,0,71,0,100,29,39,32,3,2669,1
5,"Bihor",29001,56,29001,,"CURTUISENI",407,"Camin cultural, Sat Curtuiseni",1235,341,331,10,0,333,8,1359,1018,144,189,3,2675,0
5,"Bihor",29001,56,29001,,"CURTUISENI",408,"Scoala generala, Sat Curtuiseni",1002,314,305,9,0,304,10,1102,788,118,186,3,2675,0
5,"Bihor",29001,56,29001,,"CURTUISENI",409,"Scoala generala, Sat Vasad",714,418,401,17,0,412,6,785,367,182,230,3,2675,0
5,"Bihor",29001,56,29001,,"CURTUISENI",410,"Scoala generala, Sat Curtuiseni",0,52,0,52,0,51,1,150,98,23,28,3,2675,1
5,"Bihor",29038,56,29038,,"DERNA",411,"Primaria, Sat Derna",802,432,419,8,5,431,1,882,450,223,208,3,2678,0
5,"Bihor",29038,56,29038,,"DERNA",412,"Scoala generala, Sat Dernisoara",458,243,233,10,0,238,5,504,261,133,105,3,2678,0
5,"Bihor",29038,56,29038,,"DERNA",413,"Scoala generala, Sat Sacalasau",501,254,249,5,0,253,1,551,297,119,134,3,2678,0
5,"Bihor",29038,56,29038,,"DERNA",414,"Scoala generala, Sat Sacalasau-Nou",241,106,96,10,0,102,4,265,159,45,57,3,2678,0
5,"Bihor",29038,56,29038,,"DERNA",415,"Scoala generala, Sat Tria",286,181,167,14,0,176,5,315,134,31,145,3,2678,0
5,"Bihor",29038,56,29038,,"DERNA",416,"Camin cultural, Sat Derna",0,74,0,74,0,73,1,150,76,36,37,3,2678,1
5,"Bihor",29092,56,29092,,"DIOSIG",417,"Primaria  str. Livezilor nr. 32, Sat Diosig",1001,277,272,5,0,272,5,1101,824,95,177,3,2684,0
5,"Bihor",29092,56,29092,,"DIOSIG",418,"Scoala noua str. Livezilor nr. 134, Sat Diosig",926,245,234,11,0,241,4,1019,774,75,166,3,2684,0
5,"Bihor",29092,56,29092,,"DIOSIG",419,"Scoala clasele I-IV  str. Argesului nr.13, Sat Diosig",951,294,286,8,0,290,4,1046,752,142,148,3,2684,0
5,"Bihor",29092,56,29092,,"DIOSIG",420,"Scoala clasele I-IV  str. Horea nr. 116, Sat Diosig",1343,620,607,13,0,618,2,1477,857,376,242,3,2684,0
5,"Bihor",29092,56,29092,,"DIOSIG",421,"Scoala clasele I-IV  str. M. Viteazu nr.113, Sat Diosig",874,505,485,20,0,472,33,961,456,240,232,3,2684,0
5,"Bihor",29092,56,29092,,"DIOSIG",422,"Scoala clasele I-IV  str. Marasesti nr. 15, Sat Ianca",230,77,66,11,0,75,2,253,176,40,35,3,2684,0
5,"Bihor",29092,56,29092,,"DIOSIG",423,"Statia CFR Diosig, Sat Diosig",0,88,0,88,0,87,1,150,62,39,48,3,2684,1
5,"Bihor",29154,56,29154,,"DOBRESTI",424,"Camin cultural, Parter, Sat Dobresti",1430,815,806,9,0,802,13,1575,760,455,347,3,2687,0
5,"Bihor",29154,56,29154,,"DOBRESTI",425,"Camin cultural, Sat Luncasprie",806,385,379,6,0,384,1,887,502,225,159,3,2687,0
5,"Bihor",29154,56,29154,,"DOBRESTI",426,"Camin cultural, Sat Hidisel",524,283,276,7,0,281,2,576,293,170,111,3,2687,0
5,"Bihor",29154,56,29154,,"DOBRESTI",427,"Camin cultural, Sat Crincesti",375,203,198,5,0,202,1,413,210,64,138,3,2687,0
5,"Bihor",29154,56,29154,,"DOBRESTI",428,"Camin cultural, Sat Cornisesti",200,129,122,7,0,129,0,220,91,54,75,3,2687,0
5,"Bihor",29154,56,29154,,"DOBRESTI",429,"Scoala clasele I-IV, Sat Topa de Jos",169,106,99,7,0,106,0,186,80,54,52,3,2687,0
5,"Bihor",29154,56,29154,,"DOBRESTI",430,"Camin cultural, Sat Topa de Sus",526,288,281,7,0,286,2,580,292,130,156,3,2687,0
5,"Bihor",29154,56,29154,,"DOBRESTI",431,"Camin cultural, Etaj, Sat Dobresti",0,116,0,116,0,115,1,200,84,71,44,3,2687,1
5,"Bihor",29243,56,29243,,"DRAGANESTI",432,"Primaria, Sat Draganesti",363,254,248,6,0,251,3,399,145,99,152,3,2696,0
5,"Bihor",29243,56,29243,,"DRAGANESTI",433,"Scoala primara, Sat Belejeni",241,201,197,4,0,200,1,265,64,40,160,3,2696,0
5,"Bihor",29243,56,29243,,"DRAGANESTI",434,"Scoala Romana, Sat Gradinari",350,205,193,12,0,203,2,385,180,92,111,3,2696,0
5,"Bihor",29243,56,29243,,"DRAGANESTI",435,"Scoala primara, Sat Livada Beiusului",113,93,88,5,0,92,1,124,31,41,51,3,2696,0
5,"Bihor",29243,56,29243,,"DRAGANESTI",436,"Fostul Sfat Popular, actualmente cabinet medical, Sat Mizies",398,264,257,7,0,264,0,438,174,118,146,3,2696,0
5,"Bihor",29243,56,29243,,"DRAGANESTI",437,"Scoala primara, Sat Pantasesti",127,101,96,5,0,101,0,140,39,48,53,3,2696,0
5,"Bihor",29243,56,29243,,"DRAGANESTI",438,"Scoala primara, Sat Sebis",260,167,159,8,0,167,0,286,119,79,88,3,2696,0
5,"Bihor",29243,56,29243,,"DRAGANESTI",439,"Scoala primara, Sat Talpe",221,146,140,6,0,144,2,243,97,72,72,3,2696,0
5,"Bihor",29243,56,29243,,"DRAGANESTI",440,"Camin cultural, Sat Tiganesti de Beius",122,97,90,7,0,96,1,134,37,35,61,3,2696,0
5,"Bihor",29243,56,29243,,"DRAGANESTI",441,"Scoala primara, Sat Pacalesti",190,125,121,4,0,124,1,209,84,43,81,3,2696,0
5,"Bihor",29243,56,29243,,"DRAGANESTI",442,"Camin cultural, Sat Draganesti",0,79,0,79,0,79,0,100,21,29,50,3,2696,1
5,"Bihor",29341,56,29341,,"DRAGESTI",443,"Primaria, Sat Dragesti",290,195,183,5,7,192,3,319,124,111,81,3,2706,0
5,"Bihor",29341,56,29341,,"DRAGESTI",444,"Camin cultural, Sat Dicanesti",211,147,138,8,1,146,1,232,85,106,40,3,2706,0
5,"Bihor",29341,56,29341,,"DRAGESTI",445,"Scoala clasele I-IV, Sat Stracos",212,169,155,9,5,169,0,233,64,103,66,3,2706,0
5,"Bihor",29341,56,29341,,"DRAGESTI",446,"Scoala generala, Sat Tasad",918,582,569,10,3,574,8,1015,433,423,151,3,2706,0
5,"Bihor",29341,56,29341,,"DRAGESTI",447,"Scoala clasele I-IV, Sat Topesti",180,115,105,10,0,115,0,200,85,47,68,3,2706,0
5,"Bihor",29341,56,29341,,"DRAGESTI",448,"Scoala cu clasele I-VIII, Sat Dragesti",0,126,0,126,0,125,1,250,124,81,44,3,2706,1
5,"Bihor",29403,56,29403,,"FINIS",449,"Primaria, Sat Finis",1432,707,703,4,0,697,10,1575,868,341,356,3,2712,0
5,"Bihor",29403,56,29403,,"FINIS",450,"Camin cultural, Sat Fizis",197,139,135,4,0,138,1,217,78,72,66,3,2712,0
5,"Bihor",29403,56,29403,,"FINIS",451,"Scoala generala, Sat Ioanis",570,350,331,19,0,346,4,627,277,137,209,3,2712,0
5,"Bihor",29403,56,29403,,"FINIS",452,"Gradinita, Sat Suncuis",616,311,301,10,0,309,2,678,367,228,81,3,2712,0
5,"Bihor",29403,56,29403,,"FINIS",453,"Scoala cu clasele I-VIII, Sat Finis",0,56,0,56,0,56,0,150,94,26,30,3,2712,1
5,"Bihor",32195,56,32195,,"GEPIU",454,"Scoala generala, Sat Gepiu",868,487,471,16,0,482,5,906,419,228,254,3,2718,0
5,"Bihor",32195,56,32195,,"GEPIU",455,"Scoala clasele I - IV, Sat Bicaci",459,308,294,14,0,304,4,505,197,230,74,3,2718,0
5,"Bihor",32195,56,32195,,"GEPIU",456,"Scoala cu clasele I-VIII, Sat Gepiu",0,165,0,165,0,161,4,200,35,65,96,3,2718,1
5,"Bihor",29467,56,29467,,"GIRISU DE CRIS",457,"Primaria, Sat Girisu de Cris",1156,631,620,10,1,625,6,1273,642,375,250,3,2721,0
5,"Bihor",29467,56,29467,,"GIRISU DE CRIS",458,"Scoala generala, Sat Tarian",863,388,381,7,0,387,1,949,561,212,175,3,2721,0
5,"Bihor",29467,56,29467,,"GIRISU DE CRIS",459,"Camin cultural, Sat Tarian",860,422,417,5,0,405,17,946,524,255,150,3,2721,0
5,"Bihor",29467,56,29467,,"GIRISU DE CRIS",460,"Scoala generala, Sat Girisu de Cris",0,109,0,109,0,109,0,150,41,47,62,3,2721,1
5,"Bihor",29519,56,29519,,"HIDISELU DE SUS",461,"Camin cultural, Sat Hidiselu de Sus",836,583,572,11,0,583,0,924,341,306,277,3,2724,0
5,"Bihor",29519,56,29519,,"HIDISELU DE SUS",462,"Gradinita, Sat Hidiselu de Jos",457,308,298,10,0,305,3,505,197,184,121,3,2724,0
5,"Bihor",29519,56,29519,,"HIDISELU DE SUS",463,"Camin cultural, Sat Mierlau",619,382,373,9,0,381,1,683,301,137,244,3,2724,0
5,"Bihor",29519,56,29519,,"HIDISELU DE SUS",464,"Scoala cu clasele I-IV, Sat Sintelec",275,194,184,10,0,189,5,305,111,67,122,3,2724,0
5,"Bihor",29519,56,29519,,"HIDISELU DE SUS",465,"Camin cultural, Sat Sumugiu",303,167,159,8,0,161,6,334,167,58,103,3,2724,0
5,"Bihor",29519,56,29519,,"HIDISELU DE SUS",466,"Scoala cu clasele I-VIII, Sat Hidiselu de Sus",0,283,0,283,0,282,1,300,17,186,96,3,2724,1
5,"Bihor",29573,56,29573,,"HOLOD",467,"Scoala generala, Sat Holod",419,225,219,3,3,225,0,461,236,93,132,3,2730,0
5,"Bihor",29573,56,29573,,"HOLOD",468,"Camin cultural, Sat Dumbrava",409,258,241,11,6,251,7,450,192,139,112,3,2730,0
5,"Bihor",29573,56,29573,,"HOLOD",469,"Camin cultural, Sat Dumbravita",179,127,111,11,5,126,1,197,70,83,43,3,2730,0
5,"Bihor",29573,56,29573,,"HOLOD",470,"Camin cultural, Sat Forosig",133,97,86,11,0,97,0,146,49,44,53,3,2730,0
5,"Bihor",29573,56,29573,,"HOLOD",471,"Camin cultural, Sat Hodis",166,89,81,8,0,87,2,183,94,39,48,3,2730,0
5,"Bihor",29573,56,29573,,"HOLOD",472,"Camin cultural, Sat Lupoaia",368,240,231,9,0,235,5,405,165,149,86,3,2730,0
5,"Bihor",29573,56,29573,,"HOLOD",473,"Scoala clasele I-IV, Sat Valea Mare de Codru",71,47,37,9,1,47,0,78,31,14,33,3,2730,0
5,"Bihor",29573,56,29573,,"HOLOD",474,"Camin cultural, Sat Vintere",654,414,398,8,8,413,1,719,305,195,218,3,2730,0
5,"Bihor",29573,56,29573,,"HOLOD",475,"Gradinita, Sat Holod",0,229,0,229,0,223,6,450,221,116,107,3,2730,1
5,"Bihor",29662,56,29662,,"HUSASAU DE TINCA",476,"Gradinita, Sala A, Sat Husasau de Tinca",592,306,300,6,0,303,3,651,345,190,113,3,2739,0
5,"Bihor",29662,56,29662,,"HUSASAU DE TINCA",477,"Scoala clasele I-IV, Sat Fonau",152,84,79,5,0,82,2,167,83,53,29,3,2739,0
5,"Bihor",29662,56,29662,,"HUSASAU DE TINCA",478,"Scoala clasele I-IV, Sat Miersig",297,182,167,7,8,181,1,327,145,106,75,3,2739,0
5,"Bihor",29662,56,29662,,"HUSASAU DE TINCA",479,"Scoala clasele I-IV., Sat Osand",368,215,209,6,0,208,7,405,190,126,82,3,2739,0
5,"Bihor",29662,56,29662,,"HUSASAU DE TINCA",480,"Scoala clasele I-IV, Sat Sititelec",291,173,162,11,0,168,5,320,147,122,46,3,2739,0
5,"Bihor",29662,56,29662,,"HUSASAU DE TINCA",481,"Gradinita, Sala B, Sat Husasau de Tinca",0,197,0,197,0,195,2,250,53,138,57,3,2739,1
5,"Bihor",29724,56,29724,,"INEU",482,"Camin cultural, Sala A, Sat Ineu",824,419,413,6,0,415,4,906,487,270,145,3,2745,0
5,"Bihor",29724,56,29724,,"INEU",483,"Gradinita Ineu, Sat Ineu",866,470,454,16,0,457,13,954,484,192,265,3,2745,0
5,"Bihor",29724,56,29724,,"INEU",484,"Scoala generala, Sat Botean",522,234,225,9,0,229,5,574,340,127,102,3,2745,0
5,"Bihor",29724,56,29724,,"INEU",485,"Scoala generala, Sat Husasau de Cris",791,411,401,10,0,411,0,870,459,207,204,3,2745,0
5,"Bihor",29724,56,29724,,"INEU",486,"Camin cultural, Sala B, Sat Ineu",0,176,0,176,0,174,2,300,124,88,86,3,2745,1
5,"Bihor",29760,56,29760,,"LAZURI DE BEIUS",487,"Primaria, Sat Lazuri de Beius",292,180,171,8,1,178,2,321,141,110,68,3,2758,0
5,"Bihor",29760,56,29760,,"LAZURI DE BEIUS",488,"Scoala clasele I - IV, Sat Cusuius",396,249,241,8,0,248,1,436,187,123,125,3,2758,0
5,"Bihor",29760,56,29760,,"LAZURI DE BEIUS",489,"Scoala generala, Sat Hinchiris",570,375,365,7,3,370,5,627,252,169,201,3,2758,0
5,"Bihor",29760,56,29760,,"LAZURI DE BEIUS",490,"Scoala clasele I - IV, Sat Baleni",183,119,112,7,0,118,1,201,82,71,47,3,2758,0
5,"Bihor",29760,56,29760,,"LAZURI DE BEIUS",491,"Scoala cu clasele I-VIII, Sat Lazuri de Beius",0,60,0,60,0,60,0,200,140,27,33,3,2758,1
5,"Bihor",29813,56,29813,,"LAZARENI",492,"Camin cultural, Sat Lazareni",544,347,328,19,0,338,9,598,251,145,193,3,2749,0
5,"Bihor",29813,56,29813,,"LAZARENI",493,"Scoala generala, Sat Carandeni",319,190,182,7,1,187,3,351,161,87,100,3,2749,0
5,"Bihor",29813,56,29813,,"LAZARENI",494,"Camin cultural, Sat Caranzel",77,50,40,10,0,48,2,85,35,18,30,3,2749,0
5,"Bihor",29813,56,29813,,"LAZARENI",495,"Scoala generala, Sat Calea Mare",516,311,296,15,0,309,2,570,259,91,218,3,2749,0
5,"Bihor",29813,56,29813,,"LAZARENI",496,"Camin cultural, Sat Gepis",483,282,270,12,0,277,5,536,254,88,189,3,2749,0
5,"Bihor",29813,56,29813,,"LAZARENI",497,"Camin cultural, Sat Gruilung",98,61,52,9,0,61,0,108,47,31,30,3,2749,0
5,"Bihor",29813,56,29813,,"LAZARENI",498,"Camin cultural, Sat Miheleu",156,89,81,8,0,89,0,173,84,44,45,3,2749,0
5,"Bihor",29813,56,29813,,"LAZARENI",499,"Scoala cu clasele I-VIII, Sat Lazareni",0,125,0,125,0,124,1,250,125,52,72,3,2749,1
5,"Bihor",29902,56,29902,,"LUGASU DE JOS",500,"Camin cultural, Sat Lugasu de Jos",1168,623,605,14,4,611,12,1288,665,333,278,3,2763,0
5,"Bihor",29902,56,29902,,"LUGASU DE JOS",501,"Camin cultural, Sat Lugasu de Sus",680,394,387,7,0,389,5,749,355,232,157,3,2763,0
5,"Bihor",29902,56,29902,,"LUGASU DE JOS",502,"Camin cultural, Sat Urvind",764,480,440,12,28,475,5,846,366,202,273,3,2763,0
5,"Bihor",29902,56,29902,,"LUGASU DE JOS",503,"Camin cultural, sala mica, Sat Lugasu de Jos",0,67,0,67,0,67,0,200,133,48,19,3,2763,1
5,"Bihor",29948,56,29948,,"LUNCA",504,"Camin cultural, Sala A, Sat Lunca",802,531,518,4,9,529,2,882,351,287,242,3,2767,0
5,"Bihor",29948,56,29948,,"LUNCA",505,"Camin cultural, Sat Briheni",305,248,226,7,15,245,3,336,88,182,63,3,2767,0
5,"Bihor",29948,56,29948,,"LUNCA",506,"Camin cultural, Sat Hotarel",263,192,183,4,5,191,1,289,97,120,71,3,2767,0
5,"Bihor",29948,56,29948,,"LUNCA",507,"Camin cultural, Sat Sustiu",385,305,286,7,12,304,1,424,119,166,138,3,2767,0
5,"Bihor",29948,56,29948,,"LUNCA",508,"Scoala generala, Sat Sirbesti",268,223,201,8,14,221,2,295,72,136,85,3,2767,0
5,"Bihor",29948,56,29948,,"LUNCA",509,"Camin cultural, Sat Seghiste",509,450,426,5,19,448,2,560,110,379,69,3,2767,0
5,"Bihor",29948,56,29948,,"LUNCA",510,"Camin cultural, Sala B, Sat Lunca",0,150,0,150,0,150,0,200,50,107,43,3,2767,1
5,"Bihor",30014,56,30014,,"MADARAS",511,"Scoala generala, Sat Madaras",766,464,442,8,14,461,3,843,379,260,201,3,2774,0
5,"Bihor",30014,56,30014,,"MADARAS",512,"Scoala clasele I-IV, Sat Homorog",618,393,384,6,3,391,2,680,287,216,175,3,2774,0
5,"Bihor",30014,56,30014,,"MADARAS",513,"Scoala generala, Sat Ianosda",754,432,421,6,5,430,2,829,397,170,260,3,2774,0
5,"Bihor",30014,56,30014,,"MADARAS",514,"Camin cultural, Sat Martihaz",173,123,110,12,1,122,1,190,67,83,39,3,2774,0
5,"Bihor",30014,56,30014,,"MADARAS",515,"Camin cultural, Sat Ianosda",0,117,0,117,0,117,0,200,83,62,55,3,2774,1
5,"Bihor",30069,56,30069,,"MAGESTI",516,"Primaria, Sat Magesti",214,153,143,8,2,151,2,236,83,78,73,3,2779,0
5,"Bihor",30069,56,30069,,"MAGESTI",517,"Scoala generala, Sat Butan",304,203,199,4,0,200,3,334,131,92,108,3,2779,0
5,"Bihor",30069,56,30069,,"MAGESTI",518,"Scoala primara, Sat Josani",311,194,189,5,0,192,2,342,148,116,76,3,2779,0
5,"Bihor",30069,56,30069,,"MAGESTI",519,"Camin cultural, Sat Dobricionesti",449,305,292,7,6,298,7,501,196,175,123,3,2779,0
5,"Bihor",30069,56,30069,,"MAGESTI",520,"Scoala  primara, Sat Galaseni",253,193,186,7,0,193,0,278,85,145,48,3,2779,0
5,"Bihor",30069,56,30069,,"MAGESTI",521,"Scoala  primara, Sat Cacuciu Nou",274,179,168,6,5,178,1,301,122,92,86,3,2779,0
5,"Bihor",30069,56,30069,,"MAGESTI",522,"Scoala primara, Sat Ortiteag",380,305,289,11,5,305,0,418,113,246,59,3,2779,0
5,"Bihor",30069,56,30069,,"MAGESTI",523,"Scoala generala, Sat Magesti",0,122,0,122,0,121,1,250,128,82,39,3,2779,1
5,"Bihor",30149,56,30149,,"NOJORID",524,"Scoala generala, Sala 1, Sat Nojorid",1408,929,917,12,0,926,3,1550,621,621,305,3,2787,0
5,"Bihor",30149,56,30149,,"NOJORID",525,"Scoala clasele I-IV, Sat Apateu",184,109,100,9,0,105,4,202,93,61,44,3,2787,0
5,"Bihor",30149,56,30149,,"NOJORID",526,"Scoala clasele I-IV, Sat Chisirid",147,81,69,12,0,81,0,162,81,56,25,3,2787,0
5,"Bihor",30149,56,30149,,"NOJORID",527,"Scoala generala, Sat Les",552,288,279,9,0,287,1,607,319,160,127,3,2787,0
5,"Bihor",30149,56,30149,,"NOJORID",528,"Gradinita Livada de Bihor, Sat Livada de Bihor",1038,612,596,16,0,609,3,1142,530,415,194,3,2787,0
5,"Bihor",30149,56,30149,,"NOJORID",529,"Scoala clasele I-IV., Sat Pausa",205,156,148,8,0,156,0,226,70,55,101,3,2787,0
5,"Bihor",30149,56,30149,,"NOJORID",530,"Scoala clasele I-IV, Sat Sauaieu",256,163,150,8,5,161,2,283,120,66,95,3,2787,0
5,"Bihor",30149,56,30149,,"NOJORID",531,"Scoala cu clasele I-VIII, Sala 4, Sat Nojorid",0,252,0,252,0,251,1,500,248,103,148,3,2787,1
5,"Bihor",30229,56,30229,,"OLCEA",532,"Scoala generala, Sat Olcea",485,350,331,7,12,348,2,535,185,249,99,3,2795,0
5,"Bihor",30229,56,30229,,"OLCEA",533,"Scoala generala, Sat Calacea",931,672,642,7,23,662,10,1027,355,466,196,3,2795,0
5,"Bihor",30229,56,30229,,"OLCEA",534,"Scoala generala, Sat Hodisel",303,252,230,6,16,251,1,333,81,154,97,3,2795,0
5,"Bihor",30229,56,30229,,"OLCEA",535,"Scoala cu clasele I-IV, Sat Ucuris",459,288,258,9,21,282,6,505,217,173,109,3,2795,0
5,"Bihor",30229,56,30229,,"OLCEA",536,"Scoala cu clasele I-IV, Sat Calacea",0,87,0,87,0,85,2,200,113,47,38,3,2795,1
5,"Bihor",30274,56,30274,,"OSORHEI",537,"Scoala generala - sala A, Sat Osorhei",1184,549,538,11,0,545,4,1302,753,287,258,3,2800,0
5,"Bihor",30274,56,30274,,"OSORHEI",538,"Scoala generala - sala B, Sat Osorhei",1227,588,570,17,1,579,9,1350,762,309,270,3,2800,0
5,"Bihor",30274,56,30274,,"OSORHEI",539,"Scoala generala, Sat Alparea",803,505,498,7,0,498,7,883,378,253,245,3,2800,0
5,"Bihor",30274,56,30274,,"OSORHEI",540,"Scoala generala, Sat Cheriu",516,321,307,14,0,314,7,568,247,119,195,3,2800,0
5,"Bihor",30274,56,30274,,"OSORHEI",541,"Scoala generala, Sat Felcheriu",260,186,178,8,0,184,2,286,100,72,112,3,2800,0
5,"Bihor",30274,56,30274,,"OSORHEI",542,"Camin cultural, Sat Fughiu",802,432,422,10,0,429,3,882,450,217,212,3,2800,0
5,"Bihor",30274,56,30274,,"OSORHEI",543,"Scoala cu clasele I-VIII, Sat Osorhei",0,180,0,180,0,178,2,350,170,72,106,3,2800,1
5,"Bihor",32161,56,32161,,"PALEU",544,"Scoala generala, Sat Paleu",609,275,264,11,0,271,4,670,395,133,138,3,2806,0
5,"Bihor",32161,56,32161,,"PALEU",545,"Scoala generala, Sat Uileacu de Munte",428,163,154,9,0,159,4,471,308,54,105,3,2806,0
5,"Bihor",32161,56,32161,,"PALEU",546,"Scoala generala, Sat Saldabagiu de Munte",573,209,198,11,0,198,11,630,421,117,81,3,2806,0
5,"Bihor",32161,56,32161,,"PALEU",547,"Casa de cultura, Sat Paleu",0,42,0,42,0,41,1,100,58,18,23,3,2806,1
5,"Bihor",30336,56,30336,,"PIETROASA",548,"Scoala generala, Sat Pietroasa",719,465,461,4,0,460,5,791,326,160,300,3,2810,0
5,"Bihor",30336,56,30336,,"PIETROASA",549,"Scoala clasele I-IV, Sat Gurani",541,325,317,8,0,324,1,595,270,177,147,3,2810,0
5,"Bihor",30336,56,30336,,"PIETROASA",550,"Scoala clasele I-IV, Sat Cociuba Mica",353,207,201,6,0,204,3,388,181,89,115,3,2810,0
5,"Bihor",30336,56,30336,,"PIETROASA",551,"Scoala generala, Sat Chiscau",632,386,376,10,0,385,1,695,309,238,147,3,2810,0
5,"Bihor",30336,56,30336,,"PIETROASA",552,"Scoala clasele I-IV, Sat Giulesti",128,86,83,3,0,84,2,141,55,43,41,3,2810,0
5,"Bihor",30336,56,30336,,"PIETROASA",553,"Scoala clasele I-IV, Sat Magura",254,161,156,5,0,161,0,279,118,68,93,3,2810,0
5,"Bihor",30336,56,30336,,"PIETROASA",554,"Scoala clasele I-IV, Sat Motesti",87,61,56,5,0,61,0,96,35,27,34,3,2810,0
5,"Bihor",30336,56,30336,,"PIETROASA",555,"Scoala cu clasele I-VIII, Sat Pietroasa",0,63,0,63,0,63,0,200,137,24,39,3,2810,1
5,"Bihor",30416,56,30416,,"POCOLA",556,"Camin cultural, Sat Pocola",448,344,337,7,0,339,5,493,149,107,232,3,2818,0
5,"Bihor",30416,56,30416,,"POCOLA",557,"Camin cultural, Sat Feneris",338,260,257,3,0,259,1,372,112,75,184,3,2818,0
5,"Bihor",30416,56,30416,,"POCOLA",558,"Camin cultural, Sat Petrani",296,203,197,6,0,199,4,326,123,89,110,3,2818,0
5,"Bihor",30416,56,30416,,"POCOLA",559,"Camin cultural, Sat Sinmartin de Beius",205,131,124,7,0,130,1,226,95,76,54,3,2818,0
5,"Bihor",30416,56,30416,,"POCOLA",560,"Camin cultural,  sala anexa, Sat Pocola",0,129,0,129,0,128,1,300,171,48,80,3,2818,1
5,"Bihor",30470,56,30470,,"POMEZEU",561,"Scoala generala veche, Sat Pomezeu",131,91,87,2,2,90,1,144,53,31,59,3,2824,0
5,"Bihor",30470,56,30470,,"POMEZEU",562,"Scoala generala, Sat Cimpani de Pomezeu",382,266,238,6,22,265,1,421,155,82,183,3,2824,0
5,"Bihor",30470,56,30470,,"POMEZEU",563,"Scoala generala, Sat Cosdeni",519,402,367,11,24,399,3,571,169,130,269,3,2824,0
5,"Bihor",30470,56,30470,,"POMEZEU",564,"Camin cultural, Sat Hidis",282,294,261,5,28,290,4,343,49,75,215,3,2824,0
5,"Bihor",30470,56,30470,,"POMEZEU",565,"Scoala generala, Sat Lacu Sarat",46,47,41,6,0,46,1,51,4,8,38,3,2824,0
5,"Bihor",30470,56,30470,,"POMEZEU",566,"Scoala generala, Sat Sitani",377,317,294,6,17,313,4,416,99,74,239,3,2824,0
5,"Bihor",30470,56,30470,,"POMEZEU",567,"Scoala generala, Sat Spinus de Pomezeu",217,181,145,9,27,179,2,239,58,35,144,3,2824,0
5,"Bihor",30470,56,30470,,"POMEZEU",568,"Scoala generala, Sat Valani de Pomezeu",469,361,331,11,19,353,8,537,176,94,259,3,2824,0
5,"Bihor",30470,56,30470,,"POMEZEU",569,"Scoala generala noua, Sat Pomezeu",0,80,0,80,0,79,1,100,20,26,53,3,2824,1
5,"Bihor",30568,56,30568,,"POPESTI",570,"Grup Scolar Industrial -sala A, Sat Popesti",1064,626,602,10,14,621,5,1170,544,256,365,3,2833,0
5,"Bihor",30568,56,30568,,"POPESTI",571,"Grup Scolar Industrial - sala B, Sat Popesti",851,460,436,24,0,451,9,936,476,172,279,3,2833,0
5,"Bihor",30568,56,30568,,"POPESTI",572,"Scoala generala, Sat Bistra",816,499,487,7,5,490,9,898,399,239,251,3,2833,0
5,"Bihor",30568,56,30568,,"POPESTI",573,"Liceul Joszef Kozacec, Sat Budoi",749,309,297,12,0,305,4,824,515,171,134,3,2833,0
5,"Bihor",30568,56,30568,,"POPESTI",574,"Scoala generala, Sat Cuzap",979,632,618,14,0,622,10,1077,445,307,315,3,2833,0
5,"Bihor",30568,56,30568,,"POPESTI",575,"Scoala generala, Sat Varviz",453,278,269,9,0,276,2,498,220,149,127,3,2833,0
5,"Bihor",30568,56,30568,,"POPESTI",576,"Scoala primara, Sat Varzari",249,145,137,6,2,138,7,274,129,63,75,3,2833,0
5,"Bihor",30568,56,30568,,"POPESTI",577,"Scoala generala - sala A, Sat Voivozi",760,544,525,14,5,540,4,876,332,306,234,3,2833,0
5,"Bihor",30568,56,30568,,"POPESTI",578,"Scoala generala - sala B, Sat Voivozi",657,378,370,8,0,373,5,723,345,189,184,3,2833,0
5,"Bihor",30568,56,30568,,"POPESTI",579,"Grup Scolar Industrial Popesti, cabinetul de limba romana, Sat Popesti",0,285,0,285,0,281,4,500,215,128,153,3,2833,1
5,"Bihor",30648,56,30648,,"RABAGANI",580,"Camin cultural, Sat Rabagani",525,313,304,5,4,309,4,578,265,134,175,3,2841,0
5,"Bihor",30648,56,30648,,"RABAGANI",581,"Camin cultural, Sat Albesti",247,171,164,7,0,171,0,272,101,37,134,3,2841,0
5,"Bihor",30648,56,30648,,"RABAGANI",582,"Scoala generala, Sat Bratesti",115,83,75,8,0,83,0,127,44,25,58,3,2841,0
5,"Bihor",30648,56,30648,,"RABAGANI",583,"Camin cultural, Sat Saucani",400,253,249,4,0,248,5,440,187,88,160,3,2841,0
5,"Bihor",30648,56,30648,,"RABAGANI",584,"Camin cultural, Sat Saliste de Pomezeu",100,88,80,8,0,88,0,110,22,38,50,3,2841,0
5,"Bihor",30648,56,30648,,"RABAGANI",585,"Camin cultural, Sat Varaseni",345,219,210,9,0,215,4,380,161,58,157,3,2841,0
5,"Bihor",30648,56,30648,,"RABAGANI",586,"Scoala cu clasele I-IV, Sat Rabagani",0,76,0,76,0,76,0,150,74,29,47,3,2841,1
5,"Bihor",30719,56,30719,,"REMETEA",587,"Scoala generala, Sala 1, Sat Remetea",665,385,371,14,0,385,0,733,348,198,187,3,2848,0
5,"Bihor",30719,56,30719,,"REMETEA",588,"Scoala generala, Sat Meziad",963,590,581,9,0,584,6,1060,470,225,359,3,2848,0
5,"Bihor",30719,56,30719,,"REMETEA",589,"Scoala clasele I -IV, Sat Dragoteni",358,240,235,5,0,236,4,394,154,108,128,3,2848,0
5,"Bihor",30719,56,30719,,"REMETEA",590,"Scoala clasele I -IV, Sat Petreasa",333,221,216,5,0,216,5,366,145,73,143,3,2848,0
5,"Bihor",30719,56,30719,,"REMETEA",591,"Scoala clasele I -IV, Sat Soimus",108,79,73,6,0,79,0,119,40,32,47,3,2848,0
5,"Bihor",30719,56,30719,,"REMETEA",592,"Scoala cu clasele I-VIII, Sala 2, Sat Remetea",0,55,0,55,0,55,0,250,195,19,36,3,2848,1
5,"Bihor",30773,56,30773,,"RIENI",593,"Camin cultural, Sat Rieni",473,338,323,6,9,336,2,520,182,237,99,3,2854,0
5,"Bihor",30773,56,30773,,"RIENI",594,"Camin cultural, Sat Ghighiseni",816,587,561,7,19,585,2,898,311,427,158,3,2854,0
5,"Bihor",30773,56,30773,,"RIENI",595,"Camin cultural, Sat Valea de Jos",456,354,339,11,4,354,0,502,148,221,133,3,2854,0
5,"Bihor",30773,56,30773,,"RIENI",596,"Camin cultural, Sat Petrileni",477,315,291,11,13,313,2,525,210,225,88,3,2854,0
5,"Bihor",30773,56,30773,,"RIENI",597,"Camin cultural, Sat Sudrigiu",294,202,191,11,0,202,0,323,121,109,93,3,2854,0
5,"Bihor",30773,56,30773,,"RIENI",598,"Bloc de locuinte - parter, Sat Rieni",0,138,0,138,0,138,0,350,212,119,19,3,2854,1
5,"Bihor",30844,56,30844,,"ROSIA",599,"Scoala noua, centru, Sat Rosia",567,400,378,20,2,400,0,624,224,156,244,3,2861,0
5,"Bihor",30844,56,30844,,"ROSIA",600,"Camin cultural, Sat Lazuri",325,231,221,10,0,229,2,358,127,92,137,3,2861,0
5,"Bihor",30844,56,30844,,"ROSIA",601,"Scoala generala Tarina, Sat Rosia",511,301,291,10,0,299,2,562,261,87,212,3,2861,0
5,"Bihor",30844,56,30844,,"ROSIA",602,"Gradinita Ponita, Sat Rosia",576,357,349,8,0,352,5,634,277,145,207,3,2861,0
5,"Bihor",30844,56,30844,,"ROSIA",603,"Scoala veche, centru, Sat Rosia",0,33,0,33,0,33,0,50,17,12,21,3,2861,1
5,"Bihor",32187,56,32187,,"ROSIORI",604,"Scoala generala, Sat Rosiori",1152,546,494,14,38,538,8,1267,721,133,405,3,2864,0
5,"Bihor",32187,56,32187,,"ROSIORI",605,"Scoala generala, Sat Mihai Bravu",866,486,475,6,5,480,6,953,467,243,237,3,2864,0
5,"Bihor",32187,56,32187,,"ROSIORI",606,"Scoala clasele I -IV, Sat Vaida",431,199,179,11,9,197,2,474,275,62,135,3,2864,0
5,"Bihor",32187,56,32187,,"ROSIORI",607,"Cladirea fostului sediul al politiei, actualmente anexa a primariei, Sat Rosiori",0,66,0,66,0,65,1,200,134,24,41,3,2864,1
5,"Bihor",30871,56,30871,,"SACADAT",608,"Camin cultural, Sala 1, Sat Sacadat",736,424,419,5,0,419,5,810,386,230,189,3,2868,0
5,"Bihor",30871,56,30871,,"SACADAT",609,"Scoala cu clasele I-IV, Sat Sabolciu",561,378,342,36,0,376,2,617,239,246,130,3,2868,0
5,"Bihor",30871,56,30871,,"SACADAT",610,"Scoala clasele I-IV, Sat Borsa",140,78,69,9,0,78,0,154,76,45,33,3,2868,0
5,"Bihor",30871,56,30871,,"SACADAT",611,"Camin cultural, Sala 2, Sat Sacadat",0,178,0,178,0,177,1,200,22,107,70,3,2868,1
5,"Bihor",30988,56,30988,,"SALACEA",612,"Scoala generala, Sat Salacea",925,195,186,9,0,192,3,1019,824,50,142,3,2872,0
5,"Bihor",30988,56,30988,,"SALACEA",613,"Camin cultural, Sat Salacea",977,218,209,9,0,210,8,1076,858,63,147,3,2872,0
5,"Bihor",30988,56,30988,,"SALACEA",614,"Scoala generala, Sat Otomani",627,153,145,8,0,151,2,691,538,59,92,3,2872,0
5,"Bihor",30988,56,30988,,"SALACEA",615,"Gradinita, Sat Salacea",0,30,0,30,0,30,0,100,70,10,20,3,2872,1
5,"Bihor",31011,56,31011,,"SALARD",616,"Grup scolar Agricultura Ecologica , sala A, Sat Salard",1152,431,430,1,0,427,4,1267,836,234,193,3,2875,0
5,"Bihor",31011,56,31011,,"SALARD",617,"Grup scolar Agricultura Ecologica, sala B, Sat Salard",1188,393,391,2,0,390,3,1308,915,137,253,3,2875,0
5,"Bihor",31011,56,31011,,"SALARD",618,"Scoala generala, Sat Hodos",620,129,127,2,0,128,1,682,553,30,98,3,2875,0
5,"Bihor",31011,56,31011,,"SALARD",619,"Cladirea anexa a primariei, Sat Sintimreu",482,163,155,8,0,162,1,530,367,35,127,3,2875,0
5,"Bihor",31011,56,31011,,"SALARD",620,"Grup scolar Agricultura Ecologica, Sala C, Sat Salard",0,68,0,68,0,67,1,150,82,35,32,3,2875,1
5,"Bihor",31057,56,31057,,"SAMBATA",621,"Scoala cu clasele I-IV, sala de sport, Sat Simbata",314,210,197,4,9,203,7,345,135,81,122,3,2879,0
5,"Bihor",31057,56,31057,,"SAMBATA",622,"Scoala cu clasele I-IV,, Sat Copaceni",117,80,68,5,7,80,0,129,49,27,53,3,2879,0
5,"Bihor",31057,56,31057,,"SAMBATA",623,"Scoala cu clasele I-IV,, Sat Ogesti",176,123,111,6,6,120,3,194,71,54,66,3,2879,0
5,"Bihor",31057,56,31057,,"SAMBATA",624,"Scoala clasele I-IV, Sat Rotaresti",137,95,88,7,0,94,1,151,56,57,37,3,2879,0
5,"Bihor",31057,56,31057,,"SAMBATA",625,"Scoala cu clasele I-IV,, Sat Rogoz",253,186,167,8,11,184,2,278,92,84,100,3,2879,0
5,"Bihor",31057,56,31057,,"SAMBATA",626,"Scoala cu clasele I-IV,, Sat Zavoiu",189,155,140,6,9,153,2,208,53,57,96,3,2879,0
5,"Bihor",31057,56,31057,,"SAMBATA",627,"Camin cultural, sala mica, Sat Simbata",0,139,0,139,0,139,0,200,61,63,76,3,2879,1
5,"Bihor",26582,56,26582,,"SANMARTIN",628,"Gradinita, Sat Sinmartin",1691,1024,983,41,0,1018,6,1860,836,627,391,3,2886,0
5,"Bihor",26582,56,26582,,"SANMARTIN",629,"Scoala generala Sinmartin, Sat Sinmartin",1165,730,690,40,0,721,9,1282,552,433,288,3,2886,0
5,"Bihor",26582,56,26582,,"SANMARTIN",630,"Scoala cu clasele I-IV, Sat Baile Felix",457,304,294,10,0,298,6,503,199,191,107,3,2886,0
5,"Bihor",26582,56,26582,,"SANMARTIN",631,"Scoala cu clasele I-IV, Sat Betfia",366,263,255,8,0,262,1,404,141,199,63,3,2886,0
5,"Bihor",26582,56,26582,,"SANMARTIN",632,"Scoala clasele I-IV, Sat Cihei",873,591,578,13,0,588,3,961,370,383,205,3,2886,0
5,"Bihor",26582,56,26582,,"SANMARTIN",633,"Scoala generala, Sat Cordau",1083,743,727,16,0,738,5,1192,449,566,172,3,2886,0
5,"Bihor",26582,56,26582,,"SANMARTIN",634,"Scoala cu clasele I-IV, Sat Haieu",867,582,563,18,1,577,5,956,374,400,177,3,2886,0
5,"Bihor",26582,56,26582,,"SANMARTIN",635,"Scoala clasele I-IV, Sat Rontau",797,551,534,17,0,543,8,878,327,380,163,3,2886,0
5,"Bihor",26582,56,26582,,"SANMARTIN",636,"Spitalul de Recuperare, Sat Baile Felix",0,557,0,557,0,551,6,2200,1643,303,248,3,2886,1
5,"Bihor",26582,56,26582,,"SANMARTIN",637,"Hotel Padis, complex hotelier SIND Romania SA, Sat Baile Felix",0,831,0,831,0,825,6,1000,169,432,393,3,2886,1
5,"Bihor",26582,56,26582,,"SANMARTIN",638,"Hotel Ceres, Cartier Baile 1 Mai",0,576,0,576,0,573,3,850,274,328,245,3,2886,1
5,"Bihor",32179,56,32179,,"SANNICOLAU ROMAN",639,"Camin cultural, Sat Sinnicolau Roman",915,501,496,5,0,496,5,1007,506,218,278,3,2894,0
5,"Bihor",32179,56,32179,,"SANNICOLAU ROMAN",640,"Camin cultural, Sat Berechiu",273,156,150,6,0,156,0,300,144,94,62,3,2894,0
5,"Bihor",32179,56,32179,,"SANNICOLAU ROMAN",641,"Camin cultural, Sat Roit",485,290,282,8,0,284,6,534,244,137,147,3,2894,0
5,"Bihor",32179,56,32179,,"SANNICOLAU ROMAN",642,"Scoala  cu clasele I-VIII, Sat Sinnicolau Roman",0,112,0,112,0,108,4,300,188,52,56,3,2894,1
5,"Bihor",26653,56,26653,,"SANTANDREI",643,"Scoala clasele I-IV, sala A, Sat Sintandrei",1519,879,854,24,1,869,10,1672,793,527,342,3,2898,0
5,"Bihor",26653,56,26653,,"SANTANDREI",644,"Scoala clasele I-IV,  sala B, Sat Sintandrei",1424,857,841,16,0,853,4,1566,709,500,353,3,2898,0
5,"Bihor",26653,56,26653,,"SANTANDREI",645,"Camin cultural, Sat Palota",563,239,230,9,0,238,1,619,380,164,74,3,2898,0
5,"Bihor",26653,56,26653,,"SANTANDREI",646,"Scoala cu clasele I-IV, sala C, Sat Sintandrei",0,182,0,182,0,179,3,300,118,107,72,3,2898,1
5,"Bihor",31128,56,31128,,"SARBI",647,"Camin cultural, Sat Sirbi",835,524,519,5,0,516,8,919,395,296,220,3,2901,0
5,"Bihor",31128,56,31128,,"SARBI",648,"Scoala clasele I-IV, Sat Almasu Mic",111,61,54,7,0,61,0,122,61,35,26,3,2901,0
5,"Bihor",31128,56,31128,,"SARBI",649,"Camin cultural, Sat Burzuc",667,414,403,9,2,409,5,734,320,249,160,3,2901,0
5,"Bihor",31128,56,31128,,"SARBI",650,"Scoala clasele I-IV, Sat Chioag",160,83,77,6,0,82,1,176,93,49,33,3,2901,0
5,"Bihor",31128,56,31128,,"SARBI",651,"Scoala clasele I-IV, Sat Fegernic",308,162,154,8,0,161,1,339,177,101,60,3,2901,0
5,"Bihor",31128,56,31128,,"SARBI",652,"Scoala clasele I-IV, Sat Sarcau",71,44,35,9,0,43,1,78,34,19,24,3,2901,0
5,"Bihor",31128,56,31128,,"SARBI",653,"Anexa caminului cultural, Sat Sirbi",0,122,0,122,0,120,2,200,78,75,45,3,2901,1
5,"Bihor",31208,56,31208,,"SPINUS",654,"Scoala cu clasele I-VIII, Sala A, Sat Spinus",319,191,182,8,1,191,0,351,160,70,121,3,2927,0
5,"Bihor",31208,56,31208,,"SPINUS",655,"Scoala clasele I-IV, Sat Nadar",162,108,102,5,1,106,2,178,70,52,54,3,2927,0
5,"Bihor",31208,56,31208,,"SPINUS",656,"Scoala clasele I-IV, Sat Ciulesti",169,111,102,8,1,111,0,185,74,44,67,3,2927,0
5,"Bihor",31208,56,31208,,"SPINUS",657,"Scoala clasele I-IV, Sat Gurbesti",107,75,66,9,0,75,0,118,43,43,32,3,2927,0
5,"Bihor",31208,56,31208,,"SPINUS",658,"Scoala clasele I-IV, Sat Saliste",209,140,130,10,0,138,2,230,90,82,56,3,2927,0
5,"Bihor",31208,56,31208,,"SPINUS",659,"Scoala cu clasele I-VIII, Sala B, Sat Spinus",0,108,0,108,0,107,1,200,92,48,59,3,2927,1
5,"Bihor",31262,56,31262,,"SUPLACU DE BARCAU",660,"Grup Scolar  Industrial, Sat Suplacu de Barcau",940,449,439,10,0,439,10,1034,585,235,204,3,2938,0
5,"Bihor",31262,56,31262,,"SUPLACU DE BARCAU",661,"Fost sediu primarie, actualmente sala de sedinte, Sat Suplacu de Barcau",1080,496,484,12,0,492,4,1188,692,267,225,3,2938,0
5,"Bihor",31262,56,31262,,"SUPLACU DE BARCAU",662,"Scoala generala, Sat Borumlaca",731,446,436,10,0,437,9,804,358,223,214,3,2938,0
5,"Bihor",31262,56,31262,,"SUPLACU DE BARCAU",663,"Scoala generala, Sat Dolea",152,70,60,10,0,69,1,167,97,36,33,3,2938,0
5,"Bihor",31262,56,31262,,"SUPLACU DE BARCAU",664,"Scoala generala, Sat Foglas",157,93,85,8,0,92,1,173,80,61,31,3,2938,0
5,"Bihor",31262,56,31262,,"SUPLACU DE BARCAU",665,"Scoala generala, Sat Valea Cerului",360,195,185,10,0,194,1,396,201,136,58,3,2938,0
5,"Bihor",31262,56,31262,,"SUPLACU DE BARCAU",666,"Scoala generala, Sat Vilcelele",204,113,104,9,0,113,0,224,111,61,52,3,2938,0
5,"Bihor",31262,56,31262,,"SUPLACU DE BARCAU",667,"Grup Scolar Industrial, Corpul D, Sat Suplacu de Barcau",0,92,0,92,0,91,1,100,8,35,56,3,2938,1
5,"Bihor",31333,56,31333,,"SIMIAN",668,"Scoala generala Kazinczy Ferenc, Sat Simian",1672,538,529,9,0,526,12,1839,1301,129,397,3,2909,0
5,"Bihor",31333,56,31333,,"SIMIAN",669,"Scoala clasele I-IV, Sat Simian Nou",235,72,64,8,0,69,3,259,187,16,53,3,2909,0
5,"Bihor",31333,56,31333,,"SIMIAN",670,"Scoala clasele I-IV, Sat Barantau",140,53,44,9,0,50,3,154,101,19,31,3,2909,0
5,"Bihor",31333,56,31333,,"SIMIAN",671,"Scoala clasele I-IV, Sat Silindru",763,299,286,13,0,287,12,840,541,184,103,3,2909,0
5,"Bihor",31333,56,31333,,"SIMIAN",672,"Scoala clasele I-IV, Sat Voivozi",360,156,150,6,0,153,3,396,240,95,58,3,2909,0
5,"Bihor",31333,56,31333,,"SIMIAN",673,"Punct de trecere frontiera Simian, Sat Simian",0,35,0,35,0,35,0,150,115,19,16,3,2909,1
5,"Bihor",31379,56,31379,,"SINTEU",674,"Primaria, Sat Sinteu",983,305,298,7,0,296,9,1091,786,209,87,3,2913,0
5,"Bihor",31379,56,31379,,"SINTEU",675,"Camin cultural, Sat Sinteu",0,70,0,70,0,70,0,150,80,55,15,3,2913,1
5,"Bihor",31422,56,31422,,"SOIMI",676,"Primaria, Sat Soimi",514,210,201,9,0,208,2,565,355,82,126,3,2918,0
5,"Bihor",31422,56,31422,,"SOIMI",677,"Scoala cu clasele I-IV, Sat Sinnicolau de Beius",126,90,83,7,0,89,1,139,49,33,56,3,2918,0
5,"Bihor",31422,56,31422,,"SOIMI",678,"Scoala cu clasele I-IV, Sat Ursad",142,102,95,7,0,102,0,156,54,30,72,3,2918,0
5,"Bihor",31422,56,31422,,"SOIMI",679,"Scoala clasele I-IV, Sat Poclusa de Beius",88,70,64,6,0,68,2,97,27,22,46,3,2918,0
5,"Bihor",31422,56,31422,,"SOIMI",680,"Scoala clasele I-IV, Sat Codru",144,122,101,20,1,122,0,158,36,45,77,3,2918,0
5,"Bihor",31422,56,31422,,"SOIMI",681,"Scoala generala, Sat Urvis de Beius",588,349,345,4,0,347,2,647,298,149,198,3,2918,0
5,"Bihor",31422,56,31422,,"SOIMI",682,"Scoala generala, Sat Dumbravita de Codru",359,211,207,4,0,211,0,395,184,98,113,3,2918,0
5,"Bihor",31422,56,31422,,"SOIMI",683,"Scoala clasele I-IV, Sala A, Sat Borz",185,125,117,5,3,125,0,204,79,60,65,3,2918,0
5,"Bihor",31422,56,31422,,"SOIMI",684,"Scoala clasele I-IV, Sala B, Sat Borz",0,77,0,77,0,77,0,200,123,34,43,3,2918,1
5,"Bihor",31510,56,31510,,"SUNCUIUS",685,"Grup scolar, Sala A, Sat Suncuius",1299,744,713,24,7,738,6,1429,685,295,443,3,2933,0
5,"Bihor",31510,56,31510,,"SUNCUIUS",686,"Scoala clasele I-IV ""Pojorata"", Sat Suncuius",120,71,51,20,0,69,2,132,61,22,47,3,2933,0
5,"Bihor",31510,56,31510,,"SUNCUIUS",687,"Scoala generala, Sat Balnaca",808,491,479,12,0,491,0,889,398,237,254,3,2933,0
5,"Bihor",31510,56,31510,,"SUNCUIUS",688,"Camin cultural, Sat Balnaca Grosi",60,47,33,14,0,47,0,66,19,19,28,3,2933,0
5,"Bihor",31510,56,31510,,"SUNCUIUS",689,"Camin cultural Zecehotare -""Catun Carmazan"", Sat Zecehotare",177,78,72,6,0,78,0,195,117,49,29,3,2933,0
5,"Bihor",31510,56,31510,,"SUNCUIUS",690,"Scoala generala Zecehotare -""catun Gugu"", Sat Zecehotare",165,125,107,18,0,122,3,182,57,49,73,3,2933,0
5,"Bihor",31510,56,31510,,"SUNCUIUS",691,"Grup Scolar, Sala B, Sat Suncuius",0,143,0,143,0,142,1,200,57,82,60,3,2933,1
5,"Bihor",31565,56,31565,,"TARCEA",692,"Camin cultural, Sat Tarcea",731,232,228,4,0,224,8,804,572,68,156,3,2955,0
5,"Bihor",31565,56,31565,,"TARCEA",693,"Camin cultural, Sat Adoni",625,194,184,10,0,192,2,688,494,75,117,3,2955,0
5,"Bihor",31565,56,31565,,"TARCEA",694,"Galospetreu Casa Roth - punct de lucru a primariei, Sat Galospetreu",777,183,170,13,0,176,7,855,672,81,95,3,2955,0
5,"Bihor",31565,56,31565,,"TARCEA",695,"Scoala cu clasele I-VIII, Sat Tarcea",0,26,0,26,0,23,3,50,24,12,11,3,2955,1
5,"Bihor",32153,56,32153,,"TAMASEU",696,"Camin cultural, Sat Tamaseu",904,355,348,6,1,347,8,994,639,99,248,3,2945,0
5,"Bihor",32153,56,32153,,"TAMASEU",697,"Scoala generala, Sat Satu Nou",208,102,92,10,0,100,2,229,127,24,76,3,2945,0
5,"Bihor",32153,56,32153,,"TAMASEU",698,"Camin cultural, Sat Niuved",201,95,86,9,0,93,2,221,126,22,71,3,2945,0
5,"Bihor",32153,56,32153,,"TAMASEU",699,"Scoala generala, Sat Parhida",421,189,184,5,0,184,5,463,274,113,71,3,2945,0
5,"Bihor",32153,56,32153,,"TAMASEU",700,"Scoala cu clasele I-VIII, Sat Tamaseu",0,44,0,44,0,43,1,150,106,24,19,3,2945,1
5,"Bihor",31609,56,31609,,"TARCAIA",701,"Primaria, Sat Tarcaia",910,484,473,8,3,468,16,1001,517,217,251,3,2950,0
5,"Bihor",31609,56,31609,,"TARCAIA",702,"Camin cultural, Sala A, Sat Tarcaita",347,245,236,0,9,244,1,382,137,170,74,3,2950,0
5,"Bihor",31609,56,31609,,"TARCAIA",703,"Camin cultural, Sat Totoreni",243,201,191,6,4,200,1,267,66,84,116,3,2950,0
5,"Bihor",31609,56,31609,,"TARCAIA",704,"Scoala clasele I-IV, Sat Mierag",174,130,119,6,5,130,0,192,62,80,50,3,2950,0
5,"Bihor",31609,56,31609,,"TARCAIA",705,"Camin cultural, Sala B, Sat Tarcaita",0,67,0,67,0,67,0,250,183,42,25,3,2950,1
5,"Bihor",31654,56,31654,,"TAUTEU",706,"Scoala generala, Sat Tauteu",929,465,445,11,9,457,8,1022,557,76,381,3,2959,0
5,"Bihor",31654,56,31654,,"TAUTEU",707,"Scoala generala, Sat Ciutelec",593,351,344,7,0,348,3,652,301,185,163,3,2959,0
5,"Bihor",31654,56,31654,,"TAUTEU",708,"Scoala generala, Sat Bogei",1059,504,487,17,0,493,11,1166,662,218,275,3,2959,0
5,"Bihor",31654,56,31654,,"TAUTEU",709,"Scoala generala, Sat Chiribis",604,320,308,11,1,319,1,664,344,198,121,3,2959,0
5,"Bihor",31654,56,31654,,"TAUTEU",710,"Scoala generala, Sat Poiana",187,104,96,8,0,104,0,206,102,63,41,3,2959,0
5,"Bihor",31654,56,31654,,"TAUTEU",711,"Centru de ingrijire si Asistenta Ciutelec, Sat Ciutelec",0,46,0,46,0,44,2,150,104,24,20,3,2959,1
5,"Bihor",31716,56,31716,,"TILEAGD",712,"Scoala generala - centrul, Sat Tileagd",1873,830,813,17,0,823,7,1960,1130,524,299,3,2970,0
5,"Bihor",31716,56,31716,,"TILEAGD",713,"Scoala generala - gara, Sat Tileagd",1279,666,644,22,0,663,3,1407,741,467,196,3,2970,0
5,"Bihor",31716,56,31716,,"TILEAGD",714,"Camin cultural, Sat Uileacu de Cris",678,261,254,6,1,259,2,746,485,147,112,3,2970,0
5,"Bihor",31716,56,31716,,"TILEAGD",715,"Camin cultural, Sat Tilecus",672,419,410,9,0,415,4,739,320,252,163,3,2970,0
5,"Bihor",31716,56,31716,,"TILEAGD",716,"Scoala generala, Sat Balaia",568,278,270,8,0,275,3,625,347,164,111,3,2970,0
5,"Bihor",31716,56,31716,,"TILEAGD",717,"Scoala generala, Sat Calatani",165,107,98,9,0,107,0,182,75,69,38,3,2970,0
5,"Bihor",31716,56,31716,,"TILEAGD",718,"Scoala generala, Sat Posoloaca",321,163,152,11,0,162,1,353,190,92,70,3,2970,0
5,"Bihor",31716,56,31716,,"TILEAGD",719,"Scoala cu clasele I-IV, Sat Tileagd",0,148,0,148,0,148,0,220,72,86,62,3,2970,1
5,"Bihor",31789,56,31789,,"TINCA",720,"Liceul Teoretic Nicolae Jiga  str. Republicii nr. 36/A, Sat Tinca",1207,678,657,16,5,651,27,1328,650,318,333,3,2977,0
5,"Bihor",31789,56,31789,,"TINCA",721,"Scoala clasele I-IV  str. Republicii nr. 73, Sat Tinca",1263,730,712,8,10,723,7,1389,659,365,358,3,2977,0
5,"Bihor",31789,56,31789,,"TINCA",722,"Gradinita cu program prelungit  str. Horea nr. 2, Sat Tinca",1133,588,562,14,12,580,8,1246,658,292,288,3,2977,0
5,"Bihor",31789,56,31789,,"TINCA",723,"Scoala generala, Sat Gurbediu",897,605,579,22,4,595,10,987,382,387,208,3,2977,0
5,"Bihor",31789,56,31789,,"TINCA",724,"Scoala primara, Sat Girisu Negru",583,367,345,13,9,354,13,641,274,143,211,3,2977,0
5,"Bihor",31789,56,31789,,"TINCA",725,"Scoala generala, Sat Ripa",475,315,309,6,0,309,6,523,208,143,166,3,2977,0
5,"Bihor",31789,56,31789,,"TINCA",726,"Scoala primara, Sat Belfir",457,164,151,8,5,163,1,503,339,88,75,3,2977,0
5,"Bihor",31789,56,31789,,"TINCA",727,"Centru de ingrijire adulti, Sat Tinca",0,234,0,234,0,234,0,400,166,131,103,3,2977,1
5,"Bihor",32201,56,32201,,"TOBOLIU",728,"Scoala clasele I-IV, Sat Toboliu",802,439,435,4,0,436,3,882,443,294,142,3,2983,0
5,"Bihor",32201,56,32201,,"TOBOLIU",729,"Scoala generala, Sat Cheresig",887,518,507,11,0,512,6,976,458,238,274,3,2983,0
5,"Bihor",32201,56,32201,,"TOBOLIU",730,"Camin cultural, Sat Cheresig",0,86,0,86,0,86,0,100,14,31,55,3,2983,1
5,"Bihor",31841,56,31841,,"TULCA",731,"Camin cultural, Sat Tulca",1582,925,899,7,19,918,7,1740,815,341,577,3,2986,0
5,"Bihor",31841,56,31841,,"TULCA",732,"Scoala clasele I-IV, Sat Tulca Satu Nou",238,143,125,13,5,141,2,262,119,54,87,3,2986,0
5,"Bihor",31841,56,31841,,"TULCA",733,"Camin cultural, Sat Cauasd",374,266,247,8,11,263,3,411,145,98,165,3,2986,0
5,"Bihor",31841,56,31841,,"TULCA",734,"Camin cultural, Sat Tulca",0,97,0,97,0,97,0,200,103,32,65,3,2986,1
5,"Bihor",31878,56,31878,,"TETCHEA",735,"Scoala generala, Sat Tetchea",632,392,384,8,0,392,0,695,303,176,216,3,2965,0
5,"Bihor",31878,56,31878,,"TETCHEA",736,"Camin cultural, Sat Hotar",730,421,409,12,0,416,5,803,382,181,235,3,2965,0
5,"Bihor",31878,56,31878,,"TETCHEA",737,"Camin cultural, Sat Subpiatra",498,297,287,9,1,294,3,548,251,175,119,3,2965,0
5,"Bihor",31878,56,31878,,"TETCHEA",738,"Camin cultural, Sat Telechiu",596,316,307,9,0,311,5,656,340,126,185,3,2965,0
5,"Bihor",31878,56,31878,,"TETCHEA",739,"Cladirea fostei mori, actualmente spatiu liber, Sat Tetchea",0,95,0,95,0,94,1,200,105,37,57,3,2965,1
5,"Bihor",31921,56,31921,,"UILEACU DE BEIUS",740,"Gradinita, Sat Uileacu de Beius",531,352,331,8,13,348,4,584,232,151,197,3,2989,0
5,"Bihor",31921,56,31921,,"UILEACU DE BEIUS",741,"Scoala generala, Sat Forau",742,466,460,6,0,463,3,816,350,216,247,3,2989,0
5,"Bihor",31921,56,31921,,"UILEACU DE BEIUS",742,"Scoala cu clasele I-IV, Sat Prisaca",397,260,256,4,0,258,2,437,177,120,138,3,2989,0
5,"Bihor",31921,56,31921,,"UILEACU DE BEIUS",743,"Scoala clasele I-IV, Sat Valani de Beius",227,161,154,7,0,161,0,250,89,97,64,3,2989,0
5,"Bihor",31921,56,31921,,"UILEACU DE BEIUS",744,"Scoala generala, Sat Uileacu de Beius",0,70,0,70,0,69,1,150,80,30,39,3,2989,1
5,"Bihor",31976,56,31976,,"VADU CRISULUI",745,"Camin cultural, Club, Sat Vadu Crisului",1591,772,760,10,2,769,3,1750,978,434,335,3,2994,0
5,"Bihor",31976,56,31976,,"VADU CRISULUI",746,"Scoala clasele I-IV, Sat Vadu Crisului",766,413,398,15,0,403,10,843,430,215,188,3,2994,0
5,"Bihor",31976,56,31976,,"VADU CRISULUI",747,"Scoala clasele I-IV, Sat Tomnatic",270,132,125,7,0,130,2,297,165,72,58,3,2994,0
5,"Bihor",31976,56,31976,,"VADU CRISULUI",748,"Scoala clasele I-IV, Sat Topa de Cris",369,213,205,8,0,211,2,406,193,111,100,3,2994,0
5,"Bihor",31976,56,31976,,"VADU CRISULUI",749,"Scoala clasele I-IV, Sat Birtin",301,204,198,6,0,204,0,331,127,82,122,3,2994,0
5,"Bihor",31976,56,31976,,"VADU CRISULUI",750,"Camin cultural, Biblioteca, Sat Vadu Crisului",0,82,0,82,0,81,1,200,118,40,41,3,2994,1
5,"Bihor",32045,56,32045,,"VIISOARA",751,"Camin cultural, Sala A, Sat Viisoara",829,483,463,3,17,475,8,914,431,168,307,3,3004,0
5,"Bihor",32045,56,32045,,"VIISOARA",752,"Scoala, Sat Izvoarele",183,67,58,6,3,66,1,201,134,35,31,3,3004,0
5,"Bihor",32045,56,32045,,"VIISOARA",753,"Camin cultural, Sat Reghea",47,37,30,7,0,37,0,52,15,10,27,3,3004,0
5,"Bihor",32045,56,32045,,"VIISOARA",754,"Camin cultural, Sala B, Sat Viisoara",0,24,0,24,0,23,1,100,76,8,15,3,3004,1
5,"Bihor",32090,56,32090,,"VARCIOROG",755,"Camin cultural, Sat Virciorog",910,482,469,13,0,476,6,1001,519,215,261,3,2999,0
5,"Bihor",32090,56,32090,,"VARCIOROG",756,"Scoala generala, Sat Fisca",377,240,233,7,0,225,15,415,175,75,150,3,2999,0
5,"Bihor",32090,56,32090,,"VARCIOROG",757,"Gradinita, Sat Serghis",462,263,250,13,0,254,9,508,245,93,161,3,2999,0
5,"Bihor",32090,56,32090,,"VARCIOROG",758,"Telecentru, Sat Virciorog",0,56,0,56,0,56,0,150,94,27,29,3,2999,1
6,"Bistrita-Nasaud",32394,65,32394,,"MUNICIPIUL BISTRITA",1,"CENTRUL CULTURAL MUNICIPAL ""GEORGE COSBUC"" BISTRITA, SALA 1 (STUDIO), BISTRITA, STR. ALBERT BERGER, NR. 10",1461,884,871,10,3,877,7,1600,716,386,491,1,3010,0
6,"Bistrita-Nasaud",32394,65,32394,,"MUNICIPIUL BISTRITA",2,"GRADINITA NR. 1 ""DUMBRAVA MINUNATA"" BISTRITA, SALA 1, BISTRITA, STR. ECATERINA TEODOROIU, NR. 2-4",1411,714,695,17,2,704,10,1500,786,445,259,1,3010,0
6,"Bistrita-Nasaud",32394,65,32394,,"MUNICIPIUL BISTRITA",3,"SCOALA GENERALA NR. 2 BISTRITA, SALA 7, BISTRITA, STR. ALEXANDRU ODOBESCU, NR.8",1382,789,778,10,1,777,12,1504,715,476,301,1,3010,0
6,"Bistrita-Nasaud",32394,65,32394,,"MUNICIPIUL BISTRITA",4,"DIRECTIA FINANTE PUBLICE MUNICIPALE BISTRITA, SALA 10, BISTRITA, STR. ALEXANDRU ODOBESCU, NR.17",1368,779,762,17,0,773,6,1500,721,422,351,1,3010,0
6,"Bistrita-Nasaud",32394,65,32394,,"MUNICIPIUL BISTRITA",5,"GRADINITA CU PROGRAM PRELUNGIT NR. 6 BISTRITA, SALA NR. 1, BISTRITA, ALEEA SIEULUI, NR.11 B",1592,861,849,12,0,857,4,1700,839,527,330,1,3010,0
6,"Bistrita-Nasaud",32394,65,32394,,"MUNICIPIUL BISTRITA",6,"GRADINITA CU PROGRAM PRELUNGIT NR. 6 BISTRITA, SALA NR. 2, BISTRITA, ALEEA SIEULUI, NR.11 B",1511,787,774,13,0,782,5,1600,813,529,253,1,3010,0
6,"Bistrita-Nasaud",32394,65,32394,,"MUNICIPIUL BISTRITA",7,"SCOALA DE ARTE SI MESERII ""SFANTA MARIA"" BISTRITA, SALA 3 , BISTRITA, B-DUL INDEPENDENTEI, NR. 23",1402,743,715,24,4,742,1,1500,757,418,324,1,3010,0
6,"Bistrita-Nasaud",32394,65,32394,,"MUNICIPIUL BISTRITA",8,"SCOALA GENERALA NR. 1, SEDIUL VECHI, SALA 1A , BISTRITA, B-DUL INDEPENDENTEI, NR.46",1169,602,589,13,0,598,4,1198,596,370,228,1,3010,0
6,"Bistrita-Nasaud",32394,65,32394,,"MUNICIPIUL BISTRITA",9,"GRADINITA CU PROGRAM NORMAL NR.10 BISTRITA, SALA1, BISTRITA, B-DUL INDEPENDENTEI NR.57",1483,837,826,11,0,833,4,1600,763,481,352,1,3010,0
6,"Bistrita-Nasaud",32394,65,32394,,"MUNICIPIUL BISTRITA",10,"SCOALA GENERALA NR.5 ""LUCIAN BLAGA"" BISTRITA, SALA 9, BISTRITA, STR. GAROAFEI, NR.8",1680,882,863,17,2,878,4,1700,818,590,288,1,3010,0
6,"Bistrita-Nasaud",32394,65,32394,,"MUNICIPIUL BISTRITA",11,"SCOALA GENERALA NR.5 ""LUCIAN BLAGA"" BISTRITA, SALA 10, BISTRITA, STR. GAROAFEI, NR.8",1615,859,850,9,0,851,8,1700,841,557,294,1,3010,0
6,"Bistrita-Nasaud",32394,65,32394,,"MUNICIPIUL BISTRITA",12,"SCOALA GENERALA NR.5 ""LUCIAN BLAGA"" BISTRITA, SALA 11, BISTRITA, STR. GAROAFEI, NR.8",1706,908,895,13,0,904,4,1800,892,566,338,1,3010,0
6,"Bistrita-Nasaud",32394,65,32394,,"MUNICIPIUL BISTRITA",13,"GRUPUL SCOLAR GRIGORE MOISIL - CORPUL PRINCIPAL, SALA 18,  BISTRITA, STR. RODNEI NR.23, ACCES DIN STR.IMP.TRAIAN",1491,806,793,13,0,804,2,1600,794,489,315,1,3010,0
6,"Bistrita-Nasaud",32394,65,32394,,"MUNICIPIUL BISTRITA",14,"GRADINITA NR.18 (GRUPUL SCOLAR GRIGORE MOISIL - CORPUL A) SALA 6, BISTRITA, STR. RODNEI NR.23, ACCES DIN STR.IMP.TRAIAN",943,461,450,11,0,456,5,1001,540,296,160,1,3010,0
6,"Bistrita-Nasaud",32394,65,32394,,"MUNICIPIUL BISTRITA",15,"GRADINITA NR.18 (GRUPUL SCOLAR GRIGORE MOISIL - CORPUL A) SALA 7, BISTRITA, STR. RODNEI NR.23, ACCES DIN STR.IMP.TRAIAN",1128,544,525,19,0,542,2,1200,656,366,176,1,3010,0
6,"Bistrita-Nasaud",32394,65,32394,,"MUNICIPIUL BISTRITA",16,"GRUPUL SCOLAR GRIGORE MOISIL - CORP PRINCIPAL, SALA 15, BISTRITA, STR. RODNEI, NR. 23",1430,793,781,12,0,786,7,1500,707,487,299,1,3010,0
6,"Bistrita-Nasaud",32394,65,32394,,"MUNICIPIUL BISTRITA",17,"SCOALA GENERALA NR.1 - SEDIUL NOU, SALA 7 B, BISTRITA, B-DUL INDEPENDENTEI, NR. 46, ACCES DIN STR. IMPARATU TRAIAN",1305,680,671,9,0,680,0,1400,720,385,295,1,3010,0
6,"Bistrita-Nasaud",32394,65,32394,,"MUNICIPIUL BISTRITA",18,"SALA DE SPORT A SCOLII GENERALE NR.1, BISTRITA, B-DUL INDEPENDENTEI, NR. 46, ACCES DIN STR. IMPARATU TRAIAN",1505,861,847,14,0,850,11,1600,739,527,323,1,3010,0
6,"Bistrita-Nasaud",32394,65,32394,,"MUNICIPIUL BISTRITA",19,"SCOALA GENERALA NR. 1 - SEDIUL VECHI, SALA III C, BISTRITA, B-DUL INDEPENDENTEI, NR. 46, ACCES DIN STR. IMPARATU TRAIAN",1377,856,828,13,15,852,4,1500,644,419,433,1,3010,0
6,"Bistrita-Nasaud",32394,65,32394,,"MUNICIPIUL BISTRITA",20,"GRADINITA NR. 14 ""TRENULETUL VESELIEI"" BISTRITA, SALA 2, BISTRITA, STR. RODNEI, NR.3",1410,800,786,14,0,795,5,1500,700,490,305,1,3010,0
6,"Bistrita-Nasaud",32394,65,32394,,"MUNICIPIUL BISTRITA",21,"INTERNATUL GRUPULUI SCOLAR FORESTIER BISTRITA, SALA DE MESE, BISTRITA, STR. ROMANA, NR.26",1438,752,739,12,1,750,2,1503,751,464,286,1,3010,0
6,"Bistrita-Nasaud",32394,65,32394,,"MUNICIPIUL BISTRITA",22,"SPATIU ADMINISTRATIV PROPRIETATEA MUNICIPIULUI BISTRITA, BISTRITA, STR. SUBCETATE, BLOC NR. 9, SC. A, PARTER, AP. 1A",1286,866,760,19,87,860,6,1400,534,593,267,1,3010,0
6,"Bistrita-Nasaud",32394,65,32394,,"MUNICIPIUL BISTRITA",23,"COLEGIUL NATIONAL ANDREI MURESANU BISTRITA, SALA DE SPORT NR. 1, BISTRITA, B-DUL REPUBLICII, NR.26",1493,802,790,12,0,797,5,1600,798,495,302,1,3010,0
6,"Bistrita-Nasaud",32394,65,32394,,"MUNICIPIUL BISTRITA",24,"GRADINITA NR. 11 ""CASUTA CU POVESTI"" BISTRITA, SALA 2, BISTRITA, STR. ZIMBRULUI, NR. 9",1372,704,692,12,0,698,6,1400,696,411,287,1,3010,0
6,"Bistrita-Nasaud",32394,65,32394,,"MUNICIPIUL BISTRITA",25,"GRADINITA CU PROGRAM NORMAL NR. 15 BISTRITA, SALA 2 , BISTRITA, STR. ZIMBRULUI, NR. 19",1184,586,575,11,0,582,4,1300,714,370,212,1,3010,0
6,"Bistrita-Nasaud",32394,65,32394,,"MUNICIPIUL BISTRITA",26,"SCOALA GENERALA A COLEGIULUI NATIONAL ""LIVIU REBREANU"" BISTRITA, SALA 16, BISTRITA, STR. URSULUI, NR. 3",1400,738,724,14,0,737,1,1500,762,479,258,1,3010,0
6,"Bistrita-Nasaud",32394,65,32394,,"MUNICIPIUL BISTRITA",27,"COLEGIUL NATIONAL ""LIVIU REBREANU"" BISTRITA, SALA 5, BISTRITA, B-DUL REPUBLICII, NR. 8",1491,786,775,10,1,785,1,1597,811,461,324,1,3010,0
6,"Bistrita-Nasaud",32394,65,32394,,"MUNICIPIUL BISTRITA",28,"GRADINITA CU PROGRAM NORMAL NR.9 BISTRITA, SALA 1, BISTRITA, STR. CRINILOR, NR. 4",1370,833,819,14,0,826,7,1500,667,448,378,1,3010,0
6,"Bistrita-Nasaud",32394,65,32394,,"MUNICIPIUL BISTRITA",29,"UNIVERSITATEA ""BABES-BOLYAI"" CLUJ-NAPOCA, EXTENSIA UNIVERSITARA BISTRITA, SALA 13, BISTRITA, STR. A.MURESANU, NR. 3-5",1622,835,825,10,0,832,3,1700,865,471,361,1,3010,0
6,"Bistrita-Nasaud",32394,65,32394,,"MUNICIPIUL BISTRITA",30,"UNIVERSITATEA ""BABES-BOLYAI"" CLUJ-NAPOCA, EXTENSIA UNIVERSITARA BISTRITA, SALA 11, BISTRITA, STR. A.MURESANU, NR. 3-5",1599,799,785,14,0,796,3,1699,900,513,283,1,3010,0
6,"Bistrita-Nasaud",32394,65,32394,,"MUNICIPIUL BISTRITA",31,"SCOALA GENERALA NR. 4 - CORPUL A SALA PROFESORALA (SALA 5), BISTRITA, STR. FLORILOR, NR. 3-5",1610,935,921,14,0,924,11,1700,765,536,388,1,3010,0
6,"Bistrita-Nasaud",32394,65,32394,,"MUNICIPIUL BISTRITA",32,"SCOALA GENERALA NR. 4 - CORPUL B SALA 56, BISTRITA, STR. FLORILOR, NR. 3-5",1392,751,736,15,0,750,1,1500,749,479,271,1,3010,0
6,"Bistrita-Nasaud",32394,65,32394,,"MUNICIPIUL BISTRITA",33,"GRADINITA CU PROGRAM NORMAL NR. 5 BISTRITA, SALA 1, BISTRITA, STR. MESTEACANULUI, NR. 15",1457,696,686,10,0,694,2,1500,804,466,228,1,3010,0
6,"Bistrita-Nasaud",32394,65,32394,,"MUNICIPIUL BISTRITA",34,"GRADINITA CU PROGRAM PRELUNGIT NR. 12 BISTRITA, SALA 1, BISTRITA, STR. A.MURESANU, NR. 44A",1510,820,810,10,0,818,2,1600,780,443,375,1,3010,0
6,"Bistrita-Nasaud",32394,65,32394,,"MUNICIPIUL BISTRITA",35,"GRADINITA CU PROGRAM NORMAL NR. 16 BISTRITA, BISTRITA, STR. CERBULUI, NR. 27",1381,824,798,26,0,816,8,1400,576,510,306,1,3010,0
6,"Bistrita-Nasaud",32394,65,32394,,"MUNICIPIUL BISTRITA",36,"SCOALA GENERALA NR. 3 ""AVRAM IANCU"" BISTRITA, SALA 3 B, BISTRITA, STR. 1 DECEMBRIE, NR. 27-29",1491,846,833,13,0,843,3,1600,754,434,409,1,3010,0
6,"Bistrita-Nasaud",32394,65,32394,,"MUNICIPIUL BISTRITA",37,"SCOALA GENERALA NR. 3 ""AVRAM IANCU"" BISTRITA, SALA 6 C, BISTRITA, STR. 1 DECEMBRIE, NR. 27-29",1340,781,768,13,0,776,5,1400,619,470,306,1,3010,0
6,"Bistrita-Nasaud",32394,65,32394,,"MUNICIPIUL BISTRITA",38,"GRADINITA CU PROGRAM NORMAL NR. 13 BISTRITA, SALA 1, BISTRITA,  STR. PETRE ISPIRESCU, NR. 10A",1520,899,886,13,0,889,10,1600,701,492,397,1,3010,0
6,"Bistrita-Nasaud",32394,65,32394,,"MUNICIPIUL BISTRITA",39,"SCOALA GENERALA NR.6 ""STEFAN CEL MARE"" BISTRITA, SALA  8, BISTRITA, B-DUL G-RAL GR. BALAN, NR. 36A",1439,806,786,19,1,797,9,1500,694,436,361,1,3010,0
6,"Bistrita-Nasaud",32394,65,32394,,"MUNICIPIUL BISTRITA",40,"SCOALA GENERALA NR.6 ""STEFAN CEL MARE"" BISTRITA, CANTINA, BISTRITA, B-DUL G-RAL GR. BALAN, NR. 36A",1550,859,836,22,1,854,5,1600,741,545,309,1,3010,0
6,"Bistrita-Nasaud",32394,65,32394,,"MUNICIPIUL BISTRITA",41,"GRADINITA CU PROGRAM PRELUNGIT NR. 3 BISTRITA, SALA 1, BISTRITA, ALEEA PLAIESULUI, NR. 2",1582,882,860,22,0,878,4,1600,718,551,327,1,3010,0
6,"Bistrita-Nasaud",32394,65,32394,,"MUNICIPIUL BISTRITA",42,"CRESA NR. 3 BISTRITA, SALA 2, BISTRITA , ALEEA PLAIESULUI, NR. 2",1168,594,580,14,0,591,3,1200,606,340,251,1,3010,0
6,"Bistrita-Nasaud",32394,65,32394,,"MUNICIPIUL BISTRITA",43,"GRADINITA CU PROGRAM PRELUNGIT NR. 7 BISTRITA, SALA 2, BISTRITA, STR. C-TIN ROMAN VIVU, NR. 29",1158,681,665,15,1,675,6,1200,519,385,290,1,3010,0
6,"Bistrita-Nasaud",32394,65,32394,,"MUNICIPIUL BISTRITA",44,"GRADINITA CU PROGRAM PRELUNGIT NR. 7  BISTRITA, SALA 3, BISTRITA, STR. C-TIN ROMAN VIVU, NR. 29",926,521,511,9,1,516,5,1000,479,323,193,1,3010,0
6,"Bistrita-Nasaud",32394,65,32394,,"MUNICIPIUL BISTRITA",45,"SEDIUL ASOCIATIEI ROTARY CLUB BISTRITA (FOST SEDIU FLORARIE), BISTRITA, STR. GRANICERILOR, NR. 1",1325,728,709,19,0,728,0,1400,672,475,253,1,3010,0
6,"Bistrita-Nasaud",32394,65,32394,,"MUNICIPIUL BISTRITA",46,"GRADINITA CU PROGRAM PRELUNGIT NR. 4 BISTRITA, BISTRITA, STR. BARGAULUI, NR. 12",1487,803,788,14,1,800,3,1500,697,526,274,1,3010,0
6,"Bistrita-Nasaud",32394,65,32394,,"MUNICIPIUL BISTRITA",47,"COLEGIUL TEHNIC ""INFOEL"" - CORPUL B, SALA 52, BISTRITA, CALEA MOLDOVEI, NR. 18",1577,834,827,7,0,829,5,1600,766,478,351,1,3010,0
6,"Bistrita-Nasaud",32394,65,32394,,"MUNICIPIUL BISTRITA",48,"LICEUL CU PROGRAM SPORTIV - CORPUL B, SALA 7, BISTRITA, CALEA MOLDOVEI, NR. 18",1152,623,611,12,0,619,4,1200,577,431,188,1,3010,0
6,"Bistrita-Nasaud",32394,65,32394,,"MUNICIPIUL BISTRITA",49,"LICEUL CU PROGRAM SPORTIV - CORPUL B, SALA 6, BISTRITA, CALEA MOLDOVEI, NR. 18",1049,632,617,15,0,627,5,1100,468,414,213,1,3010,0
6,"Bistrita-Nasaud",32394,65,32394,,"MUNICIPIUL BISTRITA",50,"SCOALA GENERALA GHINDA, LOCALITATEA COMPONENTA GHINDA",592,361,353,8,0,356,5,700,339,222,134,1,3010,0
6,"Bistrita-Nasaud",32394,65,32394,,"MUNICIPIUL BISTRITA",51,"SCOALA GENERALA SARATA, LOCALITATEA COMPONENTA SARATA",845,493,483,10,0,490,3,900,407,289,201,1,3010,0
6,"Bistrita-Nasaud",32394,65,32394,,"MUNICIPIUL BISTRITA",52,"SCOALA GENERALA SIGMIR, LOCALITATEA COMPONENTA SIGMIR",647,426,406,19,1,422,4,700,274,255,167,1,3010,0
6,"Bistrita-Nasaud",32394,65,32394,,"MUNICIPIUL BISTRITA",53,"SCOALA GENERALA ""DIMITRIE COJOCARU"" SLATINITA, LOCALITATEA COMPONENTA SLATINITA",567,329,319,10,0,328,1,700,371,243,85,1,3010,0
6,"Bistrita-Nasaud",32394,65,32394,,"MUNICIPIUL BISTRITA",54,"SCOALA GENERALA UNIREA, SALA1, LOCALITATEA COMPONENTA UNIREA",926,556,550,6,0,556,0,1000,444,379,177,1,3010,0
6,"Bistrita-Nasaud",32394,65,32394,,"MUNICIPIUL BISTRITA",55,"SCOALA GENERALA UNIREA, SALA 2, LOCALITATEA COMPONENTA UNIREA",983,627,606,21,0,621,6,1100,473,387,234,1,3010,0
6,"Bistrita-Nasaud",32394,65,32394,,"MUNICIPIUL BISTRITA",56,"SCOALA GENERALA VIISOARA, LOCALITATEA COMPONENTA VIISOARA",1507,873,860,13,0,862,11,1600,727,598,264,1,3010,0
6,"Bistrita-Nasaud",32394,65,32394,,"MUNICIPIUL BISTRITA",57,"GRADINITA NR. 14 ""TRENULETUL VESELIEI"" BISTRITA, SALA 1, BISTRITA, STR. RODNEI, NR. 3",0,1407,0,1407,0,1401,6,1450,43,944,457,1,3010,1
6,"Bistrita-Nasaud",32483,65,32483,,"ORAS BECLEAN",58,"SALA DE CASATORII, BECLEAN, STR. 1 DECEMBRIE 1918, NR. 2",1419,893,882,10,1,886,7,1501,608,431,455,1,3018,0
6,"Bistrita-Nasaud",32483,65,32483,,"ORAS BECLEAN",59,"SPITALUL ORASENESC, BECLEAN, STR. 1 DECEMBRIE 1918, NR. 63",1406,823,809,9,5,816,7,1500,677,336,480,1,3018,0
6,"Bistrita-Nasaud",32483,65,32483,,"ORAS BECLEAN",60,"CLUBUL COPIILOR, HOL, BECLEAN, STR. ALEEA GARII, NR. 10",902,522,513,9,0,518,4,1200,678,271,247,1,3018,0
6,"Bistrita-Nasaud",32483,65,32483,,"ORAS BECLEAN",61,"CLUBUL COPIILOR, BIROU, BECLEAN, STR. ALEEA GARII, NR. 10",920,510,500,8,2,507,3,1000,490,260,247,1,3018,0
6,"Bistrita-Nasaud",32483,65,32483,,"ORAS BECLEAN",62,"SEDIUL LA SCOALA GENERALA ""GRIGORE SILASI"" BECLEAN, BECLEAN, STR. P-TA LIBERTATII, NR.19",1466,908,891,8,9,901,7,1600,692,453,448,1,3018,0
6,"Bistrita-Nasaud",32483,65,32483,,"ORAS BECLEAN",63,"CASA DE CULTURA ""R. SAPLACAN"", BECLEAN, STR. AL. GHIOCELULUI, NR. 6",1544,882,869,12,1,870,12,1600,718,417,453,1,3018,0
6,"Bistrita-Nasaud",32483,65,32483,,"ORAS BECLEAN",64,"SCOALA GENERALA BECLENUT, BECLEAN, STR. BECLENUT, NR. 27",331,235,221,10,4,231,4,400,165,95,136,1,3018,0
6,"Bistrita-Nasaud",32483,65,32483,,"ORAS BECLEAN",65,"SCOALA GENERALA VALEA VIILOR, BECLEAN, STR. VALEA VIILOR, NR. 10",355,248,240,8,0,245,3,400,152,127,118,1,3018,0
6,"Bistrita-Nasaud",32483,65,32483,,"ORAS BECLEAN",66,"SCOALA GENERALA COLDAU, SAT COLDAU, NR. 145",606,342,335,6,1,340,2,700,358,185,155,1,3018,0
6,"Bistrita-Nasaud",32483,65,32483,,"ORAS BECLEAN",67,"SCOALA GENERALA FIGA, SAT FIGA, NR. 131",405,321,307,10,4,319,2,500,179,73,246,1,3018,0
6,"Bistrita-Nasaud",32483,65,32483,,"ORAS BECLEAN",68,"SCOALA GENERALA RUSU DE JOS, SAT RUSU DE JOS, NR. 26",290,173,165,8,0,170,3,400,227,76,94,1,3018,0
6,"Bistrita-Nasaud",32483,65,32483,,"ORAS BECLEAN",69,"CASA DE VANATOARE BECLEAN, BECLEAN, STR. GHIOCELULUI, NR. 6, ETAJ. I",0,357,0,357,0,354,3,600,243,201,153,1,3018,1
6,"Bistrita-Nasaud",32544,65,32544,,"ORAS NASAUD",70,"CASA DE CULTURA ""LIVIU REBREANU"" NASAUD, NASAUD, STR. PIATA UNIRII, NR. 2",1454,890,880,9,1,878,12,1500,610,515,363,1,3023,0
6,"Bistrita-Nasaud",32544,65,32544,,"ORAS NASAUD",71,"SCOALA GENERALA ""MIHAI EMINESCU"" NASAUD, NASAUD, B-DUL GRANICERILOR, NR. 15",1448,803,788,12,3,798,5,1500,697,447,351,1,3023,0
6,"Bistrita-Nasaud",32544,65,32544,,"ORAS NASAUD",72,"GRUPUL SCOLAR ECONOMIC ADMINISTRATIV SI DE SERVICII, NASAUD, B-DUL GRANICERILOR, NR. 2",1326,709,698,10,1,704,5,1500,791,443,261,1,3023,0
6,"Bistrita-Nasaud",32544,65,32544,,"ORAS NASAUD",73,"GRUP SCOLAR SILVIC, NASAUD, STR. GARII, NR. 1",1628,794,786,8,0,787,7,1700,906,421,366,1,3023,0
6,"Bistrita-Nasaud",32544,65,32544,,"ORAS NASAUD",74,"AUTOGARA CALATORI, NASAUD, STR. GARII, NR. 11",1455,752,736,16,0,740,12,1600,848,496,244,1,3023,0
6,"Bistrita-Nasaud",32544,65,32544,,"ORAS NASAUD",75,"SCOALA GENERALA VALEA SPINULUI, NASAUD, STR. GEORGE COSBUC, NR. 184",1014,557,544,13,0,548,9,1100,543,321,227,1,3023,0
6,"Bistrita-Nasaud",32544,65,32544,,"ORAS NASAUD",76,"CAMINUL CULTURAL LIVIU REBREANU, LOCALITATEA COMPONENTA LIVIU REBREANU, NR. 8",632,438,432,6,0,438,0,700,262,207,231,1,3023,0
6,"Bistrita-Nasaud",32544,65,32544,,"ORAS NASAUD",77,"CAMINUL CULTURAL LUSCA, LOCALITATEA COMPONENTA LUSCA, NR. 185",515,325,317,8,0,322,3,600,275,219,103,1,3023,0
6,"Bistrita-Nasaud",32544,65,32544,,"ORAS NASAUD",78,"AUTOGARA CALATORI, NASAUD, STR. GARII, NR. 11",0,248,0,248,0,246,2,400,152,161,85,1,3023,1
6,"Bistrita-Nasaud",32599,65,32599,,"ORAS SANGEORZ-BAI",79,"SCOALA GENERALA ""ARTEMIU PUBLIU ALEXI"" SALA 1, SANGEORZ-BAI, STR. REPUBLICII, NR. 38",1355,724,718,5,1,720,4,1400,676,397,323,1,3027,0
6,"Bistrita-Nasaud",32599,65,32599,,"ORAS SANGEORZ-BAI",80,"SCOALA GENERALA ""ARTEMIU PUBLIU ALEXI"" SALA 4, SANGEORZ-BAI, STR. REPUBLICII, NR. 38",1346,722,716,6,0,721,1,1400,678,469,252,1,3027,0
6,"Bistrita-Nasaud",32599,65,32599,,"ORAS SANGEORZ-BAI",81,"CLUBUL TINERETULUI, SANGEORZ-BAI, STR. CARPATILOR, NR. 8",1304,785,774,11,0,779,6,1400,615,561,218,1,3027,0
6,"Bistrita-Nasaud",32599,65,32599,,"ORAS SANGEORZ-BAI",82,"LICEUL TEORETIC ""SOLOMON HALITA"", SANGEORZ-BAI, STR. REPUBLICII, NR. 39",1278,600,592,8,0,598,2,1400,800,382,216,1,3027,0
6,"Bistrita-Nasaud",32599,65,32599,,"ORAS SANGEORZ-BAI",83,"POLICLINICA BALNEARA VECHE, SANGEORZ-BAI, STR. IZVOARELOR, NR. 94",1195,614,604,10,0,612,2,1301,687,432,180,1,3027,0
6,"Bistrita-Nasaud",32599,65,32599,,"ORAS SANGEORZ-BAI",84,"SCOALA GENERALA SANGEORZ-BAI, SANGEORZ-BAI, STR. TEILOR, NR. 4",1228,712,705,7,0,706,6,1300,588,468,238,1,3027,0
6,"Bistrita-Nasaud",32599,65,32599,,"ORAS SANGEORZ-BAI",85,"SCOALA GENERALA CORMAIA, LOCALITATEA COMPONENTA CORMAIA, NR. 138",608,325,319,6,0,322,3,700,375,224,98,1,3027,0
6,"Bistrita-Nasaud",32599,65,32599,,"ORAS SANGEORZ-BAI",86,"LICEUL TEORETIC ""SOLOMON HALITA"", SALA 2, SANGEORZ-BAI, STR. REPUBLICII, NR. 39",0,84,0,84,0,81,3,500,416,50,31,1,3027,1
6,"Bistrita-Nasaud",32633,65,32633,,"BISTRITA BARGAULUI",87,"PRIMARIA COMUNEI BISTRITA BARGAULUI, SAT BISTRITA BARGAULUI, NR. 1326",1309,871,862,8,1,862,9,1400,529,694,168,3,3031,0
6,"Bistrita-Nasaud",32633,65,32633,,"BISTRITA BARGAULUI",88,"SCOALA GENERALA NR. 2 BISTRITA BARGAULUI (PUSTA), SAT BISTRITA BARGAULUI, NR. 414",945,534,520,12,2,529,5,1000,466,436,93,3,3031,0
6,"Bistrita-Nasaud",32633,65,32633,,"BISTRITA BARGAULUI",89,"SALA DE NUNTI DIN BISTRITA BARGAULUI (PUSTA), SAT BISTRITA BARGAULUI, NR. 1020/A",1039,614,602,11,1,607,7,1100,486,529,78,3,3031,0
6,"Bistrita-Nasaud",32633,65,32633,,"BISTRITA BARGAULUI",90,"SCOALA GENERALA COLIBITA, SAT COLIBITA, NR. 84",233,140,130,10,0,138,2,300,160,113,25,3,3031,0
6,"Bistrita-Nasaud",32633,65,32633,,"BISTRITA BARGAULUI",91,"SCOALA GENERALA BISTRITA BARGAULUI, SAT BISTRITA BARGAULUI, NR. 1327",0,109,0,109,0,108,1,200,91,75,33,3,3031,1
6,"Bistrita-Nasaud",32660,65,32660,,"BRANISTEA",92,"PRIMARIA COMUNEI BRANISTEA, SALA DE SEDINTE, SAT BRANISTEA, NR. 101",995,667,646,4,17,665,2,1100,433,243,422,3,3034,0
6,"Bistrita-Nasaud",32660,65,32660,,"BRANISTEA",93,"CAMINUL CULTURAL CIRESOAIA, SALA MICA, SAT CIRESOAIA, NR. 19",1278,572,532,6,34,566,6,1400,828,181,385,3,3034,0
6,"Bistrita-Nasaud",32660,65,32660,,"BRANISTEA",94,"CAMINUL CULTURAL MALUT, SAT MALUT, NR. 42",499,376,367,2,7,368,8,601,225,156,212,3,3034,0
6,"Bistrita-Nasaud",32660,65,32660,,"BRANISTEA",95,"SEDIUL PRIMARIEI COMUNEI BRANISTEA, SAT BRANISTEA, NR. 101",0,67,0,67,0,67,0,200,133,26,41,3,3034,1
6,"Bistrita-Nasaud",32704,65,32704,,"BUDACU DE JOS",96,"PRIMARIA COMUNEI BUDACU DE JOS, BIROUL RELATII CU PUBLICUL, SAT BUDACU DE JOS, NR. 251",739,411,407,3,1,405,6,800,389,248,157,3,3038,0
6,"Bistrita-Nasaud",32704,65,32704,,"BUDACU DE JOS",97,"SCOALA GENERALA BUDUS, SAT BUDUS, NR. 200",455,303,289,4,10,299,4,500,197,244,55,3,3038,0
6,"Bistrita-Nasaud",32704,65,32704,,"BUDACU DE JOS",98,"GRADINITA DE COPII JELNA, SAT JELNA, NR. 109",704,485,462,12,11,480,5,800,315,363,117,3,3038,0
6,"Bistrita-Nasaud",32704,65,32704,,"BUDACU DE JOS",99,"SCOALA GENERALA MONARIU, SAT MONARIU, NR. 126",340,239,230,7,2,237,2,400,161,167,70,3,3038,0
6,"Bistrita-Nasaud",32704,65,32704,,"BUDACU DE JOS",100,"SCOALA GENERALA SIMIONESTI, SAT SIMIONESTI,  NR. 19",189,127,122,5,0,125,2,300,173,77,48,3,3038,0
6,"Bistrita-Nasaud",32704,65,32704,,"BUDACU DE JOS",101,"SALA DE SEDINTE A CONSILIULUI LOCAL BUDACU DE JOS, SAT BUDACU DE JOS, NR. 251",0,86,0,86,0,86,0,300,214,72,14,3,3038,1
6,"Bistrita-Nasaud",32768,65,32768,,"BUDESTI",102,"SCOALA GENERALA BUDESTI, SAT BUDESTI, NR. 252",537,305,302,3,0,302,3,600,295,160,142,3,3044,0
6,"Bistrita-Nasaud",32768,65,32768,,"BUDESTI",103,"SCOALA GENERALA BUDESTI-FANATE, SAT BUDESTI-FANATE, NR. 37",269,190,186,4,0,189,1,400,210,93,96,3,3044,0
6,"Bistrita-Nasaud",32768,65,32768,,"BUDESTI",104,"SCOALA GENERALA TAGU, SAT TAGU, NR. 212/A",539,315,308,6,1,314,1,600,285,153,161,3,3044,0
6,"Bistrita-Nasaud",32768,65,32768,,"BUDESTI",105,"SCOALA GENERALA TAGSORU, SAT TAGSORU, NR. 103/A",256,149,142,7,0,149,0,300,151,84,65,3,3044,0
6,"Bistrita-Nasaud",32768,65,32768,,"BUDESTI",106,"SCOALA GENERALA TAGU, SAT TAGU, NR. 212/A",0,63,0,63,0,61,2,200,137,41,20,3,3044,1
6,"Bistrita-Nasaud",32811,65,32811,,"CAIANU MIC",107,"PRIMARIA COMUNEI CAIANU MIC, SAT CAIANU MIC, NR. 100",1248,620,618,2,0,608,12,1300,680,272,336,3,3049,0
6,"Bistrita-Nasaud",32811,65,32811,,"CAIANU MIC",108,"SCOALA GENERALA CAIANU MARE, SAT CAIANU MARE, NR. 252",496,289,283,6,0,286,3,600,311,127,159,3,3049,0
6,"Bistrita-Nasaud",32811,65,32811,,"CAIANU MIC",109,"SCOALA GENERALA CICEU-POIENI, SAT CICEU-POIENI, NR. 218",636,318,312,6,0,313,5,700,382,128,185,3,3049,0
6,"Bistrita-Nasaud",32811,65,32811,,"CAIANU MIC",110,"GRADINITA VECHE DIN DOBRIC, SAT DOBRIC, NR. 43",927,411,405,6,0,407,4,1000,589,206,201,3,3049,0
6,"Bistrita-Nasaud",32811,65,32811,,"CAIANU MIC",111,"SEDIUL PRIMARIEI COMUNEI CAIANU MIC, SAT CAIANU MIC, NR. 100",0,46,0,46,0,46,0,200,154,33,13,3,3049,1
6,"Bistrita-Nasaud",32884,65,32884,,"CETATE",112,"BIBLIOTECA COMUNALA SATU NOU, SAT SATU NOU, NR. 169",580,355,348,3,4,353,2,700,345,213,140,3,3054,0
6,"Bistrita-Nasaud",32884,65,32884,,"CETATE",113,"CAMINUL CULTURAL ORHEIU BISTRITEI, SAT ORHEIU BISTRITEI, NR. 27",563,362,356,4,2,360,2,700,338,205,155,3,3054,0
6,"Bistrita-Nasaud",32884,65,32884,,"CETATE",114,"SCOALA VECHE DIN CENTRU CLS I-IV, SAT PETRIS, NR. 290",914,556,547,4,5,549,7,1000,444,364,185,3,3054,0
6,"Bistrita-Nasaud",32884,65,32884,,"CETATE",115,"SEDIUL PRIMARIEI COMUNEI CETATE, SAT SATU-NOU, NR. 53",0,57,0,57,0,57,0,100,43,31,26,3,3054,1
6,"Bistrita-Nasaud",33015,65,33015,,"CHIOCHIS",116,"PRIMARIA COMUNEI CHIOCHIS, SAT CHIOCHIS, NR. 17",376,240,236,2,2,239,1,500,260,125,114,3,3058,0
6,"Bistrita-Nasaud",33015,65,33015,,"CHIOCHIS",117,"SCOALA GENERALA APATIU, SAT APATIU, NR. 52",271,230,212,6,12,228,2,400,170,147,81,3,3058,0
6,"Bistrita-Nasaud",33015,65,33015,,"CHIOCHIS",118,"SCOALA GENERALA BOZIES, SAT BOZIES, NR. 27",571,372,367,5,0,370,2,700,328,247,123,3,3058,0
6,"Bistrita-Nasaud",33015,65,33015,,"CHIOCHIS",119,"SCOALA GENERALA BUZA CATUN, SAT BUZA CATUN, NR. 7",112,74,68,6,0,73,1,201,127,34,39,3,3058,0
6,"Bistrita-Nasaud",33015,65,33015,,"CHIOCHIS",120,"SCOALA GENERALA CHETIU, SAT CHETIU, NR. 27",270,177,159,7,11,175,2,398,221,108,67,3,3058,0
6,"Bistrita-Nasaud",33015,65,33015,,"CHIOCHIS",121,"SCOALA GENERALA JIMBOR, SAT JIMBOR, NR. 77",416,288,260,7,21,285,3,500,212,168,117,3,3058,0
6,"Bistrita-Nasaud",33015,65,33015,,"CHIOCHIS",122,"SCOALA GENERALA MANIC, SAT MANIC, NR. 87",222,165,143,10,12,165,0,300,135,113,52,3,3058,0
6,"Bistrita-Nasaud",33015,65,33015,,"CHIOCHIS",123,"SCOALA GENERALA SANICOARA, SAT SANICOARA, NR. 79",121,101,89,5,7,98,3,200,99,67,31,3,3058,0
6,"Bistrita-Nasaud",33015,65,33015,,"CHIOCHIS",124,"SCOALA GENERALA STRUGURENI, SAT STRUGURENI, NR. 104",182,133,125,8,0,133,0,300,167,89,44,3,3058,0
6,"Bistrita-Nasaud",33015,65,33015,,"CHIOCHIS",125,"SCOALA GENERALA TENTEA, SAT TENTEA, NR. 123",134,94,85,9,0,91,3,200,106,55,36,3,3058,0
6,"Bistrita-Nasaud",33015,65,33015,,"CHIOCHIS",126,"SEDIUL PRIMARIEI COMUNEI CHIOCHIS, SAT CHIOCHIS, NR. 17",0,110,0,110,0,109,1,500,390,75,34,3,3058,1
6,"Bistrita-Nasaud",33122,65,33122,,"CHIUZA",127,"SCOALA GENERALA CHIUZA, SAT CHIUZA, NR. 14",704,449,421,4,24,448,1,800,351,197,251,3,3069,0
6,"Bistrita-Nasaud",33122,65,33122,,"CHIUZA",128,"SCOALA GENERALA MIRES, SAT MIRES, NR. 16",123,95,82,7,6,94,1,200,105,25,69,3,3069,0
6,"Bistrita-Nasaud",33122,65,33122,,"CHIUZA",129,"SCOALA GENERALA PIATRA, SAT PIATRA, NR. 141 A",404,282,256,5,21,281,1,500,218,121,160,3,3069,0
6,"Bistrita-Nasaud",33122,65,33122,,"CHIUZA",130,"SCOALA GENERALA SASARM, SAT SASARM, NR. 38",561,360,338,8,14,354,6,700,340,211,143,3,3069,0
6,"Bistrita-Nasaud",33122,65,33122,,"CHIUZA",131,"SCOALA GENERALA CHIUZA, SAT CHIUZA, NR. 14",0,50,0,50,0,49,1,200,150,13,36,3,3069,1
6,"Bistrita-Nasaud",32955,65,32955,,"CICEU-GIURGESTI",132,"SCOALA GENERALA CICEU-GIURGESTI, SALA DE CLASA PARTER, SAT CICEU-GIURGESTI, NR. 287 B",838,511,494,3,14,506,5,900,389,290,216,3,3078,0
6,"Bistrita-Nasaud",32955,65,32955,,"CICEU-GIURGESTI",133,"CAMINUL CULTURAL DUMBRAVENI, SAT DUMBRAVENI, NR. 232",591,428,421,7,0,422,6,700,272,177,245,3,3078,0
6,"Bistrita-Nasaud",32955,65,32955,,"CICEU-GIURGESTI",134,"SCOALA GENERALA CICEU-GIURGESTI, SAT CICEU-GIURGESTI, NR. 287 B",0,94,0,94,0,94,0,200,106,49,45,3,3078,1
6,"Bistrita-Nasaud",179953,65,179953,,"CICEU - MIHAIESTI",135,"CAMINUL CULTURAL CICEU - MIHAIESTI, HOLUL IMOBILULUI, SAT CICEU - MIHAIESTI, NR. 42",719,394,371,12,11,393,1,800,406,170,223,3,3074,0
6,"Bistrita-Nasaud",179953,65,179953,,"CICEU - MIHAIESTI",136,"SCOALA GENERALA CICEU-CORABIA, SAT CICEU-CORABIA, NR. 86",136,74,65,9,0,72,2,200,126,42,30,3,3074,0
6,"Bistrita-Nasaud",179953,65,179953,,"CICEU - MIHAIESTI",137,"SCOALA GENERALA LELESTI, SAT LELESTI, NR. 58",150,89,83,6,0,89,0,202,113,54,35,3,3074,0
6,"Bistrita-Nasaud",179953,65,179953,,"CICEU - MIHAIESTI",138,"CAMINUL CULTURAL CICEU - MIHAIESTI, SAT CICEU - MIHAIESTI, NR. 42",0,63,0,63,0,62,1,200,137,31,31,3,3074,1
6,"Bistrita-Nasaud",33177,65,33177,,"COSBUC",139,"CAMINUL CULTURAL COSBUC, SAT COSBUC, NR. 363",852,431,429,2,0,424,7,900,469,121,303,3,3081,0
6,"Bistrita-Nasaud",33177,65,33177,,"COSBUC",140,"CAMINUL CULTURAL COSBUC, ANEXA CAMINULUI, SAT COSBUC, NR. 363",804,423,423,0,0,421,2,900,477,121,300,3,3081,0
6,"Bistrita-Nasaud",33177,65,33177,,"COSBUC",141,"SCOALA GENERALA COSBUC, SAT COSBUC, NR. 243",0,32,0,32,0,32,0,100,68,5,27,3,3081,1
6,"Bistrita-Nasaud",33202,65,33202,,"DUMITRA",142,"SCOALA GENERALA DUMITRA, SALA 1, SAT DUMITRA, NR. 5",1129,665,648,4,13,662,3,1201,536,476,186,3,3083,0
6,"Bistrita-Nasaud",33202,65,33202,,"DUMITRA",143,"SCOALA GENERALA DUMITRA, SALA 2, SAT DUMITRA, NR. 5",1053,624,613,3,8,617,7,1100,476,452,165,3,3083,0
6,"Bistrita-Nasaud",33202,65,33202,,"DUMITRA",144,"SCOALA GENERALA CEPARI, SALA 1, SAT CEPARI, NR. 73",768,450,434,6,10,446,4,800,350,324,122,3,3083,0
6,"Bistrita-Nasaud",33202,65,33202,,"DUMITRA",145,"SCOALA GENERALA TARPIU, SALA 1, SAT TARPIU, NR. 270",691,294,270,12,12,292,2,802,508,192,100,3,3083,0
6,"Bistrita-Nasaud",33202,65,33202,,"DUMITRA",146,"SCOALA GENERALA DUMITRA, SALA 3, SAT DUMITRA, NR. 5",0,163,0,163,0,163,0,600,437,120,43,3,3083,1
6,"Bistrita-Nasaud",179686,65,179686,,"DUMITRITA",147,"SCOALA GENERALA DUMITRITA, SAT DUMITRITA, NR. 150",922,588,571,9,8,583,5,1000,412,384,199,3,3087,0
6,"Bistrita-Nasaud",179686,65,179686,,"DUMITRITA",148,"SCOALA GENERALA CLS. I-IV BUDACU DE SUS, SAT BUDACU DE SUS, NR. 65 A",1349,853,819,29,5,838,15,1400,547,548,290,3,3087,0
6,"Bistrita-Nasaud",179686,65,179686,,"DUMITRITA",149,"SEDIUL PRIMARIEI COMUNEI DUMITRITA, CAMERA 7, SAT DUMITRITA, STR. PRINCIPALA, NR. 145",0,69,0,69,0,68,1,100,31,47,21,3,3087,1
6,"Bistrita-Nasaud",33248,65,33248,,"FELDRU",150,"PRIMARIA COMUNEI FELDRU, SALA DE SEDINTE NR. 1, SAT FELDRU, NR. 186",1497,806,768,28,10,802,4,1600,794,386,416,3,3091,0
6,"Bistrita-Nasaud",33248,65,33248,,"FELDRU",151,"GRUPUL SCOLAR FELDRU, SAT FELDRU, NR. 939",1412,653,623,26,4,650,3,1500,847,326,324,3,3091,0
6,"Bistrita-Nasaud",33248,65,33248,,"FELDRU",152,"CAMINUL CULTURAL FELDRU, SAT FELDRU, NR. 782",1450,719,662,47,10,714,5,1503,784,269,445,3,3091,0
6,"Bistrita-Nasaud",33248,65,33248,,"FELDRU",153,"SCOALA GENERALA FELDRU (PODEREIE), SAT FELDRU, NR. 1420",287,140,132,7,1,139,1,400,260,40,99,3,3091,0
6,"Bistrita-Nasaud",33248,65,33248,,"FELDRU",154,"CAMINUL CULTURAL NEPOS, SAT NEPOS, NR. 23 A",1463,797,767,18,12,797,0,1600,803,497,300,3,3091,0
6,"Bistrita-Nasaud",33248,65,33248,,"FELDRU",155,"SEDIUL PRIMARIEI COMUNEI FELDRU, SALA DE SEDINTE NR. 2, SAT FELDRU, NR. 186",0,136,0,136,0,135,1,400,264,94,41,3,3091,1
6,"Bistrita-Nasaud",33275,65,33275,,"GALATII BISTRITEI",156,"CAMINUL CULTURAL GALATII BISTRITEI, SAT GALATII BISTRITEI, NR 241",550,384,366,6,12,383,1,600,216,148,235,3,3094,0
6,"Bistrita-Nasaud",33275,65,33275,,"GALATII BISTRITEI",157,"SCOALA GENERALA ALBESTII BISTRITEI, SAT ALBESTII BISTRITEI,  NR. 76",139,81,75,6,0,80,1,200,119,41,39,3,3094,0
6,"Bistrita-Nasaud",33275,65,33275,,"GALATII BISTRITEI",158,"SCOALA GENERALA CLASELE I-IV DIPSA, SAT DIPSA, NR. 252",694,402,396,5,1,399,3,802,400,148,251,3,3094,0
6,"Bistrita-Nasaud",33275,65,33275,,"GALATII BISTRITEI",159,"CAMINUL CULTURAL HERINA, SAT HERINA, NR. 113",409,286,274,7,5,284,2,500,214,70,214,3,3094,0
6,"Bistrita-Nasaud",33275,65,33275,,"GALATII BISTRITEI",160,"SCOALA GENERALA TONCIU, SAT TONCIU, NR. 145",196,130,112,9,9,129,1,300,170,35,94,3,3094,0
6,"Bistrita-Nasaud",33275,65,33275,,"GALATII BISTRITEI",161,"SEDIUL PRIMARIEI COMUNEI GALATII BISTRITEI, SALA DE SEDINTE, SAT GALATII BISTRITEI, STR. PRINCIPALA, NR. 241",0,134,0,134,0,134,0,300,166,43,91,3,3094,1
6,"Bistrita-Nasaud",33337,65,33337,,"ILVA MARE",162,"PRIMARIA COMUNEI ILVA MARE SALA MARE, SAT ILVA MARE, NR. 243",1091,756,732,0,24,751,5,1200,444,562,189,3,3100,0
6,"Bistrita-Nasaud",33337,65,33337,,"ILVA MARE",163,"PRIMARIA COMUNEI ILVA MARE SALA DE SEDINTE, SAT ILVA MARE, NR. 243",952,600,574,0,26,595,5,1000,400,495,100,3,3100,0
6,"Bistrita-Nasaud",33337,65,33337,,"ILVA MARE",164,"SEDIUL PRIMARIEI COMUNEI ILVA MARE, SAT ILVA MARE, STR. PRINCIPALA, NR. 243",0,54,0,54,0,54,0,300,246,38,16,3,3100,1
6,"Bistrita-Nasaud",33364,65,33364,,"ILVA MICA",165,"PRIMARIA VECHE ILVA MICA, SAT ILVA MICA, NR. 825",1470,712,645,61,6,704,8,1600,888,435,269,3,3103,0
6,"Bistrita-Nasaud",33364,65,33364,,"ILVA MICA",166,"SCOALA GENERALA NR. 1 ILVA MICA, SAT ILVA MICA, NR. 558",1347,935,756,155,24,925,10,1400,465,550,375,3,3103,0
6,"Bistrita-Nasaud",33364,65,33364,,"ILVA MICA",167,"SCOALA GENERALA NR. 2 ILVA MICA, SAT ILVA MICA, STR. PRINCIPALA, NR. 843",0,81,0,81,0,81,0,300,219,55,26,3,3103,1
6,"Bistrita-Nasaud",33382,65,33382,,"JOSENII BARGAULUI",168,"CAMINUL CULTURAL JOSENII BARGAULUI SALA MARE, SAT JOSENII BARGAULUI, NR. 152",824,474,466,7,1,469,5,899,425,319,150,3,3105,0
6,"Bistrita-Nasaud",33382,65,33382,,"JOSENII BARGAULUI",169,"SCOALA GENERALA JOSENII BARGAULUI SALA MARE, SAT JOSENII BARGAULUI, NR. 155",815,485,477,8,0,481,4,900,415,404,77,3,3105,0
6,"Bistrita-Nasaud",33382,65,33382,,"JOSENII BARGAULUI",170,"CAMINUL CULTURAL MIJLOCENII BARGAULUI, SAT MIJLOCENII BARGAULUI, NR. 76",1399,835,822,10,3,829,6,1498,663,468,361,3,3105,0
6,"Bistrita-Nasaud",33382,65,33382,,"JOSENII BARGAULUI",171,"CAMINUL CULTURAL RUSU BARGAULUI, SAT RUSU BARGAULUI, NR. 239",768,475,467,8,0,473,2,800,325,267,206,3,3105,0
6,"Bistrita-Nasaud",33382,65,33382,,"JOSENII BARGAULUI",172,"SCOALA PRIMARA STRAMBA, SAT STRAMBA, NR. 70",272,181,169,12,0,178,3,300,119,123,55,3,3105,0
6,"Bistrita-Nasaud",33382,65,33382,,"JOSENII BARGAULUI",173,"SCOALA GENERALA JOSENII BARGAULUI SALA CENTRU DE INFORMARE-DOCUMENTARE, SAT JOSENII BARGAULUI, NR. 155, ET. I",0,96,0,96,0,94,2,200,104,52,42,3,3105,1
6,"Bistrita-Nasaud",33435,65,33435,,"LECHINTA",174,"PRIMARIA COMUNEI LECHINTA, SAT LECHINTA, NR. 509",1187,764,711,21,32,757,7,1300,536,195,562,3,3110,0
6,"Bistrita-Nasaud",33435,65,33435,,"LECHINTA",175,"SCOALA PROFESIONALA LECHINTA, SAT LECHINTA, STR. GARII, NR.394",1208,793,753,23,17,784,9,1303,510,240,544,3,3110,0
6,"Bistrita-Nasaud",33435,65,33435,,"LECHINTA",176,"CAMINUL CULTURAL SANGEORZU NOU, SAT SANGEORZU NOU, NR. 290",831,486,466,20,0,483,3,900,414,255,228,3,3110,0
6,"Bistrita-Nasaud",33435,65,33435,,"LECHINTA",177,"SCOALA PRIMARA NOUA CHIRALES, SAT CHIRALES, NR. 210",395,262,251,9,2,262,0,500,238,100,162,3,3110,0
6,"Bistrita-Nasaud",33435,65,33435,,"LECHINTA",178,"SCOALA PRIMARA SANIACOB, SAT SANIACOB, NR. 94",189,145,129,9,7,141,4,300,155,37,104,3,3110,0
6,"Bistrita-Nasaud",33435,65,33435,,"LECHINTA",179,"SCOALA PRIMARA TIGAU, SAT TIGAU, NR. 37",361,237,230,7,0,237,0,400,163,98,139,3,3110,0
6,"Bistrita-Nasaud",33435,65,33435,,"LECHINTA",180,"SCOALA GENERALA VERMES, SAT VERMES, NR. 19",755,486,456,17,13,483,3,785,299,103,380,3,3110,0
6,"Bistrita-Nasaud",33435,65,33435,,"LECHINTA",181,"SALA DE SEDINTE A PRIMARIEI COMUNEI LECHINTA, SAT LECHINTA, STR. INDEPENDENTEI, NR. 509",0,188,0,188,0,188,0,500,312,73,115,3,3110,1
6,"Bistrita-Nasaud",33514,65,33514,,"LESU",182,"FOSTUL SEDIU AL PRIMARIEI LESU, SAT LESU, NR. 132A",1407,738,700,6,32,732,6,1500,762,380,352,3,3118,0
6,"Bistrita-Nasaud",33514,65,33514,,"LESU",183,"SCOALA GENERALA NR. 2 LUNCA LESULUI, SAT LUNCA LESULUI, NR. 254A",915,449,424,10,15,445,4,1000,551,351,94,3,3118,0
6,"Bistrita-Nasaud",33514,65,33514,,"LESU",184,"SEDIUL VECHI AL PRIMARIEI, SAT LESU, NR. 133/A",0,82,0,82,0,82,0,200,118,57,25,3,3118,1
6,"Bistrita-Nasaud",33541,65,33541,,"LIVEZILE",185,"PRIMARIA COMUNEI LIVEZILE, SAT LIVEZILE, NR. 164",1210,610,603,7,0,605,5,1308,698,485,120,3,3121,0
6,"Bistrita-Nasaud",33541,65,33541,,"LIVEZILE",186,"SCOALA GENERALA LIVEZILE, SAT LIVEZILE, NR. 525",1040,540,529,11,0,537,3,1100,560,391,146,3,3121,0
6,"Bistrita-Nasaud",33541,65,33541,,"LIVEZILE",187,"SCOALA GENERALA CUSMA, SAT CUSMA, NR. 41",532,322,314,8,0,321,1,600,278,189,132,3,3121,0
6,"Bistrita-Nasaud",33541,65,33541,,"LIVEZILE",188,"CAMINUL CULTURAL DOROLEA, SAT DOROLEA, NR. 48",567,296,291,5,0,294,2,700,404,172,122,3,3121,0
6,"Bistrita-Nasaud",33541,65,33541,,"LIVEZILE",189,"SCOALA GENERALA DUMBRAVA, SAT DUMBRAVA, NR. 7",219,152,143,9,0,152,0,300,148,86,66,3,3121,0
6,"Bistrita-Nasaud",33541,65,33541,,"LIVEZILE",190,"SCOALA GENERALA VALEA POIENII, SAT VALEA POIENII, NR. 17",117,88,79,9,0,87,1,200,112,19,68,3,3121,0
6,"Bistrita-Nasaud",33541,65,33541,,"LIVEZILE",191,"SERVICIUL PUBLIC COMUNITAR LOCAL DE EVIDENTA PERSOANEI LIVEZILE, SAT LIVEZILE, STR. PRINCIPALA, NR. 180/A",0,126,0,126,0,125,1,200,74,79,46,3,3121,1
6,"Bistrita-Nasaud",33603,65,33603,,"LUNCA ILVEI",192,"PRIMARIA COMUNEI LUNCA ILVEI, SALA DE SEDINTE, SAT LUNCA ILVEI, NR. 914",1389,861,831,5,25,844,17,1500,639,679,165,3,3127,0
6,"Bistrita-Nasaud",33603,65,33603,,"LUNCA ILVEI",193,"CAMINUL CULTURAL LUNCA ILVEI, SALA DE NUNTI, SAT LUNCA ILVEI, NR. 914",1246,880,850,13,17,873,7,1300,420,707,166,3,3127,0
6,"Bistrita-Nasaud",33603,65,33603,,"LUNCA ILVEI",194,"BIBLIOTECA COMUNALA LUNCA ILVEI, SAT LUNCA ILVEI, STR. PRINCIPALA, NR. 914",0,87,0,87,0,87,0,200,113,58,29,3,3127,1
6,"Bistrita-Nasaud",33621,65,33621,,"MAIERU",195,"GRUPUL SCOLAR MAIERU, LOCAL NR. 1 (LANGA CEC), SAT MAIERU, NR. 201",982,664,656,6,2,660,4,1100,436,562,98,3,3132,0
6,"Bistrita-Nasaud",33621,65,33621,,"MAIERU",196,"GRUPUL SCOLAR MAIERU, LOCAL NR. 2 (SCOALA VECHE) ARIPA DREAPTA, SAT MAIERU, NR. 201/A",1262,787,774,11,2,779,8,1300,513,623,156,3,3132,0
6,"Bistrita-Nasaud",33621,65,33621,,"MAIERU",197,"GRUPUL SCOLAR MAIERU, LOCAL NR. 2 (SCOALA VECHE) , SAT MAIERU, NR. 201/A",923,539,532,6,1,538,1,1000,461,411,127,3,3132,0
6,"Bistrita-Nasaud",33621,65,33621,,"MAIERU",198,"CAMINUL CULTURAL MAIERU, SAT MAIERU, NR. 831 (LANGA PRIMARIA NOUA)",1498,963,948,14,1,958,5,1600,637,751,207,3,3132,0
6,"Bistrita-Nasaud",33621,65,33621,,"MAIERU",199,"SCOALA GENERALA ANIES, SAT ANIES, NR. 60",1328,895,884,6,5,889,6,1400,505,623,266,3,3132,0
6,"Bistrita-Nasaud",33621,65,33621,,"MAIERU",200,"SEDIUL PRIMARIEI VECHI, SAT MAIERU, NR. 606",0,66,0,66,0,66,0,200,134,40,26,3,3132,1
6,"Bistrita-Nasaud",33658,65,33658,,"MATEI",201,"GRADINITA MATEI, SAT MATEI, NR. 89",603,456,436,5,15,449,7,700,244,313,136,3,3143,0
6,"Bistrita-Nasaud",33658,65,33658,,"MATEI",202,"SCOALA GENERALA BIDIU, SAT BIDIU, NR. 4",202,129,121,5,3,129,0,300,171,69,60,3,3143,0
6,"Bistrita-Nasaud",33658,65,33658,,"MATEI",203,"SCOALA GENERALA CORVINESTI, SAT CORVINESTI, NR. 81",598,419,408,6,5,419,0,687,268,297,122,3,3143,0
6,"Bistrita-Nasaud",33658,65,33658,,"MATEI",204,"SCOALA GENERALA ENCIU, SAT ENCIU, NR. 125",183,126,119,7,0,124,2,300,174,75,49,3,3143,0
6,"Bistrita-Nasaud",33658,65,33658,,"MATEI",205,"SCOALA GENERALA FANTANELE, SAT FANTANELE, NR. 85",540,326,315,3,8,323,3,600,274,173,150,3,3143,0
6,"Bistrita-Nasaud",33658,65,33658,,"MATEI",206,"SCOALA GENERALA MORUT, SAT MORUT, NR. 65",195,125,116,7,2,121,4,300,175,74,47,3,3143,0
6,"Bistrita-Nasaud",33658,65,33658,,"MATEI",207,"SEDIUL PRIMARIEI COMUNEI MATEI, SAT MATEI, NR. 182",0,61,0,61,0,61,0,298,237,46,15,3,3143,1
6,"Bistrita-Nasaud",33729,65,33729,,"MAGURA ILVEI",208,"CAMINUL CULTURAL MAGURA ILVEI, SAT MAGURA ILVEI, NR. 420",1437,839,805,2,32,833,6,1500,661,553,280,3,3129,0
6,"Bistrita-Nasaud",33729,65,33729,,"MAGURA ILVEI",209,"SCOALA PRIMARA ARSITA, SAT ARSITA, NR. 90",340,248,242,6,0,244,4,400,152,213,31,3,3129,0
6,"Bistrita-Nasaud",33729,65,33729,,"MAGURA ILVEI",210,"CAMINUL CULTURAL MAGURA ILVEI, SAT MAGURA ILVEI, NR. 420",0,35,0,35,0,34,1,200,165,24,10,3,3129,1
6,"Bistrita-Nasaud",33765,65,33765,,"MARISELU",211,"SCOALA GENERALA MARISELU, SAT MAGURELE, NR. 11",601,382,376,6,0,380,2,700,318,283,97,3,3135,0
6,"Bistrita-Nasaud",33765,65,33765,,"MARISELU",212,"CAMINUL CULTURAL BARLA, SAT BARLA, NR. 95",307,206,198,8,0,203,3,400,194,71,132,3,3135,0
6,"Bistrita-Nasaud",33765,65,33765,,"MARISELU",213,"SCOALA GENERALA DOMNESTI, SAT DOMNESTI, NR. 162",660,400,390,10,0,397,3,700,300,209,188,3,3135,0
6,"Bistrita-Nasaud",33765,65,33765,,"MARISELU",214,"SOCIETATEA AGRICOLA JEICA, SAT JEICA, NR. 128",96,66,56,10,0,63,3,200,134,30,33,3,3135,0
6,"Bistrita-Nasaud",33765,65,33765,,"MARISELU",215,"SCOALA GENERALA SANTIOANA, SAT SANTIOANA, NR. 149",408,262,255,7,0,256,6,500,238,113,143,3,3135,0
6,"Bistrita-Nasaud",33765,65,33765,,"MARISELU",216,"CAMINUL CULTURAL MARISELU, SAT MARISELU, NR. 149",0,71,0,71,0,70,1,400,329,38,32,3,3135,1
6,"Bistrita-Nasaud",33845,65,33845,,"MICESTII DE CAMPIE",217,"CAMINUL CULTURAL MICESTII DE CAMPIE, SAT MICESTII DE CAMPIE, NR. 208",304,212,208,4,0,210,2,400,188,65,145,3,3150,0
6,"Bistrita-Nasaud",33845,65,33845,,"MICESTII DE CAMPIE",218,"SCOALA GENERALA FANTANITA, SAT FANTANITA, NR. 9",337,211,206,5,0,209,2,400,189,115,94,3,3150,0
6,"Bistrita-Nasaud",33845,65,33845,,"MICESTII DE CAMPIE",219,"CAMINUL CULTURAL VISUIA, SAT VISUIA, NR. 125",368,241,238,3,0,240,1,400,159,124,116,3,3150,0
6,"Bistrita-Nasaud",33845,65,33845,,"MICESTII DE CAMPIE",220,"CAMINUL CULTURAL MICESTII DE CAMPIE, SAT MICESTII DE CAMPIE, NR. 208",0,55,0,55,0,55,0,200,145,21,34,3,3150,1
6,"Bistrita-Nasaud",33881,65,33881,,"MILAS",221,"PRIMARIA COMUNEI MILAS, SAT MILAS, NR. 282",683,412,408,4,0,405,7,800,388,170,235,3,3154,0
6,"Bistrita-Nasaud",33881,65,33881,,"MILAS",222,"SCOALA GENERALA CLS. I-IV COMLOD, SAT COMLOD, NR. 67",146,87,79,8,0,85,2,200,113,31,54,3,3154,0
6,"Bistrita-Nasaud",33881,65,33881,,"MILAS",223,"SCOALA GENERALA CLS. I-IV OROSFAIA, SAT OROSFAIA, NR. 117",357,232,224,8,0,230,2,500,268,99,131,3,3154,0
6,"Bistrita-Nasaud",33881,65,33881,,"MILAS",224,"SEDIUL PRIMARIEI COMUNEI MILAS, SAT MILAS, STR. PRINCIPALA, NR. 282",0,87,0,87,0,86,1,200,113,39,47,3,3154,1
6,"Bistrita-Nasaud",33952,65,33952,,"MONOR",225,"CAMINUL CULTURAL MONOR, SALA MICA DE SEDINTE, SAT MONOR, NR. 254",782,551,542,9,0,548,3,900,349,230,318,3,3161,0
6,"Bistrita-Nasaud",33952,65,33952,,"MONOR",226,"CAMINUL CULTURAL GLEDIN, SALA MICA DE SEDINTE, SAT GLEDIN, NR. 237",470,322,317,5,0,320,2,600,278,175,145,3,3161,0
6,"Bistrita-Nasaud",33952,65,33952,,"MONOR",227,"SEDIUL PRIMARIEI COMUNEI MONOR, SAT MONOR, NR. 408",0,58,0,58,0,58,0,100,42,30,28,3,3161,1
6,"Bistrita-Nasaud",179659,65,179659,,"NEGRILESTI",228,"SCOALA DE ARTE SI MESERII NEGRILESTI, SAT NEGRILESTI, NR. 503",1085,624,606,6,12,616,8,1200,576,302,314,3,3164,0
6,"Bistrita-Nasaud",179659,65,179659,,"NEGRILESTI",229,"SCOALA GENERALA ""VICTOR MOTOGNA"" BREAZA, SAT BREAZA, NR. 124",814,482,459,3,20,478,4,900,418,172,306,3,3164,0
6,"Bistrita-Nasaud",179659,65,179659,,"NEGRILESTI",230,"SCOALA GENERALA PURCARETE, SAT PURCARETE, NR. 12",172,117,109,8,0,115,2,300,183,47,68,3,3164,0
6,"Bistrita-Nasaud",179659,65,179659,,"NEGRILESTI",231,"SCOALA DE ARTE SI MESERII NEGRILESTI, SAT NEGRILESTI, NR. 503",0,70,0,70,0,70,0,200,130,38,32,3,3164,1
6,"Bistrita-Nasaud",33989,65,33989,,"NIMIGEA",232,"SCOALA GENERALA CLASELE V-VIII NIMIGEA DE JOS, SAT NIMIGEA DE JOS, NR. 450",1275,805,780,4,21,794,11,1400,595,442,352,3,3168,0
6,"Bistrita-Nasaud",33989,65,33989,,"NIMIGEA",233,"SCOALA GENERALA FLORESTI, SAT FLORESTI, NR. 27",377,253,241,12,0,249,4,500,247,153,96,3,3168,0
6,"Bistrita-Nasaud",33989,65,33989,,"NIMIGEA",234,"SCOALA GENERALA MINTIU, SAT MINTIU, NR. 56",343,218,206,8,4,216,2,400,182,130,86,3,3168,0
6,"Bistrita-Nasaud",33989,65,33989,,"NIMIGEA",235,"SCOALA GENERALA CLS. V-VIII MITITEI, SAT MITITEI, NR. 25",594,371,366,4,1,370,1,700,329,215,155,3,3168,0
6,"Bistrita-Nasaud",33989,65,33989,,"NIMIGEA",236,"CAMINUL CULTURAL MOCOD, SAT MOCOD, NR. 60",528,334,325,9,0,330,4,600,266,201,129,3,3168,0
6,"Bistrita-Nasaud",33989,65,33989,,"NIMIGEA",237,"SCOALA GENERALA MOGOSENI, SAT MOGOSENI, NR.57",258,192,177,7,8,190,2,400,208,84,106,3,3168,0
6,"Bistrita-Nasaud",33989,65,33989,,"NIMIGEA",238,"SCOALA GENERALA NIMIGEA DE SUS, SAT NIMIGEA DE SUS, NR. 179/A",504,350,335,7,8,349,1,600,250,237,112,3,3168,0
6,"Bistrita-Nasaud",33989,65,33989,,"NIMIGEA",239,"SCOALA GENERALA TAURE, SAT TAURE, NR. 199",384,263,257,6,0,261,2,500,237,100,161,3,3168,0
6,"Bistrita-Nasaud",33989,65,33989,,"NIMIGEA",240,"BIBLIOTECA COMUNALA, SAT NIMIGEA DE JOS, NR. 185",0,116,0,116,0,115,1,400,284,60,55,3,3168,1
6,"Bistrita-Nasaud",34075,65,34075,,"NUSENI",241,"PRIMARIA COMUNEI NUSENI, SAT NUSENI, NR. 37",724,509,492,1,16,504,5,800,291,357,147,3,3177,0
6,"Bistrita-Nasaud",34075,65,34075,,"NUSENI",242,"CAMINUL CULTURAL BEUDIU, SAT BEUDIU, NR. 128",531,407,371,8,28,402,5,600,193,298,104,3,3177,0
6,"Bistrita-Nasaud",34075,65,34075,,"NUSENI",243,"SCOALA GENERALA MALIN, SAT MALIN, NR. 133",395,265,252,3,10,260,5,500,235,142,118,3,3177,0
6,"Bistrita-Nasaud",34075,65,34075,,"NUSENI",244,"SCOALA GENERALA FELEAC, SAT FELEAC, NR. 163",284,211,199,6,6,208,3,400,189,146,62,3,3177,0
6,"Bistrita-Nasaud",34075,65,34075,,"NUSENI",245,"SCOALA GENERALA RUSU DE SUS, SAT RUSU DE SUS, NR. 27",235,197,183,6,8,196,1,300,103,124,72,3,3177,0
6,"Bistrita-Nasaud",34075,65,34075,,"NUSENI",246,"SCOALA GENERALA VITA, SAT VITA, NR. 213",312,181,158,5,18,176,5,410,229,121,55,3,3177,0
6,"Bistrita-Nasaud",34075,65,34075,,"NUSENI",247,"SEDIUL PRIMARIEI COMUNEI NUSENI, SAT NUSENI, NR. 37",0,173,0,173,0,171,2,590,417,120,51,3,3177,1
6,"Bistrita-Nasaud",34155,65,34155,,"PARVA",248,"CAMINUL CULTURAL PARVA SALA MARE NR.1 LA PARTERUL PRIMARIEI, SAT PARVA, NR. 162",1029,598,590,3,5,592,6,1100,502,277,315,3,3185,0
6,"Bistrita-Nasaud",34155,65,34155,,"PARVA",249,"CAMINUL CULTURAL PARVA SALA MARE NR.2 LA PARTERUL PRIMARIEI, SAT PARVA, NR. 162",761,430,422,8,0,428,2,800,370,230,198,3,3185,0
6,"Bistrita-Nasaud",34155,65,34155,,"PARVA",250,"CENTRUL TURISTIC HUBERT TYRODE PARVA, SAT PARVA, STRADA PRINCIPALA, NR. 164",0,43,0,43,0,43,0,100,57,18,25,3,3185,1
6,"Bistrita-Nasaud",34173,65,34173,,"PETRU RARES",251,"PRIMARIA COMUNEI PETRU RARES SALA DE SEDINTE, SAT RETEAG, NR. 272",1475,860,813,21,26,840,20,1600,740,434,406,3,3187,0
6,"Bistrita-Nasaud",34173,65,34173,,"PETRU RARES",252,"SCOALA GENERALA CLS. I-IV RETEAG (POIENI), SAT RETEAG, NR. 601",768,329,313,12,4,325,4,800,471,104,221,3,3187,0
6,"Bistrita-Nasaud",34173,65,34173,,"PETRU RARES",253,"CAMINUL CULTURAL BATA, SAT BATA, NR. 149",689,414,406,7,1,408,6,800,386,211,197,3,3187,0
6,"Bistrita-Nasaud",34173,65,34173,,"PETRU RARES",254,"SCOALA GENERALA ""I.P. RETEGANUL"" CLASELE V-VIII RETEAG, SAT RETEAG, NR. 137",0,119,0,119,0,117,2,196,77,48,69,3,3187,1
6,"Bistrita-Nasaud",179720,65,179720,,"POIANA  ILVEI",255,"CAMINUL CULTURAL POIANA ILVEI, SAT POIANA ILVEI, NR. 97/A",1315,774,766,8,0,769,5,1399,625,335,434,3,3190,0
6,"Bistrita-Nasaud",179720,65,179720,,"POIANA  ILVEI",256,"SEDIUL PRIMARIEI COMUNEI POIANA ILVEI, SAT POIANA ILVEI, NR. 97/A",0,36,0,36,0,36,0,100,64,15,21,3,3190,1
6,"Bistrita-Nasaud",34235,65,34235,,"PRUNDU BARGAULUI",257,"SCOALA GENERALA PRUNDU BARGAULUI CLASA I-A C, SAT PRUNDU BARGAULUI, NR. 953",1233,622,594,28,0,617,5,1300,678,430,187,3,3192,0
6,"Bistrita-Nasaud",34235,65,34235,,"PRUNDU BARGAULUI",258,"CAMINUL CULTURAL PRUNDU BARGAULUI, SAT PRUNDU BARGAULUI, NR. 952",1570,939,791,148,0,936,3,1600,661,710,226,3,3192,0
6,"Bistrita-Nasaud",34235,65,34235,,"PRUNDU BARGAULUI",259,"SCOALA GENERALA PRUNDU BARGAULUI CLASA A IV-A C, SAT PRUNDU BARGAULUI, NR. 953",1422,807,733,74,0,804,3,1500,693,558,246,3,3192,0
6,"Bistrita-Nasaud",34235,65,34235,,"PRUNDU BARGAULUI",260,"SCOALA GENERALA SUSENII BARGAULUI , SAT SUSENII BARGAULUI, NR. 145",1130,652,603,47,2,647,5,1200,548,475,172,3,3192,0
6,"Bistrita-Nasaud",34235,65,34235,,"PRUNDU BARGAULUI",261,"SCOALA GENERALA PRUNDU BARGAULUI SALA DE CLASA PARTER, SAT PRUNDU BARGAULUI, NR. 953",0,130,0,130,0,127,3,300,170,81,46,3,3192,1
6,"Bistrita-Nasaud",34262,65,34262,,"REBRA",262,"SCOALA GENERALA NR. 1 CLS. I-IV REBRA, SAT REBRA, NR. 411",972,441,439,2,0,439,2,1000,559,318,121,3,3195,0
6,"Bistrita-Nasaud",34262,65,34262,,"REBRA",263,"SCOALA GENERALA NR. 2 CLS. V-VIII REBRA, SAT REBRA, NR. 413",1066,437,436,1,0,434,3,1100,663,290,144,3,3195,0
6,"Bistrita-Nasaud",34262,65,34262,,"REBRA",264,"SEDIUL PRIMARIEI COMUNEI REBRA, SAT REBRA, STR. PRINCIPALA, NR. 1",0,35,0,35,0,35,0,100,65,20,15,3,3195,1
6,"Bistrita-Nasaud",34280,65,34280,,"REBRISOARA",265,"CAMINUL CULTURAL REBRISOARA, SAT REBRISOARA, NR. 827",1588,863,838,3,22,846,17,1700,837,431,415,3,3197,0
6,"Bistrita-Nasaud",34280,65,34280,,"REBRISOARA",266,"SCOALA GENERALA CLS I-IV REBRISOARA, SAT REBRISOARA, NR. 502",1435,748,713,13,22,741,7,1500,752,386,355,3,3197,0
6,"Bistrita-Nasaud",34280,65,34280,,"REBRISOARA",267,"SCOALA GENERALA SAT GERSA I, SAT GERSA I, NR. 140",581,316,309,7,0,313,3,700,384,142,171,3,3197,0
6,"Bistrita-Nasaud",34280,65,34280,,"REBRISOARA",268,"SCOALA GENERALA VALEA BABII SAT GERSA II, SAT GERSA II, NR. 13",174,105,96,9,0,104,1,300,195,51,53,3,3197,0
6,"Bistrita-Nasaud",34280,65,34280,,"REBRISOARA",269,"STATIA C.F.R. REBRISOARA (GARA), SAT REBRISOARA, STR. PRINCIPALA, NR. 319",0,64,0,64,0,64,0,200,136,22,42,3,3197,1
6,"Bistrita-Nasaud",34333,65,34333,,"RODNA",270,"SCOALA GENERALA NR. 2 ""FLORIAN PORCIUS"" RODNA, SALA DE CLASA NR. 1, SAT RODNA, NR. 89",970,558,534,24,0,553,5,1100,542,308,245,3,3202,0
6,"Bistrita-Nasaud",34333,65,34333,,"RODNA",271,"SCOALA GENERALA NR. 2 ""FLORIAN PORCIUS"" RODNA, SALA DE CLASA NR. 2, SAT RODNA, NR. 89",973,547,533,13,1,545,2,1100,553,323,222,3,3202,0
6,"Bistrita-Nasaud",34333,65,34333,,"RODNA",272,"PRIMARIA COMUNEI RODNA, SAT RODNA, NR. 756",1470,912,883,29,0,904,8,1500,588,519,385,3,3202,0
6,"Bistrita-Nasaud",34333,65,34333,,"RODNA",273,"CAMINUL CULTURAL ""GHERASIM DOMIDE"" RODNA, SAT RODNA, NR. 1192",1423,865,836,28,1,853,12,1512,647,473,380,3,3202,0
6,"Bistrita-Nasaud",34333,65,34333,,"RODNA",274,"SCOALA GENERALA VALEA VINULUI, SAT VALEA VINULUI, NR. 11",169,103,97,6,0,102,1,297,194,42,60,3,3202,0
6,"Bistrita-Nasaud",34333,65,34333,,"RODNA",275,"CAMINUL CULTURAL ""GHERASIM DOMIDE"" RODNA, SAT RODNA, NR. 1192",0,60,0,60,0,60,0,200,140,26,34,3,3202,1
6,"Bistrita-Nasaud",34360,65,34360,,"ROMULI",276,"SCOALA GENERALA CLS. I-VIII ROMULI, SAT ROMULI, NR. 88",1074,544,541,3,0,536,8,1200,656,255,281,3,3205,0
6,"Bistrita-Nasaud",34360,65,34360,,"ROMULI",277,"SCOALA GENERALA CLS. I-IV DEALU STEFANITEI, SAT DEALU STEFANITEI, NR. 20",281,208,190,18,0,208,0,400,192,111,97,3,3205,0
6,"Bistrita-Nasaud",34360,65,34360,,"ROMULI",278,"SCOALA GENERALA ROMULI, SAT ROMULI, NR. 88",0,27,0,27,0,27,0,100,73,14,13,3,3205,1
6,"Bistrita-Nasaud",179944,65,179944,,"RUNCU SALVEI",279,"PRIMARIA COMUNEI RUNCU SALVEI SALA NR. 4, SAT RUNCU SALVEI, NR. 1",1082,757,745,1,11,747,10,1200,443,603,144,3,3208,0
6,"Bistrita-Nasaud",179944,65,179944,,"RUNCU SALVEI",280,"SEDIUL PRIMARIEI COMUNEI RUNCU SALVEI CAMERA 1, SAT RUNCU SALVEI, NR. 1",0,18,0,18,0,18,0,100,82,9,9,3,3208,1
6,"Bistrita-Nasaud",34397,65,34397,,"SALVA",281,"PRIMARIA COMUNEI SALVA SALA DE SEDINTA A CONSILIULUI LOCAL, SAT SALVA, NR. 154",1162,724,703,12,9,719,5,1300,576,325,394,3,3210,0
6,"Bistrita-Nasaud",34397,65,34397,,"SALVA",282,"CAMINUL CULTURAL SALVA, SALA MICA, SAT SALVA, NR. 2",1267,763,725,23,15,759,4,1300,537,306,453,3,3210,0
6,"Bistrita-Nasaud",34397,65,34397,,"SALVA",283,"CAMINUL CULTURAL SALVA, HOL, SAT SALVA, NR. 2",0,64,0,64,0,64,0,200,136,30,34,3,3210,1
6,"Bistrita-Nasaud",34422,65,34422,,"SILIVASU DE CIMPIE",284,"CAMINUL CULTURAL VECHI SILIVASU DE CAMPIE, SAT SILIVASU DE CIMPIE, NR. 76",869,531,517,7,7,522,9,1000,469,261,261,3,3248,0
6,"Bistrita-Nasaud",34422,65,34422,,"SILIVASU DE CIMPIE",285,"CAMINUL CULTURAL NOU SILIVASU DE CAMPIE, SAT SILIVASU DE CIMPIE, STR. PRINCIPALA, NR. 76",0,58,0,58,0,57,1,200,142,35,22,3,3248,1
6,"Bistrita-Nasaud",34477,65,34477,,"SANMIHAIU DE CIMPIE",286,"CAMINUL CULTURAL SANMIHAIU DE CAMPIE, SAT SANMIHAIU DE CAMPIE, NR. 43",598,394,372,5,17,389,5,700,306,213,176,3,3212,0
6,"Bistrita-Nasaud",34477,65,34477,,"SANMIHAIU DE CIMPIE",287,"CAMINUL CULTURAL BRATENI, SAT BRATENI, NR. 98",87,75,61,7,7,75,0,200,125,39,36,3,3212,0
6,"Bistrita-Nasaud",34477,65,34477,,"SANMIHAIU DE CIMPIE",288,"CAMINUL CULTURAL STUPINI, SAT STUPINI, NR. 19",209,138,123,8,7,136,2,300,162,77,59,3,3212,0
6,"Bistrita-Nasaud",34477,65,34477,,"SANMIHAIU DE CIMPIE",289,"CAMINUL CULTURAL SALCUTA, SAT SALCUTA, NR. 114",110,72,57,6,9,72,0,200,128,39,33,3,3212,0
6,"Bistrita-Nasaud",34477,65,34477,,"SANMIHAIU DE CIMPIE",290,"CAMINUL CULTURAL ZORENI, SAT ZORENI, NR. 92",280,179,172,4,3,179,0,400,221,83,96,3,3212,0
6,"Bistrita-Nasaud",34477,65,34477,,"SANMIHAIU DE CIMPIE",291,"SEDIUL PRIMARIEI COMUNEI SANMIHAIU DE CIMPIE, SAT SANMIHAIU DE CIMPIE, NR. 53",0,82,0,82,0,81,1,300,218,50,31,3,3212,1
6,"Bistrita-Nasaud",34547,65,34547,,"SPERMEZEU",292,"PRIMARIA COMUNEI SPERMEZEU, ANEXA NOUA A PRIMARIEI, SALA DE SEDINTE PARTER, SAT SPERMEZEU, NR. 270/A",1493,737,733,4,0,734,3,1600,863,329,405,3,3261,0
6,"Bistrita-Nasaud",34547,65,34547,,"SPERMEZEU",293,"SCOALA GENERALA CLS. I-IV DOBRICEL, LOCALUL NOU, SAT DOBRICEL, NR. 116",471,285,280,5,0,282,3,500,215,135,147,3,3261,0
6,"Bistrita-Nasaud",34547,65,34547,,"SPERMEZEU",294,"SCOALA GENERALA CLS. I-VIII ""TEODOR COTUTIU"" DUMBRAVITA, SAT DUMBRAVITA, NR. 211",686,364,361,3,0,361,3,800,436,178,183,3,3261,0
6,"Bistrita-Nasaud",34547,65,34547,,"SPERMEZEU",295,"SCOALA GENERALA CLS. I-VIII HALMASAU, SAT HALMASAU, NR. 87",224,129,122,7,0,129,0,300,171,65,64,3,3261,0
6,"Bistrita-Nasaud",34547,65,34547,,"SPERMEZEU",296,"SCOALA GENERALA CLS. I-VIII SITA, SAT SITA, NR. 101",290,180,177,3,0,179,1,300,120,81,98,3,3261,0
6,"Bistrita-Nasaud",34547,65,34547,,"SPERMEZEU",297,"CAMINUL CULTURAL SPERMEZEU, SAT SPERMEZEU, NR. 294",0,63,0,63,0,62,1,200,137,33,29,3,3261,1
6,"Bistrita-Nasaud",34618,65,34618,,"SANT",298,"GRADINITA NR. 1 SANT, SAT SANT, NR. 80",1376,1013,991,13,9,1007,6,1500,487,477,530,3,3219,0
6,"Bistrita-Nasaud",34618,65,34618,,"SANT",299,"CAMINUL CULTURAL SANT, SAT SANT, NR. 724",950,704,682,11,11,700,4,1000,296,286,414,3,3219,0
6,"Bistrita-Nasaud",34618,65,34618,,"SANT",300,"SCOALA GENERALA CLS. I-IV VALEA MARE, SAT VALEA MARE, NR. 34",226,187,173,13,1,187,0,300,113,103,84,3,3219,0
6,"Bistrita-Nasaud",34618,65,34618,,"SANT",301,"SEDIUL DISPENSARULUI SANITAR VETERINAR SANT, SAT SANT, NR. 92",0,53,0,53,0,53,0,200,147,23,30,3,3219,1
6,"Bistrita-Nasaud",34645,65,34645,,"SIEU",302,"CAMINUL CULTURAL SIEU, SAT SIEU, NR. 243",1148,746,731,7,8,739,7,1200,454,405,334,3,3222,0
6,"Bistrita-Nasaud",34645,65,34645,,"SIEU",303,"SCOALA GENERALA NR. II ARDAN, SAT ARDAN, NR. 115",616,389,382,7,0,389,0,699,310,303,86,3,3222,0
6,"Bistrita-Nasaud",34645,65,34645,,"SIEU",304,"SCOALA GENERALA NR. II POSMUS, SAT POSMUS, NR. 128/A",585,356,350,6,0,352,4,700,344,212,140,3,3222,0
6,"Bistrita-Nasaud",34645,65,34645,,"SIEU",305,"SCOALA GENERALA SOIMUS, SAT SOIMUS, NR. 15",150,114,105,9,0,114,0,201,87,71,43,3,3222,0
6,"Bistrita-Nasaud",34645,65,34645,,"SIEU",306,"CAMINUL CULTURAL SIEU HOL INTRARE LA CAMIN, SAT SIEU, NR. 243",0,81,0,81,0,81,0,200,119,44,37,3,3222,1
6,"Bistrita-Nasaud",34690,65,34690,,"SIEU-MAGHERUS",307,"CAMINUL CULTURAL SIEU-MAGHERUS, SAT SIEU-MAGHERUS, NR. 219",885,483,468,8,7,475,8,1000,517,225,250,3,3227,0
6,"Bistrita-Nasaud",34690,65,34690,,"SIEU-MAGHERUS",308,"SCOALA GENERALA CLS. I-IV ARCALIA , SAT ARCALIA, NR. 168",652,382,376,6,0,380,2,700,318,266,114,3,3227,0
6,"Bistrita-Nasaud",34690,65,34690,,"SIEU-MAGHERUS",309,"SCOALA GENERALA CLS. I-IV CHINTELNIC, SAT CHINTELNIC, NR. 163",525,342,328,9,5,338,4,600,258,239,99,3,3227,0
6,"Bistrita-Nasaud",34690,65,34690,,"SIEU-MAGHERUS",310,"SCOALA GENERALA CLS. I-IV CRAINIMAT, SAT CRAINIMAT, NR. 166",691,434,411,14,9,431,3,800,366,252,179,3,3227,0
6,"Bistrita-Nasaud",34690,65,34690,,"SIEU-MAGHERUS",311,"SCOALA GENERALA CLS. I-IV SARATEL, SAT SARATEL, NR. 27",450,260,244,6,10,258,2,500,240,162,96,3,3227,0
6,"Bistrita-Nasaud",34690,65,34690,,"SIEU-MAGHERUS",312,"CAMINUL CULTURAL SIEU-MAGHERUS, SAT SIEU-MAGHERUS, NR. 219",0,123,0,123,0,123,0,300,177,67,56,3,3227,1
6,"Bistrita-Nasaud",34770,65,34770,,"SIEU-ODORHEI",313,"PRIMARIA COMUNEI SIEU-ODORHEI, SAT SIEU-ODORHEI, NR. 47",630,358,347,11,0,353,5,700,342,172,181,3,3235,0
6,"Bistrita-Nasaud",34770,65,34770,,"SIEU-ODORHEI",314,"SCOALA GENERALA AGRISU DE JOS, SAT AGRISU DE JOS, NR. 86",302,195,165,30,0,193,2,400,205,59,134,3,3235,0
6,"Bistrita-Nasaud",34770,65,34770,,"SIEU-ODORHEI",315,"SCOALA GENERALA AGRISU DE SUS, SAT AGRISU DE SUS, NR. 39",155,112,105,7,0,106,6,200,88,26,80,3,3235,0
6,"Bistrita-Nasaud",34770,65,34770,,"SIEU-ODORHEI",316,"CAMINUL CULTURAL BRETEA, SAT BRETEA, NR. 22",175,114,105,9,0,114,0,200,86,64,50,3,3235,0
6,"Bistrita-Nasaud",34770,65,34770,,"SIEU-ODORHEI",317,"CAMINUL CULTURAL COASTA, SAT COASTA, NR. 60",172,122,114,8,0,121,1,200,78,56,65,3,3235,0
6,"Bistrita-Nasaud",34770,65,34770,,"SIEU-ODORHEI",318,"SCOALA GENERALA CRISTUR-SIEU, SAT CRISTUR-SIEU, NR. 127",384,242,230,12,0,240,2,400,158,146,94,3,3235,0
6,"Bistrita-Nasaud",34770,65,34770,,"SIEU-ODORHEI",319,"SCOALA GENERALA SIRIOARA, SAT SIRIOARA, NR. 14",264,194,192,2,0,188,6,300,106,64,124,3,3235,0
6,"Bistrita-Nasaud",34770,65,34770,,"SIEU-ODORHEI",320,"SEDIUL PRIMARIEI COMUNEI SIEU-ODORHEI, SAT SIEU-ODORHEI, NR. 47",0,80,0,80,0,80,0,300,220,37,43,3,3235,1
6,"Bistrita-Nasaud",34850,65,34850,,"SIEUT",321,"PRIMARIA COMUNEI SIEUT SALA MARE DE SEDINTE, SAT SIEUT, NR. 197",622,406,389,7,10,403,3,700,293,204,199,3,3243,0
6,"Bistrita-Nasaud",34850,65,34850,,"SIEUT",322,"SCOALA GENERALA LUNCA SALA DE CLASA, SAT LUNCA, NR. 55",314,202,194,7,1,200,2,400,198,132,68,3,3243,0
6,"Bistrita-Nasaud",34850,65,34850,,"SIEUT",323,"SCOALA GENERALA RUSTIOR SALA DE CLASA, SAT RUSTIOR, NR. 136",502,314,300,10,4,311,3,600,286,212,99,3,3243,0
6,"Bistrita-Nasaud",34850,65,34850,,"SIEUT",324,"CAMINUL CULTURAL SEBIS SALA ADIACENTA, SAT SEBIS, NR. 36",708,458,446,7,5,457,1,800,342,261,196,3,3243,0
6,"Bistrita-Nasaud",34850,65,34850,,"SIEUT",325,"SEDIUL PRIMARIEI COMUNEI SIEUT, ETAJ 1, BIROU NR. 1, SAT SIEUT, NR. 197",0,61,0,61,0,59,2,200,139,24,35,3,3243,1
6,"Bistrita-Nasaud",34903,65,34903,,"SINTEREAG",326,"PRIMARIA COMUNEI SINTEREAG, SAT SINTEREAG, NR. 40",849,508,480,7,21,505,3,900,392,369,136,3,3253,0
6,"Bistrita-Nasaud",34903,65,34903,,"SINTEREAG",327,"SCOALA GENERALA BLAJENII DE JOS, SAT BLAJENII DE JOS, NR. 65/A",337,243,236,7,0,241,2,400,157,190,51,3,3253,0
6,"Bistrita-Nasaud",34903,65,34903,,"SINTEREAG",328,"SCOALA GENERALA BLAJENII DE SUS, SAT BLAJENII DE SUS, NR. 34/B",345,216,211,5,0,215,1,400,184,156,59,3,3253,0
6,"Bistrita-Nasaud",34903,65,34903,,"SINTEREAG",329,"CAMINUL CULTURAL CAILA, SAT CAILA, NR. 40/A",264,196,188,8,0,195,1,300,104,161,34,3,3253,0
6,"Bistrita-Nasaud",34903,65,34903,,"SINTEREAG",330,"CAMINUL CULTURAL COCIU, SAT COCIU, NR. 21",941,579,574,5,0,575,4,1000,421,321,254,3,3253,0
6,"Bistrita-Nasaud",34903,65,34903,,"SINTEREAG",331,"SCOALA GENERALA SIEU-SFANTU, SAT SIEU-SFANTU, NR. 125",392,326,310,8,8,324,2,500,174,254,70,3,3253,0
6,"Bistrita-Nasaud",34903,65,34903,,"SINTEREAG",332,"SEDIUL PRIMARIEI COMUNEI SINTEREAG, SAT SINTEREAG, NR. 40",0,114,0,114,0,112,2,400,286,94,18,3,3253,1
6,"Bistrita-Nasaud",34985,65,34985,,"TEACA",333,"CAMINUL CULTURAL TEACA, SAT TEACA, NR. 603",917,495,481,13,1,492,3,1000,505,246,246,3,3281,0
6,"Bistrita-Nasaud",34985,65,34985,,"TEACA",334,"PRIMARIA COMUNEI TEACA, SAT TEACA, NR. 598",794,460,448,11,1,454,6,899,439,226,228,3,3281,0
6,"Bistrita-Nasaud",34985,65,34985,,"TEACA",335,"CAMINUL CULTURAL ARCHIUD, SAT ARCHIUD, NR. 32",538,302,295,7,0,298,4,600,298,95,203,3,3281,0
6,"Bistrita-Nasaud",34985,65,34985,,"TEACA",336,"CAMINUL CULTURAL BUDURLENI, SAT BUDURLENI, NR. 82",103,86,74,12,0,85,1,200,114,34,51,3,3281,0
6,"Bistrita-Nasaud",34985,65,34985,,"TEACA",337,"CAMINUL CULTURAL OCNITA, SAT OCNITA, NR. 32",960,524,512,12,0,518,6,1001,477,242,276,3,3281,0
6,"Bistrita-Nasaud",34985,65,34985,,"TEACA",338,"FOSTUL SEDIU AL CAP PINTICU, SAT PINTICU, NR. 236",636,383,377,6,0,382,1,700,317,194,188,3,3281,0
6,"Bistrita-Nasaud",34985,65,34985,,"TEACA",339,"SCOALA GENERALA VIILE TECII, SAT VIILE TECII, NR. 67",786,441,433,8,0,432,9,900,459,165,267,3,3281,0
6,"Bistrita-Nasaud",34985,65,34985,,"TEACA",340,"GRADINITA CU PROGRAM NORMAL TEACA, SAT TEACA, NR. 163",0,129,0,129,0,129,0,400,271,68,61,3,3281,1
6,"Bistrita-Nasaud",35054,65,35054,,"TELCIU",341,"GRUP SCOLAR TELCIU, SAT TELCIU, NR. 204 B",1145,605,576,27,2,602,3,1200,595,411,191,3,3288,0
6,"Bistrita-Nasaud",35054,65,35054,,"TELCIU",342,"CAMINUL CULTURAL TELCIU, SAT TELCIU, NR. 543 A",990,602,563,35,4,598,4,1100,498,427,171,3,3288,0
6,"Bistrita-Nasaud",35054,65,35054,,"TELCIU",343,"GRADINITA NR. 1 TELCIU, SAT TELCIU, NR. 818 A",1099,624,601,20,3,621,3,1200,576,389,232,3,3288,0
6,"Bistrita-Nasaud",35054,65,35054,,"TELCIU",344,"SCOALA GENERALA BICHIGIU, SAT BICHIGIU, NR. 117 A",731,383,379,4,0,379,4,800,417,278,101,3,3288,0
6,"Bistrita-Nasaud",35054,65,35054,,"TELCIU",345,"SCOALA  FIAD, SAT FIAD, NR. 113 A",236,125,117,8,0,125,0,300,175,75,50,3,3288,0
6,"Bistrita-Nasaud",35054,65,35054,,"TELCIU",346,"SCOALA GENERALA TELCISOR, SAT TELCISOR, NR. 185 A",824,478,464,14,0,475,3,900,422,389,86,3,3288,0
6,"Bistrita-Nasaud",35054,65,35054,,"TELCIU",347,"SEDIUL PRIMARIEI COMUNEI TELCIU, SAT TELCIU, NR. 744/B",0,76,0,76,0,74,2,500,424,44,30,3,3288,1
6,"Bistrita-Nasaud",35090,65,35090,,"TIHA BARGAULUI",348,"PRIMARIA COMUNEI TIHA BARGAULUI, SAT TIHA BARGAULUI, NR. 452",1369,748,729,19,0,741,7,1404,656,555,186,3,3293,0
6,"Bistrita-Nasaud",35090,65,35090,,"TIHA BARGAULUI",349,"SCOALA GENERALA PIATRA FANTANELE, SAT PIATRA FANTANELE, NR. 107A",329,163,152,11,0,161,2,400,237,132,29,3,3293,0
6,"Bistrita-Nasaud",35090,65,35090,,"TIHA BARGAULUI",350,"SCOALA GENERALA MURESENII BARGAULUI, SAT MURESENII BARGAULUI, NR. 399A",1339,775,764,10,1,768,7,1403,628,659,109,3,3293,0
6,"Bistrita-Nasaud",35090,65,35090,,"TIHA BARGAULUI",351,"SCOALA GENERALA TUREAC, SAT TUREAC, NR. 10A",1451,750,740,10,0,740,10,1500,750,625,115,3,3293,0
6,"Bistrita-Nasaud",35090,65,35090,,"TIHA BARGAULUI",352,"SCOALA GENERALA VALEA TUREACULUI, SAT TUREAC, NR. 530",504,275,262,13,0,268,7,600,325,203,65,3,3293,0
6,"Bistrita-Nasaud",35090,65,35090,,"TIHA BARGAULUI",353,"SEDIUL PRIMARIEI COMUNEI TIHA BARGAULUI, SAT TIHA BARGAULUI, NR. 452",0,58,0,58,0,58,0,400,342,36,22,3,3293,1
6,"Bistrita-Nasaud",35152,65,35152,,"TARLISUA",354,"SCOALA GENERALA TARLISUA, SAT TARLISUA, NR. 154",1291,640,637,3,0,636,4,1400,760,480,156,3,3270,0
6,"Bistrita-Nasaud",35152,65,35152,,"TARLISUA",355,"SCOALA GENERALA AGRIES, SAT AGRIES, NR. 40",876,511,505,6,0,505,6,900,389,251,254,3,3270,0
6,"Bistrita-Nasaud",35152,65,35152,,"TARLISUA",356,"SCOALA GENERALA BORLEASA, SAT BORLEASA, NR. 68",374,196,191,5,0,193,3,500,304,97,96,3,3270,0
6,"Bistrita-Nasaud",35152,65,35152,,"TARLISUA",357,"SCOALA GENERALA LUNCA SATEASCA, SAT LUNCA SATEASCA, NR. 43",282,151,142,9,0,151,0,400,249,117,34,3,3270,0
6,"Bistrita-Nasaud",35152,65,35152,,"TARLISUA",358,"SCOALA GENERALA MOLISET (COSTEASA), SAT MOLISET, NR. 54",178,111,104,7,0,109,2,300,189,80,29,3,3270,0
6,"Bistrita-Nasaud",35152,65,35152,,"TARLISUA",359,"SCOALA GENERALA TARLISUA, SAT TARLISUA, NR. 154",0,54,0,54,0,53,1,200,146,36,17,3,3270,1
6,"Bistrita-Nasaud",35269,65,35269,,"URIU",360,"SCOALA GENERALA CLS. I-IV URIU, SAT URIU, NR. 159",1141,693,681,6,6,688,5,1201,508,465,223,3,3299,0
6,"Bistrita-Nasaud",35269,65,35269,,"URIU",361,"SCOALA GENERALA CRISTESTII CICEULUI, SAT CRISTESTII CICEULUI, NR. 302",964,598,587,6,5,591,7,1000,402,293,298,3,3299,0
6,"Bistrita-Nasaud",35269,65,35269,,"URIU",362,"SCOALA GENERALA HASMASU CICEULUI, SAT HASMASU CICEULUI, NR. 148",218,152,145,7,0,149,3,300,148,86,63,3,3299,0
6,"Bistrita-Nasaud",35269,65,35269,,"URIU",363,"SCOALA GENERALA ILISUA, SAT ILISUA, NR. 37",584,380,369,11,0,376,4,700,320,186,190,3,3299,0
6,"Bistrita-Nasaud",35269,65,35269,,"URIU",364,"SCOALA GENERALA CLS. I-IV URIU, SAT URIU, NR. 159",0,91,0,91,0,91,0,300,209,64,27,3,3299,1
6,"Bistrita-Nasaud",35312,65,35312,,"URMENIS",365,"SCOALA GENERALA URMENIS, SAT URMENIS, NR. 206",807,467,460,6,1,459,8,900,433,177,282,3,3304,0
6,"Bistrita-Nasaud",35312,65,35312,,"URMENIS",366,"CAMINUL CULTURAL DELURENI, SAT DELURENI, NR. 132",296,138,125,13,0,133,5,400,262,60,73,3,3304,0
6,"Bistrita-Nasaud",35312,65,35312,,"URMENIS",367,"SCOALA GENERALA FANATE, SAT FANATE, NR. 58",165,104,94,10,0,103,1,200,96,67,36,3,3304,0
6,"Bistrita-Nasaud",35312,65,35312,,"URMENIS",368,"SCOALA GENERALA SOPTERIU, SAT SOPTERIU, NR. 86",376,185,174,11,0,183,2,500,315,96,87,3,3304,0
6,"Bistrita-Nasaud",35312,65,35312,,"URMENIS",369,"SCOALA GENERALA URMENIS, SAT URMENIS, NR. 206",0,44,0,44,0,44,0,200,156,21,23,3,3304,1
6,"Bistrita-Nasaud",35429,65,35429,,"ZAGRA",370,"SCOALA DE ARTE SI MESERII ""NICOLAE DRAGANU"" ZAGRA, SAT ZAGRA, NR. 131",911,590,568,4,18,583,7,1000,410,456,127,3,3315,0
6,"Bistrita-Nasaud",35429,65,35429,,"ZAGRA",371,"SCOALA GENERALA ALUNISUL, SAT ALUNISUL, NR. 29",207,147,133,8,6,144,3,300,153,111,33,3,3315,0
6,"Bistrita-Nasaud",35429,65,35429,,"ZAGRA",372,"SCOALA GENERALA PERISOR, SAT PERISOR, NR. 62",484,298,274,12,12,295,3,600,302,209,86,3,3315,0
6,"Bistrita-Nasaud",35429,65,35429,,"ZAGRA",373,"SCOALA GENERALA POIENILE ZAGREI, SAT POIENILE ZAGREI, NR. 146",686,395,365,8,22,392,3,800,405,312,80,3,3315,0
6,"Bistrita-Nasaud",35429,65,35429,,"ZAGRA",374,"SCOALA GENERALA SUPLAI, SAT SUPLAI, NR. 216",530,352,324,14,14,348,4,600,248,236,112,3,3315,0
6,"Bistrita-Nasaud",35429,65,35429,,"ZAGRA",375,"SCOALA DE ARTE SI MESERII ""NICOLAE DRAGANU"" ZAGRA, SAT ZAGRA, NR. 131",0,53,0,53,0,53,0,300,247,31,22,3,3315,1
7,"Botosani",35731,74,35731,,"MUNICIPIUL BOTOSANI",1,"Liceul de Arta ""Stefan Luchian"" Intrarea  A B-dul Mihai Eminescu,nr 69",862,490,481,8,1,488,2,1000,510,173,315,1,3322,0
7,"Botosani",35731,74,35731,,"MUNICIPIUL BOTOSANI",2,"Scoala Generala nr. 4  Intrarea B str. Stefan Luchian nr.38",1599,952,942,10,0,943,9,1600,648,349,594,1,3322,0
7,"Botosani",35731,74,35731,,"MUNICIPIUL BOTOSANI",3,"Scoala Generala nr. 4  Intrarea B str. Stefan Luchian nr.38",1551,845,836,9,0,839,6,1600,755,305,534,1,3322,0
7,"Botosani",35731,74,35731,,"MUNICIPIUL BOTOSANI",4,"Scoala Generala nr.7 Intrarea A str. Varnav nr.7",1251,645,634,11,0,639,6,1300,655,222,417,1,3322,0
7,"Botosani",35731,74,35731,,"MUNICIPIUL BOTOSANI",5,"Gradinita de Copii nr. 19, Aleea Prieteniei nr.5",1131,626,617,9,0,618,8,1200,574,225,393,1,3322,0
7,"Botosani",35731,74,35731,,"MUNICIPIUL BOTOSANI",6,"Gradinita de Copii nr. 19, Aleea Prieteniei nr.5",1108,516,508,8,0,510,6,1207,691,212,298,1,3322,0
7,"Botosani",35731,74,35731,,"MUNICIPIUL BOTOSANI",7,"Scoala generala nr.7 Intrarea A str. Varnav nr.7",1232,662,654,8,0,652,10,1301,639,301,351,1,3322,0
7,"Botosani",35731,74,35731,,"MUNICIPIUL BOTOSANI",8,"Scoala Generala nr.17 Al. Teodor Boyan nr. 2",1411,780,772,8,0,770,10,1500,720,259,511,1,3322,0
7,"Botosani",35731,74,35731,,"MUNICIPIUL BOTOSANI",9,"Liceul de Stiinte Naturii ""Gr igore Antipa"" Intrarea  A,B-dul M.Eminescu,nr 30",1662,906,895,10,1,892,14,1700,794,303,589,1,3322,0
7,"Botosani",35731,74,35731,,"MUNICIPIUL BOTOSANI",10,"Liceul de Stiinte Naturii ""Grigore  Antipa"" Intrarea  A, B-dul M.Eminescu,nr.30",1634,904,894,10,0,890,14,1700,796,314,576,1,3322,0
7,"Botosani",35731,74,35731,,"MUNICIPIUL BOTOSANI",11,"Scoala Generala nr. 16 - Intrarea A,  Aleea Pacea nr.7",1566,747,736,11,0,735,12,1600,853,315,420,1,3322,0
7,"Botosani",35731,74,35731,,"MUNICIPIUL BOTOSANI",12,"Scoala Generala nr.13, Aleea Curcubeului nr.2",1530,770,757,12,1,761,9,1602,832,296,465,1,3322,0
7,"Botosani",35731,74,35731,,"MUNICIPIUL BOTOSANI",13,"Scoala Generala nr.13, Aleea Curcubeului nr.2",1608,767,756,10,1,764,3,1700,933,319,445,1,3322,0
7,"Botosani",35731,74,35731,,"MUNICIPIUL BOTOSANI",14,"Colegiul National ""Mihai Eminescu"" Intrarea  A str.Octav Onicescu,nr.7",1369,701,692,9,0,694,7,1502,801,256,438,1,3322,0
7,"Botosani",35731,74,35731,,"MUNICIPIUL BOTOSANI",15,"Colegiul National ""Mihai Eminescu"" Intrarea  A str.Octav Onicescu,nr.7",1276,712,704,7,1,706,6,1302,590,257,449,1,3322,0
7,"Botosani",35731,74,35731,,"MUNICIPIUL BOTOSANI",16,"Colegiul National ""Mihai Eminescu"" Intrarea  B str.Octav Onicescu,nr.7",1428,769,761,8,0,762,7,1500,731,290,472,1,3322,0
7,"Botosani",35731,74,35731,,"MUNICIPIUL BOTOSANI",17,"Scoala Generala nr. 12 - Intrarea A str. Prieteniei nr.8",1080,511,504,7,0,503,8,1100,589,212,291,1,3322,0
7,"Botosani",35731,74,35731,,"MUNICIPIUL BOTOSANI",18,"Scoala Generala nr. 12 - Intrarea A str. Prieteniei nr.8",902,392,385,7,0,388,4,1000,608,164,224,1,3322,0
7,"Botosani",35731,74,35731,,"MUNICIPIUL BOTOSANI",19,"Scoala Generala nr. 12 - Intrarea A str. Prieteniei nr.8",1452,758,750,7,1,749,9,1500,742,274,475,1,3322,0
7,"Botosani",35731,74,35731,,"MUNICIPIUL BOTOSANI",20,"Gradinita de Copii nr.23, Aleea Nucului nr.6",1425,680,671,9,0,676,4,1500,820,259,417,1,3322,0
7,"Botosani",35731,74,35731,,"MUNICIPIUL BOTOSANI",21,"Grupul Scolar Industrial ""Ghe.Asachi""(Liceul Electrocontact),Str Prieteniei,nr.2",1074,521,514,7,0,511,10,1102,581,189,322,1,3322,0
7,"Botosani",35731,74,35731,,"MUNICIPIUL BOTOSANI",22,"Grupul Scolar Industrial ""Ghe.Asachi""(Liceul Electrocontact) Str Prieteniei,nr.2",920,479,471,8,0,477,2,1000,521,200,277,1,3322,0
7,"Botosani",35731,74,35731,,"MUNICIPIUL BOTOSANI",23,"Grupul Scolar Industrial ""Ghe.Asachi""(Sc. Prof.Electrocontact),Str Cornisa ,nr.15",1240,571,561,10,0,565,6,1300,729,237,328,1,3322,0
7,"Botosani",35731,74,35731,,"MUNICIPIUL BOTOSANI",24,"Grupul Scolar Industrial ""Ghe.Asachi""(Sc. Prof.Electrocontact),Str Cornisa ,nr.15",993,506,495,11,0,504,2,1100,594,244,260,1,3322,0
7,"Botosani",35731,74,35731,,"MUNICIPIUL BOTOSANI",25,"Grupul Scolar Industrial ""Ghe.Asachi""(Sc. Prof.Electrocontact),Str Cornisa ,nr.15",790,381,371,10,0,377,4,807,426,180,197,1,3322,0
7,"Botosani",35731,74,35731,,"MUNICIPIUL BOTOSANI",26,"Grupul Scolar de Industrie Usoara (Liceul Textil) Calea Nationala,nr.28",1391,630,620,10,0,625,5,1500,870,293,332,1,3322,0
7,"Botosani",35731,74,35731,,"MUNICIPIUL BOTOSANI",27,"Grupul Scolar de Industrie Usoara (Liceul Textil) Calea Nationala,nr.28",875,425,419,6,0,417,8,1000,575,171,246,1,3322,0
7,"Botosani",35731,74,35731,,"MUNICIPIUL BOTOSANI",28,"Grupul Scolar de Industrie Usoara (Liceul Textil) Calea Nationala,nr.28",780,364,355,9,0,361,3,800,436,146,215,1,3322,0
7,"Botosani",35731,74,35731,,"MUNICIPIUL BOTOSANI",29,"Scoala Generala nr.14 - Intrarea  A- Aleea G-ral Gh.Avramescu nr 5",893,442,436,6,0,438,4,1001,559,164,274,1,3322,0
7,"Botosani",35731,74,35731,,"MUNICIPIUL BOTOSANI",30,"Scoala Generala nr.14 - Intrarea  A- Aleea G-ral Gh.Avramescu nr 5",1117,534,522,12,0,528,6,1200,666,219,309,1,3322,0
7,"Botosani",35731,74,35731,,"MUNICIPIUL BOTOSANI",31,"Scoala Generala nr.14 - Intrarea  A- Aleea G-ral Gh.Avramescu nr 5",1130,553,544,9,0,545,8,1200,647,232,313,1,3322,0
7,"Botosani",35731,74,35731,,"MUNICIPIUL BOTOSANI",32,"Scoala Generala nr.14 - Intrarea  A- Aleea G-ral Gh.Avramescu nr 5",1489,679,671,8,0,674,5,1500,821,265,409,1,3322,0
7,"Botosani",35731,74,35731,,"MUNICIPIUL BOTOSANI",33,"Scoala Generala nr.14 - Intrarea  A- Aleea G-ral Gh.Avramescu nr 5",953,440,430,9,1,437,3,1000,560,179,258,1,3322,0
7,"Botosani",35731,74,35731,,"MUNICIPIUL BOTOSANI",34,"Scoala Generala nr.14 - Intrarea  B- Aleea G-ral Gh.Avramescu nr 5",1244,520,512,8,0,512,8,1302,782,224,288,1,3322,0
7,"Botosani",35731,74,35731,,"MUNICIPIUL BOTOSANI",35,"Gradinita de Copii nr.22 str. Parcul Tineretului nr.7",1280,560,552,8,0,555,5,1300,740,223,332,1,3322,0
7,"Botosani",35731,74,35731,,"MUNICIPIUL BOTOSANI",36,"Scoala Generala nr.8 - Intrarea  A - str. Tudor Vladimirescu nr.8",1249,604,595,8,1,596,8,1300,696,296,300,1,3322,0
7,"Botosani",35731,74,35731,,"MUNICIPIUL BOTOSANI",37,"Scoala Generala nr.8 - Intrarea  A - str. Tudor Vladimirescu nr.8",1321,632,624,8,0,628,4,1400,768,250,378,1,3322,0
7,"Botosani",35731,74,35731,,"MUNICIPIUL BOTOSANI",38,"Scoala Generala nr.8 - Intrarea  B - str. Tudor Vladimirescu nr.8",1253,605,600,5,0,599,6,1400,795,258,341,1,3322,0
7,"Botosani",35731,74,35731,,"MUNICIPIUL BOTOSANI",39,"Scoala Generala nr.8 - Intrarea  B - str. Tudor Vladimirescu nr.8",1521,692,686,6,0,687,5,1600,908,293,394,1,3322,0
7,"Botosani",35731,74,35731,,"MUNICIPIUL BOTOSANI",40,"Scoala Generala nr.11 - Intrarea A - Calea Nationala nr.75",1263,639,631,8,0,629,10,1303,664,243,386,1,3322,0
7,"Botosani",35731,74,35731,,"MUNICIPIUL BOTOSANI",41,"Scoala Generala nr.11 - Intrarea A - Calea Nationala nr.75",928,475,469,6,0,469,6,1000,525,194,275,1,3322,0
7,"Botosani",35731,74,35731,,"MUNICIPIUL BOTOSANI",42,"Scoala Generala nr.11 - Intrarea B - Calea Nationala nr.75",1303,723,718,5,0,714,9,1400,677,296,418,1,3322,0
7,"Botosani",35731,74,35731,,"MUNICIPIUL BOTOSANI",43,"Scoala Generala nr.11 - Intrarea B - Calea Nationala nr.75",1049,544,539,5,0,542,2,1100,556,214,328,1,3322,0
7,"Botosani",35731,74,35731,,"MUNICIPIUL BOTOSANI",44,"Scoala Generala nr. 2 -Intrarea  A - str. Parcul Tineretului nr.9",1156,564,551,12,1,550,14,1200,636,298,252,1,3322,0
7,"Botosani",35731,74,35731,,"MUNICIPIUL BOTOSANI",45,"Scoala Generala nr. 2 -Intrarea  A - str. Parcul Tineretului nr.9",738,337,329,8,0,331,6,800,463,175,156,1,3322,0
7,"Botosani",35731,74,35731,,"MUNICIPIUL BOTOSANI",46,"Scoala Generala nr. 2 -Intrarea B - str. Parcul Tineretului nr.9",1255,528,518,10,0,524,4,1300,772,235,289,1,3322,0
7,"Botosani",35731,74,35731,,"MUNICIPIUL BOTOSANI",47,"Scoala Generala nr. 2 -Intrarea B - str. Parcul Tineretului nr.9",1283,541,532,9,0,534,7,1300,759,266,268,1,3322,0
7,"Botosani",35731,74,35731,,"MUNICIPIUL BOTOSANI",48,"Liceul de Arta ""Stefan Luchian"" Intrarea A B-dul Mihai Eminescu,nr 69",1470,895,886,9,0,890,5,1500,605,303,587,1,3322,0
7,"Botosani",35731,74,35731,,"MUNICIPIUL BOTOSANI",49,"Liceul de Arta ""Stefan Luchian"" Intrarea A B-dul Mihai Eminescu,nr 69",1417,883,861,8,14,875,8,1500,617,330,545,1,3322,0
7,"Botosani",35731,74,35731,,"MUNICIPIUL BOTOSANI",50,"Scoala Generala nr. 10, Intrarea A, B-dul M.Eminescu nr.89",1017,552,542,10,0,548,4,1100,548,229,319,1,3322,0
7,"Botosani",35731,74,35731,,"MUNICIPIUL BOTOSANI",51,"Colegiul National ""A.T.Laurian"" str. N. Iorga nr. 19",1341,730,721,9,0,724,6,1400,670,263,461,1,3322,0
7,"Botosani",35731,74,35731,,"MUNICIPIUL BOTOSANI",52,"Colegiul National ""A.T.Laurian"" str. N. Iorga nr. 19",1566,741,726,15,0,735,6,1601,860,324,411,1,3322,0
7,"Botosani",35731,74,35731,,"MUNICIPIUL BOTOSANI",53,"Localul Clubul Pensionarilor, str. 1 Decembrie,nr 69",1455,720,712,8,0,717,3,1500,780,362,355,1,3322,0
7,"Botosani",35731,74,35731,,"MUNICIPIUL BOTOSANI",54,"Scoala generala nr. 1 - Intrarea A , str.A.S. Puskin nr.20",1290,693,685,8,0,682,11,1402,709,287,395,1,3322,0
7,"Botosani",35731,74,35731,,"MUNICIPIUL BOTOSANI",55,"Scoala generala nr. 1 - Intrarea A , str.A.S. Puskin nr.20",1112,542,532,10,0,537,5,1200,658,220,317,1,3322,0
7,"Botosani",35731,74,35731,,"MUNICIPIUL BOTOSANI",56,"Scoala generala nr. 1 - Intrarea B , str.A.S. Puskin nr.20",1404,721,712,9,0,708,13,1500,779,280,428,1,3322,0
7,"Botosani",35731,74,35731,,"MUNICIPIUL BOTOSANI",57,"Grup Scolar Economic si Administrativ ""Octav Onicescu"" ,Intrarea B,str .Bucovina,nr.33",1248,531,524,7,0,528,3,1300,769,240,288,1,3322,0
7,"Botosani",35731,74,35731,,"MUNICIPIUL BOTOSANI",58,"Grup Scolar Economic si Administrativ ""Octav Onicescu"",Intrarea  A,str.Bucovina,nr.33",1504,803,794,9,0,791,12,1700,897,328,463,1,3322,0
7,"Botosani",35731,74,35731,,"MUNICIPIUL BOTOSANI",59,"Grup Scolar Economic si Administrativ ""Octav Onicescu"",Intrarea B,str Bucovina,nr.33",865,413,399,14,0,407,6,900,487,160,247,1,3322,0
7,"Botosani",35731,74,35731,,"MUNICIPIUL BOTOSANI",60,"Grup Scolar Industrial ""Constructii de Masini"" (Liceul Ind. nr.1) Intrarea  A,str Dimitrie Rallet,nr.9",1423,704,694,10,0,699,5,1500,796,279,420,1,3322,0
7,"Botosani",35731,74,35731,,"MUNICIPIUL BOTOSANI",61,"Grup Scolar Industrial ""Constructii de Masini"" (Liceul Ind. nr.1) Intrarea B,str Dimitrie Rallet,nr.9",1399,668,656,12,0,657,11,1503,835,268,389,1,3322,0
7,"Botosani",35731,74,35731,,"MUNICIPIUL BOTOSANI",62,"Grup Scolar Industrial ""Constructii de Masini"" (Liceul Ind. nr.1) Intrarea A,str Dimitrie Rallet,nr.9",1289,676,667,9,0,667,9,1400,724,285,382,1,3322,0
7,"Botosani",35731,74,35731,,"MUNICIPIUL BOTOSANI",63,"Scoala Generala nr. 6, Aleea Scolii nr. 3",1025,464,454,10,0,458,6,1100,636,199,259,1,3322,0
7,"Botosani",35731,74,35731,,"MUNICIPIUL BOTOSANI",64,"Scoala Generala nr. 6, Aleea Scolii nr. 3",1142,515,507,8,0,513,2,1203,688,209,304,1,3322,0
7,"Botosani",35731,74,35731,,"MUNICIPIUL BOTOSANI",65,"Scoala Generala nr. 6, Aleea Scolii nr. 3",1056,520,509,11,0,510,10,1100,580,217,293,1,3322,0
7,"Botosani",35731,74,35731,,"MUNICIPIUL BOTOSANI",66,"Scoala Generala nr. 6, Aleea Scolii nr. 3",1140,568,561,7,0,562,6,1204,636,211,351,1,3322,0
7,"Botosani",35731,74,35731,,"MUNICIPIUL BOTOSANI",67,"Scoala Generala nr. 6, Aleea Scolii nr. 3",1064,540,529,11,0,536,4,1100,560,232,304,1,3322,0
7,"Botosani",35731,74,35731,,"MUNICIPIUL BOTOSANI",68,"Scoala Generala nr. 10, B-dul M.Eminescu nr.89",1518,757,748,9,0,747,10,1600,843,297,450,1,3322,0
7,"Botosani",35731,74,35731,,"MUNICIPIUL BOTOSANI",69,"Scoala Generala nr. 10, B-dul M.Eminescu nr.89",1187,674,665,9,0,661,13,1300,626,289,372,1,3322,0
7,"Botosani",35731,74,35731,,"MUNICIPIUL BOTOSANI",70,"Scoala Generala nr. 16 - Intrarea A,  Aleea Pacea nr.7",1248,541,532,9,0,533,8,1303,762,221,312,1,3322,0
7,"Botosani",35731,74,35731,,"MUNICIPIUL BOTOSANI",71,"Scoala Generala nr. 16 - Intrarea B,  Aleea Pacea nr.7",1581,730,721,9,0,725,5,1700,970,328,397,1,3322,0
7,"Botosani",35731,74,35731,,"MUNICIPIUL BOTOSANI",72,"Colegiul National ""Mihai Eminescu"" Intrarea B str.Octav Onicescu,nr.7",1433,669,658,11,0,658,11,1500,831,268,390,1,3322,0
7,"Botosani",35731,74,35731,,"MUNICIPIUL BOTOSANI",73,"Gradinita de Copii nr.22 str. Parcul Tineretului nr.7",860,445,436,9,0,436,9,900,455,188,248,1,3322,0
7,"Botosani",35731,74,35731,,"MUNICIPIUL BOTOSANI",74,"Gradinita de Copii nr.22 str. Parcul Tineretului nr.7",1089,494,485,8,1,485,9,1200,706,208,277,1,3322,0
7,"Botosani",35731,74,35731,,"MUNICIPIUL BOTOSANI",75,"Gradinita de Copii nr.22 str. Parcul Tineretului nr.7",922,448,440,8,0,439,9,1000,552,195,244,1,3322,0
7,"Botosani",35731,74,35731,,"MUNICIPIUL BOTOSANI",76,"Scoala Generala nr.11 - Intrarea B - Calea Nationala nr.75",638,351,343,8,0,348,3,700,349,142,206,1,3322,0
7,"Botosani",35731,74,35731,,"MUNICIPIUL BOTOSANI",77,"Scoala Generala nr.3 str. Tudor Vladimirescu nr.19",1491,701,690,11,0,690,11,1600,899,242,448,1,3322,0
7,"Botosani",35731,74,35731,,"MUNICIPIUL BOTOSANI",78,"Gradinita de Copii nr.8 str. Savenilor nr.103",1478,751,742,9,0,746,5,1600,849,390,356,1,3322,0
7,"Botosani",35731,74,35731,,"MUNICIPIUL BOTOSANI",79,"Scoala Generala nr.9 Tulbureni",827,495,486,8,1,485,10,900,405,236,249,1,3322,0
7,"Botosani",35731,74,35731,,"MUNICIPIUL BOTOSANI",80,"Grupul Scolar Agricol (Lic. Agroindustrial) str. Calugareni nr.9",1034,510,501,9,0,502,8,1100,590,197,305,1,3322,0
7,"Botosani",35731,74,35731,,"MUNICIPIUL BOTOSANI",81,"Grupul Scolar Agricol (Lic. Agroindustrial) str. Calugareni nr.9",1453,688,680,8,0,683,5,1500,812,280,403,1,3322,0
7,"Botosani",35731,74,35731,,"MUNICIPIUL BOTOSANI",82,"Liceul Pedagogic""Nicolae Iorga"" - Intrarea A - str. I.C. Bratianu,nr.65",1395,739,723,16,0,724,15,1501,762,307,417,1,3322,0
7,"Botosani",35731,74,35731,,"MUNICIPIUL BOTOSANI",83,"Liceul Pedagogic""Nicolae Iorga"" - Intrarea B - str. I.C. Bratianu,nr.65",1031,1002,495,7,500,973,29,1600,598,538,435,1,3322,0
7,"Botosani",35731,74,35731,,"MUNICIPIUL BOTOSANI",84,"Liceul Pedagogic""Nicolae Iorga"" - Intrarea A - str. I.C. Bratianu,nr.65",1114,595,577,17,1,581,14,1200,605,289,292,1,3322,0
7,"Botosani",35731,74,35731,,"MUNICIPIUL BOTOSANI",85,"Asociatia de Proprietari, str.Dimitrie Pompeiu nr.11,Bl.C9,Sc.A",663,384,375,9,0,379,5,700,316,210,169,1,3322,0
7,"Botosani",35731,74,35731,,"MUNICIPIUL BOTOSANI",86,"Statia CFR Botosani, str. Garii, nr.3",0,855,0,855,0,848,7,1500,645,413,435,1,3322,1
7,"Botosani",36006,74,36006,,"MUNICIPIUL DOROHOI",87,"Colegiul National ""Grigore Ghica Vv"" str. Grigore Ghica Vv  nr.41",1497,774,757,15,2,764,10,1604,830,237,527,1,3324,0
7,"Botosani",36006,74,36006,,"MUNICIPIUL DOROHOI",88,"Cladirea fostului Centru de Plasament ""Sfanta Maria"",str Al.I.Cuza,nr.15",1286,665,655,9,1,659,6,1400,735,201,458,1,3324,0
7,"Botosani",36006,74,36006,,"MUNICIPIUL DOROHOI",89,"Biblioteca Municipala (anexa cu intrareadin spatele cladirii), str.Al.I.Cuza nr.43",1650,917,911,6,0,911,6,1700,783,281,630,1,3324,0
7,"Botosani",36006,74,36006,,"MUNICIPIUL DOROHOI",90,"Scoala Generala nr.5 ""Spiru Haret""str. Olinescu nr.2",1568,821,813,8,0,812,9,1700,879,264,548,1,3324,0
7,"Botosani",36006,74,36006,,"MUNICIPIUL DOROHOI",91,"Gradinita nr.4, str. Erou slt.Dumitras nr.1",991,534,523,11,0,531,3,1100,566,153,378,1,3324,0
7,"Botosani",36006,74,36006,,"MUNICIPIUL DOROHOI",92,"Scoala Generala nr.1 str. Lt. Stroie Buican nr.2",1319,725,718,7,0,721,4,1400,675,265,456,1,3324,0
7,"Botosani",36006,74,36006,,"MUNICIPIUL DOROHOI",93,"Casa Municipala de Cultura  str. George Enescu nr.57",1341,671,663,8,0,660,11,1404,733,254,406,1,3324,0
7,"Botosani",36006,74,36006,,"MUNICIPIUL DOROHOI",94,"Scoala Generala nr.2 str. Stefan cel Mare nr.28",1135,609,600,8,1,604,5,1200,591,217,387,1,3324,0
7,"Botosani",36006,74,36006,,"MUNICIPIUL DOROHOI",95,"Scoala Generala nr.2 str. Stefan cel Mare nr.28",1140,622,612,9,1,619,3,1200,578,228,391,1,3324,0
7,"Botosani",36006,74,36006,,"MUNICIPIUL DOROHOI",96,"Scoala Generala ""Al.I.Cuza""nr.7 B-dul Victoriei nr. 95",1187,545,538,7,0,541,4,1305,760,171,370,1,3324,0
7,"Botosani",36006,74,36006,,"MUNICIPIUL DOROHOI",97,"Scoala Generala ""Al.I.Cuza""nr.7 B-dul Victoriei nr.95",1268,587,576,11,0,580,7,1400,813,183,397,1,3324,0
7,"Botosani",36006,74,36006,,"MUNICIPIUL DOROHOI",98,"Liceul ""Regina Maria"" B-dul Victoriei nr.112",1119,507,499,8,0,506,1,1200,693,146,360,1,3324,0
7,"Botosani",36006,74,36006,,"MUNICIPIUL DOROHOI",99,"Liceul ""Regina Maria"" B-dul Victoriei nr.112",1357,621,613,7,1,613,8,1415,794,165,448,1,3324,0
7,"Botosani",36006,74,36006,,"MUNICIPIUL DOROHOI",100,"Scoala Generala ""Mihail Kogalniceanu""nr.8 Al.Dumbrava nr.2",1443,616,606,10,0,613,3,1491,875,165,448,1,3324,0
7,"Botosani",36006,74,36006,,"MUNICIPIUL DOROHOI",101,"Scoala Generala ""Mihail Kogalniceanu""nr.8 Al.Dumbrava nr.2",1336,554,544,10,0,549,5,1411,857,189,360,1,3324,0
7,"Botosani",36006,74,36006,,"MUNICIPIUL DOROHOI",102,"Gradinita nr.7 - Aleea Marului",1188,524,515,9,0,521,3,1300,776,151,370,1,3324,0
7,"Botosani",36006,74,36006,,"MUNICIPIUL DOROHOI",103,"Gradinita nr.7 - Aleea Marului",1600,808,798,9,1,800,8,1700,892,195,605,1,3324,0
7,"Botosani",36006,74,36006,,"MUNICIPIUL DOROHOI",104,"Policlinica Dorohoi B-dul Victoriei nr.75",890,481,471,10,0,479,2,1000,519,135,344,1,3324,0
7,"Botosani",36006,74,36006,,"MUNICIPIUL DOROHOI",105,"Scoala Generala nr.4, str. Horia nr.21",1071,578,569,9,0,574,4,1106,528,210,364,1,3324,0
7,"Botosani",36006,74,36006,,"MUNICIPIUL DOROHOI",106,"Scoala Generala nr.4, str. Horia nr.21",1038,535,529,6,0,530,5,1100,565,219,311,1,3324,0
7,"Botosani",36006,74,36006,,"MUNICIPIUL DOROHOI",107,"Scoala Primara din Satul Nou, str. Prunului nr.1",758,388,382,6,0,384,4,800,412,124,260,1,3324,0
7,"Botosani",36006,74,36006,,"MUNICIPIUL DOROHOI",108,"Scoala Primara din Loturi Enescu",306,212,205,7,0,208,4,400,188,97,111,1,3324,0
7,"Botosani",36006,74,36006,,"MUNICIPIUL DOROHOI",109,"Autogara Dorohoi, str. C.D.Gherea, nr.6",0,342,0,342,0,340,2,700,358,141,199,1,3324,1
7,"Botosani",36453,74,36453,,"ORAS BUCECEA",110,"Scoala Generala nr.1 Bucecea, str. Calea Nationala, nr.27",711,355,345,8,2,351,4,800,445,140,211,1,3329,0
7,"Botosani",36453,74,36453,,"ORAS BUCECEA",111,"Centrul Cultural Bucecea, str. Calea Nationala, nr.62",1592,800,796,4,0,788,12,1700,900,253,535,1,3329,0
7,"Botosani",36453,74,36453,,"ORAS BUCECEA",112,"Scoala Generala nr.2 Bucecea, str. Eroilor, nr.33",1449,768,759,9,0,761,7,1500,732,255,506,1,3329,0
7,"Botosani",36453,74,36453,,"ORAS BUCECEA",113,"Scoala Generala Calinesti, str.Inv.Stoleru, nr.1",527,267,257,10,0,263,4,600,333,79,184,1,3329,0
7,"Botosani",36453,74,36453,,"ORAS BUCECEA",114,"Gradinita de copii nr. 1, Bucecea, str. Calea Nationala, nr.28",0,128,0,128,0,128,0,500,372,50,78,1,3329,1
7,"Botosani",35946,74,35946,,"ORAS DARABANI",115,"Grupul Scolar Darabani, str. T.Vladimirescu, nr.20A",1198,642,632,8,2,630,12,1304,662,223,407,1,3333,0
7,"Botosani",35946,74,35946,,"ORAS DARABANI",116,"Scoala Generala ""Leon Danaila"", str.1 Decembrie, nr. 76",1374,827,820,7,0,822,5,1500,673,255,567,1,3333,0
7,"Botosani",35946,74,35946,,"ORAS DARABANI",117,"Scoala Generala ""Leon Danaila"", str.1 Decembrie, nr. 76",1341,736,731,5,0,727,9,1400,664,229,498,1,3333,0
7,"Botosani",35946,74,35946,,"ORAS DARABANI",118,"Gradinita nr.2 Darabani, str. Unirii, nr.2",1283,751,743,7,1,739,12,1405,654,251,488,1,3333,0
7,"Botosani",35946,74,35946,,"ORAS DARABANI",119,"Scoala Cornesti, str.Scolii, nr.53",919,523,517,6,0,510,13,1000,477,177,333,1,3333,0
7,"Botosani",35946,74,35946,,"ORAS DARABANI",120,"Scoala Generala  Bajura",1508,806,801,5,0,797,9,1600,794,279,518,1,3333,0
7,"Botosani",35946,74,35946,,"ORAS DARABANI",121,"Scoala Generala Teioasa, str. Crinilor",1133,618,611,7,0,613,5,1200,582,229,384,1,3333,0
7,"Botosani",35946,74,35946,,"ORAS DARABANI",122,"Scoala Generala  Lismanita",519,335,329,6,0,330,5,600,265,60,270,1,3333,0
7,"Botosani",35946,74,35946,,"ORAS DARABANI",123,"Scoala Generala  Esanca",290,154,145,9,0,151,3,400,246,35,116,1,3333,0
7,"Botosani",35946,74,35946,,"ORAS DARABANI",124,"Fosta Casa de cultura, str. 1 Decembrie, nr.243",0,119,0,119,0,117,2,500,381,48,69,1,3333,1
7,"Botosani",37280,74,37280,,"ORAS FLAMANZI",125,"Scoala Generala nr.1 Flamanzi",693,333,328,5,0,327,6,800,467,190,137,1,3338,0
7,"Botosani",37280,74,37280,,"ORAS FLAMANZI",126,"Scoala Generala nr.1 Flamanzi",736,328,323,4,1,326,2,800,472,158,168,1,3338,0
7,"Botosani",37280,74,37280,,"ORAS FLAMANZI",127,"Scoala Generala nr.2 Flamanzi (Cordun)",1329,620,609,10,1,608,12,1400,780,253,355,1,3338,0
7,"Botosani",37280,74,37280,,"ORAS FLAMANZI",128,"Casa de Cultura Flamanzi(Cordun)",875,381,370,11,0,380,1,1000,619,175,205,1,3338,0
7,"Botosani",37280,74,37280,,"ORAS FLAMANZI",129,"Scoala Generala Poiana",1473,694,686,7,1,679,15,1595,901,302,377,1,3338,0
7,"Botosani",37280,74,37280,,"ORAS FLAMANZI",130,"Gradinita Nicolae Balcescu",836,409,391,15,3,400,9,900,491,196,204,1,3338,0
7,"Botosani",37280,74,37280,,"ORAS FLAMANZI",131,"Grup scolar N.Balcescu",743,360,350,9,1,351,9,800,440,185,166,1,3338,0
7,"Botosani",37280,74,37280,,"ORAS FLAMANZI",132,"Grup scolar N.Balcescu, loc.Bosanceni",772,397,387,8,2,388,9,900,503,172,216,1,3338,0
7,"Botosani",37280,74,37280,,"ORAS FLAMANZI",133,"Grup scolar N.Balcescu, loc.Bosanceni",858,493,478,6,9,480,13,900,407,224,256,1,3338,0
7,"Botosani",37280,74,37280,,"ORAS FLAMANZI",134,"Scoala cu clasele I-IV  Chitoveni",458,245,239,6,0,244,1,500,255,98,146,1,3338,0
7,"Botosani",37280,74,37280,,"ORAS FLAMANZI",135,"Scoala Generala Prisacani",539,296,290,6,0,289,7,600,304,152,137,1,3338,0
7,"Botosani",37280,74,37280,,"ORAS FLAMANZI",136,"Unitatea de asistenta medico-sociala N.Balcescu,loc.Bosanceni",0,147,0,147,0,142,5,500,353,53,89,1,3338,1
7,"Botosani",36060,74,36060,,"ORAS SAVENI",137,"Grup Scolar Dr. M.Ciuca  ,str. N.Iorga Saveni",1204,616,608,8,0,605,11,1301,685,177,428,1,3344,0
7,"Botosani",36060,74,36060,,"ORAS SAVENI",138,"Grup Scolar Dr. M.Ciuca  ,str. N.Iorga Saveni",864,434,427,7,0,432,2,1000,566,132,300,1,3344,0
7,"Botosani",36060,74,36060,,"ORAS SAVENI",139,"Scoala Generala cu clasele I-VIII, str. N.Iorga, nr.3 Saveni",1555,809,799,9,1,804,5,1600,791,269,535,1,3344,0
7,"Botosani",36060,74,36060,,"ORAS SAVENI",140,"Scoala Generala nr.2 , str. Stefan cel Mare Saveni",1379,728,721,6,1,713,15,1500,772,252,461,1,3344,0
7,"Botosani",36060,74,36060,,"ORAS SAVENI",141,"Scoala Generala Petricani",1119,563,560,3,0,554,9,1200,637,163,391,1,3344,0
7,"Botosani",36060,74,36060,,"ORAS SAVENI",142,"Scoala Generala sat Bodeasa",346,209,204,5,0,204,5,400,191,29,175,1,3344,0
7,"Botosani",36060,74,36060,,"ORAS SAVENI",143,"Scoala Generala sat Bozieni",207,113,7,106,0,111,2,301,188,22,89,1,3344,0
7,"Botosani",36060,74,36060,,"ORAS SAVENI",144,"Agentia Judeteana pentru Ocuparea Fortei de Munca, punct de lucru Saveni, str. T.Vladimirescu, nr. 2",0,116,0,116,0,113,3,300,184,38,75,1,3344,1
7,"Botosani",39168,74,39168,,"ORAS STEFANESTI",145,"Scoala Generala Bobulesti",1051,574,563,11,0,566,8,1100,526,165,401,1,3351,0
7,"Botosani",39168,74,39168,,"ORAS STEFANESTI",146,"Scoala Generala Badeuti",718,360,348,12,0,353,7,800,440,129,224,1,3351,0
7,"Botosani",39168,74,39168,,"ORAS STEFANESTI",147,"Grupul Scolar Stefanesti , corp A",971,464,455,9,0,459,5,1102,638,196,263,1,3351,0
7,"Botosani",39168,74,39168,,"ORAS STEFANESTI",148,"Grupul Scolar Stefanesti, corp B, Sala 1",1012,496,490,6,0,488,8,1100,604,188,300,1,3351,0
7,"Botosani",39168,74,39168,,"ORAS STEFANESTI",149,"Scoala Generala Stanca",757,400,396,4,0,400,0,800,400,162,238,1,3351,0
7,"Botosani",39168,74,39168,,"ORAS STEFANESTI",150,"Grupul Scolar Stefanesti, corp B, Sala 2",0,136,0,136,0,135,1,499,363,70,65,1,3351,1
7,"Botosani",40035,74,40035,,"ADASENI",151,"Caminul Cultural Adaseni",784,412,405,6,1,406,6,900,488,145,261,3,3357,0
7,"Botosani",40035,74,40035,,"ADASENI",152,"Scoala Generala nr. 1 Zoitani",304,184,175,9,0,180,4,400,216,43,137,3,3357,0
7,"Botosani",40035,74,40035,,"ADASENI",153,"Scoala Generala  nr. 2, cu clase;e I-VIII, Adaseni",0,40,0,40,0,40,0,301,261,21,19,3,3357,1
7,"Botosani",36131,74,36131,,"ALBESTI",154,"Caminul Cultural Albesti",1019,535,528,7,0,532,3,1100,565,191,341,3,3360,0
7,"Botosani",36131,74,36131,,"ALBESTI",155,"Scoala generala nr.2 Albesti",630,417,392,25,0,413,4,700,283,208,205,3,3360,0
7,"Botosani",36131,74,36131,,"ALBESTI",156,"Scoala Generala Buimaceni",628,323,315,8,0,320,3,700,377,144,176,3,3360,0
7,"Botosani",36131,74,36131,,"ALBESTI",157,"Scoala Generala Costiugeni",515,262,251,11,0,254,8,600,338,68,186,3,3360,0
7,"Botosani",36131,74,36131,,"ALBESTI",158,"Scoala Generala Jijia",489,255,240,15,0,253,2,600,345,99,154,3,3360,0
7,"Botosani",36131,74,36131,,"ALBESTI",159,"Scoala Generala Mascateni",315,165,158,7,0,162,3,400,235,80,82,3,3360,0
7,"Botosani",36131,74,36131,,"ALBESTI",160,"Scoala Generala Tudor Vladimirescu",585,306,299,7,0,302,4,700,394,123,179,3,3360,0
7,"Botosani",36131,74,36131,,"ALBESTI",161,"Scoala Generala Tudor Vladimirescu",596,319,312,7,0,317,2,700,381,134,183,3,3360,0
7,"Botosani",36131,74,36131,,"ALBESTI",162,"Scoala cu clasele I-VIII nr. 1 Albesti",0,86,0,86,0,84,2,300,214,41,43,3,3360,1
7,"Botosani",36202,74,36202,,"AVRAMENI",163,"Scoala Generala Avrameni",1158,610,606,4,0,603,7,1200,590,231,372,3,3367,0
7,"Botosani",36202,74,36202,,"AVRAMENI",164,"Scoala  Generala Panaitoaia",586,311,290,21,0,307,4,700,389,88,219,3,3367,0
7,"Botosani",36202,74,36202,,"AVRAMENI",165,"Scoala Generala Tudor Vladimirescu",612,338,326,12,0,336,2,700,362,111,225,3,3367,0
7,"Botosani",36202,74,36202,,"AVRAMENI",166,"Scoala  Generala Aurel Vlaicu",481,253,248,5,0,251,2,600,347,64,187,3,3367,0
7,"Botosani",36202,74,36202,,"AVRAMENI",167,"Scoala  Generala Ichimeni",139,83,73,10,0,82,1,200,117,25,57,3,3367,0
7,"Botosani",36202,74,36202,,"AVRAMENI",168,"Scoala nr.2 Avrameni",0,32,0,32,0,32,0,300,268,14,18,3,3367,1
7,"Botosani",36300,74,36300,,"BALUSENI",169,"Scoala Generala Baluseni",1497,791,786,5,0,782,9,1610,819,179,603,3,3375,0
7,"Botosani",36300,74,36300,,"BALUSENI",170,"Scoala Generala  Draxini",1569,866,857,8,1,858,8,1700,834,179,679,3,3375,0
7,"Botosani",36300,74,36300,,"BALUSENI",171,"Scoala Generala  Buzeni",562,318,304,12,2,312,6,700,382,76,236,3,3375,0
7,"Botosani",36300,74,36300,,"BALUSENI",172,"Scoala Generala Zaicesti",532,325,319,6,0,320,5,600,275,142,178,3,3375,0
7,"Botosani",36300,74,36300,,"BALUSENI",173,"Scoala Generala Baluseni, str. Principala",0,74,0,74,0,70,4,299,225,32,38,3,3375,1
7,"Botosani",39983,74,39983,,"BLANDESTI",174,"Scoala cu clasele I-VIII Blandesti",679,406,402,4,0,398,8,800,394,108,290,3,3382,0
7,"Botosani",39983,74,39983,,"BLANDESTI",175,"Scoala cu clasele I-IV Cerchejeni",725,377,371,6,0,372,5,800,423,130,242,3,3382,0
7,"Botosani",39983,74,39983,,"BLANDESTI",176,"Scoala cu clasele I-IV Soldanesti",373,236,231,5,0,234,2,500,264,67,167,3,3382,0
7,"Botosani",39983,74,39983,,"BLANDESTI",177,"Scoala cu clasele I-VIII Blandesti",0,56,0,56,0,55,1,300,244,27,28,3,3382,1
7,"Botosani",36373,74,36373,,"BRAESTI",178,"Camin Cultural Braesti",1148,605,590,5,10,603,2,1200,595,266,337,3,3386,0
7,"Botosani",36373,74,36373,,"BRAESTI",179,"Scoala Generala Poiana",375,229,221,7,1,228,1,500,271,125,103,3,3386,0
7,"Botosani",36373,74,36373,,"BRAESTI",180,"Scoala Generala Popeni",214,153,145,8,0,149,4,304,151,63,86,3,3386,0
7,"Botosani",36373,74,36373,,"BRAESTI",181,"Scoala Generala cu clasele I-VIII Braesti",0,126,0,126,0,126,0,300,174,71,55,3,3386,1
7,"Botosani",36426,74,36426,,"BROSCAUTI",182,"Gradinita de copii Broscauti",1449,714,710,4,0,707,7,1500,786,208,499,3,3391,0
7,"Botosani",36426,74,36426,,"BROSCAUTI",183,"Scoala Generala cu clasele I-VIII Dimitrie Pompeiu Broscauti",1371,670,664,6,0,658,12,1500,830,206,452,3,3391,0
7,"Botosani",36426,74,36426,,"BROSCAUTI",184,"Scoala Generala cu clasele I-VIII Dimitrie Pompeiu Broscauti",0,50,0,50,0,49,1,300,250,25,24,3,3391,1
7,"Botosani",39967,74,39967,,"CANDESTI",185,"Scoala Generala Candesti",892,503,499,4,0,497,6,1001,498,175,322,3,3398,0
7,"Botosani",39967,74,39967,,"CANDESTI",186,"Scoala Generala Talpa",531,314,311,3,0,310,4,600,286,74,236,3,3398,0
7,"Botosani",39967,74,39967,,"CANDESTI",187,"Scoala Generala Vitcani",271,162,155,7,0,161,1,300,138,60,101,3,3398,0
7,"Botosani",39967,74,39967,,"CANDESTI",188,"Scoala cu clasele I-VIII Candesti",0,93,0,93,0,91,2,300,207,36,55,3,3398,1
7,"Botosani",36499,74,36499,,"CALARASI",189,"Camin Cultural Calarasi",1018,584,574,10,0,577,7,1100,516,200,377,3,3394,0
7,"Botosani",36499,74,36499,,"CALARASI",190,"Scoala Generala Calarasi",994,545,534,11,0,541,4,1119,574,196,345,3,3394,0
7,"Botosani",36499,74,36499,,"CALARASI",191,"Scoala Generala Plesani",477,252,246,6,0,248,4,607,355,90,158,3,3394,0
7,"Botosani",36499,74,36499,,"CALARASI",192,"Scoala Generala Libertatea",392,251,245,6,0,247,4,500,249,92,155,3,3394,0
7,"Botosani",36499,74,36499,,"CALARASI",193,"Scoala cu clasele I-VIII Calarasi",0,74,0,74,0,73,1,200,126,32,41,3,3394,1
7,"Botosani",36532,74,36532,,"CONCESTI",194,"Camin Cultural Concesti Sala mica",1315,743,728,3,12,731,12,1400,657,180,551,3,3403,0
7,"Botosani",36532,74,36532,,"CONCESTI",195,"Camin Cultural  Movileni",289,203,193,7,3,195,8,400,197,35,160,3,3403,0
7,"Botosani",36532,74,36532,,"CONCESTI",196,"Camin Cultural Concesti Sala mare",0,34,0,34,0,34,0,201,167,10,24,3,3403,1
7,"Botosani",36569,74,36569,,"COPALAU",197,"Scoala cu clasele I-VIII Copalau",1073,560,555,4,1,552,8,1200,640,206,346,3,3406,0
7,"Botosani",36569,74,36569,,"COPALAU",198,"Scoala cu clasele I-VIII Copalau",1088,538,537,1,0,527,11,1200,662,231,296,3,3406,0
7,"Botosani",36569,74,36569,,"COPALAU",199,"Scoala cu clasele I-VIII Cotu",543,306,301,5,0,297,9,600,294,95,202,3,3406,0
7,"Botosani",36569,74,36569,,"COPALAU",200,"Scoala cu clasele I-IV Cerbu",576,313,305,8,0,309,4,700,387,117,192,3,3406,0
7,"Botosani",36569,74,36569,,"COPALAU",201,"Scoala cu clasele I-VIII Copalau",0,58,0,58,0,56,2,300,242,21,35,3,3406,1
7,"Botosani",36649,74,36649,,"CORDARENI",202,"Camin Cultural Cordareni Sala mica",863,490,485,5,0,483,7,1000,510,78,405,3,3410,0
7,"Botosani",36649,74,36649,,"CORDARENI",203,"Scoala Generala nr. 2 Grivita",411,220,217,3,0,217,3,500,280,51,166,3,3410,0
7,"Botosani",36649,74,36649,,"CORDARENI",204,"Scoala Generala Slobozia",345,248,242,6,0,245,3,400,152,49,196,3,3410,0
7,"Botosani",36649,74,36649,,"CORDARENI",205,"Camin Cultural Cordareni Sala mare",0,49,0,49,0,48,1,200,151,15,33,3,3410,1
7,"Botosani",36676,74,36676,,"CORLATENI",206,"Scoala Corlateni, Corp B, str. Principala, nr. 46",590,332,331,1,0,327,5,700,368,127,200,3,3414,0
7,"Botosani",36676,74,36676,,"CORLATENI",207,"Gradinita Carasa",520,332,327,5,0,324,8,600,268,109,215,3,3414,0
7,"Botosani",36676,74,36676,,"CORLATENI",208,"Scoala  Vladeni",424,279,274,4,1,270,9,500,221,124,146,3,3414,0
7,"Botosani",36676,74,36676,,"CORLATENI",209,"Scoala Podeni",363,233,229,4,0,227,6,500,267,96,131,3,3414,0
7,"Botosani",36676,74,36676,,"CORLATENI",210,"Scoala cu clasele I-VIII Corlateni",0,148,0,148,0,147,1,199,51,75,72,3,3414,1
7,"Botosani",36756,74,36756,,"CORNI",211,"Scoala Centru Corni",1304,647,640,7,0,640,7,1400,753,278,362,3,3419,0
7,"Botosani",36756,74,36756,,"CORNI",212,"Scoala Centru Corni",892,452,447,5,0,441,11,1000,548,221,220,3,3419,0
7,"Botosani",36756,74,36756,,"CORNI",213,"Scoala  Noua  Corni",1061,517,517,0,0,511,6,1218,701,221,290,3,3419,0
7,"Botosani",36756,74,36756,,"CORNI",214,"Scoala  Sarafinesti",1224,601,596,5,0,590,11,1300,699,230,360,3,3419,0
7,"Botosani",36756,74,36756,,"CORNI",215,"Scoala Mesteacan",278,162,156,6,0,160,2,400,238,86,74,3,3419,0
7,"Botosani",36756,74,36756,,"CORNI",216,"Scoala Balta Arsa",315,203,192,11,0,201,2,400,197,62,139,3,3419,0
7,"Botosani",36756,74,36756,,"CORNI",217,"Scoala  Noua  Centru Corni",0,98,0,98,0,96,2,200,102,38,58,3,3419,1
7,"Botosani",39975,74,39975,,"COSULA",218,"Scoala Generala nr. 2 Cosula",991,449,441,8,0,434,15,1100,651,152,282,3,3424,0
7,"Botosani",39975,74,39975,,"COSULA",219,"Scoala Generala Supitca",665,347,340,7,0,339,8,703,356,108,231,3,3424,0
7,"Botosani",39975,74,39975,,"COSULA",220,"Scoala Generala Padureni",438,239,231,8,0,233,6,500,261,114,119,3,3424,0
7,"Botosani",39975,74,39975,,"COSULA",221,"Scoala Generala Buda",214,127,118,9,0,123,4,305,178,55,68,3,3424,0
7,"Botosani",39975,74,39975,,"COSULA",222,"Scoala Generala nr. 2 Cosula",0,60,0,60,0,60,0,200,140,31,29,3,3424,1
7,"Botosani",36809,74,36809,,"COTUSCA",223,"Scoala Generala nr.1 Cotusca",1422,767,765,2,0,755,12,1500,733,215,540,3,3429,0
7,"Botosani",36809,74,36809,,"COTUSCA",224,"Scoala Generala Ghireni",541,356,346,10,0,352,4,600,244,124,228,3,3429,0
7,"Botosani",36809,74,36809,,"COTUSCA",225,"Scoala Generala Cotu Miculinti",355,213,203,10,0,212,1,400,187,45,167,3,3429,0
7,"Botosani",36809,74,36809,,"COTUSCA",226,"Scoala Generala Crasnaleuca",546,311,304,7,0,310,1,600,289,91,219,3,3429,0
7,"Botosani",36809,74,36809,,"COTUSCA",227,"Scoala Generala  Putureni",513,310,303,7,0,309,1,600,290,100,209,3,3429,0
7,"Botosani",36809,74,36809,,"COTUSCA",228,"Scoala Generala Nichiteni",716,433,429,4,0,430,3,800,367,135,295,3,3429,0
7,"Botosani",36809,74,36809,,"COTUSCA",229,"Grup Scolar Cotusca",0,80,0,80,0,79,1,300,220,32,47,3,3429,1
7,"Botosani",36907,74,36907,,"CRISTESTI",230,"Scoala Generala cu clasele I-VIII Cristesti",1365,683,671,4,8,665,18,1400,717,293,372,3,3439,0
7,"Botosani",36907,74,36907,,"CRISTESTI",231,"Scoala Generala cu clasele I-VIII Oneaga",1238,652,635,5,12,637,15,1300,648,267,370,3,3439,0
7,"Botosani",36907,74,36907,,"CRISTESTI",232,"Scoala Generala cu clasele I-IV Schit-Oraseni",443,242,234,8,0,237,5,500,258,134,103,3,3439,0
7,"Botosani",36907,74,36907,,"CRISTESTI",233,"Scoala Generala cu clasele I-IV Ghilanesti",591,344,327,16,1,338,6,700,356,137,201,3,3439,0
7,"Botosani",36907,74,36907,,"CRISTESTI",234,"Scoala Generala nr. 1 Cristesti",0,97,0,97,0,96,1,300,203,42,54,3,3439,1
7,"Botosani",36952,74,36952,,"CRISTINESTI",235,"P.A.P.I (Punctul de acces public la informatie ) Cristinesti",1289,709,707,2,0,698,11,1400,691,338,360,3,3444,0
7,"Botosani",36952,74,36952,,"CRISTINESTI",236,"Sala de educatie fizica scolara Dragalina",495,320,315,5,0,318,2,601,281,145,173,3,3444,0
7,"Botosani",36952,74,36952,,"CRISTINESTI",237,"Scoala Generala Fundu Hertii",629,376,372,4,0,374,2,701,325,157,217,3,3444,0
7,"Botosani",36952,74,36952,,"CRISTINESTI",238,"Scoala Generala Baranca",442,298,292,6,0,296,2,500,202,166,130,3,3444,0
7,"Botosani",36952,74,36952,,"CRISTINESTI",239,"Scoala cu clasele I-VIII Cristinesti",0,180,0,180,0,180,0,301,121,105,75,3,3444,1
7,"Botosani",35759,74,35759,,"CURTESTI",240,"Scoala Generala Curtesti",677,411,401,10,0,404,7,800,389,214,190,3,3451,0
7,"Botosani",35759,74,35759,,"CURTESTI",241,"Scoala Generala Oraseni - Vale",614,297,280,17,0,293,4,700,403,145,148,3,3451,0
7,"Botosani",35759,74,35759,,"CURTESTI",242,"Scoala Generala Oraseni - Deal",859,448,436,12,0,443,5,900,452,209,234,3,3451,0
7,"Botosani",35759,74,35759,,"CURTESTI",243,"Scoala Generala Baiceni",717,386,375,11,0,383,3,801,415,147,236,3,3451,0
7,"Botosani",35759,74,35759,,"CURTESTI",244," Scoala Generala  Manastirea - Doamnei",714,390,384,6,0,382,8,800,410,151,231,3,3451,0
7,"Botosani",35759,74,35759,,"CURTESTI",245,"Scoala Generala Agafton",213,137,126,11,0,135,2,300,163,27,108,3,3451,0
7,"Botosani",35759,74,35759,,"CURTESTI",246,"Scoala Generala Curtesti",0,28,0,28,0,28,0,500,472,15,13,3,3451,1
7,"Botosani",37057,74,37057,,"DANGENI",247,"Scoala Generala Dangeni",1046,608,604,2,2,598,10,1100,492,211,387,3,3459,0
7,"Botosani",37057,74,37057,,"DANGENI",248,"Scoala Generala Hulub",493,369,357,12,0,364,5,602,233,156,208,3,3459,0
7,"Botosani",37057,74,37057,,"DANGENI",249,"Scoala Generala Iacobeni",813,584,577,7,0,576,8,902,318,257,319,3,3459,0
7,"Botosani",37057,74,37057,,"DANGENI",250,"Caminul Cultural Dangeni",0,109,0,109,0,107,2,300,191,50,57,3,3459,1
7,"Botosani",37011,74,37011,,"DERSCA",251,"Camin Cultural Dersca",1451,784,784,0,0,772,12,1500,716,324,448,3,3464,0
7,"Botosani",37011,74,37011,,"DERSCA",252,"Scoala Generala cu clasele I-VIII  Dersca",1154,631,631,0,0,622,9,1200,569,275,347,3,3464,0
7,"Botosani",37011,74,37011,,"DERSCA",253,"Scoala Generala cu clasele I-VIII  Dersca",0,104,0,104,0,103,1,500,396,56,47,3,3464,1
7,"Botosani",39959,74,39959,,"DIMACHENI",254,"Scoala Generala cu clasele I-VIII Dimacheni",910,636,620,7,9,627,9,1000,364,88,539,3,3466,0
7,"Botosani",39959,74,39959,,"DIMACHENI",255,"Camin Cultural  Mateieni",238,153,142,6,5,151,2,300,147,30,121,3,3466,0
7,"Botosani",39959,74,39959,,"DIMACHENI",256,"Scoala Generala cu clasele I-VIII Dimacheni",0,47,0,47,0,47,0,201,154,16,31,3,3466,1
7,"Botosani",37100,74,37100,,"DOBARCENI",257,"Caminul Cultural Dobarceni",734,447,425,7,15,441,6,800,353,217,224,3,3470,0
7,"Botosani",37100,74,37100,,"DOBARCENI",258,"Scoala Generala Bivolari",135,88,77,11,0,87,1,200,112,28,59,3,3470,0
7,"Botosani",37100,74,37100,,"DOBARCENI",259,"Localul administrativ Brateni (fost CAP)",589,320,315,3,2,316,4,700,380,155,161,3,3470,0
7,"Botosani",37100,74,37100,,"DOBARCENI",260,"Scoala Generala Cismanesti",343,227,225,2,0,223,4,400,173,55,168,3,3470,0
7,"Botosani",37100,74,37100,,"DOBARCENI",261,"Scoala Generala Murguta",364,270,253,6,11,267,3,500,230,159,108,3,3470,0
7,"Botosani",37100,74,37100,,"DOBARCENI",262,"Caminul Cultural Dobarceni",0,56,0,56,0,56,0,200,144,24,32,3,3470,1
7,"Botosani",37173,74,37173,,"DRAGUSENI",263,"Scoala Generala cu clasele I-VIII Draguseni",1213,708,707,1,0,694,14,1305,597,182,512,3,3477,0
7,"Botosani",37173,74,37173,,"DRAGUSENI",264,"Scoala Generala cu clasele I-IV Podriga",750,423,419,4,0,420,3,800,377,79,341,3,3477,0
7,"Botosani",37173,74,37173,,"DRAGUSENI",265,"Scoala Generala cu clasele I-IV Sarata",128,91,82,9,0,91,0,200,109,32,59,3,3477,0
7,"Botosani",37173,74,37173,,"DRAGUSENI",266,"Scoala Generala cu clasele I-VIII Draguseni",0,35,0,35,0,35,0,201,166,21,14,3,3477,1
7,"Botosani",37217,74,37217,,"DURNESTI",267,"Scoala Veche Durnesti",939,510,509,1,0,503,7,1000,490,134,369,3,3481,0
7,"Botosani",37217,74,37217,,"DURNESTI",268,"Scoala Generala Cucuteni",701,409,405,4,0,403,6,826,417,149,254,3,3481,0
7,"Botosani",37217,74,37217,,"DURNESTI",269,"Scoala Generala Guranda",868,433,426,7,0,424,9,900,467,205,219,3,3481,0
7,"Botosani",37217,74,37217,,"DURNESTI",270,"Scoala Generala Babiceni",618,315,307,8,0,312,3,700,385,74,238,3,3481,0
7,"Botosani",37217,74,37217,,"DURNESTI",271,"Scoala Veche Durnesti",0,80,0,80,0,78,2,200,120,28,50,3,3481,1
7,"Botosani",37324,74,37324,,"FRUMUSICA",272,"Scoala Veche Frumusica",624,325,321,4,0,323,2,700,375,117,206,3,3488,0
7,"Botosani",37324,74,37324,,"FRUMUSICA",273,"Scoala Generala cu clasele I-VIII Storesti",869,484,469,15,0,473,11,1000,516,170,303,3,3488,0
7,"Botosani",37324,74,37324,,"FRUMUSICA",274,"Scoala Generala cu clasele I-IV Sendreni",560,266,259,7,0,259,7,603,337,70,189,3,3488,0
7,"Botosani",37324,74,37324,,"FRUMUSICA",275,"Scoala Generala cu clasele I-VIII Vladeni Deal",1299,603,597,6,0,596,7,1400,797,162,434,3,3488,0
7,"Botosani",37324,74,37324,,"FRUMUSICA",276,"Scoala Generala cu clasele I-VIII Radeni",804,400,392,8,0,392,8,900,500,135,257,3,3488,0
7,"Botosani",37324,74,37324,,"FRUMUSICA",277,"Scoala Generala cu clasele I-IV Boscoteni",524,294,287,7,0,284,10,600,306,161,123,3,3488,0
7,"Botosani",37324,74,37324,,"FRUMUSICA",278,"Scoala Noua Frumusica",0,45,0,45,0,43,2,300,255,14,29,3,3488,1
7,"Botosani",37397,74,37397,,"GEORGE ENESCU",279,"Sala Bibliotecii comunale George Enescu",603,386,381,5,0,377,9,700,314,216,161,3,3495,0
7,"Botosani",37397,74,37397,,"GEORGE ENESCU",280,"Scoala Generala nr.2 Dumeni",963,666,656,10,0,647,19,1100,434,384,263,3,3495,0
7,"Botosani",37397,74,37397,,"GEORGE ENESCU",281,"Scoala Generala Arborea",420,268,263,5,0,264,4,500,232,132,132,3,3495,0
7,"Botosani",37397,74,37397,,"GEORGE ENESCU",282,"Scoala Generala Stanca",312,224,220,4,0,222,2,402,178,100,122,3,3495,0
7,"Botosani",37397,74,37397,,"GEORGE ENESCU",283,"Scoala Generala Popeni",397,258,253,5,0,256,2,500,242,112,144,3,3495,0
7,"Botosani",37397,74,37397,,"GEORGE ENESCU",284,"Scoala Generala nr.1 Dumeni",0,143,0,143,0,143,0,203,60,82,61,3,3495,1
7,"Botosani",37459,74,37459,,"GORBANESTI",285,"Caminul Cultural Gorbanesti",896,546,542,4,0,530,16,1000,454,131,399,3,3501,0
7,"Botosani",37459,74,37459,,"GORBANESTI",286,"Scoala Generala George Cosbuc",212,129,123,6,0,128,1,300,171,55,73,3,3501,0
7,"Botosani",37459,74,37459,,"GORBANESTI",287,"Scoala Generala Batranesti",211,133,128,5,0,133,0,300,167,26,107,3,3501,0
7,"Botosani",37459,74,37459,,"GORBANESTI",288,"Scoala Generala Socrujeni",651,368,362,6,0,361,7,700,332,128,233,3,3501,0
7,"Botosani",37459,74,37459,,"GORBANESTI",289,"Scoala Generala Vanatori",477,279,273,4,2,277,2,600,321,89,188,3,3501,0
7,"Botosani",37459,74,37459,,"GORBANESTI",290,"Scoala Generala Siliscani",259,147,136,11,0,144,3,300,153,48,96,3,3501,0
7,"Botosani",37459,74,37459,,"GORBANESTI",291,"Scoala cu clasele I-VIII Gorbanesti",0,50,0,50,0,50,0,300,250,19,31,3,3501,1
7,"Botosani",37547,74,37547,,"HAVARNA",292,"Scoala Generala Havarna ( de langa posta)",1186,664,659,5,0,655,9,1300,636,238,417,3,3516,0
7,"Botosani",37547,74,37547,,"HAVARNA",293,"Scoala Generala Baseu",672,379,359,20,0,376,3,800,421,128,248,3,3516,0
7,"Botosani",37547,74,37547,,"HAVARNA",294,"Caminul Cultural Havarna",985,498,480,18,0,491,7,1100,602,211,280,3,3516,0
7,"Botosani",37547,74,37547,,"HAVARNA",295,"Scoala Generala Balinti",467,240,232,8,0,238,2,600,360,56,182,3,3516,0
7,"Botosani",37547,74,37547,,"HAVARNA",296,"Scoala Generala Tataraseni",717,440,435,5,0,435,5,800,360,185,250,3,3516,0
7,"Botosani",37547,74,37547,,"HAVARNA",297,"Scoala Generala Havarna ( de langa posta)",0,68,0,68,0,68,0,200,132,34,34,3,3516,1
7,"Botosani",37618,74,37618,,"HANESTI",298,"Caminul Cultural Hanesti",1135,718,696,6,16,707,11,1200,482,334,373,3,3510,0
7,"Botosani",37618,74,37618,,"HANESTI",299,"Scoala Generala Borolea",308,209,201,8,0,208,1,400,191,123,85,3,3510,0
7,"Botosani",37618,74,37618,,"HANESTI",300,"Scoala Generala  Sarata  Basarab",337,256,249,7,0,254,2,401,145,147,107,3,3510,0
7,"Botosani",37618,74,37618,,"HANESTI",301,"Scoala Generala cu clasele I-IV Hanesti",0,40,0,40,0,40,0,200,160,21,19,3,3510,1
7,"Botosani",37672,74,37672,,"HILISEU-HORIA",302,"Scoala Generala cu clasele I-VIII Hiliseu-Horia",1111,527,525,2,0,524,3,1200,673,126,398,3,3523,0
7,"Botosani",37672,74,37672,,"HILISEU-HORIA",303,"Scoala Generala cu clasele I-VIII Hiliseu - Crisan",1076,628,623,5,0,621,7,1200,572,260,361,3,3523,0
7,"Botosani",37672,74,37672,,"HILISEU-HORIA",304,"Scoala Generala cu clasele I-IV Hiliseu - Closca",528,315,306,9,0,311,4,600,285,93,218,3,3523,0
7,"Botosani",37672,74,37672,,"HILISEU-HORIA",305,"Scoala Generala cu clasele I-VIII Hiliseu-Horia",0,54,0,54,0,54,0,200,146,18,36,3,3523,1
7,"Botosani",37734,74,37734,,"HLIPICENI",306,"Scoala Generala cu clasele I-VIII Dan Iordachescu Hlipiceni",1425,755,750,5,0,741,14,1500,745,317,424,3,3529,0
7,"Botosani",37734,74,37734,,"HLIPICENI",307,"Scoala Generala cu clasele I-VIII Victoria",1175,653,648,5,0,647,6,1300,647,247,400,3,3529,0
7,"Botosani",37734,74,37734,,"HLIPICENI",308,"Scoala Generala cu clasele I-IV Dragalina",312,195,186,9,0,195,0,400,205,80,115,3,3529,0
7,"Botosani",37734,74,37734,,"HLIPICENI",309,"Scoala Generala cu clasele I-VIII Dan Iordachescu Hlipiceni",0,75,0,75,0,73,2,300,225,24,49,3,3529,1
7,"Botosani",37770,74,37770,,"HUDESTI",310,"Caminul Cultural Hudesti",929,487,470,17,0,478,9,1000,513,143,335,3,3533,0
7,"Botosani",37770,74,37770,,"HUDESTI",311,"Caminul Cultural Vatra",1040,602,599,3,0,590,12,1100,498,143,447,3,3533,0
7,"Botosani",37770,74,37770,,"HUDESTI",312,"Scoala Generala Mlenauti",611,412,382,30,0,409,3,700,288,182,227,3,3533,0
7,"Botosani",37770,74,37770,,"HUDESTI",313,"Scoala Generala Baseu",382,242,236,6,0,238,4,500,258,48,190,3,3533,0
7,"Botosani",37770,74,37770,,"HUDESTI",314,"Caminul Cultural Alba",1213,780,771,9,0,771,9,1300,520,230,541,3,3533,0
7,"Botosani",37770,74,37770,,"HUDESTI",315,"Scoala Generala Baranca",692,466,462,4,0,463,3,800,334,207,256,3,3533,0
7,"Botosani",37770,74,37770,,"HUDESTI",316,"Scoala Generala nr.1 Hudesti",0,89,0,89,0,89,0,300,211,40,49,3,3533,1
7,"Botosani",37823,74,37823,,"IBANESTI",317,"Scoala Generala Stefan cel Mare Ibanesti localul nou  (sala 1)",887,587,583,0,4,576,11,1001,414,324,252,3,3540,0
7,"Botosani",37823,74,37823,,"IBANESTI",318,"Scoala Generala Stefan cel Mare Ibanesti localul nou  (sala 2)",977,639,625,2,12,631,8,1099,460,320,311,3,3540,0
7,"Botosani",37823,74,37823,,"IBANESTI",319,"Scoala Mihail Sadoveanu localul nou  Dumbravita(sala 1)",676,433,427,6,0,425,8,800,367,243,182,3,3540,0
7,"Botosani",37823,74,37823,,"IBANESTI",320,"Scoala Mihail Sadoveanu localul nou  Dumbravita(sala 2)",731,431,426,4,1,425,6,800,369,208,217,3,3540,0
7,"Botosani",37823,74,37823,,"IBANESTI",321,"Scoala Generala Stefan cel Mare nr. 1 Ibanesti",0,162,0,162,0,161,1,300,138,97,64,3,3540,1
7,"Botosani",37850,74,37850,,"LEORDA",322,"Scoala Generala nr.1 Leorda",1184,599,593,6,0,593,6,1300,701,153,440,3,3543,0
7,"Botosani",37850,74,37850,,"LEORDA",323,"Scoala Generala  cu clasele I-IV Dolina",710,362,354,8,0,358,4,800,438,111,247,3,3543,0
7,"Botosani",37850,74,37850,,"LEORDA",324,"Scoala Generala cu clasele I-IV Costinesti",175,126,118,8,0,121,5,300,174,16,105,3,3543,0
7,"Botosani",37850,74,37850,,"LEORDA",325,"Scoala Generala nr.1 Leorda",0,121,0,121,0,121,0,301,180,41,80,3,3543,1
7,"Botosani",39942,74,39942,,"LOZNA",326,"Caminul Cultural Lozna - parter",811,474,469,5,0,465,9,900,426,165,300,3,3549,0
7,"Botosani",39942,74,39942,,"LOZNA",327,"Caminul Cultural  Strateni",711,405,401,4,0,402,3,800,395,108,294,3,3549,0
7,"Botosani",39942,74,39942,,"LOZNA",328,"Caminul Cultural Lozna  - etaj",0,121,0,121,0,119,2,300,179,52,67,3,3549,1
7,"Botosani",37912,74,37912,,"LUNCA",329,"Caminul Cultural Lunca - sala de sedinte",670,350,338,12,0,349,1,800,450,125,224,3,3552,0
7,"Botosani",37912,74,37912,,"LUNCA",330,"Caminul Cultural Baznoasa",774,446,440,6,0,436,10,900,454,74,362,3,3552,0
7,"Botosani",37912,74,37912,,"LUNCA",331,"Caminul Cultural Stroesti",798,407,404,3,0,404,3,900,493,132,272,3,3552,0
7,"Botosani",37912,74,37912,,"LUNCA",332,"Scoala Generala Zlatunoaia",1469,706,701,5,0,694,12,1600,894,263,431,3,3552,0
7,"Botosani",37912,74,37912,,"LUNCA",333,"Scoala Generala Stanesti",175,101,94,7,0,100,1,301,200,46,54,3,3552,0
7,"Botosani",37912,74,37912,,"LUNCA",334,"Caminul Cultural Lunca - sala mare",0,49,0,49,0,49,0,300,251,16,33,3,3552,1
7,"Botosani",37958,74,37958,,"MANOLEASA",335,"Scoala Generala Manoleasa",550,289,284,5,0,284,5,600,311,65,219,3,3556,0
7,"Botosani",37958,74,37958,,"MANOLEASA",336,"Scoala Generala Flondora",431,213,208,5,0,212,1,500,287,45,167,3,3556,0
7,"Botosani",37958,74,37958,,"MANOLEASA",337,"Scoala Generala Sadoveni",389,220,214,6,0,218,2,500,280,34,184,3,3556,0
7,"Botosani",37958,74,37958,,"MANOLEASA",338,"Scoala Generala Zahoreni",448,249,240,9,0,245,4,500,251,68,177,3,3556,0
7,"Botosani",37958,74,37958,,"MANOLEASA",339,"Scoala Generala Liveni",619,310,303,7,0,308,2,700,390,72,236,3,3556,0
7,"Botosani",37958,74,37958,,"MANOLEASA",340,"Scoala Generala Loturi",120,72,64,8,0,71,1,200,128,29,42,3,3556,0
7,"Botosani",37958,74,37958,,"MANOLEASA",341,"Scoala Generala  Manoleasa Prut",132,83,72,11,0,83,0,200,117,21,62,3,3556,0
7,"Botosani",37958,74,37958,,"MANOLEASA",342,"Scoala Generala cu clasele I-VIII Manoleasa",0,29,0,29,0,29,0,300,271,10,19,3,3556,1
7,"Botosani",38063,74,38063,,"MIHAI EMINESCU",343,"Scoala Generala cu clasele I-VIII Ipotesti",498,309,300,9,0,308,1,602,293,58,250,3,3567,0
7,"Botosani",38063,74,38063,,"MIHAI EMINESCU",344,"Scoala Generala cu clasele I-VIII Cucorani",723,403,397,4,2,399,4,800,397,156,243,3,3567,0
7,"Botosani",38063,74,38063,,"MIHAI EMINESCU",345,"Scoala Generala cu clasele I-VIII Cervicesti",699,440,429,11,0,436,4,800,360,123,313,3,3567,0
7,"Botosani",38063,74,38063,,"MIHAI EMINESCU",346,"Scoala   cu clasele I-VIII Catamarasti Deal",953,500,475,25,0,494,6,1000,500,239,255,3,3567,0
7,"Botosani",38063,74,38063,,"MIHAI EMINESCU",347,"Scoala   cu clasele I-VIII Catamarasti Deal",985,466,447,18,1,463,3,1100,634,216,247,3,3567,0
7,"Botosani",38063,74,38063,,"MIHAI EMINESCU",348,"Scoala Generala cu clasele I-VIII Stancesti",1159,567,558,9,0,546,21,1200,633,195,351,3,3567,0
7,"Botosani",38063,74,38063,,"MIHAI EMINESCU",349,"Scoala Generala cu clasele I-IV Catamarasti Vale",519,300,287,12,1,297,3,600,300,49,248,3,3567,0
7,"Botosani",38063,74,38063,,"MIHAI EMINESCU",350,"Scoala Generala cu clasele I-VIII Ipotesti",0,62,0,62,0,60,2,300,238,23,37,3,3567,1
7,"Botosani",38161,74,38161,,"MIHAILENI",351,"Scoala Generala cu clasele I-IV Mihaileni",1177,548,544,4,0,542,6,1300,752,173,369,3,3577,0
7,"Botosani",38161,74,38161,,"MIHAILENI",352,"Scoala Generala cu clasele I-IV Rogojesti",496,290,280,5,5,285,5,598,308,123,162,3,3577,0
7,"Botosani",38161,74,38161,,"MIHAILENI",353,"Scoala Generala cu clasele I-IV Parau - Negru",414,202,193,6,3,202,0,498,296,77,125,3,3577,0
7,"Botosani",38161,74,38161,,"MIHAILENI",354,"Scoala Generala cu clasele V-VIII Mihaileni",0,141,0,141,0,140,1,300,159,76,64,3,3577,1
7,"Botosani",38241,74,38241,,"MIHALASENI",355,"Scoala Generala Mihalaseni",648,413,405,4,4,411,2,700,287,276,135,3,3581,0
7,"Botosani",38241,74,38241,,"MIHALASENI",356,"Scoala Generala Sarata",391,264,253,8,3,262,2,500,236,167,95,3,3581,0
7,"Botosani",38241,74,38241,,"MIHALASENI",357,"Scoala Generala Negresti",385,259,253,6,0,255,4,500,241,156,99,3,3581,0
7,"Botosani",38241,74,38241,,"MIHALASENI",358,"Scoala Generala Nastase",373,250,243,5,2,248,2,500,250,101,147,3,3581,0
7,"Botosani",38241,74,38241,,"MIHALASENI",359,"Gradinita Mihalaseni",0,113,0,113,0,111,2,300,187,84,27,3,3581,1
7,"Botosani",38321,74,38321,,"MILEANCA",360,"Scoala Mileanca Corp A",1366,781,778,3,0,764,17,1501,720,336,428,3,3589,0
7,"Botosani",38321,74,38321,,"MILEANCA",361,"Caminul Cultural  Codreni",298,192,185,7,0,186,6,400,208,74,112,3,3589,0
7,"Botosani",38321,74,38321,,"MILEANCA",362,"Scoala Generala Selistea",346,200,193,7,0,199,1,401,201,44,155,3,3589,0
7,"Botosani",38321,74,38321,,"MILEANCA",363,"Scoala Generala Scutari",229,143,137,6,0,140,3,301,158,57,83,3,3589,0
7,"Botosani",38321,74,38321,,"MILEANCA",364,"Scoala cu clasele I-VIII Mileanca Corp B",0,99,0,99,0,99,0,301,202,43,56,3,3589,1
7,"Botosani",38376,74,38376,,"MITOC",365,"Scoala cu clasele I-VIII Mitoc (corp nou)",1021,577,555,2,20,572,5,1102,525,210,362,3,3594,0
7,"Botosani",38376,74,38376,,"MITOC",366,"Scoala cu clasele I-IV  Horia (corp nou)",464,306,295,8,3,301,5,600,294,80,221,3,3594,0
7,"Botosani",38376,74,38376,,"MITOC",367,"Scoala cu clasele I-VIII Mitoc Corp vechi",0,88,0,88,0,87,1,300,212,36,51,3,3594,1
7,"Botosani",38456,74,38456,,"NICSENI",368,"Caminul Cultural Nicseni",953,521,515,6,0,513,8,1000,479,163,350,3,3597,0
7,"Botosani",38456,74,38456,,"NICSENI",369,"Caminul Cultural Dorobanti",1248,632,623,9,0,620,12,1300,668,181,439,3,3597,0
7,"Botosani",38456,74,38456,,"NICSENI",370,"Caminul Cultural Nicseni - sala de sedinte",0,43,0,43,0,42,1,300,257,17,25,3,3597,1
7,"Botosani",38492,74,38492,,"PALTINIS",371,"Caminul Cultural Paltinis",788,484,458,26,0,472,12,900,416,164,308,3,3601,0
7,"Botosani",38492,74,38492,,"PALTINIS",372,"Scoala Generala Grivita",262,163,151,12,0,161,2,401,238,27,134,3,3601,0
7,"Botosani",38492,74,38492,,"PALTINIS",373,"Scoala nr.2 Paltinis catun Ivancauti",582,344,338,6,0,339,5,700,356,117,222,3,3601,0
7,"Botosani",38492,74,38492,,"PALTINIS",374,"Scoala Cuzlau",402,217,212,5,0,216,1,500,283,69,147,3,3601,0
7,"Botosani",38492,74,38492,,"PALTINIS",375,"Scoala Generala cu clasele I-VIII Horodistea",535,349,338,11,0,343,6,600,251,99,244,3,3601,0
7,"Botosani",38492,74,38492,,"PALTINIS",376,"Scoala Generala cu clasele I-VIII nr. 1 Paltinis",0,113,0,113,0,112,1,303,190,34,78,3,3601,1
7,"Botosani",38544,74,38544,,"POMARLA",377,"Sala Teatrului Liceul Teoretic Anastasie Basota Pomarla",1056,717,685,1,31,712,5,1100,383,480,232,3,3606,0
7,"Botosani",38544,74,38544,,"POMARLA",378,"Scoala Generala  cu clasele I-IV Pomarla (Ghiorteni)",851,618,591,4,23,614,4,903,285,403,211,3,3606,0
7,"Botosani",38544,74,38544,,"POMARLA",379,"Scoala Generala  cu clasele I-IV Racovat",271,195,184,7,4,192,3,400,205,118,74,3,3606,0
7,"Botosani",38544,74,38544,,"POMARLA",380,"Liceul Teoretic Anastasie Basota Pomarla",0,129,0,129,0,128,1,400,271,94,34,3,3606,1
7,"Botosani",38580,74,38580,,"PRAJENI",381,"Scoala Generala  cu clasele I-IV Prajeni",1443,697,694,3,0,679,18,1500,803,255,424,3,3610,0
7,"Botosani",38580,74,38580,,"PRAJENI",382,"Scoala Generala  cu clasele I-IV Luparia",633,357,353,4,0,349,8,700,343,179,170,3,3610,0
7,"Botosani",38580,74,38580,,"PRAJENI",383,"Scoala Generala cu clasele I-VIII Miletin",468,297,293,4,0,292,5,600,303,131,161,3,3610,0
7,"Botosani",38580,74,38580,,"PRAJENI",384,"Scoala Generala  cu clasele I-IV Prajeni",0,48,0,48,0,48,0,300,252,26,22,3,3610,1
7,"Botosani",35839,74,35839,,"RACHITI",385,"Scoala Generala Rachiti",1287,645,639,6,0,638,7,1401,756,256,382,3,3615,0
7,"Botosani",35839,74,35839,,"RACHITI",386,"Scoala Generala  Costesti",1232,730,723,7,0,722,8,1303,573,270,452,3,3615,0
7,"Botosani",35839,74,35839,,"RACHITI",387,"Scoala Generala Rosiori",1126,624,616,8,0,616,8,1200,576,234,382,3,3615,0
7,"Botosani",35839,74,35839,,"RACHITI",388,"Biblioteca Comunala Rachiti",0,90,0,90,0,89,1,300,210,45,44,3,3615,1
7,"Botosani",38633,74,38633,,"RADAUTI-PRUT",389,"Scoala Generala Radauti - Prut",637,332,328,4,0,321,11,701,369,129,192,3,3620,0
7,"Botosani",38633,74,38633,,"RADAUTI-PRUT",390,"Caminul Cultural Rediu",818,502,499,3,0,494,8,900,398,212,282,3,3620,0
7,"Botosani",38633,74,38633,,"RADAUTI-PRUT",391,"Caminul Cultural Miorcani",814,472,468,4,0,460,12,900,428,233,227,3,3620,0
7,"Botosani",38633,74,38633,,"RADAUTI-PRUT",392,"Caminul Cultural Miorcani",759,390,389,1,0,379,11,800,410,233,146,3,3620,0
7,"Botosani",38633,74,38633,,"RADAUTI-PRUT",393,"Caminul Cultural Radauti - Prut",0,81,0,81,0,81,0,300,219,31,50,3,3620,1
7,"Botosani",38679,74,38679,,"RAUSENI",394,"Caminul Cultural  Rauseni",1310,686,683,3,0,670,16,1400,714,179,491,3,3624,0
7,"Botosani",38679,74,38679,,"RAUSENI",395,"Scoala Generala Doina",443,247,242,5,0,245,2,500,253,64,181,3,3624,0
7,"Botosani",38679,74,38679,,"RAUSENI",396,"Scoala Generala Rediu",463,263,254,9,0,258,5,600,337,32,226,3,3624,0
7,"Botosani",38679,74,38679,,"RAUSENI",397,"Scoala Generala cu clasele I-VIII Rauseni",0,66,0,66,0,66,0,300,234,24,42,3,3624,1
7,"Botosani",38731,74,38731,,"RIPICENI",398,"Caminul Cultural Ripiceni",904,451,444,6,1,446,5,1000,549,170,276,3,3630,0
7,"Botosani",38731,74,38731,,"RIPICENI",399,"Gradinita de copii Ripiceni",804,407,404,3,0,402,5,900,493,150,252,3,3630,0
7,"Botosani",38731,74,38731,,"RIPICENI",400,"Scoala Veche Ripiceni",0,47,0,47,0,47,0,300,253,17,30,3,3630,1
7,"Botosani",38811,74,38811,,"ROMA",401,"Scoala Generala nr.1 Roma",1335,860,840,5,15,843,17,1401,541,265,578,3,3638,0
7,"Botosani",38811,74,38811,,"ROMA",402,"Scoala Generala nr.2 Roma",824,548,534,9,5,539,9,900,352,205,334,3,3638,0
7,"Botosani",38811,74,38811,,"ROMA",403,"Scoala Generala  nr. 4 Cotargaci",379,207,197,6,4,205,2,500,293,73,132,3,3638,0
7,"Botosani",38811,74,38811,,"ROMA",404,"Scoala de arte si meserii Roma",0,138,0,138,0,137,1,300,162,72,65,3,3638,1
7,"Botosani",38848,74,38848,,"ROMANESTI",405,"Scoala Generala cu clasele I-VIII Romanesti",1211,650,649,1,0,638,12,1300,650,186,452,3,3641,0
7,"Botosani",38848,74,38848,,"ROMANESTI",406,"Scoala Generala cu clasele I-IV Damideni",507,258,242,16,0,255,3,600,342,82,173,3,3641,0
7,"Botosani",38848,74,38848,,"ROMANESTI",407,"Scoala Generala cu clasele I-VIII Romanesti",0,55,0,55,0,54,1,301,246,22,32,3,3641,1
7,"Botosani",38893,74,38893,,"SANTA MARE",408,"Caminul Cultural Santa - Mare",1065,546,544,2,0,534,12,1200,654,218,316,3,3646,0
7,"Botosani",38893,74,38893,,"SANTA MARE",409,"Scoala Generala  Berza",177,127,120,7,0,121,6,300,173,57,64,3,3646,0
7,"Botosani",38893,74,38893,,"SANTA MARE",410,"Scoala Generala Ringhilesti",334,175,167,8,0,170,5,400,225,88,82,3,3646,0
7,"Botosani",38893,74,38893,,"SANTA MARE",411,"Scoala Generala  Bogdanesti",321,193,185,8,0,191,2,400,207,66,125,3,3646,0
7,"Botosani",38893,74,38893,,"SANTA MARE",412,"Scoala Generala  Iliseni",323,174,170,4,0,170,4,400,226,49,121,3,3646,0
7,"Botosani",38893,74,38893,,"SANTA MARE",413,"Gradinita de copii Santa - Mare",0,64,0,64,0,64,0,300,236,31,33,3,3646,1
7,"Botosani",35884,74,35884,,"STAUCENI",414,"Caminul  Cultural Stauceni",1050,543,537,6,0,540,3,1100,557,230,310,3,3659,0
7,"Botosani",35884,74,35884,,"STAUCENI",415,"Scoala Generala  Silistea",341,209,202,7,0,207,2,400,191,107,100,3,3659,0
7,"Botosani",35884,74,35884,,"STAUCENI",416,"Scoala Generala Tocileni",924,509,496,13,0,507,2,1000,491,203,304,3,3659,0
7,"Botosani",35884,74,35884,,"STAUCENI",417,"Scoala Generala Victoria",385,217,210,7,0,212,5,500,283,92,120,3,3659,0
7,"Botosani",35884,74,35884,,"STAUCENI",418,"Caminul  Cultural Stauceni",0,59,0,59,0,59,0,300,241,33,26,3,3659,1
7,"Botosani",38982,74,38982,,"SUHARAU",419,"Scoala Generala cu clasele I-IV Suharau",1106,553,544,9,0,547,6,1200,647,132,415,3,3668,0
7,"Botosani",38982,74,38982,,"SUHARAU",420,"Scoala Generala cu clasele I-VIII nr.2 Suharau",649,353,350,3,0,348,5,700,347,113,235,3,3668,0
7,"Botosani",38982,74,38982,,"SUHARAU",421,"Gradinita Lisna",764,506,499,7,0,504,2,901,395,166,338,3,3668,0
7,"Botosani",38982,74,38982,,"SUHARAU",422,"Scoala generala cu clasele I-VIII nr. 1 Oroftiana",823,457,453,4,0,456,1,900,443,230,226,3,3668,0
7,"Botosani",38982,74,38982,,"SUHARAU",423,"SAM Smirdan",717,441,428,12,1,433,8,801,360,154,279,3,3668,0
7,"Botosani",38982,74,38982,,"SUHARAU",424,"Scoala Generala cu clasele I-VIII nr.1 Suharau",0,119,0,119,0,119,0,300,181,57,62,3,3668,1
7,"Botosani",39051,74,39051,,"SULITA",425,"Scoala Generala  cu clasele I-VIII Sulita",1041,616,607,8,1,607,9,1101,485,240,367,3,3675,0
7,"Botosani",39051,74,39051,,"SULITA",426,"Scoala Generala  cu clasele I-VIII Dracsani",1239,730,728,2,0,714,16,1300,570,227,487,3,3675,0
7,"Botosani",39051,74,39051,,"SULITA",427,"Gradinita Chelis",294,177,169,8,0,176,1,401,224,52,124,3,3675,0
7,"Botosani",39051,74,39051,,"SULITA",428,"Scoala Generala  cu clasele I-VIII Sulita",0,74,0,74,0,72,2,300,226,40,32,3,3675,1
7,"Botosani",39122,74,39122,,"SENDRICENI",429,"Scoala Generala nr. 1 Sendriceni  (Ghilia)",1039,531,525,6,0,525,6,1100,569,153,372,3,3655,0
7,"Botosani",39122,74,39122,,"SENDRICENI",430,"Scoala Generala nr. 2 Sendriceni II (Cobala)",724,407,399,8,0,403,4,800,393,109,294,3,3655,0
7,"Botosani",39122,74,39122,,"SENDRICENI",431,"Scoala Generala Horlaceni",494,239,231,8,0,237,2,600,361,94,143,3,3655,0
7,"Botosani",39122,74,39122,,"SENDRICENI",432,"Scoala Generala Padureni",976,457,448,9,0,452,5,1100,643,120,332,3,3655,0
7,"Botosani",39122,74,39122,,"SENDRICENI",433,"Scoala Generala nr. 1 Sendriceni  (Ghilia)",0,46,0,46,0,46,0,300,254,17,29,3,3655,1
7,"Botosani",39220,74,39220,,"STIUBIENI",434,"Sala de Sport Stiubieni",1543,762,757,5,0,744,18,1601,839,167,577,3,3664,0
7,"Botosani",39220,74,39220,,"STIUBIENI",435,"Caminul Cultural Negreni",647,398,390,8,0,394,4,701,303,83,311,3,3664,0
7,"Botosani",39220,74,39220,,"STIUBIENI",436,"Caminul Cultural Stiubieni",0,83,0,83,0,83,0,301,218,22,61,3,3664,1
7,"Botosani",39266,74,39266,,"TODIRENI",437,"Caminul  Cultural Todireni",1281,665,664,1,0,654,11,1400,735,194,460,3,3679,0
7,"Botosani",39266,74,39266,,"TODIRENI",438,"Scoala Generala cu clasele I-IV nr.2 Todireni",438,200,192,8,0,194,6,500,300,65,129,3,3679,0
7,"Botosani",39266,74,39266,,"TODIRENI",439,"Scoala Generala cu clasele I-VIII Cernesti",679,369,360,8,1,365,4,799,430,124,241,3,3679,0
7,"Botosani",39266,74,39266,,"TODIRENI",440,"Scoala Generala cu clasele I-IV Iuresti",435,256,247,9,0,250,6,500,244,46,204,3,3679,0
7,"Botosani",39266,74,39266,,"TODIRENI",441,"Fostul sediu al CAP Todireni",0,81,0,81,0,80,1,300,219,41,39,3,3679,1
7,"Botosani",39328,74,39328,,"TRUSESTI",442,"Scoala Generala   cu clasele I-VIII Trusesti 1",1056,584,580,1,3,575,9,1101,517,236,339,3,3685,0
7,"Botosani",39328,74,39328,,"TRUSESTI",443,"Scoala Generala  cu clasele I-VIII Trusesti 2",1022,578,572,2,4,571,7,1100,522,234,337,3,3685,0
7,"Botosani",39328,74,39328,,"TRUSESTI",444,"Scoala Generala cu clasele I-VIII Buhaceni",677,415,410,5,0,411,4,811,396,144,267,3,3685,0
7,"Botosani",39328,74,39328,,"TRUSESTI",445,"Scoala Generala cu clasele I-VIII Drislea",822,510,505,5,0,503,7,900,390,196,307,3,3685,0
7,"Botosani",39328,74,39328,,"TRUSESTI",446,"Scoala  Generala  cu clasele I-VIII Ionaseni",900,525,519,6,0,516,9,1011,486,184,332,3,3685,0
7,"Botosani",39328,74,39328,,"TRUSESTI",447,"Scoala Generala   cu clasele I-VIII Trusesti",0,170,0,170,0,166,4,301,131,73,93,3,3685,1
7,"Botosani",39391,74,39391,,"TUDORA",448,"Scoala Generala ""Tiberiu Crudu"" corp B,sala 1 Tudora",1493,833,833,0,0,822,11,1600,767,319,503,3,3692,0
7,"Botosani",39391,74,39391,,"TUDORA",449,"Scoala Generala ""Tiberiu Crudu"" corp B , sala 2 Tudora",1132,548,548,0,0,542,6,1200,652,218,324,3,3692,0
7,"Botosani",39391,74,39391,,"TUDORA",450,"Scoala Generala nr. 2  Arini",1397,706,704,2,0,691,15,1498,792,284,407,3,3692,0
7,"Botosani",39391,74,39391,,"TUDORA",451,"Scoala Generala ""Tiberiu Crudu"" corp B , sala 3 Tudora",0,116,0,116,0,114,2,300,184,55,59,3,3692,1
7,"Botosani",39417,74,39417,,"UNGURENI",452,"Caminul  Cultural Ungureni",1250,562,556,6,0,561,1,1301,739,170,391,3,3694,0
7,"Botosani",39417,74,39417,,"UNGURENI",453,"Scoala Generala Epureni",1129,535,528,7,0,529,6,1200,665,227,302,3,3694,0
7,"Botosani",39417,74,39417,,"UNGURENI",454,"Scoala Generala Mihai Viteazul",372,229,221,8,0,223,6,500,271,91,132,3,3694,0
7,"Botosani",39417,74,39417,,"UNGURENI",455,"SAM Plopenii Mari",830,368,359,9,0,363,5,901,533,87,276,3,3694,0
7,"Botosani",39417,74,39417,,"UNGURENI",456,"Scoala Generala  Borzesti",1195,546,538,8,0,535,11,1299,753,211,324,3,3694,0
7,"Botosani",39417,74,39417,,"UNGURENI",457,"Scoala Generala Calugarenii Vechi",550,317,287,30,0,315,2,601,284,83,232,3,3694,0
7,"Botosani",39417,74,39417,,"UNGURENI",458,"Scoala Generala nr.1 Ungureni",0,65,0,65,0,65,0,300,235,27,38,3,3694,1
7,"Botosani",39532,74,39532,,"UNTENI",459,"Scoala Generala cu clasele I-VIII Unteni",1017,599,595,4,0,593,6,1100,501,105,488,3,3706,0
7,"Botosani",39532,74,39532,,"UNTENI",460,"Scoala Generala cu clasele I-VIII Manastireni",680,396,382,9,5,389,7,800,404,152,237,3,3706,0
7,"Botosani",39532,74,39532,,"UNTENI",461,"Scoala Generala  cu clasele I-IV Burlesti",632,349,343,6,0,343,6,700,351,125,218,3,3706,0
7,"Botosani",39532,74,39532,,"UNTENI",462,"Scoala Generala cu clasele I-VIII Unteni",0,64,0,64,0,64,0,300,236,28,36,3,3706,1
7,"Botosani",39694,74,39694,,"VARFU CAMPULUI",463,"Scoala Generala cu clasele I-VIII Maghera",591,436,417,19,0,428,8,703,267,161,267,3,3718,0
7,"Botosani",39694,74,39694,,"VARFU CAMPULUI",464,"Scoala Generala ""George Hazgan"" Varful Campului",1055,675,670,5,0,669,6,1202,527,246,423,3,3718,0
7,"Botosani",39694,74,39694,,"VARFU CAMPULUI",465,"Fosta Scoala Generala Ionaseni",652,386,382,4,0,383,3,804,418,141,242,3,3718,0
7,"Botosani",39694,74,39694,,"VARFU CAMPULUI",466,"Scoala  Generala cu clasele I-IV Lunca",586,313,310,3,0,298,15,700,387,99,199,3,3718,0
7,"Botosani",39694,74,39694,,"VARFU CAMPULUI",467,"Caminul  Cultural Varful Campului",0,145,0,145,0,141,4,300,155,57,84,3,3718,1
7,"Botosani",39612,74,39612,,"VACULESTI",468,"Scoala Generala  Vaculesti",905,605,601,2,2,598,7,1002,397,293,305,3,3714,0
7,"Botosani",39612,74,39612,,"VACULESTI",469,"Scoala Generala  Saucenita",721,476,469,6,1,472,4,801,325,179,293,3,3714,0
7,"Botosani",39612,74,39612,,"VACULESTI",470,"Scoala Generala Gorovei",35,34,26,8,0,34,0,100,66,11,23,3,3714,0
7,"Botosani",39612,74,39612,,"VACULESTI",471,"Scoala Generala  cu clasele I-IV Vaculesti",0,123,0,123,0,122,1,300,177,48,74,3,3714,1
7,"Botosani",39658,74,39658,,"VIISOARA",472,"Caminul  Cultural Viisoara",810,466,465,1,0,459,7,900,434,148,311,3,3725,0
7,"Botosani",39658,74,39658,,"VIISOARA",473,"Scoala Generala cu clasele I-VIII Cuza Voda",503,316,311,5,0,313,3,600,284,103,210,3,3725,0
7,"Botosani",39658,74,39658,,"VIISOARA",474,"Scoala Generala cu clasele I-IV Viisoara Mica",460,281,273,8,0,274,7,600,319,59,215,3,3725,0
7,"Botosani",39658,74,39658,,"VIISOARA",475,"Scoala Generala  Dimitrie Branza cu clasele I-VIII Viisoara corp A",0,37,0,37,0,37,0,300,263,23,14,3,3725,1
7,"Botosani",39738,74,39738,,"VLADENI",476,"Scoala  Veche Vladeni",1503,737,732,5,0,727,10,1600,863,213,514,3,3729,0
7,"Botosani",39738,74,39738,,"VLADENI",477,"Scoala Generala Brehuesti",1270,578,569,9,0,568,10,1400,822,220,348,3,3729,0
7,"Botosani",39738,74,39738,,"VLADENI",478,"Scoala Generala Mandresti",1135,517,507,10,0,509,8,1200,683,151,358,3,3729,0
7,"Botosani",39738,74,39738,,"VLADENI",479,"Scoala Noua Vladeni",0,85,0,85,0,85,0,300,215,26,59,3,3729,1
7,"Botosani",39792,74,39792,,"VLASINESTI",480,"Scoala Generala  cu clasele I-VIII Vlasinesti",1351,767,760,7,0,756,11,1500,733,229,527,3,3735,0
7,"Botosani",39792,74,39792,,"VLASINESTI",481,"Scoala Generala  cu clasele I-IV Sarbi",864,483,475,8,0,479,4,1000,517,181,298,3,3735,0
7,"Botosani",39792,74,39792,,"VLASINESTI",482,"Scoala Generala cu clasele I-IV Miron Costin",318,217,206,11,0,214,3,400,183,113,101,3,3735,0
7,"Botosani",39792,74,39792,,"VLASINESTI",483,"Scoala Generala  cu clasele I-VIII Vlasinesti",0,94,0,94,0,93,1,300,206,39,54,3,3735,1
7,"Botosani",39836,74,39836,,"VORNICENI",484,"Scoala Generala nr.1 Vorniceni",1269,568,561,7,0,557,11,1400,832,227,330,3,3739,0
7,"Botosani",39836,74,39836,,"VORNICENI",485,"Scoala Generala nr.2 Vorniceni",842,395,387,8,0,388,7,900,505,136,252,3,3739,0
7,"Botosani",39836,74,39836,,"VORNICENI",486,"Scoala Generala nr.3 Vorniceni",910,403,399,4,0,396,7,1000,597,157,239,3,3739,0
7,"Botosani",39836,74,39836,,"VORNICENI",487,"Scoala Generala Dealu Cruci",271,147,141,6,0,147,0,400,253,61,86,3,3739,0
7,"Botosani",39836,74,39836,,"VORNICENI",488,"Scoala Generala nr.2 Vorniceni",0,38,0,38,0,36,2,300,262,21,15,3,3739,1
7,"Botosani",39872,74,39872,,"VORONA",489,"Scoala Generala  Vorona",730,354,318,36,0,345,9,800,446,146,199,3,3743,0
7,"Botosani",39872,74,39872,,"VORONA",490,"Grup Scolar   ""Stefan cel Mare si Sfant"" Vorona",898,349,345,4,0,339,10,1012,663,112,227,3,3743,0
7,"Botosani",39872,74,39872,,"VORONA",491,"Scoala Generala  Chiscovata",737,325,316,9,0,324,1,800,475,119,205,3,3743,0
7,"Botosani",39872,74,39872,,"VORONA",492,"Scoala Generala Vorona Mare",924,415,405,10,0,410,5,1000,585,135,275,3,3743,0
7,"Botosani",39872,74,39872,,"VORONA",493,"Scoala Generala Joldesti",1008,469,456,13,0,459,10,1095,626,159,300,3,3743,0
7,"Botosani",39872,74,39872,,"VORONA",494,"Scoala Generala nr.2 Icuseni",243,135,126,9,0,135,0,300,165,47,88,3,3743,0
7,"Botosani",39872,74,39872,,"VORONA",495,"Scoala Generala nr. 3 Icuseni",790,356,347,9,0,346,10,900,544,108,238,3,3743,0
7,"Botosani",39872,74,39872,,"VORONA",496,"Scoala Generala Poiana",1029,473,458,15,0,466,7,1100,627,149,317,3,3743,0
7,"Botosani",39872,74,39872,,"VORONA",497,"Grup Scolar   ""Stefan cel Mare si Sfant"" Vorona",0,85,0,85,0,84,1,401,316,24,60,3,3743,1
8,"Brasov",40198,83,40198,,"MUNICIPIUL BRASOV",1,"Str. Egalitatii nr. 27",1360,813,803,7,3,798,15,1485,672,425,373,1,3751,0
8,"Brasov",40198,83,40198,,"MUNICIPIUL BRASOV",2,"Str. Egalitatii nr. 27",1381,815,808,7,0,796,19,1500,685,470,326,1,3751,0
8,"Brasov",40198,83,40198,,"MUNICIPIUL BRASOV",3,"Str. Constantin Brancoveanu nr. 33",1250,714,704,8,2,702,12,1400,686,363,339,1,3751,0
8,"Brasov",40198,83,40198,,"MUNICIPIUL BRASOV",4,"Str. Constantin Brancoveanu nr. 33",1180,641,630,11,0,632,9,1300,659,317,315,1,3751,0
8,"Brasov",40198,83,40198,,"MUNICIPIUL BRASOV",5,"Str. Prundului nr. 45",1584,961,947,14,0,944,17,1700,739,477,467,1,3751,0
8,"Brasov",40198,83,40198,,"MUNICIPIUL BRASOV",6,"Str. Prundului nr. 45",1524,789,777,11,1,775,14,1700,911,381,394,1,3751,0
8,"Brasov",40198,83,40198,,"MUNICIPIUL BRASOV",7,"Str. Castelului nr. 2",1541,798,789,9,0,778,20,1700,902,409,369,1,3751,0
8,"Brasov",40198,83,40198,,"MUNICIPIUL BRASOV",8,"Str. Castelului nr. 2",1774,863,848,15,0,854,9,1900,1037,451,403,1,3751,0
8,"Brasov",40198,83,40198,,"MUNICIPIUL BRASOV",9,"Str. Dupa Ziduri nr. 3",1257,660,650,8,2,646,14,1394,734,345,301,1,3751,0
8,"Brasov",40198,83,40198,,"MUNICIPIUL BRASOV",10,"Str. Dupa Ziduri nr. 3",1247,722,709,9,4,707,15,1403,681,338,369,1,3751,0
8,"Brasov",40198,83,40198,,"MUNICIPIUL BRASOV",11,"B-dul Eroilor nr. 7, corp A",1214,667,650,17,0,659,8,1300,633,318,341,1,3751,0
8,"Brasov",40198,83,40198,,"MUNICIPIUL BRASOV",12,"B-dul Eroilor nr. 7, corp A",1120,621,605,16,0,607,14,1209,588,290,317,1,3751,0
8,"Brasov",40198,83,40198,,"MUNICIPIUL BRASOV",13,"Str. Paltinis nr. 6, corp B",1095,734,672,26,36,716,18,1190,456,401,315,1,3751,0
8,"Brasov",40198,83,40198,,"MUNICIPIUL BRASOV",14,"Str. Paltinis nr. 6, corp B",1195,659,649,10,0,643,16,1300,641,340,303,1,3751,0
8,"Brasov",40198,83,40198,,"MUNICIPIUL BRASOV",15,"Str.Verii nr. 1, corp A",1298,795,785,10,0,779,16,1400,605,396,383,1,3751,0
8,"Brasov",40198,83,40198,,"MUNICIPIUL BRASOV",16,"Str.Verii nr. 1, corp A",1650,914,905,9,0,892,22,1800,886,429,463,1,3751,0
8,"Brasov",40198,83,40198,,"MUNICIPIUL BRASOV",17,"Str.Verii nr. 1, corp A",1038,565,555,10,0,552,13,1100,535,275,277,1,3751,0
8,"Brasov",40198,83,40198,,"MUNICIPIUL BRASOV",18,"Str. Dr. Cantacuzino nr. 3 acces Str.Toma Ionescu",1918,1102,1092,9,1,1090,12,2100,998,465,625,1,3751,0
8,"Brasov",40198,83,40198,,"MUNICIPIUL BRASOV",19,"Str. Dr. Cantacuzino nr. 3 acces Str.Toma Ionescu",1935,1044,1026,17,1,1028,16,2100,1056,544,484,1,3751,0
8,"Brasov",40198,83,40198,,"MUNICIPIUL BRASOV",20,"Str. Plevnei nr. 2, corp B",1273,700,689,9,2,690,10,1395,695,368,322,1,3751,0
8,"Brasov",40198,83,40198,,"MUNICIPIUL BRASOV",21,"Str. Mihai Viteazul nr. 100, corp A",1458,825,808,17,0,809,16,1600,775,402,407,1,3751,0
8,"Brasov",40198,83,40198,,"MUNICIPIUL BRASOV",22,"Str. Mihai Viteazul nr. 100, corp A",1618,952,939,12,1,934,18,1800,848,449,485,1,3751,0
8,"Brasov",40198,83,40198,,"MUNICIPIUL BRASOV",23,"Str. Colonel Buzoianu, nr. 1-3",1181,703,688,13,2,690,13,1300,597,320,370,1,3751,0
8,"Brasov",40198,83,40198,,"MUNICIPIUL BRASOV",24,"Str. De Mijloc nr. 41, corp A",1925,1075,1062,13,0,1053,22,2100,1025,519,534,1,3751,0
8,"Brasov",40198,83,40198,,"MUNICIPIUL BRASOV",25,"Str. De Mijloc nr. 41, corp A",1549,841,825,16,0,828,13,1700,859,454,374,1,3751,0
8,"Brasov",40198,83,40198,,"MUNICIPIUL BRASOV",26,"Str. Avram Iancu  nr. 114",1442,849,836,11,2,829,20,1601,752,461,368,1,3751,0
8,"Brasov",40198,83,40198,,"MUNICIPIUL BRASOV",27,"Str. Memorandului nr. 39",1331,809,792,16,1,799,10,1501,692,415,384,1,3751,0
8,"Brasov",40198,83,40198,,"MUNICIPIUL BRASOV",28,"Str. Lunga nr. 198",1119,599,586,12,1,591,8,1215,616,317,274,1,3751,0
8,"Brasov",40198,83,40198,,"MUNICIPIUL BRASOV",29,"Str. Lunga nr. 198",1028,523,515,8,0,512,11,1100,577,294,218,1,3751,0
8,"Brasov",40198,83,40198,,"MUNICIPIUL BRASOV",30,"Str. Mica nr. 10",1180,594,583,11,0,585,9,1300,706,339,246,1,3751,0
8,"Brasov",40198,83,40198,,"MUNICIPIUL BRASOV",31,"Str. Carierii nr. 20",1688,862,847,15,0,848,14,1800,938,550,298,1,3751,0
8,"Brasov",40198,83,40198,,"MUNICIPIUL BRASOV",32,"Str. Agricultorilor nr. 3",1787,882,871,11,0,873,9,1900,1018,484,389,1,3751,0
8,"Brasov",40198,83,40198,,"MUNICIPIUL BRASOV",33,"Str. Agricultorilor nr. 3",1443,685,670,15,0,675,10,1600,915,465,210,1,3751,0
8,"Brasov",40198,83,40198,,"MUNICIPIUL BRASOV",34,"Str. Agricultorilor nr. 3",1338,621,607,14,0,613,8,1500,879,414,199,1,3751,0
8,"Brasov",40198,83,40198,,"MUNICIPIUL BRASOV",35,"Str. Agricultorilor nr. 3",1486,743,731,11,1,736,7,1600,857,508,228,1,3751,0
8,"Brasov",40198,83,40198,,"MUNICIPIUL BRASOV",36,"Str. Agricultorilor nr. 3",1295,663,654,9,0,656,7,1400,737,438,218,1,3751,0
8,"Brasov",40198,83,40198,,"MUNICIPIUL BRASOV",37,"Str. Agricultorilor nr. 3",1410,705,696,8,1,698,7,1600,895,421,277,1,3751,0
8,"Brasov",40198,83,40198,,"MUNICIPIUL BRASOV",38,"Str. Agricultorilor nr. 3",1413,705,696,9,0,700,5,1600,895,428,272,1,3751,0
8,"Brasov",40198,83,40198,,"MUNICIPIUL BRASOV",39,"Str. Agricultorilor nr. 3",1508,746,740,6,0,731,15,1700,954,484,247,1,3751,0
8,"Brasov",40198,83,40198,,"MUNICIPIUL BRASOV",40,"Str. Agricultorilor nr. 3",1442,684,675,9,0,677,7,1600,916,426,251,1,3751,0
8,"Brasov",40198,83,40198,,"MUNICIPIUL BRASOV",41,"Str. Scolii nr. 11",1239,705,691,12,2,694,11,1402,697,394,300,1,3751,0
8,"Brasov",40198,83,40198,,"MUNICIPIUL BRASOV",42,"Str. Fagurului nr. 1",1251,797,779,18,0,787,10,1400,603,500,287,1,3751,0
8,"Brasov",40198,83,40198,,"MUNICIPIUL BRASOV",43,"Str. Fagurului nr. 1",1147,672,666,6,0,666,6,1300,628,419,247,1,3751,0
8,"Brasov",40198,83,40198,,"MUNICIPIUL BRASOV",44,"Str. Tudor Vladimirescu nr. 33",1951,1103,1094,9,0,1085,18,2100,997,540,545,1,3751,0
8,"Brasov",40198,83,40198,,"MUNICIPIUL BRASOV",45,"Str. Iuliu Maniu nr. 52",1977,1119,1105,14,0,1104,15,2100,981,557,547,1,3751,0
8,"Brasov",40198,83,40198,,"MUNICIPIUL BRASOV",46,"Str. Armoniei nr. 6",1404,760,750,10,0,744,16,1500,740,401,343,1,3751,0
8,"Brasov",40198,83,40198,,"MUNICIPIUL BRASOV",47,"Str. Armoniei nr. 6",1986,1155,1144,10,1,1135,20,2100,945,549,586,1,3751,0
8,"Brasov",40198,83,40198,,"MUNICIPIUL BRASOV",48,"Str. Armoniei nr. 6",1613,961,954,7,0,939,22,1800,839,449,490,1,3751,0
8,"Brasov",40198,83,40198,,"MUNICIPIUL BRASOV",49,"Str. Armoniei nr. 6",1433,841,832,9,0,824,17,1600,759,397,427,1,3751,0
8,"Brasov",40198,83,40198,,"MUNICIPIUL BRASOV",50,"B-dul Grivitei nr. 55",1666,1006,992,13,1,986,20,1792,786,514,472,1,3751,0
8,"Brasov",40198,83,40198,,"MUNICIPIUL BRASOV",51,"Str. Aurel Vlaicu nr. 26 bis",1609,896,885,11,0,868,28,1800,904,402,466,1,3751,0
8,"Brasov",40198,83,40198,,"MUNICIPIUL BRASOV",52,"Str. Aurel Vlaicu nr. 26 bis",1426,769,762,7,0,755,14,1600,831,437,318,1,3751,0
8,"Brasov",40198,83,40198,,"MUNICIPIUL BRASOV",53,"Str. Aurel Vlaicu nr. 26 bis",1319,702,693,9,0,694,8,1515,813,396,298,1,3751,0
8,"Brasov",40198,83,40198,,"MUNICIPIUL BRASOV",54,"Str. 1 Decembrie 1918 nr. 4",1273,750,739,11,0,739,11,1400,650,396,343,1,3751,0
8,"Brasov",40198,83,40198,,"MUNICIPIUL BRASOV",55,"Str. 1 Decembrie 1918 nr. 4",1599,942,921,20,1,933,9,1800,858,525,408,1,3751,0
8,"Brasov",40198,83,40198,,"MUNICIPIUL BRASOV",56,"Str. 1 Decembrie 1918 nr. 4",1686,959,948,10,1,945,14,1800,841,524,421,1,3751,0
8,"Brasov",40198,83,40198,,"MUNICIPIUL BRASOV",57,"Str. 1 Decembrie 1918 nr. 4",1345,734,728,5,1,725,9,1500,766,354,371,1,3751,0
8,"Brasov",40198,83,40198,,"MUNICIPIUL BRASOV",58,"Str. Oltet nr. 12",1364,1009,994,15,0,989,20,2000,991,484,505,1,3751,0
8,"Brasov",40198,83,40198,,"MUNICIPIUL BRASOV",59,"Str. Oltet nr. 12",1757,1031,1016,14,1,1012,19,1900,869,473,539,1,3751,0
8,"Brasov",40198,83,40198,,"MUNICIPIUL BRASOV",60,"Str. Oltet nr. 12",1729,982,975,7,0,964,18,1900,918,509,455,1,3751,0
8,"Brasov",40198,83,40198,,"MUNICIPIUL BRASOV",61,"Str. Oltet nr. 12",1946,1062,1056,6,0,1046,16,2100,1038,521,525,1,3751,0
8,"Brasov",40198,83,40198,,"MUNICIPIUL BRASOV",62,"Str. 13 Decembrie nr. 125",1613,730,717,13,0,725,5,1804,1074,429,296,1,3751,0
8,"Brasov",40198,83,40198,,"MUNICIPIUL BRASOV",63,"Str. 13 Decembrie nr. 125",1669,868,854,14,0,855,13,1819,951,462,393,1,3751,0
8,"Brasov",40198,83,40198,,"MUNICIPIUL BRASOV",64,"Str. 13 Decembrie nr. 125",1579,852,841,11,0,832,20,1700,848,495,337,1,3751,0
8,"Brasov",40198,83,40198,,"MUNICIPIUL BRASOV",65,"Str. 13 Decembrie nr. 125",1651,825,818,6,1,815,10,1801,976,438,377,1,3751,0
8,"Brasov",40198,83,40198,,"MUNICIPIUL BRASOV",66,"Str. 13 Decembrie nr. 125",1730,907,896,10,1,890,17,1900,993,501,389,1,3751,0
8,"Brasov",40198,83,40198,,"MUNICIPIUL BRASOV",67,"Str. 13 Decembrie nr. 125",1580,745,737,8,0,732,13,1700,955,444,288,1,3751,0
8,"Brasov",40198,83,40198,,"MUNICIPIUL BRASOV",68,"Str. 13 Decembrie nr. 131",567,344,332,12,0,341,3,600,256,246,95,1,3751,0
8,"Brasov",40198,83,40198,,"MUNICIPIUL BRASOV",69,"Str. Bihorului nr. 3",1768,1090,1079,10,1,1071,19,1900,810,506,565,1,3751,0
8,"Brasov",40198,83,40198,,"MUNICIPIUL BRASOV",70,"Str. Bihorului nr. 3",1827,1059,1035,21,3,1040,19,2000,941,493,547,1,3751,0
8,"Brasov",40198,83,40198,,"MUNICIPIUL BRASOV",71,"Aleea Lacramioarelor nr. 2",1272,818,810,7,1,794,24,1400,582,368,426,1,3751,0
8,"Brasov",40198,83,40198,,"MUNICIPIUL BRASOV",72,"Aleea Lacramioarelor nr. 2",1445,890,883,7,0,874,16,1600,710,398,476,1,3751,0
8,"Brasov",40198,83,40198,,"MUNICIPIUL BRASOV",73,"Aleea Lacramioarelor nr. 2",1729,1017,1005,12,0,1000,17,1900,883,472,528,1,3751,0
8,"Brasov",40198,83,40198,,"MUNICIPIUL BRASOV",74,"B-dul Garii nr. 21",1452,906,896,10,0,890,16,1599,693,455,435,1,3751,0
8,"Brasov",40198,83,40198,,"MUNICIPIUL BRASOV",75,"B-dul Garii nr. 21",1335,816,803,13,0,799,17,1500,684,360,439,1,3751,0
8,"Brasov",40198,83,40198,,"MUNICIPIUL BRASOV",76,"Fundatura Harmanului nr. 12",1997,1032,1014,18,0,1016,16,2200,1168,560,456,1,3751,0
8,"Brasov",40198,83,40198,,"MUNICIPIUL BRASOV",77,"Fundatura Harmanului nr. 12",1604,823,809,14,0,816,7,1801,978,450,366,1,3751,0
8,"Brasov",40198,83,40198,,"MUNICIPIUL BRASOV",78,"Str. Simeria nr. 5",1501,813,806,7,0,804,9,1698,885,445,359,1,3751,0
8,"Brasov",40198,83,40198,,"MUNICIPIUL BRASOV",79,"Str. Simeria nr. 5",1518,814,804,10,0,804,10,1700,886,413,391,1,3751,0
8,"Brasov",40198,83,40198,,"MUNICIPIUL BRASOV",80,"Str. Simeria nr. 5",1320,658,649,9,0,651,7,1493,835,354,297,1,3751,0
8,"Brasov",40198,83,40198,,"MUNICIPIUL BRASOV",81,"Str. Prof. Bogdan Alexandru nr. 4",1886,1037,1025,12,0,1022,15,2000,963,574,448,1,3751,0
8,"Brasov",40198,83,40198,,"MUNICIPIUL BRASOV",82,"Str. Prof. Bogdan Alexandru nr. 4",1723,918,911,6,1,908,10,1900,982,529,379,1,3751,0
8,"Brasov",40198,83,40198,,"MUNICIPIUL BRASOV",83,"Str. Prof. Bogdan Alexandru nr. 4",1923,1039,1033,6,0,1020,19,2100,1061,561,459,1,3751,0
8,"Brasov",40198,83,40198,,"MUNICIPIUL BRASOV",84,"Str. Prof. Bogdan Alexandru nr. 4",1751,989,986,3,0,967,22,1900,911,575,392,1,3751,0
8,"Brasov",40198,83,40198,,"MUNICIPIUL BRASOV",85,"Str. Busuiocului nr. 1, corp A",1258,746,737,9,0,730,16,1400,654,367,363,1,3751,0
8,"Brasov",40198,83,40198,,"MUNICIPIUL BRASOV",86,"Str. Busuiocului nr. 1, corp A",1639,869,859,10,0,858,11,1800,931,453,405,1,3751,0
8,"Brasov",40198,83,40198,,"MUNICIPIUL BRASOV",87,"Str. Busuiocului nr. 1, corp A",1502,788,776,12,0,781,7,1600,812,398,383,1,3751,0
8,"Brasov",40198,83,40198,,"MUNICIPIUL BRASOV",88,"Str. Busuiocului nr. 1, corp A",1486,840,830,10,0,829,11,1600,760,421,408,1,3751,0
8,"Brasov",40198,83,40198,,"MUNICIPIUL BRASOV",89,"Str. Margaritarelor nr. 2",1841,982,972,10,0,966,16,2000,1018,484,482,1,3751,0
8,"Brasov",40198,83,40198,,"MUNICIPIUL BRASOV",90,"Str. Margaritarelor nr. 2",1807,996,991,5,0,983,13,2000,1004,494,489,1,3751,0
8,"Brasov",40198,83,40198,,"MUNICIPIUL BRASOV",91,"Str. Margaritarelor nr. 2",1919,1100,1086,14,0,1091,9,2100,1000,503,588,1,3751,0
8,"Brasov",40198,83,40198,,"MUNICIPIUL BRASOV",92,"Str. Margaritarelor nr. 2",1874,1095,1086,9,0,1078,17,2000,905,547,531,1,3751,0
8,"Brasov",40198,83,40198,,"MUNICIPIUL BRASOV",93,"Str. Margaritarelor nr. 2",1768,1018,1009,8,1,1005,13,1900,882,447,558,1,3751,0
8,"Brasov",40198,83,40198,,"MUNICIPIUL BRASOV",94,"Aleea Mimozei nr. 2",1209,663,652,11,0,650,13,1300,637,335,315,1,3751,0
8,"Brasov",40198,83,40198,,"MUNICIPIUL BRASOV",95,"Aleea Mimozei nr. 2",1039,443,436,6,1,435,8,1100,657,257,178,1,3751,0
8,"Brasov",40198,83,40198,,"MUNICIPIUL BRASOV",96,"Aleea Mimozei nr. 2",1600,757,746,10,1,750,7,1700,943,390,360,1,3751,0
8,"Brasov",40198,83,40198,,"MUNICIPIUL BRASOV",97,"Aleea Mimozei nr. 2",1489,734,727,7,0,727,7,1600,866,403,324,1,3751,0
8,"Brasov",40198,83,40198,,"MUNICIPIUL BRASOV",98,"Str. Stefan cel Mare nr. 11",1483,844,834,10,0,827,17,1600,756,421,406,1,3751,0
8,"Brasov",40198,83,40198,,"MUNICIPIUL BRASOV",99,"Str. Stefan cel Mare nr. 11",1586,929,919,10,0,908,19,1701,774,471,437,1,3751,0
8,"Brasov",40198,83,40198,,"MUNICIPIUL BRASOV",100,"Str. Lunii nr. 6",1466,790,779,10,1,776,14,1593,803,402,374,1,3751,0
8,"Brasov",40198,83,40198,,"MUNICIPIUL BRASOV",101,"Str. Lunii nr. 6",1468,778,764,14,0,765,13,1599,821,411,354,1,3751,0
8,"Brasov",40198,83,40198,,"MUNICIPIUL BRASOV",102,"Str. Zizinului nr. 71",1321,785,770,14,1,771,14,1496,711,364,407,1,3751,0
8,"Brasov",40198,83,40198,,"MUNICIPIUL BRASOV",103,"Str. Zizinului nr. 144",1109,567,556,11,0,554,13,1200,633,370,184,1,3751,0
8,"Brasov",40198,83,40198,,"MUNICIPIUL BRASOV",104,"Str. Zizinului nr. 144",1107,545,539,6,0,537,8,1200,655,364,173,1,3751,0
8,"Brasov",40198,83,40198,,"MUNICIPIUL BRASOV",105,"Str. Zizinului nr. 144",1187,558,547,11,0,550,8,1302,744,367,183,1,3751,0
8,"Brasov",40198,83,40198,,"MUNICIPIUL BRASOV",106,"Str. Zizinului nr. 144",1170,577,566,11,0,571,6,1300,723,321,250,1,3751,0
8,"Brasov",40198,83,40198,,"MUNICIPIUL BRASOV",107,"Str. Neptun nr. 1",1245,603,592,11,0,594,9,1400,797,344,250,1,3751,0
8,"Brasov",40198,83,40198,,"MUNICIPIUL BRASOV",108,"Str. Neptun nr. 1",1114,586,573,13,0,581,5,1196,610,329,252,1,3751,0
8,"Brasov",40198,83,40198,,"MUNICIPIUL BRASOV",109,"Str. Neptun nr. 1",1548,863,852,11,0,847,16,1701,838,419,428,1,3751,0
8,"Brasov",40198,83,40198,,"MUNICIPIUL BRASOV",110,"Str. Venus nr. 1",1375,731,719,12,0,722,9,1500,769,364,358,1,3751,0
8,"Brasov",40198,83,40198,,"MUNICIPIUL BRASOV",111,"Str. Venus nr. 1",1950,1067,1059,8,0,1048,19,2100,1033,533,515,1,3751,0
8,"Brasov",40198,83,40198,,"MUNICIPIUL BRASOV",112,"Str. Venus nr. 1",1924,1112,1101,10,1,1097,15,2100,988,560,537,1,3751,0
8,"Brasov",40198,83,40198,,"MUNICIPIUL BRASOV",113,"Str. Venus nr. 1",1292,717,706,11,0,707,10,1401,684,347,360,1,3751,0
8,"Brasov",40198,83,40198,,"MUNICIPIUL BRASOV",114,"Str. Aleea Minerva nr. 11",1669,936,919,13,4,919,17,1800,862,474,445,1,3751,0
8,"Brasov",40198,83,40198,,"MUNICIPIUL BRASOV",115,"Str. Aleea Minerva nr. 11",1978,1098,1087,11,0,1081,17,2200,1102,536,545,1,3751,0
8,"Brasov",40198,83,40198,,"MUNICIPIUL BRASOV",116,"Str. Aleea Minerva nr. 11",1665,921,909,12,0,905,16,1800,879,397,508,1,3751,0
8,"Brasov",40198,83,40198,,"MUNICIPIUL BRASOV",117,"Bulevardul Stefan cel Mare si Sfant nr. 15",1429,788,777,11,0,775,13,1600,812,345,430,1,3751,0
8,"Brasov",40198,83,40198,,"MUNICIPIUL BRASOV",118,"Bulevardul Stefan cel Mare si Sfant nr. 15",1625,963,948,14,1,943,20,1800,837,427,516,1,3751,0
8,"Brasov",40198,83,40198,,"MUNICIPIUL BRASOV",119,"Bulevardul Stefan cel Mare si Sfant nr. 15",1626,955,944,11,0,936,19,1800,845,458,478,1,3751,0
8,"Brasov",40198,83,40198,,"MUNICIPIUL BRASOV",120,"Bulevardul Stefan cel Mare si Sfant nr. 15",1742,923,915,8,0,902,21,1900,977,464,438,1,3751,0
8,"Brasov",40198,83,40198,,"MUNICIPIUL BRASOV",121,"Bulevardul Stefan cel Mare si Sfant nr. 15",1934,1120,1074,43,3,1105,15,2100,980,531,574,1,3751,0
8,"Brasov",40198,83,40198,,"MUNICIPIUL BRASOV",122,"Bulevardul Stefan cel Mare si Sfant nr. 15",1863,962,947,15,0,945,17,2000,1038,470,475,1,3751,0
8,"Brasov",40198,83,40198,,"MUNICIPIUL BRASOV",123,"Str. Traian nr. 4",1386,738,729,9,0,726,12,1503,765,391,335,1,3751,0
8,"Brasov",40198,83,40198,,"MUNICIPIUL BRASOV",124,"Str. Traian nr. 4",1458,803,792,11,0,783,20,1600,797,391,392,1,3751,0
8,"Brasov",40198,83,40198,,"MUNICIPIUL BRASOV",125,"Str. Traian nr. 4",1382,808,798,10,0,800,8,1498,690,396,404,1,3751,0
8,"Brasov",40198,83,40198,,"MUNICIPIUL BRASOV",126,"Calea Bucuresti nr. 75, corp A",1619,811,799,12,0,798,13,1800,989,480,318,1,3751,0
8,"Brasov",40198,83,40198,,"MUNICIPIUL BRASOV",127,"Calea Bucuresti nr. 75, corp A",1972,1029,1014,15,0,1015,14,2000,971,541,474,1,3751,0
8,"Brasov",40198,83,40198,,"MUNICIPIUL BRASOV",128,"Calea Bucuresti nr. 75, corp A",1921,1126,1116,10,0,1098,28,2100,974,562,536,1,3751,0
8,"Brasov",40198,83,40198,,"MUNICIPIUL BRASOV",129,"Calea Bucuresti nr. 75, corp A",1983,1037,1025,12,0,1009,28,2200,1163,525,484,1,3751,0
8,"Brasov",40198,83,40198,,"MUNICIPIUL BRASOV",130,"Calea Bucuresti nr. 75, corp A",1527,838,828,10,0,823,15,1700,862,380,443,1,3751,0
8,"Brasov",40198,83,40198,,"MUNICIPIUL BRASOV",131,"Str. Cocorului nr. 10",1735,1042,1030,10,2,1015,27,1900,858,535,480,1,3751,0
8,"Brasov",40198,83,40198,,"MUNICIPIUL BRASOV",132,"Str. Cocorului nr. 10",2018,1055,1043,12,0,1029,26,2183,1128,542,487,1,3751,0
8,"Brasov",40198,83,40198,,"MUNICIPIUL BRASOV",133,"Str. Cocorului nr. 10",1866,968,960,8,0,955,13,2000,1032,505,450,1,3751,0
8,"Brasov",40198,83,40198,,"MUNICIPIUL BRASOV",134,"Str. Cocorului nr. 10",1913,1030,1020,10,0,1018,12,2100,1070,517,501,1,3751,0
8,"Brasov",40198,83,40198,,"MUNICIPIUL BRASOV",135,"Str. Barbu Lautaru nr. 10",1656,925,909,16,0,917,8,1798,873,488,429,1,3751,0
8,"Brasov",40198,83,40198,,"MUNICIPIUL BRASOV",136,"Str. Barbu Lautaru nr. 10",1544,824,819,5,0,802,22,1700,876,451,351,1,3751,0
8,"Brasov",40198,83,40198,,"MUNICIPIUL BRASOV",137,"Str. Barbu Lautaru nr. 10",1554,881,868,13,0,865,16,1698,817,488,377,1,3751,0
8,"Brasov",40198,83,40198,,"MUNICIPIUL BRASOV",138,"Str. Barbu Lautaru nr. 10",1905,1001,992,9,0,982,19,2100,1099,557,425,1,3751,0
8,"Brasov",40198,83,40198,,"MUNICIPIUL BRASOV",139,"Str. Barbu Lautaru nr. 10",1760,847,834,13,0,834,13,1900,1053,429,405,1,3751,0
8,"Brasov",40198,83,40198,,"MUNICIPIUL BRASOV",140,"Str. Barbu Lautaru nr. 8",1881,1000,984,16,0,995,5,2000,1000,532,463,1,3751,0
8,"Brasov",40198,83,40198,,"MUNICIPIUL BRASOV",141,"Str. Barbu Lautaru nr. 8",2014,1120,1112,8,0,1107,13,2200,1080,581,526,1,3751,0
8,"Brasov",40198,83,40198,,"MUNICIPIUL BRASOV",142,"Str. Poienelor  nr. 5",1077,544,535,8,1,537,7,1196,652,314,223,1,3751,0
8,"Brasov",40198,83,40198,,"MUNICIPIUL BRASOV",143,"Str. Poienelor  nr. 5",1365,694,686,8,0,673,21,1500,806,360,313,1,3751,0
8,"Brasov",40198,83,40198,,"MUNICIPIUL BRASOV",144,"Str. Valea Cetatii  nr. 24",1738,884,875,9,0,876,8,1900,1016,472,404,1,3751,0
8,"Brasov",40198,83,40198,,"MUNICIPIUL BRASOV",145,"Str. Valea Cetatii  nr. 24",1617,864,853,11,0,855,9,1800,936,448,407,1,3751,0
8,"Brasov",40198,83,40198,,"MUNICIPIUL BRASOV",146,"Str. Valea Cetatii  nr. 24",1916,986,978,8,0,961,25,2100,1114,516,445,1,3751,0
8,"Brasov",40198,83,40198,,"MUNICIPIUL BRASOV",147,"Bulevardul Valea Cetatii nr. 8",1426,769,757,11,1,757,12,1600,831,389,368,1,3751,0
8,"Brasov",40198,83,40198,,"MUNICIPIUL BRASOV",148,"Bulevardul Valea Cetatii nr. 8",1510,799,785,14,0,786,13,1599,800,450,336,1,3751,0
8,"Brasov",40198,83,40198,,"MUNICIPIUL BRASOV",149,"Bulevardul Valea Cetatii nr. 8",1532,836,824,12,0,826,10,1700,864,449,377,1,3751,0
8,"Brasov",40198,83,40198,,"MUNICIPIUL BRASOV",150,"Bulevardul Valea Cetatii nr. 8",1739,972,961,11,0,954,18,1900,928,486,468,1,3751,0
8,"Brasov",40198,83,40198,,"MUNICIPIUL BRASOV",151,"Str. Jepilor nr. 1",1788,1017,1003,14,0,1002,15,1900,883,571,431,1,3751,0
8,"Brasov",40198,83,40198,,"MUNICIPIUL BRASOV",152,"Str. Jepilor nr. 1",1894,1043,1033,10,0,1024,19,2000,957,551,473,1,3751,0
8,"Brasov",40198,83,40198,,"MUNICIPIUL BRASOV",153,"Str. Jepilor nr. 1",1910,1043,1035,8,0,1025,18,2101,1058,567,458,1,3751,0
8,"Brasov",40198,83,40198,,"MUNICIPIUL BRASOV",154,"Str. Jepilor nr. 1",1863,1033,1024,9,0,1018,15,2001,968,546,472,1,3751,0
8,"Brasov",40198,83,40198,,"MUNICIPIUL BRASOV",155,"Str. Brazilor nr. 18",1496,698,689,9,0,693,5,1600,902,411,282,1,3751,0
8,"Brasov",40198,83,40198,,"MUNICIPIUL BRASOV",156,"Str. Brazilor nr. 18",1489,700,693,7,0,688,12,1600,900,443,245,1,3751,0
8,"Brasov",40198,83,40198,,"MUNICIPIUL BRASOV",157,"Str. Brazilor nr. 18",1868,1011,1000,11,0,998,13,2000,989,593,405,1,3751,0
8,"Brasov",40198,83,40198,,"MUNICIPIUL BRASOV",158,"Str. Prunului nr. 1",1921,904,894,10,0,885,19,2100,1196,523,362,1,3751,0
8,"Brasov",40198,83,40198,,"MUNICIPIUL BRASOV",159,"Str. Prunului nr. 1",1216,631,622,9,0,625,6,1300,669,339,286,1,3751,0
8,"Brasov",40198,83,40198,,"MUNICIPIUL BRASOV",160,"Str. Prunului nr. 1",1266,651,645,6,0,642,9,1399,748,375,267,1,3751,0
8,"Brasov",40198,83,40198,,"MUNICIPIUL BRASOV",161,"Str. Prunului nr. 1",1691,745,730,15,0,736,9,1800,1055,440,296,1,3751,0
8,"Brasov",40198,83,40198,,"MUNICIPIUL BRASOV",162,"Str. Prunului nr. 1",1941,934,913,21,0,926,8,2100,1166,557,369,1,3751,0
8,"Brasov",40198,83,40198,,"MUNICIPIUL BRASOV",163,"Str. Prunului nr. 1",1683,837,823,14,0,829,8,1800,963,490,339,1,3751,0
8,"Brasov",40198,83,40198,,"MUNICIPIUL BRASOV",164,"Calea Bucuresti nr. 257",1902,1032,1016,16,0,1023,9,2101,1069,551,472,1,3751,0
8,"Brasov",40198,83,40198,,"MUNICIPIUL BRASOV",165,"Poiana Brasov, Vila Orizont",328,173,164,9,0,173,0,400,227,122,51,1,3751,0
8,"Brasov",40198,83,40198,,"MUNICIPIUL BRASOV",166,"Str. Pietii nr. 9",0,177,0,177,0,176,1,197,20,93,83,1,3751,1
8,"Brasov",40198,83,40198,,"MUNICIPIUL BRASOV",167,"Str. Mihai Viteazul nr.9",0,84,0,84,0,81,3,100,16,39,42,1,3751,1
8,"Brasov",40198,83,40198,,"MUNICIPIUL BRASOV",168,"Str. Prundului nr. 7-9",0,77,0,77,0,76,1,200,123,42,34,1,3751,1
8,"Brasov",40198,83,40198,,"MUNICIPIUL BRASOV",169,"Str. Nicopole nr. 45",0,74,0,74,0,72,2,200,126,40,32,1,3751,1
8,"Brasov",40198,83,40198,,"MUNICIPIUL BRASOV",170,"Str. George Baritiu nr.36",0,206,0,206,0,197,9,300,94,114,83,1,3751,1
8,"Brasov",40198,83,40198,,"MUNICIPIUL BRASOV",171,"Calea Bucuresti nr.25-27",0,834,0,834,0,818,16,890,56,491,327,1,3751,1
8,"Brasov",40198,83,40198,,"MUNICIPIUL BRASOV",172,"Calea Bucuresti nr.2",0,198,0,198,0,194,4,302,104,104,90,1,3751,1
8,"Brasov",40198,83,40198,,"MUNICIPIUL BRASOV",173,"Bulevardul 15 Noiembrie nr. 60",0,208,0,208,0,206,2,292,84,88,118,1,3751,1
8,"Brasov",40198,83,40198,,"MUNICIPIUL BRASOV",174,"Str. Alexandru Ioan Cuza nr. 28",0,173,0,173,0,173,0,202,29,69,104,1,3751,1
8,"Brasov",40198,83,40198,,"MUNICIPIUL BRASOV",175,"Str. Oltet nr.2",0,279,0,279,0,274,5,404,125,154,120,1,3751,1
8,"Brasov",40198,83,40198,,"MUNICIPIUL BRASOV",176,"Str. C-tin Brancoveanu nr.4",0,55,0,55,0,55,0,100,45,28,27,1,3751,1
8,"Brasov",40198,83,40198,,"MUNICIPIUL BRASOV",177,"Str. Dealul Spirii nr. 12",0,119,0,119,0,118,1,200,81,67,51,1,3751,1
8,"Brasov",40198,83,40198,,"MUNICIPIUL BRASOV",178,"Str. Avram Iancu nr. 114",0,473,0,473,0,466,7,1000,527,281,185,1,3751,1
8,"Brasov",40198,83,40198,,"MUNICIPIUL BRASOV",179,"Str. Harmanului nr. 47A",0,452,0,452,0,445,7,1005,553,241,204,1,3751,1
8,"Brasov",40198,83,40198,,"MUNICIPIUL BRASOV",180,"B-dul Garii nr. 5",0,1472,0,1472,0,1457,15,1900,428,867,590,1,3751,1
8,"Brasov",40198,83,40198,,"MUNICIPIUL BRASOV",181,"Colina Universitatii nr.1",0,946,0,946,0,933,13,1800,854,607,326,1,3751,1
8,"Brasov",40198,83,40198,,"MUNICIPIUL BRASOV",182,"Str. Memorandumului nr. 39",0,1427,0,1427,0,1394,33,2000,573,913,481,1,3751,1
8,"Brasov",40241,83,40241,,"MUNICIPIUL CODLEA",183,"Str. Chimistilor nr.3",948,414,407,7,0,413,1,1000,586,250,163,1,3754,0
8,"Brasov",40241,83,40241,,"MUNICIPIUL CODLEA",184,"Str. Chimistilor nr.3",1031,513,506,7,0,508,5,1100,587,274,234,1,3754,0
8,"Brasov",40241,83,40241,,"MUNICIPIUL CODLEA",185,"Str. Chimistilor nr.3",1296,604,597,7,0,596,8,1400,796,323,273,1,3754,0
8,"Brasov",40241,83,40241,,"MUNICIPIUL CODLEA",186,"Str. Chimistilor nr.3",1194,601,591,10,0,598,3,1300,699,291,307,1,3754,0
8,"Brasov",40241,83,40241,,"MUNICIPIUL CODLEA",187,"Str. Nuferilor nr.13",1000,909,493,6,410,874,35,1600,691,615,259,1,3754,0
8,"Brasov",40241,83,40241,,"MUNICIPIUL CODLEA",188,"Str. Laterala nr. 1",1236,636,627,9,0,628,8,1400,764,354,274,1,3754,0
8,"Brasov",40241,83,40241,,"MUNICIPIUL CODLEA",189,"Str. Laterala nr. 1",1146,574,566,8,0,568,6,1300,726,338,230,1,3754,0
8,"Brasov",40241,83,40241,,"MUNICIPIUL CODLEA",190,"Str. Magurii nr. 3",1466,831,822,7,2,823,8,1600,769,458,365,1,3754,0
8,"Brasov",40241,83,40241,,"MUNICIPIUL CODLEA",191,"Str. Magurii nr. 6",1460,679,671,8,0,675,4,1600,921,370,305,1,3754,0
8,"Brasov",40241,83,40241,,"MUNICIPIUL CODLEA",192,"Str. 9 Mai nr. 33",1383,591,580,11,0,578,13,1500,909,354,224,1,3754,0
8,"Brasov",40241,83,40241,,"MUNICIPIUL CODLEA",193,"Str. 9 Mai nr. 33",1721,892,881,10,1,872,20,1900,1008,475,397,1,3754,0
8,"Brasov",40241,83,40241,,"MUNICIPIUL CODLEA",194,"Str. Freziei nr. 2",1085,520,515,5,0,515,5,1200,680,294,221,1,3754,0
8,"Brasov",40241,83,40241,,"MUNICIPIUL CODLEA",195,"Str. Freziei nr. 2",1550,740,737,3,0,728,12,1700,960,417,311,1,3754,0
8,"Brasov",40241,83,40241,,"MUNICIPIUL CODLEA",196,"Str. Freziei nr. 2",1124,501,493,7,1,497,4,1200,699,263,234,1,3754,0
8,"Brasov",40241,83,40241,,"MUNICIPIUL CODLEA",197,"Str. Closca nr. 26",1275,641,632,9,0,639,2,1400,759,368,271,1,3754,0
8,"Brasov",40241,83,40241,,"MUNICIPIUL CODLEA",198,"Str. Carpati nr. 23",1157,600,593,7,0,581,19,1300,700,314,267,1,3754,0
8,"Brasov",40241,83,40241,,"MUNICIPIUL CODLEA",199,"Str. Carpati nr. 23",1012,674,657,17,0,643,31,1100,426,487,156,1,3754,0
8,"Brasov",40241,83,40241,,"MUNICIPIUL CODLEA",200,"Str. Nuferilor nr.13",0,272,0,272,0,272,0,600,328,152,120,1,3754,1
8,"Brasov",40278,83,40278,,"MUNICIPIUL FAGARAS",201,"Str. Tudor Vladimirescu nr. 8",765,349,324,25,0,344,5,800,451,195,149,1,3756,0
8,"Brasov",40278,83,40278,,"MUNICIPIUL FAGARAS",202,"Str. Tudor Vladimirescu nr. 8",1297,515,507,8,0,512,3,1400,885,313,199,1,3756,0
8,"Brasov",40278,83,40278,,"MUNICIPIUL FAGARAS",203,"Str. Tudor Vladimirescu nr. 8",1545,641,629,11,1,633,8,1700,1059,348,285,1,3756,0
8,"Brasov",40278,83,40278,,"MUNICIPIUL FAGARAS",204,"Str. Mihai Viteazu nr. 1",1530,728,709,19,0,718,10,1700,972,427,291,1,3756,0
8,"Brasov",40278,83,40278,,"MUNICIPIUL FAGARAS",205,"Str. Mihai Viteazu nr. 1",1547,665,656,9,0,661,4,1700,1035,336,325,1,3756,0
8,"Brasov",40278,83,40278,,"MUNICIPIUL FAGARAS",206,"Str. Gheorghe Doja nr. 48",1174,679,670,9,0,671,8,1300,621,354,317,1,3756,0
8,"Brasov",40278,83,40278,,"MUNICIPIUL FAGARAS",207,"Str. Republicii nr. 6",1097,492,474,17,1,483,9,1200,708,240,243,1,3756,0
8,"Brasov",40278,83,40278,,"MUNICIPIUL FAGARAS",208,"Str. Doamna Stanca nr. 14",1640,764,751,12,1,755,9,1800,1036,394,361,1,3756,0
8,"Brasov",40278,83,40278,,"MUNICIPIUL FAGARAS",209,"Str. Doamna Stanca nr. 14",1526,699,682,17,0,699,0,1700,1001,352,347,1,3756,0
8,"Brasov",40278,83,40278,,"MUNICIPIUL FAGARAS",210,"Str. Scolii nr. 16",1358,620,590,30,0,615,5,1500,880,323,292,1,3756,0
8,"Brasov",40278,83,40278,,"MUNICIPIUL FAGARAS",211,"Str. Scolii nr. 16",1484,757,748,9,0,741,16,1600,843,369,372,1,3756,0
8,"Brasov",40278,83,40278,,"MUNICIPIUL FAGARAS",212,"Str. Scolii nr. 1",1357,551,542,9,0,541,10,1500,949,322,219,1,3756,0
8,"Brasov",40278,83,40278,,"MUNICIPIUL FAGARAS",213,"Str. Scolii nr. 1",1669,690,685,5,0,687,3,1800,1110,385,302,1,3756,0
8,"Brasov",40278,83,40278,,"MUNICIPIUL FAGARAS",214,"Cartier 1 Decembrie 1918",1332,548,533,14,1,543,5,1500,952,310,233,1,3756,0
8,"Brasov",40278,83,40278,,"MUNICIPIUL FAGARAS",215,"Cartier 1 Decembrie 1918",1193,551,534,17,0,547,4,1300,749,276,271,1,3756,0
8,"Brasov",40278,83,40278,,"MUNICIPIUL FAGARAS",216,"Cartier 1 Decembrie 1918",1577,679,671,8,0,675,4,1700,1021,402,273,1,3756,0
8,"Brasov",40278,83,40278,,"MUNICIPIUL FAGARAS",217,"Cartier 1 Decembrie 1918",1257,530,512,18,0,527,3,1400,870,293,234,1,3756,0
8,"Brasov",40278,83,40278,,"MUNICIPIUL FAGARAS",218,"Str. Combinatului nr.3",1442,605,585,20,0,597,8,1601,996,251,346,1,3756,0
8,"Brasov",40278,83,40278,,"MUNICIPIUL FAGARAS",219,"Str. Combinatului nr.3",1181,528,520,8,0,517,11,1300,772,260,257,1,3756,0
8,"Brasov",40278,83,40278,,"MUNICIPIUL FAGARAS",220,"Str. Negoiu  nr. 147",1301,565,557,8,0,561,4,1400,835,346,215,1,3756,0
8,"Brasov",40278,83,40278,,"MUNICIPIUL FAGARAS",221,"SCOALA GENERALA NR. 5, Str. Negoiu",1438,613,587,18,8,606,7,1600,987,286,320,1,3756,0
8,"Brasov",40278,83,40278,,"MUNICIPIUL FAGARAS",222,"SCOALA GENERALA NR. 5, Str. Negoiu",1659,681,667,12,2,677,4,1800,1119,406,271,1,3756,0
8,"Brasov",40278,83,40278,,"MUNICIPIUL FAGARAS",223,"SCOALA GENERALA NR. 5, Str. Negoiu",1201,451,446,5,0,444,7,1300,849,252,192,1,3756,0
8,"Brasov",40278,83,40278,,"MUNICIPIUL FAGARAS",224,"SCOALA GENERALA NR. 5, Str. Negoiu",806,413,384,29,0,412,1,900,487,231,181,1,3756,0
8,"Brasov",40278,83,40278,,"MUNICIPIUL FAGARAS",225,"Str. Nicoale Balcescu nr.20",1131,521,509,12,0,517,4,1200,679,262,255,1,3756,0
8,"Brasov",40278,83,40278,,"MUNICIPIUL FAGARAS",226,"SCOALA GENERALA NR.2, Str. Vasile Alecsandri",1251,664,652,10,2,663,1,1400,736,316,347,1,3756,0
8,"Brasov",40278,83,40278,,"MUNICIPIUL FAGARAS",227,"Str. Negoiu  nr. 147",0,454,0,454,0,453,1,705,251,271,182,1,3756,1
8,"Brasov",40438,83,40438,,"MUNICIPIUL SACELE",228,"B-dul Brasovului nr. 227",1562,930,910,18,2,918,12,1700,770,533,385,1,3758,0
8,"Brasov",40438,83,40438,,"MUNICIPIUL SACELE",229,"B-dul Brasovului nr. 250, corp 2",1564,852,831,21,0,840,12,1700,848,526,314,1,3758,0
8,"Brasov",40438,83,40438,,"MUNICIPIUL SACELE",230,"Str. Barbu Lautaru nr. 37",1678,887,875,12,0,875,12,1800,913,539,336,1,3758,0
8,"Brasov",40438,83,40438,,"MUNICIPIUL SACELE",231,"B-dul Brasovului nr. 107",1486,782,766,16,0,771,11,1600,818,493,278,1,3758,0
8,"Brasov",40438,83,40438,,"MUNICIPIUL SACELE",232,"Piata Libertatii nr. 24",1658,936,924,12,0,914,22,1800,864,567,347,1,3758,0
8,"Brasov",40438,83,40438,,"MUNICIPIUL SACELE",233,"Piata Libertatii nr. 24",1543,815,807,6,2,801,14,1700,885,536,265,1,3758,0
8,"Brasov",40438,83,40438,,"MUNICIPIUL SACELE",234,"B-dul George Moroianu nr. 17",1606,897,892,5,0,887,10,1700,803,531,356,1,3758,0
8,"Brasov",40438,83,40438,,"MUNICIPIUL SACELE",235,"B-dul George Moroianu nr. 17",1356,700,693,7,0,688,12,1500,800,369,319,1,3758,0
8,"Brasov",40438,83,40438,,"MUNICIPIUL SACELE",236,"B-dul George Moroianu nr. 110",1665,944,932,12,0,922,22,1800,856,616,306,1,3758,0
8,"Brasov",40438,83,40438,,"MUNICIPIUL SACELE",237,"B-dul George Moroianu nr. 291",1657,1003,993,8,2,988,15,1712,709,611,377,1,3758,0
8,"Brasov",40438,83,40438,,"MUNICIPIUL SACELE",238,"Aleea Episcop Popeea nr.20",1351,704,692,8,4,692,12,1500,796,388,304,1,3758,0
8,"Brasov",40438,83,40438,,"MUNICIPIUL SACELE",239,"Aleea Episcop Popeea nr.20",981,525,514,11,0,521,4,1101,576,302,219,1,3758,0
8,"Brasov",40438,83,40438,,"MUNICIPIUL SACELE",240,"Str. Viitorului nr. 4A",1578,869,861,8,0,859,10,1700,831,478,381,1,3758,0
8,"Brasov",40438,83,40438,,"MUNICIPIUL SACELE",241,"Str. Viitorului nr. 4A",1451,814,805,9,0,801,13,1600,786,462,339,1,3758,0
8,"Brasov",40438,83,40438,,"MUNICIPIUL SACELE",242,"Str. Viitorului nr. 4A",1265,750,742,8,0,744,6,1400,650,457,287,1,3758,0
8,"Brasov",40438,83,40438,,"MUNICIPIUL SACELE",243,"B-dul George Moroianu nr. 399",1095,604,592,12,0,600,4,1200,596,423,177,1,3758,0
8,"Brasov",40438,83,40438,,"MUNICIPIUL SACELE",244,"B-dul George Moroianu nr. 399",861,483,475,8,0,458,25,900,417,300,158,1,3758,0
8,"Brasov",40438,83,40438,,"MUNICIPIUL SACELE",245,"Str. Barajului nr. 49",970,709,693,16,0,650,59,1100,391,343,307,1,3758,0
8,"Brasov",40438,83,40438,,"MUNICIPIUL SACELE",246,"Str. Barajului nr. 49",993,773,757,16,0,697,76,1100,327,324,373,1,3758,0
8,"Brasov",40438,83,40438,,"MUNICIPIUL SACELE",247,"B-dul George Moroianu nr. 17",0,281,0,281,0,275,6,503,222,155,120,1,3758,1
8,"Brasov",40214,83,40214,,"ORAS GHIMBAV",248,"Str. Lunga nr. 69",1659,900,895,5,0,891,9,1800,900,447,444,1,3760,0
8,"Brasov",40214,83,40214,,"ORAS GHIMBAV",249,"Str. Pietii nr. 70",1538,864,850,14,0,855,9,1700,836,447,408,1,3760,0
8,"Brasov",40214,83,40214,,"ORAS GHIMBAV",250,"Str. Scolii nr. 258",1482,764,752,12,0,759,5,1600,836,427,332,1,3760,0
8,"Brasov",40214,83,40214,,"ORAS GHIMBAV",251,"Str. Pietii nr. 70",0,146,0,146,0,146,0,200,54,90,56,1,3760,1
8,"Brasov",40303,83,40303,,"ORAS PREDEAL",252,"B-dul M. Saulescu nr. 127",1502,961,950,11,0,954,7,1584,623,515,439,1,3762,0
8,"Brasov",40303,83,40303,,"ORAS PREDEAL",253,"B-dul  M.Saulescu nr.91",1153,694,682,10,2,686,8,1299,605,352,334,1,3762,0
8,"Brasov",40303,83,40303,,"ORAS PREDEAL",254,"B-dul  M.Saulescu nr.91",1054,680,664,16,0,667,13,805,125,401,266,1,3762,0
8,"Brasov",40303,83,40303,,"ORAS PREDEAL",255,"SPITALUL DE NEUROPSIHIATRIE TIMISU DE SUS, Soseaua Nationala nr. 5",290,179,166,13,0,178,1,400,221,121,57,1,3762,0
8,"Brasov",40303,83,40303,,"ORAS PREDEAL",256,"TIMISU DE JOS, Soseaua Nationala nr.16",386,228,223,5,0,225,3,499,271,170,55,1,3762,0
8,"Brasov",40303,83,40303,,"ORAS PREDEAL",257,"Clubul Dambul Morii, Str. Piatra Mare  nr. 1",196,144,134,10,0,142,2,299,155,81,61,1,3762,0
8,"Brasov",40303,83,40303,,"ORAS PREDEAL",258,"Str. Intrarea Garii nr.1",0,1288,0,1288,0,1258,30,1598,310,754,504,1,3762,1
8,"Brasov",40367,83,40367,,"ORAS RASNOV",259,"Str. I.L Caragiale nr. 131",1629,896,888,8,0,887,9,1800,904,484,403,1,3767,0
8,"Brasov",40367,83,40367,,"ORAS RASNOV",260,"Str. I.L Caragiale nr. 131",1087,683,674,9,0,664,19,1200,517,386,278,1,3767,0
8,"Brasov",40367,83,40367,,"ORAS RASNOV",261,"Piata Scolii nr. 3",1246,770,756,12,2,755,15,1400,630,352,403,1,3767,0
8,"Brasov",40367,83,40367,,"ORAS RASNOV",262,"Piata Scolii nr. 3",1442,844,835,9,0,836,8,1600,756,472,364,1,3767,0
8,"Brasov",40367,83,40367,,"ORAS RASNOV",263,"Str. Campului nr. 2",941,494,489,5,0,491,3,1000,506,305,186,1,3767,0
8,"Brasov",40367,83,40367,,"ORAS RASNOV",264,"Str. Izvor nr.8",1666,794,786,8,0,781,13,1800,1006,479,302,1,3767,0
8,"Brasov",40367,83,40367,,"ORAS RASNOV",265,"Str. Izvor nr.8",1444,799,788,11,0,789,10,1600,801,460,329,1,3767,0
8,"Brasov",40367,83,40367,,"ORAS RASNOV",266,"Str. Izvor nr.8",1303,693,689,4,0,690,3,1400,707,352,338,1,3767,0
8,"Brasov",40367,83,40367,,"ORAS RASNOV",267,"Str. Republicii nr. 29",1626,942,932,10,0,927,15,1800,858,457,470,1,3767,0
8,"Brasov",40367,83,40367,,"ORAS RASNOV",268,"Str. Republicii nr. 29",1647,890,877,13,0,878,12,1800,910,461,417,1,3767,0
8,"Brasov",40367,83,40367,,"ORAS RASNOV",269,"Str. Republicii nr. 29",0,485,0,485,0,479,6,600,115,277,202,1,3767,1
8,"Brasov",40394,83,40394,,"ORAS RUPEA",270,"Str. Republicii nr. 92",1232,560,553,7,0,555,5,1399,839,338,217,1,3769,0
8,"Brasov",40394,83,40394,,"ORAS RUPEA",271,"Str. Republicii nr. 124 - parter",1324,611,602,7,2,606,5,1500,889,316,290,1,3769,0
8,"Brasov",40394,83,40394,,"ORAS RUPEA",272,"Str. Republicii nr. 145",1495,761,754,6,1,752,9,1600,839,439,313,1,3769,0
8,"Brasov",40394,83,40394,,"ORAS RUPEA",273,"Str. Muncii nr.23",578,291,285,5,1,288,3,600,309,146,142,1,3769,0
8,"Brasov",40394,83,40394,,"ORAS RUPEA",274,"Scoala Generala Fiser, nr 227",357,229,205,9,15,224,5,400,171,122,102,1,3769,0
8,"Brasov",40394,83,40394,,"ORAS RUPEA",275,"Str. Republicii nr. 124 , et.1",0,152,0,152,0,149,3,300,148,97,52,1,3769,1
8,"Brasov",40465,83,40465,,"ORAS VICTORIA",276,"Str. Stadionului nr. 14",1380,581,570,11,0,577,4,1500,919,372,205,1,3772,0
8,"Brasov",40465,83,40465,,"ORAS VICTORIA",277,"Str. Stadionului nr. 22",1207,550,534,14,2,547,3,1300,750,324,223,1,3772,0
8,"Brasov",40465,83,40465,,"ORAS VICTORIA",278,"Str. 1 Decembrie 1918 nr. 8",1424,635,628,7,0,616,19,1600,965,435,181,1,3772,0
8,"Brasov",40465,83,40465,,"ORAS VICTORIA",279,"Str. 1 Decembrie  1918 nr. 2",1038,522,513,8,1,518,4,1100,578,312,206,1,3772,0
8,"Brasov",40465,83,40465,,"ORAS VICTORIA",280,"Str. Salcamilor nr. 2",1383,668,657,11,0,664,4,1500,832,357,307,1,3772,0
8,"Brasov",40465,83,40465,,"ORAS VICTORIA",281,"Str. Libertatii nr.1",1351,531,521,10,0,526,5,1500,969,333,193,1,3772,0
8,"Brasov",40465,83,40465,,"ORAS VICTORIA",282,"Str. Stadionului nr. 18",0,233,0,233,0,220,13,500,267,131,89,1,3772,1
8,"Brasov",40492,83,40492,,"ORAS ZARNESTI",283,"Gradinita nr. 6, Cartier Grui",1515,843,832,9,2,840,3,1700,857,417,423,1,3774,0
8,"Brasov",40492,83,40492,,"ORAS ZARNESTI",284,"Str. Dr. Senchea nr. 23",1309,803,786,16,1,790,13,1400,597,418,372,1,3774,0
8,"Brasov",40492,83,40492,,"ORAS ZARNESTI",285,"Str. Tiberiu Sparchez nr. 2",1353,866,852,11,3,859,7,1500,634,453,406,1,3774,0
8,"Brasov",40492,83,40492,,"ORAS ZARNESTI",286,"Str. Tiberiu Sparchez nr. 2",1547,960,942,16,2,942,18,1700,740,504,438,1,3774,0
8,"Brasov",40492,83,40492,,"ORAS ZARNESTI",287,"Str. I. Metianu nr. 11",1288,814,798,15,1,811,3,1400,586,449,362,1,3774,0
8,"Brasov",40492,83,40492,,"ORAS ZARNESTI",288,"Str. I. Metianu nr. 77, corp B",1334,715,708,7,0,712,3,1500,785,359,353,1,3774,0
8,"Brasov",40492,83,40492,,"ORAS ZARNESTI",289,"Str. I. Metianu nr. 87, corp A",1566,835,820,15,0,824,11,1700,865,431,393,1,3774,0
8,"Brasov",40492,83,40492,,"ORAS ZARNESTI",290,"Str. I. Metianu nr. 87, corp A",916,545,537,7,1,535,10,1000,455,294,241,1,3774,0
8,"Brasov",40492,83,40492,,"ORAS ZARNESTI",291,"Str. Carpati nr. 1, corp B",1415,823,815,7,1,812,11,1600,777,374,438,1,3774,0
8,"Brasov",40492,83,40492,,"ORAS ZARNESTI",292,"Str. Carpati nr. 1, corp B",1415,837,824,11,2,830,7,1600,763,398,432,1,3774,0
8,"Brasov",40492,83,40492,,"ORAS ZARNESTI",293,"Str. Carpati nr. 1, corp A",1472,854,843,9,2,846,8,1600,746,405,441,1,3774,0
8,"Brasov",40492,83,40492,,"ORAS ZARNESTI",294,"Str. Carpati nr. 1, corp A",1350,839,832,6,1,829,10,1500,661,382,447,1,3774,0
8,"Brasov",40492,83,40492,,"ORAS ZARNESTI",295,"GRUP SCOLAR INDUSTRIAL, Str. Aleea Uzinei nr. 2",1190,607,590,13,4,603,4,1300,693,341,262,1,3774,0
8,"Brasov",40492,83,40492,,"ORAS ZARNESTI",296,"SCOALA GENERALA NR.2, Str. Scolii nr. 80",1721,823,810,11,2,796,27,1900,1077,348,448,1,3774,0
8,"Brasov",40492,83,40492,,"ORAS ZARNESTI",297,"SCOALA GENERALA NR.2, Str. Scolii nr. 80",1257,720,705,13,2,713,7,1400,680,376,337,1,3774,0
8,"Brasov",40492,83,40492,,"ORAS ZARNESTI",298,"SCOALA GENERALA NR. 4, Str. Unirii nr.4",1114,868,806,40,22,855,13,1200,332,422,433,1,3774,0
8,"Brasov",40492,83,40492,,"ORAS ZARNESTI",299,"Str. I. Metianu nr. 77",0,394,0,394,0,392,2,497,103,184,208,1,3774,1
8,"Brasov",40526,83,40526,,"APATA",300,"APATA CAMINUL CULTURAL APATA,Str. Principala nr.278",1100,674,673,1,0,665,9,1200,526,461,204,3,3777,0
8,"Brasov",40526,83,40526,,"APATA",301,"APATA CAMINUL CULTURAL APATA,Str. Principala nr.278",1105,569,568,1,0,554,15,1200,631,335,219,3,3777,0
8,"Brasov",40526,83,40526,,"APATA",302,"APATA CAMINUL CULTURAL APATA,Str. Principala nr.278",0,54,0,54,0,52,2,100,46,32,20,3,3777,1
8,"Brasov",42498,83,42498,,"AUGUSTIN",303,"AUGUSTIN Str. Garii nr. 146",1105,813,805,8,0,804,9,1194,381,482,322,3,3779,0
8,"Brasov",42498,83,42498,,"AUGUSTIN",304,"AUGUSTIN Str. Garii nr. 146",0,65,0,65,0,65,0,101,36,33,32,3,3779,1
8,"Brasov",40544,83,40544,,"BECLEAN",305,"BECLEAN CAMINUL CULTURAL BECLEAN nr.196 , cam. 1",586,290,272,7,11,284,6,700,410,139,145,3,3781,0
8,"Brasov",40544,83,40544,,"BECLEAN",306,"HUREZ Caminul cultural Hurez nr.207",355,246,229,9,8,245,1,400,154,103,142,3,3781,0
8,"Brasov",40544,83,40544,,"BECLEAN",307,"CALBOR Scoala generala Calbor nr. 20",185,117,95,10,12,115,2,201,84,56,59,3,3781,0
8,"Brasov",40544,83,40544,,"BECLEAN",308,"BOHOLT Caminul Cultural Boholt nr.323",163,122,99,12,11,119,3,200,78,63,56,3,3781,0
8,"Brasov",40544,83,40544,,"BECLEAN",309,"LUTA CAMINUL CULTURAL LUTA nr.64",47,42,31,11,0,41,1,90,48,19,22,3,3781,0
8,"Brasov",40544,83,40544,,"BECLEAN",310,"BECLEAN CAMINUL CULTURAL BECLEAN nr.196 , cam. 2",0,53,0,53,0,52,1,100,47,27,25,3,3781,1
8,"Brasov",40606,83,40606,,"BOD",311,"PRIMARIA BOD str. Scolii nr.139",1883,1029,1007,18,4,1018,11,2000,971,538,480,3,3787,0
8,"Brasov",40606,83,40606,,"BOD",312,"GRADINITA BOD COLONIE",1728,866,858,8,0,856,10,1900,1034,555,301,3,3787,0
8,"Brasov",40606,83,40606,,"BOD",313,"CAMINUL CULTURAL BOD Str. T.Vladimirescu nr.263",0,152,0,152,0,151,1,200,48,67,84,3,3787,1
8,"Brasov",40633,83,40633,,"BRAN",314,"BRAN PRIMARIA BRAN , Piata I.G.Stoian nr.1",1331,697,689,8,0,690,7,1500,803,371,319,3,3790,0
8,"Brasov",40633,83,40633,,"BRAN",315,"PREDELUT Scoala generala Predelut nr.226 A",751,478,472,6,0,470,8,800,322,238,232,3,3790,0
8,"Brasov",40633,83,40633,,"BRAN",316,"SOHODOL CAMINUL CULTURAL SOHODOL nr.219",1373,722,715,7,0,712,10,1500,778,419,293,3,3790,0
8,"Brasov",40633,83,40633,,"BRAN",317,"SIMON CAMINUL CULTURAL SIMON nr.112",1004,556,547,9,0,545,11,1100,544,372,173,3,3790,0
8,"Brasov",40633,83,40633,,"BRAN",318,"BRAN PRIMARIA BRAN , Piata I.G.Stoian nr.1",0,613,0,613,0,601,12,1000,387,344,257,3,3790,1
8,"Brasov",40688,83,40688,,"BUDILA",319,"PRIMARIA BUDILA STR. PRINCIPALA NR. 261",588,393,373,12,8,388,5,700,307,235,153,3,3795,0
8,"Brasov",40688,83,40688,,"BUDILA",320,"Str. Scolii nr. 617, corp B",1010,717,705,6,6,682,35,1100,383,434,248,3,3795,0
8,"Brasov",40688,83,40688,,"BUDILA",321,"BUDILA Str. Prejmerului nr. 593 A",1011,568,544,7,17,562,6,1100,532,306,256,3,3795,0
8,"Brasov",40688,83,40688,,"BUDILA",322,"BUDILA Str. Principala nr. 261",0,97,0,97,0,93,4,200,103,43,50,3,3795,1
8,"Brasov",40704,83,40704,,"BUNESTI",323,"BUNESTI  Nr. 119",554,318,308,10,0,312,6,591,273,120,192,3,3797,0
8,"Brasov",40704,83,40704,,"BUNESTI",324,"CRIT SC. GENERALA CRIT  NR. 121",516,319,313,6,0,312,7,600,281,164,148,3,3797,0
8,"Brasov",40704,83,40704,,"BUNESTI",325,"MESENDORF SC. GENERALA MESENDORF NR. 51",255,113,105,8,0,105,8,303,190,59,46,3,3797,0
8,"Brasov",40704,83,40704,,"BUNESTI",326,"ROADES SC. GENERALA ROADES NR. 162",201,124,115,9,0,121,3,300,176,88,33,3,3797,0
8,"Brasov",40704,83,40704,,"BUNESTI",327,"VISCRI SC. GENERALA VISCRI NR. 60",334,165,159,6,0,160,5,400,235,61,99,3,3797,0
8,"Brasov",40704,83,40704,,"BUNESTI",328,"CAMINUL CULTURAL BUNESTI, BUNESTI NR. 82A",0,60,0,60,0,60,0,200,140,29,31,3,3797,1
8,"Brasov",40768,83,40768,,"CATA",329,"CATA CAMINUL CULTURAL CATA, nr.37",950,532,526,3,3,520,12,1000,468,255,265,3,3803,0
8,"Brasov",40768,83,40768,,"CATA",330,"BEIA Satul Beia nr. 242",313,177,165,9,3,174,3,405,228,67,107,3,3803,0
8,"Brasov",40768,83,40768,,"CATA",331,"DRAUSENI GRADINITA DE COPII DRAUSENI NR. 147",436,266,253,11,2,266,0,500,234,180,86,3,3803,0
8,"Brasov",40768,83,40768,,"CATA",332,"IONESTI CAMINUL CULTURAL IONESTI NR. 68",110,81,72,9,0,80,1,200,119,39,41,3,3803,0
8,"Brasov",40768,83,40768,,"CATA",333,"PALOS SC. GENERALA PALOS, nr. 203",222,141,128,9,4,138,3,302,161,67,71,3,3803,0
8,"Brasov",40768,83,40768,,"CATA",334,"PRIMARIA CATA,  CATA nr.223",0,46,0,46,0,45,1,200,154,21,24,3,3803,1
8,"Brasov",40820,83,40820,,"CINCU",335,"CINCU Str. Pietii nr. 520",1250,685,678,3,4,676,9,1400,715,335,341,3,3809,0
8,"Brasov",40820,83,40820,,"CINCU",336,"TOARCLA SC. ELEMENTARA TOARCLA,Str.Principala  nr. 148",261,137,127,10,0,131,6,300,163,75,56,3,3809,0
8,"Brasov",40820,83,40820,,"CINCU",337,"CINCU Str. Pietii nr. 520",0,80,0,80,0,79,1,202,122,41,38,3,3809,1
8,"Brasov",40857,83,40857,,"COMANA",338,"COMANA DE JOS CAMINUL CULTURAL COMANA DE JOS NR. 179",784,396,395,0,1,391,5,900,504,235,156,3,3812,0
8,"Brasov",40857,83,40857,,"COMANA",339,"COMANA DE SUS CAMINUL CULTURAL COMANA DE SUS NR.125",267,166,153,13,0,166,0,300,134,122,44,3,3812,0
8,"Brasov",40857,83,40857,,"COMANA",340,"CRIHALMA CAMINUL CULTURAL CRIHALMA NR. 65",500,313,305,8,0,310,3,600,287,152,158,3,3812,0
8,"Brasov",40857,83,40857,,"COMANA",341,"TICUSU NOU CAMINUL CULTURAL TICUSU NOU NR. 87",428,331,315,16,0,329,2,500,169,113,216,3,3812,0
8,"Brasov",40857,83,40857,,"COMANA",342,"PRIMARIA COMUNEI COMANA, COMANA DE JOS NR.3",0,92,0,92,0,90,2,200,108,62,28,3,3812,1
8,"Brasov",40900,83,40900,,"CRISTIAN",343,"CRISTIAN Piata Libertatii nr. 8",1176,752,721,24,7,742,10,1300,548,431,311,3,3817,0
8,"Brasov",40900,83,40900,,"CRISTIAN",344,"CRISTIAN Str. Lunga nr. 103",1244,771,741,21,9,767,4,1400,629,360,407,3,3817,0
8,"Brasov",40900,83,40900,,"CRISTIAN",345,"Str. Lunga nr. 161, corp B",1252,839,820,18,1,827,12,1400,561,463,364,3,3817,0
8,"Brasov",40900,83,40900,,"CRISTIAN",346,"CRISTIAN Piata Libertatii nr. 1",0,224,0,224,0,220,4,400,176,105,115,3,3817,1
8,"Brasov",42456,83,42456,,"CRIZBAV",347,"CRIZBAV Str. Principala nr. 1",1185,892,875,5,12,868,24,1300,408,656,212,3,3819,0
8,"Brasov",42456,83,42456,,"CRIZBAV",348,"CUTUS Str. Cetatii nr. 75",418,342,332,9,1,335,7,500,158,311,24,3,3819,0
8,"Brasov",42456,83,42456,,"CRIZBAV",349,"CRIZBAV Str. Principala nr. 1",0,174,0,174,0,172,2,300,126,130,42,3,3819,1
8,"Brasov",42480,83,42480,,"DRAGUS",350,"DRAGUS Primaria comunei DRAGUS ,Str.Principala nr. 42",881,598,564,7,27,593,5,1000,402,452,141,3,3822,0
8,"Brasov",42480,83,42480,,"DRAGUS",351,"DRAGUS Primaria comunei DRAGUS ,Str.Principala nr. 42",0,183,0,183,0,180,3,300,117,142,38,3,3822,1
8,"Brasov",40928,83,40928,,"DUMBRAVITA",352,"DUMBRAVITA PRIMARIA DUMBRAVITA Str. Mare nr. 1176",1496,810,807,3,0,799,11,1600,790,482,317,3,3824,0
8,"Brasov",40928,83,40928,,"DUMBRAVITA",353,"DUMBRAVITA Str. Mare. nr. 981",1686,957,953,4,0,943,14,1800,843,572,371,3,3824,0
8,"Brasov",40928,83,40928,,"DUMBRAVITA",354,"VLADENI Str. Mare nr. 243",708,344,333,11,0,342,2,802,458,193,149,3,3824,0
8,"Brasov",40928,83,40928,,"DUMBRAVITA",355,"STR. MARE NR. 979",0,161,0,161,0,160,1,198,37,111,49,3,3824,1
8,"Brasov",40955,83,40955,,"FELDIOARA",356,"CAMINUL CULTURAL STR. OCTAVIAN GOGA",1709,893,844,49,0,883,10,1900,1007,478,405,3,3827,0
8,"Brasov",40955,83,40955,,"FELDIOARA",357,"Liceul Petru Rares Str. Octavian Goga",1814,913,864,49,0,906,7,2000,1087,454,452,3,3827,0
8,"Brasov",40955,83,40955,,"FELDIOARA",358,"Liceul Petru Rares Str. Octavian Goga",557,266,248,18,0,265,1,593,327,160,105,3,3827,0
8,"Brasov",40955,83,40955,,"FELDIOARA",359,"ROTBAV CAMINUL CULTURAL ROTBAV",1473,820,803,17,0,805,15,1600,780,492,313,3,3827,0
8,"Brasov",40955,83,40955,,"FELDIOARA",360,"FELDIOARA CAMINUL CULTURAL FELDIOARA, Str. O.Goga",0,165,0,165,0,160,5,300,135,85,75,3,3827,1
8,"Brasov",40991,83,40991,,"FUNDATA",361,"FUNDATA Scoala Generala Fundata nr.197",518,323,313,3,7,318,5,599,276,132,186,3,3831,0
8,"Brasov",40991,83,40991,,"FUNDATA",362,"SIRNEA SCOALA GENERALA SIRNEA nr.45",266,137,130,6,1,137,0,300,163,61,76,3,3831,0
8,"Brasov",40991,83,40991,,"FUNDATA",363,"PRIMARIA COMUNEI FUNDATA, STR. PRINCIPALA NR.56",0,148,0,148,0,146,2,297,149,80,66,3,3831,1
8,"Brasov",41113,83,41113,,"HARSENI",364,"SAT HARSENI NR 63 CORP A",464,226,217,8,1,221,5,500,274,126,95,3,3841,0
8,"Brasov",41113,83,41113,,"HARSENI",365,"SCOALA GENERALA SAT SEBES NR. 47",621,337,329,7,1,330,7,700,363,194,136,3,3841,0
8,"Brasov",41113,83,41113,,"HARSENI",366,"SCOALA GENERALA SAT MARGINENI NR. 15",253,162,155,7,0,160,2,300,138,86,74,3,3841,0
8,"Brasov",41113,83,41113,,"HARSENI",367,"SCOALA GENERALA SAT COPACEL NR.65-66",513,280,268,12,0,277,3,600,320,187,90,3,3841,0
8,"Brasov",41113,83,41113,,"HARSENI",368,"HARSENI , Scoala Mica  Harseni , nr.63, corp B",0,110,0,110,0,110,0,197,87,71,39,3,3841,1
8,"Brasov",41033,83,41033,,"HALCHIU",369,"HALCHIU Str. Invatatorilor nr. 2",1300,738,733,0,5,730,8,1400,662,423,307,3,3835,0
8,"Brasov",41033,83,41033,,"HALCHIU",370,"HALCHIU Str. Invatatorilor nr. 2A",1347,750,745,5,0,742,8,1400,650,425,317,3,3835,0
8,"Brasov",41033,83,41033,,"HALCHIU",371,"SATU-NOU , Caminul Cultural SATU-NOU",920,523,515,7,1,514,9,1000,477,304,210,3,3835,0
8,"Brasov",41033,83,41033,,"HALCHIU",372,"HALCHIU , Scoala Generala  Halchiu corp B, Str. Feldioarei nr.303",0,297,0,297,0,294,3,400,103,177,117,3,3835,1
8,"Brasov",41088,83,41088,,"HARMAN",373,"HARMAN Str. Pietii nr. 3",1640,898,863,35,0,890,8,1800,902,436,454,3,3838,0
8,"Brasov",41088,83,41088,,"HARMAN",374,"HARMAN Str. Dorobanti 77",1241,634,600,34,0,628,6,1404,770,329,299,3,3838,0
8,"Brasov",41088,83,41088,,"HARMAN",375,"HARMAN Str. Dorobanti 77",839,445,434,11,0,441,4,901,456,198,243,3,3838,0
8,"Brasov",41088,83,41088,,"HARMAN",376,"PODU OLT Str. Principala nr. 1157",521,332,315,17,0,330,2,594,262,244,86,3,3838,0
8,"Brasov",41088,83,41088,,"HARMAN",377,"HARMAN Str. Dorobanti 77",0,165,0,165,0,164,1,300,135,86,78,3,3838,1
8,"Brasov",41177,83,41177,,"HOGHIZ",378,"HOGHIZ CAMINUL CULTURAL HOGHIZ 232",1839,840,832,8,0,836,4,2000,1160,521,315,3,3847,0
8,"Brasov",41177,83,41177,,"HOGHIZ",379,"BOGATA CAMINUL CULTURAL BOGATA nr.75",315,235,226,9,0,231,4,383,148,130,101,3,3847,0
8,"Brasov",41177,83,41177,,"HOGHIZ",380,"CUCIULATA CAMINUL CULTURAL CUCIULATA nr.100",1008,569,559,10,0,563,6,1100,531,264,299,3,3847,0
8,"Brasov",41177,83,41177,,"HOGHIZ",381,"DOPCA CAMINUL CULTURAL DOPCA nr.24",421,256,251,5,0,256,0,500,244,210,46,3,3847,0
8,"Brasov",41177,83,41177,,"HOGHIZ",382,"FANTANA CAMINUL CULTURAL FANTANA nr.44",242,179,171,8,0,177,2,300,121,90,87,3,3847,0
8,"Brasov",41177,83,41177,,"HOGHIZ",383,"LUPSA CAMINUL CULTURAL LUPSA nr.25",86,57,48,9,0,57,0,100,43,35,22,3,3847,0
8,"Brasov",41177,83,41177,,"HOGHIZ",384,"HOGHIZ, Primaria Comunei Hoghiz nr. 161",0,112,0,112,0,110,2,194,82,71,39,3,3847,1
8,"Brasov",42472,83,42472,,"HOLBAV",385,"HOLBAV, Caminul Cultural HOLBAV nr.48",1034,570,565,4,1,561,9,1100,530,282,279,3,3854,0
8,"Brasov",42472,83,42472,,"HOLBAV",386,"HOLBAV, Caminul Cultural HOLBAV nr.48",0,51,0,51,0,51,0,100,49,23,28,3,3854,1
8,"Brasov",41248,83,41248,,"HOMOROD",387,"HOMOROD CAMINUL CULTURAL HOMOROD, Str.Principala nr. 403",1135,571,566,5,0,566,5,1200,629,370,196,3,3856,0
8,"Brasov",41248,83,41248,,"HOMOROD",388,"MERCHEASA SCOALA PRIMARA MERCHEASA, Str. Principala",405,223,208,10,5,217,6,500,277,135,82,3,3856,0
8,"Brasov",41248,83,41248,,"HOMOROD",389,"JIMBOR CAMINUL CULTURAL JIMBOR, Str. Principala",370,175,168,7,0,171,4,400,225,114,57,3,3856,0
8,"Brasov",41248,83,41248,,"HOMOROD",390,"HOMOROD CAMINUL CULTURAL HOMOROD, Str.Principala nr. 403",0,68,0,68,0,68,0,200,132,42,26,3,3856,1
8,"Brasov",41284,83,41284,,"JIBERT",391,"JIBERT SCOALA GENERALA JIBERT , Str. Principala nr 2",578,300,294,6,0,297,3,600,300,198,99,3,3860,0
8,"Brasov",41284,83,41284,,"JIBERT",392,"DACIA SCOALA GENERALA DACIA",554,317,311,6,0,310,7,600,283,133,177,3,3860,0
8,"Brasov",41284,83,41284,,"JIBERT",393,"LOVNIC SCOALA GENERALA LOVNIC",429,201,197,4,0,198,3,500,299,105,93,3,3860,0
8,"Brasov",41284,83,41284,,"JIBERT",394,"GRANARI SCOALA GENERALA GRANARI",320,149,145,4,0,148,1,400,251,54,94,3,3860,0
8,"Brasov",41284,83,41284,,"JIBERT",395,"VALENI SCOALA GENERALA VALENI",145,101,92,9,0,100,1,200,99,69,31,3,3860,0
8,"Brasov",41284,83,41284,,"JIBERT",396,"JIBERT SCOALA GENERALA JIBERT , Str. Principala nr 2",0,84,0,84,0,84,0,200,116,43,41,3,3860,1
8,"Brasov",41346,83,41346,,"LISA",397,"LISA CAMINUL CULTURAL LISA nr. 251",842,488,478,8,2,487,1,900,412,240,247,3,3866,0
8,"Brasov",41346,83,41346,,"LISA",398,"BREAZA CAMINUL CULTURAL BREAZA nr.52",432,256,244,12,0,255,1,500,244,204,51,3,3866,0
8,"Brasov",41346,83,41346,,"LISA",399,"Caminul Cultural Pojorta , nr. 46",153,112,103,7,2,111,1,199,87,82,29,3,3866,0
8,"Brasov",41346,83,41346,,"LISA",400,"LISA Scoala generala Octavian Paler LISA nr. 193",0,155,0,155,0,154,1,400,245,89,65,3,3866,1
8,"Brasov",41417,83,41417,,"MANDRA",401,"MANDRA ASEZAMANT CULTURAL MANDRA, NR. 312",894,553,515,15,23,546,7,1000,447,175,371,3,3873,0
8,"Brasov",41417,83,41417,,"MANDRA",402,"ILENI  ASEZAMANT CULTURAL ILENI, NR. 307",618,346,338,6,2,344,2,700,354,196,148,3,3873,0
8,"Brasov",41417,83,41417,,"MANDRA",403,"RAUSOR ASEZAMANT CULTURAL RAUSOR , NR. 170",375,226,216,7,3,223,3,400,174,130,93,3,3873,0
8,"Brasov",41417,83,41417,,"MANDRA",404,"TODERITA ASEZAMANT CULTURAL TODERITA nr. 49",243,138,129,7,2,137,1,300,162,54,83,3,3873,0
8,"Brasov",41417,83,41417,,"MANDRA",405,"SONA ASEZAMANT CULTURAL SONA, nr. 203",208,110,101,9,0,110,0,300,190,46,64,3,3873,0
8,"Brasov",41417,83,41417,,"MANDRA",406,"MANDRA , Scoala generala Mandra , corp B, Mandra nr. 364",0,312,0,312,0,309,3,386,74,93,216,3,3873,1
8,"Brasov",41382,83,41382,,"MAIERUS",407,"MAIERUS Str.N. Balcescu nr.2",1376,861,840,9,12,835,26,1500,639,440,395,3,3870,0
8,"Brasov",41382,83,41382,,"MAIERUS",408,"ARINI,  Sc.Generala  Arini , Str.Principala",623,455,449,6,0,442,13,700,245,270,172,3,3870,0
8,"Brasov",41382,83,41382,,"MAIERUS",409,"MAIERUS Str.N. Balcescu nr.2",0,193,0,193,0,192,1,300,107,149,43,3,3870,1
8,"Brasov",41471,83,41471,,"MOIECIU",410,"MOIECIU DE JOS CAMINUL CULTURAL MOIECIU DE JOS NR. 330 A",1237,813,806,7,0,804,9,1400,587,469,335,3,3879,0
8,"Brasov",41471,83,41471,,"MOIECIU",411,"MOIECIU DE JOS CAMINUL CULTURAL MOIECIU DE JOS NR. 330 A",1020,620,608,12,0,617,3,1100,480,380,237,3,3879,0
8,"Brasov",41471,83,41471,,"MOIECIU",412,"MOIECIU DE SUS SCOALA GENERALA  MOIECIU DE SUS NR. 210 C",721,509,493,16,0,504,5,767,258,206,298,3,3879,0
8,"Brasov",41471,83,41471,,"MOIECIU",413,"PESTERA SCOALA GENERALA  PESTERA NR. 1A",385,222,212,10,0,221,1,500,278,89,132,3,3879,0
8,"Brasov",41471,83,41471,,"MOIECIU",414,"MAGURA SCOALA GENERALA  MAGURA NR. 86B",477,277,272,5,0,273,4,494,217,144,129,3,3879,0
8,"Brasov",41471,83,41471,,"MOIECIU",415,"MOIECIU DE JOS CAMINUL CULTURAL MOIECIU DE JOS NR. 330 A",0,475,0,475,0,471,4,700,225,245,226,3,3879,1
8,"Brasov",41541,83,41541,,"ORMENIS",416,"ORMENIS Primaria Comunei Ormenis Str. Principala nr. 291",1535,1029,1007,1,21,1013,16,1700,671,448,565,3,3886,0
8,"Brasov",41541,83,41541,,"ORMENIS",417,"ORMENIS Primaria Comunei Ormenis Str. Principala nr. 291",0,42,0,42,0,41,1,103,61,22,19,3,3886,1
8,"Brasov",41578,83,41578,,"PARAU",418,"PARAU CAMINUL CULTURAL PARAU, nr. 214",510,281,273,7,1,276,5,600,319,194,82,3,3888,0
8,"Brasov",41578,83,41578,,"PARAU",419,"GRID SC. GENERALA GRID nr. 94, sala 2",260,156,149,7,0,155,1,300,144,97,58,3,3888,0
8,"Brasov",41578,83,41578,,"PARAU",420,"VENETIA DE JOS SEDIUL FOSTEI PRIMARII  VENETIA DE JOS NR. 426",554,347,341,6,0,345,2,600,253,282,63,3,3888,0
8,"Brasov",41578,83,41578,,"PARAU",421,"VENETIA DE SUS CLADIREA FOSTEI PRIMARII VENETIA DE SUS NR. 197",334,188,179,9,0,183,5,400,212,142,41,3,3888,0
8,"Brasov",41578,83,41578,,"PARAU",422,"PARAU CAMINUL CULTURAL PARAU, nr. 214",0,135,0,135,0,134,1,200,65,97,37,3,3888,1
8,"Brasov",41621,83,41621,,"POIANA MARULUI",423,"POIANA MARULUI , CAMIN CULTURAL POIANA MARULUI",1271,800,743,53,4,794,6,1400,600,416,378,3,3893,0
8,"Brasov",41621,83,41621,,"POIANA MARULUI",424,"POIANA MARULUI , Scoala Generala nr. 1 corp B",1062,526,438,88,0,519,7,1194,668,325,194,3,3893,0
8,"Brasov",41621,83,41621,,"POIANA MARULUI",425,"INTRE VAI SCOALA GENERALA NR.2 VULCANITA",327,161,96,65,0,159,2,395,234,118,41,3,3893,0
8,"Brasov",41621,83,41621,,"POIANA MARULUI",426,"POIANA MARULUI , Scoala Generala nr. 1 corp B , Str. Vanatorilor nr. 172",0,102,0,102,0,101,1,307,205,53,48,3,3893,1
8,"Brasov",41667,83,41667,,"PREJMER",427,"PREJMER nr. 2  Sc. Generala Prejmer - parter",1540,845,832,13,0,836,9,1700,855,468,368,3,3895,0
8,"Brasov",41667,83,41667,,"PREJMER",428,"PREJMER nr. 2  Sc. Generala Prejmer - parter",1470,866,850,16,0,856,10,1600,734,462,394,3,3895,0
8,"Brasov",41667,83,41667,,"PREJMER",429,"PREJMER nr. 2  Sc. Generala Prejmer - parter",1582,911,897,14,0,899,12,1700,789,504,395,3,3895,0
8,"Brasov",41667,83,41667,,"PREJMER",430,"LUNCA CALNICULUI Sc. generala Lunca Calnicului-sat nr. 220",1319,672,662,10,0,665,7,1500,828,410,255,3,3895,0
8,"Brasov",41667,83,41667,,"PREJMER",431,"LUNCA CALNICULUI Sc. generala Lunca Calnicului-colonie nr. 355",1242,748,685,62,1,735,13,1409,661,455,280,3,3895,0
8,"Brasov",41667,83,41667,,"PREJMER",432,"Scoala generala Stupinii Prejmerului",321,201,185,16,0,199,2,400,199,120,79,3,3895,0
8,"Brasov",41667,83,41667,,"PREJMER",433,"PREJMER  Sc. Generala Prejmer -  Str. Scolii nr. 2",0,211,0,211,0,209,2,300,89,118,91,3,3895,1
8,"Brasov",41701,83,41701,,"RACOS",434,"RACOS Str. Dr. Imreh Barna nr. 15",1016,547,531,16,0,539,8,1100,553,244,295,3,3899,0
8,"Brasov",41701,83,41701,,"RACOS",435,"RACOS Str. Dr. Imreh Barna nr. 13",1059,430,425,5,0,420,10,1200,770,231,189,3,3899,0
8,"Brasov",41701,83,41701,,"RACOS",436,"MATEIAS CAMINUL CULTURAL MATEIAS - Str. Princip. Nr. 173",377,228,221,7,0,226,2,400,172,126,100,3,3899,0
8,"Brasov",41701,83,41701,,"RACOS",437,"RACOS,  Str. Nyiro Jozsef    nr.24",0,38,0,38,0,38,0,199,161,17,21,3,3899,1
8,"Brasov",41738,83,41738,,"RECEA",438,"RECEA CAMINUL CULTURAL RECEA Str. Principala nr.38",1447,689,682,5,2,685,4,1600,911,513,172,3,3902,0
8,"Brasov",41738,83,41738,,"RECEA",439,"BERIVOI Scoala generala BERIVOI Str. Principala nr. 314",482,245,237,8,0,244,1,600,355,138,106,3,3902,0
8,"Brasov",41738,83,41738,,"RECEA",440,"SAVASTRENI Scoala generala SAVASTRENI Str. Principala nr. 10",560,256,246,10,0,252,4,599,343,184,68,3,3902,0
8,"Brasov",41738,83,41738,,"RECEA",441,"RECEA CAMINUL CULTURAL RECEA  Str. Principala nr.38",0,203,0,203,0,200,3,302,99,135,65,3,3902,1
8,"Brasov",42464,83,42464,,"SAMBATA DE SUS",442,"SAMBATA DE SUS Scoala generala SAMBATA DE SUS nr. 556",1218,741,733,6,2,731,10,1300,559,500,231,3,3910,0
8,"Brasov",42464,83,42464,,"SAMBATA DE SUS",443,"SAMBATA DE SUS , Sediul Jandarmeriei Montane",0,222,0,222,0,222,0,400,178,144,78,3,3910,1
8,"Brasov",41925,83,41925,,"SANPETRU",444,"SANPETRU Str. Meschendorfer nr. 333",1546,902,881,21,0,890,12,1700,798,505,385,3,3913,0
8,"Brasov",41925,83,41925,,"SANPETRU",445,"SANPETRU , Str. Scolii nr. 172",817,436,423,13,0,429,7,900,464,254,175,3,3913,0
8,"Brasov",41925,83,41925,,"SANPETRU",446,"SANPETRU , Scoala Generala  Sanpetru - corp C , Str. Republicii nr. 622",1145,606,591,15,0,599,7,1294,688,343,256,3,3913,0
8,"Brasov",41925,83,41925,,"SANPETRU",447,"SANPETRU , Scoala Generala  Sanpetru - corp C , Str. Republicii nr. 622",0,185,0,185,0,184,1,300,115,90,94,3,3913,1
8,"Brasov",41818,83,41818,,"SERCAIA",448,"SERCAIA CAMINUL CULTURAL SERCAIA   nr.82",1335,625,594,10,21,613,12,1500,875,296,317,3,3915,0
8,"Brasov",41818,83,41818,,"SERCAIA",449,"VAD GRADINITA VAD nr.192",440,238,228,8,2,235,3,500,262,113,122,3,3915,0
8,"Brasov",41818,83,41818,,"SERCAIA",450,"HALMEAG CAMINUL CULTURAL HALMEAG nr.246",380,200,178,11,11,198,2,400,200,93,105,3,3915,0
8,"Brasov",41818,83,41818,,"SERCAIA",451,"SERCAIA CAMINUL CULTURAL SERCAIA   nr.82",0,103,0,103,0,103,0,200,97,66,37,3,3915,1
8,"Brasov",41854,83,41854,,"SINCA",452,"SINCA PRIMARIA COMUNEI SINCA, Str. Principala nr.314",892,438,427,11,0,435,3,1000,562,237,198,3,3919,0
8,"Brasov",41854,83,41854,,"SINCA",453,"BUCIUM SCOALA PRIMARA BUCIUM , Str. Principala nr. 42",205,135,124,11,0,134,1,300,165,100,34,3,3919,0
8,"Brasov",41854,83,41854,,"SINCA",454,"OHABA CAMINUL CULTURAL OHABA , Str. Principala nr. 7",233,155,149,6,0,153,2,300,145,121,32,3,3919,0
8,"Brasov",41854,83,41854,,"SINCA",455,"PERSANI SCOALA GENERALA PERSANI nr.42",799,438,430,8,0,432,6,900,462,329,103,3,3919,0
8,"Brasov",41854,83,41854,,"SINCA",456,"SERCAITA SCOALA GENERALA SERCAITA",535,321,309,9,3,315,6,600,279,247,68,3,3919,0
8,"Brasov",41854,83,41854,,"SINCA",457,"SINCA VECHE , PRIMARIA COMUNEI SINCA, Str. Principala nr. 314",0,261,0,261,0,261,0,300,39,155,106,3,3919,1
8,"Brasov",42449,83,42449,,"SINCA NOUA",458,"SINCA NOUA Caminul Cultural Sinca Noua nr.57",1022,754,718,7,29,748,6,1096,342,404,344,3,3926,0
8,"Brasov",42449,83,42449,,"SINCA NOUA",459,"SINCA NOUA Sc. Generala Sinca Noua nr. 77",176,132,121,11,0,131,1,199,67,42,89,3,3926,0
8,"Brasov",42449,83,42449,,"SINCA NOUA",460,"PALTIN Sc. primara PALTIN  nr. 58",113,97,73,24,0,97,0,200,103,46,51,3,3926,0
8,"Brasov",42449,83,42449,,"SINCA NOUA",461,"SINCA NOUA Caminul Cultural Sinca Noua nr.57",0,61,0,61,0,60,1,100,39,25,35,3,3926,1
8,"Brasov",42449,83,42449,,"SINCA NOUA",462,"PALTIN Sc. primara PALTIN  nr. 58",0,61,0,61,0,58,3,100,39,39,19,3,3926,1
8,"Brasov",41943,83,41943,,"SOARS",463,"SOARS Primaria COMUNEI Soars nr. 111",463,251,248,3,0,249,2,500,249,187,62,3,3929,0
8,"Brasov",41943,83,41943,,"SOARS",464,"FELMER Scoala Generala  FELMER NR. 319",363,220,214,6,0,213,7,400,180,92,121,3,3929,0
8,"Brasov",41943,83,41943,,"SOARS",465,"BARCUT SC.GEN.  BARCUT  156",331,174,162,4,8,174,0,400,226,131,43,3,3929,0
8,"Brasov",41943,83,41943,,"SOARS",466,"RODBAV Scoala generala RODBAV nr. 112",234,128,123,5,0,127,1,304,176,97,30,3,3929,0
8,"Brasov",41943,83,41943,,"SOARS",467,"SELISTAT SC. GENERALA SELISTAT 163",160,102,95,7,0,102,0,200,98,62,40,3,3929,0
8,"Brasov",41943,83,41943,,"SOARS",468,"SOARS Primaria COMUNEI Soars nr. 111",0,74,0,74,0,73,1,100,26,38,35,3,3929,1
8,"Brasov",42003,83,42003,,"TARLUNGENI",469,"TARLUNGENI CAMINUL CULTURAL TARLUNGENI Str. Principala nr. 298",1358,723,711,11,1,703,20,1500,777,443,260,3,3935,0
8,"Brasov",42003,83,42003,,"TARLUNGENI",470,"TARLUNGENI Gradinita prog.normal  Str. Principala  nr. 754",1398,793,781,12,0,775,18,1500,707,519,256,3,3935,0
8,"Brasov",42003,83,42003,,"TARLUNGENI",471,"PURCARENI Sc. Generala  Purcareni Str. Principala nr. 465",1228,743,734,8,1,735,8,1401,658,501,234,3,3935,0
8,"Brasov",42003,83,42003,,"TARLUNGENI",472,"ZIZIN Sc. Generala Zizin Str. Nicoale Balcescu nr. 154",820,569,555,14,0,556,13,898,329,351,205,3,3935,0
8,"Brasov",42003,83,42003,,"TARLUNGENI",473,"TARLUNGENI Scoala de Arte si Meserii Tarlungeni, Str. Zizinului nr. 205",875,613,604,9,0,590,23,1000,387,328,262,3,3935,0
8,"Brasov",42003,83,42003,,"TARLUNGENI",474,"CARPINIS Sc. Generala Carpinis Str. Principala 942",332,232,219,13,0,230,2,403,171,121,109,3,3935,0
8,"Brasov",42003,83,42003,,"TARLUNGENI",475,"TARLUNGENI Gradinita prog.normal Str. Principala nr. 754",0,182,0,182,0,178,4,301,119,112,66,3,3935,1
8,"Brasov",42058,83,42058,,"TELIU",476,"TELIU Str. T. Vladimirescu nr. 449",1083,547,536,10,1,538,9,1201,654,319,219,3,3940,0
8,"Brasov",42058,83,42058,,"TELIU",477,"TELIU Str. Al.Petofi nr. 344",1143,734,722,12,0,704,30,1300,566,360,344,3,3940,0
8,"Brasov",42058,83,42058,,"TELIU",478,"TELIU Str. T. Vladimirescu nr. 800",734,437,430,7,0,434,3,800,363,187,247,3,3940,0
8,"Brasov",42058,83,42058,,"TELIU",479,"TELIU Str. T. Vladimirescu nr. 499",0,92,0,92,0,89,3,201,109,48,41,3,3940,1
8,"Brasov",42076,83,42076,,"TICUSU",480,"TICUSU VECHI Caminul cultural TICUSU Vechi",544,358,356,1,1,346,12,600,242,182,164,3,3942,0
8,"Brasov",42076,83,42076,,"TICUSU",481,"COBOR Scoala primara COBOR",188,138,127,8,3,138,0,200,62,93,45,3,3942,0
8,"Brasov",42076,83,42076,,"TICUSU",482,"TICUSU VECHI Primaria TICUSU Vechi",0,77,0,77,0,76,1,100,23,66,10,3,3942,1
8,"Brasov",42101,83,42101,,"UCEA",483,"UCEA DE JOS Primaria Comunei  UCEA DE JOS nr. 78",722,316,312,4,0,312,4,800,484,183,129,3,3945,0
8,"Brasov",42101,83,42101,,"UCEA",484,"UCEA DE SUS SC. GENERALA UCEA DE SUS, nr.18",781,439,432,7,0,420,19,901,462,276,144,3,3945,0
8,"Brasov",42101,83,42101,,"UCEA",485,"FELDIOARA Gradinita FELDIOARA nr.9",184,116,110,6,0,113,3,200,84,40,73,3,3945,0
8,"Brasov",42101,83,42101,,"UCEA",486,"CORBI Satul Corbi nr.3",137,88,79,9,0,87,1,200,112,47,40,3,3945,0
8,"Brasov",42101,83,42101,,"UCEA",487,"UCEA DE JOS Primaria Comunei  UCEA DE JOS nr. 78",0,101,0,101,0,99,2,215,114,47,52,3,3945,1
8,"Brasov",42156,83,42156,,"UNGRA",488,"UNGRA Scoala Generala Ungra , corp B, Str. Principala nr. 177",1053,672,665,5,2,663,9,1200,528,242,421,3,3950,0
8,"Brasov",42156,83,42156,,"UNGRA",489,"DAISOARA Gradinita DAISOARA nr.120",547,400,384,8,8,388,12,600,200,46,342,3,3950,0
8,"Brasov",42156,83,42156,,"UNGRA",490,"UNGRA Scoala Generala Ungra , corp B, Str. Principala nr. 177",0,54,0,54,0,51,3,100,46,18,33,3,3950,1
8,"Brasov",42183,83,42183,,"VAMA BUZAULUI",491,"VAMA BUZAULUI CAMINUL CULTURAL VAMA BUZAULUI,str.Principala nr. 425",1361,741,729,7,5,734,7,1500,759,309,425,3,3953,0
8,"Brasov",42183,83,42183,,"VAMA BUZAULUI",492,"ACRIS CAMINUL CULTURAL ACRIS, Str.Principala nr.85",845,523,513,10,0,519,4,900,377,257,262,3,3953,0
8,"Brasov",42183,83,42183,,"VAMA BUZAULUI",493,"BUZAIEL SC. PRIMARA BUZAIEL,DC 49 nr.951",443,214,205,9,0,212,2,500,286,85,127,3,3953,0
8,"Brasov",42183,83,42183,,"VAMA BUZAULUI",494," VAMA BUZAULUI , Str. Principala nr.424",0,75,0,75,0,75,0,101,26,31,44,3,3953,1
8,"Brasov",42236,83,42236,,"VISTEA",495,"VISTEA Primaria Comunei Vistea, Vistea de Jos nr.132",576,271,266,5,0,266,5,600,329,173,93,3,3958,0
8,"Brasov",42236,83,42236,,"VISTEA",496,"VISTEA DE SUS SC. GENERALA VISTEA DE SUS nr.23",516,260,255,5,0,258,2,600,340,172,86,3,3958,0
8,"Brasov",42236,83,42236,,"VISTEA",497,"OLTET SC. GENERALA OLTET nr.24",275,146,135,10,1,146,0,299,153,105,41,3,3958,0
8,"Brasov",42236,83,42236,,"VISTEA",498,"RUCAR SC. GENERALA RUCAR nr.32",323,191,183,8,0,180,11,400,209,139,41,3,3958,0
8,"Brasov",42236,83,42236,,"VISTEA",499,"VISTEA Primaria Comunei Vistea, Vistea de Jos nr.132",0,121,0,121,0,121,0,194,73,87,34,3,3958,1
8,"Brasov",42307,83,42307,,"VOILA",500,"VOILA PRIMARIA VOILA,  Str. Principala nr.124",595,342,327,6,9,336,6,700,358,177,159,3,3964,0
8,"Brasov",42307,83,42307,,"VOILA",501,"CINCSOR Caminul cultural Str. Principala nr. 206",597,311,295,7,9,307,4,700,389,154,153,3,3964,0
8,"Brasov",42307,83,42307,,"VOILA",502,"DRIDIF Caminul cultural  DRIDIF nr.32",324,197,187,10,0,196,1,400,203,101,95,3,3964,0
8,"Brasov",42307,83,42307,,"VOILA",503,"LUDISOR Caminul cultural  LUDISOR  nr. 131",144,80,72,8,0,79,1,200,120,55,24,3,3964,0
8,"Brasov",42307,83,42307,,"VOILA",504,"SAMBATA DE JOS CAMINUL CULTURAL SAMBATA DE  JOS, nr.9",390,181,175,6,0,180,1,500,319,104,76,3,3964,0
8,"Brasov",42307,83,42307,,"VOILA",505,"VOIVODENI CAMINUL CULTURAL VOIVODENI, Str. Principala nr. 72",374,222,207,8,7,218,4,400,178,136,82,3,3964,0
8,"Brasov",42307,83,42307,,"VOILA",506,"VOILA PRIMARIA VOILA, Str. Principala nr.124",0,250,0,250,0,249,1,400,150,106,143,3,3964,1
8,"Brasov",42398,83,42398,,"VULCAN",507,"VULCAN CAMINUL CULTURAL VULCAN nr.305 sala mare",1622,957,940,10,7,950,7,1800,843,582,368,3,3971,0
8,"Brasov",42398,83,42398,,"VULCAN",508,"VULCAN CAMINUL CULTURAL VULCAN nr.305 sala mica",1389,741,730,9,2,721,20,1500,759,489,232,3,3971,0
8,"Brasov",42398,83,42398,,"VULCAN",509,"COLONIA 1 MAI CAMINUL CULTURAL COLONIA 1 MAI nr.34",551,296,286,10,0,295,1,600,304,227,68,3,3971,0
8,"Brasov",42398,83,42398,,"VULCAN",510,"VULCAN CAMINUL CULTURAL VULCAN nr.305 sala mica",0,85,0,85,0,85,0,208,123,52,33,3,3971,1
9,"Braila",42682,92,42682,,"MUNICIPIUL BRAILA",1,"Scoala Generala nr.31 ""Mihai Viteazu"", str.Sebesului nr.6, Cart.Radu Negru",1279,600,588,12,0,594,6,1400,800,295,299,1,3975,0
9,"Braila",42682,92,42682,,"MUNICIPIUL BRAILA",2,"Scoala Generala nr.31 ""Mihai Viteazu"", str.Sebesului nr.6, Cart.Radu Negru",1358,700,684,16,0,699,1,1500,800,334,365,1,3975,0
9,"Braila",42682,92,42682,,"MUNICIPIUL BRAILA",3,"Scoala Generala nr.31 ""Mihai Viteazu"", str.Sebesului nr.6, Cart.Radu Negru",1232,644,615,29,0,637,7,1300,656,245,392,1,3975,0
9,"Braila",42682,92,42682,,"MUNICIPIUL BRAILA",4,"Scoala Generala nr.31 ""Mihai Viteazu"", str.Sebesului nr.6, Cart.Radu Negru",1404,752,745,7,0,745,7,1500,748,343,402,1,3975,0
9,"Braila",42682,92,42682,,"MUNICIPIUL BRAILA",5,"Scoala Generala nr.31 ""Mihai Viteazu"", str.Sebesului nr.6, Cart.Radu Negru",1335,678,671,7,0,675,3,1500,822,274,401,1,3975,0
9,"Braila",42682,92,42682,,"MUNICIPIUL BRAILA",6,"Gradinita nr.61 ""Bobocel"" ,str.Baraganului nr.3",1371,744,729,15,0,739,5,1500,756,326,413,1,3975,0
9,"Braila",42682,92,42682,,"MUNICIPIUL BRAILA",7,"Scoala Generala nr.1 ""Vlaicu Voda"" , str.Chisinau nr.44",1319,739,728,11,0,735,4,1400,661,311,424,1,3975,0
9,"Braila",42682,92,42682,,"MUNICIPIUL BRAILA",8,"Scoala Generala nr.1 ""Vlaicu Voda"" , str.Chisinau nr.44",1533,890,880,10,0,882,8,1700,810,397,485,1,3975,0
9,"Braila",42682,92,42682,,"MUNICIPIUL BRAILA",9,"Gradinita nr.12 "" Sf.Nicolae"", str.Grigore Alexandrescu nr.33",1911,1044,1034,10,0,1033,11,2100,1056,423,610,1,3975,0
9,"Braila",42682,92,42682,,"MUNICIPIUL BRAILA",10,"Gradinita nr.12 "" Sf.Nicolae"", str.Grigore Alexandrescu nr.33",1551,850,832,18,0,837,13,1700,850,347,490,1,3975,0
9,"Braila",42682,92,42682,,"MUNICIPIUL BRAILA",11,"Scoala Generala nr.27 ""Aurel Vlaicu"", Sos.Buzaului nr.86",1474,812,801,11,0,808,4,1600,788,419,389,1,3975,0
9,"Braila",42682,92,42682,,"MUNICIPIUL BRAILA",12,"Scoala Generala nr.27 ""Aurel Vlaicu"", Sos.Buzaului nr.86",1461,761,757,4,0,747,14,1600,839,335,412,1,3975,0
9,"Braila",42682,92,42682,,"MUNICIPIUL BRAILA",13,"Scoala Generala nr.27 ""Aurel Vlaicu"", Sos.Buzaului nr.86",1732,860,853,7,0,855,5,1900,1040,432,423,1,3975,0
9,"Braila",42682,92,42682,,"MUNICIPIUL BRAILA",14,"Scoala Generala nr.27 ""Aurel Vlaicu"", Sos.Buzaului nr.86",1301,614,603,10,1,607,7,1400,786,280,327,1,3975,0
9,"Braila",42682,92,42682,,"MUNICIPIUL BRAILA",15,"Scoala Generala nr.2 ""Fanus Neagu"", Sos.Buzaului nr.10",985,453,443,10,0,451,2,1100,647,238,213,1,3975,0
9,"Braila",42682,92,42682,,"MUNICIPIUL BRAILA",16,"Scoala Generala nr.2 ""Fanus Neagu"", Sos.Buzaului nr.10",1115,656,639,17,0,649,7,1196,540,295,354,1,3975,0
9,"Braila",42682,92,42682,,"MUNICIPIUL BRAILA",17,"Scoala Generala nr.2 ""Fanus Neagu"", Sos.Buzaului nr.10",1274,760,744,16,0,750,10,1400,640,359,391,1,3975,0
9,"Braila",42682,92,42682,,"MUNICIPIUL BRAILA",18,"Scoala Generala nr.2 ""Fanus Neagu"", Sos.Buzaului nr.10",1257,629,621,8,0,623,6,1400,771,273,350,1,3975,0
9,"Braila",42682,92,42682,,"MUNICIPIUL BRAILA",19,"Scoala Generala nr.2 ""Fanus Neagu"", Sos.Buzaului nr.10",1232,616,611,5,0,611,5,1400,784,318,293,1,3975,0
9,"Braila",42682,92,42682,,"MUNICIPIUL BRAILA",20,"Gradinita nr.39  ""Casuta Fermecata"", Al. Cresei nr.1",1441,730,717,13,0,722,8,1600,870,337,385,1,3975,0
9,"Braila",42682,92,42682,,"MUNICIPIUL BRAILA",21,"Gradinita nr.39  ""Casuta Fermecata"", Al. Cresei nr.1",1316,720,710,10,0,713,7,1400,680,337,376,1,3975,0
9,"Braila",42682,92,42682,,"MUNICIPIUL BRAILA",22,"Gradinita nr.39  ""Casuta Fermecata"", Al. Cresei nr.1",1313,637,626,11,0,630,7,1400,763,293,337,1,3975,0
9,"Braila",42682,92,42682,,"MUNICIPIUL BRAILA",23,"Scoala Generala nr.28 ""V. Alecsandri"",  Al.Stiintei nr.2",1328,612,601,11,0,605,7,1500,888,266,339,1,3975,0
9,"Braila",42682,92,42682,,"MUNICIPIUL BRAILA",24,"Scoala Generala nr.28 ""V. Alecsandri"",  Al.Stiintei nr.2",1202,617,606,11,0,612,5,1300,683,285,327,1,3975,0
9,"Braila",42682,92,42682,,"MUNICIPIUL BRAILA",25,"Scoala Generala nr.28 ""V. Alecsandri"",  Al. Stiintei nr.2",1507,838,822,16,0,831,7,1600,762,355,476,1,3975,0
9,"Braila",42682,92,42682,,"MUNICIPIUL BRAILA",26,"Scoala Generala nr.28 ""V. Alecsandri"",  Al. Stiintei nr.2",1383,664,653,11,0,655,9,1500,836,294,361,1,3975,0
9,"Braila",42682,92,42682,,"MUNICIPIUL BRAILA",27,"Scoala Generala nr.28 ""V. Alecsandri"",  Al. Stiintei nr.2",1224,607,599,8,0,603,4,1300,693,244,359,1,3975,0
9,"Braila",42682,92,42682,,"MUNICIPIUL BRAILA",28,"Scoala Generala nr.28 ""V. Alecsandri"",  Al. Stiintei nr.2",966,483,474,9,0,477,6,1098,615,216,261,1,3975,0
9,"Braila",42682,92,42682,,"MUNICIPIUL BRAILA",29,"Gradinita nr.38 ""Iris"", Cart.Viziru III ,Bl.U, Al.Mecanizatorilor nr.2",1266,679,667,11,1,673,6,1298,619,271,402,1,3975,0
9,"Braila",42682,92,42682,,"MUNICIPIUL BRAILA",30,"Scoala Generala nr.29 ""Mihail Sadoveanu"", Al. Cocorilor nr.3",1292,695,680,15,0,692,3,1400,705,279,413,1,3975,0
9,"Braila",42682,92,42682,,"MUNICIPIUL BRAILA",31,"Scoala Generala nr.29 ""Mihail Sadoveanu"", Al. Cocorilor nr.3",1251,551,543,8,0,545,6,1300,749,239,306,1,3975,0
9,"Braila",42682,92,42682,,"MUNICIPIUL BRAILA",32,"Scoala Generala nr.29 ""Mihail Sadoveanu"", Al. Cocorilor nr.3",1373,623,611,12,0,620,3,1500,877,302,318,1,3975,0
9,"Braila",42682,92,42682,,"MUNICIPIUL BRAILA",33,"Scoala Generala nr.29 ""Mihail Sadoveanu"", Al. Cocorilor nr.3",1223,639,628,11,0,632,7,1300,661,297,335,1,3975,0
9,"Braila",42682,92,42682,,"MUNICIPIUL BRAILA",34,"Gradinita nr.53 ""Nu ma uita"", Al.Lebedelor nr.9, cart. Viziru 3",1825,931,916,15,0,921,10,1999,1068,431,490,1,3975,0
9,"Braila",42682,92,42682,,"MUNICIPIUL BRAILA",35,"Grup  Scolar ""Ana Aslan"", Calea Calarasilor nr.307A",1528,810,802,8,0,802,8,1600,790,411,391,1,3975,0
9,"Braila",42682,92,42682,,"MUNICIPIUL BRAILA",36,"Grup  Scolar ""Ana Aslan"", Calea Calarasilor nr.307A",1552,822,811,11,0,815,7,1700,878,411,404,1,3975,0
9,"Braila",42682,92,42682,,"MUNICIPIUL BRAILA",37,"Grup  Scolar ""Ana Aslan"", Calea Calarasilor nr.307A",1353,694,687,7,0,687,7,1399,705,296,391,1,3975,0
9,"Braila",42682,92,42682,,"MUNICIPIUL BRAILA",38,"Grup  Scolar ""Ana Aslan"", Calea Calarasilor nr.307A",1726,715,700,15,0,705,10,1900,1185,342,363,1,3975,0
9,"Braila",42682,92,42682,,"MUNICIPIUL BRAILA",39,"Grup Scolar ""Edmond Nicolau"",Sos.Buzaului nr.2 (Lic. Constructii)",1914,1025,1012,13,0,1016,9,2100,1075,469,547,1,3975,0
9,"Braila",42682,92,42682,,"MUNICIPIUL BRAILA",40,"CUP Dunarea, Piata Uzinei nr.1",1699,852,838,14,0,846,6,1798,946,373,473,1,3975,0
9,"Braila",42682,92,42682,,"MUNICIPIUL BRAILA",41,"Scoala  Generala nr.4  ""Al.I.Cuza"", str.Ghioceilor nr.1",1422,847,836,11,0,838,9,1500,653,398,440,1,3975,0
9,"Braila",42682,92,42682,,"MUNICIPIUL BRAILA",42,"Scoala  Generala nr.4  ""Al.I.Cuza"", str.Ghioceilor nr.1",1485,900,890,10,0,892,8,1600,700,421,471,1,3975,0
9,"Braila",42682,92,42682,,"MUNICIPIUL BRAILA",43,"Scoala  Generala nr.4  ""Al.I.Cuza"", str.Ghioceilor nr.1",1540,908,885,23,0,902,6,1700,792,422,480,1,3975,0
9,"Braila",42682,92,42682,,"MUNICIPIUL BRAILA",44,"Scoala Waldorf, Calea Calarasilor nr.104",1304,786,773,13,0,781,5,1400,614,326,455,1,3975,0
9,"Braila",42682,92,42682,,"MUNICIPIUL BRAILA",45,"Scoala Waldorf, Calea Calarasilor nr.104",1034,634,616,18,0,630,4,1094,460,281,349,1,3975,0
9,"Braila",42682,92,42682,,"MUNICIPIUL BRAILA",46,"Scoala Generala nr.8 ""Ion Bancila"", str. Scolilor nr.60",1401,785,775,9,1,770,15,1500,715,328,442,1,3975,0
9,"Braila",42682,92,42682,,"MUNICIPIUL BRAILA",47,"Scoala Generala nr.8 ""Ion Bancila"", str. Scolilor nr.60",1379,761,745,16,0,753,8,1500,739,365,388,1,3975,0
9,"Braila",42682,92,42682,,"MUNICIPIUL BRAILA",48,"Scoala Generala nr.8 ""Ion Bancila"", str. Scolilor nr.60",1363,755,740,15,0,752,3,1500,745,353,399,1,3975,0
9,"Braila",42682,92,42682,,"MUNICIPIUL BRAILA",49,"Scoala Generala nr.8 ""Ion Bancila"", str. Scolilor nr.60",1486,847,832,15,0,837,10,1600,753,398,439,1,3975,0
9,"Braila",42682,92,42682,,"MUNICIPIUL BRAILA",50,"Liceul  ""Gh. Munteanu Murgoci"",  Bdul.Independentei nr.4",1448,952,933,19,0,940,12,1600,648,432,508,1,3975,0
9,"Braila",42682,92,42682,,"MUNICIPIUL BRAILA",51,"Liceul  ""Gh. Munteanu Murgoci"",  Bdul.Independentei nr.4",1461,830,817,13,0,821,9,1600,770,348,473,1,3975,0
9,"Braila",42682,92,42682,,"MUNICIPIUL BRAILA",52,"Scoala Generala nr.7 ""Ion Creanga"",  str.Scolilor nr.15",1341,771,766,5,0,764,7,1500,729,329,435,1,3975,0
9,"Braila",42682,92,42682,,"MUNICIPIUL BRAILA",53,"Scoala Generala nr.7 ""Ion Creanga"",  str.Scolilor nr.15",1179,696,688,8,0,683,13,1299,603,320,363,1,3975,0
9,"Braila",42682,92,42682,,"MUNICIPIUL BRAILA",54,"Scoala Generala nr.7 ""Ion Creanga"",  str.Scolilor nr.15",1098,637,620,16,1,631,6,1199,562,330,301,1,3975,0
9,"Braila",42682,92,42682,,"MUNICIPIUL BRAILA",55,"Liceul ""N.Iorga"", str. R.S.Campiniu"" nr.4-6",978,473,450,15,8,466,7,1094,621,227,239,1,3975,0
9,"Braila",42682,92,42682,,"MUNICIPIUL BRAILA",56,"Scoala Generala nr.5, str.Rubinelor nr.2",1135,540,526,13,1,537,3,1200,660,300,237,1,3975,0
9,"Braila",42682,92,42682,,"MUNICIPIUL BRAILA",57,"Colegiul National ""Nicolae Balcescu"",  Bdul. Al. I. Cuza nr.182",1661,870,860,10,0,860,10,1800,930,392,468,1,3975,0
9,"Braila",42682,92,42682,,"MUNICIPIUL BRAILA",58,"Liceul de Arta ""Haricleea Darclee"", Bdul. Al. I. Cuza nr.184",1652,851,832,19,0,842,9,1800,949,472,370,1,3975,0
9,"Braila",42682,92,42682,,"MUNICIPIUL BRAILA",59,"Grupul Scolar ""Grigore Moisil"" (fosta Scoala Generala nr.16),  Bdul. Panait Istrati nr.34",1958,1067,1052,14,1,1057,10,2100,1033,540,517,1,3975,0
9,"Braila",42682,92,42682,,"MUNICIPIUL BRAILA",60,"Grupul Scolar ""Grigore Moisil"" (fosta Scoala Generala nr. 25),  Str.Carantina nr.8",1262,832,630,15,187,824,8,1500,668,530,294,1,3975,0
9,"Braila",42682,92,42682,,"MUNICIPIUL BRAILA",61,"Scoala Generala nr.17 ""E. Teodoroiu"", str.Stefan cel Mare nr.475",1401,862,846,16,0,855,7,1500,638,398,457,1,3975,0
9,"Braila",42682,92,42682,,"MUNICIPIUL BRAILA",62,"Scoala Generala nr.17 ""E. Teodoroiu"", str.Stefan cel Mare nr.475",1685,1011,991,20,0,1004,7,1800,789,478,526,1,3975,0
9,"Braila",42682,92,42682,,"MUNICIPIUL BRAILA",63,"Grup Scolar Ind. ""Panait Istrati"", str. Plantelor nr.7",1555,874,868,6,0,860,14,1700,826,414,446,1,3975,0
9,"Braila",42682,92,42682,,"MUNICIPIUL BRAILA",64,"Grup Scolar Ind. ""Panait Istrati"", str. Plantelor nr.7",1028,614,604,9,1,607,7,1098,484,304,303,1,3975,0
9,"Braila",42682,92,42682,,"MUNICIPIUL BRAILA",65,"Grup Scolar Ind. ""Panait Istrati"", str. Plantelor nr.7",1326,694,683,11,0,687,7,1500,806,367,320,1,3975,0
9,"Braila",42682,92,42682,,"MUNICIPIUL BRAILA",66,"Scoala Generala nr.18 ""Mihu Dragomir"", Calea Galati nr.61",1165,650,639,11,0,645,5,1300,650,295,350,1,3975,0
9,"Braila",42682,92,42682,,"MUNICIPIUL BRAILA",67,"Scoala Generala nr.18 ""Mihu Dragomir"", Calea Galati nr.61",1370,741,726,13,2,735,6,1508,767,361,374,1,3975,0
9,"Braila",42682,92,42682,,"MUNICIPIUL BRAILA",68,"Gradinita nr.21 ""Pescarusul"",  str.M. Kogalniceanu nr.10A",1536,830,822,8,0,822,8,1600,770,384,438,1,3975,0
9,"Braila",42682,92,42682,,"MUNICIPIUL BRAILA",69,"Gradinita nr.21 ""Pescarusul"",  str.M. Kogalniceanu nr.10A",1173,574,564,10,0,567,7,1300,726,251,316,1,3975,0
9,"Braila",42682,92,42682,,"MUNICIPIUL BRAILA",70,"Gradinita nr.21 ""Pescarusul"",  str.M. Kogalniceanu nr.10A",1328,676,666,8,2,671,5,1500,824,334,337,1,3975,0
9,"Braila",42682,92,42682,,"MUNICIPIUL BRAILA",71,"Scoala Generala nr.6 ""C.Sandu Aldea"",str.Gral Eremia Grigorescu nr.23",1436,852,846,6,0,842,10,1600,748,381,461,1,3975,0
9,"Braila",42682,92,42682,,"MUNICIPIUL BRAILA",72,"Scoala Generala nr.6 ""C.Sandu Aldea"",str.Gral Eremia Grigorescu nr.23",1438,842,830,12,0,826,16,1600,758,389,437,1,3975,0
9,"Braila",42682,92,42682,,"MUNICIPIUL BRAILA",73,"Scoala Generala nr.6 ""C.Sandu Aldea"",str.Gral Eremia Grigorescu nr.23",1344,795,764,31,0,787,8,1393,598,326,461,1,3975,0
9,"Braila",42682,92,42682,,"MUNICIPIUL BRAILA",74,"Scoala Generala nr.6 ""C.Sandu Aldea"",str.Gral Eremia Grigorescu nr.23",1350,792,783,9,0,786,6,1499,707,394,392,1,3975,0
9,"Braila",42682,92,42682,,"MUNICIPIUL BRAILA",75,"Grupul Scolar ""Anghel Saligny"" (fosta Scoala Generala nr.12), str. G-ral Eremia Grigorescu nr.52",1448,876,853,23,0,865,11,1500,624,386,479,1,3975,0
9,"Braila",42682,92,42682,,"MUNICIPIUL BRAILA",76,"Grupul Scolar ""Anghel Saligny"" (fosta Scoala Generala nr.12), str. G-ral Eremia Grigorescu nr.52",1173,695,683,12,0,690,5,1297,602,340,350,1,3975,0
9,"Braila",42682,92,42682,,"MUNICIPIUL BRAILA",77,"Grupul Scolar ""Anghel Saligny"" (fosta Scoala Generala nr.12), str. G-ral Eremia Grigorescu nr.52",1400,769,755,12,2,757,12,1499,730,372,385,1,3975,0
9,"Braila",42682,92,42682,,"MUNICIPIUL BRAILA",78,"Scoala Generala nr.10 ""Sf. Nicolae"", str.Grivita nr.230",1298,725,697,28,0,716,9,1400,675,347,369,1,3975,0
9,"Braila",42682,92,42682,,"MUNICIPIUL BRAILA",79,"Scoala Generala nr.10 ""Sf. Nicolae"", str.Grivita nr.230",1506,754,740,14,0,748,6,1600,846,373,375,1,3975,0
9,"Braila",42682,92,42682,,"MUNICIPIUL BRAILA",80,"Casa Corpului Didactic, str.Grivita nr.312",1354,729,714,15,0,723,6,1400,671,357,366,1,3975,0
9,"Braila",42682,92,42682,,"MUNICIPIUL BRAILA",81,"Lic. ""Panait Cerna"", Bdul .Dorobantilor nr.311",1320,775,756,19,0,769,6,1389,614,353,416,1,3975,0
9,"Braila",42682,92,42682,,"MUNICIPIUL BRAILA",82,"Lic. ""Panait Cerna"", Bdul .Dorobantilor nr.311",1381,773,764,9,0,763,10,1500,727,323,440,1,3975,0
9,"Braila",42682,92,42682,,"MUNICIPIUL BRAILA",83,"Lic. ""Panait Cerna"", Bdul .Dorobantilor nr.311",1430,754,742,12,0,750,4,1500,746,342,408,1,3975,0
9,"Braila",42682,92,42682,,"MUNICIPIUL BRAILA",84,"Lic. ""Panait Cerna"", Bdul .Dorobantilor nr.311",1325,693,675,18,0,688,5,1400,707,301,387,1,3975,0
9,"Braila",42682,92,42682,,"MUNICIPIUL BRAILA",85,"Scoala Generala nr.32 ""Dimitrie Cantemir"", str.Oborului nr.9",1413,687,674,13,0,680,7,1500,813,283,397,1,3975,0
9,"Braila",42682,92,42682,,"MUNICIPIUL BRAILA",86,"Scoala Generala nr.32 ""Dimitrie Cantemir"", str.Oborului nr.9",1425,738,723,15,0,734,4,1500,762,338,396,1,3975,0
9,"Braila",42682,92,42682,,"MUNICIPIUL BRAILA",87,"Scoala Generala nr.32 ""Dimitrie Cantemir"", str.Oborului nr.9",1437,755,744,10,1,748,7,1500,745,306,442,1,3975,0
9,"Braila",42682,92,42682,,"MUNICIPIUL BRAILA",88,"Scoala Generala nr.32 ""Dimitrie Cantemir"", str.Oborului nr.9",1644,899,889,10,0,890,9,1700,801,393,497,1,3975,0
9,"Braila",42682,92,42682,,"MUNICIPIUL BRAILA",89,"Scoala Generala nr.32 ""Dimitrie Cantemir"", str.Oborului nr.9",1578,880,870,10,0,872,8,1700,820,390,482,1,3975,0
9,"Braila",42682,92,42682,,"MUNICIPIUL BRAILA",90,"Gradinita nr.48 'Luceafarul"", str.Scolilor nr.83",1296,673,665,8,0,670,3,1400,727,311,359,1,3975,0
9,"Braila",42682,92,42682,,"MUNICIPIUL BRAILA",91,"Gradinita nr.48 'Luceafarul"", str.Scolilor nr.83",1451,821,813,8,0,809,12,1600,779,401,408,1,3975,0
9,"Braila",42682,92,42682,,"MUNICIPIUL BRAILA",92,"Gradinita nr.48 'Luceafarul"", str.Scolilor nr.83",1334,773,755,18,0,769,4,1397,624,265,504,1,3975,0
9,"Braila",42682,92,42682,,"MUNICIPIUL BRAILA",93,"Gradinita nr.48 'Luceafarul"", str.Scolilor nr.83",1251,706,694,11,1,691,15,1400,694,316,375,1,3975,0
9,"Braila",42682,92,42682,,"MUNICIPIUL BRAILA",94,"Gradinita nr.37 ,  Al. Trandafirilor nr.3",1282,731,719,12,0,726,5,1400,669,275,451,1,3975,0
9,"Braila",42682,92,42682,,"MUNICIPIUL BRAILA",95,"Gradinita nr.37 ,  Al. Trandafirilor nr.3",1406,835,821,14,0,825,10,1600,765,348,477,1,3975,0
9,"Braila",42682,92,42682,,"MUNICIPIUL BRAILA",96,"Scoala Generala nr.3 ""Spiru Haret"", Al. Parcului nr.2",1520,843,820,23,0,835,8,1600,757,367,468,1,3975,0
9,"Braila",42682,92,42682,,"MUNICIPIUL BRAILA",97,"Liceul cu Program Sportiv, Al. Parcului nr.7",1520,665,647,18,0,660,5,1596,931,314,346,1,3975,0
9,"Braila",42682,92,42682,,"MUNICIPIUL BRAILA",98,"Liceul cu Program Sportiv, Al. Parcului nr.7",1118,505,494,11,0,500,5,1200,695,219,281,1,3975,0
9,"Braila",42682,92,42682,,"MUNICIPIUL BRAILA",99,"Liceul Pedagogic ""D.P.Perpessicius"", Al.Invatatorilor nr.10",1693,956,944,12,0,949,7,1800,844,388,561,1,3975,0
9,"Braila",42682,92,42682,,"MUNICIPIUL BRAILA",100,"Liceul Pedagogic ""D.P.Perpessicius"", Al.Invatatorilor nr.10",1643,1007,991,16,0,998,9,1700,693,391,607,1,3975,0
9,"Braila",42682,92,42682,,"MUNICIPIUL BRAILA",101,"Scoala  Generala nr.23 ""Mihail Eminescu"", Al.Cutezatorilor nr.2",1368,765,743,22,0,760,5,1399,634,312,448,1,3975,0
9,"Braila",42682,92,42682,,"MUNICIPIUL BRAILA",102,"Scoala Generala Nr. 9, Str. Dorului nr.38",1097,545,536,9,0,535,10,1198,653,264,271,1,3975,0
9,"Braila",42682,92,42682,,"MUNICIPIUL BRAILA",103,"Scoala Generala Nr. 9, Str. Dorului nr.38",1147,547,540,7,0,537,10,1200,653,270,267,1,3975,0
9,"Braila",42682,92,42682,,"MUNICIPIUL BRAILA",104,"Scoala Generala Nr. 9, Str. Dorului nr.38",1199,592,583,9,0,587,5,1300,708,289,298,1,3975,0
9,"Braila",42682,92,42682,,"MUNICIPIUL BRAILA",105,"Scoala Generala Nr. 9, Str. Dorului nr.38",1077,499,484,13,2,493,6,1200,701,260,233,1,3975,0
9,"Braila",42682,92,42682,,"MUNICIPIUL BRAILA",106,"Scoala Generala Nr. 13, Str. Deva nr.11",1387,713,699,14,0,701,12,1500,787,363,338,1,3975,0
9,"Braila",42682,92,42682,,"MUNICIPIUL BRAILA",107,"Scoala Generala Nr. 13, Str. Deva nr.11",1364,736,726,10,0,728,8,1500,764,335,393,1,3975,0
9,"Braila",42682,92,42682,,"MUNICIPIUL BRAILA",108,"Scoala Generala nr.22 , Sos. Focsani nr.35",1431,743,731,12,0,735,8,1500,757,299,436,1,3975,0
9,"Braila",42682,92,42682,,"MUNICIPIUL BRAILA",109,"Scoala Generala nr.22 , Sos. Focsani nr.35",1457,745,731,14,0,739,6,1600,855,323,416,1,3975,0
9,"Braila",42682,92,42682,,"MUNICIPIUL BRAILA",110,"Scoala Generala nr.22 , Sos. Focsani nr.35",1295,666,657,9,0,660,6,1400,734,325,335,1,3975,0
9,"Braila",42682,92,42682,,"MUNICIPIUL BRAILA",111,"Scoala Generala nr.22 , Sos. Focsani nr.35",1299,695,685,10,0,690,5,1398,703,276,414,1,3975,0
9,"Braila",42682,92,42682,,"MUNICIPIUL BRAILA",112,"Scoala Generala nr.22 , Sos. Focsani nr.35",1275,665,654,11,0,653,12,1399,734,302,351,1,3975,0
9,"Braila",42682,92,42682,,"MUNICIPIUL BRAILA",113,"Camin Cultural, Str. Comuna din Paris nr.95",1441,722,703,19,0,714,8,1500,778,323,391,1,3975,0
9,"Braila",42682,92,42682,,"MUNICIPIUL BRAILA",114,"Scoala Generala nr.24 , str.Carabusului nr.22",1415,692,683,9,0,687,5,1500,808,324,363,1,3975,0
9,"Braila",42682,92,42682,,"MUNICIPIUL BRAILA",115,"Scoala Generala nr.24 , str.Carabusului nr.22",1567,749,738,11,0,738,11,1600,851,333,405,1,3975,0
9,"Braila",42682,92,42682,,"MUNICIPIUL BRAILA",116,"Scoala Generala nr.24 , str.Carabusului nr.22",1203,652,645,7,0,648,4,1300,648,340,308,1,3975,0
9,"Braila",42682,92,42682,,"MUNICIPIUL BRAILA",117,"SC AISE Electroserv, Sos.Baldovinesti nr.12",1570,744,723,21,0,735,9,1700,956,380,355,1,3975,0
9,"Braila",42682,92,42682,,"MUNICIPIUL BRAILA",118,"Gradinita nr.28 'Palatul de clestar"", str.Progresului nr.9",1395,712,704,7,1,708,4,1495,783,318,390,1,3975,0
9,"Braila",42682,92,42682,,"MUNICIPIUL BRAILA",119,"Gradinita nr.28 'Palatul de clestar"", str.Progresului nr.9",1392,714,700,14,0,705,9,1500,786,329,376,1,3975,0
9,"Braila",42682,92,42682,,"MUNICIPIUL BRAILA",120,"Scoala Generala nr.11 ""I. L. Caragiale"", str.Progresului nr.7",1265,695,686,9,0,684,11,1300,605,326,358,1,3975,0
9,"Braila",42682,92,42682,,"MUNICIPIUL BRAILA",121,"Scoala Generala nr.11 ""I. L. Caragiale"", str.Progresului nr.7",1411,675,663,11,1,670,5,1500,825,357,313,1,3975,0
9,"Braila",42682,92,42682,,"MUNICIPIUL BRAILA",122,"Scoala Generala nr.19 ""Mihail Kogalniceanu"" ,str.C. Negruzzi nr.76",1436,758,742,16,0,750,8,1500,742,408,342,1,3975,0
9,"Braila",42682,92,42682,,"MUNICIPIUL BRAILA",123,"Scoala Generala nr.19 ""Mihail Kogalniceanu"" ,str.C. Negruzzi nr.76",1334,651,642,9,0,641,10,1400,749,301,340,1,3975,0
9,"Braila",42682,92,42682,,"MUNICIPIUL BRAILA",124,"Scoala Generala nr.19 ""Mihail Kogalniceanu"" ,str.C. Negruzzi nr.76",1441,770,761,9,0,763,7,1500,730,384,379,1,3975,0
9,"Braila",42682,92,42682,,"MUNICIPIUL BRAILA",125,"Scoala Generala nr.19 ""Mihail Kogalniceanu"" ,str.C. Negruzzi nr.76",1280,624,593,31,0,618,6,1394,770,300,318,1,3975,0
9,"Braila",42682,92,42682,,"MUNICIPIUL BRAILA",126,"Scoala Generala nr.21,str.Targovistei nr.28",1312,630,615,15,0,625,5,1410,780,373,252,1,3975,0
9,"Braila",42682,92,42682,,"MUNICIPIUL BRAILA",127,"Scoala Generala nr.21,str.Targovistei nr.28",1402,668,652,16,0,659,9,1500,832,387,272,1,3975,0
9,"Braila",42682,92,42682,,"MUNICIPIUL BRAILA",128,"Scoala Generala nr.20 ""George Cosbuc"", str.Ulmului nr.20",1552,846,830,16,0,836,10,1600,754,383,453,1,3975,0
9,"Braila",42682,92,42682,,"MUNICIPIUL BRAILA",129,"Scoala Generala nr.20 ""George Cosbuc"", str.Ulmului nr.20",1360,708,702,6,0,700,8,1500,792,317,383,1,3975,0
9,"Braila",42682,92,42682,,"MUNICIPIUL BRAILA",130,"Scoala Generala nr.20 ""George Cosbuc"", str.Ulmului nr.20",1540,817,803,14,0,810,7,1600,783,372,438,1,3975,0
9,"Braila",42682,92,42682,,"MUNICIPIUL BRAILA",131,"Grup Scolar Industrial ""C-tin Brancoveanu"" , Calea Galati nr.346 bis",1174,593,586,7,0,587,6,1300,707,293,294,1,3975,0
9,"Braila",42682,92,42682,,"MUNICIPIUL BRAILA",132,"Grup Scolar Industrial ""C-tin Brancoveanu"" , Calea Galati nr.346 bis",1451,718,707,11,0,709,9,1500,782,347,362,1,3975,0
9,"Braila",42682,92,42682,,"MUNICIPIUL BRAILA",133,"Grup Scolar Industrial ""C-tin Brancoveanu"" , Calea Galati nr.346 bis",1628,806,776,30,0,801,5,1700,894,373,428,1,3975,0
9,"Braila",42682,92,42682,,"MUNICIPIUL BRAILA",134,"Grup Scolar Industrial ""C-tin Brancoveanu"" , Calea Galati nr.346 bis",1386,739,725,14,0,733,6,1500,761,345,388,1,3975,0
9,"Braila",42682,92,42682,,"MUNICIPIUL BRAILA",135,"Grup Scolar Industrial ""C-tin Brancoveanu"" , Calea Galati nr.346 bis",1327,625,619,6,0,618,7,1400,775,316,302,1,3975,0
9,"Braila",42682,92,42682,,"MUNICIPIUL BRAILA",136,"Scoala Genearala nr.33 ""Sf. Andrei"",  str.Dudului nr.2",1195,652,640,12,0,642,10,1300,648,379,263,1,3975,0
9,"Braila",42682,92,42682,,"MUNICIPIUL BRAILA",137,"Scoala Genearala nr.33 ""Sf. Andrei"",  str.Dudului nr.2",1505,744,736,8,0,738,6,1600,856,371,367,1,3975,0
9,"Braila",42682,92,42682,,"MUNICIPIUL BRAILA",138,"Scoala Genearala nr.33 ""Sf. Andrei"",  str.Dudului nr.2",1315,720,711,8,1,709,11,1400,680,315,394,1,3975,0
9,"Braila",42682,92,42682,,"MUNICIPIUL BRAILA",139,"KM 10 (Punct de lucru al SC Drumuri si Poduri)",363,176,160,16,0,174,2,500,324,83,91,1,3975,0
9,"Braila",42682,92,42682,,"MUNICIPIUL BRAILA",140,"Gara CFR , Str.Eremia Grigorescu nr.1",0,824,0,824,0,812,12,999,175,457,355,1,3975,1
9,"Braila",42682,92,42682,,"MUNICIPIUL BRAILA",141,"Autogara, Str.Siret nr.10",0,182,0,182,0,179,3,400,218,84,95,1,3975,1
9,"Braila",42682,92,42682,,"MUNICIPIUL BRAILA",142,"Statiunea Lacu Sarat",0,278,0,278,0,271,7,402,124,97,174,1,3975,1
9,"Braila",42682,92,42682,,"MUNICIPIUL BRAILA",143,"Spitalul Judetean, Corp A, Soseaua Buzaului nr.2",0,254,0,254,0,252,2,400,146,111,141,1,3975,1
9,"Braila",42682,92,42682,,"MUNICIPIUL BRAILA",144,"Spitalul Judetean, Corp B, Str. Pietatii nr.1",0,215,0,215,0,212,3,401,186,100,112,1,3975,1
9,"Braila",42682,92,42682,,"MUNICIPIUL BRAILA",145,"Spitalul de Obstetrica si Ginecologie, B-dul Independentei nr.1",0,68,0,68,0,68,0,201,133,42,26,1,3975,1
9,"Braila",42753,92,42753,,"ORAS FAUREI",146,"Casa de Cultura, str.Republicii nr.44",1611,849,844,5,0,841,8,1700,851,335,506,1,3977,0
9,"Braila",42753,92,42753,,"ORAS FAUREI",147,"Scoala Generala nr.1, str.Republicii nr.48",1446,782,773,9,0,778,4,1598,816,339,439,1,3977,0
9,"Braila",42753,92,42753,,"ORAS FAUREI",148,"Scoala Generala nr.2, str.Baraganului nr.27",541,288,279,9,0,287,1,600,312,103,184,1,3977,0
9,"Braila",42753,92,42753,,"ORAS FAUREI",149,"Gara CFR",0,138,0,138,0,134,4,400,262,56,78,1,3977,1
9,"Braila",43331,92,43331,,"ORAS IANCA",150,"Scoala Generala cl. 1-8, str.Sarateni nr.28 , Ianca",1144,566,560,6,0,563,3,1400,834,231,332,1,3979,0
9,"Braila",43331,92,43331,,"ORAS IANCA",151,"Scoala Generala cl. 1-8, str.Sarateni nr.28 , Ianca",1290,603,597,5,1,601,2,1296,693,283,318,1,3979,0
9,"Braila",43331,92,43331,,"ORAS IANCA",152,"Casa de Cultura Ion Teodorescu Sion,  Calea Brailei nr.35  ,Ianca",1196,614,596,15,3,609,5,1200,586,262,347,1,3979,0
9,"Braila",43331,92,43331,,"ORAS IANCA",153,"Liceul Teoretic Constantin Angelescu , Calea Brailei nr.167 ,Ianca",1084,558,546,12,0,551,7,1199,641,232,319,1,3979,0
9,"Braila",43331,92,43331,,"ORAS IANCA",154,"Liceul Teoretic Constantin Angelescu , Calea Brailei nr.167 ,Ianca",915,493,486,5,2,488,5,997,504,246,242,1,3979,0
9,"Braila",43331,92,43331,,"ORAS IANCA",155,"Scoala Generala  1-8 , Sat Plopu",1296,655,645,10,0,645,10,1400,745,268,377,1,3979,0
9,"Braila",43331,92,43331,,"ORAS IANCA",156,"Scoala Generala  1-8 ,Sat Oprisenesti",662,313,297,14,2,308,5,700,387,147,161,1,3979,0
9,"Braila",43331,92,43331,,"ORAS IANCA",157,"Scoala Generala  1-8 ,Sat Perisoru",925,518,507,11,0,515,3,992,474,202,313,1,3979,0
9,"Braila",43331,92,43331,,"ORAS IANCA",158,"Scoala Generala 1-4 , Tarlele Filiu",513,279,266,13,0,274,5,600,321,92,182,1,3979,0
9,"Braila",43331,92,43331,,"ORAS IANCA",159,"Scoala Generala 1-4 , Sat Berlesti",297,176,165,11,0,174,2,300,124,76,98,1,3979,0
9,"Braila",43331,92,43331,,"ORAS IANCA",160,"Liceul teoretic Constantin Angelescu, Calea Brailei nr.167",0,173,0,173,0,171,2,300,127,78,93,1,3979,1
9,"Braila",43411,92,43411,,"ORAS INSURATEI",161,"Scoala  cl. 1-8 Locatia 1 Insuratei , str.Lacu Rezii nr.92",1117,518,506,12,0,504,14,1200,682,216,288,1,3987,0
9,"Braila",43411,92,43411,,"ORAS INSURATEI",162,"Scoala  cl. 1-8 Locatia 1 Insuratei , str.Lacu Rezii nr.92",1008,493,484,9,0,483,10,1100,607,223,260,1,3987,0
9,"Braila",43411,92,43411,,"ORAS INSURATEI",163,"Scoala Anexa a Grupului Scolar Industrial Insuratei, str. Scoala Veche nr.9",1020,498,486,12,0,492,6,1199,701,238,254,1,3987,0
9,"Braila",43411,92,43411,,"ORAS INSURATEI",164,"Scoala Anexa a Grupului Scolar Industrial Insuratei, str. Scoala Veche nr.9",1084,481,475,6,0,469,12,1198,717,208,261,1,3987,0
9,"Braila",43411,92,43411,,"ORAS INSURATEI",165,"Scoala  cl. 1-8 , Locatia 2 Insuratei  ,str.N.Balcescu nr.5",1322,643,626,17,0,632,11,1397,754,261,371,1,3987,0
9,"Braila",43411,92,43411,,"ORAS INSURATEI",166,"Scoala Generala -  Lacu Rezii",423,229,221,8,0,223,6,501,272,120,103,1,3987,0
9,"Braila",43411,92,43411,,"ORAS INSURATEI",167,"Scoala Anexa a Grupului Scolar Industrial Insuratei, str. Scoala Veche nr.9",0,96,0,96,0,96,0,201,105,44,52,1,3987,1
9,"Braila",42824,92,42824,,"BARAGANUL",168,"Camin Cultural Baraganul",1805,907,900,7,0,896,11,2000,1093,269,627,3,3992,0
9,"Braila",42824,92,42824,,"BARAGANUL",169,"Scoala Generala nr.1 corp cladire Radu Voda  com. Baraganul",949,488,484,4,0,478,10,1000,512,150,328,3,3992,0
9,"Braila",42824,92,42824,,"BARAGANUL",170,"Camin Cultural Baraganul",0,83,0,83,0,83,0,201,118,39,44,3,3992,1
9,"Braila",42842,92,42842,,"BERTESTII DE JOS",171,"Caminul Cultural  Bertestii de Jos",709,326,322,4,0,316,10,832,506,62,254,3,3994,0
9,"Braila",42842,92,42842,,"BERTESTII DE JOS",172,"Caminul Cultural Spiru Haret",1239,691,682,9,0,677,14,1298,607,326,351,3,3994,0
9,"Braila",42842,92,42842,,"BERTESTII DE JOS",173,"Caminul Cultural Bertestii de Sus",287,167,162,5,0,165,2,300,133,54,111,3,3994,0
9,"Braila",42842,92,42842,,"BERTESTII DE JOS",174,"Scoala Generala 1-4 Gura Calmatui",286,166,160,6,0,164,2,300,134,57,107,3,3994,0
9,"Braila",42842,92,42842,,"BERTESTII DE JOS",175,"Caminul Cultural  Bertestii de Jos",0,54,0,54,0,53,1,200,146,22,31,3,3994,1
9,"Braila",42913,92,42913,,"BORDEI VERDE",176,"Scoala Generala 1-8 Bordei Verde",1234,778,775,2,1,771,7,1397,619,357,414,3,4001,0
9,"Braila",42913,92,42913,,"BORDEI VERDE",177,"Sc.cu clasele 1-4 , Sat C.Gabrielescu",647,440,429,11,0,433,7,700,260,248,185,3,4001,0
9,"Braila",42913,92,42913,,"BORDEI VERDE",178,"Scoala Generala 1-4 , Sat Liscoteanca",449,299,289,10,0,296,3,501,202,149,147,3,4001,0
9,"Braila",42913,92,42913,,"BORDEI VERDE",179,"Scoala Generala 1-8 Bordei Verde",0,105,0,105,0,105,0,300,195,57,48,3,4001,1
9,"Braila",44560,92,44560,,"CAZASU",180,"Sc.clase 1-4  Cazasu Nou  (Satuc)",890,494,431,63,0,490,4,997,503,240,250,3,4006,0
9,"Braila",44560,92,44560,,"CAZASU",181,"Sc.clase 1-8  Cazasu Vechi",1682,933,877,50,6,917,16,1800,867,433,484,3,4006,0
9,"Braila",44560,92,44560,,"CAZASU",182,"Sc.clase 1-4  Cazasu ,Str. Principala nr. 17",0,55,0,55,0,55,0,200,145,27,28,3,4006,1
9,"Braila",42708,92,42708,,"CHISCANI",183,"Scoala Generala 1-8 Chiscani - centru",1488,624,614,10,0,613,11,1600,976,323,290,3,4008,0
9,"Braila",42708,92,42708,,"CHISCANI",184,"Scoala Generala 1-4 Chiscani- cartier",1760,808,790,18,0,797,11,2000,1192,461,336,3,4008,0
9,"Braila",42708,92,42708,,"CHISCANI",185,"Scoala Generala  1-4 Lacu Sarat",1267,603,595,8,0,595,8,1300,697,255,340,3,4008,0
9,"Braila",42708,92,42708,,"CHISCANI",186,"Scoala Generala 1-4 Chiscani- cartier ,Str. Vasile Alexandri, nr.15",0,61,0,61,0,61,0,300,239,38,23,3,4008,1
9,"Braila",42968,92,42968,,"CIOCILE",187,"Caminul Cultural Ciocile Sala mica",1840,1093,1089,4,0,1078,15,2000,907,451,627,3,4012,0
9,"Braila",42968,92,42968,,"CIOCILE",188,"Scoala Generala  Sat Chichinetu",548,301,293,8,0,297,4,601,300,104,193,3,4012,0
9,"Braila",42968,92,42968,,"CIOCILE",189,"Scoala Alexandru Turtoi Ciocile",0,75,0,75,0,75,0,200,125,25,50,3,4012,1
9,"Braila",43019,92,43019,,"CIRESU",190,"Scoala Generala 1-8 Ciresu",831,458,453,5,0,455,3,998,540,260,195,3,4017,0
9,"Braila",43019,92,43019,,"CIRESU",191,"Scoala Generala 1-8 Batogu",579,283,278,5,0,281,2,600,317,103,178,3,4017,0
9,"Braila",43019,92,43019,,"CIRESU",192,"Scoala Generala 1-8 Scarlatesti",770,440,435,5,0,431,9,897,457,230,201,3,4017,0
9,"Braila",43019,92,43019,,"CIRESU",193,"Scoala Generala 1-8 Vultureni",525,316,312,4,0,311,5,600,284,143,168,3,4017,0
9,"Braila",43019,92,43019,,"CIRESU",194,"Caminul Cultural Ciresu",0,55,0,55,0,55,0,202,147,25,30,3,4017,1
9,"Braila",43073,92,43073,,"DUDESTI",195,"Scoala Generala 1-8 Dudesti",1425,781,761,20,0,773,8,1600,819,246,527,3,4023,0
9,"Braila",43073,92,43073,,"DUDESTI",196,"Scoala Generala 5-8 Tataru",1706,992,978,14,0,976,16,1800,808,279,697,3,4023,0
9,"Braila",43073,92,43073,,"DUDESTI",197,"Scoala Generala 1-8 Dudesti",0,104,0,104,0,104,0,200,96,38,66,3,4023,1
9,"Braila",43117,92,43117,,"FRECATEI",198,"Scoala Generala Agaua",429,277,266,9,2,276,1,500,223,143,133,3,4027,0
9,"Braila",43117,92,43117,,"FRECATEI",199,"Scoala Generala Frecatei",318,193,185,8,0,191,2,400,207,77,114,3,4027,0
9,"Braila",43117,92,43117,,"FRECATEI",200,"Scoala Generala Titcov",407,224,217,7,0,223,1,500,276,122,101,3,4027,0
9,"Braila",43117,92,43117,,"FRECATEI",201,"Scoala Generala Frecatei",0,48,0,48,0,47,1,200,152,16,31,3,4027,1
9,"Braila",43180,92,43180,,"GALBENU",202,"Scoala Generala 1-8 Galbenu",862,458,447,9,2,453,5,1000,542,101,352,3,4034,0
9,"Braila",43180,92,43180,,"GALBENU",203,"Scoala Generala Satuc",606,275,271,4,0,270,5,700,425,87,183,3,4034,0
9,"Braila",43180,92,43180,,"GALBENU",204,"Scoala Generala  Pintecani",143,102,94,8,0,101,1,200,98,37,64,3,4034,0
9,"Braila",43180,92,43180,,"GALBENU",205,"Caminul Cultural Zamfiresti",319,221,213,8,0,219,2,400,179,36,183,3,4034,0
9,"Braila",43180,92,43180,,"GALBENU",206,"Scoala Generala Drogu",711,378,373,5,0,368,10,798,420,91,277,3,4034,0
9,"Braila",43180,92,43180,,"GALBENU",207,"Gradinita de copii Galbenu",0,74,0,74,0,74,0,200,126,20,54,3,4034,1
9,"Braila",43242,92,43242,,"GEMENELE",208,"Scoala Generala 1-8 Gemenele",1513,850,843,7,0,824,26,1600,750,268,556,3,4040,0
9,"Braila",43242,92,43242,,"GEMENELE",209,"Scoala Generala 1-8 Gemenele",0,46,0,46,0,45,1,202,156,11,34,3,4040,1
9,"Braila",43279,92,43279,,"GRADISTEA",210,"Camin Cultural  Gradistea - Sala Mica",1063,554,543,11,0,537,17,1100,546,232,305,3,4043,0
9,"Braila",43279,92,43279,,"GRADISTEA",211,"Scoala Generala Ibrianu",630,281,277,4,0,271,10,700,419,105,166,3,4043,0
9,"Braila",43279,92,43279,,"GRADISTEA",212,"Scoala Generala Maraloiu",271,152,148,4,0,150,2,300,148,45,105,3,4043,0
9,"Braila",43279,92,43279,,"GRADISTEA",213,"Camin Cultural  Gradistea- Sala Mare",0,90,0,90,0,90,0,200,110,44,46,3,4043,1
9,"Braila",43313,92,43313,,"GROPENI",214,"Scoala de Arte si Meserii Gropeni",1102,587,563,24,0,570,17,1200,613,349,221,3,4047,0
9,"Braila",43313,92,43313,,"GROPENI",215,"Camin Cultural Gropeni",1757,984,955,29,0,963,21,1900,916,594,369,3,4047,0
9,"Braila",43313,92,43313,,"GROPENI",216,"Camin Cultural Gropeni",0,93,0,93,0,92,1,200,107,51,41,3,4047,1
9,"Braila",43466,92,43466,,"JIRLAU",217,"Camin Cultural  Jirlau, str.Rm.Sarat nr.105",1027,551,549,2,0,540,11,1100,549,230,310,3,4049,0
9,"Braila",43466,92,43466,,"JIRLAU",218,"Scoala  nr.1 ,mare ,com.Jirlau, str.Rm.Sarat nr.104",1619,854,841,13,0,843,11,1700,846,439,404,3,4049,0
9,"Braila",43466,92,43466,,"JIRLAU",219,"Sediul Consiliului Local Jirlau, str. Rm. Sarat nr. 110",0,91,0,91,0,91,0,200,109,37,54,3,4049,1
9,"Braila",43493,92,43493,,"MARASU",220,"Camin Cultural Marasu",833,508,497,11,0,496,12,900,392,224,272,3,4052,0
9,"Braila",43493,92,43493,,"MARASU",221,"Scoala Generala Bandoiu",377,227,215,12,0,224,3,503,276,129,95,3,4052,0
9,"Braila",43493,92,43493,,"MARASU",222,"Scoala Generala Tacau",642,360,356,4,0,359,1,700,340,252,107,3,4052,0
9,"Braila",43493,92,43493,,"MARASU",223,"Camin Cultural  Magureni",449,297,284,13,0,294,3,500,203,204,90,3,4052,0
9,"Braila",43493,92,43493,,"MARASU",224,"Scoala Generala Plopi",181,127,115,12,0,126,1,200,73,90,36,3,4052,0
9,"Braila",43493,92,43493,,"MARASU",225,"Camin Cultural Marasu , Punct informatii",0,74,0,74,0,73,1,200,126,44,29,3,4052,1
9,"Braila",43563,92,43563,,"MAXINENI",226,"Scoala Generala Maxineni, str. Preot Postolache Ilie nr.32",1285,736,700,8,28,726,10,1399,663,344,382,3,4059,0
9,"Braila",43563,92,43563,,"MAXINENI",227,"Caminul Cultural Corbu Nou, str.Republicii nr.22",727,415,393,9,13,402,13,796,381,122,280,3,4059,0
9,"Braila",43563,92,43563,,"MAXINENI",228,"Caminul Cultural Corbu Vechi, str.Culturii nr.16",243,172,163,9,0,169,3,301,129,71,98,3,4059,0
9,"Braila",43563,92,43563,,"MAXINENI",229,"Caminul Cultural Latinu, Sos. Focsani nr.28",631,303,295,8,0,299,4,700,397,103,196,3,4059,0
9,"Braila",43563,92,43563,,"MAXINENI",230,"Liceul Matei Basarab Maxineni, str. Preot Postolache Ilie nr.32",0,105,0,105,0,104,1,200,95,45,59,3,4059,1
9,"Braila",43625,92,43625,,"MIRCEA VODA",231,"Scoala Generala nr.1 Mircea Voda",983,498,490,8,0,491,7,1100,602,213,278,3,4065,0
9,"Braila",43625,92,43625,,"MIRCEA VODA",232,"Scoala Generala nr.1 Mircea Voda",1022,500,467,33,0,487,13,1100,600,256,231,3,4065,0
9,"Braila",43625,92,43625,,"MIRCEA VODA",233,"Scoala Generala Dedulesti",763,361,358,3,0,357,4,798,437,108,249,3,4065,0
9,"Braila",43625,92,43625,,"MIRCEA VODA",234,"Scoala Generala nr.1 Mircea Voda",0,83,0,83,0,82,1,202,119,41,41,3,4065,1
9,"Braila",43652,92,43652,,"MOVILA MIRESII",235,"Scoala Veche Movila Miresii",1232,699,668,31,0,683,16,1300,601,200,483,3,4068,0
9,"Braila",43652,92,43652,,"MOVILA MIRESII",236,"Caminul Cultural Movila Miresii",1229,763,733,30,0,751,12,1300,537,160,591,3,4068,0
9,"Braila",43652,92,43652,,"MOVILA MIRESII",237,"Scoala Generala  Sat Tepes Voda",746,432,418,14,0,425,7,800,368,138,287,3,4068,0
9,"Braila",43652,92,43652,,"MOVILA MIRESII",238,"Scoala Generala Sat Esna",254,194,170,24,0,188,6,300,106,35,153,3,4068,0
9,"Braila",43652,92,43652,,"MOVILA MIRESII",239,"Scoala cu clasele 1-4 Movila Miresii, strada III nr. 499",0,94,0,94,0,93,1,300,206,28,65,3,4068,1
9,"Braila",43698,92,43698,,"RACOVITA",240,"Clubul Caminului Cultural Racovita",1042,578,577,1,0,569,9,1100,522,143,426,3,4072,0
9,"Braila",43698,92,43698,,"RACOVITA",241,"Caminul Cultural Racovita - cabinet director",0,41,0,41,0,41,0,200,159,20,21,3,4072,1
9,"Braila",43732,92,43732,,"RAMNICELU",242,"Scoala Generala 1-8 Ramnicelu",1192,615,603,12,0,607,8,1300,685,213,394,3,4076,0
9,"Braila",43732,92,43732,,"RAMNICELU",243,"Scoala Generala 1-4  Constantinesti",295,158,148,10,0,154,4,400,242,37,117,3,4076,0
9,"Braila",43732,92,43732,,"RAMNICELU",244,"Scoala Generala 1-4 M.Kogalniceanu",231,145,126,19,0,143,2,299,154,37,106,3,4076,0
9,"Braila",43732,92,43732,,"RAMNICELU",245,"Scoala Generala 1-8 Ramnicelu",0,57,0,57,0,56,1,200,143,28,28,3,4076,1
9,"Braila",43787,92,43787,,"ROMANU",246,"Scoala Generala 1-8 Romanu",1238,601,590,11,0,592,9,1300,699,172,420,3,4081,0
9,"Braila",43787,92,43787,,"ROMANU",247,"Scoala Generala 1-4  Oancea",349,175,167,8,0,173,2,400,225,76,97,3,4081,0
9,"Braila",43787,92,43787,,"ROMANU",248,"Scoala Generala 1-8 Romanu",0,44,0,44,0,43,1,200,156,23,20,3,4081,1
9,"Braila",43812,92,43812,,"ROSIORI",249,"Scoala Generala Rosiori",1403,784,771,13,0,765,19,1500,716,219,546,3,4084,0
9,"Braila",43812,92,43812,,"ROSIORI",250,"Scoala Generala Coltea",907,516,505,11,0,510,6,1000,484,102,408,3,4084,0
9,"Braila",43812,92,43812,,"ROSIORI",251,"Scoala Generala Rosiori",0,82,0,82,0,80,2,300,218,32,48,3,4084,1
9,"Braila",43867,92,43867,,"SALCIA TUDOR",252,"Camin Cultural Salcia Tudor",624,394,383,11,0,392,2,700,306,175,217,3,4089,0
9,"Braila",43867,92,43867,,"SALCIA TUDOR",253,"Scoala Generala Cuza Voda",804,426,418,8,0,416,10,899,473,163,253,3,4089,0
9,"Braila",43867,92,43867,,"SALCIA TUDOR",254,"Camin Cultural Gulianca",370,216,206,10,0,213,3,500,284,130,83,3,4089,0
9,"Braila",43867,92,43867,,"SALCIA TUDOR",255,"Camin Cultural Olaneasca",360,173,164,9,0,169,4,400,227,60,109,3,4089,0
9,"Braila",43867,92,43867,,"SALCIA TUDOR",256,"Camin Cultural Ariciu",139,100,90,10,0,97,3,200,100,41,56,3,4089,0
9,"Braila",43867,92,43867,,"SALCIA TUDOR",257,"Camin Cultural Gulianca",0,42,0,42,0,41,1,200,158,15,26,3,4089,1
9,"Braila",43929,92,43929,,"SCORTARU NOU",258,"Scoala Generala Scortaru Nou",700,347,344,3,0,335,12,801,454,93,242,3,4095,0
9,"Braila",43929,92,43929,,"SCORTARU NOU",259,"Scoala Generala Sat Sihleanu",429,215,210,5,0,209,6,500,285,64,145,3,4095,0
9,"Braila",43929,92,43929,,"SCORTARU NOU",260,"Scoala cu clasele 1-8 Scortaru Nou",0,78,0,78,0,78,0,200,122,25,53,3,4095,1
9,"Braila",43992,92,43992,,"SILISTEA",261,"Scoala Generala  Silistea",877,509,499,10,0,504,4,894,385,220,284,3,4102,0
9,"Braila",43992,92,43992,,"SILISTEA",262,"Scoala Generala  Muchea",328,248,239,9,0,247,1,401,153,187,60,3,4102,0
9,"Braila",43992,92,43992,,"SILISTEA",263,"Scoala Generala  Cotu Lung",262,153,150,3,0,152,1,300,147,71,81,3,4102,0
9,"Braila",43992,92,43992,,"SILISTEA",264,"Scoala Generala  1-4 Muchea",0,150,0,150,0,149,1,203,53,94,55,3,4102,1
9,"Braila",44060,92,44060,,"STANCUTA",265,"Scoala de Arte si Meserii Stancuta",1361,759,750,9,0,738,21,1499,740,245,493,3,4109,0
9,"Braila",44060,92,44060,,"STANCUTA",266,"Camin Cultural din satul Cuza Voda",1212,660,653,7,0,647,13,1300,640,263,384,3,4109,0
9,"Braila",44060,92,44060,,"STANCUTA",267,"Scoala Generala Sat Stanca",402,231,223,8,0,225,6,500,269,72,153,3,4109,0
9,"Braila",44060,92,44060,,"STANCUTA",268,"Scoala de Arte si Meserii Stancuta",0,58,0,58,0,57,1,200,142,31,26,3,4109,1
9,"Braila",44113,92,44113,,"SURDILA-GAISEANCA",269,"Camin Cultural Surdila Gaiseanca, str.Brailei nr.34",1424,800,799,0,1,786,14,1500,700,270,516,3,4114,0
9,"Braila",44113,92,44113,,"SURDILA-GAISEANCA",270,"Scoala Generala 1-4 Filipesti, str.Costache Filipescu nr.30",662,397,391,6,0,388,9,702,305,121,267,3,4114,0
9,"Braila",44113,92,44113,,"SURDILA-GAISEANCA",271,"Camin Cultural Filipesti, str. Costache Filipescu, nr. 29",0,94,0,94,0,94,0,203,109,39,55,3,4114,1
9,"Braila",42771,92,42771,,"SURDILA-GRECI",272,"Scoala cu clasele 1-8 Surdila Greci",668,387,380,7,0,382,5,800,413,167,215,3,4117,0
9,"Braila",42771,92,42771,,"SURDILA-GRECI",273,"Scoala cu cls. 1-4 Faurei Sat",293,232,205,27,0,229,3,400,168,130,99,3,4117,0
9,"Braila",42771,92,42771,,"SURDILA-GRECI",274,"Scoala Generala 1-4 Horia",339,254,240,14,0,252,2,404,150,142,110,3,4117,0
9,"Braila",42771,92,42771,,"SURDILA-GRECI",275,"Scoala cu clasele 1-8 Surdila Greci",0,51,0,51,0,51,0,300,249,33,18,3,4117,1
9,"Braila",44140,92,44140,,"SUTESTI",276,"Camin Cultural Sutesti",1082,471,445,26,0,466,5,1200,729,181,285,3,4122,0
9,"Braila",44140,92,44140,,"SUTESTI",277,"Scoala de Arte si Meserii Sutesti",1227,547,533,14,0,538,9,1299,752,236,302,3,4122,0
9,"Braila",44140,92,44140,,"SUTESTI",278,"Scoala de Arte si Meserii Sutesti",1114,546,505,41,0,539,7,1200,654,267,272,3,4122,0
9,"Braila",44140,92,44140,,"SUTESTI",279,"Scoala Generala  1-4 M.Kogalniceanu",297,185,170,15,0,185,0,400,215,102,83,3,4122,0
9,"Braila",44140,92,44140,,"SUTESTI",280,"Scoala de Arte si Meserii Sutesti",0,126,0,126,0,125,1,202,76,66,59,3,4122,1
9,"Braila",44177,92,44177,,"TICHILESTI",281,"Scoala Generala  1-8 Intrarea A Tichilesti",1411,704,614,10,80,689,15,1500,796,326,363,3,4125,0
9,"Braila",44177,92,44177,,"TICHILESTI",282,"Scoala Generala  1-8 Intrarea B Tichilesti",1505,688,683,5,0,681,7,1600,912,353,328,3,4125,0
9,"Braila",44177,92,44177,,"TICHILESTI",283,"Scoala Generala Albina",209,96,87,9,0,95,1,300,204,39,56,3,4125,0
9,"Braila",44177,92,44177,,"TICHILESTI",284,"Scoala Generala  1-8 Tichilesti",0,58,0,58,0,58,0,200,142,25,33,3,4125,1
9,"Braila",44202,92,44202,,"TRAIAN",285,"Scoala Generala Traian",935,473,464,9,0,468,5,1000,527,150,318,3,4128,0
9,"Braila",44202,92,44202,,"TRAIAN",286,"Scoala Generala Silistraru",649,360,357,3,0,357,3,701,341,157,200,3,4128,0
9,"Braila",44202,92,44202,,"TRAIAN",287,"Scoala Generala Urleasca",1091,482,474,8,0,470,12,1196,714,180,290,3,4128,0
9,"Braila",44202,92,44202,,"TRAIAN",288,"Scoala Generala Caldarusa",157,116,111,5,0,113,3,200,84,24,89,3,4128,0
9,"Braila",44202,92,44202,,"TRAIAN",289,"Scoala Generala Traian",0,77,0,77,0,77,0,200,123,34,43,3,4128,1
9,"Braila",44257,92,44257,,"TUDOR VLADIMIRESCU",290,"Scoala cu clasele 1-8 Tudor Vladimirescu",848,482,469,13,0,472,10,899,417,221,251,3,4133,0
9,"Braila",44257,92,44257,,"TUDOR VLADIMIRESCU",291,"Sediul fostului C.A.P. Scortaru Vechi",843,512,505,7,0,500,12,898,386,170,330,3,4133,0
9,"Braila",44257,92,44257,,"TUDOR VLADIMIRESCU",292,"Camin Cultural Comaneasca",166,124,114,10,0,124,0,200,76,35,89,3,4133,0
9,"Braila",44257,92,44257,,"TUDOR VLADIMIRESCU",293,"Scoala cu clasele 1-8 Tudor Vladimirescu",0,69,0,69,0,68,1,200,131,39,29,3,4133,1
9,"Braila",44300,92,44300,,"TUFESTI",294,"Scoala Generala nr.1 Tufesti",1531,769,705,64,0,763,6,1600,831,239,524,3,4137,0
9,"Braila",44300,92,44300,,"TUFESTI",295,"Camin Cultural nr.1 Tufesti",1206,688,606,82,0,680,8,1300,612,288,392,3,4137,0
9,"Braila",44300,92,44300,,"TUFESTI",296,"Gradinita nr.2 Tufesti",900,562,496,66,0,557,5,994,432,177,380,3,4137,0
9,"Braila",44300,92,44300,,"TUFESTI",297,"Scoala Generala nr.2 Tufesti",993,551,498,53,0,531,20,998,447,162,369,3,4137,0
9,"Braila",44300,92,44300,,"TUFESTI",298,"Camin Cultural nr.1 Tufesti , str. Primariei nr. 1",0,79,0,79,0,78,1,200,121,31,47,3,4137,1
9,"Braila",44328,92,44328,,"ULMU",299,"Camin Cultural  Ulmu",1434,754,711,43,0,738,16,1500,746,343,395,3,4139,0
9,"Braila",44328,92,44328,,"ULMU",300,"Camin Cultural  Mohreanu",1016,600,536,64,0,585,15,1100,500,142,443,3,4139,0
9,"Braila",44328,92,44328,,"ULMU",301,"Camin Cultural  Jugureanu",903,444,433,11,0,423,21,1000,556,136,287,3,4139,0
9,"Braila",44328,92,44328,,"ULMU",302,"Camin Cultural  Ulmu",0,100,0,100,0,99,1,204,104,41,58,3,4139,1
9,"Braila",44355,92,44355,,"UNIREA",303,"Scoala Generala 1-8 Unirea",941,541,529,12,0,533,8,1099,558,289,244,3,4142,0
9,"Braila",44355,92,44355,,"UNIREA",304,"Scoala Generala 1-8 Valea Canepii",1041,660,655,5,0,649,11,1100,440,365,284,3,4142,0
9,"Braila",44355,92,44355,,"UNIREA",305,"Scoala Generala 1-8 Unirea",0,90,0,90,0,90,0,201,111,45,45,3,4142,1
9,"Braila",44391,92,44391,,"VADENI",306,"Scoala Generala Vadeni",1963,1088,1078,10,0,1072,16,2100,1012,467,605,3,4146,0
9,"Braila",44391,92,44391,,"VADENI",307,"Scoala cu clasele 1-8 Baldovinesti",859,448,437,11,0,440,8,1000,552,201,239,3,4146,0
9,"Braila",44391,92,44391,,"VADENI",308,"Scoala Generala Pietroiu",372,233,214,19,0,233,0,500,267,119,114,3,4146,0
9,"Braila",44391,92,44391,,"VADENI",309,"Scoala cu clasele 1-8 Baldovinesti  sala de curs ptr. cls a IV-a",0,96,0,96,0,96,0,300,204,42,54,3,4146,1
9,"Braila",44435,92,44435,,"VICTORIA",310,"Scoala cu clasele 1-8 Victoria",1818,852,849,2,1,843,9,1900,1048,179,664,3,4150,0
9,"Braila",44435,92,44435,,"VICTORIA",311,"Scoala cu clasele 1-8  Mihai Bravu",1239,556,552,4,0,548,8,1300,744,196,352,3,4150,0
9,"Braila",44435,92,44435,,"VICTORIA",312,"Scoala cu clasele 1-8 Victoria",0,34,0,34,0,33,1,100,66,14,19,3,4150,1
9,"Braila",44462,92,44462,,"VISANI",313,"Scoala cu clasele 1-8 Visani",1528,875,868,7,0,868,7,1600,725,271,597,3,4153,0
9,"Braila",44462,92,44462,,"VISANI",314,"Scoala cu clasele 1-4 Ciineni",534,284,280,4,0,279,5,600,316,77,202,3,4153,0
9,"Braila",44462,92,44462,,"VISANI",315,"Scoala cu clasele 1-8 Visani",0,78,0,78,0,77,1,300,222,26,51,3,4153,1
9,"Braila",44505,92,44505,,"VIZIRU",316,"Scoala Generala  nr.1 Viziru",1436,765,674,91,0,753,12,1500,735,335,418,3,4157,0
9,"Braila",44505,92,44505,,"VIZIRU",317,"Scoala  Anexa Viziru",1791,920,854,66,0,906,14,1900,980,454,452,3,4157,0
9,"Braila",44505,92,44505,,"VIZIRU",318,"Scoala Generala Lanurile",1768,1018,996,22,0,996,22,1900,882,477,519,3,4157,0
9,"Braila",44505,92,44505,,"VIZIRU",319,"Scoala de Arte si Meserii Viziru",0,128,0,128,0,127,1,202,74,71,56,3,4157,1
9,"Braila",44532,92,44532,,"ZAVOAIA",320,"Camin Cultural  Zavoaia - Sala mica",1986,1042,1036,6,0,1024,18,2100,1058,378,646,3,4160,0
9,"Braila",44532,92,44532,,"ZAVOAIA",321,"Camin Cultural Dudescu",691,412,408,4,0,404,8,806,394,145,259,3,4160,0
9,"Braila",44532,92,44532,,"ZAVOAIA",322,"Camin Cultural  Zavoaia - Sala mare",0,104,0,104,0,98,6,200,96,31,67,3,4160,1
10,"Buzau",44818,109,44818,,"MUNICIPIUL BUZAU",1,"Scoala gen. nr. 5, ""Ep. Dionisie Romano"" str. Bistritei, nr.31",1735,965,957,7,1,959,6,1900,935,399,560,1,4164,0
10,"Buzau",44818,109,44818,,"MUNICIPIUL BUZAU",2,"Scoala generala nr. 11,str. Chiristigii nr.7",1576,908,898,9,1,900,8,1701,793,387,513,1,4164,0
10,"Buzau",44818,109,44818,,"MUNICIPIUL BUZAU",3,"Directia de Asistenta Sociala, str. Marghiloman nr.29",1157,660,646,14,0,644,16,1300,640,300,344,1,4164,0
10,"Buzau",44818,109,44818,,"MUNICIPIUL BUZAU",4,"Directia de Asistenta Sociala, str. Marghiloman nr.29",1063,581,566,15,0,570,11,1200,619,237,333,1,4164,0
10,"Buzau",44818,109,44818,,"MUNICIPIUL BUZAU",5,"Grupul scolar ""Grigore Moisil"" cartier Brosteni",1833,913,905,8,0,909,4,2000,1087,398,511,1,4164,0
10,"Buzau",44818,109,44818,,"MUNICIPIUL BUZAU",6,"Grupul scolar ""Grigore Moisil"" cartier Brosteni",1615,859,852,7,0,855,4,1800,941,405,450,1,4164,0
10,"Buzau",44818,109,44818,,"MUNICIPIUL BUZAU",7,"Grupul scolar ""Grigore Moisil"" cartier Brosteni",1659,828,821,7,0,818,10,1900,1072,373,445,1,4164,0
10,"Buzau",44818,109,44818,,"MUNICIPIUL BUZAU",8,"Grupul scolar ""Grigore Moisil"" cartier Brosteni",1462,691,685,6,0,683,8,1600,909,326,357,1,4164,0
10,"Buzau",44818,109,44818,,"MUNICIPIUL BUZAU",9,"Colegiul Universitar Economic, cartier Brosteni",1875,973,961,12,0,961,12,2100,1127,446,515,1,4164,0
10,"Buzau",44818,109,44818,,"MUNICIPIUL BUZAU",10,"Scoala cu clasele I-VIII nr.7, cartier Dorobanti I",1912,950,935,15,0,936,14,2100,1150,436,500,1,4164,0
10,"Buzau",44818,109,44818,,"MUNICIPIUL BUZAU",11,"Scoala cu clasele I-VIII nr.6, str. Victoriei nr. 73",1095,517,510,7,0,516,1,1200,683,225,291,1,4164,0
10,"Buzau",44818,109,44818,,"MUNICIPIUL BUZAU",12,"Scoala cu clasele I-VIII nr.6, str. Victoriei nr. 73",1096,557,548,9,0,553,4,1186,629,271,282,1,4164,0
10,"Buzau",44818,109,44818,,"MUNICIPIUL BUZAU",13,"Liceul teoretic ""Alexandru Marghiloman"", cartier Dorobanti II",1475,762,751,11,0,751,11,1600,838,352,399,1,4164,0
10,"Buzau",44818,109,44818,,"MUNICIPIUL BUZAU",14,"Scoala cu clasele I-VIII nr.7, cartier Dorobanti I",1921,1006,994,12,0,996,10,2100,1094,427,569,1,4164,0
10,"Buzau",44818,109,44818,,"MUNICIPIUL BUZAU",15,"Liceul pentru deficienti de vedere, str.Horticolei nr.54",1192,557,547,10,0,555,2,1300,743,252,303,1,4164,0
10,"Buzau",44818,109,44818,,"MUNICIPIUL BUZAU",16,"Centrul Scolar ptr. Educatie Incluziva, str.Horticolei nr.56",1195,495,487,8,0,478,17,1300,805,217,261,1,4164,0
10,"Buzau",44818,109,44818,,"MUNICIPIUL BUZAU",17,"Liceul teoretic "" Alexandru Marghiloman"", cartierDorobanti II",1411,740,731,9,0,725,15,1600,860,339,386,1,4164,0
10,"Buzau",44818,109,44818,,"MUNICIPIUL BUZAU",18,"Liceul teoretic "" Alexandru Marghiloman"", cartierDorobanti II",1526,747,736,11,0,744,3,1700,953,375,369,1,4164,0
10,"Buzau",44818,109,44818,,"MUNICIPIUL BUZAU",19,"Scoala cu clasele I-VIII nr.6, str. Victoriei nr. 73",1963,1021,1015,6,0,1009,12,2200,1179,391,618,1,4164,0
10,"Buzau",44818,109,44818,,"MUNICIPIUL BUZAU",20,"Grup scolar ind. de transporturi cai ferate str. Horticolei 50",1192,624,616,8,0,613,11,1300,676,281,332,1,4164,0
10,"Buzau",44818,109,44818,,"MUNICIPIUL BUZAU",21,"Grup scolar ind. de transporturi cai ferate str. Horticolei 50",1431,664,650,14,0,658,6,1600,936,290,368,1,4164,0
10,"Buzau",44818,109,44818,,"MUNICIPIUL BUZAU",22,"Scoala cu clasele I-VIII nr.16, ""Ion Creanga"", cartier Micro V",1790,879,872,7,0,874,5,2001,1122,391,483,1,4164,0
10,"Buzau",44818,109,44818,,"MUNICIPIUL BUZAU",23,"Scoala cu clasele I-VIII nr.16, ""Ion Creanga"", cartier Micro V",1524,831,819,12,0,828,3,1701,870,334,494,1,4164,0
10,"Buzau",44818,109,44818,,"MUNICIPIUL BUZAU",24,"Scoala generala nr. 6, str. Victoriei nr. 73",1375,737,725,12,0,725,12,1500,763,342,383,1,4164,0
10,"Buzau",44818,109,44818,,"MUNICIPIUL BUZAU",25,"Gradinita nr. 13, b-dul Republicii nr. 18",1022,522,518,4,0,516,6,1100,578,216,300,1,4164,0
10,"Buzau",44818,109,44818,,"MUNICIPIUL BUZAU",26,"Colegiul tehnic bd.Republicii nr.18",1062,540,532,8,0,538,2,1196,656,216,322,1,4164,0
10,"Buzau",44818,109,44818,,"MUNICIPIUL BUZAU",27,"Scoala cu clasele I-VIII nr.16,  ""Ion Creanga"", cartier Micro V",1811,969,960,9,0,960,9,2000,1031,416,544,1,4164,0
10,"Buzau",44818,109,44818,,"MUNICIPIUL BUZAU",28,"Liceul de arta ""Margareta Sterian"", str. Bucegi nr. 6",1582,907,899,8,0,898,9,1800,893,354,544,1,4164,0
10,"Buzau",44818,109,44818,,"MUNICIPIUL BUZAU",29,"Scoala cu clasele I-VIII nr. 16, ""Ion Creanga"", cartier Micro V",1515,848,832,16,0,838,10,1700,852,334,504,1,4164,0
10,"Buzau",44818,109,44818,,"MUNICIPIUL BUZAU",30,"Colegiul National B.P. HASDEU,str. Libertatii nr. 3",1504,827,815,12,0,815,12,1700,873,347,468,1,4164,0
10,"Buzau",44818,109,44818,,"MUNICIPIUL BUZAU",31,"Scoala cu clasele I-VIII nr. 10, ""P.H.Zangopol"" str.Stupariei nr. 1",1279,569,549,20,0,559,10,1400,831,284,275,1,4164,0
10,"Buzau",44818,109,44818,,"MUNICIPIUL BUZAU",32,"Scoala cu clasele I-VIII nr. 10, ""P.H.Zangopol"" str.Stupariei nr. 1",1019,527,516,11,0,516,11,1100,573,249,267,1,4164,0
10,"Buzau",44818,109,44818,,"MUNICIPIUL BUZAU",33,"Scoala cu clasele I-VIII nr. 10, ""P.H.Zangopol"" str.Stupariei nr. 1",1724,834,824,10,0,832,2,2000,1166,364,468,1,4164,0
10,"Buzau",44818,109,44818,,"MUNICIPIUL BUZAU",34,"Liceul ""Dimitrie Filipescu"",str. D.Filipescu nr. 6",1460,796,783,13,0,787,9,1600,804,384,403,1,4164,0
10,"Buzau",44818,109,44818,,"MUNICIPIUL BUZAU",35,"Liceul ""Dimitrie Filipescu"",str. D.Filipescu nr. 6",1541,669,659,10,0,664,5,1700,1031,340,324,1,4164,0
10,"Buzau",44818,109,44818,,"MUNICIPIUL BUZAU",36,"Colegiul agricol Dr.C.Angelescu, str. Crizantemelor nr.17",1475,862,850,12,0,853,9,1600,738,415,438,1,4164,0
10,"Buzau",44818,109,44818,,"MUNICIPIUL BUZAU",37,"Scoala cu clasele I-VIII nr. 8, ""N.Constantinescu"" str. Col.Ion Buzoianu nr. 109",1055,550,541,9,0,543,7,1100,550,249,294,1,4164,0
10,"Buzau",44818,109,44818,,"MUNICIPIUL BUZAU",38,"Scoala cu clasele I-VIII nr. 8, ""N.Constantinescu"" str. Col.Ion Buzoianu nr. 109",1032,575,565,10,0,571,4,1100,525,237,334,1,4164,0
10,"Buzau",44818,109,44818,,"MUNICIPIUL BUZAU",39,"Scoala cu clasele I-VIII nr. 8, ""N.Constantinescu"" str. Col.Ion Buzoianu nr. 109",1882,993,982,11,0,981,12,2100,1107,405,576,1,4164,0
10,"Buzau",44818,109,44818,,"MUNICIPIUL BUZAU",40,"Gradinita cu program prelungit nr.8, bd. Unirii, nr.10",1118,616,598,18,0,612,4,1200,584,281,331,1,4164,0
10,"Buzau",44818,109,44818,,"MUNICIPIUL BUZAU",41,"Gradinita cu program prelungit nr.8, bd. Unirii, nr.10",1050,547,536,11,0,544,3,1200,653,235,309,1,4164,0
10,"Buzau",44818,109,44818,,"MUNICIPIUL BUZAU",42,"Gradinita de copii cu program normal nr.8, str. Independentei nr.81",1867,1088,1074,14,0,1006,82,2100,1012,429,577,1,4164,0
10,"Buzau",44818,109,44818,,"MUNICIPIUL BUZAU",43,"Colegiul national M. Eminescu, str. Independentei, nr.22",1917,953,929,24,0,941,12,2100,1147,438,503,1,4164,0
10,"Buzau",44818,109,44818,,"MUNICIPIUL BUZAU",44,"Liceul pedagogic ""Spiru Haret"", str. Spiru Haret nr. 6",920,548,504,44,0,541,7,995,447,244,297,1,4164,0
10,"Buzau",44818,109,44818,,"MUNICIPIUL BUZAU",45,"Liceul pedagogic ""Spiru Haret"", str. Spiru Haret nr. 6",1007,513,500,13,0,510,3,1073,560,236,274,1,4164,0
10,"Buzau",44818,109,44818,,"MUNICIPIUL BUZAU",46,"Scoala cu clasele I-VIII nr. 15, ""Dr.George Emil Palade"" str. Spiru Haret nr.8",1743,946,941,5,0,934,12,1600,654,374,560,1,4164,0
10,"Buzau",44818,109,44818,,"MUNICIPIUL BUZAU",47,"Scoala cu clasele I-VIII nr. 15, ""Dr.George Emil Palade"" str. Spiru Haret nr.8",1759,921,909,12,0,912,9,1600,679,364,548,1,4164,0
10,"Buzau",44818,109,44818,,"MUNICIPIUL BUZAU",48,"Scoala cu clasele I-VIII nr. 15, ""Dr.George Emil Palade"" str. Spiru Haret nr.8",1444,814,797,17,0,803,11,1600,786,293,510,1,4164,0
10,"Buzau",44818,109,44818,,"MUNICIPIUL BUZAU",49,"Scoala cu clasele I-VIII nr. 15, ""Dr.George Emil Palade"" str. Spiru Haret nr.8",1350,796,784,12,0,785,11,1500,704,312,473,1,4164,0
10,"Buzau",44818,109,44818,,"MUNICIPIUL BUZAU",50,"Scoala cu clasele I-VIII nr. 15, ""Dr.George Emil Palade"" str. Spiru Haret nr.8",1401,683,674,9,0,677,6,1500,817,303,374,1,4164,0
10,"Buzau",44818,109,44818,,"MUNICIPIUL BUZAU",51,"Liceul pedagogic ""Spiru Haret"", str. Spiru Haret nr. 6",1602,925,915,10,0,917,8,1500,575,332,585,1,4164,0
10,"Buzau",44818,109,44818,,"MUNICIPIUL BUZAU",52,"Liceul pedagogic ""Spiru Haret"", str. Spiru Haret nr. 6",1358,805,799,6,0,799,6,1500,695,277,522,1,4164,0
10,"Buzau",44818,109,44818,,"MUNICIPIUL BUZAU",53,"Sc. gen. nr.1 ""Cpt.av.Mircea T. Badulescu"", bd. N. Balcescu 28",1470,909,902,7,0,903,6,1600,691,378,525,1,4164,0
10,"Buzau",44818,109,44818,,"MUNICIPIUL BUZAU",54,"Colegiul national M. Eminescu, str. Independentei, nr.22",1699,949,941,8,0,938,11,1900,951,405,533,1,4164,0
10,"Buzau",44818,109,44818,,"MUNICIPIUL BUZAU",55,"Colegiul economic, str. T. Vladimirescu nr.15",1459,918,897,21,0,907,11,1600,682,390,517,1,4164,0
10,"Buzau",44818,109,44818,,"MUNICIPIUL BUZAU",56,"Sc. gen. nr.1 ""Cpt.av.Mircea T. Badulescu"", bd. N. Balcescu 28",1597,937,924,13,0,921,16,1800,863,379,542,1,4164,0
10,"Buzau",44818,109,44818,,"MUNICIPIUL BUZAU",57,"SC PROIECT SA, str. Unirii bl.13A+B",1555,907,895,12,0,896,11,1700,793,376,520,1,4164,0
10,"Buzau",44818,109,44818,,"MUNICIPIUL BUZAU",58,"Sc. gen. nr.1 ""Cpt.av.Mircea T. Badulescu"", bd. N. Balcescu 28",1108,586,577,9,0,578,8,1200,614,236,342,1,4164,0
10,"Buzau",44818,109,44818,,"MUNICIPIUL BUZAU",59,"Muzeul judetean de istorie, bd. N. Balcescu, nr.50",1526,919,908,11,0,903,16,1700,781,385,518,1,4164,0
10,"Buzau",44818,109,44818,,"MUNICIPIUL BUZAU",60,"Scoala generala nr. 2  ""N.Titulescu"", str. George Cosbuc nr. 5",1465,838,831,7,0,831,7,1589,751,333,498,1,4164,0
10,"Buzau",44818,109,44818,,"MUNICIPIUL BUZAU",61,"Scoala generala nr. 2  ""N.Titulescu"", str. George Cosbuc nr. 5",1584,884,867,17,0,876,8,1700,816,390,486,1,4164,0
10,"Buzau",44818,109,44818,,"MUNICIPIUL BUZAU",62,"Scoala generala nr. 12, cartier Micro XIV",1426,719,705,14,0,711,8,1600,881,302,409,1,4164,0
10,"Buzau",44818,109,44818,,"MUNICIPIUL BUZAU",63,"Centrul de rec. si cons. al sangelui, str. G-ral Grigore Bastan, nr.2",1952,1076,1065,11,0,1067,9,2100,1024,444,623,1,4164,0
10,"Buzau",44818,109,44818,,"MUNICIPIUL BUZAU",64,"Scoala generala nr. 12, cartier Micro XIV",1560,801,794,7,0,792,9,1700,899,363,429,1,4164,0
10,"Buzau",44818,109,44818,,"MUNICIPIUL BUZAU",65,"Scoala generala nr. 12, cartier Micro XIV",1758,870,858,12,0,858,12,2000,1130,364,494,1,4164,0
10,"Buzau",44818,109,44818,,"MUNICIPIUL BUZAU",66,"Liceul cu program sportiv I. Balas Sotter, cartier Micro XIV",1072,521,512,9,0,517,4,1200,679,202,315,1,4164,0
10,"Buzau",44818,109,44818,,"MUNICIPIUL BUZAU",67,"Liceul cu program sportiv I. Balas Sotter, cartier Micro XIV",1489,782,757,24,1,774,8,1600,818,326,448,1,4164,0
10,"Buzau",44818,109,44818,,"MUNICIPIUL BUZAU",68,"Liceul cu program sportiv I. Balas Sotter, cartier Micro XIV",1238,622,608,14,0,616,6,1400,778,288,328,1,4164,0
10,"Buzau",44818,109,44818,,"MUNICIPIUL BUZAU",69,"Scoala generala nr. 11, str. Chiristigii nr. 7",1695,1008,974,20,14,1003,5,1900,892,440,563,1,4164,0
10,"Buzau",44818,109,44818,,"MUNICIPIUL BUZAU",70,"Scoala generala nr. 11, str. Chiristigii nr. 7",1835,1014,1001,13,0,1004,10,2000,986,426,578,1,4164,0
10,"Buzau",44818,109,44818,,"MUNICIPIUL BUZAU",71,"Scoala generala nr. 11, str. Chiristigii nr. 7",1699,949,938,11,0,943,6,1880,931,378,565,1,4164,0
10,"Buzau",44818,109,44818,,"MUNICIPIUL BUZAU",72,"Gradinita cu program prelungit nr.5, cartier Episcopiei",1575,856,844,11,1,841,15,1700,844,365,476,1,4164,0
10,"Buzau",44818,109,44818,,"MUNICIPIUL BUZAU",73,"Seminarul teologic,  aleea Episcopiei nr.1",1943,1110,1100,8,2,1100,10,2100,990,486,614,1,4164,0
10,"Buzau",44818,109,44818,,"MUNICIPIUL BUZAU",74,"Seminarul teologic,  aleea Episcopiei nr.1",1653,825,815,10,0,818,7,1800,975,403,415,1,4164,0
10,"Buzau",44818,109,44818,,"MUNICIPIUL BUZAU",75,"Grupul scolar ""Costin Nenitescu"" Transilvaniei, nr. 134",1833,870,851,19,0,851,19,2000,1130,462,389,1,4164,0
10,"Buzau",44818,109,44818,,"MUNICIPIUL BUZAU",76,"Grupul scolar de meserii si servicii, str. Bazalt, nr.1",1965,818,802,16,0,808,10,2200,1382,428,380,1,4164,0
10,"Buzau",44818,109,44818,,"MUNICIPIUL BUZAU",77,"Grupul scolar de meserii si servicii, str. Bazalt, nr.1",625,292,284,8,0,288,4,700,408,170,118,1,4164,0
10,"Buzau",44818,109,44818,,"MUNICIPIUL BUZAU",78,"Scoala cu clasele I-VIII nr. 14, ""N.Kogalniceanu"" str. Transilvaniei nr. 313",1679,732,725,7,0,717,15,1900,1168,384,333,1,4164,0
10,"Buzau",44818,109,44818,,"MUNICIPIUL BUZAU",79,"Scoala cu clasele I-VIII nr. 14, ""N.Kogalniceanu"" str. Transilvaniei nr. 313",1587,858,841,17,0,826,32,1700,842,309,517,1,4164,0
10,"Buzau",44818,109,44818,,"MUNICIPIUL BUZAU",80,"Scoala cu clasele I-VIII nr. 14, ""N.Kogalniceanu"" str. Transilvaniei nr. 313",1551,773,765,8,0,737,36,1700,927,383,354,1,4164,0
10,"Buzau",44818,109,44818,,"MUNICIPIUL BUZAU",81,"Statia CFR Buzau, Bd. 1 decembrie 1918, nr.1",0,1632,0,1632,0,1621,11,1700,68,840,781,1,4164,1
10,"Buzau",44845,109,44845,,"MUNICIPIUL RAMNICU SARAT",82,"Sc.gen.nr.7,Str.Merisorului nr.3",1882,967,953,14,0,954,13,2100,1133,403,551,1,4166,0
10,"Buzau",44845,109,44845,,"MUNICIPIUL RAMNICU SARAT",83,"Sc.cu clasele I-VIII nr.3,Str.Perisori nr.2",1601,974,961,13,0,958,16,1800,826,192,766,1,4166,0
10,"Buzau",44845,109,44845,,"MUNICIPIUL RAMNICU SARAT",84,"Sc.cu clasele I-VIII nr.5 ""Vasile Cristoforeanu"", local I,  Str.Al.Ioan Cuza",1714,930,913,17,0,922,8,1900,970,344,578,1,4166,0
10,"Buzau",44845,109,44845,,"MUNICIPIUL RAMNICU SARAT",85,"Gradinita cu program normal nr.8,Str.lt.Pantazescu nr.2",1751,860,852,8,0,849,11,2001,1141,346,503,1,4166,0
10,"Buzau",44845,109,44845,,"MUNICIPIUL RAMNICU SARAT",86,"Sc. profesionala nr.1, Str.M.Kogalniceanu,nr.22",1934,884,858,26,0,867,17,2100,1216,370,497,1,4166,0
10,"Buzau",44845,109,44845,,"MUNICIPIUL RAMNICU SARAT",87,"Sc. cu clasele I-VIII nr.5 ""Vasile Cristoforeanu"", local II, Str.Al.Ioan Cuza",1459,732,714,18,0,726,6,1600,868,261,465,1,4166,0
10,"Buzau",44845,109,44845,,"MUNICIPIUL RAMNICU SARAT",88,"Sc. cu clasele I-VIII nr.5 ""Vasile Cristoforeanu"" local III, Str.Al.Ioan Cuza",1470,780,774,6,0,772,8,1600,820,321,451,1,4166,0
10,"Buzau",44845,109,44845,,"MUNICIPIUL RAMNICU SARAT",89,"Col.Nat.""Al.Vlahuta"",Local II,Str.T.Vladimirescu nr.17",1464,737,693,43,1,729,8,1600,863,293,436,1,4166,0
10,"Buzau",44845,109,44845,,"MUNICIPIUL RAMNICU SARAT",90,"Caminul de copii cu program prelungit nr.1, Str.C.Brincoveanu nr.13",1394,682,660,20,2,670,12,1529,847,275,395,1,4166,0
10,"Buzau",44845,109,44845,,"MUNICIPIUL RAMNICU SARAT",91,"Sc. cu clasele I-VIII nr.6, Str.Matei Basarab nr.86",2064,1071,1058,13,0,1062,9,2309,1238,433,629,1,4166,0
10,"Buzau",44845,109,44845,,"MUNICIPIUL RAMNICU SARAT",92,"Lic.teoretic ""Stefan cel Mare"", Str.Liliacului nr.15",1511,804,788,16,0,800,4,1700,896,338,462,1,4166,0
10,"Buzau",44845,109,44845,,"MUNICIPIUL RAMNICU SARAT",93,"Grupul scolar Agricol, Str.N.Balcescu nr.2",1423,734,722,11,1,723,11,1589,855,284,439,1,4166,0
10,"Buzau",44845,109,44845,,"MUNICIPIUL RAMNICU SARAT",94,"Cantina de ajutor social, Str.plt.Torcaru nr.12",1468,701,689,12,0,695,6,1601,900,296,399,1,4166,0
10,"Buzau",44845,109,44845,,"MUNICIPIUL RAMNICU SARAT",95,"Col.Nat.""Al.Vlahuta"", Localul I, Str.T.Vladimirescu nr.13",1442,779,763,16,0,770,9,1600,821,285,485,1,4166,0
10,"Buzau",44845,109,44845,,"MUNICIPIUL RAMNICU SARAT",96,"Sc.cu clasele I-VIII nr.1, Str.Stefan cel Mare nr.17",1301,711,698,13,0,703,8,1400,689,274,429,1,4166,0
10,"Buzau",44845,109,44845,,"MUNICIPIUL RAMNICU SARAT",97,"Sc.cu clasele I-VIII nr.2, Str.Paun Pincio nr.8",1776,849,832,17,0,838,11,2000,1151,314,524,1,4166,0
10,"Buzau",44845,109,44845,,"MUNICIPIUL RAMNICU SARAT",98,"S.C. ""OILREG"" S.A.,Str.Costieni nr.106",2139,1066,1054,12,0,1046,20,2400,1334,436,610,1,4166,0
10,"Buzau",44845,109,44845,,"MUNICIPIUL RAMNICU SARAT",99,"Caminul de copii cu program prelungit nr.3 Costieni, localul I, Bd.1 decembrie 1918 nr.2",1738,818,803,15,0,809,9,1900,1082,362,447,1,4166,0
10,"Buzau",44845,109,44845,,"MUNICIPIUL RAMNICU SARAT",100,"Caminul de copii cu program prelungit nr.3 Costieni, localul II, Bd.1 decembrie 1918 nr.2",1652,777,768,9,0,767,10,1800,1023,322,445,1,4166,0
10,"Buzau",44845,109,44845,,"MUNICIPIUL RAMNICU SARAT",101,"Sc. cu clasele I-VIII nr.8,Str.Lalelelor nr.1",1681,780,768,12,0,774,6,1808,1028,336,438,1,4166,0
10,"Buzau",44845,109,44845,,"MUNICIPIUL RAMNICU SARAT",102,"Grup Scolar Economic,Str.Lalelelor nr.1",1624,796,781,15,0,791,5,1795,999,352,439,1,4166,0
10,"Buzau",44845,109,44845,,"MUNICIPIUL RAMNICU SARAT",103,"Primaria Rm. Sarat, str.Nicolae Balcescu, nr.1",0,452,0,452,0,444,8,886,434,251,193,1,4166,1
10,"Buzau",47916,109,47916,,"ORAS NEHOIU",104,"Casa de cultura oraseneasca Nehoiu",1280,793,784,7,2,784,9,1400,607,286,498,1,4168,0
10,"Buzau",47916,109,47916,,"ORAS NEHOIU",105,"Grup scolar tehnic Nehoiu, str. Scolii",1133,684,673,11,0,678,6,1200,516,330,348,1,4168,0
10,"Buzau",47916,109,47916,,"ORAS NEHOIU",106,"Sala de sport, cartier Lunca Mare, Garboi",752,486,481,5,0,477,9,800,314,205,272,1,4168,0
10,"Buzau",47916,109,47916,,"ORAS NEHOIU",107,"Caminul cult.Badirlegi",136,96,85,8,3,94,2,200,104,39,55,1,4168,0
10,"Buzau",47916,109,47916,,"ORAS NEHOIU",108,"Fosta sectie confectionat incaltaminte Dimbovita (langa Biserica ortodoxa), str. Valea Nehoiului",592,411,397,13,1,406,5,600,189,160,246,1,4168,0
10,"Buzau",47916,109,47916,,"ORAS NEHOIU",109,"Caminul cult.Valea Nehoiului",929,619,602,12,5,610,9,1000,381,243,367,1,4168,0
10,"Buzau",47916,109,47916,,"ORAS NEHOIU",110,"Caminul cult.Valea Nehoiasului",386,259,241,4,14,257,2,500,241,91,166,1,4168,0
10,"Buzau",47916,109,47916,,"ORAS NEHOIU",111,"Caminul cult.Lunca Pripor",657,485,468,12,5,474,11,800,315,220,254,1,4168,0
10,"Buzau",47916,109,47916,,"ORAS NEHOIU",112,"Sc.cu clasele I-IV, Prund",391,297,289,8,0,290,7,500,203,171,119,1,4168,0
10,"Buzau",47916,109,47916,,"ORAS NEHOIU",113,"Caminul cult. Bisca Roziliei",578,411,401,6,4,404,7,700,289,216,188,1,4168,0
10,"Buzau",47916,109,47916,,"ORAS NEHOIU",114,"Gradinita Pod Vinetis",583,411,406,4,1,407,4,600,189,166,241,1,4168,0
10,"Buzau",47916,109,47916,,"ORAS NEHOIU",115,"Caminul cult. Vinetis",155,127,118,9,0,124,3,200,73,48,76,1,4168,0
10,"Buzau",47916,109,47916,,"ORAS NEHOIU",116,"Scoala cu clasele I-VIII, Paltineni",735,483,474,9,0,475,8,800,317,172,303,1,4168,0
10,"Buzau",47916,109,47916,,"ORAS NEHOIU",117,"Camin cultural Mlajet",757,544,516,6,22,540,4,800,256,211,329,1,4168,0
10,"Buzau",47916,109,47916,,"ORAS NEHOIU",118,"Sc.cu clasele I-IV, Chirlesti",631,428,420,8,0,422,6,697,269,136,286,1,4168,0
10,"Buzau",47916,109,47916,,"ORAS NEHOIU",119,"Caminul cult. Curmatura",186,130,122,8,0,128,2,300,170,35,93,1,4168,0
10,"Buzau",47916,109,47916,,"ORAS NEHOIU",120,"Casa de cultura, str. 1 Decembrie 1918",0,215,0,215,0,212,3,890,675,108,104,1,4168,1
10,"Buzau",48325,109,48325,,"ORAS PATARLAGELE",121,"Sc. de arte si meserii Patirlagele, sala nr.1",1010,583,583,0,0,579,4,1092,509,227,352,1,4179,0
10,"Buzau",48325,109,48325,,"ORAS PATARLAGELE",122,"Sc. de arte si meserii Patirlagele, sala nr.2",1214,683,680,3,0,675,8,1400,717,263,412,1,4179,0
10,"Buzau",48325,109,48325,,"ORAS PATARLAGELE",123,"Scoala primara din satul Poienile",282,174,164,10,0,172,2,403,229,101,71,1,4179,0
10,"Buzau",48325,109,48325,,"ORAS PATARLAGELE",124,"Sc.gen. din satul Maruntisu",1268,719,711,8,0,712,7,1400,681,278,434,1,4179,0
10,"Buzau",48325,109,48325,,"ORAS PATARLAGELE",125,"Sc.primara din satul Valea Lupului",415,234,226,8,0,234,0,500,266,110,124,1,4179,0
10,"Buzau",48325,109,48325,,"ORAS PATARLAGELE",126,"Sc.primara din satul Valea Viei",432,295,285,10,0,293,2,497,202,137,156,1,4179,0
10,"Buzau",48325,109,48325,,"ORAS PATARLAGELE",127,"Sc.primara din satul Manastirea",74,56,46,10,0,56,0,100,44,17,39,1,4179,0
10,"Buzau",48325,109,48325,,"ORAS PATARLAGELE",128,"Sc.primara din satul Cring",513,304,300,4,0,301,3,580,276,106,195,1,4179,0
10,"Buzau",48325,109,48325,,"ORAS PATARLAGELE",129,"Sc.gen. din satul Muscel",657,386,377,9,0,381,5,685,299,171,210,1,4179,0
10,"Buzau",48325,109,48325,,"ORAS PATARLAGELE",130,"Sc. primara din satul Sibiciu de Sus",781,494,486,8,0,491,3,813,319,192,299,1,4179,0
10,"Buzau",48325,109,48325,,"ORAS PATARLAGELE",131,"Sc.primara din satul  Valea Sibiciului",222,155,151,4,0,154,1,300,145,58,96,1,4179,0
10,"Buzau",48325,109,48325,,"ORAS PATARLAGELE",132,"Scoala profesionala Patarlagele, sala nr.3, str. Al. I. Cuza, nr.6",0,143,0,143,0,139,4,900,757,63,76,1,4179,1
10,"Buzau",48744,109,48744,,"ORAS POGOANELE",133,"Liceul Pogoanele, str. Unirii nr.15",1556,895,864,7,24,883,12,1700,805,319,564,1,4195,0
10,"Buzau",48744,109,48744,,"ORAS POGOANELE",134,"Clubul copiilor, str. M.Eminescu",1480,868,853,10,5,850,18,1600,732,301,549,1,4195,0
10,"Buzau",48744,109,48744,,"ORAS POGOANELE",135,"Sc.gen.nr.2 Pogoanele, str. I.L. Caragiale , nr.71",1607,980,953,16,11,953,27,1700,720,311,642,1,4195,0
10,"Buzau",48744,109,48744,,"ORAS POGOANELE",136,"Sc.gen.Caldarasti",1668,922,886,9,27,910,12,1900,978,300,610,1,4195,0
10,"Buzau",48744,109,48744,,"ORAS POGOANELE",137,"Primaria Pogoanele, str. Unirii, nr.18",0,148,0,148,0,146,2,800,652,62,84,1,4195,1
10,"Buzau",44863,109,44863,,"AMARU",138,"Sc. cu clasele I-VIII Amaru",1087,573,559,13,1,564,9,1200,627,211,353,3,4198,0
10,"Buzau",44863,109,44863,,"AMARU",139,"Sc. cu clasele I-IV Dulbanu",435,251,235,16,0,246,5,500,249,77,169,3,4198,0
10,"Buzau",44863,109,44863,,"AMARU",140,"Sc. cu clasele I-IV Lunca",335,178,165,13,0,171,7,501,323,37,134,3,4198,0
10,"Buzau",44863,109,44863,,"AMARU",141,"Sc. cu clasele I-IV Lacu Sinaia",211,155,137,18,0,149,6,301,146,34,115,3,4198,0
10,"Buzau",44863,109,44863,,"AMARU",142,"Primaria comunei Amaru, comuna Amaru",0,119,0,119,0,118,1,300,181,39,79,3,4198,1
10,"Buzau",44934,109,44934,,"BALTA ALBA",143,"Sc. cu clasele I-IV din satul Balta Alba",501,321,311,10,0,318,3,501,180,89,229,3,4207,0
10,"Buzau",44934,109,44934,,"BALTA ALBA",144,"Sc. cu clasele I-IV din satul Baile",434,242,229,13,0,238,4,520,278,114,124,3,4207,0
10,"Buzau",44934,109,44934,,"BALTA ALBA",145,"Sc. de coordonare din satul Amara",1405,871,855,10,6,859,12,1500,629,344,515,3,4207,0
10,"Buzau",44934,109,44934,,"BALTA ALBA",146,"Primaria comunei Balta Alba, sat Balta Alba",0,132,0,132,0,131,1,301,169,68,63,3,4207,1
10,"Buzau",44989,109,44989,,"BALACEANU",147,"Primaria Balaceanu",1379,694,688,6,0,682,12,1514,820,293,389,3,4205,0
10,"Buzau",44989,109,44989,,"BALACEANU",148,"Primaria Balaceanu, comuna Balaceanu",0,61,0,61,0,60,1,300,239,27,33,3,4205,1
10,"Buzau",45003,109,45003,,"BECENI",149,"Sc.cu clasele.I-IV, sat Beceni",886,438,425,13,0,432,6,1000,562,207,225,3,4212,0
10,"Buzau",45003,109,45003,,"BECENI",150,"Sc.cu clasele. I-VIII, sat Gura Dimienii",831,476,442,34,0,470,6,1000,524,182,288,3,4212,0
10,"Buzau",45003,109,45003,,"BECENI",151,"Sc.cu clasele .I-VIII, sat Valea Parului",1287,575,554,21,0,572,3,1481,906,218,354,3,4212,0
10,"Buzau",45003,109,45003,,"BECENI",152,"Sc.cu clasele.I-VIII, sat Izvoru Dulce",625,389,328,61,0,389,0,700,311,185,204,3,4212,0
10,"Buzau",45003,109,45003,,"BECENI",153,"Sc.cu clasele .I-IV, sat Floresti",241,141,128,13,0,140,1,300,159,41,99,3,4212,0
10,"Buzau",45003,109,45003,,"BECENI",154,"Primaria comunei Beceni , sat Beceni",0,144,0,144,0,144,0,301,157,64,80,3,4212,1
10,"Buzau",45101,109,45101,,"BERCA",155,"Casa de cultura Berca",1263,623,607,16,0,619,4,1300,677,337,282,3,4222,0
10,"Buzau",45101,109,45101,,"BERCA",156,"Casa de cultura Berca",1386,689,679,10,0,683,6,1500,811,344,339,3,4222,0
10,"Buzau",45101,109,45101,,"BERCA",157,"Gr.scolar ind.  ""Sf.mucenic Sava"", Berca",565,355,284,71,0,350,5,600,245,175,175,3,4222,0
10,"Buzau",45101,109,45101,,"BERCA",158,"Gradinita Satuc",517,298,273,25,0,294,4,600,302,137,157,3,4222,0
10,"Buzau",45101,109,45101,,"BERCA",159,"Sc. Ratesti",940,441,425,13,3,432,9,1000,559,178,254,3,4222,0
10,"Buzau",45101,109,45101,,"BERCA",160,"Sc. Picle",161,99,84,15,0,94,5,200,101,41,53,3,4222,0
10,"Buzau",45101,109,45101,,"BERCA",161,"Sc. Joseni",766,397,377,19,1,390,7,900,503,199,191,3,4222,0
10,"Buzau",45101,109,45101,,"BERCA",162,"Sc. Plesesti",724,358,345,13,0,355,3,801,443,190,165,3,4222,0
10,"Buzau",45101,109,45101,,"BERCA",163,"Camin cult. Plescoi",818,432,422,10,0,428,4,901,469,191,237,3,4222,0
10,"Buzau",45101,109,45101,,"BERCA",164,"Sc. Valea Nucului",594,328,310,18,0,323,5,601,273,148,175,3,4222,0
10,"Buzau",45101,109,45101,,"BERCA",165,"Primaria Berca, str. 1 Decembrie, nr.427",0,200,0,200,0,194,6,300,100,110,84,3,4222,1
10,"Buzau",45245,109,45245,,"BISOCA",166,"Primaria Bisoca, sala de festivitati",553,275,267,8,0,266,9,598,323,72,194,3,4236,0
10,"Buzau",45245,109,45245,,"BISOCA",167,"Campusul ptr. copii Sf.Sava Recea",837,370,358,12,0,366,4,900,530,80,286,3,4236,0
10,"Buzau",45245,109,45245,,"BISOCA",168,"Sc. Plesi",345,190,176,14,0,189,1,400,210,29,160,3,4236,0
10,"Buzau",45245,109,45245,,"BISOCA",169,"Sc.gen. Sarile",415,219,209,10,0,204,15,495,276,65,139,3,4236,0
10,"Buzau",45245,109,45245,,"BISOCA",170,"Primaria Bisoca, sat Bisoca nr.101",0,36,0,36,0,34,2,300,264,11,23,3,4236,1
10,"Buzau",45334,109,45334,,"BLAJANI",171,"Caminul cult. Blajani",707,522,477,4,41,518,4,793,271,107,411,3,4245,0
10,"Buzau",45334,109,45334,,"BLAJANI",172,"Caminul cult. Soresti",270,202,180,8,14,195,7,300,98,42,153,3,4245,0
10,"Buzau",45334,109,45334,,"BLAJANI",173,"Biblioteca comunala Blajani, sat Blajani",0,80,0,80,0,80,0,300,220,17,63,3,4245,1
10,"Buzau",45361,109,45361,,"BOLDU",174,"Clubul Primariei Boldu",1080,708,646,12,50,704,4,1200,492,205,499,3,4248,0
10,"Buzau",45361,109,45361,,"BOLDU",175,"Gradinita de copii Boldu",863,554,509,11,34,549,5,1000,446,175,374,3,4248,0
10,"Buzau",45361,109,45361,,"BOLDU",176,"Primaria Boldu, comuna Boldu",0,99,0,99,0,99,0,300,201,39,60,3,4248,1
10,"Buzau",45389,109,45389,,"BOZIORU",177,"Sc. cu clasele I-IV, Bozioru",573,375,352,0,23,368,7,600,225,207,161,3,4250,0
10,"Buzau",45389,109,45389,,"BOZIORU",178,"Sc.cu clasele I-IV, Fisici",393,286,259,7,20,284,2,407,121,149,135,3,4250,0
10,"Buzau",45389,109,45389,,"BOZIORU",179,"Primaria Bozioru, comuna Bozioru",0,82,0,82,0,80,2,300,218,39,41,3,4250,1
10,"Buzau",45496,109,45496,,"BRADEANU",180,"Sc.gen. Bradeanu",971,606,572,11,23,584,22,1100,494,138,446,3,4261,0
10,"Buzau",45496,109,45496,,"BRADEANU",181,"Sc.gen. Smirdan",806,491,464,11,16,479,12,901,410,109,370,3,4261,0
10,"Buzau",45496,109,45496,,"BRADEANU",182,"Sc.gen. Mitropolia",396,271,242,10,19,268,3,395,124,80,188,3,4261,0
10,"Buzau",45496,109,45496,,"BRADEANU",183,"Primaria Bradeanu, sat Bradeanu",0,88,0,88,0,87,1,300,212,21,66,3,4261,1
10,"Buzau",45539,109,45539,,"BRAESTI",184,"Caminul cultural Braesti",792,406,401,5,0,402,4,793,387,143,259,3,4265,0
10,"Buzau",45539,109,45539,,"BRAESTI",185,"Gradinita Bratilesti",1165,537,530,7,0,526,11,1300,763,206,320,3,4265,0
10,"Buzau",45539,109,45539,,"BRAESTI",186,"Primaria Braesti, comuna Braesti",0,31,0,31,0,31,0,298,267,20,11,3,4265,1
10,"Buzau",45619,109,45619,,"BREAZA",187,"Gradinita cu progr.normal Breaza",924,562,552,10,0,554,8,1000,438,307,247,3,4273,0
10,"Buzau",45619,109,45619,,"BREAZA",188,"Sc.gen. cu clasele I-VIII, Greceanca",856,496,487,9,0,489,7,985,489,295,194,3,4273,0
10,"Buzau",45619,109,45619,,"BREAZA",189,"Sc.gen. cu clasele I-IV, Vispesti",638,382,376,6,0,376,6,700,318,202,174,3,4273,0
10,"Buzau",45619,109,45619,,"BREAZA",190,"Primaria Breaza, sat Breaza",0,149,0,149,0,148,1,300,151,70,78,3,4273,1
10,"Buzau",45673,109,45673,,"BUDA",191,"Sc. Buda, sat Buda",1426,792,786,6,0,777,15,1600,808,361,416,3,4279,0
10,"Buzau",45673,109,45673,,"BUDA",192,"Sc. Al.Odobescu, sat Al. Odobescu",1092,491,484,7,0,478,13,1200,709,210,268,3,4279,0
10,"Buzau",45673,109,45673,,"BUDA",193,"Primaria Buda, sat Buda",0,148,0,148,0,147,1,300,152,78,69,3,4279,1
10,"Buzau",45815,109,45815,,"C.A. ROSETTI",194,"Sc.cu clasele I-VIII, C.A.Rosetti",791,378,362,16,0,373,5,815,437,127,246,3,4287,0
10,"Buzau",45815,109,45815,,"C.A. ROSETTI",195,"Sc.cu clasele I-IV, Balteni",432,264,256,8,0,259,5,500,236,124,135,3,4287,0
10,"Buzau",45815,109,45815,,"C.A. ROSETTI",196,"Sc. cu clasele I-IV, Bilhacu",187,95,87,8,0,91,4,190,95,23,68,3,4287,0
10,"Buzau",45815,109,45815,,"C.A. ROSETTI",197,"Sc. cu clasele I-IV, Cotu Ciorii",488,270,261,9,0,269,1,489,219,96,173,3,4287,0
10,"Buzau",45815,109,45815,,"C.A. ROSETTI",198,"Sediul fostei primarii Lunca",984,625,617,8,0,615,10,1087,462,160,455,3,4287,0
10,"Buzau",45815,109,45815,,"C.A. ROSETTI",199,"Sc. cu clasele I-IV, Vizireni",392,258,253,5,0,257,1,390,132,132,125,3,4287,0
10,"Buzau",45815,109,45815,,"C.A. ROSETTI",200,"Primaria C.A. Rosetti, sat C.A. Rosetti",0,121,0,121,0,120,1,301,180,57,63,3,4287,1
10,"Buzau",45753,109,45753,,"CALVINI",201,"Camin cult. Calvini",804,424,418,6,0,413,11,898,474,213,200,3,4294,0
10,"Buzau",45753,109,45753,,"CALVINI",202,"Sc. Dumitru Ionescu, Calvini",1324,632,624,8,0,608,24,1397,765,248,360,3,4294,0
10,"Buzau",45753,109,45753,,"CALVINI",203,"Sc. cu clasele I-IV, Bascenii de Jos",490,324,310,14,0,315,9,455,131,142,173,3,4294,0
10,"Buzau",45753,109,45753,,"CALVINI",204,"Sc. cu clasele I-VIII, Bascenii de Sus",744,398,393,5,0,392,6,838,440,234,158,3,4294,0
10,"Buzau",45753,109,45753,,"CALVINI",205,"Primaria Calvini, sat Calvini",0,112,0,112,0,112,0,300,188,68,44,3,4294,1
10,"Buzau",45888,109,45888,,"CANESTI",206,"Sc.gen. Canesti",586,393,367,4,22,386,7,600,207,148,238,3,4300,0
10,"Buzau",45888,109,45888,,"CANESTI",207,"Sc. cu clasele I-IV, Negosina",169,137,123,9,5,136,1,200,63,37,99,3,4300,0
10,"Buzau",45888,109,45888,,"CANESTI",208,"Primaria Canesti, sat Canesti, nr.66",0,53,0,53,0,53,0,300,247,23,30,3,4300,1
10,"Buzau",45959,109,45959,,"CATINA",209,"Caminul cultural Catina",1187,753,711,4,38,749,4,1400,647,335,414,3,4307,0
10,"Buzau",45959,109,45959,,"CATINA",210,"Sc.gen. cl.I-VIII, Corbu",674,429,417,3,9,427,2,700,271,126,301,3,4307,0
10,"Buzau",45959,109,45959,,"CATINA",211,"Sc. cu clasele I-IV,  Zeletin",174,53,48,5,0,53,0,200,147,16,37,3,4307,0
10,"Buzau",45959,109,45959,,"CATINA",212,"Primaria Catina, str.Principala, nr.320",0,101,0,101,0,100,1,303,202,54,46,3,4307,1
10,"Buzau",46019,109,46019,,"CERNATESTI",213,"Sc.gen. Cernatesti",991,576,552,20,4,570,6,1100,524,291,279,3,4313,0
10,"Buzau",46019,109,46019,,"CERNATESTI",214,"Camin cult. Zarnesti Slanic",1097,612,598,11,3,598,14,1200,588,347,251,3,4313,0
10,"Buzau",46019,109,46019,,"CERNATESTI",215,"Camin cult. Aldeni",663,402,396,6,0,396,6,700,298,190,206,3,4313,0
10,"Buzau",46019,109,46019,,"CERNATESTI",216,"Sc.gen. Fulga",443,260,253,7,0,256,4,500,240,108,148,3,4313,0
10,"Buzau",46019,109,46019,,"CERNATESTI",217,"Primaria Cernatesti, comuna Cernatesti",0,176,0,176,0,175,1,300,124,92,83,3,4313,1
10,"Buzau",46108,109,46108,,"CHILIILE",218,"Sala de festivitati a Consiliului local Chiliile",354,255,249,0,6,252,3,500,245,73,179,3,4322,0
10,"Buzau",46108,109,46108,,"CHILIILE",219,"Sc.gen. cu clasele I-IV, Trestioara",235,140,131,9,0,136,4,302,162,23,113,3,4322,0
10,"Buzau",46108,109,46108,,"CHILIILE",220,"Primaria Chiliile, sat Chiliile",0,77,0,77,0,77,0,301,224,36,41,3,4322,1
10,"Buzau",46180,109,46180,,"CHIOJDU",221,"Sc.gen. din satul Chiojdu",815,486,472,4,10,482,4,1000,514,228,254,3,4330,0
10,"Buzau",46180,109,46180,,"CHIOJDU",222,"Sc.gen. din satul Bisca Chiojdului",1153,721,706,4,11,715,6,1300,579,316,399,3,4330,0
10,"Buzau",46180,109,46180,,"CHIOJDU",223,"Sc.gen. din satul Catiasu",360,195,187,8,0,189,6,398,203,37,152,3,4330,0
10,"Buzau",46180,109,46180,,"CHIOJDU",224,"Sc.gen. din satul Lera",374,238,224,6,8,229,9,482,244,76,153,3,4330,0
10,"Buzau",46180,109,46180,,"CHIOJDU",225,"Sc.gen. din satul Poienitele",251,164,145,9,10,159,5,300,136,74,85,3,4330,0
10,"Buzau",46180,109,46180,,"CHIOJDU",226,"Primaria Chiojdu, sat Chiojdu",0,118,0,118,0,116,2,303,185,33,83,3,4330,1
10,"Buzau",46251,109,46251,,"CILIBIA",227,"Primaria comunei Cilibia",1179,616,581,7,28,604,12,1300,684,238,366,3,4337,0
10,"Buzau",46251,109,46251,,"CILIBIA",228,"Sc. primara din satul Movila Oii",349,252,237,7,8,248,4,400,148,84,164,3,4337,0
10,"Buzau",46251,109,46251,,"CILIBIA",229,"Primaria Cilibia, sat Cilibia",0,76,0,76,0,76,0,300,224,32,44,3,4337,1
10,"Buzau",46313,109,46313,,"CISLAU",230,"Sc.gen. Cislau",1860,1116,1096,20,0,1107,9,2000,884,415,692,3,4343,0
10,"Buzau",46313,109,46313,,"CISLAU",231,"Sc.gen. Scarisoara",1095,762,709,53,0,747,15,1200,438,367,380,3,4343,0
10,"Buzau",46313,109,46313,,"CISLAU",232,"Centrul de zi Buda Craciunesti",686,398,385,13,0,393,5,800,402,186,207,3,4343,0
10,"Buzau",46313,109,46313,,"CISLAU",233,"Sc. cu clasele I-IV, Gura Bascii",283,162,147,15,0,162,0,400,238,63,99,3,4343,0
10,"Buzau",46313,109,46313,,"CISLAU",234,"Primaria Cislau, str.Culturii, nr.64",0,142,0,142,0,142,0,300,158,66,76,3,4343,1
10,"Buzau",46377,109,46377,,"COCHIRLEANCA",235,"Caminul cultural sat vechi Cochirleanca",1502,625,601,24,0,614,11,1701,1076,221,393,3,4349,0
10,"Buzau",46377,109,46377,,"COCHIRLEANCA",236,"Sc.nr.2 sat nou Cochirleanca",720,402,334,68,0,389,13,800,398,142,247,3,4349,0
10,"Buzau",46377,109,46377,,"COCHIRLEANCA",237,"Sc.cu clasele I-VIII, Boboc",1365,602,596,6,0,590,12,1500,898,236,354,3,4349,0
10,"Buzau",46377,109,46377,,"COCHIRLEANCA",238,"Sc.cu clasele I-IV, Rosioru",620,304,289,15,0,295,9,700,396,135,160,3,4349,0
10,"Buzau",46377,109,46377,,"COCHIRLEANCA",239,"Sc.cu clasele I-IV, sat Gara Boboc",254,156,149,7,0,154,2,300,144,83,71,3,4349,0
10,"Buzau",46377,109,46377,,"COCHIRLEANCA",240,"Sc. cu clasele I-IV, Tirlele",44,42,30,12,0,40,2,101,59,18,22,3,4349,0
10,"Buzau",46377,109,46377,,"COCHIRLEANCA",241,"Primaria Cochirleanca, sat Cochirleanca",0,51,0,51,0,51,0,301,250,27,24,3,4349,1
10,"Buzau",46439,109,46439,,"COLTI",242,"Sc. gen. Colti",477,295,285,5,5,293,2,499,204,115,178,3,4355,0
10,"Buzau",46439,109,46439,,"COLTI",243,"Sc. gen. Alunis",133,110,101,7,2,110,0,200,90,44,66,3,4355,0
10,"Buzau",46439,109,46439,,"COLTI",244,"Caminul cultural Muscelul Caramanesti",129,96,88,8,0,94,2,200,104,23,71,3,4355,0
10,"Buzau",46439,109,46439,,"COLTI",245,"Sc. cu clasele I-IV, Coltii de jos",287,200,189,10,1,195,5,300,100,48,147,3,4355,0
10,"Buzau",46439,109,46439,,"COLTI",246,"Primaria Colti, sat Colti, str.Principala, nr.141",0,40,0,40,0,40,0,301,261,22,18,3,4355,1
10,"Buzau",46484,109,46484,,"COSTESTI",247,"Sc.noua Costesti, sat Costesti",1265,671,659,12,0,659,12,1400,729,283,376,3,4360,0
10,"Buzau",46484,109,46484,,"COSTESTI",248,"Gradinita noua sat Pietrosu",1189,576,558,18,0,560,16,1300,724,183,377,3,4360,0
10,"Buzau",46484,109,46484,,"COSTESTI",249,"Sc. Budisteni",428,280,267,13,0,272,8,500,220,119,153,3,4360,0
10,"Buzau",46484,109,46484,,"COSTESTI",250,"Sc. Spataru",887,444,433,11,0,442,2,998,554,221,221,3,4360,0
10,"Buzau",46484,109,46484,,"COSTESTI",251,"Sc. Gomoesti",235,149,142,7,0,148,1,302,153,53,95,3,4360,0
10,"Buzau",46484,109,46484,,"COSTESTI",252,"Sc. gen. Costesti, sat Costesti",0,167,0,167,0,165,2,301,134,92,73,3,4360,1
10,"Buzau",46554,109,46554,,"COZIENI",253,"Sc. gen. Cozieni",561,328,321,7,0,326,2,609,281,185,141,3,4367,0
10,"Buzau",46554,109,46554,,"COZIENI",254,"Sc. gen. Balanesti",705,453,447,6,0,444,9,823,370,247,197,3,4367,0
10,"Buzau",46554,109,46554,,"COZIENI",255,"Caminul cult. Trestia",401,235,232,3,0,234,1,403,168,81,153,3,4367,0
10,"Buzau",46554,109,46554,,"COZIENI",256,"Sc. cu clasele I-IV, Pietraru",265,133,129,4,0,128,5,302,169,53,75,3,4367,0
10,"Buzau",46554,109,46554,,"COZIENI",257,"Primaria Cozieni, sat Cozieni",0,136,0,136,0,133,3,300,164,76,57,3,4367,1
10,"Buzau",50564,109,50564,,"FLORICA",258,"Sc.gen. cu clasele I-VIII, Florica",1268,744,742,2,0,725,19,1400,656,358,367,3,4388,0
10,"Buzau",50564,109,50564,,"FLORICA",259,"Primaria Florica, comuna Florica",0,97,0,97,0,97,0,300,203,44,53,3,4388,1
10,"Buzau",46769,109,46769,,"GALBINASI",260,"Sc. cu clasele I-VIII, Galbinasi",1040,563,556,7,0,557,6,1200,637,229,328,3,4390,0
10,"Buzau",46769,109,46769,,"GALBINASI",261,"Caminul cultural Bentu",764,449,442,7,0,445,4,888,439,261,184,3,4390,0
10,"Buzau",46769,109,46769,,"GALBINASI",262,"Sc. nr.1 Tabarastii Vechi",637,374,360,14,0,371,3,700,326,167,204,3,4390,0
10,"Buzau",46769,109,46769,,"GALBINASI",263,"Gradinita nr.2, Tabarastii Noi",957,538,525,13,0,531,7,996,458,239,292,3,4390,0
10,"Buzau",46769,109,46769,,"GALBINASI",264,"Sc. gen. Galbinasi, sat Galbinasi, nr.4",0,112,0,112,0,110,2,300,188,54,56,3,4390,1
10,"Buzau",46803,109,46803,,"GHERASENI",265,"Gradinita de copii din satul Gheraseni",1822,975,968,7,0,963,12,2000,1025,534,429,3,4394,0
10,"Buzau",46803,109,46803,,"GHERASENI",266,"Sc.cu clasele I-IV, Gheraseni 2 (fost sat Cremenea)",685,386,371,12,3,383,3,685,299,179,204,3,4394,0
10,"Buzau",46803,109,46803,,"GHERASENI",267,"Sc. cu clasele I-IV, Suditi",500,246,235,10,1,244,2,500,254,113,131,3,4394,0
10,"Buzau",46803,109,46803,,"GHERASENI",268,"Primaria Gheraseni, str. Principala",0,80,0,80,0,80,0,300,220,36,44,3,4394,1
10,"Buzau",46830,109,46830,,"GHERGHEASA",269,"Sc.gen. Ghergheasa",1136,614,607,7,0,599,15,1290,676,211,388,3,4397,0
10,"Buzau",46830,109,46830,,"GHERGHEASA",270,"Sc.gen. Salcioara",987,559,550,9,0,553,6,1000,441,173,380,3,4397,0
10,"Buzau",46830,109,46830,,"GHERGHEASA",271,"Primaria Ghergheasa, comuna Ghergheasa",0,101,0,101,0,100,1,300,199,43,57,3,4397,1
10,"Buzau",46867,109,46867,,"GLODEANU SARAT",272,"Caminul cult. din satul Gl.Sarat",1966,1179,1146,33,0,1151,28,2200,1021,395,756,3,4400,0
10,"Buzau",46867,109,46867,,"GLODEANU SARAT",273,"Sc. cu clasele I-IV din satul  Ileana",385,255,247,8,0,249,6,499,244,79,170,3,4400,0
10,"Buzau",46867,109,46867,,"GLODEANU SARAT",274,"Sc. cu clasele I-VIII din satul Pitulicea",747,412,385,27,0,401,11,800,388,150,251,3,4400,0
10,"Buzau",46867,109,46867,,"GLODEANU SARAT",275,"Caminul cult. din satul Caldarusanca",509,352,330,22,0,349,3,600,248,108,241,3,4400,0
10,"Buzau",46867,109,46867,,"GLODEANU SARAT",276,"Primaria Glodeanu Sarat, sat Glodeanu Sarat",0,141,0,141,0,138,3,300,159,55,83,3,4400,1
10,"Buzau",46910,109,46910,,"GLODEANU-SILISTEA",277,"Caminul cult. Gl.Silistea",1336,743,741,2,0,721,22,1500,757,316,405,3,4405,0
10,"Buzau",46910,109,46910,,"GLODEANU-SILISTEA",278,"Caminul cult. Cotorca",850,548,537,11,0,534,14,1000,452,180,354,3,4405,0
10,"Buzau",46910,109,46910,,"GLODEANU-SILISTEA",279,"Sc. Cirligu Mare",443,255,252,3,0,252,3,500,245,83,169,3,4405,0
10,"Buzau",46910,109,46910,,"GLODEANU-SILISTEA",280,"Sc. Vacareasca",495,252,244,8,0,248,4,500,248,105,143,3,4405,0
10,"Buzau",46910,109,46910,,"GLODEANU-SILISTEA",281,"Gradinita Casota",303,162,152,10,0,162,0,400,238,73,89,3,4405,0
10,"Buzau",46910,109,46910,,"GLODEANU-SILISTEA",282,"Primaria Glodeanu Silistea, comuna Glodeanu Silistea",0,182,0,182,0,178,4,300,118,61,117,3,4405,1
10,"Buzau",47006,109,47006,,"GREBANU",283,"Sc. Plevna",1166,706,695,11,0,699,7,1300,594,301,398,3,4414,0
10,"Buzau",47006,109,47006,,"GREBANU",284,"Sc. Grebanu",1763,1141,1092,22,27,1130,11,2000,859,853,277,3,4414,0
10,"Buzau",47006,109,47006,,"GREBANU",285,"Sc. Homesti",807,470,464,6,0,467,3,1001,531,225,242,3,4414,0
10,"Buzau",47006,109,47006,,"GREBANU",286,"Sc. Livada Mare",629,414,384,12,18,406,8,700,286,219,187,3,4414,0
10,"Buzau",47006,109,47006,,"GREBANU",287,"Caminul cultural Grebanu, sat Grebanu",0,173,0,173,0,173,0,300,127,99,74,3,4414,1
10,"Buzau",47079,109,47079,,"GURA TEGHII",288,"Sc.gen.cu clasele I-VIII, Paltinis",596,370,359,6,5,364,6,700,330,156,208,3,4421,0
10,"Buzau",47079,109,47079,,"GURA TEGHII",289,"Caminul cult. sat Furtunesti",830,534,525,8,1,527,7,897,363,253,274,3,4421,0
10,"Buzau",47079,109,47079,,"GURA TEGHII",290,"Caminul cul. sat Gura Teghii",1138,761,737,8,16,754,7,1200,439,357,397,3,4421,0
10,"Buzau",47079,109,47079,,"GURA TEGHII",291,"Sc.gen.cu clasele I-IV, sat Varlaam",509,275,269,6,0,273,2,500,225,129,144,3,4421,0
10,"Buzau",47079,109,47079,,"GURA TEGHII",292,"Primaria Gura Teghii, sat Gura Teghii",0,89,0,89,0,89,0,300,211,48,41,3,4421,1
10,"Buzau",47159,109,47159,,"LARGU",293,"Sala de sedinte a Cons. local Largu",1391,805,798,7,0,798,7,1474,669,481,317,3,4429,0
10,"Buzau",47159,109,47159,,"LARGU",294,"Primaria Largu, comuna Largu",0,77,0,77,0,77,0,300,223,47,30,3,4429,1
10,"Buzau",47186,109,47186,,"LOPATARI",295,"Caminul cult. Lopatari",1112,615,573,42,0,610,5,1105,490,256,354,3,4432,0
10,"Buzau",47186,109,47186,,"LOPATARI",296,"Caminul cult. Luncile",702,335,304,31,0,327,8,700,365,158,169,3,4432,0
10,"Buzau",47186,109,47186,,"LOPATARI",297,"Sc.Terca",423,233,217,16,0,232,1,493,260,103,129,3,4432,0
10,"Buzau",47186,109,47186,,"LOPATARI",298,"Sc. Plostina",470,251,234,17,0,246,5,501,250,97,149,3,4432,0
10,"Buzau",47186,109,47186,,"LOPATARI",299,"Sc. Plaiul Nucului",658,316,301,15,0,311,5,701,385,92,219,3,4432,0
10,"Buzau",47186,109,47186,,"LOPATARI",300,"Primaria Lopatari, comuna Lopatari",0,101,0,101,0,101,0,300,199,36,65,3,4432,1
10,"Buzau",47300,109,47300,,"LUCIU",301,"Sc. gen. Luciu",1654,1004,995,9,0,989,15,1800,796,628,361,3,4444,0
10,"Buzau",47300,109,47300,,"LUCIU",302,"Sc. gen. Caragele",717,468,460,8,0,462,6,791,323,243,219,3,4444,0
10,"Buzau",47300,109,47300,,"LUCIU",303,"Primaria Luciu, comuna Luciu, nr.507",0,71,0,71,0,71,0,300,229,39,32,3,4444,1
10,"Buzau",47337,109,47337,,"MAGURA",304,"Sc.gen. Magura",1183,622,620,2,0,612,10,1300,678,250,362,3,4447,0
10,"Buzau",47337,109,47337,,"MAGURA",305,"Sc.gen. Ciuta",625,391,380,11,0,376,15,700,309,115,261,3,4447,0
10,"Buzau",47337,109,47337,,"MAGURA",306,"Primaria Magura, str. Mihai Viteazu, nr.195",0,140,0,140,0,140,0,311,171,63,77,3,4447,1
10,"Buzau",47373,109,47373,,"MARACINENI",307,"Sc.gen. Potoceni, str. Centrala nr.105",1566,946,932,14,0,939,7,1700,754,593,346,3,4464,0
10,"Buzau",47373,109,47373,,"MARACINENI",308,"Gradinita din satul Capatinesti, str. Centrala nr.96",1594,1028,1006,22,0,1018,10,1800,772,630,388,3,4464,0
10,"Buzau",47373,109,47373,,"MARACINENI",309,"Sc.gen. Capatanesti, str. Centrala nr.59",821,501,487,14,0,497,4,1000,499,332,165,3,4464,0
10,"Buzau",47373,109,47373,,"MARACINENI",310,"Sc.gen. Maracineni, str. Centrala nr 147",1292,761,749,12,0,756,5,1400,639,457,299,3,4464,0
10,"Buzau",47373,109,47373,,"MARACINENI",311,"Sc.gen. Maracineni, str. Centrala nr.147",1104,653,643,10,0,646,7,1200,547,432,214,3,4464,0
10,"Buzau",47373,109,47373,,"MARACINENI",312,"Primaria Maracineni, sat Capatanesti, str. Centrala, nr.96",0,175,0,175,0,173,2,300,125,105,68,3,4464,1
10,"Buzau",47417,109,47417,,"MARGARITESTI",313,"Primaria Margaritesti",684,414,411,3,0,405,9,800,386,214,191,3,4468,0
10,"Buzau",47417,109,47417,,"MARGARITESTI",314,"Primaria Margaritesti, comuna Margaritesti",0,46,0,46,0,46,0,300,254,22,24,3,4468,1
10,"Buzau",47453,109,47453,,"MEREI",315,"Sc.gen. Merei",978,463,455,8,0,460,3,1101,638,184,276,3,4472,0
10,"Buzau",47453,109,47453,,"MEREI",316,"Sc.gen. Lipia",1606,879,867,10,2,866,13,1800,921,297,569,3,4472,0
10,"Buzau",47453,109,47453,,"MEREI",317,"Sc.gen. Sarata Monteoru",721,424,416,8,0,422,2,762,338,203,219,3,4472,0
10,"Buzau",47453,109,47453,,"MEREI",318,"Sc.gen.Gura Saratii",161,97,91,6,0,97,0,200,103,32,65,3,4472,0
10,"Buzau",47453,109,47453,,"MEREI",319,"Sc.gen. Dealu Viei",639,341,337,4,0,340,1,700,359,152,188,3,4472,0
10,"Buzau",47453,109,47453,,"MEREI",320,"Sc.gen. Izvoru Dulce",831,340,333,7,0,335,5,1000,660,170,165,3,4472,0
10,"Buzau",47453,109,47453,,"MEREI",321,"Sc.gen. Nenciulesti",238,135,127,8,0,135,0,300,165,60,75,3,4472,0
10,"Buzau",47453,109,47453,,"MEREI",322,"Sc.gen. Ograzi",580,302,299,3,0,299,3,600,298,142,157,3,4472,0
10,"Buzau",47453,109,47453,,"MEREI",323,"Primaria Merei, comuna Merei",0,352,0,352,0,348,4,400,48,178,170,3,4472,1
10,"Buzau",47578,109,47578,,"MIHAILESTI",324,"Sc.cu clasele I-VIII, Mihailesti",1039,518,511,7,0,503,15,1100,582,193,310,3,4484,0
10,"Buzau",47578,109,47578,,"MIHAILESTI",325,"Sc. cu clasele I-IV, Margineanu",632,319,311,8,0,310,9,700,381,82,228,3,4484,0
10,"Buzau",47578,109,47578,,"MIHAILESTI",326,"Primaria Mihailesti, sat Mihailesti",0,69,0,69,0,69,0,300,231,24,45,3,4484,1
10,"Buzau",47630,109,47630,,"MANZALESTI",327,"Sc. Minzalesti",779,399,393,5,1,395,4,800,401,204,191,3,4450,0
10,"Buzau",47630,109,47630,,"MANZALESTI",328,"Sc. Beslii",520,277,267,6,4,271,6,594,317,133,138,3,4450,0
10,"Buzau",47630,109,47630,,"MANZALESTI",329,"Sc. Valea Cotoarei",151,108,100,8,0,107,1,200,92,58,49,3,4450,0
10,"Buzau",47630,109,47630,,"MANZALESTI",330,"Sc. Gura Badicului",419,215,207,6,2,213,2,501,286,136,77,3,4450,0
10,"Buzau",47630,109,47630,,"MANZALESTI",331,"Sc. Trestioara",282,156,147,9,0,155,1,300,144,87,68,3,4450,0
10,"Buzau",47630,109,47630,,"MANZALESTI",332,"Primaria Manzalesti, comuna Manzalesti",0,65,0,65,0,65,0,300,235,30,35,3,4450,1
10,"Buzau",47774,109,47774,,"MOVILA BANULUI",333,"Caminul cult. din satul Movila Banului",1069,693,646,11,36,679,14,1200,507,384,295,3,4489,0
10,"Buzau",47774,109,47774,,"MOVILA BANULUI",334,"Caminul cult. din satul Limpezis",865,605,535,12,58,598,7,1001,396,378,220,3,4489,0
10,"Buzau",47774,109,47774,,"MOVILA BANULUI",335,"Sc. gen. din satul  Cioranca",209,152,132,7,13,150,2,300,148,89,61,3,4489,0
10,"Buzau",47774,109,47774,,"MOVILA BANULUI",336,"Primaria Movila Banului, comuna Movila Banului",0,132,0,132,0,132,0,300,168,75,57,3,4489,1
10,"Buzau",47818,109,47818,,"MURGESTI",337,"Sediul Primariei Murgesti",876,599,590,9,0,587,12,1000,401,268,319,3,4493,0
10,"Buzau",47818,109,47818,,"MURGESTI",338,"Primaria Murgesti, sat Murgesti",0,74,0,74,0,73,1,300,226,22,51,3,4493,1
10,"Buzau",47854,109,47854,,"NAENI",339,"Fostul CAP Naeni",493,275,257,18,0,271,4,478,203,103,168,3,4497,0
10,"Buzau",47854,109,47854,,"NAENI",340,"Sc. Fintesti",537,314,302,12,0,309,5,618,304,98,211,3,4497,0
10,"Buzau",47854,109,47854,,"NAENI",341,"Sc. Virf",251,172,159,13,0,170,2,304,132,61,109,3,4497,0
10,"Buzau",47854,109,47854,,"NAENI",342,"Gradinita Prosca",190,125,104,21,0,122,3,200,75,58,64,3,4497,0
10,"Buzau",47854,109,47854,,"NAENI",343,"Caminul cultural Naeni, sat Naeni",0,74,0,74,0,74,0,306,232,40,34,3,4497,1
10,"Buzau",48021,109,48021,,"ODAILE",344,"Sc. cu clasele I-VIII, Odaile",801,528,470,2,56,523,5,900,372,321,202,3,4503,0
10,"Buzau",48021,109,48021,,"ODAILE",345,"Primaria Odaile, comuna Odaile",0,71,0,71,0,71,0,301,230,48,23,3,4503,1
10,"Buzau",48138,109,48138,,"PADINA",346,"Sc. nr.2 Padina",1513,668,648,20,0,647,21,1700,1032,211,436,3,4514,0
10,"Buzau",48138,109,48138,,"PADINA",347,"Caminul cult. Padina",1090,611,544,67,0,595,16,1200,589,200,395,3,4514,0
10,"Buzau",48138,109,48138,,"PADINA",348,"Sc.nr.1 Padina",1040,571,509,62,0,560,11,1101,530,152,408,3,4514,0
10,"Buzau",48138,109,48138,,"PADINA",349,"Primaria Padina, str. Erou Arma Ion",0,155,0,155,0,153,2,300,145,69,84,3,4514,1
10,"Buzau",48165,109,48165,,"PARDOSI",350,"Sc.gen. Pardosi",439,332,273,3,56,328,4,500,168,190,138,3,4527,0
10,"Buzau",48165,109,48165,,"PARDOSI",351,"Primaria Pardosi, comuna Pardosi",0,68,0,68,0,67,1,300,232,37,30,3,4527,1
10,"Buzau",48227,109,48227,,"PANATAU",352,"Sc.cu clasele I-VIII,  Panatau",1592,922,919,3,0,910,12,1800,878,472,438,3,4517,0
10,"Buzau",48227,109,48227,,"PANATAU",353,"Sc.cu clasele I-IV, Zaharesti",636,341,332,9,0,334,7,700,359,223,111,3,4517,0
10,"Buzau",48227,109,48227,,"PANATAU",354,"Scoala gen. Panatau, sat Panatau",0,69,0,69,0,69,0,300,231,41,28,3,4517,1
10,"Buzau",48487,109,48487,,"PIETROASELE",355,"Sc. cu clasele I-VIII din satul  Pietroasele",1633,943,915,28,0,923,20,1815,872,571,352,3,4546,0
10,"Buzau",48487,109,48487,,"PIETROASELE",356,"Gradinita cu program normal din satul Saringa",1198,645,634,11,0,632,13,1300,655,331,301,3,4546,0
10,"Buzau",48487,109,48487,,"PIETROASELE",357,"Primaria Pietroasele, sat Pietroasele, nr.188",0,217,0,217,0,217,0,300,83,121,96,3,4546,1
10,"Buzau",48557,109,48557,,"PARSCOV",358,"Caminul cult Pirscov",1332,599,594,4,1,593,6,1500,901,269,324,3,4533,0
10,"Buzau",48557,109,48557,,"PARSCOV",359,"Caminul cult.Pirscov",1275,589,579,10,0,580,9,1400,811,232,348,3,4533,0
10,"Buzau",48557,109,48557,,"PARSCOV",360,"Sc.gen. Badila",660,317,307,10,0,312,5,700,383,135,177,3,4533,0
10,"Buzau",48557,109,48557,,"PARSCOV",361,"Sc. gen. Lunca Frumoasa",982,516,503,13,0,512,4,1101,585,197,315,3,4533,0
10,"Buzau",48557,109,48557,,"PARSCOV",362,"Sc.gen. Robesti",547,306,298,8,0,302,4,600,294,114,188,3,4533,0
10,"Buzau",48557,109,48557,,"PARSCOV",363,"Trestieni - Magazinul cooperativei de consum Parscov",67,32,22,10,0,31,1,100,68,12,19,3,4533,0
10,"Buzau",48557,109,48557,,"PARSCOV",364,"Primaria Parscov, comuna Parscov",0,157,0,157,0,156,1,300,143,72,84,3,4533,1
10,"Buzau",48682,109,48682,,"PODGORIA",365,"Sc. gen. cu clasele I-VIII, Podgoria",1291,653,630,16,7,640,13,1395,742,335,305,3,4553,0
10,"Buzau",48682,109,48682,,"PODGORIA",366,"Sc. gen. cu clasele I-VIII, Cotatcu",1020,532,508,18,6,523,9,1100,568,275,248,3,4553,0
10,"Buzau",48682,109,48682,,"PODGORIA",367,"Sc. gen. cu clasele I-IV, Plesesti",351,150,140,10,0,147,3,406,256,95,52,3,4553,0
10,"Buzau",48682,109,48682,,"PODGORIA",368,"Primaria Podgoria, sat Podgoria",0,78,0,78,0,78,0,300,222,36,42,3,4553,1
10,"Buzau",48771,109,48771,,"POSTA CALNAU",369,"Gradinita din satul Posta Cilnau",1972,1264,1238,10,16,1245,19,2200,936,605,640,3,4559,0
10,"Buzau",48771,109,48771,,"POSTA CALNAU",370,"Sc.gen. din satul Potirnichesti",369,244,229,15,0,243,1,517,273,129,114,3,4559,0
10,"Buzau",48771,109,48771,,"POSTA CALNAU",371,"Sc.gen. din satul Zilisteanca",1056,666,645,19,2,657,9,1200,534,287,370,3,4559,0
10,"Buzau",48771,109,48771,,"POSTA CALNAU",372,"Sc.gen. din satul Suditi",1545,934,914,16,4,915,19,1700,766,393,522,3,4559,0
10,"Buzau",48771,109,48771,,"POSTA CALNAU",373,"Primaria Posta Calnau, sat Posta Calnau",0,275,0,275,0,273,2,300,25,145,128,3,4559,1
10,"Buzau",48842,109,48842,,"PUIESTI",374,"Sc. din satul Puiesti de Jos",1586,804,793,11,0,796,8,1700,896,243,553,3,4566,0
10,"Buzau",48842,109,48842,,"PUIESTI",375,"Sc. din satul Nicolesti",1454,635,625,10,0,625,10,1600,965,200,425,3,4566,0
10,"Buzau",48842,109,48842,,"PUIESTI",376,"Sc. din satul Macrina",528,308,296,12,0,304,4,500,192,84,220,3,4566,0
10,"Buzau",48842,109,48842,,"PUIESTI",377,"Primaria Puiesti, sat Puiestii de Jos",0,130,0,130,0,130,0,300,170,47,83,3,4566,1
10,"Buzau",48922,109,48922,,"RACOVITENI",378,"Primaria comunei Racoviteni",1137,591,584,7,0,575,16,1300,709,210,365,3,4574,0
10,"Buzau",48922,109,48922,,"RACOVITENI",379,"Primaria Racoviteni, sat Racoviteni",0,84,0,84,0,84,0,301,217,36,48,3,4574,1
10,"Buzau",48968,109,48968,,"RAMNICELU",380,"Sc.nr.1 sat Rimnicelu",847,384,373,11,0,373,11,910,526,189,184,3,4578,0
10,"Buzau",48968,109,48968,,"RAMNICELU",381,"Sc.nr.2 sat Rimnicelu",1440,525,519,6,0,513,12,1600,1075,348,165,3,4578,0
10,"Buzau",48968,109,48968,,"RAMNICELU",382,"Sc. Stiubei sat Stiubei",507,257,252,5,0,256,1,600,343,82,174,3,4578,0
10,"Buzau",48968,109,48968,,"RAMNICELU",383,"Sc. din satul Colibasi",304,177,166,11,0,174,3,400,223,46,128,3,4578,0
10,"Buzau",48968,109,48968,,"RAMNICELU",384,"Sc. sat Fotin",157,100,90,10,0,98,2,200,100,38,60,3,4578,0
10,"Buzau",48968,109,48968,,"RAMNICELU",385,"Primaria Ramnicelu, sat Ramnicelu",0,64,0,64,0,64,0,300,236,28,36,3,4578,1
10,"Buzau",49019,109,49019,,"ROBEASCA",386,"Sc.cu clasele I-VIII, sat Robeasca",639,384,345,6,33,379,5,719,335,96,283,3,4583,0
10,"Buzau",49019,109,49019,,"ROBEASCA",387,"Sc. cu clasele I-IV, sat Mosesti",327,225,184,10,31,221,4,401,176,39,182,3,4583,0
10,"Buzau",49019,109,49019,,"ROBEASCA",388,"Primaria Robeasca, str. Principala, nr.14",0,79,0,79,0,77,2,302,223,20,57,3,4583,1
10,"Buzau",49046,109,49046,,"RUSETU",389,"Sc. de arte si meserii Rusetu, str. 1 Decembrie 1918, nr.10",1025,632,628,4,0,625,7,1100,468,258,367,3,4586,0
10,"Buzau",49046,109,49046,,"RUSETU",390,"Dispensar med. Rusetu, str. 1 Decembrie 1918, nr.4A",1058,638,628,10,0,629,9,1080,442,254,375,3,4586,0
10,"Buzau",49046,109,49046,,"RUSETU",391,"Caminul cult. ""Dimitrie Gusti"" din satul  Rusetu, str. 1 decembrie 1918 nr.35",1118,681,664,17,0,672,9,1200,519,293,379,3,4586,0
10,"Buzau",49046,109,49046,,"RUSETU",392,"Sc.primara din satul Serg.Ionel Stefan, str. Unirii nr.16",194,149,137,12,0,148,1,300,151,49,99,3,4586,0
10,"Buzau",49046,109,49046,,"RUSETU",393,"Primaria Rusetu, comuna Rusetu",0,164,0,164,0,164,0,300,136,86,78,3,4586,1
10,"Buzau",49073,109,49073,,"SAGEATA",394,"Sc. Sageata",1278,906,861,18,27,896,10,1386,480,347,549,3,4589,0
10,"Buzau",49073,109,49073,,"SAGEATA",395,"Sc. Dimbroca",1004,712,686,16,10,698,14,1090,378,402,296,3,4589,0
10,"Buzau",49073,109,49073,,"SAGEATA",396,"Sc. Bordusani",370,272,253,15,4,268,4,400,128,110,158,3,4589,0
10,"Buzau",49073,109,49073,,"SAGEATA",397,"Sc. Beilic",320,253,226,20,7,251,2,400,147,76,175,3,4589,0
10,"Buzau",49073,109,49073,,"SAGEATA",398,"Sc. Gavanesti",982,652,600,4,48,645,7,1097,445,239,406,3,4589,0
10,"Buzau",49073,109,49073,,"SAGEATA",399,"Sc. Banita",271,226,199,10,17,224,2,300,74,76,148,3,4589,0
10,"Buzau",49073,109,49073,,"SAGEATA",400,"Primaria Sageata, comuna Sageata",0,220,0,220,0,216,4,300,80,77,139,3,4589,1
10,"Buzau",49153,109,49153,,"SAHATENI",401,"Caminul cult. Sahateni, sat Sahateni",1294,710,693,17,0,699,11,1400,690,423,276,3,4597,0
10,"Buzau",49153,109,49153,,"SAHATENI",402,"Sc.cu clasele I-IV, Istrita de Jos",271,178,159,19,0,177,1,297,119,102,75,3,4597,0
10,"Buzau",49153,109,49153,,"SAHATENI",403,"Sc. cu clasele I-IV, Gageni",312,222,175,47,0,217,5,300,78,132,85,3,4597,0
10,"Buzau",49153,109,49153,,"SAHATENI",404,"Sc. cu clasele I-VIII, Vintileanca",867,377,369,8,0,371,6,922,545,200,171,3,4597,0
10,"Buzau",49153,109,49153,,"SAHATENI",405,"Primaria Sahateni, sat Sahateni, str. Principala, nr.143",0,84,0,84,0,83,1,315,231,45,38,3,4597,1
10,"Buzau",49206,109,49206,,"SAPOCA",406,"Sc. cu clasele I-VIII din satul Sapoca",1465,847,835,12,0,837,10,1600,753,413,424,3,4602,0
10,"Buzau",49206,109,49206,,"SAPOCA",407,"Sc. cu clasele I-VIII din satul Matesti",1338,819,810,9,0,811,8,1500,681,385,426,3,4602,0
10,"Buzau",49206,109,49206,,"SAPOCA",408,"Primaria Sapoca, sat Sapoca, nr.470",0,123,0,123,0,123,0,300,177,55,68,3,4602,1
10,"Buzau",49233,109,49233,,"SARULESTI",409,"Caminul cult. al comunei Sarulesti",1205,575,570,5,0,571,4,1300,725,228,343,3,4605,0
10,"Buzau",49233,109,49233,,"SARULESTI",410,"Primaria Sarulesti, sat Sarulesti",0,67,0,67,0,67,0,300,233,29,38,3,4605,1
10,"Buzau",49313,109,49313,,"SCORTOASA",411,"Sala de festivitati Scortoasa",1103,514,502,12,0,508,6,1172,658,230,278,3,4613,0
10,"Buzau",49313,109,49313,,"SCORTOASA",412,"Sc.cu clasele I-IV, Gura Vaii",186,125,113,12,0,124,1,200,75,43,81,3,4613,0
10,"Buzau",49313,109,49313,,"SCORTOASA",413,"Sc. cu clasele I-IV, Plopeasa de Sus",212,120,100,20,0,116,4,306,186,53,63,3,4613,0
10,"Buzau",49313,109,49313,,"SCORTOASA",414,"Sc. cu clasele I-IV, Grabicina de Jos",248,124,112,12,0,122,2,299,175,33,89,3,4613,0
10,"Buzau",49313,109,49313,,"SCORTOASA",415,"Sc. cu clasele I-IV, Golu Grabicina",228,142,114,28,0,141,1,291,149,36,105,3,4613,0
10,"Buzau",49313,109,49313,,"SCORTOASA",416,"Sc. cu clasele I-VIII, Balta Tocila",305,136,124,12,0,136,0,314,178,39,97,3,4613,0
10,"Buzau",49313,109,49313,,"SCORTOASA",417,"Sc. cu clasele I-IV, Beciu",161,94,84,10,0,91,3,200,106,30,61,3,4613,0
10,"Buzau",49313,109,49313,,"SCORTOASA",418,"Primaria Scortoasa, sat Scortoasa",0,116,0,116,0,114,2,318,202,44,70,3,4613,1
10,"Buzau",49439,109,49439,,"SCUTELNICI",419,"Caminul cult. din satul Scutelnici",1049,574,559,15,0,563,11,1181,607,259,304,3,4625,0
10,"Buzau",49439,109,49439,,"SCUTELNICI",420,"Gradinita Bragareasa",582,367,356,11,0,359,8,700,333,195,164,3,4625,0
10,"Buzau",49439,109,49439,,"SCUTELNICI",421,"Sc.gen. cu clasele I-IV din satul  Arcanu",364,270,254,16,0,265,5,513,243,101,164,3,4625,0
10,"Buzau",49439,109,49439,,"SCUTELNICI",422,"Primaria Scutelnici, sat Scutelnici",0,122,0,122,0,121,1,300,178,52,69,3,4625,1
10,"Buzau",49484,109,49484,,"SIRIU",423,"Sc.gen. cu clasele I-VIII, Siriu din satul Lunca Jaristei",1483,896,886,10,0,884,12,1601,705,427,457,3,4630,0
10,"Buzau",49484,109,49484,,"SIRIU",424,"Sc. cu clasele I-IV, Coltu Pietrii nr.1",1065,732,713,17,2,724,8,1100,368,367,357,3,4630,0
10,"Buzau",49484,109,49484,,"SIRIU",425,"Primaria Siriu, comuna Siriu",0,117,0,117,0,116,1,301,184,55,61,3,4630,1
10,"Buzau",49545,109,49545,,"SMEENI",426,"Sc.gen. cu clasele I-IV, Balaia",154,111,95,16,0,110,1,200,89,40,70,3,4636,0
10,"Buzau",49545,109,49545,,"SMEENI",427,"Sc.gen. cu clasele I-IV, Smeeni",1574,746,721,25,0,734,12,1700,954,282,452,3,4636,0
10,"Buzau",49545,109,49545,,"SMEENI",428,"Sc. gen. cu clasele I-VIII, Smeeni (Sala de sport)",693,322,310,12,0,318,4,693,371,129,189,3,4636,0
10,"Buzau",49545,109,49545,,"SMEENI",429,"Sc.gen. cu clasele I-IV, Salcioara",534,285,231,54,0,285,0,600,315,117,168,3,4636,0
10,"Buzau",49545,109,49545,,"SMEENI",430,"Sc.gen. cu clasele cl.I-IV, Moisica",274,148,133,15,0,147,1,301,153,44,103,3,4636,0
10,"Buzau",49545,109,49545,,"SMEENI",431,"Gradinita Albesti",704,405,387,18,0,400,5,715,310,123,277,3,4636,0
10,"Buzau",49545,109,49545,,"SMEENI",432,"Gradinita Udati-Minzu",790,435,402,33,0,431,4,803,368,114,317,3,4636,0
10,"Buzau",49545,109,49545,,"SMEENI",433,"Sc.gen. cu clasele I-IV, Caltuna",412,239,224,15,0,236,3,399,160,122,114,3,4636,0
10,"Buzau",49545,109,49545,,"SMEENI",434,"Sc.gen.  cu clasele I-IV, Udati-Lucieni",314,143,129,14,0,141,2,306,163,85,56,3,4636,0
10,"Buzau",49545,109,49545,,"SMEENI",435,"Caminul cultural Smeeni, com. Smeeni",0,146,0,146,0,145,1,298,152,64,81,3,4636,1
10,"Buzau",49625,109,49625,,"STALPU",436,"Sc. cu clasele I-VIII, Stilpu",1397,734,725,9,0,727,7,1500,766,345,382,3,4644,0
10,"Buzau",49625,109,49625,,"STALPU",437,"Primaria Stilpu",1169,639,632,7,0,635,4,1201,562,224,411,3,4644,0
10,"Buzau",49625,109,49625,,"STALPU",438,"Primaria Stalpu, str. Principala, nr.427",0,110,0,110,0,110,0,300,190,53,57,3,4644,1
10,"Buzau",49643,109,49643,,"TISAU",439,"Caminul cult.Grajdana",1491,786,774,11,1,775,11,1600,814,335,440,3,4651,0
10,"Buzau",49643,109,49643,,"TISAU",440,"Sc. cu clasele I-IV, Izvoranu",92,67,41,26,0,67,0,100,33,30,37,3,4651,0
10,"Buzau",49643,109,49643,,"TISAU",441,"Sc. cu clasele I-VIII, Hales",1364,639,601,38,0,634,5,1500,861,323,311,3,4651,0
10,"Buzau",49643,109,49643,,"TISAU",442,"Gradinita Tisau",680,392,387,5,0,382,10,701,309,173,209,3,4651,0
10,"Buzau",49643,109,49643,,"TISAU",443,"Sc. cu clasele I-IV, Strezeni",418,297,239,58,0,293,4,414,117,177,116,3,4651,0
10,"Buzau",49643,109,49643,,"TISAU",444,"Primaria Tisau, sat Izvoru, nr.5",0,153,0,153,0,152,1,311,158,69,83,3,4651,1
10,"Buzau",49769,109,49769,,"TOPLICENI",445,"Sc. cu clasele I-IV, satul Posta",413,247,239,8,0,243,4,524,277,95,148,3,4663,0
10,"Buzau",49769,109,49769,,"TOPLICENI",446,"Sc.cu clasele I-VIII, satul Topliceni",1005,525,511,14,0,522,3,1100,575,185,337,3,4663,0
10,"Buzau",49769,109,49769,,"TOPLICENI",447,"Sc. cu clasele I-IV, satul Raducesti",361,227,217,10,0,221,6,397,170,89,132,3,4663,0
10,"Buzau",49769,109,49769,,"TOPLICENI",448,"Sc. cu clasele I-VIII, satul Babeni",878,496,482,14,0,488,8,1000,504,227,261,3,4663,0
10,"Buzau",49769,109,49769,,"TOPLICENI",449,"Scoala Dedulesti",826,448,445,3,0,436,12,900,452,176,260,3,4663,0
10,"Buzau",49769,109,49769,,"TOPLICENI",450,"Sc. cu clasele I-IV, satul Gura Faget",129,85,74,11,0,85,0,200,115,28,57,3,4663,0
10,"Buzau",49769,109,49769,,"TOPLICENI",451,"Primaria Topliceni, comuna Topliceni",0,99,0,99,0,99,0,300,201,40,59,3,4663,1
10,"Buzau",49849,109,49849,,"TINTESTI",452,"Sc.gen. Tintesti",1830,969,950,19,0,956,13,2000,1031,212,744,3,4646,0
10,"Buzau",49849,109,49849,,"TINTESTI",453,"Spatiul de utilitate publica Maxenu",1787,981,963,18,0,959,22,2000,1019,297,662,3,4646,0
10,"Buzau",49849,109,49849,,"TINTESTI",454,"Primaria Tintesti, com. Tintesti, nr.231",0,108,0,108,0,107,1,300,192,37,70,3,4646,1
10,"Buzau",49894,109,49894,,"ULMENI",455,"Sc.gen. din satul Ulmeni",1250,641,635,6,0,630,11,1300,659,299,331,3,4671,0
10,"Buzau",49894,109,49894,,"ULMENI",456,"Localul fostei Primarii din satul Clondiru",1352,768,761,7,0,758,10,1500,732,308,450,3,4671,0
10,"Buzau",49894,109,49894,,"ULMENI",457,"Primaria Ulmeni, sat Ulmeni, Str. Principala, nr.10",0,122,0,122,0,121,1,300,178,52,69,3,4671,1
10,"Buzau",50549,109,50549,,"UNGURIU",458,"Sc.gen. ""ing. Oprisan Iarca"", Unguriu - sala de sport",928,493,487,6,0,487,6,1001,508,265,222,3,4677,0
10,"Buzau",50549,109,50549,,"UNGURIU",459,"Sc.gen. ""ing. Oprisan Iarca"", Unguriu - sala de sport",997,547,542,5,0,544,3,1101,554,293,251,3,4677,0
10,"Buzau",50549,109,50549,,"UNGURIU",460,"Primaria Unguriu, str. Soseaua Brasovului, nr.183",0,104,0,104,0,103,1,300,196,52,51,3,4677,1
10,"Buzau",49956,109,49956,,"VADU PASII",461,"Sc. Vadu Pasii",1869,1109,1090,19,0,1092,17,2000,891,626,466,3,4680,0
10,"Buzau",49956,109,49956,,"VADU PASII",462,"Caminul cultural Vadu Pasii",1364,762,742,20,0,758,4,1500,738,399,359,3,4680,0
10,"Buzau",49956,109,49956,,"VADU PASII",463,"Sc. gen. Focsanei",1068,535,518,17,0,529,6,1100,565,294,235,3,4680,0
10,"Buzau",49956,109,49956,,"VADU PASII",464,"Sc. gen. Scurtesti",1660,906,854,52,0,897,9,1800,894,430,467,3,4680,0
10,"Buzau",49956,109,49956,,"VADU PASII",465,"Sc. gen. Scurtesti (Ciocarlia)",452,320,277,43,0,316,4,500,180,135,181,3,4680,0
10,"Buzau",49956,109,49956,,"VADU PASII",466,"Sc. gen. Stancesti",1295,741,703,38,0,726,15,1400,659,323,403,3,4680,0
10,"Buzau",49956,109,49956,,"VADU PASII",467,"Primaria Vadu Pasii, sat Vadu Pasii",0,137,0,137,0,137,0,300,163,74,63,3,4680,1
10,"Buzau",50022,109,50022,,"VALEA RAMNICULUI",468,"Sc.gen.Valea Rimnicului, sat Valea Rimnicului",1763,869,852,11,6,863,6,1901,1032,353,510,3,4689,0
10,"Buzau",50022,109,50022,,"VALEA RAMNICULUI",469,"Sc.gen.Oreavu, sat Oreavu",1996,1000,989,11,0,995,5,2100,1100,418,577,3,4689,0
10,"Buzau",50022,109,50022,,"VALEA RAMNICULUI",470,"Sc.gen.Rubla, sat Rubla",983,526,498,8,20,522,4,1100,574,164,358,3,4689,0
10,"Buzau",50022,109,50022,,"VALEA RAMNICULUI",471,"Primaria Valea Ramnicului, str. Principala",0,58,0,58,0,58,0,300,242,28,30,3,4689,1
10,"Buzau",50068,109,50068,,"VALEA SALCIEI",472,"Caminul cult. ""Eliza Petrescu"", sat Modreni",690,429,381,3,45,424,5,700,271,85,339,3,4693,0
10,"Buzau",50068,109,50068,,"VALEA SALCIEI",473,"Primaria Valea Salciei, sat Modreni",0,38,0,38,0,37,1,300,262,4,33,3,4693,1
10,"Buzau",50102,109,50102,,"VERNESTI",474,"Sc.gen. Vernesti",1817,899,881,18,0,889,10,2000,1101,420,469,3,4697,0
10,"Buzau",50102,109,50102,,"VERNESTI",475,"Sc.gen. Cindesti",1313,738,719,19,0,724,14,1400,662,496,228,3,4697,0
10,"Buzau",50102,109,50102,,"VERNESTI",476,"Sc.gen. Cindesti",1273,708,696,12,0,695,13,1400,692,463,232,3,4697,0
10,"Buzau",50102,109,50102,,"VERNESTI",477,"Sc.gen. Zoresti",1047,574,559,15,0,571,3,1100,526,331,240,3,4697,0
10,"Buzau",50102,109,50102,,"VERNESTI",478,"Sc.gen. Niscov",1402,691,674,17,0,686,5,1500,809,360,326,3,4697,0
10,"Buzau",50102,109,50102,,"VERNESTI",479,"Sc.gen. Sasenii Noi",327,203,189,14,0,198,5,400,197,102,96,3,4697,0
10,"Buzau",50102,109,50102,,"VERNESTI",480,"Primaria Vernesti, str. Principala, nr.1",0,173,0,173,0,171,2,301,128,101,70,3,4697,1
10,"Buzau",50228,109,50228,,"VINTILA VODA",481,"Sc. Vintila Voda",1384,726,717,9,0,721,5,1600,874,379,342,3,4709,0
10,"Buzau",50228,109,50228,,"VINTILA VODA",482,"Sc. gen. Niculesti",965,529,507,22,0,525,4,1000,471,210,315,3,4709,0
10,"Buzau",50228,109,50228,,"VINTILA VODA",483,"Sc. gen. Coca Antimiresti",231,116,107,9,0,115,1,300,184,74,41,3,4709,0
10,"Buzau",50228,109,50228,,"VINTILA VODA",484,"Primaria Vintila Voda, sat Vintila Voda",0,138,0,138,0,138,0,292,154,76,62,3,4709,1
10,"Buzau",50326,109,50326,,"VIPERESTI",485,"Sc.cu clasele I-VIII, Viperesti",841,461,446,7,8,453,8,900,439,246,207,3,4719,0
10,"Buzau",50326,109,50326,,"VIPERESTI",486,"Sc. cu clasele I-IV, Tronari",760,416,412,4,0,411,5,800,384,153,258,3,4719,0
10,"Buzau",50326,109,50326,,"VIPERESTI",487,"Sc. cu clasele I-VIII, Ursoaia",976,449,414,9,26,445,4,1001,552,154,291,3,4719,0
10,"Buzau",50326,109,50326,,"VIPERESTI",488,"Sc.cu clasele I-IV, Muscel",153,76,63,13,0,74,2,200,124,36,38,3,4719,0
10,"Buzau",50326,109,50326,,"VIPERESTI",489,"Sc. gen. Viperesti, com. Viperesti, nr.206",0,77,0,77,0,76,1,300,223,38,38,3,4719,1
10,"Buzau",50399,109,50399,,"VALCELELE",490,"Caminul cult. Vilcelele",1378,744,732,3,9,741,3,1500,756,338,403,3,4687,0
10,"Buzau",50399,109,50399,,"VALCELELE",491,"Primaria Valcelele, str. Principala, nr.1",0,99,0,99,0,99,0,300,201,46,53,3,4687,1
10,"Buzau",50415,109,50415,,"ZARNESTI",492,"Sc. gen. Fundeni",1922,1137,1125,12,0,1122,15,2200,1063,338,784,3,4726,0
10,"Buzau",50415,109,50415,,"ZARNESTI",493,"Gradinita de copii din satul Pruneni",354,201,192,9,0,196,5,400,199,47,149,3,4726,0
10,"Buzau",50415,109,50415,,"ZARNESTI",494,"Scoala gen. din satul Vadu Soresti",1187,663,654,9,0,647,16,1262,599,343,304,3,4726,0
10,"Buzau",50415,109,50415,,"ZARNESTI",495,"Sc.gen. din satul Zarnesti",920,577,559,18,0,566,11,989,412,161,405,3,4726,0
10,"Buzau",50415,109,50415,,"ZARNESTI",496,"Scola gen. Fundeni, sat Fundeni",0,147,0,147,0,146,1,300,153,55,91,3,4726,1
10,"Buzau",50479,109,50479,,"ZIDURI",497,"Sala de sedinte a Primariei Ziduri",842,474,465,9,0,470,4,900,426,244,226,3,4732,0
10,"Buzau",50479,109,50479,,"ZIDURI",498,"Caminul cult. Lanurile",644,343,329,14,0,342,1,700,357,138,204,3,4732,0
10,"Buzau",50479,109,50479,,"ZIDURI",499,"Sc. cu clasele I-IV, H.Radulescu",772,421,412,9,0,410,11,900,479,170,240,3,4732,0
10,"Buzau",50479,109,50479,,"ZIDURI",500,"Sc.gen. cu clasele I-IV, Costieni",660,386,373,13,0,378,8,700,314,208,170,3,4732,0
10,"Buzau",50479,109,50479,,"ZIDURI",501,"Caminul cult. Zoita",512,301,294,7,0,293,8,600,299,151,142,3,4732,0
10,"Buzau",50479,109,50479,,"ZIDURI",502,"Sc. cu clasele I-IV, Cuculeasa",388,261,251,10,0,258,3,600,339,149,109,3,4732,0
10,"Buzau",50479,109,50479,,"ZIDURI",503,"Primaria Ziduri, comuna Ziduri",0,121,0,121,0,120,1,301,180,70,50,3,4732,1
11,"Caras-Severin",50790,118,50790,,"MUNICIPIUL RESITA",1,"Scoala nr.5, str. Sodol, nr.10/A",1295,553,536,8,9,548,5,1400,847,294,254,1,4740,0
11,"Caras-Severin",50790,118,50790,,"MUNICIPIUL RESITA",2,"Centrul de zi ""Maria"",str. Ciresului, nr.75",635,253,244,9,0,252,1,700,447,134,118,1,4740,0
11,"Caras-Severin",50790,118,50790,,"MUNICIPIUL RESITA",3,"Gradinita nr.2, str. Zimbrului, nr.46",1075,436,425,11,0,430,6,1200,764,274,156,1,4740,0
11,"Caras-Severin",50790,118,50790,,"MUNICIPIUL RESITA",4,"Scoala nr.1 Beton, str.Castanilor, nr.72",1773,749,730,19,0,739,10,1900,1151,407,332,1,4740,0
11,"Caras-Severin",50790,118,50790,,"MUNICIPIUL RESITA",5,"Scoala nr.1 Casa Muncitoreasca, P-ta Republicii, nr.44",1554,622,615,7,0,611,11,1700,1078,338,273,1,4740,0
11,"Caras-Severin",50790,118,50790,,"MUNICIPIUL RESITA",6,"Scoala nr.1 Casa Muncitoreasca, P-ta Republicii, nr.44",1128,392,383,8,1,383,9,1200,808,246,137,1,4740,0
11,"Caras-Severin",50790,118,50790,,"MUNICIPIUL RESITA",7,"Scoala Dealu Mare, str. Badea Cirtan",1571,541,529,12,0,530,11,1700,1159,324,206,1,4740,0
11,"Caras-Severin",50790,118,50790,,"MUNICIPIUL RESITA",8,"Scoala nr.2, str. Romanilor, nr.1",1123,475,466,9,0,473,2,1195,720,246,227,1,4740,0
11,"Caras-Severin",50790,118,50790,,"MUNICIPIUL RESITA",9,"Scoala nr.2, str. Romanilor, nr.1",1366,670,660,10,0,666,4,1500,830,320,346,1,4740,0
11,"Caras-Severin",50790,118,50790,,"MUNICIPIUL RESITA",10,"Scoala nr.2, str. Romanilor, nr.1",1254,620,615,5,0,612,8,1400,780,283,329,1,4740,0
11,"Caras-Severin",50790,118,50790,,"MUNICIPIUL RESITA",11,"Scoala cu clasele I-IV , str. Mociur, nr.4",577,239,224,15,0,239,0,607,368,146,93,1,4740,0
11,"Caras-Severin",50790,118,50790,,"MUNICIPIUL RESITA",12,"Gradinita P.P.3, str. Otelului, nr.18",1056,553,544,9,0,545,8,1100,547,266,279,1,4740,0
11,"Caras-Severin",50790,118,50790,,"MUNICIPIUL RESITA",13,"Gradinita P.P.3, str. Otelului, nr.18",1364,730,718,12,0,725,5,1500,770,336,389,1,4740,0
11,"Caras-Severin",50790,118,50790,,"MUNICIPIUL RESITA",14,"Gradinita P.P.3, str. Otelului, nr.18",1406,625,617,8,0,620,5,1500,875,311,309,1,4740,0
11,"Caras-Severin",50790,118,50790,,"MUNICIPIUL RESITA",15,"SC Drumuri si Poduri SA , str.24 Ianuarie, nr.1",1087,504,491,13,0,497,7,1180,676,262,235,1,4740,0
11,"Caras-Severin",50790,118,50790,,"MUNICIPIUL RESITA",16,"Universitatea Eftimie Murgu, Piata Traian Vuia, nr.1-4.",1825,898,891,6,1,884,14,2000,1102,413,471,1,4740,0
11,"Caras-Severin",50790,118,50790,,"MUNICIPIUL RESITA",17,"Liceul Traian Lalescu, local nou, Bd. Al.I. Cuza, nr.7",1271,600,594,6,0,593,7,1400,800,313,280,1,4740,0
11,"Caras-Severin",50790,118,50790,,"MUNICIPIUL RESITA",18,"Liceul Traian Lalescu, local nou, Bd. Al.I. Cuza, nr.7",1841,894,882,11,1,878,16,2044,1150,440,438,1,4740,0
11,"Caras-Severin",50790,118,50790,,"MUNICIPIUL RESITA",19,"Liceul Traian Lalescu, local nou, Bd. Al.I. Cuza, nr.7",1459,642,634,8,0,638,4,1620,978,348,290,1,4740,0
11,"Caras-Severin",50790,118,50790,,"MUNICIPIUL RESITA",20,"Scoala nr.6, str. Gratz, nr.10",1876,927,916,11,0,912,15,2001,1074,407,505,1,4740,0
11,"Caras-Severin",50790,118,50790,,"MUNICIPIUL RESITA",21,"Scoala nr.6, str. Gratz, nr.10",1062,513,493,8,12,508,5,1200,687,254,254,1,4740,0
11,"Caras-Severin",50790,118,50790,,"MUNICIPIUL RESITA",22,"Grup Scolar Stefan Anghel, Bd. Al.I. Cuza, nr.39",1498,710,701,9,0,702,8,1600,890,405,297,1,4740,0
11,"Caras-Severin",50790,118,50790,,"MUNICIPIUL RESITA",23,"Grup Scolar Stefan Anghel, Bd. Al.I. Cuza, nr.39",1870,898,892,6,0,885,13,2080,1182,423,462,1,4740,0
11,"Caras-Severin",50790,118,50790,,"MUNICIPIUL RESITA",24,"Gradinita nr.13, str. Ciprian Porumbescu, nr.17",770,333,323,9,1,328,5,860,527,203,125,1,4740,0
11,"Caras-Severin",50790,118,50790,,"MUNICIPIUL RESITA",25,"Gradinita nr.16, Calea Timisorii, nr.12",1197,547,537,10,0,539,8,1300,753,273,266,1,4740,0
11,"Caras-Severin",50790,118,50790,,"MUNICIPIUL RESITA",26,"Liceul Traian Vuia, Calea Caransebesului, nr.2",1463,579,567,12,0,575,4,1630,1051,374,201,1,4740,0
11,"Caras-Severin",50790,118,50790,,"MUNICIPIUL RESITA",27,"Liceul Traian Vuia, Calea Caransebesului, nr.2",1755,637,619,18,0,632,5,1900,1263,411,221,1,4740,0
11,"Caras-Severin",50790,118,50790,,"MUNICIPIUL RESITA",28,"Liceul Traian Vuia, Calea Caransebesului, nr.2",1595,630,623,7,0,620,10,1700,1070,364,256,1,4740,0
11,"Caras-Severin",50790,118,50790,,"MUNICIPIUL RESITA",29,"Liceul Traian Vuia, Calea Caransebesului, nr.2",1232,576,566,10,0,569,7,1370,794,272,297,1,4740,0
11,"Caras-Severin",50790,118,50790,,"MUNICIPIUL RESITA",30,"Liceul Traian Vuia, Calea Caransebesului, nr.2",1238,538,530,8,0,534,4,1380,842,295,239,1,4740,0
11,"Caras-Severin",50790,118,50790,,"MUNICIPIUL RESITA",31,"Scoala nr.8, Aleea Bazna, nr.2",1650,712,704,8,0,702,10,1830,1118,402,300,1,4740,0
11,"Caras-Severin",50790,118,50790,,"MUNICIPIUL RESITA",32,"Scoala nr.8, Aleea Bazna, nr.2",1252,576,568,8,0,568,8,1401,825,320,248,1,4740,0
11,"Caras-Severin",50790,118,50790,,"MUNICIPIUL RESITA",33,"Scoala nr.8, Aleea Bazna, nr.2",1219,572,562,10,0,569,3,1350,778,282,287,1,4740,0
11,"Caras-Severin",50790,118,50790,,"MUNICIPIUL RESITA",34,"Liceul ""Mircea Eliade"",corp B, str. Fagarasului, nr.6-8",1166,516,505,11,0,513,3,1300,784,273,240,1,4740,0
11,"Caras-Severin",50790,118,50790,,"MUNICIPIUL RESITA",35,"Liceul ""Mircea Eliade"",corp B, str. Fagarasului, nr.6-8",1079,528,519,9,0,524,4,1200,672,278,246,1,4740,0
11,"Caras-Severin",50790,118,50790,,"MUNICIPIUL RESITA",36,"Grup Scolar Constructii Montaj Resita, str.Fagarasului, nr.10",1309,655,646,9,0,652,3,1450,795,304,348,1,4740,0
11,"Caras-Severin",50790,118,50790,,"MUNICIPIUL RESITA",37,"Grup Scolar Constructii Montaj Resita, str.Fagarasului, nr.10",1057,463,451,11,1,457,6,1172,709,252,205,1,4740,0
11,"Caras-Severin",50790,118,50790,,"MUNICIPIUL RESITA",38,"Scoala nr.7 (corp B), Aleea Galati, nr.6 (fosta Scoala nr.10)",1546,724,710,13,1,720,4,1720,996,392,328,1,4740,0
11,"Caras-Severin",50790,118,50790,,"MUNICIPIUL RESITA",39,"Scoala nr.7 (corp B), Aleea Galati, nr.6 (fosta Scoala nr.10)",1293,658,647,11,0,653,5,1440,782,337,316,1,4740,0
11,"Caras-Severin",50790,118,50790,,"MUNICIPIUL RESITA",40,"Scoala nr.7 (corp A), str. Progresului, nr.6",1187,551,542,8,1,541,10,1300,749,269,272,1,4740,0
11,"Caras-Severin",50790,118,50790,,"MUNICIPIUL RESITA",41,"Scoala nr.7 (corp A), str. Progresului, nr.6",1284,548,540,8,0,537,11,1400,852,290,247,1,4740,0
11,"Caras-Severin",50790,118,50790,,"MUNICIPIUL RESITA",42,"Colegiul Economic,al Banatului Montan, Aleea Dacia, nr.4 (fost Grup Scolar Economic)",1169,536,526,10,0,533,3,1300,764,286,247,1,4740,0
11,"Caras-Severin",50790,118,50790,,"MUNICIPIUL RESITA",43,"Colegiul Economic,al Banatului Montan, Aleea Dacia, nr.4 (fost Grup Scolar Economic)",1327,572,563,9,0,565,7,1480,908,291,274,1,4740,0
11,"Caras-Severin",50790,118,50790,,"MUNICIPIUL RESITA",44,"Colegiul Economic,al Banatului Montan, Aleea Dacia, nr.4 (fost Grup Scolar Economic)",1676,791,783,8,0,786,5,1850,1059,402,384,1,4740,0
11,"Caras-Severin",50790,118,50790,,"MUNICIPIUL RESITA",45,"Colegiul Economic,al Banatului Montan, Aleea Dacia, nr.4 (fost Grup Scolar Economic)",1128,514,506,8,0,507,7,1250,736,247,260,1,4740,0
11,"Caras-Severin",50790,118,50790,,"MUNICIPIUL RESITA",46,"Scoala nr.9, Aleea Marghitas, nr.5",1206,544,536,8,0,541,3,1344,800,285,256,1,4740,0
11,"Caras-Severin",50790,118,50790,,"MUNICIPIUL RESITA",47,"Scoala nr.9, Aleea Marghitas, nr.5",1603,717,710,7,0,710,7,1700,983,382,328,1,4740,0
11,"Caras-Severin",50790,118,50790,,"MUNICIPIUL RESITA",48,"Scoala nr.9, Aleea Marghitas, nr.5",1359,618,613,5,0,605,13,1510,892,320,285,1,4740,0
11,"Caras-Severin",50790,118,50790,,"MUNICIPIUL RESITA",49,"Scoala nr.9, Aleea Marghitas, nr.5",1634,692,678,14,0,686,6,1800,1108,369,317,1,4740,0
11,"Caras-Severin",50790,118,50790,,"MUNICIPIUL RESITA",50,"Liceul de Arta ""Sabin Pauta"", Aleea Herculane, nr.3",1106,452,443,9,0,450,2,1227,775,246,204,1,4740,0
11,"Caras-Severin",50790,118,50790,,"MUNICIPIUL RESITA",51,"Liceul de Arta ""Sabin Pauta"", Aleea Herculane, nr.3",1406,638,624,14,0,629,9,1570,932,369,260,1,4740,0
11,"Caras-Severin",50790,118,50790,,"MUNICIPIUL RESITA",52,"Liceul de Arta ""Sabin Pauta"", Aleea Herculane, nr.3",1494,699,691,8,0,692,7,1660,961,368,324,1,4740,0
11,"Caras-Severin",50790,118,50790,,"MUNICIPIUL RESITA",53,"Liceul de Arta ""Sabin Pauta"", Aleea Herculane, nr.3",1234,597,587,10,0,589,8,1380,783,302,287,1,4740,0
11,"Caras-Severin",50790,118,50790,,"MUNICIPIUL RESITA",54,"Scoala nr.12, Aleea Macinului, nr.3",1325,618,609,8,1,609,9,1469,851,320,289,1,4740,0
11,"Caras-Severin",50790,118,50790,,"MUNICIPIUL RESITA",55,"Scoala nr.12, Aleea Macinului, nr.3",1541,707,696,11,0,701,6,1700,993,408,293,1,4740,0
11,"Caras-Severin",50790,118,50790,,"MUNICIPIUL RESITA",56,"Scoala nr.12, Aleea Macinului, nr.3",1322,548,544,4,0,544,4,1420,872,325,219,1,4740,0
11,"Caras-Severin",50790,118,50790,,"MUNICIPIUL RESITA",57,"Scoala nr.12, Aleea Macinului, nr.3",1097,504,495,9,0,502,2,1235,731,263,239,1,4740,0
11,"Caras-Severin",50790,118,50790,,"MUNICIPIUL RESITA",58,"Scoala Cilnic",1352,646,638,8,0,635,11,1500,854,327,308,1,4740,0
11,"Caras-Severin",50790,118,50790,,"MUNICIPIUL RESITA",59,"Gradinita Cuptoare",290,162,150,12,0,160,2,340,178,84,76,1,4740,0
11,"Caras-Severin",50790,118,50790,,"MUNICIPIUL RESITA",60,"Scoala Doman",617,265,250,15,0,263,2,697,432,180,83,1,4740,0
11,"Caras-Severin",50790,118,50790,,"MUNICIPIUL RESITA",61,"Scoala Secu",463,206,197,9,0,201,5,520,314,142,59,1,4740,0
11,"Caras-Severin",50790,118,50790,,"MUNICIPIUL RESITA",62,"Scoala Terova",465,196,190,6,0,190,6,532,336,118,72,1,4740,0
11,"Caras-Severin",50790,118,50790,,"MUNICIPIUL RESITA",63,"Scoala Moniom",284,180,172,6,2,179,1,324,144,107,72,1,4740,0
11,"Caras-Severin",50790,118,50790,,"MUNICIPIUL RESITA",64,"Caminul studentesc al Universitatii ""Eftimie Murgu"", incinta Cantinei  Studentesti, str.Rosiorilor, nr.1",0,354,0,354,0,349,5,550,196,180,169,1,4740,1
11,"Caras-Severin",50790,118,50790,,"MUNICIPIUL RESITA",65,"CNCFR SA - Sucursala CFR Timisoara - Statia Resita Nord, sala de asteptare clasa I, str.Garii, nr.1",0,638,0,638,0,635,3,717,79,364,271,1,4740,1
11,"Caras-Severin",51010,118,51010,,"MUNICIPIUL CARANSEBES",66,"Scoala primara, cls.I-IV, str. Nicolae Balcescu, nr.113",1152,588,583,5,0,585,3,967,379,259,326,1,4748,0
11,"Caras-Severin",51010,118,51010,,"MUNICIPIUL CARANSEBES",67,"Muzeul de Etnografie si al Regimentului de Granita, Piata Gen. Ioan Dragalina, nr.2",1542,818,813,5,0,808,10,1703,885,351,457,1,4748,0
11,"Caras-Severin",51010,118,51010,,"MUNICIPIUL CARANSEBES",68,"Scoala generala nr.8, str. Racovita, nr.1",1705,847,828,19,0,835,12,1882,1035,366,469,1,4748,0
11,"Caras-Severin",51010,118,51010,,"MUNICIPIUL CARANSEBES",69,"Grupul Scolar Forestier, str. Libertatii, nr.21",1313,593,585,7,1,586,7,1447,854,278,308,1,4748,0
11,"Caras-Severin",51010,118,51010,,"MUNICIPIUL CARANSEBES",70,"Casa Municipala de Cultura ""George Suru"", str. Mihai Viteazul,nr.6",1339,668,658,8,2,662,6,1476,808,302,360,1,4748,0
11,"Caras-Severin",51010,118,51010,,"MUNICIPIUL CARANSEBES",71,"Gradinita de copii nr.1, str. Muntele Mic, nr.1",1870,857,846,10,1,848,9,2061,1204,452,396,1,4748,0
11,"Caras-Severin",51010,118,51010,,"MUNICIPIUL CARANSEBES",72,"Scoala generala nr.7, Aleea Alunisului, nr.1",1897,829,802,27,0,821,8,2090,1261,467,354,1,4748,0
11,"Caras-Severin",51010,118,51010,,"MUNICIPIUL CARANSEBES",73,"Clubul Sportiv Scolar, Aleea Alunisului, nr.1",1875,776,768,7,1,769,7,2063,1287,398,371,1,4748,0
11,"Caras-Severin",51010,118,51010,,"MUNICIPIUL CARANSEBES",74,"Gradinita nr.4, Aleea Gradinitei, nr.1",1488,636,625,9,2,626,10,1639,1003,320,306,1,4748,0
11,"Caras-Severin",51010,118,51010,,"MUNICIPIUL CARANSEBES",75,"Scoala generala nr.2, str. Ardealului, nr.138,sala de sport",1567,694,683,10,1,686,8,1726,1032,349,337,1,4748,0
11,"Caras-Severin",51010,118,51010,,"MUNICIPIUL CARANSEBES",76,"Scoala generala nr.2, str. Ardealului, nr.138, sala clasei a III-a A",1338,582,573,6,3,575,7,1476,894,304,271,1,4748,0
11,"Caras-Severin",51010,118,51010,,"MUNICIPIUL CARANSEBES",77,"Scoala generala nr.2, str. Ardealului, nr.138, sala clasei a III-a B",1504,630,620,9,1,626,4,1659,1029,363,263,1,4748,0
11,"Caras-Severin",51010,118,51010,,"MUNICIPIUL CARANSEBES",78,"Grup Scolar Constructii de Masini, str. Ardealului, nr.166, sala 02",1465,546,534,11,1,543,3,1613,1067,272,271,1,4748,0
11,"Caras-Severin",51010,118,51010,,"MUNICIPIUL CARANSEBES",79,"Grup Scolar Constructii de Masini, str. Ardealului, nr.166, sala 03",1202,559,539,19,1,549,10,1323,764,280,269,1,4748,0
11,"Caras-Severin",51010,118,51010,,"MUNICIPIUL CARANSEBES",80,"Scoala normala, str. C.D. Loga, nr.12",1612,705,696,9,0,696,9,1774,1069,362,334,1,4748,0
11,"Caras-Severin",51010,118,51010,,"MUNICIPIUL CARANSEBES",81,"Gradinita de copii, Cartier Caransebesul Nou, Calea Severinului,nr.48",1215,549,540,9,0,540,9,1338,789,260,280,1,4748,0
11,"Caras-Severin",51010,118,51010,,"MUNICIPIUL CARANSEBES",82,"Scoala generala nr.1, Calea Severinului, nr.149",1844,818,808,6,4,809,9,2032,1214,371,438,1,4748,0
11,"Caras-Severin",51010,118,51010,,"MUNICIPIUL CARANSEBES",83,"Scoala primara Jupa",471,266,258,8,0,265,1,519,253,126,139,1,4748,0
11,"Caras-Severin",51010,118,51010,,"MUNICIPIUL CARANSEBES",84,"Statia CFR Caransebes, sala de asteptare clasa I, str.Nicolae Balcescu, nr. 127",0,689,0,689,0,684,5,850,161,397,287,1,4748,1
11,"Caras-Severin",50889,118,50889,,"ORAS ANINA",85,"Casa de Cultura Anina,str.Sf.Varvara",929,419,407,8,4,412,7,1022,603,179,233,1,4751,0
11,"Caras-Severin",50889,118,50889,,"ORAS ANINA",86,"Centrul de Afaceri Anina,sala nr. U6, str.Sf.Varvara, nr.51",1006,499,488,8,3,497,2,1107,608,174,323,1,4751,0
11,"Caras-Severin",50889,118,50889,,"ORAS ANINA",87,"Gradinita Celnic Nord,str.Celnic Nord",683,286,276,8,2,277,9,751,465,115,162,1,4751,0
11,"Caras-Severin",50889,118,50889,,"ORAS ANINA",88,"Sediul SC GOSTRANS SA ,str.Uzinei,nr.12",559,285,276,7,2,280,5,616,331,140,140,1,4751,0
11,"Caras-Severin",50889,118,50889,,"ORAS ANINA",89,"Gradinita Orasul Nou,str.Orasul Nou",653,252,242,10,0,248,4,718,466,127,121,1,4751,0
11,"Caras-Severin",50889,118,50889,,"ORAS ANINA",90,"Centrul de zi Anina,str.Libertatii,nr.28",733,320,313,7,0,316,4,806,486,135,181,1,4751,0
11,"Caras-Severin",50889,118,50889,,"ORAS ANINA",91,"Sediul Depozitul Final  Cantar,str.Closca",687,304,296,8,0,300,4,766,462,150,150,1,4751,0
11,"Caras-Severin",50889,118,50889,,"ORAS ANINA",92,"Gradinita Sigismund,str.Republicii",574,235,228,7,0,231,4,631,396,109,122,1,4751,0
11,"Caras-Severin",50889,118,50889,,"ORAS ANINA",93,"Scoala Steierdorf,str.Victoriei",1221,531,522,9,0,517,14,1334,803,278,239,1,4751,0
11,"Caras-Severin",50889,118,50889,,"ORAS ANINA",94,"Sediul Caritas,str.Morii",595,269,261,7,1,265,4,656,387,121,144,1,4751,0
11,"Caras-Severin",50889,118,50889,,"ORAS ANINA",95,"Scoala generala Bradet,str.Bradet",308,173,165,7,1,172,1,339,166,88,84,1,4751,0
11,"Caras-Severin",50889,118,50889,,"ORAS ANINA",96,"Centrul de Afaceri Anina, sala nr. U11, Str. Sf.Varvara, nr.51",0,100,0,100,0,100,0,150,50,49,51,1,4751,1
11,"Caras-Severin",50923,118,50923,,"ORAS BAILE HERCULANE",97,"Cinematograful Hercules, P-ta 1 Mai",400,232,226,5,1,230,2,440,208,105,125,1,4754,0
11,"Caras-Severin",50923,118,50923,,"ORAS BAILE HERCULANE",98,"Scoala generala, zona UGSR, sala de curs clasa a III-a C, str. Castanilor, nr.17",1609,840,829,11,0,831,9,1773,933,468,363,1,4754,0
11,"Caras-Severin",50923,118,50923,,"ORAS BAILE HERCULANE",99,"Liceul Hercules, str. Trandafirilor, nr.36",1091,560,556,4,0,556,4,1200,640,295,261,1,4754,0
11,"Caras-Severin",50923,118,50923,,"ORAS BAILE HERCULANE",100,"Liceul Hercules, str. Trandafirilor, nr.36",1267,653,640,12,1,648,5,1394,741,363,285,1,4754,0
11,"Caras-Severin",50923,118,50923,,"ORAS BAILE HERCULANE",101,"Scoala  generala , zona Pecinisca, str. Pecinisca, nr.9",544,347,336,10,1,342,5,598,251,182,160,1,4754,0
11,"Caras-Severin",50923,118,50923,,"ORAS BAILE HERCULANE",102,"Scoala cu clasele I-IV, zona UGSR, sala de curs clasa a IV-a, Str. Castanilor, nr.17",0,880,0,880,0,876,4,1175,295,432,444,1,4754,1
11,"Caras-Severin",50969,118,50969,,"ORAS BOCSA",103,"Scoala generala nr.2, str.1 Decembrie 1918, nr.12",1267,597,580,12,5,586,11,1394,797,326,260,1,4757,0
11,"Caras-Severin",50969,118,50969,,"ORAS BOCSA",104,"Gradinita de copii, nr.4, str. Serei, nr.2",1405,686,674,9,3,675,11,1546,860,351,324,1,4757,0
11,"Caras-Severin",50969,118,50969,,"ORAS BOCSA",105,"Scoala generala nr.3, str. Magura, nr.45",1235,584,577,7,0,572,12,1359,775,271,301,1,4757,0
11,"Caras-Severin",50969,118,50969,,"ORAS BOCSA",106,"Liceul Teoretic Bocsa, str.Tata Oancea, nr.4",1163,557,548,9,0,554,3,1279,722,261,293,1,4757,0
11,"Caras-Severin",50969,118,50969,,"ORAS BOCSA",107,"Liceul Teoretic Bocsa, str.Tudor Vladimirescu, nr.57 A",867,366,356,10,0,361,5,954,588,199,162,1,4757,0
11,"Caras-Severin",50969,118,50969,,"ORAS BOCSA",108,"Grup Scolar Industrial Constructii de Masini, str. Tineretului,nr.1",1540,672,662,8,2,669,3,1694,1022,393,276,1,4757,0
11,"Caras-Severin",50969,118,50969,,"ORAS BOCSA",109,"Gradinita nr.6 Bocsa, str. Carpati, bl.5",1280,514,506,6,2,510,4,1408,894,281,229,1,4757,0
11,"Caras-Severin",50969,118,50969,,"ORAS BOCSA",110,"Sediul Serviciu Public de Gospodarie Comunala, Birou Tehnic, str. Ceahlau,nr.2",1267,498,488,10,0,497,1,1391,893,277,220,1,4757,0
11,"Caras-Severin",50969,118,50969,,"ORAS BOCSA",111,"Scoala generala nr.1, str. Republicii, nr.97",1378,557,552,5,0,548,9,1514,957,328,220,1,4757,0
11,"Caras-Severin",50969,118,50969,,"ORAS BOCSA",112,"Clubul elevilor, str. Victoriei, nr.6",1450,588,579,9,0,585,3,1595,1007,299,286,1,4757,0
11,"Caras-Severin",50969,118,50969,,"ORAS BOCSA",113,"Scoala generala nr.1, str. Sadovei, nr.2E",1292,605,598,6,1,598,7,1421,816,331,267,1,4757,0
11,"Caras-Severin",50969,118,50969,,"ORAS BOCSA",114,"Scoala generala nr.1, str. Republicii, nr.100",1304,563,556,7,0,555,8,1434,871,322,233,1,4757,0
11,"Caras-Severin",50969,118,50969,,"ORAS BOCSA",115,"Sediul Serviciului Public de Gospodarie Comunala, Birou Salubritate, str. Ceahlau, nr.2",0,180,0,180,0,179,1,233,53,91,88,1,4757,1
11,"Caras-Severin",51056,118,51056,,"ORAS MOLDOVA NOUA",116,"Scoala generala nr.1,str.Nicolae Balcescu,nr.3,hol parter",1357,774,759,5,10,771,3,1500,726,320,451,1,4759,0
11,"Caras-Severin",51056,118,51056,,"ORAS MOLDOVA NOUA",117,"Casa de Cultura Moldova Noua, str.1 Decembrie 1918, nr.2,sala parter",1018,542,534,6,2,542,0,1097,555,210,332,1,4759,0
11,"Caras-Severin",51056,118,51056,,"ORAS MOLDOVA NOUA",118,"Gradinita nr.2 Moldova Noua, str. 1 Decembrie 1918,nr.219, sala clasa intrarea principala",544,330,318,10,2,330,0,600,270,184,146,1,4759,0
11,"Caras-Severin",51056,118,51056,,"ORAS MOLDOVA NOUA",119,"Scoala generala nr.3, Moldova Noua,aleeaTraian Vuia, hol parter",1271,552,539,13,0,544,8,1396,844,215,329,1,4759,0
11,"Caras-Severin",51056,118,51056,,"ORAS MOLDOVA NOUA",120,"Gradinita cu program prelungit nr.2,aleea Francesco Griselini, hol parter intrarea principala",1215,487,480,7,0,478,9,1340,853,197,281,1,4759,0
11,"Caras-Severin",51056,118,51056,,"ORAS MOLDOVA NOUA",121,"Sediul SC ""Moldomin"" SA - parter, SC Dunarea SA, str. Dunarii, nr.1",1453,599,589,10,0,595,4,1600,1001,239,356,1,4759,0
11,"Caras-Severin",51056,118,51056,,"ORAS MOLDOVA NOUA",122,"Scoala generala nr.4,aleea George Cosbuc, sala laborator biologie",1135,493,483,7,3,487,6,1200,707,199,288,1,4759,0
11,"Caras-Severin",51056,118,51056,,"ORAS MOLDOVA NOUA",123,"Gradinita PP1 (Clubul copiilor si elevilor),aleea Ioan Slavici, hol parter intrarea principala",1082,459,449,10,0,455,4,1200,741,202,253,1,4759,0
11,"Caras-Severin",51056,118,51056,,"ORAS MOLDOVA NOUA",124,"Liceul Moldova Noua,aleea George Cosbuc, hol parter intrarea principala",893,387,375,12,0,383,4,1000,613,144,239,1,4759,0
11,"Caras-Severin",51056,118,51056,,"ORAS MOLDOVA NOUA",125,"Scoala generala Macesti,nr.111A, sala clasa intrarea principala",484,288,281,7,0,285,3,550,262,105,180,1,4759,0
11,"Caras-Severin",51056,118,51056,,"ORAS MOLDOVA NOUA",126,"Camin Cultural Moldova Veche,nr.447",1358,723,715,8,0,710,13,1501,778,280,430,1,4759,0
11,"Caras-Severin",51056,118,51056,,"ORAS MOLDOVA NOUA",127,"Camin Cultural Moldovita,nr.7B",197,161,150,11,0,161,0,219,58,63,98,1,4759,0
11,"Caras-Severin",51056,118,51056,,"ORAS MOLDOVA NOUA",128,"Portul de Calatori Moldova Veche, str. Portului, nr.1",0,226,0,226,0,224,2,252,26,103,121,1,4759,1
11,"Caras-Severin",51118,118,51118,,"ORAS ORAVITA",129,"Scoala generala nr.3 Oravita, str. Emanoil Gojdu nr.54",1071,507,498,8,1,496,11,1100,593,288,208,1,4764,0
11,"Caras-Severin",51118,118,51118,,"ORAS ORAVITA",130,"Liceul Teoretic General Dragalina Oravita, str. Piata Ferdinand, nr.1",972,482,475,6,1,474,8,1003,521,259,215,1,4764,0
11,"Caras-Severin",51118,118,51118,,"ORAS ORAVITA",131,"Scoala generala nr.2 Oravita, str. Eftimie Murgu nr.31-33",994,527,515,10,2,523,4,1000,473,246,277,1,4764,0
11,"Caras-Severin",51118,118,51118,,"ORAS ORAVITA",132,"Grup Scolar Agricol Oravita, str. Closca nr.10",1119,532,525,7,0,526,6,1200,668,308,218,1,4764,0
11,"Caras-Severin",51118,118,51118,,"ORAS ORAVITA",133,"Scoala generala nr.1 Oravita, Corp cladire veche, str. Zona Garii",1369,588,582,6,0,583,5,1400,812,313,270,1,4764,0
11,"Caras-Severin",51118,118,51118,,"ORAS ORAVITA",134,"Scoala generala nr.1 Oravita, Sala de sport veche, str. Zona Garii",1506,657,640,17,0,648,9,1600,943,398,250,1,4764,0
11,"Caras-Severin",51118,118,51118,,"ORAS ORAVITA",135,"Cresa Camin Oravita str. Zona Garii",1402,627,618,8,1,623,4,1600,973,303,320,1,4764,0
11,"Caras-Severin",51118,118,51118,,"ORAS ORAVITA",136,"Scoala Generala nr.1 Oravita,Corp Cladire Noua, str. Zona Garii",1179,506,502,4,0,501,5,1200,694,301,200,1,4764,0
11,"Caras-Severin",51118,118,51118,,"ORAS ORAVITA",137,"Camin Cultural Ciclova Montana,str.Brazilor nr.118",480,271,263,8,0,265,6,600,329,122,143,1,4764,0
11,"Caras-Severin",51118,118,51118,,"ORAS ORAVITA",138,"Centrul Administrativ Marila",48,34,24,10,0,34,0,200,166,22,12,1,4764,0
11,"Caras-Severin",51118,118,51118,,"ORAS ORAVITA",139,"Scoala generala Agadici",186,105,93,12,0,103,2,302,197,69,34,1,4764,0
11,"Caras-Severin",51118,118,51118,,"ORAS ORAVITA",140,"Scoala generala Bradisoru de Jos, nr.50 A",461,228,216,11,1,225,3,600,372,128,97,1,4764,0
11,"Caras-Severin",51118,118,51118,,"ORAS ORAVITA",141,"Camin Cultural Brosteni, nr.50",513,245,234,11,0,244,1,699,454,145,99,1,4764,0
11,"Caras-Severin",51118,118,51118,,"ORAS ORAVITA",142,"Scoala generala Rachitova, nr.48",296,155,145,10,0,154,1,300,145,96,58,1,4764,0
11,"Caras-Severin",51118,118,51118,,"ORAS ORAVITA",143,"Autogara - SC Auto Nera SA, str. Brosteniului, nr.10",0,254,0,254,0,251,3,351,97,125,126,1,4764,1
11,"Caras-Severin",51207,118,51207,,"ORAS OTELU ROSU",144,"Casa de Cultura a Orasului Otelu Rosu - Sala intrare, Centrul Civic",1024,493,489,4,0,486,7,1126,633,235,251,1,4772,0
11,"Caras-Severin",51207,118,51207,,"ORAS OTELU ROSU",145,"Casa de Cultura a Orasului Otelu Rosu - Sala conferinte, Centrul Civic",800,364,359,5,0,357,7,880,516,171,186,1,4772,0
11,"Caras-Severin",51207,118,51207,,"ORAS OTELU ROSU",146,"Scoala generala nr.3, str. Libertatii,nr.3",1429,675,666,9,0,666,9,1572,897,331,335,1,4772,0
11,"Caras-Severin",51207,118,51207,,"ORAS OTELU ROSU",147,"Gradinita cu program prelungit nr.3 str.Rozelor,nr.3",1194,658,642,16,0,654,4,1213,555,314,340,1,4772,0
11,"Caras-Severin",51207,118,51207,,"ORAS OTELU ROSU",148,"Cantina de Ajutor Social, str. Republicii,nr.40",905,442,431,11,0,435,7,996,554,223,212,1,4772,0
11,"Caras-Severin",51207,118,51207,,"ORAS OTELU ROSU",149,"Gradinita cu program normal nr.2 str.Revolutiei,nr.67",1183,643,636,7,0,635,8,1301,658,354,281,1,4772,0
11,"Caras-Severin",51207,118,51207,,"ORAS OTELU ROSU",150,"Gradinita cu program normal Gai,str.Closca,nr.7",1100,611,601,10,0,600,11,1210,599,307,293,1,4772,0
11,"Caras-Severin",51207,118,51207,,"ORAS OTELU ROSU",151,"Gradinita cu program normal Valea Ohabii,nr.10",559,305,296,9,0,299,6,615,310,174,125,1,4772,0
11,"Caras-Severin",51207,118,51207,,"ORAS OTELU ROSU",152,"SC Romflex SA - Sala sedinte, str.Tineretului,nr.1",325,174,167,7,0,168,6,358,184,80,88,1,4772,0
11,"Caras-Severin",51207,118,51207,,"ORAS OTELU ROSU",153,"SC Romflex SA - Sala protocol,str.Tineretului, nr.1",1285,618,611,7,0,599,19,1414,796,354,245,1,4772,0
11,"Caras-Severin",51207,118,51207,,"ORAS OTELU ROSU",154,"Caminul Cultural Ciresa str.Hategului",664,383,374,8,1,378,5,730,347,242,136,1,4772,0
11,"Caras-Severin",51207,118,51207,,"ORAS OTELU ROSU",155,"Scoala generala cls.I-IV Mal sat Mal",313,227,221,6,0,227,0,344,117,157,70,1,4772,0
11,"Caras-Severin",51207,118,51207,,"ORAS OTELU ROSU",156,"Grup Scolar Industrial Otelu Rosu, str.Republicii, nr.10",0,228,0,228,0,226,2,306,78,150,76,1,4772,1
11,"Caras-Severin",51243,118,51243,,"ARMENIS",157,"Scoala cu clasele I-VIII Armenis,nr.69, sala cu clasele I-III",1144,746,739,7,0,740,6,1258,512,386,354,3,4776,0
11,"Caras-Severin",51243,118,51243,,"ARMENIS",158,"Scoala cu clasele I-IV Fenes,nr.15, sala cu clasele II-IV",463,318,312,6,0,315,3,480,162,151,164,3,4776,0
11,"Caras-Severin",51243,118,51243,,"ARMENIS",159,"Scoala cu clasele I-IV Sat Batrin,nr.82,  sala cu clasele II-IV",340,223,219,4,0,222,1,374,151,127,95,3,4776,0
11,"Caras-Severin",51243,118,51243,,"ARMENIS",160,"Scoala cu clasele I-IV Submarginea,nr.63, sala cu clasele I-IV",170,108,96,12,0,108,0,187,79,69,39,3,4776,0
11,"Caras-Severin",51243,118,51243,,"ARMENIS",161,"Gara CFR Armenis, sala de asteptare, sat Armenis",0,126,0,126,0,126,0,161,35,63,63,3,4776,1
11,"Caras-Severin",51305,118,51305,,"BANIA",162,"Caminul Cultural din centrul comunei Bania, sala parter",1013,661,648,7,6,658,3,1094,433,368,290,3,4782,0
11,"Caras-Severin",51305,118,51305,,"BANIA",163,"Caminul Cultural Girbovat",509,319,315,4,0,316,3,560,241,132,184,3,4782,0
11,"Caras-Severin",51305,118,51305,,"BANIA",164,"Caminul Cultural din centrul comunei Bania, sala etaj, nr.129",0,38,0,38,0,38,0,55,17,21,17,3,4782,1
11,"Caras-Severin",51332,118,51332,,"BAUTAR",165,"Casa Culturala Bautar de Jos, sat Bautar, nr.253A, sala de spectacole",732,502,460,11,31,497,5,782,280,280,217,3,4785,0
11,"Caras-Severin",51332,118,51332,,"BAUTAR",166,"Primaria Comunei Bautar, sat Bautar, nr.55, sala de sedinta a Consiliului local",725,501,462,16,23,492,9,816,315,265,227,3,4785,0
11,"Caras-Severin",51332,118,51332,,"BAUTAR",167,"Scoala cu clasele I-VIII Bucova, sat Bucova, nr.53",760,592,567,3,22,584,8,836,244,286,298,3,4785,0
11,"Caras-Severin",51332,118,51332,,"BAUTAR",168,"Scoala cu clasele I-VIII Bautar, Centru, sat Bautar, nr.353",0,123,0,123,0,122,1,175,52,61,61,3,4785,1
11,"Caras-Severin",51387,118,51387,,"BERLISTE",169,"Scoala cu clasele I-IV Berliste",303,177,170,3,4,173,4,337,160,49,124,3,4790,0
11,"Caras-Severin",51387,118,51387,,"BERLISTE",170,"Scoala cu clasele I-IV Iam",299,188,172,8,8,188,0,329,141,82,106,3,4790,0
11,"Caras-Severin",51387,118,51387,,"BERLISTE",171,"Scoala cu clasele I-IV Milcoveni",227,131,123,8,0,129,2,251,120,59,70,3,4790,0
11,"Caras-Severin",51387,118,51387,,"BERLISTE",172,"Scoala cu clasele I-IV Rusova Noua",137,84,80,4,0,84,0,151,67,43,41,3,4790,0
11,"Caras-Severin",51387,118,51387,,"BERLISTE",173,"Scoala cu clasele V-VIII Berliste",0,97,0,97,0,97,0,158,61,42,55,3,4790,1
11,"Caras-Severin",51449,118,51449,,"BERZASCA",174,"Casa Culturala Berzasca, sala de spectacole",1170,671,637,12,22,667,4,1287,616,387,280,3,4796,0
11,"Caras-Severin",51449,118,51449,,"BERZASCA",175,"Scoala cu cls.I-VIII Bigar",217,97,87,10,0,94,3,239,142,49,45,3,4796,0
11,"Caras-Severin",51449,118,51449,,"BERZASCA",176,"Scoala cu cls.I-IV Cozla",89,49,36,13,0,49,0,98,49,24,25,3,4796,0
11,"Caras-Severin",51449,118,51449,,"BERZASCA",177,"Gradinita PN Liubcova, sala clasa, intrarea din curte",961,598,582,9,7,586,12,1057,459,377,209,3,4796,0
11,"Caras-Severin",51449,118,51449,,"BERZASCA",178,"Casa Culturala Berzasca, sala de dans",0,115,0,115,0,114,1,165,50,80,34,3,4796,1
11,"Caras-Severin",51500,118,51500,,"BERZOVIA",179,"Scoala generala Berzovia,nr.122",1758,664,659,5,0,656,8,1881,1217,301,355,3,4802,0
11,"Caras-Severin",51500,118,51500,,"BERZOVIA",180,"Scoala generala Fizes,nr.4",678,251,241,10,0,249,2,710,459,160,89,3,4802,0
11,"Caras-Severin",51500,118,51500,,"BERZOVIA",181,"Scoala generala Ghertenis.nr.324",809,318,311,7,0,316,2,890,572,169,147,3,4802,0
11,"Caras-Severin",51500,118,51500,,"BERZOVIA",182,"Caminul Cultural Berzovia, nr.127",0,79,0,79,0,79,0,100,21,31,48,3,4802,1
11,"Caras-Severin",51546,118,51546,,"BOLVASNITA",183,"Clubul Tineretului Bolvasnita",426,226,226,0,0,222,4,449,223,113,109,3,4806,0
11,"Caras-Severin",51546,118,51546,,"BOLVASNITA",184,"Clubul Tineretului Virciorova",799,449,444,1,4,448,1,877,428,214,234,3,4806,0
11,"Caras-Severin",51546,118,51546,,"BOLVASNITA",185,"Scoala cu clasele I-IV, Bolvasnita, str.Principala, nr. 167",0,60,0,60,0,59,1,60,0,27,32,3,4806,1
11,"Caras-Severin",51573,118,51573,,"BOZOVICI",186,"Scoala cu clasele I-IV Bozovici (langa biserica),nr.206",1310,829,791,9,29,826,3,1441,612,412,414,3,4809,0
11,"Caras-Severin",51573,118,51573,,"BOZOVICI",187,"Liceul Teoretic Bozovici,nr.826",726,443,418,13,12,440,3,799,356,230,210,3,4809,0
11,"Caras-Severin",51573,118,51573,,"BOZOVICI",188,"Scoala cu clasele I-VIII Prilipeti,nr.27",672,423,417,6,0,419,4,739,316,250,169,3,4809,0
11,"Caras-Severin",51573,118,51573,,"BOZOVICI",189,"Scoala cu clasele V-VIII Bozovici, corp I",0,205,0,205,0,205,0,283,78,107,98,3,4809,1
11,"Caras-Severin",51626,118,51626,,"BREBU",190,"Scoala generala ""Sf.Iacob"" cls.I-VIII Brebu, sala nr.2",614,426,378,3,45,423,3,675,249,203,220,3,4814,0
11,"Caras-Severin",51626,118,51626,,"BREBU",191,"Caminul Cultural Apadia",202,148,135,8,5,146,2,222,74,116,30,3,4814,0
11,"Caras-Severin",51626,118,51626,,"BREBU",192,"Scoala cu cls.I-IV Valeadeni",194,146,122,10,14,145,1,213,67,74,71,3,4814,0
11,"Caras-Severin",51626,118,51626,,"BREBU",193,"Scoala cu clasele I-VIII Brebu, parter, sala nr.3",0,279,0,279,0,276,3,467,188,137,139,3,4814,1
11,"Caras-Severin",51662,118,51662,,"BREBU NOU",194,"Caminul Cultural din Garina,nr.147",279,60,55,5,0,58,2,307,247,24,34,3,4818,0
11,"Caras-Severin",51662,118,51662,,"BREBU NOU",195,"Centrul de Informare Turistica Garina (sediul fostei Scoli generale din Garina), nr.147",0,75,0,75,0,75,0,112,37,40,35,3,4818,1
11,"Caras-Severin",51699,118,51699,,"BUCHIN",196,"Scoala cu cls.I-IV Buchin,nr.2",741,384,368,8,8,381,3,815,431,223,158,3,4821,0
11,"Caras-Severin",51699,118,51699,,"BUCHIN",197,"Scoala cu cls.I-VIII Poiana, nr.137",578,373,327,6,40,371,2,636,263,134,237,3,4821,0
11,"Caras-Severin",51699,118,51699,,"BUCHIN",198,"Scoala cu cls.I-IV Valea Timisului,nr.101",465,286,280,6,0,283,3,512,226,151,132,3,4821,0
11,"Caras-Severin",51699,118,51699,,"BUCHIN",199,"Caminul Cultural Buchin, nr.4A",0,90,0,90,0,90,0,151,61,46,44,3,4821,1
11,"Caras-Severin",51751,118,51751,,"BUCOSNITA",200,"Scoala cu clasele I-IV Bucosnita, sala clasei a II-a",626,413,409,4,0,410,3,487,74,186,224,3,4827,0
11,"Caras-Severin",51751,118,51751,,"BUCOSNITA",201,"Scoala cu clasele I-IV Golet, sala sport",444,380,370,10,0,378,2,486,106,159,219,3,4827,0
11,"Caras-Severin",51751,118,51751,,"BUCOSNITA",202,"Scoala cu clasele I-VIII Petrosnita, cabinet matematica",750,475,470,5,0,472,3,825,350,285,187,3,4827,0
11,"Caras-Severin",51751,118,51751,,"BUCOSNITA",203,"Scoala cu clasele I-VIII Valisoara, sala gradinita",575,317,311,6,0,315,2,631,314,174,141,3,4827,0
11,"Caras-Severin",51751,118,51751,,"BUCOSNITA",204,"Scoala cu clasele I-IV Bucosnita, nr.1,sala gradinita",0,233,0,233,0,232,1,291,58,52,180,3,4827,1
11,"Caras-Severin",51804,118,51804,,"CARASOVA",205,"Caminul Cultural Carasova, sala mica de la parter",957,379,376,3,0,375,4,1043,664,241,134,3,4832,0
11,"Caras-Severin",51804,118,51804,,"CARASOVA",206,"Scoala cu clasele I-IV nr.1 Carasova, sala nr.1",1050,360,356,4,0,355,5,1155,795,230,125,3,4832,0
11,"Caras-Severin",51804,118,51804,,"CARASOVA",207,"Scoala cu clasele I-IV Iabalcea",176,116,110,6,0,113,3,194,78,55,58,3,4832,0
11,"Caras-Severin",51804,118,51804,,"CARASOVA",208,"Scoala cu clasele I-IV Nermed",460,227,221,6,0,227,0,506,279,178,49,3,4832,0
11,"Caras-Severin",51804,118,51804,,"CARASOVA",209,"Scoala cu clasele I-IV nr.1 Carasova, nr.23, sala nr.2",0,46,0,46,0,46,0,53,7,31,15,3,4832,1
11,"Caras-Severin",51840,118,51840,,"CARBUNARI",210,"Scoala cu clasele I-VIII Carbunari, sala clasei a VIII-a",623,413,386,3,24,409,4,685,272,165,244,3,4836,0
11,"Caras-Severin",51840,118,51840,,"CARBUNARI",211,"Scoala cu clasele I-IV Stinapari",338,219,209,9,1,219,0,372,153,106,113,3,4836,0
11,"Caras-Severin",51840,118,51840,,"CARBUNARI",212,"Scoala cu clasele I-VIII Carbunari, sala clasei a IV-a",0,70,0,70,0,70,0,168,98,39,31,3,4836,1
11,"Caras-Severin",51948,118,51948,,"CICLOVA ROMANA",213,"Scoala cu clasele I-VIII Ciclova Romana, sala nr.1",952,441,420,5,16,437,4,1000,559,148,289,3,4839,0
11,"Caras-Severin",51948,118,51948,,"CICLOVA ROMANA",214,"Scoala cu clasele I-IV Ilidia",288,147,134,8,5,145,2,300,153,63,82,3,4839,0
11,"Caras-Severin",51948,118,51948,,"CICLOVA ROMANA",215,"Sediul fostei primarii din Socolari",131,82,73,9,0,82,0,150,68,52,30,3,4839,0
11,"Caras-Severin",51948,118,51948,,"CICLOVA ROMANA",216,"Scoala cu clasele I-VIII Ciclova Romana, sala I.C. Bratianu",0,69,0,69,0,69,0,265,196,39,30,3,4839,1
11,"Caras-Severin",51984,118,51984,,"CIUCHICI",217,"Casa de Cultura Ciuchici, locatia 1",444,270,265,4,1,267,3,445,175,133,134,3,4843,0
11,"Caras-Severin",51984,118,51984,,"CIUCHICI",218,"Casa de Cultura Macoviste",102,73,69,4,0,72,1,110,37,54,18,3,4843,0
11,"Caras-Severin",51984,118,51984,,"CIUCHICI",219,"Sediul fostei primarii Nicolint",229,137,117,9,11,134,3,240,103,98,36,3,4843,0
11,"Caras-Severin",51984,118,51984,,"CIUCHICI",220,"Casa de Cultura Petrilova",133,103,93,10,0,101,2,140,37,65,36,3,4843,0
11,"Caras-Severin",51984,118,51984,,"CIUCHICI",221,"Casa Culturala Ion Frumosu, locatia 2",0,99,0,99,0,99,0,302,203,62,37,3,4843,1
11,"Caras-Severin",52035,118,52035,,"CIUDANOVITA",222,"Scoala generala cu clasele I-VIII Ciudanovita, sala clasei a V-a",477,262,259,3,0,257,5,500,238,70,187,3,4848,0
11,"Caras-Severin",52035,118,52035,,"CIUDANOVITA",223,"Caminul Cultural Jitin",132,94,85,9,0,93,1,150,56,46,47,3,4848,0
11,"Caras-Severin",52035,118,52035,,"CIUDANOVITA",224,"Scoala generala cu clasele I-VIII Ciudanovita, sala clasei a VI-a",0,28,0,28,0,28,0,63,35,14,14,3,4848,1
11,"Caras-Severin",51877,118,51877,,"CONSTANTIN DAICOVICIU",225,"Camin Cultural Cavaran",584,407,388,7,12,403,4,642,235,142,261,3,4851,0
11,"Caras-Severin",51877,118,51877,,"CONSTANTIN DAICOVICIU",226,"Scoala cu clasele I-VIII Maciova",371,214,209,5,0,214,0,408,194,107,107,3,4851,0
11,"Caras-Severin",51877,118,51877,,"CONSTANTIN DAICOVICIU",227,"Scoala cu clasele I-IV Matnicu Mare",329,205,197,8,0,204,1,362,157,109,95,3,4851,0
11,"Caras-Severin",51877,118,51877,,"CONSTANTIN DAICOVICIU",228,"Scoala cu clasele I-IV Pestere",191,130,124,6,0,126,4,210,80,54,72,3,4851,0
11,"Caras-Severin",51877,118,51877,,"CONSTANTIN DAICOVICIU",229,"Scoala cu clasele I-IV Prisaca",333,189,185,4,0,186,3,366,177,101,85,3,4851,0
11,"Caras-Severin",51877,118,51877,,"CONSTANTIN DAICOVICIU",230,"Scoala cu clasele I-VIII Zagujeni",444,250,245,5,0,248,2,488,238,122,126,3,4851,0
11,"Caras-Severin",51877,118,51877,,"CONSTANTIN DAICOVICIU",231,"Gradinita PN Cavaran",0,100,0,100,0,98,2,259,159,45,53,3,4851,1
11,"Caras-Severin",52062,118,52062,,"COPACELE",232,"Scoala cu clasele I-VIII Copacele",346,176,175,0,1,174,2,350,174,55,119,3,4858,0
11,"Caras-Severin",52062,118,52062,,"COPACELE",233,"Scoala cu cls.I-IV Ohaba Matnic",243,149,145,4,0,147,2,300,151,93,54,3,4858,0
11,"Caras-Severin",52062,118,52062,,"COPACELE",234,"Scoala cu cls.I-IV Ruginosu",86,63,57,6,0,63,0,100,37,25,38,3,4858,0
11,"Caras-Severin",52062,118,52062,,"COPACELE",235,"Scoala cu cls.I-IV Zorile",399,202,194,8,0,200,2,400,198,96,104,3,4858,0
11,"Caras-Severin",52062,118,52062,,"COPACELE",236,"Caminul Cultural Copacele, nr.122",0,72,0,72,0,71,1,119,47,44,27,3,4858,1
11,"Caras-Severin",52115,118,52115,,"CORNEA",237,"Scoala cu clasele I-VIII Cornea, prima sala din dreapta",678,407,391,1,15,403,4,746,339,156,247,3,4863,0
11,"Caras-Severin",52115,118,52115,,"CORNEA",238,"Scoala cu clasele I-IV Crusovat, sala din stanga",432,302,302,0,0,300,2,475,173,141,159,3,4863,0
11,"Caras-Severin",52115,118,52115,,"CORNEA",239,"Scoala cu clasele I-VIII Cuptoare, sala din dreapta",562,368,356,7,5,366,2,618,250,186,180,3,4863,0
11,"Caras-Severin",52115,118,52115,,"CORNEA",240,"Caminul Cultural Cornea, nr.128",0,70,0,70,0,70,0,88,18,27,43,3,4863,1
11,"Caras-Severin",52160,118,52160,,"CORNEREVA",241,"Scoala Cornereva",361,192,180,12,0,191,1,397,205,120,71,3,4868,0
11,"Caras-Severin",52160,118,52160,,"CORNEREVA",242,"Scoala Bogiltin",455,186,176,10,0,186,0,501,315,89,97,3,4868,0
11,"Caras-Severin",52160,118,52160,,"CORNEREVA",243,"Scoala Dolina",722,419,398,21,0,415,4,794,375,187,228,3,4868,0
11,"Caras-Severin",52160,118,52160,,"CORNEREVA",244,"Scoala Gruni",898,527,504,23,0,520,7,988,461,326,194,3,4868,0
11,"Caras-Severin",52160,118,52160,,"CORNEREVA",245,"Scoala Inelet",103,48,34,14,0,48,0,113,65,22,26,3,4868,0
11,"Caras-Severin",52160,118,52160,,"CORNEREVA",246,"Gradinita Cornereva",0,96,0,96,0,96,0,105,9,51,45,3,4868,1
11,"Caras-Severin",53489,118,53489,,"CORONINI",247,"Scoala cu cls.I-VIII Coronini, nr.59, sala nr.1",1123,738,736,2,0,734,4,1236,498,356,378,3,4909,0
11,"Caras-Severin",53489,118,53489,,"CORONINI",248,"Caminul Cultural Sfanta Elena, nr.99",452,210,200,10,0,207,3,497,287,87,120,3,4909,0
11,"Caras-Severin",53489,118,53489,,"CORONINI",249,"Scoala cu cls.I-VIII Coronini, nr.59, sala nr.2",0,37,0,37,0,37,0,53,16,24,13,3,4909,1
11,"Caras-Severin",52570,118,52570,,"DALBOSET",250,"Caminul Cultural Dalboset,nr.128, sala fostei biblioteci comunale, parter",934,671,638,3,30,666,5,1020,349,273,393,3,4912,0
11,"Caras-Severin",52570,118,52570,,"DALBOSET",251,"Caminul Cultural Sopotu Vechi,nr.115, sala mare parter",584,432,398,10,24,428,4,645,213,185,243,3,4912,0
11,"Caras-Severin",52570,118,52570,,"DALBOSET",252,"Caminul Cultural Dalboset,nr.128, sala nr.2",0,123,0,123,0,119,4,194,71,76,43,3,4912,1
11,"Caras-Severin",52650,118,52650,,"DOCLIN",253,"Scoala cu clasele I-IV Doclin,nr.114, sala claselor II-IV",450,288,269,3,16,288,0,435,147,138,150,3,4920,0
11,"Caras-Severin",52650,118,52650,,"DOCLIN",254,"Scoala cu cls.I-VIII Binis,nr.121",651,324,320,4,0,319,5,715,391,183,136,3,4920,0
11,"Caras-Severin",52650,118,52650,,"DOCLIN",255,"Scoala cu cls.I-VIII Tirol,nr.1",522,237,231,2,4,234,3,574,337,101,133,3,4920,0
11,"Caras-Severin",52650,118,52650,,"DOCLIN",256,"Scoala cu clasele I-IV Doclin,nr.114, sala clasei I",0,95,0,95,0,93,2,95,0,36,57,3,4920,1
11,"Caras-Severin",52696,118,52696,,"DOGNECEA",257,"Scoala generala Dognecea, corp A",970,616,573,5,38,612,4,1047,431,414,198,3,4924,0
11,"Caras-Severin",52696,118,52696,,"DOGNECEA",258,"Scoala generala Dognecea, corp B",528,378,357,11,10,378,0,581,203,341,37,3,4924,0
11,"Caras-Severin",52696,118,52696,,"DOGNECEA",259,"Caminul Cultural Calina",96,89,62,10,17,88,1,106,17,67,21,3,4924,0
11,"Caras-Severin",52696,118,52696,,"DOGNECEA",260,"Sediul Serviciului Voluntar pentru Situatii de Urgenta Dognecea, nr.141 A",0,120,0,120,0,119,1,136,16,80,39,3,4924,1
11,"Caras-Severin",52721,118,52721,,"DOMASNEA",261,"Caminul Cultural Domasnea",891,574,522,4,48,565,9,1000,426,270,295,3,4927,0
11,"Caras-Severin",52721,118,52721,,"DOMASNEA",262,"Caminul Cultural Canicea",317,197,175,7,15,197,0,349,152,150,47,3,4927,0
11,"Caras-Severin",52721,118,52721,,"DOMASNEA",263,"Scoala cu clasele I-VIII Domasnea, nr.343",0,118,0,118,0,117,1,146,28,68,49,3,4927,1
11,"Caras-Severin",53700,118,53700,,"EFTIMIE MURGU",264,"Casa Culturala ""Dr.Ion Sirbu"", nr.261, sala club",1440,1028,983,0,45,1018,10,1584,556,408,610,3,4930,0
11,"Caras-Severin",53700,118,53700,,"EFTIMIE MURGU",265,"Casa Culturala ""Dr.Ion Sirbu"", nr.261, sala biblioteca",0,55,0,55,0,55,0,78,23,29,26,3,4930,1
11,"Caras-Severin",52758,118,52758,,"EZERIS",266,"Scoala generala cu clasele I-VIII Ezeris, corpul II",524,292,270,4,18,287,5,560,268,135,152,3,4932,0
11,"Caras-Severin",52758,118,52758,,"EZERIS",267,"Scoala cu clasele I-IV Soceni",552,390,349,8,33,386,4,560,170,127,259,3,4932,0
11,"Caras-Severin",52758,118,52758,,"EZERIS",268,"Scoala generala cu clasele I-VIII Ezeris, corpul I",0,87,0,87,0,86,1,212,125,42,44,3,4932,1
11,"Caras-Severin",52785,118,52785,,"FARLIUG",269,"Scoala cu clasele I-VIII Firliug,nr.100, sala nr.1",687,489,449,2,38,488,1,700,211,380,108,3,4935,0
11,"Caras-Severin",52785,118,52785,,"FARLIUG",270,"Scoala cu cls.I-IV Dezesti,nr.115",161,146,125,8,13,146,0,190,44,113,33,3,4935,0
11,"Caras-Severin",52785,118,52785,,"FARLIUG",271,"Scoala cu cls.I-IV Duleu,nr.155",162,130,115,9,6,130,0,180,50,101,29,3,4935,0
11,"Caras-Severin",52785,118,52785,,"FARLIUG",272,"Scoala cu clasele I-IV Remetea Poganici,nr.115",156,119,110,9,0,119,0,160,41,86,33,3,4935,0
11,"Caras-Severin",52785,118,52785,,"FARLIUG",273,"Caminul Cultural Scaius,nr.83A",287,217,184,3,30,214,3,300,83,146,68,3,4935,0
11,"Caras-Severin",52785,118,52785,,"FARLIUG",274,"Caminul Cultural Valea Mare,nr.87",98,85,66,10,9,85,0,120,35,70,15,3,4935,0
11,"Caras-Severin",52785,118,52785,,"FARLIUG",275,"Scoala cu clasele I-VIII Firliug,nr.100, sala nr.2, parter",0,244,0,244,0,242,2,349,105,193,49,3,4935,1
11,"Caras-Severin",52856,118,52856,,"FOROTIC",276,"Caminul Cultural Forotic, sala parter",571,317,300,2,15,314,3,600,283,223,91,3,4942,0
11,"Caras-Severin",52856,118,52856,,"FOROTIC",277,"Caminul Cultural Comoriste",498,273,265,3,5,268,5,500,227,137,131,3,4942,0
11,"Caras-Severin",52856,118,52856,,"FOROTIC",278,"Caminul Cultural Surducu Mare",393,227,221,6,0,227,0,400,173,158,69,3,4942,0
11,"Caras-Severin",52856,118,52856,,"FOROTIC",279,"Caminul Cultural Forotic, nr.151, sala etaj",0,47,0,47,0,47,0,191,144,26,21,3,4942,1
11,"Caras-Severin",52909,118,52909,,"GARNIC",280,"Casa Culturala ""Petr Glaser"" Garnic",434,186,180,6,0,184,2,477,291,147,37,3,4947,0
11,"Caras-Severin",52909,118,52909,,"GARNIC",281,"Casa Culturala Padina Matei",758,543,520,9,14,541,2,832,289,135,406,3,4947,0
11,"Caras-Severin",52909,118,52909,,"GARNIC",282,"Scoala cu clasele I-VIII Padina Matei, nr.12",0,28,0,28,0,28,0,47,19,12,16,3,4947,1
11,"Caras-Severin",52936,118,52936,,"GLIMBOCA",283,"Caminul Cultural Glimboca, nr.367, sala de spectacole",1496,966,917,3,46,952,14,1600,634,589,363,3,4950,0
11,"Caras-Severin",52936,118,52936,,"GLIMBOCA",284,"Caminul Cultural Glimboca, nr.367, sala de sedinte",0,74,0,74,0,73,1,121,47,42,31,3,4950,1
11,"Caras-Severin",52954,118,52954,,"GORUIA",285,"Caminul Cultural Goruia",300,183,180,3,0,180,3,320,137,91,89,3,4952,0
11,"Caras-Severin",52954,118,52954,,"GORUIA",286,"Dispensarul Medical Giurgiova",130,64,58,6,0,63,1,150,86,19,44,3,4952,0
11,"Caras-Severin",52954,118,52954,,"GORUIA",287,"Scoala cu cls.I-IV Girliste, sala nr.2",276,173,170,3,0,171,2,296,123,102,69,3,4952,0
11,"Caras-Severin",52954,118,52954,,"GORUIA",288,"Scoala cu cls.I-IV Girliste, sala nr.1",0,99,0,99,0,99,0,106,7,60,39,3,4952,1
11,"Caras-Severin",52990,118,52990,,"GRADINARI",289,"Scoala cu clasele I-VIII Gradinari, sala clasei a III-a",898,510,483,3,24,503,7,800,290,200,303,3,4956,0
11,"Caras-Severin",52990,118,52990,,"GRADINARI",290,"Fostul sediu CAP Greoni, nr.1",785,456,436,7,13,455,1,800,344,230,225,3,4956,0
11,"Caras-Severin",52990,118,52990,,"GRADINARI",291,"Scoala cu clasele I-VIII Gradinari, nr.268, sala clasei a II-a",0,87,0,87,0,87,0,331,244,43,44,3,4956,1
11,"Caras-Severin",53023,118,53023,,"IABLANITA",292,"Scoala cu cls.I-VIII Iablanita",680,387,374,6,7,384,3,703,316,173,211,3,4959,0
11,"Caras-Severin",53023,118,53023,,"IABLANITA",293,"Scoala cu cls.I-IV Globu Craiovei",613,394,373,11,10,391,3,677,283,167,224,3,4959,0
11,"Caras-Severin",53023,118,53023,,"IABLANITA",294,"Scoala cu cls.I-IV Petnic",682,385,375,4,6,385,0,750,365,225,160,3,4959,0
11,"Caras-Severin",53023,118,53023,,"IABLANITA",295,"Gara Iablanita, str. Garii, nr.404, sala calatori",0,105,0,105,0,104,1,147,42,47,57,3,4959,1
11,"Caras-Severin",53069,118,53069,,"LAPUSNICEL",296,"Caminul Cultural Lapusnicel,sala mica,etaj 1",476,296,294,2,0,296,0,524,228,134,162,3,4963,0
11,"Caras-Severin",53069,118,53069,,"LAPUSNICEL",297,"Scoala cu cls.I-IV Parvova, sala nr.1",427,323,314,9,0,322,1,470,147,196,126,3,4963,0
11,"Caras-Severin",53069,118,53069,,"LAPUSNICEL",298,"Scoala cu cls.I-VIII Sumita, sala 1",97,93,85,8,0,93,0,107,14,41,52,3,4963,0
11,"Caras-Severin",53069,118,53069,,"LAPUSNICEL",299,"Caminul Cultural Lapusnicel, nr.278, sala nr.1",0,88,0,88,0,87,1,88,0,51,36,3,4963,1
11,"Caras-Severin",53103,118,53103,,"LAPUSNICU MARE",300,"Caminul Cultural Lapusnicu Mare",992,583,580,2,1,581,2,1091,508,317,264,3,4967,0
11,"Caras-Severin",53103,118,53103,,"LAPUSNICU MARE",301,"Caminul Cultural Moceris",517,291,283,8,0,289,2,570,279,197,92,3,4967,0
11,"Caras-Severin",53103,118,53103,,"LAPUSNICU MARE",302,"Scoala generala clasele I-VIII Lapusnicu Mare, nr.128",0,58,0,58,0,58,0,131,73,28,30,3,4967,1
11,"Caras-Severin",53130,118,53130,,"LUNCAVITA",303,"Caminul Cultural Luncavita, sala mica",752,422,418,4,0,421,1,827,405,265,156,3,4970,0
11,"Caras-Severin",53130,118,53130,,"LUNCAVITA",304,"Caminul Cultural Verendin, sala nr.2",1451,905,900,5,0,901,4,1586,681,646,255,3,4970,0
11,"Caras-Severin",53130,118,53130,,"LUNCAVITA",305,"Caminul Cultural Verendin, nr.90, sala nr.1",0,75,0,75,0,74,1,83,8,47,27,3,4970,1
11,"Caras-Severin",53167,118,53167,,"LUPAC",306,"Scala cu cls.I-VIII Lupac, sala nr.1, parter",771,257,252,5,0,253,4,810,553,169,84,3,4973,0
11,"Caras-Severin",53167,118,53167,,"LUPAC",307,"Scoala generala Clocotici, sala nr.1, parter",748,304,295,9,0,298,6,800,496,229,69,3,4973,0
11,"Caras-Severin",53167,118,53167,,"LUPAC",308,"Scoala generala Rafnic, sala nr.1, parter",439,183,178,5,0,182,1,500,317,125,57,3,4973,0
11,"Caras-Severin",53167,118,53167,,"LUPAC",309,"Scoala generala Vodnic, sala de clasa",349,152,142,10,0,151,1,367,215,98,53,3,4973,0
11,"Caras-Severin",53167,118,53167,,"LUPAC",310,"Scoala cu cls.I-VIII Lupac, sala clasei a VII-a",0,31,0,31,0,31,0,100,69,23,8,3,4973,1
11,"Caras-Severin",53210,118,53210,,"MARGA",311,"Casa Culturala ""Dumbravita"" Marga, sat Marga nr.101, sala mare",1015,688,643,4,41,685,3,1107,419,212,473,3,4978,0
11,"Caras-Severin",53210,118,53210,,"MARGA",312,"""Casa Satului"" Vama Marga, nr.11",0,61,0,61,0,60,1,119,58,16,44,3,4978,1
11,"Caras-Severin",53247,118,53247,,"MAURENI",313,"Caminul Cultural  Maureni, nr.131 A, parter",1423,627,612,1,14,614,13,1548,921,290,324,3,4981,0
11,"Caras-Severin",53247,118,53247,,"MAURENI",314,"Scoala cu cls.I-VIII Sosdea, nr.399-400",659,326,312,5,9,324,2,727,401,156,168,3,4981,0
11,"Caras-Severin",53247,118,53247,,"MAURENI",315,"Scoala cu clasele I-VIII Maureni, nr.450-451",0,51,0,51,0,51,0,64,13,28,23,3,4981,1
11,"Caras-Severin",53274,118,53274,,"MEHADIA",316,"Liceul Nicolae Stoica de Hateg, parter partea dreapta",1161,638,634,4,0,635,3,1277,639,316,319,3,4984,0
11,"Caras-Severin",53274,118,53274,,"MEHADIA",317,"Liceul Nicolae Stoica de Hateg, parter partea stanga",724,382,369,13,0,382,0,746,364,209,173,3,4984,0
11,"Caras-Severin",53274,118,53274,,"MEHADIA",318,"Scoala Globurau",206,111,107,4,0,110,1,227,116,70,40,3,4984,0
11,"Caras-Severin",53274,118,53274,,"MEHADIA",319,"Scoala generala Plugova",708,404,397,7,0,402,2,779,375,195,207,3,4984,0
11,"Caras-Severin",53274,118,53274,,"MEHADIA",320,"Scoala Generala Valea Bolvasnita",626,290,286,4,0,290,0,689,399,159,131,3,4984,0
11,"Caras-Severin",53274,118,53274,,"MEHADIA",321,"Liceul Mehadia, sala profesorala",0,177,0,177,0,176,1,182,5,99,77,3,4984,1
11,"Caras-Severin",53327,118,53327,,"MEHADICA",322,"Caminul Cultural Mehadica, sala nr.1",687,493,470,0,23,485,8,710,217,316,169,3,4989,0
11,"Caras-Severin",53327,118,53327,,"MEHADICA",323,"Caminul Cultural Mehadica, nr.70, sala nr.2",0,79,0,79,0,77,2,100,21,53,24,3,4989,1
11,"Caras-Severin",53345,118,53345,,"NAIDAS",324,"Primaria veche Naidas,nr.1, sala 1",692,483,440,5,38,480,3,743,260,328,152,3,4991,0
11,"Caras-Severin",53345,118,53345,,"NAIDAS",325,"Caminul Cultural Lescovita,nr.102",232,179,157,11,11,176,3,255,76,80,96,3,4991,0
11,"Caras-Severin",53345,118,53345,,"NAIDAS",326,"Primaria veche Naidas,nr.1, sala 3",0,134,0,134,0,134,0,134,0,89,45,3,4991,1
11,"Caras-Severin",53372,118,53372,,"OBREJA",327,"Scoala cu clasele V-VIII Obreja",1463,809,805,4,0,796,13,1463,654,375,421,3,4994,0
11,"Caras-Severin",53372,118,53372,,"OBREJA",328,"Scoala cu cls.I-IV Ciuta",300,178,169,9,0,178,0,300,122,50,128,3,4994,0
11,"Caras-Severin",53372,118,53372,,"OBREJA",329,"Scoala cu cls.I-IV Iaz",505,302,295,7,0,300,2,505,203,115,185,3,4994,0
11,"Caras-Severin",53372,118,53372,,"OBREJA",330,"Scoala cu cls.I-IV Var",334,269,263,6,0,268,1,334,65,117,151,3,4994,0
11,"Caras-Severin",53372,118,53372,,"OBREJA",331,"Scoala cu clasele I-IV Obreja, nr.166, sala gradinita, grupa mica",0,119,0,119,0,119,0,405,286,51,68,3,4994,1
11,"Caras-Severin",50987,118,50987,,"OCNA DE FIER",332,"Scoala cu clasele I-VIII Ocna de Fier, sala 1",601,330,321,2,7,328,2,663,333,153,175,3,4999,0
11,"Caras-Severin",50987,118,50987,,"OCNA DE FIER",333,"Scoala cu clasele I-VIII Ocna de Fier,nr.59, sala 2",0,50,0,50,0,50,0,51,1,37,13,3,4999,1
11,"Caras-Severin",53425,118,53425,,"PALTINIS",334,"Caminul Cultural Paltinis, sala nr.1",547,267,263,4,0,265,2,602,335,188,77,3,5001,0
11,"Caras-Severin",53425,118,53425,,"PALTINIS",335,"Scoala generala Cornutel",800,327,323,4,0,323,4,880,553,160,163,3,5001,0
11,"Caras-Severin",53425,118,53425,,"PALTINIS",336,"Scoala generala Delinesti",378,272,265,7,0,272,0,417,145,129,143,3,5001,0
11,"Caras-Severin",53425,118,53425,,"PALTINIS",337,"Scoala primara Ohabita",73,47,37,10,0,46,1,80,33,30,16,3,5001,0
11,"Caras-Severin",53425,118,53425,,"PALTINIS",338,"Scoala primara Rugi",232,115,108,7,0,115,0,255,140,81,34,3,5001,0
11,"Caras-Severin",53425,118,53425,,"PALTINIS",339,"Caminul Cultural Paltinis, sala nr.2",0,64,0,64,0,62,2,67,3,30,32,3,5001,1
11,"Caras-Severin",53513,118,53513,,"POJEJENA",340,"Scoala Generala  Pojejena,nr.412",1007,637,612,7,18,631,6,1108,471,370,261,3,5007,0
11,"Caras-Severin",53513,118,53513,,"POJEJENA",341,"Scoala Generala Belobresca,nr.233",552,360,340,7,13,354,6,607,247,246,108,3,5007,0
11,"Caras-Severin",53513,118,53513,,"POJEJENA",342,"Scoala Generala Divici,nr.67",256,177,163,7,7,176,1,282,105,110,66,3,5007,0
11,"Caras-Severin",53513,118,53513,,"POJEJENA",343,"Scoala Generala ""Sveti Nicola"" Radimna,nr.37",444,351,338,4,9,350,1,487,136,292,58,3,5007,0
11,"Caras-Severin",53513,118,53513,,"POJEJENA",344,"Scoala Generala Susca,nr.169",381,226,217,9,0,219,7,419,193,136,83,3,5007,0
11,"Caras-Severin",53513,118,53513,,"POJEJENA",345,"Caminul Cultural Pojejena Sarba",0,111,0,111,0,110,1,332,221,70,40,3,5007,1
11,"Caras-Severin",53577,118,53577,,"PRIGOR",346,"Scoala veche Prigor",786,467,461,6,0,465,2,867,400,220,245,3,5013,0
11,"Caras-Severin",53577,118,53577,,"PRIGOR",347,"Scoala Generala Borlovenii Noi",382,201,194,7,0,201,0,420,219,130,71,3,5013,0
11,"Caras-Severin",53577,118,53577,,"PRIGOR",348,"Camin Cultural Borlovenii Vechi",422,253,250,3,0,250,3,465,212,90,160,3,5013,0
11,"Caras-Severin",53577,118,53577,,"PRIGOR",349,"Scoala Generala Patas",501,252,246,6,0,249,3,548,296,154,95,3,5013,0
11,"Caras-Severin",53577,118,53577,,"PRIGOR",350,"Scoala Putna",139,98,91,7,0,96,2,153,55,24,72,3,5013,0
11,"Caras-Severin",53577,118,53577,,"PRIGOR",351,"Club Camin Cultural Prigor",0,83,0,83,0,82,1,118,35,22,60,3,5013,1
11,"Caras-Severin",53639,118,53639,,"RAMNA",352,"Scoala cu clasele I-VIII Ramna, sala nr.2",984,561,536,4,21,551,10,1080,519,258,293,3,5022,0
11,"Caras-Severin",53639,118,53639,,"RAMNA",353,"Scoala cu clasele I-IV Valeapai",357,197,188,8,1,195,2,393,196,85,110,3,5022,0
11,"Caras-Severin",53639,118,53639,,"RAMNA",354,"Scoala cu clasele I-VIII Ramna,nr.232, sala nr.1, parter",0,50,0,50,0,50,0,121,71,23,27,3,5022,1
11,"Caras-Severin",53675,118,53675,,"RACASDIA",355,"Consiliul local Racasdia,nr.535, sala de sedinte",1381,687,685,2,0,682,5,1469,782,367,315,3,5019,0
11,"Caras-Severin",53675,118,53675,,"RACASDIA",356,"Cladirea fostei primarii Vraniut,nr.204, sala de sedinte",289,110,100,10,0,110,0,318,208,59,51,3,5019,0
11,"Caras-Severin",53675,118,53675,,"RACASDIA",357,"Caminul Cultural Racasdia",0,103,0,103,0,102,1,133,30,56,46,3,5019,1
11,"Caras-Severin",53728,118,53728,,"RUSCA MONTANA",358,"Scoala cu clasele I-VIII Rusca Montana, sala clasei a III-a",1367,806,797,6,3,792,14,1500,694,371,421,3,5026,0
11,"Caras-Severin",53728,118,53728,,"RUSCA MONTANA",359,"Scoala cu clasele I-IV Ruschita",338,181,176,5,0,180,1,330,149,73,107,3,5026,0
11,"Caras-Severin",53728,118,53728,,"RUSCA MONTANA",360,"Scoala cu clasele I-VIII Rusca Montana, nr.404, sala clasei a II-a",0,52,0,52,0,52,0,100,48,39,13,3,5026,1
11,"Caras-Severin",53755,118,53755,,"SACU",361,"Gradinita PN Sacu, nr.48",695,495,464,9,22,491,4,746,251,345,146,3,5029,0
11,"Caras-Severin",53755,118,53755,,"SACU",362,"Scoala Salbagelu Nou,nr.7",178,110,100,10,0,109,1,200,90,64,45,3,5029,0
11,"Caras-Severin",53755,118,53755,,"SACU",363,"Gradinita Tincova, nr.119",397,227,217,8,2,226,1,450,223,114,112,3,5029,0
11,"Caras-Severin",53755,118,53755,,"SACU",364,"Club Camin Cultural Sacu, nr.55",0,110,0,110,0,109,1,122,12,70,39,3,5029,1
11,"Caras-Severin",53791,118,53791,,"SASCA MONTANA",365,"Scoala cu cls.I-VIII Sasca Montana, sala clasei a VIII-a",462,258,236,5,17,254,4,508,250,125,129,3,5033,0
11,"Caras-Severin",53791,118,53791,,"SASCA MONTANA",366,"Caminul Cultural Bogodint",103,62,50,9,3,62,0,113,51,23,39,3,5033,0
11,"Caras-Severin",53791,118,53791,,"SASCA MONTANA",367,"Caminul Cultural Potoc",233,174,146,8,20,170,4,256,82,119,51,3,5033,0
11,"Caras-Severin",53791,118,53791,,"SASCA MONTANA",368,"Caminul Cultural Sasca Romana",324,209,183,8,18,206,3,356,147,87,119,3,5033,0
11,"Caras-Severin",53791,118,53791,,"SASCA MONTANA",369,"Caminul Cultural Slatina Nera",264,131,120,11,0,128,3,292,161,68,60,3,5033,0
11,"Caras-Severin",53791,118,53791,,"SASCA MONTANA",370,"Scoala cu cls.I-VIII Sasca Montana, sala claselor I-III",0,145,0,145,0,144,1,306,161,89,55,3,5033,1
11,"Caras-Severin",53853,118,53853,,"SICHEVITA",371,"Caminul Cultural Sichevita, nr.395",1345,835,831,3,1,828,7,1480,645,512,316,3,5039,0
11,"Caras-Severin",53853,118,53853,,"SICHEVITA",372,"Scoala cu clasele I-IV Gornea,nr.79",493,321,317,4,0,319,2,542,221,125,194,3,5039,0
11,"Caras-Severin",53853,118,53853,,"SICHEVITA",373,"SC C.C.C.F. SA Timisoara, Santierul Liborajdea",129,55,44,11,0,55,0,142,87,23,32,3,5039,0
11,"Caras-Severin",53853,118,53853,,"SICHEVITA",374,"Sediul fostului Post de Politie Sichevita, nr.396",0,95,0,95,0,95,0,120,25,59,36,3,5039,1
11,"Caras-Severin",54056,118,54056,,"SLATINA-TIMIS",375,"Scoala cu cls.I-IV Slatina Timis",1439,897,848,6,43,893,4,1574,677,470,423,3,5059,0
11,"Caras-Severin",54056,118,54056,,"SLATINA-TIMIS",376,"Scoala generala Ilova",668,465,451,8,6,464,1,735,270,272,192,3,5059,0
11,"Caras-Severin",54056,118,54056,,"SLATINA-TIMIS",377,"Scoala generala Sadova Noua",229,170,145,10,15,170,0,252,82,39,131,3,5059,0
11,"Caras-Severin",54056,118,54056,,"SLATINA-TIMIS",378,"Scoala generala Sadova Veche",304,127,120,7,0,126,1,334,207,74,52,3,5059,0
11,"Caras-Severin",54056,118,54056,,"SLATINA-TIMIS",379,"Scoala generala Sadova Veche, sala gradinita",0,129,0,129,0,128,1,201,72,72,56,3,5059,1
11,"Caras-Severin",54109,118,54109,,"SOCOL",380,"Scoala generala Socol,nr 80",630,292,273,10,9,288,4,693,401,147,141,3,5064,0
11,"Caras-Severin",54109,118,54109,,"SOCOL",381,"Caminul Cultural Bazias",59,35,26,9,0,35,0,65,30,24,11,3,5064,0
11,"Caras-Severin",54109,118,54109,,"SOCOL",382,"Scoala primara Campia,nr 123",476,248,222,26,0,246,2,524,276,108,138,3,5064,0
11,"Caras-Severin",54109,118,54109,,"SOCOL",383,"Scoala primara Zlatita, nr212",613,372,336,8,28,367,5,673,301,205,162,3,5064,0
11,"Caras-Severin",54109,118,54109,,"SOCOL",384,"Caminul Cultural Socol, nr.81",0,50,0,50,0,50,0,189,139,17,33,3,5064,1
11,"Caras-Severin",54163,118,54163,,"SOPOTU NOU",385,"Caminul Cultural Sopotu Nou, nr.18",312,188,181,5,2,186,2,342,154,98,88,3,5070,0
11,"Caras-Severin",54163,118,54163,,"SOPOTU NOU",386,"Caminul Cultural Ravensca, nr.38",125,57,50,7,0,56,1,138,81,23,33,3,5070,0
11,"Caras-Severin",54163,118,54163,,"SOPOTU NOU",387,"Scoala cu clasele I-IV Rachita, nr.3",113,72,65,7,0,69,3,124,52,54,15,3,5070,0
11,"Caras-Severin",54163,118,54163,,"SOPOTU NOU",388,"Caminul Cultural Stancilova, nr.39",109,81,70,11,0,81,0,120,39,48,33,3,5070,0
11,"Caras-Severin",54163,118,54163,,"SOPOTU NOU",389,"Caminul Cultural Stancilova, nr.94",145,103,94,8,1,102,1,160,57,40,62,3,5070,0
11,"Caras-Severin",54163,118,54163,,"SOPOTU NOU",390,"Caminul Cultural Valea Rosie,nr.9",231,127,122,5,0,127,0,254,127,90,37,3,5070,0
11,"Caras-Severin",54163,118,54163,,"SOPOTU NOU",391,"Scoala cu clasele I-VIII Sopotu Nou, nr.76",0,42,0,42,0,41,1,86,44,23,18,3,5070,1
11,"Caras-Severin",54270,118,54270,,"TEREGOVA",392,"Scoala de Arte si Meserii Teregova, prima sala de la parter",1238,941,890,5,46,927,14,1300,359,357,570,3,5084,0
11,"Caras-Severin",54270,118,54270,,"TEREGOVA",393,"Caminul Cultural Teregova, biblioteca",1243,970,924,8,38,965,5,1367,397,399,566,3,5084,0
11,"Caras-Severin",54270,118,54270,,"TEREGOVA",394,"Oficiul Primariei Rusca",1021,782,745,11,26,777,5,1125,343,383,394,3,5084,0
11,"Caras-Severin",54270,118,54270,,"TEREGOVA",395,"Scoala de Arte si Meserii Teregova, ultima sala de curs de la parter",0,249,0,249,0,247,2,266,17,166,81,3,5084,1
11,"Caras-Severin",54305,118,54305,,"TICVANIU MARE",396,"Casa Culturala Virgil Birou Ticvaniu Mare, sala de sedinte",656,270,263,4,3,264,6,721,451,129,135,3,5087,0
11,"Caras-Severin",54305,118,54305,,"TICVANIU MARE",397,"Scoala generala Cirnecea",267,138,126,12,0,135,3,293,155,51,84,3,5087,0
11,"Caras-Severin",54305,118,54305,,"TICVANIU MARE",398,"Scoala generala Secaseni",238,139,130,9,0,138,1,261,122,31,107,3,5087,0
11,"Caras-Severin",54305,118,54305,,"TICVANIU MARE",399,"Scoala generala Ticvaniu Mic",271,172,159,13,0,169,3,298,126,105,64,3,5087,0
11,"Caras-Severin",54305,118,54305,,"TICVANIU MARE",400,"Casa Culturala Virgil Birou Ticvaniu Mare, biblioteca",0,105,0,105,0,103,2,189,84,41,62,3,5087,1
11,"Caras-Severin",54350,118,54350,,"TARNOVA",401,"Scoala cu clasele I-VIII Tirnova, sala nr.1",1462,824,756,2,66,814,10,1612,788,392,422,3,5081,0
11,"Caras-Severin",54350,118,54350,,"TARNOVA",402,"Scoala cu clasele I-VIII Tirnova, sala nr.2",0,89,0,89,0,88,1,100,11,28,60,3,5081,1
11,"Caras-Severin",54387,118,54387,,"TOPLET",403,"Camin Cultural Toplet,nr.155",1221,680,675,5,0,677,3,1343,663,403,274,3,5092,0
11,"Caras-Severin",54387,118,54387,,"TOPLET",404,"Scoala generala Birza,nr.95",1071,556,549,6,1,546,10,1178,622,307,239,3,5092,0
11,"Caras-Severin",54387,118,54387,,"TOPLET",405,"Gara Toplet, sala de asteptare",0,113,0,113,0,113,0,139,26,60,53,3,5092,1
11,"Caras-Severin",54412,118,54412,,"TURNU RUIENI",406,"Sediul vechii Primarii Turnu Ruieni, sala nr.2",724,326,316,10,0,324,2,730,404,159,165,3,5095,0
11,"Caras-Severin",54412,118,54412,,"TURNU RUIENI",407,"Scoala cu clasele I-VIII Borlova",1106,526,521,5,0,523,3,1110,584,299,224,3,5095,0
11,"Caras-Severin",54412,118,54412,,"TURNU RUIENI",408,"Caminul Cultural Dalci",238,159,150,9,0,157,2,240,81,71,86,3,5095,0
11,"Caras-Severin",54412,118,54412,,"TURNU RUIENI",409,"Scoala cu clasele I-IV  Zervesti",430,342,334,8,0,335,7,435,93,102,233,3,5095,0
11,"Caras-Severin",54412,118,54412,,"TURNU RUIENI",410,"Caminul Cultural Zlagna",271,215,208,7,0,215,0,280,65,101,114,3,5095,0
11,"Caras-Severin",54412,118,54412,,"TURNU RUIENI",411,"Sediul vechii Primarii Turnu Ruieni, nr.43, sala nr.1",0,68,0,68,0,68,0,347,279,29,39,3,5095,1
11,"Caras-Severin",54485,118,54485,,"VALIUG",412,"Scoala cu cls.I-VIII Valiug,nr.57, sala nr.1",680,399,388,4,7,399,0,680,281,238,161,3,5102,0
11,"Caras-Severin",54485,118,54485,,"VALIUG",413,"Scoala cu cls.I-VIII Valiug,nr.57, sala nr.2",0,191,0,191,0,190,1,200,9,63,127,3,5102,1
11,"Caras-Severin",54500,118,54500,,"VARADIA",414,"Gradinita de copii Varadia, sala nr.1",691,358,350,5,3,351,7,700,342,253,98,3,5104,0
11,"Caras-Severin",54500,118,54500,,"VARADIA",415,"Cladirea administratiei locale (fostul CAP Mercina)",482,268,253,7,8,262,6,500,232,135,127,3,5104,0
11,"Caras-Severin",54500,118,54500,,"VARADIA",416,"Gradinita de copii Varadia,nr.190, sala nr.2",0,92,0,92,0,92,0,267,175,50,42,3,5104,1
11,"Caras-Severin",54537,118,54537,,"VERMES",417,"Sala de sport Vermes,nr.182",880,526,519,7,0,526,0,968,442,293,233,3,5107,0
11,"Caras-Severin",54537,118,54537,,"VERMES",418,"Scoala cu cls.I-IV Ersig,nr.1",240,143,132,10,1,143,0,264,121,101,42,3,5107,0
11,"Caras-Severin",54537,118,54537,,"VERMES",419,"Scoala cu cls.I-IV Izgar, nr.1",273,161,152,9,0,158,3,301,140,94,64,3,5107,0
11,"Caras-Severin",54537,118,54537,,"VERMES",420,"Gradinita PN Vermes, nr.152",0,79,0,79,0,78,1,91,12,52,26,3,5107,1
11,"Caras-Severin",54573,118,54573,,"VRANI",421,"Caminul Cultural Vrani, sala din partea stanga",733,445,409,1,35,437,8,780,335,233,204,3,5111,0
11,"Caras-Severin",54573,118,54573,,"VRANI",422,"Scoala cu clasele I-IV Ciortea",136,102,89,10,3,102,0,150,48,67,35,3,5111,0
11,"Caras-Severin",54573,118,54573,,"VRANI",423,"Caminul Cultural Vrani, sala din partea dreapta",0,69,0,69,0,65,4,100,31,43,22,3,5111,1
11,"Caras-Severin",54617,118,54617,,"ZAVOI",424,"Caminul Cultural Zavoi, sala 2",1478,844,838,6,0,837,7,1478,634,338,499,3,5115,0
11,"Caras-Severin",54617,118,54617,,"ZAVOI",425,"Caminul Cultural Magura",412,297,290,7,0,297,0,412,115,92,205,3,5115,0
11,"Caras-Severin",54617,118,54617,,"ZAVOI",426,"Caminul Cultural Maru",892,594,577,17,0,587,7,892,298,199,388,3,5115,0
11,"Caras-Severin",54617,118,54617,,"ZAVOI",427,"Casa Primariei Poiana Marului",54,54,44,10,0,47,7,54,0,19,28,3,5115,0
11,"Caras-Severin",54617,118,54617,,"ZAVOI",428,"Caminul Cultural Voislova",484,358,348,10,0,357,1,484,126,103,254,3,5115,0
11,"Caras-Severin",54617,118,54617,,"ZAVOI",429,"Caminul Cultural Zavoi, nr.38, sala 1",0,93,0,93,0,92,1,526,433,39,53,3,5115,1
11,"Caras-Severin",54699,118,54699,,"ZORLENTU MARE",430,"Scoala cu clasele I-VIII Zorlentu Mare,nr.369",659,369,361,8,0,358,11,692,323,278,80,3,5123,0
11,"Caras-Severin",54699,118,54699,,"ZORLENTU MARE",431,"Caminul Cultural Zorlencior, sala intruniri",100,87,79,8,0,87,0,120,33,70,17,3,5123,0
11,"Caras-Severin",54699,118,54699,,"ZORLENTU MARE",432,"Scoala cu clasele I-VIII Zorlentu Mare,nr.369, sala profesorala, parter",0,217,0,217,0,215,2,259,42,149,66,3,5123,1
12,"Calarasi",92569,519,92569,,"MUNICIPIUL CALARASI",1,"GIMNAZIUL CAROL I (fosta scoala generala nr. 1), str. Bucuresti, nr. 159",1496,882,860,22,0,872,10,1500,618,378,494,1,5127,0
12,"Calarasi",92569,519,92569,,"MUNICIPIUL CALARASI",2,"GIMNAZIUL CAROL I (fosta scoala generala nr. 1), str. Bucuresti, nr. 159",750,446,437,9,0,438,8,902,456,204,234,1,5127,0
12,"Calarasi",92569,519,92569,,"MUNICIPIUL CALARASI",3,"GIMNAZIUL CAROL I (fosta scoala generala nr. 4 - actualul corp E. Topescu), str. Bucuresti, nr. 72",1174,638,623,14,1,632,6,1300,662,295,337,1,5127,0
12,"Calarasi",92569,519,92569,,"MUNICIPIUL CALARASI",4,"GIMNAZIUL CAROL I (fosta scoala generala nr. 4 - actualul corp E. Topescu), str. Bucuresti, nr. 72",924,555,533,22,0,550,5,1100,545,268,282,1,5127,0
12,"Calarasi",92569,519,92569,,"MUNICIPIUL CALARASI",5,"COLEGIUL NATIONAL BARBU STIRBEI, str. Eroilor, nr. 36",1272,734,699,14,21,728,6,1400,666,396,332,1,5127,0
12,"Calarasi",92569,519,92569,,"MUNICIPIUL CALARASI",6,"COLEGIUL NATIONAL BARBU STIRBEI, str. Eroilor, nr. 36",1133,557,549,8,0,552,5,1199,642,281,271,1,5127,0
12,"Calarasi",92569,519,92569,,"MUNICIPIUL CALARASI",7,"GRADINITA CU PROGRAM NORMAL NR.5 (langa restaurantul ""Clasic"") Str. Grivita Nr.98",1413,721,704,17,0,711,10,1496,775,321,390,1,5127,0
12,"Calarasi",92569,519,92569,,"MUNICIPIUL CALARASI",8,"GRADINITA CU PROGRAM NORMAL NR. 4 CASUTA CU POVESTI (anexa fostei scoli generale nr. 5), str. Stadionului, nr.27",1539,790,776,14,0,776,14,1600,810,321,455,1,5127,0
12,"Calarasi",92569,519,92569,,"MUNICIPIUL CALARASI",9,"GRADINITA CU PROGRAM PRELUNGIT (Micro 6) Aleea Centralei",1618,860,838,22,0,854,6,1700,840,417,437,1,5127,0
12,"Calarasi",92569,519,92569,,"MUNICIPIUL CALARASI",10,"GRUPUL SCOLAR AGRICOL SANDU ALDEA, str. Prel. Bucuresti, nr. 10",1290,716,693,23,0,703,13,999,283,344,359,1,5127,0
12,"Calarasi",92569,519,92569,,"MUNICIPIUL CALARASI",11,"GRUPUL SCOLAR AGRICOL SANDU ALDEA, str. Prel. Bucuresti, nr. 10",1218,647,637,10,0,641,6,1300,653,337,304,1,5127,0
12,"Calarasi",92569,519,92569,,"MUNICIPIUL CALARASI",12,"GRUPUL SCOLAR AGRICOL SANDU ALDEA, str. Prel. Bucuresti, nr. 10",1042,475,453,22,0,464,11,1100,625,252,212,1,5127,0
12,"Calarasi",92569,519,92569,,"MUNICIPIUL CALARASI",13,"LICEUL TEORETIC MIHAI EMINESCU, str. Prel. Bucuresti, nr. 14",1113,630,616,14,0,621,9,1200,570,314,307,1,5127,0
12,"Calarasi",92569,519,92569,,"MUNICIPIUL CALARASI",14,"LICEUL TEORETIC MIHAI EMINESCU, str. Prel. Bucuresti, nr. 14",1525,791,781,10,0,784,7,1600,809,438,346,1,5127,0
12,"Calarasi",92569,519,92569,,"MUNICIPIUL CALARASI",15,"LICEUL TEORETIC MIHAI EMINESCU, str. Prel. Bucuresti, nr. 14",1288,697,665,32,0,694,3,1400,703,349,345,1,5127,0
12,"Calarasi",92569,519,92569,,"MUNICIPIUL CALARASI",16,"SCOALA CU CLASELE I-VIII MIHAI VITEAZU (fosta scoala generala nr. 10), str. Prel. Bucuresti, nr. 12",1291,606,592,14,0,599,7,1400,794,321,278,1,5127,0
12,"Calarasi",92569,519,92569,,"MUNICIPIUL CALARASI",17,"SCOALA CU CLASELE I-VIII MIHAI VITEAZU (fosta scoala generala nr. 10), str. Prel. Bucuresti, nr. 12",1350,669,652,17,0,666,3,1400,731,369,297,1,5127,0
12,"Calarasi",92569,519,92569,,"MUNICIPIUL CALARASI",18,"SCOALA CU CLASELE I-VIII MIHAI VITEAZU (fosta scoala generala nr. 10), str. Prel. Bucuresti, nr. 12",1487,782,775,7,0,771,11,1500,718,406,365,1,5127,0
12,"Calarasi",92569,519,92569,,"MUNICIPIUL CALARASI",19,"SCOALA CU CLASELE I-VIII MIHAI VITEAZU (fosta scoala generala nr. 10), str. Prel. Bucuresti, nr. 12",872,457,443,14,0,452,5,1000,543,236,216,1,5127,0
12,"Calarasi",92569,519,92569,,"MUNICIPIUL CALARASI",20,"SALA DE SPORT DE LA SCOALA CU CLASELE I-VIII NICOLAE TITULESCU  (fosta scoala gen.nr. 5) b-dul Nicolae Titulescu, nr.3",873,484,457,27,0,481,3,1000,516,270,211,1,5127,0
12,"Calarasi",92569,519,92569,,"MUNICIPIUL CALARASI",21,"SALA DE SPORT DE LA SCOALA CU CLASELE I-VIII NICOLAE TITULESCU  (fosta scoala gen.nr. 5) b-dul Nicolae Titulescu, nr.3",1634,772,755,17,0,761,11,1700,928,387,374,1,5127,0
12,"Calarasi",92569,519,92569,,"MUNICIPIUL CALARASI",22,"GRADINITA CU PROGRAM PRELUNGIT NR. 1, str. Dunarii, nr. 1 (langa  fosta Parcare cu plata)",1271,678,660,18,0,676,2,1300,622,342,334,1,5127,0
12,"Calarasi",92569,519,92569,,"MUNICIPIUL CALARASI",23,"GRADINITA CU PROGRAM PRELUNGIT NR. 2 ZONA NORD, str. Baraganului",1905,879,866,13,0,874,5,2000,1121,457,417,1,5127,0
12,"Calarasi",92569,519,92569,,"MUNICIPIUL CALARASI",24,"GRUP SCOLAR DANUBIUS, str. Stirbei Voda, nr. 1",1741,735,720,15,0,721,14,1800,1065,433,288,1,5127,0
12,"Calarasi",92569,519,92569,,"MUNICIPIUL CALARASI",25,"GRUP SCOLAR DANUBIUS, str. Stirbei Voda, nr. 1",1714,799,784,15,0,790,9,1800,1001,444,346,1,5127,0
12,"Calarasi",92569,519,92569,,"MUNICIPIUL CALARASI",26,"GRUP SCOLAR DANUBIUS, str. Stirbei Voda, nr. 1",1776,730,710,20,0,720,10,1800,1070,449,271,1,5127,0
12,"Calarasi",92569,519,92569,,"MUNICIPIUL CALARASI",27,"CRESA SAPTAMANALA CU 100 LOCURI, str. Aleea Musetelului",1458,545,536,9,0,536,9,1500,955,320,216,1,5127,0
12,"Calarasi",92569,519,92569,,"MUNICIPIUL CALARASI",28,"CRESA SAPTAMANALA CU 100 LOCURI, str. Aleea Musetelului",859,375,365,10,0,369,6,989,614,219,150,1,5127,0
12,"Calarasi",92569,519,92569,,"MUNICIPIUL CALARASI",29,"SCOALA CU CLASELE I-VIII TUDOR VLADIMIRESCU (fosta scoala generala nr. 11), str. Macului",1366,727,713,14,0,723,4,1370,643,353,370,1,5127,0
12,"Calarasi",92569,519,92569,,"MUNICIPIUL CALARASI",30,"SCOALA CU CLASELE I-VIII TUDOR VLADIMIRESCU (fosta scoala generala nr. 11), str. Macului",1275,674,659,15,0,670,4,1297,623,328,342,1,5127,0
12,"Calarasi",92569,519,92569,,"MUNICIPIUL CALARASI",31,"SCOALA CU CLASELE I-VIII TUDOR VLADIMIRESCU (fosta scoala generala nr. 11), str. Macului",1446,749,736,13,0,741,8,1500,751,402,339,1,5127,0
12,"Calarasi",92569,519,92569,,"MUNICIPIUL CALARASI",32,"SCOALA CU CLASELE I-VIII TUDOR VLADIMIRESCU (fosta scoala generala nr. 11), str. Macului",1452,758,743,14,1,751,7,1500,742,407,344,1,5127,0
12,"Calarasi",92569,519,92569,,"MUNICIPIUL CALARASI",33,"SALA DE SPORT A SCOALII GENERALE NR.12 (in constructie) str. Prel. Bucuresti, nr. 133",1375,703,693,10,0,695,8,1405,702,404,291,1,5127,0
12,"Calarasi",92569,519,92569,,"MUNICIPIUL CALARASI",34,"SALA DE SPORT A SCOALII GENERALE NR.12 (in constructie) str. Prel. Bucuresti, nr. 133",1211,592,580,12,0,581,11,1298,706,311,270,1,5127,0
12,"Calarasi",92569,519,92569,,"MUNICIPIUL CALARASI",35,"SCOALA CU CLASELE I-VIII MIRCEA VODA (fosta scoala generala nr. 8), str.Prel. Bucuresti, nr.189",1202,616,599,17,0,611,5,1300,684,305,306,1,5127,0
12,"Calarasi",92569,519,92569,,"MUNICIPIUL CALARASI",36,"SCOALA CU CLASELE I-VIII MIRCEA VODA (fosta scoala generala nr. 8), str.Prel. Bucuresti, nr.189",993,397,387,10,0,392,5,1100,703,217,175,1,5127,0
12,"Calarasi",92569,519,92569,,"MUNICIPIUL CALARASI",37,"SCOALA CU CLASELE I-VIII MIRCEA VODA (fosta scoala generala nr. 8), str.Prel. Bucuresti, nr.189",1618,813,801,12,0,805,8,1695,882,431,374,1,5127,0
12,"Calarasi",92569,519,92569,,"MUNICIPIUL CALARASI",38,"SCOALA CU CLASELE I-VIII MIRCEA VODA (fosta scoala generala nr. 8), str.Prel. Bucuresti, nr.189",929,433,420,13,0,426,7,1100,667,222,204,1,5127,0
12,"Calarasi",92569,519,92569,,"MUNICIPIUL CALARASI",39,"SCOALA CU CLASELE I-VIII MIRCEA VODA (fosta scoala generala nr. 8), Anexa din Str. Crangului, nr.20",1691,851,829,22,0,836,15,1700,849,443,393,1,5127,0
12,"Calarasi",92569,519,92569,,"MUNICIPIUL CALARASI",40,"SCOALA CU CLASELE I-VIII MIRCEA VODA (fosta scoala generala nr. 8), Anexa din Str. Crangului, nr.20",1158,562,549,13,0,555,7,1200,638,300,255,1,5127,0
12,"Calarasi",92569,519,92569,,"MUNICIPIUL CALARASI",41,"GRADINITA CU PROGRAM PRELUNGIT NR. 5, str. Bucuresti, nr. 227",1156,671,658,13,0,662,9,1200,529,384,278,1,5127,0
12,"Calarasi",92569,519,92569,,"MUNICIPIUL CALARASI",42,"COLEGIUL ECONOMIC SEDIUL B (fosta scoala generala nr.2), str. Grivita, nr. 188",1198,642,634,8,0,632,10,1200,558,357,275,1,5127,0
12,"Calarasi",92569,519,92569,,"MUNICIPIUL CALARASI",43,"GRUPUL SCOLAR DE TRANSPORTURI AUTO, str. Sloboziei, nr. 2",1203,618,604,14,0,604,14,1300,682,354,250,1,5127,0
12,"Calarasi",92569,519,92569,,"MUNICIPIUL CALARASI",44,"SCOALA CU CLASELE I-VIII CONSTANTIN BRANCOVEANU (fosta scoala generala nr.9), str. Grivita, nr.343",1190,672,656,16,0,660,12,1200,528,377,283,1,5127,0
12,"Calarasi",92569,519,92569,,"MUNICIPIUL CALARASI",45,"SCOALA CU CLASELE I-VIII CONSTANTIN BRANCOVEANU (fosta scoala generala nr.9), str. Grivita, nr.343",1134,580,570,10,0,571,9,1200,620,292,279,1,5127,0
12,"Calarasi",92569,519,92569,,"MUNICIPIUL CALARASI",46,"SCOALA CU CLASELE I-VIII CONSTANTIN BRANCOVEANU (fosta scoala generala nr.9), str. Grivita, nr.343",1191,701,682,19,0,693,8,1300,599,374,319,1,5127,0
12,"Calarasi",92569,519,92569,,"MUNICIPIUL CALARASI",47,"SCOALA CU CLASELE I-VIII POMPEI SAMARIAN (fosta scoala generala nr. 6), str. Prel. Independentei, nr. 20",1075,612,600,12,0,598,14,1100,488,324,274,1,5127,0
12,"Calarasi",92569,519,92569,,"MUNICIPIUL CALARASI",48,"SCOALA CU CLASELE I-VIII POMPEI SAMARIAN (fosta scoala generala nr. 6), str. Prel. Independentei, nr. 20",1141,631,616,15,0,616,15,1200,569,341,275,1,5127,0
12,"Calarasi",92569,519,92569,,"MUNICIPIUL CALARASI",49,"C.A.L.I.F., str. Caisilor, nr. 2",1347,511,503,8,0,489,22,1400,889,238,251,1,5127,0
12,"Calarasi",92569,519,92569,,"MUNICIPIUL CALARASI",50,"ADMINISTRATIA PIETELOR - OBORUL DUMINICAL, str. Prel. Dobrogei",648,370,354,16,0,342,28,700,330,205,137,1,5127,0
12,"Calarasi",92569,519,92569,,"MUNICIPIUL CALARASI",51,"COLEGIUL ECONOMIC, str. 1 Decembrie 1918, nr. 98",1784,1084,1062,22,0,1076,8,1800,716,497,579,1,5127,0
12,"Calarasi",92569,519,92569,,"MUNICIPIUL CALARASI",52,"PIATA BIG CALARASI, str.Prel. Bucuresti, nr.2",0,689,0,689,0,683,6,2500,1811,395,288,1,5127,1
12,"Calarasi",100610,519,100610,,"MUNICIPIUL OLTENITA",53,"SCOALA CU CLASELE I-VIII ""AL.D.GHICA""  NR. 5, str. M. Eminescu, nr. 17",1948,976,969,7,0,953,23,2000,1024,386,567,1,5129,0
12,"Calarasi",100610,519,100610,,"MUNICIPIUL OLTENITA",54,"CANTINA DE AJUTOR SOCIAL, str. Traian, nr. 16",1363,739,731,8,0,733,6,1400,661,244,489,1,5129,0
12,"Calarasi",100610,519,100610,,"MUNICIPIUL OLTENITA",55,"SCOALA CU CLASELE I-VIII NR. 2 - LOCAL NR. 1, str. Argesului, nr. 10",1358,687,679,8,0,683,4,1400,713,249,434,1,5129,0
12,"Calarasi",100610,519,100610,,"MUNICIPIUL OLTENITA",56,"SCOALA CU CLASELE I-VIII NR. 2 - LOCAL NR. 2, str. Argesului, nr. 12",1673,885,876,9,0,879,6,1700,815,319,560,1,5129,0
12,"Calarasi",100610,519,100610,,"MUNICIPIUL OLTENITA",57,"PRIMARIA MUNICIPIULUI OLTENITA, b-dul Republicii, nr. 40 (intrarea dinspre b-dul Republiciii)",1959,1015,1005,10,0,1007,8,2000,985,339,668,1,5129,0
12,"Calarasi",100610,519,100610,,"MUNICIPIUL OLTENITA",58,"PRIMARIA MUNICIPIULUI OLTENITA, b-dul Republicii, nr. 40 (intrarea dinspre b-dul Tineretului)",1934,1042,1037,5,0,1035,7,2000,958,379,656,1,5129,0
12,"Calarasi",100610,519,100610,,"MUNICIPIUL OLTENITA",59,"SCOALA CU CLASELE I-VIII ""SPIRU HARET""  NR.1, str. Mihai Eminescu, nr. 23",1960,907,878,29,0,898,9,2000,1093,368,530,1,5129,0
12,"Calarasi",100610,519,100610,,"MUNICIPIUL OLTENITA",60,"LICEUL ""NEAGOE BASARAB"", b-dul Tineretului, nr. 157",1947,1025,1014,11,0,1016,9,2100,1075,365,651,1,5129,0
12,"Calarasi",100610,519,100610,,"MUNICIPIUL OLTENITA",61,"SCOALA CU CLASELE I-VIII NR. 6,  b-dul Marasesti, nr. 21 C",2002,877,855,22,0,868,9,2100,1223,300,568,1,5129,0
12,"Calarasi",100610,519,100610,,"MUNICIPIUL OLTENITA",62,"GRADINITA NR. 4, b-dul Marasesti, nr. 28",1928,858,849,9,0,853,5,2000,1142,330,523,1,5129,0
12,"Calarasi",100610,519,100610,,"MUNICIPIUL OLTENITA",63,"SCOALA CU CLASELE I-VIII NR. 2 - Local nr. 3,  str. Cuza Voda, nr. 36",1902,833,818,15,0,820,13,2000,1167,319,501,1,5129,0
12,"Calarasi",100610,519,100610,,"MUNICIPIUL OLTENITA",64,"SCOALA CU CLASELE I-VIII ""CONSTANTIN DECULESCU"" (fosta scoala cu clasele I-VIII nr.4), str. Razboieni, nr. 9",1965,699,686,13,0,676,23,2000,1301,255,421,1,5129,0
12,"Calarasi",100610,519,100610,,"MUNICIPIUL OLTENITA",65,"SCOALA CU CLASELE I-VIII ""MIRCEA ELIADE"" (fosta scoala nr. 3), b-dul 22 Decembrie, nr. 76",1384,766,751,15,0,755,11,1400,634,248,507,1,5129,0
12,"Calarasi",100610,519,100610,,"MUNICIPIUL OLTENITA",66,"GRADINITA NR. 2 (fostul local vechi al  Scolii nr. 3) , str. Spiru Haret, nr. 1",1741,871,861,10,0,859,12,1800,929,278,581,1,5129,0
12,"Calarasi",100610,519,100610,,"MUNICIPIUL OLTENITA",67,"PRIMARIA MUNICIPIULUI OLTENITA, b-dul Republicii, nr.40 (intrarea 2), camera 16, parter",0,370,0,370,0,366,4,707,337,165,201,1,5129,1
12,"Calarasi",101458,519,101458,,"ORAS BUDESTI",68,"GRUPUL SCOLAR BUDESTI",1881,1130,1109,21,0,1091,39,2000,870,628,463,1,5131,0
12,"Calarasi",101458,519,101458,,"ORAS BUDESTI",69,"GRUPUL SCOLAR BUDESTI",1936,1127,1115,12,0,1079,48,2100,973,656,423,1,5131,0
12,"Calarasi",101458,519,101458,,"ORAS BUDESTI",70,"SCOALA GENERALA  APROZI",840,499,479,20,0,486,13,900,401,223,263,1,5131,0
12,"Calarasi",101458,519,101458,,"ORAS BUDESTI",71,"SCOALA GENERALA BUCIUMENI",515,400,391,9,0,385,15,600,200,222,163,1,5131,0
12,"Calarasi",101458,519,101458,,"ORAS BUDESTI",72,"SCOALA GENERALA GRUIU",671,420,405,15,0,408,12,700,280,204,204,1,5131,0
12,"Calarasi",101458,519,101458,,"ORAS BUDESTI",73,"GRADINITA CU PROGRAM NORMAL BUDESTI, str. Garii, nr.14",0,344,0,344,0,341,3,1000,656,183,158,1,5131,1
12,"Calarasi",103032,519,103032,,"ORAS FUNDULEA",74,"I.N.C.D.A FUNDULEA, str. Nicolae Titulescu",1003,720,688,32,0,711,9,1083,363,365,346,1,5136,0
12,"Calarasi",103032,519,103032,,"ORAS FUNDULEA",75,"GRADINITA FUNDULEA, b-dul 22 Decembrie",1358,1015,934,81,0,981,34,1500,485,481,500,1,5136,0
12,"Calarasi",103032,519,103032,,"ORAS FUNDULEA",76,"SCOALA GENERALA FUNDULEA, str. Nichita Stanescu",1167,799,775,24,0,786,13,1300,501,360,426,1,5136,0
12,"Calarasi",103032,519,103032,,"ORAS FUNDULEA",77,"SCOALA CU CLASELE I-IV NR.4  CRANGU",1263,923,905,18,0,902,21,1372,449,516,386,1,5136,0
12,"Calarasi",103032,519,103032,,"ORAS FUNDULEA",78,"SCOALA CU CLASELE I-VIII NR.3  GOSTILELE",519,343,334,9,0,329,14,600,257,88,241,1,5136,0
12,"Calarasi",103032,519,103032,,"ORAS FUNDULEA",79,"GRADINITA FUNDULEA,sala 2, b-dul 22 Decembrie, nr. 127",0,835,0,835,0,819,16,1500,665,439,380,1,5136,1
12,"Calarasi",93888,519,93888,,"ORAS LEHLIU GARA",80,"SALA DE SEDINTE A PRIMARIEI LEHLIU - GARA",1703,984,975,7,2,974,10,1900,916,541,433,1,5140,0
12,"Calarasi",93888,519,93888,,"ORAS LEHLIU GARA",81,"CASA DE CULTURA LEHLIU-GARA",1600,944,939,5,0,938,6,1800,856,517,421,1,5140,0
12,"Calarasi",93888,519,93888,,"ORAS LEHLIU GARA",82,"SCOALA GENERALA CU CLASELE I-VIII RAZVANI",640,369,354,14,1,363,6,700,331,198,165,1,5140,0
12,"Calarasi",93888,519,93888,,"ORAS LEHLIU GARA",83,"SCOALA GENERALA CU CLASELE I-IV RAZVANI",1198,674,650,24,0,650,24,1291,617,286,364,1,5140,0
12,"Calarasi",93888,519,93888,,"ORAS LEHLIU GARA",84,"SCOALA GENERALA CU CLASELE I-IV BUZOIENI",409,273,266,7,0,264,9,495,222,101,163,1,5140,0
12,"Calarasi",93888,519,93888,,"ORAS LEHLIU GARA",85,"CASA DE CULTURA LEHLIU-GARA, b-dul Garii, nr. 19",0,268,0,268,0,268,0,705,437,161,107,1,5140,1
12,"Calarasi",94125,519,94125,,"ALEXANDRU ODOBESCU",86,"SCOALA GENERALA SAT NICOLAE BALCESCU",1236,803,795,8,0,786,17,1394,591,278,508,3,5145,0
12,"Calarasi",94125,519,94125,,"ALEXANDRU ODOBESCU",87,"SCOALA GENERALA SAT ALEXANDRU ODOBESCU",790,512,506,6,0,503,9,907,395,176,327,3,5145,0
12,"Calarasi",94125,519,94125,,"ALEXANDRU ODOBESCU",88,"SCOALA GENERALA SAT GALATUI",280,206,189,17,0,196,10,299,93,86,110,3,5145,0
12,"Calarasi",94125,519,94125,,"ALEXANDRU ODOBESCU",89,"GRADINITA SAT ALEXANDRU ODOBESCU",0,219,0,219,0,217,2,502,283,107,110,3,5145,1
12,"Calarasi",101083,519,101083,,"BELCIUGATELE",90,"SCOALA GENERALA BELCIUGATELE",1187,688,669,18,1,674,14,1300,612,369,305,3,5149,0
12,"Calarasi",101083,519,101083,,"BELCIUGATELE",91,"SCOALA GENERALA MARIUTA",453,216,216,0,0,210,6,490,274,120,90,3,5149,0
12,"Calarasi",101083,519,101083,,"BELCIUGATELE",92,"SCOALA GENERALA BELCIUGATELE, str. Profesor Vasile Voinescu, nr. 322",0,383,0,383,0,378,5,700,317,243,135,3,5149,1
12,"Calarasi",92961,519,92961,,"BORCEA",93,"SCOALA GENERALA NR. 3 PIETROIU",950,432,307,125,0,419,13,1000,568,207,212,3,5155,0
12,"Calarasi",92961,519,92961,,"BORCEA",94,"GRADINITA NR. 3 PIETROIU",1237,471,375,96,0,467,4,1400,929,210,257,3,5155,0
12,"Calarasi",92961,519,92961,,"BORCEA",95,"CLUBUL ELEVILOR (sala A) BORCEA",1456,757,653,104,0,749,8,1600,843,364,385,3,5155,0
12,"Calarasi",92961,519,92961,,"BORCEA",96,"SCOALA GENERALA NR.1 BORCEA",1687,783,662,121,0,773,10,1900,1117,348,425,3,5155,0
12,"Calarasi",92961,519,92961,,"BORCEA",97,"SCOALA GENERALA NR. 2 BORCEA",1748,778,640,138,0,773,5,1900,1122,371,402,3,5155,0
12,"Calarasi",92961,519,92961,,"BORCEA",98,"CLUBUL ELEVILOR (sala B) BORCEA",0,139,0,139,0,138,1,700,561,62,76,3,5155,1
12,"Calarasi",101724,519,101724,,"CASCIOARELE",99,"CAMINUL CULTURAL",1718,931,928,3,0,923,8,1900,969,461,462,3,5157,0
12,"Calarasi",101724,519,101724,,"CASCIOARELE",100,"SALA DE SEDINTE A CONSILIULUI LOCAL",0,83,0,83,0,83,0,300,217,37,46,3,5157,1
12,"Calarasi",101804,519,101804,,"CHIRNOGI",101,"SCOALA CU CLASELE I-VIII NR. 1 CHIRNOGI",1618,668,610,58,0,653,15,1800,1132,385,268,3,5159,0
12,"Calarasi",101804,519,101804,,"CHIRNOGI",102,"SCOALA CU CLASELE I-VIII NR. 2 CHIRNOGI",1666,746,704,42,0,736,10,1666,920,389,347,3,5159,0
12,"Calarasi",101804,519,101804,,"CHIRNOGI",103,"SCOALA CU CLASELE I-VIII NR. 2 CHIRNOGI",1582,738,686,52,0,726,12,1700,962,380,346,3,5159,0
12,"Calarasi",101804,519,101804,,"CHIRNOGI",104,"SCOALA CU CLASELE I-VIII NR. 3 CHIRNOGI",1534,582,566,16,0,568,14,1700,1118,254,314,3,5159,0
12,"Calarasi",101804,519,101804,,"CHIRNOGI",105,"CAMINUL CULTURAL CHIRNOGI, str. Caminului, nr.4",0,101,0,101,0,100,1,300,199,61,39,3,5159,1
12,"Calarasi",101822,519,101822,,"CHISELET",106,"SCOALA GENERALA NR. 1 CHISELET",955,446,429,17,0,424,22,1100,654,173,251,3,5161,0
12,"Calarasi",101822,519,101822,,"CHISELET",107,"SCOALA GENERALA NR. 1 CHISELET",1015,451,441,9,1,436,15,1100,649,158,278,3,5161,0
12,"Calarasi",101822,519,101822,,"CHISELET",108,"SCOALA GENERALA  NR. 2 SURLARI",814,387,350,37,0,375,12,900,513,137,238,3,5161,0
12,"Calarasi",101822,519,101822,,"CHISELET",109,"SALA DE SPORT A SCOALII GENERALE NR.1 CHISELET",0,150,0,150,0,148,2,400,250,58,90,3,5161,1
12,"Calarasi",93085,519,93085,,"CIOCANESTI",110,"SCOALA GENERALA SMARDAN",845,479,437,42,0,470,9,900,421,159,311,3,5163,0
12,"Calarasi",93085,519,93085,,"CIOCANESTI",111,"SCOALA GENERALA MARGINENI",821,451,402,44,5,429,22,900,449,149,280,3,5163,0
12,"Calarasi",93085,519,93085,,"CIOCANESTI",112,"GRADINITA DE COPII NR. 1 SARBI",1116,785,689,77,19,770,15,1180,395,316,454,3,5163,0
12,"Calarasi",93085,519,93085,,"CIOCANESTI",113,"SCOALA GENERALA ANDOLINA",889,624,507,54,63,610,14,973,349,300,310,3,5163,0
12,"Calarasi",93085,519,93085,,"CIOCANESTI",114,"GRADINITA DE COPII NR. 1 SARBI",0,345,0,345,0,342,3,500,155,145,197,3,5163,1
12,"Calarasi",180055,519,180055,,"CRIVAT",115,"SCOALA NICOLAE PETRESCU (fosta scoala generala cu clasele I-VIII nr. 1) CRIVAT",887,477,471,6,0,473,4,1000,523,208,265,3,5165,0
12,"Calarasi",180055,519,180055,,"CRIVAT",116,"SCOALA NICOLAE PETRESCU (fosta scoala generala cu clasele I-VIII nr. 1) CRIVAT",1007,514,511,3,0,504,10,1100,586,237,267,3,5165,0
12,"Calarasi",180055,519,180055,,"CRIVAT",117,"SCOALA NICOLAE PETRESCU (fosta scoala generala cu clasele I-VIII nr. 1) CRIVAT",0,125,0,125,0,124,1,300,175,52,72,3,5165,1
12,"Calarasi",102419,519,102419,,"CURCANI",118,"SCOALA GENERALA NR. 1, CORPUL A, CURCANI",1397,573,567,6,0,559,14,1500,927,225,334,3,5167,0
12,"Calarasi",102419,519,102419,,"CURCANI",119,"SCOALA GENERALA NR. 1 CORPUL B,  CURCANI",1370,564,555,9,0,550,14,1500,936,231,319,3,5167,0
12,"Calarasi",102419,519,102419,,"CURCANI",120,"SCOALA GENERALA NR. 1 CORPUL C, CURCANI",1462,629,627,2,0,620,9,1600,971,224,396,3,5167,0
12,"Calarasi",102419,519,102419,,"CURCANI",121,"SCOALA GENERALA NR. 1 CURCANI, str. Penes Curcanul",0,262,0,262,0,260,2,500,238,135,125,3,5167,1
12,"Calarasi",93281,519,93281,,"CUZA VODA",122,"SCOALA CEACU",1102,618,608,10,0,608,10,1201,583,260,348,3,5170,0
12,"Calarasi",93281,519,93281,,"CUZA VODA",123,"SCOALA VECHE CUZA VODA",1706,954,923,31,0,940,14,1900,946,356,584,3,5170,0
12,"Calarasi",93281,519,93281,,"CUZA VODA",124,"SCOALA CALARASII VECHI",547,365,346,10,9,361,4,600,235,97,264,3,5170,0
12,"Calarasi",93281,519,93281,,"CUZA VODA",125,"GRADINITA CEACU",0,337,0,337,0,333,4,600,263,185,148,3,5170,1
12,"Calarasi",93325,519,93325,,"DICHISENI",126,"SCOALA GENERALA CU CLASELE I-VIII, DICHISENI",831,431,420,6,5,425,6,900,469,193,232,3,5174,0
12,"Calarasi",93325,519,93325,,"DICHISENI",127,"SCOALA GENERALA CU CLASELE I-IV COSLOGENI",666,394,384,8,2,390,4,723,329,205,185,3,5174,0
12,"Calarasi",93325,519,93325,,"DICHISENI",128,"SCOALA GENERALA CU CLASELE I-VIII, DICHISENI",0,83,0,83,0,82,1,500,417,38,44,3,5174,1
12,"Calarasi",93370,519,93370,,"DOR MARUNT",129,"SCOALA DOR MARUNT-GARA",1700,843,831,12,0,823,20,1900,1057,353,470,3,5179,0
12,"Calarasi",93370,519,93370,,"DOR MARUNT",130,"SCOALA DOR MARUNT SAT",1417,691,680,11,0,679,12,1600,909,366,313,3,5179,0
12,"Calarasi",93370,519,93370,,"DOR MARUNT",131,"SCOALA CU CLASELE I-IV BARZENI",253,191,182,9,0,189,2,300,109,104,85,3,5179,0
12,"Calarasi",93370,519,93370,,"DOR MARUNT",132,"SCOALA INFRATIREA",262,135,128,7,0,132,3,300,165,73,59,3,5179,0
12,"Calarasi",93370,519,93370,,"DOR MARUNT",133,"SCOALA PELINU",230,70,56,14,0,67,3,300,230,26,41,3,5179,0
12,"Calarasi",93370,519,93370,,"DOR MARUNT",134,"SCOALA NR. 3 DALGA GARA",546,357,349,8,0,345,11,600,244,119,226,3,5179,0
12,"Calarasi",93370,519,93370,,"DOR MARUNT",135,"SCOALA DALGA",854,537,527,10,0,533,4,900,363,309,224,3,5179,0
12,"Calarasi",93370,519,93370,,"DOR MARUNT",136,"SCOALA VECHE DOR MARUNT SAT",0,304,0,304,0,300,4,1000,696,147,153,3,5179,1
12,"Calarasi",93441,519,93441,,"DOROBANTU",137,"SCOALA GENERALA DOROBANTU",1312,675,668,7,0,659,16,1400,725,278,381,3,5186,0
12,"Calarasi",93441,519,93441,,"DOROBANTU",138,"SCOALA GENERALA VARASTI",857,421,411,10,0,412,9,902,481,173,239,3,5186,0
12,"Calarasi",93441,519,93441,,"DOROBANTU",139,"SCOALA GENERALA BOSNEAGU",358,216,191,25,0,210,6,394,178,119,91,3,5186,0
12,"Calarasi",93441,519,93441,,"DOROBANTU",140,"SCOALA GENERALA DOROBANTU",0,192,0,192,0,190,2,500,308,86,104,3,5186,1
12,"Calarasi",93487,519,93487,,"DRAGALINA",141,"SCOALA GENERALA CLASELE I-VIII CORP A DRAGALINA",1548,664,610,54,0,655,9,1700,1036,311,344,3,5190,0
12,"Calarasi",93487,519,93487,,"DRAGALINA",142,"SCOALA GENERALA CLASELE I-VIII CORP B DRAGALINA",1205,526,454,71,1,519,7,1300,774,206,313,3,5190,0
12,"Calarasi",93487,519,93487,,"DRAGALINA",143,"SCOALA GENERALA CLASELE I-VIII CORP INTERNAT DRAGALINA",1280,686,596,90,0,667,19,1400,714,350,317,3,5190,0
12,"Calarasi",93487,519,93487,,"DRAGALINA",144,"GRADINITA DRAGALINA",917,494,439,55,0,486,8,1000,506,229,257,3,5190,0
12,"Calarasi",93487,519,93487,,"DRAGALINA",145,"SCOALA GENERALA CLASELE I-VIII DRAJNA",1055,548,507,40,1,542,6,1200,652,300,242,3,5190,0
12,"Calarasi",93487,519,93487,,"DRAGALINA",146,"SCOALA GENERALA CLASELE I-VIII C. BRANCOVEANU",812,396,378,18,0,394,2,900,504,178,216,3,5190,0
12,"Calarasi",93487,519,93487,,"DRAGALINA",147,"PRIMARIA DRAGALINA, str. Dispensarului, nr. 3",0,126,0,126,0,124,2,528,402,50,74,3,5190,1
12,"Calarasi",93539,519,93539,,"DRAGOS VODA",148,"SCOALA GENERALA CU CLASELE I-VIII DRAGOS VODA",1086,587,577,9,1,580,7,1200,613,334,246,3,5194,0
12,"Calarasi",93539,519,93539,,"DRAGOS VODA",149,"SCOALA GENERALA CU CLASELE I-VIII DRAGOS VODA",991,498,475,17,6,494,4,1100,602,347,147,3,5194,0
12,"Calarasi",93539,519,93539,,"DRAGOS VODA",150,"SCOALA GENERALA CU CLASELE I-IV SOCOALELE",210,93,79,11,3,91,2,300,207,45,46,3,5194,0
12,"Calarasi",93539,519,93539,,"DRAGOS VODA",151,"SALA DE SPORT A SCOLII GENERALE CU CLASELE I-VIII DRAGOS VODA",0,131,0,131,0,129,2,300,169,75,54,3,5194,1
12,"Calarasi",102838,519,102838,,"FRASINET",152,"SCOALA GENERALA CU CLASELE I-VIII FRASINET",950,515,512,3,0,508,7,998,483,213,295,3,5198,0
12,"Calarasi",102838,519,102838,,"FRASINET",153,"SCOALA GENERALA CU CLASELE I-IV LUPTATORI",553,265,255,10,0,258,7,599,334,85,173,3,5198,0
12,"Calarasi",102838,519,102838,,"FRASINET",154,"SCOALA GENERALA CU CLASELE I-VIII FRASINET",0,149,0,149,0,145,4,300,151,66,79,3,5198,1
12,"Calarasi",102945,519,102945,,"FRUMUSANI",155,"SCOALA GENERALA PASAREA",572,281,275,6,0,274,7,609,328,182,92,3,5205,0
12,"Calarasi",102945,519,102945,,"FRUMUSANI",156,"SCOALA GENERALA CU CLASELE I-VIII FRUMUSANI",1761,800,772,28,0,775,25,1900,1100,471,304,3,5205,0
12,"Calarasi",102945,519,102945,,"FRUMUSANI",157,"SCOALA GENERALA PADURISU",359,180,171,9,0,174,6,400,220,131,43,3,5205,0
12,"Calarasi",102945,519,102945,,"FRUMUSANI",158,"SCOALA GENERALA ORASTI",942,453,433,20,0,447,6,1000,547,290,157,3,5205,0
12,"Calarasi",102945,519,102945,,"FRUMUSANI",159,"SCOALA GENERALA CU CLASELE I-VIII FRUMUSANI",0,480,0,480,0,479,1,788,308,316,163,3,5205,1
12,"Calarasi",103014,519,103014,,"FUNDENI",160,"SCOALA GENERALA NR. 1 FUNDENI",1402,716,670,46,0,703,13,1497,781,450,253,3,5212,0
12,"Calarasi",103014,519,103014,,"FUNDENI",161,"SCOALA GENERALA NR. 2 FUNDENI",1210,635,563,72,0,624,11,1300,665,418,206,3,5212,0
12,"Calarasi",103014,519,103014,,"FUNDENI",162,"SCOALA GENERALA NR. 3 FUNDENI",1248,466,444,22,0,455,11,1400,934,266,189,3,5212,0
12,"Calarasi",103014,519,103014,,"FUNDENI",163,"SCOALA GENERALA NR. 2 FUNDENI, str. Trandafirilor",0,376,0,376,0,373,3,800,424,243,130,3,5212,1
12,"Calarasi",179962,519,179962,,"GALBINASI",164,"SCOALA NR. 1 GALBINASI",1120,559,534,25,0,549,10,1178,619,300,249,3,5214,0
12,"Calarasi",179962,519,179962,,"GALBINASI",165,"SCOALA NR. 2 GALBINASI",1524,825,806,19,0,804,21,1700,875,433,371,3,5214,0
12,"Calarasi",179962,519,179962,,"GALBINASI",166,"SCOALA NR. 1 GALBINASI",0,219,0,219,0,215,4,700,481,89,126,3,5214,1
12,"Calarasi",93664,519,93664,,"GRADISTEA",167,"SCOALA GENERALA GRADISTEA (localul vechi)",1767,1036,1009,27,0,1020,16,1900,864,371,649,3,5216,0
12,"Calarasi",93664,519,93664,,"GRADISTEA",168,"SCOALA GENERALA CUNESTI",745,415,404,11,0,407,8,800,385,151,256,3,5216,0
12,"Calarasi",93664,519,93664,,"GRADISTEA",169,"SCOALA GENERALA RASA (localul vechi)",1075,619,604,15,0,605,14,1193,574,284,321,3,5216,0
12,"Calarasi",93664,519,93664,,"GRADISTEA",170,"SCOALA GENERALA BOGATA",477,298,286,12,0,287,11,500,202,89,198,3,5216,0
12,"Calarasi",93664,519,93664,,"GRADISTEA",171,"CAMINUL CULTURAL GRADISTEA",0,208,0,208,0,208,0,700,492,84,124,3,5216,1
12,"Calarasi",103568,519,103568,,"GURBANESTI",172,"SCOALA GENERALA CU CLASELE I-VIII GURBANESTI",577,288,281,7,0,267,21,600,312,97,170,3,5221,0
12,"Calarasi",103568,519,103568,,"GURBANESTI",173,"SCOALA GENERALA CU CLASELE I-IV COTOFANCA",344,182,171,11,0,178,4,400,218,71,107,3,5221,0
12,"Calarasi",103568,519,103568,,"GURBANESTI",174,"GRADINITA DE COPII VALEA PRESNEI",192,119,106,13,0,114,5,229,110,36,78,3,5221,0
12,"Calarasi",103568,519,103568,,"GURBANESTI",175,"SCOALA GENERALA CU CLASELE I-VIII GURBANESTI",0,188,0,188,0,186,2,400,212,81,105,3,5221,1
12,"Calarasi",103764,519,103764,,"ILEANA",176,"SCOALA GENERALA CU CLASELE I-VIII ILEANA",872,509,497,12,0,494,15,1000,491,166,328,3,5228,0
12,"Calarasi",103764,519,103764,,"ILEANA",177,"SCOALA GENERALA FLORICA",569,327,315,12,0,321,6,600,273,94,227,3,5228,0
12,"Calarasi",103764,519,103764,,"ILEANA",178,"CAMINUL CULTURAL STEFANESTI",660,353,342,11,0,340,13,700,347,147,193,3,5228,0
12,"Calarasi",103764,519,103764,,"ILEANA",179,"SCOALA GENERALA ARTARI",585,291,278,13,0,287,4,600,309,66,221,3,5228,0
12,"Calarasi",103764,519,103764,,"ILEANA",180,"SCOALA GENERALA CU CLASELE I-VIII ILEANA",0,210,0,210,0,210,0,400,190,105,105,3,5228,1
12,"Calarasi",93771,519,93771,,"INDEPENDENTA",181,"GRADINITA DE COPII INDEPENDENTA",1844,1164,1155,6,3,1156,8,2000,836,570,586,3,5238,0
12,"Calarasi",93771,519,93771,,"INDEPENDENTA",182,"SCOALA GENERALA POTCOAVA",699,444,410,34,0,434,10,800,356,212,222,3,5238,0
12,"Calarasi",93771,519,93771,,"INDEPENDENTA",183,"GRADINITA DE COPII VISINII",429,286,276,10,0,283,3,500,214,178,105,3,5238,0
12,"Calarasi",93771,519,93771,,"INDEPENDENTA",184,"GRADINITA DE COPII INDEPENDENTA, str. Unirii, nr. 43",0,176,0,176,0,176,0,300,124,99,77,3,5238,1
12,"Calarasi",93815,519,93815,,"JEGALIA",185,"SCOALA GENERALA CU CLASELE I-VIII JEGALIA",1780,895,882,13,0,878,17,1900,1005,357,521,3,5242,0
12,"Calarasi",93815,519,93815,,"JEGALIA",186,"SCOALA GENERALA CU CLASELE I-VIII GALDAU",1216,604,598,6,0,591,13,1300,696,240,351,3,5242,0
12,"Calarasi",93815,519,93815,,"JEGALIA",187,"SCOALA GENERALA CU CLASELE I-IV IEZERU",744,347,341,6,0,345,2,800,453,144,201,3,5242,0
12,"Calarasi",93815,519,93815,,"JEGALIA",188,"SCOALA GENERALA CU CLASELE I-VIII JEGALIA",0,89,0,89,0,89,0,300,211,45,44,3,5242,1
12,"Calarasi",93851,519,93851,,"LEHLIU",189,"CAMINUL CULTURAL LEHLIU",1447,803,775,28,0,786,17,1600,797,322,464,3,5246,0
12,"Calarasi",93851,519,93851,,"LEHLIU",190,"SCOALA GENERALA SAPUNARI",785,425,410,15,0,416,9,900,475,209,207,3,5246,0
12,"Calarasi",93851,519,93851,,"LEHLIU",191,"CAMINUL CULTURAL LEHLIU",0,108,0,108,0,108,0,300,192,57,51,3,5246,1
12,"Calarasi",104083,519,104083,,"LUICA",192,"SCOALA GENERALA CU CLASELE I-VIII LUICA",1375,626,618,8,0,609,17,1500,874,257,352,3,5249,0
12,"Calarasi",104083,519,104083,,"LUICA",193,"SCOALA GENERALA CU CLASELE I-IV VALEA STANII",459,148,140,8,0,146,2,500,352,59,87,3,5249,0
12,"Calarasi",104083,519,104083,,"LUICA",194,"SCOALA GENERALA CU CLASELE I-VIII LUICA",0,95,0,95,0,93,2,300,205,39,54,3,5249,1
12,"Calarasi",93931,519,93931,,"LUPSANU",195,"SCOALA GENERALA NUCETU",562,283,273,10,0,281,2,594,311,96,185,3,5252,0
12,"Calarasi",93931,519,93931,,"LUPSANU",196,"SCOALA GENERALA LUPSANU",582,306,293,13,0,302,4,600,294,110,192,3,5252,0
12,"Calarasi",93931,519,93931,,"LUPSANU",197,"SCOALA GENERALA RADU VODA",1074,546,538,8,0,541,5,1200,654,150,391,3,5252,0
12,"Calarasi",93931,519,93931,,"LUPSANU",198,"SCOALA GENERALA PLEVNA",608,260,254,6,0,255,5,700,440,98,157,3,5252,0
12,"Calarasi",93931,519,93931,,"LUPSANU",199,"SCOALA GENERALA RADU VODA",0,132,0,132,0,130,2,400,268,46,84,3,5252,1
12,"Calarasi",104181,519,104181,,"MANASTIREA",200,"SCOALA GENERALA NR. 1 MANASTIREA",1275,582,571,10,1,573,9,1400,818,268,305,3,5258,0
12,"Calarasi",104181,519,104181,,"MANASTIREA",201,"SCOALA GENERALA NR. 1 MANASTIREA",1726,658,647,10,1,643,15,1900,1242,306,337,3,5258,0
12,"Calarasi",104181,519,104181,,"MANASTIREA",202,"SCOALA GENERALA NR. 2 COCONI",951,388,378,10,0,373,15,1000,612,149,224,3,5258,0
12,"Calarasi",104181,519,104181,,"MANASTIREA",203,"SCOALA GENERALA NR. 3 SULTANA",813,387,375,11,1,377,10,900,513,133,244,3,5258,0
12,"Calarasi",104181,519,104181,,"MANASTIREA",204,"SCOALA VECHE MANASTIREA",0,95,0,95,0,94,1,300,205,49,45,3,5258,1
12,"Calarasi",100638,519,100638,,"MITRENI",205,"SCOALA GENERALA NR. 1 MITRENI",1337,549,528,21,0,530,19,1500,951,190,340,3,5262,0
12,"Calarasi",100638,519,100638,,"MITRENI",206,"SCOALA GENERALA NR. 2 VALEA ROSIE",1966,838,812,26,0,833,5,2200,1362,275,558,3,5262,0
12,"Calarasi",100638,519,100638,,"MITRENI",207,"SCOALA GENERALA NR. 3 CLATESTI",487,235,220,15,0,225,10,500,265,109,116,3,5262,0
12,"Calarasi",100638,519,100638,,"MITRENI",208,"SCOALA GENERALA NR. 1 MITRENI, str. Zambilei, nr.44",0,81,0,81,0,80,1,300,219,34,46,3,5262,1
12,"Calarasi",92587,519,92587,,"MODELU",209,"SCOALA GENERALA NR. 1 MODELU (CLADIRE P+1)",1649,937,927,10,0,928,9,1800,863,498,430,3,5266,0
12,"Calarasi",92587,519,92587,,"MODELU",210,"SCOALA GENERALA NR. 1 MODELU (CLADIRE PARTER)",1744,908,894,14,0,888,20,1900,992,442,446,3,5266,0
12,"Calarasi",92587,519,92587,,"MODELU",211,"SALA DE NUNTI - MODELU",1520,850,828,22,0,823,27,1700,850,322,501,3,5266,0
12,"Calarasi",92587,519,92587,,"MODELU",212,"SCOALA GENERALA NR. 2 MODELU",1569,869,849,20,0,858,11,1700,831,392,466,3,5266,0
12,"Calarasi",92587,519,92587,,"MODELU",213,"SCOALA GENERALA TONEA",1253,618,596,22,0,604,14,1400,782,258,346,3,5266,0
12,"Calarasi",92587,519,92587,,"MODELU",214,"SALA DE SEDINTE A PRIMARIEI MODELU, str. Plopilor, nr.12",0,127,0,127,0,127,0,611,484,51,76,3,5266,1
12,"Calarasi",104323,519,104323,,"NANA",215,"SCOALA GENERALA CU CLASELE I-VIII, NANA",856,467,455,4,8,452,15,900,433,234,218,3,5271,0
12,"Calarasi",104323,519,104323,,"NANA",216,"SCOALA GENERALA CU CLASELE I-VIII, NANA",1175,704,688,1,15,691,13,1300,596,367,324,3,5271,0
12,"Calarasi",104323,519,104323,,"NANA",217,"SCOALA GENERALA CU CLASELE I-VIII, NANA",0,104,0,104,0,102,2,300,196,59,43,3,5271,1
12,"Calarasi",104341,519,104341,,"NICOLAE BALCESCU",218,"SCOALA GENERALA CU CLASELE I-VIII NICOLAE BALCESCU",998,502,500,2,0,491,11,1110,608,167,324,3,5273,0
12,"Calarasi",104341,519,104341,,"NICOLAE BALCESCU",219,"SCOALA GENERALA CU CLASELE I-IV FANTANA DOAMNEI",301,156,148,8,0,149,7,399,243,73,76,3,5273,0
12,"Calarasi",104341,519,104341,,"NICOLAE BALCESCU",220,"SCOALA GENERALA CU CLASELE I-VIII NICOLAE BALCESCU",0,134,0,134,0,132,2,300,166,69,63,3,5273,1
12,"Calarasi",94223,519,94223,,"PERISORU",221,"CAMINUL CULTURAL PERISORU",1704,799,785,14,0,787,12,1900,1101,354,433,3,5277,0
12,"Calarasi",94223,519,94223,,"PERISORU",222,"CAMINUL CULTURAL PERISORU",1382,612,597,15,0,610,2,1500,888,290,320,3,5277,0
12,"Calarasi",94223,519,94223,,"PERISORU",223,"SCOALA GENERALA TUDOR VLADIMIRESCU",820,375,357,18,0,371,4,888,513,190,181,3,5277,0
12,"Calarasi",94223,519,94223,,"PERISORU",224,"SCOALA GENERALA PRODASEM",201,102,95,7,0,101,1,300,198,34,67,3,5277,0
12,"Calarasi",94223,519,94223,,"PERISORU",225,"CAMINUL CULTURAL PERISORU CORP B",0,116,0,116,0,112,4,300,184,63,49,3,5277,1
12,"Calarasi",104635,519,104635,,"PLATARESTI",226,"SEDIUL PRIMARIEI PLATARESTI",1137,632,617,15,0,623,9,1300,668,324,299,3,5281,0
12,"Calarasi",104635,519,104635,,"PLATARESTI",227,"SCOALA GENERALA DOROBANTU",887,521,505,16,0,513,8,1000,479,368,145,3,5281,0
12,"Calarasi",104635,519,104635,,"PLATARESTI",228,"SCOALA GENERALA CUCUIETI",482,236,226,10,0,235,1,502,266,119,116,3,5281,0
12,"Calarasi",104635,519,104635,,"PLATARESTI",229,"SCOALA GENERALA PODU PITARULUI",368,219,211,8,0,217,2,400,181,117,100,3,5281,0
12,"Calarasi",104635,519,104635,,"PLATARESTI",230,"SEDIUL PRIMARIEI PLATARESTI, str. Calea Bucuresti, nr. 115",0,340,0,340,0,336,4,700,360,225,111,3,5281,1
12,"Calarasi",104751,519,104751,,"RADOVANU",231,"SCOALA NOUA RADOVANU",1185,638,609,29,0,632,6,1300,662,288,344,3,5286,0
12,"Calarasi",104751,519,104751,,"RADOVANU",232,"SCOALA VECHE RADOVANU",1059,602,561,41,0,594,8,1200,598,264,330,3,5286,0
12,"Calarasi",104751,519,104751,,"RADOVANU",233,"SCOALA COADELE",1151,699,608,91,0,690,9,1300,601,272,418,3,5286,0
12,"Calarasi",104751,519,104751,,"RADOVANU",234,"SCOALA VALEA POPII",539,372,344,28,0,367,5,600,228,129,238,3,5286,0
12,"Calarasi",104751,519,104751,,"RADOVANU",235,"SCOALA VECHE RADOVANU",0,243,0,243,0,242,1,800,557,103,139,3,5286,1
12,"Calarasi",94312,519,94312,,"ROSETI",236,"SCOALA GENERALA SECTOR 2",1653,800,790,10,0,770,30,1800,1000,334,436,3,5289,0
12,"Calarasi",94312,519,94312,,"ROSETI",237,"SCOALA GENERALA CENTRU",1267,634,626,8,0,627,7,1400,766,314,313,3,5289,0
12,"Calarasi",94312,519,94312,,"ROSETI",238,"SCOALA DIN DEAL",1824,952,936,16,0,927,25,2000,1048,484,443,3,5289,0
12,"Calarasi",94312,519,94312,,"ROSETI",239,"SALA DE CONSILIU A PRIMARIEI ROSETI",0,60,0,60,0,59,1,400,340,27,32,3,5289,1
12,"Calarasi",104886,519,104886,,"SARULESTI",240,"SCOALA GENERALA CU CLASELE I-IV SARULESTI GARA",1122,719,700,19,0,692,27,1203,484,368,324,3,5291,0
12,"Calarasi",104886,519,104886,,"SARULESTI",241,"SCOALA GENERALA CU CLASELE I-IV SANDULITA",502,301,291,10,0,290,11,600,299,145,145,3,5291,0
12,"Calarasi",104886,519,104886,,"SARULESTI",242,"SCOALA GENERALA CU CLASELE I-IV SARULESTI",401,221,216,5,0,216,5,500,279,68,148,3,5291,0
12,"Calarasi",104886,519,104886,,"SARULESTI",243,"SCOALA GENERALA CU CLASELE I-IV SOLACOLU",241,124,114,10,0,123,1,303,179,42,81,3,5291,0
12,"Calarasi",104886,519,104886,,"SARULESTI",244,"SCOALA GENERALA CU CLASELE I-VIII SARULESTI GARA",0,217,0,217,0,214,3,500,283,98,116,3,5291,1
12,"Calarasi",105222,519,105222,,"SOHATU",245,"SCOALA GENERALA SOHATU",1541,694,684,10,0,655,39,1700,1006,265,390,3,5299,0
12,"Calarasi",105222,519,105222,,"SOHATU",246,"SCOALA GENERALA PROGRESU",936,442,425,17,0,431,11,1000,558,139,292,3,5299,0
12,"Calarasi",105222,519,105222,,"SOHATU",247,"SCOALA GENERALA SOHATU",0,293,0,293,0,289,4,605,312,134,155,3,5299,1
12,"Calarasi",105259,519,105259,,"SPANTOV",248,"SCOALA GENERALA NR. 1 SPANTOV",921,469,453,16,0,461,8,995,526,145,316,3,5305,0
12,"Calarasi",105259,519,105259,,"SPANTOV",249,"SCOALA GENERALA CETATEA VECHE",736,406,391,15,0,399,7,800,394,166,233,3,5305,0
12,"Calarasi",105259,519,105259,,"SPANTOV",250,"SCOALA GENERALA NR. 2 STANCEA",1230,623,613,10,0,606,17,1400,777,307,299,3,5305,0
12,"Calarasi",105259,519,105259,,"SPANTOV",251,"SCOALA GENERALA NR. 3 STANCEA",801,446,438,8,0,436,10,900,454,214,222,3,5305,0
12,"Calarasi",105259,519,105259,,"SPANTOV",252,"SCOALA GENERALA NR. 1 SPANTOV",0,147,0,147,0,146,1,400,253,63,83,3,5305,1
12,"Calarasi",105384,519,105384,,"SOLDANU",253,"SCOALA ""CONSTANTIN TEODORESCU"" SOLDANU",1824,921,911,10,0,911,10,2000,1079,342,569,3,5302,0
12,"Calarasi",105384,519,105384,,"SOLDANU",254,"SCOALA ""MATEI BASARAB"" NEGOIESTI",797,399,391,8,0,393,6,899,500,167,226,3,5302,0
12,"Calarasi",105384,519,105384,,"SOLDANU",255,"SCOALA ""CONSTANTIN TEODORESCU"" SOLDANU",0,202,0,202,0,198,4,299,97,72,126,3,5302,1
12,"Calarasi",94562,519,94562,,"STEFAN CEL MARE",256,"SCOALA GENERALA CU CLASELE I-VIII STEFAN CEL MARE (PARTEA DE VEST)",1494,790,766,4,20,782,8,1600,810,249,533,3,5309,0
12,"Calarasi",94562,519,94562,,"STEFAN CEL MARE",257,"SCOALA GENERALA CU CLASELE I-VIII STEFAN CEL MARE (PARTEA DE EST)",1144,619,599,7,13,608,11,1292,673,218,390,3,5309,0
12,"Calarasi",94562,519,94562,,"STEFAN CEL MARE",258,"BIBLIOTECA COMUNALA STEFAN CEL MARE, str. Scolii, nr. 32A",0,107,0,107,0,104,3,305,198,51,53,3,5309,1
12,"Calarasi",94580,519,94580,,"STEFAN VODA",259,"SCOALA GENERALA CU CLASELE I-VIII STEFAN VODA (CABINETUL DE BIOLOGIE)",1102,694,659,15,20,683,11,1200,506,434,249,3,5311,0
12,"Calarasi",94580,519,94580,,"STEFAN VODA",260,"SCOALA GENERALA CU CLASELE I-VIII STEFAN VODA (CABINETUL DE CHIMIE)",841,527,506,11,10,521,6,900,373,308,213,3,5311,0
12,"Calarasi",94580,519,94580,,"STEFAN VODA",261,"SCOALA GENERALA CU CLASELE I-VIII STEFAN VODA",0,113,0,113,0,110,3,299,186,54,56,3,5311,1
12,"Calarasi",105455,519,105455,,"TAMADAU MARE",262,"SCOALA GENERALA CU CLASELE I-VIII TAMADAU MARE",1164,561,551,10,0,551,10,1300,739,328,223,3,5313,0
12,"Calarasi",105455,519,105455,,"TAMADAU MARE",263,"SCOALA GENERALA CU CLASELE I-IV PLUMBUITA",776,327,321,6,0,316,11,900,573,153,163,3,5313,0
12,"Calarasi",105455,519,105455,,"TAMADAU MARE",264,"SCOALA GENERALA CU CLASELE I-VIII TAMADAU MARE",0,165,0,165,0,165,0,500,335,88,77,3,5313,1
12,"Calarasi",105605,519,105605,,"ULMENI",265,"SCOALA GENERALA NR. 1 ULMENI",1470,676,644,32,0,668,8,1600,924,294,374,3,5321,0
12,"Calarasi",105605,519,105605,,"ULMENI",266,"SCOALA GENERALA NR. 2 ULMENI",1483,771,759,12,0,740,31,1600,829,229,511,3,5321,0
12,"Calarasi",105605,519,105605,,"ULMENI",267,"SCOALA GENERALA NR. 3 ULMENI",1361,671,635,36,0,659,12,1500,829,236,423,3,5321,0
12,"Calarasi",105605,519,105605,,"ULMENI",268,"PRIMARIA ULMENI",0,115,0,115,0,113,2,700,585,43,70,3,5321,1
12,"Calarasi",94606,519,94606,,"ULMU",269,"SCOALA GENERALA CU CLASELE I-VIII ULMU",815,561,499,8,54,533,28,900,339,225,308,3,5323,0
12,"Calarasi",94606,519,94606,,"ULMU",270,"SCOALA PRIMARA CU CLASELE I-IV FAUREI",420,318,276,9,33,308,10,500,182,90,218,3,5323,0
12,"Calarasi",94606,519,94606,,"ULMU",271,"SCOALA PRIMARA ZIMBRU",86,65,55,10,0,64,1,100,35,43,21,3,5323,0
12,"Calarasi",94606,519,94606,,"ULMU",272,"SCOALA PRIMARA CU CLASELE I-VIII ULMU",0,201,0,201,0,201,0,600,399,91,110,3,5323,1
12,"Calarasi",94651,519,94651,,"UNIREA",273,"SCOALA GENERALA NR. 1 UNIREA  (localul de langa biserica)",1061,648,626,6,16,641,7,1197,549,296,345,3,5328,0
12,"Calarasi",94651,519,94651,,"UNIREA",274,"SCOALA GENERALA NR. 1 UNIREA (localul de langa Caminul Cultural)",1331,763,734,5,24,752,11,1500,737,398,354,3,5328,0
12,"Calarasi",94651,519,94651,,"UNIREA",275,"SCOALA GENERALA NR. 1 UNIREA (localul de langa Caminul Cultural), sala III",0,132,0,132,0,132,0,401,269,64,68,3,5328,1
12,"Calarasi",105712,519,105712,,"VALEA ARGOVEI",276,"SCOALA GENERALA CU CLASELE I-VIII VALEA ARGOVEI",1494,691,688,3,0,669,22,1600,909,339,330,3,5334,0
12,"Calarasi",105712,519,105712,,"VALEA ARGOVEI",277,"SCOALA GENERALA SILISTEA",613,354,350,4,0,341,13,700,346,169,172,3,5334,0
12,"Calarasi",105712,519,105712,,"VALEA ARGOVEI",278,"SCOALA GENERALA CU CLASELE I-VIII VALEA ARGOVEI",0,139,0,139,0,138,1,500,361,75,63,3,5334,1
12,"Calarasi",105829,519,105829,,"VASILATI",279,"SCOALA ""CONSTANTIN BRANCOVEANU"" VASILIATI (localul cu etaj)",1064,517,499,18,0,508,9,1100,583,162,346,3,5340,0
12,"Calarasi",105829,519,105829,,"VASILATI",280,"SCOALA ""CONSTANTIN BRANCOVEANU"" VASILIATI (localul vechi de langa Gara CFR)",1678,809,800,9,0,793,16,1800,991,264,529,3,5340,0
12,"Calarasi",105829,519,105829,,"VASILATI",281,"SCOALA GENERALA NR. 4 NUCI",298,169,163,6,0,167,2,300,131,52,115,3,5340,0
12,"Calarasi",105829,519,105829,,"VASILATI",282,"SCOALA GENERALA NR. 5 POPESTI",302,181,172,9,0,180,1,400,219,46,134,3,5340,0
12,"Calarasi",105829,519,105829,,"VASILATI",283,"SCOALA ""CONSTANTIN BRANCOVEANU"" VASILIATI (fosta scoala generala nr.1)(localul vechi de langa Gara CFR)-Centrul P.A.P.I.",0,308,0,308,0,304,4,503,195,106,198,3,5340,1
12,"Calarasi",94731,519,94731,,"VALCELELE",284,"SCOALA GENERALA CU CLASELE I-VIII ""FLORENTA ALBU""  VALCELELE",1031,789,686,14,89,779,10,1100,311,568,211,3,5331,0
12,"Calarasi",94731,519,94731,,"VALCELELE",285,"SCOALA GENERALA CU CLASELE I-VIII ""EROU GRENADIER CONSTANTIN MUSAT"" FLOROAICA",511,379,358,7,14,377,2,605,226,285,92,3,5331,0
12,"Calarasi",94731,519,94731,,"VALCELELE",286,"SCOALA GENERALA CU CLASELE I-VIII ""FLORENTA ALBU""  VALCELELE",0,431,0,431,0,424,7,800,369,320,104,3,5331,1
12,"Calarasi",94768,519,94768,,"VLAD TEPES",287,"SCOALA GENERALA VLAD TEPES",1300,714,686,17,11,692,22,1400,686,273,419,3,5344,0
12,"Calarasi",94768,519,94768,,"VLAD TEPES",288,"SCOALA GENERALA MIHAI VITEAZU",635,341,334,6,1,332,9,701,360,109,223,3,5344,0
12,"Calarasi",94768,519,94768,,"VLAD TEPES",289,"SCOALA GENERALA VLAD TEPES",0,161,0,161,0,160,1,700,539,77,83,3,5344,1
13,"Cluj",54975,127,54975,,"MUNICIPIUL CLUJ-NAPOCA",1,"Colegiul Economic ""Iulian Pop"", Strada Emil Isac nr.19",2181,754,725,29,0,742,12,2399,1645,431,311,1,5348,0
13,"Cluj",54975,127,54975,,"MUNICIPIUL CLUJ-NAPOCA",2,"Colegiul Tehnic de Telecomunicatii ""Augustin Maior"" , Strada Motilor nr.78-80",1960,917,900,16,1,903,14,2157,1240,558,345,1,5348,0
13,"Cluj",54975,127,54975,,"MUNICIPIUL CLUJ-NAPOCA",3,"Colegiul Tehnic de Telecomunicatii ""Augustin Maior"" , Strada Motilor nr.78-80",1537,823,811,11,1,815,8,1690,867,413,402,1,5348,0
13,"Cluj",54975,127,54975,,"MUNICIPIUL CLUJ-NAPOCA",4,"Scoala ""Ion Creanga"", Aleea Peana nr.4",1156,681,671,10,0,675,6,1271,590,391,284,1,5348,0
13,"Cluj",54975,127,54975,,"MUNICIPIUL CLUJ-NAPOCA",5,"Scoala ""Ion Creanga"", Aleea Peana nr.4",1725,1007,994,13,0,1002,5,1900,893,652,350,1,5348,0
13,"Cluj",54975,127,54975,,"MUNICIPIUL CLUJ-NAPOCA",6,"Scoala ""Ion Creanga"", Aleea Peana nr.4",1425,761,747,14,0,753,8,1568,807,507,246,1,5348,0
13,"Cluj",54975,127,54975,,"MUNICIPIUL CLUJ-NAPOCA",7,"Gradinita Dumbrava Minunata (fosta 66), Strada Grigore Alexandrescu nr.47",1197,625,607,18,0,622,3,1320,695,409,213,1,5348,0
13,"Cluj",54975,127,54975,,"MUNICIPIUL CLUJ-NAPOCA",8,"Gradinita Dumbrava Minunata (fosta 66), Strada Grigore Alexandrescu nr.47",1813,1059,1047,11,1,1048,11,1989,930,606,442,1,5348,0
13,"Cluj",54975,127,54975,,"MUNICIPIUL CLUJ-NAPOCA",9,"Gradinita Dumbrava Minunata (fosta 66), Strada Grigore Alexandrescu nr.47",1754,958,943,15,0,945,13,1925,967,630,315,1,5348,0
13,"Cluj",54975,127,54975,,"MUNICIPIUL CLUJ-NAPOCA",10,"Scoala ""Iuliu Hatieganu"" (fosta nr.21), Strada Grigore Alexandrescu nr.16",1965,1091,1077,14,0,1087,4,2165,1074,771,316,1,5348,0
13,"Cluj",54975,127,54975,,"MUNICIPIUL CLUJ-NAPOCA",11,"Gradinita Curcubeu (fosta 55), Strada Grigore Alexandrescu nr.21",1858,1006,997,9,0,997,9,2045,1039,581,416,1,5348,0
13,"Cluj",54975,127,54975,,"MUNICIPIUL CLUJ-NAPOCA",12,"Scoala ""Iuliu Hatieganu"" (fosta nr.21), Strada Grigore Alexandrescu nr.16",1607,814,798,16,0,807,7,1770,956,547,260,1,5348,0
13,"Cluj",54975,127,54975,,"MUNICIPIUL CLUJ-NAPOCA",13,"Scoala ""Iuliu Hatieganu"" (fosta nr.21), Strada Grigore Alexandrescu nr.16",1696,900,888,11,1,892,8,1870,970,558,334,1,5348,0
13,"Cluj",54975,127,54975,,"MUNICIPIUL CLUJ-NAPOCA",14,"Scoala ""Iuliu Hatieganu"" (fosta nr.21), Strada Grigore Alexandrescu nr.16",1667,887,874,13,0,882,5,1835,948,586,296,1,5348,0
13,"Cluj",54975,127,54975,,"MUNICIPIUL CLUJ-NAPOCA",15,"Colegiul Tehnic Napoca ,Strada Taberei nr.1-3",1862,1029,1018,10,1,1016,13,2042,1013,692,324,1,5348,0
13,"Cluj",54975,127,54975,,"MUNICIPIUL CLUJ-NAPOCA",16,"Liceul cu Program Sportiv (fosta Scoala nr.20), Strada Arinilor nr.9",1956,1155,1145,9,1,1145,10,2140,985,789,356,1,5348,0
13,"Cluj",54975,127,54975,,"MUNICIPIUL CLUJ-NAPOCA",17,"Liceul cu Program Sportiv (fosta Scoala nr.20), Strada Arinilor nr.9",1495,873,858,15,0,863,10,1645,772,659,204,1,5348,0
13,"Cluj",54975,127,54975,,"MUNICIPIUL CLUJ-NAPOCA",18,"Liceul cu Program Sportiv (fosta Scoala nr.20), Strada Arinilor nr.9",1478,815,807,8,0,806,9,1630,815,529,277,1,5348,0
13,"Cluj",54975,127,54975,,"MUNICIPIUL CLUJ-NAPOCA",19,"Liceul ""Eugen Pora"", Strada Mogosoaia nr.6",1851,1067,1056,11,0,1050,17,2034,967,642,408,1,5348,0
13,"Cluj",54975,127,54975,,"MUNICIPIUL CLUJ-NAPOCA",20,"Liceul ""Eugen Pora"", Strada Mogosoaia nr.6",1812,1050,1039,11,0,1037,13,1990,940,678,359,1,5348,0
13,"Cluj",54975,127,54975,,"MUNICIPIUL CLUJ-NAPOCA",21,"Liceul ""Eugen Pora"", Strada Mogosoaia nr.6",1945,1072,1060,12,0,1067,5,2140,1068,689,378,1,5348,0
13,"Cluj",54975,127,54975,,"MUNICIPIUL CLUJ-NAPOCA",22,"Scoala ""Ion Lupas"", Calea Manastur nr.22-24",2216,1242,1218,22,2,1232,10,2440,1198,770,462,1,5348,0
13,"Cluj",54975,127,54975,,"MUNICIPIUL CLUJ-NAPOCA",23,"Biblioteca Judeteana - Filiala Manastur, Strada Islazului nr.18",1753,1083,1070,13,0,1076,7,1925,842,719,357,1,5348,0
13,"Cluj",54975,127,54975,,"MUNICIPIUL CLUJ-NAPOCA",24,"Scoala ""Ion Lupas"", Calea Manastur nr.22-24",1498,866,861,5,0,856,10,1650,784,542,314,1,5348,0
13,"Cluj",54975,127,54975,,"MUNICIPIUL CLUJ-NAPOCA",25,"Scoala ""Ion Lupas"", Calea Manastur nr.22-24",1664,982,969,13,0,973,9,1830,848,624,349,1,5348,0
13,"Cluj",54975,127,54975,,"MUNICIPIUL CLUJ-NAPOCA",26,"Scoala ""Ion Lupas"", Calea Manastur nr.22-24",1359,834,823,11,0,820,14,1493,659,459,361,1,5348,0
13,"Cluj",54975,127,54975,,"MUNICIPIUL CLUJ-NAPOCA",27,"Sala Sporturilor , Splaiul Independentei",2301,1289,1275,13,1,1270,19,2531,1242,729,541,1,5348,0
13,"Cluj",54975,127,54975,,"MUNICIPIUL CLUJ-NAPOCA",28,"Sala Sporturilor , Splaiul Independentei",1321,678,664,13,1,671,7,1472,794,431,240,1,5348,0
13,"Cluj",54975,127,54975,,"MUNICIPIUL CLUJ-NAPOCA",29,"Centrul Regional de Excelenta Strada Octavian Goga nr.23",1991,1113,1097,13,3,1095,18,2190,1077,536,559,1,5348,0
13,"Cluj",54975,127,54975,,"MUNICIPIUL CLUJ-NAPOCA",30,"Liceul Teoretic ""Onisifor Ghibu"", Strada Al. Vlahuta nr.12-14",1932,1187,1167,19,1,1172,15,2125,938,607,565,1,5348,0
13,"Cluj",54975,127,54975,,"MUNICIPIUL CLUJ-NAPOCA",31,"Gradinita Mica Sirena (fosta 64), Strada Al. Vlahuta nr.59",1467,879,862,15,2,862,17,1615,736,488,374,1,5348,0
13,"Cluj",54975,127,54975,,"MUNICIPIUL CLUJ-NAPOCA",32,"Liceul Teoretic ""Onisifor Ghibu"", Strada Al. Vlahuta nr.12-14",1436,822,813,9,0,812,10,1578,756,503,309,1,5348,0
13,"Cluj",54975,127,54975,,"MUNICIPIUL CLUJ-NAPOCA",33,"Liceul Teoretic ""Onisifor Ghibu"", Strada Al. Vlahuta nr.12-14",1107,632,616,16,0,626,6,1219,587,334,292,1,5348,0
13,"Cluj",54975,127,54975,,"MUNICIPIUL CLUJ-NAPOCA",34,"Scoala ""Onisifor Ghibu"", Strada Al. Vlahuta nr.44-48",1293,731,721,10,0,718,13,1419,688,420,298,1,5348,0
13,"Cluj",54975,127,54975,,"MUNICIPIUL CLUJ-NAPOCA",35,"Scoala ""Onisifor Ghibu"", Strada Al. Vlahuta nr.44-48",2004,1204,1191,13,0,1193,11,2200,996,661,532,1,5348,0
13,"Cluj",54975,127,54975,,"MUNICIPIUL CLUJ-NAPOCA",36,"Gradinita Steluta Fermecata (fosta 68), Strada Fantanele nr.46",1527,870,861,8,1,862,8,1680,810,532,330,1,5348,0
13,"Cluj",54975,127,54975,,"MUNICIPIUL CLUJ-NAPOCA",37,"Gradinita Steluta Fermecata (fosta 68), Strada Fantanele nr.46",1174,654,644,10,0,647,7,1290,636,385,262,1,5348,0
13,"Cluj",54975,127,54975,,"MUNICIPIUL CLUJ-NAPOCA",38,"Institutul de Cercetari in Chimie Raluca Ripan, Strada Fantanele nr.30",1975,1165,1150,14,1,1153,12,2170,1005,794,359,1,5348,0
13,"Cluj",54975,127,54975,,"MUNICIPIUL CLUJ-NAPOCA",39,"Gradinita Mica Sirena (fosta 12), Strada Donath nr.150",1758,1020,1003,17,0,1000,20,1935,915,589,411,1,5348,0
13,"Cluj",54975,127,54975,,"MUNICIPIUL CLUJ-NAPOCA",40,"Institutul de Cercetari in Chimie Raluca Ripan, Strada Fantanele nr.30",1953,1162,1144,16,2,1151,11,2145,983,766,385,1,5348,0
13,"Cluj",54975,127,54975,,"MUNICIPIUL CLUJ-NAPOCA",41,"Institutul de Cercetari in Chimie Raluca Ripan, Strada Fantanele nr.30",1821,1035,1018,17,0,1029,6,2000,965,629,400,1,5348,0
13,"Cluj",54975,127,54975,,"MUNICIPIUL CLUJ-NAPOCA",42,"Scoala Radu Stanca (fosta nr.10), Strada Zorilor nr.27",2232,1267,1255,12,0,1251,16,1555,288,877,374,1,5348,0
13,"Cluj",54975,127,54975,,"MUNICIPIUL CLUJ-NAPOCA",43,"Scoala Radu Stanca (fosta nr.10), Strada Zorilor nr.27",2512,1442,1432,10,0,1431,11,2760,1318,952,479,1,5348,0
13,"Cluj",54975,127,54975,,"MUNICIPIUL CLUJ-NAPOCA",44,"Asociatia Caritatea, Strada Mircea Eliade nr.22",790,545,507,38,0,542,3,870,325,293,249,1,5348,0
13,"Cluj",54975,127,54975,,"MUNICIPIUL CLUJ-NAPOCA",45,"Scoala Radu Stanca (fosta nr.10), Strada Zorilor nr.27",2230,1342,1332,9,1,1325,17,2453,1111,939,386,1,5348,0
13,"Cluj",54975,127,54975,,"MUNICIPIUL CLUJ-NAPOCA",46,"Scoala Radu Stanca (fosta nr.10), Strada Zorilor nr.27",2082,1247,1237,8,2,1233,14,2290,1043,844,389,1,5348,0
13,"Cluj",54975,127,54975,,"MUNICIPIUL CLUJ-NAPOCA",47,"Gradinita Scufita Rosie-structura 1(fosta nr.74), Strada L. Pasteur nr.12",1205,654,638,16,0,646,8,1325,671,414,232,1,5348,0
13,"Cluj",54975,127,54975,,"MUNICIPIUL CLUJ-NAPOCA",48,"Facultatea de Constructii Sectia Drumuri-Poduri, Strada Observatorului nr.72",2018,1115,1099,16,0,1098,17,2220,1105,754,344,1,5348,0
13,"Cluj",54975,127,54975,,"MUNICIPIUL CLUJ-NAPOCA",49,"Facultatea de Constructii Sectia Drumuri-Poduri, Strada Observatorului nr.72",1841,1076,1067,9,0,1068,8,2026,950,754,314,1,5348,0
13,"Cluj",54975,127,54975,,"MUNICIPIUL CLUJ-NAPOCA",50,"Facultatea de Constructii Sectia Drumuri-Poduri, Strada Observatorului nr.72",1792,988,977,11,0,983,5,1970,982,672,311,1,5348,0
13,"Cluj",54975,127,54975,,"MUNICIPIUL CLUJ-NAPOCA",51,"Liceul Informatica ""T. Popoviciu"", Calea Turzii nr.140-142",1339,796,778,18,0,787,9,1263,467,517,270,1,5348,0
13,"Cluj",54975,127,54975,,"MUNICIPIUL CLUJ-NAPOCA",52,"Liceul Informatica ""T. Popoviciu"", Calea Turzii nr.140-142",1916,1180,1156,24,0,1170,10,2110,930,779,391,1,5348,0
13,"Cluj",54975,127,54975,,"MUNICIPIUL CLUJ-NAPOCA",53,"Palatul Copiilor, Strada Republicii nr.23",1824,980,962,17,1,963,17,2004,1024,459,504,1,5348,0
13,"Cluj",54975,127,54975,,"MUNICIPIUL CLUJ-NAPOCA",54,"Scoala ""Ioan Bob"", Strada Episcop Ioan Bob nr.10",1802,907,892,13,2,892,15,1980,1073,454,438,1,5348,0
13,"Cluj",54975,127,54975,,"MUNICIPIUL CLUJ-NAPOCA",55,"Colegiul National ""G.Cosbuc"", Strada Avran Iancu nr.44",1302,780,765,15,0,767,13,1428,648,369,398,1,5348,0
13,"Cluj",54975,127,54975,,"MUNICIPIUL CLUJ-NAPOCA",56,"Liceul Teoretic ""Gh.Sincai"", Strada Avram Iancu nr.33",1762,1048,1023,22,3,1045,3,1935,887,589,456,1,5348,0
13,"Cluj",54975,127,54975,,"MUNICIPIUL CLUJ-NAPOCA",57,"Liceul Teoretic ""Gh.Sincai"", Strada Avram Iancu nr.33",1239,798,789,9,0,782,16,1365,567,372,410,1,5348,0
13,"Cluj",54975,127,54975,,"MUNICIPIUL CLUJ-NAPOCA",58,"Grup Scolar Eletrotehnic, Strada Campului Micro II/2",1955,1127,1094,33,0,1116,11,2150,1023,701,415,1,5348,0
13,"Cluj",54975,127,54975,,"MUNICIPIUL CLUJ-NAPOCA",59,"Grup Scolar Eletrotehnic, Strada Campului Micro II/2",1754,909,903,6,0,903,6,1925,1016,582,321,1,5348,0
13,"Cluj",54975,127,54975,,"MUNICIPIUL CLUJ-NAPOCA",60,"Grup Scolar Eletrotehnic, Strada Campului Micro II/2",1667,933,919,14,0,928,5,1835,902,642,286,1,5348,0
13,"Cluj",54975,127,54975,,"MUNICIPIUL CLUJ-NAPOCA",61,"Scoala ""Liviu Rebreanu"",Strada Moldoveanu nr.1",1859,983,972,11,0,973,10,2045,1062,678,295,1,5348,0
13,"Cluj",54975,127,54975,,"MUNICIPIUL CLUJ-NAPOCA",62,"Gradinita Universul Copiilor (fosta 71), Strada Moldoveanu nr.7",1605,895,884,11,0,890,5,1765,870,576,314,1,5348,0
13,"Cluj",54975,127,54975,,"MUNICIPIUL CLUJ-NAPOCA",63,"Scoala ""Liviu Rebreanu"",Strada Moldoveanu nr.1",1635,857,841,15,1,849,8,1800,943,547,302,1,5348,0
13,"Cluj",54975,127,54975,,"MUNICIPIUL CLUJ-NAPOCA",64,"Scoala ""Constantin Brancoveanu"" (fosta nr.3), Aleea Retezat nr.44",1844,952,936,15,1,946,6,2025,1073,689,257,1,5348,0
13,"Cluj",54975,127,54975,,"MUNICIPIUL CLUJ-NAPOCA",65,"Scoala ""Constantin Brancoveanu"" (fosta nr.3), Aleea Retezat nr.44",1922,1049,1036,12,1,1039,10,2107,1058,744,295,1,5348,0
13,"Cluj",54975,127,54975,,"MUNICIPIUL CLUJ-NAPOCA",66,"Scoala ""Constantin Brancoveanu"" (fosta nr.3), Aleea Retezat nr.44",1845,989,975,14,0,979,10,2036,1047,694,285,1,5348,0
13,"Cluj",54975,127,54975,,"MUNICIPIUL CLUJ-NAPOCA",67,"Scoala ""Liviu Rebreanu"",Strada Moldoveanu nr.1",1885,969,958,10,1,959,10,2075,1106,656,303,1,5348,0
13,"Cluj",54975,127,54975,,"MUNICIPIUL CLUJ-NAPOCA",68,"Gradinita Buburuza (fosta 70), Strada Mehedinti nr.19",1277,648,634,14,0,645,3,1393,745,410,235,1,5348,0
13,"Cluj",54975,127,54975,,"MUNICIPIUL CLUJ-NAPOCA",69,"Gradinita Buburuza (fosta 70), Strada Mehedinti nr.19",1842,904,890,14,0,897,7,2025,1121,593,304,1,5348,0
13,"Cluj",54975,127,54975,,"MUNICIPIUL CLUJ-NAPOCA",70,"Gradinita Academia Piticilor (fosta 72), Strada Tazlau nr.11",1898,1041,1022,18,1,1032,9,2087,1046,644,388,1,5348,0
13,"Cluj",54975,127,54975,,"MUNICIPIUL CLUJ-NAPOCA",71,"Gradinita Academia Piticilor (fosta 72), Strada Tazlau nr.11",1690,883,865,17,1,877,6,1859,976,555,322,1,5348,0
13,"Cluj",54975,127,54975,,"MUNICIPIUL CLUJ-NAPOCA",72,"Fosta Scoala nr.6, Aleea Meziad, nr.4",1667,800,788,11,1,787,13,1835,1035,542,245,1,5348,0
13,"Cluj",54975,127,54975,,"MUNICIPIUL CLUJ-NAPOCA",73,"Fosta Scoala nr.6, Aleea Meziad, nr.4",1739,1002,990,11,1,991,11,1915,913,654,337,1,5348,0
13,"Cluj",54975,127,54975,,"MUNICIPIUL CLUJ-NAPOCA",74,"Fosta Scoala nr.6, Aleea Meziad, nr.4",1871,1021,1014,7,0,1014,7,2053,1032,699,315,1,5348,0
13,"Cluj",54975,127,54975,,"MUNICIPIUL CLUJ-NAPOCA",75,"Fosta Scoala nr.6, Aleea Meziad, nr.4",1269,705,697,8,0,696,9,1400,695,410,286,1,5348,0
13,"Cluj",54975,127,54975,,"MUNICIPIUL CLUJ-NAPOCA",76,"Scoala ""Octavian Goga"", Aleea Peana nr.16",1926,1034,1022,12,0,1022,12,2116,1082,675,347,1,5348,0
13,"Cluj",54975,127,54975,,"MUNICIPIUL CLUJ-NAPOCA",77,"Scoala ""Octavian Goga"", Aleea Peana nr.16",1586,743,727,16,0,737,6,1745,1002,493,244,1,5348,0
13,"Cluj",54975,127,54975,,"MUNICIPIUL CLUJ-NAPOCA",78,"Scoala ""Octavian Goga"", Aleea Peana nr.16",1357,647,632,15,0,641,6,1495,848,471,170,1,5348,0
13,"Cluj",54975,127,54975,,"MUNICIPIUL CLUJ-NAPOCA",79,"Sala Sportiva a Armatei, Strada Generel Traian Mosoiu nr.9",1936,1135,1122,11,2,1120,15,2130,995,608,512,1,5348,0
13,"Cluj",54975,127,54975,,"MUNICIPIUL CLUJ-NAPOCA",80,"Gradinita Lumea Copiilor (fosta nr.20), Strada Brasov nr.27",2150,1331,1312,15,4,1307,24,2365,1034,645,662,1,5348,0
13,"Cluj",54975,127,54975,,"MUNICIPIUL CLUJ-NAPOCA",81,"Gradinita Poienita (fosta 67), Strada Alverna nr.63",2102,1231,1188,41,2,1219,12,2310,1079,783,436,1,5348,0
13,"Cluj",54975,127,54975,,"MUNICIPIUL CLUJ-NAPOCA",82,"Scoala ""Constantin Brancusi"", Strada Horticultorilor nr.1",1924,1031,982,48,1,1021,10,2115,1084,653,368,1,5348,0
13,"Cluj",54975,127,54975,,"MUNICIPIUL CLUJ-NAPOCA",83,"Scoala ""Constantin Brancusi"", Strada Horticultorilor nr.1",1970,1058,1035,22,1,1046,12,1970,912,591,455,1,5348,0
13,"Cluj",54975,127,54975,,"MUNICIPIUL CLUJ-NAPOCA",84,"Scoala ""Constantin Brancusi"", Strada Horticultorilor nr.1",1682,926,912,13,1,916,10,1850,924,518,398,1,5348,0
13,"Cluj",54975,127,54975,,"MUNICIPIUL CLUJ-NAPOCA",85,"Gradinita Mamaruta (fosta nr.42), Strada Septimiu Albini nr.53",1049,597,587,10,0,590,7,1157,560,346,244,1,5348,0
13,"Cluj",54975,127,54975,,"MUNICIPIUL CLUJ-NAPOCA",86,"Scoala Speciala nr.1 (fosta Scoala nr.22), Strada Septimiu Albini nr.91",1572,911,897,14,0,904,7,1725,814,551,353,1,5348,0
13,"Cluj",54975,127,54975,,"MUNICIPIUL CLUJ-NAPOCA",87,"Scoala Speciala nr.1 (fosta Scoala nr.22), Strada Septimiu Albini nr.91",1805,901,888,11,2,889,12,1805,904,534,355,1,5348,0
13,"Cluj",54975,127,54975,,"MUNICIPIUL CLUJ-NAPOCA",88,"Gradinita  Lumea Copiilor (fosta 20), Strada Septimiu Albini nr.91",1602,757,741,16,0,752,5,1760,1003,511,241,1,5348,0
13,"Cluj",54975,127,54975,,"MUNICIPIUL CLUJ-NAPOCA",89,"Gradinita  Lumea Copiilor (fosta 20), Strada Septimiu Albini nr.91",1891,1001,984,17,0,988,13,2080,1079,635,353,1,5348,0
13,"Cluj",54975,127,54975,,"MUNICIPIUL CLUJ-NAPOCA",90,"Liceul Teoretic ""Lucian Blaga"", Aleea Baisoara nr.2-4",1984,1079,1066,13,0,1061,18,2180,1101,642,419,1,5348,0
13,"Cluj",54975,127,54975,,"MUNICIPIUL CLUJ-NAPOCA",91,"Liceul Teoretic ""Lucian Blaga"", Aleea Baisoara nr.2-4",1512,870,857,12,1,862,8,1660,790,422,440,1,5348,0
13,"Cluj",54975,127,54975,,"MUNICIPIUL CLUJ-NAPOCA",92,"Liceul Teoretic ""Lucian Blaga"", Aleea Baisoara nr.2-4",1294,683,673,10,0,676,7,1420,737,340,336,1,5348,0
13,"Cluj",54975,127,54975,,"MUNICIPIUL CLUJ-NAPOCA",93,"Liceul Teoretic ""Lucian Blaga"", Aleea Baisoara nr.2-4",1718,902,889,12,1,891,11,1890,988,528,363,1,5348,0
13,"Cluj",54975,127,54975,,"MUNICIPIUL CLUJ-NAPOCA",94,"Scoala N.Titulescu, Aleea Herculane nr.7",1704,973,956,17,0,963,10,1861,888,505,458,1,5348,0
13,"Cluj",54975,127,54975,,"MUNICIPIUL CLUJ-NAPOCA",95,"Grupul Scolar Al. Borza, Strada Al.  Vaida Voievod nr.57",1866,1062,1049,13,0,1053,9,2050,988,558,495,1,5348,0
13,"Cluj",54975,127,54975,,"MUNICIPIUL CLUJ-NAPOCA",96,"Scoala N.Titulescu, Aleea Herculane nr.7",1625,930,916,14,0,917,13,1789,859,484,433,1,5348,0
13,"Cluj",54975,127,54975,,"MUNICIPIUL CLUJ-NAPOCA",97,"Colegiul Tehnic de Transporturi Transilvania Strada Bistritei nr.21",1704,952,943,8,1,941,11,1864,912,527,414,1,5348,0
13,"Cluj",54975,127,54975,,"MUNICIPIUL CLUJ-NAPOCA",98,"Colegiul Tehnic  Raluca Ripan, Strada Bistritei nr.21",2238,1342,1329,13,0,1324,18,2465,1123,789,535,1,5348,0
13,"Cluj",54975,127,54975,,"MUNICIPIUL CLUJ-NAPOCA",99,"Colegiul tehnic ""Energetic"", Strada N.Pascaly nr.2",1766,1002,990,11,1,989,13,1945,943,508,481,1,5348,0
13,"Cluj",54975,127,54975,,"MUNICIPIUL CLUJ-NAPOCA",100,"Universitatea ""Babes-Bolyai""-Facultatea de Stiinte Economice si Gestiunea Afacerilor, Strada Teodor Mihali, Nr.58-60",1976,1087,1069,18,0,1076,11,2175,1088,702,374,1,5348,0
13,"Cluj",54975,127,54975,,"MUNICIPIUL CLUJ-NAPOCA",101,"Universitatea ""Babes-Bolyai""-Facultatea de Stiinte Economice si Gestiunea Afacerilor, Strada Teodor Mihali, Nr.58-60",1843,936,920,16,0,931,5,2025,1089,598,333,1,5348,0
13,"Cluj",54975,127,54975,,"MUNICIPIUL CLUJ-NAPOCA",102,"Scoala ""Ion Agarbiceanu"",  Strada Gradinarilor nr.1",1845,1037,1026,11,0,1028,9,2032,995,686,342,1,5348,0
13,"Cluj",54975,127,54975,,"MUNICIPIUL CLUJ-NAPOCA",103,"Scoala ""Ion Agarbiceanu"", Strada Gradinarilor nr.1",1849,1086,1073,13,0,1079,7,2034,948,761,318,1,5348,0
13,"Cluj",54975,127,54975,,"MUNICIPIUL CLUJ-NAPOCA",104,"Scoala ""Ion Agarbiceanu"",  Strada Gradinarilor nr.1",2015,1066,1054,12,0,1060,6,2220,1154,742,318,1,5348,0
13,"Cluj",54975,127,54975,,"MUNICIPIUL CLUJ-NAPOCA",105,"Gradinita Mamaruta (fosta 42), Bulevardul 21 Decembrie 1989 nr.124",2079,1199,1187,11,1,1192,7,2188,989,743,449,1,5348,0
13,"Cluj",54975,127,54975,,"MUNICIPIUL CLUJ-NAPOCA",106,"Colegiu tehnic ""Anghel Saligny"",Bulevardul 21 Decembrie 1989 nr.128",1885,1052,1043,9,0,1043,9,2075,1023,683,360,1,5348,0
13,"Cluj",54975,127,54975,,"MUNICIPIUL CLUJ-NAPOCA",107,"Colegiu tehnic ""Anghel Saligny"",Bulevardul 21 Decembrie 1989 nr.128",1822,1083,1068,15,0,1072,11,2000,917,701,371,1,5348,0
13,"Cluj",54975,127,54975,,"MUNICIPIUL CLUJ-NAPOCA",108,"Colegiu tehnic ""Anghel Saligny"",Bulevardul 21 Decembrie 1989 nr.128",2026,1213,1099,16,98,1202,11,2225,1012,838,364,1,5348,0
13,"Cluj",54975,127,54975,,"MUNICIPIUL CLUJ-NAPOCA",109,"Scoala ""Ion Agarbiceanu"",  Strada Gradinarilor nr.1",2063,1174,1161,13,0,1159,15,2265,1091,752,407,1,5348,0
13,"Cluj",54975,127,54975,,"MUNICIPIUL CLUJ-NAPOCA",110,"Liceul Teoretic ""Mihai Eminescu"",Bulevardul 21 Decembrie 1989 nr.98",1956,1074,1060,13,1,1057,17,2161,1087,617,440,1,5348,0
13,"Cluj",54975,127,54975,,"MUNICIPIUL CLUJ-NAPOCA",111,"Scoala ""S. Barnutiu"", Strada Dorobantilor nr.72",1761,1021,972,13,36,1010,11,1935,914,570,440,1,5348,0
13,"Cluj",54975,127,54975,,"MUNICIPIUL CLUJ-NAPOCA",112,"Scoala ""S. Barnutiu"", Strada Dorobantilor nr.72",1930,1235,1204,31,0,1224,11,2122,887,650,574,1,5348,0
13,"Cluj",54975,127,54975,,"MUNICIPIUL CLUJ-NAPOCA",113,"Scoala ""S. Barnutiu"", Strada Dorobantilor nr.72",1917,1103,1094,9,0,1094,9,2110,1007,706,388,1,5348,0
13,"Cluj",54975,127,54975,,"MUNICIPIUL CLUJ-NAPOCA",114,"Grupul Scolar MR ""Unirea"", Strada Paris nr.60",2157,1161,1152,9,0,1153,8,2375,1214,712,441,1,5348,0
13,"Cluj",54975,127,54975,,"MUNICIPIUL CLUJ-NAPOCA",115,"Liceul Teoretic ""A. Iancu"", Strada Onisifor Ghibu nr.25",1922,1009,992,16,1,997,12,2110,1101,613,384,1,5348,0
13,"Cluj",54975,127,54975,,"MUNICIPIUL CLUJ-NAPOCA",116,"Scoala ""David Prodan"", Strada Meseriilor nr.20",1818,924,905,19,0,915,9,2000,1076,644,271,1,5348,0
13,"Cluj",54975,127,54975,,"MUNICIPIUL CLUJ-NAPOCA",117,"Scoala ""David Prodan"", Strada Meseriilor nr.20",1304,658,645,12,1,649,9,1430,772,410,239,1,5348,0
13,"Cluj",54975,127,54975,,"MUNICIPIUL CLUJ-NAPOCA",118,"Scoala ""Horea"", Strada Horea nr.19/A",1677,854,837,17,0,842,12,1845,991,445,397,1,5348,0
13,"Cluj",54975,127,54975,,"MUNICIPIUL CLUJ-NAPOCA",119,"Liceul ""N. Balcescu"", Strada Constanta nr.6",1671,857,839,17,1,846,11,1835,978,427,419,1,5348,0
13,"Cluj",54975,127,54975,,"MUNICIPIUL CLUJ-NAPOCA",120,"Liceul ""Brassai Samuel"",Bulevardul 21 Decembrie 1989 nr.9",1652,780,764,15,1,764,16,1815,1035,385,379,1,5348,0
13,"Cluj",54975,127,54975,,"MUNICIPIUL CLUJ-NAPOCA",121,"Pavilionul ""Expo Transilvania"", Strada Aurel Vlaicu F.N.",1916,1069,1062,7,0,1055,14,2110,1041,779,276,1,5348,0
13,"Cluj",54975,127,54975,,"MUNICIPIUL CLUJ-NAPOCA",122,"Pavilionul ""Expo Transilvania"", Strada Aurel Vlaicu F.N.",1946,1130,1119,11,0,1125,5,2145,1015,747,378,1,5348,0
13,"Cluj",54975,127,54975,,"MUNICIPIUL CLUJ-NAPOCA",123,"Pavilionul ""Expo Transilvania"", Strada Aurel Vlaicu F.N.",1961,1145,1130,14,1,1139,6,2153,1008,795,344,1,5348,0
13,"Cluj",54975,127,54975,,"MUNICIPIUL CLUJ-NAPOCA",124,"Pavilionul ""Expo Transilvania"", Strada Aurel Vlaicu F.N.",1961,1023,1010,13,0,1012,11,2154,1131,741,271,1,5348,0
13,"Cluj",54975,127,54975,,"MUNICIPIUL CLUJ-NAPOCA",125,"Pavilionul ""Expo Transilvania"", Strada Aurel Vlaicu F.N.",1921,937,922,15,0,927,10,2110,1173,734,193,1,5348,0
13,"Cluj",54975,127,54975,,"MUNICIPIUL CLUJ-NAPOCA",126,"Pavilionul ""Expo Transilvania"", Strada Aurel Vlaicu F.N.",1919,951,942,9,0,945,6,2115,1164,717,228,1,5348,0
13,"Cluj",54975,127,54975,,"MUNICIPIUL CLUJ-NAPOCA",127,"Gradinita Degetica (fosta 53), Strada Tarnavelor nr.22",1889,1043,1035,8,0,1036,7,2080,1037,730,306,1,5348,0
13,"Cluj",54975,127,54975,,"MUNICIPIUL CLUJ-NAPOCA",128,"Gradinita Degetica (fosta 53), Strada Tarnavelor nr.22",1958,1054,1036,18,0,1051,3,2155,1101,823,228,1,5348,0
13,"Cluj",54975,127,54975,,"MUNICIPIUL CLUJ-NAPOCA",129,"Scoala Al. Vaida Voievod Strada Oltului nr.83",1764,920,911,9,0,918,2,1940,1020,682,236,1,5348,0
13,"Cluj",54975,127,54975,,"MUNICIPIUL CLUJ-NAPOCA",130,"Scoala Al. Vaida Voievod Strada Oltului nr.83",1684,919,914,5,0,915,4,1850,931,653,262,1,5348,0
13,"Cluj",54975,127,54975,,"MUNICIPIUL CLUJ-NAPOCA",131,"Scoala Al. Vaida Voievod Strada Oltului nr.83",1449,779,768,11,0,768,11,1595,816,587,181,1,5348,0
13,"Cluj",54975,127,54975,,"MUNICIPIUL CLUJ-NAPOCA",132,"Scoala Al. Vaida Voievod Strada Oltului nr.83",2013,1071,1060,11,0,1064,7,2210,1139,746,318,1,5348,0
13,"Cluj",54975,127,54975,,"MUNICIPIUL CLUJ-NAPOCA",133,"Scoala de Arte si Meserii Samus Strada Fabricii de Zahar nr.51",1751,934,928,6,0,925,9,1919,985,608,317,1,5348,0
13,"Cluj",54975,127,54975,,"MUNICIPIUL CLUJ-NAPOCA",134,"Scoala de Arte si Meserii Samus Strada Fabricii de Zahar nr.51",2079,1136,1126,10,0,1124,12,2290,1154,841,283,1,5348,0
13,"Cluj",54975,127,54975,,"MUNICIPIUL CLUJ-NAPOCA",135,"Scoala de Arte si Meserii Samus Strada Fabricii de Zahar nr.51",1569,875,870,5,0,873,2,1730,855,558,315,1,5348,0
13,"Cluj",54975,127,54975,,"MUNICIPIUL CLUJ-NAPOCA",136,"Grup Scolar Chimie Industriala ""Terapia"" Strada Decebal (K. Marx) nr.41",1859,880,854,10,16,871,9,2052,1172,563,308,1,5348,0
13,"Cluj",54975,127,54975,,"MUNICIPIUL CLUJ-NAPOCA",137,"Grup Scolar Chimie Industriala ""Terapia"" Strada Decebal (K. Marx) nr.41",1772,913,881,30,2,903,10,1544,631,537,366,1,5348,0
13,"Cluj",54975,127,54975,,"MUNICIPIUL CLUJ-NAPOCA",138,"Grup Scolar  Protectia Mediului Strada Horea nr.51",995,573,560,13,0,561,12,1306,733,305,256,1,5348,0
13,"Cluj",54975,127,54975,,"MUNICIPIUL CLUJ-NAPOCA",139,"Scoala Horea (fosta nr.27) Strada 11 Octombrie nr.3",1530,887,870,17,0,873,14,1683,796,503,370,1,5348,0
13,"Cluj",54975,127,54975,,"MUNICIPIUL CLUJ-NAPOCA",140,"Liceul Teologic ""Emanuel "" Strada 11 Octombrie nr.3",1851,1031,1018,12,1,1024,7,2035,1004,671,353,1,5348,0
13,"Cluj",54975,127,54975,,"MUNICIPIUL CLUJ-NAPOCA",141,"Liceul Teologic ""Emanuel "" Strada 11 Octombrie nr.3",1376,748,739,9,0,741,7,1515,767,447,294,1,5348,0
13,"Cluj",54975,127,54975,,"MUNICIPIUL CLUJ-NAPOCA",142,"Scoala ""Emil Isac"" ( fosta Scoala nr.9) Calea Baciului nr.18",1664,907,894,13,0,896,11,1830,923,663,233,1,5348,0
13,"Cluj",54975,127,54975,,"MUNICIPIUL CLUJ-NAPOCA",143,"Scoala ""Emil Isac"" ( fosta Scoala nr.9) Calea Baciului nr.18",1253,671,664,7,0,670,1,1371,700,497,173,1,5348,0
13,"Cluj",54975,127,54975,,"MUNICIPIUL CLUJ-NAPOCA",144,"Liceul Waldorf, Strada Corneliu Coposu nr. 20",1477,820,798,21,1,813,7,1625,805,585,228,1,5348,0
13,"Cluj",54975,127,54975,,"MUNICIPIUL CLUJ-NAPOCA",145,"Liceul Waldorf, Strada Corneliu Coposu nr. 20",2046,1103,1085,18,0,1095,8,2255,1152,764,331,1,5348,0
13,"Cluj",54975,127,54975,,"MUNICIPIUL CLUJ-NAPOCA",146,"Scoala""Emil Isac"",Strada Giordano Bruno nr.46",2021,1133,1122,11,0,1127,6,2220,1087,738,389,1,5348,0
13,"Cluj",54975,127,54975,,"MUNICIPIUL CLUJ-NAPOCA",147,"Scoala ""Nicolae Iorga"" ,Strada Razboieni nr.67",1556,803,786,17,0,794,9,1715,912,584,210,1,5348,0
13,"Cluj",54975,127,54975,,"MUNICIPIUL CLUJ-NAPOCA",148,"Scoala ""Nicolae Iorga"" ,Strada Razboieni nr.67",1963,1043,1018,25,0,1041,2,2155,1112,761,280,1,5348,0
13,"Cluj",54975,127,54975,,"MUNICIPIUL CLUJ-NAPOCA",149,"Scoala ""Nicolae Iorga"" ,Strada Razboieni nr.67",2049,1076,1063,13,0,1062,14,2255,1179,734,328,1,5348,0
13,"Cluj",54975,127,54975,,"MUNICIPIUL CLUJ-NAPOCA",150,"Grup Scolar ""Tehnofrig"",Strada Maramuresului nr.165/A",1867,770,751,19,0,766,4,2030,1260,628,138,1,5348,0
13,"Cluj",54975,127,54975,,"MUNICIPIUL CLUJ-NAPOCA",151,"Grup Scolar ""Tehnofrig"",Strada Maramuresului nr.165/A",1205,602,586,15,1,598,4,1323,721,447,151,1,5348,0
13,"Cluj",54975,127,54975,,"MUNICIPIUL CLUJ-NAPOCA",152,"Grup Scolar ""Aurel Vlaicu"",Bulevardul Muncii nr.189",2087,976,949,27,0,973,3,2300,1324,769,204,1,5348,0
13,"Cluj",54975,127,54975,,"MUNICIPIUL CLUJ-NAPOCA",153,"Garaje RATUC Strada Plevnei nr.12",2037,1022,1002,20,0,1010,12,2245,1223,729,281,1,5348,0
13,"Cluj",54975,127,54975,,"MUNICIPIUL CLUJ-NAPOCA",154,"Scoala ""Traian Darjan"" Strada Traian Vuia nr.76",2498,1382,1359,23,0,1368,14,2750,1368,1070,298,1,5348,0
13,"Cluj",54975,127,54975,,"MUNICIPIUL CLUJ-NAPOCA",155,"Scoala ""Traian Darjan"" Strada Traian Vuia nr.76",1653,1001,987,14,0,996,5,1815,814,760,236,1,5348,0
13,"Cluj",54975,127,54975,,"MUNICIPIUL CLUJ-NAPOCA",156,"Scoala ""Traian Darjan"" Strada Traian Vuia nr.76",1437,854,840,14,0,848,6,1585,731,605,243,1,5348,0
13,"Cluj",54975,127,54975,,"MUNICIPIUL CLUJ-NAPOCA",157,"Aeroportul international Cluj-Napoca,Cluj-Napoca,Strada Traian Vuia nr.149,",0,1246,0,1246,0,1241,5,2078,832,804,437,1,5348,1
13,"Cluj",54975,127,54975,,"MUNICIPIUL CLUJ-NAPOCA",158,"Gara Cluj-Napoca ,Cluj-Napoca,Piata Garii nr.1-3",0,1702,0,1702,0,1686,16,2800,1098,1117,569,1,5348,1
13,"Cluj",54975,127,54975,,"MUNICIPIUL CLUJ-NAPOCA",159,"Gara Cluj-Napoca ,Cluj-Napoca,Piata Garii nr.1-3",0,1493,0,1493,0,1473,20,2410,917,941,532,1,5348,1
13,"Cluj",54975,127,54975,,"MUNICIPIUL CLUJ-NAPOCA",160,"Cantina Complex Studentesc Observator , Cluj-Napoca,Strada Observator nr.34",0,2059,0,2059,0,2010,49,2680,621,1295,715,1,5348,1
13,"Cluj",54975,127,54975,,"MUNICIPIUL CLUJ-NAPOCA",161,"Complex Studentesc Marasti, Cluj-Napoca,Strada Fabricii de Zahar nr.58",0,1660,0,1660,0,1642,18,3000,1340,1123,519,1,5348,1
13,"Cluj",54975,127,54975,,"MUNICIPIUL CLUJ-NAPOCA",162,"Cantina Complex Studentesc Hasdeu, Cluj-Napoca,Strada Hasdeu nr.45",0,1985,0,1985,0,1937,48,2300,315,1217,720,1,5348,1
13,"Cluj",54975,127,54975,,"MUNICIPIUL CLUJ-NAPOCA",163,"Cantina Complex Studentesc Hasdeu, Cluj-Napoca,Strada Hasdeu nr.45",0,1702,0,1702,0,1662,40,2560,858,1032,630,1,5348,1
13,"Cluj",54975,127,54975,,"MUNICIPIUL CLUJ-NAPOCA",164,"Spitalul Clinic de Recuperare ,Cluj-Napoca, Strada Viilor nr.46-50",0,966,0,966,0,951,15,1597,631,605,346,1,5348,1
13,"Cluj",54975,127,54975,,"MUNICIPIUL CLUJ-NAPOCA",165,"Spitalul Clinic Judetean de Urgenta, Cluj-Napoca,Strada Clinicilor nr .3-5",0,519,0,519,0,512,7,2701,2182,360,152,1,5348,1
13,"Cluj",54975,127,54975,,"MUNICIPIUL CLUJ-NAPOCA",166,"Spitalul Clinic Municipal Cluj-Napoca,Cluj-Napoca,Strada Tabacarilor nr.11",0,174,0,174,0,174,0,902,728,103,71,1,5348,1
13,"Cluj",54975,127,54975,,"MUNICIPIUL CLUJ-NAPOCA",167,"Spitalul Clinic de Urgenta ""prof dr. Octavian Fodor "",Cluj-Napoca,Strada Croitorilor nr.19-21",0,444,0,444,0,437,7,700,256,255,182,1,5348,1
13,"Cluj",54975,127,54975,,"MUNICIPIUL CLUJ-NAPOCA",168,"Spitalul clinic de Boli Infectioase Cluj-Napoca, Cluj-Napoca,Strada Iuliu Moldovan nr.23",0,184,0,184,0,179,5,499,315,107,72,1,5348,1
13,"Cluj",54975,127,54975,,"MUNICIPIUL CLUJ-NAPOCA",169,"Institutul Oncologic ""prof. dr. Ion Chiricuta "" , Cluj-Napoca, Strada Republicii nr.34-36",0,740,0,740,0,728,12,2089,1349,418,310,1,5348,1
13,"Cluj",54975,127,54975,,"MUNICIPIUL CLUJ-NAPOCA",170,"Institutul Inimii ""Nicolae Stancioiu"", Cluj-Napoca,Strada Motilor nr.19-21",0,930,0,930,0,914,16,2110,1180,537,377,1,5348,1
13,"Cluj",54975,127,54975,,"MUNICIPIUL CLUJ-NAPOCA",171,"Spitalul Militar de Urgenta  "" Dr. Constantin Papilian "" ,Cluj-Napoca,Strada Traian Mosoiu nr.22",0,994,0,994,0,985,9,2000,1006,589,396,1,5348,1
13,"Cluj",54975,127,54975,,"MUNICIPIUL CLUJ-NAPOCA",172,"Universitatea Babes-Bolyai-Fac.de Stiinte Economice si Gestiunea Afacerilor, Cluj-Napoca,Strada Teodor Mihali, nr.58-60",0,2118,0,2118,0,2098,20,2395,277,1357,741,1,5348,1
13,"Cluj",55357,127,55357,,"MUNICIPIUL CAMPIA TURZII",173,"Colegiul tehnic "" V. Ungureanu"" ,Strada Laminoristilor , nr. 115",1894,896,856,40,0,888,8,2080,1184,571,317,1,5350,0
13,"Cluj",55357,127,55357,,"MUNICIPIUL CAMPIA TURZII",174,"Colegiul tehnic "" V. Ungureanu"" ,Strada Laminoristilor , nr. 115",1811,854,835,19,0,837,17,1990,1136,576,261,1,5350,0
13,"Cluj",55357,127,55357,,"MUNICIPIUL CAMPIA TURZII",175,"Scoala generala nr.3 ""Iuliu Deac"" ,Strada Gh. Lazar, nr.14",1880,984,973,11,0,977,7,2068,1084,574,403,1,5350,0
13,"Cluj",55357,127,55357,,"MUNICIPIUL CAMPIA TURZII",176,"Scoala generala nr.2 ""A. Iancu"" , Strada Noua , nr.8",1970,1030,1021,9,0,1010,20,2167,1137,532,478,1,5350,0
13,"Cluj",55357,127,55357,,"MUNICIPIUL CAMPIA TURZII",177,"Scoala generala nr.2 ""A. Iancu"" , Strada Noua , nr.8",1926,949,936,12,1,934,15,2120,1171,533,401,1,5350,0
13,"Cluj",55357,127,55357,,"MUNICIPIUL CAMPIA TURZII",178,"Gradinita nr.8, Strada Retezatului, nr. 6 A",1422,766,757,8,1,761,5,1565,799,462,299,1,5350,0
13,"Cluj",55357,127,55357,,"MUNICIPIUL CAMPIA TURZII",179,"Gradinita nr.8, Strada Retezatului, nr. 6 A",1440,633,623,10,0,629,4,1584,951,397,232,1,5350,0
13,"Cluj",55357,127,55357,,"MUNICIPIUL CAMPIA TURZII",180,"Gradinita nr.8, Strada Retezatului, nr. 6 A",1414,730,712,17,1,723,7,1555,825,444,279,1,5350,0
13,"Cluj",55357,127,55357,,"MUNICIPIUL CAMPIA TURZII",181,"Scoala generala nr. 1 "" M. Viteazu"" , Strada Gh. Baritiu, nr.57",1980,950,941,9,0,943,7,2178,1228,617,326,1,5350,0
13,"Cluj",55357,127,55357,,"MUNICIPIUL CAMPIA TURZII",182,"Scoala generala nr. 1 "" M. Viteazu"" , Strada Gh. Baritiu, nr.57",1898,908,897,11,0,903,5,2090,1182,607,296,1,5350,0
13,"Cluj",55357,127,55357,,"MUNICIPIUL CAMPIA TURZII",183,"Scoala generala nr. 1 "" M. Viteazu"" , Strada Gh. Baritiu, nr.57",1814,764,752,12,0,757,7,1995,1231,546,211,1,5350,0
13,"Cluj",55357,127,55357,,"MUNICIPIUL CAMPIA TURZII",184,"Liceul teoretic "" P.Dan"" ( cls. I-IV ) , Strada T.Vladimirescu, nr.33",1044,499,491,8,0,495,4,1145,646,302,193,1,5350,0
13,"Cluj",55357,127,55357,,"MUNICIPIUL CAMPIA TURZII",185,"Liceul teoretic "" P.Dan"" , Strada 1 Decembrie 1918, nr.17",1964,970,955,15,0,965,5,2160,1190,652,313,1,5350,0
13,"Cluj",55357,127,55357,,"MUNICIPIUL CAMPIA TURZII",186,"Liceul teoretic "" P.Dan"" , Strada 1 Decembrie 1918, nr.17",1871,974,962,12,0,967,7,2060,1086,514,453,1,5350,0
13,"Cluj",55357,127,55357,,"MUNICIPIUL CAMPIA TURZII",187,"Liceul Teoretic ""Pavel Dan"" Campia Turzii , Strada 1 Decembrie 1918 , nr. 17",0,377,0,377,0,374,3,500,123,249,125,1,5350,1
13,"Cluj",55008,127,55008,,"MUNICIPIUL DEJ",188,"Autogara din DEJ, Strada Bistritei nr. 2",1097,550,540,10,0,549,1,1210,660,272,277,1,5352,0
13,"Cluj",55008,127,55008,,"MUNICIPIUL DEJ",189,"Scoala Generala nr. 1 Dej, Strada Marasesti nr. 2",1619,854,836,15,3,844,10,1785,931,448,396,1,5352,0
13,"Cluj",55008,127,55008,,"MUNICIPIUL DEJ",190,"Gradinita de copii din Dej , Strada 1 Mai , nr. 12",915,400,385,15,0,397,3,1215,815,261,136,1,5352,0
13,"Cluj",55008,127,55008,,"MUNICIPIUL DEJ",191,"Gradinita de copii din Dej , Strada 1 Mai , nr. 12",957,538,527,11,0,530,8,1055,517,270,260,1,5352,0
13,"Cluj",55008,127,55008,,"MUNICIPIUL DEJ",192,"Scoala Generala nr. 3 din Dej , Strada Avram Iancu, nr. 2",1575,930,913,17,0,923,7,1735,805,463,460,1,5352,0
13,"Cluj",55008,127,55008,,"MUNICIPIUL DEJ",193,"Liceul Teoretic din Dej, Piata Lupeni nr.2",1602,830,818,12,0,827,3,1760,930,421,406,1,5352,0
13,"Cluj",55008,127,55008,,"MUNICIPIUL DEJ",194,"Caminul de Copii din Dej, Strada Infratirii nr.30",1559,817,810,7,0,809,8,1715,898,401,408,1,5352,0
13,"Cluj",55008,127,55008,,"MUNICIPIUL DEJ",195,"Ocolul Silvic Dej , Strada Nicolae Iorga nr. 5",1499,819,765,18,36,808,11,1650,831,449,359,1,5352,0
13,"Cluj",55008,127,55008,,"MUNICIPIUL DEJ",196,"Agentia Plati Interventii Agricultura , Strada Corneliu Coposu nr. 13",1570,850,828,22,0,841,9,1727,877,400,441,1,5352,0
13,"Cluj",55008,127,55008,,"MUNICIPIUL DEJ",197,"Scoala Generala Dej , Strada Valea Codorului   nr. 72",767,445,437,8,0,443,2,845,400,220,223,1,5352,0
13,"Cluj",55008,127,55008,,"MUNICIPIUL DEJ",198,"Scoala Generala nr. 2 Dej ,Strada Marasti nr. 5 A",1581,805,793,12,0,802,3,1740,935,419,383,1,5352,0
13,"Cluj",55008,127,55008,,"MUNICIPIUL DEJ",199,"Tipografia "" Sprint"" Dej , Strada Ecaterina Teodoroiu nr. 71",1515,782,768,14,0,778,4,1665,883,379,399,1,5352,0
13,"Cluj",55008,127,55008,,"MUNICIPIUL DEJ",200,"Sediul Serviciului de Administrare al Domeniului Public Dej, Strada Cringului fn",1642,811,798,13,0,810,1,1805,994,456,354,1,5352,0
13,"Cluj",55008,127,55008,,"MUNICIPIUL DEJ",201,"Scoala Generala nr. 5  Dej, Strada Pepineriei nr. 6 ( Intrarea principala )",1672,840,833,7,0,832,8,1835,995,476,356,1,5352,0
13,"Cluj",55008,127,55008,,"MUNICIPIUL DEJ",202,"Scoala Generala nr. 5  Dej, Strada Pepineriei nr. 6 ( Intrarea  secundara )",1601,860,840,19,1,859,1,1760,900,409,450,1,5352,0
13,"Cluj",55008,127,55008,,"MUNICIPIUL DEJ",203,"Cresa de Copii din Dej , Aleea Tomis nr. 4",1031,550,535,14,1,545,5,1130,580,275,270,1,5352,0
13,"Cluj",55008,127,55008,,"MUNICIPIUL DEJ",204,"Cresa de Copii din Dej , Aleea Tomis nr. 4",1317,673,659,14,0,668,5,1220,547,393,275,1,5352,0
13,"Cluj",55008,127,55008,,"MUNICIPIUL DEJ",205,"Cresa de Copii din Dej , Aleea Tomis nr. 4",1466,761,744,16,1,758,3,1615,854,389,369,1,5352,0
13,"Cluj",55008,127,55008,,"MUNICIPIUL DEJ",206,"Caminul de Copii al S.C. Somes S.A. Dej, Strada Unirii nr. 1",1331,707,695,12,0,701,6,1460,753,341,360,1,5352,0
13,"Cluj",55008,127,55008,,"MUNICIPIUL DEJ",207,"Caminul de Copii nr. 10 Dej, Strada Aurora nr. 3",1570,712,698,12,2,705,7,1726,1014,430,275,1,5352,0
13,"Cluj",55008,127,55008,,"MUNICIPIUL DEJ",208,"Scoala Generala nr. 4 Dej , Strada Aurora nr.5",1552,745,732,13,0,741,4,1705,960,418,323,1,5352,0
13,"Cluj",55008,127,55008,,"MUNICIPIUL DEJ",209,"Cartier Ocna Dej, Scoala Generala Ocna Dej, Strada Mixandrelor , nr. 2 / A",926,520,509,11,0,516,4,1020,500,365,151,1,5352,0
13,"Cluj",55008,127,55008,,"MUNICIPIUL DEJ",210,"Cartier Ocna Dej ,Scoala Generala Ocna Dej, Strada Mixandrelor , nr. 2 / A",1270,637,628,9,0,631,6,1397,760,413,218,1,5352,0
13,"Cluj",55008,127,55008,,"MUNICIPIUL DEJ",211,"Cartier Viile Dejului, Scoala Generala Viile Dejului",1396,670,665,5,0,666,4,1535,865,373,293,1,5352,0
13,"Cluj",55008,127,55008,,"MUNICIPIUL DEJ",212,"Sat Somcutu Mic , Scoala Generala Somcutu Mic",470,313,289,24,0,310,3,510,197,202,108,1,5352,0
13,"Cluj",55008,127,55008,,"MUNICIPIUL DEJ",213,"Sat Pintic , Scoala Generala Pintic",236,105,84,21,0,103,2,260,155,62,41,1,5352,0
13,"Cluj",55008,127,55008,,"MUNICIPIUL DEJ",214,"Gara CFR Dej - calatori , Dej , Strada 1 Mai nr. 63",0,463,0,463,0,456,7,500,37,273,183,1,5352,1
13,"Cluj",55384,127,55384,,"MUNICIPIUL GHERLA",215,"Liceul Petru Maior, Gherla, Strada Bobalna nr. 36 , Sala numarul 4",1868,1325,1031,2,292,1308,17,2055,730,760,548,1,5358,0
13,"Cluj",55384,127,55384,,"MUNICIPIUL GHERLA",216,"Liceul Petru Maior, Gherla, Strada Bobalna nr. 36 , Sala numarul 7",1539,844,834,8,2,833,11,1695,851,449,384,1,5358,0
13,"Cluj",55384,127,55384,,"MUNICIPIUL GHERLA",217,"Scoala Generala nr. 2 , Gherla,Strada  Bobalna  Nr. 14, Clasa  I C",1552,884,871,11,2,881,3,1705,821,477,404,1,5358,0
13,"Cluj",55384,127,55384,,"MUNICIPIUL GHERLA",218,"Scoala Generala nr. 1 , Gherla , Strada L.Rebreanu , Nr. 27 , Clasa III B",1718,937,930,7,0,933,4,1890,953,515,418,1,5358,0
13,"Cluj",55384,127,55384,,"MUNICIPIUL GHERLA",219,"Scoala Generala nr. 1 , Gherla , Strada L. Rebreanu Nr. 27 , clasa I B",1794,933,926,7,0,921,12,1970,1037,525,396,1,5358,0
13,"Cluj",55384,127,55384,,"MUNICIPIUL GHERLA",220,"Scoala Generala nr. 2, Gherla , Strada Dragos Voda Nr.3, Clasa VI B",1894,989,976,13,0,980,9,2080,1091,569,411,1,5358,0
13,"Cluj",55384,127,55384,,"MUNICIPIUL GHERLA",221,"Liceul Ana Ipatescu, Gherla Strada 1 Decembrie 1918 nr. 20 , Clasa XI  B",2106,1095,1089,5,1,1082,13,2320,1225,615,467,1,5358,0
13,"Cluj",55384,127,55384,,"MUNICIPIUL GHERLA",222,"Liceul Ana Ipatescu, Gherla Strada 1 Decembrie 1918 nr. 20 , Clasa XII  C",1997,1001,1000,1,0,994,7,2200,1199,638,356,1,5358,0
13,"Cluj",55384,127,55384,,"MUNICIPIUL GHERLA",223,"Liceul Ana Ipatescu, Gherla Strada 1 Decembrie 1918 nr. 20 , Clasa VI A",2169,1159,1156,3,0,1153,6,2390,1231,682,471,1,5358,0
13,"Cluj",55384,127,55384,,"MUNICIPIUL GHERLA",224,"Clubul Copiilor Gherla , Strada 1 Decembrie 1918 Nr.12, Sala Cercul de Muzica",2054,1013,1003,10,0,1008,5,2260,1247,621,387,1,5358,0
13,"Cluj",55384,127,55384,,"MUNICIPIUL GHERLA",225,"Localitatea Baita , Scoala Generala",385,193,180,13,0,191,2,425,232,127,64,1,5358,0
13,"Cluj",55384,127,55384,,"MUNICIPIUL GHERLA",226,"Localitatea Hasdate , Scoala Generala",271,149,136,13,0,147,2,300,151,82,65,1,5358,0
13,"Cluj",55384,127,55384,,"MUNICIPIUL GHERLA",227,"Localitatea Silivas , Scoala Generala",164,91,80,11,0,89,2,180,89,62,27,1,5358,0
13,"Cluj",55384,127,55384,,"MUNICIPIUL GHERLA",228,"Autogara Mun.Gherla, Strada Romana nr.2",0,167,0,167,0,165,2,300,133,100,65,1,5358,1
13,"Cluj",55384,127,55384,,"MUNICIPIUL GHERLA",229,"Gara Mun. Gherla, Gherla , Piata Unirii nr.6",0,212,0,212,0,211,1,300,88,137,74,1,5358,1
13,"Cluj",55259,127,55259,,"MUNICIPIUL TURDA",230,"Scoala ""Teodor Muresanu "", Strada Bogdan Petriceicu Hasdeu , numarul 4 , sala de clasa",1211,619,609,8,2,614,5,1328,709,360,254,1,5363,0
13,"Cluj",55259,127,55259,,"MUNICIPIUL TURDA",231,"Scoala ""Teodor Muresanu "", Strada Dr. Ioan Ratiu , numarul 53, sala de clasa",1782,947,935,11,1,940,7,1963,1016,541,399,1,5363,0
13,"Cluj",55259,127,55259,,"MUNICIPIUL TURDA",232,"Scoala ""Teodor Muresanu "", Strada Bogdan Petriceicu Hasdeu , numarul 4 , sala de clasa",1391,758,747,11,0,751,7,1530,772,446,305,1,5363,0
13,"Cluj",55259,127,55259,,"MUNICIPIUL TURDA",233,"Scoala "" Potaissa "", PIATA  Romana, numarul 12 , sala de clasa",1341,655,643,11,1,651,4,1475,820,422,229,1,5363,0
13,"Cluj",55259,127,55259,,"MUNICIPIUL TURDA",234,"Scoala "" Potaissa "", PIATA  Romana, numarul 12 , sala de clasa",1081,552,541,10,1,545,7,1184,632,332,213,1,5363,0
13,"Cluj",55259,127,55259,,"MUNICIPIUL TURDA",235,"Scoala "" George Baritiu "", Strada Constantin Brancoveanu, numarul 4, sala de clasa",1220,628,619,9,0,625,3,1381,753,397,228,1,5363,0
13,"Cluj",55259,127,55259,,"MUNICIPIUL TURDA",236,"Scoala "" George Baritiu "", Strada Constantin Brancoveanu, numarul 4, sala de clasa",1139,608,602,6,0,602,6,1255,647,387,215,1,5363,0
13,"Cluj",55259,127,55259,,"MUNICIPIUL TURDA",237,"Colegiul Tehnic Turda, Strada Basarabiei, numarul 48, sala de clasa",1305,687,678,9,0,676,11,1435,748,420,256,1,5363,0
13,"Cluj",55259,127,55259,,"MUNICIPIUL TURDA",238,"Colegiul Tehnic Turda, Strada Basarabiei, numarul 48, sala de clasa",1264,627,613,14,0,621,6,1383,756,389,232,1,5363,0
13,"Cluj",55259,127,55259,,"MUNICIPIUL TURDA",239,"Colegiul National "" Mihai Viteazul "", Strada Dr. Ioan Ratiu, numarul 111, sala de clasa",1111,599,585,14,0,594,5,1222,623,363,231,1,5363,0
13,"Cluj",55259,127,55259,,"MUNICIPIUL TURDA",240,"Colegiul "" Emil Negrutiu "", Strada Agriculturii, numarul 27, sala de clasa",1451,669,653,16,0,663,6,1595,926,483,180,1,5363,0
13,"Cluj",55259,127,55259,,"MUNICIPIUL TURDA",241,"Scoala ""Andrei Saguna "" , Strada Axente Sever, numarul 4, sala de clasa",1833,883,875,8,0,870,13,2015,1132,612,258,1,5363,0
13,"Cluj",55259,127,55259,,"MUNICIPIUL TURDA",242,"Scoala ""Andrei Saguna "" , Strada Axente Sever, numarul 4, sala de clasa",1496,794,777,16,1,788,6,1647,853,509,279,1,5363,0
13,"Cluj",55259,127,55259,,"MUNICIPIUL TURDA",243,"Colegiul "" Dr. Ioan Ratiu "", Strada Stefan cel Mare , numarul 6 , sala de clasa",1041,552,538,14,0,544,8,1145,593,407,137,1,5363,0
13,"Cluj",55259,127,55259,,"MUNICIPIUL TURDA",244,"Colegiul "" Dr. Ioan Ratiu "", Strada Stefan cel Mare , numarul 6 , sala de clasa",1046,492,480,12,0,485,7,1149,657,354,131,1,5363,0
13,"Cluj",55259,127,55259,,"MUNICIPIUL TURDA",245,"Scoala ""Avram Iancu"", Strada Rapsodiei, numarul 1B, sala de clasa",1053,542,527,15,0,536,6,1155,613,324,212,1,5363,0
13,"Cluj",55259,127,55259,,"MUNICIPIUL TURDA",246,"Scoala ""Avram Iancu"", Strada Rapsodiei, numarul 1B, sala de clasa",1075,544,535,9,0,538,6,1184,640,352,186,1,5363,0
13,"Cluj",55259,127,55259,,"MUNICIPIUL TURDA",247,"Scoala ""Avram Iancu"", Strada Rapsodiei, numarul 1B, sala de clasa",1529,793,776,17,0,791,2,1685,892,477,314,1,5363,0
13,"Cluj",55259,127,55259,,"MUNICIPIUL TURDA",248,"Scoala ""Avram Iancu"", Strada Rapsodiei, numarul 1B, sala de clasa",1370,647,636,11,0,644,3,1504,857,372,272,1,5363,0
13,"Cluj",55259,127,55259,,"MUNICIPIUL TURDA",249,"Scoala ""Ion Opris"", Strada Aviatorilor, numarul 1 sala de clasa",1360,707,699,7,1,698,9,1495,788,392,306,1,5363,0
13,"Cluj",55259,127,55259,,"MUNICIPIUL TURDA",250,"Scoala ""Ion Opris"", Strada Aviatorilor, numarul 1 sala de clasa",1084,596,585,11,0,590,6,1188,592,340,250,1,5363,0
13,"Cluj",55259,127,55259,,"MUNICIPIUL TURDA",251,"Scoala ""Ion Opris"", Strada Aviatorilor, numarul 1 sala de clasa",1495,734,720,12,2,728,6,1645,911,468,260,1,5363,0
13,"Cluj",55259,127,55259,,"MUNICIPIUL TURDA",252,"Liceul Teoretic ""Liviu Rebreanu"" , Strada Tineretului, numarul 6 sala de clasa",1503,762,755,7,0,756,6,1650,888,465,291,1,5363,0
13,"Cluj",55259,127,55259,,"MUNICIPIUL TURDA",253,"Liceul Teoretic ""Liviu Rebreanu"" , Strada Tineretului, numarul 6 sala de clasa",1966,982,972,10,0,974,8,2165,1183,664,310,1,5363,0
13,"Cluj",55259,127,55259,,"MUNICIPIUL TURDA",254,"Liceul Teoretic ""Liviu Rebreanu"" , Strada Tineretului, numarul 6 sala de clasa",1986,871,859,12,0,863,8,2186,1315,580,283,1,5363,0
13,"Cluj",55259,127,55259,,"MUNICIPIUL TURDA",255,"Liceul Teoretic ""Liviu Rebreanu"" , Strada Tineretului, numarul 6 sala de clasa",1578,746,736,10,0,742,4,1742,996,472,270,1,5363,0
13,"Cluj",55259,127,55259,,"MUNICIPIUL TURDA",256,"Liceul Teoretic ""Liviu Rebreanu"" , Strada Tineretului, numarul 6 sala de clasa",1720,832,819,13,0,825,7,1890,1058,510,315,1,5363,0
13,"Cluj",55259,127,55259,,"MUNICIPIUL TURDA",257,"Scoala ""Horea, Closca si Crisan"", Strada Lotus, numarul 7 sala de clasa",1650,784,771,13,0,778,6,1815,1031,515,263,1,5363,0
13,"Cluj",55259,127,55259,,"MUNICIPIUL TURDA",258,"Scoala ""Horea, Closca si Crisan"", Strada Lotus, numarul 7 sala de clasa",1973,924,912,11,1,917,7,2200,1276,620,297,1,5363,0
13,"Cluj",55259,127,55259,,"MUNICIPIUL TURDA",259,"Scoala ""Horea, Closca si Crisan"", Strada Lotus, numarul 7 sala de clasa",1120,547,533,14,0,546,1,1244,697,361,185,1,5363,0
13,"Cluj",55259,127,55259,,"MUNICIPIUL TURDA",260,"Scoala ""Horea, Closca si Crisan"", Strada Lotus, numarul 7 sala de clasa",1933,912,899,13,0,899,13,2100,1188,612,287,1,5363,0
13,"Cluj",55259,127,55259,,"MUNICIPIUL TURDA",261,"Scoala ""Horea, Closca si Crisan"", Strada Lotus, numarul 7 sala de clasa",1436,646,636,10,0,641,5,1580,934,458,183,1,5363,0
13,"Cluj",55259,127,55259,,"MUNICIPIUL TURDA",262,"Scoala ""Horea, Closca si Crisan"", Strada Lotus, numarul 7 sala de clasa",1789,861,852,9,0,856,5,1970,1109,568,288,1,5363,0
13,"Cluj",55259,127,55259,,"MUNICIPIUL TURDA",263,"Scoala de Arte si Meserii Poiana, Strada Campiei, numarul 57 sala de clasa",1085,585,577,8,0,580,5,1196,611,388,192,1,5363,0
13,"Cluj",55259,127,55259,,"MUNICIPIUL TURDA",264,"Scoala de Arte si Meserii Poiana, Strada Campiei, numarul 57 sala de clasa",1418,796,787,9,0,787,9,1469,673,621,166,1,5363,0
13,"Cluj",55259,127,55259,,"MUNICIPIUL TURDA",265,"Spatiul situat administrativ in Turda, Strada Libertatii nr. 2-4",0,559,0,559,0,557,2,800,241,336,221,1,5363,1
13,"Cluj",55446,127,55446,,"ORAS HUEDIN",266,"Scoala cu 16 sali de clasa, Piata Republicii nr. 42-48",1995,1106,1101,3,2,1096,10,2195,1089,790,306,1,5365,0
13,"Cluj",55446,127,55446,,"ORAS HUEDIN",267,"Grupul Scolar Huedin, Strada Horea nr.78",1477,683,677,5,1,676,7,1625,942,431,245,1,5365,0
13,"Cluj",55446,127,55446,,"ORAS HUEDIN",268,"Casa de copii, Strada Avram Iancu nr. 39",1994,1170,1162,7,1,1159,11,2190,1020,741,418,1,5365,0
13,"Cluj",55446,127,55446,,"ORAS HUEDIN",269,"Primaria Orasului Huedin, Strada Horea nr. 1",1586,801,786,11,4,790,11,1745,944,579,211,1,5365,0
13,"Cluj",55446,127,55446,,"ORAS HUEDIN",270,"Scoala generala - Cetatea Veche, Scoala Generala din Cetatea Veche nr. 2",399,131,122,9,0,127,4,442,311,97,30,1,5365,0
13,"Cluj",55446,127,55446,,"ORAS HUEDIN",271,"Scoala Generala Bicalat, din localitatea Componenta Bicalat",319,205,193,12,0,203,2,350,145,161,42,1,5365,0
13,"Cluj",55446,127,55446,,"ORAS HUEDIN",272,"Liceul Teoretic Octavian Goga, Huedin, Piata Victoriei nr. 11",0,300,0,300,0,297,3,350,50,215,82,1,5365,1
13,"Cluj",55473,127,55473,,"AGHIRESU",273,"Sat Aghiresu, Imobil Aghiresu nr. 363",1117,488,476,11,1,483,5,1222,734,348,135,3,5368,0
13,"Cluj",55473,127,55473,,"AGHIRESU",274,"Sat Aghiresu Fabrici, Sediu Consiliul Local Aghiresu Fabrici nr. 86",1294,679,659,16,4,678,1,1420,741,457,221,3,5368,0
13,"Cluj",55473,127,55473,,"AGHIRESU",275,"Sat Aghiresu Fabrici , Scoala generala nr. 169",1409,708,682,26,0,702,6,1550,842,500,202,3,5368,0
13,"Cluj",55473,127,55473,,"AGHIRESU",276,"Sat Arghisu, Camin Cultural nr. 66",146,87,73,14,0,86,1,167,80,77,9,3,5368,0
13,"Cluj",55473,127,55473,,"AGHIRESU",277,"Sat Bagara, Scoala Generala nr. 139",313,148,138,10,0,144,4,342,194,92,52,3,5368,0
13,"Cluj",55473,127,55473,,"AGHIRESU",278,"Sat Dancu, Scoala Generala",79,48,39,9,0,46,2,90,42,23,23,3,5368,0
13,"Cluj",55473,127,55473,,"AGHIRESU",279,"Sat Doroltu, Camin cultural nr. 17",84,53,43,10,0,52,1,90,37,32,20,3,5368,0
13,"Cluj",55473,127,55473,,"AGHIRESU",280,"Sat Inucu, Scoala Generala",311,160,151,9,0,158,2,341,181,70,88,3,5368,0
13,"Cluj",55473,127,55473,,"AGHIRESU",281,"Sat Leghia, Scoala Generala nr 20/A",452,232,223,9,0,231,1,495,263,155,76,3,5368,0
13,"Cluj",55473,127,55473,,"AGHIRESU",282,"Sat Macau, Imobil consiliu nr. 7",546,249,241,8,0,247,2,605,356,122,125,3,5368,0
13,"Cluj",55473,127,55473,,"AGHIRESU",283,"Sat Ticu-Colonie, Scoala Generala nr. 80",158,94,83,11,0,93,1,175,81,79,14,3,5368,0
13,"Cluj",55473,127,55473,,"AGHIRESU",284,"Sat Ticu, Scoala Generala nr. 77",81,43,33,10,0,43,0,90,47,35,8,3,5368,0
13,"Cluj",55473,127,55473,,"AGHIRESU",285,"sat Aghiresu Fabrici nr. 86, Primaria Aghiresu",0,107,0,107,0,107,0,201,94,72,35,3,5368,1
13,"Cluj",55598,127,55598,,"AITON",286,"Sat Aiton, Camin Cultural din localitatea Aiton nr. 159 (sala Club)",569,390,370,4,16,381,9,630,240,174,207,3,5380,0
13,"Cluj",55598,127,55598,,"AITON",287,"Sat Rediu, Sediul vechi al C.A.P., situat in curtea Caminului Cultural din localitatea Rediu nr. 225",461,257,241,8,8,256,1,505,248,129,127,3,5380,0
13,"Cluj",55598,127,55598,,"AITON",288,"sat Aiton nr. 159, Caminul Cultural Aiton",0,90,0,90,0,89,1,200,110,37,52,3,5380,1
13,"Cluj",55623,127,55623,,"ALUNIS",289,"Sat Alunis, Caminul Cultural Alunis",512,273,259,7,7,268,5,559,286,160,108,3,5383,0
13,"Cluj",55623,127,55623,,"ALUNIS",290,"Sat Corneni, Caminul Cultural Corneni",142,68,60,8,0,67,1,153,85,33,34,3,5383,0
13,"Cluj",55623,127,55623,,"ALUNIS",291,"Sat Ghirolt, Sediul Administrativ Ghirolt (fost sediu C.A.P.)",360,185,177,8,0,181,4,396,211,108,73,3,5383,0
13,"Cluj",55623,127,55623,,"ALUNIS",292,"Sat Vale, Caminul Cultural Vale",95,63,53,10,0,62,1,105,42,32,30,3,5383,0
13,"Cluj",55623,127,55623,,"ALUNIS",293,"sat Alunis, Scoala cu clasele I-VIII Alunis nr. 173",0,47,0,47,0,47,0,200,153,28,19,3,5383,1
13,"Cluj",55687,127,55687,,"APAHIDA",294,"Sala de sport a Grupului scolar ""Stefan Pascu"", Apahida strada Libertatii nr. 114",1429,805,799,6,0,799,6,1575,770,545,254,3,5389,0
13,"Cluj",55687,127,55687,,"APAHIDA",295,"Sala de sport a Grupului scolar ""Stefan Pascu"" , Apahida, strada Libertatii nr.114",1481,799,779,20,0,795,4,1625,826,563,232,3,5389,0
13,"Cluj",55687,127,55687,,"APAHIDA",296,"Sala de sport a Grupului scolar ""Stefan Pascu"" , Apahida, strada Libertatii nr.114",1450,813,802,11,0,809,4,1595,782,532,277,3,5389,0
13,"Cluj",55687,127,55687,,"APAHIDA",297,"sat Sannicoara, Scoala Generala Sannicoara, str.Scolii nr.50",1461,891,869,22,0,889,2,1605,714,669,220,3,5389,0
13,"Cluj",55687,127,55687,,"APAHIDA",298,"sat Dezmir, sediul Primariei comunei Apahida din Dezmir, strada Viilor nr.15",1116,651,638,13,0,649,2,1230,579,465,184,3,5389,0
13,"Cluj",55687,127,55687,,"APAHIDA",299,"sat Pata , sediul Primariei comunei Apahida din Pata, strada George Cosbuc nr.88",487,273,268,5,0,271,2,542,269,155,116,3,5389,0
13,"Cluj",55687,127,55687,,"APAHIDA",300,"sat Corpadea, Caminul Cultural Corpadea, strada Crisan nr.8",374,240,227,13,0,236,4,410,170,162,74,3,5389,0
13,"Cluj",55687,127,55687,,"APAHIDA",301,"sat Apahida, Sala de Sport a Grupului Scolar ""Stefan Pascu"" , strada Libertatii nr.114",0,223,0,223,0,220,3,300,77,150,70,3,5389,1
13,"Cluj",55776,127,55776,,"ASCHILEU",302,"sat Aschileu Mare, Gradinita Aschileu Mare nr. 180",568,265,263,2,0,258,7,637,372,148,110,3,5398,0
13,"Cluj",55776,127,55776,,"ASCHILEU",303,"sat Aschileu Mic, Caminul Cultural Aschileu Mic, nr. 38",263,157,150,7,0,154,3,288,131,61,93,3,5398,0
13,"Cluj",55776,127,55776,,"ASCHILEU",304,"sat Cristorel, Scoala cu clasele I-IV Cristorel nr. 173",325,203,196,7,0,201,2,360,157,126,75,3,5398,0
13,"Cluj",55776,127,55776,,"ASCHILEU",305,"sat Fodora, Scoala cu clasele I-IV  Fodora nr.32",236,130,125,5,0,130,0,260,130,75,55,3,5398,0
13,"Cluj",55776,127,55776,,"ASCHILEU",306,"sat Aschileu Mare, Gradinita Aschileu Mare nr. 180",0,123,0,123,0,123,0,200,77,60,63,3,5398,1
13,"Cluj",55838,127,55838,,"BACIU",307,"sat Baciu, blocurile noi nr.28 D - parter",455,266,252,14,0,261,5,501,235,164,97,3,5404,0
13,"Cluj",55838,127,55838,,"BACIU",308,"sat Baciu, Caminul cultural Baciu nr. 792, sala mare",1686,961,957,4,0,954,7,1855,894,615,339,3,5404,0
13,"Cluj",55838,127,55838,,"BACIU",309,"sat Baciu, Caminul cultural Baciu nr. 792, sala mare",1742,805,799,5,1,798,7,1915,1110,482,316,3,5404,0
13,"Cluj",55838,127,55838,,"BACIU",310,"sat Corusu, Scoala Corusu",425,274,268,6,0,272,2,470,196,156,116,3,5404,0
13,"Cluj",55838,127,55838,," BACIU",311,"sat Mera, Scoala Mera",1254,637,609,3,25,628,9,1375,738,407,221,3,5404,0
13,"Cluj",55838,127,55838,,"BACIU",312,"sat Popesti, Scoala Popesti",467,280,275,5,0,276,4,515,235,183,93,3,5404,0
13,"Cluj",55838,127,55838,,"BACIU",313,"sat Salistea Noua, Scoala Salistea Noua",140,116,101,15,0,116,0,154,38,94,22,3,5404,0
13,"Cluj",55838,127,55838,,"BACIU",314,"sat Suceagu, Scoala Suceagu",1048,516,507,9,0,513,3,1153,637,370,143,3,5404,0
13,"Cluj",55838,127,55838,,"BACIU",315,"sat Baciu, Caminul Cultural Baciu nr. 792",0,265,0,265,0,259,6,348,83,148,111,3,5404,1
13,"Cluj",55918,127,55918,,"BAISOARA",316,"sat Baisoara, Scoala cu clasele I-VIII Baisoara, Cladirea Veche",889,558,544,3,11,550,8,983,425,337,213,3,5412,0
13,"Cluj",55918,127,55918,,"BAISOARA",317,"sat Sacel, Scoala cu clasele I-IV Sacel",357,257,246,7,4,255,2,395,138,194,61,3,5412,0
13,"Cluj",55918,127,55918,,"BAISOARA",318,"sat Muntele Baisorii, Scoala cu clasele I-IV Muntele Baisorii",325,184,174,9,1,181,3,360,176,104,77,3,5412,0
13,"Cluj",55918,127,55918,,"BAISOARA",319,"sat Muntele Cacovei, Scoala cu clasele I-IV Muntele Cacovei",100,69,60,7,2,68,1,111,42,49,19,3,5412,0
13,"Cluj",55918,127,55918,,"BAISOARA",320,"sat Muntele Sacel,  Cantonul Silvic",71,47,31,12,4,47,0,75,28,40,7,3,5412,0
13,"Cluj",55918,127,55918,,"BAISOARA",321,"sat Moara de Padure, Gospodaria d-lui Pasca Roman nr.24",121,81,72,9,0,79,2,131,50,53,26,3,5412,0
13,"Cluj",55918,127,55918,,"BAISOARA",322,"sat Baisoara, Statiunea turistica Muntele Baisorii, Hotel Alpin",0,85,0,85,0,84,1,800,715,60,24,3,5412,1
13,"Cluj",56014,127,56014,,"BELIS",323,"sat Belis, Primaria Belis",493,297,292,4,1,295,2,540,243,169,126,3,5422,0
13,"Cluj",56014,127,56014,,"BELIS",324,"sat Balcesti, Scoala Generala Balcesti",127,80,75,5,0,80,0,140,60,46,34,3,5422,0
13,"Cluj",56014,127,56014,,"BELIS",325,"sat Dealu Botii, Scoala Generala Dealu Botii",53,41,34,7,0,41,0,55,14,25,16,3,5422,0
13,"Cluj",56014,127,56014,,"BELIS",326,"sat Smida, Scoala Generala Smida",39,33,22,11,0,33,0,50,17,16,17,3,5422,0
13,"Cluj",56014,127,56014,,"BELIS",327,"sat Giurcuta de Sus, Scoala Generala Giurcuta de Sus",159,112,103,7,2,111,1,175,63,58,53,3,5422,0
13,"Cluj",56014,127,56014,,"BELIS",328,"sat Poiana Horea, Scoala Generala Poiana Horea",330,227,222,5,0,224,3,363,136,170,54,3,5422,0
13,"Cluj",56014,127,56014,,"BELIS",329,"sat Balcesti, Caminul Cultural Balcesti",0,97,0,97,0,97,0,500,403,53,44,3,5422,1
13,"Cluj",56096,127,56096,,"BOBALNA",330,"sat Babdiu, Scoala Generala Babdiu nr. 162",173,101,95,6,0,99,2,188,87,56,43,3,5430,0
13,"Cluj",56096,127,56096,,"BOBALNA",331,"sat Bobalna, Scoala Generala Bobalna nr. 36, Sala de sport",379,250,241,8,1,244,6,421,171,96,148,3,5430,0
13,"Cluj",56096,127,56096,,"BOBALNA",332,"sat Maia, Scoala Generala Maia nr.14",221,150,137,13,0,150,0,242,92,69,81,3,5430,0
13,"Cluj",56096,127,56096,,"BOBALNA",333,"sat Osorhel, Scoala Generala Osorhel nr.14",127,63,55,8,0,62,1,139,76,37,25,3,5430,0
13,"Cluj",56096,127,56096,,"BOBALNA",334,"sat Pruni, Caminul Cultural Pruni nr.40",52,40,32,8,0,39,1,55,15,22,17,3,5430,0
13,"Cluj",56096,127,56096,,"BOBALNA",335,"sat Razbuneni, Scoala Generala Razbuneni nr.103",206,151,144,7,0,148,3,230,79,98,50,3,5430,0
13,"Cluj",56096,127,56096,,"BOBALNA",336,"sat Suaras, Caminul Cultural Suaras nr.45",121,96,89,7,0,95,1,130,34,60,35,3,5430,0
13,"Cluj",56096,127,56096,,"BOBALNA",337,"sat Vilcelele, Scoala Generala Vilcelele nr.51",94,56,50,6,0,56,0,102,46,34,22,3,5430,0
13,"Cluj",56096,127,56096,,"BOBALNA",338,"sat Bobalna, Scoala Generala Bobalna nr.36",0,153,0,153,0,152,1,301,148,78,74,3,5430,1
13,"Cluj",56210,127,56210,,"BONTIDA",339,"sat Bontida, Primaria Bontida, strada Mihai Eminescu nr.446",1815,926,908,18,0,916,10,2000,1074,530,386,3,5442,0
13,"Cluj",56210,127,56210,,"BONTIDA",340,"sat Bontida, Clubul Tineretului, strada Mihai Eminescu nr.135",511,250,238,12,0,250,0,560,310,143,107,3,5442,0
13,"Cluj",56210,127,56210,,"BONTIDA",341,"sat Rascruci, Scoala Generala Rascruci nr.109",1283,724,719,4,1,721,3,1410,686,580,141,3,5442,0
13,"Cluj",56210,127,56210,,"BONTIDA",342,"sat Coasta, Scoala Generala Coasta nr.120",119,58,50,8,0,57,1,135,77,32,25,3,5442,0
13,"Cluj",56210,127,56210,,"BONTIDA",343,"sat Tauseni, Caminul Cultural Tauseni nr.119",67,31,21,10,0,31,0,83,52,14,17,3,5442,0
13,"Cluj",56210,127,56210,,"BONTIDA",344,"sat Bontida, Scoala cu clasele I-VIII Bontida, strada Mihai Eminescu nr.271",0,110,0,110,0,109,1,201,91,78,31,3,5442,1
13,"Cluj",56265,127,56265,,"BORSA",345,"sat Borsa, Primaria comunei Borsa",993,575,551,1,23,567,8,1090,515,285,282,3,5447,0
13,"Cluj",56265,127,56265,,"BORSA",346,"sat Giula, Caminul Cultural Giula",153,96,84,10,2,96,0,165,69,59,37,3,5447,0
13,"Cluj",56265,127,56265,,"BORSA",347,"sat Ciumafaia, Scoala Generala Ciumafaia",137,74,68,6,0,73,1,155,81,34,39,3,5447,0
13,"Cluj",56265,127,56265,,"BORSA",348,"sat Borsa, Sediul Primariei Borsa nr.262",0,132,0,132,0,129,3,250,118,90,39,3,5447,1
13,"Cluj",56327,127,56327,,"BUZA",349,"sat Buza, Caminul Cultural Buza",1125,613,607,1,5,607,6,1239,626,364,243,3,5453,0
13,"Cluj",56327,127,56327,,"BUZA",350,"sat Buza, Caminul Cultural Buza nr.63",0,31,0,31,0,30,1,200,169,18,12,3,5453,1
13,"Cluj",56354,127,56354,,"CAIANU",351,"sat Caianu Mic, Scoala Caianu Mic",658,320,315,5,0,320,0,624,304,224,96,3,5456,0
13,"Cluj",56354,127,56354,,"CAIANU",352,"sat Barai, Caminul Cultural Barai",256,130,123,7,0,129,1,285,155,78,51,3,5456,0
13,"Cluj",56354,127,56354,,"CAIANU",353,"sat Caianu-Vama, Scoala Caianu-Vama",439,219,212,7,0,217,2,485,266,155,62,3,5456,0
13,"Cluj",56354,127,56354,,"CAIANU",354,"sat Vaida Camaras, biroul Primariei Vaida Camaras",780,319,312,7,0,311,8,853,534,157,154,3,5456,0
13,"Cluj",56354,127,56354,,"CAIANU",355,"sat Caianu Mic, Scoala cu clasele I-VIII  Caianu Mic",0,72,0,72,0,72,0,199,127,47,25,3,5456,1
13,"Cluj",56425,127,56425,,"CALARASI",356,"sat Calarasi, Caminul Cultural Calarasi nr.8",822,307,302,5,0,301,6,900,593,230,71,3,5463,0
13,"Cluj",56425,127,56425,,"CALARASI",357,"sat Bogata, Scoala cu clasele I-IV nr.79",940,369,361,8,0,367,2,1034,665,254,113,3,5463,0
13,"Cluj",56425,127,56425,,"CALARASI",358,"sat Calarasi-Gara, Scoala cu clasele I-IV Calarasi-Gara",335,165,158,7,0,164,1,370,205,115,49,3,5463,0
13,"Cluj",56425,127,56425,,"CALARASI",359,"sat Calarasi, Caminul Cultural Calarasi nr.10",0,34,0,34,0,34,0,200,166,26,8,3,5463,1
13,"Cluj",56461,127,56461,,"CALATELE",360,"sat Calatele, Caminul Cultural Calatele",746,381,376,5,0,367,14,827,446,219,148,3,5467,0
13,"Cluj",56461,127,56461,,"CALATELE",361,"sat Calatele, Caminul Cultural Calatele - Padure",220,153,146,7,0,153,0,242,89,105,48,3,5467,0
13,"Cluj",56461,127,56461,,"CALATELE",362,"sat Calata, sediul Scolii Calata",322,209,201,8,0,208,1,355,146,116,92,3,5467,0
13,"Cluj",56461,127,56461,,"CALATELE",363,"sat Valeni , Caminul Cultural Valeni",289,148,140,8,0,148,0,320,172,83,65,3,5467,0
13,"Cluj",56461,127,56461,," CALATELE",364,"sat Finciu, Caminul Cultural Finciu",136,100,93,7,0,99,1,150,50,39,60,3,5467,0
13,"Cluj",56461,127,56461,,"CALATELE",365,"sat Dealu Negru, sediul Scolii Dealu Negru",368,225,219,6,0,224,1,403,178,174,50,3,5467,0
13,"Cluj",56461,127,56461,,"CALATELE",366,"sat Calatele, Caminul Cultural Calatele nr.459",0,86,0,86,0,86,0,200,114,57,29,3,5467,1
13,"Cluj",56522,127,56522,,"CAMARASU",367,"sat Camarasu, Caminul Cultural Camarasu, strada Principala nr. 32, Sala Mare",1169,532,526,5,1,522,10,1280,748,256,266,3,5473,0
13,"Cluj",56522,127,56522,,"CAMARASU",368,"sat Naoiu, Caminul Cultural Naoiu, strada Principala nr. 129, Sala Mare",435,207,199,8,0,204,3,483,276,87,117,3,5473,0
13,"Cluj",56522,127,56522,,"CAMARASU",369,"sat Simboleni, Caminul Cultural Simboleni, strada Principala nr. 59, Sala Mare",509,237,227,10,0,233,4,564,327,106,127,3,5473,0
13,"Cluj",56522,127,56522,,"CAMARASU",370,"sat Camarasu, Caminul Cultural Camarasu nr.32",0,54,0,54,0,53,1,200,146,20,33,3,5473,1
13,"Cluj",56568,127,56568,,"CAPUSU MARE",371,"sat Capusu Mare, Caminul Cultural Capusu Mare nr.59",747,391,384,7,0,385,6,812,421,242,143,3,5477,0
13,"Cluj",56568,127,56568,,"CAPUSU MARE",372,"sat Capusu Mic, Caminul Cultural Capusu Mic nr.86",644,322,314,8,0,318,4,705,383,215,103,3,5477,0
13,"Cluj",56568,127,56568,,"CAPUSU MARE",373,"sat Dumbrava, fostul sediu CAP nr.74",305,172,166,6,0,169,3,335,163,111,58,3,5477,0
13,"Cluj",56568,127,56568,,"CAPUSU MARE",374,"sat Paniceni, Scoala cu clasele I-IV Paniceni nr. 164",249,154,146,8,0,153,1,276,122,109,44,3,5477,0
13,"Cluj",56568,127,56568,,"CAPUSU MARE",375,"sat Dangau Mic, Scoala cu clasele I-IV Dangau Mic nr. 115",488,283,276,7,0,279,4,540,257,165,114,3,5477,0
13,"Cluj",56568,127,56568,,"CAPUSU MARE",376,"sat Agarbiciu, Scoala cu clasele I-IV Agarbiciu nr.201A",431,309,303,6,0,309,0,470,161,221,88,3,5477,0
13,"Cluj",56568,127,56568,,"CAPUSU MARE",377,"sat Capusu Mare, Caminul Cultural Capusu Mare nr.59",0,97,0,97,0,96,1,200,103,57,39,3,5477,1
13,"Cluj",56666,127,56666,,"CASEIU",378,"sat Caseiu, Caminul Cultural Caseiu",1135,612,608,4,0,603,9,1250,638,318,285,3,5487,0
13,"Cluj",56666,127,56666,,"CASEIU",379,"sat Coplean, Gradinita Coplean",345,170,159,11,0,168,2,380,210,102,66,3,5487,0
13,"Cluj",56666,127,56666,,"CASEIU",380,"sat Rugasesti, Scoala Generala Rugasesti",898,439,432,7,0,431,8,990,551,200,231,3,5487,0
13,"Cluj",56666,127,56666,,"CASEIU",381,"sat Guga, Scoala Generala Guga",255,127,113,14,0,125,2,280,153,55,70,3,5487,0
13,"Cluj",56666,127,56666,,"CASEIU",382,"sat Garbau-Dejului, Scoala Generala Garbau-Dejului",210,115,109,6,0,113,2,231,116,64,49,3,5487,0
13,"Cluj",56666,127,56666,,"CASEIU",383,"sat Salatruc, Scoala Generala Salatruc",139,70,59,11,0,68,2,155,85,47,21,3,5487,0
13,"Cluj",56666,127,56666,,"CASEIU",384,"sat Urisor, Scoala Generala Urisor",835,447,441,6,0,442,5,896,449,182,260,3,5487,0
13,"Cluj",56666,127,56666,,"CASEIU",385,"sat Caseiu, Caminul Cultural Caseiu nr.247",0,121,0,121,0,120,1,200,79,54,66,3,5487,1
13,"Cluj",56773,127,56773,,"CATINA",386,"sat Catina, Primaria comunei Catina",1063,493,490,3,0,483,10,1170,677,242,241,3,5502,0
13,"Cluj",56773,127,56773,,"CATINA",387,"sat Feldioara, Scoala cu clasele I-IV Feldioara",469,241,235,6,0,238,3,515,274,135,103,3,5502,0
13,"Cluj",56773,127,56773,,"CATINA",388,"sat Copru, Caminul Cultural Copru",112,77,69,8,0,77,0,120,43,37,40,3,5502,0
13,"Cluj",56773,127,56773,,"CATINA",389,"sat Catina, Sediul Primariei Catina nr. 154",0,60,0,60,0,59,1,200,140,39,20,3,5502,1
13,"Cluj",57314,127,57314,,"CATCAU",390,"sat Catcau, Caminul Cultural Catcau nr.101",1283,748,717,6,25,744,4,1410,662,346,398,3,5498,0
13,"Cluj",57314,127,57314,,"CATCAU",391,"sat Muncel, Scoala cu clasele I-IV Muncel nr.35",202,123,116,7,0,122,1,220,97,64,58,3,5498,0
13,"Cluj",57314,127,57314,,"CATCAU",392,"sat Salisca, Scoala cu clasele I-IV Salisca nr.181",506,357,341,10,6,354,3,610,253,125,229,3,5498,0
13,"Cluj",57314,127,57314,,"CATCAU",393,"sat Catcau, Scoala cu clasele I-VIII Catcau nr.102",0,62,0,62,0,62,0,200,138,31,31,3,5498,1
13,"Cluj",56844,127,56844,,"CEANU MARE",394,"sat Ceanu Mare, Caminul Cultural Ceanu Mare nr.376",1385,550,545,5,0,546,4,1385,835,343,203,3,5509,0
13,"Cluj",56844,127,56844,,"CEANU MARE",395,"sat Boldut, Caminul Cultural Boldut nr.54",702,347,341,6,0,343,4,770,423,218,125,3,5509,0
13,"Cluj",56844,127,56844,,"CEANU MARE",396,"sat Boian, Gradinita Boian nr.219",772,397,389,8,0,388,9,845,448,288,100,3,5509,0
13,"Cluj",56844,127,56844,," CEANU MARE",397,"sat Iacobeni, Caminul Cultural Iacobeni nr.111/B",548,269,261,8,0,265,4,605,336,157,108,3,5509,0
13,"Cluj",56844,127,56844,,"CEANU MARE",398,"sat Dosu Napului, Scoala Dosu Napului nr.76",136,63,53,10,0,63,0,150,87,39,24,3,5509,0
13,"Cluj",56844,127,56844,,"CEANU MARE",399,"sat Ceanu Mare, Scoala Moara, Ceanu Mare nr.78",0,68,0,68,0,68,0,200,132,43,25,3,5509,1
13,"Cluj",56988,127,56988,,"CHINTENI",400,"sat Chinteni, Primaria Comunei Chinteni, strada Principala nr.144",899,594,570,12,12,585,9,998,404,219,366,3,5523,0
13,"Cluj",56988,127,56988,,"CHINTENI",401,"sat Deusu, Scoala cu clasele I-VIII Deusu",620,396,380,10,6,391,5,682,286,220,171,3,5523,0
13,"Cluj",56988,127,56988,,"CHINTENI",402,"sat Macicasu, Scoala cu clasele I-IV Macicasu",390,250,229,10,11,243,7,440,190,115,128,3,5523,0
13,"Cluj",56988,127,56988,,"CHINTENI",403,"sat Feiurdeni, Primaria Comunei Chinteni, punctul de lucru din localitatea Feiurdeni",405,259,237,11,11,254,5,461,202,75,179,3,5523,0
13,"Cluj",56988,127,56988,,"CHINTENI",404,"sat Chinteni, Sediul Primariei Chinteni, strada Principala nr.144",0,221,0,221,0,220,1,249,28,86,134,3,5523,1
13,"Cluj",57083,127,57083,,"CHIUIESTI",405,"sat Chiuiesti, Scoala cu clasele I-VIII Chiuiesti nr.146",1331,805,799,4,2,801,4,1460,655,471,330,3,5533,0
13,"Cluj",57083,127,57083,,"CHIUIESTI",406,"sat Magoaja, Scoala cu clasele I-IV Magoaja nr.58",332,226,203,14,9,223,3,365,139,129,94,3,5533,0
13,"Cluj",57083,127,57083,,"CHIUIESTI",407,"sat Strambu, Scoala cu clasele I-IV Strambu nr.145",376,224,214,10,0,218,6,394,170,111,107,3,5533,0
13,"Cluj",57083,127,57083,,"CHIUIESTI",408,"sat Huta, Scoala cu clasele I-IV Huta nr.36",113,80,76,4,0,79,1,120,40,49,30,3,5533,0
13,"Cluj",57083,127,57083,,"CHIUIESTI",409,"sat Chiuiesti, Scoala cu clasele I-VIII Chiuiesti nr.146",0,123,0,123,0,123,0,250,127,55,68,3,5533,1
13,"Cluj",57163,127,57163,,"CIUCEA",410,"sat Ciucea, Scoala cu clasele I-VIII  ""OCTAVIAN GOGA"", Ciucea, str.Principala nr.121",789,456,446,5,5,453,3,870,414,232,221,3,5541,0
13,"Cluj",57163,127,57163,,"CIUCEA",411,"sat Calea-Lata, Scoala cu clasele I-IV Calea-Lata nr.442",221,89,78,11,0,88,1,240,151,52,36,3,5541,0
13,"Cluj",57163,127,57163,,"CIUCEA",412,"sat Vinatori, Scoala cu clasele I-IV Vinatori nr.29",402,252,246,6,0,250,2,440,188,184,66,3,5541,0
13,"Cluj",57163,127,57163,,"CIUCEA",413,"sat Ciucea, Statia CFR Ciucea nr.196",0,66,0,66,0,66,0,249,183,35,31,3,5541,1
13,"Cluj",57225,127,57225,,"CIURILA",414,"sat Ciurila, fost Magazin alimentar-liber, nr.7",173,118,109,7,2,115,3,190,72,64,51,3,5544,0
13,"Cluj",57225,127,57225,,"CIURILA",415,"sat Filea de Jos, Scoala cu clasele I-IV Filea de Jos nr. 81",319,184,174,10,0,170,14,355,171,82,88,3,5544,0
13,"Cluj",57225,127,57225,,"CIURILA",416,"sat Salicea, Scoala cu clasele I-IV Salicea nr.120",217,139,128,11,0,136,3,240,101,111,25,3,5544,0
13,"Cluj",57225,127,57225,,"CIURILA",417,"sat Sutu, Scoala cu clasele I-IV Sutu nr.7",322,184,177,7,0,180,4,352,168,134,46,3,5544,0
13,"Cluj",57225,127,57225,,"CIURILA",418,"sat Saliste, Magazin alimentar-liber, nr.75",101,64,57,7,0,64,0,110,46,37,27,3,5544,0
13,"Cluj",57225,127,57225,,"CIURILA",419,"sat Salicea, Caminul Cultural Salicea nr.45",0,190,0,190,0,188,2,250,60,130,58,3,5544,1
13,"Cluj",57350,127,57350,,"COJOCNA",420,"sat Cojocna, cladirea Restaurantului Bai Cojocna, strada Republicii nr.126",1882,848,840,8,0,837,11,2070,1222,589,248,3,5553,0
13,"Cluj",57350,127,57350,,"COJOCNA",421,"sat Boju, Scoala Boju, strada George Cosbuc nr.1A",497,230,225,5,0,228,2,550,320,139,89,3,5553,0
13,"Cluj",57350,127,57350,,"COJOCNA",422,"sat Cara, biroul Primariei din satul Cara, strada Libertatii nr.29",633,336,329,7,0,334,2,694,358,169,165,3,5553,0
13,"Cluj",57350,127,57350,,"COJOCNA",423,"sat Iuriu de Cimpie, Caminul Cultural Iuriu de Cimpie, strada Republicii fn",377,174,166,8,0,172,2,415,241,89,83,3,5553,0
13,"Cluj",57350,127,57350,,"COJOCNA",424,"sat Cojocna, cladirea Primariei Cojocna - sala de sedinte, strada Republicii nr.106",0,105,0,105,0,104,1,200,95,68,36,3,5553,1
13,"Cluj",57449,127,57449,,"CORNESTI",425,"sat Cornesti, Caminul Cultural Cornesti nr.37",204,113,110,3,0,111,2,220,107,73,38,3,5562,0
13,"Cluj",57449,127,57449,,"CORNESTI",426,"sat Barlea, Caminul Cultural Barlea nr.135",161,107,101,6,0,104,3,177,70,46,58,3,5562,0
13,"Cluj",57449,127,57449,,"CORNESTI",427,"sat Lujerdiu, Scoala Generala cu clasele I-IV Lujerdiu nr.45",309,165,154,11,0,163,2,341,176,60,103,3,5562,0
13,"Cluj",57449,127,57449,,"CORNESTI",428,"sat Stoiana, Sala de sedinte a Parohiei Ortodoxe Stoiana nr.109",227,135,127,8,0,132,3,249,114,65,67,3,5562,0
13,"Cluj",57449,127,57449,,"CORNESTI",429,"sat Tiocu de Jos, Scoala Generala cu clasele I-IV Tiocu de Jos nr.88",125,83,73,10,0,83,0,140,57,46,37,3,5562,0
13,"Cluj",57449,127,57449,,"CORNESTI",430,"sat Tiocu de Sus, Sala de sedinte a Parohiei Ortodoxe Tiocu de Sus nr.101 (fostul sediu CAP)",144,90,82,8,0,89,1,155,65,34,55,3,5562,0
13,"Cluj",57449,127,57449,,"CORNESTI",431,"sat Tioltur, Scoala Generala cu clasele I-IV Tioltur nr.128",175,104,98,6,0,104,0,195,91,62,42,3,5562,0
13,"Cluj",57449,127,57449,,"CORNESTI",432,"sat Cornesti, Centrul Cultural Sportiv de Informare Cornesti nr.38",0,121,0,121,0,121,0,200,79,52,69,3,5562,1
13,"Cluj",55062,127,55062,,"CUZDRIOARA",433,"sat Cuzdrioara, Caminul Cultural Cuzdrioara, strada Mihai Eminescu nr. 107",1801,964,956,8,0,954,10,1980,1016,483,471,3,5572,0
13,"Cluj",55062,127,55062,,"CUZDRIOARA",434,"sat Manasturel, Scoala Generala din satul Manasturel",620,271,261,10,0,268,3,682,411,115,153,3,5572,0
13,"Cluj",55062,127,55062,,"CUZDRIOARA",435,"sat Cuzdrioara, sediul Primariei Cuzdrioara, strada Mihai Eminescu nr.107",0,50,0,50,0,48,2,202,152,26,22,3,5572,1
13,"Cluj",57546,127,57546,,"DABACA",436,"sat Dabaca, Scoala Generala clasele I-VIII Dabaca",639,288,283,5,0,288,0,705,417,135,153,3,5576,0
13,"Cluj",57546,127,57546,,"DABACA",437,"sat Luna de Jos, Scoala Generala clasele I-IV Luna de Jos",533,262,253,7,2,261,1,585,323,177,84,3,5576,0
13,"Cluj",57546,127,57546,,"DABACA",438,"sat Piglisa, Caminul Cultural",104,58,53,5,0,58,0,110,52,33,25,3,5576,0
13,"Cluj",57546,127,57546,,"DABACA",439,"sat Dabaca, sediul Primariei Dabaca nr.339",0,84,0,84,0,84,0,150,66,44,40,3,5576,1
13,"Cluj",57582,127,57582,,"FELEACU",440,"sat Feleacu, Caminul Cultural Feleacu  nr.131/A",1400,771,759,12,0,766,5,1550,779,568,198,3,5580,0
13,"Cluj",57582,127,57582,,"FELEACU",441,"sat Gheorgheni, Caminul Cultural Gheorgheni nr. 270",881,323,311,12,0,319,4,965,642,251,68,3,5580,0
13,"Cluj",57582,127,57582,,"FELEACU",442,"sat Vilcele, fostul sediu CAP Vilcele nr.158/D",798,385,376,9,0,383,2,874,489,322,61,3,5580,0
13,"Cluj",57582,127,57582,,"FELEACU",443,"sat Feleacu, sediul Primariei Feleacu nr.131",0,141,0,141,0,139,2,200,59,97,42,3,5580,1
13,"Cluj",57644,127,57644,,"FIZESU GHERLII",444,"sat Fizesu Gherlii, Caminul Cultural Fizesu Gherlii",1125,440,429,11,0,437,3,1240,800,259,178,3,5586,0
13,"Cluj",57644,127,57644,,"FIZESU GHERLII",445,"sat Nicula, Scoala cu clasele I-VIII Nicula",541,266,258,8,0,261,5,595,329,164,97,3,5586,0
13,"Cluj",57644,127,57644,,"FIZESU GHERLII",446,"sat Bont, Scoala cu clasele I-IV Bont",293,168,159,9,0,166,2,320,152,80,86,3,5586,0
13,"Cluj",57644,127,57644,,"FIZESU GHERLII",447,"sat Sacalaia, Scoala cu clasele I-IV Sacalaia",187,136,126,10,0,136,0,205,69,86,50,3,5586,0
13,"Cluj",57644,127,57644,,"FIZESU GHERLII",448,"sat  Nicula, Scoala cu clasele I-VIII Nicula nr. 107",0,54,0,54,0,53,1,200,146,25,28,3,5586,1
13,"Cluj",57706,127,57706,,"FLORESTI",449,"Scoala ""Gh.Sincai"",  strada  Avram Iancu nr.221, Floresti",2295,1276,1217,59,0,1252,24,2526,1250,818,434,3,5592,0
13,"Cluj",57706,127,57706,,"FLORESTI",450,"Scoala ""Gh.Sincai"",  strada  Avram Iancu nr.221, Floresti",1125,619,602,17,0,614,5,1253,634,443,171,3,5592,0
13,"Cluj",57706,127,57706,,"FLORESTI",451,"Gradinita nr. 1 Floresti, strada Avram Iancu nr.132",1242,719,691,28,0,704,15,1365,646,482,222,3,5592,0
13,"Cluj",57706,127,57706,,"FLORESTI",452,"Gradinita nr .2 Floresti, strada Horea nr.55",1612,996,949,47,0,988,8,1768,772,683,305,3,5592,0
13,"Cluj",57706,127,57706,,"FLORESTI",453,"Scoala din Cartierul ANL ""Cetatea Fetei""",1300,743,687,55,1,737,6,1430,687,544,193,3,5592,0
13,"Cluj",57706,127,57706,,"FLORESTI",454,"sat Luna de Sus, Caminul Cultural Luna de Sus",1757,903,888,15,0,895,8,1935,1032,704,191,3,5592,0
13,"Cluj",57706,127,57706,,"FLORESTI",455,"sat Tauti, Caminul Cultural Tauti",159,85,73,12,0,85,0,174,89,66,19,3,5592,0
13,"Cluj",57706,127,57706,,"FLORESTI",456,"sat Floresti, Scoala Generala Floresti, sala nr.3, strada Avram Iancu nr.221",0,1008,0,1008,0,1001,7,1102,94,691,310,3,5592,1
13,"Cluj",57742,127,57742,,"FRATA",457,"sat Frata, Caminul  Cultural Frata, Sala mica, nr.410",1740,703,699,4,0,697,6,1915,1212,398,299,3,5596,0
13,"Cluj",57742,127,57742,,"FRATA",458,"sat Poiana Fratii, Scoala Poiana Fratii  nr.103",194,99,89,10,0,98,1,210,111,68,30,3,5596,0
13,"Cluj",57742,127,57742,,"FRATA",459,"sat Berchiesu, Caminul Cultural Berchiesu nr.44",569,240,236,4,0,235,5,630,390,94,141,3,5596,0
13,"Cluj",57742,127,57742,,"FRATA",460,"sat Soporu de Campie, Caminul Cultural Soporu de Campie nr.100",1005,398,391,7,0,388,10,1105,707,215,173,3,5596,0
13,"Cluj",57742,127,57742,,"FRATA",461,"sat Frata, Caminul Cultural Frata, Sala mare, nr.410",0,67,0,67,0,67,0,200,133,41,26,3,5596,1
13,"Cluj",57948,127,57948,,"GARBAU",462,"sat Garbau, Caminul Cultural Garbau nr.82",588,324,320,4,0,323,1,655,331,161,162,3,5605,0
13,"Cluj",57948,127,57948,,"GARBAU",463,"sat Vistea, Scoala Generala Vistea nr.34",624,344,336,8,0,340,4,685,341,233,107,3,5605,0
13,"Cluj",57948,127,57948,,"GARBAU",464,"sat Turea, Scoala Generala Turea nr.40",433,190,182,8,0,186,4,475,285,115,71,3,5605,0
13,"Cluj",57948,127,57948,,"GARBAU",465,"sat Nadasel, Scoala Generala Nadasel nr.106",254,152,143,8,1,152,0,280,128,83,69,3,5605,0
13,"Cluj",57948,127,57948,,"GARBAU",466,"sat Cornesti, Caminul Cultural Cornesti nr.74",117,79,70,9,0,78,1,130,51,40,38,3,5605,0
13,"Cluj",57948,127,57948,,"GARBAU",467,"sat Garbau, Scoala cu clasele I-VIII Garbau, strada Principala nr.177",0,89,0,89,0,89,0,202,113,60,29,3,5605,1
13,"Cluj",57831,127,57831,,"GEACA",468,"sat Geaca, Camin Cultural Geaca, strada Principala nr.183",505,249,245,4,0,243,6,553,304,108,135,3,5611,0
13,"Cluj",57831,127,57831,,"GEACA",469,"sat Sucutard, Camin Cultural Sucutard",330,165,158,7,0,165,0,362,197,96,69,3,5611,0
13,"Cluj",57831,127,57831,,"GEACA",470,"sat Lacu, Camin Cultural Lacu",252,140,132,8,0,140,0,273,133,66,74,3,5611,0
13,"Cluj",57831,127,57831,,"GEACA",471,"sat Legii, Camin Cultural Legii",146,90,79,11,0,88,2,165,75,38,50,3,5611,0
13,"Cluj",57831,127,57831,,"GEACA",472,"sat Chiris, Scoala Chiris",84,45,34,11,0,42,3,102,57,16,26,3,5611,0
13,"Cluj",57831,127,57831,,"GEACA",473,"sat Puini, Camin Cultural Puini",85,52,45,7,0,50,2,100,48,16,34,3,5611,0
13,"Cluj",57831,127,57831,,"GEACA",474,"sat Geaca, Primaria Geaca, str. Principala nr.183",0,51,0,51,0,51,0,199,148,22,29,3,5611,1
13,"Cluj",57902,127,57902,,"GILAU",475,"sat Gilau, Casa de Cultura Dumitru Sopon, strada Principala nr.723",1661,910,885,25,0,906,4,1825,915,649,257,3,5618,0
13,"Cluj",57902,127,57902,,"GILAU",476,"sat Gilau, Caminul Cultural Vechi Gilau, strada Principala nr.723",1591,994,935,57,2,990,4,1750,756,712,278,3,5618,0
13,"Cluj",57902,127,57902,,"GILAU",477,"sat Gilau, Liceul ""Gelu Voievod"" Cladirea Internat, strada Principala nr.721",1633,956,933,23,0,945,11,1895,939,651,294,3,5618,0
13,"Cluj",57902,127,57902,,"GILAU",478,"sat Somesu Rece, Scoala Generala Somesu Rece nr.187",965,623,606,17,0,615,8,1065,442,449,166,3,5618,0
13,"Cluj",57902,127,57902,,"GILAU",479,"sat Somesu Rece, catun Uzina, Scoala Somesul Rece - Uzina Electrica",520,252,237,15,0,250,2,570,318,147,103,3,5618,0
13,"Cluj",57902,127,57902,,"GILAU",480,"sat Gilau, Scoala Veche, Gilau nr.238",0,344,0,344,0,340,4,352,8,216,124,3,5618,1
13,"Cluj",58008,127,58008,,"IARA",481,"sat Agris, Scoala Agris",368,180,172,8,0,179,1,405,225,118,61,3,5622,0
13,"Cluj",58008,127,58008,,"IARA",482,"sat Borzesti, casa particulara nr.17",45,35,24,11,0,34,1,50,15,19,15,3,5622,0
13,"Cluj",58008,127,58008,,"IARA",483,"sat Buru, Scoala Buru",175,89,80,9,0,86,3,195,106,55,31,3,5622,0
13,"Cluj",58008,127,58008,,"IARA",484,"sat Cacova Ierii, Scoala Cacova Ierii",403,235,227,6,2,233,2,440,205,159,74,3,5622,0
13,"Cluj",58008,127,58008,,"IARA",485,"sat Fagetul Ierii, Scoala Fagetul Ierii",264,132,123,9,0,132,0,290,158,86,46,3,5622,0
13,"Cluj",58008,127,58008,,"IARA",486,"sat Iara, Scoala Iara",841,384,377,7,0,384,0,925,541,202,182,3,5622,0
13,"Cluj",58008,127,58008,,"IARA",487,"sat Iara, Scoala Iara",873,415,409,6,0,412,3,960,545,224,188,3,5622,0
13,"Cluj",58008,127,58008,,"IARA",488,"sat Lungesti, casa particulara nr.27",49,35,25,10,0,35,0,60,25,22,13,3,5622,0
13,"Cluj",58008,127,58008,,"IARA",489,"sat Masca, Scoala Masca",168,82,73,9,0,82,0,185,103,55,27,3,5622,0
13,"Cluj",58008,127,58008,,"IARA",490,"sat Magura Ierii, casa particulara nr.44",33,30,20,10,0,29,1,40,10,20,9,3,5622,0
13,"Cluj",58008,127,58008,,"IARA",491,"sat Ocolisel, Scoala Ocolisel",122,73,66,7,0,73,0,130,57,50,23,3,5622,0
13,"Cluj",58008,127,58008,,"IARA",492,"sat Surduc, Scoala Surduc",281,154,145,9,0,153,1,305,151,109,44,3,5622,0
13,"Cluj",58008,127,58008,,"IARA",493,"sat Valea Agrisului, casa particulara nr.2",24,25,15,10,0,25,0,30,5,11,14,3,5622,0
13,"Cluj",58008,127,58008,,"IARA",494,"sat Valea Vadului, Scoala Valea Vadului",46,40,29,11,0,40,0,62,22,21,19,3,5622,0
13,"Cluj",58008,127,58008,,"IARA",495,"sat Iara, Scoala generala cu clasele I-IV Iara",0,111,0,111,0,110,1,250,139,78,32,3,5622,1
13,"Cluj",58142,127,58142,,"ICLOD",496,"sat Iclod, sediul Primariei/Consiliului Local Iclod nr.117, Sala de sedinte",1655,892,887,5,0,881,11,1822,930,540,341,3,5636,0
13,"Cluj",58142,127,58142,,"ICLOD",497,"sat Fundatura, sediul Scolii cu clasele I-IV Fundatura, nr.38/A, Sala de cursuri",568,302,295,7,0,299,3,624,322,165,134,3,5636,0
13,"Cluj",58142,127,58142,,"ICLOD",498,"sat Livada, sediul Scolii cu clasele I-VIII Livada nr.212, Sala de cursuri",813,431,421,10,0,428,3,890,459,293,135,3,5636,0
13,"Cluj",58142,127,58142,,"ICLOD",499,"sat Orman, sediul Scolii cu clasele I-IV  Orman nr.144, Sala de cursuri",509,264,254,10,0,264,0,560,296,189,75,3,5636,0
13,"Cluj",58142,127,58142,,"ICLOD",500,"sat Iclod, Scoala Generala Iclod nr.441",0,110,0,110,0,110,0,250,140,73,37,3,5636,1
13,"Cluj",58204,127,58204,,"IZVORU CRISULUI",501,"sat Izvoru Crisului, Primaria Izvoru Crisului nr.39, cladirea principala Sala de sedinte",750,312,272,11,29,308,4,860,548,176,132,3,5642,0
13,"Cluj",58204,127,58204,,"IZVORU CRISULUI",502,"sat Nadasu, Scoala Generala cu clasele I-IV Nadasu nr.127, Sala de clase",227,150,144,6,0,147,3,250,100,72,75,3,5642,0
13,"Cluj",58204,127,58204,,"IZVORU CRISULUI",503,"sat Saula, Caminul Cultural Saula nr. 94, Sala de spectacol",308,136,128,8,0,135,1,340,204,64,71,3,5642,0
13,"Cluj",58204,127,58204,,"IZVORU CRISULUI",504,"sat Izvorul Crisului, sediul Primariei Izvoru Crisului, strada Principala nr.39",0,27,0,27,0,27,0,200,173,15,12,3,5642,1
13,"Cluj",55106,127,55106,,"JICHISU DE JOS",505,"sat Jichisu de Jos, Caminul Cultural Jichisu de Jos nr.145",366,243,237,5,1,241,2,408,165,134,107,3,5647,0
13,"Cluj",55106,127,55106,,"JICHISU DE JOS",506,"sat Codor, Scoala Generala Codor nr.40",331,217,210,7,0,214,3,360,143,135,79,3,5647,0
13,"Cluj",55106,127,55106,,"JICHISU DE JOS",507,"sat Jichisu de Sus, Scoala Generala Jichisu de Sus nr.138",207,141,133,8,0,141,0,230,89,103,38,3,5647,0
13,"Cluj",55106,127,55106,,"JICHISU DE JOS",508,"sat Tarpiu, Scoala Generala Tarpiu  nr.61",95,58,52,6,0,58,0,105,47,33,25,3,5647,0
13,"Cluj",55106,127,55106,,"JICHISU DE JOS",509,"sat Sigau, Caminul Cultural Sigau nr.57",31,28,18,10,0,28,0,40,12,14,14,3,5647,0
13,"Cluj",55106,127,55106,,"JICHISU DE JOS",510,"sat Jichisu de Jos, Scoala Generala Jichisu de Jos nr.27",0,104,0,104,0,104,0,201,97,57,47,3,5647,1
13,"Cluj",58259,127,58259,,"JUCU",511,"sat Jucu de Sus, sediul Primariei Jucu de Sus, nr.112",1214,630,615,12,3,620,10,1335,705,451,169,3,5653,0
13,"Cluj",58259,127,58259,,"JUCU",512,"sat Jucu de Mijloc, Scoala cu clasele I-IV Jucu de Mijloc",742,414,403,11,0,414,0,815,401,330,84,3,5653,0
13,"Cluj",58259,127,58259,,"JUCU",513,"sat Gadalin, Scoala cu clasele I-VIII Gadalin",528,317,313,4,0,314,3,585,268,199,115,3,5653,0
13,"Cluj",58259,127,58259,,"JUCU",514,"sat Visea, Scoala cu clasele I-VIII Visea",493,256,238,4,14,255,1,540,284,199,56,3,5653,0
13,"Cluj",58259,127,58259,,"JUCU",515,"sat Jucu Herghelie, Scoala cu clasele I-VIII Jucu Herghelie",369,233,223,10,0,230,3,405,172,166,64,3,5653,0
13,"Cluj",58259,127,58259,,"JUCU",516,"sat Jucu de Sus, sediul Primariei comunei Jucu nr.112",0,216,0,216,0,216,0,250,34,158,58,3,5653,1
13,"Cluj",58311,127,58311,,"LUNA",517,"sat Luna, Caminul Cultural Luna nr.725",2152,1057,1033,6,18,1049,8,2365,1308,608,441,3,5659,0
13,"Cluj",58311,127,58311,,"LUNA",518,"sat Luncani, Gradinita Luncani nr. 414",1284,543,536,7,0,536,7,1410,867,354,182,3,5659,0
13,"Cluj",58311,127,58311,,"LUNA",519,"Sat Gligoresti  Scoala Generala nr.136",451,226,219,7,0,224,2,500,274,142,82,3,5659,0
13,"Cluj",58311,127,58311,,"LUNA",520,"sat Luna, Caminul Cultural Luna, str. Principala nr. 752",0,68,0,68,0,68,0,200,132,40,28,3,5659,1
13,"Cluj",58357,127,58357,,"MAGURI-RACATAU",521,"Localitatea Maguri Racatau, Primaria Maguri Racatau nr. 88, Sala de Sedinte",665,318,314,4,0,317,1,735,417,246,71,3,5663,0
13,"Cluj",58357,127,58357,,"MAGURI-RACATAU",522,"Sat Maguri nr.170 , Scoala Maguri Bogdanesti",743,356,345,11,0,354,2,810,454,277,77,3,5663,0
13,"Cluj",58357,127,58357,,"MAGURI-RACATAU",523,"Sat Muntele Rece nr. 144/A, Caminul Cultural",461,217,212,5,0,217,0,505,288,140,77,3,5663,0
13,"Cluj",58357,127,58357,,"MAGURI-RACATAU",524,"sat Maguri Racatau nr. 87, Caminul Cultural",0,37,0,37,0,36,1,200,163,30,6,3,5663,1
13,"Cluj",58393,127,58393,,"MANASTIRENI",525,"Primaria Manastireni nr. 222, sala de sedinte",879,499,496,3,0,493,6,965,466,324,169,3,5667,0
13,"Cluj",58393,127,58393,,"MANASTIRENI",526,"Sat Bedeciu, Scoala Generala cu clasele I-IV Sala Gradinita",498,342,331,11,0,336,6,560,218,200,136,3,5667,0
13,"Cluj",58393,127,58393,,"MANASTIRENI",527,"sat Manastireni, Sediul Primariei Manastireni nr.222",0,73,0,73,0,71,2,200,127,40,31,3,5667,1
13,"Cluj",58464,127,58464,,"MARGAU",528,"sat Margau Primaria Margau nr.204",394,247,243,4,0,244,3,431,184,162,82,3,5674,0
13,"Cluj",58464,127,58464,,"MARGAU",529,"Sat Rachitele nr.165, Sediu Primarie",642,390,384,6,0,385,5,707,317,291,94,3,5674,0
13,"Cluj",58464,127,58464,,"MARGAU",530,"Sat Scrind-Frasinet nr.48, Scoala cu clasele I-IV",157,102,97,5,0,101,1,175,73,76,25,3,5674,0
13,"Cluj",58464,127,58464,,"MARGAU",531,"Sat Buteni nr.101 , Scoala Buteni",200,107,98,9,0,104,3,220,113,66,38,3,5674,0
13,"Cluj",58464,127,58464,,"MARGAU",532,"sat Margau, Sediul Primariei Margau nr.204",0,80,0,80,0,80,0,200,120,56,24,3,5674,1
13,"Cluj",58534,127,58534,,"MARISEL",533,"Catunul Rosesti-Rusesti, Scoala Marisel Rusesti",98,76,67,8,1,76,0,110,34,65,11,3,5681,0
13,"Cluj",58534,127,58534,,"MARISEL",534,"Catunul Stanesti, Scoala ""Pelaghia Rosu""",1017,607,605,2,0,601,6,1120,513,460,141,3,5681,0
13,"Cluj",58534,127,58534,,"MARISEL",535,"Catunul Costesti, Scoala Marisel Costesti",178,101,92,9,0,101,0,195,94,78,23,3,5681,0
13,"Cluj",58534,127,58534,,"MARISEL",536,"sat Marisel, Scoala Generala Marisel nr.433",0,85,0,85,0,84,1,200,115,55,29,3,5681,1
13,"Cluj",55160,127,55160,,"MICA",537,"Caminul Cultural Mica",630,359,354,5,0,354,5,688,329,160,194,3,5683,0
13,"Cluj",55160,127,55160,,"MICA",538,"Sat Manastirea, Caminul Cultural",589,347,338,9,0,344,3,650,303,162,182,3,5683,0
13,"Cluj",55160,127,55160,,"MICA",539,"Sat Nires, fost sediu CAP",960,487,482,5,0,480,7,1056,569,261,219,3,5683,0
13,"Cluj",55160,127,55160,,"MICA",540,"Sat Sanmarghita, Scoala cu clasele I-VIII",894,409,401,8,0,407,2,980,571,241,166,3,5683,0
13,"Cluj",55160,127,55160,,"MICA",541,"sat Mica, Sediul Primariei Mica nr.209",0,63,0,63,0,63,0,199,136,31,32,3,5683,1
13,"Cluj",55277,127,55277,,"MIHAI VITEAZU",542,"Caminul Cultural Mihai Viteazu nr.1127",1416,678,667,10,1,674,4,1560,882,453,221,3,5691,0
13,"Cluj",55277,127,55277,,"MIHAI VITEAZU",543,"Scoala Veche Mihai Viteazu",1481,681,670,11,0,673,8,1622,941,455,218,3,5691,0
13,"Cluj",55277,127,55277,,"MIHAI VITEAZU",544,"sat Mihai Viteazu nr. 1014 Sala de Sport",1020,467,457,10,0,463,4,1122,655,287,176,3,5691,0
13,"Cluj",55277,127,55277,,"MIHAI VITEAZU",545,"Sat Cheia, Scoala Cheia",489,231,223,8,0,229,2,540,309,158,71,3,5691,0
13,"Cluj",55277,127,55277,,"MIHAI VITEAZU",546,"Sat Cornesti, Scoala Cornesti",630,273,265,8,0,270,3,692,419,173,97,3,5691,0
13,"Cluj",55277,127,55277,,"MIHAI VITEAZU",547,"sat Mihai Viteazu, sediul Primariei Mihai Viteazu, str.Principala nr.1014",0,93,0,93,0,93,0,199,106,61,32,3,5691,1
13,"Cluj",58552,127,58552,,"MINTIU GHERLII",548,"Primaria comunei Mintiu Gherlii nr.184",1252,687,680,7,0,677,10,1358,671,333,344,3,5695,0
13,"Cluj",58552,127,58552,,"MINTIU GHERLII",549,"Sat Bunesti nr.227,Scoala cu clasele I-IV",745,374,364,10,0,371,3,823,449,224,147,3,5695,0
13,"Cluj",58552,127,58552,,"MINTIU GHERLII",550,"Sat Nima nr.188, Scoala cu clasele I-IV",607,335,327,8,0,332,3,670,335,151,181,3,5695,0
13,"Cluj",58552,127,58552,,"MINTIU GHERLII",551,"Sat Padureni nr.28, Scoala cu clasele I-IV",93,61,51,10,0,59,2,100,39,33,26,3,5695,0
13,"Cluj",58552,127,58552,,"MINTIU GHERLII",552,"Sat Petresti nr.77, Scoala cu clasele I-IV",194,129,120,9,0,129,0,210,81,60,69,3,5695,0
13,"Cluj",58552,127,58552,,"MINTIU GHERLII",553,"Sat Salatiu nr.47, Scoala cu clasele I-IV",200,139,131,8,0,139,0,220,81,60,79,3,5695,0
13,"Cluj",58552,127,58552,,"MINTIU GHERLII",554,"sat Mintiu Gherlii, Gradinita Mintiu Gherlii nr.269",0,57,0,57,0,57,0,200,143,25,32,3,5695,1
13,"Cluj",58623,127,58623,,"MOCIU",555,"Caminul Cultural Mociu nr.105, sala mica",1435,715,712,3,0,705,10,1580,865,390,315,3,5702,0
13,"Cluj",58623,127,58623,,"MOCIU",556,"Sat Boteni nr.12, Cladirea fostei cooperative Boteni, actual proprietate privata Sabau Marius",196,112,105,7,0,111,1,215,103,40,71,3,5702,0
13,"Cluj",58623,127,58623,,"MOCIU",557,"Sat Chesau nr.139, Scoala cu  clasele I-IV, sala de curs",297,166,155,11,0,164,2,325,159,50,114,3,5702,0
13,"Cluj",58623,127,58623,,"MOCIU",558,"Sat Criseni nr.132, Scoala cu clasele I-IV, sala de sedinte",247,145,138,7,0,141,4,275,130,94,47,3,5702,0
13,"Cluj",58623,127,58623,,"MOCIU",559,"Sat Ghirisu Roman nr.75, Scoala cu clasele I-IV, sala de curs",306,186,179,7,0,186,0,335,149,119,67,3,5702,0
13,"Cluj",58623,127,58623,,"MOCIU",560,"Sat Rosieni nr.19, Scoala cu clasele I-IV, sala de curs",159,86,76,10,0,86,0,175,89,49,37,3,5702,0
13,"Cluj",58623,127,58623,,"MOCIU",561,"Sat Zorenii de Vale nr.139, Scoala cu clasele I-IV, sala Gradinita",264,147,141,6,0,146,1,300,153,77,69,3,5702,0
13,"Cluj",58623,127,58623,,"MOCIU",562,"sat Mociu, Palatul Administrativ al comunei Mociu nr.26",0,127,0,127,0,126,1,252,125,72,54,3,5702,1
13,"Cluj",58721,127,58721,,"MOLDOVENESTI",563,"Sediul Primarie - parter-sala mare, Moldovenesti nr.240",608,251,246,5,0,247,4,670,419,152,95,3,5712,0
13,"Cluj",58721,127,58721,,"MOLDOVENESTI",564,"Sala de Sport a Scolii cu clasele I-VIII, Moldovenesti nr.588",415,225,219,6,0,221,4,460,235,137,84,3,5712,0
13,"Cluj",58721,127,58721,,"MOLDOVENESTI",565,"Sat Plaiesti nr.67, Scoala cu clasele I-IV",518,192,183,9,0,189,3,570,378,121,68,3,5712,0
13,"Cluj",58721,127,58721,,"MOLDOVENESTI",566,"Sat Badeni, Casa Satului Badeni nr.227",580,195,186,9,0,194,1,638,443,149,45,3,5712,0
13,"Cluj",58721,127,58721,,"MOLDOVENESTI",567,"Sat Stejeris nr.131, Cladirea Primariei",153,56,47,9,0,54,2,165,109,38,16,3,5712,0
13,"Cluj",58721,127,58721,,"MOLDOVENESTI",568,"Sat Pietroasa nr.96, Caminul Cultural",126,61,53,8,0,61,0,140,79,48,13,3,5712,0
13,"Cluj",58721,127,58721,,"MOLDOVENESTI",569,"Sat Podeni nr.68, Scoala cu clasele I-IV",469,214,206,8,0,210,4,515,301,125,85,3,5712,0
13,"Cluj",58721,127,58721,,"MOLDOVENESTI",570,"sat Moldovenesti, Sediul Primariei Moldovenesti nr.240",0,50,0,50,0,50,0,200,150,21,29,3,5712,1
13,"Cluj",60169,127,60169,,"NEGRENI",571,"Caminul Cultural Negreni nr.57",1486,849,841,8,0,842,7,1635,786,617,225,3,5719,0
13,"Cluj",60169,127,60169,,"NEGRENI",572,"Sat Bucea nr.50, Casa de Cultura",631,405,398,7,0,404,1,690,285,218,186,3,5719,0
13,"Cluj",60169,127,60169,,"NEGRENI",573,"sat Negreni, Sediul Primariei Negreni , str.Principala nr.63",0,70,0,70,0,70,0,200,130,33,37,3,5719,1
13,"Cluj",58856,127,58856,,"PANTICEU",574,"Primaria Panticeu, str.Principala nr.93",528,250,243,7,0,245,5,589,339,130,115,3,5729,0
13,"Cluj",58856,127,58856,,"PANTICEU",575,"Sat Darja, Scoala Generala,str.Principala nr.40",185,122,113,9,0,120,2,205,83,64,56,3,5729,0
13,"Cluj",58856,127,58856,,"PANTICEU",576,"Sat Cublesu Somesan, Scoala Generala , str.Principala nr.250/A",360,193,187,6,0,191,2,395,202,64,127,3,5729,0
13,"Cluj",58856,127,58856,,"PANTICEU",577,"Sat Sarata, Caminul Cultural, str.Principala nr.63",232,96,90,6,0,96,0,250,154,50,46,3,5729,0
13,"Cluj",58856,127,58856,,"PANTICEU",578,"Sat Catalina, Caminul Cultural, str.Principala nr.51",61,42,34,8,0,42,0,65,23,22,20,3,5729,0
13,"Cluj",58856,127,58856,,"PANTICEU",579,"sat Panticeu, Scoala Panticeu, nr.92",0,159,0,159,0,159,0,250,91,100,59,3,5729,1
13,"Cluj",58794,127,58794,,"PALATCA",580,"Scoala Generala Palatca, str.Principala nr.456",754,417,415,2,0,410,7,823,406,312,98,3,5723,0
13,"Cluj",58794,127,58794,,"PALATCA",581,"Sat Sava, Scoala Generala nr.84",313,151,143,8,0,149,2,340,189,108,41,3,5723,0
13,"Cluj",58794,127,58794,,"PALATCA",582,"sat Palatca, Scoala Generala Palatca nr.456",0,87,0,87,0,87,0,201,114,63,24,3,5723,1
13,"Cluj",58918,127,58918,,"PETRESTII DE JOS",583,"Camin Cultural, Petrestii de Jos",535,301,299,2,0,297,4,590,289,221,76,3,5735,0
13,"Cluj",58918,127,58918,,"PETRESTII DE JOS",584,"Sat Petrestii de Mijloc, Scoala Petrestii de Mijloc",227,105,97,8,0,102,3,250,145,70,32,3,5735,0
13,"Cluj",58918,127,58918,,"PETRESTII DE JOS",585,"Sat Deleni, Scoala Deleni",199,136,127,9,0,135,1,220,84,95,40,3,5735,0
13,"Cluj",58918,127,58918,,"PETRESTII DE JOS",586,"Sat Livada, Scoala Livada",173,102,94,8,0,101,1,190,88,74,27,3,5735,0
13,"Cluj",58918,127,58918,,"PETRESTII DE JOS",587,"Sat Craiesti, Scoala Craiesti",174,122,112,10,0,120,2,190,68,74,46,3,5735,0
13,"Cluj",58918,127,58918,,"PETRESTII DE JOS",588,"Sat Plaiuri, casa de locuit nr.92",134,99,90,9,0,98,1,145,46,68,30,3,5735,0
13,"Cluj",58918,127,58918,,"PETRESTII DE JOS",589,"sat Petrestii de Jos, Sediul Primariei Petrestii de Jos, nr.76",0,88,0,88,0,88,0,200,112,62,26,3,5735,1
13,"Cluj",58990,127,58990,,"PLOSCOS",590,"Sat Ploscos nr.39, Scoala Generala cu clasele I-VIII",361,144,138,6,0,143,1,395,251,103,40,3,5743,0
13,"Cluj",58990,127,58990,,"PLOSCOS",591,"Sat Valea Florilor nr.50, Scoala cu clasele I-IV",255,149,132,17,0,146,3,280,131,80,66,3,5743,0
13,"Cluj",58990,127,58990,,"PLOSCOS",592,"sat Ploscos, Sediul Primariei Ploscos, str.Principala nr.46",0,38,0,38,0,38,0,200,162,26,12,3,5743,1
13,"Cluj",59041,127,59041,,"POIENI",593,"Primaria Poieni , str.Principala nr.268",997,537,535,2,0,533,4,1100,563,316,217,3,5748,0
13,"Cluj",59041,127,59041,,"POIENI",594,"Sat Bologa nr.204, Scoala cu clasele I-IV",558,333,329,4,0,332,1,615,282,197,135,3,5748,0
13,"Cluj",59041,127,59041,,"POIENI",595,"Sat Morlaca nr.110B, Scoala cu clasele I-IV",708,392,389,3,0,388,4,780,388,275,113,3,5748,0
13,"Cluj",59041,127,59041,,"POIENI",596,"Sat Hodisu nr.176A, Scoala cu clasele I-IV",357,210,202,8,0,208,2,395,185,148,60,3,5748,0
13,"Cluj",59041,127,59041,,"POIENI",597,"Sat Valea Draganului nr.417, Scoala ""Aurel Munteanu""",1406,809,801,8,0,801,8,1545,736,417,384,3,5748,0
13,"Cluj",59041,127,59041,,"POIENI",598,"Sat Tranisu nr.184, Scoala cu clasele I-IV",353,158,153,5,0,158,0,385,227,97,61,3,5748,0
13,"Cluj",59041,127,59041,,"POIENI",599,"Sat Lunca Visagului nr.41, Scoala cu clasele I-IV",220,104,94,10,0,104,0,242,138,48,56,3,5748,0
13,"Cluj",59041,127,59041,,"POIENI",600,"sat Poieni, Caminul Cultural Poieni, str.Principala nr.268",0,107,0,107,0,106,1,250,143,58,48,3,5748,1
13,"Cluj",59238,127,59238,,"RISCA",601,"Sat Risca, nr.317, Scoala cu clasele I-VIII",896,541,540,1,0,539,2,985,444,448,91,3,5767,0
13,"Cluj",59238,127,59238,,"RISCA",602,"Sat Dealu Mare nr.82, Scoala cu clasele I-IV",368,245,239,6,0,244,1,405,160,207,37,3,5767,0
13,"Cluj",59238,127,59238,,"RISCA",603,"Sat Marcesti nr.28, Scoala cu clasele I-IV",200,135,125,10,0,135,0,220,85,113,22,3,5767,0
13,"Cluj",59238,127,59238,,"RISCA",604,"sat Risca, nr.317, Scoala cu clasele I-VIII",0,78,0,78,0,77,1,200,122,58,19,3,5767,1
13,"Cluj",59130,127,59130,,"RECEA-CRISTUR",605,"Primaria comunei Recea Cristur nr.158, sala de sedinte",585,308,293,15,0,301,7,646,338,198,103,3,5757,0
13,"Cluj",59130,127,59130,,"RECEA-CRISTUR",606,"Sat Elciu nr.16, Scoala Generala cu clasele I-IV, sala 1",128,74,68,6,0,71,3,145,71,37,34,3,5757,0
13,"Cluj",59130,127,59130,,"RECEA-CRISTUR",607,"Sat Pustuta nr.20, Scoala Generala cu clasele I-IV, sala 1",92,66,59,7,0,64,2,100,34,20,44,3,5757,0
13,"Cluj",59130,127,59130,,"RECEA-CRISTUR",608,"Sat Ciubancuta nr.55, Scoala Generala cu clasele I-IV, sala 1",172,107,100,7,0,104,3,185,78,44,60,3,5757,0
13,"Cluj",59130,127,59130,,"RECEA-CRISTUR",609,"Sat Ciubanca nr.82, Caminul Cultural, sala B",110,74,65,9,0,72,2,121,47,33,39,3,5757,0
13,"Cluj",59130,127,59130,,"RECEA-CRISTUR",610,"Sat Osoi nr.97, Scoala Generala cu clasele I-IV, sala A",126,98,90,8,0,96,2,140,42,50,46,3,5757,0
13,"Cluj",59130,127,59130,,"RECEA-CRISTUR",611,"sat Recea Cristur,Scoala Generala cu clasele I-IV, str.Principala nr.260",0,82,0,82,0,82,0,200,118,48,34,3,5757,1
13,"Cluj",59283,127,59283,,"SACUIEU",612,"Sacuieu, Caminul Cultural nr.128",444,251,250,1,0,247,4,486,235,137,110,3,5772,0
13,"Cluj",59283,127,59283,,"SACUIEU",613,"Sat Rogojel nr.187/a, Caminul Cultural",578,322,318,4,0,321,1,632,310,247,74,3,5772,0
13,"Cluj",59283,127,59283,,"SACUIEU",614,"Sat Visagu nr.111, Scoala generala cu clasele I-IV",279,153,146,7,0,153,0,310,157,95,58,3,5772,0
13,"Cluj",59283,127,59283,,"SACUIEU",615,"sat Sacuieu, Sediul Primariei Sacuieu nr.129",0,41,0,41,0,41,0,200,159,25,16,3,5772,1
13,"Cluj",55311,127,55311,,"SANDULESTI",616,"Sat Sandulesti nr.162, Scoala Sandulesti",539,273,264,9,0,272,1,595,322,177,95,3,5782,0
13,"Cluj",55311,127,55311,,"SANDULESTI",617,"Sat Copaceni nr.178, Scoala ""Simion Balint""",1081,485,476,9,0,483,2,1185,700,341,142,3,5782,0
13,"Cluj",55311,127,55311,,"SANDULESTI",618,"sat Sandulesti, Sediul Primariei Sandulesti nr.169",0,36,0,36,0,36,0,200,164,23,13,3,5782,1
13,"Cluj",59327,127,59327,,"SAVADISLA",619,"Caminul Cultural Savadisla nr.368",870,384,374,10,0,378,6,957,573,219,159,3,5801,0
13,"Cluj",59327,127,59327,,"SAVADISLA",620,"Sat Finisel nr.106, Scoala cu clasele I-VIII",656,385,374,11,0,383,2,725,340,209,174,3,5801,0
13,"Cluj",59327,127,59327,,"SAVADISLA",621,"Sat Hasdate nr.42, Scoala cu clasele I-VIII",442,272,260,12,0,269,3,485,213,203,66,3,5801,0
13,"Cluj",59327,127,59327,,"SAVADISLA",622,"Sat Lita nr.78, Caminul Cultural",267,172,162,10,0,169,3,295,123,114,55,3,5801,0
13,"Cluj",59327,127,59327,,"SAVADISLA",623,"Sat Liteni nr.177, Scoala cu clasele I-IV",361,183,173,10,0,181,2,395,212,142,39,3,5801,0
13,"Cluj",59327,127,59327,,"SAVADISLA",624,"Sat Stolna nr.22, Scoala cu clasele I-IV",190,129,119,10,0,129,0,209,80,91,38,3,5801,0
13,"Cluj",59327,127,59327,,"SAVADISLA",625,"Sat Valisoara nr.78, Caminul Cultural",69,45,33,12,0,45,0,75,30,27,18,3,5801,0
13,"Cluj",59327,127,59327,,"SAVADISLA",626,"Sat Vlaha nr.240, Caminul Cultural",739,362,352,10,0,355,7,815,453,281,74,3,5801,0
13,"Cluj",59327,127,59327,,"SAVADISLA",627,"sat Savadisla nr.150 ,Scoala ""Borbely Jozsef""",0,141,0,141,0,141,0,250,109,98,43,3,5801,1
13,"Cluj",59434,127,59434,,"SANCRAIU",628,"Sancraiu nr.332, Caminul Cultural",1015,659,607,5,47,654,5,1120,461,343,311,3,5776,0
13,"Cluj",59434,127,59434,,"SANCRAIU",629,"Sat Alunisu nr.74, Caminul Cultural",122,79,65,7,7,73,6,130,51,39,34,3,5776,0
13,"Cluj",59434,127,59434,,"SANCRAIU",630,"Sat Domosu nr.22, Caminul Cultural",295,174,164,8,2,174,0,325,151,91,83,3,5776,0
13,"Cluj",59434,127,59434,,"SANCRAIU",631,"sat Sancraiu, Sediul Primariei Sancraiu nr.340",0,46,0,46,0,46,0,200,154,23,23,3,5776,1
13,"Cluj",59498,127,59498,,"SANMARTIN",632,"Primaria Comunei Sanmartin nr.207",198,115,112,3,0,113,2,220,105,59,54,3,5785,0
13,"Cluj",59498,127,59498,,"SANMARTIN",633,"Sat Ceaba nr.71, Scoala cu clasele I-IV",214,148,140,8,0,146,2,235,87,123,23,3,5785,0
13,"Cluj",59498,127,59498,,"SANMARTIN",634,"Sat Cutca nr.163, Scoala cu clasele I-VIII",401,285,279,6,0,282,3,441,156,227,55,3,5785,0
13,"Cluj",59498,127,59498,,"SANMARTIN",635,"Sat Samboieni nr.36, Caminul Cultural",157,123,117,6,0,121,2,175,52,90,31,3,5785,0
13,"Cluj",59498,127,59498,,"SANMARTIN",636,"Sat Targusor nr.32, Scoala cu clasele I-IV",100,73,65,8,0,71,2,110,37,41,30,3,5785,0
13,"Cluj",59498,127,59498,,"SANMARTIN",637,"Sat Mahal nr.47, Scoala cu clasele I-IV",82,67,60,7,0,67,0,85,18,43,24,3,5785,0
13,"Cluj",59498,127,59498,,"SANMARTIN",638,"Sat Diviciorii Mari nr.148, Scoala cu clasele I-IV",151,119,111,8,0,119,0,165,46,93,26,3,5785,0
13,"Cluj",59498,127,59498,,"SANMARTIN",639,"Sat Diviciorii Mici nr.71, Scoala cu clasele I-IV",65,56,49,7,0,56,0,75,19,41,15,3,5785,0
13,"Cluj",59498,127,59498,,"SANMARTIN",640,"sat Sanmartin, Sediul Primariei Sanmartin nr.207",0,107,0,107,0,107,0,200,93,67,40,3,5785,1
13,"Cluj",59586,127,59586,,"SANPAUL",641,"Sediul Primariei Sanpaul nr.195",719,416,411,5,0,406,10,792,376,222,184,3,5794,0
13,"Cluj",59586,127,59586,,"SANPAUL",642,"Sat Sardu nr.7, Scoala Generala",376,219,213,6,0,218,1,415,196,170,48,3,5794,0
13,"Cluj",59586,127,59586,,"SANPAUL",643,"Sat Berindu nr.56, Scoala Generala",380,227,219,6,2,225,2,424,197,101,124,3,5794,0
13,"Cluj",59586,127,59586,,"SANPAUL",644,"Sat Mihaiesti nr.28, Scoala Generala",251,161,148,13,0,156,5,275,114,102,54,3,5794,0
13,"Cluj",59586,127,59586,,"SANPAUL",645,"Sat Topa Mica nr.19, Magazinul Cooperatiei",213,91,85,6,0,91,0,235,144,63,28,3,5794,0
13,"Cluj",59586,127,59586,,"SANPAUL",646,"sat Sanpaul, Primaria Comunei Sanpaul nr.195",0,122,0,122,0,121,1,251,129,72,49,3,5794,1
13,"Cluj",59416,127,59416,,"SIC",647,"sat Sic,Caminul Cultural Sic strada a-III-a nr. 360",2190,585,579,6,0,575,10,2410,1825,192,383,3,5810,0
13,"Cluj",59416,127,59416,,"SIC",648,"sat Sic, Caminul Cultural Sic",0,26,0,26,0,25,1,200,174,11,14,3,5810,1
13,"Cluj",59657,127,59657,,"SUATU",649,"Primaria Comunei Suatu nr.685",1226,583,582,1,0,567,16,1340,757,329,238,3,5812,0
13,"Cluj",59657,127,59657,,"SUATU",650,"Sat Aruncuta, Sediul Administrativ nr.201",326,164,159,5,0,161,3,360,196,74,87,3,5812,0
13,"Cluj",59657,127,59657,,"SUATU",651,"sat Suatu, Sediul Primariei Suatu nr.685",0,81,0,81,0,81,0,200,119,56,25,3,5812,1
13,"Cluj",59693,127,59693,,"TRITENII DE JOS",652,"Tritenii de Jos, str.Principala nr.390, Scoala ""Pavel Dan""",1292,602,589,10,3,598,4,1420,818,409,189,3,5822,0
13,"Cluj",59693,127,59693,,"TRITENII DE JOS",653,"Sat  Tritenii de Sus nr.84, Scoala cu clasele I-VIII",919,475,466,9,0,471,4,1010,535,284,187,3,5822,0
13,"Cluj",59693,127,59693,,"TRITENII DE JOS",654,"Sat Padureni nr.257, Caminul Cultural",1060,442,435,7,0,437,5,1154,712,233,204,3,5822,0
13,"Cluj",59693,127,59693,,"TRITENII DE JOS",655,"Sat Colonia nr.124, Scoala cu clasele I-IV",399,186,177,8,1,184,2,440,254,102,82,3,5822,0
13,"Cluj",59693,127,59693,,"TRITENII DE JOS",656,"Sat Tritenii Hotar nr.101, Scoala cu clasele I-IV",266,123,108,11,4,119,4,296,173,76,43,3,5822,0
13,"Cluj",59693,127,59693,,"TRITENII DE JOS",657,"Sat Clapa nr.23",78,46,37,9,0,45,1,85,39,32,13,3,5822,0
13,"Cluj",59693,127,59693,,"TRITENII DE JOS",658,"sat Tritenii de Jos, str. Principala nr.390, Scoala ""Pavel Dan""",0,55,0,55,0,55,0,200,145,32,23,3,5822,1
13,"Cluj",59764,127,59764,,"TURENI",659,"Primaria Comunei Tureni, str. Principala nr.243, Sala de Festivitati",831,448,441,7,0,447,1,912,464,307,140,3,5829,0
13,"Cluj",59764,127,59764,,"TURENI",660,"Sat Ceanu Mic, str.Principala nr.184, Scoala Generala cu clasele I-IV, Sala 1",394,180,175,5,0,179,1,435,255,106,73,3,5829,0
13,"Cluj",59764,127,59764,,"TURENI",661,"Sat Comsesti, str.Principala nr.111, Scoala Generala cu clasele I-IV, Sala 1",185,91,83,8,0,91,0,205,114,72,19,3,5829,0
13,"Cluj",59764,127,59764,,"TURENI",662,"Sat Micesti, str.Principala nr.57, Scoala Generala cu clasele I-IV, Sala 1",294,151,142,9,0,147,4,320,169,86,61,3,5829,0
13,"Cluj",59764,127,59764,,"TURENI",663,"Sat Martinesti, str.Principala nr.60, Scoala Generala cu clasele I-IV, Sala 1",291,159,150,9,0,157,2,320,161,119,38,3,5829,0
13,"Cluj",59764,127,59764,,"TURENI",664,"sat Tureni, Gradinita Tureni nr.205",0,64,0,64,0,63,1,150,86,34,29,3,5829,1
13,"Cluj",59826,127,59826,,"TAGA",665,"Primaria Taga  nr.23, Sala de Sedinte",661,380,380,0,0,379,1,725,345,185,194,3,5816,0
13,"Cluj",59826,127,59826,,"TAGA",666,"Sat Santioana nr.65, Scoala cu clasele I-IV, Sala de clasa",494,272,267,5,0,272,0,540,268,141,131,3,5816,0
13,"Cluj",59826,127,59826,,"TAGA",667,"Sat Nasal nr.276, fosta Scoala cu clasele I-IV, Sala de clasa",341,192,184,8,0,190,2,375,183,94,96,3,5816,0
13,"Cluj",59826,127,59826,,"TAGA",668,"Sat Sintejude nr.108, Fosta Scoala cu clasele I-IV, Sala de clasa",228,116,108,8,0,112,4,255,139,48,64,3,5816,0
13,"Cluj",59826,127,59826,,"TAGA",669,"satTaga nr.137A, Scoala cu clasele I-IV",0,66,0,66,0,66,0,150,84,26,40,3,5816,1
13,"Cluj",59880,127,59880,,"UNGURAS",670,"Caminul Cultural Unguras nr.154",1601,640,639,1,0,629,11,1763,1123,340,289,3,5835,0
13,"Cluj",59880,127,59880,,"UNGURAS",671,"Sat Batin nr.54, Scoala cu clasele I-VIII",653,338,332,6,0,332,6,715,377,157,175,3,5835,0
13,"Cluj",59880,127,59880,,"UNGURAS",672,"Sat Valea Ungurasului nr.25, Scoala cu clasele I-IV",208,140,131,9,0,138,2,230,90,106,32,3,5835,0
13,"Cluj",59880,127,59880,,"UNGURAS",673,"sat Unguras nr.36, Gradinita cu program normal",0,53,0,53,0,53,0,200,147,27,26,3,5835,1
13,"Cluj",59942,127,59942,,"VAD",674,"Sat Vad nr.170, Scoala Vad",292,174,171,0,3,170,4,318,144,76,94,3,5841,0
13,"Cluj",59942,127,59942,,"VAD",675,"Sat Cetan nr.67, Scoala Cetan",458,265,258,7,0,258,7,506,241,127,131,3,5841,0
13,"Cluj",59942,127,59942,,"VAD",676,"Sat Bogata de Jos nr.53, Scoala Bogata de Jos",241,171,167,4,0,168,3,265,94,95,73,3,5841,0
13,"Cluj",59942,127,59942,,"VAD",677,"Sat Curtuiusu Dejului nr.110, Scoala Curtuiusu Dejului",148,100,93,7,0,96,4,165,65,39,57,3,5841,0
13,"Cluj",59942,127,59942,,"VAD",678,"Sat Bogata de Sus nr.138, Scoala Bogata De Sus",234,139,134,5,0,136,3,255,116,67,69,3,5841,0
13,"Cluj",59942,127,59942,,"VAD",679,"Sat Valea Grosilor  nr.27, Scoala Valea Grosilor",228,137,133,4,0,133,4,255,118,59,74,3,5841,0
13,"Cluj",59942,127,59942,,"VAD",680,"Sat Calna nr.37, Scoala Calna",122,94,87,7,0,93,1,130,36,49,44,3,5841,0
13,"Cluj",59942,127,59942,,"VAD",681,"sat Vad, Scoala Generala Vad nr.171",0,111,0,111,0,110,1,200,89,56,54,3,5841,1
13,"Cluj",60026,127,60026,,"VALEA IERII",682,"sat Valea Ierii nr.50, Caminul Cultural",846,525,514,9,2,522,3,935,410,414,108,3,5849,0
13,"Cluj",60026,127,60026,,"VALEA IERII",683,"sat Valea Ierii nr.50, Caminul Cultural",0,41,0,41,0,41,0,200,159,26,15,3,5849,1
13,"Cluj",60062,127,60062,,"VIISOARA",684,"Viisoara, Scoala cu clasele I-VIII",1847,746,732,11,3,735,11,2035,1289,522,213,3,5853,0
13,"Cluj",60062,127,60062,,"VIISOARA",685,"Viisoara, Scoala generala cu clasele I-IV",2188,1111,1067,25,19,1091,20,2410,1299,643,448,3,5853,0
13,"Cluj",60062,127,60062,,"VIISOARA",686,"Sat Urca , Scoala Generala Urca",854,392,379,13,0,387,5,935,543,202,185,3,5853,0
13,"Cluj",60062,127,60062,,"VIISOARA",687,"sat Viisoara, Caminul Cultural Viisoara",0,74,0,74,0,71,3,300,226,49,22,3,5853,1
13,"Cluj",60099,127,60099,,"VULTURENI",688,"Sediul Primariei Comunei Vultureni nr.73",330,162,157,5,0,161,1,360,198,77,84,3,5856,0
13,"Cluj",60099,127,60099,,"VULTURENI",689,"Sat Babutiu nr.68, Scoala Generala",157,108,101,7,0,107,1,175,67,47,60,3,5856,0
13,"Cluj",60099,127,60099,,"VULTURENI",690,"Sat Badesti nr.107, Caminul Cultural",112,79,74,5,0,78,1,120,41,30,48,3,5856,0
13,"Cluj",60099,127,60099,,"VULTURENI",691,"Sat Chidea nr.166, Sediul Fundatiei KIDE (fost sediu CAP)",113,54,46,8,0,53,1,120,66,21,32,3,5856,0
13,"Cluj",60099,127,60099,,"VULTURENI",692,"Sat Faureni nr.21, Scoala Generala",179,119,112,7,0,116,3,201,82,77,39,3,5856,0
13,"Cluj",60099,127,60099,,"VULTURENI",693,"Sat Soimeni nr.16, Scoala Generala",291,149,145,4,0,148,1,320,171,56,92,3,5856,0
13,"Cluj",60099,127,60099,,"VULTURENI",694,"sat Vultureni, Sediul Primariei Vultureni nr.73",0,134,0,134,0,133,1,300,166,63,70,3,5856,1
14,"Constanta",60419,136,60419,,"MUNICIPIUL CONSTANTA",1,"LICEUL MIHAI EMINESCU - STR TRAIAN NR.19",909,503,493,10,0,499,4,1000,497,255,244,1,5864,0
14,"Constanta",60419,136,60419,,"MUNICIPIUL CONSTANTA",2,"LICEUL MIHAI EMINESCU - STR. TRAIAN NR.19",877,468,458,10,0,462,6,1001,533,272,190,1,5864,0
14,"Constanta",60419,136,60419,,"MUNICIPIUL CONSTANTA",3,"SCOALA NR.2 - STR. ARISTIDE KARATZALI NR.13",1249,670,662,8,0,662,8,1400,730,409,253,1,5864,0
14,"Constanta",60419,136,60419,,"MUNICIPIUL CONSTANTA",4,"COLEGIUL NATIONAL MIRCEA CEL  BATRIN - STR.STEFAN CEL MARE NR6",857,508,498,9,1,500,8,900,392,248,252,1,5864,0
14,"Constanta",60419,136,60419,,"MUNICIPIUL CONSTANTA",5,"COLEGIUL NATIONAL MIRCEA CEL  BATRIN - STR.STEFAN CEL MARE NR6",680,434,425,9,0,426,8,700,266,216,210,1,5864,0
14,"Constanta",60419,136,60419,,"MUNICIPIUL CONSTANTA",6,"SCOALA NR.28 - STR. DECEBAL NR.15",579,332,311,21,0,327,5,600,268,177,150,1,5864,0
14,"Constanta",60419,136,60419,,"MUNICIPIUL CONSTANTA",7,"COLEGIUL ECONOMIC CAROL  I - STR.DECEBAL NR.15",1593,1005,994,11,0,994,11,1800,795,547,447,1,5864,0
14,"Constanta",60419,136,60419,,"MUNICIPIUL CONSTANTA",8,"COLEGIUL ECONOMIC CAROL  I - STR. DECEBAL NR.15",1121,649,640,9,0,637,12,1200,551,330,307,1,5864,0
14,"Constanta",60419,136,60419,,"MUNICIPIUL CONSTANTA",9,"COLEGIUL PEDAGOGIC  'CONSTANTIN BRATESCU' - STR. 1907 NR.42",1818,1070,1052,18,0,1058,12,2000,930,655,403,1,5864,0
14,"Constanta",60419,136,60419,,"MUNICIPIUL CONSTANTA",10,"COLEGIUL PEDAGOGIC  'CONSTANTIN BRATESCU' - STR. 1907 NR.42",1533,862,852,10,0,851,11,1701,839,487,364,1,5864,0
14,"Constanta",60419,136,60419,,"MUNICIPIUL CONSTANTA",11,"GRADINITA CU ORAR PRELUNGIT PERLUTELE MARII - STR. MIHAI VITEAZU NR.56",1631,936,921,15,0,928,8,1800,864,529,399,1,5864,0
14,"Constanta",60419,136,60419,,"MUNICIPIUL CONSTANTA",12,"SCOALA NR.25 - STR. CUZA VODA NR.80",1487,810,794,14,2,798,12,1600,790,484,314,1,5864,0
14,"Constanta",60419,136,60419,,"MUNICIPIUL CONSTANTA",13,"TEATRUL 'FANTASIO' - BD. FERDINAND",769,507,496,11,0,499,8,800,293,213,286,1,5864,0
14,"Constanta",60419,136,60419,,"MUNICIPIUL CONSTANTA",14,"TEATRUL 'FANTASIO' - BD. FERDINAND",927,590,574,15,1,580,10,1000,410,312,268,1,5864,0
14,"Constanta",60419,136,60419,,"MUNICIPIUL CONSTANTA",15,"LICEUL 'TRAIAN' - STR. TRAIAN NR.55",1066,637,626,11,0,628,9,1200,563,315,313,1,5864,0
14,"Constanta",60419,136,60419,,"MUNICIPIUL CONSTANTA",16,"LICEUL 'TRAIAN' - STR.TRAIAN NR.55",807,527,518,9,0,524,3,900,373,270,254,1,5864,0
14,"Constanta",60419,136,60419,,"MUNICIPIUL CONSTANTA",17,"LICEUL 'TRAIAN' - STR. TRAIAN NR.55",1142,700,683,17,0,693,7,1300,600,418,275,1,5864,0
14,"Constanta",60419,136,60419,,"MUNICIPIUL CONSTANTA",18,"SCOALA NR.25 ARIPA STANGA - STR. CUZA VODA NR.80",1309,744,723,21,0,730,14,1400,656,448,282,1,5864,0
14,"Constanta",60419,136,60419,,"MUNICIPIUL CONSTANTA",19,"SCOALA NR.25 ARIPA DREAPTA - STR. CUZA VODA NR.80",1446,854,841,13,0,843,11,1600,746,482,361,1,5864,0
14,"Constanta",60419,136,60419,,"MUNICIPIUL CONSTANTA",20,"SCOALA NR.24 - STR. GRIVITEI NR.70",1432,967,956,11,0,952,15,1600,633,495,457,1,5864,0
14,"Constanta",60419,136,60419,,"MUNICIPIUL CONSTANTA",21,"SCOALA NR.24 - STR. GRIVITEI NR.70",1511,981,970,11,0,970,11,1700,719,517,453,1,5864,0
14,"Constanta",60419,136,60419,,"MUNICIPIUL CONSTANTA",22,"LICEUL CU PROGRAM SPORTIV (FOSTA SCOALA NR.34) - STR. ION CORVIN,NR 2",1643,1042,1031,11,0,1033,9,1800,758,578,455,1,5864,0
14,"Constanta",60419,136,60419,,"MUNICIPIUL CONSTANTA",23,"LICEUL CU PROGRAM SPORTIV (FOSTA SCOALA NR.34) - STR. ION CORVIN,NR 2",1227,728,720,8,0,715,13,1300,572,382,333,1,5864,0
14,"Constanta",60419,136,60419,,"MUNICIPIUL CONSTANTA",24,"LICEUL CU PROGRAM SPORTIV (FOSTA SCOALA NR.34) - STR. ION CORVIN,NR 2",1455,872,862,10,0,861,11,1600,728,442,419,1,5864,0
14,"Constanta",60419,136,60419,,"MUNICIPIUL CONSTANTA",25,"LICEUL DE ARTA - BD.AL.LAPUSNEANU NR.1",1128,709,700,9,0,701,8,1200,491,381,320,1,5864,0
14,"Constanta",60419,136,60419,,"MUNICIPIUL CONSTANTA",26,"GRUP SCOLAR  SPORTIV (FOSTA SCOALA NR.34) - STR. ION CORVIN,NR 2",1699,1102,1092,10,0,1090,12,1899,797,582,508,1,5864,0
14,"Constanta",60419,136,60419,,"MUNICIPIUL CONSTANTA",27,"LICEUL 'OVIDIUS'- STRADELA BASARABI NR.2",1827,972,957,14,1,957,15,2000,1028,543,414,1,5864,0
14,"Constanta",60419,136,60419,,"MUNICIPIUL CONSTANTA",28,"SCOALA NR.21 - 'I.L.CARAGIALE' - STR. CORBULUI NR.2",2077,1127,1108,19,0,1118,9,2300,1173,574,544,1,5864,0
14,"Constanta",60419,136,60419,,"MUNICIPIUL CONSTANTA",29,"LICEUL 'OVIDIUS' - STRADELA BASARABI NR.2",1203,772,763,9,0,764,8,1300,528,373,391,1,5864,0
14,"Constanta",60419,136,60419,,"MUNICIPIUL CONSTANTA",30,"GRUP SCOLAR DE CONSTRUCTII  MASINI (SNC) - BD. 1 MAI NR.44",1305,765,754,11,0,754,11,1399,634,386,368,1,5864,0
14,"Constanta",60419,136,60419,,"MUNICIPIUL CONSTANTA",31,"LICEUL 'OVIDIUS' - STRADELA BASARABI  NR.2",1428,838,829,9,0,826,12,1600,762,442,384,1,5864,0
14,"Constanta",60419,136,60419,,"MUNICIPIUL CONSTANTA",32,"GRUP SCOLAR DE CONSTRUCTII  MASINI (SNC) - BD. 1 MAI  NR.44",1012,624,612,12,0,613,11,1100,476,343,270,1,5864,0
14,"Constanta",60419,136,60419,,"MUNICIPIUL CONSTANTA",33,"GRUP SCOLAR DE CONSTRUCTII  MASINI (SNC) - BD. 1 MAI  NR.44",1627,1005,962,43,0,990,15,1800,795,514,476,1,5864,0
14,"Constanta",60419,136,60419,,"MUNICIPIUL CONSTANTA",34,"SCOALA NR.16 - SOS. MANGALIEI NR.89",1770,1006,998,8,0,998,8,1900,894,516,482,1,5864,0
14,"Constanta",60419,136,60419,,"MUNICIPIUL CONSTANTA",35,"SCOALA NR.16 - SOS. MANGALIEI NR.89",1674,999,978,21,0,985,14,1800,801,493,492,1,5864,0
14,"Constanta",60419,136,60419,,"MUNICIPIUL CONSTANTA",36,"SCOALA NR.16 - SOS. MANGALIEI NR.89",1840,1078,1070,8,0,1056,22,2000,922,453,603,1,5864,0
14,"Constanta",60419,136,60419,,"MUNICIPIUL CONSTANTA",37,"SCOALA NR.16 - SOS. MANGALIEI NR.89",1977,1074,1056,18,0,1062,12,2200,1126,589,473,1,5864,0
14,"Constanta",60419,136,60419,,"MUNICIPIUL CONSTANTA",38,"ANEXA LICEU 'LUCIAN BLAGA'  (FOSTA SCOALA NR.41 )- STR. MARTISOR NR3-5",1180,647,630,17,0,638,9,1300,653,360,278,1,5864,0
14,"Constanta",60419,136,60419,,"MUNICIPIUL CONSTANTA",39,"ANEXA LICEU 'LUCIAN BLAGA'  (FOSTA SCOALA NR.41 )- STR. MARTISOR NR3-5",2025,1109,1097,12,0,1085,24,2200,1091,530,555,1,5864,0
14,"Constanta",60419,136,60419,,"MUNICIPIUL CONSTANTA",40,"LICEUL DE MARINA - BD 1MAI NR.101",1858,976,962,14,0,967,9,2000,1024,527,440,1,5864,0
14,"Constanta",60419,136,60419,,"MUNICIPIUL CONSTANTA",41,"LICEUL DE MARINA - BD 1MAI NR.101",2349,1374,1355,19,0,1359,15,2600,1226,664,695,1,5864,0
14,"Constanta",60419,136,60419,,"MUNICIPIUL CONSTANTA",42,"LICEUL DE MARINA - BD 1MAI NR.101",1900,1083,1071,12,0,1074,9,2100,1017,400,674,1,5864,0
14,"Constanta",60419,136,60419,,"MUNICIPIUL CONSTANTA",43,"LICEUL DE MARINA - BD 1MAI NR.101",2191,1205,1189,15,1,1192,13,2400,1195,590,602,1,5864,0
14,"Constanta",60419,136,60419,,"MUNICIPIUL CONSTANTA",44,"LICEUL DE MARINA - BD 1MAI NR.101",1968,1174,1164,10,0,1162,12,2200,1026,603,559,1,5864,0
14,"Constanta",60419,136,60419,,"MUNICIPIUL CONSTANTA",45,"SCOALA NR.15 'GRIGORE ANTIPA' - SOS. MANGALIEI NR.128",2147,1262,1245,17,0,1246,16,2400,1138,643,603,1,5864,0
14,"Constanta",60419,136,60419,,"MUNICIPIUL CONSTANTA",46,"SCOALA NR.15 'GRIGORE ANTIPA' - SOS. MANGALIEI NR.128",2074,1190,1172,18,0,1181,9,2300,1110,651,530,1,5864,0
14,"Constanta",60419,136,60419,,"MUNICIPIUL CONSTANTA",47,"SCOALA NR.17 - STR. MESTERUL MANOLE NR.42",2052,1162,1145,17,0,1144,18,2300,1138,672,472,1,5864,0
14,"Constanta",60419,136,60419,,"MUNICIPIUL CONSTANTA",48,"SCOALA NR.17 - STR.MESTERUL MANOLE NR.42",1447,855,843,12,0,844,11,1600,745,480,364,1,5864,0
14,"Constanta",60419,136,60419,,"MUNICIPIUL CONSTANTA",49,"SCOALA NR.17 - STR. MESTERUL MANOLE NR.42",1882,1057,1033,23,1,1049,8,2100,1043,561,488,1,5864,0
14,"Constanta",60419,136,60419,,"MUNICIPIUL CONSTANTA",50,"SCOALA NR.17 - STR. MESTERUL MANOLE NR.42",1826,1107,1089,17,1,1097,10,2000,893,634,463,1,5864,0
14,"Constanta",60419,136,60419,,"MUNICIPIUL CONSTANTA",51,"SCOALA NR.33 - KM 4-5  ALEEA NARCISELOR NR.2",1398,797,785,12,0,791,6,1500,703,348,443,1,5864,0
14,"Constanta",60419,136,60419,,"MUNICIPIUL CONSTANTA",52,"SCOALA NR.33 - KM 4-5  ALEEA NARCISELOR NR.2",1423,872,854,18,0,864,8,1600,728,443,421,1,5864,0
14,"Constanta",60419,136,60419,,"MUNICIPIUL CONSTANTA",53,"SCOALA NR.33 - KM 4-5  ALEEA NARCISELOR NR.2",1398,942,923,19,0,932,10,1600,658,462,470,1,5864,0
14,"Constanta",60419,136,60419,,"MUNICIPIUL CONSTANTA",54,"SCOALA NR.33 - KM 4-5  ALEEA NARCISELOR NR.2",1168,738,726,12,0,733,5,1300,562,357,376,1,5864,0
14,"Constanta",60419,136,60419,,"MUNICIPIUL CONSTANTA",55,"SCOALA NR.37 - STR. ARCULUI NR.4",1288,779,743,36,0,771,8,1400,621,395,376,1,5864,0
14,"Constanta",60419,136,60419,,"MUNICIPIUL CONSTANTA",56,"SCOALA NR.37 - STR. ARCULUI NR.4",1452,872,861,11,0,866,6,1600,728,470,396,1,5864,0
14,"Constanta",60419,136,60419,,"MUNICIPIUL CONSTANTA",57,"SCOALA NR.37 - STR.ARCULUI NR.4",1403,843,812,31,0,835,8,1500,657,400,435,1,5864,0
14,"Constanta",60419,136,60419,,"MUNICIPIUL CONSTANTA",58,"SCOALA NR.18 'JEAN BARTH' - STR.ION URSU NR.51A",1476,825,814,11,0,821,4,1599,774,404,417,1,5864,0
14,"Constanta",60419,136,60419,,"MUNICIPIUL CONSTANTA",59,"SCOALA NR.18 'JEAN BARTH' - STR.ION URSU NR.51A",1306,758,742,16,0,746,12,1400,642,368,378,1,5864,0
14,"Constanta",60419,136,60419,,"MUNICIPIUL CONSTANTA",60,"GRUP SCOLAR ALIMENTAR - BD AUREL VLAICU NR 86",1471,845,833,12,0,836,9,1600,755,447,389,1,5864,0
14,"Constanta",60419,136,60419,,"MUNICIPIUL CONSTANTA",61,"GRUP SCOLAR ALIMENTAR - BD AUREL VLAICU NR 86",2044,1137,1123,14,0,1125,12,2200,1063,524,601,1,5864,0
14,"Constanta",60419,136,60419,,"MUNICIPIUL CONSTANTA",62,"GRUP SCOLAR 'DIMITRIE LEONIDA'-ALEEA PELICANULUI NR.8",2021,1134,1123,10,1,1125,9,2200,1066,599,526,1,5864,0
14,"Constanta",60419,136,60419,,"MUNICIPIUL CONSTANTA",63,"GRUP SCOLAR 'DIMITRIE LEONIDA'-ALEEA PELICANULUI NR.8",2076,1156,1139,17,0,1146,10,2300,1144,581,565,1,5864,0
14,"Constanta",60419,136,60419,,"MUNICIPIUL CONSTANTA",64,"SCOALA NR 18 'JEAN BARTH'-STR. ION URSU NR.51A",2446,1465,1452,13,0,1448,17,2700,1235,762,686,1,5864,0
14,"Constanta",60419,136,60419,,"MUNICIPIUL CONSTANTA",65,"SCOALA NR 40 'AUREL VLAICU'-ALEEA PELICANULUI NR.2",2313,1149,1136,13,0,1140,9,2500,1351,556,584,1,5864,0
14,"Constanta",60419,136,60419,,"MUNICIPIUL CONSTANTA",66,"SCOALA NR 40 'AUREL VLAICU'-ALEEA PELICANULUI NR.2",2289,1100,1084,16,0,1093,7,2500,1400,475,618,1,5864,0
14,"Constanta",60419,136,60419,,"MUNICIPIUL CONSTANTA",67,"SCOALA NR 40 'AUREL VLAICU'-ALEEA PELICANULUI NR.2",1701,955,946,9,0,946,9,1900,945,468,478,1,5864,0
14,"Constanta",60419,136,60419,,"MUNICIPIUL CONSTANTA",68,"SCOALA NR 40 'AUREL VLAICU'-ALEEA PELICANULUI NR.2",1816,1024,1008,16,0,1004,20,2000,976,519,485,1,5864,0
14,"Constanta",60419,136,60419,,"MUNICIPIUL CONSTANTA",69,"SCOALA NR 19-STR. MEDEEA NR.6",1130,630,595,35,0,626,4,1200,570,300,326,1,5864,0
14,"Constanta",60419,136,60419,,"MUNICIPIUL CONSTANTA",70,"SCOALA NR 19-STR. MEDEEA NR.6",1649,906,896,10,0,890,16,1800,894,468,422,1,5864,0
14,"Constanta",60419,136,60419,,"MUNICIPIUL CONSTANTA",71,"SCOALA NR 19-STR. MEDEEA NR.6",1306,760,748,12,0,751,9,1400,640,360,391,1,5864,0
14,"Constanta",60419,136,60419,,"MUNICIPIUL CONSTANTA",72,"SCOALA NR 31-BD. I.C.BRATIANU NR.143",1690,890,871,19,0,883,7,1900,1010,424,459,1,5864,0
14,"Constanta",60419,136,60419,,"MUNICIPIUL CONSTANTA",73,"GRUP SCOLAR C.F.R-STR. VIFOR HAIDUCUL NR.34",1738,1034,993,41,0,1018,16,1900,866,445,573,1,5864,0
14,"Constanta",60419,136,60419,,"MUNICIPIUL CONSTANTA",74,"SCOALA NR 20-STR.MIHU COPILU NR.1",1383,766,758,6,2,755,11,1500,734,322,433,1,5864,0
14,"Constanta",60419,136,60419,,"MUNICIPIUL CONSTANTA",75,"SCOALA NR 31-BD. I.C.BRATIANU NR.143",1962,1075,1059,16,0,1062,13,2200,1125,484,578,1,5864,0
14,"Constanta",60419,136,60419,,"MUNICIPIUL CONSTANTA",76,"SCOALA NR 22-STR. RAZVAN VODA NR.6",1863,1067,1055,11,1,1054,13,2000,933,495,559,1,5864,0
14,"Constanta",60419,136,60419,,"MUNICIPIUL CONSTANTA",77,"SCOALA AJUTATOARE NR 2-STR. NICU MANDAI NR.15",1707,1010,999,11,0,998,12,1900,890,479,519,1,5864,0
14,"Constanta",60419,136,60419,,"MUNICIPIUL CONSTANTA",78,"SCOALA NR 22-STR. RAZVAN VODA NR.6",1281,736,729,7,0,729,7,1400,664,405,324,1,5864,0
14,"Constanta",60419,136,60419,,"MUNICIPIUL CONSTANTA",79,"SCOALA AJUTATOARE NR 2-STR. NICU MANDAI NR.15",876,497,490,7,0,492,5,1000,503,266,226,1,5864,0
14,"Constanta",60419,136,60419,,"MUNICIPIUL CONSTANTA",80,"SCOALA AJUTATOARE NR 2-STR. NICU MANDAI NR.15",2127,1224,1207,16,1,1214,10,2300,1076,678,536,1,5864,0
14,"Constanta",60419,136,60419,,"MUNICIPIUL CONSTANTA",81,"SCOALA NR 8-BD.I.C.BRATIANU NR.68",1594,923,911,12,0,920,3,1802,879,474,446,1,5864,0
14,"Constanta",60419,136,60419,,"MUNICIPIUL CONSTANTA",82,"SCOALA NR 8-BD.I.C.BRATIANU NR.68",1659,976,963,13,0,959,17,1801,825,494,465,1,5864,0
14,"Constanta",60419,136,60419,,"MUNICIPIUL CONSTANTA",83,"SCOALA NR 8-BD.I.C.BRATIANU NR.68",1725,1036,1026,10,0,1025,11,1900,864,554,471,1,5864,0
14,"Constanta",60419,136,60419,,"MUNICIPIUL CONSTANTA",84,"SCOALA NR 8-BD.I.C.BRATIANU NR.68",1596,991,980,11,0,977,14,1800,809,535,442,1,5864,0
14,"Constanta",60419,136,60419,,"MUNICIPIUL CONSTANTA",85,"SCOALA NR 21 'I L CARAGIALE'-STR. CORBULUI NR.2A",2073,1147,1128,19,0,1137,10,2300,1153,523,614,1,5864,0
14,"Constanta",60419,136,60419,,"MUNICIPIUL CONSTANTA",86,"SCOALA NR 21 'I L CARAGIALE'-STR. CORBULUI NR.2A",1954,989,975,14,0,982,7,2100,1111,506,476,1,5864,0
14,"Constanta",60419,136,60419,,"MUNICIPIUL CONSTANTA",87,"SCOALA NR 21 'I L CARAGIALE'-STR. CORBULUI NR.2A",1621,919,902,17,0,910,9,1800,881,426,484,1,5864,0
14,"Constanta",60419,136,60419,,"MUNICIPIUL CONSTANTA",88,"SCOALA NR 21 'I L CARAGIALE'-STR.CORBULUI NR.2A",1535,878,868,10,0,870,8,1700,822,411,459,1,5864,0
14,"Constanta",60419,136,60419,,"MUNICIPIUL CONSTANTA",89,"SCOALA NR 23-STR. DEZROBIRII NR.82",1966,1120,1104,16,0,1114,6,2200,1080,627,487,1,5864,0
14,"Constanta",60419,136,60419,,"MUNICIPIUL CONSTANTA",90,"SCOALA NR 23-STR. DEZROBIRII NR.82",2260,1300,1286,14,0,1290,10,2501,1201,740,550,1,5864,0
14,"Constanta",60419,136,60419,,"MUNICIPIUL CONSTANTA",91,"SCOALA NR 39 'NICOLAE TONITZA'-STR. SOLIDARITATII NR.8",1620,988,973,15,0,979,9,1800,812,491,488,1,5864,0
14,"Constanta",60419,136,60419,,"MUNICIPIUL CONSTANTA",92,"SCOALA NR 39 'NICOLAE TONITZA'-STR. SOLIDARITATII NR.8",1696,1030,1015,15,0,1016,14,1900,870,549,467,1,5864,0
14,"Constanta",60419,136,60419,,"MUNICIPIUL CONSTANTA",93,"SCOALA NR 39 'NICOLAE TONITZA'-STR. SOLIDARITATII NR.8",1844,1060,1045,15,0,1046,14,2000,940,526,520,1,5864,0
14,"Constanta",60419,136,60419,,"MUNICIPIUL CONSTANTA",94,"SCOALA NR 39 'NICOLAE TONITZA'-STR. SOLIDARITATII NR.8",1874,1152,1142,10,0,1138,14,2100,948,595,543,1,5864,0
14,"Constanta",60419,136,60419,,"MUNICIPIUL CONSTANTA",95,"SCOALA NR 10-STR.IZVOR NR.26",2134,1206,1186,20,0,1191,15,2300,1094,692,499,1,5864,0
14,"Constanta",60419,136,60419,,"MUNICIPIUL CONSTANTA",96,"SCOALA NR 23-STR. DEZROBIRII NR.82",2141,1195,1180,14,1,1184,11,2400,1205,646,538,1,5864,0
14,"Constanta",60419,136,60419,,"MUNICIPIUL CONSTANTA",97,"SCOALA NR 10-STR.IZVOR NR.26",1608,962,952,10,0,949,13,1800,838,509,440,1,5864,0
14,"Constanta",60419,136,60419,,"MUNICIPIUL CONSTANTA",98,"SCOALA NR 10-STR.IZVOR NR.26",1358,863,852,11,0,851,12,1500,637,496,355,1,5864,0
14,"Constanta",60419,136,60419,,"MUNICIPIUL CONSTANTA",99,"CENTRUL DE PERFECTIONARE AL MARINEI CIVILE-STR. BABA NOVAC",1988,1156,1139,17,0,1145,11,2200,1044,620,525,1,5864,0
14,"Constanta",60419,136,60419,,"MUNICIPIUL CONSTANTA",100,"SCOLA NR 9 ION CREANGA-STR STRAJERULUI NR 50",1981,1190,1166,24,0,1170,20,2200,1010,649,521,1,5864,0
14,"Constanta",60419,136,60419,,"MUNICIPIUL CONSTANTA",101,"SCOALA NR 10-STR.IZVOR NR.26",1675,1025,1014,11,0,1016,9,1800,775,630,386,1,5864,0
14,"Constanta",60419,136,60419,,"MUNICIPIUL CONSTANTA",102,"SCOALA NR 9 'ION CREANGA'-STR. STRAJERULUI NR.50",1856,1016,1005,10,1,1011,5,2000,984,559,452,1,5864,0
14,"Constanta",60419,136,60419,,"MUNICIPIUL CONSTANTA",103,"SCOALA NR 9 'ION CREANGA'-STR. STRAJERULUI NR.50",1990,1162,1150,12,0,1149,13,2200,1038,607,542,1,5864,0
14,"Constanta",60419,136,60419,,"MUNICIPIUL CONSTANTA",104,"SCOALA AJUTATOARE NR 1-STR. SEMANATORULUI NR.8",2212,1218,1201,17,0,1197,21,2400,1182,600,597,1,5864,0
14,"Constanta",60419,136,60419,,"MUNICIPIUL CONSTANTA",105,"SCOALA AJUTATOARE NR 1-STR. SEMANATORULUI NR.8",1957,1122,1114,8,0,1113,9,2200,1078,611,502,1,5864,0
14,"Constanta",60419,136,60419,,"MUNICIPIUL CONSTANTA",106,"SCOALA NR 12 'BOGDAN PETRICEICU HASDEU'-STR. B.P.HASDEU NR.98",2117,1328,1313,14,1,1312,16,2299,971,720,592,1,5864,0
14,"Constanta",60419,136,60419,,"MUNICIPIUL CONSTANTA",107,"SCOALA NR 12 'BOGDAN PETRICEICU HASDEU'-STR. B.P.HASDEU NR.98",1566,916,896,19,1,907,9,1700,784,488,419,1,5864,0
14,"Constanta",60419,136,60419,,"MUNICIPIUL CONSTANTA",108,"SCOALA AJUTATOARE NR 1-STR. SEMANATORULUI NR.8",1694,1030,980,50,0,1012,18,1900,870,628,384,1,5864,0
14,"Constanta",60419,136,60419,,"MUNICIPIUL CONSTANTA",109,"SCOALA NR 36 'DIMITRIE STIUBEI' -ALEEA FRAGILOR NR.3",1272,750,744,6,0,741,9,1400,650,431,310,1,5864,0
14,"Constanta",60419,136,60419,,"MUNICIPIUL CONSTANTA",110,"SCOALA NR 36 'DIMITRIE STIUBEI' -ALEEA FRAGILOR NR.3",1517,857,845,12,0,844,13,1700,843,424,420,1,5864,0
14,"Constanta",60419,136,60419,,"MUNICIPIUL CONSTANTA",111,"SCOALA NR 36 'DIMITRIE STIUBEI' -ALEEA FRAGILOR NR.3",1502,895,885,10,0,879,16,1700,805,441,438,1,5864,0
14,"Constanta",60419,136,60419,,"MUNICIPIUL CONSTANTA",112,"GRADINITA NR 43-ALEEA FRAGILOR NR.2",1617,944,928,16,0,936,8,1800,856,465,471,1,5864,0
14,"Constanta",60419,136,60419,,"MUNICIPIUL CONSTANTA",113,"GRADINITA NR 43-ALEEA FRAGILOR NR.2",1804,1067,1045,21,1,1049,18,2000,933,546,503,1,5864,0
14,"Constanta",60419,136,60419,,"MUNICIPIUL CONSTANTA",114,"SCOALA NR 36 'DIMITRIE STIUBEI' -ALEEA FRAGILOR NR.3",1864,1113,1100,13,0,1106,7,2100,987,615,491,1,5864,0
14,"Constanta",60419,136,60419,,"MUNICIPIUL CONSTANTA",115,"GRADINITA NR 51-STR. BADEA CIRTAN NR.8",1725,984,977,7,0,973,11,1900,916,479,494,1,5864,0
14,"Constanta",60419,136,60419,,"MUNICIPIUL CONSTANTA",116,"GRADINITA NR 51-STR. BADEA CIRTAN NR.8",1758,1080,1069,11,0,1061,19,1900,820,533,528,1,5864,0
14,"Constanta",60419,136,60419,,"MUNICIPIUL CONSTANTA",117,"SCOALA NR 36 'DIMITRIE STIUBEI' -ALEEA FRAGILOR NR.3",1931,1165,1147,17,1,1149,16,2100,935,612,537,1,5864,0
14,"Constanta",60419,136,60419,,"MUNICIPIUL CONSTANTA",118,"AGENTIA FISCALA NR 1-4-STR. BADEA CIRTAN NR.3",1703,1064,1049,15,0,1053,11,1900,836,589,464,1,5864,0
14,"Constanta",60419,136,60419,,"MUNICIPIUL CONSTANTA",119,"AGENTIA FISCALA NR 1-4-STR. BADEA CIRTAN NR.3",1669,1011,1003,7,1,995,16,1800,789,509,486,1,5864,0
14,"Constanta",60419,136,60419,,"MUNICIPIUL CONSTANTA",120,"LICEUL 'GEORGE CALINESCU'-STR. CPT.DOBRILA EUGENIU NR.6",1290,831,824,7,0,823,8,1400,569,429,394,1,5864,0
14,"Constanta",60419,136,60419,,"MUNICIPIUL CONSTANTA",121,"SCOALA NR 14-PALAZU MARE-ARIPA STINGA-STR.DUMBRAVENI NR.2",1904,1116,1035,16,65,1109,7,2100,984,618,491,1,5864,0
14,"Constanta",60419,136,60419,,"MUNICIPIUL CONSTANTA",122,"SCOALA NR 14-PALAZU MARE-ARIPA STINGA-STR.DUMBRAVENI NR.2",2002,1180,1142,38,0,1159,21,2200,1020,628,531,1,5864,0
14,"Constanta",60419,136,60419,,"MUNICIPIUL CONSTANTA",123,"LICEUL 'GEORGE CALINESCU'-STR. CPT.DOBRILA EUGENIU NR.6",1236,864,854,10,0,852,12,1400,536,428,424,1,5864,0
14,"Constanta",60419,136,60419,,"MUNICIPIUL CONSTANTA",124,"LICEUL 'GEORGE CALINESCU'-STR. CPT.DOBRILA EUGENIU NR.6",1215,766,757,9,0,755,11,1300,534,444,311,1,5864,0
14,"Constanta",60419,136,60419,,"MUNICIPIUL CONSTANTA",125,"SCOALA NR 38-STR. CPT.DOBRILA EUGENIU NR.20",1132,739,727,12,0,729,10,1200,461,368,361,1,5864,0
14,"Constanta",60419,136,60419,,"MUNICIPIUL CONSTANTA",126,"SCOALA NR 38-STR. CPT.DOBRILA EUGENIU NR.20",1157,747,740,7,0,737,10,1300,553,331,406,1,5864,0
14,"Constanta",60419,136,60419,,"MUNICIPIUL CONSTANTA",127,"LICEUL DECEBAL- ALEEA.HORIA AGARICI NR.4",1110,720,708,12,0,711,9,1200,480,349,362,1,5864,0
14,"Constanta",60419,136,60419,,"MUNICIPIUL CONSTANTA",128,"GRUP SCOLAR ECONOMIC 'VIRGIL MADGEARU'(FOSTA SCOALA NR 35-) ALEEA MELODIEI NR 3",1009,609,597,12,0,603,6,1100,491,305,298,1,5864,0
14,"Constanta",60419,136,60419,,"MUNICIPIUL CONSTANTA",129,"GRUP SCOLAR ECONOMIC 'VIRGIL MADGEARU'(FOSTA SCOALA NR 35-) ALEEA MELODIEI NR 3",1289,781,768,13,0,774,7,1400,619,399,375,1,5864,0
14,"Constanta",60419,136,60419,,"MUNICIPIUL CONSTANTA",130,"GRUP SCOLAR ECONOMIC 'VIRGIL MADGEARU'(FOSTA SCOALA NR 35-) ALEEA MELODIEI NR 3",964,579,569,10,0,572,7,1100,521,243,329,1,5864,0
14,"Constanta",60419,136,60419,,"MUNICIPIUL CONSTANTA",131,"GRADINITA NR 12-STR. CPT.DOBRILA EUGENIU NR.14",1458,864,843,20,1,851,13,1600,736,401,450,1,5864,0
14,"Constanta",60419,136,60419,,"MUNICIPIUL CONSTANTA",132,"LICEUL DECEBAL- STR.HORIA AGARICI NR.4",753,462,453,9,0,452,10,800,338,207,245,1,5864,0
14,"Constanta",60419,136,60419,,"MUNICIPIUL CONSTANTA",133,"LICEUL DECEBAL- STR.HORIA AGARICI NR.4",602,375,365,10,0,373,2,700,325,173,200,1,5864,0
14,"Constanta",60419,136,60419,,"MUNICIPIUL CONSTANTA",134,"LICEUL DECEBAL- STR.HORIA AGARICI NR.4",933,564,550,14,0,559,5,1000,436,278,281,1,5864,0
14,"Constanta",60419,136,60419,,"MUNICIPIUL CONSTANTA",135,"SCOALA NR 29-STR.CISMELEI NR.13",771,445,434,11,0,441,4,800,355,214,227,1,5864,0
14,"Constanta",60419,136,60419,,"MUNICIPIUL CONSTANTA",136,"SCOALA NR 29-STR. CISMELEI NR.13",818,575,563,11,1,563,12,900,325,303,260,1,5864,0
14,"Constanta",60419,136,60419,,"MUNICIPIUL CONSTANTA",137,"SCOALA NR 29-STR. CISMELEI NR.13",861,528,518,9,1,519,9,900,372,230,289,1,5864,0
14,"Constanta",60419,136,60419,,"MUNICIPIUL CONSTANTA",138,"SCOALA NR 7-STR. ADAMCLISI NR.2",1341,857,852,5,0,844,13,1500,643,417,427,1,5864,0
14,"Constanta",60419,136,60419,,"MUNICIPIUL CONSTANTA",139,"SCOALA NR 29-STR. CISMELEI NR,13",1190,773,763,10,0,764,9,1300,527,394,370,1,5864,0
14,"Constanta",60419,136,60419,,"MUNICIPIUL CONSTANTA",140,"SCOALA NR 7-STR.ADAMCLISI NR.2",1052,564,556,7,1,560,4,1200,636,291,269,1,5864,0
14,"Constanta",60419,136,60419,,"MUNICIPIUL CONSTANTA",141,"SCOALA NR 12 'BOGDAN PETRICEICU HASDEU'-STR. B.P.HASDEU NR.98",1468,895,887,8,0,883,12,1600,705,424,459,1,5864,0
14,"Constanta",60419,136,60419,,"MUNICIPIUL CONSTANTA",142,"SCOALA NR 7-STR. ADAMCLISI NR.2",1577,1022,1010,12,0,1010,12,1700,678,530,480,1,5864,0
14,"Constanta",60419,136,60419,,"MUNICIPIUL CONSTANTA",143,"SCOALA NR 7-STR.ADAMCLISI NR.2",1381,890,877,13,0,876,14,1500,610,456,420,1,5864,0
14,"Constanta",60419,136,60419,,"MUNICIPIUL CONSTANTA",144,"SCOALA NR 6-ALEEA CAMELIEI NR.2",1115,709,696,13,0,698,11,1200,491,364,334,1,5864,0
14,"Constanta",60419,136,60419,,"MUNICIPIUL CONSTANTA",145,"SCOALA NR 6-ALEEA CAMELIEI NR.2",1261,797,789,8,0,789,8,1400,603,475,314,1,5864,0
14,"Constanta",60419,136,60419,,"MUNICIPIUL CONSTANTA",146,"SCOALA NR 6-ALEEA CAMELIEI NR.2",1187,736,727,9,0,726,10,1300,564,409,317,1,5864,0
14,"Constanta",60419,136,60419,,"MUNICIPIUL CONSTANTA",147,"GRADINITA 13-ALEEA IASOMIEI NR.3",1139,737,725,12,0,724,13,1300,563,352,372,1,5864,0
14,"Constanta",60419,136,60419,,"MUNICIPIUL CONSTANTA",148,"PARCUL COPIILOR-STR. SOVEJA",1206,780,769,11,0,770,10,1300,520,407,363,1,5864,0
14,"Constanta",60419,136,60419,,"MUNICIPIUL CONSTANTA",149,"PARCUL COPIILOR-STR. SOVEJA",1223,748,731,16,1,736,12,1300,552,390,346,1,5864,0
14,"Constanta",60419,136,60419,,"MUNICIPIUL CONSTANTA",150,"SCOALA NR 27-BD. AL.LAPUSNEANU NR.69",1597,1045,1027,16,2,1037,8,1800,755,597,440,1,5864,0
14,"Constanta",60419,136,60419,,"MUNICIPIUL CONSTANTA",151,"SCOALA NR 27-BD. AL.LAPUSNEANU NR,69",1184,723,712,10,1,715,8,1300,577,427,288,1,5864,0
14,"Constanta",60419,136,60419,,"MUNICIPIUL CONSTANTA",152,"GRUP SCOLAR TOMIS,BD TOMIS NR 153",1084,681,670,10,1,672,9,1200,519,409,263,1,5864,0
14,"Constanta",60419,136,60419,,"MUNICIPIUL CONSTANTA",153,"SCOALA NR 30 GHEORGHE TITEICA,STR FLAMINDA NR 13",1296,682,667,15,0,675,7,1400,718,426,249,1,5864,0
14,"Constanta",60419,136,60419,,"MUNICIPIUL CONSTANTA",154,"SCOALA NR 6,AL CAMELIEI NR 2",1072,683,671,12,0,676,7,1200,517,427,249,1,5864,0
14,"Constanta",60419,136,60419,,"MUNICIPIUL CONSTANTA",155,"SCOALA NR 1-BD MAMAIA NR 179",1280,770,751,19,0,758,12,1400,630,481,277,1,5864,0
14,"Constanta",60419,136,60419,,"MUNICIPIUL CONSTANTA",156,"CAMINUL DE PENSIONARI-STR. UNIRII NR.67",1294,803,788,15,0,789,14,1400,597,438,351,1,5864,0
14,"Constanta",60419,136,60419,,"MUNICIPIUL CONSTANTA",157,"LICEUL 'ENERGETIC BD MAMAIA NE 248",1332,845,824,21,0,836,9,1500,655,496,340,1,5864,0
14,"Constanta",60419,136,60419,,"MUNICIPIUL CONSTANTA",158,"LICEUL 'ENERGETIC BD MAMAIA NE 248",701,429,402,27,0,424,5,800,371,235,189,1,5864,0
14,"Constanta",60419,136,60419,,"MUNICIPIUL CONSTANTA",159,"LICEUL 'ENERGETIC BD MAMAIA NE 248",1273,825,814,11,0,810,15,1400,575,467,343,1,5864,0
14,"Constanta",60419,136,60419,,"MUNICIPIUL CONSTANTA",160,"LICEUL ENERGETIC-BD.MAMAIA NR.248",2056,1310,1295,13,2,1295,15,2300,990,724,571,1,5864,0
14,"Constanta",60419,136,60419,,"MUNICIPIUL CONSTANTA",161,"SCOALA NR 3-STR. CIPRIAN PORUMBESCU NR.3",1737,1082,1065,16,1,1069,13,1900,818,585,484,1,5864,0
14,"Constanta",60419,136,60419,,"MUNICIPIUL CONSTANTA",162,"SCOALA NR 3-STR. CIPRIAN PORUMBESCU NR.3",1271,797,786,11,0,789,8,1400,603,467,322,1,5864,0
14,"Constanta",60419,136,60419,,"MUNICIPIUL CONSTANTA",163,"GRADINITA NR 45-STR. UNIRII NR.68",874,577,543,34,0,572,5,1000,423,326,246,1,5864,0
14,"Constanta",60419,136,60419,,"MUNICIPIUL CONSTANTA",164,"SCOALA NR 1-BD. MAMAIA NR.179",1043,665,652,13,0,662,3,1100,435,392,270,1,5864,0
14,"Constanta",60419,136,60419,,"MUNICIPIUL CONSTANTA",165,"SCOALA NR 1-BD. MAMAIA NR.179",1098,709,693,15,1,699,10,1200,491,401,298,1,5864,0
14,"Constanta",60419,136,60419,,"MUNICIPIUL CONSTANTA",166,"SCOALA NR 3-STR. CIPRIAN PORUMBESCU NR.3",1068,655,642,13,0,647,8,1200,545,346,301,1,5864,0
14,"Constanta",60419,136,60419,,"MUNICIPIUL CONSTANTA",167,"UNIVERSITATEA 'OVIDIUS'-MEDICINA-STR. ION VODA NR.58",2013,1177,1159,18,0,1162,15,2200,1023,704,458,1,5864,0
14,"Constanta",60419,136,60419,,"MUNICIPIUL CONSTANTA",168,"UNIVERSITATEA 'OVIDIUS'-BD. MAMAIA NR.124",1092,665,657,8,0,663,2,1200,535,415,248,1,5864,0
14,"Constanta",60419,136,60419,,"MUNICIPIUL CONSTANTA",169,"UNIVERSITATEA 'OVIDIUS'-BD. MAMAIA NR.124",1082,673,620,19,34,666,7,1200,527,436,230,1,5864,0
14,"Constanta",60419,136,60419,,"MUNICIPIUL CONSTANTA",170,"SCOALA NR.43 - STR. UNIRII NR.12",1117,682,673,9,0,672,10,1200,518,419,253,1,5864,0
14,"Constanta",60419,136,60419,,"MUNICIPIUL CONSTANTA",171,"SCOALA NR.43 - STR. UNIRII NR.12",1172,699,685,14,0,694,5,1300,601,424,270,1,5864,0
14,"Constanta",60419,136,60419,,"MUNICIPIUL CONSTANTA",172,"SCOALA NR.4 - STR. NICOLAE IORGA NR.14",869,525,513,12,0,518,7,1000,475,317,201,1,5864,0
14,"Constanta",60419,136,60419,,"MUNICIPIUL CONSTANTA",173,"SCOALA NR.4 - STR. NICOLAE IORGA NR.14",742,466,457,8,1,463,3,800,334,225,238,1,5864,0
14,"Constanta",60419,136,60419,,"MUNICIPIUL CONSTANTA",174,"SCOALA NR.4 - STR. NICOLAE IORGA NR.14",683,452,443,8,1,449,3,800,348,208,241,1,5864,0
14,"Constanta",60419,136,60419,,"MUNICIPIUL CONSTANTA",175,"SCOALA NR.4 - STR. NICOLAE IORGA NR.14",701,428,420,8,0,419,9,800,372,250,169,1,5864,0
14,"Constanta",60419,136,60419,,"MUNICIPIUL CONSTANTA",176,"GRADINITA NR.8 - TOMIS II - ALEEA LUMINITEI",909,606,595,11,0,601,5,1000,394,301,300,1,5864,0
14,"Constanta",60419,136,60419,,"MUNICIPIUL CONSTANTA",177,"ATELIER SCOALA - STR. PETRU VULCAN NR.100",837,558,543,15,0,553,5,900,342,302,251,1,5864,0
14,"Constanta",60419,136,60419,,"MUNICIPIUL CONSTANTA",178,"GRUP SCOLAR 'TOMIS' - BD. TOMIS NR.153",736,459,443,16,0,454,5,800,341,261,193,1,5864,0
14,"Constanta",60419,136,60419,,"MUNICIPIUL CONSTANTA",179,"GRUP SCOLAR 'TOMIS' - BD. TOMIS NR.153",985,661,650,10,1,653,8,1100,439,353,300,1,5864,0
14,"Constanta",60419,136,60419,,"MUNICIPIUL CONSTANTA",180,"GRADINITA NR.6 - ALEEA MALINULUI NR.5",881,577,565,11,1,566,11,1000,423,294,272,1,5864,0
14,"Constanta",60419,136,60419,,"MUNICIPIUL CONSTANTA",181,"SCOALA NR.30 'GHEORGHE TITEICA' - STR. FLAMANDA NR.13",965,647,639,7,1,639,8,1100,453,374,265,1,5864,0
14,"Constanta",60419,136,60419,,"MUNICIPIUL CONSTANTA",182,"SCOALA NR.30 'GHEORGHE TITEICA' - STR. FLAMANDA NR.13",975,608,598,10,0,603,5,1100,492,337,266,1,5864,0
14,"Constanta",60419,136,60419,,"MUNICIPIUL CONSTANTA",183,"SCOALA NR.11 - STR. CALARASI NR.48",1396,915,902,12,1,904,11,1500,585,564,340,1,5864,0
14,"Constanta",60419,136,60419,,"MUNICIPIUL CONSTANTA",184,"SCOALA NR.11 - STR. CALARASI NR.48",1350,872,857,15,0,857,15,1500,628,506,351,1,5864,0
14,"Constanta",60419,136,60419,,"MUNICIPIUL CONSTANTA",185,"GRUP SCOLAR DE TELECOMUNICATII - BD.AL.LAPUSNEANU NR.15",1464,926,913,11,2,915,11,1600,674,507,408,1,5864,0
14,"Constanta",60419,136,60419,,"MUNICIPIUL CONSTANTA",186,"GRUP SCOLAR DE TELECOMUNICATII- BD.AL.LAPUSNEANU NR.15",1721,1015,999,16,0,1008,7,1900,885,575,433,1,5864,0
14,"Constanta",60419,136,60419,,"MUNICIPIUL CONSTANTA",187,"UNIVERSITATEA  'ANDREI SAGUNA'- BD.AL.LAPUSNEANU NR.13",1298,806,797,7,2,797,9,1400,594,436,361,1,5864,0
14,"Constanta",60419,136,60419,,"MUNICIPIUL CONSTANTA",188,"LICEUL DE ARTA (SCOALA NR.42) - BD. AL.LAPUSNEANU NR.11",1105,748,739,9,0,736,12,1200,452,448,288,1,5864,0
14,"Constanta",60419,136,60419,,"MUNICIPIUL CONSTANTA",189,"LICEUL DE ARTA (SCOALA NR.42) - BD. AL.LAPUSNEANU NR.11",1223,748,738,10,0,743,5,1300,552,402,341,1,5864,0
14,"Constanta",60419,136,60419,,"MUNICIPIUL CONSTANTA",190,"LICEUL DE ARTA (SCOALA NR.42) - BD. AL.LAPUSNEANU NR.11",669,422,412,10,0,419,3,700,278,216,203,1,5864,0
14,"Constanta",60419,136,60419,,"MUNICIPIUL CONSTANTA",191,"CAMINUL DE PENSIONARI ,STR UNIRII NR 67",1570,880,867,13,0,872,8,1700,820,464,408,1,5864,0
14,"Constanta",60419,136,60419,,"MUNICIPIUL CONSTANTA",192,"GARA CONSTANTA,CORP CENTRAL,ETAJ1",0,1945,0,1945,0,1930,15,4200,2255,1207,723,1,5864,1
14,"Constanta",60419,136,60419,,"MUNICIPIUL CONSTANTA",193,"AUTOGARA NORD CONSTANTA,PARTER,STR SOVEJA,NR 35",0,1500,0,1500,0,1490,10,4200,2700,919,571,1,5864,1
14,"Constanta",60419,136,60419,,"MUNICIPIUL CONSTANTA",194,"UNIVERSITATEA OVIDIUS CAMIN STUDENTESC NR 2,ET1,BD MAMAIA,NR 284",0,1400,0,1400,0,1382,18,4100,2700,789,593,1,5864,1
14,"Constanta",60482,136,60482,,"MUNICIPIUL MANGALIA",195,"CASA MUNICIPALA DE CULTURA - MANGALIA SOS. CONSTANTEI",753,486,460,26,0,481,5,801,315,279,202,1,5868,0
14,"Constanta",60482,136,60482,,"MUNICIPIUL MANGALIA",196,"POLICLINICA MANGALIA",1191,795,781,14,0,790,5,1299,504,421,369,1,5868,0
14,"Constanta",60482,136,60482,,"MUNICIPIUL MANGALIA",197,"GRADINITA NR.1 MANGALIA - STR. DELFINULUI",1033,644,634,10,0,633,11,1100,456,381,252,1,5868,0
14,"Constanta",60482,136,60482,,"MUNICIPIUL MANGALIA",198,"GRUP SCOLAR 'ION BANESCU' MANGALIA - STR. NEGRU VODA",661,398,365,33,0,392,6,700,302,318,74,1,5868,0
14,"Constanta",60482,136,60482,,"MUNICIPIUL MANGALIA",199,"BAZA SPORTIVA  'PESCARUS' - MANGALIA",1718,961,947,13,1,953,8,1900,939,574,379,1,5868,0
14,"Constanta",60482,136,60482,,"MUNICIPIUL MANGALIA",200,"GRUP SCOLAR 'ION BANESCU' MANGALIA - STR. NEGRU VODA",2081,1167,1138,29,0,1154,13,2300,1133,797,357,1,5868,0
14,"Constanta",60482,136,60482,,"MUNICIPIUL MANGALIA",201,"SCOALA GENERALA NR.3 MANGALIA",1283,780,754,24,2,772,8,1402,622,482,290,1,5868,0
14,"Constanta",60482,136,60482,,"MUNICIPIUL MANGALIA",202,"SCOALA GENERALA NR.3 MANGALIA",2322,1382,1363,19,0,1368,14,2600,1218,901,467,1,5868,0
14,"Constanta",60482,136,60482,,"MUNICIPIUL MANGALIA",203,"GRADINITA NR.3 MANGALIA",1706,953,937,16,0,939,14,1898,945,575,364,1,5868,0
14,"Constanta",60482,136,60482,,"MUNICIPIUL MANGALIA",204,"SCOALA GENERALA NR.2 - STR. T. S. SAVEANU MANGALIA",2151,1180,1161,19,0,1173,7,2400,1220,768,405,1,5868,0
14,"Constanta",60482,136,60482,,"MUNICIPIUL MANGALIA",205,"GRUP SCOLAR 'ECONOMIC' MANGALIA",881,499,485,14,0,490,9,1000,501,331,159,1,5868,0
14,"Constanta",60482,136,60482,,"MUNICIPIUL MANGALIA",206,"SEDIU SC 'ECO GOLD 'SA",1862,1155,1135,20,0,1149,6,2002,847,773,376,1,5868,0
14,"Constanta",60482,136,60482,,"MUNICIPIUL MANGALIA",207,"SCOALA GENERALA NR.1 MANGALIA (LOCAL NOU) - STR. MATEI BASARAB",2274,1393,1379,14,0,1379,14,2500,1107,937,442,1,5868,0
14,"Constanta",60482,136,60482,,"MUNICIPIUL MANGALIA",208,"SCOALA GENERALA NR.1 MANGALIA (LOCAL GRADINITA) - STR. MATEI B",1583,955,937,18,0,944,11,1702,747,643,301,1,5868,0
14,"Constanta",60482,136,60482,,"MUNICIPIUL MANGALIA",209,"BLOC A 01( STR M.I DOBROGEANU) MANGALIA",662,496,415,81,0,485,11,701,205,353,132,1,5868,0
14,"Constanta",60482,136,60482,,"MUNICIPIUL MANGALIA",210,"ASIROM MANGALIA",1650,1039,1023,15,1,1029,10,1800,761,599,430,1,5868,0
14,"Constanta",60482,136,60482,,"MUNICIPIUL MANGALIA",211,"SCOALA GENERALA NR 5 MANGALIA",1261,680,670,10,0,674,6,1400,720,451,223,1,5868,0
14,"Constanta",60482,136,60482,,"MUNICIPIUL MANGALIA",212,"SCOALA GENERALA NR 5 MANGALIA",1324,926,840,86,0,917,9,1504,578,605,312,1,5868,0
14,"Constanta",60482,136,60482,,"MUNICIPIUL MANGALIA",213,"BIBLIOTECA FRANCEZA",1635,980,959,20,1,967,13,1799,819,561,406,1,5868,0
14,"Constanta",60482,136,60482,,"MUNICIPIUL MANGALIA",214,"HOTEL MANGALIA - SANATORIUL BALNEAR -STR. MATEI BASARAB",1449,897,886,11,0,890,7,1600,703,539,351,1,5868,0
14,"Constanta",60482,136,60482,,"MUNICIPIUL MANGALIA",215,"CLUB SPITAL MANGALIA",1045,669,653,16,0,664,5,1100,431,425,239,1,5868,0
14,"Constanta",60482,136,60482,,"MUNICIPIUL MANGALIA",216,"GRADINITA 'CALLATIS' MANGALIA",1786,1009,999,10,0,993,16,2000,991,637,356,1,5868,0
14,"Constanta",60482,136,60482,,"MUNICIPIUL MANGALIA",217,"LICEUL 'CALLATIS' MANGALIA",1993,1193,1177,16,0,1180,13,2200,1007,750,430,1,5868,0
14,"Constanta",60482,136,60482,,"MUNICIPIUL MANGALIA",218,"BLOCUL C9 NEPTUN",1060,550,542,8,0,544,6,1200,650,360,184,1,5868,0
14,"Constanta",60482,136,60482,,"MUNICIPIUL MANGALIA",219,"BLOCUL C 3 OLIMP",451,225,216,9,0,225,0,500,275,139,86,1,5868,0
14,"Constanta",60482,136,60482,,"MUNICIPIUL MANGALIA",220,"INCINTA FRUVILEG",455,339,258,81,0,335,4,500,161,175,160,1,5868,0
14,"Constanta",60482,136,60482,,"MUNICIPIUL MANGALIA",221,"GARA MANGALIA,SOS CONSTANTEI NR 51",0,1126,0,1126,0,1119,7,1599,473,695,424,1,5868,1
14,"Constanta",60847,136,60847,,"MUNICIPIUL MEDGIDIA",222,"CASA DE CULTURA 'I.N.ROMAN'  MEDGIDIA - STR. REPUBLICII",953,592,565,27,0,584,8,1000,408,218,366,1,5876,0
14,"Constanta",60847,136,60847,,"MUNICIPIUL MEDGIDIA",223,"GRADINITA NR.1 MEDGIDIA - STR. MARGARITARULUI",775,445,429,16,0,442,3,900,455,175,267,1,5876,0
14,"Constanta",60847,136,60847,,"MUNICIPIUL MEDGIDIA",224,"GRADINITA NR.1 MEDGIDIA - STR. MARGARITARULUI",1041,573,559,14,0,562,11,1100,527,232,330,1,5876,0
14,"Constanta",60847,136,60847,,"MUNICIPIUL MEDGIDIA",225,"SCOALA GEN.NR.4 MEDGIDIA - INTRARE STR. SIRETULUI",1016,525,516,9,0,516,9,1100,575,230,286,1,5876,0
14,"Constanta",60847,136,60847,,"MUNICIPIUL MEDGIDIA",226,"SCOALA GEN.NR.4 MEDGIDIA - INTRARE STR. JIULUI",1511,779,761,18,0,752,27,1700,921,363,389,1,5876,0
14,"Constanta",60847,136,60847,,"MUNICIPIUL MEDGIDIA",227,"SCOALA GEN.NR.4 MEDGIDIA -  SALA DE SPORT - STR. JIULUI",1114,575,553,22,0,544,31,1200,625,253,291,1,5876,0
14,"Constanta",60847,136,60847,,"MUNICIPIUL MEDGIDIA",228,"GRADINITA NR 8 MEDGIDIA - STR. POPORULUI",1298,657,644,13,0,643,14,1400,743,305,338,1,5876,0
14,"Constanta",60847,136,60847,,"MUNICIPIUL MEDGIDIA",229,"LICEUL NR.2 MEDGIDIA - STR. POPORULUI",1075,562,544,17,1,555,7,1201,639,263,292,1,5876,0
14,"Constanta",60847,136,60847,,"MUNICIPIUL MEDGIDIA",230,"SCOALA 'CONSTANTIN BRINCUSI'  MEDGIDIA - STR. KEMAL AGI AMET",1142,646,634,12,0,640,6,1300,654,259,381,1,5876,0
14,"Constanta",60847,136,60847,,"MUNICIPIUL MEDGIDIA",231,"LICEUL 'NICOLAE BALCESCU' MEDGIDIA- INTRARE STR. SCARLAT VARNAV",926,530,517,13,0,523,7,1000,470,227,296,1,5876,0
14,"Constanta",60847,136,60847,,"MUNICIPIUL MEDGIDIA",232,"SCOALA GEN.NR.7 MEDGIDIA - INTRARE STR. ION CREANGA",1031,532,519,13,0,529,3,1100,568,191,338,1,5876,0
14,"Constanta",60847,136,60847,,"MUNICIPIUL MEDGIDIA",233,"SCOALA GEN.NR.7 - MEDGIDIA - INTRARE STR. WALTER MARACINEANU",848,464,449,15,0,459,5,900,436,164,295,1,5876,0
14,"Constanta",60847,136,60847,,"MUNICIPIUL MEDGIDIA",234,"LICEUL 'NICOLAE BALCESCU' MEDGIDIA- INTRARE STR. ION CREANGA",855,476,467,9,0,469,7,900,424,192,277,1,5876,0
14,"Constanta",60847,136,60847,,"MUNICIPIUL MEDGIDIA",235,"GRADINITA 'TUNA' MEDGIDIA(FOSTA CAP) - STR. REPUBLICII",1242,750,737,13,0,740,10,1400,650,338,402,1,5876,0
14,"Constanta",60847,136,60847,,"MUNICIPIUL MEDGIDIA",236,"GRADINITA NR.2 MEDGIDIA (IN FATA BLOCULUI SC4)",1063,653,642,11,0,648,5,1200,547,244,404,1,5876,0
14,"Constanta",60847,136,60847,,"MUNICIPIUL MEDGIDIA",237,"GRADINITA NR.11 MEDGIDIA (IN FATA BLOCULUI SC3)",854,568,552,15,1,563,5,900,332,226,337,1,5876,0
14,"Constanta",60847,136,60847,,"MUNICIPIUL MEDGIDIA",238,"LICEUL 'KEMAL ATATURK'  MEDGIDIA",1050,619,605,14,0,613,6,1200,581,310,303,1,5876,0
14,"Constanta",60847,136,60847,,"MUNICIPIUL MEDGIDIA",239,"HOTEL 'STADION' ETAJ III MEDGIDIA",966,549,537,12,0,544,5,1100,551,222,322,1,5876,0
14,"Constanta",60847,136,60847,,"MUNICIPIUL MEDGIDIA",240,"HOTEL 'STADION' RECEPTIE  MEDGIDIA",997,541,537,4,0,538,3,1100,559,223,315,1,5876,0
14,"Constanta",60847,136,60847,,"MUNICIPIUL MEDGIDIA",241,"HOTEL 'STADION'  SALON OFICIAL MEDGIDIA",1179,618,608,10,0,613,4,1300,682,226,387,1,5876,0
14,"Constanta",60847,136,60847,,"MUNICIPIUL MEDGIDIA",242,"SCOALA NR.5  MEDGIDIA - STR. LUPENI",996,518,508,9,1,512,6,1100,582,172,340,1,5876,0
14,"Constanta",60847,136,60847,,"MUNICIPIUL MEDGIDIA",243,"SCOALA NR.5  MEDGIDIA - STR. LUPENI",872,484,468,16,0,478,6,1001,517,209,269,1,5876,0
14,"Constanta",60847,136,60847,,"MUNICIPIUL MEDGIDIA",244,"SCOALA 'LUCIAN GRIGORESCU'  MEDGIDIA - FOSTA NR. 6 - CLADIRE NOUA",1186,667,651,15,1,663,4,1300,633,292,371,1,5876,0
14,"Constanta",60847,136,60847,,"MUNICIPIUL MEDGIDIA",245,"SCOALA 'LUCIAN GRIGORESCU'  MEDGIDIA - FOSTA NR. 6 - CLADIRE NOUA,AL TRANDAFIRILOR",735,454,441,13,0,452,2,800,346,171,281,1,5876,0
14,"Constanta",60847,136,60847,,"MUNICIPIUL MEDGIDIA",246,"SCOALA CONSTANTIN BRANCUSI FOASTA NR1,STR KEMAL AGI AMET",1111,641,627,13,1,636,5,1200,559,237,399,1,5876,0
14,"Constanta",60847,136,60847,,"MUNICIPIUL MEDGIDIA",247,"CLUBUL PENSIONARILOR-STR VASILE LUPU",733,415,407,8,0,410,5,800,385,166,244,1,5876,0
14,"Constanta",60847,136,60847,,"MUNICIPIUL MEDGIDIA",248,"SCOALA NR.2  MEDGIDIA - STR. DEZROBIRII",1129,636,628,8,0,632,4,1201,565,252,380,1,5876,0
14,"Constanta",60847,136,60847,,"MUNICIPIUL MEDGIDIA",249,"SCOALA NR.2  MEDGIDIA - STR. DEZROBIRII",1142,568,560,8,0,565,3,1301,733,266,299,1,5876,0
14,"Constanta",60847,136,60847,,"MUNICIPIUL MEDGIDIA",250,"SCOALA NR.2  MEDGIDIA - STR. DEZROBIRII",992,551,536,15,0,549,2,1100,549,214,335,1,5876,0
14,"Constanta",60847,136,60847,,"MUNICIPIUL MEDGIDIA",251,"LICEUL NR.1  MEDGIDIA - STR. DEZROBIRII",1109,560,551,9,0,552,8,1200,640,238,314,1,5876,0
14,"Constanta",60847,136,60847,,"MUNICIPIUL MEDGIDIA",252,"LICEUL NR.1  MEDGIDIA - STR. DEZROBIRII",1402,809,803,6,0,803,6,1500,691,344,459,1,5876,0
14,"Constanta",60847,136,60847,,"MUNICIPIUL MEDGIDIA",253,"SCOALA NR.3  MEDGIDIA - STR. THEODOR AMAN",881,503,494,9,0,481,22,1000,497,170,311,1,5876,0
14,"Constanta",60847,136,60847,,"MUNICIPIUL MEDGIDIA",254,"SCOALA NR.3  MEDGIDIA - STR. THEODOR AMAN",1558,869,848,21,0,851,18,1700,831,395,456,1,5876,0
14,"Constanta",60847,136,60847,,"MUNICIPIUL MEDGIDIA",255,"SCOALA NR.3  MEDGIDIA - STR. THEODOR AMAN",1344,741,727,14,0,736,5,1500,759,350,386,1,5876,0
14,"Constanta",60847,136,60847,,"MUNICIPIUL MEDGIDIA",256,"GRADINITA NR.7 MEDGIDIA- STR. ALEXANDRU CEL BUN",1518,862,851,11,0,855,7,1700,838,409,446,1,5876,0
14,"Constanta",60847,136,60847,,"MUNICIPIUL MEDGIDIA",257,"SCOALA - LOCALITATEA VALEA DACILOR",1165,628,618,10,0,622,6,1300,672,270,352,1,5876,0
14,"Constanta",60847,136,60847,,"MUNICIPIUL MEDGIDIA",258," SC MAXICOMP SRL,SAT REMUS OPREANU",295,179,173,6,0,177,2,300,121,101,76,1,5876,0
14,"Constanta",60847,136,60847,,"MUNICIPIUL MEDGIDIA",259,"SEDIU D.G.D.P.P.,STR REPUBLICII NR 4",0,465,0,465,0,457,8,1800,1335,241,216,1,5876,1
14,"Constanta",61069,136,61069,,"ORAS BANEASA",260,"SCOALA GENERALA NR 1  BANEASA",978,562,551,7,4,556,6,1100,538,321,235,1,5880,0
14,"Constanta",61069,136,61069,,"ORAS BANEASA",261,"LICEUL TEORETIC  BANEASA",1947,1173,1149,5,19,1159,14,2100,927,673,486,1,5880,0
14,"Constanta",61069,136,61069,,"ORAS BANEASA",262,"SCOALA GENERALA NEGURENI",576,376,353,6,17,371,5,600,224,235,136,1,5880,0
14,"Constanta",61069,136,61069,,"ORAS BANEASA",263,"SCOALA GENERALA FAUREI",872,500,489,11,0,486,14,900,400,210,276,1,5880,0
14,"Constanta",61069,136,61069,,"ORAS BANEASA",264,"CAMIN CULTURAL ORAS BANEASA,STR TRANDAFIRILOR,NR 97",0,116,0,116,0,116,0,200,84,74,42,1,5880,1
14,"Constanta",60776,136,60776,,"ORAS CERNAVODA",265,"SCOALA GEN. NR.1 CERNAVODA- STR. SALCIEI NR. 6",1850,883,874,9,0,879,4,2001,1118,600,279,1,5885,0
14,"Constanta",60776,136,60776,,"ORAS CERNAVODA",266,"SCOALA GEN. NR.1 CERNAVODA - STR. SALCIEI NR. 6",1507,745,732,13,0,737,8,1701,956,430,307,1,5885,0
14,"Constanta",60776,136,60776,,"ORAS CERNAVODA",267,"GRADINITA NR.1 CERNAVODA - STR. SALCIEI NR. 8",1470,815,804,10,1,809,6,1601,786,460,349,1,5885,0
14,"Constanta",60776,136,60776,,"ORAS CERNAVODA",268,"SCOALA GEN. NR.2 CERNAVODA -  STR. M.SADOVEANU NR. 9",1555,917,904,13,0,903,14,1700,783,487,416,1,5885,0
14,"Constanta",60776,136,60776,,"ORAS CERNAVODA",269,"SCOALA GEN. NR.3 CERNAVODA - STR. A.SALIGNY NR. 24",1722,1035,1025,9,1,1021,14,1900,865,563,458,1,5885,0
14,"Constanta",60776,136,60776,,"ORAS CERNAVODA",270,"SCOALA GEN. NR.3 CERNAVODA - STR. A.SALIGNY NR. 24",1700,1015,1004,11,0,999,16,1899,884,543,456,1,5885,0
14,"Constanta",60776,136,60776,,"ORAS CERNAVODA",271,"GRADINITA NR.4 CERNAVODA - STR. TUDOR VLADIMIRESCU NR. 12",1330,782,767,15,0,768,14,1500,718,456,312,1,5885,0
14,"Constanta",60776,136,60776,,"ORAS CERNAVODA",272,"CRESA - STR. TUDOR VLADIMIRESCU NR. 10 CERNAVODA",1002,542,526,16,0,532,10,1100,558,301,231,1,5885,0
14,"Constanta",60776,136,60776,,"ORAS CERNAVODA",273,"GRUP SCOLAR IND.ENERGETIC CERNAVODA - STR. CAZARMII NR. 6",1559,826,816,10,0,819,7,1700,874,477,342,1,5885,0
14,"Constanta",60776,136,60776,,"ORAS CERNAVODA",274,"GRUP SCOLAR IND.ENERGETIC CERNAVODA- STR. CAZARMII NR. 6",1256,659,651,8,0,651,8,1401,742,360,291,1,5885,0
14,"Constanta",60776,136,60776,,"ORAS CERNAVODA",275,"SCOALA GEN NR.4 CERNAVODA",1166,601,588,13,0,591,10,1300,699,322,269,1,5885,0
14,"Constanta",60776,136,60776,,"ORAS CERNAVODA",276,"SCOALA NR3,SALA CLS I CERNAVODA,STR ING A.SALIGNY,NR 24-26",0,587,0,587,0,578,9,700,113,306,272,1,5885,1
14,"Constanta",60455,136,60455,,"ORAS EFORIE",277,"LICEUL ""CARMEN SILVA"" EFORIE SUD",1547,1003,984,17,2,992,11,1700,697,587,405,1,5887,0
14,"Constanta",60455,136,60455,,"ORAS EFORIE",278,"SEDIUL POLITIEI  COMUNITARE EFORIE SUD,STR MARASTI NR 11",1532,1003,986,13,4,994,9,1500,497,521,473,1,5887,0
14,"Constanta",60455,136,60455,,"ORAS EFORIE",279,"GRADINITA DE COPII EFORIE SUD - STR. V.ALECSANDRI NR.2",1097,694,670,21,3,685,9,1100,406,368,317,1,5887,0
14,"Constanta",60455,136,60455,,"ORAS EFORIE",280,"HOTEL ""TRAIAN"" - STR.TRAIAN ,EFORIE NORD",1536,958,941,14,3,950,8,1700,742,594,356,1,5887,0
14,"Constanta",60455,136,60455,,"ORAS EFORIE",281,"SALA DE SPORT EFORIE NORD-STR M.KOGAANICEANU",1361,910,892,17,1,904,6,1499,589,567,337,1,5887,0
14,"Constanta",60455,136,60455,,"ORAS EFORIE",282,"SCOALA GENERALA EFORIE NORD - STR M.KOGALNICEANU NR.25",1942,1310,1280,28,2,1300,10,2100,790,840,460,1,5887,0
14,"Constanta",60455,136,60455,,"ORAS EFORIE",283,"CENTRU DE RELATII CU PUBLICUL EFORIE SUD,STR AVRAM IANCU",0,691,0,691,0,679,12,701,10,357,322,1,5887,1
14,"Constanta",60801,136,60801,,"ORAS HARSOVA",284,"CASA DE CULTURA HARSOVA - STR. PIATA 1 DECEMBRIE NR. 2",904,480,472,8,0,476,4,1000,520,213,263,1,5890,0
14,"Constanta",60801,136,60801,,"ORAS HARSOVA",285,"LICEUL TEORETIC HARSOVA - SOS. CONSTANTEI NR. 24",1463,728,717,11,0,723,5,1600,872,331,392,1,5890,0
14,"Constanta",60801,136,60801,,"ORAS HARSOVA",286,"GRADINITA CU ORAR NORMAL HARSOVA - STR. SOARELUI NR. 2",1296,679,668,9,2,672,7,1401,722,330,342,1,5890,0
14,"Constanta",60801,136,60801,,"ORAS HARSOVA",287,"SCOALA PORT HARSOVA",1684,759,749,10,0,749,10,1900,1141,437,312,1,5890,0
14,"Constanta",60801,136,60801,,"ORAS HARSOVA",288,"SCOALA GENERALA NR.1 HARSOVA - STR. REVOLUTIEI NR. 5",1886,899,888,11,0,885,14,2100,1201,491,394,1,5890,0
14,"Constanta",60801,136,60801,,"ORAS HARSOVA",289,"SEDIU OCOLUL SILVIC HARSOVA - STR. VADULUI NR. 87",1354,718,707,9,2,707,11,1500,782,324,383,1,5890,0
14,"Constanta",60801,136,60801,,"ORAS HARSOVA",290,"SCOALA PRIMARA VADU OII",330,187,178,9,0,186,1,400,213,114,72,1,5890,0
14,"Constanta",60801,136,60801,,"ORAS HARSOVA",291,"PRIMARIA ORASULUI HARSOVA,SOS CONSTANTEI,NR17",0,128,0,128,0,128,0,400,272,63,65,1,5890,1
14,"Constanta",62360,136,62360,,"ORAS MURFATLAR",292,"LICEUL TEORETIC MURFATLAR   - STR. MIHAI EMINESCU NR.50",1530,846,839,7,0,840,6,1700,854,468,372,1,5893,0
14,"Constanta",62360,136,62360,,"ORAS MURFATLAR",293,"LICEUL TEORETIC MURFATLAR   - STR. MIHAI EMINESCU NR.50",1341,802,797,5,0,794,8,1500,698,472,322,1,5893,0
14,"Constanta",62360,136,62360,,"ORAS MURFATLAR",294,"SALA DE SPORT MURFATLAR STR G-RAL VASILE MILEA",1219,703,695,8,0,699,4,1300,597,405,294,1,5893,0
14,"Constanta",62360,136,62360,,"ORAS MURFATLAR",295,"SCOALA GENERALA NR.2 MURFATLAR   - STR.ION CREANGA NR.25",1731,1096,1084,11,1,1081,15,1900,804,732,349,1,5893,0
14,"Constanta",62360,136,62360,,"ORAS MURFATLAR",296,"CLUB TINERET I.A.S. MURFATLAR- AL. MARGARITARELOR NR. 9",1629,976,968,7,1,966,10,1600,624,611,355,1,5893,0
14,"Constanta",62360,136,62360,,"ORAS MURFATLAR",297,"CANTINA SCUG SA MURFATLAR - STR. CIOCIRLIEI NR. 1",865,537,529,8,0,529,8,1000,463,335,194,1,5893,0
14,"Constanta",62360,136,62360,,"ORAS MURFATLAR",298,"CAMINUL CULTURAL SIMINOC-STR MURFATLAR NR 20",854,629,615,6,8,623,6,900,271,365,258,1,5893,0
14,"Constanta",62360,136,62360,,"ORAS MURFATLAR",299,"CLUB TINERET MURFATLAR.AL MARGARITARELOR NR 9",0,521,0,521,0,514,7,599,78,337,177,1,5893,1
14,"Constanta",60507,136,60507,,"ORAS NAVODARI",300,"SCOALA NR 3 NAVODARI -  STR. CABANEI NR. 2",1720,878,865,13,0,868,10,1900,1022,461,407,1,5896,0
14,"Constanta",60507,136,60507,,"ORAS NAVODARI",301,"LICEUL 'LAZAR EDELEANU' NAVODARI-STR. SANATATII NR. 4",1451,825,814,10,1,813,12,1600,775,463,350,1,5896,0
14,"Constanta",60507,136,60507,,"ORAS NAVODARI",302,"LICEUL 'LAZAR EDELEANU' NAVODARI-STR. SANATATII NR. 4",974,517,507,10,0,508,9,1099,582,290,218,1,5896,0
14,"Constanta",60507,136,60507,,"ORAS NAVODARI",303,"SCOALA GENERALA NR 1 NAVODARI -STR. CULTURII NR. 33",1570,848,833,15,0,836,12,1700,852,475,361,1,5896,0
14,"Constanta",60507,136,60507,,"ORAS NAVODARI",304,"CRESA NR.20-STR. CABANEI,NR 5",1696,776,750,25,1,766,10,1900,1124,418,348,1,5896,0
14,"Constanta",60507,136,60507,,"ORAS NAVODARI",305,"LICEUL 'LAZAR EDELEANU' NAVODARI-STR. SANATATII NR. 4",1796,870,855,15,0,860,10,2000,1130,505,355,1,5896,0
14,"Constanta",60507,136,60507,,"ORAS NAVODARI",306,"SCOALA GENERALA NR 1 NAVODARI -STR. CULTURII NR. 33",2193,1191,1176,15,0,1178,13,2400,1209,670,508,1,5896,0
14,"Constanta",60507,136,60507,,"ORAS NAVODARI",307,"SCOALA GENERALA NR 2 NAVODARI -STR. PLOPILOR NR. 38",1735,990,963,27,0,975,15,1900,910,528,447,1,5896,0
14,"Constanta",60507,136,60507,,"ORAS NAVODARI",308,"GRADINITA ALBATROS NR 4,STR PLOPILOR NR 38",1454,843,829,14,0,833,10,1600,757,428,405,1,5896,0
14,"Constanta",60507,136,60507,,"ORAS NAVODARI",309,"CLUBUL PETROMIDIA NAVODARI -STR. TINERETULUI NR. 3",1492,860,846,13,1,851,9,1600,740,500,351,1,5896,0
14,"Constanta",60507,136,60507,,"ORAS NAVODARI",310,"LICEUL 'LAZAR EDELEANU' NAVODARI-STR. SANATATII NR. 4",1603,882,859,23,0,871,11,1800,918,482,389,1,5896,0
14,"Constanta",60507,136,60507,,"ORAS NAVODARI",311,"SCOALA NR.3 NAVODARI - STR.CABANEI NR.5",943,540,521,18,1,531,9,1000,460,294,237,1,5896,0
14,"Constanta",60507,136,60507,,"ORAS NAVODARI",312,"CASA CASATORIILOR NAVODARI-STR. CONSTANTEI BL. B2",1644,870,854,16,0,861,9,1800,930,472,389,1,5896,0
14,"Constanta",60507,136,60507,,"ORAS NAVODARI",313,"SCOALA GENERALA NR 2 NAVODARI -STR. PLOPILOR NR. 38",938,464,449,14,1,461,3,999,535,264,197,1,5896,0
14,"Constanta",60507,136,60507,,"ORAS NAVODARI",314,"SCOALA GENERALA NR 2 NAVODARI -STR. PLOPILOR NR. 38",1050,535,520,13,2,530,5,1200,665,253,277,1,5896,0
14,"Constanta",60507,136,60507,,"ORAS NAVODARI",315,"CENTRUL CULTURAL  NAVODARI-STR. CONSTANTEI",1576,926,916,10,0,918,8,1700,774,552,366,1,5896,0
14,"Constanta",60507,136,60507,,"ORAS NAVODARI",316,"CENTRUL CULTURAL  NAVODARI-STR. CONSTANTEI",1903,1047,1030,17,0,1037,10,2100,1053,601,436,1,5896,0
14,"Constanta",60507,136,60507,,"ORAS NAVODARI",317,"CLUBUL PENSIONARILOR NAVODARI,STR ALBINELOR",1185,813,798,15,0,805,8,1300,487,425,380,1,5896,0
14,"Constanta",60507,136,60507,,"ORAS NAVODARI",318,"CASA DE CULTURA NAVODARI STR SANATATII",860,436,417,18,1,432,4,900,464,221,211,1,5896,0
14,"Constanta",60507,136,60507,,"ORAS NAVODARI",319,"COLOANA AUTO ECOTERM NAVODARI,STR CONSTANTEI",1095,747,716,31,0,740,7,1206,459,374,366,1,5896,0
14,"Constanta",60507,136,60507,,"ORAS NAVODARI",320,"SCOALA PENINSULA NAVODARI GRUP SOCIAL PENINSULA",386,251,239,12,0,242,9,400,149,64,178,1,5896,0
14,"Constanta",60507,136,60507,,"ORAS NAVODARI",321,"DISPENSAR TASAUL NAVODARI,STR NUFERILOR",1145,614,593,20,1,609,5,1300,686,296,313,1,5896,0
14,"Constanta",60507,136,60507,,"ORAS NAVODARI",322,"DISPENSAR NAVODARI,STR RANDUNELELOR",1398,892,877,15,0,883,9,1500,608,463,420,1,5896,0
14,"Constanta",60507,136,60507,,"ORAS NAVODARI",323,"CLUBUL PENSIONARILOR NAVODARI,STR CONSTANTEI",421,207,194,13,0,205,2,500,293,114,91,1,5896,0
14,"Constanta",60507,136,60507,,"ORAS NAVODARI",324,"UNITATEA MILITARA MAMAIA SAT NAVODARI",454,320,305,15,0,315,5,500,180,169,146,1,5896,0
14,"Constanta",60507,136,60507,,"ORAS NAVODARI",325,"SALA DE SEDINTE A SC TSP ECOTERM SA,STR TINERETULUI NR3",0,949,0,949,0,938,11,1500,551,518,420,1,5896,1
14,"Constanta",62397,136,62397,,"ORAS NEGRU VODA",326,"CLUB ORASENEASC NEGRU VODA -STR RECOLTEI NR 29A",2263,1192,1178,13,1,1164,28,2500,1308,544,620,1,5899,0
14,"Constanta",62397,136,62397,,"ORAS NEGRU VODA",327,"SCOALA GENERALA CLASA NR 1 NEGRU VODA -STR SILOZULUI NR 9",1384,770,754,13,3,763,7,1500,730,315,448,1,5899,0
14,"Constanta",62397,136,62397,,"ORAS NEGRU VODA",328,"CAMIN CULTURAL DARABANI",609,278,266,12,0,273,5,700,422,104,169,1,5899,0
14,"Constanta",62397,136,62397,,"ORAS NEGRU VODA",329,"SCOALA GENERALA VALCELE",216,130,120,10,0,129,1,200,70,61,68,1,5899,0
14,"Constanta",62397,136,62397,,"ORAS NEGRU VODA",330,"GRADINITA CU ORAR NORMAL-SECTIA DARABANI-",94,97,68,29,0,97,0,100,3,61,36,1,5899,0
14,"Constanta",62397,136,62397,,"ORAS NEGRU VODA",331,"SCOALA GENERALA CLASA 2NEGRU VODA,STR SILOZULUI NR 9",0,124,0,124,0,120,4,200,76,58,62,1,5899,1
14,"Constanta",60687,136,60687,,"ORAS OVIDIU",332,"LICEUL TEORETIC OVIDIU (ARIPA VECHE) OVIDIU",2181,1197,1182,15,0,1180,17,2400,1203,652,528,1,5904,0
14,"Constanta",60687,136,60687,,"ORAS OVIDIU",333,"SCOALA GENERALA NR.1 - OVIDIU  -ARIPA NOUA",2129,1090,1063,27,0,1076,14,2300,1210,680,396,1,5904,0
14,"Constanta",60687,136,60687,,"ORAS OVIDIU",334,"SCOALA GENERALA NR.2 OVIDIU --ARIPA NOUA",2569,1469,1428,41,0,1459,10,2801,1332,926,533,1,5904,0
14,"Constanta",60687,136,60687,,"ORAS OVIDIU",335,"CENTRUL CULTURAL OVIDIU",2190,1350,1271,79,0,1339,11,2400,1050,865,474,1,5904,0
14,"Constanta",60687,136,60687,,"ORAS OVIDIU",336,"SCOALA GENERALA NR.2 OVIDIU --ARIPA VECHE",1474,821,813,8,0,814,7,1600,779,540,274,1,5904,0
14,"Constanta",60687,136,60687,,"ORAS OVIDIU",337,"SCOALA GENERALA -SAT POIANA",707,433,424,9,0,429,4,800,367,272,157,1,5904,0
14,"Constanta",60687,136,60687,,"ORAS OVIDIU",338,"SC.GENERALA NAZARCEA",914,510,476,34,0,496,14,1000,490,230,266,1,5904,0
14,"Constanta",60687,136,60687,,"ORAS OVIDIU",339,"CENTRUL CULTURAL OVIDIU ETAJ1 ,STR NATIONALA NR 68",0,316,0,316,0,313,3,500,184,180,133,1,5904,1
14,"Constanta",60534,136,60534,,"ORAS TECHIRGHIOL",340,"SALA DE SPORT - STR.9 MAI NR 50",1941,1146,1128,17,1,1134,12,2099,953,654,480,1,5907,0
14,"Constanta",60534,136,60534,,"ORAS TECHIRGHIOL",341,"SALA DE SPORT-INTRARE DIN STR VICTORIEI NR 15",1656,1048,1032,16,0,1029,19,1803,755,638,391,1,5907,0
14,"Constanta",60534,136,60534,,"ORAS TECHIRGHIOL",342,"GRADINITA NR 2 TECHIRGHIOL-STR.N.BALCESCU NR.65",1524,900,879,21,0,894,6,1700,800,561,333,1,5907,0
14,"Constanta",60534,136,60534,,"ORAS TECHIRGHIOL",343,"LICEUL EMIL RACOVITA TECHIRGHIOL STR.NICOLAE BALCESCU NR.14",1286,778,766,12,0,775,3,1400,622,498,277,1,5907,0
14,"Constanta",60534,136,60534,,"ORAS TECHIRGHIOL",344,"CASA DE CULTURA HOL CINEMA,STR N.BALCESCU,NR 27A",0,505,0,505,0,502,3,700,195,277,225,1,5907,1
14,"Constanta",60598,136,60598,,"23 AUGUST",345,"SCOALA 23 AUGUST SALA 1 PARTER",2563,1406,1397,8,1,1399,7,2700,1294,959,440,3,5909,0
14,"Constanta",60598,136,60598,,"23 AUGUST",346,"SCOALA NOUA  DULCESTI",1024,644,630,14,0,638,6,1100,456,500,138,3,5909,0
14,"Constanta",60598,136,60598,,"23 AUGUST",347,"GRADINITA  MOSNENI",950,558,546,12,0,550,8,1000,442,362,188,3,5909,0
14,"Constanta",60598,136,60598,,"23 AUGUST",348,"SCOALA 23 AUGUST SALA2 PARTER DN 39F.N",0,207,0,207,0,205,2,300,93,130,75,3,5909,1
14,"Constanta",60883,136,60883,,"ADAMCLISI",349,"SCOALA DE ARTE SI MESERII  JEAN DINU -ADAMCLISI",993,618,588,11,19,611,7,1000,382,261,350,3,5913,0
14,"Constanta",60883,136,60883,,"ADAMCLISI",350,"SCOALA GENERALA ZORILE STR NAZALARU NR 2",503,360,338,11,11,351,9,600,240,71,280,3,5913,0
14,"Constanta",60883,136,60883,,"ADAMCLISI",351,"SCOALA GENERALA URLUIA STR LIBERTATII NR 8",275,195,174,13,8,192,3,300,105,52,140,3,5913,0
14,"Constanta",60883,136,60883,,"ADAMCLISI",352,"SCOALA GENERALA  ABRUD STR ADAMACLISI NR 4",114,77,60,11,6,76,1,100,23,25,51,3,5913,0
14,"Constanta",60883,136,60883,,"ADAMCLISI",353,"CAMINUL CULTURAL ADAMCLISI STR TRAIAN,NR 36",0,105,0,105,0,105,0,201,96,27,78,3,5913,1
14,"Constanta",60570,136,60570,,"AGIGEA",354,"SCOALA 'ION BORCEA' AGIGEA SALA CLS III-A - SOS.MANGALIEI",2128,1390,1365,25,0,1375,15,2299,909,880,495,3,5919,0
14,"Constanta",60570,136,60570,,"AGIGEA",355,"GRADINITA AGIGEA",2048,1392,1363,29,0,1380,12,2300,908,869,511,3,5919,0
14,"Constanta",60570,136,60570,,"AGIGEA",356,"SPITALUL FTIZIOLOGIC . AGIGEA",371,261,225,36,0,259,2,400,139,123,136,3,5919,0
14,"Constanta",60570,136,60570,,"AGIGEA",357,"SCOALA LAZU",1093,740,724,16,0,736,4,1200,460,458,278,3,5919,0
14,"Constanta",60570,136,60570,,"AGIGEA",358,"SCOALA ION BORCEA PARTER,CLS III,SOS MANGALIEI",0,276,0,276,0,274,2,299,23,168,106,3,5919,1
14,"Constanta",60945,136,60945,,"ALBESTI",359,"SCOALA GENERALA SALA CLASA I ALBESTI,SOS MANGALIEI,NR 33",1265,776,767,6,3,769,7,1400,624,557,212,3,5924,0
14,"Constanta",60945,136,60945,,"ALBESTI",360,"SCOALA GENERALA ARSA",407,260,249,11,0,253,7,400,140,154,99,3,5924,0
14,"Constanta",60945,136,60945,,"ALBESTI",361,"SCOALA GENERALA COROANA",125,77,68,9,0,74,3,100,23,39,35,3,5924,0
14,"Constanta",60945,136,60945,,"ALBESTI",362,"SCOALA GENERALA COTU VAII",876,517,510,7,0,510,7,1000,483,346,164,3,5924,0
14,"Constanta",60945,136,60945,,"ALBESTI",363,"SCOALA GENERALA VARTOP",179,139,131,8,0,137,2,200,61,93,44,3,5924,0
14,"Constanta",60945,136,60945,,"ALBESTI",364,"SCOALA GENERALA ALBESTI,CLS III,SOS MANGALIEI,NR 33",0,238,0,238,0,236,2,300,62,194,42,3,5924,1
14,"Constanta",61005,136,61005,,"ALIMAN",365,"SCOALA GENERALA-SAT ALIMAN STR PRINCIPALA NR 45",685,431,407,4,20,426,5,800,369,198,228,3,5930,0
14,"Constanta",61005,136,61005,,"ALIMAN",366,"SCOALA DE ARTA SI MESERII-SAT DUNARENI STR SCOLII NR 9",1155,660,655,5,0,646,14,1300,640,206,440,3,5930,0
14,"Constanta",61005,136,61005,,"ALIMAN",367,"SCOALA CU CLASELE I-IV VLAHII STR BISERICII NR4",391,261,249,9,3,256,5,400,139,94,162,3,5930,0
14,"Constanta",61005,136,61005,,"ALIMAN",368,"SCOALA  CU CLASELE I-VIII ALIMAN,CLS VIII,STR PRINCIPALAL NR 45",0,60,0,60,0,60,0,100,40,32,28,3,5930,1
14,"Constanta",63198,136,63198,,"AMZACEA",369,"SCOALA GENERALA-SAT AMZACEA",1046,536,523,10,3,528,8,1199,663,215,313,3,5935,0
14,"Constanta",63198,136,63198,,"AMZACEA",370,"SCOALA GENERALA-SAT GENERAL SCARISOREANU",785,385,371,7,7,383,2,900,515,94,289,3,5935,0
14,"Constanta",63198,136,63198,,"AMZACEA",371,"SCOALA CU CLASELE I-IV SAT CASICEA",337,184,176,8,0,180,4,400,216,107,73,3,5935,0
14,"Constanta",63198,136,63198,,"AMZACEA",372,"SCOALA GENERALA AMZACEA SALA 1B,STR AMZACEI NR 22",0,64,0,64,0,64,0,100,36,35,29,3,5935,1
14,"Constanta",63294,136,63294,,"BARAGANU",373,"CAMINUL CULTURAL- BARAGANU",914,514,496,6,12,512,2,1000,486,175,337,3,5939,0
14,"Constanta",63294,136,63294,,"BARAGANU",374,"CAMINUL CULTURAL-SAT LANURILE",745,377,371,6,0,374,3,800,423,167,207,3,5939,0
14,"Constanta",63294,136,63294,,"BARAGANU",375,"CAMINUL CULTURAL BARAGANU,STR PETRE MARINESCU NR 186",0,87,0,87,0,87,0,100,13,49,38,3,5939,1
14,"Constanta",61121,136,61121,,"CASTELU",376,"CAMINUL CULTURAL CASTELU-STR REPUBLICII NR 60,SALA SPECTACOLE",1247,721,716,5,0,708,13,1400,679,341,367,3,5942,0
14,"Constanta",61121,136,61121,,"CASTELU",377,"CAMINUL CULTURAL CASTELU-STR REPUBLICII NR 60,SALA SPECTACOLE",1143,696,694,2,0,685,11,1300,604,356,329,3,5942,0
14,"Constanta",61121,136,61121,,"CASTELU",378,"CAMINUL CULTURAL  NISIPARI STR SPERANTEI NR7",1388,954,942,12,0,939,15,1500,546,714,225,3,5942,0
14,"Constanta",61121,136,61121,,"CASTELU",379,"CAMINUL CULTURAL CASTELU,STR REPUBLICII NR 60,BIBLIOTECA",0,125,0,125,0,122,3,200,75,69,53,3,5942,1
14,"Constanta",61167,136,61167,,"CERCHEZU",380,"CAMINUL CULTURAL CERCHEZU STR G-RAL CERCHEZ NR 26",464,288,284,4,0,281,7,500,212,99,182,3,5945,0
14,"Constanta",61167,136,61167,,"CERCHEZU",381,"CAMINUL CULTURAL-SAT CASCIOARELE,CALEA DOBROGEI NR 33",232,182,170,11,1,181,1,300,118,31,150,3,5945,0
14,"Constanta",61167,136,61167,,"CERCHEZU",382,"CAMINUL CULTURAL-SAT VIROAGA STR ORIZONTULUI NR 9",425,256,246,10,0,250,6,500,244,121,129,3,5945,0
14,"Constanta",61167,136,61167,,"CERCHEZU",383,"CASA AGRONOMULUI-SAT MAGURA STR IZVOR NR 26",98,69,60,9,0,68,1,100,31,21,47,3,5945,0
14,"Constanta",61167,136,61167,,"CERCHEZU",384,"SCOALA GENERALA CERCHEZU,STR TINERETULUI NR 2",0,82,0,82,0,80,2,100,18,35,45,3,5945,1
14,"Constanta",61210,136,61210,,"CHIRNOGENI",385,"SCOALA DE ARTA SI MESERII CHIRNOGENI,CLS IV,SOS NEGRU VODA 41",1549,777,772,3,2,763,14,1700,923,238,525,3,5950,0
14,"Constanta",61210,136,61210,,"CHIRNOGENI",386,"SCOALA GENERALA-SAT PLOPENI",982,476,461,11,4,472,4,1100,624,179,293,3,5950,0
14,"Constanta",61210,136,61210,,"CHIRNOGENI",387,"GRADINITA CU ORAR NORMAL-SAT CREDINTA",247,123,114,9,0,122,1,300,177,70,52,3,5950,0
14,"Constanta",61210,136,61210,,"CHIRNOGENI",388,"SCOALA DE ARTE SI MESERII CHIRNOGENI,CLS III,SOSEAUA NEGRU VODA NR 41",0,82,0,82,0,81,1,200,118,30,51,3,5950,1
14,"Constanta",61256,136,61256,,"CIOBANU",389,"SCOALA GENERALA- PARTER SAT. CIOBANU",1196,650,649,1,0,648,2,1300,650,334,314,3,5954,0
14,"Constanta",61256,136,61256,,"CIOBANU",390,"SCOALA GENERALA- ET I SAT. CIOBANU",1393,711,708,3,0,707,4,1500,789,401,306,3,5954,0
14,"Constanta",61256,136,61256,,"CIOBANU",391,"SCOALA GENERALA-SAT. MIORITA",276,151,141,10,0,146,5,300,149,81,65,3,5954,0
14,"Constanta",61256,136,61256,,"CIOBANU",392,"DISPENSARUL UMAN CIOBANU PARTER,STR EROILOR NR 82",0,41,0,41,0,41,0,100,59,24,17,3,5954,1
14,"Constanta",61283,136,61283,,"CIOCARLIA",393,"CAMINUL CULTURAL CIOCARLIA,INTRAREA PRINCIPALA,STR 1 DECEMBRIE,NR66",1366,724,720,3,1,714,10,1500,776,291,423,3,5957,0
14,"Constanta",61283,136,61283,,"CIOCARLIA",394,"CAMINUL CULTURAL SAT CIOCIRLIA DE SUS,STR VENUS NR 15",1011,537,520,17,0,530,7,1100,563,247,283,3,5957,0
14,"Constanta",61283,136,61283,,"CIOCARLIA",395,"CAMINUL CULTURAL CIOCARLIA INTRAREA SECUNDARA ,STR 1 DECEMBRIE NR 66",0,92,0,92,0,90,2,100,8,43,47,3,5957,1
14,"Constanta",61318,136,61318,,"COBADIN",396,"CAMINUL CULTURAL- COBADIN",1920,949,942,7,0,936,13,2100,1151,457,479,3,5960,0
14,"Constanta",61318,136,61318,,"COBADIN",397,"SCOALA TATARA-SAT COBADIN",1798,915,902,11,2,905,10,2000,1085,460,445,3,5960,0
14,"Constanta",61318,136,61318,,"COBADIN",398,"SEDIU FOST C.A.P-SAT COBADIN",1674,818,808,10,0,811,7,1800,982,377,434,3,5960,0
14,"Constanta",61318,136,61318,,"COBADIN",399,"SCOALA GENERALA-SAT CONACU",301,138,128,10,0,138,0,300,162,92,46,3,5960,0
14,"Constanta",61318,136,61318,,"COBADIN",400,"CAMINUL CULTURAL-SAT NEGRESTI",384,199,189,10,0,199,0,400,201,43,156,3,5960,0
14,"Constanta",61318,136,61318,,"COBADIN",401,"SEDIUL FOST C.A.P-SAT VIISOARA",1214,651,640,11,0,643,8,1300,649,277,366,3,5960,0
14,"Constanta",61318,136,61318,,"COBADIN",402,"CLUBUL PENSIONARILOR COBADIN,PIATA EROILOR NR 3",0,214,0,214,0,208,6,300,86,131,77,3,5960,1
14,"Constanta",61372,136,61372,,"COGEALAC",403,"GRADINITA DE COPII -SAT COGEALAC,STR MARE NR 53",1581,911,899,12,0,895,16,1699,788,446,449,3,5966,0
14,"Constanta",61372,136,61372,,"COGEALAC",404,"SCOALA GENERALA SAT COGEALAC,STR MARE NR 55",1363,809,794,15,0,797,12,1400,591,404,393,3,5966,0
14,"Constanta",61372,136,61372,,"COGEALAC",405,"SCOALA GENERALA-SAT TARIVERDE,STR TUDOR VLADIMIRESCU",873,510,498,12,0,503,7,1000,490,281,222,3,5966,0
14,"Constanta",61372,136,61372,,"COGEALAC",406,"SCOALA GENERALA- SAT RAMNICUL DE JOS,STR FABRICII NR 25B",674,356,347,9,0,348,8,700,344,182,166,3,5966,0
14,"Constanta",61372,136,61372,,"COGEALAC",407,"GRUP SCOLAR COGELAC,STR LICEULUI NR 36",0,206,0,206,0,199,7,300,94,110,89,3,5966,1
14,"Constanta",61452,136,61452,,"COMANA",408,"SCOALAGENERALA-SAT COMANA",770,448,444,4,0,444,4,801,353,190,254,3,5972,0
14,"Constanta",61452,136,61452,,"COMANA",409,"SCOALA GENERALA-SAT TATARU",516,306,299,7,0,305,1,600,294,153,152,3,5972,0
14,"Constanta",61452,136,61452,,"COMANA",410,"SCOALA PRIMARA-SAT PELINU",242,140,131,9,0,136,4,300,160,51,85,3,5972,0
14,"Constanta",61452,136,61452,,"COMANA",411,"SCOALA GENERALA COMANA,STR PRIMAVERII NR 20",0,52,0,52,0,51,1,100,48,27,24,3,5972,1
14,"Constanta",61513,136,61513,,"CORBU",412,"SCOALA GENERALA NR 1-SAT. CORBU",2627,1295,1253,42,0,1283,12,2900,1605,766,517,3,5976,0
14,"Constanta",61513,136,61513,,"CORBU",413,"ASOCIATIA AGRICOLA 'SPICUL' -SAT. CORBU",1607,814,760,54,0,805,9,1800,986,418,387,3,5976,0
14,"Constanta",61513,136,61513,,"CORBU",414,"SCOALA GENERALA-SAT. VADU",533,313,303,9,1,310,3,600,287,202,108,3,5976,0
14,"Constanta",61513,136,61513,,"CORBU",415,"CAMINUL CULTURAL CORBU STR PRINCIPALA NR  306",0,146,0,146,0,144,2,200,54,74,70,3,5976,1
14,"Constanta",63286,136,63286,,"COSTINESTI",416,"SCOALA GENERALA NR1 COSTINESTI",866,577,573,3,1,574,3,900,323,341,233,3,5980,0
14,"Constanta",63286,136,63286,,"COSTINESTI",417,"SCOALA PRIMARA SCHITU",1481,1008,998,10,0,992,16,1600,592,651,341,3,5980,0
14,"Constanta",63286,136,63286,,"COSTINESTI",418,"GRADINITA DE COPII CU ORAR NORMAL COSTINESTI,STR GARII NR 1",0,255,0,255,0,254,1,300,45,159,95,3,5980,1
14,"Constanta",61559,136,61559,,"CRUCEA",419,"CAMINUL CULTURAL CRUCEA,SLA DE CONFERINTE,SOS CONSTANTEI NR46",974,437,431,6,0,429,8,1100,663,208,221,3,5983,0
14,"Constanta",61559,136,61559,,"CRUCEA",420,"SCOALA  CU CLASELE I-IV SAT GALBIORI",250,138,132,6,0,134,4,300,162,97,37,3,5983,0
14,"Constanta",61559,136,61559,,"CRUCEA",421,"SCOALA  CU CLASELE I-IV - SAT BALTAGESTI",390,170,161,9,0,166,4,400,230,46,120,3,5983,0
14,"Constanta",61559,136,61559,,"CRUCEA",422,"SCOALA CU CLASELE I-IV-SAT STUPINA",587,270,261,9,0,268,2,600,330,101,167,3,5983,0
14,"Constanta",61559,136,61559,,"CRUCEA",423,"SCOALA CU CLASELE I-IV- SAT CRISAN",314,165,163,2,0,163,2,300,135,85,78,3,5983,0
14,"Constanta",61559,136,61559,,"CRUCEA",424,"SCOALA CU CLASELE I-IV-SAT SIRIU",210,102,94,8,0,101,1,200,98,50,51,3,5983,0
14,"Constanta",61559,136,61559,,"CRUCEA",425,"CAMINUL CULTURAL BIROU I.S.U SOS CONSTANTEI NR 46",0,55,0,55,0,55,0,200,145,31,24,3,5983,1
14,"Constanta",61620,136,61620,,"CUMPANA",426,"SCOALA GENERALA CU ETAJ NOUA  -. CUMPANA",1957,1047,1035,12,0,1036,11,2200,1153,527,509,3,5990,0
14,"Constanta",61620,136,61620,,"CUMPANA",427,"SCOALA  GENERALA CU ETAJ  VECHE  -. CUMPANA",2410,1409,1392,17,0,1395,14,2700,1291,725,670,3,5990,0
14,"Constanta",61620,136,61620,,"CUMPANA",428,"ANEXA SCOLII  GENERALE  CUMPANA-LINGA BISERICA SFINTA MARIA",2298,1409,1371,38,0,1387,22,2500,1091,703,684,3,5990,0
14,"Constanta",61620,136,61620,,"CUMPANA",429,"SALA DE SPORT CUMPANA",2700,1536,1493,43,0,1522,14,3000,1464,798,724,3,5990,0
14,"Constanta",61620,136,61620,,"CUMPANA",430,"SCOALA GENERALA CUMPANA PARTER SOS CONSTANTEI NR 136",0,379,0,379,0,377,2,400,21,201,176,3,5990,1
14,"Constanta",63300,136,63300,,"CUZA VODA",431,"SCOALA CU CLASELE I-VIII CUZA VODA",1262,638,636,2,0,626,12,1400,762,367,259,3,5993,0
14,"Constanta",63300,136,63300,,"CUZA VODA",432,"SCOALA CU CLASELE I-VIII CUZA VODA",1385,805,800,5,0,790,15,1500,695,311,479,3,5993,0
14,"Constanta",63300,136,63300,,"CUZA VODA",433,"SCOALA CU CLASELE I-VIII CUZA VODA,STR MEDGIDIEI NR 53",0,83,0,83,0,82,1,100,17,45,37,3,5993,1
14,"Constanta",61675,136,61675,,"DELENI",434," CAMIN CULTURAL-SAT DELENI",336,250,240,8,2,244,6,400,150,115,129,3,5995,0
14,"Constanta",61675,136,61675,,"DELENI",435,"CAMIN CULTURAL-SAT PIETRENI",687,436,411,12,13,429,7,800,364,165,264,3,5995,0
14,"Constanta",61675,136,61675,,"DELENI",436,"SCOALA -SAT SIPOTELE",415,299,276,9,14,292,7,500,201,105,187,3,5995,0
14,"Constanta",61675,136,61675,,"DELENI",437,"SEDIU FOST CAP -SAT PETROSANI",469,321,306,15,0,317,4,500,179,127,190,3,5995,0
14,"Constanta",61675,136,61675,,"DELENI",438,"CAMINUL CULTURAL DELENI CLUB,STR PRINCIPALA NR 127",0,100,0,100,0,98,2,100,0,41,57,3,5995,1
14,"Constanta",61737,136,61737,,"DOBROMIR",439,"SCOALA DE ARTE SI MESERII-CORP SCOALA NOUA SAT DOBROMIR",691,456,454,2,0,441,15,800,344,131,310,3,6000,0
14,"Constanta",61737,136,61737,,"DOBROMIR",440,"SCOALA GENERALA CU CLASELE I-IV-SAT DOBROMIR DEAL",248,170,161,7,2,166,4,301,131,48,118,3,6000,0
14,"Constanta",61737,136,61737,,"DOBROMIR",441,"SCOALA GENERALA CU CLASELE I-IV-SAT LESPEZI",327,254,246,8,0,248,6,400,146,79,169,3,6000,0
14,"Constanta",61737,136,61737,,"DOBROMIR",442,"SCOALA GENERALA CU CLASELE I-IV-SAT VALENI",664,394,384,10,0,388,6,700,306,78,310,3,6000,0
14,"Constanta",61737,136,61737,,"DOBROMIR",443,"SCOALA GENERALA CU CLASELE I-IV -SAT PADURENI",113,77,68,9,0,76,1,99,22,35,41,3,6000,0
14,"Constanta",61737,136,61737,,"DOBROMIR",444,"PRIMARIA COMUNEI DOBROMIR STR BANEASA NR 28",0,55,0,55,0,54,1,99,44,20,34,3,6000,1
14,"Constanta",63161,136,63161,,"DUMBRAVENI",445,"SCOALA GENERALA-SAT DUMBRAVENI",397,240,237,3,0,234,6,400,160,71,163,3,6007,0
14,"Constanta",63161,136,63161,,"DUMBRAVENI",446,"GRADINITA SAT FURNICA",76,62,55,7,0,62,0,100,38,14,48,3,6007,0
14,"Constanta",63161,136,63161,,"DUMBRAVENI",447,"GRADINITA DE COPII DUMBRAVENI",0,56,0,56,0,55,1,100,44,23,32,3,6007,1
14,"Constanta",63334,136,63334,,"FANTANELE",448,"SCOALA CU CLASELE I-VIII FANTANELE,CLS III A",1335,883,837,5,41,864,19,1500,617,213,651,3,6010,0
14,"Constanta",63334,136,63334,,"FANTANELE",449,"SCOALA CU CLASELE I-VIII FANTANELE,CLS IV,STR BASARBIA NR 83",0,79,0,79,0,79,0,100,21,26,53,3,6010,1
14,"Constanta",61808,136,61808,,"GARLICIU",450,"CENTRUL CULTURAL DUNAREA VECHE -SAT GIRLICIU",1489,905,868,1,36,895,10,1600,695,286,609,3,6012,0
14,"Constanta",61808,136,61808,,"GARLICIU",451,"CENTRUL CULTURAL DUNAREA VECHE -SAT GIRLICIU,STR 1DECEMBRIE 1918,NR 33",0,49,0,49,0,48,1,100,51,20,28,3,6012,1
14,"Constanta",61826,136,61826,,"GHINDARESTI",452,"CAMINUL CULTURAL-SAT GHINDARESTI",1163,511,511,0,0,501,10,1300,789,316,185,3,6014,0
14,"Constanta",61826,136,61826,,"GHINDARESTI",453,"CAMINUL CULTURAL-SAT GHINDARESTI",1139,470,470,0,0,467,3,1300,830,276,191,3,6014,0
14,"Constanta",61826,136,61826,,"GHINDARESTI",454,"CAMINUL CULTURAL GHINDARESTI STR SCOLII NR 436",0,42,0,42,0,41,1,200,158,26,15,3,6014,1
14,"Constanta",63326,136,63326,,"GRADINA",455,"SCOALA CU CLASELE I-VIII ,CAB BIOLOGIE GRADINA",644,450,440,1,9,437,13,700,250,141,296,3,6016,0
14,"Constanta",63326,136,63326,,"GRADINA",456,"SCOALA CU CLASELE I-IV CHEIA",318,226,220,4,2,224,2,400,174,88,136,3,6016,0
14,"Constanta",63326,136,63326,,"GRADINA",457,"SCOALA CU CLASELE I-VIII GRADINA CAB MATEMATICA,STR VICTORIEI,NR32",0,88,0,88,0,88,0,100,12,20,68,3,6016,1
14,"Constanta",63278,136,63278,,"HORIA",458,"CAMINUL CULTURAL-SAT HORIA",729,482,452,12,18,475,7,800,318,242,233,3,6020,0
14,"Constanta",63278,136,63278,,"HORIA",459,"CAMINUL CULTURAL-SAT TICHILESTI",292,185,172,7,6,182,3,300,115,84,98,3,6020,0
14,"Constanta",63278,136,63278,,"HORIA",460,"CAMINUL CULTURAL HORIA,STR PRINCIPALA NR 7",0,56,0,56,0,55,1,100,44,39,16,3,6020,1
14,"Constanta",61871,136,61871,,"INDEPENDENTA",461,"SCOALA GENERALA- CORP A SAT INDEPENDENTA",1048,614,614,0,0,610,4,1200,586,227,383,3,6024,0
14,"Constanta",61871,136,61871,,"INDEPENDENTA",462,"SCOALA GENERALA-SAT MOVILA VERDE",499,263,255,8,0,259,4,500,237,137,122,3,6024,0
14,"Constanta",61871,136,61871,,"INDEPENDENTA",463,"SCOALA GENERALA-SAT OLTENI",348,209,200,9,0,201,8,400,191,106,95,3,6024,0
14,"Constanta",61871,136,61871,,"INDEPENDENTA",464,"SCOALA GENERALA-SAT TUFANI",287,213,206,7,0,213,0,300,87,92,121,3,6024,0
14,"Constanta",61871,136,61871,,"INDEPENDENTA",465,"SCOALA GENERALA-SAT FINTINA MARE",291,190,179,11,0,183,7,301,111,81,102,3,6024,0
14,"Constanta",61871,136,61871,,"INDEPENDENTA",466,"SCOALA GENERALA INDEPENDENTA CORP B,STR CONSTANTEI NR 39",0,67,0,67,0,66,1,100,33,37,29,3,6024,1
14,"Constanta",61951,136,61951,,"ION CORVIN",467,"SCOALA CU CLASELE I-VIII,CLASA A -V-A SAT ION CORVIN",501,321,301,8,12,315,6,600,279,134,181,3,6030,0
14,"Constanta",61951,136,61951,,"ION CORVIN",468,"SCOALA CU CLASELE I-VIII-SAT VIILE",844,589,561,8,20,579,10,900,311,229,350,3,6030,0
14,"Constanta",61951,136,61951,,"ION CORVIN",469,"SCOALA CU CLASELE I-IV -SAT RARISTEA",225,139,126,8,5,136,3,201,62,42,94,3,6030,0
14,"Constanta",61951,136,61951,,"ION CORVIN",470,"SCOALA PRIMARA-SAT CRANGU",99,60,51,8,1,58,2,100,40,16,42,3,6030,0
14,"Constanta",61951,136,61951,,"ION CORVIN",471,"SCOALA CU CLASELE I-VIII ION CORVIN,CLS I,STR SF ANDREI NR 46",0,78,0,78,0,77,1,400,322,40,37,3,6030,1
14,"Constanta",62020,136,62020,,"ISTRIA",472,"SCOALA CU CLASELE I-VIII,CORP2,SALA1 PARTER -SAT ISTRIA",1183,606,599,7,0,596,10,1300,694,293,303,3,6036,0
14,"Constanta",62020,136,62020,,"ISTRIA",473,"SCOALA CU CLASELE I-VIII NUNTASI",886,660,655,5,0,628,32,1000,340,217,411,3,6036,0
14,"Constanta",62020,136,62020,,"ISTRIA",474,"SCOALA CU CLASELE I-VIII ISTRIA CORP2,SALA2,STR PRIMARIEI NR 15",0,66,0,66,0,66,0,100,34,27,39,3,6036,1
14,"Constanta",60632,136,60632,,"LIMANU",475,"SCOALA CU CLASELE I-VIII-SAT LIMANU",2412,1367,1353,14,0,1352,15,2700,1333,970,382,3,6039,0
14,"Constanta",60632,136,60632,,"LIMANU",476,"SCOALA CU CLASELE I-VIII-SAT 2 MAI",2444,1425,1407,18,0,1416,9,2700,1275,980,436,3,6039,0
14,"Constanta",60632,136,60632,,"LIMANU",477,"INCINTA S.C.U.P LIMANU,STR MORII NR 8",0,212,0,212,0,212,0,401,189,135,77,3,6039,1
14,"Constanta",62057,136,62057,,"LIPNITA",478,"CAMINUL CULTURAL-SAT LIPNITA",831,510,497,5,8,500,10,800,290,315,185,3,6044,0
14,"Constanta",62057,136,62057,,"LIPNITA",479,"CAMINUL CULTURAL-SAT COSLUGEA",644,400,371,12,17,395,5,700,300,143,252,3,6044,0
14,"Constanta",62057,136,62057,,"LIPNITA",480,"CAMINUL CULTURAL SAT CANLIA",471,301,278,5,18,295,6,500,199,134,161,3,6044,0
14,"Constanta",62057,136,62057,,"LIPNITA",481,"SCOALA GENERALA-SAT CARVAN",388,240,230,7,3,235,5,399,159,112,123,3,6044,0
14,"Constanta",62057,136,62057,,"LIPNITA",482,"SCOALA  CU CLASELE I-IV-SAT IZVOARELE",114,76,68,8,0,75,1,100,24,33,42,3,6044,0
14,"Constanta",62057,136,62057,,"LIPNITA",483,"SCOALA CU CLASELE I-IV -SAT GORUNI",109,66,54,8,4,64,2,100,34,35,29,3,6044,0
14,"Constanta",62057,136,62057,,"LIPNITA",484,"SCOALA CU CLASELE I-IV-SAT CUIUGIUC",166,109,102,7,0,107,2,200,91,48,59,3,6044,0
14,"Constanta",62057,136,62057,,"LIPNITA",485,"CAMINUL CULTURAL LIPNITA SALA B,STR MORII,NR 350",0,128,0,128,0,125,3,200,72,64,61,3,6044,1
14,"Constanta",63152,136,63152,,"LUMINA",486,"SCOALA GENERALA(NOUA)-SAT LUMINA STR PELICAN NR 9BIS",2416,1393,1368,25,0,1379,14,2600,1207,728,651,3,6052,0
14,"Constanta",63152,136,63152,,"LUMINA",487,"GRADINITA NOUA  LUMINA.STR PELICAN NR 10",1810,844,778,66,0,833,11,2000,1156,405,428,3,6052,0
14,"Constanta",63152,136,63152,,"LUMINA",488,"CAMIN CULTURAL,SAT LUMINA STR MARE NR 173",2152,1416,1135,281,0,1398,18,2400,984,720,678,3,6052,0
14,"Constanta",63152,136,63152,,"LUMINA",489,"SCOALA GENERALA-SAT OITUZ",573,330,323,7,0,328,2,600,270,233,95,3,6052,0
14,"Constanta",63152,136,63152,,"LUMINA",490,"SCOALA GENERALA-SAT SIBIOARA",370,213,204,9,0,211,2,400,187,105,106,3,6052,0
14,"Constanta",63152,136,63152,,"LUMINA",491,"SCOALA VECHE LUMINA STR MARE NR 158",0,271,0,271,0,267,4,300,29,125,142,3,6052,1
14,"Constanta",62137,136,62137,,"MERENI",492,"SCOALA GENERALA-SAT MERENI",1100,592,581,11,0,582,10,1200,608,269,313,3,6056,0
14,"Constanta",62137,136,62137,,"MERENI",493,"SCOALA GENERALA-SAT OSMANCEA",473,310,303,7,0,305,5,499,189,135,170,3,6056,0
14,"Constanta",62137,136,62137,,"MERENI",494,"SCOALA GENERALA-SAT CIOBANITA",274,158,152,6,0,158,0,300,142,55,103,3,6056,0
14,"Constanta",62137,136,62137,,"MERENI",495,"SCOALA GENERALAL MERENI SALA2,STR LIBERTATII NR 137",0,89,0,89,0,89,0,100,11,47,42,3,6056,1
14,"Constanta",62253,136,62253,,"MIHAI VITEAZU",496,"SCOALA DE ARTE SI MESERII ,SALA 1SAT MIHAI VITEAZU",1567,746,742,4,0,733,13,1700,954,473,260,3,6061,0
14,"Constanta",62253,136,62253,,"MIHAI VITEAZU",497,"SCOALA CU CLASELE I-VIII-SAT SINOIE",1073,591,579,12,0,583,8,1200,609,459,124,3,6061,0
14,"Constanta",62253,136,62253,,"MIHAI VITEAZU",498,"SCOALA DE ARTE SI MESERII SALA2,STR PRINCIPALA NR4",0,56,0,56,0,56,0,100,44,34,22,3,6061,1
14,"Constanta",62191,136,62191,,"MIHAIL KOGALNICEANU",499,"GRADINITA DOMINO MIHAIL KOGALNICEANU",1152,624,608,16,0,624,0,1300,676,423,201,3,6064,0
14,"Constanta",62191,136,62191,,"MIHAIL KOGALNICEANU",500,"GRADINITA PINOCHIO MIHAIL KOGALNICEANU",1142,698,668,30,0,694,4,1300,602,505,189,3,6064,0
14,"Constanta",62191,136,62191,,"MIHAIL KOGALNICEANU",501,"SCOLA GENERALA NR.2 M.KOGALNICEANU",1275,707,691,16,0,705,2,1400,693,450,255,3,6064,0
14,"Constanta",62191,136,62191,,"MIHAIL KOGALNICEANU",502,"LICEUL TEORETIC - M.KOGALNICEANU",1376,703,671,31,1,696,7,1500,797,437,259,3,6064,0
14,"Constanta",62191,136,62191,,"MIHAIL KOGALNICEANU",503,"GRADINITA PITICOT MIHAIL KOGALNICEANU",784,418,397,21,0,410,8,900,482,242,168,3,6064,0
14,"Constanta",62191,136,62191,,"MIHAIL KOGALNICEANU",504,"GRADINITA PITICOT MIHAIL KOGALNICEANU",844,464,453,11,0,462,2,900,436,192,270,3,6064,0
14,"Constanta",62191,136,62191,,"MIHAIL KOGALNICEANU",505,"SCOALA GENERALA CERES M.KOGALNICEANU",415,210,202,8,0,209,1,500,290,120,89,3,6064,0
14,"Constanta",62191,136,62191,,"MIHAIL KOGALNICEANU",506,"U.A SIBIOARA",337,216,209,7,0,213,3,400,184,60,153,3,6064,0
14,"Constanta",62191,136,62191,,"MIHAIL KOGALNICEANU",507,"SCOLA CU CLASELE I-VIII-SAT PIATRA",667,419,410,9,0,416,3,700,281,260,156,3,6064,0
14,"Constanta",62191,136,62191,,"MIHAIL KOGALNICEANU",508,"SCOALA GENERALA-SAT PALAZU MIC",264,161,155,6,0,161,0,300,139,117,44,3,6064,0
14,"Constanta",62191,136,62191,,"MIHAIL KOGALNICEANU",509,"CAMINUL CULTURAL MIHAIL KOGALNICEANU,STR TUDOR VLADIMIRESCU NR49",0,200,0,200,0,200,0,400,200,118,82,3,6064,1
14,"Constanta",62280,136,62280,,"MIRCEA VODA",510,"SCOALA CU CLASELE I-VIII,CLS III SALA 5-SAT MIRCEA VODA",1552,872,857,15,0,858,14,1700,828,342,516,3,6068,0
14,"Constanta",62280,136,62280,,"MIRCEA VODA",511,"SCOALA CU CLASELE I-VIII-SAT SATU NOU",2095,1122,1103,17,2,1109,13,2200,1078,445,664,3,6068,0
14,"Constanta",62280,136,62280,,"MIRCEA VODA",512,"SCOALA CU CLASELE I-VIII  MIRCEA VODA SALA 4",0,73,0,73,0,72,1,200,127,32,40,3,6068,1
14,"Constanta",62440,136,62440,,"NICOLAE BALCESCU",513,"SCOALA GENERALA NICOLAE BALCESCU",1288,691,681,10,0,685,6,1300,609,406,279,3,6073,0
14,"Constanta",62440,136,62440,,"NICOLAE BALCESCU",514,"SCOALA GENERALA NICOLAE BALCESCU",1453,794,779,15,0,790,4,1600,806,431,359,3,6073,0
14,"Constanta",62440,136,62440,,"NICOLAE BALCESCU",515,"SCOALA GENERALA-SAT DOROBANTU",1461,774,757,15,2,759,15,1600,826,379,380,3,6073,0
14,"Constanta",62440,136,62440,,"NICOLAE BALCESCU",516,"SCOALA NICOLAE BALCESCU,STR CAROL I NR 22",0,294,0,294,0,293,1,300,6,110,183,3,6073,1
14,"Constanta",62486,136,62486,,"OLTINA",517,"SCOALA DE ARTE SI MESERII  ,SALA 1 OLTINA",1570,851,847,4,0,841,10,1600,749,457,384,3,6076,0
14,"Constanta",62486,136,62486,,"OLTINA",518,"SCOALACU CLASELE I-VIII SAT RAZOARELE",508,338,330,8,0,333,5,600,262,183,150,3,6076,0
14,"Constanta",62486,136,62486,,"OLTINA",519,"SCOALA CU CLASELE I-IV-SAT SATU NOU",204,147,135,12,0,145,2,200,53,54,91,3,6076,0
14,"Constanta",62486,136,62486,,"OLTINA",520,"SCOALA DE ARTE SI MESERII OLTINA SALA2,STR DISPENSARULUI 674",0,127,0,127,0,123,4,200,73,73,50,3,6076,1
14,"Constanta",62538,136,62538,,"OSTROV",521,"GRUP SCOLAR OSTROV",2324,1259,1236,18,5,1238,21,2500,1241,750,488,3,6081,0
14,"Constanta",62538,136,62538,,"OSTROV",522,"CAMINUL CULTURALSAT ALMALAU",741,381,374,7,0,374,7,800,419,156,218,3,6081,0
14,"Constanta",62538,136,62538,,"OSTROV",523,"SCOALA GENERALA-SAT ESECHIOI",216,146,128,18,0,144,2,200,54,52,92,3,6081,0
14,"Constanta",62538,136,62538,,"OSTROV",524,"CAMINUL CULTURAL -SAT GARLITA",283,170,163,7,0,165,5,300,130,71,94,3,6081,0
14,"Constanta",62538,136,62538,,"OSTROV",525,"CAMINUL CULTURAL-SAT GALITA",508,291,283,8,0,283,8,600,309,146,137,3,6081,0
14,"Constanta",62538,136,62538,,"OSTROV",526,"SCOALA GENERALA-SAT BUGEAC",177,103,91,12,0,100,3,200,97,21,79,3,6081,0
14,"Constanta",62538,136,62538,,"OSTROV",527,"CAMINUL CULTURAL OSTROV STR 1 MAI NR 78",0,156,0,156,0,154,2,200,44,70,84,3,6081,1
14,"Constanta",62609,136,62609,,"PANTELIMON",528,"GRADINTA-SAT PANTELIMON DE SUS,STR PRINCIPALA NR 219",624,381,369,2,10,376,5,700,319,111,265,3,6088,0
14,"Constanta",62609,136,62609,,"PANTELIMON",529,"SCOALA PRIMARA-SAT PANTELIMON DE JOS,STR PRINCIPALA NR 46",192,115,107,6,2,111,4,200,85,45,66,3,6088,0
14,"Constanta",62609,136,62609,,"PANTELIMON",530,"SCOALA PRIMARA-SAT RUNCU,STR PRINCIPALA NR 41",338,225,218,7,0,225,0,400,175,55,170,3,6088,0
14,"Constanta",62609,136,62609,,"PANTELIMON",531,"SCOALA PRIMARA-SAT NISTORESTI,STR SCOLII NR 68",220,121,114,7,0,120,1,200,79,41,79,3,6088,0
14,"Constanta",62609,136,62609,,"PANTELIMON",532,"GRADINITA PANTELIMONU DE SUS SALA1,STR PRINCIPALA NR 219",0,81,0,81,0,81,0,100,19,34,47,3,6088,1
14,"Constanta",62672,136,62672,,"PECINEAGA",533,"CAMINUL CULTURAL -SAT PECINEAGA SALA MARE,STR STEFAN CEL MARE NR 66",2547,1278,1264,12,2,1262,16,2700,1422,706,556,3,6094,0
14,"Constanta",62672,136,62672,,"PECINEAGA",534,"CAMINUL CULTURAL PECINEAGA SALA ANEXA,STR STEFAN CEL MARE NR 66",0,79,0,79,0,78,1,100,21,48,30,3,6094,1
14,"Constanta",62707,136,62707,,"PESTERA",535,"CAMINUL CULTURAL -SAT PESTERA,STR IZVORULUI NR 29",1411,745,738,7,0,734,11,1600,855,175,559,3,6097,0
14,"Constanta",62707,136,62707,,"PESTERA",536,"CAMINUL CULTURAL  IVRINEZU MARE,STR SCOLII NR 25",689,434,424,10,0,430,4,800,366,87,343,3,6097,0
14,"Constanta",62707,136,62707,,"PESTERA",537,"CAMINUL CULTURAL- IZVORU MARE,STR CISMELEI NR 1",566,263,251,12,0,261,2,595,332,96,165,3,6097,0
14,"Constanta",62707,136,62707,,"PESTERA",538,"SCOALA DE ARTE SI MESERII PESTERA STR FLORILOR NR 98",0,94,0,94,0,92,1,100,6,24,68,3,6097,1
14,"Constanta",62761,136,62761,,"POARTA ALBA",539,"SCOALA PUBLICA NR 1 (NOUA) POARTA ALBA,PARTER CLASA A II A  ,CALEA BUCURESTI NR 19",1469,860,847,13,0,856,4,1400,540,524,332,3,6103,0
14,"Constanta",62761,136,62761,,"POARTA ALBA",540,"SCOALA PUBLICA NR 1 (NOUA) POARTA ALBA,PARTER CLASA A II B,CALEA BUCURESTI NR 19",1291,765,758,2,5,754,11,1300,535,466,288,3,6103,0
14,"Constanta",62761,136,62761,,"POARTA ALBA",541,"CAMINUL CULTURAL DIN CARIERUL VIA,AL CANTINEI NR 2",907,982,587,4,391,953,29,1300,318,601,352,3,6103,0
14,"Constanta",62761,136,62761,,"POARTA ALBA",542,"SCOALA PRIMARA NAZARCEA(GALESU),CALEA OVIDIU NR 20",261,172,167,5,0,172,0,300,128,118,54,3,6103,0
14,"Constanta",62761,136,62761,,"POARTA ALBA",543,"SCOALA PUBLICA NR1 LOCAL NOU ET 1 CLS IIIB,CALEA BUCURESTI NR 19",0,155,0,155,0,155,0,200,45,91,64,3,6103,1
14,"Constanta",62798,136,62798,,"RASOVA",544,"SCOALA CU CLASELE I-IV- -SAT RASOVA",2029,1058,1051,7,0,1041,17,2100,1042,677,364,3,6106,0
14,"Constanta",62798,136,62798,,"RASOVA",545,"SCOALACU CLASELE I-VIII-SAT COCHIRLENI",961,511,501,10,0,503,8,1100,589,239,264,3,6106,0
14,"Constanta",62798,136,62798,,"RASOVA",546,"SCOALA CU CLASELE I-IV- RASOVA CLS I STR MIHAI EMINESCU NR 20",0,71,0,71,0,68,3,101,30,44,24,3,6106,1
14,"Constanta",62878,136,62878,,"SACELE",547,"SCOALADE ARTE SI MESERII  CORP A -SAT SACELE",1866,1064,1054,10,0,1055,9,2100,1036,639,416,3,6109,0
14,"Constanta",62878,136,62878,,"SACELE",548,"SCOALA DE ARTE SI MESERII SACELE CORP B,STR CETATEA HISTRIEI",0,114,0,114,0,114,0,200,86,77,37,3,6109,1
14,"Constanta",63318,136,63318,,"SALIGNY",549,"SCOALA GENERALA-SAT SALIGNY,CLS I A",700,356,349,7,0,352,4,802,446,154,198,3,6112,0
14,"Constanta",63318,136,63318,,"SALIGNY",550,"SCOALA GENERALA-SAT FACLIA",636,365,355,10,0,363,2,700,335,156,207,3,6112,0
14,"Constanta",63318,136,63318,,"SALIGNY",551,"SCOALA GENERALA-SAT STEFAN CEL MARE",383,202,194,8,0,200,2,400,198,108,92,3,6112,0
14,"Constanta",63318,136,63318,,"SALIGNY",552,"SCOALA GENERALA SALIGNY,CLS IV STR SCOLII",0,55,0,55,0,55,0,100,45,24,31,3,6112,1
14,"Constanta",62823,136,62823,,"SARAIU",553,"SCOALA CU CLASELE I-VIII -SAT SARAIU",681,392,387,5,0,385,7,700,308,153,232,3,6116,0
14,"Constanta",62823,136,62823,,"SARAIU",554,"SCOALA CU CLASELE I-IV--SAT DULGHERU",470,205,201,4,0,203,2,500,295,57,146,3,6116,0
14,"Constanta",62823,136,62823,,"SARAIU",555,"CAMINUL CULTURAL SARAIU STR NICOLAE MARALOI NR 1",0,45,0,45,0,44,1,100,55,23,21,3,6116,1
14,"Constanta",62903,136,62903,,"SEIMENI",556,"SCOALA CU CLASELE I-IV--SAT SEIMENII MICI",675,355,348,7,0,353,2,700,345,201,152,3,6120,0
14,"Constanta",62903,136,62903,,"SEIMENI",557,"SCOALA CU CLASELE I-VIII SAT SEIMENI,SALA 1",475,230,219,11,0,226,4,500,270,96,130,3,6120,0
14,"Constanta",62903,136,62903,,"SEIMENI",558,"GRADINITA DE COPII -SAT DUNAREA",589,320,316,4,0,315,5,600,280,95,220,3,6120,0
14,"Constanta",62903,136,62903,,"SEIMENI",559,"SCOALA CU CLASELE I-VIII SEIMENI SALA2,STR PRINCIPALA NR 38",0,60,0,60,0,60,0,100,40,26,34,3,6120,1
14,"Constanta",62949,136,62949,,"SILISTEA",560,"SCOALA DE ARTA SI MESERII-SAT SILISTEA",555,298,288,5,5,291,7,600,302,60,231,3,6124,0
14,"Constanta",62949,136,62949,,"SILISTEA",561,"SCOALA CU CLASELE I-VIII-SAT TEPES VODA",618,347,332,8,7,342,5,700,353,138,204,3,6124,0
14,"Constanta",62949,136,62949,,"SILISTEA",562,"SCOALA DE ARTE SI MESERII SILISTEA,STR MARE NR 134A",0,56,0,56,0,56,0,100,44,18,38,3,6124,1
14,"Constanta",62985,136,62985,,"TARGUSOR",563,"SALA SEDINTE CL-SAT TIRGUSOR",1123,657,647,10,0,646,11,1200,543,270,376,3,6127,0
14,"Constanta",62985,136,62985,,"TARGUSOR",564,"SCOALA CU CLASELE I-IV-SAT MIREASA",282,177,168,9,0,176,1,300,123,82,94,3,6127,0
14,"Constanta",62985,136,62985,,"TARGUSOR",565,"SALA DE SEDINTE CL TARGUSOR,STR BRINDUSEI NR 11",0,49,0,49,0,49,0,100,51,26,23,3,6127,1
14,"Constanta",63045,136,63045,,"TOPALU",566,"GRADINITA CU ORAR NORMAL TOPALU",1526,966,961,5,0,956,10,1700,734,267,689,3,6130,0
14,"Constanta",63045,136,63045,,"TOPALU",567,"CAMINUL CULTURAL TOPALU ,STR DINU SI SEVASTA VINTILA",0,87,0,87,0,86,1,200,113,43,43,3,6130,1
14,"Constanta",63072,136,63072,,"TOPRAISAR",568,"GRUP SCOLAR TOPRAISAR",1320,676,669,7,0,669,7,1500,824,249,420,3,6133,0
14,"Constanta",63072,136,63072,,"TOPRAISAR",569,"SCOALA VECHE-SAT TOPRAISAR",1477,793,782,11,0,789,4,1600,807,315,474,3,6133,0
14,"Constanta",63072,136,63072,,"TOPRAISAR",570,"SCOALA SAT BIRUINTA",576,349,344,5,0,346,3,600,251,112,234,3,6133,0
14,"Constanta",63072,136,63072,,"TOPRAISAR",571,"SCOALA SAT MOVILITA",807,441,428,13,0,436,5,900,459,220,216,3,6133,0
14,"Constanta",63072,136,63072,,"TOPRAISAR",572,"SCOALA  POTIRNICHEA",378,203,189,14,0,203,0,400,197,81,122,3,6133,0
14,"Constanta",63072,136,63072,,"TOPRAISAR",573,"GRUP SCOLAR TOPRAISAR,SOS NATINALA NR 32B",0,137,0,137,0,135,2,200,63,72,63,3,6133,1
14,"Constanta",63189,136,63189,,"TORTOMAN",574,"SEDIU FOST C.A.P-SAT TORTOMANU SALA MARE",1382,761,752,9,0,750,11,1500,739,282,468,3,6138,0
14,"Constanta",63189,136,63189,,"TORTOMAN",575,"SCOALA CU CLASELE I-VIII TORTOMAN,STR 1 DECEMBRIE NR 18",0,34,0,34,0,33,1,100,66,8,25,3,6138,1
14,"Constanta",60721,136,60721,,"TUZLA",576,"CAMINUL CULTURAL-SAT TUZLA",1640,990,980,10,0,983,7,1800,810,603,380,3,6141,0
14,"Constanta",60721,136,60721,,"TUZLA",577,"SCOALA MICA C;S I-IV TUZLA",2139,1272,1253,19,0,1265,7,2300,1028,784,481,3,6141,0
14,"Constanta",60721,136,60721,,"TUZLA",578,"SCOALA MARE CU CLASELE I-VIII-SAT TUZLA",1796,1086,1066,20,0,1075,11,2000,914,673,402,3,6141,0
14,"Constanta",60721,136,60721,,"TUZLA",579,"GRADINITA TUZLA,SOS CONSTANTEI NR 53",0,239,0,239,0,237,2,300,61,146,91,3,6141,1
14,"Constanta",63125,136,63125,,"VALU LUI TRAIAN",580,"SCOALA CU CLASELE I-VIII  NR 1 SAT. VALU LUI TRAIAN",1931,1300,1266,33,1,1291,9,2100,800,900,391,3,6143,0
14,"Constanta",63125,136,63125,,"VALU LUI TRAIAN",581,"GRADINITA ZONA C VALU LUI TRAIAN",2172,1409,1356,52,1,1395,14,2300,891,1050,345,3,6143,0
14,"Constanta",63125,136,63125,,"VALU LUI TRAIAN",582,"COMPLEX(SEDIU CONSUM COOP)",2340,1656,1639,17,0,1649,7,2500,844,1159,490,3,6143,0
14,"Constanta",63125,136,63125,,"VALU LUI TRAIAN",583,"SCOALA CU CLASELE I-VIII  NR 2- VICEAMIRAL IOAN MURGESCU VALEA SEACA",1814,1114,1098,14,2,1101,13,2000,886,793,308,3,6143,0
14,"Constanta",63125,136,63125,,"VALU LUI TRAIAN",584,"GRADINITA NR 2 VALEA SEACA",919,792,580,18,194,781,11,1000,208,575,206,3,6143,0
14,"Constanta",63125,136,63125,,"VALU LUI TRAIAN",585,"SCOALA NR 1 VALU LUI TRAIAN SALA GIMNASTICA,CALEA DOBROGEI NR 47",0,487,0,487,0,480,7,1000,513,338,142,3,6143,1
14,"Constanta",63170,136,63170,,"VULTURU",586,"CAMINUL CULTURAL-SAT VULTURU SALA MARE STR CARTAL NR 1",602,320,316,2,2,315,5,700,380,134,181,3,6145,0
14,"Constanta",63170,136,63170,,"VULTURU",587,"CAMINUL CULTURAL VULTURU CLUB STR CARTAL NR 1",0,25,0,25,0,25,0,100,75,10,15,3,6145,1
15,"Covasna",63394,145,63394,,"MUNICIPIUL SFANTU GHEORGHE",1,"Casa de Cultura Municipala Sfantu  Gheorghe str. Kossuth Lajos, nr. 13",1132,344,333,11,0,328,16,1184,840,187,141,1,6148,0
15,"Covasna",63394,145,63394,,"MUNICIPIUL SFANTU GHEORGHE",2,"Grup scolar ""KOS KAROLY"" Sfantu Gheorghe str. Gabor  Aron, nr. 18",639,224,217,7,0,219,5,700,476,119,100,1,6148,0
15,"Covasna",63394,145,63394,,"MUNICIPIUL SFANTU GHEORGHE",3,"Grup scolar ""KOS KAROLY"" Sfantu Gheorghe str. Gabor Aron, nr. 18",1413,491,479,11,1,480,11,1499,1008,235,245,1,6148,0
15,"Covasna",63394,145,63394,,"MUNICIPIUL SFANTU GHEORGHE",4,"Liceul Teoretic ""SZEKELY MIKO"" Sfantu Gheorghe str. Grof Miko Imre, nr.1",1668,566,558,8,0,540,26,1800,1234,301,239,1,6148,0
15,"Covasna",63394,145,63394,,"MUNICIPIUL SFANTU GHEORGHE",5,"Grup scolar Economic, Administrativ ""BERDE ARON"" Sfantu Gheorghe str. Crangului, nr.30",708,228,222,6,0,224,4,800,572,131,93,1,6148,0
15,"Covasna",63394,145,63394,,"MUNICIPIUL SFANTU GHEORGHE",6,"Grup scolar Economic, Administrativ ""BERDE ARON"" Sfantu Gheorghe str. Crangului, nr.30",1683,612,605,7,0,601,11,1700,1088,367,234,1,6148,0
15,"Covasna",63394,145,63394,,"MUNICIPIUL SFANTU GHEORGHE",7,"Grup scolar Economic, Administrativ ""BERDE ARON"" Sfantu Gheorghe str. Crangului, nr.30",888,351,341,10,0,347,4,1000,649,183,164,1,6148,0
15,"Covasna",63394,145,63394,,"MUNICIPIUL SFANTU GHEORGHE",8,"Liceul Teoretic ""MIKES KELEMEN"" Sfantu Gheorghe str. Kos Karoly, nr.5/A",744,285,274,11,0,280,5,800,515,139,141,1,6148,0
15,"Covasna",63394,145,63394,,"MUNICIPIUL SFANTU GHEORGHE",9,"Gradinita de copii ""GULLIVER"" Sfantu Gheorghe (cladirea fostei scoli generale  Kiss Arpad) str. Kos Karoly, nr.78",1328,398,387,11,0,390,8,1400,1002,234,156,1,6148,0
15,"Covasna",63394,145,63394,,"MUNICIPIUL SFANTU GHEORGHE",10,"Gradinita de copii ""GULLIVER"" Sfantu Gheorghe str. Dealului, nr.24",1070,368,360,8,0,362,6,1200,832,215,147,1,6148,0
15,"Covasna",63394,145,63394,,"MUNICIPIUL SFANTU GHEORGHE",11,"Gradinita de copii ""GULLIVER"" Sfantu Gheorghe str. Dealului, nr.24",1073,347,338,9,0,338,9,1200,853,187,151,1,6148,0
15,"Covasna",63394,145,63394,,"MUNICIPIUL SFANTU GHEORGHE",12,"Gradinita de copii ""GULLIVER"" Sfantu Gheorghe str. Dealului, nr.24",1459,487,480,7,0,475,12,1500,1013,252,223,1,6148,0
15,"Covasna",63394,145,63394,,"MUNICIPIUL SFANTU GHEORGHE",13,"Colegiul National ""MIHAI VITEAZUL"" Sfantu Gheorghe str. Kos Karoly, nr.22;",1100,372,364,8,0,364,8,1100,728,193,171,1,6148,0
15,"Covasna",63394,145,63394,,"MUNICIPIUL SFANTU GHEORGHE",14,"Colegiul National ""MIHAI VITEAZUL"" Sfantu Gheorghe str. Kos Karoly, nr.22;",952,248,239,9,0,241,7,1016,768,139,102,1,6148,0
15,"Covasna",63394,145,63394,,"MUNICIPIUL SFANTU GHEORGHE",15,"Colegiul National ""MIHAI VITEAZUL"" Sfantu Gheorghe str. Kos Karoly, nr.22;",931,297,287,10,0,292,5,999,702,167,125,1,6148,0
15,"Covasna",63394,145,63394,,"MUNICIPIUL SFANTU GHEORGHE",16,"Complexul Sportiv Municipal Sfantu Gheorghe (noua Sala de sport) str. Vanatorilor, nr.1.",1367,563,553,9,1,552,11,1400,837,301,251,1,6148,0
15,"Covasna",63394,145,63394,,"MUNICIPIUL SFANTU GHEORGHE",17,"Gradinita de copii ""ALBA CA ZAPADA"" Sfantu Gheorghe Aleea Tineretului, nr.2",897,304,293,11,0,295,9,1000,696,164,131,1,6148,0
15,"Covasna",63394,145,63394,,"MUNICIPIUL SFANTU GHEORGHE",18,"Scoala cu clasele I - VIII ""VARADI JOZSEF"" Sfantu Gheorghe str. Benedek Elek, nr.20;",590,254,246,8,0,245,9,700,446,161,84,1,6148,0
15,"Covasna",63394,145,63394,,"MUNICIPIUL SFANTU GHEORGHE",19,"Scoala cu clasele I - VIII ""VARADI JOZSEF"" Sfantu Gheorghe str. Benedek Elek, nr.20;",1328,517,499,18,0,504,13,1400,883,290,214,1,6148,0
15,"Covasna",63394,145,63394,,"MUNICIPIUL SFANTU GHEORGHE",20,"Liceul de Arta ""PLUGOR SADOR"" Sfantu Gheorghe str. Kossuth Lajos, nr.15;",794,309,295,10,4,297,12,894,585,158,139,1,6148,0
15,"Covasna",63394,145,63394,,"MUNICIPIUL SFANTU GHEORGHE",21,"Liceul de Arta ""PLUGOR SANDOR"" Sfantu Gheorghe str. Kossuth Lajos, nr.15;",983,366,357,9,0,345,21,1100,734,231,114,1,6148,0
15,"Covasna",63394,145,63394,,"MUNICIPIUL SFANTU GHEORGHE",22,"Scoala Ajutatoare Sfantu Gheorghe Piata Veche, nr.3",701,273,263,10,0,266,7,795,522,153,113,1,6148,0
15,"Covasna",63394,145,63394,,"MUNICIPIUL SFANTU GHEORGHE",23,"Gradinita de copii ""PANSELUTA"" Sfantu Gheorghe str. Romulus Cioflec, nr.14;",1333,445,431,14,0,440,5,1400,955,278,162,1,6148,0
15,"Covasna",63394,145,63394,,"MUNICIPIUL SFANTU GHEORGHE",24,"Gradinita de copii ""PANSELUTA"" Sfantu Gheorghe str. Romulus Cioflec, nr.14;",909,243,235,8,0,238,5,1000,757,160,78,1,6148,0
15,"Covasna",63394,145,63394,,"MUNICIPIUL SFANTU GHEORGHE",25,"Scoala cu clasele I - VIII ""GODRI FERENC"" Sfantu Gheorghe str. Elevilor, nr.1;",1412,425,417,8,0,417,8,1500,1075,284,133,1,6148,0
15,"Covasna",63394,145,63394,,"MUNICIPIUL SFANTU GHEORGHE",26,"Scoala cu clasele I - VIII ""GODRI FERENC"" Sfantu Gheorghe str. Elevilor, nr.1;",1021,301,291,10,0,298,3,1100,799,197,101,1,6148,0
15,"Covasna",63394,145,63394,,"MUNICIPIUL SFANTU GHEORGHE",27,"Grup scolar Agricol si Ind. Alimentara ""GAMAN JANOS"" Sfantu Gheorghe str. Ciucului, nr.50;",1324,400,391,9,0,393,7,1400,1000,252,141,1,6148,0
15,"Covasna",63394,145,63394,,"MUNICIPIUL SFANTU GHEORGHE",28,"Extensia Universitara Sfantu Gheorghe a UNIVERSITATII BABES - BOLYAI Cluj Napoca str. Ciucului, nr.50;",1838,604,593,11,0,590,14,1900,1296,331,259,1,6148,0
15,"Covasna",63394,145,63394,,"MUNICIPIUL SFANTU GHEORGHE",29,"Gradinita de copii ""PINOCCHIO"" Sfantu Gheorghe str. Daliei, nr.1; bloc12, sc.E, parter;",740,241,232,9,0,232,9,800,559,143,89,1,6148,0
15,"Covasna",63394,145,63394,,"MUNICIPIUL SFANTU GHEORGHE",30,"Gradinita de copii ""PINOCCHIO"" Sfantu Gheorghe str. Daliei, nr.1; bloc12, sc.E, parter;",1255,468,458,9,1,458,10,1299,831,262,196,1,6148,0
15,"Covasna",63394,145,63394,,"MUNICIPIUL SFANTU GHEORGHE",31,"Gradinita de copii ""PINOCCHIO"" Sfantu Gheorghe str. Daliei, nr.1; bloc12, sc.F, parter;",1862,658,644,14,0,642,16,1900,1242,379,263,1,6148,0
15,"Covasna",63394,145,63394,,"MUNICIPIUL SFANTU GHEORGHE",32,"Gradinita de copii ""BENEDEK ELEK"" Sfantu Gheorghe str. Oltului, nr.36 - 38;",1769,690,681,9,0,664,26,1800,1110,376,288,1,6148,0
15,"Covasna",63394,145,63394,,"MUNICIPIUL SFANTU GHEORGHE",33,"Centru de Informare pentru Cetateni Sfantu Gheorghe str.1.Decembrie 1918, bloc nr.18 sc.O, parter;",1336,464,456,8,0,454,10,1400,936,295,159,1,6148,0
15,"Covasna",63394,145,63394,,"MUNICIPIUL SFANTU GHEORGHE",34,"Grup scolar ""PUSKAS TIVADAR"" Sfantu Gheorghe str. Pescarilor, nr.35;",1631,589,583,5,1,574,15,1700,1111,306,268,1,6148,0
15,"Covasna",63394,145,63394,,"MUNICIPIUL SFANTU GHEORGHE",35,"Grup scolar ""PUSKAS TIVADAR"" Sfantu Gheorghe str. Pescarilor, nr.35;",1354,514,510,4,0,504,10,1400,886,286,218,1,6148,0
15,"Covasna",63394,145,63394,,"MUNICIPIUL SFANTU GHEORGHE",36,"Scoala cu clasele I - VIII ""NICOLAE COLAN"" Sfantu Gheorghe str. Lalelei, nr.1;",1347,487,476,11,0,483,4,1399,912,295,188,1,6148,0
15,"Covasna",63394,145,63394,,"MUNICIPIUL SFANTU GHEORGHE",37,"Scoala cu clasele I - VIII ""NICOLAE COLAN"" Sfantu Gheorghe str.Lalelei, nr.1;",1213,453,448,5,0,446,7,1300,847,265,181,1,6148,0
15,"Covasna",63394,145,63394,,"MUNICIPIUL SFANTU GHEORGHE",38,"Scoala cu clasele I - VIII ""NICOLAE COLAN"" Sfantu Gheorghe str. Lalelei, nr.1;",1079,396,388,8,0,389,7,1198,802,236,153,1,6148,0
15,"Covasna",63394,145,63394,,"MUNICIPIUL SFANTU GHEORGHE",39,"Scoala cu clasele I - VIII ""NICOLAE COLAN"" Sfantu Gheorghe str. Lalelei, nr.1;",1432,499,495,4,0,488,11,1500,1001,300,188,1,6148,0
15,"Covasna",63394,145,63394,,"MUNICIPIUL SFANTU GHEORGHE",40,"Strand Municipal Sfantu Gheorghe str. Sporturilor, nr.2;",1342,514,503,11,0,506,8,1399,885,290,216,1,6148,0
15,"Covasna",63394,145,63394,,"MUNICIPIUL SFANTU GHEORGHE",41,"Strand Municipal Sfantu Gheorghe str. Sporturilor, nr.2;",1242,401,393,8,0,398,3,1300,899,235,163,1,6148,0
15,"Covasna",63394,145,63394,,"MUNICIPIUL SFANTU GHEORGHE",42,"Scoala cu clasele I - VIII ""ADY ENDRE"" Sfantu Gheorghe str. Armata Romana, nr.25;",886,391,381,10,0,381,10,1000,609,219,162,1,6148,0
15,"Covasna",63394,145,63394,,"MUNICIPIUL SFANTU GHEORGHE",43,"Scoala cu clasele I - VIII ""ADY ENDRE"" Sfantu Gheorghe str. Armata Romana, nr.25;",914,303,292,11,0,299,4,1000,697,170,129,1,6148,0
15,"Covasna",63394,145,63394,,"MUNICIPIUL SFANTU GHEORGHE",44,"Scoala cu clasele I - VIII ""ADY ENDRE"" Sfantu Gheorghe str. Armata Romana, nr.25;",1324,474,466,7,1,471,3,1400,926,294,177,1,6148,0
15,"Covasna",63394,145,63394,,"MUNICIPIUL SFANTU GHEORGHE",45,"Gradinita de copii cu program normal NR.9 Sfantu Gheorghe str. Armata Romana, nr.23;",1180,408,401,7,0,405,3,1300,892,264,141,1,6148,0
15,"Covasna",63394,145,63394,,"MUNICIPIUL SFANTU GHEORGHE",46,"Gradinita de copii cu program prelungit ""NAPSUGAR"" Sfantu Gheorghe str. Armata Romana, nr.23;",1234,418,408,10,0,417,1,1300,882,224,193,1,6148,0
15,"Covasna",63394,145,63394,,"MUNICIPIUL SFANTU GHEORGHE",47,"Scoala generala CAMPUL FRUMOS",365,169,160,9,0,169,0,400,231,139,30,1,6148,0
15,"Covasna",63394,145,63394,,"MUNICIPIUL SFANTU GHEORGHE",48,"Camin Cultural CHILIENI",629,237,228,9,0,229,8,700,463,150,79,1,6148,0
15,"Covasna",63394,145,63394,,"MUNICIPIUL SFANTU GHEORGHE",49,"Camin Cultural COSENI",427,143,136,7,0,143,0,500,357,107,36,1,6148,0
15,"Covasna",63394,145,63394,,"MUNICIPIUL SFANTU GHEORGHE",50,"Gara C.F.R. - Sala de asteptare cl. I Mun. Sfantu Gheorghe str. Garii nr. 1",0,388,0,388,0,384,4,600,212,203,181,1,6148,1
15,"Covasna",63394,145,63394,,"MUNICIPIUL SFANTU GHEORGHE",51,"Spitalul Judetean Fogolyan Kristof - Cantina Mun. Sfantu Gheorghe str. Stadionului nr. 1-3",0,118,0,118,0,115,3,400,282,70,45,1,6148,1
15,"Covasna",63740,145,63740,,"MUNICIPIUL TARGU SECUIESC",52,"Casa municipala de cultura ""Vigado"" P-ta Gabor Aron nr. 21",1320,456,446,10,0,449,7,1400,944,310,139,1,6152,0
15,"Covasna",63740,145,63740,,"MUNICIPIUL TARGU SECUIESC",53,"Liceul ""Nagy Mozes"" Str. Kanta nr. 23",1078,271,265,6,0,263,8,1200,929,167,96,1,6152,0
15,"Covasna",63740,145,63740,,"MUNICIPIUL TARGU SECUIESC",54,"Liceul Bod Peter Strada Ady Endre nr. 20",1323,422,417,5,0,416,6,1400,978,224,192,1,6152,0
15,"Covasna",63740,145,63740,,"MUNICIPIUL TARGU SECUIESC",55,"Liceul Reformat Str. Ady Endre nr. 9",1396,404,396,8,0,401,3,1500,1096,260,141,1,6152,0
15,"Covasna",63740,145,63740,,"MUNICIPIUL TARGU SECUIESC",56,"Gradinita de copii ""Benedek Elek"" Str. Dozsa Gyorgy nr. 8",1478,462,456,6,0,456,6,1600,1138,306,150,1,6152,0
15,"Covasna",63740,145,63740,,"MUNICIPIUL TARGU SECUIESC",57,"Scoala Generala ""Petofi Sandor"" Str. Stadionului fn.",1400,432,422,10,0,428,4,1499,1067,289,139,1,6152,0
15,"Covasna",63740,145,63740,,"MUNICIPIUL TARGU SECUIESC",58,"Gradinita de copii ""Csipkerozsika"" Str. Rozelor nr. 4",1485,490,482,8,0,472,18,1599,1109,312,160,1,6152,0
15,"Covasna",63740,145,63740,,"MUNICIPIUL TARGU SECUIESC",59,"Scoala Generala ""Turoczi Mozes"" Str. Noua nr. 1",1443,438,427,11,0,434,4,1500,1062,280,154,1,6152,0
15,"Covasna",63740,145,63740,,"MUNICIPIUL TARGU SECUIESC",60,"Gradinita de copii ""Manocska"" Str. Gradinitei nr. 1",1459,439,429,10,0,431,8,1600,1161,323,108,1,6152,0
15,"Covasna",63740,145,63740,,"MUNICIPIUL TARGU SECUIESC",61,"Gradinita de copii cu program normal nr. 3 Str. Achim Andrei",965,329,321,8,0,325,4,1000,671,219,106,1,6152,0
15,"Covasna",63740,145,63740,,"MUNICIPIUL TARGU SECUIESC",62,"Grupul scolar ""Gabor Aron"" Str. Fabricii nr. 8",1218,379,368,11,0,376,3,1300,921,255,121,1,6152,0
15,"Covasna",63740,145,63740,,"MUNICIPIUL TARGU SECUIESC",63,"Scoala Generala ""Molnar Jozsias"" Str. Nemere nr. 2",1281,426,417,9,0,424,2,1400,974,254,170,1,6152,0
15,"Covasna",63740,145,63740,,"MUNICIPIUL TARGU SECUIESC",64,"Scoala primara Ruseni Str. Bem Jozsef nr. 83",445,123,116,7,0,122,1,500,377,80,42,1,6152,0
15,"Covasna",63740,145,63740,,"MUNICIPIUL TARGU SECUIESC",65,"Scoala primara Tinoasa ,Tinoasa nr. 657",288,100,87,13,0,97,3,300,200,74,23,1,6152,0
15,"Covasna",63740,145,63740,,"MUNICIPIUL TARGU SECUIESC",66,"Scoala Generala ""Jakabos Odon"" Lunga nr. 360",1008,244,237,7,0,235,9,1100,856,138,97,1,6152,0
15,"Covasna",63740,145,63740,,"MUNICIPIUL TARGU SECUIESC",67,"Sediul Primariei, cam. 2 (parter) Mun. Targu Secuiesc Piata Gabor Aron nr. 24",0,107,0,107,0,105,2,500,393,65,40,1,6152,1
15,"Covasna",63447,145,63447,,"ORAS BARAOLT",68,"Primaria str. Libertatii nr. 2",1235,386,377,9,0,381,5,1300,914,219,162,1,6155,0
15,"Covasna",63447,145,63447,,"ORAS BARAOLT",69,"Casa de Cultura str. Kossuth Lajos nr. 129",1195,379,372,7,0,371,8,1299,920,199,172,1,6155,0
15,"Covasna",63447,145,63447,,"ORAS BARAOLT",70,"Scoala cu clasele I-VIII Gaal Mozes Baraolt-Diakdomb str. Kossuth Lajos nr. 144",1243,428,418,10,0,419,9,1300,872,271,148,1,6155,0
15,"Covasna",63447,145,63447,,"ORAS BARAOLT",71,"Gradinita de copii Calea Trandafirilor bl. 3A",1182,415,409,5,1,413,2,1300,885,237,176,1,6155,0
15,"Covasna",63447,145,63447,,"ORAS BARAOLT",72,"Caminul Cultural Biborteni  nr. 30",622,217,209,8,0,213,4,701,484,124,89,1,6155,0
15,"Covasna",63447,145,63447,,"ORAS BARAOLT",73,"Caminul Cultural Bodos nr. 106",339,133,125,8,0,130,3,400,267,86,44,1,6155,0
15,"Covasna",63447,145,63447,,"ORAS BARAOLT",74,"Caminul Cultural Capeni nr. 345",958,279,273,6,0,275,4,1000,721,186,89,1,6155,0
15,"Covasna",63447,145,63447,,"ORAS BARAOLT",75,"Gradinita de copii Miclosoara nr. 90",388,168,162,6,0,165,3,500,332,118,47,1,6155,0
15,"Covasna",63447,145,63447,,"ORAS BARAOLT",76,"Caminul Cultural Racosul de Sus nr. 100",766,230,222,8,0,227,3,799,569,114,113,1,6155,0
15,"Covasna",63447,145,63447,,"ORAS BARAOLT",77,"Gradinita de copii, orasul Baraolt calea Trandafirilor nr. 3A",0,44,0,44,0,44,0,300,256,19,25,1,6155,1
15,"Covasna",63526,145,63526,,"ORAS COVASNA",78,"Casa de Cultura Chiurus",365,179,173,6,0,175,4,400,221,141,34,1,6162,0
15,"Covasna",63526,145,63526,,"ORAS COVASNA",79,"Gradinita de copii str. Gabor Aron nr. 1/A",1358,492,484,8,0,484,8,1500,1008,335,149,1,6162,0
15,"Covasna",63526,145,63526,,"ORAS COVASNA",80,"Clubul orasenesc str. 1 Decembrie 1918 nr. 1",1391,502,489,13,0,492,10,1500,998,362,130,1,6162,0
15,"Covasna",63526,145,63526,,"ORAS COVASNA",81,"Liceul KOROSI CSOMA SANDOR Corp A str. Stefan cel Mare nr. 40",1202,466,454,12,0,459,7,1300,834,351,108,1,6162,0
15,"Covasna",63526,145,63526,,"ORAS COVASNA",82,"Liceul KOROSI CSOMA SANDOR Corp B str. Stefan cel Mare nr. 40",1337,558,549,9,0,547,11,1400,842,389,158,1,6162,0
15,"Covasna",63526,145,63526,,"ORAS COVASNA",83,"Internat Liceul KOROSI CSOMA SANDOR str. Stefan cel Mare nr. 100",1660,685,679,6,0,676,9,1800,1115,526,150,1,6162,0
15,"Covasna",63526,145,63526,,"ORAS COVASNA",84,"Scoala generala AVRAM IANCU str. Piata Eroilor nr. 4",1262,576,567,9,0,570,6,1400,824,369,201,1,6162,0
15,"Covasna",63526,145,63526,,"ORAS COVASNA",85,"Scoala generala AVRAM IANCU str. Mihai Eminescu nr. 15",1157,638,631,7,0,633,5,1200,562,392,241,1,6162,0
15,"Covasna",63526,145,63526,,"ORAS COVASNA",86,"Hotel Cerbul Orasul Covasna str. 1 Decembrie 1918 nr. 2/A",0,228,0,228,0,225,3,600,372,126,99,1,6162,1
15,"Covasna",63526,145,63526,,"ORAS COVASNA",87,"Hotel Dacia Orasul Covasna str. Unirii nr. 10",0,653,0,653,0,645,8,1000,347,300,345,1,6162,1
15,"Covasna",63526,145,63526,,"ORAS COVASNA",88,"Spital Cardiovascular Orasul Covasna str. Mihai Eminescu nr. 160",0,454,0,454,0,444,10,1000,546,187,257,1,6162,1
15,"Covasna",63580,145,63580,,"ORAS INTORSURA BUZAULUI",89,"Scoala generala nr. 1 Intorsura Buzaului  str. Mihai Viteazul nr. 188",1833,810,803,7,0,807,3,1900,1090,382,425,1,6165,0
15,"Covasna",63580,145,63580,,"ORAS INTORSURA BUZAULUI",90,"Casa de Cultura Intorsura Buzaului str. Mihai Viteazul nr. 169",1485,628,622,6,0,624,4,1600,972,295,329,1,6165,0
15,"Covasna",63580,145,63580,,"ORAS INTORSURA BUZAULUI",91,"Districtul DN  str. Mihai Viteazul nr. 223",1817,871,865,6,0,868,3,1900,1029,433,435,1,6165,0
15,"Covasna",63580,145,63580,,"ORAS INTORSURA BUZAULUI",92,"Caminul Cultural Bradet",951,436,427,9,0,434,2,999,563,217,217,1,6165,0
15,"Covasna",63580,145,63580,,"ORAS INTORSURA BUZAULUI",93,"Caminul Cultural Floroaia",1139,537,528,9,0,534,3,1200,663,270,264,1,6165,0
15,"Covasna",63580,145,63580,,"ORAS INTORSURA BUZAULUI",94,"Gara C.F.R.  Intorsura Buzaului str. 1 Decembrie 1918 nr. 4",0,132,0,132,0,130,2,300,168,65,65,1,6165,1
15,"Covasna",63777,145,63777,,"AITA MARE",95,"Sediul Primariei comunei Aita Mare nr. 206",752,254,248,6,0,249,5,800,546,168,81,3,6170,0
15,"Covasna",63777,145,63777,,"AITA MARE",96,"Caminul Cultural Aita Medie nr. 326",612,234,228,6,0,233,1,700,466,165,68,3,6170,0
15,"Covasna",63777,145,63777,,"AITA MARE",97,"Scolala cu clasele I-VIII Kriza Janos Aita Mare nr. 170",0,32,0,32,0,29,3,100,68,16,13,3,6170,1
15,"Covasna",65113,145,65113,,"ARCUS",98,"Sediul Primariei comunei Arcus sala de sedinta, P-ta Gabor aron nr. 237",1159,363,356,7,0,346,17,1300,937,191,155,3,6173,0
15,"Covasna",65113,145,65113,,"ARCUS",99,"Sediul Primariei comunei Arcus P-ta Gabor aron nr. 237",0,31,0,31,0,31,0,100,69,8,23,3,6173,1
15,"Covasna",63633,145,63633,,"BARCANI",100,"Caminul Cultural  Barcani",981,487,482,4,1,482,5,1100,613,208,274,3,6175,0
15,"Covasna",63633,145,63633,,"BARCANI",101,"Caminul Cultural  Barcani",1100,390,386,4,0,389,1,1100,710,144,245,3,6175,0
15,"Covasna",63633,145,63633,,"BARCANI",102,"Scoala generala Ladauti",525,233,219,14,0,233,0,600,367,62,171,3,6175,0
15,"Covasna",63633,145,63633,,"BARCANI",103,"Scoala generala Saramas",541,272,262,10,0,269,3,600,328,97,172,3,6175,0
15,"Covasna",63633,145,63633,,"BARCANI",104,"Primaria comunei Barcani nr. 266",0,36,0,36,0,36,0,100,64,13,23,3,6175,1
15,"Covasna",63802,145,63802,,"BATANI",105,"Cladirea Primariei  Batanii Mari nr. 474",1628,592,588,4,0,574,18,1700,1108,447,127,3,6179,0
15,"Covasna",63802,145,63802,,"BATANI",106,"Caminul Cultural Batanii Mici nr. 174",432,157,147,10,0,142,15,500,343,116,26,3,6179,0
15,"Covasna",63802,145,63802,,"BATANI",107,"Cladirea de deplasare al Primariei in Herculian nr. 58",843,274,267,7,0,265,9,1000,726,193,72,3,6179,0
15,"Covasna",63802,145,63802,,"BATANI",108,"Cladirea de deplasare al Primariei in Aita Seaca nr. 440",608,216,210,6,0,212,4,700,484,146,66,3,6179,0
15,"Covasna",63802,145,63802,,"BATANI",109,"Sediul Primariei Biroul - fond funciar Batanii Mari str. Principala nr. 474",0,49,0,49,0,49,0,200,151,34,15,3,6179,1
15,"Covasna",63866,145,63866,,"BELIN",110,"Cladirea Primariei Belin nr. 390",1118,384,378,6,0,378,6,1200,816,265,113,3,6185,0
15,"Covasna",63866,145,63866,,"BELIN",111,"Scolala cu clasele I-IV Belin Vale nr. 174",873,474,462,12,0,447,27,1000,526,329,118,3,6185,0
15,"Covasna",63866,145,63866,,"BELIN",112,"Scoala cu clasele I-VIII Boloni Farkas Sandor Belin str. Principala nr. 378",0,45,0,45,0,44,1,200,155,22,22,3,6185,1
15,"Covasna",65121,145,65121,,"BIXAD",113,"Caminul Cultural din Bixad",1495,428,427,1,0,425,3,1600,1172,284,141,3,6188,0
15,"Covasna",65121,145,65121,,"BIXAD",114,"Gradinita Abraham Arpad Bixad str. Principala nr. 406",0,25,0,25,0,25,0,100,75,14,11,3,6188,1
15,"Covasna",63893,145,63893,,"BODOC",115,"Caminul Cultural din Bodoc",967,354,350,4,0,346,8,1100,746,208,138,3,6190,0
15,"Covasna",63893,145,63893,,"BODOC",116,"Caminul Cultural din Zalan",482,120,113,7,0,116,4,500,380,82,34,3,6190,0
15,"Covasna",63893,145,63893,,"BODOC",117,"Imobilul Primariei din Olteni nr. 37",517,241,235,6,0,226,15,600,359,123,103,3,6190,0
15,"Covasna",63893,145,63893,,"BODOC",118,"Caminul Cultural Bodoc nr. 148",0,21,0,21,0,20,1,100,79,9,11,3,6190,1
15,"Covasna",63937,145,63937,,"BOROSNEU MARE",119,"Cladirea Consiliului local Borosneu Mare nr. 393",1230,323,320,3,0,307,16,1300,977,181,126,3,6194,0
15,"Covasna",63937,145,63937,,"BOROSNEU MARE",120,"Scoala generala Borosneu Mic nr. 122",331,112,105,7,0,108,4,400,288,62,46,3,6194,0
15,"Covasna",63937,145,63937,,"BOROSNEU MARE",121,"Caminul Cultural Dobolii de Sus nr. 23",176,82,76,6,0,79,3,200,118,35,44,3,6194,0
15,"Covasna",63937,145,63937,,"BOROSNEU MARE",122,"Scolala generala Let nr. 83",507,110,101,9,0,102,8,600,490,59,43,3,6194,0
15,"Covasna",63937,145,63937,,"BOROSNEU MARE",123,"Caminul Cultural Tufalau nr. 54",174,89,80,9,0,87,2,200,111,54,33,3,6194,0
15,"Covasna",63937,145,63937,,"BOROSNEU MARE",124,"Sediul Primariei comunei Borosneu Mare nr. 393",0,32,0,32,0,32,0,200,168,19,13,3,6194,1
15,"Covasna",64005,145,64005,,"BRATES",125,"Cantina fostei C.A.P. Brates nr. 31",492,234,217,8,9,233,1,600,366,170,63,3,6206,0
15,"Covasna",64005,145,64005,,"BRATES",126,"Caminul Cultural Telechia",487,167,158,9,0,160,7,502,335,124,36,3,6206,0
15,"Covasna",64005,145,64005,,"BRATES",127,"Caminul Cultural Pachia",265,130,124,0,6,127,3,300,170,98,29,3,6206,0
15,"Covasna",64005,145,64005,,"BRATES",128,"Cantina fostei C.A.P. Brates nr. 31",0,27,0,27,0,27,0,200,173,15,12,3,6206,1
15,"Covasna",64041,145,64041,,"BRADUT",129,"Clubul Caminului Cultural din Bradut",767,233,228,5,0,225,8,900,667,126,99,3,6201,0
15,"Covasna",64041,145,64041,,"BRADUT",130,"Caminul Cultural din Talisoara",626,250,250,0,0,246,4,700,450,88,158,3,6201,0
15,"Covasna",64041,145,64041,,"BRADUT",131,"Clubul Caminului Cultural din Doboseni",1198,468,457,11,0,451,17,1300,832,266,185,3,6201,0
15,"Covasna",64041,145,64041,,"BRADUT",132,"Clubul Caminului Cultural din Filia",1006,500,493,7,0,494,6,1100,600,193,301,3,6201,0
15,"Covasna",64041,145,64041,,"BRADUT",133,"Caminul Cultural Bradut str. Scolii nr. 149",0,14,0,14,0,14,0,200,186,7,7,3,6201,1
15,"Covasna",64096,145,64096,,"BRETCU",134,"Centrul Cultural Bretcu",1281,425,419,6,0,417,8,1400,975,227,190,3,6210,0
15,"Covasna",64096,145,64096,,"BRETCU",135,"Centrul Cultural Bretcu",876,298,294,4,0,285,13,1000,702,128,157,3,6210,0
15,"Covasna",64096,145,64096,,"BRETCU",136,"Scoala cu clasele I-IV  Martanus",638,269,261,6,2,265,4,700,431,185,80,3,6210,0
15,"Covasna",64096,145,64096,,"BRETCU",137,"Scoala cu clasele I-VIII Oituz",267,110,101,9,0,108,2,300,190,81,27,3,6210,0
15,"Covasna",64096,145,64096,,"BRETCU",138,"Sediul Primariei comunei Bretcu str. Principala nr. 142",0,54,0,54,0,53,1,200,146,32,21,3,6210,1
15,"Covasna",64130,145,64130,,"CATALINA",139,"Caminul Cultural Catalina nr. 216",1179,389,382,7,0,381,8,1300,911,273,108,3,6214,0
15,"Covasna",64130,145,64130,,"CATALINA",140,"Caminul Cultural Imeni",260,106,97,9,0,104,2,300,194,63,41,3,6214,0
15,"Covasna",64130,145,64130,,"CATALINA",141,"Caminul Cultural Hatiuca",375,176,169,7,0,172,4,400,224,101,71,3,6214,0
15,"Covasna",64130,145,64130,,"CATALINA",142,"Caminul Cultural Martineni",484,182,174,8,0,175,7,500,318,110,65,3,6214,0
15,"Covasna",64130,145,64130,,"CATALINA",143,"Caminul Cultural Marcusa",527,160,150,10,0,158,2,600,440,120,38,3,6214,0
15,"Covasna",64130,145,64130,,"CATALINA",144,"Clubul Tineresc Caminul Cultural Catalina nr. 216",0,19,0,19,0,19,0,201,182,13,6,3,6214,1
15,"Covasna",64194,145,64194,,"CERNAT",145,"Scoala cu clasele I-IV nr. 3 Cernat nr. 60",651,177,170,7,0,176,1,700,523,127,49,3,6220,0
15,"Covasna",64194,145,64194,,"CERNAT",146,"Scoala cu clasele I-VIII Vegh Antal Cernat nr. 462",1163,302,292,10,0,294,8,1300,998,151,143,3,6220,0
15,"Covasna",64194,145,64194,,"CERNAT",147,"Scoala cu clasele I-VIII Bod Peter Cernat nr. 1081",942,275,269,6,0,270,5,1000,725,127,143,3,6220,0
15,"Covasna",64194,145,64194,,"CERNAT",148,"Cladirea Consiliului Local Cernat, Albis nr. 43",339,67,59,8,0,63,4,400,333,42,21,3,6220,0
15,"Covasna",64194,145,64194,,"CERNAT",149,"Caminul Cultural Icafalau nr. 147",231,90,85,5,0,86,4,300,210,38,48,3,6220,0
15,"Covasna",64194,145,64194,,"CERNAT",150,"Sediul Primariei Cernat nr. 456",0,13,0,13,0,13,0,200,187,4,9,3,6220,1
15,"Covasna",64238,145,64238,,"CHICHIS",151,"Caminul Cultural Chichis",854,363,357,6,0,352,11,1000,637,239,113,3,6224,0
15,"Covasna",64238,145,64238,,"CHICHIS",152,"Gradinita de copii Bacel",469,182,174,8,0,180,2,500,318,125,55,3,6224,0
15,"Covasna",64238,145,64238,,"CHICHIS",153,"Sala de sedinta a Primariei Chichis nr. 103",0,24,0,24,0,24,0,100,76,19,5,3,6224,1
15,"Covasna",63553,145,63553,,"COMANDAU",154,"Sediul primariei Comandau",860,360,360,0,0,358,2,1000,640,264,94,3,6227,0
15,"Covasna",63553,145,63553,,"COMANDAU",155,"Caminul Cultural Comandau",0,21,0,21,0,21,0,100,79,17,4,3,6227,1
15,"Covasna",65147,145,65147,,"DALNIC",156,"Sala de sedinta Primaria Dalnic nr. 45",803,192,185,7,0,182,10,900,708,107,75,3,6229,0
15,"Covasna",65147,145,65147,,"DALNIC",157,"Scolala generala I-VIII Darko Jeno Dalnic str. Principala nr. 229",0,17,0,17,0,15,2,100,83,9,6,3,6229,1
15,"Covasna",64265,145,64265,,"DOBARLAU",158,"Caminul Cultural din Dobarlau",854,344,338,5,1,340,4,1000,656,182,158,3,6231,0
15,"Covasna",64265,145,64265,,"DOBARLAU",159,"Scoala generala Valea Dobarlaului",243,133,125,8,0,133,0,300,167,99,34,3,6231,0
15,"Covasna",64265,145,64265,,"DOBARLAU",160,"Scoala generala Marcus",354,178,173,5,0,178,0,400,222,117,61,3,6231,0
15,"Covasna",64265,145,64265,,"DOBARLAU",161,"Scoala generala Lunca Marcusului",301,143,135,8,0,141,2,399,256,84,57,3,6231,0
15,"Covasna",64265,145,64265,,"DOBARLAU",162,"Gradinita Dobarlau nr. 235",0,87,0,87,0,85,2,200,113,41,44,3,6231,1
15,"Covasna",65154,145,65154,,"ESTELNIC",163,"Cladirea Primariei Estelnic str. Principala nr. 175",684,319,293,7,19,308,11,800,481,123,185,3,6236,0
15,"Covasna",65154,145,65154,,"ESTELNIC",164,"Caminul Cultural din Valea Scurta nr. 135",220,168,153,8,7,165,3,300,132,35,130,3,6236,0
15,"Covasna",65154,145,65154,,"ESTELNIC",165,"Scoala cu clasele I-VIII Estelnic, corp II nr. 165",0,28,0,28,0,28,0,100,72,9,19,3,6236,1
15,"Covasna",64318,145,64318,,"GHELINTA",166,"Caminul Cultural Ghelinta nr. 738",1569,404,404,0,0,396,8,1700,1296,230,166,3,6240,0
15,"Covasna",64318,145,64318,,"GHELINTA",167,"Scoala cu clasele I-VIII Jancso Benedek Ghelinta",1057,249,237,12,0,241,8,1100,851,144,97,3,6240,0
15,"Covasna",64318,145,64318,,"GHELINTA",168,"Scoala generala nr. 2 cu clasele I-IV Ghelinta",1106,240,230,10,0,226,14,1200,960,147,79,3,6240,0
15,"Covasna",64318,145,64318,,"GHELINTA",169,"Scoala cu clasele I-IV Harale",205,104,98,6,0,98,6,300,196,40,58,3,6240,0
15,"Covasna",64318,145,64318,,"GHELINTA",170,"Caminul Cultural Ghelinta nr. 738",0,26,0,26,0,26,0,100,74,12,14,3,6240,1
15,"Covasna",64345,145,64345,,"GHIDFALAU",171,"Cladire aflata in domeniul public al comunei Ghidfalau, sat Anghelus nr. 142A",557,166,160,6,0,159,7,600,434,102,57,3,6243,0
15,"Covasna",64345,145,64345,,"GHIDFALAU",172,"Caminul Cultural din satul Fotos nr. 63A",299,82,76,6,0,81,1,400,318,51,30,3,6243,0
15,"Covasna",64345,145,64345,,"GHIDFALAU",173,"Caminul Cultural din satul Ghidfalau nr. 109",905,267,260,7,0,256,11,997,730,194,62,3,6243,0
15,"Covasna",64345,145,64345,,"GHIDFALAU",174,"Cladire aflata in domeniul privat al comunei Ghidfalau, sat Zoltan nr. 94",331,180,174,6,0,176,4,400,220,127,49,3,6243,0
15,"Covasna",64345,145,64345,,"GHIDFALAU",175,"Scoala generala Czetcz Janos cu clasele I-VIII, Ghidfalau nr. 105",0,20,0,20,0,19,1,100,80,11,8,3,6243,1
15,"Covasna",64390,145,64390,,"HAGHIG",176,"Caminul Cultural Haghig",1301,528,528,0,0,523,5,1400,872,301,222,3,6248,0
15,"Covasna",64390,145,64390,,"HAGHIG",177,"Scoala generala Iaras",359,168,159,8,1,164,4,400,232,122,42,3,6248,0
15,"Covasna",64390,145,64390,,"HAGHIG",178,"Sala de sedinta a Caminul Cultural Haghig nr. 259",0,84,0,84,0,82,2,200,116,38,44,3,6248,1
15,"Covasna",64425,145,64425,,"ILIENI",179,"Caminul Cultural al comunei Ilieni",846,322,317,5,0,314,8,1000,678,203,111,3,6251,0
15,"Covasna",64425,145,64425,,"ILIENI",180,"Scoala generala al satului Sancraiu",259,125,115,10,0,119,6,300,175,77,42,3,6251,0
15,"Covasna",64425,145,64425,,"ILIENI",181,"Scoala generala al satului Dobolii de Jos",464,185,177,8,0,184,1,500,315,127,57,3,6251,0
15,"Covasna",64425,145,64425,,"ILIENI",182,"Scoala generala Laszlo Lukacs din Ilieni str. Kossuth Lajos nr.96",0,29,0,29,0,29,0,200,171,20,9,3,6251,1
15,"Covasna",64461,145,64461,,"LEMNIA",183,"Primaria Lemnia sala de sedinta",712,212,208,4,0,204,8,800,588,117,87,3,6255,0
15,"Covasna",64461,145,64461,,"LEMNIA",184,"Scoala generala nr. 2 Lemnia",905,269,260,9,0,255,14,1000,731,160,95,3,6255,0
15,"Covasna",64461,145,64461,,"LEMNIA",185,"Sediul Primariei comunei Lemnia",0,30,0,30,0,29,1,100,70,16,13,3,6255,1
15,"Covasna",64504,145,64504,,"MALNAS",186,"Caminul Cultural Malnas str. Principala nr. 30",448,174,166,8,0,168,6,500,326,109,59,3,6257,0
15,"Covasna",64504,145,64504,,"MALNAS",187,"Scoala generala cu clasele I-IV Malnas Bai nr. 32",367,124,112,12,0,123,1,400,276,74,49,3,6257,0
15,"Covasna",64504,145,64504,,"MALNAS",188,"Scoala generala cu clasele I-IV Valea Zalanului nr. 22",113,44,38,6,0,43,1,200,156,6,37,3,6257,0
15,"Covasna",64504,145,64504,,"MALNAS",189,"Cladirea Caminului Cultural Corpul A localitatea Malnas str. Principala nr. 30",0,12,0,12,0,12,0,200,188,5,7,3,6257,1
15,"Covasna",65105,145,65105,,"MERENI",190,"Caminul Cultural Mereni",757,297,280,9,8,290,7,800,503,123,167,3,6261,0
15,"Covasna",65105,145,65105,,"MERENI",191,"Caminul Cultural Lutoasa",366,124,112,8,4,118,6,400,276,59,59,3,6261,0
15,"Covasna",65105,145,65105,,"MERENI",192,"Sediul Primariei comunei Mereni nr. 250",0,26,0,26,0,26,0,100,74,13,13,3,6261,1
15,"Covasna",65139,145,65139,,"MICFALAU",193,"Primaria comunei Micfalau",1541,386,381,5,0,375,11,1600,1214,186,189,3,6264,0
15,"Covasna",65139,145,65139,,"MICFALAU",194,"Caminul Cultural Sala de Protocol  Micfalau nr. 299",0,27,0,27,0,27,0,100,73,11,16,3,6264,1
15,"Covasna",64568,145,64568,,"MOACSA",195,"Sediul primariei - sala de sedinta Moacsa nr. 354",564,186,177,0,9,185,1,600,414,133,52,3,6266,0
15,"Covasna",64568,145,64568,,"MOACSA",196,"Scoala generala cu clasele I-IV Moacsa nr. 357",165,74,65,9,0,72,2,200,126,56,16,3,6266,0
15,"Covasna",64568,145,64568,,"MOACSA",197,"Caminul Cultural Padureni nr. 2",258,115,92,9,14,111,4,300,185,85,26,3,6266,0
15,"Covasna",64568,145,64568,,"MOACSA",198,"Sediul Primariei comunei Moacsa nr. 354",0,38,0,38,0,36,2,100,62,24,12,3,6266,1
15,"Covasna",64602,145,64602,,"OJDULA",199,"Caminul Cultural ''Zsogon Zoltan'' Ojdula",1336,326,323,3,0,314,12,1400,1074,250,64,3,6269,0
15,"Covasna",64602,145,64602,,"OJDULA",200,"Scoala generala ''Kun Kocsard'' Ojdula",1326,491,491,0,0,485,6,1400,909,334,151,3,6269,0
15,"Covasna",64602,145,64602,,"OJDULA",201,"Caminul Cultural Hilib",222,111,102,9,0,110,1,300,189,86,24,3,6269,0
15,"Covasna",64602,145,64602,,"OJDULA",202,"Primaria Ojdula nr. 1008",0,43,0,43,0,42,1,200,157,22,20,3,6269,1
15,"Covasna",64639,145,64639,,"OZUN",203,"Caminul Cultural Ozun",1076,281,275,6,0,269,12,1200,919,193,76,3,6272,0
15,"Covasna",64639,145,64639,,"OZUN",204,"Centrul de informare asupra U.E.",1264,467,460,7,0,461,6,1400,933,347,114,3,6272,0
15,"Covasna",64639,145,64639,,"OZUN",205,"Scoala generala Sintionlunca",643,228,220,8,0,214,14,700,472,141,73,3,6272,0
15,"Covasna",64639,145,64639,,"OZUN",206,"Caminul Cultural  Lisnau",505,161,152,9,0,158,3,600,439,118,40,3,6272,0
15,"Covasna",64639,145,64639,,"OZUN",207,"Caminul Cultural  Bicfalau",308,133,124,9,0,132,1,400,267,92,40,3,6272,0
15,"Covasna",64639,145,64639,,"OZUN",208,"Gara C.F.R. Ozun nr. 229",0,47,0,47,0,47,0,200,153,32,15,3,6272,1
15,"Covasna",64719,145,64719,,"POIAN",209,"Sala de Protocol al Primariei Poian nr. 10",1064,250,244,6,0,242,8,1200,950,108,134,3,6280,0
15,"Covasna",64719,145,64719,,"POIAN",210,"Scoala generala Belani nr.10",393,142,134,8,0,140,2,500,358,58,82,3,6280,0
15,"Covasna",64719,145,64719,,"POIAN",211,"Sediul Primariei Poian str. Principala nr. 10",0,18,0,18,0,18,0,100,82,10,8,3,6280,1
15,"Covasna",64773,145,64773,,"RECI",212,"Caminul Cultural Reci",1143,221,216,5,0,212,9,1200,979,147,65,3,6283,0
15,"Covasna",64773,145,64773,,"RECI",213,"Scoala cu clasele I-IV Aninoasa",345,89,82,7,0,83,6,400,311,46,37,3,6283,0
15,"Covasna",64773,145,64773,,"RECI",214,"Scoala cu clasele I-IV Bita",247,83,78,5,0,82,1,300,217,38,44,3,6283,0
15,"Covasna",64773,145,64773,,"RECI",215,"Caminul Cultural Saciova",105,55,47,8,0,54,1,200,145,26,28,3,6283,0
15,"Covasna",64773,145,64773,,"RECI",216,"Biblioteca comunala Reci str. Principala nr. 268",0,21,0,21,0,21,0,200,179,13,8,3,6283,1
15,"Covasna",64826,145,64826,,"SANZIENI",217,"Sala de sedinte a Consiliului local Sanzieni",1277,314,305,9,0,310,4,1400,1086,150,160,3,6288,0
15,"Covasna",64826,145,64826,,"SANZIENI",218,"Clubul Caminului Cultural Sanzieni nr. 342",1012,294,293,1,0,286,8,1100,806,144,142,3,6288,0
15,"Covasna",64826,145,64826,,"SANZIENI",219,"Caminul Cultural Casinu Mic",233,97,88,9,0,97,0,300,203,51,46,3,6288,0
15,"Covasna",64826,145,64826,,"SANZIENI",220,"Caminul Cultural Petriceni nr. 315",759,210,203,7,0,207,3,800,590,93,114,3,6288,0
15,"Covasna",64826,145,64826,,"SANZIENI",221,"Caminul Cultural Valea Seaca nr. 19",524,156,151,5,0,148,8,600,444,74,74,3,6288,0
15,"Covasna",64826,145,64826,,"SANZIENI",222,"Caminului Cultural Sanzieni str. Principala nr. 342",0,22,0,22,0,21,1,200,178,10,11,3,6288,1
15,"Covasna",63688,145,63688,,"SITA BUZAULUI",223,"Primaria Sita Buzaului",1234,609,602,6,1,606,3,1300,691,264,342,3,6293,0
15,"Covasna",63688,145,63688,,"SITA BUZAULUI",224,"Scoala generala nr. 2 Ciumernic",809,392,380,12,0,388,4,900,508,206,182,3,6293,0
15,"Covasna",63688,145,63688,,"SITA BUZAULUI",225,"Scoala generala nr. 3 Bobocea",863,446,436,8,2,444,2,995,549,189,255,3,6293,0
15,"Covasna",63688,145,63688,,"SITA BUZAULUI",226,"Scoala generala Zabratau",452,203,198,5,0,202,1,502,299,108,94,3,6293,0
15,"Covasna",63688,145,63688,,"SITA BUZAULUI",227,"Scoala generala Crasna",433,194,187,7,0,194,0,500,306,86,108,3,6293,0
15,"Covasna",63688,145,63688,,"SITA BUZAULUI",228,"Sediuln Primariei Sita Buzaului nr. 222",0,45,0,45,0,44,1,100,55,26,18,3,6293,1
15,"Covasna",64871,145,64871,,"TURIA",229,"Caminul Cultural Turia nr. 835",1716,417,411,6,0,406,11,1800,1383,209,197,3,6298,0
15,"Covasna",64871,145,64871,,"TURIA",230,"Scoala generala Turia de Sus nr. 694",1212,270,262,8,0,253,17,1300,1030,100,153,3,6298,0
15,"Covasna",64871,145,64871,,"TURIA",231,"Scoala generala Alungeni nr. 85",281,132,125,7,0,127,5,300,168,57,70,3,6298,0
15,"Covasna",64871,145,64871,,"TURIA",232,"Comlex Transilvania - Baile Balvanyos str. Principala",0,43,0,43,0,43,0,200,157,23,20,3,6298,1
15,"Covasna",64906,145,64906,,"VALEA CRISULUI",233,"Sediul Primariei Valea Crisului",1374,532,527,5,0,491,41,1500,968,388,103,3,6306,0
15,"Covasna",64906,145,64906,,"VALEA CRISULUI",234,"Scoala ""dr. Bedo Albert"" din satul Calnic",412,118,107,11,0,118,0,500,382,75,43,3,6306,0
15,"Covasna",64906,145,64906,,"VALEA CRISULUI",235,"Caminul Cultural - Valea Crisului str. Principala nr. 177",0,33,0,33,0,33,0,100,67,22,11,3,6306,1
15,"Covasna",65099,145,65099,,"VALEA MARE",236,"Cladirea Primariei comunei Valea Mare",930,423,417,3,3,419,4,1000,577,205,214,3,6309,0
15,"Covasna",65099,145,65099,,"VALEA MARE",237,"Scoala cu clasele I-VIII Mihai Eminescu Valea Mare nr. 323",0,30,0,30,0,30,0,100,70,16,14,3,6309,1
15,"Covasna",64942,145,64942,,"VALCELE",238,"Sediul Primariei situat in satul Araci - corpul A",832,495,489,6,0,489,6,900,405,336,153,3,6301,0
15,"Covasna",64942,145,64942,,"VALCELE",239,"Sediul Primariei situat in satul Araci - corpul B",562,238,231,6,1,234,4,600,362,144,90,3,6301,0
15,"Covasna",64942,145,64942,,"VALCELE",240,"Scoala generala Ariusd",370,211,201,10,0,209,2,400,189,130,79,3,6301,0
15,"Covasna",64942,145,64942,,"VALCELE",241,"Scoala generala Valcele",887,555,537,10,8,546,9,1000,445,293,253,3,6301,0
15,"Covasna",64942,145,64942,,"VALCELE",242,"Caminul Cultural Valcele nr. 128",0,141,0,141,0,140,1,300,159,48,92,3,6301,1
15,"Covasna",64997,145,64997,,"VARGHIS",243,"Caminul Cultural Varghis nr. 423",1560,397,390,7,0,386,11,1700,1303,251,135,3,6311,0
15,"Covasna",64997,145,64997,,"VARGHIS",244,"Primaria comunei Varghis - Sala de sedinte, Varghis nr. 423",0,18,0,18,0,18,0,100,82,11,7,3,6311,1
15,"Covasna",65011,145,65011,,"ZAGON",245,"Caminul Cultural nr. 1 Zagon nr. 114",987,364,355,9,0,348,16,1100,736,241,107,3,6318,0
15,"Covasna",65011,145,65011,,"ZAGON",246,"Scoala generala cu clasele I-VIII, Mikes Kelemen Zagon nr. 467",1250,522,509,13,0,508,14,1300,778,392,116,3,6318,0
15,"Covasna",65011,145,65011,,"ZAGON",247,"Caminul Cultural nr. 2 Zagon nr. 934",1051,426,416,10,0,412,14,1100,674,289,123,3,6318,0
15,"Covasna",65011,145,65011,,"ZAGON",248,"Imobilul primariei din Papauti",1045,418,408,10,0,411,7,1100,682,225,186,3,6318,0
15,"Covasna",65011,145,65011,,"ZAGON",249,"Scoala cu clasele I-IV George Cosbuc Zagon str. Principala nr. 927",0,71,0,71,0,71,0,200,129,37,34,3,6318,1
15,"Covasna",65048,145,65048,,"ZABALA",250,"Caminul Cultural Zabala",1291,333,326,7,0,324,9,1400,1067,205,119,3,6313,0
15,"Covasna",65048,145,65048,,"ZABALA",251,"Clubul nr. 2 Zabala",883,313,303,10,0,301,12,1000,687,167,134,3,6313,0
15,"Covasna",65048,145,65048,,"ZABALA",252,"Caminul Cultural Pava",701,150,144,6,0,144,6,800,650,100,44,3,6313,0
15,"Covasna",65048,145,65048,,"ZABALA",253,"Caminul Cultural Tamasfalau",429,207,197,10,0,202,5,500,293,164,38,3,6313,0
15,"Covasna",65048,145,65048,,"ZABALA",254,"Caminul Cultural Surcea",506,243,232,11,0,235,8,600,357,221,14,3,6313,0
15,"Covasna",65048,145,65048,,"ZABALA",255,"Caminul Cultural Peteni",107,60,51,9,0,54,6,200,140,37,17,3,6313,0
15,"Covasna",65048,145,65048,,"ZABALA",256,"Caminul Cultural nr. 1 Zabala str. Principala nr. 829",0,50,0,50,0,49,1,200,150,27,22,3,6313,1
16,"Dambovita",65342,154,65342,,"MUNICIPIUL TARGOVISTE",1,"SCOALA ""VASILE CARLOVA"" ( fosta Scoala nr. 1), Calea Domneasca nr. 184, TARGOVISTE",1159,717,694,23,0,694,23,1301,584,404,290,1,6322,0
16,"Dambovita",65342,154,65342,,"MUNICIPIUL TARGOVISTE",2,"SCOALA ""VASILE CARLOVA: (fosta Scoala nr. 1), Calea Domneasca nr. 184, TARGOVISTE",1485,906,881,25,0,899,7,1650,744,467,432,1,6322,0
16,"Dambovita",65342,154,65342,,"MUNICIPIUL TARGOVISTE",3,"GRADINITA NR. 2 strada Radu Varzaru Armasu , nr.9A, TARGOVISTE",1595,910,893,17,0,883,27,1750,840,510,373,1,6322,0
16,"Dambovita",65342,154,65342,,"MUNICIPIUL TARGOVISTE",4,"SCOALA  '' RADU CEL MARE'' (fosta Scoala nr. 10) str   RADU CEL MARE nr.12 TARGOVISTE",1347,665,644,21,0,652,13,1500,835,393,259,1,6322,0
16,"Dambovita",65342,154,65342,,"MUNICIPIUL TARGOVISTE",5,"SCOALA  '' RADU CEL MARE'' (fosta Scoala nr. 10) str   RADU CEL MARE nr.12 TARGOVISTE",1483,778,761,11,6,772,6,1651,873,418,354,1,6322,0
16,"Dambovita",65342,154,65342,,"MUNICIPIUL TARGOVISTE",6,"SCOALA  '' RADU CEL MARE'' (fosta Scoala nr. 10) str   RADU CEL MARE nr.12 TARGOVISTE",1454,719,708,9,2,711,8,1600,881,381,330,1,6322,0
16,"Dambovita",65342,154,65342,,"MUNICIPIUL TARGOVISTE",7,"SCOALA  '' RADU CEL MARE'' (fosta Scoala nr. 10) str   RADU CEL MARE nr.12 TARGOVISTE",1537,913,878,35,0,897,16,1700,787,508,389,1,6322,0
16,"Dambovita",65342,154,65342,,"MUNICIPIUL TARGOVISTE",8,"GRUPUL SCOLAR  '' SPIRU HARET '' (fost LICEUL NR. 6)  str Mihai Eminescu nr.24 TARGOVISTE",1365,690,677,13,0,683,7,1500,810,391,292,1,6322,0
16,"Dambovita",65342,154,65342,,"MUNICIPIUL TARGOVISTE",9,"GRUPUL SCOLAR  '' SPIRU HARET '' (fostLICEUL NR. 6)  str Mihai Eminescu nr.24 TARGOVISTE",1091,598,588,10,0,586,12,1201,603,344,242,1,6322,0
16,"Dambovita",65342,154,65342,,"MUNICIPIUL TARGOVISTE",10,"GRUPUL SCOLAR  '' SPIRU HARET '' (fost LICEUL NR. 6)  str Mihai Eminescu nr.24 TARGOVISTE",1439,840,830,10,0,829,11,1601,761,464,365,1,6322,0
16,"Dambovita",65342,154,65342,,"MUNICIPIUL TARGOVISTE",11,"SCOALA DE MUZICA str. Lt. Parvan Popescu nr. 60 TARGOVISTE",1219,680,665,15,0,669,11,1351,671,359,310,1,6322,0
16,"Dambovita",65342,154,65342,,"MUNICIPIUL TARGOVISTE",12,"COLEGIUL ''CONSTANTIN  CARABELA'' (fost ''GRIGORE ALEXANDRESCU '' ) str. Lt. Parvan Popescu nr 58 TARGOVISTE",1257,729,714,15,0,714,15,1401,672,339,375,1,6322,0
16,"Dambovita",65342,154,65342,,"MUNICIPIUL TARGOVISTE",13,"LICEUL '' PETRU CERCEL '' (fost SANITAR) str. Lt. Parvan Popescu nr. 94 TARGOVISTE",1603,1016,992,24,0,979,37,1750,734,584,395,1,6322,0
16,"Dambovita",65342,154,65342,,"MUNICIPIUL TARGOVISTE",14,"SCOALA  ''MATEI BASARAB''  (fosta Scoala nr.13) str Mr. Spirescu nr.5(fosta SLD. PUIU SORIN NR. 3)  TARGOVISTE",944,569,551,18,0,564,5,1054,485,288,276,1,6322,0
16,"Dambovita",65342,154,65342,,"MUNICIPIUL TARGOVISTE",15,"SCOALA  ''MATEI BASARAB''  (fosta Scoala nr.13) str Mr. Spirescu nr.5(fosta SLD. PUIU SORIN NR. 3)  TARGOVISTE",885,537,516,21,0,528,9,1000,463,301,227,1,6322,0
16,"Dambovita",65342,154,65342,,"MUNICIPIUL TARGOVISTE",16,"SCOALA  ''MATEI BASARAB''  (fosta Scoala nr.13) str Mr. Spirescu nr.5(fosta SLD. PUIU SORIN NR. 3)  TARGOVISTE",1476,857,824,33,0,838,19,1600,743,451,387,1,6322,0
16,"Dambovita",65342,154,65342,,"MUNICIPIUL TARGOVISTE",17,"SCOALA   ''TUDOR VLADIMIRESCU ''  (fosta Scoala nr. 6) Str. Moldovei nr.2  TARGOVISTE",1569,820,799,21,0,809,11,1700,880,485,324,1,6322,0
16,"Dambovita",65342,154,65342,,"MUNICIPIUL TARGOVISTE",18,"SCOALA   ''TUDOR VLADIMIRESCU ''  (fosta Scoala nr. 6) Str. Moldovei nr.2  TARGOVISTE",1325,740,730,7,3,727,13,1450,710,427,300,1,6322,0
16,"Dambovita",65342,154,65342,,"MUNICIPIUL TARGOVISTE",19,"GRUP  SCOLAR  '' CONSTANTIN BRANCOVEANU'' (fost LICEUL NR 4) Bd Unirii 24-26 TARGOVISTE",923,465,459,6,0,456,9,1000,535,263,193,1,6322,0
16,"Dambovita",65342,154,65342,,"MUNICIPIUL TARGOVISTE",20,"GRUP  SCOLAR  '' CONSTANTIN BRANCOVEANU'' (fost LICEUL NR 4) Bd Unirii 24-26 TARGOVISTE",977,484,476,8,0,475,9,1100,616,281,194,1,6322,0
16,"Dambovita",65342,154,65342,,"MUNICIPIUL TARGOVISTE",21,"GRUP  SCOLAR  '' CONSTANTIN BRANCOVEANU'' (fost LICEUL NR 4) Bd Unirii 24-26 TARGOVISTE",1522,848,834,14,0,840,8,1650,802,485,355,1,6322,0
16,"Dambovita",65342,154,65342,,"MUNICIPIUL TARGOVISTE",22,"GRUP  SCOLAR  '' CONSTANTIN BRANCOVEANU'' (fost LICEUL NR 4) Bd Unirii 24-26 TARGOVISTE",910,476,467,9,0,472,4,1001,525,265,207,1,6322,0
16,"Dambovita",65342,154,65342,,"MUNICIPIUL TARGOVISTE",23,"GRUP  SCOLAR  '' CONSTANTIN BRANCOVEANU'' (fost LICEUL NR 4) Bd Unirii 24-26 TARGOVISTE",821,407,397,10,0,403,4,903,496,242,161,1,6322,0
16,"Dambovita",65342,154,65342,,"MUNICIPIUL TARGOVISTE",24,"DIRECTIA GENERALA A MUNCII SI PROTECTIEI SOCIALE STR. T. Vladimirescu nr.3 TARGOVISTE",1301,701,688,13,0,689,12,1450,749,400,289,1,6322,0
16,"Dambovita",65342,154,65342,,"MUNICIPIUL TARGOVISTE",25,"CANTINA DE AJUTOR SOCIAL str. T Vladimirescu nr.1 TARGOVISTE",1124,598,578,20,0,593,5,1251,653,314,279,1,6322,0
16,"Dambovita",65342,154,65342,,"MUNICIPIUL TARGOVISTE",26,"SCOALA NR. 11 str. Moldovei nr. 3 TARGOVISTE",1178,629,615,13,1,620,9,1300,671,379,241,1,6322,0
16,"Dambovita",65342,154,65342,,"MUNICIPIUL TARGOVISTE",27,"LICEUL '' I.H.RADULESCU'' ( fost LICEUL NR 3) Bd. Unirii nr.28 TARGOVISTE",1063,666,653,13,0,657,9,1146,480,366,291,1,6322,0
16,"Dambovita",65342,154,65342,,"MUNICIPIUL TARGOVISTE",28,"LICEUL '' I.H.RADULESCU'' ( fost LICEUL NR 3) Bd. Unirii nr.28 TARGOVISTE",1282,740,728,12,0,736,4,1400,660,364,372,1,6322,0
16,"Dambovita",65342,154,65342,,"MUNICIPIUL TARGOVISTE",29,"BIROURI PRIMARIE ( SERV. TAXE SI IMPOZITE - centrala termica) str. Poet Gr. Alexandrescu bl. E4 TARGOVISTE",901,558,536,22,0,557,1,1000,442,289,268,1,6322,0
16,"Dambovita",65342,154,65342,,"MUNICIPIUL TARGOVISTE",30,"BIROURI PRIMARIE ( SERV. TAXE SI IMPOZITE) str. Poet Gr. Alexandrescu bl. E4 TARGOVISTE",931,575,562,13,0,567,8,1007,432,278,289,1,6322,0
16,"Dambovita",65342,154,65342,,"MUNICIPIUL TARGOVISTE",31,"BIROURI PRIMARIE - CORP B str. Revolutiei nr.3 TARGOVISTE",1087,645,633,11,1,637,8,1201,556,352,285,1,6322,0
16,"Dambovita",65342,154,65342,,"MUNICIPIUL TARGOVISTE",32,"COLEGIUL '' ION GHICA''  ( fost LICEUL ECONOMIC) Calea Domneasca nr. 223 (fosta N. BALCESCU NR. 261)TARGOVISTE",1169,731,718,12,1,723,8,1300,569,352,371,1,6322,0
16,"Dambovita",65342,154,65342,,"MUNICIPIUL TARGOVISTE",33,"COLEGIUL '' ION GHICA''  ( fost LICEUL ECONOMIC) Calea Domneasca nr. 223 (fosta N. BALCESCU NR. 261)TARGOVISTE",1382,832,817,15,0,824,8,1501,669,408,416,1,6322,0
16,"Dambovita",65342,154,65342,,"MUNICIPIUL TARGOVISTE",34,"COLEGIUL  'IENACHITA  VACARESCU'' Calea Domneasca nr 235-237 TARGOVISTE",1484,909,894,14,1,900,9,1650,741,475,425,1,6322,0
16,"Dambovita",65342,154,65342,,"MUNICIPIUL TARGOVISTE",35,"SCOALA ""BRATESCU- VOINESTI"" (fosta  Scoala NR 2 )  Calea Domneasca nr. 252 TARGOVISTE",1242,730,718,12,0,721,9,1351,621,395,326,1,6322,0
16,"Dambovita",65342,154,65342,,"MUNICIPIUL TARGOVISTE",36,"SCOALA ""BRATESCU- VOINESTI"" (fosta  Scoala NR 2 )  Calea Domneasca nr. 252 TARGOVISTE",1034,659,638,21,0,652,7,1151,492,342,310,1,6322,0
16,"Dambovita",65342,154,65342,,"MUNICIPIUL TARGOVISTE",37,"SCOALA ""BRATESCU- VOINESTI"" (fosta  Scoala NR 2 )  Calea Domneasca nr. 252 TARGOVISTE",1014,536,520,16,0,515,21,1100,564,325,190,1,6322,0
16,"Dambovita",65342,154,65342,,"MUNICIPIUL TARGOVISTE",38,"GRUP SCOLAR ""VOIEVODUL MIRCEA "" (fost LICEUL NR. 2) Bd. Regele Carol I nr.70 TARGOVISTE",1491,940,861,58,21,933,7,1650,710,504,429,1,6322,0
16,"Dambovita",65342,154,65342,,"MUNICIPIUL TARGOVISTE",39,"SCOALA '' DIACONU CORESSI'' (fosta SCOALA NR 5) Al. Trandafirilor nr. 2 TARGOVISTE",1314,846,833,10,3,837,9,1451,605,370,467,1,6322,0
16,"Dambovita",65342,154,65342,,"MUNICIPIUL TARGOVISTE",40,"GRUP SCOLAR ""CONSTRUCTII MONTAJ""  (fost liceul nr. 5), strada G-ral I.E. Florescu nr. 18, TARGOVISTE",1273,772,759,13,0,764,8,1400,628,410,354,1,6322,0
16,"Dambovita",65342,154,65342,,"MUNICIPIUL TARGOVISTE",41,"GRUP SCOLAR ""CONSTRUCTII MONTAJ""  (fost liceul nr. 5), strada G-ral I.E. Florescu nr. 18, TARGOVISTE",1410,723,711,12,0,716,7,1551,828,408,308,1,6322,0
16,"Dambovita",65342,154,65342,,"MUNICIPIUL TARGOVISTE",42,"GRUP SCOLAR ""CONSTRUCTII MONTAJ""  (fost liceul nr. 5), strada G-ral I.E. Florescu nr. 18, TARGOVISTE",1457,822,799,23,0,809,13,1600,778,450,359,1,6322,0
16,"Dambovita",65342,154,65342,,"MUNICIPIUL TARGOVISTE",43,"LICEUL '' NICOLAE CIORANESCU''  (fost LICEUL NR 1 ) str 1 Mai nr 1A TARGOVISTE",1400,704,677,27,0,694,10,1550,846,405,289,1,6322,0
16,"Dambovita",65342,154,65342,,"MUNICIPIUL TARGOVISTE",44,"LICEUL '' NICOLAE CIORANESCU''  (fost LICEUL NR 1 ) str 1 Mai nr 1A TARGOVISTE",1379,837,818,19,0,829,8,1500,663,405,424,1,6322,0
16,"Dambovita",65342,154,65342,,"MUNICIPIUL TARGOVISTE",45,"LICEUL '' NICOLAE CIORANESCU''  (fost LICEUL NR 1 ) str 1 Mai nr 1A TARGOVISTE",778,431,402,29,0,424,7,851,420,216,208,1,6322,0
16,"Dambovita",65342,154,65342,,"MUNICIPIUL TARGOVISTE",46,"LICEUL '' NICOLAE CIORANESCU''  (fost LICEUL NR 1 ) str 1 Mai nr 1A TARGOVISTE",909,495,473,22,0,486,9,1000,505,229,257,1,6322,0
16,"Dambovita",65342,154,65342,,"MUNICIPIUL TARGOVISTE",47,"SCOALA '' MIHAI VITEAZU''  (fosta SCOALA NR 8) str Prof. ALEXANDRU VASILESCU nr 1  TARGOVISTE",1342,759,737,17,5,748,11,1451,692,374,374,1,6322,0
16,"Dambovita",65342,154,65342,,"MUNICIPIUL TARGOVISTE",48,"SCOALA '' MIHAI VITEAZU''  (fosta SCOALA NR 8) str Prof. ALEXANDRU VASILESCU nr 1  TARGOVISTE",1315,787,755,31,1,775,12,1451,664,407,368,1,6322,0
16,"Dambovita",65342,154,65342,,"MUNICIPIUL TARGOVISTE",49,"COLEGIUL  ''CONSTANTIN CANTACUZINO''   (fosta SCOALA NORMALA) str. George Cair nr.3 TARGOVISTE",1495,702,676,25,1,688,14,1652,950,390,298,1,6322,0
16,"Dambovita",65342,154,65342,,"MUNICIPIUL TARGOVISTE",50,"COLEGIUL  ''CONSTANTIN CANTACUZINO''   (fosta SCOALA NORMALA) str. George Cair nr.3 TARGOVISTE",1652,876,863,13,0,865,11,1800,924,503,362,1,6322,0
16,"Dambovita",65342,154,65342,,"MUNICIPIUL TARGOVISTE",51,"COLEGIUL  ''CONSTANTIN CANTACUZINO''   (fosta SCOALA NORMALA) str. George Cair nr.3 TARGOVISTE",797,446,427,19,0,440,6,901,455,245,195,1,6322,0
16,"Dambovita",65342,154,65342,,"MUNICIPIUL TARGOVISTE",52,"COLEGIUL  ''CONSTANTIN CANTACUZINO''   (fosta SCOALA NORMALA) str. George Cair nr.3 TARGOVISTE",974,521,512,9,0,512,9,1101,580,275,237,1,6322,0
16,"Dambovita",65342,154,65342,,"MUNICIPIUL TARGOVISTE",53,"SCOALA  GR ALEXANDRESCU  (fosta SCOALA NR 9) str. Vasile Blendea nr.7  TARGOVISTE",1587,804,788,14,2,791,13,1751,947,489,302,1,6322,0
16,"Dambovita",65342,154,65342,,"MUNICIPIUL TARGOVISTE",54,"SCOALA  GR ALEXANDRESCU  (fosta SCOALA NR 9) str. Vasile Blendea nr.7  TARGOVISTE",1470,755,739,16,0,744,11,1600,845,426,318,1,6322,0
16,"Dambovita",65342,154,65342,,"MUNICIPIUL TARGOVISTE",55,"SCOALA  GR ALEXANDRESCU  (fosta SCOALA NR 9) str. Vasile Blendea nr.7  TARGOVISTE",999,518,509,9,0,510,8,1100,582,335,175,1,6322,0
16,"Dambovita",65342,154,65342,,"MUNICIPIUL TARGOVISTE",56,"SCOALA  GR ALEXANDRESCU  (fosta SCOALA NR 9) str. Vasile Blendea nr.7  TARGOVISTE",749,404,378,26,0,400,4,850,446,215,185,1,6322,0
16,"Dambovita",65342,154,65342,,"MUNICIPIUL TARGOVISTE",57,"SCOALA '' SMARANDA GHEORGHIU'' (fosta SCOALA NR 3)   Calea Bucuresti nr.28 TARGOVISTE",1465,839,823,16,0,818,21,1601,762,404,414,1,6322,0
16,"Dambovita",65342,154,65342,,"MUNICIPIUL TARGOVISTE",58,"SCOALA '' SMARANDA GHEORGHIU'' (fosta SCOALA NR 3)   Calea Bucuresti nr.28 TARGOVISTE",1744,922,908,13,1,903,19,1901,979,472,431,1,6322,0
16,"Dambovita",65342,154,65342,,"MUNICIPIUL TARGOVISTE",59,"SCOALA '' SMARANDA GHEORGHIU'' (fosta SCOALA NR 3)   Calea Bucuresti nr.28 TARGOVISTE",1390,785,772,13,0,771,14,1551,766,442,329,1,6322,0
16,"Dambovita",65342,154,65342,,"MUNICIPIUL TARGOVISTE",60,"SCOALA '' SMARANDA GHEORGHIU'' (fosta SCOALA NR 3)   Calea Bucuresti nr.28 TARGOVISTE",927,496,486,10,0,486,10,1000,504,263,223,1,6322,0
16,"Dambovita",65342,154,65342,,"MUNICIPIUL TARGOVISTE",61,"SCOALA '' SMARANDA GHEORGHIU'' (fosta SCOALA NR 3)   Calea Bucuresti nr.28 TARGOVISTE",1084,651,625,26,0,619,32,1198,547,326,293,1,6322,0
16,"Dambovita",65342,154,65342,,"MUNICIPIUL TARGOVISTE",62,"CASA DE CULTURA A MUNICIPIULUI  (fost CAMIN CULTURAL MATEI VOIEVOD) str. Calea PLOIESTI, TARGOVISTE",1543,936,917,19,0,921,15,1650,714,580,341,1,6322,0
16,"Dambovita",65342,154,65342,,"MUNICIPIUL TARGOVISTE",63,"GRUP SCOLAR CONSTRUCTIII MONTAJ  (fost  LICEUL NR 5) str. Gral IE Florescu nr.18 TARGOVISTE",1477,806,762,44,0,792,14,1650,844,423,369,1,6322,0
16,"Dambovita",65342,154,65342,,"MUNICIPIUL TARGOVISTE",64,"GRUP SCOLAR CONSTRUCTIII MONTAJ  (fost  LICEUL NR 5) str. Gral IE Florescu nr.18 TARGOVISTE",1462,715,683,32,0,705,10,1600,885,408,297,1,6322,0
16,"Dambovita",65342,154,65342,,"MUNICIPIUL TARGOVISTE",65,"SCOALA PRISEACA str Crangului TARGOVISTE",875,494,479,15,0,486,8,971,477,246,240,1,6322,0
16,"Dambovita",65342,154,65342,,"MUNICIPIUL TARGOVISTE",66,"GRUP SCOLAR ""VOIEVODUL MIRCEA ""  Bd. Regele Carol I nr.70 , CP 130024,TARGOVISTE",0,1529,0,1529,0,1515,14,3001,1472,810,705,1,6322,1
16,"Dambovita",65841,154,65841,,"MUNICIPIUL  MORENI",67,"SCOALA GENERALA NR.2  SCHELA MARE STR SIRIUS NR. 56 MORENI",1114,696,681,15,0,684,12,1201,505,407,277,1,6325,0
16,"Dambovita",65841,154,65841,,"MUNICIPIUL  MORENI",68,"CLUB CRISTIAN (fosta UA MORENI) STR TARGOVISTEI, MORENI",773,482,475,7,0,472,10,851,368,277,195,1,6325,0
16,"Dambovita",65841,154,65841,,"MUNICIPIUL  MORENI",69,"GRADINITA TUICANI STR Ion Creanga, nr. 5,  MORENI",450,258,245,13,0,248,10,500,242,167,81,1,6325,0
16,"Dambovita",65841,154,65841,,"MUNICIPIUL  MORENI",70,"GRADINITA NR. 2,STR. A.I.CUZA NR.7 MORENI",788,518,510,8,0,510,8,851,333,266,244,1,6325,0
16,"Dambovita",65841,154,65841,,"MUNICIPIUL  MORENI",71,"CLUBUL ""FLACARA"" NR.2 STR FLACARA MORENI",895,550,544,6,0,543,7,1000,450,275,268,1,6325,0
16,"Dambovita",65841,154,65841,,"MUNICIPIUL  MORENI",72,"GRADINITA TISA , Fundatura Scolii nr. 1C, MORENI",461,338,334,4,0,334,4,500,162,134,200,1,6325,0
16,"Dambovita",65841,154,65841,,"MUNICIPIUL  MORENI",73,"SCOALA GENERALA NR. 3 STR VICTORIEI NR 56 MORENI",1321,835,824,7,4,826,9,1450,615,405,421,1,6325,0
16,"Dambovita",65841,154,65841,,"MUNICIPIUL  MORENI",74,"SCOALA GENERALA NR. 3 STR VICTORIEI NR 56 MORENI",968,530,525,5,0,522,8,1050,520,312,210,1,6325,0
16,"Dambovita",65841,154,65841,,"MUNICIPIUL  MORENI",75,"SCOALA GENERALA NR. 3 STR VICTORIEI NR 56 MORENI",842,470,460,8,2,465,5,900,430,263,202,1,6325,0
16,"Dambovita",65841,154,65841,,"MUNICIPIUL  MORENI",76,"SCOALA GENERALA NR. 3 STR VICTORIEI NR 56 MORENI",1047,600,587,12,1,586,14,1150,550,366,220,1,6325,0
16,"Dambovita",65841,154,65841,,"MUNICIPIUL  MORENI",77,"SCOALA GENERALA NR. 3 STR VICTORIEI NR 56 MORENI",1090,618,612,6,0,606,12,1201,583,329,277,1,6325,0
16,"Dambovita",65841,154,65841,,"MUNICIPIUL  MORENI",78,"SCOALA GENERALA NR. 4 STR PETROLULUI NR 3 MORENI",1138,641,627,14,0,632,9,1250,609,377,255,1,6325,0
16,"Dambovita",65841,154,65841,,"MUNICIPIUL  MORENI",79,"SCOALA GENERALA NR. 4 STR PETROLULUI NR 3 MORENI",729,423,416,7,0,416,7,801,378,247,169,1,6325,0
16,"Dambovita",65841,154,65841,,"MUNICIPIUL  MORENI",80,"SCOALA GENERALA NR. 4 STR PETROLULUI NR 3 MORENI",1054,614,601,10,3,603,11,1150,536,361,242,1,6325,0
16,"Dambovita",65841,154,65841,,"MUNICIPIUL  MORENI",81,"SCOALA GENERALA NR. 4 STR PETROLULUI NR 3 MORENI",1020,611,601,10,0,604,7,1100,489,330,274,1,6325,0
16,"Dambovita",65841,154,65841,,"MUNICIPIUL  MORENI",82,"SCOALA GENERALA NR. 4 STR PETROLULUI NR 3 MORENI",958,570,564,6,0,564,6,1051,481,290,274,1,6325,0
16,"Dambovita",65841,154,65841,,"MUNICIPIUL  MORENI",83,"SALA DE SPORT STR REPUBLICII NR 15 MORENI",813,527,517,10,0,524,3,903,376,278,246,1,6325,0
16,"Dambovita",65841,154,65841,,"MUNICIPIUL  MORENI",84,"SALA DE SPORT STR REPUBLICII NR 15 MORENI",655,368,356,12,0,364,4,701,333,220,144,1,6325,0
16,"Dambovita",65841,154,65841,,"MUNICIPIUL  MORENI",85,"LICEUL NR. 1 STR 22 DECEMBRIE 1989 NR.16 MORENI",750,450,441,9,0,445,5,850,400,212,233,1,6325,0
16,"Dambovita",65841,154,65841,,"MUNICIPIUL  MORENI",86,"LICEUL NR. 2 (fost PETROL) STR 22 DECEMBRIE 1989 NR 40 MORENI",1410,829,812,17,0,811,18,1550,721,419,392,1,6325,0
16,"Dambovita",65841,154,65841,,"MUNICIPIUL  MORENI",87,"Grupul Scolar Industrial nr. 1, str. 22 Decembrie 1989, nr.16, CP 135300, MORENI",0,480,0,480,0,474,6,701,221,242,232,1,6325,1
16,"Dambovita",65609,154,65609,,"ORAS FIENI",88,"GRADINITA ,, PINOCHIO '' SAT COSTESTI  FIENI",684,420,410,9,1,417,3,746,326,142,275,1,6327,0
16,"Dambovita",65609,154,65609,,"ORAS FIENI",89,"GRADINITA ,, PITICII '' SAT BEREVOIESTI  FIENI",574,350,343,7,0,346,4,651,301,169,177,1,6327,0
16,"Dambovita",65609,154,65609,,"ORAS FIENI",90,"SCOALA GENERALA ""DIACONU CORESI"" STR RUNCULUI NR 41 FIENI",1563,891,881,8,2,883,8,1701,810,526,357,1,6327,0
16,"Dambovita",65609,154,65609,,"ORAS FIENI",91,"GRUPUL SCOLAR INDUSTRIAL ''ING AUREL RAINU'' FIENI - CORP B STR DOCTOR N STEFANESCU NR 13",1578,796,773,22,1,787,9,1750,954,446,341,1,6327,0
16,"Dambovita",65609,154,65609,,"ORAS FIENI",92,"GRADINITA '' DUMBRAVA MINUNATA '' STR TEILOR NR 14 FIENI",688,304,292,10,2,298,6,751,447,149,149,1,6327,0
16,"Dambovita",65609,154,65609,,"ORAS FIENI",93,"GRUP SCOLAR INDUSTRIAL ''ING AUREL RAINU'' FIENI-CORP A STR REPUBLICII NR 20",1580,818,809,7,2,809,9,1701,883,464,345,1,6327,0
16,"Dambovita",65609,154,65609,,"ORAS FIENI",94,"SALA DE SEDINTE DIN CLADIREA POLITIEI COMUNITARE, str. Ing. Aurel Rainu, nr. 67, CP 135100, FIENI",0,151,0,151,0,151,0,400,249,99,52,1,6327,1
16,"Dambovita",65681,154,65681,,"ORAS GAESTI",95,"SCOALA NR.1 SALA NR.1 STR AC SERBAN CIOCULESCU GAESTI",929,539,531,8,0,534,5,1001,462,227,307,1,6331,0
16,"Dambovita",65681,154,65681,,"ORAS GAESTI",96,"SCOALA NR.1 SALA NR. 2 STR AC SERBAN CIOCULESCU GAESTI",879,548,538,7,3,538,10,951,403,229,309,1,6331,0
16,"Dambovita",65681,154,65681,,"ORAS GAESTI",97,"SCOALA NR.2 STR ARGESULUI GAESTI",1328,844,836,8,0,838,6,1451,607,312,526,1,6331,0
16,"Dambovita",65681,154,65681,,"ORAS GAESTI",98,"COLEGIUL  ""VLADIMIR STREINU"" SALA NR. 2  STR. N. TITULESCU, GAESTI",1501,891,883,7,1,880,11,1650,759,313,567,1,6331,0
16,"Dambovita",65681,154,65681,,"ORAS GAESTI",99,"SCOALA  NR. 6 SALA NR. 1, STR CUZA VODA GAESTI",1454,786,772,14,0,779,7,1600,814,407,372,1,6331,0
16,"Dambovita",65681,154,65681,,"ORAS GAESTI",100,"SCOALA  NR. 6 SALA NR. 2, STR CUZA VODA GAESTI",945,517,505,12,0,510,7,1051,534,235,275,1,6331,0
16,"Dambovita",65681,154,65681,,"ORAS GAESTI",101,"SCOALA  NR. 6 SALA NR. 3, STR CUZA VODA GAESTI",1292,710,688,22,0,706,4,1401,691,323,383,1,6331,0
16,"Dambovita",65681,154,65681,,"ORAS GAESTI",102,"SCOALA  NR. 6 SALA NR. 4, STR CUZA VODA GAESTI",1519,861,852,9,0,839,22,1650,789,368,471,1,6331,0
16,"Dambovita",65681,154,65681,,"ORAS GAESTI",103,"SCOALA  NR. 3 SALA NR. 1 STR 13 DECEMBRIE GAESTI",899,482,475,7,0,474,8,1000,518,210,264,1,6331,0
16,"Dambovita",65681,154,65681,,"ORAS GAESTI",104,"SCOALA  NR. 3 SALA NR. 2 STR 13 DECEMBRIE GAESTI",1051,609,602,7,0,600,9,1150,541,284,316,1,6331,0
16,"Dambovita",65681,154,65681,,"ORAS GAESTI",105,"SCOALA  NR. 3 SALA NR. 3 STR 13 DECEMBRIE GAESTI",1592,966,952,14,0,954,12,1700,734,460,494,1,6331,0
16,"Dambovita",65681,154,65681,,"ORAS GAESTI",106,"COLEGIUL NATIONAL ""VLADIMIR STREINU"" strada N. Titulescu, nr. 24-26, CP 135200, GAESTI",0,405,0,405,0,400,5,800,395,205,195,1,6331,1
16,"Dambovita",65921,154,65921,,"ORAS PUCIOASA",107,"SCOALA GENERALA NR. 2 PUCIOASA",1281,768,762,6,0,760,8,1400,632,385,375,1,6333,0
16,"Dambovita",65921,154,65921,,"ORAS PUCIOASA",108,"GRADINITA DIACONESTI, PUCIOASA  - SAT DIACONESTI",864,536,527,8,1,531,5,948,412,259,272,1,6333,0
16,"Dambovita",65921,154,65921,,"ORAS PUCIOASA",109,"SCOALA GENERALA NR. 1 PUCIOASA",1128,628,619,9,0,623,5,1270,642,337,286,1,6333,0
16,"Dambovita",65921,154,65921,,"ORAS PUCIOASA",110,"SCOALA GENERALA NR. 1 PUCIOASA",1117,693,681,11,1,687,6,1250,557,391,296,1,6333,0
16,"Dambovita",65921,154,65921,,"ORAS PUCIOASA",111,"GRADINITA NR. 1 PUCIOASA",1008,637,599,38,0,628,9,1100,463,311,317,1,6333,0
16,"Dambovita",65921,154,65921,,"ORAS PUCIOASA",112,"SCOALA GENERALA NR. 4 PUCIOASA",1460,789,772,13,4,774,15,1601,812,434,340,1,6333,0
16,"Dambovita",65921,154,65921,,"ORAS PUCIOASA",113,"LICEUL  ''NICOLAE TITULESCU'' PUCIOASA",1265,704,682,14,8,695,9,1400,696,352,343,1,6333,0
16,"Dambovita",65921,154,65921,,"ORAS PUCIOASA",114,"GRADINITA NR. 2 PUCIOASA",1226,701,682,19,0,691,10,1350,649,409,282,1,6333,0
16,"Dambovita",65921,154,65921,,"ORAS PUCIOASA",115,"GRADINITA NR. 3 PUCIOASA",1237,711,696,12,3,708,3,1351,640,310,398,1,6333,0
16,"Dambovita",65921,154,65921,,"ORAS PUCIOASA",116,"SCOALA GENERALA  NR.3 PUCIOASA",1263,647,636,11,0,640,7,1401,754,312,328,1,6333,0
16,"Dambovita",65921,154,65921,,"ORAS PUCIOASA",117,"SCOALA GENERALA NR. 5 GLODENI PUCIOASA - SAT GLODENI",1042,596,590,6,0,590,6,1150,554,256,334,1,6333,0
16,"Dambovita",65921,154,65921,,"ORAS PUCIOASA",118,"SCOALA GENERALA MALURILE ORASUL PUCIOASA - SAT MALURILE",132,92,82,9,1,91,1,201,109,29,62,1,6333,0
16,"Dambovita",65921,154,65921,,"ORAS PUCIOASA",119,"SCOALA GENERALA  PUCIOASA -SAT, PUCIOASA,  SAT PUCIOASA-SAT",345,223,215,8,0,219,4,400,177,91,128,1,6333,0
16,"Dambovita",65921,154,65921,,"ORAS PUCIOASA",120,"COLEGIUL NATIONAL ""NICOLAE TITULESCU"" B-UL TRANDAFIRILOR NR. 9, CP 135400, PUCIOASA",0,668,0,668,0,657,11,900,232,338,319,1,6333,1
16,"Dambovita",68627,154,68627,,"ORAS RACARI",121,"SCOALA GENERALA  RACARI, SALA NR. 2, Str. Ana Ipatescu, nr. 115",1074,783,740,13,30,771,12,1201,418,413,358,1,6341,0
16,"Dambovita",68627,154,68627,,"ORAS RACARI",122,"SCOALA GENERALA  RACARI, SALA NR.3, Str. Ana Ipatescu, nr. 115",685,504,469,5,30,500,4,750,246,244,256,1,6341,0
16,"Dambovita",68627,154,68627,,"ORAS RACARI",123,"SCOALA GENERALA GHERGANI, Str. Ion Ghica, nr. 204, ORASUL RACARI - SAT GHERGANI",633,488,451,10,27,481,7,701,213,332,149,1,6341,0
16,"Dambovita",68627,154,68627,,"ORAS RACARI",124,"SCOALA MAVRODIN ORASUL RACARI SAT MAVRODIN",821,593,551,32,10,585,8,901,308,366,219,1,6341,0
16,"Dambovita",68627,154,68627,,"ORAS RACARI",125,"SCOALA GENERALA GHIMPATI ORASUL RACARI - SAT GHIMPATI",646,546,517,12,17,543,3,750,204,377,166,1,6341,0
16,"Dambovita",68627,154,68627,,"ORAS RACARI",126,"SCOALA GENERALA COLACU ORASUL RACARI - SAT COLACU",764,567,544,11,12,556,11,850,283,301,255,1,6341,0
16,"Dambovita",68627,154,68627,,"ORAS RACARI",127,"GRADINITA  SABIESTI ORASUL RACARI - SAT SABIESTI",686,552,518,15,19,547,5,750,198,323,224,1,6341,0
16,"Dambovita",68627,154,68627,,"ORAS RACARI",128,"SCOALA GENERALA  RACARI,  Str. Ana Ipatescu, nr. 115, CP 137385",0,596,0,596,0,592,4,901,305,348,244,1,6341,1
16,"Dambovita",66081,154,66081,,"ORAS TITU",129,"SCOALA GENERALA  NR 2 TITU-TARG ORAS TITU",1303,870,854,10,6,851,19,1400,530,353,498,1,6350,0
16,"Dambovita",66081,154,66081,,"ORAS TITU",130,"SCOALA GENERALA  NR 2 TITU-TARG ORAS TITU",957,661,638,23,0,646,15,1045,384,262,384,1,6350,0
16,"Dambovita",66081,154,66081,,"ORAS TITU",131,"SCOALA GENERALA NR. 3 SALCUTA ORAS TITU - SAT SALCUTA",1141,800,767,19,14,781,19,1251,451,454,327,1,6350,0
16,"Dambovita",66081,154,66081,,"ORAS TITU",132,"SCOALA GENERALA NR 1 TITU GARA ORAS TITU",1301,863,855,7,1,851,12,1401,537,412,439,1,6350,0
16,"Dambovita",66081,154,66081,,"ORAS TITU",133,"LICEUL TEORETIC '' I.C. VISSARION ''  (CANTINA) TITU",1288,681,676,4,1,676,5,1400,719,299,377,1,6350,0
16,"Dambovita",66081,154,66081,,"ORAS TITU",134,"LICEUL TEORETIC '' I.C. VISSARION ''  (INTERNAT) TITU",1454,779,772,7,0,771,8,1601,822,338,433,1,6350,0
16,"Dambovita",66081,154,66081,,"ORAS TITU",135,"LICEUL TEORETIC '' I.C. VISSARION ''  (LOCAL) TITU",1170,742,728,14,0,731,11,1300,558,398,333,1,6350,0
16,"Dambovita",66081,154,66081,,"ORAS TITU",136,"LICEUL TEORETIC '' I.C. VISSARION ''  Str. I.C. Visarion, Nr. 1, CP 135500  TITU",0,423,0,423,0,418,5,701,278,207,211,1,6350,1
16,"Dambovita",65379,154,65379,,"ANINOASA",137,"SCOALA  ANINOASA STR C-TIN MANOLESCU, nr. 79 - SAT ANINOASA",916,600,592,8,0,593,7,1001,401,273,320,3,6357,0
16,"Dambovita",65379,154,65379,,"ANINOASA",138,"SCOALA  ANINOASA STR C-TIN MANOLESCU, nr. 79 - SAT ANINOASA",1060,691,678,13,0,682,9,1150,459,298,384,3,6357,0
16,"Dambovita",65379,154,65379,,"ANINOASA",139,"SCOALA  VIFORATA STR MIHAI VITEAZU COMUNA ANINOASA, Nr. 153 - SAT VIFORATA",820,504,486,7,11,496,8,901,397,225,271,3,6357,0
16,"Dambovita",65379,154,65379,,"ANINOASA",140,"SCOALA  VIFORATA STR MIHAI VITEAZU COMUNA ANINOASA, Nr. 153 - SAT VIFORATA",1036,699,672,17,10,693,6,1100,401,281,412,3,6357,0
16,"Dambovita",65379,154,65379,,"ANINOASA",141,"SCOALA SATENI STR POPA MARIN, nr. 82 COMUNA ANINOASA - SAT SATENI",1230,722,714,8,0,710,12,1350,628,288,422,3,6357,0
16,"Dambovita",65379,154,65379,,"ANINOASA",142,"SCOALA  GENERALA ANINOASA STR C-TIN MANOLESCU, nr. 79 - SAT ANINOASA, CP 137005",0,310,0,310,0,308,2,400,90,206,102,3,6357,1
16,"Dambovita",66198,154,66198,,"BALENI",143,"SCOALA DE ARTE SI MESERII BALENI - SATUL BALENI ROMANI",1468,873,859,14,0,866,7,1600,727,420,446,3,6361,0
16,"Dambovita",66198,154,66198,,"BALENI",144,"GRUPUL SCOLAR ""UDREA BALEANU"" BALENI - SATUL BALENI ROMANI",1456,970,959,11,0,955,15,1601,631,592,363,3,6361,0
16,"Dambovita",66198,154,66198,,"BALENI",145,"GRUPUL SCOLAR ""UDREA BALEANU"" BALENI - SATUL BALENI ROMANI",879,471,452,18,1,462,9,1001,530,225,237,3,6361,0
16,"Dambovita",66198,154,66198,,"BALENI",146,"CAMINUL CULTURAL BALENI SARBI -COMUNA BALENI SATUL BALENI SARBI",1418,710,694,16,0,701,9,1550,840,385,316,3,6361,0
16,"Dambovita",66198,154,66198,,"BALENI",147,"FOSTA PRIMARIE BALENI-SARBI COMUNA BALENI  - SATUL BALENI SARBI",1149,736,694,42,0,718,18,1250,514,443,275,3,6361,0
16,"Dambovita",66198,154,66198,,"BALENI",148,"CAMINUL CULTURAL BALENI SARBI -SATUL BALENI SARBI, Nr.2120, CP 137011",0,237,0,237,0,233,4,400,163,144,89,3,6361,1
16,"Dambovita",66223,154,66223,,"BARBULETU",149,"SCOALA  DE ARTE SI MESERII GURA BARBULETULUI COMUNA BARBULETU - SAT GURA BARBULETULUI",420,306,295,11,0,305,1,500,194,213,92,3,6364,0
16,"Dambovita",66223,154,66223,,"BARBULETU",150,"SCOALA I-VIII BARBULETU - SAT BARBULETU",1528,939,913,26,0,919,20,1601,662,664,255,3,6364,0
16,"Dambovita",66223,154,66223,,"BARBULETU",151,"SCOALA GENERALA BARBULETU, SAT BARBULETU, NR. 352, CP 137020",0,67,0,67,0,66,1,300,233,32,34,3,6364,1
16,"Dambovita",66330,154,66330,,"BEZDEAD",152,"SCOALA NR 1  ,, GRIGORE RADULESCU '' BEZDEAD - SAT BEZDEAD",1642,899,889,9,1,889,10,1800,901,484,405,3,6368,0
16,"Dambovita",66330,154,66330,,"BEZDEAD",153,"SCOALA  NR. 2 ,, VASILE VOICULESCU '' BEZDEAD - SAT BEZDEAD",1443,803,779,24,0,794,9,1601,798,354,440,3,6368,0
16,"Dambovita",66330,154,66330,,"BEZDEAD",154,"SCOALA  MAGURA COMUNA BEZDEAD - SAT MAGURA",906,515,505,10,0,510,5,1000,485,298,212,3,6368,0
16,"Dambovita",66330,154,66330,,"BEZDEAD",155,"CAMINUL CULTURAL NR. 1 BEZDEAD, SAT BEZDEAD, NR. 1568, CP 137035",0,147,0,147,0,146,1,300,153,78,68,3,6368,1
16,"Dambovita",66401,154,66401,,"BILCIURESTI",156,"CAMINUL CULTURAL BILCIURESTI, NR. 137 - SAT BILCIURESTI",1367,869,860,9,0,855,14,1501,632,351,504,3,6375,0
16,"Dambovita",66401,154,66401,,"BILCIURESTI",157,"CAMINUL CULTURAL BILCIURESTI, SAT BILCIURESTI, STRADA PRINCIPALA, NR. 137, CP 137045",0,174,0,174,0,174,0,300,126,73,101,3,6375,1
16,"Dambovita",66152,154,66152,,"BRANISTEA",158,"SCOALA ""SPIRU HARET"" CLASELE I-IV BRANISTEA, SALA NR. 1, SAT BRANISTEA",1283,918,869,12,37,903,15,1401,483,389,514,3,6381,0
16,"Dambovita",66152,154,66152,,"BRANISTEA",159,"SCOALA ""SPIRU HARET"" CLASELE I-IV BRANISTEA, SALA NR.2,  SAT BRANISTEA",1209,895,845,13,37,884,11,1301,406,372,512,3,6381,0
16,"Dambovita",66152,154,66152,,"BRANISTEA",160,"SCOALA GENERALA  DAMBOVICIOARA COMUNA BRANISTEA - SAT DAMBOVICIOARA",928,651,641,10,0,644,7,991,340,290,354,3,6381,0
16,"Dambovita",66152,154,66152,,"BRANISTEA",161,"SCOALA  I - IV  SAVESTI COMUNA BRANISTEA - SAT SAVESTI",148,107,98,9,0,106,1,200,93,28,78,3,6381,0
16,"Dambovita",66152,154,66152,,"BRANISTEA",162,"SCOALA  GENERALA ""SPIRU HARET"" BRANISTEA, SAT BRANISTEA, NR. 1153, CP 137050",0,169,0,169,0,169,0,401,232,81,88,3,6381,1
16,"Dambovita",66009,154,66009,,"BRANESTI",163,"CAMINUL CULTURAL BRANESTI STR PRINCIPALA NR 259 - SAT BRANESTI",1383,881,867,10,4,873,8,1500,619,496,377,3,6378,0
16,"Dambovita",66009,154,66009,,"BRANESTI",164,"SCOALA GENERALA ,, SPIRU HARET '' BRANESTI  STR PRINCIPALA  - SAT BRANESTI",1490,871,844,21,6,862,9,1650,779,466,396,3,6378,0
16,"Dambovita",66009,154,66009,,"BRANESTI",165,"SCOALA  GENERALA PRIBOIU COMUNA BRANESTI STR DRUMUL VECHI NR 105 - SAT PRIBOIU",849,582,574,8,0,577,5,951,369,346,231,3,6378,0
16,"Dambovita",66009,154,66009,,"BRANESTI",166,"SCOALA VECHE, SALA DE SPORT BRANESTI, SAT BRANESTI, STR. PRINCIPALA, CP 137055",0,96,0,96,0,95,1,300,204,51,44,3,6378,1
16,"Dambovita",101341,154,101341,,"BREZOAELE",167,"SCOALA  I-VIII  BREZOAELE - SAT BREZOAELE",1240,893,877,16,0,877,16,1350,457,524,353,3,6385,0
16,"Dambovita",101341,154,101341,,"BREZOAELE",168,"SCOALA  I-VIII BREZOAIA SALA NR. 1 COMUNA BREZOAELE - SAT BREZOAIA",789,573,568,5,0,564,9,850,277,346,218,3,6385,0
16,"Dambovita",101341,154,101341,,"BREZOAELE",169,"SCOALA  I-VIII BREZOAIA SALA NR. 2 COMUNA BREZOAELE  - SAT BREZOAIA",997,745,739,6,0,738,7,1100,355,440,298,3,6385,0
16,"Dambovita",101341,154,101341,,"BREZOAELE",170,"SCOALA I-VIII, BREZOAELE, SAT BREZOAELE, CP 137060",0,224,0,224,0,223,1,403,179,128,95,3,6385,1
16,"Dambovita",66438,154,66438,,"BUCIUMENI",171,"GRADINITA  BUCIUMENI,  NR. 293 - SAT BUCIUMENI",1531,887,876,11,0,881,6,1700,813,508,373,3,6388,0
16,"Dambovita",66438,154,66438,,"BUCIUMENI",172,"SCOALA I-IV DEALU MARE, NR. 101, COMUNA BUCIUMENI  - SAT DEALU MARE",1196,738,723,15,0,735,3,1300,562,426,309,3,6388,0
16,"Dambovita",66438,154,66438,,"BUCIUMENI",173,"SCOALA SI GRADINITA VALEA LEURZII, NR. 56, COMUNA BUCIUMENI - SAT VALEA LEURZII",1193,629,608,21,0,627,2,1300,671,252,375,3,6388,0
16,"Dambovita",66438,154,66438,,"BUCIUMENI",174,"GRADINITA BUCIUMENI, SAT BUCIUMENI, NR. 293, CP 137065",0,85,0,85,0,85,0,201,116,49,36,3,6388,1
16,"Dambovita",66474,154,66474,,"BUCSANI",175,"SCOALA ""DORA DALLES"" BUCSANI, STR. PRINCIPALA, NR. 933, SALA NR. 1 SAT BUCSANI",1498,969,956,13,0,960,9,1650,681,539,421,3,6392,0
16,"Dambovita",66474,154,66474,,"BUCSANI",176,"SCOALA ""DORA DALLES"" BUCSANI, STR. PRINCIPALA, NR. 933, SALA NR. 2 SAT BUCSANI",1523,945,937,8,0,938,7,1651,706,497,441,3,6392,0
16,"Dambovita",66474,154,66474,,"BUCSANI",177,"SCOALA GENERALA  HABENI, STR. PRINCIPALA, NR. 187, COMUNA BUCSANI, SAT HABENI",1144,711,695,16,0,701,10,1250,539,367,334,3,6392,0
16,"Dambovita",66474,154,66474,,"BUCSANI",178,"SCOALA GENERALA RACOVITA, STR. PRINCIPALA, NR. 283, COMUNA BUCSANI - SAT RACOVITA",962,549,539,10,0,544,5,1051,502,274,270,3,6392,0
16,"Dambovita",66474,154,66474,,"BUCSANI",179,"SCOALA GENERALA RATOAIA, STR. ZIMBRARIEI, NR. 146 COMUNA BUCSANI - SAT RATOAIA",389,340,326,14,0,336,4,500,160,162,174,3,6392,0
16,"Dambovita",66474,154,66474,,"BUCSANI",180,"SCOALA ""DORA DALLES"" BUCSANI, SAT BUCSANI, STR. PRINCIPALA, NR. 933, CP 137070",0,119,0,119,0,119,0,300,181,68,51,3,6392,1
16,"Dambovita",101564,154,101564,,"BUTIMANU",181,"SCOALA GENERALA BUTIMANU - SAT BUTIMANU",1389,1061,1057,4,0,1052,9,1501,440,698,354,3,6397,0
16,"Dambovita",101564,154,101564,,"BUTIMANU",182,"SCOALA  LUCIANCA COMUNA BUTIMANU - SAT LUCIANCA",363,273,266,7,0,272,1,401,128,144,128,3,6397,0
16,"Dambovita",101564,154,101564,,"BUTIMANU",183,"SCOALA GENERALA BUTIMANU - SAT BUTIMANU, NR. 31, CP 137075",0,358,0,358,0,356,2,600,242,189,167,3,6397,1
16,"Dambovita",66526,154,66526,,"CANDESTI",184,"CAMINUL CULTURAL CANDESTI-VALE COMUNA CANDESTI - SAT CANDESTI VALE",1022,736,714,12,10,724,12,1100,364,484,240,3,6402,0
16,"Dambovita",66526,154,66526,,"CANDESTI",185,"SCOALA GENERALA DRAGODANESTI - COMUNA CANDESTI - SAT DRAGODANESTI",681,463,453,10,0,460,3,800,337,238,222,3,6402,0
16,"Dambovita",66526,154,66526,,"CANDESTI",186,"SCOALA GENERALA CANDESTI DEAL - COMUNA CANDESTI - SAT CANDESTI DEAL",202,163,150,13,0,162,1,251,88,134,28,3,6402,0
16,"Dambovita",66526,154,66526,,"CANDESTI",187,"SCOALA PRIMARA  VALEA MARE COMUNA CANDESTI - SAT VALEA MARE",132,104,100,4,0,104,0,151,47,60,44,3,6402,0
16,"Dambovita",66526,154,66526,,"CANDESTI",188,"SCOALA PRIMARA  STURZENI COMUNA CANDESTI - CATUNUL STURZENI",432,303,294,9,0,299,4,501,198,169,130,3,6402,0
16,"Dambovita",66526,154,66526,,"CANDESTI",189,"SCOALA CANDESTI VALE, SAT CANDESTI VALE, CP 137083",0,166,0,166,0,165,1,400,234,89,76,3,6402,1
16,"Dambovita",101840,154,101840,,"CIOCANESTI",190,"SCOALA  DE ARTE SI MESERII CIOCANESTI - SAT CIOCANESTI",987,541,529,12,0,537,4,1100,559,286,251,3,6408,0
16,"Dambovita",101840,154,101840,,"CIOCANESTI",191,"SCOALA  DE ARTE SI MESERII CIOCANESTI - SAT CIOCANESTI",654,385,372,13,0,380,5,701,316,202,178,3,6408,0
16,"Dambovita",101840,154,101840,,"CIOCANESTI",192,"GRADINITA DECINDEA, COMUNA CIOCANESTI - SAT DECINDEA",407,300,292,8,0,296,4,451,151,144,152,3,6408,0
16,"Dambovita",101840,154,101840,,"CIOCANESTI",193,"SCOALA I-VIII  URZICEANCA COMUNA CIOCANESTI - SAT URZICEANCA",1191,800,786,14,0,780,20,1301,501,210,570,3,6408,0
16,"Dambovita",101840,154,101840,,"CIOCANESTI",194,"SCOALA I-VIII  ""DUMITRU SI SMARANDA ROMAN"" VIZURESTI COMUNA CIOCANESTI - SAT VIZURESTI",755,471,458,13,0,440,31,851,380,162,278,3,6408,0
16,"Dambovita",101840,154,101840,,"CIOCANESTI",195,"SCOALA GENERALA URZICEANCA, SAT URZICEANCA, CP 137093",0,211,0,211,0,208,3,500,289,94,114,3,6408,1
16,"Dambovita",66580,154,66580,,"COBIA",196,"SCOALA MANASTIREA COMUNA COBIA - SAT MANASTIREA",421,309,300,9,0,306,3,450,141,102,204,3,6414,0
16,"Dambovita",66580,154,66580,,"COBIA",197,"GRADINITA GHERGHITESTI COMUNA COBIA - SAT GHERGHITESTI",944,625,615,10,0,621,4,1051,426,270,351,3,6414,0
16,"Dambovita",66580,154,66580,,"COBIA",198,"GRADINITA MISLEA COMUNA COBIA - SAT MISLEA",707,455,447,8,0,453,2,801,346,183,270,3,6414,0
16,"Dambovita",66580,154,66580,,"COBIA",199,"GRADINITA  FRASIN DEAL COMUNA COBIA - SAT FRASIN DEAL",596,431,417,14,0,423,8,700,269,184,239,3,6414,0
16,"Dambovita",66580,154,66580,,"COBIA",200,"SCOALA I-VIII, GHERGHITESTI SAT GHERGHITESTI, STR. PRINCIPALA, NR. 30 , CP 137104",0,143,0,143,0,143,0,300,157,58,85,3,6414,1
16,"Dambovita",66697,154,66697,,"COJASCA",201,"SCOALA DE ARTE SI MESERII COJASCA STR. PRINCIPALA NR.681 - SAT COJASCA",1461,875,804,71,0,845,30,1600,725,361,484,3,6425,0
16,"Dambovita",66697,154,66697,,"COJASCA",202,"SCOALA  I-IV  IAZU STR. SCOLII NR.283 COMUNA COJASCA - SAT IAZU",1186,760,753,7,0,710,50,1300,540,491,219,3,6425,0
16,"Dambovita",66697,154,66697,,"COJASCA",203,"GRADINITA IAZU STR. SCOLII NR.283 COMUNA COJASCA - SAT IAZU",643,465,451,14,0,428,37,700,235,265,163,3,6425,0
16,"Dambovita",66697,154,66697,,"COJASCA",204,"SCOALA GENERALA  FINTANELE STR. PRINCIPALA NR.18 COMUNA COJASCA - SAT FANTANELE",1382,815,803,12,0,795,20,1500,685,155,640,3,6425,0
16,"Dambovita",66697,154,66697,,"COJASCA",205,"SCOALA DE ARTE SI MESERII COJASCA, SAT COJASCA, CP 137115",0,362,0,362,0,359,3,701,339,138,221,3,6425,1
16,"Dambovita",66731,154,66731,,"COMISANI",206,"CAMINUL CULTURAL COMISANI , STR. SUSENI, NR. 219,  SAT COMISANI",1558,932,910,22,0,922,10,1700,768,430,492,3,6429,0
16,"Dambovita",66731,154,66731,,"COMISANI",207,"SCOALA I-IV COMISANI, STR. HELESTEULUI, NR.2,  - SAT COMISANI",1226,740,727,13,0,735,5,1301,561,332,403,3,6429,0
16,"Dambovita",66731,154,66731,,"COMISANI",208,"CAMINUL CULTURAL LAZURI, STR. TARGULUI,NR.1,  COMUNA COMISANI - SAT LAZURI",1563,953,940,13,0,944,9,1701,748,446,498,3,6429,0
16,"Dambovita",66731,154,66731,,"COMISANI",209,"CAMINUL CULTURAL COMISANI, SAT COMISANI, STR. SUSENI NR. 219, CP 137120",0,119,0,119,0,117,2,201,82,52,65,3,6429,1
16,"Dambovita",66768,154,66768,,"CONTESTI",210,"SCOALA I-IV CONTESTI - SAT CRANGASI",719,484,456,27,1,477,7,792,308,249,228,3,6432,0
16,"Dambovita",66768,154,66768,,"CONTESTI",211,"SCOALA V-VIII CONTESTI - SAT CONTESTI",447,308,290,13,5,305,3,500,192,175,130,3,6432,0
16,"Dambovita",66768,154,66768,,"CONTESTI",212,"SCOALA I-IV BOTENI COMUNA CONTESTI - SAT BOTENI",684,431,412,8,11,422,9,750,319,198,224,3,6432,0
16,"Dambovita",66768,154,66768,,"CONTESTI",213,"SCOALA I-VIII BALTENI COMUNA CONTESTI - SAT BALTENI",1343,893,877,16,0,868,25,1450,557,508,360,3,6432,0
16,"Dambovita",66768,154,66768,,"CONTESTI",214,"FOSTUL SEDIU AL PRIMARIEI CONTESTI, SAT CONTESTI STR. PRIMARIEI NR. 456 CP 137125",0,332,0,332,0,329,3,701,369,177,152,3,6432,1
16,"Dambovita",66857,154,66857,,"CORBII MARI",215,"SCOALA  CORBII MARI - SAT CORBII MARI",1356,809,777,32,0,798,11,1500,691,360,438,3,6441,0
16,"Dambovita",66857,154,66857,,"CORBII MARI",216,"SCOALA VADU STANCHII COMUNA CORBII MARI - SAT VADU STANCHII",365,250,224,26,0,248,2,401,151,138,110,3,6441,0
16,"Dambovita",66857,154,66857,,"CORBII MARI",217,"SCOALA   PETRESTI COMUNA CORBII MARI- SAT PETRESTI",996,607,580,27,0,597,10,1100,493,348,249,3,6441,0
16,"Dambovita",66857,154,66857,,"CORBII MARI",218,"SCOALA  OBISLAV (GROZAVESTI II) COMUNA CORBII MARI - SAT GROZAVESTI",1403,740,719,21,0,720,20,1550,810,379,341,3,6441,0
16,"Dambovita",66857,154,66857,,"CORBII MARI",219,"SCOALA  UNGURENI COMUNA CORBII MARI - SAT UNGURENI",1515,1052,1026,26,0,1038,14,1650,598,621,417,3,6441,0
16,"Dambovita",66857,154,66857,,"CORBII MARI",220,"SCOALA  SATU NOU COMUNA CORBII MARI - SAT SATU NOU",360,277,268,9,0,273,4,401,124,199,74,3,6441,0
16,"Dambovita",66857,154,66857,,"CORBII MARI",221,"SCOALA I-X CORBII MARI, SAT CORBII MARI, STR. PRINCIPALA, NR. 2, CP. 137135",0,347,0,347,0,347,0,800,453,187,160,3,6441,1
16,"Dambovita",66955,154,66955,,"CORNATELU",222,"SCOALA GENERALA CORNATELU STR. DOMNITA MARULA, NR.50 - SAT CORNATELU",348,280,258,12,10,276,4,401,121,156,120,3,6451,0
16,"Dambovita",66955,154,66955,,"CORNATELU",223,"SCOALA I-IV  BOLOVANI, STR. ION BOLOVANEANU, NR.525 COMUNA CORNATELU - SAT BOLOVANI",583,492,449,9,34,486,6,700,208,368,118,3,6451,0
16,"Dambovita",66955,154,66955,,"CORNATELU",224,"SCOALA I-IV ALUNISU, STR. DIMITRIE RALLET, NR.21 COMUNA CORNATELU - SAT ALUNISU",265,215,203,9,3,211,4,301,86,98,113,3,6451,0
16,"Dambovita",66955,154,66955,,"CORNATELU",225,"SCOALA BOLOVANI, SAT BOLOVANI, STR. ION BOLOVANEANU, NR. 525, CP 137145 COMUNA CORNATELU",0,334,0,334,0,332,2,600,266,201,131,3,6451,1
16,"Dambovita",67014,154,67014,,"CORNESTI",226,"SCOALA   BUJOREANCA COMUNA CORNESTI - SAT BUJOREANCA",396,209,198,11,0,208,1,451,242,88,120,3,6457,0
16,"Dambovita",67014,154,67014,,"CORNESTI",227,"SCOALA CATUNU COMUNA CORNESTI - SAT CATUNU",742,448,436,12,0,442,6,801,353,178,264,3,6457,0
16,"Dambovita",67014,154,67014,,"CORNESTI",228,"SCOALA CORNESTI SALA NR. 1, COMUNA CORNESTI - SAT CORNESTI",1441,845,832,13,0,837,8,1600,755,403,434,3,6457,0
16,"Dambovita",67014,154,67014,,"CORNESTI",229,"SCOALA CRIVATU COMUNA CORNESTI - SAT CRIVATU",254,181,170,11,0,176,5,301,120,54,122,3,6457,0
16,"Dambovita",67014,154,67014,,"CORNESTI",230,"SCOALA FRASINU COMUNA CORNESTI - SAT FRASINU",515,292,279,13,0,290,2,600,308,202,88,3,6457,0
16,"Dambovita",67014,154,67014,,"CORNESTI",231,"SCOALA IBRIANU COMUNA CORNESTI - SAT IBRIANU",672,397,383,14,0,393,4,750,353,195,198,3,6457,0
16,"Dambovita",67014,154,67014,,"CORNESTI",232,"SCOALA   POSTARNACU COMUNA CORNESTI - SAT POSTARNACU",713,429,425,4,0,423,6,800,371,217,206,3,6457,0
16,"Dambovita",67014,154,67014,,"CORNESTI",233,"SCOALA   UNGURENI COMUNA CORNESTI - SAT UNGURENI",732,426,411,15,0,420,6,800,374,167,253,3,6457,0
16,"Dambovita",67014,154,67014,,"CORNESTI",234,"SCOALA CORNESTI, SAT CORNESTI, CP 137150",0,408,0,408,0,405,3,601,193,172,233,3,6457,1
16,"Dambovita",67121,154,67121,,"COSTESTII DIN VALE",235,"GRADINITA COSTESTII DIN VALE -STR. CRINULUI  SAT  COSTESTII DIN VALE",450,314,274,33,7,310,4,501,187,136,174,3,6468,0
16,"Dambovita",67121,154,67121,,"COSTESTII DIN VALE",236,"SCOALA  I-VIII COSTESTII DIN VALE - STR. CRINULUI,  SAT COSTESTII DIN VALE",1244,797,777,12,8,780,17,1298,501,465,315,3,6468,0
16,"Dambovita",67121,154,67121,,"COSTESTII DIN VALE",237,"SCOALA I - VIII TOMSANI, STR. TEIULUI , COMUNA COSTESTII DIN VALE - SAT TOMSANI",992,779,723,41,15,767,12,1100,321,467,300,3,6468,0
16,"Dambovita",67121,154,67121,,"COSTESTII DIN VALE",238,"SCOALA I-VIII TOMSANI, SAT TOMSANI, STR. TEIULUI, NR. 144 A, CP 137165, COMUNA COSTESTII DIN VALE",0,136,0,136,0,136,0,401,265,88,48,3,6468,1
16,"Dambovita",67167,154,67167,,"CRANGURILE",239,"SCOALA GENERALA BADULESTI COMUNA CRANGURILE - SAT BADULESTI",1188,770,757,13,0,749,21,1301,531,268,481,3,6472,0
16,"Dambovita",67167,154,67167,,"CRANGURILE",240,"SCOALA GENERALA PATROAIA-VALE COMUNA CRANGURILE SAT PATROAIA-VALE",986,609,603,6,0,597,12,1101,492,197,400,3,6472,0
16,"Dambovita",67167,154,67167,,"CRANGURILE",241,"SCOALA PRIMARA VOIA COMUNA CRANGURILE - SAT VOIA",409,262,252,10,0,251,11,501,238,65,186,3,6472,0
16,"Dambovita",67167,154,67167,,"CRANGURILE",242,"CAMINUL CULTURAL PATROAIA VALE, SAT PATROAIA VALE, CP 137176, COMUNA CRANGURILE",0,212,0,212,0,212,0,400,188,54,158,3,6472,1
16,"Dambovita",102286,154,102286,,"CREVEDIA",243,"SCOALA GENERALA CREVEDIA STR. BUCURESTI-TARGOVISTE, NR. 528 - SAT CREVEDIA",1308,763,721,42,0,754,9,1450,687,427,327,3,6481,0
16,"Dambovita",102286,154,102286,,"CREVEDIA",244,"CAMINUL CULTURAL CREVEDIA, STR. BUCURESTI-TARGOVISTE, NR. 139- SAT CREVEDIA",556,402,324,78,0,397,5,650,248,201,196,3,6481,0
16,"Dambovita",102286,154,102286,,"CREVEDIA",245,"SCOALA GENERALA DIRZA, STR. SCOLII NR.85 COMUNA CREVEDIA - SAT DARZA",1383,878,842,36,0,870,8,1350,472,443,427,3,6481,0
16,"Dambovita",102286,154,102286,,"CREVEDIA",246,"GRADINITA  SAMURCASI STR. ERNEST MAFTEI NR.147 COMUNA CREVEDIA - SAT SAMURCASI",1001,706,649,57,0,699,7,1090,384,424,275,3,6481,0
16,"Dambovita",102286,154,102286,,"CREVEDIA",247,"SCOALA  I-IV COCANI, STR. SCOLII NR. 169 COMUNA CREVEDIA - SAT COCANI",358,234,212,22,0,226,8,401,167,129,97,3,6481,0
16,"Dambovita",102286,154,102286,,"CREVEDIA",248,"GRADINITA CREVEDIA, SAT CREVEDIA, STR. BERZELOR NR. 69 CP 137180",0,1147,0,1147,0,1138,9,1150,3,662,476,3,6481,1
16,"Dambovita",67256,154,67256,,"DARMANESTI",249,"SCOALA DARMANESTI - SAT DARMANESTI",1466,898,889,9,0,885,13,1600,702,552,333,3,6487,0
16,"Dambovita",67256,154,67256,,"DARMANESTI",250,"CAMINUL CULTURAL CLUB  DARMANESTI  STR. PRINCIPALA, NR. 897 - SAT DARMANESTI",1685,1053,1038,15,0,1044,9,1851,798,636,408,3,6487,0
16,"Dambovita",67256,154,67256,,"DARMANESTI",251,"SCOALA  MARGINENII DE SUS COMUNA DARMANESTI - SAT MARGINENII DE SUS",874,655,600,55,0,650,5,950,295,415,235,3,6487,0
16,"Dambovita",67256,154,67256,,"DARMANESTI",252,"SCOALA DE ARTE SI MESERII DARMANESTI, SAT DARMANESTI, NR. 182, CP 137185",0,206,0,206,0,205,1,300,94,86,119,3,6487,1
16,"Dambovita",67292,154,67292,,"DOBRA",253,"SCOALA  ""PREOT PANAIT GEORGESCU"" DOBRA - SAT DOBRA",1486,1041,1032,9,0,1022,19,1650,609,695,327,3,6490,0
16,"Dambovita",67292,154,67292,,"DOBRA",254,"SCOALA ""INV IULIAN RUSU"" MARCESTI COMUNA DOBRA  SAT  MARCESTI",1527,1077,1064,13,0,1055,22,1651,574,663,392,3,6490,0
16,"Dambovita",67292,154,67292,,"DOBRA",255,"SCOALA  ""PREOT PANAIT GEORGESCU"" DOBRA - SAT DOBRA, STR. PRINCIPALA NR. 568, CP 137190",0,128,0,128,0,128,0,200,72,82,46,3,6490,1
16,"Dambovita",65413,154,65413,,"DOICESTI",256,"CAMINUL CULTURAL DOICESTI SALA DE FESTIVITATI,  STR. CONSTANTIN BRANCOVEANU NR. 379   - SAT DOICESTI",1464,827,799,28,0,809,18,1601,774,279,530,3,6493,0
16,"Dambovita",65413,154,65413,,"DOICESTI",257,"SCOALA  NR. 3 DOICESTI STR COLONIEI NR.15- SAT DOICESTI",1551,793,784,9,0,784,9,1700,907,308,476,3,6493,0
16,"Dambovita",65413,154,65413,,"DOICESTI",258,"SCOALA  NR.2 DOICESTI STR. CONSTANTIN BRANCOVEANU NR. 186- SAT DOICESTI",884,537,508,29,0,535,2,1000,463,202,333,3,6493,0
16,"Dambovita",65413,154,65413,,"DOICESTI",259,"SCOALA NR. 1 DOICESTI, SAT DOICESTI, STR. C-TIN BRANCOVEANU NR. 435, CP 137195",0,93,0,93,0,91,2,201,108,47,44,3,6493,1
16,"Dambovita",67327,154,67327,,"DRAGODANA",260,"SCOALA GENERALA DRAGODANA   - SAT DRAGODANA",1313,778,765,13,0,773,5,1450,672,429,344,3,6495,0
16,"Dambovita",67327,154,67327,,"DRAGODANA",261,"SCOALA GENERALA BURDUCA COMUNA DRAGODANA   - SAT BURDUCA",1083,668,663,5,0,658,10,1200,532,319,339,3,6495,0
16,"Dambovita",67327,154,67327,,"DRAGODANA",262,"SCOALA GENERALA NR 1 PICIOR DE MUNTE ( PAUNEI) COMUNA DRAGODANA   - SAT PICIOR DE MUNTE",1307,737,722,15,0,728,9,1449,712,400,328,3,6495,0
16,"Dambovita",67327,154,67327,,"DRAGODANA",263,"SCOALA GENERALA NR 2 PICIOR  DE MUNTE (BOBOCI) SALA NR.1 COMUNA DRAGODANA   - SAT BOBOCI",1155,671,665,6,0,663,8,1250,579,372,291,3,6495,0
16,"Dambovita",67327,154,67327,,"DRAGODANA",264,"SCOALA GENERALA NR 2 PICIOR  DE MUNTE (BOBOCI) SALA NR.2 COMUNA DRAGODANA  - SAT BOBOCI",685,383,378,5,0,378,5,750,367,247,131,3,6495,0
16,"Dambovita",67327,154,67327,,"DRAGODANA",265,"SCOALA GENERALA DRAGODANA   - SAT DRAGODANA, NR. 409, CP 137200",0,111,0,111,0,111,0,500,389,65,46,3,6495,1
16,"Dambovita",67407,154,67407,,"DRAGOMIRESTI",266,"SCOALA I-VIII  DRAGOMIRESTI, NR. 318   - SAT DRAGOMIRESTI",1601,999,982,17,0,986,13,1700,701,511,475,3,6503,0
16,"Dambovita",67407,154,67407,,"DRAGOMIRESTI",267,"SCOALA  I-VIII DECINDENI, NR.491, COMUNA DRAGOMIRESTI   - SAT DECINDENI",945,619,606,13,0,611,8,1050,431,286,325,3,6503,0
16,"Dambovita",67407,154,67407,,"DRAGOMIRESTI",268,"SCOALA  I-VIII DECINDENI, NR. 491, COMUNA DRAGOMIRESTI  - SAT DECINDENI",962,668,654,14,0,655,13,1050,382,280,375,3,6503,0
16,"Dambovita",67407,154,67407,,"DRAGOMIRESTI",269,"SCOALA  I-VIII RANCACIOV, NR.73, COMUNA DRAGOMIRESTI  - SAT RANCACIOV",902,530,522,8,0,524,6,1001,471,220,304,3,6503,0
16,"Dambovita",67407,154,67407,,"DRAGOMIRESTI",270,"SCOALA  I-VIII RANCACIOV, NR. 73 COMUNA DRAGOMIRESTI  - SAT RANCACIOV",658,366,359,7,0,361,5,750,384,159,202,3,6503,0
16,"Dambovita",67407,154,67407,,"DRAGOMIRESTI",271,"SCOALA  I-VIII UNGURENI COMUNA DRAGOMIRESTI  - SAT UNGURENI",983,530,500,30,0,522,8,1051,521,220,302,3,6503,0
16,"Dambovita",67407,154,67407,,"DRAGOMIRESTI",272,"CAMINUL CULTURAL MOGOSESTI, SAT GEANGOESTI",741,446,436,10,0,440,6,800,354,170,270,3,6503,0
16,"Dambovita",67407,154,67407,,"DRAGOMIRESTI",273,"SCOALA I-VIII DRAGOMIRESTI, SAT DRAGOMIRESTI, STR. PRINCIPALA NR. 318, CP 137210",0,158,0,158,0,158,0,400,242,91,67,3,6503,1
16,"Dambovita",67470,154,67470,,"FINTA",274,"SCOALA GENERALA GHEBOAIA SALA NR. 1 COMUNA FINTA   - SAT GHEBOAIA",873,583,577,6,0,577,6,951,368,287,290,3,6510,0
16,"Dambovita",67470,154,67470,,"FINTA",275,"SCOALA GENERALA GHEBOAIA SALA NR. 2 COMUNA FINTA   - SAT GHEBOAIA",918,590,581,9,0,576,14,1000,410,312,264,3,6510,0
16,"Dambovita",67470,154,67470,,"FINTA",276,"SCOALA GENERALA FINTA MARE COMUNA FINTA   - SAT FINTA MARE",1102,782,745,23,14,772,10,1200,418,402,370,3,6510,0
16,"Dambovita",67470,154,67470,,"FINTA",277,"SCOALA I-IV BECHINESTI COMUNA FINTA  - SAT BECHINESTI",650,407,376,31,0,395,12,750,343,197,198,3,6510,0
16,"Dambovita",67470,154,67470,,"FINTA",278,"SCOALA I-VIII FINTA MARE, SAT FINTA MARE, STR. EROILOR, CP 137222",0,146,0,146,0,146,0,301,155,87,59,3,6510,1
16,"Dambovita",67522,154,67522,,"GLODENI",279,"SCOALA  ""BUICA IONESCU"" GLODENI IMOBIL A, STR. CENTRU, NR. 4   - SAT  GLODENI",1518,1048,1026,19,3,1034,14,1651,603,634,400,3,6515,0
16,"Dambovita",67522,154,67522,,"GLODENI",280,"SCOALA  ""BUICA IONESCU"" GLODENI, IMOBIL B, STR. CENTRU, NR. 4,  - SAT GLODENI",1312,922,874,39,9,912,10,1456,534,532,380,3,6515,0
16,"Dambovita",67522,154,67522,,"GLODENI",281,"GRADINITA  LACULETE, STR. LACULETE, NR. 78 COMUNA GLODENI  - SAT LACULETE",765,547,539,8,0,541,6,900,353,320,221,3,6515,0
16,"Dambovita",67522,154,67522,,"GLODENI",282,"SCOALA  ""BUICA IONESCU"" GLODENI, SAT  GLODENI, STR. CENTRU, NR. 4 , CP 137225",0,68,0,68,0,68,0,201,133,54,14,3,6515,1
16,"Dambovita",65707,154,65707,,"GURA FOII",283,"SCOALA GENERALA  GURA FOII  - SAT GURA FOII",1226,943,905,13,25,931,12,1350,407,415,516,3,6522,0
16,"Dambovita",65707,154,65707,,"GURA FOII",284,"SALA DE FESTIVITATI COMUNA GURA FOII  - SAT FAGETU",314,256,248,8,0,251,5,401,145,155,96,3,6522,0
16,"Dambovita",65707,154,65707,,"GURA FOII",285,"GRADINITA BUMBUIA COMUNA GURA FOII  - SAT BUMBUIA",379,313,297,7,9,311,2,451,138,128,183,3,6522,0
16,"Dambovita",65707,154,65707,,"GURA FOII",286,"SCOALA I-VIII GURA FOII, SAT GURA FOII, CP 137235",0,461,0,461,0,460,1,596,135,310,150,3,6522,1
16,"Dambovita",67595,154,67595,,"GURA OCNITEI",287,"SCOALA DE ARTE SI MESERII GURA OCNITEI  - SAT GURA OCNITEI",1474,790,776,14,0,781,8,1600,810,425,356,3,6527,0
16,"Dambovita",67595,154,67595,,"GURA OCNITEI",288,"SCOALA DE ARTE SI MESERII GURA OCNITEI  - SAT GURA OCNITEI",1522,865,853,12,0,850,15,1651,786,491,359,3,6527,0
16,"Dambovita",67595,154,67595,,"GURA OCNITEI",289,"SCOALA GENERALA ADANCA COMUNA GURA OCNITEI  - SAT ADANCA",1619,1016,999,17,0,1005,11,1750,734,487,518,3,6527,0
16,"Dambovita",67595,154,67595,,"GURA OCNITEI",290,"SCOALA GENERALA SACUENI COMUNA GURA OCNITEI  - SAT SACUIENI",1565,909,891,18,0,899,10,1701,792,383,516,3,6527,0
16,"Dambovita",67595,154,67595,,"GURA OCNITEI",291,"SCOALA DE ARTE SI MESERII GURA OCNITEI  - SAT GURA OCNITEI, STR. PRINCIPALA, NR. 192, CP 137240",0,199,0,199,0,195,4,401,202,113,82,3,6527,1
16,"Dambovita",67648,154,67648,,"GURA SUTII",292,"SCOALA GENERALA GURA SUTII  - SAT GURA SUTII",890,532,524,8,0,523,9,950,418,248,275,3,6532,0
16,"Dambovita",67648,154,67648,,"GURA SUTII",293,"SCOALA GENERALA GURA SUTII  - SAT GURA SUTII",896,578,565,13,0,572,6,951,373,257,315,3,6532,0
16,"Dambovita",67648,154,67648,,"GURA SUTII",294,"GRADINITA NR. 2 GURA SUTII  - SAT GURA SUTII",964,648,630,18,0,636,12,1051,403,201,435,3,6532,0
16,"Dambovita",67648,154,67648,,"GURA SUTII",295,"SCOALA GENERALA SPERIETENI COMUNA GURA SUTII  - SAT SPERIETENI",1513,762,751,11,0,755,7,1650,888,283,472,3,6532,0
16,"Dambovita",67648,154,67648,,"GURA SUTII",296,"GRADINITA SPERIETENI, SAT SPERIETENI, STR. PRINCIPALA, CP 137245,",0,143,0,143,0,140,3,600,457,71,69,3,6532,1
16,"Dambovita",67675,154,67675,,"HULUBESTI",297,"GRADINITA  HULUBESTI   - SAT HULUBESTI",711,503,498,5,0,497,6,800,297,307,190,3,6535,0
16,"Dambovita",67675,154,67675,,"HULUBESTI",298,"GRADINITA MAGURA COMUNA HULUBESTI   - SAT MAGURA",532,426,412,14,0,415,11,601,175,245,170,3,6535,0
16,"Dambovita",67675,154,67675,,"HULUBESTI",299,"GRADINITA BUTOIU DE JOS COMUNA HULUBESTI  - SAT BUTOIU DE JOS",768,524,511,13,0,515,9,901,377,335,180,3,6535,0
16,"Dambovita",67675,154,67675,,"HULUBESTI",300,"GRADINITA BUTOIU DE SUS COMUNA HULUBESTI  - SAT BUTOIU DE SUS",626,465,447,18,0,460,5,701,236,318,142,3,6535,0
16,"Dambovita",67675,154,67675,,"HULUBESTI",301,"GRADINITA BUTOIU DE SUS,SAT BUTOIU DE SUS, CP137252, COMUNA HULUBESTI",0,162,0,162,0,161,1,701,539,98,63,3,6535,1
16,"Dambovita",67737,154,67737,,"I. L. CARAGIALE",302,"SCOALA  NR.1 GHIRDOVENI COMUNA IL CARAGIALE   - SAT GHIRDOVENI",1552,999,951,48,0,984,15,1701,702,415,569,3,6541,0
16,"Dambovita",67737,154,67737,,"I. L. CARAGIALE",303,"SCOALA  NR. 2 GHIRDOVENI COMUNA IL CARAGIALE  - SAT GHIRDOVENI",1321,897,866,31,0,891,6,1450,553,367,524,3,6541,0
16,"Dambovita",67737,154,67737,,"I. L. CARAGIALE",304,"CLUB PENITENCIAR I.L. CARAGIALE   - SAT I.L.CARAGIALE",600,759,394,14,351,743,16,1096,337,377,366,3,6541,0
16,"Dambovita",67737,154,67737,,"I. L. CARAGIALE",305,"CAMINUL CULTURAL I.L. CARAGIALE  - SAT IL CARAGIALE",1475,1022,996,26,0,1004,18,1600,578,417,587,3,6541,0
16,"Dambovita",67737,154,67737,,"I. L. CARAGIALE",306,"SCOALA   MIJA COMUNA IL CARAGIALE  - SAT MIJA",642,392,377,15,0,388,4,751,359,173,215,3,6541,0
16,"Dambovita",67737,154,67737,,"I. L. CARAGIALE",307,"SCOALA  NR. 2 GHIRDOVENI, SAT GHIRDOVENI, STR. PRINCIPALA NR.1203, CP 137256,  COMUNA IL CARAGIALE",0,115,0,115,0,114,1,901,786,47,67,3,6541,1
16,"Dambovita",65869,154,65869,,"IEDERA",308,"SCOALA  IEDERA DE JOS, STR. PRINCIPALA, NR. 530, COMUNA IEDERA   - SAT IEDERA DE JOS",1244,864,839,25,0,855,9,1350,486,568,287,3,6545,0
16,"Dambovita",65869,154,65869,,"IEDERA",309,"SCOALA IEDERA DE SUS, STR. PRINCIPALA, NR. 185,  COMUNA IEDERA  - SAT IEDERA DE SUS",1066,777,764,13,0,766,11,1201,424,536,230,3,6545,0
16,"Dambovita",65869,154,65869,,"IEDERA",310,"SCOALA DE ARTE SI MESERII COLIBASI, STR. PRINCIPALA NR. 14, COMUNA IEDERA, SAT COLIBASI",468,329,318,11,0,324,5,550,221,168,156,3,6545,0
16,"Dambovita",65869,154,65869,,"IEDERA",311,"GRADINITA CRICOVUL DULCE, STR. PRINCIPALA, NR. 157, SAT CRICOVUL DULCE, COMUNA IEDERA",349,245,234,11,0,242,3,400,155,120,122,3,6545,0
16,"Dambovita",65869,154,65869,,"IEDERA",312,"SCOALA  IEDERA DE JOS, SAT IEDERA DE JOS, STR. PRINCIPALA, NR. 530, CP 137263, COMUNA IEDERA",0,101,0,101,0,100,1,301,200,64,36,3,6545,1
16,"Dambovita",67773,154,67773,,"LUCIENI",313,"SCOALA LUCIENI  - SAT LUCIENI",1057,659,645,9,5,650,9,1150,491,298,352,3,6550,0
16,"Dambovita",67773,154,67773,,"LUCIENI",314,"SCOALA  LUCIENI  - SAT LUCIENI",994,638,626,9,3,632,6,1101,463,262,370,3,6550,0
16,"Dambovita",67773,154,67773,,"LUCIENI",315,"SCOALA  OLTENI COMUNA LUCIENI  - SAT OLTENI",407,298,292,6,0,293,5,451,153,144,149,3,6550,0
16,"Dambovita",67773,154,67773,,"LUCIENI",316,"SCOALA I-IV OLTENI, SAT OLTENI, CP 137266, COMUNA LUCIENI",0,106,0,106,0,106,0,201,95,64,42,3,6550,1
16,"Dambovita",67835,154,67835,,"LUDESTI",317,"SCOALA  TELESTI COMUNA LUDESTI  - SAT TELESTI",1384,871,860,11,0,859,12,1500,629,632,227,3,6553,0
16,"Dambovita",67835,154,67835,,"LUDESTI",318,"SCOALA  POTOCELU COMUNA LUDESTI  - SAT POTOCELU",767,602,589,13,0,592,10,901,299,524,68,3,6553,0
16,"Dambovita",67835,154,67835,,"LUDESTI",319,"SCOALA SCHEIU DE JOS COMUNA LUDESTI  - SAT SCHEIU DE JOS",842,623,579,44,0,621,2,901,278,411,210,3,6553,0
16,"Dambovita",67835,154,67835,,"LUDESTI",320,"SCOALA  SCHEIU DE SUS COMUNA LUDESTI  - SAT SCHEIU DE SUS",817,525,512,13,0,507,18,900,375,337,170,3,6553,0
16,"Dambovita",67835,154,67835,,"LUDESTI",321,"SCOALA I-IV LUDESTI, SAT LUDESTI, CP 137270",0,143,0,143,0,142,1,401,258,83,59,3,6553,1
16,"Dambovita",67906,154,67906,,"LUNGULETU",322,"SCOALA NR.2 LUNGULETU  - SAT LUNGULETU",875,439,420,19,0,437,2,1001,562,209,228,3,6560,0
16,"Dambovita",67906,154,67906,,"LUNGULETU",323,"SCOALA NR.2 LUNGULETU  - SAT LUNGULETU",1068,559,529,30,0,557,2,1151,592,299,258,3,6560,0
16,"Dambovita",67906,154,67906,,"LUNGULETU",324,"SCOALA  NR. 1 LUNGULETU   - SAT LUNGULETU",1375,688,641,47,0,678,10,1501,813,242,436,3,6560,0
16,"Dambovita",67906,154,67906,,"LUNGULETU",325,"SCOALA  SERDANU COMUNA LUNGULETU  - SAT SERDANU",1066,629,616,13,0,621,8,1051,422,224,397,3,6560,0
16,"Dambovita",67906,154,67906,,"LUNGULETU",326,"SCOALA NR. 2 LUNGULETU, SAT LUNGULETU, STR. DN 7, CP 137280",0,122,0,122,0,121,1,301,179,53,68,3,6560,1
16,"Dambovita",67942,154,67942,,"MALU CU FLORI",327,"SCOALA GENERALA MALU CU FLORI  - SAT MALU CU FLORI",1269,870,860,10,0,859,11,1401,531,476,383,3,6564,0
16,"Dambovita",67942,154,67942,,"MALU CU FLORI",328,"SCOALA I-IV MICLOSANII MICI COMUNA MALU CU FLORI  - SAT MICLOSANII MICI",799,579,553,26,0,573,6,900,321,316,257,3,6564,0
16,"Dambovita",67942,154,67942,,"MALU CU FLORI",329,"CAMINUL CULTURAL MALU CU FLORI, SALA MICA, SAT MALU CU FLORI, CP 137285",0,140,0,140,0,138,2,301,161,78,60,3,6564,1
16,"Dambovita",68002,154,68002,,"MANESTI",330,"SCOALA  MANESTI  - SAT MANESTI",1088,723,701,18,4,713,10,1200,477,369,344,3,6570,0
16,"Dambovita",68002,154,68002,,"MANESTI",331,"SCOALA DRAGAESTI- UNGURENI COMUNA MANESTI  - SAT DRAGAESTI-UNGURENI",989,634,603,31,0,620,14,1101,467,281,339,3,6570,0
16,"Dambovita",68002,154,68002,,"MANESTI",332,"SCOALA DRAGAESTI - PAMANTENI COMUNA MANESTI  - SAT DRAGAESTI-PAMANTENI",1561,1030,1017,12,1,1016,14,1701,671,644,372,3,6570,0
16,"Dambovita",68002,154,68002,,"MANESTI",333,"GRADINITA MANESTI, SAT MANESTI, CP 137290",0,109,0,109,0,109,0,201,92,71,38,3,6570,1
16,"Dambovita",68048,154,68048,,"MATASARU",334,"SCOALA GENERALA MATASARU  - SAT MATASARU",849,509,492,17,0,502,7,950,441,187,315,3,6574,0
16,"Dambovita",68048,154,68048,,"MATASARU",335,"SCOALA  PRIMARA ODAIA TURCULUI COMUNA MATASARU  - SAT ODAIA TURCULUI",950,639,629,10,0,635,4,1050,411,250,385,3,6574,0
16,"Dambovita",68048,154,68048,,"MATASARU",336,"GRADINITA TETCOIU COMUNA MATASARU  - SAT TETCOIU",1093,611,603,8,0,604,7,1200,589,278,326,3,6574,0
16,"Dambovita",68048,154,68048,,"MATASARU",337,"SCOALA GENERALA POROINICA COMUNA MATASARU  - SAT POROINICA",691,464,452,12,0,455,9,751,287,190,265,3,6574,0
16,"Dambovita",68048,154,68048,,"MATASARU",338,"SCOALA PRIMARA PUTU CU SALCIE  COMUNA MATASARU  - SAT PUTU CU SALCIE",777,488,470,18,0,483,5,850,362,248,235,3,6574,0
16,"Dambovita",68048,154,68048,,"MATASARU",339,"GRADINITA CRETULESTI, SAT CRETULESTI, CP 137296, COMUNA MATASARU",0,265,0,265,0,261,4,700,435,148,113,3,6574,1
16,"Dambovita",68128,154,68128,,"MOGOSANI",340,"SCOALA I-VIII  MOGOSANI  - SAT MOGOSANI",1377,918,904,14,0,908,10,1501,583,483,425,3,6582,0
16,"Dambovita",68128,154,68128,,"MOGOSANI",341,"SCOALA I-VIII COJOCARU COMUNA MOGOSANI  - SAT COJOCARU",637,442,425,17,0,436,6,701,259,146,290,3,6582,0
16,"Dambovita",68128,154,68128,,"MOGOSANI",342,"SCOALA I-IV MERII COMUNA MOGOSANI  - SAT MERII",823,558,545,13,0,552,6,901,343,221,331,3,6582,0
16,"Dambovita",68128,154,68128,,"MOGOSANI",343,"SCOALA I-IV ZAVOIU COMUNA MOGOSANI  - SAT ZAVOIU",739,558,549,9,0,550,8,801,243,289,261,3,6582,0
16,"Dambovita",68128,154,68128,,"MOGOSANI",344,"SCOALA I-VIII MOGOSANI, SAT MOGOSANI, CP 137305",0,188,0,188,0,187,1,401,213,84,103,3,6582,1
16,"Dambovita",68182,154,68182,,"MOROENI",345,"CAMINUL CULTURAL MOROENI  - SAT LUNCA",993,650,636,14,0,643,7,1101,451,350,293,3,6588,0
16,"Dambovita",68182,154,68182,,"MOROENI",346,"SCOALA DE ARTE SI MESERII  '' ION CIORANESCU'' MOROENI  - SAT MOROENI",1377,779,757,14,8,778,1,1501,722,419,359,3,6588,0
16,"Dambovita",68182,154,68182,,"MOROENI",347,"MAGAZINUL COOPERATIEI PUCHENI COMUNA MOROENI  - SAT PUCHENI",468,301,288,13,0,294,7,501,200,185,109,3,6588,0
16,"Dambovita",68182,154,68182,,"MOROENI",348,"SCOALA I-VIII  GLOD  COMUNA MOROENI  - SAT GLOD",1193,851,838,13,0,822,29,1300,449,464,358,3,6588,0
16,"Dambovita",68182,154,68182,,"MOROENI",349,"SCOALA  MUSCEL  COMUNA MOROENI  - SAT MUSCEL",71,49,40,9,0,49,0,101,52,31,18,3,6588,0
16,"Dambovita",68182,154,68182,,"MOROENI",350,"SANATORIUL TBC MOROENI   - SAT DOBRESTI",37,30,19,11,0,30,0,101,71,15,15,3,6588,0
16,"Dambovita",68182,154,68182,,"MOROENI",351,"SCOALA ""ION CIORANESCU"" MOROENI, SAT MOROENI, STR. PIETEI NR. 2, CP 137310",0,193,0,193,0,191,2,601,408,109,82,3,6588,1
16,"Dambovita",68253,154,68253,,"MORTENI",352,"GRADINITA MORTENI (CENTRU ), SALA NR. 1  STR PRINCIPALA , NR. 1131  - SAT MORTENI",1235,833,824,9,0,824,9,1350,517,439,385,3,6595,0
16,"Dambovita",68253,154,68253,,"MORTENI",353,"GRADINITA MORTENI (CENTRU ), SALA NR. 2 STR PRINCIPALA,  NR.  1131  - SAT MORTENI",1172,791,784,7,0,783,8,1250,459,402,381,3,6595,0
16,"Dambovita",68253,154,68253,,"MORTENI",354,"GRADINITA MORTENI, SAT MORTENI, STR. PRINCIPALA, NR. 1131, CP 137320",0,118,0,118,0,118,0,215,97,50,68,3,6595,1
16,"Dambovita",65645,154,65645,,"MOTAIENI",355,"CAMINUL CULTURAL MOTAIENI, NR. 136   - SAT MOTAENI",1429,944,924,9,11,937,7,1553,609,439,498,3,6598,0
16,"Dambovita",65645,154,65645,,"MOTAIENI",356,"SCOALA CUCUTENI, STR. ""INV. POPA CONSTANTIN"", NR. 11 COMUNA  MOTAIENI  - SAT CUCUTENI",422,296,287,9,0,290,6,451,155,159,131,3,6598,0
16,"Dambovita",65645,154,65645,,"MOTAIENI",357,"SCOALA I-VIII MOTAIENI, SAT MOTAIENI, STR. PRINCIPALA, NR. 140, CP 137325",0,83,0,83,0,83,0,301,218,32,51,3,6598,1
16,"Dambovita",104387,154,104387,,"NICULESTI",358,"SCOALA GENERALA NICULESTI, SALA A  - SAT NICULESTI",1033,595,589,6,0,585,10,1089,494,260,325,3,6601,0
16,"Dambovita",104387,154,104387,,"NICULESTI",359,"SCOALA GENERALA NICULESTI, SALA B  - SAT NICULESTI",778,434,423,11,0,429,5,850,416,168,261,3,6601,0
16,"Dambovita",104387,154,104387,,"NICULESTI",360,"SCOALA I-IV MOVILA COMUNA NICULESTI  - SAT MOVILA",552,269,262,7,0,268,1,651,382,136,132,3,6601,0
16,"Dambovita",104387,154,104387,,"NICULESTI",361,"SCOALA GENERALA CIOCANARI COMUNA NICULESTI  - SAT CIOCANARI",984,505,493,12,0,490,15,1100,595,245,245,3,6601,0
16,"Dambovita",104387,154,104387,,"NICULESTI",362,"SCOALA GENERALA NICULESTI, SAT NICULESTI, CP 137330",0,186,0,186,0,184,2,300,114,78,106,3,6601,1
16,"Dambovita",68280,154,68280,,"NUCET",363,"SCOALA GENERALA NUCET  - SAT NUCET",933,602,585,15,2,597,5,1000,398,149,448,3,6605,0
16,"Dambovita",68280,154,68280,,"NUCET",364,"SCOALA GENERALA NUCET  - SAT NUCET",881,562,551,11,0,546,16,915,353,137,409,3,6605,0
16,"Dambovita",68280,154,68280,,"NUCET",365,"SCOALA GENERALA  CAZACI COMUNA NUCET  - SAT CAZACI",1177,781,761,20,0,771,10,1300,519,288,483,3,6605,0
16,"Dambovita",68280,154,68280,,"NUCET",366,"SCOALA  ILFOVENI COMUNA NUCET  - SAT ILFOVENI",412,304,296,8,0,300,4,451,147,168,132,3,6605,0
16,"Dambovita",68280,154,68280,,"NUCET",367,"GRUPUL SCOLAR AGRICOL NUCET, SAT NUCET, ULITA GARII, NR. 6, CP 137335",0,157,0,157,0,157,0,300,143,70,87,3,6605,1
16,"Dambovita",68324,154,68324,,"OCNITA",368,"GRADINITA NR1 OCNITA  - SAT OCNITA",1123,676,664,5,7,669,7,1201,525,376,293,3,6609,0
16,"Dambovita",68324,154,68324,,"OCNITA",369,"SCOALA GENERALA NR.1 OCNITA  - SAT OCNITA",1328,820,792,10,18,812,8,1401,581,483,329,3,6609,0
16,"Dambovita",68324,154,68324,,"OCNITA",370,"SCOALA FUNDUL OCNEI COMUNA OCNITA  - SAT OCNITA",1078,674,627,27,20,666,8,1201,527,454,212,3,6609,0
16,"Dambovita",68324,154,68324,,"OCNITA",371,"CAMINUL CULTURAL OCNITA, STR. PRINCIPALA, NR. 456, CP 137340",0,135,0,135,0,135,0,401,266,96,39,3,6609,1
16,"Dambovita",68342,154,68342,,"ODOBESTI",372,"SCOALA GENERALA ODOBESTI  - SAT ODOBESTI",1297,896,869,27,0,883,13,1400,504,571,312,3,6611,0
16,"Dambovita",68342,154,68342,,"ODOBESTI",373,"SCOALA I-IV  BRINCOVEANU COMUNA ODOBESTI  - SAT BRANCOVEANU",548,397,391,6,0,393,4,600,203,190,203,3,6611,0
16,"Dambovita",68342,154,68342,,"ODOBESTI",374,"SCOALA I-IV  MIULESTI COMUNA ODOBESTI  - SAT MIULESTI",407,264,253,11,0,257,7,450,186,136,121,3,6611,0
16,"Dambovita",68342,154,68342,,"ODOBESTI",375,"GRADINITA CROVU COMUNA ODOBESTI  - SAT CROVU",1054,744,734,10,0,731,13,1150,406,357,374,3,6611,0
16,"Dambovita",68342,154,68342,,"ODOBESTI",376,"SCOALA I-IV  ZIDURILE COMUNA ODOBESTI  - SAT ZIDURILE",651,496,492,4,0,487,9,700,204,260,227,3,6611,0
16,"Dambovita",68342,154,68342,,"ODOBESTI",377,"SCOALA GENERALA ODOBESTI, SAT ODOBESTI, STR. PRINCIPALA NR. 82, CP 137345",0,200,0,200,0,196,4,501,301,98,98,3,6611,1
16,"Dambovita",179935,154,179935,,"PERSINARI",378,"SCOALA I-VIII PERSINARI STR. BISERICII  - SAT PERSINARI",1156,666,640,7,19,654,12,1296,630,225,429,3,6617,0
16,"Dambovita",179935,154,179935,,"PERSINARI",379,"SCOALA  I-VIII PERSINARI STR. BISERICII  - SAT PERSINARI",1182,715,687,7,21,701,14,1301,586,223,478,3,6617,0
16,"Dambovita",179935,154,179935,,"PERSINARI",380,"SCOALA I-VIII PERSINARI, STR. SCOLII, CP 137498",0,104,0,104,0,99,5,200,96,54,45,3,6617,1
16,"Dambovita",65752,154,65752,,"PETRESTI",381,"SCOALA I-VIII  PETRESTI  - SAT PETRESTI",1197,784,769,15,0,776,8,1300,516,415,361,3,6619,0
16,"Dambovita",65752,154,65752,,"PETRESTI",382,"SCOALA I-IV PUNTEA DE GRECI COMUNA PETRESTI  - SAT PUNTEA DE GRECI",600,477,459,18,0,471,6,651,174,264,207,3,6619,0
16,"Dambovita",65752,154,65752,,"PETRESTI",383,"SCOALA I-VIII GRECI COMUNA PETRESTI  - SAT GRECI",1274,892,874,18,0,887,5,1401,509,562,325,3,6619,0
16,"Dambovita",65752,154,65752,,"PETRESTI",384,"SCOALA I-IV  IONESTI COMUNA PETRESTI  - SAT IONESTI",785,558,541,17,0,552,6,850,292,346,206,3,6619,0
16,"Dambovita",65752,154,65752,,"PETRESTI",385,"GRADINITA IONESTI COMUNA PETRESTI  - SAT IONESTI",933,657,648,9,0,646,11,1000,343,424,222,3,6619,0
16,"Dambovita",65752,154,65752,,"PETRESTI",386,"SCOALA I-IV IONESTI, SAT IONESTI, CP 137350, COMUNA PETRESTI",0,288,0,288,0,283,5,401,113,163,120,3,6619,1
16,"Dambovita",179908,154,179908,,"PIETRARI",387,"CAMINUL CULTURAL PIETRARI  - SAT PIETRARI",1515,927,918,9,0,916,11,1601,674,457,459,3,6627,0
16,"Dambovita",179908,154,179908,,"PIETRARI",388,"SCOALA  I-IV VALEA NR. 996, COMUNA PIETRARI  - SAT VALEA",518,358,339,18,1,350,8,601,243,144,206,3,6627,0
16,"Dambovita",179908,154,179908,,"PIETRARI",389,"CAMINUL CULTURAL PIETRARI, SAT PIETRARI,STR. PRINCIPALA, NR. 520, CP 137026",0,118,0,118,0,118,0,400,282,49,69,3,6627,1
16,"Dambovita",68404,154,68404,,"PIETROSITA",390,"SCOALA  PIETROSITA CENTRU NR. 327 - SAT PIETROSITA",903,563,551,11,1,558,5,1001,438,255,303,3,6633,0
16,"Dambovita",68404,154,68404,,"PIETROSITA",391,"SCOALA  PIETROSITA CENTRU NR. 327 - SAT PIETROSITA",997,617,604,13,0,608,9,1100,483,281,327,3,6633,0
16,"Dambovita",68404,154,68404,,"PIETROSITA",392,"SCOALA  DEALU FRUMOS NR 78, COMUNA PIETROSITA  - SAT DEALU FRUMOS",881,527,519,8,0,525,2,1001,474,269,256,3,6633,0
16,"Dambovita",68404,154,68404,,"PIETROSITA",393,"SCOALA PIETROSITA, SAT PIETROSITA, NR. 327, CP 137360",0,116,0,116,0,116,0,301,185,59,57,3,6633,1
16,"Dambovita",68431,154,68431,,"POIANA",394,"SCOALA  NR.1 POIANA  - SAT POIANA",1328,999,986,13,0,988,11,1401,402,742,246,3,6636,0
16,"Dambovita",68431,154,68431,,"POIANA",395,"SCOALA  NR.1 POIANA  - SAT POIANA",629,456,447,9,0,449,7,701,245,301,148,3,6636,0
16,"Dambovita",68431,154,68431,,"POIANA",396,"SCOALA  NR.2 POIANA  - SAT POIANA",923,715,695,20,0,708,7,1001,286,496,212,3,6636,0
16,"Dambovita",68431,154,68431,,"POIANA",397,"SCOALA NR. 1 POIANA, SAT POIANA, CP 137365",0,253,0,253,0,249,4,301,48,153,96,3,6636,1
16,"Dambovita",68468,154,68468,,"POTLOGI",398,"SCOALA POTLOGI, STR. C-TIN BRANCOVEANU, NR. 64  - SAT POTLOGI",1274,686,679,7,0,675,11,1400,714,267,408,3,6639,0
16,"Dambovita",68468,154,68468,,"POTLOGI",399,"SCOALA POTLOGI, STR. C-TIN BRANCOVEANU, NR. 64  - SAT POTLOGI",1192,615,607,8,0,611,4,1300,685,229,382,3,6639,0
16,"Dambovita",68468,154,68468,,"POTLOGI",400,"SCOALA   PITARU STR. SCOLII NR. 244 COMUNA POTLOGI  - SAT PITARU",719,434,420,14,0,428,6,800,366,129,299,3,6639,0
16,"Dambovita",68468,154,68468,,"POTLOGI",401,"SCOALA   VLASCENI STR. GEN. ZAMFIRESCU NR. 342 COMUNA POTLOGI  - SAT VLASCENI",594,394,386,8,0,383,11,701,307,151,232,3,6639,0
16,"Dambovita",68468,154,68468,,"POTLOGI",402,"SCOALA   ROMANESTI STR.IOAN DOBRESCU, NR. 179 COMUNA POTLOGI  - SAT ROMANESTI",1344,729,712,17,0,724,5,1450,721,333,391,3,6639,0
16,"Dambovita",68468,154,68468,,"POTLOGI",403,"SCOALA   ROMANESTI STR.IOAN DOBRESCU, NR. 179 COMUNA POTLOGI  - SAT ROMANESTI",1151,641,621,20,0,619,22,1251,610,303,316,3,6639,0
16,"Dambovita",68468,154,68468,,"POTLOGI",404,"SCOALA POTLOGI, SAT POTLOGI, STR. C-TIN BRANCOVEANU, NR. 64, CP 137370",0,395,0,395,0,391,4,600,205,130,261,3,6639,1
16,"Dambovita",68529,154,68529,,"PRODULESTI",405,"CAMINUL CULTURAL PRODULESTI, STR VALE NR. 623 - SAT PRODULESTI",1552,962,947,15,0,953,9,1701,739,497,456,3,6645,0
16,"Dambovita",68529,154,68529,,"PRODULESTI",406,"SCOALA  I-IV BROSTENI, STR TARGOVISTEI, NR. 229, COMUNA PRODULESTI  - SAT BROSTENI",515,365,338,27,0,358,7,551,186,146,212,3,6645,0
16,"Dambovita",68529,154,68529,,"PRODULESTI",407,"SCOALA I-IV  COSTESTII DIN DEAL, STR. PRINCIPALA, NR. 348 COMUNA PRODULESTI  - SAT COSTESTII DIN DEAL",691,485,455,30,0,478,7,751,266,170,308,3,6645,0
16,"Dambovita",68529,154,68529,,"PRODULESTI",408,"SCOALA DE ARTE SI MESERII PRODULESTI, SAT PRODULESTI, SOS. TARGOVISTEI NR. 624, CP 137375",0,134,0,134,0,134,0,400,266,50,84,3,6645,1
16,"Dambovita",68565,154,68565,,"PUCHENI",409,"CAMINUL CULTURAL PUCHENI  - SAT PUCHENI",1468,1031,1020,8,3,1015,16,1601,570,351,664,3,6649,0
16,"Dambovita",68565,154,68565,,"PUCHENI",410,"SCOALA VALEA LARGA COMUNA PUCHENI  - SAT VALEA LARGA",228,157,151,6,0,154,3,300,143,71,83,3,6649,0
16,"Dambovita",68565,154,68565,,"PUCHENI",411,"SCOALA GENERALA PUCHENI, SAT PUCHENI, CP 137380",0,83,0,83,0,83,0,200,117,35,48,3,6649,1
16,"Dambovita",179891,154,179891,,"RACIU",412,"SCOALA RACIU, STR. PRINCIPALA NR. 109,    - SAT RACIU",1210,738,723,10,5,721,17,1351,613,289,432,3,6655,0
16,"Dambovita",179891,154,179891,,"RACIU",413,"SCOALA SUTA SEACA, DN 72, NR. 309,  COMUNA RACIU  - SAT SUTA SEACA",702,484,460,10,14,481,3,751,267,223,258,3,6655,0
16,"Dambovita",179891,154,179891,,"RACIU",414,"SCOALA  SILISTEA, STR. PRINCIPALA, NR. 260,   COMUNA RACIU  - SAT SILISTEA",728,491,475,10,6,488,3,800,309,162,326,3,6655,0
16,"Dambovita",179891,154,179891,,"RACIU",415,"SCOALA RACIU, SAT RACIU, STR. PRINCIPALA NR. 109, CP 137267",0,78,0,78,0,78,0,300,222,35,43,3,6655,1
16,"Dambovita",179926,154,179926,,"RASCAETI",416,"SCOALA  DRAGHINEASCA STR. SAULESCU NR.27 COMUNA RASCAETI  - SAT RASCAETI",767,562,531,10,21,558,4,851,289,404,154,3,6659,0
16,"Dambovita",179926,154,179926,,"RASCAETI",417,"SCOALA  RASCAETI STR. Mr. I. VOCHIN NR. 100  - SAT RASCAETI",1050,808,771,16,21,801,7,1151,343,589,212,3,6659,0
16,"Dambovita",179926,154,179926,,"RASCAETI",418,"SCOALA  RASCAETI, SAT RASCAETI, STR. Mr. I. VOCHIN NR. 100  CP 137518",0,109,0,109,0,109,0,300,191,82,27,3,6659,1
16,"Dambovita",65431,154,65431,,"RAZVAD",419,"BIBLIOTECA RAZVAD DE JOS, STR.  LUNCA, NR.2  - SAT RAZVAD",1510,973,957,16,0,965,8,1651,678,516,449,3,6665,0
16,"Dambovita",65431,154,65431,,"RAZVAD",420,"SCOALA  RAZVAD DE JOS, STR. DISPENSAR, NR. 53 - COMUNA RAZVAD  -SAT RAZVAD",1146,735,722,13,0,725,10,1251,516,355,370,3,6665,0
16,"Dambovita",65431,154,65431,,"RAZVAD",421,"CENTRUL DE EDUCARE COPII SARACI  RAZVAD DE SUS, STR. PRINCIPALA, NR. 185 COMUNA RAZVAD  - SAT RAZVAD",1102,697,670,26,1,691,6,1201,504,356,335,3,6665,0
16,"Dambovita",65431,154,65431,,"RAZVAD",422,"SCOALA   VALEA VOIEVOZILOR, STR. T. VLADIMIRESCU, NR. 11, COMUNA RAZVAD  - SAT VALEA VOIEVOZILOR",1169,761,752,9,0,745,16,1251,490,399,346,3,6665,0
16,"Dambovita",65431,154,65431,,"RAZVAD",423,"SCOALA   VALEA VOIEVOZILOR, STR. T. VLADIMIRESCU, NR. 11, COMUNA RAZVAD  - SAT VALEA VOIEVOZILOR",1222,801,786,15,0,790,11,1350,549,391,399,3,6665,0
16,"Dambovita",65431,154,65431,,"RAZVAD",424,"SCOALA  GORGOTA STR. PRINCIPALA, COMUNA RAZVAD  - SAT GORGOTA",1119,680,667,13,0,669,11,1201,521,443,226,3,6665,0
16,"Dambovita",65431,154,65431,,"RAZVAD",425,"CENTRUL DE  COPII SARACI , SAT RAZVAD , STR. PRINCIPALA, NR. 185 CP 137395",0,397,0,397,0,393,4,1001,604,240,153,3,6665,1
16,"Dambovita",179917,154,179917,,"RAU ALB",426,"CAMINUL CULTURAL RAU ALB DE JOS, SALA DE FESTIVITATI, DC 122, NR. 840-COMUNA RAU ALB  - SAT RAU ALB DE JOS",1284,850,829,21,0,835,15,1400,550,579,256,3,6662,0
16,"Dambovita",179917,154,179917,,"RAU ALB",427,"SCOALA RAU ALB DE JOS, SAT RAU ALB DE JOS, STR. CIOBANESTI, NR. 836, CP 137027",0,177,0,177,0,174,3,400,223,105,69,3,6662,1
16,"Dambovita",68716,154,68716,,"RUNCU",428,"GRADINITA NR. 1 RUNCU STR. PRINCIPALA NR. 1  - SAT RUNCU",1210,671,657,14,0,667,4,1350,679,374,293,3,6669,0
16,"Dambovita",68716,154,68716,,"RUNCU",429,"SCOALA GENERALA  NR. 1 RUNCU, SALA NR. 1,  STR. PRINCIPALA NR. 94  - SAT RUNCU",1097,533,523,10,0,525,8,1201,668,268,257,3,6669,0
16,"Dambovita",68716,154,68716,,"RUNCU",430,"GRADINITA  BADENI STR. PRINCIPALA NR. 46 COMUNA RUNCU  - SAT BADENI",847,475,462,10,3,471,4,951,476,216,255,3,6669,0
16,"Dambovita",68716,154,68716,,"RUNCU",431,"SCOALA  BREBU STR. PLAIU DOMNESC NR. 83 COMUNA RUNCU  - SAT BREBU",555,352,342,10,0,349,3,600,248,74,275,3,6669,0
16,"Dambovita",68716,154,68716,,"RUNCU",432,"SCOALA GENERALA  NR. 1 RUNCU, SAT RUNCU,  STR. PRINCIPALA NR. 94  CP 137400",0,73,0,73,0,72,1,401,328,39,33,3,6669,1
16,"Dambovita",68789,154,68789,,"SALCIOARA",433,"SALA DE FESTIVITATI BANESTI COMUNA SALCIOARA   - SAT BANESTI",376,246,235,10,1,244,2,451,205,98,146,3,6676,0
16,"Dambovita",68789,154,68789,,"SALCIOARA",434,"SCOALA I -VIII MIRCEA VODA SALA A COMUNA SALCIOARA  - SAT MIRCEA VODA",911,609,589,20,0,599,10,1000,391,258,341,3,6676,0
16,"Dambovita",68789,154,68789,,"SALCIOARA",435,"SCOALA I-IV CUZA VODA COMUNA SALCIOARA  - SAT CUZA VODA",292,210,199,11,0,206,4,351,141,66,140,3,6676,0
16,"Dambovita",68789,154,68789,,"SALCIOARA",436,"SCOALA  I-IV PODU RIZII  SALA A COMUNA SALCIOARA  - SAT PODU RIZII",631,454,444,10,0,447,7,701,247,147,300,3,6676,0
16,"Dambovita",68789,154,68789,,"SALCIOARA",437,"SCOALA  I-VIII GHINESTI SALA A COMUNA SALCIOARA  - SAT GHINESTI",1008,673,665,8,0,664,9,1075,402,214,450,3,6676,0
16,"Dambovita",68789,154,68789,,"SALCIOARA",438,"SCOALA  I-IV PODU RIZII, SAT PODU RIZII, CP 137419,   COMUNA SALCIOARA",0,180,0,180,0,180,0,601,421,67,113,3,6676,1
16,"Dambovita",105142,154,105142,,"SLOBOZIA MOARA",439,"SCOALA  I-VIII SLOBOZIA MOARA  - SAT SLOBOZIA MOARA",865,589,579,10,0,584,5,1001,412,311,273,3,6690,0
16,"Dambovita",105142,154,105142,,"SLOBOZIA MOARA",440,"SCOALA  I-VIII SLOBOZIA MOARA  - SAT SLOBOZIA MOARA",827,550,542,8,0,541,9,900,350,316,225,3,6690,0
16,"Dambovita",105142,154,105142,,"SLOBOZIA MOARA",441,"SCOALA GENERALA SLOBOZIA MOARA, SAT SLOBOZIA MOARA, STR. PRIMARIEI, NR. 37, CP 137420",0,122,0,122,0,122,0,200,78,63,59,3,6690,1
16,"Dambovita",68887,154,68887,,"SELARU",442,"SCOALA I-VIII SELARU, SALA NR. 1  - SAT SELARU",834,557,539,14,4,551,6,900,343,357,194,3,6686,0
16,"Dambovita",68887,154,68887,,"SELARU",443,"SCOALA I-VIII FIERBINTI COMUNA SELARU  - SAT FIERBINTI",1256,866,854,12,0,848,18,1400,534,505,343,3,6686,0
16,"Dambovita",68887,154,68887,,"SELARU",444,"SCOALA I-VIII GLOGOVEANU COMUNA SELARU  - SAT GLOGOVEANU",602,424,408,16,0,417,7,700,276,256,161,3,6686,0
16,"Dambovita",68887,154,68887,,"SELARU",445,"SCOALA I-VIII SELARU, SAT SELARU, NR. 164, CP 137425",0,265,0,265,0,265,0,500,235,149,116,3,6686,1
16,"Dambovita",65477,154,65477,,"SOTANGA",446,"SCOALA  TEIS CORP A, SALA NR. 1, STR. TEIUL DOAMNEI, NR.56 COMUNA SOTANGA   - SAT TEIS",1147,681,678,3,0,675,6,1251,570,317,358,3,6692,0
16,"Dambovita",65477,154,65477,,"SOTANGA",447,"SCOALA  TEIS CORP A, SALA NR. 2, STR. TEIUL DOAMNEI, NR.56 COMUNA SOTANGA   - SAT TEIS",967,570,565,5,0,567,3,1051,481,294,273,3,6692,0
16,"Dambovita",65477,154,65477,,"SOTANGA",448,"SCOALA  ""PROFESOR ILIE POPESCU"" SOTANGA , SALA NR. 1,  STR. C-TIN BRANCOVEANU NR. 269- SAT SOTANGA",1530,893,869,24,0,875,18,1701,808,256,619,3,6692,0
16,"Dambovita",65477,154,65477,,"SOTANGA",449,"GRADINITA NR 1 SOTANGA STR. C-TIN BRANCOVEANU NR. 313 - SAT SOTANGA",1162,716,673,43,0,708,8,1301,585,245,463,3,6692,0
16,"Dambovita",65477,154,65477,,"SOTANGA",450,"SCOALA  NR. 2 SOTANGA  STR. CALEA PUCIOASEI NR. 40- SAT SOTANGA",1083,611,580,31,0,602,9,1201,590,193,409,3,6692,0
16,"Dambovita",65477,154,65477,,"SOTANGA",451,"SCOALA  ""PROFESOR ILIE POPESCU"" SOTANGA , SAT SOTANGA, STR. C-TIN BRANCOVEANU NR. 269, CP 137430",0,130,0,130,0,127,3,411,281,55,72,3,6692,1
16,"Dambovita",105534,154,105534,,"TARTASESTI",452,"SCOALA GENERALA TARTASESTI - SAT TARTASESTI",800,536,522,14,0,529,7,901,365,213,316,3,6695,0
16,"Dambovita",105534,154,105534,,"TARTASESTI",453,"GRUP SCOLAR TARTASESTI - SAT TARTASESTI",821,543,533,10,0,534,9,900,357,234,300,3,6695,0
16,"Dambovita",105534,154,105534,,"TARTASESTI",454,"SCOALA GENERALA  BALDANA COMUNA TARTASESTI - SAT BALDANA",1395,958,940,18,0,950,8,1500,542,563,387,3,6695,0
16,"Dambovita",105534,154,105534,,"TARTASESTI",455,"SCOALA GENERALA GULIA COMUNA TARTASESTI - SAT GULIA",813,594,578,16,0,586,8,901,307,137,449,3,6695,0
16,"Dambovita",105534,154,105534,,"TARTASESTI",456,"SCOALA GENERALA TARTASESTI, SAT TARTASESTI CP 137435",0,553,0,553,0,547,6,800,247,271,276,3,6695,1
16,"Dambovita",68921,154,68921,,"TATARANI",457,"SALA DE FESTIVITATI  TATARANI - SAT TATARANI",972,683,659,13,11,672,11,1050,367,230,442,3,6699,0
16,"Dambovita",68921,154,68921,,"TATARANI",458,"GRADINITA GHEBOIENI COMUNA TATARANI - SAT GHEBOIENI",1313,893,870,18,5,875,18,1451,558,393,482,3,6699,0
16,"Dambovita",68921,154,68921,,"TATARANI",459,"CAMINUL CULTURAL CAPRIORU COMUNA TATARANI - SAT CAPRIORU",1330,937,909,17,11,920,17,1451,514,443,477,3,6699,0
16,"Dambovita",68921,154,68921,,"TATARANI",460,"CAMINUL CULTURAL PRIBOIU COMUNA TATARANI - SAT PRIBOIU",791,645,597,27,21,637,8,850,205,274,363,3,6699,0
16,"Dambovita",68921,154,68921,,"TATARANI",461,"SALA DE FESTIVITATI  TATARANI, SAT TATARANI, STR. PRINCIPALA CP 137440",0,227,0,227,0,224,3,401,174,120,104,3,6699,1
16,"Dambovita",68976,154,68976,,"ULIESTI",462,"SCOALA  I-VIII ULIESTI - SAT ULIESTI",1113,703,689,14,0,694,9,1200,497,272,422,3,6704,0
16,"Dambovita",68976,154,68976,,"ULIESTI",463,"GRADINITA CROITORI COMUNA ULIESTI - SAT CROITORI",683,476,464,12,0,468,8,800,324,213,255,3,6704,0
16,"Dambovita",68976,154,68976,,"ULIESTI",464,"SCOALA HANUL LUI PALA COMUNA ULIESTI - SAT HANU LUI PALA",273,194,184,10,0,189,5,302,108,66,123,3,6704,0
16,"Dambovita",68976,154,68976,,"ULIESTI",465,"SCOALA I-VIII JUGURENI, COMUNA ULIESTI, SAT JUGURENI",1361,852,837,15,0,843,9,1500,648,259,584,3,6704,0
16,"Dambovita",68976,154,68976,,"ULIESTI",466,"GRADINITA ULIESTI, SAT ULIESTI, STR. PRINCIPALA, NR. 14, CP 137445",0,208,0,208,0,206,2,400,192,73,133,3,6704,1
16,"Dambovita",65501,154,65501,,"ULMI",467,"SCOALA GENERALA ULMI - SAT ULMI",1022,612,599,13,0,604,8,1101,489,268,336,3,6713,0
16,"Dambovita",65501,154,65501,,"ULMI",468,"SCOALA PRIMARA DUMBRAVA COMUNA ULMI - SAT DUMBRAVA",830,547,533,14,0,538,9,901,354,321,217,3,6713,0
16,"Dambovita",65501,154,65501,,"ULMI",469,"SCOALA GENERALA VIISOARA COMUNA ULMI - SAT VIISOARA",1036,660,646,14,0,645,15,1151,491,295,350,3,6713,0
16,"Dambovita",65501,154,65501,,"ULMI",470,"GRADINITA MATRACA COMUNA ULMI - SAT MATRACA",512,347,331,16,0,343,4,551,204,141,202,3,6713,0
16,"Dambovita",65501,154,65501,,"ULMI",471,"SCOALA GENERALA ULMI, SAT ULMI, STR. PRINCIPALA, NR. 216 CP 137455",0,177,0,177,0,174,3,300,123,105,69,3,6713,1
16,"Dambovita",69063,154,69063,,"VALEA LUNGA",472,"SCOALA I-VIII  VALEA LUNGA-CRICOV COMUNA VALEA LUNGA - SAT VALEA LUNGA CRICOV",1051,700,684,14,2,690,10,1151,451,298,392,3,6726,0
16,"Dambovita",69063,154,69063,,"VALEA LUNGA",473,"SCOALA I-IV VALEA MARE COMUNA VALEA LUNGA - SAT VALEA MARE",458,304,292,12,0,300,4,550,246,192,108,3,6726,0
16,"Dambovita",69063,154,69063,,"VALEA LUNGA",474,"SCOALA I-IV VALEA LUNGA-OGREA COMUNA VALEA LUNGA - SAT VALEA LUNGA-OGREA",1079,747,724,23,0,738,9,1200,453,426,312,3,6726,0
16,"Dambovita",69063,154,69063,,"VALEA LUNGA",475,"SCOALA I-VIII MOSIA-MICA COMUNA VALEA LUNGA - SAT MOSIA MICA",1056,673,656,17,0,659,14,1201,528,387,272,3,6726,0
16,"Dambovita",69063,154,69063,,"VALEA LUNGA",476,"SCOALA I-IV  STUBEIE TISA COMUNA VALEA LUNGA - SAT STUBEIE-TISA",358,250,238,12,0,240,10,401,151,150,90,3,6726,0
16,"Dambovita",69063,154,69063,,"VALEA LUNGA",477,"SCOALA GENERALA  VALEA LUNGA-CRICOV,SAT VALEA LUNGA CRICOV, NR. 168, CP 137468 COMUNA VALEA LUNGA",0,138,0,138,0,137,1,502,364,77,60,3,6726,1
16,"Dambovita",69170,154,69170,,"VALEA MARE",478,"SCOALA DE ARTE SI MESERII  VALEA MARE - SAT VALEA MARE",1300,925,922,3,0,907,18,1400,475,415,492,3,6737,0
16,"Dambovita",69170,154,69170,,"VALEA MARE",479,"SCOALA I-IV  VALEA CASELOR COMUNA VALEA MARE - SAT VALEA CASELOR",652,467,458,9,0,464,3,701,234,202,262,3,6737,0
16,"Dambovita",69170,154,69170,,"VALEA MARE",480,"SCOALA DE ARTE SI MESERII  VALEA MARE, SAT VALEA MARE, CP 137485",0,179,0,179,0,176,3,301,122,80,96,3,6737,1
16,"Dambovita",69250,154,69250,,"VACARESTI",481,"SCOALA ""IANCU VACARESCU""  VACARESTI  - SAT VACARESTI",1373,721,707,14,0,714,7,1500,779,395,319,3,6722,0
16,"Dambovita",69250,154,69250,,"VACARESTI",482,"SCOALA ""IANCU VACARESCU""  VACARESTI - SAT VACARESTI",1184,625,615,10,0,618,7,1301,676,303,315,3,6722,0
16,"Dambovita",69250,154,69250,,"VACARESTI",483,"SCOALA  I-VIII BUNGETU COMUNA VACARESTI - SAT BUNGETU",1023,678,663,15,0,666,12,1150,472,255,411,3,6722,0
16,"Dambovita",69250,154,69250,,"VACARESTI",484,"SCOALA I-IV BRATESTII DE JOS COMUNA VACARESTI - SAT BRATESTII DE JOS",568,352,325,27,0,347,5,650,298,166,181,3,6722,0
16,"Dambovita",69250,154,69250,,"VACARESTI",485,"GRADINITA VACARESTI, SAT VACARESTI, STR. PRINCIPALA CP 137495",0,123,0,123,0,123,0,400,277,46,77,3,6722,1
16,"Dambovita",69303,154,69303,,"VALENI-DIMBOVITA",486,"SCOALA ""IOSIF GABREA"" (SALA 1) VALENI- DAMBOVITA - SAT VALENI DAMBOVITA",1225,800,796,4,0,794,6,1351,551,412,382,3,6745,0
16,"Dambovita",69303,154,69303,,"VALENI-DIMBOVITA",487,"SCOALA ""IOSIF GABREA"" VALENI- DAMBOVITA - SAT VALENI DAMBOVITA",859,535,530,5,0,532,3,950,415,268,264,3,6745,0
16,"Dambovita",69303,154,69303,,"VALENI-DIMBOVITA",488,"SCOALA  NOUA MESTEACAN COMUNA  VALENI-DAMBOVITA - SAT MESTEACAN",229,157,146,11,0,156,1,300,143,68,88,3,6745,0
16,"Dambovita",69303,154,69303,,"VALENI-DIMBOVITA",489,"SCOALA ""IOSIF GABREA"" VALENI- DAMBOVITA, SAT VALENI DAMBOVITA, CP 137500",0,98,0,98,0,97,1,200,102,56,41,3,6745,1
16,"Dambovita",69447,154,69447,,"VIRFURI",490,"CAMINUL CULTURAL VIRFURI SATUL SUVITA",1631,902,894,8,0,890,12,1801,899,539,351,3,6748,0
16,"Dambovita",69447,154,69447,,"VIRFURI",491,"GRADINITA SUVITA, SAT SUVITA, NR. 135, CP 137505, COMUNA VARFURI",0,66,0,66,0,66,0,201,135,39,27,3,6748,1
16,"Dambovita",69330,154,69330,,"VISINA",492,"GRADINITA NR. 1  VISINA, STR. MIHAI VITEAZU, NR. 27, - SAT VISINA",1006,681,673,8,0,658,23,1100,419,266,392,3,6756,0
16,"Dambovita",69330,154,69330,,"VISINA",493,"CAMINUL CULTURAL  VISINA, STR. MIHAI VITEAZU, NR. 95 - SAT VISINA",1378,949,906,43,0,931,18,1499,550,368,563,3,6756,0
16,"Dambovita",69330,154,69330,,"VISINA",494,"SCOALA  I-VIII BROSTENI, STR. SCHITULUI , NR. 59 COMUNA VISINA - SAT BROSTENI",969,610,595,15,0,601,9,1101,491,213,388,3,6756,0
16,"Dambovita",69330,154,69330,,"VISINA",495,"LICEUL ""MIHAI VITEAZU"" VISINA, SAT VISINA, STR. MIHAI VITEAZU, NR. 93, CP 137515",0,200,0,200,0,198,2,400,200,102,96,3,6756,1
16,"Dambovita",69394,154,69394,,"VISINESTI",496,"SCOALA  VISINESTI - SAT VISINESTI",914,612,582,7,23,603,9,1000,388,352,251,3,6760,0
16,"Dambovita",69394,154,69394,,"VISINESTI",497,"SCOALA  URSEIU COMUNA  VISINESTI - SAT URSEIU",602,419,391,11,17,414,5,650,231,226,188,3,6760,0
16,"Dambovita",69394,154,69394,,"VISINESTI",498,"SCOALA  SULTANU  COMUNA  VISINESTI - SAT SULTANU",299,212,189,8,15,209,3,350,138,145,64,3,6760,0
16,"Dambovita",69394,154,69394,,"VISINESTI",499,"SCOALA  GENERALA VISINESTI - SAT VISINESTI, STR. PRTINCIPALA, CP 137520",0,128,0,128,0,127,1,300,172,71,56,3,6760,1
16,"Dambovita",179711,154,179711,,"VLADENI",500,"SCOALA I-VIII  ""STAN STEFAN"" VLADENI STR. PRINCIPALA, NR. 719 - SAT VLADENI",1217,854,829,25,0,833,21,1350,496,411,422,3,6765,0
16,"Dambovita",179711,154,179711,,"VLADENI",501,"CAMINUL CULTURAL  VLADENI, STR. PRINCIPALA, NR. 718 - SAT VLADENI",1016,715,706,9,0,704,11,1151,436,338,366,3,6765,0
16,"Dambovita",179711,154,179711,,"VLADENI",502,"SCOALA I-VIII  VLADENI, SAT VLADENI STR. PRINCIPALA, NR. 719 ,CP 137187",0,126,0,126,0,123,3,200,74,71,52,3,6765,1
16,"Dambovita",69526,154,69526,,"VOINESTI",503,"GRADINITA  ONCESTI STR. SCOLII NR.92 COMUNA VOINESTI - SAT ONCESTI",666,462,451,11,0,455,7,750,288,180,275,3,6767,0
16,"Dambovita",69526,154,69526,,"VOINESTI",504,"CAMINUL CULTURAL GEMENEA-BRATULESTI STR. PRINCIPALA NR.419 COMUNA VOINESTI - SAT GEMENEA BRATULESTI",1004,712,688,24,0,706,6,1100,388,308,398,3,6767,0
16,"Dambovita",69526,154,69526,,"VOINESTI",505,"SCOALA I-VIII VOINESTI STR. POSTEI NR.591 - SAT VOINESTI",1342,883,866,17,0,874,9,1451,568,263,611,3,6767,0
16,"Dambovita",69526,154,69526,,"VOINESTI",506,"SCOALA I-VIII SUDULENI STR. INV. ELENA DRAGHICI NR.8 COMUNA VOINESTI - SAT SUDULENI",1301,850,819,31,0,829,21,1451,601,308,521,3,6767,0
16,"Dambovita",69526,154,69526,,"VOINESTI",507,"SCOALA I-IV MANGA STR. PRINCIPALA NR. 86 COMUNA VOINESTI - SAT MANGA",644,407,397,10,0,403,4,751,344,157,246,3,6767,0
16,"Dambovita",69526,154,69526,,"VOINESTI",508,"CASA DE CULTURA ""RODICA BUJOR"" VOINESTI, SAT VOINESTI, STR. PRINCIPALA NR. 145, CP 137525",0,271,0,271,0,269,2,600,329,101,168,3,6767,1
16,"Dambovita",69615,154,69615,,"VULCANA-BAI",509,"GRADINITA  VULCANA- BAI STR. VLAD TEPES NR.2 - SAT VULCANA BAI",1281,793,776,10,7,783,10,1401,608,287,496,3,6776,0
16,"Dambovita",69615,154,69615,,"VULCANA-BAI",510,"GRADINITA  VULCANA DE SUS STR. T. VLADIMIRESCU NR. 38 COMUNA VULCANA BAI - SAT VULCANA DE SUS",1135,670,663,7,0,659,11,1200,530,398,261,3,6776,0
16,"Dambovita",69615,154,69615,,"VULCANA-BAI",511,"GRADINITA  VULCANA- BAI, SAT VULCANA-BAI,  STR. VLAD TEPES NR.2, CP 137535",0,56,0,56,0,54,2,300,244,14,40,3,6776,1
16,"Dambovita",179640,154,179640,,"VULCANA-PANDELE",512,"CAMINUL CULTURAL VULCANA-PANDELE STR. PRINCIPALA NR. 9 - SAT VULCANA PANDELE",1230,808,772,36,0,803,5,1350,542,281,522,3,6780,0
16,"Dambovita",179640,154,179640,,"VULCANA-PANDELE",513,"SCOALA GENERALA  VULCANA-PANDELE STR. BISERICII NR.1 -  SAT VULCANA PANDELE",1220,663,648,14,1,649,14,1350,687,259,390,3,6780,0
16,"Dambovita",179640,154,179640,,"VULCANA-PANDELE",514,"SCOALA GENERALA GURA VULCANEI STR. VALEA NEAGRA NR.1 COMUNA VULCANA PANDELE - SAT GURA VULCANEI",895,565,541,24,0,553,12,1000,435,190,363,3,6780,0
16,"Dambovita",179640,154,179640,,"VULCANA-PANDELE",515,"SCOALA GENERALA GURA VULCANEI STR. VALEA NEAGRA NR.1 COMUNA VULCANA PANDELE - SAT GURA VULCANEI",794,479,459,20,0,472,7,901,422,172,300,3,6780,0
16,"Dambovita",179640,154,179640,,"VULCANA-PANDELE",516,"SCOALA I-VIII VULCANA PANDELE, SAT VULCANA-PANDELE STR. BISERICII NR.1, CP 137540",0,133,0,133,0,132,1,300,167,77,55,3,6780,1
17,"Dolj",69900,163,69900,,"MUNICIPIUL CRAIOVA",1,"Colegiul National ""Elena Cuza"", Str. Mihai Viteazul nr. 12",1428,890,879,11,0,881,9,1509,619,319,562,1,6786,0
17,"Dolj",69900,163,69900,,"MUNICIPIUL CRAIOVA",2,"Casa Studentilor, Str. Eugeniu Carada nr. 10",1761,966,952,14,0,955,11,1900,934,412,543,1,6786,0
17,"Dolj",69900,163,69900,,"MUNICIPIUL CRAIOVA",3,"Regia Autonoma Termoficare Craiova, Str. Mitropolit Firmilian nr. 14",1722,901,894,5,2,891,10,1900,999,409,482,1,6786,0
17,"Dolj",69900,163,69900,,"MUNICIPIUL CRAIOVA",4,"Liceul  cu Program Sportiv ""Petrache Triscu"", Str. Tudor Vladimirescu nr. 9",1803,1057,1040,17,0,1041,16,1900,843,445,596,1,6786,0
17,"Dolj",69900,163,69900,,"MUNICIPIUL CRAIOVA",5,"Grupul scolar ""Traian Vuia"", Str. Rovinari nr. 1A",1231,748,730,18,0,741,7,1300,552,292,449,1,6786,0
17,"Dolj",69900,163,69900,,"MUNICIPIUL CRAIOVA",6,"Grupul scolar ""Traian Vuia"", Str. Rovinari nr. 1A",1133,673,651,22,0,666,7,1187,514,246,420,1,6786,0
17,"Dolj",69900,163,69900,,"MUNICIPIUL CRAIOVA",7,"Liceul Teoretic ""Charles Laugier"", Str.Imparatul Traian nr. 39",1846,1152,1136,13,3,1142,10,2000,848,476,666,1,6786,0
17,"Dolj",69900,163,69900,,"MUNICIPIUL CRAIOVA",8,"Liceul Teoretic ""Charles Laugier"", Str.Imparatul Traian nr. 39",1901,1162,1147,14,1,1150,12,2000,838,442,708,1,6786,0
17,"Dolj",69900,163,69900,,"MUNICIPIUL CRAIOVA",9,"Universitate, Str. A. I. Cuza nr. 13",1198,730,716,13,1,721,9,1300,570,307,414,1,6786,0
17,"Dolj",69900,163,69900,,"MUNICIPIUL CRAIOVA",10,"Universitate, Str. A. I. Cuza nr. 13",1040,688,676,12,0,675,13,1100,412,261,414,1,6786,0
17,"Dolj",69900,163,69900,,"MUNICIPIUL CRAIOVA",11,"Scoala cu clasele I-VIII nr. 22 ""Mircea Eliade"", Str. Closca nr. 1",1349,811,800,11,0,802,9,1486,675,346,456,1,6786,0
17,"Dolj",69900,163,69900,,"MUNICIPIUL CRAIOVA",12,"Scoala cu clasele I-VIII nr. 22 ""Mircea Eliade"", Str. Closca nr. 1",1647,1047,1031,16,0,1035,12,1800,753,407,628,1,6786,0
17,"Dolj",69900,163,69900,,"MUNICIPIUL CRAIOVA",13,"Gradinita de copii cu program prelungit nr.37 ""Dumbrava Minunata"", Str. Putnei nr. 50",1899,1134,1121,12,1,1112,22,2000,866,418,694,1,6786,0
17,"Dolj",69900,163,69900,,"MUNICIPIUL CRAIOVA",14,"Gradinita de copii cu program prelungit nr.37 ""Dumbrava Minunata"", Str. Putnei nr. 50",1946,1034,1021,13,0,1022,12,2000,966,468,554,1,6786,0
17,"Dolj",69900,163,69900,,"MUNICIPIUL CRAIOVA",15,"Scoala cu clasele I-VIII nr.37 ""Mihai Eminescu"" , Str. Ion Tuculescu nr. 3",1383,760,751,9,0,756,4,1500,740,365,391,1,6786,0
17,"Dolj",69900,163,69900,,"MUNICIPIUL CRAIOVA",16,"Scoala cu clasele I-VIII nr.37 ""Mihai Eminescu"" , Str. Ion Tuculescu nr. 3",1523,790,777,13,0,783,7,1600,810,336,447,1,6786,0
17,"Dolj",69900,163,69900,,"MUNICIPIUL CRAIOVA",17,"Scoala cu clasele I-VIII nr.37 ""Mihai Eminescu"" , Str. Ion Tuculescu nr. 3",1390,692,683,9,0,685,7,1500,808,342,343,1,6786,0
17,"Dolj",69900,163,69900,,"MUNICIPIUL CRAIOVA",18,"Gradinita nr. 55 Lapus, Str. Ion Tuculescu nr. 12",1075,610,599,11,0,603,7,1200,590,271,332,1,6786,0
17,"Dolj",69900,163,69900,,"MUNICIPIUL CRAIOVA",19,"Gradinita nr. 55 Lapus, Str. Ion Tuculescu nr. 12",1271,628,615,13,0,620,8,1400,772,346,274,1,6786,0
17,"Dolj",69900,163,69900,,"MUNICIPIUL CRAIOVA",20,"Liceul Teoretic ""Henri Coanda"" , Str. Henri Coanda nr. 48",1787,858,843,14,1,849,9,1900,1042,386,463,1,6786,0
17,"Dolj",69900,163,69900,,"MUNICIPIUL CRAIOVA",21,"Colegiul Tehnic ""Ion Mincu"", Str. Henri Coanda nr. 48",1589,898,880,17,1,895,3,1700,802,358,537,1,6786,0
17,"Dolj",69900,163,69900,,"MUNICIPIUL CRAIOVA",22,"Colegiul Tehnic ""Ion Mincu"", Str. Henri Coanda nr. 48",1532,847,828,18,1,843,4,1700,853,360,483,1,6786,0
17,"Dolj",69900,163,69900,,"MUNICIPIUL CRAIOVA",23,"Grupul scolar de Arta si Meserii ""Spiru Haret"", Str. Electroputere nr. 2",1898,1090,1078,11,1,1081,9,2000,910,512,569,1,6786,0
17,"Dolj",69900,163,69900,,"MUNICIPIUL CRAIOVA",24,"Grupul scolar Industrial Electroputere, Str. Electroputere nr. 21",1971,998,973,24,1,991,7,2100,1102,424,567,1,6786,0
17,"Dolj",69900,163,69900,,"MUNICIPIUL CRAIOVA",25,"Liceul de Informatica  ""Stefan Odobleja"", Str. Electroputere nr  21",1764,794,782,12,0,788,6,1900,1106,349,439,1,6786,0
17,"Dolj",69900,163,69900,,"MUNICIPIUL CRAIOVA",26,"Gradinita de copii cu program prelungit nr. 41 ""Elena Farago"", Str. Revolutiei nr. 15",1005,532,523,9,0,528,4,1100,568,228,300,1,6786,0
17,"Dolj",69900,163,69900,,"MUNICIPIUL CRAIOVA",27,"Gradinita de copii cu program prelungit nr. 41 ""Elena Farago"", Str. Revolutiei nr. 15",1389,689,677,12,0,683,6,1500,811,326,357,1,6786,0
17,"Dolj",69900,163,69900,,"MUNICIPIUL CRAIOVA",28,"Scoala cu clasele I-VIII nr. 31 ""Theodor Aman"", Str. Vantului nr. 3",1682,1019,1009,10,0,1012,7,1800,781,477,535,1,6786,0
17,"Dolj",69900,163,69900,,"MUNICIPIUL CRAIOVA",29,"Gradinita de copii cu program prelungit nr. 42  ""Ion Creanga"", Str. Vantului nr. 10",1412,798,782,16,0,794,4,1500,702,340,454,1,6786,0
17,"Dolj",69900,163,69900,,"MUNICIPIUL CRAIOVA",30,"Scoala cu clasele I-VIII nr. 29  ""Nicolae Romanescu"", Str. Caracal nr. 81",1706,774,760,14,0,769,5,1800,1026,360,409,1,6786,0
17,"Dolj",69900,163,69900,,"MUNICIPIUL CRAIOVA",31,"Scoala cu clasele I-VIII nr. 29  ""Nicolae Romanescu"", Str. Caracal nr. 81",1465,788,774,14,0,781,7,1600,812,317,464,1,6786,0
17,"Dolj",69900,163,69900,,"MUNICIPIUL CRAIOVA",32,"Scoala cu clasele I-VIII nr. 29  ""Nicolae Romanescu"", Str. Caracal nr. 81",1453,675,659,16,0,666,9,1600,925,316,350,1,6786,0
17,"Dolj",69900,163,69900,,"MUNICIPIUL CRAIOVA",33,"Facultatea de Medicina si Farmacie, str. Petru Rares nr. 2",1137,646,640,6,0,642,4,1200,554,284,358,1,6786,0
17,"Dolj",69900,163,69900,,"MUNICIPIUL CRAIOVA",34,"Facultatea de Medicina si Farmacie, str. Petru Rares nr. 2",1095,585,571,14,0,577,8,1200,615,258,319,1,6786,0
17,"Dolj",69900,163,69900,,"MUNICIPIUL CRAIOVA",35,"Grupul scolar de Transporturi Auto, Bulevardul Nicolae Romanescu nr. 99",2041,1072,1043,29,0,1053,19,2200,1128,544,509,1,6786,0
17,"Dolj",69900,163,69900,,"MUNICIPIUL CRAIOVA",36,"Grupul scolar de Transporturi Auto, Bulevardul Nicolae Romanescu nr. 99",1991,898,880,18,0,886,12,2100,1202,475,411,1,6786,0
17,"Dolj",69900,163,69900,,"MUNICIPIUL CRAIOVA",37,"Grupul scolar de Transporturi Auto, Bulevardul Nicolae Romanescu nr. 99",1913,940,925,15,0,924,16,2100,1160,491,433,1,6786,0
17,"Dolj",69900,163,69900,,"MUNICIPIUL CRAIOVA",38,"Scoala cu clasele I-VIII nr. 25 Facai, Str. Prelungirea Bechetului nr. 3",972,442,427,15,0,433,9,1100,658,238,195,1,6786,0
17,"Dolj",69900,163,69900,,"MUNICIPIUL CRAIOVA",39,"Scoala cu clasele I-IV nr. 27 Popoveni, soseaua Popoveni nr.3",815,461,448,13,0,455,6,900,439,225,230,1,6786,0
17,"Dolj",69900,163,69900,,"MUNICIPIUL CRAIOVA",40,"Scoala cu clasele I-VIII nr. 36 ""Gheorghe Bibescu"", Str. Dr. Ionescu Sisesti nr.3",1513,851,839,12,0,847,4,1600,749,369,478,1,6786,0
17,"Dolj",69900,163,69900,,"MUNICIPIUL CRAIOVA",41,"Scoala cu clasele I-VIII nr. 36 ""Gheorghe Bibescu"", Str. Dr. Ionescu Sisesti nr.3",1873,956,947,9,0,951,5,2000,1044,359,592,1,6786,0
17,"Dolj",69900,163,69900,,"MUNICIPIUL CRAIOVA",42,"Scoala  cu clasele I-VIII nr. 36 ""Gheorghe Bibescu"", Str. Dr. Ionescu Sisesti nr.3",1875,1009,997,11,1,999,10,2000,991,484,515,1,6786,0
17,"Dolj",69900,163,69900,,"MUNICIPIUL CRAIOVA",43,"Scoala  cu clasele I-VIII nr. 36 ""Gheorghe Bibescu"", Str. Dr. Ionescu Sisesti nr. 3",1650,890,873,17,0,884,6,1800,910,390,494,1,6786,0
17,"Dolj",69900,163,69900,,"MUNICIPIUL CRAIOVA",44,"Colegiul National Economic ""Gheorghe Chitu"", Str. Dr. Dimitrie Gerota nr. 22",1642,848,835,13,0,841,7,1800,952,374,467,1,6786,0
17,"Dolj",69900,163,69900,,"MUNICIPIUL CRAIOVA",45,"Colegiul National Economic ""Gheorghe Chitu"", Str. Dr. Dimitrie Gerota nr. 22",1506,782,773,9,0,772,10,1600,818,378,394,1,6786,0
17,"Dolj",69900,163,69900,,"MUNICIPIUL CRAIOVA",46,"Colegiul National Economic ""Gheorghe Chitu"", Str. Dr. Dimitrie Gerota nr. 22",1771,982,969,13,0,978,4,1900,918,418,560,1,6786,0
17,"Dolj",69900,163,69900,,"MUNICIPIUL CRAIOVA",47,"Universitatea de Medicina si Farmacie - cladirea noua, Bulevardul 1 Mai nr. 66",1742,988,973,15,0,975,13,1800,812,452,523,1,6786,0
17,"Dolj",69900,163,69900,,"MUNICIPIUL CRAIOVA",48,"Scoala cu clasele I-VIII nr.18 ""Sfantul Dumitru"", Str. Unirii nr. 162",1303,851,839,12,0,841,10,1400,549,405,436,1,6786,0
17,"Dolj",69900,163,69900,,"MUNICIPIUL CRAIOVA",49,"Liceul de Arta ""Marin Sorescu"", Str. Marin Sorescu nr. 4",971,635,621,13,1,625,10,1100,465,274,351,1,6786,0
17,"Dolj",69900,163,69900,,"MUNICIPIUL CRAIOVA",50,"Liceul de Arta ""Marin Sorescu"", Str. Marin Sorescu nr. 4",1876,1072,1053,19,0,1063,9,2000,928,507,556,1,6786,0
17,"Dolj",69900,163,69900,,"MUNICIPIUL CRAIOVA",51,"Colegiul National ""Fratii Buzesti"", Str. Stirbei Voda nr. 5",1998,1133,1123,10,0,1121,12,2100,967,464,657,1,6786,0
17,"Dolj",69900,163,69900,,"MUNICIPIUL CRAIOVA",52,"Colegiul National ""Fratii Buzesti"", Str. Stirbei Voda nr. 5",1976,1109,1097,12,0,1095,14,2100,991,470,625,1,6786,0
17,"Dolj",69900,163,69900,,"MUNICIPIUL CRAIOVA",53,"Scoala cu clasele I-VIII nr. 19, Str. Baraganului nr. 45",2072,1042,1030,12,0,1036,6,2200,1158,484,552,1,6786,0
17,"Dolj",69900,163,69900,,"MUNICIPIUL CRAIOVA",54,"Scoala cu clasele I-VIII nr. 19, Str. Baraganului nr. 45",1989,1022,1004,18,0,1017,5,2100,1078,463,554,1,6786,0
17,"Dolj",69900,163,69900,,"MUNICIPIUL CRAIOVA",55,"Scoala cu clasele I-VIII nr. 19, Str. Baraganului nr. 45",1976,1031,1013,17,1,1017,14,2097,1066,497,520,1,6786,0
17,"Dolj",69900,163,69900,,"MUNICIPIUL CRAIOVA",56,"Scoala cu clasele I-VIII nr. 26 Mofleni, Str. Banu Stepan nr. 20",1211,582,566,15,1,578,4,1306,724,292,286,1,6786,0
17,"Dolj",69900,163,69900,,"MUNICIPIUL CRAIOVA",57,"S.C. pentru Lucrari de Drumuri si Poduri Dolj S.A., Str. Drumul Jiului, nr. 10",1964,562,544,16,2,554,8,2100,1538,233,321,1,6786,0
17,"Dolj",69900,163,69900,,"MUNICIPIUL CRAIOVA",58,"Scoala cu clasele I-VIII nr. 13 Bucovat, Str. Bucovat nr. 76",1804,673,656,16,1,667,6,1900,1227,362,305,1,6786,0
17,"Dolj",69900,163,69900,,"MUNICIPIUL CRAIOVA",59,"Colegiul National ""Carol  I"", Str. Ion Maiorescu nr. 2",1108,691,677,14,0,684,7,1200,509,273,411,1,6786,0
17,"Dolj",69900,163,69900,,"MUNICIPIUL CRAIOVA",60,"Colegiul National ""Carol  I"", Str. Ion Maiorescu nr. 2",1345,736,718,17,1,724,12,1493,757,374,350,1,6786,0
17,"Dolj",69900,163,69900,,"MUNICIPIUL CRAIOVA",61,"Facultatea de Agricultura, Str. Libertatii nr. 19",1980,961,948,13,0,953,8,2100,1139,438,515,1,6786,0
17,"Dolj",69900,163,69900,,"MUNICIPIUL CRAIOVA",62,"Facultatea de Agricultura, Str. Libertatii nr. 19",1887,1117,1100,17,0,1104,13,2000,883,504,600,1,6786,0
17,"Dolj",69900,163,69900,,"MUNICIPIUL CRAIOVA",63,"Gradinita de copii cu program prelungit nr. 24, Str. Renasterii nr. 1",1146,549,541,8,0,537,12,1287,738,257,280,1,6786,0
17,"Dolj",69900,163,69900,,"MUNICIPIUL CRAIOVA",64,"Gradinita de copii cu program prelungit nr. 24, Str. Renasterii nr. 1",1126,676,668,8,0,670,6,1181,505,311,359,1,6786,0
17,"Dolj",69900,163,69900,,"MUNICIPIUL CRAIOVA",65,"Grupul scolar ""Ilie Murgulescu"", Str. Brestei nr. 144",1922,1052,1037,15,0,1041,11,2100,1048,467,574,1,6786,0
17,"Dolj",69900,163,69900,,"MUNICIPIUL CRAIOVA",66,"Grupul scolar ""Ilie Murgulescu"", Str. Brestei nr. 144",1759,702,692,10,0,700,2,1700,998,311,389,1,6786,0
17,"Dolj",69900,163,69900,,"MUNICIPIUL CRAIOVA",67,"Grupul scolar ""Ilie Murgulescu"", Str. Brestei nr. 144",1835,869,859,10,0,860,9,2000,1131,400,460,1,6786,0
17,"Dolj",69900,163,69900,,"MUNICIPIUL CRAIOVA",68,"Scoala cu clasele I-VIII nr. 16, Str. Brestei nr. 234",2014,934,912,21,1,925,9,2100,1166,469,456,1,6786,0
17,"Dolj",69900,163,69900,,"MUNICIPIUL CRAIOVA",69,"Scoala cu clasele I-VIII nr. 16, Str. Brestei nr. 234",1967,970,963,7,0,963,7,2100,1130,454,509,1,6786,0
17,"Dolj",69900,163,69900,,"MUNICIPIUL CRAIOVA",70,"Gradinita de copii cu program normal nr.15, Str. Brestei nr. 342",2023,954,940,14,0,943,11,2100,1146,480,463,1,6786,0
17,"Dolj",69900,163,69900,,"MUNICIPIUL CRAIOVA",71,"Regia Autonoma de Transport Craiova, Sectia 2 -  Depou Tramvai , Bulevardul Dacia nr. 3",1759,907,898,9,0,898,9,1900,993,415,483,1,6786,0
17,"Dolj",69900,163,69900,,"MUNICIPIUL CRAIOVA",72,"Scoala cu clasele I-VIII nr. 34 ""Eugeniu Carada"", Str. Elena Farago nr. 53",1617,850,838,12,0,844,6,1700,850,394,450,1,6786,0
17,"Dolj",69900,163,69900,,"MUNICIPIUL CRAIOVA",73,"Scoala cu clasele I-VIII nr. 34 ""Eugeniu Carada"", Str. Elena Farago nr. 53",1666,762,748,14,0,757,5,1800,1038,384,373,1,6786,0
17,"Dolj",69900,163,69900,,"MUNICIPIUL CRAIOVA",74,"Scoala cu clasele I-VIII nr. 34 ""Eugeniu Carada"", Str. Elena Farago nr. 53",1619,785,771,14,0,772,13,1700,915,327,445,1,6786,0
17,"Dolj",69900,163,69900,,"MUNICIPIUL CRAIOVA",75,"Scoala cu clasele I-VIII nr. 34 ""Eugeniu Carada"", Str. Elena Farago nr. 53",1824,924,918,6,0,917,7,2000,1076,408,509,1,6786,0
17,"Dolj",69900,163,69900,,"MUNICIPIUL CRAIOVA",76,"Scoala cu clasele I-VIII nr. 33, Str. Elena Farago nr. 19",1956,942,935,7,0,933,9,2100,1158,412,521,1,6786,0
17,"Dolj",69900,163,69900,,"MUNICIPIUL CRAIOVA",77,"Scoala cu clasele I-VIII nr. 33, Str. Elena Farago nr. 19",1874,1010,991,19,0,1003,7,2000,990,446,557,1,6786,0
17,"Dolj",69900,163,69900,,"MUNICIPIUL CRAIOVA",78,"Scoala cu clasele I-VIII nr. 33, Str. Elena Farago nr. 19",1817,892,880,12,0,890,2,2000,1108,423,467,1,6786,0
17,"Dolj",69900,163,69900,,"MUNICIPIUL CRAIOVA",79,"Gradinita de copii cu program prelungit nr. 45, Str. Elena Farago nr. 17",1882,964,951,13,0,955,9,2000,1036,414,541,1,6786,0
17,"Dolj",69900,163,69900,,"MUNICIPIUL CRAIOVA",80,"Gradinita de copii cu program prelungit nr. 45, Str. Elena Farago nr. 17",1294,639,629,9,1,638,1,1400,761,306,332,1,6786,0
17,"Dolj",69900,163,69900,,"MUNICIPIUL CRAIOVA",81,"Gradinita de copii cu program prelungit nr. 45, Str. Elena Farago nr. 17",1202,580,568,11,1,575,5,1300,720,269,306,1,6786,0
17,"Dolj",69900,163,69900,,"MUNICIPIUL CRAIOVA",82,"Gradinita de copii cu program prelungit nr. 51, Str. Nicolae Coculescu nr. 20",1412,765,751,14,0,756,9,1459,694,337,419,1,6786,0
17,"Dolj",69900,163,69900,,"MUNICIPIUL CRAIOVA",83,"Gradinita de copii cu program prelungit nr. 51, Str. Nicolae Coculescu nr. 20",1484,695,681,14,0,690,5,1600,905,303,387,1,6786,0
17,"Dolj",69900,163,69900,,"MUNICIPIUL CRAIOVA",84,"Gradinita de copii cu program prelungit nr. 51, Str. Nicolae Coculescu nr. 20",1470,741,727,14,0,734,7,1600,859,361,373,1,6786,0
17,"Dolj",69900,163,69900,,"MUNICIPIUL CRAIOVA",85,"Scoala cu clasele I-VIII nr. 32  ""Alexandru Macedonski"", Str. Castanilor nr.4",1819,906,888,18,0,900,6,2000,1094,452,448,1,6786,0
17,"Dolj",69900,163,69900,,"MUNICIPIUL CRAIOVA",86,"Scoala cu clasele I-VIII nr. 32  ""Alexandru Macedonski"", Str. Castanilor nr.4",1865,952,941,11,0,946,6,2000,1048,426,520,1,6786,0
17,"Dolj",69900,163,69900,,"MUNICIPIUL CRAIOVA",87,"Scoala cu clasele I-VIII nr. 32  ""Alexandru Macedonski"", Str. Castanilor nr.4",1973,892,878,14,0,879,13,2100,1208,395,484,1,6786,0
17,"Dolj",69900,163,69900,,"MUNICIPIUL CRAIOVA",88,"Scoala cu clasele I-VIII nr. 32  ""Alexandru Macedonski"", Str. Castanilor nr.4",1815,937,923,14,0,928,9,2000,1063,401,527,1,6786,0
17,"Dolj",69900,163,69900,,"MUNICIPIUL CRAIOVA",89,"Gradinita de copii cu program prelungit nr. 40, Str. Tineretului nr. 28",1546,706,696,10,0,700,6,1700,994,330,370,1,6786,0
17,"Dolj",69900,163,69900,,"MUNICIPIUL CRAIOVA",90,"Gradinita de copii cu program prelungit nr. 40, Str. Tineretului nr. 28",1790,879,866,13,0,874,5,1900,1021,395,479,1,6786,0
17,"Dolj",69900,163,69900,,"MUNICIPIUL CRAIOVA",91,"Scoala cu clasele I-VIII nr. 30 ""Mihai Viteazul"", Str. Arhitect Duiliu Marcu nr. 16",1586,791,779,12,0,785,6,1700,909,409,376,1,6786,0
17,"Dolj",69900,163,69900,,"MUNICIPIUL CRAIOVA",92,"Scoala cu clasele I-VIII nr. 30 ""Mihai Viteazul"", Str. Arhitect Duiliu Marcu nr. 16",1755,829,816,11,2,823,6,1800,971,355,468,1,6786,0
17,"Dolj",69900,163,69900,,"MUNICIPIUL CRAIOVA",93,"Scoala cu clasele I-VIII nr. 30 ""Mihai Viteazul"", Str. Arhitect Duiliu Marcu nr. 16",1665,848,837,11,0,840,8,1800,952,400,440,1,6786,0
17,"Dolj",69900,163,69900,,"MUNICIPIUL CRAIOVA",94,"Scoala cu clasele I-VIII nr. 30 ""Mihai Viteazul"", Str. Arhitect Duiliu Marcu nr. 16",1531,796,789,7,0,789,7,1600,804,385,404,1,6786,0
17,"Dolj",69900,163,69900,,"MUNICIPIUL CRAIOVA",95,"Scoala cu clasele I-VIII nr. 30 ""Mihai Viteazul"", Str. Arhitect Duiliu Marcu nr. 16",1573,813,800,13,0,810,3,1700,887,370,440,1,6786,0
17,"Dolj",69900,163,69900,,"MUNICIPIUL CRAIOVA",96,"Grupul scolar ICM ""George Bibescu"", Str. C. Brancoveanu nr. 101",1376,663,651,12,0,658,5,1500,837,284,374,1,6786,0
17,"Dolj",69900,163,69900,,"MUNICIPIUL CRAIOVA",97,"Grupul scolar ICM ""George Bibescu"", Str. C. Brancoveanu nr. 101",1333,646,633,12,1,644,2,1400,754,273,371,1,6786,0
17,"Dolj",69900,163,69900,,"MUNICIPIUL CRAIOVA",98,"Gradinita de copii cu program prelungit nr. 52, Bulevardul Oltenia nr. 81",1409,703,695,8,0,700,3,1498,795,310,390,1,6786,0
17,"Dolj",69900,163,69900,,"MUNICIPIUL CRAIOVA",99,"Gradinita de copii cu program prelungit nr. 52, Bulevardul Oltenia nr. 81",1273,671,660,11,0,665,6,1400,729,308,357,1,6786,0
17,"Dolj",69900,163,69900,,"MUNICIPIUL CRAIOVA",100,"Grupul scolar Industrial de Chimie ""Costin D. Nenitescu"", Str. Pascani nr. 9",1805,1036,1015,19,2,1024,12,1900,864,425,599,1,6786,0
17,"Dolj",69900,163,69900,,"MUNICIPIUL CRAIOVA",101,"Grupul scolar Industrial de Chimie ""Costin D. Nenitescu"", Str. Pascani nr. 9",1693,861,855,6,0,852,9,1800,939,364,488,1,6786,0
17,"Dolj",69900,163,69900,,"MUNICIPIUL CRAIOVA",102,"Grupul scolar Industrial de Chimie ""Costin D. Nenitescu"", Str. Pascani nr. 9",1582,830,820,10,0,824,6,1700,870,328,496,1,6786,0
17,"Dolj",69900,163,69900,,"MUNICIPIUL CRAIOVA",103,"Grupul scolar Industrial de Chimie ""Costin D. Nenitescu"", Str. Pascani nr. 9",1511,784,774,10,0,780,4,1600,816,371,409,1,6786,0
17,"Dolj",69900,163,69900,,"MUNICIPIUL CRAIOVA",104,"Grupul scolar Industrial de Chimie ""Costin D. Nenitescu"", Str. Pascani nr. 9",1731,890,875,15,0,883,7,1900,1010,411,472,1,6786,0
17,"Dolj",69900,163,69900,,"MUNICIPIUL CRAIOVA",105,"Scoala cu clasele I-VIII nr. 12 ""Decebal"", Bulevardul Nicolae Titulescu nr. 64",1692,913,903,9,1,905,8,1800,887,368,537,1,6786,0
17,"Dolj",69900,163,69900,,"MUNICIPIUL CRAIOVA",106,"Scoala cu clasele I-VIII nr. 12 ""Decebal"", Bulevardul Nicolae Titulescu nr. 64",1519,905,891,14,0,900,5,1600,695,353,547,1,6786,0
17,"Dolj",69900,163,69900,,"MUNICIPIUL CRAIOVA",107,"Scoala cu clasele I-VIII nr. 12 ""Decebal"", Bulevardul Nicolae Titulescu nr. 64",1593,855,846,9,0,849,6,1700,845,354,495,1,6786,0
17,"Dolj",69900,163,69900,,"MUNICIPIUL CRAIOVA",108,"Grupul scolar Industrial Energetic, Str. Amaradiei nr. 59",1552,907,883,23,1,902,5,1700,793,416,486,1,6786,0
17,"Dolj",69900,163,69900,,"MUNICIPIUL CRAIOVA",109,"Grupul scolar Industrial Energetic, Str. Amaradiei nr. 59",1668,880,868,12,0,870,10,1800,920,376,494,1,6786,0
17,"Dolj",69900,163,69900,,"MUNICIPIUL CRAIOVA",110,"Grupul scolar Industrial Energetic, Str. Amaradiei nr. 59",1442,776,763,13,0,767,7,1597,823,300,467,1,6786,0
17,"Dolj",69900,163,69900,,"MUNICIPIUL CRAIOVA",111,"Colegiul National  ""Stefan Velovan"", Str. Amaradiei nr.72",1846,1003,991,11,1,983,20,2000,997,457,526,1,6786,0
17,"Dolj",69900,163,69900,,"MUNICIPIUL CRAIOVA",112,"Colegiul National  ""Stefan Velovan"", Str. Amaradiei nr.72",1812,1041,1030,10,1,1029,12,1900,859,427,602,1,6786,0
17,"Dolj",69900,163,69900,,"MUNICIPIUL CRAIOVA",113,"Gradinita nr.43, Str. General Stefan Falcoianu nr. 6",1781,942,911,31,0,936,6,1900,958,423,513,1,6786,0
17,"Dolj",69900,163,69900,,"MUNICIPIUL CRAIOVA",114,"Gradinita de copii cu program prelungit nr. 43, Str. General Stefan Falcoianu nr. 6",1715,946,928,16,2,930,16,1802,856,406,524,1,6786,0
17,"Dolj",69900,163,69900,,"MUNICIPIUL CRAIOVA",115,"Gradinita de copii cu program prelungit nr. 32, Str. Colonel Scarlat Demetriade nr. 1",1646,952,933,17,2,947,5,1800,848,399,548,1,6786,0
17,"Dolj",69900,163,69900,,"MUNICIPIUL CRAIOVA",116,"Gradinita de copii cu program prelungit nr. 32, Str. Colonel Scarlat Demetriade nr. 1",1411,738,722,16,0,729,9,1500,762,326,403,1,6786,0
17,"Dolj",69900,163,69900,,"MUNICIPIUL CRAIOVA",117,"Scoala cu clasele I-VIII nr. 24 ""Sfantu Gheorghe"", Str. Brazda lui Novac nr. 87",1903,1105,1092,12,1,1093,12,2000,895,493,600,1,6786,0
17,"Dolj",69900,163,69900,,"MUNICIPIUL CRAIOVA",118,"Scoala cu clasele I-VIII nr. 24 ""Sfantu Gheorghe"", Str. Brazda lui Novac nr. 87",1823,1027,1016,9,2,1014,13,2000,973,396,618,1,6786,0
17,"Dolj",69900,163,69900,,"MUNICIPIUL CRAIOVA",119,"Scoala cu clasele I-VIII nr. 24 ""Sfantu Gheorghe"", Str. Brazda lui Novac nr. 87",1784,954,945,9,0,945,9,1900,946,409,536,1,6786,0
17,"Dolj",69900,163,69900,,"MUNICIPIUL CRAIOVA",120,"Grupul scolar Industrial de Transporturi C.F., Str. Constantin Brancusi nr. 15",1086,679,633,17,29,668,11,1200,521,253,415,1,6786,0
17,"Dolj",69900,163,69900,,"MUNICIPIUL CRAIOVA",121,"Grupul scolar Industrial de Transporturi C.F., Str. Constantin Brancusi nr. 15",1132,694,681,13,0,686,8,1200,506,296,390,1,6786,0
17,"Dolj",69900,163,69900,,"MUNICIPIUL CRAIOVA",122,"Colegiul National ""Nicolae Titulescu"", Str. Doljului nr. 12",1853,1121,1103,18,0,1109,12,2000,879,428,681,1,6786,0
17,"Dolj",69900,163,69900,,"MUNICIPIUL CRAIOVA",123,"Scoala cu clasele I-VIII nr. 2 ""Traian"", Str. Principatele Unite nr. 7",1116,728,714,14,0,719,9,1184,456,302,417,1,6786,0
17,"Dolj",69900,163,69900,,"MUNICIPIUL CRAIOVA",124,"Scoala cu clasele I-VIII nr. 2 ""Traian"", Str. Principatele Unite nr. 7",1317,833,823,9,1,825,8,1400,567,377,448,1,6786,0
17,"Dolj",69900,163,69900,,"MUNICIPIUL CRAIOVA",125,"Gradinita de copii cu program prelungit  nr. 21, Bulevardul Carol I nr. 19",1872,1128,1103,24,1,1115,13,2000,872,474,641,1,6786,0
17,"Dolj",69900,163,69900,,"MUNICIPIUL CRAIOVA",126,"Scoala cu clasele I-VIII nr. 23, Str. Lamaitei nr. 4",1944,1180,1163,17,0,1163,17,2100,920,512,651,1,6786,0
17,"Dolj",69900,163,69900,,"MUNICIPIUL CRAIOVA",127,"Scoala cu clasele I-VIII nr. 23, Str. Lamaitei nr. 4",1883,1143,1127,16,0,1133,10,2000,857,486,647,1,6786,0
17,"Dolj",69900,163,69900,,"MUNICIPIUL CRAIOVA",128,"Scoala cu clasele I-VIII nr. 23, Str. Lamaitei nr. 4",1916,1082,1074,8,0,1076,6,2100,1018,467,609,1,6786,0
17,"Dolj",69900,163,69900,,"MUNICIPIUL CRAIOVA",129,"Scoala cu clasele I-VIII nr. 23, Str. Lamaitei nr. 4",1384,745,720,24,1,738,7,1500,755,321,417,1,6786,0
17,"Dolj",69900,163,69900,,"MUNICIPIUL CRAIOVA",130,"Scoala cu clasele I-VIII nr. 23, Str. Lamaitei nr. 4",1934,1108,1099,8,1,1098,10,2100,992,520,578,1,6786,0
17,"Dolj",69900,163,69900,,"MUNICIPIUL CRAIOVA",131,"Scoala cu clasele I-VIII nr. 14 ""Ion Tuculescu"", Str. Bariera Valcii  nr. 52",1503,825,814,11,0,821,4,1600,775,359,462,1,6786,0
17,"Dolj",69900,163,69900,,"MUNICIPIUL CRAIOVA",132,"Scoala cu clasele I-VIII nr. 14 ""Ion Tuculescu"", Str. Bariera Valcii  nr. 52",1908,1291,1107,14,170,1270,21,2000,709,591,679,1,6786,0
17,"Dolj",69900,163,69900,,"MUNICIPIUL CRAIOVA",133,"Scoala cu clasele I-IV nr. 14 ""Ion Tuculescu"" (fost nr.28), Simnicu de Jos, Str. Soseaua Balcesti nr. 53",915,585,569,16,0,584,1,1000,415,296,288,1,6786,0
17,"Dolj",69900,163,69900,,"MUNICIPIUL CRAIOVA",134,"Gradinita de copii cu program normal nr. 5 ""Ingerasii"", Str. Teilor nr. 63",1708,1044,1025,19,0,1033,11,1800,756,459,574,1,6786,0
17,"Dolj",69900,163,69900,,"MUNICIPIUL CRAIOVA",135,"Gradinita de copii cu program normal nr. 5 ""Ingerasii"", Str. Teilor nr. 63",1907,957,946,11,0,954,3,2000,1043,457,497,1,6786,0
17,"Dolj",69900,163,69900,,"MUNICIPIUL CRAIOVA",136,"Gradinita de copii cu program prelungit nr. 50 ""Sf. Lucia"", Str. I. G. Duca nr. 5",1395,813,800,13,0,806,7,1500,687,296,510,1,6786,0
17,"Dolj",69900,163,69900,,"MUNICIPIUL CRAIOVA",137,"Liceul Teoretic ""Tudor Arghezi"" Str. Bucovina nr. 5",1713,1000,987,13,0,984,16,1800,800,401,583,1,6786,0
17,"Dolj",69900,163,69900,,"MUNICIPIUL CRAIOVA",138,"Gradinita de copii cu program prelungit nr. 50 ""Sf. Lucia"", Str. I. G. Duca nr. 5",1049,652,643,9,0,640,12,1200,548,273,367,1,6786,0
17,"Dolj",69900,163,69900,,"MUNICIPIUL CRAIOVA",139,"Gradinita de copii cu program prelungit nr. 50 ""Sf. Lucia"", Str. I. G. Duca nr. 5",1048,647,635,12,0,639,8,1097,450,266,373,1,6786,0
17,"Dolj",69900,163,69900,,"MUNICIPIUL CRAIOVA",140,"Scoala cu clasele I-VIII  nr. 9 ""Petrache Poenaru"", Str. Vasile Alecsandri nr. 87",1676,1459,988,11,460,1435,24,1800,341,786,649,1,6786,0
17,"Dolj",69900,163,69900,,"MUNICIPIUL CRAIOVA",141,"Scoala cu clasele I-VIII  nr. 9 ""Petrache Poenaru"", Str. Vasile Alecsandri nr. 87",1350,845,831,13,1,832,13,1500,655,358,474,1,6786,0
17,"Dolj",69900,163,69900,,"MUNICIPIUL CRAIOVA",142,"Scoala cu clasele I-VIII nr. 21 ""Gheorghe Titeica"", Str.Calea Bucuresti nr. 93",1624,961,945,16,0,952,9,1700,739,365,587,1,6786,0
17,"Dolj",69900,163,69900,,"MUNICIPIUL CRAIOVA",143,"Scoala cu clasele I-VIII nr. 21 ""Gheorghe Titeica"", Str.Calea Bucuresti nr. 93",1657,1002,982,20,0,995,7,1700,698,393,602,1,6786,0
17,"Dolj",69900,163,69900,,"MUNICIPIUL CRAIOVA",144,"Gradinita de copii cu program prelungit ""Pinochio"" - Electroputere, Str. Stefan Velovan nr.4",1307,778,764,14,0,773,5,1363,585,318,455,1,6786,0
17,"Dolj",69900,163,69900,,"MUNICIPIUL CRAIOVA",145,"Scoala cu clasele I-VIII nr. 35 ""I. D. Sirbu"", Str. Nicolae Julea nr. 1",1291,750,739,11,0,743,7,1384,634,329,414,1,6786,0
17,"Dolj",69900,163,69900,,"MUNICIPIUL CRAIOVA",146,"Scoala cu clasele I-VIII nr. 35 ""I. D. Sirbu"", Str. Nicolae Julea nr. 1",1211,681,667,13,1,677,4,1300,619,328,349,1,6786,0
17,"Dolj",69900,163,69900,,"MUNICIPIUL CRAIOVA",147,"Scoala cu clasele I-VIII nr. 35 ""I. D. Sirbu"", Str. Nicolae Julea nr. 1",1420,832,819,13,0,826,6,1489,657,337,489,1,6786,0
17,"Dolj",69900,163,69900,,"MUNICIPIUL CRAIOVA",148,"Grupul scolar  ""Matei Basarab"", Str. Vasile  Alecsandri nr. 113",1123,645,635,10,0,638,7,1200,555,246,392,1,6786,0
17,"Dolj",69900,163,69900,,"MUNICIPIUL CRAIOVA",149,"Grupul Scolar  ""Matei Basarab"", Str. Vasile  Alecsandri nr. 113",1064,573,562,11,0,569,4,1200,627,260,309,1,6786,0
17,"Dolj",69900,163,69900,,"MUNICIPIUL CRAIOVA",150,"Liceul  Teoretic ""Tudor Arghezi,"" Str. Bucovina nr. 5",1442,811,799,12,0,803,8,1600,789,343,460,1,6786,0
17,"Dolj",69900,163,69900,,"MUNICIPIUL CRAIOVA",151,"Liceul  Teoretic ""Tudor Arghezi,"" Str. Bucovina nr. 5",1511,882,866,15,1,874,8,1600,718,345,529,1,6786,0
17,"Dolj",69900,163,69900,,"MUNICIPIUL CRAIOVA",152,"Liceul  Teoretic ""Tudor Arghezi,"" Str. Bucovina nr. 5",1573,872,851,21,0,860,12,1700,828,320,540,1,6786,0
17,"Dolj",69900,163,69900,,"MUNICIPIUL CRAIOVA",153,"Scoala cu clasele I-VIII nr. 39 ""Nicolae Balcescu"", Str. Traian Lalescu nr. 6",1556,939,928,11,0,923,16,1700,761,346,577,1,6786,0
17,"Dolj",69900,163,69900,,"MUNICIPIUL CRAIOVA",154,"Scoala cu clasele I-VIII nr. 39 ""Nicolae Balcescu"", Str. Traian Lalescu nr. 6",1508,849,836,13,0,842,7,1600,751,335,507,1,6786,0
17,"Dolj",69900,163,69900,,"MUNICIPIUL CRAIOVA",155,"Scoala cu clasele I-VIII nr. 39 ""Nicolae Balcescu"", Str. Traian Lalescu nr. 6",1655,897,888,9,0,890,7,1800,903,394,496,1,6786,0
17,"Dolj",69900,163,69900,,"MUNICIPIUL CRAIOVA",156,"Scoala cu clasele I-VIII nr. 39 ""Nicolae Balcescu"", Str. Traian Lalescu nr. 6",1558,873,859,14,0,864,9,1700,827,372,492,1,6786,0
17,"Dolj",69900,163,69900,,"MUNICIPIUL CRAIOVA",157,"Gradinita nr. 14, Str. M.Strajan nr. 12",1701,996,979,16,1,982,14,1800,804,435,547,1,6786,0
17,"Dolj",69900,163,69900,,"MUNICIPIUL CRAIOVA",158,"Facultatea de Mecanica, Str. Calea Bucuresti nr. 107",1209,719,701,18,0,712,7,1296,577,309,403,1,6786,0
17,"Dolj",69900,163,69900,,"MUNICIPIUL CRAIOVA",159,"Grupul scolar  ""Traian Demetrescu,"" Str. Tehnicii nr. 15",1824,939,929,10,0,933,6,2001,1062,432,501,1,6786,0
17,"Dolj",69900,163,69900,,"MUNICIPIUL CRAIOVA",160,"Grupul scolar  ""Traian Demetrescu,"" Str. Tehnicii nr. 15",1533,787,777,10,0,773,14,1700,913,315,458,1,6786,0
17,"Dolj",69900,163,69900,,"MUNICIPIUL CRAIOVA",161,"Gradinita de copii cu program prelungit nr. 31, Bulevardul Decebal, nr. 43, Bloc 53",1303,690,677,13,0,685,5,1400,710,331,354,1,6786,0
17,"Dolj",69900,163,69900,,"MUNICIPIUL CRAIOVA",162,"Gradinita de copii cu program prelungit nr. 31, Bulevardul Decebal, nr. 43, Bloc 53",1094,594,582,12,0,593,1,1200,606,236,357,1,6786,0
17,"Dolj",69900,163,69900,,"MUNICIPIUL CRAIOVA",163,"Directia de Asistenta si Protectie Sociala, Str.Eustatiu Stoenescu, bl.T8",1384,803,765,38,0,799,4,1500,697,350,449,1,6786,0
17,"Dolj",69900,163,69900,,"MUNICIPIUL CRAIOVA",164,"Directia de Asistenta si Protectie Sociala, Str.Eustatiu Stoenescu, bl.T8",1272,736,722,14,0,728,8,1400,664,305,423,1,6786,0
17,"Dolj",69900,163,69900,,"MUNICIPIUL CRAIOVA",165,"Scoala cu clasele I-VIII nr. 38 Cernele, Str. Brestei nr. 597",1908,921,896,25,0,913,8,2100,1179,453,460,1,6786,0
17,"Dolj",69900,163,69900,,"MUNICIPIUL CRAIOVA",166,"Scoala cu clasele I-VIII nr. 38 Cernele, Str. Brestei nr. 597",1790,858,841,17,0,854,4,1900,1042,435,419,1,6786,0
17,"Dolj",69900,163,69900,,"MUNICIPIUL CRAIOVA",167,"Scoala cu clasele I-IV Rovine, Str. Rovine nr. 30A",485,268,253,15,0,267,1,600,332,116,151,1,6786,0
17,"Dolj",69900,163,69900,,"MUNICIPIUL CRAIOVA",168,"Scoala cu clasele I-IV Izvorul Rece, Izvorul Rece - Cernele, nr. 40",545,292,279,13,0,287,5,579,287,168,119,1,6786,0
17,"Dolj",69900,163,69900,,"MUNICIPIUL CRAIOVA",169,"Spitalul Clinic de Urgenta Craiova, Str. Tabaci nr.1",0,453,0,453,0,450,3,580,127,200,250,1,6786,1
17,"Dolj",69900,163,69900,,"MUNICIPIUL CRAIOVA",170,"Spitalul Clinic Municipal ""Filantropia"", Str. Filantropia nr.1",0,321,0,321,0,319,2,621,300,161,158,1,6786,1
17,"Dolj",69900,163,69900,,"MUNICIPIUL CRAIOVA",171,"Spitalul de Boli Infectioase si Pneumoftiziologie ""Victor Babes"", Str. Calea Bucuresti nr.126",0,93,0,93,0,92,1,600,507,45,47,1,6786,1
17,"Dolj",69900,163,69900,,"MUNICIPIUL CRAIOVA",172,"Spitalul Clinic de Urgenta Militar ""Dr. Stefan Odobleja"", Str. Caracal nr.150",0,206,0,206,0,205,1,602,396,93,112,1,6786,1
17,"Dolj",69900,163,69900,,"MUNICIPIUL CRAIOVA",173,"Spitalul Clinic C.F. Craiova, Str. Stirbei Voda nr.6",0,139,0,139,0,138,1,600,461,65,73,1,6786,1
17,"Dolj",69900,163,69900,,"MUNICIPIUL CRAIOVA",174,"Caminul Studentesc nr.3 Agronomie, Str. Libertatii nr.19",0,522,0,522,0,517,5,700,178,267,250,1,6786,1
17,"Dolj",69900,163,69900,,"MUNICIPIUL CRAIOVA",175,"Caminul Studentesc nr.7 Mecanica, Str. Calea Bucuresti nr. 107 B",0,585,0,585,0,578,7,600,15,287,291,1,6786,1
17,"Dolj",69900,163,69900,,"MUNICIPIUL CRAIOVA",176,"Caminul Studentesc nr.10 Electrotehnica, Str. Tehnicii nr. 4",0,447,0,447,0,445,2,505,58,165,280,1,6786,1
17,"Dolj",69900,163,69900,,"MUNICIPIUL CRAIOVA",177,"Caminul Studentesc nr.11 Educatie Fizica si Sport, Str. Brestei nr. 146",0,135,0,135,0,134,1,500,365,67,67,1,6786,1
17,"Dolj",69900,163,69900,,"MUNICIPIUL CRAIOVA",178,"Caminul Studentesc nr.1-2 Medicina, Bd. 1 Mai nr. 68",0,503,0,503,0,497,6,600,97,271,226,1,6786,1
17,"Dolj",69900,163,69900,,"MUNICIPIUL CRAIOVA",179,"Serviciul Public de Asistenta Medico-Sociala, Str. Tabaci nr.3",0,53,0,53,0,51,2,400,347,23,28,1,6786,1
17,"Dolj",69900,163,69900,,"MUNICIPIUL CRAIOVA",180,"Cladirea Administrativa a Regionalei C.F.R. Craiova, Bd. Decebal nr.5-7",0,1417,0,1417,0,1404,13,1554,137,695,709,1,6786,1
17,"Dolj",70316,163,70316,,"MUNICIPIUL  BAILESTI",181,"Scoala cu clasele I-VIII nr. 1, Str. Panduri",1502,794,782,12,0,784,10,1600,806,466,318,1,6796,0
17,"Dolj",70316,163,70316,,"MUNICIPIUL  BAILESTI",182,"Gradinita de copii nr. 3, Str. Carpati",1109,582,530,52,0,579,3,1200,618,316,263,1,6796,0
17,"Dolj",70316,163,70316,,"MUNICIPIUL  BAILESTI",183,"Scoala cu clasele I-VIII nr. 3, Str. Lt. Becherescu",664,249,238,11,0,249,0,700,451,142,107,1,6796,0
17,"Dolj",70316,163,70316,,"MUNICIPIUL  BAILESTI",184,"Scoala cu clasele I-VIII nr. 5, Str. Lt. Becherescu",1166,528,522,6,0,523,5,1300,772,262,261,1,6796,0
17,"Dolj",70316,163,70316,,"MUNICIPIUL  BAILESTI",185,"Gradinita de copii nr. 7, Str. Dragalina",815,467,460,7,0,464,3,900,433,231,233,1,6796,0
17,"Dolj",70316,163,70316,,"MUNICIPIUL  BAILESTI",186,"Liceul ""Mihai Viteazul"",  Str. Marasesti",1056,575,562,13,0,571,4,1200,625,287,284,1,6796,0
17,"Dolj",70316,163,70316,,"MUNICIPIUL  BAILESTI",187,"Gradinita de copii nr. 5, Str. Horia, Closca si Crisan",684,342,334,8,0,336,6,810,468,165,171,1,6796,0
17,"Dolj",70316,163,70316,,"MUNICIPIUL  BAILESTI",188,"Scoala Generala cu clasele I-VIII nr. 3, Str. Horia, Closca si Crisan",885,453,441,12,0,451,2,1006,553,240,211,1,6796,0
17,"Dolj",70316,163,70316,,"MUNICIPIUL  BAILESTI",189,"Scoala Generala cu clasele I-VIII nr. 4, Str. Dreptatii",1494,767,759,7,1,762,5,1600,833,402,360,1,6796,0
17,"Dolj",70316,163,70316,,"MUNICIPIUL  BAILESTI",190,"Gradinita de copii nr. 8, Str. Dreptatii",1465,796,792,4,0,789,7,1600,804,399,390,1,6796,0
17,"Dolj",70316,163,70316,,"MUNICIPIUL  BAILESTI",191,"Liceul Agricol, Str. Revolutiei",647,363,336,27,0,363,0,700,337,211,152,1,6796,0
17,"Dolj",70316,163,70316,,"MUNICIPIUL  BAILESTI",192,"Scoala cu clasele I-VIII nr. 2, Str. Amza Pellea",1072,525,515,10,0,518,7,1182,657,248,270,1,6796,0
17,"Dolj",70316,163,70316,,"MUNICIPIUL  BAILESTI",193,"S.A. Agrozind, Str. Alexandru Ioan Cuza",921,508,505,3,0,505,3,1000,492,224,281,1,6796,0
17,"Dolj",70316,163,70316,,"MUNICIPIUL  BAILESTI",194,"Gradinita de copii nr. 6,  Str. Independentei",1011,549,524,25,0,540,9,1100,551,265,275,1,6796,0
17,"Dolj",70316,163,70316,,"MUNICIPIUL  BAILESTI",195,"Scoala cu clasele I-VIII nr. 6, Str. Teilor",1535,747,738,9,0,738,9,1700,953,361,377,1,6796,0
17,"Dolj",70316,163,70316,,"MUNICIPIUL  BAILESTI",196,"Scoala Generala Balasan",482,328,322,6,0,327,1,600,272,204,123,1,6796,0
17,"Dolj",70316,163,70316,,"MUNICIPIUL  BAILESTI",197,"Cladire statie CFR Bailesti, Str. Victoriei nr.1",0,276,0,276,0,271,5,500,224,133,138,1,6796,1
17,"Dolj",70352,163,70352,,"MUNICIPIUL CALAFAT",198,"Caminul Cultural Golenti",466,276,271,5,0,274,2,500,224,104,170,1,6799,0
17,"Dolj",70352,163,70352,,"MUNICIPIUL CALAFAT",199,"Caminul Cultural,  Sat Basarabi",971,635,626,9,0,623,12,1100,465,320,303,1,6799,0
17,"Dolj",70352,163,70352,,"MUNICIPIUL CALAFAT",200,"Caminul Cultural Ciupercenii Vechi",1945,996,991,5,0,984,12,2100,1104,371,613,1,6799,0
17,"Dolj",70352,163,70352,,"MUNICIPIUL CALAFAT",201,"Scoala Generala nr. 1 Calafat",1805,870,859,11,0,865,5,1900,1030,364,501,1,6799,0
17,"Dolj",70352,163,70352,,"MUNICIPIUL CALAFAT",202,"Liceul Teoretic Independenta",1991,1194,1180,14,0,1183,11,2100,906,382,801,1,6799,0
17,"Dolj",70352,163,70352,,"MUNICIPIUL CALAFAT",203,"Localul de Alimentatie Publica, str. H.C.C. nr. 42",1629,939,926,13,0,931,8,1800,861,304,627,1,6799,0
17,"Dolj",70352,163,70352,,"MUNICIPIUL CALAFAT",204,"Scoala Generala nr. 2 - local vechi",1897,980,964,16,0,957,23,2000,1020,423,534,1,6799,0
17,"Dolj",70352,163,70352,,"MUNICIPIUL CALAFAT",205,"Scoala Generala nr. 2 Calafat - local nou",1761,833,821,12,0,831,2,1900,1067,345,486,1,6799,0
17,"Dolj",70352,163,70352,,"MUNICIPIUL CALAFAT",206,"Gradinita nr. 4, Cartierul Tudor Vladimirescu",1912,868,854,13,1,865,3,2100,1232,377,488,1,6799,0
17,"Dolj",70352,163,70352,,"MUNICIPIUL CALAFAT",207,"Localul de Alimentatie Publica Partener 3, Cartierul Tudor Vladimirescu (Mogador), Str. 1907 de langa Bl. M9",1991,993,982,9,2,984,9,2100,1107,409,575,1,6799,0
17,"Dolj",70352,163,70352,,"MUNICIPIUL CALAFAT",208,"Scoala Generala nr.2 ""Constantin Gerota"", Str. Tudor Vladimirescu nr.52",0,317,0,317,0,316,1,500,183,135,181,1,6799,1
17,"Dolj",70879,163,70879,,"ORAS BECHET",209,"Liceul Teoretic  Bechet, Str. Alexandru Ioan Cuza nr. 33",1307,714,693,18,3,701,13,1390,676,415,286,1,6804,0
17,"Dolj",70879,163,70879,,"ORAS BECHET",210,"Scoala Generala Bechetul din Vale, Str. Jiului nr. 34",739,464,449,8,7,458,6,800,336,210,248,1,6804,0
17,"Dolj",70879,163,70879,,"ORAS BECHET",211,"Protoieria Bechet, Str. Alexandru Ioan Cuza nr. 100 bis",1095,538,523,15,0,527,11,1177,639,261,266,1,6804,0
17,"Dolj",70879,163,70879,,"ORAS BECHET",212,"Caminul Cultural Bechet, Str. Nicolae Titulescu nr.25 bis",0,191,0,191,0,190,1,200,9,91,99,1,6804,1
17,"Dolj",72007,163,72007,,"ORAS DABULENI",213,"Scoala cu clasele I-VIII nr. 4  Dabuleni, Str. Unirii nr. 120",1734,1218,1182,35,1,1201,17,1900,682,400,801,1,6806,0
17,"Dolj",72007,163,72007,,"ORAS DABULENI",214,"Clubul copiilor Dabuleni, Str. Unirii nr. 15",1729,1318,1258,47,13,1305,13,1900,582,451,854,1,6806,0
17,"Dolj",72007,163,72007,,"ORAS DABULENI",215,"Scoala cu clasele I-VIII nr. 1, Nord, Str. Unirii nr. 16",1739,1307,1241,47,19,1287,20,1900,593,377,910,1,6806,0
17,"Dolj",72007,163,72007,,"ORAS DABULENI",216,"Scoala cu clasele I-VIII nr. 1, Sud, Str. Dunarii nr. 2",1856,1375,1331,41,3,1354,21,2000,625,464,890,1,6806,0
17,"Dolj",72007,163,72007,,"ORAS DABULENI",217,"Scoala cu clasele I-VIII nr. 2 - intrare elevi, Str. Marin Preda nr. 4",1242,946,903,36,7,933,13,1400,454,294,639,1,6806,0
17,"Dolj",72007,163,72007,,"ORAS DABULENI",218,"Scoala cu clasele I-VIII nr. 3 - intrare elevi, Str. Victoriei nr. 84",1390,1051,1023,26,2,1033,18,1500,449,368,665,1,6806,0
17,"Dolj",72007,163,72007,,"ORAS DABULENI",219,"Scoala cu clasele I-VIII nr. 3 - intrare profesori, Str. Victoriei nr. 84",1361,1014,975,39,0,997,17,1513,499,360,637,1,6806,0
17,"Dolj",72007,163,72007,,"ORAS DABULENI",220,"Casa de Cultura a orasului Dabuleni, Str. Unirii nr. 16",0,308,0,308,0,308,0,503,195,126,182,1,6806,1
17,"Dolj",70414,163,70414,,"ORAS FILIASI",221,"Scoala Generala Filiasi, Bulevardul Racoteanu nr. 148",1253,728,716,11,1,722,6,1400,672,273,449,1,6809,0
17,"Dolj",70414,163,70414,,"ORAS FILIASI",222,"Primaria Filiasi, Bulevardul Racoteanu nr. 160",1853,988,980,8,0,981,7,2000,1012,397,584,1,6809,0
17,"Dolj",70414,163,70414,,"ORAS FILIASI",223,"Grup scolar Filiasi, Bulevardul Racoteanu nr. 178",1532,735,720,15,0,718,17,1700,965,283,435,1,6809,0
17,"Dolj",70414,163,70414,,"ORAS FILIASI",224,"Gradinita nr. 2 Filiasi, Str. Garii nr. 2",1955,1019,1012,7,0,1008,11,2100,1081,410,598,1,6809,0
17,"Dolj",70414,163,70414,,"ORAS FILIASI",225,"Casa de Cultura, Bulevardul Racoteanu nr. 169",1305,632,623,9,0,629,3,1400,768,210,419,1,6809,0
17,"Dolj",70414,163,70414,,"ORAS FILIASI",226,"Gradinita nr. 3 Filiasi, Str. Nicolae Balcescu nr. 2",1383,736,725,11,0,731,5,1500,764,288,443,1,6809,0
17,"Dolj",70414,163,70414,,"ORAS FILIASI",227,"Gradinita nr. 1 Filiasi, Str. Tudor Vladimirescu nr. 4 H",1941,1051,1034,17,0,1039,12,2100,1049,403,636,1,6809,0
17,"Dolj",70414,163,70414,,"ORAS FILIASI",228,"Scoala Generala Racarii de Sus, Sat Racarii de Sus, Str. Scolii nr. 15",929,650,643,7,0,640,10,1000,350,246,394,1,6809,0
17,"Dolj",70414,163,70414,,"ORAS FILIASI",229,"Scoala Generala Fratostita CORP 1, Sat Fratostita, Str. Valea Bisericii nr. 8",1267,858,842,16,0,849,9,1400,542,350,499,1,6809,0
17,"Dolj",70414,163,70414,,"ORAS FILIASI",230,"Scoala Generala Fratostita CORP 2, Sat Fratostita, Str. Valea Bisericii nr. 8",762,487,473,14,0,478,9,800,313,254,224,1,6809,0
17,"Dolj",70414,163,70414,,"ORAS FILIASI",231,"Scoala Generala Balta, Sat Balta, Str. Pandurilor nr. 218",919,619,610,9,0,599,20,1000,381,296,303,1,6809,0
17,"Dolj",70414,163,70414,,"ORAS FILIASI",232,"Biblioteca Oraseneasca ""Anton Pann"", Bd. Racoteanu nr.157",0,389,0,389,0,384,5,500,111,217,167,1,6809,1
17,"Dolj",70502,163,70502,,"ORAS SEGARCEA",233,"Grupul scolar  ""Horia Vintila""",1779,930,912,17,1,916,14,1900,970,277,639,1,6817,0
17,"Dolj",70502,163,70502,,"ORAS SEGARCEA",234,"Fosta Scoala Generala cu clasele I-VIII",1417,622,616,6,0,609,13,1500,878,173,436,1,6817,0
17,"Dolj",70502,163,70502,,"ORAS SEGARCEA",235,"Biblioteca Oraseneasca ""Mircea Radina""",1630,957,946,11,0,945,12,1800,843,265,680,1,6817,0
17,"Dolj",70502,163,70502,,"ORAS SEGARCEA",236,"Clubul Copiilor",1697,958,948,10,0,934,24,1800,842,288,646,1,6817,0
17,"Dolj",70502,163,70502,,"ORAS SEGARCEA",237,"Grupul scolar ""Horia Vintila"", Str. Unirii nr. 33",0,203,0,203,0,203,0,299,96,81,122,1,6817,1
17,"Dolj",70520,163,70520,,"AFUMATI",238,"Primaria Afumati",1086,576,552,8,16,565,11,1200,624,261,304,3,6819,0
17,"Dolj",70520,163,70520,,"AFUMATI",239,"Caminul Cultural Boureni",937,523,488,16,19,521,2,1000,477,147,374,3,6819,0
17,"Dolj",70520,163,70520,,"AFUMATI",240,"Caminul Cultural Covei",446,251,231,8,12,245,6,500,249,78,167,3,6819,0
17,"Dolj",70520,163,70520,,"AFUMATI",241,"Caminul Cultural Afumati, Sat Afumati",0,168,0,168,0,167,1,198,30,62,105,3,6819,1
17,"Dolj",70566,163,70566,,"ALMAJ",242,"Scoala Generala  cu clasele I-VIII Almaj, Sat Almaj",1169,729,719,10,0,719,10,1300,571,367,352,3,6823,0
17,"Dolj",70566,163,70566,,"ALMAJ",243,"Scoala Generala cu clasele I-IV Sitoaia, Sat Sitoaia",519,318,311,7,0,311,7,600,282,139,172,3,6823,0
17,"Dolj",70566,163,70566,,"ALMAJ",244,"Scoala cu clasele I-VIII I.G. Plesa, Sat Almaj nr.17",0,150,0,150,0,150,0,200,50,58,92,3,6823,1
17,"Dolj",70637,163,70637,,"AMARASTII DE JOS",245,"Caminul Cultural Amarastii de Jos",1305,800,793,7,0,795,5,1395,595,355,440,3,6828,0
17,"Dolj",70637,163,70637,,"AMARASTII DE JOS",246,"Gradinita Tosca",1118,698,681,12,5,691,7,1200,502,215,476,3,6828,0
17,"Dolj",70637,163,70637,,"AMARASTII DE JOS",247,"Gradinita Prapor, Sat Prapor",1225,800,783,17,0,788,12,1300,500,273,515,3,6828,0
17,"Dolj",70637,163,70637,,"AMARASTII DE JOS",248,"Scoala Generala Ocolna, Sat Ocolna",776,518,507,11,0,500,18,874,356,113,387,3,6828,0
17,"Dolj",70637,163,70637,,"AMARASTII DE JOS",249,"Caminul Cultural Amarastii de Jos",0,210,0,210,0,209,1,306,96,77,132,3,6828,1
17,"Dolj",70673,163,70673,,"AMARASTII DE SUS",250,"Caminul Cultural Amarastii de Sus",1405,1094,998,7,89,1082,12,1500,406,276,806,3,6832,0
17,"Dolj",70673,163,70673,,"AMARASTII DE SUS",251,"Caminul Cultural Amarastii de Sus, birou director",0,174,0,174,0,172,2,200,26,86,86,3,6832,1
17,"Dolj",70726,163,70726,,"APELE VII",252,"Caminul Cultural Apele Vii",1841,1075,1067,8,0,1061,14,1950,875,522,539,3,6835,0
17,"Dolj",70726,163,70726,,"APELE VII",253,"Caminul Cultural Apele Vii",0,220,0,220,0,218,2,259,39,105,113,3,6835,1
17,"Dolj",70744,163,70744,,"ARGETOAIA",254,"Scoala Generala Argetoaia, Str. Constantin Argetoianu nr. 225",561,341,329,8,4,339,2,700,359,100,239,3,6837,0
17,"Dolj",70744,163,70744,,"ARGETOAIA",255,"Scoala Generala Argetoaia, Str. Constantin Argetoianu nr. 225",1104,587,561,26,0,581,6,1200,613,167,414,3,6837,0
17,"Dolj",70744,163,70744,,"ARGETOAIA",256,"Scoala Generala Salcia, Sat Salcia, Str. Omorna de Sus nr. 44A",982,619,607,12,0,611,8,1100,481,213,398,3,6837,0
17,"Dolj",70744,163,70744,,"ARGETOAIA",257,"Scoala Generala Piria, Sat Piria, Str. Calea Curmatura nr. 19",364,223,209,14,0,222,1,500,277,106,116,3,6837,0
17,"Dolj",70744,163,70744,,"ARGETOAIA",258,"Scoala Generala cu clasele I-IV Leordoasa, Sat Leordoasa, Str. Scolii nr. 18",345,206,191,15,0,199,7,500,294,58,141,3,6837,0
17,"Dolj",70744,163,70744,,"ARGETOAIA",259,"Scoala Generala cu clasele I-IV Novac, sat Novac, Aleea Novacu nr. 7",206,144,132,12,0,141,3,300,156,52,89,3,6837,0
17,"Dolj",70744,163,70744,,"ARGETOAIA",260,"Scoala Generala Argetoaia, Str. Constantin Argetoianu nr. 225",0,172,0,172,0,172,0,300,128,54,118,3,6837,1
17,"Dolj",70897,163,70897,,"BISTRET",261,"Scoala Generala ""Centru"" Bistret",1111,678,648,30,0,665,13,1200,522,326,339,3,6852,0
17,"Dolj",70897,163,70897,,"BISTRET",262,"Scoala Generala ""Stadion"" Bistret",845,512,508,4,0,506,6,900,388,238,268,3,6852,0
17,"Dolj",70897,163,70897,,"BISTRET",263,"Scoala Generala Bistretu Nou",639,331,322,9,0,322,9,800,469,135,187,3,6852,0
17,"Dolj",70897,163,70897,,"BISTRET",264,"Scoala Generala Plosca",817,474,467,7,0,464,10,900,426,169,295,3,6852,0
17,"Dolj",70897,163,70897,,"BISTRET",265,"Scoala de Arte si Meserii Bistret, etajul I",0,330,0,330,0,328,2,400,70,140,188,3,6852,1
17,"Dolj",70940,163,70940,,"BIRCA",266,"Sala Club a Caminului Cultural Birca, str. Mihai Viteazu nr. 244",1752,911,886,11,14,899,12,1900,989,237,662,3,6850,0
17,"Dolj",70940,163,70940,,"BIRCA",267,"Gradinita de copii nr.1, str. Mihai Viteazu nr. 249",1556,843,806,9,28,831,12,1700,857,263,568,3,6850,0
17,"Dolj",70940,163,70940,,"BIRCA",268,"Gradinita, Str. Mihai Viteazu nr. 249",0,157,0,157,0,154,3,200,43,64,90,3,6850,1
17,"Dolj",70968,163,70968,,"BOTOSESTI-PAIA",269,"Caminul Cultural, Sala Mare",714,577,526,1,50,570,7,789,212,307,263,3,6857,0
17,"Dolj",70968,163,70968,,"BOTOSESTI-PAIA",270,"Caminul Cultural, Sala Mica, Str. Mihai Varzaru",0,109,0,109,0,109,0,200,91,67,42,3,6857,1
17,"Dolj",70986,163,70986,,"BRABOVA",271,"Scoala Generala cu clasele V-VIII Brabova, str. Centrala nr. 126bis",497,309,303,6,0,309,0,615,306,66,243,3,6859,0
17,"Dolj",70986,163,70986,,"BRABOVA",272,"Caminul Cultural Urdinita, Str. Cimpenilor nr. 11",331,206,200,6,0,203,3,500,294,70,133,3,6859,0
17,"Dolj",70986,163,70986,,"BRABOVA",273,"Caminul Cultural Rachita de Jos, Str. Sectia Veche nr. 4",288,172,164,8,0,171,1,400,228,66,105,3,6859,0
17,"Dolj",70986,163,70986,,"BRABOVA",274,"Scoala cu clasele I-IV Mosna, Str. Invatatorilor nr. 1",170,122,114,8,0,121,1,200,78,54,67,3,6859,0
17,"Dolj",70986,163,70986,,"BRABOVA",275,"Scoala Generala cu clasele V-VIII Brabova, Sat Brabova, str. Centrala nr. 126 bis",0,134,0,134,0,134,0,201,67,56,78,3,6859,1
17,"Dolj",71126,163,71126,,"BRALOSTITA",276,"Sala de sedinte a Consiliului Local Bralostita, Str. Stadionului nr. 1",643,443,437,6,0,438,5,822,379,197,241,3,6873,0
17,"Dolj",71126,163,71126,,"BRALOSTITA",277,"Scoala Sfircea, Str. Grigore Olaru, nr. 63",847,620,614,6,0,610,10,900,280,283,327,3,6873,0
17,"Dolj",71126,163,71126,,"BRALOSTITA",278,"Scoala Valea Fintinilor",482,363,349,14,0,357,6,600,237,240,117,3,6873,0
17,"Dolj",71126,163,71126,,"BRALOSTITA",279,"Scoala Ciocanele",579,429,426,3,0,427,2,700,271,295,132,3,6873,0
17,"Dolj",71126,163,71126,,"BRALOSTITA",280,"Scoala Schitu",373,303,298,5,0,299,4,390,87,164,135,3,6873,0
17,"Dolj",71126,163,71126,,"BRALOSTITA",281,"Scoala cu clasele I-VIII Bralostita, Str. Stadionului nr.6",0,143,0,143,0,141,2,199,56,58,83,3,6873,1
17,"Dolj",71199,163,71199,,"BRATOVOESTI",282,"Scoala cu clasele I-IV Badosi",732,533,503,17,13,528,5,817,284,160,368,3,6880,0
17,"Dolj",71199,163,71199,,"BRATOVOESTI",283,"Scoala cu clasele I-IV Prunet",485,332,321,11,0,329,3,600,268,122,207,3,6880,0
17,"Dolj",71199,163,71199,,"BRATOVOESTI",284,"Scoala cu clasele I-VIII Bratovoesti",1070,701,673,28,0,698,3,1200,499,220,478,3,6880,0
17,"Dolj",71199,163,71199,,"BRATOVOESTI",285,"Scoala cu clasele I-IV Georocu Mare",459,357,332,13,12,351,6,505,148,99,252,3,6880,0
17,"Dolj",71199,163,71199,,"BRATOVOESTI",286,"Scoala Generala Bratovoesti cu clasele I-VIII",0,204,0,204,0,204,0,300,96,81,123,3,6880,1
17,"Dolj",71055,163,71055,,"BRADESTI",287,"Scoala Generala Bradesti, Sat Bradesti, str. Mihai Viteazul nr. 56",1434,887,861,26,0,882,5,1600,713,330,552,3,6866,0
17,"Dolj",71055,163,71055,,"BRADESTI",288,"Scoala Generala Bradesti BatrIni, Sat Bradesti BatrIni, str. Ciobotilor nr.3",343,223,198,24,1,220,3,400,177,72,148,3,6866,0
17,"Dolj",71055,163,71055,,"BRADESTI",289,"Scoala Generala Tatomiresti, Sat Tatomiresti, str. Boier Ion Dumitriu nr. 108",819,538,521,17,0,535,3,900,362,156,379,3,6866,0
17,"Dolj",71055,163,71055,,"BRADESTI",290,"Scoala Generala Racarii de Jos, Sat Racarii de Jos, Str. Unirii nr. 6",855,543,538,5,0,537,6,900,357,160,377,3,6866,0
17,"Dolj",71055,163,71055,,"BRADESTI",291,"Scoala Generala Piscani, Sat Piscani, str. Aleea Scolii nr. 2",123,85,69,16,0,84,1,200,115,39,45,3,6866,0
17,"Dolj",71055,163,71055,,"BRADESTI",292,"Scoala Generala cu clasele I-VIII ""Ioan Grecescu"", Str. Mihai Viteazul nr. 56",0,199,0,199,0,199,0,200,1,78,121,3,6866,1
17,"Dolj",71260,163,71260,,"BREASTA",293,"Scoala Sat Breasta",1114,628,615,13,0,623,5,1200,572,411,212,3,6885,0
17,"Dolj",71260,163,71260,,"BREASTA",294,"Scoala Sat Breasta",912,633,624,9,0,621,12,1000,367,457,164,3,6885,0
17,"Dolj",71260,163,71260,,"BREASTA",295,"Scoala Sat Valea Lungului",508,290,283,7,0,290,0,600,310,188,102,3,6885,0
17,"Dolj",71260,163,71260,,"BREASTA",296,"Scoala Sat Obedin",638,384,377,7,0,377,7,700,316,298,79,3,6885,0
17,"Dolj",71260,163,71260,,"BREASTA",297,"Scoala Generala Breasta, Str. C. Argetoianu nr. 13",0,171,0,171,0,169,2,199,28,112,57,3,6885,1
17,"Dolj",69964,163,69964,,"BUCOVAT",298,"Scoala Generala cu clasele I - VIII Bucovat",1507,878,869,9,0,870,8,1610,732,432,438,3,6893,0
17,"Dolj",69964,163,69964,,"BUCOVAT",299,"Scoala Generala cu clasele I - IV Leamna de Jos",259,186,177,9,0,186,0,300,114,88,98,3,6893,0
17,"Dolj",69964,163,69964,,"BUCOVAT",300,"Scoala Generala cu clasele I - IV Leamna de Sus",316,209,194,15,0,206,3,400,191,130,76,3,6893,0
17,"Dolj",69964,163,69964,,"BUCOVAT",301,"Scoala Generala cu clasele I - VIII Palilula",664,400,387,13,0,393,7,700,300,234,159,3,6893,0
17,"Dolj",69964,163,69964,,"BUCOVAT",302,"Scoala Generala cu clasele I-VIII Sarbatoarea",576,345,334,11,0,339,6,700,355,165,174,3,6893,0
17,"Dolj",69964,163,69964,,"BUCOVAT",303,"Scoala Generala Bucovat cu clasele I-VIII, Sala nr. 2, Sat Bucovat",0,266,0,266,0,263,3,306,40,124,139,3,6893,1
17,"Dolj",71340,163,71340,,"BULZESTI",304,"Caminul Cultural Bulzesti - Sala de festivitati, Sat Bulzesti nr. 36",722,471,432,2,37,462,9,800,329,321,141,3,6901,0
17,"Dolj",71340,163,71340,,"BULZESTI",305,"Punct Informare Primaria Bulzesti, Sat Infratirea nr. 42",619,444,400,12,32,441,3,700,256,272,169,3,6901,0
17,"Dolj",71340,163,71340,,"BULZESTI",306,"Camin Cultural Bulzesti, foaier, Sat Bulzesti nr. 36",0,220,0,220,0,219,1,300,80,129,90,3,6901,1
17,"Dolj",71457,163,71457,,"CALOPAR",307,"Scoala Generala Calopar",1084,601,588,13,0,594,7,1200,599,152,442,3,6915,0
17,"Dolj",71457,163,71457,,"CALOPAR",308,"Scoala Generala Belcin",491,317,314,3,0,301,16,600,283,81,220,3,6915,0
17,"Dolj",71457,163,71457,,"CALOPAR",309,"Scoala Generala Panaghia",1330,695,684,11,0,682,13,1400,705,206,476,3,6915,0
17,"Dolj",71457,163,71457,,"CALOPAR",310,"Scoala Generala Calopar",0,191,0,191,0,190,1,200,9,84,106,3,6915,1
17,"Dolj",71518,163,71518,,"CARAULA",311,"Camin Cultural Caraula",1966,1095,1088,7,0,1077,18,2100,1005,458,619,3,6921,0
17,"Dolj",71518,163,71518,,"CARAULA",312,"Gradinita de copii, Str. Craiovei nr. 160",0,132,0,132,0,131,1,200,68,69,62,3,6921,1
17,"Dolj",71536,163,71536,,"CARPEN",313,"Camin Cultural Carpen, str. Primariei nr. 3",762,523,510,13,0,517,6,790,267,177,340,3,6927,0
17,"Dolj",71536,163,71536,,"CARPEN",314,"Caminul Cultural Cleanov, str. Desnatuiului nr.5",1232,733,712,21,0,722,11,1300,567,206,516,3,6927,0
17,"Dolj",71536,163,71536,,"CARPEN",315,"Scoala Generala Geblesti, str. Boier Geblescu nr. 30",115,86,73,13,0,85,1,169,83,36,49,3,6927,0
17,"Dolj",71536,163,71536,,"CARPEN",316,"Scoala cu clasele I-IV Carpen, Sat Carpen",0,82,0,82,0,80,2,200,118,36,44,3,6927,1
17,"Dolj",71536,163,71536,,"CARPEN",317,"Scoala cu clasele I-IV Cleanov, Sat Cleanov",0,68,0,68,0,66,2,200,132,16,50,3,6927,1
17,"Dolj",71572,163,71572,,"CASTRANOVA",318,"Caminul Cultural Castranova, sat Castranova, Str. Stadionului nr. 1",1537,880,875,5,0,862,18,1500,620,235,627,3,6931,0
17,"Dolj",71572,163,71572,,"CASTRANOVA",319,"Scoala Generala Puturi, Sat Puturi, Str. Leului nr. 2",1147,681,672,9,0,677,4,1300,619,257,420,3,6931,0
17,"Dolj",71572,163,71572,,"CASTRANOVA",320,"Caminul Cultural Castranova, Str. Stadionului nr.1",0,286,0,286,0,285,1,400,114,149,136,3,6931,1
17,"Dolj",74842,163,74842,,"CATANE",321,"Scoala Generala cu clasele I-VIII Catane",1415,858,817,1,40,853,5,1500,642,435,418,3,6934,0
17,"Dolj",74842,163,74842,,"CATANE",322,"Scoala Generala cu clasele I-VIII Catane",0,116,0,116,0,114,2,200,84,49,65,3,6934,1
17,"Dolj",71607,163,71607,,"CALARASI",323,"Caminul Cultural Calarasi",1608,1091,1016,30,45,1088,3,1700,609,688,400,3,6912,0
17,"Dolj",71607,163,71607,,"CALARASI",324,"Scoala cu clasele I - VIII nr. 1 Calarasi",1910,1328,1211,48,69,1318,10,2100,772,765,553,3,6912,0
17,"Dolj",71607,163,71607,,"CALARASI",325,"Scoala cu clasele I - VIII nr. 1 Sarata",1705,1269,1175,57,37,1255,14,1800,531,756,499,3,6912,0
17,"Dolj",71607,163,71607,,"CALARASI",326,"Scoala Generala cu clasele I-VIII nr.1, Calarasi, Str. Principala",0,171,0,171,0,170,1,200,29,93,77,3,6912,1
17,"Dolj",74859,163,74859,,"CARCEA",327,"Fosta Scoala Generala, Str. Aeroportului nr. 45",1457,1062,965,27,70,1047,15,1600,538,335,712,3,6923,0
17,"Dolj",74859,163,74859,,"CARCEA",328,"Gradinita Carcea, Sat Carcea, str. Aeroportului nr.45",0,191,0,191,0,190,1,301,110,80,110,3,6923,1
17,"Dolj",74867,163,74867,,"CARNA",329,"Scoala cu clasele I - VIII Carna",1262,889,820,22,47,881,8,1400,511,492,389,3,6925,0
17,"Dolj",74867,163,74867,,"CARNA",330,"Scoala cu clasele I-VIII Carna",0,149,0,149,0,149,0,200,51,86,63,3,6925,1
17,"Dolj",71634,163,71634,,"CELARU",331,"Scoala Noua Celaru",1602,987,975,12,0,964,23,1700,713,356,608,3,6937,0
17,"Dolj",71634,163,71634,,"CELARU",332,"Caminul Cultural Marotinu de Jos",484,337,328,9,0,332,5,597,260,124,208,3,6937,0
17,"Dolj",71634,163,71634,,"CELARU",333,"Caminul Cultural Ghizdavesti",1282,766,759,7,0,754,12,1400,634,279,475,3,6937,0
17,"Dolj",71634,163,71634,,"CELARU",334,"Scoala Marotinu de Sus",514,326,316,10,0,321,5,600,274,113,208,3,6937,0
17,"Dolj",71634,163,71634,,"CELARU",335,"S.A.M. Celaru, Sat Celaru, Str. Principala nr.130",0,291,0,291,0,290,1,300,9,96,194,3,6937,1
17,"Dolj",71698,163,71698,,"CERAT",336,"Caminul Cultural Cerat",1925,984,972,11,1,963,21,2100,1116,290,673,3,6943,0
17,"Dolj",71698,163,71698,,"CERAT",337,"Scoala Generala cu clasele I-IV Cerat",1122,481,473,8,0,457,24,1200,719,164,293,3,6943,0
17,"Dolj",71698,163,71698,,"CERAT",338,"Scoala Generala cu clasele I-IV Cerat",0,98,0,98,0,97,1,200,102,53,44,3,6943,1
17,"Dolj",71723,163,71723,,"CERNATESTI",339,"Gradinita Tiu",413,267,260,7,0,260,7,498,231,85,175,3,6946,0
17,"Dolj",71723,163,71723,,"CERNATESTI",340,"Caminul Cultural Cernatesti",478,325,310,12,3,318,7,600,275,78,240,3,6946,0
17,"Dolj",71723,163,71723,,"CERNATESTI",341,"Scoala Generala Cornita",234,152,145,7,0,149,3,300,148,27,122,3,6946,0
17,"Dolj",71723,163,71723,,"CERNATESTI",342,"Gradinita Rasnicu Oghian",451,313,308,5,0,306,7,500,187,77,229,3,6946,0
17,"Dolj",71723,163,71723,,"CERNATESTI",343,"Caminul Cultural Cernatesti, Sat Cernatesti nr.96",0,152,0,152,0,149,3,185,33,38,111,3,6946,1
17,"Dolj",71787,163,71787,,"CETATE",344,"Scoala Primara Cetate",1671,1566,1525,41,0,1559,7,1800,234,92,1467,3,6952,0
17,"Dolj",71787,163,71787,,"CETATE",345,"Caminul Cultural Cetate",1491,892,832,60,0,881,11,1600,708,330,551,3,6952,0
17,"Dolj",71787,163,71787,,"CETATE",346,"Scoala Generala nr. 2 Cetate (""Fintana Banului"")",855,789,770,19,0,783,6,900,111,186,597,3,6952,0
17,"Dolj",71787,163,71787,,"CETATE",347,"Scoala Primara Moreni",529,443,429,14,0,437,6,600,157,144,293,3,6952,0
17,"Dolj",71787,163,71787,,"CETATE",348,"Caminul Cultural Cetate",0,140,0,140,0,139,1,400,260,65,74,3,6952,1
17,"Dolj",71812,163,71812,,"CIOROIASI",349,"Scoala cu clasele I - VIII Cioroiasi, sala de curs, Sat Cioroiasi nr. 79",997,642,633,9,0,633,9,1100,458,302,331,3,6955,0
17,"Dolj",71812,163,71812,,"CIOROIASI",350,"Scoala cu clasele I- IV Cioroiu-Nou, sala de curs, Sat Cioroiu Nou",465,281,275,6,0,278,3,505,224,82,196,3,6955,0
17,"Dolj",71812,163,71812,,"CIOROIASI",351,"Scoala cu clasele I - VIII Cioroiasi, sala de curs, Sat Cioroiasi nr. 79",0,147,0,147,0,146,1,200,53,62,84,3,6955,1
17,"Dolj",71858,163,71858,,"CIUPERCENII NOI",352,"Caminul Cultural Ciupercenii Noi, Sala de Club, Str. scolii nr. 1",1646,862,812,14,36,846,16,1800,938,334,512,3,6959,0
17,"Dolj",71858,163,71858,,"CIUPERCENII NOI",353,"Scoala cu clasele I-VIII Ciupercenii Noi, sala de curs a claselor III B si VII B, Str. Scolii nr.8",1918,1092,1016,21,55,1083,9,2100,1008,470,613,3,6959,0
17,"Dolj",71858,163,71858,,"CIUPERCENII NOI",354,"Scoala cu clasele I - VIII Ciupercenii Noi, Structura Smirdan, str. 1877 nr. 4, Sala de curs nr. 14 a clasei a VI",1138,620,558,12,50,617,3,1200,580,242,375,3,6959,0
17,"Dolj",71858,163,71858,,"CIUPERCENII NOI",355,"Scoala Generala cu clasele I-VIII Ciupercenii Noi, Str. Dunarii nr.8",0,101,0,101,0,101,0,200,99,44,57,3,6959,1
17,"Dolj",71885,163,71885,,"COSOVENI",356,"Caminul Cultural Cosoveni, Str. Revolutiei nr.2A",854,573,556,17,0,571,2,897,324,278,293,3,6962,0
17,"Dolj",71885,163,71885,,"COSOVENI",357,"Gradinita Cosoveni Nr. 1 Str. Sfantul Nicolae nr. 17",1051,750,710,32,8,732,18,1211,461,377,355,3,6962,0
17,"Dolj",71885,163,71885,,"COSOVENI",358,"Gradinita Cosoveni nr.2, str. Mica nr. 4",694,503,488,12,3,496,7,678,175,284,212,3,6962,0
17,"Dolj",71885,163,71885,,"COSOVENI",359,"Scoala cu clasele I-VIII, Str.Scolii nr.6",0,377,0,377,0,372,5,400,23,247,125,3,6962,1
17,"Dolj",71910,163,71910,,"COTOFENII DIN DOS",360,"Scoala cu clasele I-VIII Cotofenii din Dos",891,603,594,9,0,594,9,1000,397,201,393,3,6964,0
17,"Dolj",71910,163,71910,,"COTOFENII DIN DOS",361,"Scoala cu clasele  I-IV Potmeltu",409,287,280,5,2,282,5,493,206,156,126,3,6964,0
17,"Dolj",71910,163,71910,,"COTOFENII DIN DOS",362,"Scoala Mihaita",653,413,401,6,6,408,5,700,287,164,244,3,6964,0
17,"Dolj",71910,163,71910,,"COTOFENII DIN DOS",363,"Scoala Generala cu clasele I-VIII Cotofenii din Dos, Str. Nicu Iovipale nr.172",0,93,0,93,0,93,0,203,110,42,51,3,6964,1
17,"Dolj",74875,163,74875,,"COTOFENII DIN FATA",364,"Scoala cu clasele I-VIII Cotofenii din Fata",1213,752,748,4,0,738,14,1318,566,322,416,3,6968,0
17,"Dolj",74875,163,74875,,"COTOFENII DIN FATA",365,"Scoala cu clasele  I-IV Beharca",261,192,186,6,0,192,0,300,108,124,68,3,6968,0
17,"Dolj",74875,163,74875,,"COTOFENII DIN FATA",366,"Scoala Generala cu clasele I-VIII Cotofenii din Fata",0,139,0,139,0,137,2,200,61,74,63,3,6968,1
17,"Dolj",71956,163,71956,,"DANETI",367,"Caminul Cultural Daneti",1727,1051,1027,11,13,1034,17,1900,849,603,431,3,6971,0
17,"Dolj",71956,163,71956,,"DANETI",368,"Scoala nr. 1 Daneti",1561,903,872,20,11,887,16,1700,797,516,371,3,6971,0
17,"Dolj",71956,163,71956,,"DANETI",369,"Scoala Generala Braniste",551,369,332,37,0,363,6,600,231,123,240,3,6971,0
17,"Dolj",71956,163,71956,,"DANETI",370,"Scoala Generala Locusteni",526,314,303,11,0,306,8,600,286,138,168,3,6971,0
17,"Dolj",71956,163,71956,,"DANETI",371,"Scoala Generala Brabeti",855,608,540,68,0,594,14,900,292,337,257,3,6971,0
17,"Dolj",71956,163,71956,,"DANETI",372,"Scoala nr.1 Daneti, local nou, Sat Daneti",0,318,0,318,0,317,1,400,82,189,128,3,6971,1
17,"Dolj",72034,163,72034,,"DESA",373,"Scoala cu clasele  I-VIII Desa, localul vechi - partea de vest",1968,1145,1141,4,0,1135,10,2100,955,581,554,3,6976,0
17,"Dolj",72034,163,72034,,"DESA",374,"Scoala cu clasele  I-VIII Desa, localul vechi - partea de est",1920,1052,1044,8,0,1041,11,2100,1048,528,513,3,6976,0
17,"Dolj",72034,163,72034,,"DESA",375,"Scoala Generala Desa, Comuna Desa",0,110,0,110,0,110,0,200,90,44,66,3,6976,1
17,"Dolj",72052,163,72052,,"DIOSTI",376,"Clubul Caminului Cultural Diosti, str. Santierului",1004,688,646,22,20,678,10,1100,412,296,382,3,6978,0
17,"Dolj",72052,163,72052,,"DIOSTI",377,"Scoala cu clasele I-IV Radomir, str. Mihai Viteazul",890,578,549,10,19,578,0,1000,422,256,322,3,6978,0
17,"Dolj",72052,163,72052,,"DIOSTI",378,"Scoala Generala cu clasele I-VIII Ciocanesti, str. Scolii",641,437,400,11,26,428,9,700,263,188,240,3,6978,0
17,"Dolj",72052,163,72052,,"DIOSTI",379,"Scoala cu clasele I-IV Radomir, Sat Radomir",0,214,0,214,0,214,0,300,86,94,120,3,6978,1
17,"Dolj",72098,163,72098,,"DOBRESTI",380,"Scoala cu clasele I - VIII Dobresti",360,206,202,4,0,204,2,400,194,132,72,3,6982,0
17,"Dolj",72098,163,72098,,"DOBRESTI",381,"Scoala cu clasele I - IV Caciulatesti",442,303,294,9,0,291,10,500,199,109,182,3,6982,0
17,"Dolj",72098,163,72098,,"DOBRESTI",382,"Scoala cu clasele I - IV Toceni",543,373,366,7,0,366,7,600,227,175,191,3,6982,0
17,"Dolj",72098,163,72098,,"DOBRESTI",383,"Scoala cu clasele I - IV Murta",769,480,467,13,0,468,12,900,420,188,280,3,6982,0
17,"Dolj",72098,163,72098,,"DOBRESTI",384,"Caminul Cultural Dobresti",0,137,0,137,0,136,1,200,63,76,60,3,6982,1
17,"Dolj",74883,163,74883,,"DOBROTESTI",385,"Caminul Cultural Dobrotesti",1500,1101,1094,7,0,1082,19,1600,499,534,548,3,6988,0
17,"Dolj",74883,163,74883,,"DOBROTESTI",386,"Sediul fostului Consiliu Local, Str. Principala nr. 222",0,168,0,168,0,165,3,204,36,77,88,3,6988,1
17,"Dolj",72150,163,72150,,"DRAGOTESTI",387,"Scoala cu clasele I - IV Viisoara, Str. Mihai Viteazu nr. 1",451,322,297,9,16,314,8,511,189,82,232,3,6991,0
17,"Dolj",72150,163,72150,,"DRAGOTESTI",388,"Scoala veche Dragotesti, Str. Tudor Vladimirescu nr. 1",397,312,296,0,16,307,5,500,188,74,233,3,6991,0
17,"Dolj",72150,163,72150,,"DRAGOTESTI",389,"Scoala cu clasele I - IV Benesti, Str. Iancu Jianu nr. 140",357,268,249,12,7,261,7,400,132,96,165,3,6991,0
17,"Dolj",72150,163,72150,,"DRAGOTESTI",390,"Scoala cu clasele I - IV Popinzalesti, Str. Nicolae Titulescu nr. 27",475,334,322,6,6,328,6,489,155,84,244,3,6991,0
17,"Dolj",72150,163,72150,,"DRAGOTESTI",391,"Scoala cu clasele I - IV Buzduc, Str. Constantin Brancoveanu nr. 80",125,99,82,10,7,99,0,200,101,29,70,3,6991,0
17,"Dolj",72150,163,72150,,"DRAGOTESTI",392,"Scoala Veche Dragotesti, Str. Tudor Vladimirescu nr.1A",0,126,0,126,0,125,1,203,77,38,87,3,6991,1
17,"Dolj",72150,163,72150,,"DRAGOTESTI",393,"Scoala Popinzalesti, Str. Nicolae Titulescu nr.27",0,73,0,73,0,71,2,200,127,26,45,3,6991,1
17,"Dolj",72150,163,72150,,"DRAGOTESTI",394,"Scoala Buzduc, Str. Constantin Brancoveanu nr. 80",0,53,0,53,0,53,0,203,150,13,40,3,6991,1
17,"Dolj",72221,163,72221,,"DRANIC",395,"Caminul Cultural Dranic",928,575,569,6,0,572,3,1000,425,278,294,3,6998,0
17,"Dolj",72221,163,72221,,"DRANIC",396,"Caminul Cultural Padea",781,496,481,11,4,485,11,911,415,300,185,3,6998,0
17,"Dolj",72221,163,72221,,"DRANIC",397,"Scoala Generala Booveni",306,230,219,7,4,229,1,398,168,102,127,3,6998,0
17,"Dolj",72221,163,72221,,"DRANIC",398,"Scoala Generala Foisor",309,207,195,10,2,206,1,410,203,123,83,3,6998,0
17,"Dolj",72221,163,72221,,"DRANIC",399,"Camin Cultural Padea, Sat Padea nr. 144",0,177,0,177,0,177,0,300,123,86,91,3,6998,1
17,"Dolj",72276,163,72276,,"FARCAS",400,"Caminul Cultural Farcas",957,538,525,13,0,533,5,1100,562,205,328,3,7003,0
17,"Dolj",72276,163,72276,,"FARCAS",401,"Scoala Generala Golumbu",633,343,337,6,0,335,8,700,357,121,214,3,7003,0
17,"Dolj",72276,163,72276,,"FARCAS",402,"Gradinita Farcas, Sat Farcas nr. 81",0,89,0,89,0,89,0,200,111,44,45,3,7003,1
17,"Dolj",72383,163,72383,,"GALICEA MARE",403,"Scoala cu  clasele I - VIII, Str. Calafatului nr. 1",1282,628,619,9,0,617,11,1400,772,295,322,3,7009,0
17,"Dolj",72383,163,72383,,"GALICEA MARE",404,"Scoala cu clasele I - IV (Gradinita nr. 2), Str. Scolii nr. 2",989,461,454,7,0,456,5,1100,639,226,230,3,7009,0
17,"Dolj",72383,163,72383,,"GALICEA MARE",405,"Scoala cu  clasele I - IV (Biserica), Str. Scolii nr. 2",1298,616,598,18,0,611,5,1400,784,322,289,3,7009,0
17,"Dolj",72383,163,72383,,"GALICEA MARE",406,"Scoala Generala cu clasele I-VIII Galicea Mare, localul nr. 1, Str. Craiovei nr. 1",0,98,0,98,0,98,0,200,102,45,53,3,7009,1
17,"Dolj",74891,163,74891,,"GALICIUICA",407,"Caminul Cultural Galiciuica",1238,861,825,5,31,846,15,1288,427,450,396,3,7011,0
17,"Dolj",74891,163,74891,,"GALICIUICA",408,"Scoala Generala cu clasele I-VIII Galiciuica",0,116,0,116,0,116,0,200,84,59,57,3,7011,1
17,"Dolj",72409,163,72409,,"GHERCESTI",409,"Caminul Cultural Ghercesti, Sat Ghercesti",704,509,496,4,9,500,9,800,291,248,252,3,7013,0
17,"Dolj",72409,163,72409,,"GHERCESTI",410,"Scoala Generala cu clasele I-IV Girlesti, Sat Girlesti",352,251,245,4,2,251,0,400,149,147,104,3,7013,0
17,"Dolj",72409,163,72409,,"GHERCESTI",411,"Scoala Generala Ungureni, Sat Ungureni",322,251,242,6,3,251,0,396,145,78,173,3,7013,0
17,"Dolj",72409,163,72409,,"GHERCESTI",412,"Scoala Ghercesti, Sat Ghercesti, Str. Eroilor nr. 109",0,359,0,359,0,356,3,380,21,183,173,3,7013,1
17,"Dolj",74907,163,74907,,"GHIDICI",413,"Caminul Cultural Ghidici, Str. Mihai Viteazu nr. 142",1822,1227,1113,15,99,1217,10,2000,773,384,833,3,7019,0
17,"Dolj",74907,163,74907,,"GHIDICI",414,"Gradinita de copii Ghidici, Str. Mihai Viteazul nr. 100",0,128,0,128,0,128,0,200,72,59,69,3,7019,1
17,"Dolj",74915,163,74915,,"GHINDENI",415,"Caminul Cultural Ghindeni",1474,1030,1019,11,0,1010,20,1550,520,504,506,3,7021,0
17,"Dolj",74915,163,74915,,"GHINDENI",416,"Caminul Cultural Ghindeni",0,244,0,244,0,242,2,245,1,122,120,3,7021,1
17,"Dolj",72463,163,72463,,"GIGHERA",417,"Caminul Cultural Gighera",1008,573,547,24,2,568,5,1098,525,287,281,3,7023,0
17,"Dolj",72463,163,72463,,"GIGHERA",418,"Caminul Cultural Nedeia",871,464,435,29,0,453,11,1000,536,177,276,3,7023,0
17,"Dolj",72463,163,72463,,"GIGHERA",419,"Caminul Cultural Zaval",705,433,426,7,0,418,15,800,367,278,140,3,7023,0
17,"Dolj",72463,163,72463,,"GIGHERA",420,"Caminul Cultural Gighera, Sat Gighera, Str. Principala nr. 184",0,203,0,203,0,202,1,298,95,90,112,3,7023,1
17,"Dolj",72506,163,72506,,"GIUBEGA",421,"Scoala veche cu clasele I - IV Giubega - sala I",901,513,503,10,0,502,11,1000,487,264,238,3,7030,0
17,"Dolj",72506,163,72506,,"GIUBEGA",422,"Caminul Cultural Giubega",938,544,540,4,0,538,6,1000,456,254,284,3,7030,0
17,"Dolj",72506,163,72506,,"GIUBEGA",423,"Scoala Veche, Comuna Giubega nr. 466",0,167,0,167,0,165,2,200,33,65,100,3,7030,1
17,"Dolj",72533,163,72533,,"GIURGITA",424,"Scoala cu clasele I - VIII Giurgita, Sat Giurgita, Str. Calea Dunarii nr. 156",1023,552,528,24,0,545,7,1100,548,239,306,3,7032,0
17,"Dolj",72533,163,72533,,"GIURGITA",425,"Gradinita Portaresti, Str. Calea Dunarii nr. 67",936,488,473,14,1,478,10,1000,512,226,252,3,7032,0
17,"Dolj",72533,163,72533,,"GIURGITA",426,"Scoala cu clasele I - IV Curmatura, Str. Scolii nr. 5",542,283,267,16,0,281,2,600,317,130,151,3,7032,0
17,"Dolj",72533,163,72533,,"GIURGITA",427,"Scoala cu clasele I - VIII Giurgita, Sat Giurgita, Str. Calea Dunarii nr. 156",0,166,0,166,0,166,0,200,34,62,104,3,7032,1
17,"Dolj",72579,163,72579,,"GINGIOVA",428,"Caminul Cultural Gingiova",1211,752,700,9,43,744,8,1300,548,303,441,3,7027,0
17,"Dolj",72579,163,72579,,"GINGIOVA",429,"Caminul Cultural Comosteni",893,521,472,17,32,508,13,991,470,145,363,3,7027,0
17,"Dolj",72579,163,72579,,"GINGIOVA",430,"Caminul Cultural Gingiova",0,137,0,137,0,135,2,200,63,71,64,3,7027,1
17,"Dolj",72604,163,72604,,"GOGOSU",431,"Caminul Cultural Gogosu, Sat Gogosu",273,156,147,9,0,153,3,300,144,77,76,3,7036,0
17,"Dolj",72604,163,72604,,"GOGOSU",432,"Scoala Generala Gogosita, Sat Gogosita",217,156,149,7,0,151,5,290,134,40,111,3,7036,0
17,"Dolj",72604,163,72604,,"GOGOSU",433,"Scoala Generala Stefanel, Sat Stefanel",188,125,119,6,0,123,2,197,72,51,72,3,7036,0
17,"Dolj",72604,163,72604,,"GOGOSU",434,"Scoala Generala Gogosu",0,120,0,120,0,120,0,200,80,59,61,3,7036,1
17,"Dolj",72640,163,72640,,"GOICEA",435,"Scoala Goicea Mica",965,531,466,24,41,528,3,1100,569,194,334,3,7040,0
17,"Dolj",72640,163,72640,,"GOICEA",436,"Caminul Cultural Goicea",1374,824,736,36,52,805,19,1501,677,229,576,3,7040,0
17,"Dolj",72640,163,72640,,"GOICEA",437,"Scoala ""Tudor Segarceanu"" Goicea",0,222,0,222,0,220,2,301,79,90,130,3,7040,1
17,"Dolj",72677,163,72677,,"GOIESTI",438,"Caminul Cultural Goiesti, Sat Goiesti",1134,782,760,14,8,763,19,1152,370,471,292,3,7042,0
17,"Dolj",72677,163,72677,,"GOIESTI",439,"Scoala Generala cu clasele I - IV Mogosesti, Sat Fintini",441,371,352,9,10,362,9,488,117,251,111,3,7042,0
17,"Dolj",72677,163,72677,,"GOIESTI",440,"Scoala Generala cu clasele I - IV Malaiesti",492,413,383,10,20,407,6,592,179,322,85,3,7042,0
17,"Dolj",72677,163,72677,,"GOIESTI",441,"Scoala Generala cu clasele I - VIII Tandara",481,374,350,14,10,370,4,600,226,280,90,3,7042,0
17,"Dolj",72677,163,72677,,"GOIESTI",442,"Scoala cu clasele I-VIII Goiesti, Sat Goiesti",0,324,0,324,0,320,4,350,26,223,97,3,7042,1
17,"Dolj",72819,163,72819,,"GRECESTI",443,"Scoala Barboi",336,259,235,10,14,257,2,400,141,108,149,3,7056,0
17,"Dolj",72819,163,72819,,"GRECESTI",444,"Scoala Grecesti",243,187,178,6,3,185,2,200,13,45,140,3,7056,0
17,"Dolj",72819,163,72819,,"GRECESTI",445,"Scoala Busu",565,431,401,7,23,424,7,595,164,153,271,3,7056,0
17,"Dolj",72819,163,72819,,"GRECESTI",446,"Scoala Gropanele",255,152,143,9,0,147,5,300,148,67,80,3,7056,0
17,"Dolj",72819,163,72819,,"GRECESTI",447,"Caminul Cultural Grecesti, Sat Grecesti, Str. Scolii",0,206,0,206,0,204,2,300,94,52,152,3,7056,1
17,"Dolj",70094,163,70094,,"ISALNITA",448,"Fosta Scoala nr.2 cu clasele I-VIII  Isalnita, Str. Preot Grigore Tolescu nr. 22",1629,992,980,7,5,979,13,1800,808,425,554,3,7065,0
17,"Dolj",70094,163,70094,,"ISALNITA",449,"Caminul Cultural Isalnita, Str. A. I. Cuza nr. 5",1587,1008,975,14,19,998,10,1712,704,444,554,3,7065,0
17,"Dolj",70094,163,70094,,"ISALNITA",450,"Scoala Isalnita, Str. Preot Tolescu nr.22",0,141,0,141,0,138,3,200,59,45,93,3,7065,1
17,"Dolj",72882,163,72882,,"IZVOARE",451,"Gradinita Izvoare",1154,713,703,10,0,699,14,1299,586,301,398,3,7067,0
17,"Dolj",72882,163,72882,,"IZVOARE",452,"Scoala cu clasele I - IV Corlate",294,197,188,9,0,196,1,400,203,94,102,3,7067,0
17,"Dolj",72882,163,72882,,"IZVOARE",453,"Gradinita Izvoare",0,158,0,158,0,157,1,200,42,72,85,3,7067,1
17,"Dolj",74923,163,74923,,"INTORSURA",454,"""Scoala de la Nuci""",1311,843,843,0,0,831,12,1300,457,473,358,3,7063,0
17,"Dolj",74923,163,74923,,"INTORSURA",455,"""Scoala de la Nuci""",0,231,0,231,0,231,0,300,69,144,87,3,7063,1
17,"Dolj",72926,163,72926,,"LEU",456,"Scoala de Arte si Meserii ""Nica Barbu Locusteanu"", Str. Craiovei",1564,931,921,10,0,906,25,1650,719,440,466,3,7071,0
17,"Dolj",72926,163,72926,,"LEU",457,"Scoala de Arte si Meserii ""Nica Barbu Locusteanu"", Str. Craiovei",1634,933,932,1,0,908,25,1800,867,430,478,3,7071,0
17,"Dolj",72926,163,72926,,"LEU",458,"Scoala veche Zanoaga",1027,657,652,5,0,646,11,1100,443,276,370,3,7071,0
17,"Dolj",72926,163,72926,,"LEU",459,"Scoala de Arte si Meserii ""Nica Barbu Locusteanu"", Str. Principala",0,330,0,330,0,328,2,350,20,161,167,3,7071,1
17,"Dolj",72953,163,72953,,"LIPOVU",460,"Scoala Generala  cu clasele I - VIII ""Petre Manarcescu"", nr.  208",1380,715,701,14,0,703,12,1500,785,462,241,3,7074,0
17,"Dolj",72953,163,72953,,"LIPOVU",461,"Local Primarie, Sat Lipovu nr. 630",804,431,424,7,0,423,8,900,469,306,117,3,7074,0
17,"Dolj",72953,163,72953,,"LIPOVU",462,"Scoala Generala cu clasele I - IV, Sat Lipovul de Sus nr. 1149",165,115,105,10,0,113,2,202,87,98,15,3,7074,0
17,"Dolj",72953,163,72953,,"LIPOVU",463,"Camin Cultural, Comuna Lipovu nr. 211",0,189,0,189,0,188,1,298,109,93,95,3,7074,1
17,"Dolj",73031,163,73031,,"MAGLAVIT",464,"Scoala Generala nr. 1 cu clasele I - VIII, Sat Maglavit, Str. Calea Severinului nr.75",1885,1116,1054,62,0,1094,22,2000,884,477,617,3,7082,0
17,"Dolj",73031,163,73031,,"MAGLAVIT",465,"Scoala Generala cu clasele I - IV, Sat Maglavit,  Str. Calea Severinului nr.101",1169,735,688,47,0,719,16,1300,565,295,424,3,7082,0
17,"Dolj",73031,163,73031,,"MAGLAVIT",466,"Scoala Generala nr. 3 cu clasele I - VIII, Sat Hunia, Str. Calea Cetatii nr.72",1233,758,692,66,0,745,13,1296,538,328,417,3,7082,0
17,"Dolj",73031,163,73031,,"MAGLAVIT",467,"Scoala cu clasele I-VIII Maglavit (nr.1), Str. Calea Severinului nr.75",0,270,0,270,0,269,1,398,128,138,131,3,7082,1
17,"Dolj",73068,163,73068,,"MALU MARE",468,"Caminul Cultural Malu Mare, Sat Malu Mare",1740,999,991,8,0,993,6,1900,901,382,611,3,7085,0
17,"Dolj",73068,163,73068,,"MALU MARE",469,"Caminul Cultural Preajba, Sat Preajba",836,615,550,11,54,608,7,907,292,325,283,3,7085,0
17,"Dolj",73068,163,73068,,"MALU MARE",470,"Grup scolar Agricol Malu Mare, Sat Malu Mare",0,177,0,177,0,176,1,205,28,81,95,3,7085,1
17,"Dolj",73068,163,73068,,"MALU MARE",471,"Scoala cu clasele I-IV Preajba, Sat Preajba",0,145,0,145,0,144,1,200,55,62,82,3,7085,1
17,"Dolj",72980,163,72980,,"MACESU DE JOS",472,"Primaria Macesu de Jos - sala mare, Str. Academician Stefan Berneanu nr. 12",902,529,529,0,0,523,6,993,464,174,349,3,7077,0
17,"Dolj",72980,163,72980,,"MACESU DE JOS",473,"Scoala cu clasele I - IV,  Sat Sapata, Str. Alexandru Ioan Cuza nr. 31",318,190,187,3,0,189,1,392,202,82,107,3,7077,0
17,"Dolj",72980,163,72980,,"MACESU DE JOS",474,"Caminul Cultural Macesu de Jos, Sat Macesu de Jos, Str. Academician Stefan Berceanu nr. 16",0,113,0,113,0,113,0,201,88,60,53,3,7077,1
17,"Dolj",73013,163,73013,,"MACESU DE SUS",475,"Centrul Cultural Macesu de Sus",1191,821,810,11,0,809,12,1300,479,473,336,3,7080,0
17,"Dolj",73013,163,73013,,"MACESU DE SUS",476,"Scoala cu clasele I-VIII Macesu de Sus",0,108,0,108,0,108,0,200,92,50,58,3,7080,1
17,"Dolj",73102,163,73102,,"MELINESTI",477,"Caminul Cultural Melinesti",953,645,631,14,0,639,6,1000,355,255,384,3,7090,0
17,"Dolj",73102,163,73102,,"MELINESTI",478,"Scoala Generala cu clasele I-VIII, Sat Negoiesti",1149,661,648,13,0,652,9,1300,639,197,455,3,7090,0
17,"Dolj",73102,163,73102,,"MELINESTI",479,"Scoala cu clasele I-IV Bodaiesti",665,410,400,10,0,401,9,700,290,120,281,3,7090,0
17,"Dolj",73102,163,73102,,"MELINESTI",480,"Scoala cu clasele I-IV, Sat Bodaiestii de Sus",242,187,161,26,0,185,2,285,98,65,120,3,7090,0
17,"Dolj",73102,163,73102,,"MELINESTI",481,"Scoala cu clasele I-IV, Sat Spineni",249,177,163,14,0,175,2,300,123,41,134,3,7090,0
17,"Dolj",73102,163,73102,,"MELINESTI",482,"Camin Cultural Melinesti, Sat Melinesti nr. 61",0,272,0,272,0,271,1,400,128,106,165,3,7090,1
17,"Dolj",73246,163,73246,,"MISCHII",483,"Scoala Generala cu clasele I-VIII Mischii",472,359,314,14,31,349,10,500,141,184,165,3,7104,0
17,"Dolj",73246,163,73246,,"MISCHII",484,"Scoala Generala, Sat Mlecanesti",432,375,340,14,21,371,4,500,125,187,184,3,7104,0
17,"Dolj",73246,163,73246,,"MISCHII",485,"Scoala Generala, Sat Urechesti",404,289,272,9,8,287,2,498,209,166,121,3,7104,0
17,"Dolj",73246,163,73246,,"MISCHII",486,"Scoala Generala, Sat Calinesti",136,115,88,11,16,114,1,200,85,59,55,3,7104,0
17,"Dolj",73246,163,73246,,"MISCHII",487,"Scoala Generala cu clasele I-VIII Mischii, Str. Eroilor nr. 11",0,413,0,413,0,410,3,500,87,277,133,3,7104,1
17,"Dolj",73317,163,73317,,"MARSANI",488,"Scoala Generala nr. 2 Mirsani",1479,1109,1030,17,62,1099,10,1600,491,233,866,3,7088,0
17,"Dolj",73317,163,73317,,"MARSANI",489,"Scoala Generala nr. 1 Mirsani",1205,884,818,20,46,872,12,1200,316,239,633,3,7088,0
17,"Dolj",73317,163,73317,,"MARSANI",490,"Scoala Generala nr. 3 Mirsani",1319,983,924,9,50,966,17,1400,417,282,684,3,7088,0
17,"Dolj",73317,163,73317,,"MARSANI",491,"Scoala Generala cu clasele I-VIII nr. 1 Mirsani",0,374,0,374,0,372,2,400,26,177,195,3,7088,1
17,"Dolj",73335,163,73335,,"MOTATEI",492,"Scoala cu clasele I-VIII, Sat Motatei-Gara",727,434,422,12,0,430,4,800,366,151,279,3,7111,0
17,"Dolj",73335,163,73335,,"MOTATEI",493,"Gradinita nr. 2, Sat Motatei",1802,1095,1074,21,0,1082,13,1900,805,442,640,3,7111,0
17,"Dolj",73335,163,73335,,"MOTATEI",494,"Scoala cu clasele I-VIII nr.1, Sat Motatei",1461,922,902,20,0,910,12,1600,678,397,513,3,7111,0
17,"Dolj",73335,163,73335,,"MOTATEI",495,"Gradinita nr. 3, Sat Motatei",1721,1121,1108,13,0,1108,13,1900,779,590,518,3,7111,0
17,"Dolj",73335,163,73335,,"MOTATEI",496,"Scoala cu clasele I-VIII, Sat Dobridor",680,440,430,10,0,436,4,800,360,183,253,3,7111,0
17,"Dolj",73335,163,73335,,"MOTATEI",497,"Scoala cu clasele I-VIII nr. 1 Motatei",0,230,0,230,0,228,2,302,72,113,115,3,7111,1
17,"Dolj",73371,163,73371,,"MURGASI",498,"Scoala cu clasele I - VIII, Sat Murgasi, Str. Popa Murgasanu nr. 152",889,649,629,8,12,638,11,1000,351,399,239,3,7115,0
17,"Dolj",73371,163,73371,,"MURGASI",499,"Structura scolara cu clasele I - VIII, Sat Balota de Jos, Str. Florea Marinescu nr. 47",756,534,511,18,5,526,8,748,214,326,200,3,7115,0
17,"Dolj",73371,163,73371,,"MURGASI",500,"Structura scolara cu clasele I - IV, Sat Velesti, Str. Tudor Vladimirescu nr. 216",457,344,331,13,0,335,9,500,156,191,144,3,7115,0
17,"Dolj",73371,163,73371,,"MURGASI",501,"Structura scolara Balota de Jos, Sat Balota de Jos, Str. Florea Marinescu nr. 47",0,231,0,231,0,229,2,249,18,107,122,3,7115,1
17,"Dolj",73460,163,73460,,"NEGOI",502,"Scoala cu clasele I - VIII Negoi, Satul vechi",930,642,579,6,57,638,4,1000,358,332,306,3,7124,0
17,"Dolj",73460,163,73460,,"NEGOI",503,"Scoala cu clasele I - VIII Negoi, Satul nou",848,523,469,13,41,517,6,900,377,334,183,3,7124,0
17,"Dolj",73460,163,73460,,"NEGOI",504,"Scoala cu clasele I-VIII Negoi, Satul vechi",0,152,0,152,0,149,3,200,48,74,75,3,7124,1
17,"Dolj",73503,163,73503,,"ORODEL",505,"Scoala cu clasele I - VIII Orodel",981,627,597,14,16,617,10,1100,473,151,466,3,7126,0
17,"Dolj",73503,163,73503,,"ORODEL",506,"Scoala cu clasele I - VIII Cornu",474,348,312,14,22,344,4,506,158,136,208,3,7126,0
17,"Dolj",73503,163,73503,,"ORODEL",507,"Scoala cu clasele I - VIII Calugarei",628,458,413,12,33,453,5,697,239,138,315,3,7126,0
17,"Dolj",73503,163,73503,,"ORODEL",508,"Scoala cu clasele I-IV Teiu",208,152,141,11,0,152,0,300,148,38,114,3,7126,0
17,"Dolj",73503,163,73503,,"ORODEL",509,"Scoala cu clasele I-VIII Orodel",0,183,0,183,0,181,2,200,17,75,106,3,7126,1
17,"Dolj",73567,163,73567,,"OSTROVENI",510,"Caminul Cultural, Sat Ostroveni",1281,760,721,39,0,738,22,1400,640,150,588,3,7132,0
17,"Dolj",73567,163,73567,,"OSTROVENI",511,"Gradinita de copii Orasani, Sat Ostroveni",1291,792,732,60,0,771,21,1400,608,183,588,3,7132,0
17,"Dolj",73567,163,73567,,"OSTROVENI",512,"Gradinita de copii Grindeni, Sat Ostroveni",611,372,335,37,0,367,5,700,328,118,249,3,7132,0
17,"Dolj",73567,163,73567,,"OSTROVENI",513,"Gradinita de copii Listeava, Sat Listeava",1230,600,579,21,0,587,13,1300,700,203,384,3,7132,0
17,"Dolj",73567,163,73567,,"OSTROVENI",514,"Biblioteca Comunala, Sat Ostroveni nr. 590",0,228,0,228,0,228,0,300,72,24,204,3,7132,1
17,"Dolj",73594,163,73594,,"PERISOR",515,"Scoala Primara  Perisor - local vechi, Sat Perisor",1266,752,724,28,0,743,9,1400,648,326,417,3,7135,0
17,"Dolj",73594,163,73594,,"PERISOR",516,"Scoala Primara cu clasele I - IV Maracinele",224,148,136,9,3,146,2,300,152,63,83,3,7135,0
17,"Dolj",73594,163,73594,,"PERISOR",517,"Gradinita nr. 2, Comuna Perisor",0,283,0,283,0,283,0,300,17,151,132,3,7135,1
17,"Dolj",73629,163,73629,,"PIELESTI",518,"Scoala nr. 1 Pielesti, Str. Gheorghita Geolgau nr. 187",1173,754,748,6,0,742,12,1301,547,420,322,3,7138,0
17,"Dolj",73629,163,73629,,"PIELESTI",519,"Scoala nr. 2 Pielesti, Str. Gheorghita Geolgau nr. 441",940,562,551,11,0,556,6,1000,438,292,264,3,7138,0
17,"Dolj",73629,163,73629,,"PIELESTI",520,"Scoala Generala nr. 2, Sat Campeni",669,402,396,6,0,400,2,797,395,177,223,3,7138,0
17,"Dolj",73629,163,73629,,"PIELESTI",521,"Caminul Cultural nr.1 Pielesti, Str. Gheorghita Geolgau nr. 186",0,230,0,230,0,229,1,300,70,110,119,3,7138,1
17,"Dolj",73665,163,73665,,"PISCU VECHI",522,"Caminul Cultural Piscu Vechi, Sat Piscu Vechi, Str. Mihai Viteazu nr. 89",2018,1006,1002,4,0,997,9,2200,1194,482,515,3,7142,0
17,"Dolj",73665,163,73665,,"PISCU VECHI",523,"Caminul Cultural Pisculet, Str. Granicerilor nr. 14",255,146,138,8,0,143,3,300,154,60,83,3,7142,0
17,"Dolj",73665,163,73665,,"PISCU VECHI",524,"Scoala Generala cu clasele I-VIII Piscu Vechi, Sat Piscu Vechi, Str. Mihai Viteazu nr. 110",0,80,0,80,0,79,1,200,120,43,36,3,7142,1
17,"Dolj",73709,163,73709,,"PLENITA",525,"Grupul Scolar Industrial ""Constantin Nicolaescu Plopsor"", Sat Plenita, Str. Traian nr. 1",1200,712,671,5,36,706,6,1300,588,301,405,3,7145,0
17,"Dolj",73709,163,73709,,"PLENITA",526,"Scoala cu clasele I - VIII Plenita - local B - Poiana, Sat Plenita, Str. Biserica Poiana nr. 5",1035,566,526,18,22,556,10,1100,534,285,271,3,7145,0
17,"Dolj",73709,163,73709,,"PLENITA",527,"Gradinita de copii  ""Alba ca Zapada"", Sat Plenita, Str. Lalelelor nr. 27",1086,687,614,19,54,673,14,1200,513,368,305,3,7145,0
17,"Dolj",73709,163,73709,,"PLENITA",528,"Caminul Cultural, Sat Castrele Traiane, Str. Decebal nr. 70",741,467,412,7,48,461,6,800,333,158,303,3,7145,0
17,"Dolj",73709,163,73709,,"PLENITA",529,"Grupul Scolar Industrial ""Constantin Nicolaescu Plopsor"", Sat Plenita, Str. Traian nr. 1",0,177,0,177,0,173,4,297,120,77,96,3,7145,1
17,"Dolj",74931,163,74931,,"PLESOI",530,"Scoala cu clasele I - VIII Plesoi, Sat Plesoi - sala nr.2",1109,654,647,7,0,636,18,1200,546,372,264,3,7148,0
17,"Dolj",74931,163,74931,,"PLESOI",531,"Scoala cu clasele I-VIII Plesoi, Sat Plesoi",0,101,0,101,0,100,1,200,99,58,42,3,7148,1
17,"Dolj",70110,163,70110,,"PODARI",532,"Scoala Generala, Sat Braniste, Str. Calafatului nr. 87",630,374,364,10,0,369,5,700,326,135,234,3,7153,0
17,"Dolj",70110,163,70110,,"PODARI",533,"Scoala Generala Balta Verde, Str. Scolii",334,248,231,17,0,244,4,400,152,104,140,3,7153,0
17,"Dolj",70110,163,70110,,"PODARI",534,"Primaria Podari, Str. Dunarii nr. 67",1465,763,750,13,0,751,12,1600,837,311,440,3,7153,0
17,"Dolj",70110,163,70110,,"PODARI",535,"Scoala Generala Podari, Str. scolii nr. 1",1731,831,819,12,0,821,10,1900,1069,302,519,3,7153,0
17,"Dolj",70110,163,70110,,"PODARI",536,"Scoala Generala Livezi, Str. Segarcea nr. 75",743,458,440,18,0,453,5,800,342,115,338,3,7153,0
17,"Dolj",70110,163,70110,,"PODARI",537,"Scoala Generala Gura Vaii, Str. Progresului nr. 96",346,260,246,14,0,257,3,400,140,56,201,3,7153,0
17,"Dolj",70110,163,70110,,"PODARI",538,"Scoala Generala Podari clasele I-VIII, Sat Podari, Str. Scolii nr.1",0,158,0,158,0,158,0,301,143,60,98,3,7153,1
17,"Dolj",73736,163,73736,,"POIANA MARE",539,"Scoala Primara I - IV ""Sirbi""",1703,881,872,9,0,875,6,1800,919,314,561,3,7159,0
17,"Dolj",73736,163,73736,,"POIANA MARE",540,"Scoala Generala ""Dragu""",1701,862,842,20,0,856,6,1800,938,310,546,3,7159,0
17,"Dolj",73736,163,73736,,"POIANA MARE",541,"Scoala Generala nr. 3 (centru)",1409,768,743,25,0,758,10,1500,732,314,444,3,7159,0
17,"Dolj",73736,163,73736,,"POIANA MARE",542,"Liceul ""George St. Marincu""",1359,715,688,27,0,705,10,1500,785,275,430,3,7159,0
17,"Dolj",73736,163,73736,,"POIANA MARE",543,"Scoala Generala ""Traistaru "" (sosea)",1747,1034,1016,18,0,1026,8,1900,866,434,592,3,7159,0
17,"Dolj",73736,163,73736,,"POIANA MARE",544,"Scoala Generala Tunarii Vechi, Sat Tunarii Vechi",1149,631,615,16,0,625,6,1300,669,284,341,3,7159,0
17,"Dolj",73736,163,73736,,"POIANA MARE",545,"Scoala Primara I-IV Tunarii Noi, Sat Tunarii Noi",445,256,246,10,0,255,1,500,244,80,175,3,7159,0
17,"Dolj",73736,163,73736,,"POIANA MARE",546,"Caminul Cultural Poiana Mare, Str. Independentei nr.5",0,192,0,192,0,190,2,400,208,77,113,3,7159,1
17,"Dolj",73772,163,73772,,"PREDESTI",547,"S.A.M. Predesti, corpul A",1672,1096,1087,9,0,1070,26,1800,704,622,448,3,7163,0
17,"Dolj",73772,163,73772,,"PREDESTI",548,"S.A.M. Predesti, corpul B, Str. Lacramioarelor nr. 569",0,406,0,406,0,404,2,500,94,210,194,3,7163,1
17,"Dolj",73852,163,73852,,"RADOVAN",549,"Caminul Cultural Radovan, Str. soseaua Calafatului nr. 46",789,473,466,6,1,455,18,807,334,185,270,3,7167,0
17,"Dolj",73852,163,73852,,"RADOVAN",550,"Caminul Cultural Tirnava, Str. Drumul Maracinelui nr. 60",161,120,110,9,1,115,5,200,80,53,62,3,7167,0
17,"Dolj",73852,163,73852,,"RADOVAN",551,"Caminul Cultural Fintinele, Str. Barajului nr. 2",102,76,70,6,0,75,1,200,124,38,37,3,7167,0
17,"Dolj",73852,163,73852,,"RADOVAN",552,"Scoala Generala , Str. soseaua Calafatului nr. 44",0,327,0,327,0,321,6,400,73,121,200,3,7167,1
17,"Dolj",73905,163,73905,,"RAST",553,"Primaria din Rastu-Nou, Str. Via Miritoiu nr. 82 - Sala nr. 1",774,486,443,43,0,476,10,900,414,147,329,3,7171,0
17,"Dolj",73905,163,73905,,"RAST",554,"Primaria din Rastu-Vechi (Camera Agricola), Str. Drumul Bailestilor",2107,1305,1278,27,0,1283,22,2300,995,529,754,3,7171,0
17,"Dolj",73905,163,73905,,"RAST",555,"Sediu Primarie Rastu-Nou, Str. Via Miritoiu nr. 82",0,100,0,100,0,99,1,200,100,39,60,3,7171,1
17,"Dolj",73923,163,73923,,"ROBANESTI",556,"Caminul Cultural Robanestii de Jos, Sat Robanestii de Jos, Str. Traian Vuia nr. 50",516,323,317,6,0,317,6,600,277,149,168,3,7173,0
17,"Dolj",73923,163,73923,,"ROBANESTI",557,"Scoala cu clasele V-VIII, Sat Golfin, Str. Romanati nr. 74",576,359,354,5,0,352,7,700,341,90,262,3,7173,0
17,"Dolj",73923,163,73923,,"ROBANESTI",558,"Scoala cu clasele I - IV Lacrita Mare, Sat Lacrita Mare, Str. Drumul Craiovei nr. 206",498,376,365,10,1,370,6,600,224,193,177,3,7173,0
17,"Dolj",73923,163,73923,,"ROBANESTI",559,"Scoala cu clasele I-IV Robanestii de Sus, Sat Robanestii de Sus, Str. Garii nr. 82",457,320,316,3,1,320,0,500,180,155,165,3,7173,0
17,"Dolj",73923,163,73923,,"ROBANESTI",560,"Camin Cultural, Sat Robanestii de Jos, Str. Traian Vuia nr. 50",0,179,0,179,0,178,1,202,23,80,98,3,7173,1
17,"Dolj",74949,163,74949,,"ROJISTE",561,"Scoala cu clasele I - VIII Rojiste - Gradinita de copii",1343,971,952,14,5,961,10,1448,477,335,626,3,7180,0
17,"Dolj",74949,163,74949,,"ROJISTE",562,"Scoala cu clasele I - IV Timburesti",505,408,389,19,0,401,7,610,202,102,299,3,7180,0
17,"Dolj",74949,163,74949,,"ROJISTE",563,"Scoala Generala cu clasele I-IV Timburesti, Sat Timburesti, Str. Principala nr. 217",0,200,0,200,0,200,0,202,2,84,116,3,7180,1
17,"Dolj",73996,163,73996,,"SADOVA",564,"Scoala Generala cu clasele I - IV Raieti",534,324,307,17,0,318,6,608,284,106,212,3,7183,0
17,"Dolj",73996,163,73996,,"SADOVA",565,"Scoala Generala cu clasele I - IV Raieti",1046,382,363,19,0,377,5,1100,718,102,275,3,7183,0
17,"Dolj",73996,163,73996,,"SADOVA",566,"Caminul Cultural Sadova, Sat Sadova",1119,683,663,18,2,674,9,1200,517,306,368,3,7183,0
17,"Dolj",73996,163,73996,,"SADOVA",567,"Scoala Generala cu clasele I - VIII Sadova",1230,850,801,46,3,836,14,1300,450,361,475,3,7183,0
17,"Dolj",73996,163,73996,,"SADOVA",568,"Caminul Cultural Damian",1377,902,861,25,16,891,11,1500,598,414,477,3,7183,0
17,"Dolj",73996,163,73996,,"SADOVA",569,"Scoala Generala  Piscu Sadovei - local vechi",980,711,641,59,11,698,13,1100,389,270,428,3,7183,0
17,"Dolj",73996,163,73996,,"SADOVA",570,"Scoala cu clasele I-VIII Sadova, Scoala veche",0,242,0,242,0,241,1,400,158,104,137,3,7183,1
17,"Dolj",74028,163,74028,,"SALCUTA",571,"Caminul Cultural Salcuta, Sat Salcuta",937,473,466,7,0,458,15,1000,527,280,178,3,7186,0
17,"Dolj",74028,163,74028,,"SALCUTA",572,"Scoala Generala cu clasele I - VIII Tencanau, Sat Tencanau",706,376,369,7,0,363,13,800,424,229,134,3,7186,0
17,"Dolj",74028,163,74028,,"SALCUTA",573,"Sala mica a Caminului Cultural, Comuna Salcuta",0,168,0,168,0,165,3,200,32,87,78,3,7186,1
17,"Dolj",74073,163,74073,,"SCAESTI",574,"Scoala Generala cu clasele I-VIII Scaesti",897,653,613,6,34,644,9,1010,357,286,358,3,7191,0
17,"Dolj",74073,163,74073,,"SCAESTI",575,"Scoala Generala cu clasele I-VIII Valea lui Patru",747,460,443,9,8,454,6,796,336,212,242,3,7191,0
17,"Dolj",74073,163,74073,,"SCAESTI",576,"Scoala Generala Scaesti cu clasele I-VIII, Sat Scaesti",0,142,0,142,0,142,0,200,58,57,85,3,7191,1
17,"Dolj",74108,163,74108,,"SEACA DE CAMP",577,"Scoala Generala cu clasele I - VIII Seaca de Camp - sala mare, Sat Seaca de Camp",856,662,597,10,55,649,13,900,238,192,457,3,7194,0
17,"Dolj",74108,163,74108,,"SEACA DE CAMP",578,"Scoala Generala cu clasele I - VIII Piscu Nou - sala mare, Sat Piscu Nou",865,610,573,13,24,592,18,1000,390,202,390,3,7194,0
17,"Dolj",74108,163,74108,,"SEACA DE CAMP",579,"Scoala cu clasele I-VIII Seaca de Camp, sala nr.2, Comuna Seaca de Camp nr. 80",0,114,0,114,0,114,0,200,86,42,72,3,7194,1
17,"Dolj",74135,163,74135,,"SEACA DE PADURE",580,"Scoala cu clasele I-VIII Seaca de Padure",405,254,250,4,0,252,2,500,246,118,134,3,7197,0
17,"Dolj",74135,163,74135,,"SEACA DE PADURE",581,"Scoala cu clasele I - IV Veleni",419,267,257,10,0,265,2,500,233,96,169,3,7197,0
17,"Dolj",74135,163,74135,,"SEACA DE PADURE",582,"Scoala cu clasele I - IV Rachita de Sus",162,104,99,5,0,102,2,200,96,29,73,3,7197,0
17,"Dolj",74135,163,74135,,"SEACA DE PADURE",583,"Scoala Generala cu clasele I-VIII Seaca de Padure",0,98,0,98,0,98,0,200,102,23,75,3,7197,1
17,"Dolj",74171,163,74171,,"SECU",584,"Atelier Scoala cu clasele I - IV Secu",705,452,406,4,42,447,5,800,348,207,240,3,7201,0
17,"Dolj",74171,163,74171,,"SECU",585,"Scoala Generala cu clasele I - IV Smadovicioara",189,151,132,7,12,148,3,200,49,76,72,3,7201,0
17,"Dolj",74171,163,74171,,"SECU",586,"Scoala Generala Secu, atelier",0,69,0,69,0,69,0,200,131,39,30,3,7201,1
17,"Dolj",74171,163,74171,,"SECU",587,"Scoala Generala Smadovicioara, Sat Smadovicioara",0,22,0,22,0,22,0,200,178,9,13,3,7201,1
17,"Dolj",74224,163,74224,,"SILISTEA CRUCII",588,"Gradinita de copii, parter - sala nr.1",1397,733,709,5,19,717,16,1500,767,319,398,3,7206,0
17,"Dolj",74224,163,74224,,"SILISTEA CRUCII",589,"Gradinita de copii, sala nr. 2",0,109,0,109,0,109,0,200,91,40,69,3,7206,1
17,"Dolj",74242,163,74242,,"SOPOT",590,"Scoala Generala Sopot, Sat Sopot",444,308,299,9,0,299,9,500,192,63,236,3,7221,0
17,"Dolj",74242,163,74242,,"SOPOT",591,"Scoala Generala Cernat, Sat Cernat",71,47,38,9,0,46,1,100,53,15,31,3,7221,0
17,"Dolj",74242,163,74242,,"SOPOT",592,"Scoala Generala Bascov, Sat Bascov",309,223,215,8,0,219,4,408,185,75,144,3,7221,0
17,"Dolj",74242,163,74242,,"SOPOT",593,"Scoala Generala Belot, Sat Belot",432,270,259,11,0,264,6,500,230,90,174,3,7221,0
17,"Dolj",74242,163,74242,,"SOPOT",594,"Scoala Generala Pietroaia, Sat Pietroaia",334,217,210,7,0,213,4,400,183,116,97,3,7221,0
17,"Dolj",74242,163,74242,,"SOPOT",595,"Scoala Generala Belot, Sat Belot",0,111,0,111,0,109,2,200,89,29,80,3,7221,1
17,"Dolj",70174,163,70174,,"SIMNICU DE SUS",596,"Caminul Cultural Albesti",594,367,359,8,0,363,4,700,333,181,182,3,7208,0
17,"Dolj",70174,163,70174,,"SIMNICU DE SUS",597,"Caminul Cultural Dudovicesti",1060,576,565,11,0,568,8,1193,617,260,308,3,7208,0
17,"Dolj",70174,163,70174,,"SIMNICU DE SUS",598,"Scoala Generala de 4 ani Izvor",479,312,303,9,0,309,3,600,288,156,153,3,7208,0
17,"Dolj",70174,163,70174,,"SIMNICU DE SUS",599,"Scoala Generala Lesile, Sala de sport - cladirea noua",736,445,433,12,0,439,6,800,355,224,215,3,7208,0
17,"Dolj",70174,163,70174,,"SIMNICU DE SUS",600,"Scoala Generala de 4 ani Milesti",737,426,420,6,0,420,6,800,374,183,237,3,7208,0
17,"Dolj",70174,163,70174,,"SIMNICU DE SUS",601,"Scoala Generala Lesile, cladirea cea noua, sala de clasa, Sat Lesile",0,175,0,175,0,175,0,300,125,75,100,3,7208,1
17,"Dolj",74956,163,74956,,"TALPAS",602,"Caminul Cultural Talpas",1035,661,653,2,6,653,8,1100,439,306,347,3,7229,0
17,"Dolj",74956,163,74956,,"TALPAS",603,"Caminul Cultural Talpas, Comuna Talpas",0,126,0,126,0,125,1,200,74,62,63,3,7229,1
17,"Dolj",74322,163,74322,,"TEASC",604,"Scoala cu clasele I-VIII, Sat Secui, Str. Eroilor nr. 65",1143,748,746,2,0,740,8,1200,452,551,189,3,7235,0
17,"Dolj",74322,163,74322,,"TEASC",605,"Scoala cu clasele I-VIII , Sat Teasc, Str.Bechetului nr. 238",1453,916,907,9,0,910,6,1600,684,407,503,3,7235,0
17,"Dolj",74322,163,74322,,"TEASC",606,"Scoala cu clasele I-VIII Sat Secui, Sat Secui, Str. Eroilor nr. 65",0,106,0,106,0,105,1,200,94,68,37,3,7235,1
17,"Dolj",74322,163,74322,,"TEASC",607,"Scoala cu clasele I-VIII Sat Teasc, Sat Teasc, Str. Bechetului nr. 238",0,114,0,114,0,114,0,201,87,67,47,3,7235,1
17,"Dolj",74359,163,74359,,"TERPEZITA",608,"Scoala Generala Terpezita",822,601,580,11,10,581,20,897,296,115,466,3,7238,0
17,"Dolj",74359,163,74359,,"TERPEZITA",609,"Scoala Generala Caciulatu",340,259,250,8,1,256,3,400,141,108,148,3,7238,0
17,"Dolj",74359,163,74359,,"TERPEZITA",610,"Scoala Generala Lazu",286,195,189,6,0,190,5,300,105,47,143,3,7238,0
17,"Dolj",74359,163,74359,,"TERPEZITA",611,"Caminul Cultural Terpezita, Sat Terpezita",0,288,0,288,0,287,1,299,11,103,184,3,7238,1
17,"Dolj",74411,163,74411,,"TESLUI",612,"Caminul Cultural Teslui",1004,583,572,11,0,574,9,1100,517,219,355,3,7244,0
17,"Dolj",74411,163,74411,,"TESLUI",613,"Scoala cu clasele V-VIII Preajba de Padure",723,485,474,11,0,475,10,800,315,249,226,3,7244,0
17,"Dolj",74411,163,74411,,"TESLUI",614,"Scoala cu clasele I - VII Tartal",317,244,229,15,0,240,4,400,156,112,128,3,7244,0
17,"Dolj",74411,163,74411,,"TESLUI",615,"Scoala cu clasele I-VIII Teslui",0,174,0,174,0,174,0,200,26,77,97,3,7244,1
17,"Dolj",74509,163,74509,,"TUGLUI",616,"Scoala Generala cu clasele I-VIII Tuglui",1292,867,864,3,0,863,4,1416,549,285,578,3,7253,0
17,"Dolj",74509,163,74509,,"TUGLUI",617,"Gradinita nr. 2, Sat Tuglui",872,617,608,9,0,611,6,1001,384,193,418,3,7253,0
17,"Dolj",74509,163,74509,,"TUGLUI",618,"Scoala Generala cu clasele I-IV Jiul",203,140,129,11,0,138,2,300,160,26,112,3,7253,0
17,"Dolj",74509,163,74509,,"TUGLUI",619,"Scoala Generala Tuglui, corp B, Comuna Tuglui nr. 191",0,163,0,163,0,163,0,200,37,57,106,3,7253,1
17,"Dolj",74536,163,74536,,"UNIREA",620,"Scoala nr. 1 ""Scoala din Vale"" - sala nr.1 partea de sud",1698,1166,1115,14,37,1142,24,1800,634,468,674,3,7256,0
17,"Dolj",74536,163,74536,,"UNIREA",621,"Scoala nr. 2 ""Scoala cu Etaj"" - sala nr. 3 partea de vest",1458,981,935,12,34,960,21,1600,619,433,527,3,7256,0
17,"Dolj",74536,163,74536,,"UNIREA",622,"Scoala din Vale nr.1, Comuna Unirea",0,195,0,195,0,195,0,201,6,93,102,3,7256,1
17,"Dolj",74554,163,74554,,"URZICUTA",623,"Scoala cu clasele I-VIII ""Barbu Ionescu"" Urzicuta, Sat Urzicuta, Str. Calea Craiovei nr. 25",1920,957,949,8,0,945,12,2100,1143,247,698,3,7258,0
17,"Dolj",74554,163,74554,,"URZICUTA",624,"Scoala cu clasele I - IV Urzica Mare, Sat Urzica Mare, Str. Calea Craiovei nr. 27",487,321,315,6,0,320,1,600,279,90,230,3,7258,0
17,"Dolj",74554,163,74554,,"URZICUTA",625,"Scoala ""Barbu Ionescu"" Urzicuta, Str. Calea Craiovei nr. 25",0,155,0,155,0,150,5,200,45,32,118,3,7258,1
17,"Dolj",74581,163,74581,,"VALEA STANCIULUI",626,"Gradinita Tuguresti",635,387,367,20,0,383,4,700,313,164,219,3,7261,0
17,"Dolj",74581,163,74581,,"VALEA STANCIULUI",627,"Caminul Cultural Birza",705,449,432,17,0,444,5,800,351,138,306,3,7261,0
17,"Dolj",74581,163,74581,,"VALEA STANCIULUI",628,"Scoala cu clasele I - VIII Valea Stanciului",1286,843,824,19,0,823,20,1400,557,299,524,3,7261,0
17,"Dolj",74581,163,74581,,"VALEA STANCIULUI",629,"Scoala cu clasele I - VIII Horezu Poenari",1346,822,805,17,0,807,15,1500,678,266,541,3,7261,0
17,"Dolj",74581,163,74581,,"VALEA STANCIULUI",630,"Scoala cu clasele I - IV Horezu Poenari",674,439,422,17,0,431,8,800,361,109,322,3,7261,0
17,"Dolj",74581,163,74581,,"VALEA STANCIULUI",631,"Scoala cu clasele I-IV Valea Stanciului, Str. Arhitect Cezar Lazarescu nr. 33",0,283,0,283,0,281,2,300,17,114,167,3,7261,1
17,"Dolj",74616,163,74616,,"VELA",632,"Scoala Generala cu clasele I-VIII Vela",416,309,272,7,30,301,8,466,157,134,167,3,7275,0
17,"Dolj",74616,163,74616,,"VELA",633,"Scoala cu clasele I-IV Bucovicior",362,290,252,16,22,286,4,400,110,160,126,3,7275,0
17,"Dolj",74616,163,74616,,"VELA",634,"Scoala cu clasele I-VIII Gubaucea",529,408,354,10,44,403,5,600,192,313,90,3,7275,0
17,"Dolj",74616,163,74616,,"VELA",635,"Scoala Generala cu clasele I-IV Suharu",224,192,175,9,8,191,1,300,108,84,107,3,7275,0
17,"Dolj",74616,163,74616,,"VELA",636,"Scoala cu clasele I-IV Stiubei",102,88,72,7,9,88,0,188,100,52,36,3,7275,0
17,"Dolj",74616,163,74616,,"VELA",637,"Caminul Cultural, Str. Principala",0,262,0,262,0,261,1,300,38,128,133,3,7275,1
17,"Dolj",74705,163,74705,,"VERBITA",638,"Scoala Generala cu clasele I - VIII (clasa VII-a), Sat Verbita",705,457,442,5,10,454,3,800,343,219,235,3,7284,0
17,"Dolj",74705,163,74705,,"VERBITA",639,"Scoala Generala cu clasele I-IV (clasele I-IV) , Sat Verbicioara",444,270,267,3,0,263,7,500,230,93,170,3,7284,0
17,"Dolj",74705,163,74705,,"VERBITA",640,"Scoala Generala Verbita cu clasele I-VIII, Str. scolii nr. 41",0,94,0,94,0,92,2,200,106,36,56,3,7284,1
17,"Dolj",74732,163,74732,,"VARTOP",641,"Scoala cu clasele I - V - sala curs - parter",1359,854,828,6,20,841,13,1500,646,429,412,3,7264,0
17,"Dolj",74732,163,74732,,"VARTOP",642,"Scoala cu clasele I-VIII, Vartop",0,110,0,110,0,109,1,200,90,46,63,3,7264,1
17,"Dolj",74750,163,74750,,"VARVORU DE JOS",643,"Scoala cu clasele I - IV Varvor",591,305,298,7,0,301,4,712,407,143,158,3,7266,0
17,"Dolj",74750,163,74750,,"VARVORU DE JOS",644,"Scoala cu clasele I - VIII Varvoru de Jos",960,537,531,6,0,530,7,1000,463,242,288,3,7266,0
17,"Dolj",74750,163,74750,,"VARVORU DE JOS",645,"Scoala cu clasele I - IV Ciutura",715,481,472,9,0,463,18,800,319,119,344,3,7266,0
17,"Dolj",74750,163,74750,,"VARVORU DE JOS",646,"Scoala cu clasele I-VIII Varvoru de Jos",0,345,0,345,0,344,1,400,55,104,240,3,7266,1
18,"Galati",75098,172,75098,,"MUNICIPIUL GALATI",1," Scoala generala nr.26  ""Ion Creanga"" , str.Vadul Sacalelor nr.2",1308,830,816,13,1,822,8,1395,565,368,454,1,7288,0
18,"Galati",75098,172,75098,,"MUNICIPIUL GALATI",2," Scoala generala nr.26  ""Ion Creanga"" , str.Vadul Sacalelor nr.2",1281,801,795,6,0,785,16,1503,702,340,445,1,7288,0
18,"Galati",75098,172,75098,,"MUNICIPIUL GALATI",3," Scoala generala nr.28  ""Mihai Eminescu"" , str.Rosiori nr.31",1274,820,808,10,2,803,17,1497,677,417,386,1,7288,0
18,"Galati",75098,172,75098,,"MUNICIPIUL GALATI",4," Scoala generala nr.28  ""Mihai Eminescu"" , str.Rosiori nr.31",1212,745,733,11,1,738,7,1400,655,306,432,1,7288,0
18,"Galati",75098,172,75098,,"MUNICIPIUL GALATI",5," Scoala generala nr.28  ""Mihai Eminescu"" , str.Rosiori nr.31",1535,980,970,8,2,963,17,1700,720,451,512,1,7288,0
18,"Galati",75098,172,75098,,"MUNICIPIUL GALATI",6," Scoala generala nr.28  ""Mihai Eminescu"" , str.Rosiori nr.31",1458,906,883,20,3,891,15,1700,794,415,476,1,7288,0
18,"Galati",75098,172,75098,,"MUNICIPIUL GALATI",7," Scoala generala nr.28  ""Mihai Eminescu"" , str.Rosiori nr.31",958,602,592,10,0,598,4,1100,498,298,300,1,7288,0
18,"Galati",75098,172,75098,,"MUNICIPIUL GALATI",8," S.C. ""APATERM"" S.A , str.C.Brancoveanu nr. 2",1401,870,858,12,0,855,15,1600,730,435,420,1,7288,0
18,"Galati",75098,172,75098,,"MUNICIPIUL GALATI",9," S.C. ""APATERM"" S.A , str.C.Brancoveanu nr. 2",1676,1045,1034,10,1,1032,13,1900,855,482,550,1,7288,0
18,"Galati",75098,172,75098,,"MUNICIPIUL GALATI",10," S.C. ""APATERM"" S.A , str.C.Brancoveanu nr. 2",1515,887,870,16,1,875,12,1700,813,416,459,1,7288,0
18,"Galati",75098,172,75098,,"MUNICIPIUL GALATI",11," Scoala generala nr.2 , Str.Regiment 11 Siret nr. 2",1639,906,893,13,0,887,19,1700,794,492,395,1,7288,0
18,"Galati",75098,172,75098,,"MUNICIPIUL GALATI",12," Scoala generala nr.2 , Str.Regiment 11 Siret nr. 2",1726,1018,1003,14,1,1007,11,1800,782,463,544,1,7288,0
18,"Galati",75098,172,75098,,"MUNICIPIUL GALATI",13," Liceul ""Emil Racovita"" (scoala generala nr. 6) , str.Regiment 11 Siret nr.12-14",1532,910,899,11,0,896,14,1600,690,425,471,1,7288,0
18,"Galati",75098,172,75098,,"MUNICIPIUL GALATI",14," Liceul ""Emil Racovita"" (scoala generala nr. 6) , str.Regiment 11 Siret nr.12-14",1381,713,703,10,0,706,7,1400,687,329,377,1,7288,0
18,"Galati",75098,172,75098,,"MUNICIPIUL GALATI",15," Liceul ""Emil Racovita"" (scoala generala nr. 6) , str.Regiment 11 Siret nr.12-14",1194,614,603,11,0,603,11,1200,586,287,316,1,7288,0
18,"Galati",75098,172,75098,,"MUNICIPIUL GALATI",16," Colegiul National ""Mihail Kogalniceanu"" , str.Brailei nr.161B , Tiglina I",1165,537,526,9,2,525,12,1300,763,273,252,1,7288,0
18,"Galati",75098,172,75098,,"MUNICIPIUL GALATI",17," Colegiul National ""Mihail Kogalniceanu"" , str.Brailei nr.161B , Tiglina I",1233,736,726,10,0,715,21,1300,564,382,333,1,7288,0
18,"Galati",75098,172,75098,,"MUNICIPIUL GALATI",18," Casa de Cultura a Sindicatelor , Str. Brailei nr. 136",1727,1002,986,16,0,984,18,1899,897,517,467,1,7288,0
18,"Galati",75098,172,75098,,"MUNICIPIUL GALATI",19," Casa de Cultura a Sindicatelor , Str. Brailei nr. 136",1540,882,869,12,1,869,13,1700,818,451,418,1,7288,0
18,"Galati",75098,172,75098,,"MUNICIPIUL GALATI",20," Scoala generala nr.15 ""Elena Cuza"" , str. General Alexandru Cernat nr.190",1433,718,699,19,0,708,10,1700,982,388,320,1,7288,0
18,"Galati",75098,172,75098,,"MUNICIPIUL GALATI",21," Scoala generala nr.15 ""Elena Cuza"" , str. General Alexandru Cernat nr.190",1645,813,783,16,14,792,21,1800,987,457,335,1,7288,0
18,"Galati",75098,172,75098,,"MUNICIPIUL GALATI",22," Gradinita nr. 15 , str. Nenitescu nr. 12",1391,708,699,8,1,695,13,1700,992,424,271,1,7288,0
18,"Galati",75098,172,75098,,"MUNICIPIUL GALATI",23," Gradinita nr. 15 , str. Nenitescu nr. 12",1575,738,721,15,2,731,7,1800,1062,430,301,1,7288,0
18,"Galati",75098,172,75098,,"MUNICIPIUL GALATI",24," Colegiul National ""Al. I. Cuza"" , Aleea scolii nr. 2",1134,624,607,17,0,612,12,1400,776,280,332,1,7288,0
18,"Galati",75098,172,75098,,"MUNICIPIUL GALATI",25," Scoala generala nr.16 ""N. Balcescu"" , str.Ariesului nr. 8",1569,877,856,21,0,865,12,1800,923,429,436,1,7288,0
18,"Galati",75098,172,75098,,"MUNICIPIUL GALATI",26," Scoala generala nr.16 ""N. Balcescu"" , str.Ariesului nr. 8",1498,715,700,15,0,711,4,1800,1085,360,351,1,7288,0
18,"Galati",75098,172,75098,,"MUNICIPIUL GALATI",27," Scoala generala nr.16 ""N. Balcescu"" , str.Ariesului nr. 8",1339,817,791,26,0,808,9,1600,783,444,364,1,7288,0
18,"Galati",75098,172,75098,,"MUNICIPIUL GALATI",28," Scoala generala nr.16 ""N. Balcescu"" , str.Ariesului nr. 8",1172,666,654,12,0,661,5,1400,734,317,344,1,7288,0
18,"Galati",75098,172,75098,,"MUNICIPIUL GALATI",29," Colegiul National ""Vasile Alecsandri"" , str. N.Balcescu nr. 41",1538,912,896,15,1,908,4,1700,788,447,461,1,7288,0
18,"Galati",75098,172,75098,,"MUNICIPIUL GALATI",30," Colegiul National ""Vasile Alecsandri"" , str. N.Balcescu nr. 41",1412,757,743,14,0,737,20,1613,856,375,362,1,7288,0
18,"Galati",75098,172,75098,,"MUNICIPIUL GALATI",31," Scoala generala nr.25 ""Petru Rares"" , str. Basarabiei",1578,813,802,11,0,798,15,1800,987,416,382,1,7288,0
18,"Galati",75098,172,75098,,"MUNICIPIUL GALATI",32," Scoala generala nr.25 ""Petru Rares"" , str. Basarabiei",1584,880,871,9,0,872,8,1800,920,430,442,1,7288,0
18,"Galati",75098,172,75098,,"MUNICIPIUL GALATI",33," Scoala generala nr.25 ""Petru Rares"" , str. Basarabiei",1468,796,787,9,0,785,11,1700,904,409,376,1,7288,0
18,"Galati",75098,172,75098,,"MUNICIPIUL GALATI",34," Universitatea ""Dunarea de jos"" Galati  , str. Domneasca nr.47",1661,904,891,12,1,889,15,1900,996,502,387,1,7288,0
18,"Galati",75098,172,75098,,"MUNICIPIUL GALATI",35," Scoala generala nr. 19  ""Ludovic Cosma"" , str. Stelei nr.2",1462,691,685,6,0,686,5,1700,1009,396,290,1,7288,0
18,"Galati",75098,172,75098,,"MUNICIPIUL GALATI",36," Scoala generala nr. 19  ""Ludovic Cosma"" , str. Stelei nr.2",1623,884,866,18,0,874,10,1800,916,487,387,1,7288,0
18,"Galati",75098,172,75098,,"MUNICIPIUL GALATI",37," Grup Scolar Industrial nr.1 ""Traian"" , str. Traian nr. 203",1244,653,643,9,1,647,6,1500,847,355,292,1,7288,0
18,"Galati",75098,172,75098,,"MUNICIPIUL GALATI",38," Grup Scolar ""Elena Doamna"" , str. Domneasca nr. 169",1481,1030,718,11,301,1009,21,1700,670,537,472,1,7288,0
18,"Galati",75098,172,75098,,"MUNICIPIUL GALATI",39," Grup Scolar ""Elena Doamna"" , str. Domneasca nr. 169",1680,906,868,15,23,894,12,1900,994,497,397,1,7288,0
18,"Galati",75098,172,75098,,"MUNICIPIUL GALATI",40," Grup Scolar ""Radu Negru"" , str. Stiintei nr. 27",1566,816,795,21,0,807,9,1800,984,468,339,1,7288,0
18,"Galati",75098,172,75098,,"MUNICIPIUL GALATI",41," Scoala generala nr. 20 ""Traian"" , str. Traian nr. 318",1464,751,733,18,0,740,11,1700,949,455,285,1,7288,0
18,"Galati",75098,172,75098,,"MUNICIPIUL GALATI",42," Scoala generala nr. 20 ""Traian"" , str. Traian nr. 318",841,423,411,12,0,419,4,1000,577,253,166,1,7288,0
18,"Galati",75098,172,75098,,"MUNICIPIUL GALATI",43," Scoala generala nr. 20 ""Traian"" , str. Traian nr. 318",1527,767,759,8,0,763,4,1700,933,432,331,1,7288,0
18,"Galati",75098,172,75098,,"MUNICIPIUL GALATI",44," Scoala generala nr. 24 ""Sf. Arh. Mihail si Gavril"" , str. Egalitatii nr. 8",1786,1110,1102,8,0,1103,7,2000,890,525,578,1,7288,0
18,"Galati",75098,172,75098,,"MUNICIPIUL GALATI",45," Grup Scolar de Marina (Liceul de Marina) , str. Portului nr. 57",1370,663,614,49,0,653,10,1500,837,407,246,1,7288,0
18,"Galati",75098,172,75098,,"MUNICIPIUL GALATI",46," Grup Scolar de Marina (Liceul de Marina) , str. Portului nr. 57",1491,738,717,21,0,726,12,1700,962,393,333,1,7288,0
18,"Galati",75098,172,75098,,"MUNICIPIUL GALATI",47," Grup Scolar de Marina (Liceul de Marina) , str. Portului nr. 57",1375,785,770,15,0,768,17,1503,718,429,339,1,7288,0
18,"Galati",75098,172,75098,,"MUNICIPIUL GALATI",48," Gradinita nr.59 (Fosta Scoala Generala nr.8) , str. Saturn nr.26 , Tiglina I",1484,878,869,7,2,866,12,1600,722,443,423,1,7288,0
18,"Galati",75098,172,75098,,"MUNICIPIUL GALATI",49," Gradinita nr.59 (Fosta Scoala Generala nr.8) , str. Saturn nr.26 , Tiglina I",1640,945,933,12,0,932,13,1700,755,419,513,1,7288,0
18,"Galati",75098,172,75098,,"MUNICIPIUL GALATI",50," Gradinita nr.59 (Fosta Scoala Generala nr.8) , str. Saturn nr.26 , Tiglina I",1548,876,866,8,2,864,12,1600,724,428,436,1,7288,0
18,"Galati",75098,172,75098,,"MUNICIPIUL GALATI",51," Gradinita nr.59 (Fosta Scoala Generala nr.8) , str. Saturn nr.26 , Tiglina I",1504,756,746,9,1,748,8,1600,844,400,348,1,7288,0
18,"Galati",75098,172,75098,,"MUNICIPIUL GALATI",52," Liceul cu Program de Educatie Fizica nr.12 , str. Stadionului nr.5 , Micro 21",1537,782,770,12,0,767,15,1600,818,383,384,1,7288,0
18,"Galati",75098,172,75098,,"MUNICIPIUL GALATI",53," Liceul cu Program de Educatie Fizica nr.12 , str. Stadionului nr.5 , Micro 21",1631,872,857,15,0,861,11,1700,828,431,430,1,7288,0
18,"Galati",75098,172,75098,,"MUNICIPIUL GALATI",54," Liceul cu Program de Educatie Fizica nr.12 , str. Stadionului nr.5 , Micro 21",1633,824,813,11,0,813,11,1700,876,425,388,1,7288,0
18,"Galati",75098,172,75098,,"MUNICIPIUL GALATI",55," Liceul cu Program de Educatie Fizica nr.12 , str. Stadionului nr.5 , Micro 21",1631,794,785,9,0,779,15,1700,906,402,377,1,7288,0
18,"Galati",75098,172,75098,,"MUNICIPIUL GALATI",56," Scoala Generala nr.17 ""Nichita Stanescu"" , str. Costache Conachi nr. 2",1380,648,640,8,0,644,4,1399,751,323,321,1,7288,0
18,"Galati",75098,172,75098,,"MUNICIPIUL GALATI",57," Scoala Generala nr.17 ""Nichita Stanescu"" , str. Costache Conachi nr. 2",1483,708,698,8,2,698,10,1500,792,346,352,1,7288,0
18,"Galati",75098,172,75098,,"MUNICIPIUL GALATI",58," Scoala Generala nr.17 ""Nichita Stanescu"" , str. Costache Conachi nr. 2",1337,585,576,9,0,575,10,1401,816,299,276,1,7288,0
18,"Galati",75098,172,75098,,"MUNICIPIUL GALATI",59," Grup Scolar Economic Administrativ ""Virgil Madgearu"" , str. Strungarilor nr. 31",1435,750,740,10,0,743,7,1496,746,350,393,1,7288,0
18,"Galati",75098,172,75098,,"MUNICIPIUL GALATI",60," Scoala Generala nr.29 ""Sfanta Ana"" , str. Strungarilor nr. 3",1442,702,693,9,0,691,11,1506,804,317,374,1,7288,0
18,"Galati",75098,172,75098,,"MUNICIPIUL GALATI",61," Scoala Generala nr.29 ""Sfanta Ana"" , str. Strungarilor nr. 3",1463,804,792,12,0,791,13,1501,697,392,399,1,7288,0
18,"Galati",75098,172,75098,,"MUNICIPIUL GALATI",62," Scoala Generala nr.29 ""Sfanta Ana"" , str. Strungarilor nr. 3",1460,759,748,11,0,749,10,1500,741,356,393,1,7288,0
18,"Galati",75098,172,75098,,"MUNICIPIUL GALATI",63," Scoala Generala nr.29 ""Sfanta Ana"" , str. Strungarilor nr. 3",1599,910,897,13,0,900,10,1700,790,462,438,1,7288,0
18,"Galati",75098,172,75098,,"MUNICIPIUL GALATI",64," Scoala Generala nr.22 ""Dimitrie Cantemir"" , str. Zidarilor nr.5",1625,753,742,11,0,743,10,1700,947,332,411,1,7288,0
18,"Galati",75098,172,75098,,"MUNICIPIUL GALATI",65," Scoala Generala nr.22 ""Dimitrie Cantemir"" , str. Zidarilor nr.5",1594,912,897,14,1,900,12,1700,788,418,482,1,7288,0
18,"Galati",75098,172,75098,,"MUNICIPIUL GALATI",66," Scoala Generala nr.22 ""Dimitrie Cantemir"" , str. Zidarilor nr.5",1661,828,817,11,0,808,20,1701,873,410,398,1,7288,0
18,"Galati",75098,172,75098,,"MUNICIPIUL GALATI",67," Gradinita nr.62 ""Prichindel"" , str. Brailei nr. 205",1657,913,904,9,0,903,10,1700,787,424,479,1,7288,0
18,"Galati",75098,172,75098,,"MUNICIPIUL GALATI",68," Gradinita nr.62 ""Prichindel"" , str. Brailei nr. 205",1639,828,821,7,0,815,13,1700,872,403,412,1,7288,0
18,"Galati",75098,172,75098,,"MUNICIPIUL GALATI",69," Gradinita nr.62 ""Prichindel"" , str. Brailei nr. 205",1598,847,833,14,0,838,9,1700,853,410,428,1,7288,0
18,"Galati",75098,172,75098,,"MUNICIPIUL GALATI",70," Gara CFR Barbosi",470,230,218,12,0,229,1,503,273,110,119,1,7288,0
18,"Galati",75098,172,75098,,"MUNICIPIUL GALATI",71," Scoala Generala nr.43 ""Dan Barbilian"" , str. Furnalistilor nr. 3",1593,810,804,6,0,801,9,1700,890,349,452,1,7288,0
18,"Galati",75098,172,75098,,"MUNICIPIUL GALATI",72," Scoala Generala nr.43 ""Dan Barbilian"" , str. Furnalistilor nr. 3",1584,820,810,10,0,815,5,1700,880,369,446,1,7288,0
18,"Galati",75098,172,75098,,"MUNICIPIUL GALATI",73," Scoala Generala nr.43 ""Dan Barbilian"" , str. Furnalistilor nr. 3",1568,815,805,9,1,800,15,1600,785,407,393,1,7288,0
18,"Galati",75098,172,75098,,"MUNICIPIUL GALATI",74," Scoala Generala nr.43 ""Dan Barbilian"" , str. Furnalistilor nr. 3",1580,807,796,11,0,796,11,1600,793,425,371,1,7288,0
18,"Galati",75098,172,75098,,"MUNICIPIUL GALATI",75," Scoala Generala nr.43 ""Dan Barbilian"" , str. Furnalistilor nr. 3",1697,871,862,9,0,859,12,1800,929,398,461,1,7288,0
18,"Galati",75098,172,75098,,"MUNICIPIUL GALATI",76," Scoala Generala nr.43 ""Dan Barbilian"" , str. Furnalistilor nr. 3",1481,760,750,9,1,753,7,1600,840,384,369,1,7288,0
18,"Galati",75098,172,75098,,"MUNICIPIUL GALATI",77," Scoala Generala nr.43 ""Dan Barbilian"" , str. Furnalistilor nr. 3",1651,799,787,12,0,781,18,1700,901,367,414,1,7288,0
18,"Galati",75098,172,75098,,"MUNICIPIUL GALATI",78," Scoala Generala nr. 3 ""I. L. Caragiale"" , B-dul Dunarea nr. 60, Micro 21",1697,861,849,12,0,855,6,1800,939,445,410,1,7288,0
18,"Galati",75098,172,75098,,"MUNICIPIUL GALATI",79," Scoala Generala nr. 3 ""I. L. Caragiale"" , B-dul Dunarea nr. 60, Micro 21",1753,891,879,12,0,879,12,1800,909,472,407,1,7288,0
18,"Galati",75098,172,75098,,"MUNICIPIUL GALATI",80," Scoala Generala nr. 3 ""I. L. Caragiale"" , B-dul Dunarea nr. 60, Micro 21",1668,840,834,6,0,827,13,1700,860,428,399,1,7288,0
18,"Galati",75098,172,75098,,"MUNICIPIUL GALATI",81," Scoala Generala nr. 3 ""I. L. Caragiale"" , B-dul Dunarea nr. 60, Micro 21",1703,879,870,9,0,873,6,1800,921,489,384,1,7288,0
18,"Galati",75098,172,75098,,"MUNICIPIUL GALATI",82," Scoala Generala nr. 3 ""I. L. Caragiale"" , B-dul Dunarea nr. 60, Micro 21",1617,838,826,12,0,825,13,1700,862,422,403,1,7288,0
18,"Galati",75098,172,75098,,"MUNICIPIUL GALATI",83," Scoala Generala nr.40 ""Iulia Hasdeu"" , str. Oltului nr. 6 , Micro 18",1631,784,772,12,0,772,12,1700,916,391,381,1,7288,0
18,"Galati",75098,172,75098,,"MUNICIPIUL GALATI",84," Scoala Generala nr.40 ""Iulia Hasdeu"" , str. Oltului nr. 6 , Micro 18",1490,783,770,13,0,781,2,1600,817,387,394,1,7288,0
18,"Galati",75098,172,75098,,"MUNICIPIUL GALATI",85," Scoala Generala nr.40 ""Iulia Hasdeu"" , str. Oltului nr. 6 , Micro 18",1591,828,820,8,0,820,8,1700,872,377,443,1,7288,0
18,"Galati",75098,172,75098,,"MUNICIPIUL GALATI",86," Scoala Generala nr.40 ""Iulia Hasdeu"" , str. Oltului nr. 6 , Micro 18",1547,829,814,15,0,815,14,1600,771,424,391,1,7288,0
18,"Galati",75098,172,75098,,"MUNICIPIUL GALATI",87," Scoala Generala nr.40 ""Iulia Hasdeu"" , str. Oltului nr. 6 , Micro 18",1488,784,770,14,0,778,6,1600,816,415,363,1,7288,0
18,"Galati",75098,172,75098,,"MUNICIPIUL GALATI",88," Scoala Generala nr.40 ""Iulia Hasdeu"" , str. Oltului nr. 6 , Micro 18",1496,772,761,11,0,755,17,1600,828,376,379,1,7288,0
18,"Galati",75098,172,75098,,"MUNICIPIUL GALATI",89," Scoala Generala nr.9 ""Calistrat Hogas"" , str. Barbosi nr. 38",1551,876,867,9,0,871,5,1600,724,414,457,1,7288,0
18,"Galati",75098,172,75098,,"MUNICIPIUL GALATI",90," Scoala Generala nr.9 ""Calistrat Hogas"" , str. Barbosi nr. 38",1411,735,723,12,0,727,8,1500,765,369,358,1,7288,0
18,"Galati",75098,172,75098,,"MUNICIPIUL GALATI",91," Scoala Generala nr.9 ""Calistrat Hogas"" , str. Barbosi nr. 38",1414,752,741,11,0,737,15,1500,748,372,365,1,7288,0
18,"Galati",75098,172,75098,,"MUNICIPIUL GALATI",92," Scoala Generala nr.1 ""Nicolae Mantu"" , str.Brailei nr. 184",1618,895,864,28,3,891,4,1700,805,450,441,1,7288,0
18,"Galati",75098,172,75098,,"MUNICIPIUL GALATI",93," Scoala Generala nr.1 ""Nicolae Mantu"" , str.Brailei nr. 184",1533,811,803,8,0,805,6,1600,789,402,403,1,7288,0
18,"Galati",75098,172,75098,,"MUNICIPIUL GALATI",94," Scoala Generala nr.5 ""Cuza Voda"" , str. Gorunului nr. 6",1633,786,769,17,0,771,15,1800,1014,428,343,1,7288,0
18,"Galati",75098,172,75098,,"MUNICIPIUL GALATI",95," Scoala Generala nr.5 ""Cuza Voda"" , str. Gorunului nr. 6",1504,777,766,11,0,768,9,1600,823,396,372,1,7288,0
18,"Galati",75098,172,75098,,"MUNICIPIUL GALATI",96," Scoala Generala nr.5 ""Cuza Voda"" , str. Gorunului nr. 6",1532,785,773,12,0,769,16,1700,915,387,382,1,7288,0
18,"Galati",75098,172,75098,,"MUNICIPIUL GALATI",97," Scoala Generala nr.5 ""Cuza Voda"" , str. Gorunului nr. 6",1476,828,819,9,0,820,8,1600,772,420,400,1,7288,0
18,"Galati",75098,172,75098,,"MUNICIPIUL GALATI",98," Liceul Teoretic ""Dunarea"" , str. Oltului nr. 24 , Micro 17",1481,774,761,13,0,765,9,1600,826,403,362,1,7288,0
18,"Galati",75098,172,75098,,"MUNICIPIUL GALATI",99," Liceul Teoretic ""Dunarea"" , str. Oltului nr. 24 , Micro 17",1460,763,751,12,0,755,8,1500,737,389,366,1,7288,0
18,"Galati",75098,172,75098,,"MUNICIPIUL GALATI",100," Liceul Teoretic ""Dunarea"" , str. Oltului nr. 24 , Micro 17",1492,771,760,10,1,759,12,1600,829,386,373,1,7288,0
18,"Galati",75098,172,75098,,"MUNICIPIUL GALATI",101," Scoala Generala nr.11 ""Mihail Sadoveanu"" , str. Mihail Sadoveanu nr. 16",1571,853,839,14,0,846,7,1700,847,403,443,1,7288,0
18,"Galati",75098,172,75098,,"MUNICIPIUL GALATI",102," Scoala Generala nr.11 ""Mihail Sadoveanu"" , str. Mihail Sadoveanu nr. 16",1332,740,730,10,0,728,12,1500,760,364,364,1,7288,0
18,"Galati",75098,172,75098,,"MUNICIPIUL GALATI",103," Scoala Generala nr.11 ""Mihail Sadoveanu"" , str. Mihail Sadoveanu nr. 16",1285,830,817,13,0,810,20,1705,875,344,466,1,7288,0
18,"Galati",75098,172,75098,,"MUNICIPIUL GALATI",104," Scoala Generala nr.11 ""Mihail Sadoveanu"" , str. Mihail Sadoveanu nr. 16",1556,768,758,10,0,759,9,1700,932,397,362,1,7288,0
18,"Galati",75098,172,75098,,"MUNICIPIUL GALATI",105," Scoala Generala nr.11 ""Mihail Sadoveanu"" , str. Mihail Sadoveanu nr. 16",1505,861,849,12,0,851,10,1700,839,400,451,1,7288,0
18,"Galati",75098,172,75098,,"MUNICIPIUL GALATI",106," Scoala Generala nr.11 ""Mihail Sadoveanu"" , str. Mihail Sadoveanu nr. 16",1480,855,839,16,0,846,9,1600,745,347,499,1,7288,0
18,"Galati",75098,172,75098,,"MUNICIPIUL GALATI",107," Scoala Generala nr.10 ""Petre Tutea"" , str. Lebedei nr. 4",1488,829,818,11,0,817,12,1600,771,389,428,1,7288,0
18,"Galati",75098,172,75098,,"MUNICIPIUL GALATI",108," Scoala Generala nr.10 ""Petre Tutea"" , str. Lebedei nr. 4",1550,792,782,9,1,781,11,1700,908,348,433,1,7288,0
18,"Galati",75098,172,75098,,"MUNICIPIUL GALATI",109," Scoala Generala nr.10 ""Petre Tutea"" , str. Lebedei nr. 4",1517,760,751,9,0,748,12,1700,940,369,379,1,7288,0
18,"Galati",75098,172,75098,,"MUNICIPIUL GALATI",110," Scoala Generala nr.10 ""Petre Tutea"" , str. Lebedei nr. 4",1589,814,802,12,0,810,4,1700,886,407,403,1,7288,0
18,"Galati",75098,172,75098,,"MUNICIPIUL GALATI",111," Scoala Generala nr.10 ""Petre Tutea"" , str. Lebedei nr. 4",1619,852,834,18,0,844,8,1800,948,388,456,1,7288,0
18,"Galati",75098,172,75098,,"MUNICIPIUL GALATI",112," Colegiul Tehnic ""Traian Vuia"" (Grup Scolar Tansporturi auto) , str. Ing. Anghel Saligny nr. 117",1435,779,766,13,0,766,13,1600,821,402,364,1,7288,0
18,"Galati",75098,172,75098,,"MUNICIPIUL GALATI",113," Colegiul Tehnic ""Traian Vuia"" (Grup Scolar Tansporturi auto) , str. Ing. Anghel Saligny nr. 117",1442,781,767,13,1,774,7,1600,819,440,334,1,7288,0
18,"Galati",75098,172,75098,,"MUNICIPIUL GALATI",114," Colegiul Tehnic ""Traian Vuia"" (Grup Scolar Tansporturi auto) , str. Ing. Anghel Saligny nr. 117",1399,744,729,15,0,735,9,1500,756,329,406,1,7288,0
18,"Galati",75098,172,75098,,"MUNICIPIUL GALATI",115," Scoala Generala nr.42 ""Sfintii Imparati"" , str. Siderurgistilor nr. 17",1505,853,842,11,0,839,14,1600,747,446,393,1,7288,0
18,"Galati",75098,172,75098,,"MUNICIPIUL GALATI",116," Scoala Generala nr.42 ""Sfintii Imparati"" , str. Siderurgistilor nr. 17",1630,930,914,16,0,915,15,1700,770,454,461,1,7288,0
18,"Galati",75098,172,75098,,"MUNICIPIUL GALATI",117," Scoala Generala nr.42 ""Sfintii Imparati"" , str. Siderurgistilor nr. 17",1546,862,851,11,0,850,12,1700,838,432,418,1,7288,0
18,"Galati",75098,172,75098,,"MUNICIPIUL GALATI",118," Scoala Generala nr.41 ""Sf.Grigore Teologul"" , str. 1 Decembrie 1918 nr. 15",1705,898,889,8,1,885,13,1900,1002,409,476,1,7288,0
18,"Galati",75098,172,75098,,"MUNICIPIUL GALATI",119," Scoala Generala nr.41 ""Sf.Grigore Teologul"" , str. 1 Decembrie 1918 nr. 15",1681,859,846,13,0,848,11,1900,1041,412,436,1,7288,0
18,"Galati",75098,172,75098,,"MUNICIPIUL GALATI",120," Scoala Generala nr.41 ""Sf.Grigore Teologul"" , str. 1 Decembrie 1918 nr. 15",1644,857,847,10,0,847,10,1800,943,413,434,1,7288,0
18,"Galati",75098,172,75098,,"MUNICIPIUL GALATI",121," Scoala Generala nr.41 ""Sf.Grigore Teologul"" , str. 1 Decembrie 1918 nr. 15",1696,882,866,15,1,869,13,1900,1018,443,426,1,7288,0
18,"Galati",75098,172,75098,,"MUNICIPIUL GALATI",122," Grupul Scolar Industrial nr.9 ""Anghel Saligny"" , Calea Smardan nr. 13",1539,761,750,11,0,748,13,1699,938,390,358,1,7288,0
18,"Galati",75098,172,75098,,"MUNICIPIUL GALATI",123," Grupul Scolar Industrial nr.9 ""Anghel Saligny"" , Calea Smardan nr. 13",1306,637,621,16,0,630,7,1400,763,365,265,1,7288,0
18,"Galati",75098,172,75098,,"MUNICIPIUL GALATI",124," Grupul Scolar Industrial nr.9 ""Anghel Saligny"" , Calea Smardan nr. 13",1617,735,719,16,0,731,4,1800,1065,344,387,1,7288,0
18,"Galati",75098,172,75098,,"MUNICIPIUL GALATI",125," Grupul Scolar Industrial nr.9 ""Anghel Saligny"" , Calea Smardan nr. 13",1677,760,744,16,0,749,11,1900,1140,431,318,1,7288,0
18,"Galati",75098,172,75098,,"MUNICIPIUL GALATI",126," Grupul Scolar Industrial nr.10 ""Sfanta Maria"" , str. Constructorilor nr. 25 , Tiglina II",1210,675,663,12,0,657,18,1300,625,316,341,1,7288,0
18,"Galati",75098,172,75098,,"MUNICIPIUL GALATI",127," Grupul Scolar Industrial nr.10 ""Sfanta Maria"" , str. Constructorilor nr. 25 , Tiglina II",1651,880,865,14,1,866,14,1800,920,437,429,1,7288,0
18,"Galati",75098,172,75098,,"MUNICIPIUL GALATI",128," Scoala Generala nr.13 ""Stefan cel Mare"" , str. Constructorilor nr. 9 , Tiglina II",1680,905,892,12,1,893,12,1800,895,414,479,1,7288,0
18,"Galati",75098,172,75098,,"MUNICIPIUL GALATI",129," Scoala Generala nr.7 ""C. Brancoveanu"" , str. Brailei nr. 204 , Tiglina II",1719,1026,1005,21,0,1012,14,1800,774,439,573,1,7288,0
18,"Galati",75098,172,75098,,"MUNICIPIUL GALATI",130," Liceul Pegadogic ""C. Negri"" , str. Brailei nr. 134",1617,952,937,15,0,936,16,1700,748,474,462,1,7288,0
18,"Galati",75098,172,75098,,"MUNICIPIUL GALATI",131," Liceul Pegadogic ""C. Negri"" , str. Brailei nr. 134",1656,1003,946,19,38,988,15,1700,697,485,503,1,7288,0
18,"Galati",75098,172,75098,,"MUNICIPIUL GALATI",132," Liceul Pegadogic ""C. Negri"" , str. Brailei nr. 134",1573,937,920,15,2,921,16,1600,663,438,483,1,7288,0
18,"Galati",75098,172,75098,,"MUNICIPIUL GALATI",133," Scoala Generala nr.33 ""Sf. Dumitru"" , str. Ionel Fernic , nr. 5 , Micro 39A",1517,773,759,14,0,765,8,1700,927,373,392,1,7288,0
18,"Galati",75098,172,75098,,"MUNICIPIUL GALATI",134," Scoala Generala nr.33 ""Sf. Dumitru"" , str. Ionel Fernic , nr. 5 , Micro 39A",1552,810,797,13,0,795,15,1700,890,423,372,1,7288,0
18,"Galati",75098,172,75098,,"MUNICIPIUL GALATI",135," Scoala Generala nr.33 ""Sf. Dumitru"" , str. Ionel Fernic , nr. 5 , Micro 39A",1508,774,758,16,0,767,7,1699,925,380,387,1,7288,0
18,"Galati",75098,172,75098,,"MUNICIPIUL GALATI",136," Scoala Generala nr.33 ""Sf. Dumitru"" , str. Ionel Fernic , nr. 5 , Micro 39A",1457,718,701,15,2,710,8,1600,882,354,356,1,7288,0
18,"Galati",75098,172,75098,,"MUNICIPIUL GALATI",137," Scoala Generala nr.31 ""Ghe. Munteanu"" , str. Camil Ressu nr. 9 , Micro 38",1638,857,844,13,0,850,7,1800,943,409,441,1,7288,0
18,"Galati",75098,172,75098,,"MUNICIPIUL GALATI",138," Scoala Generala nr.31 ""Ghe. Munteanu"" , str. Camil Ressu nr. 9 , Micro 38",1598,789,775,14,0,784,5,1800,1011,375,409,1,7288,0
18,"Galati",75098,172,75098,,"MUNICIPIUL GALATI",139," Scoala Generala nr.31 ""Ghe. Munteanu"" , str. Camil Ressu nr. 9 , Micro 38",1575,768,758,10,0,760,8,1700,932,363,397,1,7288,0
18,"Galati",75098,172,75098,,"MUNICIPIUL GALATI",140," Gradinita Filesti",400,229,212,17,0,226,3,500,271,127,99,1,7288,0
18,"Galati",75098,172,75098,,"MUNICIPIUL GALATI",141," Colegiul Tehnic ""Paul Dimo"" , str. 1 Decembrie 1918 nr. 27 (Liceul Energetic nr. 4)",1553,690,677,13,0,682,8,1700,1010,347,335,1,7288,0
18,"Galati",75098,172,75098,,"MUNICIPIUL GALATI",142," Colegiul Tehnic ""Paul Dimo"" , str. 1 Decembrie 1918 nr. 27 (Liceul Energetic nr. 4)",1633,781,765,16,0,771,10,1800,1019,380,391,1,7288,0
18,"Galati",75098,172,75098,,"MUNICIPIUL GALATI",143," Colegiul Tehnic ""Paul Dimo"" , str. 1 Decembrie 1918 nr. 27 (Liceul Energetic nr. 4)",1609,786,778,8,0,773,13,1800,1014,369,404,1,7288,0
18,"Galati",75098,172,75098,,"MUNICIPIUL GALATI",144," Colegiul Tehnic ""Paul Dimo"" , str. 1 Decembrie 1918 nr. 27 (Liceul Energetic nr. 4)",1229,602,591,11,0,595,7,1400,798,283,312,1,7288,0
18,"Galati",75098,172,75098,,"MUNICIPIUL GALATI",145," Colegiul Tehnic ""Paul Dimo"" , str. 1 Decembrie 1918 nr. 27 (Liceul Energetic nr. 4)",1455,789,714,75,0,780,9,1600,811,372,408,1,7288,0
18,"Galati",75098,172,75098,,"MUNICIPIUL GALATI",146," Colegiul Tehnic ""Paul Dimo"" , str. 1 Decembrie 1918 nr. 27 (Liceul Energetic nr. 4)",1607,834,819,15,0,824,10,1800,966,381,443,1,7288,0
18,"Galati",75098,172,75098,,"MUNICIPIUL GALATI",147," Colegiul Tehnic ""Paul Dimo"" , str. 1 Decembrie 1918 nr. 27 (Liceul Energetic nr. 4)",1544,766,751,15,0,756,10,1700,934,378,378,1,7288,0
18,"Galati",75098,172,75098,,"MUNICIPIUL GALATI",148," Colegiul Tehnic ""Paul Dimo"" , str. 1 Decembrie 1918 nr. 27 (Liceul Energetic nr. 4)",1672,874,860,14,0,864,10,1899,1025,438,426,1,7288,0
18,"Galati",75098,172,75098,,"MUNICIPIUL GALATI",149," Scoala Generala nr. 34 ""Mihai Viteazul"" , str. Traian Vuia nr. 22 , Micro 39B",1578,809,791,18,0,803,6,1700,891,434,369,1,7288,0
18,"Galati",75098,172,75098,,"MUNICIPIUL GALATI",150," Scoala Generala nr. 34 ""Mihai Viteazul"" , str. Traian Vuia nr. 22 , Micro 39B",1484,720,708,12,0,708,12,1600,880,364,344,1,7288,0
18,"Galati",75098,172,75098,,"MUNICIPIUL GALATI",151," Scoala Generala nr. 30 ""Aurel Vlaicu"" , str. V. Papilian nr. 7 , Micro 40",1384,681,669,12,0,667,14,1498,817,363,304,1,7288,0
18,"Galati",75098,172,75098,,"MUNICIPIUL GALATI",152," Scoala Generala nr. 30 ""Aurel Vlaicu"" , str. V. Papilian nr. 7 , Micro 40",1559,767,751,16,0,759,8,1700,933,412,347,1,7288,0
18,"Galati",75098,172,75098,,"MUNICIPIUL GALATI",153," Scoala Generala nr. 30 ""Aurel Vlaicu"" , str. V. Papilian nr. 7 , Micro 40",1804,785,766,19,0,778,7,2000,1215,434,344,1,7288,0
18,"Galati",75098,172,75098,,"MUNICIPIUL GALATI",154," Scoala Generala nr. 30 ""Aurel Vlaicu"" , str. V. Papilian nr. 7 , Micro 40",1542,646,634,12,0,628,18,1700,1054,375,253,1,7288,0
18,"Galati",75098,172,75098,,"MUNICIPIUL GALATI",155," Grupul Scolar Industrial nr.3 Metalurgic , str. 1 Decembrie 1918 nr. 25",1537,686,672,14,0,681,5,1700,1014,350,331,1,7288,0
18,"Galati",75098,172,75098,,"MUNICIPIUL GALATI",156," Grupul Scolar Industrial nr.3 Metalurgic , str. 1 Decembrie 1918 nr. 25",1470,690,674,15,1,679,11,1600,910,356,323,1,7288,0
18,"Galati",75098,172,75098,,"MUNICIPIUL GALATI",157," Grupul Scolar Industrial nr.3 Metalurgic , str. 1 Decembrie 1918 nr. 25",1659,883,866,17,0,871,12,1800,917,414,457,1,7288,0
18,"Galati",75098,172,75098,,"MUNICIPIUL GALATI",158," Grupul Scolar Industrial nr.3 Metalurgic , str. 1 Decembrie 1918 nr. 25",1505,711,700,11,0,701,10,1700,989,404,297,1,7288,0
18,"Galati",75098,172,75098,,"MUNICIPIUL GALATI",159," Grupul Scolar Industrial nr.8 ""Ghe. Asachi"" , B-dul. Milcov nr. 13",1194,622,608,14,0,614,8,1300,678,370,244,1,7288,0
18,"Galati",75098,172,75098,,"MUNICIPIUL GALATI",160," Grupul Scolar Industrial nr.8 ""Ghe. Asachi"" , B-dul. Milcov nr. 13",1637,785,768,16,1,774,11,1800,1015,464,310,1,7288,0
18,"Galati",75098,172,75098,,"MUNICIPIUL GALATI",161," Grupul Scolar Industrial nr.8 ""Ghe. Asachi"" , B-dul. Milcov nr. 13",1159,522,508,14,0,516,6,1310,788,298,218,1,7288,0
18,"Galati",75098,172,75098,,"MUNICIPIUL GALATI",162," Grupul Scolar Industrial Transporturi CFR , B-dul G.Cosbuc nr. 225",1607,770,758,11,1,760,10,1800,1030,418,342,1,7288,0
18,"Galati",75098,172,75098,,"MUNICIPIUL GALATI",163," Grupul Scolar Industrial Transporturi CFR , B-dul G.Cosbuc nr. 225",1573,817,806,11,0,806,11,1700,883,404,402,1,7288,0
18,"Galati",75098,172,75098,,"MUNICIPIUL GALATI",164," Grupul Scolar Industrial Transporturi CFR , B-dul G.Cosbuc nr. 225",1692,804,799,5,0,786,18,1900,1096,425,361,1,7288,0
18,"Galati",75098,172,75098,,"MUNICIPIUL GALATI",165," Scoala Generala nr.12 ""Miron Costin"" , str. Alba Iulia nr. 2",1577,847,833,14,0,827,20,1719,872,418,409,1,7288,0
18,"Galati",75098,172,75098,,"MUNICIPIUL GALATI",166," Scoala Generala nr.12 ""Miron Costin"" , str. Alba Iulia nr. 2",1618,754,745,9,0,745,9,1801,1047,339,406,1,7288,0
18,"Galati",75098,172,75098,,"MUNICIPIUL GALATI",167," Scoala Generala nr.12 ""Miron Costin"" , str. Alba Iulia nr. 2",1634,821,806,15,0,810,11,1800,979,428,382,1,7288,0
18,"Galati",75098,172,75098,,"MUNICIPIUL GALATI",168," Scoala Generala nr.12 ""Miron Costin"" , str. Alba Iulia nr. 2",1656,858,848,10,0,846,12,1800,942,466,380,1,7288,0
18,"Galati",75098,172,75098,,"MUNICIPIUL GALATI",169," Scoala Generala nr.12 ""Miron Costin"" , str. Alba Iulia nr. 2",1665,855,841,13,1,841,14,1800,945,452,389,1,7288,0
18,"Galati",75098,172,75098,,"MUNICIPIUL GALATI",170," Scoala Generala nr.12 ""Miron Costin"" , str. Alba Iulia nr. 2",1616,885,863,22,0,876,9,1800,915,421,455,1,7288,0
18,"Galati",75098,172,75098,,"MUNICIPIUL GALATI",171," Scoala Generala nr.12 ""Miron Costin"" , str. Alba Iulia nr. 2",1595,786,769,17,0,777,9,1800,1014,367,410,1,7288,0
18,"Galati",75098,172,75098,,"MUNICIPIUL GALATI",172," Scoala Generala nr.12 ""Miron Costin"" , str. Alba Iulia nr. 2",1591,783,768,15,0,772,11,1800,1017,398,374,1,7288,0
18,"Galati",75098,172,75098,,"MUNICIPIUL GALATI",173," Anexa Scolii nr. 12 , str. Tecuci nr. 160",1634,835,812,22,1,825,10,1800,965,428,397,1,7288,0
18,"Galati",75098,172,75098,,"MUNICIPIUL GALATI",174," Anexa Scolii nr. 12 , str. Tecuci nr. 160",1431,720,708,12,0,711,9,1600,880,361,350,1,7288,0
18,"Galati",75098,172,75098,,"MUNICIPIUL GALATI",175," Anexa Scolii nr. 12 , str. Tecuci nr. 160",1249,663,644,19,0,654,9,1401,738,368,286,1,7288,0
18,"Galati",75098,172,75098,,"MUNICIPIUL GALATI",176," SC ""UNICOM"" SA - Sala de Expozitii , str. Tecuci nr. 161",1668,851,836,15,0,839,12,1800,949,414,425,1,7288,0
18,"Galati",75098,172,75098,,"MUNICIPIUL GALATI",177,"Statia CFR Galati , Str. Garii nr. 1",0,1501,0,1501,0,1491,10,4000,2499,860,631,1,7288,1
18,"Galati",75098,172,75098,,"MUNICIPIUL GALATI",178,"Cantina Studenteasca , str. Domneasca nr. 155",0,1040,0,1040,0,1029,11,1196,156,659,370,1,7288,1
18,"Galati",75203,172,75203,,"MUNICIPIUL TECUCI",179," Scoala nr. 1 , str. Tecuciul nou",1273,671,666,5,0,663,8,1400,729,407,256,1,7290,0
18,"Galati",75203,172,75203,,"MUNICIPIUL TECUCI",180," Scoala nr. 1 , str. Tecuciul nou",1281,637,629,8,0,634,3,1400,763,376,258,1,7290,0
18,"Galati",75203,172,75203,,"MUNICIPIUL TECUCI",181," Scoala nr. 1 , str. Tecuciul nou",1532,785,780,5,0,772,13,1700,915,462,310,1,7290,0
18,"Galati",75203,172,75203,,"MUNICIPIUL TECUCI",182," Scoala nr. 10 , str.1 Decembrie 1918 nr. 26",1073,521,514,6,1,510,11,1199,678,234,276,1,7290,0
18,"Galati",75203,172,75203,,"MUNICIPIUL TECUCI",183," Scoala nr. 10 , str.1 Decembrie 1918 nr. 26",802,410,402,8,0,408,2,900,490,194,214,1,7290,0
18,"Galati",75203,172,75203,,"MUNICIPIUL TECUCI",184," Scoala nr. 2 , str.Alexandru Papadopol Calimah nr. 13",1417,706,690,16,0,691,15,1599,893,317,374,1,7290,0
18,"Galati",75203,172,75203,,"MUNICIPIUL TECUCI",185," Scoala nr. 2 , str.Alexandru Papadopol Calimah nr. 13",1094,476,464,12,0,465,11,1200,724,219,246,1,7290,0
18,"Galati",75203,172,75203,,"MUNICIPIUL TECUCI",186," Gradinita de Copii , str. Cuza Voda",1329,668,657,11,0,658,10,1498,830,353,305,1,7290,0
18,"Galati",75203,172,75203,,"MUNICIPIUL TECUCI",187," Scoala nr. 4 , str.Unirii nr. 6",1034,550,540,9,1,540,10,1100,550,248,292,1,7290,0
18,"Galati",75203,172,75203,,"MUNICIPIUL TECUCI",188," Scoala nr. 4 , str.Unirii nr. 6",908,503,482,20,1,494,9,1000,497,192,302,1,7290,0
18,"Galati",75203,172,75203,,"MUNICIPIUL TECUCI",189," Liceul Spiru Haret , B-dul Victoriei nr. 12",1421,818,803,15,0,808,10,1600,782,359,449,1,7290,0
18,"Galati",75203,172,75203,,"MUNICIPIUL TECUCI",190," Liceul Spiru Haret , B-dul Victoriei nr. 12",738,386,369,17,0,382,4,800,414,163,219,1,7290,0
18,"Galati",75203,172,75203,,"MUNICIPIUL TECUCI",191," Grup Scolar Agricol nr. 103",1190,557,540,17,0,555,2,1300,743,283,272,1,7290,0
18,"Galati",75203,172,75203,,"MUNICIPIUL TECUCI",192," Grup Scolar Agricol nr. 103",1529,770,757,13,0,762,8,1700,930,351,411,1,7290,0
18,"Galati",75203,172,75203,,"MUNICIPIUL TECUCI",193," Gradinita nr. 17 , str.Bradului",836,430,412,18,0,424,6,900,470,197,227,1,7290,0
18,"Galati",75203,172,75203,,"MUNICIPIUL TECUCI",194," Gradinita nr. 17 , str.Bradului",905,393,387,6,0,391,2,1000,607,183,208,1,7290,0
18,"Galati",75203,172,75203,,"MUNICIPIUL TECUCI",195," Scoala nr. 11 , str. 1 Decembrie 1918 nr. 125",1088,500,493,6,1,495,5,1200,700,241,254,1,7290,0
18,"Galati",75203,172,75203,,"MUNICIPIUL TECUCI",196," Scoala nr. 11 , str. 1 Decembrie 1918 nr. 125",1269,540,532,8,0,539,1,1400,860,281,258,1,7290,0
18,"Galati",75203,172,75203,,"MUNICIPIUL TECUCI",197," Scoala nr. 11 , str. 1 Decembrie 1918 nr. 125",1068,560,548,12,0,556,4,1200,640,275,281,1,7290,0
18,"Galati",75203,172,75203,,"MUNICIPIUL TECUCI",198," Scoala nr. 8 , str.Matei Basarab nr. 2",1362,739,730,9,0,726,13,1500,761,352,374,1,7290,0
18,"Galati",75203,172,75203,,"MUNICIPIUL TECUCI",199," Scoala nr. 6 , str.Elena Doamna nr. 52",1289,688,679,9,0,683,5,1400,712,332,351,1,7290,0
18,"Galati",75203,172,75203,,"MUNICIPIUL TECUCI",200," Scoala nr. 6 , str.Elena Doamna nr. 52",1370,650,631,19,0,647,3,1500,850,328,319,1,7290,0
18,"Galati",75203,172,75203,,"MUNICIPIUL TECUCI",201," Scoala nr. 7 , str.Ana Ipatescu",1367,657,650,7,0,638,19,1500,843,353,285,1,7290,0
18,"Galati",75203,172,75203,,"MUNICIPIUL TECUCI",202," Scoala nr. 7 , str.Ana Ipatescu",961,489,485,4,0,483,6,1100,611,282,201,1,7290,0
18,"Galati",75203,172,75203,,"MUNICIPIUL TECUCI",203," Gradinita din cartierul Nicolae Balcescu",817,413,399,13,1,404,9,900,487,220,184,1,7290,0
18,"Galati",75203,172,75203,,"MUNICIPIUL TECUCI",204," Gradinita nr. 18 , str.Gh. Petrascu nr. 58",1771,875,855,19,1,868,7,2000,1125,405,463,1,7290,0
18,"Galati",75203,172,75203,,"MUNICIPIUL TECUCI",205," Gradinita nr. 2 , str.Gh. Petrascu nr. 42",676,338,325,13,0,337,1,800,462,166,171,1,7290,0
18,"Galati",75203,172,75203,,"MUNICIPIUL TECUCI",206," Gradinita nr. 2 , str.Gh. Petrascu nr. 42",1130,539,527,12,0,534,5,1200,661,239,295,1,7290,0
18,"Galati",75203,172,75203,,"MUNICIPIUL TECUCI",207," Liceul Calistrat Hogas , str.Costache Racovita nr. 24",1029,410,388,22,0,409,1,1100,690,200,209,1,7290,0
18,"Galati",75203,172,75203,,"MUNICIPIUL TECUCI",208," Liceul Calistrat Hogas , str.Costache Racovita nr. 24",1052,522,501,21,0,519,3,1200,678,251,268,1,7290,0
18,"Galati",75203,172,75203,,"MUNICIPIUL TECUCI",209," Gradinita nr. 3 , str.1 Decembrie 1918 nr. 39",1280,561,535,26,0,557,4,1400,839,249,308,1,7290,0
18,"Galati",75203,172,75203,,"MUNICIPIUL TECUCI",210," Caminul nr. 15 , Str. Vasile Alecsandri",979,475,468,7,0,467,8,1100,625,201,266,1,7290,0
18,"Galati",75203,172,75203,,"MUNICIPIUL TECUCI",211," Scoala nr. 9 , str.Cocorasti nr. 1",971,598,586,12,0,591,7,1100,502,340,251,1,7290,0
18,"Galati",75203,172,75203,,"MUNICIPIUL TECUCI",212,"Autogara Tecuci , str. Transilvaniei nr. 7",0,541,0,541,0,534,7,800,259,265,269,1,7290,1
18,"Galati",75338,172,75338,,"ORAS BERESTI",213," Gradinita de copii , str. Muzicii nr. 12",1424,769,763,6,0,759,10,1600,831,213,546,1,7292,0
18,"Galati",75338,172,75338,,"ORAS BERESTI",214," Grup Scolar Paul Bujor , str. Trandafirilor nr. 210",1488,851,839,12,0,838,13,1700,849,228,610,1,7292,0
18,"Galati",75338,172,75338,,"ORAS BERESTI",215,"Autogara Beresti, str.Trandafirilor nr. 2B",0,130,0,130,0,130,0,300,170,71,59,1,7292,1
18,"Galati",75472,172,75472,,"ORAS TARGU BUJOR",216," Scoala Generala nr. 1 Lascar Catargiu",1578,930,920,9,1,906,24,1700,770,280,626,1,7294,0
18,"Galati",75472,172,75472,,"ORAS TARGU BUJOR",217," Scoala Generala nr. 2 Grigore Hagiu",1433,734,729,5,0,727,7,1600,866,298,429,1,7294,0
18,"Galati",75472,172,75472,,"ORAS TARGU BUJOR",218," Grup Scolar Eremia Grigorescu",1131,611,604,5,2,605,6,1200,589,259,346,1,7294,0
18,"Galati",75472,172,75472,,"ORAS TARGU BUJOR",219," Scoala generala Moscu",1081,654,639,15,0,642,12,1200,546,167,475,1,7294,0
18,"Galati",75472,172,75472,,"ORAS TARGU BUJOR",220," Scoala generala Umbraresti",923,532,511,16,5,522,10,1000,468,145,377,1,7294,0
18,"Galati",75472,172,75472,,"ORAS TARGU BUJOR",221,"Gradinita nr. 2 str.Grigore Hagiu nr. 13",0,231,0,231,0,229,2,300,69,94,135,1,7294,1
18,"Galati",75515,172,75515,,"BARCEA",222," Scoala nr. 2 Barcea",805,376,373,3,0,370,6,899,523,234,136,3,7313,0
18,"Galati",75515,172,75515,,"BARCEA",223," Scoala nr. 2 Barcea",896,425,418,7,0,414,11,996,571,249,165,3,7313,0
18,"Galati",75515,172,75515,,"BARCEA",224," Scoala  primara nr. 3 Barcea",993,490,476,14,0,483,7,1100,610,303,180,3,7313,0
18,"Galati",75515,172,75515,,"BARCEA",225," Caminul Cultural sat Barcea",1039,501,498,3,0,491,10,1200,699,297,194,3,7313,0
18,"Galati",75515,172,75515,,"BARCEA",226," Scoala  primara nr. 4 Podoleni",1073,590,580,10,0,582,8,1200,610,343,239,3,7313,0
18,"Galati",75515,172,75515,,"BARCEA",227,"Caminul Cultural , sat Barcea",0,110,0,110,0,110,0,200,90,67,43,3,7313,1
18,"Galati",75542,172,75542,,"BALABANESTI",228," Caminul Cultural Balabanesti , str.Culturii nr. 13",639,395,392,3,0,387,8,700,305,100,287,3,7298,0
18,"Galati",75542,172,75542,,"BALABANESTI",229," Scoala  generala  Bursucani , str.Luca Eugen nr. 20",496,294,287,7,0,290,4,600,306,107,183,3,7298,0
18,"Galati",75542,172,75542,,"BALABANESTI",230," Scoala generala Lungesti , str.Scolii nr. 4 , sat Lungesti",504,291,277,14,0,290,1,600,309,82,208,3,7298,0
18,"Galati",75542,172,75542,,"BALABANESTI",231,"Caminul Cultural , sat Balabanesti , str. Culturii nr. 12",0,140,0,140,0,138,2,200,60,67,71,3,7298,1
18,"Galati",75613,172,75613,,"BALASESTI",232," Scoala gimnaziala clase I-VIII Balasesti",899,591,583,8,0,573,18,1001,410,317,256,3,7303,0
18,"Galati",75613,172,75613,,"BALASESTI",233," Gradinita din satul Ciurestii Noi",463,305,295,10,0,305,0,500,195,161,144,3,7303,0
18,"Galati",75613,172,75613,,"BALASESTI",234," Scoala generala din satul Ciuresti",319,214,197,17,0,203,11,400,186,102,101,3,7303,0
18,"Galati",75613,172,75613,,"BALASESTI",235," Scoala generala  din satul Pupezeni",196,128,118,10,0,125,3,200,72,75,50,3,7303,0
18,"Galati",75613,172,75613,,"BALASESTI",236,"Scoala veche din comuna Balasesti",0,190,0,190,0,190,0,199,9,99,91,3,7303,1
18,"Galati",75668,172,75668,,"BALENI",237," Scoala generala Baleni",1313,749,733,10,6,736,13,1501,752,245,491,3,7308,0
18,"Galati",75668,172,75668,,"BALENI",238," Scoala generala Baleni",831,500,486,8,6,493,7,900,400,163,330,3,7308,0
18,"Galati",75668,172,75668,,"BALENI",239,"Scoala generala cu clase  I-VIII Baleni",0,155,0,155,0,154,1,200,45,59,95,3,7308,1
18,"Galati",75686,172,75686,,"BANEASA",240," Gradinita de copii Baneasa",1237,748,737,9,2,740,8,1400,652,328,412,3,7310,0
18,"Galati",75686,172,75686,,"BANEASA",241," Scoala Roscani",545,312,303,5,4,305,7,599,287,174,131,3,7310,0
18,"Galati",75686,172,75686,,"BANEASA",242,"Gradinita de copii, sat Baneasa",0,115,0,115,0,113,2,200,85,54,59,3,7310,1
18,"Galati",75356,172,75356,,"BERESTI-MERIA",243," Scoala  din satul Beresti Meria",464,281,270,11,0,276,5,500,219,77,199,3,7316,0
18,"Galati",75356,172,75356,,"BERESTI-MERIA",244," Scoala Slivna",611,339,329,10,0,336,3,700,361,108,228,3,7316,0
18,"Galati",75356,172,75356,,"BERESTI-MERIA",245," Scoala Puricani",322,177,168,9,0,177,0,400,223,71,106,3,7316,0
18,"Galati",75356,172,75356,,"BERESTI-MERIA",246," Scoala Aldesti",402,241,230,11,0,237,4,500,259,34,203,3,7316,0
18,"Galati",75356,172,75356,,"BERESTI-MERIA",247," Gradinita Plesa",610,310,305,5,0,303,7,700,390,118,185,3,7316,0
18,"Galati",75356,172,75356,,"BERESTI-MERIA",248," Scoala Balintesti",834,449,430,19,0,432,17,898,449,131,301,3,7316,0
18,"Galati",75356,172,75356,,"BERESTI-MERIA",249,"Centrul transfrontalier de instruire profesionala , str.Principala nr. 10 A , sat Beresti Meria",0,148,0,148,0,146,2,200,52,32,114,3,7316,1
18,"Galati",75711,172,75711,,"BRANISTEA",250," Gradinita de copii Branistea, sat Branistea",1158,570,559,5,6,567,3,1300,730,271,296,3,7332,0
18,"Galati",75711,172,75711,,"BRANISTEA",251," Gradinita de copii Branistea, sat Branistea",892,448,437,5,6,439,9,1000,552,221,218,3,7332,0
18,"Galati",75711,172,75711,,"BRANISTEA",252," Scoala generala  din  satul Vasile Alecsandri",770,392,382,1,9,388,4,900,508,233,155,3,7332,0
18,"Galati",75711,172,75711,,"BRANISTEA",253," Scoala generala  din satul Traian",396,228,221,7,0,221,7,400,172,117,104,3,7332,0
18,"Galati",75711,172,75711,,"BRANISTEA",254,"Gradinita de copii Branistea , sat Branistea",0,90,0,90,0,89,1,200,110,49,40,3,7332,1
18,"Galati",75766,172,75766,,"BRAHASESTI",255," Scoala gimnaziala  nr. 1 Brahasesti",1205,582,577,5,0,566,16,1200,618,226,340,3,7327,0
18,"Galati",75766,172,75766,,"BRAHASESTI",256," Scoala gimnaziala  nr. 1 Brahasesti",930,451,447,4,0,441,10,1000,549,209,232,3,7327,0
18,"Galati",75766,172,75766,,"BRAHASESTI",257," Scoala gimnaziala Toflea , corp vechi",1318,423,411,12,0,420,3,1500,1077,37,383,3,7327,0
18,"Galati",75766,172,75766,,"BRAHASESTI",258," Scoala gimnaziala Toflea , corp vechi",953,309,291,18,0,302,7,1100,791,42,260,3,7327,0
18,"Galati",75766,172,75766,,"BRAHASESTI",259," Scoala gimnaziala Toflea , corp nou",1217,447,423,24,0,429,18,1399,952,154,275,3,7327,0
18,"Galati",75766,172,75766,,"BRAHASESTI",260,"Scoala gimnaziala nr.1 , sat  Brahasesti",0,249,0,249,0,248,1,300,51,42,206,3,7327,1
18,"Galati",75819,172,75819,,"BUCIUMENI",261," Scoala de arte si meserii Buciumeni",871,540,518,22,0,524,16,999,459,221,303,3,7337,0
18,"Galati",75819,172,75819,,"BUCIUMENI",262," Scoala cu clasele I-VIII Hantesti",396,234,225,9,0,228,6,500,266,106,122,3,7337,0
18,"Galati",75819,172,75819,,"BUCIUMENI",263," Scoala cu clasele I-IV Vizuresti",319,184,177,7,0,180,4,400,216,75,105,3,7337,0
18,"Galati",75819,172,75819,,"BUCIUMENI",264," Scoala cu clasele I-IV Tecucel",406,232,223,9,0,227,5,500,268,99,128,3,7337,0
18,"Galati",75819,172,75819,,"BUCIUMENI",265,"Scoala de arte si meserii Buciumeni",0,104,0,104,0,104,0,199,95,59,45,3,7337,1
18,"Galati",75864,172,75864,,"CAVADINESTI",266," Scoala generala Grapeni",187,128,115,13,0,125,3,200,72,68,57,3,7342,0
18,"Galati",75864,172,75864,,"CAVADINESTI",267," Scoala gimnaziala Cavadinesti",977,597,581,16,0,589,8,1100,503,276,313,3,7342,0
18,"Galati",75864,172,75864,,"CAVADINESTI",268," Scoala gimnaziala Ganesti",675,374,369,5,0,367,7,800,426,178,189,3,7342,0
18,"Galati",75864,172,75864,,"CAVADINESTI",269," Scoala generala Vadeni",435,293,283,10,0,285,8,500,207,149,136,3,7342,0
18,"Galati",75864,172,75864,,"CAVADINESTI",270," Scoala generala Comanesti",214,141,126,15,0,140,1,300,159,53,87,3,7342,0
18,"Galati",75864,172,75864,,"CAVADINESTI",271,"Caminul Cultural , comuna Cavadinesti",0,205,0,205,0,204,1,300,95,115,89,3,7342,1
18,"Galati",75917,172,75917,,"CERTESTI",272," Scoala generala Certesti",703,459,442,15,2,451,8,800,341,265,186,3,7347,0
18,"Galati",75917,172,75917,,"CERTESTI",273," Scoala generala Carlomanesti",638,386,383,3,0,382,4,699,313,188,194,3,7347,0
18,"Galati",75917,172,75917,,"CERTESTI",274," Scoala generala Cotoroaia",628,420,411,3,6,411,9,714,294,229,182,3,7347,0
18,"Galati",75917,172,75917,,"CERTESTI",275,"Scoala generala George Ivascu , Certesti",0,165,0,165,0,162,3,200,35,93,69,3,7347,1
18,"Galati",76004,172,76004,,"CORNI",276," Scoala Noua - sat Corni",771,476,472,4,0,469,7,900,424,219,250,3,7351,0
18,"Galati",76004,172,76004,,"CORNI",277," Scoala de arte si meserii , sat  Maciseni",735,437,432,5,0,431,6,800,363,300,131,3,7351,0
18,"Galati",76004,172,76004,,"CORNI",278," Scoala generala Urlesti",432,259,252,7,0,255,4,500,241,127,128,3,7351,0
18,"Galati",76004,172,76004,,"CORNI",279,"Scoala generala Teodor si Sevastita Patrichi , str. Principala nr. 191, sat Corni",0,71,0,71,0,71,0,200,129,33,38,3,7351,1
18,"Galati",75953,172,75953,,"COROD",280," Scoala nr. 2 Corod",1224,559,532,27,0,550,9,1397,838,263,287,3,7355,0
18,"Galati",75953,172,75953,,"COROD",281," Caminul Cultural Corod",1479,718,708,10,0,706,12,1600,882,362,344,3,7355,0
18,"Galati",75953,172,75953,,"COROD",282," Scoala generala nr. 3 Corod",1547,689,684,5,0,663,26,1700,1011,287,376,3,7355,0
18,"Galati",75953,172,75953,,"COROD",283," Scoala Blanzi",957,416,398,18,0,411,5,1101,685,118,293,3,7355,0
18,"Galati",75953,172,75953,,"COROD",284," Scoala Bratulesti",523,215,208,7,0,207,8,600,385,95,112,3,7355,0
18,"Galati",75953,172,75953,,"COROD",285," Scoala Carapcesti",623,347,337,10,0,341,6,700,353,108,233,3,7355,0
18,"Galati",75953,172,75953,,"COROD",286,"Scoala nr. 2 Corod",0,114,0,114,0,111,3,201,87,52,59,3,7355,1
18,"Galati",76040,172,76040,,"COSMESTI",287," Caminul Cultural Cosmesti",1191,662,611,51,0,654,8,1300,638,237,417,3,7360,0
18,"Galati",76040,172,76040,,"COSMESTI",288," Scoala cu clasele I-VIII Cosmesti Vale",1015,578,563,15,0,562,16,1100,522,203,359,3,7360,0
18,"Galati",76040,172,76040,,"COSMESTI",289," Scoala cu clasele I-IV Baltareti",736,378,369,9,0,375,3,797,419,124,251,3,7360,0
18,"Galati",76040,172,76040,,"COSMESTI",290," Scoala  Furcenii Vechi",1261,605,590,15,0,583,22,1403,798,254,329,3,7360,0
18,"Galati",76040,172,76040,,"COSMESTI",291," Scoala cu clasele I-VIII Furcenii Noi",1286,618,605,13,0,598,20,1393,775,250,348,3,7360,0
18,"Galati",76040,172,76040,,"COSMESTI",292,"Caminul cultural - sala de sedinte , sat Cosmesti",0,120,0,120,0,118,2,200,80,43,75,3,7360,1
18,"Galati",76111,172,76111,,"COSTACHE NEGRI",293," Caminul Cultural Costache Negri",1104,611,595,3,13,602,9,1201,590,257,345,3,7367,0
18,"Galati",76111,172,76111,,"COSTACHE NEGRI",294," Caminul Cultural Costache Negri",976,550,538,2,10,540,10,1099,549,207,333,3,7367,0
18,"Galati",76111,172,76111,,"COSTACHE NEGRI",295,"Caminul Cultural Costache Negri , Biblioteca Comunala , str.Principala nr.535",0,142,0,142,0,141,1,200,58,68,73,3,7367,1
18,"Galati",76139,172,76139,,"CUCA",296," Caminul Cultural Cuca",1065,609,609,0,0,597,12,1200,591,164,433,3,7369,0
18,"Galati",76139,172,76139,,"CUCA",297," Scoala generala Cuca",1031,538,528,10,0,532,6,1100,562,151,381,3,7369,0
18,"Galati",76139,172,76139,,"CUCA",298,"Caminul Cultural Cuca , sala de festivitati",0,149,0,149,0,147,2,200,51,87,60,3,7369,1
18,"Galati",76157,172,76157,,"CUDALBI",299," Scoala gimnaziala nr. 1 Cudalbi",1806,939,918,21,0,920,19,2000,1061,394,526,3,7371,0
18,"Galati",76157,172,76157,,"CUDALBI",300," Scoala gimnaziala nr. 1 Cudalbi - corp B",1489,727,723,4,0,710,17,1700,973,295,415,3,7371,0
18,"Galati",76157,172,76157,,"CUDALBI",301," Scoala gimnaziala nr. 1 Cudalbi - corp C",1404,706,701,5,0,680,26,1600,894,253,427,3,7371,0
18,"Galati",76157,172,76157,,"CUDALBI",302," Scoala gimnaziala nr. 2 Cudalbi",1734,904,892,12,0,890,14,1900,996,445,445,3,7371,0
18,"Galati",76157,172,76157,,"CUDALBI",303,"Scoala gimnaziala nr. 1 Cudalbi - corp A",0,124,0,124,0,124,0,200,76,48,76,3,7371,1
18,"Galati",77595,172,77595,,"CUZA VODA",304," Scoala gimnaziala Elena Doamna, corp I",1271,724,708,9,7,714,10,1400,676,256,458,3,7373,0
18,"Galati",77595,172,77595,,"CUZA VODA",305," Scoala gimnaziala Elena Doamna, corp II",1136,635,619,10,6,627,8,1300,665,207,420,3,7373,0
18,"Galati",77595,172,77595,,"CUZA VODA",306,"Caminul Cultural , str. Principala , sat Cuza Voda",0,100,0,100,0,98,2,200,100,47,51,3,7373,1
18,"Galati",75221,172,75221,,"DRAGANESTI",307," Scoala din satul Draganesti",1264,653,645,4,4,650,3,1400,747,351,299,3,7375,0
18,"Galati",75221,172,75221,,"DRAGANESTI",308," Scoala din satul Draganesti",1274,673,659,11,3,667,6,1400,727,412,255,3,7375,0
18,"Galati",75221,172,75221,,"DRAGANESTI",309," Scoala din satul Malul Alb",1158,559,551,7,1,554,5,1300,741,301,253,3,7375,0
18,"Galati",75221,172,75221,,"DRAGANESTI",310," Scoala din satul Malul Alb",1006,488,474,11,3,480,8,1100,612,275,205,3,7375,0
18,"Galati",75221,172,75221,,"DRAGANESTI",311,"Scoala generala din comuna Draganesti",0,86,0,86,0,85,1,200,114,57,28,3,7375,1
18,"Galati",76175,172,76175,,"DRAGUSENI",312," Scoala cu clasele I-IV Draguseni , corp B",1376,734,728,6,0,714,20,1492,758,327,387,3,7378,0
18,"Galati",76175,172,76175,,"DRAGUSENI",313," Scoala Fundeanu",716,387,361,26,0,382,5,800,413,189,193,3,7378,0
18,"Galati",76175,172,76175,,"DRAGUSENI",314," Scoala Nicopole",451,225,218,7,0,220,5,500,275,81,139,3,7378,0
18,"Galati",76175,172,76175,,"DRAGUSENI",315," Scoala Cauiesti",468,251,246,5,0,246,5,500,249,94,152,3,7378,0
18,"Galati",76175,172,76175,,"DRAGUSENI",316," Scoala Stietesti",260,133,128,5,0,132,1,298,165,40,92,3,7378,0
18,"Galati",76175,172,76175,,"DRAGUSENI",317," Scoala Adam",618,286,277,9,0,279,7,700,414,122,157,3,7378,0
18,"Galati",76175,172,76175,,"DRAGUSENI",318," Scoala Ghinghesti",236,140,127,13,0,139,1,300,160,43,96,3,7378,0
18,"Galati",76175,172,76175,,"DRAGUSENI",319,"Scoala cu clase I-IV Draguseni",0,96,0,96,0,96,0,200,104,36,60,3,7378,1
18,"Galati",76255,172,76255,,"FARTANESTI",320," Caminul cultural Fartanesti",1391,774,768,6,0,765,9,1501,727,203,562,3,7386,0
18,"Galati",76255,172,76255,,"FARTANESTI",321," Caminul cultural Fartanesti",1407,747,738,9,0,737,10,1600,853,226,511,3,7386,0
18,"Galati",76255,172,76255,,"FARTANESTI",322," Caminul Cultural  satul Viile",1293,781,752,29,0,767,14,1400,619,186,581,3,7386,0
18,"Galati",76255,172,76255,,"FARTANESTI",323,"Dispensarul medical Fartanesti",0,144,0,144,0,144,0,196,52,52,92,3,7386,1
18,"Galati",76282,172,76282,,"FOLTESTI",324," Caminul Cultural Foltesti",1819,926,913,13,0,905,21,2000,1074,434,471,3,7389,0
18,"Galati",76282,172,76282,,"FOLTESTI",325," Scoala generala cu clase I-VIII Stoicani",830,470,463,7,0,461,9,900,430,242,219,3,7389,0
18,"Galati",76282,172,76282,,"FOLTESTI",326,"Caminul Cultural Foltesti",0,178,0,178,0,176,2,200,22,94,82,3,7389,1
18,"Galati",76317,172,76317,,"FRUMUSITA",327," Scoala generala nr.1 Frumusita",1840,934,906,28,0,916,18,2000,1066,369,547,3,7392,0
18,"Galati",76317,172,76317,,"FRUMUSITA",328," Scoala generala Petru Rares",850,489,477,12,0,474,15,800,311,134,340,3,7392,0
18,"Galati",76317,172,76317,,"FRUMUSITA",329," Scoala generala Ijdileni",686,371,354,17,0,361,10,801,430,127,234,3,7392,0
18,"Galati",76317,172,76317,,"FRUMUSITA",330," Scoala generala Tamaoani",927,467,453,14,0,458,9,1000,533,227,231,3,7392,0
18,"Galati",76317,172,76317,,"FRUMUSITA",331,"Scoala gimnaziala Petru Rares , sat Frumusita",0,261,0,261,0,260,1,350,89,108,152,3,7392,1
18,"Galati",76353,172,76353,,"FUNDENI",332," Scoala generala Fundeni",677,457,436,21,0,449,8,700,243,200,249,3,7396,0
18,"Galati",76353,172,76353,,"FUNDENI",333," Scoala generala Hanu Conachi",1220,751,737,13,1,741,10,1300,549,416,325,3,7396,0
18,"Galati",76353,172,76353,,"FUNDENI",334," Scoala generala Hanu Conachi",882,506,506,0,0,503,3,999,493,274,229,3,7396,0
18,"Galati",76353,172,76353,,"FUNDENI",335," Scoala primara Lungoci",504,299,294,5,0,294,5,600,301,158,136,3,7396,0
18,"Galati",76353,172,76353,,"FUNDENI",336,"Scoala gimnaziala Hanu Conachi",0,190,0,190,0,188,2,200,10,102,86,3,7396,1
18,"Galati",76406,172,76406,,"GHIDIGENI",337," Gradinita de copii Ghidigeni",1440,775,753,22,0,761,14,1600,825,372,389,3,7401,0
18,"Galati",76406,172,76406,,"GHIDIGENI",338," Scoala generala Gefu",823,525,511,14,0,517,8,900,375,296,221,3,7401,0
18,"Galati",76406,172,76406,,"GHIDIGENI",339," Scoala primara Garbovat",218,122,111,11,0,120,2,300,178,81,39,3,7401,0
18,"Galati",76406,172,76406,,"GHIDIGENI",340," Scoala generala Talpigi",1561,899,883,16,0,880,19,1700,801,620,260,3,7401,0
18,"Galati",76406,172,76406,,"GHIDIGENI",341," Scoala primara Slobozia Corni",618,380,372,8,0,379,1,700,320,218,161,3,7401,0
18,"Galati",76406,172,76406,,"GHIDIGENI",342,"Gradinita de copii, sala 2, str. Principala , sat Ghidigeni",0,111,0,111,0,110,1,197,86,60,50,3,7401,1
18,"Galati",76497,172,76497,,"GOHOR",343," Scoala gimnaziala Gohor",759,424,420,4,0,416,8,800,376,240,176,3,7410,0
18,"Galati",76497,172,76497,,"GOHOR",344," Scoala gimnaziala Gohor",695,416,412,4,0,406,10,800,384,216,190,3,7410,0
18,"Galati",76497,172,76497,,"GOHOR",345," Scoala cu clasele I-IV Ireasca",256,142,138,4,0,137,5,300,158,70,67,3,7410,0
18,"Galati",76497,172,76497,,"GOHOR",346," Scoala cu clasele I-IV Nartesti",719,376,372,4,0,369,7,800,424,154,215,3,7410,0
18,"Galati",76497,172,76497,,"GOHOR",347," Scoala gimnaziala Berheci",526,280,271,8,1,276,4,600,320,136,140,3,7410,0
18,"Galati",76497,172,76497,,"GOHOR",348,"Scoala gimnaziala  cu clase I-VIII, sat Gohor",0,186,0,186,0,186,0,200,14,73,113,3,7410,1
18,"Galati",76558,172,76558,,"GRIVITA",349," Scoala Noua sat Grivita",1456,752,744,8,0,742,10,1600,848,374,368,3,7416,0
18,"Galati",76558,172,76558,,"GRIVITA",350," Scoala veche Grivita",1116,565,548,17,0,557,8,1200,635,276,281,3,7416,0
18,"Galati",76558,172,76558,,"GRIVITA",351," Scoala primara sat Calmatui",526,234,228,6,0,232,2,600,366,107,125,3,7416,0
18,"Galati",76558,172,76558,,"GRIVITA",352,"Scoala veche - sala vagon, str.Deal R. , sat Grivita",0,85,0,85,0,85,0,200,115,36,49,3,7416,1
18,"Galati",76585,172,76585,,"INDEPENDENTA",353," Scoala gimnaziala nr. 1",1342,842,823,9,10,838,4,1500,658,446,392,3,7419,0
18,"Galati",76585,172,76585,,"INDEPENDENTA",354," Scoala gimnaziala nr. 2 (in cladirea gradinitei nr. 2)",1617,1011,986,7,18,991,20,1800,789,578,413,3,7419,0
18,"Galati",76585,172,76585,,"INDEPENDENTA",355," Gradinita nr.1",908,552,537,11,4,544,8,900,348,331,213,3,7419,0
18,"Galati",76585,172,76585,,"INDEPENDENTA",356,"Scoala generala nr.1, str.Tudor Vladimirescu  nr. 79",0,181,0,181,0,178,3,199,18,97,81,3,7419,1
18,"Galati",76601,172,76601,,"IVESTI",357," Scoala nr. 2 Ivesti",696,358,335,23,0,349,9,799,441,151,198,3,7421,0
18,"Galati",76601,172,76601,,"IVESTI",358," Scoala gimnaziala  nr. 3 Ivesti",1414,721,698,23,0,698,23,1600,879,299,399,3,7421,0
18,"Galati",76601,172,76601,,"IVESTI",359," Scoala de arte si meserii H.P.Bengescu Ivesti",1882,1011,968,43,0,986,25,2100,1089,311,675,3,7421,0
18,"Galati",76601,172,76601,,"IVESTI",360," Scoala gimnaziala nr.2  Negoita Danaila Bucesti",1913,881,855,26,0,866,15,2100,1219,394,472,3,7421,0
18,"Galati",76601,172,76601,,"IVESTI",361," Scoala gimnaziala nr.1 General Eremia Grigorescu  Bucesti",1754,858,826,30,2,844,14,1900,1042,411,433,3,7421,0
18,"Galati",76601,172,76601,,"IVESTI",362,"Scoala H.P. Bengescu, str.G-ral Eremia Grigorescu nr. 420",0,191,0,191,0,191,0,199,8,80,111,3,7421,1
18,"Galati",76638,172,76638,,"JORASTI",363," Scoala cu clasele I-VIII Jorasti",971,546,540,6,0,521,25,1101,555,133,388,3,7424,0
18,"Galati",76638,172,76638,,"JORASTI",364," Caminul Cultural - Sala de intruniri, sat Lunca",188,137,127,10,0,137,0,201,64,26,111,3,7424,0
18,"Galati",76638,172,76638,,"JORASTI",365," Caminul Cultural Zarnesti",303,203,195,8,0,198,5,400,197,90,108,3,7424,0
18,"Galati",76638,172,76638,,"JORASTI",366,"Scoala cu clasele I-VIII Jorasti",0,78,0,78,0,74,4,200,122,31,43,3,7424,1
18,"Galati",76674,172,76674,,"LIESTI",367," Scoala generala nr.1 Liesti",1578,725,715,10,0,712,13,1700,975,390,322,3,7428,0
18,"Galati",76674,172,76674,,"LIESTI",368," Scoala de Arte si Meserii nr. 2 Liesti",1636,751,740,11,0,742,9,1800,1049,440,302,3,7428,0
18,"Galati",76674,172,76674,,"LIESTI",369," Scoala de Arte si Meserii nr. 2 Liesti",1480,730,665,65,0,722,8,1600,870,400,322,3,7428,0
18,"Galati",76674,172,76674,,"LIESTI",370," Scoala generala nr. 3 Liesti",1392,700,664,36,0,691,9,1447,747,361,330,3,7428,0
18,"Galati",76674,172,76674,,"LIESTI",371," Gradinita nr.3 Liesti",1304,657,620,37,0,636,21,1397,740,331,305,3,7428,0
18,"Galati",76674,172,76674,,"LIESTI",372," Scoala generala nr. 4 Liesti",1538,758,750,8,0,749,9,1700,942,400,349,3,7428,0
18,"Galati",76674,172,76674,,"LIESTI",373,"Scoala gimnaziala nr.3 , comuna Liesti nr.2088",0,201,0,201,0,200,1,250,49,110,90,3,7428,1
18,"Galati",76692,172,76692,,"MATCA",374," Scoala nr. 2 Matca",1576,901,794,107,0,890,11,1700,799,550,340,3,7433,0
18,"Galati",76692,172,76692,,"MATCA",375," Scoala nr. 1 Suseni",1718,1032,928,104,0,1010,22,1900,868,657,353,3,7433,0
18,"Galati",76692,172,76692,,"MATCA",376," Scoala nr. 1 Matca",1613,869,754,115,0,850,19,1800,931,559,291,3,7433,0
18,"Galati",76692,172,76692,,"MATCA",377," Scoala nr. 1 Matca",1118,570,496,74,0,560,10,1200,630,413,147,3,7433,0
18,"Galati",76692,172,76692,,"MATCA",378," Scoala nr. 3 Matca",1862,1141,999,142,0,1121,20,2000,859,674,447,3,7433,0
18,"Galati",76692,172,76692,,"MATCA",379," Scoala nr. 1 Matca",1445,828,738,90,0,801,27,1600,772,509,292,3,7433,0
18,"Galati",76692,172,76692,,"MATCA",380,"Scoala nr. 1 Suseni , comuna Matca",0,128,0,128,0,127,1,200,72,88,39,3,7433,1
18,"Galati",76718,172,76718,,"MASTACANI",381," Scoala generala GH.V.Poalelungi , Mastacani",978,497,485,11,1,486,11,1093,596,195,291,3,7430,0
18,"Galati",76718,172,76718,,"MASTACANI",382," Scoala generala nr. 3 Mastacani",867,532,503,14,15,522,10,1001,469,288,234,3,7430,0
18,"Galati",76718,172,76718,,"MASTACANI",383," Scoala nr. 1 Dumitru Gunea Chiraftei",1147,567,550,15,2,553,14,1291,724,143,410,3,7430,0
18,"Galati",76718,172,76718,,"MASTACANI",384," Scoala generala nr. 2 Chiraftei (de la sosea)",1069,532,500,32,0,525,7,1200,668,200,325,3,7430,0
18,"Galati",76718,172,76718,,"MASTACANI",385,"Scoala generala nr. 1 Dumitru Gunea , sat Chiraftei",0,170,0,170,0,169,1,200,30,73,96,3,7430,1
18,"Galati",76745,172,76745,,"MOVILENI",386," Gradinita nr. 1 Movileni",1467,605,599,6,0,592,13,1600,995,318,274,3,7435,0
18,"Galati",76745,172,76745,,"MOVILENI",387," Scoala nr. 2 Movileni",1204,566,558,8,0,552,14,1300,734,353,199,3,7435,0
18,"Galati",76745,172,76745,,"MOVILENI",388,"Gradinita nr. 1 Movileni",0,70,0,70,0,69,1,200,130,46,23,3,7435,1
18,"Galati",75258,172,75258,,"MUNTENI",389," Gradinita de copii din satul Munteni",1404,765,743,22,0,738,27,1600,835,341,397,3,7437,0
18,"Galati",75258,172,75258,,"MUNTENI",390," Scoala gimnaziala nr. 1 sat Munteni",1871,984,965,19,0,956,28,2099,1115,360,596,3,7437,0
18,"Galati",75258,172,75258,,"MUNTENI",391," Scoala gimnaziala , sat Frunzeasca",548,292,275,17,0,286,6,600,308,142,144,3,7437,0
18,"Galati",75258,172,75258,,"MUNTENI",392," Scoala gimnaziala , sat Tiganesti",817,457,439,18,0,454,3,900,443,219,235,3,7437,0
18,"Galati",75258,172,75258,,"MUNTENI",393," Scoala gimnaziala , sat Ungureni",1146,616,598,18,0,601,15,1300,684,292,309,3,7437,0
18,"Galati",75258,172,75258,,"MUNTENI",394,"Scoala gimnaziala nr. 1 , str. Eroilor nr. 3 , Munteni",0,86,0,86,0,85,1,200,114,40,45,3,7437,1
18,"Galati",76763,172,76763,,"NAMOLOASA",395," Scoala gimnaziala nr. 1 Namoloasa",888,522,511,7,4,508,14,1001,479,188,320,3,7442,0
18,"Galati",76763,172,76763,,"NAMOLOASA",396," Scoala gimnaziala nr. 2 Namoloasa",996,592,575,11,6,583,9,1100,508,168,415,3,7442,0
18,"Galati",76763,172,76763,,"NAMOLOASA",397,"Scoala gimnaziala nr. 2 , sat Namoloasa",0,146,0,146,0,145,1,199,53,63,82,3,7442,1
18,"Galati",77579,172,77579,,"NEGRILESTI",398," Gradinita de copii din satul Negrilesti",1241,730,696,34,0,713,17,1401,671,267,446,3,7446,0
18,"Galati",77579,172,77579,,"NEGRILESTI",399," Scoala generala , sat Slobozia Blaneasa",830,490,474,16,0,479,11,900,410,274,205,3,7446,0
18,"Galati",77579,172,77579,,"NEGRILESTI",400,"Scoala generala , str. Alexandru cel Bun nr. 34 , sat Slobozia Blaneasa",0,90,0,90,0,89,1,200,110,47,42,3,7446,1
18,"Galati",76807,172,76807,,"NICORESTI",401," Scoala Nicoresti",1215,520,509,11,0,511,9,1300,780,242,269,3,7449,0
18,"Galati",76807,172,76807,,"NICORESTI",402," Scoala Fantani",511,260,243,17,0,250,10,600,340,107,143,3,7449,0
18,"Galati",76807,172,76807,,"NICORESTI",403," Scoala Coasta Lupei",313,129,120,9,0,126,3,412,283,57,69,3,7449,0
18,"Galati",76807,172,76807,,"NICORESTI",404," Scoala Piscu Corbului",204,111,100,11,0,110,1,200,89,55,55,3,7449,0
18,"Galati",76807,172,76807,,"NICORESTI",405," Scoala Malureni",155,105,90,15,0,104,1,200,95,28,76,3,7449,0
18,"Galati",76807,172,76807,,"NICORESTI",406," Scoala Ionasesti",570,294,279,15,0,287,7,598,304,183,104,3,7449,0
18,"Galati",76807,172,76807,,"NICORESTI",407," Scoala Dobrinesti",351,161,147,14,0,159,2,399,238,60,99,3,7449,0
18,"Galati",76807,172,76807,,"NICORESTI",408,"Caminul cultural , sat Nicoresti",0,144,0,144,0,141,3,201,57,56,85,3,7449,1
18,"Galati",76932,172,76932,,"OANCEA",409," Scoala gimnaziala Oancea",1179,777,777,0,0,761,16,1300,523,234,527,3,7460,0
18,"Galati",76932,172,76932,,"OANCEA",410,"Scoala gimnaziala , str. Nationala nr.124 , Oancea",0,154,0,154,0,149,5,200,46,58,91,3,7460,1
18,"Galati",76969,172,76969,,"PECHEA",411," Scoala nr. 1, str. Galati nr. 152 , Pechea",1466,739,711,28,0,725,14,1600,861,334,391,3,7463,0
18,"Galati",76969,172,76969,,"PECHEA",412," Scoala nr. 2, str. Galati nr. 179 , Pechea",1436,785,732,53,0,774,11,1517,732,369,405,3,7463,0
18,"Galati",76969,172,76969,,"PECHEA",413," Gradinita nr. 3,  str.Cooperatorilor nr. 11 , Pechea",1388,651,618,33,0,645,6,1500,849,233,412,3,7463,0
18,"Galati",76969,172,76969,,"PECHEA",414," Gradinita nr. 1 , str.Galati nr. 240 , Pechea",1261,655,613,42,0,650,5,1400,745,316,334,3,7463,0
18,"Galati",76969,172,76969,,"PECHEA",415," Caminul Cultural , str.Galati nr. 252 , Pechea",1789,867,855,12,0,854,13,2000,1133,383,471,3,7463,0
18,"Galati",76969,172,76969,,"PECHEA",416," Scoala nr.4  str.Suhurlui nr.83,  Pechea",1557,810,772,38,0,797,13,1700,890,232,565,3,7463,0
18,"Galati",76969,172,76969,,"PECHEA",417,"Scoala gimnaziala nr. 2 , str. Galati nr.179 , Pechea",0,267,0,267,0,264,3,281,14,132,132,3,7463,1
18,"Galati",76996,172,76996,,"PISCU",418," Gradinita de copii nr. 1 Piscu",1068,582,577,5,0,572,10,1200,618,261,311,3,7466,0
18,"Galati",76996,172,76996,,"PISCU",419," Scoala nr. 1 - corp B , sat Piscu",926,495,486,9,0,491,4,1000,505,264,227,3,7466,0
18,"Galati",76996,172,76996,,"PISCU",420," Scoala generala nr. 2 Piscu",1531,850,838,10,2,842,8,1700,850,478,364,3,7466,0
18,"Galati",76996,172,76996,,"PISCU",421," Caminul Cultural Vames",452,211,203,8,0,205,6,500,289,76,129,3,7466,0
18,"Galati",76996,172,76996,,"PISCU",422,"Gradinita de copii nr. 1 , sat Piscu",0,192,0,192,0,192,0,200,8,94,98,3,7466,1
18,"Galati",77587,172,77587,,"POIANA",423," Scoala Poiana",1034,693,658,17,18,686,7,1095,402,248,438,3,7469,0
18,"Galati",77587,172,77587,,"POIANA",424," Scoala Visina",367,269,243,12,14,264,5,400,131,121,143,3,7469,0
18,"Galati",77587,172,77587,,"POIANA",425,"Scoala generala , comuna Poiana",0,123,0,123,0,123,0,200,77,54,69,3,7469,1
18,"Galati",77028,172,77028,,"PRIPONESTI",426," Scoala Priponestii de Sus",816,415,406,9,0,405,10,900,485,187,218,3,7472,0
18,"Galati",77028,172,77028,,"PRIPONESTI",427," Caminul Cultural , sat Ciorasti",875,476,466,10,0,471,5,1000,524,129,342,3,7472,0
18,"Galati",77028,172,77028,,"PRIPONESTI",428," Scoala din satul Liesti",191,95,86,9,0,94,1,200,105,30,64,3,7472,0
18,"Galati",77028,172,77028,,"PRIPONESTI",429,"Scoala generala din comuna Priponesti",0,141,0,141,0,141,0,200,59,60,81,3,7472,1
18,"Galati",77561,172,77561,,"RADESTI",430," Caminul Cultural , sat Radesti",1049,638,624,14,0,618,20,1200,562,202,416,3,7478,0
18,"Galati",77561,172,77561,,"RADESTI",431," Scoala generala  Cruceanu",255,164,156,8,0,160,4,300,136,58,102,3,7478,0
18,"Galati",77561,172,77561,,"RADESTI",432,"Caminul Cultural , str.Principala nr. 39 , sat Radesti",0,135,0,135,0,134,1,200,65,60,74,3,7478,1
18,"Galati",77082,172,77082,,"REDIU",433," Scoala Arte si Meserii cu clasele I-X,  Rediu",1481,862,797,18,47,851,11,1600,738,371,480,3,7481,0
18,"Galati",77082,172,77082,,"REDIU",434," Scoala cu clasele I-IV Plevna",481,305,274,31,0,297,8,500,195,83,214,3,7481,0
18,"Galati",77082,172,77082,,"REDIU",435,"Scoala de arte si meserii , sat Rediu",0,122,0,122,0,121,1,200,78,42,79,3,7481,1
18,"Galati",77153,172,77153,,"SCHELA",436," Gradinita de copii Schela",1233,903,881,3,19,895,8,1399,496,310,585,3,7487,0
18,"Galati",77153,172,77153,,"SCHELA",437," Gradinita de copii Schela",1058,736,718,6,12,729,7,1099,363,254,475,3,7487,0
18,"Galati",77153,172,77153,,"SCHELA",438," Scoala  generala, sat Negrea",529,384,364,8,12,379,5,601,217,97,282,3,7487,0
18,"Galati",77153,172,77153,,"SCHELA",439,"Gradinita de copii , str.Principala, sat Schela",0,235,0,235,0,235,0,300,65,83,152,3,7487,1
18,"Galati",77126,172,77126,,"SCANTEIESTI",440," Caminul Cultural Scanteiesti",793,479,454,10,15,469,10,901,422,192,277,3,7484,0
18,"Galati",77126,172,77126,,"SCANTEIESTI",441," Caminul Cultural Fantanele",1383,847,805,7,35,828,19,1504,657,243,585,3,7484,0
18,"Galati",77126,172,77126,,"SCANTEIESTI",442,"Caminul Cultural , sat Fantanele",0,121,0,121,0,119,2,199,78,70,49,3,7484,1
18,"Galati",77180,172,77180,,"SLOBOZIA CONACHI",443," Sala de sedinte a primariei Slobozia Conachi",1441,820,782,14,24,815,5,1600,780,346,469,3,7494,0
18,"Galati",77180,172,77180,,"SLOBOZIA CONACHI",444," Centrul de formare profesionala  satul Slobozia Conachi",1288,730,701,15,14,721,9,1400,670,298,423,3,7494,0
18,"Galati",77180,172,77180,,"SLOBOZIA CONACHI",445," Scoala gimnaziala , satul Izvoarele",819,498,451,30,17,489,9,900,402,219,270,3,7494,0
18,"Galati",77180,172,77180,,"SLOBOZIA CONACHI",446,"Centrul de formare profesionala , sala mica , comuna Slobozia Conachi",0,157,0,157,0,155,2,200,43,56,99,3,7494,1
18,"Galati",77224,172,77224,,"SMARDAN",447," Scoala generala Smardan",1200,682,668,14,0,675,7,1300,618,318,357,3,7497,0
18,"Galati",77224,172,77224,,"SMARDAN",448," Scoala generala Smardan",685,372,362,9,1,368,4,690,318,177,191,3,7497,0
18,"Galati",77224,172,77224,,"SMARDAN",449," Scoala generala M.Kogalniceanu",690,425,411,14,0,416,9,794,369,157,259,3,7497,0
18,"Galati",77224,172,77224,,"SMARDAN",450," Scoala generala Cismele",1043,627,619,8,0,618,9,1200,573,258,360,3,7497,0
18,"Galati",77224,172,77224,,"SMARDAN",451,"Scoala generala Smardan",0,210,0,210,0,208,2,210,0,111,97,3,7497,1
18,"Galati",77260,172,77260,,"SMULTI",452," Gradinita de Copii Smulti",1287,734,718,5,11,721,13,1407,673,163,558,3,7501,0
18,"Galati",77260,172,77260,,"SMULTI",453,"Gradinita de Copii Smulti",0,142,0,142,0,142,0,198,56,80,62,3,7501,1
18,"Galati",77288,172,77288,,"SUCEVENI",454," Scoala generala cu clasele I-IV Suceveni",1068,587,569,6,12,576,11,1200,613,180,396,3,7503,0
18,"Galati",77288,172,77288,,"SUCEVENI",455," Scoala generala cu clase V-VIII Rogojeni",531,320,296,7,17,313,7,600,280,96,217,3,7503,0
18,"Galati",77288,172,77288,,"SUCEVENI",456,"Scoala generala cu clasele I-IV Suceveni",0,141,0,141,0,140,1,201,60,41,99,3,7503,1
18,"Galati",77601,172,77601,,"SUHURLUI",457," Scoala gimnaziala Suhurlui",1213,658,647,11,0,643,15,1300,642,232,411,3,7506,0
18,"Galati",77601,172,77601,,"SUHURLUI",458,"Scoala gimnaziala Suhurlui",0,93,0,93,0,93,0,200,107,48,45,3,7506,1
18,"Galati",75114,172,75114,,"SENDRENI",459," Scoala gimnaziala Sendreni",1920,1051,1041,10,0,1040,11,2100,1049,472,568,3,7490,0
18,"Galati",75114,172,75114,,"SENDRENI",460," Scoala primara Movileni",488,261,250,11,0,259,2,500,239,110,149,3,7490,0
18,"Galati",75114,172,75114,,"SENDRENI",461," Scoala primara Serbestii Vechi",533,310,302,8,0,308,2,600,290,151,157,3,7490,0
18,"Galati",75114,172,75114,,"SENDRENI",462,"Scoala gimnaziala Sendreni",0,144,0,144,0,144,0,202,58,80,64,3,7490,1
18,"Galati",77313,172,77313,,"TUDOR VLADIMIRESCU",463," Scoala generala de 8 ani - moara - Tudor Vladimirescu",768,394,381,13,0,389,5,800,406,187,202,3,7511,0
18,"Galati",77313,172,77313,,"TUDOR VLADIMIRESCU",464," Scoala generala de 4 ani - veche -  Tudor Vladimirescu",1463,904,888,16,0,896,8,1600,696,462,434,3,7511,0
18,"Galati",77313,172,77313,,"TUDOR VLADIMIRESCU",465," Scoala generala de 4 ani - Prival  - Tudor Vladimirescu",1021,633,618,15,0,626,7,1101,468,246,380,3,7511,0
18,"Galati",77313,172,77313,,"TUDOR VLADIMIRESCU",466," Grup Scolar , comuna Tudor Vladimirescu",1061,678,666,12,0,674,4,1100,422,332,342,3,7511,0
18,"Galati",77313,172,77313,,"TUDOR VLADIMIRESCU",467,"Grup Scolar , comuna Tudor Vladimirescu",0,242,0,242,0,239,3,300,58,133,106,3,7511,1
18,"Galati",77331,172,77331,,"TULUCESTI",468," Gradinita , sat Tulucesti",1733,869,851,18,0,862,7,1900,1031,476,386,3,7513,0
18,"Galati",77331,172,77331,,"TULUCESTI",469," Scoala Tulucesti",1801,891,879,12,0,875,16,2000,1109,526,349,3,7513,0
18,"Galati",77331,172,77331,,"TULUCESTI",470," Scoala Tatarca",697,404,393,11,0,390,14,800,396,183,207,3,7513,0
18,"Galati",77331,172,77331,,"TULUCESTI",471," Scoala Sivita",1118,644,631,13,0,635,9,1201,557,297,338,3,7513,0
18,"Galati",77331,172,77331,,"TULUCESTI",472," Gradinita Sivita",1013,516,507,9,0,503,13,1100,584,209,294,3,7513,0
18,"Galati",77331,172,77331,,"TULUCESTI",473,"Scoala generala , sat Tulucesti",0,184,0,184,0,183,1,200,16,100,83,3,7513,1
18,"Galati",77377,172,77377,,"TEPU",474," Scoala  gimnaziala nr. 1 Tudor Pamfile - Tepu",1311,805,768,10,27,779,26,1400,595,255,524,3,7508,0
18,"Galati",77377,172,77377,,"TEPU",475," Gradinita  Profesor Ioan Basoc, Tepu",846,591,561,19,11,576,15,900,309,204,372,3,7508,0
18,"Galati",77377,172,77377,,"TEPU",476,"Scoala gimnaziala nr. 1 Tudor Pamfile - comuna Tepu",0,82,0,82,0,79,3,200,118,29,50,3,7508,1
18,"Galati",77402,172,77402,,"UMBRARESTI",477," Scoala generala , sat  Umbraresti",1626,707,643,64,0,693,14,1800,1093,278,415,3,7517,0
18,"Galati",77402,172,77402,,"UMBRARESTI",478," Scoala generala , sat Umbraresti Deal",1967,937,846,91,0,926,11,2200,1263,388,538,3,7517,0
18,"Galati",77402,172,77402,,"UMBRARESTI",479," Scoala generala Torcesti",547,337,300,37,0,333,4,600,263,143,190,3,7517,0
18,"Galati",77402,172,77402,,"UMBRARESTI",480," Scoala generala Condrea",518,258,236,22,0,251,7,600,342,102,149,3,7517,0
18,"Galati",77402,172,77402,,"UMBRARESTI",481," Scoala Salcia",687,294,267,27,0,287,7,800,506,120,167,3,7517,0
18,"Galati",77402,172,77402,,"UMBRARESTI",482," Scoala Silistea",308,164,149,15,0,163,1,400,236,76,87,3,7517,0
18,"Galati",77402,172,77402,,"UMBRARESTI",483,"Caminul Cultural , sat Umbraresti",0,129,0,129,0,129,0,200,71,41,88,3,7517,1
18,"Galati",77475,172,77475,,"VALEA MARULUI",484," Scoala generala nr. 1 Valea Marului",889,560,534,8,18,554,6,1000,440,188,366,3,7524,0
18,"Galati",77475,172,77475,,"VALEA MARULUI",485," Scoala generala nr. 1 Valea Marului",937,564,541,5,18,557,7,950,386,165,392,3,7524,0
18,"Galati",77475,172,77475,,"VALEA MARULUI",486," Scoala generala Coasta Vaii",303,206,195,7,4,199,7,400,194,69,130,3,7524,0
18,"Galati",77475,172,77475,,"VALEA MARULUI",487," Scoala generala Mandresti",876,506,495,7,4,494,12,1000,494,148,346,3,7524,0
18,"Galati",77475,172,77475,,"VALEA MARULUI",488,"Scoala gimnaziala Valea Marului",0,208,0,208,0,203,5,250,42,52,151,3,7524,1
18,"Galati",75150,172,75150,,"VANATORI",489," Scoala Sf.Nicolae , sat Vanatori",901,529,521,8,0,523,6,899,370,275,248,3,7527,0
18,"Galati",75150,172,75150,,"VANATORI",490," Scoala Sf.Nicolae , sat Vanatori",878,524,506,18,0,521,3,999,475,238,283,3,7527,0
18,"Galati",75150,172,75150,,"VANATORI",491," Scoala Maria Grecu , sat Odaia Manolache",1364,823,811,12,0,818,5,1500,677,423,395,3,7527,0
18,"Galati",75150,172,75150,,"VANATORI",492," Scoala primara Costi",513,333,324,9,0,330,3,600,267,168,162,3,7527,0
18,"Galati",75150,172,75150,,"VANATORI",493,"Caminul Cultural , str. Eroilor nr.38, sat Vanatori",0,279,0,279,0,278,1,337,58,184,94,3,7527,1
18,"Galati",77509,172,77509,,"VARLEZI",494," Scoala  Varlezi",1001,629,588,7,34,622,7,1000,371,212,410,3,7531,0
18,"Galati",77509,172,77509,,"VARLEZI",495," Gradinita Craiesti",724,438,424,8,6,429,9,800,362,163,266,3,7531,0
18,"Galati",77509,172,77509,,"VARLEZI",496,"Scoala generala , sala 4 , comuna Varlezi",0,213,0,213,0,211,2,302,89,65,146,3,7531,1
18,"Galati",77536,172,77536,,"VLADESTI",497," Caminul Cultural sat Vladesti",985,585,579,6,0,570,15,1098,513,224,346,3,7534,0
18,"Galati",77536,172,77536,,"VLADESTI",498," Scoala , sat  Branesti",767,467,458,9,0,458,9,901,434,158,300,3,7534,0
18,"Galati",77536,172,77536,,"VLADESTI",499,"Scoala generala , comuna Vladesti",0,135,0,135,0,134,1,200,65,78,56,3,7534,1
19,"Giurgiu",100521,528,100521,,"MUNICIPIUL GIURGIU",1,"SCOALA GENERALA NR. 1 PIATA SF.GHEORGHE, NR.1",1293,732,720,12,0,717,15,1423,691,279,438,1,7538,0
19,"Giurgiu",100521,528,100521,,"MUNICIPIUL GIURGIU",2,"GALERIILE DE ARTA, STR.MIRCEA CEL BATRAN, BL. 92",1143,755,739,16,0,743,12,1258,503,243,500,1,7538,0
19,"Giurgiu",100521,528,100521,,"MUNICIPIUL GIURGIU",3,"DIRECTIA JUDETEANA PENTRU PROTECTIA COPILULUI (VIS-A-VIS DE STATIA  CFR GIURGIU ORAS)",1348,723,715,8,0,713,10,1482,759,246,467,1,7538,0
19,"Giurgiu",100521,528,100521,,"MUNICIPIUL GIURGIU",4,"LICEUL TUDOR VIANU (LICEUL NR.2) STR. 23 AUGUST NR.10",1299,665,658,6,1,654,11,1428,763,228,426,1,7538,0
19,"Giurgiu",100521,528,100521,,"MUNICIPIUL GIURGIU",5,"SCOALA GENERALA NR.2 STR. NICOLAE IORGA NR.34 (FOST 6 MARTIE)",1388,768,759,9,0,758,10,1526,758,245,513,1,7538,0
19,"Giurgiu",100521,528,100521,,"MUNICIPIUL GIURGIU",6,"LICEUL DE CHIMIE, SOS SLOBOZIEI, NR.1 (LANGA ISTRU)",1720,727,719,8,0,722,5,1892,1165,259,463,1,7538,0
19,"Giurgiu",100521,528,100521,,"MUNICIPIUL GIURGIU",7,"LICEUL DE CHIMIE, SOS. SLOBOZIEI NR.1 (LANGA ISTRU)",1268,581,572,9,0,572,9,1394,813,175,397,1,7538,0
19,"Giurgiu",100521,528,100521,,"MUNICIPIUL GIURGIU",8,"CANTINA SEMINARULUI ""SF.IOAN VALAHUL"", SOS SLOBOZIEI, NR.1",1226,582,571,11,0,577,5,1348,766,162,415,1,7538,0
19,"Giurgiu",100521,528,100521,,"MUNICIPIUL GIURGIU",9,"PALATUL COPIILOR (PARCUL ELEVILOR), SOS. ALEXANDRIEI NR.7",1362,755,741,14,0,741,14,1498,743,236,505,1,7538,0
19,"Giurgiu",100521,528,100521,,"MUNICIPIUL GIURGIU",10,"LICEUL N.CARTOJAN STR.23 AUGUST NR.57 (FOST LIC.IND.DE CONSTR.)",1219,588,575,13,0,580,8,1340,752,192,388,1,7538,0
19,"Giurgiu",100521,528,100521,,"MUNICIPIUL GIURGIU",11,"SCOALA GENERALA NR.3 STR.DAN LUCAN NR.19",1381,660,652,8,0,650,10,1519,859,231,419,1,7538,0
19,"Giurgiu",100521,528,100521,,"MUNICIPIUL GIURGIU",12,"GRADINITA NR.8 STR.GORNENI NR.54",1388,724,711,13,0,718,6,1526,802,208,510,1,7538,0
19,"Giurgiu",100521,528,100521,,"MUNICIPIUL GIURGIU",13,"DIRECTIA PENTRU AGRICULTURA SI DEZVOLTARE RURALA (SEDIUL A.P.I.A.) SOS. GHIZDARULUI NR.1",1480,520,504,16,0,506,14,1629,1109,158,348,1,7538,0
19,"Giurgiu",100521,528,100521,,"MUNICIPIUL GIURGIU",14,"DIRECTIA PENTRU AGRICULTURA SI DEZVOLTARE RURALA SOS. GHIZDARULUI NR.2",1274,691,538,13,140,678,13,1401,710,208,470,1,7538,0
19,"Giurgiu",100521,528,100521,,"MUNICIPIUL GIURGIU",15,"FOSTA SCOALA NR.9, STR.DAMBOVITEI (FABRICA DE CARAMIDA)",1599,809,796,13,0,793,16,1758,949,271,522,1,7538,0
19,"Giurgiu",100521,528,100521,,"MUNICIPIUL GIURGIU",16,"A.J.O.F.M. GIURGIU, B-DUL BUCURESTI, BL. 202/5D, MEZANIN",1011,529,518,11,0,522,7,1109,580,172,350,1,7538,0
19,"Giurgiu",100521,528,100521,,"MUNICIPIUL GIURGIU",17,"SPITALUL JUDETEAN SOS.BUCURESTI, NR.80",1220,620,608,12,0,616,4,1343,723,228,388,1,7538,0
19,"Giurgiu",100521,528,100521,,"MUNICIPIUL GIURGIU",18,"SEDIUL ISTH GIURGIU (INTRAREA VECHE SPITALUL JUDETEAN), SOS. BUCURESTI, NR.82",1075,496,483,13,0,486,10,1182,686,129,357,1,7538,0
19,"Giurgiu",100521,528,100521,,"MUNICIPIUL GIURGIU",19,"CLUBUL CADRELOR MILITARE IN RETRAGERE, SOS. BUCURESTI, NR.63-65",1783,882,866,16,0,874,8,1962,1080,264,610,1,7538,0
19,"Giurgiu",100521,528,100521,,"MUNICIPIUL GIURGIU",20,"SCOALA GENERALA NR.8,  STR. NEGRU VODA",1195,540,533,7,0,532,8,1314,774,178,354,1,7538,0
19,"Giurgiu",100521,528,100521,,"MUNICIPIUL GIURGIU",21,"CLUB IRE, SOS. BUCURESTI, BL. 202/5D PARTER",1255,640,631,9,0,629,11,1380,740,181,448,1,7538,0
19,"Giurgiu",100521,528,100521,,"MUNICIPIUL GIURGIU",22,"SCOALA GENERALA NR.8, STR. NEGRU VODA",1237,624,614,10,0,617,7,1361,737,199,418,1,7538,0
19,"Giurgiu",100521,528,100521,,"MUNICIPIUL GIURGIU",23,"SCOALA GENERALA NR.8, STR. NEGRU VODA",1344,669,661,8,0,664,5,1480,811,223,441,1,7538,0
19,"Giurgiu",100521,528,100521,,"MUNICIPIUL GIURGIU",24,"SCOALA GENERALA NR.8, STR. NEGRU VODA",1143,605,598,6,1,599,6,1257,652,209,390,1,7538,0
19,"Giurgiu",100521,528,100521,,"MUNICIPIUL GIURGIU",25,"GRADINITA NR.6, BL.40/853, PARTER. STR.NEGRU VODA",1359,633,620,13,0,625,8,1497,864,195,430,1,7538,0
19,"Giurgiu",100521,528,100521,,"MUNICIPIUL GIURGIU",26,"SCOALA GENERALA NR. 10, STR.TINERETULUI, NR.24",1160,555,539,16,0,554,1,1276,721,166,388,1,7538,0
19,"Giurgiu",100521,528,100521,,"MUNICIPIUL GIURGIU",27,"SCOALA GENERALA NR.5",1069,501,488,13,0,498,3,1177,676,177,321,1,7538,0
19,"Giurgiu",100521,528,100521,,"MUNICIPIUL GIURGIU",28,"DISPENSAR URBAN NR.5 SOS. BUCURESTI ANSAMBLUL 1D",1023,497,489,8,0,488,9,1126,629,172,316,1,7538,0
19,"Giurgiu",100521,528,100521,,"MUNICIPIUL GIURGIU",29,"PUNCTUL TERMIC 34 (LANGA 2 PAPUCI) SOS.BUCURESTI",1133,520,508,12,0,514,6,1246,726,143,371,1,7538,0
19,"Giurgiu",100521,528,100521,,"MUNICIPIUL GIURGIU",30,"PUNCTUL TERMIC 63 (LANGA BL.B1 TURN)",1186,589,578,11,0,584,5,1304,715,226,358,1,7538,0
19,"Giurgiu",100521,528,100521,,"MUNICIPIUL GIURGIU",31,"SCOALA GENERALA NR.10, STR.TINERETULUI, NR.24",1189,555,543,12,0,551,4,1307,752,240,311,1,7538,0
19,"Giurgiu",100521,528,100521,,"MUNICIPIUL GIURGIU",32,"SCOALA GENERALA NR.10, STR.TINERETULUI, NR.24",1253,561,551,9,1,553,8,1378,817,210,343,1,7538,0
19,"Giurgiu",100521,528,100521,,"MUNICIPIUL GIURGIU",33,"SCOALA GENERALA NR.10, STR.TINERETULUI, NR.24",1028,485,478,7,0,477,8,1130,645,157,320,1,7538,0
19,"Giurgiu",100521,528,100521,,"MUNICIPIUL GIURGIU",34,"GRADINITA CU PROGRAM PRELUNGIT, STR.TINERETULUI NR.3",1087,466,454,12,0,460,6,1195,729,167,293,1,7538,0
19,"Giurgiu",100521,528,100521,,"MUNICIPIUL GIURGIU",35,"GRADINITA CU PROGRAM PRELUNGIT, STR.TINERETULUI NR.3",1089,452,435,17,0,449,3,1199,747,151,298,1,7538,0
19,"Giurgiu",100521,528,100521,,"MUNICIPIUL GIURGIU",36,"SCOALA GENERALA NR.5, STR.TINERETULUI, NR.5",1327,566,549,17,0,559,7,1460,894,210,349,1,7538,0
19,"Giurgiu",100521,528,100521,,"MUNICIPIUL GIURGIU",37,"SCOALA GENERALA NR.5, STR.TINERETULUI, NR.5",1294,580,570,10,0,566,14,1423,843,204,362,1,7538,0
19,"Giurgiu",100521,528,100521,,"MUNICIPIUL GIURGIU",38,"GRADINITA CU PROGRAM PRELUNGIT NR.4, STR. TINERETULUI, NR.4",1201,511,500,11,0,501,10,1321,810,165,336,1,7538,0
19,"Giurgiu",100521,528,100521,,"MUNICIPIUL GIURGIU",39,"CANTINA DE AJUTOR SOCIAL STR. TINERETULUI",1121,414,401,13,0,410,4,1233,819,116,294,1,7538,0
19,"Giurgiu",100521,528,100521,,"MUNICIPIUL GIURGIU",40,"SCOALA GENERALA NR.6, STR.1 DECEMBRIE 1918, NR.81",1447,726,709,17,0,722,4,1591,865,232,490,1,7538,0
19,"Giurgiu",100521,528,100521,,"MUNICIPIUL GIURGIU",41,"SCOALA GENERALA NR.6, STR.1 DECEMBRIE 1918, NR.81",1263,588,579,9,0,578,10,1389,801,190,388,1,7538,0
19,"Giurgiu",100521,528,100521,,"MUNICIPIUL GIURGIU",42,"LICEUL ECONOMIC STR.1 DECEMBRIE 1918 NR.92",1237,584,571,13,0,576,8,1360,776,214,362,1,7538,0
19,"Giurgiu",100521,528,100521,,"MUNICIPIUL GIURGIU",43,"CASA ARMATEI, STR. 1 DECEMBRIE 1918",1217,585,576,9,0,579,6,1338,753,204,375,1,7538,0
19,"Giurgiu",100521,528,100521,,"MUNICIPIUL GIURGIU",44,"LICEUL ION MAIORESCU, STR.PROF.N.D. BARCIAN, NR.8",1261,763,757,6,0,753,10,1389,626,240,513,1,7538,0
19,"Giurgiu",100521,528,100521,,"MUNICIPIUL GIURGIU",45,"LICEUL ION MAIORESCU, STR.PROF.N.D. BARCIAN, NR.8",979,613,595,17,1,608,5,1076,463,196,412,1,7538,0
19,"Giurgiu",100521,528,100521,,"MUNICIPIUL GIURGIU",46,"SCOALA GENERALA NR.7, STR.PORTULUI, NR.21",1387,845,813,18,14,834,11,1526,681,260,574,1,7538,0
19,"Giurgiu",100521,528,100521,,"MUNICIPIUL GIURGIU",47,"SCOALA GENERALA NR.4, STR.VLAD TEPES, NR.45",1504,836,827,9,0,830,6,1654,818,305,525,1,7538,0
19,"Giurgiu",100521,528,100521,,"MUNICIPIUL GIURGIU",48,"GRADINITA CU PROGRAM NORMAL, STR. SMARDA",1451,744,729,14,1,740,4,1596,852,284,456,1,7538,0
19,"Giurgiu",100521,528,100521,,"MUNICIPIUL GIURGIU",49,"STATIA CFR GIURGIU ORAS, INTR. GARII, NR.1",0,504,0,504,0,498,6,1400,896,219,279,1,7538,1
19,"Giurgiu",100521,528,100521,,"MUNICIPIUL GIURGIU",50,"INCINTA PUNCT TRECERE FRONTIERA, DN5, KM 63",0,131,0,131,0,129,2,1398,1267,58,71,1,7538,1
19,"Giurgiu",101190,528,101190,,"ORAS BOLINTIN-VALE",51,"SCOALA GENERALA BOLINTIN VALE",1243,732,717,15,0,724,8,1367,635,428,296,1,7540,0
19,"Giurgiu",101190,528,101190,,"ORAS BOLINTIN-VALE",52,"SCOALA GENERALA BOLINTIN VALE",1137,584,562,22,0,553,31,1251,667,221,332,1,7540,0
19,"Giurgiu",101190,528,101190,,"ORAS BOLINTIN-VALE",53,"SCOALA GENERALA BOLINTIN VALE,",1455,718,707,11,0,664,54,1600,882,288,376,1,7540,0
19,"Giurgiu",101190,528,101190,,"ORAS BOLINTIN-VALE",54,"LICEUL BOLINTIN VALE",854,455,440,15,0,449,6,939,484,290,159,1,7540,0
19,"Giurgiu",101190,528,101190,,"ORAS BOLINTIN-VALE",55,"PRIMARIA BOLINTIN VALE",1596,787,771,16,0,774,13,1756,969,499,275,1,7540,0
19,"Giurgiu",101190,528,101190,,"ORAS BOLINTIN-VALE",56,"SCOALA GENERALA MALU-SPART",1371,677,665,12,0,667,10,1509,832,413,254,1,7540,0
19,"Giurgiu",101190,528,101190,,"ORAS BOLINTIN-VALE",57,"SCOALA GENERALA MALU-SPART,",1535,687,683,4,0,672,15,1688,1001,418,254,1,7540,0
19,"Giurgiu",101190,528,101190,,"ORAS BOLINTIN-VALE",58,"GRADINITA CRIVINA",721,367,358,9,0,360,7,793,426,183,177,1,7540,0
19,"Giurgiu",101190,528,101190,,"ORAS BOLINTIN-VALE",59,"GRUP SCOLAR DIMITRIE BOLINTINEANU, STR. REPUBLICII NR.2L",0,398,0,398,0,395,3,400,2,187,208,1,7540,1
19,"Giurgiu",104136,528,104136,,"ORAS MIHAILESTI",60,"SCOALA GENERALA NR.1 MIHAILESTI",1824,1328,1302,26,0,1306,22,2006,678,838,468,1,7545,0
19,"Giurgiu",104136,528,104136,,"ORAS MIHAILESTI",61,"SCOALA GENERALA NR. 1 - SEDIU VECHI",892,676,671,5,0,671,5,981,305,455,216,1,7545,0
19,"Giurgiu",104136,528,104136,,"ORAS MIHAILESTI",62,"SCOALA GENERALA NR.2 - TUFA",1021,708,695,13,0,685,23,1124,416,459,226,1,7545,0
19,"Giurgiu",104136,528,104136,,"ORAS MIHAILESTI",63,"SCOALA GENERALA NR.3 DRAGANESCU",364,298,289,9,0,292,6,400,102,236,56,1,7545,0
19,"Giurgiu",104136,528,104136,,"ORAS MIHAILESTI",64,"SCOALA GENERALA NR.4 POPESTI",882,652,631,21,0,641,11,970,318,450,191,1,7545,0
19,"Giurgiu",104136,528,104136,,"ORAS MIHAILESTI",65,"SCOALA GENERALA NR.5 NOVACI",913,588,578,10,0,575,13,1004,416,372,203,1,7545,0
19,"Giurgiu",104136,528,104136,,"ORAS MIHAILESTI",66,"GRUP SCOLAR MIHAILESTI, CALEA BUCURESTI, NR.168",0,867,0,867,0,858,9,1000,133,556,302,1,7545,1
19,"Giurgiu",100781,528,100781,,"ADUNATII-COPACENI",67,"SCOALA GENERALA NR.1 ADUNATII COPACENI",1461,964,829,135,0,946,18,1607,643,430,516,3,7550,0
19,"Giurgiu",100781,528,100781,,"ADUNATII-COPACENI",68,"SCOALA GENERALA NR.2 ADUNATII-COPACENI",1158,627,585,42,0,614,13,1273,646,287,327,3,7550,0
19,"Giurgiu",100781,528,100781,,"ADUNATII-COPACENI",69,"SCOALA GENERALA NR.1 DARASTI VLASCA",1660,969,951,17,1,953,16,1826,857,411,542,3,7550,0
19,"Giurgiu",100781,528,100781,,"ADUNATII-COPACENI",70,"SCOALA GENERALA NR.1 VARLAAM",467,305,291,14,0,300,5,513,208,114,186,3,7550,0
19,"Giurgiu",100781,528,100781,,"ADUNATII-COPACENI",71,"SCOALA GENERALA NR.1 MOGOSESTI",384,260,247,13,0,256,4,422,162,131,125,3,7550,0
19,"Giurgiu",100781,528,100781,,"ADUNATII-COPACENI",72,"SCOALA GENERALA CU CLS. I-VIII NR.1 ADUNATII COPACENI",0,394,0,394,0,390,4,500,106,169,221,3,7550,1
19,"Giurgiu",101001,528,101001,,"BANEASA",73,"SCOALA GENERALA NR.1 BANEASA",1828,1025,990,35,0,1004,21,1956,931,398,606,3,7555,0
19,"Giurgiu",101001,528,101001,,"BANEASA",74,"SCOALA GENERALA  NR.2 MELETIE",863,551,478,73,0,541,10,950,399,236,305,3,7555,0
19,"Giurgiu",101001,528,101001,,"BANEASA",75,"SCOALA GENERALA NR.4 PIETRELE",1029,619,605,14,0,612,7,1131,512,217,395,3,7555,0
19,"Giurgiu",101001,528,101001,,"BANEASA",76,"SCOALA GENERALA NR.3 FRASINU",463,191,185,6,0,188,3,510,319,52,136,3,7555,0
19,"Giurgiu",101001,528,101001,,"BANEASA",77,"SCOALA GENERALA NR.6 SF.GHEORGHE",202,138,124,14,0,136,2,223,85,17,119,3,7555,0
19,"Giurgiu",101001,528,101001,,"BANEASA",78,"CAMIN CULTURAL BANEASA",0,261,0,261,0,259,2,400,139,103,156,3,7555,1
19,"Giurgiu",101163,528,101163,,"BOLINTIN-DEAL",79,"CAMIN CULTURAL SALA MICA SATUL BOLINTIN DEAL",1612,773,726,42,5,764,9,1774,1001,451,313,3,7560,0
19,"Giurgiu",101163,528,101163,,"BOLINTIN-DEAL",80,"SCOALA GENERALA  CLS I-VIII SATUL BOLINTIN DEAL",1943,946,921,14,11,933,13,2139,1193,630,303,3,7560,0
19,"Giurgiu",101163,528,101163,,"BOLINTIN-DEAL",81,"SCOALA GENERALA  CLS.I-VIII-SALA CLASA A IV-A, SATUL MIHAI VODA",1554,938,889,33,16,922,16,1709,771,549,373,3,7560,0
19,"Giurgiu",101163,528,101163,,"BOLINTIN-DEAL",82,"SCOALA GENERALA NR.1 BOLINTIN DEAL, B-DUL MUNCII NR.9",0,400,0,400,0,390,10,400,0,205,185,3,7560,1
19,"Giurgiu",101378,528,101378,,"BUCSANI",83,"SAM BUCSANI",752,449,435,14,0,447,2,827,378,170,277,3,7563,0
19,"Giurgiu",101378,528,101378,,"BUCSANI",84,"SCOALA GENERALA  VADU LAT",591,424,421,3,0,421,3,652,228,136,285,3,7563,0
19,"Giurgiu",101378,528,101378,,"BUCSANI",85,"SCOALA GENERALA  PODISOR,",445,389,383,6,0,386,3,489,100,88,298,3,7563,0
19,"Giurgiu",101378,528,101378,,"BUCSANI",86,"SCOALA GENERALA  OBEDENI",377,178,178,0,0,174,4,413,235,66,108,3,7563,0
19,"Giurgiu",101378,528,101378,,"BUCSANI",87,"SCOALA GENERALA  UIESTI",284,211,207,4,0,208,3,312,101,94,114,3,7563,0
19,"Giurgiu",101378,528,101378,,"BUCSANI",88,"SCOALA GENERALA  GOLEASCA",383,326,323,3,0,315,11,422,96,97,218,3,7563,0
19,"Giurgiu",101378,528,101378,,"BUCSANI",89,"SAM BUCSANI",0,172,0,172,0,170,2,350,178,73,97,3,7563,1
19,"Giurgiu",101519,528,101519,,"BULBUCATA",90,"CAMIN CULTURAL BULBUCATA",1117,673,669,4,0,669,4,1228,555,320,349,3,7571,0
19,"Giurgiu",101519,528,101519,,"BULBUCATA",91,"CAMIN CULTURAL BULBUCATA",0,199,0,199,0,195,4,200,1,77,118,3,7571,1
19,"Giurgiu",101617,528,101617,,"BUTURUGENI",92,"SCOALA  BUTURUGENI",983,604,593,11,0,593,11,1083,479,261,332,3,7576,0
19,"Giurgiu",101617,528,101617,,"BUTURUGENI",93,"SCOALA  PRISICENI",569,408,390,18,0,401,7,625,217,164,237,3,7576,0
19,"Giurgiu",101617,528,101617,,"BUTURUGENI",94,"SCOALA  PADURENI",1230,695,688,7,0,679,16,1354,659,261,418,3,7576,0
19,"Giurgiu",101617,528,101617,,"BUTURUGENI",95,"SCOALA  POSTA",331,176,166,10,0,171,5,364,188,70,101,3,7576,0
19,"Giurgiu",101617,528,101617,,"BUTURUGENI",96,"SCOALA CU CLS.I-VIII BUTURUGENI",0,215,0,215,0,214,1,300,85,89,125,3,7576,1
19,"Giurgiu",101662,528,101662,,"CALUGARENI",97,"SCOALA GENERALA CALUGARENI",1456,818,804,13,1,801,17,1602,784,294,507,3,7581,0
19,"Giurgiu",101662,528,101662,,"CALUGARENI",98,"SCOALA  GENERALA BRANISTARI",724,426,418,8,0,412,14,797,371,117,295,3,7581,0
19,"Giurgiu",101662,528,101662,,"CALUGARENI",99,"SCOALA GENERALA  CLS.I-VIII UZUNU",1236,641,627,14,0,633,8,1359,718,288,345,3,7581,0
19,"Giurgiu",101662,528,101662,,"CALUGARENI",100,"SCOALA GENERALA  HULUBESTI",1407,928,913,15,0,910,18,1552,624,322,588,3,7581,0
19,"Giurgiu",101662,528,101662,,"CALUGARENI",101,"SCOALA GENERALA CU CLS.I-VIII CALUGARENI STR.BUCURESTI-GIURGIU NR.218",0,485,0,485,0,484,1,550,65,189,295,3,7581,1
19,"Giurgiu",101984,528,101984,,"CLEJANI",102,"CAMINUL CULTURAL CLEJANI",1419,960,891,3,66,945,15,1564,604,266,679,3,7587,0
19,"Giurgiu",101984,528,101984,,"CLEJANI",103,"SCOALA GENERALA CLS I-IV NEAJLOV",1045,848,770,7,71,816,32,1150,302,149,667,3,7587,0
19,"Giurgiu",101984,528,101984,,"CLEJANI",104,"BIBLIOTECA COMUNALA CLEJANI",0,510,0,510,0,507,3,550,40,154,353,3,7587,1
19,"Giurgiu",102071,528,102071,,"COLIBASI",105,"SCOALA GENERALA NR.1 COLIBASI",898,856,802,54,0,843,13,987,131,212,631,3,7592,0
19,"Giurgiu",102071,528,102071,,"COLIBASI",106,"SCOALA GENERALA NR.3 COLIBASI",791,536,500,36,0,527,9,870,334,216,311,3,7592,0
19,"Giurgiu",102071,528,102071,,"COLIBASI",107,"SCOALA GENERALA NR.2. CIMPURELU",1160,887,871,16,0,873,14,1276,389,241,632,3,7592,0
19,"Giurgiu",102071,528,102071,,"COLIBASI",108," SCOALA NR.1 COLIBASI",0,175,0,175,0,175,0,300,125,68,107,3,7592,1
19,"Giurgiu",102106,528,102106,,"COMANA",109,"SCOALA GENERALA CLS I-VIII COMANA",1808,1260,1245,15,0,1245,15,1988,728,1083,162,3,7595,0
19,"Giurgiu",102106,528,102106,,"COMANA",110,"SCOALA GENERALA CLS I-IV BUDENI",543,443,406,37,0,439,4,597,154,344,95,3,7595,0
19,"Giurgiu",102106,528,102106,,"COMANA",111,"SCOALA GENERALA CLS I-VIII FALASTOACA",627,449,433,15,1,444,5,689,240,263,181,3,7595,0
19,"Giurgiu",102106,528,102106,,"COMANA",112,"SCOALA GENERALA CLS I-VIII GRADISTEA,",1346,807,794,13,0,789,18,1480,673,503,286,3,7595,0
19,"Giurgiu",102106,528,102106,,"COMANA",113,"SCOALA GENERALA CLS I-VIII VLAD-TEPES",1418,1051,1034,17,0,1040,11,1557,506,833,207,3,7595,0
19,"Giurgiu",102106,528,102106,,"COMANA",114,"SCOALA CU CLS. I-VIII COMANA, STR.SERBAN CANTACUZINO, NR.361",0,822,0,822,0,812,10,950,128,555,257,3,7595,1
19,"Giurgiu",179748,528,179748,,"COSOBA",115,"GRADINITA DE COPII  COSOBA",1997,990,988,2,0,976,14,2197,1207,459,517,3,7601,0
19,"Giurgiu",179748,528,179748,,"COSOBA",116,"DISPENSARUL MEDICAL COSOBA, STR.PRINCIPALA, NR.295",0,50,0,50,0,49,1,50,0,27,22,3,7601,1
19,"Giurgiu",102348,528,102348,,"CREVEDIA MARE",117,"SCOALA  CLS I-VIII CREVEDIA MARE",1177,708,690,18,0,700,8,1296,588,319,381,3,7603,0
19,"Giurgiu",102348,528,102348,,"CREVEDIA MARE",118,"SCOALA  CU CLS I-IV  DEALU",955,544,529,15,0,532,12,1050,506,216,316,3,7603,0
19,"Giurgiu",102348,528,102348,,"CREVEDIA MARE",119,"SCOALA  CU CLS I-IV CREVEDIA MICA",1526,917,899,18,0,907,10,1678,761,353,554,3,7603,0
19,"Giurgiu",102348,528,102348,,"CREVEDIA MARE",120,"SCOALA CU CLS. I-VIII CREVEDIA MARE",0,250,0,250,0,250,0,250,0,92,158,3,7603,1
19,"Giurgiu",102446,528,102446,,"DAIA",121,"CAMINUL CULTURAL DAIA",548,310,296,14,0,307,3,583,273,81,226,3,7610,0
19,"Giurgiu",102446,528,102446,,"DAIA",122,"SCOALA  DAIA",327,165,158,7,0,162,3,359,194,54,108,3,7610,0
19,"Giurgiu",102446,528,102446,,"DAIA",123,"SCOALA  PLOPSORU",711,395,372,23,0,393,2,782,387,209,184,3,7610,0
19,"Giurgiu",102446,528,102446,,"DAIA",124,"SCOALA  CLS I-VIII  DAITA",770,365,348,17,0,353,12,847,482,130,223,3,7610,0
19,"Giurgiu",102446,528,102446,,"DAIA",125,"SCOALA PLOPSORU",0,185,0,185,0,181,4,205,20,88,93,3,7610,1
19,"Giurgiu",102794,528,102794,,"FLORESTI-STOENESTI",126,"SCOALA GENERALA STOENESTI",1506,680,673,7,0,670,10,1656,976,434,236,3,7613,0
19,"Giurgiu",102794,528,102794,,"FLORESTI-STOENESTI",127,"SCOALA  VECHE FLORESTI",1747,1048,1036,12,0,1038,10,1926,878,497,541,3,7613,0
19,"Giurgiu",102794,528,102794,,"FLORESTI-STOENESTI",128,"SCOALA  NOUA FLORESTI",1502,920,903,17,0,909,11,1652,732,465,444,3,7613,0
19,"Giurgiu",102794,528,102794,,"FLORESTI-STOENESTI",129,"SCOALA GENERALA PALANCA",1123,679,675,4,0,670,9,1236,557,520,150,3,7613,0
19,"Giurgiu",102794,528,102794,,"FLORESTI-STOENESTI",130,"SCOALA GENERALA PALANCA",932,552,549,1,2,543,9,1025,473,434,109,3,7613,0
19,"Giurgiu",102794,528,102794,,"FLORESTI-STOENESTI",131,"SCOALA GENERALA STOENESTI",0,317,0,317,0,316,1,400,83,215,101,3,7613,1
19,"Giurgiu",102909,528,102909,,"FRATESTI",132,"CAMIN CULTURAL FRATESTI",1547,792,779,13,0,781,11,1701,909,267,514,3,7617,0
19,"Giurgiu",102909,528,102909,,"FRATESTI",133,"SCOALA NR. 2 - LUNCA",608,342,330,12,0,338,4,668,326,121,217,3,7617,0
19,"Giurgiu",102909,528,102909,,"FRATESTI",134,"CAMIN CULTURAL REMUS",1612,969,938,31,0,950,19,1773,804,419,531,3,7617,0
19,"Giurgiu",102909,528,102909,,"FRATESTI",135,"SCOALA CU CLS I-IV CETATEA",440,236,210,26,0,228,8,484,248,49,179,3,7617,0
19,"Giurgiu",102909,528,102909,,"FRATESTI",136,"SCOALA CU CLS I-IV CETATEA (BALANOAIA)",253,120,110,10,0,119,1,278,158,44,75,3,7617,0
19,"Giurgiu",102909,528,102909,,"FRATESTI",137,"SCOALA GENERALA REMUS",0,482,0,482,0,478,4,600,118,291,187,3,7617,1
19,"Giurgiu",103087,528,103087,,"GAISENI",138,"SCOALA  CLS. I- VIII  GAISENI",1785,797,790,7,0,788,9,1966,1169,429,359,3,7621,0
19,"Giurgiu",103087,528,103087,,"GAISENI",139,"SCOALA CLS I- VIII CASCIOARELE",1646,715,702,13,0,699,16,1810,1095,391,308,3,7621,0
19,"Giurgiu",103087,528,103087,,"GAISENI",140,"SCOALA  CLS. I-IV  CARPENISU",629,379,366,13,0,371,8,691,312,161,210,3,7621,0
19,"Giurgiu",103087,528,103087,,"GAISENI",141,"SCOALA  CLS. I-IV  PODU POPA NAE",148,92,79,13,0,89,3,162,70,48,41,3,7621,0
19,"Giurgiu",103087,528,103087,,"GAISENI",142,"SCOALA GENERALA GAISENI",0,150,0,150,0,150,0,150,0,82,68,3,7621,1
19,"Giurgiu",103194,528,103194,,"GAUJANI",143,"SCOALA CU CLS. I-IV CETATUIA",186,132,114,9,9,127,5,194,62,53,74,3,7626,0
19,"Giurgiu",103194,528,103194,,"GAUJANI",144,"SCOALA GENERALA ""DRAGHICI DAVILA"" GAUJANI",1069,722,665,7,50,710,12,1175,453,290,420,3,7626,0
19,"Giurgiu",103194,528,103194,,"GAUJANI",145,"SCOALA CU CLS I-VIII PIETRISU",799,421,405,12,4,416,5,879,458,185,231,3,7626,0
19,"Giurgiu",103194,528,103194,,"GAUJANI",146,"SCOALA CU CLS.I-VIII GAUJANI",0,202,0,202,0,199,3,250,48,81,118,3,7626,1
19,"Giurgiu",103238,528,103238,,"GHIMPATI",147,"SCOALA CU CLASELE I-VIII  GHIMPATI",1228,870,827,31,12,860,10,1370,500,722,138,3,7630,0
19,"Giurgiu",103238,528,103238,,"GHIMPATI",148,"GRADINITA CROVU",630,539,476,25,38,529,10,693,154,425,104,3,7630,0
19,"Giurgiu",103238,528,103238,,"GHIMPATI",149,"GRADINITA COPACIU",849,599,559,5,35,585,14,934,335,381,204,3,7630,0
19,"Giurgiu",103238,528,103238,,"GHIMPATI",150,"FOSTA SCOALA  NAIPU",1347,1219,1115,9,95,1185,34,1481,262,891,294,3,7630,0
19,"Giurgiu",103238,528,103238,,"GHIMPATI",151,"SCOALA CLS  I-IV  VALEA PLOPILOR",440,312,300,12,0,306,6,484,172,216,90,3,7630,0
19,"Giurgiu",103238,528,103238,,"GHIMPATI",152,"CAMIN CULTURAL GHIMPATI, SALA MICA, STR.BUCURESTI-ALEXANDRIA",0,583,0,583,0,581,2,900,317,417,164,3,7630,1
19,"Giurgiu",103309,528,103309,,"GOGOSARI",153,"CAMIN CULTURAL GOGOSARI",690,467,460,3,4,459,8,759,292,163,296,3,7635,0
19,"Giurgiu",103309,528,103309,,"GOGOSARI",154,"SCOALA GENERALA RALESTI",133,88,81,7,0,86,2,146,58,23,63,3,7635,0
19,"Giurgiu",103309,528,103309,,"GOGOSARI",155,"FOSTA PRIMARIE DRAGHICEANU",113,87,80,6,1,85,2,124,37,33,52,3,7635,0
19,"Giurgiu",103309,528,103309,,"GOGOSARI",156,"PUNCT SANITAR IZVORU",586,333,329,4,0,324,9,644,311,92,232,3,7635,0
19,"Giurgiu",103309,528,103309,,"GOGOSARI",157,"CAMIN CULTURAL GOGOSARI",0,265,0,265,0,261,4,300,35,74,187,3,7635,1
19,"Giurgiu",103372,528,103372,,"GOSTINARI",158,"SCOALA GENERALA  CU CLS I-VIII GOSTINARI",1557,1169,1102,10,57,1140,29,1713,544,351,789,3,7640,0
19,"Giurgiu",103372,528,103372,,"GOSTINARI",159,"SCOALA GENERALA CU CLASELE I-IV MIRONESTI",458,198,188,10,0,195,3,503,305,67,128,3,7640,0
19,"Giurgiu",103372,528,103372,,"GOSTINARI",160,"SCOALA GENERALA GOSTINARI",0,306,0,306,0,296,10,350,44,88,208,3,7640,1
19,"Giurgiu",103354,528,103354,,"GOSTINU",161,"SCOALA  NR.1 GOSTINU",903,549,500,3,46,548,1,994,445,192,356,3,7643,0
19,"Giurgiu",103354,528,103354,,"GOSTINU",162,"GRADINITA GOSTINU",955,631,582,3,46,627,4,1050,419,191,436,3,7643,0
19,"Giurgiu",103354,528,103354,,"GOSTINU",163,"GRADINITA GOSTINU",0,120,0,120,0,120,0,250,130,43,77,3,7643,1
19,"Giurgiu",103407,528,103407,,"GRADINARI",164,"SCOALA CU CLS I-VIII GRADINARI",847,464,454,10,0,455,9,933,469,138,317,3,7645,0
19,"Giurgiu",103407,528,103407,,"GRADINARI",165,"SCOALA CU CLS I-VIII  TINTAVA",940,491,486,5,0,484,7,1034,543,186,298,3,7645,0
19,"Giurgiu",103407,528,103407,,"GRADINARI",166,"SCOALA CU CLS I-IV ZORILE",838,551,542,9,0,543,8,921,370,268,275,3,7645,0
19,"Giurgiu",103407,528,103407,,"GRADINARI",167,"SCOALA GRADINARI",0,197,0,197,0,195,2,200,3,105,90,3,7645,1
19,"Giurgiu",103470,528,103470,,"GREACA",168,"SCOALA GENERALA  GREACA",1553,1359,1248,10,101,1346,13,1709,350,705,641,3,7649,0
19,"Giurgiu",103470,528,103470,,"GREACA",169,"SCOALA  CLS.I-IV  PUTU GRECI",311,213,189,8,16,211,2,342,129,121,90,3,7649,0
19,"Giurgiu",103470,528,103470,,"GREACA",170,"SCOALA  CLS.I-IV  ZBOIU",274,154,145,8,1,152,2,301,147,90,62,3,7649,0
19,"Giurgiu",103470,528,103470,,"GREACA",171,"GRADINITA GREACA",0,144,0,144,0,142,2,200,56,65,77,3,7649,1
19,"Giurgiu",179757,528,179757,,"HERASTI",172,"SCOALA GENERALA HERASTI",1643,973,910,13,50,959,14,1807,834,352,607,3,7653,0
19,"Giurgiu",179757,528,179757,,"HERASTI",173,"SALA P.A.P.I., STR.PRINCIPALA, NR.3",0,250,0,250,0,248,2,250,0,100,148,3,7653,1
19,"Giurgiu",103639,528,103639,,"HOTARELE",174,"LICEUL ""UDRISTE NASTUREL"" (INTRAREA DIN FATA)",1310,633,605,28,0,620,13,1441,808,300,320,3,7656,0
19,"Giurgiu",103639,528,103639,,"HOTARELE",175,"SCOALA GENERALA  HOTARELE DEAL",642,323,290,33,0,317,6,707,384,140,177,3,7656,0
19,"Giurgiu",103639,528,103639,,"HOTARELE",176,"LICEUL ""UDRISTE NASTUREL"" (INTRAREA DIN SPATE)",709,355,307,48,0,347,8,779,424,148,199,3,7656,0
19,"Giurgiu",103639,528,103639,,"HOTARELE",177,"SCOALA GENERALA  SCARISOARA",677,429,375,54,0,419,10,744,315,144,275,3,7656,0
19,"Giurgiu",103639,528,103639,,"HOTARELE",178,"GRUP SCOLAR""UDRISTE NASTUREL""",0,283,0,283,0,276,7,350,67,137,139,3,7656,1
19,"Giurgiu",103693,528,103693,,"IEPURESTI",179,"PRIMARIA IEPURESTI,",967,708,702,6,0,689,19,1062,354,426,263,3,7658,0
19,"Giurgiu",103693,528,103693,,"IEPURESTI",180,"SCOALA GENERALA GORNENI",545,410,402,8,0,404,6,603,193,202,202,3,7658,0
19,"Giurgiu",103693,528,103693,,"IEPURESTI",181,"SCOALA  GENERALA STALPU",186,152,144,8,0,150,2,204,52,80,70,3,7658,0
19,"Giurgiu",103693,528,103693,,"IEPURESTI",182,"CAMIN CULTURAL IEPURESTI",0,499,0,499,0,486,13,499,0,219,267,3,7658,1
19,"Giurgiu",179766,528,179766,,"ISVOARELE",183,"SCOALA  CU CLS. I-VIII ISVOARELE",1209,929,899,30,0,926,3,1329,400,520,406,3,7665,0
19,"Giurgiu",179766,528,179766,,"ISVOARELE",184,"SCOALA  TEIUSU",169,149,145,4,0,149,0,185,36,108,41,3,7665,0
19,"Giurgiu",179766,528,179766,,"ISVOARELE",185,"SCOALA GENERALA CU CLS.I-VIII ISVOARELE, STR. PRINCIPALA",0,150,0,150,0,149,1,150,0,98,51,3,7665,1
19,"Giurgiu",103899,528,103899,,"IZVOARELE",186,"SCOALA GENERALA IZVOARELE",1189,637,598,39,0,630,7,1302,665,200,430,3,7668,0
19,"Giurgiu",103899,528,103899,,"IZVOARELE",187,"SCOALA GENERALA CHIRIACU",1165,618,607,10,1,607,11,1282,664,109,498,3,7668,0
19,"Giurgiu",103899,528,103899,,"IZVOARELE",188,"SCOALA GENERALA PETRU RARES",92,88,79,9,0,86,2,101,13,15,71,3,7668,0
19,"Giurgiu",103899,528,103899,,"IZVOARELE",189,"SCOALA GENERALA VALEA BUJORULUI",451,253,242,11,0,248,5,485,232,60,188,3,7668,0
19,"Giurgiu",103899,528,103899,,"IZVOARELE",190,"FOSTA PRIMARIE SAT DIMITRIE CANTEMIR",181,112,99,13,0,105,7,200,88,21,84,3,7668,0
19,"Giurgiu",103899,528,103899,,"IZVOARELE",191,"SCOALA GENERALA RADU VODA",206,116,106,10,0,113,3,226,110,35,78,3,7668,0
19,"Giurgiu",103899,528,103899,,"IZVOARELE",192,"SCOALA CU CLS. I-VIII IZVOARELE",0,247,0,247,0,241,6,349,102,57,184,3,7668,1
19,"Giurgiu",103997,528,103997,,"JOITA",193,"SALA DE SEDINTA A CONSILIULUI LOCAL JOITA",1675,891,880,11,0,875,16,1842,951,588,287,3,7675,0
19,"Giurgiu",103997,528,103997,,"JOITA",194,"SCOALA CLS.I-VIII  BICU",974,506,477,29,0,501,5,1035,529,286,215,3,7675,0
19,"Giurgiu",103997,528,103997,,"JOITA",195,"SCOALA CU CLS.I-VIII JOITA, STR. SCOLII",0,250,0,250,0,249,1,250,0,148,101,3,7675,1
19,"Giurgiu",104047,528,104047,,"LETCA NOUA",196,"CAMIN CULTURAL LETCA NOUA",780,460,452,8,0,446,14,858,398,121,325,3,7678,0
19,"Giurgiu",104047,528,104047,,"LETCA NOUA",197,"CAMIN CULTURAL LETCA VECHE,",886,883,879,4,0,874,9,974,91,100,774,3,7678,0
19,"Giurgiu",104047,528,104047,,"LETCA NOUA",198,"SCOALA  CU CLASELE I-VIII MILCOVATU",1050,565,558,7,0,552,13,1156,591,185,367,3,7678,0
19,"Giurgiu",104047,528,104047,,"LETCA NOUA",199,"CAMIN CULTURAL LETCA NOUA, STR. CAMINULUI",0,275,0,275,0,272,3,350,75,92,180,3,7678,1
19,"Giurgiu",179739,528,179739,,"MALU",200,"CAMIN CULTURAL MALU",846,460,448,11,1,452,8,930,470,108,344,3,7682,0
19,"Giurgiu",179739,528,179739,,"MALU",201,"GRADINITA MALU",1235,697,680,17,0,689,8,1358,661,148,541,3,7682,0
19,"Giurgiu",179739,528,179739,,"MALU",202,"GRADINITA MALU",0,176,0,176,0,175,1,220,44,46,129,3,7682,1
19,"Giurgiu",104225,528,104225,,"MARSA",203,"SCOALA  CLS I-VIII MARSA,  CORP A",1063,610,603,5,2,599,11,1070,460,206,393,3,7684,0
19,"Giurgiu",104225,528,104225,,"MARSA",204,"SCOALA  CLS I-VIII MARSA , CORP B",1082,638,624,7,7,634,4,1190,552,241,393,3,7684,0
19,"Giurgiu",104225,528,104225,,"MARSA",205,"GRADINITA CARE APARTINE SCOLII CU CLS.I-VIII MARSA",0,128,0,128,0,128,0,200,72,49,79,3,7684,1
19,"Giurgiu",104118,528,104118,,"MIHAI BRAVU",206,"SCOALA CU CLS.I-VIII MIHAI BRAVU",1121,669,630,13,26,656,13,1232,563,242,414,3,7686,0
19,"Giurgiu",104118,528,104118,,"MIHAI BRAVU",207,"SCOALA CLS. I-IV MIHAI BRAVU",927,580,558,3,19,564,16,1021,441,213,351,3,7686,0
19,"Giurgiu",104118,528,104118,,"MIHAI BRAVU",208,"SCOALA CLS. I-IV MIHAI BRAVU, SOS.PRINCIPALA NR.74",0,241,0,241,0,240,1,250,9,105,135,3,7686,1
19,"Giurgiu",104485,528,104485,,"OGREZENI",209,"SCOALA  GENERALA  NR.1 OGREZENI",1017,588,577,11,0,584,4,1119,531,362,222,3,7688,0
19,"Giurgiu",104485,528,104485,,"OGREZENI",210,"SCOALA GENERALA NR.2 OGREZENI,",1178,683,675,8,0,679,4,1295,612,457,222,3,7688,0
19,"Giurgiu",104485,528,104485,,"OGREZENI",211,"SCOALA  GENERALA  NR.3 OGREZENI",825,570,544,25,1,566,4,908,338,373,193,3,7688,0
19,"Giurgiu",104485,528,104485,,"OGREZENI",212,"SCOALA GENERALA NR. 4  HOBAIA",718,542,521,21,0,537,5,790,248,420,117,3,7688,0
19,"Giurgiu",104485,528,104485,,"OGREZENI",213,"SCOALA CU CLS.I-VIII, NR.1 OGREZENI",0,354,0,354,0,353,1,400,46,232,121,3,7688,1
19,"Giurgiu",104519,528,104519,,"OINACU",214,"CAMIN CULTURAL OINACU-PARTER",1618,878,857,21,0,864,14,1780,902,314,550,3,7691,0
19,"Giurgiu",104519,528,104519,,"OINACU",215,"SCOALA BRANISTEA",932,485,462,23,0,477,8,1025,540,196,281,3,7691,0
19,"Giurgiu",104519,528,104519,,"OINACU",216,"SCOALA COMASCA",507,282,273,9,0,279,3,564,282,108,171,3,7691,0
19,"Giurgiu",104519,528,104519,,"OINACU",217,"CAMIN CULTURAL OINACU",0,442,0,442,0,437,5,449,7,100,337,3,7691,1
19,"Giurgiu",104680,528,104680,,"PRUNDU",218,"CAMIN CULTURAL PRUNDU",1443,1043,1040,3,0,1033,10,1587,544,785,248,3,7695,0
19,"Giurgiu",104680,528,104680,,"PRUNDU",219,"SCOALA GENERALA CLS I-IV  PRUNDU",1322,1322,1309,13,0,1233,89,1669,347,1031,202,3,7695,0
19,"Giurgiu",104680,528,104680,,"PRUNDU",220,"SCOALA GENERALA CLS.I-IV  PUIENI",678,638,624,14,0,623,15,745,107,504,119,3,7695,0
19,"Giurgiu",104680,528,104680,,"PRUNDU",221,"CAMIN CULTURAL PRUNDU",0,288,0,288,0,286,2,350,62,192,94,3,7695,1
19,"Giurgiu",104715,528,104715,,"PUTINEIU",222,"CASA DE CULTURA PUTINEIU",1136,625,619,6,0,608,17,1249,624,158,450,3,7698,0
19,"Giurgiu",104715,528,104715,,"PUTINEIU",223,"SCOALA HODIVOAIA",339,151,151,0,0,145,6,375,224,44,101,3,7698,0
19,"Giurgiu",104715,528,104715,,"PUTINEIU",224,"SCOALA VIERU",668,348,340,8,0,342,6,734,386,97,245,3,7698,0
19,"Giurgiu",104715,528,104715,,"PUTINEIU",225,"SCOALA GENERALA HODIVOAIA",0,106,0,106,0,105,1,150,44,28,77,3,7698,1
19,"Giurgiu",104788,528,104788,,"RASUCENI",226,"SCOALA  CU ETAJ RASUCENI",906,478,456,22,0,464,14,994,516,130,334,3,7702,0
19,"Giurgiu",104788,528,104788,,"RASUCENI",227,"SCOALA  CLS I-IV RASUCENI",383,198,179,19,0,190,8,421,223,40,150,3,7702,0
19,"Giurgiu",104788,528,104788,,"RASUCENI",228,"SCOALA  CU ETAJ CUCURUZU",846,448,436,12,0,429,19,930,482,102,327,3,7702,0
19,"Giurgiu",104788,528,104788,,"RASUCENI",229,"SCOALA GENERALA CU ETAJ CU CLS.V-VIII ""CONSTANTIN STANCESCU""",0,212,0,212,0,210,2,250,38,62,148,3,7702,1
19,"Giurgiu",104831,528,104831,,"ROATA DE JOS",230,"SCOALA ROATA MICA",370,308,272,36,0,308,0,407,99,235,73,3,7707,0
19,"Giurgiu",104831,528,104831,,"ROATA DE JOS",231,"SCOALA NR.6 ROATA DE JOS",889,624,619,5,0,612,12,979,355,418,194,3,7707,0
19,"Giurgiu",104831,528,104831,,"ROATA DE JOS",232,"SCOALA NR.1 ROATA DE JOS",1047,657,651,6,0,649,8,1151,494,381,268,3,7707,0
19,"Giurgiu",104831,528,104831,,"ROATA DE JOS",233,"SCOALA SADINA",1110,782,763,19,0,775,7,1221,439,518,257,3,7707,0
19,"Giurgiu",104831,528,104831,,"ROATA DE JOS",234,"SCOALA CARTOJANI",1025,670,662,8,0,660,10,1127,457,330,330,3,7707,0
19,"Giurgiu",104831,528,104831,,"ROATA DE JOS",235,"SCOALA CARTOJANI",1123,685,677,8,0,674,11,1235,550,361,313,3,7707,0
19,"Giurgiu",104831,528,104831,,"ROATA DE JOS",236,"GRADINITA CARTOJANI",783,481,479,2,0,478,3,861,380,298,180,3,7707,0
19,"Giurgiu",104831,528,104831,,"ROATA DE JOS",237,"SCOALA GENERALA CU CLS.I-VIII ROATA DE JOS, STR. REPUBLICII NR.6",0,401,0,401,0,398,3,500,99,258,140,3,7707,1
19,"Giurgiu",179775,528,179775,,"SABARENI",238,"SCOALA CU CLS I-VIII SABARENI",1988,1008,998,10,0,998,10,2186,1178,473,525,3,7712,0
19,"Giurgiu",179775,528,179775,,"SABARENI",239,"SCOALA CU CLS.I-VIII SABARENI, ULITA SCOLII NR.724",0,100,0,100,0,99,1,100,0,48,51,3,7712,1
19,"Giurgiu",104975,528,104975,,"SCHITU",240,"SCOALA  SCHITU",217,116,116,0,0,114,2,238,122,32,82,3,7714,0
19,"Giurgiu",104975,528,104975,,"SCHITU",241,"SCOALA  BILA",443,220,215,5,0,212,8,487,267,70,142,3,7714,0
19,"Giurgiu",104975,528,104975,,"SCHITU",242,"SCOALA CAMINEASCA",495,297,287,10,0,293,4,544,247,138,155,3,7714,0
19,"Giurgiu",104975,528,104975,,"SCHITU",243,"SCOALA  VLASIN",477,301,294,7,0,294,7,524,223,89,205,3,7714,0
19,"Giurgiu",104975,528,104975,,"SCHITU",244,"SCOALA GENERALA SCHITU, SALA NR.2",0,200,0,200,0,197,3,200,0,69,128,3,7714,1
19,"Giurgiu",105106,528,105106,,"SINGURENI",245,"SCOALA CU CLS I-VIII SINGURENI",1313,710,705,5,0,701,9,1444,734,320,381,3,7719,0
19,"Giurgiu",105106,528,105106,,"SINGURENI",246,"SCOALA CU CLS I-IV CRINGURI",614,415,402,12,1,407,8,677,262,164,243,3,7719,0
19,"Giurgiu",105106,528,105106,,"SINGURENI",247,"SCOALA CU CLS I-IV STEJARU",612,369,363,6,0,362,7,673,304,129,233,3,7719,0
19,"Giurgiu",105106,528,105106,,"SINGURENI",248,"SCOALA CU CLS. I-VIII SINGURENI",0,300,0,300,0,299,1,400,100,141,158,3,7719,1
19,"Giurgiu",100549,528,100549,,"SLOBOZIA",249,"SCOALA GENERALA SLOBOZIA",815,438,428,10,0,427,11,896,458,117,310,3,7723,0
19,"Giurgiu",100549,528,100549,,"SLOBOZIA",250,"GRADINITA  SLOBOZIA",1235,672,668,4,0,662,10,1358,686,205,457,3,7723,0
19,"Giurgiu",100549,528,100549,,"SLOBOZIA",251,"GRADINITA SLOBOZIA SALA NR.2",0,431,0,431,0,423,8,500,69,210,213,3,7723,1
19,"Giurgiu",105295,528,105295,,"STANESTI",252,"SCOALA STANESTI",1172,777,733,7,37,765,12,1285,508,146,619,3,7725,0
19,"Giurgiu",105295,528,105295,,"STANESTI",253,"SCOALA GENERALA GHIZDARU",475,301,291,10,0,292,9,522,221,62,230,3,7725,0
19,"Giurgiu",105295,528,105295,,"STANESTI",254,"SCOALA GENERALA BALANU",381,242,234,8,0,239,3,419,177,30,209,3,7725,0
19,"Giurgiu",105295,528,105295,,"STANESTI",255,"GRADINITA ONCESTI",317,241,213,12,16,234,7,348,107,55,179,3,7725,0
19,"Giurgiu",105295,528,105295,,"STANESTI",256,"SCOALA CU CLS.I-VIII STANESTI",0,252,0,252,0,250,2,300,48,37,213,3,7725,1
19,"Giurgiu",105348,528,105348,,"STOENESTI",257,"SCOALA GENERALA CLS I-IV IANCULESTI",205,139,135,4,0,134,5,225,86,34,100,3,7730,0
19,"Giurgiu",105348,528,105348,,"STOENESTI",258,"CAMIN CULTURAL STOENESTI",994,927,913,14,0,903,24,1093,166,267,636,3,7730,0
19,"Giurgiu",105348,528,105348,,"STOENESTI",259,"SCOALA GENERALA CLS I-IV  STOENESTI (TANGIRU)",446,389,378,11,0,376,13,490,101,78,298,3,7730,0
19,"Giurgiu",105348,528,105348,,"STOENESTI",260,"SCOALA CLS I-IV MIRAU",164,137,124,13,0,133,4,180,43,17,116,3,7730,0
19,"Giurgiu",105348,528,105348,,"STOENESTI",261,"SCOALA CU CLS.I-VIII STOENESTI",0,319,0,319,0,315,4,500,181,87,228,3,7730,1
19,"Giurgiu",154709,528,154709,,"TOPORU",262,"CAMIN CULTURAL TOPORU",1212,744,647,10,87,722,22,1333,589,176,546,3,7734,0
19,"Giurgiu",154709,528,154709,,"TOPORU",263,"SCOALA GENERALA TOMULESTI,",551,402,372,8,22,398,4,606,204,104,294,3,7734,0
19,"Giurgiu",154709,528,154709,,"TOPORU",264,"SCOALA CU CLS. I-VIII TOPORU",0,196,0,196,0,195,1,200,4,53,142,3,7734,1
19,"Giurgiu",105623,528,105623,,"ULMI",265,"SCOALA ULMI",857,406,392,14,0,401,5,942,536,226,175,3,7737,0
19,"Giurgiu",105623,528,105623,,"ULMI",266,"SCOALA POENARI",1138,592,584,8,0,588,4,1251,659,367,221,3,7737,0
19,"Giurgiu",105623,528,105623,,"ULMI",267,"SCOALA  TRESTIENI",1976,900,891,9,0,892,8,2173,1273,375,517,3,7737,0
19,"Giurgiu",105623,528,105623,,"ULMI",268,"SCOALA  DRAGANEASCA",574,302,275,27,0,297,5,631,329,120,177,3,7737,0
19,"Giurgiu",105623,528,105623,,"ULMI",269,"SCOALA  ICOANA",832,470,462,8,0,466,4,915,445,337,129,3,7737,0
19,"Giurgiu",105623,528,105623,,"ULMI",270,"SCOALA  GHIONEA",418,222,216,6,0,219,3,459,237,149,70,3,7737,0
19,"Giurgiu",105623,528,105623,,"ULMI",271,"SCOALA GENERALA CU CLS.I-IV ULMI",0,320,0,320,0,317,3,549,229,164,153,3,7737,1
19,"Giurgiu",105776,528,105776,,"VALEA DRAGULUI",272,"SCOALA GENERALA VALEA DRAGULUI",1465,989,948,8,33,976,13,1611,622,594,382,3,7746,0
19,"Giurgiu",105776,528,105776,,"VALEA DRAGULUI",273,"SCOALA CIOCOVENI",1029,848,779,32,37,831,17,1131,283,577,254,3,7746,0
19,"Giurgiu",105776,528,105776,,"VALEA DRAGULUI",274,"SCOALA CIOCOVENI",0,666,0,666,0,651,15,755,89,430,221,3,7746,1
19,"Giurgiu",105972,528,105972,,"VANATORII MICI",275,"SCOALA CU CLS I-VIII VANATORII MICI,",843,462,453,9,0,456,6,927,465,206,250,3,7748,0
19,"Giurgiu",105972,528,105972,,"VANATORII MICI",276,"SCOALA  VECHE SAT IZVORU",665,381,372,9,0,374,7,731,350,144,230,3,7748,0
19,"Giurgiu",105972,528,105972,,"VANATORII MICI",277,"SCOALA  CLS I-VIII VANATORII MARI",1015,600,588,12,0,593,7,1116,516,192,401,3,7748,0
19,"Giurgiu",105972,528,105972,,"VANATORII MICI",278,"SCOALA  SAT POIANA LUI STINGA",524,354,342,12,0,351,3,576,222,171,180,3,7748,0
19,"Giurgiu",105972,528,105972,,"VANATORII MICI",279,"SCOALA  SAT CORBEANCA",379,245,231,14,0,240,5,416,171,90,150,3,7748,0
19,"Giurgiu",105972,528,105972,,"VANATORII MICI",280,"SCOALA  SAT CUPELE",357,243,235,8,0,240,3,398,155,78,162,3,7748,0
19,"Giurgiu",105972,528,105972,,"VANATORII MICI",281,"SCOALA CU CLS.I-VIII VANATORII MICI",0,257,0,257,0,256,1,350,93,127,129,3,7748,1
19,"Giurgiu",105874,528,105874,,"VARASTI",282,"SCOALA VECHE VARASTI",1142,879,872,7,0,865,14,1258,379,379,486,3,7757,0
19,"Giurgiu",105874,528,105874,,"VARASTI",283,"GRADINITA DE COPII VARASTI",958,772,751,21,0,757,15,1053,281,372,385,3,7757,0
19,"Giurgiu",105874,528,105874,,"VARASTI",284,"SCOALA CU CLS. I-IV VARASTI CARTIER  OBEDENI",953,616,610,6,0,613,3,1049,433,258,355,3,7757,0
19,"Giurgiu",105874,528,105874,,"VARASTI",285,"SCOALA  CU CLS.I-VIII DOBRENI",1827,1025,1019,6,0,1000,25,2010,985,440,560,3,7757,0
19,"Giurgiu",105874,528,105874,,"VARASTI",286,"CAMIN CULTURAL VARASTI, SOS.PRINCIPALA",0,292,0,292,0,286,6,300,8,138,148,3,7757,1
19,"Giurgiu",105909,528,105909,,"VEDEA",287,"SCOALA DE 4 ANI JAPCA",739,363,345,17,1,362,1,814,451,117,245,3,7760,0
19,"Giurgiu",105909,528,105909,,"VEDEA",288,"CAMINUL CULTURAL (GRADINITA  VEDEA)",828,464,448,16,0,459,5,910,446,166,293,3,7760,0
19,"Giurgiu",105909,528,105909,,"VEDEA",289,"SCOALA GENERALA DE 8 ANI ""APOSTOL ARSACHE"" VEDEA",855,402,389,13,0,394,8,938,536,102,292,3,7760,0
19,"Giurgiu",105909,528,105909,,"VEDEA",290,"GRADINITA NR.2 VEDEA, STR. ARSACHE, NR.25",0,242,0,242,0,240,2,250,8,133,107,3,7760,1
20,"Gorj",77812,181,77812,,"MUNICIPIUL TARGU JIU",1,"Universitatea ""Constantin Brancusi"" din Str. Geneva",1950,1127,1104,23,0,1114,13,2000,873,438,676,1,7763,0
20,"Gorj",77812,181,77812,,"MUNICIPIUL TARGU JIU",2,"Colegiul National ""Tudor Vladimirescu"" , strada Unirii",835,479,465,14,0,473,6,1000,521,198,275,1,7763,0
20,"Gorj",77812,181,77812,,"MUNICIPIUL TARGU JIU",3,"Scoala gimnaziala ""Constantin Savoiu"",  strada Unirii",1852,1002,993,9,0,999,3,2000,998,397,602,1,7763,0
20,"Gorj",77812,181,77812,,"MUNICIPIUL TARGU JIU",4,"Grupul Scolar Industrial Materiale de Constructii(Liceul Industrial nr. 2),  strada Victoriei",1802,943,933,10,0,935,8,2000,1057,408,527,1,7763,0
20,"Gorj",77812,181,77812,,"MUNICIPIUL TARGU JIU",5,"Scoala primara din localitatea Romanesti",610,364,351,13,0,362,2,700,336,163,199,1,7763,0
20,"Gorj",77812,181,77812,,"MUNICIPIUL TARGU JIU",6,"Scoala generala ""Alexandru Stefulescu""(fosta nr.4) ,  strada Eroilor",1108,613,605,8,0,608,5,1200,587,212,396,1,7763,0
20,"Gorj",77812,181,77812,,"MUNICIPIUL TARGU JIU",7,"Colegiul Comercial "" Virgil Madgearu"", str. Tudor Vladimirescu",1327,748,737,11,0,743,5,1400,652,289,454,1,7763,0
20,"Gorj",77812,181,77812,,"MUNICIPIUL TARGU JIU",8,"Universitatea ""Constantin Brancusi""(fosta Scoala generala nr. 10), strada Calea Bucuresti",1266,701,693,8,0,695,6,1300,599,265,430,1,7763,0
20,"Gorj",77812,181,77812,,"MUNICIPIUL TARGU JIU",9,"Scoala primara din localitatea Dragoieni",1218,692,684,8,0,683,9,1300,608,254,429,1,7763,0
20,"Gorj",77812,181,77812,,"MUNICIPIUL TARGU JIU",10,"Scoala gimnaziala ""Constantin Savoiu"",  strada Unirii",1394,708,689,19,0,699,9,1600,892,313,386,1,7763,0
20,"Gorj",77812,181,77812,,"MUNICIPIUL TARGU JIU",11,"Casa Tineretului, str. Nicolae Titulescu",1226,729,701,28,0,725,4,1300,571,294,431,1,7763,0
20,"Gorj",77812,181,77812,,"MUNICIPIUL TARGU JIU",12,"Colegiul National ""Spiru Haret"", strada 1 Decembrie 1918",1162,604,593,11,0,601,3,1200,596,253,348,1,7763,0
20,"Gorj",77812,181,77812,,"MUNICIPIUL TARGU JIU",13,"Palatul Copiilor, strada Siret",1257,702,688,14,0,693,9,1300,598,308,385,1,7763,0
20,"Gorj",77812,181,77812,,"MUNICIPIUL TARGU JIU",14,"Liceul Teologic(Scoala generala nr.13), strada A.I. Cuza",1663,946,929,17,0,939,7,1700,754,382,557,1,7763,0
20,"Gorj",77812,181,77812,,"MUNICIPIUL TARGU JIU",15,"Liceul Teologic(Scoala generala nr.13), strada A.I. Cuza",1691,751,744,7,0,746,5,1700,949,341,405,1,7763,0
20,"Gorj",77812,181,77812,,"MUNICIPIUL TARGU JIU",16,"Colegiul National ""Spiru Haret"", strada 1 Decembrie 1918",1820,850,828,22,0,844,6,2000,1150,382,462,1,7763,0
20,"Gorj",77812,181,77812,,"MUNICIPIUL TARGU JIU",17,"Scoala gimnaziala ""Gheorghe Tatarascu""(fosta nr.1),  strada 23 August",1736,804,788,16,0,788,16,1800,996,363,425,1,7763,0
20,"Gorj",77812,181,77812,,"MUNICIPIUL TARGU JIU",18,"Scoala generala ""Pompiliu Marcea""(fosta nr.11), strada Mioritei",1875,809,798,11,0,798,11,2000,1191,363,435,1,7763,0
20,"Gorj",77812,181,77812,,"MUNICIPIUL TARGU JIU",19,"Scoala generala ""Pompiliu Marcea""(fosta nr.11), strada Mioritei",1920,948,939,9,0,937,11,2000,1052,389,548,1,7763,0
20,"Gorj",77812,181,77812,,"MUNICIPIUL TARGU JIU",20,"Colegiul National ""Spiru Haret"", strada 1 Decembrie 1918",1589,784,775,9,0,781,3,1600,816,361,420,1,7763,0
20,"Gorj",77812,181,77812,,"MUNICIPIUL TARGU JIU",21,"Colegiul National ""Spiru Haret"", strada 1 Decembrie 1918",1395,700,692,8,0,694,6,1600,900,302,392,1,7763,0
20,"Gorj",77812,181,77812,,"MUNICIPIUL TARGU JIU",22,"Scoala generala ""Constantin Brancusi""(fosta nr.12), strada Liviu Rebreanu",1988,1047,1041,6,0,1039,8,2000,953,416,623,1,7763,0
20,"Gorj",77812,181,77812,,"MUNICIPIUL TARGU JIU",23,"Scoala generala ""Constantin Brancusi""(fosta nr.12), strada Liviu Rebreanu",1784,918,903,14,1,914,4,1800,882,391,523,1,7763,0
20,"Gorj",77812,181,77812,,"MUNICIPIUL TARGU JIU",24,"Scoala generala ""Constantin Brancusi""(fostanr.12), strada Liviu Rebreanu",1363,673,666,7,0,668,5,1600,927,300,368,1,7763,0
20,"Gorj",77812,181,77812,,"MUNICIPIUL TARGU JIU",25,"Scoala generala""Constantin Brancusi""(fosta  nr.12), strada Liviu Rebreanu",1949,938,927,11,0,925,13,2000,1062,434,491,1,7763,0
20,"Gorj",77812,181,77812,,"MUNICIPIUL TARGU JIU",26,"Scoala gimnaziala ""Gheorghe Tatarascu""(fosta nr.1),  strada 23 August",1807,988,976,12,0,979,9,2000,1012,415,564,1,7763,0
20,"Gorj",77812,181,77812,,"MUNICIPIUL TARGU JIU",27,"Colegiul National ""Ecaterina Teodoroiu"", strada 1 Decembrie 1918",1591,794,781,13,0,791,3,1600,806,364,427,1,7763,0
20,"Gorj",77812,181,77812,,"MUNICIPIUL TARGU JIU",28,"Colegiul National ""Ecaterina Teodoroiu"", strada 1 Decembrie 1918",1709,835,830,5,0,833,2,1800,965,385,448,1,7763,0
20,"Gorj",77812,181,77812,,"MUNICIPIUL TARGU JIU",29,"Colegiul National ""Ecaterina Teodoroiu"", strada 1 Decembrie 1918",1674,809,802,7,0,801,8,1700,891,303,498,1,7763,0
20,"Gorj",77812,181,77812,,"MUNICIPIUL TARGU JIU",30,"Liceul cu Program Sportiv , strada 23 August",1049,545,538,7,0,541,4,1100,555,220,321,1,7763,0
20,"Gorj",77812,181,77812,,"MUNICIPIUL TARGU JIU",31,"Liceul cu Program Sportiv , strada 23 August",975,540,526,14,0,535,5,1000,460,248,287,1,7763,0
20,"Gorj",77812,181,77812,,"MUNICIPIUL TARGU JIU",32,"Colegiul Comercial"" Virgil Madgearu"", str. Tudor Vladimirescu",1988,1123,1113,10,0,1108,15,2000,877,420,688,1,7763,0
20,"Gorj",77812,181,77812,,"MUNICIPIUL TARGU JIU",33,"Liceul de Muzica si Arte Plastice ""Constantin Brailoiu""(fosta Scoala generala nr.3), strada Grivitei",1232,683,676,7,0,677,6,1300,617,288,389,1,7763,0
20,"Gorj",77812,181,77812,,"MUNICIPIUL TARGU JIU",34,"Liceul de Muzica si Arte Plastice ""Constantin Brailoiu""(fosta Scoala generala nr.3), strada Grivitei",1112,642,629,13,0,637,5,1200,558,270,367,1,7763,0
20,"Gorj",77812,181,77812,,"MUNICIPIUL TARGU JIU",35,"Casa de Cultura a Sindicatelor, strada Traian",1249,699,691,8,0,693,6,1300,601,266,427,1,7763,0
20,"Gorj",77812,181,77812,,"MUNICIPIUL TARGU JIU",36,"Scoala generala ""Sfantu Nicolae"", strada 11 Iunie 1848",1711,1160,989,11,160,1150,10,1800,640,516,634,1,7763,0
20,"Gorj",77812,181,77812,,"MUNICIPIUL TARGU JIU",37,"Scoala generala ""Sfantu Nicolae"", strada 11 Iunie 1848",1083,564,554,10,0,556,8,1200,636,267,289,1,7763,0
20,"Gorj",77812,181,77812,,"MUNICIPIUL TARGU JIU",38,"Scoala generala ""Sfantu Nicolae"", strada 11 Iunie 1848",1128,644,639,5,0,641,3,1200,556,265,376,1,7763,0
20,"Gorj",77812,181,77812,,"MUNICIPIUL TARGU JIU",39,"Liceul de Muzica si Arte Plastice ""Constantin Brailoiu""(fosta Scoala generala nr.3), strada Grivitei",1817,1060,1045,15,0,1052,8,2000,940,431,621,1,7763,0
20,"Gorj",77812,181,77812,,"MUNICIPIUL TARGU JIU",40,"Liceul de Muzica si Arte Plastice ""Constantin Brailoiu""(fosta Scoala generala nr.3), strada Grivitei",1415,733,724,9,0,716,17,1600,867,182,534,1,7763,0
20,"Gorj",77812,181,77812,,"MUNICIPIUL TARGU JIU",41,"Scoala generala ""Ecaterina Teodoroiu""(fosta nr.2), b-dul Ecaterina Teodoroiu",1666,869,858,11,0,861,8,1800,931,362,499,1,7763,0
20,"Gorj",77812,181,77812,,"MUNICIPIUL TARGU JIU",42,"Grupul Scolar Tehnologic ""Ion Mincu""(fost Industrial nr. 4), strada Lt. Col. Dumitru Petrescu",1385,699,690,9,0,693,6,1600,901,315,378,1,7763,0
20,"Gorj",77812,181,77812,,"MUNICIPIUL TARGU JIU",43,"Colegiul National Tehnic""Gheorghe Magheru"", strada Lt. Col. Dumitru Petrescu",2000,926,914,12,0,922,4,2000,1074,451,471,1,7763,0
20,"Gorj",77812,181,77812,,"MUNICIPIUL TARGU JIU",44,"Colegiul National Tehnic ""Gheorghe Magheru"", strada Lt. Col. Dumitru Petrescu",1927,879,867,12,0,879,0,2000,1121,425,454,1,7763,0
20,"Gorj",77812,181,77812,,"MUNICIPIUL TARGU JIU",45,"Scoala generala nr.7, b-dul Ecaterina Teodoroiu",1668,814,808,6,0,810,4,1700,886,308,502,1,7763,0
20,"Gorj",77812,181,77812,,"MUNICIPIUL TARGU JIU",46,"Scoala generala nr.7, b-dul Ecaterina Teodoroiu",1884,982,967,15,0,974,8,2000,1018,404,570,1,7763,0
20,"Gorj",77812,181,77812,,"MUNICIPIUL TARGU JIU",47,"Scoala generala ""Voievod Litovoi""(fosta nr.5), strada Calea Severinului",1628,912,898,14,0,898,14,1700,788,401,497,1,7763,0
20,"Gorj",77812,181,77812,,"MUNICIPIUL TARGU JIU",48,"Scoala generala ""Voievod Litovoi""(fosta nr.5), strada Calea Severinului",1489,926,903,22,1,916,10,1600,674,357,559,1,7763,0
20,"Gorj",77812,181,77812,,"MUNICIPIUL TARGU JIU",49,"Scoala generala nr.9, din localitatea Barsesti",1360,765,752,13,0,757,8,1600,835,355,402,1,7763,0
20,"Gorj",77812,181,77812,,"MUNICIPIUL TARGU JIU",50,"Colegiul National ""Tudor Vladimirescu"" , strada Unirii",1323,745,731,14,0,739,6,1600,855,334,405,1,7763,0
20,"Gorj",77812,181,77812,,"MUNICIPIUL TARGU JIU",51,"Liceul Teologic(fosta Scoala generala nr.13), strada A.I. Cuza",1643,845,838,7,0,839,6,1700,855,323,516,1,7763,0
20,"Gorj",77812,181,77812,,"MUNICIPIUL TARGU JIU",52,"Gradinita de Copii nr.53 din localitatea Iezureni",580,351,338,13,0,347,4,600,249,136,211,1,7763,0
20,"Gorj",77812,181,77812,,"MUNICIPIUL TARGU JIU",53,"Scoala primara si Gradinita de Copii din localitatea Ursati",508,314,306,8,0,312,2,600,286,116,196,1,7763,0
20,"Gorj",77812,181,77812,,"MUNICIPIUL TARGU JIU",54,"Scoala generala ""Voievod Litovoi"", strada Calea Severinului",1709,968,952,16,0,950,18,1800,832,343,607,1,7763,0
20,"Gorj",77812,181,77812,,"MUNICIPIUL TARGU JIU",55,"Grup scolar tehnologic ""Ion Mincu"", str Lt Col Dumitru Petrescu",940,427,419,8,0,426,1,1000,573,188,238,1,7763,0
20,"Gorj",77812,181,77812,,"MUNICIPIUL TARGU JIU",56,"Statia CFR din Targu Jiu, Bulevardul Republicii nr. 27A",0,1131,0,1131,0,1123,8,1300,169,576,547,1,7763,1
20,"Gorj",77812,181,77812,,"MUNICIPIUL TARGU JIU",57,"Complexul Studentesc Debarcader din Targu Jiu, Str. Tineretului nr. 4",0,293,0,293,0,291,2,1000,707,159,132,1,7763,1
20,"Gorj",77812,181,77812,,"MUNICIPIUL TARGU JIU",58,"Spitalul Judetean din Targu Jiu, Str. Progresului, nr. 18",0,296,0,296,0,294,2,1000,404,151,143,1,7763,1
20,"Gorj",78141,181,78141,,"MUNICIPIUL MOTRU",59,"Scoala generala nr. 2, Motru, str Tineretului",1995,1139,1119,19,1,1127,12,2000,861,505,622,1,7773,0
20,"Gorj",78141,181,78141,,"MUNICIPIUL MOTRU",60,"Casa Sindicatelor Motru, str Macului Micro II",1920,1049,1036,13,0,1036,13,2000,951,442,594,1,7773,0
20,"Gorj",78141,181,78141,,"MUNICIPIUL MOTRU",61,"Colegiul National ""George Cosbuc"" Motru, str Margaretei",1891,982,971,9,2,975,7,1900,918,415,560,1,7773,0
20,"Gorj",78141,181,78141,,"MUNICIPIUL MOTRU",62,"Scoala generala nr. 1 Motru, str Minerului",1852,1017,999,15,3,1007,10,1900,883,415,592,1,7773,0
20,"Gorj",78141,181,78141,,"MUNICIPIUL MOTRU",63,"Gradinita ""Vile"" Motru, str Macului Micro I",1227,694,681,10,3,689,5,1292,598,321,368,1,7773,0
20,"Gorj",78141,181,78141,,"MUNICIPIUL MOTRU",64,"Policlinica Motru, str Minerului",1862,1038,1023,15,0,1029,9,1900,862,428,601,1,7773,0
20,"Gorj",78141,181,78141,,"MUNICIPIUL MOTRU",65,"Gradinita - Cresa nr. 1 Motru, str Minerului",1889,1025,1013,12,0,1017,8,1900,875,446,571,1,7773,0
20,"Gorj",78141,181,78141,,"MUNICIPIUL MOTRU",66,"Scoala Leurda, sat Leurda",647,467,460,7,0,459,8,700,233,189,270,1,7773,0
20,"Gorj",78141,181,78141,,"MUNICIPIUL MOTRU",67,"Scoala Horasti, sat Horasti",424,285,280,5,0,281,4,500,215,140,141,1,7773,0
20,"Gorj",78141,181,78141,,"MUNICIPIUL MOTRU",68,"Scoala primara Plostina, sat Plostina",1140,810,789,21,0,803,7,1200,390,442,361,1,7773,0
20,"Gorj",78141,181,78141,,"MUNICIPIUL MOTRU",69,"Scoala primara Rosiuta, sat Rosiuta",600,400,392,8,0,397,3,700,300,171,226,1,7773,0
20,"Gorj",78141,181,78141,,"MUNICIPIUL MOTRU",70,"Scoala Rapa, sat Rapa",314,239,229,9,1,237,2,400,161,92,145,1,7773,0
20,"Gorj",78141,181,78141,,"MUNICIPIUL MOTRU",71,"Casa Sindicatelor nr. 2 Motru, str Macului Micro II",1932,999,987,12,0,991,8,2000,1001,411,580,1,7773,0
20,"Gorj",78141,181,78141,,"MUNICIPIUL MOTRU",72,"Casa Multiculturala Motru, str Minerului",1846,995,989,6,0,989,6,1900,905,385,604,1,7773,0
20,"Gorj",78141,181,78141,,"MUNICIPIUL MOTRU",73,"Halta CFR Motru, Str. Motrului,nr. 1",0,476,0,476,0,474,2,800,324,204,270,1,7773,1
20,"Gorj",79308,181,79308,,"ORAS BUMBESTI-JIU",74,"Sala de Sport a Orasului Bumbesti - Jiu, Aleea Stadionului",1211,669,661,8,0,663,6,1300,631,270,393,1,7783,0
20,"Gorj",79308,181,79308,,"ORAS BUMBESTI-JIU",75,"Gradinita cu program prelungit, str. Garii",1271,672,660,12,0,668,4,1300,628,322,346,1,7783,0
20,"Gorj",79308,181,79308,,"ORAS BUMBESTI-JIU",76,"Scoala generala nr. 1(corpul vechi), Bumbesti - Jiu,str. Trandafirilor",1630,805,791,14,0,793,12,1700,895,354,439,1,7783,0
20,"Gorj",79308,181,79308,,"ORAS BUMBESTI-JIU",77,"Scoala generala nr. 1(corp nou), Bumbesti - Jiu,str. Gr. Alex. Ghica",1087,540,528,12,0,536,4,1200,660,232,304,1,7783,0
20,"Gorj",79308,181,79308,,"ORAS BUMBESTI-JIU",78,"Colegiul  ""Mihai Viteazul"" Bumbesti - Jiu, str Gh. Dumitrescu-Bumbesti",984,527,511,16,0,524,3,1000,473,284,240,1,7783,0
20,"Gorj",79308,181,79308,,"ORAS BUMBESTI-JIU",79,"Scoala primara Bumbesti - Jiu, str Bumbesti",958,528,512,16,0,528,0,1000,472,257,271,1,7783,0
20,"Gorj",79308,181,79308,,"ORAS BUMBESTI-JIU",80,"Scoala primara Tetila, sat Tetila",972,513,502,10,1,510,3,1000,487,277,233,1,7783,0
20,"Gorj",79308,181,79308,,"ORAS BUMBESTI-JIU",81,"Scoala generala Curtisoara, sat Curtisoara",694,367,359,8,0,364,3,800,433,169,195,1,7783,0
20,"Gorj",79308,181,79308,,"ORAS BUMBESTI-JIU",82,"Spitalul Orasenesc Bumbesti Jiu, Str. Sanatatii nr. 1",0,245,0,245,0,244,1,400,155,120,124,1,7783,1
20,"Gorj",78258,181,78258,,"ORAS NOVACI",83,"Scoala generala nr. 1 Novaci, str. Eroilor",1692,1041,1038,3,0,1029,12,1800,759,637,392,1,7789,0
20,"Gorj",78258,181,78258,,"ORAS NOVACI",84,"Clubul Elevilor Novaci, str. Rinca",1158,689,681,8,0,682,7,1200,511,434,248,1,7789,0
20,"Gorj",78258,181,78258,,"ORAS NOVACI",85,"Scoala  Pociovalistea, sat Pociovalistea",1451,872,867,5,0,861,11,1600,728,462,399,1,7789,0
20,"Gorj",78258,181,78258,,"ORAS NOVACI",86,"Gradinita Bercesti, sat Bercesti",590,387,379,7,1,382,5,700,313,210,172,1,7789,0
20,"Gorj",78258,181,78258,,"ORAS NOVACI",87,"Casa de Cultura Novaci, Str. Parangului",0,304,0,304,0,300,4,400,96,139,161,1,7789,1
20,"Gorj",82895,181,82895,,"ORAS ROVINARI",88,"Scoala generala nr. 1 Rovinari, str Tineretului",1279,627,620,7,0,622,5,1400,773,371,251,1,7795,0
20,"Gorj",82895,181,82895,,"ORAS ROVINARI",89,"Scoala generala nr. 1 Rovinari, str Tineretului",1298,667,651,16,0,664,3,1400,733,423,241,1,7795,0
20,"Gorj",82895,181,82895,,"ORAS ROVINARI",90,"Grupul Scolar Rovinari, str Jiului",1232,638,627,11,0,636,2,1300,662,371,265,1,7795,0
20,"Gorj",82895,181,82895,,"ORAS ROVINARI",91,"Grupul Scolar Rovinari, str Jiului",1184,571,559,12,0,569,2,1200,629,325,244,1,7795,0
20,"Gorj",82895,181,82895,,"ORAS ROVINARI",92,"Clubul Elevilor Rovinari, Aleea Pietii",1200,607,600,7,0,604,3,1300,693,396,208,1,7795,0
20,"Gorj",82895,181,82895,,"ORAS ROVINARI",93,"Clubul Elevilor Rovinari, Aleea Pietii",1242,636,623,13,0,625,11,1281,645,373,252,1,7795,0
20,"Gorj",82895,181,82895,,"ORAS ROVINARI",94,"Gradinita nr. 3 Rovinari, Aleea Ciresului",1338,680,672,8,0,672,8,1400,720,430,242,1,7795,0
20,"Gorj",82895,181,82895,,"ORAS ROVINARI",95,"Gradinita nr. 3 Rovinari, Aleea Ciresului",1272,687,671,16,0,683,4,1400,713,437,246,1,7795,0
20,"Gorj",82895,181,82895,,"ORAS ROVINARI",96,"Scoala generala Virt, cartier Virt",539,355,348,7,0,354,1,600,245,198,156,1,7795,0
20,"Gorj",82895,181,82895,,"ORAS ROVINARI",97,"Spitalul Sfantul Stefan, Str. Jiului, nr. 2",0,558,0,558,0,556,2,1000,442,357,199,1,7795,1
20,"Gorj",82430,181,82430,,"ORAS TISMANA",98,"Scoala generala Tismana Centru",1815,1016,992,24,0,1010,6,2000,984,486,524,1,7812,0
20,"Gorj",82430,181,82430,,"ORAS TISMANA",99,"Scoala generala Celei, sat Celei",1393,761,729,32,0,752,9,1600,839,389,363,1,7812,0
20,"Gorj",82430,181,82430,,"ORAS TISMANA",100,"Scoala generala Topesti, sat Topesti",929,530,519,11,0,525,5,1000,470,243,282,1,7812,0
20,"Gorj",82430,181,82430,,"ORAS TISMANA",101,"Scoala generala Pocruia, sat Pocruia",1204,735,705,30,0,729,6,1300,565,384,345,1,7812,0
20,"Gorj",82430,181,82430,,"ORAS TISMANA",102,"Scoala generala Sohodol, sat Sohodol",854,496,489,7,0,493,3,900,404,268,225,1,7812,0
20,"Gorj",82430,181,82430,,"ORAS TISMANA",103,"Scoala cu clasele I-IV Tismana Centru",0,230,0,230,0,227,3,600,370,95,132,1,7812,1
20,"Gorj",78329,181,78329,,"ORAS TARGU CARBUNESTI",104,"Scoala Gimnaziala ""George Uscatescu"", Tg-Carbunesti",1122,574,570,4,0,569,5,1200,626,213,356,1,7798,0
20,"Gorj",78329,181,78329,,"ORAS TARGU CARBUNESTI",105,"Scoala Gimnaziala ""George Uscatescu"", Tg-Carbunesti",1805,842,837,5,0,839,3,2000,1158,359,480,1,7798,0
20,"Gorj",78329,181,78329,,"ORAS TARGU CARBUNESTI",106,"Colegiul National ""Tudor Arghezi"", Tg-Carbunesti",1210,573,561,12,0,562,11,1300,727,244,318,1,7798,0
20,"Gorj",78329,181,78329,,"ORAS TARGU CARBUNESTI",107,"Scoala generala Cretesti, sat Cretesti",810,430,420,10,0,422,8,900,470,227,195,1,7798,0
20,"Gorj",78329,181,78329,,"ORAS TARGU CARBUNESTI",108,"Scoala generala Pojogeni, sat Pojogeni",649,354,328,26,0,350,4,800,446,154,196,1,7798,0
20,"Gorj",78329,181,78329,,"ORAS TARGU CARBUNESTI",109,"Scoala generala Stefanesti, sat Stefanesti",476,281,264,12,5,274,7,500,219,76,198,1,7798,0
20,"Gorj",78329,181,78329,,"ORAS TARGU CARBUNESTI",110,"Caminul Cultural Carbunesti Sat, sat Carbunesti Sat",618,341,334,7,0,336,5,700,359,141,195,1,7798,0
20,"Gorj",78329,181,78329,,"ORAS TARGU CARBUNESTI",111,"Scoala generala Cerat, sat Cerat",221,137,117,20,0,135,2,400,263,59,76,1,7798,0
20,"Gorj",78329,181,78329,,"ORAS TARGU CARBUNESTI",112,"Scoala primara Cojani, sat Cojani",288,189,180,9,0,185,4,400,211,90,95,1,7798,0
20,"Gorj",78329,181,78329,,"ORAS TARGU CARBUNESTI",113,"Scoala Generala ""George Uscatescu"" Tg-Carbunesti , Str. Trandafirilor, nr. 136",0,240,0,240,0,236,4,700,460,121,115,1,7798,1
20,"Gorj",82617,181,82617,,"ORAS TURCENI",114,"Casa de Cultura a orasului Turceni, Sala nr 1",830,495,479,11,5,486,9,900,405,195,291,1,7824,0
20,"Gorj",82617,181,82617,,"ORAS TURCENI",115,"Casa de Cultura a orasului Turceni, Sala nr 2",1943,1040,1030,9,1,1037,3,2000,960,485,552,1,7824,0
20,"Gorj",82617,181,82617,,"ORAS TURCENI",116,"Gradinita cu Program Normal nr. 2 Turceni (Colonie), bloc G6",536,346,306,39,1,343,3,600,254,138,205,1,7824,0
20,"Gorj",82617,181,82617,,"ORAS TURCENI",117,"Scoala generala Stolojani, oras Turceni",579,380,362,15,3,376,4,700,320,123,253,1,7824,0
20,"Gorj",82617,181,82617,,"ORAS TURCENI",118,"Scoala generala Murgesti, sat Murgesti",634,481,470,5,6,478,3,791,310,179,299,1,7824,0
20,"Gorj",82617,181,82617,,"ORAS TURCENI",119,"Scoala generala Garbovu, sat Garbovu",768,524,511,6,7,518,6,800,276,268,250,1,7824,0
20,"Gorj",82617,181,82617,,"ORAS TURCENI",120,"Scoala generala Stramba-Jiu, sat  Stramba-Jiu",1294,781,773,7,1,775,6,1400,619,407,368,1,7824,0
20,"Gorj",82617,181,82617,,"ORAS TURCENI",121,"Scoala Primara Murgesti, orasul Turceni, sat Murgesti",0,282,0,282,0,281,1,1300,1018,133,148,1,7824,1
20,"Gorj",78454,181,78454,,"ORAS TICLENI",122,"Scoala primara nr. 2 Tunsi, str Petrolistilor",1078,640,610,29,1,635,5,1200,560,326,309,1,7810,0
20,"Gorj",78454,181,78454,,"ORAS TICLENI",123,"Scoala generala nr.1, str Petrolistilor",1862,1078,1046,32,0,1071,7,2000,922,539,532,1,7810,0
20,"Gorj",78454,181,78454,,"ORAS TICLENI",124,"Scoala primara nr. 3 Rasina, Aleea Livezilor",1138,652,638,13,1,644,8,1200,548,308,336,1,7810,0
20,"Gorj",78454,181,78454,,"ORAS TICLENI",125,"Grupul Scolar Industrial de Petrol Ticleni-cabinetul de matematica, Str. Stadionului nr. 1",0,123,0,123,0,123,0,301,178,60,63,1,7810,1
20,"Gorj",78472,181,78472,,"ALBENI",126,"Scoala generala  nr.1 Albeni, sat Albeni",1079,567,543,24,0,563,4,1200,633,223,340,3,7831,0
20,"Gorj",78472,181,78472,,"ALBENI",127,"Scoala primara Albeni II, sat Albeni II",539,225,209,16,0,222,3,601,376,86,136,3,7831,0
20,"Gorj",78472,181,78472,,"ALBENI",128,"Scoala primara Bolbocesti, sat Bolbocesti",495,246,242,4,0,243,3,600,354,67,176,3,7831,0
20,"Gorj",78472,181,78472,,"ALBENI",129,"Scoala primara Prunesti, sat Prunesti",170,78,71,7,0,78,0,201,123,31,47,3,7831,0
20,"Gorj",78472,181,78472,,"ALBENI",130,"Caminul Cultural Albeni, Sat Albeni",0,93,0,93,0,93,0,303,210,36,57,3,7831,1
20,"Gorj",78542,181,78542,,"ALIMPESTI",131,"Scoala gimnaziala Alimpesti""Ion Lotreanu"",sat Alimpesti",943,551,545,5,1,545,6,1005,454,204,341,3,7838,0
20,"Gorj",78542,181,78542,,"ALIMPESTI",132,"Scoala generala Sirbesti, sat Sirbesti",709,438,432,6,0,429,9,796,358,213,216,3,7838,0
20,"Gorj",78542,181,78542,,"ALIMPESTI",133,"Gradinita Alimpesti, Sat Alimpesti",0,140,0,140,0,140,0,400,260,71,69,3,7838,1
20,"Gorj",78604,181,78604,,"ANINOASA",134,"Scoala generala Aninoasa, sat Aninoasa",1156,605,595,9,1,601,4,1200,595,306,295,3,7844,0
20,"Gorj",78604,181,78604,,"ANINOASA",135,"Scoala primara Costesti I, sat Costesti",788,452,445,7,0,447,5,800,348,183,264,3,7844,0
20,"Gorj",78604,181,78604,,"ANINOASA",136,"Scoala generala Groserea, sat Groserea",533,346,338,8,0,338,8,600,254,136,202,3,7844,0
20,"Gorj",78604,181,78604,,"ANINOASA",137,"Scoala primara nr. 2 Sterpoaia, sat Sterpoaia",711,437,424,13,0,432,5,800,363,198,234,3,7844,0
20,"Gorj",78604,181,78604,,"ANINOASA",138,"Scoala Gimnaziala Sterpoaia, Sat Sterpoaia",0,201,0,201,0,200,1,800,599,82,118,3,7844,1
20,"Gorj",78668,181,78668,,"ARCANI",139,"Scoala generala Arcani, sat Arcani",1106,703,673,3,27,698,5,1200,497,367,331,3,7850,0
20,"Gorj",78668,181,78668,,"ARCANI",140,"Scoala Generala Arcani, Sat Arcani",0,255,0,255,0,252,3,400,145,146,106,3,7850,1
20,"Gorj",78711,181,78711,,"BAIA DE FIER",141,"Scoala generala Baia de Fier, sat Baia de Fier",1457,871,866,5,0,858,13,1400,529,433,425,3,7855,0
20,"Gorj",78711,181,78711,,"BAIA DE FIER",142,"Scoala generala Baia de Fier, sat Baia de Fier",1412,891,887,4,0,882,9,1600,709,351,531,3,7855,0
20,"Gorj",78711,181,78711,,"BAIA DE FIER",143,"Scoala generala Cernadia, sat Cernadia",685,438,426,12,0,433,5,800,362,238,195,3,7855,0
20,"Gorj",78711,181,78711,,"BAIA DE FIER",144,"Scoala Generala nr. 1 Baia de Fier, Sat Baia de Fier",0,147,0,147,0,147,0,400,253,65,82,3,7855,1
20,"Gorj",78748,181,78748,,"BALANESTI",145,"Scoala primara Balanesti, sat Balanesti",615,386,379,7,0,382,4,800,414,197,185,3,7858,0
20,"Gorj",78748,181,78748,,"BALANESTI",146,"Caminul Cultural Voitestii din Vale, sat Voitestii din Vale",544,335,328,7,0,330,5,600,265,162,168,3,7858,0
20,"Gorj",78748,181,78748,,"BALANESTI",147,"Scoala Glodeni, sat Glodeni",719,413,413,0,0,410,3,800,387,138,272,3,7858,0
20,"Gorj",78748,181,78748,,"BALANESTI",148,"Caminul Cultural Voitestii din Vale, sat Voitestii din Vale",0,183,0,183,0,182,1,400,217,94,88,3,7858,1
20,"Gorj",77910,181,77910,,"BALESTI",149,"Caminul Cultural Balesti, sat Balesti",1698,971,942,29,0,962,9,1800,829,395,567,3,7866,0
20,"Gorj",77910,181,77910,,"BALESTI",150,"Scoala Generala Ceauru, sat Ceauru",1894,1078,1060,18,0,1065,13,2000,922,433,632,3,7866,0
20,"Gorj",77910,181,77910,,"BALESTI",151,"Scoala primara Cornesti, sat Cornesti",563,330,313,17,0,322,8,700,370,132,190,3,7866,0
20,"Gorj",77910,181,77910,,"BALESTI",152,"Scoala primara Rasova, sat Rasova",384,262,251,11,0,261,1,400,138,149,112,3,7866,0
20,"Gorj",77910,181,77910,,"BALESTI",153,"Scoala primara Stolojani, sat Stolojani",539,262,249,13,0,257,5,601,339,131,126,3,7866,0
20,"Gorj",77910,181,77910,,"BALESTI",154,"Scoala primara Talpasesti, sat Talpasesti",423,273,261,12,0,270,3,500,227,140,130,3,7866,0
20,"Gorj",77910,181,77910,,"BALESTI",155,"Scoala primara Tamasesti, sat Tamasesti",510,329,297,32,0,327,2,600,271,146,181,3,7866,0
20,"Gorj",77910,181,77910,,"BALESTI",156,"Scoala cu clasele I-IV Balesti, Sat Balesti, Linia Seci",0,211,0,211,0,211,0,600,389,94,117,3,7866,1
20,"Gorj",78828,181,78828,,"BARBATESTI",157,"Clubul Tineretului Barbatesti, sat Barbatesti",1442,796,784,12,0,785,11,1600,804,447,338,3,7882,0
20,"Gorj",78828,181,78828,,"BARBATESTI",158,"Scoala Generala cu clasele I-VIII Barbatesti, Sat Barbatesti",0,116,0,116,0,116,0,300,184,67,49,3,7882,1
20,"Gorj",78873,181,78873,,"BENGESTI-CIOCADIA",159,"Caminul Cultural Bengesti, sat  Bengesti",925,448,440,8,0,442,6,1000,552,206,236,3,7887,0
20,"Gorj",78873,181,78873,,"BENGESTI-CIOCADIA",160,"Caminul Cultural Linia-Mare, catunul Linia Mare",303,193,182,11,0,192,1,400,207,71,121,3,7887,0
20,"Gorj",78873,181,78873,,"BENGESTI-CIOCADIA",161,"Caminul Cultural Ciocadia, sat  Ciocadia",805,364,359,5,0,361,3,900,536,169,192,3,7887,0
20,"Gorj",78873,181,78873,,"BENGESTI-CIOCADIA",162,"Caminul Cultural Balcesti, sat  Balcesti",711,421,417,4,0,417,4,775,354,175,242,3,7887,0
20,"Gorj",78873,181,78873,,"BENGESTI-CIOCADIA",163,"bloc specialisti, sat Bengesti",0,137,0,137,0,137,0,300,163,84,53,3,7887,1
20,"Gorj",78926,181,78926,,"BERLESTI",164,"Caminul Cultural Piriu-Viu, sat  Piriu-Viu",1034,644,639,5,0,633,11,1201,557,270,363,3,7892,0
20,"Gorj",78926,181,78926,,"BERLESTI",165,"Scoala Primara Berlesti, Sat Berlesti",671,383,376,7,0,376,7,801,418,186,190,3,7892,0
20,"Gorj",78926,181,78926,,"BERLESTI",166,"Primaria Berlesti - sala de sedinte, Sat Piriul Viu",0,168,0,168,0,167,1,201,33,52,115,3,7892,1
20,"Gorj",79004,181,79004,,"BALTENI",167,"Primaria Balteni, sat Balteni",1693,945,938,7,0,935,10,1800,855,481,454,3,7876,0
20,"Gorj",79004,181,79004,,"BALTENI",168,"Scoala generala nr.1 Pesteana-Jiu, sat Pesteana-Jiu",1699,926,918,8,0,915,11,1800,874,395,520,3,7876,0
20,"Gorj",79004,181,79004,,"BALTENI",169,"Scoala generala Moi, sat Moi",1680,993,981,12,0,981,12,1800,807,519,462,3,7876,0
20,"Gorj",79004,181,79004,,"BALTENI",170,"Scoala generala Cocoreni, sat Cocoreni",1034,584,579,5,0,577,7,1200,616,265,312,3,7876,0
20,"Gorj",79004,181,79004,,"BALTENI",171,"Scoala Primara ""Dinca Schileru"" Bilteni, Sat Bilteni",0,139,0,139,0,138,1,300,161,69,69,3,7876,1
20,"Gorj",79077,181,79077,,"BOLBOSI",172,"Scoala generala Bolbosi, sat Bolboasa, corp A",1458,911,901,10,0,901,10,1600,689,339,562,3,7900,0
20,"Gorj",79077,181,79077,,"BOLBOSI",173,"Scoala generala Valea I, sat Valea",803,501,494,7,0,491,10,1000,499,204,287,3,7900,0
20,"Gorj",79077,181,79077,,"BOLBOSI",174,"Scoala primara Valea II, sat Valea, catunul Ursoita",271,129,117,12,0,129,0,400,271,66,63,3,7900,0
20,"Gorj",79077,181,79077,,"BOLBOSI",175,"Scoala cu clasele I-IV Bolbosi, Sat Bolbosi",0,85,0,85,0,84,1,200,115,42,42,3,7900,1
20,"Gorj",79157,181,79157,,"BORASCU",176,"Scoala primara Borascu, sat  Borascu",964,562,547,14,1,557,5,1000,438,271,286,3,7908,0
20,"Gorj",79157,181,79157,,"BORASCU",177,"Scoala primara Mentii din Dos, sat  Mentii din Dos",563,370,357,13,0,365,5,600,230,130,235,3,7908,0
20,"Gorj",79157,181,79157,,"BORASCU",178,"Scoala generala Miluta, sat Miluta",517,244,237,7,0,240,4,600,356,99,141,3,7908,0
20,"Gorj",79157,181,79157,,"BORASCU",179,"Scoala primara Calaparu, sat Calaparu",689,403,403,0,0,397,6,800,397,194,203,3,7908,0
20,"Gorj",79157,181,79157,,"BORASCU",180,"Scola Primara cu clasele I-IV Borascu, Sat Borascu",0,147,0,147,0,146,1,300,153,70,76,3,7908,1
20,"Gorj",79237,181,79237,,"BRANESTI",181,"Scoala gimnaziala Capu-Dealului, sat Capu-Dealului",680,469,462,7,0,461,8,800,331,131,330,3,7916,0
20,"Gorj",79237,181,79237,,"BRANESTI",182,"Scoala primara Branesti, sat  Branesti",507,327,318,9,0,324,3,600,273,126,198,3,7916,0
20,"Gorj",79237,181,79237,,"BRANESTI",183,"Scoala gimnaziala Gilortu",477,269,259,10,0,264,5,600,331,98,166,3,7916,0
20,"Gorj",79237,181,79237,,"BRANESTI",184,"Scoala primara Badesti, sat,  Badesti",198,118,100,18,0,118,0,400,282,46,72,3,7916,0
20,"Gorj",79237,181,79237,,"BRANESTI",185,"Scoala Generala Capu-Dealului, Sat Capu-Dealului",0,150,0,150,0,150,0,300,150,46,104,3,7916,1
20,"Gorj",79362,181,79362,,"BUMBESTI-PITIC",186,"Caminul Cultural Bumbesti-Pitic, sat  Bumbesti-Pitic",1062,556,551,5,0,552,4,1200,644,296,256,3,7923,0
20,"Gorj",79362,181,79362,,"BUMBESTI-PITIC",187,"Gradinita Carligei, sat Carligei",211,117,107,10,0,116,1,400,283,61,55,3,7923,0
20,"Gorj",79362,181,79362,,"BUMBESTI-PITIC",188,"Scoala generala Poienari, sat Poienari",611,345,339,6,0,342,3,800,455,146,196,3,7923,0
20,"Gorj",79362,181,79362,,"BUMBESTI-PITIC",189,"Caminul Cultural Bumbesti-Pitic - sala nr. 2, Sat Bumbesti-Pitic",0,123,0,123,0,123,0,200,77,57,66,3,7923,1
20,"Gorj",79406,181,79406,,"BUSTUCHIN",190,"Grupul Scolar Industrial Bustuchin, sat Bustuchin",869,566,546,15,5,563,3,1000,434,115,448,3,7927,0
20,"Gorj",79406,181,79406,,"BUSTUCHIN",191,"Scoala generala Poiana-Seciuri, sat Poiana-Seciuri",763,508,499,9,0,507,1,900,392,121,386,3,7927,0
20,"Gorj",79406,181,79406,,"BUSTUCHIN",192,"Scoala primara Valea Pojarului, sat Valea Pojarului",347,263,249,9,5,260,3,500,237,76,184,3,7927,0
20,"Gorj",79406,181,79406,,"BUSTUCHIN",193,"Scoala primara Poienita, sat  Poienita",340,252,225,17,10,249,3,500,248,27,222,3,7927,0
20,"Gorj",79406,181,79406,,"BUSTUCHIN",194,"Scoala primara Pojaru, sat Pojaru",388,246,229,12,5,246,0,501,255,64,182,3,7927,0
20,"Gorj",79406,181,79406,,"BUSTUCHIN",195,"Grupul Scolar Industrial Bustuchin, Sat Bustuchin, nr. 186",0,156,0,156,0,155,1,500,344,39,116,3,7927,1
20,"Gorj",79497,181,79497,,"CAPRENI",196,"Scoala Generala Capreni Centru, corp A, sat Capreni",824,455,444,11,0,449,6,1000,545,232,217,3,7946,0
20,"Gorj",79497,181,79497,,"CAPRENI",197,"Scoala Primara Caprenii de Sus, sat Satu Nou",572,301,297,4,0,297,4,700,399,142,155,3,7946,0
20,"Gorj",79497,181,79497,,"CAPRENI",198,"Scoala primara Bulbuceni, sat  Bulbuceni",423,267,259,8,0,259,8,500,233,113,146,3,7946,0
20,"Gorj",79497,181,79497,,"CAPRENI",199,"Scoala Generala Capreni, Sat Capreni, nr. 1",0,141,0,141,0,141,0,300,159,69,72,3,7946,1
20,"Gorj",79585,181,79585,,"CATUNELE",200,"Gradinita Valea Perilor, sat Valea Perilor",586,377,371,6,0,371,6,700,323,160,211,3,7955,0
20,"Gorj",79585,181,79585,,"CATUNELE",201,"Scoala generala Valea-Manastirii, sat Valea-Manastirii",357,244,237,7,0,239,5,500,256,117,122,3,7955,0
20,"Gorj",79585,181,79585,,"CATUNELE",202,"Caminul Cultural Lupoaia, sat  Lupoaia",766,494,488,6,0,490,4,800,306,217,273,3,7955,0
20,"Gorj",79585,181,79585,,"CATUNELE",203,"Scoala primara Dealu-Viilor, sat  Dealu-Viilor",479,332,325,7,0,330,2,501,169,178,152,3,7955,0
20,"Gorj",79585,181,79585,,"CATUNELE",204,"Primaria Catunele, Sat Valea Perilor",0,82,0,82,0,82,0,200,118,50,32,3,7955,1
20,"Gorj",79656,181,79656,,"CIUPERCENI",205,"Centrul Cultural (Fosta Primarie) Ciuperceni, sat Ciuperceni",439,288,286,2,0,280,8,500,212,123,157,3,7962,0
20,"Gorj",79656,181,79656,,"CIUPERCENI",206,"Scoala Stramba Vulcan, sat Stramba Vulcan",312,204,194,10,0,199,5,400,196,86,113,3,7962,0
20,"Gorj",79656,181,79656,,"CIUPERCENI",207,"Scoala primara  Pesteana Vulcan, sat  Pesteana Vulcan",250,178,169,9,0,174,4,400,222,71,103,3,7962,0
20,"Gorj",79656,181,79656,,"CIUPERCENI",208,"Scoala  primara Vartopu, sat Vartopu",312,210,203,7,0,209,1,400,190,119,90,3,7962,0
20,"Gorj",79656,181,79656,,"CIUPERCENI",209,"Caminul Cultural Ciuperceni (fosta Primarie), Sat Ciuperceni",0,249,0,249,0,249,0,400,151,100,149,3,7962,1
20,"Gorj",79736,181,79736,,"CALNIC",210,"Caminul Cultural Cilnic, sat  Cilnic",562,377,364,12,1,373,4,700,323,201,172,3,7936,0
20,"Gorj",79736,181,79736,,"CALNIC",211,"Scoala primara Cilnicul de Sus, sat  Cilnicul de Sus",594,333,332,1,0,328,5,700,367,149,179,3,7936,0
20,"Gorj",79736,181,79736,,"CALNIC",212,"Scoala primara Pinoasa, sat  Pinoasa",331,170,163,7,0,168,2,400,230,58,110,3,7936,0
20,"Gorj",79736,181,79736,,"CALNIC",213,"Scoala Primara Hodoreasca, sat Hodoreasca",296,171,164,7,0,170,1,400,229,80,90,3,7936,0
20,"Gorj",79736,181,79736,,"CALNIC",214,"Scoala Generala cu clasele I-VIII Calnic, Sat Calnic, nr. 47",0,152,0,152,0,150,2,700,548,77,73,3,7936,1
20,"Gorj",79834,181,79834,,"CRASNA",215,"Caminul Cultural Carpinis, Sat Carpinis",1632,1054,1037,17,0,1049,5,1700,646,488,561,3,7970,0
20,"Gorj",79834,181,79834,,"CRASNA",216,"Scoala primara Dragoiesti, sat  Dragoiesti",1058,624,616,8,0,618,6,1200,576,299,319,3,7970,0
20,"Gorj",79834,181,79834,,"CRASNA",217,"Caminul Cultural Dumbraveni, sat  Dumbraveni",787,505,497,8,0,499,6,800,295,206,293,3,7970,0
20,"Gorj",79834,181,79834,,"CRASNA",218,"Caminul Cultural Aninis, sat  Aninisul din Vale",760,471,464,7,0,461,10,800,329,247,214,3,7970,0
20,"Gorj",79834,181,79834,,"CRASNA",219,"Caminul Cultural Buzesti, Sat Buzesti",0,162,0,162,0,162,0,800,638,68,94,3,7970,1
20,"Gorj",79932,181,79932,,"CRUSET",220,"Scoala primara Cruset, sat  Cruset",1412,698,684,14,0,682,16,1600,902,265,417,3,7980,0
20,"Gorj",79932,181,79932,,"CRUSET",221,"Caminul Cultural Maiag, sat  Maiag",693,319,309,10,0,314,5,800,481,99,215,3,7980,0
20,"Gorj",79932,181,79932,,"CRUSET",222,"Caminul Cultural Slavuta, sat  Slavuta",596,291,287,4,0,286,5,700,409,104,182,3,7980,0
20,"Gorj",79932,181,79932,,"CRUSET",223,"Scoala Primara Cruset, Sat Cruset",0,194,0,194,0,190,4,500,306,79,111,3,7980,1
20,"Gorj",80043,181,80043,,"DANCIULESTI",224,"Scoala generala Danciulesti, sat  Danciulesti",708,416,409,6,1,410,6,800,384,212,198,3,7991,0
20,"Gorj",80043,181,80043,,"DANCIULESTI",225,"Caminul Cultural Radinesti, sat  Radinesti",593,314,305,9,0,309,5,700,386,192,117,3,7991,0
20,"Gorj",80043,181,80043,,"DANCIULESTI",226,"Scoala generala Obirsia, sat Obirsia",540,270,264,6,0,266,4,600,330,166,100,3,7991,0
20,"Gorj",80043,181,80043,,"DANCIULESTI",227,"Scoala Generala Danciulesti, Sat Danciulesti",0,163,0,163,0,163,0,200,37,75,88,3,7991,1
20,"Gorj",80123,181,80123,,"DANESTI",228,"Scoala primara Danesti, sat  Danesti",1041,612,600,11,1,605,7,1200,588,306,299,3,7999,0
20,"Gorj",80123,181,80123,,"DANESTI",229,"Scoala primara Vacarea, sat Vacarea",637,427,409,17,1,423,4,800,373,218,205,3,7999,0
20,"Gorj",80123,181,80123,,"DANESTI",230,"Scoala primara Sasa, sat  Sasa",549,308,285,23,0,308,0,600,292,167,141,3,7999,0
20,"Gorj",80123,181,80123,,"DANESTI",231,"Scoala primara Bratuia, sat  Bratuia",762,402,393,9,0,401,1,800,398,184,217,3,7999,0
20,"Gorj",80123,181,80123,,"DANESTI",232,"Primaria Danesti, sat Danesti",0,148,0,148,0,147,1,402,254,59,88,3,7999,1
20,"Gorj",80249,181,80249,,"DRAGOTESTI",233,"Caminul Cultural Dragotesti, sat  Dragotesti",1004,644,641,3,0,636,8,1101,457,261,375,3,8011,0
20,"Gorj",80249,181,80249,,"DRAGOTESTI",234,"Scoala Corobai, sat  Corobai",1109,731,729,2,0,725,6,1200,469,403,322,3,8011,0
20,"Gorj",80249,181,80249,,"DRAGOTESTI",235,"Scoala cu clasele I-VIII ""Ion Valceanu"" Dragotesti, sat Dragotesti",0,110,0,110,0,108,2,201,91,65,43,3,8011,1
20,"Gorj",78016,181,78016,,"DRAGUTESTI",236,"Caminul Cultural Iasi-Gorj, sat  Iasi-Gorj",823,538,530,8,0,534,4,900,362,246,288,3,8015,0
20,"Gorj",78016,181,78016,,"DRAGUTESTI",237,"Scoala Generala Dragutesti, sat Dragutesti",820,556,547,9,0,556,0,900,344,216,340,3,8015,0
20,"Gorj",78016,181,78016,,"DRAGUTESTI",238,"Scoala generala Urechesti, sat  Urechesti",733,514,506,7,1,509,5,800,286,219,290,3,8015,0
20,"Gorj",78016,181,78016,,"DRAGUTESTI",239,"Scoala primara Talvesti, sat  Talvesti",529,373,364,9,0,368,5,600,227,137,231,3,8015,0
20,"Gorj",78016,181,78016,,"DRAGUTESTI",240,"Scoala generala Cirbesti, sat  Cirbesti",1228,806,797,9,0,795,11,1300,494,286,509,3,8015,0
20,"Gorj",78016,181,78016,,"DRAGUTESTI",241,"Scoala Generala Dragutesti, Sat Dragutesti",0,172,0,172,0,172,0,500,328,77,95,3,8015,1
20,"Gorj",80285,181,80285,,"FARCASESTI",242,"Gradinita  Pesteana de Jos, sat Pesteana de Jos",677,488,477,11,0,483,5,800,312,210,273,3,8022,0
20,"Gorj",80285,181,80285,,"FARCASESTI",243,"Scoala Generala ""Victor Popescu"", sat Valea cu Apa",636,494,474,20,0,492,2,700,206,281,211,3,8022,0
20,"Gorj",80285,181,80285,,"FARCASESTI",244,"Scoala cu clasele I-IV Farcasesti, sat  Farcasesti",610,424,419,5,0,420,4,700,276,236,184,3,8022,0
20,"Gorj",80285,181,80285,,"FARCASESTI",245,"Liceul Rosia-Jiu, sat  Rosia-Jiu",711,437,433,4,0,432,5,800,363,213,219,3,8022,0
20,"Gorj",80285,181,80285,,"FARCASESTI",246,"Scoala gimnaziala Timiseni, sat  Timiseni",160,84,79,5,0,82,2,200,116,43,39,3,8022,0
20,"Gorj",80285,181,80285,,"FARCASESTI",247,"Primaria Farcasesti - sala de sedinte, Sat Farcasesti",0,107,0,107,0,106,1,600,493,64,42,3,8022,1
20,"Gorj",80365,181,80365,,"GLOGOVA",248,"Primaria Comunei Glogova, Sala de Sedinta a Consiliului Local",1510,1095,1087,3,5,1088,7,1600,505,470,618,3,8030,0
20,"Gorj",80365,181,80365,,"GLOGOVA",249,"Primaria Comunei Glogova",0,180,0,180,0,178,2,300,120,103,75,3,8030,1
20,"Gorj",80427,181,80427,,"GODINESTI",250,"Primaria Comunei Godinesti - Sala de Sedinta a Consiliului Local, sat Godinesti",950,495,489,4,2,492,3,1000,505,198,294,3,8036,0
20,"Gorj",80427,181,80427,,"GODINESTI",251,"Scoala Generala Calcesti, Corp Nou, sat  Calcesti",285,139,132,7,0,137,2,400,261,81,56,3,8036,0
20,"Gorj",80427,181,80427,,"GODINESTI",252,"Gradinita Paraul de Pripor , sat   Paraul de Pripor",331,220,210,10,0,216,4,400,180,82,134,3,8036,0
20,"Gorj",80427,181,80427,,"GODINESTI",253,"Scoala primara Paraul de Vale , sat   Paraul de Vale",193,123,112,11,0,122,1,300,177,25,97,3,8036,0
20,"Gorj",80427,181,80427,,"GODINESTI",254,"Scoala Generala Calcesti - sala gradinita, Sat Calcesti, nr. 206",0,184,0,184,0,182,2,300,116,78,104,3,8036,1
20,"Gorj",80506,181,80506,,"HUREZANI",255,"Caminul Cultural Hurezani, sat  Hurezani",1154,777,763,13,1,767,10,1200,423,396,371,3,8044,0
20,"Gorj",80506,181,80506,,"HUREZANI",256,"Scoala primara Plopu de Hurezani, sat    Plopu de Hurezani",190,117,109,8,0,115,2,302,185,44,71,3,8044,0
20,"Gorj",80506,181,80506,,"HUREZANI",257,"Biblioteca Publica Hurezani, Sat Hurezani",0,280,0,280,0,277,3,299,19,121,156,3,8044,1
20,"Gorj",80560,181,80560,,"IONESTI",258,"Scoala generala Ionesti, sat   Ionesti",1185,728,725,3,0,721,7,1300,572,238,483,3,8050,0
20,"Gorj",80560,181,80560,,"IONESTI",259,"Scoala primara Iliesti, sat   Iliesti",447,299,292,7,0,298,1,500,201,53,245,3,8050,0
20,"Gorj",80560,181,80560,,"IONESTI",260,"Scoala primara Picu, sat  Picu",311,196,186,10,0,192,4,398,202,82,110,3,8050,0
20,"Gorj",80560,181,80560,,"IONESTI",261,"Scoala Generala Ionesti, Sat Ionesti",0,87,0,87,0,87,0,199,112,33,54,3,8050,1
20,"Gorj",80613,181,80613,,"JUPANESTI",262,"Camin Cultural Jupanesti, sat Jupanesti",1122,550,542,8,0,546,4,1200,650,263,283,3,8055,0
20,"Gorj",80613,181,80613,,"JUPANESTI",263,"Scoala primara Viersani I, sat   Viersani",702,336,330,6,0,330,6,800,464,170,160,3,8055,0
20,"Gorj",80613,181,80613,,"JUPANESTI",264,"Scoala Generala cu clasele I-VIII Jupanesti, Sat Jupanesti",0,126,0,126,0,125,1,400,274,82,43,3,8055,1
20,"Gorj",80677,181,80677,,"LELESTI",265,"Sediul vechi al Primariei Comunei Lelesti, sat  Lelesti",1047,812,781,8,23,802,10,1200,388,260,542,3,8061,0
20,"Gorj",80677,181,80677,,"LELESTI",266,"Caminul Cultural, sat Fratesti",254,193,181,9,3,192,1,400,207,50,142,3,8061,0
20,"Gorj",80677,181,80677,,"LELESTI",267,"Scoala primara Rasovita, sat Rasovita",146,134,120,7,7,134,0,194,60,33,101,3,8061,0
20,"Gorj",80677,181,80677,,"LELESTI",268,"Sediul vechi al Primariei Lelesti, sat Lelesti",0,550,0,550,0,548,2,769,219,166,382,3,8061,1
20,"Gorj",80711,181,80711,,"LICURICI",269,"Scoala primara Licurici, sat    Licurici",621,312,305,7,0,303,9,800,488,130,173,3,8065,0
20,"Gorj",80711,181,80711,,"LICURICI",270,"Scoala coordonatoare Negreni, sat  Negreni",613,292,282,10,0,289,3,800,508,133,156,3,8065,0
20,"Gorj",80711,181,80711,,"LICURICI",271,"Scoala generala Totea, sat  Totea",641,302,292,10,0,297,5,800,498,177,120,3,8065,0
20,"Gorj",80711,181,80711,,"LICURICI",272,"Scoala Coordonatoare Negreni, Sat Negreni",0,131,0,131,0,128,3,300,169,59,69,3,8065,1
20,"Gorj",80766,181,80766,,"LOGRESTI",273,"Caminul Cultural Frunza, sat  Frunza",644,330,325,5,0,319,11,800,470,185,134,3,8070,0
20,"Gorj",80766,181,80766,,"LOGRESTI",274,"Caminul cultural Targu Logresti, sat Targu Logresti",623,365,345,20,0,360,5,800,435,130,230,3,8070,0
20,"Gorj",80766,181,80766,,"LOGRESTI",275,"Scoala primara Maru Cetate, sat  Maru",323,194,190,4,0,187,7,400,206,82,105,3,8070,0
20,"Gorj",80766,181,80766,,"LOGRESTI",276,"Scoala primara Seaca, sat  Seaca",265,159,152,7,0,158,1,400,241,59,99,3,8070,0
20,"Gorj",80766,181,80766,,"LOGRESTI",277,"Scoala primara Mosteni, sat  Logresti-Mosteni",414,282,265,17,0,280,2,500,218,143,137,3,8070,0
20,"Gorj",80766,181,80766,,"LOGRESTI",278,"Scoala Generala Ramificatie Maru, Sat Maru",0,197,0,197,0,197,0,600,403,85,112,3,8070,1
20,"Gorj",80846,181,80846,,"MATASARI",279,"Gradinita Matasari Sala A, sat Matasari",989,471,460,11,0,466,5,1000,529,223,243,3,8078,0
20,"Gorj",80846,181,80846,,"MATASARI",280,"Gradinita Matasari Sala B, sat Matasari",1449,680,676,4,0,676,4,1600,920,335,341,3,8078,0
20,"Gorj",80846,181,80846,,"MATASARI",281,"Scoala  nr. 2 Matasari, sat Matasari",632,409,399,10,0,406,3,700,291,184,222,3,8078,0
20,"Gorj",80846,181,80846,,"MATASARI",282,"Scoala Primara Bradet, sat  Bradet",550,397,393,4,0,390,7,600,203,218,172,3,8078,0
20,"Gorj",80846,181,80846,,"MATASARI",283,"Scoala primara Runcurel, sat  Runcurel",318,225,219,6,0,222,3,400,175,78,144,3,8078,0
20,"Gorj",80846,181,80846,,"MATASARI",284,"Scoala primara Croici, sat Croici",349,224,216,8,0,222,2,400,176,84,138,3,8078,0
20,"Gorj",80846,181,80846,,"MATASARI",285,"Colegiul Tehnic Matasari - sala de sport, Sat Matasari",0,251,0,251,0,250,1,502,251,146,104,3,8078,1
20,"Gorj",80908,181,80908,,"MUSETESTI",286,"Scoala Generala Musetesti, sat Musetesti",846,474,470,4,0,469,5,1000,526,179,290,3,8084,0
20,"Gorj",80908,181,80908,,"MUSETESTI",287,"Scoala primara Stancesti, sat Stancesti",496,301,294,7,0,299,2,500,199,165,134,3,8084,0
20,"Gorj",80908,181,80908,,"MUSETESTI",288,"Scoala primara Grui, sat  Grui",461,302,291,11,0,299,3,500,198,116,183,3,8084,0
20,"Gorj",80908,181,80908,,"MUSETESTI",289,"Scoala Generala Musetesti - Gradinita, Sat Musetesti",0,82,0,82,0,82,0,300,218,30,52,3,8084,1
20,"Gorj",80980,181,80980,,"NEGOMIR",290,"Scoala generala Negomir, sat Negomir",1144,808,804,4,0,794,14,1200,392,458,336,3,8092,0
20,"Gorj",80980,181,80980,,"NEGOMIR",291,"Scoala cu clasele I-IV Artanu, sat  Artanu",936,658,651,7,0,648,10,1000,342,371,277,3,8092,0
20,"Gorj",80980,181,80980,,"NEGOMIR",292,"Scoala Generala cu clasele I-VIIIRaci, sat Condeiesti",815,580,576,3,1,569,11,1000,420,291,278,3,8092,0
20,"Gorj",80980,181,80980,,"NEGOMIR",293,"scoala Primara Ursoaia, Sat Ursoaia",0,151,0,151,0,151,0,400,249,83,68,3,8092,1
20,"Gorj",81095,181,81095,,"PADES",294,"Scoala generala Pades, sat   Pades",1266,792,780,11,1,784,8,1300,508,368,416,3,8103,0
20,"Gorj",81095,181,81095,,"PADES",295,"Caminul Cultural Calugareni, sat  Calugareni",926,624,616,8,0,619,5,1000,376,302,317,3,8103,0
20,"Gorj",81095,181,81095,,"PADES",296,"Scoala generala Motru-Sec, sat   Motru-Sec",1656,1013,1001,12,0,1002,11,1700,687,521,481,3,8103,0
20,"Gorj",81095,181,81095,,"PADES",297,"Scoala primara Cerna-Sat, sat Cerna-Sat",82,41,27,14,0,41,0,200,159,30,11,3,8103,0
20,"Gorj",81095,181,81095,,"PADES",298,"Gradinita Calugareni, Sat Calugareni",0,190,0,190,0,189,1,500,310,90,99,3,8103,1
20,"Gorj",81184,181,81184,,"PESTISANI",299,"Grup Scolar Industrial ""Constantin Brancusi"" Pestisani, sat Pestisani",1289,766,759,7,0,762,4,1365,599,388,374,3,8112,0
20,"Gorj",81184,181,81184,,"PESTISANI",300,"Scoala generala Pestisani, sat  Pestisani",1385,800,794,6,0,795,5,1600,800,338,457,3,8112,0
20,"Gorj",81184,181,81184,,"PESTISANI",301,"Scoala primara Bradiceni, sat Bradiceni",540,365,355,10,0,359,6,600,235,117,242,3,8112,0
20,"Gorj",81184,181,81184,,"PESTISANI",302,"Grupul Scolar ""Constantin Brancusi"" Pestisani, Sat Pestisani",0,324,0,324,0,324,0,600,276,126,198,3,8112,1
20,"Gorj",81264,181,81264,,"PLOPSORU",303,"Scoala generala Plopsoru, sat Plopsoru",2005,1155,1145,10,0,1147,8,2200,1045,448,699,3,8120,0
20,"Gorj",81264,181,81264,,"PLOPSORU",304,"Scoala generala Piscuri, sat Piscuri",912,578,565,13,0,571,7,1002,424,230,341,3,8120,0
20,"Gorj",81264,181,81264,,"PLOPSORU",305,"Scoala primara Valeni, sat Valeni",1359,828,821,7,0,813,15,1600,772,413,400,3,8120,0
20,"Gorj",81264,181,81264,,"PLOPSORU",306,"Scoala primara Brosteni, sat  Brosteni",782,530,523,7,0,527,3,800,270,273,254,3,8120,0
20,"Gorj",81264,181,81264,,"PLOPSORU",307,"Scoala Generala Plopsoru - sala nr. 1, Sat Plopsoru",0,206,0,206,0,204,2,506,300,96,108,3,8120,1
20,"Gorj",81380,181,81380,,"POLOVRAGI",308,"Scoala generala I-IV Polovragi, sat Polovragi",1924,993,990,3,0,982,11,2000,1007,416,566,3,8132,0
20,"Gorj",81380,181,81380,,"POLOVRAGI",309,"Scoala primara Racovita, sat  Racovita",414,250,244,6,0,249,1,500,250,77,172,3,8132,0
20,"Gorj",81380,181,81380,,"POLOVRAGI",310,"Primaria Polovragi, Sat Polovragi, nr. 301",0,94,0,94,0,92,2,300,206,38,54,3,8132,1
20,"Gorj",81415,181,81415,,"PRIGORIA",311,"Scoala I-IV Calugareasa, sat   Calugareasa",497,262,255,7,0,261,1,600,338,95,166,3,8135,0
20,"Gorj",81415,181,81415,,"PRIGORIA",312,"Scoala I-IV Negoesti, sat Negoesti",298,129,119,10,0,129,0,400,271,55,74,3,8135,0
20,"Gorj",81415,181,81415,,"PRIGORIA",313,"Scoala I-IV Dobrana, sat  Dobrana",377,167,158,9,0,164,3,500,333,84,80,3,8135,0
20,"Gorj",81415,181,81415,,"PRIGORIA",314,"Scoala generala Prigoria, sat Prigoria",394,200,189,11,0,198,2,500,300,78,120,3,8135,0
20,"Gorj",81415,181,81415,,"PRIGORIA",315,"Scoala I-IV Bucsana, sat Bucsana",706,373,365,8,0,367,6,800,427,175,192,3,8135,0
20,"Gorj",81415,181,81415,,"PRIGORIA",316,"Scoala I-IV Zorlesti, sat  Zorlesti",395,230,223,7,0,225,5,500,270,55,170,3,8135,0
20,"Gorj",81415,181,81415,,"PRIGORIA",317,"Scoala Generala Prigoria, Sat Prigoria",0,73,0,73,0,72,1,300,227,23,49,3,8135,1
20,"Gorj",81497,181,81497,,"ROSIA DE AMARADIA",318,"Caminul Cultural ""Izvorul"", sat Rosia de Amaradia",1423,888,872,13,3,881,7,1600,712,439,442,3,8143,0
20,"Gorj",81497,181,81497,,"ROSIA DE AMARADIA",319,"Scoala primara clasele I-IV Seciurile, sat  Seciurile",629,360,349,11,0,359,1,800,440,199,160,3,8143,0
20,"Gorj",81497,181,81497,,"ROSIA DE AMARADIA",320,"Scoala primara clasele I-IV Ruget, sat Ruget",470,288,278,10,0,288,0,500,212,124,164,3,8143,0
20,"Gorj",81497,181,81497,,"ROSIA DE AMARADIA",321,"Caminul Cultural Rosia de Amaradia - Anexa unde functioneaza Gradinita nr. 1, Sat Rosia de Amaradia",0,86,0,86,0,85,1,201,115,37,48,3,8143,1
20,"Gorj",81576,181,81576,,"RUNCU",322,"Caminul Cultural Valea-Mare, sat  Valea-Mare",693,454,430,22,2,451,3,800,346,300,151,3,8151,0
20,"Gorj",81576,181,81576,,"RUNCU",323,"Scoala primara Bilta, sat  Bilta",1414,880,838,38,4,866,14,1600,720,473,393,3,8151,0
20,"Gorj",81576,181,81576,,"RUNCU",324,"Scoala generala Runcu, sat   Runcu",1128,649,637,12,0,641,8,1200,551,375,266,3,8151,0
20,"Gorj",81576,181,81576,,"RUNCU",325,"Caminul Cultural Dobrita, sat   Dobrita",876,574,546,14,14,564,10,1000,426,234,330,3,8151,0
20,"Gorj",81576,181,81576,,"RUNCU",326,"Centrul de ingrijire si asistenta Suseni, sat Suseni",201,185,142,30,13,182,3,400,215,90,92,3,8151,0
20,"Gorj",81576,181,81576,,"RUNCU",327,"Spitalul de Pneumoftiziologie ""Tudor Vladimirescu""",0,167,0,167,0,166,1,500,333,56,110,3,8151,1
20,"Gorj",81576,181,81576,,"RUNCU",328,"Primaria Runcu, Sat Runcu",0,245,0,245,0,244,1,1000,755,135,109,3,8151,1
20,"Gorj",81656,181,81656,,"SAMARINESTI",329,"Scoala Generala clasele V-VIII Samarinesti , sat Samarinesti",1048,712,709,3,0,704,8,1200,488,271,433,3,8165,0
20,"Gorj",81656,181,81656,,"SAMARINESTI",330,"Scoala primara Larga, sat  Larga",359,223,217,6,0,222,1,500,277,102,120,3,8165,0
20,"Gorj",81656,181,81656,,"SAMARINESTI",331,"Scoala Generala clasele V-VIII Samarinesti , sat Samarinesti",0,107,0,107,0,107,0,300,193,44,63,3,8165,1
20,"Gorj",81754,181,81754,,"SACELU",332,"Teatrul de vara din centrul  statiunii Sacelu , sat Sacelu",1337,755,745,10,0,746,9,1500,745,393,353,3,8159,0
20,"Gorj",81754,181,81754,,"SACELU",333,"Primaria Sacelu - sediul nou, Sat Sacelu",0,231,0,231,0,231,0,500,269,114,117,3,8159,1
20,"Gorj",81816,181,81816,,"SAULESTI",334,"Scoala generala Saulesti, sat Saulesti",1918,888,875,2,11,881,7,2000,1112,544,337,3,8175,0
20,"Gorj",81816,181,81816,,"SAULESTI",335,"Scoala Primara Saulesti, Sat Saulesti",0,140,0,140,0,140,0,500,360,75,65,3,8175,1
20,"Gorj",81987,181,81987,,"SCHELA",336,"Fosta Scoala primara Sambotin, sat Sambotin",490,327,323,4,0,325,2,500,173,135,190,3,8180,0
20,"Gorj",81987,181,81987,,"SCHELA",337,"Scoala primara Gornacel, sat  Gornacel",535,303,298,5,0,299,4,600,297,157,142,3,8180,0
20,"Gorj",81987,181,81987,,"SCHELA",338,"Scoala Primara Schela (Fosta Scoala generala  cu clasele I-VIII Schela), sat  Schela",572,324,317,7,0,323,1,600,276,141,182,3,8180,0
20,"Gorj",81987,181,81987,,"SCHELA",339,"Scoala Generala cu clasele I-VIII Sambotin, Sat Sambotin",0,56,0,56,0,56,0,300,244,23,33,3,8180,1
20,"Gorj",81861,181,81861,,"SCOARTA",340,"Scoala generala Budieni, sat  Budieni",615,347,334,13,0,344,3,700,353,132,212,3,8186,0
20,"Gorj",81861,181,81861,,"SCOARTA",341,"Scoala primara Pistestii din Deal, sat Pistestii din Deal",803,312,308,4,0,303,9,1000,688,91,212,3,8186,0
20,"Gorj",81861,181,81861,,"SCOARTA",342,"Scoala generala Copacioasa, sat   Copacioasa",690,360,350,10,0,354,6,800,440,153,201,3,8186,0
20,"Gorj",81861,181,81861,,"SCOARTA",343,"Caminul Cultural Scoarta, sat  Scoarta",759,424,414,10,0,421,3,800,376,201,220,3,8186,0
20,"Gorj",81861,181,81861,,"SCOARTA",344,"Fosta Primarie Bobu, sat Bobu",990,557,546,11,0,550,7,1000,443,267,283,3,8186,0
20,"Gorj",81861,181,81861,,"SCOARTA",345,"Primaria Scoarta, birou Secretar, Sat Scoarta",0,288,0,288,0,288,0,586,298,104,184,3,8186,1
20,"Gorj",82047,181,82047,,"SLIVILESTI",346,"Scoala primara cu clasele I-IV Slivilesti, sat Slivilesti",1940,1112,1094,18,0,1093,19,2000,888,405,688,3,8198,0
20,"Gorj",82047,181,82047,,"SLIVILESTI",347,"Sala de Sport Miculesti, sat Miculesti",858,591,562,29,0,587,4,993,402,236,351,3,8198,0
20,"Gorj",82047,181,82047,,"SLIVILESTI",348,"Scoala cu clasele I -IV Slivilesti, sat Slivilesti",0,149,0,149,0,148,1,400,251,73,75,3,8198,1
20,"Gorj",82136,181,82136,,"STANESTI",349,"Scoala generala Stanesti, sat Stanesti",1161,718,707,10,1,715,3,1200,482,352,363,3,8207,0
20,"Gorj",82136,181,82136,,"STANESTI",350,"Scoala generala Curpen, sat  Curpen",834,453,447,5,1,447,6,1000,547,250,197,3,8207,0
20,"Gorj",82136,181,82136,,"STANESTI",351,"Scoala Generala Stanesti, Sat Stanesti",0,191,0,191,0,190,1,301,110,94,96,3,8207,1
20,"Gorj",82243,181,82243,,"STEJARI",352,"Caminul Cultural Stejari, sat Stejari",894,470,460,10,0,467,3,1000,530,218,249,3,8218,0
20,"Gorj",82243,181,82243,,"STEJARI",353,"Caminul Cultural Piscoiu, sat Piscoiu",797,392,385,7,0,389,3,904,512,248,141,3,8218,0
20,"Gorj",82243,181,82243,,"STEJARI",354,"Caminul Cultural Balosani, sat  Balosani",402,244,235,9,0,241,3,500,256,98,143,3,8218,0
20,"Gorj",82243,181,82243,,"STEJARI",355,"Scoala Generala nr. 1 Stejari, sat Stejari",0,140,0,140,0,140,0,300,160,75,65,3,8218,1
20,"Gorj",82314,181,82314,,"STOINA",356,"Caminul Cultural Stoina, sat  Stoina",1212,753,723,30,0,749,4,1300,547,296,453,3,8225,0
20,"Gorj",82314,181,82314,,"STOINA",357,"Scoala primara Paisani, sat Paisani",662,429,420,9,0,419,10,700,271,225,194,3,8225,0
20,"Gorj",82314,181,82314,,"STOINA",358,"Grupul Scolar Industrial Stoina, Sat Stoina",0,282,0,282,0,280,2,400,118,125,155,3,8225,1
20,"Gorj",82396,181,82396,,"TELESTI",359,"Sala de sedinta a Consiliului Local Telesti, Satul Telesti",435,250,235,15,0,248,2,500,250,114,134,3,8238,0
20,"Gorj",82396,181,82396,,"TELESTI",360,"Scoala primara Telesti, sat Telesti",581,318,308,10,0,315,3,600,282,154,161,3,8238,0
20,"Gorj",82396,181,82396,,"TELESTI",361,"Scoala primara Somanesti,  sat Somanesti",542,365,359,6,0,364,1,600,235,182,182,3,8238,0
20,"Gorj",82396,181,82396,,"TELESTI",362,"Scoala primara nr.1 Buduhala, sat Buduhala",645,346,336,10,0,346,0,700,354,89,257,3,8238,0
20,"Gorj",82396,181,82396,,"TELESTI",363,"Primaria Telesti - biroul contabilitate, sat Telesti",0,145,0,145,0,143,2,300,155,45,98,3,8238,1
20,"Gorj",82555,181,82555,,"TURBUREA",364,"Scoala primara Turburea de Sus, catun Turburea de Sus",448,304,297,7,0,301,3,500,196,159,142,3,8242,0
20,"Gorj",82555,181,82555,,"TURBUREA",365,"Scoala generala Turburea, sat Turburea",711,468,450,16,2,462,6,800,332,200,262,3,8242,0
20,"Gorj",82555,181,82555,,"TURBUREA",366,"Scoala primara Sipotu, sat Spahii",666,428,410,18,0,423,5,700,272,205,218,3,8242,0
20,"Gorj",82555,181,82555,,"TURBUREA",367,"Scoala generala Poiana, sat Poiana",1259,805,792,13,0,799,6,1300,495,391,408,3,8242,0
20,"Gorj",82555,181,82555,,"TURBUREA",368,"Scoala primara Cocorova, sat Cocorova",407,242,235,7,0,240,2,500,258,126,114,3,8242,0
20,"Gorj",82555,181,82555,,"TURBUREA",369,"Scoala Generala Poiana, Sat Poiana",0,329,0,329,0,327,2,500,171,153,174,3,8242,1
20,"Gorj",78089,181,78089,,"TURCINESTI",370,"Primaria Turcinesti, sat Turcinesti",1311,817,810,7,0,809,8,1400,583,366,443,3,8248,0
20,"Gorj",78089,181,78089,,"TURCINESTI",371,"Scoala primara Rugi, sat  Rugi",551,336,336,0,0,333,3,600,264,196,137,3,8248,0
20,"Gorj",78089,181,78089,,"TURCINESTI",372,"Scoala Generala ""Grigore Geamanu"" Turcinesti, Sat Turcinesti",0,273,0,273,0,272,1,299,26,147,125,3,8248,1
20,"Gorj",82680,181,82680,,"TANTARENI",373,"Scoala Generala Tintareni, sat  Tintareni",1883,1053,1036,17,0,1037,16,1900,847,460,577,3,8233,0
20,"Gorj",82680,181,82680,,"TANTARENI",374,"Scoala generala Capinteni nr. 2, sat Floresti",979,633,604,29,0,625,8,1100,467,237,388,3,8233,0
20,"Gorj",82680,181,82680,,"TANTARENI",375,"Scoala generala Floresti nr.1, sat Floresti",1347,788,767,21,0,774,14,1400,612,305,469,3,8233,0
20,"Gorj",82680,181,82680,,"TANTARENI",376,"Scoala Generala Chiciora, sat  Chiciora",248,166,153,13,0,164,2,346,180,28,136,3,8233,0
20,"Gorj",82680,181,82680,,"TANTARENI",377,"Scoala Generala Tantareni, Sat Tantareni",0,161,0,161,0,158,3,401,240,69,89,3,8233,1
20,"Gorj",82733,181,82733,,"URDARI",378,"Scoala generala Fintinele, sat  Fintinele",767,533,530,3,0,529,4,800,267,349,180,3,8253,0
20,"Gorj",82733,181,82733,,"URDARI",379,"Scoala generala nr. 1 Urdari, sat Urdari",1300,860,845,15,0,850,10,1300,440,424,426,3,8253,0
20,"Gorj",82733,181,82733,,"URDARI",380,"Scoala primara nr. 2 Urdari, sat Urdari",461,302,296,6,0,299,3,500,198,164,135,3,8253,0
20,"Gorj",82733,181,82733,,"URDARI",381,"Scoala Generala nr. 1 Urdari - sala de curs Limba Romana, Sat Urdari",0,87,0,87,0,86,1,200,113,47,39,3,8253,1
20,"Gorj",82779,181,82779,,"VAGIULESTI",382,"Scoala generala Vagiulesti, sat Vagiulesti",1159,714,706,8,0,708,6,1200,486,285,423,3,8257,0
20,"Gorj",82779,181,82779,,"VAGIULESTI",383,"Scoala generala Covrigi, sat Covrigi",1131,636,628,7,1,626,10,1200,564,242,384,3,8257,0
20,"Gorj",82779,181,82779,,"VAGIULESTI",384,"Scoala Primara cu clasele I-IV Murgilesti, sat Murgilesti",0,137,0,137,0,136,1,200,63,63,73,3,8257,1
20,"Gorj",82831,181,82831,,"VLADIMIR",385,"Caminul Cultural Andreesti, sat Andreesti",924,608,599,9,0,601,7,1000,392,334,267,3,8263,0
20,"Gorj",82831,181,82831,,"VLADIMIR",386,"Scoala generala Frasin, sat Frasin",560,321,313,8,0,320,1,600,279,140,180,3,8263,0
20,"Gorj",82831,181,82831,,"VLADIMIR",387,"Scoala generala Vladimir, sat  Vladimir",997,553,539,14,0,548,5,1000,447,201,347,3,8263,0
20,"Gorj",82831,181,82831,,"VLADIMIR",388,"Scoala Generala Blindulesti, Sat Andreesti",0,288,0,288,0,288,0,500,212,130,158,3,8263,1
21,"Harghita",83320,190,83320,,"MUNICIPIUL MIERCUREA CIUC",1,"Teatrul municipal ""Csiki Jatekszin"", B-dul Timisoarei nr. 6",1684,625,612,12,1,612,13,1798,1173,285,327,1,8269,0
21,"Harghita",83320,190,83320,,"MUNICIPIUL MIERCUREA CIUC",2,"Casa de Cultura a Sindicatelor, Piata Libertatii nr. 16",1433,598,588,10,0,582,16,1530,932,253,329,1,8269,0
21,"Harghita",83320,190,83320,,"MUNICIPIUL MIERCUREA CIUC",3,"Casa de Cultura a Sindicatelor, Piata Libertatii nr. 16",1514,522,514,8,0,514,8,1617,1095,308,206,1,8269,0
21,"Harghita",83320,190,83320,,"MUNICIPIUL MIERCUREA CIUC",4,"Casa de Cultura a Sindicatelor, Piata Libertatii nr. 16",1048,332,325,7,0,326,6,1119,787,153,173,1,8269,0
21,"Harghita",83320,190,83320,,"MUNICIPIUL MIERCUREA CIUC",5,"Scoala generala ""Nagy Imre"", Str. Revolutiei din Decembrie nr. 1",1622,569,559,9,1,560,9,1732,1163,282,278,1,8269,0
21,"Harghita",83320,190,83320,,"MUNICIPIUL MIERCUREA CIUC",6,"Scoala generala ""Nagy Imre"", Str. Revolutiei din Decembrie nr. 1",1007,327,320,7,0,322,5,1075,748,180,142,1,8269,0
21,"Harghita",83320,190,83320,,"MUNICIPIUL MIERCUREA CIUC",7,"Liceul teoretic ""Marton Aron"", Str. Marton Aron nr. 80",1520,511,503,8,0,501,10,1623,1112,253,248,1,8269,0
21,"Harghita",83320,190,83320,,"MUNICIPIUL MIERCUREA CIUC",8,"Liceul teoretic ""Marton Aron"", Str. Marton Aron nr. 80",1060,365,356,9,0,362,3,1132,767,165,197,1,8269,0
21,"Harghita",83320,190,83320,,"MUNICIPIUL MIERCUREA CIUC",9,"Scoala Generala nr. 9 ""Liviu Rebreanu"", Str. Patinoarului nr. 2",1965,813,803,10,0,794,19,2098,1285,370,424,1,8269,0
21,"Harghita",83320,190,83320,,"MUNICIPIUL MIERCUREA CIUC",10,"Caminul de zi nr. 1 ""Napraforgo"", Str. Harghita nr.34",1594,644,637,7,0,633,11,1702,1058,350,283,1,8269,0
21,"Harghita",83320,190,83320,,"MUNICIPIUL MIERCUREA CIUC",11,"S.C. Goscom SA, Str. Salcam nr. 1",1433,442,439,3,0,436,6,1530,1088,250,186,1,8269,0
21,"Harghita",83320,190,83320,,"MUNICIPIUL MIERCUREA CIUC",12,"Scoala generala nr.8 ""Jozsef Attila"", Str. Miron Cristea",1597,662,614,10,38,648,14,1705,1043,328,320,1,8269,0
21,"Harghita",83320,190,83320,,"MUNICIPIUL MIERCUREA CIUC",13,"Casa de Cultura, Str. Zsogodi Nagy Imre nr.140",1122,388,378,10,0,375,13,1198,810,210,165,1,8269,0
21,"Harghita",83320,190,83320,,"MUNICIPIUL MIERCUREA CIUC",14,"Colegiul National ""Octavian Goga"", Str. Tudor Vladimirescu nr.40",1347,492,484,8,0,490,2,1438,946,267,223,1,8269,0
21,"Harghita",83320,190,83320,,"MUNICIPIUL MIERCUREA CIUC",15,"Colegiul National ""Octavian Goga"", Str. Tudor Vladimirescu nr.40",1056,393,386,7,0,386,7,1128,735,195,191,1,8269,0
21,"Harghita",83320,190,83320,,"MUNICIPIUL MIERCUREA CIUC",16,"Scoala generala ""Jozsef Attila"", B-ul Fratiei nr.20",1028,382,373,9,0,373,9,1098,716,195,178,1,8269,0
21,"Harghita",83320,190,83320,,"MUNICIPIUL MIERCUREA CIUC",17,"Scoala generala ""Jozsef Attila"", B-ul Fratiei nr.20",1282,436,422,14,0,431,5,1369,933,217,214,1,8269,0
21,"Harghita",83320,190,83320,,"MUNICIPIUL MIERCUREA CIUC",18,"Gradinita nr. 18 ""Tulipan"", Str. Leliceni nr.62",1798,642,634,8,0,628,14,1920,1278,344,284,1,8269,0
21,"Harghita",83320,190,83320,,"MUNICIPIUL MIERCUREA CIUC",19,"Camin de zi nr. 2 ""Szivarvany"",  Aleea Copiilor nr.6",1797,579,570,9,0,572,7,1919,1340,348,224,1,8269,0
21,"Harghita",83320,190,83320,,"MUNICIPIUL MIERCUREA CIUC",20,"Scoala generala nr.1 ""Petofi Sandor"", Str. Petofi Sandor nr.40",1564,535,526,9,0,528,7,1670,1135,321,207,1,8269,0
21,"Harghita",83320,190,83320,,"MUNICIPIUL MIERCUREA CIUC",21,"Scoala generala nr.1 ""Petofi Sandor"", Str. Petofi Sandor nr.40",768,274,266,8,0,268,6,820,546,118,150,1,8269,0
21,"Harghita",83320,190,83320,,"MUNICIPIUL MIERCUREA CIUC",22,"Grupul Scolar Industrial nr.4 ""Szekely Karoly"", Str. Iancu de Hunedoara nr.29/B",1354,452,443,9,0,443,9,1446,994,259,184,1,8269,0
21,"Harghita",83320,190,83320,,"MUNICIPIUL MIERCUREA CIUC",23,"Grupul Scolar Industrial nr.4 ""Szekely Karoly"", Str. Iancu de Hunedoara nr.29/B",1270,404,397,6,1,402,2,1357,953,211,191,1,8269,0
21,"Harghita",83320,190,83320,,"MUNICIPIUL MIERCUREA CIUC",24,"Sediul Asociatiei ""Csiksomlyo"", Str. Szek nr. 123",1871,615,604,11,0,602,13,1998,1383,300,302,1,8269,0
21,"Harghita",83320,190,83320,,"MUNICIPIUL MIERCUREA CIUC",25,"Scoala generala ""Xantus Janos"", Str. Toplita nr. 112",1554,567,556,11,0,556,11,1659,1092,294,262,1,8269,0
21,"Harghita",83320,190,83320,,"MUNICIPIUL MIERCUREA CIUC",26,"Scoala generala ""Nyiro Jozsef"", Harghita Bai",179,69,57,12,0,69,0,192,123,49,20,1,8269,0
21,"Harghita",83320,190,83320,,"MUNICIPIUL MIERCUREA CIUC",27,"Gara CFR Miercurea-Ciuc, Miercurea-Ciuc str.Brasovului nr.1",0,552,0,552,0,541,11,1000,448,311,230,1,8269,1
21,"Harghita",83561,190,83561,,"MUNICIPIUL  GHEORGHENI",28,"Scoala generala nr. 2 ""Kos Karoly"", Str. Kossuth Lajos nr. 124",2112,589,579,10,0,576,13,2255,1666,359,217,1,8274,0
21,"Harghita",83561,190,83561,,"MUNICIPIUL  GHEORGHENI",29,"Gradinita nr.13 ""Pitypang"", Str. Kossuth Lajos nr.81",1930,543,535,8,0,529,14,2061,1518,329,200,1,8274,0
21,"Harghita",83561,190,83561,,"MUNICIPIUL  GHEORGHENI",30,"Gradinita nr.13 ""Pitypang"", Str. Kossuth Lajos nr.81",2151,633,624,9,0,618,15,2296,1663,402,216,1,8274,0
21,"Harghita",83561,190,83561,,"MUNICIPIUL  GHEORGHENI",31,"Centrul Cultural, B-dul Fratiei nr.9",2020,615,607,8,0,593,22,2157,1542,351,242,1,8274,0
21,"Harghita",83561,190,83561,,"MUNICIPIUL  GHEORGHENI",32,"Scoala gen. ""Vaskertes"", Str. Kossuth Lajos nr.2",2188,649,641,8,0,636,13,2336,1687,396,240,1,8274,0
21,"Harghita",83561,190,83561,,"MUNICIPIUL  GHEORGHENI",33,"Liceul teoretic ""Solomon Erno"", Str. Lacu Rosu 3-5",2205,744,716,28,0,718,26,2354,1610,385,333,1,8274,0
21,"Harghita",83561,190,83561,,"MUNICIPIUL  GHEORGHENI",34,"Grup Scolar Constructii de Masini, Str. Marton Aron 13-15",2155,630,613,17,0,608,22,2101,1471,354,254,1,8274,0
21,"Harghita",83561,190,83561,,"MUNICIPIUL  GHEORGHENI",35,"Colegiul tehnic ""Batthyany Ignac"", B-ul Lacu Rosu nr.149",2165,575,564,11,0,554,21,2111,1536,384,170,1,8274,0
21,"Harghita",83561,190,83561,,"MUNICIPIUL  GHEORGHENI",36,"Scoala generala, Statiunea Lacu-Rosu",75,46,36,10,0,44,2,81,35,29,15,1,8274,0
21,"Harghita",83561,190,83561,,"MUNICIPIUL  GHEORGHENI",37,"Gara CFR Gheorgheni, Gheorgheni str.Garii nr.18",0,166,0,166,0,161,5,500,334,92,69,1,8274,1
21,"Harghita",83561,190,83561,,"MUNICIPIUL  GHEORGHENI",38,"Spitalul Municipal Gheorgheni, Gheorgheni B.dul Lacu Rosu nr.16",0,111,0,111,0,110,1,500,389,70,40,1,8274,1
21,"Harghita",83561,190,83561,,"MUNICIPIUL  GHEORGHENI",39,"Sediu Administratie Lacu Rosu, Statiunea Lacu Rosu Bl.cu 20 apartamente/parter",0,54,0,54,0,54,0,500,446,36,18,1,8274,1
21,"Harghita",83133,190,83133,,"MUNICIPIUL ODORHEIU SECUIESC",40,"Colegiul tehnic ""Banyai Janos"", Str. Budvar nr. 8/A",1438,422,407,15,0,405,17,1535,1113,244,161,1,8290,0
21,"Harghita",83133,190,83133,,"MUNICIPIUL ODORHEIU SECUIESC",41,"Colegiul tehnic ""Banyai Janos"", Str. Budvar nr. 8/A",1048,302,295,7,0,296,6,1119,817,181,115,1,8290,0
21,"Harghita",83133,190,83133,,"MUNICIPIUL ODORHEIU SECUIESC",42,"Gradinita Zsibongo, Str. Morii nr.33",1589,529,521,8,0,520,9,1697,1168,318,202,1,8290,0
21,"Harghita",83133,190,83133,,"MUNICIPIUL ODORHEIU SECUIESC",43,"Liceul Pedagogic, Piata Libertatii nr. 11",1070,312,302,10,0,303,9,1143,831,169,134,1,8290,0
21,"Harghita",83133,190,83133,,"MUNICIPIUL ODORHEIU SECUIESC",44,"Liceul Pedagogic, Piata Libertatii nr. 11",1285,339,326,13,0,332,7,1372,1033,216,116,1,8290,0
21,"Harghita",83133,190,83133,,"MUNICIPIUL ODORHEIU SECUIESC",45,"Casa de Cultura, Str. Tamasi Aron nr. 11",1530,555,544,10,1,538,17,1634,1079,273,265,1,8290,0
21,"Harghita",83133,190,83133,,"MUNICIPIUL ODORHEIU SECUIESC",46,"Liceul ""Kos Karoly"", Str. Nicolae Balcescu nr. 35",1593,523,512,11,0,517,6,1701,1178,221,296,1,8290,0
21,"Harghita",83133,190,83133,,"MUNICIPIUL ODORHEIU SECUIESC",47,"Liceul ""Kos Karoly"", Str. Nicolae Balcescu nr. 35",1651,514,505,9,0,503,11,1763,1249,297,206,1,8290,0
21,"Harghita",83133,190,83133,,"MUNICIPIUL ODORHEIU SECUIESC",48,"Imobilul din strada Bethlen Gabor nr.50, Str. Bethlen Gabor nr. 50",1388,474,458,16,0,460,14,1482,1008,265,195,1,8290,0
21,"Harghita",83133,190,83133,,"MUNICIPIUL ODORHEIU SECUIESC",49,"Scoala generala ""Orban Balazs"", Str. Independentei nr. 37",1561,471,464,7,0,465,6,1610,1139,263,202,1,8290,0
21,"Harghita",83133,190,83133,,"MUNICIPIUL ODORHEIU SECUIESC",50,"Scoala generala ""Orban Balazs"", Str. Independentei nr. 37",1320,416,410,6,0,408,8,1409,993,221,187,1,8290,0
21,"Harghita",83133,190,83133,,"MUNICIPIUL ODORHEIU SECUIESC",51,"Scoala generala ""Orban Balazs"", Str. Independentei nr. 37",1036,366,360,6,0,362,4,1106,740,188,174,1,8290,0
21,"Harghita",83133,190,83133,,"MUNICIPIUL ODORHEIU SECUIESC",52,"Scoala generala ""Bethlen Gabor"", Str. Tineretului nr. 3",1594,534,525,9,0,534,0,1702,1168,303,231,1,8290,0
21,"Harghita",83133,190,83133,,"MUNICIPIUL ODORHEIU SECUIESC",53,"Scoala generala ""Bethlen Gabor"", Str. Tineretului nr. 3",1530,460,454,6,0,457,3,1634,1174,310,147,1,8290,0
21,"Harghita",83133,190,83133,,"MUNICIPIUL ODORHEIU SECUIESC",54,"Scoala generala ""Bethlen Gabor"", Str. Tineretului nr. 3",1487,505,502,3,0,497,8,1588,1083,322,175,1,8290,0
21,"Harghita",83133,190,83133,,"MUNICIPIUL ODORHEIU SECUIESC",55,"Scoala generala ""Bethlen Gabor"", Str. Tineretului nr. 3",1634,517,507,10,0,504,13,1745,1228,324,180,1,8290,0
21,"Harghita",83133,190,83133,,"MUNICIPIUL ODORHEIU SECUIESC",56,"Scoala generala ""Bethlen Gabor"", Str. Tineretului nr. 3",1574,383,374,8,1,374,9,1681,1298,241,133,1,8290,0
21,"Harghita",83133,190,83133,,"MUNICIPIUL ODORHEIU SECUIESC",57,"Scoala generala nr. 7 ""Mora Ferenc"", Str. Victoriei nr. 16",1690,530,519,11,0,522,8,1804,1274,322,200,1,8290,0
21,"Harghita",83133,190,83133,,"MUNICIPIUL ODORHEIU SECUIESC",58,"Scoala generala nr. 7 ""Mora Ferenc"", Str. Victoriei nr. 16",1693,486,480,6,0,478,8,1808,1322,312,166,1,8290,0
21,"Harghita",83133,190,83133,,"MUNICIPIUL ODORHEIU SECUIESC",59,"Scoala generala nr. 7 ""Mora Ferenc"", Str. Victoriei nr. 16",1689,457,451,6,0,450,7,1803,1346,295,155,1,8290,0
21,"Harghita",83133,190,83133,,"MUNICIPIUL ODORHEIU SECUIESC",60,"Scoala generala nr. 7 ""Mora Ferenc"", Str. Victoriei nr. 16",1719,510,504,6,0,503,7,1835,1325,302,201,1,8290,0
21,"Harghita",83133,190,83133,,"MUNICIPIUL ODORHEIU SECUIESC",61,"Clubul Casei de Cultura Beclean, str. Beclean nr.170",1456,512,501,11,0,503,9,1555,1043,314,189,1,8290,0
21,"Harghita",83133,190,83133,,"MUNICIPIUL ODORHEIU SECUIESC",62,"Autogara Odorheiu Secuiesc, Odorheiu Secuiesc str.Targului nr.10",0,299,0,299,0,292,7,700,401,181,111,1,8290,1
21,"Harghita",83632,190,83632,,"MUNICIPIUL  TOPLITA",63,"Scoala generala nr. 8 ""Miron Cristea"", Str. Avram Iancu nr. 4",1660,802,798,4,0,797,5,1772,970,464,333,1,8280,0
21,"Harghita",83632,190,83632,,"MUNICIPIUL  TOPLITA",64,"Scoala generala nr. 8 ""Miron Cristea"", Str. Avram Iancu nr. 4",1644,786,784,2,0,774,12,1756,970,454,320,1,8280,0
21,"Harghita",83632,190,83632,,"MUNICIPIUL  TOPLITA",65,"Liceul Teoretic ""Kemeny Janos"", Str. Sportivilor nr. 5/G",1220,548,541,7,0,547,1,1303,755,329,218,1,8280,0
21,"Harghita",83632,190,83632,,"MUNICIPIUL  TOPLITA",66,"Gradinita ""Voinicel"", Str. Garii",1177,515,502,13,0,505,10,1257,742,267,238,1,8280,0
21,"Harghita",83632,190,83632,,"MUNICIPIUL  TOPLITA",67,"Scoala generala nr. 2 Zencani, Str. Teiului nr. 12",1517,737,727,9,1,730,7,1620,883,473,257,1,8280,0
21,"Harghita",83632,190,83632,,"MUNICIPIUL  TOPLITA",68,"Scoala generala ""Andrei Saguna"", Toplita Str. 1 Decembrie 1918",1605,834,824,10,0,826,8,1714,880,500,326,1,8280,0
21,"Harghita",83632,190,83632,,"MUNICIPIUL  TOPLITA",69,"Colegiul National ""Mihai Eminescu"", Str. Stefan cel Mare nr. 6",995,461,453,8,0,459,2,1063,602,256,203,1,8280,0
21,"Harghita",83632,190,83632,,"MUNICIPIUL  TOPLITA",70,"Scoala Generala nr.4 ""Sfantul Ilie"", Str. Stefan cel Mare",1180,491,486,5,0,483,8,1260,769,317,166,1,8280,0
21,"Harghita",83632,190,83632,,"MUNICIPIUL  TOPLITA",71,"Liceul ""O.C.Taslaoanu"", Str. Dealului nr. 9",1417,619,611,8,0,616,3,1513,894,412,204,1,8280,0
21,"Harghita",83632,190,83632,,"MUNICIPIUL  TOPLITA",72,"Scoala generala ""Andrei Saguna"", Str. Calimani nr. 5",977,506,499,7,0,504,2,1043,537,336,168,1,8280,0
21,"Harghita",83632,190,83632,,"MUNICIPIUL  TOPLITA",73,"Scoala Generala Secu, Secu nr.15",62,44,35,9,0,44,0,66,22,28,16,1,8280,0
21,"Harghita",83632,190,83632,,"MUNICIPIUL  TOPLITA",74,"Gara Municipiului Toplita, Toplita str.Garii nr.13",0,258,0,258,0,257,1,600,342,152,105,1,8280,1
21,"Harghita",83428,190,83428,,"ORAS BAILE TUSNAD",75,"Biblioteca Oraseneasca, Str. Oltului nr.114 Baile Tusnad",1470,574,571,3,0,569,5,1570,996,422,147,1,8292,0
21,"Harghita",83428,190,83428,,"ORAS BAILE TUSNAD",76,"Biblioteca oraseneasca Baile Tusnad, Baile Tusnad str.Oltului nr.114",0,276,0,276,0,272,4,600,324,159,113,1,8292,1
21,"Harghita",83464,190,83464,,"ORAS BALAN",77,"Casa de cultura Balan Str. 1 Decembrie",1389,475,466,8,1,473,2,1483,1008,203,270,1,8295,0
21,"Harghita",83464,190,83464,,"ORAS BALAN",78,"Scoala generala nr.1, Balan, Str. 1 Decembrie nr. 31/B",1457,428,421,7,0,419,9,1556,1128,192,227,1,8295,0
21,"Harghita",83464,190,83464,,"ORAS BALAN",79,"Scoala gen.""Geo Bogza"" Balan, Str. Florilor nr. 82",1352,420,415,5,0,417,3,1444,1024,168,249,1,8295,0
21,"Harghita",83464,190,83464,,"ORAS BALAN",80,"Gradinita nr.2 ""Licurici"" Balan, Str. Florilor nr. 10",1279,397,393,4,0,390,7,1366,969,158,232,1,8295,0
21,"Harghita",83464,190,83464,,"ORAS BALAN",81,"Clubul elevilor Balan, Str. Florilor nr. 7",1492,457,446,11,0,456,1,1593,1136,167,289,1,8295,0
21,"Harghita",83464,190,83464,,"ORAS BALAN",82,"Clubul ""MINERUL"" Balan, Balan str. 1 Decembrie nr.21/A",0,44,0,44,0,44,0,300,256,22,22,1,8295,1
21,"Harghita",83491,190,83491,,"ORAS BORSEC",83,"Grupul Scolar ""Zimmethausen"", Str. M. Eminescu nr.2, etaj 1",945,410,408,0,2,405,5,1009,599,295,110,1,8297,0
21,"Harghita",83491,190,83491,,"ORAS BORSEC",84,"Sediul Consiliului local, Str. Carpati nr.6/A parter",1430,642,637,4,1,632,10,1527,885,423,209,1,8297,0
21,"Harghita",83491,190,83491,,"ORAS BORSEC",85,"Grup Scolar ""ZIMETHOUSEN"" Borsec, Borsec str.Mihai Eminescu nr.1",0,58,0,58,0,58,0,300,242,42,16,1,8297,1
21,"Harghita",83525,190,83525,,"ORAS CRISTURU SECUIESC",86,"Caminul Cultural, Betesti",564,144,131,13,0,138,6,602,458,104,34,1,8299,0
21,"Harghita",83525,190,83525,,"ORAS CRISTURU SECUIESC",87,"Scoala generala ""Petofi Sandor"", Str. Timafalvi nr.43",1181,386,376,10,0,385,1,1261,875,242,143,1,8299,0
21,"Harghita",83525,190,83525,,"ORAS CRISTURU SECUIESC",88,"Clubul elevilor, Str. Libertatii nr.62",1566,447,438,8,1,439,8,1672,1225,238,201,1,8299,0
21,"Harghita",83525,190,83525,,"ORAS CRISTURU SECUIESC",89,"Primaria Orasului Cristuru - Secuiesc, Str. Libertatii nr.27",1532,424,419,5,0,415,9,1636,1212,244,171,1,8299,0
21,"Harghita",83525,190,83525,,"ORAS CRISTURU SECUIESC",90,"Casa de Cultura, Str. Kriza Janos nr.8",1573,505,496,9,0,500,5,1679,1174,333,167,1,8299,0
21,"Harghita",83525,190,83525,,"ORAS CRISTURU SECUIESC",91,"Liceul Teoretic ""Berde Mozes"", Str. Orban Balazs nr.1",1613,476,463,13,0,474,2,1722,1246,309,165,1,8299,0
21,"Harghita",83525,190,83525,,"ORAS CRISTURU SECUIESC",92,"Centrul de planificare a familiei, Str. Filias nr.188",923,358,353,5,0,352,6,986,628,258,94,1,8299,0
21,"Harghita",83525,190,83525,,"ORAS CRISTURU SECUIESC",93,"Primaria Orasului Cristuru Secuiesc, Cristuru Secuiesc str.Libertatii nr.27",0,67,0,67,0,65,2,300,233,41,24,1,8299,1
21,"Harghita",83749,190,83749,,"ORAS VLAHITA",94,"Scoala generala ""Martonffi Janos"", Str. Harghitei nr.63",1311,376,367,9,0,368,8,1400,1024,271,97,1,8303,0
21,"Harghita",83749,190,83749,,"ORAS VLAHITA",95,"Scoala generala ""Martonffi Janos"", Str. Republicii nr.24",1469,464,458,6,0,450,14,1568,1104,299,151,1,8303,0
21,"Harghita",83749,190,83749,,"ORAS VLAHITA",96,"Scoala generala ""Tamasi Aron"", Str. Mihai Eminescu nr.2",999,258,248,10,0,253,5,1067,809,155,98,1,8303,0
21,"Harghita",83749,190,83749,,"ORAS VLAHITA",97,"Grup Scolar ""Gabor Aron"", Str. Mihai Eminescu nr.2",1169,306,296,10,0,299,7,1248,942,157,142,1,8303,0
21,"Harghita",83749,190,83749,,"ORAS VLAHITA",98,"Casa de Cultura ""Bartok Bela"", Str. Gabor Aron nr.47",1194,342,333,9,0,339,3,1275,933,206,133,1,8303,0
21,"Harghita",83749,190,83749,,"ORAS VLAHITA",99,"Casa de Cultura Vlahita, Vlahita str.Republicii nr.24",0,27,0,27,0,26,1,300,273,11,15,1,8303,1
21,"Harghita",83785,190,83785,,"ATID",100,"Caminul cultural Atid, Sat Atid nr. 469",967,292,286,6,0,276,16,1033,741,157,119,3,8307,0
21,"Harghita",83785,190,83785,,"ATID",101,"Caminul cultural Criseni, Sat Criseni nr. 287",585,219,211,8,0,209,10,625,406,120,89,3,8307,0
21,"Harghita",83785,190,83785,,"ATID",102,"Caminul cultural Cusmed, Sat Cusmed nr.33",316,119,109,10,0,113,6,338,219,67,46,3,8307,0
21,"Harghita",83785,190,83785,,"ATID",103,"Sediul Composesorat, Sat Inlaceni nr. 37",147,72,65,7,0,72,0,157,85,34,38,3,8307,0
21,"Harghita",83785,190,83785,,"ATID",104,"Caminul cultural, Sat Siclod nr.256",227,73,64,9,0,69,4,243,170,34,35,3,8307,0
21,"Harghita",83785,190,83785,,"ATID",105,"Caminul Cultural Atid, Atid nr.469",0,18,0,18,0,18,0,200,182,14,4,3,8307,1
21,"Harghita",83847,190,83847,,"AVRAMESTI",106,"Sediul Primariei Avramesti, Sat Avramesti nr.126",830,260,258,2,0,246,14,886,626,199,47,3,8313,0
21,"Harghita",83847,190,83847,,"AVRAMESTI",107,"Scoala generala Cechesti, Sat Cechesti nr.31",447,142,142,0,0,134,8,478,336,103,31,3,8313,0
21,"Harghita",83847,190,83847,,"AVRAMESTI",108,"Scoala generala Goagiu, Sat Goagiu nr.90",549,239,232,7,0,233,6,586,347,199,34,3,8313,0
21,"Harghita",83847,190,83847,,"AVRAMESTI",109,"Scoala generala Medisoru Mic, Sat Medisoru Mic nr.1",72,25,15,10,0,25,0,77,52,17,8,3,8313,0
21,"Harghita",83847,190,83847,,"AVRAMESTI",110,"Scoala generala FirtanusSat, Firtanus nr.124",214,60,56,4,0,58,2,226,166,45,13,3,8313,0
21,"Harghita",83847,190,83847,,"AVRAMESTI",111,"Primaria Comunei Avramesti, Avramesti str.Principala nr.126",0,27,0,27,0,26,1,200,173,20,6,3,8313,1
21,"Harghita",83936,190,83936,,"BILBOR",112,"Caminul Cultural Bilbor, Sat Bilbor nr.111/B",2258,1272,1264,8,0,1264,8,2411,1139,577,687,3,8322,0
21,"Harghita",83936,190,83936,,"BILBOR",113,"Caminul Cultural Bilbor, Bilbor nr.120/B",0,45,0,45,0,44,1,200,155,24,20,3,8322,1
21,"Harghita",83151,190,83151,,"BRADESTI",114,"Scoala generala nr.1 Bradesti, Sat Bradesti nr.264",854,362,362,0,0,356,6,912,550,196,160,3,8325,0
21,"Harghita",83151,190,83151,,"BRADESTI",115,"Scoala generala Tarnovita, Sat Tarnovita nr. 158",582,298,298,0,0,288,10,622,324,132,156,3,8325,0
21,"Harghita",83151,190,83151,,"BRADESTI",116,"Scoala Generala nr.1 Bradesti, Bradesti nr.264",0,35,0,35,0,35,0,200,165,19,16,3,8325,1
21,"Harghita",83963,190,83963,,"CAPALNITA",117,"Caminul Cultural Capilnita, Capalnita nr. 525",1651,432,426,6,0,415,17,1763,1331,270,145,3,8328,0
21,"Harghita",83963,190,83963,,"CAPALNITA",118,"Caminul Cultural Capilnita, Capilnita nr.525",0,19,0,19,0,19,0,200,181,11,8,3,8328,1
21,"Harghita",86461,190,86461,,"CICEU",119,"Fosta scoala confesionala Sat. Ciceu, str. Principala nr. 440 Intrarea I",1467,553,545,8,0,538,15,1566,1013,309,229,3,8333,0
21,"Harghita",86461,190,86461,,"CICEU",120,"Fosta scoala confesionala Sat. Ciceu, str. Principala nr. 440 Intrarea II",762,233,223,10,0,231,2,814,581,130,101,3,8333,0
21,"Harghita",86461,190,86461,,"CICEU",121,"Primaria Comunei Ciceu, Ciceu nr.651",0,19,0,19,0,18,1,200,181,10,8,3,8333,1
21,"Harghita",83981,190,83981,,"CIUCSANGEORGIU",122,"Scoala generala ""Gal Sandor"" Sat Ciucsingeorgiu nr.558",1550,521,504,17,0,500,21,1655,1134,289,211,3,8336,0
21,"Harghita",83981,190,83981,,"CIUCSANGEORGIU",123,"Caminul Cultural Armasenii -Noi, Satul Armasenii - Noi nr. 603",254,148,141,7,0,144,4,272,124,69,75,3,8336,0
21,"Harghita",83981,190,83981,,"CIUCSANGEORGIU",124,"Caminul Cultural Armaseni, Satul Armaseni 110",736,360,351,9,0,354,6,786,426,206,148,3,8336,0
21,"Harghita",83981,190,83981,,"CIUCSANGEORGIU",125,"Scoala generala ""Marton Ferenc"", Sat Bancu nr. 154",1054,273,263,10,0,271,2,1126,853,180,91,3,8336,0
21,"Harghita",83981,190,83981,,"CIUCSANGEORGIU",126,"Caminul cultural Eghersec, Sat Eghersec nr.610/a",88,49,42,7,0,48,1,94,45,26,22,3,8336,0
21,"Harghita",83981,190,83981,,"CIUCSANGEORGIU",127,"Caminul cultural Eghersec - Cinod, Sat Cinod nr. 560",148,63,56,7,0,60,3,158,95,42,18,3,8336,0
21,"Harghita",83981,190,83981,,"CIUCSANGEORGIU",128,"Primaria Comunei Ciucsangeorgiu, Ciucsingeorgiu str. Principala nr.130",0,25,0,25,0,24,1,200,175,16,8,3,8336,1
21,"Harghita",84086,190,84086,,"CIUMANI",129,"Caminul Cultural, Ciumani nr.209",1409,426,418,8,0,420,6,1504,1078,198,222,3,8346,0
21,"Harghita",84086,190,84086,,"CIUMANI",130,"Scoala Generala nr.1, Ciumani nr.218",1150,362,356,6,0,351,11,1228,866,205,146,3,8346,0
21,"Harghita",84086,190,84086,,"CIUMANI",131,"Scoala Generala nr.3, Ciumani nr.1096",1188,337,328,9,0,332,5,1269,932,209,123,3,8346,0
21,"Harghita",84086,190,84086,,"CIUMANI",132,"Primaria Comunei Ciumani, Ciuman nr.208",0,42,0,42,0,41,1,200,158,20,21,3,8346,1
21,"Harghita",84102,190,84102,,"CARTA",133,"Primaria comunei Cirta, Sat Carta nr.159",837,299,293,6,0,295,4,894,595,112,183,3,8330,0
21,"Harghita",84102,190,84102,,"CARTA",134,"Sediul Coposesoratului Tercs situat in Cladirea Caminului Cultural Ineu, Sat Ineu nr.535",1441,432,425,7,0,427,5,1539,1107,205,222,3,8330,0
21,"Harghita",84102,190,84102,,"CARTA",135,"Primaria Comunei Cirta, Cirta str.Principala nr.159",0,26,0,26,0,25,1,200,174,15,10,3,8330,1
21,"Harghita",84148,190,84148,,"CORBU",136,"Caminul Cultural Corbu, Corbu nr. 344",800,447,437,10,0,439,8,854,407,280,159,3,8348,0
21,"Harghita",84148,190,84148,,"CORBU",137,"Caminul Cultural Capu Corbului, Capu Corbului nr.109",406,214,204,10,0,208,6,434,220,95,113,3,8348,0
21,"Harghita",84148,190,84148,,"CORBU",138,"Caminul Cultural Corbu, Corbu nr.344",0,64,0,64,0,62,2,200,136,32,30,3,8348,1
21,"Harghita",84175,190,84175,,"CORUND",139,"Scoala generala Corund, Sat Corund nr.570, Aripa Stanga",1975,545,538,7,0,538,7,2109,1564,307,231,3,8351,0
21,"Harghita",84175,190,84175,,"CORUND",140,"Scoala generala Corund, Sat Corund nr.570, Aripa dreapta",2031,579,571,8,0,562,17,2168,1589,324,238,3,8351,0
21,"Harghita",84175,190,84175,,"CORUND",141,"Fostul sediu al primariei din satul Atia, Sat Atia nr.284",181,64,55,9,0,62,2,194,130,45,17,3,8351,0
21,"Harghita",84175,190,84175,,"CORUND",142,"Scoala generala Sat Fantana Brazilor nr.145",257,106,99,7,0,105,1,275,169,46,59,3,8351,0
21,"Harghita",84175,190,84175,,"CORUND",143,"Scoala generala, Sat Valea lui Pavel nr.154",297,86,74,12,0,83,3,318,232,32,51,3,8351,0
21,"Harghita",84175,190,84175,,"CORUND",144,"Scoala Generala Corund, Corund nr.570",0,38,0,38,0,38,0,200,162,26,12,3,8351,1
21,"Harghita",86446,190,86446,,"COZMENI",145,"Caminul cultural Cozmeni, Sat Cozmeni nr.200",1107,430,419,11,0,414,16,1182,752,219,195,3,8357,0
21,"Harghita",86446,190,86446,,"COZMENI",146,"Casa Udvari, Sat Lazaresti nr.4",507,138,132,6,0,133,5,542,404,55,78,3,8357,0
21,"Harghita",86446,190,86446,,"COZMENI",147,"Primaria Comunei Cozmeni, Cozmeni nr.200",0,17,0,17,0,17,0,200,183,12,5,3,8357,1
21,"Harghita",84237,190,84237,,"DANESTI",148,"Caminul Cultural Danesti, Com. Danesti nr.32",1896,574,567,7,0,564,10,2024,1450,321,243,3,8360,0
21,"Harghita",84237,190,84237,,"DANESTI",149,"Caminul Cultural Danesti, Danesti str.Principala nr.32",0,34,0,34,0,34,0,200,166,20,14,3,8360,1
21,"Harghita",84264,190,84264,,"DEALU",150,"Casa comunala Sat Dealu nr.95 (Vechea casa comunala)",1507,530,523,7,0,526,4,1609,1079,270,256,3,8365,0
21,"Harghita",84264,190,84264,,"DEALU",151,"Caminul cultural Sincrai, Sat Sincrai nr.41",1036,364,355,9,0,352,12,1106,742,265,87,3,8365,0
21,"Harghita",84264,190,84264,,"DEALU",152,"Casa comunala Ulcani, Sat Ulcani nr.18",515,162,150,12,0,159,3,550,388,79,80,3,8365,0
21,"Harghita",84264,190,84264,,"DEALU",153,"Primaria Comunei Dealu, Dealu nr.601",0,18,0,18,0,18,0,200,182,9,9,3,8365,1
21,"Harghita",84344,190,84344,,"DITRAU",154,"Scoala Generala nr. 5 ""Siklodi Lorinc"" clasele I - IV, Sat Ditrau, str. Libertatii, nr. 3",1624,497,490,7,0,490,7,1734,1237,250,240,3,8373,0
21,"Harghita",84344,190,84344,,"DITRAU",155,"Scoala Generala nr. 3, Sat Ditrau, str. Puskas Tivadar nr. 101",878,242,225,17,0,238,4,938,696,124,114,3,8373,0
21,"Harghita",84344,190,84344,,"DITRAU",156,"Scoala generala ""Csiby Andor"" Clasele I-V ""Kohid"", Sat Ditrau, str.Nicolae Balcescu nr. 80",971,251,243,8,0,248,3,1037,786,139,109,3,8373,0
21,"Harghita",84344,190,84344,,"DITRAU",157,"Scoala generala nr.1 ""Csiby Andor"" Clasele V-VIII, Sat Ditrau, str. Nicolae Balcescu nr. 127",902,254,245,9,0,244,10,963,709,107,137,3,8373,0
21,"Harghita",84344,190,84344,,"DITRAU",158,"Scoala generala nr. 2 Jolotca, Sat Jolotca",506,154,148,6,0,150,4,541,387,61,89,3,8373,0
21,"Harghita",84344,190,84344,,"DITRAU",159,"Scoala Generala nr.5 ""Siklodi Lorinc"" Ditrau, Ditrau, str.Libertatii nr.4",0,28,0,28,0,28,0,200,172,19,9,3,8373,1
21,"Harghita",84380,190,84380,,"DARJIU",160,"Caminul Cultural Darjiu, Sat Darjiu nr. 185",581,183,180,3,0,182,1,621,438,104,78,3,8362,0
21,"Harghita",84380,190,84380,,"DARJIU",161,"Caminul cultural Mujna, Sat Mujna nr. 140",311,141,136,5,0,138,3,332,191,68,70,3,8362,0
21,"Harghita",84380,190,84380,,"DARJIU",162,"Caminul Cultural Dirjiu, Dirjiu nr.184",0,20,0,20,0,19,1,200,180,12,7,3,8362,1
21,"Harghita",83197,190,83197,,"FELICENI",163,"Scoala generala clase I-VIII ""Fulop Aron"", Sat Feliceni nr.9, Sala de clasa",850,291,285,6,0,284,7,908,617,181,103,3,8377,0
21,"Harghita",83197,190,83197,,"FELICENI",164,"Scoala generala cu clasele I - IV, Sat Taureni nr.5, Sala de clasa",573,185,178,7,0,184,1,612,427,129,55,3,8377,0
21,"Harghita",83197,190,83197,,"FELICENI",165,"Clubul Caminul cultural Hoghia, Sat Hoghia nr.75",229,87,79,8,0,86,1,245,158,43,43,3,8377,0
21,"Harghita",83197,190,83197,,"FELICENI",166,"Scoala generala clase I - IV, Sat Forteni nr.168, Sala de clasa",433,160,152,8,0,160,0,463,303,55,105,3,8377,0
21,"Harghita",83197,190,83197,,"FELICENI",167,"Scoala generala I-IV, Sat Polonita nr.121, Sala de Clasa",247,135,127,8,0,131,4,264,129,62,69,3,8377,0
21,"Harghita",83197,190,83197,,"FELICENI",168,"Scoala generala cu clasele I - IV, Sat Teleac nr.93, Sala de clasa",202,104,97,7,0,101,3,216,112,46,55,3,8377,0
21,"Harghita",83197,190,83197,,"FELICENI",169,"Scoala Generala ""Fulop Aron"" Feliceni, Feliceni, str.Principala nr.9",0,18,0,18,0,18,0,200,182,12,6,3,8377,1
21,"Harghita",84415,190,84415,,"FRUMOASA",170,"Caminul cultural Frumoasa, Sat Frumoasa, Str. Bisericii nr.212",1490,373,372,1,0,366,7,1591,1218,150,216,3,8389,0
21,"Harghita",84415,190,84415,,"FRUMOASA",171,"Scoala generala nr. 2 Nicolesti, Sat Nicolesti, nr.156",924,249,246,3,0,247,2,987,738,139,108,3,8389,0
21,"Harghita",84415,190,84415,,"FRUMOASA",172,"Caminul Cultural Barzava, Sat Barzava nr.111",538,197,191,6,0,197,0,575,378,54,143,3,8389,0
21,"Harghita",84415,190,84415,,"FRUMOASA",173,"Caminul Cultural Frumoasa, Frumoasa, str.Bisericii nr.212",0,34,0,34,0,34,0,200,166,13,21,3,8389,1
21,"Harghita",84460,190,84460,,"GALAUTAS",174,"Scoala generala nr.1 ""Dumitru Gafton"", Sat Galautas nr. 124",1837,761,743,4,14,754,7,1961,1200,431,323,3,8394,0
21,"Harghita",84460,190,84460,,"GALAUTAS",175,"Scoala Generala nr.2, Sat Galautas - Pirau nr. 324",275,157,148,8,1,157,0,294,137,110,47,3,8394,0
21,"Harghita",84460,190,84460,,"GALAUTAS",176,"Primaria Comunei Galautas, Galautas nr.1",0,38,0,38,0,38,0,200,162,21,17,3,8394,1
21,"Harghita",84558,190,84558,,"JOSENI",177,"Grup Scolar ""Sover Elek"" Joseni, Sat Joseni Nr. 627, Cladirea cabinetelor",1395,398,395,0,3,395,3,1489,1091,244,151,3,8403,0
21,"Harghita",84558,190,84558,,"JOSENI",178,"Grup Scolar ""Sover Elek"" Joseni, Sat Joseni nr. 627, Cladirea bibliotecii",1399,390,382,8,0,385,5,1494,1104,262,123,3,8403,0
21,"Harghita",84558,190,84558,,"JOSENI",179,"Scoala generala ""Veres"" Joseni, Sat Joseni nr. 110",1395,416,403,12,1,411,5,1489,1073,259,152,3,8403,0
21,"Harghita",84558,190,84558,,"JOSENI",180,"Scoala generala ""Gall Tamas"" Borzont, Sat Borzont nr.75",662,252,243,9,0,249,3,707,455,192,57,3,8403,0
21,"Harghita",84558,190,84558,,"JOSENI",181,"Primaria Comunei Joseni, Joseni nr.666",0,42,0,42,0,41,1,200,158,20,21,3,8403,1
21,"Harghita",84594,190,84594,,"LAZAREA",182,"Scoala generala nr. 2 ""Felszeg"", Sat Lazarea nr. 275",1091,237,232,5,0,234,3,1165,928,88,146,3,8407,0
21,"Harghita",84594,190,84594,,"LAZAREA",183,"Scoala generala nr. 1 ""Bethlen Gabor"", Sat Lazarea nr. 696 - 697",850,227,221,6,0,223,4,908,681,100,123,3,8407,0
21,"Harghita",84594,190,84594,,"LAZAREA",184,"Scoala generala nr. 3 ""Alszeg"", Sat Lazarea nr. 1049",929,213,205,8,0,207,6,992,779,98,109,3,8407,0
21,"Harghita",84594,190,84594,,"LAZAREA",185,"Scoala generala nr. 4 Ghidut, Com. Ghidut nr.1459",135,77,64,13,0,77,0,145,68,40,37,3,8407,0
21,"Harghita",84594,190,84594,,"LAZAREA",186,"Primaria Comunei Lazarea, Lazarea nr.702",0,10,0,10,0,10,0,200,190,5,5,3,8407,1
21,"Harghita",86479,190,86479,,"LELICENI",187,"Scoala generala Leliceni, Sat Leliceni nr.54",267,112,103,9,0,109,3,285,173,57,52,3,8410,0
21,"Harghita",86479,190,86479,,"LELICENI",188,"Sediul administrativ din Misentea, Sat Misentea nr.116",824,240,234,6,0,235,5,880,640,127,108,3,8410,0
21,"Harghita",86479,190,86479,,"LELICENI",189,"Caminul Cultural Fitod, Sat Fitod nr.81",380,155,149,6,0,154,1,406,251,87,67,3,8410,0
21,"Harghita",86479,190,86479,,"LELICENI",190,"Sala de Sport Misentea, Misentea nr.168/A",0,18,0,18,0,18,0,200,182,7,11,3,8410,1
21,"Harghita",84629,190,84629,,"LUETA",191,"Sediul Primariei Lueta nr.397",1562,308,302,6,0,306,2,1668,1360,191,115,3,8415,0
21,"Harghita",84629,190,84629,,"LUETA",192,"Caminul cultural Lueta, Lueta nr.963",1518,341,340,1,0,336,5,1621,1280,216,120,3,8415,0
21,"Harghita",84629,190,84629,,"LUETA",193,"Caminul Cultural Lueta, Lueta nr.963",0,24,0,24,0,24,0,200,176,12,12,3,8415,1
21,"Harghita",84656,190,84656,,"LUNCA DE JOS",194,"Primaria Lunca de Jos, Sat Lunca de Jos nr.647, Sala de sedinta",667,250,241,9,0,246,4,712,462,143,103,3,8418,0
21,"Harghita",84656,190,84656,,"LUNCA DE JOS",195,"Scoala generala nr.1 ""Majlath Gusztav Karoly"", Sat Lunca de Jos nr.493",1421,472,470,2,0,468,4,1517,1045,287,181,3,8418,0
21,"Harghita",84656,190,84656,,"LUNCA DE JOS",196,"Scoala Generala nr.8, Sat Valea Rece nr.892",851,565,558,7,0,561,4,909,344,124,437,3,8418,0
21,"Harghita",84656,190,84656,,"LUNCA DE JOS",197,"Camin Cultural, Sat Valea Rece nr.1297, Sala mica",1214,622,619,3,0,612,10,1296,674,158,454,3,8418,0
21,"Harghita",84656,190,84656,,"LUNCA DE JOS",198,"Scoala generala Puntea Lupului, Sat Puntea Lupului nr.1679/A",106,99,89,10,0,95,4,114,15,27,68,3,8418,0
21,"Harghita",84656,190,84656,,"LUNCA DE JOS",199,"Primaria Comunei Lunca de Jos, Lunca de Jos nr.647",0,22,0,22,0,21,1,200,178,12,9,3,8418,1
21,"Harghita",84754,190,84754,,"LUNCA DE SUS",200,"Primaria com. Lunca de Sus, Sat Lunca de Sus nr. 537",1382,541,541,0,0,524,17,1476,935,296,228,3,8428,0
21,"Harghita",84754,190,84754,,"LUNCA DE SUS",201,"Scoala Generala Izvorul Trotusului, Sat Izvorul-Trotusului nr. 246/C",543,210,204,6,0,202,8,580,370,94,108,3,8428,0
21,"Harghita",84754,190,84754,,"LUNCA DE SUS",202,"Scoala Generala, Sat Comiat nr. 23",283,105,98,7,0,104,1,303,198,69,35,3,8428,0
21,"Harghita",84754,190,84754,,"LUNCA DE SUS",203,"Scoala Generala Paltinis-Ciuc, Sat Paltinis-Ciuc nr. 1040/B",458,227,211,16,0,226,1,489,262,167,59,3,8428,0
21,"Harghita",84754,190,84754,,"LUNCA DE SUS",204,"Primaria Comunei Lunca de Sus, Lunca de Sus nr.537",0,31,0,31,0,31,0,300,269,13,18,3,8428,1
21,"Harghita",84825,190,84825,,"LUPENI",205,"Scoala generala ""Tamasi Aron"" clase I-VIII, Sat Lupeni nr. 579",1523,493,489,4,0,490,3,1626,1133,331,159,3,8435,0
21,"Harghita",84825,190,84825,,"LUPENI",206,"Scoala generala ""Benedek Fidel"" clase I-VIII, Sat Bisericani nr.166",580,223,215,8,0,219,4,620,397,165,54,3,8435,0
21,"Harghita",84825,190,84825,,"LUPENI",207,"Scoala generala clase I-IV, Sat Bulgareni nr.25",217,89,79,10,0,87,2,232,143,61,26,3,8435,0
21,"Harghita",84825,190,84825,,"LUPENI",208,"Casa de cultura Morareni, Sat Morareni nr.222",632,248,242,6,0,243,5,675,427,186,57,3,8435,0
21,"Harghita",84825,190,84825,,"LUPENI",209,"Casa de cultura Paltinis, Sat Paltinis nr.107",428,125,117,8,0,125,0,457,332,98,27,3,8435,0
21,"Harghita",84825,190,84825,,"LUPENI",210,"Scoala generala Pauleni, Sat Pauleni nr.15",315,93,85,8,0,90,3,337,244,60,30,3,8435,0
21,"Harghita",84825,190,84825,,"LUPENI",211,"Scoala Generala ""Tamasi Aron"" Lupeni, Lupeni, str.Principala nr.579",0,20,0,20,0,20,0,200,180,13,7,3,8435,1
21,"Harghita",86438,190,86438,,"MADARAS",212,"Scoala generala ""Kiss Ferenc"", Com. Madaras nr. 45",1823,532,525,7,0,517,15,1946,1414,274,243,3,8445,0
21,"Harghita",86438,190,86438,,"MADARAS",213,"Scoala Generala ""Kiss Ferencz"" Madaras, Madaras nr.45",0,23,0,23,0,22,1,200,177,11,11,3,8445,1
21,"Harghita",84923,190,84923,,"MARTINIS",214,"Clubul pensionarilor, Sat Martinis nr. 82",480,146,137,9,0,139,7,513,367,70,69,3,8447,0
21,"Harghita",84923,190,84923,,"MARTINIS",215,"Scoala generala nr.2 Aldea, Sat Aldea nr. 144",308,132,123,9,0,128,4,329,197,101,27,3,8447,0
21,"Harghita",84923,190,84923,,"MARTINIS",216,"Scoala generala Badeni, Sat Badeni nr. 18",171,60,53,7,0,59,1,183,123,31,28,3,8447,0
21,"Harghita",84923,190,84923,,"MARTINIS",217,"Scoala generala Ghipes, Sat Ghipes nr. 124",105,30,23,7,0,30,0,113,83,21,9,3,8447,0
21,"Harghita",84923,190,84923,,"MARTINIS",218,"Scoala generala Sanpaul, Sat Sanpaul nr. 126",415,149,144,5,0,148,1,443,294,81,67,3,8447,0
21,"Harghita",84923,190,84923,,"MARTINIS",219,"Gradinita de copii Oraseni, Sat Oraseni nr.60",225,99,94,5,0,99,0,241,142,39,60,3,8447,0
21,"Harghita",84923,190,84923,,"MARTINIS",220,"Scoala generala Petreni, Sat Petreni nr.26",171,68,63,5,0,68,0,183,115,26,42,3,8447,0
21,"Harghita",84923,190,84923,,"MARTINIS",221,"Scoala generala Rares, Sat Raresnr. 65",109,48,39,9,0,48,0,117,69,37,11,3,8447,0
21,"Harghita",84923,190,84923,,"MARTINIS",222,"Scoala generala Comanesti, Sat Comanesti nr. 131",165,73,63,10,0,73,0,177,104,55,18,3,8447,0
21,"Harghita",84923,190,84923,,"MARTINIS",223,"Scoala generala Calugareni, Sat Calugareni nr. 14",53,32,24,8,0,32,0,57,25,16,16,3,8447,0
21,"Harghita",84923,190,84923,,"MARTINIS",224,"Scoala Generala Chinusu, Sat Chinusu nr. 8",123,33,24,9,0,31,2,132,99,19,12,3,8447,0
21,"Harghita",84923,190,84923,,"MARTINIS",225,"Gradinita de copii Locodeni, Sat Locodeni nr.34",67,22,12,10,0,22,0,72,50,15,7,3,8447,0
21,"Harghita",84923,190,84923,,"MARTINIS",226,"Clubul Tineretului Martinis, Martinis nr.81",0,36,0,36,0,33,3,200,164,21,12,3,8447,1
21,"Harghita",85056,190,85056,,"MERESTI",227,"Primaria comunei Meresti, Meresti Str. Principala nr.144",1130,374,368,6,0,363,11,1207,833,214,149,3,8460,0
21,"Harghita",85056,190,85056,,"MERESTI",228,"Primaria Comunei Meresti, Meresti nr.144",0,38,0,38,0,38,0,200,162,20,18,3,8460,1
21,"Harghita",85074,190,85074,,"MIHAILENI",229,"Scoala ""Arany Janos"", Sat Mihaileni nr.174",789,198,191,7,0,195,3,843,645,115,80,3,8462,0
21,"Harghita",85074,190,85074,,"MIHAILENI",230,"Scoala Generala Livezi, Sat Livezi nr.29",437,151,143,8,0,151,0,467,316,55,96,3,8462,0
21,"Harghita",85074,190,85074,,"MIHAILENI",231,"Scoala Primara Nadejdea, Sat Nadejdea nr.117",506,129,120,9,0,128,1,541,412,70,58,3,8462,0
21,"Harghita",85074,190,85074,,"MIHAILENI",232,"Scoala Primara Vacaresti, Sat Vacaresti nr.61",469,194,186,8,0,193,1,501,307,99,94,3,8462,0
21,"Harghita",85074,190,85074,,"MIHAILENI",233,"Scoala Generala ""Arany Janos"" Mihaileni, Mihaileni nr.174",0,15,0,15,0,15,0,200,185,7,8,3,8462,1
21,"Harghita",85127,190,85127,,"MUGENI",234,"Primaria Comunei Mugeni, Sat Mugeni nr.150, Sala de sedinta",868,278,275,3,0,276,2,927,649,209,67,3,8467,0
21,"Harghita",85127,190,85127,,"MUGENI",235,"Clubul Caminului Cultural Lutita, Lutita nr.194",622,216,208,8,0,213,3,664,448,121,92,3,8467,0
21,"Harghita",85127,190,85127,,"MUGENI",236,"Clubul Caminului Cultural Matiseni, Sat Matiseni nr.10",110,56,48,8,0,56,0,118,62,33,23,3,8467,0
21,"Harghita",85127,190,85127,,"MUGENI",237,"Caminului Cultural Dejutiu, Sat Dejutiu nr.51, Sala de clasa",155,76,69,7,0,73,3,166,90,54,19,3,8467,0
21,"Harghita",85127,190,85127,,"MUGENI",238,"Scoala generala Alunis, Sat Alunis nr. 78, Sala de clasa",116,63,54,9,0,59,4,124,61,33,26,3,8467,0
21,"Harghita",85127,190,85127,,"MUGENI",239,"Clubul Caminului Cultural Dobeni, Sat Dobeni nr. 69",462,210,202,8,0,209,1,494,284,87,122,3,8467,0
21,"Harghita",85127,190,85127,,"MUGENI",240,"Clubul Caminul Cultural Taietura, Sat Taietura nr.34",234,88,80,8,0,88,0,250,162,36,52,3,8467,0
21,"Harghita",85127,190,85127,,"MUGENI",241,"Clubul Caminului cultural Beta, Sat Beta nr.33",272,114,108,6,0,110,4,291,177,64,46,3,8467,0
21,"Harghita",85127,190,85127,,"MUGENI",242,"Clubul din Caminul Cultural Mugeni, Mugeni nr.308/A",0,33,0,33,0,33,0,200,167,21,12,3,8467,1
21,"Harghita",85243,190,85243,,"OCLAND",243,"Primaria comunei Ocland, Sat Ocland, str. Principala nr.174",359,108,103,5,0,107,1,384,276,79,28,3,8476,0
21,"Harghita",85243,190,85243,,"OCLAND",244,"Caminul cultural Craciunel, Sat Craciunel, str. Principala nr. 58",369,130,124,6,0,117,13,394,264,62,55,3,8476,0
21,"Harghita",85243,190,85243,,"OCLAND",245,"Caminul cultural, Sat Satul Nou nr.29",255,131,128,3,0,130,1,273,142,76,54,3,8476,0
21,"Harghita",85243,190,85243,,"OCLAND",246,"Primaria Comunei Ocland, Ocland nr.174",0,16,0,16,0,16,0,200,184,13,3,3,8476,1
21,"Harghita",83375,190,83375,,"PAULENI-CIUC",247,"Caminul cultural Pauleni Ciuc, Sat Pauleni-Ciuc nr.64",494,126,119,5,2,120,6,528,402,65,55,3,8480,0
21,"Harghita",83375,190,83375,,"PAULENI-CIUC",248,"Scoala generala Delnita, Sat Delnita nr.184",504,155,149,6,0,145,10,538,383,58,87,3,8480,0
21,"Harghita",83375,190,83375,,"PAULENI-CIUC",249,"Scoala generala Soimeni, Sat Soimeni nr.10",438,131,126,5,0,128,3,468,337,71,57,3,8480,0
21,"Harghita",83375,190,83375,,"PAULENI-CIUC",250,"Camin Cultural Pauleni Ciuc, Pauleni Ciuc nr.65",0,20,0,20,0,17,3,200,180,10,7,3,8480,1
21,"Harghita",85289,190,85289,,"PLAIESII DE JOS",251,"Casa de cultura, Sat Plaiesii de Jos nr.105",696,227,225,2,0,224,3,743,516,138,86,3,8484,0
21,"Harghita",85289,190,85289,,"PLAIESII DE JOS",252,"Scoala Generala, Sat Plaiesii de Sus nr. 206",595,267,260,7,0,243,24,636,369,136,107,3,8484,0
21,"Harghita",85289,190,85289,,"PLAIESII DE JOS",253,"Scoala gen. Iacobeni, Sat Iacobeni nr. 331",307,112,103,9,0,110,2,328,216,60,50,3,8484,0
21,"Harghita",85289,190,85289,,"PLAIESII DE JOS",254,"Scoala generala Casinu Nou, Sat Casinu Nou nr.333",604,245,238,7,0,234,11,645,400,111,123,3,8484,0
21,"Harghita",85289,190,85289,,"PLAIESII DE JOS",255,"Casa de Cultura Plaiesii de Jos, Plaiesii de Jos nr.105",0,43,0,43,0,42,1,200,157,27,15,3,8484,1
21,"Harghita",86487,190,86487,,"PORUMBENI",256,"Caminul cultural, Sat Porumbenii Mari nr. 244/a",996,507,507,0,0,497,10,1064,557,229,268,3,8490,0
21,"Harghita",86487,190,86487,,"PORUMBENI",257,"Caminul cultural, Sat Porumbenii Mici nr.18",392,215,206,9,0,210,5,419,204,68,142,3,8490,0
21,"Harghita",86487,190,86487,,"PORUMBENI",258,"Primaria Comunei Porumbeni, Porumbenii Mari str.Principala nr.244/A",0,31,0,31,0,31,0,200,169,13,18,3,8490,1
21,"Harghita",85341,190,85341,,"PRAID",259,"Consiliului Local Praid, Sat Praid nr. 394, Sala de sedinte",1809,648,641,6,1,641,7,1931,1283,488,153,3,8493,0
21,"Harghita",85341,190,85341,,"PRAID",260,"Caminul cultural Praid, Sat Praid nr. 423",1107,475,460,15,0,458,17,1182,707,343,115,3,8493,0
21,"Harghita",85341,190,85341,,"PRAID",261,"Caminul cultural Ocna de Jos, Sat Ocna de Jos nr.540",1320,596,588,8,0,581,15,1409,813,409,172,3,8493,0
21,"Harghita",85341,190,85341,,"PRAID",262,"Scoala generala Ocna de Sus, Sat Ocna de Sus nr.264",1080,361,349,12,0,348,13,1153,792,211,137,3,8493,0
21,"Harghita",85341,190,85341,,"PRAID",263,"Scoala generala, Sat Becas nr.14",108,65,58,7,0,63,2,116,51,38,25,3,8493,0
21,"Harghita",85341,190,85341,,"PRAID",264,"Biroul Asociatiei ""Microregiunea Sovidek"", Praid, bloc.141, apt.3",0,48,0,48,0,47,1,400,352,25,22,3,8493,1
21,"Harghita",86495,190,86495,,"RACU",265,"Casa de cultura, Racu nr. 232",905,394,394,0,0,389,5,966,572,200,189,3,8500,0
21,"Harghita",86495,190,86495,,"RACU",266,"Gradinita de Copii, Satu Nou nr. 36",376,131,124,7,0,128,3,402,271,81,47,3,8500,0
21,"Harghita",86495,190,86495,,"RACU",267,"Casa de Cultura Racu, Racu nr.232",0,27,0,27,0,27,0,200,173,17,10,3,8500,1
21,"Harghita",85412,190,85412,,"REMETEA",268,"Gradinita de copii ""Alszeg"", Sat Remetea, str.Bethlen Gabor nr.31",1398,525,516,9,0,507,18,1493,968,207,300,3,8503,0
21,"Harghita",85412,190,85412,,"REMETEA",269,"Scoala generala ""Frater Gyorgy"", Sat Remetea, Piata Cseres Tibor nr.2",1425,585,578,7,0,560,25,1522,937,203,357,3,8503,0
21,"Harghita",85412,190,85412,,"REMETEA",270,"Gradinita de copii ""Tulamaros"", Sat Remetea, str.Borviz nr.8",1190,459,451,8,0,448,11,1271,812,153,295,3,8503,0
21,"Harghita",85412,190,85412,,"REMETEA",271,"Scoala generala ""Balas Jeno"", Sat Remertea, str.Csutakfalva nr.80",1126,464,456,8,0,445,19,1202,738,193,252,3,8503,0
21,"Harghita",85412,190,85412,,"REMETEA",272,"Casa Comunala Remetea, Remetea, P.ta Cseres Tibor nr.8",0,33,0,33,0,32,1,200,167,14,18,3,8503,1
21,"Harghita",86501,190,86501,,"SATU MARE",273,"Caminul cultural, Com. Satu Mare nr.450",1590,512,510,2,0,492,20,1698,1186,236,256,3,8534,0
21,"Harghita",86501,190,86501,,"SATU MARE",274,"Caminul Cultural, Satu Mare, Satu Mare nr.450",0,29,0,29,0,29,0,200,171,14,15,3,8534,1
21,"Harghita",85467,190,85467,,"SACEL",275,"Scoala Generala Sacel, Sat Sacel nr. 73",101,37,30,7,0,37,0,108,71,27,10,3,8508,0
21,"Harghita",85467,190,85467,,"SACEL",276,"Caminul Cultural Vidacut, Sat Vidacut nr. 114",252,91,87,4,0,85,6,269,178,62,23,3,8508,0
21,"Harghita",85467,190,85467,,"SACEL",277,"Caminul cultural Soimusu-Mic, Sat Soimusu Mic nr. 22",370,122,116,6,0,116,6,395,273,67,49,3,8508,0
21,"Harghita",85467,190,85467,,"SACEL",278,"Caminul cultural Soimusu-Mare, Sat Soimusu Mare nr. 51",285,114,107,7,0,112,2,305,191,64,48,3,8508,0
21,"Harghita",85467,190,85467,,"SACEL",279,"Scoala Generala Sacel, Sacel str.Principala nr.71",0,26,0,26,0,25,1,200,174,19,6,3,8508,1
21,"Harghita",85528,190,85528,,"SARMAS",280,"Scoala generala nr.4, Platonesti nr. 74/C",404,249,239,10,0,249,0,432,183,157,92,3,8528,0
21,"Harghita",85528,190,85528,,"SARMAS",281,"Scoala generala ""Sf. Andrei"", Sat Sarmas nr.598",1657,907,903,3,1,901,6,1769,862,625,276,3,8528,0
21,"Harghita",85528,190,85528,,"SARMAS",282,"Scoala generala Hodosa, Hodosa - gara nr. 1397",1280,639,631,8,0,635,4,1367,728,391,244,3,8528,0
21,"Harghita",85528,190,85528,,"SARMAS",283,"Scoala Generala ""Sfantu Andrei"" Sarmas, Sarmas str.Principala nr.598",0,48,0,48,0,48,0,200,152,26,22,3,8528,1
21,"Harghita",86519,190,86519,,"SANTIMBRU",284,"Scoala gen. cu clasele I - VIII ""Arany Janos"", Com. Santimbru nr. 539",1686,567,566,1,0,557,10,1800,1233,315,242,3,8525,0
21,"Harghita",86519,190,86519,,"SANTIMBRU",285,"Scoala Generala ""Arany Janos"" Santimbru, Santimbru nr.539",0,28,0,28,0,27,1,200,172,13,14,3,8525,1
21,"Harghita",85582,190,85582,,"SECUIENI",286,"Casa de cultura, Sat Secuieni nr. 49",598,238,230,8,0,236,2,639,401,147,89,3,8536,0
21,"Harghita",85582,190,85582,,"SECUIENI",287,"Biroul administrativ, Sat Bodogaia nr.172",668,214,209,5,0,212,2,714,500,150,62,3,8536,0
21,"Harghita",85582,190,85582,,"SECUIENI",288,"Caminul cultural Eliseni, Sat Eliseni nr.217",914,290,287,3,0,282,8,976,686,218,64,3,8536,0
21,"Harghita",85582,190,85582,,"SECUIENI",289,"Primaria Comunei Secuieni, Secuieni nr.224",0,25,0,25,0,25,0,200,175,13,12,3,8536,1
21,"Harghita",85626,190,85626,,"SICULENI",290,"Primari comunei Siculeni, Com. Siculeni, nr. 106",910,350,338,12,0,344,6,972,622,134,210,3,8540,0
21,"Harghita",85626,190,85626,,"SICULENI",291,"Scoala generala ""Zold Peter"", Com Siculeni, nr. 225",1412,552,546,6,0,539,13,1508,956,146,393,3,8540,0
21,"Harghita",85626,190,85626,,"SICULENI",292,"Gara CFR din Siculeni, Siculeni nr.7",0,53,0,53,0,51,2,400,347,16,35,3,8540,1
21,"Harghita",85680,190,85680,,"SANCRAIENI",293,"Scoala generala ""Vitos Mozes"", Com. Sincraieni nr. 604",1171,433,422,11,0,421,12,1250,817,202,219,3,8514,0
21,"Harghita",85680,190,85680,,"SANCRAIENI",294,"Scoala generala ""Vitos Mozes"", Com. Sincraieni nr. 604",889,279,271,8,0,274,5,949,670,109,165,3,8514,0
21,"Harghita",85680,190,85680,,"SANCRAIENI",295,"Scoala Generala ""Vitos Mozes"" Sincraieni, Sincraieni nr.604",0,27,0,27,0,27,0,200,173,15,12,3,8514,1
21,"Harghita",85760,190,85760,,"SANDOMINIC",296,"Sediul Primariei Sandominic, Sindominic nr. 507",1522,393,385,8,0,389,4,1625,1232,206,183,3,8516,0
21,"Harghita",85760,190,85760,,"SANDOMINIC",297,"Sediul Primariei Sandominic, Sindominic nr. 507",1489,373,365,8,0,371,2,1590,1217,231,140,3,8516,0
21,"Harghita",85760,190,85760,,"SANDOMINIC",298,"Scoala generala ""Marton Aron"", Sindominic",1148,299,293,6,0,294,5,1226,927,161,133,3,8516,0
21,"Harghita",85760,190,85760,,"SANDOMINIC",299,"Scoala generala ""Marton Aron"", Sindominic",1099,283,272,11,0,280,3,1174,891,163,117,3,8516,0
21,"Harghita",85760,190,85760,,"SANDOMINIC",300,"Primaria Comunei Sindominic, Sindominic str.Principala nr.507",0,17,0,17,0,17,0,200,183,8,9,3,8516,1
21,"Harghita",85788,190,85788,,"SANMARTIN",301,"Primaria comunei Sinmartin, Sat Sinmartin, str. Principala nr. 40",1766,517,507,10,0,499,18,1885,1368,223,276,3,8518,0
21,"Harghita",85788,190,85788,,"SANMARTIN",302,"Primaria Comunei Sinmartin, Sinmartin nr.40",0,18,0,18,0,16,2,200,182,9,7,3,8518,1
21,"Harghita",85840,190,85840,,"SANSIMION",303,"Caminul cultural Sinsimion, Sat Sansimion nr.110",961,316,310,6,0,308,8,1026,710,124,184,3,8522,0
21,"Harghita",85840,190,85840,,"SANSIMION",304,"Caminul cultural Sinsimion, Sat Sinsimion nr.110",985,332,326,6,0,328,4,1052,720,190,138,3,8522,0
21,"Harghita",85840,190,85840,,"SANSIMION",305,"Caminul cultural Cetatuia, Sat Cetatuia nr.65",785,331,319,11,1,313,18,838,507,152,161,3,8522,0
21,"Harghita",85840,190,85840,,"SANSIMION",306,"Caminul Cultural Sinsimion, Sinsimion nr.110",0,28,0,28,0,28,0,200,172,17,11,3,8522,1
21,"Harghita",85877,190,85877,,"SUBCETATE",307,"Caminul Cultural Subcetate, Sat Subcetate, str. Protopop Vasile Urzica nr.1",1655,852,846,6,0,848,4,1767,915,521,327,3,8557,0
21,"Harghita",85877,190,85877,,"SUBCETATE",308,"Clubul Caminului Cultural Subcetare, Subcetate, str.Protopop Vasile Urzica nr.1",0,58,0,58,0,58,0,200,142,39,19,3,8557,1
21,"Harghita",85920,190,85920,,"SUSENI",309,"Primariei comunei Suseni, Sat Suseni nr.212",1730,474,466,8,0,469,5,1847,1373,213,256,3,8562,0
21,"Harghita",85920,190,85920,,"SUSENI",310,"Scoala generala Mures sat, Sat Suseni nr.332",742,261,251,10,0,248,13,792,531,76,172,3,8562,0
21,"Harghita",85920,190,85920,,"SUSENI",311,"Scoala generala, Sat Chileni nr.206",658,195,187,8,0,189,6,703,508,63,126,3,8562,0
21,"Harghita",85920,190,85920,,"SUSENI",312,"Scoala generala, Sat Valea Stramba nr.291",1143,291,282,9,0,281,10,1221,930,177,104,3,8562,0
21,"Harghita",85920,190,85920,,"SUSENI",313,"Scoala generala, Sat Liban nr.11",56,23,13,10,0,23,0,60,37,12,11,3,8562,0
21,"Harghita",85920,190,85920,,"SUSENI",314,"Primaria Comunei Suseni, Suseni nr.212",0,25,0,25,0,24,1,200,175,10,14,3,8562,1
21,"Harghita",85984,190,85984,,"SIMONESTI",315,"Caminul cultural Ruganesti, Sat Ruganesti str. Principala nr. 40",662,211,207,4,0,207,4,707,496,120,87,3,8542,0
21,"Harghita",85984,190,85984,,"SIMONESTI",316,"Primaria Simonesti, Sat Simonesti str. Morii nr. 249",1041,302,296,6,0,298,4,1112,810,205,93,3,8542,0
21,"Harghita",85984,190,85984,,"SIMONESTI",317,"Scoala Generala Medisoru Mare, Sat Medisoru Mare str. Principala nr. 93",122,55,48,7,0,53,2,131,76,22,31,3,8542,0
21,"Harghita",85984,190,85984,,"SIMONESTI",318,"Caminul cultural Cobatesti, Sat Cobatesti str. Prinicipala nr. 77",452,210,205,5,0,210,0,483,273,166,44,3,8542,0
21,"Harghita",85984,190,85984,,"SIMONESTI",319,"Caminul cultural Cehetel, Sat Cehetel str. Prinicipala nr. 88",116,55,48,7,0,53,2,124,69,27,26,3,8542,0
21,"Harghita",85984,190,85984,,"SIMONESTI",320,"Caminul cultural Turdeni, Sat Turdeni str. Prinicipala nr. 86",73,49,41,8,0,49,0,78,29,44,5,3,8542,0
21,"Harghita",85984,190,85984,,"SIMONESTI",321,"Caminul cultural Tarcesti, Sat Tarcesti str. Prinicipala nr. 59",165,79,74,5,0,79,0,177,98,71,8,3,8542,0
21,"Harghita",85984,190,85984,,"SIMONESTI",322,"Caminul cultural Mihaileni, Sat Mihaileni str. Prinicipala nr.3",468,240,235,5,0,238,2,500,260,177,61,3,8542,0
21,"Harghita",85984,190,85984,,"SIMONESTI",323,"Primaria Comunei Simonesti, Simonesti str.Morii nr.249",0,27,0,27,0,27,0,200,173,15,12,3,8542,1
21,"Harghita",86453,190,86453,,"TOMESTI",324,"Cladirea salii de sport, Centrul comunei Tomesti",2127,574,570,4,0,568,6,2071,1497,334,234,3,8568,0
21,"Harghita",86453,190,86453,,"TOMESTI",325,"Sala de Sport Tomesti, Tomesti",0,14,0,14,0,14,0,200,186,8,6,3,8568,1
21,"Harghita",86133,190,86133,,"TULGHES",326,"Scoala generala nr.1, Sat Tulghes Centru nr.338",1409,608,605,3,0,607,1,1505,897,349,258,3,8570,0
21,"Harghita",86133,190,86133,,"TULGHES",327,"Scoala generala nr.4, Sat Tulghes Putna nr.42/a",493,264,253,11,0,263,1,527,263,142,121,3,8570,0
21,"Harghita",86133,190,86133,,"TULGHES",328,"Scoala primara nr.3, Sat Recea nr.14",193,73,65,8,0,70,3,207,134,40,30,3,8570,0
21,"Harghita",86133,190,86133,,"TULGHES",329,"Scoala primara nr.5, Sat Tulghes, Valea Frumoasa nr. 851",564,237,224,13,0,235,2,602,365,128,107,3,8570,0
21,"Harghita",86133,190,86133,,"TULGHES",330,"Caminul Cultural Tulghes, Tulghes nr.418",0,144,0,144,0,141,3,400,256,83,58,3,8570,1
21,"Harghita",86188,190,86188,,"TUSNAD",331,"Primaria comunei Tusnad, Sat Tusnad nr.176",753,272,262,10,0,269,3,804,532,119,150,3,8575,0
21,"Harghita",86188,190,86188,,"TUSNAD",332,"Caminul cultural, Sat Tusnad Nou nr.573",792,308,280,28,0,298,10,846,538,185,113,3,8575,0
21,"Harghita",86188,190,86188,,"TUSNAD",333,"Caminul Cultural, Sat Vrabia nr. 6",179,97,88,9,0,95,2,192,95,32,63,3,8575,0
21,"Harghita",86188,190,86188,,"TUSNAD",334,"Primaria Comunei Tusnad, Tusnad nr.176",0,21,0,21,0,20,1,200,179,8,12,3,8575,1
21,"Harghita",86222,190,86222,,"ULIES",335,"Caminul cultural Ulies, Sat Ulies nr.53",294,103,100,3,0,102,1,314,211,44,58,3,8579,0
21,"Harghita",86222,190,86222,,"ULIES",336,"Caminul cultural Petecu, Sat Petecu nr.194",214,85,81,4,0,77,8,229,144,40,37,3,8579,0
21,"Harghita",86222,190,86222,,"ULIES",337,"Caminul cultural Ighiu, Sat Ighiu nr.61",40,29,22,7,0,29,0,43,14,14,15,3,8579,0
21,"Harghita",86222,190,86222,,"ULIES",338,"Scoala generala Daia, Sat Daia nr.168",207,43,39,4,0,42,1,221,178,25,17,3,8579,0
21,"Harghita",86222,190,86222,,"ULIES",339,"Casa comunala, Sat Nicolesti nr.23",168,36,28,8,0,36,0,180,144,13,23,3,8579,0
21,"Harghita",86222,190,86222,,"ULIES",340,"Caminul Cultural Ulies, Ulies str.Principala nr.53",0,11,0,11,0,11,0,200,189,6,5,3,8579,1
21,"Harghita",86311,190,86311,,"VARSAG",341,"Caminul cultural din comuna Varsag, Com. Varsag nr. 385",1000,345,340,2,3,335,10,1068,723,160,175,3,8588,0
21,"Harghita",86311,190,86311,,"VARSAG",342,"Scoala Generala ""Solyomko"", Com. Varsag nr.16",240,105,97,8,0,104,1,257,152,72,32,3,8588,0
21,"Harghita",86311,190,86311,,"VARSAG",343,"Primaria Comunei Varsag, Varsag nr.351",0,31,0,31,0,30,1,200,169,15,15,3,8588,1
21,"Harghita",86339,190,86339,,"VOSLABENI",344,"Scoala generala nr.1 ""Teodor Chindea"", Sat Voslabeni nr.386",989,390,385,5,0,388,2,1056,666,204,184,3,8590,0
21,"Harghita",86339,190,86339,,"VOSLABENI",345,"Scoala generala ""Ion Creanga"", Sat Izvoru Muresului nr. 582",625,291,286,5,0,286,5,668,377,134,152,3,8590,0
21,"Harghita",86339,190,86339,,"VOSLABENI",346,"Districtul CFR Izvorul Muresului, Izvorul Muresului nr.124",0,68,0,68,0,67,1,300,232,23,44,3,8590,1
21,"Harghita",86366,190,86366,,"ZETEA",347,"Primaria Zetea, Sat Zetea nr.271",1970,631,623,8,0,606,25,1903,1272,400,206,3,8593,0
21,"Harghita",86366,190,86366,,"ZETEA",348,"Scoala generala nr.7, Sat Zetea nr.378",1723,535,529,6,0,525,10,1840,1305,346,179,3,8593,0
21,"Harghita",86366,190,86366,,"ZETEA",349,"Scoala generala ""Jokai Mor"", Sat Sub Cetate nr. 100",597,131,125,6,0,130,1,638,507,88,42,3,8593,0
21,"Harghita",86366,190,86366,,"ZETEA",350,"Caminul Cultural Sicasau, Sat Sicasau nr. 39",140,31,24,7,0,30,1,150,119,19,11,3,8593,0
21,"Harghita",86366,190,86366,,"ZETEA",351,"Scoala generala ""Szekely Janos"", Sat Izvoare 134",291,49,42,7,0,49,0,311,262,30,19,3,8593,0
21,"Harghita",86366,190,86366,,"ZETEA",352,"Primaria Comunei  Zetea, Zetea nr.272",0,28,0,28,0,28,0,232,204,14,14,3,8593,1
22,"Hunedoara",86687,207,86687,,"MUNICIPIUL DEVA",1,"Casa de Cultura, Piata Victoriei nr.4, sala mica",1587,1004,950,54,0,992,12,1750,746,367,625,1,8601,0
22,"Hunedoara",86687,207,86687,,"MUNICIPIUL DEVA",2,"Casa de Cultura, sala 4, etaj 2, Piata Victoriei nr.4",1379,798,772,26,0,791,7,1500,702,343,448,1,8601,0
22,"Hunedoara",86687,207,86687,,"MUNICIPIUL DEVA",3,"Casa de Cultura, Piata Victoriei nr.4, sala taraf",1567,856,840,16,0,845,11,1700,844,370,475,1,8601,0
22,"Hunedoara",86687,207,86687,,"MUNICIPIUL DEVA",4,"Gradinita nr.7, Aleea Patriei nr.6, sala 1",1303,786,769,17,0,775,11,1450,664,311,464,1,8601,0
22,"Hunedoara",86687,207,86687,,"MUNICIPIUL DEVA",5,"Liceul ""Sabin Dragoi"" (fostul Pedagogic), Str.Ghe.Baritiu nr.2, sala de sport",1236,757,743,14,0,740,17,1350,593,310,430,1,8601,0
22,"Hunedoara",86687,207,86687,,"MUNICIPIUL DEVA",6,"Casa de Cultura, Piata Victoriei nr.4, holul mare",1733,1014,990,24,0,999,15,1900,886,419,580,1,8601,0
22,"Hunedoara",86687,207,86687,,"MUNICIPIUL DEVA",7,"Cantina Restaurant, B-dul Decebal, Blocul M, parter, sala de mese",1472,838,827,10,1,827,11,1600,762,345,482,1,8601,0
22,"Hunedoara",86687,207,86687,,"MUNICIPIUL DEVA",8,"Galeria Forma, B-dul Decebal, bl.8, parter",1484,893,879,13,1,882,11,1650,757,340,542,1,8601,0
22,"Hunedoara",86687,207,86687,,"MUNICIPIUL DEVA",9,"Colegiul National  ""Decebal"", B-dul 1 Decembrie nr.1, sala 17",1370,807,793,13,1,798,9,1500,693,283,515,1,8601,0
22,"Hunedoara",86687,207,86687,,"MUNICIPIUL DEVA",10,"Colegiul National Sportiv Cetate Deva, Str.Axente Sever nr.3, sala profesorala",1485,899,885,14,0,889,10,1650,751,381,508,1,8601,0
22,"Hunedoara",86687,207,86687,,"MUNICIPIUL DEVA",11,"Scoala Primara  Viile Noi, Str.16 Februarie nr.1, cabinet limbi straine",1776,968,955,11,2,957,11,1950,982,478,479,1,8601,0
22,"Hunedoara",86687,207,86687,,"MUNICIPIUL DEVA",12,"Liceul de Muzica Si Arte Plastice ""Sigismund Toduta"" (fosta Scoala Generala  ""Lucian Blaga"" nr.2), str. Avram Iancu nr.2",1370,834,818,14,2,821,13,1498,664,333,488,1,8601,0
22,"Hunedoara",86687,207,86687,,"MUNICIPIUL DEVA",13,"Gara C.F.R., Piata Garii, sala de Sedinte, etaj 2",1856,1047,992,54,1,1036,11,2050,1003,456,580,1,8601,0
22,"Hunedoara",86687,207,86687,,"MUNICIPIUL DEVA",14,"Directia Silvica Deva, Str.M.Viteazu nr. 10, sala de Sedinta",1473,844,834,10,0,838,6,1600,756,320,518,1,8601,0
22,"Hunedoara",86687,207,86687,,"MUNICIPIUL DEVA",15,"Splitalul Judetean Deva, B-dul 22 Decembrie nr.58, hol central parter, pavilionul principal",1484,864,841,23,0,854,10,1650,786,334,520,1,8601,0
22,"Hunedoara",86687,207,86687,,"MUNICIPIUL DEVA",16,"Institutul Multimedia, Aleea Vitorului nr. 2 sala Jura, parter",1564,824,812,12,0,808,16,1700,876,393,415,1,8601,0
22,"Hunedoara",86687,207,86687,,"MUNICIPIUL DEVA",17,"Scoala Generala  ""Andrei Saguna"", corp Cladire nou, Aleea Viitorului nr.9, sala 9",1496,900,878,22,0,889,11,1650,750,386,503,1,8601,0
22,"Hunedoara",86687,207,86687,,"MUNICIPIUL DEVA",18,"Scoala Generala ""Andrei Saguna"", corp Cladire nou, Aleea Viitorului nr.9, sala 11",1357,756,747,9,0,743,13,1500,744,345,398,1,8601,0
22,"Hunedoara",86687,207,86687,,"MUNICIPIUL DEVA",19,"Scoala Generala ""Andrei Saguna"", corp Cladire nou, Aleea Viitorului nr.9, sala 13",1586,886,877,9,0,880,6,1750,864,356,524,1,8601,0
22,"Hunedoara",86687,207,86687,,"MUNICIPIUL DEVA",20,"Sala Sporturilor, Str.Marasti nr.30, corp B",1364,780,765,15,0,768,12,1500,720,333,435,1,8601,0
22,"Hunedoara",86687,207,86687,,"MUNICIPIUL DEVA",21,"Colegiul Tehnic ""Transilvania"", Bd. 22 Decembrie nr.116 parter, sala 5",1881,945,925,20,0,931,14,2050,1105,423,508,1,8601,0
22,"Hunedoara",86687,207,86687,,"MUNICIPIUL DEVA",22,"Liceul de muzica si arte plastice ""Sigismund Toduta"",  Str.Ciprian Porumbescu nr.1, sala 4",1356,786,779,7,0,768,18,1500,714,324,444,1,8601,0
22,"Hunedoara",86687,207,86687,,"MUNICIPIUL DEVA",23,"Colegiul Tehnic ""Transilvania"" (fosta Scoala Generala Eminescu Petofi), B-dul Dacia nr.8, sala 1",1716,932,911,21,0,922,10,1900,968,411,511,1,8601,0
22,"Hunedoara",86687,207,86687,,"MUNICIPIUL DEVA",24,"Colegiul Tehnic ""Transilvania"",  Bd. 22 Decembrie nr.116 parter, sala 6",1635,947,924,11,12,938,9,1800,853,413,525,1,8601,0
22,"Hunedoara",86687,207,86687,,"MUNICIPIUL DEVA",25,"Colegiul Tehnic ""Transivlania"", Bd. 22 Decembrie nr.116, cabinet franceza",1751,893,881,12,0,881,12,1951,1058,458,423,1,8601,0
22,"Hunedoara",86687,207,86687,,"MUNICIPIUL DEVA",26,"Club Scolar Sportiv, Str.Carpati nr.3, sala sport",1517,864,856,8,0,857,7,1700,836,373,484,1,8601,0
22,"Hunedoara",86687,207,86687,,"MUNICIPIUL DEVA",27,"Colegiul Tehnic ""Transilvania"" (fosta Scoala Generala Eminescu Petofi), B-dul Dacia nr.8, sala 2",1467,764,749,15,0,756,8,1600,836,337,419,1,8601,0
22,"Hunedoara",86687,207,86687,,"MUNICIPIUL DEVA",28,"Colegiul Tehnic ""Transivlania"" (fosta Scoala Generala Eminescu Petofi), B-dul Dacia nr.8, sala 7",1725,934,870,64,0,924,10,1900,966,418,506,1,8601,0
22,"Hunedoara",86687,207,86687,,"MUNICIPIUL DEVA",29,"Casa Maghiara Deva (fosta Casa Armatei), B-dul 22 Decembrie nr.164, sala mare",1965,1095,1082,13,0,1071,24,2050,955,481,590,1,8601,0
22,"Hunedoara",86687,207,86687,,"MUNICIPIUL DEVA",30,"Scoala Generala ""Octavian Goga"" (fosta Scoala Generala nr.6), Str. Bejan nr.8, sala P1",1533,682,666,15,1,674,8,1700,1018,394,280,1,8601,0
22,"Hunedoara",86687,207,86687,,"MUNICIPIUL DEVA",31,"Scoala Generala ""Octavian Goga"" (fosta Scoala Generala nr.6), Str.Bejan nr.8, sala P4",1291,596,582,14,0,584,12,1400,804,310,274,1,8601,0
22,"Hunedoara",86687,207,86687,,"MUNICIPIUL DEVA",32,"Scoala Generala ""Octavian Goga"" (fosta Scoala Generala nr.6), Str.Bejan nr.8, sala P5",1591,699,687,12,0,696,3,1750,1051,358,338,1,8601,0
22,"Hunedoara",86687,207,86687,,"MUNICIPIUL DEVA",33,"Gradinita P.N. nr.3, Aleea Teilor, sala de sport",1684,854,830,24,0,847,7,1850,996,414,433,1,8601,0
22,"Hunedoara",86687,207,86687,,"MUNICIPIUL DEVA",34,"Gradinita P.N. nr.3, Aleea Teilor, sala grupa mica",1694,861,849,12,0,849,12,1850,989,409,440,1,8601,0
22,"Hunedoara",86687,207,86687,,"MUNICIPIUL DEVA",35,"Grup Scolar ""Ioan Mincu"" (fostul Grup Scolar de Constructii), Str.Titu Maiorescu nr.30, cabinet instalatii",1638,888,870,18,0,874,14,1800,912,388,486,1,8601,0
22,"Hunedoara",86687,207,86687,,"MUNICIPIUL DEVA",36,"Grup Scolar ""Grigore Moisil"" (fostul Liceu Miner), Str.Titu Maiorescu nr.24, sala 6",1867,1044,1030,14,0,1028,16,2050,1006,410,618,1,8601,0
22,"Hunedoara",86687,207,86687,,"MUNICIPIUL DEVA",37,"Scoala Generala ""Andrei Muresanu"" (fosta Scoala Generala nr.5), Str.Scarisoara nr.4, sala 3",1817,951,939,12,0,942,9,2000,1049,393,549,1,8601,0
22,"Hunedoara",86687,207,86687,,"MUNICIPIUL DEVA",38,"Scoala Generala ""Andrei Muresanu"" (fosta Scoala Generala nr.5), Str.Scarisoara nr.4, sala 4",1737,878,866,12,0,870,8,1900,1022,415,455,1,8601,0
22,"Hunedoara",86687,207,86687,,"MUNICIPIUL DEVA",39,"Gradinita Cristur, Str. Ulita Mare, sala 1",1392,770,757,13,0,764,6,1550,780,346,418,1,8601,0
22,"Hunedoara",86687,207,86687,,"MUNICIPIUL DEVA",40,"Caminul Cultural Santuhalm, Str. Santuhalm",561,502,307,8,187,493,9,700,198,272,221,1,8601,0
22,"Hunedoara",86687,207,86687,,"MUNICIPIUL DEVA",41,"Autogara Deva, Piata Garii, CP 330058",0,1079,0,1079,0,1074,5,1300,221,586,488,1,8601,1
22,"Hunedoara",87291,207,87291,,"MUNICIPIUL BRAD",42,"Casa de Cultura Brad, Str. Independentei",996,571,565,6,0,567,4,1100,529,260,307,1,8611,0
22,"Hunedoara",87291,207,87291,,"MUNICIPIUL BRAD",43,"Casa de Cultura Brad, Str. Independentei",1113,627,619,8,0,624,3,1200,573,251,373,1,8611,0
22,"Hunedoara",87291,207,87291,,"MUNICIPIUL BRAD",44,"Scoala Generala ""Mircea Santimbreanu"" Brad, Str. Libertatii",1750,940,930,9,1,930,10,1950,1010,384,546,1,8611,0
22,"Hunedoara",87291,207,87291,,"MUNICIPIUL BRAD",45,"Scoala Generala ""Mircea Santimbreanu"" Brad, Str. Libertatii",1445,774,764,8,2,771,3,1600,826,350,421,1,8611,0
22,"Hunedoara",87291,207,87291,,"MUNICIPIUL BRAD",46,"Scoala Generala ""Mircea Santimbreanu"" Brad, Str. Victoriei",1374,732,726,6,0,729,3,1500,768,311,418,1,8611,0
22,"Hunedoara",87291,207,87291,,"MUNICIPIUL BRAD",47,"Scoala Generala ""Mircea Santimbreanu"" Brad, Str. Victoriei",1438,738,734,4,0,733,5,1600,862,320,413,1,8611,0
22,"Hunedoara",87291,207,87291,,"MUNICIPIUL BRAD",48,"Colegiul National ""Avram Iancu"", str. Liceului, Brad",997,509,500,8,1,501,8,1100,591,227,274,1,8611,0
22,"Hunedoara",87291,207,87291,,"MUNICIPIUL BRAD",49,"Colegiul National ""Avram Iancu"", str. Liceului, Brad",1204,642,636,6,0,638,4,1299,657,271,367,1,8611,0
22,"Hunedoara",87291,207,87291,,"MUNICIPIUL BRAD",50,"Caminul de Copii cu program prelungit Brad, Str. Horea",1249,684,671,13,0,677,7,1348,664,258,419,1,8611,0
22,"Hunedoara",87291,207,87291,,"MUNICIPIUL BRAD",51,"Scoala Generala ""Horea, Closca si Crisan"" Brad, Str. Liceului",1109,626,614,12,0,619,7,1196,570,263,356,1,8611,0
22,"Hunedoara",87291,207,87291,,"MUNICIPIUL BRAD",52,"Scoala Generala Valea Bradului",711,383,374,9,0,380,3,804,421,186,194,1,8611,0
22,"Hunedoara",87291,207,87291,,"MUNICIPIUL BRAD",53,"Scoala Generala Taratel",642,344,337,7,0,344,0,700,356,161,183,1,8611,0
22,"Hunedoara",87291,207,87291,,"MUNICIPIUL BRAD",54,"Scoala Generala Mesteacan",497,267,258,9,0,266,1,550,283,114,152,1,8611,0
22,"Hunedoara",87291,207,87291,,"MUNICIPIUL BRAD",55,"Caminul Cultural Ruda Brad",164,97,88,9,0,92,5,200,103,29,63,1,8611,0
22,"Hunedoara",87291,207,87291,,"MUNICIPIUL BRAD",56,"Casa Casatoriilor, str. Republicii nr. 18, CP 335200",0,235,0,235,0,234,1,273,38,121,113,1,8611,1
22,"Hunedoara",86810,207,86810,,"MUNICIPIUL HUNEDOARA",57,"Scoala Generala nr.12, Str. Prutului nr. 9, sala de clasa V-A",1560,752,741,11,0,736,16,1700,948,423,313,1,8618,0
22,"Hunedoara",86810,207,86810,,"MUNICIPIUL HUNEDOARA",58,"Scoala Generala nr.10, Str. Intrarea Spicului nr.6, sala de clasa I B",1436,722,711,11,0,712,10,1600,878,377,335,1,8618,0
22,"Hunedoara",86810,207,86810,,"MUNICIPIUL HUNEDOARA",59,"Scoala Generala nr.10, Str. Intrarea Spicului nr.6, sala de clasa VI B",1725,816,795,21,0,804,12,1900,1084,436,368,1,8618,0
22,"Hunedoara",86810,207,86810,,"MUNICIPIUL HUNEDOARA",60,"Scoala Generala nr.10, Str. Intrarea Spicului nr.6, sala de clasa VIII B",1303,660,647,13,0,651,9,1450,790,303,348,1,8618,0
22,"Hunedoara",86810,207,86810,,"MUNICIPIUL HUNEDOARA",61,"Scoala Generala nr.9, Str. Trandafirilor nr.10, sala de sport - Parter",1742,856,847,9,0,842,14,1900,1044,375,467,1,8618,0
22,"Hunedoara",86810,207,86810,,"MUNICIPIUL HUNEDOARA",62,"Scoala Generala nr.9 Str. Trandafirilor nr.10, sala de clasa nr.2 - parter",1518,688,683,5,0,680,8,1650,962,325,355,1,8618,0
22,"Hunedoara",86810,207,86810,,"MUNICIPIUL HUNEDOARA",63,"Scoala Generala nr.9, Str. Trandafirilor nr.10, sala de clasa nr.3 - parter",1591,813,787,26,0,803,10,1750,937,382,421,1,8618,0
22,"Hunedoara",86810,207,86810,,"MUNICIPIUL HUNEDOARA",64,"Scoala Generala nr.9, Str. Trandafirilor nr.10, sala de clasa nr.4 ? parter",1361,698,688,10,0,683,15,1500,802,292,391,1,8618,0
22,"Hunedoara",86810,207,86810,,"MUNICIPIUL HUNEDOARA",65,"Gradinita cu program normal Micro VII PN6, Str. Trandafirilor nr.18, Hol Intrarea Principala",1331,633,624,0,9,629,4,1450,817,309,320,1,8618,0
22,"Hunedoara",86810,207,86810,,"MUNICIPIUL HUNEDOARA",66,"Colegiul Economic ""Emanuil Gojdu"" (Liceul nr.2), Str. Al. Vlahuta nr.1 bis, sala de clasa nr.4 - parter",1449,830,818,11,1,813,17,1600,770,324,489,1,8618,0
22,"Hunedoara",86810,207,86810,,"MUNICIPIUL HUNEDOARA",67,"Grup Scolar de Telecomunicatii si Lucrari Publice (Liceul Industrial nr.3), Aleea Turnatorului nr.1 bis, sala de clasa n",1367,729,722,7,0,716,13,1500,771,321,395,1,8618,0
22,"Hunedoara",86810,207,86810,,"MUNICIPIUL HUNEDOARA",68,"Colegiul National de Informatica ""Traian Lalescu"" (Cladirea noua a liceului), Str. Victoriei nr.23, sala de clasa 7 - pa",1487,901,886,15,0,885,16,1648,747,323,562,1,8618,0
22,"Hunedoara",86810,207,86810,,"MUNICIPIUL HUNEDOARA",69,"Colegiul National de Informatica ""Traian Lalescu"" (Cladirea Scoala Generala nr.4), Str. Victoriei nr.23, sala de clasa 2",1156,734,724,9,1,719,15,1250,516,358,361,1,8618,0
22,"Hunedoara",86810,207,86810,,"MUNICIPIUL HUNEDOARA",70,"Colegiul National de Informatica ""Traian Lalescu"" (Cladirea Scoala Generala nr.4), Str. Victoriei nr.23, sala de clasa 3",1333,703,689,12,2,697,6,1450,747,306,391,1,8618,0
22,"Hunedoara",86810,207,86810,,"MUNICIPIUL HUNEDOARA",71,"Scoala Generala nr.5, B-dul Decebal nr.11, sala de sport nr.1 - parter",1691,897,885,12,0,883,14,1850,953,397,486,1,8618,0
22,"Hunedoara",86810,207,86810,,"MUNICIPIUL HUNEDOARA",72,"Scoala Generala nr.5, B-dul Decebal nr.11, sala de sport nr.2 - parter",1221,564,555,9,0,556,8,1350,786,257,299,1,8618,0
22,"Hunedoara",86810,207,86810,,"MUNICIPIUL HUNEDOARA",73,"Scoala Generala nr.5, B-dul Decebal nr.11, sala de clasa IV C - Parter",1139,667,657,10,0,662,5,1249,582,318,344,1,8618,0
22,"Hunedoara",86810,207,86810,,"MUNICIPIUL HUNEDOARA",74,"Scoala Generala Hasdat, sala de clasa",358,200,191,9,0,196,4,401,201,117,79,1,8618,0
22,"Hunedoara",86810,207,86810,,"MUNICIPIUL HUNEDOARA",75,"Scoala Generala nr.6, Piata Florilor nr.1, sala de clasa nr.2 - parter",1671,966,948,17,1,946,20,1850,884,383,563,1,8618,0
22,"Hunedoara",86810,207,86810,,"MUNICIPIUL HUNEDOARA",76,"Scoala Generala nr.6, Piata Florilor nr.1, sala de sport - parter",1566,804,790,14,0,779,25,1700,896,363,416,1,8618,0
22,"Hunedoara",86810,207,86810,,"MUNICIPIUL HUNEDOARA",77,"Colegiul Tehnic Matei Corvin (Liceul Industrial nr.1), Str. Victoriei nr.12, Hol sala profesorilor,",1270,710,704,6,0,704,6,1400,690,285,419,1,8618,0
22,"Hunedoara",86810,207,86810,,"MUNICIPIUL HUNEDOARA",78,"Gradinita cu program normal nr.4 Micro I (langa Scoala Generala nr.3), Str. Laminatorului nr.8, sala de clasa parter",1708,924,910,14,0,908,16,1900,976,352,556,1,8618,0
22,"Hunedoara",86810,207,86810,,"MUNICIPIUL HUNEDOARA",79,"Scoala Generala nr.1, B-dul Corvin nr.14, sala de clasa 2 ? parter",1001,594,584,10,0,584,10,1100,506,230,354,1,8618,0
22,"Hunedoara",86810,207,86810,,"MUNICIPIUL HUNEDOARA",80,"Scoala Generala nr.1, B-dul Corvin nr.14, sala de clasa  - parter",1233,669,661,8,0,664,5,1348,679,318,346,1,8618,0
22,"Hunedoara",86810,207,86810,,"MUNICIPIUL HUNEDOARA",81,"Colegiul Economic ""Emanuil Gojdu"" (Scoala Generala nr.3), Str. Laminatorului nr.10, sala de clasa - parter",1510,881,867,14,0,873,8,1650,769,390,483,1,8618,0
22,"Hunedoara",86810,207,86810,,"MUNICIPIUL HUNEDOARA",82,"Colegiul Economic ""Emanuil Gojdu"" (Scoala Generala nr.3), Str. Laminatorului nr.10, sala de clasa - parter",1480,872,862,10,0,860,12,1600,728,364,496,1,8618,0
22,"Hunedoara",86810,207,86810,,"MUNICIPIUL HUNEDOARA",83,"Scoala Generala nr.7, Str. Moldovei nr.2, sala de clasa 1 - parter",1249,704,694,10,0,696,8,1350,646,323,373,1,8618,0
22,"Hunedoara",86810,207,86810,,"MUNICIPIUL HUNEDOARA",84,"Scoala Generala  nr.7, Str. Moldovei nr.2, sala de clasa 2 - parter",1375,772,762,10,0,760,12,1500,728,320,440,1,8618,0
22,"Hunedoara",86810,207,86810,,"MUNICIPIUL HUNEDOARA",85,"Scoala Generala nr.7, Str. Moldovei nr.2, sala de clasa 3 - parter",1395,738,725,13,0,722,16,1550,812,321,401,1,8618,0
22,"Hunedoara",86810,207,86810,,"MUNICIPIUL HUNEDOARA",86,"Scoala Generala nr.8, Str. Cerbului nr.2, sala de sport - parter",1224,705,694,11,0,697,8,1248,543,303,394,1,8618,0
22,"Hunedoara",86810,207,86810,,"MUNICIPIUL HUNEDOARA",87,"Scoala Generala nr.8, Str. Cerbului nr.2, sala de clasa 4 - parter",1233,682,668,14,0,673,9,1349,667,292,381,1,8618,0
22,"Hunedoara",86810,207,86810,,"MUNICIPIUL HUNEDOARA",88,"Gradinita ""Floarea Soarelui"", Str. Cerbului nr.3 bis, sala de mese - parter",1252,607,592,15,0,595,12,1400,793,268,327,1,8618,0
22,"Hunedoara",86810,207,86810,,"MUNICIPIUL HUNEDOARA",89,"Gradinita PN ""Zori de zi"", Str. Cerbului 3, Hol intrare Principala",1301,722,706,16,0,714,8,1450,728,313,401,1,8618,0
22,"Hunedoara",86810,207,86810,,"MUNICIPIUL HUNEDOARA",90,"Scoala Generala nr.2, Str. Luncii nr.1, sala de clasa 1 - parter",1639,950,939,10,1,940,10,1800,850,396,544,1,8618,0
22,"Hunedoara",86810,207,86810,,"MUNICIPIUL HUNEDOARA",91,"Scoala Generala nr.2, Str. Luncii nr.1, sala de clasa 2 - parter",1774,990,967,23,0,979,11,1950,960,415,564,1,8618,0
22,"Hunedoara",86810,207,86810,,"MUNICIPIUL HUNEDOARA",92,"Scoala Generala nr.2, Str. Luncii nr.1, sala de clasa 3 - parter",1268,708,702,6,0,701,7,1400,692,292,409,1,8618,0
22,"Hunedoara",86810,207,86810,,"MUNICIPIUL HUNEDOARA",93,"Scoala Generala nr.2, Str. Luncii nr.1, sala de clasa 4 - parter",1622,842,830,12,0,823,19,1800,958,329,494,1,8618,0
22,"Hunedoara",86810,207,86810,,"MUNICIPIUL HUNEDOARA",94,"Centru de zi, Str.Randunicii nr.1, sala Consiliere Individuala - parter",1683,817,809,8,0,805,12,1850,1033,406,399,1,8618,0
22,"Hunedoara",86810,207,86810,,"MUNICIPIUL HUNEDOARA",95,"Scoala Generala nr.11, Str. Randunicii nr.3, sala de clasa 1 - parter",1891,976,965,10,1,965,11,2050,1074,483,482,1,8618,0
22,"Hunedoara",86810,207,86810,,"MUNICIPIUL HUNEDOARA",96,"Scoala Generala nr.11, Str. Randunicii nr.3, sala de clasa 2 - parter",1816,957,944,13,0,941,16,2000,1043,451,490,1,8618,0
22,"Hunedoara",86810,207,86810,,"MUNICIPIUL HUNEDOARA",97,"Scoala Generala nr.11, Str. Randunicii nr.3, sala de clasa 3 - parter",1677,878,865,13,0,860,18,1850,972,413,447,1,8618,0
22,"Hunedoara",86810,207,86810,,"MUNICIPIUL HUNEDOARA",98,"Scoala Generala nr.11, Str. Randunicii nr.3",1388,730,723,7,0,722,8,1500,770,348,374,1,8618,0
22,"Hunedoara",86810,207,86810,,"MUNICIPIUL HUNEDOARA",99,"Caminul Cultural Buituri, Str. Latureni nr.31",630,394,385,9,0,392,2,700,306,189,203,1,8618,0
22,"Hunedoara",86810,207,86810,,"MUNICIPIUL HUNEDOARA",100,"Sediul Primariei Municipiului Hunedoara (fosta BRD), B-dul Libertatii nr.26, sala Centrul de Informare pentru Cetateni",1858,1097,1064,33,0,1081,16,1600,503,470,611,1,8618,0
22,"Hunedoara",86810,207,86810,,"MUNICIPIUL HUNEDOARA",101,"Scoala Generala Racastie, sala de clasa",540,300,291,9,0,295,5,598,298,141,154,1,8618,0
22,"Hunedoara",86810,207,86810,,"MUNICIPIUL HUNEDOARA",102,"Scoala Generala Zlasti, Str. Zlasti",415,269,265,4,0,268,1,450,181,145,123,1,8618,0
22,"Hunedoara",86810,207,86810,,"MUNICIPIUL HUNEDOARA",103,"Caminul Cultural Bos (Gradinita)",496,287,280,7,0,286,1,550,263,141,145,1,8618,0
22,"Hunedoara",86810,207,86810,,"MUNICIPIUL HUNEDOARA",104,"Scoala Generala Pestisu Mare, sala profesorilor parter",1109,626,618,8,0,616,10,1250,624,273,343,1,8618,0
22,"Hunedoara",86810,207,86810,,"MUNICIPIUL HUNEDOARA",105,"Facultatea de ingineri Hunedoara, str. Revolutiei nr. 5, CP 331128",0,198,0,198,0,195,3,650,452,93,102,1,8618,1
22,"Hunedoara",86810,207,86810,,"MUNICIPIUL HUNEDOARA",106,"Autogara Hunedoara, B-dul Republicii nr. 11A, CP 331049",0,417,0,417,0,412,5,700,283,194,218,1,8618,1
22,"Hunedoara",87059,207,87059,,"MUNICIPIUL LUPENI",107,"Scoala Generala nr. 1, Corpul II, Str. Revolutiei nr. 4",1662,875,861,14,0,852,23,1800,925,220,632,1,8625,0
22,"Hunedoara",87059,207,87059,,"MUNICIPIUL LUPENI",108,"Casa Pensionarilor, Str. Avram Iancu nr. 1",1454,738,724,14,0,725,13,1600,862,170,555,1,8625,0
22,"Hunedoara",87059,207,87059,,"MUNICIPIUL LUPENI",109,"Scoala Generala nr. 1, Str. Tudor Vladimirescu nr. 3",1201,647,629,18,0,642,5,1300,653,134,508,1,8625,0
22,"Hunedoara",87059,207,87059,,"MUNICIPIUL LUPENI",110,"Scoala Generala nr. 1, Str. Tudor Vladimirescu nr. 3",1026,450,439,11,0,439,11,1148,698,79,360,1,8625,0
22,"Hunedoara",87059,207,87059,,"MUNICIPIUL LUPENI",111,"Imobilul de pe Al. Liliacului nr. 8, Lupeni",1847,1016,974,41,1,1005,11,2050,1034,194,811,1,8625,0
22,"Hunedoara",87059,207,87059,,"MUNICIPIUL LUPENI",112,"Scoala Generala nr. 3, Str. Calea Braii nr. 7",1062,627,620,7,0,616,11,1148,521,118,498,1,8625,0
22,"Hunedoara",87059,207,87059,,"MUNICIPIUL LUPENI",113,"Scoala Generala nr. 3, Str. Calea Braii nr. 7",1149,627,618,9,0,617,10,1250,623,131,486,1,8625,0
22,"Hunedoara",87059,207,87059,,"MUNICIPIUL LUPENI",114,"Cinematograful ""Cultural"", Str. Tudor Vladimirescu nr. 82",1422,790,776,14,0,775,15,1550,760,172,603,1,8625,0
22,"Hunedoara",87059,207,87059,,"MUNICIPIUL LUPENI",115,"Fosta TESMA, Sediul S.C. ""Autocom Amicii G.L.C."" S.R.L., B-dul Pacii nr. 2 bis",1820,1082,1070,12,0,1067,15,2000,918,225,842,1,8625,0
22,"Hunedoara",87059,207,87059,,"MUNICIPIUL LUPENI",116,"Gradinita nr. 6, Str. Tineretului",1664,880,837,43,0,866,14,1850,970,200,666,1,8625,0
22,"Hunedoara",87059,207,87059,,"MUNICIPIUL LUPENI",117,"Liceul Teoretic, Str. Viitorului nr. 2",1600,762,729,33,0,752,10,1750,988,154,598,1,8625,0
22,"Hunedoara",87059,207,87059,,"MUNICIPIUL LUPENI",118,"Liceul Teoretic, Str. Viitorului nr. 2",1026,438,425,13,0,428,10,1151,713,101,327,1,8625,0
22,"Hunedoara",87059,207,87059,,"MUNICIPIUL LUPENI",119,"Scoala Generala nr. 2, Str. Trandafirilor",1367,737,728,8,1,731,6,1499,762,131,600,1,8625,0
22,"Hunedoara",87059,207,87059,,"MUNICIPIUL LUPENI",120,"Scoala Generala nr. 2, Str. Trandafirilor",1189,670,662,8,0,665,5,1298,628,154,511,1,8625,0
22,"Hunedoara",87059,207,87059,,"MUNICIPIUL LUPENI",121,"Gradinita P.N. nr. 2, Str. Barbateni",1101,516,509,7,0,512,4,1200,684,93,419,1,8625,0
22,"Hunedoara",87059,207,87059,,"MUNICIPIUL LUPENI",122,"Gradinita P.N. nr. 2, Str. Barbateni",1037,497,486,11,0,489,8,1150,653,115,374,1,8625,0
22,"Hunedoara",87059,207,87059,,"MUNICIPIUL LUPENI",123,"Gradinita P.N. nr. 2, Str. Barbateni",1399,666,653,13,0,661,5,1550,884,159,502,1,8625,0
22,"Hunedoara",87059,207,87059,,"MUNICIPIUL LUPENI",124,"S.C. ""Universal Edil"" S.A., Str. Barbateni",745,394,368,26,0,393,1,802,408,104,289,1,8625,0
22,"Hunedoara",87059,207,87059,,"MUNICIPIUL LUPENI",125,"Scoala Generala nr. 1 Lupeni, str. T. Vladimirescu nr. 3, CP 335600",0,191,0,191,0,187,4,403,212,90,97,1,8625,1
22,"Hunedoara",87638,207,87638,,"MUNICIPIUL ORASTIE",126,"Casa de Cultura, Piata Victoriei nr.20",1833,1005,996,9,0,1000,5,2000,995,495,505,1,8627,0
22,"Hunedoara",87638,207,87638,,"MUNICIPIUL ORASTIE",127,"Cresa Municipala, Str.Pricazului nr. 46",1912,837,823,14,0,831,6,2100,1263,416,415,1,8627,0
22,"Hunedoara",87638,207,87638,,"MUNICIPIUL ORASTIE",128,"Gradinita ""Scufita Rosie"", Str.Pricazului nr.48",1915,815,806,8,1,811,4,2100,1285,432,379,1,8627,0
22,"Hunedoara",87638,207,87638,,"MUNICIPIUL ORASTIE",129,"Scoala Generala ""Dominic Stanca"", Str.Eroilor nr.21",1919,853,844,9,0,850,3,2100,1247,435,415,1,8627,0
22,"Hunedoara",87638,207,87638,,"MUNICIPIUL ORASTIE",130,"Local S.A.M., Str. A.Saguna nr. 16",1843,839,829,10,0,837,2,2050,1211,489,348,1,8627,0
22,"Hunedoara",87638,207,87638,,"MUNICIPIUL ORASTIE",131,"Scoala Generala ""Dr. Aurel Vlad"", Str.Luminii nr.10",1508,760,749,11,0,753,7,1650,890,376,377,1,8627,0
22,"Hunedoara",87638,207,87638,,"MUNICIPIUL ORASTIE",132,"Scoala Generala 1-4 Gara, Str. Targului nr. 2",1748,811,801,10,0,804,7,1900,1089,390,414,1,8627,0
22,"Hunedoara",87638,207,87638,,"MUNICIPIUL ORASTIE",133,"Oficiul de Gospodarire a Apelor, Str. Progresului nr.2",1427,807,798,9,0,800,7,1550,743,414,386,1,8627,0
22,"Hunedoara",87638,207,87638,,"MUNICIPIUL ORASTIE",134,"Grupul Scolar ""Nicolaus Olahus"", Str. O.Goga nr.25",1862,882,872,10,0,876,6,2050,1168,456,420,1,8627,0
22,"Hunedoara",87638,207,87638,,"MUNICIPIUL ORASTIE",135,"Colegiul National ""Aurel Vlaicu"", Str. Gh.Lazar nr.8",1731,883,872,11,0,869,14,1900,1017,467,402,1,8627,0
22,"Hunedoara",87638,207,87638,,"MUNICIPIUL ORASTIE",136,"Primaria municipiului Orastie, Piata Aurel Vlaicu nr.3",1940,1028,1011,16,1,1015,13,2100,1072,493,522,1,8627,0
22,"Hunedoara",87638,207,87638,,"MUNICIPIUL ORASTIE",137,"Autogara Orastie, str. Gradistei nr. 2, CP 335700",0,276,0,276,0,275,1,300,24,160,115,1,8627,1
22,"Hunedoara",86990,207,86990,,"MUNICIPIUL PETROSANI",138,"Scoala Generala I.G.Duca (Scoala Generala nr.1), sediul vechi, Str. 1 Decembrie 1918",1777,1060,1054,6,0,1038,22,1950,890,320,718,1,8629,0
22,"Hunedoara",86990,207,86990,,"MUNICIPIUL PETROSANI",139,"Scoala Generala I.G.Duca (Scoala Generala nr.1), sediul vechi, Str.1 Decembrie 1918",1692,1036,1025,10,1,1018,18,1850,814,340,678,1,8629,0
22,"Hunedoara",86990,207,86990,,"MUNICIPIUL PETROSANI",140,"Scoala Generala I.G.Duca (Scoala Generala nr.1), sediul nou, Str. St.O.Iosif",1489,903,891,11,1,894,9,1650,747,256,638,1,8629,0
22,"Hunedoara",86990,207,86990,,"MUNICIPIUL PETROSANI",141,"Amfiteatrul Universitatii, Str. Universitatii nr.20",1584,925,915,10,0,913,12,1750,825,297,616,1,8629,0
22,"Hunedoara",86990,207,86990,,"MUNICIPIUL PETROSANI",142,"Club Sportiv Scolar, Str.1 Decembrie 1918 nr.79",1127,694,680,14,0,686,8,1250,556,211,475,1,8629,0
22,"Hunedoara",86990,207,86990,,"MUNICIPIUL PETROSANI",143,"Scoala Generala Avram Stanca (Scoala Generala nr.4), Str.1 Decembrie 1918 nr.73",1209,740,730,10,0,732,8,1350,610,214,518,1,8629,0
22,"Hunedoara",86990,207,86990,,"MUNICIPIUL PETROSANI",144,"Scoala Generala Avram Stanca (Scoala Generala nr.4), Str.1 Decembrie 1918 nr.73",1709,1007,998,9,0,992,15,1900,893,344,648,1,8629,0
22,"Hunedoara",86990,207,86990,,"MUNICIPIUL PETROSANI",145,"Liceul Teoretic Mihai Eminescu, Str.1 Decembrie 1918",1883,1002,987,14,1,989,13,2050,1048,290,699,1,8629,0
22,"Hunedoara",86990,207,86990,,"MUNICIPIUL PETROSANI",146,"Gradinita nr.3 cu program prelungit, Str. Carpati nr.3",1038,658,652,6,0,647,11,1150,492,219,428,1,8629,0
22,"Hunedoara",86990,207,86990,,"MUNICIPIUL PETROSANI",147,"Liceul de Informatica, Str. Slatinioara nr.10",1570,888,881,7,0,873,15,1700,812,333,540,1,8629,0
22,"Hunedoara",86990,207,86990,,"MUNICIPIUL PETROSANI",148,"Colegiul Economic Hermes, str. Independentei nr.1A",1617,970,959,7,4,961,9,1750,780,277,684,1,8629,0
22,"Hunedoara",86990,207,86990,,"MUNICIPIUL PETROSANI",149,"Scoala Generala Spiru Haret (Scoala Generala nr.5), Str. Oituz nr.7",1542,917,908,9,0,904,13,1700,783,290,614,1,8629,0
22,"Hunedoara",86990,207,86990,,"MUNICIPIUL PETROSANI",150,"Scoala Generala Spiru Haret (Scoala Generala nr.5), Str. Oituz nr.7",1591,898,889,8,1,881,17,1750,852,254,627,1,8629,0
22,"Hunedoara",86990,207,86990,,"MUNICIPIUL PETROSANI",151,"Scoala Generala Carmen Sylva (Scoala Generala nr.6), Str.Independentei nr.37",1985,1126,1112,10,4,1109,17,2150,1024,323,786,1,8629,0
22,"Hunedoara",86990,207,86990,,"MUNICIPIUL PETROSANI",152,"Scoala Generala Carmen Sylva (Scoala Generala nr.6), Str.Independentei nr.37",1846,908,896,12,0,899,9,2050,1142,222,677,1,8629,0
22,"Hunedoara",86990,207,86990,,"MUNICIPIUL PETROSANI",153,"Gradinita Aeroport cu program prelungit, Str. Aviatorilor nr.3",950,524,510,14,0,514,10,1050,526,126,388,1,8629,0
22,"Hunedoara",86990,207,86990,,"MUNICIPIUL PETROSANI",154,"Gradinita cu program normal nr.2 Aeroport, Str. Aviatorilor nr.30",1659,874,861,13,0,865,9,1800,926,229,636,1,8629,0
22,"Hunedoara",86990,207,86990,,"MUNICIPIUL PETROSANI",155,"Gradinita cu program normal nr.2 Aeroport, Str. Aviatorilor nr.30",1854,905,891,13,1,895,10,2050,1145,225,670,1,8629,0
22,"Hunedoara",86990,207,86990,,"MUNICIPIUL PETROSANI",156,"Scoala Generala nr.7, Str. Venus nr.9",1941,989,971,18,0,977,12,2111,1122,249,728,1,8629,0
22,"Hunedoara",86990,207,86990,,"MUNICIPIUL PETROSANI",157,"Scoala Generala nr.7, Str. Venus nr.9",1949,946,919,27,0,936,10,2150,1204,253,683,1,8629,0
22,"Hunedoara",86990,207,86990,,"MUNICIPIUL PETROSANI",158,"Scoala Generala Surduc, Str.1 Decembrie 1918",655,380,371,9,0,374,6,700,320,151,223,1,8629,0
22,"Hunedoara",86990,207,86990,,"MUNICIPIUL PETROSANI",159,"S.C. GTS Company S.R.L. (Teatrul Vechi), Str. Grivita Rosie nr.36",1368,755,745,10,0,744,11,1500,745,300,444,1,8629,0
22,"Hunedoara",86990,207,86990,,"MUNICIPIUL PETROSANI",160,"S.C. GTS Company S.R.L. (Teatrul Vechi), Str. Grivita Rosie nr.36",1107,609,595,14,0,601,8,1200,591,191,410,1,8629,0
22,"Hunedoara",86990,207,86990,,"MUNICIPIUL PETROSANI",161,"Scoala Generala nr.2, Str. Gheorghe Baritiu nr.9",1272,668,658,10,0,659,9,1400,732,203,456,1,8629,0
22,"Hunedoara",86990,207,86990,,"MUNICIPIUL PETROSANI",162,"Sediul S.C. Termoficare, Str. Mihai Eminescu nr.15-17",1203,639,626,12,1,630,9,1300,661,223,407,1,8629,0
22,"Hunedoara",86990,207,86990,,"MUNICIPIUL PETROSANI",163,"Scoala Generala Dalja Mare",200,112,107,5,0,112,0,245,133,18,94,1,8629,0
22,"Hunedoara",86990,207,86990,,"MUNICIPIUL PETROSANI",164,"Scoala Sportiva, str. 1 Decembrie 1918 nr. 79, CP 332012",0,391,0,391,0,387,4,413,22,167,220,1,8629,1
22,"Hunedoara",86990,207,86990,,"MUNICIPIUL PETROSANI",165,"Caminul Studentesc nr. 1, str. Universitatii nr. 20, CP 332006",0,177,0,177,0,174,3,300,123,71,103,1,8629,1
22,"Hunedoara",87175,207,87175,,"MUNICIPIUL  VULCAN",166,"Gradinita nr.1, Str. Romanilor nr. 15",1242,685,675,10,0,678,7,1350,665,137,541,1,8607,0
22,"Hunedoara",87175,207,87175,,"MUNICIPIUL  VULCAN",167,"Scoala Generala nr.4, Str. N. Titulescu nr.31",1143,641,619,22,0,630,11,1250,609,150,480,1,8607,0
22,"Hunedoara",87175,207,87175,,"MUNICIPIUL  VULCAN",168,"Scoala Generala nr.4, Str. N. Titulescu nr. 31",1192,636,624,12,0,628,8,1300,664,137,491,1,8607,0
22,"Hunedoara",87175,207,87175,,"MUNICIPIUL  VULCAN",169,"Cantina de ajutor social, Str. Jiului nr. 7",1367,735,729,6,0,730,5,1500,765,173,557,1,8607,0
22,"Hunedoara",87175,207,87175,,"MUNICIPIUL  VULCAN",170,"Grup Scolar ""M.Viteazu"", Str. N.Titulescu nr. 43",1006,546,538,8,0,542,4,1100,554,129,413,1,8607,0
22,"Hunedoara",87175,207,87175,,"MUNICIPIUL  VULCAN",171,"Grup Scolar ""M.Viteazu"", Str. N.Titulescu nr. 43",1003,561,550,11,0,557,4,1100,539,101,456,1,8607,0
22,"Hunedoara",87175,207,87175,,"MUNICIPIUL  VULCAN",172,"Scoala Generala nr.5, Str. N.Titulescu nr. 63",1421,795,786,9,0,786,9,1550,755,141,645,1,8607,0
22,"Hunedoara",87175,207,87175,,"MUNICIPIUL  VULCAN",173,"Scoala Generala nr. 5, Str. N.Titulescu nr. 63",1544,866,852,14,0,862,4,1700,834,180,682,1,8607,0
22,"Hunedoara",87175,207,87175,,"MUNICIPIUL  VULCAN",174,"Stadionul central, Str. Coroesti nr. 17",1354,728,719,9,0,721,7,1500,772,167,554,1,8607,0
22,"Hunedoara",87175,207,87175,,"MUNICIPIUL  VULCAN",175,"Sala de sport, Str. V.Alecsandri nr. 3",1715,932,917,15,0,918,14,1900,968,212,706,1,8607,0
22,"Hunedoara",87175,207,87175,,"MUNICIPIUL  VULCAN",176,"Scoala Generala nr.6, Str. Traian nr. 2a",1848,783,779,4,0,773,10,2050,1267,203,570,1,8607,0
22,"Hunedoara",87175,207,87175,,"MUNICIPIUL  VULCAN",177,"Scoala Generala nr.6, Str. Traian nr. 2a",1897,902,894,8,0,890,12,2100,1198,178,712,1,8607,0
22,"Hunedoara",87175,207,87175,,"MUNICIPIUL  VULCAN",178,"Scoala Generala nr.6, Str. Traian nr. 2a",1937,937,925,12,0,932,5,2100,1163,177,755,1,8607,0
22,"Hunedoara",87175,207,87175,,"MUNICIPIUL  VULCAN",179,"Scoala Generala nr.1 Str. N.Titulescu, nr. 12",1234,608,594,14,0,602,6,1350,742,118,484,1,8607,0
22,"Hunedoara",87175,207,87175,,"MUNICIPIUL  VULCAN",180,"Scoala Generala nr.1 Str. N.Titulescu, nr. 12",1014,573,565,8,0,566,7,1100,527,112,454,1,8607,0
22,"Hunedoara",87175,207,87175,,"MUNICIPIUL  VULCAN",181,"Clubul copiilor si elevilor Str. Decebal, nr. 8",1011,541,535,6,0,540,1,1100,559,137,403,1,8607,0
22,"Hunedoara",87175,207,87175,,"MUNICIPIUL  VULCAN",182,"Scoala Generala nr.2 Str. Crividia, nr. 64",864,453,443,8,2,450,3,1000,547,103,347,1,8607,0
22,"Hunedoara",87175,207,87175,,"MUNICIPIUL  VULCAN",183,"Scoala Generala nr.3 Aleea Salcamilor, nr. 11",1497,866,861,4,1,859,7,1650,784,300,559,1,8607,0
22,"Hunedoara",87175,207,87175,,"MUNICIPIUL  VULCAN",184,"Grup Scolar ""Mihai Viteazu"", str. Nicolae Titulescu nr. 43 Vulcan, CP336200",0,185,0,185,0,185,0,250,65,79,106,1,8607,1
22,"Hunedoara",87219,207,87219,,"ORAS ANINOASA",185,"Clubul Sindicatului, Str. Libertatii",1696,964,944,16,4,950,14,1850,886,222,728,1,8635,0
22,"Hunedoara",87219,207,87219,,"ORAS ANINOASA",186,"Stadionul ""Minerul Aninoasa"", Str. Libertatii",950,582,571,9,2,577,5,1048,466,193,384,1,8635,0
22,"Hunedoara",87219,207,87219,,"ORAS ANINOASA",187,"Centrul Cultural Iscroni, Str. Catanesti, nr. 326",1359,764,748,10,6,754,10,1500,736,244,510,1,8635,0
22,"Hunedoara",87219,207,87219,,"ORAS ANINOASA",188,"Scoala Generala Iscroni, str. Catanesti nr. 50, CP 335100",0,58,0,58,0,57,1,130,72,22,35,1,8635,1
22,"Hunedoara",87424,207,87424,,"ORAS CALAN",189,"Oras Vechi Calan, Str.Garii, nr.1 sala de Sedinte a Consiliului local",1084,527,520,7,0,521,6,1200,673,286,235,1,8638,0
22,"Hunedoara",87424,207,87424,,"ORAS CALAN",190,"Oras Nou Calan, Str.Florilor nr.14 A, Scoala Generala nr.2",1237,566,559,7,0,559,7,1350,784,280,279,1,8638,0
22,"Hunedoara",87424,207,87424,,"ORAS CALAN",191,"Oras Nou Calan, Str.Independentei nr. 8, Scoala Generala nr.1",1529,657,646,10,1,649,8,1650,993,362,287,1,8638,0
22,"Hunedoara",87424,207,87424,,"ORAS CALAN",192,"Oras Nou Calan, Str. Ovid Densusianu nr. 5, Grup Scolar Ovid Densusianu",1637,727,716,11,0,717,10,1800,1073,360,357,1,8638,0
22,"Hunedoara",87424,207,87424,,"ORAS CALAN",193,"Oras Nou Calan, Str. Policlinicii nr.1, Policlinica",1531,762,728,34,0,760,2,1650,888,402,358,1,8638,0
22,"Hunedoara",87424,207,87424,,"ORAS CALAN",194,"Oras Nou Calan, Str.Independentei nr.14, Consiliul Local Oras Nou Calan",1517,750,742,8,0,740,10,1650,900,339,401,1,8638,0
22,"Hunedoara",87424,207,87424,,"ORAS CALAN",195,"Caminul Cultural Nadastia de Jos",253,175,164,10,1,174,1,300,125,99,75,1,8638,0
22,"Hunedoara",87424,207,87424,,"ORAS CALAN",196,"Caminul Cultural Nadastia de Sus",251,161,151,10,0,158,3,300,139,55,103,1,8638,0
22,"Hunedoara",87424,207,87424,,"ORAS CALAN",197,"Caminul Cultural Strei",324,177,167,10,0,177,0,350,173,86,91,1,8638,0
22,"Hunedoara",87424,207,87424,,"ORAS CALAN",198,"Scoala Primara Batiz",493,285,279,6,0,284,1,500,215,129,155,1,8638,0
22,"Hunedoara",87424,207,87424,,"ORAS CALAN",199,"Scoala Primara Sancrai",279,137,132,5,0,136,1,300,163,69,67,1,8638,0
22,"Hunedoara",87424,207,87424,,"ORAS CALAN",200,"Scoala Primara Santamaria de Piatra",153,103,96,7,0,103,0,200,97,64,39,1,8638,0
22,"Hunedoara",87424,207,87424,,"ORAS CALAN",201,"Caminul Cultural Strei-Sacel",152,102,89,12,1,101,1,200,98,43,58,1,8638,0
22,"Hunedoara",87424,207,87424,,"ORAS CALAN",202,"Caminul Cultural Streisangiorgiu",655,352,342,10,0,348,4,700,348,166,182,1,8638,0
22,"Hunedoara",87424,207,87424,,"ORAS CALAN",203,"Caminul Cultural Valea Sangiorgiului",262,176,169,7,0,172,4,300,124,96,76,1,8638,0
22,"Hunedoara",87424,207,87424,,"ORAS CALAN",204,"Caminul Cultural Grid",220,143,136,7,0,141,2,250,107,49,92,1,8638,0
22,"Hunedoara",87424,207,87424,,"ORAS CALAN",205,"Primaria Orasului Calan, str. Garii nr. 1, CP 335300",0,118,0,118,0,118,0,480,362,60,58,1,8638,1
22,"Hunedoara",89561,207,89561,,"ORAS GEOAGIU",206,"Sediul Primariei Geoagiu, Str. Calea Romanilor nr. 141",1254,672,656,6,10,668,4,1350,678,313,355,1,8652,0
22,"Hunedoara",89561,207,89561,,"ORAS GEOAGIU",207,"Gradinita nr.1 Geoagiu, Str. Calea Romanilor nr. 140",1123,664,656,8,0,658,6,1200,536,251,407,1,8652,0
22,"Hunedoara",89561,207,89561,,"ORAS GEOAGIU",208,"Caminul Cultural Aurel Vlaicu",765,372,357,15,0,368,4,800,428,169,199,1,8652,0
22,"Hunedoara",89561,207,89561,,"ORAS GEOAGIU",209,"Caminul Cultural Bozes",203,141,134,7,0,139,2,250,109,34,105,1,8652,0
22,"Hunedoara",89561,207,89561,,"ORAS GEOAGIU",210,"Caminul Cultural Cigmau",89,65,57,8,0,64,1,100,35,13,51,1,8652,0
22,"Hunedoara",89561,207,89561,,"ORAS GEOAGIU",211,"Scoala Generala Geoagiu Bai, sala de clasa nr. 2",410,231,227,4,0,227,4,450,219,112,115,1,8652,0
22,"Hunedoara",89561,207,89561,,"ORAS GEOAGIU",212,"Scoala Primara Gelmar",414,242,226,9,7,241,1,450,208,116,125,1,8652,0
22,"Hunedoara",89561,207,89561,,"ORAS GEOAGIU",213,"Caminul Cultural Homorod Joseni",218,135,130,5,0,133,2,250,115,41,92,1,8652,0
22,"Hunedoara",89561,207,89561,,"ORAS GEOAGIU",214,"Scoala Primara Homorod Suseni",114,69,57,12,0,69,0,150,81,28,41,1,8652,0
22,"Hunedoara",89561,207,89561,,"ORAS GEOAGIU",215,"Caminul Cultural Renghet",200,132,124,8,0,129,3,220,88,73,56,1,8652,0
22,"Hunedoara",89561,207,89561,,"ORAS GEOAGIU",216,"Scoala Primara Valeni",57,37,27,10,0,36,1,70,33,13,23,1,8652,0
22,"Hunedoara",89561,207,89561,,"ORAS GEOAGIU",217,"Scoala Generala Geoagiu Bai, sala de clasa nr. 1, str. Scolii nr. 1, CP 335400",0,355,0,355,0,350,5,450,95,173,177,1,8652,1
22,"Hunedoara",89561,207,89561,,"ORAS GEOAGIU",218,"Sediul contabilitate, Sanatoriul de Pneumoftiziologie Geoagiu, str. Sanatoriului nr. 8, CP 335400",0,187,0,187,0,185,2,250,63,63,122,1,8652,1
22,"Hunedoara",87576,207,87576,,"ORAS HATEG",219,"Primaria Veche, Str. Libertatii nr.5, sala de Sedinte a punctului de lucru ""Somaj"" Hateg",1613,971,961,9,1,966,5,1798,827,435,531,1,8664,0
22,"Hunedoara",87576,207,87576,,"ORAS HATEG",220,"Scoala Generala ""Ovid Densusianu"", Str. Piata Unirii nr. 1",1753,952,943,9,0,942,10,1900,948,413,529,1,8664,0
22,"Hunedoara",87576,207,87576,,"ORAS HATEG",221,"Scoala Generala ""Aron Densusianu"", Str. Independentei nr. 2",1735,953,940,12,1,950,3,1900,947,455,495,1,8664,0
22,"Hunedoara",87576,207,87576,,"ORAS HATEG",222,"Colegiul National ""I.C. Bratianu"" Str. Muntii Retezat nr. 3",1643,970,953,17,0,961,9,1800,830,446,515,1,8664,0
22,"Hunedoara",87576,207,87576,,"ORAS HATEG",223,"Cantina Sociala, Str. Horea nr. 3",1747,1079,1068,9,2,1073,6,1900,821,478,595,1,8664,0
22,"Hunedoara",87576,207,87576,,"ORAS HATEG",224,"Scoala Primara Nalatvad",280,195,189,6,0,192,3,300,105,79,113,1,8664,0
22,"Hunedoara",87576,207,87576,,"ORAS HATEG",225,"Scoala Primara Silvasu de Jos",336,245,237,8,0,243,2,400,155,94,149,1,8664,0
22,"Hunedoara",87576,207,87576,,"ORAS HATEG",226,"Scoala Primara Silvasu de Sus",284,193,184,9,0,193,0,300,107,72,121,1,8664,0
22,"Hunedoara",87576,207,87576,,"ORAS HATEG",227,"Autogara Hateg, str. Progresului nr. 84, CP 335500",0,232,0,232,0,231,1,280,48,117,114,1,8664,1
22,"Hunedoara",87077,207,87077,,"ORAS PETRILA",228,"Casa de Cultura ""Ladislau Schmidt"" Petrila, secTia II, Str. Republicii nr.51",1723,944,937,7,0,931,13,1900,956,221,710,1,8669,0
22,"Hunedoara",87077,207,87077,,"ORAS PETRILA",229,"S.C.Termoprest S.A. Petrila (sala de Sedinte), Str. Privighetorilor nr.14",1631,893,880,12,1,888,5,1800,907,218,670,1,8669,0
22,"Hunedoara",87077,207,87077,,"ORAS PETRILA",230,"Gradinita nr.1 Petrila (sala de clasa), Str. Privighetorilor nr.16",1112,591,580,11,0,583,8,1200,609,156,427,1,8669,0
22,"Hunedoara",87077,207,87077,,"ORAS PETRILA",231,"Scoala Generala I.D.Sarbu (sala de clasa), Str. T.Vladimirescu nr.3",1366,745,731,14,0,742,3,1500,755,151,591,1,8669,0
22,"Hunedoara",87077,207,87077,,"ORAS PETRILA",232,"Clubul Copiilor Petrila (sala atelier), Str. T.Vladimirescu nr.3",1389,768,760,8,0,755,13,1500,732,160,595,1,8669,0
22,"Hunedoara",87077,207,87077,,"ORAS PETRILA",233,"Scoala Generala nr.6 sectia I (sala de clasa), Str. 8 Martie nr.68",1378,788,781,7,0,775,13,1500,712,178,597,1,8669,0
22,"Hunedoara",87077,207,87077,,"ORAS PETRILA",234,"Scoala Generala nr.6 sectia II (sala de clasa), Str. 8 Martie nr.68",1016,550,545,5,0,543,7,1098,548,147,396,1,8669,0
22,"Hunedoara",87077,207,87077,,"ORAS PETRILA",235,"Scoala Generala nr.5 sectia I (sala de clasa), Str. 8 Martie nr.15",1511,783,774,9,0,774,9,1650,867,182,592,1,8669,0
22,"Hunedoara",87077,207,87077,,"ORAS PETRILA",236,"Scoala Generala nr.5 sectia II (sala de clasa), Str.  8 Martie nr.15",1364,700,689,11,0,694,6,1500,800,206,488,1,8669,0
22,"Hunedoara",87077,207,87077,,"ORAS PETRILA",237,"Gradinita si cresa Petrila (sala de clasa), Str. 8 Martie nr.40",1463,745,730,15,0,734,11,1600,855,214,520,1,8669,0
22,"Hunedoara",87077,207,87077,,"ORAS PETRILA",238,"Grup Scolar Constantin Brancusi (sala de clasa), Str. Republicii nr.196",1004,602,589,13,0,595,7,1100,498,221,374,1,8669,0
22,"Hunedoara",87077,207,87077,,"ORAS PETRILA",239,"Casa Pensionarilor Lonea (sala de Sedinta), Str. Tineretului nr.1",972,591,582,9,0,586,4,1094,503,186,400,1,8669,0
22,"Hunedoara",87077,207,87077,,"ORAS PETRILA",240,"Scoala Generala Ana Colda (sala de clasa), Str. Republicii nr.293",1768,1082,1069,12,1,1069,13,1950,868,264,805,1,8669,0
22,"Hunedoara",87077,207,87077,,"ORAS PETRILA",241,"Scoala Generala nr.3 (sala de clasa) Str. Cimpa nr.50 localitate componenta a loc.Cimpa",1456,967,952,13,2,949,18,1600,633,236,713,1,8669,0
22,"Hunedoara",87077,207,87077,,"ORAS PETRILA",242,"Centrul de ingrijire si Asistenta Petrila",1250,776,759,16,1,766,10,1400,624,228,538,1,8669,0
22,"Hunedoara",87077,207,87077,,"ORAS PETRILA",243,"Scoala Generala nr.4 (sala de clasa) Str. JieT f.n.",590,373,365,7,1,366,7,650,277,111,255,1,8669,0
22,"Hunedoara",87077,207,87077,,"ORAS PETRILA",244,"Clubul Petrila, Casa de Cultura Ladislau Schmidt, str. Republicii nr. 51, CP 335800",0,102,0,102,0,101,1,230,128,48,53,1,8669,1
22,"Hunedoara",87665,207,87665,,"ORAS SIMERIA",245,"Scoala Generala nr.2, Str. Avram Iancu, nr.17",2048,1260,1253,7,0,1250,10,2200,940,538,712,1,8675,0
22,"Hunedoara",87665,207,87665,,"ORAS SIMERIA",246,"Gradinita nr.2, Str. 1 Decembrie",1533,868,860,8,0,860,8,1700,832,390,470,1,8675,0
22,"Hunedoara",87665,207,87665,,"ORAS SIMERIA",247,"Gradinita Waldorf, Str. Cuza Voda, nr.2",1488,855,843,11,1,849,6,1600,745,392,457,1,8675,0
22,"Hunedoara",87665,207,87665,,"ORAS SIMERIA",248,"Ocolul Silvic Simeria, Str. Preot Nistor Socaciu, nr.3",1467,824,810,12,2,819,5,1600,776,374,445,1,8675,0
22,"Hunedoara",87665,207,87665,,"ORAS SIMERIA",249,"Scoala Generala nr.1, Str. Decebal nr.20",1547,961,948,13,0,955,6,1700,739,373,582,1,8675,0
22,"Hunedoara",87665,207,87665,,"ORAS SIMERIA",250,"Colegiul Tehnic de Transport Feroviar ,,Anghel Saligny'' Simeria, Str. Soseaua Nationala",1300,687,679,8,0,677,10,1430,743,334,343,1,8675,0
22,"Hunedoara",87665,207,87665,,"ORAS SIMERIA",251,"Stadionul Sportiv ,,CFR - Marmosim'' Simeria, Str. Victoriei nr.20A",906,508,501,7,0,504,4,999,491,213,291,1,8675,0
22,"Hunedoara",87665,207,87665,,"ORAS SIMERIA",252,"Scoala Generala Simeria Veche",355,217,209,8,0,216,1,400,183,77,139,1,8675,0
22,"Hunedoara",87665,207,87665,,"ORAS SIMERIA",253,"Casa Satului Uroi",518,323,313,10,0,320,3,600,277,157,163,1,8675,0
22,"Hunedoara",87665,207,87665,,"ORAS SIMERIA",254,"Scoala Generala Sintandrei",950,585,571,13,1,582,3,1050,465,218,364,1,8675,0
22,"Hunedoara",87665,207,87665,,"ORAS SIMERIA",255,"Incinta Garii CFR Simeria, Casa Speciala nr. 12, str. Victoriei nr. 11, CP 335900",0,303,0,303,0,300,3,400,97,157,143,1,8675,1
22,"Hunedoara",87139,207,87139,,"ORAS URICANI",256,"S.C. Goscomloc S.A. Uricani, Str. Sterminos, nr. 22",1921,920,907,13,0,913,7,2100,1180,246,667,1,8683,0
22,"Hunedoara",87139,207,87139,,"ORAS URICANI",257,"Scoala Generala nr. 2, B-dul Muncii, nr. 12",2006,844,836,8,0,837,7,2200,1356,188,649,1,8683,0
22,"Hunedoara",87139,207,87139,,"ORAS URICANI",258,"Scoala Generala nr. 1, Str. Republicii, nr. 16",1960,953,945,8,0,944,9,2100,1147,258,686,1,8683,0
22,"Hunedoara",87139,207,87139,,"ORAS URICANI",259,"Casa de Cultura, Str. Republicii, nr. 1",1795,904,897,7,0,900,4,2000,1096,241,659,1,8683,0
22,"Hunedoara",87139,207,87139,,"ORAS URICANI",260,"Scoala Primara, Str. Campu lui Neag",423,257,250,7,0,254,3,500,243,147,107,1,8683,0
22,"Hunedoara",87139,207,87139,,"ORAS URICANI",261,"Casa de Cultura Uricani, sala Biblioteca, str. Republicii nr. 1, CP 336100",0,121,0,121,0,120,1,150,29,52,68,1,8683,1
22,"Hunedoara",87745,207,87745,,"BAIA DE CRIS",262,"Scoala Generala, str. Tribunului nr.18",697,414,409,5,0,410,4,748,334,170,240,3,8692,0
22,"Hunedoara",87745,207,87745,,"BAIA DE CRIS",263,"Scoala Primara Lunca",246,142,134,8,0,142,0,300,158,94,48,3,8692,0
22,"Hunedoara",87745,207,87745,,"BAIA DE CRIS",264,"Scoala Primara Carastau",196,120,114,6,0,120,0,220,100,73,47,3,8692,0
22,"Hunedoara",87745,207,87745,,"BAIA DE CRIS",265,"Caminul Cultural Risca",219,130,126,4,0,130,0,250,120,83,47,3,8692,0
22,"Hunedoara",87745,207,87745,,"BAIA DE CRIS",266,"Scoala Primara Risculita",471,260,255,5,0,256,4,502,242,141,115,3,8692,0
22,"Hunedoara",87745,207,87745,,"BAIA DE CRIS",267,"Scoala Primara Tebea",652,410,402,5,3,406,4,700,290,173,233,3,8692,0
22,"Hunedoara",87745,207,87745,,"BAIA DE CRIS",268,"Scoala Generala Baia de Cris, sala de sport, sat Baia de Cris, CP 337005",0,72,0,72,0,71,1,121,49,34,37,3,8692,1
22,"Hunedoara",87843,207,87843,,"BALSA",269,"Sala de Sedinta a Primariei comunei Balsa",295,158,147,8,3,154,4,320,162,73,81,3,8714,0
22,"Hunedoara",87843,207,87843,,"BALSA",270,"Caminul Cultural Ardeu",47,43,37,5,1,43,0,60,17,6,37,3,8714,0
22,"Hunedoara",87843,207,87843,,"BALSA",271,"Caminul Cultural Mada",113,59,52,7,0,58,1,130,71,20,38,3,8714,0
22,"Hunedoara",87843,207,87843,,"BALSA",272,"Caminul Cultural Voia",92,72,65,6,1,70,2,100,28,30,40,3,8714,0
22,"Hunedoara",87843,207,87843,,"BALSA",273,"Scoala Primara Valisoara",58,29,22,6,1,28,1,70,41,11,17,3,8714,0
22,"Hunedoara",87843,207,87843,,"BALSA",274,"Scoala Primara Almasu Mic de Munte",67,54,46,7,1,52,2,80,26,21,31,3,8714,0
22,"Hunedoara",87843,207,87843,,"BALSA",275,"Scoala Primara Poiana",119,68,62,6,0,68,0,130,62,28,40,3,8714,0
22,"Hunedoara",87843,207,87843,,"BALSA",276,"Caminul Cultural Poienita",79,66,57,8,1,66,0,90,24,20,46,3,8714,0
22,"Hunedoara",87843,207,87843,,"BALSA",277,"Scoala Generala Balsa, sat Balsa, CP 337015",0,69,0,69,0,69,0,200,131,23,46,3,8714,1
22,"Hunedoara",87996,207,87996,,"BARU",278,"Scoala Primara Baru",1016,560,555,5,0,554,6,1100,540,186,368,3,8733,0
22,"Hunedoara",87996,207,87996,,"BARU",279,"Scoala Generala Petros, corp Cladire nr. 4",572,319,316,3,0,315,4,650,331,142,173,3,8733,0
22,"Hunedoara",87996,207,87996,,"BARU",280,"Scoala Primara Livadia",540,307,301,6,0,303,4,600,293,104,199,3,8733,0
22,"Hunedoara",87996,207,87996,,"BARU",281,"Scoala Primara Valea Lupului nr. 235",189,104,98,6,0,101,3,199,95,38,63,3,8733,0
22,"Hunedoara",87996,207,87996,,"BARU",282,"Scoala Generala clasele I-VIII Petros, corp Cladire noua, sat Petros, str. Prof. Dr. St. Garbea nr. 163, CP 337035",0,121,0,121,0,120,1,219,98,39,81,3,8733,1
22,"Hunedoara",88047,207,88047,,"BACIA",283,"Caminul Cultural nr. 235 Club",823,544,536,6,2,542,2,900,356,179,363,3,8687,0
22,"Hunedoara",88047,207,88047,,"BACIA",284,"Scoala Primara Totia  nr. 3",73,53,43,10,0,52,1,99,46,31,21,3,8687,0
22,"Hunedoara",88047,207,88047,,"BACIA",285,"Scoala Primara Timpa, nr. 28",617,439,430,5,4,435,4,680,241,110,325,3,8687,0
22,"Hunedoara",88047,207,88047,,"BACIA",286,"Scoala Primara, sala 1, sat Timpa nr. 28, CP 337042",0,119,0,119,0,118,1,140,21,32,86,3,8687,1
22,"Hunedoara",88092,207,88092,,"BAITA",287,"Caminul Cultural Baita",1070,590,583,7,0,584,6,1150,560,233,351,3,8702,0
22,"Hunedoara",88092,207,88092,,"BAITA",288,"Caminul Cultural Hartagani",725,368,361,7,0,358,10,800,432,143,215,3,8702,0
22,"Hunedoara",88092,207,88092,,"BAITA",289,"Caminul Cultural Cainelul de Sus",377,241,236,5,0,236,5,400,159,92,144,3,8702,0
22,"Hunedoara",88092,207,88092,,"BAITA",290,"Scoala Primara Ormindea",517,260,255,5,0,255,5,600,340,108,147,3,8702,0
22,"Hunedoara",88092,207,88092,,"BAITA",291,"Caminul Cultural Fizes",280,188,181,7,0,186,2,300,112,61,125,3,8702,0
22,"Hunedoara",88092,207,88092,,"BAITA",292,"Caminul Cultural Lunca",261,176,166,10,0,174,2,300,124,65,109,3,8702,0
22,"Hunedoara",88092,207,88092,,"BAITA",293,"Scoala Generala Baita, clasele V-VIII, sat Baita, str. Principala, CP 337045",0,148,0,148,0,145,3,240,92,61,84,3,8702,1
22,"Hunedoara",87246,207,87246,,"BANITA",294,"Caminul Cultural Banita, str. Garii, nr. 201",987,690,688,2,0,682,8,1100,410,216,466,3,8729,0
22,"Hunedoara",87246,207,87246,,"BANITA",295,"Caminul Cultural, sala mica, sat Banita, str. Garii, nr. 201, CP 337065",0,42,0,42,0,42,0,50,8,5,37,3,8729,1
22,"Hunedoara",88216,207,88216,,"BATRANA",296,"Primaria comunei Batrana, sala de Sedinte",137,100,97,1,2,97,1,160,60,68,29,3,8738,0
22,"Hunedoara",88216,207,88216,,"BATRANA",297,"Primaria comunei Batrana, sat Batrana, CP 337070",0,23,0,23,0,23,0,30,7,13,10,3,8738,1
22,"Hunedoara",88261,207,88261,,"BERIU",298,"Caminul Cultural Beriu",532,287,278,9,0,284,3,600,313,148,136,3,8743,0
22,"Hunedoara",88261,207,88261,,"BERIU",299,"Scoala Generala Castau",980,492,486,6,0,484,8,1050,558,327,157,3,8743,0
22,"Hunedoara",88261,207,88261,,"BERIU",300,"Scoala Primara Cucuis",115,82,74,8,0,82,0,150,68,66,16,3,8743,0
22,"Hunedoara",88261,207,88261,,"BERIU",301,"Scoala Primara Orastioara de Jos",282,167,158,9,0,167,0,300,133,90,77,3,8743,0
22,"Hunedoara",88261,207,88261,,"BERIU",302,"Scoala Primara Sereca",178,106,97,9,0,104,2,200,94,55,49,3,8743,0
22,"Hunedoara",88261,207,88261,,"BERIU",303,"Scoala Primara Sibisel",615,307,295,12,0,304,3,676,369,186,118,3,8743,0
22,"Hunedoara",88261,207,88261,,"BERIU",304,"Caminul Cultural Beriu, sala nr. 2, sat Beriu, str. Campului nr. 131, CP 337075",0,95,0,95,0,95,0,150,55,53,42,3,8743,1
22,"Hunedoara",88350,207,88350,,"BLAJENI",305,"Caminul Cultural Blajeni, Satul Blajeni, nr. 63",627,285,281,4,0,284,1,690,405,79,205,3,8752,0
22,"Hunedoara",88350,207,88350,,"BLAJENI",306,"Scoala Primara Cris, Satul Cris nr. 84",229,133,126,5,2,133,0,250,117,23,110,3,8752,0
22,"Hunedoara",88350,207,88350,,"BLAJENI",307,"Scoala Primara Blajeni Vulcan",82,61,44,17,0,61,0,100,39,20,41,3,8752,0
22,"Hunedoara",88350,207,88350,,"BLAJENI",308,"Scoala Primara Ret, Satul Ret nr.31",105,61,54,7,0,61,0,120,59,17,44,3,8752,0
22,"Hunedoara",88350,207,88350,,"BLAJENI",309,"Scoala Primara Grosuri, Satul Grosuri, nr.5",111,63,54,9,0,62,1,120,57,23,39,3,8752,0
22,"Hunedoara",88350,207,88350,,"BLAJENI",310,"Caminul Cultural Blajeni, sala nr. 2, sat Blajeni, nr. 65, CP 337085",0,27,0,27,0,26,1,80,53,12,14,3,8752,1
22,"Hunedoara",88449,207,88449,,"BOSOROD",311,"Caminul Cultural Bosorod nr. 59",769,524,519,5,0,516,8,853,329,221,295,3,8761,0
22,"Hunedoara",88449,207,88449,,"BOSOROD",312,"Caminul Cultural Chitid nr. 131",474,288,284,2,2,284,4,546,258,147,137,3,8761,0
22,"Hunedoara",88449,207,88449,,"BOSOROD",313,"Caminul Cultural Luncani nr. 23",109,67,60,7,0,66,1,122,55,37,29,3,8761,0
22,"Hunedoara",88449,207,88449,,"BOSOROD",314,"Caminul Cultural Ursici nr. 33",73,45,36,9,0,45,0,81,36,14,31,3,8761,0
22,"Hunedoara",88449,207,88449,,"BOSOROD",315,"Caminul Cultural Alun nr. 5",68,49,39,10,0,49,0,82,33,10,39,3,8761,0
22,"Hunedoara",88449,207,88449,,"BOSOROD",316,"Caminul Cultural Tirsa nr. 33",186,117,107,10,0,117,0,200,83,34,83,3,8761,0
22,"Hunedoara",88449,207,88449,,"BOSOROD",317,"Caminul Cultural Bosorod, sala mica, fosta biblioteca, sat Bosorod nr. 59, CP 337095",0,74,0,74,0,73,1,121,47,36,37,3,8761,1
22,"Hunedoara",88546,207,88546,,"BRANISCA",318,"Caminul Cultural Branisca, str. Principala, sala mica, nr. 95",513,277,271,6,0,276,1,559,282,97,179,3,8771,0
22,"Hunedoara",88546,207,88546,,"BRANISCA",319,"Caminul Cultural Boz, nr. 145",403,276,264,4,8,274,2,465,189,131,143,3,8771,0
22,"Hunedoara",88546,207,88546,,"BRANISCA",320,"Scoala Primara Rovina, sala mica, nr. 15",167,127,115,9,3,127,0,193,66,69,58,3,8771,0
22,"Hunedoara",88546,207,88546,,"BRANISCA",321,"Caminul Cultural Tarnavita, nr. 91",145,91,83,8,0,87,4,160,69,44,43,3,8771,0
22,"Hunedoara",88546,207,88546,,"BRANISCA",322,"Caminul Cultural Tarnava, sala mica, nr.  43",134,65,60,5,0,64,1,151,86,20,44,3,8771,0
22,"Hunedoara",88546,207,88546,,"BRANISCA",323,"Caminul Cultural, Furcsoara, sala mica, nr. 1",66,29,21,8,0,29,0,80,51,13,16,3,8771,0
22,"Hunedoara",88546,207,88546,,"BRANISCA",324,"Caminul Cultural Branisca, sala anexa sediu Caminul, sat Branisca, str. Principala nr. 65, CP 337105",0,109,0,109,0,105,4,166,57,52,53,3,8771,1
22,"Hunedoara",88644,207,88644,,"BRETEA ROMANA",325,"Scoala Generala Bretea Romana",236,150,144,5,1,149,1,254,104,64,85,3,8781,0
22,"Hunedoara",88644,207,88644,,"BRETEA ROMANA",326,"Caminul Cultural Bretea Streiului",173,104,99,5,0,103,1,202,98,36,67,3,8781,0
22,"Hunedoara",88644,207,88644,,"BRETEA ROMANA",327,"Scoala Primara Batalar",202,138,131,7,0,138,0,212,74,55,83,3,8781,0
22,"Hunedoara",88644,207,88644,,"BRETEA ROMANA",328,"Scoala Primara Covragiu",152,91,82,7,2,91,0,169,78,41,50,3,8781,0
22,"Hunedoara",88644,207,88644,,"BRETEA ROMANA",329,"Scoala Primara Gantaga",259,179,176,3,0,178,1,265,86,104,74,3,8781,0
22,"Hunedoara",88644,207,88644,,"BRETEA ROMANA",330,"Scoala Primara Maceu",309,179,174,5,0,178,1,327,148,71,107,3,8781,0
22,"Hunedoara",88644,207,88644,,"BRETEA ROMANA",331,"Scoala Primara Ocolisu Mare",196,130,122,8,0,127,3,228,98,49,78,3,8781,0
22,"Hunedoara",88644,207,88644,,"BRETEA ROMANA",332,"Scoala Primara Ocolisu Plopi",232,124,119,5,0,121,3,252,128,44,77,3,8781,0
22,"Hunedoara",88644,207,88644,,"BRETEA ROMANA",333,"Caminul Cultural  Rusi",216,137,132,5,0,137,0,264,127,64,73,3,8781,0
22,"Hunedoara",88644,207,88644,,"BRETEA ROMANA",334,"Scoala Primara Valcelele Bune",359,228,223,5,0,225,3,383,155,137,88,3,8781,0
22,"Hunedoara",88644,207,88644,,"BRETEA ROMANA",335,"Scoala Primara Valcele",207,148,142,6,0,148,0,230,82,71,77,3,8781,0
22,"Hunedoara",88644,207,88644,,"BRETEA ROMANA",336,"Caminul Cultural Bretea Romana, str. Principala nr. 73, CP 337115",0,105,0,105,0,105,0,242,137,48,57,3,8781,1
22,"Hunedoara",88788,207,88788,,"BUCES",337,"Caminul Cultural Buces",147,92,90,2,0,92,0,170,78,34,58,3,8795,0
22,"Hunedoara",88788,207,88788,,"BUCES",338,"Scoala Primara clasele I - IV Buces Vulcan",213,140,136,4,0,140,0,227,87,33,107,3,8795,0
22,"Hunedoara",88788,207,88788,,"BUCES",339,"Scoala Primara Grohotele",182,124,119,5,0,121,3,200,76,29,92,3,8795,0
22,"Hunedoara",88788,207,88788,,"BUCES",340,"Scoala Generala Dupa Piatra",501,291,287,4,0,289,2,550,259,102,187,3,8795,0
22,"Hunedoara",88788,207,88788,,"BUCES",341,"Scoala Primara Mihaileni",396,267,266,1,0,261,6,440,173,110,151,3,8795,0
22,"Hunedoara",88788,207,88788,,"BUCES",342,"Scoala Primara Stanija",359,202,200,2,0,199,3,400,198,78,121,3,8795,0
22,"Hunedoara",88788,207,88788,,"BUCES",343,"Sediul Caminului Cultural Buces, sat Buces nr. 60, CP 337135",0,37,0,37,0,37,0,89,52,14,23,3,8795,1
22,"Hunedoara",88868,207,88868,,"BUCURESCI",344,"Scoala Generala clasele I-VII Sabin Oprean, Bucuresci, Satul Bucuresci",537,354,349,4,1,342,12,600,246,145,197,3,8803,0
22,"Hunedoara",88868,207,88868,,"BUCURESCI",345,"Caminul Cultural Curechiu",314,203,200,3,0,202,1,350,147,94,108,3,8803,0
22,"Hunedoara",88868,207,88868,,"BUCURESCI",346,"Caminul Cultural Rovina",160,105,100,4,1,105,0,176,71,39,66,3,8803,0
22,"Hunedoara",88868,207,88868,,"BUCURESCI",347,"Caminul Cultural Merisor",89,66,60,6,0,66,0,100,34,25,41,3,8803,0
22,"Hunedoara",88868,207,88868,,"BUCURESCI",348,"Scoala Primara Sesuri",393,256,249,7,0,253,3,429,173,102,151,3,8803,0
22,"Hunedoara",88868,207,88868,,"BUCURESCI",349,"Caminul Cultural, sat Bucuresci nr. 169, CP 337145",0,71,0,71,0,70,1,130,59,34,36,3,8803,1
22,"Hunedoara",88920,207,88920,,"BULZESTII DE SUS",350,"Sala de Sedinte din cadrul Primariei comunei Bulzestii de Sus, nr. 35",166,101,95,6,0,100,1,190,89,55,45,3,8809,0
22,"Hunedoara",88920,207,88920,,"BULZESTII DE SUS",351,"Scoala Primara Bulzestii de Jos",116,62,61,1,0,60,2,130,68,26,34,3,8809,0
22,"Hunedoara",88920,207,88920,,"BULZESTII DE SUS",352,"Scoala Primara clasele I-IV Bulzestii de Sus, str. Principala nr. 32, CP 337150",0,47,0,47,0,47,0,80,33,25,22,3,8809,1
22,"Hunedoara",89026,207,89026,,"BUNILA",353,"Sala de Sedinta a Consiliului local Bunila",82,39,33,6,0,38,1,100,61,13,25,3,8819,0
22,"Hunedoara",89026,207,89026,,"BUNILA",354,"Dispensarul medical, nr. 54, sala nr. 2, Satul Cernisoara - Florese",164,109,98,11,0,109,0,180,71,28,81,3,8819,0
22,"Hunedoara",89026,207,89026,,"BUNILA",355,"Sala de clasa a Scolii Primare, Satul Poienita Voinii, nr. 4",79,59,53,6,0,58,1,90,31,35,23,3,8819,0
22,"Hunedoara",89026,207,89026,,"BUNILA",356,"Caminul Cultural, Satul Vadu Dobrii, nr. 53",25,20,13,7,0,20,0,30,10,8,12,3,8819,0
22,"Hunedoara",89026,207,89026,,"BUNILA",357,"Dispensarul medical uman, sat Bunila nr. 6, CP 337160",0,23,0,23,0,23,0,80,57,11,12,3,8819,1
22,"Hunedoara",89080,207,89080,,"BURJUC",358,"Scoala Primara Burjuc, sala mare",164,100,91,8,1,100,0,181,81,46,54,3,8825,0
22,"Hunedoara",89080,207,89080,,"BURJUC",359,"Caminul Cultural Tatarasti, sala mica",140,85,80,5,0,84,1,163,78,55,29,3,8825,0
22,"Hunedoara",89080,207,89080,,"BURJUC",360,"Scoala Primara Tisa, sala mica",121,74,66,8,0,74,0,140,66,32,42,3,8825,0
22,"Hunedoara",89080,207,89080,,"BURJUC",361,"Scoala Primara Glodghilesti, sala mica",178,98,93,3,2,96,2,200,102,38,58,3,8825,0
22,"Hunedoara",89080,207,89080,,"BURJUC",362,"Scoala Primara Bradatel, sala mica",147,61,57,4,0,60,1,170,109,19,41,3,8825,0
22,"Hunedoara",89080,207,89080,,"BURJUC",363,"Scoala Primara Burjuc, sat Burjuc nr. 91, CP 337165",0,47,0,47,0,47,0,140,93,25,22,3,8825,1
22,"Hunedoara",89151,207,89151,,"CERBAL",364,"Casa Comunala Cerbal, sala de Sedinta a Consiliului local Cerbal",195,101,96,5,0,99,2,220,119,45,54,3,8838,0
22,"Hunedoara",89151,207,89151,,"CERBAL",365,"Sala Scolii Primare Poienita Tomii",150,86,82,4,0,86,0,170,84,19,67,3,8838,0
22,"Hunedoara",89151,207,89151,,"CERBAL",366,"Sala Scolii Primare Poiana Rachitelii",127,90,86,4,0,90,0,140,50,24,66,3,8838,0
22,"Hunedoara",89151,207,89151,,"CERBAL",367,"Scoala Primara Cerbal, sat Cerbal, CP 337180",0,26,0,26,0,26,0,80,54,9,17,3,8838,1
22,"Hunedoara",89240,207,89240,,"CERTEJU DE SUS",368,"Caminul Cultural Certeju de Sus",1309,681,669,2,10,677,4,1437,756,274,403,3,8847,0
22,"Hunedoara",89240,207,89240,,"CERTEJU DE SUS",369,"Caminul Cultural Hondol",435,245,232,10,3,243,2,480,235,104,139,3,8847,0
22,"Hunedoara",89240,207,89240,,"CERTEJU DE SUS",370,"Scoala Generala Bocsa mica",117,77,68,9,0,76,1,130,53,29,47,3,8847,0
22,"Hunedoara",89240,207,89240,,"CERTEJU DE SUS",371,"Caminul Cultural Sacaramb",150,71,65,6,0,69,2,170,99,30,39,3,8847,0
22,"Hunedoara",89240,207,89240,,"CERTEJU DE SUS",372,"Scoala Generala Magura Toplita",102,80,72,7,1,78,2,121,41,20,58,3,8847,0
22,"Hunedoara",89240,207,89240,,"CERTEJU DE SUS",373,"Scoala Generala Toplita Muresului",80,57,51,6,0,57,0,92,35,18,39,3,8847,0
22,"Hunedoara",89240,207,89240,,"CERTEJU DE SUS",374,"Scoala Generala Nojag",230,130,125,5,0,128,2,250,120,46,82,3,8847,0
22,"Hunedoara",89240,207,89240,,"CERTEJU DE SUS",375,"Scoala Generala Varmaga",282,165,156,7,2,163,2,316,151,54,109,3,8847,0
22,"Hunedoara",89240,207,89240,,"CERTEJU DE SUS",376,"Scoala Generala Certeju de Sus, corp Cladire clasele I-IV, sat Certeju de Sus, str. Faeragului nr.226, CP 337190",0,92,0,92,0,91,1,250,158,22,69,3,8847,1
22,"Hunedoara",86749,207,86749,,"CARJITI",377,"Scoala Generala clasele I-IV Satul Carjiti, sala de Gradinita",107,66,58,8,0,64,2,120,54,37,27,3,8832,0
22,"Hunedoara",86749,207,86749,,"CARJITI",378,"Caminul Cultural Satul Cherghes",85,58,54,4,0,58,0,100,42,27,31,3,8832,0
22,"Hunedoara",86749,207,86749,,"CARJITI",379,"Caminul Cultural Satul Popesti",130,91,85,6,0,91,0,151,60,38,53,3,8832,0
22,"Hunedoara",86749,207,86749,,"CARJITI",380,"Caminul Cultural Satul Almasu Sec",154,98,93,5,0,98,0,170,72,53,45,3,8832,0
22,"Hunedoara",86749,207,86749,,"CARJITI",381,"Caminul Cultural Satul Cozia",133,59,55,4,0,59,0,150,91,30,29,3,8832,0
22,"Hunedoara",86749,207,86749,,"CARJITI",382,"Scoala Generala clasele I-IV, sala de clasa, sat Cirjiti nr. 1, CP 337175",0,55,0,55,0,54,1,150,95,29,25,3,8832,1
22,"Hunedoara",87362,207,87362,,"CRISCIOR",383,"Scoala Generala nr. 1 Criscior, sala de Sport",1518,812,805,7,0,806,6,1650,838,298,508,3,8857,0
22,"Hunedoara",87362,207,87362,,"CRISCIOR",384,"Grup Scolar ""Crisan"" Criscior",1226,782,729,53,0,777,5,1350,568,258,519,3,8857,0
22,"Hunedoara",87362,207,87362,,"CRISCIOR",385,"Scoala Primara Zdrapti",804,481,473,8,0,476,5,900,419,195,281,3,8857,0
22,"Hunedoara",87362,207,87362,,"CRISCIOR",386,"Scoala Generala Criscior, sat Criscior, str. Luncii nr. 8, CP 337200",0,75,0,75,0,75,0,130,55,24,51,3,8857,1
22,"Hunedoara",89348,207,89348,,"DENSUS",387,"Scoala Generala Densus",509,363,338,8,17,357,6,560,197,128,229,3,8862,0
22,"Hunedoara",89348,207,89348,,"DENSUS",388,"Caminul Cultural Pesteana",314,225,207,6,12,224,1,350,125,104,120,3,8862,0
22,"Hunedoara",89348,207,89348,,"DENSUS",389,"Scoala Primara Pestenita",252,152,145,6,1,152,0,280,128,52,100,3,8862,0
22,"Hunedoara",89348,207,89348,,"DENSUS",390,"Caminul Cultural Stei",185,134,119,7,8,133,1,200,66,41,92,3,8862,0
22,"Hunedoara",89348,207,89348,,"DENSUS",391,"Scoala Primara Poieni",86,76,68,5,3,74,2,100,24,10,64,3,8862,0
22,"Hunedoara",89348,207,89348,,"DENSUS",392,"Caminul Cultural Densus, sat Densus nr. 31, CP 337205",0,69,0,69,0,69,0,130,61,30,39,3,8862,1
22,"Hunedoara",89428,207,89428,,"DOBRA",393,"Caminul Cultural Dobra, Piata Victoriei, nr. 5",1374,782,759,6,17,772,10,1450,668,344,428,3,8870,0
22,"Hunedoara",89428,207,89428,,"DOBRA",394,"Caminul Cultural Lapusnic, nr. 14",401,280,258,7,15,278,2,449,169,170,108,3,8870,0
22,"Hunedoara",89428,207,89428,,"DOBRA",395,"Caminul Cultural Radulesti, nr. 14",184,145,134,6,5,144,1,200,55,74,70,3,8870,0
22,"Hunedoara",89428,207,89428,,"DOBRA",396,"Caminul Cultural Stancesti,  nr. 45",109,75,67,8,0,74,1,130,55,24,50,3,8870,0
22,"Hunedoara",89428,207,89428,,"DOBRA",397,"Scoala Generala Roscani, nr. 92",615,370,346,6,18,368,2,680,310,164,204,3,8870,0
22,"Hunedoara",89428,207,89428,,"DOBRA",398,"Caminul Cultural Panc, nr. 84",189,119,109,6,4,119,0,210,91,76,43,3,8870,0
22,"Hunedoara",89428,207,89428,,"DOBRA",399,"Scoala Generala Dobra, sat Dobra, str. Lugojului nr. 28, CP 337215",0,213,0,213,0,212,1,250,37,107,105,3,8870,1
22,"Hunedoara",91731,207,91731,,"GENERAL BERTHELOT",400,"Sala de Sedinta a Primariei General Berthelot",582,352,350,2,0,346,6,637,285,142,204,3,8884,0
22,"Hunedoara",91731,207,91731,,"GENERAL BERTHELOT",401,"Scoala Primara Tustea, nr. 39",249,178,168,10,0,178,0,280,102,94,84,3,8884,0
22,"Hunedoara",91731,207,91731,,"GENERAL BERTHELOT",402,"Scoala Primara General Berthelot, sat General Berthelot nr. 33, CP 337235",0,31,0,31,0,31,0,70,39,14,17,3,8884,1
22,"Hunedoara",86883,207,86883,,"GHELARI",403,"Sala de Sedinte a Primariei comunei Ghelari, str. Rusca, nr. 5, Satul Ghelari",670,356,350,5,1,350,6,750,394,131,219,3,8890,0
22,"Hunedoara",86883,207,86883,,"GHELARI",404,"Clubul ""Minerul "", cartier Cut, Satul Ghelari",944,414,406,8,0,411,3,1050,636,126,285,3,8890,0
22,"Hunedoara",86883,207,86883,,"GHELARI",405,"Caminul Cultural Ruda, sala mare",160,93,86,7,0,91,2,180,87,26,65,3,8890,0
22,"Hunedoara",86883,207,86883,,"GHELARI",406,"Magazinul ABC Plop, sala mica",30,23,17,6,0,22,1,40,17,11,11,3,8890,0
22,"Hunedoara",86883,207,86883,,"GHELARI",407,"Fostul Dispensar uman Satul Govajdia",87,48,39,9,0,47,1,100,52,23,24,3,8890,0
22,"Hunedoara",86883,207,86883,,"GHELARI",408,"Caminul Cultural Catun Manastire",44,46,36,10,0,46,0,50,4,23,23,3,8890,0
22,"Hunedoara",86883,207,86883,,"GHELARI",409,"Centrul de Zi Ghelari - sala de clasa, sat Ghelari, str. Rusca nr. 50, CP 337240",0,56,0,56,0,55,1,130,74,27,28,3,8890,1
22,"Hunedoara",89687,207,89687,,"GURASADA",410,"Sala de Sedinta, Primaria comunei Gurasada",711,429,422,7,0,423,6,780,351,118,305,3,8895,0
22,"Hunedoara",89687,207,89687,,"GURASADA",411,"Caminul Cultural Campuri Surduc, sala mica",395,220,214,6,0,216,4,450,230,63,153,3,8895,0
22,"Hunedoara",89687,207,89687,,"GURASADA",412,"Scoala Generala Boiu de Sus, sala mica",142,106,97,9,0,104,2,160,54,20,84,3,8895,0
22,"Hunedoara",89687,207,89687,,"GURASADA",413,"Scoala Generala Carmazanesti, sala mica",135,88,78,10,0,86,2,150,62,32,54,3,8895,0
22,"Hunedoara",89687,207,89687,,"GURASADA",414,"Sediul Scolii Generale clasele I-IV Campuri Surduc, sat Campuri Surduc nr. 122, DN7, CP 337251",0,85,0,85,0,84,1,130,45,30,54,3,8895,1
22,"Hunedoara",89801,207,89801,,"HARAU",415,"Caminul Cultural Harau, sala de Club",597,358,346,12,0,355,3,650,292,171,184,3,8907,0
22,"Hunedoara",89801,207,89801,,"HARAU",416,"Scoala Generala Birsau, sala de clasa",426,249,240,9,0,249,0,457,208,122,127,3,8907,0
22,"Hunedoara",89801,207,89801,,"HARAU",417,"Scoala Primara Chimindia, sala de clasa",295,180,172,8,0,174,6,339,159,67,107,3,8907,0
22,"Hunedoara",89801,207,89801,,"HARAU",418,"Caminul Cultural Banpotoc, sala Mare",390,250,243,7,0,247,3,442,192,127,120,3,8907,0
22,"Hunedoara",89801,207,89801,,"HARAU",419,"Caminul Cultural Harau, sat Harau, CP 337265",0,77,0,77,0,77,0,100,23,40,37,3,8907,1
22,"Hunedoara",89856,207,89856,,"ILIA",420,"Caminul Cultural Ilia, str. Libertatii, nr. 16",1492,1018,974,5,39,1000,18,1650,632,607,393,3,8912,0
22,"Hunedoara",89856,207,89856,,"ILIA",421,"Caminul Cultural Bretea Muresana, nr. 153",513,371,360,11,0,366,5,559,188,205,161,3,8912,0
22,"Hunedoara",89856,207,89856,,"ILIA",422,"Scoala Primara Sarbi, nr. 93",382,288,276,12,0,279,9,408,120,201,78,3,8912,0
22,"Hunedoara",89856,207,89856,,"ILIA",423,"Caminul Cultural Valea Lunga, nr. 32",117,85,80,5,0,84,1,130,45,50,34,3,8912,0
22,"Hunedoara",89856,207,89856,,"ILIA",424,"Caminul Cultural Bacea, nr. 63",294,214,209,5,0,209,5,332,118,168,41,3,8912,0
22,"Hunedoara",89856,207,89856,,"ILIA",425,"Caminul Cultural Braznic, nr. 44",223,171,158,4,9,170,1,260,89,126,44,3,8912,0
22,"Hunedoara",89856,207,89856,,"ILIA",426,"Caminul Cultural Sacamasa, nr. 103",214,178,146,11,21,173,5,250,72,126,47,3,8912,0
22,"Hunedoara",89856,207,89856,,"ILIA",427,"Caminul Cultural Ilia, sat Ilia, str. Libertatii, nr. 16, CP 337270",0,278,0,278,0,276,2,502,224,171,105,3,8912,1
22,"Hunedoara",89954,207,89954,,"LAPUGIU DE JOS",428,"Caminul Cultural Lapugiu de Jos",433,196,190,6,0,193,3,480,284,104,89,3,8922,0
22,"Hunedoara",89954,207,89954,,"LAPUGIU DE JOS",429,"Caminul Cultural Ohaba",433,234,227,7,0,231,3,480,246,84,147,3,8922,0
22,"Hunedoara",89954,207,89954,,"LAPUGIU DE JOS",430,"Caminul Cultural Lapugiu de Sus",335,217,209,8,0,214,3,370,153,92,122,3,8922,0
22,"Hunedoara",89954,207,89954,,"LAPUGIU DE JOS",431,"Primaria Lapugiu de Jos, sat Lapugiu de Jos, CP 337280",0,115,0,115,0,115,0,150,35,63,52,3,8922,1
22,"Hunedoara",90066,207,90066,,"LELESE",432,"Scoala Primara Lelese nr. 20",170,99,90,4,5,98,1,200,101,25,73,3,8933,0
22,"Hunedoara",90066,207,90066,,"LELESE",433,"Caminul Cultural Cerisor nr. 89",95,68,60,8,0,67,1,110,42,19,48,3,8933,0
22,"Hunedoara",90066,207,90066,,"LELESE",434,"Caminul Cultural Runcu Mare nr. 25",113,61,55,6,0,60,1,130,69,26,34,3,8933,0
22,"Hunedoara",90066,207,90066,,"LELESE",435,"Caminul Cultural Lelese, sat Lelese nr. 72, CP 337295",0,21,0,21,0,21,0,50,29,9,12,3,8933,1
22,"Hunedoara",90119,207,90119,,"LUNCA CERNII DE JOS",436,"Scoala Generala Lunca Cernii de Jos, sala de sport",408,206,200,6,0,205,1,449,243,130,75,3,8938,0
22,"Hunedoara",90119,207,90119,,"LUNCA CERNII DE JOS",437,"Scoala Primara Negoiu",185,82,76,6,0,82,0,200,118,48,34,3,8938,0
22,"Hunedoara",90119,207,90119,,"LUNCA CERNII DE JOS",438,"Scoala Primara Meria",260,145,139,6,0,145,0,300,155,115,30,3,8938,0
22,"Hunedoara",90119,207,90119,,"LUNCA CERNII DE JOS",439,"Scoala Generala clasele I-VIII Lunca Cernii de Jos, sat Lunca Cernii de Jos nr. 19, CP 337300",0,36,0,36,0,36,0,50,14,21,15,3,8938,1
22,"Hunedoara",90208,207,90208,,"LUNCOIU DE JOS",440,"Caminul Cultural Luncoiu de Jos, nr.124A",909,552,544,8,0,546,6,1000,448,205,341,3,8947,0
22,"Hunedoara",90208,207,90208,,"LUNCOIU DE JOS",441,"Caminul Cultural Luncoiu de Sus, nr.57A",690,438,428,10,0,437,1,746,308,132,305,3,8947,0
22,"Hunedoara",90208,207,90208,,"LUNCOIU DE JOS",442,"Scoala Generala Luncoiu de Jos, sala de clasa, sat Luncoiu de Jos nr. 123A, CP 337310",0,50,0,50,0,50,0,90,40,22,28,3,8947,1
22,"Hunedoara",90262,207,90262,,"MARTINESTI",443,"Caminul Cultural Martinesti, nr. 30",217,146,129,7,10,142,4,242,96,88,54,3,8953,0
22,"Hunedoara",90262,207,90262,,"MARTINESTI",444,"Caminul Cultural Dancu Mare, nr. 112",214,162,139,5,18,161,1,231,69,102,59,3,8953,0
22,"Hunedoara",90262,207,90262,,"MARTINESTI",445,"Caminul Cultural Dancu Mic,  nr. 25",108,82,61,8,13,82,0,120,38,65,17,3,8953,0
22,"Hunedoara",90262,207,90262,,"MARTINESTI",446,"Caminul Cultural Jeledinti,  nr. 78",223,135,114,4,17,135,0,248,113,91,44,3,8953,0
22,"Hunedoara",90262,207,90262,,"MARTINESTI",447,"Caminul Cultural Tamasasa, nr. 55",104,66,53,7,6,64,2,120,54,35,29,3,8953,0
22,"Hunedoara",90262,207,90262,,"MARTINESTI",448,"Scoala Primara clasele I-IV Martinesti, sala nr. 1, sat Martinesti, CP 337315",0,164,0,164,0,162,2,200,36,128,34,3,8953,1
22,"Hunedoara",90342,207,90342,,"ORASTIOARA DE SUS",449,"Caminul Cultural Orastioara de Sus, nr. 45",408,244,237,6,1,244,0,454,210,154,90,3,8961,0
22,"Hunedoara",90342,207,90342,,"ORASTIOARA DE SUS",450,"Scoala Primara Bucium, sala de clasa",286,171,165,6,0,169,2,321,150,98,71,3,8961,0
22,"Hunedoara",90342,207,90342,,"ORASTIOARA DE SUS",451,"Scoala Primara Ludestii de Jos, sala de clasa",285,151,145,6,0,150,1,320,169,94,56,3,8961,0
22,"Hunedoara",90342,207,90342,,"ORASTIOARA DE SUS",452,"Caminul Cultural Costesti",457,266,261,5,0,262,4,497,231,136,126,3,8961,0
22,"Hunedoara",90342,207,90342,,"ORASTIOARA DE SUS",453,"Scoala Primara Gradistea de Munte, nr. 1, sala de clasa",143,63,55,8,0,63,0,160,97,28,35,3,8961,0
22,"Hunedoara",90342,207,90342,,"ORASTIOARA DE SUS",454,"Scoala Primara Ocolisu Mic, nr. 105, sala de clasa",317,199,197,2,0,197,2,350,151,147,50,3,8961,0
22,"Hunedoara",90342,207,90342,,"ORASTIOARA DE SUS",455,"Scoala Primara Ludestii de Jos, sat Ludestii de Jos nr. 6, CP 337331",0,60,0,60,0,60,0,100,40,36,24,3,8961,1
22,"Hunedoara",90431,207,90431,,"PESTISU MIC",456,"Scoala Primara Pestisu Mic, str. Principala nr. 64A",153,114,103,10,1,114,0,170,56,57,57,3,8970,0
22,"Hunedoara",90431,207,90431,,"PESTISU MIC",457,"Caminul Cultural Almasu Mic, nr. 35A",60,48,43,4,1,47,1,70,22,26,21,3,8970,0
22,"Hunedoara",90431,207,90431,,"PESTISU MIC",458,"Caminul Cultural Ciulpaz, nr. 29",100,71,62,9,0,70,1,110,39,28,42,3,8970,0
22,"Hunedoara",90431,207,90431,,"PESTISU MIC",459,"Scoala Primara Josani nr. 29",169,123,119,3,1,118,1,190,71,70,48,3,8970,0
22,"Hunedoara",90431,207,90431,,"PESTISU MIC",460,"Scoala Primara Manerau, nr. 10",245,172,163,6,3,169,3,270,98,60,109,3,8970,0
22,"Hunedoara",90431,207,90431,,"PESTISU MIC",461,"Scoala Primara Nandru nr. 1",147,108,103,5,0,107,1,161,53,61,46,3,8970,0
22,"Hunedoara",90431,207,90431,,"PESTISU MIC",462,"Scoala Primara Valea Nandrului, nr. 20",127,90,81,9,0,89,1,140,50,45,44,3,8970,0
22,"Hunedoara",90431,207,90431,,"PESTISU MIC",463,"Dispensarul uman Pestisu Mic, sat Pestisu Mic nr. 64B, CP 337335",0,57,0,57,0,57,0,181,124,28,29,3,8970,1
22,"Hunedoara",90538,207,90538,,"PUI",464,"Scoala Generala Pui, str.Republicii",689,380,372,4,4,379,1,750,370,182,197,3,8980,0
22,"Hunedoara",90538,207,90538,,"PUI",465,"Scoala Primara Rusor",245,178,170,7,1,176,2,270,92,68,108,3,8980,0
22,"Hunedoara",90538,207,90538,,"PUI",466,"Scoala Primara Baiesti",194,123,118,4,1,122,1,220,97,66,56,3,8980,0
22,"Hunedoara",90538,207,90538,,"PUI",467,"Scoala Primara Galati",391,262,261,1,0,260,2,427,165,94,166,3,8980,0
22,"Hunedoara",90538,207,90538,,"PUI",468,"Scoala Primara Fizesti",316,172,166,6,0,171,1,350,178,69,102,3,8980,0
22,"Hunedoara",90538,207,90538,,"PUI",469,"Scoala Primara Serel",384,235,226,9,0,233,2,420,185,62,171,3,8980,0
22,"Hunedoara",90538,207,90538,,"PUI",470,"Scoala Primara Riu Barbat",158,126,106,13,7,125,1,180,54,41,84,3,8980,0
22,"Hunedoara",90538,207,90538,,"PUI",471,"Scoala Primara Hobita",136,105,98,7,0,105,0,150,45,23,82,3,8980,0
22,"Hunedoara",90538,207,90538,,"PUI",472,"Scoala Primara Uric",231,163,156,6,1,163,0,250,87,65,98,3,8980,0
22,"Hunedoara",90538,207,90538,,"PUI",473,"Scoala Primara Ponor",364,216,214,2,0,215,1,400,184,89,126,3,8980,0
22,"Hunedoara",90538,207,90538,,"PUI",474,"Scoala Primara Ohaba Ponor",245,156,150,6,0,156,0,270,114,117,39,3,8980,0
22,"Hunedoara",90538,207,90538,,"PUI",475,"Caminul Cultural Federi",252,107,103,4,0,107,0,300,193,65,42,3,8980,0
22,"Hunedoara",90538,207,90538,,"PUI",476,"Caminul Cultural Pui, sat Pui, str. Republicii nr. 65, CP 337345",0,117,0,117,0,116,1,300,183,47,69,3,8980,1
22,"Hunedoara",90663,207,90663,,"RAPOLTU MARE",477,"Sediul Primariei Rapoltu Mare, sala Festiva",749,464,457,7,0,463,1,850,386,292,171,3,9001,0
22,"Hunedoara",90663,207,90663,,"RAPOLTU MARE",478,"Scoala Primara Bobalna",421,248,242,6,0,248,0,456,208,137,111,3,9001,0
22,"Hunedoara",90663,207,90663,,"RAPOLTU MARE",479,"Caminul Cultural Folt",141,90,81,9,0,89,1,160,70,60,29,3,9001,0
22,"Hunedoara",90663,207,90663,,"RAPOLTU MARE",480,"Scoala Primara Boiu",143,85,79,6,0,84,1,160,75,48,36,3,9001,0
22,"Hunedoara",90663,207,90663,,"RAPOLTU MARE",481,"Caminul Cultural Rapoltel",188,119,112,7,0,118,1,219,100,67,51,3,9001,0
22,"Hunedoara",90663,207,90663,,"RAPOLTU MARE",482,"Scoala Generala Rapoltu Mare, sat Rapoltu Mare nr. 45, CP 337365",0,102,0,102,0,102,0,151,49,54,48,3,9001,1
22,"Hunedoara",90725,207,90725,,"RACHITOVA",483,"Caminul Cultural Rachitova",582,354,350,1,3,344,10,650,296,152,192,3,8993,0
22,"Hunedoara",90725,207,90725,,"RACHITOVA",484,"Scoala Primara Boita",399,290,286,4,0,289,1,450,160,190,99,3,8993,0
22,"Hunedoara",90725,207,90725,,"RACHITOVA",485,"Scoala Primara Valioara",212,134,130,4,0,131,3,240,106,72,59,3,8993,0
22,"Hunedoara",90725,207,90725,,"RACHITOVA",486,"Scoala Generala Rachitova, sat Rachitova nr. 22, CP 337370",0,68,0,68,0,67,1,140,72,53,14,3,8993,1
22,"Hunedoara",90805,207,90805,,"RIBITA",487,"Caminul Cultural Ribita, nr. 21",542,393,382,7,4,389,4,600,207,167,222,3,9019,0
22,"Hunedoara",90805,207,90805,,"RIBITA",488,"Scoala Primara clasele I-IV ""Vlaicu Barna""",422,314,295,4,15,311,3,441,127,134,177,3,9019,0
22,"Hunedoara",90805,207,90805,,"RIBITA",489,"Caminul Cultural Dumbrava de Jos. Nr. 65",170,143,128,8,7,140,3,200,57,106,34,3,9019,0
22,"Hunedoara",90805,207,90805,,"RIBITA",490,"Scoala Primara Dumbrava de Sus, nr. 85",57,39,29,10,0,39,0,70,31,30,9,3,9019,0
22,"Hunedoara",90805,207,90805,,"RIBITA",491,"Caminul Cultural Uibaresti, nr. 28",66,60,52,7,1,59,1,80,20,37,22,3,9019,0
22,"Hunedoara",90805,207,90805,,"RIBITA",492,"Scoala Generala clasele I-VIII ""Preot Iosif Comsa"" Ribita, sat Ribita nr. 40, CP 337400",0,65,0,65,0,64,1,150,85,42,22,3,9019,1
22,"Hunedoara",90878,207,90878,,"RAU DE MORI",493,"Scoala Generala Rau de Mori",881,538,531,7,0,530,8,950,412,259,271,3,9007,0
22,"Hunedoara",90878,207,90878,,"RAU DE MORI",494,"Scoala Generala Clopotiva",714,435,433,2,0,430,5,800,365,157,273,3,9007,0
22,"Hunedoara",90878,207,90878,,"RAU DE MORI",495,"Scoala Generala Unciuc",162,130,126,4,0,130,0,180,50,53,77,3,9007,0
22,"Hunedoara",90878,207,90878,,"RAU DE MORI",496,"Scoala Generala Valea Daljii",218,157,150,7,0,157,0,250,93,90,67,3,9007,0
22,"Hunedoara",90878,207,90878,,"RAU DE MORI",497,"Scoala Generala Ostrov",419,289,280,9,0,286,3,450,161,138,148,3,9007,0
22,"Hunedoara",90878,207,90878,,"RAU DE MORI",498,"Scoala Generala Sibisel",310,205,194,11,0,201,4,350,145,76,125,3,9007,0
22,"Hunedoara",90878,207,90878,,"RAU DE MORI",499,"Scoala Generala clasele I-VIII Rau de Mori, sat Rau de Mori, str. Principala nr. 26, CP 337380",0,101,0,101,0,100,1,200,99,48,52,3,9007,1
22,"Hunedoara",90994,207,90994,,"ROMOS",500,"Scoala Generala clasele I-IV Romos",978,616,601,5,10,609,7,1050,434,308,301,3,9026,0
22,"Hunedoara",90994,207,90994,,"ROMOS",501,"Scoala Generala clasele  I-IV Romosel",655,397,381,7,9,389,8,700,303,308,81,3,9026,0
22,"Hunedoara",90994,207,90994,,"ROMOS",502,"Scoala general clasele I-IV Vaidei, str.Principala",538,354,328,6,20,351,3,600,246,224,127,3,9026,0
22,"Hunedoara",90994,207,90994,,"ROMOS",503,"Scoala Generala, clasele I-IV Pischinti",191,135,130,5,0,134,1,250,115,82,52,3,9026,0
22,"Hunedoara",90994,207,90994,,"ROMOS",504,"Scoala Generala clasele I-IV Romos, sat Romos nr. 317, CP 337410",0,108,0,108,0,108,0,190,82,64,44,3,9026,1
22,"Hunedoara",91054,207,91054,,"SARMIZEGETUSA",505,"Scoala Generala  Sarmizegetusa",501,387,367,0,20,387,0,550,163,117,270,3,9054,0
22,"Hunedoara",91054,207,91054,,"SARMIZEGETUSA",506,"Scoala Primara Breazova",149,123,116,5,2,120,3,168,45,44,76,3,9054,0
22,"Hunedoara",91054,207,91054,,"SARMIZEGETUSA",507,"Scoala Primara Hobita",123,110,96,8,6,110,0,140,30,23,87,3,9054,0
22,"Hunedoara",91054,207,91054,,"SARMIZEGETUSA",508,"Scoala Primara Paucinesti",164,147,129,13,5,143,4,180,33,52,91,3,9054,0
22,"Hunedoara",91054,207,91054,,"SARMIZEGETUSA",509,"Caminul Cultural Zeicani",135,98,86,12,0,98,0,150,52,55,43,3,9054,0
22,"Hunedoara",91054,207,91054,,"SARMIZEGETUSA",510,"Scoala Generala clasele I-VIII Sarmizegetusa, sat Sarmizegetusa, str. Principala nr. 1, CP 337415",0,47,0,47,0,46,1,200,153,20,26,3,9054,1
22,"Hunedoara",91116,207,91116,,"SALASU DE SUS",511,"Sala Consiliului local Salasu de Sus",487,287,283,4,0,282,5,524,237,148,134,3,9032,0
22,"Hunedoara",91116,207,91116,,"SALASU DE SUS",512,"Scoala Generala Salasu de Jos",197,126,120,6,0,125,1,218,92,46,79,3,9032,0
22,"Hunedoara",91116,207,91116,,"SALASU DE SUS",513,"Scoala Generala Ohaba de Sub Piatra",175,101,96,5,0,100,1,200,99,55,45,3,9032,0
22,"Hunedoara",91116,207,91116,,"SALASU DE SUS",514,"Scoala Generala Rau Alb",163,103,98,5,0,103,0,180,77,28,75,3,9032,0
22,"Hunedoara",91116,207,91116,,"SALASU DE SUS",515,"Caminul Cultural Coroiesti",167,117,113,4,0,116,1,179,62,40,76,3,9032,0
22,"Hunedoara",91116,207,91116,,"SALASU DE SUS",516,"Scoala Generala Paros",319,209,205,4,0,206,3,349,140,88,118,3,9032,0
22,"Hunedoara",91116,207,91116,,"SALASU DE SUS",517,"Scoala Generala Nucsoara",262,146,139,7,0,144,2,290,144,71,73,3,9032,0
22,"Hunedoara",91116,207,91116,,"SALASU DE SUS",518,"Caminul Cultural Malaiesti",128,104,99,5,0,102,2,149,45,46,56,3,9032,0
22,"Hunedoara",91116,207,91116,,"SALASU DE SUS",519,"Caminul Cultural Zavoi",96,79,72,7,0,77,2,110,31,33,44,3,9032,0
22,"Hunedoara",91116,207,91116,,"SALASU DE SUS",520,"Scoala Generala Rau Mic",148,117,112,5,0,114,3,170,53,53,61,3,9032,0
22,"Hunedoara",91116,207,91116,,"SALASU DE SUS",521,"Scoala Generala clasele I-IV Ohaba de sub Piatra, sat Ohaba de sub Piatra nr. 108b, CP 337424",0,92,0,92,0,91,1,200,108,41,50,3,9032,1
22,"Hunedoara",91232,207,91232,,"SANTAMARIA-ORLEA",522,"Caminul Cultural Santamaria-Orlea",581,368,362,3,3,366,2,630,262,162,204,3,9044,0
22,"Hunedoara",91232,207,91232,,"SANTAMARIA-ORLEA",523,"Scoala Primara Subcetate",466,299,293,6,0,298,1,499,200,99,199,3,9044,0
22,"Hunedoara",91232,207,91232,,"SANTAMARIA-ORLEA",524,"Caminul Cultural Bucium-Orlea",166,128,122,6,0,126,2,190,62,45,81,3,9044,0
22,"Hunedoara",91232,207,91232,,"SANTAMARIA-ORLEA",525,"Scoala Primara Balomir",268,190,182,5,3,189,1,293,103,80,109,3,9044,0
22,"Hunedoara",91232,207,91232,,"SANTAMARIA-ORLEA",526,"Scoala Primara Ciopeia",357,211,197,6,8,206,5,422,211,56,150,3,9044,0
22,"Hunedoara",91232,207,91232,,"SANTAMARIA-ORLEA",527,"Scoala Primara Barastii Hategului",321,202,197,5,0,202,0,336,134,89,113,3,9044,0
22,"Hunedoara",91232,207,91232,,"SANTAMARIA-ORLEA",528,"Scoala Speciala Sacel",259,158,151,7,0,156,2,281,123,94,62,3,9044,0
22,"Hunedoara",91232,207,91232,,"SANTAMARIA-ORLEA",529,"Scoala Primara Sanpetru",216,164,152,12,0,163,1,278,114,62,101,3,9044,0
22,"Hunedoara",91232,207,91232,,"SANTAMARIA-ORLEA",530,"Caminul Cultural Santamaria-Orlea, sala de Sedinte a Consiliului local, sat Santamaria-Orlea nr. 128, CP 337440",0,135,0,135,0,132,3,221,86,76,56,3,9044,1
22,"Hunedoara",91330,207,91330,,"SOIMUS",531,"Caminul Cultural, sala mare, Sat Soimus, nr. 310 A",1030,614,604,10,0,601,13,1098,484,231,370,3,9060,0
22,"Hunedoara",91330,207,91330,,"SOIMUS",532,"Caminul Cultural, sala mare, Sat Balata, nr. 37",330,212,204,8,0,210,2,393,181,73,137,3,9060,0
22,"Hunedoara",91330,207,91330,,"SOIMUS",533,"Caminul Cultural, sala mare, Sat Boholt, nr. 39",278,204,196,8,0,200,4,298,94,95,105,3,9060,0
22,"Hunedoara",91330,207,91330,,"SOIMUS",534,"Scoala Primara, sala de clasa, Sat Fornadia, nr. 70",190,124,116,8,0,124,0,238,114,37,87,3,9060,0
22,"Hunedoara",91330,207,91330,,"SOIMUS",535,"Scoala Primara, sala mare, Sat Sulighete, nr. 88 A",240,187,177,10,0,183,4,282,95,56,127,3,9060,0
22,"Hunedoara",91330,207,91330,,"SOIMUS",536,"Caminul Cultural Sat Bejan",549,363,355,8,0,355,8,600,237,158,197,3,9060,0
22,"Hunedoara",91330,207,91330,,"SOIMUS",537,"Caminul Cultural, sala mare, Sat Chiscadaga, nr. 94",319,207,201,6,0,204,3,335,128,101,103,3,9060,0
22,"Hunedoara",91330,207,91330,,"SOIMUS",538,"Caminul Cultural Soimus, sediul Casei Casatoriilor, sat Soimus nr. 310A, CP 337450",0,283,0,283,0,282,1,374,91,74,208,3,9060,1
22,"Hunedoara",86936,207,86936,,"TELIUCU INFERIOR",539,"Primaria comunei Teliucu Inferior, str. Minei, nr. 2",1206,729,711,14,4,720,9,1300,571,275,445,3,9071,0
22,"Hunedoara",86936,207,86936,,"TELIUCU INFERIOR",540,"Scoala Primara, clasele I-IV, Cincis Cerna str. Principala, nr. 31",581,394,383,11,0,392,2,650,256,152,240,3,9071,0
22,"Hunedoara",86936,207,86936,,"TELIUCU INFERIOR",541,"Caminul Cultural Izvoarele",108,79,74,5,0,78,1,120,41,22,56,3,9071,0
22,"Hunedoara",86936,207,86936,,"TELIUCU INFERIOR",542,"Scoala Primara clasele I-IV  Teliucu Superior",114,85,80,4,1,84,1,130,45,30,54,3,9071,0
22,"Hunedoara",86936,207,86936,,"TELIUCU INFERIOR",543,"Scoala Primara clasele I-IV  Teliucu Superior",143,98,92,6,0,98,0,160,62,33,65,3,9071,0
22,"Hunedoara",86936,207,86936,,"TELIUCU INFERIOR",544,"Scoala Generala clasele I-IV Teliucu Inferior, sat Teliucu Inferior, str. Minei nr. 1, CP 337465",0,87,0,87,0,86,1,200,113,43,43,3,9071,1
22,"Hunedoara",91447,207,91447,,"TOMESTI",545,"Sediul Primariei comunei Tomesti, str. Principala, nr. 50",511,300,295,5,0,300,0,550,250,138,162,3,9076,0
22,"Hunedoara",91447,207,91447,,"TOMESTI",546,"Caminul Cultural Dobrot",377,248,247,1,0,245,3,420,172,98,147,3,9076,0
22,"Hunedoara",91447,207,91447,,"TOMESTI",547,"Scoala Primara Livada, sala de clasa",107,72,66,6,0,71,1,130,58,15,56,3,9076,0
22,"Hunedoara",91447,207,91447,,"TOMESTI",548,"Caminul Cultural Tomesti, sat Tomesti, str. Principala nr. 52, CP 337470",0,27,0,27,0,27,0,70,43,11,16,3,9076,1
22,"Hunedoara",91535,207,91535,,"TOPLITA",549,"Primaria comunei Toplita",154,93,87,4,2,91,2,173,80,32,59,3,9085,0
22,"Hunedoara",91535,207,91535,,"TOPLITA",550,"Caminul Cultural Hasdau",321,204,200,2,2,199,5,354,150,92,107,3,9085,0
22,"Hunedoara",91535,207,91535,,"TOPLITA",551,"Caminul Cultural Dabaca",145,87,76,8,3,87,0,161,74,30,57,3,9085,0
22,"Hunedoara",91535,207,91535,,"TOPLITA",552,"Caminul Cultural Dealu Mic",41,35,27,8,0,35,0,50,15,13,22,3,9085,0
22,"Hunedoara",91535,207,91535,,"TOPLITA",553,"Caminul Cultural Valari",38,38,29,9,0,37,1,50,12,18,19,3,9085,0
22,"Hunedoara",91535,207,91535,,"TOPLITA",554,"Caminul Cultural Goles",11,16,6,10,0,16,0,20,4,4,12,3,9085,0
22,"Hunedoara",91535,207,91535,,"TOPLITA",555,"Caminul Cultural Toplita, sat Toplita, str. Principala nr. 52, CP 337480",0,66,0,66,0,66,0,210,144,19,47,3,9085,1
22,"Hunedoara",91624,207,91624,,"TOTESTI",556,"Caminul Cultural Totesti",357,291,278,6,7,285,6,400,109,70,215,3,9094,0
22,"Hunedoara",91624,207,91624,,"TOTESTI",557,"Scoala Primara claseleI-IV Carnesti",412,320,313,2,5,316,4,450,130,101,215,3,9094,0
22,"Hunedoara",91624,207,91624,,"TOTESTI",558,"Scoala Primara claseleI-IV Reea",333,238,225,3,10,237,1,348,110,66,171,3,9094,0
22,"Hunedoara",91624,207,91624,,"TOTESTI",559,"Scoala Primara claseleI-IV Paclisa",458,318,301,7,10,313,5,500,182,73,240,3,9094,0
22,"Hunedoara",91624,207,91624,,"TOTESTI",560,"Scoala Primara clasele I-IV Totesti, sat Totesti, str. Principala nr. 54, CP 337490",0,116,0,116,0,112,4,160,44,22,90,3,9094,1
22,"Hunedoara",91688,207,91688,,"TURDAS",561,"Scoala Primara Turdas",435,319,288,10,21,310,9,471,152,224,86,3,9100,0
22,"Hunedoara",91688,207,91688,,"TURDAS",562,"Caminul Cultural Pricaz",761,415,409,3,3,409,6,830,415,231,178,3,9100,0
22,"Hunedoara",91688,207,91688,,"TURDAS",563,"sala de Sedinta Pricaz Fabrica",246,174,151,23,0,171,3,270,96,117,54,3,9100,0
22,"Hunedoara",91688,207,91688,,"TURDAS",564,"Scoala Primara Spini",205,125,114,8,3,124,1,231,106,88,36,3,9100,0
22,"Hunedoara",91688,207,91688,,"TURDAS",565,"Cladire inchiriata nr. 8, Rapas",44,39,32,6,1,38,1,60,21,26,12,3,9100,0
22,"Hunedoara",91688,207,91688,,"TURDAS",566,"Caminul Cultural Turdas, sat Turdas nr. 44, CP 337495",0,52,0,52,0,52,0,150,98,36,16,3,9100,1
22,"Hunedoara",91795,207,91795,,"VATA DE JOS",567,"Scoala Generala Vata de Jos",984,512,507,5,0,510,2,1050,538,199,311,3,9110,0
22,"Hunedoara",91795,207,91795,,"VATA DE JOS",568,"Scoala Primara Cazanesti",189,88,83,5,0,87,1,210,122,45,42,3,9110,0
22,"Hunedoara",91795,207,91795,,"VATA DE JOS",569,"Scoala Primara Prihodiste",349,222,216,6,0,215,7,404,182,56,159,3,9110,0
22,"Hunedoara",91795,207,91795,,"VATA DE JOS",570,"Scoala Primara Birtin",253,164,156,7,1,163,1,300,136,86,77,3,9110,0
22,"Hunedoara",91795,207,91795,,"VATA DE JOS",571,"Scoala Primara Tirnava de Cris",730,410,407,1,2,408,2,800,390,152,256,3,9110,0
22,"Hunedoara",91795,207,91795,,"VATA DE JOS",572,"Scoala Primara Ociu",441,208,204,4,0,207,1,485,277,105,102,3,9110,0
22,"Hunedoara",91795,207,91795,,"VATA DE JOS",573,"Scoala Primara Pravaleni",273,168,162,6,0,168,0,300,132,108,60,3,9110,0
22,"Hunedoara",91795,207,91795,,"VATA DE JOS",574,"Scoala Primara Ciungani",232,119,111,8,0,117,2,253,134,42,75,3,9110,0
22,"Hunedoara",91795,207,91795,,"VATA DE JOS",575,"Caminul Cultural Vata de Jos, sat Vata de Jos, str. Piata Motilor, CP 337500",0,73,0,73,0,71,2,200,127,39,32,3,9110,1
22,"Hunedoara",91937,207,91937,,"VALISOARA",576,"Caminul Cultural Valisoara, comuna Valisoara nr. 193",723,403,399,4,0,400,3,800,397,161,239,3,9105,0
22,"Hunedoara",91937,207,91937,,"VALISOARA",577,"Caminul Cultural Dealu Mare nr . 87",198,123,116,7,0,121,2,222,99,41,80,3,9105,0
22,"Hunedoara",91937,207,91937,,"VALISOARA",578,"Caminul Cultural Salistioara nr. 49",261,170,164,6,0,170,0,280,110,70,100,3,9105,0
22,"Hunedoara",91937,207,91937,,"VALISOARA",579,"Cladire administrativa Valisoara, sat Valisoara nr. 23, CP 337520",0,63,0,63,0,63,0,90,27,32,31,3,9105,1
22,"Hunedoara",91982,207,91982,,"VETEL",580,"Caminul Cultural Vetel",724,457,442,8,7,450,7,699,242,183,267,3,9124,0
22,"Hunedoara",91982,207,91982,,"VETEL",581,"Caminul Cultural Mintia",770,491,485,5,1,487,4,837,346,272,215,3,9124,0
22,"Hunedoara",91982,207,91982,,"VETEL",582,"Caminul Cultural Lesnic",442,290,280,7,3,283,7,480,190,150,133,3,9124,0
22,"Hunedoara",91982,207,91982,,"VETEL",583,"Scoala Primara Herepeia",100,76,70,6,0,75,1,120,44,42,33,3,9124,0
22,"Hunedoara",91982,207,91982,,"VETEL",584,"Scoala Primara Bretelin",38,27,16,11,0,27,0,50,23,8,19,3,9124,0
22,"Hunedoara",91982,207,91982,,"VETEL",585,"Scoala Generala Muncelu Mic",106,54,45,9,0,53,1,121,67,18,35,3,9124,0
22,"Hunedoara",91982,207,91982,,"VETEL",586,"Caminul Cultural Muncelu Mare",84,42,35,7,0,40,2,101,59,17,23,3,9124,0
22,"Hunedoara",91982,207,91982,,"VETEL",587,"Foaierul Caminului Cultural Vetel, sat Vetel, str. Mihai Eminescu nr. 20B, CP 337525",0,188,0,188,0,187,1,280,92,55,132,3,9124,1
22,"Hunedoara",92097,207,92097,,"VORTA",588,"Caminul Cultural Vorta nr. 103",160,100,97,3,0,95,5,180,80,34,61,3,9135,0
22,"Hunedoara",92097,207,92097,,"VORTA",589,"Scoala Primara Visca nr. 149",347,237,233,4,0,233,4,391,154,125,108,3,9135,0
22,"Hunedoara",92097,207,92097,,"VORTA",590,"Scoala Primara Valea Poienii nr. 35",137,83,83,0,0,82,1,150,67,20,62,3,9135,0
22,"Hunedoara",92097,207,92097,,"VORTA",591,"Imobilul cu nr. 9, Sat Coaja",152,99,94,5,0,95,4,170,71,34,61,3,9135,0
22,"Hunedoara",92097,207,92097,,"VORTA",592,"Scoala Generala clasele I-VIII Visca, sat Visca, CP 337547",0,67,0,67,0,66,1,70,3,37,29,3,9135,1
22,"Hunedoara",92177,207,92177,,"ZAM",593,"Caminul Cultural Zam, sala mica, str. Principala, nr. 283",580,326,322,3,1,320,6,631,305,149,171,3,9143,0
22,"Hunedoara",92177,207,92177,,"ZAM",594,"Caminul Cultural Poganesti nr. 37",256,129,125,4,0,129,0,280,151,72,57,3,9143,0
22,"Hunedoara",92177,207,92177,,"ZAM",595,"Caminul Cultural Almas-Saliste nr. 29, sala mare",163,95,88,7,0,92,3,173,78,50,42,3,9143,0
22,"Hunedoara",92177,207,92177,,"ZAM",596,"Caminul Cultural Godinesti nr. 7, sala mare",148,83,76,7,0,83,0,170,87,58,25,3,9143,0
22,"Hunedoara",92177,207,92177,,"ZAM",597,"Caminul Cultural Salciva nr. 7",419,203,199,4,0,202,1,440,237,100,102,3,9143,0
22,"Hunedoara",92177,207,92177,,"ZAM",598,"Caminul Cultural Zam, sala mare, sat Zam nr. 149, CP 337550",0,146,0,146,0,145,1,159,13,84,61,3,9143,1
23,"Ialomita",92658,216,92658,,"MUNICIPIUL SLOBOZIA",1,"GRUP SCOLAR AL. IOAN CUZA (LICEUL DE CONSTRUCTII) , STR. LACULUI ,NR.10",1365,743,600,9,134,724,19,1400,657,387,337,1,9158,0
23,"Ialomita",92658,216,92658,,"MUNICIPIUL SLOBOZIA",2,"GRUP SCOLAR AL. IOAN CUZA(LICEUL DE CONSTRUCTII), STR LACULUI NR.10",1182,599,587,12,0,599,0,1300,701,308,291,1,9158,0
23,"Ialomita",92658,216,92658,,"MUNICIPIUL SLOBOZIA",3,"SCOALA GENERALA NR.3, B-DUL UNIRII NR.14",1309,679,668,11,0,674,5,1400,721,345,329,1,9158,0
23,"Ialomita",92658,216,92658,,"MUNICIPIUL SLOBOZIA",4,"SCOALA GENERALA NR.3, B-DUL UNIRII NR.14",1075,519,506,13,0,516,3,1100,581,229,287,1,9158,0
23,"Ialomita",92658,216,92658,,"MUNICIPIUL SLOBOZIA",5,"COLEGIUL NATIONAL ""MIHAI VITEAZUL""(LICEUL DE MATEMATICA-FIZICA), B-DUL UNIRII NR.1",1360,749,735,13,1,744,5,1400,651,287,457,1,9158,0
23,"Ialomita",92658,216,92658,,"MUNICIPIUL SLOBOZIA",6,"LICEUL PEDAGOGIC MATEI BASARAB(SCOALA NORMALA) , B-DUL M BASARAB NR.3",1743,957,945,12,0,952,5,1800,843,466,486,1,9158,0
23,"Ialomita",92658,216,92658,,"MUNICIPIUL SLOBOZIA",7,"MUZEUL AGRICULTURII(AMBIANTA) , B-DUL MATEI BASARAB NR.2",1725,851,835,16,0,848,3,1784,933,375,473,1,9158,0
23,"Ialomita",92658,216,92658,,"MUNICIPIUL SLOBOZIA",8,"SCOALA GENERALA NR.6 , STR ALEEA PARCULUI NR. 8",1698,839,827,12,0,830,9,1800,961,380,450,1,9158,0
23,"Ialomita",92658,216,92658,,"MUNICIPIUL SLOBOZIA",9,"SCOALA GENERALA NR.6 , STR ALEEA PARCULUI NR. 8",1489,673,667,6,0,666,7,1600,927,302,364,1,9158,0
23,"Ialomita",92658,216,92658,,"MUNICIPIUL SLOBOZIA",10,"GRADINITA CU PROGRAM PRELUNGIT, STR. C.D.GHEREA , NR.4",1675,875,861,14,0,866,9,1800,925,374,492,1,9158,0
23,"Ialomita",92658,216,92658,,"MUNICIPIUL SLOBOZIA",11,"CLUBUL TINERETULUI, B-DUL CHIMIEI ,NR.10",1188,559,538,21,0,554,5,1300,741,248,306,1,9158,0
23,"Ialomita",92658,216,92658,,"MUNICIPIUL SLOBOZIA",12,"SEMINARUL TEOLOGIC, STR. ALEXANDRU ODOBESCU , NR.2",1154,681,660,12,9,676,5,1200,519,290,386,1,9158,0
23,"Ialomita",92658,216,92658,,"MUNICIPIUL SLOBOZIA",13,"SC PRORENT SA, B-DUL CHIMIEI NR.2",1630,797,780,16,1,786,11,1700,903,374,412,1,9158,0
23,"Ialomita",92658,216,92658,,"MUNICIPIUL SLOBOZIA",14,"LICEUL ""MIHAI EMINESCU""(LICEUL DE CHIMIE), ALEEA CHIMIEI NR.9",1371,632,613,13,6,626,6,1400,768,345,281,1,9158,0
23,"Ialomita",92658,216,92658,,"MUNICIPIUL SLOBOZIA",15,"SCOALA GENERALA NR.4, ALEEA SCOLII NR.2",1521,736,728,8,0,729,7,1600,864,364,365,1,9158,0
23,"Ialomita",92658,216,92658,,"MUNICIPIUL SLOBOZIA",16,"SCOALA GENERALA NR.4, ALEEA SCOLII NR.2",1818,794,783,11,0,785,9,1900,1106,421,364,1,9158,0
23,"Ialomita",92658,216,92658,,"MUNICIPIUL SLOBOZIA",17,"GRADINITA CU PROGRAM PRELUNGIT, STR.VECHEA MATCA",1616,920,893,26,1,912,8,1700,780,392,520,1,9158,0
23,"Ialomita",92658,216,92658,,"MUNICIPIUL SLOBOZIA",18,"S.C.E.L.I.F, STR. CUZA VODA NR.2",1599,844,828,16,0,837,7,1700,856,371,466,1,9158,0
23,"Ialomita",92658,216,92658,,"MUNICIPIUL SLOBOZIA",19,"SCOALA GENERALA NR.2, B-DUL M BASARAB NR.35",1772,928,913,14,1,926,2,1900,972,403,523,1,9158,0
23,"Ialomita",92658,216,92658,,"MUNICIPIUL SLOBOZIA",20,"SCOALA GENERALA NR.2, B-DUL M BASARAB NR.35",1647,958,934,24,0,948,10,1700,742,374,574,1,9158,0
23,"Ialomita",92658,216,92658,,"MUNICIPIUL SLOBOZIA",21,"SC DRUMURI SI PODURI IALOMITA, STR. RAZOARE, NR.1",1545,921,903,18,0,912,9,1600,679,382,530,1,9158,0
23,"Ialomita",92658,216,92658,,"MUNICIPIUL SLOBOZIA",22,"CERCUL MILITAR(CASA ARMATEI), B-DUL M BASARAB NR.52",1575,964,881,83,0,962,2,1600,636,418,544,1,9158,0
23,"Ialomita",92658,216,92658,,"MUNICIPIUL SLOBOZIA",23,"CLUBUL ELEVILOR, B-DUL M BASARAB NR.54",1457,820,807,11,2,815,5,1500,680,348,467,1,9158,0
23,"Ialomita",92658,216,92658,,"MUNICIPIUL SLOBOZIA",24,"SCOALA GENERALA NR.1(LOCAL NOU) , B-DUL M BASARAB NR.67",1050,599,589,10,0,594,5,1100,501,259,335,1,9158,0
23,"Ialomita",92658,216,92658,,"MUNICIPIUL SLOBOZIA",25,"SCOALA GENERALA NR.1(LOCAL ANEXA), B-DUL M BASARAB NR.69",1008,599,585,14,0,596,3,1100,501,272,324,1,9158,0
23,"Ialomita",92658,216,92658,,"MUNICIPIUL SLOBOZIA",26,"LICEUL DE ARTA , STR. MIHAI EMINESCU NR.3",1282,638,629,9,0,633,5,1400,762,322,311,1,9158,0
23,"Ialomita",92658,216,92658,,"MUNICIPIUL SLOBOZIA",27,"LICEUL DE ARTA , STR. MIHAI EMINESCU NR.3",1195,660,646,14,0,658,2,1200,540,283,375,1,9158,0
23,"Ialomita",92658,216,92658,,"MUNICIPIUL SLOBOZIA",28,"GRADINITA CU PROGRAM PRELUNGIT NR.3, STR.M EMINESCU NR.6",1443,769,759,10,0,768,1,1500,731,317,451,1,9158,0
23,"Ialomita",92658,216,92658,,"MUNICIPIUL SLOBOZIA",29,"SC URBAN SA, STR. VASILE ALECSANDRI NR.14",1845,913,889,24,0,898,15,1900,987,405,493,1,9158,0
23,"Ialomita",92658,216,92658,,"MUNICIPIUL SLOBOZIA",30,"SCOALA GENERALA BORA, STR. GENERAL MAGHERU",1516,640,620,19,1,621,19,1600,960,241,380,1,9158,0
23,"Ialomita",92658,216,92658,,"MUNICIPIUL SLOBOZIA",31,"SCOALA GENERALA NR. 5 SLOBOZIA NOUA , STR. SCOLII",1876,962,951,9,2,954,8,2000,1038,484,470,1,9158,0
23,"Ialomita",92658,216,92658,,"MUNICIPIUL SLOBOZIA",32,"SALA DE ASTEPTARE CLS I , STR. PIATA GARII, NR.1",0,658,0,658,0,652,6,800,142,316,336,1,9158,1
23,"Ialomita",92701,216,92701,,"MUNICIPIUL FETESTI",33,"SCOALA NR.3 BULIGA , STR. CALARASI NR.61",939,540,519,21,0,537,3,1000,460,208,329,1,9162,0
23,"Ialomita",92701,216,92701,,"MUNICIPIUL FETESTI",34,"SCOALA NR.6 FETESTI LOCALUL MARE, STR. CALARASI NR.82",1575,652,644,8,0,642,10,1600,948,284,358,1,9162,0
23,"Ialomita",92701,216,92701,,"MUNICIPIUL FETESTI",35,"SCOALA NR.6 FETESTI LOCALUL MARE, STR. CALARASI NR 82",956,386,375,11,0,383,3,1000,614,181,202,1,9162,0
23,"Ialomita",92701,216,92701,,"MUNICIPIUL FETESTI",36,"SCOALA NR.6 FETESTI LOCALUL MIC , STR CALARASI NR.263",1092,514,503,11,0,510,4,1100,586,243,267,1,9162,0
23,"Ialomita",92701,216,92701,,"MUNICIPIUL FETESTI",37,"SCOALA NR. 2 FETESTI,  STR CALARASI NR.263",1011,500,494,6,0,494,6,1100,600,266,228,1,9162,0
23,"Ialomita",92701,216,92701,,"MUNICIPIUL FETESTI",38,"FOSTUL PARCHET , STR CALARASI NR.395",1161,581,572,9,0,575,6,1200,619,272,303,1,9162,0
23,"Ialomita",92701,216,92701,,"MUNICIPIUL FETESTI",39,"SCOALA NR.1 FETESTI, STR. SPIRU HARET NR.14",1006,439,424,15,0,436,3,1100,661,212,224,1,9162,0
23,"Ialomita",92701,216,92701,,"MUNICIPIUL FETESTI",40,"SCOALA NR.4 VLASCA FETESTI, STR M SADOVEANU, NR. 37",841,372,357,15,0,364,8,900,528,169,195,1,9162,0
23,"Ialomita",92701,216,92701,,"MUNICIPIUL FETESTI",41,"SCOALA NR.4 VLASCA FETESTI, STR M SADOVEANU, NR. 37",892,459,452,7,0,421,38,1000,541,210,211,1,9162,0
23,"Ialomita",92701,216,92701,,"MUNICIPIUL FETESTI",42,"GRUP SCOLAR CCF FETESTI,  STR CALARASI NR.526",1262,603,595,8,0,595,8,1300,697,258,337,1,9162,0
23,"Ialomita",92701,216,92701,,"MUNICIPIUL FETESTI",43,"LICEUL TEORETIC FETESTI ,  STR CALARASI NR.530",1211,567,553,14,0,558,9,1300,733,281,277,1,9162,0
23,"Ialomita",92701,216,92701,,"MUNICIPIUL FETESTI",44,"SCOALA NR.7 FETESTI,  STR CALARASI NR.532",1328,716,706,10,0,707,9,1400,684,310,397,1,9162,0
23,"Ialomita",92701,216,92701,,"MUNICIPIUL FETESTI",45,"GRUP SCOLAR INDUSTRIE ALIMENTARA , STR. BANATENILOR",1807,812,801,11,0,806,6,1900,1088,396,410,1,9162,0
23,"Ialomita",92701,216,92701,,"MUNICIPIUL FETESTI",46,"GRADINITA VOINICEL , STR CAMINULUI NR.1",1257,597,579,18,0,590,7,1298,701,281,309,1,9162,0
23,"Ialomita",92701,216,92701,,"MUNICIPIUL FETESTI",47,"SALA DE SPORT, STR. BANATENILOR NR.2",1006,530,519,11,0,528,2,1100,570,204,324,1,9162,0
23,"Ialomita",92701,216,92701,,"MUNICIPIUL FETESTI",48,"SCOALA NR.8 FETESTI, STR. SIRENEI NR.28",1006,518,506,11,1,513,5,1100,582,213,300,1,9162,0
23,"Ialomita",92701,216,92701,,"MUNICIPIUL FETESTI",49,"SCOALA NR.8 FETESTI, STR. SIRENEI NR.28",1060,513,504,9,0,504,9,1100,587,217,287,1,9162,0
23,"Ialomita",92701,216,92701,,"MUNICIPIUL FETESTI",50,"GRADINITA NR.7 FETESTI, STR. DEPOULUI NR.2",1363,775,754,21,0,767,8,1400,625,305,462,1,9162,0
23,"Ialomita",92701,216,92701,,"MUNICIPIUL FETESTI",51,"SCOALA NR.3 FETESTI, STR. VASILE LUPU NR.20",1398,748,736,12,0,739,9,1500,752,316,423,1,9162,0
23,"Ialomita",92701,216,92701,,"MUNICIPIUL FETESTI",52,"SCOALA NR.3 FETESTI, STR. VASILE LUPU NR.20",1178,628,620,8,0,622,6,1200,572,284,338,1,9162,0
23,"Ialomita",92701,216,92701,,"MUNICIPIUL FETESTI",53,"SCOALA NR.3 FETESTI, STR. VASILE LUPU NR.20",824,491,438,53,0,486,5,900,409,209,277,1,9162,0
23,"Ialomita",92701,216,92701,,"MUNICIPIUL FETESTI",54,"PF IORDAN STR. INDEPENDENTEI NR. 34",1440,656,646,10,0,637,19,1500,844,287,350,1,9162,0
23,"Ialomita",92701,216,92701,,"MUNICIPIUL FETESTI",55,"SC AGROSEM STR. INDEPENDENTEI NR. 40",1298,617,600,17,0,608,9,1400,783,253,355,1,9162,0
23,"Ialomita",92701,216,92701,,"MUNICIPIUL FETESTI",56,"SCOALA NR.5 FETESTI, STR. SCOLII NR.21",1177,504,493,11,0,495,9,1200,696,214,281,1,9162,0
23,"Ialomita",92701,216,92701,,"MUNICIPIUL FETESTI",57,"SCOALA NR.5 FETESTI, STR. SCOLII NR.21",1101,490,481,9,0,484,6,1200,710,268,216,1,9162,0
23,"Ialomita",92701,216,92701,,"MUNICIPIUL FETESTI",58,"GARA CFR FETESTI",0,401,0,401,0,398,3,501,100,187,211,1,9162,1
23,"Ialomita",100683,216,100683,,"MUNICIPIUL URZICENI",59,"SCOALA GENERALA NR.3 ,STR. CAPITAN URZICA , NR.29",1442,677,666,11,0,667,10,1500,823,299,368,1,9167,0
23,"Ialomita",100683,216,100683,,"MUNICIPIUL URZICENI",60,"GRADINITA DE COPII, STR. PANDURI NR.21",1277,644,634,10,0,639,5,1300,656,293,346,1,9167,0
23,"Ialomita",100683,216,100683,,"MUNICIPIUL URZICENI",61,"CASA DE CULTURA, STR. REGELE FERDINAND NR.73",1323,698,686,12,0,695,3,1400,702,331,364,1,9167,0
23,"Ialomita",100683,216,100683,,"MUNICIPIUL URZICENI",62,"GRADINITA CU PROGR PREL , STR. REVOLUTIEI NR.14",1129,608,599,9,0,599,9,1200,592,243,356,1,9167,0
23,"Ialomita",100683,216,100683,,"MUNICIPIUL URZICENI",63,"GRUP SCOLAR  INDUSTRIAL ""SF ECATERINA"", STR. PANDURI NR.57",1339,718,704,14,0,712,6,1400,682,305,407,1,9167,0
23,"Ialomita",100683,216,100683,,"MUNICIPIUL URZICENI",64,"SCOALA GENERALA NR. 1 , STR. AURORA NR.17",1511,814,808,6,0,808,6,1600,786,420,388,1,9167,0
23,"Ialomita",100683,216,100683,,"MUNICIPIUL URZICENI",65,"CLUBUL SINDICATELOR, STR. CALEA BUCURESTI NR.72",1491,722,713,9,0,718,4,1600,878,318,400,1,9167,0
23,"Ialomita",100683,216,100683,,"MUNICIPIUL URZICENI",66,"SCOALA GENERALA NR.2,STR. CALEA BUCURESTI NR.102",1481,709,693,16,0,696,13,1500,791,311,385,1,9167,0
23,"Ialomita",100683,216,100683,,"MUNICIPIUL URZICENI",67,"SCOALA GENERALA NR.2,STR. CALEA BUCURESTI NR.102",1483,712,697,15,0,707,5,1500,788,297,410,1,9167,0
23,"Ialomita",100683,216,100683,,"MUNICIPIUL URZICENI",68,"INTERNATUL LICEULUI TEORETIC , STR. AL I CUZA NR.11",1302,638,623,15,0,628,10,1400,762,298,330,1,9167,0
23,"Ialomita",100683,216,100683,,"MUNICIPIUL URZICENI",69,"FABRICA DE CERAMICA, STR. VINATORI NR.13",1527,647,630,17,0,629,18,1600,953,332,297,1,9167,0
23,"Ialomita",100683,216,100683,,"MUNICIPIUL URZICENI",70,"SALA DE ASTEPTARE MICA, GARA CFR URZICENI",0,385,0,385,0,380,5,500,115,199,181,1,9167,1
23,"Ialomita",92836,216,92836,,"ORAS AMARA",71,"GRADINITA DE COPII, STR. VIILOR",1337,611,599,12,0,606,5,1400,789,284,322,1,9169,0
23,"Ialomita",92836,216,92836,,"ORAS AMARA",72,"GRADINITA DE COPII, STR. VIILOR",1111,523,510,13,0,513,10,1200,677,236,277,1,9169,0
23,"Ialomita",92836,216,92836,,"ORAS AMARA",73,"SCOALA DE ARTE SI MESERII ""GEORGE VALSAN"", STR. TUDOR VLADIMIRESCU",1374,645,630,15,0,641,4,1399,754,293,348,1,9169,0
23,"Ialomita",92836,216,92836,,"ORAS AMARA",74,"SCOALA DE ARTE SI MESERII ""GEORGE VALSAN"", STR. TUDOR VLADIMIRESCU",1452,674,662,12,0,661,13,1500,826,300,361,1,9169,0
23,"Ialomita",92836,216,92836,,"ORAS AMARA",75,"CASA DE CULTURA ""JAN CACIULA"", STR. AL. I. CUZA",1414,690,677,13,0,682,8,1500,810,313,369,1,9169,0
23,"Ialomita",92836,216,92836,,"ORAS AMARA",76,"SCOALA DE ARTE SI MESERII ""GEORGE VALSAN"", STR. TUDOR VLADIMIRESCU",0,335,0,335,0,332,3,500,165,165,167,1,9169,1
23,"Ialomita",93067,216,93067,,"ORAS CAZANESTI",77,"GRUP SCOLAR AGRICOL CORP C, SCOALA VECHE, SOS BUCURESTI NR 68",1477,788,741,46,1,783,5,1600,812,337,446,1,9172,0
23,"Ialomita",93067,216,93067,,"ORAS CAZANESTI",78,"GRUP SCOLAR AGRICOL CORPUL A (LICEU) STR GARII NR.15",1479,644,633,11,0,633,11,1600,956,242,391,1,9172,0
23,"Ialomita",93067,216,93067,,"ORAS CAZANESTI",79,"GRUPUL SCOLAR AGRICOL CORP C (SCOALA VECHE)",0,74,0,74,0,74,0,500,426,46,28,1,9172,1
23,"Ialomita",102749,216,102749,,"ORAS FIERBINTI-TARG",80,"CAMINUL CULTURAL",1392,690,686,4,0,683,7,1500,810,367,316,1,9174,0
23,"Ialomita",102749,216,102749,,"ORAS FIERBINTI-TARG",81,"SCOALA GENERALA CU CLASELE I-IV FIERBINTII DE SUS",1641,775,765,10,0,765,10,1700,925,360,405,1,9174,0
23,"Ialomita",102749,216,102749,,"ORAS FIERBINTI-TARG",82,"SCOALA GENERALA CU CLASELE I-IV FIERBINTII DE JOS",1002,581,570,10,1,572,9,1100,519,324,248,1,9174,0
23,"Ialomita",102749,216,102749,,"ORAS FIERBINTI-TARG",83,"GRUPUL SCOLAR AGRICOL FIERBINTI TARG",0,261,0,261,0,257,4,500,239,154,103,1,9174,1
23,"Ialomita",92765,216,92765,,"ORAS TANDAREI",84,"GRUP SCOLAR AGRICOL STR. FETESTI NR.3",1448,611,605,6,0,607,4,1500,889,260,347,1,9179,0
23,"Ialomita",92765,216,92765,,"ORAS TANDAREI",85,"LICEUL TEORETIC ""PAUL GEORGESCU""  STR IONEL PERLEA NR.8",1744,699,691,8,0,694,5,1800,1101,312,382,1,9179,0
23,"Ialomita",92765,216,92765,,"ORAS TANDAREI",86,"SCOALA NR.2 STR BARIEREI NR.10",1903,874,869,5,0,866,8,2000,1126,372,494,1,9179,0
23,"Ialomita",92765,216,92765,,"ORAS TANDAREI",87,"SCOALA NR.2 STR BARIEREI NR.10",1593,686,676,9,1,674,12,1700,1014,280,394,1,9179,0
23,"Ialomita",92765,216,92765,,"ORAS TANDAREI",88,"SCOALA NR.1 TANDAREI, STR. NARCISELOR NR.32",1617,762,752,10,0,756,6,1700,938,329,427,1,9179,0
23,"Ialomita",92765,216,92765,,"ORAS TANDAREI",89,"CASA DE CULTURA STR. GARII NR.2",1253,587,576,11,0,581,6,1300,713,244,337,1,9179,0
23,"Ialomita",92765,216,92765,,"ORAS TANDAREI",90,"SCOALA NR.1 STR. BUCURESTI NR.20",1700,432,424,8,0,416,16,1800,1368,183,233,1,9179,0
23,"Ialomita",92765,216,92765,,"ORAS TANDAREI",91,"GARA CFR BIROUL DE MESAGERIE",0,143,0,143,0,143,0,498,355,68,75,1,9179,1
23,"Ialomita",100754,216,100754,," ADANCATA",92,"SALA DE SPORT DE LANGA PRIMARIA ADANCATA",1598,967,957,10,0,952,15,1600,633,409,543,3,9181,0
23,"Ialomita",100754,216,100754,," ADANCATA",93,"SCOALA GENERALA PATRU FRATI",708,432,388,44,0,419,13,800,368,216,203,3,9181,0
23,"Ialomita",100754,216,100754,," ADANCATA",94,"SALA DE SPORT ADANCATA",0,179,0,179,0,176,3,200,21,88,88,3,9181,1
23,"Ialomita",92783,216,92783,," ALBESTI",95,"SCOALA ALBESTI",710,498,467,6,25,482,16,800,302,171,311,3,9184,0
23,"Ialomita",92783,216,92783,," ALBESTI",96,"SCOALA MARSILIENI",399,291,280,7,4,283,8,500,209,88,195,3,9184,0
23,"Ialomita",92783,216,92783,," ALBESTI",97,"SCOALA CU CLASELE I-VIII CONSTANTIN STEFAN ALBESTI",0,78,0,78,0,78,0,200,122,29,49,3,9184,1
23,"Ialomita",100852,216,100852,," ALEXENI",98,"SCOALA VECHE ALEXENI",950,410,406,4,0,406,4,1000,590,160,246,3,9188,0
23,"Ialomita",100852,216,100852,," ALEXENI",99,"SCOALA VECHE ALEXENI",1014,511,508,3,0,493,18,1098,587,191,302,3,9188,0
23,"Ialomita",100852,216,100852,," ALEXENI",100,"SCOALA VECHE ALEXENI",0,80,0,80,0,80,0,200,120,33,47,3,9188,1
23,"Ialomita",92872,216,92872,," ANDRASESTI",101,"SCOALA GENERALA  ANDRASESTI",1544,829,807,7,15,819,10,1600,771,282,537,3,9190,0
23,"Ialomita",92872,216,92872,," ANDRASESTI",102,"SCOALA ORBOIESTI",304,148,141,7,0,146,2,400,252,73,73,3,9190,0
23,"Ialomita",92872,216,92872,," ANDRASESTI",103,"SCOALA ANDRASESTI",0,80,0,80,0,79,1,200,120,35,44,3,9190,1
23,"Ialomita",100870,216,100870,," ARMASESTI",104,"SCOALA GENERALA ARMASESTI",945,312,295,17,0,298,14,1000,688,163,135,3,9193,0
23,"Ialomita",100870,216,100870,," ARMASESTI",105,"SCOALA GENERALA MALU ROSU",1135,521,510,11,0,509,12,1200,679,250,259,3,9193,0
23,"Ialomita",100870,216,100870,," ARMASESTI",106,"SCOALA CU CLASELE I-IV ARMASESTI",0,59,0,59,0,59,0,200,141,38,21,3,9193,1
23,"Ialomita",100923,216,100923,," AXINTELE",107,"SCOALA AXINTELE",635,379,370,9,0,377,2,700,321,104,273,3,9197,0
23,"Ialomita",100923,216,100923,," AXINTELE",108,"SCOALA FRUMUSICA",897,458,443,15,0,447,11,1000,542,166,281,3,9197,0
23,"Ialomita",100923,216,100923,," AXINTELE",109,"SCOALA HORIA",582,346,333,13,0,341,5,700,354,146,195,3,9197,0
23,"Ialomita",100923,216,100923,," AXINTELE",110,"SCOALA CU CLASELE I-VIII AXINTELE",0,178,0,178,0,178,0,200,22,81,97,3,9197,1
23,"Ialomita",92907,216,92907,," BALACIU",111,"SCOALA GENERALA CU CLASELE I-VIII BALACIU",816,414,400,14,0,406,8,900,486,121,285,3,9201,0
23,"Ialomita",92907,216,92907,," BALACIU",112,"SCOALA CU CLASELE I-IV  CRASANII DE JOS",374,138,127,11,0,137,1,500,362,42,95,3,9201,0
23,"Ialomita",92907,216,92907,," BALACIU",113,"SCOALA COPUZU",276,154,141,13,0,153,1,300,146,92,61,3,9201,0
23,"Ialomita",92907,216,92907,," BALACIU",114,"CAMINUL CULTURAL BALACIU",0,109,0,109,0,106,3,200,91,48,58,3,9201,1
23,"Ialomita",180064,216,180064,," BARBULESTI",115,"SCOALA GENERALA CU CLASELE I-VIII BARBULESTI",976,327,326,1,0,304,23,1100,773,85,219,3,9206,0
23,"Ialomita",180064,216,180064,," BARBULESTI",116,"SCOALA GENERALA CU CLASELE I-VIII BARBULESTI",1003,305,303,2,0,291,14,1100,795,91,200,3,9206,0
23,"Ialomita",180064,216,180064,," BARBULESTI",117,"SCOALA GENERALA CU CLASELE I-VIII BARBULESTI",1022,324,321,3,0,301,23,1100,776,95,206,3,9206,0
23,"Ialomita",180064,216,180064,," BARBULESTI",118,"SCOALA CU CLASELE I-VIII BARBULESTI",0,52,0,52,0,50,2,200,148,20,30,3,9206,1
23,"Ialomita",101056,216,101056,," BARCANESTI",119,"SCOALA BARCANESTI",1721,772,751,21,0,748,24,1800,1028,286,462,3,9208,0
23,"Ialomita",101056,216,101056,," BARCANESTI",120,"SCOALA GENERALA CONDEESTI",1344,609,601,8,0,592,17,1400,791,187,405,3,9208,0
23,"Ialomita",101056,216,101056,," BARCANESTI",121,"SCOALA CU CLASELE I -VIII BARCANESTI",0,147,0,147,0,144,3,200,53,51,93,3,9208,1
23,"Ialomita",179784,216,179784,," BORANESTI",122,"SCOALA GENERALA CU CLASELE I-VIII BORANESTI",1449,688,670,18,0,663,25,1500,812,340,323,3,9211,0
23,"Ialomita",179784,216,179784,," BORANESTI",123,"FOSTA SCOALA SINTESTI",296,189,179,10,0,185,4,400,211,102,83,3,9211,0
23,"Ialomita",179784,216,179784,," BORANESTI",124,"SCOALA CU CLASELE I - VIII BORANESTI",0,86,0,86,0,85,1,200,114,46,39,3,9211,1
23,"Ialomita",92989,216,92989,," BORDUSANI",125,"SCOALA VECHE BORDUSANI",1152,551,526,9,16,543,8,1200,649,275,268,3,9214,0
23,"Ialomita",92989,216,92989,," BORDUSANI",126,"CAMINUL CULTURAL BORDUSANI",948,478,461,10,7,473,5,1000,522,237,236,3,9214,0
23,"Ialomita",92989,216,92989,," BORDUSANI",127,"SCOALA DE ARTE SI MESERII BORDUSANI(ZONA MOARA)",961,496,481,13,2,491,5,1000,504,256,235,3,9214,0
23,"Ialomita",92989,216,92989,," BORDUSANI",128,"SCOALA CU CLASELE I-VIII CEGANI",1048,519,511,8,0,513,6,1100,581,352,161,3,9214,0
23,"Ialomita",92989,216,92989,," BORDUSANI",129,"GRADINITA BORDUSANI",0,106,0,106,0,106,0,200,94,53,53,3,9214,1
23,"Ialomita",101243,216,101243,," BRAZII",130,"CAMINUL CULTURAL BRAZII",809,433,424,9,0,420,13,900,467,109,311,3,9217,0
23,"Ialomita",101243,216,101243,," BRAZII",131,"SCOALA GENERALA CU CLASELE I-IV RASIMNICEA",268,171,165,6,0,167,4,400,229,69,98,3,9217,0
23,"Ialomita",101243,216,101243,," BRAZII",132,"CAMINUL CULTURAL BRAZII",0,126,0,126,0,125,1,200,74,48,77,3,9217,1
23,"Ialomita",93021,216,93021,," BUCU",133,"CAMINUL CULTURAL BUCU(SALA MICA)",2028,1091,1076,15,0,1082,9,2102,1011,684,398,3,9221,0
23,"Ialomita",93021,216,93021,," BUCU",134,"CAMINUL CULTURAL BUCU",0,123,0,123,0,120,3,201,78,72,48,3,9221,1
23,"Ialomita",179793,216,179793,," BUESTI",135,"SCOALA CU CLASELE I-IV BUESTI",927,635,619,9,7,627,8,1002,367,193,434,3,9223,0
23,"Ialomita",179793,216,179793,," BUESTI",136,"SCOALA CU CLASELE I-IV BUESTI",0,72,0,72,0,70,2,200,128,27,43,3,9223,1
23,"Ialomita",93101,216,93101,," CIOCHINA",137,"CAMINUL CULTURAL CIOCHINA",1350,570,549,19,2,563,7,1400,830,217,346,3,9228,0
23,"Ialomita",93101,216,93101,," CIOCHINA",138,"CAMINUL CULTURAL BORDUSELU",684,369,350,9,10,360,9,800,431,179,181,3,9228,0
23,"Ialomita",93101,216,93101,," CIOCHINA",139,"SCOALA CU CLASELE I- IV OREZU",694,251,244,7,0,244,7,800,549,93,151,3,9228,0
23,"Ialomita",93101,216,93101,," CIOCHINA",140,"CAMINUL CULTURAL CIOCHINA",0,84,0,84,0,83,1,200,116,34,49,3,9228,1
23,"Ialomita",100709,216,100709,," CIOCARLIA",141,"SCOALA GENERALA CU CLASELE I-IV CIOCARLIA",691,316,311,5,0,308,8,800,484,162,146,3,9225,0
23,"Ialomita",100709,216,100709,," CIOCARLIA",142,"SCOALA GENERALA CU CLASELE I-IV CIOCARLIA",0,49,0,49,0,48,1,200,151,20,28,3,9225,1
23,"Ialomita",93156,216,93156,," CIULNITA",143,"CAMINUL CULTURAL CIULNITA",903,484,472,12,0,481,3,1000,516,288,193,3,9233,0
23,"Ialomita",93156,216,93156,," CIULNITA",144,"CAMINUL CULTURAL ION GHICA",449,286,270,15,1,284,2,500,214,144,140,3,9233,0
23,"Ialomita",93156,216,93156,," CIULNITA",145,"SCOALA CU CLASELE I-VIII POIANA(LOCALUL VECHI)",681,373,367,6,0,367,6,800,427,202,165,3,9233,0
23,"Ialomita",93156,216,93156,," CIULNITA",146,"SCOALA CU CLASELE I-VIII CIULNITA",0,86,0,86,0,86,0,200,114,45,41,3,9233,1
23,"Ialomita",93209,216,93209,," COCORA",147,"SALA DE SEDINTA A CONSIULUI LOCAL COCORA",934,605,573,15,17,596,9,1000,395,393,203,3,9238,0
23,"Ialomita",93209,216,93209,," COCORA",148,"SCOALA VECHE COCORA",881,608,577,17,14,597,11,1000,392,356,241,3,9238,0
23,"Ialomita",93209,216,93209,," COCORA",149,"CAMINUL CULTURAL COCORA",0,108,0,108,0,107,1,200,92,59,48,3,9238,1
23,"Ialomita",179971,216,179971,," COLELIA",150,"SCOALA CU CLASELE I-VIII COLELIA",1040,645,596,7,42,623,22,1100,455,198,425,3,9240,0
23,"Ialomita",179971,216,179971,," COLELIA",151,"SCOALA GENERALA CU CLASELE I-VIII COLELIA",0,52,0,52,0,52,0,200,148,21,31,3,9240,1
23,"Ialomita",93236,216,93236,," COSAMBESTI",152,"CAMINUL CULTURAL SALA NR.1 COSAMBESTI",819,588,546,9,33,578,10,900,312,296,282,3,9242,0
23,"Ialomita",93236,216,93236,," COSAMBESTI",153,"SCOALA GENERALA GIMBASANI",760,523,484,8,31,519,4,900,377,205,314,3,9242,0
23,"Ialomita",93236,216,93236,," COSAMBESTI",154,"CAMINUL CULTURAL SALA NR.2 COSAMBESTI",0,145,0,145,0,145,0,200,55,76,69,3,9242,1
23,"Ialomita",102240,216,102240,," COSERENI",155,"CAMINUL CULTURAL COSERENI",1487,784,775,9,0,775,9,1600,816,368,407,3,9245,0
23,"Ialomita",102240,216,102240,," COSERENI",156,"SCOALA GENERALA COSERENI",1240,709,700,9,0,699,10,1300,591,224,475,3,9245,0
23,"Ialomita",102240,216,102240,," COSERENI",157,"GRADINITA-PATRIME COSERENI",1122,576,563,13,0,562,14,1200,624,220,342,3,9245,0
23,"Ialomita",102240,216,102240,," COSERENI",158,"GRADINITA COSERENI",0,109,0,109,0,108,1,200,91,54,54,3,9245,1
23,"Ialomita",102641,216,102641,," DRAGOESTI",159,"CAMINUL CULTURAL SAT DRAGOESTI",832,466,463,3,0,448,18,900,434,169,279,3,9247,0
23,"Ialomita",102641,216,102641,," DRAGOESTI",160,"CAMINUL CULTURAL DRAGOESTI",0,160,0,160,0,159,1,200,40,60,99,3,9247,1
23,"Ialomita",102703,216,102703,," DRIDU",161,"SCOALA GENERALA CU CLASELE I-VIII DRIDU",1882,952,943,9,0,937,15,1900,948,366,571,3,9253,0
23,"Ialomita",102703,216,102703,," DRIDU",162,"GRADINITA DRIDU-MOVILA",664,369,360,9,0,364,5,800,431,149,215,3,9253,0
23,"Ialomita",102703,216,102703,," DRIDU",163,"GRADINITA DRIDU-SNAGOV",446,202,196,6,0,200,2,500,298,77,123,3,9253,0
23,"Ialomita",102703,216,102703,," DRIDU",164,"SCOALA CU CLASELE I - VIII DRIDU",0,248,0,248,0,244,4,300,52,102,142,3,9253,1
23,"Ialomita",93575,216,93575,," FACAENI",165,"SCOALA GENERALA NR.1 FACAENI",1553,793,722,66,5,782,11,1700,907,373,409,3,9256,0
23,"Ialomita",93575,216,93575,," FACAENI",166,"SCOALA DE ARTE SI MESERII FACAENI",1360,643,607,35,1,636,7,1400,757,282,354,3,9256,0
23,"Ialomita",93575,216,93575,," FACAENI",167,"SCOALA GENERALA NR.2 CU CLASELE I-IV(GAITA)",1092,542,513,26,3,538,4,1100,558,242,296,3,9256,0
23,"Ialomita",93575,216,93575,," FACAENI",168,"SCOALA NR. 3 PROGRESU",527,297,278,13,6,293,4,603,306,125,168,3,9256,0
23,"Ialomita",93575,216,93575,," FACAENI",169,"CAMINUL CULTURAL FACAENI",0,98,0,98,0,98,0,200,102,50,48,3,9256,1
23,"Ialomita",93600,216,93600,," GHEORGHE DOJA",170,"SCOALA GENERALA NR.1 GHEORGHE DOJA",1144,663,627,2,34,655,8,1200,537,194,461,3,9261,0
23,"Ialomita",93600,216,93600,," GHEORGHE DOJA",171,"SCOALA GENERALA NR.1 GHEORGHE DOJA",1190,664,628,9,27,659,5,1300,636,227,432,3,9261,0
23,"Ialomita",93600,216,93600,," GHEORGHE DOJA",172,"SCOALA GENERALA NR.1 GHEORGHE DOJA",0,105,0,105,0,105,0,200,95,43,62,3,9261,1
23,"Ialomita",93628,216,93628,," GHEORGHE LAZAR",173,"SCOALA GENERALA GHEORGHE LAZAR(CABINETUL DE LIMBA ROMANA SI LITERATURA ROMANA)",1157,703,661,10,32,683,20,1200,497,218,465,3,9263,0
23,"Ialomita",93628,216,93628,," GHEORGHE LAZAR",174,"SCOALA GENERALA GHEORGHE LAZAR(CABINETUL DE ISTORIE)",831,530,506,7,17,520,10,900,370,160,360,3,9263,0
23,"Ialomita",93628,216,93628,," GHEORGHE LAZAR",175,"SCOALA GENERALA GHEORGHE LAZAR(CABINETUL DE GEOGRAFIE)",0,167,0,167,0,167,0,200,33,48,119,3,9263,1
23,"Ialomita",93646,216,93646,," GIURGENI",176,"SCOALA  GENERALA CU CLASELE I-VIII GIURGENI",1268,849,795,1,53,836,13,1300,451,361,475,3,9265,0
23,"Ialomita",93646,216,93646,," GIURGENI",177,"SCOALA  GENERALA CU CLASELE I-VIII GIURGENI",0,39,0,39,0,38,1,200,161,20,18,3,9265,1
23,"Ialomita",103283,216,103283,," GARBOVI",178,"SCOALA  GENERALA CU CLASELE I-VIII GARBOVI",1127,390,390,0,0,382,8,1200,810,164,218,3,9259,0
23,"Ialomita",103283,216,103283,," GARBOVI",179,"SCOALA  GENERALA CU CLASELE I-VIII GARBOVI",1176,448,445,3,0,438,10,1300,852,199,239,3,9259,0
23,"Ialomita",103283,216,103283,," GARBOVI",180,"SCOALA  GENERALA CU CLASELE I-VIII GARBOVI",1239,429,425,3,1,422,7,1300,871,184,238,3,9259,0
23,"Ialomita",103283,216,103283,," GARBOVI",181,"SCOALA  GENERALA CU CLASELE I-VIII GARBOVI",0,98,0,98,0,98,0,200,102,48,50,3,9259,1
23,"Ialomita",93717,216,93717,," GRINDU",182,"CAMINUL CULTURAL GRINDU",1212,482,477,5,0,475,7,1299,817,161,314,3,9267,0
23,"Ialomita",93717,216,93717,," GRINDU",183,"CAMINUL CULTURAL GRINDU",665,274,273,1,0,271,3,800,526,89,182,3,9267,0
23,"Ialomita",93717,216,93717,," GRINDU",184,"CAMINUL CULTURAL GRINDU",0,91,0,91,0,89,2,200,109,37,52,3,9267,1
23,"Ialomita",93735,216,93735,," GRIVITA",185,"SCOALA GENERALA CU CLASELE I-X GRIVITA LOCALUL NOU",1084,733,686,8,39,726,7,1100,367,414,312,3,9269,0
23,"Ialomita",93735,216,93735,," GRIVITA",186,"SCOALA GENERALA CU CLASELE I-X GRIVITA LOCALUL NOU",1021,697,657,2,38,689,8,1100,403,441,248,3,9269,0
23,"Ialomita",93735,216,93735,," GRIVITA",187,"SCOALA CU CLASELE I-IV SMIRNA LOCALUL NOU",875,582,530,11,41,574,8,1001,419,281,293,3,9269,0
23,"Ialomita",93735,216,93735,," GRIVITA",188,"SCOALA GENERALA ARETA TEODORESCU (CORPUL B) GRIVITA",0,137,0,137,0,137,0,200,63,63,74,3,9269,1
23,"Ialomita",180046,216,180046,," GURA IALOMITEI",189,"CAMINUL CULTURAL GURA IALOMITEI",1058,626,617,9,0,618,8,1100,474,206,412,3,9272,0
23,"Ialomita",180046,216,180046,," GURA IALOMITEI",190,"SCOALA GENERALA LUCIU",1158,642,634,8,0,628,14,1200,558,196,432,3,9272,0
23,"Ialomita",180046,216,180046,," GURA IALOMITEI",191,"SCOALA GENERALA LUCIU",0,60,0,60,0,60,0,200,140,27,33,3,9272,1
23,"Ialomita",103862,216,103862,," ION ROATA",192,"SCOALA GENERALA ION ROATA",954,491,485,5,1,481,10,1000,509,227,254,3,9275,0
23,"Ialomita",103862,216,103862,," ION ROATA",193,"GRADINITA ION ROATA LOCALUL VECHI",849,436,425,11,0,429,7,900,464,192,237,3,9275,0
23,"Ialomita",103862,216,103862,," ION ROATA",194,"SCOALA GENERALA BROSTENI",1173,625,616,9,0,618,7,1300,675,170,448,3,9275,0
23,"Ialomita",103862,216,103862,," ION ROATA",195,"CAMINUL CULTURAL ION ROATA",0,100,0,100,0,99,1,200,100,42,57,3,9275,1
23,"Ialomita",103960,216,103960,," JILAVELE",196,"SCOALA NR. 1 JILAVELE(CU ETAJ)",1229,572,553,19,0,561,11,1300,728,200,361,3,9278,0
23,"Ialomita",103960,216,103960,," JILAVELE",197,"SCOALA NR.2 JILAVELE",1456,671,640,31,0,657,14,1500,829,284,373,3,9278,0
23,"Ialomita",103960,216,103960,," JILAVELE",198,"SCOALA SLATIOARELE",394,185,166,19,0,184,1,500,315,72,112,3,9278,0
23,"Ialomita",103960,216,103960,," JILAVELE",199,"SCOALA NR.3 JILAVELE",0,108,0,108,0,108,0,200,92,51,57,3,9278,1
23,"Ialomita",179800,216,179800,," MAIA",200,"SCOALA CU CLASELE I-VIII BARBU CATARGIU MAIA",1545,888,882,6,0,874,14,1600,712,384,490,3,9281,0
23,"Ialomita",179800,216,179800,," MAIA",201,"SCOALA CU CLASELE I-VIII BARBU CATARGIU MAIA",0,142,0,142,0,142,0,200,58,66,76,3,9281,1
23,"Ialomita",100736,216,100736,," MANASIA",202,"SCOALA NOUA MANASIA",1361,695,687,8,0,683,12,1400,705,369,314,3,9283,0
23,"Ialomita",100736,216,100736,," MANASIA",203,"SCOALA NOUA MANASIA",1628,802,792,10,0,791,11,1700,898,409,382,3,9283,0
23,"Ialomita",100736,216,100736,," MANASIA",204,"SCOALA NOUA MANASIA",901,454,446,8,0,450,4,1000,546,240,210,3,9283,0
23,"Ialomita",100736,216,100736,," MANASIA",205,"SCOALA GENERALA CU CLASELE I - VIII MANASIA",0,113,0,113,0,109,4,200,87,70,39,3,9283,1
23,"Ialomita",179980,216,179980,," MARCULESTI",206,"SCOALA GENERALA  CU CLASELE I-VIII MARCULESTI",1385,966,918,13,35,961,5,1500,534,486,475,3,9285,0
23,"Ialomita",179980,216,179980,," MARCULESTI",207,"SCOALA GENERALA  CU CLASELE I-VIII MARCULESTI",0,100,0,100,0,100,0,200,100,58,42,3,9285,1
23,"Ialomita",93995,216,93995,," MIHAIL KOGALNICEANU",208,"CAMINUL CULTURAL M. KOGALNICEANU",1378,736,726,10,0,694,42,1500,764,223,471,3,9287,0
23,"Ialomita",93995,216,93995,," MIHAIL KOGALNICEANU",209,"SCOALA GENERALA CU CLASELE I-VIII M KOGALNICEANU",1290,633,621,12,0,610,23,1400,767,223,387,3,9287,0
23,"Ialomita",93995,216,93995,," MIHAIL KOGALNICEANU",210,"SCOALA GENERALA CU CLASELE I-VIII M KOGALNICEANU",0,92,0,92,0,92,0,200,108,31,61,3,9287,1
23,"Ialomita",94045,216,94045,," MILOSESTI",211,"SCOALA DE ARTE SI MESERII MILOSESTI",804,396,377,12,7,395,1,900,504,135,260,3,9290,0
23,"Ialomita",94045,216,94045,," MILOSESTI",212,"GRADINITA DE COPII MILOSESTI",847,391,382,6,3,389,2,900,509,141,248,3,9290,0
23,"Ialomita",94045,216,94045,," MILOSESTI",213,"SCOALA GENERALA NICOLESTI",416,215,206,9,0,212,3,499,284,125,87,3,9290,0
23,"Ialomita",94045,216,94045,," MILOSESTI",214,"SCOALA GENERALA TOVARASIA",361,195,188,7,0,195,0,493,298,85,110,3,9290,0
23,"Ialomita",94045,216,94045,," MILOSESTI",215,"SCOALA DE ARTE SI MESERII MILOSESTI",0,51,0,51,0,51,0,200,149,23,28,3,9290,1
23,"Ialomita",179999,216,179999,," MOLDOVENI",216,"SCOALA GENERALA CU CLASELE I-VIII MOLDOVENI",1032,643,634,9,0,636,7,1100,457,170,466,3,9294,0
23,"Ialomita",179999,216,179999,," MOLDOVENI",217,"SCOALA GENERALA CU CLASELE I-VIII MOLDOVENI",0,97,0,97,0,95,2,200,103,28,67,3,9294,1
23,"Ialomita",94081,216,94081,," MOVILA",218,"SCOALA GENERALA MOVILA",1665,904,895,2,7,896,8,1800,896,298,598,3,9296,0
23,"Ialomita",94081,216,94081,," MOVILA",219,"GRADINITA CU PROGRAM NORMAL MOVILA",0,75,0,75,0,74,1,200,125,29,45,3,9296,1
23,"Ialomita",104270,216,104270,," MOVILITA",220,"SCOALA GENERALA CU CLASELE I-VIII MOVILITA",995,408,400,8,0,398,10,1100,692,169,229,3,9298,0
23,"Ialomita",104270,216,104270,," MOVILITA",221,"SCOALA GENERALA CU CLASELE I-VIII MOVILITA",1049,392,387,5,0,381,11,1100,708,171,210,3,9298,0
23,"Ialomita",104270,216,104270,," MOVILITA",222,"SCOALA GENERALA CU CLASELE I-VIII MOVILITA",0,169,0,169,0,169,0,200,31,86,83,3,9298,1
23,"Ialomita",94107,216,94107,," MUNTENI-BUZAU",223,"SCOALA GENERALA NR. 1 MUNTENI BUZAU",1565,923,881,4,38,911,12,1600,677,248,663,3,9302,0
23,"Ialomita",94107,216,94107,," MUNTENI-BUZAU",224,"SCOALA GENERALA NR.2 MUNTENI BUZAU",1429,777,719,10,48,768,9,1500,723,280,488,3,9302,0
23,"Ialomita",94107,216,94107,," MUNTENI-BUZAU",225,"SCOALA GENERALA NR. 1 MUNTENI BUZAU",0,133,0,133,0,132,1,190,57,57,75,3,9302,1
23,"Ialomita",179819,216,179819,," OGRADA",226,"GRADINITA DIN VECINATATEA SCOLII ""IONEL PERLEA"" CU CLASELE I-VIII OGRADA",1216,609,602,5,2,602,7,1300,691,280,322,3,9304,0
23,"Ialomita",179819,216,179819,," OGRADA",227,"SCOALA CU CLASELE I-VIII  ""IONEL PERLEA"" OGRADA(SALA DE CLASA NR 1)",1066,546,541,5,0,535,11,1200,654,246,289,3,9304,0
23,"Ialomita",179819,216,179819,," OGRADA",228,"SCOALA CU CLASELE I-VIII  OGRADA(SALA DE CLASA NR.2)",0,104,0,104,0,102,2,200,96,63,39,3,9304,1
23,"Ialomita",94161,216,94161,," PERIETI",229,"SCOALA PERIETI",1077,411,399,11,1,410,1,1200,789,160,250,3,9306,0
23,"Ialomita",94161,216,94161,," PERIETI",230,"SCOALA GENERALA STEJARU",851,439,424,14,1,432,7,900,461,188,244,3,9306,0
23,"Ialomita",94161,216,94161,," PERIETI",231,"SCOALA GENERALA FUNDATA",370,187,178,9,0,187,0,400,213,84,103,3,9306,0
23,"Ialomita",94161,216,94161,," PERIETI",232,"SCOALA GENERALA MISLEANU",687,369,359,10,0,365,4,800,431,161,204,3,9306,0
23,"Ialomita",94161,216,94161,," PERIETI",233,"SCOALA GENERALA STEJARU",0,72,0,72,0,71,1,200,128,43,28,3,9306,1
23,"Ialomita",180000,216,180000,," PLATONESTI",234,"CAMINUL CULTURAL PLATONESTI",806,639,580,12,47,633,6,900,261,471,162,3,9312,0
23,"Ialomita",180000,216,180000,," PLATONESTI",235,"FOSTUL CAMIN CULTURAL LACUSTENI",815,582,538,14,30,576,6,900,318,376,200,3,9312,0
23,"Ialomita",180000,216,180000,," PLATONESTI",236,"SCOALA GENERALA PLATONESTI",0,141,0,141,0,141,0,200,59,128,13,3,9312,1
23,"Ialomita",94269,216,94269,," REVIGA",237,"SCOALA GENERALA REVIGA",1237,679,656,23,0,669,10,1300,621,394,275,3,9315,0
23,"Ialomita",94269,216,94269,," REVIGA",238,"SCOALA GENERALA ROVINE",824,499,463,36,0,488,11,900,401,281,207,3,9315,0
23,"Ialomita",94269,216,94269,," REVIGA",239,"SCOALA GENERALA CRUNTI",461,275,261,14,0,267,8,500,225,148,119,3,9315,0
23,"Ialomita",94269,216,94269,," REVIGA",240,"SCOALA REVIGA",0,155,0,155,0,152,3,200,45,87,65,3,9315,1
23,"Ialomita",179828,216,179828,," ROSIORI",241,"SCOALA CU CLASELE I-VIII ROSIORI",947,567,549,17,1,555,12,1000,433,188,367,3,9320,0
23,"Ialomita",179828,216,179828,," ROSIORI",242,"SCOALA CU CLASELE I-VIII ROSIORI",669,396,382,11,3,382,14,800,404,132,250,3,9320,0
23,"Ialomita",179828,216,179828,," ROSIORI",243,"SCOALA CU CLASELE I-VIII ROSIORI",0,107,0,107,0,106,1,200,93,36,70,3,9320,1
23,"Ialomita",94330,216,94330,," SALCIOARA",244,"SCOALA SALCIOARA",954,562,517,16,29,559,3,1000,438,186,373,3,9322,0
23,"Ialomita",94330,216,94330,," SALCIOARA",245,"SCOALA GENERALA CU CLASELE I-IV RASI",939,588,546,5,37,577,11,1000,412,151,426,3,9322,0
23,"Ialomita",94330,216,94330,," SALCIOARA",246,"SCOALA CU CLASELE I - VIII SALCIOARA",0,86,0,86,0,84,2,200,114,40,44,3,9322,1
23,"Ialomita",180019,216,180019,," SARATENI",247,"SCOALA SARATENI",1108,758,712,3,43,741,17,1200,442,478,263,3,9325,0
23,"Ialomita",180019,216,180019,," SARATENI",248,"SCOALA CU CLASELE I -IV SARATENI",0,75,0,75,0,73,2,200,125,57,16,3,9325,1
23,"Ialomita",94376,216,94376,," SAVENI",249,"SCOALA GENERALA SAVENI (CLADIREA NOUA)",1295,654,644,10,0,647,7,1400,746,211,436,3,9327,0
23,"Ialomita",94376,216,94376,," SAVENI",250,"GRADINITA SAVENI",1272,597,583,14,0,591,6,1400,803,175,416,3,9327,0
23,"Ialomita",94376,216,94376,," SAVENI",251,"SCOALA CU CLASELE I-IV FRATILESTI",359,224,202,22,0,224,0,400,176,80,144,3,9327,0
23,"Ialomita",94376,216,94376,," SAVENI",252,"SCOLA GENERALA (CLADIREA NOUA) SAVENI",0,45,0,45,0,45,0,200,155,17,28,3,9327,1
23,"Ialomita",94429,216,94429,," SCANTEIA",253,"GRADINITA SCANTEIA",1226,598,592,6,0,581,17,1300,702,211,370,3,9330,0
23,"Ialomita",94429,216,94429,," SCANTEIA",254,"SCOALA GENERALA SCANTEIA",1199,586,579,7,0,564,22,1300,714,211,353,3,9330,0
23,"Ialomita",94429,216,94429,," SCANTEIA",255,"SCOALA CU CLASELE I-IV IAZU",945,459,447,12,0,450,9,1000,541,160,290,3,9330,0
23,"Ialomita",94429,216,94429,," SCANTEIA",256,"SCOALA GENERALA SCANTEIA",0,65,0,65,0,64,1,200,135,24,40,3,9330,1
23,"Ialomita",94456,216,94456,," SFANTU GHEORGHE",257,"CENTRUL SOCIAL DE ZI PENTRU COPII ""VIITORUL"" SF GHEORGHE",754,462,452,10,0,457,5,797,335,209,248,3,9333,0
23,"Ialomita",94456,216,94456,," SFANTU GHEORGHE",258,"CAMINUL CULTURAL MALU",912,510,499,10,1,504,6,1000,490,219,285,3,9333,0
23,"Ialomita",94456,216,94456,," SFANTU GHEORGHE",259,"CENTRUL SOCIAL DE ZI  PENTRU COPII ""VIITORUL"" SF GHEORGHE",0,143,0,143,0,142,1,200,57,71,71,3,9333,1
23,"Ialomita",105026,216,105026,," SINESTI",260,"GRADINITA SINESTI",1144,512,504,8,0,501,11,1200,688,218,283,3,9337,0
23,"Ialomita",105026,216,105026,," SINESTI",261,"SCOALA DE PATRU ANI LILIECI",866,344,332,12,0,339,5,1000,656,150,189,3,9337,0
23,"Ialomita",105026,216,105026,," SINESTI",262,"GRADINITA SINESTI",0,172,0,172,0,171,1,200,28,69,102,3,9337,1
23,"Ialomita",94492,216,94492,," STELNICA",263,"SALA DE SEDINTA CONSILIUL LOCAL STELNICA",1443,817,795,9,13,812,5,1500,683,374,438,3,9344,0
23,"Ialomita",94492,216,94492,," STELNICA",264,"BIBLIOTECA STELNICA",0,63,0,63,0,63,0,200,137,25,38,3,9344,1
23,"Ialomita",94535,216,94535,," SUDITI",265,"SCOALA ""APOSTOL D CULEA"", SUDITI(SALA DE CLASA NR 1 STANGA)",938,684,642,6,36,670,14,1000,316,282,388,3,9348,0
23,"Ialomita",94535,216,94535,," SUDITI",266,"SCOALA ""APOSTOL D CULEA"", SUDITI(SALA DE CLASA NR 1 DREAPTA)",834,570,542,8,20,562,8,900,330,267,295,3,9348,0
23,"Ialomita",94535,216,94535,," SUDITI",267,"SCOALA ""APOSTOL D CULEA"", SUDITI",0,92,0,92,0,91,1,200,108,45,46,3,9348,1
23,"Ialomita",179702,216,179702,," TRAIAN",268,"GRADINITA TRAIAN",1330,800,794,6,0,776,24,1400,600,279,497,3,9351,0
23,"Ialomita",179702,216,179702,," TRAIAN",269,"SCOALA DE ARTE SI MESERII TRAIAN LOCAL NOU",1244,734,725,9,0,706,28,1300,566,241,465,3,9351,0
23,"Ialomita",179702,216,179702,," TRAIAN",270,"GRADINITA TRAIAN",0,71,0,71,0,71,0,200,129,24,47,3,9351,1
23,"Ialomita",94688,216,94688,," VALEA CIORII",271,"SCOALA CU CLASELE I-VIII VALEA CIORII",1549,961,903,7,51,943,18,1700,739,357,586,3,9353,0
23,"Ialomita",94688,216,94688,," VALEA CIORII",272,"SCOALA CU CLASELE I-VIII VALEA CIORII",0,62,0,62,0,62,0,200,138,29,33,3,9353,1
23,"Ialomita",105794,216,105794,," VALEA MACRISULUI",273,"CAMINUL CULTURAL VALEA MACRISULUI",1155,564,552,12,0,554,10,1200,636,205,349,3,9358,0
23,"Ialomita",105794,216,105794,," VALEA MACRISULUI",274,"CAMINUL CULTURAL VALEA MACRISULUI",452,241,221,20,0,237,4,500,259,84,153,3,9358,0
23,"Ialomita",105794,216,105794,," VALEA MACRISULUI",275,"CAMINUL CULTURAL VALEA MACRISULUI",0,52,0,52,0,52,0,193,141,24,28,3,9358,1
23,"Ialomita",94795,216,94795,," VLADENI",276,"CAMINUL CULTURAL VLADENI",1751,1052,1047,5,0,1031,21,1900,848,341,690,3,9361,0
23,"Ialomita",94795,216,94795,," VLADENI",277,"CAMINUL CULTURAL VLADENI",0,40,0,40,0,39,1,200,160,18,21,3,9361,1
24,"Iasi",95060,225,95060,,"MUNICIPIUL IASI",1,"GRADINITA CU PROGRAM NORMAL NR. 15, ALEEA PACURARI NR. 2",1388,727,691,36,0,718,9,1500,773,358,360,1,9364,0
24,"Iasi",95060,225,95060,,"MUNICIPIUL IASI",2,"GRADINITA CU PROGRAM NORMAL NR. 15, ALEEA PACURARI NR. 2",1335,655,645,10,0,644,11,1400,745,311,333,1,9364,0
24,"Iasi",95060,225,95060,,"MUNICIPIUL IASI",3,"SCOALA ELENA CUZA,  ALEEA CANTA NR.10",1671,896,876,20,0,891,5,1800,904,459,432,1,9364,0
24,"Iasi",95060,225,95060,,"MUNICIPIUL IASI",4,"SCOALA ELENA CUZA,  ALEEA CANTA NR.10",1408,735,720,15,0,725,10,1502,767,370,355,1,9364,0
24,"Iasi",95060,225,95060,,"MUNICIPIUL IASI",5,"SCOALA ELENA CUZA,  ALEEA CANTA NR.10",1585,817,799,16,2,807,10,1700,883,417,390,1,9364,0
24,"Iasi",95060,225,95060,,"MUNICIPIUL IASI",6,"SCOALA ELENA CUZA,  ALEEA CANTA NR.10",1633,837,814,23,0,830,7,1800,963,413,417,1,9364,0
24,"Iasi",95060,225,95060,,"MUNICIPIUL IASI",7,"SCOALA ELENA CUZA,  ALEEA CANTA NR.10",1425,779,760,19,0,757,22,1500,721,345,412,1,9364,0
24,"Iasi",95060,225,95060,,"MUNICIPIUL IASI",8,"SCOALA ELENA CUZA,  ALEEA CANTA NR.10",1630,858,836,22,0,848,10,1800,942,402,446,1,9364,0
24,"Iasi",95060,225,95060,,"MUNICIPIUL IASI",9,"SCOALA ELENA CUZA,  ALEEA CANTA NR.10",1441,790,776,13,1,777,13,1600,810,380,397,1,9364,0
24,"Iasi",95060,225,95060,,"MUNICIPIUL IASI",10,"SCOALA ELENA CUZA,  ALEEA CANTA NR.10",1505,755,740,15,0,748,7,1600,845,383,365,1,9364,0
24,"Iasi",95060,225,95060,,"MUNICIPIUL IASI",11,"SCOALA  NR.17  ION CREANGA, STRADA PACURARI NR.178",1395,717,702,15,0,702,15,1510,793,365,337,1,9364,0
24,"Iasi",95060,225,95060,,"MUNICIPIUL IASI",12,"SCOALA  NR.17  ION CREANGA, STRADA PACURARI NR.178",1607,901,891,10,0,891,10,1700,799,365,526,1,9364,0
24,"Iasi",95060,225,95060,,"MUNICIPIUL IASI",13,"SCOALA  NR.17  ION CREANGA, STRADA PACURARI NR.178",703,366,356,10,0,360,6,795,429,185,175,1,9364,0
24,"Iasi",95060,225,95060,,"MUNICIPIUL IASI",14,"SCOALA  NR.17  ION CREANGA, STRADA PACURARI NR.178",798,440,429,11,0,432,8,900,460,218,214,1,9364,0
24,"Iasi",95060,225,95060,,"MUNICIPIUL IASI",15,"SCOALA NR.38  PETRU PONI, STRADA PACURARI NR.112",1534,930,920,10,0,917,13,1600,670,460,457,1,9364,0
24,"Iasi",95060,225,95060,,"MUNICIPIUL IASI",16,"SCOALA NR.38  PETRU PONI, STRADA PACURARI NR.112",1064,604,585,19,0,597,7,1200,596,311,286,1,9364,0
24,"Iasi",95060,225,95060,,"MUNICIPIUL IASI",17,"SCOALA NR.38  PETRU PONI, STRADA PACURARI NR.112",1520,885,835,49,1,869,16,1600,715,404,465,1,9364,0
24,"Iasi",95060,225,95060,,"MUNICIPIUL IASI",18,"SCOALA NR.38  PETRU PONI, STRADA PACURARI NR.112",1166,682,674,8,0,668,14,1300,618,317,351,1,9364,0
24,"Iasi",95060,225,95060,,"MUNICIPIUL IASI",19,"SCOALA STEFAN BARSANESCU, STRADA ZUGRAVI NR. 12 A",1315,836,824,12,0,826,10,1400,564,412,414,1,9364,0
24,"Iasi",95060,225,95060,,"MUNICIPIUL IASI",20,"SCOALA STEFAN BARSANESCU, STRADA ZUGRAVI NR. 12 A",1235,540,530,10,0,529,11,1398,858,279,250,1,9364,0
24,"Iasi",95060,225,95060,,"MUNICIPIUL IASI",21,"SCOALA STEFAN BARSANESCU, STRADA ZUGRAVI NR. 12 A",1330,729,716,13,0,717,12,1506,777,307,410,1,9364,0
24,"Iasi",95060,225,95060,,"MUNICIPIUL IASI",22,"SCOALA STEFAN BARSANESCU, STRADA ZUGRAVI NR. 12 A",1152,769,751,17,1,757,12,1300,531,361,396,1,9364,0
24,"Iasi",95060,225,95060,,"MUNICIPIUL IASI",23,"CASA DE CULTURA A STUDENTILOR, STR. VASILE CONTA NR.30",1429,834,793,40,1,821,13,1500,666,370,451,1,9364,0
24,"Iasi",95060,225,95060,,"MUNICIPIUL IASI",24,"COLEGIUL NATIONAL - CORP A, STRADA ARCU NR.4",749,577,564,13,0,567,10,1100,523,237,330,1,9364,0
24,"Iasi",95060,225,95060,,"MUNICIPIUL IASI",25,"COLEGIUL NATIONAL - CORP A, STRADA ARCU NR.4",1309,798,779,19,0,791,7,1409,611,342,449,1,9364,0
24,"Iasi",95060,225,95060,,"MUNICIPIUL IASI",26,"COLEGIUL NATIONAL - Corp C, STRADA HORIA NR. 10",1363,750,736,14,0,736,14,1500,750,383,353,1,9364,0
24,"Iasi",95060,225,95060,,"MUNICIPIUL IASI",27,"COLEGIUL NATIONAL - Corp C, STRADA HORIA NR. 10",1227,674,662,12,0,662,12,1300,626,316,346,1,9364,0
24,"Iasi",95060,225,95060,,"MUNICIPIUL IASI",28,"GRADINITA CU PROGRAM PRELUNGIT NR.4, STRADA SF. ANDREI NR. 73",1440,791,772,18,1,783,8,1600,809,382,401,1,9364,0
24,"Iasi",95060,225,95060,,"MUNICIPIUL IASI",29,"COLEGIUL NATIONAL CORP C, BULEVARDUL STEFAN CEL MARE SI SFINT",1009,553,533,17,3,550,3,1100,547,247,303,1,9364,0
24,"Iasi",95060,225,95060,,"MUNICIPIUL IASI",30,"COLEGIUL  COSTACHE NEGRUZZI, STRADA  TOMA COZMA (fosta CULTURII) NR. 4",1078,646,625,17,4,635,11,1200,554,300,335,1,9364,0
24,"Iasi",95060,225,95060,,"MUNICIPIUL IASI",31,"COLEGIUL  COSTACHE NEGRUZZI, STRADA  TOMA COZMA (fosta CULTURII) NR. 4",923,597,585,12,0,588,9,996,399,273,315,1,9364,0
24,"Iasi",95060,225,95060,,"MUNICIPIUL IASI",32,"LICEUL  TEORETIC  GARABET I BRAILEANU, STRADA OASTEI NR. 1",737,472,463,9,0,469,3,797,325,165,304,1,9364,0
24,"Iasi",95060,225,95060,,"MUNICIPIUL IASI",33,"LICEUL  TEORETIC  GARABET IBRAILEANU, STRADA OASTEI NR. 1",951,982,595,10,377,962,20,1600,618,548,414,1,9364,0
24,"Iasi",95060,225,95060,,"MUNICIPIUL IASI",34,"LICEUL  TEORETIC  GARABET IBRAILEANU, STRADA OASTEI NR. 1",1226,825,752,29,44,808,17,1400,575,346,462,1,9364,0
24,"Iasi",95060,225,95060,,"MUNICIPIUL IASI",35,"LICEUL  TEORETIC  GARABET IBRAILEANU, STRADA OASTEI NR. 1",1055,538,525,12,1,534,4,1200,662,284,250,1,9364,0
24,"Iasi",95060,225,95060,,"MUNICIPIUL IASI",36,".FACULTATEA DE HORTICULTURA, ALEEA M. SADOVEANU NR.3",1468,940,920,19,1,931,9,1600,660,450,481,1,9364,0
24,"Iasi",95060,225,95060,,"MUNICIPIUL IASI",37,"LICEUL DE INFORMATICA GRIGORE MOISIL, STRADA PETRE ANDREI NR.9",1352,729,697,32,0,723,6,1500,771,390,333,1,9364,0
24,"Iasi",95060,225,95060,,"MUNICIPIUL IASI",38,"COLEGIUL NATIONAL MIHAI EMINESCU, STRADA MIHAIL KOGALNICEANU NR. 10",1072,689,677,12,0,678,11,1224,535,331,347,1,9364,0
24,"Iasi",95060,225,95060,,"MUNICIPIUL IASI",39,"COLEGIUL NATIONAL MIHAI EMINESCU, STRADA MIHAIL KOGALNICEANU NR. 10",974,544,530,14,0,537,7,1100,556,293,244,1,9364,0
24,"Iasi",95060,225,95060,,"MUNICIPIUL IASI",40,"SCOALA NR. 28  M. CODREANU, STRADELA SF. TEODOR (SPATE BLOC B1-5)",591,397,386,11,0,395,2,712,315,203,192,1,9364,0
24,"Iasi",95060,225,95060,,"MUNICIPIUL IASI",41,"SCOALA NR. 28  M. CODREANU, STRADELA SF. TEODOR (SPATE BLOC B1-5)",662,401,391,9,1,398,3,700,299,175,223,1,9364,0
24,"Iasi",95060,225,95060,,"MUNICIPIUL IASI",42,"GRUP SCOLAR U.C.E.C.O.M., BULEVARDUL C.A. ROSETTI NR. 12",1203,612,597,14,1,605,7,1300,688,306,299,1,9364,0
24,"Iasi",95060,225,95060,,"MUNICIPIUL IASI",43,"GRUP SCOLAR U.C.E.C.O.M., BULEVARD C.A. ROSETTI NR. 12",977,512,495,16,1,508,4,1100,588,271,237,1,9364,0
24,"Iasi",95060,225,95060,,"MUNICIPIUL IASI",44,"GRUP SCOLAR U.C.E.C.O.M., BULEVARD C.A. ROSETTI NR. 12",973,480,458,19,3,474,6,1100,620,276,198,1,9364,0
24,"Iasi",95060,225,95060,,"MUNICIPIUL IASI",45,"COLEGIUL ECONOMIC ADMINISTRATIV NR. 1, STRADA SARARIE NR. 35",1017,542,524,18,0,535,7,1099,557,286,249,1,9364,0
24,"Iasi",95060,225,95060,,"MUNICIPIUL IASI",46,"COLEGIUL ECONOMIC ADMINISTRATIV NR. 1, STRADA SARARIE NR. 35",1026,627,617,10,0,613,14,1100,473,269,344,1,9364,0
24,"Iasi",95060,225,95060,,"MUNICIPIUL IASI",47,"LICEUL TEORETIC  V. ALECSANDRI, STRADA C. NEGRI NR.50",1256,800,788,12,0,788,12,1400,600,364,424,1,9364,0
24,"Iasi",95060,225,95060,,"MUNICIPIUL IASI",48,"LICEUL TEORETIC  V. ALECSANDRI, STRADA C. NEGRI NR.50",661,390,381,9,0,384,6,700,310,203,181,1,9364,0
24,"Iasi",95060,225,95060,,"MUNICIPIUL IASI",49,"LICEUL TEORETIC  V. ALECSANDRI, STRADA C. NEGRI NR.50",1051,666,656,10,0,658,8,1200,534,242,416,1,9364,0
24,"Iasi",95060,225,95060,,"MUNICIPIUL IASI",50,"GRUP SCOLAR  VASILE PAVELCU, STRADA I.C. BRATIANU NR. 26",984,598,566,32,0,586,12,1100,502,288,298,1,9364,0
24,"Iasi",95060,225,95060,,"MUNICIPIUL IASI",51,"GRUP SCOLAR  VASILE PAVELCU, STRADA I.C. BRATIANU NR. 26",675,383,373,9,1,377,6,701,318,185,192,1,9364,0
24,"Iasi",95060,225,95060,,"MUNICIPIUL IASI",52,"LICEUL DE ARTA  O. BANCILA, STRADA I.C. BRATIANU NR.1",864,539,531,8,0,528,11,1000,461,253,275,1,9364,0
24,"Iasi",95060,225,95060,,"MUNICIPIUL IASI",53,"LICEUL DE ARTA  O. BANCILA, STRADA I.C. BRATIANU NR.1",934,510,496,14,0,504,6,1000,490,222,282,1,9364,0
24,"Iasi",95060,225,95060,,"MUNICIPIUL IASI",54,"SCOALA  NR.34  I. SIMIONESCU, CALEA GALATA NR.42",1048,562,553,8,1,553,9,1200,638,295,258,1,9364,0
24,"Iasi",95060,225,95060,,"MUNICIPIUL IASI",55,"SCOALA  NR.34  I. SIMIONESCU, CALEA GALATA NR.42",781,386,375,11,0,382,4,900,514,188,194,1,9364,0
24,"Iasi",95060,225,95060,,"MUNICIPIUL IASI",56,"SCOALA  NR.34  I. SIMIONESCU, CALEA GALATA NR.42",1478,758,751,7,0,751,7,1600,842,388,363,1,9364,0
24,"Iasi",95060,225,95060,,"MUNICIPIUL IASI",57,"SCOALA  NR.34  I. SIMIONESCU, CALEA GALATA NR.42",1393,649,632,17,0,640,9,1514,865,294,346,1,9364,0
24,"Iasi",95060,225,95060,,"MUNICIPIUL IASI",58,"SCOALA  NR.34  I. SIMIONESCU, CALEA GALATA NR.42",1411,772,761,11,0,763,9,1500,728,345,418,1,9364,0
24,"Iasi",95060,225,95060,,"MUNICIPIUL IASI",59,"SCOALA  NR.34 I. SIMIONESCU, CALEA  GALATA NR.42",1502,834,826,8,0,827,7,1600,766,411,416,1,9364,0
24,"Iasi",95060,225,95060,,"MUNICIPIUL IASI",60,"SCOALA  NR.34 I. SIMIONESCU, CALEA  GALATA NR.42",1395,744,725,19,0,732,12,1500,756,343,389,1,9364,0
24,"Iasi",95060,225,95060,,"MUNICIPIUL IASI",61,"GRADINITA CU PROGRAM PRELUNGIT  NR. 25, SOSEAUA NATIONALA NR. 50",1093,694,684,10,0,685,9,1200,506,342,343,1,9364,0
24,"Iasi",95060,225,95060,,"MUNICIPIUL IASI",62,"GRADINITA CU PROGRAM PRELUNGIT   NR. 25, SOSEAUA NATIONALA NR. 50",1237,540,529,11,0,533,7,1400,860,275,258,1,9364,0
24,"Iasi",95060,225,95060,,"MUNICIPIUL IASI",63,"GRADINITA CU PROGRAM NORMAL  NR.21, SOSEAUA NATIONALA NR.64",1143,641,632,9,0,634,7,1300,659,284,350,1,9364,0
24,"Iasi",95060,225,95060,,"MUNICIPIUL IASI",64,"GRADINITA CU PROGRAM NORMAL  NR.21, SOSEAUA NATIONALA NR.64",909,498,489,9,0,496,2,1000,502,230,266,1,9364,0
24,"Iasi",95060,225,95060,,"MUNICIPIUL IASI",65,"GRADINITA CU PROGRAM NORMAL  NR.21, SOSEAUA NATIONALA NR.64",1123,579,569,10,0,570,9,1200,621,265,305,1,9364,0
24,"Iasi",95060,225,95060,,"MUNICIPIUL IASI",66,"GRADINITA CU PROGRAM NORMAL  NR.21, SOSEAUA NATIONALA NR.64",782,418,408,10,0,414,4,900,482,189,225,1,9364,0
24,"Iasi",95060,225,95060,,"MUNICIPIUL IASI",67,"GRADINITA CU PROGRAM PRELUNGIT  NR.21, STRADA PLAIESILOR NR.35",1226,622,608,14,0,614,8,1300,678,288,326,1,9364,0
24,"Iasi",95060,225,95060,,"MUNICIPIUL IASI",68,"GRADINITA CU PROGRAM PRELUNGIT  NR.21, STRADA PLAIESILOR NR.35",820,491,478,12,1,486,5,900,409,248,238,1,9364,0
24,"Iasi",95060,225,95060,,"MUNICIPIUL IASI",69,"GRADINITA CU PROGRAM NORMAL NR. 7, STRADA PLAIESILOR NR. 35",693,323,307,16,0,316,7,800,477,169,147,1,9364,0
24,"Iasi",95060,225,95060,,"MUNICIPIUL IASI",70,"GRADINITA CU PROGRAM NORMAL NR. 7, STRADA PLAIESILOR NR. 35",1049,497,487,10,0,492,5,1200,703,251,241,1,9364,0
24,"Iasi",95060,225,95060,,"MUNICIPIUL IASI",71,"GRUP SCOLAR  VIRGIL MADGEARU, STRADA PLAIESILOR NR. 9",947,441,429,12,0,435,6,1000,559,201,234,1,9364,0
24,"Iasi",95060,225,95060,,"MUNICIPIUL IASI",72,"GRUP SCOLAR  VIRGIL MADGEARU, STRADA PLAIESILOR NR. 9",1255,574,557,17,0,568,6,1396,822,316,252,1,9364,0
24,"Iasi",95060,225,95060,,"MUNICIPIUL IASI",73,"GRUP SCOLAR  VIRGIL MADGEARU, STRADA PLAIESILOR NR. 9",1489,757,746,10,1,744,13,1600,843,351,393,1,9364,0
24,"Iasi",95060,225,95060,,"MUNICIPIUL IASI",74,"GRUP SCOLAR  VIRGIL MADGEARU, STRADA PLAIESILOR NR. 9",921,645,637,8,0,630,15,1500,855,311,319,1,9364,0
24,"Iasi",95060,225,95060,,"MUNICIPIUL IASI",75,"GRUP SCOLAR  VIRGIL MADGEARU, STRADA PLAIESILOR NR. 9",915,457,444,13,0,442,15,1000,543,216,226,1,9364,0
24,"Iasi",95060,225,95060,,"MUNICIPIUL IASI",76,"SCOALA  NR.13 ALEXANDRU CEL BUN, STRADA MUSATINI NR.53",1146,501,487,12,2,497,4,1300,799,244,253,1,9364,0
24,"Iasi",95060,225,95060,,"MUNICIPIUL IASI",77,"SCOALA  NR.13 ALEXANDRU CEL BUN, STRADA MUSATINI NR.53",1606,941,925,15,1,931,10,1700,759,404,527,1,9364,0
24,"Iasi",95060,225,95060,,"MUNICIPIUL IASI",78,"SCOALA  NR.13 ALEXANDRU CEL BUN, STRADA MUSATINI NR.53",1527,898,886,11,1,886,12,1600,702,374,512,1,9364,0
24,"Iasi",95060,225,95060,,"MUNICIPIUL IASI",79,"SCOALA  NR.13 ALEXANDRU CEL BUN, STRADA MUSATINI NR.53",1223,613,600,12,1,607,6,1290,677,303,304,1,9364,0
24,"Iasi",95060,225,95060,,"MUNICIPIUL IASI",80,"SCOALA  NR.13 ALEXANDRU CEL BUN, STRADA MUSATINI NR.53",1140,582,561,19,2,574,8,1299,717,289,285,1,9364,0
24,"Iasi",95060,225,95060,,"MUNICIPIUL IASI",81,"SCOALA NR. 37  MITROPOLIT DOSOFTEI, STRADA MILCOV NR. 11",1024,504,495,9,0,501,3,1100,596,260,241,1,9364,0
24,"Iasi",95060,225,95060,,"MUNICIPIUL IASI",82,"SCOALA NR. 37  MITROPOLIT DOSOFTEI, STRADA MILCOV NR. 11",1230,568,551,17,0,564,4,1411,843,262,302,1,9364,0
24,"Iasi",95060,225,95060,,"MUNICIPIUL IASI",83,"SCOALA NR. 37  MITROPOLIT DOSOFTEI, STRADA MILCOV NR. 11",1208,690,680,10,0,679,11,1296,606,333,346,1,9364,0
24,"Iasi",95060,225,95060,,"MUNICIPIUL IASI",84,"SCOALA NR. 37  MITROPOLIT DOSOFTEI, STRADA MILCOV NR. 11",1040,661,651,10,0,645,16,1400,739,284,361,1,9364,0
24,"Iasi",95060,225,95060,,"MUNICIPIUL IASI",85,"SCOALA GEORGE COSBUC, STRADA ION SIMIONESCU NR. 16",1550,779,769,10,0,772,7,1700,921,383,389,1,9364,0
24,"Iasi",95060,225,95060,,"MUNICIPIUL IASI",86,"SCOALA GEORGE COSBUC, STRADA ION SIMIONESCU NR. 16",850,464,455,9,0,458,6,893,429,260,198,1,9364,0
24,"Iasi",95060,225,95060,,"MUNICIPIUL IASI",87,"SCOALA GEORGE COSBUC, STRADA ION SIMIONESCU NR. 16",1414,703,692,11,0,700,3,1521,818,376,324,1,9364,0
24,"Iasi",95060,225,95060,,"MUNICIPIUL IASI",88,"SCOALA GEORGE COSBUC, STRADA ION SIMIONESCU NR. 16",1491,705,697,8,0,699,6,1600,895,338,361,1,9364,0
24,"Iasi",95060,225,95060,,"MUNICIPIUL IASI",89,"SCOALA GEORGE COSBUC, STRADA ION SIMIONESCU NR. 16",1686,844,835,9,0,829,15,1800,956,403,426,1,9364,0
24,"Iasi",95060,225,95060,,"MUNICIPIUL IASI",90,"SCOALA GEORGE COSBUC, STRADA ION SIMIONESCU NR. 16",1344,676,663,13,0,672,4,1511,835,320,352,1,9364,0
24,"Iasi",95060,225,95060,,"MUNICIPIUL IASI",91,"SCOALA GEORGE COSBUC, STRADA ION SIMIONESCU NR. 16",805,439,424,15,0,431,8,900,461,213,218,1,9364,0
24,"Iasi",95060,225,95060,,"MUNICIPIUL IASI",92,"SCOALA GEORGE COSBUC, STRADA ION SIMIONESCU NR. 16",822,429,415,14,0,419,10,911,482,221,198,1,9364,0
24,"Iasi",95060,225,95060,,"MUNICIPIUL IASI",93,"SCOALA GEORGE COSBUC, STRADA ION SIMIONESCU NR. 16",617,298,286,12,0,291,7,700,402,142,149,1,9364,0
24,"Iasi",95060,225,95060,,"MUNICIPIUL IASI",94,"SCOALA  AL. VLAHUTA, STRADA BURIDAVA NR. 10",1173,583,572,11,0,581,2,1300,717,273,308,1,9364,0
24,"Iasi",95060,225,95060,,"MUNICIPIUL IASI",95,"SCOALA  AL. VLAHUTA, STRADA BURIDAVA NR. 10",735,306,297,9,0,301,5,800,494,165,136,1,9364,0
24,"Iasi",95060,225,95060,,"MUNICIPIUL IASI",96,"SCOALA  AL. VLAHUTA, STRADA BURIDAVA NR. 10",1162,630,622,8,0,621,9,1300,670,267,354,1,9364,0
24,"Iasi",95060,225,95060,,"MUNICIPIUL IASI",97,"SCOALA  AL. VLAHUTA, STRADA BURIDAVA NR. 10",1006,538,522,16,0,534,4,1100,562,238,296,1,9364,0
24,"Iasi",95060,225,95060,,"MUNICIPIUL IASI",98,"SCOALA  AL. VLAHUTA, STRADA BURIDAVA NR. 10",843,449,439,10,0,442,7,900,451,200,242,1,9364,0
24,"Iasi",95060,225,95060,,"MUNICIPIUL IASI",99,"SCOALA GEORGE CALINESCU, STRADA AMURGULUI NR. 2",1171,646,630,16,0,635,11,1300,654,299,336,1,9364,0
24,"Iasi",95060,225,95060,,"MUNICIPIUL IASI",100,"SCOALA GEORGE CALINESCU, STRADA AMURGULUI NR. 2",1609,895,883,12,0,876,19,1700,805,407,469,1,9364,0
24,"Iasi",95060,225,95060,,"MUNICIPIUL IASI",101,"SCOALA GEORGE CALINESCU, STRADA AMURGULUI NR. 2",1083,531,523,8,0,521,10,1200,669,252,269,1,9364,0
24,"Iasi",95060,225,95060,,"MUNICIPIUL IASI",102,"SCOALA GEORGE CALINESCU, STRADA AMURGULUI NR. 2",1746,906,892,14,0,898,8,1800,894,441,457,1,9364,0
24,"Iasi",95060,225,95060,,"MUNICIPIUL IASI",103,"SCOALA GEORGE CALINESCU, STRADA AMURGULUI NR. 2",1742,745,737,8,0,736,9,1600,855,388,348,1,9364,0
24,"Iasi",95060,225,95060,,"MUNICIPIUL IASI",104,"SCOALA GEORGE CALINESCU, STRADA AMURGULUI NR. 2",1309,695,679,16,0,685,10,1400,705,339,346,1,9364,0
24,"Iasi",95060,225,95060,,"MUNICIPIUL IASI",105,"GRUP SCOLAR ECONOMIC DE TURISM, STRADA MIRCEA CEL BATRAN NR. 12",858,486,473,13,0,477,9,916,430,247,230,1,9364,0
24,"Iasi",95060,225,95060,,"MUNICIPIUL IASI",106,"GRUP SCOLAR ECONOMIC DE TURISM, STRADA MIRCEA CEL BATRAN NR. 12",1341,689,679,10,0,681,8,1500,811,351,330,1,9364,0
24,"Iasi",95060,225,95060,,"MUNICIPIUL IASI",107,"GRUP SCOLAR ECONOMIC DE TURISM, STRADA MIRCEA CEL BATRAN NR. 12",1482,768,755,13,0,762,6,1600,832,348,414,1,9364,0
24,"Iasi",95060,225,95060,,"MUNICIPIUL IASI",108,"GRUP SCOLAR ECONOMIC DE TURISM, STRADA MIRCEA CEL BATRAN NR. 12",1299,709,700,9,0,703,6,1400,691,379,324,1,9364,0
24,"Iasi",95060,225,95060,,"MUNICIPIUL IASI",109,"GRUP SCOLAR ECONOMIC DE TURISM, STRADA MIRCEA CEL BATRAN NR. 12",1335,650,638,12,0,643,7,1500,850,318,325,1,9364,0
24,"Iasi",95060,225,95060,,"MUNICIPIUL IASI",110,"GRUP SCOLAR ECONOMIC DE TURISM, STRADA MIRCEA CEL BATRAN NR. 12",891,357,342,13,2,355,2,1000,643,184,171,1,9364,0
24,"Iasi",95060,225,95060,,"MUNICIPIUL IASI",111,"GRUP SCOLAR ECONOMIC DE TURISM, STRADA MIRCEA CEL BATRAN NR. 12",1057,428,418,10,0,424,4,1200,772,218,206,1,9364,0
24,"Iasi",95060,225,95060,,"MUNICIPIUL IASI",112,"SCOALA  NR.8  CARMEN SYLVA, STRADA GHICA VODA NR.24",1464,844,825,19,0,836,8,1600,756,365,471,1,9364,0
24,"Iasi",95060,225,95060,,"MUNICIPIUL IASI",113,"SCOALA  NR.8  CARMEN SYLVA, STRADA GHICA VODA NR.24",1196,744,700,14,30,738,6,1300,556,347,391,1,9364,0
24,"Iasi",95060,225,95060,,"MUNICIPIUL IASI",114,"SCOALA NR. 5  CALISTRAT HOGAS, STRADA CIRIC NR. 23A",1547,859,841,16,2,849,10,1700,841,464,385,1,9364,0
24,"Iasi",95060,225,95060,,"MUNICIPIUL IASI",115,"SCOALA NR. 5  CALISTRAT HOGAS, STRADA CIRIC NR. 23A",1301,585,574,11,0,579,6,1400,815,281,298,1,9364,0
24,"Iasi",95060,225,95060,,"MUNICIPIUL IASI",116,"SCOALA NR. 5  CALISTRAT HOGAS, STRADA CIRIC NR. 23A",1071,443,432,11,0,436,7,1211,768,220,216,1,9364,0
24,"Iasi",95060,225,95060,,"MUNICIPIUL IASI",117,"SCOALA NR. 30  C. NEGRI, STRADA ETERNITATE NR. 37",1095,612,598,14,0,604,8,1200,588,319,285,1,9364,0
24,"Iasi",95060,225,95060,,"MUNICIPIUL IASI",118,"SCOALA NR. 30  C. NEGRI, STRADA ETERNITATE NR. 37",1516,748,728,20,0,737,11,1600,852,368,369,1,9364,0
24,"Iasi",95060,225,95060,,"MUNICIPIUL IASI",119,"SCOALA  NR. 22  B. P. HASDEU, STRADA I. CREANGA NR. 27",1326,774,760,14,0,761,13,1400,626,388,373,1,9364,0
24,"Iasi",95060,225,95060,,"MUNICIPIUL IASI",120,"SCOALA  NR. 22  B. P. HASDEU, STRADA I. CREANGA NR. 27",1270,639,627,10,2,628,11,1400,761,318,310,1,9364,0
24,"Iasi",95060,225,95060,,"MUNICIPIUL IASI",121,"SCOALA  NR. 22  B. P. HASDEU, STRADA I. CREANGA NR. 27",1395,647,623,24,0,646,1,1500,853,339,307,1,9364,0
24,"Iasi",95060,225,95060,,"MUNICIPIUL IASI",122,"LICEUL TEORETIC AL.I.CUZA, STRADA ION CREANGA NR. 37",1126,722,711,11,0,700,22,1210,488,312,388,1,9364,0
24,"Iasi",95060,225,95060,,"MUNICIPIUL IASI",123,"LICEUL TEORETIC AL.I.CUZA, STRADA ION CREANGA NR. 37",1436,880,866,13,1,865,15,1600,720,384,481,1,9364,0
24,"Iasi",95060,225,95060,,"MUNICIPIUL IASI",124,"LICEUL TEORETIC AL.I.CUZA, STRADA ION CREANGA NR. 37",909,539,525,14,0,531,8,1000,461,230,301,1,9364,0
24,"Iasi",95060,225,95060,,"MUNICIPIUL IASI",125,"LICEUL TEORETIC AL.I.CUZA, STRADA ION CREANGA NR. 37",884,490,482,8,0,484,6,993,503,215,269,1,9364,0
24,"Iasi",95060,225,95060,,"MUNICIPIUL IASI",126,"SCOALA NR.18   C. CONACHI, STRADA I. CREANGA NR.109",1358,797,782,11,4,787,10,1500,703,399,388,1,9364,0
24,"Iasi",95060,225,95060,,"MUNICIPIUL IASI",127,"SCOALA NR.18   C. CONACHI, STRADA I. CREANGA NR.109",1118,544,533,11,0,535,9,1200,656,304,231,1,9364,0
24,"Iasi",95060,225,95060,,"MUNICIPIUL IASI",128,"SCOALA NR.18   C. CONACHI, STRADA I. CREANGA NR.109",1194,621,610,11,0,616,5,1337,716,323,293,1,9364,0
24,"Iasi",95060,225,95060,,"MUNICIPIUL IASI",129,"SCOALA NR.18   C. CONACHI, STRADA I. CREANGA NR.109",1196,553,543,9,1,543,10,1300,747,306,237,1,9364,0
24,"Iasi",95060,225,95060,,"MUNICIPIUL IASI",130,"SCOALA NR.18   C. CONACHI, STRADA I. CREANGA NR.109",1364,624,606,17,1,618,6,1490,866,260,358,1,9364,0
24,"Iasi",95060,225,95060,,"MUNICIPIUL IASI",131,"SALA SPORTURILOR GRADINARI, BULEVARDUL CHIMIEI",941,529,522,7,0,525,4,1200,671,284,241,1,9364,0
24,"Iasi",95060,225,95060,,"MUNICIPIUL IASI",132,"SALA SPORTURILOR GRADINARI, BULEVARDUL CHIMIEI",1522,735,717,18,0,727,8,1600,865,354,373,1,9364,0
24,"Iasi",95060,225,95060,,"MUNICIPIUL IASI",133,"SALA SPORTURILOR GRADINARI, BULEVARDUL CHIMIEI",1421,607,594,13,0,605,2,1500,893,320,285,1,9364,0
24,"Iasi",95060,225,95060,,"MUNICIPIUL IASI",134,"SALA SPORTURILOR GRADINARI, BULEVARDUL CHIMIEI",1420,788,778,10,0,778,10,1500,712,396,382,1,9364,0
24,"Iasi",95060,225,95060,,"MUNICIPIUL IASI",135,"SALA SPORTURILOR GRADINARI, BULEVARDUL CHIMIEI",1370,708,697,11,0,699,9,1500,792,358,341,1,9364,0
24,"Iasi",95060,225,95060,,"MUNICIPIUL IASI",136,"SALA SPORTURILOR GRADINARI, BULEVARDUL CHIMIEI",836,410,398,12,0,406,4,893,483,217,189,1,9364,0
24,"Iasi",95060,225,95060,,"MUNICIPIUL IASI",137,"SCOALA IONEL TEODOREANU, STRADA VASILE LUPU NR.110B",1350,763,754,9,0,758,5,1500,737,368,390,1,9364,0
24,"Iasi",95060,225,95060,,"MUNICIPIUL IASI",138,"SCOALA IONEL TEODOREANU, STRADA VASILE LUPU NR.110B",1131,602,590,12,0,592,10,1200,598,283,309,1,9364,0
24,"Iasi",95060,225,95060,,"MUNICIPIUL IASI",139,"SCOALA IONEL TEODOREANU, STRADA VASILE LUPU NR.110B",1232,645,637,8,0,636,9,1400,755,293,343,1,9364,0
24,"Iasi",95060,225,95060,,"MUNICIPIUL IASI",140,"SCOALA IONEL TEODOREANU, STRADA VASILE LUPU NR.110B",1423,771,762,9,0,759,12,1500,729,339,420,1,9364,0
24,"Iasi",95060,225,95060,,"MUNICIPIUL IASI",141,"SCOALA IONEL TEODOREANU, STRADA VASILE LUPU NR.110B",1092,612,603,9,0,607,5,1189,577,306,301,1,9364,0
24,"Iasi",95060,225,95060,,"MUNICIPIUL IASI",142,"SCOALA GH.I. BRATIANU, STRADA CIORNEI NR.18-20",1604,697,684,13,0,688,9,1700,1003,307,381,1,9364,0
24,"Iasi",95060,225,95060,,"MUNICIPIUL IASI",143,"SCOALA GH.I. BRATIANU, STRADA CIORNEI NR.18-20",1228,662,652,10,0,654,8,1300,638,303,351,1,9364,0
24,"Iasi",95060,225,95060,,"MUNICIPIUL IASI",144,"SCOALA GH.I. BRATIANU, STRADA CIORNEI NR.18-20",1278,765,750,15,0,759,6,1387,622,396,363,1,9364,0
24,"Iasi",95060,225,95060,,"MUNICIPIUL IASI",145,"SCOALA GH.I. BRATIANU, STRADA CIORNEI NR.18-20",1218,551,539,11,1,548,3,1300,749,292,256,1,9364,0
24,"Iasi",95060,225,95060,,"MUNICIPIUL IASI",146,"SCOALA GH.I. BRATIANU, STRADA CIORNEI NR.18-20",1138,721,706,15,0,713,8,1296,575,316,397,1,9364,0
24,"Iasi",95060,225,95060,,"MUNICIPIUL IASI",147,"FACULTATEA DE CHIMIE, BULEVARDUL  D. MANGERON NR.71",973,581,515,66,0,569,12,1100,519,263,306,1,9364,0
24,"Iasi",95060,225,95060,,"MUNICIPIUL IASI",148,"FACULTATEA DE CONSTRUCTII, BULEVARDUL  D. MANGERON NR. 43",818,510,495,14,1,497,13,901,391,201,296,1,9364,0
24,"Iasi",95060,225,95060,,"MUNICIPIUL IASI",149,"FACULTATEA DE CONSTRUCTII, BULEVARDUL  D. MANGERON NR. 43",802,475,463,12,0,470,5,900,425,208,262,1,9364,0
24,"Iasi",95060,225,95060,,"MUNICIPIUL IASI",150,"FACULTATEA DE CONSTRUCTII, BULEVARDUL  D. MANGERON NR. 43",1225,784,773,10,1,765,19,1289,505,377,388,1,9364,0
24,"Iasi",95060,225,95060,,"MUNICIPIUL IASI",151,"SCOALA  NR.24  ION GHICA, STRADA PRIMAVERII NR.38",1558,830,814,16,0,822,8,1700,870,381,441,1,9364,0
24,"Iasi",95060,225,95060,,"MUNICIPIUL IASI",152,"SCOALA  NR.24  ION GHICA, STRADA PRIMAVERII NR.38",733,420,404,16,0,417,3,800,380,186,231,1,9364,0
24,"Iasi",95060,225,95060,,"MUNICIPIUL IASI",153,"SCOALA  NR.24  ION GHICA, STRADA PRIMAVERII NR.38",765,447,433,14,0,444,3,793,346,245,199,1,9364,0
24,"Iasi",95060,225,95060,,"MUNICIPIUL IASI",154,"CASA SINDICATELOR, BULEVARDUL  SOCOLA NR.113",887,368,352,16,0,366,2,1000,632,204,162,1,9364,0
24,"Iasi",95060,225,95060,,"MUNICIPIUL IASI",155,"CASA SINDICATELOR, BULEVARDUL  SOCOLA NR.113",808,435,428,7,0,434,1,900,465,248,186,1,9364,0
24,"Iasi",95060,225,95060,,"MUNICIPIUL IASI",156,"CASA SINDICATELOR, BULEVARDUL  SOCOLA NR.113",639,410,395,15,0,407,3,900,490,186,221,1,9364,0
24,"Iasi",95060,225,95060,,"MUNICIPIUL IASI",157,"CASA SINDICATELOR, BULEVARDUL  SOCOLA NR.113",838,336,324,12,0,329,7,898,562,183,146,1,9364,0
24,"Iasi",95060,225,95060,,"MUNICIPIUL IASI",158,"COLEGIUL TEHNIC IOAN C.STEFANESCU, BULEVARDUL  SOCOLA NR. 51",867,466,455,11,0,458,8,1000,534,226,232,1,9364,0
24,"Iasi",95060,225,95060,,"MUNICIPIUL IASI",159,"COLEGIUL TEHNIC IOAN C.STEFANESCU, BULEVARDUL  SOCOLA NR. 51",924,331,309,22,0,324,7,994,663,193,131,1,9364,0
24,"Iasi",95060,225,95060,,"MUNICIPIUL IASI",160,"COLEGIUL TEHNIC I.C.STEFANESCU, BULEVARDUL  SOCOLA NR. 53",716,275,257,16,2,271,4,795,520,153,118,1,9364,0
24,"Iasi",95060,225,95060,,"MUNICIPIUL IASI",161,"GRUP SCOLAR  ANGHEL SALIGNY, STRADA BUCIUM NR.17",1232,602,590,12,0,599,3,1400,798,283,316,1,9364,0
24,"Iasi",95060,225,95060,,"MUNICIPIUL IASI",162,"GRUP SCOLAR  ANGHEL SALIGNY, STRADA BUCIUM NR.17",509,263,249,14,0,261,2,600,337,123,138,1,9364,0
24,"Iasi",95060,225,95060,,"MUNICIPIUL IASI",163,"GRUP SCOLAR  ANGHEL SALIGNY, STRADA BUCIUM NR.17",689,338,329,9,0,336,2,798,460,151,185,1,9364,0
24,"Iasi",95060,225,95060,,"MUNICIPIUL IASI",164,"GRUP SCOLAR  ANGHEL SALIGNY, STRADA BUCIUM NR.17",1341,621,611,10,0,613,8,1500,879,316,297,1,9364,0
24,"Iasi",95060,225,95060,,"MUNICIPIUL IASI",165,"COLEGIUL TEHNIC DE ELECTRONICA SI TELECOMUNICATII, STRADA MIHAIL STURDZA NR.43",1491,719,706,13,0,709,10,1600,881,351,358,1,9364,0
24,"Iasi",95060,225,95060,,"MUNICIPIUL IASI",166,"COLEGIUL TEHNIC DE ELECTRONICA SI TELECOMUNICATII, STRADA MIHAIL STURDZA NR.43",1229,436,424,12,0,429,7,1300,864,251,178,1,9364,0
24,"Iasi",95060,225,95060,,"MUNICIPIUL IASI",167,"SCOALA  VERONICA MICLE, SOSEA BUCIUM NR. 72",1116,659,637,21,1,649,10,1200,541,367,282,1,9364,0
24,"Iasi",95060,225,95060,,"MUNICIPIUL IASI",168,"SCOALA  VERONICA MICLE, SOSEA BUCIUM NR. 72",1059,591,577,14,0,585,6,1200,609,295,290,1,9364,0
24,"Iasi",95060,225,95060,,"MUNICIPIUL IASI",169,"SCOALA  VERONICA MICLE, SOSEA BUCIUM NR. 72",1093,600,583,17,0,591,9,1200,600,307,284,1,9364,0
24,"Iasi",95060,225,95060,,"MUNICIPIUL IASI",170,"GRUP SCOLAR DUMITRU MANGERON, BULEVARD POITIERS NR.41",808,464,449,15,0,457,7,900,436,241,216,1,9364,0
24,"Iasi",95060,225,95060,,"MUNICIPIUL IASI",171,"GRUP SCOLAR DUMITRU MANGERON, BULEVARD POITIERS NR.41",821,369,361,8,0,366,3,912,543,169,197,1,9364,0
24,"Iasi",95060,225,95060,,"MUNICIPIUL IASI",172,"GRUP SCOLAR DUMITRU MANGERON, BULEVARD POITIERS NR.41",932,399,391,8,0,397,2,1010,611,228,169,1,9364,0
24,"Iasi",95060,225,95060,,"MUNICIPIUL IASI",173,"GRUP SCOLAR DUMITRU MANGERON, BULEVARD POITIERS NR.41",754,230,221,9,0,228,2,800,570,158,70,1,9364,0
24,"Iasi",95060,225,95060,,"MUNICIPIUL IASI",174,"GRUP SCOLAR DUMITRU MANGERON, BULEVARD POITIERS NR.41",870,399,384,15,0,397,2,1000,601,227,170,1,9364,0
24,"Iasi",95060,225,95060,,"MUNICIPIUL IASI",175,"GRUP SCOLAR DUMITRU MANGERON, BULEVARD POITIERS NR.41",989,447,436,10,1,442,5,1110,663,233,209,1,9364,0
24,"Iasi",95060,225,95060,,"MUNICIPIUL IASI",176,"SCOALA  DIMITRIE A. STURDZA, STRADA CETATUIA NR. 3",847,419,409,10,0,416,3,900,481,229,187,1,9364,0
24,"Iasi",95060,225,95060,,"MUNICIPIUL IASI",177,"SCOALA  DIMITRIE A. STURDZA, STRADA CETATUIA NR. 3",1111,534,519,15,0,525,9,1200,666,303,222,1,9364,0
24,"Iasi",95060,225,95060,,"MUNICIPIUL IASI",178,"SCOALA  DIMITRIE A. STURDZA, STRADA CETATUIA NR. 3",1323,642,624,18,0,637,5,1400,758,352,285,1,9364,0
24,"Iasi",95060,225,95060,,"MUNICIPIUL IASI",179,"SCOALA  DIMITRIE A. STURDZA, STRADA CETATUIA NR. 3",1597,794,780,13,1,782,12,1700,906,425,357,1,9364,0
24,"Iasi",95060,225,95060,,"MUNICIPIUL IASI",180,"SCOALA NR. 40  A. RUSSO, STRADA LIBERTATII NR. 24",1431,704,693,11,0,693,11,1584,880,400,293,1,9364,0
24,"Iasi",95060,225,95060,,"MUNICIPIUL IASI",181,"SCOALA NR. 40  A. RUSSO, STRADA LIBERTATII NR. 24",1639,821,813,8,0,808,13,1800,979,395,413,1,9364,0
24,"Iasi",95060,225,95060,,"MUNICIPIUL IASI",182,"SCOALA NR. 40  A. RUSSO, STRADA LIBERTATII NR. 24",1020,441,434,7,0,435,6,1100,659,221,214,1,9364,0
24,"Iasi",95060,225,95060,,"MUNICIPIUL IASI",183,"SCOALA NR. 40  A. RUSSO, STRADA LIBERTATII NR. 24",789,432,421,11,0,425,7,896,464,210,215,1,9364,0
24,"Iasi",95060,225,95060,,"MUNICIPIUL IASI",184,"SCOALA NR. 40  A. RUSSO, STRADA LIBERTATII NR. 24",1202,601,591,10,0,598,3,1300,699,329,269,1,9364,0
24,"Iasi",95060,225,95060,,"MUNICIPIUL IASI",185,"SCOALA NR. 40  A. RUSSO, STRADA LIBERTATII NR. 24",1011,495,484,11,0,491,4,1100,605,273,218,1,9364,0
24,"Iasi",95060,225,95060,,"MUNICIPIUL IASI",186,"SCOALA NR. 19   GH. GHIBANESCU, ALEEA NICOLINA NR. 167",839,446,433,13,0,443,3,893,447,256,187,1,9364,0
24,"Iasi",95060,225,95060,,"MUNICIPIUL IASI",187,"SCOALA NR. 19   GH. GHIBANESCU, ALEEA NICOLINA NR. 167",859,454,445,9,0,448,6,896,442,231,217,1,9364,0
24,"Iasi",95060,225,95060,,"MUNICIPIUL IASI",188,"SCOALA NR. 19   GH. GHIBANESCU, ALEEA NICOLINA NR. 167",1654,900,889,11,0,876,24,1800,900,484,392,1,9364,0
24,"Iasi",95060,225,95060,,"MUNICIPIUL IASI",189,"SCOALA NR. 19   GH. GHIBANESCU, ALEEA NICOLINA NR. 167",1530,812,794,16,2,797,15,1600,788,456,341,1,9364,0
24,"Iasi",95060,225,95060,,"MUNICIPIUL IASI",190,"SCOALA NR. 19   GH. GHIBANESCU, ALEEA NICOLINA NR. 167",1265,643,632,11,0,633,10,1400,757,344,289,1,9364,0
24,"Iasi",95060,225,95060,,"MUNICIPIUL IASI",191,"GRADINITA CU PROGRAM PRELUNGIT NR.1, SOSEAUA NICOLINA NR.46",916,534,516,18,0,524,10,996,462,250,274,1,9364,0
24,"Iasi",95060,225,95060,,"MUNICIPIUL IASI",192,"GRADINITA CU PROGRAM PRELUNGIT NR.1, SOSEAUA NICOLINA NR.46",1263,672,658,14,0,657,15,1392,720,336,321,1,9364,0
24,"Iasi",95060,225,95060,,"MUNICIPIUL IASI",193,"SCOALA  NR.42  N. IORGA, STRADA HLINCEA NR.7",1536,737,721,16,0,734,3,1600,863,422,312,1,9364,0
24,"Iasi",95060,225,95060,,"MUNICIPIUL IASI",194,"SCOALA  NR.42  N. IORGA, STRADA HLINCEA NR.7",1554,748,737,11,0,739,9,1700,952,446,293,1,9364,0
24,"Iasi",95060,225,95060,,"MUNICIPIUL IASI",195,"SCOALA  NR.42  N. IORGA, STRADA HLINCEA NR.7",1203,631,621,10,0,625,6,1300,669,359,266,1,9364,0
24,"Iasi",95060,225,95060,,"MUNICIPIUL IASI",196,"SCOALA  NR.42  N. IORGA, STRADA HLINCEA NR.7",1008,513,499,14,0,507,6,1100,587,267,240,1,9364,0
24,"Iasi",95060,225,95060,,"MUNICIPIUL IASI",197,"SCOALA  NR.42  N. IORGA, STRADA HLINCEA NR.7",1572,778,767,11,0,766,12,1700,922,404,362,1,9364,0
24,"Iasi",95060,225,95060,,"MUNICIPIUL IASI",198,"SCOALA  NR.42  N. IORGA, STRADA HLINCEA NR.7",1513,785,768,17,0,778,7,1600,815,406,372,1,9364,0
24,"Iasi",95060,225,95060,,"MUNICIPIUL IASI",199,"PARCUL STIINTIFIC SI TEHNOLOGIC IASI (COMPLEX TEHNOPOLIS)",1208,587,574,13,0,583,4,1300,713,308,275,1,9364,0
24,"Iasi",95060,225,95060,,"MUNICIPIUL IASI",200,"PARCUL STIINTIFIC SI TEHNOLOGIC IASI (COMPLEX TEHNOPOLIS)",1130,581,566,15,0,576,5,1200,619,324,252,1,9364,0
24,"Iasi",95060,225,95060,,"MUNICIPIUL IASI",201,"SCOALA GENERALA  TUDOR ARGHEZI, SOSEA IASI-VOINESTI NR. 32",1176,566,552,14,0,559,7,1287,721,280,279,1,9364,0
24,"Iasi",95060,225,95060,,"MUNICIPIUL IASI",202,"SCOALA GENERALA  TUDOR ARGHEZI, SOSEA IASI-VOINESTI NR. 32",1240,616,601,15,0,603,13,1400,784,312,291,1,9364,0
24,"Iasi",95060,225,95060,,"MUNICIPIUL IASI",203,"SCOALA  NR.11 O.CAZIMIR, BULEVARD SOCOLA NR. 13",1312,680,670,10,0,663,17,1400,720,313,350,1,9364,0
24,"Iasi",95060,225,95060,,"MUNICIPIUL IASI",204,"SCOALA  NR.11 O.CAZIMIR, BULEVARD SOCOLA NR. 13",1177,634,623,11,0,627,7,1313,679,319,308,1,9364,0
24,"Iasi",95060,225,95060,,"MUNICIPIUL IASI",205,"SCOALA  NR.11 O.CAZIMIR, BULEVARD SOCOLA NR. 13",1206,659,644,15,0,645,14,1323,664,320,325,1,9364,0
24,"Iasi",95060,225,95060,,"MUNICIPIUL IASI",206,"SCOALA  NR.11 O.CAZIMIR, BULEVARD SOCOLA NR. 13",1329,744,733,11,0,736,8,1500,756,322,414,1,9364,0
24,"Iasi",95060,225,95060,,"MUNICIPIUL IASI",207,"COLEGIUL  NATIONAL EMIL RACOVITA, ALEEA NICOLINA NR.4",1307,691,678,13,0,681,10,1403,712,297,384,1,9364,0
24,"Iasi",95060,225,95060,,"MUNICIPIUL IASI",208,"COLEGIUL  NATIONAL EMIL RACOVITA, ALEEA NICOLINA NR.4",1394,800,786,12,2,793,7,1495,695,364,429,1,9364,0
24,"Iasi",95060,225,95060,,"MUNICIPIUL IASI",209,"COLEGIUL  NATIONAL EMIL RACOVITA, ALEEA NICOLINA NR.4",811,450,435,15,0,442,8,900,450,183,259,1,9364,0
24,"Iasi",95060,225,95060,,"MUNICIPIUL IASI",210,"COLEGIUL  NATIONAL EMIL RACOVITA, ALEEA NICOLINA NR.4",955,537,525,12,0,532,5,1100,563,261,271,1,9364,0
24,"Iasi",95060,225,95060,,"MUNICIPIUL IASI",211,"LICEUL   DIMITRIE CANTEMIR, STRADA DECEBAL NR. 13",1268,704,691,13,0,695,9,1400,696,312,383,1,9364,0
24,"Iasi",95060,225,95060,,"MUNICIPIUL IASI",212,"LICEUL   DIMITRIE CANTEMIR, STRADA DECEBAL NR. 13",1294,709,694,15,0,698,11,1400,691,325,373,1,9364,0
24,"Iasi",95060,225,95060,,"MUNICIPIUL IASI",213,"LICEUL   DIMITRIE CANTEMIR, STRADA DECEBAL NR. 13",1602,941,930,11,0,933,8,1700,759,438,495,1,9364,0
24,"Iasi",95060,225,95060,,"MUNICIPIUL IASI",214,"LICEUL   DIMITRIE CANTEMIR, STRADA DECEBAL NR. 13",961,509,500,9,0,505,4,1100,591,231,274,1,9364,0
24,"Iasi",95060,225,95060,,"MUNICIPIUL IASI",215,"SCOALA TITU MAIORESCU, ALEEA DECEBAL NR.10",732,438,422,16,0,432,6,800,362,211,221,1,9364,0
24,"Iasi",95060,225,95060,,"MUNICIPIUL IASI",216,"SCOALA TITU MAIORESCU, ALEEA DECEBAL NR.10",597,327,317,10,0,323,4,700,373,144,179,1,9364,0
24,"Iasi",95060,225,95060,,"MUNICIPIUL IASI",217,"SCOALA TITU MAIORESCU, ALEEA DECEBAL NR.10",1166,633,622,11,0,625,8,1300,667,327,298,1,9364,0
24,"Iasi",95060,225,95060,,"MUNICIPIUL IASI",218,"GRADINITA NR. 23, SOSEA NATIONALA NR.45",860,455,441,14,0,450,5,897,442,198,252,1,9364,0
24,"Iasi",95060,225,95060,,"MUNICIPIUL IASI",219,"SCOALA  ION NECULCE, STRADA ROMANA NR.30",1318,600,592,8,0,595,5,1400,800,278,317,1,9364,0
24,"Iasi",95060,225,95060,,"MUNICIPIUL IASI",220,"SCOALA  ION NECULCE, STRADA ROMANA NR.30",1649,941,934,7,0,931,10,1800,859,451,480,1,9364,0
24,"Iasi",95060,225,95060,,"MUNICIPIUL IASI",221,"SCOALA  ION NECULCE, STRADA ROMANA NR.30",1001,569,555,13,1,562,7,1091,522,259,303,1,9364,0
24,"Iasi",95060,225,95060,,"MUNICIPIUL IASI",222,"SCOALA  ION NECULCE, STRADA ROMANA NR.30",798,341,334,7,0,336,5,886,545,158,178,1,9364,0
24,"Iasi",95060,225,95060,,"MUNICIPIUL IASI",223,"SCOALA  NR.36 VASILE CONTA - CORP B, ALEEA NICOLINA NR.86",997,728,714,14,0,719,9,1400,672,351,368,1,9364,0
24,"Iasi",95060,225,95060,,"MUNICIPIUL IASI",224,"SCOALA  NR.36 VASILE CONTA - CORP B, ALEEA NICOLINA NR.86",1326,662,651,11,0,655,7,1400,738,308,347,1,9364,0
24,"Iasi",95060,225,95060,,"MUNICIPIUL IASI",225,"SCOALA  NR.36 VASILE CONTA - CORP B, ALEEA NICOLINA NR.86",1399,738,729,9,0,728,10,1500,762,340,388,1,9364,0
24,"Iasi",95060,225,95060,,"MUNICIPIUL IASI",226,"SCOALA  NR.36 VASILE CONTA - CORP A, STRADA GH. DOJA NR.2",1623,819,811,8,0,809,10,1700,881,402,407,1,9364,0
24,"Iasi",95060,225,95060,,"MUNICIPIUL IASI",227,"SCOALA  NR.36 VASILE CONTA - CORP A, STRADA GH. DOJA NR.2",1520,799,785,14,0,790,9,1600,801,427,363,1,9364,0
24,"Iasi",95060,225,95060,,"MUNICIPIUL IASI",228,"SCOALA  NR.36 VASILE CONTA - CORP A, STRADA GH. DOJA NR.2",1130,538,530,8,0,527,11,1177,639,279,248,1,9364,0
24,"Iasi",95060,225,95060,,"MUNICIPIUL IASI",229,"SCOALA  NR.36 VASILE CONTA - CORP A, STRADA GH. DOJA NR.2",1146,622,613,9,0,617,5,1300,678,330,287,1,9364,0
24,"Iasi",95060,225,95060,,"MUNICIPIUL IASI",230,"GRUPUL SCOLAR  ION HOLBAN, STRADA PANTELIMON HALIPA, NR.16",1772,928,920,8,0,918,10,1900,972,464,454,1,9364,0
24,"Iasi",95060,225,95060,,"MUNICIPIUL IASI",231,"GRUPUL SCOLAR  ION HOLBAN, STRADA PANTELIMON HALIPA, NR.16",1039,500,483,17,0,493,7,1088,588,252,241,1,9364,0
24,"Iasi",95060,225,95060,,"MUNICIPIUL IASI",232,"GRUPUL SCOLAR  ION HOLBAN, STRADA PANTELIMON HALIPA, NR.16",1367,610,591,17,2,600,10,1496,886,281,319,1,9364,0
24,"Iasi",95060,225,95060,,"MUNICIPIUL IASI",233,"LICEUL  MIRON COSTIN, STRADA MUSATINI NR.2",1427,745,737,8,0,737,8,1500,755,394,343,1,9364,0
24,"Iasi",95060,225,95060,,"MUNICIPIUL IASI",234,"LICEUL  MIRON COSTIN, STRADA MUSATINI NR.2",1311,793,785,8,0,784,9,1400,607,327,457,1,9364,0
24,"Iasi",95060,225,95060,,"MUNICIPIUL IASI",235,"LICEUL  MIRON COSTIN, STRADA MUSATINI NR.2",1437,735,725,10,0,726,9,1600,865,317,409,1,9364,0
24,"Iasi",95060,225,95060,,"MUNICIPIUL IASI",236,"LICEUL  MIRON COSTIN, STRADA MUSATINI NR.2",1354,660,643,17,0,654,6,1500,840,309,345,1,9364,0
24,"Iasi",95060,225,95060,,"MUNICIPIUL IASI",237,"CAMIN T1-T2, CAMPUS TUDOR VLADIMIRESCU",0,1575,0,1575,0,1546,29,1600,25,883,663,1,9364,1
24,"Iasi",95060,225,95060,,"MUNICIPIUL IASI",238,"CAMIN T3-T4, CAMPUS TUDOR VLADIMIRESCU",0,1208,0,1208,0,1188,20,1600,392,712,476,1,9364,1
24,"Iasi",95060,225,95060,,"MUNICIPIUL IASI",239,"CAMIN T5, CAMPUS TUDOR VLADIMIRESCU",0,822,0,822,0,803,19,1600,778,446,357,1,9364,1
24,"Iasi",95060,225,95060,,"MUNICIPIUL IASI",240,"CAMIN T7-T8, CAMPUS TUDOR VLADIMIRESCU",0,915,0,915,0,895,20,1600,685,477,418,1,9364,1
24,"Iasi",95060,225,95060,,"MUNICIPIUL IASI",241,"CAMIN T17, CAMPUS TUDOR VLADIMIRESCU",0,1454,0,1454,0,1430,24,1600,146,856,574,1,9364,1
24,"Iasi",95060,225,95060,,"MUNICIPIUL IASI",242,"CAMIN C10, CAMPUS CODRESCU",0,643,0,643,0,631,12,1600,957,381,250,1,9364,1
24,"Iasi",95060,225,95060,,"MUNICIPIUL IASI",243,"CAMIN C12, CAMPUS CODRESCU",0,944,0,944,0,915,29,1600,656,516,399,1,9364,1
24,"Iasi",95060,225,95060,,"MUNICIPIUL IASI",244,"CAMIN C2, TARGUSOR COPOU",0,937,0,937,0,908,29,1600,663,510,398,1,9364,1
24,"Iasi",95060,225,95060,,"MUNICIPIUL IASI",245,"CAMIN C6, CAMPUS TITU MAIORESCU",0,923,0,923,0,902,21,1600,677,508,394,1,9364,1
24,"Iasi",95060,225,95060,,"MUNICIPIUL IASI",246,"CAMIN C7, CAMPUS TITU MAIORESCU",0,631,0,631,0,615,16,1600,969,360,255,1,9364,1
24,"Iasi",95060,225,95060,,"MUNICIPIUL IASI",247,"COLEGIUL TEHNIC GHEORGHE ASACHI, STRADA SARARIEI NR.189",0,449,0,449,0,439,10,1600,1151,247,192,1,9364,1
24,"Iasi",95060,225,95060,,"MUNICIPIUL IASI",248,"FACULTATEA DE MEDICINA VETERINARA, ALEEA M. SADOVEANU NR.3",0,830,0,830,0,811,19,1600,770,421,390,1,9364,1
24,"Iasi",95060,225,95060,,"MUNICIPIUL IASI",249,"GRUP SCOLAR V.  PAVELCU, STRADA  I.C. BRATIANU NR.1",0,433,0,433,0,432,1,1600,1167,255,177,1,9364,1
24,"Iasi",95060,225,95060,,"MUNICIPIUL IASI",250,"CENTRUL SCOLAR NR.2 ION HOLBAN, STRADA  P. HALIPA NR.16",0,1072,0,1072,0,1058,14,1600,528,557,501,1,9364,1
24,"Iasi",95060,225,95060,,"MUNICIPIUL IASI",251,"AEROPORTUL IASI, STRADA AEROPORTULUI NR.1",0,416,0,416,0,409,7,498,82,224,185,1,9364,1
24,"Iasi",95060,225,95060,,"MUNICIPIUL IASI",252,"GARA IASI",0,1784,0,1784,0,1767,17,3200,1416,1081,686,1,9364,1
24,"Iasi",95391,225,95391,,"MUNICIPIUL PASCANI",253,"Casa Municipala de Cultura Mihail Sadoveanu, Str. Stefan cel Mare nr. 7",1398,737,724,12,1,719,18,1500,763,280,439,1,9366,0
24,"Iasi",95391,225,95391,,"MUNICIPIUL PASCANI",254,"Casa Municipala de Cultura Mihail Sadoveanu, Str. Stefan cel Mare nr. 7",1350,725,712,13,0,714,11,1600,875,251,463,1,9366,0
24,"Iasi",95391,225,95391,,"MUNICIPIUL PASCANI",255,"Scoala Ion Creanga, str.  Dragos Voda nr. 59",1379,764,743,21,0,752,12,1500,736,308,444,1,9366,0
24,"Iasi",95391,225,95391,,"MUNICIPIUL PASCANI",256,"Gradinita nr. 1,Str. Aleea Tineretului",1298,626,617,9,0,621,5,1400,774,193,428,1,9366,0
24,"Iasi",95391,225,95391,,"MUNICIPIUL PASCANI",257,"Scoala nr. 3 Iordache Cantacuzino, Sala de sport, Str. Stefan cel Mare nr. 33",1536,856,842,14,0,848,8,1600,744,321,527,1,9366,0
24,"Iasi",95391,225,95391,,"MUNICIPIUL PASCANI",258,"Scoala nr. 3 Iordache Cantacuzino, Sala de sport, Str. Stefan cel Mare nr. 33",1173,581,567,14,0,574,7,1300,719,244,330,1,9366,0
24,"Iasi",95391,225,95391,,"MUNICIPIUL PASCANI",259,"Gradinita Vatra, str. Stefan cel Mare  nr. 154",1353,678,667,11,0,651,27,1500,822,257,394,1,9366,0
24,"Iasi",95391,225,95391,,"MUNICIPIUL PASCANI",260,"Colegiul National Mihail Sadoveanu,  corpul A, Str. Sportului nr.11",1506,716,707,8,1,705,11,1600,884,244,461,1,9366,0
24,"Iasi",95391,225,95391,,"MUNICIPIUL PASCANI",261,"Colegiul National Mihail Sadoveanu,  corpul A, Str. Sportului nr.11",1609,780,772,8,0,768,12,1700,920,303,465,1,9366,0
24,"Iasi",95391,225,95391,,"MUNICIPIUL PASCANI",262,"Gradinita Siretul, str. Sportului nr. 11",1575,684,671,13,0,673,11,1700,1016,254,419,1,9366,0
24,"Iasi",95391,225,95391,,"MUNICIPIUL PASCANI",263,"Scoala  de arte si meserii Nicolae Iorga, str. Eugen Stamate nr. 8",1698,783,768,15,0,772,11,1800,1017,308,464,1,9366,0
24,"Iasi",95391,225,95391,,"MUNICIPIUL PASCANI",264,"Scoala speciala, str. Garii nr. 97",1787,843,827,16,0,835,8,1900,1057,284,551,1,9366,0
24,"Iasi",95391,225,95391,,"MUNICIPIUL PASCANI",265,"Colegiul Tehnic de Cai Ferate Unirea,corpul A, Str Ceferistilor nr. 3",1385,619,609,10,0,613,6,1507,888,231,382,1,9366,0
24,"Iasi",95391,225,95391,,"MUNICIPIUL PASCANI",266,"Colegiul Tehnic de Cai Ferate Unirea,corpul A, Str Ceferistilor nr. 3",1275,587,572,15,0,577,10,1400,813,220,357,1,9366,0
24,"Iasi",95391,225,95391,,"MUNICIPIUL PASCANI",267,"Gradinita cu program prelungit nr. 3, str. Izvoarelor",1181,550,537,13,0,546,4,1300,750,171,375,1,9366,0
24,"Iasi",95391,225,95391,,"MUNICIPIUL PASCANI",268,"Gradinita cu program prelungit nr. 3, str. Izvoarelor",1436,661,649,12,0,645,16,1600,939,245,400,1,9366,0
24,"Iasi",95391,225,95391,,"MUNICIPIUL PASCANI",269,"Liceul Miron Costin,  corp A, str. Izvoarelor nr. 11",1562,639,627,12,0,632,7,1700,1061,255,377,1,9366,0
24,"Iasi",95391,225,95391,,"MUNICIPIUL PASCANI",270,"Liceul Miron Costin,  corp A, str. Izvoarelor nr. 11",1445,677,665,12,0,670,7,1600,923,188,482,1,9366,0
24,"Iasi",95391,225,95391,,"MUNICIPIUL PASCANI",271,"Grup Scolar 'Mihai Busuioc, al. 22 Decembrie nr. 2",1238,711,701,10,0,702,9,1600,889,233,469,1,9366,0
24,"Iasi",95391,225,95391,,"MUNICIPIUL PASCANI",272,"Grup Scolar Mihai Busuioc, al. 22 Decembrie nr. 2",1436,666,650,16,0,657,9,1600,934,232,425,1,9366,0
24,"Iasi",95391,225,95391,,"MUNICIPIUL PASCANI",273,"Scoala Blagesti(localitate componenta Blagesti) , str. Avram Iancu nr. 36",1221,655,649,6,0,642,13,1300,645,264,378,1,9366,0
24,"Iasi",95391,225,95391,,"MUNICIPIUL PASCANI",274,"Scoala Gistesti (localitate componenta Gistesti) , Str.Gistesti nr. 23",1006,496,492,4,0,486,10,1100,604,157,329,1,9366,0
24,"Iasi",95391,225,95391,,"MUNICIPIUL PASCANI",275,"Scoala Gistesti (localitate componenta Gistesti) , Str.Gistesti nr. 23",1469,723,717,6,0,718,5,1600,877,216,502,1,9366,0
24,"Iasi",95391,225,95391,,"MUNICIPIUL PASCANI",276,"Scoala Lunca (localitate componenta Lunca), Str. Mihai Viteazu nr. 172",1054,602,586,16,0,599,3,1200,598,147,452,1,9366,0
24,"Iasi",95391,225,95391,,"MUNICIPIUL PASCANI",277,"Scoala Lunca (localitate componenta Lunca), Str. Mihai Viteazu nr. 172",1059,595,589,6,0,592,3,1200,605,164,428,1,9366,0
24,"Iasi",95391,225,95391,,"MUNICIPIUL PASCANI",278,"Scoala Sodomeni (localitate componenta Sodomeni), Str. 13 Decembrie",988,556,545,11,0,551,5,1108,552,156,395,1,9366,0
24,"Iasi",95391,225,95391,,"MUNICIPIUL PASCANI",279,"Scoala Bosteni (localitate componenta Bosteni), Str. Ion Creanga",1136,615,604,11,0,602,13,1200,585,190,412,1,9366,0
24,"Iasi",95391,225,95391,,"MUNICIPIUL PASCANI",280,"Gara CF Pascani, Str. Garii, nr. 18, Cod 705200",0,461,0,461,0,458,3,1600,1139,228,230,1,9366,1
24,"Iasi",95355,225,95355,,"ORAS HARLAU",281,"Grupul Scolar de Arte si Meserii, str. Mihai Eminescu nr.14",1386,573,559,14,0,567,6,1500,927,140,427,1,9373,0
24,"Iasi",95355,225,95355,,"ORAS HARLAU",282,"Liceul Teoretic Stefan cel Mare, str. Mihai Eminescu nr. 3",1336,620,601,18,1,615,5,1500,880,203,412,1,9373,0
24,"Iasi",95355,225,95355,,"ORAS HARLAU",283,"Scoala Generala Petru Rares (corp vechi), str. Stefan cel Mare nr. 34",1423,685,673,11,1,680,5,1500,815,215,465,1,9373,0
24,"Iasi",95355,225,95355,,"ORAS HARLAU",284,"Gradinita nr. 2, str. Stefan cel Mare nr.17",1335,653,644,9,0,647,6,1500,847,196,451,1,9373,0
24,"Iasi",95355,225,95355,,"ORAS HARLAU",285,"Scoala Generala Petru Rares (corp nou), str. Stefan cel Mare nr 23",1322,660,641,19,0,652,8,1400,740,220,432,1,9373,0
24,"Iasi",95355,225,95355,,"ORAS HARLAU",286,"Gradinita Pircovaci, sat Pircovaci",1437,842,832,10,0,828,14,1600,758,155,673,1,9373,0
24,"Iasi",95355,225,95355,,"ORAS HARLAU",287,"Scoala Generala Pircovaci, sat Pircovaci",1211,674,663,11,0,663,11,1300,626,132,531,1,9373,0
24,"Iasi",95355,225,95355,,"ORAS HARLAU",288,"Casa de Cultura Harlau",0,154,0,154,0,154,0,800,646,77,77,1,9373,1
24,"Iasi",98373,225,98373,,"ORAS PODU ILOAIEI",289,"Scoala AL.I.CUZA, strada Nationala nr. 102",1351,484,460,24,0,479,5,1500,1016,229,250,1,9376,0
24,"Iasi",98373,225,98373,,"ORAS PODU ILOAIEI",290,"Scoala AL.I.CUZA, strada Nationala nr. 102",979,439,412,26,1,434,5,1100,661,231,203,1,9376,0
24,"Iasi",98373,225,98373,,"ORAS PODU ILOAIEI",291,"Scoala AL.I.CUZA, strada Nationala nr. 102",760,333,303,30,0,327,6,800,467,121,206,1,9376,0
24,"Iasi",98373,225,98373,,"ORAS PODU ILOAIEI",292,"Scoala AL.I.CUZA, strada Nationala nr. 102",783,342,322,20,0,339,3,900,558,167,172,1,9376,0
24,"Iasi",98373,225,98373,,"ORAS PODU ILOAIEI",293,"Scoala AL.I.CUZA, strada Nationala nr. 102",821,326,302,24,0,322,4,900,574,138,184,1,9376,0
24,"Iasi",98373,225,98373,,"ORAS PODU ILOAIEI",294,"Scoala AL.I.CUZA, strada Nationala nr. 102",825,370,325,45,0,364,6,900,530,179,185,1,9376,0
24,"Iasi",98373,225,98373,,"ORAS PODU ILOAIEI",295,"Scoala primara Henci, strada Henci",368,173,157,16,0,172,1,400,227,101,71,1,9376,0
24,"Iasi",98373,225,98373,,"ORAS PODU ILOAIEI",296,"Scoala primara Holm, strada Holm",197,107,96,11,0,106,1,300,193,61,45,1,9376,0
24,"Iasi",98373,225,98373,,"ORAS PODU ILOAIEI",297,"Scoala primara Scobilteni, strada Scobilteni",845,365,349,16,0,358,7,900,535,140,218,1,9376,0
24,"Iasi",98373,225,98373,,"ORAS PODU ILOAIEI",298,"Scoala primara Budai, cartier Budai",645,306,295,11,0,304,2,700,394,139,165,1,9376,0
24,"Iasi",98373,225,98373,,"ORAS PODU ILOAIEI",299,"Scoala primara Cositeni, strada Cositeni",248,128,116,12,0,128,0,300,172,60,68,1,9376,0
24,"Iasi",98373,225,98373,,"ORAS PODU ILOAIEI",300,"Scoala Generala Al.I. Cuza, strada Nationala nr. 102",0,122,0,122,0,120,2,800,678,62,58,1,9376,1
24,"Iasi",95471,225,95471,,"ORAS TARGU FRUMOS",301,"Scoala Generala Ion Creanga, str. Bogdan Voda nr. 5, Sala 1",1678,743,734,9,0,740,3,1800,1057,256,484,1,9382,0
24,"Iasi",95471,225,95471,,"ORAS TARGU FRUMOS",302,"Scoala Generala Ion Creanga, str. Bogdan Voda nr. 5, Sala 2",863,351,340,11,0,337,14,900,549,117,220,1,9382,0
24,"Iasi",95471,225,95471,,"ORAS TARGU FRUMOS",303,"Scoala Generala Garabet Ibraileanu, str. Petru Rares nr. 6D, Sala 1",1443,557,546,11,0,549,8,1500,943,187,362,1,9382,0
24,"Iasi",95471,225,95471,,"ORAS TARGU FRUMOS",304,"Scoala Generala Garabet Ibraileanu, str. Petru Rares nr. 6D, Sala 2",1315,535,530,5,0,529,6,1400,865,179,350,1,9382,0
24,"Iasi",95471,225,95471,,"ORAS TARGU FRUMOS",305,"Centrul de Plasament Sfintul Spiridon, str. Petru Rares nr. 37",1329,654,636,18,0,638,16,1400,746,257,381,1,9382,0
24,"Iasi",95471,225,95471,,"ORAS TARGU FRUMOS",306,"Casa de Cultura Garabet Ibraileanu, str. Cuza Voda nr. 44, Sala 1",1619,675,655,20,0,657,18,1700,1025,277,380,1,9382,0
24,"Iasi",95471,225,95471,,"ORAS TARGU FRUMOS",307,"Casa de Cultura Garabet Ibraileanu, str. Cuza Voda nr. 44, Sala 2",1626,700,683,17,0,689,11,1700,1000,277,412,1,9382,0
24,"Iasi",95471,225,95471,,"ORAS TARGU FRUMOS",308,"Liceul Teoretic Ion Neculce - str. Cuza Voda nr. 65",1419,631,613,18,0,625,6,1500,869,260,365,1,9382,0
24,"Iasi",95471,225,95471,,"ORAS TARGU FRUMOS",309,"Statia CFR Tg, Frumos  Str. 20 Decembrie 1989, nr. 1",0,239,0,239,0,237,2,800,561,112,125,1,9382,1
24,"Iasi",95612,225,95612,,"ALEXANDRU I. CUZA",310,"Scoala generala clasele I - IV Al.I.Cuza",601,324,316,8,0,320,4,692,368,80,240,3,9384,0
24,"Iasi",95612,225,95612,,"ALEXANDRU I. CUZA",311,"Scoala generala clasele I - VIII Scheia",1041,390,385,5,0,384,6,1100,710,132,252,3,9384,0
24,"Iasi",95612,225,95612,,"ALEXANDRU I. CUZA",312,"Scoala primara clasele I - IV Volintiresti",639,352,338,14,0,347,5,700,348,79,268,3,9384,0
24,"Iasi",95612,225,95612,,"ALEXANDRU I. CUZA",313,"Scoala generala Clasele I-IV Al.I. Cuza",0,64,0,64,0,63,1,200,136,24,39,3,9384,1
24,"Iasi",95667,225,95667,,"ANDRIESENI",314,"Scoala  Gh. Ciobanu Andrieseni",1344,737,725,10,2,718,19,1400,663,289,429,3,9389,0
24,"Iasi",95667,225,95667,,"ANDRIESENI",315,"Scoala Buhaeni",549,282,274,8,0,275,7,600,318,95,180,3,9389,0
24,"Iasi",95667,225,95667,,"ANDRIESENI",316,"Scoala Spineni",786,420,401,19,0,407,13,900,480,121,286,3,9389,0
24,"Iasi",95667,225,95667,,"ANDRIESENI",317,"Scoala Glavanesti",591,343,335,8,0,338,5,700,357,38,300,3,9389,0
24,"Iasi",95667,225,95667,,"ANDRIESENI",318,"Scoala Generala cu clasele I-VIII Ghiorghe Ciobanu  Andrieseni",0,137,0,137,0,134,3,200,63,41,93,3,9389,1
24,"Iasi",95747,225,95747,,"ARONEANU",319,"Scoala generala Aroneanu",960,555,549,6,0,546,9,1100,545,303,243,3,9397,0
24,"Iasi",95747,225,95747,,"ARONEANU",320,"Scoala generala Dorobant",912,525,513,12,0,516,9,984,459,328,188,3,9397,0
24,"Iasi",95747,225,95747,,"ARONEANU",321,"Scoala generala Rediu Aldei",293,182,176,6,0,177,5,404,222,89,88,3,9397,0
24,"Iasi",95747,225,95747,,"ARONEANU",322,"Scoala Generala Sorogari",164,114,107,7,0,113,1,203,89,80,33,3,9397,0
24,"Iasi",95747,225,95747,,"ARONEANU",323,"Scoala Generala Aroneanu",0,221,0,221,0,221,0,397,176,151,70,3,9397,1
24,"Iasi",100273,225,100273,,"BALS",324,"Scoala generala Bals",1111,637,622,3,12,631,6,1194,557,265,366,3,9402,0
24,"Iasi",100273,225,100273,,"BALS",325,"Scoala generala Boureni",1268,749,723,6,20,735,14,1400,651,366,369,3,9402,0
24,"Iasi",100273,225,100273,,"BALS",326,"Scoala primara Coasta Magurii",184,114,104,7,3,111,3,300,186,86,25,3,9402,0
24,"Iasi",100273,225,100273,,"BALS",327,"Scoala Generala Boureni",0,62,0,62,0,58,4,200,138,26,32,3,9402,1
24,"Iasi",95792,225,95792,,"BALTATI",328,"Scoala generala Baltati",1389,717,708,9,0,713,4,1500,783,332,381,3,9406,0
24,"Iasi",95792,225,95792,,"BALTATI",329,"Scoala generala Madirjesti",787,385,371,5,9,384,1,900,515,147,237,3,9406,0
24,"Iasi",95792,225,95792,,"BALTATI",330,"Scoala primara Podisu",420,239,233,6,0,237,2,496,257,90,147,3,9406,0
24,"Iasi",95792,225,95792,,"BALTATI",331,"Scoala generala Sirca",794,471,468,3,0,466,5,906,435,197,269,3,9406,0
24,"Iasi",95792,225,95792,,"BALTATI",332,"Scoala generala Valea Oilor",531,284,278,6,0,276,8,600,316,118,158,3,9406,0
24,"Iasi",95792,225,95792,,"BALTATI",333,"Scoala Generala Baltati",0,73,0,73,0,73,0,200,127,36,37,3,9406,1
24,"Iasi",95872,225,95872,,"BELCESTI",334,"Grup Scolar V.M. Craiu, prima sala pe stanga",973,470,428,42,0,467,3,1091,621,232,235,3,9421,0
24,"Iasi",95872,225,95872,,"BELCESTI",335,"Grup Scolar V.M. Craiu, a doua sala pe stanga",1339,667,579,88,0,664,3,1400,733,286,378,3,9421,0
24,"Iasi",95872,225,95872,,"BELCESTI",336,"Scoala generala Rusi, a doua sala pe stanga",1363,618,582,36,0,609,9,1500,882,203,406,3,9421,0
24,"Iasi",95872,225,95872,,"BELCESTI",337,"Scoala generala Satu Nou",1397,642,632,10,0,625,17,1500,858,252,373,3,9421,0
24,"Iasi",95872,225,95872,,"BELCESTI",338,"Scoala generala Munteni",911,431,423,8,0,422,9,1011,580,109,313,3,9421,0
24,"Iasi",95872,225,95872,,"BELCESTI",339,"Magazinul Consumcoop Tansa",812,401,386,15,0,393,8,900,499,153,240,3,9421,0
24,"Iasi",95872,225,95872,,"BELCESTI",340,"Scoala generala Liteni",1036,498,489,9,0,488,10,1100,602,189,299,3,9421,0
24,"Iasi",95872,225,95872,,"BELCESTI",341,"Magazinul Consumcoop Ulmi",529,296,288,8,0,287,9,589,293,87,200,3,9421,0
24,"Iasi",95872,225,95872,,"BELCESTI",342,"Grup Scolar Victor Mihailescu Craiu, Cladirea Spiru Haret Belcesti",0,144,0,144,0,144,0,200,56,77,67,3,9421,1
24,"Iasi",95943,225,95943,,"BIVOLARI",343,"Scoala de arte si meserii Bivolari",957,448,441,7,0,439,9,1100,652,221,218,3,9428,0
24,"Iasi",95943,225,95943,,"BIVOLARI",344,"Scoala de arte si meserii Bivolari",957,452,449,3,0,441,11,1100,648,230,211,3,9428,0
24,"Iasi",95943,225,95943,,"BIVOLARI",345,"Scoala generala A. Barbu Tabara",983,437,431,6,0,428,9,1100,663,126,302,3,9428,0
24,"Iasi",95943,225,95943,,"BIVOLARI",346,"Scoala primara Solonet",554,276,265,11,0,271,5,600,324,79,192,3,9428,0
24,"Iasi",95943,225,95943,,"BIVOLARI",347,"Scoala de Arte si Meserii Bivolari",0,85,0,85,0,85,0,201,116,37,48,3,9428,1
24,"Iasi",95088,225,95088,,"BARNOVA",348,"Caminul Cultural Birnova",848,412,407,4,1,407,5,900,488,149,258,3,9414,0
24,"Iasi",95088,225,95088,,"BARNOVA",349,"Scoala primara Pietrarie",516,268,253,15,0,266,2,600,332,131,135,3,9414,0
24,"Iasi",95088,225,95088,,"BARNOVA",350,"Scoala primara Cercul",404,183,173,10,0,181,2,489,306,84,97,3,9414,0
24,"Iasi",95088,225,95088,,"BARNOVA",351,"Scoala primara Todirel",421,206,191,14,1,202,4,500,294,90,112,3,9414,0
24,"Iasi",95088,225,95088,,"BARNOVA",352,"Scoala primara Visan",532,262,247,15,0,262,0,600,338,147,115,3,9414,0
24,"Iasi",95088,225,95088,,"BARNOVA",353,"Gradinita de copii Paun",849,482,469,13,0,472,10,913,431,228,244,3,9414,0
24,"Iasi",95088,225,95088,,"BARNOVA",354,"Caminul Cultural Barnova",0,213,0,213,0,210,3,500,287,69,141,3,9414,1
24,"Iasi",96058,225,96058,,"BRAESTI",355,"Scoala Braesti",937,461,440,3,18,446,15,1100,639,234,212,3,9434,0
24,"Iasi",96058,225,96058,,"BRAESTI",356,"Scoala generala Cristesti",1023,461,435,13,13,443,18,1000,539,273,170,3,9434,0
24,"Iasi",96058,225,96058,,"BRAESTI",357,"Scoala primara Albesti",523,287,273,14,0,284,3,600,313,117,167,3,9434,0
24,"Iasi",96058,225,96058,,"BRAESTI",358,"Scoala de Arte si Meserii Braesti",0,63,0,63,0,63,0,200,137,31,32,3,9434,1
24,"Iasi",96110,225,96110,,"BUTEA",359,"Camin cultural nr. 1 Butea",1615,565,562,3,0,558,7,1700,1135,299,259,3,9440,0
24,"Iasi",96110,225,96110,,"BUTEA",360,"Gradinita cu program normal Butea",1496,544,541,3,0,535,9,1600,1056,265,270,3,9440,0
24,"Iasi",96110,225,96110,,"BUTEA",361,"Scoala generala Miclauseni",324,174,168,6,0,169,5,381,207,106,63,3,9440,0
24,"Iasi",96110,225,96110,,"BUTEA",362,"Caminul Cultural nr. 1 Butea",0,81,0,81,0,78,3,200,119,45,33,3,9440,1
24,"Iasi",96147,225,96147,,"CEPLENITA",363,"Scoala generala Grigore Ureche Ceplenita",1180,585,568,17,0,575,10,1300,715,172,403,3,9443,0
24,"Iasi",96147,225,96147,,"CEPLENITA",364,"Scoala generala Buhalnita",1293,560,546,14,0,544,16,1400,840,168,376,3,9443,0
24,"Iasi",96147,225,96147,,"CEPLENITA",365,"Scoala generala Poiana Marului",752,338,326,12,0,329,9,787,449,108,221,3,9443,0
24,"Iasi",96147,225,96147,,"CEPLENITA",366,"Scoala generala Zlodica",235,107,98,9,0,105,2,303,196,40,65,3,9443,0
24,"Iasi",96147,225,96147,,"CEPLENITA",367,"Scoala generala Grigore Ureche Ceplenita",0,53,0,53,0,52,1,198,145,15,37,3,9443,1
24,"Iasi",100362,225,100362,,"CIOHORANI",368,"Camin cultural Ciohorani",1476,732,731,1,0,715,17,1600,868,155,560,3,9448,0
24,"Iasi",100362,225,100362,,"CIOHORANI",369,"Caminul Cultural Ciohorani",0,74,0,74,0,73,1,200,126,26,47,3,9448,1
24,"Iasi",96192,225,96192,,"CIORTESTI",370,"Camin cultural Ciortesti",1036,549,539,10,0,537,12,1100,551,154,383,3,9450,0
24,"Iasi",96192,225,96192,,"CIORTESTI",371,"Scoala generala Coropceni",898,527,511,16,0,521,6,1000,473,194,327,3,9450,0
24,"Iasi",96192,225,96192,,"CIORTESTI",372,"Scoala generala Serbesti",681,386,379,7,0,372,14,800,414,115,257,3,9450,0
24,"Iasi",96192,225,96192,,"CIORTESTI",373,"Scoala primara Rotaria",308,167,159,8,0,162,5,400,233,39,123,3,9450,0
24,"Iasi",96192,225,96192,,"CIORTESTI",374,"Scoala primara Deleni",428,236,226,10,0,233,3,500,264,91,142,3,9450,0
24,"Iasi",96192,225,96192,,"CIORTESTI",375,"Caminul Cultural Ciortesti",0,87,0,87,0,87,0,200,113,40,47,3,9450,1
24,"Iasi",96254,225,96254,,"CIUREA",376,"Scoala Ciurea",914,362,349,13,0,362,0,1000,638,175,187,3,9456,0
24,"Iasi",96254,225,96254,,"CIUREA",377,"Scoala Ciurea",915,410,401,9,0,408,2,1000,590,205,203,3,9456,0
24,"Iasi",96254,225,96254,,"CIUREA",378,"Scoala Curaturi",206,92,84,8,0,92,0,299,207,39,53,3,9456,0
24,"Iasi",96254,225,96254,,"CIUREA",379,"Scoala Dumbrava",992,483,470,13,0,478,5,1100,617,292,186,3,9456,0
24,"Iasi",96254,225,96254,,"CIUREA",380,"Scoala Hlincea",148,86,76,10,0,84,2,198,112,48,36,3,9456,0
24,"Iasi",96254,225,96254,,"CIUREA",381,"Scoala Lunca Cetatuii",1079,515,507,8,0,512,3,1190,675,257,255,3,9456,0
24,"Iasi",96254,225,96254,,"CIUREA",382,"Scoala Lunca Cetatuii",1197,605,595,10,0,601,4,1300,695,285,316,3,9456,0
24,"Iasi",96254,225,96254,,"CIUREA",383,"Scoala Zanea",403,269,248,21,0,260,9,500,231,83,177,3,9456,0
24,"Iasi",96254,225,96254,,"CIUREA",384,"Scoala Lunca Cetatuii",967,481,462,19,0,476,5,1100,619,253,223,3,9456,0
24,"Iasi",96254,225,96254,,"CIUREA",385,"Scoala Lunca Cetatuii",960,462,450,12,0,454,8,1081,619,255,199,3,9456,0
24,"Iasi",96254,225,96254,,"CIUREA",386,"Scoala Piciorul Lupului",467,221,210,11,0,220,1,500,279,76,144,3,9456,0
24,"Iasi",96254,225,96254,,"CIUREA",387,"Scoala Slobozia",373,218,211,7,0,217,1,391,173,77,140,3,9456,0
24,"Iasi",96254,225,96254,,"CIUREA",388,"Scoala Generala Ciurea",0,117,0,117,0,115,2,200,83,59,56,3,9456,1
24,"Iasi",96334,225,96334,,"COARNELE CAPREI",389,"Scoala generala nr. 1 - Coarnele Caprei",994,508,490,5,13,498,10,1100,592,114,384,3,9464,0
24,"Iasi",96334,225,96334,,"COARNELE CAPREI",390,"Scoala generala nr. 1 - Coarnele Caprei",884,448,439,0,9,438,10,1000,552,93,345,3,9464,0
24,"Iasi",96334,225,96334,,"COARNELE CAPREI",391,"Scoala generala Arama",340,178,167,11,0,172,6,400,222,41,131,3,9464,0
24,"Iasi",96334,225,96334,,"COARNELE CAPREI",392,"Scoala generala Petrosica",76,58,49,9,0,56,2,97,39,17,39,3,9464,0
24,"Iasi",96334,225,96334,,"COARNELE CAPREI",393,"Scoala Generala nr. 1 Coarnele Caprei",0,34,0,34,0,34,0,200,166,14,20,3,9464,1
24,"Iasi",96370,225,96370,,"COMARNA",394,"Scoala Osoi",1511,753,727,9,17,742,11,1600,847,349,393,3,9468,0
24,"Iasi",96370,225,96370,,"COMARNA",395,"Scoala Stanca",164,91,82,9,0,90,1,198,107,53,37,3,9468,0
24,"Iasi",96370,225,96370,,"COMARNA",396,"Scoala generala Comarna",1054,541,513,12,16,534,7,1200,659,199,335,3,9468,0
24,"Iasi",96370,225,96370,,"COMARNA",397,"Scoala primara Comarna",802,486,451,23,12,473,13,900,414,127,346,3,9468,0
24,"Iasi",96370,225,96370,,"COMARNA",398,"Scoala Curagau",110,90,73,17,0,89,1,200,110,17,72,3,9468,0
24,"Iasi",96370,225,96370,,"COMARNA",399,"Scoala Generala Osoi",0,156,0,156,0,156,0,200,44,75,81,3,9468,1
24,"Iasi",100282,225,100282,,"COSTESTI",400,"Scoala generala Costesti, corp B",674,381,358,23,0,371,10,700,319,113,258,3,9473,0
24,"Iasi",100282,225,100282,,"COSTESTI",401,"Scoala primara Pietrisu de Jos",393,225,202,23,0,220,5,500,275,63,157,3,9473,0
24,"Iasi",100282,225,100282,,"COSTESTI",402,"Scoala generala Giurgesti",397,206,194,12,0,199,7,500,294,62,137,3,9473,0
24,"Iasi",100282,225,100282,,"COSTESTI",403,"Scoala Generala nr. 2 Costesti, corp B",0,53,0,53,0,52,1,200,147,18,34,3,9473,1
24,"Iasi",96423,225,96423,,"COSTULENI",404,"Scoala generala Costuleni",1205,653,643,10,0,641,12,1300,647,162,479,3,9476,0
24,"Iasi",96423,225,96423,,"COSTULENI",405,"Scoala generala Covasna",1069,594,582,12,0,572,22,1193,599,171,401,3,9476,0
24,"Iasi",96423,225,96423,,"COSTULENI",406,"Scoala generala Cozia",921,449,443,6,0,439,10,1010,561,173,266,3,9476,0
24,"Iasi",96423,225,96423,,"COSTULENI",407,"Scoala generala Hilita",653,337,332,5,0,322,15,700,363,153,169,3,9476,0
24,"Iasi",96423,225,96423,,"COSTULENI",408,"Scoala generala Costuleni",0,89,0,89,0,89,0,200,111,38,51,3,9476,1
24,"Iasi",96478,225,96478,,"COTNARI",409,"Camin cultural Cotnari",1421,717,708,9,0,709,8,1500,783,290,419,3,9481,0
24,"Iasi",96478,225,96478,,"COTNARI",410,"Scoala Bahlui",283,147,140,7,0,144,3,400,253,56,88,3,9481,0
24,"Iasi",96478,225,96478,,"COTNARI",411,"Scoala Hodora",1213,693,678,15,0,676,17,1300,607,273,403,3,9481,0
24,"Iasi",96478,225,96478,,"COTNARI",412,"Scoala Horodistea",514,221,213,8,0,214,7,600,379,69,145,3,9481,0
24,"Iasi",96478,225,96478,,"COTNARI",413,"Scoala Cirjoaia",1395,636,625,11,0,630,6,1500,864,273,357,3,9481,0
24,"Iasi",96478,225,96478,,"COTNARI",414,"Scoala Valea Racului",270,145,137,8,0,139,6,300,155,46,93,3,9481,0
24,"Iasi",96478,225,96478,,"COTNARI",415,"Scoala Zbereni",615,335,324,11,0,328,7,700,365,166,162,3,9481,0
24,"Iasi",96478,225,96478,,"COTNARI",416,"Scoala Luparia",282,160,151,9,0,159,1,400,240,17,142,3,9481,0
24,"Iasi",96478,225,96478,,"COTNARI",417,"Caminul Cultural Cotnari",0,73,0,73,0,73,0,200,127,39,34,3,9481,1
24,"Iasi",96593,225,96593,,"COZMESTI",418,"Scoala de Arte si Meserii Cozmesti",1243,596,588,8,0,588,8,1257,661,257,331,3,9493,0
24,"Iasi",96593,225,96593,,"COZMESTI",419,"Scoala noua Podolenii de Sus",782,388,380,8,0,385,3,895,507,231,154,3,9493,0
24,"Iasi",96593,225,96593,,"COZMESTI",420,"Scoala Podolenii de Jos",249,169,161,8,0,166,3,300,131,103,63,3,9493,0
24,"Iasi",96593,225,96593,,"COZMESTI",421,"Caminul Cultural Cozmesti",0,73,0,73,0,72,1,200,127,31,41,3,9493,1
24,"Iasi",96637,225,96637,,"CRISTESTI",422,"Scoala generala Cristesti",1251,630,616,14,0,628,2,1400,770,134,494,3,9497,0
24,"Iasi",96637,225,96637,,"CRISTESTI",423,"Scoala generala Cristesti",1044,529,519,10,0,524,5,1100,571,92,432,3,9497,0
24,"Iasi",96637,225,96637,,"CRISTESTI",424,"Scoala generala Heresti",627,358,349,9,0,356,2,700,342,80,276,3,9497,0
24,"Iasi",96637,225,96637,,"CRISTESTI",425,"Scoala generala Homita",301,190,179,11,0,188,2,403,213,43,145,3,9497,0
24,"Iasi",96637,225,96637,,"CRISTESTI",426,"Scoala Generala nr. 1 Cristesti",0,60,0,60,0,60,0,200,140,15,45,3,9497,1
24,"Iasi",96664,225,96664,,"CUCUTENI",427,"Gradinita, sat Cucuteni",705,378,371,3,4,372,6,800,422,199,173,3,9500,0
24,"Iasi",96664,225,96664,,"CUCUTENI",428,"Scoala Sacaresti, sat Sacaresti",364,248,233,14,1,245,3,400,152,134,111,3,9500,0
24,"Iasi",96664,225,96664,,"CUCUTENI",429,"Scoala Generala Sacaresti",0,67,0,67,0,67,0,200,133,38,29,3,9500,1
24,"Iasi",96717,225,96717,,"DAGATA",430,"Scoala Generala Dagata, sat Dagata",1271,702,676,26,0,693,9,1400,698,320,373,3,9505,0
24,"Iasi",96717,225,96717,,"DAGATA",431,"Caminul Cultural Manastirea, sat Manastirea",890,461,442,19,0,458,3,1000,539,186,272,3,9505,0
24,"Iasi",96717,225,96717,,"DAGATA",432,"Scoala Balusesti, sat Balusesti",161,103,94,9,0,100,3,200,97,47,53,3,9505,0
24,"Iasi",96717,225,96717,,"DAGATA",433,"Scoala Zece Prajini, sat Zece Prajini",383,232,217,15,0,228,4,500,268,140,88,3,9505,0
24,"Iasi",96717,225,96717,,"DAGATA",434,"Scoala Piscu Rusului, sat Piscu Rusului",310,172,161,11,0,172,0,397,225,89,83,3,9505,0
24,"Iasi",96717,225,96717,,"DAGATA",435,"Scoala Boatca, sat Boatca",192,128,120,8,0,127,1,300,172,71,56,3,9505,0
24,"Iasi",96717,225,96717,,"DAGATA",436,"Scoala Poienile, sat Poienile",168,121,108,13,0,120,1,200,79,101,19,3,9505,0
24,"Iasi",96717,225,96717,,"DAGATA",437,"Scoala Tarnita, sat Tarnita",97,58,50,8,0,58,0,200,142,22,36,3,9505,0
24,"Iasi",96717,225,96717,,"DAGATA",438,"Scoala Buzdug, sat Buzdug",58,47,35,12,0,47,0,100,53,24,23,3,9505,0
24,"Iasi",96717,225,96717,,"DAGATA",439,"Scoala de Arte si Meserii Dagata",0,80,0,80,0,78,2,200,120,41,37,3,9505,1
24,"Iasi",96815,225,96815,,"DELENI",440,"Scoala Noua-Deleni, sat Deleni",1639,678,647,31,0,667,11,1700,1022,268,399,3,9515,0
24,"Iasi",96815,225,96815,,"DELENI",441,"Gradinita, sat Deleni",1593,728,705,23,0,722,6,1700,972,284,438,3,9515,0
24,"Iasi",96815,225,96815,,"DELENI",442,"Scoala Maxut, sat Maxut",1029,490,473,17,0,485,5,1075,585,193,292,3,9515,0
24,"Iasi",96815,225,96815,,"DELENI",443,"Gradinita Maxut, sat Maxut",791,402,387,15,0,399,3,900,498,130,269,3,9515,0
24,"Iasi",96815,225,96815,,"DELENI",444,"Scoala Slobozia, sat Slobozia",1013,427,411,16,0,420,7,1100,673,144,276,3,9515,0
24,"Iasi",96815,225,96815,,"DELENI",445,"Scoala Feredeni, sat Feredeni",690,313,307,6,0,311,2,800,487,98,213,3,9515,0
24,"Iasi",96815,225,96815,,"DELENI",446,"Gradinita Poiana, sat Poiana",956,501,492,9,0,494,7,1100,599,118,376,3,9515,0
24,"Iasi",96815,225,96815,,"DELENI",447,"Scoala Generala Deleni- Deal",0,75,0,75,0,75,0,200,125,31,44,3,9515,1
24,"Iasi",96888,225,96888,,"DOBROVAT",448,"Scoala Generala nr.1 Moldoveni, sat Dobrovat",1200,656,637,18,1,641,15,1300,644,223,418,3,9522,0
24,"Iasi",96888,225,96888,,"DOBROVAT",449,"Scoala Generala nr. 2, Rusi, sat Dobrovat",825,476,462,14,0,463,13,900,424,157,306,3,9522,0
24,"Iasi",96888,225,96888,,"DOBROVAT",450,"Scoala Generala Moldoveni",0,113,0,113,0,113,0,200,87,63,50,3,9522,1
24,"Iasi",96904,225,96904,,"DOLHESTI",451,"Scoala de Arte si Meserii,sat Dolhesti",575,318,316,2,0,312,6,603,285,148,164,3,9524,0
24,"Iasi",96904,225,96904,,"DOLHESTI",452,"Scoala cu cls. I-VIII, sat Bradicesti",869,428,420,8,0,420,8,1000,572,138,282,3,9524,0
24,"Iasi",96904,225,96904,,"DOLHESTI",453,"Scoala cu cls. I-IV, sat Pietris",752,398,391,7,0,388,10,800,402,113,275,3,9524,0
24,"Iasi",96904,225,96904,,"DOLHESTI",454,"Scoala de Arte si Meserii Dolhesti",0,50,0,50,0,50,0,201,151,31,19,3,9524,1
24,"Iasi",100308,225,100308,,"DRAGUSENI",455,"Camin Cultural, sat Draguseni",705,403,390,8,5,393,10,805,402,106,287,3,9528,0
24,"Iasi",100308,225,100308,,"DRAGUSENI",456,"Scoala Generala, sat Frenciugi",429,243,239,4,0,242,1,500,257,108,134,3,9528,0
24,"Iasi",100308,225,100308,,"DRAGUSENI",457,"Caminul Cultural Draguseni",0,68,0,68,0,67,1,200,132,31,36,3,9528,1
24,"Iasi",96940,225,96940,,"DUMESTI",458,"Scoala de Arte si Meserii, sat Dumesti",1476,638,630,8,0,628,10,1600,962,264,364,3,9531,0
24,"Iasi",96940,225,96940,,"DUMESTI",459,"Scoala Generala, sat Pausesti",827,398,392,6,0,391,7,900,502,130,261,3,9531,0
24,"Iasi",96940,225,96940,,"DUMESTI",460,"Scoala Generala, sat Pausesti",508,233,224,9,0,230,3,595,362,89,141,3,9531,0
24,"Iasi",96940,225,96940,,"DUMESTI",461,"Scoala Generala, sat Hoisesti",613,290,281,9,0,286,4,700,410,144,142,3,9531,0
24,"Iasi",96940,225,96940,,"DUMESTI",462,"Scoala Generala, sat Banu",289,158,153,5,0,155,3,400,242,87,68,3,9531,0
24,"Iasi",96940,225,96940,,"DUMESTI",463,"Scoala Generala Dumesti",0,41,0,41,0,41,0,200,159,22,19,3,9531,1
24,"Iasi",97009,225,97009,,"ERBICENI",464,"Scoala cu cls. I-IV, sat Erbiceni",851,483,475,8,0,476,7,900,417,182,294,3,9537,0
24,"Iasi",97009,225,97009,,"ERBICENI",465,"Scoala cu cls. I-IV, sat Erbiceni",1055,565,551,14,0,552,13,1200,635,255,297,3,9537,0
24,"Iasi",97009,225,97009,,"ERBICENI",466,"Scoala cu cls. I-IV, sat Totoesti",1267,613,598,15,0,598,15,1400,787,343,255,3,9537,0
24,"Iasi",97009,225,97009,,"ERBICENI",467,"Scoala cu cls. I-VIII, sat Birlesti",561,302,284,18,0,301,1,600,298,119,182,3,9537,0
24,"Iasi",97009,225,97009,,"ERBICENI",468,"Scoala cu cls. I-IV, sat Sprinceana",315,170,159,11,0,170,0,400,230,99,71,3,9537,0
24,"Iasi",97009,225,97009,,"ERBICENI",469,"Scoala cu cls. I-IV, sat Spinoasa",246,150,143,7,0,149,1,300,150,74,75,3,9537,0
24,"Iasi",97009,225,97009,,"ERBICENI",470,"Scoala cu clasele I-IV Erbiceni",0,115,0,115,0,115,0,200,85,67,48,3,9537,1
24,"Iasi",100317,225,100317,,"FANTANELE",471,"Gradinita nr. 1, sat Fantanele",1501,841,830,11,0,835,6,1600,759,218,617,3,9543,0
24,"Iasi",100317,225,100317,,"FANTANELE",472,"Gradinita nr. 1 Fantanele",0,44,0,44,0,43,1,200,156,14,29,3,9543,1
24,"Iasi",97063,225,97063,,"FOCURI",473,"Camin Cultural, sat Focuri",1566,596,582,14,0,578,18,1700,1104,160,418,3,9545,0
24,"Iasi",97063,225,97063,,"FOCURI",474,"Gradinita nr. 2 Pascaneni, sat Focuri",1483,535,515,20,0,527,8,1600,1065,157,370,3,9545,0
24,"Iasi",97063,225,97063,,"FOCURI",475,"Caminul Cultural Focuri",0,59,0,59,0,57,2,200,141,23,34,3,9545,1
24,"Iasi",97090,225,97090,,"GOLAIESTI",476,"Scoala Generala Golaesti, sat Golaesti",1432,778,763,15,0,773,5,1500,722,499,274,3,9547,0
24,"Iasi",97090,225,97090,,"GOLAIESTI",477,"Scoala Generala Gradinari, sat Gradinari",711,401,395,6,0,396,5,800,399,184,212,3,9547,0
24,"Iasi",97090,225,97090,,"GOLAIESTI",478,"Scoala Generala Cotu lui Ivan, sat Cotu lui Ivan",310,190,181,9,0,184,6,400,210,86,98,3,9547,0
24,"Iasi",97090,225,97090,,"GOLAIESTI",479,"Scoala Generala Petresti, sat Petresti",259,175,167,8,0,169,6,300,125,55,114,3,9547,0
24,"Iasi",97090,225,97090,,"GOLAIESTI",480,"Scoala Generala Podu Jijiei, sat Podu Jijiei",192,137,128,9,0,135,2,300,163,83,52,3,9547,0
24,"Iasi",97090,225,97090,,"GOLAIESTI",481,"Scoala Generala Golaesti",0,147,0,147,0,146,1,200,53,98,48,3,9547,1
24,"Iasi",97189,225,97189,,"GORBAN",482,"Scoala cu cls. I-VIII, sat Gorban",601,322,293,21,8,313,9,694,372,157,156,3,9556,0
24,"Iasi",97189,225,97189,,"GORBAN",483,"Scoala cu cls. I-IV, sat Podul Hagiului",551,288,284,4,0,288,0,600,312,217,71,3,9556,0
24,"Iasi",97189,225,97189,,"GORBAN",484,"Scoala cu cls. I-IV, sat Scoposeni",494,266,255,7,4,265,1,600,334,111,154,3,9556,0
24,"Iasi",97189,225,97189,,"GORBAN",485,"Scoala cu cls. I-VIII, sat Gura-Bohotin",387,221,216,4,1,217,4,498,277,93,124,3,9556,0
24,"Iasi",97189,225,97189,,"GORBAN",486,"Scoala cu cls. I-IV, sat Zberoaia",267,152,146,6,0,150,2,304,152,90,60,3,9556,0
24,"Iasi",97189,225,97189,,"GORBAN",487,"Scoala Generala cu clasele I-VIII Gorban",0,93,0,93,0,93,0,200,107,67,26,3,9556,1
24,"Iasi",97241,225,97241,,"GRAJDURI",488,"Camin Cultural, sat Grajduri",879,451,425,15,11,443,8,1000,549,261,182,3,9562,0
24,"Iasi",97241,225,97241,,"GRAJDURI",489,"Scoala cu cls. I-IV, sat Valea Satului",591,301,287,14,0,292,9,700,399,70,222,3,9562,0
24,"Iasi",97241,225,97241,,"GRAJDURI",490,"Scoala Padureni, sat Padureni",383,172,157,14,1,171,1,497,325,85,86,3,9562,0
24,"Iasi",97241,225,97241,,"GRAJDURI",491,"Scoala Carbunari, sat Carbunari",278,147,136,7,4,145,2,302,155,59,86,3,9562,0
24,"Iasi",97241,225,97241,,"GRAJDURI",492,"Spitalul Barnova, sat Poiana cu Cetate",123,67,53,14,0,62,5,200,133,37,25,3,9562,0
24,"Iasi",97241,225,97241,,"GRAJDURI",493,"Spitalul Padureni, sat Padureni",41,26,16,10,0,26,0,100,74,12,14,3,9562,0
24,"Iasi",97241,225,97241,,"GRAJDURI",494,"Gara Grajduri",0,90,0,90,0,90,0,199,109,42,48,3,9562,1
24,"Iasi",97321,225,97321,,"GROPNITA",495,"Scoala Malaesti, sat Malaesti",374,197,189,8,0,190,7,400,203,91,99,3,9570,0
24,"Iasi",97321,225,97321,,"GROPNITA",496,"Scoala Forasti, sat Forasti",397,210,196,14,0,208,2,500,290,71,137,3,9570,0
24,"Iasi",97321,225,97321,,"GROPNITA",497,"Scoala Gropnita, sat Gropnita",383,172,168,4,0,171,1,503,331,54,117,3,9570,0
24,"Iasi",97321,225,97321,,"GROPNITA",498,"Sediul Primariei, sat Bulbucani",565,255,247,8,0,249,6,600,345,61,188,3,9570,0
24,"Iasi",97321,225,97321,,"GROPNITA",499,"Scoala Saveni, sat Saveni",582,271,265,6,0,271,0,700,429,60,211,3,9570,0
24,"Iasi",97321,225,97321,,"GROPNITA",500,"Scoala Singeri, sat Singeri",303,191,184,7,0,188,3,400,209,41,147,3,9570,0
24,"Iasi",97321,225,97321,,"GROPNITA",501,"Scoala cu clasele I-X Gropnita",0,74,0,74,0,74,0,200,126,28,46,3,9570,1
24,"Iasi",97394,225,97394,,"GROZESTI",502,"Scoala Generala cu cls. I-VIII sat Grozesti",962,518,512,6,0,514,4,1100,582,168,346,3,9577,0
24,"Iasi",97394,225,97394,,"GROZESTI",503,"Scoala Generala cls. I-IV, sat Coltu-Cornii",494,243,234,9,0,239,4,600,357,75,164,3,9577,0
24,"Iasi",97394,225,97394,,"GROZESTI",504,"Scoala generala Grozesti",0,37,0,37,0,37,0,199,162,17,20,3,9577,1
24,"Iasi",97438,225,97438,,"HALAUCESTI",505,"Scoala Generala, sat Halaucesti",1386,594,584,10,0,588,6,1500,906,265,323,3,9581,0
24,"Iasi",97438,225,97438,,"HALAUCESTI",506,"Liceul  Bogdan Voda , sat Halaucesti",1310,546,542,4,0,538,8,1400,854,274,264,3,9581,0
24,"Iasi",97438,225,97438,,"HALAUCESTI",507,"Camin Cultural, sat Halaucesti",1161,454,451,3,0,446,8,1300,846,239,207,3,9581,0
24,"Iasi",97438,225,97438,,"HALAUCESTI",508,"Scoala Generala,sat Luncasi",790,350,343,7,0,347,3,900,550,181,166,3,9581,0
24,"Iasi",97438,225,97438,,"HALAUCESTI",509,"Liceul Bogban Voda Halaucesti",0,84,0,84,0,83,1,200,116,53,30,3,9581,1
24,"Iasi",100326,225,100326,,"HARMANESTI",510,"Scoala Harmanestii- Vechi, sat Harmanestii- Vechi",1202,653,640,13,0,651,2,1313,660,202,449,3,9584,0
24,"Iasi",100326,225,100326,,"HARMANESTI",511,"Scoala Harmanestii Noi",568,302,292,10,0,298,4,600,298,126,172,3,9584,0
24,"Iasi",100326,225,100326,,"HARMANESTI",512,"Scoala Generala Harmanestii Vechi",0,87,0,87,0,87,0,198,111,45,42,3,9584,1
24,"Iasi",97465,225,97465,,"HELESTENI",513,"Scoala de Arte si Meserii, sat Helesteni",644,525,509,16,0,522,3,700,175,82,440,3,9588,0
24,"Iasi",97465,225,97465,,"HELESTENI",514,"Centrul de zi  Sf. Nicolae sat Harmaneasa",553,362,351,11,0,356,6,600,238,83,273,3,9588,0
24,"Iasi",97465,225,97465,,"HELESTENI",515,"Scoala Generala cu Cls. I-VIII, sat Oboroceni",673,416,398,10,8,412,4,700,284,78,334,3,9588,0
24,"Iasi",97465,225,97465,,"HELESTENI",516,"Scoala Generala, sat Movileni",161,129,115,13,1,128,1,200,71,44,84,3,9588,0
24,"Iasi",97465,225,97465,,"HELESTENI",517,"Scoala de Arte si Meserii Helesteni",0,66,0,66,0,65,1,200,134,18,47,3,9588,1
24,"Iasi",95159,225,95159,,"HOLBOCA",518,"scoala cu cl. I - VIII Holboca",1143,512,509,3,0,506,6,1200,688,272,234,3,9593,0
24,"Iasi",95159,225,95159,,"HOLBOCA",519,"scoala cu cl. I - VIII Holboca",1111,524,513,11,0,520,4,1200,676,260,260,3,9593,0
24,"Iasi",95159,225,95159,,"HOLBOCA",520,"Gradinita cu program normal Dancu",825,389,373,16,0,383,6,900,511,231,152,3,9593,0
24,"Iasi",95159,225,95159,,"HOLBOCA",521,"Gradinita cu program normal Dancu",901,418,406,12,0,414,4,1000,582,228,186,3,9593,0
24,"Iasi",95159,225,95159,,"HOLBOCA",522,"Scoala Stefan cel Mare , Dancu",1513,735,728,7,0,732,3,1600,865,382,350,3,9593,0
24,"Iasi",95159,225,95159,,"HOLBOCA",523,"Scoala Stefan cel Mare , Dancu",1562,736,724,12,0,725,11,1700,964,348,377,3,9593,0
24,"Iasi",95159,225,95159,,"HOLBOCA",524,"Scoala Stefan cel Mare , Dancu",1687,809,799,10,0,801,8,1800,991,480,321,3,9593,0
24,"Iasi",95159,225,95159,,"HOLBOCA",525,"scoala cu cl. I - VIII  Rusenii Vechi",448,234,227,7,0,230,4,500,266,151,79,3,9593,0
24,"Iasi",95159,225,95159,,"HOLBOCA",526,"scoala cu cl. I - IV  Rusenii Noi",295,142,133,9,0,142,0,400,258,60,82,3,9593,0
24,"Iasi",95159,225,95159,,"HOLBOCA",527,"scoala cu cl. I - IV Orzeni",562,286,275,11,0,279,7,600,314,144,135,3,9593,0
24,"Iasi",95159,225,95159,,"HOLBOCA",528,"scoala cu cl. I - IV  Cristesti",493,287,273,14,0,281,6,600,313,150,131,3,9593,0
24,"Iasi",95159,225,95159,,"HOLBOCA",529,"scoala Valea Lunga",217,116,104,11,1,113,3,300,184,55,58,3,9593,0
24,"Iasi",95159,225,95159,,"HOLBOCA",530,"Scoala cu clasele I-VIII Holboca",0,108,0,108,0,107,1,196,88,65,42,3,9593,1
24,"Iasi",97517,225,97517,,"HORLESTI",531,"Caminul Cultural, sala mare Horlesti",1264,643,637,6,0,630,13,1368,725,361,269,3,9601,0
24,"Iasi",97517,225,97517,,"HORLESTI",532,"Caminul Cultural, sala mica Horlesti",335,166,165,1,0,161,5,383,217,103,58,3,9601,0
24,"Iasi",97517,225,97517,,"HORLESTI",533,"Caminul Cultural  Bogdanesti",512,253,248,5,0,243,10,600,347,107,136,3,9601,0
24,"Iasi",97517,225,97517,,"HORLESTI",534,"Scoala Generala cu cl. I - IV  Scoposeni",235,140,131,9,0,139,1,300,160,78,61,3,9601,0
24,"Iasi",97517,225,97517,,"HORLESTI",535,"Scoala Generala cu clasele I-VIII Horlesti",0,88,0,88,0,87,1,201,113,53,34,3,9601,1
24,"Iasi",95499,225,95499,,"ION NECULCE",536,"scoala cu cl. I - VIII  Razboieni",1410,862,852,10,0,834,28,1500,638,211,623,3,9605,0
24,"Iasi",95499,225,95499,,"ION NECULCE",537,"scoala cu cl. I - VIII Buznea",1211,631,622,9,0,609,22,1300,669,186,423,3,9605,0
24,"Iasi",95499,225,95499,,"ION NECULCE",538,"scoala cu cl. I - IV Dadesti",214,127,120,7,0,123,4,300,173,36,87,3,9605,0
24,"Iasi",95499,225,95499,,"ION NECULCE",539,"scoala cu cl. I - IV Ganesti",594,370,365,5,0,366,4,700,330,58,308,3,9605,0
24,"Iasi",95499,225,95499,,"ION NECULCE",540,"scoala cu cl. I - IV Ion Neculce",129,94,81,13,0,91,3,200,106,34,57,3,9605,0
24,"Iasi",95499,225,95499,,"ION NECULCE",541,"scoala cu cl. I - VIII Prigoreni",523,351,347,4,0,349,2,600,249,58,291,3,9605,0
24,"Iasi",95499,225,95499,,"ION NECULCE",542,"Scoala cu clasele I-VIII Razboieni",0,58,0,58,0,56,2,200,142,34,22,3,9605,1
24,"Iasi",97553,225,97553,,"IPATELE",543,"Scoala cu cl. I - VIII Ipatele",591,334,308,7,19,329,5,680,346,71,258,3,9612,0
24,"Iasi",97553,225,97553,,"IPATELE",544,"Scoala cu cl. I - IV  Cuza Voda",386,227,209,6,12,222,5,500,273,47,175,3,9612,0
24,"Iasi",97553,225,97553,,"IPATELE",545,"Scoala cu cl. I - VIII Bicu",480,294,292,2,0,292,2,500,206,89,203,3,9612,0
24,"Iasi",97553,225,97553,,"IPATELE",546,"Scoala cu clasele I-VIII Ipatele",0,65,0,65,0,63,2,200,135,28,35,3,9612,1
24,"Iasi",97606,225,97606,,"LESPEZI",547,"scoala Lespezi",893,357,349,8,0,357,0,1000,643,102,255,3,9617,0
24,"Iasi",97606,225,97606,,"LESPEZI",548,"scoala Heci",942,433,426,7,0,430,3,1000,567,122,308,3,9617,0
24,"Iasi",97606,225,97606,,"LESPEZI",549,"scoala Heci",863,391,380,11,0,388,3,900,509,103,285,3,9617,0
24,"Iasi",97606,225,97606,,"LESPEZI",550,"scoala Buda",887,387,380,7,0,385,2,1000,613,148,237,3,9617,0
24,"Iasi",97606,225,97606,,"LESPEZI",551,"scoala Bursuc Deal",727,325,318,7,0,322,3,800,475,90,232,3,9617,0
24,"Iasi",97606,225,97606,,"LESPEZI",552,"scoala Dumbrava",559,294,282,12,0,293,1,600,306,107,186,3,9617,0
24,"Iasi",97606,225,97606,,"LESPEZI",553,"Scoala Generala Lespezi",0,55,0,55,0,55,0,199,144,24,31,3,9617,1
24,"Iasi",97679,225,97679,,"LETCANI",554,"Scoala cu cl. I - VIII Letcani",1587,770,760,10,0,752,18,1700,930,369,383,3,9624,0
24,"Iasi",97679,225,97679,,"LETCANI",555,"Scoala cu cl. I - VIII Letcani",1370,658,650,8,0,651,7,1500,842,310,341,3,9624,0
24,"Iasi",97679,225,97679,,"LETCANI",556,"Scoala cu cl. I - VIII Letcani",1437,640,632,8,0,629,11,1498,858,259,370,3,9624,0
24,"Iasi",97679,225,97679,,"LETCANI",557,"scoala generala Bogonos",543,312,303,9,0,305,7,597,285,160,145,3,9624,0
24,"Iasi",97679,225,97679,,"LETCANI",558,"scoala generala Cucuteni",394,223,212,11,0,222,1,477,254,108,114,3,9624,0
24,"Iasi",97679,225,97679,,"LETCANI",559,"Scoala cu clasele I-VIII Letcani",0,104,0,104,0,103,1,200,96,60,43,3,9624,1
24,"Iasi",97722,225,97722,,"LUNGANI",560,"Scoala Lungani",866,453,435,2,16,448,5,1000,547,190,258,3,9629,0
24,"Iasi",97722,225,97722,,"LUNGANI",561,"Scoala Goesti",712,409,395,8,6,405,4,800,391,89,316,3,9629,0
24,"Iasi",97722,225,97722,,"LUNGANI",562,"Scoala Crucea",1020,806,798,8,0,795,11,1100,294,119,676,3,9629,0
24,"Iasi",97722,225,97722,,"LUNGANI",563,"Scoala Zmeu",1061,934,924,10,0,927,7,1200,266,68,859,3,9629,0
24,"Iasi",97722,225,97722,,"LUNGANI",564,"Gradinita din satul Lungani",0,69,0,69,0,67,2,200,131,22,45,3,9629,1
24,"Iasi",97777,225,97777,,"MADARJAC",565,"scoala generala cu clasele I - VIII Madarjac",1165,742,700,11,31,733,9,1300,558,214,519,3,9634,0
24,"Iasi",97777,225,97777,,"MADARJAC",566,"scoala generala cu clasele I - VIII Madarjac",0,50,0,50,0,49,1,200,150,17,32,3,9634,1
24,"Iasi",97811,225,97811,,"MIRCESTI",567,"scoala Mircesti",1303,572,567,5,0,563,9,1400,828,220,343,3,9638,0
24,"Iasi",97811,225,97811,,"MIRCESTI",568,"scoala Iugani",1310,663,659,4,0,657,6,1400,737,364,293,3,9638,0
24,"Iasi",97811,225,97811,,"MIRCESTI",569,"gradinita Iugani",363,171,168,3,0,169,2,400,229,104,65,3,9638,0
24,"Iasi",97811,225,97811,,"MIRCESTI",570,"Scoala Generala Mircesti",0,35,0,35,0,35,0,198,163,15,20,3,9638,1
24,"Iasi",97875,225,97875,,"MIRONEASA",571,"Scoala de Arte si Meserii Mironeasa",1243,631,622,8,1,614,17,1300,669,141,473,3,9641,0
24,"Iasi",97875,225,97875,,"MIRONEASA",572,"Scoala de Arte si Meserii Mironeasa",1214,634,634,0,0,616,18,1300,666,88,528,3,9641,0
24,"Iasi",97875,225,97875,,"MIRONEASA",573,"scoala generala Ursita",401,210,205,5,0,207,3,500,290,58,149,3,9641,0
24,"Iasi",97875,225,97875,,"MIRONEASA",574,"Scoala de Arte si Meserii Mironeasa",0,50,0,50,0,48,2,200,150,18,30,3,9641,1
24,"Iasi",97919,225,97919,,"MIROSLAVA",575,"scoala generala Miroslava",859,416,409,7,0,413,3,900,484,221,192,3,9645,0
24,"Iasi",97919,225,97919,,"MIROSLAVA",576,"scoala generala Miroslava",897,448,439,8,1,448,0,973,525,243,205,3,9645,0
24,"Iasi",97919,225,97919,,"MIROSLAVA",577,"cladirea primariei vechi Miroslava (biblioteca)",557,281,259,22,0,279,2,600,319,142,137,3,9645,0
24,"Iasi",97919,225,97919,,"MIROSLAVA",578,"scoala generala Valea Adanca",692,327,312,15,0,324,3,800,473,168,156,3,9645,0
24,"Iasi",97919,225,97919,,"MIROSLAVA",579,"magazinul de mobila proprietatea Tofan, Aleea cu plopi",892,437,414,23,0,435,2,1000,563,270,165,3,9645,0
24,"Iasi",97919,225,97919,,"MIROSLAVA",580,"scoala generala Uricani",800,398,388,10,0,392,6,900,502,169,223,3,9645,0
24,"Iasi",97919,225,97919,,"MIROSLAVA",581,"scoala generala Vorovesti",584,295,289,6,0,290,5,720,425,101,189,3,9645,0
24,"Iasi",97919,225,97919,,"MIROSLAVA",582,"scoala generala Bratuleni",245,152,143,9,0,147,5,300,148,76,71,3,9645,0
24,"Iasi",97919,225,97919,,"MIROSLAVA",583,"scoala generala Cornesti",903,419,406,13,0,413,6,1000,581,279,134,3,9645,0
24,"Iasi",97919,225,97919,,"MIROSLAVA",584,"scoala generala Ciurbesti",753,367,356,11,0,357,10,816,449,201,156,3,9645,0
24,"Iasi",97919,225,97919,,"MIROSLAVA",585,"scoala generala Horpaz",981,487,470,17,0,484,3,1122,635,268,216,3,9645,0
24,"Iasi",97919,225,97919,,"MIROSLAVA",586,"Scoala Generala Miroslava",0,199,0,199,0,197,2,500,301,121,76,3,9645,1
24,"Iasi",98051,225,98051,,"MIROSLOVESTI",587,"Scoala de Arte si Meserii Miroslovesti",738,336,335,1,0,331,5,800,464,93,238,3,9659,0
24,"Iasi",98051,225,98051,,"MIROSLOVESTI",588,"Scoala de Arte si Meserii Miroslovesti",913,460,450,10,0,453,7,1000,540,153,300,3,9659,0
24,"Iasi",98051,225,98051,,"MIROSLOVESTI",589,"scoala generala cu cl. I - VIII Soci",1102,574,549,25,0,568,6,1200,626,122,446,3,9659,0
24,"Iasi",98051,225,98051,,"MIROSLOVESTI",590,"scoala generala cu cl. I - VIII Verseni",1048,483,472,11,0,477,6,1100,617,156,321,3,9659,0
24,"Iasi",98051,225,98051,,"MIROSLOVESTI",591,"Scoala de Arte si Meserii Miroslovesti",0,94,0,94,0,93,1,200,106,33,60,3,9659,1
24,"Iasi",98113,225,98113,,"MOGOSESTI",592,"Scoala de Arte si Meserii Dumitru Popa, sala nr. 1",1279,562,555,7,0,555,7,1400,838,237,318,3,9664,0
24,"Iasi",98113,225,98113,,"MOGOSESTI",593,"Scoala de Arte si Meserii Dumitru Popa, sala nr. 2",911,376,371,5,0,369,7,1000,624,142,227,3,9664,0
24,"Iasi",98113,225,98113,,"MOGOSESTI",594,"scoala generala Minjesti",793,360,344,16,0,357,3,900,540,115,242,3,9664,0
24,"Iasi",98113,225,98113,,"MOGOSESTI",595,"scoala generala Hadimbu, localul de jos",816,429,418,11,0,412,17,900,471,180,232,3,9664,0
24,"Iasi",98113,225,98113,,"MOGOSESTI",596,"Scoala de Arte si meserii Mogosesti",0,106,0,106,0,106,0,200,94,43,63,3,9664,1
24,"Iasi",98168,225,98168,,"MOGOSESTI-SIRET",597,"scoala Mogosesti Siret",1405,690,678,12,0,677,13,1500,810,178,499,3,9669,0
24,"Iasi",98168,225,98168,,"MOGOSESTI-SIRET",598,"scoala Mogosesti Siret",928,600,579,21,0,589,11,1000,400,110,479,3,9669,0
24,"Iasi",98168,225,98168,,"MOGOSESTI-SIRET",599,"scoala Muncelu de Sus",863,674,660,14,0,670,4,900,226,143,527,3,9669,0
24,"Iasi",98168,225,98168,,"MOGOSESTI-SIRET",600,"Scoala Generala Mogosesti Siret",0,81,0,81,0,81,0,200,119,25,56,3,9669,1
24,"Iasi",98202,225,98202,,"MOSNA",601,"scoala generala Mosna",1515,816,812,4,0,798,18,1600,784,515,283,3,9673,0
24,"Iasi",98202,225,98202,,"MOSNA",602,"scoala generala Mosna",0,48,0,48,0,48,0,200,152,28,20,3,9673,1
24,"Iasi",98220,225,98220,,"MOTCA",603,"camin cultural Motca",1490,690,684,1,5,680,10,1600,910,344,336,3,9675,0
24,"Iasi",98220,225,98220,,"MOTCA",604,"camin cultural Motca",1435,704,691,8,5,694,10,1500,796,353,341,3,9675,0
24,"Iasi",98220,225,98220,,"MOTCA",605,"camin cultural Boureni",1095,551,542,8,1,543,8,1200,649,264,279,3,9675,0
24,"Iasi",98220,225,98220,,"MOTCA",606,"Caminul Cultural Motca",0,73,0,73,0,72,1,200,127,45,27,3,9675,1
24,"Iasi",98257,225,98257,,"MOVILENI",607,"camin cultural Movileni",458,200,194,6,0,196,4,500,300,46,150,3,9678,0
24,"Iasi",98257,225,98257,,"MOVILENI",608,"scoala Potingeni",788,323,317,6,0,313,10,900,577,97,216,3,9678,0
24,"Iasi",98257,225,98257,,"MOVILENI",609,"scoala Iepureni",707,355,347,8,0,343,12,800,445,90,253,3,9678,0
24,"Iasi",98257,225,98257,,"MOVILENI",610,"scoala Larga Jijia",611,286,279,7,0,274,12,700,414,100,174,3,9678,0
24,"Iasi",98257,225,98257,,"MOVILENI",611,"Scoala Generala Movileni",0,72,0,72,0,72,0,200,128,28,44,3,9678,1
24,"Iasi",98300,225,98300,,"OTELENI",612,"Scoala de Arte si Meserii Oteleni",994,424,422,2,0,421,3,1100,676,180,241,3,9683,0
24,"Iasi",98300,225,98300,,"OTELENI",613,"Scoala de Arte si Meserii Oteleni",1089,465,463,2,0,463,2,1200,735,195,268,3,9683,0
24,"Iasi",98300,225,98300,,"OTELENI",614,"scoala cu cl. I - VIII Hindresti",926,372,360,12,0,368,4,1000,628,172,196,3,9683,0
24,"Iasi",98300,225,98300,,"OTELENI",615,"Scoala Generala Oteleni, Corpul B",0,73,0,73,0,73,0,200,127,32,41,3,9683,1
24,"Iasi",98337,225,98337,,"PLUGARI",616,"Scoala generala Plugari",1468,700,693,6,1,689,11,1600,900,184,505,3,9686,0
24,"Iasi",98337,225,98337,,"PLUGARI",617,"Scoala generala Borosoaia",1262,605,585,19,1,598,7,1400,795,109,489,3,9686,0
24,"Iasi",98337,225,98337,,"PLUGARI",618,"Scoala Generala Plugari",0,28,0,28,0,28,0,201,173,10,18,3,9686,1
24,"Iasi",98435,225,98435,,"POPESTI",619,"Scoala de Arte si Meserii Dimitrie Sturdza, Popesti",854,388,386,2,0,378,10,903,515,109,269,3,9690,0
24,"Iasi",98435,225,98435,,"POPESTI",620,"Scoala de Arte si Meserii Dimitrie Sturdza, Popesti",824,379,374,5,0,373,6,900,521,122,251,3,9690,0
24,"Iasi",98435,225,98435,,"POPESTI",621,"Scoala generala Obrijeni",224,127,116,11,0,126,1,301,174,62,64,3,9690,0
24,"Iasi",98435,225,98435,,"POPESTI",622,"Scoala generala Doroscani",498,233,225,8,0,229,4,600,367,62,167,3,9690,0
24,"Iasi",98435,225,98435,,"POPESTI",623,"Scoala generala Harpasesti",698,290,278,12,0,288,2,800,510,63,225,3,9690,0
24,"Iasi",98435,225,98435,,"POPESTI",624,"Scoala de Arte si Meserii Dimitrie Sturdza, Popesti",0,117,0,117,0,117,0,204,87,37,80,3,9690,1
24,"Iasi",98505,225,98505,,"POPRICANI",625,"Scoala Popricani",1076,542,535,7,0,535,7,1199,657,186,349,3,9697,0
24,"Iasi",98505,225,98505,,"POPRICANI",626,"Scoala Popricani",1022,508,499,9,0,505,3,1099,591,200,305,3,9697,0
24,"Iasi",98505,225,98505,,"POPRICANI",627,"Scoala Moimesti",325,193,181,12,0,192,1,409,216,73,119,3,9697,0
24,"Iasi",98505,225,98505,,"POPRICANI",628,"Scoala Tipilesti",340,213,202,11,0,210,3,400,187,82,128,3,9697,0
24,"Iasi",98505,225,98505,,"POPRICANI",629,"Scoala Cotu Mori",213,136,128,8,0,134,2,298,162,60,74,3,9697,0
24,"Iasi",98505,225,98505,,"POPRICANI",630,"Gradinita Vinatori",990,520,509,11,0,507,13,1100,580,242,265,3,9697,0
24,"Iasi",98505,225,98505,,"POPRICANI",631,"Gradinita Vinatori",740,420,401,19,0,413,7,800,380,211,202,3,9697,0
24,"Iasi",98505,225,98505,,"POPRICANI",632,"Scoala Cirlig",539,300,290,10,0,291,9,600,300,145,146,3,9697,0
24,"Iasi",98505,225,98505,,"POPRICANI",633,"Scoala Cuza-Voda",449,263,253,10,0,260,3,500,237,130,130,3,9697,0
24,"Iasi",98505,225,98505,,"POPRICANI",634,"Scoala cu clasele I-VIII Vanatori",0,139,0,139,0,138,1,196,57,88,50,3,9697,1
24,"Iasi",98603,225,98603,,"PRISACANI",635,"Scoala de Arte si Meserii Prisacani",1481,762,754,5,3,746,16,1600,838,243,503,3,9707,0
24,"Iasi",98603,225,98603,,"PRISACANI",636,"Scoala generala Macaresti",534,261,254,7,0,258,3,600,339,90,168,3,9707,0
24,"Iasi",98603,225,98603,,"PRISACANI",637,"Scoala generala Moreni",788,448,441,7,0,437,11,900,452,214,223,3,9707,0
24,"Iasi",98603,225,98603,,"PRISACANI",638,"Scoala de Arte si Meserii Prisacani",0,96,0,96,0,96,0,199,103,46,50,3,9707,1
24,"Iasi",98649,225,98649,,"PROBOTA",639,"Scoala generala Probota",1025,482,468,14,0,476,6,1100,618,149,327,3,9711,0
24,"Iasi",98649,225,98649,,"PROBOTA",640,"Scoala Balteni, corp B",533,320,312,8,0,318,2,600,280,61,257,3,9711,0
24,"Iasi",98649,225,98649,,"PROBOTA",641,"Scoala Grigore Sturdza",1290,708,699,9,0,693,15,1400,692,192,501,3,9711,0
24,"Iasi",98649,225,98649,,"PROBOTA",642,"Scoala Generala Probota",0,136,0,136,0,135,1,200,64,55,80,3,9711,1
24,"Iasi",100335,225,100335,,"RACHITENI",643,"Scoala de Arte si Meserii Rachiteni, corp A",1506,659,652,7,0,654,5,1600,941,349,305,3,9715,0
24,"Iasi",100335,225,100335,,"RACHITENI",644,"Scoala generala Izvoarele",1118,458,453,5,0,455,3,1200,742,179,276,3,9715,0
24,"Iasi",100335,225,100335,,"RACHITENI",645,"Scoala de Arte si Meserii Rachiteni",0,46,0,46,0,46,0,200,154,27,19,3,9715,1
24,"Iasi",98685,225,98685,,"RADUCANENI",646,"Lic.Teoretic Lascar Rosetti, Sala de sport",792,341,317,24,0,333,8,900,559,160,173,3,9719,0
24,"Iasi",98685,225,98685,,"RADUCANENI",647,"Lic.Teoretic Lascar Rosetti, Sala de sport",807,394,368,26,0,390,4,900,506,215,175,3,9719,0
24,"Iasi",98685,225,98685,,"RADUCANENI",648,"Scoala generala Raducaneni",1582,811,771,40,0,800,11,1700,889,341,459,3,9719,0
24,"Iasi",98685,225,98685,,"RADUCANENI",649,"Scoala generala Bazga",1141,561,544,17,0,549,12,1300,739,228,321,3,9719,0
24,"Iasi",98685,225,98685,,"RADUCANENI",650,"Scoala generala Bohotin",1145,574,569,5,0,567,7,1300,726,214,353,3,9719,0
24,"Iasi",98685,225,98685,,"RADUCANENI",651,"Scoala generala Rosu",501,234,219,15,0,227,7,600,366,81,146,3,9719,0
24,"Iasi",98685,225,98685,,"RADUCANENI",652,"Scoala generala Isaiia",260,154,145,9,0,153,1,300,146,92,61,3,9719,0
24,"Iasi",98685,225,98685,,"RADUCANENI",653,"Scoala Generala Raducaneni",0,89,0,89,0,89,0,200,111,39,50,3,9719,1
24,"Iasi",95239,225,95239,,"REDIU",654,"Scoala generala Rediu",1407,670,651,19,0,661,9,1500,830,314,347,3,9724,0
24,"Iasi",95239,225,95239,,"REDIU",655,"Scoala primara Breazu",870,450,432,18,0,445,5,1000,550,248,197,3,9724,0
24,"Iasi",95239,225,95239,,"REDIU",656,"Scoala generala Horlesti",883,433,416,17,0,428,5,1002,569,189,239,3,9724,0
24,"Iasi",95239,225,95239,,"REDIU",657,"Scoala Generala Rediu",0,103,0,103,0,103,0,200,97,58,45,3,9724,1
24,"Iasi",98738,225,98738,,"ROMANESTI",658,"Scoala generala Romanesti",777,423,409,9,5,415,8,900,477,154,261,3,9729,0
24,"Iasi",98738,225,98738,,"ROMANESTI",659,"Scoala primara Avantu",440,258,232,10,16,252,6,496,238,133,119,3,9729,0
24,"Iasi",98738,225,98738,,"ROMANESTI",660,"Scoala primara Ursoaia",333,224,186,23,15,224,0,398,174,136,88,3,9729,0
24,"Iasi",98738,225,98738,,"ROMANESTI",661,"Scoala Generala Romanesti",0,78,0,78,0,78,0,200,122,42,36,3,9729,1
24,"Iasi",100344,225,100344,,"ROSCANI",662,"Gradinita Radeni",600,304,280,24,0,299,5,600,296,115,184,3,9733,0
24,"Iasi",100344,225,100344,,"ROSCANI",663,"Scoala generala cu clasele I-IV Roscani",569,278,270,8,0,270,8,604,326,97,173,3,9733,0
24,"Iasi",100344,225,100344,,"ROSCANI",664,"Gradinita Radeni",0,21,0,21,0,21,0,200,179,11,10,3,9733,1
24,"Iasi",98774,225,98774,,"RUGINOASA",665,"Sediul Primariei",886,500,484,15,1,492,8,1000,500,215,277,3,9736,0
24,"Iasi",98774,225,98774,,"RUGINOASA",666,"Scoala Generala Ruginoasa",725,388,363,23,2,378,10,800,412,156,222,3,9736,0
24,"Iasi",98774,225,98774,,"RUGINOASA",667,"Scoala generala Dumbravita",1063,572,568,4,0,562,10,1200,628,198,364,3,9736,0
24,"Iasi",98774,225,98774,,"RUGINOASA",668,"Scoala generala Dumbravita",847,439,430,9,0,439,0,900,461,155,284,3,9736,0
24,"Iasi",98774,225,98774,,"RUGINOASA",669,"Scoala generala Rediu",909,568,550,18,0,558,10,1000,432,216,342,3,9736,0
24,"Iasi",98774,225,98774,,"RUGINOASA",670,"Scoala generala  Vascani",406,271,258,13,0,267,4,500,229,123,144,3,9736,0
24,"Iasi",98774,225,98774,,"RUGINOASA",671,"Scoala Generala Ruginoasa",0,125,0,125,0,123,2,200,75,53,70,3,9736,1
24,"Iasi",98916,225,98916,,"SCANTEIA",672,"Scoala generala Scanteia",1300,558,554,4,0,551,7,1400,842,268,283,3,9741,0
24,"Iasi",98916,225,98916,,"SCANTEIA",673,"Scoala generala Bodesti",339,190,180,10,0,190,0,400,210,66,124,3,9741,0
24,"Iasi",98916,225,98916,,"SCANTEIA",674,"Scoala generala Tufestii de Sus",216,114,109,5,0,111,3,300,186,26,85,3,9741,0
24,"Iasi",98916,225,98916,,"SCANTEIA",675,"Scoala generala Rediu",179,95,85,10,0,92,3,200,105,55,37,3,9741,0
24,"Iasi",98916,225,98916,,"SCANTEIA",676,"Scoala generala Ciocarlesti",299,144,136,8,0,142,2,400,256,63,79,3,9741,0
24,"Iasi",98916,225,98916,,"SCANTEIA",677,"Scoala generala Lunca Rates",317,158,148,10,0,148,10,400,242,36,112,3,9741,0
24,"Iasi",98916,225,98916,,"SCANTEIA",678,"Gradinita Borosesti",726,333,324,9,0,328,5,800,467,153,175,3,9741,0
24,"Iasi",98916,225,98916,,"SCANTEIA",679,"Sala de sedinte a Consiliului Local Scinteia",0,86,0,86,0,86,0,200,114,47,39,3,9741,1
24,"Iasi",98827,225,98827,,"SCHITU DUCA",680,"Scoala generala Schitu Duca",528,276,263,12,1,273,3,600,324,122,151,3,9755,0
24,"Iasi",98827,225,98827,,"SCHITU DUCA",681,"Scoala generala Poieni",634,370,357,13,0,364,6,700,330,148,216,3,9755,0
24,"Iasi",98827,225,98827,,"SCHITU DUCA",682,"Scoala generala Dumitrestii Galatii",538,351,338,13,0,344,7,597,246,115,229,3,9755,0
24,"Iasi",98827,225,98827,,"SCHITU DUCA",683,"Scoala generala Pocreaca",371,238,226,12,0,226,12,400,162,58,168,3,9755,0
24,"Iasi",98827,225,98827,,"SCHITU DUCA",684,"Scoala generala Poiana",402,272,232,40,0,267,5,500,228,107,160,3,9755,0
24,"Iasi",98827,225,98827,,"SCHITU DUCA",685,"Scoala generala  Satu Nou",456,262,255,7,0,255,7,500,238,92,163,3,9755,0
24,"Iasi",98827,225,98827,,"SCHITU DUCA",686,"Scoala generala Slobozia",336,242,225,17,0,235,7,400,158,52,183,3,9755,0
24,"Iasi",98827,225,98827,,"SCHITU DUCA",687,"Scoala generala Schitu Duca",0,170,0,170,0,170,0,203,33,66,104,3,9755,1
24,"Iasi",98998,225,98998,,"SCOBINTI",688,"Scoala veche Scobinti",1203,579,562,17,0,573,6,1300,721,158,415,3,9764,0
24,"Iasi",98998,225,98998,,"SCOBINTI",689,"Scoala Zvarici",278,154,144,10,0,151,3,300,146,46,105,3,9764,0
24,"Iasi",98998,225,98998,,"SCOBINTI",690,"Scoala Badeni",1001,513,503,10,0,508,5,1100,587,132,376,3,9764,0
24,"Iasi",98998,225,98998,,"SCOBINTI",691,"Scoala coordonatoare Scobinti",1026,462,453,9,0,455,7,1100,638,178,277,3,9764,0
24,"Iasi",98998,225,98998,,"SCOBINTI",692,"Scoala Sticlaria",1124,620,612,8,0,606,14,1200,580,201,405,3,9764,0
24,"Iasi",98998,225,98998,,"SCOBINTI",693,"Scoala Rediu",197,110,102,8,0,109,1,300,190,31,78,3,9764,0
24,"Iasi",98998,225,98998,,"SCOBINTI",694,"Scoala Zagavia",902,453,438,15,0,443,10,1000,547,148,295,3,9764,0
24,"Iasi",98998,225,98998,,"SCOBINTI",695,"Scoala Generala Fetesti",0,78,0,78,0,77,1,200,122,36,41,3,9764,1
24,"Iasi",99058,225,99058,,"SINESTI",696,"Sala de sport Sinesti",1314,685,670,7,8,673,12,1400,715,240,433,3,9770,0
24,"Iasi",99058,225,99058,,"SINESTI",697,"Scoala generala Bocnita",234,159,148,11,0,156,3,297,138,36,120,3,9770,0
24,"Iasi",99058,225,99058,,"SINESTI",698,"Scoala generala Osoi",730,331,323,8,0,326,5,795,464,115,211,3,9770,0
24,"Iasi",99058,225,99058,,"SINESTI",699,"Scoala generala Stornesti",833,426,412,14,0,418,8,900,474,123,295,3,9770,0
24,"Iasi",99058,225,99058,,"SINESTI",700,"Sala de sport Sinesti",0,53,0,53,0,51,2,198,145,22,29,3,9770,1
24,"Iasi",99101,225,99101,,"SIRETEL",701,"Scoala de Arte si Meserii Siretel",850,380,377,3,0,374,6,900,520,126,248,3,9782,0
24,"Iasi",99101,225,99101,,"SIRETEL",702,"Scoala de Arte si Meserii Siretel",853,335,332,3,0,330,5,900,565,127,203,3,9782,0
24,"Iasi",99101,225,99101,,"SIRETEL",703,"Scoala generala Slobozia",646,315,307,8,0,312,3,700,385,121,191,3,9782,0
24,"Iasi",99101,225,99101,,"SIRETEL",704,"Scoala generala Humosu",610,327,320,7,0,323,4,700,373,94,229,3,9782,0
24,"Iasi",99101,225,99101,,"SIRETEL",705,"Scoala de Arte si Meserii Siretel",0,31,0,31,0,31,0,200,169,12,19,3,9782,1
24,"Iasi",99165,225,99165,,"STOLNICENI-PRAJESCU",706,"Camin Cultural Matei Millo Stolniceni Prajescu",1238,676,657,13,6,672,4,1300,624,324,348,3,9788,0
24,"Iasi",99165,225,99165,,"STOLNICENI-PRAJESCU",707,"Scoala cu clasele I-VIII Cozmesti, Sala 1",920,426,423,3,0,421,5,1000,574,261,160,3,9788,0
24,"Iasi",99165,225,99165,,"STOLNICENI-PRAJESCU",708,"Scoala cu clasele I-VII Cozmesti, Sala 2",817,340,334,6,0,334,6,900,560,180,154,3,9788,0
24,"Iasi",99165,225,99165,,"STOLNICENI-PRAJESCU",709,"Scoala cu clasele I-VIII Bratesti",562,304,285,19,0,300,4,600,296,106,194,3,9788,0
24,"Iasi",99165,225,99165,,"STOLNICENI-PRAJESCU",710,"Scoala cu clasele I-IV Bratesti",933,515,506,9,0,505,10,1000,485,178,327,3,9788,0
24,"Iasi",99165,225,99165,,"STOLNICENI-PRAJESCU",711,"Camin Cultural Matei Millo Stolniceni Prajescu",0,36,0,36,0,36,0,200,164,23,13,3,9788,1
24,"Iasi",99209,225,99209,,"STRUNGA",712,"Scoala generala Strunga",526,253,252,1,0,250,3,600,347,112,138,3,9792,0
24,"Iasi",99209,225,99209,,"STRUNGA",713,"Centrul de Diagnostic si Tratament Persoane cu Handicap Fedeleseni",689,344,336,8,0,335,9,800,456,82,253,3,9792,0
24,"Iasi",99209,225,99209,,"STRUNGA",714,"Scoala primara Crivesti",295,162,153,9,0,160,2,400,238,28,132,3,9792,0
24,"Iasi",99209,225,99209,,"STRUNGA",715,"Scoala Cucova",127,76,68,8,0,75,1,200,124,16,59,3,9792,0
24,"Iasi",99209,225,99209,,"STRUNGA",716,"Scoala Farcaseni",793,357,350,7,0,349,8,900,543,90,259,3,9792,0
24,"Iasi",99209,225,99209,,"STRUNGA",717,"Scoala Farcaseni",740,320,308,12,0,314,6,800,480,91,223,3,9792,0
24,"Iasi",99209,225,99209,,"STRUNGA",718,"Scoala primara Habasesti",377,239,234,5,0,237,2,400,161,87,150,3,9792,0
24,"Iasi",99209,225,99209,,"STRUNGA",719,"Biblioteca Comunala Strunga",0,59,0,59,0,58,1,200,141,18,40,3,9792,1
24,"Iasi",99290,225,99290,,"SCHEIA",720,"Scoala generala Scheia",924,429,424,5,0,423,6,1000,571,91,332,3,9749,0
24,"Iasi",99290,225,99290,,"SCHEIA",721,"Scoala generala cu clasele I-IV Cauesti",410,266,229,37,0,262,4,500,234,67,195,3,9749,0
24,"Iasi",99290,225,99290,,"SCHEIA",722,"Scoala generala cu clasele I-IV Cioca-Boca",370,196,185,11,0,193,3,400,204,49,144,3,9749,0
24,"Iasi",99290,225,99290,,"SCHEIA",723,"Scoala generala cu clasele I-IV Satu-Nou",259,141,130,11,0,137,4,300,159,31,106,3,9749,0
24,"Iasi",99290,225,99290,,"SCHEIA",724,"Scoala generala cu clasele I-IV Poiana-Scheii",353,209,200,9,0,207,2,400,191,43,164,3,9749,0
24,"Iasi",99290,225,99290,,"SCHEIA",725,"Scoala generala Scheia",0,68,0,68,0,67,1,200,132,15,52,3,9749,1
24,"Iasi",99370,225,99370,,"SIPOTE",726,"Scoala generala Sipote",905,399,387,12,0,392,7,1000,601,154,238,3,9775,0
24,"Iasi",99370,225,99370,,"SIPOTE",727,"Scoala generala Iazu Nou",758,441,420,21,0,436,5,800,359,100,336,3,9775,0
24,"Iasi",99370,225,99370,,"SIPOTE",728,"Scoala generala Chiscareni",1297,682,637,45,0,672,10,1400,718,150,522,3,9775,0
24,"Iasi",99370,225,99370,,"SIPOTE",729,"Scoala generala Halceni",1172,607,561,46,0,598,9,1300,693,193,405,3,9775,0
24,"Iasi",99370,225,99370,,"SIPOTE",730,"Scoala generala Sipote",0,60,0,60,0,60,0,200,140,16,44,3,9775,1
24,"Iasi",99441,225,99441,,"TANSA",731,"Gradinita de copii Tansa",1215,789,741,36,12,772,17,1300,511,284,488,3,9801,0
24,"Iasi",99441,225,99441,,"TANSA",732,"Scoala generala Suhulet",1038,690,647,20,23,681,9,1100,410,290,391,3,9801,0
24,"Iasi",99441,225,99441,,"TANSA",733,"Gradinita de copii Tansa",0,114,0,114,0,114,0,200,86,42,72,3,9801,1
24,"Iasi",99478,225,99478,,"TATARUSI",734,"Caminul Cultural Alexandru Vasiliu Tatarusi",1512,834,823,6,5,818,16,1600,766,213,605,3,9804,0
24,"Iasi",99478,225,99478,,"TATARUSI",735,"Scoala generala Uda",1219,670,661,8,1,659,11,1300,630,156,503,3,9804,0
24,"Iasi",99478,225,99478,,"TATARUSI",736,"Scoala generala Pietrosu",1145,615,599,14,2,605,10,1200,585,168,437,3,9804,0
24,"Iasi",99478,225,99478,,"TATARUSI",737,"Scoala generala Iorcani",705,428,415,5,8,423,5,800,372,131,292,3,9804,0
24,"Iasi",99478,225,99478,,"TATARUSI",738,"Caminul Cultural Alexandru Vasiliu Tatarusi",0,81,0,81,0,81,0,200,119,34,47,3,9804,1
24,"Iasi",99539,225,99539,,"TODIRESTI",739,"Caminul Cultural Todiresti",1306,532,517,15,0,530,2,1400,868,148,382,3,9835,0
24,"Iasi",99539,225,99539,,"TODIRESTI",740,"Caminul Cultural Todiresti",786,332,309,23,0,328,4,900,568,88,240,3,9835,0
24,"Iasi",99539,225,99539,,"TODIRESTI",741,"Scoala nr. 2 Todiresti",786,375,368,7,0,369,6,900,525,120,249,3,9835,0
24,"Iasi",99539,225,99539,,"TODIRESTI",742,"Scoala generala Stroiesti",343,152,148,4,0,151,1,400,248,49,102,3,9835,0
24,"Iasi",99539,225,99539,,"TODIRESTI",743,"Scoala generala Baiceni",311,190,180,10,0,183,7,400,210,30,153,3,9835,0
24,"Iasi",99539,225,99539,,"TODIRESTI",744,"Gradinita din Satul Todiresti",0,40,0,40,0,40,0,200,160,10,30,3,9835,1
24,"Iasi",95293,225,95293,,"TOMESTI",745,"Primaria Tomesti",524,305,217,88,0,304,1,600,295,114,190,3,9839,0
24,"Iasi",95293,225,95293,,"TOMESTI",746,"Scoala generala Goruni",982,491,471,20,0,479,12,1100,609,213,266,3,9839,0
24,"Iasi",95293,225,95293,,"TOMESTI",747,"Scoala generala Chicerea",932,440,429,10,1,436,4,1000,560,216,220,3,9839,0
24,"Iasi",95293,225,95293,,"TOMESTI",748,"Scoala generala D. D. Patrascanu Tomesti",1481,576,540,36,0,571,5,1600,1024,265,306,3,9839,0
24,"Iasi",95293,225,95293,,"TOMESTI",749,"Scoala generala Vladiceni",455,232,223,9,0,226,6,500,268,118,108,3,9839,0
24,"Iasi",95293,225,95293,,"TOMESTI",750,"Scoala generala D. D. Patrascanu Tomesti",1642,675,664,11,0,671,4,1700,1025,357,314,3,9839,0
24,"Iasi",95293,225,95293,,"TOMESTI",751,"Scoala generala D. D. Patrascanu Tomesti",1504,670,658,12,0,664,6,1600,930,341,323,3,9839,0
24,"Iasi",95293,225,95293,,"TOMESTI",752,"Scoala generala D. D. Patrascanu Tomesti",1730,739,730,9,0,731,8,1800,1061,416,315,3,9839,0
24,"Iasi",95293,225,95293,,"TOMESTI",753,"Scoala generala D. D. Patrascanu Tomesti",1662,766,758,7,1,760,6,1800,1034,403,357,3,9839,0
24,"Iasi",95293,225,95293,,"TOMESTI",754,"Scoala generala D. D. Patrascanu Tomesti",0,203,0,203,0,203,0,300,97,116,87,3,9839,1
24,"Iasi",99600,225,99600,,"TRIFESTI",755,"Gradinita de copii Trifesti",1376,642,637,5,0,635,7,1500,858,279,356,3,9844,0
24,"Iasi",99600,225,99600,,"TRIFESTI",756,"Scoala generala Zaboloteni",551,337,330,7,0,331,6,600,263,119,212,3,9844,0
24,"Iasi",99600,225,99600,,"TRIFESTI",757,"Scoala generala Hermeziu",727,441,434,7,0,434,7,800,359,241,193,3,9844,0
24,"Iasi",99600,225,99600,,"TRIFESTI",758,"Scoala generala Vladomira",204,127,120,7,0,126,1,298,171,57,69,3,9844,0
24,"Iasi",99600,225,99600,,"TRIFESTI",759,"Gradinita de copii Trifesti",0,78,0,78,0,78,0,199,121,45,33,3,9844,1
24,"Iasi",99673,225,99673,,"TIBANA",760,"Scoala generala de zece ani Tibana",1106,481,476,5,0,476,5,1200,719,235,241,3,9810,0
24,"Iasi",99673,225,99673,,"TIBANA",761,"Scoala generala de opt ani Alexeni",587,327,319,8,0,316,11,700,373,141,175,3,9810,0
24,"Iasi",99673,225,99673,,"TIBANA",762,"Scoala generala de patru ani Poiana de Sus",413,208,203,5,0,207,1,500,292,126,81,3,9810,0
24,"Iasi",99673,225,99673,,"TIBANA",763,"Scoala generala de opt ani Domnita",883,432,424,8,0,426,6,1000,568,156,270,3,9810,0
24,"Iasi",99673,225,99673,,"TIBANA",764,"Scoala generala de opt ani Runcu",366,209,197,12,0,206,3,400,191,63,143,3,9810,0
24,"Iasi",99673,225,99673,,"TIBANA",765,"Scoala generala Vadu Vejei",187,123,114,9,0,121,2,300,177,46,75,3,9810,0
24,"Iasi",99673,225,99673,,"TIBANA",766,"Scoala generala de opt ani Garbesti",754,371,354,17,0,367,4,800,429,145,222,3,9810,0
24,"Iasi",99673,225,99673,,"TIBANA",767,"Scoala generala de patru ani Garbesti",826,357,343,14,0,352,5,900,543,125,227,3,9810,0
24,"Iasi",99673,225,99673,,"TIBANA",768,"Scoala generala de zece ani Tibana",0,69,0,69,0,69,0,200,131,25,44,3,9810,1
24,"Iasi",99780,225,99780,,"TIBANESTI",769,"Grupul Scolar D.D.Carp Tibanesti",861,420,407,12,1,410,10,900,480,172,238,3,9821,0
24,"Iasi",99780,225,99780,,"TIBANESTI",770,"Grupul Scolar D.D.Carp Tibanesti",867,423,411,12,0,413,10,1000,577,210,203,3,9821,0
24,"Iasi",99780,225,99780,,"TIBANESTI",771,"Scoala generala Rasboieni",694,328,318,5,5,326,2,800,472,125,201,3,9821,0
24,"Iasi",99780,225,99780,,"TIBANESTI",772,"Gradinita de copii Glodenii Gandului",901,428,417,11,0,424,4,1000,572,239,185,3,9821,0
24,"Iasi",99780,225,99780,,"TIBANESTI",773,"Gradinita de copii Glodenii Gandului",826,393,388,5,0,386,7,900,507,216,170,3,9821,0
24,"Iasi",99780,225,99780,,"TIBANESTI",774,"Scoala generala Jigoreni",548,312,301,5,6,308,4,600,288,128,180,3,9821,0
24,"Iasi",99780,225,99780,,"TIBANESTI",775,"Scoala generala Valenii",230,145,137,8,0,141,4,300,155,37,104,3,9821,0
24,"Iasi",99780,225,99780,,"TIBANESTI",776,"Scoala generala Tungujei",516,275,268,6,1,271,4,600,325,70,201,3,9821,0
24,"Iasi",99780,225,99780,,"TIBANESTI",777,"Scoala generala Recea",146,92,80,12,0,91,1,200,108,18,73,3,9821,0
24,"Iasi",99780,225,99780,,"TIBANESTI",778,"Scoala generala Griesti",212,115,109,6,0,114,1,300,185,34,80,3,9821,0
24,"Iasi",99780,225,99780,,"TIBANESTI",779,"Gradinita Tibanesti",0,99,0,99,0,99,0,200,101,51,48,3,9821,1
24,"Iasi",99879,225,99879,,"TIGANASI",780,"Scoala generala Tiganasi",1069,560,543,17,0,551,9,1196,636,217,334,3,9830,0
24,"Iasi",99879,225,99879,,"TIGANASI",781,"Scoala generala Mihail Kogalniceanu",902,441,433,8,0,437,4,1000,559,155,282,3,9830,0
24,"Iasi",99879,225,99879,,"TIGANASI",782,"Scoala generala Carniceni",1166,597,588,9,0,589,8,1300,703,233,356,3,9830,0
24,"Iasi",99879,225,99879,,"TIGANASI",783,"Scoala generala Stejarii",266,151,143,8,0,149,2,300,149,68,81,3,9830,0
24,"Iasi",99879,225,99879,,"TIGANASI",784,"Scoala de Arte si Meserii Tiganasi",0,90,0,90,0,90,0,200,110,42,48,3,9830,1
24,"Iasi",99922,225,99922,,"TUTORA",785,"Scoala de Arte si Meserii Tutora",1746,897,890,7,0,883,14,1800,903,417,466,3,9849,0
24,"Iasi",99922,225,99922,,"TUTORA",786,"Scoala generala Tutora",0,174,0,174,0,174,0,200,26,108,66,3,9849,1
24,"Iasi",96003,225,96003,,"UNGHENI",787,"Scoala generala cu clasele I-VIII Bosia",875,434,430,4,0,424,10,1000,566,234,190,3,9853,0
24,"Iasi",96003,225,96003,,"UNGHENI",788,"Scoala generala cu clasele I-VIII Bosia",743,381,378,3,0,375,6,800,419,193,182,3,9853,0
24,"Iasi",96003,225,96003,,"UNGHENI",789,"Scoala generala cu clasele I-IV Coada Stancii",482,255,248,7,0,254,1,600,345,130,124,3,9853,0
24,"Iasi",96003,225,96003,,"UNGHENI",790,"Scoala generala cu clasele I-IV Manzatesti",771,378,371,7,0,375,3,800,422,173,202,3,9853,0
24,"Iasi",96003,225,96003,,"UNGHENI",791,"Scoala generala cu clasele I-IV Ungheni",528,306,299,7,0,300,6,600,294,179,121,3,9853,0
24,"Iasi",96003,225,96003,,"UNGHENI",792,"Scoala generala cu clasele I-VIII Bosia",0,80,0,80,0,80,0,199,119,53,27,3,9853,1
24,"Iasi",100353,225,100353,,"VALEA LUPULUI",793,"Scoala generala Valea Lupului",1167,692,692,0,0,685,7,1300,608,326,359,3,9858,0
24,"Iasi",100353,225,100353,,"VALEA LUPULUI",794,"Scoala generala Valea Lupului",1257,701,701,0,0,694,7,1400,699,348,346,3,9858,0
24,"Iasi",100353,225,100353,,"VALEA LUPULUI",795,"Scoala generala Valea Lupului",1004,583,583,0,0,578,5,1103,520,281,297,3,9858,0
24,"Iasi",100353,225,100353,,"VALEA LUPULUI",796,"Scoala generala Valea Lupului",0,167,0,167,0,165,2,198,31,93,72,3,9858,1
24,"Iasi",99968,225,99968,,"VALEA SEACA",797,"Scoala generala Valea-Seaca",1562,715,708,7,0,706,9,1700,985,194,512,3,9860,0
24,"Iasi",99968,225,99968,,"VALEA SEACA",798,"Scoala generala Contesti",1392,672,655,17,0,669,3,1493,821,292,377,3,9860,0
24,"Iasi",99968,225,99968,,"VALEA SEACA",799,"Scoala generala Topile",1752,893,885,8,0,884,9,1900,1007,193,691,3,9860,0
24,"Iasi",99968,225,99968,,"VALEA SEACA",800,"Scoala de Arte si Meserii Valea Seaca",0,52,0,52,0,52,0,199,147,26,26,3,9860,1
24,"Iasi",100086,225,100086,,"VANATORI",801,"Caminul Cultural Vanatori",962,514,507,7,0,506,8,1100,586,197,309,3,9864,0
24,"Iasi",100086,225,100086,,"VANATORI",802,"Scoala generala cu clasele I-VIII Crivesti",1221,685,675,10,0,672,13,1300,615,319,353,3,9864,0
24,"Iasi",100086,225,100086,,"VANATORI",803,"Scoala generala cu clasele I-IV Gura-Badilitei",505,278,268,10,0,275,3,600,322,101,174,3,9864,0
24,"Iasi",100086,225,100086,,"VANATORI",804,"Scoala generala cu clasele I-VIII Hartoape",982,485,471,14,0,484,1,1100,615,164,320,3,9864,0
24,"Iasi",100086,225,100086,,"VANATORI",805,"Caminul Cultural Vanatori",0,65,0,65,0,65,0,198,133,28,37,3,9864,1
24,"Iasi",100004,225,100004,,"VICTORIA",806,"Scoala generala Victoria",1246,585,574,11,0,575,10,1300,715,132,443,3,9870,0
24,"Iasi",100004,225,100004,,"VICTORIA",807,"Scoala generala Frasuleni",270,150,140,10,0,150,0,300,150,57,93,3,9870,0
24,"Iasi",100004,225,100004,,"VICTORIA",808,"Scoala generala Icuseni",417,218,195,23,0,211,7,500,282,61,150,3,9870,0
24,"Iasi",100004,225,100004,,"VICTORIA",809,"Scoala I-IV Luceni",452,242,229,13,0,238,4,493,251,44,194,3,9870,0
24,"Iasi",100004,225,100004,,"VICTORIA",810,"Scoala generala Sculeni",280,159,149,10,0,155,4,300,141,76,79,3,9870,0
24,"Iasi",100004,225,100004,,"VICTORIA",811,"Gradinita Victoria",422,191,185,6,0,189,2,500,309,87,102,3,9870,0
24,"Iasi",100004,225,100004,,"VICTORIA",812,"Scoala generala Sendreni",230,130,116,14,0,129,1,300,170,61,68,3,9870,0
24,"Iasi",100004,225,100004,,"VICTORIA",813,"Punctul Vamal Sculeni",0,173,0,173,0,171,2,200,27,90,81,3,9870,1
24,"Iasi",100148,225,100148,,"VLADENI",814,"Grupul Scolar  Vladeni",1525,689,675,12,2,678,11,1600,911,287,391,3,9878,0
24,"Iasi",100148,225,100148,,"VLADENI",815,"Scoala generala cu clasele I-VIII Borsa",1035,490,483,7,0,482,8,1089,599,156,326,3,9878,0
24,"Iasi",100148,225,100148,,"VLADENI",816,"Scoala I-IV Iacobeni",212,112,102,10,0,109,3,299,187,38,71,3,9878,0
24,"Iasi",100148,225,100148,,"VLADENI",817,"Scoala I-IV Alexandru cel Bun",427,217,206,11,0,214,3,497,280,81,133,3,9878,0
24,"Iasi",100148,225,100148,,"VLADENI",818,"Scoala generala Brosteni",309,162,152,10,0,158,4,394,232,51,107,3,9878,0
24,"Iasi",100148,225,100148,,"VLADENI",819,"Grupul Scolar  Vladeni",0,91,0,91,0,91,0,200,109,52,39,3,9878,1
24,"Iasi",100219,225,100219,,"VOINESTI",820,"Scoala generala Voinesti, Corp B",1027,506,494,12,0,499,7,1100,594,206,293,3,9885,0
24,"Iasi",100219,225,100219,,"VOINESTI",821,"Scoala generala Voinesti, Corp B",703,344,339,5,0,340,4,800,456,142,198,3,9885,0
24,"Iasi",100219,225,100219,,"VOINESTI",822,"Scoala generala Voinesti, Corp B",889,417,409,8,0,411,6,1000,583,188,223,3,9885,0
24,"Iasi",100219,225,100219,,"VOINESTI",823,"Scoala generala Slobozia, Corp A",605,301,290,11,0,285,16,695,394,158,127,3,9885,0
24,"Iasi",100219,225,100219,,"VOINESTI",824,"Scoala generala Slobozia, Corp A",604,300,287,13,0,290,10,700,400,141,149,3,9885,0
24,"Iasi",100219,225,100219,,"VOINESTI",825,"Scoala generala Lungani",429,252,243,9,0,248,4,500,248,127,121,3,9885,0
24,"Iasi",100219,225,100219,,"VOINESTI",826,"Scoala generala Schitu-Stavnic",400,219,210,9,0,218,1,494,275,93,125,3,9885,0
24,"Iasi",100219,225,100219,,"VOINESTI",827,"Sala Gheorghita Petre Vocotesti",125,96,85,10,1,94,2,200,104,38,56,3,9885,0
24,"Iasi",100219,225,100219,,"VOINESTI",828,"Scoala generala Voinesti",0,146,0,146,0,143,3,200,54,91,52,3,9885,1
25,"Ilfov",179221,234,179221,,"ORAS BRAGADIRU",1,"SCOALA GENERALA NR. 1, SOS. ALEXANDRIEI, NR. 243 A",1666,988,979,9,0,968,20,1801,813,601,367,1,9892,0
25,"Ilfov",179221,234,179221,,"ORAS BRAGADIRU",2,"SCOALA GENERALA NR. 1, SOS. ALEXANDRIEI, NR. 243 A",1545,990,975,15,0,969,21,1699,709,627,342,1,9892,0
25,"Ilfov",179221,234,179221,,"ORAS BRAGADIRU",3,"SCOALA GENERALA NR. 1, SOS. ALEXANDRIEI, NR. 243 A",1727,1071,1056,15,0,1055,16,1899,828,688,367,1,9892,0
25,"Ilfov",179221,234,179221,,"ORAS BRAGADIRU",4,"SCOALA GENERALA NR. 1, SOS. ALEXANDRIEI, NR. 243 A",1734,1081,1063,18,0,1067,14,1900,819,656,411,1,9892,0
25,"Ilfov",179221,234,179221,,"ORAS BRAGADIRU",5,"SCOALA GENERALA NR. 1, SOS. ALEXANDRIEI, NR. 243 A",1693,1025,1004,21,0,1012,13,1900,875,683,329,1,9892,0
25,"Ilfov",179221,234,179221,,"ORAS BRAGADIRU",6,"SCOALA GENERALA NR. 1, SOS. ALEXANDRIEI, NR. 243 A, CP077025",0,900,0,900,0,895,5,900,0,516,379,1,9892,1
25,"Ilfov",100576,234,100576,,"ORAS BUFTEA",7,"SCOALA GENERALA NR. 1 BUFTEA, ALEEA SCOLII NR. 2",1780,882,842,40,0,872,10,1950,1068,466,406,1,9894,0
25,"Ilfov",100576,234,100576,,"ORAS BUFTEA",8,"SCOALA GENERALA NR. 1 BUFTEA, ALEEA SCOLII NR. 2, CARTIER C.P.C.",1927,1065,1038,27,0,1045,20,2100,1035,539,506,1,9894,0
25,"Ilfov",100576,234,100576,,"ORAS BUFTEA",9,"SCOALA GENERALA NR. 1 BUFTEA, ALEEA SCOLII NR. 2, CARTIER C.P.C.",1830,879,866,13,0,863,16,2000,1121,492,371,1,9894,0
25,"Ilfov",100576,234,100576,,"ORAS BUFTEA",10,"GRUPUL SCOLAR DUMITRU DUMITRESCU (LICEUL ENERGETIC), SOS. BUCURESTI-TARGOVISTE, NR. 135",2013,1184,1096,87,1,1156,28,2200,1016,735,421,1,9894,0
25,"Ilfov",100576,234,100576,,"ORAS BUFTEA",11,"SCOALA GENERALA NR. 2 BUFTEA, STR. STIRBEI VODA, NR. 22",1929,1024,1015,7,2,1009,15,2100,1076,544,465,1,9894,0
25,"Ilfov",100576,234,100576,,"ORAS BUFTEA",12,"SCOALA GENERALA NR. 2 BUFTEA, STR. STIRBEI VODA, NR. 22",1939,1144,1127,17,0,1135,9,2100,956,568,567,1,9894,0
25,"Ilfov",100576,234,100576,,"ORAS BUFTEA",13,"SCOALA GENERALA NR. 2 BUFTEA, STR. STIRBEI VODA, NR. 22",1892,1141,1115,25,1,1122,19,2100,959,594,528,1,9894,0
25,"Ilfov",100576,234,100576,,"ORAS BUFTEA",14,"SCOALA NR. 4 BUCIUMENI, STR. AGRICULTORI, NR. 116",845,634,618,16,0,627,7,900,266,436,191,1,9894,0
25,"Ilfov",100576,234,100576,,"ORAS BUFTEA",15,"LOCALUL DIN SOSEAUA BUCURESTI-TARGOVISTE, NR. 14, BUCIUMENI (FOST SEDIU C.A.P.)",1199,892,812,80,0,877,15,1300,408,629,248,1,9894,0
25,"Ilfov",100576,234,100576,,"ORAS BUFTEA",16,"GRADINITA BUCOVENI, STR. INDEPENDENTEI, NR. 64",1609,981,944,37,0,973,8,1800,819,490,483,1,9894,0
25,"Ilfov",100576,234,100576,,"ORAS BUFTEA",17,"STR. RASARITULUI, NR. 11-VIS A VIS DE GARA SABARENI",391,183,169,14,0,177,6,450,267,125,52,1,9894,0
25,"Ilfov",100576,234,100576,,"ORAS BUFTEA",18,"SCOALA GENERALA NR. 2 BUFTEA, STR. STIRBEI VODA, NR. 22, CP 070000",0,716,0,716,0,714,2,1000,284,416,298,1,9894,1
25,"Ilfov",179285,234,179285,,"ORAS CHITILA",19,"GRADINITA NR. 1, SOS. BANATULUI, NR. 2, CHITILA",1362,818,800,18,0,805,13,1490,672,351,454,1,9897,0
25,"Ilfov",179285,234,179285,,"ORAS CHITILA",20,"SCOALA GENERALA NR. 1, SOS. BANATULUI, NR. 85, CHITILA",1594,966,953,13,0,954,12,1750,784,460,494,1,9897,0
25,"Ilfov",179285,234,179285,,"ORAS CHITILA",21,"SCOALA GENERALA NR. 1, SOS. BANATULUI, NR. 85, CHITILA",1105,718,687,31,0,706,12,1197,479,337,369,1,9897,0
25,"Ilfov",179285,234,179285,,"ORAS CHITILA",22,"CASA DE CULTURA ""TUDOR ARGHEZI"", SOS. BANATULUI NR. 46, CHITILA",1846,1221,1204,17,0,1197,24,2000,779,617,580,1,9897,0
25,"Ilfov",179285,234,179285,,"ORAS CHITILA",23,"CASA DE CULTURA ""TUDOR ARGHEZI"", SOS. BANATULUI NR. 46, CHITILA",1920,1186,1155,31,0,1153,33,2100,914,639,514,1,9897,0
25,"Ilfov",179285,234,179285,,"ORAS CHITILA",24,"SCOALA CARTIER, STR. SCOLII, NR. 36, CHITILA",1986,1008,989,19,0,992,16,2200,1192,501,491,1,9897,0
25,"Ilfov",179285,234,179285,,"ORAS CHITILA",25,"SCOALA RUDENI, STR. PANDURI, NR. 2, SAT RUDENI",1031,517,494,23,0,509,8,1097,580,251,258,1,9897,0
25,"Ilfov",179285,234,179285,,"ORAS CHITILA",26,"SCOALA NR.1 SECTIA CLS.I-IV SI GRUPA DE PRESCOLARI RUDENI-CHITILA, SAT RUDENI,STR. PANDURI, NR. 2, CP 077046",0,609,0,609,0,605,4,700,91,358,247,1,9897,1
25,"Ilfov",179409,234,179409,,"ORAS MAGURELE",27,"LOCALUL SECTIEI CU GRUPE DE PRESCOLARI MAGURELE A LICEULUI ""HORIA HULUBEI"", STR. CALUGARENI, NR.8, SAT MAGURELE",1276,826,815,11,0,803,23,1400,574,487,316,1,9900,0
25,"Ilfov",179409,234,179409,,"ORAS MAGURELE",28,"LICEUL CU CLS I-XII ""HORIA HULUBEI"", STR. FIZICIENILOR, NR. 42, SAT MAGURELE",1014,678,665,13,0,668,10,1100,422,334,334,1,9900,0
25,"Ilfov",179409,234,179409,,"ORAS MAGURELE",29,"PRIMARIA ORASULUI MAGURELE, STR. CALUGARENI, NR. 2-4, SAT MAGURELE",904,656,644,12,0,644,12,1000,344,337,307,1,9900,0
25,"Ilfov",179409,234,179409,,"ORAS MAGURELE",30,"PRIMARIA ORASULUI MAGURELE, STR. CALUGARENI, NR. 2-4, SAT MAGURELE",785,489,462,27,0,486,3,900,411,253,233,1,9900,0
25,"Ilfov",179409,234,179409,,"ORAS MAGURELE",31,"LOCALUL FOSTEI GRADINITE ALUNIS, STR. ALUNIS, NR. 169, SAT ALUNISU",1054,719,700,19,0,711,8,1199,480,438,273,1,9900,0
25,"Ilfov",179409,234,179409,,"ORAS MAGURELE",32,"LOCALUL SECTIEI CU CLS I-IV VARTEJU A LICEULUI TEORETIC CU CLS I-XII ""HORIA HULUBEI"", STR. CHIRCA, NR. 1, SAT VARTEJU",782,601,575,26,0,588,13,900,299,319,269,1,9900,0
25,"Ilfov",179409,234,179409,,"ORAS MAGURELE",33,"LOCALUL SECTIEI CU GRUPE DE PRESCOLARI VARTEJU A LICEULUI ""HORIA HULUBEI"", STR. BUCURESTI, NR.4, SAT VARTEJU",878,595,579,16,0,576,19,1001,406,319,257,1,9900,0
25,"Ilfov",179409,234,179409,,"ORAS MAGURELE",34,"LOCALUL SECTIEI CU CLS I-IV DUMITRANA A LICEULUI ""HORIA HULUBEI"", STR. DUZILOR, NR. 131, SAT DUMITRANA",698,526,512,14,0,512,14,800,274,325,187,1,9900,0
25,"Ilfov",179409,234,179409,,"ORAS MAGURELE",35,"FACULTATEA DE FIZICA A UNIVERSITATII BUCURESTI, STR.ATOMISTILOR,NR.405,CP 077125",0,998,0,998,0,981,17,1000,2,618,363,1,9900,1
25,"Ilfov",179481,234,179481,,"ORAS OTOPENI",36,"SCOALA GENERALA NR. 3, STR. SCOLII, NR. 6",1127,691,672,19,0,686,5,1197,506,351,335,1,9906,0
25,"Ilfov",179481,234,179481,,"ORAS OTOPENI",37,"LICEUL TEORETIC ""IOAN PETRUS"", STR. 23 AUGUST, NR. 6",1299,762,743,19,0,749,13,1400,638,415,334,1,9906,0
25,"Ilfov",179481,234,179481,,"ORAS OTOPENI",38,"LICEUL TEORETIC ""IOAN PETRUS"", STR. 23 AUGUST, NR. 6",1399,816,806,10,0,809,7,1500,684,472,337,1,9906,0
25,"Ilfov",179481,234,179481,,"ORAS OTOPENI",39,"LICEUL TEORETIC ""IOAN PETRUS"", STR. 23 AUGUST, NR. 6",1508,868,852,16,0,854,14,1650,782,512,342,1,9906,0
25,"Ilfov",179481,234,179481,,"ORAS OTOPENI",40,"CONSILIUL LOCAL AL ORASULUI OTOPENI, STR. 23 AUGUST, NR. 10",1751,1001,982,19,0,990,11,1900,899,582,408,1,9906,0
25,"Ilfov",179481,234,179481,,"ORAS OTOPENI",41,"SCOALA GENERALA NR. 2, STR. 23 AUGUST, NR. 99",1247,673,648,25,0,666,7,1400,727,370,296,1,9906,0
25,"Ilfov",179481,234,179481,,"ORAS OTOPENI",42,"LICEUL TEORETIC ""IOAN PETRUS"", STR. 23 AUGUST, NR. 6",886,493,469,24,0,488,5,1000,507,257,231,1,9906,0
25,"Ilfov",179481,234,179481,,"ORAS OTOPENI",43,"INSTITUTUL NATIONAL DE GERIATRIE SI GERONTOLOGIE, STR. CALEA BUCURESTILOR, NR. 307",631,399,382,17,0,399,0,700,301,220,179,1,9906,0
25,"Ilfov",179481,234,179481,,"ORAS OTOPENI",44,"AEROPORTUL INTERNATIONAL ""HENRI COANDA"" BUCURESTI-OTOPENI, TERMINAL INTERNATIONAL, CAL.BUCURESTILOR,NR.224E,CP 075100",0,1400,0,1400,0,1387,13,1401,1,818,569,1,9906,1
25,"Ilfov",179515,234,179515,,"ORAS PANTELIMON",45,"SCOALA GENERALA NR. 1, STR. MIORITEI, NR. 24 A",1277,776,752,24,0,766,10,1400,624,426,340,1,9909,0
25,"Ilfov",179515,234,179515,,"ORAS PANTELIMON",46,"SCOALA GENERALA NR. 1, STR. MIORITEI, NR. 24 A",1497,859,818,41,0,850,9,1650,791,502,348,1,9909,0
25,"Ilfov",179515,234,179515,,"ORAS PANTELIMON",47,"SCOALA GENERALA NR. 1, STR. MIORITEI, NR. 24 A",1643,1012,976,36,0,998,14,1800,788,682,316,1,9909,0
25,"Ilfov",179515,234,179515,,"ORAS PANTELIMON",48,"SCOALA GENERALA NR. 1, STR. MIORITEI, NR. 24 A",1131,708,690,18,0,682,26,1197,489,475,207,1,9909,0
25,"Ilfov",179515,234,179515,,"ORAS PANTELIMON",49,"SCOALA GENERALA NR. 1, STR. MIORITEI, NR. 24 A",1132,654,634,20,0,639,15,1250,596,375,264,1,9909,0
25,"Ilfov",179515,234,179515,,"ORAS PANTELIMON",50,"SCOALA GENERALA NR. 1, STR. MIORITEI, NR. 24 A",1239,606,586,20,0,596,10,1400,794,372,224,1,9909,0
25,"Ilfov",179515,234,179515,,"ORAS PANTELIMON",51,"SCOALA GENERALA NR. 1, B-DUL BIRUINTEI, NR. 70",1412,908,882,26,0,894,14,1550,642,530,364,1,9909,0
25,"Ilfov",179515,234,179515,,"ORAS PANTELIMON",52,"SCOALA GENERALA NR. 1, B-DUL BIRUINTEI, NR. 70",1035,672,654,18,0,666,6,1099,427,343,323,1,9909,0
25,"Ilfov",179515,234,179515,,"ORAS PANTELIMON",53,"SCOALA GENERALA NR. 1, B-DUL BIRUINTEI, NR. 70",1109,676,634,42,0,658,18,1197,521,381,277,1,9909,0
25,"Ilfov",179515,234,179515,,"ORAS PANTELIMON",54,"GRADINITA DE COPII  NR. 1, B-DUL BIRUINTEI, NR. 36",1230,799,769,30,0,787,12,1300,501,415,372,1,9909,0
25,"Ilfov",179515,234,179515,,"ORAS PANTELIMON",55,"GRADINITA DE COPII  NR. 1, B-DUL BIRUINTEI, NR. 36",1001,636,621,15,0,621,15,1100,464,348,273,1,9909,0
25,"Ilfov",179515,234,179515,,"ORAS PANTELIMON",56,"GRADINITA DE COPII  NR. 1, B-DUL BIRUINTEI, NR. 36",1009,650,632,18,0,635,15,1100,450,371,264,1,9909,0
25,"Ilfov",179515,234,179515,,"ORAS PANTELIMON",57,"GRADINITA DE COPII  NR. 1, B-DUL BIRUINTEI, NR. 36",1304,830,793,37,0,812,18,1400,570,477,335,1,9909,0
25,"Ilfov",179515,234,179515,,"ORAS PANTELIMON",58,"GRADINITA DE COPII  NR. 1, B-DUL BIRUINTEI, NR. 36",1010,583,561,22,0,568,15,1099,516,301,267,1,9909,0
25,"Ilfov",179515,234,179515,,"ORAS PANTELIMON",59,"SCOALA GENERALA NR. 1, B-DUL BIRUINTEI, NR. 70, CP 077145",0,900,0,900,0,888,12,900,0,566,322,1,9909,1
25,"Ilfov",179533,234,179533,,"ORAS POPESTI LEORDENI",60,"FUNDATIA ""LEONARDO MURIALDO"", STR. SFANTUL LEONARDO MURIALDO, NR. 1, ORASUL POPESTI LEORDENI",1353,680,637,43,0,666,14,1500,820,348,318,1,9911,0
25,"Ilfov",179533,234,179533,,"ORAS POPESTI LEORDENI",61,"SCOALA GENERALA NR. 2, STR. SCOLII, NR. 6",1274,839,806,33,0,831,8,1400,561,387,444,1,9911,0
25,"Ilfov",179533,234,179533,,"ORAS POPESTI LEORDENI",62,"SCOALA GENERALA NR. 2, STR. SCOLII, NR. 6",1301,844,835,9,0,834,10,1401,557,429,405,1,9911,0
25,"Ilfov",179533,234,179533,,"ORAS POPESTI LEORDENI",63,"CAMINUL CULTURAL, SOS. OLTENITEI, NR. 64",1170,777,638,139,0,770,7,1300,523,436,334,1,9911,0
25,"Ilfov",179533,234,179533,,"ORAS POPESTI LEORDENI",64,"SCOALA GENERALA NR. 1, STR. LEORDENI, NR. 52",1338,789,769,20,0,777,12,1500,711,372,405,1,9911,0
25,"Ilfov",179533,234,179533,,"ORAS POPESTI LEORDENI",65,"SCOALA GENERALA NR. 1, STR. LEORDENI, NR. 52",1881,1114,1086,28,0,1093,21,2100,986,569,524,1,9911,0
25,"Ilfov",179533,234,179533,,"ORAS POPESTI LEORDENI",66,"SCOALA GENERALA NR. 4, STR. UNIRII, NR. 21",1325,816,790,24,2,805,11,1450,634,368,437,1,9911,0
25,"Ilfov",179533,234,179533,,"ORAS POPESTI LEORDENI",67,"SCOALA GENERALA NR. 3, STR. DOMNITA BALASA, NR. 13",1206,815,777,38,0,811,4,1300,485,369,442,1,9911,0
25,"Ilfov",179533,234,179533,,"ORAS POPESTI LEORDENI",68,"SCOALA GENERALA NR. 3, STR. DOMNITA BALASA, NR. 13",1198,598,575,23,0,588,10,1300,702,295,293,1,9911,0
25,"Ilfov",179533,234,179533,,"ORAS POPESTI LEORDENI",69,"BLOC C1F, SOS. OLTENITEI, NR. 181",1591,906,888,18,0,901,5,1700,794,497,404,1,9911,0
25,"Ilfov",179533,234,179533,,"ORAS POPESTI LEORDENI",70,"AGROPOL POPESTI-LEORDENI SA, SOS. OLTENITEI, NR. 216",432,236,226,10,0,235,1,500,264,141,94,1,9911,0
25,"Ilfov",179533,234,179533,,"ORAS POPESTI LEORDENI",71,"FUNDATIA ""LEONARDO MURIALDO"", STR. SFANTUL LEONARDO MURIALDO, NR. 1, CP 077160",0,1058,0,1058,0,1039,19,1100,42,420,619,1,9911,1
25,"Ilfov",179551,234,179551,,"ORAS VOLUNTARI",72,"SALA DE SPORT, STR. TUDOR VLADIMIRESCU, NR. 40",1665,933,908,25,0,925,8,1800,867,402,523,1,9913,0
25,"Ilfov",179551,234,179551,,"ORAS VOLUNTARI",73,"SCOALA GENERALA NR. 42, B-DUL TUDOR VLADIMIRESCU, NR. 38",1752,994,973,21,0,982,12,1900,906,433,549,1,9913,0
25,"Ilfov",179551,234,179551,,"ORAS VOLUNTARI",74,"SCOALA GENERALA NR. 42, B-DUL TUDOR VLADIMIRESCU, NR. 37",1841,1038,1011,27,0,1016,22,2000,962,448,568,1,9913,0
25,"Ilfov",179551,234,179551,,"ORAS VOLUNTARI",75,"CAMINUL CULTURAL, B-DUL TUDOR VLADIMIRESCU, NR. 42",1560,764,749,15,0,752,12,1700,936,314,438,1,9913,0
25,"Ilfov",179551,234,179551,,"ORAS VOLUNTARI",76,"SCOALA GENERALA NR. 42, STR. ANTON PANN, NR. 7",1485,844,827,16,1,829,15,1600,756,360,469,1,9913,0
25,"Ilfov",179551,234,179551,,"ORAS VOLUNTARI",77,"SCOALA GENERALA NR. 42, STR. ANTON PANN, NR. 7",1734,1025,1004,21,0,1005,20,1900,875,447,558,1,9913,0
25,"Ilfov",179551,234,179551,,"ORAS VOLUNTARI",78,"SCOALA GENERALA NR. 42, STR. ANTON PANN, NR. 7",1605,888,871,17,0,873,15,1800,912,376,497,1,9913,0
25,"Ilfov",179551,234,179551,,"ORAS VOLUNTARI",79,"SCOALA GENERALA NR. 43, B-DUL DUNARII, NR. 43",1915,1138,1117,21,0,1117,21,2100,962,485,632,1,9913,0
25,"Ilfov",179551,234,179551,,"ORAS VOLUNTARI",80,"SCOALA GENERALA NR. 43, B-DUL DUNARII, NR. 43",1513,892,875,17,0,869,23,1700,808,342,527,1,9913,0
25,"Ilfov",179551,234,179551,,"ORAS VOLUNTARI",81,"SCOALA GENERALA NR. 43, B-DUL DUNARII, NR. 43",1515,900,880,20,0,885,15,1700,800,399,486,1,9913,0
25,"Ilfov",179551,234,179551,,"ORAS VOLUNTARI",82,"FOSTUL SEDIU AL PRIMARIEI VOLUNTARI, B-DUL DUNARII, NR. 71",1593,999,979,19,1,976,23,1750,751,434,542,1,9913,0
25,"Ilfov",179551,234,179551,,"ORAS VOLUNTARI",83,"PRIMARIA VOLUNTARI, SOS. AFUMATI, NR. 74",1491,914,900,14,0,899,15,1601,687,438,461,1,9913,0
25,"Ilfov",179551,234,179551,,"ORAS VOLUNTARI",84,"SCOALA GENERALA NR. 42, B-DUL NICOLAE BALCESCU, NR. 38",1910,1100,1076,24,0,1084,16,2100,1000,494,590,1,9913,0
25,"Ilfov",179551,234,179551,,"ORAS VOLUNTARI",85,"SCOALA GENERALA NR. 42, B-DUL NICOLAE BALCESCU, NR. 38",1678,980,960,20,0,964,16,1800,820,472,492,1,9913,0
25,"Ilfov",179551,234,179551,,"ORAS VOLUNTARI",86,"SCOALA GENERALA NR. 3 (PIPERA), STR. SERBAN ION, NR. 1",1700,984,963,21,0,978,6,1898,914,483,495,1,9913,0
25,"Ilfov",179551,234,179551,,"ORAS VOLUNTARI",87,"SCOALA GENERALA NR. 3 (PIPERA), STR. SERBAN ION, NR. 1",1373,745,712,33,0,741,4,1489,744,361,380,1,9913,0
25,"Ilfov",179551,234,179551,,"ORAS VOLUNTARI",88,"SCOALA GENERALA NR. 3 (PIPERA), STR. SERBAN ION, NR. 1",2230,1329,1292,37,0,1317,12,2450,1121,667,650,1,9913,0
25,"Ilfov",179551,234,179551,,"ORAS VOLUNTARI",89,"CENTRUL COMERCIAL ""JOLIE VILLE"",STR.EROU IANCU NICOLAE,NR.103, CP 077190",0,1192,0,1192,0,1176,16,1197,5,636,540,1,9913,1
25,"Ilfov",179551,234,179551,,"ORAS VOLUNTARI",90,"GRADINITA CU PROGRAM NORMAL NR.1,VOLUNTARI,STR.BUZIAS,NR.5, CP 077190",0,796,0,796,0,791,5,798,2,391,400,1,9913,1
25,"Ilfov",102543,234,102543,,"1 DECEMBRIE",91,"SCOALA NR. 1, CORP A, STR. SOS. GIURGIULUI, NR. 220",1569,786,717,69,0,781,5,1700,914,384,397,3,9915,0
25,"Ilfov",102543,234,102543,,"1 DECEMBRIE",92,"SCOALA NR. 1, CORP A, STR. SOS. GIURGIULUI, NR. 220",1345,506,462,44,0,502,4,1500,994,294,208,3,9915,0
25,"Ilfov",102543,234,102543,,"1 DECEMBRIE",93,"SCOALA NR. 1, CORP B, STR. 8 MARTIE, NR. 12",1547,689,636,53,0,683,6,1700,1011,353,330,3,9915,0
25,"Ilfov",102543,234,102543,,"1 DECEMBRIE",94,"SCOALA NR. 1, CORP B, STR. 8 MARTIE, NR. 12",1300,514,455,59,0,506,8,1450,936,247,259,3,9915,0
25,"Ilfov",102543,234,102543,,"1 DECEMBRIE",95,"SCOALA CU CLS.I-VIII, NR. 1, CORP A, SOS. GIURGIULUI, NR. 220, CP 070005",0,371,0,371,0,370,1,400,29,180,190,3,9915,1
25,"Ilfov",100834,234,100834,,"AFUMATI",96,"SCOALA GENERALA NR. 1, SOS. BUCURESTI-URZICENI, NR. 130",1585,927,866,61,0,914,13,1700,773,440,474,3,9917,0
25,"Ilfov",100834,234,100834,,"AFUMATI",97,"SCOALA GENERALA NR. 1, CLS. V-VIII, SOS. PETRACHIOAIA, NR. 10",1244,657,628,29,0,647,10,1390,733,361,286,3,9917,0
25,"Ilfov",100834,234,100834,,"AFUMATI",98,"SCOALA GENERALA NR. 3,  CLS I-IV, SOS BUCURESTI - URZICENI, NR. 228 (OGRADA SINDRILITA)",1400,843,789,54,0,826,17,1490,647,382,444,3,9917,0
25,"Ilfov",100834,234,100834,,"AFUMATI",99,"SCOALA GENERALA NR. 2, CLS I-IV, STR. SCOLII, NR. 35 (OGRADA STEFANESTI)",1387,825,749,75,1,807,18,1500,675,431,376,3,9917,0
25,"Ilfov",100834,234,100834,,"AFUMATI",100,"BIBLIOTECA COMUNALA AFUMATI,SOS.BUCURESTI-URZICENI,NR.130, CP 077010",0,500,0,500,0,488,12,500,0,258,230,3,9917,1
25,"Ilfov",100969,234,100969,,"BALOTESTI",101,"SCOALA NR. 1 BALOTESTI, SAT BALOTESTI, SOS. UNIRII, NR. 6",2065,1170,1142,28,0,1157,13,2300,1130,642,515,3,9919,0
25,"Ilfov",100969,234,100969,,"BALOTESTI",102,"SCOALA GENERALA NR. 3 BALOTESTI, SOS. UNIRII, NR. 224",1736,964,949,14,1,956,8,1900,936,537,419,3,9919,0
25,"Ilfov",100969,234,100969,,"BALOTESTI",103,"CAMINUL CULTURAL BALOTESTI, STR. ION I.C. BRATIANU, NR. 10",1011,570,547,23,0,567,3,1100,530,328,239,3,9919,0
25,"Ilfov",100969,234,100969,,"BALOTESTI",104,"SCOALA NR. 2 SAFTICA, STR. CALEA BUCURESTI, NR. 76",914,610,595,15,0,605,5,1000,390,341,264,3,9919,0
25,"Ilfov",100969,234,100969,,"BALOTESTI",105,"SCOALA NR. 1 BALOTESTI, SOS. UNIRII, NR. 6, CP 077015",0,700,0,700,0,696,4,700,0,339,357,3,9919,1
25,"Ilfov",101145,234,101145,,"BERCENI",106,"SCOALA GENERALA NR. 2, CLS. I-IV",1891,1358,1258,46,54,1347,11,2100,742,506,841,3,9923,0
25,"Ilfov",101145,234,101145,,"BERCENI",107,"SCOALA GENERALA NR. 1, CLS. I-VIII,BD.1 MAI,NR.264",1550,1057,1006,28,23,1048,9,1700,643,333,715,3,9923,0
25,"Ilfov",101145,234,101145,,"BERCENI",108,"SCOALA GENERALA NR. 1 CU CLS. I-VIII,BERCENI,BD.1 MAI,NR.264, CP 077020",0,600,0,600,0,589,11,600,0,226,363,3,9923,1
25,"Ilfov",101298,234,101298,,"BRANESTI",109,"SCOALA GENERALA  DIN CARTIERUL BAJENARI, STR. MIHAI EMINESCU, NR. 37",1552,893,817,76,0,881,12,1700,807,554,327,3,9925,0
25,"Ilfov",101298,234,101298,,"BRANESTI",110,"SCOALA GENERALA NR. 1, SAT BRANESTI, STR. SLT. PETRE IONEL, NR. 147",2201,1277,1205,72,0,1253,24,2400,1123,708,545,3,9925,0
25,"Ilfov",101298,234,101298,,"BRANESTI",111,"LICEUL TEORETIC ""TRAIAN LALESCU"", STR. SLT. PETRE IONEL, NR. 1A",1520,989,895,94,0,980,9,1700,711,526,454,3,9925,0
25,"Ilfov",101298,234,101298,,"BRANESTI",112,"SCOALA GENERALA DIN SAT PASAREA, STR. NICOLAE BALCESCU, NR. 16A,  SAT PASAREA",621,381,345,36,0,375,6,700,319,193,182,3,9925,0
25,"Ilfov",101298,234,101298,,"BRANESTI",113,"GRADINITA DE COPII DIN SATUL ISLAZ, STR. 24 IANUARIE, NR. 28A, SAT ISLAZ",1058,608,541,67,0,599,9,1200,592,284,315,3,9925,0
25,"Ilfov",101298,234,101298,,"BRANESTI",114,"INCINTA MANASTIRII PASAREA,STR. NICOLAE BALCESCU,NR.79",88,100,66,34,0,95,5,101,1,71,24,3,9925,0
25,"Ilfov",101298,234,101298,,"BRANESTI",115,"COLEGIUL SILVIC ""THEODOR PIETRARU"",STR. SLT.PETRE IONEL,NR.2, CP 077030",0,800,0,800,0,788,12,800,0,400,388,3,9925,1
25,"Ilfov",101742,234,101742,,"CERNICA",116,"SCOALA GENERALA NR. 1 CERNICA, STR. TRAIAN, NR. 19, SAT CERNICA",1292,737,651,86,0,716,21,1391,654,531,185,3,9930,0
25,"Ilfov",101742,234,101742,,"CERNICA",117,"SCOALA GENERALA NR. 1 CERNICA, STR. TRAIAN, NR. 19, SAT CERNICA",1831,1066,1015,51,0,1045,21,2000,934,766,279,3,9930,0
25,"Ilfov",101742,234,101742,,"CERNICA",118,"SCOALA GENERALA NR. 4 BALACEANCA, SOS. GARII, NR. 41, SAT BALACEANCA",1383,1162,998,164,0,1141,21,1491,329,645,496,3,9930,0
25,"Ilfov",101742,234,101742,,"CERNICA",119,"SCOALA GENERALA NR. 2 CALDARARU, STR. BISERICII, NR. 55, SAT CALDARARU",788,720,604,116,0,707,13,900,180,446,261,3,9930,0
25,"Ilfov",101742,234,101742,,"CERNICA",120,"SCOALA NR. 5 POSTA, STR. POSTEI, NR. 13, SAT POSTA",388,345,285,60,0,342,3,452,107,141,201,3,9930,0
25,"Ilfov",101742,234,101742,,"CERNICA",121,"SCOALA GENERALA NR. 3 TANGANU, STR. BUREBISTA, NR. 25, SAT TANGANU",791,619,535,84,0,607,12,900,281,349,258,3,9930,0
25,"Ilfov",101742,234,101742,,"CERNICA",122,"SCOALA GENERALA NR. 3 TANGANU, STR. BUREBISTA, NR. 25, SAT TANGANU",1160,1050,860,190,0,1013,37,1300,250,600,413,3,9930,0
25,"Ilfov",101742,234,101742,,"CERNICA",123,"SCOALA GENERALA NR. 1,SAT CERNICA, STR. TRAIAN, NR. 19, CP 077035",0,800,0,800,0,783,17,800,0,528,255,3,9930,1
25,"Ilfov",179249,234,179249,,"CHIAJNA",124,"SALA DE SPORT CONCORDIA CHIAJNA, STR. DRUMUL GARII, NR. 1-3",1742,1020,997,23,0,1011,9,1900,880,477,534,3,9936,0
25,"Ilfov",179249,234,179249,,"CHIAJNA",125,"SALA DE SPORT CONCORDIA CHIAJNA, STR. DRUMUL GARII, NR. 1-3",1659,1073,1052,21,0,1057,16,1800,727,425,632,3,9936,0
25,"Ilfov",179249,234,179249,,"CHIAJNA",126,"SALA DE SPORT A SCOLII GENERALE ""ALEXANDRU ODOBESCU""-CHIAJNA, STR. PACII, NR. 72",878,544,500,44,0,538,6,950,406,258,280,3,9936,0
25,"Ilfov",179249,234,179249,,"CHIAJNA",127,"SALA DE SPORT A GRUPULUI SCOLAR ""DOAMNA CHIAJNA"" DIN SATUL ROSU, STR. GEORGE COSBUC, NR. 7-9",1685,904,871,33,0,892,12,1800,896,437,455,3,9936,0
25,"Ilfov",179249,234,179249,,"CHIAJNA",128,"SALA DE SPORT A GRUPULUI SCOLAR ""DOAMNA CHIAJNA"" DIN SATUL ROSU, STR. GEORGE COSBUC, NR. 7-9",1720,961,945,16,0,947,14,1900,939,438,509,3,9936,0
25,"Ilfov",179249,234,179249,,"CHIAJNA",129,"SALA DE SPORT CONCORDIA CHIAJNA, STR. DRUMUL GARII, NR. 1-3, CP 077040",0,800,0,800,0,789,11,800,0,321,468,3,9936,1
25,"Ilfov",101902,234,101902,,"CIOLPANI",130,"CAMINUL CULTURAL CIOLPANI, STR. MIHAI EMINESCU, NR. 15",1870,1123,1065,58,0,1113,10,2000,877,489,624,3,9940,0
25,"Ilfov",101902,234,101902,,"CIOLPANI",131,"SCOALA GENERALA CU CLS I-IV PISCU, STR. BISERICII, NR. 35",658,446,432,14,0,439,7,700,254,192,247,3,9940,0
25,"Ilfov",101902,234,101902,,"CIOLPANI",132,"SCOALA GENERALA CU CLS I-IV TIGANESTI, STR. TIGANESTI, NR. 4",777,477,446,31,0,472,5,800,323,230,242,3,9940,0
25,"Ilfov",101902,234,101902,,"CIOLPANI",133,"SCOALA GENERALA CU CLS I-IV IZVORANI, STR. VINTILA BRATIANU, NR. 12",479,312,294,18,0,308,4,500,188,195,113,3,9940,0
25,"Ilfov",101902,234,101902,,"CIOLPANI",134,"SCOALA NR.1 CIOLPANI,STR.SCOLII,NR.79, CP 077050",0,500,0,500,0,496,4,500,0,228,268,3,9940,1
25,"Ilfov",101957,234,101957,,"CIOROGARLA",135,"SCOALA NR. 1 CIOROGARLA, SOS BUCURESTI, NR. 110",1143,642,625,17,0,637,5,1300,658,303,334,3,9945,0
25,"Ilfov",101957,234,101957,,"CIOROGARLA",136,"SCOALA NR. 1 CIOROGARLA, SOS BUCURESTI, NR. 110",1424,774,745,29,0,768,6,1500,726,404,364,3,9945,0
25,"Ilfov",101957,234,101957,,"CIOROGARLA",137,"SCOALA NR. 2, DARVARI, STR. ADUNATI, NR. 31, SAT DARVARI",1499,852,838,14,0,827,25,1600,748,433,394,3,9945,0
25,"Ilfov",101957,234,101957,,"CIOROGARLA",138,"SCOALA NR. 1 CIOROGARLA, SOS. BUCURESTI, NR. 110, CP 077055",0,474,0,474,0,472,2,500,26,257,215,3,9945,1
25,"Ilfov",102035,234,102035,,"CLINCENI",139,"SCOALA GENERALA NR. 2, STR. MONUMENTUL EROILOR, NR. 120, SAT CLINCENI",1276,745,705,40,0,733,12,1400,655,320,413,3,9948,0
25,"Ilfov",102035,234,102035,,"CLINCENI",140,"SCOALA GENERALA NR. 1, STR. PRINCIPALA, NR. 107, SAT CLINCENI",2012,1252,1161,91,0,1224,28,2199,947,515,709,3,9948,0
25,"Ilfov",102035,234,102035,,"CLINCENI",141,"SCOALA GENERALA NR.4, STR. CIOROGARLEI, NR. 10, SAT OLTENI",1046,678,636,42,0,665,13,1100,422,365,300,3,9948,0
25,"Ilfov",102035,234,102035,,"CLINCENI",142,"SCOALA GENERALA NR. 1, STR. PRINCIPALA, NR. 107,  CP 077060",0,698,0,698,0,688,10,700,2,325,363,3,9948,1
25,"Ilfov",179588,234,179588,,"COPACENI",143,"ASEZAMANTUL SOCIAL AL BISERICII SF. DUMITRU DIN PAROHIA COPACENI MANASTIREA, SOS. PRINCIPALA, NR. 182",1273,931,774,157,0,921,10,1400,469,485,436,3,9952,0
25,"Ilfov",179588,234,179588,,"COPACENI",144,"SCOALA GENERALA  CU CLS I-VIII - CORP B, SOS. PRINCIPALA, NR. 622",1000,724,651,73,0,711,13,1100,376,390,321,3,9952,0
25,"Ilfov",179588,234,179588,,"COPACENI",145,"ASEZAMANTUL SOCIAL  DIN PAROHIA COPACENI MANASTIREA, STR. PRINCIPALA, NR. 182, CP 077006",0,400,0,400,0,395,5,400,0,253,142,3,9952,1
25,"Ilfov",102160,234,102160,,"CORBEANCA",146,"SCOALA GENERALA NR. 1, STR. INDEPENDENTEI, NR. 15",1932,1322,1264,58,0,1302,20,2100,778,618,684,3,9954,0
25,"Ilfov",102160,234,102160,,"CORBEANCA",147,"SCOALA GENERALA NR. 2, SAT TAMASI, SOS UNIRII, NR. 411",1751,1282,1237,45,0,1263,19,1900,618,574,689,3,9954,0
25,"Ilfov",102160,234,102160,,"CORBEANCA",148,"SCOALA GENERALA NR. 1 CU CLS.I-VIII, STR. INDEPENDENTEI, NR. 15, CP 077065",0,800,0,800,0,790,10,800,0,343,447,3,9954,1
25,"Ilfov",102213,234,102213,,"CORNETU",149,"SCOALA CU CLS. I-VIII, SOS. ALEXANDRIEI, NR. 179, SAT CORNETU",1241,765,756,9,0,759,6,1300,535,446,313,3,9959,0
25,"Ilfov",102213,234,102213,,"CORNETU",150,"SCOALA CU CLS. I-VIII, SOS. ALEXANDRIEI, NR. 179, SAT CORNETU",1161,709,702,7,0,700,9,1200,491,421,279,3,9959,0
25,"Ilfov",102213,234,102213,,"CORNETU",151,"SCOALA CU CLS. I-VIII, SOS. ALEXANDRIEI, NR. 179, SAT CORNETU",760,495,492,3,0,485,10,800,305,299,186,3,9959,0
25,"Ilfov",102213,234,102213,,"CORNETU",152,"SCOALA CU CLS. I-VIII, SOS. ALEXANDRIEI, NR. 179, SAT CORNETU",950,582,580,2,0,571,11,1000,418,364,207,3,9959,0
25,"Ilfov",102213,234,102213,,"CORNETU",153,"SCOALA CU CLS. I-VIII NR.1, CORNETU,SOS. ALEXANDRIEI, NR. 179, CP 077070",0,500,0,500,0,498,2,500,0,304,194,3,9959,1
25,"Ilfov",102473,234,102473,,"DASCALU",154,"SCOALA GENERALA NR. 1, SAT DASCALU, STR.VICTORIEI, NR.99",1595,1050,1022,28,0,1026,24,1700,650,563,463,3,9964,0
25,"Ilfov",102473,234,102473,,"DASCALU",155,"SCOALA GENERALA NR. 2, SAT GAGU, STR.PUTNA, NR.12",522,345,335,10,0,341,4,600,255,200,141,3,9964,0
25,"Ilfov",102473,234,102473,,"DASCALU",156,"PRIMARIA COMUNEI DASCALU, STR.VICTORIEI, NR.87, CP 077075",0,300,0,300,0,293,7,300,0,197,96,3,9964,1
25,"Ilfov",102525,234,102525,,"DARASTI-ILFOV",157,"SCOALA GENERALA NR. 1, STR. MIHAI EMINESCU, NR. 5",1115,803,786,17,0,794,9,1200,397,364,430,3,9962,0
25,"Ilfov",102525,234,102525,,"DARASTI-ILFOV",158,"SCOALA GENERALA NR. 1, STR. MIHAI EMINESCU, NR. 5",1187,823,815,8,0,806,17,1300,477,221,585,3,9962,0
25,"Ilfov",102525,234,102525,,"DARASTI-ILFOV",159,"SCOALA GENERALA NR. 1,DARASTI-ILFOV, STR. MIHAI EMINESCU, NR. 5, CP 077080",0,600,0,600,0,590,10,600,0,333,257,3,9962,1
25,"Ilfov",179310,234,179310,,"DOBROESTI",160,"SCOALA NR. 1 DOBROESTI, STR. NICOLAE BALCESCU, NR. 16-18",1843,1139,1118,21,0,1124,15,1999,860,507,617,3,9969,0
25,"Ilfov",179310,234,179310,,"DOBROESTI",161,"SCOALA NR. 1 DOBROESTI, STR. NICOLAE BALCESCU, NR. 16-18",1758,1129,1110,19,0,1118,11,1900,771,481,637,3,9969,0
25,"Ilfov",179310,234,179310,,"DOBROESTI",162,"SCOALA NR. 2, FUNDENI, SOS. FUNDENI, NR. 134",1259,790,769,21,0,781,9,1400,610,324,457,3,9969,0
25,"Ilfov",179310,234,179310,,"DOBROESTI",163,"SCOALA NR. 2, FUNDENI, SOS. FUNDENI, NR. 134",1106,713,689,24,0,706,7,1199,486,298,408,3,9969,0
25,"Ilfov",179310,234,179310,,"DOBROESTI",164,"SCOALA GENERALA NR. 2, FUNDENI, SOS. FUNDENI, NR. 134, CP 077086",0,698,0,698,0,695,3,700,2,249,446,3,9969,1
25,"Ilfov",102570,234,102570,,"DOMNESTI",165,"SCOALA GENERALA NR. 1, SAT DOMNESTI (LOCAL CU 4 SALI DE CLASA COJESTI)",1570,964,902,62,0,951,13,1700,736,557,394,3,9972,0
25,"Ilfov",102570,234,102570,,"DOMNESTI",166,"SCOALA GENERALA NR. 1, SAT DOMNESTI (LOCAL CU 4 SALI DE CLASA COJESTI)",1748,1152,1064,88,0,1125,27,1900,748,622,503,3,9972,0
25,"Ilfov",102570,234,102570,,"DOMNESTI",167,"SCOALA GENERALA NR. 1, SAT DOMNESTI (LOCAL CU 8 SALI DE CLASA )",1511,1106,1003,103,0,1093,13,1599,493,721,372,3,9972,0
25,"Ilfov",102570,234,102570,,"DOMNESTI",168,"LOCALUL SCOLII  DIN SATUL TEGHES",453,364,330,34,0,358,6,502,138,298,60,3,9972,0
25,"Ilfov",102570,234,102570,,"DOMNESTI",169,"SCOALA  NR. 1, SAT DOMNESTI, NR.1227, CP 077090",0,700,0,700,0,689,11,700,0,374,315,3,9972,1
25,"Ilfov",102605,234,102605,,"DRAGOMIRESTI-VALE",170,"GRUPUL SCOLAR AGRICOL ""VINTILA BRATIANU"", STR. MICSUNELELOR, NR. 165, SAT DRAGOMIRESTI-VALE",1018,693,660,28,5,679,14,1100,407,405,274,3,9975,0
25,"Ilfov",102605,234,102605,,"DRAGOMIRESTI-VALE",171,"SCOALA GENERALA NR. 2, SAT DRAGOMIRESTI - DEAL, STR. REPUBLICII, NR. 142",1114,810,782,27,1,797,13,1198,388,399,398,3,9975,0
25,"Ilfov",102605,234,102605,,"DRAGOMIRESTI-VALE",172,"SCOALA VECHE, SAT DRAGOMIRESTI-DEAL, STR. PACII, NR. 40-41",777,535,509,26,0,526,9,900,365,216,310,3,9975,0
25,"Ilfov",102605,234,102605,,"DRAGOMIRESTI-VALE",173,"SCOALA GENERALA NR. 3 , STR. GHIOCEILOR, NR. 38, SAT ZURBAUA",689,521,488,19,14,516,5,792,271,327,189,3,9975,0
25,"Ilfov",102605,234,102605,,"DRAGOMIRESTI-VALE",174,"SCOALA VECHE, SAT DRAGOMIRESTI-DEAL, STR. PACII, NR. 40, CP 077095",0,501,0,501,0,491,10,501,0,311,180,3,9975,1
25,"Ilfov",102605,234,102605,,"DRAGOMIRESTI-VALE",175,"GRUPUL SCOLAR ""VINTILA BRATIANU"", SAT DRAGOMIRESTI-VALE, STR. MICSUNELELOR, NR. 165, CP 077095",0,401,0,401,0,394,7,401,0,277,117,3,9975,1
25,"Ilfov",103130,234,103130,,"GANEASA",176,"SCOALA CU CLS.I-IV GANEASA, SAT GANEASA, STR. STEFAN CEL MARE, NR. 43",632,360,343,17,0,351,9,700,340,194,157,3,9979,0
25,"Ilfov",103130,234,103130,,"GANEASA",177,"SCOALA MOARA DOMNEASCA, SAT MOARA DOMNEASCA, STR. P. KONTZEBUE, NR. 4",479,393,375,18,0,390,3,500,107,293,97,3,9979,0
25,"Ilfov",103130,234,103130,,"GANEASA",178,"SCOALA COZIENI, SAT COZIENI, STR. MANASTIRII, NR. 2 A",591,362,346,16,0,349,13,650,288,285,64,3,9979,0
25,"Ilfov",103130,234,103130,,"GANEASA",179,"GRADINITA SINDRILITA, SAT SINDRILITA, STR. DN 2, BUCURESTI-URZICENI, NR. 22",858,631,600,31,0,609,22,900,269,231,378,3,9979,0
25,"Ilfov",103130,234,103130,,"GANEASA",180,"SCOALA PITEASCA, SAT PITEASCA, STR. REVOLUTIEI, NR. 69",952,599,546,53,0,568,31,1000,401,336,232,3,9979,0
25,"Ilfov",103130,234,103130,,"GANEASA",181,"SCOALA CU CLS.I-IV, SAT GANEASA, STR. STEFAN CEL MARE, NR. 43, CP 077100",0,399,0,399,0,396,3,400,1,266,130,3,9979,1
25,"Ilfov",179347,234,179347,,"GLINA",182,"SCOALA GENERALA NR. 1, STR. PARCULUI, NR. 1, SAT GLINA",1356,894,867,27,0,882,12,1491,597,542,340,3,9985,0
25,"Ilfov",179347,234,179347,,"GLINA",183,"SCOALA GENERALA NR. 1, STR. PARCULUI, NR. 1, SAT GLINA",1008,625,607,18,0,612,13,1099,474,361,251,3,9985,0
25,"Ilfov",179347,234,179347,,"GLINA",184,"SCOALA GENERALA NR. 3, STR. LIBERTATII, NR. 220, SAT GLINA",1428,871,838,33,0,823,48,1600,729,422,401,3,9985,0
25,"Ilfov",179347,234,179347,,"GLINA",185,"SCOALA GENERALA NR. 2, STR. LIBERTATII, NR. 130, SAT CATELU",1235,621,599,22,0,613,8,1350,729,335,278,3,9985,0
25,"Ilfov",179347,234,179347,,"GLINA",186,"SCOALA NR. 2 GLINA, STR. LIBERTATII, NR. 130, SAT CATELU",879,489,476,13,0,479,10,1000,511,274,205,3,9985,0
25,"Ilfov",179347,234,179347,,"GLINA",187,"SCOALA  NR. 1, GLINA,STR. PARCULUI, NR. 1, CP 077105",0,600,0,600,0,584,16,600,0,292,292,3,9985,1
25,"Ilfov",103443,234,103443,,"GRADISTEA",188,"CAMINUL CULTURAL GRADISTEA, STR. LIBERTATII, NR. 137 E",1613,1047,1028,19,0,1031,16,1800,753,587,444,3,9989,0
25,"Ilfov",103443,234,103443,,"GRADISTEA",189,"SCOALA GENERALA NR. 2 CU CLS. I-IV, SAT SITARU, STR. TEIULUI, NR. 44",774,599,545,54,0,593,6,856,257,322,271,3,9989,0
25,"Ilfov",103443,234,103443,,"GRADISTEA",190,"SCOALA CU CLS.I-VIII NR.1, GRADISTEA - SECTIA PRESCOLARI,SAT GRADISTEA, STR.LIBERTATII,NR.118, CP 077110",0,378,0,378,0,375,3,400,22,216,159,3,9989,1
25,"Ilfov",103513,234,103513,,"GRUIU",191,"SCOALA DE 4 ANI (SCOALA MARE), SOS. GRUIU-SNAGOV, NR. 206, SAT GRUIU",1720,863,842,21,0,853,10,1900,1037,326,527,3,9992,0
25,"Ilfov",103513,234,103513,,"GRUIU",192,"GRADINITA DE COPII, LIPIA, SOS. LIPIA-NUCI, NR. 102, SAT LIPIA",1677,972,947,25,0,938,34,1851,879,405,533,3,9992,0
25,"Ilfov",103513,234,103513,,"GRUIU",193,"SCOALA DE 8 ANI, SILISTEA, STR. ANTIM IVIREANUL, NR. 53, SAT SILISTEA-SNAGOVULUI",1669,1002,924,78,0,986,16,1800,798,557,429,3,9992,0
25,"Ilfov",103513,234,103513,,"GRUIU",194,"SCOALA DE 4 ANI, SANTU FLORESTI, STR. UNGURENI, NR. 28, SAT SANTU FLORESTI",452,313,283,30,0,308,5,500,187,118,190,3,9992,0
25,"Ilfov",103513,234,103513,,"GRUIU",195,"CAMINUL CULTURAL GRUIU, SAT GRUIU, SOS.GRUIU,NR.150,CP 077115",0,600,0,600,0,597,3,601,1,255,342,3,9992,1
25,"Ilfov",179383,234,179383,,"JILAVA",196,"SEDIUL ADMINISTRATIV AL SC PROGRESUL SA, SOS. GIURGIULUI, NR. 5",1204,560,535,25,0,548,12,1300,740,311,237,3,9997,0
25,"Ilfov",179383,234,179383,,"JILAVA",197,"SCOALA NR. 2, STR. ODAI, NR. 142",1423,886,861,25,0,881,5,1550,664,523,358,3,9997,0
25,"Ilfov",179383,234,179383,,"JILAVA",198,"SCOALA NR. 1, SOS. GIURGIULUI, NR. 266",2273,1235,1196,39,0,1216,19,2510,1275,696,520,3,9997,0
25,"Ilfov",179383,234,179383,,"JILAVA",199,"SCOALA NR. 3, STR. VERII, NR. 33",1794,1147,1107,40,0,1112,35,2000,853,658,454,3,9997,0
25,"Ilfov",179383,234,179383,,"JILAVA",200,"FOSTUL C.A.P., SOS. GIURGIULUI, NR. 288",1448,1626,919,31,676,1594,32,2400,774,1001,593,3,9997,0
25,"Ilfov",179383,234,179383,,"JILAVA",201,"SCOALA GENERALA NR. 1, SOS. GIURGIULUI, NR. 266, CP 077120",0,500,0,500,0,490,10,500,0,272,218,3,9997,1
25,"Ilfov",104243,234,104243,,"MOARA VLASIEI",202,"SCOALA GENERALA NR. 2,  MOARA VLASIEI, SOS. EROILOR, NR. 282",2016,1014,970,44,0,993,21,2200,1186,482,511,3,9999,0
25,"Ilfov",104243,234,104243,,"MOARA VLASIEI",203,"SCOALA GENERALA NR. 1,  MOARA VLASIEI, SOS. EROILOR, NR. 127",1388,808,740,68,0,788,20,1500,692,401,387,3,9999,0
25,"Ilfov",104243,234,104243,,"MOARA VLASIEI",204,"SCOALA GENERALA NR. 3,  MOARA VLASIEI, SAT CACIULATI, SOS. UNIRII, NR. 146",1390,766,705,61,0,745,21,1500,734,381,364,3,9999,0
25,"Ilfov",104243,234,104243,,"MOARA VLASIEI",205,"SCOALA GENERALA NR. 1 MOARA VLASIEI, SAT MOARA VLASIEI,SOS. EROILOR, NR. 127, CP 077130",0,299,0,299,0,297,2,299,0,134,163,3,9999,1
25,"Ilfov",179463,234,179463,,"MOGOSOAIA",206,"SCOALA GENERALA NR. 1 MOGOSOAIA, SOS. BUCURESTI-TARGOVISTE, NR. 107",927,618,603,15,0,612,6,1000,382,234,378,3,10002,0
25,"Ilfov",179463,234,179463,,"MOGOSOAIA",207,"SCOALA GENERALA NR. 1 MOGOSOAIA, SOS. BUCURESTI-TARGOVISTE, NR. 107",1066,586,578,8,0,580,6,1200,614,268,312,3,10002,0
25,"Ilfov",179463,234,179463,,"MOGOSOAIA",208,"SCOALA GENERALA NR. 1 MOGOSOAIA, SOS. BUCURESTI-TARGOVISTE, NR. 107",998,610,597,13,0,600,10,1100,490,293,307,3,10002,0
25,"Ilfov",179463,234,179463,,"MOGOSOAIA",209,"SCOALA GENERALA NR. 1 MOGOSOAIA, SOS. BUCURESTI-TARGOVISTE, NR. 107",1270,718,708,10,0,707,11,1400,682,289,418,3,10002,0
25,"Ilfov",179463,234,179463,,"MOGOSOAIA",210,"SCOALA GENERALA NR. 1 MOGOSOAIA, SOS. BUCURESTI-TARGOVISTE, NR. 107",866,475,459,16,0,470,5,950,475,273,197,3,10002,0
25,"Ilfov",179463,234,179463,,"MOGOSOAIA",211,"SCOALA GENERALA NR. 1 MOGOSOAIA, SOS. BUCURESTI-TARGOVISTE, NR. 107, CP 077135",0,880,0,880,0,869,11,998,118,384,485,3,10002,1
25,"Ilfov",104421,234,104421,,"NUCI",212,"SCOALA MERII PETCHI, STR. CRINILOR, NR. 72",1025,673,626,16,31,658,15,1100,427,293,365,3,10004,0
25,"Ilfov",104421,234,104421,,"NUCI",213,"SCOALA MICSUNESTI-MOARA, STR. VIITORULUI, NR. 2",1311,884,822,27,35,873,11,1400,516,243,630,3,10004,0
25,"Ilfov",104421,234,104421,,"NUCI",214,"SCOALA CU CLS.I-IV NUCI, SAT NUCI, SOS.CALEA BUCURESTILOR,NR.236, CP 077140",0,400,0,400,0,393,7,400,0,131,262,3,10004,1
25,"Ilfov",104546,234,104546,,"PERIS",215,"SCOALA NR. 1 PERIS",1882,932,905,27,0,922,10,2100,1168,505,417,3,10010,0
25,"Ilfov",104546,234,104546,,"PERIS",216,"SCOALA NR. 2 PERIS",1870,999,958,41,0,994,5,2050,1051,542,452,3,10010,0
25,"Ilfov",104546,234,104546,,"PERIS",217,"SCOALA NR. 3 PERIS",523,299,278,21,0,298,1,600,301,159,139,3,10010,0
25,"Ilfov",104546,234,104546,,"PERIS",218,"SCOALA NR. 4 BURIAS",1104,682,657,25,0,670,12,1200,518,256,414,3,10010,0
25,"Ilfov",104546,234,104546,,"PERIS",219,"SCOALA NR. 5 BALTENI",326,245,229,16,0,243,2,350,105,80,163,3,10010,0
25,"Ilfov",104546,234,104546,,"PERIS",220,"SEDIUL PRIMARIEI COMUNEI PERIS, STR.PRINCIPALA,NR.211, CP 077150",0,400,0,400,0,394,6,400,0,189,205,3,10010,1
25,"Ilfov",104582,234,104582,,"PETRACHIOAIA",221,"GRADINITA PETRACHIOAIA, SOS. VANATORI, NR. 359",2012,1131,1104,27,0,1106,25,2201,1070,574,532,3,10014,0
25,"Ilfov",104582,234,104582,,"PETRACHIOAIA",222,"SCOALA GENERALA SAT MAINEASCA, SOS. SINESTI, NR. 13",274,166,157,9,0,161,5,299,133,102,59,3,10014,0
25,"Ilfov",104582,234,104582,,"PETRACHIOAIA",223,"GRADINITA PETRACHIOAIA, SOS. VANATORI, NR. 359, CP 077155",0,261,0,261,0,256,5,300,39,152,104,3,10014,1
25,"Ilfov",105160,234,105160,,"SNAGOV",224,"LOCALUL FOSTEI SCOLI GENERALE CU CLS. I-IV, SAT SNAGOV, SOS. SNAGOV, NR. 125",1303,884,862,22,0,874,10,1400,516,507,367,3,10019,0
25,"Ilfov",105160,234,105160,,"SNAGOV",225,"CASA DE CULTURA, SAT GHERMANESTI, INTRAREA ISLAZ, NR. 3",1848,1245,1215,30,0,1226,19,2001,756,730,496,3,10019,0
25,"Ilfov",105160,234,105160,,"SNAGOV",226,"SCOALA GENERALA NR.3 CU CLS.I-IV, CIOFLICENI, SAT CIOFLICENI, STR. MIRCEA CEL BATRAN, NR. 16",848,559,539,20,0,551,8,899,340,373,178,3,10019,0
25,"Ilfov",105160,234,105160,,"SNAGOV",227,"SCOALA GENERALA NR.1 CU CLS. I-VIII TANCABESTI, SAT TANCABESTI, STR. I.C. BAICOIANU, NR. 10",1191,735,705,30,0,722,13,1300,565,433,289,3,10019,0
25,"Ilfov",105160,234,105160,,"SNAGOV",228,"PRIMARIA COMUNEI SNAGOV, SAT GHERMANESTI,SOS.GHERMANESTI,NR.49, CP 077170",0,800,0,800,0,793,7,800,0,385,408,3,10019,1
25,"Ilfov",105419,234,105419,,"STEFANESTII DE JOS",229,"SCOALA NR. 1 CU CLS I-VIII,  SOS. STEFANESTI, NR. 157",1205,923,858,65,0,915,8,1297,374,505,410,3,10025,0
25,"Ilfov",105419,234,105419,,"STEFANESTII DE JOS",230,"SCOALA NR. 2, SOS. STEFANESTI, NR. 130",1235,1032,990,42,0,1023,9,1350,318,257,766,3,10025,0
25,"Ilfov",105419,234,105419,,"STEFANESTII DE JOS",231,"SCOALA CRETULEASCA, STR. DUDULUI, NR. 10",909,674,636,38,0,660,14,995,321,235,425,3,10025,0
25,"Ilfov",105419,234,105419,,"STEFANESTII DE JOS",232,"GRADINITA NR. 1, STR. ZORILOR, NR. 485",722,571,535,36,0,559,12,807,236,406,153,3,10025,0
25,"Ilfov",105419,234,105419,,"STEFANESTII DE JOS",233,"SCOALA CU CLS I-VIII,  CORP B, SOS. STEFANESTI, NR. 130, CP 077175",0,700,0,700,0,693,7,700,0,249,444,3,10025,1
25,"Ilfov",105570,234,105570,,"TUNARI",234,"SCOALA NR. 1 TUNARI, CORP A, STR. MIHAI EMINESCU, NR. 3",1786,1218,1175,43,0,1203,15,2000,782,548,655,3,10029,0
25,"Ilfov",105570,234,105570,,"TUNARI",235,"SCOALA NR. 1 TUNARI, CORP C, STR. MIHAI EMINESCU, NR. 3",1582,1064,1017,47,0,1046,18,1700,636,639,407,3,10029,0
25,"Ilfov",105570,234,105570,,"TUNARI",236,"SCOALA NR. 1 TUNARI,  STR. MIHAI EMINESCU, NR. 3, CP 077180",0,500,0,500,0,496,4,501,1,233,263,3,10029,1
25,"Ilfov",105936,234,105936,,"VIDRA",237,"SCOALA GENERALA NR. 304, VIDRA-BRAGADIRU, STR. PRINCIPALA, NR. 315, SAT VIDRA",731,439,366,73,0,428,11,800,361,299,129,3,10032,0
25,"Ilfov",105936,234,105936,,"VIDRA",238,"SCOALA GENERALA NR. 301 VIDRA, STR. PRINCIPALA, NR. 106, SAT VIDRA",1420,782,661,121,0,774,8,1600,818,475,299,3,10032,0
25,"Ilfov",105936,234,105936,,"VIDRA",239,"SCOALA NR. 302 CRETESTI, STR. PRINCIPALA, NR. 203, SAT CRETESTI",1149,644,572,72,0,634,10,1300,656,389,245,3,10032,0
25,"Ilfov",105936,234,105936,,"VIDRA",240,"SCOALA NR. 302 CRETESTI, STR. PRINCIPALA, NR. 203, SAT CRETESTI",958,529,455,74,0,523,6,1050,521,349,174,3,10032,0
25,"Ilfov",105936,234,105936,,"VIDRA",241,"SCOALA GENERALA NR. 303 SINTESTI, STR. PRINCIPALA, NR. 169, SAT SINTESTI",773,463,368,95,0,458,5,850,387,263,195,3,10032,0
25,"Ilfov",105936,234,105936,,"VIDRA",242,"SCOALA GENERALA NR. 304 VIDRA, STR. PRINCIPALA, NR. 315, SAT VIDRA",682,562,345,217,0,549,13,750,188,305,244,3,10032,0
25,"Ilfov",105936,234,105936,,"VIDRA",243,"SCOALA GENERALA NR. 303 SINTESTI, STR. PRINCIPALA, NR. 169, SAT SINTESTI",934,438,378,60,0,422,16,1000,562,262,160,3,10032,0
25,"Ilfov",105936,234,105936,,"VIDRA",244,"SCOALA NR. 2 CRETESTI, CORP B,SAT CRETESTI, STR. PRINCIPALA, NR. 186A,  CP 077186",0,489,0,489,0,482,7,600,111,170,312,3,10032,1
26,"Maramures",106318,243,106318,,"MUNICIPIUL BAIA MARE",1,"Scoala generala nr. 7, strada Valea Borcutului",1486,853,843,10,0,847,6,1594,741,465,382,1,10037,0
26,"Maramures",106318,243,106318,,"MUNICIPIUL BAIA MARE",2,"Scoala generala nr. 12, strada Victoriei nr. 132 A",1913,1043,1029,14,0,1033,10,2100,1057,607,426,1,10037,0
26,"Maramures",106318,243,106318,,"MUNICIPIUL BAIA MARE",3,"Grup Scolar Gheorghe Lazar, strada Victor Babes nr. 64",1879,832,818,14,0,827,5,2100,1268,500,327,1,10037,0
26,"Maramures",106318,243,106318,,"MUNICIPIUL BAIA MARE",4,"Grup Scolar Gheorghe Lazar, strada Victor Babes nr. 64",1931,936,929,7,0,931,5,2100,1164,530,401,1,10037,0
26,"Maramures",106318,243,106318,,"MUNICIPIUL BAIA MARE",5,"Universitate I, strada Victor Babes nr. 62/A",1923,945,930,15,0,936,9,2100,1155,541,395,1,10037,0
26,"Maramures",106318,243,106318,,"MUNICIPIUL BAIA MARE",6,"Scoala generala nr. 12, strada Victoriei nr. 132/ A",1401,719,706,13,0,715,4,1599,880,367,348,1,10037,0
26,"Maramures",106318,243,106318,,"MUNICIPIUL BAIA MARE",7,"Scoala generala nr. 6 Nichita Stanescu, strada Iza nr. 2",1156,667,653,13,1,660,7,1302,635,335,325,1,10037,0
26,"Maramures",106318,243,106318,,"MUNICIPIUL BAIA MARE",8,"Scoala generala nr. 6 Nichita Stanescu, strada Iza nr. 2",1003,498,490,8,0,492,6,1100,602,279,213,1,10037,0
26,"Maramures",106318,243,106318,,"MUNICIPIUL BAIA MARE",9,"Scoala generala nr. 4, strada Victoriei nr. 84",1113,564,556,8,0,556,8,1201,637,289,267,1,10037,0
26,"Maramures",106318,243,106318,,"MUNICIPIUL BAIA MARE",10,"Scoala generala nr. 4, strada Victoriei nr. 84",1180,667,657,10,0,659,8,1300,633,334,325,1,10037,0
26,"Maramures",106318,243,106318,,"MUNICIPIUL BAIA MARE",11,"Grup Scolar Electromecanic, strada Gheorge Marinescu nr. 1",1070,580,567,13,0,576,4,1200,620,280,296,1,10037,0
26,"Maramures",106318,243,106318,,"MUNICIPIUL BAIA MARE",12,"Grup Scolar Electromecanic, strada Gheorge Marinescu nr. 1",1132,610,602,8,0,605,5,1201,591,327,278,1,10037,0
26,"Maramures",106318,243,106318,,"MUNICIPIUL BAIA MARE",13,"Universitatea II, strada Victoriei nr. 76",1846,993,968,24,1,983,10,1998,1005,473,510,1,10037,0
26,"Maramures",106318,243,106318,,"MUNICIPIUL BAIA MARE",14,"Biblioteca Judeteana  Petre Dulfu ,  Bulevardul Independentei nr. 4B",1415,794,786,8,0,785,9,1600,806,408,377,1,10037,0
26,"Maramures",106318,243,106318,,"MUNICIPIUL BAIA MARE",15,"S.C. Energoterm, strada Victoriei nr. 35",915,527,512,14,1,520,7,1004,477,262,258,1,10037,0
26,"Maramures",106318,243,106318,,"MUNICIPIUL BAIA MARE",16,"Liceul de arta, strada Petofi nr. 2",1076,639,628,11,0,631,8,1201,562,310,321,1,10037,0
26,"Maramures",106318,243,106318,,"MUNICIPIUL BAIA MARE",17,"Liceul de arta, strada Petofi nr. 2",1140,637,617,19,1,629,8,1300,663,350,279,1,10037,0
26,"Maramures",106318,243,106318,,"MUNICIPIUL BAIA MARE",18,"Grup Scolar Sanitar,  strada Minerilor nr. 3",1154,626,613,13,0,621,5,1300,674,335,286,1,10037,0
26,"Maramures",106318,243,106318,,"MUNICIPIUL BAIA MARE",19,"Gradinita nr. 12, strada Industriei nr. 1",1737,850,830,19,1,839,11,1900,1050,505,334,1,10037,0
26,"Maramures",106318,243,106318,,"MUNICIPIUL BAIA MARE",20,"Scoala generala nr.16, strada Arenei nr. 15",1422,681,664,17,0,667,14,1600,919,438,229,1,10037,0
26,"Maramures",106318,243,106318,,"MUNICIPIUL BAIA MARE",21,"Scoala generala nr.16, strada Arenei nr. 15",1199,572,559,13,0,558,14,1300,728,331,227,1,10037,0
26,"Maramures",106318,243,106318,,"MUNICIPIUL BAIA MARE",22,"Scoala generala nr. 9, Luncii 22",2144,1063,1047,16,0,1052,11,2300,1237,622,430,1,10037,0
26,"Maramures",106318,243,106318,,"MUNICIPIUL BAIA MARE",23,"Scoala generala nr. 13, strada Firiza",1323,795,782,13,0,786,9,1501,706,445,341,1,10037,0
26,"Maramures",106318,243,106318,,"MUNICIPIUL BAIA MARE",24,"Scoala generala nr. 2 Octavian Goga, strada Vasile Lucaciu nr. 65",1194,591,582,9,0,585,6,1302,711,330,255,1,10037,0
26,"Maramures",106318,243,106318,,"MUNICIPIUL BAIA MARE",25,"Scoala generala nr. 2 Octavian Goga, strada Vasile Lucaciu nr. 65",1264,662,646,16,0,656,6,1400,738,351,305,1,10037,0
26,"Maramures",106318,243,106318,,"MUNICIPIUL BAIA MARE",26,"Colegiul National Gheorghe Sincai, strada Gheorghe Sincai nr. 25",1812,929,910,17,2,916,13,1900,971,453,463,1,10037,0
26,"Maramures",106318,243,106318,,"MUNICIPIUL BAIA MARE",27,"Colegiul National Vasile Lucaciu, strada Culturii nr. 2",1740,848,839,9,0,839,9,1900,1052,420,419,1,10037,0
26,"Maramures",106318,243,106318,,"MUNICIPIUL BAIA MARE",28,"Grup Scolar de Posta si Telecomunicatii George Baritiu, strada Culturii nr. 8",1622,933,919,12,2,923,10,1800,867,437,486,1,10037,0
26,"Maramures",106318,243,106318,,"MUNICIPIUL BAIA MARE",29,"Grup Scolar Tehnic Anghel Saligny, strada Progresului nr. 43",1783,1012,999,10,3,1003,9,1900,888,534,469,1,10037,0
26,"Maramures",106318,243,106318,,"MUNICIPIUL BAIA MARE",30,"Scoala Generala nr. 8, Lucian Blaga, strada Progresului nr. 38",1144,589,578,11,0,584,5,1301,712,321,263,1,10037,0
26,"Maramures",106318,243,106318,,"MUNICIPIUL BAIA MARE",31,"Scoala Generala nr. 8, Lucian Blaga, strada Progresului nr. 38",1157,620,606,14,0,614,6,1300,680,330,284,1,10037,0
26,"Maramures",106318,243,106318,,"MUNICIPIUL BAIA MARE",32,"Grup Scolar Industrial Metalurgic C.D. Nenitescu, strada Luminisului nr. 1",2500,1191,1167,23,1,1168,23,2600,1409,660,508,1,10037,0
26,"Maramures",106318,243,106318,,"MUNICIPIUL BAIA MARE",33,"Grup Scolar Industrial Metalurgic C.D. Nenitescu, strada Luminisului nr. 1",1642,820,809,11,0,809,11,1800,980,471,338,1,10037,0
26,"Maramures",106318,243,106318,,"MUNICIPIUL BAIA MARE",34,"Liceul Emil Racovita, strada V. Alecsandri nr. 56",1587,869,855,14,0,859,10,1699,830,477,382,1,10037,0
26,"Maramures",106318,243,106318,,"MUNICIPIUL BAIA MARE",35,"Liceul Emil Racovita, strada V. Alecsandri nr. 56",1629,778,760,18,0,773,5,1801,1023,495,278,1,10037,0
26,"Maramures",106318,243,106318,,"MUNICIPIUL BAIA MARE",36,"Gradinita  Otilia Cazimir, strada Banatului nr. 3",1764,756,745,11,0,749,7,1900,1144,478,271,1,10037,0
26,"Maramures",106318,243,106318,,"MUNICIPIUL BAIA MARE",37,"Scoala cu clasele, I - VIII nr. 10, strada Mihai Eminescu 80 A (strada Marasesti 2)",2283,1064,1019,45,0,1060,4,2300,1236,717,343,1,10037,0
26,"Maramures",106318,243,106318,,"MUNICIPIUL BAIA MARE",38,"Gradinita nr. 4, strada Paltinisului nr. 65B",2136,1042,995,47,0,1038,4,2198,1156,776,262,1,10037,0
26,"Maramures",106318,243,106318,,"MUNICIPIUL BAIA MARE",39,"Scoala cu clasele I - VIII NR. 5, strada Pasunii nr. 2A",1647,742,733,9,0,731,11,1800,1058,541,190,1,10037,0
26,"Maramures",106318,243,106318,,"MUNICIPIUL BAIA MARE",40,"Gradinita nr. 27, strada V. Alecsandri nr. 58",2268,1064,1007,57,0,1059,5,2299,1235,746,313,1,10037,0
26,"Maramures",106318,243,106318,,"MUNICIPIUL BAIA MARE",41,"Protectia copilului, strada Banatului nr. 1",2062,921,868,53,0,912,9,2100,1179,656,256,1,10037,0
26,"Maramures",106318,243,106318,,"MUNICIPIUL BAIA MARE",42,"Drumuri si Poduri S.A - S.U.T., strada V. Alecsandri nr. 99",2537,859,843,16,0,848,11,2500,1641,592,256,1,10037,0
26,"Maramures",106318,243,106318,,"MUNICIPIUL BAIA MARE",43,"Scoala cu clasele I - VIII nr. 5, strada Pasunii nr. 2A",2317,972,953,19,0,967,5,2400,1428,604,363,1,10037,0
26,"Maramures",106318,243,106318,,"MUNICIPIUL BAIA MARE",44,"Gradinita  Otilia Cazimir, strada Banatului nr. 3",1824,901,892,9,0,896,5,2000,1099,568,328,1,10037,0
26,"Maramures",106318,243,106318,,"MUNICIPIUL BAIA MARE",45,"Circa Sanitara, strada Banatului nr. 1",2234,998,960,38,0,987,11,2300,1302,675,312,1,10037,0
26,"Maramures",106318,243,106318,,"MUNICIPIUL BAIA MARE",46,"Bazinul Olimpic, Bd. Unirii nr. 14B",1482,705,692,13,0,700,5,1600,895,374,326,1,10037,0
26,"Maramures",106318,243,106318,,"MUNICIPIUL BAIA MARE",47,"Liceu cu profil sportiv, Bulevardul Republicii 33 - 35",1655,849,837,12,0,842,7,1798,949,438,404,1,10037,0
26,"Maramures",106318,243,106318,,"MUNICIPIUL BAIA MARE",48,"Bazinul Olimpic, Bulevardul Unirii nr.14B",1808,897,887,10,0,887,10,2000,1103,479,408,1,10037,0
26,"Maramures",106318,243,106318,,"MUNICIPIUL BAIA MARE",49,"Administratia Bazelor Sportive, strada Unirii nr. 24D",1698,851,841,10,0,846,5,1900,1049,452,394,1,10037,0
26,"Maramures",106318,243,106318,,"MUNICIPIUL BAIA MARE",50,"Centrul Social ASSOC, Bulevardul Unirii nr. 28",1482,743,723,20,0,735,8,1600,857,416,319,1,10037,0
26,"Maramures",106318,243,106318,,"MUNICIPIUL BAIA MARE",51,"Planning Familial, Bulevardul Bucuresti nr. 17B",1935,1033,1012,21,0,1021,12,1999,966,515,506,1,10037,0
26,"Maramures",106318,243,106318,,"MUNICIPIUL BAIA MARE",52,"Grup Scolar Industrie Usoara, Bulevardul Republicii nr. 8",1663,839,827,12,0,832,7,1801,962,470,362,1,10037,0
26,"Maramures",106318,243,106318,,"MUNICIPIUL BAIA MARE",53,"Gradinita nr. 20, Bulevardul Bucuresti nr. 20",1687,901,887,14,0,890,11,1800,899,446,444,1,10037,0
26,"Maramures",106318,243,106318,,"MUNICIPIUL BAIA MARE",54,"Scoala Generala George Cosbuc, strada Gheorghe Bilascu nr. 19A",1190,614,604,10,0,603,11,1300,686,310,293,1,10037,0
26,"Maramures",106318,243,106318,,"MUNICIPIUL BAIA MARE",55,"Scoala Generala George Cosbuc, strada Gheorghe Bilascu nr. 19A",1340,715,709,6,0,710,5,1503,788,358,352,1,10037,0
26,"Maramures",106318,243,106318,,"MUNICIPIUL BAIA MARE",56,"Scoala Generala Nicolae Iorga, strada Gheorghe Bilascu nr. 1",1041,558,542,16,0,553,5,1198,640,256,297,1,10037,0
26,"Maramures",106318,243,106318,,"MUNICIPIUL BAIA MARE",57,"Gradinita nr. 9, strada Nicolae Iorga, nr. 3A",1287,688,674,13,1,682,6,1402,714,372,310,1,10037,0
26,"Maramures",106318,243,106318,,"MUNICIPIUL BAIA MARE",58,"Grup Scolar Industrie Usoara, Bulevardul Republicii nr. 8",1636,816,802,14,0,810,6,1800,984,459,351,1,10037,0
26,"Maramures",106318,243,106318,,"MUNICIPIUL BAIA MARE",59,"Scoala Generala nr. 17, strada Cuza Voda nr. 7",1352,685,671,12,2,677,8,1495,810,360,317,1,10037,0
26,"Maramures",106318,243,106318,,"MUNICIPIUL BAIA MARE",60,"Scoala Generala nr. 17, strada Cuza Voda nr. 7",1426,673,658,15,0,671,2,1600,927,388,283,1,10037,0
26,"Maramures",106318,243,106318,,"MUNICIPIUL BAIA MARE",61,"Gradinita nr. 29, strada Cuza Voda nr. 8B",1880,911,898,13,0,901,10,2000,1089,564,337,1,10037,0
26,"Maramures",106318,243,106318,,"MUNICIPIUL BAIA MARE",62,"Scoala generala nr.18, Aleea Filaturii nr. 2",1828,904,893,9,2,900,4,2000,1096,552,348,1,10037,0
26,"Maramures",106318,243,106318,,"MUNICIPIUL BAIA MARE",63,"Scoala generala nr.18, Aleea Filaturii nr. 2",1679,759,750,9,0,756,3,1800,1041,439,317,1,10037,0
26,"Maramures",106318,243,106318,,"MUNICIPIUL BAIA MARE",64,"Gradinita nr. 28, Aleea Filaturii nr. 4",1897,846,835,11,0,838,8,2100,1254,489,349,1,10037,0
26,"Maramures",106318,243,106318,,"MUNICIPIUL BAIA MARE",65,"Liceu cu profil sportiv, Bulevardul Republicii nr. 33 - 35",1418,667,656,11,0,661,6,1600,933,330,331,1,10037,0
26,"Maramures",106318,243,106318,,"MUNICIPIUL BAIA MARE",66,"Liceu cu profil sportiv, Bulevardul Republicii nr. 33 - 35",777,407,402,5,0,405,2,802,395,245,160,1,10037,0
26,"Maramures",106318,243,106318,,"MUNICIPIUL BAIA MARE",67,"Scoala generala nr. 21, strada Bucovinei nr. 9",1973,842,831,11,0,839,3,2200,1358,492,347,1,10037,0
26,"Maramures",106318,243,106318,,"MUNICIPIUL BAIA MARE",68,"Scoala generala nr. 21, strada Bucovinei nr. 9",1892,974,963,10,1,968,6,2100,1126,537,431,1,10037,0
26,"Maramures",106318,243,106318,,"MUNICIPIUL BAIA MARE",69,"Gradinita nr. 36, strada Bucovinei nr. 7",1935,893,882,11,0,892,1,2100,1207,539,353,1,10037,0
26,"Maramures",106318,243,106318,,"MUNICIPIUL BAIA MARE",70,"Gradinita nr. 34, Aleea Amurgului nr. 2",1934,946,934,12,0,941,5,2100,1154,591,350,1,10037,0
26,"Maramures",106318,243,106318,,"MUNICIPIUL BAIA MARE",71,"Gradinita nr. 25, Aleea Jupiter nr. 4",1778,880,866,14,0,873,7,1900,1020,509,364,1,10037,0
26,"Maramures",106318,243,106318,,"MUNICIPIUL BAIA MARE",72,"Scoala generala nr 15, Aleea Neptun nr. 5",1497,774,755,19,0,768,6,1600,826,474,294,1,10037,0
26,"Maramures",106318,243,106318,,"MUNICIPIUL BAIA MARE",73,"Scoala generala nr 15, Aleea Neptun nr. 5",1376,618,602,16,0,614,4,1501,883,408,206,1,10037,0
26,"Maramures",106318,243,106318,,"MUNICIPIUL BAIA MARE",74,"Scoala generala nr. 3, strada Bogdan Voda nr. 6",1764,849,836,13,0,841,8,1900,1051,471,370,1,10037,0
26,"Maramures",106318,243,106318,,"MUNICIPIUL BAIA MARE",75,"Scoala generala nr. 3, strada Bogdan Voda nr. 6",1973,965,954,11,0,959,6,2100,1135,593,366,1,10037,0
26,"Maramures",106318,243,106318,,"MUNICIPIUL BAIA MARE",76,"Gara CFR, strada Garii nr. 4",1813,776,764,12,0,771,5,1997,1221,480,291,1,10037,0
26,"Maramures",106318,243,106318,,"MUNICIPIUL BAIA MARE",77,"SC Confstill SA, Bulevardul Bucuresti nr. 44",2053,865,855,10,0,860,5,2200,1335,562,298,1,10037,0
26,"Maramures",106318,243,106318,,"MUNICIPIUL BAIA MARE",78,"Spitalul de Urgenta   Constantin Opris , Strada George Cosbuc nr. 31",0,623,0,623,0,617,6,900,277,376,241,1,10037,1
26,"Maramures",106318,243,106318,,"MUNICIPIUL BAIA MARE",79,"Universitatea de Nord, strada Victoriei nr.76",0,516,0,516,0,513,3,901,385,298,215,1,10037,1
26,"Maramures",106318,243,106318,,"MUNICIPIUL BAIA MARE",80,"Gara CFR, strada Garii nr. 4",0,972,0,972,0,963,9,1100,128,631,332,1,10037,1
26,"Maramures",106559,243,106559,,"MUNICIPIUL SIGHETU MARMATIEI",81,"Scoala generala nr.8, strada Iapa",1203,566,557,9,0,559,7,1306,740,284,275,1,10042,0
26,"Maramures",106559,243,106559,,"MUNICIPIUL SIGHETU MARMATIEI",82,"Scoala generala nr.1 CEARDA, strada Valea Hotarului nr. 11",1383,566,560,6,0,559,7,1500,934,315,244,1,10042,0
26,"Maramures",106559,243,106559,,"MUNICIPIUL SIGHETU MARMATIEI",83,"Scoala generala nr. 11, strada Campu Negru nr. 11",1066,511,499,12,0,509,2,1201,690,281,228,1,10042,0
26,"Maramures",106559,243,106559,,"MUNICIPIUL SIGHETU MARMATIEI",84,"Gradinita nr. 12, Bulevardul Independentei nr. 10",1608,709,699,10,0,696,13,1800,1091,416,280,1,10042,0
26,"Maramures",106559,243,106559,,"MUNICIPIUL SIGHETU MARMATIEI",85,"Universitatea Babes Bolyai, strada Avram Iancu nr. 6",1905,790,782,8,0,784,6,2000,1210,458,326,1,10042,0
26,"Maramures",106559,243,106559,,"MUNICIPIUL SIGHETU MARMATIEI",86,"Liceul Regele Ferdinand, strada 22 Decembrie nr. 5",1992,926,917,9,0,919,7,2200,1274,496,423,1,10042,0
26,"Maramures",106559,243,106559,,"MUNICIPIUL SIGHETU MARMATIEI",87,"Casa de cultura, strada Iuliu Maniu nr. 31",1724,872,865,6,1,859,13,1900,1028,478,381,1,10042,0
26,"Maramures",106559,243,106559,,"MUNICIPIUL SIGHETU MARMATIEI",88,"Liceul Dragos Voda, strada Mihai Viteazu nr.13",1457,665,653,12,0,662,3,1600,935,356,306,1,10042,0
26,"Maramures",106559,243,106559,,"MUNICIPIUL SIGHETU MARMATIEI",89,"Liceul Ucrainean, Piata Libertatii nr.22",1348,640,628,12,0,629,11,1500,860,366,263,1,10042,0
26,"Maramures",106559,243,106559,,"MUNICIPIUL SIGHETU MARMATIEI",90,"S.C.  ACATERM  S.A., Piata Libertatii nr.25",1428,703,671,31,1,688,15,1600,897,361,327,1,10042,0
26,"Maramures",106559,243,106559,,"MUNICIPIUL SIGHETU MARMATIEI",91,"Scoala generala nr.2, strada Gheorghe Sincai nr.1",1418,671,660,11,0,660,11,1600,929,343,317,1,10042,0
26,"Maramures",106559,243,106559,,"MUNICIPIUL SIGHETU MARMATIEI",92,"Gradinita nr. 9, strada Gheorghe Sincai nr. 2",1666,788,770,18,0,783,5,1700,912,455,328,1,10042,0
26,"Maramures",106559,243,106559,,"MUNICIPIUL SIGHETU MARMATIEI",93,"Scoala generala nr. 9, strada Tudor Vladimirescu nr. 6-8 intrarea A",1421,701,680,21,0,692,9,1600,899,360,332,1,10042,0
26,"Maramures",106559,243,106559,,"MUNICIPIUL SIGHETU MARMATIEI",94,"Scoala generala nr.9, strada Tudor Vladimirescu nr. 6-8, intrarea B",1194,524,505,19,0,519,5,1300,776,286,233,1,10042,0
26,"Maramures",106559,243,106559,,"MUNICIPIUL SIGHETU MARMATIEI",95,"Liceul Industrial nr.1, strada Dragos Voda nr. 43",1929,851,833,18,0,844,7,2100,1249,438,406,1,10042,0
26,"Maramures",106559,243,106559,,"MUNICIPIUL SIGHETU MARMATIEI",96,"Scoala generala nr. 6, strada Dragos Voda nr. 244",1496,688,647,40,1,681,7,1600,912,346,335,1,10042,0
26,"Maramures",106559,243,106559,,"MUNICIPIUL SIGHETU MARMATIEI",97,"Scoala generala nr.10, strada Unirii  - Intrarea A",1512,722,709,13,0,712,10,1600,878,364,348,1,10042,0
26,"Maramures",106559,243,106559,,"MUNICIPIUL SIGHETU MARMATIEI",98,"Scoala generala nr.10, strada Unirii  - Intrarea B",1796,812,802,7,3,804,8,1900,1088,448,356,1,10042,0
26,"Maramures",106559,243,106559,,"MUNICIPIUL SIGHETU MARMATIEI",99,"Gradinita nr 1, Cartierul Bogdan Voda bloc A5 (parter)",1993,911,893,18,0,904,7,2100,1189,493,411,1,10042,0
26,"Maramures",106559,243,106559,,"MUNICIPIUL SIGHETU MARMATIEI",100,"Scoala generala nr.4, strada Bogdan Voda nr. 118 Intrarea A",1927,855,842,13,0,844,11,2100,1245,445,399,1,10042,0
26,"Maramures",106559,243,106559,,"MUNICIPIUL SIGHETU MARMATIEI",101,"Scoala generala nr.4, strada Bogdan Voda nr. 118 Intrarea B",1914,885,865,20,0,879,6,2100,1215,482,397,1,10042,0
26,"Maramures",106559,243,106559,,"MUNICIPIUL SIGHETU MARMATIEI",102,"Scoala generala nr.5, strada Bogdan Voda nr. 246",1136,528,518,10,0,521,7,1300,772,273,248,1,10042,0
26,"Maramures",106559,243,106559,,"MUNICIPIUL SIGHETU MARMATIEI",103,"Scoala generala nr.5, strada Bogdan Voda nr. 246",1347,650,639,11,0,644,6,1501,851,415,229,1,10042,0
26,"Maramures",106559,243,106559,,"MUNICIPIUL SIGHETU MARMATIEI",104,"Scoala generala nr. 7, Cartier Sugau",838,396,385,11,0,391,5,900,504,262,129,1,10042,0
26,"Maramures",106559,243,106559,,"MUNICIPIUL SIGHETU MARMATIEI",105,"Liceul   Regele Ferdinand , strada 22 Decembrie, nr.5",0,459,0,459,0,455,4,500,41,262,193,1,10042,1
26,"Maramures",106684,243,106684,,"ORAS BAIA SPRIE",106,"Scoala cu cls. I-VIII nr. 1, Piata Libertatii nr. 2",2411,1074,1047,26,1,1063,11,2600,1526,694,369,1,10049,0
26,"Maramures",106684,243,106684,,"ORAS BAIA SPRIE",107,"Grup scolar auto, Aleea Minerilor nr. 1",2379,1035,1025,10,0,1034,1,2500,1465,704,330,1,10049,0
26,"Maramures",106684,243,106684,,"ORAS BAIA SPRIE",108,"Scoala cu cls. I-VIII nr. 2, Microraion Vest",1592,657,644,13,0,654,3,1700,1043,445,209,1,10049,0
26,"Maramures",106684,243,106684,,"ORAS BAIA SPRIE",109,"Scoala cu cls. I-VIII nr. 2, Microraion Vest",1654,830,818,12,0,824,6,1800,970,594,230,1,10049,0
26,"Maramures",106684,243,106684,,"ORAS BAIA SPRIE",110,"Sala de sport, Ignis nr. 1",2027,978,966,12,0,973,5,2200,1222,698,275,1,10049,0
26,"Maramures",106684,243,106684,,"ORAS BAIA SPRIE",111,"Scoala cu cls. I-VIII, Chiuzbaia nr. 35",559,328,322,6,0,326,2,600,272,205,121,1,10049,0
26,"Maramures",106684,243,106684,,"ORAS BAIA SPRIE",112,"Scoala cu cls. I-VIII Ioan Slavici, Forestierilor 1",2187,1069,957,17,95,1054,15,2300,1231,614,440,1,10049,0
26,"Maramures",106684,243,106684,,"ORAS BAIA SPRIE",113,"Scoala cu cls. I-VIII, Satu Nou de Sus",842,459,451,8,0,457,2,901,442,349,108,1,10049,0
26,"Maramures",106684,243,106684,,"ORAS BAIA SPRIE",114,"Primarie, strada Piata Libertatii, nr. 5",0,106,0,106,0,105,1,400,294,73,32,1,10049,1
26,"Maramures",106746,243,106746,,"ORAS BORSA",115,"Scoala nr. 1 , strada Dragos Voda nr. 90",1917,638,632,6,0,626,12,2100,1462,398,228,1,10054,0
26,"Maramures",106746,243,106746,,"ORAS BORSA",116,"Joseni (U.M.), strada Libertatii nr. 154",1737,656,649,7,0,644,12,1900,1244,419,225,1,10054,0
26,"Maramures",106746,243,106746,,"ORAS BORSA",117,"Scoala nr. 8, Centru, strada Libertatii nr. 76",1700,719,711,8,0,712,7,1900,1181,455,257,1,10054,0
26,"Maramures",106746,243,106746,,"ORAS BORSA",118,"Scoala nr. 9, Centru, strada Decebal nr. 8",1862,680,669,11,0,671,9,2000,1320,370,301,1,10054,0
26,"Maramures",106746,243,106746,,"ORAS BORSA",119,"Casa de Cultura, strada Victoriei nr. 8",1707,671,663,8,0,667,4,1900,1229,419,248,1,10054,0
26,"Maramures",106746,243,106746,,"ORAS BORSA",120,"Spital, strada Floare de Colt nr. 1",1057,432,423,9,0,420,12,1200,768,297,123,1,10054,0
26,"Maramures",106746,243,106746,,"ORAS BORSA",121,"Scoala nr. 2 Garlea, strada Garlei nr. 31",973,397,389,8,0,394,3,1100,703,237,157,1,10054,0
26,"Maramures",106746,243,106746,,"ORAS BORSA",122,"Scoala Stiubeie, strada Victoriei nr. 72",871,344,339,5,0,341,3,1000,656,244,97,1,10054,0
26,"Maramures",106746,243,106746,,"ORAS BORSA",123,"Scoala Repedea, strada Repezii nr. 100",1750,657,646,11,0,651,6,1900,1243,402,249,1,10054,0
26,"Maramures",106746,243,106746,,"ORAS BORSA",124,"Scoala Poiana, strada A.I.Cuza nr. 73",1749,692,682,10,0,685,7,1899,1207,421,264,1,10054,0
26,"Maramures",106746,243,106746,,"ORAS BORSA",125,"Scoala Birt, strada A.I.Cuza nr. 249",1217,459,447,12,0,454,5,1400,941,330,124,1,10054,0
26,"Maramures",106746,243,106746,,"ORAS BORSA",126,"Scoala Fantana, strada Preluca Tatarilor nr. 1",1062,413,406,7,0,410,3,1200,787,317,93,1,10054,0
26,"Maramures",106746,243,106746,,"ORAS BORSA",127,"Scoala Rotundu, strada Unirii nr. 11",1825,676,668,8,0,667,9,2000,1324,408,259,1,10054,0
26,"Maramures",106746,243,106746,,"ORAS BORSA",128,"Scoala nr. 7 (corpul de pe strada Minerilor), Baia Borsa strada Minerilor nr. 48",1690,605,597,8,0,596,9,1800,1195,356,240,1,10054,0
26,"Maramures",106746,243,106746,,"ORAS BORSA",129,"Scoala nr. 7 Baia Borsa, strada Independentei nr. 22 A",1458,518,512,6,0,514,4,1600,1082,239,275,1,10054,0
26,"Maramures",106746,243,106746,,"ORAS BORSA",130,"Biblioteca oraseneasca, strada Libertatii, nr.26",0,302,0,302,0,293,9,401,99,172,121,1,10054,1
26,"Maramures",106782,243,106782,,"ORAS CAVNIC",131,"Grup scolar industrial Cavnic, strada 1 Mai nr. 15",1856,798,785,13,0,786,12,1997,1199,416,370,1,10057,0
26,"Maramures",106782,243,106782,,"ORAS CAVNIC",132,"Scoala generala nr. 2, strada Independentei nr. 2",1713,872,855,17,0,863,9,1900,1028,393,470,1,10057,0
26,"Maramures",106782,243,106782,,"ORAS CAVNIC",133,"Scoala generala nr. 1, strada Eliberarii nr. 55",830,259,249,7,3,257,2,901,642,158,99,1,10057,0
26,"Maramures",106782,243,106782,,"ORAS CAVNIC",134,"Scoala generala, nr.2, strada Independentei, nr.2",0,59,0,59,0,56,3,400,341,29,27,1,10057,1
26,"Maramures",108017,243,108017,,"ORAS DRAGOMIRESTI",135,"Camin cultural, strada 1 Decembrie 1918 nr. 149",898,450,426,20,4,444,6,1000,550,250,194,1,10059,0
26,"Maramures",108017,243,108017,,"ORAS DRAGOMIRESTI",136,"Camin cultural, strada 1 Decembrie 1918 nr. 150",1714,854,825,15,14,846,8,1900,1046,461,385,1,10059,0
26,"Maramures",108017,243,108017,,"ORAS DRAGOMIRESTI",137,"Camin cultural, strada 1 Decembrie 1918, nr.149",0,66,0,66,0,66,0,400,334,39,27,1,10059,1
26,"Maramures",108892,243,108892,,"ORAS SALISTEA DE SUS",138,"Casa de Cultura, strada Liviu Doru Bindea nr. 59",2311,1169,1157,12,0,1162,7,2500,1331,681,481,1,10061,0
26,"Maramures",108892,243,108892,,"ORAS SALISTEA DE SUS",139,"Scoala de arte si meserii  Mihai Eminescu , strada Liviu Doru Bindea nr. 107",2021,964,957,7,0,959,5,2200,1236,543,416,1,10061,0
26,"Maramures",108892,243,108892,,"ORAS SALISTEA DE SUS",140,"Scoala de arte si meserii  Mihai Eminescu , strada Liviu Doru Bindea nr. 107",0,57,0,57,0,57,0,400,343,31,26,1,10061,1
26,"Maramures",108963,243,108963,,"ORAS SEINI",141,"Casa de Cultura, strada Mihai Eminescu nr. 4",1654,754,747,7,0,749,5,1800,1046,491,258,1,10063,0
26,"Maramures",108963,243,108963,,"ORAS SEINI",142,"Gradinita de copii, strada Mihai Eminescu nr. 35",1955,800,786,12,2,791,9,2100,1300,491,300,1,10063,0
26,"Maramures",108963,243,108963,,"ORAS SEINI",143,"Scoala generala nr. 1, strada Nicolae Balcescu nr. 2",1728,824,806,18,0,815,9,1900,1076,511,304,1,10063,0
26,"Maramures",108963,243,108963,,"ORAS SEINI",144,"Scoala Maghiara, Piata Unirii nr. 11",1119,569,554,13,2,566,3,1300,731,349,217,1,10063,0
26,"Maramures",108963,243,108963,,"ORAS SEINI",145,"Gradinita de copii, Sabisa 42",633,310,301,9,0,310,0,700,390,191,119,1,10063,0
26,"Maramures",108963,243,108963,,"ORAS SEINI",146,"Scoala Viile Apei 75",476,246,235,11,0,244,2,500,254,153,91,1,10063,0
26,"Maramures",108963,243,108963,,"ORAS SEINI",147,"Primarie, Piata Unirii, nr.16",0,132,0,132,0,132,0,400,268,90,42,1,10063,1
26,"Maramures",109176,243,109176,,"ORAS SOMCUTA MARE",148,"Casa de Cultura, strada Nicolae Balcescu nr. 3",1514,871,858,10,3,859,12,1700,829,417,442,1,10067,0
26,"Maramures",109176,243,109176,,"ORAS SOMCUTA MARE",149,"Dispensar veterinar, strada N. Balcescu nr. 75",983,592,579,11,2,589,3,1100,508,276,313,1,10067,0
26,"Maramures",109176,243,109176,,"ORAS SOMCUTA MARE",150,"Scoala generala nr. 2, strada Miresului nr. 81",584,428,414,14,0,421,7,700,272,323,98,1,10067,0
26,"Maramures",109176,243,109176,,"ORAS SOMCUTA MARE",151,"Scoala generala Buciumi, nr. 61",639,419,413,5,1,414,5,700,281,215,199,1,10067,0
26,"Maramures",109176,243,109176,,"ORAS SOMCUTA MARE",152,"Scoala generala Buteasa, nr. 13",313,207,198,9,0,205,2,400,193,117,88,1,10067,0
26,"Maramures",109176,243,109176,,"ORAS SOMCUTA MARE",153,"Scoala generala Ciolt, nr. 151",505,288,281,7,0,288,0,602,314,149,139,1,10067,0
26,"Maramures",109176,243,109176,,"ORAS SOMCUTA MARE",154,"Scoala generala Codru Butesii, nr. 23",217,138,132,6,0,136,2,300,162,87,49,1,10067,0
26,"Maramures",109176,243,109176,,"ORAS SOMCUTA MARE",155,"Scoala generala Finteusu Mare, nr. 49",528,324,317,7,0,323,1,601,277,137,186,1,10067,0
26,"Maramures",109176,243,109176,,"ORAS SOMCUTA MARE",156,"Scoala generala Hovrila, nr. 78",253,191,184,7,0,190,1,300,109,93,97,1,10067,0
26,"Maramures",109176,243,109176,,"ORAS SOMCUTA MARE",157,"Scoala generala Valenii Somcutei, nr. 197",689,490,475,13,2,487,3,802,312,255,232,1,10067,0
26,"Maramures",109176,243,109176,,"ORAS SOMCUTA MARE",158,"Scoala generala cl. I-IV, strada Republicii nr.5",0,158,0,158,0,157,1,398,240,95,62,1,10067,1
26,"Maramures",106461,243,106461,,"ORAS TAUTII-MAGHERAUS",159,"Gradinita Magheraus, Strada 1 nr. 97",718,468,461,7,0,457,4,805,344,252,205,1,10091,0
26,"Maramures",106461,243,106461,,"ORAS TAUTII-MAGHERAUS",160,"Scoala cu cls. I-VIII, Strada 1 nr. 229",806,479,456,23,0,468,11,900,421,221,247,1,10091,0
26,"Maramures",106461,243,106461,,"ORAS TAUTII-MAGHERAUS",161,"Gradinita Hosteze, Strada 24 nr. 69",643,423,403,20,0,418,5,700,277,211,207,1,10091,0
26,"Maramures",106461,243,106461,,"ORAS TAUTII-MAGHERAUS",162,"Scoala generala Nistru Strada 103, nr. 1",606,357,349,8,0,356,1,700,343,159,197,1,10091,0
26,"Maramures",106461,243,106461,,"ORAS TAUTII-MAGHERAUS",163,"Gradinita 9 Mai",288,199,185,14,0,198,1,300,101,81,117,1,10091,0
26,"Maramures",106461,243,106461,,"ORAS TAUTII-MAGHERAUS",164,"Canton Silvic, Strada 73, nr. 244",179,130,113,17,0,130,0,200,70,70,60,1,10091,0
26,"Maramures",106461,243,106461,,"ORAS TAUTII-MAGHERAUS",165,"Scoala generala, Strada 89 nr. 11",931,561,543,17,1,550,11,1000,439,344,206,1,10091,0
26,"Maramures",106461,243,106461,,"ORAS TAUTII-MAGHERAUS",166,"Gradinita Rosti, Strada 73 nr. 111",416,269,255,14,0,268,1,502,233,131,137,1,10091,0
26,"Maramures",106461,243,106461,,"ORAS TAUTII-MAGHERAUS",167,"Scoala generala, Strada 129 nr. 11",480,291,282,9,0,288,3,500,209,115,173,1,10091,0
26,"Maramures",106461,243,106461,,"ORAS TAUTII-MAGHERAUS",168,"Caminul cultural, Strada 114, nr. 76",488,262,256,6,0,261,1,499,237,149,112,1,10091,0
26,"Maramures",106461,243,106461,,"ORAS TAUTII-MAGHERAUS",169,"Scoala generala, Strada 133, nr. 98",204,151,144,7,0,148,3,300,149,52,96,1,10091,0
26,"Maramures",106461,243,106461,,"ORAS TAUTII-MAGHERAUS",170,"Caminul cultural, Strada 141, nr. 35",158,110,104,6,0,110,0,200,90,47,63,1,10091,0
26,"Maramures",106461,243,106461,,"ORAS TAUTII-MAGHERAUS",171,"Scoala cu cls. I-VIII, strada 1, nr. 229",0,141,0,141,0,140,1,400,259,64,76,1,10091,1
26,"Maramures",106817,243,106817,,"ORAS TARGU LAPUS",172,"Casa oraseneasca de cultura, strada Piata Eroilor nr. 10",1690,786,775,11,0,777,9,1900,1114,362,415,1,10076,0
26,"Maramures",106817,243,106817,,"ORAS TARGU LAPUS",173,"Scoala generala pentru copii cu deficiente, strada Piata Eroilor nr. 31",1996,1012,1003,9,0,1005,7,2100,1088,452,553,1,10076,0
26,"Maramures",106817,243,106817,,"ORAS TARGU LAPUS",174,"Holul mare al Primariei, strada Tiblesului nr. 2",1425,707,700,7,0,698,9,1600,893,332,366,1,10076,0
26,"Maramures",106817,243,106817,,"ORAS TARGU LAPUS",175,"Scoala generala, nr.159",355,161,154,7,0,159,2,400,239,82,77,1,10076,0
26,"Maramures",106817,243,106817,,"ORAS TARGU LAPUS",176,"Scoala generala, nr. 117",417,282,274,8,0,275,7,500,218,200,75,1,10076,0
26,"Maramures",106817,243,106817,,"ORAS TARGU LAPUS",177,"Scoala generala, nr. 15",175,119,113,6,0,119,0,200,81,66,53,1,10076,0
26,"Maramures",106817,243,106817,,"ORAS TARGU LAPUS",178,"Scoala generala, nr. 302",781,302,294,8,0,300,2,900,598,188,112,1,10076,0
26,"Maramures",106817,243,106817,,"ORAS TARGU LAPUS",179,"Scoala generala, nr. 56",184,102,95,7,0,102,0,200,98,57,45,1,10076,0
26,"Maramures",106817,243,106817,,"ORAS TARGU LAPUS",180,"Scoala generala, nr. 53",332,186,179,7,0,183,3,400,214,131,52,1,10076,0
26,"Maramures",106817,243,106817,,"ORAS TARGU LAPUS",181,"Scoala generala, nr. 132",246,152,143,9,0,150,2,300,148,79,71,1,10076,0
26,"Maramures",106817,243,106817,,"ORAS TARGU LAPUS",182,"Scoala generala, nr. 6",63,48,39,9,0,47,1,100,52,19,28,1,10076,0
26,"Maramures",106817,243,106817,,"ORAS TARGU LAPUS",183,"Scoala generala, nr. 106",225,152,141,11,0,151,1,300,148,118,33,1,10076,0
26,"Maramures",106817,243,106817,,"ORAS TARGU LAPUS",184,"Camin cultural nr. 49",657,342,334,8,0,339,3,800,458,181,158,1,10076,0
26,"Maramures",106817,243,106817,,"ORAS TARGU LAPUS",185,"Scoala generala nr. 198",448,245,236,9,0,242,3,500,255,129,113,1,10076,0
26,"Maramures",106817,243,106817,,"ORAS TARGU LAPUS",186,"Camin cultural nr. 426",1306,579,573,6,0,576,3,1400,821,289,287,1,10076,0
26,"Maramures",106817,243,106817,,"ORAS TARGU LAPUS",187,"Gradinita, nr. 254",620,304,298,6,0,303,1,700,396,209,94,1,10076,0
26,"Maramures",106817,243,106817,,"ORAS TARGU LAPUS",188,"Scoala generala nr. 92",215,126,120,6,0,126,0,300,174,82,44,1,10076,0
26,"Maramures",106817,243,106817,,"ORAS TARGU LAPUS",189,"Spitalul nou (Holul Ambulatoriului de specialitate), strada Tineretului, nr.9-11",0,174,0,174,0,172,2,400,226,100,72,1,10076,1
26,"Maramures",109265,243,109265,,"ORAS ULMENI",190,"Camin Cultural, strada Dr. Florian C Ulmeanu, nr. 13",1278,772,765,5,2,768,4,1400,628,403,365,1,10099,0
26,"Maramures",109265,243,109265,,"ORAS ULMENI",191,"Scoala generala Kos Karoly",723,391,382,9,0,384,7,800,409,244,140,1,10099,0
26,"Maramures",109265,243,109265,,"ORAS ULMENI",192,"Scoala generala",1001,744,714,19,11,742,2,1097,353,547,195,1,10099,0
26,"Maramures",109265,243,109265,,"ORAS ULMENI",193,"Scoala generala",897,486,480,6,0,484,2,1000,514,184,300,1,10099,0
26,"Maramures",109265,243,109265,,"ORAS ULMENI",194,"Scoala generala",654,334,327,7,0,333,1,700,366,194,139,1,10099,0
26,"Maramures",109265,243,109265,,"ORAS ULMENI",195,"Scoala generala",189,113,104,9,0,111,2,200,87,52,59,1,10099,0
26,"Maramures",109265,243,109265,,"ORAS ULMENI",196,"Scoala generala",575,370,361,9,0,367,3,600,230,184,183,1,10099,0
26,"Maramures",109265,243,109265,,"ORAS ULMENI",197,"Camin cultural",309,147,138,9,0,145,2,400,253,48,97,1,10099,0
26,"Maramures",109265,243,109265,,"ORAS ULMENI",198,"Gradinita, strada Dr. Florian C Ulmeanu, nr.11",0,113,0,113,0,113,0,397,284,70,43,1,10099,1
26,"Maramures",106979,243,106979,,"ORAS VISEU DE SUS",199,"Scoala generala nr. 2, strada Dragos Voda nr. 68, Viseu de Mijloc",1135,491,482,9,0,490,1,1300,809,312,178,1,10108,0
26,"Maramures",106979,243,106979,,"ORAS VISEU DE SUS",200,"Scoala generala nr. 2, strada Dragos Voda nr. 68, Viseu de Mijloc",1169,449,438,11,0,444,5,1300,851,305,139,1,10108,0
26,"Maramures",106979,243,106979,,"ORAS VISEU DE SUS",201,"Liceul Bogdan Voda, strada M. Eminescu nr. 1",1954,869,862,7,0,855,14,2100,1231,546,309,1,10108,0
26,"Maramures",106979,243,106979,,"ORAS VISEU DE SUS",202,"Scoala de Arte si Meserii nr. 7, Aleea Eroilor nr. 8",1955,889,876,13,0,884,5,2100,1211,643,241,1,10108,0
26,"Maramures",106979,243,106979,,"ORAS VISEU DE SUS",203,"Scoala de Arte si Meserii nr. 7, Aleea Eroilor nr. 8",1292,505,490,14,1,502,3,1401,896,319,183,1,10108,0
26,"Maramures",106979,243,106979,,"ORAS VISEU DE SUS",204,"Scoala generala nr. 3, strada Rindunelelor nr. 80",800,353,348,5,0,348,5,902,549,298,50,1,10108,0
26,"Maramures",106979,243,106979,,"ORAS VISEU DE SUS",205,"Cantina de ajutor social, strada Carpati nr. 38",1960,978,962,16,0,970,8,2100,1122,627,343,1,10108,0
26,"Maramures",106979,243,106979,,"ORAS VISEU DE SUS",206,"Scoala generala nr. 1, strada Tudor Vladimirescu nr. 1",1370,479,465,14,0,473,6,1500,1021,332,141,1,10108,0
26,"Maramures",106979,243,106979,,"ORAS VISEU DE SUS",207,"Scoala generala nr. 1, strada Tudor Vladimirescu nr. 1",1387,516,513,3,0,509,7,1500,984,329,180,1,10108,0
26,"Maramures",106979,243,106979,,"ORAS VISEU DE SUS",208,"Scoala generala nr. 4, strada 1 Mai nr. 110",2107,876,868,8,0,861,15,2300,1424,593,268,1,10108,0
26,"Maramures",106979,243,106979,,"ORAS VISEU DE SUS",209,"Liceul teoretic Bogdan Voda, strada Mihai Eminescu nr.1",0,190,0,190,0,188,2,402,212,106,82,1,10108,1
26,"Maramures",107001,243,107001,,"ARDUSAT",210,"Scoala cu cls. I-VIII, strada Principala nr. 435",1459,653,646,7,0,648,5,1600,947,415,233,3,10111,0
26,"Maramures",107001,243,107001,,"ARDUSAT",211,"Scoala cu cls. I-IV, strada Principala nr. 78",198,107,99,8,0,107,0,200,93,76,31,3,10111,0
26,"Maramures",107001,243,107001,,"ARDUSAT",212,"Scoala cu cls. I-IV, strada Principala nr. 39",331,183,172,11,0,182,1,400,217,85,97,3,10111,0
26,"Maramures",107001,243,107001,,"ARDUSAT",213,"Scoala generala cu cls. I-VIII, strada Principala, nr.335",0,68,0,68,0,67,1,200,132,40,27,3,10111,1
26,"Maramures",107047,243,107047,,"ARINIS",214,"Caminul cultural, nr. 234",638,417,402,4,11,415,2,800,383,154,261,3,10115,0
26,"Maramures",107047,243,107047,,"ARINIS",215,"Scoala Tamasesti, nr. 204",205,144,134,10,0,143,1,300,156,56,87,3,10115,0
26,"Maramures",107047,243,107047,,"ARINIS",216,"Camin Cultural, strada Principala, nr.234",0,103,0,103,0,102,1,200,97,47,55,3,10115,1
26,"Maramures",107083,243,107083,,"ASUAJU DE SUS",217,"Primarie, Sala de sedinte",870,560,509,0,51,552,8,1000,440,176,376,3,10119,0
26,"Maramures",107083,243,107083,,"ASUAJU DE SUS",218,"Camin Cultural",321,187,171,13,3,183,4,400,213,76,107,3,10119,0
26,"Maramures",107083,243,107083,,"ASUAJU DE SUS",219,"Scoala generala , strada Principala, nr.282",0,111,0,111,0,108,3,200,89,54,54,3,10119,1
26,"Maramures",107118,243,107118,,"BAITA DE SUB CODRU",220,"Scoala cu clasele I-VIII, nr. 18",1172,703,685,3,15,701,2,1300,597,397,304,3,10122,0
26,"Maramures",107118,243,107118,,"BAITA DE SUB CODRU",221,"Scoala cu clasele I-IV, nr. 64",247,178,164,9,5,175,3,300,122,105,70,3,10122,0
26,"Maramures",107118,243,107118,,"BAITA DE SUB CODRU",222,"Scoala cu cls. I- VIII, strada Principala, nr. 18",0,85,0,85,0,84,1,200,115,49,35,3,10122,1
26,"Maramures",107154,243,107154,,"BAIUT",223,"Scoala generala, nr. 56",1489,557,542,5,10,557,0,1600,1043,277,280,3,10125,0
26,"Maramures",107154,243,107154,,"BAIUT",224,"Scoala generala, nr. 60",217,113,105,8,0,112,1,300,187,58,54,3,10125,0
26,"Maramures",107154,243,107154,,"BAIUT",225,"Scoala generala, nr. 236",507,208,191,16,1,207,1,600,392,91,116,3,10125,0
26,"Maramures",107154,243,107154,,"BAIUT",226,"Scoala de Arte si Meserii, strada Principala, nr.56",0,50,0,50,0,48,2,200,150,23,25,3,10125,1
26,"Maramures",107190,243,107190,,"BASESTI",227,"Primaria",485,260,256,4,0,258,2,600,340,126,132,3,10132,0
26,"Maramures",107190,243,107190,,"BASESTI",228,"Scoala cu cls. I-IV",342,202,185,4,13,202,0,396,194,109,93,3,10132,0
26,"Maramures",107190,243,107190,,"BASESTI",229,"Scoala cu cls. I-IV",98,68,57,7,4,67,1,100,32,44,23,3,10132,0
26,"Maramures",107190,243,107190,,"BASESTI",230,"Scoala cu cls. I-IV",260,147,136,11,0,145,2,300,153,89,56,3,10132,0
26,"Maramures",107190,243,107190,,"BASESTI",231,"Primarie (Sala de oaspeti), strada Principala, nr.133",0,102,0,102,0,102,0,200,98,65,37,3,10132,1
26,"Maramures",107234,243,107234,,"BICAZ",232,"Camin Cultural, nr. 93",462,224,222,2,0,223,1,500,276,57,166,3,10137,0
26,"Maramures",107234,243,107234,,"BICAZ",233,"Scoala cu cls. I-IV, Ciuta nr. 78",160,107,98,9,0,101,6,198,91,34,67,3,10137,0
26,"Maramures",107234,243,107234,,"BICAZ",234,"Caminul Cultural Corni nr. 62",265,155,146,9,0,154,1,300,145,62,92,3,10137,0
26,"Maramures",107234,243,107234,,"BICAZ",235,"Camin Cultural, strada Principala, Nr.93",0,43,0,43,0,43,0,200,157,16,27,3,10137,1
26,"Maramures",107270,243,107270,,"BISTRA",236,"Primaria comunei, nr. 315",845,363,358,5,0,362,1,900,537,169,193,3,10141,0
26,"Maramures",107270,243,107270,,"BISTRA",237,"Camin cultural Crasna Viseului, nr. 480",1304,606,593,13,0,594,12,1500,894,460,134,3,10141,0
26,"Maramures",107270,243,107270,,"BISTRA",238,"Scoala cu clasele I-VIII Valea Viseului nr. 99",1169,498,489,9,0,490,8,1300,802,336,154,3,10141,0
26,"Maramures",107270,243,107270,,"BISTRA",239,"Primarie (Sala de sedinta), strada Principala, nr.315",0,30,0,30,0,30,0,200,170,14,16,3,10141,1
26,"Maramures",107314,243,107314,,"BARSANA",240,"Camin Cultural, Barsana nr. 2",1499,735,725,10,0,732,3,1600,865,442,290,3,10129,0
26,"Maramures",107314,243,107314,,"BARSANA",241,"Scoala centru, nr. 4",1161,579,536,43,0,575,4,1300,721,296,279,3,10129,0
26,"Maramures",107314,243,107314,,"BARSANA",242,"Scoala Valea Muntelui nr. 7",620,266,239,27,0,262,4,700,434,176,86,3,10129,0
26,"Maramures",107314,243,107314,,"BARSANA",243,"Scoala Nanesti nr. 11",579,312,310,2,0,309,3,600,288,155,154,3,10129,0
26,"Maramures",107314,243,107314,,"BARSANA",244,"Scoala Mircea Vulcanescu, strada Principala , Nr.640",0,32,0,32,0,32,0,200,168,16,16,3,10129,1
26,"Maramures",107350,243,107350,,"BOCICOIU MARE",245,"Primarie nr. 136",495,237,225,12,0,235,2,500,263,126,109,3,10145,0
26,"Maramures",107350,243,107350,,"BOCICOIU MARE",246,"Scoala cu cls. I-VIII, nr 247",1250,623,616,7,0,617,6,1400,777,296,321,3,10145,0
26,"Maramures",107350,243,107350,,"BOCICOIU MARE",247,"Scoala cu cls. I-VIII, nr 106",731,277,267,10,0,273,4,800,523,105,168,3,10145,0
26,"Maramures",107350,243,107350,,"BOCICOIU MARE",248,"Scoala cu cls. I-VIII, nr 350",1130,515,506,9,0,512,3,1300,785,290,222,3,10145,0
26,"Maramures",107350,243,107350,,"BOCICOIU MARE",249,"Scoala generala cu cls. I - VIII, strada Principala , Nr.149",0,28,0,28,0,28,0,200,172,14,14,3,10145,1
26,"Maramures",107403,243,107403,,"BOGDAN VODA",250,"Clubul Camin Cultural, nr. 363",2065,906,899,7,0,899,7,2200,1294,415,484,3,10150,0
26,"Maramures",107403,243,107403,,"BOGDAN VODA",251,"Scoala generala Bocicoel, nr. 274",629,330,307,23,0,326,4,700,370,77,249,3,10150,0
26,"Maramures",107403,243,107403,,"BOGDAN VODA",252,"Club Camin cultural, strada Principala, nr.363",0,33,0,33,0,33,0,200,167,21,12,3,10150,1
26,"Maramures",107430,243,107430,,"BOIU MARE",253,"Primarie nr. 204",475,235,231,4,0,231,4,500,265,92,139,3,10153,0
26,"Maramures",107430,243,107430,,"BOIU MARE",254,"Scoala generala, nr. 47",57,42,34,8,0,42,0,100,58,13,29,3,10153,0
26,"Maramures",107430,243,107430,,"BOIU MARE",255,"Scoala cu cls. I-IV, nr. 148",375,264,258,6,0,263,1,400,136,130,133,3,10153,0
26,"Maramures",107430,243,107430,,"BOIU MARE",256,"Scoala generala, nr. 40",70,40,33,7,0,40,0,99,59,6,34,3,10153,0
26,"Maramures",107430,243,107430,,"BOIU MARE",257,"Scoala cu cls. I-VIII, strada Principala, nr.203",0,47,0,47,0,47,0,200,153,17,30,3,10153,1
26,"Maramures",107485,243,107485,,"BOTIZA",258,"Primaria Botiza, nr. 416",2189,1467,1453,4,10,1454,13,2300,833,488,966,3,10158,0
26,"Maramures",107485,243,107485,,"BOTIZA",259,"Primarie, strada Principala, nr.416",0,34,0,34,0,34,0,200,166,16,18,3,10158,1
26,"Maramures",107519,243,107519,,"BUDESTI",260,"Primarie, nr. 816",1278,665,656,9,0,656,9,1400,735,317,339,3,10160,0
26,"Maramures",107519,243,107519,,"BUDESTI",261,"Gradinita si Scoala Budesti-Susani, nr. 543",719,360,351,9,0,355,5,800,440,124,231,3,10160,0
26,"Maramures",107519,243,107519,,"BUDESTI",262,"Scoala cu cls. I-VIII nr. 25",715,339,328,11,0,338,1,800,461,181,157,3,10160,0
26,"Maramures",107519,243,107519,,"BUDESTI",263,"Primarie, strada Principala, nr.816",0,24,0,24,0,24,0,200,176,11,13,3,10160,1
26,"Maramures",107546,243,107546,,"CALINESTI",264,"Camin cultural, Calinesti 179",1221,676,661,13,2,669,7,1396,720,398,271,3,10163,0
26,"Maramures",107546,243,107546,,"CALINESTI",265,"Camin Cultural Cornesti 21",374,178,170,8,0,178,0,400,222,96,82,3,10163,0
26,"Maramures",107546,243,107546,,"CALINESTI",266,"Camin cultural Valeni 457",1106,597,592,5,0,597,0,1200,603,253,344,3,10163,0
26,"Maramures",107546,243,107546,,"CALINESTI",267,"Primarie, strada Principala, nr.26",0,36,0,36,0,36,0,200,164,16,20,3,10163,1
26,"Maramures",107582,243,107582,,"CERNESTI",268,"Scoala generala nr. 152",651,390,380,10,0,389,1,700,310,167,222,3,10169,0
26,"Maramures",107582,243,107582,,"CERNESTI",269,"Scoala generala nr. 28",187,105,98,7,0,104,1,200,95,66,38,3,10169,0
26,"Maramures",107582,243,107582,,"CERNESTI",270,"Gradinita nr. 377/A",884,396,388,7,1,393,3,1000,604,208,185,3,10169,0
26,"Maramures",107582,243,107582,,"CERNESTI",271,"Camin cultural nr. 18",520,262,252,10,0,260,2,604,342,116,144,3,10169,0
26,"Maramures",107582,243,107582,,"CERNESTI",272,"Scoala generala nr. 71",180,113,103,10,0,113,0,200,87,57,56,3,10169,0
26,"Maramures",107582,243,107582,,"CERNESTI",273,"Scoala generala, nr. 164",535,319,306,13,0,317,2,600,281,120,197,3,10169,0
26,"Maramures",107582,243,107582,,"CERNESTI",274,"Primarie, strada Principala, nr. 146",0,58,0,58,0,58,0,200,142,30,28,3,10169,1
26,"Maramures",107662,243,107662,,"CICARLAU",275,"Camin cultural Cicarlau, nr. 742",1747,931,917,10,4,925,6,1900,969,670,255,3,10177,0
26,"Maramures",107662,243,107662,,"CICARLAU",276,"Camin Cultural, nr. 130",1097,497,487,10,0,495,2,1200,703,309,186,3,10177,0
26,"Maramures",107662,243,107662,,"CICARLAU",277,"Camin cultural Handalu Ilbei nr. 40",382,175,167,8,0,174,1,400,225,101,73,3,10177,0
26,"Maramures",107662,243,107662,,"CICARLAU",278,"Primarie, strada Principala, nr. 389",0,96,0,96,0,94,2,200,104,67,27,3,10177,1
26,"Maramures",107715,243,107715,,"CAMPULUNG LA TISA",279,"Caminul Cultural Campulung la Tisa nr. 253",2044,667,662,5,0,656,11,2200,1533,362,294,3,10167,0
26,"Maramures",107715,243,107715,,"CAMPULUNG LA TISA",280,"Camin cultural, strada Principala, nr.253",0,35,0,35,0,33,2,200,165,21,12,3,10167,1
26,"Maramures",179837,243,179837,,"COAS",281,"Camin cultural nr. 268",1089,621,588,3,30,610,11,1200,579,353,257,3,10182,0
26,"Maramures",179837,243,179837,,"COAS",282,"Scoala generala nr. 26",63,58,46,12,0,57,1,100,42,17,40,3,10182,0
26,"Maramures",179837,243,179837,,"COAS",283,"Clubul Pensionarilor nr. 268, strada Principala, nr.265/A",0,53,0,53,0,51,2,195,142,18,33,3,10182,1
26,"Maramures",179846,243,179846,,"COLTAU",284,"Casa de cultura nr. 68",1746,954,948,6,0,946,8,1900,946,544,402,3,10185,0
26,"Maramures",179846,243,179846,,"COLTAU",285,"Camin cultural ( Sala mare), strada Principala, nr .68",0,57,0,57,0,57,0,200,143,33,24,3,10185,1
26,"Maramures",107733,243,107733,,"COPALNIC-MANASTUR",286,"Caminul Cultural nr 225",684,358,349,7,2,352,6,700,342,180,172,3,10188,0
26,"Maramures",107733,243,107733,,"COPALNIC-MANASTUR",287,"Caminul cultural nr. 171",591,373,364,9,0,373,0,700,327,199,174,3,10188,0
26,"Maramures",107733,243,107733,,"COPALNIC-MANASTUR",288,"Scoala, nr 35",557,209,194,15,0,206,3,600,391,125,81,3,10188,0
26,"Maramures",107733,243,107733,,"COPALNIC-MANASTUR",289,"Scoala,  nr 49",81,39,29,10,0,39,0,100,61,28,11,3,10188,0
26,"Maramures",107733,243,107733,,"COPALNIC-MANASTUR",290,"Scoala gen., nr 36",278,159,148,11,0,158,1,300,141,61,97,3,10188,0
26,"Maramures",107733,243,107733,,"COPALNIC-MANASTUR",291,"Scoala, nr 35",198,82,75,7,0,82,0,200,118,46,36,3,10188,0
26,"Maramures",107733,243,107733,,"COPALNIC-MANASTUR",292,"Caminul cultural nr. 159",658,348,342,5,1,347,1,700,352,133,214,3,10188,0
26,"Maramures",107733,243,107733,,"COPALNIC-MANASTUR",293,"Caminul Cultural, nr 20",427,222,217,5,0,221,1,500,278,96,125,3,10188,0
26,"Maramures",107733,243,107733,,"COPALNIC-MANASTUR",294,"Scoala, nr 78",257,122,111,11,0,121,1,300,178,44,77,3,10188,0
26,"Maramures",107733,243,107733,,"COPALNIC-MANASTUR",295,"Scoala, nr. 73",316,176,165,11,0,175,1,400,224,126,49,3,10188,0
26,"Maramures",107733,243,107733,,"COPALNIC-MANASTUR",296,"Caminul Cultural, nr 116",217,128,120,8,0,127,1,300,172,82,45,3,10188,0
26,"Maramures",107733,243,107733,,"COPALNIC-MANASTUR",297,"Scoala, nr 54",302,173,163,10,0,173,0,400,227,66,107,3,10188,0
26,"Maramures",107733,243,107733,,"COPALNIC-MANASTUR",298,"Clubul Caminului cultural, strada Principala, nr. 225",0,95,0,95,0,95,0,200,105,50,45,3,10188,1
26,"Maramures",107868,243,107868,,"COROIENI",299,"Primarie, nr. 161",353,208,192,7,9,206,2,400,192,147,59,3,10201,0
26,"Maramures",107868,243,107868,,"COROIENI",300,"Scoala cls. I-IV, Baba 117",417,276,255,7,14,273,3,500,224,228,45,3,10201,0
26,"Maramures",107868,243,107868,,"COROIENI",301,"Scoala  cls. I-IV, Dealu Mare 71",222,132,121,7,4,132,0,300,168,60,72,3,10201,0
26,"Maramures",107868,243,107868,,"COROIENI",302,"Scoala cls. I-IV, Draghia 68",178,114,103,10,1,113,1,200,86,63,50,3,10201,0
26,"Maramures",107868,243,107868,,"COROIENI",303,"Scoala generala, Valenii Lapusului 63",611,403,384,12,7,396,7,702,299,285,111,3,10201,0
26,"Maramures",107868,243,107868,,"COROIENI",304,"Primarie, strada Principala, nr.161",0,58,0,58,0,57,1,200,142,33,24,3,10201,1
26,"Maramures",107920,243,107920,,"CUPSENI",305,"Scoala cls. I-VIII, Cupseni nr. 225",682,417,391,9,17,412,5,700,283,328,84,3,10207,0
26,"Maramures",107920,243,107920,,"CUPSENI",306,"Scoala cls. I-VIII, Costeni nr. 30",394,217,211,6,0,216,1,400,183,157,59,3,10207,0
26,"Maramures",107920,243,107920,,"CUPSENI",307,"Scoala cls. I-IV, Libotin nr. 342",947,561,553,7,1,557,4,1000,439,344,213,3,10207,0
26,"Maramures",107920,243,107920,,"CUPSENI",308,"Scoala cls. I-VIII, Ungureni nr. 108",1074,492,481,11,0,488,4,1100,608,120,368,3,10207,0
26,"Maramures",107920,243,107920,,"CUPSENI",309,"Scoala Coordonatoare, strada Principala, nr. 255",0,38,0,38,0,38,0,200,162,11,27,3,10207,1
26,"Maramures",107975,243,107975,,"DESESTI",310,"Camin cultural Desesti nr. 328",803,521,505,3,13,518,3,900,379,324,194,3,10212,0
26,"Maramures",107975,243,107975,,"DESESTI",311,"Camin cultural Harnicesti nr. 72",495,287,269,6,12,285,2,500,213,216,69,3,10212,0
26,"Maramures",107975,243,107975,,"DESESTI",312,"Scoala generala Mara nr. 306",812,594,559,4,31,591,3,900,306,481,110,3,10212,0
26,"Maramures",107975,243,107975,,"DESESTI",313,"Camin Cultural, strada Principala, nr. 328",0,78,0,78,0,78,0,200,122,53,25,3,10212,1
26,"Maramures",108035,243,108035,,"DUMBRAVITA",314,"Scoala veche, nr. 343",944,518,506,10,2,515,3,1000,482,357,158,3,10216,0
26,"Maramures",108035,243,108035,,"DUMBRAVITA",315,"Scoala Chechis, nr. 155",733,417,412,5,0,415,2,800,383,236,179,3,10216,0
26,"Maramures",108035,243,108035,,"DUMBRAVITA",316,"Scoala Carbunari, nr. 27",489,314,305,9,0,313,1,500,186,200,113,3,10216,0
26,"Maramures",108035,243,108035,,"DUMBRAVITA",317,"Scoala Rus, nr. 183",540,275,269,6,0,272,3,602,327,177,95,3,10216,0
26,"Maramures",108035,243,108035,,"DUMBRAVITA",318,"Scoala Sindresti, nr. 91",475,278,272,6,0,277,1,501,223,150,127,3,10216,0
26,"Maramures",108035,243,108035,,"DUMBRAVITA",319,"Scoala Unguras, nr. 42",369,229,220,9,0,228,1,400,171,101,127,3,10216,0
26,"Maramures",108035,243,108035,,"DUMBRAVITA",320,"Scoala Veche, strada Principala, nr. 344",0,91,0,91,0,91,0,200,109,39,52,3,10216,1
26,"Maramures",108106,243,108106,,"FARCASA",321,"Camin Cultural, Independentei 62",1740,836,826,8,2,832,4,1900,1064,529,303,3,10223,0
26,"Maramures",108106,243,108106,,"FARCASA",322,"Camin Cultural, Victoriei 15",1274,529,518,11,0,513,16,1401,872,305,208,3,10223,0
26,"Maramures",108106,243,108106,,"FARCASA",323,"Camin Cultural, strada Independentei, nr. 62",0,96,0,96,0,96,0,200,104,63,33,3,10223,1
26,"Maramures",179855,243,179855,,"GARDANI",324,"Camin Cultural Gardani, strada Principala nr. 452",1116,670,647,6,17,667,3,1300,630,389,278,3,10228,0
26,"Maramures",179855,243,179855,,"GARDANI",325,"Camin Cultural ( Sala Mica), strada Principala, nr. 452",0,48,0,48,0,48,0,200,152,30,18,3,10228,1
26,"Maramures",108151,243,108151,,"GIULESTI",326,"Camin cultural, nr. 113",1479,648,644,4,0,642,6,1600,952,298,344,3,10230,0
26,"Maramures",108151,243,108151,,"GIULESTI",327,"Camin cultural, nr. 273",1259,581,574,7,0,575,6,1400,819,330,245,3,10230,0
26,"Maramures",108151,243,108151,,"GIULESTI",328,"Primarie, strada Principala, nr.114",0,48,0,48,0,48,0,200,152,21,27,3,10230,1
26,"Maramures",106363,243,106363,,"GROSI",329,"Primaria, Grosi nr. 187",1016,601,590,9,2,595,6,1200,599,419,176,3,10235,0
26,"Maramures",106363,243,106363,,"GROSI",330,"Scoala generala Ocolis, nr. 138",342,121,115,6,0,119,2,400,279,75,44,3,10235,0
26,"Maramures",106363,243,106363,,"GROSI",331,"Scoala generala Satu Nou de Jos nr. 194",732,378,369,9,0,376,2,800,422,245,131,3,10235,0
26,"Maramures",106363,243,106363,,"GROSI",332,"Scoala cu cls.I-VIII, strada Principala, nr. 174",0,38,0,38,0,38,0,200,162,29,9,3,10235,1
26,"Maramures",179622,243,179622,,"GROSII TIBLESULUI",333,"Gradinita cu program normal, strada Principala nr.  559",948,549,539,10,0,542,7,1000,451,291,251,3,10239,0
26,"Maramures",179622,243,179622,,"GROSII TIBLESULUI",334,"Scoala cls. I-IV Greble, strada Principala nr. 416",796,486,477,9,0,483,3,900,414,268,215,3,10239,0
26,"Maramures",179622,243,179622,,"GROSII TIBLESULUI",335,"Scoala generala cu cls. I-IV Greble, strada Principala, nr. 416",0,49,0,49,0,49,0,200,151,29,20,3,10239,1
26,"Maramures",108204,243,108204,,"IEUD",336,"Camin cultural nr. 225",2933,1385,1360,17,8,1378,7,3200,1815,629,749,3,10241,0
26,"Maramures",108204,243,108204,,"IEUD",337,"Scoala Plopsor nr. 1198",318,121,110,10,1,119,1,400,279,52,67,3,10241,0
26,"Maramures",108204,243,108204,,"IEUD",338,"Scoala generala, strada Principala, nr. 225",0,51,0,51,0,50,1,201,150,19,31,3,10241,1
26,"Maramures",108222,243,108222,,"LAPUS",339,"Primaria, nr. 1027",1487,726,709,17,0,723,3,1600,874,430,293,3,10243,0
26,"Maramures",108222,243,108222,,"LAPUS",340,"Camin cultural, nr. 828",1568,836,819,17,0,827,9,1700,864,549,278,3,10243,0
26,"Maramures",108222,243,108222,,"LAPUS",341,"Gradinita nr.1, strada Principala, nr.1028",0,49,0,49,0,49,0,200,151,36,13,3,10243,1
26,"Maramures",108240,243,108240,,"LEORDINA",342,"Primaria, nr. 874",2019,1000,986,14,0,990,10,2200,1200,468,522,3,10245,0
26,"Maramures",108240,243,108240,,"LEORDINA",343,"Scoala generala nr.1, strada Principala, nr. 963",0,37,0,37,0,37,0,200,163,11,26,3,10245,1
26,"Maramures",108268,243,108268,,"MIRESU MARE",344,"Primaria Miresu Mare nr. 486",1154,635,622,12,1,629,6,1300,665,414,215,3,10247,0
26,"Maramures",108268,243,108268,,"MIRESU MARE",345,"Camin Cultural nr. 77",407,235,228,7,0,233,2,505,270,116,117,3,10247,0
26,"Maramures",108268,243,108268,,"MIRESU MARE",346,"Scoala generala Iadara nr. 48",803,496,489,7,0,493,3,900,404,308,185,3,10247,0
26,"Maramures",108268,243,108268,,"MIRESU MARE",347,"Gradinita Lucacesti nr. 177",493,251,242,7,2,247,4,500,249,155,92,3,10247,0
26,"Maramures",108268,243,108268,,"MIRESU MARE",348,"Scoala generala, nr. 39",467,276,265,11,0,272,4,500,224,120,152,3,10247,0
26,"Maramures",108268,243,108268,,"MIRESU MARE",349,"Scoala generala, nr. 92",526,284,271,13,0,282,2,600,316,147,135,3,10247,0
26,"Maramures",108268,243,108268,,"MIRESU MARE",350,"Camin cultural, strada Principala, nr. 504",0,139,0,139,0,138,1,200,61,88,50,3,10247,1
26,"Maramures",108348,243,108348,,"MOISEI",351,"Scoala nr. 4",1012,508,498,10,0,505,3,1201,693,331,174,3,10255,0
26,"Maramures",108348,243,108348,,"MOISEI",352,"Scoala nr. 3",1524,843,828,15,0,835,8,1700,857,548,287,3,10255,0
26,"Maramures",108348,243,108348,,"MOISEI",353,"Primaria Moisei",2337,1269,1263,5,1,1262,7,2500,1231,846,416,3,10255,0
26,"Maramures",108348,243,108348,,"MOISEI",354,"Scoala nr. 2",2487,1151,1135,16,0,1141,10,2600,1449,801,340,3,10255,0
26,"Maramures",108348,243,108348,,"MOISEI",355,"Camin cultural, strada Principala, nr. 391",0,114,0,114,0,113,1,200,86,90,23,3,10255,1
26,"Maramures",108366,243,108366,,"OARTA DE JOS",356,"Primarie, nr. 216",425,253,243,10,0,252,1,500,247,103,149,3,10257,0
26,"Maramures",108366,243,108366,,"OARTA DE JOS",357,"Scoala generala, nr. 263",630,364,342,11,11,361,3,700,336,188,173,3,10257,0
26,"Maramures",108366,243,108366,,"OARTA DE JOS",358,"Scoala generala, strada Principala, nr. 30",0,66,0,66,0,66,0,200,134,33,33,3,10257,1
26,"Maramures",108400,243,108400,,"OCNA SUGATAG",359,"Sala festivitati, strada Unirii 41",1271,605,599,5,1,604,1,1400,795,367,237,3,10261,0
26,"Maramures",108400,243,108400,,"OCNA SUGATAG",360,"Camin cultural, nr. 20",940,391,385,6,0,388,3,1000,609,290,98,3,10261,0
26,"Maramures",108400,243,108400,,"OCNA SUGATAG",361,"Camin cultural, nr. 22",284,177,165,12,0,175,2,300,123,126,49,3,10261,0
26,"Maramures",108400,243,108400,,"OCNA SUGATAG",362,"Camin cultural, nr. 321",981,448,438,10,0,448,0,1100,652,266,182,3,10261,0
26,"Maramures",108400,243,108400,,"OCNA SUGATAG",363,"Primarie, strada Unirii, nr.66",0,116,0,116,0,115,1,200,84,62,53,3,10261,1
26,"Maramures",179864,243,179864,,"ONCESTI",364,"Camin cultural",1263,649,645,4,0,633,16,1400,751,236,397,3,10266,0
26,"Maramures",179864,243,179864,,"ONCESTI",365,"Scoala cu cls. I-VIII, strada Principala, nr.19",0,34,0,34,0,34,0,200,166,10,24,3,10266,1
26,"Maramures",108455,243,108455,,"PETROVA",366,"Grup scolar  Alexandru Filipascu , nr. 282",2036,1012,998,9,5,1006,6,2200,1188,519,487,3,10268,0
26,"Maramures",108455,243,108455,,"PETROVA",367,"Grup Scolar   Alexandru Filipascu , strada Principala, nr. 281",0,61,0,61,0,61,0,200,139,29,32,3,10268,1
26,"Maramures",108473,243,108473,,"POIENILE DE SUB MUNTE",368,"Scoala de arte si meserii nr. 1",1301,612,597,15,0,600,12,1400,788,234,366,3,10270,0
26,"Maramures",108473,243,108473,,"POIENILE DE SUB MUNTE",369,"Caminul Cultural",1687,901,889,12,0,880,21,1800,899,297,583,3,10270,0
26,"Maramures",108473,243,108473,,"POIENILE DE SUB MUNTE",370,"Scoala de arte si meserii nr. 1 Nejni Crai",1925,908,897,11,0,898,10,2100,1192,403,495,3,10270,0
26,"Maramures",108473,243,108473,,"POIENILE DE SUB MUNTE",371,"Scoala cu clasele I-VIII nr. 4 Horb",1318,617,607,10,0,609,8,1500,883,200,409,3,10270,0
26,"Maramures",108473,243,108473,,"POIENILE DE SUB MUNTE",372,"Scoala cu clasele I-VIII nr. 2 Luhei",810,425,415,10,0,422,3,900,475,92,330,3,10270,0
26,"Maramures",108473,243,108473,,"POIENILE DE SUB MUNTE",373,"Scoala de Arte si Meserii nr.1, strada Principala, nr. 1406/C",0,63,0,63,0,58,5,200,137,22,36,3,10270,1
26,"Maramures",179604,243,179604,,"POIENILE IZEI",374,"Primaria Poienile Izei nr. 349",830,545,537,2,6,542,3,900,355,201,341,3,10272,0
26,"Maramures",179604,243,179604,,"POIENILE IZEI",375,"Primarie, strada Principala, nr. 349",0,57,0,57,0,57,0,200,143,19,38,3,10272,1
26,"Maramures",106407,243,106407,,"RECEA",376,"Scoala cu clasele I-VIII, strada Europa nr. 75",932,576,552,5,19,574,2,1000,424,311,263,3,10274,0
26,"Maramures",106407,243,106407,,"RECEA",377,"Scoala cu clasele I-VIII, strada Principala nr. 19",321,219,202,14,3,214,5,400,181,118,96,3,10274,0
26,"Maramures",106407,243,106407,,"RECEA",378,"Scoala cu clasele I-VIII, strada Unirii nr. 48",1125,679,654,11,14,678,1,1300,621,386,292,3,10274,0
26,"Maramures",106407,243,106407,,"RECEA",379,"Scoala cu clasele I-IV, strada Scolii nr. 12",706,547,512,12,23,540,7,800,253,267,273,3,10274,0
26,"Maramures",106407,243,106407,,"RECEA",380,"Scoala cu clasele I-VIII, strada 1 Decembrie nr. 186",1552,949,939,10,0,946,3,1700,751,619,327,3,10274,0
26,"Maramures",106407,243,106407,,"RECEA",381,"Scoala cu cls. I-VIII, strada Europa, nr.75",0,139,0,139,0,139,0,200,61,61,78,3,10274,1
26,"Maramures",108491,243,108491,,"REMETEA CHIOARULUI",382,"Caminul Cultural",837,434,424,8,2,432,2,900,466,246,186,3,10280,0
26,"Maramures",108491,243,108491,,"REMETEA CHIOARULUI",383,"Caminul cultural",513,246,237,9,0,243,3,600,354,152,91,3,10280,0
26,"Maramures",108491,243,108491,,"REMETEA CHIOARULUI",384,"Scoala cu clasele I-IV",374,138,129,9,0,138,0,400,262,72,66,3,10280,0
26,"Maramures",108491,243,108491,,"REMETEA CHIOARULUI",385,"Caminul cultural",278,160,149,11,0,159,1,300,140,96,63,3,10280,0
26,"Maramures",108491,243,108491,,"REMETEA CHIOARULUI",386,"Scoala Remecioara",191,107,97,10,0,106,1,200,93,56,50,3,10280,0
26,"Maramures",108491,243,108491,,"REMETEA CHIOARULUI",387,"Camin Cultural (Sala Club), strada Principala, nr. 128",0,69,0,69,0,69,0,200,131,33,36,3,10280,1
26,"Maramures",108552,243,108552,,"REMETI",388,"Scoala cu clasele I-VIII",2078,981,973,8,0,972,9,2200,1219,535,437,3,10286,0
26,"Maramures",108552,243,108552,,"REMETI",389,"Scoala cu clasele I-IV Piatra",313,143,135,8,0,142,1,400,257,99,43,3,10286,0
26,"Maramures",108552,243,108552,,"REMETI",390,"Scoala cu clasele I-IV Teceu Mic",140,60,54,6,0,60,0,200,140,42,18,3,10286,0
26,"Maramures",108552,243,108552,,"REMETI",391,"Scoala cu cls. I-VIII, strada Principala, nr. 41",0,41,0,41,0,40,1,200,159,26,14,3,10286,1
26,"Maramures",108598,243,108598,,"REPEDEA",392,"Camin cultural Repedea",2261,1121,1105,16,0,1092,29,2400,1279,350,742,3,10290,0
26,"Maramures",108598,243,108598,,"REPEDEA",393,"Scoala cu cls. I-VIII Miclusa",1058,589,572,17,0,582,7,1200,611,223,359,3,10290,0
26,"Maramures",108598,243,108598,,"REPEDEA",394,"Primarie, strada Principala, nr. 98",0,34,0,34,0,34,0,200,166,7,27,3,10290,1
26,"Maramures",108614,243,108614,,"RONA DE JOS",395,"Scoala generala  Laurentiu Ulici , nr. 667",1751,732,728,4,0,729,3,1900,1168,379,350,3,10292,0
26,"Maramures",108614,243,108614,,"RONA DE JOS",396,"Scoala cu clasele I- VIII   Laurentiu Ulici , strada Principala, nr.  667",0,31,0,31,0,30,1,200,169,17,13,3,10292,1
26,"Maramures",108632,243,108632,,"RONA DE SUS",397,"Camin cultural, nr. 1283",1734,572,561,5,6,559,13,1900,1328,176,383,3,10294,0
26,"Maramures",108632,243,108632,,"RONA DE SUS",398,"Camin cultural, nr. 1283",1507,485,480,4,1,479,6,1600,1115,160,319,3,10294,0
26,"Maramures",108632,243,108632,,"RONA DE SUS",399,"Clubul Tineretului, nr. 66",593,258,244,8,6,255,3,700,442,117,138,3,10294,0
26,"Maramures",108632,243,108632,,"RONA DE SUS",400,"Primarie, strada Principala, nr. 1286",0,32,0,32,0,32,0,200,168,10,22,3,10294,1
26,"Maramures",108669,243,108669,,"ROZAVLEA",401,"Primarie, strada Principala nr. 348",2018,1002,972,11,19,996,6,2199,1197,599,397,3,10297,0
26,"Maramures",108669,243,108669,,"ROZAVLEA",402,"Scoala Salta, strada Salta nr. 107",652,339,327,11,1,338,1,700,361,202,136,3,10297,0
26,"Maramures",108669,243,108669,,"ROZAVLEA",403,"Primarie, strada Principala, nr. 348",0,54,0,54,0,54,0,200,146,34,20,3,10297,1
26,"Maramures",108696,243,108696,,"RUSCOVA",404,"Gradinita, nr. 124",1888,789,770,19,0,778,11,2000,1211,418,360,3,10300,0
26,"Maramures",108696,243,108696,,"RUSCOVA",405,"Clubul Tineretului",1244,578,504,74,0,566,12,1399,821,302,264,3,10300,0
26,"Maramures",108696,243,108696,,"RUSCOVA",406,"Scoala nr. 2 Oblaz",1103,469,404,65,0,461,8,1200,731,297,164,3,10300,0
26,"Maramures",108696,243,108696,,"RUSCOVA",407,"Camin cultural, strada Principala, nr. 905",0,49,0,49,0,49,0,200,151,26,23,3,10300,1
26,"Maramures",106620,243,106620,,"SARASAU",408,"Camin cultural, nr. 203",2052,1068,1065,3,0,1059,9,2200,1132,777,282,3,10312,0
26,"Maramures",106620,243,106620,,"SARASAU",409,"Camin cultural, strada Principala, nr. 203",0,27,0,27,0,27,0,200,173,16,11,3,10312,1
26,"Maramures",108712,243,108712,,"SATULUNG",410,"Scoala cu clasele I-VIII",1201,711,703,7,1,706,5,1305,594,423,283,3,10314,0
26,"Maramures",108712,243,108712,,"SATULUNG",411,"Scoala cu clasele I-IV",165,126,117,9,0,126,0,200,74,72,54,3,10314,0
26,"Maramures",108712,243,108712,,"SATULUNG",412,"Scoala cu clasele I-IV",577,323,315,8,0,320,3,600,277,192,128,3,10314,0
26,"Maramures",108712,243,108712,,"SATULUNG",413,"Scoala cu clasele I-VIII",661,415,408,7,0,412,3,700,285,163,249,3,10314,0
26,"Maramures",108712,243,108712,,"SATULUNG",414,"Scoala cu clasele I-VIII",456,262,255,7,0,258,4,480,218,100,158,3,10314,0
26,"Maramures",108712,243,108712,,"SATULUNG",415,"Scoala cu clasele I-IV",615,386,376,10,0,381,5,700,314,197,184,3,10314,0
26,"Maramures",108712,243,108712,,"SATULUNG",416,"Scoala cu clasele I-VIII",589,320,312,8,0,318,2,600,280,154,164,3,10314,0
26,"Maramures",108712,243,108712,,"SATULUNG",417,"Scoala Generala cu cls. I-VIII, strada Principala, nr. 129",0,159,0,159,0,159,0,200,41,107,52,3,10314,1
26,"Maramures",108794,243,108794,,"SACALASENI",418,"Sala de sport din incinta Scolii generale la nr. 99/A",673,419,386,9,24,417,2,600,181,271,146,3,10302,0
26,"Maramures",108794,243,108794,,"SACALASENI",419,"Camin cultural, nr. 260",646,428,398,12,18,424,4,700,272,323,101,3,10302,0
26,"Maramures",108794,243,108794,,"SACALASENI",420,"Scoala generala, nr. 67",475,273,255,9,9,272,1,497,224,198,74,3,10302,0
26,"Maramures",108794,243,108794,,"SACALASENI",421,"Primarie, strada Principala, nr. 67",0,214,0,214,0,214,0,298,84,157,57,3,10302,1
26,"Maramures",108874,243,108874,,"SACEL",422,"Primaria Sacel nr. 1077",1763,885,855,8,22,876,9,1900,1015,487,389,3,10306,0
26,"Maramures",108874,243,108874,,"SACEL",423,"Scoala Valea Carelor nr. 697",1230,599,585,5,9,592,7,1400,801,359,233,3,10306,0
26,"Maramures",108874,243,108874,,"SACEL",424,"Scoala Valea Carelor, strada Principala, nr. 696",0,47,0,47,0,47,0,200,153,28,19,3,10306,1
26,"Maramures",108918,243,108918,,"SALSIG",425,"Camin Cultural, nr. 400",1207,763,745,5,13,757,6,1300,537,363,394,3,10308,0
26,"Maramures",108918,243,108918,,"SALSIG",426,"Camin Cultural (Sala mica), strada Principala, nr. 400",0,65,0,65,0,64,1,200,135,36,28,3,10308,1
26,"Maramures",108945,243,108945,,"SAPANTA",427,"Scoala de arte si meserii , nr. 513",2618,1339,1321,6,12,1330,9,2800,1461,633,697,3,10310,0
26,"Maramures",108945,243,108945,,"SAPANTA",428,"Scoala de Arte si Meserii, strada Principala, nr. 512",0,77,0,77,0,75,2,200,123,38,37,3,10310,1
26,"Maramures",109005,243,109005,,"STRAMTURA",429,"Scoala generala cu cls. I-VIII Strimtura nr. 795",1796,875,865,9,1,870,5,1900,1025,542,328,3,10332,0
26,"Maramures",109005,243,109005,,"STRAMTURA",430,"Scoala generala cu cls. I-IV Strimtura nr. 481",482,234,222,12,0,232,2,500,266,139,93,3,10332,0
26,"Maramures",109005,243,109005,,"STRAMTURA",431,"Scoala generala cu cls. I-VIII Glod nr. 93",558,264,256,8,0,263,1,600,336,154,109,3,10332,0
26,"Maramures",109005,243,109005,,"STRAMTURA",432,"Scoala generala cu cls. I-VIII Slatioara nr. 174",461,181,171,10,0,179,2,500,319,92,87,3,10332,0
26,"Maramures",109005,243,109005,,"STRAMTURA",433,"Scoala generala cu cls. I-VIII - centru, strada Principala, nr. 795",0,63,0,63,0,62,1,200,137,26,36,3,10332,1
26,"Maramures",109041,243,109041,,"SUCIU DE SUS",434,"Primarie, nr. 791",1349,863,849,8,6,856,7,1500,637,272,584,3,10336,0
26,"Maramures",109041,243,109041,,"SUCIU DE SUS",435,"Scoala Generala Candela, nr. 105",744,439,416,18,5,436,3,800,361,151,285,3,10336,0
26,"Maramures",109041,243,109041,,"SUCIU DE SUS",436,"Camin cultural, nr. 320",926,572,558,14,0,565,7,1000,428,224,341,3,10336,0
26,"Maramures",109041,243,109041,,"SUCIU DE SUS",437,"Scoala, nr. 41",314,187,174,11,2,186,1,400,213,83,103,3,10336,0
26,"Maramures",109041,243,109041,,"SUCIU DE SUS",438,"Primarie, strada Principala, nr. 791",0,105,0,105,0,105,0,200,95,68,37,3,10336,1
26,"Maramures",179613,243,179613,,"SIEU",439,"Scoala generala Sieu, nr. 102",1904,913,883,22,8,908,5,2100,1187,301,607,3,10322,0
26,"Maramures",179613,243,179613,,"SIEU",440,"Scoala Generala -Centru, strada Principala, nr. 102",0,43,0,43,0,43,0,200,157,22,21,3,10322,1
26,"Maramures",109096,243,109096,,"SISESTI",441,"Primarie Sisesti nr. 430",1239,658,650,8,0,656,2,1400,742,421,235,3,10324,0
26,"Maramures",109096,243,109096,,"SISESTI",442,"Scoala cu cls. I-IV, Bontaieni nr. 44",200,81,74,7,0,81,0,300,219,33,48,3,10324,0
26,"Maramures",109096,243,109096,,"SISESTI",443,"Scoala generala Cetatele nr. 165",540,302,298,4,0,302,0,600,298,179,123,3,10324,0
26,"Maramures",109096,243,109096,,"SISESTI",444,"Scoala generala Danesti nr. 69",522,326,315,11,0,323,3,600,274,198,125,3,10324,0
26,"Maramures",109096,243,109096,,"SISESTI",445,"Scoala cu cls. I-IV Negreia nr. 111",393,210,201,9,0,209,1,400,190,152,57,3,10324,0
26,"Maramures",109096,243,109096,,"SISESTI",446,"Scoala cu cls. I-IV, Plopis nr. 81",417,242,235,7,0,240,2,500,258,151,89,3,10324,0
26,"Maramures",109096,243,109096,,"SISESTI",447,"Scoala generala Surdesti nr. 219",1155,565,560,5,0,559,6,1300,735,333,226,3,10324,0
26,"Maramures",109096,243,109096,,"SISESTI",448,"Primarie, strada Principala, nr. 430",0,58,0,58,0,57,1,201,143,29,28,3,10324,1
26,"Maramures",106648,243,106648,,"VADU IZEI",449,"Sala de festivitati",1958,1077,1075,2,0,1068,9,2100,1023,557,511,3,10340,0
26,"Maramures",106648,243,106648,,"VADU IZEI",450,"Sala de festivitati",415,202,194,8,0,201,1,500,298,97,104,3,10340,0
26,"Maramures",106648,243,106648,,"VADU IZEI",451,"Camin cultural, strada Principala, nr. 162",0,79,0,79,0,79,0,200,121,46,33,3,10340,1
26,"Maramures",109354,243,109354,,"VALEA CHIOARULUI",452,"Camin cultural",541,343,340,3,0,342,1,601,258,135,207,3,10343,0
26,"Maramures",109354,243,109354,,"VALEA CHIOARULUI",453,"Scoala generala",261,184,173,11,0,184,0,300,116,105,79,3,10343,0
26,"Maramures",109354,243,109354,,"VALEA CHIOARULUI",454,"Camin cultural",58,48,38,10,0,48,0,100,52,21,27,3,10343,0
26,"Maramures",109354,243,109354,,"VALEA CHIOARULUI",455,"Scoala generala",340,241,232,9,0,240,1,400,159,180,60,3,10343,0
26,"Maramures",109354,243,109354,,"VALEA CHIOARULUI",456,"Scoala generala",300,156,151,5,0,156,0,398,242,90,66,3,10343,0
26,"Maramures",109354,243,109354,,"VALEA CHIOARULUI",457,"Scoala generala",261,150,143,7,0,149,1,300,150,76,73,3,10343,0
26,"Maramures",109354,243,109354,,"VALEA CHIOARULUI",458,"Primarie -Sala de sedinta, strada Principala, nr. 19",0,82,0,82,0,81,1,200,118,44,37,3,10343,1
26,"Maramures",109425,243,109425,,"VIMA MICA",459,"Camin cultural, nr. 12",335,173,165,8,0,170,3,400,227,85,85,3,10350,0
26,"Maramures",109425,243,109425,,"VIMA MICA",460,"Scoala generala, nr. 25",40,39,30,9,0,39,0,100,61,17,22,3,10350,0
26,"Maramures",109425,243,109425,,"VIMA MICA",461,"Scoala generala, nr. 16",84,46,38,8,0,46,0,100,54,30,16,3,10350,0
26,"Maramures",109425,243,109425,,"VIMA MICA",462,"Scoala generala, nr. 30",46,28,20,8,0,27,1,100,72,11,16,3,10350,0
26,"Maramures",109425,243,109425,,"VIMA MICA",463,"Camin cultural nr. 60",211,126,121,5,0,126,0,300,174,34,92,3,10350,0
26,"Maramures",109425,243,109425,,"VIMA MICA",464,"Camin cultural, nr. 42",218,118,111,7,0,117,1,300,182,61,56,3,10350,0
26,"Maramures",109425,243,109425,,"VIMA MICA",465,"Camin cultural, nr. 112",343,174,168,6,0,173,1,400,226,88,85,3,10350,0
26,"Maramures",109425,243,109425,,"VIMA MICA",466,"Camin Cultural, strada Principala, nr. 12",0,39,0,39,0,39,0,200,161,17,22,3,10350,1
26,"Maramures",109504,243,109504,,"VISEU DE JOS",467,"Primarie, nr. 1028",1587,759,755,4,0,754,5,1700,941,365,389,3,10358,0
26,"Maramures",109504,243,109504,,"VISEU DE JOS",468,"Gradinita centru, nr. 399",1608,801,794,7,0,783,18,1800,999,415,368,3,10358,0
26,"Maramures",109504,243,109504,,"VISEU DE JOS",469,"Scoala generala, nr. 309",1174,537,525,12,0,532,5,1300,763,283,249,3,10358,0
26,"Maramures",109504,243,109504,,"VISEU DE JOS",470,"Primarie, strada Principala, nr. 1028",0,60,0,60,0,60,0,200,140,29,31,3,10358,1
27,"Mehedinti",109773,252,109773,,"MUNICIPIUL DROBETA-TURNU SEVERIN",1,"SALA POLIVALENTA, BULEVARD ALUNIS, NR. 1A",1942,1084,1072,12,0,1073,11,2099,1015,436,637,1,10361,0
27,"Mehedinti",109773,252,109773,,"MUNICIPIUL DROBETA-TURNU SEVERIN",2,"SALA POLIVALENTA, BULEVARD ALUNIS, NR. 1A",1429,776,770,6,0,771,5,1499,723,355,416,1,10361,0
27,"Mehedinti",109773,252,109773,,"MUNICIPIUL DROBETA-TURNU SEVERIN",3,"SCOALA NR. 1, STRADA TRAIAN, NR. 18",1674,1056,976,12,68,1041,15,1799,743,473,568,1,10361,0
27,"Mehedinti",109773,252,109773,,"MUNICIPIUL DROBETA-TURNU SEVERIN",4,"GRUP SCOLAR DECEBAL, STRADA ANTONINI, NR. 2",1536,837,823,14,0,824,13,1699,862,338,486,1,10361,0
27,"Mehedinti",109773,252,109773,,"MUNICIPIUL DROBETA-TURNU SEVERIN",5,"SCOALA NR. 3, STRADA DR. SAIDAC, NR. 21-23",1516,842,830,12,0,819,23,1599,757,386,433,1,10361,0
27,"Mehedinti",109773,252,109773,,"MUNICIPIUL DROBETA-TURNU SEVERIN",6,"PALATUL CULTURAL THEODOR COSTESCU, BULEVARD CAROL I, NR. 4",1615,910,899,11,0,898,12,1699,789,360,538,1,10361,0
27,"Mehedinti",109773,252,109773,,"MUNICIPIUL DROBETA-TURNU SEVERIN",7,"LICEUL TRAIAN, BULEVARD CAROL I, NR. 6",1552,852,834,14,4,839,13,1699,847,408,431,1,10361,0
27,"Mehedinti",109773,252,109773,,"MUNICIPIUL DROBETA-TURNU SEVERIN",8,"SCOALA NR. 10, STRADA MIHAI EMINESCU, NR. 12",1599,906,888,16,2,897,9,1599,693,426,471,1,10361,0
27,"Mehedinti",109773,252,109773,,"MUNICIPIUL DROBETA-TURNU SEVERIN",9,"SCOALA NR. 10, STRADA MIHAI EMINESCU, NR. 12",1473,804,790,13,1,796,8,1599,795,361,435,1,10361,0
27,"Mehedinti",109773,252,109773,,"MUNICIPIUL DROBETA-TURNU SEVERIN",10,"ASOCIATIA DE PROPRIETARI NR. 90, STRADA BRANCOVEANU, NR. 172",1065,651,631,19,1,641,10,1098,447,284,357,1,10361,0
27,"Mehedinti",109773,252,109773,,"MUNICIPIUL DROBETA-TURNU SEVERIN",11,"SCOALA PROFESIONALA ENERGETICA, STRADA INDEPENDENTEI, NR. 26",1543,821,811,9,1,816,5,1699,878,367,449,1,10361,0
27,"Mehedinti",109773,252,109773,,"MUNICIPIUL DROBETA-TURNU SEVERIN",12,"SCOALA PROFESIONALA ENERGETICA, STRADA INDEPENDENTEI, NR. 26",1146,646,629,16,1,645,1,1199,553,299,346,1,10361,0
27,"Mehedinti",109773,252,109773,,"MUNICIPIUL DROBETA-TURNU SEVERIN",13,"AUTOGARA, STRADA TOPOLNITEI, NR. 3",1649,783,772,11,0,777,6,1799,1016,354,423,1,10361,0
27,"Mehedinti",109773,252,109773,,"MUNICIPIUL DROBETA-TURNU SEVERIN",14,"SCOALA NR. 9, STRADA TRAIAN, NR. 287",1594,855,844,11,0,848,7,1700,845,362,486,1,10361,0
27,"Mehedinti",109773,252,109773,,"MUNICIPIUL DROBETA-TURNU SEVERIN",15,"SCOALA NR. 9, STRADA TRAIAN, NR. 287",1540,753,745,8,0,745,8,1700,947,305,440,1,10361,0
27,"Mehedinti",109773,252,109773,,"MUNICIPIUL DROBETA-TURNU SEVERIN",16,"SCOALA NR. 9, STRADA TRAIAN, NR. 287",1806,809,799,10,0,804,5,1999,1190,381,423,1,10361,0
27,"Mehedinti",109773,252,109773,,"MUNICIPIUL DROBETA-TURNU SEVERIN",17,"SCOALA NR. 2, BULEVARD TUDOR VLADIMIRESCU, NR. 71",1373,808,790,17,1,796,12,1499,691,312,484,1,10361,0
27,"Mehedinti",109773,252,109773,,"MUNICIPIUL DROBETA-TURNU SEVERIN",18,"SCOALA NR. 8, STRADA CICERO, NR. 79",1143,678,668,9,1,676,2,1196,518,281,395,1,10361,0
27,"Mehedinti",109773,252,109773,,"MUNICIPIUL DROBETA-TURNU SEVERIN",19,"SCOALA NR. 8, STRADA CICERO, NR. 79",1747,1015,1008,7,0,1006,9,1899,884,377,629,1,10361,0
27,"Mehedinti",109773,252,109773,,"MUNICIPIUL DROBETA-TURNU SEVERIN",20,"SCOALA NR. 7, STRADA PACII, NR. 2",1992,985,975,10,0,975,10,2096,1111,441,534,1,10361,0
27,"Mehedinti",109773,252,109773,,"MUNICIPIUL DROBETA-TURNU SEVERIN",21,"SCOALA NR. 7, STRADA PACII, NR. 2",1519,762,743,19,0,756,6,1698,936,340,416,1,10361,0
27,"Mehedinti",109773,252,109773,,"MUNICIPIUL DROBETA-TURNU SEVERIN",22,"SCOALA NR. 7, STRADA PACII, NR. 2",1974,968,954,14,0,960,8,2099,1131,391,569,1,10361,0
27,"Mehedinti",109773,252,109773,,"MUNICIPIUL DROBETA-TURNU SEVERIN",23,"SCOALA NR. 7, STRADA PACII, NR. 2",1846,955,945,10,0,944,11,1995,1040,448,496,1,10361,0
27,"Mehedinti",109773,252,109773,,"MUNICIPIUL DROBETA-TURNU SEVERIN",24,"DIRECTIA AGRICOLA, STRADA CRISAN, NR. 87",1646,822,809,10,3,816,6,1799,977,418,398,1,10361,0
27,"Mehedinti",109773,252,109773,,"MUNICIPIUL DROBETA-TURNU SEVERIN",25,"DIRECTIA AGRICOLA, STRADA CRISAN, NR. 87",1721,877,862,15,0,874,3,1899,1022,419,455,1,10361,0
27,"Mehedinti",109773,252,109773,,"MUNICIPIUL DROBETA-TURNU SEVERIN",26,"SCOALA NR.15, STRADA CRISAN, NR. 49",1423,687,677,10,0,683,4,1499,812,330,353,1,10361,0
27,"Mehedinti",109773,252,109773,,"MUNICIPIUL DROBETA-TURNU SEVERIN",27,"SCOALA NR.15, STRADA CRISAN, NR. 49",1187,649,640,9,0,637,12,1299,650,269,368,1,10361,0
27,"Mehedinti",109773,252,109773,,"MUNICIPIUL DROBETA-TURNU SEVERIN",28,"SCOALA NR.15, STRADA CRISAN, NR. 49",1551,763,746,17,0,758,5,1699,936,361,397,1,10361,0
27,"Mehedinti",109773,252,109773,,"MUNICIPIUL DROBETA-TURNU SEVERIN",29,"SCOALA NR.15, STRADA CRISAN, NR. 49",1953,990,968,22,0,986,4,2099,1109,432,554,1,10361,0
27,"Mehedinti",109773,252,109773,,"MUNICIPIUL DROBETA-TURNU SEVERIN",30,"LICEUL GHEORGHE TITEICA, STRADA CRISAN, NR. 50",1408,725,717,7,1,717,8,1499,774,288,429,1,10361,0
27,"Mehedinti",109773,252,109773,,"MUNICIPIUL DROBETA-TURNU SEVERIN",31,"LICEUL GHEORGHE TITEICA, STRADA CRISAN, NR. 50",1323,725,711,14,0,719,6,1499,774,312,407,1,10361,0
27,"Mehedinti",109773,252,109773,,"MUNICIPIUL DROBETA-TURNU SEVERIN",32,"COLEGIUL THEODOR COSTESCU, STRADA ORLY, NR. 37",1236,705,689,14,2,695,10,1294,589,297,398,1,10361,0
27,"Mehedinti",109773,252,109773,,"MUNICIPIUL DROBETA-TURNU SEVERIN",33,"GRADINITA NR. 22, STRADA TRANDAFIRILOR, NR. 2",1273,602,596,6,0,599,3,1399,797,287,312,1,10361,0
27,"Mehedinti",109773,252,109773,,"MUNICIPIUL DROBETA-TURNU SEVERIN",34,"SCOALA NR. 14, BULEVARD REVOLUTIEI, NR. 6",1121,591,579,12,0,590,1,1199,608,275,315,1,10361,0
27,"Mehedinti",109773,252,109773,,"MUNICIPIUL DROBETA-TURNU SEVERIN",35,"SCOALA NR. 14, BULEVARD REVOLUTIEI, NR. 6",1553,731,717,14,0,725,6,1699,968,354,371,1,10361,0
27,"Mehedinti",109773,252,109773,,"MUNICIPIUL DROBETA-TURNU SEVERIN",36,"CLUB PENSIONARI, BULEVARD REVOLUTIEI, NR. 27",1285,731,723,8,0,724,7,1399,668,318,406,1,10361,0
27,"Mehedinti",109773,252,109773,,"MUNICIPIUL DROBETA-TURNU SEVERIN",37,"SCOALA NR. 11, STRADA  EUGEN MARESI, NR. 1",1750,888,876,12,0,879,9,1899,1011,411,468,1,10361,0
27,"Mehedinti",109773,252,109773,,"MUNICIPIUL DROBETA-TURNU SEVERIN",38,"SCOALA NR. 11, STRADA  EUGEN MARESI, NR. 1",1509,802,789,12,1,796,6,1599,797,316,480,1,10361,0
27,"Mehedinti",109773,252,109773,,"MUNICIPIUL DROBETA-TURNU SEVERIN",39,"STATIE DE SALVARE, BULEVARD SPLAI MIHAI VITEAZU, NR. 8",1690,898,879,19,0,889,9,1799,901,394,495,1,10361,0
27,"Mehedinti",109773,252,109773,,"MUNICIPIUL DROBETA-TURNU SEVERIN",40,"SPITAL JUDETEAN, BULEVARD SPLAI MIHAI VITEAZU, NR. 10",1889,944,922,22,0,942,2,1999,1055,423,519,1,10361,0
27,"Mehedinti",109773,252,109773,,"MUNICIPIUL DROBETA-TURNU SEVERIN",41,"SPITAL JUDETEAN, BULEVARD SPLAI MIHAI VITEAZU, NR. 10",1594,767,736,31,0,760,7,1699,932,374,386,1,10361,0
27,"Mehedinti",109773,252,109773,,"MUNICIPIUL DROBETA-TURNU SEVERIN",42,"GRADINITA DE COPII NR. 20, STRADA WALTER MARACINEANU, NR. 2",1675,786,772,14,0,778,8,1799,1013,384,394,1,10361,0
27,"Mehedinti",109773,252,109773,,"MUNICIPIUL DROBETA-TURNU SEVERIN",43,"LICEUL DOMNUL TUDOR, BULEVARD IC BRATIANU, NR. 7",999,555,543,12,0,550,5,1099,544,237,313,1,10361,0
27,"Mehedinti",109773,252,109773,,"MUNICIPIUL DROBETA-TURNU SEVERIN",44,"LICEUL DOMNUL TUDOR, BULEVARD IC BRATIANU, NR. 7",1311,691,675,16,0,685,6,1401,710,308,377,1,10361,0
27,"Mehedinti",109773,252,109773,,"MUNICIPIUL DROBETA-TURNU SEVERIN",45,"LICEUL DOMNUL TUDOR, BULEVARD IC BRATIANU, NR. 7",1438,767,757,9,1,760,7,1499,732,312,448,1,10361,0
27,"Mehedinti",109773,252,109773,,"MUNICIPIUL DROBETA-TURNU SEVERIN",46,"LICEUL DOMNUL TUDOR, BULEVARD IC BRATIANU, NR. 7",1438,687,675,11,1,682,5,1499,812,308,374,1,10361,0
27,"Mehedinti",109773,252,109773,,"MUNICIPIUL DROBETA-TURNU SEVERIN",47,"STADION MUNICIPAL, STRADA INDEPENDENTEI, NR. 40",1586,828,813,15,0,826,2,1699,871,299,527,1,10361,0
27,"Mehedinti",109773,252,109773,,"MUNICIPIUL DROBETA-TURNU SEVERIN",48,"LICEUL NR. 4, STRADA TG. JIULUI, NR. 13",1142,640,631,9,0,637,3,1299,659,240,397,1,10361,0
27,"Mehedinti",109773,252,109773,,"MUNICIPIUL DROBETA-TURNU SEVERIN",49,"GRADINITA NR. 3, STRADA IC BRATIANU, NR. 2",1433,747,725,19,3,739,8,1599,852,325,414,1,10361,0
27,"Mehedinti",109773,252,109773,,"MUNICIPIUL DROBETA-TURNU SEVERIN",50,"SCOALA NR. 6, STRADA KISELEFF, NR. 55",1416,769,759,10,0,756,13,1499,730,319,437,1,10361,0
27,"Mehedinti",109773,252,109773,,"MUNICIPIUL DROBETA-TURNU SEVERIN",51,"SCOALA NR. 6, STRADA KISELEFF, NR. 55",1673,867,845,22,0,860,7,1798,931,404,456,1,10361,0
27,"Mehedinti",109773,252,109773,,"MUNICIPIUL DROBETA-TURNU SEVERIN",52,"SCOALA NR. 6, STRADA KISELEFF, NR. 55",1360,676,663,13,0,672,4,1398,722,284,388,1,10361,0
27,"Mehedinti",109773,252,109773,,"MUNICIPIUL DROBETA-TURNU SEVERIN",53,"SCOALA NR. 6, STRADA KISELEFF, NR. 55",1385,741,723,18,0,736,5,1498,757,311,425,1,10361,0
27,"Mehedinti",109773,252,109773,,"MUNICIPIUL DROBETA-TURNU SEVERIN",54,"SOCIETATEA DRUMURI NATIONALE, STRADA TOPOLNITEI, NR. 24",1467,630,622,8,0,627,3,1559,929,306,321,1,10361,0
27,"Mehedinti",109773,252,109773,,"MUNICIPIUL DROBETA-TURNU SEVERIN",55,"BULEVARD TUDOR VLADIMIRESCU, PARTER BLOC,NR. 203",1238,653,642,11,0,651,2,1396,743,282,369,1,10361,0
27,"Mehedinti",109773,252,109773,,"MUNICIPIUL DROBETA-TURNU SEVERIN",56,"CABINET MEDICAL, STRADA PETRE SERGESCU, NR. 3",1106,566,556,10,0,563,3,1119,553,243,320,1,10361,0
27,"Mehedinti",109773,252,109773,,"MUNICIPIUL DROBETA-TURNU SEVERIN",57,"GRADINITA NR. 21, STRADA PETRE SERGESCU, NR. 3",1500,709,694,15,0,705,4,1599,890,319,386,1,10361,0
27,"Mehedinti",109773,252,109773,,"MUNICIPIUL DROBETA-TURNU SEVERIN",58,"SCOALA NR. 4, STRADA CLOSANI, NR. 6",1311,609,599,9,1,603,6,1399,790,285,318,1,10361,0
27,"Mehedinti",109773,252,109773,,"MUNICIPIUL DROBETA-TURNU SEVERIN",59,"SCOALA NR. 4, STRADA CLOSANI, NR. 6",1317,697,686,11,0,692,5,1499,802,323,369,1,10361,0
27,"Mehedinti",109773,252,109773,,"MUNICIPIUL DROBETA-TURNU SEVERIN",60,"SCOALA NR. 4, STRADA CLOSANI, NR. 6",1305,693,680,13,0,691,2,1396,703,301,390,1,10361,0
27,"Mehedinti",109773,252,109773,,"MUNICIPIUL DROBETA-TURNU SEVERIN",61,"GRADINITA SCHELA, STRADA CALEA TIMISOAREI, NR. 164",1992,987,979,8,0,978,9,2099,1112,545,433,1,10361,0
27,"Mehedinti",109773,252,109773,,"MUNICIPIUL DROBETA-TURNU SEVERIN",62,"GRADINITA SCHELA, STRADA CALEA TIMISOAREI, NR. 164",2099,1031,1016,15,0,1025,6,2099,1068,477,548,1,10361,0
27,"Mehedinti",109773,252,109773,,"MUNICIPIUL DROBETA-TURNU SEVERIN",63,"SCOALA NR. 5, BULEVARD VARCIOROVA, NR. 5",1907,1152,1141,11,0,1138,14,2000,848,556,582,1,10361,0
27,"Mehedinti",109773,252,109773,,"MUNICIPIUL DROBETA-TURNU SEVERIN",64,"SCOALA NR. 13, STRADA JIDOSTITEI, NR. 2",1491,981,967,14,0,972,9,1600,619,537,435,1,10361,0
27,"Mehedinti",109773,252,109773,,"MUNICIPIUL DROBETA-TURNU SEVERIN",65,"GARA CFR, BULEVARD DUNARII, NR. 2",0,557,0,557,0,554,3,1499,942,340,214,1,10361,1
27,"Mehedinti",109773,252,109773,,"MUNICIPIUL DROBETA-TURNU SEVERIN",66,"AUTOGARA, STRADA TOPOLNITEI, NR. 5",0,627,0,627,0,624,3,1499,872,347,277,1,10361,1
27,"Mehedinti",109773,252,109773,,"MUNICIPIUL DROBETA-TURNU SEVERIN",67,"COLEGIUL UNIVERSITAR - CAMINUL UNIVERSITAR NR. 1, BULEVARD IC BRATIANU, NR. 7",0,423,0,423,0,417,6,1499,1076,221,196,1,10361,1
27,"Mehedinti",110063,252,110063,,"MUNICIPIUL ORSOVA",68,"SCOALA CU CLASELE I-VIII NR. 2 SUD PETRU DUMITRIU, BULEVARD PORTILE DE FIER, NR. 64",1656,878,875,3,0,869,9,1799,921,415,454,1,10366,0
27,"Mehedinti",110063,252,110063,,"MUNICIPIUL ORSOVA",69,"LICEUL TRAIAN LALESCU, BULEVARD PORTILE DE FIER, NR. 32",1241,573,565,7,1,570,3,1399,826,314,256,1,10366,0
27,"Mehedinti",110063,252,110063,,"MUNICIPIUL ORSOVA",70,"LICEUL TRAIAN LALESCU, BULEVARD PORTILE DE FIER, NR. 32",1417,689,669,17,3,680,9,1599,910,384,296,1,10366,0
27,"Mehedinti",110063,252,110063,,"MUNICIPIUL ORSOVA",71,"CLUBUL COPIILOR, STRADA DECEBAL, NR. 7",1094,530,526,4,0,525,5,1199,669,243,282,1,10366,0
27,"Mehedinti",110063,252,110063,,"MUNICIPIUL ORSOVA",72,"CLUBUL COPIILOR, STRADA DECEBAL, NR. 7",1275,612,608,4,0,608,4,1399,787,407,201,1,10366,0
27,"Mehedinti",110063,252,110063,,"MUNICIPIUL ORSOVA",73,"GRUP SCOLAR INDUSTRIAL DE MARINA, BULEVARD 1 DECEMBRIE 1918, NR. 11A",1662,761,751,10,0,752,9,1799,1038,333,419,1,10366,0
27,"Mehedinti",110063,252,110063,,"MUNICIPIUL ORSOVA",74,"SCOALA GENERALA NR.1 NORD PAMFIL SEICARU, BULEVARD 1 DECEMBRIE 1918, NR. 2",1590,787,780,7,0,772,15,1799,1012,322,450,1,10366,0
27,"Mehedinti",110063,252,110063,,"MUNICIPIUL ORSOVA",75,"GRADINITA NR. 3, STRADA STEFAN CEL MARE, NR. 16",1654,951,937,14,0,938,13,1799,848,497,441,1,10366,0
27,"Mehedinti",110063,252,110063,,"MUNICIPIUL ORSOVA",76,"SCOALA GENERALA I-IV CORAMNIC, STRADA HERCULANE, NR. 1",319,202,193,9,0,201,1,399,197,111,90,1,10366,0
27,"Mehedinti",110063,252,110063,,"MUNICIPIUL ORSOVA",77,"GARA CFR, STRADA TUFARI, NR. 17",0,720,0,720,0,715,5,1000,280,354,361,1,10366,1
27,"Mehedinti",109924,252,109924,,"ORAS BAIA DE ARAMA",78,"SCOALA GENERALA BAIA DE ARAMA",1171,692,675,16,1,679,13,1299,607,333,346,1,10368,0
27,"Mehedinti",109924,252,109924,,"ORAS BAIA DE ARAMA",79,"SCOALA GENERALA TITERLESTI",413,275,264,11,0,272,3,489,214,115,157,1,10368,0
27,"Mehedinti",109924,252,109924,,"ORAS BAIA DE ARAMA",80,"GRUP SCOLAR CONSTANTIN BRANCOVEANU, STRADA TUDOR VLADIMIRESCU",1072,627,613,14,0,614,13,1194,567,276,338,1,10368,0
27,"Mehedinti",109924,252,109924,,"ORAS BAIA DE ARAMA",81,"SCOALA GENERALA NEGOIESTI",695,411,400,11,0,405,6,796,385,185,220,1,10368,0
27,"Mehedinti",109924,252,109924,,"ORAS BAIA DE ARAMA",82,"SCOALA GENERALA MARASESTI",1088,691,686,5,0,685,6,1199,508,339,346,1,10368,0
27,"Mehedinti",109924,252,109924,,"ORAS BAIA DE ARAMA",83,"SCOALA GENERALA CU CLASELE I-IV, SAT TITERLESTI",0,293,0,293,0,289,4,1006,713,163,126,1,10368,1
27,"Mehedinti",110116,252,110116,,"ORAS STREHAIA",84,"GRUP SCOLAR INDUSTRIAL MATEI BASARAB STREHAIA, STRADA REPUBLICII, NR. 235",1612,907,900,7,0,884,23,1799,892,374,510,1,10378,0
27,"Mehedinti",110116,252,110116,,"ORAS STREHAIA",85,"GRADINITA NR. 2, STRADA EROILOR, NR. 20",1667,899,889,7,3,887,12,1799,900,414,473,1,10378,0
27,"Mehedinti",110116,252,110116,,"ORAS STREHAIA",86,"SCOALA GENERALA STREHAIA, STRADA REPUBLICII, NR. 126",1422,827,816,10,1,818,9,1599,772,332,486,1,10378,0
27,"Mehedinti",110116,252,110116,,"ORAS STREHAIA",87,"GRADINITA DE VEST STREHAIA, STRADA REPUBLICII, NR. 88",1502,1009,946,5,58,998,11,1699,690,486,512,1,10378,0
27,"Mehedinti",110116,252,110116,,"ORAS STREHAIA",88,"SCOALA GENERALA CIOCHIUTA, CALEA SEVERINULUI, NR. 127",872,607,590,17,0,600,7,994,387,249,351,1,10378,0
27,"Mehedinti",110116,252,110116,,"ORAS STREHAIA",89,"SCOALA GENERALA SLATINIC,  STRADA TRAIAN, NR. 51",344,230,222,8,0,227,3,405,175,136,91,1,10378,0
27,"Mehedinti",110116,252,110116,,"ORAS STREHAIA",90,"SCOALA GENERALA LUNCA BANULUI, CALEA CRAIOVEI, NR. 12",376,256,250,6,0,255,1,399,143,79,176,1,10378,0
27,"Mehedinti",110116,252,110116,,"ORAS STREHAIA",91,"SCOALA GENERALA COMANDA, STRADA GRADINILOR, NR. 45",1313,779,770,9,0,763,16,1500,721,342,421,1,10378,0
27,"Mehedinti",110116,252,110116,,"ORAS STREHAIA",92,"SCOALA GENERALA HURDUCESTI, STRADA LIBERTATII, NR. 75",228,154,149,5,0,154,0,300,146,78,76,1,10378,0
27,"Mehedinti",110116,252,110116,,"ORAS STREHAIA",93,"SCOALA GENERALA STANCESTI",174,141,134,7,0,141,0,199,58,70,71,1,10378,0
27,"Mehedinti",110116,252,110116,,"ORAS STREHAIA",94,"SCOALA GENERALA CU CLASELE I-VIII STREHAIA, STRADA REPUBLICII, NR. 126",0,288,0,288,0,285,3,996,708,124,161,1,10378,1
27,"Mehedinti",110232,252,110232,,"ORAS VANJU MARE",95,"LICEUL TEORETIC VANJU MARE, STRADA RAHOVEI, NR.2",1346,816,788,15,13,798,18,1494,678,292,506,1,10389,0
27,"Mehedinti",110232,252,110232,,"ORAS VANJU MARE",96,"SCOALA GENERALA I-VIII VANJU MARE, STRADA LIBERTATII, NR. 23",1692,1011,981,12,18,1001,10,1899,888,415,586,1,10389,0
27,"Mehedinti",110232,252,110232,,"ORAS VANJU MARE",97,"SCOALA GENERALA I-IV NICOLAE BALCESCU",706,433,425,8,0,425,8,791,358,136,289,1,10389,0
27,"Mehedinti",110232,252,110232,,"ORAS VANJU MARE",98,"SCOALA GENERALA I-IV BUCURA",262,221,188,20,13,220,1,301,80,86,134,1,10389,0
27,"Mehedinti",110232,252,110232,,"ORAS VANJU MARE",99,"SCOALA GENERALA I-IV OREVITA MARE",775,528,503,17,8,518,10,899,371,254,264,1,10389,0
27,"Mehedinti",110232,252,110232,,"ORAS VANJU MARE",100,"SCOALA GENERALA I-IV TRAIAN",507,334,321,13,0,324,10,599,265,124,200,1,10389,0
27,"Mehedinti",110232,252,110232,,"ORAS VANJU MARE",101,"LICEUL DOCTOR VICTOR GOMOIU VANJU MARE, STRADA RAHOVEI, NR. 2",0,374,0,374,0,370,4,999,625,220,150,1,10389,1
27,"Mehedinti",110296,252,110296,,"BALA",102,"SCOALA GENERALA I-IV COMANESTI",342,213,203,10,0,208,5,398,185,112,96,3,10403,0
27,"Mehedinti",110296,252,110296,,"BALA",103,"SCOALA GENERALA I-VIII CRAINICI",291,200,188,12,0,197,3,299,99,101,96,3,10403,0
27,"Mehedinti",110296,252,110296,,"BALA",104,"SCOALA GENERALA I-IV SARDANESTI",209,148,142,6,0,147,1,300,152,87,60,3,10403,0
27,"Mehedinti",110296,252,110296,,"BALA",105,"SCOALA GENERALA I-IV IUPCA",281,190,182,8,0,190,0,300,110,89,101,3,10403,0
27,"Mehedinti",110296,252,110296,,"BALA",106,"SCOALA GENERALA I-VIII BALA",633,394,386,8,0,386,8,599,205,198,188,3,10403,0
27,"Mehedinti",110296,252,110296,,"BALA",107,"SCOALA GENERALA I-IV BRATESUL",99,66,57,9,0,66,0,99,33,45,21,3,10403,0
27,"Mehedinti",110296,252,110296,,"BALA",108,"SCOALA GENERALA I-IV BALA DE SUS",521,342,334,6,2,339,3,599,257,195,144,3,10403,0
27,"Mehedinti",110296,252,110296,,"BALA",109,"SCOALA GENERALA I-IV RUDINA",448,250,243,7,0,246,4,499,249,112,134,3,10403,0
27,"Mehedinti",110296,252,110296,,"BALA",110,"SCOALA GENERALA I-IV VIDIMIRESTI",142,72,64,8,0,68,4,199,127,35,33,3,10403,0
27,"Mehedinti",110296,252,110296,,"BALA",111,"SCOALA GENERALA I-VIII DILMA",365,232,226,6,0,228,4,399,167,112,116,3,10403,0
27,"Mehedinti",110296,252,110296,,"BALA",112,"SCOALA GENERALA CU CLASELE I-VIII, SAT BALA",0,532,0,532,0,529,3,601,69,312,217,3,10403,1
27,"Mehedinti",110456,252,110456,,"BALTA",113,"CAMINUL CULTURAL BALTA",430,298,294,4,0,293,5,499,201,142,151,3,10423,0
27,"Mehedinti",110456,252,110456,,"BALTA",114,"SCOALA GENERALA PREJNA",249,192,179,5,8,190,2,200,8,87,103,3,10423,0
27,"Mehedinti",110456,252,110456,,"BALTA",115,"CAMINUL CULTURAL COSTESTI",183,151,141,3,7,150,1,199,48,70,80,3,10423,0
27,"Mehedinti",110456,252,110456,,"BALTA",116,"CAMINUL CULTURAL GORNOVITA",184,142,134,8,0,140,2,200,58,70,70,3,10423,0
27,"Mehedinti",110456,252,110456,,"BALTA",117,"SCOALA GENERALA CU CLASELE I-IV, SAT BALTA",0,164,0,164,0,164,0,498,334,60,104,3,10423,1
27,"Mehedinti",110535,252,110535,,"BALACITA",118,"SCOALA GENERALA I-VIII BALACITA",1134,505,494,11,0,490,15,1299,794,197,293,3,10419,0
27,"Mehedinti",110535,252,110535,,"BALACITA",119,"SCOALA GENERALA I-VIIII GVARDINITA",975,517,492,25,0,507,10,1099,582,176,331,3,10419,0
27,"Mehedinti",110535,252,110535,,"BALACITA",120,"SCOALA GENERALA I-IV DOBRA",410,238,219,19,0,235,3,499,261,66,169,3,10419,0
27,"Mehedinti",110535,252,110535,,"BALACITA",121,"GRADINITA DE COPII GVARDINITA, SAT GVARDINITA",0,162,0,162,0,156,6,499,337,52,104,3,10419,1
27,"Mehedinti",110571,252,110571,,"BACLES",122,"SCOALA GENERALA BACLES",584,387,364,22,1,386,1,692,305,205,181,3,10395,0
27,"Mehedinti",110571,252,110571,,"BACLES",123,"SCOALA GENERALA PODU GROSULUI",180,132,122,9,1,132,0,197,65,79,53,3,10395,0
27,"Mehedinti",110571,252,110571,,"BACLES",124,"SCOALA GENERALA PETRA",192,145,129,11,5,143,2,188,43,36,107,3,10395,0
27,"Mehedinti",110571,252,110571,,"BACLES",125,"SCOALA GENERALA CORZU",392,244,239,5,0,240,4,430,186,106,134,3,10395,0
27,"Mehedinti",110571,252,110571,,"BACLES",126,"SCOALA GENERALA  SMADOVITA",488,259,251,8,0,255,4,613,354,133,122,3,10395,0
27,"Mehedinti",110571,252,110571,,"BACLES",127,"SCOALA GENERALA CU CLASELE I-VIII, SAT BACLES",0,213,0,213,0,213,0,508,295,77,136,3,10395,1
27,"Mehedinti",110688,252,110688,,"BALVANESTI",128,"PRIMARIA BALVANESTI",840,562,550,12,0,553,9,894,332,383,170,3,10431,0
27,"Mehedinti",110688,252,110688,,"BALVANESTI",129,"SCOALA GENERALA CU CLASELE I-VIII, SAT BALVANESTI",0,253,0,253,0,250,3,490,237,138,112,3,10431,1
27,"Mehedinti",114060,252,114060,,"BRANISTEA",130,"SCOALA GENERALA BRANISTEA",1280,863,813,9,41,858,5,1399,536,335,523,3,10437,0
27,"Mehedinti",114060,252,114060,,"BRANISTEA",131,"SCOALA GENERALA  I-IV GOANTA",372,264,241,12,11,261,3,399,135,114,147,3,10437,0
27,"Mehedinti",114060,252,114060,,"BRANISTEA",132,"GRADINITA DE COPII, SAT BRANISTEA",0,229,0,229,0,228,1,499,270,77,151,3,10437,1
27,"Mehedinti",110740,252,110740,,"BREZNITA-MOTRU",133,"SCOALA GENERALA BREZNITA-MOTRU",974,651,616,10,25,636,15,1094,443,256,380,3,10440,0
27,"Mehedinti",110740,252,110740,,"BREZNITA-MOTRU",134,"SCOALA GENERALA FAUROAIA",340,245,232,13,0,245,0,399,154,114,131,3,10440,0
27,"Mehedinti",110740,252,110740,,"BREZNITA-MOTRU",135,"SCOALA GENERALA CU CLASELE I-VIII, SAT BREZNITA-MOTRU",0,110,0,110,0,109,1,501,391,41,68,3,10440,1
27,"Mehedinti",110820,252,110820,,"BREZNITA-OCOL",136,"SCALA GENERALA I-VIII  BREZNITA-OCOL",1496,762,757,5,0,760,2,1699,937,346,414,3,10448,0
27,"Mehedinti",110820,252,110820,,"BREZNITA-OCOL",137,"GRADINITA MAGHERU",814,460,452,8,0,452,8,898,438,232,220,3,10448,0
27,"Mehedinti",110820,252,110820,,"BREZNITA-OCOL",138,"SCOALA GENERALA I-IV JIDOSTITA",952,500,493,7,0,497,3,1099,599,293,204,3,10448,0
27,"Mehedinti",110820,252,110820,,"BREZNITA-OCOL",139,"SCOALA GENERALA CU CLASELE I-VIII, SAT BREZNITA-OCOL",0,94,0,94,0,94,0,499,405,55,39,3,10448,1
27,"Mehedinti",110875,252,110875,,"BROSTENI",140,"CAMINUL CULTURAL BROSTENI",1175,729,705,24,0,721,8,1196,467,281,440,3,10453,0
27,"Mehedinti",110875,252,110875,,"BROSTENI",141,"CAMINUL CULTURAL LUPSA DE JOS",1092,703,691,12,0,692,11,1199,496,246,446,3,10453,0
27,"Mehedinti",110875,252,110875,,"BROSTENI",142,"GRADINITA DE COPII, SAT BROSTENI",0,370,0,370,0,363,7,499,129,201,162,3,10453,1
27,"Mehedinti",110946,252,110946,,"BURILA MARE",143,"SCOALA GENERALA BURILA MARE",612,443,413,14,16,432,11,699,256,163,269,3,10460,0
27,"Mehedinti",110946,252,110946,,"BURILA MARE",144,"SCOALA GENERALA CRIVINA",544,353,325,13,15,311,42,602,249,146,165,3,10460,0
27,"Mehedinti",110946,252,110946,,"BURILA MARE",145,"SCOALA GENERALA TIGANASI",288,198,178,12,8,194,4,299,101,103,91,3,10460,0
27,"Mehedinti",110946,252,110946,,"BURILA MARE",146,"SCOALA GENERALA VRANCEA",173,132,115,12,5,132,0,199,67,80,52,3,10460,0
27,"Mehedinti",110946,252,110946,,"BURILA MARE",147,"SCOALA GENERALA IZVORU-FRUMOS",208,127,108,13,6,125,2,199,72,72,53,3,10460,0
27,"Mehedinti",110946,252,110946,,"BURILA MARE",148,"SCOALA GENERALA CU CLASELE I-VIII, SAT BURILA MARE",0,397,0,397,0,391,6,499,102,161,230,3,10460,1
27,"Mehedinti",111006,252,111006,,"BUTOIESTI",149,"PRIMARIA BUTOIESTI",1280,731,718,13,0,725,6,1347,616,368,357,3,10466,0
27,"Mehedinti",111006,252,111006,,"BUTOIESTI",150,"SCOALA GENERALA I-IV GURA MOTRULUI",250,137,133,4,0,135,2,309,172,65,70,3,10466,0
27,"Mehedinti",111006,252,111006,,"BUTOIESTI",151,"SCOALA GENERALA I-IV BUICESTI",740,412,399,13,0,406,6,803,391,175,231,3,10466,0
27,"Mehedinti",111006,252,111006,,"BUTOIESTI",152,"SCOALA GENERALA I-IV TINTARU",245,165,154,9,2,165,0,300,135,65,100,3,10466,0
27,"Mehedinti",111006,252,111006,,"BUTOIESTI",153,"SCOALA GENERALA CU CLASELE I-VIII, SAT BUTOIESTI",0,414,0,414,0,411,3,499,85,242,169,3,10466,1
27,"Mehedinti",111097,252,111097,,"CAZANESTI",154,"SCOALA GENERALA I-IV CAZANESTI",807,491,477,14,0,486,5,898,407,228,258,3,10475,0
27,"Mehedinti",111097,252,111097,,"CAZANESTI",155,"SCOALA GENERALA I-VIII SEVERINESTI",997,638,627,11,0,620,18,1099,461,275,345,3,10475,0
27,"Mehedinti",111097,252,111097,,"CAZANESTI",156,"CAMINUL CULTURAL, SAT CAZANESTI",0,308,0,308,0,306,2,499,191,131,175,3,10475,1
27,"Mehedinti",111220,252,111220,,"CIRESU",157,"CAMINUL CULTURAL CIRESU",474,283,275,8,0,278,5,499,216,116,162,3,10488,0
27,"Mehedinti",111220,252,111220,,"CIRESU",158,"CAMINUL CULTURAL, SAT CIRESU",0,108,0,108,0,106,2,499,391,44,62,3,10488,1
27,"Mehedinti",111275,252,111275,,"CORCOVA",159,"CAMINUL CULTURAL CORCOVA",1320,836,817,14,5,828,8,1499,663,364,464,3,10493,0
27,"Mehedinti",111275,252,111275,,"CORCOVA",160,"SCOALA GENERALA IMOASA",340,249,240,9,0,246,3,399,150,89,157,3,10493,0
27,"Mehedinti",111275,252,111275,,"CORCOVA",161,"SCOALA GENERALA CORDUN",542,284,278,5,1,282,2,599,315,142,140,3,10493,0
27,"Mehedinti",111275,252,111275,,"CORCOVA",162,"SCOALA GENERALA SAT STEJARU",364,208,201,7,0,204,4,399,191,87,117,3,10493,0
27,"Mehedinti",111275,252,111275,,"CORCOVA",163,"SCOALA GENERALA JIROV",1194,648,639,9,0,635,13,1299,651,356,279,3,10493,0
27,"Mehedinti",111275,252,111275,,"CORCOVA",164,"SCOALA GENERALA MARUL ROSU",442,290,279,11,0,286,4,499,209,112,174,3,10493,0
27,"Mehedinti",111275,252,111275,,"CORCOVA",165,"SCOALA GENERALA CERNAIA",422,267,257,10,0,265,2,499,232,180,85,3,10493,0
27,"Mehedinti",111275,252,111275,,"CORCOVA",166,"SCOALA CU CLASELE I-VIII, SAT CORCOVA",0,125,0,125,0,124,1,499,374,52,72,3,10493,1
27,"Mehedinti",111417,252,111417,,"CORLATEL",167,"SCOALA GENERALA I-VIII CORLATEL",625,457,446,11,0,451,6,699,242,210,241,3,10507,0
27,"Mehedinti",111417,252,111417,,"CORLATEL",168,"SCOALA GENERALA I-IV VALEA ANILOR",481,318,310,7,1,314,4,499,181,130,184,3,10507,0
27,"Mehedinti",111417,252,111417,,"CORLATEL",169,"CAMINUL CULTURAL, SAT CORLATEL",0,323,0,323,0,318,5,499,176,161,157,3,10507,1
27,"Mehedinti",111444,252,111444,,"CUJMIR",170,"CAMINUL CULTURAL CUJMIR",999,620,594,26,0,612,8,1099,479,310,302,3,10510,0
27,"Mehedinti",111444,252,111444,,"CUJMIR",171,"BIBLIOTECA COMUNALA CUJMIR",967,596,588,7,1,591,5,1099,503,261,330,3,10510,0
27,"Mehedinti",111444,252,111444,,"CUJMIR",172,"SCOALA GENERALA AURORA",606,376,357,19,0,373,3,699,323,222,151,3,10510,0
27,"Mehedinti",111444,252,111444,,"CUJMIR",173,"GRADINITA CUJMIRU MIC",411,284,266,18,0,283,1,499,215,168,115,3,10510,0
27,"Mehedinti",111444,252,111444,,"CUJMIR",174,"LICEUL TEORETIC, SAT CUJMIR",0,296,0,296,0,294,2,499,203,161,133,3,10510,1
27,"Mehedinti",111480,252,111480,,"DEVESEL",175,"CAMINUL CULTURAL DEVESEL",979,555,536,19,0,546,9,1097,542,253,293,3,10517,0
27,"Mehedinti",111480,252,111480,,"DEVESEL",176,"SCOALA GENERALA BATOTI",401,219,206,13,0,218,1,399,180,102,116,3,10517,0
27,"Mehedinti",111480,252,111480,,"DEVESEL",177,"SCOALA GENERALA BISTRETU",428,287,274,13,0,284,3,499,212,124,160,3,10517,0
27,"Mehedinti",111480,252,111480,,"DEVESEL",178,"SCOALA GENERALA SCAPAU",641,373,362,11,0,366,7,697,324,216,150,3,10517,0
27,"Mehedinti",111480,252,111480,,"DEVESEL",179,"SCOALA CU CLASELE I-VIII, SAT DEVESEL",0,423,0,423,0,423,0,509,86,169,254,3,10517,1
27,"Mehedinti",111550,252,111550,,"DARVARI",180,"CAMINUL CULTURAL NOU DARVARI",1304,679,672,6,1,667,12,1399,720,321,346,3,10514,0
27,"Mehedinti",111550,252,111550,,"DARVARI",181,"CAMINUL CULTURAL VECHI GEMENI",975,513,498,15,0,511,2,1098,585,281,230,3,10514,0
27,"Mehedinti",111550,252,111550,,"DARVARI",182,"SCOALA CU CLASELE I-VIII, SAT DARVARI",0,151,0,151,0,149,2,494,343,69,80,3,10514,1
27,"Mehedinti",112904,252,112904,,"DUBOVA",183,"PRIMARIA DUBOVA",419,285,266,4,15,283,2,498,213,173,110,3,10524,0
27,"Mehedinti",112904,252,112904,,"DUBOVA",184,"FOSTA PRIMARIE EIBENTHAL",271,146,139,6,1,143,3,300,154,55,88,3,10524,0
27,"Mehedinti",112904,252,112904,,"DUBOVA",185,"SCOALA GENERALA BAIA NOUA",141,79,71,8,0,79,0,201,122,20,59,3,10524,0
27,"Mehedinti",112904,252,112904,,"DUBOVA",186,"SCOALA CU CLASELE I-IV, SAT DUBOVA",0,219,0,219,0,216,3,489,270,80,136,3,10524,1
27,"Mehedinti",111587,252,111587,,"DUMBRAVA",187,"CAMINUL CULTURAL DUMBRAVA DE JOS",441,232,227,5,0,230,2,499,267,82,148,3,10528,0
27,"Mehedinti",111587,252,111587,,"DUMBRAVA",188,"SCOALA GENERALA ALBULESTI",553,337,328,9,0,336,1,599,262,161,175,3,10528,0
27,"Mehedinti",111587,252,111587,,"DUMBRAVA",189,"CAMINUL CULTURAL ROCSORENI",134,96,87,9,0,95,1,200,104,41,54,3,10528,0
27,"Mehedinti",111587,252,111587,,"DUMBRAVA",190,"SCOALA GENERALA VLADICA",71,66,55,11,0,65,1,99,33,22,43,3,10528,0
27,"Mehedinti",111587,252,111587,,"DUMBRAVA",191,"SCOALA GENERALA VALEA MARCULUI",114,80,69,11,0,79,1,99,19,29,50,3,10528,0
27,"Mehedinti",111587,252,111587,,"DUMBRAVA",192,"SCOALA CU CLASELE I-IV, SAT DUMBRAVA DE JOS",0,215,0,215,0,211,4,498,283,70,141,3,10528,1
27,"Mehedinti",112245,252,112245,,"ESELNITA",193,"GRADINITA ESELNITA",1159,747,732,9,6,741,6,1298,551,358,383,3,10540,0
27,"Mehedinti",112245,252,112245,,"ESELNITA",194,"GRADINITA ESELNITA",1263,794,791,0,3,787,7,1399,605,377,410,3,10540,0
27,"Mehedinti",112245,252,112245,,"ESELNITA",195,"GRADINITA DE COPII ARLECHINO ESELNITA, STRADA TEILOR, NR. 530",0,144,0,144,0,142,2,499,355,62,80,3,10540,1
27,"Mehedinti",111685,252,111685,,"FLORESTI",196,"SCOALA GENERALA I-VIII FLORESTI",1339,810,804,6,0,805,5,1499,689,362,443,3,10542,0
27,"Mehedinti",111685,252,111685,,"FLORESTI",197,"SCOALA GENERALA I-VIII ZEGUJANI",763,542,525,17,0,537,5,797,255,162,375,3,10542,0
27,"Mehedinti",111685,252,111685,,"FLORESTI",198,"SCOALA CU CLASELE I-VIII, SAT ZEGUJANI",0,263,0,263,0,260,3,501,238,134,126,3,10542,1
27,"Mehedinti",111783,252,111783,,"GARLA MARE",199,"CAMINUL CULTURAL GARLA MARE",1500,772,710,16,46,748,24,1699,927,443,305,3,10552,0
27,"Mehedinti",111783,252,111783,,"GARLA MARE",200,"CAMINUL CULTURAL GARLA MARE",1091,636,579,14,43,618,18,1195,559,343,275,3,10552,0
27,"Mehedinti",111783,252,111783,,"GARLA MARE",201,"SCOALA CU CLASELE I-VIII, SAT GARLA MARE",0,431,0,431,0,428,3,499,68,140,288,3,10552,1
27,"Mehedinti",111818,252,111818,,"GODEANU",202,"PRIMARIA GODEANU",514,330,324,6,0,321,9,604,274,222,99,3,10554,0
27,"Mehedinti",111818,252,111818,,"GODEANU",203,"CAMINUL CULTURAL, SAT GODEANU",0,324,0,324,0,322,2,509,185,272,50,3,10554,1
27,"Mehedinti",111863,252,111863,,"GOGOSU",204,"SCOALA GENERALA I-VIII GOGOSU",930,632,613,19,0,625,7,986,354,321,304,3,10559,0
27,"Mehedinti",111863,252,111863,,"GOGOSU",205,"SCOALA GENERALA I-VIII BALTA VERDE",990,604,586,18,0,592,12,1099,495,344,248,3,10559,0
27,"Mehedinti",111863,252,111863,,"GOGOSU",206,"SCOALA GENERALA BURILA MICA",689,400,377,23,0,396,4,801,401,248,148,3,10559,0
27,"Mehedinti",111863,252,111863,,"GOGOSU",207,"SCOALA GENERALA I-IV OSTROVU MARE",418,271,248,23,0,269,2,509,238,155,114,3,10559,0
27,"Mehedinti",111863,252,111863,,"GOGOSU",208,"GRADINITA PF II",41,62,25,37,0,60,2,99,37,47,13,3,10559,0
27,"Mehedinti",111863,252,111863,,"GOGOSU",209,"GRADINITA DE COPII, SAT GOGOSU",0,496,0,496,0,494,2,498,2,221,273,3,10559,1
27,"Mehedinti",111916,252,111916,,"GRECI",210,"CAMINUL CULTURAL GRECI",562,306,301,5,0,304,2,604,298,117,187,3,10564,0
27,"Mehedinti",111916,252,111916,,"GRECI",211,"SCOALA GENERALA BILTANELE",318,185,176,9,0,184,1,401,216,86,98,3,10564,0
27,"Mehedinti",111916,252,111916,,"GRECI",212,"SCOALA GENERALA SALATRUC",197,122,118,4,0,121,1,199,77,57,64,3,10564,0
27,"Mehedinti",111916,252,111916,,"GRECI",213,"GRADINITA, SAT GRECI",0,120,0,120,0,120,0,502,382,43,77,3,10564,1
27,"Mehedinti",111989,252,111989,,"GROZESTI",214,"PRIMARIA GROZESTI",423,282,265,17,0,266,16,499,217,39,227,3,10571,0
27,"Mehedinti",111989,252,111989,,"GROZESTI",215,"SCOALA GENERALA I-IV CIRCENI",722,329,317,12,0,323,6,799,470,153,170,3,10571,0
27,"Mehedinti",111989,252,111989,,"GROZESTI",216,"SCOALA GENERALA I-IV SUSITA",483,253,237,16,0,250,3,499,246,57,193,3,10571,0
27,"Mehedinti",111989,252,111989,,"GROZESTI",217,"SCOALA GENERALA CU CLASELE I-VIII, SAT GROZESTI",0,45,0,45,0,45,0,499,454,18,27,3,10571,1
27,"Mehedinti",112030,252,112030,,"GRUIA",218,"SCOALA GENERALA I-VIII GRUIA",857,486,471,15,0,475,11,899,413,166,309,3,10576,0
27,"Mehedinti",112030,252,112030,,"GRUIA",219,"STADION COMUNAL (SALA SEDINTE) GRUIA",535,339,330,9,0,327,12,599,260,122,205,3,10576,0
27,"Mehedinti",112030,252,112030,,"GRUIA",220,"SCOALA GENERALA IZVOARELE",805,491,479,12,0,479,12,899,408,194,285,3,10576,0
27,"Mehedinti",112030,252,112030,,"GRUIA",221,"SCOALA GENERALA POIANA GRUII",174,130,125,5,0,130,0,199,69,41,89,3,10576,0
27,"Mehedinti",112030,252,112030,,"GRUIA",222,"CAMIN CULTURAL, SAT GRUIA",0,271,0,271,0,265,6,499,228,159,106,3,10576,1
27,"Mehedinti",112076,252,112076,,"HINOVA",223,"SCOALA GENERALA I-VIII HINOVA",822,407,398,9,0,402,5,899,492,184,218,3,10580,0
27,"Mehedinti",112076,252,112076,,"HINOVA",224,"SCOALA GENERALA I-VIII BISTRITA",1078,654,643,11,0,645,9,1199,545,387,258,3,10580,0
27,"Mehedinti",112076,252,112076,,"HINOVA",225,"SCOALA GENERALA I-IV OSTROVU CORBULUI",340,207,198,9,0,205,2,399,192,103,102,3,10580,0
27,"Mehedinti",112076,252,112076,,"HINOVA",226,"SCOALA GENERALA CU CLASELE I-VIII, SAT HINOVA",0,278,0,278,0,275,3,489,211,178,97,3,10580,1
27,"Mehedinti",112129,252,112129,,"HUSNICIOARA",227,"CAMINUL CULTURAL HUSNICIOARA",627,370,364,6,0,366,4,699,329,198,168,3,10585,0
27,"Mehedinti",112129,252,112129,,"HUSNICIOARA",228,"CAMINUL CULTURAL PERI",338,218,210,8,0,212,6,399,181,109,103,3,10585,0
27,"Mehedinti",112129,252,112129,,"HUSNICIOARA",229,"SCOALA GENERALA BADITESTI",179,134,128,6,0,128,6,202,68,77,51,3,10585,0
27,"Mehedinti",112129,252,112129,,"HUSNICIOARA",230,"SCOALA GENERALA CU CLASELE I-VIII, SAT HUSNICIOARA",0,287,0,287,0,287,0,501,214,151,136,3,10585,1
27,"Mehedinti",112263,252,112263,,"ILOVAT",231,"CABINET MEDICAL UMAN ILOVAT",1082,641,641,0,0,632,9,1198,557,344,288,3,10597,0
27,"Mehedinti",112263,252,112263,,"ILOVAT",232,"CAMINUL CULTURAL, SAT ILOVAT",0,189,0,189,0,188,1,499,310,77,111,3,10597,1
27,"Mehedinti",112334,252,112334,,"ILOVITA",233,"GRADINITA DE COPII ILOVITA",665,523,516,7,0,523,0,699,176,304,219,3,10604,0
27,"Mehedinti",112334,252,112334,,"ILOVITA",234,"SCOALA GENERALA BAHNA",443,271,260,11,0,266,5,499,228,144,122,3,10604,0
27,"Mehedinti",112334,252,112334,,"ILOVITA",235,"CLADIREA FOSTULUI DISPENSAR, SAT ILOVITA",0,288,0,288,0,288,0,499,211,165,123,3,10604,1
27,"Mehedinti",112370,252,112370,,"ISVERNA",236,"SCOALA GENERALA ISVERNA",1334,766,762,4,0,753,13,1499,733,490,263,3,10608,0
27,"Mehedinti",112370,252,112370,,"ISVERNA",237,"SCOALA GENERALA NADANOVA",350,196,188,8,0,193,3,399,203,97,96,3,10608,0
27,"Mehedinti",112370,252,112370,,"ISVERNA",238,"CAMINUL CULTURAL BUSESTI",171,117,111,6,0,116,1,199,82,55,61,3,10608,0
27,"Mehedinti",112370,252,112370,,"ISVERNA",239,"SCOALA GENERALA CU CLASELE I-IV, SAT ISVERNA",0,107,0,107,0,105,2,499,392,33,72,3,10608,1
27,"Mehedinti",112469,252,112469,,"IZVORU BARZII",240,"CAMINUL CULTURAL IZVORU BARZII",1069,691,679,12,0,684,7,999,308,425,259,3,10617,0
27,"Mehedinti",112469,252,112469,,"IZVORU BARZII",241,"SCOALA GENERALA I-IV BALOTESTI",364,260,233,27,0,253,7,399,139,136,117,3,10617,0
27,"Mehedinti",112469,252,112469,,"IZVORU BARZII",242,"SCOALA GENERALA I-VIII HALINGA",704,436,423,13,0,426,10,812,376,239,187,3,10617,0
27,"Mehedinti",112469,252,112469,,"IZVORU BARZII",243,"MAGAZIN SATESC SCHITUL TOPOLNITEI DE SUS",89,54,43,11,0,54,0,99,45,31,23,3,10617,0
27,"Mehedinti",112469,252,112469,,"IZVORU BARZII",244,"SCOALA GENERALA CU CLASELE I-VIII, SAT IZVORU BARZII",0,645,0,645,0,640,5,699,54,428,212,3,10617,1
27,"Mehedinti",112548,252,112548,,"JIANA",245,"SCOALA GENERALA I-VIII JIANA",626,417,401,16,0,414,3,699,282,113,301,3,10625,0
27,"Mehedinti",112548,252,112548,,"JIANA",246,"SCOALA GENERALA I-IV JIANA MARE",655,471,464,7,0,466,5,699,228,177,289,3,10625,0
27,"Mehedinti",112548,252,112548,,"JIANA",247,"SCOALA GENERALA I-VIII JIANA VECHE",832,510,498,12,0,500,10,899,389,119,381,3,10625,0
27,"Mehedinti",112548,252,112548,,"JIANA",248,"CAMINUL CULTURAL DANCEU",975,696,675,12,9,683,13,1098,402,125,558,3,10625,0
27,"Mehedinti",112548,252,112548,,"JIANA",249,"CAMINUL CULTURAL CIOROBORENI",618,411,403,8,0,404,7,699,288,127,277,3,10625,0
27,"Mehedinti",112548,252,112548,,"JIANA",250,"CAMINUL CULTURAL, SAT JIANA",0,412,0,412,0,408,4,499,87,161,247,3,10625,1
27,"Mehedinti",112600,252,112600,,"LIVEZILE",251,"SCOALA GENERALA I-VIII LIVEZILE",769,425,417,8,0,417,8,798,373,203,214,3,10631,0
27,"Mehedinti",112600,252,112600,,"LIVEZILE",252,"SCOALA GENERALA IZVORU ANESTILOR",408,241,231,9,1,238,3,499,258,116,122,3,10631,0
27,"Mehedinti",112600,252,112600,,"LIVEZILE",253,"SCOALA GENERALA IZVORALU DE JOS",174,104,98,6,0,103,1,199,95,59,44,3,10631,0
27,"Mehedinti",112600,252,112600,,"LIVEZILE",254,"SCOALA GENERALA CU CLASELE I-VIII, SAT LIVEZILE",0,205,0,205,0,204,1,500,295,90,114,3,10631,1
27,"Mehedinti",112664,252,112664,,"MALOVAT",255,"SCOALA GENERALA MALOVAT",969,666,643,16,7,664,2,1099,433,417,247,3,10637,0
27,"Mehedinti",112664,252,112664,,"MALOVAT",256,"SCOALA GENERALA I-IV 23 AUGUST",695,428,407,20,1,423,5,799,371,249,174,3,10637,0
27,"Mehedinti",112664,252,112664,,"MALOVAT",257,"CAMINUL CULTURAL BOBAITA",529,359,337,22,0,352,7,599,240,196,156,3,10637,0
27,"Mehedinti",112664,252,112664,,"MALOVAT",258,"SCOALA GENERALA CU CLASELE I-VIII, SAT MALOVAT",0,306,0,306,0,302,4,499,193,217,85,3,10637,1
27,"Mehedinti",112744,252,112744,,"OBARSIA DE CAMP",259,"CAMINUL CULTURAL OBARSIA DE CAMP",761,495,460,7,28,488,7,899,404,160,328,3,10645,0
27,"Mehedinti",112744,252,112744,,"OBARSIA DE CAMP",260,"CAMINUL CULTURAL IZIMSA",951,654,611,12,31,651,3,999,345,299,352,3,10645,0
27,"Mehedinti",112744,252,112744,,"OBARSIA DE CAMP",261,"CAMNINUL CULTURAL, SAT OBARSIA DE CAMP",0,222,0,222,0,219,3,499,277,107,112,3,10645,1
27,"Mehedinti",110027,252,110027,,"OBARSIA-CLOSANI",262,"SCOALA GENERALA I-VIII OBARSIA-CLOSANI",840,518,514,4,0,511,7,900,382,230,281,3,10648,0
27,"Mehedinti",110027,252,110027,,"OBARSIA-CLOSANI",263,"SCOALA GENERALA CU CLASELE I-VIII, SAT OBARSIA-CLOSANI",0,60,0,60,0,60,0,499,439,24,36,3,10648,1
27,"Mehedinti",112771,252,112771,,"OPRISOR",264,"CAMINUL CULTURAL OPRISOR",916,562,539,7,16,553,9,999,437,280,273,3,10651,0
27,"Mehedinti",112771,252,112771,,"OPRISOR",265,"SCOALA GENERALA I-VIII OPRISOR",904,554,532,11,11,530,24,999,445,278,252,3,10651,0
27,"Mehedinti",112771,252,112771,,"OPRISOR",266,"SCOALA GENERALA PRISACEAUA",394,244,232,10,2,241,3,499,255,67,174,3,10651,0
27,"Mehedinti",112771,252,112771,,"OPRISOR",267,"SCOALA GENERALA NR.1, CORP 1, SAT OPRISOR",0,182,0,182,0,181,1,499,317,90,91,3,10651,1
27,"Mehedinti",112806,252,112806,,"PADINA",268,"CAMINUL CULTURAL PADINA MARE",232,164,143,5,16,162,2,289,125,63,99,3,10654,0
27,"Mehedinti",112806,252,112806,,"PADINA",269,"SCOALA GENERALA PADINA MICA",191,116,103,9,4,114,2,199,83,39,75,3,10654,0
27,"Mehedinti",112806,252,112806,,"PADINA",270,"SCOALA GENERALA OLTEANCA",88,66,53,8,5,66,0,100,34,14,52,3,10654,0
27,"Mehedinti",112806,252,112806,,"PADINA",271,"SCOALA GENERALA IABLANITA",241,156,138,7,11,151,5,299,143,40,111,3,10654,0
27,"Mehedinti",112806,252,112806,,"PADINA",272,"CAMINUL CULTURAL SLASOMA",424,330,286,11,33,330,0,496,166,53,277,3,10654,0
27,"Mehedinti",112806,252,112806,,"PADINA",273,"SCOALA GENERALA BIBAN",77,63,53,10,0,63,0,99,36,26,37,3,10654,0
27,"Mehedinti",112806,252,112806,,"PADINA",274,"SCOALA GENERALA CU CLASELE I-IV, SAT SLASOMA",0,172,0,172,0,171,1,499,327,38,133,3,10654,1
27,"Mehedinti",112879,252,112879,,"PATULELE",275,"CAMINUL CULTURAL PATULELE",1348,849,772,65,12,838,11,1499,650,371,467,3,10661,0
27,"Mehedinti",112879,252,112879,,"PATULELE",276,"SCOALA GENERALA PATULELE",1113,675,593,69,13,660,15,1199,524,319,341,3,10661,0
27,"Mehedinti",112879,252,112879,,"PATULELE",277,"GRADINITA NR. 3 RUDARIE",376,172,156,16,0,167,5,392,220,65,102,3,10661,0
27,"Mehedinti",112879,252,112879,,"PATULELE",278,"CAMINUL CULTURAL VIASU",477,280,263,11,6,278,2,499,219,127,151,3,10661,0
27,"Mehedinti",112879,252,112879,,"PATULELE",279,"CENTRUL SOCIAL DE ZI, SAT PATULELE",0,172,0,172,0,172,0,499,327,59,113,3,10661,1
27,"Mehedinti",112959,252,112959,,"PODENI",280,"CAMINUL CULTURAL PODENI",631,434,434,0,0,433,1,699,265,246,187,3,10664,0
27,"Mehedinti",112959,252,112959,,"PODENI",281,"CAMINUL CULTURAL GORNENTI",155,117,110,7,0,116,1,199,82,45,71,3,10664,0
27,"Mehedinti",112959,252,112959,,"PODENI",282,"CAMINUL CULTURAL, SAT PODENI",0,158,0,158,0,158,0,501,343,79,79,3,10664,1
27,"Mehedinti",112995,252,112995,,"PONOARELE",283,"CAMINUL CULTURAL PONOARELE",826,556,543,5,8,548,8,899,343,283,265,3,10668,0
27,"Mehedinti",112995,252,112995,,"PONOARELE",284,"CAMINUL CULTURAL GHEORGHESTI",555,329,320,7,2,325,4,599,270,142,183,3,10668,0
27,"Mehedinti",112995,252,112995,,"PONOARELE",285,"SCOALA GENERALA I-IV GARDANEASA",425,279,271,7,1,272,7,506,227,160,112,3,10668,0
27,"Mehedinti",112995,252,112995,,"PONOARELE",286,"CAMINUL CULTURAL BIRIIAC",232,158,148,9,1,157,1,275,117,71,86,3,10668,0
27,"Mehedinti",112995,252,112995,,"PONOARELE",287,"SEDIUL VECHI AL PRIMARIEI PONOARELE",0,230,0,230,0,230,0,505,275,143,87,3,10668,1
27,"Mehedinti",113153,252,113153,,"POROINA MARE",288,"CAMINUL CULTURAL POROINA MARE",411,257,225,11,21,253,4,501,244,52,201,3,10684,0
27,"Mehedinti",113153,252,113153,,"POROINA MARE",289,"SCOALA GENERALA I-IV STIGNITA",406,310,289,6,15,306,4,496,186,94,212,3,10684,0
27,"Mehedinti",113153,252,113153,,"POROINA MARE",290,"SCOALA GENERALA FINTINILE NEGRE",163,131,113,11,7,131,0,199,68,57,74,3,10684,0
27,"Mehedinti",113153,252,113153,,"POROINA MARE",291,"SCOALA GENERALA CU CLASELE I-IV, SAT POROINA MARE",0,274,0,274,0,273,1,500,226,102,171,3,10684,1
27,"Mehedinti",113206,252,113206,,"PRISTOL",292,"CAMINUL CULTURAL PRISTOL",910,682,620,12,50,679,3,999,317,350,329,3,10689,0
27,"Mehedinti",113206,252,113206,,"PRISTOL",293,"SCOALA GENERALA COZIA",491,388,363,3,22,387,1,499,111,197,190,3,10689,0
27,"Mehedinti",113206,252,113206,,"PRISTOL",294,"CAMINUL CULTURAL, SAT PRISTOL",0,279,0,279,0,276,3,499,220,137,139,3,10689,1
27,"Mehedinti",113233,252,113233,,"PRUNISOR",295,"SCOALA GENERALA PRUNISOR",449,316,306,10,0,313,3,401,85,78,235,3,10692,0
27,"Mehedinti",113233,252,113233,,"PRUNISOR",296,"CAMINUL CULTURAL FINTINA DOMNEASCA",359,213,197,16,0,210,3,399,186,82,128,3,10692,0
27,"Mehedinti",113233,252,113233,,"PRUNISOR",297,"SCOALA GENERALA CERVENITA",352,225,214,10,1,223,2,394,169,74,149,3,10692,0
27,"Mehedinti",113233,252,113233,,"PRUNISOR",298,"SCOALA GENERALA GHELMEGIOAIA",326,202,198,4,0,200,2,392,190,70,130,3,10692,0
27,"Mehedinti",113233,252,113233,,"PRUNISOR",299,"SCOALA GENERALA ZEGAIA",251,162,153,9,0,161,1,300,138,34,127,3,10692,0
27,"Mehedinti",113233,252,113233,,"PRUNISOR",300,"CAMINUL CULTURAL, SAT PRUNISOR",0,508,0,508,0,507,1,600,92,252,255,3,10692,1
27,"Mehedinti",113395,252,113395,,"PUNGHINA",301,"CAMINUL CULTURAL PUNGHINA",1069,864,843,21,0,841,23,1199,335,702,139,3,10708,0
27,"Mehedinti",113395,252,113395,,"PUNGHINA",302,"GRADINITA RECEA",768,410,401,9,0,405,5,899,489,252,153,3,10708,0
27,"Mehedinti",113395,252,113395,,"PUNGHINA",303,"CAMINUL CULTURAL CEARING",148,116,103,13,0,115,1,199,83,85,30,3,10708,0
27,"Mehedinti",113395,252,113395,,"PUNGHINA",304,"CAMINUL CULTURAL DRINCEA",337,236,227,9,0,235,1,399,163,87,148,3,10708,0
27,"Mehedinti",113395,252,113395,,"PUNGHINA",305,"CAMINUL CULTURAL, SAT PUNGHINA",0,207,0,207,0,206,1,500,293,104,102,3,10708,1
27,"Mehedinti",113466,252,113466,,"ROGOVA",306,"SCOALA GENERALA I-VIII ROGOVA",1168,833,793,5,35,825,8,1249,416,490,335,3,10715,0
27,"Mehedinti",113466,252,113466,,"ROGOVA",307,"SCOALA GENERALA CU CLASELE I-VIII, SAT ROGOVA",0,425,0,425,0,422,3,495,70,244,178,3,10715,1
27,"Mehedinti",113493,252,113493,,"SALCIA",308,"SCOALA GENERALA I-VIII SALCIA",1290,659,644,15,0,652,7,1400,741,321,331,3,10718,0
27,"Mehedinti",113493,252,113493,,"SALCIA",309,"SCOALA GENERALA I-IV SALCIA",1366,688,673,15,0,677,11,1499,811,292,385,3,10718,0
27,"Mehedinti",113493,252,113493,,"SALCIA",310,"SCOALA GENERALA CU CLASELE I-IV, SAT SALCIA",0,98,0,98,0,97,1,510,412,32,65,3,10718,1
27,"Mehedinti",113518,252,113518,,"STANGACEAUA",311,"CAMINUL CULTURAL STANGACEAUA",800,518,511,7,0,514,4,895,377,223,291,3,10740,0
27,"Mehedinti",113518,252,113518,,"STANGACEAUA",312,"SCOALA GENERALA SATU MARE",389,256,243,13,0,251,5,401,145,98,153,3,10740,0
27,"Mehedinti",113518,252,113518,,"STANGACEAUA",313,"SCOALA GENERALA CU CLASELE I-VIII, SAT STANGACEAUA",0,96,0,96,0,95,1,500,404,43,52,3,10740,1
27,"Mehedinti",113607,252,113607,,"SVINITA",314,"PRIMARIA SVINITA",909,649,628,5,16,647,2,1046,397,305,342,3,10749,0
27,"Mehedinti",113607,252,113607,,"SVINITA",315,"BIBLIOTECA COMUNALA SVINITA, STRADA 2, NR. 24",0,127,0,127,0,127,0,507,380,69,58,3,10749,1
27,"Mehedinti",109826,252,109826,,"SIMIAN",316,"SCOALA GENERALA I-VIII SIMIAN",1616,879,867,12,0,867,12,1400,521,385,482,3,10720,0
27,"Mehedinti",109826,252,109826,,"SIMIAN",317,"SCOALA GENERALA I-VIII SIMIAN",1664,873,862,11,0,867,6,1799,926,369,498,3,10720,0
27,"Mehedinti",109826,252,109826,,"SIMIAN",318,"SCOALA GENERALA I-VIII CERNETI",1390,752,738,14,0,743,9,1499,747,359,384,3,10720,0
27,"Mehedinti",109826,252,109826,,"SIMIAN",319,"SCOALA GENERALA I-VIII CERNETI",1374,775,762,13,0,768,7,1499,724,349,419,3,10720,0
27,"Mehedinti",109826,252,109826,,"SIMIAN",320,"SCOALA GENERALA DUDASU",892,487,477,10,0,475,12,997,510,254,221,3,10720,0
27,"Mehedinti",109826,252,109826,,"SIMIAN",321,"SCOALA GENERALA POROINA",269,177,165,12,0,173,4,302,125,51,122,3,10720,0
27,"Mehedinti",109826,252,109826,,"SIMIAN",322,"SCOALA GENERALA DEDOVITA NOUA",312,215,208,7,0,215,0,405,190,95,120,3,10720,0
27,"Mehedinti",109826,252,109826,,"SIMIAN",323,"SCOALA GENERALA VALEA COPCII",112,81,71,10,0,80,1,99,18,46,34,3,10720,0
27,"Mehedinti",109826,252,109826,,"SIMIAN",324,"CLADIRE CONSUMCOOP ERGHEVITA",252,156,147,9,0,154,2,299,143,67,87,3,10720,0
27,"Mehedinti",109826,252,109826,,"SIMIAN",325,"LICEUL TUDOR VLADIMIRESCU SIMIAN, STRADA GARII, NR. 2",0,704,0,704,0,697,7,899,195,324,373,3,10720,1
27,"Mehedinti",113625,252,113625,,"SISESTI",326,"CAMINUL CULTURAL SISESTI",973,537,525,12,0,528,9,1048,511,312,216,3,10729,0
27,"Mehedinti",113625,252,113625,,"SISESTI",327,"SCOALA GENERALA I-IV COCOROVA",642,331,315,16,0,325,6,699,368,186,139,3,10729,0
27,"Mehedinti",113625,252,113625,,"SISESTI",328,"CAMINUL CULTURAL NOAPTESA",661,451,443,6,2,439,12,699,248,277,162,3,10729,0
27,"Mehedinti",113625,252,113625,,"SISESTI",329,"LICEUL GHEORGHE IONESCU SISESTI, SAT SISESTI",0,291,0,291,0,290,1,499,208,167,123,3,10729,1
27,"Mehedinti",113698,252,113698,,"SOVARNA",330,"PRIMARIA SOVARNA",1054,630,626,4,0,625,5,1200,570,340,285,3,10736,0
27,"Mehedinti",113698,252,113698,,"SOVARNA",331,"CAMINUL CULTURAL, SAT SOVARNA",0,180,0,180,0,178,2,499,319,99,79,3,10736,1
27,"Mehedinti",113732,252,113732,,"TAMNA",332,"PRIMARIA TAMNA",844,361,351,10,0,356,5,899,538,169,187,3,10751,0
27,"Mehedinti",113732,252,113732,,"TAMNA",333,"SCOALA GENERALA TAMNA",592,303,291,12,0,300,3,699,396,138,162,3,10751,0
27,"Mehedinti",113732,252,113732,,"TAMNA",334,"SCOALA GENERALA IZVORALU",332,291,278,13,0,291,0,399,108,141,150,3,10751,0
27,"Mehedinti",113732,252,113732,,"TAMNA",335,"SCOALA GENERALA PLOPI",499,345,337,8,0,338,7,499,154,198,140,3,10751,0
27,"Mehedinti",113732,252,113732,,"TAMNA",336,"SCOALA GENERALA CREMENEA",183,98,85,13,0,96,2,198,100,53,43,3,10751,0
27,"Mehedinti",113732,252,113732,,"TAMNA",337,"SCOALA GENERALA CU CLASELE I-VIII, SAT VALEA URSULUI",0,208,0,208,0,206,2,499,291,87,119,3,10751,1
27,"Mehedinti",113849,252,113849,,"VANATORI",338,"SCOALA GENERALA I-VIII VANATORI",942,615,572,43,0,607,8,999,384,298,309,3,10763,0
27,"Mehedinti",113849,252,113849,,"VANATORI",339,"SCOALA GENERALA I-IV ROSIORI",836,475,465,10,0,466,9,899,424,210,256,3,10763,0
27,"Mehedinti",113849,252,113849,,"VANATORI",340,"SCOALA GENERALA CU CLASELE I-VIII, SAT VANATORI",0,207,0,207,0,205,2,499,292,123,82,3,10763,1
27,"Mehedinti",113894,252,113894,,"VANJULET",341,"CAMINUL CULTURAL VANJULET",1389,906,745,6,155,886,20,1497,591,226,660,3,10766,0
27,"Mehedinti",113894,252,113894,,"VANJULET",342,"CAMINUL CULTURAL, SAT VANJULET",0,189,0,189,0,187,2,505,316,59,128,3,10766,1
27,"Mehedinti",113929,252,113929,,"VLADAIA",343,"SCOALA GENERALA VLADAIA",527,292,283,8,1,288,4,599,307,61,227,3,10769,0
27,"Mehedinti",113929,252,113929,,"VLADAIA",344,"SCOALA GENERALA ALMAJEL",569,272,267,5,0,265,7,599,327,116,149,3,10769,0
27,"Mehedinti",113929,252,113929,,"VLADAIA",345,"SCOALA GENERALA SCORILA",212,132,127,5,0,130,2,199,67,74,56,3,10769,0
27,"Mehedinti",113929,252,113929,,"VLADAIA",346,"SCOALA GENERALA STIRCOVITA",211,141,133,8,0,138,3,199,58,45,93,3,10769,0
27,"Mehedinti",113929,252,113929,,"VLADAIA",347,"SCOALA GENERALA CU CLASELE I -VIII PREDA BUZESCU, SAT VLADAIA",0,167,0,167,0,165,2,499,332,45,120,3,10769,1
27,"Mehedinti",113974,252,113974,,"VOLOIAC",348,"SCOALA GENERALA I-VIII  VOLOIAC",412,280,269,11,0,277,3,499,219,138,139,3,10774,0
27,"Mehedinti",113974,252,113974,,"VOLOIAC",349,"SCOALA GENERALA I-IV COTOROAIA",448,264,244,20,0,259,5,499,235,122,137,3,10774,0
27,"Mehedinti",113974,252,113974,,"VOLOIAC",350,"SCOALA GENERALA I-IV LAC",103,75,64,11,0,75,0,99,24,23,52,3,10774,0
27,"Mehedinti",113974,252,113974,,"VOLOIAC",351,"SCOALA GENERALA I-IV VALEA BUNA",314,178,175,3,0,175,3,299,121,78,97,3,10774,0
27,"Mehedinti",113974,252,113974,,"VOLOIAC",352,"SCOALA GENERALA I-IV RUPTURA",135,107,101,6,0,105,2,199,92,58,47,3,10774,0
27,"Mehedinti",113974,252,113974,,"VOLOIAC",353,"SCOALA GENERALA CU CLASELE I-VIII, SAT VOLOIAC",0,136,0,136,0,136,0,502,366,60,76,3,10774,1
27,"Mehedinti",114079,252,114079,,"VRATA",354,"CAMINUL CULTURAL SAT VRATA",1444,859,853,6,0,855,4,1499,640,472,383,3,10783,0
27,"Mehedinti",114079,252,114079,,"VRATA",355,"CAMINUL CULTURAL SAT VRATA",0,398,0,398,0,392,6,499,101,215,177,3,10783,1
28,"Mures",114319,261,114319,,"MUNICIPIUL TARGU MURES",1,"Casa ""Apollo"" (Scoala de Arte), Piata Trandafirilor, nr. 5",1482,699,690,7,2,689,10,1600,901,264,425,1,10786,0
28,"Mures",114319,261,114319,,"MUNICIPIUL TARGU MURES",2,"Universitatea  ""Petru Maior"", Strada  N. Iorga, nr. 1",1637,745,728,17,0,730,15,1800,1055,274,456,1,10786,0
28,"Mures",114319,261,114319,,"MUNICIPIUL TARGU MURES",3,"Liceul Teoretic ""Bolyai Farkas"", Strada  Bolyai, nr. 3",1451,818,677,20,121,787,31,1600,782,297,490,1,10786,0
28,"Mures",114319,261,114319,,"MUNICIPIUL TARGU MURES",4,"Internat Grupul Scolar ""Avram Iancu"" Strada Iuliu Maniu, nr. 4",1399,674,662,11,1,663,11,1500,826,204,459,1,10786,0
28,"Mures",114319,261,114319,,"MUNICIPIUL TARGU MURES",5,"Gimnaziul Nicolae Balcescu (fosta Scoala Generala nr. 13), Strada  Ialomitei, nr. 3 (cladirea noua)",1728,809,798,10,1,799,10,1900,1091,310,489,1,10786,0
28,"Mures",114319,261,114319,,"MUNICIPIUL TARGU MURES",6,"Gimnaziul Nicolae Balcescu (fosta Scoala Generala nr. 13), Strada  Ialomitei, nr. 3 (cladirea noua)",1102,458,437,15,6,453,5,1199,741,239,214,1,10786,0
28,"Mures",114319,261,114319,,"MUNICIPIUL TARGU MURES",7,"Gimnaziul Nicolae Balcescu (fosta Scoala Generala nr. 13), Strada  Ialomitei, nr. 3 (cladirea veche)",1598,736,721,15,0,728,8,1700,964,331,397,1,10786,0
28,"Mures",114319,261,114319,,"MUNICIPIUL TARGU MURES",8,"Gimnaziul Nicolae Balcescu (fosta Scoala Generala nr. 13), Strada  Ialomitei, nr. 3 (cladirea veche)",1843,874,854,20,0,860,14,2000,1126,385,475,1,10786,0
28,"Mures",114319,261,114319,,"MUNICIPIUL TARGU MURES",9,"Grup Scolar ""Aurel Persu"", Strada  Milcovului, nr. 5",2024,905,885,20,0,896,9,2200,1295,551,345,1,10786,0
28,"Mures",114319,261,114319,,"MUNICIPIUL TARGU MURES",10,"Gimnaziul Nicolae Balcescu (fosta Scoala Generala nr.12), Strada  Libertatii, nr. 36/A",1753,833,815,17,1,813,20,1900,1067,287,526,1,10786,0
28,"Mures",114319,261,114319,,"MUNICIPIUL TARGU MURES",11,"Sediul Primariei Municipiului Tirgu Mures, Piata Victoriei nr.3",1388,687,664,22,1,669,18,1500,813,254,415,1,10786,0
28,"Mures",114319,261,114319,,"MUNICIPIUL TARGU MURES",12,"Colegiul Agricol ""Traian Savulescu"", Strada  Calarasilor, nr. 108",1606,773,753,17,3,763,10,1700,927,294,469,1,10786,0
28,"Mures",114319,261,114319,,"MUNICIPIUL TARGU MURES",13,"Gimnaziul ""Alexandru Ioan Cuza"" (fosta Scoala Generala nr. 8), Strada Baraganului, nr. 2B",1926,1073,1067,6,0,1061,12,2099,1026,592,469,1,10786,0
28,"Mures",114319,261,114319,,"MUNICIPIUL TARGU MURES",14,"Gimnaziul ""Alexandru Ioan Cuza"" (fosta Scoala Generala nr. 8), Strada Baraganului, nr. 2B",1762,944,936,8,0,928,16,1900,956,483,445,1,10786,0
28,"Mures",114319,261,114319,,"MUNICIPIUL TARGU MURES",15,"Gimnaziul ""Alexandru Ioan Cuza"" (fosta Scoala Generala nr. 8), Strada Baraganului, nr. 2B",1852,882,866,13,3,872,10,2000,1118,462,410,1,10786,0
28,"Mures",114319,261,114319,,"MUNICIPIUL TARGU MURES",16,"Gimnaziul ""Alexandru Ioan Cuza"" (fosta Scoala Generala nr. 8), Strada Baraganului, nr. 2B",1525,767,762,5,0,753,14,1600,833,429,324,1,10786,0
28,"Mures",114319,261,114319,,"MUNICIPIUL TARGU MURES",17,"Gimnaziul ""Alexandru Ioan Cuza"" (fosta Scoala Generala nr. 8), Strada Baraganului, nr. 2B",1633,805,803,2,0,789,16,1796,991,387,402,1,10786,0
28,"Mures",114319,261,114319,,"MUNICIPIUL TARGU MURES",18,"Gimnaziul ""Alexandru Ioan Cuza"" (fosta Scoala Generala nr. 8), Strada Baraganului, nr. 2B",1620,818,810,7,1,813,5,1700,882,390,423,1,10786,0
28,"Mures",114319,261,114319,,"MUNICIPIUL TARGU MURES",19,"Gimnaziul Friederich Schiller (fosta Scoala Generala nr. 16), Aleea Carpati, nr. 23",1343,647,629,18,0,631,16,1500,853,212,419,1,10786,0
28,"Mures",114319,261,114319,,"MUNICIPIUL TARGU MURES",20,"Gimnaziul Friederich Schiller (fosta Scoala Generala nr. 16), Aleea Carpati, nr. 23",1406,736,723,13,0,723,13,1499,763,281,442,1,10786,0
28,"Mures",114319,261,114319,,"MUNICIPIUL TARGU MURES",21,"Liceul cu Program Sportiv ""Szasz Adalbert"", Strada Paul Chinezu, nr. 9/A",1730,718,696,22,0,706,12,1900,1182,262,444,1,10786,0
28,"Mures",114319,261,114319,,"MUNICIPIUL TARGU MURES",22,"Gadinita cu Program Prelungit nr. 6, Strada  Marasti, nr. 1",1899,944,925,19,0,935,9,1992,1048,383,552,1,10786,0
28,"Mures",114319,261,114319,,"MUNICIPIUL TARGU MURES",23,"Grupul Scolar ""C. Brancusi"", Strada  Victor Babes, nr. 11",1425,767,757,10,0,754,13,1500,733,270,484,1,10786,0
28,"Mures",114319,261,114319,,"MUNICIPIUL TARGU MURES",24,"Liceul cu Program Sportiv ""Szasz Adalbert"", Strada  Victor Babes, nr. 11",1152,622,611,10,1,611,11,1300,678,214,397,1,10786,0
28,"Mures",114319,261,114319,,"MUNICIPIUL TARGU MURES",25,"Scoala Generala nr. 7/A, Aleea Constructorilor, nr. 49",1700,849,835,13,1,843,6,1800,951,344,499,1,10786,0
28,"Mures",114319,261,114319,,"MUNICIPIUL TARGU MURES",26,"Scoala Generala nr. 7/B, (fosta Scoala Generala nr.6), Strada  Secuilor Martiri, nr. 14",1276,581,567,14,0,572,9,1400,819,251,321,1,10786,0
28,"Mures",114319,261,114319,,"MUNICIPIUL TARGU MURES",27,"Scoala Generala nr. 7/B, (fosta Scoala Generala nr.6), Strada  Secuilor Martiri, nr. 14",1296,643,624,19,0,629,14,1400,757,257,372,1,10786,0
28,"Mures",114319,261,114319,,"MUNICIPIUL TARGU MURES",28,"Grupul Scolar ""Ioan Vlasiu"", Strada Gh. Marinescu, nr. 62",1865,917,903,12,2,903,14,2000,1083,432,471,1,10786,0
28,"Mures",114319,261,114319,,"MUNICIPIUL TARGU MURES",29,"CASA ""M. Eminescu"", Strada Grigorescu, nr. 19",983,509,499,10,0,505,4,1100,591,168,337,1,10786,0
28,"Mures",114319,261,114319,,"MUNICIPIUL TARGU MURES",30,"Colegiul National ""Unirea"", Strada Mihai Viteazu, nr.15-17",1925,1018,1006,11,1,1002,16,2098,1080,337,665,1,10786,0
28,"Mures",114319,261,114319,,"MUNICIPIUL TARGU MURES",31,"Liceul Pedagogic ""M. Eminescu"", Strada Papiu Ilarian, nr. 37",1785,800,783,17,0,790,10,1900,1100,372,418,1,10786,0
28,"Mures",114319,261,114319,,"MUNICIPIUL TARGU MURES",32,"Gimnaziul de Stat ""Tudor Vladimirescu"", Strada  Cutezantei, nr. 51",1863,902,892,10,0,890,12,2000,1098,470,420,1,10786,0
28,"Mures",114319,261,114319,,"MUNICIPIUL TARGU MURES",33,"Gimnaziul de Stat ""Tudor Vladimirescu"", Strada  Cutezantei, nr. 51",1937,1064,1051,13,0,1056,8,2100,1036,542,514,1,10786,0
28,"Mures",114319,261,114319,,"MUNICIPIUL TARGU MURES",34,"Gimnaziul de Stat ""Tudor Vladimirescu"", Strada  Cutezantei, nr. 51",1921,973,963,10,0,955,18,2099,1126,463,492,1,10786,0
28,"Mures",114319,261,114319,,"MUNICIPIUL TARGU MURES",35,"Grupul Scolar ""Electromures"", Strada Livezeni, nr. 5",1450,731,722,9,0,722,9,1600,869,356,366,1,10786,0
28,"Mures",114319,261,114319,,"MUNICIPIUL TARGU MURES",36,"Gimnaziul de Stat ""Tudor Vladimirescu"", Strada Cutezantei, nr. 51",1814,922,916,5,1,908,14,1900,978,431,477,1,10786,0
28,"Mures",114319,261,114319,,"MUNICIPIUL TARGU MURES",37,"Gimnaziul de Stat ""Tudor Vladimirescu"", Strada Cutezantei, nr. 51",1843,921,910,11,0,907,14,2000,1079,428,479,1,10786,0
28,"Mures",114319,261,114319,,"MUNICIPIUL TARGU MURES",38,"Gimnaziul de Stat ""Mihai Viteazul"", Strada Muncii, nr. 17",1792,884,873,11,0,867,17,1898,1014,370,497,1,10786,0
28,"Mures",114319,261,114319,,"MUNICIPIUL TARGU MURES",39,"Gimnaziul de Stat ""Mihai Viteazul"", Strada Muncii, nr. 17",1951,1022,1010,12,0,1004,18,2100,1078,446,558,1,10786,0
28,"Mures",114319,261,114319,,"MUNICIPIUL TARGU MURES",40,"Gimnaziul de Stat ""Mihai Viteazul"", Strada Muncii, nr. 17",1757,881,868,13,0,867,14,1900,1019,401,466,1,10786,0
28,"Mures",114319,261,114319,,"MUNICIPIUL TARGU MURES",41,"Gimnaziul de Stat ""Mihai Viteazul"", Strada Muncii, nr. 17",1722,898,888,10,0,888,10,1900,1002,374,514,1,10786,0
28,"Mures",114319,261,114319,,"MUNICIPIUL TARGU MURES",42,"Grupul Scolar Electromures, Strada Livezeni, nr. 5",1832,894,885,9,0,885,9,2000,1106,466,419,1,10786,0
28,"Mures",114319,261,114319,,"MUNICIPIUL TARGU MURES",43,"Grupul Scolar Electromures, Strada Livezeni, nr. 5",1391,730,719,11,0,717,13,1499,769,311,406,1,10786,0
28,"Mures",114319,261,114319,,"MUNICIPIUL TARGU MURES",44,"Grupul Scolar Electromures, Strada Livezeni, nr. 5",1878,939,926,13,0,928,11,2000,1061,446,482,1,10786,0
28,"Mures",114319,261,114319,,"MUNICIPIUL TARGU MURES",45,"Gimnaziul de Stat ""Romulus Guga"", Strada Cernavoda, nr. 2",1821,1010,997,13,0,999,11,2000,990,496,503,1,10786,0
28,"Mures",114319,261,114319,,"MUNICIPIUL TARGU MURES",46,"Gimnaziul de Stat ""Romulus Guga"", Strada Cernavoda, nr. 2",1971,1036,1023,12,1,1018,18,2100,1064,491,527,1,10786,0
28,"Mures",114319,261,114319,,"MUNICIPIUL TARGU MURES",47,"Gimnaziul de Stat ""Romulus Guga"", Strada Cernavoda, nr. 2",1920,1032,1017,15,0,1020,12,2100,1068,480,540,1,10786,0
28,"Mures",114319,261,114319,,"MUNICIPIUL TARGU MURES",48,"Gradinita cu Program Prelungit ""Codrisor"" (Fosta Nr. 9), Strada Moldovei, nr. 1",1769,923,898,25,0,911,12,1900,977,430,481,1,10786,0
28,"Mures",114319,261,114319,,"MUNICIPIUL TARGU MURES",49,"Gimnaziul  ""G. Cosbuc"", Strada Moldovei, nr. 30",1564,709,676,29,4,691,18,1700,991,269,422,1,10786,0
28,"Mures",114319,261,114319,,"MUNICIPIUL TARGU MURES",50,"Gimnaziul  ""G. Cosbuc"", Strada Moldovei, nr. 30",1950,970,934,35,1,950,20,2100,1130,348,602,1,10786,0
28,"Mures",114319,261,114319,,"MUNICIPIUL TARGU MURES",51,"Gimnaziul Dacia /B (fosta Scoala Generala Nr.14), Strada T. Vladimirescu, nr. 122",1658,836,816,19,1,819,17,1905,1069,327,492,1,10786,0
28,"Mures",114319,261,114319,,"MUNICIPIUL TARGU MURES",52,"Gimnaziul Dacia /B (fosta Scoala Generala Nr.14), Strada T. Vladimirescu, nr. 122",1698,847,832,15,0,829,18,1800,953,363,466,1,10786,0
28,"Mures",114319,261,114319,,"MUNICIPIUL TARGU MURES",53,"Centrul Scolar pentru Educatie Incluziva nr.1 (fosta Scoala Speciala nr.1) Bulevardul 1 Decembrie 1918, nr. 32",1939,950,939,11,0,938,12,2112,1162,353,585,1,10786,0
28,"Mures",114319,261,114319,,"MUNICIPIUL TARGU MURES",54,"Centrul Scolar pentru Educatie Incluziva nr.1 (fosta Scoala Speciala nr.1) Bulevardul 1 Decembrie 1918, nr. 32",1560,662,653,9,0,641,21,1700,1038,327,314,1,10786,0
28,"Mures",114319,261,114319,,"MUNICIPIUL TARGU MURES",55,"Gimnaziul Dacia /A  (fosta Scoala Generala Nr.10), Pasajul Panselutelor, nr. 6",1877,1045,1028,16,1,1029,16,2000,955,423,606,1,10786,0
28,"Mures",114319,261,114319,,"MUNICIPIUL TARGU MURES",56,"Gimnaziul Dacia /A  (fosta Scoala Generala Nr.10), Pasajul Panselutelor, nr. 6",1841,974,960,13,1,958,16,2000,1026,378,580,1,10786,0
28,"Mures",114319,261,114319,,"MUNICIPIUL TARGU MURES",57,"Grupul Scolar ""Avram Iancu"", Bulevardul 1848, nr. 7",1415,734,721,12,1,720,14,1498,764,246,474,1,10786,0
28,"Mures",114319,261,114319,,"MUNICIPIUL TARGU MURES",58,"Gradinita cu Program Prelungit ""Albinuta"", Strada  Parangului, nr. 23",1812,915,899,16,0,896,19,1900,985,357,539,1,10786,0
28,"Mures",114319,261,114319,,"MUNICIPIUL TARGU MURES",59,"Gimnaziul ""Liviu Rebreanu"", Strada Surianu, nr. 1",1759,821,807,14,0,808,13,1900,1079,325,483,1,10786,0
28,"Mures",114319,261,114319,,"MUNICIPIUL TARGU MURES",60,"Gimnaziul ""Liviu Rebreanu"", Strada Surianu, nr. 1",1861,953,943,10,0,934,19,2000,1047,404,530,1,10786,0
28,"Mures",114319,261,114319,,"MUNICIPIUL TARGU MURES",61,"Parterul piscinei de la Baza Sportiva ""ing. MIRCEA BIRAU"", Strada  Liviu Rebreanu, nr. 29A",1923,872,862,10,0,860,12,2000,1128,348,512,1,10786,0
28,"Mures",114319,261,114319,,"MUNICIPIUL TARGU MURES",62,"Gimnaziul ""Liviu Rebreanu"", Strada  Surianu, nr. 1",1810,853,842,11,0,843,10,1900,1047,344,499,1,10786,0
28,"Mures",114319,261,114319,,"MUNICIPIUL TARGU MURES",63,"Gradinita cu Program Prelungit ""Licurici"", Strada  Lamaitei, nr. 18",1571,741,733,8,0,734,7,1700,959,321,413,1,10786,0
28,"Mures",114319,261,114319,,"MUNICIPIUL TARGU MURES",64,"Gradinita cu Program Prelungit ""LICURICI"", Strada  Lamaitei, nr. 18",1341,735,728,7,0,722,13,1380,645,233,489,1,10786,0
28,"Mures",114319,261,114319,,"MUNICIPIUL TARGU MURES",65,"Grupul Scolar Gh. Sincai (Fosta Scoala Generala Nr. 15), Bulevardul 1848, nr. 55",1412,707,698,9,0,698,9,1500,793,226,472,1,10786,0
28,"Mures",114319,261,114319,,"MUNICIPIUL TARGU MURES",66,"Grupul Scolar Gh. Sincai (Fosta Scoala Generala Nr. 15), Bulevardul 1848, nr. 55",1578,804,790,14,0,797,7,1700,896,334,463,1,10786,0
28,"Mures",114319,261,114319,,"MUNICIPIUL TARGU MURES",67,"Gimnaziul ""Liviu Rebreanu"" (Fosta Scoala gen. Nr. 17) Strada  Surianu, nr. 3",1499,743,732,11,0,727,16,1600,857,287,440,1,10786,0
28,"Mures",114319,261,114319,,"MUNICIPIUL TARGU MURES",68,"Gimnaziul ""Liviu Rebreanu"" (Fosta Scoala Generala Nr. 17), Strada  Surianu, nr. 3",1604,749,735,13,1,740,9,1700,951,358,382,1,10786,0
28,"Mures",114319,261,114319,,"MUNICIPIUL TARGU MURES",69,"Gradinita cu Program Prelungit nr. 14, Strada  Ion Buteanu, nr. 18",1878,773,757,16,0,764,9,2000,1227,340,424,1,10786,0
28,"Mures",114319,261,114319,,"MUNICIPIUL TARGU MURES",70,"Grupul Scolar Gh. Sincai (Fosta Scoala Generala Nr. 15), Bulevardul 1848, nr. 55",1677,742,729,11,2,731,11,1800,1058,289,442,1,10786,0
28,"Mures",114319,261,114319,,"MUNICIPIUL TARGU MURES",71,"Grup Scolar Industrial ""Avram Iancu"", Strada  Gh. Doja, nr. 13 -15",1539,743,719,20,4,711,32,1600,857,301,410,1,10786,0
28,"Mures",114319,261,114319,,"MUNICIPIUL TARGU MURES",72,"Gimnaziul ""Serafim Duicu"" (fosta Scoala Generala nr.11), Strada  Budiului, nr. 50/A",1794,787,774,13,0,769,18,1900,1113,283,486,1,10786,0
28,"Mures",114319,261,114319,,"MUNICIPIUL TARGU MURES",73,"Grupul Scolar ""Traian Vuia"", Strada  Gh. Doja, nr. 102",1633,760,750,10,0,755,5,1690,930,417,338,1,10786,0
28,"Mures",114319,261,114319,,"MUNICIPIUL TARGU MURES",74,"Grupul Scolar ""Traian Vuia"", Strada  Gh. Doja, nr. 102",1717,812,804,8,0,800,12,1800,988,438,362,1,10786,0
28,"Mures",114319,261,114319,,"MUNICIPIUL TARGU MURES",75,"Gimnaziul ""Serafim Duicu"" (fosta Scoala Generala nr.1), Strada  Hunedoara, nr. 38",1763,755,743,10,2,748,7,1900,1145,439,309,1,10786,0
28,"Mures",114319,261,114319,,"MUNICIPIUL TARGU MURES",76,"Gimnaziul ""Serafim Duicu"" (fosta Scoala Generala nr.1), Strada  Hunedoara, nr. 38",1753,813,798,12,3,807,6,1800,987,393,414,1,10786,0
28,"Mures",114319,261,114319,,"MUNICIPIUL TARGU MURES",77,"Grupul Scolar de Chimie Industriala, Strada  Gheorghe Doja nr.250",1674,704,688,16,0,689,15,1711,1007,417,272,1,10786,0
28,"Mures",114319,261,114319,,"MUNICIPIUL TARGU MURES",78,"Caminul Cultural, Strada  Caminului, nr. 13",1135,548,537,11,0,545,3,1199,651,338,207,1,10786,0
28,"Mures",114319,261,114319,,"MUNICIPIUL TARGU MURES",79,"Autogara Tirgu Mures, Strada  Gheorghe Doja nr.143",0,950,0,950,0,933,17,1000,49,553,380,1,10786,1
28,"Mures",114319,261,114319,,"MUNICIPIUL TARGU MURES",80,"Grupul Scolar ""Electromures"", Strada Livezeni nr.5, intrarea din Strada Muncii",0,603,0,603,0,594,9,998,395,380,214,1,10786,1
28,"Mures",114319,261,114319,,"MUNICIPIUL TARGU MURES",81,"Caminul Studentesc nr.3 - Strada Nicolae Grigorescu nr.15/A",0,964,0,964,0,942,22,1500,536,539,403,1,10786,1
28,"Mures",114319,261,114319,,"MUNICIPIUL TARGU MURES",82,"Universitatea de Medicina si Farmacie, Strada Nicolae Grigorescu nr.15",0,417,0,417,0,409,8,1500,1083,225,184,1,10786,1
28,"Mures",114809,261,114809,,"MUNICIPIUL REGHIN",83,"Gimnaziul de stat Alexandru Ceusianu, Piata Petru Maior nr. 41 - Sala de clasa nr. 21",1652,848,840,8,0,842,6,1800,952,469,373,1,10790,0
28,"Mures",114809,261,114809,,"MUNICIPIUL REGHIN",84,"Clubul Copiilor, strada Mihai Eminescu nr. 10 - Foaierul Clubului Copiilor",1395,761,751,8,2,757,4,1500,739,487,270,1,10790,0
28,"Mures",114809,261,114809,,"MUNICIPIUL REGHIN",85,"Grup Scolar Lucian Blaga, strada Vanatorilor, nr.29 - Sala de clasa nr. 1",1441,786,775,11,0,779,7,1600,814,523,256,1,10790,0
28,"Mures",114809,261,114809,,"MUNICIPIUL REGHIN",86,"Grup Scolar Lucian Blaga, strada Vanatorilor, nr.29 - Sala de clasa nr. 2",1147,549,535,13,1,545,4,1300,751,358,187,1,10790,0
28,"Mures",114809,261,114809,,"MUNICIPIUL REGHIN",87,"Grupul Scolar Petru Maior, strada Garii, nr.20 - Sala de clasa nr. 6 din cladirea principala",1712,907,903,4,0,895,12,1800,893,573,322,1,10790,0
28,"Mures",114809,261,114809,,"MUNICIPIUL REGHIN",88,"Grupul Scolar Petru Maior, strada Garii, nr.20 - Sala de clasa nr. 7 din cladirea principala",1827,889,880,9,0,881,8,2000,1111,594,287,1,10790,0
28,"Mures",114809,261,114809,,"MUNICIPIUL REGHIN",89,"Grup Scolar Petru Maior, strada Garii, nr.20 - Sala de sport a Scolii Generale nr. 3 - partea stanga",1535,785,775,10,0,783,2,1700,915,511,272,1,10790,0
28,"Mures",114809,261,114809,,"MUNICIPIUL REGHIN",90,"Grup Scolar Ioan Bojor, strada Raului,  nr.16 - Sala de clasa P1",1646,793,777,16,0,779,14,1800,1007,457,322,1,10790,0
28,"Mures",114809,261,114809,,"MUNICIPIUL REGHIN",91,"Grup Scolar Ioan Bojor, strada Raului,  nr.16 - Sala de clasa P4",1781,880,870,9,1,876,4,1900,1020,524,352,1,10790,0
28,"Mures",114809,261,114809,,"MUNICIPIUL REGHIN",92,"Gradinita cu program prelungit nr.4, strada Salcamilor, nr.1 - Grupa Fluturasilor - partea dreapta",1894,936,926,10,0,933,3,2000,1064,541,392,1,10790,0
28,"Mures",114809,261,114809,,"MUNICIPIUL REGHIN",93,"Caminul Cultural, strada Iernuteni, nr.143 - Sala de festivitati",1443,789,778,11,0,781,8,1598,809,470,311,1,10790,0
28,"Mures",114809,261,114809,,"MUNICIPIUL REGHIN",94,"Scoala generala nr.4, strada Castelului,  nr.35 - Sala de clasa nr. 1 - Clasa a X-a",1006,752,742,10,0,735,17,1100,348,571,164,1,10790,0
28,"Mures",114809,261,114809,,"MUNICIPIUL REGHIN",95,"Scoala generala nr.4, strada Castelului,  nr.35 - Sala de clasa nr. 4 - Clasa a VII-a",1183,572,562,10,0,563,9,1300,728,329,234,1,10790,0
28,"Mures",114809,261,114809,,"MUNICIPIUL REGHIN",96,"Gradinita cu program prelungit nr.3, cartierul Iernuteni - Grupa Mici Macko",1379,793,773,18,2,792,1,1500,707,469,323,1,10790,0
28,"Mures",114809,261,114809,,"MUNICIPIUL REGHIN",97,"Gimnaziul de stat Florea Bogdan, strada Pomilor nr.20 - Sala Clasei a VII-a B",1557,755,745,10,0,752,3,1700,945,462,290,1,10790,0
28,"Mures",114809,261,114809,,"MUNICIPIUL REGHIN",98,"Gimnaziul de stat Florea Bogdan, strada Pomilor, nr.20 - Sala Clasei a VI-a B",1482,742,731,11,0,735,7,1600,858,444,291,1,10790,0
28,"Mures",114809,261,114809,,"MUNICIPIUL REGHIN",99,"Gimnaziul de stat Florea Bogdan, strada Pomilor, nr.20  - Sala Clasei a V-a C Cabinet de Folclor",1678,801,792,9,0,796,5,1800,999,498,298,1,10790,0
28,"Mures",114809,261,114809,,"MUNICIPIUL REGHIN",100,"Gimnaziul de stat Virgil Onitiu, strada Mihai Viteazul, nr.85 - Sala de pe partea dreapta",1954,1094,1080,14,0,1086,8,2100,1006,706,380,1,10790,0
28,"Mures",114809,261,114809,,"MUNICIPIUL REGHIN",101,"Casa de Cultura a Tineretului George Enescu, strada Republicii, nr.1 - Foaierul Casei de Cultura a Tineretului",1322,674,660,13,1,672,2,1400,726,340,332,1,10790,0
28,"Mures",114809,261,114809,,"MUNICIPIUL REGHIN",102,"Gimnaziul de stat Augustin Maior, strada Scolii,  nr.3 - Sala de clasa nr. 5 Cabinet de Lb. Franceza",1368,674,664,10,0,663,11,1500,826,390,273,1,10790,0
28,"Mures",114809,261,114809,,"MUNICIPIUL REGHIN",103,"Casa de Cultura Eugen Nicoara, strada Spitalului, nr.11 - Sala de expozitii",1595,809,801,8,0,803,6,1700,891,487,316,1,10790,0
28,"Mures",114809,261,114809,,"MUNICIPIUL REGHIN",104,"Gara C.F.R. Reghin, strada Garii, nr.1 - Sala de asteptare pentru clasa I",0,481,0,481,0,476,5,807,326,299,177,1,10790,1
28,"Mures",114514,261,114514,,"MUNICIPIUL SIGHISOARA",105,"Gimnaziul ""O.Goga"", Strada Ana Ipatescu nr.14 - Sala 1 B",1434,764,755,9,0,756,8,1500,736,484,272,1,10794,0
28,"Mures",114514,261,114514,,"MUNICIPIUL SIGHISOARA",106,"Grup Scolar de Industrie Usoara - Strada Tache Ionescu  Nr.18 - Sala 1",1195,552,539,13,0,547,5,1300,748,328,219,1,10794,0
28,"Mures",114514,261,114514,,"MUNICIPIUL SIGHISOARA",107,"Grup Scolar de Industrie Usoara - Strada Tache Ionescu  Nr.18 - Sala 2",1039,462,452,10,0,457,5,1100,638,275,182,1,10794,0
28,"Mures",114514,261,114514,,"MUNICIPIUL SIGHISOARA",108,"Sala ""Mihai Eminescu"" - P-ta H.Oberth  Nr.22 - sala garderoba",1408,638,625,13,0,635,3,1500,862,388,247,1,10794,0
28,"Mures",114514,261,114514,,"MUNICIPIUL SIGHISOARA",109,"Sala ""Ciprian Porumbescu"" - Strada Turnului Nr.1 - sala de dans",1378,577,565,12,0,571,6,1500,923,353,218,1,10794,0
28,"Mures",114514,261,114514,,"MUNICIPIUL SIGHISOARA",110,"Gimnaziul Miron Neagu - Strada H.Teculescu Nr.2 - sala mica de sport",1342,554,545,9,0,554,0,1500,946,358,196,1,10794,0
28,"Mures",114514,261,114514,,"MUNICIPIUL SIGHISOARA",111,"Gradinita nr.2 - Strada Plopilor Nr.19 - sala 1",1330,668,659,9,0,662,6,1400,732,404,258,1,10794,0
28,"Mures",114514,261,114514,,"MUNICIPIUL SIGHISOARA",112,"Gimnaziul ""Nicolae Iorga"" - Strada Dumbravei Nr 28 - sala de sport",1074,516,511,5,0,513,3,1200,684,306,207,1,10794,0
28,"Mures",114514,261,114514,,"MUNICIPIUL SIGHISOARA",113,"Gimnaziul ""Nicolae Iorga"" - Strada Dumbravei Nr.28 - sala 8 B",1093,537,526,11,0,534,3,1200,663,306,228,1,10794,0
28,"Mures",114514,261,114514,,"MUNICIPIUL SIGHISOARA",114,"Gimnaziul ""Nicolae Iorga"" - Strada Dumbravei Nr.28 - sala 6",1510,680,675,5,0,672,8,1596,916,398,274,1,10794,0
28,"Mures",114514,261,114514,,"MUNICIPIUL SIGHISOARA",115,"Gimnaziul ""Nicolae Iorga"" - Strada Dumbravei Nr.28 - sala 5 A",1299,528,520,8,0,523,5,1400,872,328,195,1,10794,0
28,"Mures",114514,261,114514,,"MUNICIPIUL SIGHISOARA",116,"Gimnaziul ""Zaharie Boiu"" Strada Crizantemelor Nr.20 - sala 4 S",1419,637,626,11,0,626,11,1500,863,382,244,1,10794,0
28,"Mures",114514,261,114514,,"MUNICIPIUL SIGHISOARA",117,"Gimnaziul ""Zaharie Boiu"" Strada Crizantemelor Nr.20 - sala 2 A",1374,669,664,5,0,667,2,1500,831,440,227,1,10794,0
28,"Mures",114514,261,114514,,"MUNICIPIUL SIGHISOARA",118,"Gimnaziul ""Zaharie Boiu"" Strada Crizantemelor Nr.20 - sala 1 S",1253,571,565,6,0,563,8,1400,829,366,197,1,10794,0
28,"Mures",114514,261,114514,,"MUNICIPIUL SIGHISOARA",119,"Gimnaziul ""Zaharie Boiu"" Strada Crizantemelor Nr.20 - sala 6 S",1490,679,671,8,0,672,7,1600,921,432,240,1,10794,0
28,"Mures",114514,261,114514,,"MUNICIPIUL SIGHISOARA",120,"Gimnaziul ""Zaharie Boiu"" Strada Crizantemelor Nr.20 - sala 8 B",1407,647,635,11,1,642,5,1500,853,397,245,1,10794,0
28,"Mures",114514,261,114514,,"MUNICIPIUL SIGHISOARA",121,"Scoala Generala Dealul Viilor - Strada Viilor Nr.121 - sala 1",1521,764,749,14,1,753,11,1600,836,492,261,1,10794,0
28,"Mures",114514,261,114514,,"MUNICIPIUL SIGHISOARA",122,"Gimnaziul ""Aurel Mosora"" - Strada Andrei Saguna Nr.6 - sala 5 C",1514,751,735,14,2,737,14,1600,849,412,325,1,10794,0
28,"Mures",114514,261,114514,,"MUNICIPIUL SIGHISOARA",123,"Gimnaziul ""Aurel Mosora"" - Strada Andrei Saguna Nr.6 - sala 7 A",1479,739,726,13,0,734,5,1600,861,375,359,1,10794,0
28,"Mures",114514,261,114514,,"MUNICIPIUL SIGHISOARA",124,"Scoala Generala Radu Popa - Strada Morii, nr.28 - sala de sport",1296,643,626,17,0,637,6,1400,757,356,281,1,10794,0
28,"Mures",114514,261,114514,,"MUNICIPIUL SIGHISOARA",125,"Gimnaziul Victor Jinga - Strada Noua Nr.6 - sala 7",1317,718,708,10,0,712,6,1400,682,378,334,1,10794,0
28,"Mures",114514,261,114514,,"MUNICIPIUL SIGHISOARA",126,"Gimnaziul Victor Jinga - Strada Noua Nr.6 - sala 3",1001,489,483,6,0,477,12,1100,611,286,191,1,10794,0
28,"Mures",114514,261,114514,,"MUNICIPIUL SIGHISOARA",127,"Gradinita Hetiur, sat Hetiur nr.100, sala 1",820,423,406,17,0,416,7,900,477,268,148,1,10794,0
28,"Mures",114514,261,114514,,"MUNICIPIUL SIGHISOARA",128,"Statia CFR Calatori Sighisoara - Strada Libertatii nr.51",0,461,0,461,0,454,7,995,534,280,174,1,10794,1
28,"Mures",114925,261,114925,,"MUNICIPIUL TARNAVENI",129,"Scoala generala nr.3, strada 1 Iunie nr.11-12, parter, cls IA, intrare elevi",1047,510,494,16,0,494,16,1100,590,233,261,1,10803,0
28,"Mures",114925,261,114925,,"MUNICIPIUL TARNAVENI",130,"Scoala generala nr.3, strada 1 Iunie nr.11-12, parter, cls IB, intrare elevi",1042,452,437,15,0,445,7,1097,645,240,205,1,10803,0
28,"Mures",114925,261,114925,,"MUNICIPIUL TARNAVENI",131,"Gradinita cu program prelungit nr.1, strada Avram Iancu nr.12, grupa albinutelor",1027,559,550,9,0,554,5,1100,541,238,316,1,10803,0
28,"Mures",114925,261,114925,,"MUNICIPIUL TARNAVENI",132,"Gimnaziul de Stat Traian, strada Republicii nr.92 parter, sala nr.13",1206,540,528,12,0,536,4,1300,760,255,281,1,10803,0
28,"Mures",114925,261,114925,,"MUNICIPIUL TARNAVENI",133,"Scoala de Arte si Meserii Constantin Brancusi, piata Trandafirilor nr.10, sala de mese",1303,616,601,15,0,614,2,1300,684,278,336,1,10803,0
28,"Mures",114925,261,114925,,"MUNICIPIUL TARNAVENI",134,"Casa de Cultura ""Mihai Eminescu"", strada Republicii nr.32, foaier",1324,645,638,7,0,643,2,1400,755,341,302,1,10803,0
28,"Mures",114925,261,114925,,"MUNICIPIUL TARNAVENI",135,"Gradinita cu program prelungit nr.4, strada Republicii nr.34, grupa florilor",1081,486,470,16,0,483,3,1200,714,239,244,1,10803,0
28,"Mures",114925,261,114925,,"MUNICIPIUL TARNAVENI",136,"Colegiul Tehnic, strada Republicii nr.30, parter, sala 3",1028,517,510,7,0,512,5,1088,571,223,289,1,10803,0
28,"Mures",114925,261,114925,,"MUNICIPIUL TARNAVENI",137,"Gimnaziul de Stat  Avram Iancu, strada Soimilor nr.27, parter, sala nr.1",1003,423,413,10,0,422,1,1100,677,223,199,1,10803,0
28,"Mures",114925,261,114925,,"MUNICIPIUL TARNAVENI",138,"Gimnaziul de Stat  Avram Iancu, strada Soimilor nr.27, parter sala nr.4",1035,521,510,11,0,512,9,1097,576,210,302,1,10803,0
28,"Mures",114925,261,114925,,"MUNICIPIUL TARNAVENI",139,"Liceul Teoretic Andrei Barseanu, strada Republicii nr.15, parter, sala 5, intrare profesori",1355,621,617,4,0,616,5,1500,879,332,284,1,10803,0
28,"Mures",114925,261,114925,,"MUNICIPIUL TARNAVENI",140,"Liceul Teoretic Andrei Barseanu, strada Republicii nr.15, parter, sala 6, intrare profesori",1447,639,624,14,1,633,6,1600,961,350,283,1,10803,0
28,"Mures",114925,261,114925,,"MUNICIPIUL TARNAVENI",141,"SC Triumph SRL, strada 1 Decembrie 1918 nr. 46R, spatiu comercial",1300,554,549,5,0,549,5,1399,845,325,224,1,10803,0
28,"Mures",114925,261,114925,,"MUNICIPIUL TARNAVENI",142,"SC Triumph SRL, strada 1 Decembrie 1918 nr. 46R, spatiu comercial",1304,525,513,12,0,520,5,1400,875,330,190,1,10803,0
28,"Mures",114925,261,114925,,"MUNICIPIUL TARNAVENI",143,"Gara Tarnaveni, strada Aleea Garii nr.2, sala de asteptare",1130,553,545,8,0,549,4,1208,655,285,264,1,10803,0
28,"Mures",114925,261,114925,,"MUNICIPIUL TARNAVENI",144,"Gimnaziul de Stat Vasile Moldovan, strada Fabricii nr.4, parter, sala 2",1187,487,475,12,0,479,8,1300,813,287,192,1,10803,0
28,"Mures",114925,261,114925,,"MUNICIPIUL TARNAVENI",145,"Gimnaziul de Stat Vasile Moldovan, strada Fabricii nr.4, parter, sala 3",1142,529,516,13,0,510,19,1200,671,217,293,1,10803,0
28,"Mures",114925,261,114925,,"MUNICIPIUL TARNAVENI",146,"Gimnaziul de Stat Vasile Moldovan, strada Fabricii nr.4, parter, sala 4",1299,557,551,6,0,554,3,1400,843,295,259,1,10803,0
28,"Mures",114925,261,114925,,"MUNICIPIUL TARNAVENI",147,"Scoala Botorca, strada Mediasului nr.8A, sala nr.1",311,156,151,5,0,154,2,400,244,114,40,1,10803,0
28,"Mures",114925,261,114925,,"MUNICIPIUL TARNAVENI",148,"Camin Cultural Bobohalma, strada Principala FN, sala mare",987,426,420,6,0,419,7,1100,674,288,131,1,10803,0
28,"Mures",114925,261,114925,,"MUNICIPIUL TARNAVENI",149,"Gradinita cu program normal nr.6, Sat. Custelnic, strada Principala nr.42, sala nr.4",458,229,220,9,0,227,2,513,284,123,104,1,10803,0
28,"Mures",114925,261,114925,,"MUNICIPIUL TARNAVENI",150,"Primaria Tarnaveni, piata Primariei nr.7, registratura, camera 23",0,209,0,209,0,208,1,505,296,115,93,1,10803,1
28,"Mures",117827,261,117827,,"ORAS IERNUT",151,"Iernut, Casa de Cultura Iernut, Strada 1 Decembrie 1918, nr.9",1363,776,765,11,0,771,5,1500,724,447,324,1,10808,0
28,"Mures",117827,261,117827,,"ORAS IERNUT",152,"Iernut, Scoala Generala Iernut, strada Gheorghe Doja, nr.34",1748,921,903,16,2,905,16,1900,979,474,431,1,10808,0
28,"Mures",117827,261,117827,,"ORAS IERNUT",153,"Iernut, Scoala Generala Iernut, Strada Mihai Eminescu, nr.3",1964,1054,1043,10,1,1037,17,2100,1046,607,430,1,10808,0
28,"Mures",117827,261,117827,,"ORAS IERNUT",154,"Cipau, Scoala Generala Cipau, nr.140",815,434,423,11,0,422,12,899,465,269,153,1,10808,0
28,"Mures",117827,261,117827,,"ORAS IERNUT",155,"Deag, Scoala Generala Deag, nr.102",331,135,130,5,0,133,2,398,263,55,78,1,10808,0
28,"Mures",117827,261,117827,,"ORAS IERNUT",156,"Lechinta, Scoala Generala Lechinta f.n.",680,431,415,11,5,428,3,801,370,232,196,1,10808,0
28,"Mures",117827,261,117827,,"ORAS IERNUT",157,"Oarba de Mures, Caminul Cultural Oarba de Mures, f.n.",135,68,57,11,0,68,0,200,132,42,26,1,10808,0
28,"Mures",117827,261,117827,,"ORAS IERNUT",158,"Salcud, Scoala Generala Salcud, nr.170",620,326,316,9,1,318,8,700,374,117,201,1,10808,0
28,"Mures",117827,261,117827,,"ORAS IERNUT",159,"Sfintu Gheorghe, Scoala Generala Sfintu Gheorghe, nr.42",288,175,167,8,0,174,1,412,237,96,78,1,10808,0
28,"Mures",117827,261,117827,,"ORAS IERNUT",160,"Gara CFR Iernut, strada Dacia Traiana, fara numar",0,145,0,145,0,141,4,399,254,86,55,1,10808,1
28,"Mures",114710,261,114710,,"ORAS LUDUS",161,"Casa de Cultura ""Pompeiu Harasteanu"", Bulevardul 1 Decembrie 1918 nr. 26, Hol",1656,959,951,8,0,953,6,1800,841,624,329,1,10818,0
28,"Mures",114710,261,114710,,"ORAS LUDUS",162,"Scoala Generala ""Ioan Vladutiu"", Strada Crinului nr. 2, Sala de sport - Sala festiva",1531,889,882,7,0,883,6,1600,711,508,375,1,10818,0
28,"Mures",114710,261,114710,,"ORAS LUDUS",163,"Scoala Generala ""Ioan Vladutiu"", Strada Crinului nr. 2, Sala de clasa nr.5",1526,885,869,15,1,885,0,1598,713,528,357,1,10818,0
28,"Mures",114710,261,114710,,"ORAS LUDUS",164,"Grup Scolar Industrial Strada Crinului nr. 4, Sala de clasa 12C",1502,876,863,13,0,871,5,1600,724,496,375,1,10818,0
28,"Mures",114710,261,114710,,"ORAS LUDUS",165,"Gradinita cu Program Prelungit nr. 2, Strada Randunelelor nr. 3 bis, Sala - grupa mijlocie A",1489,828,819,9,0,823,5,1600,772,494,329,1,10818,0
28,"Mures",114710,261,114710,,"ORAS LUDUS",166,"Gradinita cu Program Normal Strada Crinului nr. 38, Sala - grupa mare",1572,935,920,15,0,929,6,1700,765,518,411,1,10818,0
28,"Mures",114710,261,114710,,"ORAS LUDUS",167,"Gradinita cu Program Prelungit nr. 1, Strada Vanatorilor nr. 31, Sala mare",1125,622,613,9,0,618,4,1197,575,385,233,1,10818,0
28,"Mures",114710,261,114710,,"ORAS LUDUS",168,"Scoala Generala nr. 1, Strada Republicii nr. 55, Sala de sport",1045,548,536,12,0,546,2,1098,550,369,177,1,10818,0
28,"Mures",114710,261,114710,,"ORAS LUDUS",169,"Scoala Generala nr. 1, Strada Republicii nr. 55, Localul 2, Sala de clasa 5C",1148,662,653,9,0,659,3,1271,609,399,260,1,10818,0
28,"Mures",114710,261,114710,,"ORAS LUDUS",170,"Camin Cultural Gheja, Strada Pacii nr. 83",1257,851,837,8,6,845,6,1395,544,495,350,1,10818,0
28,"Mures",114710,261,114710,,"ORAS LUDUS",171,"Camin Cultural Rosiori Str. Scolii nr. 9",1042,583,573,10,0,580,3,1100,517,472,108,1,10818,0
28,"Mures",114710,261,114710,,"ORAS LUDUS",172,"Autogara, Str.1 Mai nr.34, Sala de asteptare",0,211,0,211,0,209,2,400,189,137,72,1,10818,1
28,"Mures",118281,261,118281,,"ORAS MIERCUREA NIRAJULUI",173,"Scoala Genarala orasul Miercurea Nirajului, Strada Teilor nr. 5, corpul B, clasa nr. 1",1151,352,344,8,0,337,15,1300,948,121,216,1,10826,0
28,"Mures",118281,261,118281,,"ORAS MIERCUREA NIRAJULUI",174,"Caminul Cultural orasul Miercurea Nirajului, Strada Trandafirilor nr. 51, antreu",993,275,267,8,0,270,5,1100,825,111,159,1,10826,0
28,"Mures",118281,261,118281,,"ORAS MIERCUREA NIRAJULUI",175,"Sediul Primariei orasului Miercurea Nirajului, Strada Teilor nr. 48, biroul de relatii cu publicul",1059,306,296,10,0,295,11,1200,894,97,198,1,10826,0
28,"Mures",118281,261,118281,,"ORAS MIERCUREA NIRAJULUI",176,"sat. Dumitresti, nr. 23, Camin Cultural, sala mare",262,111,102,9,0,111,0,300,189,29,82,1,10826,0
28,"Mures",118281,261,118281,,"ORAS MIERCUREA NIRAJULUI",177,"sat. Tampa, nr. 89, Caminul Cultural, sala mare",374,135,125,10,0,134,1,400,265,41,93,1,10826,0
28,"Mures",118281,261,118281,,"ORAS MIERCUREA NIRAJULUI",178,"sat.Sardu Nirajului, nr. 130, Scoala Generala, clasa nr. 1",560,189,178,11,0,186,3,600,411,135,51,1,10826,0
28,"Mures",118281,261,118281,,"ORAS MIERCUREA NIRAJULUI",179,"sat. Mosuni, nr. 124,Scoala Primara, clasa nr. 1",351,133,120,13,0,132,1,400,267,76,56,1,10826,0
28,"Mures",118281,261,118281,,"ORAS MIERCUREA NIRAJULUI",180,"Centrul Administrativ Didactic, Str. Trandafirilor nr.79, sediul Punct de Acces pentru Informatii Publice",0,71,0,71,0,69,2,300,229,43,26,1,10826,1
28,"Mures",119242,261,119242,,"ORAS SARMASU",181,"Sala de Sport a orasului Sarmasu, Strada Dezrobirii nr.5",1180,533,526,6,1,526,7,1285,752,228,298,1,10840,0
28,"Mures",119242,261,119242,,"ORAS SARMASU",182,"Casa de Cultura orasul Sarmasu, Strada Republicii nr.94",851,349,336,10,3,343,6,900,551,184,159,1,10840,0
28,"Mures",119242,261,119242,,"ORAS SARMASU",183,"Scoala Generala orasul Sarmasu, Strada Scolii, nr.8",1014,529,516,12,1,527,2,1095,566,213,314,1,10840,0
28,"Mures",119242,261,119242,,"ORAS SARMASU",184,"Caminul Cultural, sat Balda, Strada Dezrobirii nr. 24",926,488,480,4,4,481,7,995,507,249,232,1,10840,0
28,"Mures",119242,261,119242,,"ORAS SARMASU",185,"Scoala Generala, sat Larga, nr.15",160,61,50,10,1,59,2,201,140,33,26,1,10840,0
28,"Mures",119242,261,119242,,"ORAS SARMASU",186,"Caminul Cultural, sat Sarmasel, Strada 1 Mai, nr.3",626,349,343,4,2,346,3,700,351,214,132,1,10840,0
28,"Mures",119242,261,119242,,"ORAS SARMASU",187,"Caminul Cultural, sat Sarmasel-Gara, Strada Republicii, nr.5/B",588,331,322,8,1,324,7,701,370,176,148,1,10840,0
28,"Mures",119242,261,119242,,"ORAS SARMASU",188,"Caminul Cultural, sat  Visinelu, Strada Plopilor, nr.36",408,264,255,4,5,258,6,500,236,82,176,1,10840,0
28,"Mures",119242,261,119242,,"ORAS SARMASU",189,"Grupul Scolar ""Samuil Micu"" oras Sarmasu, Strada Republicii nr. 98",0,102,0,102,0,101,1,301,199,50,51,1,10840,1
28,"Mures",119331,261,119331,,"ORAS SANGEORGIU DE PADURE",190,"Grup Scolar, orasul Singeorgiu de Padure, Piata Unirii nr. 2, Cladire nr.1",1346,377,366,11,0,363,14,1500,1123,109,254,1,10835,0
28,"Mures",119331,261,119331,,"ORAS SANGEORGIU DE PADURE",191,"Caminul Cultural, oras Singeorgiu de Padure, Strada N. Balcescu nr. 13, Sala mica",1248,383,375,7,1,378,5,1400,1017,135,243,1,10835,0
28,"Mures",119331,261,119331,,"ORAS SANGEORGIU DE PADURE",192,"Caminul Cultural, oras Singeorgiu de Padure, Strada N. Balcescu nr. 13, Sala Mare",1260,281,278,3,0,269,12,1400,1119,136,133,1,10835,0
28,"Mures",119331,261,119331,,"ORAS SANGEORGIU DE PADURE",193,"Scoala Generala, sat Bezid nr. 43",586,140,135,5,0,135,5,700,560,44,91,1,10835,0
28,"Mures",119331,261,119331,,"ORAS SANGEORGIU DE PADURE",194,"Grup Scolar, oras Singeorgiu de Padure, Piata Unirii nr. 2, Cladirea nr.1 - ""Sala Lumina Verde""",0,41,0,41,0,40,1,200,159,22,18,1,10835,1
28,"Mures",114854,261,114854,,"ORAS SOVATA",195,"Scoala Generala Sacadat Jos, Strada Lunga nr.138, Sala de clasa nr.1",1078,274,267,7,0,270,4,1200,926,134,136,1,10849,0
28,"Mures",114854,261,114854,,"ORAS SOVATA",196,"Scoala Generala S.Illyes Lajos, orasul Sovata, Strada Principala nr.196/A, Sala de clasa nr.1",1153,379,377,2,0,366,13,1300,921,171,195,1,10849,0
28,"Mures",114854,261,114854,,"ORAS SOVATA",197,"Scoala Generala S.Illyes Lajos, orasul Sovata, Strada Principala nr.196/A, Sala de clasa nr.2",1284,402,398,4,0,393,9,1400,998,181,212,1,10849,0
28,"Mures",114854,261,114854,,"ORAS SOVATA",198,"Sediul Primariei, oras Sovata, Strada Principala nr.155, Sala mare de sedinta",1773,570,563,6,1,555,15,1900,1330,250,305,1,10849,0
28,"Mures",114854,261,114854,,"ORAS SOVATA",199,"Biblioteca Oraseneasca Sovata Bai, oras Sovata, Strada Trandafirilor nr.99, Sala de lectura",335,108,99,9,0,107,1,400,292,64,43,1,10849,0
28,"Mures",114854,261,114854,,"ORAS SOVATA",200,"Centrul Cultural Domokos Kazmer, oras Sovata, Strada Principala nr. 30, Sala de expozitie",1617,446,440,6,0,438,8,1700,1254,215,223,1,10849,0
28,"Mures",114854,261,114854,,"ORAS SOVATA",201,"Scoala Generala nr.3, oras Sovata, Strada Praidului nr.46, Sala de clasa nr.1",956,225,218,7,0,220,5,1000,775,111,109,1,10849,0
28,"Mures",114854,261,114854,,"ORAS SOVATA",202,"Caminul Cultural, sat Iliesi, Strada Principala nr.50, Sala de sedinta",374,123,116,7,0,114,9,400,277,67,47,1,10849,0
28,"Mures",114854,261,114854,,"ORAS SOVATA",203,"Biblioteca Oraseneasca Sovata Bai, oras Sovata, Sala de sedinta, Strada Trandafirilor nr.99",0,354,0,354,0,350,4,1000,646,172,178,1,10849,1
28,"Mures",119894,261,119894,,"ORAS UNGHENI",204,"Scoala Generala ""Emil Dragan"", oras Ungheni, nr.107, sala de clasa nr. 1",1548,810,802,8,0,804,6,1700,890,427,377,1,10854,0
28,"Mures",119894,261,119894,,"ORAS UNGHENI",205,"Caminul Cultural oras Ungheni, nr. 110/B, anticamera sala de festivitati",1662,859,846,9,4,841,18,1800,941,384,457,1,10854,0
28,"Mures",119894,261,119894,,"ORAS UNGHENI",206,"Caminul Cultural, sat Moresti, nr. 123, sala de festivitati",588,397,391,6,0,395,2,703,306,206,189,1,10854,0
28,"Mures",119894,261,119894,,"ORAS UNGHENI",207,"Scoala Generala, sat Sausa, nr. 114, sala de clasa",186,133,126,5,2,133,0,201,68,68,65,1,10854,0
28,"Mures",119894,261,119894,,"ORAS UNGHENI",208,"Scoala Generala, sat  Vidrasau, nr. 28, - sala de clasa nr. 1",853,546,537,9,0,543,3,900,354,237,306,1,10854,0
28,"Mures",119894,261,119894,,"ORAS UNGHENI",209,"Scoala  Generala, sat Cerghizel  nr. 103, sala de clasa",379,267,262,5,0,262,5,401,134,118,144,1,10854,0
28,"Mures",119894,261,119894,,"ORAS UNGHENI",210,"Caminul Cultural, sat Cerghid nr. 50, sala de festivitati",410,238,236,2,0,236,2,501,263,117,119,1,10854,0
28,"Mures",119894,261,119894,,"ORAS UNGHENI",211,"Aeroportul ""Transilvania"" Tirgu Mures, sat Vidrasau, DN 15, Km 14,5 - Soseaua Tirgu Mures - Ludus",0,107,0,107,0,104,3,300,193,57,47,1,10854,1
28,"Mures",114970,261,114970,,"ACATARI",212,"Scoala Generala, sat Acatari, nr 99",956,448,413,12,23,436,12,1000,552,120,316,3,10862,0
28,"Mures",114970,261,114970,,"ACATARI",213,"Scoala Generala, sat Gruisor, nr.37",335,173,139,10,24,166,7,400,227,26,140,3,10862,0
28,"Mures",114970,261,114970,,"ACATARI",214,"Scoala Generala, sat Gaiesti nr.116",333,212,187,7,18,211,1,399,187,20,191,3,10862,0
28,"Mures",114970,261,114970,,"ACATARI",215,"Scoala Generala, sat Murgesti, nr.140",399,203,160,13,30,200,3,503,300,42,158,3,10862,0
28,"Mures",114970,261,114970,,"ACATARI",216,"Caminul Cultural, sat Roteni, nr.246",658,362,335,7,20,361,1,700,338,76,285,3,10862,0
28,"Mures",114970,261,114970,,"ACATARI",217,"Scoala Generala, sat Stejeris, nr.93",270,107,84,10,13,104,3,301,194,16,88,3,10862,0
28,"Mures",114970,261,114970,,"ACATARI",218,"Scoala Generala, sat Suveica, nr.153",193,108,91,12,5,107,1,300,192,23,84,3,10862,0
28,"Mures",114970,261,114970,,"ACATARI",219,"Scoala Generala, sat Valeni, nr.140",623,256,228,8,20,248,8,700,444,83,165,3,10862,0
28,"Mures",114970,261,114970,,"ACATARI",220,"Biroul Politiei Comunitare (sediul fostei primarii), sat Acatari nr.100",0,69,0,69,0,67,2,200,131,28,39,3,10862,1
28,"Mures",115076,261,115076,,"ADAMUS",221,"Scoala Generala sat Adamus, Strada Livezilor nr.77, sala nr.1",698,219,209,10,0,213,6,800,581,108,105,3,10872,0
28,"Mures",115076,261,115076,,"ADAMUS",222,"Caminul Cultural, sat Adamus, Strada Principala nr.8",1111,395,388,7,0,393,2,1199,804,229,164,3,10872,0
28,"Mures",115076,261,115076,,"ADAMUS",223,"Scoala Generala, sat Cornesti, Strada Viilor nr.1",1026,440,432,8,0,438,2,1086,646,244,194,3,10872,0
28,"Mures",115076,261,115076,,"ADAMUS",224,"Gradinita de copii, sat Craiesti, Strada Mare nr.24",979,319,309,10,0,317,2,1091,772,186,131,3,10872,0
28,"Mures",115076,261,115076,,"ADAMUS",225,"Gradinita de copii, sat Dambau, strada Mare nr.76",936,322,308,14,0,322,0,1000,678,153,169,3,10872,0
28,"Mures",115076,261,115076,,"ADAMUS",226,"Scoala Generala, sat Adamus, Strada Livezilor nr.77, sala nr.2",0,44,0,44,0,43,1,204,160,23,20,3,10872,1
28,"Mures",114603,261,114603,,"ALBESTI",227,"Scoala Generala, sat Albesti, Strada Lunga nr.119, Corpul B parter, clasa IV A",1514,718,715,3,0,709,9,1600,882,392,317,3,10879,0
28,"Mures",114603,261,114603,,"ALBESTI",228,"Scoala Generala, sat Albesti, Strada Lunga nr.119, Corpul B parter, clasa IV B",1564,719,717,2,0,710,9,1700,981,407,303,3,10879,0
28,"Mures",114603,261,114603,,"ALBESTI",229,"Scoala Generala, sat Topa nr.15, clasele I-IV",301,179,170,9,0,178,1,400,221,68,110,3,10879,0
28,"Mures",114603,261,114603,,"ALBESTI",230,"Scoala Generala, sat Boiu nr.397, Cabinet Romana, clasa V",1225,590,581,8,1,583,7,1300,710,394,189,3,10879,0
28,"Mures",114603,261,114603,,"ALBESTI",231,"Scoala Generala, sat Albesti, Corpul A, sectia Maghiara, clasele II-IV, Strada Lunga nr.119",0,49,0,49,0,48,1,202,153,27,21,3,10879,1
28,"Mures",115147,261,115147,,"ALUNIS",232,"Caminul Cultural, sat Alunis, Strada Principala nr.166 (sala mica)",1730,887,813,1,73,874,13,1900,1013,386,488,3,10889,0
28,"Mures",115147,261,115147,,"ALUNIS",233,"Scoala Generala, sat Fitcau, Strada Principala nr. 38",379,254,244,10,0,252,2,400,146,61,191,3,10889,0
28,"Mures",115147,261,115147,,"ALUNIS",234,"Caminul Cultural, sat Lunca Muresului, Str. Principala nr. 199",560,247,215,9,23,246,1,600,353,119,127,3,10889,0
28,"Mures",115147,261,115147,,"ALUNIS",235,"Caminul Cultural, sat Alunis, Strada Principala nr.166 (sala mare)",0,37,0,37,0,37,0,200,163,15,22,3,10889,1
28,"Mures",115183,261,115183,,"APOLD",236,"Gradinita Apold, sat Apold nr.133, sala 1",721,353,342,9,2,349,4,800,447,226,123,3,10893,0
28,"Mures",115183,261,115183,,"APOLD",237,"Scoala Generala, sat Daia nr.43",561,276,267,4,5,274,2,605,329,164,110,3,10893,0
28,"Mures",115183,261,115183,,"APOLD",238,"Caminul Cultural, sat Saes nr.160",1019,512,505,7,0,511,1,1100,588,263,248,3,10893,0
28,"Mures",115183,261,115183,,"APOLD",239,"Gradinita Apold, sat Apold nr.133, sala 2",0,56,0,56,0,55,1,200,144,40,15,3,10893,1
28,"Mures",115236,261,115236,,"ATINTIS",240,"Sediul Primariei comunei Atintis, comuna Atintis nr.242, sala mare de sedinte",605,360,350,2,8,357,3,700,340,228,129,3,10898,0
28,"Mures",115236,261,115236,,"ATINTIS",241,"Scoala Generala, sat Botez nr.26",150,94,86,8,0,93,1,200,106,51,42,3,10898,0
28,"Mures",115236,261,115236,,"ATINTIS",242,"Scoala Generala, sat Cecalaca nr.107",355,205,200,5,0,202,3,400,195,104,98,3,10898,0
28,"Mures",115236,261,115236,,"ATINTIS",243,"Scoala Generala, sat Istihaza nr.52",153,86,76,10,0,84,2,203,117,73,11,3,10898,0
28,"Mures",115236,261,115236,,"ATINTIS",244,"Cladirea ""Moldovan"", sat Siniacob nr.14",27,22,10,12,0,22,0,100,78,12,10,3,10898,0
28,"Mures",115236,261,115236,,"ATINTIS",245,"Sediul Primariei comunei Atintis, sat Atintis nr.242, sala agricola",0,52,0,52,0,52,0,200,148,37,15,3,10898,1
28,"Mures",115307,261,115307,,"BAHNEA",246,"Scoala Generala Bahnea, sat Bahnea str. Republicii nr.55, sala nr.5",1539,793,791,2,0,768,25,1700,907,479,289,3,10908,0
28,"Mures",115307,261,115307,,"BAHNEA",247,"Scoala Generala, sat Bernadea nr.49",148,74,66,8,0,73,1,200,126,40,33,3,10908,0
28,"Mures",115307,261,115307,,"BAHNEA",248,"Scoala Generala, sat Lepindea nr.192",155,92,83,9,0,89,3,200,108,52,37,3,10908,0
28,"Mures",115307,261,115307,,"BAHNEA",249,"Scoala Generala, sat Daia nr.35",171,66,56,10,0,65,1,200,134,33,32,3,10908,0
28,"Mures",115307,261,115307,,"BAHNEA",250,"Scoala Generala, sat Idiciu nr.196",240,146,135,11,0,140,6,300,154,98,42,3,10908,0
28,"Mures",115307,261,115307,,"BAHNEA",251,"Scoala Generala, sat Gogan nr.320",453,161,152,9,0,159,2,500,339,97,62,3,10908,0
28,"Mures",115307,261,115307,,"BAHNEA",252,"Scoala Generala, sat Cund nr.40",170,51,43,8,0,51,0,200,149,26,25,3,10908,0
28,"Mures",115307,261,115307,,"BAHNEA",253,"Scoala Generala, sat Bahnea str. Republicii nr.55, sala nr.4",0,53,0,53,0,51,2,200,147,29,22,3,10908,1
28,"Mures",115389,261,115389,,"BAND",254,"Scoala Generala, sat Band, str. Pacii  nr.4",807,360,342,18,0,360,0,900,540,126,234,3,10926,0
28,"Mures",115389,261,115389,,"BAND",255,"Scoala Generala, sat Band, str. Scolii nr.21",1347,636,617,19,0,622,14,1500,864,123,499,3,10926,0
28,"Mures",115389,261,115389,,"BAND",256,"Gradinita cu Program Normal, sat Band, str.Garii nr.3",617,336,298,38,0,327,9,701,365,103,224,3,10926,0
28,"Mures",115389,261,115389,,"BAND",257,"Scoala Generala, sat Tiptelnic nr.63",108,66,58,8,0,62,4,200,134,26,36,3,10926,0
28,"Mures",115389,261,115389,,"BAND",258,"Scoala Generala, sat Valea Rece nr.42 A",322,151,142,9,0,146,5,400,249,92,54,3,10926,0
28,"Mures",115389,261,115389,,"BAND",259,"Scoala Generala, sat Marasesti nr.132",238,148,136,12,0,147,1,300,152,103,44,3,10926,0
28,"Mures",115389,261,115389,,"BAND",260,"Scoala Generala, sat Finate nr.84",425,202,194,8,0,198,4,501,299,69,129,3,10926,0
28,"Mures",115389,261,115389,,"BAND",261,"Scoala Generala, sat Finatele Madarasului nr.619",156,87,80,7,0,85,2,200,113,25,60,3,10926,0
28,"Mures",115389,261,115389,,"BAND",262,"Scoala Generala, sat Oroiu nr.89",270,145,135,10,0,141,4,301,156,58,83,3,10926,0
28,"Mures",115389,261,115389,,"BAND",263,"Scoala Generala, sat Petea nr.61",173,113,107,6,0,112,1,203,90,32,80,3,10926,0
28,"Mures",115389,261,115389,,"BAND",264,"Scoala Generala, sat Draculea Bandului nr.43",117,70,57,13,0,68,2,199,129,33,35,3,10926,0
28,"Mures",115389,261,115389,,"BAND",265,"Scoala Generala, sat Negrenii de Campie nr.10",90,47,34,13,0,46,1,100,53,20,26,3,10926,0
28,"Mures",115389,261,115389,,"BAND",266,"Scoala Generala, sat Valea Mare nr.14",117,80,70,10,0,78,2,200,120,18,60,3,10926,0
28,"Mures",115389,261,115389,,"BAND",267,"Sediul Primariei comunei Band, sat Band, str.Pacii nr.18",0,69,0,69,0,67,2,304,235,29,38,3,10926,1
28,"Mures",115520,261,115520,,"BATOS",268,"Scoala Generala, sat Batos nr.400",1136,546,539,6,1,542,4,1200,654,381,161,3,10939,0
28,"Mures",115520,261,115520,,"BATOS",269,"Scoala Generala, sat Dedrad nr.44",1257,709,704,5,0,704,5,1402,693,463,241,3,10939,0
28,"Mures",115520,261,115520,,"BATOS",270,"Scoala Generala, sat Goreni nr.86",521,279,274,5,0,278,1,600,321,179,99,3,10939,0
28,"Mures",115520,261,115520,,"BATOS",271,"Scoala Generala, sat Uila nr.115",477,266,259,6,1,261,5,500,234,149,112,3,10939,0
28,"Mures",115520,261,115520,,"BATOS",272,"Sediul Primariei comunei Batos, sat Batos nr.302",0,43,0,43,0,42,1,200,157,20,22,3,10939,1
28,"Mures",115575,261,115575,,"BAGACIU",273,"Caminul Cultural, sat Bagaciu nr. 85",998,512,507,5,0,506,6,1100,588,349,157,3,10905,0
28,"Mures",115575,261,115575,,"BAGACIU",274,"Caminul Cultural, sat Delenii nr. 342",922,549,537,9,3,548,1,1000,451,424,124,3,10905,0
28,"Mures",115575,261,115575,,"BAGACIU",275,"Scoala Generala, sat Bagaciu nr.86",0,28,0,28,0,28,0,100,72,17,11,3,10905,1
28,"Mures",115600,261,115600,,"BALA",276,"Camin Cultural, sat Bala nr.138",539,312,303,3,6,308,4,600,288,183,125,3,10916,0
28,"Mures",115600,261,115600,,"BALA",277,"Scoala Generala, sat Ercea nr.124",158,96,89,7,0,94,2,200,104,57,37,3,10916,0
28,"Mures",115600,261,115600,,"BALA",278,"Caminul Cultural, sat Bala  nr.138",0,24,0,24,0,24,0,100,76,17,7,3,10916,1
28,"Mures",115637,261,115637,,"BALAUSERI",279,"Caminul Cultural, sat  Balauseri, sala A nr.271",1001,251,243,8,0,249,2,1100,849,132,117,3,10919,0
28,"Mures",115637,261,115637,,"BALAUSERI",280,"Caminul Cultural, sat Agristeu  nr.91",601,227,221,6,0,219,8,700,473,158,61,3,10919,0
28,"Mures",115637,261,115637,,"BALAUSERI",281,"Scoala Generala, sat Chendu  nr.357",1218,337,331,6,0,330,7,1300,963,162,168,3,10919,0
28,"Mures",115637,261,115637,,"BALAUSERI",282,"Scoala Generala, sat Dumitreni  nr.156",448,142,134,8,0,140,2,500,358,40,100,3,10919,0
28,"Mures",115637,261,115637,,"BALAUSERI",283,"Caminul Cultural, sat Filitelnic nr.64",208,111,106,5,0,110,1,300,189,90,20,3,10919,0
28,"Mures",115637,261,115637,,"BALAUSERI",284,"Scoala Generala, sat Senereus nr.76",536,304,298,6,0,298,6,600,296,243,55,3,10919,0
28,"Mures",115637,261,115637,,"BALAUSERI",285,"Caminul Cultural, sat  Balauseri nr.271, sala B",0,34,0,34,0,34,0,200,166,22,12,3,10919,1
28,"Mures",115708,261,115708,,"BEICA DE JOS",286,"Scoala Generala, sat Beica de Jos nr.46 A (Sala clasei a-VIII-a)",677,317,315,2,0,305,12,805,488,152,153,3,10944,0
28,"Mures",115708,261,115708,,"BEICA DE JOS",287,"Scoala Generala, sat Beica de Sus, nr.40 (Sala de gradinita)",213,128,122,6,0,127,1,300,172,61,66,3,10944,0
28,"Mures",115708,261,115708,,"BEICA DE JOS",288,"Scoala Generala, sat Nadasa, nr.20 (Sala de clasa)",212,132,124,8,0,128,4,302,170,45,83,3,10944,0
28,"Mures",115708,261,115708,,"BEICA DE JOS",289,"Scoala Generala, sat Cacuciu, nr.26 (Sala de gradinita)",119,88,82,6,0,87,1,200,112,42,45,3,10944,0
28,"Mures",115708,261,115708,,"BEICA DE JOS",290,"Caminul Cultural, sat Serbeni, nr.35 (sala de clasa)",304,189,181,8,0,184,5,400,211,102,82,3,10944,0
28,"Mures",115708,261,115708,,"BEICA DE JOS",291,"Scoala Generala, sat Sinmihai de Padure, nr.31 (Sala de clasa)",207,117,112,5,0,117,0,300,183,73,44,3,10944,0
28,"Mures",115708,261,115708,,"BEICA DE JOS",292,"Scoala Generala, sat  Beica de Jos, nr. 46A (Sala clasei a-VII-a)",0,77,0,77,0,77,0,200,123,33,44,3,10944,1
28,"Mures",120511,261,120511,,"BERENI",293,"Caminul Cultural, sat Bereni, Strada Principala nr.16, Sala A",391,172,134,0,38,168,4,500,328,59,109,3,10951,0
28,"Mures",120511,261,120511,,"BERENI",294,"Caminul Cultural, sat Eremieni, Strada Principala nr.70",189,105,82,8,15,103,2,200,95,15,88,3,10951,0
28,"Mures",120511,261,120511,,"BERENI",295,"Caminul Cultural, sat Marculeni, Strada Principala nr.15",406,203,102,10,91,200,3,500,297,35,165,3,10951,0
28,"Mures",120511,261,120511,,"BERENI",296,"Caminul Cultural, sat Bereni, Strada Principala nr.16, Sala B",0,55,0,55,0,54,1,200,145,11,43,3,10951,1
28,"Mures",115771,261,115771,,"BICHIS",297,"Caminul Cultural, sat Bichis, nr.42",190,99,86,8,5,99,0,200,101,37,62,3,10959,0
28,"Mures",115771,261,115771,,"BICHIS",298,"Scoala Generala, sat Gimbut nr.34",133,96,84,6,6,95,1,200,104,38,57,3,10959,0
28,"Mures",115771,261,115771,,"BICHIS",299,"Scoala Generala, sat Nandra nr.28",111,62,53,7,2,62,0,200,138,24,38,3,10959,0
28,"Mures",115771,261,115771,,"BICHIS",300,"Caminul Cultural, sat Ozd nr.82",303,163,141,9,13,161,2,400,237,59,102,3,10959,0
28,"Mures",115771,261,115771,,"BICHIS",301,"Sediul Primariei comunei Bichis, sat Bichis nr.42, sala de sedinte",0,46,0,46,0,46,0,200,154,15,31,3,10959,1
28,"Mures",115824,261,115824,,"BOGATA",302,"Scoala Generala, sat Bogata, nr.133, sala nr.7",1349,771,761,10,0,763,8,1499,728,358,405,3,10964,0
28,"Mures",115824,261,115824,,"BOGATA",303,"Scoala Primara, sat Ranta, nr.64, sala nr.1",244,148,137,11,0,146,2,300,152,107,39,3,10964,0
28,"Mures",115824,261,115824,,"BOGATA",304,"Scoala Generala, sat Bogata, nr.133, sala nr.5",0,31,0,31,0,31,0,201,170,13,18,3,10964,1
28,"Mures",115851,261,115851,,"BREAZA",305,"Caminul Cultural, sat Breaza nr.59, sala festiva",1016,455,450,5,0,450,5,1100,645,263,187,3,10973,0
28,"Mures",115851,261,115851,,"BREAZA",306,"Scoala Generala, sat Filpisu Mare nr.256",656,292,284,7,1,286,6,701,409,184,102,3,10973,0
28,"Mures",115851,261,115851,,"BREAZA",307,"Scoala Generala, sat Filpisu Mic nr.69",356,184,179,5,0,180,4,400,216,85,95,3,10973,0
28,"Mures",115851,261,115851,,"BREAZA",308,"Caminul Cultural, sat Breaza nr.59, Clubul Vacarilor",0,50,0,50,0,48,2,100,50,34,14,3,10973,1
28,"Mures",115897,261,115897,,"BRANCOVENESTI",309,"Scoala Primara, sat Brincovenesti, nr.149, Sala de clasa A",1359,500,496,4,0,497,3,1500,1000,247,250,3,10967,0
28,"Mures",115897,261,115897,,"BRANCOVENESTI",310,"Scoala Primara, sat Idicel,  nr.12",387,200,190,10,0,198,2,500,300,114,84,3,10967,0
28,"Mures",115897,261,115897,,"BRANCOVENESTI",311,"Caminul Cultural, sat Idicel Padure, nr.476, Sala mica",465,274,262,10,2,273,1,500,226,210,63,3,10967,0
28,"Mures",115897,261,115897,,"BRANCOVENESTI",312,"Scoala Primara, sat Sacalu de Padure, nr.128",319,165,157,8,0,162,3,400,235,86,76,3,10967,0
28,"Mures",115897,261,115897,,"BRANCOVENESTI",313,"Club - Camin Cultural, sat Valenii de Mures, nr.44",1058,414,408,6,0,413,1,1200,786,105,308,3,10967,0
28,"Mures",115897,261,115897,,"BRANCOVENESTI",314,"Scoala Generala, sat Brincovenesti, nr.149, Sala de clasa B",0,51,0,51,0,51,0,200,149,29,22,3,10967,1
28,"Mures",115959,261,115959,,"CEUASU DE CAMPIE",315,"Caminul Cultural, sat Ceuasu de Campie, nr.366",1240,606,603,3,0,600,6,1400,794,309,291,3,10977,0
28,"Mures",115959,261,115959,,"CEUASU DE CAMPIE",316,"Caminul Cultural, sat Bozed, nr.107",148,91,82,9,0,88,3,201,110,48,40,3,10977,0
28,"Mures",115959,261,115959,,"CEUASU DE CAMPIE",317,"Caminul Cultural, sat Cimpenita, nr.76",678,240,230,10,0,238,2,800,560,93,145,3,10977,0
28,"Mures",115959,261,115959,,"CEUASU DE CAMPIE",318,"Caminul Cultural, sat Culpiu, nr.112",323,151,143,8,0,150,1,400,249,75,75,3,10977,0
28,"Mures",115959,261,115959,,"CEUASU DE CAMPIE",319,"Caminul Cultural, sat  Herghelia, nr.126",287,135,124,11,0,134,1,300,165,91,43,3,10977,0
28,"Mures",115959,261,115959,,"CEUASU DE CAMPIE",320,"Scoala Generala, sat Porumbeni nr.41",413,234,225,9,0,231,3,500,266,128,103,3,10977,0
28,"Mures",115959,261,115959,,"CEUASU DE CAMPIE",321,"Caminul Cultural, sat Sabed, nr.234",611,228,219,9,0,226,2,700,472,89,137,3,10977,0
28,"Mures",115959,261,115959,,"CEUASU DE CAMPIE",322,"Caminul Cultural, sat Voiniceni, nr.27",848,537,526,11,0,531,6,900,363,360,171,3,10977,0
28,"Mures",115959,261,115959,,"CEUASU DE CAMPIE",323,"Club Caminul Cultural, sat Ceuasu de Campie, nr. 366/1",0,94,0,94,0,94,0,200,106,54,40,3,10977,1
28,"Mures",116046,261,116046,,"CHETANI",324,"Sediul Primariei comunei Chetani, Sala de sedinte, Strada Principala nr.51",1011,608,603,4,1,598,10,1098,490,363,235,3,10986,0
28,"Mures",116046,261,116046,,"CHETANI",325,"Caminul Cultural, sat Grindeni nr.117",525,291,287,4,0,287,4,605,314,237,50,3,10986,0
28,"Mures",116046,261,116046,,"CHETANI",326,"Caminul Cultural, sat Hadareni nr.95",648,321,317,4,0,314,7,700,379,229,85,3,10986,0
28,"Mures",116046,261,116046,,"CHETANI",327,"Sediul Primariei comunei Chetani, Strada Principala nr.51, biroul viceprimarului",0,49,0,49,0,49,0,100,51,33,16,3,10986,1
28,"Mures",120478,261,120478,,"CHIBED",328,"Sediul Primariei comunei Chibed, sat Chibed, nr.452, Sala mare de sedinta",1393,372,364,8,0,361,11,1500,1128,106,255,3,10994,0
28,"Mures",120478,261,120478,,"CHIBED",329,"Sediul Primariei comunei Chibed, nr.452, Sala de asteptare a Cabinetului Medical",0,19,0,19,0,19,0,100,81,5,14,3,10994,1
28,"Mures",116126,261,116126,,"CHIHERU DE JOS",330,"Sediul Primariei, sat Chiheru de Jos, nr.81, parter - birou viceprimar",374,232,229,3,0,229,3,400,168,121,108,3,10996,0
28,"Mures",116126,261,116126,,"CHIHERU DE JOS",331,"Scoala Generala, sat Chiheru de Sus, nr.163, sala nr.2 (gradinita)",298,151,140,11,0,150,1,401,250,83,67,3,10996,0
28,"Mures",116126,261,116126,,"CHIHERU DE JOS",332,"Scoala Generala, sat Urisiu de Jos, nr.116, sala nr.1",285,185,176,9,0,184,1,402,217,123,61,3,10996,0
28,"Mures",116126,261,116126,,"CHIHERU DE JOS",333,"Caminul Cultural, sat Urisiu de Sus, nr.233, sala nr.1",395,272,266,6,0,269,3,501,229,186,83,3,10996,0
28,"Mures",116126,261,116126,,"CHIHERU DE JOS",334,"Sediul Primariei, sat Chiheru de Jos, nr.8, etaj I - birou Politie Comunitara",0,62,0,62,0,62,0,100,38,31,31,3,10996,1
28,"Mures",116171,261,116171,,"COROISANMARTIN",335,"Scoala Generala, sat Coroisinmartin, nr.46, Sala de geografie",340,170,164,6,0,167,3,400,230,103,64,3,11001,0
28,"Mures",116171,261,116171,,"COROISANMARTIN",336,"Scoala Generala, sat Soimus, nr.110",360,216,211,5,0,213,3,400,184,132,81,3,11001,0
28,"Mures",116171,261,116171,,"COROISANMARTIN",337,"Caminul Cultural, sat Odrihei, nr.186",381,184,175,9,0,181,3,400,216,123,58,3,11001,0
28,"Mures",116171,261,116171,,"COROISANMARTIN",338,"Scoala Generala, sat Coroi, nr.75",107,67,61,6,0,65,2,200,133,24,41,3,11001,0
28,"Mures",116171,261,116171,,"COROISANMARTIN",339,"Scoala Generala, sat Coroisinmartin, nr.46, Sala de istorie",0,81,0,81,0,80,1,100,19,59,21,3,11001,1
28,"Mures",120487,261,120487,,"CORUNCA",340,"Camin Cultural, sat Corunca, nr.184",1690,729,713,16,0,713,16,1803,1074,307,406,3,11006,0
28,"Mures",120487,261,120487,,"CORUNCA",341,"Scoala Generala, sat Bozeni nr.18",106,65,56,9,0,64,1,200,135,12,52,3,11006,0
28,"Mures",120487,261,120487,,"CORUNCA",342,"Sediul Primariei, sat Corunca, nr.108",0,46,0,46,0,46,0,100,54,13,33,3,11006,1
28,"Mures",116224,261,116224,,"COZMA",343,"Sediul Primariei comunei Cozma, nr.41, Sala nr.1 parter",342,251,235,5,11,247,4,400,149,158,89,3,11009,0
28,"Mures",116224,261,116224,,"COZMA",344,"Caminul Cultural, sat Socolu de Campie, nr.117, Sala 1",136,87,72,9,6,84,3,201,114,39,45,3,11009,0
28,"Mures",116224,261,116224,,"COZMA",345,"Sediul Primariei comunei Cozma, nr.41, Sala de sedinte",0,65,0,65,0,65,0,100,35,46,19,3,11009,1
28,"Mures",116288,261,116288,,"CRACIUNESTI",346,"Caminul Cultural, sat Craciunesti nr.166, sala mica",1846,431,392,8,31,419,12,2000,1569,134,285,3,11015,0
28,"Mures",116288,261,116288,,"CRACIUNESTI",347,"Caminul Cultural, sat Cornesti nr.72, sala mare",706,424,384,7,33,411,13,803,379,81,330,3,11015,0
28,"Mures",116288,261,116288,,"CRACIUNESTI",348,"Caminul Cultural, sat Cinta nr.16, sala mica",430,191,167,8,16,188,3,500,309,63,125,3,11015,0
28,"Mures",116288,261,116288,,"CRACIUNESTI",349,"Scoala Generala, sat Budiu-Mic nr.101, sala clasei II-IV",285,91,82,9,0,88,3,305,214,41,47,3,11015,0
28,"Mures",116288,261,116288,,"CRACIUNESTI",350,"Camin Cultural, sat Craciunesti, sala mare, sat Craciunesti  nr.166",0,43,0,43,0,39,4,311,268,16,23,3,11015,1
28,"Mures",116340,261,116340,,"CRAIESTI",351,"Caminul Cultural, sat Craiesti nr.122",568,340,322,3,15,339,1,600,260,167,172,3,11024,0
28,"Mures",116340,261,116340,,"CRAIESTI",352,"Scoala Generala, sat Milasel nr.46",163,108,98,8,2,107,1,200,92,37,70,3,11024,0
28,"Mures",116340,261,116340,,"CRAIESTI",353,"Scoala Generala, sat Lefaia nr.24",66,50,44,6,0,49,1,100,50,25,24,3,11024,0
28,"Mures",116340,261,116340,,"CRAIESTI",354,"Scoala Generala, sat Craiesti nr.170",0,38,0,38,0,38,0,100,62,24,14,3,11024,1
28,"Mures",114355,261,114355,,"CRISTESTI",355,"Caminul Cultural sat Cristesti, sala de sedinte, Strada Principala nr.565",1376,584,574,9,1,577,7,1497,913,284,293,3,11029,0
28,"Mures",114355,261,114355,,"CRISTESTI",356,"Sediul Primariei comunei Cristesti, Strada Principala nr. 678, sala de asteptare",1262,638,632,6,0,633,5,1394,756,332,301,3,11029,0
28,"Mures",114355,261,114355,,"CRISTESTI",357,"Scoala Generala sat Cristesti, Strada Scolii nr.309",1425,613,606,4,3,603,10,1500,887,331,272,3,11029,0
28,"Mures",114355,261,114355,,"CRISTESTI",358,"Caminul Cultural, sat Valureni nr.47",863,240,235,5,0,230,10,1000,760,98,132,3,11029,0
28,"Mures",114355,261,114355,,"CRISTESTI",359,"Sediul Primariei comunei Cristesti, Strada Principala nr. 678, sala Birou Directia Agricola",0,90,0,90,0,89,1,100,10,49,40,3,11029,1
28,"Mures",116395,261,116395,,"CUCERDEA",360,"Sediul Primariei comunei Cucerdea, sat Cucerdea nr.329",699,332,327,5,0,330,2,803,471,161,169,3,11032,0
28,"Mures",116395,261,116395,,"CUCERDEA",361,"Scoala Generela, sat Seulia de Mures nr.55",502,245,238,7,0,238,7,600,355,118,120,3,11032,0
28,"Mures",116395,261,116395,,"CUCERDEA",362,"Caminul Cultural, sat Bord nr.45",126,80,73,7,0,78,2,200,120,37,41,3,11032,0
28,"Mures",116395,261,116395,,"CUCERDEA",363,"Dispensar uman, sat Cucerdea nr.292",0,49,0,49,0,49,0,100,51,26,23,3,11032,1
28,"Mures",116439,261,116439,,"CUCI",364,"Sediul Primariei comunei Cuci, nr.261, sala de sedinte a Consiliului local",735,458,452,4,2,454,4,807,349,239,215,3,11036,0
28,"Mures",116439,261,116439,,"CUCI",365,"Scoala Generala, Sat Dataseni, nr.119",316,222,209,6,7,217,5,400,178,140,77,3,11036,0
28,"Mures",116439,261,116439,,"CUCI",366,"Caminul Cultural, Sat Orosia, nr.69",145,125,117,7,1,123,2,200,75,54,69,3,11036,0
28,"Mures",116439,261,116439,,"CUCI",367,"Caminul Cultural, Sat Petrilaca, nr.238",457,306,287,7,12,305,1,500,194,182,123,3,11036,0
28,"Mures",116439,261,116439,,"CUCI",368,"Sediul Primariei comunei Cuci, nr.261, birou Registru Agricol",0,81,0,81,0,81,0,200,119,36,45,3,11036,1
28,"Mures",116493,261,116493,,"DANES",369,"Caminul Cultural, sat Danes nr. 159, sala A",1860,1080,1050,10,20,1074,6,2000,920,780,294,3,11042,0
28,"Mures",116493,261,116493,,"DANES",370,"Caminul Cultural, sat Seleus, nr.464",1531,793,784,7,2,775,18,1600,807,629,146,3,11042,0
28,"Mures",116493,261,116493,,"DANES",371,"Caminul Cultural, sat Cris nr.72",532,222,215,7,0,220,2,600,378,159,61,3,11042,0
28,"Mures",116493,261,116493,,"DANES",372,"Scoala Generala, sat Stejarenii, nr.160",261,107,102,5,0,104,3,300,193,54,50,3,11042,0
28,"Mures",116493,261,116493,,"DANES",373,"Caminul Cultural, sat Danes nr.159, sala B",0,88,0,88,0,87,1,200,112,62,25,3,11042,1
28,"Mures",116545,261,116545,,"DEDA",374,"Camin Cultural sat Deda, nr.127",1562,975,966,9,0,962,13,1700,725,563,399,3,11047,0
28,"Mures",116545,261,116545,,"DEDA",375,"Scoala Generala  sat Bistra Muresului nr.270",884,595,564,1,30,592,3,998,403,343,249,3,11047,0
28,"Mures",116545,261,116545,,"DEDA",376,"Scoala Generala sat  Filea nr.231",598,378,374,4,0,370,8,700,322,259,111,3,11047,0
28,"Mures",116545,261,116545,,"DEDA",377,"Scoala Generala sat  Pietris nr.91",406,249,243,6,0,246,3,500,251,119,127,3,11047,0
28,"Mures",116545,261,116545,,"DEDA",378,"Cladirea Postului de Politie sat Deda, nr.133B",0,139,0,139,0,137,2,200,61,72,65,3,11047,1
28,"Mures",116590,261,116590,,"EREMITU",379,"Scoala Generala, sat Eremitu nr.551, sala clasei a VII-a",1408,391,383,8,0,378,13,1498,1107,208,170,3,11052,0
28,"Mures",116590,261,116590,,"EREMITU",380,"Scoala Generala, sat Calugareni nr.142",514,128,118,10,0,120,8,599,471,46,74,3,11052,0
28,"Mures",116590,261,116590,,"EREMITU",381,"Scoala Generala, sat Campu Cetatii nr.42",314,139,127,12,0,133,6,400,261,53,80,3,11052,0
28,"Mures",116590,261,116590,,"EREMITU",382,"Scoala Generala, sat Damieni nr.165",205,79,70,9,0,75,4,299,220,32,43,3,11052,0
28,"Mures",116590,261,116590,,"EREMITU",383,"Scoala Generala, sat Matrici nr.279",650,224,209,15,0,216,8,698,474,90,126,3,11052,0
28,"Mures",116590,261,116590,,"EREMITU",384,"Scoala Generala ""Dr. Nyulas Ferenc"", sat Eremitu, nr.551, sala clasei a VI-a",0,70,0,70,0,70,0,301,231,17,53,3,11052,1
28,"Mures",116652,261,116652,,"ERNEI",385,"Caminul Cultural, sat Ernei, Nr.439, Sala de spectacole",1688,623,616,7,0,605,18,1800,1177,235,370,3,11058,0
28,"Mures",116652,261,116652,,"ERNEI",386,"Caminul Cultural, sat Caluseri, Nr.85, Sala de spectacole",469,217,207,10,0,213,4,500,283,53,160,3,11058,0
28,"Mures",116652,261,116652,,"ERNEI",387,"Caminul Cultural, sat Dumbravioara, Nr.268, Sala nr.1",1389,489,480,9,0,475,14,1500,1011,164,311,3,11058,0
28,"Mures",116652,261,116652,,"ERNEI",388,"Caminul Cultural, sat Icland, Nr.117, Sala de spectacole",288,96,86,10,0,94,2,400,304,34,60,3,11058,0
28,"Mures",116652,261,116652,,"ERNEI",389,"Scoala Generala, sat Sacareni, Nr.72, Sala de clasa nr.1",185,76,66,10,0,74,2,199,123,34,40,3,11058,0
28,"Mures",116652,261,116652,,"ERNEI",390,"Casa de Cultura Multifunctionala, sat Sangerul de Padure, nr.114/A, Sala de spectacole",294,134,124,10,0,122,12,400,266,58,64,3,11058,0
28,"Mures",116652,261,116652,,"ERNEI",391,"Sediul Primariei Comunei Ernei, Nr.439, Sala de sedinte",0,43,0,43,0,40,3,200,157,12,28,3,11058,1
28,"Mures",116723,261,116723,,"FARAGAU",392,"Sediul Primariei comunei Faragau, nr.40/A",435,296,291,5,0,283,13,500,204,141,142,3,11072,0
28,"Mures",116723,261,116723,,"FARAGAU",393,"Gradinita sat Poarta Nr.121/A",207,131,119,12,0,129,2,301,170,68,61,3,11072,0
28,"Mures",116723,261,116723,,"FARAGAU",394,"Scoala Generala sat Tonciu nr.136/B",655,438,429,9,0,430,8,700,262,89,341,3,11072,0
28,"Mures",116723,261,116723,,"FARAGAU",395,"Sediul Primariei comunei Faragau nr.40/A",0,67,0,67,0,67,0,100,33,33,34,3,11072,1
28,"Mures",116796,261,116796,,"FANTANELE",396,"Scoala Generala, sat Fintinele nr.263, Sala 1",1006,285,279,6,0,278,7,1096,811,123,155,3,11065,0
28,"Mures",116796,261,116796,,"FANTANELE",397,"Scoala Generala, sat Fintinele nr.263, Sala 2",1040,221,219,2,0,217,4,1094,873,109,108,3,11065,0
28,"Mures",116796,261,116796,,"FANTANELE",398,"Scoala Generala, sat Calimanesti nr.142",703,233,223,10,0,229,4,800,567,110,119,3,11065,0
28,"Mures",116796,261,116796,,"FANTANELE",399,"Scoala Elementara, sat Viforoasa nr.28",723,249,238,11,0,242,7,800,551,109,133,3,11065,0
28,"Mures",116796,261,116796,,"FANTANELE",400,"Scoala Elementara, sat Bordosiu nr.148",233,78,68,10,0,77,1,300,222,47,30,3,11065,0
28,"Mures",116796,261,116796,,"FANTANELE",401,"Caminul Cultural, sat Cibu nr.19",118,53,42,11,0,47,6,198,145,34,13,3,11065,0
28,"Mures",116796,261,116796,,"FANTANELE",402,"Scoala Elementara, sat Roua nr.148",281,113,102,11,0,109,4,298,185,81,28,3,11065,0
28,"Mures",116796,261,116796,,"FANTANELE",403,"Sediul Primariei comunei Fintinele nr.124, Sala  de sedinta",0,25,0,25,0,25,0,201,176,12,13,3,11065,1
28,"Mures",116867,261,116867,,"GALESTI",404,"Caminul Cultural, sat Galesti nr.84",929,156,150,6,0,153,3,1000,844,60,93,3,11079,0
28,"Mures",116867,261,116867,,"GALESTI",405,"Scoala Generala, sat Troita nr.176",628,191,181,10,0,183,8,700,509,73,110,3,11079,0
28,"Mures",116867,261,116867,,"GALESTI",406,"Scoala Generala, sat Maiad nr.41",281,89,83,6,0,87,2,300,211,28,59,3,11079,0
28,"Mures",116867,261,116867,,"GALESTI",407,"Scoala Generala, sat Sanvasii nr.14",139,54,47,7,0,53,1,200,146,17,36,3,11079,0
28,"Mures",116867,261,116867,,"GALESTI",408,"Scoala Generala, sat Adrianu Mare nr.7",151,51,43,8,0,51,0,200,149,12,39,3,11079,0
28,"Mures",116867,261,116867,,"GALESTI",409,"Caminul Cultural, sat Bedeni nr.15",143,56,46,10,0,51,5,203,147,15,36,3,11079,0
28,"Mures",116867,261,116867,,"GALESTI",410,"Sediul Primariei comunei Galesti, nr.64, sala de asteptare",0,18,0,18,0,18,0,200,182,5,13,3,11079,1
28,"Mures",116938,261,116938,,"GANESTI",411,"Scoala Generala ""Fogarasi Samuel"", sat Ganesti, nr.248, sala nr.1",1765,719,714,5,0,711,8,1900,1181,391,320,3,11087,0
28,"Mures",116938,261,116938,,"GANESTI",412,"Scoala Primara, sat Seuca, nr.293",1027,385,375,10,0,382,3,1100,715,263,119,3,11087,0
28,"Mures",116938,261,116938,,"GANESTI",413,"Caminul Cultural, sat Paucisoara, nr.86",231,92,84,8,0,92,0,300,208,54,38,3,11087,0
28,"Mures",116938,261,116938,,"GANESTI",414,"Scoala Generala ""Fogarasi Samuel"", sat Ganesti, nr.248, sala nr.2",0,36,0,36,0,36,0,200,164,20,16,3,11087,1
28,"Mures",116983,261,116983,,"GHEORGHE DOJA",415,"Caminul Cultural, sat Gheorghe Doja nr.8, sala mare",398,128,117,9,2,126,2,500,372,34,92,3,11092,0
28,"Mures",116983,261,116983,,"GHEORGHE DOJA",416,"Caminul Cultural, sat Ilieni nr.94",332,141,129,7,5,138,3,400,259,31,107,3,11092,0
28,"Mures",116983,261,116983,,"GHEORGHE DOJA",417,"Caminul Cultural, sat Leordeni nr.26",283,133,121,8,4,133,0,314,181,38,95,3,11092,0
28,"Mures",116983,261,116983,,"GHEORGHE DOJA",418,"Scoala Generala, sat Satu Nou nr.9",591,237,221,10,6,231,6,700,463,60,171,3,11092,0
28,"Mures",116983,261,116983,,"GHEORGHE DOJA",419,"Scoala Generala, sat Tirimia nr.182",682,256,254,2,0,256,0,800,544,147,109,3,11092,0
28,"Mures",116983,261,116983,,"GHEORGHE DOJA",420,"Caminul Cultural, sat Gheorghe Doja nr.8, sala mica",0,41,0,41,0,39,2,200,159,12,27,3,11092,1
28,"Mures",117042,261,117042,,"GHINDARI",421,"Caminul Cultural, sat Ghindari nr.78, Sala 2 (sala mica)",1200,454,448,6,0,425,29,1300,846,124,301,3,11098,0
28,"Mures",117042,261,117042,,"GHINDARI",422,"Scoala Elementara, sat Abud nr.48, Sala 2 (sala de cursuri)",134,56,46,10,0,53,3,201,145,30,23,3,11098,0
28,"Mures",117042,261,117042,,"GHINDARI",423,"Scoala Elementara, sat Solocma nr.192, Sala 2 (sala de cursuri)",304,119,108,11,0,109,10,400,281,34,75,3,11098,0
28,"Mures",117042,261,117042,,"GHINDARI",424,"Caminul Cultural, sat Trei Sate nr.78, Sala 2 (sala mica)",988,318,310,8,0,307,11,1100,782,131,176,3,11098,0
28,"Mures",117042,261,117042,,"GHINDARI",425,"Caminul Cultural, sat Ghindari, nr.78 - sala 1",0,31,0,31,0,29,2,200,169,9,20,3,11098,1
28,"Mures",117113,261,117113,,"GLODENI",426,"Scoala Generala ""Adorjan Karoly"", sat Glodeni nr.132, cladirea noua, parter, sala nr.3",1120,359,350,9,0,354,5,1200,841,105,249,3,11104,0
28,"Mures",117113,261,117113,,"GLODENI",427,"Scoala Generala ""Adorjan Karoly"", sat Glodeni nr.132, cladirea noua, parter, sala nr.4",834,325,316,9,0,319,6,900,575,205,114,3,11104,0
28,"Mures",117113,261,117113,,"GLODENI",428,"Scoala Primara Merisor, sat Merisor, nr.37, sala nr.1",168,84,79,5,0,83,1,200,116,47,36,3,11104,0
28,"Mures",117113,261,117113,,"GLODENI",429,"Scoala Primara Moisa, sat Moisa, nr.23, sala nr.1",236,151,139,4,8,151,0,300,149,91,60,3,11104,0
28,"Mures",117113,261,117113,,"GLODENI",430,"Scoala Primara Pacureni, sat Pacureni, nr. 37, sala nr.1",197,88,79,9,0,87,1,300,212,39,48,3,11104,0
28,"Mures",117113,261,117113,,"GLODENI",431,"Scoala Primara Paingeni, sat Paingeni, nr.126, sala nr.1",346,176,165,11,0,176,0,400,224,99,77,3,11104,0
28,"Mures",117113,261,117113,,"GLODENI",432,"Sediul Primariei comunei Glodeni, nr.133",0,44,0,44,0,44,0,200,156,20,24,3,11104,1
28,"Mures",117177,261,117177,,"GORNESTI",433,"Caminul Cultural, sat Gornesti nr.431, club",1640,710,700,8,2,701,9,1800,1090,343,358,3,11110,0
28,"Mures",117177,261,117177,,"GORNESTI",434,"Caminul Cultural, sat Peris nr.274",1489,515,482,9,24,506,9,1600,1085,258,248,3,11110,0
28,"Mures",117177,261,117177,,"GORNESTI",435,"Caminul Cultural, sat  Petrilaca de Mures nr.57",381,170,151,12,7,169,1,500,330,53,116,3,11110,0
28,"Mures",117177,261,117177,,"GORNESTI",436,"Scoala Generala, sat  Teleac nr.19",391,213,204,9,0,212,1,500,287,109,103,3,11110,0
28,"Mures",117177,261,117177,,"GORNESTI",437,"Scoala Generala, sat  Iara de Mures nr.169",271,97,81,8,8,94,3,300,203,45,49,3,11110,0
28,"Mures",117177,261,117177,,"GORNESTI",438,"Caminul Cultural, sat  Ilioara nr.11",103,57,47,10,0,57,0,200,143,20,37,3,11110,0
28,"Mures",117177,261,117177,,"GORNESTI",439,"Caminul Cultural, sat  Padureni nr.136",368,187,177,10,0,178,9,400,213,56,122,3,11110,0
28,"Mures",117177,261,117177,,"GORNESTI",440,"Caminul Cultural, sat  Gornesti nr.431, bucatarie",0,65,0,65,0,64,1,300,235,26,38,3,11110,1
28,"Mures",117275,261,117275,,"GREBENISU DE CAMPIE",441,"Caminul Cultural, sat Grebenisu de Campie nr.152, sala mare",1268,852,813,1,38,846,6,1400,548,372,474,3,11120,0
28,"Mures",117275,261,117275,,"GREBENISU DE CAMPIE",442,"Caminul Cultural, sat Grebenisu de Campie nr.152, sala mica",0,31,0,31,0,31,0,100,69,13,18,3,11120,1
28,"Mures",117319,261,117319,,"GURGHIU",443,"Caminul Cultural, sat Gurghiu, Strada Eroilor, nr.9",1586,847,844,2,1,831,16,1700,853,488,343,3,11124,0
28,"Mures",117319,261,117319,,"GURGHIU",444,"Caminul Cultural, sat Adrian nr.70",263,125,118,7,0,124,1,300,175,59,65,3,11124,0
28,"Mures",117319,261,117319,,"GURGHIU",445,"Scoala Generala, sat Casva, nr.180a",684,362,340,7,15,358,4,800,438,208,150,3,11124,0
28,"Mures",117319,261,117319,,"GURGHIU",446,"Scoala Generala, sat Comori, nr.55b",182,94,85,9,0,93,1,200,106,30,63,3,11124,0
28,"Mures",117319,261,117319,,"GURGHIU",447,"Caminul Cultural, sat Glajarie, nr.70",1410,614,609,5,0,609,5,1500,886,227,382,3,11124,0
28,"Mures",117319,261,117319,,"GURGHIU",448,"Scoala Generala, sat Larga, nr.33b",194,108,98,10,0,108,0,300,192,79,29,3,11124,0
28,"Mures",117319,261,117319,,"GURGHIU",449,"Gradinita sat Orsova, nr.34",704,407,402,5,0,401,6,800,393,294,107,3,11124,0
28,"Mures",117319,261,117319,,"GURGHIU",450,"Gradinita sat Gurghiu, Strada Eroilor, nr.2",0,75,0,75,0,75,0,300,225,48,27,3,11124,1
28,"Mures",117426,261,117426,,"HODAC",451,"Camin Cultural, sat Hodac, nr.77, Sala de Sedinta",967,487,477,8,2,480,7,1100,613,305,175,3,11135,0
28,"Mures",117426,261,117426,,"HODAC",452,"Scoala Generala sat Hodac, nr.38, sala 1",1079,646,636,8,2,641,5,1207,561,405,236,3,11135,0
28,"Mures",117426,261,117426,,"HODAC",453,"Camin Cultural, sat Toaca, nr. 513, Sala de sedinta",1527,975,965,9,1,969,6,1600,625,692,277,3,11135,0
28,"Mures",117426,261,117426,,"HODAC",454,"Scoala Generala, sat Dubistea de Padure, nr.70 A",355,247,241,6,0,245,2,400,153,143,102,3,11135,0
28,"Mures",117426,261,117426,,"HODAC",455,"Scoala Generala, sat Hodac, nr.38, sala 2",0,50,0,50,0,48,2,100,50,27,21,3,11135,1
28,"Mures",117505,261,117505,,"HODOSA",456,"Scoala Generala, sat Hodosa, nr.136",170,92,85,7,0,91,1,200,108,20,71,3,11143,0
28,"Mures",117505,261,117505,,"HODOSA",457,"Scoala Generala, sat Ihod, nr.12",82,63,55,8,0,63,0,101,38,6,57,3,11143,0
28,"Mures",117505,261,117505,,"HODOSA",458,"Scoala Generala, sat Isla, nr.55",255,116,109,7,0,114,2,299,183,37,77,3,11143,0
28,"Mures",117505,261,117505,,"HODOSA",459,"Scoala Generala, sat Simbrias, nr.105",546,267,263,4,0,262,5,599,332,45,217,3,11143,0
28,"Mures",117505,261,117505,,"HODOSA",460,"Sediul Primariei comunei Hodosa, nr.56",0,30,0,30,0,28,2,100,70,11,17,3,11143,1
28,"Mures",117550,261,117550,,"IBANESTI",461,"Camin Cultural sat Ibanesti, str. Principala nr.607",1327,843,828,15,0,836,7,1400,557,410,426,3,11148,0
28,"Mures",117550,261,117550,,"IBANESTI",462,"Sala de manifestari Isticeu, satul Ibanesti, nr.467",499,307,296,10,1,303,4,593,286,155,148,3,11148,0
28,"Mures",117550,261,117550,,"IBANESTI",463,"Sediul secundar al Primariei, satul Ibanesti-Padure, nr.14",816,477,465,11,1,471,6,893,416,277,194,3,11148,0
28,"Mures",117550,261,117550,,"IBANESTI",464,"Caminul Cultural, sat Dulcea Nr.62",910,554,539,15,0,551,3,995,441,295,256,3,11148,0
28,"Mures",117550,261,117550,,"IBANESTI",465,"Centrul de Informare si Documentare, sat Ibanesti, nr.107",0,89,0,89,0,89,0,200,111,41,48,3,11148,1
28,"Mures",117667,261,117667,,"ICLANZEL",466,"Caminul Cultural, sat Iclanzel, nr.193",1101,512,510,2,0,506,6,1200,688,200,306,3,11159,0
28,"Mures",117667,261,117667,,"ICLANZEL",467,"Caminul Cultural, sat Capusu de Campie, nr.275",658,313,303,10,0,308,5,707,394,111,197,3,11159,0
28,"Mures",117667,261,117667,,"ICLANZEL",468,"Sediul Primariei comunei Iclanzel, nr.1",0,48,0,48,0,48,0,100,52,21,27,3,11159,1
28,"Mures",117783,261,117783,,"IDECIU DE JOS",469,"Caminul Cultural, sat Ideciu de Jos nr.234",805,462,453,4,5,459,3,900,438,209,250,3,11171,0
28,"Mures",117783,261,117783,,"IDECIU DE JOS",470,"Scoala Generala, sat Ideciu de Sus nr.126",659,381,376,3,2,379,2,703,322,156,223,3,11171,0
28,"Mures",117783,261,117783,,"IDECIU DE JOS",471,"Scoala Generala, sat Deleni nr.154",271,178,169,7,2,176,2,300,122,81,95,3,11171,0
28,"Mures",117783,261,117783,,"IDECIU DE JOS",472,"Caminul pentru Persoane Varstnice nr.158, sat Ideciu de Jos, cabinet medical - sala de tratament",0,107,0,107,0,103,4,200,93,48,55,3,11171,1
28,"Mures",117925,261,117925,,"LIVEZENI",473,"Caminul Cultural, sat Livezeni nr.76",1287,457,443,14,0,448,9,1400,943,218,230,3,11175,0
28,"Mures",117925,261,117925,,"LIVEZENI",474,"Caminul Cultural, sat Ivanesti nr.42",295,116,110,6,0,112,4,400,284,50,62,3,11175,0
28,"Mures",117925,261,117925,,"LIVEZENI",475,"Scoala Generala, sat Sinisor nr.67",166,80,73,7,0,80,0,197,117,46,34,3,11175,0
28,"Mures",117925,261,117925,,"LIVEZENI",476,"Scoala Generala, sat Poienita nr.55",245,105,96,6,3,105,0,299,194,70,35,3,11175,0
28,"Mures",117925,261,117925,,"LIVEZENI",477,"Scoala Generala  ""Benedek Elek"", sat Livezeni nr.213",0,34,0,34,0,33,1,100,66,13,20,3,11175,1
28,"Mures",117998,261,117998,,"LUNCA",478,"Sediul Primariei comunei Lunca, Strada Principala nr.228, Birou impozite si taxe",478,317,313,4,0,312,5,500,183,179,133,3,11180,0
28,"Mures",117998,261,117998,,"LUNCA",479,"Scoala Generala, sat Baita, nr.98",661,387,381,6,0,380,7,700,313,241,139,3,11180,0
28,"Mures",117998,261,117998,,"LUNCA",480,"Scoala Primara, sat Frunzeni, nr.158",362,207,199,8,0,202,5,400,193,95,107,3,11180,0
28,"Mures",117998,261,117998,,"LUNCA",481,"Scoala Primara, sat Logig, nr.159",364,218,209,9,0,213,5,400,182,65,148,3,11180,0
28,"Mures",117998,261,117998,,"LUNCA",482,"Scoala Primara, sat Sintu, nr.41",313,202,197,5,0,200,2,400,198,105,95,3,11180,0
28,"Mures",117998,261,117998,,"LUNCA",483,"Sediul Primariei comunei Lunca, Strada Principala nr. 228, Birou relatii cu publicul",0,47,0,47,0,47,0,100,53,20,27,3,11180,1
28,"Mures",118058,261,118058,,"LUNCA BRADULUI",484,"Casa de Cultura, sat Lunca Bradului, nr.187, Club",1359,645,644,1,0,635,10,1500,855,437,198,3,11186,0
28,"Mures",118058,261,118058,,"LUNCA BRADULUI",485,"Scoala Generala, sat Neagra, nr.511",373,231,224,7,0,226,5,400,169,109,117,3,11186,0
28,"Mures",118058,261,118058,,"LUNCA BRADULUI",486,"Casa de Cultura, sat Lunca Bradului, nr.187, Biblioteca",0,63,0,63,0,62,1,101,38,41,21,3,11186,1
28,"Mures",120502,261,120502,,"MADARAS",487,"Scoala Generala ""Pataky Agotha"", sat Madaras, nr.260",1145,431,425,6,0,415,16,1200,769,117,298,3,11190,0
28,"Mures",120502,261,120502,,"MADARAS",488,"Sediul Primariei Comunei Madaras, nr.357",0,24,0,24,0,23,1,100,76,9,14,3,11190,1
28,"Mures",118094,261,118094,,"MAGHERANI",489,"Scoala Generala, sat Magherani nr.363, sala de sport",590,199,197,2,0,195,4,700,501,95,100,3,11192,0
28,"Mures",118094,261,118094,,"MAGHERANI",490,"Gradinita de copii, sat Silea Nirajului nr.267",368,162,154,8,0,162,0,400,238,9,153,3,11192,0
28,"Mures",118094,261,118094,,"MAGHERANI",491,"Gradinita de copii, sat Torba nr.73",132,80,73,7,0,77,3,200,120,24,53,3,11192,0
28,"Mures",118094,261,118094,,"MAGHERANI",492,"Scoala Generala, sat Magherani nr.363, sala de clasa I",0,39,0,39,0,39,0,200,161,12,27,3,11192,1
28,"Mures",118209,261,118209,,"MICA",493,"Caminul Cultural, sat Mica nr.65",621,256,247,8,1,254,2,700,444,149,105,3,11196,0
28,"Mures",118209,261,118209,,"MICA",494,"Scoala Generala, sat Abus nr.141",272,131,124,7,0,126,5,301,170,81,45,3,11196,0
28,"Mures",118209,261,118209,,"MICA",495,"Caminul Cultural, sat Ceuas nr.15",653,302,296,6,0,296,6,700,398,177,119,3,11196,0
28,"Mures",118209,261,118209,,"MICA",496,"Caminul Cultural, sat Deaj nr.127",1175,452,444,8,0,442,10,1300,848,219,223,3,11196,0
28,"Mures",118209,261,118209,,"MICA",497,"Caminul Cultural, sat Haranglab nr.265",648,253,248,5,0,244,9,700,447,166,78,3,11196,0
28,"Mures",118209,261,118209,,"MICA",498,"Caminul Cultural, sat Somostelnic nr.101",210,98,84,14,0,97,1,300,202,36,61,3,11196,0
28,"Mures",118209,261,118209,,"MICA",499,"Scoala Generala, sat Mica nr.55/B",0,27,0,27,0,27,0,300,273,12,15,3,11196,1
28,"Mures",118370,261,118370,,"MIHESU DE CAMPIE",500,"Caminul Cultural, sat Mihesu de Campie, Strada A. Petofi, nr.4",1264,734,734,0,0,724,10,1399,665,401,323,3,11204,0
28,"Mures",118370,261,118370,,"MIHESU DE CAMPIE",501,"Caminul Cultural, sat Razoare, Strada 22 Decembrie 1989, nr.45",697,371,361,10,0,369,2,800,429,157,212,3,11204,0
28,"Mures",118370,261,118370,,"MIHESU DE CAMPIE",502,"Sediul Primariei comunei Mihesu de Cimpie, Strada Mihai Eminescu nr.8",0,72,0,72,0,70,2,200,128,43,27,3,11204,1
28,"Mures",118469,261,118469,,"NADES",503,"Scoala Generala, sat Nades, Strada Principala, nr.385, Corp A, sala clasa VIII",1188,471,468,3,0,469,2,1300,829,328,141,3,11213,0
28,"Mures",118469,261,118469,,"NADES",504,"Scoala Generala, sat Tigmandru, Strada Principala, nr.66",808,371,362,9,0,364,7,900,529,271,93,3,11213,0
28,"Mures",118469,261,118469,,"NADES",505,"Scoala Generala, sat Magherus, Strada Principala, nr.114",133,85,76,9,0,84,1,200,115,57,27,3,11213,0
28,"Mures",118469,261,118469,,"NADES",506,"Caminul Cultural, sat Pipea, Strada Principala, nr.60",67,41,30,11,0,40,1,100,59,17,23,3,11213,0
28,"Mures",118469,261,118469,,"NADES",507,"Scoala Generala, sat Nades, Strada Principala, nr.385, Corp A, sala clasa VII",0,52,0,52,0,52,0,200,148,35,17,3,11213,1
28,"Mures",118511,261,118511,,"NEAUA",508,"Scoala Generala, sat Neaua, nr. 19",363,121,117,4,0,119,2,400,279,23,96,3,11218,0
28,"Mures",118511,261,118511,,"NEAUA",509,"Scoala Generala, sat Vadas, nr. 83",296,88,84,4,0,87,1,400,312,22,65,3,11218,0
28,"Mures",118511,261,118511,,"NEAUA",510,"Scoala Generala, sat Ghinesti, nr. 216",249,91,86,5,0,89,2,300,209,10,79,3,11218,0
28,"Mures",118511,261,118511,,"NEAUA",511,"Scoala Generala, sat Rigmani,  nr. 90/A",225,150,144,6,0,145,5,300,150,40,105,3,11218,0
28,"Mures",118511,261,118511,,"NEAUA",512,"Caminul Cultural, sat Neaua nr. 82",0,21,0,21,0,18,3,100,79,5,13,3,11218,1
28,"Mures",118575,261,118575,,"OGRA",513,"Club Camin Cultural, sat Ogra nr.103/A",1215,637,630,6,1,630,7,1280,643,232,398,3,11224,0
28,"Mures",118575,261,118575,,"OGRA",514,"Scoala Generala, sat Dileu Vechi nr.188",165,94,89,5,0,92,2,200,106,37,55,3,11224,0
28,"Mures",118575,261,118575,,"OGRA",515,"Scoala Generala, sat  Giulus nr.97",136,61,55,6,0,61,0,200,139,30,31,3,11224,0
28,"Mures",118575,261,118575,,"OGRA",516,"Scoala Generala, sat Lascud, nr.191",192,116,107,9,0,115,1,300,184,62,53,3,11224,0
28,"Mures",118575,261,118575,,"OGRA",517,"Scoala Generala, sat Vaideiu, nr.138",128,82,77,5,0,82,0,200,118,47,35,3,11224,0
28,"Mures",118575,261,118575,,"OGRA",518,"Sediul Primariei comunei Ogra, nr.103/A",0,61,0,61,0,61,0,201,140,23,38,3,11224,1
28,"Mures",118637,261,118637,,"PAPIU ILARIAN",519,"Caminul Cultural, sat Papiu Ilarian, Strada Principala nr.132",743,411,411,0,0,410,1,800,389,249,161,3,11236,0
28,"Mures",118637,261,118637,,"PAPIU ILARIAN",520,"Scoala Generala, sat Papiu Ilarian, str. Principala nr.115, Sala mare din cladirea veche",0,24,0,24,0,24,0,100,76,18,6,3,11236,1
28,"Mures",118691,261,118691,,"PANET",521,"Caminul Cultural, sat Panet nr.695, sala mare",1920,747,747,0,0,733,14,2100,1353,172,561,3,11230,0
28,"Mures",118691,261,118691,,"PANET",522,"Caminul Cultural, sat Berghia nr.59",972,451,445,6,0,445,6,1100,649,313,132,3,11230,0
28,"Mures",118691,261,118691,,"PANET",523,"Scoala Generala, sat Cuiesd nr.68",589,224,216,8,0,212,12,700,476,58,154,3,11230,0
28,"Mures",118691,261,118691,,"PANET",524,"Caminul Cultural, sat Hartau nr.42",263,108,103,5,0,101,7,300,192,32,69,3,11230,0
28,"Mures",118691,261,118691,,"PANET",525,"Caminul Cultural, sat Sintioana de Mures nr.395",1134,475,463,12,0,471,4,1200,725,189,282,3,11230,0
28,"Mures",118691,261,118691,,"PANET",526,"Caminul Cultural, sat Panet nr.695, sala mica",0,34,0,34,0,34,0,200,166,12,22,3,11230,1
28,"Mures",118753,261,118753,,"PASARENI",527,"Scoala Generala ""Kiss Gergely"", sat Pasareni nr. 293A, sala nr.2",727,287,275,5,7,284,3,800,513,111,173,3,11242,0
28,"Mures",118753,261,118753,,"PASARENI",528,"Caminul Cultural, sat Galateni nr. 31, sala nr.1",622,227,203,10,14,223,4,700,473,43,180,3,11242,0
28,"Mures",118753,261,118753,,"PASARENI",529,"Caminul Cultural, sat Bolintineni nr. 70, sala nr.1",180,75,65,10,0,72,3,200,125,49,23,3,11242,0
28,"Mures",118753,261,118753,,"PASARENI",530,"Caminul Cultural, sat Pasareni nr. 294, sala nr.1",0,33,0,33,0,33,0,200,167,14,19,3,11242,1
28,"Mures",118799,261,118799,,"PETELEA",531,"Caminul Cultural, sat Petelea, nr.727",1020,590,578,6,6,574,16,1100,510,410,164,3,11246,0
28,"Mures",118799,261,118799,,"PETELEA",532,"Sediul Primariei comunei Petelea nr.726, sala de sedinte",892,458,438,8,12,454,4,1000,542,273,181,3,11246,0
28,"Mures",118799,261,118799,,"PETELEA",533,"Scoala Generala, sat Habic, nr.84, sala de clasa",244,125,116,9,0,121,4,300,175,81,40,3,11246,0
28,"Mures",118799,261,118799,,"PETELEA",534,"Scoala Generala, sat Petelea nr.724, sala de sport",0,74,0,74,0,74,0,100,26,42,32,3,11246,1
28,"Mures",118824,261,118824,,"POGACEAUA",535,"Sediul Primariei comunei Pogaceaua, nr.152, sala de sedinte",1060,563,563,0,0,558,5,1220,657,355,203,3,11249,0
28,"Mures",118824,261,118824,,"POGACEAUA",536,"Caminul Cultural, sat Valeni nr.17, sala mica",447,245,231,14,0,242,3,500,255,125,117,3,11249,0
28,"Mures",118824,261,118824,,"POGACEAUA",537,"Sediul Primariei comunei Pogaceaua nr.152, birou viceprimar",0,66,0,66,0,66,0,200,134,48,18,3,11249,1
28,"Mures",118931,261,118931,,"RASTOLITA",538,"Caminul Cultural, sat Rastolita, Strada Principala nr. 54",1446,852,846,1,5,846,6,1600,748,557,289,3,11260,0
28,"Mures",118931,261,118931,,"RASTOLITA",539,"Scoala Generala, sat Rastolita, nr. 52",0,194,0,194,0,194,0,201,7,103,91,3,11260,1
28,"Mures",118995,261,118995,,"RICIU",540,"Casa de Cultura ""Vasile Contiu"", sat Riciu, Strada Gheorghe Sincai nr.71",1199,797,764,6,27,785,12,1300,503,525,260,3,11266,0
28,"Mures",118995,261,118995,,"RICIU",541,"Caminul Cultural, sat Sinmartinu de Campie, nr. 15",746,468,423,7,38,459,9,800,332,317,142,3,11266,0
28,"Mures",118995,261,118995,,"RICIU",542,"Scoala Generala, sat Ulies, nr. 129",537,282,274,8,0,280,2,600,318,172,108,3,11266,0
28,"Mures",118995,261,118995,,"RICIU",543,"Caminul Cultural, sat Nima Riciului, nr. 51",153,104,89,10,5,101,3,199,95,64,37,3,11266,0
28,"Mures",118995,261,118995,,"RICIU",544,"Scoala Generala, sat Coasta Mare, nr. 39",235,138,127,11,0,137,1,300,162,84,53,3,11266,0
28,"Mures",118995,261,118995,,"RICIU",545,"Sediul Primariei comunei Riciu, str. Gheorghe Sincai, nr. 58",0,135,0,135,0,133,2,201,66,92,41,3,11266,1
28,"Mures",119153,261,119153,,"RUSII-MUNTI",546,"Caminul Cultural, sat Rusii Munti nr. 141, sala mare (dreapta)",1302,801,792,4,5,797,4,1400,599,399,398,3,11282,0
28,"Mures",119153,261,119153,,"RUSII-MUNTI",547,"Scoala Generala, sat Morareni nr. 30",339,200,191,8,1,198,2,400,200,64,134,3,11282,0
28,"Mures",119153,261,119153,,"RUSII-MUNTI",548,"Caminul Cultural, sat Maioresti nr. 75",189,141,133,8,0,141,0,200,59,72,69,3,11282,0
28,"Mures",119153,261,119153,,"RUSII-MUNTI",549,"Caminul Cultural, sat Rusii Munti nr.141, sala mare (stanga)",0,69,0,69,0,68,1,102,33,29,39,3,11282,1
28,"Mures",119206,261,119206,,"SASCHIZ",550,"Scoala Generala, sat Saschiz nr. 534, Sala Cancelarie",1271,688,683,4,1,682,6,1400,712,376,306,3,11322,0
28,"Mures",119206,261,119206,,"SASCHIZ",551,"Scoala Primara, sat Mihai Viteazu nr.14",258,169,159,10,0,165,4,300,131,90,75,3,11322,0
28,"Mures",119206,261,119206,,"SASCHIZ",552,"Scoala Primara, sat Cloasterf nr.77",145,86,77,9,0,84,2,202,116,53,31,3,11322,0
28,"Mures",119206,261,119206,,"SASCHIZ",553,"Scoala Generala, sat Saschiz, nr.534, clasa II",0,75,0,75,0,74,1,206,131,42,32,3,11322,1
28,"Mures",120496,261,120496,,"SARATENI",554,"Caminul Cultural, sat Sarateni, Strada Principala, nr.110/A, sala de asteptare",1303,351,345,6,0,330,21,1400,1049,154,176,3,11320,0
28,"Mures",120496,261,120496,,"SARATENI",555,"Caminul Cultural, sat Sarateni, Strada Principala, nr.110/A, sala de sedinte",0,30,0,30,0,30,0,100,70,17,13,3,11320,1
28,"Mures",114382,261,114382,,"SANCRAIU DE MURES",556,"Caminul Cultural, sat Sincraiu de Mures, Strada Principala nr. 54",1761,754,739,15,0,746,8,1900,1146,421,325,3,11287,0
28,"Mures",114382,261,114382,,"SANCRAIU DE MURES",557,"Scoala Generala, sat Sincraiu de Mures, Strada Principala nr. 178",846,414,405,8,1,408,6,900,486,221,187,3,11287,0
28,"Mures",114382,261,114382,,"SANCRAIU DE MURES",558,"Sediul Primariei comunei Sincraiu de Mures - hol parter, Strada Principala nr. 197/A",1539,739,712,25,2,733,6,1700,961,357,376,3,11287,0
28,"Mures",114382,261,114382,,"SANCRAIU DE MURES",559,"Caminul Cultural Nazna, hol  parter, Strada Principala nr. 172",1762,989,980,9,0,976,13,1900,911,618,358,3,11287,0
28,"Mures",114382,261,114382,,"SANCRAIU DE MURES",560,"Sediul Primariei comunei Sincraiu de Mures - sala de protocol, Strada Principala nr. 197/A",0,123,0,123,0,121,2,397,274,61,60,3,11287,1
28,"Mures",114417,261,114417,,"SANGEORGIU DE MURES",561,"Comuna Singeorgiu de Mures, Gradinita de copii nr. 1, str. Petki David, nr. 111 (fosta Principala, nr. 1284)",1645,698,679,19,0,686,12,1800,1102,298,388,3,11290,0
28,"Mures",114417,261,114417,,"SANGEORGIU DE MURES",562,"Gimnaziul ""Sf. Gheorghe"", cl. VII C - cabinet limba maghiara, Piata Sf. Gheorghe, nr.2 (fosta str. Tofalau, nr.610)",1530,625,605,20,0,616,9,1600,975,290,326,3,11290,0
28,"Mures",114417,261,114417,,"SANGEORGIU DE MURES",563,"Gimnaziul ""Sf. Gheorghe"", cl. VII B - cabinet geografie, Piata Sf. Gheorghe, nr.2 (fosta str. Tofalau, nr.610)",1838,856,828,28,0,845,11,2000,1144,434,411,3,11290,0
28,"Mures",114417,261,114417,,"SANGEORGIU DE MURES",564,"Caminul cultural - sala mare, str. Tofalau, nr. 27 (fost nr. 815)",1958,989,964,25,0,972,17,2100,1111,514,458,3,11290,0
28,"Mures",114417,261,114417,,"SANGEORGIU DE MURES",565,"Sat Cotus, Scoala Generala, nr. 76",328,148,131,17,0,145,3,400,252,60,85,3,11290,0
28,"Mures",114417,261,114417,,"SANGEORGIU DE MURES",566,"Gimnaziul ""Sf. Gheorghe"", cl. V A - cabinet muzica, Piata Sf. Gheorghe, nr. 2 (fosta str. Tofalau, nr. 610)",0,222,0,222,0,218,4,401,179,82,136,3,11290,1
28,"Mures",119386,261,119386,,"SANGER",567,"Gradinita de copii PN Singer, nr. 106, sala nr. 1",1287,608,604,1,3,603,5,1400,792,302,301,3,11294,0
28,"Mures",119386,261,119386,,"SANGER",568,"Caminul Cultural din satul Cipaieni, nr. 9, sala nr. 1",664,350,343,7,0,348,2,700,350,127,221,3,11294,0
28,"Mures",119386,261,119386,,"SANGER",569,"Gradinita de copii PN Singer, nr. 106, sala nr. 2",0,45,0,45,0,45,0,100,55,26,19,3,11294,1
28,"Mures",119466,261,119466,,"SANPAUL",570,"Camin Cultural Sinpaul, nr.261",1306,621,610,6,5,616,5,1400,779,288,328,3,11302,0
28,"Mures",119466,261,119466,,"SANPAUL",571,"Camin Cultural Chirileu, nr.146",604,309,300,9,0,302,7,700,391,145,157,3,11302,0
28,"Mures",119466,261,119466,,"SANPAUL",572,"Camin Cultural Dileu Nou, nr.28",156,94,73,9,12,93,1,200,106,24,69,3,11302,0
28,"Mures",119466,261,119466,,"SANPAUL",573,"Camin Cultural Sinmarghita, nr.111",206,127,119,8,0,126,1,300,173,89,37,3,11302,0
28,"Mures",119466,261,119466,,"SANPAUL",574,"Camin Cultural Valea Izvoarelor, nr.321",896,463,427,10,26,460,3,994,531,146,314,3,11302,0
28,"Mures",119466,261,119466,,"SANPAUL",575,"Scoala Generala Sinpaul, nr. 289/A",0,48,0,48,0,48,0,300,252,25,23,3,11302,1
28,"Mures",119527,261,119527,,"SANPETRU DE CAMPIE",576,"Caminul Cultural Sinpetru de Campie nr. 124 A",908,465,459,5,1,465,0,995,530,265,200,3,11308,0
28,"Mures",119527,261,119527,,"SANPETRU DE CAMPIE",577,"Caminul Cultural Birlibas Nr.58",76,55,42,13,0,55,0,100,45,21,34,3,11308,0
28,"Mures",119527,261,119527,,"SANPETRU DE CAMPIE",578,"Caminul Cultural Dimbu, nr. 286",496,283,277,6,0,281,2,600,317,99,182,3,11308,0
28,"Mures",119527,261,119527,,"SANPETRU DE CAMPIE",579,"Scoala Generala Satu Nou nr.40",147,98,83,15,0,97,1,199,101,48,49,3,11308,0
28,"Mures",119527,261,119527,,"SANPETRU DE CAMPIE",580,"Caminul Cultural sat Singeorgiu de Cimpie nr. 68",297,178,170,8,0,173,5,402,224,97,76,3,11308,0
28,"Mures",119527,261,119527,,"SANPETRU DE CAMPIE",581,"Caminul Cultural Tusinu 29",484,209,205,4,0,204,5,600,391,115,89,3,11308,0
28,"Mures",119527,261,119527,,"SANPETRU DE CAMPIE",582,"Scoala Generala Sinpetru de Campie nr. 331",0,68,0,68,0,68,0,301,233,35,33,3,11308,1
28,"Mures",114453,261,114453,,"SANTANA DE MURES",583,"Scoala Generala Ion Chinezu, sat Sintana de Mures, str. Suseni nr. 81 - sala profesorala",1141,618,612,6,0,607,11,1191,573,365,242,3,11315,0
28,"Mures",114453,261,114453,,"SANTANA DE MURES",584,"Scoala Generala Ion Chinezu, sat Sintana de Mures, str. Suseni nr. 81 - sala gradinita A",1143,645,639,6,0,637,8,1201,556,379,258,3,11315,0
28,"Mures",114453,261,114453,,"SANTANA DE MURES",585,"Scoala Generala, sat Curteni str. Principala nr. 123 - sala de sport",794,374,362,12,0,363,11,904,530,168,195,3,11315,0
28,"Mures",114453,261,114453,,"SANTANA DE MURES",586,"Scoala Generala, sat Chinari str. Principala nr. 162 - sala de clasa A",525,255,247,8,0,251,4,600,345,165,86,3,11315,0
28,"Mures",114453,261,114453,,"SANTANA DE MURES",587,"Scoala Generala, sat Bardesti str. Scolii nr. 51- sala de clasa A",333,211,201,8,2,207,4,398,187,108,99,3,11315,0
28,"Mures",114453,261,114453,,"SANTANA DE MURES",588,"Scoala Generala Ion Chinezu, sat Sintana de Mures, str. Suseni nr. 81 - sala gradinita B",0,76,0,76,0,76,0,300,224,34,42,3,11315,1
28,"Mures",119590,261,119590,,"SOLOVASTRU",589,"Scoala Generala Solovastru, intrarea nr.1, prima sala de clasa de langa Sala profesorala",1375,823,810,6,7,811,12,1500,677,464,347,3,11336,0
28,"Mures",119590,261,119590,,"SOLOVASTRU",590,"Caminul Cultural Jabenita, nr.147, fosta Sala de Gradinita",960,595,578,3,14,593,2,1109,514,247,346,3,11336,0
28,"Mures",119590,261,119590,,"SOLOVASTRU",591,"Scoala Generala Solovastru, intrarea nr.2, prima sala de clasa",0,56,0,56,0,55,1,200,144,33,22,3,11336,1
28,"Mures",119625,261,119625,,"STANCENI",592,"Caminul Cultural Stinceni, Strada Principala, nr.38, sala mica",1238,699,698,1,0,692,7,1294,595,390,302,3,11339,0
28,"Mures",119625,261,119625,,"STANCENI",593,"Caminul Cultural comuna Stinceni, sala mare",0,46,0,46,0,46,0,100,54,22,24,3,11339,1
28,"Mures",119661,261,119661,,"SUPLAC",594,"Scoala Generala Suplac, Strada Principala nr.258,clasa 2-4",625,273,266,7,0,271,2,700,427,177,94,3,11343,0
28,"Mures",119661,261,119661,,"SUPLAC",595,"Scoala Generala ""Bordi Andras"", sat Idrifaia, Strada Principala nr.168,clasa 1-3",509,257,252,5,0,253,4,619,362,93,160,3,11343,0
28,"Mures",119661,261,119661,,"SUPLAC",596,"Scoala Generala ""Sf. Nicolae"", sat Laslau Mare, Strada Principala nr.176",346,202,197,5,0,199,3,400,198,100,99,3,11343,0
28,"Mures",119661,261,119661,,"SUPLAC",597,"Scoala Generala, sat Laslau Mic, Strada Principala nr.82",393,160,145,15,0,156,4,500,340,119,37,3,11343,0
28,"Mures",119661,261,119661,,"SUPLAC",598,"Sediul Primariei comunei Suplac, strada Principala nr. 238",0,65,0,65,0,65,0,200,135,41,24,3,11343,1
28,"Mures",119723,261,119723,,"SUSENI",599,"Scoala Generala Suseni nr. 451, sala 1",1284,576,553,10,13,569,7,1400,824,312,257,3,11349,0
28,"Mures",119723,261,119723,,"SUSENI",600,"Caminul Cultural Luieru nr. 83, sala mica",593,359,350,8,1,355,4,700,341,160,195,3,11349,0
28,"Mures",119723,261,119723,,"SUSENI",601,"Scoala Generala Suseni nr. 451, sala 2",0,31,0,31,0,31,0,100,69,23,8,3,11349,1
28,"Mures",119750,261,119750,,"SAULIA",602,"Caminul Cultural Saulia, Saulia, Strada Principala, nr.38",1604,883,868,6,9,876,7,1700,817,521,355,3,11326,0
28,"Mures",119750,261,119750,,"SAULIA",603,"Clubul Tineretului Saulia, Saulia, Strada Principala, nr.39",0,93,0,93,0,93,0,100,7,61,32,3,11326,1
28,"Mures",119803,261,119803,,"SINCAI",604,"Sediul Primariei comunei Sincai, sala de sedinta, sat Sincai nr.156",860,400,395,5,0,396,4,900,500,211,185,3,11331,0
28,"Mures",119803,261,119803,,"SINCAI",605,"Scoala Generala, sat Lechincioara f.n.",80,59,50,9,0,58,1,100,41,39,19,3,11331,0
28,"Mures",119803,261,119803,,"SINCAI",606,"Scoala Generala, sat Sincai Finate, f.n.",206,112,105,7,0,110,2,300,188,59,51,3,11331,0
28,"Mures",119803,261,119803,,"SINCAI",607,"Scoala Generala, sat Pusta f.n.",101,76,68,8,0,76,0,200,124,37,39,3,11331,0
28,"Mures",119803,261,119803,,"SINCAI",608,"Sediul Primariei comunei Sincai, Birou agricol, sat Sincai nr.156",0,41,0,41,0,39,2,102,61,22,17,3,11331,1
28,"Mures",119858,261,119858,,"TAURENI",609,"Sediul Primariei comunei Taureni, sat Taureni, nr.256, Sala de sedinte",774,555,522,6,27,528,27,902,347,155,373,3,11352,0
28,"Mures",119858,261,119858,,"TAURENI",610,"Scoala Generala Taureni, sat Taureni, nr.141, corp vechi - Laborator",0,54,0,54,0,54,0,100,46,17,37,3,11352,1
28,"Mures",119974,261,119974,,"VALEA LARGA",611,"Sediul Primariei comunei Valea Larga, nr.248 - Sala de sedinta",1354,546,544,1,1,541,5,1500,954,251,290,3,11356,0
28,"Mures",119974,261,119974,,"VALEA LARGA",612,"Caminul Cultural, sat Valea Larga nr.251",753,358,356,1,1,355,3,800,442,181,174,3,11356,0
28,"Mures",119974,261,119974,,"VALEA LARGA",613,"Scoala Generala, sat Valea Fratiei nr.3",513,243,233,10,0,242,1,600,357,146,96,3,11356,0
28,"Mures",119974,261,119974,,"VALEA LARGA",614,"Sediul Primariei Comunei Valea Larga, nr.248, Biroul Primarului",0,63,0,63,0,62,1,100,37,36,26,3,11356,1
28,"Mures",120076,261,120076,,"VARGATA",615,"Scoala Generala, sat Vargata, Strada Principala, nr.117, clasa nr. V",654,225,214,11,0,220,5,700,475,64,156,3,11372,0
28,"Mures",120076,261,120076,,"VARGATA",616,"Caminul Cultural, sat Griusorul, Strada Principala nr.106, sala mica",149,46,36,10,0,44,2,204,158,14,30,3,11372,0
28,"Mures",120076,261,120076,,"VARGATA",617,"Caminul Cultural, sat Vadu, Strada Principala nr.105, sala de spectacol",211,96,89,7,0,93,3,300,204,44,49,3,11372,0
28,"Mures",120076,261,120076,,"VARGATA",618,"Scoala Generala, sat Valea, Strada Belso nr.100, sala de clasa  I-III",538,191,183,8,0,188,3,600,409,69,119,3,11372,0
28,"Mures",120076,261,120076,,"VARGATA",619,"Sediul Primariei comunei Vargata, Strada Principala nr. 32, sala de sedinta",0,23,0,23,0,22,1,200,177,4,18,3,11372,1
28,"Mures",120138,261,120138,,"VATAVA",620,"Caminul Cultural, sat Vatava, nr.215",674,421,421,0,0,417,4,800,379,279,138,3,11378,0
28,"Mures",120138,261,120138,,"VATAVA",621,"Scoala Generala, sat Dumbrava, nr.185",601,381,373,6,2,379,2,700,319,153,226,3,11378,0
28,"Mures",120138,261,120138,,"VATAVA",622,"Scoala Generala, sat Ripa de Jos, nr.166",412,294,288,5,1,290,4,500,206,134,156,3,11378,0
28,"Mures",120138,261,120138,,"VATAVA",623,"Sediul Primariei comunei Vatava nr. 62",0,75,0,75,0,75,0,100,25,34,41,3,11378,1
28,"Mures",120174,261,120174,,"VETCA",624,"Caminul Cultural, sat Vetca, nr. 53, sala mica",444,120,120,0,0,115,5,500,380,41,74,3,11382,0
28,"Mures",120174,261,120174,,"VETCA",625,"Caminul Cultural, sat Jacodu, nr. 189",230,81,73,8,0,77,4,300,219,27,50,3,11382,0
28,"Mures",120174,261,120174,,"VETCA",626,"Caminul Cultural, sat Vetca, nr. 53, sala mare",0,27,0,27,0,26,1,100,73,9,17,3,11382,1
28,"Mures",120218,261,120218,,"VIISOARA",627,"Sediul Primariei comunei Viisoara, sala de sedinta, Strada Principala nr. 111",567,234,230,4,0,228,6,600,366,153,75,3,11386,0
28,"Mures",120218,261,120218,,"VIISOARA",628,"Scoala Generala, sat Sintioana, Strada Principala nr. 160",404,242,239,3,0,241,1,500,258,151,90,3,11386,0
28,"Mures",120218,261,120218,,"VIISOARA",629,"Caminul Cultural, sat Ormenis, Strada Principala nr. 106, sala mica",295,158,155,3,0,156,2,400,242,108,48,3,11386,0
28,"Mures",120218,261,120218,,"VIISOARA",630,"Sediul Primariei comunei Viisoara, Strada Principala nr. 111, biroul serviciului agricol",0,11,0,11,0,11,0,100,89,5,6,3,11386,1
28,"Mures",120254,261,120254,,"VANATORI",631,"Scoala Generala ""Petre N. Popescu"", sat Vinatori, Strada Principala nr.231",1340,599,589,10,0,587,12,1500,901,333,254,3,11366,0
28,"Mures",120254,261,120254,,"VANATORI",632,"Gradinita de Copii, sat Archita, Strada Principala nr.309",667,321,308,13,0,317,4,700,379,174,143,3,11366,0
28,"Mures",120254,261,120254,,"VANATORI",633,"Scoala Generala, sat Feleag, Strada Principala nr.175",174,116,106,10,0,116,0,207,91,65,51,3,11366,0
28,"Mures",120254,261,120254,,"VANATORI",634,"Scoala Generala I-IV, sat Mureni nr.47",275,128,118,10,0,126,2,300,172,63,63,3,11366,0
28,"Mures",120254,261,120254,,"VANATORI",635,"Scoala Generala I-IV, sat Soard nr.13",522,281,271,10,0,273,8,604,323,164,109,3,11366,0
28,"Mures",120254,261,120254,,"VANATORI",636,"Scoala Generala ""Petre N. Popescu"", sat Vinatori, Strada Principala nr.231",0,35,0,35,0,34,1,300,265,14,20,3,11366,1
28,"Mures",120316,261,120316,,"VOIVODENI",637,"Caminul Cultural, sat Voivodeni, nr.97,sala mica",1359,543,521,5,17,531,12,1500,957,266,265,3,11390,0
28,"Mures",120316,261,120316,,"VOIVODENI",638,"Caminul Cultural, sat Toldal, nr.50",199,106,95,9,2,106,0,298,192,41,65,3,11390,0
28,"Mures",120316,261,120316,,"VOIVODENI",639,"Caminul Cultural, sat Voivodeni, nr.97,sala mare",0,42,0,42,0,42,0,100,58,21,21,3,11390,1
28,"Mures",120343,261,120343,,"ZAGAR",640,"Sediul Primariei comunei Zagar, Strada Principala, nr. 266, birou asistenta sociala",1021,451,449,2,0,447,4,1095,644,295,152,3,11393,0
28,"Mures",120343,261,120343,,"ZAGAR",641,"Sediul Primariei comunei Zagar, Strada Principala, nr. 266, birou agent agricol",0,29,0,29,0,29,0,100,71,26,3,3,11393,1
28,"Mures",120370,261,120370,,"ZAU DE CAMPIE",642,"Caminul Cultural, sat Zau de Campie, Strada Trandafirilor nr. 1",999,404,390,9,5,400,4,1116,712,178,222,3,11396,0
28,"Mures",120370,261,120370,,"ZAU DE CAMPIE",643,"Scoala Generala cls. V-VIII, sat Zau de Campie, Strada Republicii nr. 58",1229,624,598,11,15,615,9,1299,675,247,368,3,11396,0
28,"Mures",120370,261,120370,,"ZAU DE CAMPIE",644,"Scoala Generala, sat Barbosi, nr. 47",426,176,166,10,0,174,2,500,324,69,105,3,11396,0
28,"Mures",120370,261,120370,,"ZAU DE CAMPIE",645,"Scoala Generala cls. I-IV, sat Zau de Campie, Strada Republicii nr. 41",0,54,0,54,0,52,2,100,46,23,29,3,11396,1
29,"Neamt",120726,270,120726,,"MUNICIPIUL PIATRA NEAMT",1,"Scoala nr.3, Piata 22 Decembrie, nr.1",1046,681,665,16,0,668,13,1097,416,337,331,1,11407,0
29,"Neamt",120726,270,120726,,"MUNICIPIUL PIATRA NEAMT",2,"Scoala nr.3, Piata 22 Decembrie, nr.1",1094,674,657,17,0,662,12,1201,527,307,355,1,11407,0
29,"Neamt",120726,270,120726,,"MUNICIPIUL PIATRA NEAMT",3,"Gradinita cu orar prelungit nr. 6, str. Cuza Voda,  nr. 80",1100,664,650,14,0,653,11,1200,536,301,352,1,11407,0
29,"Neamt",120726,270,120726,,"MUNICIPIUL PIATRA NEAMT",4,"Colegiul National  ""Petru Rares"", str. Stefan cel Mare, nr. 4",1447,778,760,18,0,767,11,1600,822,374,393,1,11407,0
29,"Neamt",120726,270,120726,,"MUNICIPIUL PIATRA NEAMT",5,"Scoala nr. 2, str. Maratei, nr. 4-6",1188,700,686,13,1,684,16,1300,600,327,357,1,11407,0
29,"Neamt",120726,270,120726,,"MUNICIPIUL PIATRA NEAMT",6,"Directia Agricola, str. Mihai  Eminescu, FN",1567,898,885,13,0,885,13,1700,802,424,461,1,11407,0
29,"Neamt",120726,270,120726,,"MUNICIPIUL PIATRA NEAMT",7,"Scoala nr. 3, Piata 22 Decembrie, nr.1",1269,684,665,18,1,673,11,1400,716,334,339,1,11407,0
29,"Neamt",120726,270,120726,,"MUNICIPIUL PIATRA NEAMT",8,"SC  APA SERV  SA, str. Lt. Draghiescu, nr.20",1269,731,718,12,1,718,13,1397,666,380,338,1,11407,0
29,"Neamt",120726,270,120726,,"MUNICIPIUL PIATRA NEAMT",9,"Complexul Expozitional Municipal, Bdul Republicii, nr.17, Bloc A1",1484,880,855,25,0,863,17,1600,720,436,427,1,11407,0
29,"Neamt",120726,270,120726,,"MUNICIPIUL PIATRA NEAMT",10,"Scoala Elena Cuza (fosta scoala nr.4), Bdul Decebal, nr. 72",1611,864,849,13,2,846,18,1700,836,478,368,1,11407,0
29,"Neamt",120726,270,120726,,"MUNICIPIUL PIATRA NEAMT",11,"Liceul de Arta - Corpul B, Bdul Decebal, nr. 48",1391,687,681,6,0,679,8,1500,813,376,303,1,11407,0
29,"Neamt",120726,270,120726,,"MUNICIPIUL PIATRA NEAMT",12,"Scoala nr.10, str. Ecoului, nr. 5",1378,683,671,11,1,671,12,1500,817,410,261,1,11407,0
29,"Neamt",120726,270,120726,,"MUNICIPIUL PIATRA NEAMT",13,"Scoala nr.10, str. Ecoului, nr. 5",1511,745,732,13,0,733,12,1600,855,388,345,1,11407,0
29,"Neamt",120726,270,120726,,"MUNICIPIUL PIATRA NEAMT",14,"Scoala nr.10, str. Ecoului, nr. 5",1357,660,656,4,0,648,12,1496,836,376,272,1,11407,0
29,"Neamt",120726,270,120726,,"MUNICIPIUL PIATRA NEAMT",15,"Scoala nr.10, str. Ecoului, nr. 5",1547,759,749,9,1,744,15,1700,941,482,262,1,11407,0
29,"Neamt",120726,270,120726,,"MUNICIPIUL PIATRA NEAMT",16,"Scoala nr. 10, str. Ecoului, nr.5",1543,734,725,9,0,723,11,1700,966,401,322,1,11407,0
29,"Neamt",120726,270,120726,,"MUNICIPIUL PIATRA NEAMT",17,"Scoala nr. 10, str. Ecoului, nr.5",1514,762,751,11,0,751,11,1600,838,409,342,1,11407,0
29,"Neamt",120726,270,120726,,"MUNICIPIUL PIATRA NEAMT",18,"Casa Corpului Didactic, str. Petru Movila, nr. 67",1312,809,795,14,0,800,9,1389,580,432,368,1,11407,0
29,"Neamt",120726,270,120726,,"MUNICIPIUL PIATRA NEAMT",19,"Scoala ""Elena Cuza"" (fosta Scoala nr.4 - sediul principal), Bdul Decebal, nr. 72",1554,892,872,19,1,873,19,1700,808,444,429,1,11407,0
29,"Neamt",120726,270,120726,,"MUNICIPIUL PIATRA NEAMT",20,"Grupul Scolar Industrial de Transporturi Auto (fostul Liceu Auto), str. Soarelui, nr. 1",1251,639,605,10,24,627,12,1400,761,340,287,1,11407,0
29,"Neamt",120726,270,120726,,"MUNICIPIUL PIATRA NEAMT",21,"Colegiul Tehnic Forestier, str. Stefan cel Mare nr. 67",1395,766,753,12,1,751,15,1500,734,418,333,1,11407,0
29,"Neamt",120726,270,120726,,"MUNICIPIUL PIATRA NEAMT",22,"Grupul Scolar Economic Administrativ, str. Alexandru Lapusneanu, nr.16",1529,818,802,15,1,810,8,1600,782,473,337,1,11407,0
29,"Neamt",120726,270,120726,,"MUNICIPIUL PIATRA NEAMT",23,"Colegiul Tehnic (Forestier), str. Stefan cel Mare, nr.67",1398,810,798,12,0,797,13,1500,690,474,323,1,11407,0
29,"Neamt",120726,270,120726,,"MUNICIPIUL PIATRA NEAMT",24,"Liceul Teoretic ""Calistrat Hogas"", str. Alexandru cel Bun, nr.19",1023,615,607,7,1,604,11,1095,480,344,260,1,11407,0
29,"Neamt",120726,270,120726,,"MUNICIPIUL PIATRA NEAMT",25,"Liceul comercial  ""Spiru Haret"" (fosta scoala nr.12), str. Petru Rares, nr.26",1450,799,785,14,0,782,17,1600,801,432,350,1,11407,0
29,"Neamt",120726,270,120726,,"MUNICIPIUL PIATRA NEAMT",26,"Liceul comercial  ""Spiru Haret"" (fosta scoala nr.12), str. Petru Rares, nr.26",1258,713,695,16,2,702,11,1300,587,364,338,1,11407,0
29,"Neamt",120726,270,120726,,"MUNICIPIUL PIATRA NEAMT",27,"Gradinita cu program prelungit nr. 3, Bdul Dacia, nr.14",1209,631,621,8,2,618,13,1300,669,339,279,1,11407,0
29,"Neamt",120726,270,120726,,"MUNICIPIUL PIATRA NEAMT",28,"Liceul cu Program Sportiv, str. Obor, nr.2",1395,746,735,11,0,729,17,1498,752,413,316,1,11407,0
29,"Neamt",120726,270,120726,,"MUNICIPIUL PIATRA NEAMT",29,"Liceul cu Program Sportiv, str. Obor, nr.2",1313,690,678,12,0,672,18,1416,726,367,305,1,11407,0
29,"Neamt",120726,270,120726,,"MUNICIPIUL PIATRA NEAMT",30,"Scoala nr.8, str. Darmanesti, nr.33",1454,747,730,17,0,740,7,1600,853,393,347,1,11407,0
29,"Neamt",120726,270,120726,,"MUNICIPIUL PIATRA NEAMT",31,"Gradinita cuplata cu cresa nr.5, str. Darmanesti, nr. 42",1563,777,769,8,0,767,10,1700,923,435,332,1,11407,0
29,"Neamt",120726,270,120726,,"MUNICIPIUL PIATRA NEAMT",32,"Gradinita cu program normal nr.8, str. Darmanesti, nr. 41",944,483,472,11,0,477,6,1010,527,272,205,1,11407,0
29,"Neamt",120726,270,120726,,"MUNICIPIUL PIATRA NEAMT",33,"Gradinita cuplata cu cresa  nr.5, str. Darmanesti, nr. 42",1048,511,493,18,0,501,10,1121,610,301,200,1,11407,0
29,"Neamt",120726,270,120726,,"MUNICIPIUL PIATRA NEAMT",34,"Scoala nr. 11 - corp B (Fosta Scoala nr. 20), str. Cetatea Neamtului, FN",1679,988,978,8,2,971,17,1800,812,560,411,1,11407,0
29,"Neamt",120726,270,120726,,"MUNICIPIUL PIATRA NEAMT",35,"ASE Bucuresti, str. Gavril Galinescu, nr.13",1655,768,750,18,0,755,13,1800,1032,455,300,1,11407,0
29,"Neamt",120726,270,120726,,"MUNICIPIUL PIATRA NEAMT",36,"Scoala nr.11, str. Gavril Galinescu, nr.13",1557,723,697,25,1,717,6,1701,978,404,313,1,11407,0
29,"Neamt",120726,270,120726,,"MUNICIPIUL PIATRA NEAMT",37,"Liceul Pedagogic ""Gheorghe Asachi"", str. Audia, nr. 3",1092,431,419,12,0,423,8,1200,769,257,166,1,11407,0
29,"Neamt",120726,270,120726,,"MUNICIPIUL PIATRA NEAMT",38,"Liceul Pedagogic ""Gheorghe Asachi"" , str. Audia, nr. 3",1042,471,457,13,1,464,7,1092,621,284,180,1,11407,0
29,"Neamt",120726,270,120726,,"MUNICIPIUL PIATRA NEAMT",39,"Scoala nr.5, str. 1 Decembrie 1918, nr.32",1647,816,799,17,0,805,11,1800,984,437,368,1,11407,0
29,"Neamt",120726,270,120726,,"MUNICIPIUL PIATRA NEAMT",40,"Scoala nr.5, str. 1 Decembrie 1918, nr.32",1592,889,873,16,0,877,12,1700,811,485,392,1,11407,0
29,"Neamt",120726,270,120726,,"MUNICIPIUL PIATRA NEAMT",41,"Gradinita cuplata cu cresa nr. 12, Aleea Constantin Matase,  nr. 9",1438,719,706,13,0,709,10,1500,781,379,330,1,11407,0
29,"Neamt",120726,270,120726,,"MUNICIPIUL PIATRA NEAMT",42,"Gradinita cuplata cu cresa nr. 12, Aleea Constantin Matase,  nr. 9",1436,714,702,12,0,704,10,1500,786,389,315,1,11407,0
29,"Neamt",120726,270,120726,,"MUNICIPIUL PIATRA NEAMT",43,"Gradinita cuplata cu cresa nr. 12, Aleea Constantin Matase,  nr. 9",1465,738,724,14,0,725,13,1601,863,400,325,1,11407,0
29,"Neamt",120726,270,120726,,"MUNICIPIUL PIATRA NEAMT",44,"Scoala nr.8, str. Darmanesti, nr.33",1683,893,877,16,0,879,14,1800,907,462,417,1,11407,0
29,"Neamt",120726,270,120726,,"MUNICIPIUL PIATRA NEAMT",45,"Centrul social ""PIETRICICA"" - Cantina sociala,  str. Mihai Viteazu, nr.35, bl.C4",1580,855,840,15,0,839,16,1700,845,439,400,1,11407,0
29,"Neamt",120726,270,120726,,"MUNICIPIUL PIATRA NEAMT",46,"Liceul de Informatica,  Str. Mihai Viteazu, nr. 12",902,436,423,11,2,431,5,1000,564,251,180,1,11407,0
29,"Neamt",120726,270,120726,,"MUNICIPIUL PIATRA NEAMT",47,"Centrul Social ""PIETRICICA"" - Caminul pentru persoane varstnice, str. Nufarului, nr.10",1772,980,906,74,0,961,19,1900,920,532,429,1,11407,0
29,"Neamt",120726,270,120726,,"MUNICIPIUL PIATRA NEAMT",48,"Liceul de Informatica,  str. Mihai Viteazu, nr. 12",1410,681,671,10,0,668,13,1500,819,365,303,1,11407,0
29,"Neamt",120726,270,120726,,"MUNICIPIUL PIATRA NEAMT",49,"Liceul de Informatica,  str. Mihai Viteazu, nr. 12",1446,788,777,11,0,770,18,1600,812,425,345,1,11407,0
29,"Neamt",120726,270,120726,,"MUNICIPIUL PIATRA NEAMT",50,"Liceul de Informatica,  str. Mihai Viteazu, nr. 12",1142,457,447,10,0,453,4,1200,743,307,146,1,11407,0
29,"Neamt",120726,270,120726,,"MUNICIPIUL PIATRA NEAMT",51,"Liceul de Informatica,  str. Mihai Viteazu, nr. 12",1044,531,519,12,0,519,12,1100,569,287,232,1,11407,0
29,"Neamt",120726,270,120726,,"MUNICIPIUL PIATRA NEAMT",52,"Scoala nr.2, str. Maratei, nr. 46",1320,699,688,11,0,686,13,1409,710,363,323,1,11407,0
29,"Neamt",120726,270,120726,,"MUNICIPIUL PIATRA NEAMT",53,"Scoala nr.2, str. Maratei, nr. 46",1001,552,545,7,0,544,8,1100,548,308,236,1,11407,0
29,"Neamt",120726,270,120726,,"MUNICIPIUL PIATRA NEAMT",54,"Scoala nr.2, str. Maratei, nr. 46",960,547,531,16,0,542,5,992,445,268,274,1,11407,0
29,"Neamt",120726,270,120726,,"MUNICIPIUL PIATRA NEAMT",55,"Scoala nr.2, str. Maratei, nr. 46",1473,813,795,18,0,800,13,1600,787,418,382,1,11407,0
29,"Neamt",120726,270,120726,,"MUNICIPIUL PIATRA NEAMT",56,"Grupul Scolar ""Gheorghe Cartianu"", Bdul Traian, nr. 165",1549,859,848,9,2,844,15,1700,841,401,443,1,11407,0
29,"Neamt",120726,270,120726,,"MUNICIPIUL PIATRA NEAMT",57,"Grupul Scolar ""Gheorghe Cartianu"", Bdul Traian, nr. 165",986,534,524,10,0,527,7,1100,566,288,239,1,11407,0
29,"Neamt",120726,270,120726,,"MUNICIPIUL PIATRA NEAMT",58,"Grupul Scolar ""Gheorghe Cartianu"", Bdul Traian, nr. 165",1364,783,770,13,0,769,14,1500,717,368,401,1,11407,0
29,"Neamt",120726,270,120726,,"MUNICIPIUL PIATRA NEAMT",59,"Grupul Scolar ""Gheorghe Cartianu"", Bdul Traian, nr. 165",1508,659,648,11,0,648,11,1600,941,374,274,1,11407,0
29,"Neamt",120726,270,120726,,"MUNICIPIUL PIATRA NEAMT",60,"Scoala nr. 1, str. G-ral Nicolae Dascalescu, nr. 4",1730,828,818,9,1,818,10,1900,1072,504,314,1,11407,0
29,"Neamt",120726,270,120726,,"MUNICIPIUL PIATRA NEAMT",61,"Gradinita nr.19, str. Ion Ionescu  de la Brad, nr. 13",660,376,368,8,0,376,0,700,324,229,147,1,11407,0
29,"Neamt",120726,270,120726,,"MUNICIPIUL PIATRA NEAMT",62,"Grupul Scolar nr.9 (fosta scoala nr. 9), Bdul  Marasesti, nr.13",1443,797,785,12,0,781,16,1500,703,468,313,1,11407,0
29,"Neamt",120726,270,120726,,"MUNICIPIUL PIATRA NEAMT",63,"Grupul Scolar nr.9 (fosta scoala nr. 9) - Corp A, Bdul  Marasesti, nr.13",1260,743,733,10,0,724,19,1400,657,407,317,1,11407,0
29,"Neamt",120726,270,120726,,"MUNICIPIUL PIATRA NEAMT",64,"Grupul Scolar nr. 9 - Corp B (fosta Scoala Profesionala nr. 1), str. G-ral Nicolae Dascalescu, nr. 426",1122,596,589,7,0,586,10,1200,604,347,239,1,11407,0
29,"Neamt",120726,270,120726,,"MUNICIPIUL PIATRA NEAMT",65,"Scoala ""Daniela Cuciuc"" (fosta Scoala nr. 6), str. Progresului, nr. 108",1880,842,822,18,2,826,16,1989,1147,498,328,1,11407,0
29,"Neamt",120726,270,120726,,"MUNICIPIUL PIATRA NEAMT",66,"Scoala ""Daniela Cuciuc"" (fosta Scoala nr. 6), str. Progresului, nr. 108",1673,792,746,46,0,785,7,1800,1008,491,294,1,11407,0
29,"Neamt",120726,270,120726,,"MUNICIPIUL PIATRA NEAMT",67,"Scoala ""Daniela Cuciuc"" (fosta Scoala nr. 6), str. Progresului, nr. 108",1066,537,524,13,0,526,11,1201,664,306,220,1,11407,0
29,"Neamt",120726,270,120726,,"MUNICIPIUL PIATRA NEAMT",68,"Scoala ""Daniela Cuciuc"" (fosta Scoala nr. 6), str. Progresului, nr. 108",1287,695,679,16,0,687,8,1400,705,375,312,1,11407,0
29,"Neamt",120726,270,120726,,"MUNICIPIUL PIATRA NEAMT",69,"Scoala ""Daniela Cuciuc"" (fosta Scoala nr. 6), str. Progresului, nr. 108",1052,603,589,13,1,595,8,1091,488,308,287,1,11407,0
29,"Neamt",120726,270,120726,,"MUNICIPIUL PIATRA NEAMT",70,"Gradinita nr. 7 ""Floare de colt"", str. Progresului, nr. 31",1645,812,804,8,0,793,19,1800,988,446,347,1,11407,0
29,"Neamt",120726,270,120726,,"MUNICIPIUL PIATRA NEAMT",71,"Gradinita nr. 7 ""Floare de colt"", str. Progresului, nr. 31",1393,716,706,10,0,707,9,1500,784,361,346,1,11407,0
29,"Neamt",120726,270,120726,,"MUNICIPIUL PIATRA NEAMT",72,"Gradinita nr. 1, Aleea Plaiului, nr. 7A",1374,945,927,18,0,927,18,1800,855,509,418,1,11407,0
29,"Neamt",120726,270,120726,,"MUNICIPIUL PIATRA NEAMT",73,"Scoala nr. 7, str. Gheorghe Asachi, nr. 27",1187,641,629,12,0,629,12,1300,659,346,283,1,11407,0
29,"Neamt",120726,270,120726,,"MUNICIPIUL PIATRA NEAMT",74,"Centrul Social - Cartier Speranta",843,530,505,25,0,518,12,904,374,335,183,1,11407,0
29,"Neamt",120726,270,120726,,"MUNICIPIUL PIATRA NEAMT",75,"Scoala nr. 17,  Aleea Tineretului, nr. 7",712,382,368,11,3,375,7,811,429,209,166,1,11407,0
29,"Neamt",120726,270,120726,,"MUNICIPIUL PIATRA NEAMT",76,"Statia CFR, Piata Garii, Nr. 1",0,1069,0,1069,0,1055,14,1201,132,630,425,1,11407,1
29,"Neamt",120726,270,120726,,"MUNICIPIUL PIATRA NEAMT",77,"Spitalul judetean de urgenta, Bdul Traian, Nr. 1-3",0,407,0,407,0,402,5,495,88,228,174,1,11407,1
29,"Neamt",120860,270,120860,,"MUNICIPIUL ROMAN",78,"Casa de cultura, Piata Roman Voda, nr.5",1384,700,694,6,0,695,5,1500,800,352,343,1,11412,0
29,"Neamt",120860,270,120860,,"MUNICIPIUL ROMAN",79,"Casa casatoriilor, str. Constantin Dobrogeanu Gherea, nr. 39",1389,837,829,8,0,831,6,1499,662,364,467,1,11412,0
29,"Neamt",120860,270,120860,,"MUNICIPIUL ROMAN",80,"Gradinita de copii nr. 6 cu program prelungit, str. Roman Voda, nr. 4",1349,755,746,9,0,742,13,1400,645,335,407,1,11412,0
29,"Neamt",120860,270,120860,,"MUNICIPIUL ROMAN",81,"Scoala nr.8, str. Mihai Viteazu, nr.15",1522,738,728,10,0,735,3,1600,862,383,352,1,11412,0
29,"Neamt",120860,270,120860,,"MUNICIPIUL ROMAN",82,"Scoala nr.8, str. Mihai Viteazu, nr.15",1251,530,517,11,2,515,15,1300,770,312,203,1,11412,0
29,"Neamt",120860,270,120860,,"MUNICIPIUL ROMAN",83,"Scoala nr.8, str. Mihai Viteazu, nr.15",1466,616,603,13,0,613,3,1600,984,374,239,1,11412,0
29,"Neamt",120860,270,120860,,"MUNICIPIUL ROMAN",84,"Gradinita ""Miron Costin"" cu program normal, str. Anton Pann, nr. 30A",1436,601,591,9,1,599,2,1492,891,362,237,1,11412,0
29,"Neamt",120860,270,120860,,"MUNICIPIUL ROMAN",85,"Agentia pentru Protectia Mediului, Aleea Revolutiei, bl. 17, sc D, ap. 64",1418,609,602,7,0,597,12,1500,891,313,284,1,11412,0
29,"Neamt",120860,270,120860,,"MUNICIPIUL ROMAN",86,"Gradinita de copii nr.6 cu program normal, str. Primaverii, nr. 4",1419,758,740,17,1,744,14,1500,742,417,327,1,11412,0
29,"Neamt",120860,270,120860,,"MUNICIPIUL ROMAN",87,"Grup Scolar Industrial  ""Vasile Sav"",  Bdul Republicii, nr. 46",1182,589,585,4,0,584,5,1300,711,253,331,1,11412,0
29,"Neamt",120860,270,120860,,"MUNICIPIUL ROMAN",88,"Grup Scolar Industrial ""Vasile Sav"",  Bdul Republicii, nr. 46",1221,567,559,8,0,554,13,1300,733,286,268,1,11412,0
29,"Neamt",120860,270,120860,,"MUNICIPIUL ROMAN",89,"Compartiment Ajutor Social, str. Pacii, nr. 56",1258,623,612,11,0,603,20,1400,777,348,255,1,11412,0
29,"Neamt",120860,270,120860,,"MUNICIPIUL ROMAN",90,"Gradinita de copii nr.10 cu program normal, str.  Bogdan Dragos, nr. 183",1402,742,728,14,0,730,12,1500,758,363,367,1,11412,0
29,"Neamt",120860,270,120860,,"MUNICIPIUL ROMAN",91,"Scoala nr. 6, str. Bogdan Dragos, nr. 183",1382,776,764,12,0,766,10,1497,721,398,368,1,11412,0
29,"Neamt",120860,270,120860,,"MUNICIPIUL ROMAN",92,"Scoala nr.7, str.  Bogdan Dragos, nr. 91",1491,698,684,13,1,686,12,1600,902,328,358,1,11412,0
29,"Neamt",120860,270,120860,,"MUNICIPIUL ROMAN",93,"Scoala nr.7, str.  Bogdan Dragos, nr. 91",1551,735,723,12,0,732,3,1700,965,362,370,1,11412,0
29,"Neamt",120860,270,120860,,"MUNICIPIUL ROMAN",94,"Scoala de arta, str.  Bogdan Dragos, nr. 91",1513,765,755,10,0,756,9,1600,835,341,415,1,11412,0
29,"Neamt",120860,270,120860,,"MUNICIPIUL ROMAN",95,"Gradinita de copii nr. 4 cu program normal, str.  Ecaterina Teodoroiu, nr. 4",1553,746,736,9,1,736,10,1700,954,351,385,1,11412,0
29,"Neamt",120860,270,120860,,"MUNICIPIUL ROMAN",96,"Gradinita de copii nr. 5 cu program prelungit, str. Ecaterina Teodoraiu, nr. 1A",1622,887,874,11,2,876,11,1801,914,380,496,1,11412,0
29,"Neamt",120860,270,120860,,"MUNICIPIUL ROMAN",97,"Cresa Smirodava, str. Smirodava, nr. 28",1584,727,715,12,0,712,15,1700,973,368,344,1,11412,0
29,"Neamt",120860,270,120860,,"MUNICIPIUL ROMAN",98,"Gradinita de copii nr. 1 cu program prelungit, str. Ion Creanga, nr. 13",1572,742,734,8,0,734,8,1700,958,376,358,1,11412,0
29,"Neamt",120860,270,120860,,"MUNICIPIUL ROMAN",99,"Gradinita de copii nr. 1 cu program prelungit, str. Ion Creanga, nr. 13",1573,709,10,699,0,706,3,1700,991,348,358,1,11412,0
29,"Neamt",120860,270,120860,,"MUNICIPIUL ROMAN",100,"Scoala nr. 4, str. Mihai Eminescu, nr. 27",1544,830,818,12,0,819,11,1701,871,417,402,1,11412,0
29,"Neamt",120860,270,120860,,"MUNICIPIUL ROMAN",101,"Colegiul Tehnic ""Miron Costin"", str. Mihai Eminescu, nr. 5-7",1438,578,567,11,0,573,5,1500,922,349,224,1,11412,0
29,"Neamt",120860,270,120860,,"MUNICIPIUL ROMAN",102,"Colegiul National ""Roman Voda"", str. Mihai Eminescu, nr. 4",1271,577,571,6,0,569,8,1400,823,268,301,1,11412,0
29,"Neamt",120860,270,120860,,"MUNICIPIUL ROMAN",103,"Scoala nr.1 - local vechi, str. C.A. Rosetti, nr. 8",1468,746,736,8,2,737,9,1600,854,360,377,1,11412,0
29,"Neamt",120860,270,120860,,"MUNICIPIUL ROMAN",104,"Scoala nr.1 - local nou , str. C.A. Rosetti, nr. 8",1622,741,729,12,0,728,13,1700,959,382,346,1,11412,0
29,"Neamt",120860,270,120860,,"MUNICIPIUL ROMAN",105,"Centrul de ingrijire si asistenta batrani (dispensar 7), str. Bogdan Dragos, nr. 1",1528,881,865,16,0,871,10,1700,819,422,449,1,11412,0
29,"Neamt",120860,270,120860,,"MUNICIPIUL ROMAN",106,"Biblioteca Municipala Roman, str.  Nicolae Titulescu, nr. 5",1335,736,694,42,0,726,10,1500,764,351,375,1,11412,0
29,"Neamt",120860,270,120860,,"MUNICIPIUL ROMAN",107,"Seminarul Teologic ""Sf.Gheorghe"", str.  Alexandru cel Bun, nr. 2",1577,690,681,9,0,677,13,1700,1010,375,302,1,11412,0
29,"Neamt",120860,270,120860,,"MUNICIPIUL ROMAN",108,"Scoala nr.9, str.  Victor Hugo, nr. 9",1606,677,659,18,0,665,12,1700,1023,370,295,1,11412,0
29,"Neamt",120860,270,120860,,"MUNICIPIUL ROMAN",109,"Scoala nr.9, str.  Victor Hugo, nr. 9",1620,679,668,10,1,667,12,1700,1021,354,313,1,11412,0
29,"Neamt",120860,270,120860,,"MUNICIPIUL ROMAN",110,"Complex Servicii Sociale Integrate, str. Sucedava, nr. 3",1575,690,650,40,0,685,5,1700,1010,372,313,1,11412,0
29,"Neamt",120860,270,120860,,"MUNICIPIUL ROMAN",111,"Gradinita de copii nr. 5 cu program normal,  str.  Ion Ionescu de la Brad, nr. 5",1589,703,689,14,0,693,10,1701,998,343,350,1,11412,0
29,"Neamt",120860,270,120860,,"MUNICIPIUL ROMAN",112,"Scoala nr.2 - local vechi, str. Petru Rares, nr. 1",1062,474,462,11,1,469,5,1200,726,251,218,1,11412,0
29,"Neamt",120860,270,120860,,"MUNICIPIUL ROMAN",113,"Scoala nr.2 - local nou, str. Petru Rares, nr. 1",1505,751,739,11,1,739,12,1600,849,384,355,1,11412,0
29,"Neamt",120860,270,120860,,"MUNICIPIUL ROMAN",114,"Colegiul tehnic ""Petru Poni"", Bdul Republicii, nr. 1/3",1416,662,652,9,1,645,17,1500,838,371,274,1,11412,0
29,"Neamt",120860,270,120860,,"MUNICIPIUL ROMAN",115,"Scoala nr.3, str. Cuza Voda, nr. 82",1586,787,778,9,0,772,15,1710,923,353,419,1,11412,0
29,"Neamt",120860,270,120860,,"MUNICIPIUL ROMAN",116,"Scoala nr.5, str. Cuza Voda, nr. 34",1619,749,740,9,0,742,7,1700,951,364,378,1,11412,0
29,"Neamt",120860,270,120860,,"MUNICIPIUL ROMAN",117,"Scoala nr.5, str. Cuza Voda, nr. 34",1512,689,677,12,0,675,14,1601,912,356,319,1,11412,0
29,"Neamt",120860,270,120860,,"MUNICIPIUL ROMAN",118,"Gradinita de copii nr. 3 cu program prelungit, str. Cuza Voda",1453,717,710,7,0,704,13,1600,883,350,354,1,11412,0
29,"Neamt",120860,270,120860,,"MUNICIPIUL ROMAN",119,"Gradinita de copii nr. 12 cu program normal, str. Cuza Voda, nr. 17",1498,687,673,13,1,680,7,1600,913,342,338,1,11412,0
29,"Neamt",120860,270,120860,,"MUNICIPIUL ROMAN",120,"Colegiul tehnic ""Danubiana"", str. Energiei, nr. 9",1345,670,657,13,0,666,4,1500,830,395,271,1,11412,0
29,"Neamt",120860,270,120860,,"MUNICIPIUL ROMAN",121,"Autogara Roman, str. Mihai Viteazu, nr. 1",0,729,0,729,0,722,7,900,171,442,280,1,11412,1
29,"Neamt",120860,270,120860,,"MUNICIPIUL ROMAN",122,"Spitalul municipal de urgenta Roman, str. Tineretului, nr. 28",0,342,0,342,0,333,9,407,65,165,168,1,11412,1
29,"Neamt",120968,270,120968,,"ORAS BICAZ",123,"Parter bloc ANL, str. Piatra Corbului, FN, sala 1",1288,699,692,7,0,686,13,1399,700,350,336,1,11414,0
29,"Neamt",120968,270,120968,,"ORAS BICAZ",124,"Scoala generala Marceni, str. Marceni, nr. 1",852,470,461,8,1,464,6,887,417,216,248,1,11414,0
29,"Neamt",120968,270,120968,,"ORAS BICAZ",125,"Gradinita Marceni, str. Primaverii, nr. 12",1295,683,675,8,0,670,13,1400,717,359,311,1,11414,0
29,"Neamt",120968,270,120968,,"ORAS BICAZ",126,"Grupul Scolar, str. Republicii, nr. 21",1086,610,601,9,0,607,3,1215,605,321,286,1,11414,0
29,"Neamt",120968,270,120968,,"ORAS BICAZ",127,"Scoala generala Dodeni, sala nr. 1, str. Paltinis, nr. 8",1104,527,518,9,0,520,7,1200,673,282,238,1,11414,0
29,"Neamt",120968,270,120968,,"ORAS BICAZ",128,"Scoala generala Dodeni, sala nr. 2, str. Paltinis, nr. 8",1000,430,423,7,0,425,5,1100,670,221,204,1,11414,0
29,"Neamt",120968,270,120968,,"ORAS BICAZ",129,"Scoala cu clasele I-IV",397,225,215,9,1,221,4,494,269,128,93,1,11414,0
29,"Neamt",120968,270,120968,,"ORAS BICAZ",130,"Scoala cu clasele I-IV",177,103,95,8,0,99,4,201,98,44,55,1,11414,0
29,"Neamt",120968,270,120968,,"ORAS BICAZ",131,"Scoala cu clasele I-IV",219,128,120,8,0,125,3,300,172,59,66,1,11414,0
29,"Neamt",120968,270,120968,,"ORAS BICAZ",132,"Scoala cu clasele I-IV",64,58,48,10,0,57,1,100,42,27,30,1,11414,0
29,"Neamt",120968,270,120968,,"ORAS BICAZ",133,"Parter bloc ANL, sala 2, str. Piatra Corbului, FN",0,138,0,138,0,137,1,200,62,71,66,1,11414,1
29,"Neamt",120968,270,120968,,"ORAS BICAZ",134,"Spitalul orasanesc, incinta Policlinicii, etaj 1 (fosta magazie), str. Barajului, nr. 31",0,49,0,49,0,48,1,102,53,28,20,1,11414,1
29,"Neamt",124117,270,124117,,"ORAS ROZNOV",135,"Scoala Generala  Roznov",1721,813,774,39,0,805,8,1800,987,434,371,1,11422,0
29,"Neamt",124117,270,124117,,"ORAS ROZNOV",136,"Gara Roznov",1373,774,727,47,0,758,16,1500,726,417,341,1,11422,0
29,"Neamt",124117,270,124117,,"ORAS ROZNOV",137,"Stadion Roznov",1146,705,631,74,0,693,12,1200,495,410,283,1,11422,0
29,"Neamt",124117,270,124117,,"ORAS ROZNOV",138,"Scoala generala  Chintinici",929,515,481,34,0,505,10,1000,485,285,220,1,11422,0
29,"Neamt",124117,270,124117,,"ORAS ROZNOV",139,"Dispensarul Medical Slobozia",1400,806,735,71,0,796,10,1500,694,521,275,1,11422,0
29,"Neamt",124117,270,124117,,"ORAS ROZNOV",140,"Scoala generala Slobozia",1246,766,671,95,0,757,9,1300,534,506,251,1,11422,0
29,"Neamt",124117,270,124117,,"ORAS ROZNOV",141,"Liceul Roznov, str. Tineretului, nr. 648",0,323,0,323,0,321,2,350,27,184,137,1,11422,1
29,"Neamt",121055,270,121055,,"ORAS TARGU NEAMT",142,"Gradinita nr.  2, str. Stefan cel Mare, nr. 24",1346,823,814,9,0,806,17,1401,578,395,411,1,11426,0
29,"Neamt",121055,270,121055,,"ORAS TARGU NEAMT",143,"Scoala generala nr.2 ""Grigore Ghica Voda"", str. Stefan cel Mare, nr. 30",1852,964,941,23,0,946,18,2000,1036,387,559,1,11426,0
29,"Neamt",121055,270,121055,,"ORAS TARGU NEAMT",144,"Scoala generala nr.1 ""Vasile Conta"", str. Radu Teoharie, nr. 3",1772,880,864,16,0,868,12,1905,1025,372,496,1,11426,0
29,"Neamt",121055,270,121055,,"ORAS TARGU NEAMT",145,"Colegiul National  ""Stefan cel Mare"" corp B-Scoala Generala ""Mihail  Kogalniceanu"", str. Stefan cel Mare, nr. 52",1871,913,898,15,0,893,20,2000,1087,374,519,1,11426,0
29,"Neamt",121055,270,121055,,"ORAS TARGU NEAMT",146,"Casa Culturii ""Ion Creanga"", str. Stefan cel Mare,  nr.55",1815,1022,1001,21,0,1009,13,2000,978,395,614,1,11426,0
29,"Neamt",121055,270,121055,,"ORAS TARGU NEAMT",147,"Clubul Copiilor si Elevilor, str. Marasesti, nr. 101",1863,980,969,11,0,964,16,1999,1019,398,566,1,11426,0
29,"Neamt",121055,270,121055,,"ORAS TARGU NEAMT",148,"Colegiul National  ""Stefan cel Mare"", str. Stefan cel Mare, nr. 67",1865,1080,1064,16,0,1060,20,2000,920,447,613,1,11426,0
29,"Neamt",121055,270,121055,,"ORAS TARGU NEAMT",149,"Colegiul Tehnic  ""Ion Creanga"" corp B, str. Stefan cel Mare, nr. 147",1583,894,856,38,0,880,14,1697,803,332,548,1,11426,0
29,"Neamt",121055,270,121055,,"ORAS TARGU NEAMT",150,"Colegiul Tehnic  ""Ion Creanga"" corp C, str. Vanatorului, nr. 26",677,417,407,10,0,407,10,696,279,221,186,1,11426,0
29,"Neamt",121055,270,121055,,"ORAS TARGU NEAMT",151,"Scoala generala nr.3 ""Ion Creanga"" corpul B - Humulesti , str. Mihail Sadoveanu, nr. 20",1515,814,804,10,0,803,11,1600,786,362,441,1,11426,0
29,"Neamt",121055,270,121055,,"ORAS TARGU NEAMT",152,"Scoala generala nr.3 ""Ion Creanga"" corpul A - Humulesti , str. Mihail Sadoveanu, nr. 20",1665,907,894,13,0,894,13,1800,893,322,572,1,11426,0
29,"Neamt",121055,270,121055,,"ORAS TARGU NEAMT",153,"Scoala generala nr.5  , str. Hangului, nr. 2",425,267,244,23,0,261,6,506,239,114,147,1,11426,0
29,"Neamt",121055,270,121055,,"ORAS TARGU NEAMT",154,"Spitalul orasanesc, Str. Stefan cel Mare, nr. 35",0,141,0,141,0,138,3,202,61,53,85,1,11426,1
29,"Neamt",121055,270,121055,,"ORAS TARGU NEAMT",155,"Clubul Sportiv Scolar, Str. Stefan cel Mare, nr. 80",0,285,0,285,0,279,6,303,18,152,127,1,11426,1
29,"Neamt",121108,270,121108,,"AGAPIA",156,"Scoala veche, sala 1",1526,694,670,24,0,675,19,1600,906,244,431,3,11431,0
29,"Neamt",121108,270,121108,,"AGAPIA",157,"Scoala veche",861,573,546,27,0,565,8,900,327,256,309,3,11431,0
29,"Neamt",121108,270,121108,,"AGAPIA",158,"Scoala veche",507,269,251,17,1,264,5,600,331,115,149,3,11431,0
29,"Neamt",121108,270,121108,,"AGAPIA",159,"Scoala noua",736,366,351,12,3,345,21,800,434,167,178,3,11431,0
29,"Neamt",121108,270,121108,,"AGAPIA",160,"Scoala veche Agapia, Sala nr. 2",0,97,0,97,0,94,3,100,3,49,45,3,11431,1
29,"Neamt",124938,270,124938,,"ALEXANDRU CEL BUN",161,"Scoala veche",789,385,378,7,0,380,5,901,516,201,179,3,11436,0
29,"Neamt",124938,270,124938,,"ALEXANDRU CEL BUN",162,"Scoala Agarcia",253,129,124,5,0,128,1,300,171,78,50,3,11436,0
29,"Neamt",124938,270,124938,,"ALEXANDRU CEL BUN",163,"Scoala Veche",1806,960,943,14,3,949,11,1850,890,558,391,3,11436,0
29,"Neamt",124938,270,124938,,"ALEXANDRU CEL BUN",164,"Scoala",1800,916,895,20,1,903,13,1901,985,546,357,3,11436,0
29,"Neamt",124938,270,124938,,"ALEXANDRU CEL BUN",165,"Sediul Fostei Gradinite Bistrita",0,211,0,211,0,208,3,250,39,84,124,3,11436,1
29,"Neamt",124938,270,124938,,"ALEXANDRU CEL BUN",166,"Spitalul de pneumoftiziologie Bisericani - club",0,139,0,139,0,138,1,201,62,67,71,3,11436,1
29,"Neamt",121153,270,121153,,"BAHNA",167,"Caminul cultural",584,346,318,6,22,339,7,598,252,157,182,3,11444,0
29,"Neamt",121153,270,121153,,"BAHNA",168,"Scoala cu clasele I-IV",459,309,271,10,28,303,6,501,192,160,143,3,11444,0
29,"Neamt",121153,270,121153,,"BAHNA",169,"Scoala cu claseleI-IV",288,201,183,8,10,198,3,302,101,108,90,3,11444,0
29,"Neamt",121153,270,121153,,"BAHNA",170,"Scoala cu clasele I-IV",365,222,210,10,2,221,1,404,182,124,97,3,11444,0
29,"Neamt",121153,270,121153,,"BAHNA",171,"Scoala veche",1108,708,664,10,34,688,20,1196,488,477,211,3,11444,0
29,"Neamt",121153,270,121153,,"BAHNA",172,"Scoala Veche Bahna",0,174,0,174,0,172,2,200,26,112,60,3,11444,1
29,"Neamt",121242,270,121242,,"BALTATESTI",173,"Sala de sedinte a primariei",1836,1076,1055,18,3,1069,7,2000,924,397,672,3,11453,0
29,"Neamt",121242,270,121242,,"BALTATESTI",174,"Scoala  generala",1211,625,602,23,0,618,7,1300,675,203,415,3,11453,0
29,"Neamt",121242,270,121242,,"BALTATESTI",175,"SC ""Racordex"" SRL",491,290,258,32,0,285,5,500,210,85,200,3,11453,0
29,"Neamt",121242,270,121242,,"BALTATESTI",176,"Caminul cultural Baltatesti - biblioteca comunala, Str. Florilor",0,167,0,167,0,165,2,200,33,54,111,3,11453,1
29,"Neamt",121297,270,121297,,"BICAZ-CHEI",177,"Caminul Cultural Bicaz Chei",1239,573,529,44,0,571,2,1300,727,342,229,3,11471,0
29,"Neamt",121297,270,121297,,"BICAZ-CHEI",178,"Scoala generala nr.2",766,449,384,65,0,443,6,807,358,262,181,3,11471,0
29,"Neamt",121297,270,121297,,"BICAZ-CHEI",179,"Scoala generala nr.1 Bicaz Chei",858,528,472,56,0,522,6,895,367,270,252,3,11471,0
29,"Neamt",121297,270,121297,,"BICAZ-CHEI",180,"Scoala generala",758,505,476,29,0,504,1,800,295,218,286,3,11471,0
29,"Neamt",121297,270,121297,,"BICAZ-CHEI",181,"Caminul cultural Bicaz Chei, Str. Principala",0,80,0,80,0,79,1,100,20,39,40,3,11471,1
29,"Neamt",121340,270,121340,,"BICAZU ARDELEAN",182,"Camin cultural",1439,747,743,4,0,740,7,1500,753,532,208,3,11476,0
29,"Neamt",121340,270,121340,,"BICAZU ARDELEAN",183,"Scoala generala",1165,570,563,7,0,568,2,1195,625,403,165,3,11476,0
29,"Neamt",121340,270,121340,,"BICAZU ARDELEAN",184,"Scoala primara Tosorog",438,270,262,8,0,268,2,484,214,185,83,3,11476,0
29,"Neamt",121340,270,121340,,"BICAZU ARDELEAN",185,"Scoala primara",260,155,146,9,0,153,2,300,145,107,46,3,11476,0
29,"Neamt",121340,270,121340,,"BICAZU ARDELEAN",186,"Sediul Punctului de Acces Public la Informatii",0,75,0,75,0,75,0,99,24,42,33,3,11476,1
29,"Neamt",121386,270,121386,,"BIRA",187,"Scoala cu clasele I-VIII",645,329,321,7,1,326,3,697,368,152,174,3,11480,0
29,"Neamt",121386,270,121386,,"BIRA",188,"Scoala cu clasele I-IV (Satu Nou)",507,271,263,8,0,267,4,600,329,86,181,3,11480,0
29,"Neamt",121386,270,121386,,"BIRA",189,"Scoala cu clasele I-IV",206,149,139,10,0,147,2,300,151,47,100,3,11480,0
29,"Neamt",121386,270,121386,,"BIRA",190,"Scoala cu clasele I-IV",184,113,107,6,0,113,0,200,87,41,72,3,11480,0
29,"Neamt",121386,270,121386,,"BIRA",191,"Biblioteca comunala Bira",0,68,0,68,0,68,0,100,32,17,51,3,11480,1
29,"Neamt",121466,270,121466,,"BARGAUANI",192,"Sediul Primariei",485,292,278,14,0,289,3,500,208,93,196,3,11457,0
29,"Neamt",121466,270,121466,,"BARGAUANI",193,"Gradinita ""Deal Birgauani""",539,358,333,25,0,351,7,600,242,30,321,3,11457,0
29,"Neamt",121466,270,121466,,"BARGAUANI",194,"Scoala",495,320,308,12,0,316,4,700,380,116,200,3,11457,0
29,"Neamt",121466,270,121466,,"BARGAUANI",195,"Scoala",161,116,107,9,0,113,3,200,84,44,69,3,11457,0
29,"Neamt",121466,270,121466,,"BARGAUANI",196,"Scoala",135,82,74,8,0,77,5,200,118,36,41,3,11457,0
29,"Neamt",121466,270,121466,,"BARGAUANI",197,"Scoala",243,151,138,13,0,146,5,300,149,51,95,3,11457,0
29,"Neamt",121466,270,121466,,"BARGAUANI",198,"Scoala",235,141,132,9,0,140,1,300,159,43,97,3,11457,0
29,"Neamt",121466,270,121466,,"BARGAUANI",199,"Caminul cultural",199,124,109,15,0,123,1,300,176,37,86,3,11457,0
29,"Neamt",121466,270,121466,,"BARGAUANI",200,"Scoala",379,237,227,10,0,236,1,400,163,92,144,3,11457,0
29,"Neamt",121466,270,121466,,"BARGAUANI",201,"Scoala",360,201,186,13,2,199,2,400,199,49,150,3,11457,0
29,"Neamt",121466,270,121466,,"BARGAUANI",202,"Caminul cultural Birgauani",0,157,0,157,0,155,2,200,43,59,96,3,11457,1
29,"Neamt",121607,270,121607,,"BODESTI",203,"Scoala cu clasele I-IV",994,541,528,13,0,527,14,1102,561,194,333,3,11484,0
29,"Neamt",121607,270,121607,,"BODESTI",204,"Scoala cu clasele I-IV",915,454,446,8,0,449,5,1016,562,170,279,3,11484,0
29,"Neamt",121607,270,121607,,"BODESTI",205,"Gradinita ""Catuna""",620,329,293,36,0,320,9,708,379,157,163,3,11484,0
29,"Neamt",121607,270,121607,,"BODESTI",206,"Scoala  cu clasele I-VIII",693,416,376,40,0,407,9,791,375,182,225,3,11484,0
29,"Neamt",121607,270,121607,,"BODESTI",207,"Scoala",147,104,93,11,0,102,2,197,93,40,62,3,11484,0
29,"Neamt",121607,270,121607,,"BODESTI",208,"Scoala",767,427,421,6,0,416,11,809,382,169,247,3,11484,0
29,"Neamt",121607,270,121607,,"BODESTI",209,"Biblioteca comunala Bodesti (sala mare)",0,127,0,127,0,125,2,200,73,62,63,3,11484,1
29,"Neamt",125178,270,125178,,"BOGHICEA",210,"Scoala generala, Corp A",997,617,582,23,12,608,9,1050,433,179,429,3,11489,0
29,"Neamt",125178,270,125178,,"BOGHICEA",211,"Scoala generala",579,358,339,18,1,358,0,600,242,139,219,3,11489,0
29,"Neamt",125178,270,125178,,"BOGHICEA",212,"Scoala generala",135,111,94,16,1,109,2,200,89,23,86,3,11489,0
29,"Neamt",125178,270,125178,,"BOGHICEA",213,"Scoala generala",209,141,131,10,0,139,2,300,159,42,97,3,11489,0
29,"Neamt",125178,270,125178,,"BOGHICEA",214,"Scoala cu clasele I-VIII, Boghicea, Corp B",0,65,0,65,0,64,1,100,35,18,46,3,11489,1
29,"Neamt",121652,270,121652,,"BORCA",215,"Scoala cu clasele I - VIII",928,491,487,4,0,481,10,1000,509,216,265,3,11494,0
29,"Neamt",121652,270,121652,,"BORCA",216,"Scoala cu clasele I - VIII",905,518,513,5,0,515,3,1000,482,172,343,3,11494,0
29,"Neamt",121652,270,121652,,"BORCA",217,"Scoala cu clasele I-IV",570,315,310,5,0,312,3,600,285,111,201,3,11494,0
29,"Neamt",121652,270,121652,,"BORCA",218,"Caminul cultural",773,465,456,9,0,461,4,800,335,210,251,3,11494,0
29,"Neamt",121652,270,121652,,"BORCA",219,"Scoala cu clasele I-VIII",866,524,509,15,0,520,4,901,377,289,231,3,11494,0
29,"Neamt",121652,270,121652,,"BORCA",220,"Scoala cu clasele I-IV",418,278,257,21,0,274,4,500,222,89,185,3,11494,0
29,"Neamt",121652,270,121652,,"BORCA",221,"Scoala cu clasele I-IV",699,393,390,3,0,386,7,800,407,193,193,3,11494,0
29,"Neamt",121652,270,121652,,"BORCA",222,"Caminul cultural Borca",0,137,0,137,0,136,1,204,67,70,66,3,11494,1
29,"Neamt",121732,270,121732,,"BORLESTI",223,"Scoala de arte si meserii",1785,803,753,49,1,789,14,1600,797,481,308,3,11502,0
29,"Neamt",121732,270,121732,,"BORLESTI",224,"Scoala cu clasele I-IV",528,462,283,179,0,448,14,603,141,266,182,3,11502,0
29,"Neamt",121732,270,121732,,"BORLESTI",225,"Scoala cu clasele I-VIII",1856,812,755,57,0,802,10,2000,1188,465,337,3,11502,0
29,"Neamt",121732,270,121732,,"BORLESTI",226,"Scoala cu clasele I-IV (Satul Nou)",1051,544,431,113,0,532,12,1100,556,293,239,3,11502,0
29,"Neamt",121732,270,121732,,"BORLESTI",227,"Scoala cu clasele I-VIII",1515,663,643,20,0,655,8,1600,937,382,273,3,11502,0
29,"Neamt",121732,270,121732,,"BORLESTI",228,"Scoala cu clasele I-IV",431,212,188,24,0,209,3,500,288,114,95,3,11502,0
29,"Neamt",121732,270,121732,,"BORLESTI",229,"Scoala cu clasele I-IV",249,143,134,9,0,142,1,295,152,90,52,3,11502,0
29,"Neamt",121732,270,121732,,"BORLESTI",230,"Scoala Nr. 1, Borlesti",0,135,0,135,0,133,2,400,265,93,40,3,11502,1
29,"Neamt",121796,270,121796,,"BOTESTI",231,"Scoala cu clasele I-IV",444,254,238,16,0,251,3,491,237,127,124,3,11508,0
29,"Neamt",121796,270,121796,,"BOTESTI",232,"Scoala de arte si meserii",955,460,445,15,0,451,9,998,538,263,188,3,11508,0
29,"Neamt",121796,270,121796,,"BOTESTI",233,"Scoala de Arte si Meserii",954,485,476,9,0,473,12,1000,515,290,183,3,11508,0
29,"Neamt",121796,270,121796,,"BOTESTI",234,"Scoala cu clasele I-VIII",1628,731,723,8,0,721,10,1700,969,386,335,3,11508,0
29,"Neamt",121796,270,121796,,"BOTESTI",235,"Caminul cultural Botesti",0,81,0,81,0,81,0,100,19,45,36,3,11508,1
29,"Neamt",121876,270,121876,,"BOZIENI",236,"Caminul Cultural",904,540,506,13,21,529,11,1000,460,101,428,3,11512,0
29,"Neamt",121876,270,121876,,"BOZIENI",237,"Scoala",710,452,413,14,25,447,5,800,348,105,342,3,11512,0
29,"Neamt",121876,270,121876,,"BOZIENI",238,"Scoala",667,394,364,10,20,391,3,696,302,83,308,3,11512,0
29,"Neamt",121876,270,121876,,"BOZIENI",239,"Caminul cultural Bozieni",0,121,0,121,0,119,2,185,64,46,73,3,11512,1
29,"Neamt",121938,270,121938,,"BRUSTURI",240,"Scoala cu clasele I-VIII",1545,855,846,9,0,841,14,1701,846,336,505,3,11518,0
29,"Neamt",121938,270,121938,,"BRUSTURI",241,"Scoala cu clasele I-IV",416,214,206,8,0,212,2,500,286,66,146,3,11518,0
29,"Neamt",121938,270,121938,,"BRUSTURI",242,"Scoala cu clasele I-IV",659,428,413,15,0,420,8,699,271,244,176,3,11518,0
29,"Neamt",121938,270,121938,,"BRUSTURI",243,"Scoala cu clasele I-VIII",582,327,316,11,0,321,6,600,273,149,172,3,11518,0
29,"Neamt",121938,270,121938,,"BRUSTURI",244,"Caminul cultural Brusturi",0,67,0,67,0,66,1,101,34,30,36,3,11518,1
29,"Neamt",122025,270,122025,,"CEAHLAU",245,"Scoala generala cu clasele I-VIII",1447,892,852,11,29,875,17,1600,708,352,523,3,11530,0
29,"Neamt",122025,270,122025,,"CEAHLAU",246,"Caminul Cultural",616,370,358,6,6,364,6,698,328,165,199,3,11530,0
29,"Neamt",122025,270,122025,,"CEAHLAU",247,"Scoala generala Paraul Mare",0,72,0,72,0,72,0,200,128,42,30,3,11530,1
29,"Neamt",122025,270,122025,,"CEAHLAU",248,"Unitatea Medico-Sociala",0,85,0,85,0,82,3,100,15,31,51,3,11530,1
29,"Neamt",122061,270,122061,,"CANDESTI",249,"Scoala de arte si meserii",1404,638,623,15,0,633,5,1500,862,403,230,3,11523,0
29,"Neamt",122061,270,122061,,"CANDESTI",250,"Scoala  cu clasele I-IV",979,505,475,30,0,501,4,1100,595,276,225,3,11523,0
29,"Neamt",122061,270,122061,,"CANDESTI",251,"Scoala  cu clasele I-IV",712,376,344,32,0,367,9,800,424,181,186,3,11523,0
29,"Neamt",122061,270,122061,,"CANDESTI",252,"Scoala  cu clasele I-IV",286,169,138,0,31,164,5,300,131,90,74,3,11523,0
29,"Neamt",122061,270,122061,,"CANDESTI",253,"Scoala de arte si meserii",0,53,0,53,0,53,0,100,47,22,31,3,11523,1
29,"Neamt",120888,270,120888,,"CORDUN",254,"Gradinita cu orar prelungit",1194,666,642,10,14,659,7,1300,634,312,347,3,11534,0
29,"Neamt",120888,270,120888,,"CORDUN",255,"Caminul cultural",1000,613,590,9,14,603,10,1100,487,274,329,3,11534,0
29,"Neamt",120888,270,120888,,"CORDUN",256,"Scoala  generala cu clasele I-IV",660,426,391,24,11,417,9,703,277,128,289,3,11534,0
29,"Neamt",120888,270,120888,,"CORDUN",257,"Scoala  generala cu clasele I-VIII",1753,872,848,12,12,859,13,1896,1024,466,393,3,11534,0
29,"Neamt",120888,270,120888,,"CORDUN",258,"Scoala  generala cu clasele I-VIII",1401,640,616,12,12,631,9,1500,860,364,267,3,11534,0
29,"Neamt",120888,270,120888,,"CORDUN",259,"Scoala generala cu clasele I-VIII",0,88,0,88,0,88,0,100,12,36,52,3,11534,1
29,"Neamt",122132,270,122132,,"COSTISA",260,"Scoala  nr. 1",1426,706,686,18,2,697,9,1500,794,230,467,3,11538,0
29,"Neamt",122132,270,122132,,"COSTISA",261,"Scoala  generala",758,425,412,13,0,419,6,800,375,120,299,3,11538,0
29,"Neamt",122132,270,122132,,"COSTISA",262,"Scoala Generala",508,244,233,11,0,241,3,600,356,122,119,3,11538,0
29,"Neamt",122132,270,122132,,"COSTISA",263,"Cladirea CONSUMCOOP",222,160,147,13,0,158,2,302,142,35,123,3,11538,0
29,"Neamt",122132,270,122132,,"COSTISA",264,"Scoala generala cu clasele I-VIII, nr. 1",0,64,0,64,0,64,0,100,36,28,36,3,11538,1
29,"Neamt",122187,270,122187,,"CRACAOANI",265,"Caminul Cultural",901,471,461,10,0,463,8,1004,533,195,268,3,11543,0
29,"Neamt",122187,270,122187,,"CRACAOANI",266,"Scoala  cu clasele I-VIII",929,473,466,7,0,465,8,1000,527,182,283,3,11543,0
29,"Neamt",122187,270,122187,,"CRACAOANI",267,"Scoala  cu clasele I-VIII",540,364,349,15,0,364,0,607,243,165,199,3,11543,0
29,"Neamt",122187,270,122187,,"CRACAOANI",268,"Scoala  cu clasele I-IV",915,449,435,14,0,441,8,1003,554,136,305,3,11543,0
29,"Neamt",122187,270,122187,,"CRACAOANI",269,"Scoala cu clasele I-IV",261,166,156,10,0,163,3,300,134,56,107,3,11543,0
29,"Neamt",122187,270,122187,,"CRACAOANI",270,"Scoala cu clasele I-VIII",0,90,0,90,0,86,4,100,10,42,44,3,11543,1
29,"Neamt",122249,270,122249,,"DAMUC",271,"Caminul Cultural",1294,683,678,5,0,669,14,1400,717,523,146,3,11549,0
29,"Neamt",122249,270,122249,,"DAMUC",272,"Scoala  generala nr. 2",561,334,320,14,0,332,2,600,266,246,86,3,11549,0
29,"Neamt",122249,270,122249,,"DAMUC",273,"Scoala generala",637,359,353,6,0,357,2,682,323,230,127,3,11549,0
29,"Neamt",122249,270,122249,,"DAMUC",274,"Caminul cultural",0,28,0,28,0,28,0,101,73,16,12,3,11549,1
29,"Neamt",122285,270,122285,,"DOBRENI",275,"Scoala generala, str. Lascar Catargiu, nr. 80",1442,730,709,21,0,720,10,1498,768,344,376,3,11553,0
29,"Neamt",122285,270,122285,,"DOBRENI",276,"Caminul cultural, Str. Lascar Catargiu, nr. 172",0,71,0,71,0,71,0,101,30,40,31,3,11553,1
29,"Neamt",125098,270,125098,,"DOCHIA",277,"Scoala cu clasele I-VIII, corpul C",886,553,535,18,0,541,12,987,434,340,201,3,11557,0
29,"Neamt",125098,270,125098,,"DOCHIA",278,"Scoala  cu clasele I-VIII, corpul C",1094,682,674,8,0,668,14,1196,514,361,307,3,11557,0
29,"Neamt",125098,270,125098,,"DOCHIA",279,"Scoala cu clasele I-VIII, corpul C",0,128,0,128,0,126,2,200,72,78,48,3,11557,1
29,"Neamt",122347,270,122347,,"DOLJESTI",280,"Scoala  cu clasele I-VIII",982,584,549,8,27,575,9,1093,509,150,425,3,11560,0
29,"Neamt",122347,270,122347,,"DOLJESTI",281,"Scoala  cu clasele I-IV",525,286,273,8,5,280,6,607,321,102,178,3,11560,0
29,"Neamt",122347,270,122347,,"DOLJESTI",282,"Scoala  cu clasele I-VIII",1266,537,516,8,13,528,9,1400,863,269,259,3,11560,0
29,"Neamt",122347,270,122347,,"DOLJESTI",283,"Scoala  cu clasele I-VIII",1423,685,648,15,22,676,9,1500,815,205,471,3,11560,0
29,"Neamt",122347,270,122347,,"DOLJESTI",284,"Scoala  cu clasele I-VIII",1382,607,577,10,20,598,9,1499,892,228,370,3,11560,0
29,"Neamt",122347,270,122347,,"DOLJESTI",285,"Caminul cultural",0,106,0,106,0,105,1,200,94,39,66,3,11560,1
29,"Neamt",122392,270,122392,,"DRAGOMIRESTI",286,"Scoala  generala",730,451,442,9,0,445,6,755,304,268,177,3,11570,0
29,"Neamt",122392,270,122392,,"DRAGOMIRESTI",287,"Scoala  generala",123,71,65,6,0,70,1,200,129,35,35,3,11570,0
29,"Neamt",122392,270,122392,,"DRAGOMIRESTI",288,"Scoala  generala",739,400,393,7,0,392,8,800,400,216,176,3,11570,0
29,"Neamt",122392,270,122392,,"DRAGOMIRESTI",289,"Scoala  generala",172,118,107,11,0,117,1,200,82,61,56,3,11570,0
29,"Neamt",122392,270,122392,,"DRAGOMIRESTI",290,"Scoala generala",97,70,61,9,0,67,3,200,130,39,28,3,11570,0
29,"Neamt",122392,270,122392,,"DRAGOMIRESTI",291,"Dispensarul uman",0,213,0,213,0,213,0,251,38,173,40,3,11570,1
29,"Neamt",125132,270,125132,,"DRAGANESTI",292,"Scoala  cu clasele I-VIII",578,371,364,7,0,369,2,606,235,146,223,3,11565,0
29,"Neamt",125132,270,125132,,"DRAGANESTI",293,"Scoala  cu clasele I-IV",303,186,180,6,0,180,6,401,215,52,128,3,11565,0
29,"Neamt",125132,270,125132,,"DRAGANESTI",294,"Scoala  cu clasele I-IV",401,238,231,7,0,230,8,500,262,95,135,3,11565,0
29,"Neamt",125132,270,125132,,"DRAGANESTI",295,"Scoala noua",0,38,0,38,0,38,0,100,62,19,19,3,11565,1
29,"Neamt",122463,270,122463,,"DULCESTI",296,"Scoala de arte si meserii",966,539,527,5,7,532,7,994,455,277,255,3,11577,0
29,"Neamt",122463,270,122463,,"DULCESTI",297,"Scoala Generala",520,276,266,8,2,272,4,606,330,139,133,3,11577,0
29,"Neamt",122463,270,122463,,"DULCESTI",298,"Scoala  Generala",502,368,330,13,25,363,5,601,233,180,183,3,11577,0
29,"Neamt",122463,270,122463,,"DULCESTI",299,"Scoala  Generala",245,178,169,9,0,175,3,297,119,103,72,3,11577,0
29,"Neamt",122463,270,122463,,"DULCESTI",300,"Cabinet medical veterinar, Dr. Nichifor Dragos",0,141,0,141,0,139,2,200,59,77,62,3,11577,1
29,"Neamt",120771,270,120771,,"DUMBRAVA ROSIE",301,"Scoala cu clasele I-VIII",1128,553,547,6,0,548,5,1150,597,312,236,3,11584,0
29,"Neamt",120771,270,120771,,"DUMBRAVA ROSIE",302,"Scoala cu clasele I-VIII",1387,709,691,17,1,701,8,1500,791,432,269,3,11584,0
29,"Neamt",120771,270,120771,,"DUMBRAVA ROSIE",303,"Scoala cu clasele I-IV",576,300,289,11,0,296,4,600,300,148,148,3,11584,0
29,"Neamt",120771,270,120771,,"DUMBRAVA ROSIE",304,"Scoala cu clasele I-VIII",1087,521,513,8,0,515,6,1200,679,351,164,3,11584,0
29,"Neamt",120771,270,120771,,"DUMBRAVA ROSIE",305,"Scoala cu clasele I-VIII",1172,537,528,7,2,529,8,1300,763,347,182,3,11584,0
29,"Neamt",120771,270,120771,,"DUMBRAVA ROSIE",306,"Scoala cu clasele I-VIII",972,561,536,25,0,552,9,1000,439,379,173,3,11584,0
29,"Neamt",120771,270,120771,,"DUMBRAVA ROSIE",307,"Scoala cu clasele I-VIII, Str. Dumbravei, nr. 69",0,87,0,87,0,85,2,149,62,51,34,3,11584,1
29,"Neamt",122551,270,122551,,"FARCASA",308,"Scoala generala",1157,620,605,15,0,612,8,1200,580,284,328,3,11589,0
29,"Neamt",122551,270,122551,,"FARCASA",309,"Caminul Cultural",788,479,466,13,0,477,2,900,421,215,262,3,11589,0
29,"Neamt",122551,270,122551,,"FARCASA",310,"Caminul Cultural",607,345,329,16,0,337,8,700,355,179,158,3,11589,0
29,"Neamt",122551,270,122551,,"FARCASA",311,"Scoala generala",0,70,0,70,0,70,0,100,30,34,36,3,11589,1
29,"Neamt",122613,270,122613,,"FAUREI",312,"Scoala cu clasele I-VIII",656,364,356,8,0,364,0,702,338,147,217,3,11595,0
29,"Neamt",122613,270,122613,,"FAUREI",313,"Scoala cu clasele I-IV",905,548,537,11,0,537,11,994,446,275,262,3,11595,0
29,"Neamt",122613,270,122613,,"FAUREI",314,"Scoala cu clasele I-IV",274,161,153,8,0,157,4,301,140,54,103,3,11595,0
29,"Neamt",122613,270,122613,,"FAUREI",315,"Scoala cu clasele I-VIII",0,80,0,80,0,77,3,100,20,31,46,3,11595,1
29,"Neamt",125150,270,125150,,"GADINTI",316,"Scoala cu clasele I-VIII",961,514,509,5,0,505,9,1026,512,169,336,3,11600,0
29,"Neamt",125150,270,125150,,"GADINTI",317,"Gradinita",978,542,534,8,0,531,11,989,447,153,378,3,11600,0
29,"Neamt",125150,270,125150,,"GADINTI",318,"Caminul cultural",0,64,0,64,0,63,1,102,38,36,27,3,11600,1
29,"Neamt",122668,270,122668,,"GHERAESTI",319,"Caminul Cultural,  str. Vasile Alecsandri, nr. 62",1366,635,633,2,0,624,11,1500,865,355,269,3,11606,0
29,"Neamt",122668,270,122668,,"GHERAESTI",320,"Scoala generala  cu clasele I-VIII, Corp B,  Aleea Scolii",1531,707,706,1,0,700,7,1600,893,397,303,3,11606,0
29,"Neamt",122668,270,122668,,"GHERAESTI",321,"Scoala generala  cu clasele I-VIII, Corp B,  Aleea Scolii",1086,453,450,3,0,444,9,1199,746,232,212,3,11606,0
29,"Neamt",122668,270,122668,,"GHERAESTI",322,"Scoala generala cu clasele I-IV, str. Calea Romanului",481,236,231,5,0,236,0,505,269,110,126,3,11606,0
29,"Neamt",122668,270,122668,,"GHERAESTI",323,"Scoala generala cu clasele I-VIII, str. Al. I. Cuza",679,295,288,7,0,291,4,672,377,158,133,3,11606,0
29,"Neamt",122668,270,122668,,"GHERAESTI",324,"Caminul cultural, Str. Vasile Alecsandri, nr. 62",0,54,0,54,0,54,0,101,47,32,22,3,11606,1
29,"Neamt",125114,270,125114,,"GHINDAOANI",325,"Cladirea ""Sala de nunti""",1867,1002,995,7,0,989,13,2000,998,378,611,3,11610,0
29,"Neamt",125114,270,125114,,"GHINDAOANI",326,"Scoala cu clasele I-VIII ""Vasile Conta""",0,52,0,52,0,52,0,102,50,36,16,3,11610,1
29,"Neamt",122702,270,122702,,"GIROV",327,"Scoala",1365,684,663,21,0,674,10,1500,816,326,348,3,11612,0
29,"Neamt",122702,270,122702,,"GIROV",328,"Scoala",552,295,285,10,0,291,4,591,296,102,189,3,11612,0
29,"Neamt",122702,270,122702,,"GIROV",329,"Scoala",600,334,315,19,0,330,4,716,382,105,225,3,11612,0
29,"Neamt",122702,270,122702,,"GIROV",330,"Scoala",400,231,212,19,0,227,4,497,266,98,129,3,11612,0
29,"Neamt",122702,270,122702,,"GIROV",331,"Scoala",434,254,232,22,0,252,2,485,231,132,120,3,11612,0
29,"Neamt",122702,270,122702,,"GIROV",332,"Scoala",229,126,105,21,0,124,2,299,173,54,70,3,11612,0
29,"Neamt",122702,270,122702,,"GIROV",333,"Scoala",239,123,110,13,0,121,2,300,177,53,68,3,11612,0
29,"Neamt",122702,270,122702,,"GIROV",334,"Scoala",257,165,144,21,0,163,2,300,135,86,77,3,11612,0
29,"Neamt",122702,270,122702,,"GIROV",335,"Scoala generala",0,95,0,95,0,95,0,198,103,50,45,3,11612,1
29,"Neamt",122828,270,122828,,"GARCINA",336,"Scoala generala",1173,650,641,9,0,640,10,1300,650,411,229,3,11602,0
29,"Neamt",122828,270,122828,,"GARCINA",337,"Gradinita",1042,620,597,23,0,606,14,1100,480,384,222,3,11602,0
29,"Neamt",122828,270,122828,,"GARCINA",338,"Scoala",498,331,317,14,0,323,8,600,269,187,136,3,11602,0
29,"Neamt",122828,270,122828,,"GARCINA",339,"Scoala",999,480,465,15,0,470,10,1100,620,302,168,3,11602,0
29,"Neamt",122828,270,122828,,"GARCINA",340,"Gradinita",0,80,0,80,0,79,1,98,18,50,29,3,11602,1
29,"Neamt",122864,270,122864,,"GRINTIES",341,"Caminul Cultural",1434,808,797,11,0,798,10,1500,692,269,529,3,11622,0
29,"Neamt",122864,270,122864,,"GRINTIES",342,"Sala de festivitati",677,389,370,19,0,385,4,700,311,135,250,3,11622,0
29,"Neamt",122864,270,122864,,"GRINTIES",343,"Caminul cultural",0,80,0,80,0,77,3,100,20,29,48,3,11622,1
29,"Neamt",122908,270,122908,,"GRUMAZESTI",344,"Scoala cu clasele I-VIII, corp A",1310,724,719,5,0,721,3,1400,676,233,488,3,11626,0
29,"Neamt",122908,270,122908,,"GRUMAZESTI",345,"Scoala cu clasele I-VIII, corp A",1097,522,518,4,0,514,8,1200,678,174,340,3,11626,0
29,"Neamt",122908,270,122908,,"GRUMAZESTI",346,"Scoala cu clasele I-IV",638,299,292,7,0,294,5,700,401,133,161,3,11626,0
29,"Neamt",122908,270,122908,,"GRUMAZESTI",347,"Scoala cu clasele I-VIII",1302,738,704,34,0,733,5,1400,662,326,407,3,11626,0
29,"Neamt",122908,270,122908,,"GRUMAZESTI",348,"Scoala cu clasele I-VIII, corp A, etaj",0,67,0,67,0,67,0,100,33,36,31,3,11626,1
29,"Neamt",122953,270,122953,,"HANGU",349,"Scoala generala",996,505,492,13,0,496,9,1096,591,181,315,3,11631,0
29,"Neamt",122953,270,122953,,"HANGU",350,"Scoala primara Boboteni",522,270,262,8,0,267,3,600,330,122,145,3,11631,0
29,"Neamt",122953,270,122953,,"HANGU",351,"Scoala primara",450,248,240,8,0,244,4,500,252,89,155,3,11631,0
29,"Neamt",122953,270,122953,,"HANGU",352,"Scoala primara",383,232,224,8,0,230,2,394,162,145,85,3,11631,0
29,"Neamt",122953,270,122953,,"HANGU",353,"Scoala generala",732,367,357,10,0,361,6,789,422,191,170,3,11631,0
29,"Neamt",122953,270,122953,,"HANGU",354,"Scoala primara",310,186,178,8,0,184,2,413,227,101,83,3,11631,0
29,"Neamt",122953,270,122953,,"HANGU",355,"Scoala cu clasele I-VIII",0,82,0,82,0,82,0,100,18,46,36,3,11631,1
29,"Neamt",120922,270,120922,,"HORIA",356,"Scoala Generala  nr.14,  str. Pietrei",1628,801,786,15,0,792,9,1700,899,385,407,3,11637,0
29,"Neamt",120922,270,120922,,"HORIA",357,"Caminul Cultural,  str. Pietrei",1554,762,750,12,0,757,5,1599,837,392,365,3,11637,0
29,"Neamt",120922,270,120922,,"HORIA",358,"Scoala Generala ""Otilia Cazimir"" , str. Plopului",1383,659,649,10,0,645,14,1499,840,348,297,3,11637,0
29,"Neamt",120922,270,120922,,"HORIA",359,"Gradinita, str. Cezar Boliac",1375,687,672,15,0,680,7,1488,801,387,293,3,11637,0
29,"Neamt",120922,270,120922,,"HORIA",360,"Caminul cultural, Str. Pietrei, nr. 1",0,97,0,97,0,97,0,100,3,55,42,3,11637,1
29,"Neamt",123013,270,123013,,"ICUSESTI",361,"Scoala cu clasele I-VIII",646,336,331,5,0,333,3,700,364,168,165,3,11640,0
29,"Neamt",123013,270,123013,,"ICUSESTI",362,"Scoala de arte si meserii - corpul B",743,357,346,11,0,355,2,800,443,188,167,3,11640,0
29,"Neamt",123013,270,123013,,"ICUSESTI",363,"Scoala de arte si meserii - corpul A",1193,608,600,8,0,598,10,1300,692,312,286,3,11640,0
29,"Neamt",123013,270,123013,,"ICUSESTI",364,"Scoala cu clasele I-IV",462,243,228,15,0,236,7,500,257,165,71,3,11640,0
29,"Neamt",123013,270,123013,,"ICUSESTI",365,"Scoala cu clasele I-IV",424,249,242,7,0,249,0,500,251,159,90,3,11640,0
29,"Neamt",123013,270,123013,,"ICUSESTI",366,"Scoala cu clasele I-IV",203,136,126,10,0,136,0,304,168,58,78,3,11640,0
29,"Neamt",123013,270,123013,,"ICUSESTI",367,"Biroul din incinta magazinului satesc a ""CONSUMCOOP"" Roman Musat",0,139,0,139,0,138,1,200,61,80,58,3,11640,1
29,"Neamt",123102,270,123102,,"ION CREANGA",368,"Caminul cultural ,  str. I.C. Bratianu, nr. 101",1455,746,727,7,12,740,6,1550,804,429,311,3,11648,0
29,"Neamt",123102,270,123102,,"ION CREANGA",369,"Caminul cultural ,  str. I.C. Bratianu, nr. 101",664,339,324,8,7,328,11,688,349,175,153,3,11648,0
29,"Neamt",123102,270,123102,,"ION CREANGA",370,"Scoala cu clasele I-VIII, str. Oancea Averescu",800,428,414,14,0,422,6,892,464,139,283,3,11648,0
29,"Neamt",123102,270,123102,,"ION CREANGA",371,"Scoala cu clasele I-IV, str. Scolii",352,205,186,19,0,203,2,400,195,113,90,3,11648,0
29,"Neamt",123102,270,123102,,"ION CREANGA",372,"Scoala, str. Siretului",644,316,304,12,0,315,1,702,386,175,140,3,11648,0
29,"Neamt",123102,270,123102,,"ION CREANGA",373,"Caminul  cultural, str. Preot Moraru",678,402,393,9,0,394,8,700,298,210,184,3,11648,0
29,"Neamt",123102,270,123102,,"ION CREANGA",374,"Scoala de arte si meserii, Gradinita, str. I.C. Bratianu, nr. 91",0,107,0,107,0,106,1,151,44,58,48,3,11648,1
29,"Neamt",123175,270,123175,,"MARGINENI",375,"Caminul cultural",953,443,434,8,1,428,15,1000,557,131,297,3,11655,0
29,"Neamt",123175,270,123175,,"MARGINENI",376,"Caminul cultural",971,489,470,14,5,480,9,1000,511,168,312,3,11655,0
29,"Neamt",123175,270,123175,,"MARGINENI",377,"Scoala generala",205,164,144,18,2,161,3,300,136,68,93,3,11655,0
29,"Neamt",123175,270,123175,,"MARGINENI",378,"Scoala generala",805,420,398,22,0,415,5,900,480,158,257,3,11655,0
29,"Neamt",123175,270,123175,,"MARGINENI",379,"Scoala generala",270,157,148,7,2,154,3,300,143,84,70,3,11655,0
29,"Neamt",123175,270,123175,,"MARGINENI",380,"Scoala cu clasele I-VIII",0,92,0,92,0,89,3,100,8,41,48,3,11655,1
29,"Neamt",123228,270,123228,,"MOLDOVENI",381,"Scoala cu clasele I-VIII",1103,680,665,8,7,676,4,1097,417,339,337,3,11660,0
29,"Neamt",123228,270,123228,,"MOLDOVENI",382,"Scoala cu clasele I-IV",819,468,456,7,5,457,11,903,435,254,203,3,11660,0
29,"Neamt",123228,270,123228,,"MOLDOVENI",383,"Gradinita",0,103,0,103,0,102,1,200,97,59,43,3,11660,1
29,"Neamt",125169,270,125169,,"NEGRESTI",384,"Scoala cu clasele I-VIII ""Dumitru Almas""",1286,697,692,5,0,682,15,1401,704,301,381,3,11663,0
29,"Neamt",125169,270,125169,,"NEGRESTI",385,"Scoala",330,190,182,8,0,187,3,393,203,41,146,3,11663,0
29,"Neamt",125169,270,125169,,"NEGRESTI",386,"Gradinita",0,132,0,132,0,130,2,200,68,78,52,3,11663,1
29,"Neamt",123255,270,123255,,"ONICENI",387,"Scoala cu clasele I-VIII",674,409,399,10,0,398,11,700,291,93,305,3,11666,0
29,"Neamt",123255,270,123255,,"ONICENI",388,"Scoala cu clasele I-IV",362,251,240,10,1,247,4,410,159,49,198,3,11666,0
29,"Neamt",123255,270,123255,,"ONICENI",389,"Scoala cu clasele I-IV",506,347,340,7,0,346,1,601,254,66,280,3,11666,0
29,"Neamt",123255,270,123255,,"ONICENI",390,"Scoala cu clasele I-VIII",867,600,591,9,0,590,10,900,300,120,470,3,11666,0
29,"Neamt",123255,270,123255,,"ONICENI",391,"Scoala (local nou), cancelarie",0,135,0,135,0,135,0,200,65,33,102,3,11666,1
29,"Neamt",123371,270,123371,,"PASTRAVENI",392,"Scoala cu clasele I-VIII",1462,792,789,3,0,774,18,1600,808,196,578,3,11691,0
29,"Neamt",123371,270,123371,,"PASTRAVENI",393,"Scoala cu clasele I-VIII",804,472,461,11,0,460,12,895,423,155,305,3,11691,0
29,"Neamt",123371,270,123371,,"PASTRAVENI",394,"Scoala cu clasele I-IV",562,334,327,7,0,321,13,589,255,127,194,3,11691,0
29,"Neamt",123371,270,123371,,"PASTRAVENI",395,"Scoala cu clasele I-IV",267,193,184,9,0,190,3,290,97,49,141,3,11691,0
29,"Neamt",123371,270,123371,,"PASTRAVENI",396,"Scoala cu clasele I-VIII",0,91,0,91,0,91,0,100,9,53,38,3,11691,1
29,"Neamt",125141,270,125141,,"PANCESTI",397,"Scoala de arte si meserii",992,586,583,3,0,573,13,1100,514,256,317,3,11678,0
29,"Neamt",125141,270,125141,,"PANCESTI",398,"Scoala  Generala",252,161,156,5,0,160,1,301,140,70,90,3,11678,0
29,"Neamt",125141,270,125141,,"PANCESTI",399,"Scoala de arte si meserii",0,45,0,45,0,44,1,103,58,23,21,3,11678,1
29,"Neamt",123424,270,123424,,"PETRICANI",400,"Scoala de arte si meserii nr. 1",1461,680,660,20,0,674,6,1500,820,253,421,3,11696,0
29,"Neamt",123424,270,123424,,"PETRICANI",401,"Scoala generala",759,456,443,13,0,448,8,800,344,168,280,3,11696,0
29,"Neamt",123424,270,123424,,"PETRICANI",402,"Scoala generala",1073,554,523,31,0,540,14,1100,546,157,383,3,11696,0
29,"Neamt",123424,270,123424,,"PETRICANI",403,"Scoala generala",1069,474,458,16,0,467,7,1100,626,161,306,3,11696,0
29,"Neamt",123424,270,123424,,"PETRICANI",404,"Scoala de arte si meserii nr.1",0,58,0,58,0,57,1,102,44,21,36,3,11696,1
29,"Neamt",123479,270,123479,,"PIATRA SOIMULUI",405,"Scoala generala nr.1",1513,670,628,40,2,664,6,1600,930,282,382,3,11701,0
29,"Neamt",123479,270,123479,,"PIATRA SOIMULUI",406,"Scoala generala  nr.2",1451,699,669,30,0,690,9,1500,801,321,369,3,11701,0
29,"Neamt",123479,270,123479,,"PIATRA SOIMULUI",407,"Scoala generala",1114,493,479,14,0,491,2,1200,707,168,323,3,11701,0
29,"Neamt",123479,270,123479,,"PIATRA SOIMULUI",408,"Scoala generala",1043,481,464,17,0,474,7,1100,619,190,284,3,11701,0
29,"Neamt",123479,270,123479,,"PIATRA SOIMULUI",409,"Scoala primara",540,302,286,16,0,300,2,591,289,143,157,3,11701,0
29,"Neamt",123479,270,123479,,"PIATRA SOIMULUI",410,"Scoala generala",1040,630,607,23,0,611,19,1100,470,156,455,3,11701,0
29,"Neamt",123479,270,123479,,"PIATRA SOIMULUI",411,"Scoala generala nr.1, Str. Cantonului",0,85,0,85,0,85,0,100,15,46,39,3,11701,1
29,"Neamt",123521,270,123521,,"PIPIRIG",412,"Scoala de arte si meserii ""Ion Creanga"", str. David Creanga, sala de clasa",1370,727,697,30,0,720,7,1497,770,336,384,3,11706,0
29,"Neamt",123521,270,123521,,"PIPIRIG",413,"Scoala cu clasele I-IV nr.2 , str. Ion Creanga,  sala de clasa",910,455,438,15,2,454,1,998,543,170,284,3,11706,0
29,"Neamt",123521,270,123521,,"PIPIRIG",414,"Scoala cu clasele I-VIII, str. Ozana, sala de clasa",1296,730,723,7,0,718,12,1400,670,180,538,3,11706,0
29,"Neamt",123521,270,123521,,"PIPIRIG",415,"Scoala  cu clasele I-IV, str. Cerbariei, sala de clasa",453,280,264,16,0,275,5,500,220,135,140,3,11706,0
29,"Neamt",123521,270,123521,,"PIPIRIG",416,"Scoala  cu clasele I-VIII, str. Codrului, sala de clasa",1077,576,564,12,0,570,6,1100,524,267,303,3,11706,0
29,"Neamt",123521,270,123521,,"PIPIRIG",417,"Scoala  cu clasele I-IV, str. David Creanga, sala de clasa",844,415,401,14,0,415,0,892,477,151,264,3,11706,0
29,"Neamt",123521,270,123521,,"PIPIRIG",418,"Scoala  cu clasele I- VIII, str. Cujbeni,  sala de clasa",846,411,399,12,0,405,6,903,492,200,205,3,11706,0
29,"Neamt",123521,270,123521,,"PIPIRIG",419,"Scoala de arte si meserii ""Ion Creanga""",0,73,0,73,0,72,1,100,27,32,40,3,11706,1
29,"Neamt",123601,270,123601,,"PANGARATI",420,"Scoala  cu clasele I-VIII",1624,927,880,45,2,923,4,1699,772,542,381,3,11684,0
29,"Neamt",123601,270,123601,,"PANGARATI",421,"Scoala generala",635,325,305,20,0,323,2,688,363,183,140,3,11684,0
29,"Neamt",123601,270,123601,,"PANGARATI",422,"Scoala generala",1260,742,724,15,3,735,7,1300,558,437,298,3,11684,0
29,"Neamt",123601,270,123601,,"PANGARATI",423,"Scoala  generala",858,478,459,17,2,477,1,916,438,287,190,3,11684,0
29,"Neamt",123601,270,123601,,"PANGARATI",424,"Scoala cu clasele I-VIII",0,86,0,86,0,84,2,100,14,41,43,3,11684,1
29,"Neamt",123674,270,123674,,"PODOLENI",425,"Scoala ""Alexandru Podoleanu"" corp A, str. Sperantei, nr. 437",1084,488,469,19,0,481,7,1103,615,249,232,3,11714,0
29,"Neamt",123674,270,123674,,"PODOLENI",426,"Scoala ""Alexandru Podoleanu"" corp B, str. Sperantei, nr. 440",1193,511,501,10,0,506,5,1300,789,248,258,3,11714,0
29,"Neamt",123674,270,123674,,"PODOLENI",427,"Scoala Generala nr.2, str. Vatra Noua, nr. 1465",1239,597,556,41,0,591,6,1300,703,277,314,3,11714,0
29,"Neamt",123674,270,123674,,"PODOLENI",428,"Scoala Generala nr.3, str. Sfanta Treime, nr. 691",871,499,445,54,0,495,4,900,401,247,248,3,11714,0
29,"Neamt",123674,270,123674,,"PODOLENI",429,"Scoala Generala nr.4, sat Negritesti, nr. 145",326,198,189,9,0,193,5,386,188,98,95,3,11714,0
29,"Neamt",123674,270,123674,,"PODOLENI",430,"Fosta baie comunala (constructie libera), str. Sperantei, nr. 441",0,74,0,74,0,74,0,200,126,39,35,3,11714,1
29,"Neamt",123709,270,123709,,"POIENARI",431,"Scoala  Generala nr. 1",1111,667,656,11,0,659,8,1111,444,383,276,3,11729,0
29,"Neamt",123709,270,123709,,"POIENARI",432,"Scoala  Generala",309,197,192,5,0,192,5,392,195,87,105,3,11729,0
29,"Neamt",123709,270,123709,,"POIENARI",433,"Scoala cu clasele I-VIII, nr. 1",0,109,0,109,0,107,2,115,6,45,62,3,11729,1
29,"Neamt",123790,270,123790,,"POIANA TEIULUI",434,"Gradinita",1298,686,674,12,0,681,5,1400,714,397,284,3,11717,0
29,"Neamt",123790,270,123790,,"POIANA TEIULUI",435,"Scoala, corp principal",964,556,527,29,0,543,13,1001,445,205,338,3,11717,0
29,"Neamt",123790,270,123790,,"POIANA TEIULUI",436,"Scoala,  corp principal",755,389,376,13,0,385,4,800,411,179,206,3,11717,0
29,"Neamt",123790,270,123790,,"POIANA TEIULUI",437,"Scoala,  corp principal",978,388,379,9,0,386,2,1000,612,218,168,3,11717,0
29,"Neamt",123790,270,123790,,"POIANA TEIULUI",438,"Scoala cu clasele I-VIII Galu",0,65,0,65,0,65,0,100,35,20,45,3,11717,1
29,"Neamt",123914,270,123914,,"RAUCESTI",439,"Scoala  nr.1",1339,680,649,30,1,676,4,1400,720,282,394,3,11733,0
29,"Neamt",123914,270,123914,,"RAUCESTI",440,"Scoala  nr.2",788,441,399,42,0,438,3,900,459,122,316,3,11733,0
29,"Neamt",123914,270,123914,,"RAUCESTI",441,"Gradinita nr.2",527,331,302,29,0,326,5,600,269,129,197,3,11733,0
29,"Neamt",123914,270,123914,,"RAUCESTI",442,"Scoala nr.2",780,469,372,97,0,467,2,900,431,212,255,3,11733,0
29,"Neamt",123914,270,123914,,"RAUCESTI",443,"Scoala nr.1",1550,871,763,108,0,864,7,1600,729,338,526,3,11733,0
29,"Neamt",123914,270,123914,,"RAUCESTI",444,"Sediul PF Salaru Geanina",626,395,358,37,0,389,6,712,317,232,157,3,11733,0
29,"Neamt",123914,270,123914,,"RAUCESTI",445,"Scoala",385,225,209,16,0,223,2,400,175,69,154,3,11733,0
29,"Neamt",123914,270,123914,,"RAUCESTI",446,"Scoala",426,274,252,22,0,272,2,500,226,117,155,3,11733,0
29,"Neamt",123914,270,123914,,"RAUCESTI",447,"Serviciul Voluntar pentru situatii de urgenta - blocul din centrul comunei, parter, nr. 303",0,90,0,90,0,90,0,100,10,33,57,3,11733,1
29,"Neamt",123969,270,123969,,"RAZBOIENI",448,"Scoala generala nr.1",630,417,390,25,2,408,9,694,277,78,330,3,11738,0
29,"Neamt",123969,270,123969,,"RAZBOIENI",449,"Scoala",308,181,173,8,0,175,6,414,233,31,144,3,11738,0
29,"Neamt",123969,270,123969,,"RAZBOIENI",450,"Scoala  Generala nr. 3",537,265,252,13,0,255,10,599,334,81,174,3,11738,0
29,"Neamt",123969,270,123969,,"RAZBOIENI",451,"Scoala Generala",337,232,223,9,0,229,3,400,168,56,173,3,11738,0
29,"Neamt",123969,270,123969,,"RAZBOIENI",452,"Scoala generala nr.1",0,168,0,168,0,168,0,300,132,68,100,3,11738,1
29,"Neamt",124028,270,124028,,"REDIU",453,"Scoala de arte si meserii",1966,864,841,22,1,857,7,2100,1236,415,442,3,11744,0
29,"Neamt",124028,270,124028,,"REDIU",454,"Scoala de arte si meserii",1149,559,502,57,0,553,6,1200,641,232,321,3,11744,0
29,"Neamt",124028,270,124028,,"REDIU",455,"Scoala de arte si meserii",609,359,333,26,0,355,4,700,341,151,204,3,11744,0
29,"Neamt",124028,270,124028,,"REDIU",456,"Scoala de arte si meserii",609,284,263,21,0,283,1,700,416,99,184,3,11744,0
29,"Neamt",124028,270,124028,,"REDIU",457,"Scoala cu clasele I-VIII",0,57,0,57,0,56,1,100,43,20,36,3,11744,1
29,"Neamt",124073,270,124073,,"ROMANI",458,"Scoala cu clasele I- VIII",832,457,447,10,0,454,3,896,439,217,237,3,11749,0
29,"Neamt",124073,270,124073,,"ROMANI",459,"Scoala cu clasele I- VIII",1020,612,597,4,11,601,11,1100,488,137,464,3,11749,0
29,"Neamt",124073,270,124073,,"ROMANI",460,"Scoala cu clasele I- VIII",770,438,427,6,5,429,9,800,362,153,276,3,11749,0
29,"Neamt",124073,270,124073,,"ROMANI",461,"Scoala cu clasele I- VIII",823,460,451,9,0,454,6,904,444,153,301,3,11749,0
29,"Neamt",124073,270,124073,,"ROMANI",462,"Scoala cu clasele I-VIII",0,139,0,139,0,137,2,202,63,69,68,3,11749,1
29,"Neamt",125105,270,125105,,"RUGINOASA",463,"Scoala general cu clasele I- VIII",700,498,469,1,28,495,3,810,312,243,252,3,11753,0
29,"Neamt",125105,270,125105,,"RUGINOASA",464,"Scoala generala cu clasele I- VIII",690,466,432,0,34,460,6,776,310,234,226,3,11753,0
29,"Neamt",125105,270,125105,,"RUGINOASA",465,"Scoala",231,178,143,29,6,177,1,299,121,95,82,3,11753,0
29,"Neamt",125105,270,125105,,"RUGINOASA",466,"Scoala cu clasele I-VIII",0,183,0,183,0,181,2,202,19,105,76,3,11753,1
29,"Neamt",125105,270,125105,,"RUGINOASA",467,"Centrul de Ingrijire si asistenta sociala",0,95,0,95,0,90,5,101,6,58,32,3,11753,1
29,"Neamt",124153,270,124153,,"SAGNA",468,"Scoala generala, localul 3",1590,659,653,6,0,650,9,1700,1041,323,327,3,11759,0
29,"Neamt",124153,270,124153,,"SAGNA",469,"Scoala generala, localul 4",1436,652,643,9,0,639,13,1500,848,268,371,3,11759,0
29,"Neamt",124153,270,124153,,"SAGNA",470,"Gradinita",375,194,189,5,0,190,4,400,206,53,137,3,11759,0
29,"Neamt",124153,270,124153,,"SAGNA",471,"Scoala Generala",652,335,322,12,1,328,7,700,365,171,157,3,11759,0
29,"Neamt",124153,270,124153,,"SAGNA",472,"Gradinita",0,86,0,86,0,85,1,100,14,37,48,3,11759,1
29,"Neamt",124206,270,124206,,"SABAOANI",473,"Liceul teoretic ""Vasile Alecsandri"", corp A, str. Progresului, nr.40",2167,916,904,10,2,904,12,2300,1384,342,562,3,11756,0
29,"Neamt",124206,270,124206,,"SABAOANI",474,"Scoala generala - corp B, str. Progresului, nr. 19",2028,834,799,33,2,822,12,2192,1358,374,448,3,11756,0
29,"Neamt",124206,270,124206,,"SABAOANI",475,"Scoala Generala de langa brutarie",1676,734,725,5,4,719,15,1800,1066,258,461,3,11756,0
29,"Neamt",124206,270,124206,,"SABAOANI",476,"Scoala Generala nr.2",2229,898,887,8,3,886,12,2400,1502,332,554,3,11756,0
29,"Neamt",124206,270,124206,,"SABAOANI",477,"Scoala",948,480,469,11,0,473,7,1000,520,222,251,3,11756,0
29,"Neamt",124206,270,124206,,"SABAOANI",478,"Clubul copiilor, str. Orizontului, nr. 54",0,85,0,85,0,85,0,200,115,39,46,3,11756,1
29,"Neamt",120824,270,120824,,"SAVINESTI",479,"Scoala cu clasele I-VIII  (Savinesti colonie)",1513,624,611,13,0,609,15,1600,976,282,327,3,11763,0
29,"Neamt",120824,270,120824,,"SAVINESTI",480,"Gradinita cu orar normal",405,199,178,21,0,196,3,500,301,104,92,3,11763,0
29,"Neamt",120824,270,120824,,"SAVINESTI",481,"Gradinita cu orar prelungit",570,297,286,11,0,293,4,600,303,140,153,3,11763,0
29,"Neamt",120824,270,120824,,"SAVINESTI",482,"Scoala cu clasele I-VIII, (Savinesti  sat)",1409,746,712,34,0,739,7,1500,754,384,355,3,11763,0
29,"Neamt",120824,270,120824,,"SAVINESTI",483,"Scoala cu clasele I-IV  (Dumbrava Vale)",1207,664,644,20,0,651,13,1300,636,239,412,3,11763,0
29,"Neamt",120824,270,120824,,"SAVINESTI",484,"Scoala cu clasele I-IV",361,209,193,14,2,206,3,400,191,91,115,3,11763,0
29,"Neamt",120824,270,120824,,"SAVINESTI",485,"Centrul social Polivalent, str. G-ral Bunis, nr.4",0,71,0,71,0,71,0,100,29,28,43,3,11763,1
29,"Neamt",124233,270,124233,,"SECUIENI",486,"Caminul Cultural",983,488,476,10,2,483,5,1000,512,204,279,3,11766,0
29,"Neamt",124233,270,124233,,"SECUIENI",487,"Caminul Cultural",551,300,288,12,0,299,1,600,300,136,163,3,11766,0
29,"Neamt",124233,270,124233,,"SECUIENI",488,"Caminul Cultural",979,452,447,5,0,442,10,1000,548,139,303,3,11766,0
29,"Neamt",124233,270,124233,,"SECUIENI",489,"Scoala Generala",239,112,107,5,0,106,6,300,188,31,75,3,11766,0
29,"Neamt",124233,270,124233,,"SECUIENI",490,"Scoala generala, sala de sport",0,60,0,60,0,59,1,101,41,29,30,3,11766,1
29,"Neamt",124331,270,124331,,"STANITA",491,"Scoala",901,462,447,11,4,456,6,1010,548,248,208,3,11776,0
29,"Neamt",124331,270,124331,,"STANITA",492,"Scoala",859,482,467,15,0,465,17,898,416,248,217,3,11776,0
29,"Neamt",124331,270,124331,,"STANITA",493,"Scoala",0,101,0,101,0,100,1,150,49,55,45,3,11776,1
29,"Neamt",124411,270,124411,,"STEFAN CEL MARE",494,"Scoala generala",1427,912,897,15,0,901,11,1497,585,489,412,3,11784,0
29,"Neamt",124411,270,124411,,"STEFAN CEL MARE",495,"Scoala generala",516,334,322,12,0,330,4,584,250,183,147,3,11784,0
29,"Neamt",124411,270,124411,,"STEFAN CEL MARE",496,"Scoala generala",435,261,252,9,0,261,0,493,232,150,111,3,11784,0
29,"Neamt",124411,270,124411,,"STEFAN CEL MARE",497,"Scoala generala",276,177,170,7,0,176,1,300,123,107,69,3,11784,0
29,"Neamt",124411,270,124411,,"STEFAN CEL MARE",498,"Scoala generala, str. Stefan cel Mare, nr.27",0,200,0,200,0,197,3,301,101,133,64,3,11784,1
29,"Neamt",124493,270,124493,,"TARCAU",499,"Scoala de Arte si Meserii , corp vechi, sala 1",781,440,431,9,0,431,9,799,359,196,235,3,11795,0
29,"Neamt",124493,270,124493,,"TARCAU",500,"Scoala de Arte si Meserii , corp vechi, parter, sala 2",827,420,406,14,0,417,3,897,477,211,206,3,11795,0
29,"Neamt",124493,270,124493,,"TARCAU",501,"Scoala  cu clasele I-IV",532,293,279,14,0,286,7,599,306,152,134,3,11795,0
29,"Neamt",124493,270,124493,,"TARCAU",502,"Gradinita",421,261,248,13,0,254,7,500,239,128,126,3,11795,0
29,"Neamt",124493,270,124493,,"TARCAU",503,"Scoala cu clasele I-IV",280,158,150,8,0,157,1,300,142,105,52,3,11795,0
29,"Neamt",124493,270,124493,,"TARCAU",504,"Scoala de arte si meserii, corp nou, parter, sala 1, Tarcau, nr. 230",0,98,0,98,0,96,2,100,2,47,49,3,11795,1
29,"Neamt",124563,270,124563,,"TASCA",505,"Caminul Cultural",1463,939,934,5,0,914,25,1600,661,498,416,3,11802,0
29,"Neamt",124563,270,124563,,"TASCA",506,"Sala de Sedinte",774,490,479,11,0,482,8,796,306,287,195,3,11802,0
29,"Neamt",124563,270,124563,,"TASCA",507,"Caminul cultural",0,54,0,54,0,54,0,100,46,29,25,3,11802,1
29,"Neamt",124616,270,124616,,"TAZLAU",508,"Scoala cu clasele I-VIII ""I.I. Mironescu"", str. Stefan cel Mare, nr. 186",1130,567,560,7,0,552,15,1200,633,205,347,3,11807,0
29,"Neamt",124616,270,124616,,"TAZLAU",509,"Caminul Cultural, str. Fabricii, nr. 2",1255,684,682,2,0,676,8,1306,622,267,409,3,11807,0
29,"Neamt",124616,270,124616,,"TAZLAU",510,"Caminul cultural, anexa, str. Fabricii, nr.2",0,65,0,65,0,65,0,100,35,26,39,3,11807,1
29,"Neamt",124634,270,124634,,"TAMASENI",511,"Scoala",1371,507,480,27,0,503,4,1500,993,208,295,3,11792,0
29,"Neamt",124634,270,124634,,"TAMASENI",512,"Caminul Cultural",902,463,405,58,0,457,6,978,515,172,285,3,11792,0
29,"Neamt",124634,270,124634,,"TAMASENI",513,"Gradinita",1123,592,528,64,0,585,7,1215,623,199,386,3,11792,0
29,"Neamt",124634,270,124634,,"TAMASENI",514,"Scoala",1819,687,623,64,0,679,8,1900,1213,444,235,3,11792,0
29,"Neamt",124634,270,124634,,"TAMASENI",515,"Gradinita",860,432,327,105,0,425,7,900,468,281,144,3,11792,0
29,"Neamt",124634,270,124634,,"TAMASENI",516,"Gradinita",1101,574,461,113,0,562,12,1200,626,388,174,3,11792,0
29,"Neamt",124634,270,124634,,"TAMASENI",517,"Caminul cultural",0,63,0,63,0,63,0,101,38,38,25,3,11792,1
29,"Neamt",124661,270,124661,,"TIMISESTI",518,"Scoala generala",1035,562,548,13,1,546,16,1102,540,167,379,3,11813,0
29,"Neamt",124661,270,124661,,"TIMISESTI",519,"Scoala Generala",917,532,522,10,0,524,8,993,461,110,414,3,11813,0
29,"Neamt",124661,270,124661,,"TIMISESTI",520,"Scoala Generala",630,306,296,9,1,303,3,696,390,87,216,3,11813,0
29,"Neamt",124661,270,124661,,"TIMISESTI",521,"Scoala Generala",475,281,273,8,0,277,4,498,217,94,183,3,11813,0
29,"Neamt",124661,270,124661,,"TIMISESTI",522,"Scoala Generala",127,94,87,7,0,92,2,200,106,39,53,3,11813,0
29,"Neamt",124661,270,124661,,"TIMISESTI",523,"Scoala generala cu clasele I-VIII, sala de clasa nr.2",0,61,0,61,0,61,0,93,32,17,44,3,11813,1
29,"Neamt",124723,270,124723,,"TRIFESTI",524,"Scoala cu clasele I-VIII nr. 1",1863,866,841,25,0,849,17,1999,1133,285,564,3,11819,0
29,"Neamt",124723,270,124723,,"TRIFESTI",525,"Scoala cu clasele I-IV nr.2",747,440,401,39,0,435,5,794,354,167,268,3,11819,0
29,"Neamt",124723,270,124723,,"TRIFESTI",526,"Scoala cu clasele I-VIII nr.1",897,438,419,19,0,431,7,1005,567,125,306,3,11819,0
29,"Neamt",124723,270,124723,,"TRIFESTI",527,"Scoala cu clasele I-IV nr.2",665,391,364,27,0,381,10,708,317,123,258,3,11819,0
29,"Neamt",124723,270,124723,,"TRIFESTI",528,"Scoala cu clasele I-VIII",0,75,0,75,0,74,1,100,25,26,48,3,11819,1
29,"Neamt",124750,270,124750,,"TUPILATI",529,"Scoala cu clasele I-VIII",990,573,533,40,0,562,11,1096,523,167,395,3,11822,0
29,"Neamt",124750,270,124750,,"TUPILATI",530,"Magazin Lunca",562,344,325,19,0,333,11,598,254,95,238,3,11822,0
29,"Neamt",124750,270,124750,,"TUPILATI",531,"Scoala  cu clasele I-IV Totoiesti",283,145,134,11,0,142,3,300,155,40,102,3,11822,0
29,"Neamt",124750,270,124750,,"TUPILATI",532,"Caminul cultural",0,113,0,113,0,112,1,200,87,38,74,3,11822,1
29,"Neamt",124803,270,124803,,"TIBUCANI",533,"Scoala cu clasele I-VIII nr. 1, sala de gradinita, grupa pregatitoare",1398,780,770,10,0,766,14,1500,720,168,598,3,11809,0
29,"Neamt",124803,270,124803,,"TIBUCANI",534,"Scoala generala nr.3, sala clasei a VIII- a",879,498,465,32,1,492,6,1000,502,121,371,3,11809,0
29,"Neamt",124803,270,124803,,"TIBUCANI",535,"Scoala cu clasele I-VIII, corp A, sala clasei a VI-a",830,435,426,9,0,434,1,893,458,115,319,3,11809,0
29,"Neamt",124803,270,124803,,"TIBUCANI",536,"Scoala cu clasele I-IV, sala de clasa",348,240,208,32,0,236,4,399,159,69,167,3,11809,0
29,"Neamt",124803,270,124803,,"TIBUCANI",537,"Scoala generala cu clasele I-VIII nr. 1",0,119,0,119,0,118,1,200,81,44,74,3,11809,1
29,"Neamt",124849,270,124849,,"URECHENI",538,"Scoala nr.1",968,398,374,24,0,393,5,987,589,183,210,3,11827,0
29,"Neamt",124849,270,124849,,"URECHENI",539,"Scoala nr.1",569,314,274,40,0,310,4,600,286,106,204,3,11827,0
29,"Neamt",124849,270,124849,,"URECHENI",540,"Scoala Fundatura",624,404,343,61,0,398,6,700,296,160,238,3,11827,0
29,"Neamt",124849,270,124849,,"URECHENI",541,"Gradinita Catuna",372,261,220,41,0,256,5,411,150,174,82,3,11827,0
29,"Neamt",124849,270,124849,,"URECHENI",542,"Scoala",736,387,368,19,0,382,5,801,414,180,202,3,11827,0
29,"Neamt",124849,270,124849,,"URECHENI",543,"Scoala generala, centru",0,51,0,51,0,50,1,101,50,21,29,3,11827,1
29,"Neamt",124885,270,124885,,"VALEA URSULUI",544,"Camin Cultural",751,363,343,20,0,358,5,795,432,110,248,3,11831,0
29,"Neamt",124885,270,124885,,"VALEA URSULUI",545,"Scoala",515,319,296,23,0,301,18,600,281,61,240,3,11831,0
29,"Neamt",124885,270,124885,,"VALEA URSULUI",546,"Scoala",849,512,486,26,0,499,13,990,478,150,349,3,11831,0
29,"Neamt",124885,270,124885,,"VALEA URSULUI",547,"Scoala",561,274,265,9,0,261,13,600,326,83,178,3,11831,0
29,"Neamt",124885,270,124885,,"VALEA URSULUI",548,"Scoala",282,188,168,20,0,181,7,300,112,60,121,3,11831,0
29,"Neamt",124885,270,124885,,"VALEA URSULUI",549,"Caminul cultural , sediul Punctului de Acces Public la Informatii",0,87,0,87,0,86,1,100,13,27,59,3,11831,1
29,"Neamt",125123,270,125123,,"VALENI",550,"Scoala cu clasele I-VIII, corp II, sat Valeni, nr. 317E",732,451,440,11,0,436,15,802,351,166,270,3,11837,0
29,"Neamt",125123,270,125123,,"VALENI",551,"Scoala cu clasele I-VIII, corp B, nr. 84A",553,336,324,12,0,322,14,381,45,61,261,3,11837,0
29,"Neamt",125123,270,125123,,"VALENI",552,"Biblioteca comunala, Valeni, nr. 317E",0,67,0,67,0,67,0,100,33,25,42,3,11837,1
29,"Neamt",125016,270,125016,,"VANATORI-NEAMT",553,"Scoala de Arte si Meserii, str. Stefan cel Mare, nr. 198",1566,744,712,32,0,736,8,1699,955,327,409,3,11842,0
29,"Neamt",125016,270,125016,,"VANATORI-NEAMT",554,"Gradinita nr.2, str. Vacarescu Ioan, nr. 46",1345,734,702,32,0,712,22,1397,663,309,403,3,11842,0
29,"Neamt",125016,270,125016,,"VANATORI-NEAMT",555,"Scoala Generala nr.2, str. Drehuta, nr. 1093",1330,729,695,34,0,698,31,1389,660,315,383,3,11842,0
29,"Neamt",125016,270,125016,,"VANATORI-NEAMT",556,"Sala de mese a Manastirii Sihastria, str. Secu, nr. 1510",160,66,51,15,0,56,10,200,134,36,20,3,11842,0
29,"Neamt",125016,270,125016,,"VANATORI-NEAMT",557,"Scoala Generala, str. Mitropolit Varlaam, nr. 128",977,527,500,27,0,518,9,994,467,226,292,3,11842,0
29,"Neamt",125016,270,125016,,"VANATORI-NEAMT",558,"Scoala Manastirea Neamt, Str. Arh. Chiriac Nicolau, nr. 34",202,130,114,16,0,126,4,300,170,52,74,3,11842,0
29,"Neamt",125016,270,125016,,"VANATORI-NEAMT",559,"Scoala generala, str. Erou Alexandru Moisii, nr. 210",1297,687,654,33,0,673,14,1396,709,296,377,3,11842,0
29,"Neamt",125016,270,125016,,"VANATORI-NEAMT",560,"Biblioteca comunala ""Arhimandrit Chiriac Nicolau"", str. Stefan cel Mare, nr. 223",0,101,0,101,0,99,2,202,101,44,55,3,11842,1
29,"Neamt",125061,270,125061,,"ZANESTI",561,"Gradinita Centru",1772,1002,976,26,0,973,29,1900,898,461,512,3,11847,0
29,"Neamt",125061,270,125061,,"ZANESTI",562,"Scoala nr.1, cladirea noua",1431,928,877,51,0,900,28,1500,572,493,407,3,11847,0
29,"Neamt",125061,270,125061,,"ZANESTI",563,"Cantina ""Sfantul Ilie"" Fauri",1029,603,563,40,0,587,16,1100,497,297,290,3,11847,0
29,"Neamt",125061,270,125061,,"ZANESTI",564,"Scoala generala,  cladirea noua",815,537,526,11,0,528,9,900,363,298,230,3,11847,0
29,"Neamt",125061,270,125061,,"ZANESTI",565,"Gradinita nr. 2, centru",0,103,0,103,0,100,3,200,97,61,39,3,11847,1
30,"Olt",125347,289,125347,,"MUNICIPIUL SLATINA",1,"Colegiul National Radu Greceanu Str. Nicolae Balcescu nr. 8",1420,800,788,12,0,794,6,1567,767,332,462,1,11851,0
30,"Olt",125347,289,125347,,"MUNICIPIUL SLATINA",2,"Colegiul National Radu Greceanu Str. Nicolae Balcescu nr. 8",1254,696,684,12,0,684,12,1383,687,298,386,1,11851,0
30,"Olt",125347,289,125347,,"MUNICIPIUL SLATINA",3,"Colegiul National Radu Greceanu Str. Nicolae Balcescu nr. 8",1962,1317,1292,25,0,1257,60,2161,844,667,590,1,11851,0
30,"Olt",125347,289,125347,,"MUNICIPIUL SLATINA",4,"Scoala generala nr. 1 Str. Ion Morosanu nr. 2",1247,813,779,18,16,805,8,1375,562,333,472,1,11851,0
30,"Olt",125347,289,125347,,"MUNICIPIUL SLATINA",5,"Scoala generala nr. 1 Str. Ion Morosanu nr. 2",897,569,557,12,0,561,8,990,421,228,333,1,11851,0
30,"Olt",125347,289,125347,,"MUNICIPIUL SLATINA",6,"Colegiul National Ion Minulescu  Str. Basarabilor nr. 37",1660,903,890,12,1,894,9,1830,927,435,459,1,11851,0
30,"Olt",125347,289,125347,,"MUNICIPIUL SLATINA",7,"Colegiul National Ion Minulescu  Str. Basarabilor nr. 37",1749,912,891,21,0,896,16,1929,1017,453,443,1,11851,0
30,"Olt",125347,289,125347,,"MUNICIPIUL SLATINA",8,"Colegiul National Ion Minulescu  Str. Basarabilor nr. 37",1398,823,811,11,1,813,10,1542,719,408,405,1,11851,0
30,"Olt",125347,289,125347,,"MUNICIPIUL SLATINA",9,"Colegiul National Ion Minulescu  Str. Basarabilor nr. 37",1390,836,821,15,0,823,13,1531,695,378,445,1,11851,0
30,"Olt",125347,289,125347,,"MUNICIPIUL SLATINA",10,"Scoala generala Stefan Protopopescu (nr.2)   Str. Arinului nr.1",2000,1077,1067,10,0,1069,8,2201,1124,546,523,1,11851,0
30,"Olt",125347,289,125347,,"MUNICIPIUL SLATINA",11,"Scoala generala Stefan Protopopescu (nr.2)   Str. Arinului nr.1",1964,992,971,21,0,980,12,2135,1143,545,435,1,11851,0
30,"Olt",125347,289,125347,,"MUNICIPIUL SLATINA",12,"Colegiul National Vocational Nicolae Titulescu  Aleea Rozelor nr. 5",1813,1038,1018,20,0,1027,11,1999,961,524,503,1,11851,0
30,"Olt",125347,289,125347,,"MUNICIPIUL SLATINA",13,"Colegiul National Vocational Nicolae Titulescu  Aleea Rozelor nr. 5",1692,990,977,12,1,982,8,1854,864,530,452,1,11851,0
30,"Olt",125347,289,125347,,"MUNICIPIUL SLATINA",14,"Colegiul National Vocational Nicolae Titulescu  Aleea Rozelor nr. 5",1441,825,815,10,0,811,14,1589,764,392,419,1,11851,0
30,"Olt",125347,289,125347,,"MUNICIPIUL SLATINA",15,"Scoala generala nr. 5  Str. Libertatii nr.5A",1794,1038,1017,11,10,1030,8,1978,940,417,613,1,11851,0
30,"Olt",125347,289,125347,,"MUNICIPIUL SLATINA",16,"Scoala generala nr. 5  Str. Libertatii nr.5A",1555,935,920,14,1,919,16,1723,788,409,510,1,11851,0
30,"Olt",125347,289,125347,,"MUNICIPIUL SLATINA",17,"Scoala generala Eugen Ionescu (nr.8)  Str.Unirii nr.1",1804,928,915,13,0,920,8,1989,1061,490,430,1,11851,0
30,"Olt",125347,289,125347,,"MUNICIPIUL SLATINA",18,"Scoala generala Eugen Ionescu (nr.8)  Str.Unirii nr.1",1438,806,795,10,1,798,8,1586,780,379,419,1,11851,0
30,"Olt",125347,289,125347,,"MUNICIPIUL SLATINA",19,"Scoala generala Eugen Ionescu (nr.8)  Str.Unirii nr.1",1382,712,699,12,1,705,7,1524,812,325,380,1,11851,0
30,"Olt",125347,289,125347,,"MUNICIPIUL SLATINA",20,"Colegiul National Vocational Nicolae Titulescu  (Sc. Gen.nr.10 )    Aleea Muncii nr. 4",1205,659,642,17,0,650,9,1329,670,339,311,1,11851,0
30,"Olt",125347,289,125347,,"MUNICIPIUL SLATINA",21,"Colegiul National Vocational Nicolae Titulescu  (Sc. Gen.nr.10 )    Aleea Muncii nr. 4",1439,783,771,12,0,774,9,1587,804,389,385,1,11851,0
30,"Olt",125347,289,125347,,"MUNICIPIUL SLATINA",22,"Scoala generala nr. 7  Aleea Înfratirii nr. 6",1849,972,961,11,0,965,7,2041,1069,490,475,1,11851,0
30,"Olt",125347,289,125347,,"MUNICIPIUL SLATINA",23,"Scoala generala nr. 7  Aleea Înfratirii nr. 6",1188,676,661,15,0,668,8,1311,635,320,348,1,11851,0
30,"Olt",125347,289,125347,,"MUNICIPIUL SLATINA",24,"Scoala generala nr. 7  Aleea Înfratirii nr. 6",1478,749,738,11,0,742,7,1630,881,370,372,1,11851,0
30,"Olt",125347,289,125347,,"MUNICIPIUL SLATINA",25,"Colegiul Economic P.S.Aurelian (textil)  Str. Primaverii nr.5",1270,715,702,13,0,710,5,1401,686,317,393,1,11851,0
30,"Olt",125347,289,125347,,"MUNICIPIUL SLATINA",26,"Colegiul Economic P.S.Aurelian (textil)  Str. Primaverii nr.5",1867,944,927,16,1,938,6,2059,1115,516,422,1,11851,0
30,"Olt",125347,289,125347,,"MUNICIPIUL SLATINA",27,"Liceul cu Program Sportiv  ( Sc. Gen.nr.4)  Str. Toamnei nr. 10",1998,1086,1044,42,0,1062,24,2200,1114,547,515,1,11851,0
30,"Olt",125347,289,125347,,"MUNICIPIUL SLATINA",28,"Liceul cu Program Sportiv  ( Sc. Gen.nr.4)  Str. Toamnei nr. 10",1799,983,968,15,0,972,11,1984,1001,488,484,1,11851,0
30,"Olt",125347,289,125347,,"MUNICIPIUL SLATINA",29,"Liceul cu Program Sportiv  ( Sc. Gen.nr.4)  Str. Toamnei nr. 10",1493,771,757,14,0,756,15,1646,875,378,378,1,11851,0
30,"Olt",125347,289,125347,,"MUNICIPIUL SLATINA",30,"Scoala generala nr. 3  Str. Ec. Teodoroiu nr.1B",1665,802,792,10,0,794,8,1836,1034,409,385,1,11851,0
30,"Olt",125347,289,125347,,"MUNICIPIUL SLATINA",31,"Scoala generala nr.3 Str.Ecaterina Teodoroiu,nr.1B",1624,849,841,8,0,839,10,1791,942,382,457,1,11851,0
30,"Olt",125347,289,125347,,"MUNICIPIUL SLATINA",32,"Scoala generala nr. 3  Str. Ec. Teodoroiu nr.1B",946,479,453,26,0,478,1,1043,564,238,240,1,11851,0
30,"Olt",125347,289,125347,,"MUNICIPIUL SLATINA",33,"Scoala generala nr. 3  Str. Ec. Teodoroiu nr.1B",1753,896,885,11,0,885,11,1934,1038,447,438,1,11851,0
30,"Olt",125347,289,125347,,"MUNICIPIUL SLATINA",34,"Grup Scolar Metalurgic  Str. Ec. Teodoroiu nr. 8A",1817,873,865,8,0,861,12,2001,1128,494,367,1,11851,0
30,"Olt",125347,289,125347,,"MUNICIPIUL SLATINA",35,"Grup Scolar Metalurgic  Str. Ec. Teodoroiu nr. 8A",1686,833,819,14,0,817,16,1859,1026,461,356,1,11851,0
30,"Olt",125347,289,125347,,"MUNICIPIUL SLATINA",36,"Grup Scolar Metalurgic  Str. Ec. Teodoroiu nr. 8A",693,399,384,15,0,391,8,765,366,164,227,1,11851,0
30,"Olt",125347,289,125347,,"MUNICIPIUL SLATINA",37,"Scoala generala nr. 11 Constantin Brâncoveanu (Draganeºti) Str. Draganeºti nr.11",1313,647,638,9,0,643,4,1448,801,357,286,1,11851,0
30,"Olt",125347,289,125347,,"MUNICIPIUL SLATINA",38,"Scoala generala nr. 11 Constantin Brâncoveanu (Draganeºti) Str. Draganeºti nr.11",1601,806,794,12,0,790,16,1766,960,467,323,1,11851,0
30,"Olt",125347,289,125347,,"MUNICIPIUL SLATINA",39,"Scoala generala nr. 11 Constantin Brâncoveanu (Plevnei)   Str. Plevnei nr. 4",1912,950,938,12,0,939,11,2108,1158,474,465,1,11851,0
30,"Olt",125347,289,125347,,"MUNICIPIUL SLATINA",40,"Scoala generala nr. 11 Constantin Brâncoveanu (Plevnei)   Str. Plevnei nr. 4",1601,884,873,11,0,877,7,1766,882,464,413,1,11851,0
30,"Olt",125347,289,125347,,"MUNICIPIUL SLATINA",41,"Scoala generala nr. 11 Constantin Brâncoveanu (Plevnei)   Str. Plevnei nr. 4",1776,939,927,12,0,931,8,1958,1019,490,441,1,11851,0
30,"Olt",125347,289,125347,,"MUNICIPIUL SLATINA",42,"Scoala generala nr. 6 ( Clocociov)  Str. Mânastirii nr.39",1211,791,774,17,0,782,9,1336,545,372,410,1,11851,0
30,"Olt",125347,289,125347,,"MUNICIPIUL SLATINA",43,"Grup Scolar Industrial Constructii Maºini  (I.P.T.A.P.A)  Str. Cireaºov nr.10",1718,869,853,16,0,865,4,1894,1025,504,361,1,11851,0
30,"Olt",125347,289,125347,,"MUNICIPIUL SLATINA",44,"Grup Scolar Industrial Constructii Maºini  (I.P.T.A.P.A)  Str. Cireaºov nr.10",1428,739,724,15,0,731,8,1575,836,413,318,1,11851,0
30,"Olt",125347,289,125347,,"MUNICIPIUL SLATINA",45,"Grup Scolar Industrial Constructii Maºini  (I.P.T.A.P.A)  Str. Cireaºov nr.10",1424,670,648,22,0,666,4,1570,900,368,298,1,11851,0
30,"Olt",125347,289,125347,,"MUNICIPIUL SLATINA",46,"Scoala Cireaºov  Str . Eroilor nr.39",1067,728,717,11,0,709,19,1177,449,319,390,1,11851,0
30,"Olt",125347,289,125347,,"MUNICIPIUL SLATINA",47,"Scoala generala nr. 12 George Poboran  Bulevardul A.I.Cuza nr. 29A",1376,736,718,18,0,724,12,1517,781,342,382,1,11851,0
30,"Olt",125347,289,125347,,"MUNICIPIUL SLATINA",48,"Scoala generala nr. 12 George Poboran  Bulevardul A.I.Cuza nr. 29A",1341,672,648,24,0,670,2,1405,733,335,335,1,11851,0
30,"Olt",125347,289,125347,,"MUNICIPIUL SLATINA",49,"Cladirea fostului Economat Strada Tudor Vladimirescu nr. 92B, CP 230087",0,964,0,964,0,954,10,1400,436,523,431,1,11851,1
30,"Olt",125472,289,125472,,"MUNICIPIUL CARACAL",50,"Colegiul National Ionita Asan, B-dul N.Titulescu, nr.19",1827,907,894,13,0,889,18,2014,1107,303,586,1,11854,0
30,"Olt",125472,289,125472,,"MUNICIPIUL CARACAL",51,"Gradinita cu program prelungit nr. 1, Bdul N.Titulescu, nr.2",1813,847,827,20,0,834,13,2001,1154,276,558,1,11854,0
30,"Olt",125472,289,125472,,"MUNICIPIUL CARACAL",52,"Gradinita cu program normal nr. 4, B-dul N.Titulescu, nr.46",1788,884,868,16,0,876,8,1788,904,313,563,1,11854,0
30,"Olt",125472,289,125472,,"MUNICIPIUL CARACAL",53,"Scoala Generala nr. 6, str.V.Alecsandri, nr.11",1997,929,907,22,0,919,10,2201,1272,317,602,1,11854,0
30,"Olt",125472,289,125472,,"MUNICIPIUL CARACAL",54,"Liceul Mihai Viteazul (Clubul Sportiv),  str.Plevnei, nr.15",1738,854,846,8,0,839,15,1915,1061,287,552,1,11854,0
30,"Olt",125472,289,125472,,"MUNICIPIUL CARACAL",55,"Grupul Scolar Industrial, Al.1 Decembrie 1918 NR.9",1938,790,773,17,0,781,9,2143,1353,284,497,1,11854,0
30,"Olt",125472,289,125472,,"MUNICIPIUL CARACAL",56,"Gradinita cu program prelungit nr. 3, A.Cresei NR 6",1962,832,818,14,0,819,13,2161,1329,286,533,1,11854,0
30,"Olt",125472,289,125472,,"MUNICIPIUL CARACAL",57,"Scoala Generala nr. 7 (Sala de sport), str.Grl  Ghe Magheru, nr.13",1942,897,877,20,0,886,11,2140,1243,323,563,1,11854,0
30,"Olt",125472,289,125472,,"MUNICIPIUL CARACAL",58,"Scoala Generala nr. 7, str.Grl  Ghe Magheru, nr.13",1685,873,835,38,0,871,2,1859,986,316,555,1,11854,0
30,"Olt",125472,289,125472,,"MUNICIPIUL CARACAL",59,"Scoala Generala nr. 2, str.I.H.Radulescu, nr.2",1918,1002,987,15,0,994,8,2115,1113,352,642,1,11854,0
30,"Olt",125472,289,125472,,"MUNICIPIUL CARACAL",60,"Biblioteca Municipala Caracal, str.Iancu Jianu  nr.18A",1870,928,909,18,1,920,8,1960,1032,348,572,1,11854,0
30,"Olt",125472,289,125472,,"MUNICIPIUL CARACAL",61,"Biblioteca Municipala Caracal, str.Iancu Jianu  nr.18A",1939,966,953,13,0,962,4,2137,1171,321,641,1,11854,0
30,"Olt",125472,289,125472,,"MUNICIPIUL CARACAL",62,"Centrul Cultural Radu Serban, str.Cuza Voda, nr.8",1529,900,889,11,0,894,6,1686,786,340,554,1,11854,0
30,"Olt",125472,289,125472,,"MUNICIPIUL CARACAL",63,"Scoala Generala nr. 5, str.Radu Calomfirescu  nr.7",1868,1059,1036,22,1,1049,10,2059,1000,322,727,1,11854,0
30,"Olt",125472,289,125472,,"MUNICIPIUL CARACAL",64,"Scoala Generala nr. 4, str.G.Doja, nr.62",1763,1073,1062,11,0,1059,14,1943,870,428,631,1,11854,0
30,"Olt",125472,289,125472,,"MUNICIPIUL CARACAL",65,"Scoala Generala nr. 3, str.G.Doja, nr.93",1910,1114,1103,11,0,1097,17,2126,1012,325,772,1,11854,0
30,"Olt",125472,289,125472,,"MUNICIPIUL CARACAL",66,"Scoala Generala nr. 1, str.M.Viteazul, nr.2",1637,1005,985,20,0,992,13,1805,800,380,612,1,11854,0
30,"Olt",125472,289,125472,,"MUNICIPIUL CARACAL",67,"Statia C.F.R. Caracal Strada Walter M?r?cineanu, nr. 2, CP 235200",0,622,0,622,0,616,6,1121,499,268,348,1,11854,1
30,"Olt",125418,289,125418,,"ORAS BALS",68,"Scoala generala nr. 3 Romana, Str. Crinilor nr. 1",982,606,596,10,0,589,17,1097,491,297,292,1,11856,0
30,"Olt",125418,289,125418,,"ORAS BALS",69,"Scoala generala nr. 2 Vartina, Str. Tudor Vladimirescu nr. 140",1265,724,713,11,0,708,16,1395,671,320,388,1,11856,0
30,"Olt",125418,289,125418,,"ORAS BALS",70,"Garda de Interventie nr. 2, Bals, apartinand ISU OLT, Str.Ciresului nr. 100",1012,590,584,6,0,580,10,1116,526,236,344,1,11856,0
30,"Olt",125418,289,125418,,"ORAS BALS",71,"Scoala Ajutatoare, Str. Plopului nr. 16",1918,983,973,10,0,964,19,2114,1131,405,559,1,11856,0
30,"Olt",125418,289,125418,,"ORAS BALS",72,"Biblioteca oraseneasca, Str. Nicolae Balcescu nr. 9",1634,835,827,8,0,830,5,1801,966,343,487,1,11856,0
30,"Olt",125418,289,125418,,"ORAS BALS",73,"Biblioteca oraseneasca, Str. Nicolae Balcescu nr. 9",1597,748,735,13,0,736,12,1760,1012,320,416,1,11856,0
30,"Olt",125418,289,125418,,"ORAS BALS",74,"Scoala Generala nr. 5, Str. Nicolae Balcescu   nr. 51",1735,841,830,11,0,827,14,1912,1071,351,476,1,11856,0
30,"Olt",125418,289,125418,,"ORAS BALS",75,"Scoala Generala nr. 5, Str. Nicolae Balcescu   nr. 51",1745,814,793,21,0,808,6,1923,1109,351,457,1,11856,0
30,"Olt",125418,289,125418,,"ORAS BALS",76,"Gradinita nr. 6, Str.Nicolae Balcescu nr 181",1058,475,453,22,0,470,5,1169,694,183,287,1,11856,0
30,"Olt",125418,289,125418,,"ORAS BALS",77,"Gradinita nr. 6, Str.Nicolae Balcescu nr 181",1709,742,722,19,1,734,8,1884,1142,294,440,1,11856,0
30,"Olt",125418,289,125418,,"ORAS BALS",78,"Grupul Scolar Industrial Constructii Masini, Str. Nicolae Balcescu nr. 213",1969,832,821,11,0,828,4,2171,1339,356,472,1,11856,0
30,"Olt",125418,289,125418,,"ORAS BALS",79,"Grupul Scolar Industrial Constructii Masini, Str. Nicolae Balcescu nr. 213",1136,521,469,52,0,515,6,1252,731,283,232,1,11856,0
30,"Olt",125418,289,125418,,"ORAS BALS",80,"Scoala  Generala Teis, Str.Teis nr 163",613,364,360,4,0,363,1,644,280,152,211,1,11856,0
30,"Olt",125418,289,125418,,"ORAS BALS",81,"Grupul scolar Agricol Bals Strada Nicolae B?lcescu, nr. 45-47, CP 235100",0,443,0,443,0,440,3,812,369,220,220,1,11856,1
30,"Olt",125542,289,125542,,"ORAS CORABIA",82,"Scoala cu cls. I -VIII nr.1, Str. Nicoale Titulescu nr. 68 A",1553,802,793,8,1,786,16,1712,910,302,484,1,11861,0
30,"Olt",125542,289,125542,,"ORAS CORABIA",83,"Scoala cu cls. I-VIII nr. 2 ,,Dumitru Buzdun"", Str. Dumitru Buzdun nr. 1, Corabia",1413,881,855,11,15,875,6,1557,676,337,538,1,11861,0
30,"Olt",125542,289,125542,,"ORAS CORABIA",84,"Scoala cu cls. I-VIII nr. 3, Str. Cuza Voda nr. 71",1236,553,542,11,0,547,6,1362,809,192,355,1,11861,0
30,"Olt",125542,289,125542,,"ORAS CORABIA",85,"Scoala cu cls. I-VIII nr. 3, Str. Cuza Voda nr. 71",1170,576,560,16,0,570,6,1289,713,199,371,1,11861,0
30,"Olt",125542,289,125542,,"ORAS CORABIA",86,"Scoala cu cls. I -VIII nr. 3, Str. Tudor Vladimirescu nr. 63,",1027,597,584,11,2,587,10,1132,535,200,387,1,11861,0
30,"Olt",125542,289,125542,,"ORAS CORABIA",87,"Colegiul National ,,Alexandru Ioan CUZA"", Str.1 Mai nr. 5,",1243,541,531,10,0,531,10,1368,827,175,356,1,11861,0
30,"Olt",125542,289,125542,,"ORAS CORABIA",88,"Colegiul National ,,Alexandru Ioan CUZA"", Str.1 Mai nr. 5,",1410,699,694,5,0,694,5,1554,855,222,472,1,11861,0
30,"Olt",125542,289,125542,,"ORAS CORABIA",89,"Scoala cu cls.I-VIII nr. 4, Str. Stefan Cel  Mare nr. 49,",1365,652,639,13,0,634,18,1504,852,211,423,1,11861,0
30,"Olt",125542,289,125542,,"ORAS CORABIA",90,"Scoala cu cls.I-VIII nr. 4, Str. Stefan Cel  Mare nr. 49,",1303,609,596,13,0,598,11,1436,827,206,392,1,11861,0
30,"Olt",125542,289,125542,,"ORAS CORABIA",91,"Scoala Corabia Veche, Str. Carpati  nr. 2,",1662,723,710,12,1,709,14,1832,1109,273,436,1,11861,0
30,"Olt",125542,289,125542,,"ORAS CORABIA",92,"Scoala cu cls. I-VIII Celeiu, Str. Libertatii nr. 22,",1577,854,842,5,7,846,8,1737,883,389,457,1,11861,0
30,"Olt",125542,289,125542,,"ORAS CORABIA",93,"Scoala cu cls.I-IV, Sat Vârtopu  (sat apartinttor Vârtop)",441,220,214,6,0,216,4,486,266,103,113,1,11861,0
30,"Olt",125542,289,125542,,"ORAS CORABIA",94,"Scoala Generala,  Tudor Vladimirescu, (sat apartinator Tudor Vladimirescu",554,320,314,6,0,318,2,611,291,160,158,1,11861,0
30,"Olt",125542,289,125542,,"ORAS CORABIA",95,"Scoala cu cls. I - IV Silistioara, Str. Plopilor,",482,315,303,4,8,312,3,531,216,151,161,1,11861,0
30,"Olt",125542,289,125542,,"ORAS CORABIA",96,"Scoala cu clasele I-VIII nr.2 ""Dumitru Buzdun"" ,str.Dumitru Buzdun,nr.1, sala nr. 2 (lânga autogara) CP 235300",0,374,0,374,0,367,7,997,623,152,215,1,11861,1
30,"Olt",125622,289,125622,,"ORAS DRAGANESTI-OLT",97,"Liceul ""Tudor Vladimirescu"", Str. Nicolae Titulescu, nr.129,",1787,883,868,15,0,863,20,1970,1087,424,439,1,11865,0
30,"Olt",125622,289,125622,,"ORAS DRAGANESTI-OLT",98,"Liceul ""Tudor Vladimirescu"", Str. Nicolae Titulescu, nr.129,",1791,835,824,11,0,828,7,1974,1139,374,454,1,11865,0
30,"Olt",125622,289,125622,,"ORAS DRAGANESTI-OLT",99,"Scoala Generala clasele I-VIII, Str. Nicolae Titulescu, nr.308,",1178,554,542,12,0,539,15,1298,744,222,317,1,11865,0
30,"Olt",125622,289,125622,,"ORAS DRAGANESTI-OLT",100,"Scoala Generala clasele I-VIII, Str. Nicolae Titulescu, nr.308,",913,374,367,7,0,362,12,1006,632,164,198,1,11865,0
30,"Olt",125622,289,125622,,"ORAS DRAGANESTI-OLT",101,"Localul fostei Gradinite de copii nr.3 (fosta APIA), Str. Nicolae Titulescu, nr.60A,",1823,943,928,15,0,930,13,2009,1066,422,508,1,11865,0
30,"Olt",125622,289,125622,,"ORAS DRAGANESTI-OLT",102,"Scoala Generala clasele I-VIII, Str. Vadul Cumanilor, nr.102,",1209,605,588,17,0,592,13,1332,727,312,280,1,11865,0
30,"Olt",125622,289,125622,,"ORAS DRAGANESTI-OLT",103,"Scoala Generala clasele I-VIII, Str. Vadul Cumanilor, nr.102,",1382,724,717,7,0,719,5,1506,782,402,317,1,11865,0
30,"Olt",125622,289,125622,,"ORAS DRAGANESTI-OLT",104,"Casa de Cultura ""Ileana Constantinescu"" Strada Nicolae Titulescu nr.253, CP 235400",0,275,0,275,0,271,4,700,425,152,119,1,11865,1
30,"Olt",128105,289,128105,,"ORAS PIATRA-OLT",105,"Muzeul Piatra Olt, Sala nr. 1,  Str. Aleea Tineretului, nr.1,",950,545,530,10,5,532,13,1047,502,156,376,1,11868,0
30,"Olt",128105,289,128105,,"ORAS PIATRA-OLT",106,"Muzeul Piatra Olt, Sala nr. 2,  Str. Aleea Tineretului, nr.1,",896,558,529,15,14,553,5,987,429,149,404,1,11868,0
30,"Olt",128105,289,128105,,"ORAS PIATRA-OLT",107,"Gradinita Piatra, Str. Traian, nr.154, Sat apartinator Piatra",1736,1213,1189,6,18,1206,7,1913,700,430,776,1,11868,0
30,"Olt",128105,289,128105,,"ORAS PIATRA-OLT",108,"Gradinita cu Program Normal, Str. Argeseanu, nr.6A, Sat apartinator Criva",886,655,636,15,4,646,9,980,325,251,395,1,11868,0
30,"Olt",128105,289,128105,,"ORAS PIATRA-OLT",109,"Gradinita cu Program Normal, str. Nitulesti, nr.49, Sat apartinator Enosesti",278,209,196,9,4,207,2,306,97,60,147,1,11868,0
30,"Olt",128105,289,128105,,"ORAS PIATRA-OLT",110,"Scoala Generala cu clasele I - IV Bistrita Noua, Str. Padurea Sarului, nr.15, Sat apartinator Bistrita Noua",478,331,321,10,0,328,3,527,196,120,208,1,11868,0
30,"Olt",128105,289,128105,,"ORAS PIATRA-OLT",111,"Gradinita  Piatra,  Strada Traian, nr.154 (Sat apartinator Piatra), sala nr. 2, CP 235505",0,294,0,294,0,293,1,997,703,120,173,1,11868,1
30,"Olt",128374,289,128374,,"ORAS POTCOAVA",112,"Scoala cu clasele I - IV Falcoeni, Sat apartinator Potcoava Falcoeni",814,560,547,13,0,556,4,897,337,259,297,1,11875,0
30,"Olt",128374,289,128374,,"ORAS POTCOAVA",113,"Liceul Potcoava,Scoala cu cls. I-IV",1158,727,716,11,0,723,4,1276,549,326,397,1,11875,0
30,"Olt",128374,289,128374,,"ORAS POTCOAVA",114,"Liceul Potcoava,Scoala cu cls.I-IV",1219,775,746,29,0,764,11,1343,568,308,456,1,11875,0
30,"Olt",128374,289,128374,,"ORAS POTCOAVA",115,"Scoala Generala Sinesti",1611,1090,1066,24,0,1076,14,1775,685,497,579,1,11875,0
30,"Olt",128374,289,128374,,"ORAS POTCOAVA",116,"Liceul Teoretic Potcoava, Strada Principala, CP 237355",0,509,0,509,0,504,5,1000,491,274,230,1,11875,1
30,"Olt",128711,289,128711,,"ORAS SCORNICESTI",117,"Grupul Scolar Agricol Scornicesti, Str.Pompierilor nr.17",1994,954,946,8,0,938,16,2198,1244,360,578,1,11881,0
30,"Olt",128711,289,128711,,"ORAS SCORNICESTI",118,"Scoala Generala cu cls.I-VIII Scornicesti, Bulevardul Muncii nr. 54",1964,886,861,25,0,874,12,2165,1279,335,539,1,11881,0
30,"Olt",128711,289,128711,,"ORAS SCORNICESTI",119,"Scoala generala cu clasele I-VIII Margineni",1589,889,877,12,0,863,26,1751,862,356,507,1,11881,0
30,"Olt",128711,289,128711,,"ORAS SCORNICESTI",120,"Scoala cu cls.I-VIII Negreni",1040,579,570,9,0,577,2,1146,567,154,423,1,11881,0
30,"Olt",128711,289,128711,,"ORAS SCORNICESTI",121,"Scoala cu cls.I-VIII Bircii",892,512,498,14,0,508,4,983,471,248,260,1,11881,0
30,"Olt",128711,289,128711,,"ORAS SCORNICESTI",122,"Gradinita Mogosesti",465,304,295,9,0,299,5,512,208,142,157,1,11881,0
30,"Olt",128711,289,128711,,"ORAS SCORNICESTI",123,"Scoala cu clasele I-IV  Constantinesti",443,322,311,11,0,318,4,488,166,75,243,1,11881,0
30,"Olt",128711,289,128711,,"ORAS SCORNICESTI",124,"Gradinita Teius",526,340,324,16,0,334,6,580,240,97,237,1,11881,0
30,"Olt",128711,289,128711,,"ORAS SCORNICESTI",125,"Gradinita Suica",212,146,138,8,0,144,2,234,88,61,83,1,11881,0
30,"Olt",128711,289,128711,,"ORAS SCORNICESTI",126,"Scoala Generala cu cls.I-VIII Jitaru",807,443,429,14,0,434,9,889,446,144,290,1,11881,0
30,"Olt",128711,289,128711,,"ORAS SCORNICESTI",127,"Scoala Generala I-IV Chiteasca",353,227,217,10,0,221,6,380,153,55,166,1,11881,0
30,"Olt",128711,289,128711,,"ORAS SCORNICESTI",128,"Scoala Generala ""Ion Popescu"" Negreni,CP 235609",0,281,0,281,0,280,1,1000,719,99,181,1,11881,1
30,"Olt",125677,289,125677,,"BALDOVINESTI",129,"Scoala cu clasele I - VIII Baldovinesti, Sat Baldovinesti",572,400,379,8,13,395,5,630,230,173,222,3,11898,0
30,"Olt",125677,289,125677,,"BALDOVINESTI",130,"Scoala cu clasele I - IV Pietris, Sat Pietris",302,200,190,5,5,197,3,333,133,51,146,3,11898,0
30,"Olt",125677,289,125677,,"BALDOVINESTI",131,"Scoala cu clasele I - IV Gubandru, Sat Gubandru",116,91,76,9,6,91,0,126,35,19,72,3,11898,0
30,"Olt",125677,289,125677,,"BALDOVINESTI",132,"Fostul sediu al Prim?riei Baldovinesti, CP 237005",0,160,0,160,0,159,1,380,220,50,109,3,11898,1
30,"Olt",125659,289,125659,,"BABICIU",133,"Caminul Cultural Babiciu, Str. Caracal nr. 95, Sat Babiciu",971,678,635,11,32,669,9,1070,392,197,472,3,11896,0
30,"Olt",125659,289,125659,,"BABICIU",134,"Scoala Generala cu clasele I-VIII ""Mihai Viteazul"", Str. Caracal nr. 107, Sat Babiciu",884,578,555,5,18,572,6,973,395,169,403,3,11896,0
30,"Olt",125659,289,125659,,"BABICIU",135,"Caminul Cultural Babiciu, sala mica, Sat Babiciu, CP 237015",0,167,0,167,0,163,4,370,203,68,95,3,11896,1
30,"Olt",130286,289,130286,,"BALTENI",136,"Scoala Generala ""Ion Graure"" Balteni",1381,973,934,21,18,957,16,1521,548,292,665,3,11902,0
30,"Olt",130286,289,130286,,"BALTENI",137,"Dispensarul Comunal Balteni , Sat Balteni, CP 237331",0,224,0,224,0,220,4,351,127,91,129,3,11902,1
30,"Olt",125757,289,125757,,"BARASTI",138,"Scoala cu clasele I - VIII Barastii de Vede, Sat Barastii de Vede",786,615,575,7,33,609,6,866,251,282,327,3,11904,0
30,"Olt",125757,289,125757,,"BARASTI",139,"Scoala cu clasele I - IV Barastii de Cepturi, Sat Barastii de Cepturi",509,386,349,10,27,382,4,565,179,118,264,3,11904,0
30,"Olt",125757,289,125757,,"BARASTI",140,"Sediul Brigazii Agricole ( Sediul fostei Societat Agricole ""Avântul""), Satul Motoiesti",78,66,56,9,1,64,2,86,20,13,51,3,11904,0
30,"Olt",125757,289,125757,,"BARASTI",141,"Scoala Generala cu clasele I-VIII Barastii de Vede,sat Barastii de Vede,CP 237020",0,486,0,486,0,484,2,690,204,205,279,3,11904,1
30,"Olt",125846,289,125846,,"BARZA",142,"Scoala cu clasele I - VIII Bîrza, Str. Teilor, nr. 83, Sat Bîrza",901,537,525,12,0,533,4,993,456,176,357,3,11913,0
30,"Olt",125846,289,125846,,"BARZA",143,"Scoala cu clasele I - VIII Branet, STRADA Cantonului, nr. 6, Sat Branet",1234,722,711,11,0,714,8,1360,638,281,433,3,11913,0
30,"Olt",125846,289,125846,,"BARZA",144,"Scoala Generala Branet, Sat Branet, CP 237030",0,108,0,108,0,105,3,150,42,37,68,3,11913,1
30,"Olt",125873,289,125873,,"BOBICESTI",145,"Caminul Cultural Leotesti, Sat Leotesti",1330,751,721,30,0,742,9,1470,719,383,359,3,11916,0
30,"Olt",125873,289,125873,,"BOBICESTI",146,"Scoala generala  cu cls. V-VIII Bobicesti, Sat Bobicesti",923,441,424,17,0,437,4,1020,579,234,203,3,11916,0
30,"Olt",125873,289,125873,,"BOBICESTI",147,"Scoala Generala Chintesti, Sat Chintesti",199,120,110,10,0,115,5,196,76,44,71,3,11916,0
30,"Olt",125873,289,125873,,"BOBICESTI",148,"Scoala Generala Bechet, Sat Bechet",276,185,169,16,0,180,5,300,115,73,107,3,11916,0
30,"Olt",125873,289,125873,,"BOBICESTI",149,"scoala cu clasele I-VIII Bobicesti, Strada DJ 42, Sat Bobicesti, CP 237035",0,117,0,117,0,117,0,191,74,56,61,3,11916,1
30,"Olt",125962,289,125962,,"BRASTAVATU",150,"Scoala de Arte si Meserii Brastavatu, Corpul I, Sala de clasa Biologie, Sat Brastavatu",1501,883,853,19,11,867,16,1653,770,517,350,3,11930,0
30,"Olt",125962,289,125962,,"BRASTAVATU",151,"Scoala de Arte si Meserii Brastavatu, Corpul II, Sala de clasa Rusa, Sat Brastavatu",1552,882,851,19,12,872,10,1710,828,488,384,3,11930,0
30,"Olt",125962,289,125962,,"BRASTAVATU",152,"Scoala Generala Crusovu, Corp I, Sala de Festivitati, Sat Crusovu",1016,541,532,8,1,534,7,1119,578,238,296,3,11930,0
30,"Olt",125962,289,125962,,"BRASTAVATU",153,"scoala de Arte si Meserii Brastavatu, Corp scoala I, Sala de sport, Sat Brastavatu, CP 237045",0,201,0,201,0,200,1,260,59,111,89,3,11930,1
30,"Olt",125999,289,125999,,"BREBENI",154,"Scoala cu clasele I -VIII Brebeni, sala 1, Sat Brebeni",1288,856,814,16,26,845,11,1425,569,527,318,3,11933,0
30,"Olt",125999,289,125999,,"BREBENI",155,"Scoala cu clasele I -VIII Brebeni, sala 2, Sat Brebeni",945,608,583,16,9,608,0,841,233,380,228,3,11933,0
30,"Olt",125999,289,125999,,"BREBENI",156,"Scoala cu clasele I-VIII Brebeni Sat Brebeni,CP 237055",0,567,0,567,0,556,11,622,55,346,210,3,11933,1
30,"Olt",126022,289,126022,,"BRANCOVENI",157,"Scoala ""Voievod Brîncoveanu"", Sat Brîncoveni",992,615,586,29,0,603,12,1093,478,225,378,3,11925,0
30,"Olt",126022,289,126022,,"BRANCOVENI",158,"Scoala ""Matei Basarab"", Sat Margheni",998,749,705,44,0,737,12,1100,351,378,359,3,11925,0
30,"Olt",126022,289,126022,,"BRANCOVENI",159,"Scoala ""Domnita Balasa"", Sat Valeni",405,273,262,11,0,265,8,446,173,64,201,3,11925,0
30,"Olt",126022,289,126022,,"BRANCOVENI",160,"Scoala ""Voievod Brâncoveanu""  Sat Brîncoveni, CP 237050",0,168,0,168,0,165,3,300,132,84,81,3,11925,1
30,"Olt",126077,289,126077,,"BUCINISU",161,"Scoala Generala cu clasele I-IV Bucinisu, Sala de clasa amplasata pe latura de sud-est a scolii,sat Bucinisu",1781,1030,1028,2,0,1019,11,1962,932,336,683,3,11936,0
30,"Olt",126077,289,126077,,"BUCINISU",162,"scoala Generala cu clasele V-VIII, sala nr. 3, Sat Bucinisu, CP 237060",0,123,0,123,0,123,0,151,28,44,79,3,11936,1
30,"Olt",130295,289,130295,,"CALUI",163,"scoala Generala cu clasele I - VIII Calui, STRADA Monumentul Eroilor numarul 2, Sat Calui",985,522,494,14,14,519,3,1082,560,168,351,3,11939,0
30,"Olt",130295,289,130295,,"CALUI",164,"scoala Generala cu clasele I - IV Gura Calui, STRADA Fratii Buzesti num?ru 133, Sat Gura C?lui",438,358,276,73,9,348,10,483,125,152,196,3,11939,0
30,"Olt",130295,289,130295,,"CALUI",165,"scoala General?a cu clasele I - VIII Calui, Sat Calui, CP 237291",0,126,0,126,0,125,1,360,234,35,90,3,11939,1
30,"Olt",126102,289,126102,,"CEZIENI",166,"Scoala Generala Cezieni, str.Principala, Sat Cezieni",1078,713,688,15,10,706,7,1188,475,127,579,3,11948,0
30,"Olt",126102,289,126102,,"CEZIENI",167,"Caminul Cultural Bondrea, Sat Bondrea",206,161,144,13,4,159,2,227,66,37,122,3,11948,0
30,"Olt",126102,289,126102,,"CEZIENI",168,"Centrul Social Corlatesti, Sat Corlatesti",299,211,193,9,9,209,2,330,119,46,163,3,11948,0
30,"Olt",126102,289,126102,,"CEZIENI",169," scoala Generala Cezieni, Strada Principala, Sat Cezieni, CP 237070",0,147,0,147,0,146,1,240,93,39,107,3,11948,1
30,"Olt",126148,289,126148,,"CILIENI",170,"Scoala Generala numarul 1 Cilieni, Sat Cilieni",1384,773,766,7,0,766,7,1524,751,271,495,3,11952,0
30,"Olt",126148,289,126148,,"CILIENI",171,"Scoala Generala numarul 1 Cilieni, Sat Cilieni",1437,724,719,5,0,715,9,1584,860,296,419,3,11952,0
30,"Olt",126148,289,126148,,"CILIENI",172,"Scoala Generala numarul 2 Cilieni, Sat CilieniCP 237075",0,115,0,115,0,114,1,130,15,53,61,3,11952,1
30,"Olt",126166,289,126166,,"CARLOGANI",173,"Scoala Generala cu clasele I - VIII, Sat Cîrlogani",1346,859,851,8,0,837,22,1488,629,457,380,3,11942,0
30,"Olt",126166,289,126166,,"CARLOGANI",174,"Scoala Generala cu clasele I - IV, Sat Cepari",756,577,522,55,0,566,11,833,256,345,221,3,11942,0
30,"Olt",126166,289,126166,,"CARLOGANI",175,"Scoala Generala cu clasele I-VIII Cârlogani,CP 237065",0,203,0,203,0,203,0,330,127,115,88,3,11942,1
30,"Olt",126228,289,126228,,"COLONESTI",176," Biblioteca comunala-Scoala Generala Colonesti, Sat Colonesti",698,484,468,10,6,480,4,769,285,335,145,3,11954,0
30,"Olt",126228,289,126228,,"COLONESTI",177,"Scoala Generala "" Maria Tudorache"", Sat Maruntei",357,284,244,31,9,279,5,392,108,139,140,3,11954,0
30,"Olt",126228,289,126228,,"COLONESTI",178,"Gradinita cu Program Normal Vlaici, Sat Vlaici",319,266,238,18,10,266,0,352,86,154,112,3,11954,0
30,"Olt",126228,289,126228,,"COLONESTI",179,"Gadinita cu Program Normal Batareni, Sat Batareni",156,131,112,17,2,130,1,172,41,109,21,3,11954,0
30,"Olt",126228,289,126228,,"COLONESTI",180,"Caminul Cultural ""Ilie Martin"" Colonesti,sat Colonesti,CP 237080",0,537,0,537,0,533,4,620,83,355,178,3,11954,1
30,"Olt",126326,289,126326,,"CORBU",181,"Scoala Generalacu clasele I - VIII Corbu, Sat Corbu",887,509,478,8,23,500,9,978,469,159,341,3,11964,0
30,"Olt",126326,289,126326,,"CORBU",182,"Scoala Generala cu clasele I - VIII Buzesti, Sat Buzesti",556,405,384,8,13,397,8,614,209,142,255,3,11964,0
30,"Olt",126326,289,126326,,"CORBU",183,"Scoala Generala Milcoveni",379,304,283,13,8,298,6,418,114,112,186,3,11964,0
30,"Olt",126326,289,126326,,"CORBU",184,"Scoala cu clasele I-VIII Corbu, corp B Sat Corbu, CP 237090",0,185,0,185,0,185,0,344,159,91,94,3,11964,1
30,"Olt",126380,289,126380,,"COTEANA",185,"Scoala cu clasele I - VIII Coteana, (Sala de clasa numarul 1), Sat Coteana",1004,904,904,0,0,899,5,1107,203,661,238,3,11970,0
30,"Olt",126380,289,126380,,"COTEANA",186,"Scoala cu clasele I - VIII Coteana, (Sala de clasa numarul 2), Sat Coteana",1057,960,960,0,0,953,7,1165,205,461,492,3,11970,0
30,"Olt",126380,289,126380,,"COTEANA",187,"Scoala Generala cu clasele I-VIII Coteana, clasa nr. 3 Sat Coteana, CP 237095",0,215,0,215,0,215,0,570,355,122,93,3,11970,1
30,"Olt",126406,289,126406,,"CRAMPOIA",188,"Scoala de Arte si Meserii Crîmpoia, Sat Crîmpoia",1176,820,807,13,0,810,10,1298,478,409,401,3,11972,0
30,"Olt",126406,289,126406,,"CRAMPOIA",189,"Scoala de Arte si Meserii Crîmpoia, Sat Crîmpoia",1168,793,784,9,0,783,10,1226,433,435,348,3,11972,0
30,"Olt",126406,289,126406,,"CRAMPOIA",190,"Scoala cu clasele I-IV Buta, Sat Buta",627,419,401,18,0,411,8,696,277,217,194,3,11972,0
30,"Olt",126406,289,126406,,"CRAMPOIA",191,"Scoala de Arte si Meserii Crâmpoia, corp B  Sat Crîmpoia, CP 237100",0,134,0,134,0,133,1,180,46,70,63,3,11972,1
30,"Olt",126503,289,126503,,"CUNGREA",192,"Scoala cu clasele I - VIII Cungrea, Sat Cungrea",839,514,500,14,0,508,6,900,386,302,206,3,11975,0
30,"Olt",126503,289,126503,,"CUNGREA",193,"Scoala cu clasele I - IV Otestii de Sus, Sat Otestii de Sus",722,553,516,37,0,550,3,796,243,309,241,3,11975,0
30,"Olt",126503,289,126503,,"CUNGREA",194,"Scoala cu clasele I - IV Spataru, Sat Spataru",270,196,178,18,0,196,0,298,102,102,94,3,11975,0
30,"Olt",126503,289,126503,,"CUNGREA",195,"Caminul Cultural Cungrea Sat Cungrea, CP 237105",0,290,0,290,0,287,3,305,15,230,57,3,11975,1
30,"Olt",126433,289,126433,,"CURTISOARA",196,"Scoala cu clasele I -VIII Curtisoara, Sat Curtisoara",1454,827,810,17,0,817,10,1602,775,346,471,3,11983,0
30,"Olt",126433,289,126433,,"CURTISOARA",197,"Scoala cu clasele I -VIII Dobrotinet, Sat Dobrotinet",1262,810,794,16,0,800,10,1391,581,332,468,3,11983,0
30,"Olt",126433,289,126433,,"CURTISOARA",198,"Scoala cu clasele I -IV Proaspeti, Sat Proaspeti",847,515,499,16,0,508,7,935,420,206,302,3,11983,0
30,"Olt",126433,289,126433,,"CURTISOARA",199,"Scoala cu clasele I-VIII Curtisoara Sat Curti?oara, CP 237115",0,370,0,370,0,368,2,521,151,204,164,3,11983,1
30,"Olt",126585,289,126585,,"DANEASA",200,"Caminul Cultural Daneasa, Sat Daneasa",1184,789,735,26,28,778,11,1304,515,396,382,3,11990,0
30,"Olt",126585,289,126585,,"DANEASA",201,"Scoala cu clasele I -VIII Berindei, Sat Berindei",481,325,309,12,4,321,4,530,205,91,230,3,11990,0
30,"Olt",126585,289,126585,,"DANEASA",202,"Gradinita cu Program Normal Cioflanu, Sat Cioflanu",514,318,291,12,15,309,9,565,247,111,198,3,11990,0
30,"Olt",126585,289,126585,,"DANEASA",203,"Scoala cu clasele I - IV Pestra, Sat Pestra",483,312,286,4,22,309,3,532,220,92,217,3,11990,0
30,"Olt",126585,289,126585,,"DANEASA",204,"Scoala cu clasele I - IV Zanoaga, Sat Zanoaga",351,252,241,11,0,242,10,386,134,100,142,3,11990,0
30,"Olt",126585,289,126585,,"DANEASA",205,"Caminul Cultural Daneasa Sat Daneasa, CP 237125",0,174,0,174,0,173,1,200,26,62,111,3,11990,1
30,"Olt",126647,289,126647,,"DEVESELU",206,"Scoala cu cls.I-VIII Deveselu, Sat Deveselu",1417,896,865,28,3,883,13,1558,662,498,385,3,11996,0
30,"Olt",126647,289,126647,,"DEVESELU",207,"Caminul Cultural Comanca, Sat Comanca",1057,632,615,13,4,624,8,1154,522,245,379,3,11996,0
30,"Olt",126647,289,126647,,"DEVESELU",208,"Asociatia de locatari ""Vulturii Deveselu"", Cartier Blocuri MApN, Sat Deveselu",255,106,90,16,0,104,2,282,176,53,51,3,11996,0
30,"Olt",126647,289,126647,,"DEVESELU",209,"Scoala cu clasele I-VIII , clasa a-III-a Sat Deveselu, CP 237130  ",0,110,0,110,0,110,0,203,93,66,44,3,11996,1
30,"Olt",126674,289,126674,,"DOBRETU",210,"Caminul Cultural Dobretu, Sat Curtisoara",708,392,380,11,1,387,5,780,388,197,190,3,11999,0
30,"Olt",126674,289,126674,,"DOBRETU",211,"Caminul Cultural Horezu, Sat Horezu",385,335,289,43,3,331,4,424,89,177,154,3,11999,0
30,"Olt",126674,289,126674,,"DOBRETU",212,"Gradinita cu Program Normal Dobretu Sat Dobre?u, CP 237135",0,128,0,128,0,127,1,190,62,59,68,3,11999,1
30,"Olt",126718,289,126718,,"DOBROSLOVENI",213,"Scoala cu clasele I - VIII Dobrosloveni, Sat Dobrosloveni",1141,714,692,10,12,707,7,1257,543,191,516,3,12003,0
30,"Olt",126718,289,126718,,"DOBROSLOVENI",214,"Scoala cu clasele I - VIII Resca, Sat Resca",969,667,641,14,12,649,18,1068,401,212,437,3,12003,0
30,"Olt",126718,289,126718,,"DOBROSLOVENI",215,"Scoala cu clasele I- IV Frasinet, Sat Frasinet",377,271,266,5,0,270,1,415,144,103,167,3,12003,0
30,"Olt",126718,289,126718,,"DOBROSLOVENI",216,"Scoala cu clasele I- IV Potopin, Sat Potopin",546,346,330,14,2,342,4,602,256,84,258,3,12003,0
30,"Olt",126718,289,126718,,"DOBROSLOVENI",217,"Caminul Cultural Dobrosloveni Sat Dobrosloveni, CP 237140",0,177,0,177,0,175,2,195,18,76,99,3,12003,1
30,"Olt",126772,289,126772,,"DOBROTEASA",218,"Caminul Cultural Dobroteasa,sala din partea de vest din corpul de cladire, Sat Dobroteasa",1504,980,972,8,0,965,15,1657,677,313,652,3,12009,0
30,"Olt",126772,289,126772,,"DOBROTEASA",219,"Scoala cu clasele I-IV Dobroteasa, sala nr. 1 Sat Dobroteasa, CP 237145",0,217,0,217,0,216,1,281,64,77,139,3,12009,1
30,"Olt",126825,289,126825,,"DOBRUN",220,"Scoala cu clasele I - VIII Dobrun, Sat Dobrun",623,427,399,13,15,426,1,687,260,111,315,3,12014,0
30,"Olt",126825,289,126825,,"DOBRUN",221,"Scoala cu clasele I -IV Rosienii Mari, Sat Rosienii Mari",650,490,431,22,37,484,6,716,226,132,352,3,12014,0
30,"Olt",126825,289,126825,,"DOBRUN",222,"Scoala Generala cu clasele I-IV Rosienii Mari , Sat Rosienii Mari, CP 237150",0,131,0,131,0,130,1,150,19,50,80,3,12014,1
30,"Olt",125490,289,125490,,"DRAGHICENI",223,"Scoala cu clasele I - VIII Draghiceni, Sat Draghiceni",1529,1067,1067,0,0,1059,8,1598,531,385,674,3,12020,0
30,"Olt",125490,289,125490,,"DRAGHICENI",224,"Scoala cu clasele I-VIII Draghiceni, corpul B , Sat Draghiceni, CP 237160  ",0,200,0,200,0,196,4,330,130,73,123,3,12020,1
30,"Olt",126905,289,126905,,"FAGETELU",225,"Scoala de Arte si Meserii Fagetelu, Sat Fagetelu",536,323,306,17,0,318,5,591,268,104,214,3,12024,0
30,"Olt",126905,289,126905,,"FAGETELU",226,"Scoala Generala Chilia, Sat Chilia",306,209,183,26,0,202,7,337,128,82,120,3,12024,0
30,"Olt",126905,289,126905,,"FAGETELU",227,"Scoala de Arte si Meserii Fagetelu Sat Fagetelu  CP 237165",0,291,0,291,0,288,3,308,17,127,161,3,12024,1
30,"Olt",126978,289,126978,,"FALCOIU",228,"Scoala cu clasele I - VIII Falcoiu, Sat Falcoiu",1029,617,574,5,38,608,9,1134,517,142,466,3,12031,0
30,"Olt",126978,289,126978,,"FALCOIU",229,"Scoala cu clasele I - VIII Facoiu, Sat Falcoiu",1022,585,532,10,43,571,14,1026,441,134,437,3,12031,0
30,"Olt",126978,289,126978,,"FALCOIU",230,"Scoala cu clasele I - VIII Cioroiu, Sat Cioroiu",1152,692,663,9,20,683,9,1263,571,234,449,3,12031,0
30,"Olt",126978,289,126978,,"FALCOIU",231,"Scoala Generala cu clasele I-VIII Falcoiu   Sediul nou, Sat Falcoiu, CP 237175",0,174,0,174,0,172,2,300,126,63,109,3,12031,1
30,"Olt",127019,289,127019,,"FARCASELE",232,"C?minul Cultural Farcasele, Sat Farcasele",1018,604,587,17,0,597,7,1135,531,304,293,3,12035,0
30,"Olt",127019,289,127019,,"FARCASELE",233,"Gradinita Farcasu de Jos, Sat Farcasu de Jos",1418,879,874,5,0,861,18,1563,684,419,442,3,12035,0
30,"Olt",127019,289,127019,,"FARCASELE",234,"Scoala cu clasele I- VIII Farcasele Sat Ghimpati",711,439,435,4,0,435,4,772,333,215,220,3,12035,0
30,"Olt",127019,289,127019,,"FARCASELE",235,"Scoala cu clasele I- VIII Hotarani, Sat Hotarani",723,477,465,12,0,471,6,797,320,190,281,3,12035,0
30,"Olt",127019,289,127019,,"FARCASELE",236,"Scoala cu clasele I-VIII Ghimpati Sat Ghimpati, CP 237182",0,187,0,187,0,185,2,259,72,72,113,3,12035,1
30,"Olt",127064,289,127064,,"GANEASA",237,"Scoala cu clasele I- VIII Ganeasa, Sat Ganeasa",1482,1078,1038,24,16,1065,13,1633,555,490,575,3,12040,0
30,"Olt",127064,289,127064,,"GANEASA",238,"Scoala cu clasele I- VIII Dranovatu, Sat Dranovatu",1027,798,768,23,7,787,11,1129,331,464,323,3,12040,0
30,"Olt",127064,289,127064,,"GANEASA",239,"Scoala cu clasele I - IV Izvoru, Sat Izvoru",562,469,456,6,7,466,3,619,150,254,212,3,12040,0
30,"Olt",127064,289,127064,,"GANEASA",240,"Scoala Ganeasa Sat Ganeasa, CP 237185  ",0,497,0,497,0,495,2,560,63,218,277,3,12040,1
30,"Olt",130302,289,130302,,"GAVANESTI",241,"Scoala cu clasele I - VIII Baleasa, Sat Baleasa",717,520,475,36,9,516,4,790,270,116,400,3,12049,0
30,"Olt",130302,289,130302,,"GAVANESTI",242,"Caminul Cultural Gavanesti, Sat Gavanesti",668,399,369,14,16,389,10,736,337,153,236,3,12049,0
30,"Olt",130302,289,130302,,"GAVANESTI",243,"Scoala cu clasele I - IV Brosteni, Sat Brosteni",293,195,186,9,0,190,5,323,128,75,115,3,12049,0
30,"Olt",130302,289,130302,,"GAVANESTI",244,"Scoala cu clasele I-VIII Gavanesti, Strada Principala, Sat Gavanesti, CP 237009",0,183,0,183,0,180,3,390,207,53,127,3,12049,1
30,"Olt",130311,289,130311,,"GHIMPETENI",245,"Scoala cu clasele I - VIII Ghimpeteni, Sat Ghimpeteni",891,632,577,14,41,626,6,981,349,275,351,3,12054,0
30,"Olt",130311,289,130311,,"GHIMPETENI",246,"Scoala cu clasele I - IV Ghimpetenii Noi",370,285,261,5,19,280,5,408,123,86,194,3,12054,0
30,"Olt",130311,289,130311,,"GHIMPETENI",247,"Scoala cu clasele I-VIII Ghimpeteni Sat Ghimpeteni, CP 237281",0,101,0,101,0,100,1,300,199,45,55,3,12054,1
30,"Olt",127126,289,127126,,"GIUVARASTI",248,"Scoala Generala Giuvarasti, Cabinetul de Limba Româna, Sat Giuvarasti",1054,600,594,6,0,590,10,1162,562,255,335,3,12057,0
30,"Olt",127126,289,127126,,"GIUVARASTI",249,"Scoala Generala Giuvarasti, Cabinetul de Matematica, Sat Giuvarasti",1059,617,610,7,0,606,11,1167,550,267,339,3,12057,0
30,"Olt",127126,289,127126,,"GIUVARASTI",250,"Scoala Generala Giuvarasti, Cabinetul de Matematica II Sat Giuvarasti CP 237195  ",0,89,0,89,0,88,1,180,91,40,48,3,12057,1
30,"Olt",125588,289,125588,,"GARCOV",251,"Gradinita cu Program Normal Gîrcov, Sat Gîrcov",1320,748,734,4,10,737,11,1455,707,363,374,3,12046,0
30,"Olt",125588,289,125588,,"GARCOV",252,"Scoala cu clasele I - VIII Ursa, Sat Ursa",839,387,384,3,0,378,9,925,538,136,242,3,12046,0
30,"Olt",125588,289,125588,,"GARCOV",253,"Gradinita cu Program Normal Gârcov, Sat Gîrcov, CP 237190",0,94,0,94,0,94,0,100,6,49,45,3,12046,1
30,"Olt",127144,289,127144,,"GOSTAVATU",254,"Scoala Generala Gostavatu, Strada Principala, Sat Gostavatu",1416,873,867,6,0,858,15,1561,688,167,691,3,12059,0
30,"Olt",127144,289,127144,,"GOSTAVATU",255,"Caminul Cultural Slaveni, Strada Principala, Sat Slaveni",1184,668,656,12,0,655,13,1312,644,173,482,3,12059,0
30,"Olt",127144,289,127144,,"GOSTAVATU",256,"Fostul sediu al Primariei Gostavatu, Sat Gostavatu CP 237200",0,141,0,141,0,140,1,189,48,51,89,3,12059,1
30,"Olt",127171,289,127171,,"GRADINARI",257,"Scoala Generala Gradinari, Sat Gradinari",848,571,563,6,2,564,7,835,264,255,309,3,12062,0
30,"Olt",127171,289,127171,,"GRADINARI",258,"Scoala cu clasele I - IV Petculesti, Sat Petculesti",772,423,415,8,0,413,10,851,428,293,120,3,12062,0
30,"Olt",127171,289,127171,,"GRADINARI",259,"Scoala cu clasele I - IV Satu Nou, Sat Satu Nou",235,188,159,29,0,187,1,259,71,101,86,3,12062,0
30,"Olt",127171,289,127171,,"GRADINARI",260,"Scoala Generala cu clasele I-VIII  Gradinari, Sat Gradinari, CP 237205  ",0,224,0,224,0,221,3,237,13,148,73,3,12062,1
30,"Olt",130320,289,130320,,"GRADINILE",261,"Caminul Cultural Gradinile, Str. Principala, Sat Gradinile",1264,946,883,8,55,938,8,1393,447,189,749,3,12067,0
30,"Olt",130320,289,130320,,"GRADINILE",262,"Scoala cu clasele I-VIII ""Neda Marinescu"" corpul B, Strada Principala, Sat Gradinile, CP 237447     ",0,145,0,145,0,143,2,190,45,37,106,3,12067,1
30,"Olt",127224,289,127224,,"GROJDIBODU",263,"Scoala Generala Veche Grojdibodu, Sala de clasa, Sat Grojdibodu",1040,737,713,17,7,722,15,1143,406,352,370,3,12071,0
30,"Olt",127224,289,127224,,"GROJDIBODU",264,"Scoala Generala Veche Grojdibodu, Sala de sport, Sat Grojdibodu",787,555,535,6,14,551,4,867,312,253,298,3,12071,0
30,"Olt",127224,289,127224,,"GROJDIBODU",265,"Gradinita cu Program Normal Hotaru, Sala de clasa, Sat Hotaru",724,534,505,11,18,520,14,798,264,201,319,3,12071,0
30,"Olt",127224,289,127224,,"GROJDIBODU",266,"Scoala Generala Veche Grojdibodu , Sat Grojdibodu, CP 237210   ",0,172,0,172,0,167,5,280,108,89,78,3,12071,1
30,"Olt",130339,289,130339,,"GURA PADINII",267,"C?minul Cultural Gura Padinii, Sat Gura Padinii",1547,1113,1032,16,65,1102,11,1704,591,498,604,3,12074,0
30,"Olt",130339,289,130339,,"GURA PADINII",268,"Caminul Cultural Gura Padinii, Sat Gura Padinii, CP 237306",0,87,0,87,0,87,0,201,114,40,47,3,12074,1
30,"Olt",127251,289,127251,,"IANCA",269,"Scoala Generala ""Ada Umbra"", Sat Ianca",1230,761,749,12,0,751,10,1354,593,365,386,3,12077,0
30,"Olt",127251,289,127251,,"IANCA",270,"Scoala Generala ""Ada Umbra"", Sat Ianca",1141,662,655,7,0,646,15,1257,595,253,393,3,12077,0
30,"Olt",127251,289,127251,,"IANCA",271,"Scoala de Arte si Meserii ""George Visan"" Potelu, Sat Potelu",1064,670,652,18,0,661,9,1175,505,290,371,3,12077,0
30,"Olt",127251,289,127251,,"IANCA",272,"Scoala de Arte si Meserii ""George Visan"" Potelu, Sat Potelu, CP 237216",0,186,0,186,0,186,0,190,4,89,97,3,12077,1
30,"Olt",127288,289,127288,,"IANCU JIANU",273,"Scoala Generala numarul 1 Iancu Jianu, (sala de clasa numarul 2, parter), Sat Iancu Jianu",1419,768,752,16,0,745,23,1565,797,241,504,3,12080,0
30,"Olt",127288,289,127288,,"IANCU JIANU",274,"Liceul Iancu Jianu, (Corp de cladire vechi, sala de clasa numarul 1, parter), sat Iancu Jianu",1389,711,705,6,0,701,10,1531,820,320,381,3,12080,0
30,"Olt",127288,289,127288,,"IANCU JIANU",275,"Scoala Generala Dobriceni, (Corp Cladire Veche, Sala de festivitati), Sat Dobriceni",765,392,380,12,0,390,2,843,451,173,217,3,12080,0
30,"Olt",127288,289,127288,,"IANCU JIANU",276,"Caminul Cultural Iancu Jianu, Strada Principala, Sat Iancu Jianu, CP 237220",0,143,0,143,0,143,0,239,96,42,101,3,12080,1
30,"Olt",127322,289,127322,,"ICOANA",277,"Scoala Generala Icoana, Sat Icoana",667,348,332,16,0,344,4,735,387,130,214,3,12084,0
30,"Olt",127322,289,127322,,"ICOANA",278,"Scoala Generala Ursoaia, Sat Ursoaia",600,409,372,37,0,403,6,661,252,292,111,3,12084,0
30,"Olt",127322,289,127322,,"ICOANA",279,"Caminul Cultural Floru, Sat Floru",420,279,243,36,0,277,2,463,184,119,158,3,12084,0
30,"Olt",127322,289,127322,,"ICOANA",280,"Dispensarul Uman Icoana, Sat Icoana, CP 237225",0,120,0,120,0,120,0,200,80,53,67,3,12084,1
30,"Olt",130348,289,130348,,"IPOTESTI",281,"Gradinita cu Program Normal Ipotesti, Str. Principala, nr.409 C",1217,787,775,12,0,770,17,1341,554,235,535,3,12088,0
30,"Olt",130348,289,130348,,"IPOTESTI",282,"Gradinita Ipotesti, STRADA Principala, nr.409 C, Sat Ipotesti, CP 237261",0,171,0,171,0,171,0,210,39,73,98,3,12088,1
30,"Olt",127368,289,127368,,"IZBICENI",283,"Gradinita cu Program Normal Izbiceni",1454,887,876,11,0,878,9,1602,715,421,457,3,12090,0
30,"Olt",127368,289,127368,,"IZBICENI",284,"Scoala Generala Noua Izbiceni, Sat Izbiceni",1552,934,907,27,0,929,5,1710,776,457,472,3,12090,0
30,"Olt",127368,289,127368,,"IZBICENI",285,"Scoala Generala Veche Izbiceni, Sat Izbiceni",1029,659,641,18,0,654,5,1129,470,290,364,3,12090,0
30,"Olt",127368,289,127368,,"IZBICENI",286,"Scoala Veche Izbiceni Sat Izbiceni, CP 237270",0,116,0,116,0,115,1,200,84,55,60,3,12090,1
30,"Olt",127386,289,127386,,"IZVOARELE",287,"Scoala cu clasele I - VIII Izvoarele, Sat Izvoarele",1190,549,538,11,0,538,11,1311,762,235,303,3,12092,0
30,"Olt",127386,289,127386,,"IZVOARELE",288,"Scoala cu clasele I - VIII Alimanesti, Sat Alimanesti",1732,1129,1119,10,0,1091,38,1909,780,490,601,3,12092,0
30,"Olt",127386,289,127386,,"IZVOARELE",289,"Scoala de Arte si Meserii Izvoarele, Sat Izvoarele, CP 237235  ",0,105,0,105,0,104,1,163,58,29,75,3,12092,1
30,"Olt",127411,289,127411,,"LELEASCA",290,"Caminul Cultural Leleasca, Sat Leleasca",584,339,337,2,0,334,5,644,305,73,261,3,12095,0
30,"Olt",127411,289,127411,,"LELEASCA",291,"Scoala Generala Tonesti, Sat Tonesti",323,275,224,51,0,269,6,356,81,164,105,3,12095,0
30,"Olt",127411,289,127411,,"LELEASCA",292,"Gradinita cu program normal Ursi, Sat Ursi",281,201,187,14,0,198,3,310,109,76,122,3,12095,0
30,"Olt",127411,289,127411,,"LELEASCA",293,"Scoala Generala Mierlicesti, Sat Mierlicesti",155,115,108,7,0,113,2,171,56,39,74,3,12095,0
30,"Olt",127411,289,127411,,"LELEASCA",294,"Caminul Cultural Leleasca, Sat Leleasca, CP 237240",0,308,0,308,0,305,3,580,272,133,172,3,12095,1
30,"Olt",127493,289,127493,,"MARUNTEI",295,"Scoala cu clasele I - VIII Maruntei (Cabinet Istorie),  Sat Maruntei",1076,497,489,8,0,490,7,1174,677,218,272,3,12103,0
30,"Olt",127493,289,127493,,"MARUNTEI",296,"Scoala cu clasele I - VIII Maruntei (Cabinet Franceza),  Sat Maruntei",1046,584,576,8,0,581,3,1153,569,309,272,3,12103,0
30,"Olt",127493,289,127493,,"MARUNTEI",297,"Scoala cu clasele I - VIII Balanesti,  Sat Balanesti",1172,618,598,20,0,605,13,1292,674,283,322,3,12103,0
30,"Olt",127493,289,127493,,"MARUNTEI",298,"Scoala cu clasele I - IV Malu Rosu,  Sat Malu Rosu",115,76,66,10,0,75,1,127,51,40,35,3,12103,0
30,"Olt",127493,289,127493,,"MARUNTEI",299,"Scoala cu clasele I-VIII Maruntei , Sat Maruntei, CP 237250",0,150,0,150,0,149,1,170,20,81,68,3,12103,1
30,"Olt",127536,289,127536,,"MIHAESTI",300,"Scoala cu clasele I - VIII Mihaesti, Sat Mihaesti",852,474,469,5,0,462,12,937,463,148,314,3,12107,0
30,"Olt",127536,289,127536,,"MIHAESTI",301,"Scoala cu clasele I - IV Busca, Sat Busca",632,398,395,3,0,392,6,697,299,203,189,3,12107,0
30,"Olt",127536,289,127536,,"MIHAESTI",302,"Scoala cu clasele I-VIII Mihaesti  Sat Mihaesti   CP 237255",0,174,0,174,0,174,0,210,36,41,133,3,12107,1
30,"Olt",127563,289,127563,,"MILCOV",303,"Caminul Cultural Ulmi, Sat Ulmi",552,377,358,19,0,371,6,608,231,111,260,3,12110,0
30,"Olt",127563,289,127563,,"MILCOV",304,"Scoala Generala cu clasele I - VIII Milcovu din Deal, Sat Milcovu din Deal",442,290,270,20,0,281,9,487,197,152,129,3,12110,0
30,"Olt",127563,289,127563,,"MILCOV",305,"Scoala Generaa cu clasele I - IV Milcovu din Vale, Sat Milcovu din Vale",217,172,159,13,0,168,4,239,67,75,93,3,12110,0
30,"Olt",127563,289,127563,,"MILCOV",306,"Scoala Generala cu clasele I-IV Ulmi, Strada Principala, CP 237260  ",0,274,0,274,0,271,3,370,96,128,143,3,12110,1
30,"Olt",127625,289,127625,,"MORUNGLAV",307,"Caminul Cultural Morunglav, Sala Mare, Sat Morunglav",1316,768,753,15,0,761,7,1440,672,363,398,3,12115,0
30,"Olt",127625,289,127625,,"MORUNGLAV",308,"Scoala Generala Morunesti, Sat Morunesti",562,359,352,7,0,353,6,619,260,128,225,3,12115,0
30,"Olt",127625,289,127625,,"MORUNGLAV",309,"Scoala Generala Barasti, Sat Barasti",327,215,198,17,0,208,7,360,145,61,147,3,12115,0
30,"Olt",127625,289,127625,,"MORUNGLAV",310,"Caminul Cultural Morunglav, Cabinet Director, Sat Morunglav, CP 237270",0,150,0,150,0,149,1,189,39,82,67,3,12115,1
30,"Olt",127689,289,127689,,"MOVILENI",311,"Scoala cu clasele I - VIII Movileni, Sat Movileni",987,620,611,9,0,608,12,1088,468,306,302,3,12121,0
30,"Olt",127689,289,127689,,"MOVILENI",312,"Scoala cu clasele I - VIII Movileni, Sat Movileni",856,558,539,19,0,548,10,900,342,269,279,3,12121,0
30,"Olt",127689,289,127689,,"MOVILENI",313,"Scoala cu clasele I - VIII Bacea, Sat Bacea",1054,673,667,6,0,656,17,1162,489,383,273,3,12121,0
30,"Olt",127689,289,127689,,"MOVILENI",314,"Scoala cu clasele I-VIII Movileni Sat Movileni, CP 237275",0,190,0,190,0,188,2,223,33,94,94,3,12121,1
30,"Olt",127714,289,127714,,"NICOLAE TITULESCU",315,"Scoala cu clasele I - VIII ""Nicolae Titulescu"", Sat Nicolae Titulescu",1096,780,700,23,57,768,12,1196,416,529,239,3,12124,0
30,"Olt",127714,289,127714,,"NICOLAE TITULESCU",316,"Scoala Generala cu clasele I-VIII Nicolae  Titulescu , Sat Nicolae Titulescu, CP 237280",0,153,0,153,0,150,3,201,48,108,42,3,12124,1
30,"Olt",127750,289,127750,,"OBARSIA",317,"Scoala Generala Obîrsia, Sat Obîrsia",660,458,430,7,21,453,5,727,269,94,359,3,12126,0
30,"Olt",127750,289,127750,,"OBARSIA",318,"Scoala Generala Obîrsia Noua, Sat Obîrsia Noua",1088,747,699,7,41,737,10,1200,453,294,443,3,12126,0
30,"Olt",127750,289,127750,,"OBARSIA",319,"Scoala GeneralaCîmpu Parului, Sat Cîmpu Parului",327,256,232,11,13,255,1,360,104,52,203,3,12126,0
30,"Olt",127750,289,127750,,"OBARSIA",320,"Scoala Generala Coteni, Sat Coteni",223,170,159,6,5,170,0,246,76,29,141,3,12126,0
30,"Olt",127750,289,127750,,"OBARSIA",321,"Scoala Generala Tabonu, Sat Tabonu",133,117,98,9,10,115,2,147,30,11,104,3,12126,0
30,"Olt",127750,289,127750,,"OBARSIA",322,"Scoala Generala Obârsia, Sat Obîrsia, CP 237285",0,133,0,133,0,133,0,289,156,51,82,3,12126,1
30,"Olt",127812,289,127812,,"OBOGA",323,"Caminul Cultural Oboga, Sat Oboga",1012,647,612,20,15,638,9,1108,461,139,499,3,12132,0
30,"Olt",127812,289,127812,,"OBOGA",324,"Scoala cu clasele I IV Oboga de Jos, Sat Oboga",420,313,266,36,11,305,8,463,150,55,250,3,12132,0
30,"Olt",127812,289,127812,,"OBOGA",325,"Scoala cu clasele I-VIII Oboga, Sat Oboga, CP 237290",0,171,0,171,0,170,1,238,67,33,137,3,12132,1
30,"Olt",127858,289,127858,,"OPORELU",326,"Caminul Cultural Oporelu, Sat Oporelu",992,675,652,4,19,671,4,1093,418,177,494,3,12134,0
30,"Olt",127858,289,127858,,"OPORELU",327,"Scoala cu clasele I-VIII Oporelu, Sat Oporelu, CP 237295",0,207,0,207,0,205,2,270,63,85,120,3,12134,1
30,"Olt",127901,289,127901,,"OPTASI-MAGURA",328,"Scoala cu cls.I-VIII  Optasi Magura, Sat Optasi",1101,980,955,7,18,962,18,1205,225,316,646,3,12139,0
30,"Olt",127901,289,127901,,"OPTASI-MAGURA",329,"Scoala cu clasele I-VIII Optasi-Magura, Sat Optasi-Magura, CP 237300",0,138,0,138,0,135,3,500,362,46,89,3,12139,1
30,"Olt",127938,289,127938,,"ORLEA",330,"Caminul Cultural Orlea, nr. 357A, Sat Orlea",1310,770,763,7,0,760,10,1444,674,345,415,3,12141,0
30,"Olt",127938,289,127938,,"ORLEA",331,"Caminul Cultural Orlea, nr. 357A, Sat Orlea",803,478,470,8,0,474,4,885,407,229,245,3,12141,0
30,"Olt",127938,289,127938,,"ORLEA",332,"Gradinita Orlea Noua, nr. 20A, Sat Orlea Noua, CP 237305",0,111,0,111,0,111,0,150,39,54,57,3,12141,1
30,"Olt",130357,289,130357,,"OSICA DE JOS",333,"Scoala cu clasele I - VIII Osica de Jos, Sat Osica de Jos",1285,937,882,19,36,917,20,1416,479,313,604,3,12144,0
30,"Olt",130357,289,130357,,"OSICA DE JOS",334,"Scoala cu clasele I-VIII Osica de Jos, Sat Osica de Jos, CP 237153",0,188,0,188,0,186,2,260,72,79,107,3,12144,1
30,"Olt",127983,289,127983,,"OSICA DE SUS",335,"Centrul Pentru Promovarea Sanatatii, Sat Vladuleni",442,276,263,13,0,273,3,487,211,124,149,3,12147,0
30,"Olt",127983,289,127983,,"OSICA DE SUS",336,"Casa Blanaru, Sat Osica de Sus",1112,611,592,19,0,604,7,1226,615,251,353,3,12147,0
30,"Olt",127983,289,127983,,"OSICA DE SUS",337,"Scoala Generala nr. 2 Osica de Sus, Sat Osica de Sus",1365,803,782,21,0,794,9,1505,702,279,515,3,12147,0
30,"Olt",127983,289,127983,,"OSICA DE SUS",338,"Scoala Generala Greci, Sat Greci",878,605,587,18,0,602,3,968,363,323,279,3,12147,0
30,"Olt",127983,289,127983,,"OSICA DE SUS",339,"Scoala Primara Tomeni, Sat Tomeni",346,154,143,11,0,148,6,381,227,61,87,3,12147,0
30,"Olt",127983,289,127983,,"OSICA DE SUS",340,"Caminul Cultural Vladuleni, Sat Vladuleni, CP 237315",0,195,0,195,0,193,2,250,55,75,118,3,12147,1
30,"Olt",128052,289,128052,,"PERIETI",341,"Caminul Cultural Perieti, Sala nr.1, Sat Perieti",1263,717,714,3,0,708,9,1292,575,276,432,3,12158,0
30,"Olt",128052,289,128052,,"PERIETI",342,"Caminul Cultural Perieti, Sala nr.2, Sat Perieti",489,329,310,12,7,324,5,539,210,127,197,3,12158,0
30,"Olt",128052,289,128052,,"PERIETI",343,"Gradinita  Perieti, Sat Perieti, CP 237330     ",0,240,0,240,0,238,2,260,20,136,102,3,12158,1
30,"Olt",128178,289,128178,,"PARSCOVENI",344,"Scoala cu clasele I - VIII Pîrscoveni, Sat Pîrscoveni",1404,809,780,26,3,801,8,1547,738,331,470,3,12154,0
30,"Olt",128178,289,128178,,"PARSCOVENI",345,"Scoala cu clasele I - VIII Olari, Sat Olari",1099,512,499,13,0,504,8,1211,699,180,324,3,12154,0
30,"Olt",128178,289,128178,,"PARSCOVENI",346,"Gradinita  cu Program Normal Pârscoveni, Sat Pîrscoveni, CP 237325",0,126,0,126,0,126,0,220,94,60,66,3,12154,1
30,"Olt",128221,289,128221,,"PLESOIU",347,"Scoala cu clasele I - VIII Plesoiu, Sat Plesoiu",1343,806,772,34,0,793,13,1480,674,313,480,3,12162,0
30,"Olt",128221,289,128221,,"PLESOIU",348,"Scoala cu clasele I - VIII Doba, Sat Doba",1156,918,889,29,0,899,19,1272,354,312,587,3,12162,0
30,"Olt",128221,289,128221,,"PLESOIU",349,"Caminul Cultural Plesoiu, Strada Principala nr. 165, Sat Plesoiu, CP 237335",0,166,0,166,0,164,2,190,24,68,96,3,12162,1
30,"Olt",128301,289,128301,,"POBORU",350,"Scoala cu clasele I - VIII Poboru, Sat Poboru",688,458,446,12,0,453,5,758,300,131,322,3,12170,0
30,"Olt",128301,289,128301,,"POBORU",351,"Scoala cu clasele I - VIII Cornatelu, Sat Cornatelu",839,554,535,19,0,540,14,926,372,259,281,3,12170,0
30,"Olt",128301,289,128301,,"POBORU",352,"Scoala cu clasele I - VIII Seaca, Sat Seaca",215,180,157,23,0,177,3,237,57,96,81,3,12170,0
30,"Olt",128301,289,128301,,"POBORU",353,"Scoala Generala Poboru, Sat Poboru, CP 237345",0,172,0,172,0,171,1,247,75,59,112,3,12170,1
30,"Olt",128436,289,128436,,"PRISEACA",354,"Scoala Generala Priseaca, Sat Priseaca",1495,927,922,5,0,908,19,1646,719,286,622,3,12177,0
30,"Olt",128436,289,128436,,"PRISEACA",355,"Scoala Generala cu clasele I-VIII Priseaca,sat Priseaca,CP 237360",0,300,0,300,0,294,6,360,60,119,175,3,12177,1
30,"Olt",128472,289,128472,,"RADOMIRESTI",356,"Caminul Cultural Radomiresti, Sat Radomiresti",1274,648,641,7,0,632,16,1404,756,263,369,3,12181,0
30,"Olt",128472,289,128472,,"RADOMIRESTI",357,"Scoala Veche Craciunei, Sat Craciunei",693,359,350,9,0,346,13,764,405,125,221,3,12181,0
30,"Olt",128472,289,128472,,"RADOMIRESTI",358,"Scoala Veche Calinesti, Sat Calinesti",883,428,419,9,0,423,5,973,545,152,271,3,12181,0
30,"Olt",128472,289,128472,,"RADOMIRESTI",359,"Scoala Generala Poiana, Sat Poiana",290,175,168,7,0,172,3,320,145,74,98,3,12181,0
30,"Olt",128472,289,128472,,"RADOMIRESTI",360,"Scoala Generala cu clasele I-VIII Radomiresti, Sat Radomiresti, CP 237365",0,138,0,138,0,138,0,160,22,61,77,3,12181,1
30,"Olt",128524,289,128524,,"REDEA",361,"Gradinita cu program normal, Sala numarul 1, Sat Redea",848,549,517,7,25,542,7,835,286,181,361,3,12186,0
30,"Olt",128524,289,128524,,"REDEA",362,"Gradinita cu program normal, Sala numarul 2, Sat Redea",958,635,605,14,16,627,8,906,271,192,435,3,12186,0
30,"Olt",128524,289,128524,,"REDEA",363,"Caminul Cultural Redisoara, Sat Redisoara",414,350,313,22,15,346,4,406,56,47,299,3,12186,0
30,"Olt",128524,289,128524,,"REDEA",364,"Caminul Cultural Valea Soarelui, Sat Valea Soarelui",241,202,187,10,5,197,5,265,63,33,164,3,12186,0
30,"Olt",128524,289,128524,,"REDEA",365,"Scoala Generala Redea, Sat Redea, CP 237370",0,390,0,390,0,388,2,430,40,90,298,3,12186,1
30,"Olt",128560,289,128560,,"ROTUNDA",366,"Sediul fostului CAP Rotunda, sala numarul 1, Str. Principala, nr. 529, Sat Rotunda",1207,828,820,8,0,811,17,1328,500,306,505,3,12190,0
30,"Olt",128560,289,128560,,"ROTUNDA",367,"Sediul fostului CAP Rotunda, sala numarul 2, Str. Principala, nr. 529, Sat Rotunda",1203,839,833,6,0,826,13,1326,487,295,531,3,12190,0
30,"Olt",128560,289,128560,,"ROTUNDA",368,"Caminul Cultural Rotunda, Sala Mica, Strada Principala nr. 537, Sat Rotunda, CP 237375",0,251,0,251,0,250,1,270,19,67,183,3,12190,1
30,"Olt",128588,289,128588,,"RUSANESTI",369,"Scoala Generala nr. 1, Sat Rusanesti",1317,760,635,122,3,746,14,1449,689,287,459,3,12192,0
30,"Olt",128588,289,128588,,"RUSANESTI",370,"Scoala Generala nr. 2, Sat Rusanesti",1444,785,663,118,4,771,14,1591,806,288,483,3,12192,0
30,"Olt",128588,289,128588,,"RUSANESTI",371,"Scoala Generala Jieni, Sat Jieni",984,567,541,25,1,555,12,1084,517,220,335,3,12192,0
30,"Olt",128588,289,128588,,"RUSANESTI",372,"Caminul Cultural Rusanesti, Strada Principala, Sat Rusanesti, CP 237380",0,166,0,166,0,166,0,180,14,60,106,3,12192,1
30,"Olt",130366,289,130366,,"SARBII - MAGURA",373,"Scoala Generala cu clasele I - VIII Vitanesti, Sat Vitanesti",848,813,796,17,0,807,6,935,122,217,590,3,12203,0
30,"Olt",130366,289,130366,,"SARBII - MAGURA",374,"Scoala Generala cu clasele I - IV Braniste, Sat Vitanesti",777,582,572,10,0,578,4,856,274,228,350,3,12203,0
30,"Olt",130366,289,130366,,"SARBII - MAGURA",375,"Scoala Generala cu clasele I-VIII Vitanesti, Sat Vitanesti, CP 237302",0,153,0,153,0,151,2,230,77,50,101,3,12203,1
30,"Olt",128613,289,128613,,"SCARISOARA",376,"Scoala Generala cu clasele I-VIII Scarisoara, Sat Scarisoara",1012,537,535,2,0,523,14,1126,589,296,227,3,12205,0
30,"Olt",128613,289,128613,,"SCARISOARA",377,"Scoala Generala cu clasele I-VIII Scarisoara, Sat Scarisoara",816,404,401,3,0,395,9,899,495,243,152,3,12205,0
30,"Olt",128613,289,128613,,"SCARISOARA",378,"Scoala Generala Plaviceni, Sat Plaviceni",594,358,338,20,0,355,3,655,297,151,204,3,12205,0
30,"Olt",128613,289,128613,,"SCARISOARA",379,"Caminul Cultural Scarisoara, Strada Principala, Sat Scarisoara, CP 237395",0,118,0,118,0,118,0,170,52,55,63,3,12205,1
30,"Olt",128659,289,128659,,"SCHITU",380,"Scoala Generala Schitu, Sat Schitu",1340,775,735,21,19,752,23,1477,702,294,458,3,12209,0
30,"Olt",128659,289,128659,,"SCHITU",381,"Scoala Generala Greci, Sat Greci",654,498,404,83,11,493,5,721,223,112,381,3,12209,0
30,"Olt",128659,289,128659,,"SCHITU",382,"Scoala Generala cu clasele I-IV Lisa, Sat Lisa",292,264,215,49,0,260,4,322,58,86,174,3,12209,0
30,"Olt",128659,289,128659,,"SCHITU",383,"Scoala cu clasele I-VIII Schitu, Sat Schitu, CP 237400",0,159,0,159,0,159,0,220,61,43,116,3,12209,1
30,"Olt",128864,289,128864,,"SEACA",384,"Gradinita cu Program Normal nr. 1 Seaca, Sala nr. 1, Sat Seaca",922,609,589,9,11,603,6,1016,407,163,440,3,12215,0
30,"Olt",128864,289,128864,,"SEACA",385,"Gradinita cu Program Normal nr. 1 Seaca, Sala nr. 2, Sat Seaca",851,543,520,12,11,537,6,938,395,146,391,3,12215,0
30,"Olt",128864,289,128864,,"SEACA",386,"Gradinita cu Program Normal nr. 1 Seaca, sala nr. 3, Sat Seaca, CP 237405   ",0,135,0,135,0,134,1,250,115,53,81,3,12215,1
30,"Olt",128882,289,128882,,"SAMBURESTI",387,"Scoala cu clasele I - VIII Sîmburesti",944,715,697,0,18,697,18,1038,323,281,416,3,12195,0
30,"Olt",128882,289,128882,,"SAMBURESTI",388,"Scoala cu clasele I-VIII Sâmburesti, Sat Sîmburesti, CP 237385",0,209,0,209,0,206,3,350,141,92,114,3,12195,1
30,"Olt",125374,289,125374,,"SLATIOARA",389,"Gradinita Slatioara, Sala A, Sat Slatioara",1172,808,770,18,20,803,5,1312,504,350,453,3,12221,0
30,"Olt",125374,289,125374,,"SLATIOARA",390,"Gradinita Slatioara, Sala B, Sat Slatioara",886,583,559,11,13,577,6,976,393,230,347,3,12221,0
30,"Olt",125374,289,125374,,"SLATIOARA",391,"Gradinita de copii Slatioara, Sala B, Sat Slatioara, CP 237410",0,222,0,222,0,221,1,240,18,93,128,3,12221,1
30,"Olt",128962,289,128962,,"SPINENI",392,"Scoala cu clasele I - VIII Alunisu, Sat Alunisu",437,263,261,2,0,255,8,431,168,135,120,3,12226,0
30,"Olt",128962,289,128962,,"SPINENI",393,"Caminul Cultural Profa, Sat Profa",492,289,286,3,0,282,7,540,251,157,125,3,12226,0
30,"Olt",128962,289,128962,,"SPINENI",394,"Caminul Cultural Spineni, Sat Spineni",622,393,387,6,0,385,8,686,293,165,220,3,12226,0
30,"Olt",128962,289,128962,,"SPINENI",395,"Scoala Generala Alunisu, Sat Alunisu, CP 237104  ",0,328,0,328,0,321,7,370,42,138,183,3,12226,1
30,"Olt",129040,289,129040,,"SPRANCENATA",396,"Caminul Cultural Viespesti (Catun Viespesti), Sat Sprîncenata",1677,727,715,12,0,716,11,1848,1121,291,425,3,12234,0
30,"Olt",129040,289,129040,,"SPRANCENATA",397,"Scoala Veche Frunzaru, Sat Frunzaru",601,330,314,16,0,323,7,662,332,97,226,3,12234,0
30,"Olt",129040,289,129040,,"SPRANCENATA",398,"Caminul Cultural Sprâncenata-Viespesti, Sat Sprîncenata, CP 237425",0,163,0,163,0,163,0,200,37,61,102,3,12234,1
30,"Olt",129095,289,129095,,"STOENESTI",399,"Caminul Cultural Stoenesti, Sat Stoenesti",1927,1383,1344,17,22,1361,22,2115,732,598,763,3,12242,0
30,"Olt",129095,289,129095,,"STOENESTI",400,"Dispensarul Uman Stoenesti, nr. 3, Sat Stoenesti, CP 237430",0,162,0,162,0,158,4,230,68,74,84,3,12242,1
30,"Olt",129111,289,129111,,"STOICANESTI",401,"Scoala cu clasele I - VIII Stoicanesti, Sat Stoicanesti",1287,740,734,6,0,732,8,1418,678,193,539,3,12244,0
30,"Olt",129111,289,129111,,"STOICANESTI",402,"Scoala cu clasele I - VIII Stoicanesti, Sat Stoicanesti",1207,693,693,0,0,688,5,1330,637,185,503,3,12244,0
30,"Olt",129111,289,129111,,"STOICANESTI",403,"Scoala cu clasele I - VIII Stoicanesti, Sat Stoicanesti, CP 237435",0,99,0,99,0,99,0,120,21,21,78,3,12244,1
30,"Olt",129139,289,129139,,"STREJESTI",404,"Biblioteca Casa Buzescu, Sat Streje?ti",899,571,554,17,0,559,12,990,419,165,394,3,12246,0
30,"Olt",129139,289,129139,,"STREJESTI",405,"Scoala cu clasele I - VIII Strejestii de Sus, Sat Strejestii de Sus",1361,950,921,29,0,932,18,1448,498,232,700,3,12246,0
30,"Olt",129139,289,129139,,"STREJESTI",406,"Gradinita cu Program Normal Colibasi, Sat Colibasi",372,299,276,23,0,298,1,410,111,139,159,3,12246,0
30,"Olt",129139,289,129139,,"STREJESTI",407,"Gradinita cu Program Normal Strejestii de jos, Sat Strejesti, CP 237440",0,174,0,174,0,172,2,310,136,76,96,3,12246,1
30,"Olt",129184,289,129184,,"STUDINA",408,"Caminul Cultural Studina, Sala Mica, Sat Studina",1364,842,821,7,14,835,7,1502,660,561,274,3,12251,0
30,"Olt",129184,289,129184,,"STUDINA",409,"Scoala Generala Studinita, Sala de clasa numarul 1, Sat Studinita",1006,625,610,14,1,620,5,1109,484,329,291,3,12251,0
30,"Olt",129184,289,129184,,"STUDINA",410,"Gradinita cu Program Normal Studina, Sat Studina, CP 237445",0,266,0,266,0,264,2,340,74,203,61,3,12251,1
30,"Olt",129246,289,129246,,"SERBANESTI",411,"Scoala ""Dumitru Popovici"" Serbanesti, Sat Serbanesti",937,587,579,8,0,572,15,1033,446,202,370,3,12217,0
30,"Olt",129246,289,129246,,"SERBANESTI",412,"Scoala ""Dumitru Popovici"" Serbanesti, Sat Serbanesti",919,590,583,7,0,573,17,1008,418,235,338,3,12217,0
30,"Olt",129246,289,129246,,"SERBANESTI",413,"Gradinita Serbanestii de Sus, Sat Serbanestii de Sus",593,356,350,6,0,344,12,654,298,109,235,3,12217,0
30,"Olt",129246,289,129246,,"SERBANESTI",414,"Scoala ""Dumitru Popovici"" Serbanesti, Cabinetul de biologie Sat Serbanesti, CP 237450",0,153,0,153,0,151,2,310,157,59,92,3,12217,1
30,"Olt",130384,289,130384,,"SOPARLITA",415,"Scoala Generala cu clasele I - VIII Sopîrlita, Str. Principala, Sat Sopîrlita",1114,834,767,11,56,824,10,1228,394,232,592,3,12224,0
30,"Olt",130384,289,130384,,"SOPARLITA",416,"Scoala Generala cu clasele I-VIII, Sat Sopîrlita, CP 237328",0,162,0,162,0,161,1,290,128,42,119,3,12224,1
30,"Olt",129282,289,129282,,"STEFAN CEL MARE",417,"Caminul Cultural Stefan Cel Mare, Sat Stefan cel Mare",1140,781,760,13,8,765,16,1252,471,311,454,3,12239,0
30,"Olt",129282,289,129282,,"STEFAN CEL MARE",418,"Gradinita cu Program Normal Ianca Noua, Sat Ianca Noua",514,338,314,18,6,331,7,566,228,107,224,3,12239,0
30,"Olt",129282,289,129282,,"STEFAN CEL MARE",419,"Caminul Cultural Stefan cel Mare, strada Principala,Sala mica , Sat Stefan cel Mare, CP 237455",0,123,0,123,0,123,0,189,66,46,77,3,12239,1
30,"Olt",129317,289,129317,,"TATULESTI",420,"Scoala cu clasele I - VIII Tatulesti, Sat Tatulesti",496,370,361,0,9,369,1,547,177,130,239,3,12254,0
30,"Olt",129317,289,129317,,"TATULESTI",421,"Scoala cu clasele I - IV Barbalai, Sat Barbalai",190,151,148,3,0,150,1,209,58,44,106,3,12254,0
30,"Olt",129317,289,129317,,"TATULESTI",422,"Scoala cu clasele I - IV Mircesti, Sat Mircesti",141,111,102,9,0,110,1,155,44,32,78,3,12254,0
30,"Olt",129317,289,129317,,"TATULESTI",423,"Scoala cu clasele I-VIII Tatulesti, Sat  Tatulesti, CP 237460",0,357,0,357,0,356,1,549,192,157,199,3,12254,1
30,"Olt",129380,289,129380,,"TESLUI",424,"Scoala Generala cu clasele I - VIII Teslui, Sat Cherlestii din Deal",1358,824,814,10,0,819,5,1497,673,401,418,3,12261,0
30,"Olt",129380,289,129380,,"TESLUI",425,"Scoala Generala cu clasele I - VIII Comanita, Sat Comanita",820,551,506,30,15,541,10,904,353,216,325,3,12261,0
30,"Olt",129380,289,129380,,"TESLUI",426,"Scoala Generala cu clasele I-VIII Teslui,  Sat Cherlestii din Deal, CP 237472    ",0,251,0,251,0,250,1,290,39,120,130,3,12261,1
30,"Olt",129460,289,129460,,"TIA MARE",427,"Scoala Generala Doanca, Sat Doanca",1080,658,651,7,0,650,8,1190,532,243,407,3,12269,0
30,"Olt",129460,289,129460,,"TIA MARE",428,"Gradinita cu Program Normal Potlogeni, Sat Potlogeni",1352,795,786,9,0,785,10,1490,695,251,534,3,12269,0
30,"Olt",129460,289,129460,,"TIA MARE",429,"Gradinita cu Program Normal Tia Mare, Sat Tia Mare",1327,821,804,17,0,809,12,1462,641,266,543,3,12269,0
30,"Olt",129460,289,129460,,"TIA MARE",430,"Gradinita cu program normal Tia Mare, Sat Tia Mare, CP 237480",0,122,0,122,0,122,0,140,18,53,69,3,12269,1
30,"Olt",129503,289,129503,,"TOPANA",431,"Scoala cu clasele I - VIII Topana, Sat Topana",334,214,214,0,0,210,4,369,155,115,95,3,12273,0
30,"Olt",129503,289,129503,,"TOPANA",432,"Scoala cu clasele I - IV Ungureni, Sat Ungureni",119,100,84,9,7,100,0,131,31,72,28,3,12273,0
30,"Olt",129503,289,129503,,"TOPANA",433,"Scoala cu clasele I - IV Cîndelesti, Sat Cîndelesti",95,95,87,8,0,82,13,106,11,76,6,3,12273,0
30,"Olt",129503,289,129503,,"TOPANA",434,"Gradinita Gojgarei, Sat Gojgarei",167,134,114,14,6,131,3,181,47,97,34,3,12273,0
30,"Olt",129503,289,129503,,"TOPANA",435,"Scoala Topana  Sat Topana, CP 237485",0,263,0,263,0,263,0,400,137,162,101,3,12273,1
30,"Olt",129567,289,129567,,"TRAIAN",436,"scoala Generala Nr. 2 Traian, sala Centrului de Documentare,  Sat Traian",1370,733,721,8,4,714,19,1510,777,215,499,3,12279,0
30,"Olt",129567,289,129567,,"TRAIAN",437,"Scoala Generala Nr. 2, sala de curs, Sat Traian",1246,626,608,8,10,618,8,1373,747,147,471,3,12279,0
30,"Olt",129567,289,129567,,"TRAIAN",438,"Caminul Cultural Traian, Sat Traian, CP 237490   ",0,77,0,77,0,77,0,160,83,17,60,3,12279,1
30,"Olt",129585,289,129585,,"TUFENI",439,"Scoala Veche Tufeni, Sat Tufeni",1388,874,818,4,52,860,14,1530,656,306,554,3,12281,0
30,"Olt",129585,289,129585,,"TUFENI",440,"Scoala cu clasele I - VIII Stoborasti, Sat Stoborasti",962,607,587,14,6,594,13,1060,453,269,325,3,12281,0
30,"Olt",129585,289,129585,,"TUFENI",441,"Scoala Veche Tufeni, Sat Tufeni, CP 237495",0,299,0,299,0,299,0,330,31,147,152,3,12281,1
30,"Olt",129629,289,129629,,"URZICA",442,"Scoala cu clasele I - VIII Urzica (cladirea din vecinatatea Primariei), Sat Urzica",1284,743,730,5,8,736,7,1420,677,313,423,3,12285,0
30,"Olt",129629,289,129629,,"URZICA",443,"Scoala cu clasele I - IV Stavaru (Scoala Noua), Sat Stavaru",705,403,391,9,3,395,8,777,374,155,240,3,12285,0
30,"Olt",129629,289,129629,,"URZICA",444,"Scoala Veche cu clasele I-VIII Urzica, Sat Urzica, CP 237500",0,95,0,95,0,94,1,220,125,42,52,3,12285,1
30,"Olt",129656,289,129656,,"VALEA MARE",445,"Scoala Generala Valea Mare, Sat Valea Mare",1355,709,689,12,8,701,8,1499,790,368,333,3,12296,0
30,"Olt",129656,289,129656,,"VALEA MARE",446,"Caminul Cultural Valea Mare, Sat Birca",665,399,383,12,4,391,8,733,334,235,156,3,12296,0
30,"Olt",129656,289,129656,,"VALEA MARE",447,"Scoala Generala Turia, Sat Turia",486,376,334,42,0,371,5,536,160,250,121,3,12296,0
30,"Olt",129656,289,129656,,"VALEA MARE",448,"Scoala Generala Zorleasca, Sat Zorleasca",550,415,401,14,0,412,3,601,186,240,172,3,12296,0
30,"Olt",129656,289,129656,,"VALEA MARE",449,"Cladirea Administrativa Turia, Sat Turia, CP 237505",0,227,0,227,0,227,0,560,333,134,93,3,12296,1
30,"Olt",129718,289,129718,,"VADASTRA",450,"Scoala cu clasele I-VIII Vadastra, Cabinetul de limba româna, Sat Vadastra",1287,936,847,11,78,926,10,1418,482,567,359,3,12288,0
30,"Olt",129718,289,129718,,"VADASTRA",451,"Scoala cu clasele I - VIII Vadastra, Cabinetul de matematica, Sat Vadastra, CP 237510  ",0,157,0,157,0,156,1,290,133,80,76,3,12288,1
30,"Olt",129745,289,129745,,"VADASTRITA",452,"Caminul Cultural Vadastrita, Sala numarul 1, Sat Vadastrita",1431,921,916,5,0,912,9,1577,656,488,424,3,12290,0
30,"Olt",129745,289,129745,,"VADASTRITA",453,"Caminul Cultural Vadastrita, Sala numarul 2, Sat Vadastrita",1438,992,983,9,0,985,7,1585,593,492,493,3,12290,0
30,"Olt",129745,289,129745,,"VADASTRITA",454,"Gradinita de copii Vadastrita, Sat Vadastrita, CP 237515",0,164,0,164,0,162,2,180,16,71,91,3,12290,1
30,"Olt",129763,289,129763,,"VALENI",455,"Scoala Generala Valeni, Sat Valeni",971,624,606,14,4,612,12,1070,446,187,425,3,12302,0
30,"Olt",129763,289,129763,,"VALENI",456,"Scoala Generala Valeni, Sat Valeni",947,577,554,15,8,568,9,1044,467,167,401,3,12302,0
30,"Olt",129763,289,129763,,"VALENI",457,"Scoala Generala Mandra, Sat Mandra",584,402,376,25,1,396,6,644,242,106,290,3,12302,0
30,"Olt",129763,289,129763,,"VALENI",458,"Scoala Generala Valeni, Sat Valeni, CP 237520",0,213,0,213,0,212,1,240,27,52,160,3,12302,1
30,"Olt",129816,289,129816,,"VERGULEASA",459,"Punct de lucru Primarie din Sat Cazanesti",714,476,468,8,0,468,8,787,311,256,212,3,12307,0
30,"Olt",129816,289,129816,,"VERGULEASA",460,"Caminul Cultural Poganu, Sat Poganu",1118,728,722,6,0,718,10,1232,504,259,459,3,12307,0
30,"Olt",129816,289,129816,,"VERGULEASA",461,"Scoala cu clasele I -IV Dumitresti, Sat Dumitresti",592,449,396,53,0,443,6,652,203,191,252,3,12307,0
30,"Olt",129816,289,129816,,"VERGULEASA",462,"Caminul Cultural Poganu  Sat Poganu, CP 237530",0,391,0,391,0,389,2,468,77,188,201,3,12307,1
30,"Olt",129898,289,129898,,"VISINA",463,"Gradinita cu Program Normal Visina, Sat Visina",1431,996,967,7,22,975,21,1577,581,390,585,3,12315,0
30,"Olt",129898,289,129898,,"VISINA",464,"Gradinita cu Program Normal Visina, Sat Visina",1231,870,840,12,18,858,12,1357,487,300,558,3,12315,0
30,"Olt",129898,289,129898,,"VISINA",465,"Gradinita de copii Visina, Sat Vi?ina, CP 237540",0,284,0,284,0,282,2,310,26,95,187,3,12315,1
30,"Olt",130375,289,130375,,"VISINA NOUA",466,"Caminul Cultural, Sat Visina Noua",1548,1130,1026,29,75,1122,8,1706,576,298,824,3,12317,0
30,"Olt",130375,289,130375,,"VISINA NOUA",467,"Scoala cu clasele I-VIII Visina Noua, Strada Intrarea Europei nr. 40, CP 237511",0,100,0,100,0,100,0,229,129,38,62,3,12317,1
30,"Olt",129914,289,129914,,"VITOMIRESTI",468,"Liceul Vitomiresti, Sat Vitomiresti",503,311,302,9,0,306,5,554,243,122,184,3,12319,0
30,"Olt",129914,289,129914,,"VITOMIRESTI",469,"Scoala cu clasele I - IV Bulimanu, Sat Bulimanu",203,136,129,7,0,136,0,224,88,45,91,3,12319,0
30,"Olt",129914,289,129914,,"VITOMIRESTI",470,"Scoala cu clasele I - IV Trepteni, Sat Trepteni",302,184,176,8,0,183,1,333,149,46,137,3,12319,0
30,"Olt",129914,289,129914,,"VITOMIRESTI",471,"Scoala Generala Dejesti, Sat Dejesti",663,394,382,11,1,391,3,731,337,97,294,3,12319,0
30,"Olt",129914,289,129914,,"VITOMIRESTI",472,"Scoala cu clasele I - IV Donesti, Sat Donesti",204,159,152,7,0,156,3,225,66,37,119,3,12319,0
30,"Olt",129914,289,129914,,"VITOMIRESTI",473,"Liceul Vitomiresti, Sat Vitomiresti, CP 237545",0,201,0,201,0,201,0,310,109,75,126,3,12319,1
30,"Olt",129987,289,129987,,"VALCELE",474,"Scoala cu clasele I - VIII Olteni, Sat Vîlcele",1449,898,889,9,0,891,7,1597,699,446,445,3,12292,0
30,"Olt",129987,289,129987,,"VALCELE",475,"Scoala cu clasele I - IV Barcanesti, Sat Barcanesti",606,413,36,377,0,405,8,668,255,210,195,3,12292,0
30,"Olt",129987,289,129987,,"VALCELE",476,"Scoala cu clasele I-VIII Vâlcele, corp B, Catun Olteni, Sat Vîlcele, CP 237525",0,240,0,240,0,235,5,400,160,122,113,3,12292,1
30,"Olt",130026,289,130026,,"VLADILA",477,"Scoala Generala Vladila, Sala numarul 1, Sat Vladila",431,238,230,7,1,236,2,477,239,101,135,3,12326,0
30,"Olt",130026,289,130026,,"VLADILA",478,"Scoala Generala Vladila, Sala numarul 2, Sat Vladila",1262,702,680,5,17,694,8,1398,696,316,378,3,12326,0
30,"Olt",130026,289,130026,,"VLADILA",479,"Scoala Generala Vladila, Sat Vladila, CP 237555  ",0,108,0,108,0,107,1,130,22,56,51,3,12326,1
30,"Olt",130062,289,130062,,"VOINEASA",480,"Scoala cu clasele I - VIII Voineasa Mica, Sat Voineasa",742,491,475,16,0,485,6,818,327,193,292,3,12330,0
30,"Olt",130062,289,130062,,"VOINEASA",481,"Scoala cu clasele I - VIII Margaritesti, Sat Margaritesti",1022,656,636,20,0,646,10,1126,470,227,419,3,12330,0
30,"Olt",130062,289,130062,,"VOINEASA",482,"Scoala cu clasele I-VIII Margaritesti, Sat Margaritesti, CP 237562",0,115,0,115,0,113,2,190,75,35,78,3,12330,1
30,"Olt",130124,289,130124,,"VULPENI",483,"Scoala cu clasele I - VIII Vulpeni, Sat Vulpeni",912,587,572,15,0,580,7,1018,431,251,329,3,12336,0
30,"Olt",130124,289,130124,,"VULPENI",484,"scoala cu clasele I-IV Prisaca, Sat Prisaca",337,239,221,18,0,239,0,372,133,89,150,3,12336,0
30,"Olt",130124,289,130124,,"VULPENI",485,"Scoala cu clasele I - VIII Gropsani, Sat Gropsani",735,446,431,15,0,443,3,810,364,159,284,3,12336,0
30,"Olt",130124,289,130124,,"VULPENI",486,"Scoala cu clasele I - VIII Vulpeni, sala nr. 2, Sat Vulpeni, CP 237565",0,192,0,192,0,191,1,250,58,81,110,3,12336,1
30,"Olt",130231,289,130231,,"VULTURESTI",487,"Scoala Generala cu clasele I - IV ""Valea lui Alb"" (Sala nr.1), Sat Valea lui Alb",488,241,230,10,1,240,1,539,298,80,160,3,12347,0
30,"Olt",130231,289,130231,,"VULTURESTI",488,"Scoala Generala  cu clasele I - VIII ""Vulturesti"" (Sala nr.2), Sat Vulturesti",746,361,345,9,7,349,12,822,461,126,223,3,12347,0
30,"Olt",130231,289,130231,,"VULTURESTI",489,"Cladirea fostului CAP Dienci, Sat Dienci",851,555,504,35,16,547,8,938,383,146,401,3,12347,0
30,"Olt",130231,289,130231,,"VULTURESTI",490,"Scoala cu clasele I-VIII Vulturesti, sala nr. 1, Strada Principala Sat Vulturesti, CP 237580",0,189,0,189,0,187,2,369,180,67,120,3,12347,1
31,"Prahova",130534,298,130534,,"MUNICIPIUL PLOIESTI",1,"PALATUL CULTURII,B-dul Republicii nr.4",1315,840,825,15,0,828,12,1500,660,384,444,1,12353,0
31,"Prahova",130534,298,130534,,"MUNICIPIUL PLOIESTI",2,"CASA DE CULTURA A SINDICATELOR, B-dul Republicii nr.65",1066,696,685,9,2,683,13,1200,504,303,380,1,12353,0
31,"Prahova",130534,298,130534,,"MUNICIPIUL PLOIESTI",3,"CASA DE CULTURA A SINDICATELOR, B-dul Republicii nr.65",1124,737,723,14,0,726,11,1200,463,363,363,1,12353,0
31,"Prahova",130534,298,130534,,"MUNICIPIUL PLOIESTI",4,"LICEUL ALEXANDRU IOAN CUZA, str. Trei Ierarhi, nr.10",1287,783,771,12,0,767,16,1398,615,371,396,1,12353,0
31,"Prahova",130534,298,130534,,"MUNICIPIUL PLOIESTI",5,"SCOALA NR.4 <<ELENA DOAMNA>>, str. Elena Doamna nr.25",1529,1006,998,7,1,983,23,1700,694,435,548,1,12353,0
31,"Prahova",130534,298,130534,,"MUNICIPIUL PLOIESTI",6,"SCOALA NR.4 <<ELENA DOAMNA>>, str. Elena Doamna nr.25",1421,904,893,11,0,890,14,1600,696,442,448,1,12353,0
31,"Prahova",130534,298,130534,,"MUNICIPIUL PLOIESTI",7,"SCOALA NR.7 << CANDIANO POPESCU>> , str. Nucilor nr.39",1451,877,866,10,1,868,9,1600,723,468,400,1,12353,0
31,"Prahova",130534,298,130534,,"MUNICIPIUL PLOIESTI",8,"SCOALA NR.7 << CANDIANO POPESCU>> , str. Nucilor nr.39",1261,595,579,11,5,591,4,1400,805,356,235,1,12353,0
31,"Prahova",130534,298,130534,,"MUNICIPIUL PLOIESTI",9,"COLEGIUL << ION LUCA CARAGIALE>> str. Gh. Doja, nr.98",1511,860,848,12,0,848,12,1700,840,490,358,1,12353,0
31,"Prahova",130534,298,130534,,"MUNICIPIUL PLOIESTI",10,"COLEGIUL << ION LUCA CARAGIALE>> str. Gh. Doja, nr.98",1387,857,819,38,0,843,14,1500,643,443,400,1,12353,0
31,"Prahova",130534,298,130534,,"MUNICIPIUL PLOIESTI",11,"DIRECTIA JUDETEANA A SPORTURILOR, str. Pielari nr.5",1330,723,714,9,0,717,6,1500,777,392,325,1,12353,0
31,"Prahova",130534,298,130534,,"MUNICIPIUL PLOIESTI",12,"DIRECTIA JUDETEANA A SPORTURILOR, str. Pielari nr.5",1477,813,804,8,1,798,15,1600,787,430,368,1,12353,0
31,"Prahova",130534,298,130534,,"MUNICIPIUL PLOIESTI",13,"GRUPUL SCOLAR DE ARTE SI MESERII << SPIRU HARET>> str. Toma Ionescu nr.27",1247,671,660,11,0,655,16,1400,729,373,282,1,12353,0
31,"Prahova",130534,298,130534,,"MUNICIPIUL PLOIESTI",14,"ANEXA SCOLII NR.21 (<< SFANTA VINERI>>) Str. Stadionului nr.9",1098,653,639,14,0,647,6,1200,547,303,344,1,12353,0
31,"Prahova",130534,298,130534,,"MUNICIPIUL PLOIESTI",15,"MUZEUL DE ISTORIE Str. Toma Caragiu nr.10",935,564,554,10,0,553,11,1000,436,275,278,1,12353,0
31,"Prahova",130534,298,130534,,"MUNICIPIUL PLOIESTI",16,"COLEGIUL << MIHAI VITEAZUL>> B-dul Independentei nr.8",807,469,457,11,1,463,6,900,431,232,231,1,12353,0
31,"Prahova",130534,298,130534,,"MUNICIPIUL PLOIESTI",17,"CLUBUL SPORTIV SCOLAR, Str. Stefan cel Mare, nr.5",1016,630,611,19,0,622,8,1103,473,330,292,1,12353,0
31,"Prahova",130534,298,130534,,"MUNICIPIUL PLOIESTI",18,"SC << ELECTRICA >> SA Marasesti, nr.44",1292,738,727,11,0,729,9,1397,659,371,358,1,12353,0
31,"Prahova",130534,298,130534,,"MUNICIPIUL PLOIESTI",19,"SALA SPORTURILOR <<OLIMPIA>> Parcul Tineretului",1521,914,906,8,0,899,15,1700,786,464,435,1,12353,0
31,"Prahova",130534,298,130534,,"MUNICIPIUL PLOIESTI",20,"SALA SPORTURILOR <<OLIMPIA>> Parcul Tineretului",1505,897,884,13,0,884,13,1700,803,489,395,1,12353,0
31,"Prahova",130534,298,130534,,"MUNICIPIUL PLOIESTI",21,"SCOALA NR.12 ""NICOLAE TITULESCU"" Str. Popa Farcas nr.23",1249,757,747,10,0,740,17,1400,643,442,298,1,12353,0
31,"Prahova",130534,298,130534,,"MUNICIPIUL PLOIESTI",22,"SCOALA NR.12 ""NICOLAE TITULESCU"" Str. Popa Farcas nr.23",1529,955,940,15,0,934,21,1700,745,533,401,1,12353,0
31,"Prahova",130534,298,130534,,"MUNICIPIUL PLOIESTI",23,"ANEXA GRUP SCOLAR INDUSTRIAL TRANSPORTURI (fost Liceul Auto) Str. Traian nr.28",1572,881,861,20,0,874,7,1700,819,483,391,1,12353,0
31,"Prahova",130534,298,130534,,"MUNICIPIUL PLOIESTI",24,"SCOALA NR.14 ""SFANTUL VASILE"" B-dul Republicii nr.145",1591,1024,1013,10,1,1008,16,1700,676,516,492,1,12353,0
31,"Prahova",130534,298,130534,,"MUNICIPIUL PLOIESTI",25,"SCOALA NR.14 ""SFANTUL VASILE"" B-dul Republicii nr.145",1479,975,962,13,0,962,13,1600,625,474,488,1,12353,0
31,"Prahova",130534,298,130534,,"MUNICIPIUL PLOIESTI",26,"SCOALA NR.14 ""SFANTUL VASILE"" B-dul Republicii nr.145",1399,858,847,9,2,845,13,1500,642,451,394,1,12353,0
31,"Prahova",130534,298,130534,,"MUNICIPIUL PLOIESTI",27,"SCOALA NR.14 ""SFANTUL VASILE"" B-dul Republicii nr.145",1550,985,971,14,0,971,14,1700,715,560,411,1,12353,0
31,"Prahova",130534,298,130534,,"MUNICIPIUL PLOIESTI",28,"SCOALA NR.13 ""DIMITRIE BOLINTINEANU"" Str. Dimitrie Bolintineanu nr.32",1222,752,740,12,0,742,10,1300,548,410,332,1,12353,0
31,"Prahova",130534,298,130534,,"MUNICIPIUL PLOIESTI",29,"SCOALA NR.13 ""DIMITRIE BOLINTINEANU"" Str. Dimitrie Bolintineanu nr.32",1149,690,678,12,0,679,11,1300,610,362,317,1,12353,0
31,"Prahova",130534,298,130534,,"MUNICIPIUL PLOIESTI",30,"SEDIUL REGIEI AUTONOME DE TRANSPORT PUBLIC, Str. Gageni, nr.88",1528,809,789,20,0,803,6,1500,691,468,335,1,12353,0
31,"Prahova",130534,298,130534,,"MUNICIPIUL PLOIESTI",31,"SEDIUL REGIEI AUTONOME DE TRANSPORT PUBLIC, Str. Gageni, nr.88",1333,793,765,27,1,785,8,1500,707,464,321,1,12353,0
31,"Prahova",130534,298,130534,,"MUNICIPIUL PLOIESTI",32,"SEDIUL REGIEI AUTONOME DE TRANSPORT PUBLIC, Str. Gageni, nr.88",1095,657,642,14,1,644,13,1394,737,358,286,1,12353,0
31,"Prahova",130534,298,130534,,"MUNICIPIUL PLOIESTI",33,"SC ""COMCEREAL"" SA PLOIESTI, Str. Valeni, nr.137",1675,965,941,24,0,948,17,1801,836,490,458,1,12353,0
31,"Prahova",130534,298,130534,,"MUNICIPIUL PLOIESTI",34,"SCOALA NR.16 <<ANTON PANN>> Str. Luminisului, nr.8",1684,850,841,9,0,834,16,1800,950,478,356,1,12353,0
31,"Prahova",130534,298,130534,,"MUNICIPIUL PLOIESTI",35,"SCOALA NR.16 <<ANTON PANN>> Str. Luminisului, nr.8",1717,860,849,11,0,838,22,1900,1040,426,412,1,12353,0
31,"Prahova",130534,298,130534,,"MUNICIPIUL PLOIESTI",36,"SCOALA NR.16 <<ANTON PANN>> Str. Luminisului, nr.8",1508,774,763,11,0,766,8,1700,926,467,299,1,12353,0
31,"Prahova",130534,298,130534,,"MUNICIPIUL PLOIESTI",37,"BLOCUL 24 B PARTER Str. Mihai Bravu, nr.214",1495,813,803,10,0,797,16,1600,787,433,364,1,12353,0
31,"Prahova",130534,298,130534,,"MUNICIPIUL PLOIESTI",38,"BLOCUL 24 B PARTER Str. Mihai Bravu, nr.214",1602,845,835,10,0,833,12,1800,955,470,363,1,12353,0
31,"Prahova",130534,298,130534,,"MUNICIPIUL PLOIESTI",39,"CANTINA DE AJUTOR SOCIAL Str. Mihai Bravu nr.231",1602,888,864,24,0,875,13,1800,912,529,346,1,12353,0
31,"Prahova",130534,298,130534,,"MUNICIPIUL PLOIESTI",40,"CANTINA DE AJUTOR SOCIAL Str. Mihai Bravu nr.231",1542,876,865,9,2,867,9,1700,824,499,368,1,12353,0
31,"Prahova",130534,298,130534,,"MUNICIPIUL PLOIESTI",41,"OFICIUL POSTAL NR.11 Str. Chimiei nr.3",1617,880,864,16,0,871,9,1800,920,460,411,1,12353,0
31,"Prahova",130534,298,130534,,"MUNICIPIUL PLOIESTI",42,"GRUP SCOLAR TELEAJEN Str. Mihai Bravu nr.241",891,514,442,72,0,510,4,1000,486,322,188,1,12353,0
31,"Prahova",130534,298,130534,,"MUNICIPIUL PLOIESTI",43,"GRADINITA DE COPII NR.4 Str. Rosiori nr.28",851,562,551,11,0,557,5,899,337,317,240,1,12353,0
31,"Prahova",130534,298,130534,,"MUNICIPIUL PLOIESTI",44,"SCOALA NR.17 ""IOAN GRIGORESCU"", Str. Izvoare nr.81",1200,645,640,5,0,638,7,1300,655,343,295,1,12353,0
31,"Prahova",130534,298,130534,,"MUNICIPIUL PLOIESTI",45,"SCOALA NR.17 ""IOAN GRIGORESCU"", Str. Izvoare nr.81",1340,780,771,9,0,761,19,1500,720,422,339,1,12353,0
31,"Prahova",130534,298,130534,,"MUNICIPIUL PLOIESTI",46,"SCOALA NR.17 ""IOAN GRIGORESCU"", Str. Izvoare nr.81",1122,583,576,7,0,578,5,1200,617,328,250,1,12353,0
31,"Prahova",130534,298,130534,,"MUNICIPIUL PLOIESTI",47,"SCOALA NR.9 ""RARES VODA"", Str. Vornicul Boldur nr.3",1105,705,689,16,0,695,10,1200,495,374,321,1,12353,0
31,"Prahova",130534,298,130534,,"MUNICIPIUL PLOIESTI",48,"CASA CORPULUI DIDACTIC Str. Democratiei nr.35",1227,720,706,14,0,710,10,1300,580,360,350,1,12353,0
31,"Prahova",130534,298,130534,,"MUNICIPIUL PLOIESTI",49,"CASA CORPULUI DIDACTIC Str. Democratiei nr.35",907,551,540,10,1,544,7,1002,451,261,283,1,12353,0
31,"Prahova",130534,298,130534,,"MUNICIPIUL PLOIESTI",50,"LICEUL PEDAGOGIC PLOIESTI, str. Nicolae Iorga, nr.7",1266,769,755,13,1,758,11,1400,631,366,392,1,12353,0
31,"Prahova",130534,298,130534,,"MUNICIPIUL PLOIESTI",51,"GRUP SCOLAR ADMINISTRATIV SERVICII ""VICTOR SLAVESCU""(fosta SCOALA NR.32), str. Teleajen nr.11",1284,783,772,11,0,777,6,1390,607,421,356,1,12353,0
31,"Prahova",130534,298,130534,,"MUNICIPIUL PLOIESTI",52,"GRUP SCOLAR ADMINISTRATIV SERVICII ""VICTOR SLAVESCU""(fosta SCOALA NR.32), str. Teleajen nr.11",1219,751,728,22,1,740,11,1300,549,354,386,1,12353,0
31,"Prahova",130534,298,130534,,"MUNICIPIUL PLOIESTI",53,"SCOALA NR.10 ""GEORGE COSBUC"" Str. Alexandru Lapusneanu nr.17",1385,864,856,8,0,854,10,1500,636,402,452,1,12353,0
31,"Prahova",130534,298,130534,,"MUNICIPIUL PLOIESTI",54,"SCOALA NR.10 ""GEORGE COSBUC"" Str. Alexandru Lapusneanu nr.17",1335,788,777,11,0,777,11,1500,712,434,343,1,12353,0
31,"Prahova",130534,298,130534,,"MUNICIPIUL PLOIESTI",55,"SCOALA NR.18 ""UNIREA"" Str. Fagaras nr.1",1941,1020,1009,11,0,1000,20,2100,1080,566,434,1,12353,0
31,"Prahova",130534,298,130534,,"MUNICIPIUL PLOIESTI",56,"GRUPUL SCOLAR 1 MAI B-dul Petrolului nr.16",1641,862,840,22,0,850,12,1799,937,466,384,1,12353,0
31,"Prahova",130534,298,130534,,"MUNICIPIUL PLOIESTI",57,"GRUPUL SCOLAR 1 MAI B-dul Petrolului nr.16",1474,793,786,7,0,786,7,1600,807,405,381,1,12353,0
31,"Prahova",130534,298,130534,,"MUNICIPIUL PLOIESTI",58,"COLEGIUL ""LAZAR EDELEANU"" (fost LICEUL DE CHIMIE) B-dul Petrolului nr.14",1443,814,803,11,0,810,4,1600,786,438,372,1,12353,0
31,"Prahova",130534,298,130534,,"MUNICIPIUL PLOIESTI",59,"COLEGIUL ""LAZAR EDELEANU"" (fost LICEUL DE CHIMIE) B-dul Petrolului nr.14",1631,831,812,18,1,812,19,1800,969,454,358,1,12353,0
31,"Prahova",130534,298,130534,,"MUNICIPIUL PLOIESTI",60,"SCOALA NR.15 ""MIHAIL EMINESCU"" B-dul Bucuresti nr.25 A",1495,934,924,10,0,928,6,1600,666,509,419,1,12353,0
31,"Prahova",130534,298,130534,,"MUNICIPIUL PLOIESTI",61,"SCOALA NR.15 ""MIHAIL EMINESCU"" B-dul Bucuresti nr.25 A",1558,918,912,6,0,910,8,1700,782,494,416,1,12353,0
31,"Prahova",130534,298,130534,,"MUNICIPIUL PLOIESTI",62,"SCOALA NR.19 B-dul Petrolului nr.7",1066,616,601,15,0,580,36,1200,584,358,222,1,12353,0
31,"Prahova",130534,298,130534,,"MUNICIPIUL PLOIESTI",63,"SCOALA NR.1 ""RADU STANIAN"" Str. Bobalna nr.76",1165,744,733,11,0,738,6,1300,556,364,374,1,12353,0
31,"Prahova",130534,298,130534,,"MUNICIPIUL PLOIESTI",64,"LICEUL DE ARTA Str. Bobalna nr.44",1067,646,634,12,0,639,7,1200,554,355,284,1,12353,0
31,"Prahova",130534,298,130534,,"MUNICIPIUL PLOIESTI",65,"LICEUL DE ARTA Str. Bobalna nr.44",850,540,529,11,0,535,5,900,360,290,245,1,12353,0
31,"Prahova",130534,298,130534,,"MUNICIPIUL PLOIESTI",66,"SC APA NOVA SRL Str. Ana Ipatescu nr.8",1173,950,722,22,206,932,18,1298,348,533,399,1,12353,0
31,"Prahova",130534,298,130534,,"MUNICIPIUL PLOIESTI",67,"COLEGIUL ""SPIRU HARET"" (fost Liceul de Constructii Masini) Str. Constructorului nr.8",898,511,497,14,0,503,8,1000,489,260,243,1,12353,0
31,"Prahova",130534,298,130534,,"MUNICIPIUL PLOIESTI",68,"OCOLUL SILVIC PLOIESTI Str. Eroilor nr.58",1274,666,647,19,0,661,5,1388,722,365,296,1,12353,0
31,"Prahova",130534,298,130534,,"MUNICIPIUL PLOIESTI",69,"INSPET Str. Sondelor nr.65",865,400,391,9,0,395,5,1000,600,208,187,1,12353,0
31,"Prahova",130534,298,130534,,"MUNICIPIUL PLOIESTI",70,"SCOALA NR.11 ""FLORIN COMISEL""  Str. Jupiter nr.6",1429,880,872,8,0,860,20,1600,720,491,369,1,12353,0
31,"Prahova",130534,298,130534,,"MUNICIPIUL PLOIESTI",71,"PALATUL COPIILOR (fosta Scoala 20) Str. Marasesti nr.239",1300,740,730,10,0,732,8,1394,654,405,327,1,12353,0
31,"Prahova",130534,298,130534,,"MUNICIPIUL PLOIESTI",72,"PALATUL COPIILOR (fosta Scoala 20) Str. Marasesti nr.239",1343,800,787,13,0,790,10,1500,700,435,355,1,12353,0
31,"Prahova",130534,298,130534,,"MUNICIPIUL PLOIESTI",73,"PALATUL COPIILOR (fosta Scoala 20) Str. Marasesti nr.239",1526,851,841,10,0,833,18,1700,849,408,425,1,12353,0
31,"Prahova",130534,298,130534,,"MUNICIPIUL PLOIESTI",74,"PALATUL COPIILOR (fosta Scoala 20) Str. Marasesti nr.239",940,484,473,11,0,480,4,997,513,293,187,1,12353,0
31,"Prahova",130534,298,130534,,"MUNICIPIUL PLOIESTI",75,"PALATUL COPIILOR (fosta Scoala 20) Str. Marasesti nr.239",1131,647,639,8,0,640,7,1200,553,354,286,1,12353,0
31,"Prahova",130534,298,130534,,"MUNICIPIUL PLOIESTI",76,"SCOALA I.A. BASSARABESCU, Aleea Strunga nr.2",1837,1091,1082,9,0,1081,10,1800,709,585,496,1,12353,0
31,"Prahova",130534,298,130534,,"MUNICIPIUL PLOIESTI",77,"SCOALA I.A. BASSARABESCU, Aleea Strunga nr.2",1431,828,814,14,0,821,7,1600,772,481,340,1,12353,0
31,"Prahova",130534,298,130534,,"MUNICIPIUL PLOIESTI",78,"SCOALA I.A. BASSARABESCU, Aleea Strunga nr.2",1587,921,913,8,0,904,17,1700,779,523,381,1,12353,0
31,"Prahova",130534,298,130534,,"MUNICIPIUL PLOIESTI",79,"SCOALA I.A. BASSARABESCU, Aleea Strunga nr.2",1463,826,819,7,0,818,8,1800,974,457,361,1,12353,0
31,"Prahova",130534,298,130534,,"MUNICIPIUL PLOIESTI",80,"DIRECTIA JUDETEANA DE PROTECTIA COPILULUI PRAHOVA, Sos. Vestului nr.14-16",1448,838,828,10,0,831,7,1600,762,498,333,1,12353,0
31,"Prahova",130534,298,130534,,"MUNICIPIUL PLOIESTI",81,"DIRECTIA JUDETEANA DE PROTECTIA COPILULUI PRAHOVA, Sos. Vestului nr.14-16",1494,901,890,11,0,893,8,1600,699,490,403,1,12353,0
31,"Prahova",130534,298,130534,,"MUNICIPIUL PLOIESTI",82,"SCOALA NR.29 Aleea Godeanu nr.4",1487,853,842,11,0,844,9,1600,747,455,389,1,12353,0
31,"Prahova",130534,298,130534,,"MUNICIPIUL PLOIESTI",83,"SCOALA NR.29 Aleea Godeanu nr.4",1359,714,704,10,0,704,10,1500,786,395,309,1,12353,0
31,"Prahova",130534,298,130534,,"MUNICIPIUL PLOIESTI",84,"SCOALA NR.29 Aleea Godeanu nr.4",1455,754,738,15,1,745,9,1600,846,466,279,1,12353,0
31,"Prahova",130534,298,130534,,"MUNICIPIUL PLOIESTI",85,"SCOALA NR.29 Aleea Godeanu nr.4",1342,742,730,12,0,735,7,1500,758,432,303,1,12353,0
31,"Prahova",130534,298,130534,,"MUNICIPIUL PLOIESTI",86,"GRADINITA NR.50 Aleea Godeanu nr.4",1168,729,720,9,0,714,15,1281,552,375,339,1,12353,0
31,"Prahova",130534,298,130534,,"MUNICIPIUL PLOIESTI",87,"GRADINITA NR.50 Aleea Godeanu nr.4",1343,765,754,10,1,757,8,1509,744,411,346,1,12353,0
31,"Prahova",130534,298,130534,,"MUNICIPIUL PLOIESTI",88,"GRADINITA NR.40 Str. Anotimpului nr.1",1326,751,737,14,0,742,9,1500,749,407,335,1,12353,0
31,"Prahova",130534,298,130534,,"MUNICIPIUL PLOIESTI",89,"GRADINITA NR.40 Str. Anotimpului nr.1",1045,607,596,11,0,602,5,1100,493,284,318,1,12353,0
31,"Prahova",130534,298,130534,,"MUNICIPIUL PLOIESTI",90,"GRADINITA NR.40 Str. Anotimpului nr.1",1536,945,932,13,0,931,14,1700,755,505,426,1,12353,0
31,"Prahova",130534,298,130534,,"MUNICIPIUL PLOIESTI",91,"SCOALA NR.3 ""TOMA CARAGIU "" Str. Minerva nr.4",1272,745,739,6,0,731,14,1400,655,400,331,1,12353,0
31,"Prahova",130534,298,130534,,"MUNICIPIUL PLOIESTI",92,"SCOALA NR.3 ""TOMA CARAGIU "" Str. Minerva nr.4",993,599,582,17,0,592,7,1104,505,325,267,1,12353,0
31,"Prahova",130534,298,130534,,"MUNICIPIUL PLOIESTI",93,"SCOALA NR.3 ""TOMA CARAGIU "" Str. Minerva nr.4",1472,823,812,11,0,813,10,1600,777,465,348,1,12353,0
31,"Prahova",130534,298,130534,,"MUNICIPIUL PLOIESTI",94,"Scoala nr.31"" Nicolae Iorga"",str.Minerva nr.4",1593,782,777,5,0,768,14,1700,918,439,329,1,12353,0
31,"Prahova",130534,298,130534,,"MUNICIPIUL PLOIESTI",95,"Scoala nr.31"" Nicolae Iorga"", str.Minerva nr.4",1359,827,811,15,1,818,9,1500,673,441,377,1,12353,0
31,"Prahova",130534,298,130534,,"MUNICIPIUL PLOIESTI",96,"Gradinita nr.39,str.G-ral Eremia Grigorescu nr.4",973,580,568,12,0,569,11,1097,517,318,251,1,12353,0
31,"Prahova",130534,298,130534,,"MUNICIPIUL PLOIESTI",97,"Gradinita nr.39,str.G-ral Eremia Grigorescu nr.4",941,560,551,9,0,553,7,1000,440,301,252,1,12353,0
31,"Prahova",130534,298,130534,,"MUNICIPIUL PLOIESTI",98,"Gradinita nr.36""Sf.Mucenic Mina"",str.slt.erou Moldoveanu Marian nr.14",1498,919,906,13,0,909,10,1600,681,485,424,1,12353,0
31,"Prahova",130534,298,130534,,"MUNICIPIUL PLOIESTI",99,"Gradinita nr.36""Sf.Mucenic Mina"",str.slt.erou Moldoveanu Marian nr.14",1650,892,880,12,0,879,13,1800,908,490,389,1,12353,0
31,"Prahova",130534,298,130534,,"MUNICIPIUL PLOIESTI",100,"Gradinita nr.36""Sf.Mucenic Mina"",str.slt.erou Moldoveanu Marian nr.14",1307,793,784,9,0,790,3,1400,607,416,374,1,12353,0
31,"Prahova",130534,298,130534,,"MUNICIPIUL PLOIESTI",101,"Scoala nr.6""Matei Basarab"",str.Infratirii nr.4",1543,851,833,18,0,833,18,1700,849,483,350,1,12353,0
31,"Prahova",130534,298,130534,,"MUNICIPIUL PLOIESTI",102,"Scoala nr.6""Matei Basarab"",str.Infratirii nr.4",1475,809,802,7,0,801,8,1600,791,494,307,1,12353,0
31,"Prahova",130534,298,130534,,"MUNICIPIUL PLOIESTI",103,"Scoala nr.6""Matei Basarab"",str.Infratirii nr.4",1194,613,595,17,1,609,4,1300,687,387,222,1,12353,0
31,"Prahova",130534,298,130534,,"MUNICIPIUL PLOIESTI",104,"Gradinita nr.47, Aleea Iezerului nr.5-7",1026,634,626,8,0,623,11,1100,466,325,298,1,12353,0
31,"Prahova",130534,298,130534,,"MUNICIPIUL PLOIESTI",105,"Gradinita nr.47,Aleea Iezerului nr.5-7",935,578,561,16,1,569,9,999,421,291,278,1,12353,0
31,"Prahova",130534,298,130534,,"MUNICIPIUL PLOIESTI",106,"Gradinita nr.47 Aleea Iezerului nr.5-7",979,542,524,18,0,534,8,1095,553,317,217,1,12353,0
31,"Prahova",130534,298,130534,,"MUNICIPIUL PLOIESTI",107,"SEDIUL SISTEMUL DE GOSPODARIRE A APELOR PRAHOVA Str.Gh.GR.Cantacuzino nr.308",1307,821,797,24,0,810,11,1400,579,402,408,1,12353,0
31,"Prahova",130534,298,130534,,"MUNICIPIUL PLOIESTI",108,"SEDIUL AGENTIEI DE PROTECTIE A MEDIULUI PRAHOVA Str.Gh.Gr.Cantacuzino nr.306",1273,816,801,15,0,803,13,1399,583,423,380,1,12353,0
31,"Prahova",130534,298,130534,,"MUNICIPIUL PLOIESTI",109,"SEDIUL A.N.APELE ROMANE-EXPLOATARE SISTEM ZONAL PRAHOVA Str.Gh.Gr.Cantacuzino nr.304",1189,694,685,9,0,687,7,1300,606,372,315,1,12353,0
31,"Prahova",130534,298,130534,,"MUNICIPIUL PLOIESTI",110,"SCOALA NR.2 ""IENACHITA VACARESCU"" Str.Spatar Milescu nr.22",1542,917,908,8,1,906,11,1700,783,478,428,1,12353,0
31,"Prahova",130534,298,130534,,"MUNICIPIUL PLOIESTI",111,"SCOALA NR.2 ""IENACHITA VACARESCU"" Str.Spatar Milescu nr.22",1647,978,969,9,0,960,18,1800,822,510,450,1,12353,0
31,"Prahova",130534,298,130534,,"MUNICIPIUL PLOIESTI",112,"SCOALA NR.2 ""IENACHITA VACARESCU"" Str.Spatar Milescu nr.22",1450,905,888,17,0,891,14,1600,695,504,387,1,12353,0
31,"Prahova",130534,298,130534,,"MUNICIPIUL PLOIESTI",113,"SCOALA NR.2 ""IENACHITA VACARESCU"" Str.Spatar Milescu nr.22",1039,635,630,5,0,628,7,1100,465,353,275,1,12353,0
31,"Prahova",130534,298,130534,,"MUNICIPIUL PLOIESTI",114,"GRUPUL SCOLAR INDUSTRIAL ""TOMA SOCOLESCU"" Str.Gh.GR.Cantacuzino nr.328",1099,667,659,8,0,659,8,1201,534,354,305,1,12353,0
31,"Prahova",130534,298,130534,,"MUNICIPIUL PLOIESTI",115,"GRUPUL SCOLAR INDUSTRIAL""TOMA SOCOLESCU"" Str.Gh.Gr.Cantacuzino nr.328",821,464,451,13,0,455,9,900,436,236,219,1,12353,0
31,"Prahova",130534,298,130534,,"MUNICIPIUL PLOIESTI",116,"GRUPUL SCOLAR INDUSTRIAL ENERGETIC ""ELIE RADU"" Soseaua Vestului nr.22",1477,840,834,6,0,835,5,1600,760,412,423,1,12353,0
31,"Prahova",130534,298,130534,,"MUNICIPIUL PLOIESTI",117,"GRUPUL SCOLAR INDUSTRIAL ENERGETIC ""ELIE RADU"" Soseaua Vestului nr.22",1699,937,931,6,0,922,15,1900,963,499,423,1,12353,0
31,"Prahova",130534,298,130534,,"MUNICIPIUL PLOIESTI",118,"GRUPUL SCOLAR INDUSTRIAL ENERGRTIC ""ELIE RADU"" Soseaua Vestului nr.22",1018,609,604,5,0,599,10,1100,491,326,273,1,12353,0
31,"Prahova",130534,298,130534,,"MUNICIPIUL PLOIESTI",119,"SCOALA PROFESOR""NICOLAE SIMACHE"" Str.Malu Rosu nr.102",1488,877,868,9,0,867,10,1600,723,494,373,1,12353,0
31,"Prahova",130534,298,130534,,"MUNICIPIUL PLOIESTI",120,"SCOALA PROFESOR""NICOLAE SIMACHE""Str.Malu Rosu nr.102",1460,845,830,15,0,837,8,1600,755,454,383,1,12353,0
31,"Prahova",130534,298,130534,,"MUNICIPIUL PLOIESTI",121,"SCOALA PROFESOR""NICOLAE SIMACHE""Str.Malu Rosu nr.102",1346,718,714,4,0,714,4,1500,782,407,307,1,12353,0
31,"Prahova",130534,298,130534,,"MUNICIPIUL PLOIESTI",122,"SCOALA NR.28 ""NICOLAE BALCESCU"" Aleea Scolii nr.2",1597,866,854,12,0,851,15,1800,934,459,392,1,12353,0
31,"Prahova",130534,298,130534,,"MUNICIPIUL PLOIESTI",123,"SCOALA NR.28 ""NICOLAE BALCESCU"" Aleea Scolii nr.2",1521,777,763,13,1,765,12,1701,924,427,338,1,12353,0
31,"Prahova",130534,298,130534,,"MUNICIPIUL PLOIESTI",124,"SCOALA NR.28 ""NICOLAE BALCESCU"" Aleea Scolii nr.2",1640,878,866,12,0,870,8,1800,922,471,399,1,12353,0
31,"Prahova",130534,298,130534,,"MUNICIPIUL PLOIESTI",125,"SCOALA NR.28 ""NICOLAE BALCESCU"" Aleea Scolii nr.2",1277,752,732,20,0,736,16,1400,648,404,332,1,12353,0
31,"Prahova",130534,298,130534,,"MUNICIPIUL PLOIESTI",126,"GRADINITA DE COPII NR.10 Secelenilor nr.3",1512,802,793,9,0,792,10,1700,898,449,343,1,12353,0
31,"Prahova",130534,298,130534,,"MUNICIPIUL PLOIESTI",127,"GRADINITA DE COPII NR.10 Secelenilor nr.3",1044,599,587,10,2,592,7,1100,501,366,226,1,12353,0
31,"Prahova",130534,298,130534,,"MUNICIPIUL PLOIESTI",128,"GRADINITA DE COPII NR.10 Secelenilor nr.3",1220,648,635,13,0,642,6,1300,652,371,271,1,12353,0
31,"Prahova",130534,298,130534,,"MUNICIPIUL PLOIESTI",129,"SC""ELCO""SA Sos.Vestului, nr.26",1127,688,680,8,0,673,15,1211,523,388,285,1,12353,0
31,"Prahova",130534,298,130534,,"MUNICIPIUL PLOIESTI",130,"SCOALA NR.5""ION CREANGA"" Str.8 Martie nr.2",1509,825,811,14,0,814,11,1700,875,457,357,1,12353,0
31,"Prahova",130534,298,130534,,"MUNICIPIUL PLOIESTI",131,"SCOALA NR.5""ION CREANGA"" Str.8 Martie nr.2",1373,847,837,10,0,834,13,1500,653,477,357,1,12353,0
31,"Prahova",130534,298,130534,,"MUNICIPIUL PLOIESTI",132,"SCOALA NR.5""ION CREANGA"" Str.8 Martie nr.2",1470,908,890,18,0,896,12,1600,692,526,370,1,12353,0
31,"Prahova",130534,298,130534,,"MUNICIPIUL PLOIESTI",133,"SCOALA NR.5""ION CREANGA"" Str.8 Martie nr.2",1364,886,876,10,0,879,7,1500,614,443,436,1,12353,0
31,"Prahova",130534,298,130534,,"MUNICIPIUL PLOIESTI",134,"SCOALA NR.5""ION CREANGA"" Str.8 Martie nr.2",1426,940,922,18,0,929,11,1600,660,471,458,1,12353,0
31,"Prahova",130534,298,130534,,"MUNICIPIUL PLOIESTI",135,"SCOALA NR.23 ""ANDREI MURESEANU"" Str.Trotus nr.4",1699,1052,1042,10,0,1041,11,1900,848,526,515,1,12353,0
31,"Prahova",130534,298,130534,,"MUNICIPIUL PLOIESTI",136,"SCOALA NR.23 ""ANDREI MURESEANU"" Str.Trotus nr.4",1263,697,686,11,0,683,14,1400,703,368,315,1,12353,0
31,"Prahova",130534,298,130534,,"MUNICIPIUL PLOIESTI",137,"SCOALA NR.23 ""ANDREI MURESEANU"" Str.Trotus nr.4",1126,671,659,12,0,666,5,1200,529,365,301,1,12353,0
31,"Prahova",130534,298,130534,,"MUNICIPIUL PLOIESTI",138,"SCOALA GENERALA NR.25 ""HENRI MATHIAS BERTHELOT"" Str.Arinului nr.2",1011,636,621,15,0,629,7,1102,466,310,319,1,12353,0
31,"Prahova",130534,298,130534,,"MUNICIPIUL PLOIESTI",139,"SCOALA GENERALA NR.25 ""HENRI MATHIAS BERTHELOT"" Str.Arinului nr.2",1227,773,754,18,1,767,6,1300,527,389,378,1,12353,0
31,"Prahova",130534,298,130534,,"MUNICIPIUL PLOIESTI",140,"SCOALA GENERALA NR.25 ""HENRI MATHIAS BERTHELOT"" Str.Arinului nr.6",1184,723,711,12,0,717,6,1300,577,365,352,1,12353,0
31,"Prahova",130534,298,130534,,"MUNICIPIUL PLOIESTI",141,"SCOALA NR.8 ""GRIGORE MOISIL"" Str. Laurilor nr.2A",1231,751,735,15,1,744,7,1396,645,399,345,1,12353,0
31,"Prahova",130534,298,130534,,"MUNICIPIUL PLOIESTI",142,"SCOALA NR.8 ""GRIGORE MOISIL"" Str. Laurilor nr.2A",1179,707,698,9,0,697,10,1300,593,329,368,1,12353,0
31,"Prahova",130534,298,130534,,"MUNICIPIUL PLOIESTI",143,"LICEUL NICHITA STANESCU Str.Nalbei nr.3",991,586,578,8,0,575,11,1104,518,262,313,1,12353,0
31,"Prahova",130534,298,130534,,"MUNICIPIUL PLOIESTI",144,"LICEUL NICHITA STANESCU Str.Nalbei nr.3",1045,661,649,12,0,651,10,1093,432,356,295,1,12353,0
31,"Prahova",130534,298,130534,,"MUNICIPIUL PLOIESTI",145,"LICEUL NICHITA STANESCU Str.Nalbei nr.3",1028,607,596,11,0,598,9,1099,492,286,312,1,12353,0
31,"Prahova",130534,298,130534,,"MUNICIPIUL PLOIESTI",146,"LICEUL NICHITA STANESCU Str.Nalbei nr.3",1408,869,854,15,0,859,10,1500,631,453,406,1,12353,0
31,"Prahova",130534,298,130534,,"MUNICIPIUL PLOIESTI",147,"POLICLINICA CINA Str.Andrei Muresanu nr.56",1555,927,914,13,0,915,12,1700,773,518,397,1,12353,0
31,"Prahova",130534,298,130534,,"MUNICIPIUL PLOIESTI",148,"POLICLINICA CINA Str.Andrei Muresanu nr.56",1424,882,861,21,0,875,7,1597,715,446,429,1,12353,0
31,"Prahova",130534,298,130534,,"MUNICIPIUL PLOIESTI",149,"SCOALA NR.24 ""SFANTUL ANDREI"" Aleea Deditel nr.4",1585,865,856,7,2,859,6,1700,835,490,369,1,12353,0
31,"Prahova",130534,298,130534,,"MUNICIPIUL PLOIESTI",150,"SCOALA NR.24 ""SFANTUL ANDREI"" Aleea Deditel nr.4",1540,960,942,17,1,944,16,1700,740,487,457,1,12353,0
31,"Prahova",130534,298,130534,,"MUNICIPIUL PLOIESTI",151,"SCOALA NR.24 ""SFANTUL ANDREI"" Aleea Deditel nr.4",1498,828,820,8,0,816,12,1600,772,389,427,1,12353,0
31,"Prahova",130534,298,130534,,"MUNICIPIUL PLOIESTI",152,"SCOALA NR.24 ""SFANTUL ANDREI"" Aleea Deditel nr.4",1576,937,922,14,1,927,10,1700,763,422,505,1,12353,0
31,"Prahova",130534,298,130534,,"MUNICIPIUL PLOIESTI",153,"SCOALA NR.24 ""SFANTUL ANDREI"" Aleea Deditel nr.4",1468,852,840,11,1,846,6,1599,747,411,435,1,12353,0
31,"Prahova",130534,298,130534,,"MUNICIPIUL PLOIESTI",154,"SCOALA NR.22 ""MITICA APOSTOL"" Str.Ciocarliei nr.7",1184,634,624,10,0,626,8,1300,666,395,231,1,12353,0
31,"Prahova",130534,298,130534,,"MUNICIPIUL PLOIESTI",155,"GARA PLOIESTI TRIAJ",155,100,89,11,0,98,2,198,98,44,54,1,12353,0
31,"Prahova",130534,298,130534,,"MUNICIPIUL PLOIESTI",156,"GARA de SUD Strada Depoului,nr.1",0,1015,0,1015,0,1005,10,1200,185,585,420,1,12353,1
31,"Prahova",130534,298,130534,,"MUNICIPIUL PLOIESTI",157,"GARA de VEST Strada Domnisori nr.95",0,928,0,928,0,919,9,1200,272,534,385,1,12353,1
31,"Prahova",130534,298,130534,,"MUNICIPIUL PLOIESTI",158,"UNIVERSITATEA PETROL-GAZE Bulevardul Bucuresti nr.39",0,833,0,833,0,826,7,1200,367,546,280,1,12353,1
31,"Prahova",131256,298,131256,,"MUNICIPIUL CAMPINA",159,"CASA DE CULTURA ""GEO BOGZA""  Str,Grivitei,nr. 95 (hol)",1485,916,905,11,0,902,14,1600,684,477,425,1,12355,0
31,"Prahova",131256,298,131256,,"MUNICIPIUL CAMPINA",160,"COLEGIUL NATIONAL "" NICOLAE GRIGORESCU"" Calea Doftanei, nr.4 (sala de clasa)",1315,824,813,11,0,809,15,1400,576,429,380,1,12355,0
31,"Prahova",131256,298,131256,,"MUNICIPIUL CAMPINA",161,"COLEGIUL NATIONAL "" NICOLAE GRIGORESCU"" Calea Doftanei, nr.4 (sala de clasa)",1497,925,916,9,0,915,10,1500,575,502,413,1,12355,0
31,"Prahova",131256,298,131256,,"MUNICIPIUL CAMPINA",162,"S.C. EDILCONST S.A. Str.Bucea,nr.2 (cantina)",1124,682,670,12,0,675,7,1200,518,411,264,1,12355,0
31,"Prahova",131256,298,131256,,"MUNICIPIUL CAMPINA",163,"SCOALA CENTRALA Calea Doftanei,nr.13 (sala de clasa)",1168,635,620,15,0,626,9,1300,665,371,255,1,12355,0
31,"Prahova",131256,298,131256,,"MUNICIPIUL CAMPINA",164,"GRUPUL SCOLAR INDUSTRIAL ENERGETIC Str.Grivitei,nr.2 (corp""A""-sala de clasa nr.5)",1285,775,760,14,1,768,7,1400,625,395,373,1,12355,0
31,"Prahova",131256,298,131256,,"MUNICIPIUL CAMPINA",165,"SCOALA GENERALA NR.7 Str.Mihail Kogalniceanu,nr.31 (sala de clasa)",1543,844,834,10,0,833,11,1700,856,477,356,1,12355,0
31,"Prahova",131256,298,131256,,"MUNICIPIUL CAMPINA",166,"CASA TINERETULUI B-dul Nicolae Balcescu,nr.50 (hol mic)",1653,982,969,12,1,963,19,1800,818,511,452,1,12355,0
31,"Prahova",131256,298,131256,,"MUNICIPIUL CAMPINA",167,"SC STEAUA ROMANA SA Calea Doftanei, nr.72 (cantina)",1431,850,837,13,0,836,14,1600,750,444,392,1,12355,0
31,"Prahova",131256,298,131256,,"MUNICIPIUL CAMPINA",168,"GRUPUL SCOLAR INDUSTRIAL ENERGETIC Str.Grivitei,nr.2 (corp""A""-sala de clasa nr.3)",1043,589,578,10,1,585,4,1097,508,338,247,1,12355,0
31,"Prahova",131256,298,131256,,"MUNICIPIUL CAMPINA",169,"GRUPUL SCOLAR FORESTIER B-dul Carol I,  nr.31 (sala de sport)",1426,897,892,5,0,880,17,1600,703,491,389,1,12355,0
31,"Prahova",131256,298,131256,,"MUNICIPIUL CAMPINA",170,"GRUPUL SCOLAR FORESTIER B-dul Carol I, nr.31 (sala de sport)",1490,906,893,12,1,896,10,1600,694,472,424,1,12355,0
31,"Prahova",131256,298,131256,,"MUNICIPIUL CAMPINA",171,"COLEGIUL TEHNIC ""DR.CONSTANTIN ISTRATI"" (fost GRUPUL SCOLAR INDUSTRIAL DE PETROL) B-dul Nicolae Balcescu, nr.45 (camin)",1636,939,927,11,1,929,10,1800,861,525,404,1,12355,0
31,"Prahova",131256,298,131256,,"MUNICIPIUL CAMPINA",172,"SCOALA GENERALA NR.5 B-dul Nicolae Balcescu,nr.5 (sala de clasa)",1253,849,834,14,1,839,10,1400,551,516,323,1,12355,0
31,"Prahova",131256,298,131256,,"MUNICIPIUL CAMPINA",173,"GRUPUL SCOLAR INDUSTRIAL CONSTRUCTII DE MASINI Str.Ecaterina Teodoroiu, nr.34 (sala de sport)",1667,920,907,13,0,909,11,1800,880,523,386,1,12355,0
31,"Prahova",131256,298,131256,,"MUNICIPIUL CAMPINA",174,"COLEGIUL TEHNIC ""DR.CONSTANTIN ISTRATI"" (fost GRUPUL SCOLAR INDUSTRIAL DE PETROL)  str. Grivitei , nr.91 (sala de clasa)",1659,1002,978,12,12,994,8,1800,798,574,420,1,12355,0
31,"Prahova",131256,298,131256,,"MUNICIPIUL CAMPINA",175,"SCOLA GENERALA NR.6 Str.Ciceu, nr.2 (sala de clasa)",1607,930,914,16,0,922,8,1800,870,542,380,1,12355,0
31,"Prahova",131256,298,131256,,"MUNICIPIUL CAMPINA",176,"GRUPUL SCOLAR INDUSTRIAL CONSTRUCTII  MASINI Str.Ecaterina Teodoroiu, nr.34 (cantina)",1470,852,844,8,0,841,11,1600,748,550,291,1,12355,0
31,"Prahova",131256,298,131256,,"MUNICIPIUL CAMPINA",177,"SCOALA GENERALA NR.8 B-dul Carol I, nr.104 (sala de clasa)",1580,1012,1003,9,0,999,13,1700,688,546,453,1,12355,0
31,"Prahova",131256,298,131256,,"MUNICIPIUL CAMPINA",178,"S.C.ELECTROUTILAJ S.A. Str.Bobalna, nr.44 (cantina)",1661,933,917,15,1,918,15,1800,867,540,378,1,12355,0
31,"Prahova",131256,298,131256,,"MUNICIPIUL CAMPINA",179,"SCOALA GENERALA NR.3 Str.Voila, nr.11(sala de clasa)",1697,1113,1097,16,0,1099,14,1900,787,659,440,1,12355,0
31,"Prahova",131256,298,131256,,"MUNICIPIUL CAMPINA",180,"GRUPUL SCOLAR INDUSTRIAL CONSTRUCTII  MASINI Str.Ecaterina Teodoroiu, nr.34 (cantina)",1630,870,854,16,0,854,16,1800,930,503,351,1,12355,0
31,"Prahova",131256,298,131256,,"MUNICIPIUL CAMPINA",181,"SCOALA GENERALA NR.8 B-dul Carol I, nr.104 (sala de clasa)",1692,1042,1033,9,0,1034,8,1901,859,531,503,1,12355,0
31,"Prahova",131256,298,131256,,"MUNICIPIUL CAMPINA",182,"CASA TINERETULUI Foaierul mare B-dul Nicolae Balcescu,nr.50",0,840,0,840,0,827,13,1200,360,483,344,1,12355,1
31,"Prahova",130954,298,130954,,"ORAS AZUGA",183,"LICEUL TEORETIC AZUGA CLASELE I-IV Str. Victoriei, nr.65",1662,1016,1003,10,3,997,19,1800,784,608,389,1,12357,0
31,"Prahova",130954,298,130954,,"ORAS AZUGA",184,"LICEUL TEORETIC AZUGA Str Independentei, nr.53",1247,767,757,9,1,755,12,1400,633,413,342,1,12357,0
31,"Prahova",130954,298,130954,,"ORAS AZUGA",185,"GRADINITA DE COPII Str Valea Azugii, nr.3",1348,841,834,6,1,831,10,1500,659,539,292,1,12357,0
31,"Prahova",130954,298,130954,,"ORAS AZUGA",186,"Scoala gimnaziala cu clasele I-IV Str. Victoriei, nr.63",0,322,0,322,0,315,7,600,278,182,133,1,12357,1
31,"Prahova",130981,298,130981,,"ORAS BAICOI",187,"SECTORUL DE GOSPODARIE LOCALA Str.Republicii, nr.55",1145,754,750,3,1,747,7,1300,546,456,291,1,12359,0
31,"Prahova",130981,298,130981,,"ORAS BAICOI",188,"SCOALA GENERALA TUFENI Str.Popa Sapca,nr.117",1231,775,766,9,0,768,7,1400,625,419,349,1,12359,0
31,"Prahova",130981,298,130981,,"ORAS BAICOI",189,"CLUBUL ELEVILOR Str.Unirii, nr.4",1529,979,975,4,0,972,7,1700,721,501,471,1,12359,0
31,"Prahova",130981,298,130981,,"ORAS BAICOI",190,"GRUP SCOLAR CONSTANTIN CANTACUZINO - CLASA I Str.Republicii, nr.111",1159,684,673,11,0,675,9,1300,616,401,274,1,12359,0
31,"Prahova",130981,298,130981,,"ORAS BAICOI",191,"GRUP SCOLAR CONSTANTIN CANTACUZINO - CLASA II Str.Republicii, nr.111",1135,717,705,12,0,704,13,1300,583,416,288,1,12359,0
31,"Prahova",130981,298,130981,,"ORAS BAICOI",192,"GRADINITA LILIESTI Str. Progresului,nr.1",1163,683,676,7,0,671,12,1300,617,391,280,1,12359,0
31,"Prahova",130981,298,130981,,"ORAS BAICOI",193,"SCOALA NR.3 LILIESTI Str.Progresului, nr.2",1662,901,890,11,0,896,5,1800,899,518,378,1,12359,0
31,"Prahova",130981,298,130981,,"ORAS BAICOI",194,"SCOALA NR.3 LILIESTI ANEXA Str.Republicii,nr.317",1588,972,964,8,0,962,10,1700,728,532,430,1,12359,0
31,"Prahova",130981,298,130981,,"ORAS BAICOI",195,"GRADINITA LILIESTI Str.Dorobanti,nr.5",1049,631,624,7,0,619,12,1200,569,318,301,1,12359,0
31,"Prahova",130981,298,130981,,"ORAS BAICOI",196,"CASA DE CULTURA LILIESTI Str.Dorobanti,nr.6",1333,831,814,10,7,822,9,1500,669,456,366,1,12359,0
31,"Prahova",130981,298,130981,,"ORAS BAICOI",197,"SCOALA GENERALA DIMBU Str.Dumbrava Rosie,nr.7",1145,713,707,5,1,707,6,1200,487,385,322,1,12359,0
31,"Prahova",130981,298,130981,,"ORAS BAICOI",198,"SCOALA GENERALA TINTEA Str.Independentei, nr.188",1306,731,723,8,0,723,8,1400,669,402,321,1,12359,0
31,"Prahova",130981,298,130981,,"ORAS BAICOI",199,"CASA DE CULTURA TINTEA Str.Independentei, nr.177",1089,649,639,10,0,638,11,1200,551,392,246,1,12359,0
31,"Prahova",130981,298,130981,,"ORAS BAICOI",200,"SALA DE SPORT  Str.Republicii, nr.10",0,464,0,464,0,458,6,600,136,266,192,1,12359,1
31,"Prahova",131069,298,131069,,"ORAS BOLDESTI-SCAENI",201,"SCOALA GENERALA NR.1 DIN CARTIER BOLDESTI - Str.Podgoriei,nr.12",1091,642,637,5,0,633,9,1200,558,378,255,1,12366,0
31,"Prahova",131069,298,131069,,"ORAS BOLDESTI-SCAENI",202,"SCOALA GENERALA NR.1 DIN CARTIER BOLDESTI - Str.Podgoriei,nr.12",1266,736,725,11,0,726,10,1400,664,407,319,1,12366,0
31,"Prahova",131069,298,131069,,"ORAS BOLDESTI-SCAENI",203,"SCOALA GENERALA NR.1 DIN CARTIER BOLDESTI - Str.Podgoriei,nr.12",1175,703,696,7,0,693,10,1300,597,395,298,1,12366,0
31,"Prahova",131069,298,131069,,"ORAS BOLDESTI-SCAENI",204,"GRADINITA NORD - Str.Calea Unirii,nr.114A",1254,849,837,12,0,834,15,1400,551,426,408,1,12366,0
31,"Prahova",131069,298,131069,,"ORAS BOLDESTI-SCAENI",205,"SCOALA GENERALA NR.2 DIN CARTIER SCAENI - Str.Colinei,nr.40",892,551,543,8,0,546,5,1000,449,285,261,1,12366,0
31,"Prahova",131069,298,131069,,"ORAS BOLDESTI-SCAENI",206,"CASA DE CULTURA DIN CARTIER SCAENI -Str.Bucovului,nr.5",927,605,595,10,0,601,4,1000,395,315,286,1,12366,0
31,"Prahova",131069,298,131069,,"ORAS BOLDESTI-SCAENI",207,"LICEUL INDUSTRIA STICLEI SCAENI - Str.Bucovului,nr.6",931,524,517,6,1,518,6,1001,477,286,232,1,12366,0
31,"Prahova",131069,298,131069,,"ORAS BOLDESTI-SCAENI",208,"SCOALA GENERALA NR.2 BALACA - Str.Morii,nr.36",1056,638,631,7,0,635,3,1199,561,329,306,1,12366,0
31,"Prahova",131069,298,131069,,"ORAS BOLDESTI-SCAENI",209,"SCOALA GENERALA SECIU",848,543,534,8,1,539,4,900,357,268,271,1,12366,0
31,"Prahova",131069,298,131069,,"ORAS BOLDESTI-SCAENI",210,"SCOALA GENERALA SECIU - Seciu,nr.159",0,537,0,537,0,535,2,600,63,242,293,1,12366,1
31,"Prahova",131103,298,131103,,"ORAS BREAZA",211,"SCOALA DE ARTE SI MESERII PODUL VADULUI- Str.23 August,nr 126",1469,817,810,7,0,809,8,1600,783,404,405,1,12369,0
31,"Prahova",131103,298,131103,,"ORAS BREAZA",212,"SCOALA BREAZA DE JOS -  Str.Libertatii,nr.14",1007,585,576,9,0,578,7,1100,515,297,281,1,12369,0
31,"Prahova",131103,298,131103,,"ORAS BREAZA",213,"SCOALA BREAZA DE JOS -  Str.Libertatii,nr.14",1107,628,620,8,0,622,6,1200,572,326,296,1,12369,0
31,"Prahova",131103,298,131103,,"ORAS BREAZA",214,"CASA DE CULTURA ""ION MANOLESCU"" - Str.Republicii,nr.82",1502,861,850,11,0,848,13,1600,739,440,408,1,12369,0
31,"Prahova",131103,298,131103,,"ORAS BREAZA",215,"CASA DE CULTURA ""ION MANOLESCU"" - Str.Republicii,nr.82",1249,783,763,20,0,775,8,1400,617,444,331,1,12369,0
31,"Prahova",131103,298,131103,,"ORAS BREAZA",216,"LICEUL ""AUREL VLAICU"" - Str.Republicii,nr.94",1714,972,967,5,0,964,8,1900,928,517,447,1,12369,0
31,"Prahova",131103,298,131103,,"ORAS BREAZA",217,"LICEUL ""AUREL VLAICU"" - Str.Republicii,nr.94",1034,566,555,11,0,562,4,1100,534,301,261,1,12369,0
31,"Prahova",131103,298,131103,,"ORAS BREAZA",218,"GRADINITA CU PROGRAM PRELUNGIT - FDT.Liliacului f.n.",1032,577,567,10,0,574,3,1100,523,336,238,1,12369,0
31,"Prahova",131103,298,131103,,"ORAS BREAZA",219,"SCOALA GENERALA  CAPU CAMPULUI - Str. Republicii,nr.214",1375,869,862,7,0,860,9,1500,631,505,355,1,12369,0
31,"Prahova",131103,298,131103,,"ORAS BREAZA",220,"GRADINITA GURA BELIEI - Str.30 Decembrie,nr.57",1154,639,630,9,0,635,4,1300,661,358,277,1,12369,0
31,"Prahova",131103,298,131103,,"ORAS BREAZA",221,"SCOALA GENERALA NISTORESTI - Str.Muresului,nr.3",1146,712,704,7,1,711,1,1300,588,360,351,1,12369,0
31,"Prahova",131103,298,131103,,"ORAS BREAZA",222,"SCOALA GENERALA VALEA TIRSEI - Str.Ocinei,nr.183",1182,617,610,7,0,608,9,1300,683,315,293,1,12369,0
31,"Prahova",131103,298,131103,,"ORAS BREAZA",223,"CASA DE CULTURA ""ION MANOLESCU"" -BREAZA, Str.Republicii,nr.82",0,771,0,771,0,764,7,1400,629,360,404,1,12369,1
31,"Prahova",131210,298,131210,,"ORAS BUSTENI",224,"GRUPUL SCOLAR ""ION KALINDERU"" - Str.Alpinistilor,nr.1 Sala multifuctionala",1057,669,655,9,5,656,13,1200,531,449,207,1,12380,0
31,"Prahova",131210,298,131210,,"ORAS BUSTENI",225,"SCOALA CU CLASELE I-VIII ""NESTOR URECHEA"" NR.1 - B-dul Libertatii,nr.123 (sala de clasa)",1110,726,716,8,2,702,24,1200,474,471,231,1,12380,0
31,"Prahova",131210,298,131210,,"ORAS BUSTENI",226,"SCOALA CU CLASELE I-VIII ""NESTOR URECHEA"" NR.1 - B-dul Libertatii,nr.123 (sala de clasa)",936,624,613,11,0,612,12,1000,376,402,210,1,12380,0
31,"Prahova",131210,298,131210,,"ORAS BUSTENI",227,"GRADINITA NR. 6 - Str.Victoriei,nr.11 (sala de clasa)",800,538,521,12,5,527,11,900,362,330,197,1,12380,0
31,"Prahova",131210,298,131210,,"ORAS BUSTENI",228,"PATISERIE ZAMORA - Str.Panduri,nr.38 (sala de festivitati)",1237,853,844,9,0,837,16,1400,547,527,310,1,12380,0
31,"Prahova",131210,298,131210,,"ORAS BUSTENI",229,"SCOALA CU CLASELE I-VIII ""REGINA ELISABETA"" NR.3 - Str.Crinului,nr.2 (sala de festivitati)",1352,924,902,10,12,906,18,1500,576,601,305,1,12380,0
31,"Prahova",131210,298,131210,,"ORAS BUSTENI",230,"SCOALA CU CLASELE I-VIII "" CEZAR PETRESCU"" NR.2 - Str Scolii,nr 20 (sala de clasa)",1393,868,858,9,1,849,19,1500,632,549,300,1,12380,0
31,"Prahova",131210,298,131210,,"ORAS BUSTENI",231,"SCOALA CU CLASELE I-VIII "" CEZAR PETRESCU"" NR.2 - Str Scolii,nr 20 (sala de clasa)",1053,683,676,6,1,675,8,1200,517,458,217,1,12380,0
31,"Prahova",131210,298,131210,,"ORAS BUSTENI",232,"CASA ROMANO-FRANCEZA B-dul Libertatii,nr.174",0,1059,0,1059,0,1043,16,1600,541,638,405,1,12380,1
31,"Prahova",131336,298,131336,,"ORAS COMARNIC",233,"GRUPUL SCOLAR ""SIMION STOLNICU"" COMARNIC - Str.Republicii,nr.30",1656,980,972,8,0,974,6,1800,820,586,388,1,12383,0
31,"Prahova",131336,298,131336,,"ORAS COMARNIC",234,"SCOALA GENERALA NR.2 COMARNIC (VATRA SATULUI) CORPUL 1-Str Er.Nicoara Stelian,nr.2",917,565,560,5,0,558,7,1000,435,325,233,1,12383,0
31,"Prahova",131336,298,131336,,"ORAS COMARNIC",235,"SCOALA GENERALA NR.2 COMARNIC (VATRA SATULUI) CORPUL 2 -Str Er.Nicoara Stelian,nr.2",1367,783,776,6,1,774,9,1499,716,537,237,1,12383,0
31,"Prahova",131336,298,131336,,"ORAS COMARNIC",236,"SCOALA GENERALA NR.3 COMARNIC - POIANA - Str.Poiana.nr.183",1569,922,913,9,0,912,10,1700,778,607,305,1,12383,0
31,"Prahova",131336,298,131336,,"ORAS COMARNIC",237,"GRADINITA DE PRESCOLARI POIANA COMARNIC - Str.Poiana.nr.153",902,594,588,6,0,586,8,1003,409,336,250,1,12383,0
31,"Prahova",131336,298,131336,,"ORAS COMARNIC",238,"SCOALA PRIMARA PODUL LUNG - Str Podul Lung,nr.33",511,324,316,8,0,322,2,600,276,191,131,1,12383,0
31,"Prahova",131336,298,131336,,"ORAS COMARNIC",239,"GRADINITA DE PRESCOLARI NR.2 GHIOSESTI - Str. Ghiosesti,nr.298",1660,969,957,4,8,962,7,1800,831,684,278,1,12383,0
31,"Prahova",131336,298,131336,,"ORAS COMARNIC",240,"SCOALA PRIMARA GHIOSESTI - Str.Ghiosesti,nr.89",1185,727,716,10,1,719,8,1297,570,548,171,1,12383,0
31,"Prahova",131336,298,131336,,"ORAS COMARNIC",241,"GRADINITA POSADA - Str.Podul Vartos,nr.118",1214,738,719,5,14,732,6,1300,562,481,251,1,12383,0
31,"Prahova",131336,298,131336,,"ORAS COMARNIC",242,"GRUP SCOLAR ""SIMION STOLNICU"" - LOCALUL NR.2 - Str.Republicii,nr.20",0,269,0,269,0,267,2,600,331,143,124,1,12383,1
31,"Prahova",131407,298,131407,,"ORAS MIZIL",243,"SALA SPORTULUI - Str.Erou Locotenent Radu Nicolae,nr.4",1432,784,770,14,0,768,16,1600,816,350,418,1,12389,0
31,"Prahova",131407,298,131407,,"ORAS MIZIL",244,"SCOALA GENERALA NR.2 - Str.Tohani,nr.38",1315,737,726,11,0,728,9,1400,663,331,397,1,12389,0
31,"Prahova",131407,298,131407,,"ORAS MIZIL",245,"SCOALA GENERALA NR.1 - Str.Mihai Bravu,nr.110",1186,592,581,10,1,582,10,1300,708,259,323,1,12389,0
31,"Prahova",131407,298,131407,,"ORAS MIZIL",246,"GRUPUL SCOLAR ""TASE DUMITRESCU"" - Str.Mihai Bravu,nr.116",1107,600,589,11,0,598,2,1200,600,228,370,1,12389,0
31,"Prahova",131407,298,131407,,"ORAS MIZIL",247,"CENTRUL DE INFORMARE ""EUROPE DIRECT"" - Str.Mihai Bravu,nr.85",1076,533,524,9,0,518,15,1200,667,221,297,1,12389,0
31,"Prahova",131407,298,131407,,"ORAS MIZIL",248,"CASA DE CULTURA - Str.Mihai Bravu,nr.112",1672,774,766,8,0,763,11,1800,1026,333,430,1,12389,0
31,"Prahova",131407,298,131407,,"ORAS MIZIL",249,"PRIMARIA ORASULUI MIZIL - B-dul Unirii,nr.14",868,479,468,11,0,474,5,1000,521,199,275,1,12389,0
31,"Prahova",131407,298,131407,,"ORAS MIZIL",250,"PRIMARIA ORASULUI MIZIL - B-dul Unirii,nr.14",1176,568,556,12,0,562,6,1300,732,250,312,1,12389,0
31,"Prahova",131407,298,131407,,"ORAS MIZIL",251,"SCOALA GENERALA NR.3 - Str.Erou Locotenent Radu Nicolae,nr.2",1090,548,536,12,0,537,11,1200,652,241,296,1,12389,0
31,"Prahova",131407,298,131407,,"ORAS MIZIL",252,"LICEUL ""GRIGORE TOCILESCU"" - Str.Nicolae Balcescu,nr.133",1075,550,535,12,3,543,7,1200,650,247,296,1,12389,0
31,"Prahova",131407,298,131407,,"ORAS MIZIL",253,"SCOALA GENERALA NR.3 - Str.Erou Locotenent Radu Nicolae,nr.2",1200,661,652,9,0,653,8,1300,639,254,399,1,12389,0
31,"Prahova",131407,298,131407,,"ORAS MIZIL",254,"GRUP SCOLAR ""TASE DUMITRESCU""  MIZIL - Str.Mihai Bravu,nr.116",0,257,0,257,0,251,6,500,243,139,112,1,12389,1
31,"Prahova",131443,298,131443,,"ORAS PLOPENI",255,"CASA DE CULTURA FOAIER - B-dul Republicii,nr.2",1464,891,885,5,1,879,12,1600,709,451,428,1,12392,0
31,"Prahova",131443,298,131443,,"ORAS PLOPENI",256,"SALA POLIVALENTA FOAIER PARTEA DIN DREAPTA - B-dul Republicii,nr.2A",1179,728,709,19,0,723,5,1300,572,352,371,1,12392,0
31,"Prahova",131443,298,131443,,"ORAS PLOPENI",257,"SALA POLIVALENTA FOAIER PARTEA DIN STANGA - B-dul Republicii,nr.2A",1335,784,778,5,1,771,13,1500,716,359,412,1,12392,0
31,"Prahova",131443,298,131443,,"ORAS PLOPENI",258,"GRUP SCOLAR PLOPENI CLADIREA VECHE (PRIMA SALA DE LA PARTER DIN DREAPTA)- B-dul Republicii,nr.10",1208,682,674,6,2,676,6,1300,618,342,334,1,12392,0
31,"Prahova",131443,298,131443,,"ORAS PLOPENI",259,"GRUP SCOLAR PLOPENI CLADIREA VECHE (PRIMA SALA DE LA PARTER DIN STANGA)- B-dul Republicii,nr.10",1598,843,837,6,0,833,10,1700,857,522,311,1,12392,0
31,"Prahova",131443,298,131443,,"ORAS PLOPENI",260,"SCOALA GENERALA AMFITEATRU B-dul Republicii,nr.25",1469,930,922,7,1,917,13,1600,670,540,377,1,12392,0
31,"Prahova",131443,298,131443,,"ORAS PLOPENI",261,"GRUP SCOLAR PLOPENI   B-dul Republicii,nr.21B",0,327,0,327,0,321,6,500,173,202,119,1,12392,1
31,"Prahova",131540,298,131540,,"ORAS SINAIA",262,"Scoala cu clasele I-VIII ""George Enescu"" , Sinaia B-dul Carol I nr.36",911,559,547,12,0,554,5,1010,451,295,259,1,12394,0
31,"Prahova",131540,298,131540,,"ORAS SINAIA",263,"Scoala cu clasele I-VIII ""George Enescu"" , Sinaia B-dul Carol I nr.36",1005,614,605,8,1,607,7,1100,486,359,248,1,12394,0
31,"Prahova",131540,298,131540,,"ORAS SINAIA",264,"Sucursala de Reprezentare si Protocol Sinaia - Complex Economat Aleea Pelesului nr 2 Sala de Conferinte",721,462,455,7,0,459,3,789,327,280,179,1,12394,0
31,"Prahova",131540,298,131540,,"ORAS SINAIA",265,"Centrul Cultural ""Carmen Sylva"" Sinaia str. Mihail Kogalniceanu nr 80 parter",650,387,380,7,0,382,5,700,313,203,179,1,12394,0
31,"Prahova",131540,298,131540,,"ORAS SINAIA",266,"Fosta Gradinita nr 3 Sinaia B-dul Ferdinand nr 2",648,389,377,12,0,385,4,701,312,223,162,1,12394,0
31,"Prahova",131540,298,131540,,"ORAS SINAIA",267,"Inspectia de Stat in Constructii Lucrari Publice, Urbanism si Amenajarea Teritoriului Sinaia B-dul Republicii nr.33",920,571,563,7,1,562,9,1000,429,277,285,1,12394,0
31,"Prahova",131540,298,131540,,"ORAS SINAIA",268,"Compania Nationala de Autostrazi si Drumuri Nationale din Romania SA Sectia Drumuri Nationale Ploiesti - Filiala Sinaia",747,499,485,11,3,493,6,800,301,281,212,1,12394,0
31,"Prahova",131540,298,131540,,"ORAS SINAIA",269,"Scoala cu clasele I-VIII ""Principesa Maria"" Sinaia Calea Moroieni nr 25 Corp A",1597,1057,1044,12,1,1047,10,1800,743,660,387,1,12394,0
31,"Prahova",131540,298,131540,,"ORAS SINAIA",270,"Scoala cu clasele I-VIII ""Principesa Maria"" Sinaia Calea Moroieni nr 25 Corp B",1336,862,851,10,1,842,20,1500,638,470,372,1,12394,0
31,"Prahova",131540,298,131540,,"ORAS SINAIA",271,"Colegiul ""Mihail Cantacuzino"" Sinaia Calea Bucuresti nr 40",1222,756,742,14,0,745,11,1300,544,452,293,1,12394,0
31,"Prahova",131540,298,131540,,"ORAS SINAIA",272,"Colegiul ""Mihail Cantacuzino"" Sinaia Calea Bucuresti nr 40",1142,708,696,12,0,700,8,1300,592,419,281,1,12394,0
31,"Prahova",131540,298,131540,,"ORAS SINAIA",273,"Scoala cu clasele I-VIII ""George Enescu"" parter , B-dul Carol I nr.36  -",0,1190,0,1190,0,1179,11,2500,1310,696,483,1,12394,1
31,"Prahova",131577,298,131577,,"ORAS SLANIC",274,"Scoala Prajani , strada Calea Ploiesti nr. 248",1119,732,727,4,1,722,10,1200,468,326,396,1,12396,0
31,"Prahova",131577,298,131577,,"ORAS SLANIC",275,"Grup Scolar Slanic, strada Slanicului nr. 13 parter",1380,776,770,6,0,763,13,1500,724,355,408,1,12396,0
31,"Prahova",131577,298,131577,,"ORAS SLANIC",276,"Grup Scolar Slanic, strada Slanicului nr. 13  etaj",1425,715,713,2,0,704,11,1600,885,337,367,1,12396,0
31,"Prahova",131577,298,131577,,"ORAS SLANIC",277,"Scoala Grosani, strada Stefan cel Mare nr.24",1628,922,918,4,0,912,10,1800,878,380,532,1,12396,0
31,"Prahova",131577,298,131577,,"ORAS SLANIC",278,"Grup Scolar Slanic - parter, strada Slanicului nr. 13",0,273,0,273,0,269,4,600,327,130,139,1,12396,1
31,"Prahova",131620,298,131620,,"ORAS URLATI",279,"Cresa-gradinita str. Tudor Vladimirescu, nr.10/A",1582,865,853,12,0,860,5,1700,835,436,424,1,12400,0
31,"Prahova",131620,298,131620,,"ORAS URLATI",280,"Liceul Teoretic Urlati (cladirea veche) str. 1 Mai nr.73",1652,876,864,12,0,864,12,1800,924,452,412,1,12400,0
31,"Prahova",131620,298,131620,,"ORAS URLATI",281,"Liceul Teoretic Urlati ,str. 1 Mai nr.30",1498,757,745,12,0,742,15,1600,843,345,397,1,12400,0
31,"Prahova",131620,298,131620,,"ORAS URLATI",282,"Scoala generala nr.2 str. Viitor, nr.1",1653,917,910,6,1,903,14,1800,883,479,424,1,12400,0
31,"Prahova",131620,298,131620,,"ORAS URLATI",283,"Casa de Cultura str. Tudor Vladimirescu, nr.47",1471,821,806,15,0,817,4,1600,779,410,407,1,12400,0
31,"Prahova",131620,298,131620,,"ORAS URLATI",284,"Scoala Jercalai str. Jercalai nr.54",711,376,366,10,0,367,9,800,424,195,172,1,12400,0
31,"Prahova",131620,298,131620,,"ORAS URLATI",285,"Scoala generala (cladirea noua), str. Cherba nr.1",908,473,463,10,0,464,9,1000,527,267,197,1,12400,0
31,"Prahova",131620,298,131620,,"ORAS URLATI",286,"Liceul Teoretic ""Brancoveanu Voda"" cladirea veche , str. 1 Mai nr.73",0,308,0,308,0,305,3,600,292,153,152,1,12400,1
31,"Prahova",131817,298,131817,,"ORAS VALENII DE MUNTE",287,"Primarie, strada Berevoiesti nr. 3A, Sala Casa Casatoriilor",1164,681,674,7,0,673,8,1300,619,323,350,1,12418,0
31,"Prahova",131817,298,131817,,"ORAS VALENII DE MUNTE",288,"Casa de Cultura, strada Berevoiesti nr.9, sala Mica",1305,842,832,9,1,830,12,1400,558,399,431,1,12418,0
31,"Prahova",131817,298,131817,,"ORAS VALENII DE MUNTE",289,"Casa de Cultura, strada Berevoiesti nr.9,  Foaier",1151,665,659,6,0,654,11,1300,635,312,342,1,12418,0
31,"Prahova",131817,298,131817,,"ORAS VALENII DE MUNTE",290,"Clubul Elevilor, strada Berceni nr.1",1022,623,612,7,4,612,11,1100,477,265,347,1,12418,0
31,"Prahova",131817,298,131817,,"ORAS VALENII DE MUNTE",291,"Scoala de Arte si Meserii ""Gheorghe Panculescu"", str. Berceni nr.18",1316,851,840,9,2,841,10,1400,549,438,403,1,12418,0
31,"Prahova",131817,298,131817,,"ORAS VALENII DE MUNTE",292,"Gradinita nr.1, strada nr.20",1332,795,782,11,2,789,6,1500,705,389,400,1,12418,0
31,"Prahova",131817,298,131817,,"ORAS VALENII DE MUNTE",293,"Gradinita nr.4, b-dul Nicolae Iorga nr.96",1041,666,657,9,0,661,5,1100,434,285,376,1,12418,0
31,"Prahova",131817,298,131817,,"ORAS VALENII DE MUNTE",294,"Grup scolar ""Romeo Constantinescu"", strada Brazilor nr.1",951,624,615,8,1,617,7,1100,476,272,345,1,12418,0
31,"Prahova",131817,298,131817,,"ORAS VALENII DE MUNTE",295,"Scoala generala Miulesti, B-dul Nicolae Iorga nr. 188",1136,728,720,8,0,719,9,1200,472,325,394,1,12418,0
31,"Prahova",131817,298,131817,,"ORAS VALENII DE MUNTE",296,"Scoala generala  Valea Gardului, strada Doctor Istrate nr.2",858,622,613,7,2,612,10,1000,378,362,250,1,12418,0
31,"Prahova",131817,298,131817,,"ORAS VALENII DE MUNTE",297,"Sala de Sport ""Stelian Manolescu"", B-dul Nicolae Iorga nr. 43A",0,591,0,591,0,584,7,800,209,301,283,1,12418,1
31,"Prahova",131899,298,131899,,"ADUNATI",298,"Caminul Cultural sat Adunati nr 16",951,584,575,9,0,582,2,1100,516,241,341,3,12420,0
31,"Prahova",131899,298,131899,,"ADUNATI",299,"Gradinita de copii sat Adunati nr 17",832,450,447,3,0,442,8,900,450,248,194,3,12420,0
31,"Prahova",131899,298,131899,,"ADUNATI",300,"Gradinita de copii sat Adunati nr 17",0,67,0,67,0,66,1,200,133,27,39,3,12420,1
31,"Prahova",131933,298,131933,,"ALBESTI-PALEOLOGU",301,"Gradinita de copii Albesti Paleologu",1547,843,823,20,0,833,10,1700,857,495,338,3,12424,0
31,"Prahova",131933,298,131933,,"ALBESTI-PALEOLOGU",302,"Scoala cu clasele I-VIII Vadu Parului",1683,813,781,31,1,804,9,1900,1087,454,350,3,12424,0
31,"Prahova",131933,298,131933,,"ALBESTI-PALEOLOGU",303,"Gradinita de Copii Albesti Muru",934,477,465,12,0,470,7,1000,523,230,240,3,12424,0
31,"Prahova",131933,298,131933,,"ALBESTI-PALEOLOGU",304,"Scoala cu clasele I-VIII Cioceni",693,383,368,15,0,379,4,800,417,151,228,3,12424,0
31,"Prahova",131933,298,131933,,"ALBESTI-PALEOLOGU",305,"Gradinita Albesti Paleologu  Comuna Albesti Paleologu",0,132,0,132,0,132,0,200,68,77,55,3,12424,1
31,"Prahova",131988,298,131988,,"ALUNIS",306,"Scoala cu cls. I-VIII Nr 1 Alunis sat Alunis nr 1025",1331,863,851,12,0,857,6,1500,637,303,554,3,12429,0
31,"Prahova",131988,298,131988,,"ALUNIS",307,"Scoala cu cls. I-IV Nr 2 Alunis sat Alunis nr 632",811,481,469,12,0,472,9,903,422,156,316,3,12429,0
31,"Prahova",131988,298,131988,,"ALUNIS",308,"Scoala cu cls. I-VIII Alunis - Ostrov sat Ostrov nr 23",823,547,540,7,0,539,8,896,349,226,313,3,12429,0
31,"Prahova",131988,298,131988,,"ALUNIS",309,"Scoala cu cls. I-VIII  Alunis centru,sat Alunis nr 1024",0,119,0,119,0,119,0,201,82,43,76,3,12429,1
31,"Prahova",132011,298,132011,,"APOSTOLACHE",310,"Consiliul Local Apostolache",1779,983,979,4,0,977,6,2000,1017,585,392,3,12432,0
31,"Prahova",132011,298,132011,,"APOSTOLACHE",311,"Gradinita cu program normal Apostolache , sat Apostolache nr. 92B  Comuna Apostolache",0,137,0,137,0,137,0,200,63,67,70,3,12432,1
31,"Prahova",132075,298,132075,,"ARICESTII RAHTIVANI",312,"Scoala nr 1 Aricestii Rahtivani - sala cabinet istorie",1181,679,669,10,0,670,9,1300,621,379,291,3,12438,0
31,"Prahova",132075,298,132075,,"ARICESTII RAHTIVANI",313,"Caminul Cultural Aricestii Rahtivani - sala mica",1099,661,658,3,0,658,3,1200,539,337,321,3,12438,0
31,"Prahova",132075,298,132075,,"ARICESTII RAHTIVANI",314,"Gradinita Nedelea - holul gradinitei",807,468,461,7,0,466,2,900,432,238,228,3,12438,0
31,"Prahova",132075,298,132075,,"ARICESTII RAHTIVANI",315,"Scoala Nedelea - sala de sport",1169,692,687,5,0,685,7,1300,608,393,292,3,12438,0
31,"Prahova",132075,298,132075,,"ARICESTII RAHTIVANI",316,"Scoala Stoenesti - sala cabinet istorie",1144,649,641,8,0,638,11,1300,651,276,362,3,12438,0
31,"Prahova",132075,298,132075,,"ARICESTII RAHTIVANI",317,"Scoala Tirgsoru Nou - sala clasa a IV-a",893,805,575,5,225,794,11,998,193,339,455,3,12438,0
31,"Prahova",132075,298,132075,,"ARICESTII RAHTIVANI",318,"Scoala Buda - cancelarie",326,210,200,10,0,208,2,402,192,120,88,3,12438,0
31,"Prahova",132075,298,132075,,"ARICESTII RAHTIVANI",319,"Scoala cu clasele I-VIII Aricestii Rahtivani - sat Aricestii Rahtivani  nr 96",0,191,0,191,0,189,2,500,309,101,88,3,12438,1
31,"Prahova",132137,298,132137,,"ARICESTII ZELETIN",320,"Scoala cu cls I-VIII Inv. Athanasie Jan Stoicescu Aricestii Zeletin,  sat Aricestii Zeletin nr 135, sala sport",1068,598,591,4,3,594,4,1200,602,252,342,3,12444,0
31,"Prahova",132137,298,132137,,"ARICESTII ZELETIN",321,"Scoala cu cls I-VIII Invatator Athanasie Jan Stoicescu  str. Principala  nr 135",0,72,0,72,0,70,2,200,128,34,36,3,12444,1
31,"Prahova",132164,298,132164,,"BABA ANA",322,"Scoala Baba Ana , nr 355, sala din dreapta",1576,874,863,11,0,863,11,1700,826,429,434,3,12447,0
31,"Prahova",132164,298,132164,,"BABA ANA",323,"Scoala sat Ciresanu nr 5",657,343,340,3,0,335,8,700,357,145,190,3,12447,0
31,"Prahova",132164,298,132164,,"BABA ANA",324,"Scoala sat Conduratu nr 220",1018,559,546,11,2,553,6,1100,541,218,335,3,12447,0
31,"Prahova",132164,298,132164,,"BABA ANA",325,"Scoala sat Satu Nou  nr 9",90,61,50,11,0,59,2,100,39,17,42,3,12447,0
31,"Prahova",132164,298,132164,,"BABA ANA",326,"Scoala cu cls I-VIII Baba Ana , sat Baba Ana , nr 355",0,73,0,73,0,72,1,200,127,33,39,3,12447,1
31,"Prahova",132226,298,132226,,"BALTA DOAMNEI",327,"Scoala Balta Doamnei",1220,837,830,7,0,823,14,1300,463,397,426,3,12453,0
31,"Prahova",132226,298,132226,,"BALTA DOAMNEI",328,"Scoala Bira",841,674,674,0,0,660,14,900,226,145,515,3,12453,0
31,"Prahova",132226,298,132226,,"BALTA DOAMNEI",329,"Gradinita Balta Doamnei sat Balta Doamnei nr.236",0,114,0,114,0,113,1,200,86,53,60,3,12453,1
31,"Prahova",132271,298,132271,,"BALTESTI",330,"Scoala cu clasele I-IV Baltesti",1430,863,858,5,0,853,10,1500,637,257,596,3,12458,0
31,"Prahova",132271,298,132271,,"BALTESTI",331,"Scoala cu clasele V-VII Podenii - Vechi",1472,931,921,10,0,929,2,1600,669,461,468,3,12458,0
31,"Prahova",132271,298,132271,,"BALTESTI",332,"Sediul Dispensarului Uman Baltesti , Comuna Baltesti nr.100",0,312,0,312,0,309,3,369,57,82,227,3,12458,1
31,"Prahova",132315,298,132315,,"BANESTI",333,"Scoala Banesti, sat Banesti  nr 301, corp cu etaj",1427,943,923,11,9,924,19,1600,657,538,386,3,12462,0
31,"Prahova",132315,298,132315,,"BANESTI",334,"Dispensar uman Banesti, sat Banesti nr 586, cabinet medical Burlacu Mugurel",1344,879,853,20,6,874,5,1500,621,509,365,3,12462,0
31,"Prahova",132315,298,132315,,"BANESTI",335,"Scoala Urleta, sat Urleta nr 117, corp nou",1070,680,671,4,5,674,6,1200,520,371,303,3,12462,0
31,"Prahova",132315,298,132315,,"BANESTI",336,"Scoala Urleta , sat Urleta, nr 495, corp vechi",994,633,617,14,2,629,4,1100,467,331,298,3,12462,0
31,"Prahova",132315,298,132315,,"BANESTI",337,"Scoala Generala Banesti, sat Banesti str. Din Jos nr 301",0,204,0,204,0,203,1,400,196,131,72,3,12462,1
31,"Prahova",130552,298,130552,,"BARCANESTI",338,"Scoala Generala cu cls.I-VIII, sat Barcanesti",1208,575,557,18,0,561,14,1300,725,268,293,3,12465,0
31,"Prahova",130552,298,130552,,"BARCANESTI",339,"Scoala Generala cu cls.I-VIII , sat Barcanesti",1370,647,634,13,0,638,9,1500,853,319,319,3,12465,0
31,"Prahova",130552,298,130552,,"BARCANESTI",340,"Scoala Generala cu cls. I-VIII, sat Romanesti",1568,901,882,19,0,889,12,1700,799,496,393,3,12465,0
31,"Prahova",130552,298,130552,,"BARCANESTI",341,"Sediul fostei Scoli cu clasele  I-IV sat Puscasi",338,231,221,10,0,226,5,400,169,128,98,3,12465,0
31,"Prahova",130552,298,130552,,"BARCANESTI",342,"Scoala Generala cu cls. I-VIII, sat Tatarani",1272,747,735,12,0,738,9,1300,553,403,335,3,12465,0
31,"Prahova",130552,298,130552,,"BARCANESTI",343,"Scoala Generala cu cls. I-VIII , sat Tatarani",1257,671,663,8,0,665,6,1400,729,408,257,3,12465,0
31,"Prahova",130552,298,130552,,"BARCANESTI",344,"Sediul fostei Scoli cu cls. I-IV, sat Ghighiu",614,387,377,10,0,382,5,700,313,233,149,3,12465,0
31,"Prahova",130552,298,130552,,"BARCANESTI",345,"Scoala cu clasele I-VIII , sat Barcanesti str. DN1",0,400,0,400,0,391,9,400,0,154,237,3,12465,1
31,"Prahova",136278,298,136278,,"BATRANI",346,"Scoala cu clasele I-VIII Batrani",1715,1211,1202,2,7,1200,11,1900,689,580,620,3,12471,0
31,"Prahova",136278,298,136278,,"BATRANI",347,"Scoala cu clasele I-VIII Batrani sat Batrani nr.170",0,153,0,153,0,152,1,200,47,109,43,3,12471,1
31,"Prahova",130614,298,130614,,"BERCENI",348,"Scoala generala Berceni, sat Berceni",1258,603,596,7,0,596,7,1400,797,317,279,3,12474,0
31,"Prahova",130614,298,130614,,"BERCENI",349,"Gradinita nr 2 Berceni, sat Berceni",764,380,365,15,0,376,4,767,387,196,180,3,12474,0
31,"Prahova",130614,298,130614,,"BERCENI",350,"Scoala generala Corlatesti, sat Corlatesti",1166,693,685,8,0,680,13,1299,606,432,248,3,12474,0
31,"Prahova",130614,298,130614,,"BERCENI",351,"Caminul cultural , sat Dimbu",373,240,229,11,0,238,2,400,160,130,108,3,12474,0
31,"Prahova",130614,298,130614,,"BERCENI",352,"Scoala generala Catunu, sat Catunu",551,356,342,14,0,356,0,600,244,167,189,3,12474,0
31,"Prahova",130614,298,130614,,"BERCENI",353,"Scoala generala sat Moara Noua",748,420,406,14,0,416,4,800,380,265,151,3,12474,0
31,"Prahova",130614,298,130614,,"BERCENI",354,"Scoala Generala Berceni, sat Berceni",0,92,0,92,0,92,0,200,108,51,41,3,12474,1
31,"Prahova",132342,298,132342,,"BERTEA",355,"Gradinita de copii nr 1 Bertea",1472,894,887,7,0,884,10,1600,706,531,353,3,12480,0
31,"Prahova",132342,298,132342,,"BERTEA",356,"Gradinita de copii nr 2 Bertea",1208,690,683,7,0,682,8,1400,710,312,370,3,12480,0
31,"Prahova",132342,298,132342,,"BERTEA",357,"Gradinita nr 1 Bertea, sat Bertea",0,72,0,72,0,72,0,200,128,36,36,3,12480,1
31,"Prahova",130678,298,130678,,"BLEJOI",358,"Scoala generala cu clasele I-VIII Blejoi",1613,979,966,8,5,967,12,1600,621,551,416,3,12483,0
31,"Prahova",130678,298,130678,,"BLEJOI",359,"Gradinita Blejoi",1502,902,896,5,1,892,10,1700,798,451,441,3,12483,0
31,"Prahova",130678,298,130678,,"BLEJOI",360,"Gradinita Ploiestiori",1126,708,691,17,0,696,12,1200,492,360,336,3,12483,0
31,"Prahova",130678,298,130678,,"BLEJOI",361,"Caminul Cultural Ploiestiori",1350,781,747,33,1,779,2,1400,619,442,337,3,12483,0
31,"Prahova",130678,298,130678,,"BLEJOI",362,"Gradinita Tintareni",1303,739,730,9,0,736,3,1400,661,423,313,3,12483,0
31,"Prahova",130678,298,130678,,"BLEJOI",363,"Sediul Pietei Agroalimentare Blejoi sat Blejoi nr.1005",0,371,0,371,0,366,5,400,29,152,214,3,12483,1
31,"Prahova",132379,298,132379,,"BOLDESTI-GRADISTEA",364,"Scoala generala cu clasele I-VIII Boldesti, sat Boldesti",759,535,526,8,1,527,8,806,271,304,223,3,12487,0
31,"Prahova",132379,298,132379,,"BOLDESTI-GRADISTEA",365,"Scoala generala cu clasele I-IV Gradistea, sat Gradistea",799,514,510,4,0,509,5,904,390,336,173,3,12487,0
31,"Prahova",132379,298,132379,,"BOLDESTI-GRADISTEA",366,"Scoala Generala cu clasele I-VIII, sat Boldesti",0,73,0,73,0,72,1,200,127,43,29,3,12487,1
31,"Prahova",130712,298,130712,,"BRAZI",367,"Sala de sport - scoala Batesti, sat Batesti",1378,812,803,9,0,802,10,1500,688,486,316,3,12490,0
31,"Prahova",130712,298,130712,,"BRAZI",368,"Sala de festivitati - Primaria Brazi, sat Brazii de Jos",645,373,366,7,0,369,4,700,327,190,179,3,12490,0
31,"Prahova",130712,298,130712,,"BRAZI",369,"Scoala generala Brazii de Sus, sat Brazii de Sus",1002,666,649,16,1,658,8,1100,434,237,421,3,12490,0
31,"Prahova",130712,298,130712,,"BRAZI",370,"Punct de lucru Primaria Brazi, sat Popesti",1441,826,820,6,0,823,3,1600,774,477,346,3,12490,0
31,"Prahova",130712,298,130712,,"BRAZI",371,"Sala de sport - Scoala Negoiesti, sat Negoiesti",1588,964,955,9,0,954,10,1700,736,557,397,3,12490,0
31,"Prahova",130712,298,130712,,"BRAZI",372,"Fostul sediu al Gradinitei de copii din Colonia Brazi",346,195,182,13,0,194,1,400,205,118,76,3,12490,0
31,"Prahova",130712,298,130712,,"BRAZI",373,"Fostul sediu al Scolii generale Stejaru, sat Stejaru",499,277,273,4,0,272,5,600,323,197,75,3,12490,0
31,"Prahova",130712,298,130712,,"BRAZI",374,"Fostul sediu al Gradinitei de copii din satul Brazii de Sus, sat Brazii de Sus, str. Lalelelor nr.4",0,172,0,172,0,170,2,300,128,76,94,3,12490,1
31,"Prahova",132404,298,132404,,"BREBU",375,"Scoala veche  din satul Brebu Minastirii",924,539,532,7,0,535,4,1000,461,281,254,3,12497,0
31,"Prahova",132404,298,132404,,"BREBU",376,"Scoala noua din satul Brebu Minastirii",1473,769,767,2,0,763,6,1600,831,499,264,3,12497,0
31,"Prahova",132404,298,132404,,"BREBU",377,"Scoala nr 2 din satul Brebu Megiesesc (Lacul Sec)",1549,842,836,6,0,827,15,1700,858,485,342,3,12497,0
31,"Prahova",132404,298,132404,,"BREBU",378,"Scoala din satul Brebu Megiesesc ( Siliste)",1240,717,706,8,3,711,6,1400,683,448,263,3,12497,0
31,"Prahova",132404,298,132404,,"BREBU",379,"Scoala din satul Pietriceaua",992,488,480,8,0,485,3,1100,612,274,211,3,12497,0
31,"Prahova",132404,298,132404,,"BREBU",380,"Scoala Nr 1 Local Nou sat Brebu Manastirii nr. 803",0,187,0,187,0,184,3,300,113,97,87,3,12497,1
31,"Prahova",130785,298,130785,,"BUCOV",381,"Scoala Bucov Constantin Stere, sat Bucov",1333,670,664,6,0,661,9,1500,830,378,283,3,12502,0
31,"Prahova",130785,298,130785,,"BUCOV",382,"Scoala Bucov Constantin Stere, sat Bucov",1398,777,738,39,0,772,5,1500,723,422,350,3,12502,0
31,"Prahova",130785,298,130785,,"BUCOV",383,"Gradinita Bucov, sat Bucov",1279,637,629,7,1,630,7,1400,763,355,275,3,12502,0
31,"Prahova",130785,298,130785,,"BUCOV",384,"Gradinita Chitorani, sat  Chitorani",1177,686,660,26,0,676,10,1300,614,351,325,3,12502,0
31,"Prahova",130785,298,130785,,"BUCOV",385,"Scoala Mihai Voda, sat Pleasa",1168,678,667,11,0,675,3,1300,622,357,318,3,12502,0
31,"Prahova",130785,298,130785,,"BUCOV",386,"Gradinita Pleasa, sat Pleasa",1334,753,737,16,0,743,10,1500,747,405,338,3,12502,0
31,"Prahova",130785,298,130785,,"BUCOV",387,"Gradinita II Pleasa, sat Pleasa",969,436,425,11,0,436,0,1000,564,275,161,3,12502,0
31,"Prahova",130785,298,130785,,"BUCOV",388,"Gradinita Bucov, sat Bucov nr. 777 D",0,157,0,157,0,156,1,300,143,90,66,3,12502,1
31,"Prahova",132459,298,132459,,"CALUGARENI",389,"Scoala generala clasele I-VIII , sat Calugareni",1065,611,611,0,0,596,15,1200,589,278,318,3,12508,0
31,"Prahova",132459,298,132459,,"CALUGARENI",390,"Scoala generala clasele I-VIII , sat Calugareni",0,73,0,73,0,72,1,200,127,37,35,3,12508,1
31,"Prahova",132486,298,132486,,"CARBUNESTI",391,"Scoala cu clasele I-VIII , sat Carbunesti",1460,856,847,1,8,847,9,1600,744,530,317,3,12511,0
31,"Prahova",132486,298,132486,,"CARBUNESTI",392,"Scoala Carbunesti, sat Carbunesti nr 168",0,83,0,83,0,82,1,201,118,49,33,3,12511,1
31,"Prahova",132510,298,132510,,"CEPTURA",393,"Scoala cu clasele I-VIII sat Ceptura de Jos",991,534,522,12,0,529,5,1100,566,266,263,3,12514,0
31,"Prahova",132510,298,132510,,"CEPTURA",394,"Scoala cu clasele I-VIII sat Ceptura de jos",981,489,478,11,0,486,3,1100,611,271,215,3,12514,0
31,"Prahova",132510,298,132510,,"CEPTURA",395,"Scoala cu clasele I-IV, sat Ceptura de Sus",536,270,260,10,0,266,4,600,330,131,135,3,12514,0
31,"Prahova",132510,298,132510,,"CEPTURA",396,"Scoala cu clasele I-VIII sat Soimesti",665,374,368,5,1,370,4,700,326,208,162,3,12514,0
31,"Prahova",132510,298,132510,,"CEPTURA",397,"Scoala cu clasele I-VIII ,sat Rotari",666,308,300,8,0,305,3,700,392,177,128,3,12514,0
31,"Prahova",132510,298,132510,,"CEPTURA",398,"Scoala cu clasele I-IV , sat Malu-Rosu",176,96,88,8,0,94,2,200,104,56,38,3,12514,0
31,"Prahova",132510,298,132510,,"CEPTURA",399,"Caminul cultural, sat Ceptura de Jos nr. 344",0,120,0,120,0,117,3,201,81,55,62,3,12514,1
31,"Prahova",132574,298,132574,,"CERASU",400,"Scoala de Arte si Meserii Cerasu, corp B(scoala noua), sala de cursuri clasa a X-a",1286,772,746,11,15,758,14,1400,628,371,387,3,12520,0
31,"Prahova",132574,298,132574,,"CERASU",401,"Scoala generala cu clasele I-VIII Valea Borului , corp A, sala de cursuri clasa a VIII -a",745,508,480,6,22,496,12,800,292,237,259,3,12520,0
31,"Prahova",132574,298,132574,,"CERASU",402,"Scoala generala cu clasele I-VIII Slon, sala de cursuri clasa a VIII-a B",814,489,473,7,9,485,4,895,406,242,243,3,12520,0
31,"Prahova",132574,298,132574,,"CERASU",403,"Scoala generala cu clasele I-VIII Slon, sala de cursuri clasa a VII-a",926,556,538,5,13,544,12,1000,444,259,285,3,12520,0
31,"Prahova",132574,298,132574,,"CERASU",404,"Scoala de Arte si Meserii Cerasu,  sat Cerasu",0,132,0,132,0,132,0,200,68,51,81,3,12520,1
31,"Prahova",132645,298,132645,,"CHIOJDEANCA",405,"Gradinita sat Chiojdeanca",864,586,579,3,4,581,5,1000,414,336,245,3,12527,0
31,"Prahova",132645,298,132645,,"CHIOJDEANCA",406,"Scoala generala sat Trenu",490,326,305,12,9,322,4,500,174,112,210,3,12527,0
31,"Prahova",132645,298,132645,,"CHIOJDEANCA",407,"Gradinita Chiojdeanca (a doua sala de clasa) ,sat Chiojdeanca",0,101,0,101,0,101,0,200,99,54,47,3,12527,1
31,"Prahova",132681,298,132681,,"CIORANI",408,"Liceul Ciorani ( cladirea veche), sat Cioranii de Jos",1008,637,614,12,11,634,3,1100,463,169,465,3,12531,0
31,"Prahova",132681,298,132681,,"CIORANI",409,"Liceul Ciorani (cladirea noua), sat Cioranii de Jos",1495,960,924,18,18,945,15,1600,640,328,617,3,12531,0
31,"Prahova",132681,298,132681,,"CIORANI",410,"Scoala cu clasele I-IV( fostul spital), sat Cioranii de Jos",1043,881,840,18,23,870,11,1200,319,184,686,3,12531,0
31,"Prahova",132681,298,132681,,"CIORANI",411,"Scoala generala Cioranii de Sus ( cladirea noua)",922,618,602,15,1,612,6,1000,382,206,406,3,12531,0
31,"Prahova",132681,298,132681,,"CIORANI",412,"Primaria ( cladirea anexa, Cioranii de Sus)",1011,667,648,19,0,651,16,1098,431,192,459,3,12531,0
31,"Prahova",132681,298,132681,,"CIORANI",413,"Scoala Generala Cioranii de Sus , cladirea noua , sat Cioranii de Sus",0,167,0,167,0,167,0,200,33,74,93,3,12531,1
31,"Prahova",136241,298,136241,,"COCORASTII COLT",414,"Gradinita de copii Cocorastii Colt",1523,866,859,7,0,850,16,1700,834,480,370,3,12534,0
31,"Prahova",136241,298,136241,,"COCORASTII COLT",415,"Scoala cu clasele I-IV Cocorastii Grind",942,559,538,21,0,551,8,1000,441,330,221,3,12534,0
31,"Prahova",136241,298,136241,,"COCORASTII COLT",416,"Camin cultural, sat Persunari, nr 180A",0,178,0,178,0,177,1,200,22,70,107,3,12534,1
31,"Prahova",132716,298,132716,,"COCORASTII MISLII",417,"Caminul cultural Cocorastii Mislii, sat Cocorastii Mislii",1602,1049,1044,5,0,1037,12,1800,751,631,406,3,12543,0
31,"Prahova",132716,298,132716,,"COCORASTII MISLII",418,"Caminul cultural din satul Goruna",1350,849,842,5,2,839,10,1500,651,487,352,3,12543,0
31,"Prahova",132716,298,132716,,"COCORASTII MISLII",419,"Scoala cu clasele I-VIII ,sat Cocorastii Mislii, sala de sport sat Cocorastii Mislii",0,115,0,115,0,114,1,200,85,86,28,3,12543,1
31,"Prahova",132752,298,132752,,"COLCEAG",420,"Scoala generala cu clasele I-VIII Colceag",1230,610,586,24,0,605,5,1300,690,288,317,3,12547,0
31,"Prahova",132752,298,132752,,"COLCEAG",421,"Scoala generala cu clasele I-IV Vilcelele",461,289,267,22,0,280,9,500,211,147,133,3,12547,0
31,"Prahova",132752,298,132752,,"COLCEAG",422,"Scoala generala cu clasele I-VIII Inotesti",1582,1043,971,43,29,1032,11,1698,655,441,591,3,12547,0
31,"Prahova",132752,298,132752,,"COLCEAG",423,"Scoala generala cu clasele I-VIII Parepa - Rusani",894,486,458,10,18,485,1,1000,514,245,240,3,12547,0
31,"Prahova",132752,298,132752,,"COLCEAG",424,"Scoala cu clasele I-VIII Colceag sat Colceag nr.384 D",0,161,0,161,0,159,2,300,139,86,73,3,12547,1
31,"Prahova",132805,298,132805,,"CORNU",425,"Gradinita de copii Cornu  de Jos, str. Gradinitei nr. 337",1448,871,863,8,0,863,8,1600,729,302,561,3,12552,0
31,"Prahova",132805,298,132805,,"CORNU",426,"Scoala generala clasele I-VIII Cornu de Jos, B-dul Eroilor, nr 480",1465,920,911,9,0,914,6,1400,480,334,580,3,12552,0
31,"Prahova",132805,298,132805,,"CORNU",427,"Gradinita de copii Cornu de Sus, str. Mihai Viteazul , nr  217",857,600,593,6,1,592,8,805,205,219,373,3,12552,0
31,"Prahova",132805,298,132805,,"CORNU",428,"Caminul cultural ,sat Cornu de Jos,  Bdul Eroilor nr. 481",0,495,0,495,0,487,8,600,105,182,305,3,12552,1
31,"Prahova",132841,298,132841,,"COSMINELE",429,"Biblioteca comunala Cosminele, sat Cosmina de Jos nr 83 A",945,596,581,1,14,592,4,1000,404,327,265,3,12556,0
31,"Prahova",132841,298,132841,,"COSMINELE",430,"Gradinita de copii Cosmina de Jos sat Cosmina de Jos   nr.83",0,93,0,93,0,91,2,200,107,37,54,3,12556,1
31,"Prahova",132896,298,132896,,"DRAJNA",431,"Scoala de Arte si Meserii Platon Mocanu, sat Drajna de Jos, nr 670, sala 1, parter",1481,927,918,9,0,919,8,1450,523,324,595,3,12569,0
31,"Prahova",132896,298,132896,,"DRAJNA",432,"Scoala generala cu clasele I-IV Plaisani, sat Drajna de Jos, nr 537, sala  1, parter",715,457,450,7,0,454,3,806,349,180,274,3,12569,0
31,"Prahova",132896,298,132896,,"DRAJNA",433,"Scoala generala cu clasele I-VIII sat Drajna de Sus, nr 465, sala 1 , parter",1230,707,696,11,0,701,6,1401,694,353,348,3,12569,0
31,"Prahova",132896,298,132896,,"DRAJNA",434,"Scoala generala cu clasele I-VIII sat Ogretin, nr 254, sala 1 , parter",1118,642,631,11,0,636,6,1200,558,363,273,3,12569,0
31,"Prahova",132896,298,132896,,"DRAJNA",435,"Scoala cu clasele I-VIII Drajna de Jos, sat Drajna de Jos",0,275,0,275,0,272,3,350,75,151,121,3,12569,1
31,"Prahova",133018,298,133018,,"DRAGANESTI",436,"Gradinita Draganesti, sat Draganesti",1035,485,475,10,0,473,12,1098,613,285,188,3,12561,0
31,"Prahova",133018,298,133018,,"DRAGANESTI",437,"Gradinita Baraitaru, sat Baraitaru",724,419,416,3,0,412,7,800,381,246,166,3,12561,0
31,"Prahova",133018,298,133018,,"DRAGANESTI",438,"Gradinita Belciug, sat Belciug",463,275,267,8,0,273,2,500,225,162,111,3,12561,0
31,"Prahova",133018,298,133018,,"DRAGANESTI",439,"Scoala cu clasele I-IV Cornu de Jos",519,291,283,8,0,289,2,600,309,192,97,3,12561,0
31,"Prahova",133018,298,133018,,"DRAGANESTI",440,"Scoala cu clasele I-IV Hatcarau",421,237,230,7,0,235,2,503,266,130,105,3,12561,0
31,"Prahova",133018,298,133018,,"DRAGANESTI",441,"Scoala cu clasele I-IV Meri",865,421,411,10,0,415,6,900,479,272,143,3,12561,0
31,"Prahova",133018,298,133018,,"DRAGANESTI",442,"Gradinita Draganesti, sat Draganesti",0,132,0,132,0,132,0,300,168,81,51,3,12561,1
31,"Prahova",133090,298,133090,,"DUMBRAVA",443,"Caminul cultural sat Dumbrava",1410,796,785,9,2,785,11,1500,704,377,408,3,12581,0
31,"Prahova",133090,298,133090,,"DUMBRAVA",444,"Caminul cultural sat Zanoaga",746,473,465,5,3,465,8,800,327,212,253,3,12581,0
31,"Prahova",133090,298,133090,,"DUMBRAVA",445,"Caminul cultural sat Ciupelnita",1325,704,697,7,0,686,18,1500,796,349,337,3,12581,0
31,"Prahova",133090,298,133090,,"DUMBRAVA",446,"Scoala generala nr 2 Nicolae Dinu , sat Dumbrava, str. Politiei nr.99",0,98,0,98,0,98,0,200,102,48,50,3,12581,1
31,"Prahova",131461,298,131461,,"DUMBRAVESTI",447,"Caminul cultural, sat Dumbravesti",1216,747,727,7,13,738,9,1300,553,340,398,3,12588,0
31,"Prahova",131461,298,131461,,"DUMBRAVESTI",448,"Sala de festivitati Plopeni Sat",1304,809,800,5,4,800,9,1400,591,444,356,3,12588,0
31,"Prahova",131461,298,131461,,"DUMBRAVESTI",449,"Scoala sat Sfarleanca",507,342,332,6,4,336,6,601,259,149,187,3,12588,0
31,"Prahova",131461,298,131461,,"DUMBRAVESTI",450,"Gradinita Dumbravesti, sat Dumbravesti",0,175,0,175,0,174,1,201,26,57,117,3,12588,1
31,"Prahova",133278,298,133278,,"FANTANELE",451,"Caminul cultural, camera 1, sat Fantanele",869,474,459,9,6,473,1,999,525,254,219,3,12595,0
31,"Prahova",133278,298,133278,,"FANTANELE",452,"Caminul cultural, camera 2, sat Fantanele",874,478,468,6,4,476,2,998,520,245,231,3,12595,0
31,"Prahova",133278,298,133278,,"FANTANELE",453,"Camin cultural, etaj 1, camera 3 Comuna Fantanele nr. 493A",0,54,0,54,0,54,0,200,146,25,29,3,12595,1
31,"Prahova",133161,298,133161,,"FILIPESTII DE PADURE",454,"Clubul Minerul Filipestii de Padure",1016,538,530,7,1,537,1,1100,562,316,221,3,12598,0
31,"Prahova",133161,298,133161,,"FILIPESTII DE PADURE",455,"Scoala veche Filipestii de Padure",1663,913,901,12,0,900,13,1800,887,482,418,3,12598,0
31,"Prahova",133161,298,133161,,"FILIPESTII DE PADURE",456,"Liceul Teoretic Filipestii de Padure",1602,885,871,14,0,881,4,1700,815,465,416,3,12598,0
31,"Prahova",133161,298,133161,,"FILIPESTII DE PADURE",457,"Scoala Generala , sat Ditesti",1115,635,616,19,0,624,11,1200,565,426,198,3,12598,0
31,"Prahova",133161,298,133161,,"FILIPESTII DE PADURE",458,"Gradinita nr 1, sat Ditesti",1009,594,567,27,0,584,10,1100,506,376,208,3,12598,0
31,"Prahova",133161,298,133161,,"FILIPESTII DE PADURE",459,"Gradinita  nr 2, sat Ditesti",954,527,514,13,0,514,13,1100,573,328,186,3,12598,0
31,"Prahova",133161,298,133161,,"FILIPESTII DE PADURE",460,"Grupul Scolar , sat Minieri",1139,631,624,7,0,623,8,1300,669,300,323,3,12598,0
31,"Prahova",133161,298,133161,,"FILIPESTII DE PADURE",461,"Liceul Teoretic , Filipestii de Padure, corpul  B, str. Principala nr. 344A",0,164,0,164,0,164,0,300,136,100,64,3,12598,1
31,"Prahova",133214,298,133214,,"FILIPESTII DE TARG",462,"Scoala generala Filipestii de Tirg, sat Filipestii de Tirg",1009,568,558,10,0,564,4,1100,532,361,203,3,12603,0
31,"Prahova",133214,298,133214,,"FILIPESTII DE TARG",463,"Camin cultural Filipestii de Tirg ( ARLUS), sat Filipestii de Tirg",1190,696,682,14,0,689,7,1300,604,467,222,3,12603,0
31,"Prahova",133214,298,133214,,"FILIPESTII DE TARG",464,"Scoala generala Bratasanca, sat Bratasanca",1569,990,985,5,0,976,14,1700,710,689,287,3,12603,0
31,"Prahova",133214,298,133214,,"FILIPESTII DE TARG",465,"Scoala generala Marginenii de Jos ( scoala noua), sat Marginenii de Jos",1575,732,715,17,0,720,12,1700,968,314,406,3,12603,0
31,"Prahova",133214,298,133214,,"FILIPESTII DE TARG",466,"Scoala generala Marginenii de Jos ( scoala veche), sat Marginenii de Jos",1186,581,568,13,0,574,7,1300,719,169,405,3,12603,0
31,"Prahova",133214,298,133214,,"FILIPESTII DE TARG",467,"Scoala generala Filipestii de Targ, Comuna Filipestii de Targ",0,192,0,192,0,190,2,310,118,117,73,3,12603,1
31,"Prahova",133330,298,133330,,"FLORESTI",468,"Gradinita de copii sat Floresti",1221,951,939,12,0,935,16,1399,448,189,746,3,12609,0
31,"Prahova",133330,298,133330,,"FLORESTI",469,"Scoala cu clasele I-VIII sat Floresti",721,515,455,60,0,507,8,796,281,227,280,3,12609,0
31,"Prahova",133330,298,133330,,"FLORESTI",470,"Scoala cu clasele I-VIII localul vechi, sat Floresti",1276,676,667,9,0,668,8,1400,724,314,354,3,12609,0
31,"Prahova",133330,298,133330,,"FLORESTI",471,"Cantina sociala Floresti, sat Floresti",1065,581,556,25,0,572,9,1315,734,290,282,3,12609,0
31,"Prahova",133330,298,133330,,"FLORESTI",472,"Scoala cu clasele I-VIII , sat Calinesti",418,321,267,14,40,317,4,501,180,110,207,3,12609,0
31,"Prahova",133330,298,133330,,"FLORESTI",473,"Caminul cultural sat Calinesti",1034,553,434,15,104,546,7,1100,547,184,362,3,12609,0
31,"Prahova",133330,298,133330,,"FLORESTI",474,"Scoala cu clasele I-IV , sat Novacesti",593,400,387,13,0,397,3,599,199,137,260,3,12609,0
31,"Prahova",133330,298,133330,,"FLORESTI",475,"Scoala cu clasele I-VIII local vechi Floresti, sat Floresti nr. 250",0,227,0,227,0,225,2,600,373,113,112,3,12609,1
31,"Prahova",133394,298,133394,,"FULGA",476,"Caminul cultural, sat Fulga de Jos",1330,584,577,7,0,574,10,1500,916,193,381,3,12615,0
31,"Prahova",133394,298,133394,,"FULGA",477,"Scoala Fulga de Sus, sat Fulga de Sus",1613,769,766,3,0,753,16,1800,1031,350,403,3,12615,0
31,"Prahova",133394,298,133394,,"FULGA",478,"Fostul sediu al Primariei Comunei Fulga, sat Fulga de Jos",0,89,0,89,0,88,1,200,111,43,45,3,12615,1
31,"Prahova",133429,298,133429,,"GHERGHITA",479,"Scoala generala cu clasele I-VIII , sat Gherghita",969,536,516,9,11,523,13,1099,563,199,324,3,12618,0
31,"Prahova",133429,298,133429,,"GHERGHITA",480,"Scoala cu clasele I-IV sat Malamuc",337,220,206,6,8,217,3,400,180,117,100,3,12618,0
31,"Prahova",133429,298,133429,,"GHERGHITA",481,"Scoala cu clasele I-IV sat Independenta",173,116,107,9,0,115,1,201,85,65,50,3,12618,0
31,"Prahova",133429,298,133429,,"GHERGHITA",482,"Scoala cu clasele I-VIII , sat  Gherghita",0,97,0,97,0,95,2,200,103,48,47,3,12618,1
31,"Prahova",133508,298,133508,,"GORGOTA",483,"Scoala  Generala sat Potigrafu",1102,730,715,12,3,724,6,1098,368,415,309,3,12623,0
31,"Prahova",133508,298,133508,,"GORGOTA",484,"Scoala cu clasele I-IV , sat Gorgota",1297,812,797,15,0,806,6,1400,588,461,345,3,12623,0
31,"Prahova",133508,298,133508,,"GORGOTA",485,"Scoala generala , sat Poienarii Apostoli",1199,763,751,12,0,757,6,1300,537,351,406,3,12623,0
31,"Prahova",133508,298,133508,,"GORGOTA",486,"Scoala cu clasele I-IV , sat Crivina",808,522,516,6,0,516,6,900,378,222,294,3,12623,0
31,"Prahova",133508,298,133508,,"GORGOTA",487,"Caminul cultural Poienarii Apostoli , sat Poienarii Apostoli",0,179,0,179,0,179,0,200,21,95,84,3,12623,1
31,"Prahova",133562,298,133562,,"GORNET",488,"Scoala generala cu clasele I-VIII , sat Gornet",881,578,575,3,0,572,6,1100,522,258,314,3,12629,0
31,"Prahova",133562,298,133562,,"GORNET",489,"Caminul cultural , sat Gornet",1138,782,782,0,0,776,6,1200,418,396,380,3,12629,0
31,"Prahova",133562,298,133562,,"GORNET",490,"Scoala generala cu clasele I-IV , sat Cuib",310,218,210,8,0,214,4,400,182,73,141,3,12629,0
31,"Prahova",133562,298,133562,,"GORNET",491,"Scoala generala cu clasele I-IV , sat Nucet",188,121,114,7,0,120,1,201,80,53,67,3,12629,0
31,"Prahova",133562,298,133562,,"GORNET",492,"Camin cultural Gornet, sat Gornet, sat Gornet, str. Principala nr.459",0,76,0,76,0,76,0,200,124,34,42,3,12629,1
31,"Prahova",133615,298,133615,,"GORNET-CRICOV",493,"Caminul cultural , sat Gornet-Cricov",846,426,419,7,0,417,9,898,472,225,192,3,12634,0
31,"Prahova",133615,298,133615,,"GORNET-CRICOV",494,"Gradinita din satul Coserele",691,393,385,6,2,389,4,800,407,208,181,3,12634,0
31,"Prahova",133615,298,133615,,"GORNET-CRICOV",495,"Gradinita din satul Dobrota",416,269,259,10,0,265,4,500,231,127,138,3,12634,0
31,"Prahova",133615,298,133615,,"GORNET-CRICOV",496,"Gradinita Gornet Cricov,din sat Gornet-Cricov",0,120,0,120,0,120,0,300,180,55,65,3,12634,1
31,"Prahova",133688,298,133688,,"GURA VADULUI",497,"Scoala din satul Gura Vadului",1237,636,599,7,30,630,6,1300,664,328,302,3,12641,0
31,"Prahova",133688,298,133688,,"GURA VADULUI",498,"Scoala generala din satul Persunari",750,445,420,12,13,440,5,805,360,215,225,3,12641,0
31,"Prahova",133688,298,133688,,"GURA VADULUI",499,"Scoala din satul Gura Vadului, sat Gura Vadului",0,96,0,96,0,96,0,202,106,49,47,3,12641,1
31,"Prahova",131835,298,131835,,"GURA VITIOAREI",500,"Scoala Gura Vitioarei nr.197",1700,917,907,10,0,912,5,1900,983,434,478,3,12645,0
31,"Prahova",131835,298,131835,,"GURA VITIOAREI",501,"Scoala Fagetu nr.371",995,517,513,4,0,505,12,900,383,234,271,3,12645,0
31,"Prahova",131835,298,131835,,"GURA VITIOAREI",502,"Scoala Poiana Copaceni nr. 321",825,520,511,9,0,515,5,900,380,225,290,3,12645,0
31,"Prahova",131835,298,131835,,"GURA VITIOAREI",503,"Scoala Buchea de Jos nr.74",845,453,449,4,0,449,4,1099,646,223,226,3,12645,0
31,"Prahova",131835,298,131835,,"GURA VITIOAREI",504,"Gradinita Fundeni nr.197",566,336,329,7,0,335,1,600,264,200,135,3,12645,0
31,"Prahova",131835,298,131835,,"GURA VITIOAREI",505,"Camin Cultural Sat Gura Vitioarei, sat Gura Vitioarei",0,105,0,105,0,104,1,201,96,53,51,3,12645,1
31,"Prahova",133722,298,133722,,"IORDACHEANU",506,"Gradinita Iordacheanu",970,590,584,6,0,586,4,1100,510,379,207,3,12651,0
31,"Prahova",133722,298,133722,,"IORDACHEANU",507,"Scoala Mocesti",975,509,502,7,0,506,3,1100,591,276,230,3,12651,0
31,"Prahova",133722,298,133722,,"IORDACHEANU",508,"Cladire noua Valea Cucului",1062,606,598,8,0,597,9,1200,594,346,251,3,12651,0
31,"Prahova",133722,298,133722,,"IORDACHEANU",509,"Scoala Varbila",1130,621,613,8,0,606,15,1300,679,249,357,3,12651,0
31,"Prahova",133722,298,133722,,"IORDACHEANU",510,"Scoala de Arte si Meserii  sat Iordacheanu",0,142,0,142,0,141,1,300,158,88,53,3,12651,1
31,"Prahova",133795,298,133795,,"IZVOARELE",511,"Scoala I-VIII sat Izvoarele",1119,630,624,6,0,627,3,1201,571,292,335,3,12658,0
31,"Prahova",133795,298,133795,,"IZVOARELE",512,"Scoala I-VIII sat Izvoarele",903,536,525,11,0,533,3,1000,464,253,280,3,12658,0
31,"Prahova",133795,298,133795,,"IZVOARELE",513,"Scoala I-VIII sat Homoriciu",988,584,578,6,0,577,7,1100,516,252,325,3,12658,0
31,"Prahova",133795,298,133795,,"IZVOARELE",514,"Scoala I-VIII sat Homoriciu",793,405,394,11,0,400,5,900,495,183,217,3,12658,0
31,"Prahova",133795,298,133795,,"IZVOARELE",515,"Scoala I-VIII sat Schiulesti",1016,578,570,8,0,577,1,1100,522,199,378,3,12658,0
31,"Prahova",133795,298,133795,,"IZVOARELE",516,"Scoala I-IV sat Malu Vinat",704,408,399,9,0,404,4,800,392,204,200,3,12658,0
31,"Prahova",133795,298,133795,,"IZVOARELE",517,"Caminul Cultural  Homoriciu, sat Homoriciu str. DN1A nr.178",0,225,0,225,0,225,0,300,75,111,114,3,12658,1
31,"Prahova",133866,298,133866,,"JUGURENI",518,"Caminul Cultural sat Jugureni",527,392,335,5,52,389,3,600,208,127,262,3,12665,0
31,"Prahova",133866,298,133866,,"JUGURENI",519,"Cladirea caminului cultural in sala fosta biblioteca, Comuna  Jugureni nr. 131",0,94,0,94,0,92,2,200,106,30,62,3,12665,1
31,"Prahova",133919,298,133919,,"LAPOS",520,"Scoala cu clasele I-VIII Lapos Cabinetul  de Limba si Literatura Romana",1059,580,580,0,0,565,15,1200,620,237,328,3,12670,0
31,"Prahova",133919,298,133919,,"LAPOS",521,"Caminul Cultural  sat Lapos",0,45,0,45,0,45,0,199,154,14,31,3,12670,1
31,"Prahova",133964,298,133964,,"LIPANESTI",522,"Camin cultural, sala fosta biblioteca actuala sala de lectura, sat Lipanesti",1349,786,771,14,1,766,20,1500,714,461,305,3,12675,0
31,"Prahova",133964,298,133964,,"LIPANESTI",523,"Scoala Eroilor cu clasele I-VIII Sipotu, sala cabinet romana, sat Sipotu",1816,1040,1020,20,0,1023,17,2000,960,615,408,3,12675,0
31,"Prahova",133964,298,133964,,"LIPANESTI",524,"Scoala cu clasele I-VIII Zamfira, sala limba si comunicare, sat Zamfira",940,564,553,11,0,560,4,996,432,337,223,3,12675,0
31,"Prahova",133964,298,133964,,"LIPANESTI",525,"Scoala cu clasele I-VIII  sat Zamfira, sat Zamfira , DN 1A",0,190,0,190,0,188,2,400,210,129,59,3,12675,1
31,"Prahova",134014,298,134014,,"MAGURELE",526,"Caminul cultural , sat Magurele",1303,753,747,6,0,747,6,1400,647,435,312,3,12680,0
31,"Prahova",134014,298,134014,,"MAGURELE",527,"Scoala veche , sat Magurele",1500,908,897,11,0,897,11,1450,542,518,379,3,12680,0
31,"Prahova",134014,298,134014,,"MAGURELE",528,"Scoala cu clasele I-IV , sat Coada Malului",680,477,465,12,0,466,11,701,224,268,198,3,12680,0
31,"Prahova",134014,298,134014,,"MAGURELE",529,"Gradinita , sat Iazu",527,309,299,10,0,299,10,600,291,210,89,3,12680,0
31,"Prahova",134014,298,134014,,"MAGURELE",530,"Scoala de Arte si Meserii  Magurele, sat Magurele nr. 688",0,252,0,252,0,249,3,350,98,178,71,3,12680,1
31,"Prahova",134050,298,134050,,"MAGURENI",531,"Scoala cu clasele I-IV Magureni, corp B, sat Magureni",1445,751,739,12,0,743,8,1600,849,347,396,3,12684,0
31,"Prahova",134050,298,134050,,"MAGURENI",532,"Scoala cu clasele I-IV nr 2 - Magureni, sat Magureni",1026,551,544,6,1,548,3,1100,549,283,265,3,12684,0
31,"Prahova",134050,298,134050,,"MAGURENI",533,"Scoala generala nr 1 cu clasele I-VIII Magureni, corp A, sat Magureni",1352,680,672,7,1,672,8,1500,820,375,297,3,12684,0
31,"Prahova",134050,298,134050,,"MAGURENI",534,"Scoala cu clasele I-IV nr 3  Lunca Prahovei, sat Lunca Prahovei",881,472,466,6,0,464,8,1000,528,154,310,3,12684,0
31,"Prahova",134050,298,134050,,"MAGURENI",535,"Scoala cu clasele  I-IV nr 4 Cocorastii Caplii, sat Cocorastii Caplii",690,405,396,9,0,402,3,800,395,219,183,3,12684,0
31,"Prahova",134050,298,134050,,"MAGURENI",536,"Camin Cultural centru Magureni, str. Principala nr.983",0,139,0,139,0,137,2,202,63,79,58,3,12684,1
31,"Prahova",134096,298,134096,,"MANECIU",537,"Gradinita de copii cu 4 grupe sat Maneciu Ungureni",1520,967,949,11,7,960,7,1700,733,414,546,3,12688,0
31,"Prahova",134096,298,134096,,"MANECIU",538,"Scoala Mica cu clasele I-IV din satul Gheaba, nr.391",1400,881,867,6,8,870,11,1500,619,348,522,3,12688,0
31,"Prahova",134096,298,134096,,"MANECIU",539,"Grup Scolar Maneciu, sat Gheaba, nr.5",1175,745,732,9,4,739,6,1300,555,408,331,3,12688,0
31,"Prahova",134096,298,134096,,"MANECIU",540,"Grup Scolar Maneciu, sat Gheaba, nr.5",1144,704,693,10,1,701,3,1300,596,318,383,3,12688,0
31,"Prahova",134096,298,134096,,"MANECIU",541,"Scoala cu clasele I-IV, sat Maneciu Paminteni, nr. 267",1779,1047,1041,5,1,1035,12,2000,953,553,482,3,12688,0
31,"Prahova",134096,298,134096,,"MANECIU",542,"Scoala cu clasele I-VIII, sat Maneciu Paminteni, nr. 1229",1630,981,972,8,1,967,14,1800,819,450,517,3,12688,0
31,"Prahova",134096,298,134096,,"MANECIU",543,"Scoala cu clasele I-IV,  sat Cheia",341,187,175,12,0,186,1,400,213,110,76,3,12688,0
31,"Prahova",134096,298,134096,,"MANECIU",544,"Sala de sport , sat Cheia, nr.364",0,269,0,269,0,264,5,2008,1739,165,99,3,12688,1
31,"Prahova",134194,298,134194,,"MANESTI",545,"Caminul cultural Manesti, sala mare",1005,551,545,6,0,540,11,1100,549,306,234,3,12698,0
31,"Prahova",134194,298,134194,,"MANESTI",546,"Scoala cu clasele I-IV Zalhanaua",748,483,473,10,0,479,4,800,317,209,270,3,12698,0
31,"Prahova",134194,298,134194,,"MANESTI",547,"Scoala cu clasele I-IV Coada Izvorului",731,476,462,14,0,471,5,800,324,236,235,3,12698,0
31,"Prahova",134194,298,134194,,"MANESTI",548,"Scoala cu clasele I-IV Baltita",758,470,458,12,0,467,3,800,330,277,190,3,12698,0
31,"Prahova",134194,298,134194,,"MANESTI",549,"Caminul Cultural Manesti, sat Manesti str. Principala nr.131",0,165,0,165,0,164,1,200,35,93,71,3,12698,1
31,"Prahova",136250,298,136250,,"OLARI",550,"Scoala cu clasele I-IV sat Olarii-Vechi",707,470,461,9,0,464,6,800,330,70,394,3,12704,0
31,"Prahova",136250,298,136250,,"OLARI",551,"Scoala cu clasele I-VIII sat Olari",552,418,377,41,0,410,8,600,182,120,290,3,12704,0
31,"Prahova",136250,298,136250,,"OLARI",552,"Scoala cu clasele I-IV sat Finari",342,253,244,9,0,245,8,399,146,55,190,3,12704,0
31,"Prahova",136250,298,136250,,"OLARI",553,"Scoala cu clasele I-VIII  Olari, sat Olari",0,76,0,76,0,76,0,200,124,24,52,3,12704,1
31,"Prahova",134336,298,134336,,"PACURETI",554,"Gradinita Pacureti nr 112 Sala 1",1107,701,694,7,0,688,13,1200,499,420,268,3,12708,0
31,"Prahova",134336,298,134336,,"PACURETI",555,"Scoala Matita nr 365 A, sala 1",673,362,355,7,0,356,6,700,338,227,129,3,12708,0
31,"Prahova",134336,298,134336,,"PACURETI",556,"Gradinita Pacureti , sala II sat Pacureti nr. 112",0,78,0,78,0,76,2,200,122,46,30,3,12708,1
31,"Prahova",130847,298,130847,,"PAULESTI",557,"Scoala generala cu clasele I-VIII "" Toma T Socolescu"" sat Paulestii Noi",1160,807,792,15,0,793,14,1300,493,392,401,3,12714,0
31,"Prahova",130847,298,130847,,"PAULESTI",558,"Caminul Cultural din satul Paulesti",961,696,686,10,0,691,5,1100,404,349,342,3,12714,0
31,"Prahova",130847,298,130847,,"PAULESTI",559,"Gradinita din satul Cocosesti",660,531,508,12,11,522,9,700,169,283,239,3,12714,0
31,"Prahova",130847,298,130847,,"PAULESTI",560,"Scoala cu clasele I-VIII  "" Vlad Musatescu"" din satul Gageni",876,629,615,8,6,622,7,1000,371,321,301,3,12714,0
31,"Prahova",130847,298,130847,,"PAULESTI",561,"Caminul Cultural din satul Gageni",850,618,596,14,8,611,7,900,282,285,326,3,12714,0
31,"Prahova",130847,298,130847,,"PAULESTI",562,"Gradinita Paulesti, sat Paulesti nr. 497",0,301,0,301,0,300,1,406,105,133,167,3,12714,1
31,"Prahova",134390,298,134390,,"PLOPU",563,"Gradinita Plopu parter, sat Plopu nr. imobil 271A",833,508,499,9,0,503,5,900,392,271,232,3,12719,0
31,"Prahova",134390,298,134390,,"PLOPU",564,"Scoala cu cls. I-IV Nisipoasa, parter, sala din stanga nr. imobil 190",655,424,416,7,1,415,9,700,276,179,236,3,12719,0
31,"Prahova",134390,298,134390,,"PLOPU",565,"Scoala cu cls. I-IV Gilmea, parter, sala din stanga nr. imobil 75",202,121,117,4,0,121,0,301,180,62,59,3,12719,0
31,"Prahova",134390,298,134390,,"PLOPU",566,"Scoala cu cls. I-IV Hirsa, parter, sala din dreapta nr. imobil 1A",202,132,127,5,0,129,3,201,69,48,81,3,12719,0
31,"Prahova",134390,298,134390,,"PLOPU",567,"Scoala Generala cu clasele I-VIII Plopu, sat Plopu nr. 138",0,130,0,130,0,128,2,300,170,58,70,3,12719,1
31,"Prahova",134443,298,134443,,"PODENII NOI",568,"Scoala cu clasele I-VIII Podenii Noi",1157,626,619,7,0,610,16,1300,674,308,302,3,12724,0
31,"Prahova",134443,298,134443,,"PODENII NOI",569,"Scoala cu clasele I-VIII  Valea Dulce",1328,686,678,8,0,679,7,1400,714,410,269,3,12724,0
31,"Prahova",134443,298,134443,,"PODENII NOI",570,"Scoala cu clasele I-VIII  Mehedinta",1218,753,744,9,0,744,9,1300,547,351,393,3,12724,0
31,"Prahova",134443,298,134443,,"PODENII NOI",571,"Scoala de coordonare cu clasele I-VIII, sat Podenii Noi",0,177,0,177,0,175,2,200,23,74,101,3,12724,1
31,"Prahova",131274,298,131274,,"POIANA CAMPINA",572,"Scoala Generala cu clasele I-VIII ""inv. Ion Mateescu"" sat Poiana Campina nr.235 Sala de sport",1013,591,580,7,4,584,7,1000,409,296,288,3,12735,0
31,"Prahova",131274,298,131274,,"POIANA CAMPINA",573,"Primaria comunei Poiana - Campina, sat Poiana - Campina, nr 462 holul principal al institutiei",1212,708,695,8,5,702,6,1300,592,385,317,3,12735,0
31,"Prahova",131274,298,131274,,"POIANA CAMPINA",574,"Biblioteca ""Dimitrie Gusti"", Sat Poiana - Campina nr. 462",957,557,549,8,0,546,11,1097,540,263,283,3,12735,0
31,"Prahova",131274,298,131274,,"POIANA CAMPINA",575,"Scoala Generala Pietrisu, Sat Pietrisu, nr. 118B holul principal",366,233,218,15,0,226,7,400,167,134,92,3,12735,0
31,"Prahova",131274,298,131274,,"POIANA CAMPINA",576,"Caminul Cultural Bobolia, sat Bobolia nr. 264",867,572,558,14,0,570,2,1000,428,419,151,3,12735,0
31,"Prahova",131274,298,131274,,"POIANA CAMPINA",577,"Gara CFR Campina, sat Poiana Campina nr 188",0,302,0,302,0,295,7,400,98,164,131,3,12735,1
31,"Prahova",134559,298,134559,,"POIENARII BURCHII",578,"Scoala Generala cu clasele I-VIII  satul Poienarii Burchii",1140,668,641,27,0,656,12,1200,532,394,262,3,12740,0
31,"Prahova",134559,298,134559,,"POIENARII BURCHII",579,"Gradinita de copii din satul Carbunari",610,394,348,46,0,391,3,700,306,213,178,3,12740,0
31,"Prahova",134559,298,134559,,"POIENARII BURCHII",580,"Scoala Generala cu clasele I-VIII  satul Poienarii Rali",934,630,605,25,0,619,11,1000,370,232,387,3,12740,0
31,"Prahova",134559,298,134559,,"POIENARII BURCHII",581,"Gradinita de copii din satul Ologeni",1192,680,669,11,0,674,6,1300,620,366,308,3,12740,0
31,"Prahova",134559,298,134559,,"POIENARII BURCHII",582,"Caminul Cultural din satul Tatarai",411,270,238,32,0,263,7,500,230,110,153,3,12740,0
31,"Prahova",134559,298,134559,,"POIENARII BURCHII",583,"Scoala cu clasele I-VIII  Poienarii Burchii, sat Poienarii Burchii",0,308,0,308,0,305,3,401,93,162,143,3,12740,1
31,"Prahova",134648,298,134648,,"POSESTI",584,"Caminul Cultural Posesti din satul Posesti-Paminteni",764,464,441,2,21,458,6,800,336,277,181,3,12749,0
31,"Prahova",134648,298,134648,,"POSESTI",585,"Localul fostei primarii Nucsoara din satul Nucsoara de Jos",1241,718,718,0,0,715,3,1400,682,336,379,3,12749,0
31,"Prahova",134648,298,134648,,"POSESTI",586,"Caminul Cultural din satul Valea Plopului",727,429,421,8,0,424,5,818,389,162,262,3,12749,0
31,"Prahova",134648,298,134648,,"POSESTI",587,"Scoala Generala cu clasele I-IV din satul Tirlesti",533,287,284,3,0,282,5,600,313,156,126,3,12749,0
31,"Prahova",134648,298,134648,,"POSESTI",588,"Caminul Cultural , intrarea principala, sat Posesti Pamanteni nr.8",0,139,0,139,0,138,1,203,64,87,51,3,12749,1
31,"Prahova",134755,298,134755,,"PREDEAL-SARARI",589,"Scoala Generala cu clasele I-VIII sat Predeal nr 201",810,483,482,0,1,479,4,706,223,225,254,3,12760,0
31,"Prahova",134755,298,134755,,"PREDEAL-SARARI",590,"Scoala Elementara Zimbroaia sat Zimbroaia nr.111",162,104,91,9,4,104,0,200,96,19,85,3,12760,0
31,"Prahova",134755,298,134755,,"PREDEAL-SARARI",591,"Scoala Generala cu clasele I-VIII Predeal, sat  Vitioara de Sus nr.59",1016,567,563,4,0,567,0,1193,626,275,292,3,12760,0
31,"Prahova",134755,298,134755,,"PREDEAL-SARARI",592,"Scoala cu clasele I-VIII Predeal, sat Predeal nr.201",0,87,0,87,0,87,0,203,116,33,54,3,12760,1
31,"Prahova",134853,298,134853,,"PROVITA DE JOS",593,"Scoala Generala cu clasele I-VIII din satul Provita de Jos",984,587,584,2,1,579,8,1100,513,352,227,3,12770,0
31,"Prahova",134853,298,134853,,"PROVITA DE JOS",594,"Gradinita de Copii din satul Draganeasa",933,600,588,7,5,594,6,1015,415,400,194,3,12770,0
31,"Prahova",134853,298,134853,,"PROVITA DE JOS",595,"Scoala cu clasele I-VIII Provita de Jos, parter, cabinet biologie, sat Provita de Jos nr.170",0,137,0,137,0,137,0,200,63,79,58,3,12770,1
31,"Prahova",134899,298,134899,,"PROVITA DE SUS",596,"Scoala Generala cu clasele I-VIII satul Provita de Sus",1491,979,959,7,13,973,6,1600,621,655,318,3,12774,0
31,"Prahova",134899,298,134899,,"PROVITA DE SUS",597,"Scoala Generala cu clasele I-IV Izvoru",343,228,222,6,0,224,4,407,179,158,66,3,12774,0
31,"Prahova",134899,298,134899,,"PROVITA DE SUS",598,"Gradinita de copii  Provita de Sus, sat Provita de Sus nr.74",0,159,0,159,0,158,1,200,41,98,60,3,12774,1
31,"Prahova",134942,298,134942,,"PUCHENII MARI",599,"Scoala Generala cu clasele I-VIII Puchenii Mari satul Puchenii Mari",1119,638,628,10,0,623,15,1100,462,393,230,3,12779,0
31,"Prahova",134942,298,134942,,"PUCHENII MARI",600,"Scoala Generala cu clasele I-VIII Pietrosani satul Pietrosani",1032,544,537,7,0,531,13,1000,456,306,225,3,12779,0
31,"Prahova",134942,298,134942,,"PUCHENII MARI",601,"Gradinita de copii satul Pietrosani",938,517,508,9,0,510,7,1000,483,267,243,3,12779,0
31,"Prahova",134942,298,134942,,"PUCHENII MARI",602,"Scoala Generala cu clasele I-VIII satul Puchenii Mosneni",1170,698,678,20,0,692,6,1300,602,432,260,3,12779,0
31,"Prahova",134942,298,134942,,"PUCHENII MARI",603,"Scoala Generala cu clasele I-IV satul Miroslavesti",1551,851,817,34,0,838,13,1600,749,490,348,3,12779,0
31,"Prahova",134942,298,134942,,"PUCHENII MARI",604,"Scoala Generala cu clasele I-IV Odaile",1346,907,892,15,0,888,19,1400,493,629,259,3,12779,0
31,"Prahova",134942,298,134942,,"PUCHENII MARI",605,"Scoala cu clasele I-VIII Puchenii Mari, sat Puchenii Mari nr.1",0,514,0,514,0,504,10,600,86,314,190,3,12779,1
31,"Prahova",135020,298,135020,,"RAFOV",606,"Sc.gen. cu cls. I-IV satul Malaesti",634,408,404,4,0,406,2,701,293,136,270,3,12787,0
31,"Prahova",135020,298,135020,,"RAFOV",607,"Sc.gen. cu cls. I-IV  satul Moara Domneasca",791,477,470,7,0,468,9,900,423,273,195,3,12787,0
31,"Prahova",135020,298,135020,,"RAFOV",608,"Sc.gen. cu cls. I-VIII satul Buda",899,497,484,13,0,496,1,1000,503,323,173,3,12787,0
31,"Prahova",135020,298,135020,,"RAFOV",609,"Sc.gen. cu cls. I-IV  satul Palanca",923,530,524,6,0,524,6,999,469,300,224,3,12787,0
31,"Prahova",135020,298,135020,,"RAFOV",610,"Sc.gen. cu cls. I-IV  satul Goga",401,243,236,7,0,241,2,500,257,133,108,3,12787,0
31,"Prahova",135020,298,135020,,"RAFOV",611,"Sc.gen. cu cls. I-IV  satul Sicrita",384,207,200,7,0,206,1,400,193,129,77,3,12787,0
31,"Prahova",135020,298,135020,,"RAFOV",612,"Fostul sediu primarie sat Rifov",305,164,159,5,0,161,3,401,237,88,73,3,12787,0
31,"Prahova",135020,298,135020,,"RAFOV",613,"Sc.gen. cu cls. I-IV  sat Buchilasi",115,84,73,11,0,83,1,200,116,52,31,3,12787,0
31,"Prahova",135020,298,135020,,"RAFOV",614,"Scoala generala cu clasele V-VIII Malaiesti, sat Malaiesti str. Principala nr.216",0,118,0,118,0,116,2,200,82,65,51,3,12787,1
31,"Prahova",135128,298,135128,,"SALCIA",615,"Scoala cu clasele V-VIII sat Salcia nr 195, corpul nr.1 sala nr 1",932,504,501,3,0,500,4,1000,496,322,178,3,12797,0
31,"Prahova",135128,298,135128,,"SALCIA",616,"Scoala cu clasele V-VIII sat Salcia nr 195",0,70,0,70,0,70,0,200,130,42,28,3,12797,1
31,"Prahova",135146,298,135146,,"SALCIILE",617,"Localul scolii noi sat Salciile nr 351",885,583,577,6,0,574,9,996,413,298,276,3,12799,0
31,"Prahova",135146,298,135146,,"SALCIILE",618,"Sala mica a Caminului Cultural sat Salciile nr 350",836,509,504,5,0,503,6,900,391,256,247,3,12799,0
31,"Prahova",135146,298,135146,,"SALCIILE",619,"Localul scolii vechi , sat Salciile nr. 348",0,171,0,171,0,171,0,200,29,88,83,3,12799,1
31,"Prahova",135244,298,135244,,"SANGERU",620,"Caminul Cultural din satul Singeru",1113,533,528,5,0,528,5,1200,667,189,339,3,12801,0
31,"Prahova",135244,298,135244,,"SANGERU",621,"Caminul Cultural din satul Singeru",1345,553,549,4,0,541,12,1500,947,252,289,3,12801,0
31,"Prahova",135244,298,135244,,"SANGERU",622,"Caminul Cultural din satul Miresu Mare",1247,654,643,11,0,645,9,1400,746,307,338,3,12801,0
31,"Prahova",135244,298,135244,,"SANGERU",623,"Caminul Cultural din satul Butuci",445,262,255,7,0,258,4,500,238,123,135,3,12801,0
31,"Prahova",135244,298,135244,,"SANGERU",624,"Gradinita Sangeru, sat Sangeru nr. 83",0,91,0,91,0,91,0,203,112,32,59,3,12801,1
31,"Prahova",135164,298,135164,,"SCORTENI",625,"Scoala cu clasele I-VIII Scorteni str. Principala nr 7, sala de clasa",1266,659,650,9,0,655,4,1400,741,383,272,3,12808,0
31,"Prahova",135164,298,135164,,"SCORTENI",626,"Scoala cu clasele I-VIII Mislea str. Schelei nr 17 sala de clasa",1560,856,840,16,0,844,12,1700,844,477,367,3,12808,0
31,"Prahova",135164,298,135164,,"SCORTENI",627,"Sediul fostei Scoli cu clasele I-IV Bordenii Mari, Strada Mircea cel Batran nr.1 Corp A sala de clasa",1209,736,717,19,0,731,5,1300,564,404,327,3,12808,0
31,"Prahova",135164,298,135164,,"SCORTENI",628,"Scoala cu clasele I-VIII Sarca str IL Caragiale nr 12, cancelarie",844,520,504,15,1,515,5,900,380,287,228,3,12808,0
31,"Prahova",135164,298,135164,,"SCORTENI",629,"Sediul Serviciului Public Comunitar Local de Evidenta a Persoanei Scorteni, sat Scorteni str. Unirii nr.15",0,110,0,110,0,110,0,300,190,57,53,3,12808,1
31,"Prahova",135226,298,135226,,"SECARIA",630,"Caminul Cultural Secaria",1056,785,753,1,31,778,7,1200,415,567,211,3,12814,0
31,"Prahova",135226,298,135226,,"SECARIA",631,"Caminul Cultural Intrare I, Comuna Secaria nr. 367 A",0,67,0,67,0,67,0,200,133,54,13,3,12814,1
31,"Prahova",135315,298,135315,,"STARCHIOJD",632,"Gradinita de copii Starchiojd sat Starchiojd nr 452",1472,858,846,11,1,850,8,1600,742,415,435,3,12834,0
31,"Prahova",135315,298,135315,,"STARCHIOJD",633,"Gradinita de copii Garbeasca sat Starchiojd nr 1018",1240,748,741,7,0,736,12,1400,652,317,419,3,12834,0
31,"Prahova",135315,298,135315,,"STARCHIOJD",634,"Scoala Valea Anei sat Valea Anei nr 201",523,275,267,8,0,274,1,600,325,67,207,3,12834,0
31,"Prahova",135315,298,135315,,"STARCHIOJD",635,"Gradinita de copii , sat Starchiojd nr 45A",0,141,0,141,0,139,2,200,59,69,70,3,12834,1
31,"Prahova",135404,298,135404,,"SURANI",636,"Gradinita de copii Surani nr 232 sala A",1495,799,794,5,0,789,10,1700,901,501,288,3,12845,0
31,"Prahova",135404,298,135404,,"SURANI",637,"Gradinita de copii Surani , Comuna Surani nr 232",0,71,0,71,0,71,0,200,129,44,27,3,12845,1
31,"Prahova",135431,298,135431,,"SIRNA",638,"Scoala cu clasele I-VIII  Tariceni sala nr1 Festivitati",964,613,607,6,0,606,7,1100,487,324,282,3,12816,0
31,"Prahova",135431,298,135431,,"SIRNA",639,"Scoala cu clasele I-VIII  Tariceni sala nr 2",651,379,371,8,0,376,3,700,321,213,163,3,12816,0
31,"Prahova",135431,298,135431,,"SIRNA",640,"Scoala cu clasele I-IV Sirna sala nr 1",659,378,370,8,0,370,8,700,322,224,146,3,12816,0
31,"Prahova",135431,298,135431,,"SIRNA",641,"Scoala cu clasele I-VIII Varnita sat Varnita",811,471,460,11,0,464,7,900,429,322,142,3,12816,0
31,"Prahova",135431,298,135431,,"SIRNA",642,"Scoala cu clasele I-VIII  Habud",672,423,416,7,0,421,2,700,277,255,166,3,12816,0
31,"Prahova",135431,298,135431,,"SIRNA",643,"Scoala cu clasele I-IV Bratesti",449,294,287,7,0,285,9,500,206,162,123,3,12816,0
31,"Prahova",135431,298,135431,,"SIRNA",644,"Scoala cu clasele I-IV Sirna , Comuna Sirna, str. Principala nr.32",0,183,0,183,0,181,2,200,17,100,81,3,12816,1
31,"Prahova",135501,298,135501,,"SOIMARI",645,"Scoala Generala cu clasele I-VIII Soimari",1388,774,768,6,0,763,11,1500,726,496,267,3,12823,0
31,"Prahova",135501,298,135501,,"SOIMARI",646,"Gradinita Lopatnita",567,340,336,4,0,337,3,600,260,231,106,3,12823,0
31,"Prahova",135501,298,135501,,"SOIMARI",647,"Caminul cultural Magura",436,263,256,7,0,259,4,500,237,147,112,3,12823,0
31,"Prahova",135501,298,135501,,"SOIMARI",648,"Club Tineret, sat Soimari",0,104,0,104,0,100,4,201,97,57,43,3,12823,1
31,"Prahova",135547,298,135547,,"SOTRILE",649,"Scoala cu clasele I-VIII sat Sotriile nr 148",914,414,406,8,0,412,2,998,584,234,178,3,12827,0
31,"Prahova",135547,298,135547,,"SOTRILE",650,"Scoala cu clasele I-IV sat Seciuri nr 12",305,196,187,9,0,195,1,370,174,123,72,3,12827,0
31,"Prahova",135547,298,135547,,"SOTRILE",651,"Scoala cu clasele I-IV sat Lunca Mare nr 123",393,245,240,5,0,243,2,400,155,142,101,3,12827,0
31,"Prahova",135547,298,135547,,"SOTRILE",652,"Scoala cu clasele I-IV sat Plaiul Campinei nr 82",619,357,352,5,0,343,14,700,343,196,147,3,12827,0
31,"Prahova",135547,298,135547,,"SOTRILE",653,"Scoala cu clasele I-IV sat Vistieru nr 19",507,291,287,4,0,289,2,595,304,122,167,3,12827,0
31,"Prahova",135547,298,135547,,"SOTRILE",654,"Scoala Sotrile, sat Sotrile",0,50,0,50,0,50,0,200,150,25,25,3,12827,1
31,"Prahova",135618,298,135618,,"STEFESTI",655,"Scoala Generala cu clasele I-VIII  din satul Stefesti nr 116",1277,740,732,8,0,736,4,1400,660,317,419,3,12841,0
31,"Prahova",135618,298,135618,,"STEFESTI",656,"Gradinita de copii din satul Scurtesti nr 246A",727,412,407,5,0,407,5,800,388,177,230,3,12841,0
31,"Prahova",135618,298,135618,,"STEFESTI",657,"Scoala Generala cu clasele I-VIII, sat Stefesti nr 116",0,48,0,48,0,48,0,200,152,23,25,3,12841,1
31,"Prahova",135654,298,135654,,"TALEA",658,"Scoala Generala cu clasele I-VIII Talea",960,658,657,0,1,647,11,1100,442,424,223,3,12848,0
31,"Prahova",135654,298,135654,,"TALEA",659,"Scoala cu clasele I-VIII Talea, sat Talea nr. 53",0,49,0,49,0,49,0,200,151,23,26,3,12848,1
31,"Prahova",135681,298,135681,,"TATARU",660,"Primaria Tataru,  sat Podgoria",582,343,330,4,9,337,6,600,257,207,130,3,12856,0
31,"Prahova",135681,298,135681,,"TATARU",661,"Caminul Cultural  Tataru",309,220,199,5,16,219,1,404,184,108,111,3,12856,0
31,"Prahova",135681,298,135681,,"TATARU",662,"Scoala  cu  clasele  I--VIII Podgoria, sat Podgoria nr. 94",0,77,0,77,0,77,0,200,123,36,41,3,12856,1
31,"Prahova",130892,298,130892,,"TARGSORU VECHI",663,"Baza  Sportiva  a S.C.CONPET, sat  Strejnicu",1431,898,889,9,0,892,6,1600,702,667,225,3,12851,0
31,"Prahova",130892,298,130892,,"TARGSORU VECHI",664,"Gradinita   Strejnicu  ,  sat  Strejnicu",1571,938,923,15,0,926,12,1700,762,683,243,3,12851,0
31,"Prahova",130892,298,130892,,"TARGSORU VECHI",665,"Scoala  Generala  cu  clasele I-VIII Strejnicu  ,sat Strejnicu",1575,858,846,12,0,852,6,1692,834,616,236,3,12851,0
31,"Prahova",130892,298,130892,,"TARGSORU VECHI",666,"Scoala Generala cu clasele I-VIII Tirgsoru Vechi (cladirea noua)",1027,532,523,9,0,525,7,1114,582,378,147,3,12851,0
31,"Prahova",130892,298,130892,,"TARGSORU VECHI",667,"Gradinita  Tirgsoru  Vechi",825,461,449,12,0,450,11,900,439,293,157,3,12851,0
31,"Prahova",130892,298,130892,,"TARGSORU VECHI",668,"Scoala  Generala  cu clasele I-IV Stancesti",697,416,400,16,0,411,5,800,384,246,165,3,12851,0
31,"Prahova",130892,298,130892,,"TARGSORU VECHI",669,"Scoala Targsoru Vechi - cladirea  veche , Sat Targsoru Vechi",0,270,0,270,0,270,0,406,136,208,62,3,12851,1
31,"Prahova",135725,298,135725,,"TEISANI",670,"Scoala Generala cu cls  I-VIII  Teisani",1499,959,950,8,1,946,13,1700,741,508,438,3,12860,0
31,"Prahova",135725,298,135725,,"TEISANI",671,"Scoala  Generala cu  cls I-VIII  Olteni",1595,990,990,0,0,983,7,1800,810,442,541,3,12860,0
31,"Prahova",135725,298,135725,,"TEISANI",672,"Casa  de  citit Bughea de Sus",57,53,45,8,0,53,0,100,47,16,37,3,12860,0
31,"Prahova",135725,298,135725,,"TEISANI",673,"Scoala  cu  clasele  I-VIII  Olteni, sat Olteni nr. 147",0,86,0,86,0,85,1,200,114,47,38,3,12860,1
31,"Prahova",135789,298,135789,,"TELEGA",674,"Scoala  cu  clasele  I-VIII  Telega  Centru  nr 1,nr 1302",1235,688,678,10,0,679,9,1400,712,352,327,3,12866,0
31,"Prahova",135789,298,135789,,"TELEGA",675,"Scoala cu  clasele  I-VIII  Telega -Vale ,nr. 2,  nr  487",1536,981,964,17,0,965,16,1700,719,544,421,3,12866,0
31,"Prahova",135789,298,135789,,"TELEGA",676,"Gradinita  de  copii  Telega  Centru  nr1, nr  1313A",1233,765,760,5,0,761,4,1392,627,404,357,3,12866,0
31,"Prahova",135789,298,135789,,"TELEGA",677,"Scoala  cu  clasele I-VIII  Sat  Bustenari , nr 62",586,323,313,10,0,321,2,600,277,171,150,3,12866,0
31,"Prahova",135789,298,135789,,"TELEGA",678,"Scoala  cu  clasele  I-IV  Sat  Melicesti , nr 99",446,281,270,11,0,279,2,502,221,127,152,3,12866,0
31,"Prahova",135789,298,135789,,"TELEGA",679,"Gradinita  Doftana,  sat  Telega nr. 1629",0,204,0,204,0,203,1,300,96,96,107,3,12866,1
31,"Prahova",135850,298,135850,,"TINOSU",680,"Camin  cultural- gradinita  Tinosu,  sat  Tinosu",960,556,547,9,0,554,2,1096,540,332,222,3,12873,0
31,"Prahova",135850,298,135850,,"TINOSU",681,"Scoala  cu  clasele  I-IV  Predesti  ,sat  Predesti",541,416,401,8,7,411,5,601,185,292,119,3,12873,0
31,"Prahova",135850,298,135850,,"TINOSU",682,"Scoala  cu  clasele  I-IV  Pisculesti ,sat  Pisculesti",514,343,336,7,0,340,3,599,256,193,147,3,12873,0
31,"Prahova",135850,298,135850,,"TINOSU",683,"Cladirea camin  cultural-gradinita, sat Tinosu nr. 347",0,114,0,114,0,114,0,200,86,67,47,3,12873,1
31,"Prahova",135896,298,135896,,"TOMSANI",684,"Caminul  Cultural  Tomsani",1252,733,726,7,0,721,12,1400,667,386,335,3,12877,0
31,"Prahova",135896,298,135896,,"TOMSANI",685,"Scoala  veche  Magula  ,sat  Magula",1167,674,668,5,1,664,10,1300,626,312,352,3,12877,0
31,"Prahova",135896,298,135896,,"TOMSANI",686,"Caminul  Cultural  Loloiasca  ,sat  Loloiasca",1236,708,704,4,0,700,8,1408,700,302,398,3,12877,0
31,"Prahova",135896,298,135896,,"TOMSANI",687,"Caminul  Cultural  Loloiasca, sat Loloiasca, DE 577 (DN 1B)",0,96,0,96,0,95,1,200,104,51,44,3,12877,1
31,"Prahova",136269,298,136269,,"VADU SAPAT",688,"Caminul  cultural  Vadu  Sapat  ,sat  Vadu  Sapat  ,nr 259",1474,861,855,6,0,845,16,1600,739,613,232,3,12882,0
31,"Prahova",136269,298,136269,,"VADU SAPAT",689,"Camin  cultural , sat  Vadu  Sapat , nr 259",0,77,0,77,0,75,2,200,123,48,27,3,12882,1
31,"Prahova",135949,298,135949,,"VALEA CALUGAREASCA",690,"Scoala  Generala  cu  clasele  I-VIII Valea  Calugareasca",1348,567,559,8,0,564,3,1500,933,275,289,3,12890,0
31,"Prahova",135949,298,135949,,"VALEA CALUGAREASCA",691,"Scoala  Generala  cu  clasele  I-VIII  Valea  Calugareasca",1174,583,567,16,0,575,8,1300,717,265,310,3,12890,0
31,"Prahova",135949,298,135949,,"VALEA CALUGAREASCA",692,"Caminul  Cultural  Valea  Calugareasca",1077,547,541,6,0,543,4,1200,653,249,294,3,12890,0
31,"Prahova",135949,298,135949,,"VALEA CALUGAREASCA",693,"Scoala  cu  clasele  I-VIII  Nicovani",1082,540,525,15,0,538,2,1200,660,279,259,3,12890,0
31,"Prahova",135949,298,135949,,"VALEA CALUGAREASCA",694,"Gradinita  Darvari  ,sat  Darvari",499,295,284,11,0,293,2,500,205,128,165,3,12890,0
31,"Prahova",135949,298,135949,,"VALEA CALUGAREASCA",695,"Gradinita  Coslegi  ,sat  Coslegi",523,308,293,9,6,301,7,600,292,153,148,3,12890,0
31,"Prahova",135949,298,135949,,"VALEA CALUGAREASCA",696,"Gradinita  Radila  ,sat  Radila",259,205,191,14,0,201,4,300,95,84,117,3,12890,0
31,"Prahova",135949,298,135949,,"VALEA CALUGAREASCA",697,"Scoala  cu  clasele  I-VIII  Pantazi ,sat  Pantazi",940,486,473,13,0,483,3,1000,514,230,253,3,12890,0
31,"Prahova",135949,298,135949,,"VALEA CALUGAREASCA",698,"Scoala  cu  clasele  I-VIII Rachieri  ,sat  Rachieri",1010,587,559,28,0,579,8,1100,513,257,322,3,12890,0
31,"Prahova",135949,298,135949,,"VALEA CALUGAREASCA",699,"Colegiul  Agricol  Gheorghe  Ionescu-Sisesti ,sat  Valea  Popii",715,408,393,15,0,401,7,800,392,225,176,3,12890,0
31,"Prahova",135949,298,135949,,"VALEA CALUGAREASCA",700,"Cabana  de  Vanatoare ,sat  Scheau",102,46,35,11,0,45,1,202,156,32,13,3,12890,0
31,"Prahova",135949,298,135949,,"VALEA CALUGAREASCA",701,"SERVICIUL PUBLIC COMUNITAR LOCAL  DE  EVIDENTA  A  PERSOANELOR ,Sat  Valea  Calugareasca ,bl 30CD,parter",0,162,0,162,0,161,1,400,238,75,86,3,12890,1
31,"Prahova",136107,298,136107,,"VALEA DOFTANEI",702,"Grupul Scolar Agromontan Tesila sat Tesila",1495,832,830,1,1,827,5,1700,868,558,269,3,12906,0
31,"Prahova",136107,298,136107,,"VALEA DOFTANEI",703,"Primaria Traisteni",1062,535,530,5,0,535,0,1200,665,364,171,3,12906,0
31,"Prahova",136107,298,136107,,"VALEA DOFTANEI",704,"Scoala generala erou invatator Ionel Draganescu",1109,702,698,4,0,699,3,1200,498,446,253,3,12906,0
31,"Prahova",136107,298,136107,,"VALEA DOFTANEI",705,"Gradinita de copii nr 1 Tesila",1099,555,548,6,1,552,3,1200,645,388,164,3,12906,0
31,"Prahova",136107,298,136107,,"VALEA DOFTANEI",706,"Gradinita de copii nr 3 Tesila",1012,577,573,4,0,573,4,1100,523,409,164,3,12906,0
31,"Prahova",136107,298,136107,,"VALEA DOFTANEI",707,"Grupul Scolar Agromontan Tesila, sat Tesila",0,185,0,185,0,184,1,200,15,103,81,3,12906,1
31,"Prahova",136134,298,136134,,"VARBILAU",708,"Scoala Generala cu clasele I-IV sala de clasa sat Varbilau",985,534,530,4,0,526,8,1100,566,245,281,3,12909,0
31,"Prahova",136134,298,136134,,"VARBILAU",709,"Scoala Generala cu clasele I-IV sala de clasa sat Varbilau",932,449,448,1,0,447,2,1000,551,156,291,3,12909,0
31,"Prahova",136134,298,136134,,"VARBILAU",710,"Scoala Generala cu clasele I-VIII sala de clasa sat Varbilau",1161,638,633,5,0,630,8,1300,662,222,408,3,12909,0
31,"Prahova",136134,298,136134,,"VARBILAU",711,"Scoala Generala cu clasele I-IV sala de clasa sat Livadea",933,533,528,4,1,523,10,1000,467,199,324,3,12909,0
31,"Prahova",136134,298,136134,,"VARBILAU",712,"Scoala Generala cu clasele I-IV sala de clasa sat Poiana Varbilau",1022,601,592,4,5,584,17,1100,499,305,279,3,12909,0
31,"Prahova",136134,298,136134,,"VARBILAU",713,"Scoala Generala cu clasele I-IV sala de clasa sat Cotofenesti",773,456,454,2,0,455,1,900,444,213,242,3,12909,0
31,"Prahova",136134,298,136134,,"VARBILAU",714,"Scoala Generala cu clasele I-VIII Varbilau, sat Varbilau",0,113,0,113,0,113,0,200,87,50,63,3,12909,1
31,"Prahova",136198,298,136198,,"VALCANESTI",715,"Centrul cultural Vilcanesti sat Vilcanesti",1446,947,932,10,5,930,17,1600,653,549,381,3,12886,0
31,"Prahova",136198,298,136198,,"VALCANESTI",716,"Gradinita de copii sat Branzari",812,555,535,1,19,548,7,900,345,266,282,3,12886,0
31,"Prahova",136198,298,136198,,"VALCANESTI",717,"Scoala cu clasele I-IV Cirjari sat Cirjari",614,397,386,4,7,389,8,701,304,215,174,3,12886,0
31,"Prahova",136198,298,136198,,"VALCANESTI",718,"Biblioteca sateasca Trestioara, sat Trestioara",415,243,228,11,4,241,2,500,257,143,98,3,12886,0
31,"Prahova",136198,298,136198,,"VALCANESTI",719,"Centrul cultural  sala de sedinte, sat Vilcanesti",0,76,0,76,0,74,2,200,124,39,35,3,12886,1
32,"Satu Mare",136483,305,136483,,"MUNICIPIUL SATU MARE",1,"Gradinita Draga Mea, Str. Uzinei nr. 19/A",1498,534,525,9,0,533,1,1600,1066,336,197,1,12916,0
32,"Satu Mare",136483,305,136483,,"MUNICIPIUL SATU MARE",2,"Gradinita Draga Mea, Str. Uzinei nr. 19/A",1997,883,867,16,0,878,5,2200,1317,483,395,1,12916,0
32,"Satu Mare",136483,305,136483,,"MUNICIPIUL SATU MARE",3,"Asociatia CARITAS Centrul Social Casa Prieteniei, Str. Uzinei nr. 19/A",1141,491,476,15,0,483,8,1300,809,211,272,1,12916,0
32,"Satu Mare",136483,305,136483,,"MUNICIPIUL SATU MARE",4,"Scoala Generala Ioan Creanga, Str. Somesului nr. 6",1386,661,617,44,0,654,7,1500,839,353,301,1,12916,0
32,"Satu Mare",136483,305,136483,,"MUNICIPIUL SATU MARE",5,"Scoala Generala Ioan Creanga, Str. Somesului nr. 6",1367,600,596,4,0,597,3,1499,899,311,286,1,12916,0
32,"Satu Mare",136483,305,136483,,"MUNICIPIUL SATU MARE",6,"Scoala Generala Ioan Creanga, Str. Somesului nr. 6",1357,597,581,16,0,594,3,1500,903,337,257,1,12916,0
32,"Satu Mare",136483,305,136483,,"MUNICIPIUL SATU MARE",7,"Scoala Generala Ioan Creanga, Str. Somesului nr. 6",1510,666,657,9,0,664,2,1700,1034,356,308,1,12916,0
32,"Satu Mare",136483,305,136483,,"MUNICIPIUL SATU MARE",8,"Scoala Generala Lucian Blaga, Str. Ion Vidu nr. 51-53",1527,678,671,7,0,673,5,1700,1022,375,298,1,12916,0
32,"Satu Mare",136483,305,136483,,"MUNICIPIUL SATU MARE",9,"Scoala Generala Lucian Blaga, Str. Ion Vidu nr. 51-53",1534,705,692,13,0,703,2,1700,995,402,301,1,12916,0
32,"Satu Mare",136483,305,136483,,"MUNICIPIUL SATU MARE",10,"Scoala Generala Lucian Blaga, Str. Ion Vidu nr. 51-53",1264,555,542,13,0,555,0,1400,845,307,248,1,12916,0
32,"Satu Mare",136483,305,136483,,"MUNICIPIUL SATU MARE",11,"Scoala Generala Lucian Blaga, Str. Ion Vidu nr. 51-53",1440,645,635,10,0,641,4,1600,955,372,269,1,12916,0
32,"Satu Mare",136483,305,136483,,"MUNICIPIUL SATU MARE",12,"Scoala Generala Octavian Goga, Aleea Postavaru nr. 3",1349,547,537,10,0,543,4,1500,953,259,284,1,12916,0
32,"Satu Mare",136483,305,136483,,"MUNICIPIUL SATU MARE",13,"Scoala Generala Octavian Goga, Aleea Postavaru nr. 3",1350,617,592,25,0,614,3,1498,881,353,261,1,12916,0
32,"Satu Mare",136483,305,136483,,"MUNICIPIUL SATU MARE",14,"Scoala Generala Octavian Goga, Aleea Postavaru nr. 3",1468,689,674,15,0,685,4,1599,910,386,299,1,12916,0
32,"Satu Mare",136483,305,136483,,"MUNICIPIUL SATU MARE",15,"Scoala Generala Octavian Goga, Aleea Postavaru nr. 3",1569,763,737,26,0,757,6,1700,937,406,351,1,12916,0
32,"Satu Mare",136483,305,136483,,"MUNICIPIUL SATU MARE",16,"Scoala Generala Nr. 7, B-dul Lucian Blaga nr. 121",1486,687,667,20,0,682,5,1600,913,393,289,1,12916,0
32,"Satu Mare",136483,305,136483,,"MUNICIPIUL SATU MARE",17,"Scoala Generala Nr. 7, B-dul Lucian Blaga nr. 121",1558,672,656,16,0,665,7,1700,1028,408,257,1,12916,0
32,"Satu Mare",136483,305,136483,,"MUNICIPIUL SATU MARE",18,"Scoala Generala Nr. 7, B-dul Lucian Blaga nr. 121",1687,801,782,19,0,795,6,1900,1099,433,362,1,12916,0
32,"Satu Mare",136483,305,136483,,"MUNICIPIUL SATU MARE",19,"Scoala Generala Nr. 7, B-dul Lucian Blaga nr. 121",1591,727,716,10,1,720,7,1800,1073,477,243,1,12916,0
32,"Satu Mare",136483,305,136483,,"MUNICIPIUL SATU MARE",20,"Scoala Generala Nr. 9, B-dul Lucian Blaga nr. 409",1085,539,515,24,0,535,4,1200,661,333,202,1,12916,0
32,"Satu Mare",136483,305,136483,,"MUNICIPIUL SATU MARE",21,"Liceul Teoretic German Johhan Ettinger, B-dul Closca nr. 72",1837,691,671,18,2,682,9,2008,1317,395,287,1,12916,0
32,"Satu Mare",136483,305,136483,,"MUNICIPIUL SATU MARE",22,"Colegiul Tehnic Eliza Zamfirescu, B-dul Closca nr. 48",1627,725,713,12,0,724,1,1800,1075,385,339,1,12916,0
32,"Satu Mare",136483,305,136483,,"MUNICIPIUL SATU MARE",23,"Scoala Generala Mircea Eliade, Str. Mircea Eliade nr. 3",1544,707,631,76,0,701,6,1700,993,361,340,1,12916,0
32,"Satu Mare",136483,305,136483,,"MUNICIPIUL SATU MARE",24,"Scoala Generala Mircea Eliade, Str. Mircea Eliade nr. 3",1788,767,747,20,0,759,8,2001,1234,367,392,1,12916,0
32,"Satu Mare",136483,305,136483,,"MUNICIPIUL SATU MARE",25,"Scoala Generala Mircea Eliade, Str. Mircea Eliade nr. 3",1627,480,465,15,0,477,3,1800,1320,286,191,1,12916,0
32,"Satu Mare",136483,305,136483,,"MUNICIPIUL SATU MARE",26,"Scoala Generala Mircea Eliade, Str. Mircea Eliade nr. 3",1315,580,541,39,0,575,5,1400,820,283,292,1,12916,0
32,"Satu Mare",136483,305,136483,,"MUNICIPIUL SATU MARE",27,"Gradinita cu program prelungit Nr. 9, Aleea Tarnavei nr. 18",1458,588,567,21,0,585,3,1600,1012,310,275,1,12916,0
32,"Satu Mare",136483,305,136483,,"MUNICIPIUL SATU MARE",28,"Gradinita cu program prelungit Nr. 9, Aleea Tarnavei nr. 18",1618,582,566,16,0,577,5,1800,1218,323,254,1,12916,0
32,"Satu Mare",136483,305,136483,,"MUNICIPIUL SATU MARE",29,"Scoala Generala Balcescu Petofi, Aleea Trotusului nr. 2",1407,599,588,11,0,594,5,1500,901,348,246,1,12916,0
32,"Satu Mare",136483,305,136483,,"MUNICIPIUL SATU MARE",30,"Scoala Generala Balcescu Petofi, Aleea Trotusului nr. 2",1956,745,735,10,0,736,9,2200,1455,350,386,1,12916,0
32,"Satu Mare",136483,305,136483,,"MUNICIPIUL SATU MARE",31,"Scoala Generala Balcescu Petofi, Aleea Trotusului nr. 2",1547,627,616,11,0,621,6,1700,1073,371,250,1,12916,0
32,"Satu Mare",136483,305,136483,,"MUNICIPIUL SATU MARE",32,"Gradinita cu program prelungit Nr. 13, Aleea Milcov nr. 4",1534,640,626,14,0,637,3,1700,1060,329,308,1,12916,0
32,"Satu Mare",136483,305,136483,,"MUNICIPIUL SATU MARE",33,"Gradinita cu program prelungit Nr. 5, Aleea Tisa nr. 8",1250,490,476,14,0,490,0,1400,910,253,237,1,12916,0
32,"Satu Mare",136483,305,136483,,"MUNICIPIUL SATU MARE",34,"Gradinita cu program prelungit Nr. 5, Aleea Tisa nr. 8",1524,629,612,17,0,623,6,1700,1071,345,278,1,12916,0
32,"Satu Mare",136483,305,136483,,"MUNICIPIUL SATU MARE",35,"Gradinita cu program prelungit nr. 15, B, B-dul Muncii nr. 24",1420,563,549,14,0,562,1,1600,1037,272,290,1,12916,0
32,"Satu Mare",136483,305,136483,,"MUNICIPIUL SATU MARE",36,"Scoala Generala Avram Iancu, B-dul Muncii nr. 19",1656,841,818,23,0,830,11,1800,959,425,405,1,12916,0
32,"Satu Mare",136483,305,136483,,"MUNICIPIUL SATU MARE",37,"Scoala Generala Avram Iancu, B-dul Muncii nr. 19",1193,525,505,20,0,518,7,1299,774,253,265,1,12916,0
32,"Satu Mare",136483,305,136483,,"MUNICIPIUL SATU MARE",38,"Scoala Generala Avram Iancu, B-dul Muncii nr. 19",1685,740,726,14,0,733,7,1900,1160,376,357,1,12916,0
32,"Satu Mare",136483,305,136483,,"MUNICIPIUL SATU MARE",39,"Scoala Generala Avram Iancu, B-dul Muncii nr. 19",1443,600,587,13,0,598,2,1600,1000,358,240,1,12916,0
32,"Satu Mare",136483,305,136483,,"MUNICIPIUL SATU MARE",40,"Gradinita cu prg. prelungit Voinicelul, Str. Aurora, Bl. E21",1529,649,635,14,0,648,1,1700,1051,351,297,1,12916,0
32,"Satu Mare",136483,305,136483,,"MUNICIPIUL SATU MARE",41,"Scoala Generala Dariu Pop, Str. Crizantemei nr. 3",1535,647,637,10,0,646,1,1700,1053,366,280,1,12916,0
32,"Satu Mare",136483,305,136483,,"MUNICIPIUL SATU MARE",42,"Scoala Generala Dariu Pop, Str. Crizantemei nr. 3",1549,668,652,14,2,662,6,1700,1032,341,321,1,12916,0
32,"Satu Mare",136483,305,136483,,"MUNICIPIUL SATU MARE",43,"Scoala Generala Dariu Pop, Str. Crizantemei nr. 3",1610,675,666,9,0,671,4,1800,1125,319,352,1,12916,0
32,"Satu Mare",136483,305,136483,,"MUNICIPIUL SATU MARE",44,"Scoala Generala Dariu Pop, Str. Crizantemei nr. 3",1437,601,587,14,0,598,3,1600,999,311,287,1,12916,0
32,"Satu Mare",136483,305,136483,,"MUNICIPIUL SATU MARE",45,"Scoala Generala Dariu Pop, Str. Crizantemei nr. 3",1492,629,614,14,1,624,5,1600,971,334,290,1,12916,0
32,"Satu Mare",136483,305,136483,,"MUNICIPIUL SATU MARE",46,"Scoala Generala cartier Satmarel",1131,497,492,5,0,487,10,1200,703,308,179,1,12916,0
32,"Satu Mare",136483,305,136483,,"MUNICIPIUL SATU MARE",47,"Asociatia Judeteana de Fotbal, B-dul Unirii nr. 95",1583,570,554,16,0,564,6,1699,1129,267,297,1,12916,0
32,"Satu Mare",136483,305,136483,,"MUNICIPIUL SATU MARE",48,"Sectia de Drumuri Nationale, str. Baritiu nr. 127",1616,655,641,12,2,648,7,1800,1145,340,308,1,12916,0
32,"Satu Mare",136483,305,136483,,"MUNICIPIUL SATU MARE",49,"Scoala Generala Nr. 5, Str. Wolfenbuttel nr. 6",1473,529,515,14,0,520,9,1600,1071,237,283,1,12916,0
32,"Satu Mare",136483,305,136483,,"MUNICIPIUL SATU MARE",50,"Gradinita Nr. 15, B-dul Unirii nr. 9",1188,477,467,10,0,468,9,1300,823,211,257,1,12916,0
32,"Satu Mare",136483,305,136483,,"MUNICIPIUL SATU MARE",51,"Liceul Teologic Nicolae Steinhardt, str. G. Calinescu nr. 51",1723,597,580,17,0,594,3,1900,1303,310,284,1,12916,0
32,"Satu Mare",136483,305,136483,,"MUNICIPIUL SATU MARE",52,"Liceul Teologic Nicolae Steinhardt, str. G. Calinescu nr. 51",1625,690,677,13,0,684,6,1800,1110,334,350,1,12916,0
32,"Satu Mare",136483,305,136483,,"MUNICIPIUL SATU MARE",53,"Gradinita cu program prelungit nr.12, Aleea Ilisesti nr. 4",1508,558,544,14,0,553,5,1700,1142,315,238,1,12916,0
32,"Satu Mare",136483,305,136483,,"MUNICIPIUL SATU MARE",54,"Scoala Generala  Dr. Vasile Lucaciu, str. Rodnei nr. 64",1241,553,540,13,0,549,4,1400,847,291,258,1,12916,0
32,"Satu Mare",136483,305,136483,,"MUNICIPIUL SATU MARE",55,"Scoala Generala  Dr. Vasile Lucaciu, str. Rodnei nr. 64",1253,585,572,11,2,582,3,1401,816,328,254,1,12916,0
32,"Satu Mare",136483,305,136483,,"MUNICIPIUL SATU MARE",56,"Gradinita cu program prelungit 14 Mai, Aleea Gladiolei nr.4",1703,666,657,8,1,659,7,1900,1234,341,318,1,12916,0
32,"Satu Mare",136483,305,136483,,"MUNICIPIUL SATU MARE",57,"Gradinita cu program prelungit 14 Mai, Aleea Gladiolei nr.4",1270,492,484,8,0,490,2,1400,908,261,229,1,12916,0
32,"Satu Mare",136483,305,136483,,"MUNICIPIUL SATU MARE",58,"Grupul Scolar de Industrializare a Lemnului, Str. Crisan nr. 1",1471,736,717,19,0,727,9,1600,864,307,420,1,12916,0
32,"Satu Mare",136483,305,136483,,"MUNICIPIUL SATU MARE",59,"Liceul cu program sportiv, Str. Ioan Slavici nr. 43",1223,513,496,17,0,505,8,1300,787,213,292,1,12916,0
32,"Satu Mare",136483,305,136483,,"MUNICIPIUL SATU MARE",60,"Scoala Generala Grigore Moisil, Str. Mileniului nr. 1",1162,757,522,11,224,746,11,1300,543,348,398,1,12916,0
32,"Satu Mare",136483,305,136483,,"MUNICIPIUL SATU MARE",61,"Scoala Generala Grigore Moisil, Str. Mileniului nr. 1",1186,562,546,15,1,557,5,1300,738,275,282,1,12916,0
32,"Satu Mare",136483,305,136483,,"MUNICIPIUL SATU MARE",62,"Grupul Scolar I. C. Bratianu, B-dul Vasile Lucaciu nr. 1",1502,683,651,31,1,680,3,1700,1017,319,361,1,12916,0
32,"Satu Mare",136483,305,136483,,"MUNICIPIUL SATU MARE",63,"Grupul Scolar Romano-Catolic Ham Janos, Str. 1 Dec. 1918 nr. 2",1195,497,479,18,0,491,6,1300,803,209,282,1,12916,0
32,"Satu Mare",136483,305,136483,,"MUNICIPIUL SATU MARE",64,"Colegiul National Kolcsey Ferencz, Piata Pacii, nr. 2",1052,456,446,10,0,452,4,1200,744,166,286,1,12916,0
32,"Satu Mare",136483,305,136483,,"MUNICIPIUL SATU MARE",65,"Gradinita Dumbrava Minunata, Str. G. Lazar de Purcaret nr. 21",1328,605,593,12,0,597,8,1495,890,281,316,1,12916,0
32,"Satu Mare",136483,305,136483,,"MUNICIPIUL SATU MARE",66,"Colegiul National D-na Stanca, Str. Stefan cel Mare nr. 5",1165,495,482,12,1,492,3,1300,805,206,286,1,12916,0
32,"Satu Mare",136483,305,136483,,"MUNICIPIUL SATU MARE",67,"Gradinita  de copii nr. , Str. Porumbeilor nr. 1",1194,428,415,13,0,424,4,1299,871,181,243,1,12916,0
32,"Satu Mare",136483,305,136483,,"MUNICIPIUL SATU MARE",68,"Scoala Generala nr. 10, Str. Ana Ipatescu nr. 8",1601,691,684,7,0,678,13,1800,1109,288,390,1,12916,0
32,"Satu Mare",136483,305,136483,,"MUNICIPIUL SATU MARE",69,"Scoala Generala C. Brancoveanu, Str. Brancoveanu nr. 6",1770,887,870,17,0,878,9,1900,1013,396,482,1,12916,0
32,"Satu Mare",136483,305,136483,,"MUNICIPIUL SATU MARE",70,"Colegiul National M. Eminescu, Str. M. Eminescu nr.5",1333,656,640,15,1,652,4,1499,843,269,383,1,12916,0
32,"Satu Mare",136483,305,136483,,"MUNICIPIUL SATU MARE",71,"Grupul Scolar Economic Gh. Dragos, B-dul Henri Coanda nr. 23",1581,790,765,10,15,783,7,1700,910,385,398,1,12916,0
32,"Satu Mare",136483,305,136483,,"MUNICIPIUL SATU MARE",72,"Scoala Generala Nr. 13, Str. Botizului nr. 61/A",1329,576,566,10,0,567,9,1520,944,306,261,1,12916,0
32,"Satu Mare",136483,305,136483,,"MUNICIPIUL SATU MARE",73,"Scoala Generala Nr. 13, Str. Botizului nr. 61/A",1061,421,415,6,0,416,5,1200,779,212,204,1,12916,0
32,"Satu Mare",136483,305,136483,,"MUNICIPIUL SATU MARE",74,"Scoala Generala Nr. 13, Str. Botizului nr. 61/A",1165,477,463,12,2,473,4,1296,819,235,238,1,12916,0
32,"Satu Mare",136483,305,136483,,"MUNICIPIUL SATU MARE",75,"Statia CFR Satu Mare Nord, Str. Grivitei nr. 1",0,1073,0,1073,0,1061,12,1496,423,641,420,1,12916,1
32,"Satu Mare",136526,305,136526,,"MUNICIPIUL CAREI",76,"Gr. Sc. Teologic Romano-Catolic Iosephus Calazantius, Str. Iuliu Maniu nr. 1",1688,683,657,25,1,670,13,1900,1217,395,275,1,12919,0
32,"Satu Mare",136526,305,136526,,"MUNICIPIUL CAREI",77,"Colegiul tehnic Iuliu Maniu, Str. Iuliu Maniu nr. 20",1493,615,607,8,0,609,6,1600,985,228,381,1,12919,0
32,"Satu Mare",136526,305,136526,,"MUNICIPIUL CAREI",78,"Scoala de Arte si Meserii, Str. Rakoczi Ferencz, nr. 12",1643,607,596,11,0,596,11,1800,1193,203,393,1,12919,0
32,"Satu Mare",136526,305,136526,,"MUNICIPIUL CAREI",79,"Scoala Generala Nr. 1, Str. 1 Decembrie 1918, nr. 30",1671,613,603,9,1,605,8,1800,1187,268,337,1,12919,0
32,"Satu Mare",136526,305,136526,,"MUNICIPIUL CAREI",80,"Scoala Generala Vasile Lucaciu, Str. Vasile Lucaciu, nr. 16",1919,731,698,33,0,719,12,2100,1369,313,406,1,12919,0
32,"Satu Mare",136526,305,136526,,"MUNICIPIUL CAREI",81,"Gradinita Nr. 9, Str. Nicolae Titulescu nr. 2",1326,473,463,10,0,469,4,1500,1027,179,290,1,12919,0
32,"Satu Mare",136526,305,136526,,"MUNICIPIUL CAREI",82,"Gradinita Nr. 10, Str. Liszt Ferencz nr. 1",2180,738,729,9,0,733,5,2383,1645,312,421,1,12919,0
32,"Satu Mare",136526,305,136526,,"MUNICIPIUL CAREI",83,"Scoala Generala Nr. 3, Str, Ignisului, nr. 18",1677,752,730,22,0,745,7,1800,1048,332,413,1,12919,0
32,"Satu Mare",136526,305,136526,,"MUNICIPIUL CAREI",84,"Liceul Teoretic, Str. Ignisului, nr. 20",1589,514,501,13,0,508,6,1689,1175,249,259,1,12919,0
32,"Satu Mare",136526,305,136526,,"MUNICIPIUL CAREI",85,"Gradinita Nr. 5, Str. Tireamului, nr. 27",1917,728,718,10,0,719,9,2100,1372,318,401,1,12919,0
32,"Satu Mare",136526,305,136526,,"MUNICIPIUL CAREI",86,"Gradinita Nr. 8, Str. Viilor, nr. 1",1171,422,407,15,0,421,1,1300,878,202,219,1,12919,0
32,"Satu Mare",136526,305,136526,,"MUNICIPIUL CAREI",87,"Grupul Scolar Simion Barnutiu, Str. Agrara, nr. 1",2017,700,689,11,0,694,6,2200,1500,311,383,1,12919,0
32,"Satu Mare",136526,305,136526,,"MUNICIPIUL CAREI",88,"Grupul Scolar Simion Barnutiu, Str. Agrara, nr. 1",1119,366,356,10,0,365,1,1200,834,154,211,1,12919,0
32,"Satu Mare",136526,305,136526,,"MUNICIPIUL CAREI",89,"Gradinita Ianculesti, sat Ianculesti nr. 38",319,195,181,14,0,193,2,400,205,91,102,1,12919,0
32,"Satu Mare",136526,305,136526,,"MUNICIPIUL CAREI",90,"Statia CFR Carei, Str. Independentei nr. 50",0,231,0,231,0,227,4,598,367,139,88,1,12919,1
32,"Satu Mare",136848,305,136848,,"ORAS ARDUD",91,"Grupul Scolar Ardud, Str. Mihai Viteazul, nr. 1",1835,794,774,20,0,789,5,2000,1206,483,306,1,12922,0
32,"Satu Mare",136848,305,136848,,"ORAS ARDUD",92,"Primaria Ardud, Str.Stefan cel Mare nr. 37",1860,797,784,13,0,785,12,2116,1319,494,291,1,12922,0
32,"Satu Mare",136848,305,136848,,"ORAS ARDUD",93,"Scoala Generala Baba Novac, sat Baba Novac nr. 34",459,233,223,10,0,230,3,500,267,107,123,1,12922,0
32,"Satu Mare",136848,305,136848,,"ORAS ARDUD",94,"Scoala Generala Gerausa, sat Gerausa nr. 303",437,252,239,13,0,246,6,500,248,139,107,1,12922,0
32,"Satu Mare",136848,305,136848,,"ORAS ARDUD",95,"Scoala Generala Madaras, sat Madaras nr. 66",893,423,411,12,0,420,3,1000,577,217,203,1,12922,0
32,"Satu Mare",136848,305,136848,,"ORAS ARDUD",96,"Grupul Scolar Ardud, Str. Mihai Viteazul, nr. 1",0,100,0,100,0,97,3,506,406,50,47,1,12922,1
32,"Satu Mare",138039,305,138039,,"ORAS LIVADA",97,"Scoala Generala Livada Noua, Str. Victoriei nr. 67",992,337,325,12,0,335,2,1100,763,171,164,1,12929,0
32,"Satu Mare",138039,305,138039,,"ORAS LIVADA",98,"Gradinita Livada Noua, Str. Satu Mare nr. 6",1379,550,546,4,0,545,5,1500,950,335,210,1,12929,0
32,"Satu Mare",138039,305,138039,,"ORAS LIVADA",99,"Scoala Generala Livada Veche, Str. Oasului nr. 7",1657,497,483,14,0,491,6,1800,1303,280,211,1,12929,0
32,"Satu Mare",138039,305,138039,,"ORAS LIVADA",100,"Caminul cultural Adrian, sat Adrian nr.16",424,169,161,8,0,167,2,500,331,50,117,1,12929,0
32,"Satu Mare",138039,305,138039,,"ORAS LIVADA",101,"Caminul cultural Dumbrava, sat Dumbrava nr. 234",889,434,424,10,0,432,2,993,559,219,213,1,12929,0
32,"Satu Mare",138039,305,138039,,"ORAS LIVADA",102,"Caminul cultural Livada Mica,  sat Livada Mica nr. 18",249,163,154,9,0,163,0,271,108,115,48,1,12929,0
32,"Satu Mare",138039,305,138039,,"ORAS LIVADA",103,"Gradinita Livada Noua, Str. Satu Mare nr. 6",0,53,0,53,0,53,0,500,447,34,19,1,12929,1
32,"Satu Mare",136599,305,136599,,"ORAS NEGRESTI-OAS",104,"Scoala Generala Nr. 2 Negresti Oas, Str. Popesti nr. 36",1038,386,379,7,0,383,3,1100,714,286,97,1,12934,0
32,"Satu Mare",136599,305,136599,,"ORAS NEGRESTI-OAS",105,"Scoala Generala Nr. 2 Negresti Oas, Str. Popesti nr. 36",1105,383,363,20,0,379,4,1200,817,269,110,1,12934,0
32,"Satu Mare",136599,305,136599,,"ORAS NEGRESTI-OAS",106,"Scoala Generala Nr. 3 Negresti Oas, Str. Victoriei nr. 59",1688,642,636,6,0,640,2,1900,1258,385,255,1,12934,0
32,"Satu Mare",136599,305,136599,,"ORAS NEGRESTI-OAS",107,"Scoala Generala Nr. 3 Negresti Oas, Str. Victoriei nr. 59",1387,479,467,12,0,473,6,1500,1021,348,125,1,12934,0
32,"Satu Mare",136599,305,136599,,"ORAS NEGRESTI-OAS",108,"Scoala Generala Nr. 3 Negresti Oas, Str. Victoriei nr. 59",1410,650,639,8,3,638,12,1600,950,453,185,1,12934,0
32,"Satu Mare",136599,305,136599,,"ORAS NEGRESTI-OAS",109,"Scoala Generala Nr. 1 Negresti Oas, Str. Victoriei nr. 99",1117,521,504,14,3,517,4,1199,678,310,207,1,12934,0
32,"Satu Mare",136599,305,136599,,"ORAS NEGRESTI-OAS",110,"Scoala Generala Nr. 1 Negresti Oas, Str. Victoriei nr. 99",943,495,451,44,0,492,3,999,504,321,171,1,12934,0
32,"Satu Mare",136599,305,136599,,"ORAS NEGRESTI-OAS",111,"Liceul Teoretic Negresti Oas, Str. Victoriei nr. 101",1130,551,531,20,0,545,6,1200,649,361,184,1,12934,0
32,"Satu Mare",136599,305,136599,,"ORAS NEGRESTI-OAS",112,"Liceul Teoretic Negresti Oas, Str. Victoriei nr. 101",1181,498,485,13,0,491,7,1300,802,340,151,1,12934,0
32,"Satu Mare",136599,305,136599,,"ORAS NEGRESTI-OAS",113,"Liceul Teoretic Negresti Oas, Str. Victoriei nr. 101",1217,580,564,15,1,574,6,1300,720,363,211,1,12934,0
32,"Satu Mare",136599,305,136599,,"ORAS NEGRESTI-OAS",114,"Scoala cu clase I - IV Tur, sat  Tur nr. 456",1582,531,521,10,0,525,6,1700,1169,290,235,1,12934,0
32,"Satu Mare",136599,305,136599,,"ORAS NEGRESTI-OAS",115,"Scoala Generala Nr. 1 Negresti Oas, Str. Victoriei nr. 99",0,309,0,309,0,304,5,595,286,188,116,1,12934,1
32,"Satu Mare",136642,305,136642,,"ORAS TASNAD",116,"Scoala Generala Nr. 1 Tasnad, Str. Nicolae Balcescu nr. 27",1321,581,577,4,0,575,6,1500,919,267,308,1,12938,0
32,"Satu Mare",136642,305,136642,,"ORAS TASNAD",117,"Scoala Generala Tasnad, Str. Lacramioarelor nr. 25",1731,702,697,5,0,699,3,1900,1198,359,340,1,12938,0
32,"Satu Mare",136642,305,136642,,"ORAS TASNAD",118,"Scoala Generala Tasnad, Str. Lacramioarelor nr. 25",1759,740,734,6,0,736,4,1900,1160,365,371,1,12938,0
32,"Satu Mare",136642,305,136642,,"ORAS TASNAD",119,"Casa de cultura Tasnad, Str. Infratirii nr. 3",1684,814,799,15,0,805,9,1900,1086,507,298,1,12938,0
32,"Satu Mare",136642,305,136642,,"ORAS TASNAD",120,"Scoala Generala Blaja, sat  Blaja nr. 3",192,114,101,13,0,112,2,200,86,53,59,1,12938,0
32,"Satu Mare",136642,305,136642,,"ORAS TASNAD",121,"Scoala Generala Cig, sat Cig nr. 37",395,188,179,9,0,185,3,400,212,121,64,1,12938,0
32,"Satu Mare",136642,305,136642,,"ORAS TASNAD",122,"Scoala Generala Sarauad, sat Sarauad nr. 131",784,431,423,8,0,421,10,900,469,271,150,1,12938,0
32,"Satu Mare",136642,305,136642,,"ORAS TASNAD",123,"Scoala Generala Valea Morii, sat Valea Morii nr. 33",148,115,105,10,0,112,3,200,85,72,40,1,12938,0
32,"Satu Mare",136642,305,136642,,"ORAS TASNAD",124,"Scoala Generala Nr. 1 Tasnad, Str. Nicolae Balcescu nr. 27",0,103,0,103,0,102,1,495,392,53,49,1,12938,1
32,"Satu Mare",136713,305,136713,,"ACIS",125,"Primaria comunei Acas, sat Acas nr. 129",1450,546,534,12,0,524,22,1500,954,248,276,3,12945,0
32,"Satu Mare",136713,305,136713,,"ACIS",126,"Scoala Generala Mihaieni, sat Mihaieni nr. 38",381,148,138,10,0,147,1,400,252,42,105,3,12945,0
32,"Satu Mare",136713,305,136713,,"ACIS",127,"Scoala Generala Unimat, sat Unimat nr. 285",377,242,207,13,22,238,4,400,158,85,153,3,12945,0
32,"Satu Mare",136713,305,136713,,"ACIS",128,"Caminul cultural Acas, sat Acas nr. 129",0,62,0,62,0,62,0,252,190,29,33,3,12945,1
32,"Satu Mare",179873,305,179873,,"AGRIS",129,"Primaria comunei Agris, sat Agris, Str. Csury Balint nr. 68",885,325,318,7,0,323,2,997,672,134,189,3,12950,0
32,"Satu Mare",179873,305,179873,,"AGRIS",130,"Scoala cu clase I - IV Agris, sat Agris, Str. Agrisu Nou nr. 65",156,94,80,14,0,93,1,200,106,51,42,3,12950,0
32,"Satu Mare",179873,305,179873,,"AGRIS",131,"Scoala cu clase I - IV Ciuperceni, sat Ciuperceni nr. 37",450,162,153,9,0,160,2,500,338,107,53,3,12950,0
32,"Satu Mare",179873,305,179873,,"AGRIS",132,"Scoala cu clase I - IV Ciuperceni, sat Ciuperceni nr. 38",0,24,0,24,0,22,2,240,216,12,10,3,12950,1
32,"Satu Mare",136768,305,136768,,"ANDRID",133,"Scoala de Arte si Meserii Andrid, sat Andrid nr. 181",981,592,565,10,17,586,6,1096,504,269,317,3,12953,0
32,"Satu Mare",136768,305,136768,,"ANDRID",134,"Scoala Generala Dindesti, sat Dindesti nr. 211",617,416,398,6,12,405,11,700,284,253,152,3,12953,0
32,"Satu Mare",136768,305,136768,,"ANDRID",135,"Scoala Generala Irina, sat Irina nr. 128",408,202,191,11,0,198,4,500,298,112,86,3,12953,0
32,"Satu Mare",136768,305,136768,,"ANDRID",136,"Scoala de Arte si Meserii Andrid, sat Andrid nr. 86",0,81,0,81,0,80,1,251,170,40,40,3,12953,1
32,"Satu Mare",136802,305,136802,,"APA",137,"Centrul cultural Apa, sat Apa nr. 444",1107,567,549,13,5,557,10,1200,633,331,226,3,12957,0
32,"Satu Mare",136802,305,136802,,"APA",138,"Scoala cu clase I - IV Apa, sat Apa nr. 43",803,397,383,5,9,388,9,900,503,176,212,3,12957,0
32,"Satu Mare",136802,305,136802,,"APA",139,"Scoala cu clase I - IV Someseni, sat Someseni nr. 73",245,179,160,19,0,179,0,300,121,82,97,3,12957,0
32,"Satu Mare",136802,305,136802,,"APA",140,"Centrul cultural Apa, sat Apa nr. 444",0,104,0,104,0,103,1,250,146,62,41,3,12957,1
32,"Satu Mare",136919,305,136919,,"BATARCI",141,"Scoala Generala Batarci, sat Batarci str. Principala nr. 85",1851,657,657,0,0,651,6,2000,1343,235,416,3,12964,0
32,"Satu Mare",136919,305,136919,,"BATARCI",142,"Gradinita Comlausa, sat Comlausa nr. 42",877,364,354,10,0,359,5,996,632,186,173,3,12964,0
32,"Satu Mare",136919,305,136919,,"BATARCI",143,"Scoala cu clase I - IV Tamaseni, sat Tamaseni str. Principala nr. 78",335,191,182,9,0,188,3,388,197,52,136,3,12964,0
32,"Satu Mare",136919,305,136919,,"BATARCI",144,"Scoala Generala Batarci, sat Batarci str. Principala nr. 85",0,52,0,52,0,52,0,250,198,29,23,3,12964,1
32,"Satu Mare",137103,305,137103,,"BARSAU",145,"Primaria Barsau, sat Barsau de Sus nr. 277",1423,830,761,9,60,820,10,1600,770,332,488,3,12961,0
32,"Satu Mare",137103,305,137103,,"BARSAU",146,"Biroul public adm. Barsau de Jos, sat Barsau de Jos nr. 87",543,337,292,26,19,332,5,600,263,188,144,3,12961,0
32,"Satu Mare",137103,305,137103,,"BARSAU",147,"Scoala de Arte si Meserii Barsau, sat Barsau de Sus nr. 335",0,66,0,66,0,65,1,253,187,44,21,3,12961,1
32,"Satu Mare",136964,305,136964,,"BELTIUG",148,"Scoala Generala Beltiug, sat Beltiug nr. 618",1187,457,442,7,8,454,3,1200,743,207,247,3,12969,0
32,"Satu Mare",136964,305,136964,,"BELTIUG",149,"Caminul cultural Bolda, sat Bolda nr. 53",70,51,33,10,8,49,2,100,49,18,31,3,12969,0
32,"Satu Mare",136964,305,136964,,"BELTIUG",150,"Scoala Generala Ghirisa, sat Ghirisa nr. 218",575,182,171,11,0,173,9,600,418,70,103,3,12969,0
32,"Satu Mare",136964,305,136964,,"BELTIUG",151,"Scoala Generala Giungi, sat Giungi nr. 164",118,52,45,7,0,52,0,200,148,12,40,3,12969,0
32,"Satu Mare",136964,305,136964,,"BELTIUG",152,"Scoala Generala Ratesti, sat Ratesti nr. 85",597,243,237,6,0,235,8,796,553,148,87,3,12969,0
32,"Satu Mare",136964,305,136964,,"BELTIUG",153,"Gradinita Sandra, sat Sandra nr. 6",186,97,90,7,0,95,2,200,103,71,24,3,12969,0
32,"Satu Mare",136964,305,136964,,"BELTIUG",154,"Scoala Generala Beltiug, sat Beltiug nr. 617",0,56,0,56,0,55,1,250,194,21,34,3,12969,1
32,"Satu Mare",137032,305,137032,,"BERVENI",155,"Scoala Generala Berveni, sat Berveni str. I. Maior nr. 117",1771,522,513,9,0,512,10,1900,1378,212,300,3,12976,0
32,"Satu Mare",137032,305,137032,,"BERVENI",156,"Scoala Generala Lucaceni, sat Lucaceni nr. 66",1260,510,490,20,0,507,3,1400,890,191,316,3,12976,0
32,"Satu Mare",137032,305,137032,,"BERVENI",157,"Scoala Generala Berveni, sat Berveni str. I. Maior nr. 117",0,29,0,29,0,29,0,250,221,17,12,3,12976,1
32,"Satu Mare",137069,305,137069,,"BIXAD",158,"Scoala Generala Nr. 1 Bixad, sat Bixad nr. 105",1543,499,486,13,0,493,6,1700,1201,366,127,3,12979,0
32,"Satu Mare",137069,305,137069,,"BIXAD",159,"Scoala Generala Nr. 1 Bixad, sat Bixad nr. 105",1256,445,436,9,0,444,1,1400,955,326,118,3,12979,0
32,"Satu Mare",137069,305,137069,,"BIXAD",160,"Scoala Generala Boinesti, sat Boinesti nr. 179",1375,459,448,11,0,449,10,1500,1041,310,139,3,12979,0
32,"Satu Mare",137069,305,137069,,"BIXAD",161,"Scoala Generala Aurel Haiduc Trip, sat Trip nr. 443",1113,386,370,16,0,382,4,1200,814,279,103,3,12979,0
32,"Satu Mare",137069,305,137069,,"BIXAD",162,"Scoala Generala Aurel Haiduc Trip, sat Trip nr. 443",906,260,254,6,0,258,2,1000,740,207,51,3,12979,0
32,"Satu Mare",137069,305,137069,,"BIXAD",163,"Scoala Generala Aurel Haiduc Trip, sat Trip nr. 442",0,79,0,79,0,79,0,250,171,58,21,3,12979,1
32,"Satu Mare",137130,305,137130,,"BOGDAND",164,"Primaria comunei Bogdand, sat Bogdand nr. 310/A",858,306,300,6,0,305,1,900,594,59,246,3,12983,0
32,"Satu Mare",137130,305,137130,,"BOGDAND",165,"Scoala Generala Babta, sat Babta nr. 346",625,396,382,14,0,392,4,700,304,167,225,3,12983,0
32,"Satu Mare",137130,305,137130,,"BOGDAND",166,"Scoala Generala Corund, sat Corund nr. 160",382,214,202,12,0,211,3,400,186,87,124,3,12983,0
32,"Satu Mare",137130,305,137130,,"BOGDAND",167,"Scoala Generala Ser, sat Ser nr. 99",597,171,162,9,0,166,5,700,529,38,128,3,12983,0
32,"Satu Mare",137130,305,137130,,"BOGDAND",168,"Gradinita Bogdand, sat Bogdand nr. 108",0,61,0,61,0,60,1,250,189,28,32,3,12983,1
32,"Satu Mare",137185,305,137185,,"BOTIZ",169,"Primaria comunei Botiz, sat Botiz, Str. Mioritei nr. 63",1449,663,645,16,2,661,2,1600,937,448,213,3,12988,0
32,"Satu Mare",137185,305,137185,,"BOTIZ",170,"Scoala Generala Osvareu, sat Botiz, Str. Teilor nr. 61",1427,720,694,21,5,711,9,1600,880,423,288,3,12988,0
32,"Satu Mare",137185,305,137185,,"BOTIZ",171,"Scoala Generala Osvareu, sat Botiz, Str. Teilor nr. 61",0,78,0,78,0,78,0,252,174,45,33,3,12988,1
32,"Satu Mare",137229,305,137229,,"CALINESTI-OAS",172,"Primaria comunei Calinesti Oas, sat Calinesti Oas nr. 1",1336,594,586,6,2,594,0,1500,906,390,204,3,12990,0
32,"Satu Mare",137229,305,137229,,"CALINESTI-OAS",173,"Scoala de Arte si Meserii Calinesti Oas, Calinesti Oas nr. 13",799,393,384,3,6,391,2,900,507,263,128,3,12990,0
32,"Satu Mare",137229,305,137229,,"CALINESTI-OAS",174,"Scoala Generala Coca, sat Coca nr. 94",778,319,308,6,5,315,4,900,581,207,108,3,12990,0
32,"Satu Mare",137229,305,137229,,"CALINESTI-OAS",175,"Scoala Generala Lechinta, sat Lechinta nr. 2",655,274,265,9,0,271,3,704,430,132,139,3,12990,0
32,"Satu Mare",137229,305,137229,,"CALINESTI-OAS",176,"Scoala cu clase I - IV Pasunea Mare, sat Pasunea Mare nr. 56",240,120,105,15,0,119,1,300,180,85,34,3,12990,0
32,"Satu Mare",137229,305,137229,,"CALINESTI-OAS",177,"Scoala de Arte si Meserii Calinesti Oas, Calinesti Oas nr. 13",0,62,0,62,0,62,0,250,188,36,26,3,12990,1
32,"Satu Mare",137274,305,137274,,"CAMARZANA",178,"Primaria comunei Camarzana, sat Camarzana nr. 338",1128,414,381,2,31,409,5,1200,786,213,196,3,12995,0
32,"Satu Mare",137274,305,137274,,"CAMARZANA",179,"Scoala Generala Camarzana, sat Camarzana nr. 459",936,385,374,0,11,379,6,1000,615,229,150,3,12995,0
32,"Satu Mare",137274,305,137274,,"CAMARZANA",180,"Gradinita Camarzana, sat Camarzana nr. 459/D",0,33,0,33,0,33,0,251,218,20,13,3,12995,1
32,"Satu Mare",179677,305,179677,,"CAMIN",181,"Scoala Generala Camin, sat Camin nr. 195",1177,405,405,0,0,395,10,1300,895,105,290,3,12997,0
32,"Satu Mare",179677,305,179677,,"CAMIN",182,"Scoala Generala Camin, sat Camin nr. 42",0,16,0,16,0,16,0,253,237,5,11,3,12997,1
32,"Satu Mare",136553,305,136553,,"CAPLENI",183,"Consiliul Local Capleni, Sala de Sedinte, sat Capleni nr. 619",1237,368,362,6,0,361,7,1399,1031,145,216,3,12999,0
32,"Satu Mare",136553,305,136553,,"CAPLENI",184,"Scoala Generala Fenyi Istvan Capleni, sat Capleni nr. 752",1457,440,434,6,0,432,8,1500,1060,181,251,3,12999,0
32,"Satu Mare",136553,305,136553,,"CAPLENI",185,"Caminul Cultural Capleni, sat Capleni nr. 618",0,14,0,14,0,14,0,250,236,4,10,3,12999,1
32,"Satu Mare",137292,305,137292,,"CAUAS",186,"Scoala Generala Cauas, sat Cauas str. Principala nr. 240",553,263,257,6,0,255,8,600,337,124,131,3,13001,0
32,"Satu Mare",137292,305,137292,,"CAUAS",187,"Caminul Cultural Ady Endre, sat Ady Endre str. Principala nr. 69",127,58,47,11,0,58,0,200,142,30,28,3,13001,0
32,"Satu Mare",137292,305,137292,,"CAUAS",188,"Scoala Generala Ghenci, sat Ghenci str. Principala nr. 84",1002,370,366,4,0,365,5,1095,725,241,124,3,13001,0
32,"Satu Mare",137292,305,137292,,"CAUAS",189,"Scoala Generala Ghilesti, sat Ghilesti str. Principala nr. 75",87,61,52,9,0,60,1,100,39,29,31,3,13001,0
32,"Satu Mare",137292,305,137292,,"CAUAS",190,"Scoala Generala Hotoan, sat Hotoan str. Principala nr. 118/A",146,87,80,7,0,87,0,200,113,31,56,3,13001,0
32,"Satu Mare",137292,305,137292,,"CAUAS",191,"Scoala Generala Radulesti, sat Radulesti str. Principala nr. 37/A",97,64,56,8,0,64,0,100,36,38,26,3,13001,0
32,"Satu Mare",137292,305,137292,,"CAUAS",192,"Scoala Generala Cauas, sat Cauas str. Principala nr. 20",0,40,0,40,0,40,0,251,211,13,27,3,13001,1
32,"Satu Mare",137363,305,137363,,"CEHAL",193,"Caminul Cultural Cehal, sat Cehalut nr. 288",539,354,333,7,14,350,4,603,249,131,219,3,13008,0
32,"Satu Mare",137363,305,137363,,"CEHAL",194,"Scoala Generala Cehal, sat Cehal nr. 128",730,553,502,10,41,549,4,794,241,175,374,3,13008,0
32,"Satu Mare",137363,305,137363,,"CEHAL",195,"Cladirea primariei din Orbau, sat Orbau nr. 70",246,152,133,6,13,149,3,300,148,35,114,3,13008,0
32,"Satu Mare",137363,305,137363,,"CEHAL",196,"Caminul Cultural Cehal, sat Cehalut nr. 288",0,47,0,47,0,47,0,250,203,26,21,3,13008,1
32,"Satu Mare",137407,305,137407,,"CERTEZE",197,"Scoala Generala Certeze, sat Certeze str. Scolii nr. 863",1659,570,549,17,4,566,4,1800,1230,310,256,3,13012,0
32,"Satu Mare",137407,305,137407,,"CERTEZE",198,"Scoala Generala Certeze, sat Certeze str. Scolii nr. 863",1123,397,381,16,0,396,1,1198,801,227,169,3,13012,0
32,"Satu Mare",137407,305,137407,,"CERTEZE",199,"Scoala cu clase I - IV Huta Certeze, sat Huta Certeze str. Principala nr. 234",931,384,374,10,0,381,3,995,611,283,98,3,13012,0
32,"Satu Mare",137407,305,137407,,"CERTEZE",200,"Scoala cu clase I - IV Moiseni, sat Moiseni str. Principala nr. 105",1082,352,341,11,0,351,1,1198,846,183,168,3,13012,0
32,"Satu Mare",137407,305,137407,,"CERTEZE",201,"Scoala Generala Certeze, sat Certeze str. Scolii nr. 863",0,98,0,98,0,98,0,251,153,28,70,3,13012,1
32,"Satu Mare",179882,305,179882,,"CIUMESTI",202,"Caminul cultural Ciumesti, sat Ciumesti nr. 266",1132,310,299,9,2,299,11,1200,890,98,201,3,13016,0
32,"Satu Mare",179882,305,179882,,"CIUMESTI",203,"Caminul cultural Ciumesti, sat Ciumesti nr. 266",0,22,0,22,0,22,0,254,232,11,11,3,13016,1
32,"Satu Mare",137443,305,137443,,"CRAIDOROLT",204,"Primaria comunei Craidorolt, sat Craidorolt nr. 106",875,382,372,10,0,378,4,1000,618,192,186,3,13020,0
32,"Satu Mare",137443,305,137443,,"CRAIDOROLT",205,"Scoala cu clase I - IV Criseni, sat Criseni nr. 24",153,89,79,10,0,87,2,200,111,30,57,3,13020,0
32,"Satu Mare",137443,305,137443,,"CRAIDOROLT",206,"Scoala cu clase I - IV Eriu Sancrai, sat Eriu Sancrai str. Canepii nr. 166",515,382,377,5,0,381,1,600,218,110,271,3,13020,0
32,"Satu Mare",137443,305,137443,,"CRAIDOROLT",207,"Scoala cu clase I - IV Satu Mic, sat Satu Mic nr. 139",160,97,87,10,0,96,1,200,103,37,59,3,13020,0
32,"Satu Mare",137443,305,137443,,"CRAIDOROLT",208,"Scoala Generala Craidorolt, sat Craidorolt nr. 116",0,64,0,64,0,64,0,250,186,33,31,3,13020,1
32,"Satu Mare",137504,305,137504,,"CRUCISOR",209,"Scoala cu clase I - IV  Crucisor, sat Crucisor nr. 152",490,337,313,4,20,332,5,603,266,131,201,3,13026,0
32,"Satu Mare",137504,305,137504,,"CRUCISOR",210,"Scoala cu clase I - IV Iegheriste, sat  Iegheriste nr. 2",461,316,288,10,18,314,2,500,184,168,146,3,13026,0
32,"Satu Mare",137504,305,137504,,"CRUCISOR",211,"Scoala de Arte si Meserii Poiana Codrului, sat Poiana Codrului nr. 143",1205,789,759,14,16,784,5,1300,511,332,452,3,13026,0
32,"Satu Mare",137504,305,137504,,"CRUCISOR",212,"Scoala de Arte si Meserii Poiana Codrului, sat Poiana Codrului nr. 135",0,70,0,70,0,69,1,248,178,34,35,3,13026,1
32,"Satu Mare",137540,305,137540,,"CULCIU",213,"Consiliul Local Culciu, sat Culciu Mare nr. 234",629,257,253,4,0,248,9,700,443,88,160,3,13030,0
32,"Satu Mare",137540,305,137540,,"CULCIU",214,"Scoala Generala Apateu, sat Apateu nr. 101",251,92,83,9,0,91,1,300,208,30,61,3,13030,0
32,"Satu Mare",137540,305,137540,,"CULCIU",215,"Scoala de Arte si Meserii Caraseu, sat Caraseu nr. 328",927,332,324,8,0,326,6,1000,668,134,192,3,13030,0
32,"Satu Mare",137540,305,137540,,"CULCIU",216,"Scoala Generala Corod, sat Corod nr. 189",425,168,159,9,0,165,3,500,332,84,81,3,13030,0
32,"Satu Mare",137540,305,137540,,"CULCIU",217,"Scoala Generala Culciu Mic, sat Culciu Mic nr. 122",558,182,173,9,0,180,2,600,418,66,114,3,13030,0
32,"Satu Mare",137540,305,137540,,"CULCIU",218,"Scoala Generala Lipau, sat Lipau nr. 283",459,297,286,11,0,291,6,500,203,163,128,3,13030,0
32,"Satu Mare",137540,305,137540,,"CULCIU",219,"Scoala Generala Culciu Mare, sat Culciu Mare nr. 66",0,104,0,104,0,104,0,250,146,57,47,3,13030,1
32,"Satu Mare",137611,305,137611,,"DOBA",220,"Primaria comunei Doba, sat Doba nr. 56",1019,424,411,13,0,423,1,1100,676,235,188,3,13037,0
32,"Satu Mare",137611,305,137611,,"DOBA",221,"Scoala Generala Boghis, sat Boghis nr. 331",662,252,246,6,0,250,2,700,448,166,84,3,13037,0
32,"Satu Mare",137611,305,137611,,"DOBA",222,"Caminul cultural Dacia, sat Dacia nr. 68",143,105,96,9,0,105,0,202,97,41,64,3,13037,0
32,"Satu Mare",137611,305,137611,,"DOBA",223,"Scoala Generala Paulian, sat Paulian nr. 62",376,226,213,13,0,226,0,400,174,137,89,3,13037,0
32,"Satu Mare",137611,305,137611,,"DOBA",224,"Caminul cultural Traian, sat Traian nr. 78",149,81,72,9,0,80,1,200,119,31,49,3,13037,0
32,"Satu Mare",137611,305,137611,,"DOBA",225,"Scoala Generala Doba, sat Doba nr. 58",0,87,0,87,0,87,0,250,163,58,29,3,13037,1
32,"Satu Mare",137675,305,137675,,"DOROLT",226,"Primaria comunei Dorolt, sat Dorolt nr. 83",1664,518,512,6,0,495,23,1700,1182,213,282,3,13043,0
32,"Satu Mare",137675,305,137675,,"DOROLT",227,"Scoala Generala Dara, sat Dara nr. 79",1012,259,251,8,0,256,3,1100,841,53,203,3,13043,0
32,"Satu Mare",137675,305,137675,,"DOROLT",228,"Caminul cultural Atea, sat Atea FN",310,175,168,7,0,169,6,400,225,75,94,3,13043,0
32,"Satu Mare",137675,305,137675,,"DOROLT",229,"Scoala Generala Dorolt, sat Dorolt nr. 295",0,54,0,54,0,54,0,250,196,29,25,3,13043,1
32,"Satu Mare",137728,305,137728,,"FOIENI",230,"Consiliul Local Foieni, sat Foieni nr. 469",1636,379,374,5,0,375,4,1800,1421,82,293,3,13048,0
32,"Satu Mare",137728,305,137728,,"FOIENI",231,"Caminul cultural Foieni, sat Foieni nr. 468",0,16,0,16,0,16,0,201,185,10,6,3,13048,1
32,"Satu Mare",137746,305,137746,,"GHERTA MICA",232,"Primaria comunei Gherta Mica sala de oficiere, sat Gherta Mica nr. 234",1434,518,515,3,0,512,6,1600,1082,227,285,3,13050,0
32,"Satu Mare",137746,305,137746,,"GHERTA MICA",233,"Scoala de Arte si Meserii Gherta Mica, sat Gherta Mica nr. 441",1060,405,399,6,0,405,0,1200,795,192,213,3,13050,0
32,"Satu Mare",137746,305,137746,,"GHERTA MICA",234,"Primaria comunei Gherta Mica sala de sedinte, sat Gherta Mica nr. 234",0,39,0,39,0,39,0,250,211,12,27,3,13050,1
32,"Satu Mare",137764,305,137764,,"HALMEU",235,"Scoala Generala Halmeu, sat Halmeu, str. Eliberarii nr. 74",1932,763,756,6,1,756,7,2100,1337,387,369,3,13052,0
32,"Satu Mare",137764,305,137764,,"HALMEU",236,"Scoala Generala Rosie Halmeu, sat Halmeu, str. Eliberarii nr. 15",926,461,436,22,3,451,10,1100,639,258,193,3,13052,0
32,"Satu Mare",137764,305,137764,,"HALMEU",237,"Scoala cu clase I - IV Babesti, sat  Babesti nr. 22",332,164,144,10,10,161,3,400,236,61,100,3,13052,0
32,"Satu Mare",137764,305,137764,,"HALMEU",238,"Scoala cu clase I - IV Dabolt, sat Dabolt nr. 89",341,148,140,8,0,146,2,400,252,62,84,3,13052,0
32,"Satu Mare",137764,305,137764,,"HALMEU",239,"Scoala cu clase I - IV Mesteacan, sat Mesteacan nr. 11",344,139,129,10,0,137,2,399,260,69,68,3,13052,0
32,"Satu Mare",137764,305,137764,,"HALMEU",240,"Scoala de Arte si Meserii Halmeu, sat Halmeu, str. Eliberarii nr. 74",0,73,0,73,0,73,0,248,175,33,40,3,13052,1
32,"Satu Mare",137844,305,137844,,"HODOD",241,"Primaria comunei Hodod, sat Hodod nr.171",734,253,239,14,0,251,2,792,539,93,158,3,13058,0
32,"Satu Mare",137844,305,137844,,"HODOD",242,"Scoala Generala Giurtelecu Hododului, sat Giurtelecu Hododului nr. 150",512,192,183,9,0,185,7,599,407,75,110,3,13058,0
32,"Satu Mare",137844,305,137844,,"HODOD",243,"Scoala Generala Lelei, sat Lelei nr. 312",488,161,151,10,0,160,1,500,339,56,104,3,13058,0
32,"Satu Mare",137844,305,137844,,"HODOD",244,"Centrul Social Nadisu Hododului, sat Nadisu Hododului nr. 223",609,220,210,10,0,213,7,700,480,109,104,3,13058,0
32,"Satu Mare",137844,305,137844,,"HODOD",245,"Scoala Generala Hodod, sat Hodod nr. 84",0,42,0,42,0,42,0,200,158,17,25,3,13058,1
32,"Satu Mare",137899,305,137899,,"HOMOROADE",246,"Scoala Generala Homorodu de Mijloc, sat Homorodu de Mijloc nr. 268",604,371,354,12,5,368,3,701,330,207,161,3,13063,0
32,"Satu Mare",137899,305,137899,,"HOMOROADE",247,"Scoala cu clase I - IV Chilia, sat Chilia nr. 160",196,114,105,9,0,113,1,201,87,56,57,3,13063,0
32,"Satu Mare",137899,305,137899,,"HOMOROADE",248,"Scoala cu clase I - IV Homorodu de Jos, sat Homorodu de Jos nr. 71",298,157,145,8,4,157,0,300,143,90,67,3,13063,0
32,"Satu Mare",137899,305,137899,,"HOMOROADE",249,"Scoala Generala Necopoi, sat Necopoi nr. 175",210,138,120,9,9,136,2,300,162,78,58,3,13063,0
32,"Satu Mare",137899,305,137899,,"HOMOROADE",250,"Scoala cu clase I - IV Solduba, sat Solduba nr. 46",241,167,140,16,11,165,2,301,134,90,75,3,13063,0
32,"Satu Mare",137899,305,137899,,"HOMOROADE",251,"Scoala Generala Homorodu de Mijloc, sat Homorodu de Mijloc nr. 268",0,130,0,130,0,129,1,200,70,81,48,3,13063,1
32,"Satu Mare",137960,305,137960,,"LAZURI",252,"Caminul cultural nou Lazuri, sat Lazuri nr. 76",2205,700,680,19,1,696,4,2241,1541,360,336,3,13070,0
32,"Satu Mare",137960,305,137960,,"LAZURI",253,"Scoala Generala Bercu, sat Bercu nr. 183",529,180,174,6,0,175,5,600,420,93,82,3,13070,0
32,"Satu Mare",137960,305,137960,,"LAZURI",254,"Scoala Generala Nisipeni, sat Nisipeni FN",689,204,199,5,0,202,2,801,597,99,103,3,13070,0
32,"Satu Mare",137960,305,137960,,"LAZURI",255,"Scoala cu clase I - IV Noroieni, sat Noroieni FN",290,133,125,8,0,133,0,301,168,102,31,3,13070,0
32,"Satu Mare",137960,305,137960,,"LAZURI",256,"Scoala Generala Peles, sat Peles FN",726,180,175,5,0,179,1,803,623,61,118,3,13070,0
32,"Satu Mare",137960,305,137960,,"LAZURI",257,"Scoala cu clase I - IV Pelisor, sat Pelisor FN",184,72,63,9,0,69,3,207,135,17,52,3,13070,0
32,"Satu Mare",137960,305,137960,,"LAZURI",258,"Scoala Generala Bercu, sat Bercu nr. 183",0,59,0,59,0,57,2,250,191,26,31,3,13070,1
32,"Satu Mare",138084,305,138084,,"MEDIESU AURIT",259,"Primaria comunei Mediesu Aurit, sat Mediesu Aurit nr. 157",970,563,527,16,20,554,9,1100,537,289,265,3,13077,0
32,"Satu Mare",138084,305,138084,,"MEDIESU AURIT",260,"Scoala Generala Mediesu Aurit, sat Mediesu Aurit nr. 551",1157,666,625,29,12,661,5,1291,625,391,270,3,13077,0
32,"Satu Mare",138084,305,138084,,"MEDIESU AURIT",261,"Gradinita Babasesti, sat Babasesti nr. 50",484,298,272,15,11,297,1,500,202,163,134,3,13077,0
32,"Satu Mare",138084,305,138084,,"MEDIESU AURIT",262,"Scoala Generala Iojib, sat Iojib nr. 370",880,409,391,11,7,406,3,900,491,297,109,3,13077,0
32,"Satu Mare",138084,305,138084,,"MEDIESU AURIT",263,"Scoala cu clase I - IV Medies Raturi, sat Medies Raturi nr. 117",221,123,110,13,0,123,0,300,177,63,60,3,13077,0
32,"Satu Mare",138084,305,138084,,"MEDIESU AURIT",264,"Scoala cu clase I - IV Medies Vii, sat Medies Vii nr. 29",169,91,80,11,0,89,2,200,109,58,31,3,13077,0
32,"Satu Mare",138084,305,138084,,"MEDIESU AURIT",265,"Scoala Generala Potau, sat Potau nr. 329",861,441,416,4,21,440,1,900,459,275,165,3,13077,0
32,"Satu Mare",138084,305,138084,,"MEDIESU AURIT",266,"Scoala cu clase I - IV Romanesti, sat Romanesti nr. 43",597,389,368,12,9,386,3,700,311,227,159,3,13077,0
32,"Satu Mare",138084,305,138084,,"MEDIESU AURIT",267,"Scoala Generala Mediesu Aurit, sat Mediesu Aurit nr. 551",0,171,0,171,0,171,0,245,74,108,63,3,13077,1
32,"Satu Mare",138164,305,138164,,"MICULA",268,"Caminul cultural Micula, sat Micula nr. 93",1217,385,370,15,0,375,10,1300,915,197,178,3,13085,0
32,"Satu Mare",138164,305,138164,,"MICULA",269,"Gradinita nr. 2 Micula, sat Micula nr. 420",1322,632,594,38,0,623,9,1500,868,444,179,3,13085,0
32,"Satu Mare",138164,305,138164,,"MICULA",270,"Scoala Generala Micula Noua, sat Micula Noua nr. 42",532,265,234,31,0,260,5,600,335,153,107,3,13085,0
32,"Satu Mare",138164,305,138164,,"MICULA",271,"Scoala de Arte si Meserii Gellert Sandor Micula, sat Micula nr. 98",0,57,0,57,0,57,0,250,193,24,33,3,13085,1
32,"Satu Mare",138208,305,138208,,"MOFTIN",272,"Caminul cultural Moftinu Mic, sat Moftinu Mic nr. 221",1051,488,482,6,0,478,10,1198,710,198,280,3,13089,0
32,"Satu Mare",138208,305,138208,,"MOFTIN",273,"Scoala Generala Domanesti, sat Domanesti nr. 78",909,425,418,7,0,420,5,1000,575,124,296,3,13089,0
32,"Satu Mare",138208,305,138208,,"MOFTIN",274,"Scoala Generala Moftinu Mare, sat Moftinu Mare nr. 51",1161,371,362,9,0,364,7,1300,929,187,177,3,13089,0
32,"Satu Mare",138208,305,138208,,"MOFTIN",275,"Gradinita Sanmiclaus, sat Sanmiclaus nr. 73",456,202,191,11,0,201,1,500,298,86,115,3,13089,0
32,"Satu Mare",138208,305,138208,,"MOFTIN",276,"Caminul cultural Moftinu Mic, sat Moftinu Mic nr. 221",0,73,0,73,0,73,0,250,177,29,44,3,13089,1
32,"Satu Mare",138280,305,138280,,"ODOREU",277,"Gradinita Odoreu, sat Odoreu Str. Replublicii nr. 86",1841,956,933,16,7,945,11,1998,1042,596,349,3,13097,0
32,"Satu Mare",138280,305,138280,,"ODOREU",278,"Scoala Generala Odoreu, sat Odoreu Str. Tineretului nr. 2",2004,1135,1099,27,9,1117,18,2100,965,690,427,3,13097,0
32,"Satu Mare",138280,305,138280,,"ODOREU",279,"SC Prodexim SRL Berindan, sat Berindan FN",106,49,41,8,0,49,0,196,147,27,22,3,13097,0
32,"Satu Mare",138280,305,138280,,"ODOREU",280,"Caminul cultural Martinesti, sat Martinesti FN",357,246,236,10,0,245,1,400,154,127,118,3,13097,0
32,"Satu Mare",138280,305,138280,,"ODOREU",281,"Gradinita Odoreu, sat Odoreu Str. Replublicii nr. 86",0,129,0,129,0,128,1,250,121,78,50,3,13097,1
32,"Satu Mare",138351,305,138351,,"ORASU NOU",282,"Scoala Generala Orasu Nou, sat Orasu Nou str. Satu Mare nr. 79",812,405,400,5,0,398,7,909,504,330,68,3,13104,0
32,"Satu Mare",138351,305,138351,,"ORASU NOU",283,"Scoala Generala Orasu Nou, sat Orasu Nou str. Satu Mare nr. 79",854,442,435,7,0,435,7,905,463,377,58,3,13104,0
32,"Satu Mare",138351,305,138351,,"ORASU NOU",284,"Scoala Generala Orasu Nou Vii, sat Orasu Nou Vii nr. 91",331,174,165,9,0,172,2,394,220,96,76,3,13104,0
32,"Satu Mare",138351,305,138351,,"ORASU NOU",285,"Scoala Generala Prilog, sat Prilog Str. Principala nr. 171",567,276,250,15,11,273,3,600,324,168,105,3,13104,0
32,"Satu Mare",138351,305,138351,,"ORASU NOU",286,"Imobilul cu nr. 42 din Prilog Vii, sat Prilog Vii nr. 42",139,97,83,14,0,96,1,200,103,31,65,3,13104,0
32,"Satu Mare",138351,305,138351,,"ORASU NOU",287,"Scoala Generala Prilog Vii, sat Prilog Vii str. Mujdeni nr. 117",96,63,47,16,0,63,0,100,37,34,29,3,13104,0
32,"Satu Mare",138351,305,138351,,"ORASU NOU",288,"Scoala Generala Racsa, sat Racsa nr. 335",1379,811,768,11,32,807,4,1400,589,81,726,3,13104,0
32,"Satu Mare",138351,305,138351,,"ORASU NOU",289,"Scoala Generala Racsa, sat Racsa nr. 335",780,499,472,9,18,488,11,899,400,52,436,3,13104,0
32,"Satu Mare",138351,305,138351,,"ORASU NOU",290,"Scoala Generala Racsa Vii, sat Racsa Vii nr. 29",192,136,122,14,0,136,0,200,64,50,86,3,13104,0
32,"Satu Mare",138351,305,138351,,"ORASU NOU",291,"Scoala Generala Remetea Oas, sat Remetea Oas nr. 90",449,233,221,12,0,229,4,486,253,148,81,3,13104,0
32,"Satu Mare",138351,305,138351,,"ORASU NOU",292,"Scoala Generala Orasu Nou, sat Orasu Nou str. Satu Mare nr. 77",0,54,0,54,0,54,0,255,201,16,38,3,13104,1
32,"Satu Mare",138431,305,138431,,"PAULESTI",293,"Caminul cultural Paulesti, sat Paulesti str. Principala nr. 134",1011,512,500,12,0,503,9,1098,586,255,248,3,13112,0
32,"Satu Mare",138431,305,138431,,"PAULESTI",294,"Scoala Generala Amati, sat Amati nr. 265",809,388,378,10,0,381,7,900,512,220,161,3,13112,0
32,"Satu Mare",138431,305,138431,,"PAULESTI",295,"Scoala Generala Soltesz Janos Ambud, sat Ambud nr. 130",900,317,307,10,0,314,3,1000,683,140,174,3,13112,0
32,"Satu Mare",138431,305,138431,,"PAULESTI",296,"Scoala Generala Hrip, sat Hrip nr. 348",502,246,238,8,0,242,4,600,354,147,95,3,13112,0
32,"Satu Mare",138431,305,138431,,"PAULESTI",297,"Scoala Generala Petin, sat Petin nr. 57",568,213,207,6,0,208,5,600,387,67,141,3,13112,0
32,"Satu Mare",138431,305,138431,,"PAULESTI",298,"Scoala Generala Ruseni, sat Ruseni nr. 75",200,136,125,11,0,134,2,300,164,53,81,3,13112,0
32,"Satu Mare",138431,305,138431,,"PAULESTI",299,"Caminul cultural Paulesti, sat Paulesti str. Principala nr. 203",0,109,0,109,0,109,0,250,141,46,63,3,13112,1
32,"Satu Mare",138501,305,138501,,"PETRESTI",300,"Primaria comunei Petresti, sat Petresti str. Piscoltului nr. 1",1383,360,353,7,0,354,6,1400,1040,102,252,3,13119,0
32,"Satu Mare",138501,305,138501,,"PETRESTI",301,"Gradinita Dindestiu Mic, sat Dindestiu Mic nr. 35",297,100,90,10,0,95,5,300,200,54,41,3,13119,0
32,"Satu Mare",138501,305,138501,,"PETRESTI",302,"Scoala Generala Petresti, sat Petresti str. Principala nr. 548",0,34,0,34,0,34,0,250,216,16,18,3,13119,1
32,"Satu Mare",138538,305,138538,,"PIR",303,"Scoala de Arte si Meserii Pir, sat Pir nr. 279",1203,556,537,13,6,547,9,1300,744,281,266,3,13122,0
32,"Satu Mare",138538,305,138538,,"PIR",304,"Scoala cu clasele I - IV Sarvazel, sat Sarvazel nr. 67",123,84,74,10,0,82,2,203,119,37,45,3,13122,0
32,"Satu Mare",138538,305,138538,,"PIR",305,"Scoala de Arte si Meserii Pir, sat Pir nr. 279",0,45,0,45,0,44,1,250,205,16,28,3,13122,1
32,"Satu Mare",138574,305,138574,,"PISCOLT",306,"Primaria comunei Piscolt, sat Piscolt str. Libertatii nr. 62",961,588,571,11,6,585,3,1096,508,373,212,3,13126,0
32,"Satu Mare",138574,305,138574,,"PISCOLT",307,"Primaria comunei Piscolt, sat Piscolt str. Libertatii nr. 62",865,566,550,14,2,552,14,898,332,301,251,3,13126,0
32,"Satu Mare",138574,305,138574,,"PISCOLT",308,"Scoala cu clasele I - IV Resighea, sat Resighea str. Principala nr.193",337,228,214,9,5,228,0,401,173,145,83,3,13126,0
32,"Satu Mare",138574,305,138574,,"PISCOLT",309,"Scoala cu cls. I - IV Scarisoara Noua, sat Scarisoara Noua str. Principala nr. 177",369,268,255,13,0,265,3,405,137,90,175,3,13126,0
32,"Satu Mare",138574,305,138574,,"PISCOLT",310,"Scoala cu clasele I - IV Piscolt, sat Piscolt str. Libertatii nr. 289",0,115,0,115,0,115,0,250,135,55,60,3,13126,1
32,"Satu Mare",138618,305,138618,,"POMI",311,"Primaria comunei Pomi, sat Pomi nr. 110",748,453,414,8,31,444,9,776,323,253,191,3,13130,0
32,"Satu Mare",138618,305,138618,,"POMI",312,"Scoala cu clasele I - IV Aciua, sat Aciua nr. 62",82,46,37,9,0,45,1,100,54,12,33,3,13130,0
32,"Satu Mare",138618,305,138618,,"POMI",313,"Scoala cu clasele I - IV Bicau, sat Bicau nr. 84",136,90,84,6,0,89,1,200,110,38,51,3,13130,0
32,"Satu Mare",138618,305,138618,,"POMI",314,"Scoala Generala Borlesti, sat Borlesti nr. 195",585,276,267,7,2,268,8,593,317,150,118,3,13130,0
32,"Satu Mare",138618,305,138618,,"POMI",315,"Scoala Generala Borlesti, sat Borlesti nr. 195",0,160,0,160,0,159,1,249,89,81,78,3,13130,1
32,"Satu Mare",180028,305,180028,,"PORUMBESTI",316,"Scoala Generala Porumbesti, sat Porumbesti nr. 35",1193,471,464,7,0,463,8,1195,724,109,354,3,13135,0
32,"Satu Mare",180028,305,180028,,"PORUMBESTI",317,"Scoala Generala Cidreag, sat Cidreag nr. 16",816,294,291,3,0,281,13,900,606,134,147,3,13135,0
32,"Satu Mare",180028,305,180028,,"PORUMBESTI",318,"Caminul cultural Porumbesti, sat Porumbesti nr. 221",0,30,0,30,0,29,1,247,217,16,13,3,13135,1
32,"Satu Mare",138663,305,138663,,"SANISLAU",319,"Gradinita Nr. 1 Sanislau, sat Sanislau nr. 1082",1394,519,499,18,2,511,8,1400,881,188,323,3,13141,0
32,"Satu Mare",138663,305,138663,,"SANISLAU",320,"Scoala Generala Gheorghe Bulgare Sanislau,sat Sanislau nr.1069",1273,576,559,11,6,569,7,1300,724,255,314,3,13141,0
32,"Satu Mare",138663,305,138663,,"SANISLAU",321,"Caminul cultural Horea, sat Horea nr. 64",147,99,90,9,0,96,3,198,99,58,38,3,13141,0
32,"Satu Mare",138663,305,138663,,"SANISLAU",322,"Caminul cultural Marna, sat Marna nr. 86",279,170,157,6,7,170,0,326,156,56,114,3,13141,0
32,"Satu Mare",138663,305,138663,,"SANISLAU",323,"Gradinita Nr. 1 Sanislau, sat Sanislau nr. 1082",0,74,0,74,0,74,0,249,175,42,32,3,13141,1
32,"Satu Mare",138734,305,138734,,"SANTAU",324,"Scoala Generala Santau, sat Santau nr. 225",1403,844,824,8,12,830,14,1500,656,434,396,3,13145,0
32,"Satu Mare",138734,305,138734,,"SANTAU",325,"Scoala cu clasele I - IV Chereusa, sat Chereusa nr. 105",504,295,286,4,5,293,2,600,305,183,110,3,13145,0
32,"Satu Mare",138734,305,138734,,"SANTAU",326,"Scoala cu clasele I - IV Sudurau, sat Sudurau nr. 88",144,79,70,9,0,79,0,200,121,44,35,3,13145,0
32,"Satu Mare",138734,305,138734,,"SANTAU",327,"Scoala Generala Santau, sat Santau nr. 225",0,73,0,73,0,73,0,250,177,55,18,3,13145,1
32,"Satu Mare",138770,305,138770,,"SACASENI",328,"Primaria conumei Sacaseni, sat Sacaseni nr. 467",850,348,335,6,7,340,8,893,545,157,183,3,13138,0
32,"Satu Mare",138770,305,138770,,"SACASENI",329,"Scoala Generala Chegea, sat Chegea nr. 186/A",167,122,101,14,7,117,5,200,78,86,31,3,13138,0
32,"Satu Mare",138770,305,138770,,"SACASENI",330,"Scoala Generala Sacaseni, sat Sacaseni nr. 467",0,33,0,33,0,32,1,251,218,21,11,3,13138,1
32,"Satu Mare",138805,305,138805,,"SAUCA",331,"Scoala de Arte si Meserii Sauca, sat Sauca nr. 23",334,199,192,7,0,198,1,400,201,91,107,3,13149,0
32,"Satu Mare",138805,305,138805,,"SAUCA",332,"Scoala de Arte si Meserii Becheni, sat Becheni nr. 78",414,183,176,7,0,178,5,500,317,124,54,3,13149,0
32,"Satu Mare",138805,305,138805,,"SAUCA",333,"Scoala cu clasele I - IV Cean, sat Cean nr. 44",240,138,124,14,0,133,5,300,162,64,69,3,13149,0
32,"Satu Mare",138805,305,138805,,"SAUCA",334,"Scoala cu clasele I - IV Silvas, sat Silvas nr. 6",119,79,72,7,0,77,2,200,121,35,42,3,13149,0
32,"Satu Mare",138805,305,138805,,"SAUCA",335,"Scoala de Arte si Meserii Sauca, sat Sauca nr. 23",0,42,0,42,0,42,0,250,208,18,24,3,13149,1
32,"Satu Mare",138869,305,138869,,"SOCOND",336,"Scoala Generala Socond, sat Socond nr. 30",410,258,246,11,1,257,1,500,242,153,104,3,13155,0
32,"Satu Mare",138869,305,138869,,"SOCOND",337,"Scoala Generala Cuta, sat Cuta nr. 101",331,197,171,5,21,196,1,400,203,108,88,3,13155,0
32,"Satu Mare",138869,305,138869,,"SOCOND",338,"Scoala Generala Hodisa, sat Hodisa nr. 179/A",212,129,124,5,0,127,2,300,171,74,53,3,13155,0
32,"Satu Mare",138869,305,138869,,"SOCOND",339,"Scoala Generala Soconzel, sat Soconzel nr. 130/A",276,198,180,5,13,196,2,300,102,99,97,3,13155,0
32,"Satu Mare",138869,305,138869,,"SOCOND",340,"Scoala Generala Stana, sat Stana nr. 216",770,474,467,7,0,468,6,798,324,225,243,3,13155,0
32,"Satu Mare",138869,305,138869,,"SOCOND",341,"Scoala Generala Socond, sat Socond nr. 179",0,76,0,76,0,76,0,250,174,43,33,3,13155,1
32,"Satu Mare",138921,305,138921,,"SUPUR",342,"Primaria comunei Supur, sat Supuru de Jos, Str. Teilor nr. 14",1029,497,485,12,0,490,7,1100,603,163,327,3,13161,0
32,"Satu Mare",138921,305,138921,,"SUPUR",343,"Scoala Generala Dobra, sat Dobra nr. 307",856,312,305,7,0,302,10,895,583,63,239,3,13161,0
32,"Satu Mare",138921,305,138921,,"SUPUR",344,"Scoala Generala Giorocuta, sat Giorocuta nr. 269",596,336,322,14,0,333,3,700,364,96,237,3,13161,0
32,"Satu Mare",138921,305,138921,,"SUPUR",345,"Scoala Generala Hurezu Mare, sat Hurezu Mare nr. 143",310,194,183,11,0,193,1,400,206,88,105,3,13161,0
32,"Satu Mare",138921,305,138921,,"SUPUR",346,"Scoala Generala Racova, sat Racova nr. 69",212,150,141,9,0,145,5,300,150,74,71,3,13161,0
32,"Satu Mare",138921,305,138921,,"SUPUR",347,"Scoala Generala Secheresa, sat Secheresa nr. 6",62,34,26,8,0,34,0,100,66,4,30,3,13161,0
32,"Satu Mare",138921,305,138921,,"SUPUR",348,"Scoala Generala Ioan Galu Supuru de Sus, sat Supuru de Sus nr. 160",399,231,217,14,0,226,5,400,169,55,171,3,13161,0
32,"Satu Mare",138921,305,138921,,"SUPUR",349,"Scoala de Arte si Meserii Supuru de Jos, sat Supuru de Jos, Str. Teilor nr. 3",0,162,0,162,0,161,1,250,88,61,100,3,13161,1
32,"Satu Mare",139009,305,139009,,"TARNA MARE",350,"Primaria comunei Tarna Mare,  sat Tarna Mare nr. 284",1256,605,596,7,2,597,8,1296,691,371,226,3,13169,0
32,"Satu Mare",139009,305,139009,,"TARNA MARE",351,"Scoala cu clasele I - IV  nr. 2 Tarna Mare, sat Tarna Mare nr. 518",419,223,210,13,0,221,2,505,282,129,92,3,13169,0
32,"Satu Mare",139009,305,139009,,"TARNA MARE",352,"Scoala cu clasele I - IV Bocicau, sat Bocicau nr. 105",486,230,224,6,0,228,2,504,274,155,73,3,13169,0
32,"Satu Mare",139009,305,139009,,"TARNA MARE",353,"Gradinita Valea Seaca, sat Valea Seaca nr. 390",954,403,396,6,1,400,3,995,592,237,163,3,13169,0
32,"Satu Mare",139009,305,139009,,"TARNA MARE",354,"Scoala de Arte si Meserii Tarna Mare,  sat Tarna Mare nr. 308",0,44,0,44,0,42,2,251,207,27,15,3,13169,1
32,"Satu Mare",139143,305,139143,,"TARSOLT",355,"Scoala de Arte si Meserii Tarsolt, sat Tarsolt nr. 89",1317,445,434,8,3,438,7,1400,955,299,139,3,13174,0
32,"Satu Mare",139143,305,139143,,"TARSOLT",356,"Scoala de Arte si Meserii Tarsolt, sat Tarsolt nr. 89",743,207,194,10,3,205,2,798,591,118,87,3,13174,0
32,"Satu Mare",139143,305,139143,,"TARSOLT",357,"Scoala cu clasele I - IV Aliceni, sat Aliceni nr. 89",303,106,95,6,5,104,2,400,294,56,48,3,13174,0
32,"Satu Mare",139143,305,139143,,"TARSOLT",358,"Scoala Generala Tarsolt, sat Tarsolt nr. 89",0,64,0,64,0,64,0,250,186,25,39,3,13174,1
32,"Satu Mare",139054,305,139054,,"TEREBESTI",359,"Primaria comunei Terebesti,  sat Terebesti nr. 166",537,298,292,6,0,295,3,602,304,187,108,3,13177,0
32,"Satu Mare",139054,305,139054,,"TEREBESTI",360,"Scoala cu clasele I - IV Gelu, sat Gelu nr. 151",384,258,246,12,0,255,3,403,145,101,154,3,13177,0
32,"Satu Mare",139054,305,139054,,"TEREBESTI",361,"Scoala cu clasele I - IV Piscari, sat Piscari nr. 60",347,214,204,10,0,209,5,403,189,82,127,3,13177,0
32,"Satu Mare",139054,305,139054,,"TEREBESTI",362,"Scoala generalaTerebesti,  sat Terebesti nr. 50",0,77,0,77,0,75,2,250,173,31,44,3,13177,1
32,"Satu Mare",139107,305,139107,,"TIREAM",363,"Primaria comunei Tiream,  sat Tiream nr. 490",1393,437,434,3,0,430,7,1500,1063,186,244,3,13182,0
32,"Satu Mare",139107,305,139107,,"TIREAM",364,"Scoala cu clasele I - IV Portita, sat Portita nr. 31",159,96,87,9,0,96,0,200,104,58,38,3,13182,0
32,"Satu Mare",139107,305,139107,,"TIREAM",365,"Scoala generala Vezendiu, sat Vezendiu nr. 88",390,237,222,14,1,233,4,400,163,109,124,3,13182,0
32,"Satu Mare",139107,305,139107,,"TIREAM",366,"Scoala generala Tiream,  sat Tiream nr. 245",0,72,0,72,0,72,0,250,178,21,51,3,13182,1
32,"Satu Mare",139170,305,139170,,"TURT",367,"Scoala de Arte si Meserii Turt, sat Turt P-ta Eroilor nr. 31, corp A",1492,586,579,7,0,583,3,1600,1014,316,267,3,13186,0
32,"Satu Mare",139170,305,139170,,"TURT",368,"Scoala de Arte si Meserii Turt, sat Turt P-ta Eroilor nr. 31, corp B",1146,485,462,23,0,485,0,1300,815,299,186,3,13186,0
32,"Satu Mare",139170,305,139170,,"TURT",369,"Scoala Generala Nr. 2  Turt, sat Turt str. Ulita Mare nr. 111",1285,548,522,26,0,545,3,1400,852,334,211,3,13186,0
32,"Satu Mare",139170,305,139170,,"TURT",370,"Scoala Generala Nr. 1 Turt, sat Turt str. Susani de Jos nr. 83",836,370,353,17,0,367,3,894,524,215,152,3,13186,0
32,"Satu Mare",139170,305,139170,,"TURT",371,"Scoala Generala Gherta Mare, sat Gherta Mare str. Turulung nr. 76",1230,444,438,6,0,443,1,1400,956,265,178,3,13186,0
32,"Satu Mare",139170,305,139170,,"TURT",372,"Scoala de Arte si Meserii Turt, sat Turt P-ta Eroilor nr. 32",0,55,0,55,0,55,0,252,197,35,20,3,13186,1
32,"Satu Mare",139214,305,139214,,"TURULUNG",373,"Primaria comunei Turulung,  sat Turulung str. Parcului nr. 260",978,234,229,5,0,227,7,1100,866,105,122,3,13190,0
32,"Satu Mare",139214,305,139214,,"TURULUNG",374,"Scoala de Arte si Meserii Turulung, sat Turulung str. Principala nr. 13",1131,361,355,6,0,353,8,1200,839,158,195,3,13190,0
32,"Satu Mare",139214,305,139214,,"TURULUNG",375,"Scoala Generala Draguseni, sat Draguseni nr. 41",1017,440,431,9,0,434,6,1100,660,246,188,3,13190,0
32,"Satu Mare",139214,305,139214,,"TURULUNG",376,"Scoala cu clasele I - IV Turulung Vii, sat Turulung Vii nr. 50",154,54,44,10,0,54,0,200,146,24,30,3,13190,0
32,"Satu Mare",139214,305,139214,,"TURULUNG",377,"Scoala de Arte si Meserii Turulung, sat Turulung str. Principala nr. 13",0,39,0,39,0,38,1,250,211,23,15,3,13190,1
32,"Satu Mare",139250,305,139250,,"URZICENI",378,"Caminul cultural Urziceni, sat Urziceni nr. 238",1103,320,315,5,0,316,4,1200,880,110,206,3,13194,0
32,"Satu Mare",139250,305,139250,,"URZICENI",379,"Scoala Generala Urziceni Padure, sat Urziceni Padure nr. 23",175,68,58,10,0,66,2,200,132,47,19,3,13194,0
32,"Satu Mare",139250,305,139250,,"URZICENI",380,"Caminul cultural Urziceni, sat Urziceni nr. 239",0,26,0,26,0,26,0,250,224,19,7,3,13194,1
32,"Satu Mare",139287,305,139287,,"VALEA VINULUI",381,"Primaria comunei Valea Vinului, sat Valea Vinului nr. 63",685,458,437,7,14,451,7,697,239,196,255,3,13197,0
32,"Satu Mare",139287,305,139287,,"VALEA VINULUI",382,"Scoala cu clasele I - IV Marius, sat Marius nr. 38",222,172,156,16,0,171,1,302,130,108,63,3,13197,0
32,"Satu Mare",139287,305,139287,,"VALEA VINULUI",383,"Scoala cu clasele I - IV Rosiori, sat Rosiori nr. 169",379,239,226,8,5,236,3,401,162,137,99,3,13197,0
32,"Satu Mare",139287,305,139287,,"VALEA VINULUI",384,"Scoala cu clasele I - IV Sai, sat Sai nr. 200",419,194,170,16,8,194,0,502,308,82,112,3,13197,0
32,"Satu Mare",139287,305,139287,,"VALEA VINULUI",385,"Scoala cu clasele I - IV Petru Vacarciuc Rosiori, sat Rosiori nr. 169",0,167,0,167,0,166,1,253,86,73,93,3,13197,1
32,"Satu Mare",139330,305,139330,,"VAMA",386,"Gradinita centru Vama, sat Vama str. Principala nr. 704",1738,729,720,9,0,724,5,1900,1171,459,265,3,13202,0
32,"Satu Mare",139330,305,139330,,"VAMA",387,"Scoala Generala Vama, sat Vama str. Principala nr. 743",1497,647,640,7,0,640,7,1600,953,409,231,3,13202,0
32,"Satu Mare",139330,305,139330,,"VAMA",388,"Gradinita centru Vama, sat Vama str. Principala nr. 704",0,54,0,54,0,53,1,252,198,37,16,3,13202,1
32,"Satu Mare",139358,305,139358,,"VETIS",389,"Scoala Generala Vetis, sat Vetis nr. 185",1666,711,704,7,0,692,19,1800,1089,465,227,3,13204,0
32,"Satu Mare",139358,305,139358,,"VETIS",390,"Scoala Generala Decebal, sat Decebal nr. 230",953,473,460,13,0,470,3,1000,527,301,169,3,13204,0
32,"Satu Mare",139358,305,139358,,"VETIS",391,"Caminul cultural Oar, sat Oar nr. 259",1294,357,351,6,0,353,4,1400,1043,182,171,3,13204,0
32,"Satu Mare",139358,305,139358,,"VETIS",392,"Scoala Generala Vetis, sat Vetis nr. 185",0,69,0,69,0,68,1,250,181,40,28,3,13204,1
32,"Satu Mare",139394,305,139394,,"VIILE SATU MARE",393,"Primaria comunei Viile Satu Mare, sat Viile Satu Mare str. Republicii nr. 1",1198,453,432,21,0,445,8,1300,847,233,212,3,13208,0
32,"Satu Mare",139394,305,139394,,"VIILE SATU MARE",394,"Scoala Generala Dealu Mare, sat Viile Satu Mare str. Codrului nr. 38",539,286,273,11,2,281,5,593,307,184,97,3,13208,0
32,"Satu Mare",139394,305,139394,,"VIILE SATU MARE",395,"Scoala Generala Cionchesti, sat Cionchesti nr. 43",172,131,122,8,1,130,1,200,69,97,33,3,13208,0
32,"Satu Mare",139394,305,139394,,"VIILE SATU MARE",396,"Scoala Generala Medisa, sat Medisa nr. 120",197,107,96,11,0,104,3,200,93,50,54,3,13208,0
32,"Satu Mare",139394,305,139394,,"VIILE SATU MARE",397,"Scoala Generala Tatarasti, sat Tatarasti nr. 42",606,328,320,8,0,327,1,690,362,181,146,3,13208,0
32,"Satu Mare",139394,305,139394,,"VIILE SATU MARE",398,"Scoala Generala Viile Satu Mare, sat Viile Satu Mare str. Republicii nr. 4",0,124,0,124,0,124,0,250,126,55,69,3,13208,1
33,"Salaj",139704,314,139704,,"MUNICIPIUL ZALAU",1,"COLEGIUL NATIONAL SILVANIA, STR. UNIRII NR.1 (SALA DE CURS)",2454,1244,1233,11,0,1232,12,2400,1156,477,755,1,13215,0
33,"Salaj",139704,314,139704,,"MUNICIPIUL ZALAU",2,"CAMIN DE COPII NR.1, STR. GHEORGHE DOJA, NR.19  (SALA DE CURS)",2026,1044,1036,8,0,1027,17,2200,1156,447,580,1,13215,0
33,"Salaj",139704,314,139704,,"MUNICIPIUL ZALAU",3,"STADIONUL MUNICIPAL,STR.STADIONULUI NR.5  (SALA DE CURS)",2300,1183,1174,9,0,1176,7,2500,1317,551,625,1,13215,0
33,"Salaj",139704,314,139704,,"MUNICIPIUL ZALAU",4,"LICEUL SPORTIV ""AVRAM IANCU"",STR.AVRAM IANCU,NR.4  (SALA DE CURS)",2217,1050,1038,12,0,1044,6,2400,1350,482,562,1,13215,0
33,"Salaj",139704,314,139704,,"MUNICIPIUL ZALAU",5,"LICEUL SPORTIV ""AVRAM IANCU"" (SALA DE SPORT), STR. AVRAM IANCU, NR.4",2616,1255,1244,11,0,1248,7,2800,1545,611,637,1,13215,0
33,"Salaj",139704,314,139704,,"MUNICIPIUL ZALAU",6,"CASA DE CULTURA MUNICIPALA, STR. CORNELIU COPOSU, NR.9  (SALA DE CURS)",2312,1326,1316,10,0,1316,10,2500,1174,531,785,1,13215,0
33,"Salaj",139704,314,139704,,"MUNICIPIUL ZALAU",7,"CASA DE CULTURA A SINDICATELOR,STR.9 MAI,NR.9",2346,1224,1211,13,0,1211,13,2500,1276,478,733,1,13215,0
33,"Salaj",139704,314,139704,,"MUNICIPIUL ZALAU",8,"SCOALA GENERALA GHEORGHE LAZAR, STR. GHEORGHE LAZAR,NR.3  (SALA DE CURS)",2242,1137,1126,10,1,1131,6,2400,1263,508,623,1,13215,0
33,"Salaj",139704,314,139704,,"MUNICIPIUL ZALAU",9,"GRUP SCOLAR MIHAI VITEAZUL, STR. TUDOR VLADIMIRESCU,NR.5  (SALA DE CURS)",2142,1063,1039,9,15,1044,19,2300,1237,520,524,1,13215,0
33,"Salaj",139704,314,139704,,"MUNICIPIUL ZALAU",10,"SCOALA GENERALA POROLISSUM, STR. POROLISSUM,NR.9  (SALA DE CURS)",1713,796,789,7,0,793,3,1800,1004,397,396,1,13215,0
33,"Salaj",139704,314,139704,,"MUNICIPIUL ZALAU",11,"SCOALA GENERALA POROLISSUM, STR. POROLISSUM,NR.9  (SALA DE CURS)",1587,797,792,5,0,794,3,1700,903,413,381,1,13215,0
33,"Salaj",139704,314,139704,,"MUNICIPIUL ZALAU",12,"SCOALA GIMNAZIALA IULIU MANIU, B-DUL MIHAI VITEAZUL, NR.35  (SALA DE CURS)",1945,875,865,10,0,869,6,2100,1225,427,442,1,13215,0
33,"Salaj",139704,314,139704,,"MUNICIPIUL ZALAU",13,"CAMIN DE COPII NR.3, STR. ALEEA TOAMNEI,NR.3",2411,1058,1046,11,1,1055,3,2600,1542,572,483,1,13215,0
33,"Salaj",139704,314,139704,,"MUNICIPIUL ZALAU",14,"SALA SPORTURILOR, B-DUL MIHAI VITEAZUL,NR.49",1683,775,765,10,0,775,0,1800,1025,403,372,1,13215,0
33,"Salaj",139704,314,139704,,"MUNICIPIUL ZALAU",15,"SALA SPORTURILOR, B-DUL MIHAI VITEAZUL, NR.49",2083,921,912,8,1,917,4,2200,1279,465,452,1,13215,0
33,"Salaj",139704,314,139704,,"MUNICIPIUL ZALAU",16,"SC SAMTEX SA (INTEGRATA), B-DUL MIHAI VITEAZUL, NR.97",2811,1300,1289,11,0,1296,4,3000,1700,689,607,1,13215,0
33,"Salaj",139704,314,139704,,"MUNICIPIUL ZALAU",17,"SCOALA  GENERALA CORNELIU COPOSU (NR.8), STR. SIMION BARNUTIU, NR.75 (SALA DE CURS)",2832,1362,1351,11,0,1353,9,3000,1638,777,576,1,13215,0
33,"Salaj",139704,314,139704,,"MUNICIPIUL ZALAU",18,"GRUP SCOLAR VOIEVOD GELU, STR.SIMION BARNUTIU,NR.51  (SALA DE CURS)",2201,1102,1087,14,1,1097,5,2400,1298,600,497,1,13215,0
33,"Salaj",139704,314,139704,,"MUNICIPIUL ZALAU",19,"GRUP SCOLAR VOIEVOD GELU, STR.SIMION BARNUTIU,NR.51  (SALA DE CURS)",2460,1118,1100,18,0,1114,4,2700,1582,625,489,1,13215,0
33,"Salaj",139704,314,139704,,"MUNICIPIUL ZALAU",20,"GRADINITA DE COPII NR.8, STR.SIMION BARNUTIU, NR.14",2043,976,959,15,2,971,5,2200,1224,525,446,1,13215,0
33,"Salaj",139704,314,139704,,"MUNICIPIUL ZALAU",21,"SCOALA GENERALA VASILE GOLDIS (NR.7), STR.TORENTULUI,NR.9  (SALA DE CURS)",1677,807,796,11,0,803,4,1800,993,414,389,1,13215,0
33,"Salaj",139704,314,139704,,"MUNICIPIUL ZALAU",22,"SCOALA POSTLICEALA SANITARA,STR.TORENTULUI NR.1 (BLOC P.13)  (SALA DE CURS)",1533,789,781,8,0,785,4,1600,811,365,420,1,13215,0
33,"Salaj",139704,314,139704,,"MUNICIPIUL ZALAU",23,"GRADINITA DE COPII NR.11, STR.SFANTA VINERI, NR.8",1675,796,783,13,0,792,4,1800,1004,444,348,1,13215,0
33,"Salaj",139704,314,139704,,"MUNICIPIUL ZALAU",24,"COLEGIUL TEHNIC ALEXANDRU PAPIU ILARIAN (fost LICEUL INDUSTRIAL NR.1), STR. SIMION BARNUTIU, NR.6  (SALA DE CURS)",2317,1182,1173,9,0,1176,6,2500,1318,517,659,1,13215,0
33,"Salaj",139704,314,139704,,"MUNICIPIUL ZALAU",25,"LICEUL PEDAGOGIC GHEORGHE SINCAI, STR. CRISAN, NR.15/A (SALA DE CURS)",2447,1370,1355,15,0,1362,8,2600,1230,520,842,1,13215,0
33,"Salaj",139704,314,139704,,"MUNICIPIUL ZALAU",26,"CLUB SC COMPANIA DE APA SOMES SA-SUCURSALA MUNICIPIUL ZALAU, B-DUL MIHAI VITEAZU, NR.25",2113,1117,1109,8,0,1105,12,2300,1183,500,605,1,13215,0
33,"Salaj",139704,314,139704,,"MUNICIPIUL ZALAU",27,"SCOALA GENERALA ""GEORGE COSBUC"",  CARTIER ORTELEC, STR. MOIGRADULUI, NR.3",1428,685,675,8,2,676,9,1500,815,356,320,1,13215,0
33,"Salaj",139704,314,139704,,"MUNICIPIUL ZALAU",28,"CAMIN CULTURAL, LOCALITATEA STANA, NR.166",265,161,153,8,0,160,1,300,139,52,108,1,13215,0
33,"Salaj",139704,314,139704,,"MUNICIPIUL ZALAU",29,"CLADIRE DESTINATA SEDIULUI DIRECTIEI GENERALE DE ADMINISTRARE A DOMENIULUI PUBLIC, BD. MIHAI VITEAZU, NR.68",0,418,0,418,0,416,2,800,382,224,192,1,13215,1
33,"Salaj",139704,314,139704,,"MUNICIPIUL ZALAU",30,"SPITALUL JUDETEAN SALAJ, STR. SIMION BARNUTIU NR.67",0,386,0,386,0,378,8,800,414,217,161,1,13215,1
33,"Salaj",139740,314,139740,,"ORAS CEHU SILVANIEI",31,"GRUPUL  SCOLAR ""GHEORGHE POP DE BASESTI"",STR.LIBERTATII,NR.8",1570,668,638,5,25,662,6,1700,1032,309,353,1,13218,0
33,"Salaj",139740,314,139740,,"ORAS CEHU SILVANIEI",32,"SCOALA GIMNAZIALA ""ANDREI MURESANU"" ,P-TA TRANDAFIRILOR,NR.39",1542,701,674,3,24,693,8,1600,899,287,406,1,13218,0
33,"Salaj",139740,314,139740,,"ORAS CEHU SILVANIEI",33,"CLUBUL COPIILOR,P-TA TRANDAFIRILOR,NR.29",1581,754,725,1,28,746,8,1700,946,321,425,1,13218,0
33,"Salaj",139740,314,139740,,"ORAS CEHU SILVANIEI",34,"SCOALA GENERALA HOROATU CEHULUI",160,107,101,3,3,106,1,200,93,44,62,1,13218,0
33,"Salaj",139740,314,139740,,"ORAS CEHU SILVANIEI",35,"SCOALA GIMNAZIALA GHEORGHE SINCAI MOTIS",611,422,395,4,23,419,3,600,178,168,251,1,13218,0
33,"Salaj",139740,314,139740,,"ORAS CEHU SILVANIEI",36,"SCOALA GENERALA NADIS",478,392,367,5,20,390,2,500,108,177,213,1,13218,0
33,"Salaj",139740,314,139740,,"ORAS CEHU SILVANIEI",37,"GRADINITA DE COPII ULCIUG",806,350,324,3,23,347,3,900,550,126,221,1,13218,0
33,"Salaj",139740,314,139740,,"ORAS CEHU SILVANIEI",38,"GRUPUL SCOLAR ""GHEORGHE POP DE BASESTI"", STR. LIBERTATII, NR.7, CP 455100",0,90,0,90,0,90,0,400,310,35,55,1,13218,1
33,"Salaj",139811,314,139811,,"ORAS JIBOU",39,"CASA DE CULTURA - SALA MICA, ORAS JIBOU,STR. PIATA  1 DECEMBRIE 1918, NR.8",2299,1214,1206,5,3,1205,9,2400,1186,512,693,1,13224,0
33,"Salaj",139811,314,139811,,"ORAS JIBOU",40,"GRUPUL SCOLAR  ""OCTAVIAN GOGA""- SALA DE CLASA NR.2, ORAS JIBOU, STRADA PARCULUI,NR.3",2143,1145,1137,4,4,1136,9,2300,1155,487,649,1,13224,0
33,"Salaj",139811,314,139811,,"ORAS JIBOU",41,"SCOALA  GIMNAZIALA LUCIAN BLAGA - SALA DE CLASA NR.1, ORAS JIBOU, STRADA GAROAFELOR,NR.7",1675,915,908,6,1,911,4,1800,885,352,559,1,13224,0
33,"Salaj",139811,314,139811,,"ORAS JIBOU",42,"LICEUL  TEORETIC ION AGARBICEANU- SALA DE CLASA NR 1, ORAS JIBOU, STRADA TUDOR VLADIMIRESCU,NR.7",2148,1070,1047,6,17,1057,13,2300,1230,509,548,1,13224,0
33,"Salaj",139811,314,139811,,"ORAS JIBOU",43,"SCOALA CU CLASELE I-IV - SALA DE CLASA NR 1,SAT CUCEU, NR.60",404,285,255,8,22,281,4,400,115,51,230,1,13224,0
33,"Salaj",139811,314,139811,,"ORAS JIBOU",44,"SCOALA CU CLASELE I-IV - SALA DE CLASA NR 1,SAT HUSIA, NR.57",216,135,130,5,0,135,0,200,65,46,89,1,13224,0
33,"Salaj",139811,314,139811,,"ORAS JIBOU",45,"SCOALA CU CLASELE I-IV - SALA DE CLASA NR 1,SAT RONA, NR.115/A",306,217,211,6,0,217,0,400,183,36,181,1,13224,0
33,"Salaj",139811,314,139811,,"ORAS JIBOU",46,"SCOALA CU CLASELE I-IV - SALA DE CLASA NR 1,SAT VAR, NR.103/A",437,299,287,6,6,296,3,500,201,86,210,1,13224,0
33,"Salaj",139811,314,139811,,"ORAS JIBOU",47,"SCOALA GENERALA NR.1 JIBOU, STR.PARCULUI NR.3",0,173,0,173,0,172,1,400,227,86,86,1,13224,1
33,"Salaj",139884,314,139884,,"ORAS SIMLEU SILVANIEI",48,"SCOALA GIMNAZIALA ""HOREA"",STR. HOREA NR.26",1634,839,831,7,1,831,8,1700,861,493,338,1,13230,0
33,"Salaj",139884,314,139884,,"ORAS SIMLEU SILVANIEI",49,"GRUPUL SCOLAR ""IOAN OSSIAN"", STR.SIMION BARNUTIU,NR.13",1573,784,778,6,0,775,9,1700,916,404,371,1,13230,0
33,"Salaj",139884,314,139884,,"ORAS SIMLEU SILVANIEI",50,"CENTRUL CULTURAL (CASA ORASENEASCA DE CULTURA),STR.ANDREI MURESAN,NR.1",1516,776,773,3,0,771,5,1600,824,421,350,1,13230,0
33,"Salaj",139884,314,139884,,"ORAS SIMLEU SILVANIEI",51,"COLEGIUL TEHNIC ""IULIU MANIU"",STR.MIHAIL KOGALNICEANU,NR.11",1507,781,774,7,0,766,15,1597,816,407,359,1,13230,0
33,"Salaj",139884,314,139884,,"ORAS SIMLEU SILVANIEI",52,"SCOALA SPECIALA,STR.NICOLAE BALCESCU,NR.19",1741,803,797,6,0,797,6,1900,1097,440,357,1,13230,0
33,"Salaj",139884,314,139884,,"ORAS SIMLEU SILVANIEI",53,"CLUBUL ELEVILOR,STR.1 DECEMBRIE 1918, NR.55",1873,938,932,6,0,928,10,2000,1062,534,394,1,13230,0
33,"Salaj",139884,314,139884,,"ORAS SIMLEU SILVANIEI",54,"GRADINITA DE COPII CU PROGRAM PRELUNGIT NR.3,STR.GHIOCEILOR, NR.18",1923,892,885,7,0,884,8,2000,1108,517,367,1,13230,0
33,"Salaj",139884,314,139884,,"ORAS SIMLEU SILVANIEI",55,"SCOALA GIMNAZIALA CEHEI",805,455,449,6,0,444,11,793,338,254,190,1,13230,0
33,"Salaj",139884,314,139884,,"ORAS SIMLEU SILVANIEI",56,"SCOALA GIMNAZIALA PUSTA",1134,624,613,11,0,582,42,1203,579,290,292,1,13230,0
33,"Salaj",139884,314,139884,,"ORAS SIMLEU SILVANIEI",57,"GRUPUL SCOLAR ""IOAN OSSIAN"", STR. SIMION BARNUTIU, NR.13, CP 455300",0,217,0,217,0,216,1,500,283,127,89,1,13230,1
33,"Salaj",139937,314,139937,,"AGRIJ",58,"SEDIUL PRIMARIEI AGRIJ, SAT AGRIJ, NR.348",772,456,441,7,8,450,6,800,344,167,283,3,13235,0
33,"Salaj",139937,314,139937,,"AGRIJ",59,"SCOALA CU CLASELE I-IV, SAT  RASTOLTU DESERT NR 92",294,204,187,8,9,202,2,300,96,83,119,3,13235,0
33,"Salaj",139937,314,139937,,"AGRIJ",60,"CAMINUL CULTURAL AGRIJ, SAT AGRIJ  NR.348",0,68,0,68,0,65,3,200,132,26,39,3,13235,1
33,"Salaj",139982,314,139982,,"ALMASU",61,"SEDIUL PRIMARIEI ALMASU, SAT ALMASU NR.144",893,482,458,8,16,477,5,900,418,285,192,3,13238,0
33,"Salaj",139982,314,139982,,"ALMASU",62,"CAMINUL CULTURAL, SAT JEBUCU,NR.77",338,226,205,7,14,221,5,400,174,74,147,3,13238,0
33,"Salaj",139982,314,139982,,"ALMASU",63,"SCOALA CU CLASELE I-IV, SAT  MESTEACANU, NR.75",389,233,228,5,0,231,2,400,167,144,87,3,13238,0
33,"Salaj",139982,314,139982,,"ALMASU",64,"CAMINUL CULTURAL, SAT PETRINZEL,NR.59",123,77,69,8,0,77,0,100,23,20,57,3,13238,0
33,"Salaj",139982,314,139982,,"ALMASU",65,"CAMINUL CULTURAL, SAT STANA,NR.96",142,92,84,8,0,92,0,100,8,51,41,3,13238,0
33,"Salaj",139982,314,139982,,"ALMASU",66,"SCOALA CU CLASELE I-IV, SAT TAUDU, NR.47",138,96,82,12,2,95,1,200,104,61,34,3,13238,0
33,"Salaj",139982,314,139982,,"ALMASU",67,"CAMINUL CULTURAL ALMASU, SAT ALMASU NR.260 CP 457010",0,66,0,66,0,66,0,200,134,50,16,3,13238,1
33,"Salaj",140084,314,140084,,"BABENI",68,"GRADINITA , SAT BABENI, NR.265",530,332,318,0,14,329,3,600,268,157,172,3,13248,0
33,"Salaj",140084,314,140084,,"BABENI",69,"SCOALA GIMNAZIALA VASILE ILUTIU, SAT CIOCMANI, NR.74",518,346,335,6,5,346,0,612,266,185,161,3,13248,0
33,"Salaj",140084,314,140084,,"BABENI",70,"SCOALA GENERALA, SAT POIENITA, NR.194",224,164,144,11,9,161,3,200,36,105,56,3,13248,0
33,"Salaj",140084,314,140084,,"BABENI",71,"SCOALA GENERALA, SAT CLIT, NR.41",203,151,145,6,0,151,0,200,49,68,83,3,13248,0
33,"Salaj",140084,314,140084,,"BABENI",72,"MAGAZIN SATESC, SAT PIROSA, NR.14",101,74,66,8,0,73,1,99,25,27,46,3,13248,0
33,"Salaj",140084,314,140084,,"BABENI",73,"GRADINITA BABENI, SAT BABENI, NR.265",0,171,0,171,0,171,0,200,29,98,73,3,13248,1
33,"Salaj",140146,314,140146,,"BALAN",74,"SCOALA GIMNAZIALA BALAN, SAT BALAN, NR.66, CORP A, SALA DE CLASA",845,472,465,7,0,466,6,900,428,288,178,3,13254,0
33,"Salaj",140146,314,140146,,"BALAN",75,"SCOALA PRIMARA CHECHIS, SAT CHECHIS  NR.111 -SALA DE CLASA",483,310,300,10,0,304,6,500,190,126,178,3,13254,0
33,"Salaj",140146,314,140146,,"BALAN",76,"GRADINITA CHENDREA, SAT CHENDREA NR.112 -SALA DE CURS",697,412,410,2,0,410,2,700,288,194,216,3,13254,0
33,"Salaj",140146,314,140146,,"BALAN",77,"SCOALA PRIMARA GALPAIA, SAT GALPAIA, NR.81 -SALA DE CLASA",382,216,207,9,0,214,2,400,184,82,132,3,13254,0
33,"Salaj",140146,314,140146,,"BALAN",78,"SCOALA GIMNAZIALA GALGAU-ALMASULUI,SAT GALGAU ALMASULUI, NR.402  -SALA DE CLASA",802,454,447,7,0,447,7,900,446,257,190,3,13254,0
33,"Salaj",140146,314,140146,,"BALAN",79,"CAMINUL CULTURAL CHECHIS, SAT CHECHIS, NR.110",0,211,0,211,0,211,0,250,39,117,94,3,13254,1
33,"Salaj",140208,314,140208,,"BANISOR",80,"SEDIUL PRIMARIEI  COMUNEI BANISOR, NR.29",597,335,333,2,0,333,2,711,376,158,175,3,13260,0
33,"Salaj",140208,314,140208,,"BANISOR",81,"SCOALA PRIMARA BAN, NR.3",404,250,246,4,0,245,5,401,151,143,102,3,13260,0
33,"Salaj",140208,314,140208,,"BANISOR",82,"SCOALA GIMNAZIALA PECEIU, NR.137",818,494,494,0,0,490,4,900,406,314,176,3,13260,0
33,"Salaj",140208,314,140208,,"BANISOR",83,"SEDIUL PRIMARIEI  COMUNEI BANISOR, SAT BANISOR, NR.29",0,89,0,89,0,89,0,100,11,47,42,3,13260,1
33,"Salaj",140244,314,140244,,"BENESAT",84,"SCOALA GENERALA BENESAT, SAT BENESAT, NR.208",363,187,187,0,0,184,3,400,213,70,114,3,13264,0
33,"Salaj",140244,314,140244,,"BENESAT",85,"SCOALA GIMNAZIALA ""AVRAM IANCU"", SAT ALUNIS, NR.258",514,352,346,6,0,351,1,559,207,150,201,3,13264,0
33,"Salaj",140244,314,140244,,"BENESAT",86,"SCOALA GENERALA BIUSA, SAT BIUSA, NR.201",445,273,267,6,0,271,2,500,227,61,210,3,13264,0
33,"Salaj",140244,314,140244,,"BENESAT",87,"SCOALA GENERALA BENESAT, SAT. BENESAT, NR.112",0,65,0,65,0,65,0,200,135,26,39,3,13264,1
33,"Salaj",140280,314,140280,,"BOBOTA",88,"GRADINITA BOBOTA, SALA NR.1, SAT BOBOTA, NR.277/A",1198,728,722,4,2,724,4,1300,572,331,393,3,13268,0
33,"Salaj",140280,314,140280,,"BOBOTA",89,"SCOALA  GENERALA DERSIDA, SAT DERSIDA, STR. PRINCIPALA NR.57",1464,728,719,9,0,714,14,1600,872,242,472,3,13268,0
33,"Salaj",140280,314,140280,,"BOBOTA",90,"SCOALA  GENERALA ZALNOC, SAT ZALNOC, NR.22",442,233,227,6,0,233,0,500,267,111,122,3,13268,0
33,"Salaj",140280,314,140280,,"BOBOTA",91,"GRADINITA BOBOTA - SALA NR.2, SAT BOBOTA, NR 277/A",0,86,0,86,0,86,0,203,117,47,39,3,13268,1
33,"Salaj",140324,314,140324,,"BOCSA",92,"SCOALA GIMNAZIALA  "" SIMION BARNUTIU"", BOCSA, NR.74",764,535,489,4,42,533,2,778,243,251,282,3,13272,0
33,"Salaj",140324,314,140324,,"BOCSA",93,"SCOALA GIMNAZIALA BORLA, NR.245",1303,609,578,7,24,604,5,1400,791,111,493,3,13272,0
33,"Salaj",140324,314,140324,,"BOCSA",94,"SCOALA CU CLASELE I-IV SALAJENI, NR.29",700,443,405,8,30,439,4,700,257,150,289,3,13272,0
33,"Salaj",140324,314,140324,,"BOCSA",95,"SCOALA GIMNAZIALA ""SIMION BARNUTIU"" , SAT BOCSA, NR.74",0,79,0,79,0,79,0,192,113,35,44,3,13272,1
33,"Salaj",180037,314,180037,,"BOGHIS",96,"SALA DE SEDINTE A  PRIMARIEI BOGHIS, SAT BOGHIS, NR.152",1216,613,586,5,22,600,13,1300,687,202,398,3,13277,0
33,"Salaj",180037,314,180037,,"BOGHIS",97,"CAMINUL CULTURAL DIN SATUL BOZIES, NR. 105",254,145,139,6,0,140,5,300,155,47,93,3,13277,0
33,"Salaj",180037,314,180037,,"BOGHIS",98,"BIROUL SERVICIULUI SOCIAL DIN CADRUL PRIMARIEI BOGHIS, SAT BOGHIS, NR.152",0,46,0,46,0,44,2,200,154,18,26,3,13277,1
33,"Salaj",140379,314,140379,,"BUCIUMI",99,"CAMINUL CULTURAL  BUCIUMI, SAT BUCIUMI NR. 124",1012,581,574,6,1,577,4,1098,517,344,233,3,13280,0
33,"Salaj",140379,314,140379,,"BUCIUMI",100,"SCOALA CU CLASELE I-IV BODIA, SAT BODIA,  NR.67/A",209,116,108,8,0,115,1,200,84,66,49,3,13280,0
33,"Salaj",140379,314,140379,,"BUCIUMI",101,"SCOALA CU CLASELE I-IV BOGDANA, SAT BOGDANA, NR.235/A",379,252,245,7,0,247,5,400,148,97,150,3,13280,0
33,"Salaj",140379,314,140379,,"BUCIUMI",102,"SCOALA CU CLASELE I-IV RASTOLT, SAT RASTOLT, NR.39",206,124,118,6,0,122,2,200,76,54,68,3,13280,0
33,"Salaj",140379,314,140379,,"BUCIUMI",103,"SCOALA CU CLASELE I-IV SANGEORGIU DE MESES, SAT SANGEORGIU DE MESES,NR.93/A",280,185,178,7,0,182,3,300,115,96,86,3,13280,0
33,"Salaj",140379,314,140379,,"BUCIUMI",104,"SEDIUL PRIMARIEI BUCIUMI, SAT BUCIUMI, NR.124, CP 457050",0,156,0,156,0,156,0,201,45,95,61,3,13280,1
33,"Salaj",140440,314,140440,,"CAMAR",105,"SALA DE ""CASATORII"" A PRIMARIEI  COMUNEI CAMAR, NR.1",1396,802,795,0,7,788,14,1500,698,277,511,3,13287,0
33,"Salaj",140440,314,140440,,"CAMAR",106,"SALA DE SEDINTE  A PRIMARIEI COMUNEI CAMAR, SAT CAMAR, NR.1",0,33,0,33,0,33,0,100,67,17,16,3,13287,1
33,"Salaj",140477,314,140477,,"CARASTELEC",107,"SCOALA GIMNAZIALA,  SATUL CARASTELEC, NR.463",814,719,682,5,32,714,5,900,181,99,615,3,13290,0
33,"Salaj",140477,314,140477,,"CARASTELEC",108,"SCOALA PRIMARA , SATUL DUMUSLAU,NR.37",66,42,36,6,0,41,1,100,58,26,15,3,13290,0
33,"Salaj",140477,314,140477,,"CARASTELEC",109,"SCOALA GIMNAZIALA, SATUL CARASTELEC, NR.463, CP 457065",0,40,0,40,0,38,2,100,60,11,27,3,13290,1
33,"Salaj",140501,314,140501,,"CHIESD",110,"SCOALA GIMNAZIALA CHIESD, NR.365",1513,799,795,4,0,787,12,1600,801,263,524,3,13293,0
33,"Salaj",140501,314,140501,,"CHIESD",111,"SCOALA GENERALA SIGHETU SILVANIEI, NR.23",408,248,240,8,0,245,3,400,152,58,187,3,13293,0
33,"Salaj",140501,314,140501,,"CHIESD",112,"SCOALA GIMNAZIALA CHIESD, SAT CHIESD , NR.368, CP 457070",0,75,0,75,0,75,0,100,25,39,36,3,13293,1
33,"Salaj",140547,314,140547,,"CIZER",113,"SCOALA GENERALA ""HOREA"" CIZER,  SAT.CIZER, NR.292",1350,670,665,5,0,658,12,1400,730,431,227,3,13297,0
33,"Salaj",140547,314,140547,,"CIZER",114,"SCOALA GENERALA PLESCA, SAT PLESCA, NR.97",162,110,103,6,1,108,2,197,87,81,27,3,13297,0
33,"Salaj",140547,314,140547,,"CIZER",115,"SCOALA GENERALA PRIA, SAT PRIA, NR.118",363,218,210,8,0,217,1,400,182,85,132,3,13297,0
33,"Salaj",140547,314,140547,,"CIZER",116,"SCOALA GENERALA ""HOREA"" CIZER,  SAT.CIZER, NR.292",0,89,0,89,0,88,1,200,111,55,33,3,13297,1
33,"Salaj",140583,314,140583,,"COSEIU",117,"PRIMARIA  COMUNEI COSEIU, COSEIU NR.134",377,220,216,4,0,218,2,400,180,102,116,3,13301,0
33,"Salaj",140583,314,140583,,"COSEIU",118,"SCOALA GIMNAZIALA ARCHID, ARCHID NR. 115",369,216,211,5,0,214,2,400,184,26,188,3,13301,0
33,"Salaj",140583,314,140583,,"COSEIU",119,"SCOALA CU CLASELE I-IV CHILIOARA, NR. 239",264,171,167,4,0,170,1,300,129,43,127,3,13301,0
33,"Salaj",140583,314,140583,,"COSEIU",120,"PRIMARIA COMUNEI COSEIU, SAT COSEIU, NR.134, CP 457080",0,38,0,38,0,38,0,100,62,18,20,3,13301,1
33,"Salaj",140627,314,140627,,"CRASNA",121,"CAMINUL CULTURAL , SAT CRASNA NR.559",2008,1032,930,9,93,1016,16,2200,1168,185,831,3,13305,0
33,"Salaj",140627,314,140627,,"CRASNA",122,"SCOALA  NR.2 , SAT CRASNA NR.955",1596,826,777,6,43,811,15,1800,974,193,618,3,13305,0
33,"Salaj",140627,314,140627,,"CRASNA",123,"CAMINUL CULTURAL, SAT HUSENI NR.178",378,221,212,9,0,216,5,400,179,119,97,3,13305,0
33,"Salaj",140627,314,140627,,"CRASNA",124,"CAMINUL CULTURAL , SAT MARIN NR.191",791,369,362,7,0,358,11,900,531,258,100,3,13305,0
33,"Salaj",140627,314,140627,,"CRASNA",125,"CAMINUL CULTURAL , SAT RATIN NR.47",387,271,262,9,0,257,14,400,129,73,184,3,13305,0
33,"Salaj",140627,314,140627,,"CRASNA",126,"SEDIUL P.A.P.I. DIN CAMINUL CULTURAL, SAT CRASNA, NR.559, CP 457085",0,52,0,52,0,52,0,200,148,22,30,3,13305,1
33,"Salaj",140672,314,140672,,"CREACA",127,"SCOALA GENERALA CREACA, NR.179/C",375,183,177,6,0,182,1,401,218,85,97,3,13310,0
33,"Salaj",140672,314,140672,,"CREACA",128,"SCOALA GENERALA BREBI, NR.187/A",448,257,248,8,1,254,3,500,243,162,92,3,13310,0
33,"Salaj",140672,314,140672,,"CREACA",129,"SCOALA GENERALA JAC, NR.253/B",587,377,367,6,4,375,2,600,223,243,132,3,13310,0
33,"Salaj",140672,314,140672,,"CREACA",130,"SCOALA GENERALA BRUSTURI, NR.31/B",127,98,88,10,0,97,1,100,2,67,30,3,13310,0
33,"Salaj",140672,314,140672,,"CREACA",131,"SCOALA GENERALA LUPOAIA, NR.145/A",220,142,135,7,0,135,7,200,58,84,51,3,13310,0
33,"Salaj",140672,314,140672,,"CREACA",132,"SCOALA GENERALA BORZA, NR.69/A",158,104,97,7,0,101,3,200,96,45,56,3,13310,0
33,"Salaj",140672,314,140672,,"CREACA",133,"SCOALA GENERALA PRODANESTI, NR.90/A",206,129,128,1,0,129,0,200,71,58,71,3,13310,0
33,"Salaj",140672,314,140672,,"CREACA",134,"SCOALA GENERALA CIGLEAN, NR.59/A",142,96,89,7,0,95,1,200,104,68,27,3,13310,0
33,"Salaj",140672,314,140672,,"CREACA",135,"SEDIUL PRIMARIEI CREACA NR.179/B - SALA DE SEDINTA",0,131,0,131,0,130,1,200,69,96,34,3,13310,1
33,"Salaj",140770,314,140770,,"CRISTOLT",136,"CAMINUL CULTURAL, CRISTOLT, SALA MICA, NR.72",574,335,330,5,0,331,4,600,265,158,173,3,13324,0
33,"Salaj",140770,314,140770,,"CRISTOLT",137,"SCOALA CU CLASELE I-IV MUNCEL, NR.20",166,114,105,9,0,112,2,200,86,42,70,3,13324,0
33,"Salaj",140770,314,140770,,"CRISTOLT",138,"SCOALA GIMNAZIALA VALENI, NR.35/A",379,224,214,10,0,223,1,400,176,86,137,3,13324,0
33,"Salaj",140770,314,140770,,"CRISTOLT",139,"SCOALA CU CLASELE I-IV POIANA ONTII, NR.52/A",71,41,34,7,0,41,0,100,59,19,22,3,13324,0
33,"Salaj",140770,314,140770,,"CRISTOLT",140,"SEDIUL PRIMARIEI  CRISTOLT NR.84, SAT. CRISTOLT CP 457100",0,42,0,42,0,42,0,100,58,20,22,3,13324,1
33,"Salaj",140823,314,140823,,"CRISENI",141,"SCOALA GIMNAZIALA  CRISENI, NR.276",1191,867,817,11,39,860,7,1281,414,454,406,3,13320,0
33,"Salaj",140823,314,140823,,"CRISENI",142,"SCOALA PRIMARA GARCEIU, NR. 290",606,334,324,8,2,333,1,690,356,155,178,3,13320,0
33,"Salaj",140823,314,140823,,"CRISENI",143,"SCOALA PRIMARA CRISTUR-CRISENI, NR.191",367,225,194,7,24,221,4,400,175,103,118,3,13320,0
33,"Salaj",140823,314,140823,,"CRISENI",144,"SCOALA GIMNAZIALA CRISENI, SAT CRISENI, NR. 276",0,129,0,129,0,128,1,213,84,75,53,3,13320,1
33,"Salaj",140869,314,140869,,"CUZAPLAC",145,"SCOALA  CU CLASELE I-VIII CUZAPLAC, SAT CUZAPLAC NR.242",498,344,339,5,0,343,1,600,256,112,231,3,13329,0
33,"Salaj",140869,314,140869,,"CUZAPLAC",146,"CAMIN CULTURAL GALASENI, SAT GALASENI NR.50",113,81,70,11,0,80,1,101,20,36,44,3,13329,0
33,"Salaj",140869,314,140869,,"CUZAPLAC",147,"SCOALA CU CLASELE I-IV MIERTA, SAT MIERTA NR.97",127,94,83,11,0,93,1,100,6,27,66,3,13329,0
33,"Salaj",140869,314,140869,,"CUZAPLAC",148,"CAMIN CULTURAL PETRINDU, SAT PETRINDU NR.84",401,291,284,7,0,289,2,400,109,122,167,3,13329,0
33,"Salaj",140869,314,140869,,"CUZAPLAC",149,"CAMIN CULTURAL RUGINOASA, SAT RUGINOASA NR.22",98,50,43,7,0,49,1,100,50,24,25,3,13329,0
33,"Salaj",140869,314,140869,,"CUZAPLAC",150,"SCOALA CU CLASELE I-IV TAMASA, SAT TAMASA  NR.219",289,227,219,8,0,226,1,300,73,40,186,3,13329,0
33,"Salaj",140869,314,140869,,"CUZAPLAC",151,"SCOALA CU CLASELE I-IV TAMASA, SALA TELECENTRU, SAT TAMASA NR.216",0,180,0,180,0,178,2,200,20,81,97,3,13329,1
33,"Salaj",140958,314,140958,,"DOBRIN",152,"CAMINUL CULTURAL, SAT DOBRIN NR.24/A",373,206,187,3,16,205,1,397,191,100,105,3,13338,0
33,"Salaj",140958,314,140958,,"DOBRIN",153,"SCOALA CU CLASELE I-IV DOBA, SAT DOBA NR.27",496,260,222,4,34,256,4,500,240,66,190,3,13338,0
33,"Salaj",140958,314,140958,,"DOBRIN",154,"CAMINUL CULTURAL, SAT NAIMON NR.26",138,72,54,6,12,70,2,200,128,27,43,3,13338,0
33,"Salaj",140958,314,140958,,"DOBRIN",155,"CAMINUL CULTURAL, SAT VERVEGHIU NR.107",361,190,164,6,20,185,5,415,225,64,121,3,13338,0
33,"Salaj",140958,314,140958,,"DOBRIN",156,"CAMINUL CULTURAL DOBA, SAT DOBA, STR.MARE NR.101, CP 457122",0,35,0,35,0,35,0,100,65,12,23,3,13338,1
33,"Salaj",141027,314,141027,,"DRAGU",157,"SEDIUL PRIMARIEI  COMUNEI DRAGU,SAT DRAGU NR.120",493,231,223,8,0,230,1,597,366,48,182,3,13345,0
33,"Salaj",141027,314,141027,,"DRAGU",158,"SCOALA  CU CLASELE I-IV SAT ADALIN, NR.100",147,69,63,6,0,67,2,200,131,38,29,3,13345,0
33,"Salaj",141027,314,141027,,"DRAGU",159,"CAMIN CULTURAL , SAT UGRUTIU  NR.20",34,30,21,9,0,29,1,100,70,23,6,3,13345,0
33,"Salaj",141027,314,141027,,"DRAGU",160,"SCOALA CU CLASELE I-IV VOIVODENI, NR.117",269,139,127,12,0,134,5,300,161,68,66,3,13345,0
33,"Salaj",141027,314,141027,,"DRAGU",161,"SEDIUL PRIMARIEI COMUNEI DRAGU, SAT DRAGU, NR.120",0,121,0,121,0,121,0,200,79,66,55,3,13345,1
33,"Salaj",141081,314,141081,,"FILDU DE JOS",162,"SEDIUL PRIMARIEI COMUNEI FILDU DE JOS, STR. PRINCIPALA NR.30",192,129,120,9,0,129,0,200,71,62,67,3,13351,0
33,"Salaj",141081,314,141081,,"FILDU DE JOS",163,"SCOALA GIMNAZIALA FILDU DE MIJLOC, SAT FILDU DE MIJLOC, NR.31",347,227,218,9,0,227,0,301,74,127,100,3,13351,0
33,"Salaj",141081,314,141081,,"FILDU DE JOS",164,"SCOALA CU CLASELE I-IV FILDU DE SUS, SAT FILDU DE SUS, NR.33",332,250,237,13,0,248,2,383,133,67,181,3,13351,0
33,"Salaj",141081,314,141081,,"FILDU DE JOS",165,"SCOALA CU CLASELE I-IV  TETISU, SAT TETISU, NR.28 B",260,180,172,8,0,173,7,300,120,66,107,3,13351,0
33,"Salaj",141081,314,141081,,"FILDU DE JOS",166,"SCOALA GIMNAZIALA FILDU DE MIJLOC, SAT FILDU DE MIJLOC, NR.31, CP 457136",0,77,0,77,0,77,0,200,123,48,29,3,13351,1
33,"Salaj",141134,314,141134,,"GALGAU",167,"SCOALA GIMNAZIALA  GALGAU, NR.28",576,388,381,7,0,385,3,600,212,207,178,3,13356,0
33,"Salaj",141134,314,141134,,"GALGAU",168,"SCOALA  CU CLASELE I-IV BARSAU MARE, NR.71",206,132,122,9,1,131,1,203,71,57,74,3,13356,0
33,"Salaj",141134,314,141134,,"GALGAU",169,"SCOALA  CU CLASELE I-IV CAPALNA, NR.58",259,172,163,9,0,171,1,300,128,80,91,3,13356,0
33,"Salaj",141134,314,141134,,"GALGAU",170,"SCOALA  CU CLASELE I-IV CHIZENI, NR.13",88,65,58,7,0,64,1,100,35,20,44,3,13356,0
33,"Salaj",141134,314,141134,,"GALGAU",171,"SCOALA CU CLASELE I-IV DOBROCINA, NR.37",140,96,92,4,0,96,0,200,104,31,65,3,13356,0
33,"Salaj",141134,314,141134,,"GALGAU",172,"SCOALA GIMNAZIALA FODORA, NR.32",362,222,218,4,0,221,1,400,178,122,99,3,13356,0
33,"Salaj",141134,314,141134,,"GALGAU",173,"SCOALA CU CLASELE I-IV GLOD, NR.192",382,260,253,5,2,255,5,400,140,149,106,3,13356,0
33,"Salaj",141134,314,141134,,"GALGAU",174,"SCOALA DE ARTE SI MESERII GALGAU, SAT GALGAU, NR.28",0,184,0,184,0,184,0,200,16,105,79,3,13356,1
33,"Salaj",141232,314,141232,,"GARBOU",175,"PRIMARIA COMUNEI GARBOU, LOC. GARBOU, NR.272",557,281,280,1,0,275,6,600,319,128,147,3,13366,0
33,"Salaj",141232,314,141232,,"GARBOU",176,"SCOALA PRIMARA BEZDED, LOC. BEZDED, NR.81",135,78,72,6,0,75,3,100,22,23,52,3,13366,0
33,"Salaj",141232,314,141232,,"GARBOU",177,"SCOALA PRIMARA,  LOC. CALACEA NR.191",263,154,148,6,0,152,2,300,146,48,104,3,13366,0
33,"Salaj",141232,314,141232,,"GARBOU",178,"SCOALA PRIMARA, LOC.CERNUC, NR.114",179,101,97,4,0,101,0,200,99,46,55,3,13366,0
33,"Salaj",141232,314,141232,,"GARBOU",179,"SCOALA PRIMARA, LOC. FABRICA,NR.26",81,49,40,9,0,49,0,100,51,22,27,3,13366,0
33,"Salaj",141232,314,141232,,"GARBOU",180,"SCOALA PRIMARA, LOC. POPTELEAC,NR.60",298,144,140,4,0,142,2,400,256,71,71,3,13366,0
33,"Salaj",141232,314,141232,,"GARBOU",181,"SCOALA PRIMARA, LOC. SOLOMON, NR.166",335,201,197,4,0,197,4,400,199,72,125,3,13366,0
33,"Salaj",141232,314,141232,,"GARBOU",182,"PRIMARIA COMUNEI GARBOU, SAT GARBOU, NR.272, CP 457150",0,95,0,95,0,93,2,100,5,32,61,3,13366,1
33,"Salaj",141312,314,141312,,"HALMASD",183,"CAMINUL CULTURAL HALMASD,NR.328",925,530,520,1,9,523,7,1000,470,309,214,3,13374,0
33,"Salaj",141312,314,141312,,"HALMASD",184,"SCOALA   ALEUS, SAT ALEUS NR.49",280,192,175,7,10,189,3,300,108,67,122,3,13374,0
33,"Salaj",141312,314,141312,,"HALMASD",185,"SCOALA CERISA, SAT  CERISA,NR.93",420,270,264,6,0,267,3,500,230,155,112,3,13374,0
33,"Salaj",141312,314,141312,,"HALMASD",186,"SCOALA VECHE DRIGHIU, SAT  DRIGHIU,NR.59",352,218,205,7,6,217,1,401,183,113,104,3,13374,0
33,"Salaj",141312,314,141312,,"HALMASD",187,"SEDIUL PRIMARIEI COMUNEI , SAT HALMASD, NR.339",0,43,0,43,0,43,0,200,157,24,19,3,13374,1
33,"Salaj",141376,314,141376,,"HERECLEAN",188,"CAMINUL CULTURAL HERECLEAN,  SAT HERECLEAN, NR.99",406,205,199,6,0,204,1,500,295,101,103,3,13380,0
33,"Salaj",141376,314,141376,,"HERECLEAN",189,"CAMINUL CULTURAL BADON, SAT BADON, NR.64/C",524,331,319,12,0,329,2,600,269,209,120,3,13380,0
33,"Salaj",141376,314,141376,,"HERECLEAN",190,"CAMINUL CULTURAL BOCSITA, SAT BOCSITA, NR.64",88,55,42,8,5,55,0,100,45,16,39,3,13380,0
33,"Salaj",141376,314,141376,,"HERECLEAN",191,"PUNCTUL SANITAR DIOSOD, SAT DIOSOD, NR.375",769,340,332,8,0,337,3,899,559,82,255,3,13380,0
33,"Salaj",141376,314,141376,,"HERECLEAN",192,"SCOALA  GIMNAZIALA GURUSLAU, SAT GURUSLAU, NR.49/A",501,209,198,10,1,208,1,600,391,61,147,3,13380,0
33,"Salaj",141376,314,141376,,"HERECLEAN",193,"SCOALA GIMNAZIALA PANIC, SAT PANIC, NR.100/A",777,383,375,8,0,381,2,800,417,156,225,3,13380,0
33,"Salaj",141376,314,141376,,"HERECLEAN",194,"CENTRUL AGRICOL HERECLEAN, SAT HERECLEAN, NR.26, CP 457165",0,67,0,67,0,67,0,200,133,42,25,3,13380,1
33,"Salaj",141447,314,141447,,"HIDA",195,"PRIMARIA  HIDA, NR.1",930,456,454,1,1,448,8,1000,544,274,174,3,13387,0
33,"Salaj",141447,314,141447,,"HIDA",196,"CAMIN CULTURAL , SAT BAICA, NR.58",126,80,72,8,0,80,0,100,20,37,43,3,13387,0
33,"Salaj",141447,314,141447,,"HIDA",197,"SCOALA GENERALA , SAT RACAS, NR.171",433,204,197,7,0,203,1,500,296,101,102,3,13387,0
33,"Salaj",141447,314,141447,,"HIDA",198,"SCOALA GENERALA , SAT TRESTIA, NR.63",284,165,157,8,0,162,3,300,135,74,88,3,13387,0
33,"Salaj",141447,314,141447,,"HIDA",199,"CAMIN CULTURAL, SAT MILUANI, NR.57",40,32,23,9,0,32,0,100,68,20,12,3,13387,0
33,"Salaj",141447,314,141447,,"HIDA",200,"SCOALA GENERALA, SAT SINPETRU ALMASULUI, NR.146",414,183,175,8,0,180,3,500,317,86,94,3,13387,0
33,"Salaj",141447,314,141447,,"HIDA",201,"SCOALA GENERALA, SAT STUPINI, NR.89",131,79,68,10,1,78,1,100,21,33,45,3,13387,0
33,"Salaj",141447,314,141447,,"HIDA",202,"SCOALA GENERALA , SAT PADURIS, NR.34",34,27,18,9,0,27,0,100,73,12,15,3,13387,0
33,"Salaj",141447,314,141447,,"HIDA",203,"PRIMARIA COMUNEI HIDA, SAT HIDA, STR. SFATULUI NR.1, CP 457175",0,107,0,107,0,106,1,150,43,51,55,3,13387,1
33,"Salaj",141535,314,141535,,"HOROATU CRASNEI",204,"CAMIN CULTURAL HOROATU CRASNEI ,NR.276, SALA MICA",810,377,372,5,0,373,4,900,523,181,192,3,13396,0
33,"Salaj",141535,314,141535,,"HOROATU CRASNEI",205,"SCOALA  HUREZ, NR.143",326,165,158,7,0,163,2,400,235,102,61,3,13396,0
33,"Salaj",141535,314,141535,,"HOROATU CRASNEI",206,"CAMINUL CULTURAL STARCIU,NR.401, SALA MICA",795,414,393,3,18,408,6,900,486,263,145,3,13396,0
33,"Salaj",141535,314,141535,,"HOROATU CRASNEI",207,"SCOALA SEREDEIU,NR.188",250,141,136,5,0,139,2,300,159,83,56,3,13396,0
33,"Salaj",141535,314,141535,,"HOROATU CRASNEI",208,"CAMINUL CULTURAL STARCIU, SALA MARE, SAT STARCIU NR.401, CP 457187",0,120,0,120,0,120,0,200,80,74,46,3,13396,1
33,"Salaj",141580,314,141580,,"ILEANDA",209,"CAMINUL CULTURAL ILEANDA, SAT ILEANDA, STR 1 DECEMBRIE 1918, NR.23, BIROU BIBLIOTECAR",1041,590,586,4,0,579,11,1088,498,263,316,3,13401,0
33,"Salaj",141580,314,141580,,"ILEANDA",210,"SCOALA GENERALA CU CLASELE I-IV, SAT DABACENI, STR. PRINCIPALA , NR.31 - SALA DE CLASA",148,106,101,5,0,106,0,205,99,52,54,3,13401,0
33,"Salaj",141580,314,141580,,"ILEANDA",211,"SCOALA GENERALA CU CLASELE I-IV, SAT DOLHENI, STR. PRINCIPALA, NR.43 - SALA DE CLASA",92,61,56,5,0,61,0,100,39,28,33,3,13401,0
33,"Salaj",141580,314,141580,,"ILEANDA",212,"SCOALA GENERALA CU CLASELE I-IV, SAT LUMINISU, STR. PRINCIPALA,NR.15 - SALA DE CLASA",91,65,54,6,5,65,0,100,35,35,30,3,13401,0
33,"Salaj",141580,314,141580,,"ILEANDA",213,"SCOALA GENERALA CU CLASELE I-IV, SAT NEGRENI, STR. PRINCIPALA, NR.18 - SALA DE CLASA",98,70,62,6,2,70,0,100,30,40,30,3,13401,0
33,"Salaj",141580,314,141580,,"ILEANDA",214,"SCOALA GENERALA CU CLASELE I-IV, SAT PERII VADULUI, STR. PRINCIPALA, NR.15 - SALA DE CLASA",114,74,67,7,0,74,0,100,26,45,29,3,13401,0
33,"Salaj",141580,314,141580,,"ILEANDA",215,"SCOALA GENERALA CU CLASELE I-IV, SAT PODISU, STR. PRINCIPALA,NR.77 - SALA DE CLASA",120,94,87,7,0,93,1,104,10,45,48,3,13401,0
33,"Salaj",141580,314,141580,,"ILEANDA",216,"SCOALA GENERALA CU CLASELE I-IV, SAT RASTOCI, STR. PRINCIPALA, NR.45 - SALA DE CLASA",138,100,93,5,2,97,3,200,100,39,58,3,13401,0
33,"Salaj",141580,314,141580,,"ILEANDA",217,"SCOALA GENERALA CU CLASELE I-IV,SAT  ROGNA, STR. PRINCIPALA, NR.3 - SALA DE CLASA",85,55,49,6,0,54,1,100,45,26,28,3,13401,0
33,"Salaj",141580,314,141580,,"ILEANDA",218,"SCOALA GENERALA CU CLASELE I-IV, SAT SASA, STR. PRINCIPALA, NR.3 - SALA DE CLASA",64,54,44,10,0,54,0,106,52,21,33,3,13401,0
33,"Salaj",141580,314,141580,,"ILEANDA",219,"CAMINUL CULTURAL ILEANDA, SAT. ILEANDA, STR. 1 DECEMBRIE 1918  NR.23, SALA MARE A CAMINULUI CULTURAL",0,142,0,142,0,139,3,200,58,73,66,3,13401,1
33,"Salaj",141722,314,141722,,"IP",220,"CERCUL GOSPODARILOR, SAT IP, NR.227",1484,598,593,5,0,591,7,1600,1002,360,231,3,13415,0
33,"Salaj",141722,314,141722,,"IP",221,"GRADINITA DE COPII , SAT ZAUAN, NR.330",823,383,375,8,0,375,8,900,517,194,181,3,13415,0
33,"Salaj",141722,314,141722,,"IP",222,"SCOALA GIMNAZIALA, SAT  COSNICIU DE JOS,NR.214",547,354,337,8,9,346,8,600,246,221,125,3,13415,0
33,"Salaj",141722,314,141722,,"IP",223,"SCOALA GIMNAZIALA, SAT COSNICIU DE SUS, NR.46",299,183,168,8,7,179,4,300,117,122,57,3,13415,0
33,"Salaj",141722,314,141722,,"IP",224,"SEDIUL PRIMARIEI, SAT IP, NR.93, CP 457210",0,46,0,46,0,46,0,100,54,25,21,3,13415,1
33,"Salaj",141786,314,141786,,"LETCA",225,"PRIMARIA  LETCA, SAT LETCA NR.272",478,312,309,3,0,310,2,496,184,159,151,3,13421,0
33,"Salaj",141786,314,141786,,"LETCA",226,"SCOALA GENERALA, SAT CUCIULAT, NR.45",177,111,105,6,0,109,2,200,89,35,74,3,13421,0
33,"Salaj",141786,314,141786,,"LETCA",227,"SCOALA GENERALA, SAT LEMNIU, NR.71",367,234,228,6,0,232,2,395,161,94,138,3,13421,0
33,"Salaj",141786,314,141786,,"LETCA",228,"FOSTA SCOALA GENERALA, SAT PURCARET, NR. 34",113,77,73,4,0,77,0,100,23,58,19,3,13421,0
33,"Salaj",141786,314,141786,,"LETCA",229,"FOSTA SCOALA GENERALA, SAT TOPLITA, NR.10",120,93,88,5,0,93,0,100,7,31,62,3,13421,0
33,"Salaj",141786,314,141786,,"LETCA",230,"SCOALA GENERALA, SAT  COZLA, NR.36",237,146,141,4,1,144,2,300,154,78,66,3,13421,0
33,"Salaj",141786,314,141786,,"LETCA",231,"CLADIREA FOSTULUI CONSILIU, SAT  CIULA, NR.90",104,71,64,7,0,69,2,100,29,39,30,3,13421,0
33,"Salaj",141786,314,141786,,"LETCA",232,"SCOALA GENERALA, SAT SOIMUSENI, NR.45",75,64,57,7,0,64,0,100,36,42,22,3,13421,0
33,"Salaj",141786,314,141786,,"LETCA",233,"FOSTA SCOALA GENERALA, SAT VALISOARA, NR.13",38,28,18,10,0,28,0,100,72,21,7,3,13421,0
33,"Salaj",141786,314,141786,,"LETCA",234,"GARA C.F.R. (GARA VECHE), SAT LETCA NR.278",0,100,0,100,0,100,0,151,51,52,48,3,13421,1
33,"Salaj",141884,314,141884,,"LOZNA",235,"PRIMARIA  COMUNEI LOZNA, LOZNA, NR.108",525,322,322,0,0,321,1,600,278,150,171,3,13431,0
33,"Salaj",141884,314,141884,,"LOZNA",236,"SCOALA CU CLASELE  I-IV, CORMENIS,NR.129",157,116,109,7,0,115,1,200,84,60,55,3,13431,0
33,"Salaj",141884,314,141884,,"LOZNA",237,"SCOALA CU CLASELE I-IV ,VALEA LOZNEI, NR.35",187,119,110,9,0,117,2,200,81,70,47,3,13431,0
33,"Salaj",141884,314,141884,,"LOZNA",238,"CAMINUL CULTURAL LOZNA, SAT LOZNA  NR.108",0,97,0,97,0,97,0,200,103,45,52,3,13431,1
33,"Salaj",141946,314,141946,,"MARCA",239,"CAMINUL CULTURAL  MARCA, NR.138/B",1156,629,628,1,0,618,11,1200,571,472,146,3,13444,0
33,"Salaj",141946,314,141946,,"MARCA",240,"SCOALA CU CLASELE I-IV PORT, NR.27",245,173,167,6,0,171,2,300,127,131,40,3,13444,0
33,"Salaj",141946,314,141946,,"MARCA",241,"CAMINUL CULTURAL VECHI LESMIR, NR.111",355,164,158,6,0,160,4,392,228,125,35,3,13444,0
33,"Salaj",141946,314,141946,,"MARCA",242,"CAMINUL CULTURAL SUMAL, NR.237",462,264,259,5,0,263,1,500,236,220,43,3,13444,0
33,"Salaj",141946,314,141946,,"MARCA",243,"SEDIUL VECHI AL PRIMARIEI COMUNEI MARCA, SAT MARCA, NR.138, CP 457230",0,49,0,49,0,48,1,199,150,37,11,3,13444,1
33,"Salaj",142006,314,142006,,"MAERISTE",244,"SCOALA GIMNAZIALA MAERISTE, NR 198/A",667,390,385,5,0,387,3,682,292,190,197,3,13437,0
33,"Salaj",142006,314,142006,,"MAERISTE",245,"SCOALA GENERALA CRISTELEC, NR.116/A",467,281,276,5,0,280,1,518,237,171,109,3,13437,0
33,"Salaj",142006,314,142006,,"MAERISTE",246,"SCOALA  DOH, NR.56/A",206,121,115,6,0,119,2,300,179,50,69,3,13437,0
33,"Salaj",142006,314,142006,,"MAERISTE",247,"SCOALA GIMNAZIALA GIURTELECU SIMLEULUI, NR.338/A",800,477,472,5,0,467,10,882,405,298,169,3,13437,0
33,"Salaj",142006,314,142006,,"MAERISTE",248,"SCOALA GENERALA MALADIA, NR.119/A",180,87,83,4,0,86,1,200,113,59,27,3,13437,0
33,"Salaj",142006,314,142006,,"MAERISTE",249,"SCOALA GENERALA  UILEACU SIMLEULUI, NR.53/A",396,177,175,2,0,175,2,507,330,82,93,3,13437,0
33,"Salaj",142006,314,142006,,"MAERISTE",250,"SCOALA GIMNAZIALA MAERISTE, SAT MAERISTE, STR.SCOLII NR.189",0,95,0,95,0,95,0,202,107,42,53,3,13437,1
33,"Salaj",142079,314,142079,,"MESESENII DE JOS",251,"PRIMARIA COMUNEI MESESENII DE JOS,NR.41",545,416,388,7,21,411,5,600,184,53,358,3,13450,0
33,"Salaj",142079,314,142079,,"MESESENII DE JOS",252,"GRADINITA AGHIRES, AGHIRES NR.57",1138,623,596,6,21,620,3,1300,677,327,293,3,13450,0
33,"Salaj",142079,314,142079,,"MESESENII DE JOS",253,"SCOALA  FETINDIA, FETINDIA NR.47",147,107,101,6,0,106,1,200,93,42,64,3,13450,0
33,"Salaj",142079,314,142079,,"MESESENII DE JOS",254,"SCOALA  MESESENII DE SUS, MESESENII DE SUS,NR.211",683,412,390,11,11,409,3,800,388,218,191,3,13450,0
33,"Salaj",142079,314,142079,,"MESESENII DE JOS",255,"PRIMARIA  MESESENII DE JOS, SAT MESESENII DE JOS, NR.41, CP 457245",0,82,0,82,0,81,1,200,118,27,54,3,13450,1
33,"Salaj",142122,314,142122,,"MIRSID",256,"SALA DE SEDINTA A PRIMARIEI MIRSID, NR.90",520,348,337,7,4,344,4,595,247,100,244,3,13455,0
33,"Salaj",142122,314,142122,,"MIRSID",257,"SCOALA CU CLASELE I-IV FIRMINIS, NR.46",148,91,83,8,0,91,0,201,110,33,58,3,13455,0
33,"Salaj",142122,314,142122,,"MIRSID",258,"SCOALA CU CLASELE I-IV MOIGRAD-POROLISSUM, NR.98",439,246,241,5,0,244,2,498,252,105,139,3,13455,0
33,"Salaj",142122,314,142122,,"MIRSID",259,"SCOALA CU CLASELE I-IV POPENI, NR.224",714,461,447,7,7,457,4,800,339,166,291,3,13455,0
33,"Salaj",142122,314,142122,,"MIRSID",260,"BIBLIOTECA COMUNALA, SAT MIRSID, STR. PRINCIPALA, NR.90",0,83,0,83,0,83,0,126,43,24,59,3,13455,1
33,"Salaj",142177,314,142177,,"NAPRADEA",261,"SEDIUL PRIMARIEI NAPRADEA, NR.23",680,409,391,3,15,404,5,804,395,132,272,3,13460,0
33,"Salaj",142177,314,142177,,"NAPRADEA",262,"SCOALA GIMNAZIALA ""PETRE HOSSU"", NR.41, CHEUD",663,401,391,3,7,397,4,700,299,177,220,3,13460,0
33,"Salaj",142177,314,142177,,"NAPRADEA",263,"SCOALA CU CLASELE I-IV TRANIS, NR.130",293,179,172,7,0,178,1,400,221,88,90,3,13460,0
33,"Salaj",142177,314,142177,,"NAPRADEA",264,"SCOALA CU CLASELE I-IV  SOMES-GURUSLAU, NR.229",383,193,191,0,2,193,0,305,112,100,93,3,13460,0
33,"Salaj",142177,314,142177,,"NAPRADEA",265,"SCOALA CU CLASELE I-IV  VADURELE, NR. 9",194,144,141,3,0,144,0,196,52,58,86,3,13460,0
33,"Salaj",142177,314,142177,,"NAPRADEA",266,"SEDIUL PRIMARIEI  NAPRADEA, SAT NAPRADEA, STR. PRINCIPALA, NR.23, CP 457255",0,85,0,85,0,85,0,204,119,27,58,3,13460,1
33,"Salaj",142239,314,142239,,"NUSFALAU",267,"SALA DE SEDINTE A PRIMARIEI, SAT NUSFALAU, STR.ARANY JANOS, NR.1",1392,695,687,3,5,692,3,1500,805,253,439,3,13466,0
33,"Salaj",142239,314,142239,,"NUSFALAU",268,"CAMINUL CULTURAL, SAT NUSFALAU,STR.BANFFY, NR.7",1229,646,643,2,1,633,13,1400,754,249,384,3,13466,0
33,"Salaj",142239,314,142239,,"NUSFALAU",269,"CAMINUL CULTURAL SAT BILGHEZ, NR.82",361,162,154,8,0,161,1,400,238,55,106,3,13466,0
33,"Salaj",142239,314,142239,,"NUSFALAU",270,"BIROUL DE CONSULTANTA, SITUAT IN CLADIREA DIN CURTEA PRIMARIEI, SAT NUSFALAU, STR. ARANY JANOS NR.1, CP 457260",0,52,0,52,0,52,0,200,148,25,27,3,13466,1
33,"Salaj",142284,314,142284,,"PERICEI",271,"PRIMARIA COMUNEI PERICEI, SAT PERICEI NR.239",2327,1009,1001,5,3,994,15,2496,1487,398,596,3,13469,0
33,"Salaj",142284,314,142284,,"PERICEI",272,"SCOALA  GIMNAZIALA, SAT BADACIN, NR.20",561,306,300,6,0,298,8,600,294,219,79,3,13469,0
33,"Salaj",142284,314,142284,,"PERICEI",273,"SCOALA  GIMNAZIALA, SAT SICI NR. 80",194,115,103,12,0,114,1,300,185,68,46,3,13469,0
33,"Salaj",142284,314,142284,,"PERICEI",274,"CAMINUL CULTURAL PERICEI, SAT PERICEI, STR. APEI  NR.239",0,37,0,37,0,37,0,100,63,22,15,3,13469,1
33,"Salaj",142337,314,142337,,"PLOPIS",275,"SCOALA  GIMNAZIALA CU CLS. I-VIII  PLOPIS, NR.132, IN CLADIREA ATELIERULUI SCOLAR",840,507,460,7,40,500,7,900,393,372,128,3,13474,0
33,"Salaj",142337,314,142337,,"PLOPIS",276,"SCOALA GIMNAZIALA CU CLASELE I-VIII  IAZ, NR.144",624,322,298,7,17,321,1,700,378,263,58,3,13474,0
33,"Salaj",142337,314,142337,,"PLOPIS",277,"SCOALA GIMNAZIALA CU CLASELE I-VIII  FAGETU, NR.61",529,281,264,8,9,280,1,600,319,237,43,3,13474,0
33,"Salaj",142337,314,142337,,"PLOPIS",278,"GRADINITA CU PROGRAM NORMAL NR.1, SAT PLOPIS, NR.128",0,68,0,68,0,67,1,200,132,44,23,3,13474,1
33,"Salaj",142373,314,142373,,"POIANA BLENCHII",279,"SCOALA GIMNAZIALA ,POIANA BLENCHII, SAT POIANA BLENCHII NR.106",664,450,424,5,21,446,4,700,250,159,287,3,13478,0
33,"Salaj",142373,314,142373,,"POIANA BLENCHII",280,"SCOALA CU CLASELE I-IV GOSTILA, NR.175",370,262,248,8,6,262,0,400,138,103,159,3,13478,0
33,"Salaj",142373,314,142373,,"POIANA BLENCHII",281,"SCOALA GIMNAZIALA  POIANA BLENCHII, SAT  POIANA BLENCHII, NR.160",0,55,0,55,0,55,0,100,45,29,26,3,13478,1
33,"Salaj",142426,314,142426,,"ROMANASI",282,"SCOALA GENERALA CU CLASELE I-VIII ROMANASI,NR.49",732,400,392,8,0,394,6,800,400,282,112,3,13483,0
33,"Salaj",142426,314,142426,,"ROMANASI",283,"SCOALA PRIMARA CHICHISA,NR.60/A",191,107,101,6,0,106,1,300,193,50,56,3,13483,0
33,"Salaj",142426,314,142426,,"ROMANASI",284,"SCOALA PRIMARA CIUMARNA,NR.38",371,224,219,5,0,224,0,499,275,127,97,3,13483,0
33,"Salaj",142426,314,142426,,"ROMANASI",285,"SCOALA PRIMARA PAUSA,NR.105",372,255,244,6,5,252,3,400,145,133,119,3,13483,0
33,"Salaj",142426,314,142426,,"ROMANASI",286,"SCOALA PRIMARA POARTA SALAJULUI,NR.112",343,204,199,5,0,203,1,400,196,136,67,3,13483,0
33,"Salaj",142426,314,142426,,"ROMANASI",287,"SCOALA PRIMARA ROMITA,NR.31",223,124,116,8,0,123,1,300,176,70,53,3,13483,0
33,"Salaj",142426,314,142426,,"ROMANASI",288,"SEDIUL FOSTEI PRIMARII (BIBLIOTECA COMUNALA), SAT ROMANASI, NR.39",0,134,0,134,0,134,0,200,66,74,60,3,13483,1
33,"Salaj",142499,314,142499,,"RUS",289,"SCOALA GENERALA  RUS, SAT RUS, NR. 333, SALA CLASELE A II-A SI A IV-A",623,386,380,6,0,382,4,700,314,159,223,3,13490,0
33,"Salaj",142499,314,142499,,"RUS",290,"SCOALA CU CLASELE I-IV FANTANELE RUS, SAT FANTANELE RUS, NR.29",174,127,120,7,0,121,6,199,72,62,59,3,13490,0
33,"Salaj",142499,314,142499,,"RUS",291,"SCOALA CU CLASELE I-IV BUZAS,  SAT BUZAS, NR.69",124,91,85,6,0,89,2,200,109,42,47,3,13490,0
33,"Salaj",142499,314,142499,,"RUS",292,"SCOALA GENERALA RUS, SAT RUS, NR.333, CABINETUL DE MATEMATICA",0,88,0,88,0,87,1,100,12,41,46,3,13490,1
33,"Salaj",142550,314,142550,,"SALATIG",293,"SCOALA GIMNAZIALA ""PETRE DULFU"" SALATIG, NR.57",401,217,214,3,0,216,1,500,283,130,86,3,13500,0
33,"Salaj",142550,314,142550,,"SALATIG",294,"SCOALA GIMNAZIALA  DEJA, NR.138",1000,530,519,9,2,520,10,1100,570,110,410,3,13500,0
33,"Salaj",142550,314,142550,,"SALATIG",295,"SCOALA CU CLASELE I-IV NOTIG, NR.240",441,391,369,4,18,386,5,500,109,260,126,3,13500,0
33,"Salaj",142550,314,142550,,"SALATIG",296,"SCOALA CU CLASELE I-IV MINEU, NR.107",295,119,114,5,0,116,3,400,281,55,61,3,13500,0
33,"Salaj",142550,314,142550,,"SALATIG",297,"SCOALA CU CLASELE I-IV BULGARI, NR.102",204,139,131,8,0,136,3,200,61,80,56,3,13500,0
33,"Salaj",142550,314,142550,,"SALATIG",298,"SEDIUL PRIMARIEI  COMUNEI SALATIG, SAT SALATIG NR.121",0,61,0,61,0,60,1,100,39,35,25,3,13500,1
33,"Salaj",142612,314,142612,,"SAG",299,"CAMINUL CULTURAL SAG ,NR.8",595,272,269,3,0,269,3,700,428,177,92,3,13494,0
33,"Salaj",142612,314,142612,,"SAG",300,"CAMINUL CULTURAL FIZES, NR.136",325,156,149,7,0,152,4,400,244,79,73,3,13494,0
33,"Salaj",142612,314,142612,,"SAG",301,"SCOALA CU CLS. I-IV SARBI, NR.24",252,100,96,4,0,100,0,300,200,66,34,3,13494,0
33,"Salaj",142612,314,142612,,"SAG",302,"CAMINUL CULTURAL MAL, NR.93",861,447,438,9,0,439,8,1000,553,346,93,3,13494,0
33,"Salaj",142612,314,142612,,"SAG",303,"CENTRUL DE AGREMENT IZVOARELE BARCAULUI TUSA,NR.120",645,344,337,7,0,341,3,700,356,242,99,3,13494,0
33,"Salaj",142612,314,142612,,"SAG",304,"GRUP SCOLAR SAG, SAT SAG, NR. 160",0,63,0,63,0,62,1,200,137,44,18,3,13494,1
33,"Salaj",142676,314,142676,,"SANMIHAIU ALMASULUI",305,"PRIMARIA SANMIHAIU ALMASULUI, NR.93 - SALA DE SEDINTA",905,464,463,1,0,457,7,1000,536,195,262,3,13509,0
33,"Salaj",142676,314,142676,,"SANMIHAIU ALMASULUI",306,"SCOALA  CU CLASELE I-IV  BERCEA, NR.32",143,88,81,7,0,87,1,200,112,32,55,3,13509,0
33,"Salaj",142676,314,142676,,"SANMIHAIU ALMASULUI",307,"SCOALA  CU CLASELE I-IV SINTA MARIA,NR.73",323,200,193,7,0,199,1,400,200,136,63,3,13509,0
33,"Salaj",142676,314,142676,,"SANMIHAIU ALMASULUI",308,"PRIMARIA  SANMIHAIU ALMASULUI,  NR.93 , BIROU- REGISTRU AGRICOL",0,82,0,82,0,81,1,200,118,50,31,3,13509,1
33,"Salaj",142710,314,142710,,"SOMES-ODORHEI",309,"CAMINUL CULTURAL, SAT SOMES-ODORHEI, NR.104",1069,593,571,8,14,587,6,1196,603,267,320,3,13523,0
33,"Salaj",142710,314,142710,,"SOMES-ODORHEI",310,"SCOALA PRIMARA, SAT BARSA, NR.54",114,58,50,8,0,58,0,200,142,17,41,3,13523,0
33,"Salaj",142710,314,142710,,"SOMES-ODORHEI",311,"SCOALA PRIMARA, SAT DOMNIN,NR.52",284,186,162,12,12,185,1,402,216,58,127,3,13523,0
33,"Salaj",142710,314,142710,,"SOMES-ODORHEI",312,"CAMINUL CULTURAL, SAT INAU, NR.40",513,452,425,13,14,448,4,588,136,151,297,3,13523,0
33,"Salaj",142710,314,142710,,"SOMES-ODORHEI",313,"CAMINUL CULTURAL, SAT SOIMUS, NR.31",258,144,111,7,26,141,3,300,156,58,83,3,13523,0
33,"Salaj",142710,314,142710,,"SOMES-ODORHEI",314,"CONSILIUL LOCAL SOMES-ODORHEI, SALA DE SEDINTE, SAT SOMES-ODORHEI, NR.234",0,140,0,140,0,139,1,187,47,68,71,3,13523,1
33,"Salaj",142774,314,142774,,"SURDUC",315,"CAMINUL CULTURAL, SAT SURDUC, NR.118",1058,557,545,5,7,551,6,1196,639,186,365,3,13529,0
33,"Salaj",142774,314,142774,,"SURDUC",316,"CAMINUL CULTURAL, SAT TIHAU, NR.58",897,589,579,10,0,568,21,998,409,304,264,3,13529,0
33,"Salaj",142774,314,142774,,"SURDUC",317,"CAMINUL CULTURAL, SAT BRIGLEZ, NR.115",258,191,172,7,12,184,7,303,112,72,112,3,13529,0
33,"Salaj",142774,314,142774,,"SURDUC",318,"CAMINUL CULTURAL, SAT CRISTOLTEL, NR.55",394,233,228,5,0,230,3,500,267,111,119,3,13529,0
33,"Salaj",142774,314,142774,,"SURDUC",319,"CAMINUL CULTURAL, SAT SOLONA, NR.89/A",309,199,193,6,0,196,3,400,201,57,139,3,13529,0
33,"Salaj",142774,314,142774,,"SURDUC",320,"SCOALA GENERALA, SAT TURBUTA, NR.40",273,115,107,8,0,113,2,300,185,49,64,3,13529,0
33,"Salaj",142774,314,142774,,"SURDUC",321,"STATIA CFR SURDUC, SAT SURDUC, NR. 412",0,128,0,128,0,126,2,201,73,68,58,3,13529,1
33,"Salaj",142854,314,142854,,"SAMSUD",322,"SEDIUL PRIMARIEI  SAMSUD, STR. PRINCIPALA, NR.38, LA PARTER",911,458,453,5,0,444,14,1096,638,60,384,3,13506,0
33,"Salaj",142854,314,142854,,"SAMSUD",323,"INCINTA CAMINULUI CULTURAL, SAT VALEA POMILOR",418,231,226,5,0,229,2,500,269,72,157,3,13506,0
33,"Salaj",142854,314,142854,,"SAMSUD",324,"PARTERUL PRIMARIEI SAMSUD, SAT SAMSUD, STR. PRINCIPALA NR. 38",0,31,0,31,0,31,0,102,71,14,17,3,13506,1
33,"Salaj",142881,314,142881,,"SARMASAG",325,"CASA SATULUI, SARMASAG, STR. TEILOR, NR.71/A",930,486,454,2,30,486,0,1000,514,84,402,3,13513,0
33,"Salaj",142881,314,142881,,"SARMASAG",326,"GRUPUL SCOLAR INDUSTRIAL SARMASAG, STR.PRIMAVERII, NR.15-SCOALA VECHE",799,420,407,4,9,416,4,800,380,93,323,3,13513,0
33,"Salaj",142881,314,142881,,"SARMASAG",327,"GRADINITA DE COPII NR.3 SARMASAG, STR.GAROAFELOR, NR.3",895,415,397,6,12,410,5,900,485,69,341,3,13513,0
33,"Salaj",142881,314,142881,,"SARMASAG",328,"SCOALA GENERALA NR.2 SARMASAG, STR.MINERILOR, NR.9/A",1231,564,548,9,7,563,1,1400,836,232,331,3,13513,0
33,"Salaj",142881,314,142881,,"SARMASAG",329,"SCOALA GENERALA ILISUA, SAT ILISUA NR.54",595,325,319,6,0,321,4,700,375,97,224,3,13513,0
33,"Salaj",142881,314,142881,,"SARMASAG",330,"SCOALA GENERALA LOMPIRT, SAT LOMPIRT NR.49",667,282,275,4,3,275,7,700,418,95,180,3,13513,0
33,"Salaj",142881,314,142881,,"SARMASAG",331,"SEDIU SC HERANT CONSTRUCTOR SRL, SAT MOIAD, NR.70",168,105,100,5,0,105,0,200,95,32,73,3,13513,0
33,"Salaj",142881,314,142881,,"SARMASAG",332,"SEDIUL PRIMARIEI COMUNEI SARMASAG, SAT  SARMASAG, STR. TEILOR NR.34, CP 457330",0,39,0,39,0,39,0,200,161,20,19,3,13513,1
33,"Salaj",179695,314,179695,,"SIMISNA",333,"SCOALA GIMNAZIALA SIMISNA, SAT SIMISNA NR.67",746,414,413,1,0,409,5,768,354,129,280,3,13520,0
33,"Salaj",179695,314,179695,,"SIMISNA",334,"SCOALA CU CLASELE I-IV HASMAS, SAT HASMAS, NR.52",299,187,181,6,0,178,9,400,213,70,108,3,13520,0
33,"Salaj",179695,314,179695,,"SIMISNA",335,"SCOALA GIMNAZIALA CU CLASELE I-VIII SIMISNA, SAT.SIMISNA NR.67",0,61,0,61,0,61,0,100,39,25,36,3,13520,1
33,"Salaj",179631,314,179631,,"TREZNEA",336,"SCOALA GENERALA,  SAT TREZNEA, NR.81",584,383,379,4,0,373,10,700,317,215,158,3,13537,0
33,"Salaj",179631,314,179631,,"TREZNEA",337,"SCOALA CU CLASELE I-IV , SAT BOZNA, NR.92",219,160,152,8,0,158,2,300,140,89,69,3,13537,0
33,"Salaj",179631,314,179631,,"TREZNEA",338,"SCOALA GENERALA TREZNEA, SAT. TREZNEA, NR.81",0,85,0,85,0,84,1,200,115,27,57,3,13537,1
33,"Salaj",142952,314,142952,,"VALCAU DE JOS",339,"CAMIN CULTURAL VALCAU DE JOS,  NR. 259",753,412,404,1,7,412,0,796,384,272,140,3,13540,0
33,"Salaj",142952,314,142952,,"VALCAU DE JOS",340,"SCOALA GIMNAZIALA  VALCAU DE SUS, NR. 192",656,461,445,5,11,455,6,700,239,263,192,3,13540,0
33,"Salaj",142952,314,142952,,"VALCAU DE JOS",341,"SCOALA GIMNAZIALA PREOTEASA, NR.66",522,357,338,6,13,353,4,600,243,247,106,3,13540,0
33,"Salaj",142952,314,142952,,"VALCAU DE JOS",342,"SCOALA PRIMARA  LAZURI, NR.41",240,164,159,5,0,162,2,300,136,92,70,3,13540,0
33,"Salaj",142952,314,142952,,"VALCAU DE JOS",343,"SCOALA PRIMARA SUB CETATE, NR.131",311,216,201,8,7,216,0,400,184,129,87,3,13540,0
33,"Salaj",142952,314,142952,,"VALCAU DE JOS",344,"SEDIUL VECHI AL PRIMARIEI VALCAU DE JOS, SALA DE SEDINTE, SAT VALCAU DE JOS, NR.228",0,50,0,50,0,50,0,200,150,33,17,3,13540,1
33,"Salaj",143021,314,143021,,"VARSOLT",345,"SEDIUL PRIMARIEI VARSOLT, NR.168",1429,572,569,3,0,567,5,1600,1028,225,342,3,13547,0
33,"Salaj",143021,314,143021,,"VARSOLT",346,"SCOALA  CU CLASELE I-IV, RECEA NR.224",564,317,310,7,0,309,8,600,283,193,116,3,13547,0
33,"Salaj",143021,314,143021,,"VARSOLT",347,"SEDIUL PRIMARIEI COMUNEI VARSOLT, SAT VARSOLT, NR.168",0,55,0,55,0,55,0,200,145,32,23,3,13547,1
33,"Salaj",143067,314,143067,,"ZALHA",348,"PRIMARIA  ZALHA, NR.94 - SALA DE SEDINTE",286,156,156,0,0,154,2,300,144,48,106,3,13551,0
33,"Salaj",143067,314,143067,,"ZALHA",349,"SCOALA  CEACA, NR. 83",220,159,157,0,2,158,1,300,141,74,84,3,13551,0
33,"Salaj",143067,314,143067,,"ZALHA",350,"SCOALA  VALEA HRANEI, NR. 68",89,62,58,4,0,58,4,100,38,33,25,3,13551,0
33,"Salaj",143067,314,143067,,"ZALHA",351,"SCOALA  CIURENI, NR.49",117,92,86,6,0,92,0,200,108,54,38,3,13551,0
33,"Salaj",143067,314,143067,,"ZALHA",352,"SCOALA  VALEA LUNGA, NR.20",132,74,71,3,0,73,1,200,126,39,34,3,13551,0
33,"Salaj",143067,314,143067,,"ZALHA",353,"CAMINUL CULTURAL ZALHA, SAT ZALHA,   NR.94",0,53,0,53,0,53,0,200,147,24,29,3,13551,1
33,"Salaj",143147,314,143147,,"ZIMBOR",354,"SALA DE SPORT   ZIMBOR, NR.33",574,355,347,1,7,348,7,698,343,190,158,3,13559,0
33,"Salaj",143147,314,143147,,"ZIMBOR",355,"CAMINUL CULTURAL DOLU, NR.86",62,56,45,11,0,56,0,100,44,44,12,3,13559,0
33,"Salaj",143147,314,143147,,"ZIMBOR",356,"SCOALA PRIMARA SINCRAIU ALMASULUI, NR.59",176,111,104,7,0,111,0,200,89,73,38,3,13559,0
33,"Salaj",143147,314,143147,,"ZIMBOR",357,"CAMINUL CULTURAL SUTORU, NR.50",113,89,84,5,0,87,2,200,111,42,45,3,13559,0
33,"Salaj",143147,314,143147,,"ZIMBOR",358,"SCOALA GIMNAZIALA ZIMBOR, SALA DE SPORT, SAT ZIMBOR, NR.33, CP 457370",0,108,0,108,0,108,0,200,92,70,38,3,13559,1
34,"Sibiu",143450,323,143450,,"MUNICIPIUL SIBIU",1,"Liceul Waldorf, P-ta Iancu de Hunedoara (fosta P-ta 8 Martie) nr.3-5",1469,715,701,14,0,706,9,1600,885,474,232,1,13566,0
34,"Sibiu",143450,323,143450,,"MUNICIPIUL SIBIU",2,"Liceul Waldorf, P-ta Iancu de Hunedoara (fosta P-ta 8 Martie) nr.3-5",1545,779,766,13,0,775,4,1700,921,421,354,1,13566,0
34,"Sibiu",143450,323,143450,,"MUNICIPIUL SIBIU",3,"Scoala cu clasele I-VIII nr.10, Str.E.A.Bieltz (fosta CAP Zorile) nr. 60",1230,601,588,13,0,592,9,1400,799,371,221,1,13566,0
34,"Sibiu",143450,323,143450,,"MUNICIPIUL SIBIU",4,"Scoala cu clasele I-VIII nr.10, Str.E.A.Bieltz (fosta CAP Zorile) nr. 60",1585,795,775,20,0,788,7,1700,905,477,311,1,13566,0
34,"Sibiu",143450,323,143450,,"MUNICIPIUL SIBIU",5,"Scoala cu clasele I-VIII nr.10, Str.E.A.Bieltz (fosta CAP Zorile) nr.60",1506,834,824,9,1,827,7,1700,866,486,341,1,13566,0
34,"Sibiu",143450,323,143450,,"MUNICIPIUL SIBIU",6,"Scoala cu clasele I-VIII nr.12, P-ta Cluj nr.1-3",1553,832,819,12,1,820,12,1700,868,464,356,1,13566,0
34,"Sibiu",143450,323,143450,,"MUNICIPIUL SIBIU",7,"Scoala cu clasele I-VIII nr.12, P-ta Cluj nr. 1-3",1374,818,805,13,0,803,15,1500,682,434,369,1,13566,0
34,"Sibiu",143450,323,143450,,"MUNICIPIUL SIBIU",8,"Scoala cu clasele I-VIII nr.12, P-ta Cluj nr.1-3",1359,798,789,9,0,777,21,1500,702,451,326,1,13566,0
34,"Sibiu",143450,323,143450,,"MUNICIPIUL SIBIU",9,"Grup Scolar C-tii si Arhitectura Carol I, Pedagogilor nr.7",1499,764,747,9,8,761,3,1600,836,470,291,1,13566,0
34,"Sibiu",143450,323,143450,,"MUNICIPIUL SIBIU",10,"Scoala cu clasele I-VIII nr.13, Str.Lunga (fosta 11 Iunie) nr.74",1054,615,600,15,0,609,6,1200,585,345,264,1,13566,0
34,"Sibiu",143450,323,143450,,"MUNICIPIUL SIBIU",11,"Scoala cu clasele I-VIII nr.13, Str.Lunga (fosta 11 Iunie) nr. 74",1144,599,584,15,0,588,11,1300,701,335,253,1,13566,0
34,"Sibiu",143450,323,143450,,"MUNICIPIUL SIBIU",12,"Scoala cu clasele I-VIII nr.13, Str.Lunga (fosta 11 Iunie) nr.74",1340,742,721,21,0,734,8,1500,758,407,327,1,13566,0
34,"Sibiu",143450,323,143450,,"MUNICIPIUL SIBIU",13,"Scoala cu clasele I-VIII nr.23, C.V Tiglari",1576,966,955,11,0,958,8,1700,734,614,344,1,13566,0
34,"Sibiu",143450,323,143450,,"MUNICIPIUL SIBIU",14,"Scoala cu clasele I-VIII nr.23, C.V Tiglari",1045,451,436,15,0,447,4,1100,649,311,136,1,13566,0
34,"Sibiu",143450,323,143450,,"MUNICIPIUL SIBIU",15,"Scoala cu clasele I-VIII nr.23, C.V Tiglari",1327,606,595,11,0,602,4,1500,894,398,204,1,13566,0
34,"Sibiu",143450,323,143450,,"MUNICIPIUL SIBIU",16,"Grup Scolar Ind.C-tii Masini Independenta, Str.Gladiolelor nr.2",1485,766,752,13,1,755,11,1600,834,440,315,1,13566,0
34,"Sibiu",143450,323,143450,,"MUNICIPIUL SIBIU",17,"Colegiul Tehnic de Ind. Alimentara Terezianum Sibiu, Str.Postavarilor nr. 18",1462,804,788,15,1,798,6,1600,796,492,306,1,13566,0
34,"Sibiu",143450,323,143450,,"MUNICIPIUL SIBIU",18,"Colegiul Tehnic de Ind. Alimentara Terezianum Sibiu, Str.Postavarilor nr. 18",1463,826,814,12,0,822,4,1600,774,491,331,1,13566,0
34,"Sibiu",143450,323,143450,,"MUNICIPIUL SIBIU",19,"Scoala cu clasele I-VIII nr.18, Str.Lunga (fosta 11 Iunie) nr. 65",1661,984,947,35,2,970,14,1800,816,584,386,1,13566,0
34,"Sibiu",143450,323,143450,,"MUNICIPIUL SIBIU",20,"Scoala cu clasele I-VIII nr.18, Str.Lunga (fosta 11 Iunie) nr.65",1631,944,932,12,0,930,14,1800,856,566,364,1,13566,0
34,"Sibiu",143450,323,143450,,"MUNICIPIUL SIBIU",21,"Scoala cu clasele I-VIII nr.11, Str.Gorunului nr.2",1307,538,528,10,0,535,3,1400,862,319,216,1,13566,0
34,"Sibiu",143450,323,143450,,"MUNICIPIUL SIBIU",22,"Scoala cu clasele I-VIII nr.11, Str.Gorunului nr. 2",1270,626,610,15,1,622,4,1400,774,378,244,1,13566,0
34,"Sibiu",143450,323,143450,,"MUNICIPIUL SIBIU",23,"Scoala cu clasele I-VIII nr.20, Str.Macaralei nr.1",1592,936,920,15,1,929,7,1800,864,570,359,1,13566,0
34,"Sibiu",143450,323,143450,,"MUNICIPIUL SIBIU",24,"Scoala cu clasele I-VIII nr.20, Str.Macaralei nr.1",1461,867,852,14,1,860,7,1600,733,489,371,1,13566,0
34,"Sibiu",143450,323,143450,,"MUNICIPIUL SIBIU",25,"Grup Scolar Ind.C-tii Masini (fostul liceul IPAS),  Str.Henri Coanda (fosta Sevastopol) nr.51",1112,575,566,9,0,569,6,1200,625,330,239,1,13566,0
34,"Sibiu",143450,323,143450,,"MUNICIPIUL SIBIU",26,"Grup Scolar Ind.C-tii Masini (fostul liceul IPAS),  Str.Henri Coanda ( fosta Sevastopol) nr. 51",1032,593,584,9,0,589,4,1100,507,335,254,1,13566,0
34,"Sibiu",143450,323,143450,,"MUNICIPIUL SIBIU",27,"Grup Scolar Ind.C-tii Masini (fostul liceul IPAS),  Str.Henri Coanda (fosta Sevastopol) nr.51",1637,818,803,15,0,809,9,1800,982,568,241,1,13566,0
34,"Sibiu",143450,323,143450,,"MUNICIPIUL SIBIU",28,"Scoala cu clasele I-VIII nr.8, Str.Lupeni nr. 50",1161,702,692,10,0,693,9,1300,598,419,274,1,13566,0
34,"Sibiu",143450,323,143450,,"MUNICIPIUL SIBIU",29,"Scoala cu clasele I-VIII nr.8, Str.Lupeni nr.50",1327,794,778,16,0,784,10,1500,706,434,350,1,13566,0
34,"Sibiu",143450,323,143450,,"MUNICIPIUL SIBIU",30,"Scoala cu clasele I-VIII nr.8, Str.Lupeni nr.50",1249,696,682,14,0,688,8,1400,704,359,329,1,13566,0
34,"Sibiu",143450,323,143450,,"MUNICIPIUL SIBIU",31,"Grup Scolar Ind.Transporturi Cai Ferate Sibiu Str.J.S.Bach nr.1-3",1465,835,822,13,0,827,8,1600,765,459,368,1,13566,0
34,"Sibiu",143450,323,143450,,"MUNICIPIUL SIBIU",32,"Gradinita cu program prelungit nr.17, Str.Liviu Rebreanu (fosta Reforma Agrara) nr. 7-9",1184,585,570,15,0,577,8,1300,715,345,232,1,13566,0
34,"Sibiu",143450,323,143450,,"MUNICIPIUL SIBIU",33,"Gradinita cu program prelungit nr.37, str Nicolae Teclu nr.41",1504,754,743,11,0,742,12,1700,946,408,334,1,13566,0
34,"Sibiu",143450,323,143450,,"MUNICIPIUL SIBIU",34,"Palatul Copiilor, Str.Constitutiei nr.2-4",1422,787,775,11,1,774,13,1600,813,404,370,1,13566,0
34,"Sibiu",143450,323,143450,,"MUNICIPIUL SIBIU",35,"Palatul Copiilor, Str.Constitutiei nr.2-4",1246,760,749,11,0,749,11,1400,640,380,369,1,13566,0
34,"Sibiu",143450,323,143450,,"MUNICIPIUL SIBIU",36,"Scoala cu clasele I-VIII nr.2, Str.Avram Iancu nr. 13",1033,489,481,6,2,478,11,1100,611,264,214,1,13566,0
34,"Sibiu",143450,323,143450,,"MUNICIPIUL SIBIU",37,"Colegiul National Gheorghe Lazar, Str.Ghe.Lazar nr.1",1480,766,752,14,0,757,9,1600,834,408,349,1,13566,0
34,"Sibiu",143450,323,143450,,"MUNICIPIUL SIBIU",38,"Fostul Club al Sindicatelor, Str. Avram Iancu nr.10",970,474,457,9,8,470,4,1100,626,263,207,1,13566,0
34,"Sibiu",143450,323,143450,,"MUNICIPIUL SIBIU",39,"Colegiul Tehnic Independenta Sibiu, Str. Ocnei nr.31",1380,633,616,16,1,632,1,1500,867,382,250,1,13566,0
34,"Sibiu",143450,323,143450,,"MUNICIPIUL SIBIU",40,"Liceul de Arta Sibiu, Str. Al. Odobescu nr.2",1604,807,793,14,0,793,14,1800,993,432,361,1,13566,0
34,"Sibiu",143450,323,143450,,"MUNICIPIUL SIBIU",41,"Colegiul National Oct.Goga Sibiu, Str.Mitropoliei (fosta 1 Mai) nr.34",1198,619,614,4,1,609,10,1300,681,329,280,1,13566,0
34,"Sibiu",143450,323,143450,,"MUNICIPIUL SIBIU",42,"Scoala cu clasele I-VIII nr. 15, Str.Bastionului (fosta Al.Sahia) nr.7",1455,758,746,12,0,745,13,1600,842,415,330,1,13566,0
34,"Sibiu",143450,323,143450,,"MUNICIPIUL SIBIU",43,"Scoala cu clasele I-VIII Regina Maria (fosta nr.5), Str. Zaharia Boiu nr.1",1338,837,815,20,2,823,14,1500,663,387,436,1,13566,0
34,"Sibiu",143450,323,143450,,"MUNICIPIUL SIBIU",44,"Scoala cu clasele I-VIII Regina Maria (fosta nr.5), Str. Zaharia Boiu nr.1",1347,789,778,9,2,782,7,1500,711,396,386,1,13566,0
34,"Sibiu",143450,323,143450,,"MUNICIPIUL SIBIU",45,"Colegiul Agricol D.P.Barcianu,  Str. Banatului nr.2",1241,730,691,13,26,717,13,1400,670,373,344,1,13566,0
34,"Sibiu",143450,323,143450,,"MUNICIPIUL SIBIU",46,"Casa Corpului Didactic, Str. Turismului  nr. 15",1399,847,838,9,0,836,11,1500,653,476,360,1,13566,0
34,"Sibiu",143450,323,143450,,"MUNICIPIUL SIBIU",47,"Liceul Teoretic Onisifor Ghibu, Str.Bihorului nr.3",1399,845,837,7,1,838,7,1500,655,492,346,1,13566,0
34,"Sibiu",143450,323,143450,,"MUNICIPIUL SIBIU",48,"Scoala cu clasele I-VIII nr.1, Str. Hategului nr.8",1449,864,852,12,0,852,12,1600,736,485,367,1,13566,0
34,"Sibiu",143450,323,143450,,"MUNICIPIUL SIBIU",49,"Scoala cu clasele I-VIII nr.1, Str. Hategului nr.8",1472,884,874,10,0,870,14,1600,716,500,370,1,13566,0
34,"Sibiu",143450,323,143450,,"MUNICIPIUL SIBIU",50,"Scoala cu clasele I-VIII nr.1, Str. Hategului nr.8",1749,1033,1023,9,1,1018,15,1900,867,573,445,1,13566,0
34,"Sibiu",143450,323,143450,,"MUNICIPIUL SIBIU",51,"Scoala cu clasele I-VIII nr.1, Str. Hategului nr.8",1620,997,986,10,1,984,13,1800,803,498,486,1,13566,0
34,"Sibiu",143450,323,143450,,"MUNICIPIUL SIBIU",52,"Gradinita cu program prelungit nr.22 (fosta nr.8), Str.Hochmeister nr.11",1512,943,917,24,2,924,19,1700,757,433,491,1,13566,0
34,"Sibiu",143450,323,143450,,"MUNICIPIUL SIBIU",53,"Scoala cu clasele I-VIII Emil Cioran (fosta nr.7), Calea Poplacii nr. 11",1575,963,956,6,1,952,11,1700,737,530,422,1,13566,0
34,"Sibiu",143450,323,143450,,"MUNICIPIUL SIBIU",54,"Scoala cu clasele I-VIII Emil Cioran (fosta nr.7), Calea Poplacii nr. 11",1455,897,876,20,1,890,7,1600,703,482,408,1,13566,0
34,"Sibiu",143450,323,143450,,"MUNICIPIUL SIBIU",55,"Scoala cu clasele I-VIII Emil Cioran (fosta nr.7), Calea Poplacii nr. 11",1172,639,630,9,0,627,12,1300,661,382,245,1,13566,0
34,"Sibiu",143450,323,143450,,"MUNICIPIUL SIBIU",56,"Scoala cu clasele I-VIII nr.25, Str. Sibiel nr.6",1271,712,704,8,0,705,7,1400,688,405,300,1,13566,0
34,"Sibiu",143450,323,143450,,"MUNICIPIUL SIBIU",57,"Scoala cu clasele I-VIII nr.25, Str. Sibiel nr.6",1405,782,778,4,0,773,9,1500,718,462,311,1,13566,0
34,"Sibiu",143450,323,143450,,"MUNICIPIUL SIBIU",58,"Scoala cu clasele I-VIII nr.25, Str. Sibiel nr.6",1380,791,778,13,0,779,12,1500,709,468,311,1,13566,0
34,"Sibiu",143450,323,143450,,"MUNICIPIUL SIBIU",59,"Scoala cu clasele I-VIII nr.25, Str. Sibiel nr.6",1309,742,731,11,0,732,10,1400,658,443,289,1,13566,0
34,"Sibiu",143450,323,143450,,"MUNICIPIUL SIBIU",60,"Scoala cu clasele I-VIII I.L.Caragiale (fosta nr. 16), Str. Vasile Alecsandri nr.10",1347,898,882,16,0,883,15,1500,602,467,416,1,13566,0
34,"Sibiu",143450,323,143450,,"MUNICIPIUL SIBIU",61,"Scoala cu clasele I-VIII I.L.Caragiale (fosta nr. 16), Str. Vasile Alecsandri nr.10",1357,785,763,19,3,772,12,1500,716,403,369,1,13566,0
34,"Sibiu",143450,323,143450,,"MUNICIPIUL SIBIU",62,"Gradinita cu program prelungit nr.22, Str. M.Sebastian nr.1",1230,795,781,14,0,783,12,1400,605,408,375,1,13566,0
34,"Sibiu",143450,323,143450,,"MUNICIPIUL SIBIU",63,"Facultatea de Inginerie, Str. Emil Cioran nr. 4",1508,865,844,19,2,845,20,1700,835,353,492,1,13566,0
34,"Sibiu",143450,323,143450,,"MUNICIPIUL SIBIU",64,"Gradinita cu program prelungit Fratii Grimm (fosta nr. 40), Str.Oituz nr. 27",1183,815,803,12,0,807,8,1600,785,478,329,1,13566,0
34,"Sibiu",143450,323,143450,,"MUNICIPIUL SIBIU",65,"Colegiu Economic George Baritiu (fost.Liceul Economic), Str.Oituz nr.31",1338,839,816,21,2,825,14,1500,661,395,430,1,13566,0
34,"Sibiu",143450,323,143450,,"MUNICIPIUL SIBIU",66,"Colegiu Economic George Baritiu (fost.Liceul Economic), Str.Oituz nr.31",1472,817,798,19,0,807,10,1600,783,401,406,1,13566,0
34,"Sibiu",143450,323,143450,,"MUNICIPIUL SIBIU",67,"Club Sportiv Scolar Sibiu, Str. Independentei nr.1",1407,816,792,12,12,798,18,1500,684,339,459,1,13566,0
34,"Sibiu",143450,323,143450,,"MUNICIPIUL SIBIU",68,"Scoala cu clasele I-VIII nr.4, Str. Spartacus nr. 4-6",1400,808,793,15,0,798,10,1500,692,400,398,1,13566,0
34,"Sibiu",143450,323,143450,,"MUNICIPIUL SIBIU",69,"Scoala cu clasele I-VIII nr.4, Str. Spartacus nr. 4-6",1224,718,706,12,0,712,6,1300,582,372,340,1,13566,0
34,"Sibiu",143450,323,143450,,"MUNICIPIUL SIBIU",70,"Scoala cu clasele I-VIII nr.4, Str. Spartacus nr.4-6",1560,949,937,12,0,937,12,1700,751,450,487,1,13566,0
34,"Sibiu",143450,323,143450,,"MUNICIPIUL SIBIU",71,"Gradinita cu program prelungit nr.14, Str. Iezer nr.2",1465,841,822,17,2,832,9,1600,759,476,356,1,13566,0
34,"Sibiu",143450,323,143450,,"MUNICIPIUL SIBIU",72,"Grup Scolar Ind.Energetic (fost Liceul Energetic), Str. Electricienilor nr.1",1411,732,719,13,0,717,15,1600,868,423,294,1,13566,0
34,"Sibiu",143450,323,143450,,"MUNICIPIUL SIBIU",73,"Grup Scolar Ind.Energetic (fost Liceul Energetic), Str. Electricienilor nr.1",1678,922,907,15,0,915,7,1800,878,541,374,1,13566,0
34,"Sibiu",143450,323,143450,,"MUNICIPIUL SIBIU",74,"Grup Scolar Ind.Energetic (fost Liceul Energetic), Str. Electricienilor nr.1",1563,819,804,13,2,811,8,1700,881,440,371,1,13566,0
34,"Sibiu",143450,323,143450,,"MUNICIPIUL SIBIU",75,"Scoala cu clasele I-VIII nr.24, Str. Sureanu nr.1",1380,637,625,12,0,635,2,1500,863,375,260,1,13566,0
34,"Sibiu",143450,323,143450,,"MUNICIPIUL SIBIU",76,"Scoala cu clasele I-VIII nr.24, Str. Sureanu nr.1",1292,653,639,14,0,645,8,1400,747,404,241,1,13566,0
34,"Sibiu",143450,323,143450,,"MUNICIPIUL SIBIU",77,"Scoala cu clasele I-VIII nr.24, Str. Sureanu nr.1",1507,816,803,13,0,804,12,1700,884,452,352,1,13566,0
34,"Sibiu",143450,323,143450,,"MUNICIPIUL SIBIU",78,"Scoala cu clasele I-VIII nr.24, Str. Sureanu nr.1",1416,759,741,16,2,751,8,1600,841,481,270,1,13566,0
34,"Sibiu",143450,323,143450,,"MUNICIPIUL SIBIU",79,"Scoala cu clasele I-VIII nr.24, Str. Sureanu nr.1",1186,634,619,15,0,623,11,1300,666,394,229,1,13566,0
34,"Sibiu",143450,323,143450,,"MUNICIPIUL SIBIU",80,"Scoala cu clasele I-VIII nr.24, Str. Sureanu nr.1",1386,784,776,8,0,772,12,1500,716,493,279,1,13566,0
34,"Sibiu",143450,323,143450,,"MUNICIPIUL SIBIU",81,"Scoala cu clasele I-VIII nr.24, Str. Sureanu nr.1",1385,678,668,10,0,676,2,1500,822,451,225,1,13566,0
34,"Sibiu",143450,323,143450,,"MUNICIPIUL SIBIU",82,"Gradinita cu program prelungit nr.29, Str. Negoveanu nr. 9",1272,768,753,14,1,759,9,1400,632,455,304,1,13566,0
34,"Sibiu",143450,323,143450,,"MUNICIPIUL SIBIU",83,"Scoala cu clasele I-VIII Radu Selejan (fosta nr.17), Str. Electricienilor nr.6",1279,679,664,15,0,673,6,1397,718,449,224,1,13566,0
34,"Sibiu",143450,323,143450,,"MUNICIPIUL SIBIU",84,"Scoala cu clasele I-VIII Radu Selejan (fosta nr.17), Str. Electricienilor nr. 6",1080,568,557,11,0,560,8,1200,632,309,251,1,13566,0
34,"Sibiu",143450,323,143450,,"MUNICIPIUL SIBIU",85,"Gradinita cu program prelungit nr.33, Str. ArtileriStilor nr.4 (fosta Preda Buzescu)",1291,693,682,11,0,687,6,1400,707,378,309,1,13566,0
34,"Sibiu",143450,323,143450,,"MUNICIPIUL SIBIU",86,"Gradinita cu program prelungit nr.33, Str. ArtileriStilor nr. 4 (fosta Preda Buzescu)",1516,865,851,13,1,854,11,1700,835,381,473,1,13566,0
34,"Sibiu",143450,323,143450,,"MUNICIPIUL SIBIU",87,"Scoala cu clasele I-VIII nr.21, Str. Luptei nr. 27",974,537,529,8,0,531,6,1100,563,301,230,1,13566,0
34,"Sibiu",143450,323,143450,,"MUNICIPIUL SIBIU",88,"Scoala cu clasele I-VIII nr.21, Str. Luptei nr. 27",1131,668,652,16,0,660,8,1200,532,299,361,1,13566,0
34,"Sibiu",143450,323,143450,,"MUNICIPIUL SIBIU",89,"Scoala cu clasele I-VIII nr.21, Str. Luptei nr. 27",1371,756,743,13,0,747,9,1500,744,367,380,1,13566,0
34,"Sibiu",143450,323,143450,,"MUNICIPIUL SIBIU",90,"Scoala cu clasele I-VIII nr.6, Str.Nic.Iorga nr. 56",1097,620,610,10,0,617,3,1200,580,275,342,1,13566,0
34,"Sibiu",143450,323,143450,,"MUNICIPIUL SIBIU",91,"Scoala cu clasele I-VIII nr.6, Str.Nic.Iorga nr. 56",757,449,439,10,0,445,4,800,351,236,209,1,13566,0
34,"Sibiu",143450,323,143450,,"MUNICIPIUL SIBIU",92,"Scoala cu clasele I-VIII nr.6, Str.Nic.Iorga nr. 56",1417,747,727,20,0,734,13,1600,853,398,336,1,13566,0
34,"Sibiu",143450,323,143450,,"MUNICIPIUL SIBIU",93,"Scoala cu clasele I-VIII nr.6,  Str.Nic.Iorga nr. 56",1168,626,617,9,0,615,11,1300,674,371,244,1,13566,0
34,"Sibiu",143450,323,143450,,"MUNICIPIUL SIBIU",94,"Scoala cu clasele I-VIII Mihai Eminescu (fost.nr.9), Str.OStirii nr. 5",1352,759,749,9,1,752,7,1500,741,418,334,1,13566,0
34,"Sibiu",143450,323,143450,,"MUNICIPIUL SIBIU",95,"Scoala cu clasele I-VIII Mihai Eminescu (fost.nr.9), Str.OStirii nr. 5",1458,838,829,9,0,820,18,1600,762,451,369,1,13566,0
34,"Sibiu",143450,323,143450,,"MUNICIPIUL SIBIU",96,"Scoala cu clasele I-VIII Mihai Eminescu (fost.nr.9), Str.OStirii nr. 5",1520,864,846,18,0,853,11,1700,836,470,383,1,13566,0
34,"Sibiu",143450,323,143450,,"MUNICIPIUL SIBIU",97,"Gradinita cu program prelungit nr.38, Aleea Haiducului nr.3",1614,863,854,9,0,855,8,1800,937,501,354,1,13566,0
34,"Sibiu",143450,323,143450,,"MUNICIPIUL SIBIU",98,"Scoala cu clasele I-VIII nr.19, Aleea Turnu RoSu nr. 2",1444,807,795,12,0,792,15,1600,793,398,394,1,13566,0
34,"Sibiu",143450,323,143450,,"MUNICIPIUL SIBIU",99,"Scoala cu clasele I-VIII nr.19, Aleea Turnu RoSu nr. 2",1704,986,969,16,1,971,15,1900,914,521,450,1,13566,0
34,"Sibiu",143450,323,143450,,"MUNICIPIUL SIBIU",100,"Gradinita cu program prelungit nr.42, Str. N.Iorga (fosta Kolarov) nr.62",1429,898,885,13,0,883,15,1600,702,452,431,1,13566,0
34,"Sibiu",143450,323,143450,,"MUNICIPIUL SIBIU",101,"Gradinita cu program prelungit nr.43, Aleea Streiu nr.8",1590,827,814,13,0,823,4,1700,873,568,255,1,13566,0
34,"Sibiu",143450,323,143450,,"MUNICIPIUL SIBIU",102,"Gradinita cu program prelungit nr.43, Aleea Streiu nr.8",1169,618,604,14,0,613,5,1300,682,375,238,1,13566,0
34,"Sibiu",143450,323,143450,,"MUNICIPIUL SIBIU",103,"Gradinita cu program prelungit nr.5, Str.Siretului nr.6",946,506,495,11,0,501,5,1000,494,272,229,1,13566,0
34,"Sibiu",143450,323,143450,,"MUNICIPIUL SIBIU",104,"Gradinita cu program prelungit nr.5, Str.Siretului nr.6",1668,934,922,12,0,924,10,1800,866,579,345,1,13566,0
34,"Sibiu",143450,323,143450,,"MUNICIPIUL SIBIU",105,"Spatiul Administrativ SC Tursib SA, Calea Dumbravii nr.135",1663,872,854,18,0,857,15,1800,928,500,357,1,13566,0
34,"Sibiu",143450,323,143450,,"MUNICIPIUL SIBIU",106," Paltinis, str.C.Noica bl.1 ap.2",28,14,5,9,0,14,0,100,86,10,4,1,13566,0
34,"Sibiu",143450,323,143450,,"MUNICIPIUL SIBIU",107,"Camin Studentesc, Bd. Victoriei nr 31 CP 550024",0,1551,0,1551,0,1515,36,1700,149,875,640,1,13566,1
34,"Sibiu",143450,323,143450,,"MUNICIPIUL SIBIU",108,"Camin Studentesc,Str. Vasile Aaron nr 14 CP 550297",0,570,0,570,0,561,9,1000,430,330,231,1,13566,1
34,"Sibiu",143450,323,143450,,"MUNICIPIUL SIBIU",109,"Camin Studentesc, Str. Electricienilor nr. 3, CP 550311",0,357,0,357,0,350,7,1000,643,207,143,1,13566,1
34,"Sibiu",143450,323,143450,,"MUNICIPIUL SIBIU",110,"Gara, Piata 1 Decembrie nr. 6, CP 550200",0,1302,0,1302,0,1284,18,1400,98,793,491,1,13566,1
34,"Sibiu",143450,323,143450,,"MUNICIPIUL SIBIU",111,"Aeroport, Str. Soseaua Alba Iulia nr.73, CP 550052",0,505,0,505,0,499,6,1000,495,274,225,1,13566,1
34,"Sibiu",143450,323,143450,,"MUNICIPIUL SIBIU",112,"Spitalul Clinic Judetean, Bd. Corneliu Coposu nr. 2-4, CP 550245",0,393,0,393,0,391,2,1000,607,231,160,1,13566,1
34,"Sibiu",143450,323,143450,,"MUNICIPIUL SIBIU",113,"Spitalul de Pneumoftiziologie, Str. Aleea Filozofilor nr. 3, CP 550196",0,61,0,61,0,60,1,250,189,33,27,1,13566,1
34,"Sibiu",143450,323,143450,,"MUNICIPIUL SIBIU",114,"Spitalul de Neuropsihiatrie, Str. Dr. Bagdazar nr.10 CP 550082",0,174,0,174,0,171,3,600,426,92,79,1,13566,1
34,"Sibiu",143619,323,143619,,"MUNICIPIUL MEDIAS",115,"Scoala H.Oberth, P-ta Castelului nr.2, sala de clasa",1394,570,555,12,3,561,9,1500,930,337,224,1,13569,0
34,"Sibiu",143619,323,143619,,"MUNICIPIUL MEDIAS",116," Gradinita nr.12, str.C.Brancoveanu nr.13",1203,579,570,9,0,575,4,1300,721,378,197,1,13569,0
34,"Sibiu",143619,323,143619,,"MUNICIPIUL MEDIAS",117,"Scoala Mihai Eminescu, str.M.Viteazu nr.14, sala de clasa",1405,678,663,15,0,668,10,1500,822,452,216,1,13569,0
34,"Sibiu",143619,323,143619,,"MUNICIPIUL MEDIAS",118," Gradinita nr.17, str.Dupa Zid nr.11",1300,679,671,7,1,673,6,1400,721,466,207,1,13569,0
34,"Sibiu",143619,323,143619,,"MUNICIPIUL MEDIAS",119,"Vestiar Sparta, str.Stadionului nr.85",816,426,415,11,0,420,6,900,474,290,130,1,13569,0
34,"Sibiu",143619,323,143619,,"MUNICIPIUL MEDIAS",120,"ACR  etaj 1, str.Stadionului nr.55",955,475,472,3,0,473,2,1100,625,340,133,1,13569,0
34,"Sibiu",143619,323,143619,,"MUNICIPIUL MEDIAS",121,"SC.Hula Veche SRL, str.Codrului nr.2",1203,682,667,14,1,677,5,1300,618,448,229,1,13569,0
34,"Sibiu",143619,323,143619,,"MUNICIPIUL MEDIAS",122," Clubul Copiilor Si Elevilor, str.Nucului nr.5, sala de festivitati",1105,612,599,13,0,601,11,1200,588,374,227,1,13569,0
34,"Sibiu",143619,323,143619,,"MUNICIPIUL MEDIAS",123,"Scoala Ajutatoare, str.Piscului nr.8, sala de clasa",1252,657,640,16,1,655,2,1400,743,487,168,1,13569,0
34,"Sibiu",143619,323,143619,,"MUNICIPIUL MEDIAS",124,"Sc.gen. nr.7, str. 1Decembrie nr.34, sala de clasa",1235,668,666,2,0,664,4,1400,732,445,219,1,13569,0
34,"Sibiu",143619,323,143619,,"MUNICIPIUL MEDIAS",125,"Sc.gen. nr.7, str. 1Decembrie nr.34, sala de clasa",1070,531,522,9,0,530,1,1200,669,360,170,1,13569,0
34,"Sibiu",143619,323,143619,,"MUNICIPIUL MEDIAS",126,"Sc.gen. nr.7, str. 1Decembrie nr.34, sala de clasa",1068,556,552,4,0,550,6,1200,644,367,183,1,13569,0
34,"Sibiu",143619,323,143619,,"MUNICIPIUL MEDIAS",127,"Sc.gen. nr.7, str. 1Decembrie nr.34, sala de clasa",1257,659,656,3,0,651,8,1400,741,427,224,1,13569,0
34,"Sibiu",143619,323,143619,,"MUNICIPIUL MEDIAS",128," Gradinita nr.15, str.Cluj nr.12, sala de festivitati",1356,710,696,13,1,702,8,1500,790,430,272,1,13569,0
34,"Sibiu",143619,323,143619,,"MUNICIPIUL MEDIAS",129,"Sc.Gen. nr.5, str. 1Decembrie nr.26, corp A sala de clasa",1076,595,575,19,1,588,7,1200,605,377,211,1,13569,0
34,"Sibiu",143619,323,143619,,"MUNICIPIUL MEDIAS",130,"Sc.Gen. nr.5, str. 1 Decembrie nr.26, corp A sala de clasa",1303,615,601,13,1,605,10,1400,785,418,187,1,13569,0
34,"Sibiu",143619,323,143619,,"MUNICIPIUL MEDIAS",131," Gradinita nr.7, str.Merilor nr.23",1260,605,596,9,0,600,5,1400,795,414,186,1,13569,0
34,"Sibiu",143619,323,143619,,"MUNICIPIUL MEDIAS",132," Gradinita Piticot, str.L.Blaga nr.8",1523,778,768,10,0,762,16,1700,922,488,274,1,13569,0
34,"Sibiu",143619,323,143619,,"MUNICIPIUL MEDIAS",133,"Sc.Gen.nr.4, str.St.L.Roth nr.21, sala de clasa",1106,554,547,7,0,546,8,1200,646,344,202,1,13569,0
34,"Sibiu",143619,323,143619,,"MUNICIPIUL MEDIAS",134," Spatiu cu alta destinatie (fosta Jandarmerie), str.G.Toparceanu f.n.",1046,558,543,15,0,556,2,1200,642,376,180,1,13569,0
34,"Sibiu",143619,323,143619,,"MUNICIPIUL MEDIAS",135,"Sc.Gen.nr.6, str.Dealul Furcilor nr.7, sala de clasa",1060,644,631,13,0,637,7,1200,556,421,216,1,13569,0
34,"Sibiu",143619,323,143619,,"MUNICIPIUL MEDIAS",136," Punct control Automecanica, str.A.Vlaicu f.n.",688,383,373,10,0,382,1,800,417,298,84,1,13569,0
34,"Sibiu",143619,323,143619,,"MUNICIPIUL MEDIAS",137,"SC TRANSGAZ, str.G.CoSbuc nr.29",1047,610,600,10,0,608,2,1200,590,394,214,1,13569,0
34,"Sibiu",143619,323,143619,,"MUNICIPIUL MEDIAS",138,"Societate Comerciala, str. Sos. Mosnei, nr.38",1104,583,573,9,1,581,2,1200,617,437,144,1,13569,0
34,"Sibiu",143619,323,143619,,"MUNICIPIUL MEDIAS",139,"Complex comercial, str.Stejarului f.n.",1378,784,775,7,2,776,8,1500,716,547,229,1,13569,0
34,"Sibiu",143619,323,143619,,"MUNICIPIUL MEDIAS",140,"Sc.Gen.nr.2, str.A.Iancu  nr.42, cladirea 1, sala de clasa",1009,557,550,7,0,554,3,1100,543,390,164,1,13569,0
34,"Sibiu",143619,323,143619,,"MUNICIPIUL MEDIAS",141,"Sc.Gen.nr.2, str.A.Iancu  nr.42, cladirea 1, sala de clasa",1479,858,848,9,1,846,12,1600,742,612,234,1,13569,0
34,"Sibiu",143619,323,143619,,"MUNICIPIUL MEDIAS",142,"Sc.Gen.nr.2, str.A.Iancu  nr.42, cladirea 1, sala de clasa",1419,805,792,12,1,795,10,1600,795,568,227,1,13569,0
34,"Sibiu",143619,323,143619,,"MUNICIPIUL MEDIAS",143,"Sc.Nat. de Gaze, str.Metanului nr.1, hol intrare",1276,679,666,11,2,678,1,1400,721,486,192,1,13569,0
34,"Sibiu",143619,323,143619,,"MUNICIPIUL MEDIAS",144,"Muzeul  H.Oberth, str.H.Oberth nr.31",1097,619,607,11,1,611,8,1200,581,363,248,1,13569,0
34,"Sibiu",143619,323,143619,,"MUNICIPIUL MEDIAS",145,"Liceul M.I.U., str.Sticlei nr.9, sala de clasa",1293,653,644,7,2,652,1,1400,747,456,196,1,13569,0
34,"Sibiu",143619,323,143619,,"MUNICIPIUL MEDIAS",146,"Sc.Gen. nr.3, str.Sticlei nr.11, sala de clasa",1263,656,645,10,1,653,3,1400,744,476,177,1,13569,0
34,"Sibiu",143619,323,143619,,"MUNICIPIUL MEDIAS",147," Gradinita nr.11, str.Rubinului nr.5, sala de festivitati",1171,598,589,9,0,591,7,1300,702,407,184,1,13569,0
34,"Sibiu",143619,323,143619,,"MUNICIPIUL MEDIAS",148,"Sc.Gen. nr.8, str.SebeS nr.3, sala de clasa",1305,642,632,10,0,638,4,1389,747,460,178,1,13569,0
34,"Sibiu",143619,323,143619,,"MUNICIPIUL MEDIAS",149,"Sc.Gen. nr.8, str.SebeS nr.3,  sala de clasa",1407,665,658,7,0,662,3,1500,835,476,186,1,13569,0
34,"Sibiu",143619,323,143619,,"MUNICIPIUL MEDIAS",150,"Sc.Gen. nr.8, str.SebeS nr.3, cancelarie",1472,706,699,6,1,703,3,1600,894,516,187,1,13569,0
34,"Sibiu",143619,323,143619,,"MUNICIPIUL MEDIAS",151,"Sc.Gen. nr.8, str.SebeS nr.3, sala de clasa",1461,704,692,12,0,703,1,1600,896,528,175,1,13569,0
34,"Sibiu",143619,323,143619,,"MUNICIPIUL MEDIAS",152,"Sc.Gen. nr.8, str.SebeS nr.3, sala de clasa",1374,652,640,12,0,646,6,1500,848,498,148,1,13569,0
34,"Sibiu",143619,323,143619,,"MUNICIPIUL MEDIAS",153,"SC BAT SA, str.Sibiului nr.67, birou",1195,590,577,13,0,586,4,1300,710,443,143,1,13569,0
34,"Sibiu",143619,323,143619,,"MUNICIPIUL MEDIAS",154,"Universitatea Lucian Blaga,  str.Lotru f.n.",1254,569,560,7,2,567,2,1400,831,440,127,1,13569,0
34,"Sibiu",143619,323,143619,,"MUNICIPIUL MEDIAS",155,"Universitatea Lucian Blaga, str.Lotru f.n.",1405,665,652,13,0,660,5,1500,835,484,176,1,13569,0
34,"Sibiu",143619,323,143619,,"MUNICIPIUL MEDIAS",156,"Scoala generala Ighisul Nou,sala de clasa",1223,528,520,8,0,524,4,1300,772,442,82,1,13569,0
34,"Sibiu",143619,323,143619,,"MUNICIPIUL MEDIAS",157,"Statia CFR Medias, Str. Unirii nr. 2-4, CP 551025",0,482,0,482,0,477,5,1000,518,321,156,1,13569,1
34,"Sibiu",143682,323,143682,,"ORAS AGNITA",158,"Scoala generala G.D. Teutsch, corp B, str. Mihai Viteazu nr.83, sala1 parter",1326,535,530,5,0,532,3,1500,965,341,191,1,13572,0
34,"Sibiu",143682,323,143682,,"ORAS AGNITA",159,"Gradinita nr.3, str. Fabricii nr.44, sala mare parter",1181,534,526,8,0,526,8,1300,766,328,198,1,13572,0
34,"Sibiu",143682,323,143682,,"ORAS AGNITA",160,"Complexul de servicii Agnita, str. Mihai Viteazu nr.16, sala mica parter",1565,631,619,12,0,620,11,1700,1069,369,251,1,13572,0
34,"Sibiu",143682,323,143682,,"ORAS AGNITA",161,"Scoala generala G.D. Teutsch, corp A , str. Piata G.D.Teutsch, sala curs parter",1207,622,605,8,9,621,1,1300,678,402,219,1,13572,0
34,"Sibiu",143682,323,143682,,"ORAS AGNITA",162,"Colegiul Tehnic A.T. Laurean, str.Scolii nr.2, hol cancelarie parter",1012,476,464,9,3,470,6,1100,624,252,218,1,13572,0
34,"Sibiu",143682,323,143682,,"ORAS AGNITA",163,"SC Apa Tarnavei Mari SA, Str. Avram Iancu nr.31, birou etaj",1364,533,527,6,0,531,2,1500,967,301,230,1,13572,0
34,"Sibiu",143682,323,143682,,"ORAS AGNITA",164,"Gradinita nr.2.str.Horia nr.38, sala parter",1233,579,574,5,0,574,5,1400,821,318,256,1,13572,0
34,"Sibiu",143682,323,143682,,"ORAS AGNITA",165,"Scoala Generala Coves, clasa etaj",528,277,272,5,0,274,3,600,323,176,98,1,13572,0
34,"Sibiu",143682,323,143682,,"ORAS AGNITA",166,"Scoala Generala Ruja, clasa parter",960,442,433,6,3,440,2,1100,658,267,173,1,13572,0
34,"Sibiu",143682,323,143682,,"ORAS AGNITA",167,"Primaria Orasului Agnita, P-ta Republicii nr. 19, CP 555100",0,117,0,117,0,116,1,250,133,65,51,1,13572,1
34,"Sibiu",144054,323,144054,,"ORAS AVRIG",168,"str: Ghe. Lazar nr 37, in localul Scolii generale cls I-VIII Avrig",1219,685,674,11,0,680,5,1300,615,480,200,1,13576,0
34,"Sibiu",144054,323,144054,,"ORAS AVRIG",169,"str: Ghe Lazar nr 8, in localul Casei de Cultura Avrig",1230,777,762,15,0,768,9,1400,623,522,246,1,13576,0
34,"Sibiu",144054,323,144054,,"ORAS AVRIG",170,"Str. Samuel Brukenthal nr 41, localul Gradinitei nr 1",1471,782,769,12,1,772,10,1600,818,533,239,1,13576,0
34,"Sibiu",144054,323,144054,,"ORAS AVRIG",171,"str Samuel Brukentalhal nr 149, in localul Gradinitei nr 2 din colonia Sticla",1380,698,682,15,1,687,11,1500,802,514,173,1,13576,0
34,"Sibiu",144054,323,144054,,"ORAS AVRIG",172,"str Horia nr 15, in localul Liceului Ghe Lazar",1317,679,675,4,0,675,4,1400,721,500,175,1,13576,0
34,"Sibiu",144054,323,144054,,"ORAS AVRIG",173,"str Horia nr 15, Liceul Ghe Lazar",1461,764,756,8,0,753,11,1600,836,552,201,1,13576,0
34,"Sibiu",144054,323,144054,,"ORAS AVRIG",174,"In localul Scolii Generale Mirsa",1209,587,576,11,0,581,6,1300,713,431,150,1,13576,0
34,"Sibiu",144054,323,144054,,"ORAS AVRIG",175,"In localul Grupului  Scolar Mirsa",1493,710,703,7,0,706,4,1600,890,531,175,1,13576,0
34,"Sibiu",144054,323,144054,,"ORAS AVRIG",176,"In localul Scolii Generale din Bradu",900,482,471,11,0,477,5,1000,518,360,117,1,13576,0
34,"Sibiu",144054,323,144054,,"ORAS AVRIG",177,"In localul Scolii Generale din Sacadate",531,261,259,2,0,260,1,600,339,170,90,1,13576,0
34,"Sibiu",144054,323,144054,,"ORAS AVRIG",178,"In localul Scolii Generale Glimboaca",195,102,94,8,0,102,0,200,98,70,32,1,13576,0
34,"Sibiu",144054,323,144054,,"ORAS AVRIG",179,"Clubul Elevilor Avrig, Str. Sasilor nr. 12, CP 555200",0,245,0,245,0,242,3,250,5,155,87,1,13576,1
34,"Sibiu",143735,323,143735,,"ORAS CISNADIE",180,"Scoala generala Cisnadioara",573,158,153,5,0,156,2,600,442,89,67,1,13582,0
34,"Sibiu",143735,323,143735,,"ORAS CISNADIE",181,"Sala de Sport, Str. Magurii nr.105",1561,739,729,10,0,734,5,1700,961,512,222,1,13582,0
34,"Sibiu",143735,323,143735,,"ORAS CISNADIE",182,"Clubul Elevilor,  Str. Magurii nr.93",1391,722,714,7,1,710,12,1500,778,438,272,1,13582,0
34,"Sibiu",143735,323,143735,,"ORAS CISNADIE",183," Gradinita nr.6, Str. Stejarului",1456,724,718,6,0,716,8,1600,876,463,253,1,13582,0
34,"Sibiu",143735,323,143735,,"ORAS CISNADIE",184,"Scoala generala nr.3, Str. Magurii nr. 63",1420,730,722,8,0,727,3,1600,870,450,277,1,13582,0
34,"Sibiu",143735,323,143735,,"ORAS CISNADIE",185,"Liceul ""Gustav Gundisch"", Str. Magurii nr.5",1669,817,805,12,0,809,8,1800,983,505,304,1,13582,0
34,"Sibiu",143735,323,143735,,"ORAS CISNADIE",186," Gradinita nr.3, Str. Unirii nr. 6",1431,733,719,14,0,727,6,1600,867,468,259,1,13582,0
34,"Sibiu",143735,323,143735,,"ORAS CISNADIE",187,"Scoala generala nr.2, Str. Tesatorilor nr.47",1574,807,797,10,0,803,4,1700,893,506,297,1,13582,0
34,"Sibiu",143735,323,143735,,"ORAS CISNADIE",188," Grupul Scolar de Industrie Usoara, Str. Targului nr.14",1119,567,556,11,0,562,5,1200,633,338,224,1,13582,0
34,"Sibiu",143735,323,143735,,"ORAS CISNADIE",189," Grupul Scolar de Industrie Usoara, Str. Targului nr.14",1018,488,480,8,0,483,5,1100,612,329,154,1,13582,0
34,"Sibiu",143735,323,143735,,"ORAS CISNADIE",190,"Scoala generala nr.1, Str. Selimbarului nr.1",964,477,469,8,0,471,6,1100,623,303,168,1,13582,0
34,"Sibiu",143735,323,143735,,"ORAS CISNADIE",191,"Scoala generala nr.1, Str. Selimbarului nr.1",1028,513,502,10,1,512,1,1100,587,332,180,1,13582,0
34,"Sibiu",143735,323,143735,,"ORAS CISNADIE",192,"Liceul ""Gustav Gundisch"" Cisnadie, Str. Magurii nr.5, CP 555300",0,244,0,244,0,244,0,300,56,138,106,1,13582,1
34,"Sibiu",143771,323,143771,,"ORAS COPSA MICA",193,"Sala de sport a Scolii cu clasele I-VIII, CopSa Mica nr. 1, Sos. MediaSului nr. 93",1230,556,547,9,0,551,5,1400,844,372,179,1,13585,0
34,"Sibiu",143771,323,143771,,"ORAS COPSA MICA",194,"Holul Grupului Scolar Nicolae Teclu, CopSa Mica, Sos. Sibiului nr. 61",1408,657,628,28,1,648,9,1500,843,386,262,1,13585,0
34,"Sibiu",143771,323,143771,,"ORAS COPSA MICA",195,"Sala de sport a Scolii cu clasele I-VIII, CopSa Mica nr. 3, str. Laborator nr. 45",1492,680,663,17,0,672,8,1600,920,342,330,1,13585,0
34,"Sibiu",143771,323,143771,,"ORAS COPSA MICA",196,"Scoala cu clasele I-VIII, CopSa Mica, str. Tirnavioara nr. 78",445,215,206,9,0,213,2,500,285,143,70,1,13585,0
34,"Sibiu",143771,323,143771,,"ORAS COPSA MICA",197,"Statia CFR Copsa Mica, Str. Garii nr. 1, CP 555400",0,129,0,129,0,129,0,200,71,70,59,1,13585,1
34,"Sibiu",143806,323,143806,,"ORAS DUMBRAVENI",198,"Primaria Dumbraveni ,  str. M.Eminescu nr.6 (sala de Sedinte)",1386,711,702,9,0,707,4,1500,789,456,251,1,13587,0
34,"Sibiu",143806,323,143806,,"ORAS DUMBRAVENI",199,"Liceul Teoretic Dumbraveni , str. Cuza Voda nr. 5-7 (sala de clasa)",1122,594,581,13,0,592,2,1200,606,361,231,1,13587,0
34,"Sibiu",143806,323,143806,,"ORAS DUMBRAVENI",200,"Grup Scolar Agricol ""Timotei Cipariu"" Dumbraveni , P-ta Timotei Cipariu , Nr.9 (cantina grup scolar)",1253,557,551,6,0,546,11,1400,843,361,185,1,13587,0
34,"Sibiu",143806,323,143806,,"ORAS DUMBRAVENI",201,"Centrul Scolar pentru Educatie Incluziva Dumbraveni, str. T.Vladimirescu, nr.32",1376,542,535,4,3,532,10,1500,958,383,149,1,13587,0
34,"Sibiu",143806,323,143806,,"ORAS DUMBRAVENI",202,"Scoala Generala, sat Saros pe Tarnave nr.371, sala de clasa",1350,796,781,15,0,785,11,1500,704,516,269,1,13587,0
34,"Sibiu",143806,323,143806,,"ORAS DUMBRAVENI",203,"Scoala Generala, sat Ernea nr.156, sala de clasa",372,243,238,5,0,239,4,400,157,132,107,1,13587,0
34,"Sibiu",143806,323,143806,,"ORAS DUMBRAVENI",204,"Primaria Orasului Dumbraveni, Str. M.Eminescu nr. 6, CP 555500",0,148,0,148,0,136,12,250,102,80,56,1,13587,1
34,"Sibiu",144928,323,144928,,"ORAS MIERCUREA SIBIULUI",205,"Sala mica a Casei de Cultura Corneliu Medrea, P-ta Corneliu Medrea nr. 214, Miercurea Sibiul",941,555,534,5,16,551,4,1000,445,395,156,1,13591,0
34,"Sibiu",144928,323,144928,,"ORAS MIERCUREA SIBIULUI",206,"Sala mare a Casei de Cultura Corneliu Medrea, P-ta Corneliu Medrea nr. 214, Miercurea Sibiul",792,457,438,3,16,451,6,900,443,314,137,1,13591,0
34,"Sibiu",144928,323,144928,,"ORAS MIERCUREA SIBIULUI",207,"Sala mica a Caminului cultural fost cinematograf, str. Principala, nr. 171, Apoldu de Sus",1450,743,717,19,7,735,8,1600,857,398,337,1,13591,0
34,"Sibiu",144928,323,144928,,"ORAS MIERCUREA SIBIULUI",208,"Sala mare a Caminului cultural Dobirca, str. Principala, nr. 62, Dobirca",633,313,309,4,0,309,4,700,387,231,78,1,13591,0
34,"Sibiu",144928,323,144928,,"ORAS MIERCUREA SIBIULUI",209,"Primaria Oeasului Miercurea Sibiului, Str. I.Macelariu nr. 210, CP 557151",0,133,0,133,0,132,1,300,167,93,39,1,13591,1
34,"Sibiu",143851,323,143851,,"ORAS OCNA SIBIULUI",210,"Scoala cu clasele I-VIII ciclu gimnazial Piata Traian nr. 2, Sala clasa",1899,1001,993,8,0,985,16,2100,1099,601,384,1,13595,0
34,"Sibiu",143851,323,143851,,"ORAS OCNA SIBIULUI",211,"Scoala cu clasele I-IV ciclu primar, Str.M.Viteazul nr. 82, Sala clasa",1476,894,890,4,0,887,7,1600,706,487,400,1,13595,0
34,"Sibiu",143851,323,143851,,"ORAS OCNA SIBIULUI",212,"Scoala cu clasele I-IV ciclu primar, Topircea 55, Sala clasa",118,74,66,8,0,73,1,100,26,44,29,1,13595,0
34,"Sibiu",143851,323,143851,,"ORAS OCNA SIBIULUI",213,"Centrul de informare turistica (CIT) Ocna Sibiului, Str. Bailor nr. 57, CP 555600",0,172,0,172,0,172,0,200,28,94,78,1,13595,1
34,"Sibiu",145499,323,145499,,"ORAS SALISTE",214,"Scoala generala, str. Ioan Lupas, nr. 24",1227,638,628,9,1,628,10,1400,762,338,290,1,13598,0
34,"Sibiu",145499,323,145499,,"ORAS SALISTE",215,"Scoala generala, str. Ioan Lupas, nr. 24",1113,592,582,9,1,592,0,1200,608,336,256,1,13598,0
34,"Sibiu",145499,323,145499,,"ORAS SALISTE",216,"Muzeul Etnografic ,,Maria Costachescu"", Gales, nr. 172 , Sala de Sedinte",270,164,155,9,0,164,0,300,136,99,65,1,13598,0
34,"Sibiu",145499,323,145499,,"ORAS SALISTE",217,"Primaria veche Vale, nr. 35",310,182,176,6,0,180,2,300,118,115,65,1,13598,0
34,"Sibiu",145499,323,145499,,"ORAS SALISTE",218,"Centrul de Documentare si Informare Sibiel, nr. 298",312,213,204,9,0,213,0,300,87,133,80,1,13598,0
34,"Sibiu",145499,323,145499,,"ORAS SALISTE",219,"Caminul Cultural Fantanele, nr. 27",197,102,94,7,1,101,1,200,98,58,43,1,13598,0
34,"Sibiu",145499,323,145499,,"ORAS SALISTE",220,"Scoala Generala Sacel, nr. 222A",411,252,247,5,0,247,5,500,248,172,75,1,13598,0
34,"Sibiu",145499,323,145499,,"ORAS SALISTE",221,"Scoala Generala Mag, nr. 120",310,212,206,6,0,209,3,300,88,141,68,1,13598,0
34,"Sibiu",145499,323,145499,,"ORAS SALISTE",222,"Scoala Generala Amnas, nr. 363",336,184,177,7,0,180,4,400,216,91,89,1,13598,0
34,"Sibiu",145499,323,145499,,"ORAS SALISTE",223,"Caminul Cultural Aciliu, nr. 274",212,119,110,9,0,118,1,200,81,82,36,1,13598,0
34,"Sibiu",145499,323,145499,,"ORAS SALISTE",224,"Grup Scolar Economic I.Lupas, str. I.Lupas nr. 24, CP 557236",0,206,0,206,0,205,1,400,194,112,93,1,13598,1
34,"Sibiu",145827,323,145827,,"ORAS TALMACIU",225,"Sala de Sedinte Primaria Orasului Talmaciu, str. Nicolae Balcescu nr.24",1221,621,610,11,0,616,5,1300,679,365,251,1,13609,0
34,"Sibiu",145827,323,145827,,"ORAS TALMACIU",226,"Scoala cu clasele I-VIII nr. 1, str. Nicolae Balcescu nr. 6",1099,621,617,4,0,607,14,1200,579,347,260,1,13609,0
34,"Sibiu",145827,323,145827,,"ORAS TALMACIU",227,"Spatiu apartinand  ConsumCoop Talmaciu,  Bl.1 din Piata Textilistilor",1620,899,881,17,1,891,8,1800,901,502,389,1,13609,0
34,"Sibiu",145827,323,145827,,"ORAS TALMACIU",228,"Grupul Scolar Economic J.Lebel, Str. Mihai Eminescu Nr.30",1246,659,652,7,0,657,2,1400,741,405,252,1,13609,0
34,"Sibiu",145827,323,145827,,"ORAS TALMACIU",229,"Scoala Generala Talmaciu II, nr.11",201,109,98,11,0,106,3,300,191,61,45,1,13609,0
34,"Sibiu",145827,323,145827,,"ORAS TALMACIU",230,"Scoala Generala Talmacel, nr.10",963,682,676,6,0,668,14,1100,418,278,390,1,13609,0
34,"Sibiu",145827,323,145827,,"ORAS TALMACIU",231,"Casa de Cultura Talmaciu, Str. N. Balcescu nr. 115, CP 555700",0,151,0,151,0,151,0,250,99,90,61,1,13609,1
34,"Sibiu",146012,323,146012,,"ALMA",232,"Scoala Generala cu clasele I-IV, Alma nr. 127",685,495,473,5,17,493,2,800,305,243,250,3,13613,0
34,"Sibiu",146012,323,146012,,"ALMA",233,"Caminul Cultural Smig nr. 238",731,572,550,6,16,564,8,800,228,307,257,3,13613,0
34,"Sibiu",146012,323,146012,,"ALMA",234,"Scoala Generala cu clasele I-IV, Giacas nr. 76",199,144,130,8,6,138,6,200,56,59,79,3,13613,0
34,"Sibiu",146012,323,146012,,"ALMA",235,"Primaria Comunei Alma, Str. M.Eminescu nr. 226, CP 557021",0,50,0,50,0,50,0,200,150,21,29,3,13613,1
34,"Sibiu",143888,323,143888,,"ALTINA",236," Sediul Primariei nr. 94",1010,643,589,8,46,639,4,1100,457,220,419,3,13617,0
34,"Sibiu",143888,323,143888,,"ALTINA",237,"Fostul Sediu CAP nr. 43 Benesti",200,137,128,9,0,137,0,200,63,23,114,3,13617,0
34,"Sibiu",143888,323,143888,,"ALTINA",238,"Fostul Sediu CAP nr. 77 Ghijasa de Sus",143,108,99,6,3,107,1,200,92,39,68,3,13617,0
34,"Sibiu",143888,323,143888,,"ALTINA",239,"Primaria Comunei Altina, sat Altina nr. 94, CP 550007",0,170,0,170,0,170,0,250,80,103,67,3,13617,1
34,"Sibiu",143922,323,143922,,"APOLDU DE JOS",240,"Caminul Cultural Apoldu de Jos nr. 77",905,534,531,3,0,530,4,1000,466,331,199,3,13621,0
34,"Sibiu",143922,323,143922,,"APOLDU DE JOS",241,"Scoala cu clasele I-IV, Singatin nr. 123",236,155,149,6,0,151,4,300,145,62,89,3,13621,0
34,"Sibiu",143922,323,143922,,"APOLDU DE JOS",242,"Parterul blocului cu locuinte sociale, sat Apoldu de Jos nr. 96, CP 557010",0,96,0,96,0,96,0,200,104,51,45,3,13621,1
34,"Sibiu",143959,323,143959,,"ARPASU DE JOS",243,"Primaria Arpasu de Jos, str.Principala nr. 214",901,474,467,6,1,467,7,1000,526,304,163,3,13624,0
34,"Sibiu",143959,323,143959,,"ARPASU DE JOS",244,"Scoala Generala cu clasele V-VIII Arpasu de Sus nr. 13",970,548,540,7,1,548,0,1100,552,377,171,3,13624,0
34,"Sibiu",143959,323,143959,,"ARPASU DE JOS",245,"Caminul Cultural, Nou Roman nr. 199",319,187,181,6,0,187,0,400,213,95,92,3,13624,0
34,"Sibiu",143959,323,143959,,"ARPASU DE JOS",246,"Scoala Generala clasele I-VIII, sat Arpasu de Jos nr. 75, CP 557015",0,125,0,125,0,125,0,200,75,73,52,3,13624,1
34,"Sibiu",143995,323,143995,,"ATEL",247,"Primaria Comunei Atel, str. P-ta Regele Mihai I, nr. 388",1138,658,642,7,9,651,7,1300,642,418,233,3,13628,0
34,"Sibiu",143995,323,143995,,"ATEL",248,"Scoala cu clasele I-IV, sat Dupus nr. 107",214,122,111,11,0,122,0,200,78,59,63,3,13628,0
34,"Sibiu",143995,323,143995,,"ATEL",249,"Primaria Comunei Atel, str. Regele Mikai I nr. 388, CP 557020",0,71,0,71,0,69,2,100,29,40,29,3,13628,1
34,"Sibiu",144116,323,144116,,"AXENTE SEVER",250,"Caminul Cultural , Axente Sever nr. 317",841,439,420,10,9,438,1,900,461,278,160,3,13631,0
34,"Sibiu",144116,323,144116,,"AXENTE SEVER",251,"Sala Festivitati, Axente Sever",1186,646,625,12,9,642,4,1300,654,478,164,3,13631,0
34,"Sibiu",144116,323,144116,,"AXENTE SEVER",252,"Caminul Cultural, sat Agirbiciu",1219,546,535,11,0,544,2,1300,754,370,174,3,13631,0
34,"Sibiu",144116,323,144116,,"AXENTE SEVER",253,"Caminul Cultural, sat Soala",272,163,156,7,0,162,1,300,137,113,49,3,13631,0
34,"Sibiu",144116,323,144116,,"AXENTE SEVER",254,"Scoala Generala clasele I-VIII, Axente Sever nr. 317, CP 557025",0,78,0,78,0,78,0,200,122,46,32,3,13631,1
34,"Sibiu",144152,323,144152,,"BAZNA",255,"Sala mare Primaria Bazna, nr.500",1448,780,778,2,0,770,10,1600,820,490,280,3,13635,0
34,"Sibiu",144152,323,144152,,"BAZNA",256,"Caminul Cultural, sat  Boian",1197,745,736,9,0,737,8,1300,555,574,163,3,13635,0
34,"Sibiu",144152,323,144152,,"BAZNA",257,"Scoala generala Velt",458,266,260,6,0,262,4,500,234,128,134,3,13635,0
34,"Sibiu",144152,323,144152,,"BAZNA",258,"Centrul de informare turistica (CIT) Bazna (linga Caminul Cultural), CP 557030",0,301,0,301,0,299,2,400,99,145,154,3,13635,1
34,"Sibiu",144198,323,144198,,"BIERTAN",259,"Primaria Biertan, Str. 1 Decembrie nr.19",1326,734,730,0,4,723,11,1500,766,394,329,3,13639,0
34,"Sibiu",144198,323,144198,,"BIERTAN",260,"Scoala Generala, sat Richis nr.4",628,365,359,1,5,363,2,700,335,237,126,3,13639,0
34,"Sibiu",144198,323,144198,,"BIERTAN",261,"Scoala Copsa Mare, Sala de clasa, Copsa Mare nr.141",398,254,245,7,2,251,3,400,146,100,151,3,13639,0
34,"Sibiu",144198,323,144198,,"BIERTAN",262,"Primaria Comunei Biertan, Str. 1 Decembrie 1918 nr.19, CP 557045",0,79,0,79,0,78,1,150,71,50,28,3,13639,1
34,"Sibiu",144232,323,144232,,"BIRGHIS",263," Gradinita Birghis Nr 75",648,381,355,7,19,376,5,700,319,196,180,3,13643,0
34,"Sibiu",144232,323,144232,,"BIRGHIS",264,"Scoala cu clasele  I- IV, Apos F. N.",212,126,117,9,0,126,0,200,74,31,95,3,13643,0
34,"Sibiu",144232,323,144232,,"BIRGHIS",265,"Scoala cu clasele I-IV, Pelisor nr.158",404,223,213,8,2,218,5,400,177,91,127,3,13643,0
34,"Sibiu",144232,323,144232,,"BIRGHIS",266,"Scoala cu  clasele  I - IV, Zlagna nr. 89",143,99,89,7,3,99,0,200,101,53,46,3,13643,0
34,"Sibiu",144232,323,144232,,"BIRGHIS",267,"Caminul Cultural, Ighisul  Vechi nr.34",240,131,126,5,0,125,6,300,169,57,68,3,13643,0
34,"Sibiu",144232,323,144232,,"BIRGHIS",268,"Caminul  Cultural, Vecerd  nr.125",108,77,69,7,1,75,2,100,23,19,56,3,13643,0
34,"Sibiu",144232,323,144232,,"BIRGHIS",269,"Gradinita Comunei Barghis, Barghis nr. 75, CP 557035",0,58,0,58,0,57,1,200,142,35,22,3,13643,1
34,"Sibiu",144303,323,144303,,"BLAJEL",270,"Caminul Cultural Blajel",1525,1030,978,14,38,1023,7,1700,670,597,426,3,13650,0
34,"Sibiu",144303,323,144303,,"BLAJEL",271,"Scoala Generala Paucea",360,309,289,13,7,304,5,400,91,161,143,3,13650,0
34,"Sibiu",144303,323,144303,,"BLAJEL",272,"Scoala Generala Romanesti",60,63,41,15,7,62,1,100,37,18,44,3,13650,0
34,"Sibiu",144303,323,144303,,"BLAJEL",273,"Primaria Comunei Blajel, Str. T.Vladimirescu nr. 70, CP 557050",0,106,0,106,0,103,3,300,194,42,61,3,13650,1
34,"Sibiu",146021,323,146021,,"BOITA",274,"Primaria comunei Boita, Str. Traian nr.263",1354,718,715,1,2,707,11,1500,782,421,286,3,13654,0
34,"Sibiu",146021,323,146021,,"BOITA",275,"Caminul Cultural Boita, STR. Traian nr. 263, CP 55701",0,57,0,57,0,57,0,100,43,32,25,3,13654,1
34,"Sibiu",144349,323,144349,,"BRATEIU",276,"Camin Cultural, Brateiu nr.33",1802,985,977,8,0,966,19,2000,1015,720,246,3,13663,0
34,"Sibiu",144349,323,144349,,"BRATEIU",277,"Scoala generala noua, Buzd  nr.35",816,473,457,16,0,469,4,900,427,372,97,3,13663,0
34,"Sibiu",144349,323,144349,,"BRATEIU",278,"Gradinita Brateiu, sat Brateiu nr. 51, CP 557055",0,51,0,51,0,50,1,150,99,30,20,3,13663,1
34,"Sibiu",144376,323,144376,,"BRADENI",279,"Primaria comunei Bradeni (sala mare), Bradeni nr. 31",667,388,381,7,0,384,4,700,312,206,178,3,13659,0
34,"Sibiu",144376,323,144376,,"BRADENI",280,"Sala mare in incinta cladirii fostei primarii Retis nr. 234",409,291,269,7,15,287,4,400,109,114,173,3,13659,0
34,"Sibiu",144376,323,144376,,"BRADENI",281,"Scoala Generala Teline nr.142, sala de clasa",90,74,65,7,2,73,1,100,26,29,44,3,13659,0
34,"Sibiu",144376,323,144376,,"BRADENI",282,"Primaria Comunei Bradeni, sat Bradeni nr. 31, CP 557060",0,79,0,79,0,78,1,200,121,33,45,3,13659,1
34,"Sibiu",144410,323,144410,,"BRUIU",283,"Primaria comunei, Bruiu nr. 19",443,232,220,2,10,228,4,500,268,99,129,3,13666,0
34,"Sibiu",144410,323,144410,,"BRUIU",284,"Scoala cu clasele I-IV, sat Somartin",338,135,124,6,5,135,0,400,265,60,75,3,13666,0
34,"Sibiu",144410,323,144410,,"BRUIU",285,"Primaria Comunei Bruiu, sat Bruiu nr. 19, CP 557065",0,65,0,65,0,65,0,100,35,27,38,3,13666,1
34,"Sibiu",144456,323,144456,,"CHIRPAR",286,"Scoala cu clasele I-VIII, Chirpar nr. 46",884,362,350,6,6,360,2,1000,638,188,172,3,13675,0
34,"Sibiu",144456,323,144456,,"CHIRPAR",287,"Camin Cultural, Vard nr. 27",267,174,161,6,7,170,4,300,126,110,60,3,13675,0
34,"Sibiu",144456,323,144456,,"CHIRPAR",288,"Scoala Generala cu clasele I-IV, Veseud nr. 113",149,79,71,6,2,79,0,200,121,37,42,3,13675,0
34,"Sibiu",144456,323,144456,,"CHIRPAR",289,"Camin Cultural Sasaus nr. 137",124,85,76,7,2,85,0,100,15,58,27,3,13675,0
34,"Sibiu",144456,323,144456,,"CHIRPAR",290,"Scoala generala clasele I-VIII sat Chirpar nr. 46, CP 557080",0,91,0,91,0,91,0,200,109,68,23,3,13675,1
34,"Sibiu",144508,323,144508,,"CARTA",291,"Camin Cultural, Comuna Carta nr. 240",939,444,441,3,0,441,3,1000,556,172,269,3,13670,0
34,"Sibiu",144508,323,144508,,"CARTA",292,"Primaria Comunei Carta, sat Carta nr. 104, CP 557070",0,58,0,58,0,57,1,100,42,28,29,3,13670,1
34,"Sibiu",144535,323,144535,,"CARTISOARA",293," Primaria comunei Cartisoara, nr. 55",1064,650,645,1,4,643,7,1200,550,490,153,3,13673,0
34,"Sibiu",144535,323,144535,,"CARTISOARA",294,"Primaria Comunei Cartisoara, sat Cartisoara nr. 55, CP 557075",0,102,0,102,0,102,0,200,98,61,41,3,13673,1
34,"Sibiu",143487,323,143487,,"CRISTIAN",295,"Primaria Cristian, str.I, nr.1",1835,955,942,13,0,949,6,2000,1045,696,253,3,13680,0
34,"Sibiu",143487,323,143487,,"CRISTIAN",296,"Gradinita Cristian, str.XI, nr.30",1320,734,726,5,3,725,9,1500,766,507,218,3,13680,0
34,"Sibiu",143487,323,143487,,"CRISTIAN",297,"Cantina Cristian, Str. XI nr 9A, CP 557085",0,135,0,135,0,135,0,200,65,99,36,3,13680,1
34,"Sibiu",144553,323,144553,,"DARLOS",298,"Camin Cultural, Dirlos nr. 590",1870,992,982,6,4,980,12,2100,1108,623,357,3,13682,0
34,"Sibiu",144553,323,144553,,"DARLOS",299,"Camin Cultural, Curciu nr. 188",672,377,368,9,0,375,2,700,323,302,73,3,13682,0
34,"Sibiu",144553,323,144553,,"DARLOS",300,"Camin Cultural, Valea Lunga nr. 52",191,130,121,7,2,128,2,200,70,104,24,3,13682,0
34,"Sibiu",144553,323,144553,,"DARLOS",301,"Primaria Comunei Darlos, sat Darlos nr. 590, CP 557090",0,83,0,83,0,83,0,150,67,49,34,3,13682,1
34,"Sibiu",144599,323,144599,,"GURA RAULUI",302,"Scoala Generala clasele V-VIII",1370,917,906,4,7,910,7,1500,583,689,221,3,13686,0
34,"Sibiu",144599,323,144599,,"GURA RAULUI",303,"Gradinita nr. 2, nr. adm. 538",1452,956,940,9,7,939,17,1600,644,654,285,3,13686,0
34,"Sibiu",144599,323,144599,,"GURA RAULUI",304,"Primaria Comunei Gura Raului, sat Gura Raului nr. 566, CP 557095",0,139,0,139,0,138,1,200,61,87,51,3,13686,1
34,"Sibiu",144615,323,144615,,"HOGHILAG",305,"Primaria Hoghilag, Str.Principala nr.305",924,532,528,4,0,522,10,1000,468,315,207,3,13688,0
34,"Sibiu",144615,323,144615,,"HOGHILAG",306,"Scoala cu cl.I-IV, Prod Str.Principala nr.111",224,157,151,6,0,154,3,200,43,113,41,3,13688,0
34,"Sibiu",144615,323,144615,,"HOGHILAG",307,"Sediul fostei Primarii, Valchid str.Principala nr.130",554,379,370,9,0,373,6,600,221,192,181,3,13688,0
34,"Sibiu",144615,323,144615,,"HOGHILAG",308,"Primaria Comunei Hoghilag, str. Principala nr. 305, CP 557100",0,63,0,63,0,63,0,100,37,30,33,3,13688,1
34,"Sibiu",144651,323,144651,,"IACOBENI",309,"Primarie comunei Iacobeni, nr. 57",709,389,388,1,0,383,6,800,411,114,269,3,13692,0
34,"Sibiu",144651,323,144651,,"IACOBENI",310,"Scoala cu clasele I-IV,  Stejerisu nr. 72",404,198,192,6,0,194,4,400,202,100,94,3,13692,0
34,"Sibiu",144651,323,144651,,"IACOBENI",311,"Scoala cu clasele I-IV, Netus nr. 53",354,192,179,11,2,188,4,400,208,82,106,3,13692,0
34,"Sibiu",144651,323,144651,,"IACOBENI",312,"Scoala cu clasele I-IV, Noistat nr. 171",405,206,202,4,0,200,6,400,194,105,95,3,13692,0
34,"Sibiu",144651,323,144651,,"IACOBENI",313,"Gradinita, Movile nr. 75",292,160,157,3,0,159,1,300,140,81,78,3,13692,0
34,"Sibiu",144651,323,144651,,"IACOBENI",314,"Primaria Comunei Iacobeni, str. Principala nr. 305, CP 557100",0,33,0,33,0,32,1,100,67,10,22,3,13692,1
34,"Sibiu",144713,323,144713,,"JINA",315,"Localul primariei Jina de la nr. ad-tiv 1210, sala de sedinta",1652,821,816,5,0,804,17,1800,979,690,114,3,13698,0
34,"Sibiu",144713,323,144713,,"JINA",316,"Scoala cu clasele I-IV Jina de la nr. ad-tiv 1440, vsala de clasa nr.5",1137,732,721,11,0,697,35,1300,568,529,168,3,13698,0
34,"Sibiu",144713,323,144713,,"JINA",317,"Primaria Comunei Jina, sala nr. 3, sat Jina nr. 1210, CP 557110",0,117,0,117,0,116,1,300,183,96,20,3,13698,1
34,"Sibiu",144731,323,144731,,"LASLEA",318,"Caminul Cultural, Comuna Laslea nr. 9",1147,706,699,7,0,697,9,1300,594,315,382,3,13700,0
34,"Sibiu",144731,323,144731,,"LASLEA",319,"Scoala Generala, Sat Roandola nr. 17",221,73,66,7,0,71,2,200,127,30,41,3,13700,0
34,"Sibiu",144731,323,144731,,"LASLEA",320,"Scoala Generala, Sat Noul Sasesc nr. 210",613,191,181,8,2,190,1,700,509,97,93,3,13700,0
34,"Sibiu",144731,323,144731,,"LASLEA",321,"Caminul Cultural, Sat Malincrav nr. 88",864,446,439,5,2,440,6,1000,554,224,216,3,13700,0
34,"Sibiu",144731,323,144731,,"LASLEA",322,"caminul Cultural, Sat Floresti nr. 79",92,77,65,9,3,77,0,100,23,40,37,3,13700,0
34,"Sibiu",144731,323,144731,,"LASLEA",323,"Caminul Cultural Laslea, str. Principala nr. 9, CP 557115",0,139,0,139,0,137,2,200,61,70,67,3,13700,1
34,"Sibiu",144795,323,144795,,"LOAMNES",324,"Caminul Cultural Mindra, nr. 66",279,211,198,8,5,206,5,300,89,67,139,3,13706,0
34,"Sibiu",144795,323,144795,,"LOAMNES",325,"Camin Cultural Loamnes, nr.139",528,397,381,4,12,396,1,600,203,153,243,3,13706,0
34,"Sibiu",144795,323,144795,,"LOAMNES",326,"Camin Cultural Alamor, str.Principala nr.331",666,432,418,6,8,424,8,700,268,205,219,3,13706,0
34,"Sibiu",144795,323,144795,,"LOAMNES",327,"Scoala Generala  Armeni,  nr.242 cladirea noua",496,283,277,6,0,279,4,500,217,143,136,3,13706,0
34,"Sibiu",144795,323,144795,,"LOAMNES",328,"Scoala Generala (cladirea noua), Hasag, str.Principala nr.122",491,309,292,9,8,304,5,500,191,148,156,3,13706,0
34,"Sibiu",144795,323,144795,,"LOAMNES",329,"Scoala Generala clasele I-VIII, sat Loamnes nr. 200, CP 557120",0,116,0,116,0,115,1,250,134,55,60,3,13706,1
34,"Sibiu",144866,323,144866,,"LUDOS",330," Primaria Ludos, str. Principala, nr.73",628,378,356,7,15,374,4,700,322,186,188,3,13713,0
34,"Sibiu",144866,323,144866,,"LUDOS",331,"Primaria Comunei Ludos, str. Principala nr. 73, CP 557130",0,83,0,83,0,83,0,200,117,35,48,3,13713,1
34,"Sibiu",144893,323,144893,,"MARPOD",332,"Primaria comunei, Marpod nr. 327",525,322,305,5,12,319,3,600,278,209,110,3,13716,0
34,"Sibiu",144893,323,144893,,"MARPOD",333,"Scoala Generala, Ilimbav nr. 82",156,118,105,8,5,118,0,200,82,80,38,3,13716,0
34,"Sibiu",144893,323,144893,,"MARPOD",334,"Primaria Comunei Marpod, sat marpod nr. 327, CP 557131",0,87,0,87,0,86,1,200,113,49,37,3,13716,1
34,"Sibiu",144964,323,144964,,"MERGHINDEAL",335,"Centrul de Asistenta pentru Copii de tip afterschool, str. Principala nr. 60",645,345,331,1,13,340,5,700,355,161,179,3,13719,0
34,"Sibiu",144964,323,144964,,"MERGHINDEAL",336,"Scoala cu clasele I-IV, nr. 314, Dealu Frumos",533,255,244,5,6,251,4,600,345,125,126,3,13719,0
34,"Sibiu",144964,323,144964,,"MERGHINDEAL",337,"Primaria Comunei merghindeal, sat merghindeal str. Principala nr. 60, CP 557140",0,37,0,37,0,36,1,100,63,18,18,3,13719,1
34,"Sibiu",144991,323,144991,,"MICASASA",338,"Camin Cultural Micasasa, str. 1 Decembrie nr. 293",1171,819,774,1,44,812,7,1200,381,413,399,3,13722,0
34,"Sibiu",144991,323,144991,,"MICASASA",339,"Scoala Generala Tapu, str. G.Cosbuc, nr. 187",638,308,298,10,0,302,6,700,392,163,139,3,13722,0
34,"Sibiu",144991,323,144991,,"MICASASA",340,"Scoala Generala Chesler, nr.119",79,55,45,10,0,53,2,100,45,30,23,3,13722,0
34,"Sibiu",144991,323,144991,,"MICASASA",341,"Primaria Comunei Micasasa, sat Micasasa str. 1 Decembrie nr. 144, CP 557145",0,100,0,100,0,100,0,200,100,37,63,3,13722,1
34,"Sibiu",145042,323,145042,,"MIHAILENI",342,"Localul Primariei, str. Principala nr. 165",303,171,165,6,0,171,0,300,129,96,75,3,13727,0
34,"Sibiu",145042,323,145042,,"MIHAILENI",343,"Localul Gradinitei, Ravasel nr. 111",239,138,131,7,0,137,1,300,162,68,69,3,13727,0
34,"Sibiu",145042,323,145042,,"MIHAILENI",344,"Localul Scolii Generale, Metis nr. 2",237,119,111,8,0,119,0,300,181,46,73,3,13727,0
34,"Sibiu",145042,323,145042,,"MIHAILENI",345,"Punct sanitar Mihaileni, sat Mihaileni str. Principala nr.3, CP 557155",0,45,0,45,0,45,0,100,55,25,20,3,13727,1
34,"Sibiu",145104,323,145104,,"MOSNA",346,"Scoala Generala clasele I-IV, sat Mosna nr. 452",1897,1151,1147,4,0,1139,12,2100,949,639,500,3,13733,0
34,"Sibiu",145104,323,145104,,"MOSNA",347,"Gradinita de Copiii, sat Alma Vii nr. 121",321,214,207,7,0,214,0,400,186,99,115,3,13733,0
34,"Sibiu",145104,323,145104,,"MOSNA",348,"Scoala Generala clasele I-VIII, sat Nemsa nr. 124",474,309,299,8,2,308,1,500,191,121,187,3,13733,0
34,"Sibiu",145104,323,145104,,"MOSNA",349,"Scoala generala clasele I-IV, sat Mosna nr. 452, CP 557160",0,65,0,65,0,64,1,100,35,22,42,3,13733,1
34,"Sibiu",145140,323,145140,,"NOCRICH",350,"Caminul Cultural, sat Nocrich nr. 206",1085,588,585,3,0,582,6,1200,612,386,196,3,13737,0
34,"Sibiu",145140,323,145140,,"NOCRICH",351,"Gradinita, sat Hosman nr. 224",669,299,292,6,1,296,3,700,401,173,123,3,13737,0
34,"Sibiu",145140,323,145140,,"NOCRICH",352,"Scoala cu clasele I-IV, sat Fofeldea nr. 190",255,195,186,9,0,192,3,300,105,167,25,3,13737,0
34,"Sibiu",145140,323,145140,,"NOCRICH",353,"Scoala cu clasele I-IV, sat Tichindeal nr. 67",123,93,86,7,0,90,3,100,7,63,27,3,13737,0
34,"Sibiu",145140,323,145140,,"NOCRICH",354,"Scoala cu clasele I-IV, sat Ghijasa de Jos nr. 66",78,49,39,10,0,49,0,100,51,39,10,3,13737,0
34,"Sibiu",145140,323,145140,,"NOCRICH",355,"Scoala Generala clasele I-VIII, sat Nocrich nr. 158, CP 557165",0,77,0,77,0,76,1,202,125,48,28,3,13737,1
34,"Sibiu",145202,323,145202,,"ORLAT",356,"Gradinita Orlat , strada Victoriei nr. 630",1234,714,702,9,3,709,5,1400,686,533,176,3,13743,0
34,"Sibiu",145202,323,145202,,"ORLAT",357,"Gradinita Orlat , strada Victoriei nr. 630",1350,809,805,4,0,806,3,1500,691,565,241,3,13743,0
34,"Sibiu",145202,323,145202,,"ORLAT",358,"Primaria Comunei Orlat, sat Orlat str. A. Iancu nr. 202, CP 557170",0,86,0,86,0,86,0,100,14,44,42,3,13743,1
34,"Sibiu",145220,323,145220,,"PAUCA",359,"Primaria comunei - sediul nou, Pauca nr. 96",717,362,353,5,4,360,2,800,438,273,87,3,13745,0
34,"Sibiu",145220,323,145220,,"PAUCA",360,"Scoala Generala , sat Bogatu Roman nr 130",430,344,340,4,0,342,2,500,156,293,49,3,13745,0
34,"Sibiu",145220,323,145220,,"PAUCA",361,"Scoala Generala I-IV,  Brosteni nr. 70",307,248,243,5,0,247,1,300,52,175,72,3,13745,0
34,"Sibiu",145220,323,145220,,"PAUCA",362,"Scoala Generala I-IV, Presaca nr.112A",383,272,266,6,0,268,4,400,128,177,91,3,13745,0
34,"Sibiu",145220,323,145220,,"PAUCA",363,"Primaria Comunei Pauca, sat Pauca nr. 172, CP 557175",0,40,0,40,0,40,0,100,60,32,8,3,13745,1
34,"Sibiu",145275,323,145275,,"POIANA SIBIULUI",364,"Scoala cu clasele I-VIII Vadu, nr.1332",1821,941,933,8,0,930,11,1950,1009,642,288,3,13750,0
34,"Sibiu",145275,323,145275,,"POIANA SIBIULUI",365,"Scoala Generala clasele I-VIII, sat Poiana Sibiului nr. 1331, CP 557180",0,223,0,223,0,223,0,250,27,150,73,3,13750,1
34,"Sibiu",143502,323,143502,,"POPLACA",366,"Scoala  Generala clasele I-VIII Poplaca, nr.376",1353,786,780,6,0,782,4,1500,714,581,201,3,13752,0
34,"Sibiu",143502,323,143502,,"POPLACA",367,"Scoala Generala clasele I-VIII, sat Poplaca nr. 376, CP 557185",0,69,0,69,0,69,0,100,31,41,28,3,13752,1
34,"Sibiu",145293,323,145293,,"PORUMBACU DE JOS",368,"Camin Cultural Porumbacu de Jos",903,457,448,9,0,451,6,1000,543,334,117,3,13754,0
34,"Sibiu",145293,323,145293,,"PORUMBACU DE JOS",369,"Camin Cultural Porumbacu de Sus",688,443,433,10,0,438,5,800,357,232,206,3,13754,0
34,"Sibiu",145293,323,145293,,"PORUMBACU DE JOS",370,"Camin Cultural , sat Scoreiu",557,266,261,5,0,264,2,600,334,167,97,3,13754,0
34,"Sibiu",145293,323,145293,,"PORUMBACU DE JOS",371,"Camin Cultural , sat Sarata",295,171,165,6,0,168,3,300,129,117,51,3,13754,0
34,"Sibiu",145293,323,145293,,"PORUMBACU DE JOS",372,"Scoala generala, sat Colun",147,100,89,11,0,97,3,200,100,50,47,3,13754,0
34,"Sibiu",145293,323,145293,,"PORUMBACU DE JOS",373,"Primaria Comunei Porumbacu de Jos, sat Porumbacu de Jos nr. 253, CP 557190",0,125,0,125,0,125,0,300,175,76,49,3,13754,1
34,"Sibiu",145355,323,145355,,"RACOVITA",374,"Camin Cultural,  Racovita nr. 90",1773,982,969,12,1,976,6,2000,1018,737,239,3,13760,0
34,"Sibiu",145355,323,145355,,"RACOVITA",375,"Scoala Generala sat Sebesul de Sus nr. 34",606,356,350,6,0,353,3,700,344,253,100,3,13760,0
34,"Sibiu",145355,323,145355,,"RACOVITA",376,"Primaria Comunei Racovita, sat Racovita nr. 416, CP 557195",0,46,0,46,0,45,1,100,54,27,18,3,13760,1
34,"Sibiu",143520,323,143520,,"RASINARI",377,"Scoala Generala nr.2, comuna Rasinari nr. 539",1523,821,795,26,0,815,6,1700,879,625,190,3,13763,0
34,"Sibiu",143520,323,143520,,"RASINARI",378,"Scoala Generala nr.1, comuna Rasinari nr.1512",1405,691,662,29,0,690,1,1500,809,505,185,3,13763,0
34,"Sibiu",143520,323,143520,,"RASINARI",379,"Caminul Cultural, Comuna Rasinari nr.1527",1514,858,847,11,0,854,4,1700,842,626,228,3,13763,0
34,"Sibiu",143520,323,143520,,"RASINARI",380,"Caminul Cultural Rasinari, str. Octavian Goga nr. 1527, CP 557200",0,138,0,138,0,137,1,200,62,99,38,3,13763,1
34,"Sibiu",145382,323,145382,,"RAU SADULUI",381,"Primaria comunei Riu Sadului, nr.247",494,252,250,2,0,250,2,500,248,170,80,3,13766,0
34,"Sibiu",145382,323,145382,,"RAU SADULUI",382,"Hidrocentrala Sadu V, sat Rau Sadului nr. 362, CP 557025",0,46,0,46,0,45,1,100,54,15,30,3,13766,1
34,"Sibiu",145408,323,145408,,"ROSIA",383,"Primaria Rosia, nr.22",1053,527,518,8,1,522,5,1200,673,357,165,3,13768,0
34,"Sibiu",145408,323,145408,,"ROSIA",384,"Scoala Generala I-VIII, Nou nr.373",1200,664,655,9,0,654,10,1300,636,486,168,3,13768,0
34,"Sibiu",145408,323,145408,,"ROSIA",385,"Scoala Generala V-VIII, Daia nr.177",672,340,331,9,0,338,2,700,360,268,70,3,13768,0
34,"Sibiu",145408,323,145408,,"ROSIA",386,"Scoala Generala I-VIII, Casolt nr.145",542,262,249,13,0,261,1,600,338,141,120,3,13768,0
34,"Sibiu",145408,323,145408,,"ROSIA",387,"Caminul Cultural Cornatel, nr. 43A",412,190,185,5,0,190,0,500,310,131,59,3,13768,0
34,"Sibiu",145408,323,145408,,"ROSIA",388,"Primaria Comunei Rosia, sat Rosia nr. 22, CP 557210",0,42,0,42,0,42,0,150,108,28,14,3,13768,1
34,"Sibiu",145471,323,145471,,"SADU",389,"Caminul Cultural al comunei Sadu, str. I.M. Klein, nr.42",943,517,516,0,1,512,5,1000,483,352,160,3,13775,0
34,"Sibiu",145471,323,145471,,"SADU",390,"Caminul Cultural al comunei Sadu, str. I.M. Klein, nr.42",1021,601,599,2,0,600,1,1100,499,441,159,3,13775,0
34,"Sibiu",145471,323,145471,,"SADU",391,"Primaria Comunei Sadu, str. I.M.Klein nr. 36, CP 557220",0,60,0,60,0,60,0,100,40,45,15,3,13775,1
34,"Sibiu",145603,323,145603,,"SLIMNIC",392,"Scoala Generala Slimnic, str. Principala nr.7",1036,497,491,3,3,497,0,1100,603,370,127,3,13792,0
34,"Sibiu",145603,323,145603,,"SLIMNIC",393,"Scoala Generala Slimnic, str. Principala nr.7",1214,679,663,11,5,674,5,1300,621,544,130,3,13792,0
34,"Sibiu",145603,323,145603,,"SLIMNIC",394,"Scoala Generala Rusi, nr.157",729,471,439,11,21,466,5,800,329,224,242,3,13792,0
34,"Sibiu",145603,323,145603,,"SLIMNIC",395,"Scoala Generala Veseud",180,115,97,10,8,115,0,200,85,50,65,3,13792,0
34,"Sibiu",145603,323,145603,,"SLIMNIC",396,"Primaria Comunei Slimnic, sat Slimnic, str. Principala nr.6, CP 557240",0,127,0,127,0,127,0,200,73,80,47,3,13792,1
34,"Sibiu",145667,323,145667,,"SEICA MARE",397,"Scoala Generala nr.1, Sos. Sibiului nr.416",943,497,473,13,11,487,10,1000,503,362,125,3,13777,0
34,"Sibiu",145667,323,145667,,"SEICA MARE",398,"Scoala Generala nr.1, Sos. Sibiului nr.416",873,439,427,11,1,435,4,1000,561,305,130,3,13777,0
34,"Sibiu",145667,323,145667,,"SEICA MARE",399,"Scoala Generala nr.2, Str. Principala nr.770",905,537,505,23,9,532,5,1000,463,365,167,3,13777,0
34,"Sibiu",145667,323,145667,,"SEICA MARE",400,"Caminul Cultural Boarta",357,200,191,9,0,199,1,400,200,145,54,3,13777,0
34,"Sibiu",145667,323,145667,,"SEICA MARE",401,"Scoala Generala Buia",464,229,209,11,9,227,2,500,271,176,51,3,13777,0
34,"Sibiu",145667,323,145667,,"SEICA MARE",402,"Scoala Generala Stenea",135,94,84,10,0,93,1,100,6,63,30,3,13777,0
34,"Sibiu",145667,323,145667,,"SEICA MARE",403,"Imobil situat la nr. 103,  Petis",53,28,18,10,0,27,1,100,72,18,9,3,13777,0
34,"Sibiu",145667,323,145667,,"SEICA MARE",404,"Caminul Cultural Seica Mare, sat Seica Mare nr. 316, CP 557245",0,141,0,141,0,137,4,300,159,88,49,3,13777,1
34,"Sibiu",145738,323,145738,,"SEICA MICA",405," Primaria Seica Mica, str. Principala nr. 75",1065,453,450,3,0,451,2,1200,747,314,137,3,13784,0
34,"Sibiu",145738,323,145738,,"SEICA MICA",406,"Sediul fostului CAP, Sorostin nr. 82",458,291,277,8,6,285,6,500,209,123,162,3,13784,0
34,"Sibiu",145738,323,145738,,"SEICA MICA",407,"Scoala Generala clasele I-VIII, sat Seica Mica nr. 382, CP 557255",0,59,0,59,0,59,0,100,41,36,23,3,13784,1
34,"Sibiu",143557,323,143557,,"SELIMBAR",408,"Scoala Generala Selimbar str. M. Viteazu nr. 234",1066,554,548,6,0,553,1,1200,646,311,242,3,13787,0
34,"Sibiu",143557,323,143557,,"SELIMBAR",409,"Scoala Generala Selimbar str. M. Viteazu nr. 234",1421,874,858,16,0,864,10,1600,726,458,406,3,13787,0
34,"Sibiu",143557,323,143557,,"SELIMBAR",410,"Camin Cultural Vestem, str. Principala nr. 149",1359,914,900,13,1,906,8,1500,586,540,366,3,13787,0
34,"Sibiu",143557,323,143557,,"SELIMBAR",411,"Camin Cultural Mohu nr.313",575,325,320,5,0,325,0,600,275,214,111,3,13787,0
34,"Sibiu",143557,323,143557,,"SELIMBAR",412,"Camin Cultural Bungard nr.18",464,239,234,5,0,238,1,500,261,151,87,3,13787,0
34,"Sibiu",143557,323,143557,,"SELIMBAR",413,"Scoala Generala M.Viteazu Selimbar, str. Mviteazu nr. 234, CP 557260",0,501,0,501,0,499,2,600,99,215,284,3,13787,1
34,"Sibiu",145765,323,145765,,"SURA MARE",414,"Sala de Sport, str. Principala nr. 3",1258,651,634,17,0,642,9,1400,749,461,181,3,13798,0
34,"Sibiu",145765,323,145765,,"SURA MARE",415,"Sala de Sport, str. Principala nr. 3",1213,612,597,14,1,607,5,1300,688,417,190,3,13798,0
34,"Sibiu",145765,323,145765,,"SURA MARE",416,"Camin Cultural sat Hamba, str. Cooperativei nr.53",625,337,329,8,0,335,2,700,363,260,75,3,13798,0
34,"Sibiu",145765,323,145765,,"SURA MARE",417,"Scoala Generala clasele I-VIII, sat Sura Mare str. Principala nr. 3, CP 557265",0,115,0,115,0,114,1,200,85,72,42,3,13798,1
34,"Sibiu",145792,323,145792,,"SURA MICA",418,"Scoala cu clasele I-VIII, Sura Mica nr. 407",1640,838,830,8,0,836,2,1800,962,597,239,3,13801,0
34,"Sibiu",145792,323,145792,,"SURA MICA",419,"Scoala cu clasele I-IV, Rusciori nr. 96",501,294,286,8,0,273,21,600,306,190,83,3,13801,0
34,"Sibiu",145792,323,145792,,"SURA MICA",420,"Scoala Generala clasele I-VIII, sat Sura Mica nr. 407, CP 557270",0,91,0,91,0,90,1,200,109,46,44,3,13801,1
34,"Sibiu",145907,323,145907,,"TILISCA",421,"Primaria Tilisca, str. Scolii nr. 531",888,588,570,9,9,584,4,1000,412,313,271,3,13807,0
34,"Sibiu",145907,323,145907,,"TILISCA",422,"Scoala Rod, str. Principala nr. 10",355,223,218,4,1,222,1,400,177,142,80,3,13807,0
34,"Sibiu",145907,323,145907,,"TILISCA",423,"Scoala Generala clasele I-VIII, corp B, sala 1, sat Tilisca str. Scolii nr. 483, CP 557280",0,98,0,98,0,98,0,200,102,68,30,3,13807,1
34,"Sibiu",143646,323,143646,,"TARNAVA",424,"Scoala Generala nr. 2, str. Libertatii nr. 1",1138,723,712,3,8,718,5,1300,577,424,294,3,13804,0
34,"Sibiu",143646,323,143646,,"TARNAVA",425,"Scoala Generala nr. 2, str. Libertatii nr. 2",1218,803,780,2,21,799,4,1300,497,422,377,3,13804,0
34,"Sibiu",143646,323,143646,,"TARNAVA",426,"Scoala Generala clasele I-VIII, sat Tarnava str. 1 Decembrie nr. 1",0,65,0,65,0,65,0,100,35,32,33,3,13804,1
34,"Sibiu",145934,323,145934,,"TURNU ROSU",427,"Club , nr.470",1435,813,812,1,0,809,4,1600,787,497,312,3,13810,0
34,"Sibiu",145934,323,145934,,"TURNU ROSU",428,"Sebesu de Jos, Gradinita nr.107",511,314,310,4,0,310,4,600,286,179,131,3,13810,0
34,"Sibiu",145934,323,145934,,"TURNU ROSU",429,"Primaria Comunei Turnu Rosu, sat Turnu Rosu str. Oltet nr. 54, CP 557285",0,127,0,127,0,125,2,150,23,70,55,3,13810,1
34,"Sibiu",145961,323,145961,,"VALEA VIILOR",430,"Camin Cultural Valea Viilor nr. 344",1297,793,744,3,46,782,11,1400,607,426,356,3,13813,0
34,"Sibiu",145961,323,145961,,"VALEA VIILOR",431,"Camin Cultural, Motis nr. 184",524,258,239,10,9,257,1,600,342,138,119,3,13813,0
34,"Sibiu",145961,323,145961,,"VALEA VIILOR",432,"Centrul de informare turistica, sat Valea Villor nr. 120, CP 557290",0,64,0,64,0,63,1,150,86,32,31,3,13813,1
34,"Sibiu",145998,323,145998,,"VURPAR",433,"Cinematograf,  str. Principala nr.711, sala mica",1103,604,596,8,0,590,14,1200,596,326,264,3,13816,0
34,"Sibiu",145998,323,145998,,"VURPAR",434,"Scoala Generala nr.1, nr. 367",788,376,369,5,2,373,3,900,524,271,102,3,13816,0
34,"Sibiu",145998,323,145998,,"VURPAR",435,"Primaria Comunei Vurpar, sat Vurpar nr. 455, CP 557295",0,57,0,57,0,56,1,100,43,37,19,3,13816,1
35,"Suceava",146263,332,146263,,"MUNICIPIUL SUCEAVA",1,"PRIMARIA MUNICIPIULUI SUCEAVA, BULEVARDUL 1 MAI, NR. 5A",1526,952,941,11,0,934,18,1600,648,387,547,1,13819,0
35,"Suceava",146263,332,146263,,"MUNICIPIUL SUCEAVA",2,"COLEGIUL NATIONAL  PETRU RARES   STRADA MIHAI VITEAZUL, NR. 29, SALA A",1804,1171,1155,15,1,1159,12,1900,729,544,615,1,13819,0
35,"Suceava",146263,332,146263,,"MUNICIPIUL SUCEAVA",3,"COLEGIUL NATIONAL  PETRU RARES  , STRADA MIHAI VITEAZUL, NR. 29, SALA B",1714,1100,1078,21,1,1089,11,1800,700,410,679,1,13819,0
35,"Suceava",146263,332,146263,,"MUNICIPIUL SUCEAVA",4,"COLEGIUL NATIONAL  STEFAN CEL MARE , STRADA VASILE ALECSANDRI, NR. 3",1453,918,902,16,0,904,14,1500,582,437,467,1,13819,0
35,"Suceava",146263,332,146263,,"MUNICIPIUL SUCEAVA",5,"CASA DE CULTURA A SINDICATELOR, STRADA STEFAN CEL MARE, NR. 20A",1777,1101,1090,8,3,1086,15,1800,699,496,590,1,13819,0
35,"Suceava",146263,332,146263,,"MUNICIPIUL SUCEAVA",6,"SCOALA  GENERALA NR .1,  STRADA TUDOR VLADIMIRESCU, NR. 5",1139,699,688,11,0,684,15,1200,501,300,384,1,13819,0
35,"Suceava",146263,332,146263,,"MUNICIPIUL SUCEAVA",7,"COLEGIUL TEHNIC  SAMUIL ISOPESCU , STRADA SAMUIL ISOPESCU, NR.19",1261,813,804,9,0,793,20,1300,487,341,452,1,13819,0
35,"Suceava",146263,332,146263,,"MUNICIPIUL SUCEAVA",8,"LICEUL DE ARTA CIPRIAN PORUMBESCU  STR. PETRU RARES, NR. 8, SALA A",802,508,498,9,1,500,8,900,392,218,282,1,13819,0
35,"Suceava",146263,332,146263,,"MUNICIPIUL SUCEAVA",9,"LICEUL DE ARTA\  CIPRIAN PORUMBESCU , STRADA PETRU RARES, NR. 8, SALA B",1391,813,798,15,0,796,17,1502,689,409,387,1,13819,0
35,"Suceava",146263,332,146263,,"MUNICIPIUL SUCEAVA",10,"SCOALA GENERALA NR. 3, STRADA MARASESTI, NR. 38, SALA A",1163,774,757,17,0,766,8,1200,426,333,433,1,13819,0
35,"Suceava",146263,332,146263,,"MUNICIPIUL SUCEAVA",11,"SCOALA GENERALA NR. 3,  STRADA MARASESTI, NR. 38, SALA B",1196,782,762,20,0,772,10,1300,518,303,469,1,13819,0
35,"Suceava",146263,332,146263,,"MUNICIPIUL SUCEAVA",12,"COLEGIUL ECONOMIC  DIMITRIE CANTEMIR ,  ALEEA PROFESOR LECA MORARIU, NR. 17",1226,739,729,10,0,729,10,1300,561,313,416,1,13819,0
35,"Suceava",146263,332,146263,,"MUNICIPIUL SUCEAVA",13,"GRADINITA CU PROGRAM NORMAL NR 4, ALEEA PROFESOR LECA MORARIU",1638,950,940,10,0,931,19,1700,750,435,496,1,13819,0
35,"Suceava",146263,332,146263,,"MUNICIPIUL SUCEAVA",14,"UNIVERSITATEA   STEFAN CEL MARE ,  STRADA UNIVERSITATII, NR. 13",953,547,527,20,0,538,9,1000,453,239,299,1,13819,0
35,"Suceava",146263,332,146263,,"MUNICIPIUL SUCEAVA",15,"DIRECTIA  SILVICA SUCEAVA, BULEVARDUL 1 MAI, NR. 6",1069,618,589,11,18,616,2,1100,482,276,340,1,13819,0
35,"Suceava",146263,332,146263,,"MUNICIPIUL SUCEAVA",16,"COLEGIUL DE INFORMATICA  SPIRU HARET ,  STRADA  ZORILOR, NR. 19, SALA A",1269,738,723,15,0,724,14,1300,562,391,333,1,13819,0
35,"Suceava",146263,332,146263,,"MUNICIPIUL SUCEAVA",17,"COLEGIUL DE INFORMATICA  SPIRU HARET , STRADA ZORILOR, NR. 19, SALA B",1074,641,629,12,0,633,8,1100,459,301,332,1,13819,0
35,"Suceava",146263,332,146263,,"MUNICIPIUL SUCEAVA",18,"GRADINITA CU PROGRAM PRELUNGIT NR. 7 ABC, STRADA ZORILOR, NR. 10",1519,878,866,12,0,861,17,1600,722,399,462,1,13819,0
35,"Suceava",146263,332,146263,,"MUNICIPIUL SUCEAVA",19,"SCOALA  GENERALA  NR. 4, STRADA ZORILOR, NR. 10A,  SALA A",1629,909,891,17,1,901,8,1700,791,432,469,1,13819,0
35,"Suceava",146263,332,146263,,"MUNICIPIUL SUCEAVA",20,"SCOALA  GENERALA NR. 4,  STRADA ZORILOR, NR.10A,  SALA B",1448,852,838,14,0,840,12,1500,648,414,426,1,13819,0
35,"Suceava",146263,332,146263,,"MUNICIPIUL SUCEAVA",21,"SCOALA  GENERALA NR. 8, ALEEA JUPITER, NR. 12",1994,1098,1082,16,0,1075,23,2100,1002,579,496,1,13819,0
35,"Suceava",146263,332,146263,,"MUNICIPIUL SUCEAVA",22,"GRADINITA NR. 5, ALEEA JUPITER, F.N.",1809,945,931,12,2,939,6,1900,955,484,455,1,13819,0
35,"Suceava",146263,332,146263,,"MUNICIPIUL SUCEAVA",23,"GRADINITA NR.1 ALEEA LALELELOR, F.N.",1481,822,812,10,0,813,9,1600,778,413,400,1,13819,0
35,"Suceava",146263,332,146263,,"MUNICIPIUL SUCEAVA",24,"LICEUL CU PROGRAM SPORTIV, BULEVARDUL GEORGE ENESCU, NR. 26 A,  SALA A",1656,902,894,8,0,893,9,1700,798,434,459,1,13819,0
35,"Suceava",146263,332,146263,,"MUNICIPIUL SUCEAVA",25,"LICEUL CU PROGRAM SPORTIV, BULEVARDUL GEORGE ENESCU, NR. 26 A, SALA B",1918,973,963,10,0,964,9,2000,1027,490,474,1,13819,0
35,"Suceava",146263,332,146263,,"MUNICIPIUL SUCEAVA",26,"COLEGIUL NATIONAL  MIHAI EMINESCU , STRADA MARASESTI, NR. 57, SALA A",1354,694,686,8,0,688,6,1400,706,343,345,1,13819,0
35,"Suceava",146263,332,146263,,"MUNICIPIUL SUCEAVA",27,"COLEGIUL NATIONAL  MIHAI EMINESCU , STRADA MARASESTI, NR. 57, SALA B",1558,926,913,13,0,916,10,1600,674,451,465,1,13819,0
35,"Suceava",146263,332,146263,,"MUNICIPIUL SUCEAVA",28,"GRADINITA CU PROGRAM PRELUNGIT NR. 4, STRADA MARASESTI, NR. 55",1820,1033,1018,14,1,1015,18,1900,867,500,515,1,13819,0
35,"Suceava",146263,332,146263,,"MUNICIPIUL SUCEAVA",29,"COLEGIUL TEHNIC DE INDUSTRIE ALIMENTARA, STRADA DIMITRIE CANTEMIR, NR. 5, SALA A",1921,1040,1030,10,0,1024,16,2000,960,535,489,1,13819,0
35,"Suceava",146263,332,146263,,"MUNICIPIUL SUCEAVA",30,"COLEGIUL TEHNIC DE INDUSTRIE ALIMENTARA,  STRADA DIMITRIE CANTEMIR, NR. 5, SALA B",1849,1091,1080,11,0,1077,14,1900,809,517,560,1,13819,0
35,"Suceava",146263,332,146263,,"MUNICIPIUL SUCEAVA",31,"GRADINITA CU PROGRAM PRELUNGIT  NR. 3, STRADA DOBROGEANU GHEREA, NR. 35",594,358,349,9,0,353,5,700,342,164,189,1,13819,0
35,"Suceava",146263,332,146263,,"MUNICIPIUL SUCEAVA",32,"S.C.TRUST ORIZONT S.A., STRADA CERNAUTI, NR. 55",463,245,231,14,0,243,2,600,355,142,101,1,13819,0
35,"Suceava",146263,332,146263,,"MUNICIPIUL SUCEAVA",33,"COLEGIUL TEHNIC  PETRU MUSAT , CALEA UNIRII, NR. 15",589,305,295,10,0,297,8,700,395,172,125,1,13819,0
35,"Suceava",146263,332,146263,,"MUNICIPIUL SUCEAVA",34,"S.C. ROMTELECOM  S.A., STRADA BISTRITEI, NR. 11B",2177,1116,1107,9,0,1099,17,2300,1184,630,469,1,13819,0
35,"Suceava",146263,332,146263,,"MUNICIPIUL SUCEAVA",35,"INSPECTORATUL TERITORIAL DE MUNCA, STRADA BISTRITEI, NR. 11",2219,1143,1130,12,1,1130,13,2300,1157,601,529,1,13819,0
35,"Suceava",146263,332,146263,,"MUNICIPIUL SUCEAVA",36,"AGENTIA PENTRU PROTECTIA MEDIULUI, STRADA BISTRITEI, NR. 1BIS",2268,1251,1235,15,1,1222,29,2300,1049,652,570,1,13819,0
35,"Suceava",146263,332,146263,,"MUNICIPIUL SUCEAVA",37,"SCOALA GENERALA  NR. 9, BULEVARDUL PREFECT GAVRIL TUDORAS, NR. 13,  SALA A",1988,1088,1077,11,0,1068,20,2100,1012,528,540,1,13819,0
35,"Suceava",146263,332,146263,,"MUNICIPIUL SUCEAVA",38,"SCOALA GENERALA  NR. 9, BULEVARDUL PREFECT GAVRIL TUDORAS, NR. 13, SALA B",2124,1162,1150,12,0,1146,16,2200,1038,608,538,1,13819,0
35,"Suceava",146263,332,146263,,"MUNICIPIUL SUCEAVA",39,"SCOALA  GENERALA NR. 9, BULEVARDUL PREFECT GAVRIL TUDORAS, NR. 13, SALA C",2197,1103,1095,7,1,1090,13,2300,1197,625,465,1,13819,0
35,"Suceava",146263,332,146263,,"MUNICIPIUL SUCEAVA",40,"GRADINITA NR. 9, STRADA JEAN BART, NR. 14",2081,951,929,22,0,936,15,2200,1249,608,328,1,13819,0
35,"Suceava",146263,332,146263,,"MUNICIPIUL SUCEAVA",41,"ATELIER ZONA CFR, STRADA NICOLAE IORGA, NR. 9",2392,1281,1258,22,1,1268,13,2500,1219,715,553,1,13819,0
35,"Suceava",146263,332,146263,,"MUNICIPIUL SUCEAVA",42,"SCOALA GENERALA NR. 10, STRADA BALADEI, NR. 6, SALA A",2006,1004,990,14,0,991,13,2100,1096,591,400,1,13819,0
35,"Suceava",146263,332,146263,,"MUNICIPIUL SUCEAVA",43,"SCOALA  NR. 10, STRADA BALADEI, NR. 6, SALA B",1947,991,977,13,1,984,7,2100,1109,598,386,1,13819,0
35,"Suceava",146263,332,146263,,"MUNICIPIUL SUCEAVA",44,"GRUPUL SCOLAR NR. 1, CALEA UNIRII, NR. 49, SALA A",2078,1119,1106,13,0,1109,10,2100,981,702,407,1,13819,0
35,"Suceava",146263,332,146263,,"MUNICIPIUL SUCEAVA",45,"GRUPUL SCOLAR NR. 1, CALEA UNIRII, NR. 49, SALA B",2122,1081,1072,9,0,1072,9,2200,1119,674,398,1,13819,0
35,"Suceava",146263,332,146263,,"MUNICIPIUL SUCEAVA",46,"SCOALA  GENERALA NR. 5, CALEA UNIRII, NR. 53,  CORP A",1618,882,858,24,0,872,10,1700,818,522,350,1,13819,0
35,"Suceava",146263,332,146263,,"MUNICIPIUL SUCEAVA",47,"CENTRUL  SCOLAR SUCEAVA, CALEA UNIRII, NR. 82, CORP A",2140,1088,1073,15,0,1062,26,2200,1112,659,403,1,13819,0
35,"Suceava",146263,332,146263,,"MUNICIPIUL SUCEAVA",48,"CENTRUL SCOLAR SUCEAVA, CALEA UNIRII, NR. 82,  CORP B",2022,984,967,17,0,976,8,2100,1116,628,348,1,13819,0
35,"Suceava",146263,332,146263,,"MUNICIPIUL SUCEAVA",49,"GRADINITA NR. 12, STRADA MUNCII, F.N.",1814,876,861,15,0,865,11,1900,1024,529,336,1,13819,0
35,"Suceava",146263,332,146263,,"MUNICIPIUL SUCEAVA",50,"SCOALA GENERALA NR. 11, STRADA PACII, NR. 8, SALA A",2168,1075,1066,9,0,1058,17,2200,1125,681,377,1,13819,0
35,"Suceava",146263,332,146263,,"MUNICIPIUL SUCEAVA",51,"SCOALA GENERALA NR. 11, STRADA PACII, NR. 8, SALA B",2125,1023,1011,12,0,1010,13,2200,1177,613,397,1,13819,0
35,"Suceava",146263,332,146263,,"MUNICIPIUL SUCEAVA",52,"SCOALA  GENERALA NR. 11, STRADA PACII, NR. 8, SALA C",2069,1058,1046,12,0,1053,5,2200,1142,676,377,1,13819,0
35,"Suceava",146263,332,146263,,"MUNICIPIUL SUCEAVA",53,"SCOALA  GENERALA NR. 11, STRADA PACII, NR. 8,  SALA D",2100,1013,996,17,0,1001,12,2200,1187,577,424,1,13819,0
35,"Suceava",146263,332,146263,,"MUNICIPIUL SUCEAVA",54,"SCOALA GENERALA NR. 5, STRADA GHEORGHE DOJA NR. 237A,  CORP B",1224,667,657,10,0,657,10,1300,633,432,225,1,13819,0
35,"Suceava",146263,332,146263,,"MUNICIPIUL SUCEAVA",55,"SCOALA GENERALA NR. 6, STRADA 22 DECEMBRIE , NR. 189",1960,1125,1113,12,0,1107,18,2100,975,761,346,1,13819,0
35,"Suceava",146263,332,146263,,"MUNICIPIUL SUCEAVA",56,"GARA SUCEAVA NORD  ITCANI",1190,679,669,10,0,670,9,1300,621,314,356,1,13819,0
35,"Suceava",146263,332,146263,,"MUNICIPIUL SUCEAVA",57,"GRADINITA DE COPII CU PROGRAM NORMAL NR.8, STRADA GR. ALEX. GHICA, NR. 73",1379,752,738,14,0,740,11,1500,748,410,330,1,13819,0
35,"Suceava",146263,332,146263,,"MUNICIPIUL SUCEAVA",58,"SCOALA GENERALA  NR. 7, STRADA EPAMINONDA BUCEVSCHI, NR. 7",1457,762,749,13,0,756,6,1500,738,428,328,1,13819,0
35,"Suceava",146263,332,146263,,"MUNICIPIUL SUCEAVA",59,"UNIVERSITATEA  STEFAN CEL MARE  SALA B, STR. UNIVERSITATII, NR. 13 COD POSTAL  720229",0,1426,0,1426,0,1400,26,1700,274,829,571,1,13819,1
35,"Suceava",146263,332,146263,,"MUNICIPIUL SUCEAVA",60,"GARA SUCEAVA BURDUJENI, STR. NICOLAE IORGA NR.7 COD POSTAL 720167",0,551,0,551,0,547,4,1500,949,321,226,1,13819,1
35,"Suceava",146263,332,146263,,"MUNICIPIUL SUCEAVA",61,"GARA SUCEAVA NORD ITCANI  SALA B, STR. GARII, NR.4 COD POSTAL 720694",0,205,0,205,0,200,5,1300,1095,106,94,1,13819,1
35,"Suceava",146502,332,146502,,"MUNICIPIUL CAMPULUNG MOLDOVENESC",62,"SCOALA GENERALA NR. 1  THEODOR DARIE  , CALEA TRANSILVANIEI NR. 114",1494,875,867,8,0,869,6,1600,725,554,315,1,13821,0
35,"Suceava",146502,332,146502,,"MUNICIPIUL CAMPULUNG MOLDOVENESC",63,"GRUP SCOLAR NR. 1, CALEA TRANSILVANIEI, NR. 55",919,521,516,5,0,511,10,1000,479,309,202,1,13821,0
35,"Suceava",146502,332,146502,,"MUNICIPIUL CAMPULUNG MOLDOVENESC",64,"CIRCUMSCRIPTIA SANITAR VETERINARA,  STRADA EUDOXIU HURMUZACHI, NR. 8",1415,788,780,8,0,784,4,1500,712,434,350,1,13821,0
35,"Suceava",146502,332,146502,,"MUNICIPIUL CAMPULUNG MOLDOVENESC",65,"SCOALA GENERALA NR. 4  TEODOR STEFANELLI , CALEA TRANSILVANIEI NR. 36",949,485,476,8,1,480,5,1000,515,244,236,1,13821,0
35,"Suceava",146502,332,146502,,"MUNICIPIUL CAMPULUNG MOLDOVENESC",66,"COLEGIUL NATIONAL  DRAGOS VODA , STRADA LICEULUI, NR.3",1228,613,611,2,0,607,6,1300,687,351,256,1,13821,0
35,"Suceava",146502,332,146502,,"MUNICIPIUL CAMPULUNG MOLDOVENESC",67,"CLUBUL COPIILOR SI ELEVILOR, STRADA I. HALAUCEANU, NR. 8",1424,792,788,4,0,787,5,1500,708,446,341,1,13821,0
35,"Suceava",146502,332,146502,,"MUNICIPIUL CAMPULUNG MOLDOVENESC",68,"SCOALA GENERALA NR. 3  BOGDAN VODA ,  CALEA BUCOVINEI NR. 36",1538,824,815,7,2,818,6,1600,776,472,346,1,13821,0
35,"Suceava",146502,332,146502,,"MUNICIPIUL CAMPULUNG MOLDOVENESC",69,"CLUBUL COPIILOR SI ELEVILOR  SATUL DE VACANTA, STRADA PIATA DACIEI, NR. 5",652,371,362,9,0,367,4,700,329,216,151,1,13821,0
35,"Suceava",146502,332,146502,,"MUNICIPIUL CAMPULUNG MOLDOVENESC",70,"COLEGIUL SILVIC  BUCOVINA , CALEA BUCOVINEI, NR. 56",1538,730,725,5,0,723,7,1600,870,445,278,1,13821,0
35,"Suceava",146502,332,146502,,"MUNICIPIUL CAMPULUNG MOLDOVENESC",71,"COLEGIUL SILVIC  BUCOVINA , CALEA BUCOVINEI, NR. 56",1468,731,731,0,0,720,11,1500,769,440,280,1,13821,0
35,"Suceava",146502,332,146502,,"MUNICIPIUL CAMPULUNG MOLDOVENESC",72,"COLEGIUL SILVIC  BUCOVINA , CALEA BUCOVINEI, NR. 56",1526,798,789,7,2,790,8,1600,802,504,286,1,13821,0
35,"Suceava",146502,332,146502,,"MUNICIPIUL CAMPULUNG MOLDOVENESC",73,"GRADINITA NR. 4  VALEA SEACA , CALEA BUCOVINEI, NR. 115",1103,715,708,7,0,711,4,1200,485,427,284,1,13821,0
35,"Suceava",146502,332,146502,,"MUNICIPIUL CAMPULUNG MOLDOVENESC",74,"SCOALA GENERALA NR. 2  GEORGE VOEVIDCA ,  CALEA BUCOVINEI, NR. 208",1045,577,569,8,0,571,6,1100,523,346,225,1,13821,0
35,"Suceava",146502,332,146502,,"MUNICIPIUL CAMPULUNG MOLDOVENESC",75,"SCOALA GENERALA NR. 2  GEORGE VOEVIDCA ,  CALEA BUCOVINEI, NR. 208",1056,655,644,11,0,645,10,1100,445,426,219,1,13821,0
35,"Suceava",146502,332,146502,,"MUNICIPIUL CAMPULUNG MOLDOVENESC",76,"GRADINITA CU PROGRAM PRELUNGIT NR. 1  CASUTA PITICILOR , STR. CALEA TRANSILVANIEI, NR. 18, C",0,376,0,376,0,370,6,500,124,238,132,1,13821,1
35,"Suceava",146539,332,146539,,"MUNICIPIUL FALTICENI",77,"GRUPUL SCOLAR   MIHAI BACESCU , STRADA N. BELDICEANU",1501,811,791,17,3,806,5,1600,789,305,501,1,13823,0
35,"Suceava",146539,332,146539,,"MUNICIPIUL FALTICENI",78,"SCOALA CU CLASELE I-VIII, NR. 1    AL. I. CUZA ,  STRADA SUCEVEI,  NR. 78",1525,795,786,9,0,787,8,1600,805,292,495,1,13823,0
35,"Suceava",146539,332,146539,,"MUNICIPIUL FALTICENI",79,"COLEGIUL NATIONAL  NICU GANE , STRADA SUCEVEI NR. 111",1613,832,820,12,0,820,12,1700,868,311,509,1,13823,0
35,"Suceava",146539,332,146539,,"MUNICIPIUL FALTICENI",80,"COLEGIUL NATIONAL  NICU GANE , STRADA SUCEVEI, NR. 111",1721,807,796,11,0,796,11,1800,993,332,464,1,13823,0
35,"Suceava",146539,332,146539,,"MUNICIPIUL FALTICENI",81,"SCOALA CU CLASELE I-VIII, NR. 6   I. CIUREA , STRADA13 DECEMBRIE, NR. 19",1723,800,788,12,0,784,16,1800,1000,374,410,1,13823,0
35,"Suceava",146539,332,146539,,"MUNICIPIUL FALTICENI",82,"SCOALA  CU CLASELE I-VIII, NR. 6    I. CIUREA , STRADA 13 DECEMBRIE, NR. 19",1876,924,915,9,0,916,8,1900,976,374,542,1,13823,0
35,"Suceava",146539,332,146539,,"MUNICIPIUL FALTICENI",83,"SCOALA  CU CLASELE I-VIII, NR. 3   M. SADOVEANU , STRADA ANA IPATESCU, NR. 115",1705,821,806,15,0,814,7,1800,979,354,460,1,13823,0
35,"Suceava",146539,332,146539,,"MUNICIPIUL FALTICENI",84,"SCOALA  CU CLASELE I-VIII, NR. 3   M. SADOVEANU , STRADA ANA IPATESCU, NR. 115",1455,683,675,8,0,675,8,1600,917,303,372,1,13823,0
35,"Suceava",146539,332,146539,,"MUNICIPIUL FALTICENI",85,"SCOALA  CU CLASELE I-VIII, NR. 2   I. IRIMESCU , STRADA N. BELDICEANU, NR. 23",1454,652,646,6,0,645,7,1600,948,267,378,1,13823,0
35,"Suceava",146539,332,146539,,"MUNICIPIUL FALTICENI",86,"SCOALA  CU CLASELE I-VIII, NR.2   I. IRIMESCU , STRADA N.BELDICEANU, NR. 23",1179,582,568,14,0,574,8,1200,618,244,330,1,13823,0
35,"Suceava",146539,332,146539,,"MUNICIPIUL FALTICENI",87,"SCOALA  CU CLASELE I-VIII, NR. 3   M. SADOVEANU ,  STRADA I.DRAGOSLAV, NR. 9",1206,678,667,11,0,677,1,1300,622,252,425,1,13823,0
35,"Suceava",146539,332,146539,,"MUNICIPIUL FALTICENI",88,"GRADINITA CU PROGRAM PRELUNGIT   DUMBRAVA MINUNATA ,  STRADA TARANCUTEI, NR. 19",1539,747,730,17,0,740,7,1600,853,360,380,1,13823,0
35,"Suceava",146539,332,146539,,"MUNICIPIUL FALTICENI",89,"COLEGIUL AGRICOL, STRADA MAIOR IOAN, NR. 16",1683,837,832,5,0,824,13,1700,863,320,504,1,13823,0
35,"Suceava",146539,332,146539,,"MUNICIPIUL FALTICENI",90,"COLEGIUL AGRICOL, STRADA MAIOR IOAN, NR. 16",1559,863,847,16,0,846,17,1600,737,292,554,1,13823,0
35,"Suceava",146539,332,146539,,"MUNICIPIUL FALTICENI",91,"COLEGIUL AGRICOL, STRADA ION CREANGA, NR. 82",1308,724,715,8,1,722,2,1400,676,333,389,1,13823,0
35,"Suceava",146539,332,146539,,"MUNICIPIUL FALTICENI",92,"SCOALA CU CLASELE I-VIII NR.6   I. CIUREA ,  STRADA ARMATEI, NR. 20, CLADIRE GHE. GAFENCU",1506,765,752,13,0,761,4,1600,835,328,433,1,13823,0
35,"Suceava",146539,332,146539,,"MUNICIPIUL FALTICENI",93,"SCOALA TARNA MARE",664,325,313,12,0,321,4,700,375,176,145,1,13823,0
35,"Suceava",146539,332,146539,,"MUNICIPIUL FALTICENI",94,"GRADINITA CU PROGRAM PRELUNGIT  DUMBRAVA MINUNATA ,  STRADA TARANCUTEI, NR. 19",1661,862,849,13,0,856,6,1700,838,408,448,1,13823,0
35,"Suceava",146539,332,146539,,"MUNICIPIUL FALTICENI",95,"BIBLIOTECA MUNICIPALA   EUGEN LOVINESCU , STR. REPUBLICII, NR. 14,COD 725200",0,391,0,391,0,388,3,500,109,192,196,1,13823,1
35,"Suceava",146628,332,146628,,"MUNICIPIUL RADAUTI",96,"CASA DE CULTURA, STRADA BOGDAN VODA, NR. 12",1789,1000,987,12,1,988,12,1900,900,490,498,1,13827,0
35,"Suceava",146628,332,146628,,"MUNICIPIUL RADAUTI",97,"PRIMARIA MUNICIPIULUI RADAUTI, STRADA PIATA UNIRII, NR. 2",1823,923,913,10,0,915,8,1900,977,499,416,1,13827,0
35,"Suceava",146628,332,146628,,"MUNICIPIUL RADAUTI",98,"BIBLIOTECA, STRADA PIATA UNIRII, NR. 62",1739,831,819,12,0,820,11,1800,969,423,397,1,13827,0
35,"Suceava",146628,332,146628,,"MUNICIPIUL RADAUTI",99,"SCOALA GENERALA NR.4, STRADA STEFAN CEL MARE, NR. 18",1945,974,961,13,0,963,11,2000,1026,590,373,1,13827,0
35,"Suceava",146628,332,146628,,"MUNICIPIUL RADAUTI",100,"GRUPUL SCOLAR INDUSTRIAL, STRADA TUDOR VLADIMIRESCU, NR. 12",1289,637,628,9,0,627,10,1400,763,351,276,1,13827,0
35,"Suceava",146628,332,146628,,"MUNICIPIUL RADAUTI",101,"COLEGIUL  EUDOXIU HURMUZACHI  , STRADA CALEA BUCOVINEI, NR. 7",1598,823,815,6,2,812,11,1700,877,382,430,1,13827,0
35,"Suceava",146628,332,146628,,"MUNICIPIUL RADAUTI",102,"SCOALA GENERALA NR. 5, STRADA EUDOXIU HURMUZACHI, NR. 7",1607,865,856,8,1,853,12,1700,835,422,431,1,13827,0
35,"Suceava",146628,332,146628,,"MUNICIPIUL RADAUTI",103,"GRADINITA NR. 8, STRADA MIHAI VITEAZU, NR. 52",2094,935,924,11,0,924,11,2200,1265,533,391,1,13827,0
35,"Suceava",146628,332,146628,,"MUNICIPIUL RADAUTI",104,"CAMINUL PENTRU PERSOANE VARSTNICE, STRADA VOLOVATULUI, NR. 50",2235,989,982,7,0,981,8,2150,1161,499,482,1,13827,0
35,"Suceava",146628,332,146628,,"MUNICIPIUL RADAUTI",105,"POLICLINICA, CALEA BUCOVINEI, NR. 37",1513,728,720,8,0,716,12,1600,872,360,356,1,13827,0
35,"Suceava",146628,332,146628,,"MUNICIPIUL RADAUTI",106,"SCOALA GENERALA NR. 3, STRADA IANCU FLONDOR, NR. 3",1443,729,714,14,1,718,11,1500,771,358,360,1,13827,0
35,"Suceava",146628,332,146628,,"MUNICIPIUL RADAUTI",107,"CRESA HIPODROM, STRADA MIHAI VITEAZU, NR. 3",1959,911,903,8,0,895,16,2100,1189,495,400,1,13827,0
35,"Suceava",146628,332,146628,,"MUNICIPIUL RADAUTI",108,"SCOALA GENERALA NR. 2, STRADA HOREA, NR. 44",1723,878,870,8,0,869,9,1800,922,550,319,1,13827,0
35,"Suceava",146628,332,146628,,"MUNICIPIUL RADAUTI",109,"SCOALA GENERALA NR. 1, STRADA CONSTANTIN DOBROGEANU GHEREA, NR. 12",1367,669,656,13,0,660,9,1400,731,435,225,1,13827,0
35,"Suceava",146628,332,146628,,"MUNICIPIUL RADAUTI",110,"GRADINITA 1MAI,  STRADA 1 MAI, NR. 64",1635,811,793,16,2,799,12,1700,889,473,326,1,13827,0
35,"Suceava",146628,332,146628,,"MUNICIPIUL RADAUTI",111,"PRIMARIA MUNICIPIULUI RADAUTI, STR. PIATA UNIRII, NR. 2-4, COD POSTAL 725400, MUNICIPIUL RAD",0,547,0,547,0,543,4,657,110,350,193,1,13827,1
35,"Suceava",146744,332,146744,,"MUNICIPIUL VATRA DORNEI",112,"CASA DE CULTURA  PLATON PARDAU  , STR.GARII NR.2",1534,892,880,9,3,877,15,1600,708,464,413,1,13829,0
35,"Suceava",146744,332,146744,,"MUNICIPIUL VATRA DORNEI",113,"HOTEL  BRADUL , STR.REPUBLICII NR.5",994,576,554,20,2,562,14,1098,522,284,278,1,13829,0
35,"Suceava",146744,332,146744,,"MUNICIPIUL VATRA DORNEI",114,"HOTEL   INTUS , STR. REPUBLICII, NR.5",1044,618,605,13,0,607,11,1096,478,289,318,1,13829,0
35,"Suceava",146744,332,146744,,"MUNICIPIUL VATRA DORNEI",115,"SCOALA  GENERALA NR.1, STR.REPUBLICII NR.63",1069,657,637,18,2,651,6,1100,443,384,267,1,13829,0
35,"Suceava",146744,332,146744,,"MUNICIPIUL VATRA DORNEI",116,"SALA DE SPORT A MUNICIPIULUI, STR. TRANSILVANIEI NR.1",1406,848,827,20,1,844,4,1500,652,461,383,1,13829,0
35,"Suceava",146744,332,146744,,"MUNICIPIUL VATRA DORNEI",117,"CAMINUL  CULTURAL  ROSU , STRADA ROSU, NR.64",549,329,323,6,0,326,3,600,271,199,127,1,13829,0
35,"Suceava",146744,332,146744,,"MUNICIPIUL VATRA DORNEI",118,"SCOALA GENERALA NR.2, STR.UNIRII NR.52  SALA A",1023,598,591,7,0,585,13,1100,502,302,283,1,13829,0
35,"Suceava",146744,332,146744,,"MUNICIPIUL VATRA DORNEI",119,"SCOALA GENERALA NR. 2, STR. UNIRII, NR.52  SALA B",1311,726,707,17,2,716,10,1400,674,331,385,1,13829,0
35,"Suceava",146744,332,146744,,"MUNICIPIUL VATRA DORNEI",120,"CAMINUL DE COPII CU ORAR PRELUNGIT,  STR.UNIRII NR.35",1272,703,685,18,0,690,13,1300,597,353,337,1,13829,0
35,"Suceava",146744,332,146744,,"MUNICIPIUL VATRA DORNEI",121,"GRADINITA CU PROGRAM NORMAL, STR. AZURULUI, F.N.",1078,593,581,12,0,591,2,1081,488,361,230,1,13829,0
35,"Suceava",146744,332,146744,,"MUNICIPIUL VATRA DORNEI",122,"SCOALA GENERALA NR. 3, STR. CHILIA NR. 13  SALA  A",1079,609,600,9,0,602,7,1100,491,366,236,1,13829,0
35,"Suceava",146744,332,146744,,"MUNICIPIUL VATRA DORNEI",123,"SCOALA GENERALA NR. 3, STR. CHILIA, NR.13  SALA B",968,568,563,5,0,559,9,1000,432,298,261,1,13829,0
35,"Suceava",146744,332,146744,,"MUNICIPIUL VATRA DORNEI",124,"COMPLEX C.F.R.  GARA MARE, STR.PODU VERDE NR.15",1118,660,649,9,2,648,12,1200,540,436,212,1,13829,0
35,"Suceava",146744,332,146744,,"MUNICIPIUL VATRA DORNEI",125,"SCOALA GENERALA ARGESTRU",539,328,321,7,0,325,3,600,272,196,129,1,13829,0
35,"Suceava",146744,332,146744,,"MUNICIPIUL VATRA DORNEI",126,"CASA DE CULTURA  PLATON PARDAU   CLUBUL PENSIONARILOR, STR. GARII, NR. 2, COD POSTAL 725700",0,831,0,831,0,827,4,1500,669,426,401,1,13829,1
35,"Suceava",147358,332,147358,,"ORAS BROSTENI",127,"CAMINUL CULTURAL HOLDA(SAT APARTINATOR)",1055,627,622,5,0,625,2,1100,473,382,243,1,13834,0
35,"Suceava",147358,332,147358,,"ORAS BROSTENI",128,"PRIMARIA ORASUI BROSTENI",834,444,432,12,0,440,4,900,456,212,228,1,13834,0
35,"Suceava",147358,332,147358,,"ORAS BROSTENI",129,"GRUPUL SCOLAR BROSTENI -  SCOALA GENERALA ORAS BROSTENI",1531,649,627,22,0,643,6,1600,951,308,335,1,13834,0
35,"Suceava",147358,332,147358,,"ORAS BROSTENI",130,"SPITALUL  MEDICO-SOCIAL  CARMEN SYLVA  BROSTENI, CORPUL ADMINISTRATIV",439,244,232,12,0,242,2,500,256,114,128,1,13834,0
35,"Suceava",147358,332,147358,,"ORAS BROSTENI",131,"SCOALA NR.1 SAT COTIRGASI",1037,626,618,8,0,619,7,1100,474,366,253,1,13834,0
35,"Suceava",147358,332,147358,,"ORAS BROSTENI",132,"SCOALA GENERALA  SAT FRASIN",414,248,241,7,0,247,1,500,252,120,127,1,13834,0
35,"Suceava",147358,332,147358,,"ORAS BROSTENI",133,"SCOALA GENERALA SAT DIRMOXA",137,94,83,0,11,94,0,200,106,35,59,1,13834,0
35,"Suceava",147358,332,147358,,"ORAS BROSTENI",134,"GRUPUL SCOLAR  NICOLAE NANU  BROSTENI  SCOALA GENERALA, STR. NICOLAE NANU, NR. 5, JUD. SUCE",0,111,0,111,0,111,0,300,189,59,52,1,13834,1
35,"Suceava",147633,332,147633,,"ORAS CAJVANA",135,"CAMINUL CULTURAL  CAJVANA, NR.863",1690,738,717,21,0,729,9,1800,1062,389,340,1,13845,0
35,"Suceava",147633,332,147633,,"ORAS CAJVANA",136,"SCOALA GENERALA  RACAR ORAS CAJVANA, NR.800",1562,654,630,24,0,648,6,1600,946,426,222,1,13845,0
35,"Suceava",147633,332,147633,,"ORAS CAJVANA",137,"SCOALA CU CLASELE I- IV, ORAS CAJVANA, NR.1682",1439,646,591,55,0,642,4,1500,854,445,197,1,13845,0
35,"Suceava",147633,332,147633,,"ORAS CAJVANA",138,"GRADINITA  DEAL, ORAS CAJVANA, NR.1450",1274,502,471,31,0,501,1,1300,798,306,195,1,13845,0
35,"Suceava",147633,332,147633,,"ORAS CAJVANA",139,"SCOALA GENERALA CENTRU CAJVANA,  NR.526  JUDETUL SUCEAVA, COD POSTAL 727100",0,57,0,57,0,57,0,300,243,33,24,1,13845,1
35,"Suceava",148006,332,148006,,"ORAS DOLHASCA",140,"GRUPUL SCOLAR   OLTEA DOAMNA  ORAS DOLHASCA",1164,567,455,112,0,548,19,1200,633,267,281,1,13848,0
35,"Suceava",148006,332,148006,,"ORAS DOLHASCA",141,"SCOALA CU CLASELE I-IV , ORAS DOLHASCA",1004,483,407,76,0,476,7,1100,617,199,277,1,13848,0
35,"Suceava",148006,332,148006,,"ORAS DOLHASCA",142,"SCOALA CU CLASELE I-IV SANDENI, ORAS DOLHASCA",747,429,330,99,0,422,7,800,371,236,186,1,13848,0
35,"Suceava",148006,332,148006,,"ORAS DOLHASCA",143,"SCOALA CU CLASELE I-IV SAT POIANA",406,210,196,14,0,208,2,495,285,96,112,1,13848,0
35,"Suceava",148006,332,148006,,"ORAS DOLHASCA",144,"SCOALA CU CLASELE I-VIII SAT GULIA",1510,854,830,24,0,830,24,1600,746,302,528,1,13848,0
35,"Suceava",148006,332,148006,,"ORAS DOLHASCA",145,"SCOALA CU CLASELE I-VIII SAT PROBOTA",1421,757,735,22,0,741,16,1500,743,309,432,1,13848,0
35,"Suceava",148006,332,148006,,"ORAS DOLHASCA",146,"SCOALA CU CLASELE I-IV SAT  POIENARI",229,158,141,17,0,155,3,300,142,95,60,1,13848,0
35,"Suceava",148006,332,148006,,"ORAS DOLHASCA",147,"SCOALA CU CLASELE I-VIII,  SAT SILISTEA NOUA",581,349,330,19,0,342,7,600,251,171,171,1,13848,0
35,"Suceava",148006,332,148006,,"ORAS DOLHASCA",148,"SCOALA CU CLASELE I-VIII, SAT  BUDENI",1147,537,522,15,0,530,7,1200,663,264,266,1,13848,0
35,"Suceava",148006,332,148006,,"ORAS DOLHASCA",149,"SCOALA CU CLASELE I-IV,  SAT VALEA POIENEI",405,256,234,22,0,251,5,500,244,122,129,1,13848,0
35,"Suceava",148006,332,148006,,"ORAS DOLHASCA",150,"SCOALA CU CLASELE I- IV DOLHASCA, STR.  DR. C. ARSENE  F.N.,  JUDETUL SUCEAVA, C.P. 727170",0,138,0,138,0,137,1,500,362,58,79,1,13848,1
35,"Suceava",148612,332,148612,,"ORAS FRASIN",151,"PRIMARIA ORASUI FRASIN, STR. PRINCIPALA, NR.90",1462,744,705,35,4,736,8,1500,756,473,263,1,13857,0
35,"Suceava",148612,332,148612,,"ORAS FRASIN",152,"SCOALA GENERALA I - VIII,  ORAS FRASIN",1017,617,575,42,0,612,5,1100,483,460,152,1,13857,0
35,"Suceava",148612,332,148612,,"ORAS FRASIN",153,"SCOALA DE ARTE SI MESERII  BUCSOAIA",1213,723,689,34,0,718,5,1300,577,488,230,1,13857,0
35,"Suceava",148612,332,148612,,"ORAS FRASIN",154,"SCOALA GENERALA  I-VIII DOROTEIA, SAT DOROTEIA",985,486,467,19,0,480,6,1100,614,400,80,1,13857,0
35,"Suceava",148612,332,148612,,"ORAS FRASIN",155,"CAMINUL CULTURAL PLUTONITA, SAT PLUTONITA",705,509,399,110,0,503,6,800,291,407,96,1,13857,0
35,"Suceava",148612,332,148612,,"ORAS FRASIN",156,"DISPENSARUL MEDICAL FRASIN, STR.PRINCIPALA, NR.308, JUD.SUCEAVA, COD 727245",0,118,0,118,0,116,2,300,182,70,46,1,13857,1
35,"Suceava",146584,332,146584,,"ORAS GURA HUMORULUI",157,"MUZEUL OBICEIURILOR POPULARE,  GURA HUMORULUI STR. PIATA REPUBLICII, NR. 3",1601,868,855,13,0,863,5,1700,832,479,384,1,13862,0
35,"Suceava",146584,332,146584,,"ORAS GURA HUMORULUI",158,"GRADINITA,  STR. STEFAN CEL MARE NR.32",1438,751,735,16,0,746,5,1500,749,387,359,1,13862,0
35,"Suceava",146584,332,146584,,"ORAS GURA HUMORULUI",159,"SCOALA CU CLASELE I-VIII NR.4 STR. SFANTU MIHAIL NR. 11",1999,1060,1047,11,2,1050,10,2100,1040,541,509,1,13862,0
35,"Suceava",146584,332,146584,,"ORAS GURA HUMORULUI",160,"SCOALA CU CLASELE I-VIII NR.1 B-DUL BUCOVINA NR. 62",1899,1031,1023,7,1,1021,10,2000,969,504,517,1,13862,0
35,"Suceava",146584,332,146584,,"ORAS GURA HUMORULUI",161,"SCOALA CU CLASELE I-VIII NR.2 B-DUL BUCOVINA NR. 25",1807,909,901,7,1,901,8,1900,991,409,492,1,13862,0
35,"Suceava",146584,332,146584,,"ORAS GURA HUMORULUI",162,"COLEGIUL  ALEXANDRU CEL BUN  B-DUL BUCOVINA NR. 41",1979,969,961,8,0,965,4,2100,1131,490,475,1,13862,0
35,"Suceava",146584,332,146584,,"ORAS GURA HUMORULUI",163,"SCOALA CU CLASELE I-VIII NR. 3 STR. SFANTUL MIHAIL NR. 27",1646,891,877,11,3,884,7,1700,809,414,470,1,13862,0
35,"Suceava",146584,332,146584,,"ORAS GURA HUMORULUI",164,"SCOALA CU CLASELE I-IV BOURENI, ORAS GURA HUMORULUI",622,292,278,14,0,288,4,700,408,155,133,1,13862,0
35,"Suceava",146584,332,146584,,"ORAS GURA HUMORULUI",165,"CAMINUL CULTURAL VORONET",649,425,413,12,0,419,6,700,275,260,159,1,13862,0
35,"Suceava",146584,332,146584,,"ORAS GURA HUMORULUI",166,"COMPLEXUL  BUCOVINA  DIN GARA  CFR GURA HUMORULUI ORAS  STR. STEFAN CEL MARE, F.N., COD POST",0,338,0,338,0,332,6,500,162,170,162,1,13862,1
35,"Suceava",149227,332,149227,,"ORAS LITENI",167,"CASA DE CULTURA, ORAS LITENI",1451,761,742,19,0,749,12,1500,739,425,324,1,13865,0
35,"Suceava",149227,332,149227,,"ORAS LITENI",168,"GRUP SCOLAR ORAS LITENI, CORPUL III",1393,819,788,31,0,813,6,1500,681,443,370,1,13865,0
35,"Suceava",149227,332,149227,,"ORAS LITENI",169,"BAZA DE RECEPTIE CEREALE LITENI, ORAS LITENI",848,473,455,18,0,467,6,900,427,309,158,1,13865,0
35,"Suceava",149227,332,149227,,"ORAS LITENI",170,"SCOALA DE ARTE SI MESERII, SAT ROTUNDA",1164,658,630,28,0,647,11,1200,542,364,283,1,13865,0
35,"Suceava",149227,332,149227,,"ORAS LITENI",171,"SCOALA CU CLASELE I-IV ROTUNDA - BAHNA, SAT ROTUNDA",567,308,299,9,0,306,2,600,292,140,166,1,13865,0
35,"Suceava",149227,332,149227,,"ORAS LITENI",172,"SCOALA CU CLASELE I-VIII, SAT ROSCANI",976,547,536,11,0,535,12,1000,453,322,213,1,13865,0
35,"Suceava",149227,332,149227,,"ORAS LITENI",173,"CAMINUL CULTURAL, SAT CORNI",653,410,401,9,0,401,9,700,290,208,193,1,13865,0
35,"Suceava",149227,332,149227,,"ORAS LITENI",174,"SCOALA CU CLASELE I-VIII, SAT SILISTEA",609,324,313,11,0,322,2,700,376,184,138,1,13865,0
35,"Suceava",149227,332,149227,,"ORAS LITENI",175,"PRIMARIA ORASUI LITENI,STR. MIHAIL SADOVEANU, NR. 17, COD POSTAL 727335",0,125,0,125,0,124,1,300,175,76,48,1,13865,1
35,"Suceava",146931,332,146931,,"ORAS MILISAUTI",176,"CAMINUL CULTURAL ORAS MILISAUTI, CALEA BOGDAN VODA, NR. 8",1539,830,808,22,0,822,8,1600,770,447,375,1,13872,0
35,"Suceava",146931,332,146931,,"ORAS MILISAUTI",177,"PRIMARIA ORASUI MILISAUTI, CALEA BOGDAN VODA, NR.4",1441,710,693,17,0,704,6,1500,790,345,359,1,13872,0
35,"Suceava",146931,332,146931,,"ORAS MILISAUTI",178,"CAMINUL CULTURAL LOCALITATEA BADEUT, CALEA DRAGOS VODA, NR.75",1212,678,649,29,0,663,15,1300,622,333,330,1,13872,0
35,"Suceava",146931,332,146931,,"ORAS MILISAUTI",179,"SCOALA CU CLASELE I-VIII MILISAUTI, STR. CALEA STEFAN CEL MARE NR. 64, COD POSTAL: 727360",0,60,0,60,0,58,2,300,240,37,21,1,13872,1
35,"Suceava",146370,332,146370,,"ORAS SALCEA",180,"CAMINUL CULTURAL SALCEA",2251,1143,1139,4,0,1129,14,2300,1157,623,506,1,13877,0
35,"Suceava",146370,332,146370,,"ORAS SALCEA",181,"CAMINUL CULTURAL LOCALITATEA PLOPENI",1919,943,929,14,0,935,8,1998,1055,526,409,1,13877,0
35,"Suceava",146370,332,146370,,"ORAS SALCEA",182,"SCOALA LOCALITATEA MERENI",700,378,353,25,0,371,7,800,422,221,150,1,13877,0
35,"Suceava",146370,332,146370,,"ORAS SALCEA",183,"CAMINUL CULTURAL LOCALITATEA VARATEC",1151,642,627,15,0,638,4,1200,558,298,340,1,13877,0
35,"Suceava",146370,332,146370,,"ORAS SALCEA",184,"CAMINUL CULTURAL SAT PRELIPCA",976,587,576,7,4,580,7,1000,413,405,175,1,13877,0
35,"Suceava",146370,332,146370,,"ORAS SALCEA",185,"CAMINUL CULTURAL SALCEA",0,95,0,95,0,94,1,300,205,56,38,1,13877,1
35,"Suceava",146655,332,146655,,"ORAS SIRET",186,"CASA DE CULTURA ORAS SIRET, STR.LATCU VODA NR.2",1221,659,642,17,0,644,15,1300,641,213,431,1,13883,0
35,"Suceava",146655,332,146655,,"ORAS SIRET",187,"LICEUL  LATCU VODA   ORAS SIRET, STR.LATCU VODA  NR.7",1447,690,680,10,0,679,11,1500,810,228,451,1,13883,0
35,"Suceava",146655,332,146655,,"ORAS SIRET",188,"GRADINITA  LUMINITA   ORAS SIRET, STR.MIHAI TELIMAN NR.16A",1407,594,584,10,0,585,9,1500,906,222,363,1,13883,0
35,"Suceava",146655,332,146655,,"ORAS SIRET",189,"SCOALA  PROFESIONALA, ORAS SIRET, STR.28 NOIEMBRIE, NR.43",765,362,353,9,0,357,5,800,438,150,207,1,13883,0
35,"Suceava",146655,332,146655,,"ORAS SIRET",190,"SCOALA GENERALA   PETRU MUSAT   ORAS SIRET,  STR. ALEXANDRU CEL BUN, NR.25, CORPUL II",1000,497,489,8,0,487,10,1100,603,167,320,1,13883,0
35,"Suceava",146655,332,146655,,"ORAS SIRET",191,"SCOALA GENERALA   PETRU MUSAT   ORAS SIRET,  STR. SIMION FLOREA MARIAN, NR. 2, CORPUL I",1214,567,559,8,0,551,16,1300,733,206,345,1,13883,0
35,"Suceava",146655,332,146655,,"ORAS SIRET",192,"SCOALA GENERALA PADURENI,  STR. MOLDOVEI, NR. 18",436,258,249,9,0,255,3,500,242,60,195,1,13883,0
35,"Suceava",146655,332,146655,,"ORAS SIRET",193,"SCOALA GENERALA MANASTIOARA,  STR.LIVEZILOR NR.23",461,304,297,7,0,302,2,500,196,123,179,1,13883,0
35,"Suceava",146655,332,146655,,"ORAS SIRET",194,"MUZEUL DE ISTORIE SIRET, STR. 9 MAI, NR. 17 COD POSTAL 725500",0,118,0,118,0,116,2,300,182,52,64,1,13883,1
35,"Suceava",146708,332,146708,,"ORAS SOLCA",195,"PRIMARIA ORASUI SOLCA, STR. TOMSA VODA, NR.8A,  SALA DE SEDINTE A CONSILIULUI LOCAL",1056,525,521,4,0,520,5,1100,575,276,244,1,13887,0
35,"Suceava",146708,332,146708,,"ORAS SOLCA",196,"GRUPUL SCOLAR   TOMSA VODA   ORAS SOLCA, STR. TOMSA VODA, NR.33,  CORP  A",1032,589,581,8,0,580,9,1100,511,300,280,1,13887,0
35,"Suceava",146708,332,146708,,"ORAS SOLCA",197,"SALA DE CLASA DIN GRADINITA CU PROGRAM NORMAL  MUGUR DE BRAD  NR. 2, STRADA TOMSA VODA, NR.",0,109,0,109,0,108,1,303,194,59,49,1,13887,1
35,"Suceava",151095,332,151095,,"ORAS VICOVU DE SUS",198,"CAMIN CULTURAL  EST, ORAS VICOVU DE SUS",1502,500,491,9,0,496,4,1600,1100,250,246,1,13889,0
35,"Suceava",151095,332,151095,,"ORAS VICOVU DE SUS",199,"GRADINITA EST, ORAS VICOVU DE SUS",1706,622,610,12,0,615,7,1800,1178,322,293,1,13889,0
35,"Suceava",151095,332,151095,,"ORAS VICOVU DE SUS",200,"SALA DE SPORT CENTRU, ORAS VICOVU DE SUS",1761,828,814,14,0,820,8,1800,972,464,356,1,13889,0
35,"Suceava",151095,332,151095,,"ORAS VICOVU DE SUS",201,"SCOALA GENERALA PLAI, ORAS VICOVU DE SUS, CORP VECHI",1153,562,553,9,0,555,7,1200,638,355,200,1,13889,0
35,"Suceava",151095,332,151095,,"ORAS VICOVU DE SUS",202,"SCOALA GENERALA  LAURA, ORAS VICOVU DE SUS, CORP VECHI",1274,594,587,7,0,590,4,1300,706,259,331,1,13889,0
35,"Suceava",151095,332,151095,,"ORAS VICOVU DE SUS",203,"SCOALA GENERALA LAURA, ORAS VICOVU DE SUS, CORP NOU",1580,766,756,10,0,757,9,1600,834,383,374,1,13889,0
35,"Suceava",151095,332,151095,,"ORAS VICOVU DE SUS",204,"SCOALA GENERALA BIVOLARIE, LOCALITATEA BIVOLARIE",1518,1008,714,294,0,1002,6,1616,608,667,335,1,13889,0
35,"Suceava",151095,332,151095,,"ORAS VICOVU DE SUS",205,"PRIMARIA ORASUI VICOVU DE SUS-CORP VECHI, STRADA PRIMARIEI NR.4-6",0,92,0,92,0,90,2,300,208,48,42,1,13889,1
35,"Suceava",146799,332,146799,,"ADANCATA",206,"SCOALA CU CLASELE I-IV, SAT ADANCATA",1252,764,757,7,0,748,16,1300,536,455,293,3,13892,0
35,"Suceava",146799,332,146799,,"ADANCATA",207,"SCOALA CU CLASELE V-VIII, SAT ADANCATA",1050,640,627,11,2,628,12,1100,460,368,260,3,13892,0
35,"Suceava",146799,332,146799,,"ADANCATA",208,"SCOALA CU CLASELE I-IV, SAT CALUGARENI",590,350,335,15,0,346,4,700,350,194,152,3,13892,0
35,"Suceava",146799,332,146799,,"ADANCATA",209,"SCOALA CU CLASELE I-VIII, SAT FETESTI",412,240,232,8,0,233,7,500,260,143,90,3,13892,0
35,"Suceava",146799,332,146799,,"ADANCATA",210,"SALA DE SEDINTA A PRIMARIEI  COMUNEI ADANCATA.",0,128,0,128,0,128,0,200,72,78,50,3,13892,1
35,"Suceava",146860,332,146860,,"ARBORE",211,"SCOALA NR.1 SAT ARBORE",1736,965,956,9,0,956,9,1800,835,706,250,3,13896,0
35,"Suceava",146860,332,146860,,"ARBORE",212,"SCOALA NR.2 SAT ARBORE",1687,899,893,6,0,892,7,1799,900,606,286,3,13896,0
35,"Suceava",146860,332,146860,,"ARBORE",213,"SCOALA NR.3 SAT ARBORE",962,501,496,5,0,495,6,999,498,351,144,3,13896,0
35,"Suceava",146860,332,146860,,"ARBORE",214,"SCOALA NR.4 SAT CLIT",1019,564,554,10,0,556,8,1100,536,294,262,3,13896,0
35,"Suceava",146860,332,146860,,"ARBORE",215,"SCOALA NR.6 SAT BODNARENI",224,127,122,5,0,126,1,300,173,93,33,3,13896,0
35,"Suceava",146860,332,146860,,"ARBORE",216,"SCOALA CU CLASELE I-VII  LUCA ARBURE  , NR. 688, ARBORE, CORP B",0,79,0,79,0,79,0,199,120,55,24,3,13896,1
35,"Suceava",146904,332,146904,,"BAIA",217,"GRADINITA NR. 1 SAT BAIA",1152,600,519,80,1,588,12,1200,600,268,320,3,13900,0
35,"Suceava",146904,332,146904,,"BAIA",218,"SCOALA GENERALA NR. 2 SAT  BAIA",1207,625,582,43,0,608,17,1300,675,317,291,3,13900,0
35,"Suceava",146904,332,146904,,"BAIA",219,"SCOALA GENERALA NR. 3 SAT BAIA",960,456,411,45,0,452,4,1000,544,203,249,3,13900,0
35,"Suceava",146904,332,146904,,"BAIA",220,"GRADINITA NR. 3 SAT BAIA",1020,485,448,37,0,473,12,1100,615,193,280,3,13900,0
35,"Suceava",146904,332,146904,,"BAIA",221,"SCOALA GENERALA SAT BOGATA",997,536,491,45,0,532,4,1100,564,205,327,3,13900,0
35,"Suceava",146904,332,146904,,"BAIA",222,"SEDIUL PRIMARIEI COMUNEI BAIA, SALA DE FESTIVITATI",0,55,0,55,0,53,2,200,145,29,24,3,13900,1
35,"Suceava",151530,332,151530,,"BALACEANA",223,"CAMINUL CULTURAL, SALA MICA",1288,666,666,0,0,659,7,1400,734,288,371,3,13903,0
35,"Suceava",151530,332,151530,,"BALACEANA",224,"SALA DE GRADINITA DIN INCINTA SCOLII GENERALE CU CLASELE I-VIII BALACEANA",0,92,0,92,0,91,1,150,58,35,56,3,13903,1
35,"Suceava",146995,332,146995,,"BALCAUTI",225,"PRIMARIA COMUNEI BALCAUTI, SAT BALCAUTI",1204,542,536,6,0,523,19,1300,758,208,315,3,13905,0
35,"Suceava",146995,332,146995,,"BALCAUTI",226,"SCOALA CU CLASELE V-VIII, SAT NEGOSTINA",1082,582,565,17,0,577,5,1199,617,285,292,3,13905,0
35,"Suceava",146995,332,146995,,"BALCAUTI",227,"SCOALA CU CLASELE I-IV, SAT GROPENI",281,136,129,7,0,134,2,400,264,61,73,3,13905,0
35,"Suceava",146995,332,146995,,"BALCAUTI",228,"SEDIUL PRIMARIE  BALCAUTI BIROU FOND FUNCIAR",0,78,0,78,0,77,1,200,122,40,37,3,13905,1
35,"Suceava",151576,332,151576,,"BERCHISESTI",229,"CAMINUL CULTURAL, SAT BERCHISESTI",1697,1124,1117,7,0,1109,15,1800,676,487,622,3,13909,0
35,"Suceava",151576,332,151576,,"BERCHISESTI",230,"SCOALA GENERALA CU CLASELE I-IV, SAT CORLATA",390,276,269,7,0,267,9,500,224,72,195,3,13909,0
35,"Suceava",151576,332,151576,,"BERCHISESTI",231,"SEDIUL PRIMARIEI COMUNEI BERCHISESTI",0,134,0,134,0,131,3,200,66,54,77,3,13909,1
35,"Suceava",147036,332,147036,,"BILCA",232,"PRIMARIA COMUNEI BILCA, SAT BILCA",1136,506,487,19,0,503,3,1197,691,326,177,3,13912,0
35,"Suceava",147036,332,147036,,"BILCA",233,"SCOALA GENERALA NR.2, SAT  BILCA",915,492,453,39,0,486,6,998,506,239,247,3,13912,0
35,"Suceava",147036,332,147036,,"BILCA",234,"SCOALA GENERALA NR.3, SAT BILCA",763,406,368,38,0,397,9,794,388,237,160,3,13912,0
35,"Suceava",147036,332,147036,,"BILCA",235,"SEDIUL PRIMARIEI COMUNEI BILCA",0,45,0,45,0,45,0,200,155,26,19,3,13912,1
35,"Suceava",147054,332,147054,,"BOGDANESTI",236,"SCOALA DE ARTE SI MESERII, SAT BOGDANESTI, NR. 64 (LOCALUL VECHI)",1867,1015,944,71,0,1006,9,1900,885,475,531,3,13914,0
35,"Suceava",147054,332,147054,,"BOGDANESTI",237,"SCOALA GENERALA NR.2, SAT BOGDANESTI, NR. 702",1245,724,654,70,0,719,5,1300,576,393,326,3,13914,0
35,"Suceava",147054,332,147054,,"BOGDANESTI",238,"SEDIUL PRIMARIEI COMUNEI BOGDANESTI",0,95,0,95,0,92,3,200,105,46,46,3,13914,1
35,"Suceava",147072,332,147072,,"BOROAIA",239,"CAMINUL CULTURAL BOROAIA, SAT BOROAIA -(CLADIREA NOUA)",929,475,413,62,0,471,4,1000,525,167,304,3,13916,0
35,"Suceava",147072,332,147072,,"BOROAIA",240,"SCOALA GENERALA NR.2, SAT BOROAIA",719,395,362,33,0,390,5,800,405,90,300,3,13916,0
35,"Suceava",147072,332,147072,,"BOROAIA",241,"CAMINUL CULTURAL GIULESTI, SAT GIULESTI",440,287,275,12,0,283,4,498,211,138,145,3,13916,0
35,"Suceava",147072,332,147072,,"BOROAIA",242,"SCOALA GENERALA BARASTI, SAT BARASTI",705,407,365,42,0,397,10,800,393,109,288,3,13916,0
35,"Suceava",147072,332,147072,,"BOROAIA",243,"SCOALA GENERALA SACUTA, SAT SACUTA",472,261,244,17,0,256,5,600,339,77,179,3,13916,0
35,"Suceava",147072,332,147072,,"BOROAIA",244,"SCOALA GENERALA  MOISA, SAT MOISA",581,274,263,11,0,270,4,700,426,95,175,3,13916,0
35,"Suceava",147072,332,147072,,"BOROAIA",245,"SCOALA CU CLASELE I-VIII NR. 1  VASILE TOMEGEA",0,114,0,114,0,113,1,202,88,67,46,3,13916,1
35,"Suceava",147134,332,147134,,"BOSANCI",246,"SCOALA GENERALA BOSANCI-CENTRU, CORPUL A, PARTEA DREAPTA, SALA DE CLASA PE PARTEA DREAPTA",1187,475,455,20,0,470,5,1300,825,337,133,3,13922,0
35,"Suceava",147134,332,147134,,"BOSANCI",247,"SCOALA GENERALA BOSANCI-CENTRU, CORPUL A, PARTEA DREAPTA, SALA DE CLASA PE PARTEA STANGA",973,516,448,68,0,510,6,1000,484,357,153,3,13922,0
35,"Suceava",147134,332,147134,,"BOSANCI",248,"SCOALA GENERALA BOSANCI-CENTRU, CORPUL B - GREADINITA",1210,559,521,38,0,545,14,1300,741,384,161,3,13922,0
35,"Suceava",147134,332,147134,,"BOSANCI",249,"SCOALA GENERALA BOSANCI-DEAL",1747,815,767,48,0,799,16,1800,985,598,201,3,13922,0
35,"Suceava",147134,332,147134,,"BOSANCI",250,"SCOALA GENERALA CUMPARATURA, SAT CUMPARATURA",238,142,126,16,0,136,6,305,163,101,35,3,13922,0
35,"Suceava",147134,332,147134,,"BOSANCI",251,"SEDIUL PRIMARIEI COMUNEI BOSANCI",0,68,0,68,0,68,0,200,132,46,22,3,13922,1
35,"Suceava",147161,332,147161,,"BOTOSANA",252,"CAMINUL CULTURAL BOTOSANA",2066,1276,1272,4,0,1271,5,2100,824,931,340,3,13925,0
35,"Suceava",147161,332,147161,,"BOTOSANA",253,"SCOALA DE ARTE SI MESERII BOTOSANA",0,61,0,61,0,61,0,200,139,46,15,3,13925,1
35,"Suceava",147205,332,147205,,"BREAZA",254,"CAMINUL CULTURAL, SAT BREAZA",1376,738,735,3,0,732,6,1600,862,324,408,3,13927,0
35,"Suceava",147205,332,147205,,"BREAZA",255,"PRIMARIA COMUNEI BREAZA",0,39,0,39,0,39,0,201,162,20,19,3,13927,1
35,"Suceava",147241,332,147241,,"BRODINA",256,"SCOALA GENERALA CU CLASELE I-VIII, SAT BRODINA, NR. 385B",1170,591,589,2,0,586,5,1200,609,325,261,3,13931,0
35,"Suceava",147241,332,147241,,"BRODINA",257,"SCOALA GENERALA CU CLASELE I-VIII, SAT BRODINA DE JOS, NR. 702A",679,325,318,7,0,322,3,800,475,245,77,3,13931,0
35,"Suceava",147241,332,147241,,"BRODINA",258,"GRADINITA CU PROGRAM NORMAL, SAT FALCAU, NR. 125B",1016,540,536,4,0,534,6,1096,556,361,173,3,13931,0
35,"Suceava",147241,332,147241,,"BRODINA",259,"SCOALA CU CLASELE I-IV SADU",0,57,0,57,0,57,0,200,143,33,24,3,13931,1
35,"Suceava",147465,332,147465,,"BUNESTI",260,"PRIMARIA  COMUNEI BUNESTI, SALA DE SEDINTE, SAT BUNESTI, NR.92",517,265,264,1,0,261,4,600,335,70,191,3,13942,0
35,"Suceava",147465,332,147465,,"BUNESTI",261,"SCOALA GENERALA PODENI, SALA NR.1, SAT PODENI",415,205,192,13,0,203,2,500,295,79,124,3,13942,0
35,"Suceava",147465,332,147465,,"BUNESTI",262,"SCOALA GENERALA NR. 1, SALA NR. 1, SAT PETIA",675,303,295,8,0,299,4,700,397,90,209,3,13942,0
35,"Suceava",147465,332,147465,,"BUNESTI",263,"SCOALA GENERALA UNCESTI, SALA NR. 2, SAT UNCESTI",534,259,248,11,0,252,7,600,341,102,150,3,13942,0
35,"Suceava",147465,332,147465,,"BUNESTI",264," SEDIUL PRIMARIEI  COMUNEI BUNESTI - SECRETARIAT",0,41,0,41,0,40,1,199,158,16,24,3,13942,1
35,"Suceava",151521,332,151521,,"BURLA",265,"CLADIREA MULTIFUNCTIONALA, SALA DE GRADINITA - PARTER, SAT BURLA, NR. 391",1520,764,756,6,2,750,14,1600,836,356,394,3,13948,0
35,"Suceava",151521,332,151521,,"BURLA",266,"CLADIREA MULTIFUNCTIONALA  SALA DE SEDINTE, PARTER, SAT BURLA, NR. 391",0,36,0,36,0,35,1,200,164,10,25,3,13948,1
35,"Suceava",147526,332,147526,,"CACICA",267,"CAMIN CULTURAL, SAT PARTESTII DE SUS",1504,918,911,3,4,905,13,1600,682,568,337,3,13950,0
35,"Suceava",147526,332,147526,,"CACICA",268,"SCOALA GENERALA CU CLASELE I-VIII, SAT CACICA",1124,578,564,4,10,574,4,1200,622,307,267,3,13950,0
35,"Suceava",147526,332,147526,,"CACICA",269,"SCOALA GENERALA CU CLASELE I-VIII, SAT SOLONETU NOU",629,377,370,7,0,372,5,700,323,260,112,3,13950,0
35,"Suceava",147526,332,147526,,"CACICA",270,"SCOALA GENERALA CU CLASELE I-VIII, SAT RUNCU",145,96,89,7,0,96,0,200,104,56,40,3,13950,0
35,"Suceava",147526,332,147526,,"CACICA",271,"HALTA DE MISCARE CACICA, SAT  PARTESTII DE SUS",0,87,0,87,0,85,2,200,113,48,37,3,13950,1
35,"Suceava",147580,332,147580,,"CALAFINDESTI",272,"ATENEUL POPULAR, SAT CALAFINDESTI,  SALA A",993,557,551,5,1,555,2,1100,543,237,318,3,13956,0
35,"Suceava",147580,332,147580,,"CALAFINDESTI",273,"ATENEUL POPULAR, SAT CALAFINDESTI,  SALA B",963,528,525,2,1,525,3,1000,472,223,302,3,13956,0
35,"Suceava",147580,332,147580,,"CALAFINDESTI",274,"CAMINUL CULTURAL, SAT BOTOSANITA MARE",264,188,178,8,2,187,1,300,112,49,138,3,13956,0
35,"Suceava",147580,332,147580,,"CALAFINDESTI",275,"SEDIUL PRIMARIEI CALAFINDESTI",0,42,0,42,0,42,0,200,158,21,21,3,13956,1
35,"Suceava",151503,332,151503,,"CAPU CAMPULUI",276,"CAMINUL CULTURAL CAPU CAMPULUI, SAT CAPU CAMPULUI, NR. 430",1857,1241,1239,2,0,1234,7,1900,659,802,432,3,13959,0
35,"Suceava",151503,332,151503,,"CAPU CAMPULUI",277,"CAMINUL CULTURAL - SALA BIBLIOTECA",0,92,0,92,0,92,0,200,108,62,30,3,13959,1
35,"Suceava",151451,332,151451,,"CIOCANESTI",278,"CASA DE CULTURA CIOCANESTI, SAT CIOCANESTI",913,634,610,10,14,630,4,1000,366,388,242,3,13968,0
35,"Suceava",151451,332,151451,,"CIOCANESTI",279,"CAMINUL CULTURAL BOTOS, SAT BOTOS",338,264,249,10,5,261,3,400,136,179,82,3,13968,0
35,"Suceava",151451,332,151451,,"CIOCANESTI",280,"CASA DE CULTURA",0,38,0,38,0,38,0,200,162,25,13,3,13968,1
35,"Suceava",151567,332,151567,,"CIPRIAN PORUMBESCU",281,"PRIMARIA COMUNEI CIPRIAN PORUMBESCU, SAT CIPRIAN PORUMBESCU, STR. PRINCIPALA, NR.207, SALA D",1529,864,861,3,0,862,2,1600,736,615,247,3,13971,0
35,"Suceava",151567,332,151567,,"CIPRIAN PORUMBESCU",282,"SCOALA GENERALA CU CLASELE I-VIII CIPRIAN PORUMBESCU, STR.PRINCIPALA, NR.283",0,86,0,86,0,86,0,200,114,55,31,3,13971,1
35,"Suceava",147713,332,147713,,"CARLIBABA",283,"PRIMARIA COMUNEI CORLIBABA, SAT CORLIBABA, SALA DE SEDINTE A CONSILIULUI LOCAL",1518,935,932,0,3,926,9,1600,665,649,277,3,13961,0
35,"Suceava",147713,332,147713,,"CARLIBABA",284,"SALA CAMINULUI CULTURAL, SAT CORLIBABA NOUA NR.82",0,58,0,58,0,58,0,200,142,40,18,3,13961,1
35,"Suceava",151433,332,151433,,"COMANESTI",285,"CAMINUL CULTURAL, SAT COMANESTI",983,648,638,5,5,643,5,1100,452,360,283,3,13973,0
35,"Suceava",151433,332,151433,,"COMANESTI",286,"CAMINUL CULTURAL, SAT HUMORENI",788,409,405,4,0,408,1,800,391,209,199,3,13973,0
35,"Suceava",151433,332,151433,,"COMANESTI",287,"CAMINUL CULTURAL COMANESTI",0,67,0,67,0,66,1,200,133,46,20,3,13973,1
35,"Suceava",147786,332,147786,,"CORNU LUNCII",288,"SCOALA GENERALA CORNU LUNCII, SAT CORNU LUNCII",1055,528,517,11,0,518,10,1100,572,203,315,3,13976,0
35,"Suceava",147786,332,147786,,"CORNU LUNCII",289,"SCOALA GENERALA BAISESTI, SAT BAISESTI",1183,753,743,9,1,746,7,1200,447,430,316,3,13976,0
35,"Suceava",147786,332,147786,,"CORNU LUNCII",290,"SCOALA GENERALA BRAIESTI, SAT BRAIESTI",1019,605,599,6,0,602,3,1100,495,395,207,3,13976,0
35,"Suceava",147786,332,147786,,"CORNU LUNCII",291,"SCOALA GENERALA DUMBRAVA, SAT DUMBRAVA",392,204,196,8,0,204,0,500,296,102,102,3,13976,0
35,"Suceava",147786,332,147786,,"CORNU LUNCII",292,"SCOALA GENERALA SASCA NOUA, SAT SASCA NOUA",181,96,87,9,0,95,1,200,104,35,60,3,13976,0
35,"Suceava",147786,332,147786,,"CORNU LUNCII",293,"SCOALA GENERALA SASCA MICA, SAT SASCA MICA",465,301,291,9,1,298,3,600,299,72,226,3,13976,0
35,"Suceava",147786,332,147786,,"CORNU LUNCII",294,"SCOALA GENERALA SINCA, SAT SINCA",148,99,88,11,0,98,1,200,101,30,68,3,13976,0
35,"Suceava",147786,332,147786,,"CORNU LUNCII",295,"SCOALA GENERALA SASCA MARE, SAT SASCA MARE",529,284,274,10,0,278,6,600,316,72,206,3,13976,0
35,"Suceava",147786,332,147786,,"CORNU LUNCII",296,"SCOALA GENERALA PAISENI, SAT PAISENI",568,336,323,13,0,328,8,700,364,123,205,3,13976,0
35,"Suceava",147786,332,147786,,"CORNU LUNCII",297,"PRIMARIA COMUNEI CORNU LUNCII, JUDETUL SUCEAVA (SALA DE SEDINTE)",0,197,0,197,0,171,26,500,303,112,59,3,13976,1
35,"Suceava",151497,332,151497,,"COSNA",298,"CAMINUL CULTURAL COSNA, SAT COSNA",1237,764,760,1,3,761,3,1300,536,528,233,3,13986,0
35,"Suceava",151497,332,151497,,"COSNA",299,"PRIMARIA COMUNEI COSNA, SAT COSNA NR.16",0,54,0,54,0,52,2,200,146,29,23,3,13986,1
35,"Suceava",147884,332,147884,,"CRUCEA",300,"PRIMARIA COMUNEI CRUCEA, SAT CRUCEA",1279,689,684,5,0,681,8,1300,611,374,307,3,13992,0
35,"Suceava",147884,332,147884,,"CRUCEA",301,"CAMINUL CULTURAL, SAT CHIRIL",440,278,271,7,0,273,5,500,222,177,96,3,13992,0
35,"Suceava",147884,332,147884,,"CRUCEA",302,"SEDIUL PRIMARIEI COMUNEI CRUCEA-BIROU ASISTENTA SOCIALA",0,50,0,50,0,50,0,200,150,23,27,3,13992,1
35,"Suceava",147937,332,147937,,"DARMANESTI",303,"CASA MULTIFUNCTIONALA, SAT DARMANESTI  CENTRU",1013,509,505,4,0,500,9,1100,591,339,161,3,13997,0
35,"Suceava",147937,332,147937,,"DARMANESTI",304,"SCOALA CU CLASELE I-IV, SAT DARMANESTI - GARA",766,435,415,20,0,430,5,800,365,238,192,3,13997,0
35,"Suceava",147937,332,147937,,"DARMANESTI",305,"SCOALA GENERALA, SAT MARITEI",1429,808,803,3,2,801,7,1500,692,506,295,3,13997,0
35,"Suceava",147937,332,147937,,"DARMANESTI",306,"SCOALA GENERALA, SAT CALINESTI  ENACHE",492,220,210,10,0,217,3,600,380,126,91,3,13997,0
35,"Suceava",147937,332,147937,,"DARMANESTI",307,"SCOALA GENERALA, SAT CALINESTI -VASILACHE",175,109,98,11,0,108,1,200,91,63,45,3,13997,0
35,"Suceava",147937,332,147937,,"DARMANESTI",308,"SCOALA GENERALA, SAT DANILA",788,429,423,6,0,426,3,900,471,233,193,3,13997,0
35,"Suceava",147937,332,147937,,"DARMANESTI",309,"SEDIUL PRIMARIEI COMUNEI DARMANESTI",0,98,0,98,0,95,3,200,102,71,24,3,13997,1
35,"Suceava",148097,332,148097,,"DOLHESTI",310,"PRIMARIA COMUNEI DOLHESTI, SAT DOLHESTII MARI, SALA DE SEDINTE",1506,829,822,7,0,819,10,1600,771,263,556,3,14004,0
35,"Suceava",148097,332,148097,,"DOLHESTI",311,"SCOALA GENERALA DOLHESTII MICI, SAT DOLHESTII MICI, SALA DE CURS CLASA III-A",1016,520,515,5,0,517,3,1100,580,222,295,3,14004,0
35,"Suceava",148097,332,148097,,"DOLHESTI",312,"SCOALA GENERALA VALEA BOUREI, SAT VALEA BOUREI SALA DE CURS GRADINITA",625,367,364,3,0,363,4,700,333,136,227,3,14004,0
35,"Suceava",148097,332,148097,,"DOLHESTI",313,"CAMINUL  CULTURAL DOLHESTI",0,80,0,80,0,80,0,200,120,34,46,3,14004,1
35,"Suceava",148131,332,148131,,"DORNA-ARINI",314,"SCOALA GENERALA CU CLASELE I-IV, SAT DORNA ARINI (GURA NEGRII)",518,312,297,15,0,310,2,605,293,170,140,3,14012,0
35,"Suceava",148131,332,148131,,"DORNA-ARINI",315,"CAMINUL CULTURAL COZANESTI,  SAT COZANESTI",1313,825,806,18,1,821,4,1399,574,499,322,3,14012,0
35,"Suceava",148131,332,148131,,"DORNA-ARINI",316,"SCOALA GENERALA CU CLASELE I-IV, SAT RUSCA",679,434,424,10,0,432,2,700,266,235,197,3,14012,0
35,"Suceava",148131,332,148131,,"DORNA-ARINI",317,"CLADIREA PRIMARIEI COMUNEI DORNA ARINI  SALA DE SEDINTE, SAT COZANESTI NR. 1A",0,75,0,75,0,75,0,200,125,47,28,3,14012,1
35,"Suceava",148202,332,148202,,"DORNA CANDRENILOR",318,"CAMINUL CULTURAL, SAT  DORNA CANDRENILOR",1659,1007,998,9,0,1002,5,1716,709,706,296,3,14008,0
35,"Suceava",148202,332,148202,,"DORNA CANDRENILOR",319,"CAMIN CULTURAL, SAT POIANA NEGRII",756,479,472,6,1,479,0,802,323,385,94,3,14008,0
35,"Suceava",148202,332,148202,,"DORNA CANDRENILOR",320,"PRIMARIA COMUNEI DORNA CANDRENILOR, STR. PRINCIPALA, NR. 85",0,59,0,59,0,59,0,200,141,45,14,3,14008,1
35,"Suceava",148293,332,148293,,"DORNESTI",321,"SCOALA DE ARTE SI MESERII, SAT DORNESTI",1658,677,676,1,0,667,10,1700,1023,310,357,3,14019,0
35,"Suceava",148293,332,148293,,"DORNESTI",322,"CAMINUL CULTURAL DORNESTI, SAT DORNESTI",1750,874,868,6,0,862,12,1800,926,427,435,3,14019,0
35,"Suceava",148293,332,148293,,"DORNESTI",323,"SCOALA GENERALA, SAT IAZ",147,79,69,10,0,77,2,200,121,39,38,3,14019,0
35,"Suceava",148293,332,148293,,"DORNESTI",324,"SCOALA VECHE DORNESTI",0,62,0,62,0,61,1,200,138,31,30,3,14019,1
35,"Suceava",148328,332,148328,,"DRAGOIESTI",325," PRIMARIA COMUNEI DRAGOIESTI, SAT MAZANAESTI",479,281,260,16,5,276,5,600,319,159,117,3,14022,0
35,"Suceava",148328,332,148328,,"DRAGOIESTI",326,"CAMINUL CULTURAL  LUCACESTI, SAT LUCACESTI",225,154,145,8,1,152,2,300,146,83,69,3,14022,0
35,"Suceava",148328,332,148328,,"DRAGOIESTI",327,"CAMINUL CULTURAL  DRAGOIESTI, SAT DRAGOIESTI",1386,881,856,15,10,875,6,1500,619,547,328,3,14022,0
35,"Suceava",148328,332,148328,,"DRAGOIESTI",328,"SEDIUL PRIMARIEI COMUNEI DRAGOIESTI",0,87,0,87,0,87,0,200,113,61,26,3,14022,1
35,"Suceava",148382,332,148382,,"DRAGUSENI",329,"PRIMARIA COMUNEI DRAGUSENI, SAT DRAGUSENI",1787,900,893,7,0,890,10,1900,1000,241,649,3,14026,0
35,"Suceava",148382,332,148382,,"DRAGUSENI",330,"SCOALA GENERALA, SAT BROSTENI",305,176,157,19,0,174,2,400,224,50,124,3,14026,0
35,"Suceava",148382,332,148382,,"DRAGUSENI",331,"CAMINUL CULTURAL DRAGUSENI",0,85,0,85,0,84,1,200,115,40,44,3,14026,1
35,"Suceava",148426,332,148426,,"DUMBRAVENI",332,"SEDIUL ATENEU GRADINITA DE COPII, SAT DUMBRAVENI",1262,648,635,13,0,641,7,1400,752,420,221,3,14030,0
35,"Suceava",148426,332,148426,,"DUMBRAVENI",333,"GRUPUL SCOLAR, SAT DUMBRAVENI",1744,850,841,9,0,845,5,1801,951,585,260,3,14030,0
35,"Suceava",148426,332,148426,,"DUMBRAVENI",334,"SCOALA GENERALA TOLOACA, SAT DUMBRAVENI",1561,807,783,22,2,796,11,1600,793,516,280,3,14030,0
35,"Suceava",148426,332,148426,,"DUMBRAVENI",335,"SCOALA GENERALA DEAL, SAT DUMBRAVENI",1350,759,747,0,12,755,4,1400,641,480,275,3,14030,0
35,"Suceava",148426,332,148426,,"DUMBRAVENI",336,"SCOALA GENERALA, SAT SALAGENI",404,193,188,5,0,191,2,500,307,102,89,3,14030,0
35,"Suceava",148426,332,148426,,"DUMBRAVENI",337,"CAMINUL CULTURAL DUMBRAVENI",0,77,0,77,0,77,0,200,123,47,30,3,14030,1
35,"Suceava",151488,332,151488,,"FANTANA MARE",338,"SCOALA GENERALA CU CLASELE I-IV, SAT FANTANA MARE",781,448,436,12,0,443,5,900,452,151,292,3,14033,0
35,"Suceava",151488,332,151488,,"FANTANA MARE",339,"SCOALA GENERALA CU CLASELE I-VIII, SAT COTU BAII",762,397,392,5,0,392,5,900,503,140,252,3,14033,0
35,"Suceava",151488,332,151488,,"FANTANA MARE",340,"SCOALA GENERALA CU CLASELE I-IV, SAT PRAXIA",138,97,89,8,0,94,3,200,103,54,40,3,14033,0
35,"Suceava",151488,332,151488,,"FANTANA MARE",341,"SCOALA GENERALA CU CLASELE I-IV, SAT SPATARESTI",371,212,204,8,0,211,1,500,288,88,123,3,14033,0
35,"Suceava",151488,332,151488,,"FANTANA MARE",342,"SALA DE SEDINTE CONSILIUL LOCAL FANTANA MARE",0,79,0,79,0,79,0,200,121,40,39,3,14033,1
35,"Suceava",148453,332,148453,,"FANTANELE",343,"CAMIN CULTURAL, SAT FANTANELE",879,441,436,5,0,440,1,1000,559,227,213,3,14038,0
35,"Suceava",148453,332,148453,,"FANTANELE",344,"SCOALA GENERALA CU CLASELE I-IV, SAT SLOBOZIA",175,114,102,12,0,112,2,300,186,43,69,3,14038,0
35,"Suceava",148453,332,148453,,"FANTANELE",345,"CAMINUL CULTURAL, SAT BANESTI",915,529,521,8,0,522,7,1099,570,248,274,3,14038,0
35,"Suceava",148453,332,148453,,"FANTANELE",346,"CAMINUL CULTURAL, SAT  STAMATE",1572,883,874,9,0,874,9,1600,717,364,510,3,14038,0
35,"Suceava",148453,332,148453,,"FANTANELE",347,"SCOALA GENERALA CU CLASELE I - IV , SAT COTU DOBEI",156,107,99,8,0,106,1,198,91,22,84,3,14038,0
35,"Suceava",148453,332,148453,,"FANTANELE",348,"SCOALA DE ARTE SI MESERII  MIHAI EMINESCU  , SAT BANESTI",0,90,0,90,0,89,1,190,100,44,45,3,14038,1
35,"Suceava",148514,332,148514,,"FORASTI",349,"PRIMARIA  FORASTI, SATUL FORASTI, SALA DE SEDINTE",566,270,267,3,0,263,7,700,430,111,152,3,14044,0
35,"Suceava",148514,332,148514,,"FORASTI",350,"SCOALA  GENERALA CU CLASELE I-IV ANTOCENI, SAT ANTOCENI",285,155,149,6,0,152,3,400,245,44,108,3,14044,0
35,"Suceava",148514,332,148514,,"FORASTI",351,"SCOALA  GENERALA CU CLASELE I-IV ONICENI, SAT ONICENI",815,516,500,4,12,509,7,900,384,109,400,3,14044,0
35,"Suceava",148514,332,148514,,"FORASTI",352,"SCOALA  GENERALA CU CLASELE I-IV ROSIORI, SAT ROSIORI",286,187,177,10,0,185,2,400,213,65,120,3,14044,0
35,"Suceava",148514,332,148514,,"FORASTI",353,"SCOALA  GENERALA CU CLASELE I-IV RUSI, SAT RUSI",357,236,229,7,0,234,2,500,264,60,174,3,14044,0
35,"Suceava",148514,332,148514,,"FORASTI",354,"SCOALA  GENERALA CU CLASELE I-IV TOLESTI, SAT TOLESTI",361,190,179,11,0,187,3,500,310,43,144,3,14044,0
35,"Suceava",148514,332,148514,,"FORASTI",355,"SCOALA  GENERALA CU CLASELE I-IV BOURA, SAT BOURA",486,265,252,13,0,260,5,600,335,94,166,3,14044,0
35,"Suceava",148514,332,148514,,"FORASTI",356,"SEDIUL FOSTEI PRIMARII MANOLEA, SAT MANOLEA, SALA PROTOCOL",474,275,251,24,0,273,2,600,325,75,198,3,14044,0
35,"Suceava",148514,332,148514,,"FORASTI",357,"SCOALA GENERALA CU CLASELE I-IV UIDESTI, SAT UIDESTI",135,90,80,10,0,89,1,200,110,23,66,3,14044,0
35,"Suceava",148514,332,148514,,"FORASTI",358,"SCOALA GENERALA CU CLASELE I-IV VIISOARA, SAT MANOLEA, CATUN VIISOARA",203,143,118,25,0,140,3,300,157,31,109,3,14044,0
35,"Suceava",148514,332,148514,,"FORASTI",359,"PRIMARIA  COMUNEI FORASTI, SALA  CASIERIE",0,116,0,116,0,115,1,200,84,51,64,3,14044,1
35,"Suceava",148667,332,148667,,"FRATAUTII NOI",360,"CAMINUL CULTURAL, SAT FRATAUTII NOI",1250,616,592,24,0,601,15,1400,784,315,286,3,14054,0
35,"Suceava",148667,332,148667,,"FRATAUTII NOI",361,"SCOALA CU CLASELE I-VIII NR. 2, SAT FRATAUTII NOI",1331,512,492,20,0,498,14,1500,988,341,157,3,14054,0
35,"Suceava",148667,332,148667,,"FRATAUTII NOI",362,"SCOALA CU CLASELE I-IV NR. 3 , SAT FRATAUTII NOI",386,209,193,16,0,206,3,500,291,130,76,3,14054,0
35,"Suceava",148667,332,148667,,"FRATAUTII NOI",363,"CAMINUL CULTURAL, SAT COSTISA",793,322,308,14,0,317,5,900,578,156,161,3,14054,0
35,"Suceava",148667,332,148667,,"FRATAUTII NOI",364,"SCOALA CU CLASELE I-IV NR. 2, SAT COSTISA",532,230,211,19,0,226,4,600,370,82,144,3,14054,0
35,"Suceava",148667,332,148667,,"FRATAUTII NOI",365,"SCOALA DE ARTE SI MESERII  IRACLIE PORUMBESCU  NR. 1 FRATAUTII NOI",0,56,0,56,0,56,0,201,145,28,28,3,14054,1
35,"Suceava",148694,332,148694,,"FRATAUTII VECHI",366,"CAMIN CULTURAL, SAT  FRATAUTII VECHI",1288,612,604,8,0,594,18,1500,888,377,217,3,14057,0
35,"Suceava",148694,332,148694,,"FRATAUTII VECHI",367,"SCOALA CU CLASELE I-IV NR. 2, SAT FRATAUTII VECHI",950,488,477,11,0,481,7,1100,612,314,167,3,14057,0
35,"Suceava",148694,332,148694,,"FRATAUTII VECHI",368,"CAMIN CULTURAL, SAT  MANEUTI",1554,670,657,13,0,664,6,1800,1130,451,213,3,14057,0
35,"Suceava",148694,332,148694,,"FRATAUTII VECHI",369,"INCINTA PRIMARIEI FRATAUTII VECHI-HOLUL PRINCIPAL DE ACCES",0,68,0,68,0,67,1,200,132,39,28,3,14057,1
35,"Suceava",148729,332,148729,,"FRUMOSU",370,"PRIMARIA COMUNEI FRUMOSU, SAT FRUMOSU",1859,1106,1102,4,0,1102,4,2100,994,665,437,3,14060,0
35,"Suceava",148729,332,148729,,"FRUMOSU",371,"SCOALA  CU CLASELE I-IV, SAT DRAGOSA",339,184,174,10,0,183,1,400,216,132,51,3,14060,0
35,"Suceava",148729,332,148729,,"FRUMOSU",372,"CAMIN CULTURAL,SAT DEIA",702,466,459,7,0,461,5,800,334,300,161,3,14060,0
35,"Suceava",148729,332,148729,,"FRUMOSU",373,"SCOALA CU CLASELE I-VIII  IOAN SUHANE  SATUL FRUMOSU",0,26,0,26,0,26,0,200,174,18,8,3,14060,1
35,"Suceava",148765,332,148765,,"FUNDU MOLDOVEI",374,"SCOALA CU CLASELE I-VIII   DIMITRIE GUSTI , SAT FUNDU MOLDOVEI",1586,892,876,15,1,885,7,1800,908,567,318,3,14064,0
35,"Suceava",148765,332,148765,,"FUNDU MOLDOVEI",375,"SCOALA GENERALA CU CLASELE I -VIII   SAT COLACU",824,495,489,6,0,493,2,1000,505,206,287,3,14064,0
35,"Suceava",148765,332,148765,,"FUNDU MOLDOVEI",376,"SCOALA GENERALA CU CLASELE I-VIII, SAT BOTUS",1032,551,534,17,0,546,5,1200,649,330,216,3,14064,0
35,"Suceava",148765,332,148765,,"FUNDU MOLDOVEI",377,"SEDIUL PRIMARIEI FUNDU MOLDOVEI",0,55,0,55,0,54,1,200,145,23,31,3,14064,1
35,"Suceava",148872,332,148872,,"GALANESTI",378,"GRADINITA GALANESTI, SAT  GALANESTI",1282,599,593,6,0,594,5,1500,901,236,358,3,14075,0
35,"Suceava",148872,332,148872,,"GALANESTI",379,"SCOALA CU CLASELE I-IV, SAT HURJUIENI",882,361,359,2,0,357,4,939,578,124,233,3,14075,0
35,"Suceava",148872,332,148872,,"GALANESTI",380,"CAMINUL CULTURAL GALANESTI",0,36,0,36,0,36,0,200,164,14,22,3,14075,1
35,"Suceava",148916,332,148916,,"GRAMESTI",381,"SCOALA GENERALA CU CLASELE I-VIII GRAMESTI , SAT GRAMESTI",1644,939,934,5,0,923,16,1900,961,445,478,3,14078,0
35,"Suceava",148916,332,148916,,"GRAMESTI",382,"SCOALA CU CLASELE I-IV, SAT BALINESTI",552,330,315,15,0,325,5,696,366,99,226,3,14078,0
35,"Suceava",148916,332,148916,,"GRAMESTI",383,"SCOALA CU CLASELE I-IV, SAT  BOTOSENITA MICA",194,146,134,12,0,145,1,300,154,32,113,3,14078,0
35,"Suceava",148916,332,148916,,"GRAMESTI",384,"PRIMARIA COMUNEI GRAMESTI",0,85,0,85,0,82,3,200,115,38,44,3,14078,1
35,"Suceava",148970,332,148970,,"GRANICESTI",385,"SCOALA CU CLASELE I-VIII  MIHAIL SADOVEANU , SAT GRANICESTI",1555,741,736,5,0,730,11,1800,1059,378,352,3,14084,0
35,"Suceava",148970,332,148970,,"GRANICESTI",386,"SCOALA CU CLASELE I-IV, SAT DUMBRAVA",318,146,138,8,0,146,0,400,254,93,53,3,14084,0
35,"Suceava",148970,332,148970,,"GRANICESTI",387,"SCOALA CU CLASELE I-VIII, SAT GURA SOLCII",476,235,229,6,0,232,3,600,365,82,150,3,14084,0
35,"Suceava",148970,332,148970,,"GRANICESTI",388,"SCOALA CLASELE I-IV, SAT  IACOBESTI",435,201,193,8,0,201,0,590,389,143,58,3,14084,0
35,"Suceava",148970,332,148970,,"GRANICESTI",389,"SCOALA CU CLASELE I-VIII, SAT ROMANESTI",490,249,246,3,0,247,2,600,351,85,162,3,14084,0
35,"Suceava",148970,332,148970,,"GRANICESTI",390,"SCOALA CU CLASELE I-IV, SAT SLOBOZIA SUCEVEI",472,205,197,8,0,200,5,600,395,106,94,3,14084,0
35,"Suceava",148970,332,148970,,"GRANICESTI",391,"SALA DE SEDINTE DIN CADRUL PRIMARIEI COMUNEI GRANICESTI",0,52,0,52,0,52,0,201,149,29,23,3,14084,1
35,"Suceava",151512,332,151512,,"HANTESTI",392,"SCOALA CU CLASELE I-VIII, SAT   HANTESTI",1361,788,752,4,32,778,10,1500,712,298,480,3,14091,0
35,"Suceava",151512,332,151512,,"HANTESTI",393,"SCOALA CU CLASELE I-IV, SAT HANTESTI",1070,615,595,9,11,598,17,1200,585,218,380,3,14091,0
35,"Suceava",151512,332,151512,,"HANTESTI",394,"SCOALA CU CLASELE I-IV, SAT BERESTI",483,287,266,8,13,284,3,600,313,128,156,3,14091,0
35,"Suceava",151512,332,151512,,"HANTESTI",395,"SEDIUL PRIMARIEI HANTESTI",0,74,0,74,0,73,1,200,126,23,50,3,14091,1
35,"Suceava",151549,332,151549,,"HARTOP",396,"PRIMARIA COMUNEI HARTOP, SAT HARTOP",1778,1083,1059,12,12,1074,9,2000,917,532,542,3,14095,0
35,"Suceava",151549,332,151549,,"HARTOP",397,"SEDIUL PRIMARIEI HARTOP, BIROU AGRICOL",0,49,0,49,0,49,0,200,151,26,23,3,14095,1
35,"Suceava",149101,332,149101,,"HORODNIC DE JOS",398,"CAMINUL CULTURAL, SAT HORODNIC DE JOS",1328,717,710,7,0,711,6,1500,783,403,308,3,14097,0
35,"Suceava",149101,332,149101,,"HORODNIC DE JOS",399,"SCOALA GENERALA NR.2, SAT HORODNIC DE JOS CALUGARITA",640,380,374,6,0,372,8,800,420,253,119,3,14097,0
35,"Suceava",149101,332,149101,,"HORODNIC DE JOS",400,"SEDIUL PRIMARIEI COMUNEI HORODNIC DE JOS",0,46,0,46,0,46,0,200,154,28,18,3,14097,1
35,"Suceava",151479,332,151479,,"HORODNIC DE SUS",401,"SCOALA GENERALA NR.1, SAT HORODNIC DE SUS",1508,732,716,16,0,724,8,1700,968,420,304,3,14099,0
35,"Suceava",151479,332,151479,,"HORODNIC DE SUS",402,"SCOALA GENERALA NR.2, SAT HORODNIC DE SUS",1064,509,492,17,0,501,8,1200,691,286,215,3,14099,0
35,"Suceava",151479,332,151479,,"HORODNIC DE SUS",403,"SCOALA GENERALA NR. 3, SAT HORODNIC DE SUS",1008,458,443,15,0,445,13,1200,742,191,254,3,14099,0
35,"Suceava",151479,332,151479,,"HORODNIC DE SUS",404,"CAMINUL CULTURAL HORODNIC DE SUS",0,54,0,54,0,53,1,200,146,26,27,3,14099,1
35,"Suceava",149049,332,149049,,"HORODNICENI",405,"PRIMARIA COMUNEI HORODNICENI, SAT HORODNICENI",944,560,536,11,13,554,6,1100,540,263,291,3,14101,0
35,"Suceava",149049,332,149049,,"HORODNICENI",406,"SCOALA CU CLASELE I-IV, SAT BOTESTI",396,258,241,13,4,251,7,504,246,141,110,3,14101,0
35,"Suceava",149049,332,149049,,"HORODNICENI",407,"SCOALA CU CLASELE I-IV , SAT BRADATEL",391,242,230,12,0,236,6,500,258,120,116,3,14101,0
35,"Suceava",149049,332,149049,,"HORODNICENI",408,"SCOALA CU CLASELE I-VIII, SAT MIHAIESTI",554,498,353,145,0,491,7,691,193,146,345,3,14101,0
35,"Suceava",149049,332,149049,,"HORODNICENI",409,"SCOALA CU CLASELE I-IV, SAT ROTOPANESTI",752,315,297,12,6,310,5,894,579,113,197,3,14101,0
35,"Suceava",149049,332,149049,,"HORODNICENI",410,"SCOALA  CU CLASELE I-VIII NR.1  HORODNICENI",0,95,0,95,0,95,0,200,105,44,51,3,14101,1
35,"Suceava",149138,332,149138,,"IACOBENI",411,"CASA NATIONALA, SAT IACOBENI",1048,602,577,12,13,600,2,1200,598,381,219,3,14107,0
35,"Suceava",149138,332,149138,,"IACOBENI",412,"SCOALA CU CLASELE I-IV CARAUSI, SAT IACOBENI",643,387,366,15,6,384,3,800,413,201,183,3,14107,0
35,"Suceava",149138,332,149138,,"IACOBENI",413,"CLUBUL FERMIERILOR, SAT MESTECANIS",246,177,164,12,1,177,0,400,223,101,76,3,14107,0
35,"Suceava",149138,332,149138,,"IACOBENI",414,"SEDIUL PRIMARIEI IACOBENI",0,60,0,60,0,60,0,200,140,39,21,3,14107,1
35,"Suceava",151442,332,151442,,"IASLOVAT",415," CAMINUL CULTURAL, SAT IASLOVAT, SALA MICA",1427,684,678,6,0,678,6,1600,916,351,327,3,14110,0
35,"Suceava",151442,332,151442,,"IASLOVAT",416,"SCOALA NR.2, SAT  IASLOVAT",1254,590,589,1,0,581,9,1400,810,294,287,3,14110,0
35,"Suceava",151442,332,151442,,"IASLOVAT",417,"SALA DE SEDINTE A  CONSILIULUI  LOCAL  AL COMUNEI IASLOVAT, JUDETUL SUCEAVA,  DIN SEDIUL  PR",0,31,0,31,0,31,0,200,169,18,13,3,14110,1
35,"Suceava",147660,332,147660,,"ILISESTI",418,"PRIMARIA COMUNEI ILISESTI, SAT ILISESTI, STR. PRINCIPALA, NR. 150",1846,1044,1002,19,23,1027,17,2100,1056,598,429,3,14112,0
35,"Suceava",147660,332,147660,,"ILISESTI",419,"CAMINUL CULTURAL, SAT BRASCA",290,196,184,12,0,196,0,400,204,108,88,3,14112,0
35,"Suceava",147660,332,147660,,"ILISESTI",420,"CAMINUL  CULTURAL ILISESTI",0,124,0,124,0,124,0,200,76,85,39,3,14112,1
35,"Suceava",146281,332,146281,,"IPOTESTI",421,"SCOALA CU CLASELE I-VIII, SAT IPOTESTI, STR. BISERICII",1060,585,563,21,1,576,9,1200,615,433,143,3,14115,0
35,"Suceava",146281,332,146281,,"IPOTESTI",422,"CAMIN CULTURAL, SAT IPOTESTI, STR.STEFAN CEL MARE",939,515,502,13,0,511,4,1100,585,320,191,3,14115,0
35,"Suceava",146281,332,146281,,"IPOTESTI",423,"SCOALA CU CLASELE I-IV, SAT IPOTESTI, STR. STEFAN CEL MARE",986,531,515,16,0,527,4,1097,566,393,134,3,14115,0
35,"Suceava",146281,332,146281,,"IPOTESTI",424,"SCOALA CU CLASELE I-IV , SAT TISAUTI",761,475,466,9,0,473,2,900,425,270,203,3,14115,0
35,"Suceava",146281,332,146281,,"IPOTESTI",425,"SCOALA CU CLASELE I-IV, SAT LISAURA",648,436,416,20,0,430,6,800,364,234,196,3,14115,0
35,"Suceava",146281,332,146281,,"IPOTESTI",426,"PRIMARIA COMUNEI IPOTESTI, STR. MIHAI VITEAZU, NR.541",0,70,0,70,0,69,1,200,130,46,23,3,14115,1
35,"Suceava",149183,332,149183,,"IZVOARELE SUCEVEI",427,"PRIMARIA COMUNEI IZVOARELE SUCEVEI, SAT IZVOARELE SUCEVEI",750,375,352,23,0,369,6,900,525,246,123,3,14119,0
35,"Suceava",149183,332,149183,,"IZVOARELE SUCEVEI",428,"SCOALA GENERALA CU CLASELE I-IV, SAT BOBEICA",375,189,183,6,0,189,0,490,301,158,31,3,14119,0
35,"Suceava",149183,332,149183,,"IZVOARELE SUCEVEI",429,"SCOALA GENERALA CU CLASELE I-VIII, SAT  BRODINA",565,228,226,2,0,227,1,700,472,182,45,3,14119,0
35,"Suceava",149183,332,149183,,"IZVOARELE SUCEVEI",430,"PRIMARIA IZVOARELE SUCEVEI  SALA DE SEDINTE",0,44,0,44,0,43,1,200,156,28,15,3,14119,1
35,"Suceava",149290,332,149290,,"MARGINEA",431,"SCOALA NR.2, SAT  MARGINEA, NR. 271 - SALA NR.1",1065,505,498,7,0,495,10,1200,695,351,144,3,14133,0
35,"Suceava",149290,332,149290,,"MARGINEA",432,"SCOALA NR.2, SAT  MARGINEA, NR. 271 - SALA NR.2",1217,534,528,6,0,525,9,1300,766,364,161,3,14133,0
35,"Suceava",149290,332,149290,,"MARGINEA",433,"SCOALA NR.1, SAT MARGINEA, NR. 918, SALA - NR.1",1189,578,552,26,0,562,16,1400,822,372,190,3,14133,0
35,"Suceava",149290,332,149290,,"MARGINEA",434,"SCOALA NR.1, SAT MARGINEA, NR.918, SALA - NR.2",1288,565,552,13,0,559,6,1500,935,408,151,3,14133,0
35,"Suceava",149290,332,149290,,"MARGINEA",435,"CAMINUL CULTURAL, SAT MARGINEA, NR. 919",1183,517,503,14,0,506,11,1400,883,328,178,3,14133,0
35,"Suceava",149290,332,149290,,"MARGINEA",436,"SCOALA NR.3, SAT MARGINEA, NR. 1243",1273,585,557,28,0,579,6,1500,915,377,202,3,14133,0
35,"Suceava",149290,332,149290,,"MARGINEA",437,"SCOALA DE ARTE SI MESERII  VASILE GHERASIM , MARGINEA",0,80,0,80,0,79,1,200,120,49,30,3,14133,1
35,"Suceava",149316,332,149316,,"MALINI",438,"PRIMARIA COMUNEI MALINI, SAT MALINI, STRADA PRINCIPALA, NR. 979",1273,744,643,101,0,728,16,1400,656,378,350,3,14123,0
35,"Suceava",149316,332,149316,,"MALINI",439,"SCOALA GENERALA NR. 2 MALINI, SAT MALINI",1465,872,799,73,0,863,9,1600,728,326,537,3,14123,0
35,"Suceava",149316,332,149316,,"MALINI",440,"SCOALA GENERALA PARAIE, SAT PARAIE,  MALINI",1443,813,789,24,0,807,6,1600,787,519,288,3,14123,0
35,"Suceava",149316,332,149316,,"MALINI",441,"SCOALA GENERALA POIANA MARULUI, SAT POIANA MARULUI,  MALINI",1036,576,564,12,0,563,13,1200,624,262,301,3,14123,0
35,"Suceava",149316,332,149316,,"MALINI",442,"SCOALA GENERALA NR. 1 VALENI, SAT VALENI,  MALINI",642,422,405,17,0,416,6,800,378,240,176,3,14123,0
35,"Suceava",149316,332,149316,,"MALINI",443,"SCOALA GENERALA NR.1 MALINI",0,115,0,115,0,115,0,200,85,76,39,3,14123,1
35,"Suceava",149370,332,149370,,"MANASTIREA HUMORULUI",444,"CAMINUL CULTURAL, SAT MANASTIREA HUMORULUI, STRADA STEFAN CEL MARE, NR.142",921,547,539,4,4,543,4,1100,553,393,150,3,14129,0
35,"Suceava",149370,332,149370,,"MANASTIREA HUMORULUI",445,"SCOALA CU CLASELE I-VIII, SAT MANASTIREA HUMORULUI, STRADA STEFAN CEL MARE, NR. 153",1019,629,608,13,8,626,3,1200,571,480,146,3,14129,0
35,"Suceava",149370,332,149370,,"MANASTIREA HUMORULUI",446,"CAMINUL CULTURAL,  SAT PLESA",166,92,83,9,0,92,0,200,108,74,18,3,14129,0
35,"Suceava",149370,332,149370,,"MANASTIREA HUMORULUI",447,"SCOALA CU CLASELE I-VIII,  NR.2, SAT POIANA MICULUI",463,296,289,7,0,294,2,600,304,238,56,3,14129,0
35,"Suceava",149370,332,149370,,"MANASTIREA HUMORULUI",448,"SCOALA CU CLASELE I-IV,  NR.1, SAT POIANA MICULUI",280,165,153,12,0,164,1,403,238,82,82,3,14129,0
35,"Suceava",149370,332,149370,,"MANASTIREA HUMORULUI",449,"SCOALA GENERALA CU CLASELE I-VIII MANASTIREA HUMORULUI",0,98,0,98,0,98,0,200,102,45,53,3,14129,1
35,"Suceava",146325,332,146325,,"MITOCU DRAGOMIRNEI",450,"SCOALA CU CLASELE I VIII, SAT MITOCU DRAGOMIRNEI (RUSI)",931,551,449,102,0,545,6,1100,549,359,186,3,14135,0
35,"Suceava",146325,332,146325,,"MITOCU DRAGOMIRNEI",451,"GRADINITA CU PROGRAM NORMAL MITOCU DRAGOMIRNEI, SAT MITOCU DRAGOMIRNEI",1387,820,737,83,0,795,25,1500,680,598,197,3,14135,0
35,"Suceava",146325,332,146325,,"MITOCU DRAGOMIRNEI",452,"SCOALA CU CLASELE I-IV, SAT LIPOVENI",370,208,198,10,0,204,4,500,292,136,68,3,14135,0
35,"Suceava",146325,332,146325,,"MITOCU DRAGOMIRNEI",453,"SCOALA CU CLASELE I-IV , SAT MITOCASI",611,369,353,14,2,367,2,700,331,236,131,3,14135,0
35,"Suceava",146325,332,146325,,"MITOCU DRAGOMIRNEI",454,"NOUL SEDIU AL PRIMARIEI COMUNEI MITOCU DRAGOMIRNEI",0,121,0,121,0,120,1,300,179,92,28,3,14135,1
35,"Suceava",149414,332,149414,,"MOARA",455,"PRIMARIA COMUNEI MOARA, SAT MOARA NICA",1243,637,632,5,0,632,5,1400,763,404,228,3,14140,0
35,"Suceava",149414,332,149414,,"MOARA",456,"SCOALA DE ARTE SI MESERII MOARA, SAT MOARA NICA",683,354,344,10,0,349,5,807,453,201,148,3,14140,0
35,"Suceava",149414,332,149414,,"MOARA",457,"SCOALA GENERALA MOARA CARP, SAT  MOARA CARP",676,375,368,7,0,371,4,800,425,219,152,3,14140,0
35,"Suceava",149414,332,149414,,"MOARA",458,"SCOALA GENERALA FRUMOASA, SAT FRUMOASA",146,81,71,10,0,78,3,200,119,40,38,3,14140,0
35,"Suceava",149414,332,149414,,"MOARA",459,"CAMINUL CULTURAL LITENI, SAT LITENI",678,395,377,18,0,394,1,800,405,186,208,3,14140,0
35,"Suceava",149414,332,149414,,"MOARA",460,"SCOALA GENERALA VORNICENII MARI, SAT  VORNICENII MARI",244,135,126,9,0,135,0,300,165,54,81,3,14140,0
35,"Suceava",149414,332,149414,,"MOARA",461,"CAMINUL CULTURAL MOARA NICA",0,109,0,109,0,107,2,290,181,68,39,3,14140,1
35,"Suceava",149502,332,149502,,"MOLDOVA-SULITA",462,"PRIMARIA COMUNEI MOLDOVA SULITA, SAT MOLDOVA SULITA",1060,514,512,2,0,511,3,1200,686,364,147,3,14149,0
35,"Suceava",149502,332,149502,,"MOLDOVA-SULITA",463,"SCOALA  CU CLASELE I-IV , SAT BENIA",551,321,321,0,0,321,0,700,379,232,89,3,14149,0
35,"Suceava",149502,332,149502,,"MOLDOVA-SULITA",464,"SEDIUL PRIMARIEI COMUNEI MOLDOVA SULITA",0,45,0,45,0,44,1,200,155,23,21,3,14149,1
35,"Suceava",149539,332,149539,,"MOLDOVITA",465,"SALA DE SPECTACOLE, SAT MOLDOVITA",1863,1054,1052,2,0,1044,10,2100,1046,768,276,3,14152,0
35,"Suceava",149539,332,149539,,"MOLDOVITA",466,"CAMIN  CULTURAL, SAT DEMACUSA",784,504,497,7,0,503,1,900,396,383,120,3,14152,0
35,"Suceava",149539,332,149539,,"MOLDOVITA",467,"SCOALA CU CLASELE I-IV, SAT RASCA",640,411,402,9,0,405,6,800,389,356,49,3,14152,0
35,"Suceava",149539,332,149539,,"MOLDOVITA",468,"SCOALA CU CLASELE I-VIII, SAT ARGEL",774,459,451,8,0,456,3,900,441,399,57,3,14152,0
35,"Suceava",149539,332,149539,,"MOLDOVITA",469,"SECTIA DE VOTARE DE LA SEDIUL PRIMARIEI COMUNEI MOLDOVITA",0,90,0,90,0,89,1,200,110,58,31,3,14152,1
35,"Suceava",149584,332,149584,,"MUSENITA",470,"CAMINUL CULTURAL, SAT BAINET",275,147,137,9,1,144,3,400,253,66,78,3,14157,0
35,"Suceava",149584,332,149584,,"MUSENITA",471,"CAMINUL CULTURAL, SAT CLIMAUTI",365,192,174,7,11,185,7,500,308,64,121,3,14157,0
35,"Suceava",149584,332,149584,,"MUSENITA",472,"CLADIREA  DOM POLSKI , SAT  VICSANI",201,123,117,6,0,123,0,300,177,45,78,3,14157,0
35,"Suceava",149584,332,149584,,"MUSENITA",473,"SCOALA CU CLASELE I-IV, SAT MUSENITA",338,183,173,8,2,179,4,400,217,48,131,3,14157,0
35,"Suceava",149584,332,149584,,"MUSENITA",474,"CAMINUL CULTURAL, SAT VASCAUTI",487,289,274,9,6,285,4,600,311,89,196,3,14157,0
35,"Suceava",149584,332,149584,,"MUSENITA",475,"CLADIREA SCOLII CU CLASELE I-VIII BAINET, CORPUL  B",0,34,0,34,0,34,0,200,166,10,24,3,14157,1
35,"Suceava",149655,332,149655,,"OSTRA",476,"CAMIN CULTURAL NOU, SAT OSTRA, NR.251",2112,1072,1063,2,7,1066,6,2400,1328,654,412,3,14164,0
35,"Suceava",149655,332,149655,,"OSTRA",477,"CAMIN CULTURAL VECHI, SAT OSTRA, NR.471",305,194,183,9,2,192,2,400,206,150,42,3,14164,0
35,"Suceava",149655,332,149655,,"OSTRA",478,"PUNCT ACCES PUBLIC LA INFORMATIE ( PAPI)  OSTRA",0,47,0,47,0,47,0,200,153,20,27,3,14164,1
35,"Suceava",149682,332,149682,,"PANACI",479,"CAMINUL CULTURAL, SAT PANACI",647,395,392,3,0,392,3,800,405,189,203,3,14170,0
35,"Suceava",149682,332,149682,,"PANACI",480,"SCOALA CU CLASELE I-IV, SAT COVERCA",656,359,351,8,0,357,2,800,441,220,137,3,14170,0
35,"Suceava",149682,332,149682,,"PANACI",481,"SCOALA CU CLASELE I-IV, SAT PALTINIS",299,171,164,7,0,170,1,400,229,94,76,3,14170,0
35,"Suceava",149682,332,149682,,"PANACI",482,"CAMINUL CULTURAL, SAT GLODU",260,142,135,7,0,142,0,400,258,78,64,3,14170,0
35,"Suceava",149682,332,149682,,"PANACI",483,"SCOALA CU CLASELE I-VIII,  SAT PANACI, STR. PRINCIPALA, NR. 260",0,53,0,53,0,53,0,200,147,22,31,3,14170,1
35,"Suceava",149753,332,149753,,"PALTINOASA",484,"CAMINUL CULTURAL, SAT PALTINOASA",2058,1290,1265,25,0,1284,6,2300,1010,975,309,3,14167,0
35,"Suceava",149753,332,149753,,"PALTINOASA",485,"SCOALA GENERALA GARA ILISESTI, SAT PALTINOASA",385,236,223,10,3,233,3,500,264,124,109,3,14167,0
35,"Suceava",149753,332,149753,,"PALTINOASA",486,"CAMINUL CULTURAL, SAT CAPU CODRULUI",942,591,561,28,2,584,7,1100,509,233,351,3,14167,0
35,"Suceava",149753,332,149753,,"PALTINOASA",487,"SCOALA GENERALA SAT CAPU CODRULUI",1150,646,633,13,0,634,12,1300,654,355,279,3,14167,0
35,"Suceava",149753,332,149753,,"PALTINOASA",488,"SCOALA DE ARTE SI MESERII SATUL PALTINOASA",0,76,0,76,0,76,0,302,226,42,34,3,14167,1
35,"Suceava",149833,332,149833,,"PATRAUTI",489,"CAMINUL CULTURAL, SAT PATRAUTI, SEDIUL VECHI AL PRIMARIEI",1773,850,842,8,0,845,5,2000,1150,430,415,3,14182,0
35,"Suceava",149833,332,149833,,"PATRAUTI",490,"SCOALA CU CLASELE I-IV  MOLDOVENI , SAT PATRAUTI",1404,793,786,7,0,772,21,1600,807,266,506,3,14182,0
35,"Suceava",149833,332,149833,,"PATRAUTI",491,"SEDIUL NOU AL PRIMARIEI COMUNEI PATRAUTI",0,48,0,48,0,48,0,200,152,26,22,3,14182,1
35,"Suceava",149780,332,149780,,"PARTESTII DE JOS",492,"CAMINUL CULTURAL, SAT PARTESTII DE JOS",1590,828,815,3,10,818,10,1800,972,480,338,3,14177,0
35,"Suceava",149780,332,149780,,"PARTESTII DE JOS",493,"CAMINUL CULTURAL, SAT DELENI",575,350,339,9,2,344,6,700,350,210,134,3,14177,0
35,"Suceava",149780,332,149780,,"PARTESTII DE JOS",494,"SCOALA CU CLASELE I-IV, SAT VARFU DEALULUI",111,75,67,8,0,75,0,196,121,48,27,3,14177,0
35,"Suceava",149780,332,149780,,"PARTESTII DE JOS",495,"PRIMARIA COMUNEI PARTESTII DE JOS",0,107,0,107,0,105,2,200,93,61,44,3,14177,1
35,"Suceava",149851,332,149851,,"POIANA STAMPEI",496,"CAMINUL CULTURAL, SAT POIANA STAMPEI",1538,1001,996,2,3,998,3,1700,699,606,392,3,14184,0
35,"Suceava",149851,332,149851,,"POIANA STAMPEI",497,"COMPLEX SOCIAL  DORNISOARA , SAT DORNISOARA",269,178,167,11,0,178,0,296,118,64,114,3,14184,0
35,"Suceava",149851,332,149851,,"POIANA STAMPEI",498,"SEDIUL PRIMARIEI POIANA STAMPEI",0,118,0,118,0,116,2,200,82,44,72,3,14184,1
35,"Suceava",151585,332,151585,,"POIENI-SOLCA",499,"SCOALA CU CLASELE I-VIII, SAT POIENI SOLCA",1653,799,796,3,0,792,7,1900,1101,240,552,3,14192,0
35,"Suceava",151585,332,151585,,"POIENI-SOLCA",500,"SCOLA CU CLASELE I-VIII POIENI-SOLCA SALA II",0,56,0,56,0,55,1,200,144,24,31,3,14192,1
35,"Suceava",149931,332,149931,,"POJORATA",501,"SCOALA CU CLASELE I-IV, SAT POJORATA",820,563,541,19,3,558,5,1000,437,351,207,3,14194,0
35,"Suceava",149931,332,149931,,"POJORATA",502,"CAMINUL CULTURAL, SAT POJORATA",1358,922,893,21,8,913,9,1500,578,584,329,3,14194,0
35,"Suceava",149931,332,149931,,"POJORATA",503,"CAMINUL CULTURAL, SAT VALEA PUTNEI, SALA NR.1",264,170,162,8,0,169,1,400,230,133,36,3,14194,0
35,"Suceava",149931,332,149931,,"POJORATA",504,"GARA POJORATA",0,138,0,138,0,136,2,200,62,77,59,3,14194,1
35,"Suceava",149968,332,149968,,"PREUTESTI",505,"SCOALA CU CLASELE I-VIII, SAT ARGHIRA",905,551,537,14,0,547,4,1000,449,279,268,3,14197,0
35,"Suceava",149968,332,149968,,"PREUTESTI",506,"SCOALA CU CLASELE I-VIII, SAT BASARABI",1380,773,760,13,0,770,3,1600,827,390,380,3,14197,0
35,"Suceava",149968,332,149968,,"PREUTESTI",507,"SCOALA CU CLASELE I-IV, SAT BAHNA ARINI",137,99,89,10,0,98,1,200,101,62,36,3,14197,0
35,"Suceava",149968,332,149968,,"PREUTESTI",508,"CAMINUL CULTURAL, SAT PREUTESTI",1559,888,873,15,0,881,7,1800,912,349,532,3,14197,0
35,"Suceava",149968,332,149968,,"PREUTESTI",509,"SCOALA CU CLASELE I-IV, SAT HUSI",545,355,345,10,0,340,15,600,245,203,137,3,14197,0
35,"Suceava",149968,332,149968,,"PREUTESTI",510,"SCOALA CU CLASELE I-VIII, SAT LEUCUSESTI",795,461,451,10,0,454,7,900,439,296,158,3,14197,0
35,"Suceava",149968,332,149968,,"PREUTESTI",511,"SEDIUL PRIMARIEI PREUTESTI",0,102,0,102,0,102,0,195,93,52,50,3,14197,1
35,"Suceava",150043,332,150043,,"PUTNA",512,"PRIMARIA COMUNEI PUTNA, SAT PUTNA, SALA CASATORIILOR",1165,651,650,0,1,643,8,1300,649,309,334,3,14204,0
35,"Suceava",150043,332,150043,,"PUTNA",513,"PRIMARIA COMUNEI PUTNA, SAT PUTNA,  SALA PARTER",884,513,508,2,3,508,5,990,477,286,222,3,14204,0
35,"Suceava",150043,332,150043,,"PUTNA",514,"CAMINUL CULTURAL,  SAT GURA PUTNEI",1020,585,581,4,0,579,6,1196,611,343,236,3,14204,0
35,"Suceava",150043,332,150043,,"PUTNA",515,"SCOALA CU CLASELE I-VIII  STEFAN CEL MARE  PUTNA",0,85,0,85,0,85,0,300,215,41,44,3,14204,1
35,"Suceava",150070,332,150070,,"RADASENI",516,"SCOALA CU CLASELE I-VIII, SAT RADASENI, SALA NR.1",1144,534,520,14,0,529,5,1300,766,274,255,3,14207,0
35,"Suceava",150070,332,150070,,"RADASENI",517,"SCOALA CU CLASELE I-VIII, SAT RADASENI, SALA NR. 2",1112,490,483,7,0,484,6,1300,810,254,230,3,14207,0
35,"Suceava",150070,332,150070,,"RADASENI",518,"SCOALA CU CLASELE I-VIII, SAT LAMASENI,  SALA NR.1",1086,544,532,12,0,533,11,1200,656,247,286,3,14207,0
35,"Suceava",150070,332,150070,,"RADASENI",519,"SCOALA CU CLASELE I-IV , SAT POCOLENI, SALA NR.1",178,101,93,8,0,99,2,300,199,36,63,3,14207,0
35,"Suceava",150070,332,150070,,"RADASENI",520,"CAMINUL CULTURAL RADASENI",0,60,0,60,0,60,0,200,140,33,27,3,14207,1
35,"Suceava",150114,332,150114,,"RASCA",521,"CAMINUL CULTURAL, SAT RASCA",2194,1129,1121,8,0,1120,9,2500,1371,461,659,3,14211,0
35,"Suceava",150114,332,150114,,"RASCA",522,"SCOALA CU CLASELE I-IV, SAT JAHALIA",221,117,109,8,0,116,1,300,183,45,71,3,14211,0
35,"Suceava",150114,332,150114,,"RASCA",523,"SCOALA CU CLASELE I-IV, SAT BUDA II",568,290,282,8,0,287,3,698,408,154,133,3,14211,0
35,"Suceava",150114,332,150114,,"RASCA",524,"SCOALA CU CLASELE I-IV, SAT DUMBRAVENI",300,200,178,22,0,196,4,400,200,80,116,3,14211,0
35,"Suceava",150114,332,150114,,"RASCA",525,"SCOALA CU CLASELE I-IV, SAT SLATIOARA",569,298,285,13,0,293,5,700,402,133,160,3,14211,0
35,"Suceava",150114,332,150114,,"RASCA",526,"SEDIUL PRIMARIEI RASCA  SALA DE SEDINTE A CONSILIULUI LOCAL RASCA",0,101,0,101,0,95,6,200,99,46,49,3,14211,1
35,"Suceava",150178,332,150178,,"SADOVA",527,"CAMINUL CULTURAL, SAT SADOVA",1079,661,652,8,1,655,6,1200,539,451,204,3,14217,0
35,"Suceava",150178,332,150178,,"SADOVA",528,"SCOALA GENERALA NR. 2 FUNDU SADOVEI, SAT SADOVA",870,561,550,11,0,559,2,1000,439,351,208,3,14217,0
35,"Suceava",150178,332,150178,,"SADOVA",529,"ANEXA CAMINUL CULTURAL SADOVA",0,35,0,35,0,33,2,200,165,18,15,3,14217,1
35,"Suceava",150196,332,150196,,"SATU MARE",530,"CAMINUL  CULTURAL, SAT SATU MARE, NR.344",1047,527,520,6,1,518,9,1200,673,293,225,3,14227,0
35,"Suceava",150196,332,150196,,"SATU MARE",531,"SCOALA CU CLASELE I-VIII, SAT SATU MARE",1200,647,642,5,0,637,10,1400,753,327,310,3,14227,0
35,"Suceava",150196,332,150196,,"SATU MARE",532,"SCOALA CU CLASELE I-VIII, SAT TIBENI",1014,465,462,3,0,463,2,1199,734,243,220,3,14227,0
35,"Suceava",150196,332,150196,,"SATU MARE",533,"PRIMARIA COMUNEI SATU MARE, LA PARTER",0,54,0,54,0,53,1,200,146,30,23,3,14227,1
35,"Suceava",150221,332,150221,,"SIMINICEA",534,"CAMINUL CULTURAL, SAT SIMINICEA",1273,666,665,1,0,657,9,1500,834,272,385,3,14239,0
35,"Suceava",150221,332,150221,,"SIMINICEA",535,"SCOALA GENERALA, SAT SIMINICEA, LOCALUL SCOLII VECHI",860,453,452,1,0,446,7,1000,547,165,281,3,14239,0
35,"Suceava",150221,332,150221,,"SIMINICEA",536,"SCOALA GENERALA, SAT GRIGORESTI",239,152,150,2,0,151,1,300,148,69,82,3,14239,0
35,"Suceava",150221,332,150221,,"SIMINICEA",537,"SEDIUL PRIMARIEI COMUNEI SIMINICEA",0,79,0,79,0,79,0,200,121,42,37,3,14239,1
35,"Suceava",150258,332,150258,,"SLATINA",538,"PRIMARIA COMUNEI SLATINA, SAT SLATINA",1481,743,732,11,0,729,14,1700,957,435,294,3,14242,0
35,"Suceava",150258,332,150258,,"SLATINA",539,"CASA DE CULTURA  HERLA, SAT HERLA",1012,608,596,12,0,600,8,1200,592,304,296,3,14242,0
35,"Suceava",150258,332,150258,,"SLATINA",540,"SCOALA GAINESTI, SAT GAINESTI",1579,985,969,16,0,976,9,1800,815,360,616,3,14242,0
35,"Suceava",150258,332,150258,,"SLATINA",541,"SCOALA DE ARTE SI MESERII SLATINA",0,91,0,91,0,90,1,200,109,41,49,3,14242,1
35,"Suceava",150294,332,150294,,"STRAJA",542,"GRADINITA DE COPII NR.1, SAT STRAJA",1224,607,595,12,0,599,8,1400,793,429,170,3,14246,0
35,"Suceava",150294,332,150294,,"STRAJA",543,"SCOALA DE ARTE SI MESERII STRAJA, SAT STRAJA, CORPUL NOU",1079,530,511,19,0,526,4,1200,670,409,117,3,14246,0
35,"Suceava",150294,332,150294,,"STRAJA",544,"PRIMARIA COMUNEI STRAJA , SAT STRAJA",1138,580,566,14,0,574,6,1300,720,403,171,3,14246,0
35,"Suceava",150294,332,150294,,"STRAJA",545,"GRADINITA DE COPII NR.2, SAT  STRAJA",896,437,425,12,0,430,7,1000,563,346,84,3,14246,0
35,"Suceava",150294,332,150294,,"STRAJA",546,"SEDIUL VECHI AL PRIMARIEI STRAJA,  STRAJA, NR. 1357",0,37,0,37,0,37,0,200,163,25,12,3,14246,1
35,"Suceava",150310,332,150310,,"STROIESTI",547,"CAMINUL CULTURAL, SAT STROIESTI",1067,611,607,4,0,604,7,1200,589,295,309,3,14248,0
35,"Suceava",150310,332,150310,,"STROIESTI",548,"CAMINUL CULTURAL, SAT STROIESTI",952,517,513,4,0,513,4,1100,583,290,223,3,14248,0
35,"Suceava",150310,332,150310,,"STROIESTI",549,"CAMINUL CULTURAL, SAT  ZAHARESTI",631,420,414,6,0,412,8,700,280,176,236,3,14248,0
35,"Suceava",150310,332,150310,,"STROIESTI",550,"SCOALA GENERALA CU CLASELE I-VIII , SATUL STROIESTI",0,58,0,58,0,58,0,200,142,25,33,3,14248,1
35,"Suceava",150356,332,150356,,"STULPICANI",551,"CAMINUL CULTURAL, SAT STULPICANI",1216,647,631,16,0,640,7,1400,753,435,205,3,14252,0
35,"Suceava",150356,332,150356,,"STULPICANI",552,"GRADINITA , SAT STULPICANI",1109,592,578,14,0,589,3,1300,708,430,159,3,14252,0
35,"Suceava",150356,332,150356,,"STULPICANI",553,"CAMINUL CULTURAL, SAT NEGRILEASA",838,470,449,21,0,469,1,1000,530,325,144,3,14252,0
35,"Suceava",150356,332,150356,,"STULPICANI",554,"SCOALA VADU NEGRILESEI, SAT VADU NEGRILESEI",459,292,282,10,0,290,2,600,308,214,76,3,14252,0
35,"Suceava",150356,332,150356,,"STULPICANI",555," SCOALA GEMENEA,  SAT GEMENEA",694,444,430,14,0,440,4,800,356,348,92,3,14252,0
35,"Suceava",150356,332,150356,,"STULPICANI",556,"CAMINUL CULTURAL, SAT SLATIOARA",506,323,315,8,0,320,3,600,277,246,74,3,14252,0
35,"Suceava",150356,332,150356,,"STULPICANI",557,"SCOALA DE ARTE SI MESERII STULPICANI",0,39,0,39,0,39,0,201,162,27,12,3,14252,1
35,"Suceava",150418,332,150418,,"SUCEVITA",558,"SCOALA  DIMITRIE VATAMANIUC  , SAT SUCEVITA",1192,688,679,6,3,679,9,1400,712,347,332,3,14258,0
35,"Suceava",150418,332,150418,,"SUCEVITA",559,"SCOALA GENERALA, SAT VOIEVODEASA",921,492,476,7,9,484,8,1100,608,300,184,3,14258,0
35,"Suceava",150418,332,150418,,"SUCEVITA",560,"SCOALA CU CLASELE I-VIII DIMITRIE VATAMANIUC-SUCEVITA",0,88,0,88,0,87,1,500,412,27,60,3,14258,1
35,"Suceava",150445,332,150445,,"SARU DORNEI",561,"CAMINUL CULTURAL, SAT NEAGRA SARULUI",1610,954,932,5,17,941,13,1800,846,573,368,3,14219,0
35,"Suceava",150445,332,150445,,"SARU DORNEI",562,"SCOALA CU CLASELE I-VIII, SAT SARU DORNEI",929,518,515,3,0,508,10,1079,561,253,255,3,14219,0
35,"Suceava",150445,332,150445,,"SARU DORNEI",563,"SCOALA CU CLASELE I-IV, SAT GURA HAITII",474,314,301,5,8,310,4,600,286,193,117,3,14219,0
35,"Suceava",150445,332,150445,,"SARU DORNEI",564,"SCOALA CU CLASELE I-IV, SAT SARISORU MARE",439,296,286,10,0,289,7,509,213,166,123,3,14219,0
35,"Suceava",150445,332,150445,,"SARU DORNEI",565,"SCOALA CU CLASELE I-VIII NEAGRA SARULUI",0,103,0,103,0,102,1,200,97,76,26,3,14219,1
35,"Suceava",146432,332,146432,,"SCHEIA",566,"SEDIUL PRIMARIEI COMUNEI SCHEIA, SAT SCHEIA, SALA DE CONSILIU I",1325,749,735,14,0,739,10,1500,751,392,347,3,14230,0
35,"Suceava",146432,332,146432,,"SCHEIA",567,"SEDIUL PRIMARIEI COMUNEI SCHEIA, SAT SCHEIA. SALA DE CONSILIU II",965,522,517,5,0,504,18,1100,578,275,229,3,14230,0
35,"Suceava",146432,332,146432,,"SCHEIA",568,"SCOALA GENERALA, SAT SFANTU ILIE, SALA DE SPORT",1801,1009,1000,9,0,1002,7,2000,991,656,346,3,14230,0
35,"Suceava",146432,332,146432,,"SCHEIA",569,"SCOALA GENERALA, SAT SFANTU ILIE,  SALA CLASA I",1039,569,555,14,0,564,5,1200,631,328,236,3,14230,0
35,"Suceava",146432,332,146432,,"SCHEIA",570,"SCOALA GENERALA, SAT MIHOVENI, SALA DE SPORT",1788,1099,1090,9,0,1094,5,2000,901,757,337,3,14230,0
35,"Suceava",146432,332,146432,,"SCHEIA",571,"SCOALA GENERALA  DIMITRIE PACURARIU  SCHEIA",0,131,0,131,0,131,0,200,69,90,41,3,14230,1
35,"Suceava",151460,332,151460,,"SERBAUTI",572,"CAMIN CULTURAL, SAT SERBAUTI, STRADA PRINCIPALA",1516,739,733,6,0,729,10,1700,961,369,360,3,14236,0
35,"Suceava",151460,332,151460,,"SERBAUTI",573,"CAMIN CULTURAL, SAT CALINESTI, STRADA PRINCIPALA",937,443,443,0,0,438,5,1100,657,178,260,3,14236,0
35,"Suceava",151460,332,151460,,"SERBAUTI",574,"SCOALA CU CLASELE I-VIII SERBAUTI",0,76,0,76,0,75,1,200,124,48,27,3,14236,1
35,"Suceava",150524,332,150524,,"TODIRESTI",575,"SCOALA CU CLASELE I-VIII, SAT TODIRESTI",1215,738,733,5,0,734,4,1400,662,374,360,3,14261,0
35,"Suceava",150524,332,150524,,"TODIRESTI",576,"SCOALA CU CLASELE I-VIII  VASILE BUMBAC , SAT COSTANA",864,512,504,8,0,502,10,1000,488,305,197,3,14261,0
35,"Suceava",150524,332,150524,,"TODIRESTI",577,"SCOALA CU CLASELE I-VIII, SAT PARHAUTI",998,575,565,10,0,568,7,1100,525,341,227,3,14261,0
35,"Suceava",150524,332,150524,,"TODIRESTI",578,"SCOALA CU CLASELE I-VIII, SAT SOLONET",1299,654,650,4,0,651,3,1500,846,345,306,3,14261,0
35,"Suceava",150524,332,150524,,"TODIRESTI",579,"SCOALA CU CLASELE I-VIII TODIREST",0,159,0,159,0,153,6,200,41,99,54,3,14261,1
35,"Suceava",150588,332,150588,,"UDESTI",580,"PRIMARIA COMUNEI UDESTI, SAT UDESTI",1833,1097,1088,9,0,1094,3,2100,1003,456,638,3,14267,0
35,"Suceava",150588,332,150588,,"UDESTI",581,"SCOALA CU CLASELE I-VIII, SAT POIENI",366,223,214,9,0,221,2,500,277,148,73,3,14267,0
35,"Suceava",150588,332,150588,,"UDESTI",582,"CAMINUL CULTURAL, SAT CHILISENI",545,383,376,7,0,379,4,580,197,144,235,3,14267,0
35,"Suceava",150588,332,150588,,"UDESTI",583,"SCOALA CU CLASELE I-VIII, SAT STIRBAT",472,335,323,12,0,333,2,606,271,86,247,3,14267,0
35,"Suceava",150588,332,150588,,"UDESTI",584,"CAMINUL CULTURAL, SAT RACOVA",243,168,158,10,0,166,2,300,132,73,93,3,14267,0
35,"Suceava",150588,332,150588,,"UDESTI",585,"SCOALA CU CLASELE I-IV, SAT  RUSII-MANASTIOARA",395,241,233,8,0,240,1,505,264,116,124,3,14267,0
35,"Suceava",150588,332,150588,,"UDESTI",586,"SCOALA CU CLASELE I-IV , SAT LUNCUSOARA",464,270,260,10,0,266,4,600,330,137,129,3,14267,0
35,"Suceava",150588,332,150588,,"UDESTI",587,"SCOALA CU CLASELE I-VIII, SAT REUSENI",510,311,300,10,1,310,1,600,289,151,159,3,14267,0
35,"Suceava",150588,332,150588,,"UDESTI",588,"SCOALA CU CLASELE I-VIII, SAT PLAVALARI",837,445,438,7,0,437,8,995,550,183,254,3,14267,0
35,"Suceava",150588,332,150588,,"UDESTI",589,"CAMINUL CULTURAL DIN SATUL UDESTI",0,145,0,145,0,145,0,400,255,76,69,3,14267,1
35,"Suceava",150702,332,150702,,"ULMA",590,"SCOALA CU CLASELE I-VIII, SAT ULMA",592,249,242,7,0,242,7,700,451,173,69,3,14279,0
35,"Suceava",150702,332,150702,,"ULMA",591,"SCOALA CU CLASELE I-IV, SAT  NISIPITU",324,179,176,3,0,179,0,400,221,117,62,3,14279,0
35,"Suceava",150702,332,150702,,"ULMA",592,"SCOALA CU CLASELE I-VIII , SAT LUPCINA",746,393,386,7,0,388,5,900,507,301,87,3,14279,0
35,"Suceava",150702,332,150702,,"ULMA",593,"SEDIUL PRIMARIEI COMUNEI ULMA",0,39,0,39,0,39,0,200,161,26,13,3,14279,1
35,"Suceava",150766,332,150766,,"VADU MOLDOVEI",594,"SCOALA VADU MOLDOVEI , SAT VADU MOLDOVEI",883,450,426,24,0,444,6,989,539,163,281,3,14285,0
35,"Suceava",150766,332,150766,,"VADU MOLDOVEI",595,"SCOALA DUMBRAVITA, SAT DUMBRAVITA",1091,554,515,39,0,549,5,1300,746,196,353,3,14285,0
35,"Suceava",150766,332,150766,,"VADU MOLDOVEI",596,"SCOALA NIGOTESTI, SAT NIGOTESTI",407,256,244,12,0,252,4,519,263,125,127,3,14285,0
35,"Suceava",150766,332,150766,,"VADU MOLDOVEI",597,"SCOALA MOVILENI SAT MOVILENI",214,128,116,12,0,127,1,301,173,39,88,3,14285,0
35,"Suceava",150766,332,150766,,"VADU MOLDOVEI",598,"SCOALA MESTECENI, SAT MESTECENI",179,114,106,8,0,112,2,303,189,56,56,3,14285,0
35,"Suceava",150766,332,150766,,"VADU MOLDOVEI",599,"SCOALA IONEASA, SAT IONEASA",298,192,180,12,0,189,3,400,208,74,115,3,14285,0
35,"Suceava",150766,332,150766,,"VADU MOLDOVEI",600,"SCOALA CIUMULESTI, SAT CIUMULESTI",648,371,358,13,0,368,3,800,429,208,160,3,14285,0
35,"Suceava",150766,332,150766,,"VADU MOLDOVEI",601,"SEDIUL PRIMARIEI VADU MOLDOVEI",0,95,0,95,0,93,2,201,106,49,44,3,14285,1
35,"Suceava",150891,332,150891,,"VALEA MOLDOVEI",602,"CAMINUL CULTURAL, SAT VALEA MOLDOVEI",1298,820,810,10,0,815,5,1500,680,316,499,3,14294,0
35,"Suceava",150891,332,150891,,"VALEA MOLDOVEI",603,"SCOALA CU CLASALE I-IV, SAT MIRONU",1201,675,662,13,0,661,14,1400,725,446,215,3,14294,0
35,"Suceava",150891,332,150891,,"VALEA MOLDOVEI",604,"SEDIUL PRIMARIEI COMUNEI VALEA MOLDOVEI",0,66,0,66,0,66,0,200,134,32,34,3,14294,1
35,"Suceava",150935,332,150935,,"VAMA",605,"CAMINUL CULTURAL, SAT VAMA, STRADA VICTORIEI",1006,583,576,7,0,578,5,1200,617,416,162,3,14297,0
35,"Suceava",150935,332,150935,,"VAMA",606,"SCOALA DE ARTE SI MESERII  I.G. TOMA , SAT VAMA, STRADA VICTORIEI, LOCALUL NR. 2",1651,901,889,11,1,896,5,1900,999,672,224,3,14297,0
35,"Suceava",150935,332,150935,,"VAMA",607,"SCOALA DE ARTE SI MESERII  I.G. TOMA , SAT STRAMTURA, STRADA PETRU RARES",1005,637,617,19,1,631,6,1200,563,495,136,3,14297,0
35,"Suceava",150935,332,150935,,"VAMA",608,"SCOALA DE ARTE SI MESERII  I.G. TOMA , SAT MOLID, STRADA STEFAN CEL MARE",500,301,280,21,0,296,5,600,299,188,108,3,14297,0
35,"Suceava",150935,332,150935,,"VAMA",609,"SCOALA DE ARTE SI MESERII  I.G. TOMA , SAT PRISACA DORNEI, STRADA TEILOR",682,354,345,9,0,349,5,800,446,229,120,3,14297,0
35,"Suceava",150935,332,150935,,"VAMA",610,"SEDIUL PRIMARIEI VAMA",0,107,0,107,0,104,3,200,93,70,34,3,14297,1
35,"Suceava",150980,332,150980,,"VATRA MOLDOVITEI",611,"CAMINUL CULTURAL, SAT VATRA MOLDOVITEI",1245,806,747,54,5,803,3,1400,594,655,148,3,14302,0
35,"Suceava",150980,332,150980,,"VATRA MOLDOVITEI",612,"SCOALA CU CLASELE I-IV; SAT VATRA MOLDOVITEI",630,431,364,66,1,428,3,700,269,347,81,3,14302,0
35,"Suceava",150980,332,150980,,"VATRA MOLDOVITEI",613,"SCOALA CU CLASELE I-IV, SAT CIUMARNA",361,222,199,23,0,222,0,400,178,184,38,3,14302,0
35,"Suceava",150980,332,150980,,"VATRA MOLDOVITEI",614,"CAMINUL CULTURAL, SAT PALTINU",730,420,382,26,12,417,3,900,480,358,59,3,14302,0
35,"Suceava",150980,332,150980,,"VATRA MOLDOVITEI",615,"SCOALA CU CLASELE I - IV, SAT PALTINU, CENTRUL II",598,442,364,77,1,442,0,700,258,354,88,3,14302,0
35,"Suceava",150980,332,150980,,"VATRA MOLDOVITEI",616,"CAMIN CULTURAL VATRA MOLDOVITEI",0,67,0,67,0,67,0,500,433,46,21,3,14302,1
35,"Suceava",151022,332,151022,,"VERESTI",617,"CAMINUL CULTURAL, SAT VERESTI",1243,668,666,2,0,663,5,1400,732,277,386,3,14306,0
35,"Suceava",151022,332,151022,,"VERESTI",618,"SCOALA CU CLASELE I-VIII , SAT BURSUCENI",1149,513,504,9,0,505,8,1300,787,257,248,3,14306,0
35,"Suceava",151022,332,151022,,"VERESTI",619,"CAMINUL CULTURAL, SAT COROCAIESTI",2212,1013,1001,12,0,1001,12,2500,1487,514,487,3,14306,0
35,"Suceava",151022,332,151022,,"VERESTI",620,"BIBILOTECA LA VERESTI, SAT VERESTI, SALA DE SEDINTE A CONSILIULUI LOCAL VERESTI",777,445,439,6,0,431,14,900,455,178,253,3,14306,0
35,"Suceava",151022,332,151022,,"VERESTI",621,"GARA VERESTI",0,73,0,73,0,72,1,200,127,28,44,3,14306,1
35,"Suceava",151077,332,151077,,"VICOVU DE JOS",622,"SCOALA CU CLASELE I-VIII  IOAN VICOVEANU  , SAT VICOVU DE JOS",1232,625,616,9,0,622,3,1400,775,367,255,3,14311,0
35,"Suceava",151077,332,151077,,"VICOVU DE JOS",623,"SCOALA CU CLASELE I-VIII NR.2 REMEZAU , SAT VICOVU DE JOS",1778,903,894,9,0,895,8,2000,1097,585,310,3,14311,0
35,"Suceava",151077,332,151077,,"VICOVU DE JOS",624,"SCOALA CU CLASELE I-IV   MARGINE , SAT VICOVU DE JOS",782,409,398,11,0,405,4,900,491,221,184,3,14311,0
35,"Suceava",151077,332,151077,,"VICOVU DE JOS",625,"GRADINITA   POD DABOCA , SAT  VICOVU DE JOS",894,428,421,7,0,426,2,1000,572,279,147,3,14311,0
35,"Suceava",151077,332,151077,,"VICOVU DE JOS",626,"SALA DE SPORT A SCOLII CU CL. I-VIII NR. 1  IOAN VICOVEANU  VICOVU DE JOS",0,70,0,70,0,69,1,200,130,29,40,3,14311,1
35,"Suceava",151558,332,151558,,"VOITINEL",627,"GRADINITA CU PROGRAM NORMAL, SAT  VOITINEL",1346,714,683,31,0,702,12,1500,786,285,417,3,14313,0
35,"Suceava",151558,332,151558,,"VOITINEL",628,"CAMIN CULTURAL, SAT VOITINEL",1330,705,692,13,0,695,10,1500,795,265,430,3,14313,0
35,"Suceava",151558,332,151558,,"VOITINEL",629,"CENTRUL DE CONSILIERE DIN INCINTA SEDIULUI PRIMARIEI COMUNEI VOITINEL",0,146,0,146,0,143,3,200,54,73,70,3,14313,1
35,"Suceava",151120,332,151120,,"VOLOVAT",630,"CAMINUL CULTURAL, SAT VOLOVAT, (CLADIREA NOUA, SALA CLUB)",2021,1070,1067,2,1,1045,25,2300,1230,639,406,3,14315,0
35,"Suceava",151120,332,151120,,"VOLOVAT",631,"CAMINUL CULTURAL, SAT VOLOVAT,  (CLADIRE NOUA, HOL INTRARE)",1680,842,832,10,0,831,11,1900,1058,551,280,3,14315,0
35,"Suceava",151120,332,151120,,"VOLOVAT",632,"CAMIN CULTURALVOLOVAT (CLADIRE NOUA), SALA VESTIAR",0,43,0,43,0,42,1,200,157,27,15,3,14315,1
35,"Suceava",151157,332,151157,,"VULTURESTI",633,"FOSTUL SEDIU AL CONSILIULUI LOCAL (BIBLIOTECA PUBLICA), SAT PLESESTI, NR.27",546,276,272,4,0,269,7,700,424,139,130,3,14317,0
35,"Suceava",151157,332,151157,,"VULTURESTI",634,"SCOALA CU CLASELE I-VIII, SAT VALEA GLODULUI, NR. 152",759,399,398,1,0,395,4,900,501,113,282,3,14317,0
35,"Suceava",151157,332,151157,,"VULTURESTI",635,"SCOALA CU CLASELE I-VIII, SAT GIURGESTI, NR. 34",579,386,377,5,4,382,4,700,314,161,221,3,14317,0
35,"Suceava",151157,332,151157,,"VULTURESTI",636,"SCOALA CU CLASELE I-IV, SAT HREATCA, NR. 129",323,152,147,5,0,150,2,400,248,53,97,3,14317,0
35,"Suceava",151157,332,151157,,"VULTURESTI",637,"SCOALA CU CLASELE I-IV, SAT MERESTI, NR. 16",207,151,141,10,0,147,4,300,149,64,83,3,14317,0
35,"Suceava",151157,332,151157,,"VULTURESTI",638,"SCOALA CU CLASELE I-IV, SAT JACOTA, NR.12",139,89,83,6,0,88,1,200,111,26,62,3,14317,0
35,"Suceava",151157,332,151157,,"VULTURESTI",639,"SCOALA CU CLASELE I-IV, SAT OSOI, NR. 152",306,182,174,8,0,182,0,400,218,62,120,3,14317,0
35,"Suceava",151157,332,151157,,"VULTURESTI",640,"SEDIUL PRIMARIEI VULTURESTI",0,76,0,76,0,76,0,200,124,34,42,3,14317,1
35,"Suceava",151246,332,151246,,"ZAMOSTEA",641,"CAMINUL CULTURAL, SAT ZAMOSTEA",1408,769,764,5,0,766,3,1600,831,197,569,3,14326,0
35,"Suceava",151246,332,151246,,"ZAMOSTEA",642,"SCOALA CU CLASELE I-IV, SAT CIOMARTAN",442,259,249,10,0,255,4,500,241,52,203,3,14326,0
35,"Suceava",151246,332,151246,,"ZAMOSTEA",643,"SCOALA CU CLASELE I-IV, SAT LUNCA",220,129,121,8,0,129,0,300,171,31,98,3,14326,0
35,"Suceava",151246,332,151246,,"ZAMOSTEA",644,"SCOALA CU CLASELE I-IV, SAT  NICANI",416,227,222,5,0,226,1,501,274,65,161,3,14326,0
35,"Suceava",151246,332,151246,,"ZAMOSTEA",645,"CAMIN CULTURAL ZAMOSTEA  SALA MICA",0,64,0,64,0,63,1,196,132,22,41,3,14326,1
35,"Suceava",151344,332,151344,,"ZVORISTEA",646,"CAMINUL CULTURAL, SAT ZVORISTEA",736,408,404,4,0,401,7,914,506,166,235,3,14336,0
35,"Suceava",151344,332,151344,,"ZVORISTEA",647,"SCOALA CU CLASELE I-VIII, SAT BUDA, SALA A",632,335,331,4,0,330,5,700,365,88,242,3,14336,0
35,"Suceava",151344,332,151344,,"ZVORISTEA",648,"SCOALA CU CLASELE I-VIII, SAT BUDA, SALA B",851,446,441,5,0,442,4,981,535,155,287,3,14336,0
35,"Suceava",151344,332,151344,,"ZVORISTEA",649,"SCOALA CU CLASELE I-IV, SAT STANCA",465,292,285,7,0,288,4,600,308,106,182,3,14336,0
35,"Suceava",151344,332,151344,,"ZVORISTEA",650,"SCOALA CU CLASELE I-IV, SAT STANCUTA",111,70,61,9,0,69,1,200,130,36,33,3,14336,0
35,"Suceava",151344,332,151344,,"ZVORISTEA",651,"SCOALA CU CLASELE I-VIII, SAT POIANA",434,260,251,9,0,255,5,486,226,111,144,3,14336,0
35,"Suceava",151344,332,151344,,"ZVORISTEA",652,"SCOALA CU CLASELE I-VIII, SAT SERBANESTI",883,468,460,8,0,465,3,1000,532,174,291,3,14336,0
35,"Suceava",151344,332,151344,,"ZVORISTEA",653,"SCOALA CU CLASELE I-IV, SAT SLOBOZIA",512,275,268,7,0,273,2,569,294,137,136,3,14336,0
35,"Suceava",151344,332,151344,,"ZVORISTEA",654,"CAMIN CULTURAL, SAT ZVORISTEA,  ZVORISTEA, JUDETUL SUCEAVA, COD POSTAL: 727640",0,150,0,150,0,146,4,300,150,73,73,3,14336,1
36,"Teleorman",151790,341,151790,,"MUNICIPIUL ALEXANDRIA",1,"SCOALA AJUTATOARE DIN STRADA LIBERTATII NR 1",1354,713,666,47,0,704,9,1496,783,269,435,1,14346,0
36,"Teleorman",151790,341,151790,,"MUNICIPIUL ALEXANDRIA",2,"SCOALA GENERALA NR 7 DIN STRADA 1907 NR 57",1370,681,672,9,0,677,4,1500,819,271,406,1,14346,0
36,"Teleorman",151790,341,151790,,"MUNICIPIUL ALEXANDRIA",3,"GRADINITA DE COPII NR 6 DIN STRADA 1907 NR 55",1285,624,613,11,0,618,6,1415,791,263,355,1,14346,0
36,"Teleorman",151790,341,151790,,"MUNICIPIUL ALEXANDRIA",4,"SCOALA GENERALA NR 7 DIN STRADA 1907 NR 57",1590,860,844,16,0,851,9,1750,890,326,525,1,14346,0
36,"Teleorman",151790,341,151790,,"MUNICIPIUL ALEXANDRIA",5,"SCOALA GENERALA NR 7 DIN STRADA 1907 NR 57",1432,783,777,6,0,771,12,1570,787,316,455,1,14346,0
36,"Teleorman",151790,341,151790,,"MUNICIPIUL ALEXANDRIA",6,"GRUPUL SCOLAR AGRICOL DIN STRADA LIBERTATII NR 69",1605,962,949,13,0,938,24,1748,786,391,547,1,14346,0
36,"Teleorman",151790,341,151790,,"MUNICIPIUL ALEXANDRIA",7,"LICEUL ALEXANDRU DIMITRIE GHICA DIN STRADA VIITORULUI NR 78",1618,919,907,12,0,903,16,1780,861,366,537,1,14346,0
36,"Teleorman",151790,341,151790,,"MUNICIPIUL ALEXANDRIA",8,"LICEUL ALEXANDRU D. GHICA DIN STRADA VIITORULUI NR 78",1420,775,765,10,0,770,5,1560,785,294,476,1,14346,0
36,"Teleorman",151790,341,151790,,"MUNICIPIUL ALEXANDRIA",9,"GRUPUL SCOLAR AGRICOL DIN STRADA LIBERTATII NR 69",1310,694,685,9,0,682,12,1440,746,238,444,1,14346,0
36,"Teleorman",151790,341,151790,,"MUNICIPIUL ALEXANDRIA",10,"GRADINITA DE COPII NR 10 DIN STRADA DUNARII NR 131",1542,863,846,17,0,855,8,1695,832,308,547,1,14346,0
36,"Teleorman",151790,341,151790,,"MUNICIPIUL ALEXANDRIA",11,"LICEUL C NOICA DIN STRADA DUNARII NR 133",1142,645,628,17,0,633,12,1255,610,215,418,1,14346,0
36,"Teleorman",151790,341,151790,,"MUNICIPIUL ALEXANDRIA",12,"LICEUL MIRCEA SCARLAT DIN STRADA NEGRU VODA NR 99",1344,763,754,9,0,751,12,1475,712,265,486,1,14346,0
36,"Teleorman",151790,341,151790,,"MUNICIPIUL ALEXANDRIA",13,"SCOALA GENERALA NR 5 DIN STRADA LIBERTATII NR 148",1119,692,659,9,24,673,19,1230,538,242,431,1,14346,0
36,"Teleorman",151790,341,151790,,"MUNICIPIUL ALEXANDRIA",14,"GRADINITA DE COPII NR 7 DIN STRADA ALEXANDRU COLFESCU NR 70",1264,737,716,16,5,724,13,1390,653,275,449,1,14346,0
36,"Teleorman",151790,341,151790,,"MUNICIPIUL ALEXANDRIA",15,"GRADINITA DE COPII NR 7 DIN STRADA ALEXANDRU COLFESCU NR 70",1196,701,692,9,0,693,8,1315,614,297,396,1,14346,0
36,"Teleorman",151790,341,151790,,"MUNICIPIUL ALEXANDRIA",16,"SALA POLIVALENTA DIN STRADA ALEXANDRU GHICA NR 86-88",1545,840,827,13,0,828,12,1700,860,300,528,1,14346,0
36,"Teleorman",151790,341,151790,,"MUNICIPIUL ALEXANDRIA",17,"OFICIUL POSTAL NR 3 DIN STRADA BUCURESTI NR 123",1217,710,699,11,0,703,7,1340,630,280,423,1,14346,0
36,"Teleorman",151790,341,151790,,"MUNICIPIUL ALEXANDRIA",18,"SCOALA GENERALA NR 3 DIN STRADA CARPATI NR 15",954,526,516,10,0,521,5,1048,522,202,319,1,14346,0
36,"Teleorman",151790,341,151790,,"MUNICIPIUL ALEXANDRIA",19,"SCOALA GENERALA NR 3 DIN STRADA CARPATI NR 15",1157,653,641,12,0,644,9,1261,608,266,378,1,14346,0
36,"Teleorman",151790,341,151790,,"MUNICIPIUL ALEXANDRIA",20,"SCOALA GENERALA MIHAI VITEAZUL  DIN STRADA ALEX COLFESCU NR 34",1588,871,857,13,1,865,6,1754,883,324,541,1,14346,0
36,"Teleorman",151790,341,151790,,"MUNICIPIUL ALEXANDRIA",21,"SCOALA GENERALA MIHAI VITEAZUL  DIN STRADA ALEX COLFESCU NR 34",1211,688,675,13,0,676,12,1322,634,269,407,1,14346,0
36,"Teleorman",151790,341,151790,,"MUNICIPIUL ALEXANDRIA",22,"SCOALA GENERALA NR 6 DIN STRADA 1 MAI NR 107",1020,487,475,12,0,486,1,1220,733,196,290,1,14346,0
36,"Teleorman",151790,341,151790,,"MUNICIPIUL ALEXANDRIA",23,"SCOALA GENERALA NR 6 DIN STRADA 1 MAI NR 107",1250,656,635,21,0,644,12,1375,719,241,403,1,14346,0
36,"Teleorman",151790,341,151790,,"MUNICIPIUL ALEXANDRIA",24,"LICEUL ALEXANDRU IOAN CUZA DIN STRADA CARPATI NR 27",1161,614,596,18,0,608,6,1282,668,234,374,1,14346,0
36,"Teleorman",151790,341,151790,,"MUNICIPIUL ALEXANDRIA",25,"LICEUL ALEXANDRU IOAN CUZA DIN STRADA CARPATI NR 27",1210,612,599,13,0,608,4,1330,718,257,351,1,14346,0
36,"Teleorman",151790,341,151790,,"MUNICIPIUL ALEXANDRIA",26,"LICEUL ALEXANDRU IOAN CUZA DIN STRADA CARPATI NR 27",1140,639,627,12,0,631,8,1255,616,250,381,1,14346,0
36,"Teleorman",151790,341,151790,,"MUNICIPIUL ALEXANDRIA",27,"SCOALA GENERALA NR 4 DIN STRADA DUNARII NR 292",1520,763,752,11,0,744,19,1670,907,295,449,1,14346,0
36,"Teleorman",151790,341,151790,,"MUNICIPIUL ALEXANDRIA",28,"SCOALA GENERALA NR 4 DIN STRADA DUNARII NR 292",1533,749,741,8,0,741,8,1685,936,279,462,1,14346,0
36,"Teleorman",151790,341,151790,,"MUNICIPIUL ALEXANDRIA",29,"GRADINITA DE COPII NR 1 DIN STRADA DUNARII NR 228",1593,834,813,21,0,822,12,1747,913,373,449,1,14346,0
36,"Teleorman",151790,341,151790,,"MUNICIPIUL ALEXANDRIA",30,"SCOALA GENERALA NR 4 DIN STRADA DUNARII NR 292",1616,838,825,13,0,828,10,1785,947,319,509,1,14346,0
36,"Teleorman",151790,341,151790,,"MUNICIPIUL ALEXANDRIA",31,"GRADINITA DE COPII NR 4 DIN STRADA ALEXANDRU GHICA NR 148",1517,657,638,17,2,649,8,1671,1014,262,387,1,14346,0
36,"Teleorman",151790,341,151790,,"MUNICIPIUL ALEXANDRIA",32,"GRADINITA DE COPII NR 4 DIN STRADA ALEXANDRU GHICA NR 148",1535,691,668,23,0,680,11,1690,999,285,395,1,14346,0
36,"Teleorman",151790,341,151790,,"MUNICIPIUL ALEXANDRIA",33,"SCOALA DE SOFERI AMATORI DIN STRADA DUNARII NR 265-271",1579,773,763,10,0,743,30,1735,962,251,492,1,14346,0
36,"Teleorman",151790,341,151790,,"MUNICIPIUL ALEXANDRIA",34,"GRADINITA DE COPII NR 8 DIN STRADA DUNARII NR 364",1316,377,335,42,0,355,22,1450,1073,125,230,1,14346,0
36,"Teleorman",151790,341,151790,,"MUNICIPIUL ALEXANDRIA",35,"LICEUL ""CONSTANTIN NOICA"", SALA NR. 2, STR DUNARII NR 133",0,484,0,484,0,481,3,800,316,203,278,1,14346,1
36,"Teleorman",151790,341,151790,,"MUNICIPIUL ALEXANDRIA",36,"SPITALUL JUDETEAN TELEORMAN STR LIBERTATII NR 1",0,255,0,255,0,252,3,863,608,130,122,1,14346,1
36,"Teleorman",151870,341,151870,,"MUNICIPIUL ROSIORI DE VEDE",37,"SCOALA  ""ZAHARIA STANCU"" DIN STRADA CARPATI NR 77",1382,705,690,14,1,698,7,1515,810,317,381,1,14348,0
36,"Teleorman",151870,341,151870,,"MUNICIPIUL ROSIORI DE VEDE",38,"SCOALA  NR 4 DIN STRADA CARPATI NR 40",1318,675,661,14,0,662,13,1448,773,307,355,1,14348,0
36,"Teleorman",151870,341,151870,,"MUNICIPIUL ROSIORI DE VEDE",39,"COLEGIUL TEHNIC ""ANGHEL SALIGNY"" DIN STRADA RENASTERII NR 15",1328,697,682,14,1,694,3,1453,756,291,403,1,14348,0
36,"Teleorman",151870,341,151870,,"MUNICIPIUL ROSIORI DE VEDE",40,"GRADINITA NR 1 DIN STRADA MIHAI EMINESCU NR 19",1272,697,684,11,2,687,10,1410,713,314,373,1,14348,0
36,"Teleorman",151870,341,151870,,"MUNICIPIUL ROSIORI DE VEDE",41,"CENTRUL CULTURAL  DIN STRADA MARASESTI NR 38",1220,669,654,12,3,668,1,1340,671,302,366,1,14348,0
36,"Teleorman",151870,341,151870,,"MUNICIPIUL ROSIORI DE VEDE",42,"GRADINITA NR 7 DIN STRADA  PLT RADULESCU NR 9",1203,645,632,11,2,640,5,1331,686,252,388,1,14348,0
36,"Teleorman",151870,341,151870,,"MUNICIPIUL ROSIORI DE VEDE",43,"MUZEUL DE ISTORIE DIN STRADA  DUNARII NR 54",1217,647,629,18,0,640,7,1340,693,271,369,1,14348,0
36,"Teleorman",151870,341,151870,,"MUNICIPIUL ROSIORI DE VEDE",44,"CLUBUL ELEVILOR DIN STRADA  SF TEODOR NR 16",1597,841,830,11,0,832,9,1750,909,374,458,1,14348,0
36,"Teleorman",151870,341,151870,,"MUNICIPIUL ROSIORI DE VEDE",45,"SCOALA ""GALA GALACTION"" DIN STRADA  SF VINERI NR 10",1497,678,660,18,0,667,11,1650,972,321,346,1,14348,0
36,"Teleorman",151870,341,151870,,"MUNICIPIUL ROSIORI DE VEDE",46,"SCOALA  ""ALEXANDRU DEPARATEANU"" DIN STRADA  DUNARII NR 126",1488,755,745,10,0,739,16,1640,885,325,414,1,14348,0
36,"Teleorman",151870,341,151870,,"MUNICIPIUL ROSIORI DE VEDE",47,"OFICIUL DE GOSPODARIRE A APELOR DIN STRADA  ALEXANDRU DOBRESCU NR 3",1494,705,695,8,2,674,31,1641,936,300,374,1,14348,0
36,"Teleorman",151870,341,151870,,"MUNICIPIUL ROSIORI DE VEDE",48,"SCOALA  NR 5 DIN STRADA  STEGARULUI NR 2",1634,887,878,9,0,880,7,1810,923,421,459,1,14348,0
36,"Teleorman",151870,341,151870,,"MUNICIPIUL ROSIORI DE VEDE",49,"SCOALA  NR 5 DIN STRADA  STEGARULUI NR 2",1244,711,699,10,2,705,6,1365,654,327,378,1,14348,0
36,"Teleorman",151870,341,151870,,"MUNICIPIUL ROSIORI DE VEDE",50,"SCOALA ""ALEXANDRU DEPARATEANU"" DIN STRADA  DUNARII NR 126",1256,761,744,17,0,741,20,1390,629,383,358,1,14348,0
36,"Teleorman",151870,341,151870,,"MUNICIPIUL ROSIORI DE VEDE",51,"LICEUL AGRICOL DIN STRADA  I.L. CARAGIALE NR 7",1484,768,756,12,0,759,9,1633,865,340,419,1,14348,0
36,"Teleorman",151870,341,151870,,"MUNICIPIUL ROSIORI DE VEDE",52,"CASA DE CULTURA DIN STRADA  DUNARII  NR 54-56",1125,544,530,14,0,535,9,1233,689,244,291,1,14348,0
36,"Teleorman",151870,341,151870,,"MUNICIPIUL ROSIORI DE VEDE",53,"COLEGIUL NATIONAL  ""ANASTASESCU"" DIN STRADA  REPUBLICII NR 9",1490,817,807,10,0,804,13,1637,820,343,461,1,14348,0
36,"Teleorman",151870,341,151870,,"MUNICIPIUL ROSIORI DE VEDE",54,"GRADINITA  NR 3 DIN ZONA IZBICEANU  NR 28",1637,823,810,13,0,808,15,1800,977,377,431,1,14348,0
36,"Teleorman",151870,341,151870,,"MUNICIPIUL ROSIORI DE VEDE",55,"LICEUL ECONOMIC DIN STRADA  REPUBLICII NR 11",1426,724,710,14,0,716,8,1653,929,331,385,1,14348,0
36,"Teleorman",151870,341,151870,,"MUNICIPIUL ROSIORI DE VEDE",56,"SCOALA  ""ZAHARIA STANCU"" DIN STRADA  CARPATI NR 77",1111,573,553,19,1,568,5,1135,562,224,344,1,14348,0
36,"Teleorman",151870,341,151870,,"MUNICIPIUL ROSIORI DE VEDE",57,"GRADINITA  NR 6 DIN STRADA  CARPATI NR 75",1293,595,588,7,0,589,6,1425,830,239,350,1,14348,0
36,"Teleorman",151870,341,151870,,"MUNICIPIUL ROSIORI DE VEDE",58,"SPITALUL CARITAS, STR CARPATI NR 33",0,499,0,499,0,487,12,800,301,252,235,1,14348,1
36,"Teleorman",151683,341,151683,,"MUNICIPIUL TURNU MAGURELE",59,"SCOALA VECHE DIN CARTIERUL ODAIA STR OLTULUI NR 140",1577,877,868,9,0,862,15,1740,863,333,529,1,14350,0
36,"Teleorman",151683,341,151683,,"MUNICIPIUL TURNU MAGURELE",60,"SCOALA NOUA  DIN CARTIERUL ODAIA STR GHICA VODA  NR 104",1206,607,596,11,0,596,11,1326,719,202,394,1,14350,0
36,"Teleorman",151683,341,151683,,"MUNICIPIUL TURNU MAGURELE",61,"SCOALA GENERALA NR 4 STR CHIMIEI NR 18",1917,903,837,65,1,899,4,2110,1207,350,549,1,14350,0
36,"Teleorman",151683,341,151683,,"MUNICIPIUL TURNU MAGURELE",62,"GRADINITA  ""SC TURNU SA"" DIN STRADA  TABEREI NR 1",2052,903,886,15,2,890,13,2260,1357,333,557,1,14350,0
36,"Teleorman",151683,341,151683,,"MUNICIPIUL TURNU MAGURELE",63,"COLEGIUL TEHNIC ""GENERAL DAVID PRAPORGESCU"" DIN STRADA TABEREI NR 2",1910,935,923,10,2,928,7,2100,1165,337,591,1,14350,0
36,"Teleorman",151683,341,151683,,"MUNICIPIUL TURNU MAGURELE",64,"GRADINITA  NR 4 DIN STRADA TRAIAN NR 3",1684,711,696,12,3,701,10,1855,1144,249,452,1,14350,0
36,"Teleorman",151683,341,151683,,"MUNICIPIUL TURNU MAGURELE",65,"POLICLINICA  MUNICIPIULUI TURNU MAGURELE DIN STRADA  GENERAL DAVID PRAPORGESCU NR 64",1749,770,754,11,5,752,18,1930,1160,261,491,1,14350,0
36,"Teleorman",151683,341,151683,,"MUNICIPIUL TURNU MAGURELE",66,"COLEGIUL NATIONAL ""UNIREA"" DIN STRADA  CASTANILOR NR 25",1285,705,684,20,1,693,12,1415,710,229,464,1,14350,0
36,"Teleorman",151683,341,151683,,"MUNICIPIUL TURNU MAGURELE",67,"COLEGIUL NATIONAL ""UNIREA"" DIN STRADA  CASTANILOR NR 25",1404,763,747,12,4,754,9,1544,781,293,461,1,14350,0
36,"Teleorman",151683,341,151683,,"MUNICIPIUL TURNU MAGURELE",68,"SCOALA GENERALA NR 1 DIN STRADA  AVINTULUI NR 1",1275,642,621,16,5,632,10,1545,903,274,358,1,14350,0
36,"Teleorman",151683,341,151683,,"MUNICIPIUL TURNU MAGURELE",69,"SCOALA GENERALA NR 1 DIN STRADA  AVINTULUI NR 1",1856,984,969,10,5,978,6,2047,1063,378,600,1,14350,0
36,"Teleorman",151683,341,151683,,"MUNICIPIUL TURNU MAGURELE",70,"GRUPUL SCOLAR AGRICOL ""SFINTUL HARALAMBIE"" DIN STRADA OITUZ  NR 11",1098,609,600,8,1,600,9,1210,601,221,379,1,14350,0
36,"Teleorman",151683,341,151683,,"MUNICIPIUL TURNU MAGURELE",71,"GRUPUL SCOLAR AGRICOL ""SFINTUL HARALAMBIE"" DIN STRADA OITUZ  NR 11",960,505,493,10,2,498,7,1055,550,227,271,1,14350,0
36,"Teleorman",151683,341,151683,,"MUNICIPIUL TURNU MAGURELE",72,"LICEUL ""MARIN PREDA"" DIN STRADA  CETATEA TURNU NR 9",1360,736,721,11,4,731,5,1503,767,295,436,1,14350,0
36,"Teleorman",151683,341,151683,,"MUNICIPIUL TURNU MAGURELE",73,"GRADINITA NR 5 DIN STRADA  CETATEA TURNU NR 3",1288,658,650,6,2,654,4,1420,762,282,372,1,14350,0
36,"Teleorman",151683,341,151683,,"MUNICIPIUL TURNU MAGURELE",74,"GRADINITA  NR 2 DIN STRADA  LIBERTATII NR 104",1447,664,650,13,1,647,17,1590,926,256,391,1,14350,0
36,"Teleorman",151683,341,151683,,"MUNICIPIUL TURNU MAGURELE",75,"SCOALA GENERALA NR 2 - LOCAL NOU DIN STRADA  ALXANDRU VLAHUTA NR 17",1531,772,756,12,4,752,20,1686,914,300,452,1,14350,0
36,"Teleorman",151683,341,151683,,"MUNICIPIUL TURNU MAGURELE",76,"SCOALA GENERALA NR 2 - LOCAL VECHI DIN STRADA  LIBERTATII NR 135",1544,875,850,13,12,867,8,1691,816,358,509,1,14350,0
36,"Teleorman",151683,341,151683,,"MUNICIPIUL TURNU MAGURELE",77,"LICEUL ""MARIN PREDA"", CABINET LIMBI MODERNE, SALA DE CLASA NR. 07, STR CETATEA TURNU NR 9",0,365,0,365,0,360,5,1000,635,176,184,1,14350,1
36,"Teleorman",151905,341,151905,,"ORAS VIDELE",78,"SCOALA GENERALA NR 3  VIDELE DIN STRADA  PARCULUI NR 21",1763,1197,1177,18,2,1187,10,1940,743,694,493,1,14352,0
36,"Teleorman",151905,341,151905,,"ORAS VIDELE",79,"CANTINA LICEULUI VIDELE DIN STRADA REPUBLICII NR 7",1618,1120,1093,21,6,1103,17,1780,660,578,525,1,14352,0
36,"Teleorman",151905,341,151905,,"ORAS VIDELE",80,"CASA DE CULTURA VIDELE DIN STRADA  FLORILOR NR 34",1574,1090,1071,14,5,1074,16,1730,640,670,404,1,14352,0
36,"Teleorman",151905,341,151905,,"ORAS VIDELE",81,"SCOALA GENERALA DE 4 ANI FOTACHESTI  DIN SOSEAUA PITESTI NR 165",962,704,678,15,11,696,8,1060,356,399,297,1,14352,0
36,"Teleorman",151905,341,151905,,"ORAS VIDELE",82,"SCOALA GENERALA DE 4 ANI FURCULESTI DIN STRADA  FRASINETULUI NR 9",1366,1083,1012,48,23,1057,26,1500,417,604,453,1,14352,0
36,"Teleorman",151905,341,151905,,"ORAS VIDELE",83,"SCOALA GENERALA DE 4 ANI CARTOJANCA DIN STRADA PROGRESULUI NR 62",712,587,557,26,4,573,14,780,193,360,213,1,14352,0
36,"Teleorman",151905,341,151905,,"ORAS VIDELE",84,"SCOALA GENERALA DE 10 ANI TAMASESTI DIN STRADA  PLANTELOR  NR 67",768,642,592,18,32,634,8,845,203,491,143,1,14352,0
36,"Teleorman",151905,341,151905,,"ORAS VIDELE",85,"SCOALA GENERALA DE 4 ANI PARISESTI DIN STRADA  PLANTELOR  NR 199",535,481,436,27,18,470,11,590,109,368,102,1,14352,0
36,"Teleorman",151905,341,151905,,"ORAS VIDELE",86,"SCOALA GENERALA DE 4 ANI COSOAIA-SAT APARTINATOR ORASULUI VIDELE",313,246,224,9,13,238,8,345,99,153,85,1,14352,0
36,"Teleorman",151905,341,151905,,"ORAS VIDELE",87,"SPITALUL ORASENESC VIDELE, STR SOSEAUA PITESTI NR 54",0,546,0,546,0,542,4,700,154,314,228,1,14352,1
36,"Teleorman",151978,341,151978,,"ORAS ZIMNICEA",88,"SCOALA GENERALA NR 4  DIN STRADA TURNU MAGURELE NR 38, CU INTRAREA PRIN STRADA CETATII",1573,875,862,13,0,860,15,1730,855,277,583,1,14355,0
36,"Teleorman",151978,341,151978,,"ORAS ZIMNICEA",89,"SCOALA GENERALA NR 4  STRADA TURNU MAGURELE NR 38, CU INTRAREA PRIN STRADA TURNU MAGURELE",1612,969,958,11,0,949,20,1770,801,336,613,1,14355,0
36,"Teleorman",151978,341,151978,,"ORAS ZIMNICEA",90,"GRADINITA NR 2 STR IMPARATUL TRAIAN NR 60, ZIMNICEA, CU INTRAREA PRIN STRADA IMPARATUL TRAIAN",1496,879,872,7,0,853,26,1645,766,320,533,1,14355,0
36,"Teleorman",151978,341,151978,,"ORAS ZIMNICEA",91,"SCOALA GENERALA NR 3 STRADA EROILOR NR 30, CU INTRAREA PRIN STRADA EROILOR",1652,755,742,13,0,750,5,1815,1060,289,461,1,14355,0
36,"Teleorman",151978,341,151978,,"ORAS ZIMNICEA",92,"SCOALA GENERALA NR 1 STR PRIMAVERII NR 5, CU INTRAREA PRIN STRADA PRIMAVERII",1631,750,735,15,0,746,4,1795,1045,338,408,1,14355,0
36,"Teleorman",151978,341,151978,,"ORAS ZIMNICEA",93,"GRADINITA NR 5, STR STEFAN CEL MARE, NR 14, CU INTRAREA PRIN STRADA STEFAN CEL MARE",1522,715,705,10,0,700,15,1675,960,274,426,1,14355,0
36,"Teleorman",151978,341,151978,,"ORAS ZIMNICEA",94,"SCOALA GENERALA NR 2 STR 1 MAI NR 11 CU INTRAREA PRIN STRADA 1 MAI",1508,888,883,5,0,867,21,1660,772,296,571,1,14355,0
36,"Teleorman",151978,341,151978,,"ORAS ZIMNICEA",95,"SCOALA GENERALA NR 2 STR 1 MAI NR 11 CU INTRAREA PRIN STRADA  MIRCEA VODA",1530,889,875,14,0,875,14,1685,796,311,564,1,14355,0
36,"Teleorman",151978,341,151978,,"ORAS ZIMNICEA",96,"GRADINITA NR 5, STRADA STEFAN CEL MARE, NR 14, CU INTRAREA PRIN STRADA STEFAN CEL MARE",1326,748,739,9,0,743,5,1460,712,358,385,1,14355,0
36,"Teleorman",151978,341,151978,,"ORAS ZIMNICEA",97,"LICEUL TEORETIC ZIMNICEA, LABORATORUL DE FIZICA, STR MIHAI VITEAZU NR 30",0,220,0,220,0,220,0,700,480,114,106,1,14355,1
36,"Teleorman",151996,341,151996,,"BALACI",98,"CAMINUL CULTURAL DIN COMUNA BALACI, SATUL BALACI",980,772,694,16,62,757,15,1080,308,139,618,3,14360,0
36,"Teleorman",151996,341,151996,,"BALACI",99,"CAMINUL CULTURAL DIN COMUNA BALACI SATUL TECUCI",756,506,439,16,51,494,12,834,328,94,400,3,14360,0
36,"Teleorman",151996,341,151996,,"BALACI",100,"CAMINUL CULTURAL, SALA NR 2, SAT BALACI",0,273,0,273,0,273,0,300,27,66,207,3,14360,1
36,"Teleorman",152038,341,152038,,"BABAITA",101,"SCOALA GENERALA BABAITA,  SAT BABAITA",1685,960,927,15,18,939,21,1855,895,360,579,3,14357,0
36,"Teleorman",152038,341,152038,,"BABAITA",102,"SCOALA GENERALA  SAT MERISANI",944,592,566,15,11,577,15,1060,468,267,310,3,14357,0
36,"Teleorman",152038,341,152038,,"BABAITA",103,"SCOALA GENERALA CU CLASELE I-VIII, SALA NR 1, BABAITA",0,101,0,101,0,101,0,250,149,47,54,3,14357,1
36,"Teleorman",155083,341,155083,,"BECIU",104,"GRADINITA BECIU AMPLASATA PE DJ 546",963,583,570,13,0,573,10,1060,477,200,373,3,14364,0
36,"Teleorman",155083,341,155083,,"BECIU",105,"GRADINITA SMARDAN, BECIU",518,318,304,14,0,306,12,575,257,124,182,3,14364,0
36,"Teleorman",155083,341,155083,,"BECIU",106,"DISPENSAR UMAN, DJ 546 BECIU",0,112,0,112,0,111,1,250,138,43,68,3,14364,1
36,"Teleorman",155092,341,155092,,"BEUCA",107,"CAMINUL CULTURAL BEUCA",1068,818,773,4,41,805,13,1175,357,561,244,3,14368,0
36,"Teleorman",155092,341,155092,,"BEUCA",108,"CAMINUL CULTURAL PLOPI",189,158,136,12,10,155,3,215,57,105,50,3,14368,0
36,"Teleorman",155092,341,155092,,"BEUCA",109,"CAMINUL CULTURAL, SALA PRINCIPALA, STR CALEA DOBROTESTI NR 62, BEUCA",0,123,0,123,0,122,1,250,127,69,53,3,14368,1
36,"Teleorman",152083,341,152083,,"BLEJESTI",110,"SCOALA GENERALA CU CLASELE I-VIII BLEJESTI STRADA SOS PITESTI NR 323",965,653,644,9,0,636,17,1060,407,294,342,3,14371,0
36,"Teleorman",152083,341,152083,,"BLEJESTI",111,"SCOALA GENERALA CLASELE I  - IV BLEJESTI DIN STRADA STANGULESTI",948,634,617,17,0,626,8,1022,388,275,351,3,14371,0
36,"Teleorman",152083,341,152083,,"BLEJESTI",112,"SCOALA GENERALA CLASELE I-VIII BACIU STR SOS PITESTI",890,555,542,13,0,547,8,980,425,283,264,3,14371,0
36,"Teleorman",152083,341,152083,,"BLEJESTI",113,"SCOALA GENERALA SERICU STR SOS SERICULUI NR 19",330,233,226,7,0,230,3,365,132,98,132,3,14371,0
36,"Teleorman",152083,341,152083,,"BLEJESTI",114,"SCOALA GENERALA CU CLASELE I-IV,SALA NR 1, STR STANGULESTI NR 746, BLEJESTI",0,167,0,167,0,163,4,301,134,74,89,3,14371,1
36,"Teleorman",152127,341,152127,,"BOGDANA",115,"SCOALA GENERALA CLS I-VIII DIN SATUL BOGDANA",909,502,491,11,0,492,9,1001,500,190,302,3,14375,0
36,"Teleorman",152127,341,152127,,"BOGDANA",116,"SCOALA GENERALA  CLS I-IV DIN SATUL URLUIU",639,385,373,12,0,375,10,702,317,164,211,3,14375,0
36,"Teleorman",152127,341,152127,,"BOGDANA",117,"SCOALA GENERALA  CLS I-IV DIN SATUL ULMENI",665,426,412,14,0,418,8,731,305,136,282,3,14375,0
36,"Teleorman",152127,341,152127,,"BOGDANA",118,"SCOALA GENERALA CU CLASELE I-VIII, SALA NR 1 (PARTER), BOGDANA",0,233,0,233,0,231,2,303,70,84,147,3,14375,1
36,"Teleorman",152172,341,152172,,"BOTOROAGA",119,"SCOALA GENERALA I-VIII, BOTOROAGA SATUL BOTOROAGA",1184,684,652,20,12,675,9,1300,616,236,439,3,14380,0
36,"Teleorman",152172,341,152172,,"BOTOROAGA",120,"SCOALA CU CLASELE I-VIII CALUGARU",790,722,690,22,10,713,9,870,148,230,483,3,14380,0
36,"Teleorman",152172,341,152172,,"BOTOROAGA",121,"SCOALA CU CLASELE I-VIII TIRNAVA",1195,788,740,33,15,781,7,1310,522,303,478,3,14380,0
36,"Teleorman",152172,341,152172,,"BOTOROAGA",122,"SCOALA CU CLASELE I-IV TUNARI",192,150,126,17,7,148,2,215,65,66,82,3,14380,0
36,"Teleorman",152172,341,152172,,"BOTOROAGA",123,"SCOALA CU CLASELE I-VIII VALEA CIRESULUI",1374,1004,942,46,16,991,13,1500,496,282,709,3,14380,0
36,"Teleorman",152172,341,152172,,"BOTOROAGA",124,"PUNCTUL DE ACCES AL POPULATIEI LA INFORMATII (PAPI), SALA NR 1, STR PRINCIPAL;A NR 15, BOTOROAGA",0,203,0,203,0,200,3,300,97,62,138,3,14380,1
36,"Teleorman",152234,341,152234,,"BRAGADIRU",125,"GRADINITA DE COPII DIN SATUL BRAGADIRU",1051,509,503,6,0,502,7,1155,646,150,352,3,14386,0
36,"Teleorman",152234,341,152234,,"BRAGADIRU",126,"CAMINUL CULTURAL DIN SATUL BRAGADIRU",1263,609,591,18,0,600,9,1390,781,142,458,3,14386,0
36,"Teleorman",152234,341,152234,,"BRAGADIRU",127,"SCOALA GENERALA NR 2  DIN SATUL BRAGADIRU",1284,667,651,16,0,657,10,1410,743,168,489,3,14386,0
36,"Teleorman",152234,341,152234,,"BRAGADIRU",128,"SCOALA GENERALA NR 2, SALA NR 2, BRAGADIRU",0,214,0,214,0,213,1,300,86,76,137,3,14386,1
36,"Teleorman",152252,341,152252,,"BRANCENI",129,"SCOALA CU CLASELE I - VIII BRANCENI, AMPLASATA PE DN 51",1234,839,796,14,29,815,24,1360,521,254,561,3,14388,0
36,"Teleorman",152252,341,152252,,"BRANCENI",130,"GRADINITA DE COPII BRANCENI - SEDIUL VECHI, AMPLASATA PE DN 51",1245,892,860,9,23,880,12,1370,478,278,602,3,14388,0
36,"Teleorman",152252,341,152252,,"BRANCENI",131,"SCOALA GENERALA CU CLASELE I-VIII, SALA CURS CLASELE A II-A, DN 51 BRANCENI",0,107,0,107,0,106,1,250,143,65,41,3,14388,1
36,"Teleorman",152270,341,152270,,"BUJORENI",132,"CAMINUL CULTURAL DIN SATUL BUJORENI, COMUNA BUJORENI SALA MICA, DE 70",529,368,341,4,23,363,5,402,34,151,212,3,14390,0
36,"Teleorman",152270,341,152270,,"BUJORENI",133,"SCOALA  CU CLASELE I - IV DIN SATUL PRUNARU, COMUNA BUJORENI, DE 70",370,252,222,12,18,250,2,410,158,83,167,3,14390,0
36,"Teleorman",152270,341,152270,,"BUJORENI",134,"CAMINUL CULTURAL, SALA MARE DE SPECTACOLE, BUJORENI",0,339,0,339,0,335,4,480,141,199,136,3,14390,1
36,"Teleorman",152314,341,152314,,"BUJORU",135,"SCOALA BUJORU CLASELE I-VIII",731,493,460,22,11,486,7,800,307,211,275,3,14394,0
36,"Teleorman",152314,341,152314,,"BUJORU",136,"CAMINUL CULTURAL BUJORU",881,583,556,9,18,575,8,970,387,307,268,3,14394,0
36,"Teleorman",152314,341,152314,,"BUJORU",137,"SALA DE EDUCATIE FIZICA SCOLARA DIN INCINTA SCOLII CU CLASELE I-VIII, BUJORU",0,100,0,100,0,100,0,250,150,47,53,3,14394,1
36,"Teleorman",152332,341,152332,,"BUZESCU",138,"CAMINUL CULTURAL DIN COMUNA BUZESCU",1125,686,644,16,26,674,12,1240,554,200,474,3,14396,0
36,"Teleorman",152332,341,152332,,"BUZESCU",139,"GRADINITA DE COPII DIN COMUNA BUZESCU",1263,656,628,12,16,635,21,1390,734,209,426,3,14396,0
36,"Teleorman",152332,341,152332,,"BUZESCU",140,"SCOALA GENERALA CLASELE I-VIII DIN COMUNA BUZESCU",1247,708,660,10,38,691,17,1370,662,235,456,3,14396,0
36,"Teleorman",152332,341,152332,,"BUZESCU",141,"CAMINUL CULTURAL, INTRAREA DINSPRE PARCUL COMUNAL",0,204,0,204,0,203,1,300,96,103,100,3,14396,1
36,"Teleorman",152350,341,152350,,"CALINESTI",142,"SCOALA GENERALA I-VIII CALINESTI",1340,1092,1013,15,64,1078,14,1400,308,454,624,3,14398,0
36,"Teleorman",152350,341,152350,,"CALINESTI",143,"SCOALA GENERALA I-VIII LICURICIU",521,373,331,8,34,366,7,576,203,131,235,3,14398,0
36,"Teleorman",152350,341,152350,,"CALINESTI",144,"SCOALA GENERALA I-VIII COPACEANCA",837,623,555,22,46,613,10,922,299,256,357,3,14398,0
36,"Teleorman",152350,341,152350,,"CALINESTI",145,"SCOALA GENERALA I-IV ANTONESTI",282,198,193,5,0,189,9,310,112,62,127,3,14398,0
36,"Teleorman",152350,341,152350,,"CALINESTI",146,"SCOALA GENERALA CU CLASELE I-VIII, SALA  DE LIMBA ROMANA, CALINESTI",0,415,0,415,0,414,1,486,71,254,160,3,14398,1
36,"Teleorman",152412,341,152412,,"CALMATUIU",147,"SCOALA CU CLASELE I-VIII DIN SATUL CALMATUIU",641,402,391,11,0,397,5,705,303,122,275,3,14404,0
36,"Teleorman",152412,341,152412,,"CALMATUIU",148,"SCOALA CU CLASELE I - IV DIN SATUL CARAVANETI",268,152,144,8,0,145,7,300,148,43,102,3,14404,0
36,"Teleorman",152412,341,152412,,"CALMATUIU",149,"SCOALA VECHE CU CLASELE I - IV  DIN SATUL BUJORU",218,169,160,9,0,166,3,240,71,48,118,3,14404,0
36,"Teleorman",152412,341,152412,,"CALMATUIU",150,"SCOALA VECHE  CU CLASELE I-VIII  DIN SATUL NICOLAE BALCESCU",764,505,494,10,1,495,10,840,335,165,330,3,14404,0
36,"Teleorman",152412,341,152412,,"CALMATUIU",151,"SCOALA GENERALA CU CLASELE I-VIII, LABORATORUL DE INFORMATICA , CALMATUIU",0,180,0,180,0,179,1,300,120,63,116,3,14404,1
36,"Teleorman",152467,341,152467,,"CALMATUIU DE SUS",152,"SCOALA VECHE CALMATUIU DE SUS",764,410,393,17,0,403,7,840,430,168,235,3,14409,0
36,"Teleorman",152467,341,152467,,"CALMATUIU DE SUS",153,"SCOALA IONASCU",337,164,156,8,0,161,3,372,208,57,104,3,14409,0
36,"Teleorman",152467,341,152467,,"CALMATUIU DE SUS",154,"SALA  DE FESTIVITATI  A FOSTULUI SEDIU CAP BACALESTI",959,524,512,12,0,507,17,1055,531,173,334,3,14409,0
36,"Teleorman",152467,341,152467,,"CALMATUIU DE SUS",155,"CAMINUL CULTURAL, SALA MICA, CALMATUIU DE SUS",0,94,0,94,0,93,1,251,157,38,55,3,14409,1
36,"Teleorman",152500,341,152500,,"CERVENIA",156,"SCOALA CERVENIA COMUNA CERVENIA IN CLADIRI DIFERITE,CORPUL DE CLADIRE SITUAT IN VECINATATEA LOCUITORULUI BOJAN FLOREA",1349,733,717,16,0,717,16,1491,758,341,376,3,14413,0
36,"Teleorman",152500,341,152500,,"CERVENIA",157,"SCOALA CERVENIA COMUNA CERVENIA IN CLADIRI DIFERITE,CORPUL DE CLADIRE SITUAT IN VECINATATEA LOCUITORULUI BOBOC ION",1298,699,690,9,0,691,8,1440,741,360,331,3,14413,0
36,"Teleorman",152500,341,152500,,"CERVENIA",158,"SCOALA GENERALA CU CLASELE I-VIII, CERVENIA",0,162,0,162,0,157,5,250,88,74,83,3,14413,1
36,"Teleorman",152528,341,152528,,"CIOLANESTI",159,"SCOALA GENERALA NR 1 DIN SATUL CIOLANESTI-DEAL",884,631,547,70,14,624,7,942,311,282,342,3,14415,0
36,"Teleorman",152528,341,152528,,"CIOLANESTI",160,"SCOALA GENERALA NR 2  DIN SATUL CIOLANESTI-DEAL",737,436,390,38,8,429,7,762,326,143,286,3,14415,0
36,"Teleorman",152528,341,152528,,"CIOLANESTI",161,"SCOALA GENERALA NR 3  DIN SATUL CIOLANESTI-VALE",579,378,356,13,9,375,3,640,262,110,265,3,14415,0
36,"Teleorman",152528,341,152528,,"CIOLANESTI",162,"SCOALA GENERALA  DIN SATUL BALDOVINESTI",410,282,268,14,0,276,6,450,168,132,144,3,14415,0
36,"Teleorman",152528,341,152528,,"CIOLANESTI",163,"PRIMARIA VECHE, SALA NR 1, SATUL CIOLANESTII DIN DEAL",0,205,0,205,0,202,3,300,95,73,129,3,14415,1
36,"Teleorman",151709,341,151709,,"CIUPERCENI",164,"CAMINUL CULTURAL  DIN SATUL CIUPERCENI",876,605,568,8,29,595,10,1010,405,305,290,3,14419,0
36,"Teleorman",151709,341,151709,,"CIUPERCENI",165,"SCOALA CU CLASELE I-IV POIANA",608,456,385,17,54,449,7,670,214,208,241,3,14419,0
36,"Teleorman",151709,341,151709,,"CIUPERCENI",166,"SCOALA GENERALA CU CLASELE I-VIII, LABORATORUL DE MATEMATICA, CIUPERCENI",0,203,0,203,0,203,0,301,98,100,103,3,14419,1
36,"Teleorman",152564,341,152564,,"CONTESTI",167,"SALA DE SEDINTE A CONSILIULUI LOCAL DIN CENTRUL COMUNEI CONTESTI",1434,975,909,26,40,963,12,1575,600,314,649,3,14422,0
36,"Teleorman",152564,341,152564,,"CONTESTI",168,"GRADINITA DIN CENTRUL COMUNEI CONTESTI",1515,998,955,7,36,993,5,1675,677,267,726,3,14422,0
36,"Teleorman",152564,341,152564,,"CONTESTI",169,"LOCALUL DIN CENTRUL COMUNEI, DE LANGA PRIMARIE, SALA VECINA CU PUNCTUL FARMACEUTIC",0,223,0,223,0,222,1,250,27,115,107,3,14422,1
36,"Teleorman",152582,341,152582,,"COSMESTI",170,"SCOALA GENERALA  CU CLASELE I-VIII DIN SATUL COSMESTI",872,631,580,14,37,622,9,960,329,106,516,3,14424,0
36,"Teleorman",152582,341,152582,,"COSMESTI",171,"SCOALA GENERALA  DIN SATUL CIUPERCENI",1242,804,739,29,36,799,5,1365,561,324,475,3,14424,0
36,"Teleorman",152582,341,152582,,"COSMESTI",172,"SCOALA GENERALA CU CLASELE I-VIII, SALA NR 1, COSMESTI",0,88,0,88,0,88,0,250,162,31,57,3,14424,1
36,"Teleorman",152617,341,152617,,"CRANGENI",173,"CAMINUL CULTURAL  DIN SATUL  CRINGENI",1354,848,774,33,41,834,14,1490,642,301,533,3,14427,0
36,"Teleorman",152617,341,152617,,"CRANGENI",174,"SCOALA CU CLASELE I-VIII  DIN SATUL BALTA SARATA",684,455,390,19,46,446,9,753,298,157,289,3,14427,0
36,"Teleorman",152617,341,152617,,"CRANGENI",175,"SCOALA CU CLASELE I-IV  DIN SATUL DOROBANTU",371,237,193,28,16,235,2,408,171,86,149,3,14427,0
36,"Teleorman",152617,341,152617,,"CRANGENI",176,"SCOALA CU CLASELE I-IV  DIN SATUL STEJARU",234,167,144,18,5,163,4,262,95,48,115,3,14427,0
36,"Teleorman",152617,341,152617,,"CRANGENI",177,"CAMINUL CULTURAL, BIBLIOTECA COMUNALA, CRANGENI",0,168,0,168,0,167,1,250,82,47,120,3,14427,1
36,"Teleorman",152662,341,152662,,"CRANGU",178,"CAMINUL CULTURAL CRINGU",876,551,504,20,27,540,11,568,17,240,300,3,14432,0
36,"Teleorman",152662,341,152662,,"CRANGU",179,"SCOALA GENERALA CU CLASELE I-IV  DIN SATUL  SECARA",370,284,254,15,15,277,7,410,126,178,99,3,14432,0
36,"Teleorman",152662,341,152662,,"CRANGU",180,"SCOALA GENERALA CU CLASELE I-VIII, LABORATORUL DE BIOLOGIE, CRANGU",0,260,0,260,0,258,2,641,381,116,142,3,14432,1
36,"Teleorman",151932,341,151932,,"CREVENICU",181,"GRADINITA DE COPII, SALA NR 1, SAT CREVENICU",836,565,533,11,21,560,5,920,355,238,322,3,14435,0
36,"Teleorman",151932,341,151932,,"CREVENICU",182,"CAMINUL CULTURAL RADULESTI, COMUNA CREVENICU",462,368,348,15,5,359,9,525,157,128,231,3,14435,0
36,"Teleorman",151932,341,151932,,"CREVENICU",183,"GRADINITA DE COPII, SALA NR 2, CREVENICU",0,106,0,106,0,105,1,250,144,39,66,3,14435,1
36,"Teleorman",152724,341,152724,,"DIDESTI",184,"SCOALACU CLASELE I-VIII (SALA DE ISTORIE)",1101,786,777,9,0,776,10,1210,424,531,245,3,14438,0
36,"Teleorman",152724,341,152724,,"DIDESTI",185,"CAMINUL CULTURAL, SALA MARE, DIDESTI",0,95,0,95,0,94,1,250,155,50,44,3,14438,1
36,"Teleorman",152760,341,152760,,"DOBROTESTI",186,"SCOALA  CLASELE I-VIII DOBROTESTI",1400,764,679,85,0,746,18,1540,776,277,469,3,14442,0
36,"Teleorman",152760,341,152760,,"DOBROTESTI",187,"SCOALA CU CLSELE I-IV DOBROTESTI",1459,674,623,51,0,650,24,1600,926,295,355,3,14442,0
36,"Teleorman",152760,341,152760,,"DOBROTESTI",188,"SCOALA CU CLASELE I - VIII  MERISANI",1079,610,596,14,0,596,14,1190,580,289,307,3,14442,0
36,"Teleorman",152760,341,152760,,"DOBROTESTI",189,"SCOALA GENERALA CU CLASELE I-VIII, CABINET NR 2, DOBROTESTI",0,151,0,151,0,151,0,250,99,58,93,3,14442,1
36,"Teleorman",155109,341,155109,,"DRACEA",190,"SEDIUL GRADINITEI DE COPII DRACEA  DIN SATUL DRACEA, COMUNA DRACEA",1142,557,517,1,39,549,7,1255,699,188,361,3,14445,0
36,"Teleorman",155109,341,155109,,"DRACEA",191,"SCOALA  GENERALA  DIN SATUL ZLATA, COMUNA DRACEA",92,76,61,8,7,75,1,110,34,28,47,3,14445,0
36,"Teleorman",155109,341,155109,,"DRACEA",192,"CAMINUL CULTURAL  DIN SATUL FLORICA , COMUNA DRACEA",247,177,162,8,7,175,2,275,98,32,143,3,14445,0
36,"Teleorman",155109,341,155109,,"DRACEA",193,"SALA DE SPORT DIN GRADINITA DE PE LANGA SCOALA GENERALA CU CLASELE I-VIII, STR PRINCIPALA DRACEA",0,131,0,131,0,129,2,250,119,44,85,3,14445,1
36,"Teleorman",152797,341,152797,,"DRACSENEI",194,"SCOALA CU CLASELE I-IV  DIN SATUL DRACSENEI",1119,804,743,12,49,797,7,1230,426,243,554,3,14449,0
36,"Teleorman",152797,341,152797,,"DRACSENEI",195,"SCOALA CU CLASELE I-IV  DIN SATUL ODOBEASCA",461,319,305,7,7,313,6,510,191,106,207,3,14449,0
36,"Teleorman",152797,341,152797,,"DRACSENEI",196,"SCOALA GENERALA CU CLASELE I-IV, SALA NR 2, DRACSANEI",0,140,0,140,0,140,0,254,114,80,60,3,14449,1
36,"Teleorman",152868,341,152868,,"DRAGANESTI DE VEDE",197,"SCOALA CU CLASELE I-VIII DRAGANESTI DE VEDE",1228,791,727,17,47,784,7,1350,559,442,342,3,14454,0
36,"Teleorman",152868,341,152868,,"DRAGANESTI DE VEDE",198,"SCOALA CLASELE I-VIII VACARESTI",533,350,313,28,9,346,4,600,250,183,163,3,14454,0
36,"Teleorman",152868,341,152868,,"DRAGANESTI DE VEDE",199,"SCOALA GENERALA CU CLASELE I-VIII, SALA DE PREGATIRE A CLASELOR I-III, DRAGANESTI VEDE",0,79,0,79,0,79,0,252,173,47,32,3,14454,1
36,"Teleorman",152902,341,152902,,"DRAGANESTI-VLASCA",200,"GRUPUL SCOLAR TEHNIC, SATUL DRAGANESTI VLASCA",1812,1011,964,47,0,984,27,2000,989,322,662,3,14458,0
36,"Teleorman",152902,341,152902,,"DRAGANESTI-VLASCA",201,"SCOALA GENERALA CLASELE I-VIII, SAT DRAGANESTI VLASCA",1212,678,634,44,0,670,8,1330,652,212,458,3,14458,0
36,"Teleorman",152902,341,152902,,"DRAGANESTI-VLASCA",202,"SCOALA GENERALA CLASELE I-IV, SAT  VACENI",269,161,148,13,0,160,1,300,139,46,114,3,14458,0
36,"Teleorman",152902,341,152902,,"DRAGANESTI-VLASCA",203,"SCOALA GENERALA CLASELE I-IV, SAT COMOARA",463,303,288,15,0,290,13,510,207,98,192,3,14458,0
36,"Teleorman",152902,341,152902,,"DRAGANESTI-VLASCA",204,"CLADIREA FOSTEI BAI COMUNALE, SOSEAUA VIDELE NR 9, DRAGANESTI VLASCA",0,245,0,245,0,240,5,300,55,123,117,3,14458,1
36,"Teleorman",155118,341,155118,,"FANTANELE",205,"GRADINITA FANTANELE, AMPLASATA IN ZONA CENTRALA A COMUNEI FANTANELE, PE LATURA SUDICA A DN 51, CLASA A",1591,1108,1019,5,84,1092,16,1754,646,469,623,3,14462,0
36,"Teleorman",155118,341,155118,,"FANTANELE",206,"GRADINITA FANTANELE, SALA NR 1, SOS TURNU MAGURELE, NR 94, FANTANELE",0,129,0,129,0,127,2,251,122,70,57,3,14462,1
36,"Teleorman",155127,341,155127,,"FRASINET",207,"SCOALA CU CLASELE I-VIII FRASINET",1734,1599,1567,19,13,1599,0,1900,301,767,832,3,14464,0
36,"Teleorman",155127,341,155127,,"FRASINET",208,"SCOALA CU CLASELE I-VIII CLANITA",529,467,373,86,8,460,7,585,118,205,255,3,14464,0
36,"Teleorman",155127,341,155127,,"FRASINET",209,"SCOALA GENERALA CU CLASELE I-VIII, SALA  DE BIOLOGIE, FRASINET",0,94,0,94,0,93,1,250,156,49,44,3,14464,1
36,"Teleorman",152993,341,152993,,"FRUMOASA",210,"CAMINUL CULTURAL DIN COMUNA FRUMOASA",935,620,585,15,20,612,8,1030,410,208,404,3,14467,0
36,"Teleorman",152993,341,152993,,"FRUMOASA",211,"GRADINITA DE COPII DIN CARTIERUL RAREANCA, COMUNA FRUMOASA",526,336,317,13,6,335,1,580,244,83,252,3,14467,0
36,"Teleorman",152993,341,152993,,"FRUMOASA",212,"SCOALA GENERALA CU CLASELE I-IV DIN SAT PAULEASCA, COMUNA FRUMOASA",502,314,298,9,7,312,2,555,241,124,188,3,14467,0
36,"Teleorman",152993,341,152993,,"FRUMOASA",213,"CAMINUL CULTURAL, SALA DE SPECTACOLE, FRUMOASA",0,136,0,136,0,135,1,250,114,51,84,3,14467,1
36,"Teleorman",152948,341,152948,,"FURCULESTI",214,"SCOALA CU CLASELE I-VIII DIN SATUL FURCULESTI",1429,735,710,25,0,719,16,1575,840,272,447,3,14470,0
36,"Teleorman",152948,341,152948,,"FURCULESTI",215,"SCOALA CU CLASELE I-IV DIN SATUL SPATAREI",976,653,639,14,0,642,11,1100,447,260,382,3,14470,0
36,"Teleorman",152948,341,152948,,"FURCULESTI",216,"SCOALA CU CLASELE I-IV VOIEVODA",571,355,341,14,0,349,6,641,286,135,214,3,14470,0
36,"Teleorman",152948,341,152948,,"FURCULESTI",217,"SCOALA GENERALA CU CLASELE I-VIII, CABINET CHIMIE-FIZICA, STR PRINCIPALA FURCULESTI",0,266,0,266,0,263,3,300,34,116,147,3,14470,1
36,"Teleorman",153026,341,153026,,"GALATENI",218,"SCOALA  GALATENI",1424,811,794,17,0,794,17,1565,754,466,328,3,14475,0
36,"Teleorman",153026,341,153026,,"GALATENI",219,"SCOALA  DIN SATUL  BISCOVENI",983,564,517,47,0,552,12,1085,521,243,309,3,14475,0
36,"Teleorman",153026,341,153026,,"GALATENI",220,"SCOALA GENERALA CU CLASELE I-VIII NR 2, SALA DE CLASA NR 1, GALETENI",0,165,0,165,0,163,2,250,85,91,72,3,14475,1
36,"Teleorman",153062,341,153062,,"GRATIA",221,"SCOALA GENERALA  NR 2 FARCASANCA SALA NR 1",1047,697,666,13,18,689,8,1150,453,152,537,3,14479,0
36,"Teleorman",153062,341,153062,,"GRATIA",222,"SCOALA  NR 1  DIN SATUL CIURARI DEAL",1228,863,792,40,31,850,13,1350,487,276,574,3,14479,0
36,"Teleorman",153062,341,153062,,"GRATIA",223,"SCOALA GENERALA CU CLASELE I-IV NR 2, SALA DE CLASA NR 2,STR TUDOR VLADIMIRESCU NR 10, GRATIA",0,195,0,195,0,193,2,300,105,57,136,3,14479,1
36,"Teleorman",151736,341,151736,,"ISLAZ",224,"SCOALA GENERALA NR 2  (GRADINITA DE COPII NR 2)  DIN SATUL  ISLAZ",1677,982,939,24,19,971,11,1845,863,456,515,3,14483,0
36,"Teleorman",151736,341,151736,,"ISLAZ",225,"CAMINUL CULTURAL ISLAZ  DIN SATUL ISLAZ, COMUNA ISLAZ",1434,937,901,11,25,920,17,1575,638,405,515,3,14483,0
36,"Teleorman",151736,341,151736,,"ISLAZ",226,"SCOALA GENERALA NR 1  DIN SATUL ISLAZ, COMUNA ISLAZ",836,545,501,29,15,531,14,931,386,180,351,3,14483,0
36,"Teleorman",151736,341,151736,,"ISLAZ",227,"SCOALA GENERALA  DIN SATUL MOLDOVENI, COMUNA ISLAZ",840,574,538,13,23,564,10,925,351,219,345,3,14483,0
36,"Teleorman",151736,341,151736,,"ISLAZ",228,"SCOALA GENERALA CU CLASELE I-VIII NR 1, SALA DE CLASA NR 1, DREAPTA, ISLAZ",0,249,0,249,0,246,3,300,51,99,147,3,14483,1
36,"Teleorman",153106,341,153106,,"IZVOARELE",229,"GRADINITA DE COPII  STR CAMINULUI NR 1 IZVOARELE",1071,800,748,18,34,798,2,1180,380,318,480,3,14486,0
36,"Teleorman",153106,341,153106,,"IZVOARELE",230,"SCOALA NOUA FARA ETAJ STR ZIMNICEI NR 35 IZVOARELE",1306,869,833,15,21,861,8,1435,566,341,520,3,14486,0
36,"Teleorman",153106,341,153106,,"IZVOARELE",231,"GRADINITA DE COPII, SALA NR 2, STR ZIMNICEI NR 35",0,84,0,84,0,83,1,251,167,39,44,3,14486,1
36,"Teleorman",153124,341,153124,,"LISA",232,"SCOALA CU CLASELE I-VIII LISA SALA NR 1",1381,889,784,16,89,881,8,1525,636,440,441,3,14488,0
36,"Teleorman",153124,341,153124,,"LISA",233,"FOST COMITET  VINATORI SALA NR 1",365,378,365,7,6,365,13,680,302,188,177,3,14488,0
36,"Teleorman",153124,341,153124,,"LISA",234,"SCOALA GENERALA CU CLASELE I-VIII, SALA DE CLASA NR 3, PARTER, LISA",0,96,0,96,0,95,1,250,154,61,34,3,14488,1
36,"Teleorman",151763,341,151763,,"LITA",235,"SCOALA GENERALA NR 1 DIN COMUNA LITA",1264,738,606,116,16,723,15,1390,652,243,480,3,14491,0
36,"Teleorman",151763,341,151763,,"LITA",236,"GRADINITA NR 2  DIN COMUNA LITA",1225,796,641,126,29,780,16,1350,554,274,506,3,14491,0
36,"Teleorman",151763,341,151763,,"LITA",237,"SCOALA GENERALA CU CLASELE I-VIII, SALA DE CLASA NR 3, LITA",0,156,0,156,0,154,2,251,95,60,94,3,14491,1
36,"Teleorman",153151,341,153151,,"LUNCA",238,"SCOALA GENERALA  LUNCA",1044,690,586,98,6,668,22,1150,460,259,409,3,14493,0
36,"Teleorman",153151,341,153151,,"LUNCA",239,"GRADINITA DE COPII LUNCA",737,435,363,72,0,429,6,811,376,241,188,3,14493,0
36,"Teleorman",153151,341,153151,,"LUNCA",240,"SCOALA GENERALA PRUNDU",980,489,472,17,0,475,14,1080,591,187,288,3,14493,0
36,"Teleorman",153151,341,153151,,"LUNCA",241,"SCOALA GENERALA CU CLASELE I-VIII, SALA DE SPORT, LUNCA",0,113,0,113,0,112,1,248,135,59,53,3,14493,1
36,"Teleorman",153204,341,153204,,"MAVRODIN",242,"SCOALA GENERALA CLASELE I-VIII (LOCAL VECHI) MAVRODIN",1237,800,772,20,8,791,9,1360,560,354,437,3,14506,0
36,"Teleorman",153204,341,153204,,"MAVRODIN",243,"SCOALA GENERALA CLASELE I-VIII (LOCAL NOU) MAVRODIN",999,689,649,27,13,679,10,1100,411,309,370,3,14506,0
36,"Teleorman",153204,341,153204,,"MAVRODIN",244,"SCOALA GENERALA CU CLASELE I-VIII,  LOCALUL VECHI, SALA DE CLASA NR 2, MAVRODIN",0,303,0,303,0,301,2,303,0,203,98,3,14506,1
36,"Teleorman",153240,341,153240,,"MAGURA",245,"CAMINUL CULTURAL MAGURA",1618,1142,1074,28,40,1115,27,1790,648,530,585,3,14496,0
36,"Teleorman",153240,341,153240,,"MAGURA",246,"SCOALA CU CLASELE I-VIII GURUIENI",872,602,570,26,6,591,11,960,358,245,346,3,14496,0
36,"Teleorman",153240,341,153240,,"MAGURA",247,"GRADINITA DE COPII, SALA NR 1, PE DREAPTA, MAGURA",0,250,0,250,0,245,5,300,50,105,140,3,14496,1
36,"Teleorman",153277,341,153277,,"MALDAENI",248,"SCOALA CU CLASELE I-VIII NR 1 (PARTER) MALDAENI",1255,816,786,21,9,808,8,1376,560,363,445,3,14499,0
36,"Teleorman",153277,341,153277,,"MALDAENI",249,"GRADINITA NR 1 MALDAENI (BIDOIU)",1020,643,627,11,5,628,15,1216,573,305,323,3,14499,0
36,"Teleorman",153277,341,153277,,"MALDAENI",250,"GRADINITA NR 2 SAT MAGURENI COMUNA MALDAENI",1440,932,888,19,25,911,21,1585,653,479,432,3,14499,0
36,"Teleorman",153277,341,153277,,"MALDAENI",251,"GRADINITA DE COPII NR 2, SALA NR 2, STR PRINCIPALA NR 98",0,142,0,142,0,142,0,250,108,89,53,3,14499,1
36,"Teleorman",153295,341,153295,,"MERENI",252,"SCOALA GENERALA CU CLASELE I - VIII SAT MERENII DE JOS",1426,863,837,26,0,857,6,1570,707,222,635,3,14508,0
36,"Teleorman",153295,341,153295,,"MERENI",253,"SCOALA GENERALA CU CLASELE I - VIII SAT MERENII DE SUS",950,536,523,13,0,530,6,1045,509,114,416,3,14508,0
36,"Teleorman",153295,341,153295,,"MERENI",254,"SCOALA GENERALA CU CLASELE I-VIII, SALA DE CLASA NR 2, MERENII DE JOS",0,186,0,186,0,184,2,250,64,70,114,3,14508,1
36,"Teleorman",153339,341,153339,,"MARZANESTI",255,"SCOALA CU CLASELE I-IV CERNETU",1190,924,839,34,51,907,17,1310,386,448,459,3,14501,0
36,"Teleorman",153339,341,153339,,"MARZANESTI",256,"SCOALA CU CLASELE I-IV VALEA PARULUI",752,560,523,16,21,547,13,830,270,265,282,3,14501,0
36,"Teleorman",153339,341,153339,,"MARZANESTI",257,"SCOALA CU CLASELE I-VIII MARZANESTI",552,451,412,22,17,447,4,628,177,267,180,3,14501,0
36,"Teleorman",153339,341,153339,,"MARZANESTI",258,"SCOALA CU CLASELE I-IV TELEORMANU",850,722,649,17,56,714,8,935,213,276,438,3,14501,0
36,"Teleorman",153339,341,153339,,"MARZANESTI",259,"SCOALA GENERALA CU CLASELE I-IV, SALA DE CLASA NR 2, VALEA PARULUI",0,384,0,384,0,384,0,401,17,159,225,3,14501,1
36,"Teleorman",153384,341,153384,,"MOSTENI",260,"SCOALA CU CLASELE I-VIII (LOCALUL VECHI) SALA NR 1 MOSTENI",755,543,482,7,54,540,3,794,251,119,421,3,14512,0
36,"Teleorman",153384,341,153384,,"MOSTENI",261,"SCOALA CU CLASELE I-VIII (LOCALUL VECHI) SALA NR 4 MOSTENI",576,428,358,15,55,424,4,640,212,122,302,3,14512,0
36,"Teleorman",153384,341,153384,,"MOSTENI",262,"SCOALA GENERALA CU CLASELE I-VIII, SALA DE CLASA NR 3, MOSTENI",0,69,0,69,0,69,0,250,181,26,43,3,14512,1
36,"Teleorman",151816,341,151816,,"NANOV",263,"SCOALA CU CLASELE I-VIII NR 1 NANOV SALA NR 2",1655,1008,996,12,0,991,17,1420,412,502,489,3,14514,0
36,"Teleorman",151816,341,151816,,"NANOV",264,"GRADINITA NR 2 NANOV",1447,864,852,12,0,856,8,1590,726,351,505,3,14514,0
36,"Teleorman",151816,341,151816,,"NANOV",265,"SCOALA GENERALA CU CLASELE I-VIII, SALA NR 1, NANOV",0,308,0,308,0,304,4,697,389,176,128,3,14514,1
36,"Teleorman",153400,341,153400,,"NASTURELU",266,"SCOALA GENERALA DIN SATUL NASTURELU SALA DE CLASA NR 1",1372,861,841,20,0,844,17,1514,653,280,564,3,14516,0
36,"Teleorman",153400,341,153400,,"NASTURELU",267,"SCOALA GENERALA DIN SATUL ZIMNICELE",945,585,567,14,4,579,6,1037,452,247,332,3,14516,0
36,"Teleorman",153400,341,153400,,"NASTURELU",268,"SCOALA GENERALA , SALA DE CLASA NR 2, STR GIURGIULUI 151, NASTURELU",0,38,0,38,0,38,0,250,212,16,22,3,14516,1
36,"Teleorman",153437,341,153437,,"NECSESTI",269,"SCOALA CU CLASELE I-IV NECSESTI,SAT NECSESTI",571,363,356,7,0,350,13,626,263,123,227,3,14519,0
36,"Teleorman",153437,341,153437,,"NECSESTI",270,"SCOALA  CU CLASELE I-VIII GARDESTI, SAT GARDESTI",570,332,321,11,0,326,6,630,298,75,251,3,14519,0
36,"Teleorman",153437,341,153437,,"NECSESTI",271,"SCOALA GENERALA CU CLASELE I-IV, SALA P.A.P.I., NECSESTI",0,105,0,105,0,103,2,250,145,40,63,3,14519,1
36,"Teleorman",154996,341,154996,,"NENCIULESTI",272,"SCOALA CU CLASELE I-VIII NENCIULESTI",741,468,428,14,26,464,4,820,352,161,303,3,14523,0
36,"Teleorman",154996,341,154996,,"NENCIULESTI",273,"GRADINITA DE COPII NENCIULESTI",888,567,532,9,26,553,14,980,413,223,330,3,14523,0
36,"Teleorman",154996,341,154996,,"NENCIULESTI",274,"SCOALA CU CLASELE I-IV PARUL-ROTUND",490,316,293,18,5,316,0,540,224,48,268,3,14523,0
36,"Teleorman",154996,341,154996,,"NENCIULESTI",275,"CAMINUL CULTURAL, SALA NR 1, NENCIULESTI",0,262,0,262,0,260,2,300,38,86,174,3,14523,1
36,"Teleorman",153473,341,153473,,"OLTENI",276,"SCOALA CU CLASELE I-VIII OLTENI",1575,1021,997,24,0,1006,15,1487,466,317,689,3,14526,0
36,"Teleorman",153473,341,153473,,"OLTENI",277,"SCOALA CU CLASELE I-VIII PERII-BROSTENI",1003,601,586,15,0,595,6,982,381,192,403,3,14526,0
36,"Teleorman",153473,341,153473,,"OLTENI",278,"SCOALA GENERALA CU CLASELE I-VIII, SALA DE INFORMATICA, STR ALEXANDRIEI NR 33, OLTENI",0,201,0,201,0,199,2,300,99,66,133,3,14526,1
36,"Teleorman",153507,341,153507,,"ORBEASCA",279,"SCOALA NOUA CU CLASELE I-VIII DIN SATUL ORBEASCA DE JOS, SITUATA IN A II a CLASA DE LANGA CANCELARIE",765,401,371,30,0,396,5,840,439,161,235,3,14529,0
36,"Teleorman",153507,341,153507,,"ORBEASCA",280,"LOCALUL NOU AL SCOLII CU CLASELE I-VIII DIN SATUL ORBEASCA DE JOS, SITUATA IN CLASA AFLATA FATA IN FATA CU CANCELARIA",1248,714,630,68,16,707,7,1375,661,321,386,3,14529,0
36,"Teleorman",153507,341,153507,,"ORBEASCA",281,"SCOALA VECHE DIN SATUL ORBEASCA DE SUS, CLASA DE LA STRADA IN PARTEA DREAPTA",1182,640,539,101,0,639,1,1300,660,338,301,3,14529,0
36,"Teleorman",153507,341,153507,,"ORBEASCA",282,"SCOALA VECHE DIN SATUL ORBEASCA DE SUS, CLASA DE LA STRADA IN PARTEA STANGA",1395,874,783,91,0,862,12,1535,661,445,417,3,14529,0
36,"Teleorman",153507,341,153507,,"ORBEASCA",283,"SCOALA CU CLASELE I-VIII DIN SATUL LACENI, IN PRIMA CLASA DE LA INTRARE, IN PARTEA STANGA",942,534,512,22,0,527,7,1035,501,223,304,3,14529,0
36,"Teleorman",153507,341,153507,,"ORBEASCA",284,"SCOALA CU CLASELE I-VIII DIN SATUL LACENI, IN A II a  CLASA,  DE LA INTRARE IN PARTEA STANGA",1128,599,585,14,0,594,5,1240,641,224,370,3,14529,0
36,"Teleorman",153507,341,153507,,"ORBEASCA",285,"SCOALA GENERALA CU CLASELE I-VIII, SALA DE CLASA DE LANGA CANCELARIE, SOSEAUA ALEXANDRIEI, ORBEASCA DE JOS",0,205,0,205,0,202,3,300,95,105,97,3,14529,1
36,"Teleorman",153543,341,153543,,"PERETU",286,"SCOALA CU CLASELE I-VIII PERETU STRADA  ADAMIADE NR 771",1032,651,601,50,0,640,11,1135,484,205,435,3,14533,0
36,"Teleorman",153543,341,153543,,"PERETU",287,"CAMINUL CULTURAL PERETU STRADA SOSEA DEAL NR 260",1378,839,776,63,0,818,21,1520,681,329,489,3,14533,0
36,"Teleorman",153543,341,153543,,"PERETU",288,"GRADINITA DE COPII PERETU STRADA  SOSEA VALE NR 250",1413,880,823,57,0,867,13,1555,675,382,485,3,14533,0
36,"Teleorman",153543,341,153543,,"PERETU",289,"GRADINITA DE COPII PERETU STRADA SOSEA VALE NR 250",1230,735,700,35,0,722,13,1355,620,237,485,3,14533,0
36,"Teleorman",153543,341,153543,,"PERETU",290,"SCOALA CU CLASELE I-VIII PERETU STRADA ADAMIADE NR 771",1327,762,731,31,0,747,15,1465,703,215,532,3,14533,0
36,"Teleorman",153543,341,153543,,"PERETU",291,"GRADINITA DE COPII, SALA NR 1, PERETU",0,192,0,192,0,192,0,300,108,98,94,3,14533,1
36,"Teleorman",153561,341,153561,,"PIATRA",292,"SCOALA CU CLASELE I-VIII PIATRA",985,661,654,7,0,651,10,1085,424,207,444,3,14535,0
36,"Teleorman",153561,341,153561,,"PIATRA",293,"GRADINITA DIN COMUNA PIATRA",921,562,553,9,0,552,10,1020,458,193,359,3,14535,0
36,"Teleorman",153561,341,153561,,"PIATRA",294,"CONSUMCOOP PIATRA",1018,636,630,6,0,620,16,1120,484,171,449,3,14535,0
36,"Teleorman",153561,341,153561,,"PIATRA",295,"LICEUL TEORETIC, CABINET BIOLOGIE, STR PRINCIPALA, PIATRA",0,200,0,200,0,197,3,302,102,82,115,3,14535,1
36,"Teleorman",153589,341,153589,,"PIETROSANI",296,"SCOALA VECHE  DIN SOSEA PIETROSANI",1100,672,641,13,18,656,16,1210,538,305,351,3,14537,0
36,"Teleorman",153589,341,153589,,"PIETROSANI",297,"SCOALA NOUA PIETROSANI",1451,839,814,6,19,819,20,1570,731,367,452,3,14537,0
36,"Teleorman",153589,341,153589,,"PIETROSANI",298,"SCOALA GENERALA CU CLASELE I-VIII (SCOALA NOUA), SALA DE CLASA NR 2, PIETROSANI",0,199,0,199,0,198,1,299,100,101,97,3,14537,1
36,"Teleorman",153623,341,153623,,"PLOPII-SLAVITESTI",299,"SCOALA GENERALA CU CLASELE I - VIII PLOPII SLAVITESTI, AMPLASATA PE DJ 546",650,483,438,16,29,476,7,715,232,274,202,3,14539,0
36,"Teleorman",153623,341,153623,,"PLOPII-SLAVITESTI",300,"SCOALA CU CLASELE I-IV BRANCOVEANCA, AMPLASATA PE DJ 546",899,634,590,15,29,625,9,990,356,310,315,3,14539,0
36,"Teleorman",153623,341,153623,,"PLOPII-SLAVITESTI",301,"GRADINITA DE COPII DUDU, AMPLASATA PE DJ 546",645,463,432,18,13,462,1,715,252,204,258,3,14539,0
36,"Teleorman",153623,341,153623,,"PLOPII-SLAVITESTI",302,"SCOALA GENERALA CU CLASELE I-VIII, SALA DE CLASA NR 2, PLOPII SLAVITESTI",0,137,0,137,0,137,0,250,113,58,79,3,14539,1
36,"Teleorman",153605,341,153605,,"PLOSCA",303,"SCOALA RASFIRATI, COMUNA PLOSCA",1518,991,907,72,12,980,11,1670,679,456,524,3,14543,0
36,"Teleorman",153605,341,153605,,"PLOSCA",304,"SCOALA MARE PLOSCA",780,543,459,81,3,537,6,865,322,298,239,3,14543,0
36,"Teleorman",153605,341,153605,,"PLOSCA",305,"SCOALA MICA DEAL PLOSCA",1368,906,841,57,8,887,19,1500,594,447,440,3,14543,0
36,"Teleorman",153605,341,153605,,"PLOSCA",306,"CAMINUL CULTURAL PLOSCA",1394,948,867,81,0,934,14,1535,587,466,468,3,14543,0
36,"Teleorman",153605,341,153605,,"PLOSCA",307,"CAMINUL CULTURAL, SALA NR 2, SALA DE CASATORII",0,173,0,173,0,173,0,300,127,86,87,3,14543,1
36,"Teleorman",153696,341,153696,,"POENI",308,"SCOALA GENERALA POENI, SAT POENI,  STRADA G-RAL GH RADULESCU NR 39",1140,692,681,11,0,682,10,1254,562,413,269,3,14545,0
36,"Teleorman",153696,341,153696,,"POENI",309,"SCOALA PRIMARA PREAJBA, SATUL PREAJBA STRADA PRINCIPALA NR 1",337,233,222,11,0,230,3,373,140,112,118,3,14545,0
36,"Teleorman",153696,341,153696,,"POENI",310,"SCOALA GENERALA VATASI, SATUL  VATASI, STRADA ZAVOIULUI NR 4",514,386,373,13,0,381,5,565,179,283,98,3,14545,0
36,"Teleorman",153696,341,153696,,"POENI",311,"SCOALA PRIMARA CATUNU, SATUL CATUNU SOS PITESTI NR 21",390,266,255,11,0,262,4,435,169,128,134,3,14545,0
36,"Teleorman",153696,341,153696,,"POENI",312,"PRIMARIA COMUNEI POENI, SALA DE OFICIERE A CASATORIILOR, STR G RADULESCU",0,207,0,207,0,204,3,302,95,140,64,3,14545,1
36,"Teleorman",151834,341,151834,,"POROSCHIA",313,"SCOALA GENERALA (LOCALUL NOU) POROSCHIA",1488,1042,941,101,0,1031,11,1640,598,472,559,3,14553,0
36,"Teleorman",151834,341,151834,,"POROSCHIA",314,"SCOALA GENERALA (LOCALUL VECHI) POROSCHIA",1511,956,921,35,0,939,17,1670,714,396,543,3,14553,0
36,"Teleorman",151834,341,151834,,"POROSCHIA",315,"SCOALA GENERALA DIN SATUL CALOMFIRESTI",959,685,675,10,0,668,17,1055,370,290,378,3,14553,0
36,"Teleorman",151834,341,151834,,"POROSCHIA",316,"SCOALA GENERALA CU CLASELE I-VIII , SALA DE CLASA NR 6 CLASELE A VII-A",0,686,0,686,0,671,15,800,114,472,199,3,14553,1
36,"Teleorman",155136,341,155136,,"PURANI",317,"SCOALA VECHE CLASELE V -VIII DIN SATUL PURANII DE SUS",1245,841,816,17,8,824,17,1368,527,272,552,3,14556,0
36,"Teleorman",155136,341,155136,,"PURANI",318,"SCOALA GENERALA CU CLASELE I-VIII (LOCAL VECHI), SALA DE CLASA NR 2",0,100,0,100,0,98,2,249,149,41,57,3,14556,1
36,"Teleorman",153829,341,153829,,"PUTINEIU",319,"SCOALA VECHE  DIN SATUL PUTINEIU",1323,980,959,21,0,966,14,1450,470,295,671,3,14559,0
36,"Teleorman",153829,341,153829,,"PUTINEIU",320,"GRADINITA DE COPII BADULEASA",723,488,470,18,0,474,14,800,312,165,309,3,14559,0
36,"Teleorman",153829,341,153829,,"PUTINEIU",321,"SCOALA GENERALA CU CLASELE I-IV, SALA DE CLASA NR 2",0,244,0,244,0,241,3,300,56,92,149,3,14559,1
36,"Teleorman",153865,341,153865,,"RADOIESTI",322,"SCOALA GENERALA CU CLASELE I-VIII  DIN SATUL RADOIESTI DEAL",945,621,583,18,20,620,1,1040,419,279,341,3,14563,0
36,"Teleorman",153865,341,153865,,"RADOIESTI",323,"CAMINUL CULTURALRADOIESTI, SATUL RADOIESTI VALE",596,382,331,20,31,377,5,654,272,110,267,3,14563,0
36,"Teleorman",153865,341,153865,,"RADOIESTI",324,"SCOALA GENERALA CU CLASELE I-IV  DIN SATUL CETATEA",384,254,212,11,31,248,6,425,171,61,187,3,14563,0
36,"Teleorman",153865,341,153865,,"RADOIESTI",325,"CAMINUL CULTURAL, SALA DE SEDINTA, RADOIESTI VALE",0,163,0,163,0,162,1,250,87,82,80,3,14563,1
36,"Teleorman",153909,341,153909,,"RASMIRESTI",326,"SALA MARE A CAMINULUI CULTURAL DIN COMUNA RASMIRESTI",797,600,553,18,29,592,8,880,280,296,296,3,14567,0
36,"Teleorman",153909,341,153909,,"RASMIRESTI",327,"CAMINUL CULTURAL, SALA MICA",0,127,0,127,0,126,1,250,123,59,67,3,14567,1
36,"Teleorman",155145,341,155145,,"SAELELE",328,"SCOALA GENERALA SAELELE",1522,1132,1054,20,58,1108,24,1675,543,258,850,3,14574,0
36,"Teleorman",155145,341,155145,,"SAELELE",329,"SCOALA GENERALA PLEASOV",674,619,562,37,20,609,10,860,241,88,521,3,14574,0
36,"Teleorman",155145,341,155145,,"SAELELE",330,"SCOALA GENERALA CU CLASELE I-VIII, SALA DE MATEMATICA",0,180,0,180,0,180,0,298,118,43,137,3,14574,1
36,"Teleorman",153936,341,153936,,"SALCIA",331,"SCOALA GENERALA CU CLASELE I-VIII DIN SATUL SALCIA",966,553,521,32,0,539,14,1078,525,163,376,3,14577,0
36,"Teleorman",153936,341,153936,,"SALCIA",332,"CAMINUL CULTURAL DIN SATUL BANEASA",806,573,534,37,2,561,12,880,307,155,406,3,14577,0
36,"Teleorman",153936,341,153936,,"SALCIA",333,"CAMINUL CULTURAL DIN SATUL TUDOR VLADIMIRESCU",768,541,503,38,0,535,6,855,314,160,375,3,14577,0
36,"Teleorman",153936,341,153936,,"SALCIA",334,"SCOALA GENERALA ""ZAHARIA STANCU"" SALA NR 2",0,219,0,219,0,217,2,300,81,92,125,3,14577,1
36,"Teleorman",153972,341,153972,,"SACENI",335,"SCOALA GENERALA DIN SATUL  SACENI",677,469,458,11,0,455,14,745,276,173,282,3,14570,0
36,"Teleorman",153972,341,153972,,"SACENI",336,"SCOALA GENERALA DIN SATUL CIURARI",512,339,329,8,2,331,8,565,226,102,229,3,14570,0
36,"Teleorman",153972,341,153972,,"SACENI",337,"SCOALA GENERALA CU CLASELE I-VIII, SALA DE BIOLOGIE",0,109,0,109,0,108,1,250,141,46,62,3,14570,1
36,"Teleorman",154013,341,154013,,"SCRIOASTEA",338,"CAMINUL CULTURAL SCRIOASTEA",1997,1171,1150,21,0,1152,19,2200,1029,356,796,3,14585,0
36,"Teleorman",154013,341,154013,,"SCRIOASTEA",339,"GRADINITA DE COPII SATUL BREBINA",687,447,438,9,0,440,7,745,298,178,262,3,14585,0
36,"Teleorman",154013,341,154013,,"SCRIOASTEA",340,"CAMINUL CULTURAL CUCUIETI",724,563,547,16,0,556,7,796,233,317,239,3,14585,0
36,"Teleorman",154013,341,154013,,"SCRIOASTEA",341,"SCOALA GENERALA CU CLASELE I-VIII ""ANGHEL MANOLACHE"", SALA DE SPORT",0,200,0,200,0,199,1,300,100,67,132,3,14585,1
36,"Teleorman",154068,341,154068,,"SCURTU MARE",342,"SCOALA GENERALA CU CLASELE I-VIII SCURTU",991,689,641,31,17,678,11,1110,421,348,330,3,14590,0
36,"Teleorman",154068,341,154068,,"SCURTU MARE",343,"SCOALA GENERALA  CU CLASELE I-IV DRACESTI",329,221,212,9,0,216,5,350,129,99,117,3,14590,0
36,"Teleorman",154068,341,154068,,"SCURTU MARE",344,"SCOALA GENERALA  CU CLASELE I-IV ALBENI",221,147,139,8,0,145,2,245,98,75,70,3,14590,0
36,"Teleorman",154068,341,154068,,"SCURTU MARE",345,"SCOALA GENERALA CU CLASELE I-VIII, SALA DE CLASA NR 2",0,109,0,109,0,109,0,250,141,47,62,3,14590,1
36,"Teleorman",154139,341,154139,,"SEACA",346,"GRADINITA SEACA, SAT SEACA",1374,744,675,16,53,728,16,1515,771,232,496,3,14597,0
36,"Teleorman",154139,341,154139,,"SEACA",347,"GRADINITA NAVODARI, SAT NAVODARI",801,518,483,9,26,504,14,915,397,170,334,3,14597,0
36,"Teleorman",154139,341,154139,,"SEACA",348,"GRADINITA DE COPII, SALA NR 2",0,121,0,121,0,120,1,250,129,49,71,3,14597,1
36,"Teleorman",154184,341,154184,,"SEGARCEA-VALE",349,"SCOALA GENERALA SEGARCEA VALE DIN SATUL SEGARCEA VALE",940,633,606,27,0,620,13,1030,397,242,378,3,14600,0
36,"Teleorman",154184,341,154184,,"SEGARCEA-VALE",350,"SCOALA GENERALA OLTEANCA DIN SATUL OLTEANCA",792,510,497,13,0,493,17,870,360,166,327,3,14600,0
36,"Teleorman",154184,341,154184,,"SEGARCEA-VALE",351,"SCOALA GENERALA SEGARCEA DEAL DIN SATUL SEGARCEA DEAL",1121,693,676,17,0,676,17,1235,542,227,449,3,14600,0
36,"Teleorman",154184,341,154184,,"SEGARCEA-VALE",352,"SCOALA GENERALA CU CLASELE I-VIII, SALA DE MATEMATICA",0,222,0,222,0,222,0,300,78,97,125,3,14600,1
36,"Teleorman",154166,341,154166,,"SFINTESTI",353,"CAMINUL CULTURAL SFINTESTI",1022,646,615,6,25,644,2,1133,487,338,306,3,14604,0
36,"Teleorman",154166,341,154166,,"SFINTESTI",354,"SCOALA GENERALA CU CLASELE I-VIII, SALA NR 1",0,89,0,89,0,89,0,250,161,48,41,3,14604,1
36,"Teleorman",154228,341,154228,,"SILISTEA",355,"SCOALA  CU CLASELE I-VIII SILISTEA",1158,783,759,24,0,776,7,1229,446,246,530,3,14606,0
36,"Teleorman",154228,341,154228,,"SILISTEA",356,"SCOALA  CU CLASELE I-IV BUTESTI",612,394,385,9,0,388,6,675,281,140,248,3,14606,0
36,"Teleorman",154228,341,154228,,"SILISTEA",357,"SCOALA CU CLASELE I-IV SATUL SILISTEA MICA",297,216,200,16,0,213,3,270,54,164,49,3,14606,0
36,"Teleorman",154228,341,154228,,"SILISTEA",358,"SCOALA GENERALA CU CLASELE I-VIII, SALA NR 3",0,125,0,125,0,125,0,250,125,51,74,3,14606,1
36,"Teleorman",154282,341,154282,,"SILISTEA-GUMESTI",359,"SCOALA VECHE (CENTRUL MEMORIAL M.PREDA) SILISTEA GUMESTI",1236,806,752,54,0,800,6,1360,554,300,500,3,14610,0
36,"Teleorman",154282,341,154282,,"SILISTEA-GUMESTI",360,"SCOALA GENERALA CU CLASELE I-IV MAGURA",995,592,582,10,0,585,7,1092,500,243,342,3,14610,0
36,"Teleorman",154282,341,154282,,"SILISTEA-GUMESTI",361,"CENTRUL MEMORIAL ""MARIN PREDA"", SALA NR 2",0,144,0,144,0,144,0,250,106,59,85,3,14610,1
36,"Teleorman",154308,341,154308,,"SARBENI",362,"SCOALA CU CLASELE I-IV SARBENI, STR SCOLII NR 261",628,389,379,10,0,382,7,694,305,183,199,3,14581,0
36,"Teleorman",154308,341,154308,,"SARBENI",363,"SCOALA CU CLASELE I-VIII SARBENII DE JOS STRADA PRIMARIEI NR 1",235,178,164,14,0,174,4,264,86,73,101,3,14581,0
36,"Teleorman",154308,341,154308,,"SARBENI",364,"SCOALA CU CLASELE I-IV UDENI,STRADA SOSEAUA GRATIEI NR 197",394,296,279,17,0,290,6,437,141,83,207,3,14581,0
36,"Teleorman",154308,341,154308,,"SARBENI",365,"SCOALA GENERALA CU CLASELE I-VIII, SALA NR 1",0,153,0,153,0,152,1,250,97,61,91,3,14581,1
36,"Teleorman",154344,341,154344,,"SLOBOZIA MANDRA",366,"SCOALA  DE ARTE SI MESERII SLOBOZIA MANDRA, LOCAL A",831,637,528,61,48,623,14,915,278,208,415,3,14612,0
36,"Teleorman",154344,341,154344,,"SLOBOZIA MANDRA",367,"SCOALA  DE ARTE SI MESERII SLOBOZIA MANDRA, LOCAL B",856,720,612,74,34,697,23,840,120,261,436,3,14612,0
36,"Teleorman",154344,341,154344,,"SLOBOZIA MANDRA",368,"SCOALA GENERALA CU CLASELE I-VIII,  LOCAL A,SALA DE CHIMIE",0,138,0,138,0,136,2,250,112,50,86,3,14612,1
36,"Teleorman",154380,341,154380,,"SMARDIOASA",369,"SCOALA GENERALA CU CLASELE I-VIII SMARDIOASA",1690,934,909,25,0,904,30,1860,926,347,557,3,14614,0
36,"Teleorman",154380,341,154380,,"SMARDIOASA",370,"SCOALA GENERALA CU CLASELE I-IV SOIMU",396,283,242,41,0,276,7,440,157,136,140,3,14614,0
36,"Teleorman",154380,341,154380,,"SMARDIOASA",371,"SCOALA GENERALA CU CLASELE I-VIII, SALA DE CLASA NR 2",0,142,0,142,0,141,1,251,109,85,56,3,14614,1
36,"Teleorman",154415,341,154415,,"STEJARU",372,"CAMINUL CULTURAL STEJARU",690,506,469,13,24,503,3,760,254,378,125,3,14617,0
36,"Teleorman",154415,341,154415,,"STEJARU",373,"SCOALA CU CLASELE I-IV SOCETU",699,562,520,11,31,553,9,770,208,406,147,3,14617,0
36,"Teleorman",154415,341,154415,,"STEJARU",374,"CLADIREA FOSTEI PRIMARII BRATCOVU",130,121,89,11,21,120,1,150,29,77,43,3,14617,0
36,"Teleorman",154415,341,154415,,"STEJARU",375,"FOSTA SCOALA GENERALA  GRESIA",105,89,79,5,5,88,1,120,31,69,19,3,14617,0
36,"Teleorman",154415,341,154415,,"STEJARU",376,"SCOALA GENERALA CU CLASELE I-VIII, CABINETUL ASISTENTULUI COMUNITAR",0,252,0,252,0,252,0,301,49,164,88,3,14617,1
36,"Teleorman",154460,341,154460,,"SUHAIA",377,"SCOALA CU CLS V-VIII CONSTANTIN BRANCOVEANU (SCOALA NOUA), STRADA SOSEAUA DUNARII, NR 123, COMUNA SUHAIA",1046,734,678,11,45,733,1,1150,416,448,285,3,14625,0
36,"Teleorman",154460,341,154460,,"SUHAIA",378,"SCOALA CU CLASELE I-IV, CONSTANTIN BRANCOVEANU (SCOALA VECHE) STR SOSEAUA DUNARII NR 224, SUHAIA",1173,839,784,6,49,828,11,1290,451,577,251,3,14625,0
36,"Teleorman",154460,341,154460,,"SUHAIA",379,"SCOALA GENERALA CU CLASELE I-IV ""CONSTANTIN BRANCOVEANU"", SALA DE CLASA NR 2, SOSEAUA DUNARII NR 224",0,187,0,187,0,185,2,250,63,131,54,3,14625,1
36,"Teleorman",154497,341,154497,,"STOROBANEASA",380,"SCOALA CU CLASELE I-VIII ""VASILE RACOTTA""  DIN SATUL STOROBANEASA",1523,1006,971,12,23,981,25,1689,683,437,544,3,14622,0
36,"Teleorman",154497,341,154497,,"STOROBANEASA",381,"SCOALA CU CLASELE I-VIII ""BADEA NEGREANU""  DIN SATUL BEIU",1348,831,798,8,25,816,15,1485,654,318,498,3,14622,0
36,"Teleorman",154497,341,154497,,"STOROBANEASA",382,"SCOALA GENERALA CU CLASELE I-VIII, ""BADEA NEGREANU"", SALA ATELIERULUI SCOLAR, STR SCOLII NR 1, BEIU",0,166,0,166,0,166,0,250,84,84,82,3,14622,1
36,"Teleorman",154521,341,154521,,"TALPA",383,"SCOALA GENERALA  TALPA OGRAZILE",932,714,630,22,62,703,11,1025,311,156,547,3,14627,0
36,"Teleorman",154521,341,154521,,"TALPA",384,"SCOALA GENERALA  TALPA BISCOVENI",774,642,535,48,59,627,15,850,208,200,427,3,14627,0
36,"Teleorman",154521,341,154521,,"TALPA",385,"CAMINUL CULTURAL, SALA MARE, STR 22 DECEMBRIE 1989, NR 588, TALPA",0,243,0,243,0,241,2,300,57,81,160,3,14627,1
36,"Teleorman",154585,341,154585,,"TATARASTII DE JOS",386,"CAMINUL CULTURAL TATARASTII DE JOS",1352,947,909,38,0,937,10,1493,546,280,657,3,14633,0
36,"Teleorman",154585,341,154585,,"TATARASTII DE JOS",387,"SCOALA GENERALA CU CLASELE I-VIII SLAVESTI",909,477,463,14,0,470,7,1000,523,128,342,3,14633,0
36,"Teleorman",154585,341,154585,,"TATARASTII DE JOS",388,"SCOALA CU CLASELE I-IV NEGRENI",899,409,391,18,0,395,14,980,571,148,247,3,14633,0
36,"Teleorman",154585,341,154585,,"TATARASTII DE JOS",389,"CAMINUL CULTURAL, SALA NR 2, TATARASTII DE JOS",0,176,0,176,0,175,1,251,75,76,99,3,14633,1
36,"Teleorman",154665,341,154665,,"TATARASTII DE SUS",390,"SCOALA CU CLASELE I-IV TATARASTII DE SUS",1159,645,589,56,0,629,16,1275,630,271,358,3,14641,0
36,"Teleorman",154665,341,154665,,"TATARASTII DE SUS",391,"SCOALA CU CLASELE I-IV UDUPU",1229,759,710,49,0,741,18,1364,605,308,433,3,14641,0
36,"Teleorman",154665,341,154665,,"TATARASTII DE SUS",392,"SCOALA GENERALA CU CLASELE I-IV, SALA  NR 2, TATARASTII DE SUS",0,200,0,200,0,200,0,250,50,73,127,3,14641,1
36,"Teleorman",154736,341,154736,,"TRAIAN",393,"FOSTA GRADINITA TRAIAN",820,549,534,15,0,543,6,905,356,160,383,3,14647,0
36,"Teleorman",154736,341,154736,,"TRAIAN",394,"SCOALA CU CLASELE I-VIII  TRAIAN",917,561,540,21,0,553,8,1000,439,171,382,3,14647,0
36,"Teleorman",154736,341,154736,,"TRAIAN",395,"SCOALA GENERALA CU CLASELE I-VIII, SALA DE CLASA NR 2, TRAIAN",0,116,0,116,0,115,1,248,132,38,77,3,14647,1
36,"Teleorman",154754,341,154754,,"TRIVALEA-MOSTENI",396,"SCOALA GENERALA CU CLASELE I-VIII TRIVALEA MOSTENI",859,533,507,26,0,526,7,945,412,266,260,3,14649,0
36,"Teleorman",154754,341,154754,,"TRIVALEA-MOSTENI",397,"SCOALA GENERALA  BRATASANI",589,344,336,8,0,331,13,650,306,127,204,3,14649,0
36,"Teleorman",154754,341,154754,,"TRIVALEA-MOSTENI",398,"SCOALA GENERALA ALEXANDRU DEPARATEANU DEPARATI",1005,541,535,6,0,527,14,1100,559,229,298,3,14649,0
36,"Teleorman",154754,341,154754,,"TRIVALEA-MOSTENI",399,"SCOALA GENERALA CU CLASELE I-VIII, SALA DE CLASA NR 1, TRIVALEA-MOSTENI",0,180,0,180,0,179,1,301,121,100,79,3,14649,1
36,"Teleorman",154790,341,154790,,"TROIANUL",400,"SCOALA GENERALA CU CLASELE I-VIII  DE PE STRADA PRINCIPALA, TROIANUL",1462,977,945,32,0,960,17,1600,623,348,612,3,14653,0
36,"Teleorman",154790,341,154790,,"TROIANUL",401,"SCOALA GENERALA NR 2  DE PE STRADA BISERICII DIN COMUNA TROIANUL",971,637,619,18,0,616,21,1070,433,311,305,3,14653,0
36,"Teleorman",154790,341,154790,,"TROIANUL",402,"SCOALA GENERALA DIN SATUL VATRA",191,132,119,13,0,130,2,215,83,54,76,3,14653,0
36,"Teleorman",154790,341,154790,,"TROIANUL",403,"FOSTUL CAMIN CULTURAL DIN SATUL DULCENI",80,64,49,15,0,63,1,100,36,10,53,3,14653,0
36,"Teleorman",154790,341,154790,,"TROIANUL",404,"SCOALA GENERALA CU CLASELE I-VIII ""ION PREOTU"", SALA  NR 2, TROIANUL",0,145,0,145,0,145,0,250,105,76,69,3,14653,1
36,"Teleorman",154834,341,154834,,"TIGANESTI",405,"SCOALA CU CLASELE I-IV DIN COMUNA TIGANESTI",1562,988,916,32,40,982,6,1720,732,230,752,3,14645,0
36,"Teleorman",154834,341,154834,,"TIGANESTI",406,"GRADINITA DE COPII DE LANGA PRIMARIA TIGANESTI",1480,1004,923,45,36,992,12,1630,626,315,677,3,14645,0
36,"Teleorman",154834,341,154834,,"TIGANESTI",407,"SCOALA CU CLASELE I-VIII  I GH DUCA TIGANESTI",1607,1108,1017,47,44,1096,12,1770,662,341,755,3,14645,0
36,"Teleorman",154834,341,154834,,"TIGANESTI",408,"CAMINUL CULTURAL,  SALA DE SEDINTE A CONSILIULUI LOCAL, TIGANESTI",0,227,0,227,0,226,1,300,73,75,151,3,14645,1
36,"Teleorman",155154,341,155154,,"UDA-CLOCOCIOV",409,"SCOALA CU CLASELE I-VIII UDA PACIUREA",790,528,459,14,55,518,10,870,342,154,364,3,14657,0
36,"Teleorman",155154,341,155154,,"UDA-CLOCOCIOV",410,"CAMINUL CULTURAL UDA CLOCOCIOV",793,567,464,8,95,550,17,870,303,166,384,3,14657,0
36,"Teleorman",155154,341,155154,,"UDA-CLOCOCIOV",411,"CAMINUL CULTURAL, SALA MARE, STR CLOCOCIOV, UDA-CLOCOCIOV",0,125,0,125,0,125,0,250,125,48,77,3,14657,1
36,"Teleorman",154852,341,154852,,"VEDEA",412,"SCOALA CU CLASELE I-VIII DIN SATUL VEDEA",561,509,492,8,9,501,8,620,111,269,232,3,14664,0
36,"Teleorman",154852,341,154852,,"VEDEA",413,"SCOALA CU CLASELE I-IV  ALBESTI, DIN SATUL ALBESTI",590,559,540,8,11,555,4,650,91,399,156,3,14664,0
36,"Teleorman",154852,341,154852,,"VEDEA",414,"SCOALA CU CLASELE I-IV COSOTENI DIN SATUL COSOTENI",472,300,293,3,4,294,6,518,218,152,142,3,14664,0
36,"Teleorman",154852,341,154852,,"VEDEA",415,"SCOALA CU CLASELE I-VIII DULCEANCA DIN SATUL DULCEANCA",488,470,444,17,9,467,3,540,70,304,163,3,14664,0
36,"Teleorman",154852,341,154852,,"VEDEA",416,"SCOALA CU CLASELE I-IV MERI DIN SATUL MERI",408,373,359,5,9,370,3,449,76,209,161,3,14664,0
36,"Teleorman",154852,341,154852,,"VEDEA",417,"SCOALA GENERALA CU CLASELE I-VIII, VEDEA",0,47,0,47,0,46,1,250,203,27,19,3,14664,1
36,"Teleorman",154914,341,154914,,"VIISOARA",418,"SCOALA CU CLASELE I-VIII  DIN SATUL VIISOARA",894,620,587,5,28,613,7,990,370,288,325,3,14670,0
36,"Teleorman",154914,341,154914,,"VIISOARA",419,"GRADINITA DE COPII DIN SATUL VIISOARA",773,569,537,7,25,559,10,855,286,301,258,3,14670,0
36,"Teleorman",154914,341,154914,,"VIISOARA",420,"CAMINUL CULTURAL, SALA MICA, STR PRINCIPALA NR 128, VIISOARA",0,183,0,183,0,183,0,250,67,90,93,3,14670,1
36,"Teleorman",153776,341,153776,,"VITANESTI",421,"SCOALA GENERALA CU CLASELE I-IV DIN SATUL PURANI, COMUNA VITANESTI, SALA NR 1",608,434,388,14,32,427,7,660,226,125,302,3,14672,0
36,"Teleorman",153776,341,153776,,"VITANESTI",422,"SCOALA GENERALA  DIN SATUL SILISTEA SALA NR 1",832,613,542,17,54,601,12,925,312,132,469,3,14672,0
36,"Teleorman",153776,341,153776,,"VITANESTI",423,"SCOALA  CU CLASELE I-IV  DIN SATUL VITANESTI SALA NR 1",974,700,621,17,62,690,10,1090,390,182,508,3,14672,0
36,"Teleorman",153776,341,153776,,"VITANESTI",424,"SCOALA GENERALA CU CLASELE I-IV, SALA NR 2, SATUL PURANI STR PRINCIPALA",0,263,0,263,0,263,0,300,37,86,177,3,14672,1
36,"Teleorman",154932,341,154932,,"VARTOAPE",425,"CAMIN CULTURAL DIN SATUL VARTOAPE DE SUS",959,719,682,30,7,704,15,1055,336,273,431,3,14660,0
36,"Teleorman",154932,341,154932,,"VARTOAPE",426,"CAMINUL SCOALII CU CLASELE I-VIII VARTOAPE DE JOS",843,671,633,38,0,655,16,930,259,199,456,3,14660,0
36,"Teleorman",154932,341,154932,,"VARTOAPE",427,"SCOALA GENERALA CU CLASELE I-IV SAT GARAGAU, COMUNA VARTOAPE",624,468,440,28,0,457,11,685,217,118,339,3,14660,0
36,"Teleorman",154932,341,154932,,"VARTOAPE",428,"CAMINUL CULTURAL, SALA NR 2, VARTOAPE DE SUS",0,320,0,320,0,313,7,400,80,150,163,3,14660,1
36,"Teleorman",154978,341,154978,,"ZAMBREASCA",429,"CAMINUL CULTURAL DIN COMUNA ZAMBREASCA",932,631,575,8,48,618,13,1025,394,187,431,3,14677,0
36,"Teleorman",154978,341,154978,,"ZAMBREASCA",430,"SCOALA CU CLASELE I-IV DIN COMUNA ZAMBREASCA",492,353,324,7,22,349,4,540,187,71,278,3,14677,0
36,"Teleorman",154978,341,154978,,"ZAMBREASCA",431,"CAMINUL CULTURAL, SALA MICA, ZAMBREASCA",0,84,0,84,0,83,1,250,166,27,56,3,14677,1
37,"Timis",155243,350,155243,,"MUNICIPIUL TIMISOARA",1,"UNIVERSITATEA DE MEDICINA,PIATA E.MURGU NR.2",1168,609,597,11,1,594,15,1400,791,241,353,1,14680,0
37,"Timis",155243,350,155243,,"MUNICIPIUL TIMISOARA",2,"UNIVERSITATEA DE MEDICINA,PIATA E.MURGU  NR.2",1282,611,597,13,1,602,9,1400,789,273,329,1,14680,0
37,"Timis",155243,350,155243,,"MUNICIPIUL TIMISOARA",3,"LICEUL PEDAGOGIC ""CARMEN SYLVA"" B-DUL. C.D. LOGA NR.45",832,437,417,17,3,431,6,900,463,161,270,1,14680,0
37,"Timis",155243,350,155243,,"MUNICIPIUL TIMISOARA",4,"GRUP SCOLAR INDUSTRIAL ""EMANOIL UNGUREANU"" PIATA IANCU HUNIADE NR. 3",757,415,397,18,0,413,2,800,385,176,237,1,14680,0
37,"Timis",155243,350,155243,,"MUNICIPIUL TIMISOARA",5,"LICEUL TEORETIC ""NIKOLAUS LENAU"", STR. GH. LAZAR NR.2",899,469,461,8,0,465,4,1000,531,225,240,1,14680,0
37,"Timis",155243,350,155243,,"MUNICIPIUL TIMISOARA",6,"LICEUL TEORETIC""NIKOLAUS LENAU"", STR. GHEORGHE LAZAR NR.2",822,417,394,22,1,410,7,900,483,167,243,1,14680,0
37,"Timis",155243,350,155243,,"MUNICIPIUL TIMISOARA",7,"LICEUL TEORETIC ""NIKOLAUS LENAU"", STR. GHEORGHE LAZAR NR.2",1024,486,470,16,0,476,10,1100,614,269,207,1,14680,0
37,"Timis",155243,350,155243,,"MUNICIPIUL TIMISOARA",8,"COLEGIUL TEHNIC ""HENRY COANDA"", STR. CORIOLAN BREDICEANU NR.37",989,476,460,14,2,466,10,1100,624,230,236,1,14680,0
37,"Timis",155243,350,155243,,"MUNICIPIUL TIMISOARA",9,"COLEGIUL TEHNIC ""HENRY COANDA"", STR. CORIOLAN BREDICEANU NR. 37",1404,751,738,13,0,741,10,1500,749,367,374,1,14680,0
37,"Timis",155243,350,155243,,"MUNICIPIUL TIMISOARA",10,"LICEUL TEOLOGIC ROMANO-CATOLIC ""GERHARDINUM"" 'PIATA REGINA MARIA NR.1",967,559,546,13,0,551,8,1100,541,250,301,1,14680,0
37,"Timis",155243,350,155243,,"MUNICIPIUL TIMISOARA",11,"COLEGIUL TEHNIC ""ION MINCU"", STR. GHEORGHE LAZAR NR.20",769,435,419,13,3,432,3,900,465,189,243,1,14680,0
37,"Timis",155243,350,155243,,"MUNICIPIUL TIMISOARA",12,"INSPECTORATUL JUDETEAN AL POLITIEI DE FRONTIERA (FOST UM 0301 GRANICERI), CALEA SEVER BOCU  NR.11-13",1336,556,542,14,0,552,4,1400,844,363,189,1,14680,0
37,"Timis",155243,350,155243,,"MUNICIPIUL TIMISOARA",13,"INSPECTORATUL JUDETEAN AL POLITIEI DE FRONTIERA (FOST UM 0301 GRANICERI) , CALEA SEVER BOCU NR.11-13",1463,768,733,33,2,766,2,1500,732,433,333,1,14680,0
37,"Timis",155243,350,155243,,"MUNICIPIUL TIMISOARA",14,"FUNDATIA ION SLAVICI , STR. LIREI NR.4",1306,674,665,9,0,671,3,1400,726,454,217,1,14680,0
37,"Timis",155243,350,155243,,"MUNICIPIUL TIMISOARA",15,"FUNDATIA ION SLAVICI, STR. LIREI NR.4",1511,748,731,17,0,742,6,1600,852,429,313,1,14680,0
37,"Timis",155243,350,155243,,"MUNICIPIUL TIMISOARA",16,"GRADINITA NR.37, CALEA ARADULUI NR. 38 BLOC 21",1773,908,880,28,0,902,6,1800,892,454,448,1,14680,0
37,"Timis",155243,350,155243,,"MUNICIPIUL TIMISOARA",17,"GRADINITA NR.37, CALEA ARADULUI NR.38 BLOC21",1667,867,856,11,0,857,10,1800,933,437,420,1,14680,0
37,"Timis",155243,350,155243,,"MUNICIPIUL TIMISOARA",18,"GRUP SCOLAR AGRICOL ""IULIAN DRACEA"" CALEA ARADULUI NR.56",1438,777,754,23,0,765,12,1500,723,428,337,1,14680,0
37,"Timis",155243,350,155243,,"MUNICIPIUL TIMISOARA",19,"GRUPUL SCOLAR AGRICOL ""IULIAN DRACEA"" CALEA ARADULUI NR.56",1520,752,728,24,0,740,12,1600,848,429,311,1,14680,0
37,"Timis",155243,350,155243,,"MUNICIPIUL TIMISOARA",20,"GRUPUL SCOLAR AGRICOL ""IULIAN DRACEA"" CALEA ARADULUI NR.56",1751,821,792,29,0,815,6,1700,879,466,349,1,14680,0
37,"Timis",155243,350,155243,,"MUNICIPIUL TIMISOARA",21,"GRUPUL SCOLAR AGRICOL ""IULIAN DRACEA""'CALEA ARADULUI NR.56",1749,861,849,12,0,850,11,1801,940,454,396,1,14680,0
37,"Timis",155243,350,155243,,"MUNICIPIUL TIMISOARA",22,"GRUPUL SCOLAR AGRICOL ""IULIAN DRACEA"" CALEA ARADULUI 56",1586,819,801,17,1,809,10,1600,781,484,325,1,14680,0
37,"Timis",155243,350,155243,,"MUNICIPIUL TIMISOARA",23,"GRADINITA CU PROGRAM PRELUNGIT NR. 27, STR. BRANDUSEI NR. 15",1464,766,738,28,0,754,12,1600,834,400,354,1,14680,0
37,"Timis",155243,350,155243,,"MUNICIPIUL TIMISOARA",24,"GRADINITA CU PROGRAM PRELUNGIT NR. 27, STR. BRANDUSEI NR. 15",1410,798,780,17,1,788,10,1500,702,418,370,1,14680,0
37,"Timis",155243,350,155243,,"MUNICIPIUL TIMISOARA",25,"SCOALA GENERALA  CU CLASELE I-IV NR. 19 PIATA AVRAM IANCU NR.5",1315,688,678,10,0,675,13,1400,712,359,316,1,14680,0
37,"Timis",155243,350,155243,,"MUNICIPIUL TIMISOARA",26,"SCOALA GENERALA CU CLASELE I-IV NR. 19 PIATA AVRAM IANCU NR. 5",1513,753,731,22,0,743,10,1600,847,398,345,1,14680,0
37,"Timis",155243,350,155243,,"MUNICIPIUL TIMISOARA",27,"SCOALA GENERALA NR. 24 STR. BRANDUSEI NR.7",1488,790,771,19,0,774,16,1600,810,355,419,1,14680,0
37,"Timis",155243,350,155243,,"MUNICIPIUL TIMISOARA",28,"SCOALA GENERALA NR. 24 STR. BRANDUSEI NR.7",1522,795,785,10,0,783,12,1600,805,409,374,1,14680,0
37,"Timis",155243,350,155243,,"MUNICIPIUL TIMISOARA",29,"SCOALA GENERALA NR. 24 STR. BRANDUSEI NR.7",909,454,440,14,0,449,5,1003,549,226,223,1,14680,0
37,"Timis",155243,350,155243,,"MUNICIPIUL TIMISOARA",30,"SCOALA GENERALA NR. 24 STR. BRANDUSEI NR.7",1030,619,576,43,0,615,4,1100,481,310,305,1,14680,0
37,"Timis",155243,350,155243,,"MUNICIPIUL TIMISOARA",31,"SCOALA GENERALA NR.26,STR. ULMULUI NR.2",1130,533,520,13,0,526,7,1200,667,285,241,1,14680,0
37,"Timis",155243,350,155243,,"MUNICIPIUL TIMISOARA",32,"SCOALA GENERALA NR. 26 STR. ULMULUI NR.2",1249,661,648,13,0,652,9,1300,639,322,330,1,14680,0
37,"Timis",155243,350,155243,,"MUNICIPIUL TIMISOARA",33,"SCOALA GENERALA NR.26 STR. ULMULUI NR. 2",1185,539,518,21,0,527,12,1297,758,282,245,1,14680,0
37,"Timis",155243,350,155243,,"MUNICIPIUL TIMISOARA",34,"SCOALA GENERALA NR. 26 STR. ULMULUI NR. 2",1524,842,824,18,0,826,16,1600,758,427,399,1,14680,0
37,"Timis",155243,350,155243,,"MUNICIPIUL TIMISOARA",35,"SCOALA GENERALA NR. 18 STR. AMFOREI NR.6",837,468,428,40,0,461,7,900,432,205,256,1,14680,0
37,"Timis",155243,350,155243,,"MUNICIPIUL TIMISOARA",36,"SCOALA GENERALA NR.18 STR. AMFOREI NR.6",1686,870,838,32,0,860,10,1800,930,425,435,1,14680,0
37,"Timis",155243,350,155243,,"MUNICIPIUL TIMISOARA",37,"SCOALA GENERALA NR. 18 STR. AMFOREI NR.6",1025,519,508,11,0,511,8,1100,581,247,264,1,14680,0
37,"Timis",155243,350,155243,,"MUNICIPIUL TIMISOARA",38,"CLUBUL SPORTIV SCOLAR NR.1 STR. AMFOREI NR.4",1010,585,563,22,0,579,6,1100,515,302,277,1,14680,0
37,"Timis",155243,350,155243,,"MUNICIPIUL TIMISOARA",39,"GRADINITA NR. 36 STR. TEIULUI NR. 5",1441,754,739,15,0,733,21,1500,746,399,334,1,14680,0
37,"Timis",155243,350,155243,,"MUNICIPIUL TIMISOARA",40,"SCOALA CU CLASELE I-VIII NR. 19 ""AVRAM IANCU"" B-DUL CETATII NR. 24",1084,643,585,58,0,637,6,1200,557,288,349,1,14680,0
37,"Timis",155243,350,155243,,"MUNICIPIUL TIMISOARA",41,"SCOALA CU CLASELE I-VIII NR. 19 ""AVRAM IANCU"" B-DUL CETATII NR. 24",1381,791,774,16,1,780,11,1500,709,395,385,1,14680,0
37,"Timis",155243,350,155243,,"MUNICIPIUL TIMISOARA",42,"SCOALA CU CLASELE I-VIII NR. 19 ""AVRAM IANCU"" 'B-DUL CETATII NR. 24",1403,788,775,13,0,773,15,1500,712,362,411,1,14680,0
37,"Timis",155243,350,155243,,"MUNICIPIUL TIMISOARA",43,"SCOALA GENERALA CU CLASELE I-VIII NR. 19 ""AVRAM IANCU"", B-DUL CETATII NR.24",1503,780,768,12,0,768,12,1600,820,470,298,1,14680,0
37,"Timis",155243,350,155243,,"MUNICIPIUL TIMISOARA",44,"CASIERIA DIRECTIEI PATRIMONIU ,STR. AMFOREI  NR.6",1332,660,643,17,0,651,9,1400,740,361,290,1,14680,0
37,"Timis",155243,350,155243,,"MUNICIPIUL TIMISOARA",45,"GRADINITA CU PROGRAM PRELUNGIT NR. 26 STR. TEIULUI NR.3",862,514,502,12,0,509,5,1000,486,238,271,1,14680,0
37,"Timis",155243,350,155243,,"MUNICIPIUL TIMISOARA",46,"GRADINITA CU PROGRAM PRELUNGIT NR. 26 STR. TEIULUI NR.3",1232,635,614,21,0,632,3,1300,665,326,306,1,14680,0
37,"Timis",155243,350,155243,,"MUNICIPIUL TIMISOARA",47,"GRADINITA CU PROGRAM PRELUNGIT NR.26 STR. TEIULUI NR. 3",948,480,471,9,0,476,4,1000,520,233,243,1,14680,0
37,"Timis",155243,350,155243,,"MUNICIPIUL TIMISOARA",48,"GRADINITA CU PROGRAM PRELUNGIT NR.9 ""CARLA PELZ, STR. CRISAN 21-23",1958,1024,1013,11,0,1013,11,2100,1076,567,446,1,14680,0
37,"Timis",155243,350,155243,,"MUNICIPIUL TIMISOARA",49,"GRADINITA CU PROGRAM PRELUNGIT NR.9 ""CARLA PELZ"", STR. CRISAN 21-23",1825,1037,987,50,0,1023,14,1900,863,553,470,1,14680,0
37,"Timis",155243,350,155243,,"MUNICIPIUL TIMISOARA",50,"BIROUL  LOCUINTE NORD -SERVICIUL PUBLIC DE ADMINISTRARE LOCUINTE SI UTILITATI, STR. OITUZ NR.1",987,512,504,8,0,505,7,1100,588,251,254,1,14680,0
37,"Timis",155243,350,155243,,"MUNICIPIUL TIMISOARA",51,"GRUP SCOLAR DE INDUSTRIE ALIMENTARA CALEA BOGDANESTILOR NR.32 A",1616,936,915,21,0,927,9,1700,764,541,386,1,14680,0
37,"Timis",155243,350,155243,,"MUNICIPIUL TIMISOARA",52,"GRUP SCOLAR DE INDUSTRIE ALIMENTARA CALEA BOGDANESTILOR NR.32 A",1131,619,605,14,0,604,15,1200,581,348,256,1,14680,0
37,"Timis",155243,350,155243,,"MUNICIPIUL TIMISOARA",53,"GRUP SCOLAR DE ARTE SI MESERII ""SPIRU HARET"", CALEA BOGDANESTILOR NR.32.A",1177,612,590,22,0,605,7,1300,688,344,261,1,14680,0
37,"Timis",155243,350,155243,,"MUNICIPIUL TIMISOARA",54,"GRUP SCOLAR DE ARTE SI MESERII ""SPIRU HARET"" CALEA BOGDANESTILOR NR.32A",1252,690,674,16,0,684,6,1300,610,371,313,1,14680,0
37,"Timis",155243,350,155243,,"MUNICIPIUL TIMISOARA",55,"SCOALA CU CLASELE I-IV NR.11,STR. RAZBOIENI NR. 2",1542,804,785,19,0,792,12,1600,796,514,278,1,14680,0
37,"Timis",155243,350,155243,,"MUNICIPIUL TIMISOARA",56,"SCOALA CU CLASELE I-IV NR. 11, STR. RAZBOIENI NR.2",1668,846,829,17,0,834,12,1800,954,507,327,1,14680,0
37,"Timis",155243,350,155243,,"MUNICIPIUL TIMISOARA",57,"SCOALA CU CLASELE I-IV NR. 11,STR. RAZBOIENI NR.2",1544,814,802,12,0,812,2,1600,786,507,305,1,14680,0
37,"Timis",155243,350,155243,,"MUNICIPIUL TIMISOARA",58,"SCOALA CU CLASELE I-IV  NR.19, STR. APRODUL MOVILA NR.10",1816,810,798,12,0,802,8,1900,1090,464,338,1,14680,0
37,"Timis",155243,350,155243,,"MUNICIPIUL TIMISOARA",59,"SCOALA CU CLASELE I-IV NR. 19, STR. APRODUL MOVILA NR.10",1772,916,900,16,0,902,14,1800,884,510,392,1,14680,0
37,"Timis",155243,350,155243,,"MUNICIPIUL TIMISOARA",60,"SCOALA CU CLASELE I-IV NR.19, STR. APRODUL MOVILA NR.10",1784,824,812,12,0,817,7,1900,1076,503,314,1,14680,0
37,"Timis",155243,350,155243,,"MUNICIPIUL TIMISOARA",61,"INSPECTORATUL TERITORIAL DE MUNCA TIMIS, SPL. N. TITULESCU NR.12",1345,632,616,15,1,624,8,1400,768,370,254,1,14680,0
37,"Timis",155243,350,155243,,"MUNICIPIUL TIMISOARA",62,"ADMINISTRAREA DOMENIULUI PUBLIC, SPL. N. TITULESCU NR.10",1330,696,676,20,0,685,11,1400,704,368,317,1,14680,0
37,"Timis",155243,350,155243,,"MUNICIPIUL TIMISOARA",63,"ADMINISTRAREA DOMENIULUI PUBLIC, SPL. N. TITULESCU NR.10",1576,682,667,13,2,680,2,1700,1018,471,209,1,14680,0
37,"Timis",155243,350,155243,,"MUNICIPIUL TIMISOARA",64,"COLEGIUL TEHNIC DE VEST, BDUL. TINERETII NR. 11",1349,634,621,13,0,628,6,1400,766,322,306,1,14680,0
37,"Timis",155243,350,155243,,"MUNICIPIUL TIMISOARA",65,"COLEGIUL TEHNIC DE VEST,BDUL. TINERETII NR. 11",1124,500,493,7,0,494,6,1200,700,274,220,1,14680,0
37,"Timis",155243,350,155243,,"MUNICIPIUL TIMISOARA",66,"COLEGIUL TEHNIC DE VEST, BDUL TINERETII NR.11",1207,533,525,8,0,529,4,1300,767,323,206,1,14680,0
37,"Timis",155243,350,155243,,"MUNICIPIUL TIMISOARA",67,"SCOALA CU CLASELE I-VIII NR.12, B-DUL REGELE CAROL I NR. 17",1013,505,497,8,0,496,9,1100,595,278,218,1,14680,0
37,"Timis",155243,350,155243,,"MUNICIPIUL TIMISOARA",68,"SCOALA CU CLASELE I-VIII NR.12, B-DUL REGELE CAROL I NR.17",1366,609,594,15,0,601,8,1500,891,360,241,1,14680,0
37,"Timis",155243,350,155243,,"MUNICIPIUL TIMISOARA",69,"COLEGIUL ECONOMIC  ""F.S.NITTI"" 'STR. CORBULUI NR. 7",1375,594,584,9,1,589,5,1500,906,329,260,1,14680,0
37,"Timis",155243,350,155243,,"MUNICIPIUL TIMISOARA",70,"COLEGIUL ECONOMIC ""F.S.NITTI"",STR. CORBULUI NR. 7",1340,652,629,23,0,643,9,1400,748,381,262,1,14680,0
37,"Timis",155243,350,155243,,"MUNICIPIUL TIMISOARA",71,"COLEGIUL ECONOMIC ""F.S.NITTI"",STR. CORBULUI NR. 7",1312,677,658,19,0,671,6,1300,623,347,324,1,14680,0
37,"Timis",155243,350,155243,,"MUNICIPIUL TIMISOARA",72,"COLEGIUL ECONOMIC ""F.S. NITTI"",STR. CORBULUI NR. 7",1345,629,612,17,0,624,5,1400,771,311,313,1,14680,0
37,"Timis",155243,350,155243,,"MUNICIPIUL TIMISOARA",73,"SCOALA CU CLASEL I-VIII  NR.22 , P-TA N. BALCESCU NR.2",1071,533,518,14,1,523,10,1200,667,241,282,1,14680,0
37,"Timis",155243,350,155243,,"MUNICIPIUL TIMISOARA",74,"SCOALA CU CLASELE I-VIII NR.22, P-TA N. BALCESCU NR.2",1118,561,545,16,0,548,13,1200,639,295,253,1,14680,0
37,"Timis",155243,350,155243,,"MUNICIPIUL TIMISOARA",75,"SCOALA CU CLASELE I-VIII NR.22, P-TA N. BALCESCU NR.2",1074,543,533,10,0,537,6,1198,655,268,269,1,14680,0
37,"Timis",155243,350,155243,,"MUNICIPIUL TIMISOARA",76,"SCOALA CU CLASELE I-VIII NR.22, P-TA N. BALCESCU NR.2",1080,569,548,20,1,562,7,1198,629,310,252,1,14680,0
37,"Timis",155243,350,155243,,"MUNICIPIUL TIMISOARA",77,"LICEUL  ""GRIGORE MOISIL"" STR. GHIRLANDEI NR.4",1124,568,558,10,0,563,5,1191,623,312,251,1,14680,0
37,"Timis",155243,350,155243,,"MUNICIPIUL TIMISOARA",78,"LICEUL  ""GRIGORE MOISIL"" STR. GHIRLANDEI NR. 4",1112,598,587,11,0,585,13,1203,605,244,341,1,14680,0
37,"Timis",155243,350,155243,,"MUNICIPIUL TIMISOARA",79,"SCOALA GENERALA NR. 9 B-DUL LIVIU REBREANU NR. 35",1391,741,715,26,0,728,13,1500,759,377,351,1,14680,0
37,"Timis",155243,350,155243,,"MUNICIPIUL TIMISOARA",80,"SCOALA GENERALA NR. 9, B-DUL LIVIU REBREANU NR.35",1497,689,665,24,0,681,8,1600,911,421,260,1,14680,0
37,"Timis",155243,350,155243,,"MUNICIPIUL TIMISOARA",81,"SCOALA GENERALA NR. 9 B-DUL LIVIU REBREANU NR. 35",1325,702,690,12,0,683,19,1400,698,369,314,1,14680,0
37,"Timis",155243,350,155243,,"MUNICIPIUL TIMISOARA",82,"SCOALA GENERALA  NR. 9, B-DUL LIVIU REBREANU NR. 35",1285,582,564,18,0,578,4,1400,818,289,289,1,14680,0
37,"Timis",155243,350,155243,,"MUNICIPIUL TIMISOARA",83,"GRADINITA CU PROGRAM PRELUNGIT NR. 3, STR. N. LEONARD NR. 13",1079,542,525,17,0,527,15,1200,658,284,243,1,14680,0
37,"Timis",155243,350,155243,,"MUNICIPIUL TIMISOARA",84,"GRADINITA CU PROGRAM PRELUNGIT NR. 3, STR. N. LEONARD NR. 13",1593,777,764,13,0,761,16,1700,923,436,325,1,14680,0
37,"Timis",155243,350,155243,,"MUNICIPIUL TIMISOARA",85,"SCOALA CU CLASELE I-VIII NR. 27, STR. GORNISTILOR NR.3",1643,813,801,12,0,799,14,1700,887,467,332,1,14680,0
37,"Timis",155243,350,155243,,"MUNICIPIUL TIMISOARA",86,"SCOAL CU CLASELE I-VIII NR.27, STR. GORNISTILOR NR.3",1633,790,772,14,4,781,9,1700,910,492,289,1,14680,0
37,"Timis",155243,350,155243,,"MUNICIPIUL TIMISOARA",87,"SCOALA CU CLASELE I-VIII NR. 27 , STR. GORNISTILOR NR.3",1781,921,909,11,1,910,11,1900,979,545,365,1,14680,0
37,"Timis",155243,350,155243,,"MUNICIPIUL TIMISOARA",88,"SCOALA CU CLASELE I-VIII NR. 27, STR. GORNISTILOR NR.3",1689,831,816,15,0,822,9,1800,969,473,349,1,14680,0
37,"Timis",155243,350,155243,,"MUNICIPIUL TIMISOARA",89,"SCOALA CU CLASELE I-VIII NR. 6 , STR. VULTURILOR NR. 89",1229,593,578,15,0,586,7,1300,707,330,256,1,14680,0
37,"Timis",155243,350,155243,,"MUNICIPIUL TIMISOARA",90,"SCOALA CU CLASELE I-VIII NR. 6,STR.VULTURILOR NR. 89",1302,673,665,8,0,659,14,1400,727,383,276,1,14680,0
37,"Timis",155243,350,155243,,"MUNICIPIUL TIMISOARA",91,"SCOALA CU CLASELE I-VIII NR. 6,STR. VULTURILOR NR. 89",1550,709,697,12,0,700,9,1400,691,392,308,1,14680,0
37,"Timis",155243,350,155243,,"MUNICIPIUL TIMISOARA",92,"SCOALA CU CLASELE I-VIII NR. 6 , STR. VULTURILOR NR.89",1563,731,716,15,0,720,11,1700,969,440,280,1,14680,0
37,"Timis",155243,350,155243,,"MUNICIPIUL TIMISOARA",93,"GRUP SCOLAR INDUSTRIAL TRANSPORTURI AUTO STR. ARDEALULUI NR. 1",1533,763,741,21,1,755,8,1600,837,500,255,1,14680,0
37,"Timis",155243,350,155243,,"MUNICIPIUL TIMISOARA",94,"GRUP SCOLAR INDUSTRIAL TRANSPORTURI AUTO STR. ARDEALULUI NR.1",1338,677,664,12,1,674,3,1400,723,418,256,1,14680,0
37,"Timis",155243,350,155243,,"MUNICIPIUL TIMISOARA",95,"GRUP SCOLAR INDUSTRIAL TRANSPORTURI AUTO, STR. ARDEALULUI NR. 1",1815,915,901,14,0,904,11,1900,985,552,352,1,14680,0
37,"Timis",155243,350,155243,,"MUNICIPIUL TIMISOARA",96,"SCOALA CU CLASELE I-VIII NR. 29, STR. ION SLAVICI NR. 51",741,349,334,15,0,348,1,800,451,231,117,1,14680,0
37,"Timis",155243,350,155243,,"MUNICIPIUL TIMISOARA",97,"SCOALA CU CLASELE I-VIII NR. 29, ION SLAVICI NR. 51",1437,613,601,11,1,605,8,1495,882,426,179,1,14680,0
37,"Timis",155243,350,155243,,"MUNICIPIUL TIMISOARA",98,"SCOALA CU CLASELE I-VIII NR. 29,ION SLAVICI NR. 51",1731,811,799,12,0,803,8,1800,989,564,239,1,14680,0
37,"Timis",155243,350,155243,,"MUNICIPIUL TIMISOARA",99,"SCOALA CU CLASELE I-IV NR.15, STR. IZLAZ NR. 44",1900,934,891,43,0,915,19,1900,966,549,366,1,14680,0
37,"Timis",155243,350,155243,,"MUNICIPIUL TIMISOARA",100,"SCOALA CU CLASELE I-IV NR.15,STR. IZLAZ NR. 44",1904,1029,986,43,0,1006,23,2000,971,614,392,1,14680,0
37,"Timis",155243,350,155243,,"MUNICIPIUL TIMISOARA",101,"GRADINITA CU PROGRAM PRELUNGIT NR. 29, STR. MURES NR. 6",1444,709,683,26,0,705,4,1500,791,379,326,1,14680,0
37,"Timis",155243,350,155243,,"MUNICIPIUL TIMISOARA",102,"GRADINITA CU PROGRAM PRELUNGIT NR. 29, STR. MURES NR. 6",1299,644,626,18,0,628,16,1400,756,336,292,1,14680,0
37,"Timis",155243,350,155243,,"MUNICIPIUL TIMISOARA",103,"SCOALA CU CLASELE I-VIII NR.2, STR. MURES NR.8",1378,677,668,9,0,666,11,1500,823,339,327,1,14680,0
37,"Timis",155243,350,155243,,"MUNICIPIUL TIMISOARA",104,"SCOALA CU CLASELE I-VIII NR. 2, STR. MURES NR. 8",1682,821,808,13,0,809,12,1800,979,446,363,1,14680,0
37,"Timis",155243,350,155243,,"MUNICIPIUL TIMISOARA",105,"SCOALA CU CLASELE I-VIII NR.2, STR. MURES NR.8",1570,849,831,18,0,837,12,1700,851,454,383,1,14680,0
37,"Timis",155243,350,155243,,"MUNICIPIUL TIMISOARA",106,"SCOALA CU CLASELE I-VIII NR.14, STR. ALUNIS   NR.41 A",1755,982,964,17,1,973,9,1800,818,552,421,1,14680,0
37,"Timis",155243,350,155243,,"MUNICIPIUL TIMISOARA",107,"SCOALA CU CLASELE I-VIII NR. 14,STR. ALUNIS           NR.41A",1545,816,802,14,0,812,4,1600,784,461,351,1,14680,0
37,"Timis",155243,350,155243,,"MUNICIPIUL TIMISOARA",108,"GRADINITA CU PROGRAM PRELUNGIT NR.28, ZONA STADION",1493,756,733,22,1,748,8,1600,844,378,370,1,14680,0
37,"Timis",155243,350,155243,,"MUNICIPIUL TIMISOARA",109,"LICEUL CU PROGRAM SPORTIV ""BANATUL"", STR. F.C.RIPENSIA NR.29",640,359,340,19,0,352,7,700,341,197,155,1,14680,0
37,"Timis",155243,350,155243,,"MUNICIPIUL TIMISOARA",110,"LICEUL CU PROGRAM SPORTIV ""BANATUL"" , STR. F.C.RIPENSIA NR.29",1188,626,607,18,1,614,12,1298,672,299,315,1,14680,0
37,"Timis",155243,350,155243,,"MUNICIPIUL TIMISOARA",111,"COLEGIUL NATIONAL DE ARTA ""ION VIDU"", STR. CLUJ NR.12",665,357,347,10,0,348,9,800,443,163,185,1,14680,0
37,"Timis",155243,350,155243,,"MUNICIPIUL TIMISOARA",112,"CASA TINERETULUI, STR. ARIES NR.19",1027,547,530,17,0,541,6,1100,553,299,242,1,14680,0
37,"Timis",155243,350,155243,,"MUNICIPIUL TIMISOARA",113,"CASA TINERETULUI, STR. ARIES NR.19",1272,602,588,14,0,597,5,1400,798,342,255,1,14680,0
37,"Timis",155243,350,155243,,"MUNICIPIUL TIMISOARA",114,"CASA TINERETULUI, STR. ARIES NR.19",944,499,487,10,2,489,10,1000,501,263,226,1,14680,0
37,"Timis",155243,350,155243,,"MUNICIPIUL TIMISOARA",115,"CASA TINERETULUI, STR. ARIES NR.19",1157,546,533,13,0,537,9,1197,651,310,227,1,14680,0
37,"Timis",155243,350,155243,,"MUNICIPIUL TIMISOARA",116,"UNIVERSITATEA ""TIBISCUS"",STR. DALIEI NR.1",1129,521,503,18,0,519,2,1300,779,299,220,1,14680,0
37,"Timis",155243,350,155243,,"MUNICIPIUL TIMISOARA",117,"SCOALA CU CLASELE I-VIII NR.30,STR. ASTRILOR NR.13",1821,995,956,39,0,984,11,1800,805,565,419,1,14680,0
37,"Timis",155243,350,155243,,"MUNICIPIUL TIMISOARA",118,"SCOALA CU CLASELE I-VIII NR.30, STR. ASTRILOR NR.13",1427,744,733,11,0,737,7,1500,756,436,301,1,14680,0
37,"Timis",155243,350,155243,,"MUNICIPIUL TIMISOARA",119,"SCOALA CU CLASELE I-VIII NR.30, STR.ASTRILOR NR.13",1647,939,917,22,0,931,8,1700,761,541,390,1,14680,0
37,"Timis",155243,350,155243,,"MUNICIPIUL TIMISOARA",120,"SCOALA CU CLASELE I-VIII NR.30 STR. ASTRILOR NR.13",1692,889,857,32,0,878,11,1800,911,497,381,1,14680,0
37,"Timis",155243,350,155243,,"MUNICIPIUL TIMISOARA",121,"SCOALA CU CLASELE I-VIII NR.30, STR. ASTRILOR NR.13",1447,759,751,8,0,755,4,1500,741,461,294,1,14680,0
37,"Timis",155243,350,155243,,"MUNICIPIUL TIMISOARA",122,"SCOALA GENERALA NR.28,  STR. FAGULUI NR.5",1233,533,519,14,0,523,10,1302,769,321,202,1,14680,0
37,"Timis",155243,350,155243,,"MUNICIPIUL TIMISOARA",123,"SCOALA GENERALA NR.28, STR. FAGULUI NR.5",935,459,446,13,0,454,5,1000,541,279,175,1,14680,0
37,"Timis",155243,350,155243,,"MUNICIPIUL TIMISOARA",124,"SCOALA CU CLASELE I-VIII  NR.5, STR. MOISE NICOARA NR.17",1494,711,692,19,0,696,15,1600,889,411,285,1,14680,0
37,"Timis",155243,350,155243,,"MUNICIPIUL TIMISOARA",125,"SCOALA CU CLASELE I-VIII NR.5, STR. MOISE NICOARA NR.17",1184,627,602,25,0,622,5,1300,673,321,301,1,14680,0
37,"Timis",155243,350,155243,,"MUNICIPIUL TIMISOARA",126,"GRADINITA CU PROGRAM PRELUNGIT NR.11, STR. VERSULUI NR.2",1391,733,713,20,0,719,14,1500,767,416,303,1,14680,0
37,"Timis",155243,350,155243,,"MUNICIPIUL TIMISOARA",127,"GRADINITA CU PROGRAM PRELUNGIT NR.11, STR. VERSULUI NR.2",1181,615,604,11,0,605,10,1300,685,350,255,1,14680,0
37,"Timis",155243,350,155243,,"MUNICIPIUL TIMISOARA",128,"GRUP SCOLAR DE CHIMIE SI PROTECTIA MEDIULUI ""AZUR"" 'STR. NATURII NR.2A",1611,800,786,14,0,783,17,1700,900,424,359,1,14680,0
37,"Timis",155243,350,155243,,"MUNICIPIUL TIMISOARA",129,"GRUP SCOLAR DE CHIMIE SI PROTECTIA MEDIULUI ""AZUR"" 'CALEA MARTIRILOR 1989 NR. 64",1742,823,798,25,0,810,13,1800,977,489,321,1,14680,0
37,"Timis",155243,350,155243,,"MUNICIPIUL TIMISOARA",130,"GRUP SCOLAR DE CHIMIE SI PROTECTIA MEDIULUI ""AZUR"" ,'CALEA MARTIRILOR 1989 NR. 64",1243,595,579,16,0,586,9,1300,705,326,260,1,14680,0
37,"Timis",155243,350,155243,,"MUNICIPIUL TIMISOARA",131,"GRUP SCOLAR DE CHIMIE SI PROTECTIA MEDIULUI ""AZUR"" ,'CALEA MARTIRILOR 1989 NR.64",1080,532,524,8,0,528,4,1200,668,298,230,1,14680,0
37,"Timis",155243,350,155243,,"MUNICIPIUL TIMISOARA",132,"GRUP SCOLAR DE CHIMIE  SI PROTECTIA MEDIULUI ""AZUR"",'CALEA MARTIRILOR 1989 NR. 64",1682,815,796,19,0,801,14,1801,986,467,334,1,14680,0
37,"Timis",155243,350,155243,,"MUNICIPIUL TIMISOARA",133,"GRUP SCOLAR DE CHIMIE  SI PROTECTIA MEDIULUI ""AZUR"" ,CALEA MARTIRILOR 1989 NR. 64",1728,880,865,15,0,862,18,1797,917,564,298,1,14680,0
37,"Timis",155243,350,155243,,"MUNICIPIUL TIMISOARA",134,"LICEUL TEORETIC ""IRIS"",STR. COSMINULUI NR. 40",1587,824,809,15,0,815,9,1700,876,516,299,1,14680,0
37,"Timis",155243,350,155243,,"MUNICIPIUL TIMISOARA",135,"SCOALA CU CLASELE I-VIIINR. 25, STR.COSMINULUI NR. 42",1734,868,848,20,0,852,16,1900,1032,493,359,1,14680,0
37,"Timis",155243,350,155243,,"MUNICIPIUL TIMISOARA",136,"SCOALA CU CLASELE I-VIII NR. 25, STR. COSMINULUI NR. 42",1682,866,852,14,0,840,26,1800,934,443,397,1,14680,0
37,"Timis",155243,350,155243,,"MUNICIPIUL TIMISOARA",137,"SCOALA CU CLASELE I-VIII NR. 25, STR. COSMINULUI NR. 42",1682,905,885,20,0,887,18,1800,895,488,399,1,14680,0
37,"Timis",155243,350,155243,,"MUNICIPIUL TIMISOARA",138,"SCOALA CU CLASELE I-VIII NR.25, STR.COSMINULUI NR.42",1528,816,787,29,0,813,3,1600,784,464,349,1,14680,0
37,"Timis",155243,350,155243,,"MUNICIPIUL TIMISOARA",139,"SCOALA CU CLASELE I-VIII NR.25, STR. COSMINULUI NR.42",783,405,378,27,0,402,3,904,499,244,158,1,14680,0
37,"Timis",155243,350,155243,,"MUNICIPIUL TIMISOARA",140,"GRADINITA CU PROGRAM PRELUNGIT NR.12, PIATA  AXENTE SEVER  NR. 10",787,419,400,18,1,412,7,897,478,195,217,1,14680,0
37,"Timis",155243,350,155243,,"MUNICIPIUL TIMISOARA",141,"SCOALA CU CLASELE I-VIII NR.15, STR. CHISODEI NR. 1",1250,589,573,15,1,583,6,1301,712,345,238,1,14680,0
37,"Timis",155243,350,155243,,"MUNICIPIUL TIMISOARA",142,"SCOALA CU CLASELE I-VIII NR. 15, STR. CHISODEI NR.1",1538,795,742,53,0,785,10,1600,805,417,368,1,14680,0
37,"Timis",155243,350,155243,,"MUNICIPIUL TIMISOARA",143,"SCOALA CU CLASELE I-VIII NR. 15, STR. CHISODEI NR. 1",1365,700,678,22,0,692,8,1500,800,445,247,1,14680,0
37,"Timis",155243,350,155243,,"MUNICIPIUL TIMISOARA",144,"SCOALA CU CLASELE I-VIII NR. 15, STR. CHISODEI NR.1",1393,674,653,21,0,667,7,1500,826,379,288,1,14680,0
37,"Timis",155243,350,155243,,"MUNICIPIUL TIMISOARA",145,"SANTIERUL  DRUMURI MUNICIPALEM,STR. ETERNITATII NR. 45",1365,506,490,16,0,495,11,1510,1004,323,172,1,14680,0
37,"Timis",155243,350,155243,,"MUNICIPIUL TIMISOARA",146,"SANTIERUL  DRUMURI MUNICIPALE, STR. ETERNITATII NR. 45",1098,427,409,18,0,422,5,1200,773,288,134,1,14680,0
37,"Timis",155243,350,155243,,"MUNICIPIUL TIMISOARA",147,"GRADINITA CU PROGRAM PRELUNGIT NR.23, STR. GAVRIL MUSICESCU NR.9",1273,679,658,18,3,672,7,1396,717,327,345,1,14680,0
37,"Timis",155243,350,155243,,"MUNICIPIUL TIMISOARA",148,"SCOALA CU CLASELE I-VIII NR. 13, STR. GAVRIL MUSICESCU NR.14",1232,567,548,19,0,563,4,1300,733,376,187,1,14680,0
37,"Timis",155243,350,155243,,"MUNICIPIUL TIMISOARA",149,"SCOALA CU CLASELE I-VIII NR.13 STR. GAVRIL MUSICESCU NR.14",1439,738,726,12,0,725,13,1500,762,372,353,1,14680,0
37,"Timis",155243,350,155243,,"MUNICIPIUL TIMISOARA",150,"SCOALA CU CLASELE I-VIII NR. 13,  STR. GAVRIL MUSICESCU NR.14",1415,672,659,13,0,664,8,1500,828,406,258,1,14680,0
37,"Timis",155243,350,155243,,"MUNICIPIUL TIMISOARA",151,"SCOALA CU CLASELE I-VIII NR. 13, STR.GAVRIL MUSICESCU NR.14",1151,544,530,14,0,541,3,1200,656,337,204,1,14680,0
37,"Timis",155243,350,155243,,"MUNICIPIUL TIMISOARA",152,"GRUP SCOLAR INDUSTRIAL ELECTROTIMIS, STR. MATEI MILLO NR. 2A",1337,676,668,8,0,668,8,1398,722,425,243,1,14680,0
37,"Timis",155243,350,155243,,"MUNICIPIUL TIMISOARA",153,"GRUP SCOLAR INDUSTRIAL ELECTROTIMIS ,STR. MATEI MILLO NR.2A",1751,823,807,16,0,813,10,1800,977,539,274,1,14680,0
37,"Timis",155243,350,155243,,"MUNICIPIUL TIMISOARA",154,"GRUP SCOLAR INDUSTRIAL ELECTROTIMIS, STR. MATEI MILLO NR. 2A",1576,818,800,18,0,807,11,1700,882,445,362,1,14680,0
37,"Timis",155243,350,155243,,"MUNICIPIUL TIMISOARA",155,"GRUP SCOLAR INDUSTRIAL ELECTROTIMIS, STR. MATEI MILLO NR.2A",1598,651,641,10,0,648,3,1700,1049,458,190,1,14680,0
37,"Timis",155243,350,155243,,"MUNICIPIUL TIMISOARA",156,"SCOALA GENERALA NR.23, STR. NEGOIUL NR.47",1416,774,757,17,0,767,7,1500,726,381,386,1,14680,0
37,"Timis",155243,350,155243,,"MUNICIPIUL TIMISOARA",157,"SCOALA GENERALA NR.23,STR. NEGOIUL NR.47",1637,683,671,12,0,675,8,1700,1017,435,240,1,14680,0
37,"Timis",155243,350,155243,,"MUNICIPIUL TIMISOARA",158,"CENTRUL SCOLAR PENTRU EDUCATIE INCLUZIVA ""CONSTANTIN PUFAN, STR. BUCEGI NR.2",1503,807,790,17,0,805,2,1600,793,409,396,1,14680,0
37,"Timis",155243,350,155243,,"MUNICIPIUL TIMISOARA",159,"GRADINITA CU PRORAM NORMAL NR.19,STR. LUMINII (MARTIR V. BALMUS) NR.22",1741,913,901,12,0,904,9,1800,887,595,309,1,14680,0
37,"Timis",155243,350,155243,,"MUNICIPIUL TIMISOARA",160,"GRADINITA CU PROGRAM NORMAL NR.19, STR. LUMINII NR.22",1609,814,800,14,0,801,13,1700,886,448,353,1,14680,0
37,"Timis",155243,350,155243,,"MUNICIPIUL TIMISOARA",161,"SCOALA GENERALA NR.16 ""TAKE IONESCU"", STR. BUCURESTI NR.1",1011,605,589,16,0,597,8,1100,495,255,342,1,14680,0
37,"Timis",155243,350,155243,,"MUNICIPIUL TIMISOARA",162,"SCOALA GENERALA NR.16 ""TAKE IONESCU"", STR. BUCURESTI NR.1",1092,1022,645,9,368,1000,22,1500,478,542,458,1,14680,0
37,"Timis",155243,350,155243,,"MUNICIPIUL TIMISOARA",163,"SCOALA GENERALA NR.16 ""TAKE IONESCU""', STR. BUCURESTI NR.1",1141,649,632,17,0,639,10,1200,551,258,381,1,14680,0
37,"Timis",155243,350,155243,,"MUNICIPIUL TIMISOARA",164,"SEDIUL R.A.T.T 'BDUL. TAKE IONESCU NR.56",879,488,433,21,34,481,7,1000,512,207,274,1,14680,0
37,"Timis",155243,350,155243,,"MUNICIPIUL TIMISOARA",165,"GRADINITA CU PROGRAM PRELUNGIT NR.48 STR. DRAGASANI NR.1",1037,529,515,14,0,519,10,1100,571,303,216,1,14680,0
37,"Timis",155243,350,155243,,"MUNICIPIUL TIMISOARA",166,"GRUPUL SCOLAR ENERGETIC,STR. RENASTERII NR.24A",1908,918,903,14,1,908,10,2000,1082,551,357,1,14680,0
37,"Timis",155243,350,155243,,"MUNICIPIUL TIMISOARA",167,"SCOALA GENERALA  NR.21, STR. MIHAIL KOGALNICEANU NR.4",1531,777,765,11,1,765,12,1600,823,455,310,1,14680,0
37,"Timis",155243,350,155243,,"MUNICIPIUL TIMISOARA",168,"SCOALA GENERALA NR.21, STR. MIHAIL KOGALNICEANU NR.4",1758,876,826,50,0,863,13,1800,924,506,357,1,14680,0
37,"Timis",155243,350,155243,,"MUNICIPIUL TIMISOARA",169,"SCOALA GENERALA NR. 21 ""VICENTIU BABES"",B-DUL. SIMION BARNUTIU NR.9",1768,949,941,8,0,937,12,1900,951,478,459,1,14680,0
37,"Timis",155243,350,155243,,"MUNICIPIUL TIMISOARA",170,"SCOALA GENERALA NR. 21 ""VICENTIU BABES"", B-DUL. SIMION BARNUTIU NR.9",1218,625,612,13,0,620,5,1298,673,354,266,1,14680,0
37,"Timis",155243,350,155243,,"MUNICIPIUL TIMISOARA",171,"FUNDATIA IOAN SLAVICI,STR. ION IONESCU DE LA BRAD NR.15",1742,800,776,24,0,796,4,1800,1000,497,299,1,14680,0
37,"Timis",155243,350,155243,,"MUNICIPIUL TIMISOARA",172,"FUNDATIA IOAN SLAVICI,STR. ION IONESCU DE LA BRAD  NR.15",1929,927,888,39,0,915,12,2000,1073,563,352,1,14680,0
37,"Timis",155243,350,155243,,"MUNICIPIUL TIMISOARA",173,"SCOALA GENERALA NR.7 ""SFANTA MARIA"",STR. ION IONESCU DE LA BRAD NR.2",1098,566,551,14,1,563,3,1200,634,350,213,1,14680,0
37,"Timis",155243,350,155243,,"MUNICIPIUL TIMISOARA",174,"SCOALA  GENERALA NR.7 ""SFANTA MARIA"",STR. ION IONESCU DE LA BRAD NR.2",1447,708,679,29,0,700,8,1500,792,450,250,1,14680,0
37,"Timis",155243,350,155243,,"MUNICIPIUL TIMISOARA",175,"SCOALA GENERALA  NR.7 ""SFANTA MARIA"",STR. ION IONESCU DE LA BRAD NR.2",1804,922,903,19,0,914,8,1900,978,518,396,1,14680,0
37,"Timis",155243,350,155243,,"MUNICIPIUL TIMISOARA",176,"SCOALA GENERALA NR.7 ""SFANTA MARIA"",STR. ION IONESCU DE LA BRAD NR.2",1720,829,808,20,1,824,5,1800,971,497,327,1,14680,0
37,"Timis",155243,350,155243,,"MUNICIPIUL TIMISOARA",177,"SCOALA GENERALA NR.7 ""SFANTA MARIA"", STR. ION IONESCU DE LA BRAD NR.2",1336,567,551,16,0,561,6,1400,833,336,225,1,14680,0
37,"Timis",155243,350,155243,,"MUNICIPIUL TIMISOARA",178,"SCOALA GENERALA  NR.7 ""SFANTA MARIA"",STR. ION IONESCU DE LA BRAD NR.2",1368,688,662,26,0,680,8,1500,812,418,262,1,14680,0
37,"Timis",155243,350,155243,,"MUNICIPIUL TIMISOARA",179,"GRADINITA CU PROGRAM PRELUNGIT NR.20, STR. IRLANDA NR.53",1829,899,884,15,0,892,7,1900,1001,522,370,1,14680,0
37,"Timis",155243,350,155243,,"MUNICIPIUL TIMISOARA",180,"GRADINITA CU PROGRAM PRELUNGIT NR.20, STR.IRLANDA NR.53",1476,832,723,108,1,822,10,1600,768,540,282,1,14680,0
37,"Timis",155243,350,155243,,"MUNICIPIUL TIMISOARA",181,"GRADINITA CU PROGRAM PRELUNGIT NR.20, STR. IRLANDA NR.53",1019,540,523,17,0,539,1,1100,560,316,223,1,14680,0
37,"Timis",155243,350,155243,,"MUNICIPIUL TIMISOARA",182,"S.C.""RETIM""S.A. , STR. IALOMITA NR.17",1890,1001,982,19,0,986,15,2000,999,556,430,1,14680,0
37,"Timis",155243,350,155243,,"MUNICIPIUL TIMISOARA",183,"S.C.""RETIM""S.A, STR. IALOMITA NR.17",1925,968,951,17,0,962,6,2000,1032,574,388,1,14680,0
37,"Timis",155243,350,155243,,"MUNICIPIUL TIMISOARA",184,"GRUP SCOLAR ""TUDOR TANASESCU, STR. LORENA NR.35",1524,769,760,8,1,766,3,1600,831,441,325,1,14680,0
37,"Timis",155243,350,155243,,"MUNICIPIUL TIMISOARA",185,"GRUP SCOLAR ""TUDOR TANASESCU"",STR. LORENA NR.35",1347,595,579,15,1,587,8,1400,805,356,231,1,14680,0
37,"Timis",155243,350,155243,,"MUNICIPIUL TIMISOARA",186,"GRUP SCOLAR ""TUDOR TANASESCU"", STR. LORENA NR.35",1584,714,690,24,0,702,12,1700,986,398,304,1,14680,0
37,"Timis",155243,350,155243,,"MUNICIPIUL TIMISOARA",187,"GRUP SCOLAR ""TUDOR TANASESCU"",STR. LORENA NR.35",1543,783,726,57,0,776,7,1600,817,443,333,1,14680,0
37,"Timis",155243,350,155243,,"MUNICIPIUL TIMISOARA",188,"S.C. ""U.M.T."" S.A.- GRADINITA,STR. A. IMBROANE (ALEEA CFR) NR.2A",1922,963,946,17,0,962,1,2000,1037,567,395,1,14680,0
37,"Timis",155243,350,155243,,"MUNICIPIUL TIMISOARA",189,"LICEUL TEORETIC ""W.SHAKESPEARE"" STR.I.L.CARAGIALE NR.6",834,463,447,16,0,458,5,900,437,216,242,1,14680,0
37,"Timis",155243,350,155243,,"MUNICIPIUL TIMISOARA",190,"LICEUL TEORETIC "" W. SHAKESPEARE"" STR.I.L.CARAGIALE NR.6",924,489,476,13,0,483,6,1000,511,238,245,1,14680,0
37,"Timis",155243,350,155243,,"MUNICIPIUL TIMISOARA",191,"CENTRUL SCOLAR PENTRU EDUCATIE INCLUZIVA "" PAUL POPESCU NEVEANU"", STR. TITU MAIORESCU NR.2 - 6",1339,637,611,26,0,628,9,1400,763,403,225,1,14680,0
37,"Timis",155243,350,155243,,"MUNICIPIUL TIMISOARA",192,"CENTRUL SCOLAR PENTRU EDUCATIE INCLUZIVA ""PAUL POPESCU NEVEANU, STR. TITU MAIORESCU NR. 2 - 6",1371,565,552,13,0,556,9,1500,935,387,169,1,14680,0
37,"Timis",155243,350,155243,,"MUNICIPIUL TIMISOARA",193,"CENTRUL SCOLAR PENTRU EDUCATIE INCLUZIVA ""PAUL POPESCU NEVEANU , STR. TITU MAIORESCU NR. 2 - 6",845,408,393,15,0,401,7,900,492,256,145,1,14680,0
37,"Timis",155243,350,155243,,"MUNICIPIUL TIMISOARA",194,"CENTRUL SCOLAR PENTRU EDUCATIE INCLUZIVA ""PAUL POPESCU NEVEANU"" , STR.TITU MAIORESCU NR.2 - 6",1464,609,592,15,2,602,7,1500,891,409,193,1,14680,0
37,"Timis",155243,350,155243,,"MUNICIPIUL TIMISOARA",195,"LICEUL TEORETIC JEAN LOUIS CALDERON,STR. PESTALOZZI NR.14",1055,504,491,13,0,496,8,1200,696,275,221,1,14680,0
37,"Timis",155243,350,155243,,"MUNICIPIUL TIMISOARA",196,"LICEUL TEORETIC JEAN LOUIS CALDERON,STR. PESTALOZZI NR.14",1582,789,774,15,0,775,14,1700,911,437,338,1,14680,0
37,"Timis",155243,350,155243,,"MUNICIPIUL TIMISOARA",197,"LICEUL TEORETIC JEAN LOUIS CALDERON,STR. PESTALOZZI NR.14",1258,663,642,20,1,657,6,1400,737,324,333,1,14680,0
37,"Timis",155243,350,155243,,"MUNICIPIUL TIMISOARA",198,"LICEUL TEORETIC JEAN LOUIS CALDERON,STR. PESTALOZZI NR.14",1207,649,633,16,0,637,12,1300,651,312,325,1,14680,0
37,"Timis",155243,350,155243,,"MUNICIPIUL TIMISOARA",199,"LICEUL TEOLOGIC PENTICOSTAL LOGOS,STR. TRANSILVANIA  NR.10A",1528,776,766,10,0,765,11,1600,824,469,296,1,14680,0
37,"Timis",155243,350,155243,,"MUNICIPIUL TIMISOARA",200,"LICEUL TEOLOGIC PENTICOSTAL LOGOS,STR. TRANSILVANIA  NR.10A",1130,553,535,18,0,542,11,1200,647,331,211,1,14680,0
37,"Timis",155243,350,155243,,"MUNICIPIUL TIMISOARA",201,"LICEUL TEOLOGIC PENTICOSTAL LOGOS STR.TRANSILVANIA NR.10A",1248,626,609,16,1,615,11,1300,674,355,260,1,14680,0
37,"Timis",155243,350,155243,,"MUNICIPIUL TIMISOARA",202,"LICEUL TEOLOGIC PENTICOSTAL LOGOS,STR. TRANSILVANIA NR. 10A",1328,707,698,9,0,694,13,1400,693,427,267,1,14680,0
37,"Timis",155243,350,155243,,"MUNICIPIUL TIMISOARA",203,"GRADINITA CU PROGRAM PRELUNGIT NR. 30,  STR. VASILE LUPU NR.29/A",1723,724,711,11,2,719,5,1800,1076,475,244,1,14680,0
37,"Timis",155243,350,155243,,"MUNICIPIUL TIMISOARA",204,"GRADINITA CU PROGRAM PRELUNGIT NR. 30 STR. VASILE LUPU NR.29/A",1630,740,726,14,0,731,9,1700,960,465,266,1,14680,0
37,"Timis",155243,350,155243,,"MUNICIPIUL TIMISOARA",205,"SCOALA GENERALA NR.20,STR. HUMULESTI(MARTIR C.RADU) NR.23",1600,892,877,15,0,881,11,1700,808,532,349,1,14680,0
37,"Timis",155243,350,155243,,"MUNICIPIUL TIMISOARA",206,"SCOALA CU CLASELE I-VIII NR 4, STR. JULES VERNE NR.64",1502,776,767,9,0,771,5,1502,726,476,295,1,14680,0
37,"Timis",155243,350,155243,,"MUNICIPIUL TIMISOARA",207,"SCOALA CU CLASELE I-VIII NR. 4,STR. JULES VERNE NR.64",1084,616,599,17,0,612,4,1200,584,371,241,1,14680,0
37,"Timis",155243,350,155243,,"MUNICIPIUL TIMISOARA",208,"GRADINITA CU PROGRAM PRELUNGIT NR.6, STR. TEPES VODA ( ISMAIL ) NR.17",1303,716,700,16,0,707,9,1400,684,413,294,1,14680,0
37,"Timis",155243,350,155243,,"MUNICIPIUL TIMISOARA",209,"GRADINITA CU PROGRAM PRELUNGIT NR.6,STR. TEPES VODA ( ISMAIL ) NR.17",1217,645,631,14,0,638,7,1300,655,381,257,1,14680,0
37,"Timis",155243,350,155243,,"MUNICIPIUL TIMISOARA",210,"CENTRUL LOGISTIC TIMIS,STR. TORAC NR.45-47",1138,541,523,17,1,533,8,1200,659,349,184,1,14680,0
37,"Timis",155243,350,155243,,"MUNICIPIUL TIMISOARA",211,"CENTRUL LOGISTIC TIMIS, STR. TORAC NR.45-47",1183,549,535,13,1,542,7,1300,751,360,182,1,14680,0
37,"Timis",155243,350,155243,,"MUNICIPIUL TIMISOARA",212,"GRADINITA AEROPORT CU PROGRAM PRELUNGIT NR.13, STR.AEROPORT NR.1",514,290,279,11,0,281,9,603,313,163,118,1,14680,0
37,"Timis",155243,350,155243,,"MUNICIPIUL TIMISOARA",213,"CAMINUL NR.9C UNIVERSITATEA POLITEHNICA-COMPLEXUL STUDENTESC, ALEEA STUDENTILOR",0,2144,0,2144,0,2116,28,5000,2856,1240,876,1,14680,1
37,"Timis",155243,350,155243,,"MUNICIPIUL TIMISOARA",214,"CAMINUL NR.19C UNIVERSITATEA POLITEHNICA-COMPLEXUL STUDENTESC, ALEEA STUDENTILOR",0,2825,0,2825,0,2780,45,5000,2175,1586,1194,1,14680,1
37,"Timis",155243,350,155243,,"MUNICIPIUL TIMISOARA",215,"CAMINUL FACULTATII DE DREPT  UNIVERSITATEA DE VEST, BD. EROILOR DE LA TISA NR.9A",0,1218,0,1218,0,1200,18,5000,3782,650,550,1,14680,1
37,"Timis",155243,350,155243,,"MUNICIPIUL TIMISOARA",216,"CAMINUL FACULTATII DE DREPT  UNIVERSITATEA DE VEST, BD. EROILOR DE LA TISA NR.9A",0,1180,0,1180,0,1166,14,5000,3820,666,500,1,14680,1
37,"Timis",155243,350,155243,,"MUNICIPIUL TIMISOARA",217,"FACULTATEA DE ZOOTEHNIE   UNIVERSITATEA DE STIINTE AGRICOLE SI MEDICINA VETERINARA A BANATULUI   CALEA ARADULUI, NR.119",0,1295,0,1295,0,1287,8,5000,3705,755,532,1,14680,1
37,"Timis",155243,350,155243,,"MUNICIPIUL TIMISOARA",218,"STATIA CFR  GARA DE NORD, STR.GARII NR.2",0,2054,0,2054,0,2040,14,3000,946,1328,712,1,14680,1
37,"Timis",155243,350,155243,,"MUNICIPIUL TIMISOARA",219,"AEROPORTUL INTERNATIONAL TRAIAN VUIA TIMISOARA",0,920,0,920,0,911,9,2500,1580,504,407,1,14680,1
37,"Timis",155243,350,155243,,"MUNICIPIUL TIMISOARA",220,"SPITALUL CLINIC DE URGENTA TIMISOARA BD. IOSIF BULBUCA NR.10",0,1248,0,1248,0,1232,16,1495,247,720,512,1,14680,1
37,"Timis",155350,350,155350,,"MUNICIPIUL LUGOJ",221,"COLEGIUL NATIONAL   ""IULIA HASDEU"",STR.V.V.DELAMARINA NR.1
",1408,717,705,9,3,705,12,1600,883,416,289,1,14682,0
37,"Timis",155350,350,155350,,"MUNICIPIUL LUGOJ",222,"SCOALA CU CLASELE I-VIII,  NR.3, STR. 20 DECEMBRIE 1989 NR.4",1749,871,861,10,0,867,4,1900,1029,495,372,1,14682,0
37,"Timis",155350,350,155350,,"MUNICIPIUL LUGOJ",223,"GRADINITA CU P.P 3,  STR. FAGETULUI NR.52",1774,888,873,15,0,878,10,1800,912,619,259,1,14682,0
37,"Timis",155350,350,155350,,"MUNICIPIUL LUGOJ",224,"GRADINITA CU P.P 4  MICRORAION I, STR. ALEEA BRAZILOR NR.3",1471,742,732,10,0,736,6,1600,858,392,344,1,14682,0
37,"Timis",155350,350,155350,,"MUNICIPIUL LUGOJ",225,"GRADINITA CU P.P 4  MICRORAION I, STR. ALEEA BRAZILOR NR.3",880,454,442,10,2,454,0,1000,546,292,162,1,14682,0
37,"Timis",155350,350,155350,,"MUNICIPIUL LUGOJ",226,"SCOALA CU CLASEL I-VIII NR.4, STR. STEFAN CEL MARE NR.7",1152,605,590,14,1,602,3,1301,696,377,225,1,14682,0
37,"Timis",155350,350,155350,,"MUNICIPIUL LUGOJ",227,"GRADINITA CU P.P  5, MICRORAION III STR. CEAHLAU NR.21",1675,821,817,4,0,815,6,1800,979,465,350,1,14682,0
37,"Timis",155350,350,155350,,"MUNICIPIUL LUGOJ",228,"GRADINITA CU P.P  5,  MICRORAION III STR. CEAHLAU NR.21",1294,700,680,20,0,690,10,1400,700,446,244,1,14682,0
37,"Timis",155350,350,155350,,"MUNICIPIUL LUGOJ",229,"SCOALA CU CLASELE I-VIII NR.2, STR.ASTALAS NR.31A",1639,753,746,7,0,750,3,1700,947,456,294,1,14682,0
37,"Timis",155350,350,155350,,"MUNICIPIUL LUGOJ",230,"SCOALA GENERALA CARTIER I.C.DRAGAN, STR. BUZIASULUI NR.36",1319,669,661,8,0,663,6,1400,731,462,201,1,14682,0
37,"Timis",155350,350,155350,,"MUNICIPIUL LUGOJ",231,"GRADINITA CU P.N. 11 STR.LIBERTATII NR.62",2052,1184,1171,13,0,1166,18,2100,916,773,393,1,14682,0
37,"Timis",155350,350,155350,,"MUNICIPIUL LUGOJ",232,"SALA SPORTURILOR IOAN KUNST GHERMANESCU STR.TIMISORII NR.51-53",757,437,425,12,0,433,4,902,465,248,185,1,14682,0
37,"Timis",155350,350,155350,,"MUNICIPIUL LUGOJ",233,"SALA SPORTURILOR IOAN KUNST GHERMANESCU STR.TIMISORII NR.51-53",1686,888,881,7,0,880,8,1800,912,506,374,1,14682,0
37,"Timis",155350,350,155350,,"MUNICIPIUL LUGOJ",234,"SALA SPORTURILOR IOAN KUNST GHERMANESCU STR.TIMISORII NR.51-53",1442,792,783,8,1,789,3,1488,696,452,337,1,14682,0
37,"Timis",155350,350,155350,,"MUNICIPIUL LUGOJ",235,"S.C M.I.SIAN PREST SRL STR. TIMISORII NR.125",1239,687,679,8,0,679,8,1300,613,397,282,1,14682,0
37,"Timis",155350,350,155350,,"MUNICIPIUL LUGOJ",236,"SCOALA CU CLASELE I-VIII ""EFTIMIE MURGU"", STR. LACRAMIOARELOR NR.21",1183,664,657,7,0,653,11,1300,636,382,271,1,14682,0
37,"Timis",155350,350,155350,,"MUNICIPIUL LUGOJ",237,"SCOALA CU CLASELE I-VIII ""EFTIMIE MURGU"", STR. LACRAMIOARELOR NR.21",1746,877,866,11,0,872,5,1900,1023,520,352,1,14682,0
37,"Timis",155350,350,155350,,"MUNICIPIUL LUGOJ",238,"GRADINITA CU P.N. 13 STR. BUCEGI NR.39",1733,945,928,15,2,929,16,1800,855,546,383,1,14682,0
37,"Timis",155350,350,155350,,"MUNICIPIUL LUGOJ",239,"GRUP SCOLAR "" VALERIU BRANISTE"", STR. GHRE.DOJA NR.41",1072,584,573,11,0,582,2,1200,616,363,219,1,14682,0
37,"Timis",155350,350,155350,,"MUNICIPIUL LUGOJ",240,"GRADINITA CU P.P. 2 STR.XENOPOL NR.48",1563,811,796,14,1,811,0,1700,889,495,316,1,14682,0
37,"Timis",155350,350,155350,,"MUNICIPIUL LUGOJ",241,"GRUP SCOLAR "" STEFAN ODOBLEJA"", STR. BUZIASULUI NR.35",1462,767,756,11,0,763,4,1600,833,501,262,1,14682,0
37,"Timis",155350,350,155350,,"MUNICIPIUL LUGOJ",242,"CLUBUL TINERETULUI, STR. ALEXANDRU MOCIONI NR.9",1175,562,550,12,0,553,9,1300,738,337,216,1,14682,0
37,"Timis",155350,350,155350,,"MUNICIPIUL LUGOJ",243,"SALA DE LUPTE SI GIMNASTICA ""FRANCISC HORVATH "", STR.PLOPILOR (PARCUL STRAND)",1201,551,528,23,0,548,3,1300,749,345,203,1,14682,0
37,"Timis",155350,350,155350,,"MUNICIPIUL LUGOJ",244,"BAZA SPORTIVA STRAND, PARCUL STRAND",1396,720,712,7,1,711,9,1500,780,400,311,1,14682,0
37,"Timis",155350,350,155350,,"MUNICIPIUL LUGOJ",245,"SALA SPORTURILOR ""LAVINIA MILOSOVICI"", STR.CARANSEBESULUI NR.2B",1618,878,867,11,0,872,6,1700,822,612,260,1,14682,0
37,"Timis",155350,350,155350,,"MUNICIPIUL LUGOJ",246,"SALA SPORTURILOR ""LAVINIA MILOSOVICI"", STR.CARANSEBESULUI NR.2B",1513,812,804,8,0,806,6,1600,788,475,331,1,14682,0
37,"Timis",155350,350,155350,,"MUNICIPIUL LUGOJ",247,"SALA SPORTURILOR ""LAVINIA MILOSOVICI "", STR.CARANSEBESULUI NR.2B",1649,813,798,13,2,808,5,1700,887,496,312,1,14682,0
37,"Timis",155350,350,155350,,"MUNICIPIUL LUGOJ",248,"SCOALA CU CLASELE I-VIII NR.1,  STR. BOCSEI NR.11",1286,709,699,10,0,699,10,1400,691,449,250,1,14682,0
37,"Timis",155350,350,155350,,"MUNICIPIUL LUGOJ",249,"SC ""FOREVER PIPE ""SA, STR.HERENDESTIULUI NR.10",467,293,282,11,0,291,2,600,307,199,92,1,14682,0
37,"Timis",155350,350,155350,,"MUNICIPIUL LUGOJ",250,"SCOALA CU CLASELE I-VIII NR.12, MAGURI",688,286,274,12,0,284,2,800,514,188,96,1,14682,0
37,"Timis",155350,350,155350,,"MUNICIPIUL LUGOJ",251,"SCOALA CU CLASELE I-VIII NR.8, TAPIA",272,165,153,12,0,165,0,400,235,74,91,1,14682,0
37,"Timis",155350,350,155350,,"MUNICIPIUL LUGOJ",252,"TEATRUL MUNICIPAL ""TRAIAN  GROZAVESCU"", SPL. C.BREDICEANU NR.5",0,843,0,843,0,834,9,1198,355,543,291,1,14682,1
37,"Timis",155403,350,155403,,"ORAS BUZIAS",253,"SCOALA GENERALA STR. REPUBLICII NR.4",1706,944,933,11,0,934,10,1800,856,478,456,1,14686,0
37,"Timis",155403,350,155403,,"ORAS BUZIAS",254,"LICEUL TEORETIC STR.PRINCIPALA NR. 19A",1561,784,775,9,0,777,7,1700,916,327,450,1,14686,0
37,"Timis",155403,350,155403,,"ORAS BUZIAS",255,"SCOALA GENERALA STR.22 DECEMBRIE NR.3",1526,786,768,11,7,777,9,1600,814,360,417,1,14686,0
37,"Timis",155403,350,155403,,"ORAS BUZIAS",256,"CAMINUL CULTURAL BACOVA, NR. 1",1518,650,639,11,0,646,4,1600,950,425,221,1,14686,0
37,"Timis",155403,350,155403,,"ORAS BUZIAS",257,"CAMINUL CULTURAL SILAGIU,  NR.44",686,419,412,7,0,414,5,800,381,204,210,1,14686,0
37,"Timis",155403,350,155403,,"ORAS BUZIAS",258,"PRIMARIA BUZIAS, STR. PRINCIPALA NR.16",0,456,0,456,0,450,6,1000,544,246,204,1,14686,1
37,"Timis",156357,350,156357,,"ORAS CIACOVA",259,"PRIMARIA CIACOVA, PIATA CETATII NR.8",1322,712,695,12,5,705,7,1400,688,460,245,1,14690,0
37,"Timis",156357,350,156357,,"ORAS CIACOVA",260,"LICEUL AL.MOCIONI STR.TUDOR VLADIMIRESCU NR.23",1100,544,532,12,0,537,7,1100,556,382,155,1,14690,0
37,"Timis",156357,350,156357,,"ORAS CIACOVA",261,"SCOALA CU CLASELE I-IV CEBZA, NR.140",602,310,304,6,0,301,9,700,390,209,92,1,14690,0
37,"Timis",156357,350,156357,,"ORAS CIACOVA",262,"CAMINUL CULTURAL MACEDONIA, NR.182",368,245,233,12,0,240,5,500,255,162,78,1,14690,0
37,"Timis",156357,350,156357,,"ORAS CIACOVA",263,"SCOALA CU CLASELE I-IV OBAD NR.82",453,283,269,14,0,283,0,500,217,215,68,1,14690,0
37,"Timis",156357,350,156357,,"ORAS CIACOVA",264,"SCOALA CU CLASELE I-IV PETROMAN, NR.370",568,350,340,10,0,348,2,700,350,242,106,1,14690,0
37,"Timis",156357,350,156357,,"ORAS CIACOVA",265,"LICEUL ALEXANDRU MOCIONI, CIACOVA, STR. TUDOR VLADIMIRESCU NR.21",0,229,0,229,0,228,1,400,171,144,84,1,14690,1
37,"Timis",155458,350,155458,,"ORAS DETA",266,"LICEUL SFANTU NICOLAE DETA, STR.MIHAI VITEAZU NR.12",1534,781,762,8,11,775,6,1600,819,486,289,1,14696,0
37,"Timis",155458,350,155458,,"ORAS DETA",267,"SCOALA CU CLS.V-VIII DETA, STR.VICTORIEI NR.50",1354,588,580,5,3,583,5,1500,912,341,242,1,14696,0
37,"Timis",155458,350,155458,,"ORAS DETA",268,"SCOALA CU CLS.V-VIII DETA, STR.VICTORIE NR.50",1294,646,636,8,2,636,10,1400,754,373,263,1,14696,0
37,"Timis",155458,350,155458,,"ORAS DETA",269,"A.N.I.F DETA,  STR. TARGUL MARE NR. 18.",1591,751,734,13,4,745,6,1700,949,474,271,1,14696,0
37,"Timis",155458,350,155458,,"ORAS DETA",270,"SCOALA CU CLS. I-IV OPATITA NR.112.",517,355,345,6,4,350,5,600,245,221,129,1,14696,0
37,"Timis",155458,350,155458,,"ORAS DETA",271,"CASA DE CULTURA DETA, STR. STEFAN CEL MARE NR.9",0,454,0,454,0,448,6,500,46,335,113,1,14696,1
37,"Timis",156801,350,156801,,"ORAS FAGET",272,"CASA DE CULTURA  FAGET, STR.CALEA                    LUGOJULUI   NR.26",1998,1134,1123,4,7,1129,5,2100,966,618,511,1,14699,0
37,"Timis",156801,350,156801,,"ORAS FAGET",273,"GRADINITA CU P.N FAGET STR. STEFAN CEL MARE NR.4",1469,999,981,17,1,988,11,1600,601,566,422,1,14699,0
37,"Timis",156801,350,156801,,"ORAS FAGET",274,"SCOALA CU CLS.I-IV BATESTI, NR.48",365,252,239,12,1,249,3,505,253,165,84,1,14699,0
37,"Timis",156801,350,156801,,"ORAS FAGET",275,"SCOALA CU CLS.I-IV BEGHEIUL MIC, NR.20",289,207,197,9,1,205,2,401,194,111,94,1,14699,0
37,"Timis",156801,350,156801,,"ORAS FAGET",276,"CAMINUL CULTURAL BICHIGI, NR.61",523,355,332,11,12,352,3,600,245,185,167,1,14699,0
37,"Timis",156801,350,156801,,"ORAS FAGET",277,"CAMINUL CULTURAL BRANESTI,NR.133A",446,286,277,9,0,284,2,512,226,97,187,1,14699,0
37,"Timis",156801,350,156801,,"ORAS FAGET",278,"SCOALA CU CLS.I-IV BUNEA MARE, NR.24",214,129,122,7,0,129,0,300,171,80,49,1,14699,0
37,"Timis",156801,350,156801,,"ORAS FAGET",279,"SCOALA CU CLS.I-IV COLONIA MICA NR.17A",149,101,94,7,0,101,0,201,100,75,26,1,14699,0
37,"Timis",156801,350,156801,,"ORAS FAGET",280,"SCOALA CU CLS.I-IV JUPANESTI, NR.46",148,111,98,7,6,109,2,200,89,51,58,1,14699,0
37,"Timis",156801,350,156801,,"ORAS FAGET",281,"CAMINUL CULTURAL POVERGINA, NR.42",161,120,111,9,0,119,1,300,180,90,29,1,14699,0
37,"Timis",156801,350,156801,,"ORAS FAGET",282,"CAMINUL CULTURAL TEMERESTI, NR.26",435,324,291,11,22,322,2,500,176,86,236,1,14699,0
37,"Timis",156801,350,156801,,"ORAS FAGET",283,"AUTOGARA FAGET, CALEA LUGOJULUI NR.82",0,201,0,201,0,198,3,600,399,102,96,1,14699,1
37,"Timis",157086,350,157086,,"ORAS GATAIA",284,"CASA DE CULTURA STR.REPUBLICII NR.111",1340,725,705,12,8,715,10,1400,675,403,312,1,14711,0
37,"Timis",157086,350,157086,,"ORAS GATAIA",285,"SEDIUL PRIMARIEI ORASULUI GATAIA STR.CARPATI NR.106",1309,669,646,15,8,663,6,1400,731,395,268,1,14711,0
37,"Timis",157086,350,157086,,"ORAS GATAIA",286,"SCOALA PRIMARA SAT SCULIA NR.284",1523,952,919,17,16,938,14,1599,647,549,389,1,14711,0
37,"Timis",157086,350,157086,,"ORAS GATAIA",287,"SCOALA PRIMARA BUTIN, NR.136",330,197,175,11,11,195,2,400,203,125,70,1,14711,0
37,"Timis",157086,350,157086,,"ORAS GATAIA",288,"SCOALA PRIMARA PERCOSOVA, NR.271",241,159,145,14,0,157,2,301,142,90,67,1,14711,0
37,"Timis",157086,350,157086,,"ORAS GATAIA",289,"SCOALA PRIMARA SEMLACUL MARE NR.168",299,133,123,10,0,131,2,300,167,95,36,1,14711,0
37,"Timis",157086,350,157086,,"ORAS GATAIA",290,"SCOALA PRIMARA  SEMLACUL MIC NR.78",154,100,86,14,0,99,1,300,200,37,62,1,14711,0
37,"Timis",157086,350,157086,,"ORAS GATAIA",291,"CASA DE CULTURA GATAIA, STR. REPUBLICII NR.111",0,240,0,240,0,239,1,1000,760,133,106,1,14711,1
37,"Timis",155494,350,155494,,"ORAS JIMBOLIA",292,"GRUP SCOLAR MIHAI EMINESCU, STR.GHEORGHE DOJA NR.14",1667,687,666,20,1,679,8,1800,1113,466,213,1,14718,0
37,"Timis",155494,350,155494,,"ORAS JIMBOLIA",293,"SCOALA CU CLASELE I-IV, STR. LORENA NR.35",1660,632,611,10,11,621,11,1800,1168,411,210,1,14718,0
37,"Timis",155494,350,155494,,"ORAS JIMBOLIA",294,"INTERNAT GRUP SCOLAR "" MIHAI EMINESCU"", STR.TUDOR VLADIMIRESCU NR.61",1561,604,596,8,0,593,11,1700,1096,360,233,1,14718,0
37,"Timis",155494,350,155494,,"ORAS JIMBOLIA",295,"CANTINA I  GRUP SCOLAR ""MIHAI EMINESCU"", STR.TUDOR VLADIMIRESCU NR.61",1540,555,530,24,1,548,7,1600,1045,368,180,1,14718,0
37,"Timis",155494,350,155494,,"ORAS JIMBOLIA",296,"CASA DE CULTURA,  STR.TUDOR VLADIMIRESCU NR.88",1687,701,677,18,6,692,9,1800,1099,407,285,1,14718,0
37,"Timis",155494,350,155494,,"ORAS JIMBOLIA",297,"CASA DE CULTURA,  STR.TUDOR VLADIMIRESCU NR.88",929,325,315,10,0,323,2,900,575,200,123,1,14718,0
37,"Timis",155494,350,155494,,"ORAS JIMBOLIA",298,"SCOALA GENERALA NR.2 STR. GEORGE ENESCU NR.9",1914,755,732,10,13,736,19,2100,1345,498,238,1,14718,0
37,"Timis",155494,350,155494,,"ORAS JIMBOLIA",299,"SCOALA   CU CLASELE I-IV STR.CLARII VII",222,107,99,8,0,107,0,299,192,87,20,1,14718,0
37,"Timis",155494,350,155494,,"ORAS JIMBOLIA",300,"GARA JIMBOLIA, STR. REPUBLICII NR.1",0,192,0,192,0,190,2,400,208,95,95,1,14718,1
37,"Timis",158314,350,158314,,"ORAS RECAS",301,"PRIMARIA ORASULUI RECAS, CALEA TIMISOAREI NR.86-88",1182,695,644,41,10,681,14,1900,1205,439,242,1,14720,0
37,"Timis",158314,350,158314,,"ORAS RECAS",302,"GRADINITA CU P.N RECAS, STR.FLORILOR NR.5",1227,690,583,105,2,683,7,1300,610,453,230,1,14720,0
37,"Timis",158314,350,158314,,"ORAS RECAS",303,"LICEUL TEORETIC RECAS, STR. GEORGE COSBUC NR.1",1375,719,672,46,1,711,8,1500,781,478,233,1,14720,0
37,"Timis",158314,350,158314,,"ORAS RECAS",304,"SCOALA CU CLASELE I-VIII  BAZOS, NR.73",659,283,266,17,0,279,4,700,417,196,83,1,14720,0
37,"Timis",158314,350,158314,,"ORAS RECAS",305,"SCOALA CU CLASELE I-IV HERNEACOVA, NR.19B",341,187,176,9,2,185,2,400,213,130,55,1,14720,0
37,"Timis",158314,350,158314,,"ORAS RECAS",306,"SCOALA CU CLASELE I-VIII IZVIN, NR.75",1130,591,562,29,0,588,3,1200,609,397,191,1,14720,0
37,"Timis",158314,350,158314,,"ORAS RECAS",307,"SCOALA CU CL. I-IV PETROVASELO, NR.33",228,123,113,10,0,122,1,300,177,72,50,1,14720,0
37,"Timis",158314,350,158314,,"ORAS RECAS",308,"CAMINUL CULTURAL  STANCIOVA NR.165",302,168,144,12,12,164,4,400,232,116,48,1,14720,0
37,"Timis",158314,350,158314,,"ORAS RECAS",309,"CASA DE CULTURA RECAS, CALEA TIMISOAREI NR.87",0,425,0,425,0,417,8,500,75,253,164,1,14720,1
37,"Timis",155528,350,155528,,"ORAS SANNICOLAU MARE",310,"SALA CASEI DE CULTURA (CASTEL) STR. REPUBLICII NR.14",1473,814,796,14,4,807,7,1600,786,493,314,1,14728,0
37,"Timis",155528,350,155528,,"ORAS SANNICOLAU MARE",311,"SALA CASEI DE CULTURA (CASTEL) STR. REPUBLICII NR.14",1939,1026,1000,20,6,1014,12,2000,974,680,334,1,14728,0
37,"Timis",155528,350,155528,,"ORAS SANNICOLAU MARE",312,"SEDIUL PRIMARIEI SANNICOLAU MARE,  STR.NISTOR OPREAN NR.1A",1836,1112,1087,12,13,1102,10,1900,788,759,343,1,14728,0
37,"Timis",155528,350,155528,,"ORAS SANNICOLAU MARE",313,"GRADINITA DE COPII STR.DECEBAL NR.13",1645,1006,973,20,13,996,10,1700,694,763,233,1,14728,0
37,"Timis",155528,350,155528,,"ORAS SANNICOLAU MARE",314,"GRADINITA DE COPII STR.DECEBAL NR.13",1548,900,879,14,7,890,10,1600,700,603,287,1,14728,0
37,"Timis",155528,350,155528,,"ORAS SANNICOLAU MARE",315,"GRUP SCOLAR AGRICOL STR.16 DECEMBRIE 1989 NR.17",1797,887,864,17,6,873,14,1900,1013,616,257,1,14728,0
37,"Timis",155528,350,155528,,"ORAS SANNICOLAU MARE",316,"SCOALA GENERALA NR.1PIATA 1 MAI NR.3",1872,1022,999,13,10,1009,13,2000,978,723,286,1,14728,0
37,"Timis",155528,350,155528,,"ORAS SANNICOLAU MARE",317,"PRIMARIEI SANNICOLAU MARE,  STR.REPUBLICII NR.15",0,442,0,442,0,437,5,499,57,315,122,1,14728,1
37,"Timis",155546,350,155546,,"BALINT",318,"CAMINUL CULTURAL BALINT, NR.135",446,223,214,4,5,220,3,503,280,130,90,3,14730,0
37,"Timis",155546,350,155546,,"BALINT",319,"SCOALA CU CLASELE I- IV BODO, NR. 55",409,215,196,11,8,215,0,500,285,154,61,3,14730,0
37,"Timis",155546,350,155546,,"BALINT",320,"SCOALA CU CLASELE I- IV FADIMAC, NR.61",190,124,106,11,7,124,0,300,176,93,31,3,14730,0
37,"Timis",155546,350,155546,,"BALINT",321,"SCOALA CU CLS.I-IV TIRGOVISTE, NR.123",294,171,157,9,5,171,0,400,229,101,70,3,14730,0
37,"Timis",155546,350,155546,,"BALINT",322,"CAMINUL CULTURAL BALINT, NR.135",0,117,0,117,0,117,0,301,184,67,50,3,14730,1
37,"Timis",155591,350,155591,,"BANLOC",323,"PRIMARIA BANLOC, NR.405",1346,574,568,6,0,564,10,1400,826,260,304,3,14735,0
37,"Timis",155591,350,155591,,"BANLOC",324,"SCOALA OFSENITA, NR. 121",316,157,146,11,0,155,2,400,243,82,73,3,14735,0
37,"Timis",155591,350,155591,,"BANLOC",325,"SCOALA  PARTOS, NR.113",354,203,179,10,14,201,2,400,197,91,110,3,14735,0
37,"Timis",155591,350,155591,,"BANLOC",326,"SCOALA  SOCA, NR. 93",438,250,240,10,0,248,2,494,244,96,152,3,14735,0
37,"Timis",155591,350,155591,,"BANLOC",327,"SCOALA GENERALACU CLS.I-VIII ""ANGHEL SALIGNY"" BANLOC, NR.782",0,112,0,112,0,112,0,300,188,61,51,3,14735,1
37,"Timis",155662,350,155662,,"BARA",328,"SEDIUL  PRIMARIEI BARA, NR.44",136,89,84,5,0,88,1,200,111,47,41,3,14740,0
37,"Timis",155662,350,155662,,"BARA",329,"SCOALA DOBRESTI,  NR.120",36,29,20,9,0,29,0,100,71,16,13,3,14740,0
37,"Timis",155662,350,155662,,"BARA",330,"CAMINUL CULTURAL  LAPUSNIC,  NR.79",32,26,17,9,0,26,0,100,74,13,13,3,14740,0
37,"Timis",155662,350,155662,,"BARA",331,"CAMINUL CULTURAL  RADMANESTI, NR.147",63,36,31,5,0,36,0,200,164,12,24,3,14740,0
37,"Timis",155662,350,155662,,"BARA",332,"PRIMARIA BARA, NR.44",0,75,0,75,0,75,0,200,125,43,32,3,14740,1
37,"Timis",155724,350,155724,,"BEBA VECHE",333,"CAMINUL CULTURAL BEBA VECHE NR.141",877,563,518,3,42,555,8,992,429,415,140,3,14754,0
37,"Timis",155724,350,155724,,"BEBA VECHE",334,"GRADINITA  CHERESTUR NR.211",434,339,317,7,15,335,4,495,156,287,48,3,14754,0
37,"Timis",155724,350,155724,,"BEBA VECHE",335,"GRADINITA CHERESTUR, NR.211",0,73,0,73,0,73,0,200,127,57,16,3,14754,1
37,"Timis",155760,350,155760,,"BECICHERECU MIC",336,"GRADINITA  BECICHERECU MIC NR.308",1176,668,629,7,32,663,5,1300,632,391,272,3,14758,0
37,"Timis",155760,350,155760,,"BECICHERECU MIC",337,"SCOALA CU CLASELE I-VIII BECICHERECU MIC NR.646",1214,694,656,8,30,684,10,1300,606,428,256,3,14758,0
37,"Timis",155760,350,155760,,"BECICHERECU MIC",338,"CAMINUL CULTURAL BECICHERECU MIC NR.647",0,253,0,253,0,250,3,400,147,150,100,3,14758,1
37,"Timis",155797,350,155797,,"BELINT",339,"SEDIUL PRIMARIEI BELINT, NR.147",1268,867,815,9,43,860,7,1400,533,610,250,3,14760,0
37,"Timis",155797,350,155797,,"BELINT",340,"SCOALA CU CLASELE I-IV  BABSA, NR.145",199,158,146,8,4,158,0,300,142,107,51,3,14760,0
37,"Timis",155797,350,155797,,"BELINT",341,"SCOALA CU CLASELE I-IV CHIZATAU, NR.275",699,535,485,11,39,531,4,800,265,381,150,3,14760,0
37,"Timis",155797,350,155797,,"BELINT",342,"SCOALA CU CLASELE I-IV GRUNI, NR.207",177,138,129,7,2,134,4,200,62,86,48,3,14760,0
37,"Timis",155797,350,155797,,"BELINT",343,"SALA DE SPORT BELINT, NR.145",0,199,0,199,0,197,2,400,201,131,66,3,14760,1
37,"Timis",155840,350,155840,,"BETHAUSEN",344,"CAMINUL CULTURAL BETHAUSEN, NR.180/A",683,373,371,2,0,370,3,797,424,240,130,3,14765,0
37,"Timis",155840,350,155840,,"BETHAUSEN",345,"CAMINUL CULTURAL CLADOVA, NR.86/B",394,237,231,6,0,236,1,500,263,122,114,3,14765,0
37,"Timis",155840,350,155840,,"BETHAUSEN",346,"CAMINUL CULTURAL CLICIOVA, NR.54",363,228,221,7,0,224,4,472,244,107,117,3,14765,0
37,"Timis",155840,350,155840,,"BETHAUSEN",347,"SCOALA CUTINA, NR.112",264,183,173,10,0,182,1,300,117,117,65,3,14765,0
37,"Timis",155840,350,155840,,"BETHAUSEN",348,"CAMINUL CULTURAL LEUCUSESTI, NR.77",376,222,218,4,0,222,0,504,282,107,115,3,14765,0
37,"Timis",155840,350,155840,,"BETHAUSEN",349,"SCOALA NEVRINCEA NR.111",178,105,100,5,0,103,2,305,200,61,42,3,14765,0
37,"Timis",155840,350,155840,,"BETHAUSEN",350,"PRIMARIA COMUNEI BETHAUSEN, NR.66,SALA DE SEDINTA",0,85,0,85,0,84,1,203,118,49,35,3,14765,1
37,"Timis",155911,350,155911,,"BILED",351,"CAMINUL CULTURAL BILED, NR.353",1818,925,881,14,30,919,6,1900,975,467,452,3,14772,0
37,"Timis",155911,350,155911,,"BILED",352,"GRADINITA CU P.P. BILED, NR.360",1455,769,712,21,36,754,15,1500,731,416,338,3,14772,0
37,"Timis",155911,350,155911,,"BILED",353,"CAMIN CULTURAL BILED, STR.PRINCIPALA NR.353",0,230,0,230,0,227,3,402,172,127,100,3,14772,1
37,"Timis",159366,350,159366,,"BIRDA",354,"SCOALA CU CLASELE V-VIII BIRDA NR.110",904,590,566,6,18,585,5,990,400,295,290,3,14774,0
37,"Timis",159366,350,159366,,"BIRDA",355,"SCOALA CU CLASELE  I -IV BERECUTA NR.74",162,105,92,7,6,104,1,299,194,54,50,3,14774,0
37,"Timis",159366,350,159366,,"BIRDA",356,"SCOALA CU CLASELE I -IV MANASTIRE NR,87",177,122,106,9,7,121,1,300,178,46,75,3,14774,0
37,"Timis",159366,350,159366,,"BIRDA",357,"SCOALA CU CLASELE I -IV  SANGEORGE NR.203/C",439,279,265,4,10,279,0,483,204,119,160,3,14774,0
37,"Timis",159366,350,159366,,"BIRDA",358,"GRADINITA PN, BIRDA NR.113",0,200,0,200,0,196,4,300,100,117,79,3,14774,1
37,"Timis",155957,350,155957,,"BARNA",359,"CAMINUL CULTURAL BARNA, NR.71",416,231,223,8,0,227,4,450,219,106,121,3,14746,0
37,"Timis",155957,350,155957,,"BARNA",360,"CAMIN CULTURAL BOTINESTI",173,110,105,5,0,109,1,300,190,49,60,3,14746,0
37,"Timis",155957,350,155957,,"BARNA",361,"CAMIN CULTURAL JURESTI",376,202,194,8,0,202,0,500,298,88,114,3,14746,0
37,"Timis",155957,350,155957,,"BARNA",362,"CAMINUL CULTURAL POGANESTI",262,150,141,9,0,150,0,396,246,76,74,3,14746,0
37,"Timis",155957,350,155957,,"BARNA",363,"SCOALA GENERALA  CU CLS.I-VIII BARNA, NR.82",0,113,0,113,0,113,0,150,37,66,47,3,14746,1
37,"Timis",156035,350,156035,,"BOGDA",364,"SEDIUL PRIMARIEI BOGDA, NR.9",227,122,116,4,2,121,1,300,178,44,77,3,14779,0
37,"Timis",156035,350,156035,,"BOGDA",365,"CAMIN CULTURAL BUZAD, NR.63",153,122,99,10,13,121,1,201,79,53,68,3,14779,0
37,"Timis",156035,350,156035,,"BOGDA",366,"SCOALA GENERALA CHARLOTTENBURG, NR.62",0,122,0,122,0,121,1,300,178,53,68,3,14779,1
37,"Timis",156106,350,156106,,"BOLDUR",367,"SCOALA CU CLASELE I - VIII  BOLDUR, NR.184",517,337,331,1,5,337,0,600,263,227,110,3,14786,0
37,"Timis",156106,350,156106,,"BOLDUR",368,"SCOALA CU CLASELE I - IV JABAR, NR.17",363,229,226,3,0,228,1,500,271,124,104,3,14786,0
37,"Timis",156106,350,156106,,"BOLDUR",369,"SCOALA CU CLASELE I-IV OHABA-FORGACI, NR.256",624,429,402,5,22,421,8,701,272,254,167,3,14786,0
37,"Timis",156106,350,156106,,"BOLDUR",370,"SCOALA CU CLASELE I-IV SINERSIG, NR.146",490,260,250,10,0,257,3,600,340,174,83,3,14786,0
37,"Timis",156106,350,156106,,"BOLDUR",371,"SCOALA GENEREALA CU CLS.I-VIII BOLDUR, NR.184",0,117,0,117,0,117,0,201,84,63,54,3,14786,1
37,"Timis",156151,350,156151,,"BRESTOVAT",372,"PRIMARIA BRESTOVAT, NR.20",228,181,173,6,2,181,0,300,119,128,53,3,14791,0
37,"Timis",156151,350,156151,,"BRESTOVAT",373,"SCOALA GENERALA COSARII, NR.86",132,92,86,6,0,91,1,200,108,48,43,3,14791,0
37,"Timis",156151,350,156151,,"BRESTOVAT",374,"CAMINUL CULTURAL TES, NR.32",226,177,174,3,0,176,1,300,123,114,62,3,14791,0
37,"Timis",156151,350,156151,,"BRESTOVAT",375,"PRIMARIA COMUNEI BRESTOVAT, NR.20",0,96,0,96,0,96,0,300,204,59,37,3,14791,1
37,"Timis",159516,350,159516,,"BUCOVAT",376,"CAMINUL CULTURAL BUCOVAT , STR.PRINCIPALA NR.178",1016,665,651,13,1,660,5,1100,435,378,282,3,14797,0
37,"Timis",159516,350,159516,,"BUCOVAT",377,"CAMINUL CULTURAL BAZOSU NOU STR.CLOSCA NR.52",237,184,176,8,0,180,4,300,116,81,99,3,14797,0
37,"Timis",159516,350,159516,,"BUCOVAT",378,"SCOALA GENERALA CU CLS.I-VIII BUCOVAT, NR.178",0,182,0,182,0,178,4,302,120,74,104,3,14797,1
37,"Timis",156213,350,156213,,"CARPINIS",379,"PRIMARIA CARPINIS, STR.III-A NR.42",1745,799,785,8,6,792,7,1800,1001,531,261,3,14800,0
37,"Timis",156213,350,156213,,"CARPINIS",380,"CAMINUL CULTURAL CARPINIS, STR.VI-A NR.80",1590,658,646,5,7,651,7,1700,1042,423,228,3,14800,0
37,"Timis",156213,350,156213,,"CARPINIS",381,"CAMIN CULTURAL  IECEA MICA NR.40",995,458,449,7,2,454,4,1100,642,296,158,3,14800,0
37,"Timis",156213,350,156213,,"CARPINIS",382,"CAMINUL CULTURAL CARPINIS, STR.III-A NR.27",0,131,0,131,0,129,2,198,67,79,50,3,14800,1
37,"Timis",156259,350,156259,,"CENAD",383,"SCOALA GENERALA CENAD, NR.1578",1890,762,758,4,0,752,10,2000,1238,505,247,3,14803,0
37,"Timis",156259,350,156259,,"CENAD",384,"SCOALA  GENERALA CENAD, NR.1578",1991,750,750,0,0,747,3,2100,1350,490,257,3,14803,0
37,"Timis",156259,350,156259,,"CENAD",385,"SCOALA GENERALA CENAD, NR.1578",0,143,0,143,0,141,2,300,157,82,59,3,14803,1
37,"Timis",156277,350,156277,,"CENEI",386,"PRIMARIA  CENEI , NR.134, SALA DE SEDINTA",1823,901,872,6,23,891,10,1899,998,596,295,3,14805,0
37,"Timis",156277,350,156277,,"CENEI",387,"SCOALA CU CLS.I-VIII BOBDA, NR.86",761,479,451,17,11,476,3,800,321,311,165,3,14805,0
37,"Timis",156277,350,156277,,"CENEI",388,"PRIMARIA  CENEI , NR.134, CAMERA AGRICOLA",0,276,0,276,0,272,4,300,24,193,79,3,14805,1
37,"Timis",159375,350,159375,,"CHECEA",389,"CAMINUL CULTURAL CHECEA, NR. 183",1552,824,801,8,15,811,13,1600,776,496,315,3,14808,0
37,"Timis",159375,350,159375,,"CHECEA",390,"PRIMARIA COMUNEI CHECEA, NR.184",0,132,0,132,0,129,3,300,168,89,40,3,14808,1
37,"Timis",156311,350,156311,,"CHEVERESU MARE",391,"SEDIUL CONSILIUL LOCAL CHEVERESU MARE NR.277",967,462,453,9,0,456,6,1100,638,273,183,3,14810,0
37,"Timis",156311,350,156311,,"CHEVERESU MARE",392,"SCOALA CU CLASELE I-IV DRAGSINA",403,271,241,19,11,270,1,400,129,133,137,3,14810,0
37,"Timis",156311,350,156311,,"CHEVERESU MARE",393,"SCOALA  CU CLASEL  I - IV VUCOVA NR.212",309,188,180,8,0,187,1,400,212,85,102,3,14810,0
37,"Timis",156311,350,156311,,"CHEVERESU MARE",394,"SCOALA CU CLS.I-VIII CHEVERESU MARE, NR.139",0,219,0,219,0,217,2,300,81,104,113,3,14810,1
37,"Timis",156437,350,156437,,"COMLOSU MARE",395,"SCOALA CU CLASEL I-VIII COMLOSU MARE, NR.485",1502,752,727,14,11,740,12,1600,848,391,349,3,14814,0
37,"Timis",156437,350,156437,,"COMLOSU MARE",396,"CAMINUL CULTURAL COMLOSU MARE, NR. 605",1376,720,691,27,2,707,13,1500,780,345,362,3,14814,0
37,"Timis",156437,350,156437,,"COMLOSU MARE",397,"BIBLIOTECA  COMLOSU MIC, NR.219",875,388,377,11,0,381,7,1000,612,260,121,3,14814,0
37,"Timis",156437,350,156437,,"COMLOSU MARE",398,"SCOALA CU CL. I - IV LUNGA NR. 73",430,254,245,9,0,249,5,500,246,132,117,3,14814,0
37,"Timis",156437,350,156437,,"COMLOSU MARE",399,"BIBLIOTECA COMUNALA COMLOSU MARE, NR.655",0,134,0,134,0,130,4,200,66,73,57,3,14814,1
37,"Timis",156473,350,156473,,"COSTEIU",400,"CAMINUL CULTURAL COSTEIU NR. 27",693,351,340,11,0,349,2,800,449,200,149,3,14818,0
37,"Timis",156473,350,156473,,"COSTEIU",401,"PRIMARIE CLADIREA VECHE COSTEIU, NR. 668",1217,646,634,8,4,642,4,1300,654,456,186,3,14818,0
37,"Timis",156473,350,156473,,"COSTEIU",402,"SCOALA GENERALA CU CLS. I-IV HEZERIS, NR.11",230,131,125,6,0,129,2,300,169,97,32,3,14818,0
37,"Timis",156473,350,156473,,"COSTEIU",403,"SCOALA GENERALA  CU CLS. I-IV PARU, NR.86",199,139,131,8,0,138,1,300,161,69,69,3,14818,0
37,"Timis",156473,350,156473,,"COSTEIU",404,"CAMINUL CULTURAL TIPARI",683,337,327,10,0,336,1,800,463,247,89,3,14818,0
37,"Timis",156473,350,156473,,"COSTEIU",405,"SCOALA CU CL.I-IV VALEA LUNGA ROMANA",127,90,84,6,0,90,0,200,110,50,40,3,14818,0
37,"Timis",156473,350,156473,,"COSTEIU",406,"CAMINUL CULTURAL COSTEIU NR. 282A",0,89,0,89,0,89,0,200,111,55,34,3,14818,1
37,"Timis",156534,350,156534,,"CRICIOVA",407,"CAMINUL CULTURAL CRICIOVA, NR.210",579,407,399,5,3,404,3,699,292,242,162,3,14824,0
37,"Timis",156534,350,156534,,"CRICIOVA",408,"CAMINUL CULTURAL CIRESU, NR.78",288,220,212,6,2,219,1,400,180,181,38,3,14824,0
37,"Timis",156534,350,156534,,"CRICIOVA",409,"CAMINUL CULTURAL JDIOARA, NR.20",438,263,256,7,0,262,1,482,219,124,138,3,14824,0
37,"Timis",156534,350,156534,,"CRICIOVA",410,"SCOALA CU CLS.I-IV CRICIOVA, NR.206",0,143,0,143,0,142,1,400,257,91,51,3,14824,1
37,"Timis",156589,350,156589,,"CURTEA",411,"CAMINUL CULTURAL CURTEA,  NR. 224",601,400,374,8,18,396,4,700,300,198,198,3,14829,0
37,"Timis",156589,350,156589,,"CURTEA",412,"CAMINUL CULTURAL COSAVA, NR. 62",478,257,248,6,3,254,3,590,333,132,122,3,14829,0
37,"Timis",156589,350,156589,,"CURTEA",413,"PRIMARIA COMUNEI CURTEA, NR.268",0,48,0,48,0,48,0,200,152,25,23,3,14829,1
37,"Timis",156623,350,156623,,"DAROVA",414,"CAMINUL CULTURAL  DAROVA NR.296",1539,544,540,4,0,543,1,1600,1056,331,212,3,14833,0
37,"Timis",156623,350,156623,,"DAROVA",415,"CAMINUL CULTURAL  HODOS NR.11",313,178,172,6,0,174,4,400,222,118,56,3,14833,0
37,"Timis",156623,350,156623,,"DAROVA",416,"SCOALA SACOSU MARE NR.220",776,374,370,4,0,372,2,900,526,242,130,3,14833,0
37,"Timis",156623,350,156623,,"DAROVA",417,"PRIMARIA COMUNEI DAROVA, STR.PRINCIPALA NR.152",0,50,0,50,0,50,0,101,51,36,14,3,14833,1
37,"Timis",156669,350,156669,,"DENTA",418,"CAMINUL CULTURAL DENTA NR.713",1912,953,942,6,5,949,4,2000,1047,539,410,3,14837,0
37,"Timis",156669,350,156669,,"DENTA",419,"SCOALA CLASELE  I-IV BRESTEA NR.88",409,250,242,7,1,244,6,500,250,121,123,3,14837,0
37,"Timis",156669,350,156669,,"DENTA",420,"CAMIN CULTURAL ROVINITA MARE NR.168",323,179,169,10,0,179,0,400,221,122,57,3,14837,0
37,"Timis",156669,350,156669,,"DENTA",421,"SCOALA GENERALA CU CLS.I-VIII DENTA, NR.712",0,98,0,98,0,98,0,300,202,56,42,3,14837,1
37,"Timis",159384,350,159384,,"DUDESTII NOI",422,"CAMINUL CULTURAL DUDESTII NOI STR. CALEATIMISOAREI NR.30",1222,581,571,10,0,579,2,1300,719,319,260,3,14842,0
37,"Timis",159384,350,159384,,"DUDESTII NOI",423,"SCOALA CU CLASELE I-VIII DUDESTII NOI, CALEA SINANDREIULUI, NR.5",1060,458,446,12,0,457,1,1200,742,240,217,3,14842,0
37,"Timis",159384,350,159384,,"DUDESTII NOI",424,"SCOALA GENERALA CU CLS.I-VIII DUDESTII NOI, CALEA SINANDREIULUI NR.5",0,169,0,169,0,167,2,400,231,100,67,3,14842,1
37,"Timis",156712,350,156712,,"DUDESTII VECHI",425,"SALA DE SPORT A LICEULUI DIN DUDESTII VECHI NR.253",1672,786,776,8,2,780,6,1799,1013,502,278,3,14844,0
37,"Timis",156712,350,156712,,"DUDESTII VECHI",426,"SALA DE SEDINTE A CONSILIULUI LOCAL DUDESTII VECHI, NR.255",1589,736,730,6,0,728,8,1700,964,535,193,3,14844,0
37,"Timis",156712,350,156712,,"DUDESTII VECHI",427,"CAMINUL CULTURAL CHEGLEVICI, NR.106",534,212,199,12,1,209,3,618,406,148,61,3,14844,0
37,"Timis",156712,350,156712,,"DUDESTII VECHI",428,"LICEUL TEORETIC ""SFINTII KIRIL SI METODII"" DUDESTII VECHI, NR.252",0,125,0,125,0,124,1,200,75,75,49,3,14844,1
37,"Timis",156767,350,156767,,"DUMBRAVA",429,"PRIMARIEI  COMUNEI DUMBRAVA NR.336",856,411,394,2,15,409,2,900,489,265,144,3,14848,0
37,"Timis",156767,350,156767,,"DUMBRAVA",430,"SCOALA GENERALA CU CL. I-IV BUCOVAT NR.126",424,328,309,7,12,323,5,500,172,173,150,3,14848,0
37,"Timis",156767,350,156767,,"DUMBRAVA",431,"SCOALA GENERALA  CU CL. I-VIII RACHITA NR.143",944,482,480,2,0,481,1,1000,518,288,193,3,14848,0
37,"Timis",156767,350,156767,,"DUMBRAVA",432,"CAMINUL CULTURAL DUMBRAVA NR.334",0,67,0,67,0,67,0,200,133,37,30,3,14848,1
37,"Timis",155261,350,155261,,"DUMBRAVITA",433,"SCOALA GENERALA I-VIII DUMBRAVITA, STR.PETOFI  SANDOR NR.29",2028,1084,1051,29,4,1063,21,2100,1016,598,465,3,14852,0
37,"Timis",155261,350,155261,,"DUMBRAVITA",434,"PRIMARIA  DUMBRAVITA, STR.PETOFI SANDOR NR.31",1754,1033,1007,22,4,1017,16,1800,767,568,449,3,14852,0
37,"Timis",155261,350,155261,,"DUMBRAVITA",435,"SCOALA GENERALA I-VIII DUMBRAVITA, STR.PETOFI  SANDOR NR.29",0,501,0,501,0,496,5,598,97,284,212,3,14852,1
37,"Timis",159393,350,159393,,"FIBIS",436,"CLUBUL CAMINULUI CULTURAL FIBIS, NR.41",1325,824,779,12,33,819,5,1400,576,509,310,3,14862,0
37,"Timis",159393,350,159393,,"FIBIS",437,"CAMIN CULTURAL FIBIS, NR.41",0,171,0,171,0,171,0,200,29,111,60,3,14862,1
37,"Timis",156927,350,156927,,"FARDEA",438,"CAMINUL CULTURAL FARDEA, NR.131",636,381,362,1,18,377,4,700,319,227,150,3,14854,0
37,"Timis",156927,350,156927,,"FARDEA",439,"CAMINUL CULTURAL DRAGSINESTI,",417,294,278,10,6,293,1,500,206,177,116,3,14854,0
37,"Timis",156927,350,156927,,"FARDEA",440,"CAMINUL CULTURAL GLADNA ROMANA",514,322,306,9,7,321,1,595,273,163,158,3,14854,0
37,"Timis",156927,350,156927,,"FARDEA",441,"CAMINUL CULTURAL FARDEA, NR.131",0,118,0,118,0,117,1,301,183,64,53,3,14854,1
37,"Timis",157004,350,157004,,"FOENI",442,"SCOALA CU CLASELE I-VIII FOENI, NR. 383A",1021,526,507,5,14,521,5,1100,574,330,191,3,14864,0
37,"Timis",157004,350,157004,,"FOENI",443,"PRIMARIA VECHE CRUCENI,NR. 76A",435,236,225,11,0,236,0,502,266,155,81,3,14864,0
37,"Timis",157004,350,157004,,"FOENI",444,"SCOALA CU CLASELE I-VIII FOENI, NR. 383A",0,117,0,117,0,116,1,200,83,76,40,3,14864,1
37,"Timis",157031,350,157031,,"GAVOJDIA",445,"SEDIUL PRIMARIEI GAVOJDIA NR. 295",1102,575,568,7,0,570,5,1300,725,407,163,3,14867,0
37,"Timis",157031,350,157031,,"GAVOJDIA",446,"SCOALA CU CLASELE I-IV JENA 150E",451,270,266,4,0,268,2,500,230,194,74,3,14867,0
37,"Timis",157031,350,157031,,"GAVOJDIA",447,"CAMINUL CULTURAL  LUGOJEL NR.274",557,327,321,6,0,324,3,600,273,230,94,3,14867,0
37,"Timis",157031,350,157031,,"GAVOJDIA",448,"CAMINUL CULTURAL SALBAGEL NR.34",248,164,157,7,0,162,2,300,136,123,39,3,14867,0
37,"Timis",157031,350,157031,,"GAVOJDIA",449,"SCOALA GENERALA CU CL.I-VIII GAVOJDIA NR.197",0,171,0,171,0,169,2,300,129,113,56,3,14867,1
37,"Timis",159400,350,159400,,"GHILAD",450,"SCOALA CU CLASELE I-VIII GHILAD NR.738",1488,703,689,14,0,691,12,1600,897,501,190,3,14872,0
37,"Timis",159400,350,159400,,"GHILAD",451,"CAMINUL CULTURAL GAD NR.235",126,61,52,9,0,60,1,200,139,35,25,3,14872,0
37,"Timis",159400,350,159400,,"GHILAD",452,"SCOALA CU CLS.I-VIII GHILAD, NR.738",0,97,0,97,0,97,0,100,3,70,27,3,14872,1
37,"Timis",155289,350,155289,,"GHIRODA",453,"GRADINITA CU P.N GHIRODA STR.VICTORIA NR.52",1737,958,936,21,1,956,2,1800,842,564,392,3,14875,0
37,"Timis",155289,350,155289,,"GHIRODA",454,"SCOALA GENERALA CU CLASELE I - VIII GHIRODA STR.VICTORIA NR.41",1695,969,910,58,1,958,11,1800,831,603,355,3,14875,0
37,"Timis",155289,350,155289,,"GHIRODA",455,"CAMINUL CULTURAL GIARMATA VII, STR.INFRATIRII NR.91",1239,789,754,35,0,780,9,1300,511,453,327,3,14875,0
37,"Timis",155289,350,155289,,"GHIRODA",456,"SCOALA CU CLS.I-VIII GHIRODA, STR.VICTORIA NR.41",0,390,0,390,0,387,3,600,210,207,180,3,14875,1
37,"Timis",157193,350,157193,,"GHIZELA",457,"SEDIUL PRIMARIEI GHIZELA NR.41",360,238,220,7,11,237,1,502,264,130,107,3,14878,0
37,"Timis",157193,350,157193,,"GHIZELA",458,"CAMINUL CULTURAL PANIOVA NR.124",231,166,154,6,6,166,0,302,136,92,74,3,14878,0
37,"Timis",157193,350,157193,,"GHIZELA",459,"CASA NATIONALA  ""NICOLAE URSU"" SANOVITA NR.32",406,309,275,6,28,307,2,495,186,247,60,3,14878,0
37,"Timis",157193,350,157193,,"GHIZELA",460,"CASA NATIONALA  ""NICOLAE URSU"" SANOVITA NR.32",0,130,0,130,0,130,0,200,70,74,56,3,14878,1
37,"Timis",157246,350,157246,,"GIARMATA",461,"CAMINUL CULTURAL GIARMATA, STR.MORII NR.726",1552,697,685,12,0,679,6,1700,1015,518,161,3,14883,0
37,"Timis",157246,350,157246,,"GIARMATA",462,"CAMINUL CULTURAL GIARMATA STR.MORII NR.726",1696,868,812,53,3,863,5,1800,932,603,260,3,14883,0
37,"Timis",157246,350,157246,,"GIARMATA",463,"SCOALA CU CLASELE I-VIII GIARMATA, STR. PRINCIPALA NR.438",1170,596,572,22,2,592,4,1300,704,419,173,3,14883,0
37,"Timis",157246,350,157246,,"GIARMATA",464,"SCOALA GENERALA CERNETEAZ STR.PRINCIPALA NR.90",847,495,475,17,3,490,5,900,405,300,190,3,14883,0
37,"Timis",157246,350,157246,,"GIARMATA",465,"CAMIN CULTURAL GIARMATA, STR.MORII NR.726, SALA MARE",0,351,0,351,0,348,3,700,349,253,95,3,14883,1
37,"Timis",157273,350,157273,,"GIERA",466,"SEDIUL PRIMARIEI GIERA NR.192",619,286,281,5,0,283,3,700,414,160,123,3,14886,0
37,"Timis",157273,350,157273,,"GIERA",467,"SCOALA  CU CLASELE  I - IV GRANICERI,.NR.28",205,102,96,6,0,102,0,300,198,65,37,3,14886,0
37,"Timis",157273,350,157273,,"GIERA",468,"SCOALA  CU CLASEL  I - IV TOAGER, NR.237",310,183,175,8,0,183,0,388,205,78,105,3,14886,0
37,"Timis",157273,350,157273,,"GIERA",469,"PRIMARIEI  COMUNEI GIERA , STR. PRINCIPALA NR.192",0,40,0,40,0,38,2,200,160,18,20,3,14886,1
37,"Timis",155314,350,155314,,"GIROC",470,"SCOALA CU CLASELE I-VIII STR.TRANDAFIRILOR NR.59",1223,759,727,30,2,749,10,1300,541,504,245,3,14890,0
37,"Timis",155314,350,155314,,"GIROC",471,"CAMINUL CULTURAL GIROC, STR. TRANDAFIRILOR NR.26",1660,964,926,38,0,950,14,1700,736,570,380,3,14890,0
37,"Timis",155314,350,155314,,"GIROC",472,"SCOALA CU CLASELE I-VIII ""IOSIF CIOROGARIU"" CHISODA, STR.NICOLAE FIRU,NR.65",1001,574,561,13,0,560,14,1100,526,347,213,3,14890,0
37,"Timis",155314,350,155314,,"GIROC",473,"CASA NATIONALA CHISODA, STR.PRIMAVERII, NR.35",963,559,547,12,0,549,10,1100,541,328,221,3,14890,0
37,"Timis",155314,350,155314,,"GIROC",474,"SC GIROCEANA SRL GIROC, STR. SEMENIC NR.56",0,474,0,474,0,469,5,600,126,271,198,3,14890,1
37,"Timis",157317,350,157317,,"GIULVAZ",475,"SEDIUL PRIMARIEI GIULVAZ, NR.172",969,470,464,6,0,466,4,1100,630,267,199,3,14893,0
37,"Timis",157317,350,157317,,"GIULVAZ",476,"CAMINUL CULTURAL CRAI NOU,NR.88",376,230,219,11,0,229,1,499,269,170,59,3,14893,0
37,"Timis",157317,350,157317,,"GIULVAZ",477,"SCOALA CU CLASELEI-IV IVANDA, NR.254",451,228,221,7,0,227,1,500,272,134,93,3,14893,0
37,"Timis",157317,350,157317,,"GIULVAZ",478,"CAMINUL CULTURAL RUDNA, NR.108",577,261,246,15,0,258,3,700,439,175,83,3,14893,0
37,"Timis",157317,350,157317,,"GIULVAZ",479,"SCOALA CU CLS.I-IV GIULVAZ, NR.172",0,113,0,113,0,111,2,200,87,72,39,3,14893,1
37,"Timis",159419,350,159419,,"GOTTLOB",480,"SALA DE SEDINTE GOTTLOB, NR. 433",1780,903,879,9,15,897,6,1900,997,683,214,3,14898,0
37,"Timis",159419,350,159419,,"GOTTLOB",481,"SCOALA GENERALA VIZEJDIA, NR.169",379,156,147,9,0,156,0,500,344,126,30,3,14898,0
37,"Timis",159419,350,159419,,"GOTTLOB",482,"SALA DE SEDINTA GOTTLOB, NR.433A",0,69,0,69,0,69,0,200,131,56,13,3,14898,1
37,"Timis",159428,350,159428,,"IECEA MARE",483,"SCOALA CU CLASELE I-IV IECEA MARE NR.128",1151,436,429,7,0,427,9,1200,764,283,144,3,14901,0
37,"Timis",159428,350,159428,,"IECEA MARE",484,"SCOALA CU CLASELE I-IV IECEA MARE NR.128",944,334,331,3,0,331,3,1000,666,207,124,3,14901,0
37,"Timis",159428,350,159428,,"IECEA MARE",485,"PRIMARIA IECEA MARE  STR.PRINCIPALA NR. 127A",0,71,0,71,0,71,0,100,29,39,32,3,14901,1
37,"Timis",157362,350,157362,,"JAMU MARE",486,"PRIMARIA JAMU MARE, NR.181",1197,597,593,4,0,588,9,1300,703,291,297,3,14903,0
37,"Timis",157362,350,157362,,"JAMU MARE",487,"SCOALA CLOPODIA, NR.259-260",583,301,289,12,0,297,4,700,399,178,119,3,14903,0
37,"Timis",157362,350,157362,,"JAMU MARE",488,"SCOALA  FERENDIA, NR.2",384,215,209,6,0,213,2,500,285,139,74,3,14903,0
37,"Timis",157362,350,157362,,"JAMU MARE",489,"CAMINUL CULTURAL GHERMAN, NR.86",213,127,120,7,0,126,1,300,173,75,51,3,14903,0
37,"Timis",157362,350,157362,,"JAMU MARE",490,"SCOALA LATUNAS, NR.280",216,129,122,7,0,128,1,300,171,54,74,3,14903,0
37,"Timis",157362,350,157362,,"JAMU MARE",491,"CAMINUL CULTURAL JAMU MARE, NR.15",0,152,0,152,0,150,2,300,148,79,71,3,14903,1
37,"Timis",157424,350,157424,,"JEBEL",492,"CASA NATIONALA JEBEL, NR.831",1425,752,737,11,4,748,4,1500,748,470,278,3,14909,0
37,"Timis",157424,350,157424,,"JEBEL",493,"GRADINITA JEBEL, NR.832",1402,779,745,23,11,771,8,1400,621,428,343,3,14909,0
37,"Timis",157424,350,157424,,"JEBEL",494,"SCOALA GENERALA CU CL.I-VIII ""MARTIN SUBONI"", JEBEL NR.830",0,343,0,343,0,339,4,402,59,182,157,3,14909,1
37,"Timis",157451,350,157451,,"LENAUHEIM",495,"CAMINUL CULTURAL LENAUHEIM, NR.205",1521,762,737,6,19,752,10,1597,835,529,223,3,14911,0
37,"Timis",157451,350,157451,,"LENAUHEIM",496,"CAMINUL CULTURAL BULGARUS, NR.251",1692,861,813,10,38,852,9,1800,939,604,248,3,14911,0
37,"Timis",157451,350,157451,,"LENAUHEIM",497,"CAMINUL CULTURAL GRABAT,  NR.238",1756,879,858,10,11,871,8,1800,921,702,169,3,14911,0
37,"Timis",157451,350,157451,,"LENAUHEIM",498,"CAMINUL CULTURAL BULGARUS, NR.251",0,128,0,128,0,128,0,300,172,91,37,3,14911,1
37,"Timis",157497,350,157497,,"LIEBLING",499,"CAMINUL CULTURAL  LIEBLING, NR.466",1489,708,694,14,0,703,5,1600,892,426,277,3,14915,0
37,"Timis",157497,350,157497,,"LIEBLING",500,"SCOALA CU CLASELE I-VIII LIEBLING, NR.523-524",1202,620,610,10,0,616,4,1300,680,362,254,3,14915,0
37,"Timis",157497,350,157497,,"LIEBLING",501,"CLADIREA FOSTEI PRIMARII DIN CERNA, NR.70",209,100,92,8,0,100,0,300,200,69,31,3,14915,0
37,"Timis",157497,350,157497,,"LIEBLING",502,"CAMINUL CULTURAL SATUL IOSIF, NR.139",247,124,113,11,0,123,1,300,176,88,35,3,14915,0
37,"Timis",157497,350,157497,,"LIEBLING",503,"GRADINITA CU PN, LIEBLING NR.55",0,142,0,142,0,141,1,200,58,87,54,3,14915,1
37,"Timis",159491,350,159491,,"LIVEZILE",504,"SCOALA CU CLASELE V-VIII  LIVEZILE, NR.197",905,403,398,5,0,398,5,1000,597,190,208,3,14919,0
37,"Timis",159491,350,159491,,"LIVEZILE",505,"SCOALA CU CLASELE I - IV  DOLAT, NR.234",446,178,168,10,0,178,0,500,322,131,47,3,14919,0
37,"Timis",159491,350,159491,,"LIVEZILE",506,"SCOALA CU CLASELE V-VIII  LIVEZILE, NR.197",0,55,0,55,0,54,1,200,145,30,24,3,14919,1
37,"Timis",157530,350,157530,,"LOVRIN",507,"GRUP SCOLAR ""ROMULUS PARASCHIVOIU"" LOVRIN NR. 202-203",2032,845,832,13,0,835,10,2100,1255,564,271,3,14922,0
37,"Timis",157530,350,157530,,"LOVRIN",508,"STRANDUL  TERMAL LOVRIN,NR. 752/B",1374,673,651,22,0,668,5,1500,827,468,200,3,14922,0
37,"Timis",157530,350,157530,,"LOVRIN",509,"STATIA CFR LOVRIN, NR.760",0,87,0,87,0,87,0,302,215,55,32,3,14922,1
37,"Timis",157585,350,157585,,"MARGINA",510,"CAMINUL CULTURAL MARGINA",1028,539,528,6,5,535,4,1017,478,169,366,3,14929,0
37,"Timis",157585,350,157585,,"MARGINA",511,"CAMINUL CULTURAL BREAZOVA",200,139,133,6,0,138,1,300,161,54,84,3,14929,0
37,"Timis",157585,350,157585,,"MARGINA",512,"CAMINUL CULTURAL COSTEIU DE SUS",185,112,108,4,0,111,1,300,188,54,57,3,14929,0
37,"Timis",157585,350,157585,,"MARGINA",513,"CAMINUL CULTURAL GROSI",115,68,61,7,0,68,0,200,132,29,39,3,14929,0
37,"Timis",157585,350,157585,,"MARGINA",514,"CAMINUL CULTURAL SINTESTI",393,254,247,7,0,252,2,503,249,166,86,3,14929,0
37,"Timis",157585,350,157585,,"MARGINA",515,"SCOALA GENERALA CU CLS.I-VIII ""SORIN TITEL"" MARGINA, STR.PRINCIPALA NR.121",0,99,0,99,0,97,2,200,101,48,49,3,14929,1
37,"Timis",157683,350,157683,,"MASLOC",516,"PRIMARIA MASLOC, NR.95",825,362,347,10,5,362,0,900,538,202,160,3,14939,0
37,"Timis",157683,350,157683,,"MASLOC",517,"CAMINUL CULTURAL ALIOS, NR.264",714,393,376,16,1,390,3,800,407,260,130,3,14939,0
37,"Timis",157683,350,157683,,"MASLOC",518,"CAMINUL CULTURAL REMETEA MICA",453,236,226,10,0,235,1,490,254,103,132,3,14939,0
37,"Timis",157683,350,157683,,"MASLOC",519,"PRIMARIA COMUNEI MASLOC, NR.95",0,138,0,138,0,137,1,300,162,63,74,3,14939,1
37,"Timis",157736,350,157736,,"MANASTIUR",520,"SCOALA GENERALA MANASTIUR, NR.299",969,505,499,6,0,500,5,1100,595,277,223,3,14924,0
37,"Timis",157736,350,157736,,"MANASTIUR",521,"SCOALA GENERALA PADURANI, NR.24",76,55,48,7,0,54,1,200,145,35,19,3,14924,0
37,"Timis",157736,350,157736,,"MANASTIUR",522,"SCOALA GENERALA REMETEA LUNCA, NR.64",328,165,160,5,0,165,0,400,235,92,73,3,14924,0
37,"Timis",157736,350,157736,,"MANASTIUR",523,"GARA MANASTIUR",0,72,0,72,0,72,0,200,128,43,29,3,14924,1
37,"Timis",157781,350,157781,,"MORAVITA",524,"SEDIUL PRIMARIEI  MORAVITA, NR.261",1002,489,484,5,0,484,5,1100,611,243,241,3,14943,0
37,"Timis",157781,350,157781,,"MORAVITA",525,"CASA NATIONALA DEJAN , NR.115",202,110,99,11,0,109,1,200,90,39,70,3,14943,0
37,"Timis",157781,350,157781,,"MORAVITA",526,"CASA NATIONALA GAIUL MIC NR. 126",146,112,101,11,0,110,2,200,88,33,77,3,14943,0
37,"Timis",157781,350,157781,,"MORAVITA",527,"SCOALA GENERALA STAMORA GERMANA , NR.186",819,394,384,10,0,391,3,900,506,157,234,3,14943,0
37,"Timis",157781,350,157781,,"MORAVITA",528,"CASA NATIONALA MORAVITA, NR.285",0,147,0,147,0,146,1,400,253,86,60,3,14943,1
37,"Timis",157834,350,157834,,"MOSNITA NOUA",529,"SCOALA  CU CLASELE I-VIII MOSNITA NOUA, NR.277",1655,953,935,16,2,939,14,1700,747,627,312,3,14948,0
37,"Timis",157834,350,157834,,"MOSNITA NOUA",530,"SCOALA CU CLASELE I-IV ALBINA NR.92",260,164,159,5,0,163,1,300,136,89,74,3,14948,0
37,"Timis",157834,350,157834,,"MOSNITA NOUA",531,"SCOALA CU CLASELE I-IV, MOSNITA VECHE, NR.262",1157,645,608,19,18,638,7,1201,556,427,211,3,14948,0
37,"Timis",157834,350,157834,,"MOSNITA NOUA",532,"GRADINITA CU PN, URSENI, NR.192",1026,594,568,11,15,588,6,1098,504,426,162,3,14948,0
37,"Timis",157834,350,157834,,"MOSNITA NOUA",533,"GRADINITA CU PN, MOSNITA NOUA, NR.304",0,367,0,367,0,362,5,602,235,200,162,3,14948,1
37,"Timis",157898,350,157898,,"NADRAG",534,"GRADINITA NADRAG STR.GRADINITEI, NR.1",1106,640,624,6,10,626,14,1200,560,340,286,3,14954,0
37,"Timis",157898,350,157898,,"NADRAG",535,"SCOALA GENERALA NADRAG STR.SCOLII, NR.1",1190,663,639,4,20,656,7,1300,637,439,217,3,14954,0
37,"Timis",157898,350,157898,,"NADRAG",536,"SCOALA GENERALA CRIVINA, NR.70",250,207,192,8,7,205,2,300,93,138,67,3,14954,0
37,"Timis",157898,350,157898,,"NADRAG",537,"PRIMARIA COMUNEI NADRAG, PIATA CENTRALA NR.2, BL.1",0,81,0,81,0,80,1,200,119,55,25,3,14954,1
37,"Timis",157923,350,157923,,"NITCHIDORF",538,"PRIMARIA NITCHIDORF, NR.212, HOL",1028,488,484,4,0,482,6,1100,612,289,193,3,14957,0
37,"Timis",157923,350,157923,,"NITCHIDORF",539,"CASA NATIONALA BLAJOVA, NR.53",120,60,50,10,0,60,0,200,140,30,30,3,14957,0
37,"Timis",157923,350,157923,,"NITCHIDORF",540,"CAMINUL CULTURAL DUBOZ, NR.157",165,101,89,12,0,99,2,300,199,44,55,3,14957,0
37,"Timis",157923,350,157923,,"NITCHIDORF",541,"CENTRU DE PERMANENTA NITCHIDORF, NR.212",0,53,0,53,0,53,0,200,147,20,33,3,14957,1
37,"Timis",157969,350,157969,,"OHABA LUNGA",542,"CAMINUL CULTURAL  OHABA LUNGA, NR.36",320,216,213,3,0,215,1,400,184,94,121,3,14961,0
37,"Timis",157969,350,157969,,"OHABA LUNGA",543,"SCOALA CU CLASELE I-IV  DUBESTI ,NR.145",236,150,146,4,0,148,2,300,150,100,48,3,14961,0
37,"Timis",157969,350,157969,,"OHABA LUNGA",544,"CAMINUL CULTURAL IERSNIC, NR.126",154,115,106,5,4,114,1,200,85,34,80,3,14961,0
37,"Timis",157969,350,157969,,"OHABA LUNGA",545,"CAMINUL CULTURAL OHABA ROMANA, NR.167",208,162,155,7,0,159,3,300,138,56,103,3,14961,0
37,"Timis",157969,350,157969,,"OHABA LUNGA",546,"SCOALA GENERALA CU CLS.I-VIII OHABA LUNGA, NR.93",0,46,0,46,0,46,0,100,54,13,33,3,14961,1
37,"Timis",158010,350,158010,,"ORTISOARA",547,"CAMINUL CULTURAL ORTISOARA, NR. 266",1971,973,965,8,0,960,13,2100,1127,600,360,3,14966,0
37,"Timis",158010,350,158010,,"ORTISOARA",548,"SCOALA GENERALA CALACEA, NR. 94",579,338,332,6,0,337,1,700,362,191,146,3,14966,0
37,"Timis",158010,350,158010,,"ORTISOARA",549,"SCOALA GENERALA  CORNESTI, NR.97",472,298,291,7,0,296,2,600,302,213,83,3,14966,0
37,"Timis",158010,350,158010,,"ORTISOARA",550,"CAMINUL CULTURAL SECEANI , NR.100",456,293,286,7,0,291,2,500,207,151,140,3,14966,0
37,"Timis",158010,350,158010,,"ORTISOARA",551,"GARA ORTISOARA, NR.620",0,245,0,245,0,244,1,400,155,121,123,3,14966,1
37,"Timis",159525,350,159525,,"OTELEC",552,"CAMINUL CULTURAL OTELEC NR.458",696,327,317,10,0,323,4,800,473,241,82,3,14971,0
37,"Timis",159525,350,159525,,"OTELEC",553,"CAMINUL CULTURAL  IOHANISFELD NR.102",771,335,330,4,1,334,1,900,565,227,107,3,14971,0
37,"Timis",159525,350,159525,,"OTELEC",554,"GRADINITA OTELEC, NR.170",0,78,0,78,0,78,0,100,22,45,33,3,14971,1
37,"Timis",159437,350,159437,,"PARTA",555,"PRIMARIA COMUNEI  PARTA,NR. 282",1549,838,827,11,0,824,14,1599,761,421,403,3,14976,0
37,"Timis",159437,350,159437,,"PARTA",556,"PRIMARIA COMUNEI PARTA,NR. 282",0,184,0,184,0,184,0,300,116,74,110,3,14976,1
37,"Timis",159446,350,159446,,"PADURENI",557,"SCOALA GENERALA CU CLS.I-VIII PADURENI, NR.221",1350,840,775,6,59,826,14,1508,668,560,266,3,14974,0
37,"Timis",159446,350,159446,,"PADURENI",558,"SCOALA GENERALA CU CLS.I-VIII PADURENI, NR.221",0,212,0,212,0,210,2,300,88,159,51,3,14974,1
37,"Timis",158065,350,158065,,"PECIU NOU",559,"LICEUL TEORETIC PECIU NOU, NR.309",1654,768,753,15,0,761,7,1800,1032,503,258,3,14978,0
37,"Timis",158065,350,158065,,"PECIU NOU",560,"SCOALA CU CLASELE I-IV  PECIU NOU, NR.63",1145,547,529,18,0,546,1,1200,653,399,147,3,14978,0
37,"Timis",158065,350,158065,,"PECIU NOU",561,"CAMINUL CULTURAL  DINIAS NR.192",787,451,438,13,0,446,5,900,449,355,91,3,14978,0
37,"Timis",158065,350,158065,,"PECIU NOU",562,"SCOALA GENERALA CU CLS. I-VIII SANMARTINU SARBESC NR.325",786,348,339,7,2,341,7,883,535,246,95,3,14978,0
37,"Timis",158065,350,158065,,"PECIU NOU",563,"GARA PECIU NOU",0,271,0,271,0,270,1,300,29,193,77,3,14978,1
37,"Timis",158109,350,158109,,"PERIAM",564,"LICEUL TEORETIC PERIAM, STR.MAGNOLIEI NR.2",1990,1142,1079,20,43,1133,9,2100,958,729,404,3,14982,0
37,"Timis",158109,350,158109,,"PERIAM",565,"LICEUL TEORETIC PERIAM, STR.VIORELELOR NR.1",2041,1316,1222,49,45,1303,13,2100,784,738,565,3,14982,0
37,"Timis",158109,350,158109,,"PERIAM",566,"LICEUL TEORETIC PERIAM, STR.VIORELELOR NR.1, LOCALUL NR.2",0,175,0,175,0,175,0,400,225,117,58,3,14982,1
37,"Timis",159507,350,159507,,"PESAC",567,"CAMIN CULTURAL  PESAC, NR.355",1712,970,932,7,31,965,5,1800,830,516,449,3,14984,0
37,"Timis",159507,350,159507,,"PESAC",568,"SCOALA GENERALA CU CLS.I-VIII PESAC, NR.279",0,108,0,108,0,108,0,200,92,58,50,3,14984,1
37,"Timis",158136,350,158136,,"PIETROASA",569,"CAMINUL CULTURAL PIETROASA NR.27D",274,219,209,5,5,213,6,400,181,86,127,3,14986,0
37,"Timis",158136,350,158136,,"PIETROASA",570,"CAMINUL CULTURAL CRIVINA DE SUS NR.9",152,125,113,10,2,124,1,200,75,48,76,3,14986,0
37,"Timis",158136,350,158136,,"PIETROASA",571,"CAMINUL CULTURAL FARASESTI NR.7",184,144,134,8,2,142,2,300,156,57,85,3,14986,0
37,"Timis",158136,350,158136,,"PIETROASA",572,"CAMINUL CULTURAL POIENI NR.19",208,182,176,6,0,181,1,300,118,65,116,3,14986,0
37,"Timis",158136,350,158136,,"PIETROASA",573,"SCOALA PRIMARA CU CLS.I-IV PIETROASA , NR.27C",0,56,0,56,0,56,0,100,44,33,23,3,14986,1
37,"Timis",158181,350,158181,,"PISCHIA",574,"SCOALA CU CLS.I-VIII PISCHIA , NR.17",1038,610,588,8,14,608,2,1100,490,408,200,3,14991,0
37,"Timis",158181,350,158181,,"PISCHIA",575,"SCOALA GENERALA CU CLASELE  I-IV BENCECU DE JOS, NR.70, SALA DE CLASA NR.1",306,221,192,13,16,220,1,400,179,103,117,3,14991,0
37,"Timis",158181,350,158181,,"PISCHIA",576,"SCOALA CU CLASELE I-VIII  BENCECU DE SUS, NR.125, SALA 1",718,451,425,14,12,448,3,801,350,286,162,3,14991,0
37,"Timis",158181,350,158181,,"PISCHIA",577,"SCOALA CU CLS.I-IV MURANI, NR.386",386,251,243,8,0,248,3,485,234,161,87,3,14991,0
37,"Timis",158181,350,158181,,"PISCHIA",578,"SCOALA GENERALA CU CLS.I-VIII PISCHIA , STR.PRINCIPALA NR.17",0,213,0,213,0,211,2,300,87,138,73,3,14991,1
37,"Timis",158243,350,158243,,"RACOVITA",579,"CAMIN CULTURAL  RACOVITA",731,422,416,6,0,418,4,800,378,260,158,3,14997,0
37,"Timis",158243,350,158243,,"RACOVITA",580,"SCOALA CU CLASELE I-IV CAPAT",221,124,118,6,0,123,1,300,176,66,57,3,14997,0
37,"Timis",158243,350,158243,,"RACOVITA",581,"SCOALA CU CLASELE I-IV DRAGOIESTI",341,174,163,11,0,174,0,400,226,106,68,3,14997,0
37,"Timis",158243,350,158243,,"RACOVITA",582,"SCOALA CU CLASELE I-IV FICATAR",341,181,173,8,0,180,1,400,219,132,48,3,14997,0
37,"Timis",158243,350,158243,,"RACOVITA",583,"CAMIN CULTURAL HITIAS",662,414,406,8,0,410,4,800,386,248,162,3,14997,0
37,"Timis",158243,350,158243,,"RACOVITA",584,"SCOALA CU CLASELE I-IV SARBOVA",211,126,118,8,0,126,0,300,174,71,55,3,14997,0
37,"Timis",158243,350,158243,,"RACOVITA",585,"SCOALA  GENERALA CU CLS.I-VIII RACOVITA",0,178,0,178,0,177,1,200,22,118,59,3,14997,1
37,"Timis",158396,350,158396,,"REMETEA MARE",586,"SCOALA GENERALA CU CLASELE I - VIII  REMETEA MARE, SALA 1",1132,619,613,6,0,613,6,1200,581,362,251,3,15004,0
37,"Timis",158396,350,158396,,"REMETEA MARE",587,"SCOALA GENERALA CU CLASELE  I - VIII  IANOVA",680,379,364,11,4,376,3,800,421,227,149,3,15004,0
37,"Timis",158396,350,158396,,"REMETEA MARE",588,"SCOALA GENERALA CU CLASELE I - VIII  REMETEA MARE,",0,208,0,208,0,208,0,300,92,105,103,3,15004,1
37,"Timis",158449,350,158449,,"SACOSU TURCESC",589,"SCOALA CU CLS.I-VIII SACOSU TURCESC, NR.1A",660,432,406,14,12,429,3,800,368,327,102,3,15011,0
37,"Timis",158449,350,158449,,"SACOSU TURCESC",590,"SCOALA CU CLS.I-IV  BERINI, NR.126",398,223,213,10,0,221,2,503,280,155,66,3,15011,0
37,"Timis",158449,350,158449,,"SACOSU TURCESC",591,"SCOALA  CU CLASELE I-IV ICLODA, NR.57",212,145,128,7,10,143,2,300,155,103,40,3,15011,0
37,"Timis",158449,350,158449,,"SACOSU TURCESC",592,"SCOALA  CU CLASELE I-IV OTVESTI, NR.158",289,170,151,11,8,169,1,400,230,125,44,3,15011,0
37,"Timis",158449,350,158449,,"SACOSU TURCESC",593,"SCOALA CU CLASELE I-IV STAMORA ROMANA, NR.80",218,108,94,10,4,108,0,300,192,86,22,3,15011,0
37,"Timis",158449,350,158449,,"SACOSU TURCESC",594,"SCOALA CU CLASELE I-VIII  ULIUC, NR.130B",519,313,298,15,0,313,0,600,287,234,79,3,15011,0
37,"Timis",158449,350,158449,,"SACOSU TURCESC",595,"SCOALA  CU CLASELE  I-IV UNIP, NR.64",194,130,120,10,0,130,0,300,170,90,40,3,15011,0
37,"Timis",158449,350,158449,,"SACOSU TURCESC",596,"CAMINUL CULTURAL  SACOSU TURCESC, STR. PRINCIPALA NR.227",0,287,0,287,0,287,0,500,213,195,92,3,15011,1
37,"Timis",159455,350,159455,,"SARAVALE",597,"PRIMARIA SARAVALE, NR.167B",1216,763,720,24,19,750,13,1400,637,485,265,3,15035,0
37,"Timis",159455,350,159455,,"SARAVALE",598,"CAMINUL CULTURAL , SARAVALE, NR.673",820,501,459,22,20,495,6,900,399,300,195,3,15035,0
37,"Timis",159455,350,159455,,"SARAVALE",599,"PRIMARIA COMUNEI SARAVALE, NR.167B",0,64,0,64,0,64,0,200,136,36,28,3,15035,1
37,"Timis",158528,350,158528,,"SATCHINEZ",600,"SCOALA  CU CLASELE V - VIII  SATCHINEZ,STR. DALIEI NR.67",1212,571,561,8,2,568,3,1300,729,399,169,3,15037,0
37,"Timis",158528,350,158528,,"SATCHINEZ",601,"SCOALA  CU CLASELE V - VIII  SATCHINEZ, STR.DALIEI NR.67",1151,507,503,3,1,500,7,1200,693,359,141,3,15037,0
37,"Timis",158528,350,158528,,"SATCHINEZ",602,"SCOALA  CU CLASELE  I - IV BARATEAZ, STR.PRINCIPALA NR.16",545,274,261,13,0,269,5,600,326,190,79,3,15037,0
37,"Timis",158528,350,158528,,"SATCHINEZ",603,"SCOALA GENERALA  CU CLASELE V- VIII HODONI, STR. GERMANA NR.21",984,486,470,15,1,486,0,1100,614,322,164,3,15037,0
37,"Timis",158528,350,158528,,"SATCHINEZ",604,"SCOALA GENERALA CU CLS.V-VIII SATCHINEZ, STR.DALIEI NR.67",0,171,0,171,0,169,2,199,28,122,47,3,15037,1
37,"Timis",158564,350,158564,,"SACALAZ",605,"SCOALA GENERALA  SACALAZ, STR.IV-A NR.294, SALA 1",1480,753,739,13,1,743,10,1600,847,511,232,3,15007,0
37,"Timis",158564,350,158564,,"SACALAZ",606,"SCOALA GENERALA  SACALAZ, STR.IV-A NR.294, SALA 2",974,488,474,14,0,483,5,1100,612,287,196,3,15007,0
37,"Timis",158564,350,158564,,"SACALAZ",607,"CAMINUL CULTURAL SACALAZ, NR.369",1301,645,625,19,1,638,7,1400,755,417,221,3,15007,0
37,"Timis",158564,350,158564,,"SACALAZ",608,"CAMINUL CULTURAL  BEREGSAU MARE, STR. PRINCIPALA",1518,798,787,11,0,792,6,1600,802,543,249,3,15007,0
37,"Timis",158564,350,158564,,"SACALAZ",609,"CAMINUL CULTURAL BEREGSAU MIC",677,376,362,14,0,376,0,800,424,251,125,3,15007,0
37,"Timis",158564,350,158564,,"SACALAZ",610,"GARA SACALAZ, STR.I",0,352,0,352,0,350,2,600,248,216,134,3,15007,1
37,"Timis",158608,350,158608,,"SECAS",611,"SEDIUL PRIMARIEI SECAS, STR.PRINCIPALA, NR.19",323,163,163,0,0,163,0,400,237,64,99,3,15041,0
37,"Timis",158608,350,158608,,"SECAS",612,"SCOAL CU CLS.I-IV SECAS, STR.PRINCIPALA NR.72",0,63,0,63,0,63,0,99,36,27,36,3,15041,1
37,"Timis",158653,350,158653,,"SANANDREI",613,"CAMINUL CULTURAL SINANDREI, NR.516",1533,729,717,10,2,727,2,1600,871,471,256,3,15021,0
37,"Timis",158653,350,158653,,"SANANDREI",614,"SCOALA GENERALA  SANANDREI, NR.515",1391,659,643,16,0,657,2,1500,841,415,242,3,15021,0
37,"Timis",158653,350,158653,,"SANANDREI",615,"CAMINUL CULTURAL CARANI,NR.216",1621,814,797,7,10,804,10,1700,886,561,243,3,15021,0
37,"Timis",158653,350,158653,,"SANANDREI",616,"CAMINUL CULTURAL COVACI, NR.115",718,429,417,12,0,426,3,800,371,238,188,3,15021,0
37,"Timis",158653,350,158653,,"SANANDREI",617,"CAMINUL CULTURAL SANANDREI, NR.516",0,295,0,295,0,295,0,600,305,196,99,3,15021,1
37,"Timis",158699,350,158699,,"SANMIHAIU ROMAN",618,"SEDIUL PRIMARIEI SANMIHAIU ROMAN , NR.1",1895,1043,1018,25,0,1037,6,2000,957,676,361,3,15028,0
37,"Timis",158699,350,158699,,"SANMIHAIU ROMAN",619,"SCOALA  CU CLASELE I-IV SANMIHAIU GERMAN",697,362,355,7,0,362,0,793,431,309,53,3,15028,0
37,"Timis",158699,350,158699,,"SANMIHAIU ROMAN",620,"GRADINITA CU P.N  UTVIN, NR.92, SALA 1",1799,989,983,6,0,982,7,1900,911,734,248,3,15028,0
37,"Timis",158699,350,158699,,"SANMIHAIU ROMAN",621,"GRADINITA CU P.N  UTVIN, NR.93, SALA 2",0,279,0,279,0,279,0,500,221,171,108,3,15028,1
37,"Timis",158733,350,158733,,"SANPETRU MARE",622,"SEDIUL PRIMARIEI SANPETRU MARE, NR. 1",984,496,485,11,0,492,4,1100,604,286,206,3,15032,0
37,"Timis",158733,350,158733,,"SANPETRU MARE",623,"SEDIUL PRIMARIEI SANPETRU MARE NR. 1",832,456,448,8,0,448,8,900,444,272,176,3,15032,0
37,"Timis",158733,350,158733,,"SANPETRU MARE",624,"SCOALA CU CLASELE I-VIII IGRIS  NR.809",938,704,693,11,0,694,10,1000,296,402,292,3,15032,0
37,"Timis",158733,350,158733,,"SANPETRU MARE",625,"SCOALA  GENERALA CU CU CLASELE I-VIII SANPETRU MARE NR.310",0,93,0,93,0,91,2,200,107,53,38,3,15032,1
37,"Timis",158779,350,158779,,"SAG",626,"CASA NATIONALA DE CULTURA ""MIHAI VITEAZU"" SAG STR.A-VIII-A NR.13-15",1230,692,676,11,5,687,5,1400,708,452,235,3,15019,0
37,"Timis",158779,350,158779,,"SAG",627,"CASA NATIONALA DE CULTURA ""MIHAI VITEAZU"" SAG STR.A-VIII-A NR.13-15",1247,726,710,10,6,722,4,1400,674,447,275,3,15019,0
37,"Timis",158779,350,158779,,"SAG",628,"CASA NATIONALA DE CULTURA ""MIHAI VITEAZU"" SAG STR.A-VIII-A NR.13-15",0,405,0,405,0,401,4,600,195,241,160,3,15019,1
37,"Timis",159464,350,159464,,"SANDRA",629,"SCOALA GENERALA CU CLASELE V-VIII SANDRA NR.29",1200,606,604,2,0,597,9,1300,694,325,272,3,15025,0
37,"Timis",159464,350,159464,,"SANDRA",630,"SCOALA GENERALA CU CLASELE I-IV SANDRA, NR.447",752,418,400,18,0,412,6,800,382,225,187,3,15025,0
37,"Timis",159464,350,159464,,"SANDRA",631,"SCOALA CU CLASELE I-IV UIHEI NR.182",443,237,229,8,0,234,3,500,263,151,83,3,15025,0
37,"Timis",159464,350,159464,,"SANDRA",632,"SCOALA GENERALA CU CLASELE V-VIII SANDRA NR.29",0,128,0,128,0,124,4,300,172,75,49,3,15025,1
37,"Timis",158804,350,158804,,"STIUCA",633,"CAMINUL CULTURAL STIUCA, NR. 112",694,343,341,1,1,342,1,800,457,181,161,3,15046,0
37,"Timis",158804,350,158804,,"STIUCA",634,"CAMIN CULTURAL  DRAGOMIRESTI, NR. 29",264,150,143,6,1,148,2,400,250,121,27,3,15046,0
37,"Timis",158804,350,158804,,"STIUCA",635,"CAMINUL CULTURAL OLOSAG, NR. 125",220,125,117,8,0,124,1,300,175,86,38,3,15046,0
37,"Timis",158804,350,158804,,"STIUCA",636,"CAMINUL CULTURAL ZGRIBESTI, NR. 141",202,129,120,7,2,129,0,300,171,52,77,3,15046,0
37,"Timis",158804,350,158804,,"STIUCA",637,"CAMINUL CULTURAL STIUCA, NR. 112",0,74,0,74,0,72,2,200,126,37,35,3,15046,1
37,"Timis",158859,350,158859,,"TEREMIA MARE",638,"CENTRUL CULTURAL TEREMIA MARE NR. 74 SALA DE SEDINTE",1111,477,464,13,0,476,1,1197,720,267,209,3,15051,0
37,"Timis",158859,350,158859,,"TEREMIA MARE",639,"CENTRUL CULTURAL TEREMIA MARE NR. 74 SALA DE SPORT",1154,491,482,7,2,489,2,1200,709,284,205,3,15051,0
37,"Timis",158859,350,158859,,"TEREMIA MARE",640,"SCOALA CU CLS.I-VIII  NERAU",905,506,484,15,7,502,4,1000,494,370,132,3,15051,0
37,"Timis",158859,350,158859,,"TEREMIA MARE",641,"SCOALA CU CLASELE I-IV  TEREMIA MICA, NR.306",567,297,282,15,0,297,0,700,403,241,56,3,15051,0
37,"Timis",158859,350,158859,,"TEREMIA MARE",642,"GRADINITA CU PN NERAU, NR.186",0,82,0,82,0,82,0,200,118,55,27,3,15051,1
37,"Timis",158895,350,158895,,"TOMESTI",643,"SCOALA CU CLS.I-VIII,  COLONIA FABRICII NR.17",755,371,367,4,0,368,3,800,429,163,205,3,15055,0
37,"Timis",158895,350,158895,,"TOMESTI",644,"SCOALA CU CLS.I-IV BALOSESTI NR.25",107,84,78,6,0,82,2,200,116,46,36,3,15055,0
37,"Timis",158895,350,158895,,"TOMESTI",645,"SCOALA CU CLS.I-IV LUNCANII DE JOS NR.138",328,248,244,4,0,244,4,400,152,132,112,3,15055,0
37,"Timis",158895,350,158895,,"TOMESTI",646,"SCOALA CU CLS.I-IV ROMANESTI NR.120",473,281,275,4,2,276,5,500,219,122,154,3,15055,0
37,"Timis",158895,350,158895,,"TOMESTI",647,"SCOALA CU CLS.I-IV TOMESTI NR.53",288,193,182,7,4,190,3,400,207,116,74,3,15055,0
37,"Timis",158895,350,158895,,"TOMESTI",648,"SCOALA GENERALA TOMESTI, COLONIA FABRICII NR.14, CLASA LA ET. 1",0,79,0,79,0,76,3,201,122,43,33,3,15055,1
37,"Timis",159473,350,159473,,"TOMNATIC",649,"PRIMARIA  TOMNATIC NR.258 CORP A",1688,811,798,8,5,794,17,1800,989,598,196,3,15062,0
37,"Timis",159473,350,159473,,"TOMNATIC",650,"PRIMARIA TOMNATIC  NR.258 CORP B",1267,657,643,8,6,648,9,1398,741,472,176,3,15062,0
37,"Timis",159473,350,159473,,"TOMNATIC",651,"SCOALA GENERALA CU CLS. I-VIII TOMNATIC, NR.649",0,58,0,58,0,58,0,197,139,36,22,3,15062,1
37,"Timis",158966,350,158966,,"TOPOLOVATU MARE",652,"PRIMARIA TOPOLOVATU MARE NR.321",986,593,584,6,3,591,2,1100,507,433,158,3,15064,0
37,"Timis",158966,350,158966,,"TOPOLOVATU MARE",653,"CAMINUL CULTURAL  CRALOVAT NR.131",134,62,56,6,0,62,0,200,138,39,23,3,15064,0
37,"Timis",158966,350,158966,,"TOPOLOVATU MARE",654,"SEDIUL FOSTULUI CAP ICTAR - BUDINTI NR.175",350,171,169,2,0,168,3,400,229,144,24,3,15064,0
37,"Timis",158966,350,158966,,"TOPOLOVATU MARE",655,"SCOALA CLASELE  I-VIII IOSIFALAU NR.184",450,220,213,7,0,215,5,500,280,176,39,3,15064,0
37,"Timis",158966,350,158966,,"TOPOLOVATU MARE",656,"CAMINUL CULTURAL SUSTRA NR.118",332,179,171,8,0,176,3,400,221,125,51,3,15064,0
37,"Timis",158966,350,158966,,"TOPOLOVATU MARE",657,"PRIMARIA TOPOLOVATU MARE NR.321",0,250,0,250,0,250,0,300,50,171,79,3,15064,1
37,"Timis",159035,350,159035,,"TORMAC",658,"CAMINUL CULTURAL TORMAC, NR.464",1363,562,560,1,1,561,1,1400,838,367,194,3,15071,0
37,"Timis",159035,350,159035,,"TORMAC",659,"CAMINUL CULTURAL CADAR, NR.1",215,151,144,5,2,150,1,300,149,103,47,3,15071,0
37,"Timis",159035,350,159035,,"TORMAC",660,"SCOALA GENERALA CU CLS. I-VIII  SIPET, NR.54",662,332,329,3,0,328,4,800,468,162,166,3,15071,0
37,"Timis",159035,350,159035,,"TORMAC",661,"CAMINUL CULTURAL TORMAC, NR.464, SALA MICA",0,80,0,80,0,80,0,202,122,45,35,3,15071,1
37,"Timis",159071,350,159071,,"TRAIAN VUIA",662,"TELECENTRUL ""TRAIAN VUIA"" SUDRIAS, NR.46",634,298,291,4,3,298,0,700,402,176,122,3,15075,0
37,"Timis",159071,350,159071,,"TRAIAN VUIA",663,"CAMINUL CULTURAL SACENI, NR.42C",170,106,104,2,0,106,0,300,194,67,39,3,15075,0
37,"Timis",159071,350,159071,,"TRAIAN VUIA",664,"CAMINUL CULTURAL SURDUCUL MIC, NR.50A",292,176,168,6,2,174,2,401,225,95,79,3,15075,0
37,"Timis",159071,350,159071,,"TRAIAN VUIA",665,"CAMINUL CULTURAL SUSANI,NR.139",302,174,169,5,0,172,2,400,226,89,83,3,15075,0
37,"Timis",159071,350,159071,,"TRAIAN VUIA",666,"CAMINUL CULTURAL TRAIAN VUIA, NR.34",360,232,228,2,2,230,2,500,268,132,98,3,15075,0
37,"Timis",159071,350,159071,,"TRAIAN VUIA",667,"SCOALA GENERALA CU CLS.I-IV TRAIAN VUIA NR.106",0,84,0,84,0,84,0,200,116,51,33,3,15075,1
37,"Timis",159142,350,159142,,"UIVAR",668,"CAMINUL CULTURAL UIVAR,NR.160",1163,422,416,6,0,414,8,1300,878,259,155,3,15082,0
37,"Timis",159142,350,159142,,"UIVAR",669,"SCOALA GENERALA PUSTINIS, NR.123",551,293,280,13,0,292,1,600,307,176,116,3,15082,0
37,"Timis",159142,350,159142,,"UIVAR",670,"SCOALA GENERALA  RAUTI,NR.87",446,240,231,9,0,238,2,500,260,192,46,3,15082,0
37,"Timis",159142,350,159142,,"UIVAR",671,"SCOALA GENERALA SANMARTINUL MAGHIAR NR.58",204,123,113,10,0,120,3,302,179,77,43,3,15082,0
37,"Timis",159142,350,159142,,"UIVAR",672,"SCOALA GENERALA CU CLS.I-VIII UIVAR,STR. PRINCIPALA NR.132",0,113,0,113,0,112,1,299,186,65,47,3,15082,1
37,"Timis",159482,350,159482,,"VALCANI",673,"SEDIUL PRIMARIEI VALCANI, NR. 222",1124,588,587,1,0,581,7,1200,612,348,233,3,15087,0
37,"Timis",159482,350,159482,,"VALCANI",674,"SEDIUL PRIMARIEI VALCANI, NR. 222",0,45,0,45,0,45,0,200,155,26,19,3,15087,1
37,"Timis",159213,350,159213,,"VARIAS",675,"CAMINUL CULTURAL  VARIAS NR.292",1776,974,959,8,7,963,11,1900,926,431,532,3,15089,0
37,"Timis",159213,350,159213,,"VARIAS",676,"SCOALA CU CLS.I-VIII  VARIAS NR.416-417",1739,1054,1024,8,22,1042,12,1800,746,555,487,3,15089,0
37,"Timis",159213,350,159213,,"VARIAS",677,"CAMINUL CULTURAL GELU NR.188",1144,647,630,12,5,641,6,1200,553,407,234,3,15089,0
37,"Timis",159213,350,159213,,"VARIAS",678,"SCOALA CU CLASELE I-IV SANPETRU MIC NR.100",450,227,220,7,0,226,1,500,273,181,45,3,15089,0
37,"Timis",159213,350,159213,,"VARIAS",679,"PRIMARIA COMUNEI VARIAS, NR.619",0,446,0,446,0,435,11,700,254,259,176,3,15089,1
37,"Timis",159259,350,159259,,"VICTOR VLAD DELAMARINA",680,"CAMINUL CULTURAL V.V DELAMARINA, NR.105",383,257,247,7,3,255,2,500,243,118,137,3,15093,0
37,"Timis",159259,350,159259,,"VICTOR VLAD DELAMARINA",681,"CAMINUL CULTURAL HERENDESTI, NR.18",389,252,244,6,2,251,1,500,248,151,100,3,15093,0
37,"Timis",159259,350,159259,,"VICTOR VLAD DELAMARINA",682,"SCOALA CU CLASELE I-IV HONORICI, NR.164A",249,155,150,4,1,154,1,298,143,98,56,3,15093,0
37,"Timis",159259,350,159259,,"VICTOR VLAD DELAMARINA",683,"SCOALA CU CLASELE I-IV PADURENI, NR.68",171,125,99,17,9,124,1,301,176,57,67,3,15093,0
37,"Timis",159259,350,159259,,"VICTOR VLAD DELAMARINA",684,"SCOALA CLASELE I-VIII PETROASA MARE, NR.74",780,374,372,2,0,374,0,900,526,178,196,3,15093,0
37,"Timis",159259,350,159259,,"VICTOR VLAD DELAMARINA",685,"SCOALA CU CLASELE I-IV VISAG, NR.307",305,183,176,7,0,180,3,400,217,82,98,3,15093,0
37,"Timis",159259,350,159259,,"VICTOR VLAD DELAMARINA",686,"CAMINUL CULTURAL VICTOR VLAD DELEMARINA, NR.105",0,92,0,92,0,90,2,200,108,41,49,3,15093,1
37,"Timis",159339,350,159339,,"VOITEG",687,"PRIMARIA  VOITEG NR.114",1551,786,783,3,0,777,9,1700,914,487,290,3,15101,0
37,"Timis",159339,350,159339,,"VOITEG",688,"SCOALA CU CLASELE I-IV FOLEA NR.15",394,203,195,8,0,201,2,500,297,100,101,3,15101,0
37,"Timis",159339,350,159339,,"VOITEG",689,"CAMINUL CULTURAL VOITEG, NR.122",0,102,0,102,0,100,2,200,98,62,38,3,15101,1
38,"Tulcea",159614,369,159614,,"MUNICIPIUL TULCEA",1,"Colegiul Dobrogean ""Spiru C.Haret"", Str.14 Noiembrie, Nr.24",1939,882,874,7,1,874,8,2124,1242,562,312,1,15105,0
38,"Tulcea",159614,369,159614,,"MUNICIPIUL TULCEA",2,"Scoala Generala ""Nifon Balasescu"", (local nou), Str.Nicolae Balcescu, Nr.43",1334,623,617,6,0,618,5,1471,848,341,277,1,15105,0
38,"Tulcea",159614,369,159614,,"MUNICIPIUL TULCEA",3,"Scoala Generala ""Nifon Balasescu"", (local nou), Str.Nicolae Balcescu, Nr.43",1658,817,809,8,0,809,8,1829,1012,477,332,1,15105,0
38,"Tulcea",159614,369,159614,,"MUNICIPIUL TULCEA",4,"Scoala Generala ""Nifon Balasescu"", (local nou), Str.Nicolae Balcescu, Nr.43",1715,827,817,10,0,817,10,1891,1064,444,373,1,15105,0
38,"Tulcea",159614,369,159614,,"MUNICIPIUL TULCEA",5,"Scoala de Arte si Meserii Nr. 3, (fosta scoala generala Nr. 3), Str.Avram Iancu, Nr.61A",1379,618,608,10,0,610,8,1520,902,343,267,1,15105,0
38,"Tulcea",159614,369,159614,,"MUNICIPIUL TULCEA",6,"Scoala de Arte si Meserii Nr. 3, (fosta scoala generala Nr. 3), Str.Avram Iancu, Nr.61A",1314,605,592,12,1,600,5,1459,854,366,234,1,15105,0
38,"Tulcea",159614,369,159614,,"MUNICIPIUL TULCEA",7,"Scoala generala Nr.9, Str.Mahmudiei, Nr. 123",1326,596,581,13,2,590,6,1462,866,373,217,1,15105,0
38,"Tulcea",159614,369,159614,,"MUNICIPIUL TULCEA",8,"Scoala generala Nr.9, Str.Mahmudiei, Nr. 123",1288,605,593,12,0,599,6,1420,815,377,222,1,15105,0
38,"Tulcea",159614,369,159614,,"MUNICIPIUL TULCEA",9,"Liceul de Arta ""George Georgescu"", Str. Slt. Gavrilov Corneliu, Nr.166",2107,1118,1099,18,1,1111,7,2323,1205,601,510,1,15105,0
38,"Tulcea",159614,369,159614,,"MUNICIPIUL TULCEA",10,"Scoala ""Ioan Nenitescu"", (fosta scoala Nr.11), Str.Miron Costin, Nr.57",1347,645,638,7,0,641,4,1485,840,407,234,1,15105,0
38,"Tulcea",159614,369,159614,,"MUNICIPIUL TULCEA",11,"Scoala ""Ioan Nenitescu"", (fosta scoala Nr.11), Str.Miron Costin, Nr.57",1278,628,618,10,0,620,8,1406,778,365,255,1,15105,0
38,"Tulcea",159614,369,159614,,"MUNICIPIUL TULCEA",12,"Gradinita cu orar prelungit Nr. 18 (fost Liceul de Arta), Str.Miron Costin, Nr. 24A",1362,641,629,12,0,636,5,1500,859,381,255,1,15105,0
38,"Tulcea",159614,369,159614,,"MUNICIPIUL TULCEA",13,"Gradinita cu orar prelungit Nr. 18 (fost Liceul de Arta), Str.Miron Costin, Nr. 24A",1104,546,536,10,0,534,12,1217,671,350,184,1,15105,0
38,"Tulcea",159614,369,159614,,"MUNICIPIUL TULCEA",14,"Scoala ""I.L.Caragiale"", Str.I.L.Caragiale, Nr.20",1878,798,787,11,0,792,6,2070,1272,489,303,1,15105,0
38,"Tulcea",159614,369,159614,,"MUNICIPIUL TULCEA",15,"Scoala ""I.L.Caragiale"", Str.I.L.Caragiale, Nr.20",1935,968,956,12,0,963,5,2133,1165,543,420,1,15105,0
38,"Tulcea",159614,369,159614,,"MUNICIPIUL TULCEA",16,"Scoala ""I.L.Caragiale"", Str.I.L.Caragiale, Nr.20",2128,907,894,11,2,899,8,2346,1439,548,351,1,15105,0
38,"Tulcea",159614,369,159614,,"MUNICIPIUL TULCEA",17,"Gradinita de Copii Nr.13, Aleea Trifoiului, Nr.4",1906,813,801,12,0,803,10,2099,1286,452,351,1,15105,0
38,"Tulcea",159614,369,159614,,"MUNICIPIUL TULCEA",18,"Liceul de Arta ""George Georgescu"", Str. Slt. Gavrilov Corneliu, Nr.166",1421,782,775,7,0,775,7,1567,785,376,399,1,15105,0
38,"Tulcea",159614,369,159614,,"MUNICIPIUL TULCEA",19,"Gradinita de copii Nr.12, Str.24 Ianuarie, Nr.2",1897,1008,1000,8,0,1007,1,2091,1083,555,452,1,15105,0
38,"Tulcea",159614,369,159614,,"MUNICIPIUL TULCEA",20,"Liceul Pedagogic, Str.Comertului, Nr.1",1393,681,671,10,0,679,2,1575,894,411,268,1,15105,0
38,"Tulcea",159614,369,159614,,"MUNICIPIUL TULCEA",21,"Liceul Pedagogic, Str.Comertului, Nr.1",1073,656,494,162,0,644,12,1183,527,400,244,1,15105,0
38,"Tulcea",159614,369,159614,,"MUNICIPIUL TULCEA",22,"Liceul de Arta ""George Georgescu"", (fosta Scoala generala Nr.2), Str.Babadag, Nr.138",1211,589,579,10,0,587,2,1335,746,318,269,1,15105,0
38,"Tulcea",159614,369,159614,,"MUNICIPIUL TULCEA",23,"Liceul de Arta ""George Georgescu"", (fosta Scoala generala Nr.2), Str.Babadag, Nr.139",1424,727,712,15,0,720,7,1568,841,436,284,1,15105,0
38,"Tulcea",159614,369,159614,,"MUNICIPIUL TULCEA",24,"Scoala Generala Nr. 5, Str. Babadag, Nr.136",1451,785,774,11,0,779,6,1600,815,433,346,1,15105,0
38,"Tulcea",159614,369,159614,,"MUNICIPIUL TULCEA",25,"Scoala Generala Nr. 5, Str. Babadag, Nr.136",1082,528,518,10,0,526,2,1191,663,307,219,1,15105,0
38,"Tulcea",159614,369,159614,,"MUNICIPIUL TULCEA",26,"Seminarul Teologic, Str.Toamnei, Nr.7",1193,648,643,5,0,643,5,1315,667,363,280,1,15105,0
38,"Tulcea",159614,369,159614,,"MUNICIPIUL TULCEA",27,"Seminarul Teologic, Str.Toamnei, Nr.7",1046,550,547,3,0,544,6,1153,603,302,242,1,15105,0
38,"Tulcea",159614,369,159614,,"MUNICIPIUL TULCEA",28,"Teatrul ""Jean Bart"", Str. Progresului, Nr. 34",1892,1103,1089,13,1,1090,13,2087,984,555,535,1,15105,0
38,"Tulcea",159614,369,159614,,"MUNICIPIUL TULCEA",29,"Scoala ""Grigore Antipa"", (fosta scoala gen. Nr. 6), Str.Victoriei Nr.66",1261,646,639,7,0,638,8,1390,744,385,253,1,15105,0
38,"Tulcea",159614,369,159614,,"MUNICIPIUL TULCEA",30,"Scoala ""Grigore Antipa"", (fosta scoala gen. Nr. 6), Str.Victoriei Nr.66",1301,717,697,19,1,707,10,1433,716,410,297,1,15105,0
38,"Tulcea",159614,369,159614,,"MUNICIPIUL TULCEA",31,"Scoala ""Mihail Sadoveanu"", Str.Libertatii,Nr.76",1821,921,902,18,1,915,6,2006,1085,559,356,1,15105,0
38,"Tulcea",159614,369,159614,,"MUNICIPIUL TULCEA",32,"Scoala ""Alexandru Ciucurencu"", Str.Victoriei, Nr.101",1491,756,739,12,5,751,5,1643,887,434,317,1,15105,0
38,"Tulcea",159614,369,159614,,"MUNICIPIUL TULCEA",33,"Scoala ""Alexandru Ciucurencu"", Str.Victoriei, Nr.101",1914,946,934,12,0,938,8,2110,1164,603,335,1,15105,0
38,"Tulcea",159614,369,159614,,"MUNICIPIUL TULCEA",34,"Scoala  ""Constantin Gavenea"", Cart.E3, Str.1848, Nr.29",1866,931,923,8,0,921,10,2056,1125,560,361,1,15105,0
38,"Tulcea",159614,369,159614,,"MUNICIPIUL TULCEA",35,"Scoala  ""Constantin Gavenea"", Cart.E3, Str.1848, Nr.29",1627,758,753,5,0,752,6,1793,1035,493,259,1,15105,0
38,"Tulcea",159614,369,159614,,"MUNICIPIUL TULCEA",36,"Scoala  ""Constantin Gavenea"", Cart.E3, Str.1848, Nr.29",1723,920,909,11,0,910,10,1898,978,538,372,1,15105,0
38,"Tulcea",159614,369,159614,,"MUNICIPIUL TULCEA",37,"Gradinita de copii Nr.19 (fosta Gradinita de copii Nr.22), Aleea Socului, bloc 2",2182,1069,1060,8,1,1059,10,2405,1336,636,423,1,15105,0
38,"Tulcea",159614,369,159614,,"MUNICIPIUL TULCEA",38,"Liceul ""Grigore Moisil"", Str.1848, Nr.7",1242,684,675,9,0,682,2,1368,684,419,263,1,15105,0
38,"Tulcea",159614,369,159614,,"MUNICIPIUL TULCEA",39,"Liceul ""Grigore Moisil"", Str.1848, Nr.7",1338,701,693,7,1,692,9,1475,774,405,287,1,15105,0
38,"Tulcea",159614,369,159614,,"MUNICIPIUL TULCEA",40,"Scoala generala Nr.12, Str.1848, Nr.5A",1352,641,636,5,0,634,7,1490,849,373,261,1,15105,0
38,"Tulcea",159614,369,159614,,"MUNICIPIUL TULCEA",41,"Scoala generala Nr.12, Str.1848, Nr.5A",1536,681,671,10,0,678,3,1692,1011,451,227,1,15105,0
38,"Tulcea",159614,369,159614,,"MUNICIPIUL TULCEA",42,"Sala de Sport multifunctionala, Str. Isaccei, Nr.20 A",1721,785,777,6,2,784,1,1894,1109,486,298,1,15105,0
38,"Tulcea",159614,369,159614,,"MUNICIPIUL TULCEA",43,"Gradinita de Copii Nr. 17, Aleea Stejarului, Nr.12",1771,892,879,13,0,882,10,1952,1060,601,281,1,15105,0
38,"Tulcea",159614,369,159614,,"MUNICIPIUL TULCEA",44,"Gradinita de Copii Nr. 17, Aleea Stejarului, Nr.12",1868,703,696,6,1,699,4,2059,1356,499,200,1,15105,0
38,"Tulcea",159614,369,159614,,"MUNICIPIUL TULCEA",45,"Colegiul Tehnic ""Henri Coanda"", Str.Tineretului,Nr.2",1724,903,884,19,0,894,9,1902,999,586,308,1,15105,0
38,"Tulcea",159614,369,159614,,"MUNICIPIUL TULCEA",46,"Biblioteca Judeteana, Str.Isaccei, Nr.20",1581,836,818,16,2,825,11,1742,906,472,353,1,15105,0
38,"Tulcea",159614,369,159614,,"MUNICIPIUL TULCEA",47,"Colegiul Economic, ""Delta Dunarii"", Str.Viitorului, Nr. 32",2168,1024,1006,18,0,1015,9,2389,1365,738,277,1,15105,0
38,"Tulcea",159614,369,159614,,"MUNICIPIUL TULCEA",48,"SC Transport Public SA , Str. Prelungirea Taberei, Nr.7",903,456,446,10,0,446,10,993,537,294,152,1,15105,0
38,"Tulcea",159614,369,159614,,"MUNICIPIUL TULCEA",49,"Grup Scolar ""Anghel Saligny"", Str.Taberei, Nr. 101",1791,698,684,14,0,690,8,1974,1276,527,163,1,15105,0
38,"Tulcea",159614,369,159614,,"MUNICIPIUL TULCEA",50,"Casa de cultura, Piata Independentei, Nr.1",1637,841,832,9,0,833,8,1820,979,496,337,1,15105,0
38,"Tulcea",159614,369,159614,,"MUNICIPIUL TULCEA",51,"Casa de cultura, Piata Independentei, Nr.1",527,274,266,8,0,270,4,581,307,178,92,1,15105,0
38,"Tulcea",159614,369,159614,,"MUNICIPIUL TULCEA",52,"Asociatia Clubul Pensionarilor Tulcea, Str.Garii. Nr.32, bloc 16, parter CP 820244",0,1246,0,1246,0,1237,9,1395,149,851,386,1,15105,1
38,"Tulcea",159650,369,159650,,"ORAS BABADAG",53,"Grup scolar ""Dimitrie Cantemir"", Str. Aurel Vlaicu, Nr.3",1538,695,686,9,0,678,17,1694,999,338,340,1,15108,0
38,"Tulcea",159650,369,159650,,"ORAS BABADAG",54,"Scoala Generala Nr.1 ""Mircea cel Batran"", Str.Cabanei , Nr.6",1750,923,913,6,4,915,8,1928,1005,529,386,1,15108,0
38,"Tulcea",159650,369,159650,,"ORAS BABADAG",55,"Scoala generala Nr. 2, Str. Republicii , Nr.142",1418,770,762,7,1,763,7,1562,792,420,343,1,15108,0
38,"Tulcea",159650,369,159650,,"ORAS BABADAG",56,"Scoala generala Nr. 3, ""Constantin Brancoveanu"", Str. Heracleea, Nr.15",1373,461,447,13,1,446,15,1512,1051,253,193,1,15108,0
38,"Tulcea",159650,369,159650,,"ORAS BABADAG",57,"Gradinita de copii Nr.2 ""Veterani"", Str.Republicii, Nr.198",642,320,310,9,1,314,6,707,387,186,128,1,15108,0
38,"Tulcea",159650,369,159650,,"ORAS BABADAG",58,"Salonul de nunti, Str.Pavel Gheorghe Nr.4",1427,770,753,13,4,761,9,1570,800,432,329,1,15108,0
38,"Tulcea",159650,369,159650,,"ORAS BABADAG",59,"Grupul scolar ""Dimitrie Cantemir"", Str. Aurel Vlaicu, Nr.3, CP 825100",0,341,0,341,0,330,11,623,282,191,139,1,15108,1
38,"Tulcea",159687,369,159687,,"ORAS ISACCEA",60,"Casa de Cultura Isaccea, Str.1Decembrie, Nr.31",1978,1019,1016,3,0,1011,8,2180,1161,638,373,1,15110,0
38,"Tulcea",159687,369,159687,,"ORAS ISACCEA",61,"Grupul Scolar ""Constantin Bratescu"", Str.1 Decembrie, Nr.91",1949,1017,1014,3,0,1008,9,2150,1133,708,300,1,15110,0
38,"Tulcea",159687,369,159687,,"ORAS ISACCEA",62,"Scoala generala Revarsarea Str.Victoriei, Nr.81",439,222,212,10,0,220,2,482,260,115,105,1,15110,0
38,"Tulcea",159687,369,159687,,"ORAS ISACCEA",63,"Casa de Cultura Isaccea, Str.1Decembrie, Nr.31, CP 825200",0,144,0,144,0,143,1,225,81,96,47,1,15110,1
38,"Tulcea",159730,369,159730,,"ORAS MACIN",64,"Scoala generala ""Gheorghe Banea"" Str. Florilor, Nr. 35",1194,561,546,5,10,555,6,1315,754,349,206,1,15114,0
38,"Tulcea",159730,369,159730,,"ORAS MACIN",65,"Scoala generala ""Gheorghe Banea"" Str. Florilor, Nr. 35",1374,665,647,9,9,661,4,1513,848,360,301,1,15114,0
38,"Tulcea",159730,369,159730,,"ORAS MACIN",66,"Gradinita Nr. 3, Str.Vanatori, Nr. 3",1849,912,887,17,8,909,3,2042,1130,489,420,1,15114,0
38,"Tulcea",159730,369,159730,,"ORAS MACIN",67,"Scoala generala Nr. 1, Str. Grivitei, Nr.11",1692,754,743,5,6,746,8,1864,1110,406,340,1,15114,0
38,"Tulcea",159730,369,159730,,"ORAS MACIN",68,"Scoala generala Nr. 1, Str. Grivitei, Nr.11",1701,750,740,10,0,744,6,1874,1124,345,399,1,15114,0
38,"Tulcea",159730,369,159730,,"ORAS MACIN",69,"Liceul ""Gheorghe Murgoci"", Str.Cetatii, Nr.19",1887,830,815,11,4,817,13,2080,1250,444,373,1,15114,0
38,"Tulcea",159730,369,159730,,"ORAS MACIN",70,"Grup scolar, Str. Vasile Alecsandri, Nr.7, CP 825300",0,241,0,241,0,240,1,294,53,96,144,1,15114,1
38,"Tulcea",159767,369,159767,,"ORAS SULINA",71,"Imobil proprietate a S.C. PRODCOM S.R.L. Pitesti, Str. I-a, Nr.158",1186,609,602,5,2,602,7,1306,697,398,204,1,15116,0
38,"Tulcea",159767,369,159767,,"ORAS SULINA",72,"Scoala generala din Prospectul Dunarii, sala de clasa, Str. Independentei nr. 127",251,152,142,10,0,152,0,276,124,120,32,1,15116,0
38,"Tulcea",159767,369,159767,,"ORAS SULINA",73,"Liceul Teoretic ""Jean Bart"", sala de clasa, Str. C.A. Rosetti, Nr.2",1193,572,561,8,3,564,8,1314,742,423,141,1,15116,0
38,"Tulcea",159767,369,159767,,"ORAS SULINA",74,"Consiliul local Sulina, sala de sedinte, Str. I-a , Nr.180",1219,685,672,12,1,681,4,1343,658,469,212,1,15116,0
38,"Tulcea",159767,369,159767,,"ORAS SULINA",75,"Liceul Teoretic ""Jean Bart"",  Scoala primara, sala de clasa, Str. C.A. Rosetti, Nr.2, CP 825400",0,175,0,175,0,174,1,295,120,123,51,1,15116,1
38,"Tulcea",159785,369,159785,,"BAIA",76,"Baia, Scoala de Arte si Meserii, corp central",1543,793,785,8,0,790,3,1700,907,299,491,3,15118,0
38,"Tulcea",159785,369,159785,,"BAIA",77,"Baia, Scoala generala cu clasele I-IV (Biserica), corp B",821,428,421,7,0,423,5,905,477,145,278,3,15118,0
38,"Tulcea",159785,369,159785,,"BAIA",78,"Camena, Scoala generala cu clasele I-IV",341,206,201,5,0,204,2,375,169,115,89,3,15118,0
38,"Tulcea",159785,369,159785,,"BAIA",79,"Caugagia, Scoala generala cu clasele I-IV",178,102,98,4,0,100,2,197,95,55,45,3,15118,0
38,"Tulcea",159785,369,159785,,"BAIA",80,"Ceamurlia de Sus, Scoala generala cu clasele I-VIII",626,268,262,6,0,265,3,695,427,155,110,3,15118,0
38,"Tulcea",159785,369,159785,,"BAIA",81,"Panduru, Scoala generala cu clasele I-IV",337,161,152,9,0,160,1,373,212,71,89,3,15118,0
38,"Tulcea",159785,369,159785,,"BAIA",82,"Baia, Scoala de Arte si Meserii, (corp central), Str. Republicii, Nr. 23, CP 827005",0,182,0,182,0,182,0,310,128,130,52,3,15118,1
38,"Tulcea",159847,369,159847,,"BEIDAUD",83,"Beidaud, Sala de sedinte a comunei",448,264,261,3,0,264,0,494,230,149,115,3,15124,0
38,"Tulcea",159847,369,159847,,"BEIDAUD",84,"Neatirnarea, Caminul Cultural",425,238,230,8,0,238,0,470,232,160,78,3,15124,0
38,"Tulcea",159847,369,159847,,"BEIDAUD",85,"Sarighiol de Deal,  Caminul cultural",439,289,283,6,0,285,4,484,195,206,79,3,15124,0
38,"Tulcea",159847,369,159847,,"BEIDAUD",86,"Beidaud, Sala de sedinte a comunei, CP 827010",0,67,0,67,0,67,0,91,24,50,17,3,15124,1
38,"Tulcea",161552,369,161552,,"BESTEPE",87,"Bestepe, Scoala",1539,694,691,3,0,681,13,1697,1003,329,352,3,15128,0
38,"Tulcea",161552,369,161552,,"BESTEPE",88,"Baltenii de Jos, Scoala",64,37,29,8,0,36,1,72,35,26,10,3,15128,0
38,"Tulcea",161552,369,161552,,"BESTEPE",89,"Bestepe, Scoala, CP 827133",0,61,0,61,0,60,1,121,60,36,24,3,15128,1
38,"Tulcea",159883,369,159883,,"C.A. ROSETTI",90,"C.A.Rosetti, Scoala generala cu clasele I-VIII",303,143,139,4,0,139,4,333,190,102,37,3,15132,0
38,"Tulcea",159883,369,159883,,"C.A. ROSETTI",91,"Letea, Scoala generala cu clasele I-IV",276,140,137,3,0,131,9,304,164,109,22,3,15132,0
38,"Tulcea",159883,369,159883,,"C.A. ROSETTI",92,"Periprava, Scoala generala cu clasele I-IV",204,105,102,3,0,103,2,225,120,89,14,3,15132,0
38,"Tulcea",159883,369,159883,,"C.A. ROSETTI",93,"C.A.Rosetti, Scoala generala cu clasele I-VIII, CP 827015",0,49,0,49,0,49,0,123,74,40,9,3,15132,1
38,"Tulcea",159945,369,159945,,"CARCALIU",94,"Carcaliu, Scoala Generala cu clasele I-VIII, Str. Scolii, Nr.1",1577,571,565,0,6,563,8,1737,1166,295,268,3,15138,0
38,"Tulcea",159945,369,159945,,"CARCALIU",95,"Carcaliu, Scoala Generala cu clasele I-VIII, Str. Scolii, Nr.1",1309,509,477,1,31,499,10,1442,933,280,219,3,15138,0
38,"Tulcea",159945,369,159945,,"CARCALIU",96,"Carcaliu, Scoala Generala cu clasele I-VIII, Str. Scolii, Nr.1, CP 827020",0,68,0,68,0,68,0,153,85,38,30,3,15138,1
38,"Tulcea",159963,369,159963,,"CASIMCEA",97,"Casimcea, Scoala generala cu clasele I-VIII",1137,574,559,15,0,560,14,1253,679,302,258,3,15140,0
38,"Tulcea",159963,369,159963,,"CASIMCEA",98,"Cismeaua Noua, Scoala generala",52,39,34,5,0,38,1,56,17,17,21,3,15140,0
38,"Tulcea",159963,369,159963,,"CASIMCEA",99,"Corugea, Scoala generala",332,178,173,5,0,172,6,336,158,72,100,3,15140,0
38,"Tulcea",159963,369,159963,,"CASIMCEA",100,"Rahmanu, Scoala generala",257,145,137,8,0,143,2,284,139,29,114,3,15140,0
38,"Tulcea",159963,369,159963,,"CASIMCEA",101,"Razboieni, Scoala generala",518,273,264,9,0,272,1,561,288,107,165,3,15140,0
38,"Tulcea",159963,369,159963,,"CASIMCEA",102,"Casimcea, Scoala generala cu clasele I-VIII, CP 827025",0,112,0,112,0,112,0,306,194,67,45,3,15140,1
38,"Tulcea",160092,369,160092,,"CEAMURLIA DE JOS",103,"Ceamurlia de Jos, Scoala generala cu clasele I-VIII",1021,451,438,5,8,444,7,1126,675,254,190,3,15148,0
38,"Tulcea",160092,369,160092,,"CEAMURLIA DE JOS",104,"Lunca, Scoala Generala cu clasele I-VIII",1059,466,456,9,1,462,4,1166,700,249,213,3,15148,0
38,"Tulcea",160092,369,160092,,"CEAMURLIA DE JOS",105,"Ceamurlia de Jos, Scoala generala cu clasele I-VIII, CP 827035",0,67,0,67,0,66,1,136,69,45,21,3,15148,1
38,"Tulcea",160047,369,160047,,"CEATALCHIOI",106,"Ceatalchioi, Scoala generala",374,201,200,0,1,201,0,411,210,140,61,3,15151,0
38,"Tulcea",160047,369,160047,,"CEATALCHIOI",107,"Patlageanca, Scoala generala",165,96,92,4,0,96,0,182,86,49,47,3,15151,0
38,"Tulcea",160047,369,160047,,"CEATALCHIOI",108,"Plauru, Vechea scoala",56,31,31,0,0,31,0,62,31,20,11,3,15151,0
38,"Tulcea",160047,369,160047,,"CEATALCHIOI",109,"Ceatalchioi, Scoala generala, CP 824070",0,68,0,68,0,68,0,129,61,43,25,3,15151,1
38,"Tulcea",160127,369,160127,,"CERNA",110,"Cerna, Scoala de Arte si Meserii",1883,914,908,6,0,908,6,2076,1162,383,525,3,15156,0
38,"Tulcea",160127,369,160127,,"CERNA",111,"General Praporgescu, Scoala generala cu clasele I-IV",181,61,53,8,0,61,0,181,120,25,36,3,15156,0
38,"Tulcea",160127,369,160127,,"CERNA",112,"Mircea Voda, Scoala generala cu clasele I-IV",452,219,213,6,0,216,3,498,279,80,136,3,15156,0
38,"Tulcea",160127,369,160127,,"CERNA",113,"Traian, Scoala generala cu clasele I-VIII",920,520,515,5,0,514,6,1014,494,231,283,3,15156,0
38,"Tulcea",160127,369,160127,,"CERNA",114,"Cerna, Scoala, CP 827045",0,84,0,84,0,84,0,143,59,45,39,3,15156,1
38,"Tulcea",160172,369,160172,,"CHILIA VECHE",115,"Chilia Veche, Caminul cultural - intrarea principala",1906,796,796,0,0,781,15,2103,1307,580,201,3,15161,0
38,"Tulcea",160172,369,160172,,"CHILIA VECHE",116,"Chilia Veche, Caminul cultural, CP 827050",0,73,0,73,0,73,0,175,102,55,18,3,15161,1
38,"Tulcea",160225,369,160225,,"CIUCUROVA",117,"Ciucurova, Scoala generala cu clasele I-VIII",1134,606,606,0,0,599,7,1252,646,367,232,3,15166,0
38,"Tulcea",160225,369,160225,,"CIUCUROVA",118,"Atmagea, Scoala generala",157,78,78,0,0,77,1,173,95,26,51,3,15166,0
38,"Tulcea",160225,369,160225,,"CIUCUROVA",119,"Fantana Mare, Scoala generala",482,255,252,3,0,253,2,531,276,113,140,3,15166,0
38,"Tulcea",160225,369,160225,,"CIUCUROVA",120,"Ciucurova, Scoala generala cu clasele I-VIII, CP 827055",0,101,0,101,0,100,1,156,55,61,39,3,15166,1
38,"Tulcea",160261,369,160261,,"CRISAN",121,"Crisan, Scoala generala cu clasele I-VIII",392,254,248,6,0,251,3,432,178,172,79,3,15170,0
38,"Tulcea",160261,369,160261,,"CRISAN",122,"Caraorman, Scoala generala",315,221,220,1,0,219,2,347,126,186,33,3,15170,0
38,"Tulcea",160261,369,160261,,"CRISAN",123,"Mila 23, Scoala generala",367,234,230,4,0,234,0,403,169,192,42,3,15170,0
38,"Tulcea",160261,369,160261,,"CRISAN",124,"Crisan, Scoala generala cu clasele I-VIII, CP 827060",0,78,0,78,0,78,0,180,102,58,20,3,15170,1
38,"Tulcea",160305,369,160305,,"DAENI",125,"Daeni, Caminul Cultural",1864,1150,1150,0,0,1127,23,2055,905,710,417,3,15174,0
38,"Tulcea",160305,369,160305,,"DAENI",126,"Daeni, Caminul Cultural, sala mica, CP 827065",0,78,0,78,0,76,2,115,37,40,36,3,15174,1
38,"Tulcea",160323,369,160323,,"DOROBANTU",127,"Dorobantu, Scoala generala cu clasele I-VIII",698,371,366,4,1,369,2,771,400,173,196,3,15176,0
38,"Tulcea",160323,369,160323,,"DOROBANTU",128,"Cirjelari, Scoala generala cu clasele I-IV",410,225,217,7,1,221,4,452,227,80,141,3,15176,0
38,"Tulcea",160323,369,160323,,"DOROBANTU",129,"Mesteru, Fosta scoala",179,123,116,7,0,122,1,197,74,36,86,3,15176,0
38,"Tulcea",160323,369,160323,,"DOROBANTU",130,"Dorobantu, Scoala generala cu clasele I-VIII, CP 827070",0,56,0,56,0,56,0,105,49,26,30,3,15176,1
38,"Tulcea",160387,369,160387,,"FRECATEI",131,"Frecatei, Scoala generala cu clasele I-VIII",1043,455,454,1,0,446,9,1149,694,295,151,3,15182,0
38,"Tulcea",160387,369,160387,,"FRECATEI",132,"Cataloi, Scoala generala cu clasele I-VIII",1061,513,504,9,0,510,3,1170,657,307,203,3,15182,0
38,"Tulcea",160387,369,160387,,"FRECATEI",133,"Posta, Scoala generala cu clasele I-IV",581,265,258,7,0,261,4,640,375,173,88,3,15182,0
38,"Tulcea",160387,369,160387,,"FRECATEI",134,"Telita, Scoala generala cu clasele I-IV",444,205,196,9,0,205,0,490,285,130,75,3,15182,0
38,"Tulcea",160387,369,160387,,"FRECATEI",135,"Frecatei, Scoala generala cu clasele I-VIII, CP 827075",0,136,0,136,0,132,4,229,93,65,67,3,15182,1
38,"Tulcea",160430,369,160430,,"GRECI",136,"Greci, Scoala ""Centru""",1538,650,642,8,0,643,7,1694,1044,387,256,3,15187,0
38,"Tulcea",160430,369,160430,,"GRECI",137,"Greci, Scoala ""Cresa""",1593,735,732,3,0,728,7,1756,1021,447,281,3,15187,0
38,"Tulcea",160430,369,160430,,"GRECI",138,"Greci, Scoala ""Stejaru""",1298,608,600,8,0,601,7,1431,823,386,215,3,15187,0
38,"Tulcea",160430,369,160430,,"GRECI",139,"Greci, Scoala de Arte si Meserii, corp ""Cresa"", Str. 1 Decembrie, Nr. 23, CP 827080",0,121,0,121,0,116,5,200,79,61,55,3,15187,1
38,"Tulcea",160458,369,160458,,"GRINDU",140,"Grindu, Scoala generala cu clasele I-VIII ""N. Iorga"", sala de festivitati din corpul C",1198,769,723,0,46,752,17,1321,552,434,318,3,15189,0
38,"Tulcea",160458,369,160458,,"GRINDU",141,"Grindu, Scoala generala cu clasele I-VIII ""N. Iorga"", sala de spor din corpul C, CP 827085",0,52,0,52,0,52,0,91,39,29,23,3,15189,1
38,"Tulcea",160476,369,160476,,"HAMCEARCA",142,"Hamcearca, Scoala generala",312,207,192,6,9,203,4,343,136,129,74,3,15191,0
38,"Tulcea",160476,369,160476,,"HAMCEARCA",143,"Balabancea, Scoala generala",292,207,191,5,11,203,4,322,115,116,87,3,15191,0
38,"Tulcea",160476,369,160476,,"HAMCEARCA",144,"Nifon, Scoala generala",554,348,334,3,11,342,6,611,263,221,121,3,15191,0
38,"Tulcea",160476,369,160476,,"HAMCEARCA",145,"Hamcearca, Scoala generala, CP 827090",0,115,0,115,0,115,0,277,162,74,41,3,15191,1
38,"Tulcea",160528,369,160528,,"HORIA",146,"Horia, Scoala veche",877,451,450,1,0,446,5,966,515,238,208,3,15196,0
38,"Tulcea",160528,369,160528,,"HORIA",147,"Closca, Scoala cu clasele I-IV",114,59,50,8,1,59,0,125,66,17,42,3,15196,0
38,"Tulcea",160528,369,160528,,"HORIA",148,"Floresti, Scoala cu clasele I-IV",268,109,105,4,0,108,1,295,186,46,62,3,15196,0
38,"Tulcea",160528,369,160528,,"HORIA",149,"Horia, Scoala veche (Gradinita Horia), CP 827095",0,63,0,63,0,62,1,156,93,32,30,3,15196,1
38,"Tulcea",161525,369,161525,,"I.C.BRATIANU",150,"I.C.Bratianu, Caminul cultural",939,610,583,0,27,602,8,1031,421,341,261,3,15200,0
38,"Tulcea",161525,369,161525,,"I.C.BRATIANU",151,"I.C.Bratianu, Caminul cultural, CP 827100",0,182,0,182,0,182,0,260,78,91,91,3,15200,1
38,"Tulcea",160564,369,160564,,"IZVOARELE",152,"Izvoarele, Scoala generala",1397,732,732,0,0,719,13,1541,809,340,379,3,15202,0
38,"Tulcea",160564,369,160564,,"IZVOARELE",153,"Alba, Scoala Generala",230,113,106,7,0,112,1,254,141,53,59,3,15202,0
38,"Tulcea",160564,369,160564,,"IZVOARELE",154,"Iulia, Scoala Generala",284,151,146,5,0,150,1,314,163,55,95,3,15202,0
38,"Tulcea",160564,369,160564,,"IZVOARELE",155,"Izvoarele, Scoala generala, CP 827105",0,68,0,68,0,68,0,140,72,34,34,3,15202,1
38,"Tulcea",160617,369,160617,,"JIJILA",156,"Jijila, Scoala generala (de sus)",1862,925,918,7,0,913,12,2052,1127,490,423,3,15206,0
38,"Tulcea",160617,369,160617,,"JIJILA",157,"Jijila, Caminul Cultural",1637,868,861,7,0,856,12,1806,938,456,400,3,15206,0
38,"Tulcea",160617,369,160617,,"JIJILA",158,"Garvan, Caminul Cultural",1123,597,587,10,0,589,8,1237,640,301,288,3,15206,0
38,"Tulcea",160617,369,160617,,"JIJILA",159,"Jijila, Caminul Cultural, CP 827110",0,55,0,55,0,55,0,108,53,29,26,3,15206,1
38,"Tulcea",160644,369,160644,,"JURILOVCA",160,"Jurilovca, Gradinita de copii, Str. 1 Mai, Nr.5",1220,521,514,7,0,512,9,1186,665,335,177,3,15209,0
38,"Tulcea",160644,369,160644,,"JURILOVCA",161,"Jurilovca, Scoala generala (sala de sport), Str. 6 Martie, Nr.27",1097,482,481,1,0,478,4,1209,727,308,170,3,15209,0
38,"Tulcea",160644,369,160644,,"JURILOVCA",162,"Salcioara, Gradinita de copii",1104,571,562,9,0,566,5,1216,645,299,267,3,15209,0
38,"Tulcea",160644,369,160644,,"JURILOVCA",163,"Visina, Caminul cultural",649,314,303,11,0,308,6,715,401,160,148,3,15209,0
38,"Tulcea",160644,369,160644,,"JURILOVCA",164,"Jurilovca, Gradinita de copii, Str. 1 Mai, Nr.5, CP 827115",0,178,0,178,0,176,2,335,157,84,92,3,15209,1
38,"Tulcea",160680,369,160680,,"LUNCAVITA",165,"Luncavita, Caminul cultural",1631,833,831,2,0,825,8,1795,962,593,232,3,15213,0
38,"Tulcea",160680,369,160680,,"LUNCAVITA",166,"Luncavita, Caminul cultural",1336,628,625,3,0,623,5,1469,841,466,157,3,15213,0
38,"Tulcea",160680,369,160680,,"LUNCAVITA",167,"Rachelu, Scoala generala",699,327,316,11,0,325,2,771,444,203,122,3,15213,0
38,"Tulcea",160680,369,160680,,"LUNCAVITA",168,"Luncavita, Caminul cultural, CP 827120",0,150,0,150,0,149,1,268,118,97,52,3,15213,1
38,"Tulcea",160724,369,160724,,"MAHMUDIA",169,"Mahmudia, Grup scolar ""Vasile Bacalu"", Str. Geolog Vasile Bacalu, Nr. 21 bis",1165,657,628,2,27,647,10,1284,627,435,212,3,15216,0
38,"Tulcea",160724,369,160724,,"MAHMUDIA",170,"Mahmudia, Grup scolar ""Vasile Bacalu"", Str. Geolog Vasile Bacalu, Nr. 21 bis",1211,647,631,1,15,641,6,1335,688,438,203,3,15216,0
38,"Tulcea",160724,369,160724,,"MAHMUDIA",171,"Mahmudia, Grup scolar ""Vasile Bacalu"", Str. Geolog Vasile Bacalu, Nr. 21 bis, CP 827130",0,76,0,76,0,76,0,199,123,46,30,3,15216,1
38,"Tulcea",160779,369,160779,,"MALIUC",172,"Maliuc, Scoala generala cu clasele I-VIII",334,135,132,3,0,134,1,373,238,110,24,3,15218,0
38,"Tulcea",160779,369,160779,,"MALIUC",173,"Gorgova, Scoala generala cu clasele I-IV",128,67,62,5,0,66,1,141,74,56,10,3,15218,0
38,"Tulcea",160779,369,160779,,"MALIUC",174,"Partizani, Scoala generala cu clasele I-VIII",395,200,197,3,0,199,1,437,237,148,51,3,15218,0
38,"Tulcea",160779,369,160779,,"MALIUC",175,"Maliuc, Scoala generala cu clasele I-VIII, CP 827135",0,49,0,49,0,49,0,115,66,32,17,3,15218,1
38,"Tulcea",160831,369,160831,,"MIHAI BRAVU",176,"Mihai Bravu, Caminul cultural",568,232,225,7,0,216,16,625,393,142,74,3,15224,0
38,"Tulcea",160831,369,160831,,"MIHAI BRAVU",177,"Satu Nou, Scoala generala cu clasele I-IV",562,343,332,11,0,335,8,620,277,235,100,3,15224,0
38,"Tulcea",160831,369,160831,,"MIHAI BRAVU",178,"Turda, Caminul cultural",980,441,434,7,0,436,5,1084,643,155,281,3,15224,0
38,"Tulcea",160831,369,160831,,"MIHAI BRAVU",179,"Satu Nou, Scoala generala cu clasele I-IV, CP 827141",0,72,0,72,0,72,0,172,100,45,27,3,15224,1
38,"Tulcea",160877,369,160877,,"MIHAIL KOGALNICEANU",180,"Mihail Kogalniceanu, Scoala de Arte si Meserii",1680,907,887,5,15,894,13,1851,944,403,491,3,15228,0
38,"Tulcea",160877,369,160877,,"MIHAIL KOGALNICEANU",181,"Lastuni, Scoala generala cu clasele I-IV",442,212,203,9,0,211,1,486,274,101,110,3,15228,0
38,"Tulcea",160877,369,160877,,"MIHAIL KOGALNICEANU",182,"Randunica, Scoala generala (sediul vechi)",558,247,239,8,0,244,3,615,368,151,93,3,15228,0
38,"Tulcea",160877,369,160877,,"MIHAIL KOGALNICEANU",183,"Mihail Kogalniceanu, Scoala de Arte si Meserii, CP 827145",0,94,0,94,0,91,3,177,83,50,41,3,15228,1
38,"Tulcea",160911,369,160911,,"MURIGHIOL",184,"Murighiol, Scoala generala",1200,604,603,1,0,599,5,1323,719,474,125,3,15232,0
38,"Tulcea",160911,369,160911,,"MURIGHIOL",185,"Colina, Scoala generala",115,68,63,5,0,66,2,128,60,33,33,3,15232,0
38,"Tulcea",160911,369,160911,,"MURIGHIOL",186,"Dunavatu de Jos, Scoala generala",545,337,331,6,0,334,3,600,263,282,52,3,15232,0
38,"Tulcea",160911,369,160911,,"MURIGHIOL",187,"Dunavatu de Sus, Scoala generala",138,79,72,7,0,79,0,152,73,63,16,3,15232,0
38,"Tulcea",160911,369,160911,,"MURIGHIOL",188,"Plopu, Scoala generala",508,243,239,4,0,238,5,560,317,185,53,3,15232,0
38,"Tulcea",160911,369,160911,,"MURIGHIOL",189,"Sarinasuf, Asociatia agricola",390,236,230,6,0,229,7,429,193,91,138,3,15232,0
38,"Tulcea",160911,369,160911,,"MURIGHIOL",190,"Murighiol, Scoala de Arte si Meserii, CP 827150",0,234,0,234,0,233,1,459,225,163,70,3,15232,1
38,"Tulcea",160993,369,160993,,"NALBANT",191,"Nalbant, Scoala generala cu clasele I-VIII",815,402,398,4,0,396,6,898,496,171,225,3,15240,0
38,"Tulcea",160993,369,160993,,"NALBANT",192,"Nicolae Balcescu, Scoala generala cu clasele I-VIII",959,346,335,11,0,339,7,1057,711,245,94,3,15240,0
38,"Tulcea",160993,369,160993,,"NALBANT",193,"Trestenic, Scoala generala cu clasele I-IV",291,140,132,8,0,136,4,321,181,58,78,3,15240,0
38,"Tulcea",160993,369,160993,,"NALBANT",194,"Nalbant, Scoala generala cu clasele I-VIII, CP 827160",0,82,0,82,0,82,0,165,83,35,47,3,15240,1
38,"Tulcea",161035,369,161035,,"NICULITEL",195,"Niculitel, Scoala Nr. 2 (Scoala de Piatra)",1971,970,951,9,10,957,13,2177,1207,673,284,3,15244,0
38,"Tulcea",161035,369,161035,,"NICULITEL",196,"Niculitel, Scoala Nr.1 (Scoala din centrul comunei)",1957,982,949,9,24,971,11,2157,1175,681,290,3,15244,0
38,"Tulcea",161035,369,161035,,"NICULITEL",197,"Niculitel, Scoala de Arte si Meserii (corpul din centrul localitatii), CP 827165",0,159,0,159,0,158,1,271,112,117,41,3,15244,1
38,"Tulcea",161053,369,161053,,"NUFARU",198,"Nufaru, Scoala generala cu clasele I-VIII, Str, Domnita Maria, Nr. 245A",1028,527,510,1,16,517,10,1133,606,363,154,3,15246,0
38,"Tulcea",161053,369,161053,,"NUFARU",199,"Malcoci, Gradinita cu program normal, Str. Calugareni, Nr. 146",849,407,392,10,5,404,3,936,529,292,112,3,15246,0
38,"Tulcea",161053,369,161053,,"NUFARU",200,"Victoria, Scoala generala cu clasele I-IV, Str. Pacii, Nr. 79",158,78,68,10,0,78,0,173,95,57,21,3,15246,0
38,"Tulcea",161053,369,161053,,"NUFARU",201,"Nufaru, Scoala generala cu clasele I-VIII, Str, Domnita Maria, Nr. 245A, CP 827170",0,136,0,136,0,135,1,293,157,90,45,3,15246,1
38,"Tulcea",161106,369,161106,,"OSTROV",202,"Ostrov, Gradinita de copii, Str. Scolii, Nr. 2",1740,1031,1013,7,11,1016,15,1917,886,693,323,3,15251,0
38,"Tulcea",161106,369,161106,,"OSTROV",203,"Ostrov, Gradinita de copii, Str. Scolii, Nr. 2, CP 827175",0,57,0,57,0,56,1,138,81,31,25,3,15251,1
38,"Tulcea",161133,369,161133,,"PARDINA",204,"Pardina, Caminul cultural",457,201,200,1,0,198,3,505,304,156,42,3,15254,0
38,"Tulcea",161133,369,161133,,"PARDINA",205,"Pardina, Caminul cultural, CP 827180",0,62,0,62,0,60,2,95,33,29,31,3,15254,1
38,"Tulcea",161151,369,161151,,"PECENEAGA",206,"Peceneaga, Caminul cultural",1546,824,808,5,11,812,12,1703,879,359,453,3,15256,0
38,"Tulcea",161151,369,161151,,"PECENEAGA",207,"Peceneaga, Caminul cultural, CP 827185",0,70,0,70,0,69,1,108,38,40,29,3,15256,1
38,"Tulcea",161179,369,161179,,"SARICHIOI",208,"Sarichioi, Scoala veche, Nr. 681A",1704,718,711,7,0,713,5,1878,1160,594,119,3,15258,0
38,"Tulcea",161179,369,161179,,"SARICHIOI",209,"Sarichioi, Scoala veche, Nr. 681A",1485,662,661,1,0,655,7,1637,975,520,135,3,15258,0
38,"Tulcea",161179,369,161179,,"SARICHIOI",210,"Enisala, Scoala generala cu clasele I-VIII, Nr. 186A",845,379,378,1,0,367,12,932,553,238,129,3,15258,0
38,"Tulcea",161179,369,161179,,"SARICHIOI",211,"Sabangia, Scoala generala cu clasele I-IV, Nr. 128",500,189,181,7,1,184,5,551,362,123,61,3,15258,0
38,"Tulcea",161179,369,161179,,"SARICHIOI",212,"Visterna, Scoala generala cu clasele I-IV, Nr, 39",384,146,137,9,0,145,1,384,238,108,37,3,15258,0
38,"Tulcea",161179,369,161179,,"SARICHIOI",213,"Zebil, Scoala generala cu clasele I-VIII, Nr, 125",1203,516,509,6,1,508,8,1327,811,314,194,3,15258,0
38,"Tulcea",161179,369,161179,,"SARICHIOI",214,"Sarichioi, Caminul cultural, Nr. 617A, CP 827190",0,104,0,104,0,103,1,175,71,67,36,3,15258,1
38,"Tulcea",161231,369,161231,,"SFANTU GHEORGHE",215,"Sfantu Gheorghe, Caminul cultural",758,391,390,0,1,386,5,836,445,293,93,3,15264,0
38,"Tulcea",161231,369,161231,,"SFANTU GHEORGHE",216,"Sfantu Gheorghe, Caminul cultural, CP 827195",0,51,0,51,0,51,0,116,65,37,14,3,15264,1
38,"Tulcea",161259,369,161259,,"SLAVA CERCHEZA",217,"Slava Cercheza, Scoala generala cu clasele I-VIII",1164,381,381,0,0,377,4,1283,902,158,219,3,15266,0
38,"Tulcea",161259,369,161259,,"SLAVA CERCHEZA",218,"Slava Rusa, Scoala generala cu clasele I-IV",1062,368,364,4,0,360,8,1168,800,197,163,3,15266,0
38,"Tulcea",161259,369,161259,,"SLAVA CERCHEZA",219,"Slava Cercheza, sediul consiliului local, Str. Principala, CP 827200",0,89,0,89,0,88,1,180,91,56,32,3,15266,1
38,"Tulcea",161286,369,161286,,"SMARDAN",220,"Smardan, Scoala generala cu clasele I-VIII ""Mr.I.Murgescu""",950,510,504,6,0,506,4,1046,536,343,163,3,15269,0
38,"Tulcea",161286,369,161286,,"SMARDAN",221,"Smardan, Scoala generala cu clasele I-VIII ""Mr.I.Murgescu"", CP 827205",0,315,0,315,0,310,5,348,33,121,189,3,15269,1
38,"Tulcea",161302,369,161302,,"SOMOVA",222,"Somova, Scoala ""Traian Cosovei""",1813,975,958,17,0,966,9,1999,1024,577,389,3,15271,0
38,"Tulcea",161302,369,161302,,"SOMOVA",223,"Mineri, Scoala generala",1228,697,685,12,0,693,4,1353,656,447,246,3,15271,0
38,"Tulcea",161302,369,161302,,"SOMOVA",224,"Parches, Scoala generala",641,347,335,12,0,339,8,708,361,221,118,3,15271,0
38,"Tulcea",161302,369,161302,,"SOMOVA",225,"Somova, Scoala ""Traian Cosovei"", CP 827210",0,141,0,141,0,140,1,262,121,84,56,3,15271,1
38,"Tulcea",161348,369,161348,,"STEJARU",226,"Stejaru, Caminul cultural",558,355,350,4,1,354,1,615,260,189,165,3,15275,0
38,"Tulcea",161348,369,161348,,"STEJARU",227,"Mina  Altan-Tepe, Scoala generala cu clasele I-VIII, sala cabinet tehnologic, parter",415,217,212,5,0,215,2,457,240,99,116,3,15275,0
38,"Tulcea",161348,369,161348,,"STEJARU",228,"Vasile Alecsandri, Scoala generala cu clasele I-IV",369,209,203,6,0,206,3,407,198,155,51,3,15275,0
38,"Tulcea",161348,369,161348,,"STEJARU",229,"Stejaru, fostul sediu al primariei comunei, CP 82 7215",0,153,0,153,0,153,0,310,157,89,64,3,15275,1
38,"Tulcea",161384,369,161384,,"TOPOLOG",230,"Topolog, Caminul cultural",2069,996,975,3,18,978,18,2069,1073,342,636,3,15279,0
38,"Tulcea",161384,369,161384,,"TOPOLOG",231,"Calfa, Scoala generala",118,73,63,10,0,71,2,130,57,16,55,3,15279,0
38,"Tulcea",161384,369,161384,,"TOPOLOG",232,"Cerbu, Scoala generala",220,125,116,9,0,123,2,243,118,44,79,3,15279,0
38,"Tulcea",161384,369,161384,,"TOPOLOG",233,"Fagarasu Nou, Scoala generala",552,269,260,9,0,267,2,608,339,94,173,3,15279,0
38,"Tulcea",161384,369,161384,,"TOPOLOG",234,"Luminita, Scoala generala",210,141,132,9,0,138,3,231,90,31,107,3,15279,0
38,"Tulcea",161384,369,161384,,"TOPOLOG",235,"Magurele, Scoala generala",198,124,116,8,0,124,0,218,94,31,93,3,15279,0
38,"Tulcea",161384,369,161384,,"TOPOLOG",236,"Sambata Noua, Scoala generala",472,292,278,14,0,290,2,520,228,85,205,3,15279,0
38,"Tulcea",161384,369,161384,,"TOPOLOG",237,"Topolog, Caminul cultural, CP 827220",0,117,0,117,0,115,2,293,176,51,64,3,15279,1
38,"Tulcea",161464,369,161464,,"TURCOAIA",238,"Turcoaia, Anexa Caminului cultural",1590,892,879,2,11,883,9,1752,860,464,419,3,15287,0
38,"Tulcea",161464,369,161464,,"TURCOAIA",239,"Turcoaia, Scoala de Arte si Meserii ""Dobre Vladescu""",1346,766,752,2,12,759,7,1483,717,394,365,3,15287,0
38,"Tulcea",161464,369,161464,,"TURCOAIA",240,"Turcoaia, Anexa Caminului cultural, CP 827230",0,68,0,68,0,67,1,118,50,23,44,3,15287,1
38,"Tulcea",161482,369,161482,,"VALEA NUCARILOR",241,"Valea Nucarilor, Caminul cultural",921,404,398,6,0,402,2,1034,630,205,197,3,15291,0
38,"Tulcea",161482,369,161482,,"VALEA NUCARILOR",242,"Agighiol, Caminul cultural",1492,632,623,9,0,622,10,1645,1013,421,201,3,15291,0
38,"Tulcea",161482,369,161482,,"VALEA NUCARILOR",243,"Iazurile, Caminul cultural",713,359,351,8,0,355,4,785,426,196,159,3,15291,0
38,"Tulcea",161482,369,161482,,"VALEA NUCARILOR",244,"Iazurile, Caminul cultural, CP 827235",0,91,0,91,0,90,1,127,36,50,40,3,15291,1
38,"Tulcea",161561,369,161561,,"VALEA TEILOR",245,"Valea Teilor, Scoala generala cu clasele I-VIII",1226,645,641,2,2,628,17,1351,706,302,326,3,15295,0
38,"Tulcea",161561,369,161561,,"VALEA TEILOR",246,"Valea Teilor, Scoala generala cu clasele I-VIII, CP 827108",0,53,0,53,0,52,1,101,48,29,23,3,15295,1
38,"Tulcea",161543,369,161543,,"VACARENI",247,"Vacareni, Caminul Cultural",1871,1043,1033,5,5,1032,11,2062,1019,557,475,3,15289,0
38,"Tulcea",161543,369,161543,,"VACARENI",248,"Vacareni, Caminul Cultural, CP 827125",0,63,0,63,0,63,0,93,30,38,25,3,15289,1
39,"Vaslui",161945,378,161945,,"MUNICIPIUL VASLUI",1,"Casa de Cultura a Sindicatelor Vaslui, STR. Stefan cel Mare nr.81",1632,909,900,9,0,903,6,1701,792,406,497,1,15298,0
39,"Vaslui",161945,378,161945,,"MUNICIPIUL VASLUI",2,"Casa de Cultura a Sindicatelor Vaslui, STR. Stefan cel Mare nr.81",1551,771,758,13,0,765,6,1601,830,301,464,1,15298,0
39,"Vaslui",161945,378,161945,,"MUNICIPIUL VASLUI",3,"Liceul M. Kogalniceanu, STR. M. Kogalniceanu nr.16",1679,774,762,12,0,766,8,1701,927,336,430,1,15298,0
39,"Vaslui",161945,378,161945,,"MUNICIPIUL VASLUI",4,"Liceul M. Kogalniceanu, STR.  M. Kogalniceanu nr.16",1184,667,653,13,1,662,5,1201,534,255,407,1,15298,0
39,"Vaslui",161945,378,161945,,"MUNICIPIUL VASLUI",5,"S.C. COREVAS S.R.L., STR. Spiru Haret nr.3",1939,956,942,14,0,949,7,2000,1044,436,513,1,15298,0
39,"Vaslui",161945,378,161945,,"MUNICIPIUL VASLUI",6,"Caminul de copii nr.15, STR. Eternitatii nr.1",1734,1014,972,23,19,1007,7,1801,787,399,608,1,15298,0
39,"Vaslui",161945,378,161945,,"MUNICIPIUL VASLUI",7,"Scoala nr.3 ""Constantin Parfene"", STR. M. Kogalniceanu nr.24",1867,807,788,19,0,793,14,1901,1094,346,447,1,15298,0
39,"Vaslui",161945,378,161945,,"MUNICIPIUL VASLUI",8,"Caminul nr.5, STR. Avantului",1861,765,753,12,0,757,8,1900,1135,299,458,1,15298,0
39,"Vaslui",161945,378,161945,,"MUNICIPIUL VASLUI",9,"ROMSILVA R.A. filiala Vaslui, STR. Veteran Turcanu nr.61",1683,803,790,13,0,796,7,1701,898,332,464,1,15298,0
39,"Vaslui",161945,378,161945,,"MUNICIPIUL VASLUI",10,"Scoala Ajutatoare Vaslui, STR. Spitalului",1958,891,878,13,0,885,6,2001,1110,414,471,1,15298,0
39,"Vaslui",161945,378,161945,,"MUNICIPIUL VASLUI",11,"Scoala nr.10, STR. Victor Babes nr.1",1627,771,765,6,0,766,5,1701,930,322,444,1,15298,0
39,"Vaslui",161945,378,161945,,"MUNICIPIUL VASLUI",12,"Scoala nr.10, STR. Victor Babes nr.1",1539,636,628,8,0,632,4,1601,965,277,355,1,15298,0
39,"Vaslui",161945,378,161945,,"MUNICIPIUL VASLUI",13,"Scoala nr.2, STR. Stefan cel Mare nr.193",1635,654,646,8,0,651,3,1701,1047,316,335,1,15298,0
39,"Vaslui",161945,378,161945,,"MUNICIPIUL VASLUI",14,"Liceul Sportiv, STR. Stefan cel Mare",1531,665,657,8,0,656,9,1601,936,284,372,1,15298,0
39,"Vaslui",161945,378,161945,,"MUNICIPIUL VASLUI",15,"Gradinita de copii nr.6, STR. Dimitrie Bolintineanu",1569,674,665,9,0,669,5,1601,927,306,363,1,15298,0
39,"Vaslui",161945,378,161945,,"MUNICIPIUL VASLUI",16,"Gradinita de copii nr.17, STR. Vasile Alecsandri  nr.1",1642,722,710,11,1,716,6,1701,979,265,451,1,15298,0
39,"Vaslui",161945,378,161945,,"MUNICIPIUL VASLUI",17,"Scoala nr.5 ""Stefan cel Mare"", STR. Constantin. Prezan,nr.4",1609,799,785,14,0,791,8,1700,901,338,453,1,15298,0
39,"Vaslui",161945,378,161945,,"MUNICIPIUL VASLUI",18,"Scoala nr.5 ""Stefan cel Mare"", STR. Constantin Prezan nr.4",1641,785,776,9,0,781,4,1701,916,320,461,1,15298,0
39,"Vaslui",161945,378,161945,,"MUNICIPIUL VASLUI",19,"Gradinita de copii nr.11, STR. Cuza Voda nr.1",2020,922,909,13,0,913,9,2101,1179,344,569,1,15298,0
39,"Vaslui",161945,378,161945,,"MUNICIPIUL VASLUI",20,"Liceul ""Emil Racovita"", STR. Husului  nr.48",1650,743,731,12,0,738,5,1701,958,285,453,1,15298,0
39,"Vaslui",161945,378,161945,,"MUNICIPIUL VASLUI",21,"Caminul de copii nr.16/Gradinita nr.12, STR. Husului nr.2",1536,689,681,8,0,686,3,1601,912,272,414,1,15298,0
39,"Vaslui",161945,378,161945,,"MUNICIPIUL VASLUI",22,"Caminul de copii nr.3, STR. Gh. Racovita nr.191",1384,669,661,8,0,661,8,1401,732,301,360,1,15298,0
39,"Vaslui",161945,378,161945,,"MUNICIPIUL VASLUI",23,"Sala Sporturilor Vaslui, STR. Decebal nr.1",1590,780,696,12,72,773,7,1601,821,349,424,1,15298,0
39,"Vaslui",161945,378,161945,,"MUNICIPIUL VASLUI",24,"Sala Sporturilor Vaslui, STR. Decebal nr.1",1607,728,714,14,0,726,2,1701,973,326,400,1,15298,0
39,"Vaslui",161945,378,161945,,"MUNICIPIUL VASLUI",25,"Scoala nr.6, STR. stefan cel Mare nr.61",1643,742,725,17,0,732,10,1701,959,308,424,1,15298,0
39,"Vaslui",161945,378,161945,,"MUNICIPIUL VASLUI",26,"Caminul de copii nr.21, STR. Biruintei nr.1",1921,829,821,8,0,824,5,1993,1164,387,437,1,15298,0
39,"Vaslui",161945,378,161945,,"MUNICIPIUL VASLUI",27,"Scoala nr.9  ""Vasile Alecsandri"", STR. Biruintei nr.1",551,228,217,11,0,223,5,615,387,104,119,1,15298,0
39,"Vaslui",161945,378,161945,,"MUNICIPIUL VASLUI",28,"Scoala nr.9  ""Vasile Alecsandri"", STR. Biruintei nr.1",1706,753,742,11,0,745,8,1801,1048,333,412,1,15298,0
39,"Vaslui",161945,378,161945,,"MUNICIPIUL VASLUI",29,"Gradinita de copii nr.19, STR. Pacii nr.2",2018,929,918,11,0,916,13,2101,1172,435,481,1,15298,0
39,"Vaslui",161945,378,161945,,"MUNICIPIUL VASLUI",30,"Scoala nr.8 ""Alexandra Nichita"", STR. Pacii nr.2",1087,479,466,13,0,476,3,1100,621,232,244,1,15298,0
39,"Vaslui",161945,378,161945,,"MUNICIPIUL VASLUI",31,"Scoala nr.8 ""Alexandra Nichita"", STR. Pacii nr.2",1006,437,428,9,0,433,4,1101,664,231,202,1,15298,0
39,"Vaslui",161945,378,161945,,"MUNICIPIUL VASLUI",32,"Liceul Anghel Rugina, STR. Traian nr.1",1426,645,632,13,0,638,7,1501,856,270,368,1,15298,0
39,"Vaslui",161945,378,161945,,"MUNICIPIUL VASLUI",33,"Liceul Anghel Rugina, StradaTraian nr.1",708,372,362,10,0,365,7,801,429,154,211,1,15298,0
39,"Vaslui",161945,378,161945,,"MUNICIPIUL VASLUI",34,"Scoala nr.4 ""Elena Cuza"", STR. Mihai Viteazu nr.10",1011,504,495,9,0,500,4,1101,597,221,279,1,15298,0
39,"Vaslui",161945,378,161945,,"MUNICIPIUL VASLUI",35,"Scoala nr.4 ""Elena Cuza"", STR. Mihai Viteazu nr.10",1119,525,518,7,0,523,2,1201,676,212,311,1,15298,0
39,"Vaslui",161945,378,161945,,"MUNICIPIUL VASLUI",36,"Scoala nr.1 ""Al. I. Cuza"", STR. Racova nr.69",1702,762,749,13,0,750,12,1801,1039,310,440,1,15298,0
39,"Vaslui",161945,378,161945,,"MUNICIPIUL VASLUI",37,"Scoala nr.1 ""Al. I. Cuza"", STR. Racova nr.69",1024,511,502,9,0,500,11,1092,581,196,304,1,15298,0
39,"Vaslui",161945,378,161945,,"MUNICIPIUL VASLUI",38,"Scoala cu clasele I-IV Bahnari, STR. Branistei",329,140,131,9,0,134,6,401,261,35,99,1,15298,0
39,"Vaslui",161945,378,161945,,"MUNICIPIUL VASLUI",39,"Scoala cu clasele I-VIII  Viisoara, STR. Egalitatii",1180,517,507,10,0,512,5,1199,682,227,285,1,15298,0
39,"Vaslui",161945,378,161945,,"MUNICIPIUL VASLUI",40,"Scoala cu clasele I-IV Moara Grecilor, STR. Gh. Doja",1297,702,677,25,0,695,7,1301,599,294,401,1,15298,0
39,"Vaslui",161945,378,161945,,"MUNICIPIUL VASLUI",41,"Scoala cu clasele I-IV Rediu, STR. Pompelor",1096,480,470,10,0,474,6,1097,617,168,306,1,15298,0
39,"Vaslui",161945,378,161945,,"MUNICIPIUL VASLUI",42,"Scoala cu clasele I-VII Brodoc, STR. Constantin Brincoveanu",893,377,351,26,0,366,11,900,523,141,225,1,15298,0
39,"Vaslui",161945,378,161945,,"MUNICIPIUL VASLUI",43,"Liceul stefan Procopiu, STR. Castanilor nr.1",1152,519,509,10,0,512,7,1201,682,224,288,1,15298,0
39,"Vaslui",161945,378,161945,,"MUNICIPIUL VASLUI",44,"Gradinita de copii nr.22 - Dispensar, STR. Metalurgiei",1043,386,373,13,0,386,0,1100,714,176,210,1,15298,0
39,"Vaslui",161945,378,161945,,"MUNICIPIUL VASLUI",45,"Autogara Vaslui, STR. Alexandru Vlahuta nr.2",0,667,0,667,0,660,7,813,146,374,286,1,15298,1
39,"Vaslui",161794,378,161794,,"MUNICIPIUL BARLAD",46,"Scoala Generala nr. 10 ""GEORGE EMIL PALADE"", STR. I.C. Bratianu nr.35",1560,710,701,8,1,700,10,1601,891,271,429,1,15305,0
39,"Vaslui",161794,378,161794,,"MUNICIPIUL BARLAD",47,"Scoala Generala nr. 10 ""GEORGE EMIL PALADE"", STR. I.C. Bratianu nr.35",1606,788,781,7,0,778,10,1701,913,365,413,1,15305,0
39,"Vaslui",161794,378,161794,,"MUNICIPIUL BARLAD",48,"Scoala Generala nr. 10 ""GEORGE EMIL PALADE"", STR. I.C. Bratianu nr.35",1630,808,783,25,0,807,1,1700,892,339,468,1,15305,0
39,"Vaslui",161794,378,161794,,"MUNICIPIUL BARLAD",49,"Scoala Generala nr. 7 ""CAPITAN GRIGORE IGNAT"", STR. 1 Mai nr. 4",1870,912,901,11,0,904,8,1900,988,392,512,1,15305,0
39,"Vaslui",161794,378,161794,,"MUNICIPIUL BARLAD",50,"Colegiul National ""Gheorghe Rosca Codreanu"", STR. Nicolae Balcesc nr.11",1053,539,526,11,2,532,7,1101,562,275,257,1,15305,0
39,"Vaslui",161794,378,161794,,"MUNICIPIUL BARLAD",51,"Colegiul National ""Gheorghe Rosca Codreanu"", STR. Nicolae Balcesc nr.11",1507,663,647,16,0,654,9,1601,938,263,391,1,15305,0
39,"Vaslui",161794,378,161794,,"MUNICIPIUL BARLAD",52,"Colegiul National ""Gheorghe Rosca Codreanu"", STR. Nicolae Balcesc nr.11",1070,601,592,8,1,592,9,1101,500,276,316,1,15305,0
39,"Vaslui",161794,378,161794,,"MUNICIPIUL BARLAD",53,"Clubul Elevilor ""Spiru Haret"", STR. Mihail Kogalniceanu nr. 4",1085,589,579,9,1,578,11,1100,511,276,302,1,15305,0
39,"Vaslui",161794,378,161794,,"MUNICIPIUL BARLAD",54,"Clubul Elevilor ""Spiru Haret"", STR. Mihail Kogalniceanu nr. 4",1078,606,595,11,0,591,15,1101,495,242,349,1,15305,0
39,"Vaslui",161794,378,161794,,"MUNICIPIUL BARLAD",55,"Scoala Generala nr. 8, STR. Nicolae Tonitza nr. 20",1744,935,917,16,2,932,3,1801,866,366,566,1,15305,0
39,"Vaslui",161794,378,161794,,"MUNICIPIUL BARLAD",56,"Scoala Generale nr. 8, STR. Nicolae Tonitza nr. 20",1855,887,877,9,1,878,9,1901,1014,349,529,1,15305,0
39,"Vaslui",161794,378,161794,,"MUNICIPIUL BARLAD",57,"Scoala Generala nr. 8, STR. Nicolae Tonitza nr. 20",1713,858,845,13,0,850,8,1801,943,328,522,1,15305,0
39,"Vaslui",161794,378,161794,,"MUNICIPIUL BARLAD",58,"Scoala Generala nr. 9 ""MANOLACHE EPUREANU"", Aleea Parc nr. 1",1528,692,682,10,0,686,6,1600,908,281,405,1,15305,0
39,"Vaslui",161794,378,161794,,"MUNICIPIUL BARLAD",59,"Grupul scolar Industrial ""ALEXANDRU IOAN CUZA"", STR. Vasile Parvan nr.1",1693,647,639,6,2,641,6,1701,1054,293,348,1,15305,0
39,"Vaslui",161794,378,161794,,"MUNICIPIUL BARLAD",60,"Grupul scolar Industrial ""ALEXANDRU IOAN CUZA"", STR. Vasile Parvan nr.1",1461,686,674,12,0,684,2,1501,815,258,426,1,15305,0
39,"Vaslui",161794,378,161794,,"MUNICIPIUL BARLAD",61,"Grupul scolar Industrial ""ALEXANDRU IOAN CUZA"", STR. Vasile Parvan nr.1",1521,723,714,9,0,720,3,1601,878,325,395,1,15305,0
39,"Vaslui",161794,378,161794,,"MUNICIPIUL BARLAD",62,"Grupul scolar Industrial ""ALEXANDRU IOAN CUZA"", STR. Vasile Parvan nr.1",1308,558,541,17,0,551,7,1401,843,219,332,1,15305,0
39,"Vaslui",161794,378,161794,,"MUNICIPIUL BARLAD",63,"Grupul scolar Industrial ""ALEXANDRU IOAN CUZA"", STR. Vasile Parvan nr.1",1656,680,669,11,0,675,5,1701,1021,304,371,1,15305,0
39,"Vaslui",161794,378,161794,,"MUNICIPIUL BARLAD",64,"Grupul scolar Industrial ""ALEXANDRU IOAN CUZA"", STR. Vasile Parvan nr.1",1629,734,725,9,0,724,10,1701,967,319,405,1,15305,0
39,"Vaslui",161794,378,161794,,"MUNICIPIUL BARLAD",65,"Grupul scolar Industrial ""ALEXANDRU IOAN CUZA"", STR. Vasile Parvan nr.1",1513,627,619,7,1,619,8,1601,974,280,339,1,15305,0
39,"Vaslui",161794,378,161794,,"MUNICIPIUL BARLAD",66,"Scoala Generala nr.3 ""GRUP SCOLAR PROFESIONAL"", STR. Petru Rares nr.41",1987,922,910,11,1,913,9,2000,1078,410,503,1,15305,0
39,"Vaslui",161794,378,161794,,"MUNICIPIUL BARLAD",67,"Scoala Generala nr.3 ""GRUP SCOLAR PROFESIONAL"", STR. Petru Rares nr.41",1849,861,852,9,0,846,15,1901,1040,412,434,1,15305,0
39,"Vaslui",161794,378,161794,,"MUNICIPIUL BARLAD",68,"Scoala Generala nr. 6 ""VICTOR IOAN POPA"", STR. Dimitrie Cantemir nr.15",1780,843,822,21,0,820,23,1801,958,347,473,1,15305,0
39,"Vaslui",161794,378,161794,,"MUNICIPIUL BARLAD",69,"Scoala Generala nr. 6 ""VICTOR IOAN POPA"", STR. Dimitrie Cantemir nr.15",1945,918,901,15,2,902,16,2001,1083,398,504,1,15305,0
39,"Vaslui",161794,378,161794,,"MUNICIPIUL BARLAD",70,"Casa de Cultura a Sindicatelor ""GEORGE TUTOVEANU"", STR. 1 Decembrie nr.2",1550,777,764,13,0,773,4,1601,824,335,438,1,15305,0
39,"Vaslui",161794,378,161794,,"MUNICIPIUL BARLAD",71,"Casa de Cultura a Sindicatelor ""GEORGE TUTOVEANU"", STR. 1 Decembrie nr.2",1791,898,889,9,0,883,15,1801,903,410,473,1,15305,0
39,"Vaslui",161794,378,161794,,"MUNICIPIUL BARLAD",72,"Scoala Generala nr. 5 ""PRINCIPESA ELENA BIBESCU"", STR. Popa Sapca nr.5",1672,829,814,15,0,822,7,1701,872,400,422,1,15305,0
39,"Vaslui",161794,378,161794,,"MUNICIPIUL BARLAD",73,"Scoala Generala nr. 5 ""PRINCIPESA ELENA BIBESCU"", STR. Popa Sapca nr.5",1613,738,710,28,0,731,7,1700,962,386,345,1,15305,0
39,"Vaslui",161794,378,161794,,"MUNICIPIUL BARLAD",74,"Scoala Generala nr. 2 ""VASILE PARVAN"" , BLV. Primaverii nr. 16",1860,824,814,9,1,820,4,1901,1077,403,417,1,15305,0
39,"Vaslui",161794,378,161794,,"MUNICIPIUL BARLAD",75,"Scoala Generala nr. 2 ""VASILE PARVAN"" , BLV. Primaverii nr. 16",1097,519,508,11,0,515,4,1100,581,231,284,1,15305,0
39,"Vaslui",161794,378,161794,,"MUNICIPIUL BARLAD",76,"Scoala Generala nr. 2 ""VASILE PARVAN"",  BLV. Primaverii nr. 16",1024,435,421,14,0,433,2,1101,666,248,185,1,15305,0
39,"Vaslui",161794,378,161794,,"MUNICIPIUL BARLAD",77,"Scoala Generala nr. 11 ""GEORGE TUTOVEANU"", STR. Carpati nr. 5",1608,693,681,12,0,679,14,1701,1008,341,338,1,15305,0
39,"Vaslui",161794,378,161794,,"MUNICIPIUL BARLAD",78,"Scoala Generala nr. 11 ""GEORGE TUTOVEANU"", STR. Carpati nr. 5",1773,741,731,10,0,735,6,1801,1060,373,362,1,15305,0
39,"Vaslui",161794,378,161794,,"MUNICIPIUL BARLAD",79,"Scoala Generala nr. 11 ""GEORGE TUTOVEANU"", STR. Carpati nr. 5",1493,696,687,9,0,691,5,1500,804,342,349,1,15305,0
39,"Vaslui",161794,378,161794,,"MUNICIPIUL BARLAD",80,"Liceul Pedagogic ""ALEXANDRU VLAHUTA"", STR. Lirei nr. 15",1278,527,515,12,0,517,10,1282,755,248,269,1,15305,0
39,"Vaslui",161794,378,161794,,"MUNICIPIUL BARLAD",81,"Liceul Pedagogic ""ALEXANDRU VLAHUTA"", STR. Lirei nr. 15",1486,617,606,11,0,613,4,1501,884,300,313,1,15305,0
39,"Vaslui",161794,378,161794,,"MUNICIPIUL BARLAD",82,"Liceul Pedagogic ""ALEXANDRU VLAHUTA"", STR. Lirei nr. 15",1676,677,665,12,0,673,4,1701,1024,297,376,1,15305,0
39,"Vaslui",161794,378,161794,,"MUNICIPIUL BARLAD",83,"Liceul Pedagogic ""ALEXANDRU VLAHUTA"", STR. Lirei nr. 15",1245,553,538,15,0,546,7,1306,753,295,251,1,15305,0
39,"Vaslui",161794,378,161794,,"MUNICIPIUL BARLAD",84,"Imobilul apartinand domeniului public al municipiului Barlad, BLV Republicii nr.85",1761,768,748,20,0,760,8,1801,1033,374,386,1,15305,0
39,"Vaslui",161794,378,161794,,"MUNICIPIUL BARLAD",85,"Imobilul apartinand domeniului public al municipiului Barlad, BLV Republicii nr.85",1978,949,934,15,0,939,10,2001,1052,412,527,1,15305,0
39,"Vaslui",161794,378,161794,,"MUNICIPIUL BARLAD",86,"Gara municipiului Barlad, BLV. Primaverii nr. 1",0,667,0,667,0,661,6,801,134,352,309,1,15305,1
39,"Vaslui",161829,378,161829,,"MUNICIPIUL HUSI",87,"Asociatia Agricola ""Corni"", STR. Sara nr.126",1103,521,513,8,0,513,8,1201,680,251,262,1,15307,0
39,"Vaslui",161829,378,161829,,"MUNICIPIUL HUSI",88,"Scoala Profesionala ""Sf.Ecaterina"", STR. Dobrina nr.2",1113,534,526,8,0,531,3,1201,667,248,283,1,15307,0
39,"Vaslui",161829,378,161829,,"MUNICIPIUL HUSI",89,"Policlinica, STR. 1 Decembrie",1734,816,804,11,1,805,11,1801,985,279,526,1,15307,0
39,"Vaslui",161829,378,161829,,"MUNICIPIUL HUSI",90,"Liceul Teoretic""Cuza Voda"", STR. Mihail Kogalniceanu",1639,791,777,14,0,787,4,1701,910,292,495,1,15307,0
39,"Vaslui",161829,378,161829,,"MUNICIPIUL HUSI",91,"Liceul Agroindustrial, STR. I.A.Anghelus",1580,778,767,10,1,768,10,1601,823,276,492,1,15307,0
39,"Vaslui",161829,378,161829,,"MUNICIPIUL HUSI",92,"Scoala Generala nr.3, STR. Mihail Kogalniceanu",1762,862,841,21,0,855,7,1800,938,305,550,1,15307,0
39,"Vaslui",161829,378,161829,,"MUNICIPIUL HUSI",93,"Scoala Generala nr.3, STR. I.L.Caragiale",1114,470,456,12,2,466,4,1201,731,180,286,1,15307,0
39,"Vaslui",161829,378,161829,,"MUNICIPIUL HUSI",94,"Scoala Generala nr.3, STR. I.L.Caragiale",1719,776,767,9,0,762,14,1800,1024,381,381,1,15307,0
39,"Vaslui",161829,378,161829,,"MUNICIPIUL HUSI",95,"Casa de Cultura, STR. Alexandru Giugaru nr.1",1761,835,821,14,0,832,3,1801,966,324,508,1,15307,0
39,"Vaslui",161829,378,161829,,"MUNICIPIUL HUSI",96,"Scoala Generala nr.1, STR. Alexandru Ioan Cuza",1736,839,819,20,0,830,9,1801,962,314,516,1,15307,0
39,"Vaslui",161829,378,161829,,"MUNICIPIUL HUSI",97,"Scoala Generala nr.2, STR. Alexandru Ioan Cuza",1528,746,737,8,1,739,7,1601,855,242,497,1,15307,0
39,"Vaslui",161829,378,161829,,"MUNICIPIUL HUSI",98,"Scoala Generala nr.2, STR. Stefan cel Mare",1789,838,808,29,1,828,10,1900,1062,324,504,1,15307,0
39,"Vaslui",161829,378,161829,,"MUNICIPIUL HUSI",99,"Scoala Generala nr.2, STR. Stefan cel Mare",1520,733,717,16,0,724,9,1601,868,246,478,1,15307,0
39,"Vaslui",161829,378,161829,,"MUNICIPIUL HUSI",100,"Scoala Generala nr.5, STR. Corni",974,435,422,12,1,429,6,995,560,233,196,1,15307,0
39,"Vaslui",161829,378,161829,,"MUNICIPIUL HUSI",101,"Scoala Generala nr.5, STR. Corni",825,332,319,11,2,321,11,901,569,193,128,1,15307,0
39,"Vaslui",161829,378,161829,,"MUNICIPIUL HUSI",102,"Scoala Generala nr.4, STR. Anton Sarbu",1432,648,638,10,0,638,10,1501,853,238,400,1,15307,0
39,"Vaslui",161829,378,161829,,"MUNICIPIUL HUSI",103,"Scoala Generala nr.4, STR. Anton Sarbu",1669,662,651,10,1,659,3,1601,939,262,397,1,15307,0
39,"Vaslui",161829,378,161829,,"MUNICIPIUL HUSI",104,"Agentia de Plati si Interventii pentru Agricultura, Soseaua Husi-Drinceni nr.16",771,313,294,19,0,313,0,804,491,113,200,1,15307,0
39,"Vaslui",161829,378,161829,,"MUNICIPIUL HUSI",105,"Scoala Profesionala ""Sf.Ecaterina"", STR. Dobrina nr.2",0,346,0,346,0,343,3,801,455,188,155,1,15307,1
39,"Vaslui",164981,378,164981,,"ORAS MURGENI",106,"Casa de Cultura ,str.C.I Balus nr.3",1828,817,811,6,0,802,15,1901,1084,282,520,1,15309,0
39,"Vaslui",164981,378,164981,,"ORAS MURGENI",107,"Scoala Generala cu clasele I-VIII Murgeni, cartier Satu Nou",920,326,287,39,0,315,11,1001,675,120,195,1,15309,0
39,"Vaslui",164981,378,164981,,"ORAS MURGENI",108,"Scoala Generala cu clasele I-VIII Carja,",881,434,429,5,0,427,7,901,467,148,279,1,15309,0
39,"Vaslui",164981,378,164981,,"ORAS MURGENI",109,"Scoala Generala cu clasele I-VIII Floreni,",548,289,281,7,1,285,4,600,311,115,170,1,15309,0
39,"Vaslui",164981,378,164981,,"ORAS MURGENI",110,"Scoala Generala cu clasele I-IV Latesti",281,175,167,8,0,172,3,301,126,53,119,1,15309,0
39,"Vaslui",164981,378,164981,,"ORAS MURGENI",111,"Scoala Generala cu clasele I-IV Raiu",567,289,283,6,0,280,9,601,312,68,212,1,15309,0
39,"Vaslui",164981,378,164981,,"ORAS MURGENI",112,"Scoala Generala cu clasele I-VIII Sarateni",311,146,141,5,0,143,3,401,255,49,94,1,15309,0
39,"Vaslui",164981,378,164981,,"ORAS MURGENI",113,"Scoala Generala cu clasele I-IV Schineni",446,249,243,6,0,245,4,501,252,76,169,1,15309,0
39,"Vaslui",164981,378,164981,,"ORAS MURGENI",114,"Autogara SC TIVICO-SRL STR. Ghenuta Coman nr.14",0,134,0,134,0,133,1,301,167,51,82,1,15309,1
39,"Vaslui",161856,378,161856,,"ORAS NEGRESTI",115,"Casa de Cultura Negresti, STR. M.Kogalniceanu  nr.4",1588,773,768,5,0,763,10,1601,828,291,472,1,15317,0
39,"Vaslui",161856,378,161856,,"ORAS NEGRESTI",116,"Casa de Cultura Negresti, STR. M.Kogalniceanu  nr.4",1559,732,721,11,0,723,9,1601,869,307,416,1,15317,0
39,"Vaslui",161856,378,161856,,"ORAS NEGRESTI",117,"Cantina de Ajutor Social, STR. Pietii nr.1",1455,742,727,15,0,727,15,1501,759,303,424,1,15317,0
39,"Vaslui",161856,378,161856,,"ORAS NEGRESTI",118,"Scoala Generala Negresti-Sat, STR. A.I.Cuza  nr.35",1073,521,512,9,0,510,11,1101,580,236,274,1,15317,0
39,"Vaslui",161856,378,161856,,"ORAS NEGRESTI",119,"Scoala Generala  Valea Mare",701,386,378,8,0,379,7,801,415,185,194,1,15317,0
39,"Vaslui",161856,378,161856,,"ORAS NEGRESTI",120,"Scoala Generala  Poiana",242,128,121,7,0,125,3,300,172,56,69,1,15317,0
39,"Vaslui",161856,378,161856,,"ORAS NEGRESTI",121,"Scoala Generala  Cioatele",232,157,150,7,0,156,1,301,144,114,42,1,15317,0
39,"Vaslui",161856,378,161856,,"ORAS NEGRESTI",122,"Scoala Generala  Parpanita",453,255,245,10,0,250,5,500,245,82,168,1,15317,0
39,"Vaslui",161856,378,161856,,"ORAS NEGRESTI",123,"Scoala Generala  Glodeni",228,138,132,6,0,137,1,302,164,46,91,1,15317,0
39,"Vaslui",161856,378,161856,,"ORAS NEGRESTI",124,"Scoala Generala Cazanesti",365,173,168,5,0,170,3,403,230,53,117,1,15317,0
39,"Vaslui",161856,378,161856,,"ORAS NEGRESTI",125,"Statia C.F.R.Negresti, STR. Garii nr.54",0,104,0,104,0,103,1,299,195,52,51,1,15317,1
39,"Vaslui",162014,378,162014,,"ALBESTI",126,"Scoala generala cu clasele I-IV, Albesti",909,453,440,13,0,432,21,1001,548,212,220,3,15325,0
39,"Vaslui",162014,378,162014,,"ALBESTI",127,"Scoala generala cu clasele I-VIII, Corni Albesti",1085,528,517,11,0,521,7,1101,573,226,295,3,15325,0
39,"Vaslui",162014,378,162014,,"ALBESTI",128,"Scoala generala cu clasele I-IV, Crasna",397,203,192,11,0,203,0,401,198,108,95,3,15325,0
39,"Vaslui",162014,378,162014,,"ALBESTI",129,"Scoala generala cu clasele I-IV, Gura Albesti",130,93,83,10,0,92,1,200,107,34,58,3,15325,0
39,"Vaslui",162014,378,162014,,"ALBESTI",130,"Scoala generala cu clasele I-VIII Corni Albesti",0,112,0,112,0,112,0,151,39,59,53,3,15325,1
39,"Vaslui",162069,378,162069,,"ALEXANDRU VLAHUTA",131,"Scoala generala cu clasele I-VIII, Alexandru Vlahuta",636,330,315,15,0,322,8,701,371,134,188,3,15330,0
39,"Vaslui",162069,378,162069,,"ALEXANDRU VLAHUTA",132,"Scoala cu clasele I-IV, Buda",243,140,128,12,0,137,3,301,161,77,60,3,15330,0
39,"Vaslui",162069,378,162069,,"ALEXANDRU VLAHUTA",133,"Scoala cu clasele I-IV, Ghicani",151,74,63,11,0,73,1,200,126,33,40,3,15330,0
39,"Vaslui",162069,378,162069,,"ALEXANDRU VLAHUTA",134,"Scoala cu clasele I-IV, Morareni",169,95,88,7,0,92,3,201,106,50,42,3,15330,0
39,"Vaslui",162069,378,162069,,"ALEXANDRU VLAHUTA",135,"Scoala cu clasele I-VIII, Floresti",513,256,244,12,0,254,2,603,347,115,139,3,15330,0
39,"Vaslui",162069,378,162069,,"ALEXANDRU VLAHUTA",136,"Scoala de Arte si Meserii Alexandru Vlahuta",0,53,0,53,0,53,0,150,97,24,29,3,15330,1
39,"Vaslui",162149,378,162149,,"ARSURA",137,"Scoala cu clasele I-VIII, Arsura",619,274,264,10,0,269,5,701,427,59,210,3,15335,0
39,"Vaslui",162149,378,162149,,"ARSURA",138,"Scoala cu clasele I-IV, Fundatura",392,176,169,7,0,175,1,398,222,76,99,3,15335,0
39,"Vaslui",162149,378,162149,,"ARSURA",139,"Scoala cu clasele I-IV, Pihnesti",413,223,209,14,0,219,4,500,277,67,152,3,15335,0
39,"Vaslui",162149,378,162149,,"ARSURA",140,"Scoala cu clasele I-IV Mihail Kogalniceanu",81,59,45,14,0,59,0,102,43,19,40,3,15335,0
39,"Vaslui",162149,378,162149,,"ARSURA",141,"Scoala cu clasele I-IV Arsura",0,58,0,58,0,58,0,153,95,26,32,3,15335,1
39,"Vaslui",162194,378,162194,,"BANCA",142,"Scoala cu clasele I-VIII, Gara Banca",874,529,487,42,0,518,11,901,372,324,194,3,15357,0
39,"Vaslui",162194,378,162194,,"BANCA",143,"Scoala cu clasele I-VIII, Banca",914,433,417,16,0,425,8,1001,568,215,210,3,15357,0
39,"Vaslui",162194,378,162194,,"BANCA",144,"Scoala cu clasele I-IV, Ghermanesti",416,237,227,10,0,233,4,501,264,108,125,3,15357,0
39,"Vaslui",162194,378,162194,,"BANCA",145,"Scoala cu clasele I-IV, Stoisesti",547,293,284,9,0,284,9,601,308,101,183,3,15357,0
39,"Vaslui",162194,378,162194,,"BANCA",146,"Scoala cu clasele I-VIII, Tifu",513,291,275,16,0,281,10,601,310,125,156,3,15357,0
39,"Vaslui",162194,378,162194,,"BANCA",147,"Scoala cu clasele I-IV, 1 Decembrie",339,290,255,35,0,253,37,400,110,118,135,3,15357,0
39,"Vaslui",162194,378,162194,,"BANCA",148,"Scoala cu clasele I-IV, Mitoc",378,224,216,8,0,222,2,401,177,119,103,3,15357,0
39,"Vaslui",162194,378,162194,,"BANCA",149,"Scoala cu clasele I-VIII, Sarbi",338,199,188,11,0,199,0,401,202,131,68,3,15357,0
39,"Vaslui",162194,378,162194,,"BANCA",150,"Scoala cu clasele I-VIII, Gara Banca, corpul A",0,77,0,77,0,76,1,151,74,42,34,3,15357,1
39,"Vaslui",162327,378,162327,,"BACANI",151,"Scoala cu clasele I-VIII, Bacani",964,589,576,12,1,572,17,1001,412,200,372,3,15340,0
39,"Vaslui",162327,378,162327,,"BACANI",152,"Scoala cu clasele I-IV, Baltateni",274,196,189,7,0,190,6,301,105,69,121,3,15340,0
39,"Vaslui",162327,378,162327,,"BACANI",153,"Scoala cu clasele I-IV, Drujesti",349,230,222,8,0,223,7,401,171,62,161,3,15340,0
39,"Vaslui",162327,378,162327,,"BACANI",154,"Scoala cu clasele I-IV, Suseni",343,178,172,6,0,173,5,401,223,50,123,3,15340,0
39,"Vaslui",162327,378,162327,,"BACANI",155,"Scoala cu clasele I-IV, Vulpaseni",165,100,91,9,0,99,1,201,101,33,66,3,15340,0
39,"Vaslui",162327,378,162327,,"BACANI",156,"Scoala cu clasele I-VIII, Bacani",0,65,0,65,0,64,1,152,87,18,46,3,15340,1
39,"Vaslui",162381,378,162381,,"BACESTI",157,"Scoala de Arte si Meserii, Bacesti",1619,805,799,5,1,783,22,1701,896,386,397,3,15346,0
39,"Vaslui",162381,378,162381,,"BACESTI",158,"Scoala cu clasele I-IV, Armaseni",318,161,149,12,0,158,3,401,240,68,90,3,15346,0
39,"Vaslui",162381,378,162381,,"BACESTI",159,"Scoala cu clasele I-IV, Babusa",326,196,185,10,1,189,7,401,205,99,90,3,15346,0
39,"Vaslui",162381,378,162381,,"BACESTI",160,"Scoala cu clasele I-IV, Paltinis",209,159,151,8,0,153,6,301,142,64,89,3,15346,0
39,"Vaslui",162381,378,162381,,"BACESTI",161,"Scoala cu clasele I-IV, tibanestii Buhlii",193,103,94,9,0,103,0,201,98,52,51,3,15346,0
39,"Vaslui",162381,378,162381,,"BACESTI",162,"Scoala cu clasele I-IV, Vovriesti",274,162,156,6,0,161,1,301,139,81,80,3,15346,0
39,"Vaslui",162381,378,162381,,"BACESTI",163,"Scoala de Arte si Meserii, Bacesti",0,89,0,89,0,84,5,151,62,57,27,3,15346,1
39,"Vaslui",162452,378,162452,,"BALTENI",164,"Scoala cu clasele I-VIII, Balteni",773,420,418,2,0,415,5,801,381,152,263,3,15353,0
39,"Vaslui",162452,378,162452,,"BALTENI",165,"Scoala cu clasele I-IV, Balteni Deal",384,184,178,6,0,180,4,401,217,52,128,3,15353,0
39,"Vaslui",162452,378,162452,,"BALTENI",166,"Scoala cu clasele I-IV, Chetresti",125,74,68,6,0,73,1,201,127,29,44,3,15353,0
39,"Vaslui",162452,378,162452,,"BALTENI",167,"Scoala cu clasele I-VIII, Balteni",0,68,0,68,0,67,1,151,83,21,46,3,15353,1
39,"Vaslui",162498,378,162498,,"BEREZENI",168,"Scoala de Arte si Meserii nr.1, Berezeni",1429,659,619,40,0,638,21,1501,842,197,441,3,15370,0
39,"Vaslui",162498,378,162498,,"BEREZENI",169,"Scoala nr.3, Berezeni",658,449,404,45,0,440,9,701,252,140,300,3,15370,0
39,"Vaslui",162498,378,162498,,"BEREZENI",170,"Scoala nr.2, Satu Nou",1082,655,573,82,0,643,12,1101,446,185,458,3,15370,0
39,"Vaslui",162498,378,162498,,"BEREZENI",171,"Scoala Musata",372,182,169,13,0,181,1,401,219,54,127,3,15370,0
39,"Vaslui",162498,378,162498,,"BEREZENI",172,"Scoala Rinceni",485,276,253,23,0,271,5,501,225,82,189,3,15370,0
39,"Vaslui",162498,378,162498,,"BEREZENI",173,"Scoala Stuhulet",207,129,114,15,0,125,4,301,172,46,79,3,15370,0
39,"Vaslui",162498,378,162498,,"BEREZENI",174,"Scoala de Arte si Meserii nr.1, Berezeni, corpul A",0,80,0,80,0,80,0,151,71,32,48,3,15370,1
39,"Vaslui",162559,378,162559,,"BLAGESTI",175,"Caminul Cultural Blagesti",992,442,438,4,0,434,8,998,556,163,271,3,15376,0
39,"Vaslui",162559,378,162559,,"BLAGESTI",176,"Scoala generala cu clasele I-IV Igesti",249,135,130,5,0,126,9,301,166,58,68,3,15376,0
39,"Vaslui",162559,378,162559,,"BLAGESTI",177,"Scoala Sipeni",103,72,63,9,0,72,0,202,130,15,57,3,15376,0
39,"Vaslui",162559,378,162559,,"BLAGESTI",178,"Caminul Cultural Blagesti",0,89,0,89,0,88,1,151,62,27,61,3,15376,1
39,"Vaslui",162595,378,162595,,"BOGDANA",179,"Scoala generala cu claseleI-VIII Bogdana",544,272,265,7,0,265,7,601,329,78,187,3,15380,0
39,"Vaslui",162595,378,162595,,"BOGDANA",180,"Scoala generala cu clasele I-IV Suceveni",183,108,98,10,0,106,2,201,93,51,55,3,15380,0
39,"Vaslui",162595,378,162595,,"BOGDANA",181,"Scoala generala cu clasele I-IV Gavanu",106,69,60,9,0,67,2,201,132,12,55,3,15380,0
39,"Vaslui",162595,378,162595,,"BOGDANA",182,"Gradinita Verdes",159,88,77,11,0,86,2,201,113,22,64,3,15380,0
39,"Vaslui",162595,378,162595,,"BOGDANA",183,"Scoala generala cu clasele I-IV Lacu Babei",316,164,162,2,0,158,6,401,237,41,117,3,15380,0
39,"Vaslui",162595,378,162595,,"BOGDANA",184,"Scoala generala cu clasele I-VIII Bogdana",0,51,0,51,0,51,0,151,100,25,26,3,15380,1
39,"Vaslui",162693,378,162693,,"BOGDANESTI",185,"Caminul Cultural Bogdanesti",831,426,414,12,0,420,6,900,474,155,265,3,15390,0
39,"Vaslui",162693,378,162693,,"BOGDANESTI",186,"Scoala generala cu clasele I-IV Buda",280,189,179,10,0,188,1,301,112,99,89,3,15390,0
39,"Vaslui",162693,378,162693,,"BOGDANESTI",187,"Scoala generala cu clasele I-IV Visinari",166,103,86,17,0,102,1,201,98,42,60,3,15390,0
39,"Vaslui",162693,378,162693,,"BOGDANESTI",188,"Scoala generala cu clasele I-IV Ulea",311,183,170,13,0,180,3,401,218,70,110,3,15390,0
39,"Vaslui",162693,378,162693,,"BOGDANESTI",189,"Scoala generala cu clasele I-VIII, Untesti",735,422,408,14,0,411,11,801,379,180,231,3,15390,0
39,"Vaslui",162693,378,162693,,"BOGDANESTI",190,"Scoala generala cu clasele I-IV Horoiata",112,87,82,5,0,87,0,201,114,46,41,3,15390,0
39,"Vaslui",162693,378,162693,,"BOGDANESTI",191,"Caminul Cultural Bogdanesti",0,121,0,121,0,121,0,151,30,65,56,3,15390,1
39,"Vaslui",162791,378,162791,,"BOGDANITA",192,"Scoala cu clasele I-IV, Bogdanita",181,94,87,7,0,91,3,201,107,37,54,3,15400,0
39,"Vaslui",162791,378,162791,,"BOGDANITA",193,"Scoala cu clasele I-IV, Coroiesti",354,182,176,6,0,180,2,400,218,95,85,3,15400,0
39,"Vaslui",162791,378,162791,,"BOGDANITA",194,"Scoala cu clasele I-IV, Tunsesti",204,124,119,5,0,122,2,301,177,64,58,3,15400,0
39,"Vaslui",162791,378,162791,,"BOGDANITA",195,"Scoala cu clasele I-IV, Cepesti",475,239,230,9,0,235,4,501,262,110,125,3,15400,0
39,"Vaslui",162791,378,162791,,"BOGDANITA",196,"Scoala cu clasele I-IV, Coroiesti",0,57,0,57,0,57,0,150,93,22,35,3,15400,1
39,"Vaslui",162871,378,162871,,"BOTESTI",197,"Scoala generala  Botesti",875,447,426,21,0,438,9,901,454,183,255,3,15408,0
39,"Vaslui",162871,378,162871,,"BOTESTI",198,"Scoala generala cu clasele I-VIII Gugesti",883,514,497,17,0,507,7,901,387,161,346,3,15408,0
39,"Vaslui",162871,378,162871,,"BOTESTI",199,"Caminul Cultural Botesti",0,63,0,63,0,62,1,151,88,28,34,3,15408,1
39,"Vaslui",162924,378,162924,,"BUNESTI-AVERESTI",200,"Scoala cu clasele I-VIII Averesti",263,141,133,8,0,141,0,301,160,34,107,3,15413,0
39,"Vaslui",162924,378,162924,,"BUNESTI-AVERESTI",201,"Scoala generala cu clasele I-VIII  Bunesti",1009,530,520,10,0,523,7,1101,571,152,371,3,15413,0
39,"Vaslui",162924,378,162924,,"BUNESTI-AVERESTI",202,"Scoala generala cu clasele I-IV Plopi",418,213,203,10,0,209,4,501,288,63,146,3,15413,0
39,"Vaslui",162924,378,162924,,"BUNESTI-AVERESTI",203,"Scoala generala cu clasele I-IV Armaseni",343,159,152,7,0,155,4,401,242,59,96,3,15413,0
39,"Vaslui",162924,378,162924,,"BUNESTI-AVERESTI",204,"Scoala generala cu clasele I-IV Podu-Oprii",217,125,110,15,0,121,4,265,140,38,83,3,15413,0
39,"Vaslui",162924,378,162924,,"BUNESTI-AVERESTI",205,"Scoala generala cu clasele I-VIII  Bunesti - cladirea noua",0,51,0,51,0,51,0,151,100,25,26,3,15413,1
39,"Vaslui",167268,378,167268,,"CIOCANI",206,"Caminul Cultural, Ciocani",870,348,340,8,0,335,13,901,553,136,199,3,15421,0
39,"Vaslui",167268,378,167268,,"CIOCANI",207,"Scoala cu clasele I-IV , Crang",352,173,166,7,0,170,3,401,228,74,96,3,15421,0
39,"Vaslui",167268,378,167268,,"CIOCANI",208,"Caminul Cultural, Ciocani",0,40,0,40,0,40,0,151,111,14,26,3,15421,1
39,"Vaslui",163002,378,163002,,"CODAESTI",209,"Caminul Cultural, Codaesti",1793,786,778,8,0,774,12,1801,1015,205,569,3,15426,0
39,"Vaslui",163002,378,163002,,"CODAESTI",210,"Scoala generala Pribesti",1003,482,458,24,0,475,7,1101,619,180,295,3,15426,0
39,"Vaslui",163002,378,163002,,"CODAESTI",211,"Caminul Cultural, Rediu-Galian",496,204,195,9,0,199,5,601,397,83,116,3,15426,0
39,"Vaslui",163002,378,163002,,"CODAESTI",212,"Scoala generala Ghergheleu",369,180,170,10,0,177,3,401,221,52,125,3,15426,0
39,"Vaslui",163002,378,163002,,"CODAESTI",213,"Caminul Cultural, Codaesti",0,63,0,63,0,63,0,151,88,18,45,3,15426,1
39,"Vaslui",163057,378,163057,,"COROIESTI",214,"Scoala Noua cu clasele I-VIII, Coroiesti jos",795,594,591,3,0,586,8,900,306,185,401,3,15431,0
39,"Vaslui",163057,378,163057,,"COROIESTI",215,"Scoala cu clasele I-IV, Chilieni",236,210,204,6,0,203,7,301,91,8,195,3,15431,0
39,"Vaslui",163057,378,163057,,"COROIESTI",216,"Scoala cu clasele I-IV, Mireni",661,504,491,13,0,497,7,701,197,86,411,3,15431,0
39,"Vaslui",163057,378,163057,,"COROIESTI",217,"Scoala Noua cu clasele I-VIII, Coroiesti jos",0,45,0,45,0,45,0,150,105,17,28,3,15431,1
39,"Vaslui",163137,378,163137,,"COSTESTI",218,"Scoala generala Costesti (SAM)",1548,788,779,9,0,769,19,1601,813,323,446,3,15439,0
39,"Vaslui",163137,378,163137,,"COSTESTI",219,"Scoala generala Puntiseni",252,148,137,11,0,142,6,301,153,46,96,3,15439,0
39,"Vaslui",163137,378,163137,,"COSTESTI",220,"Scoala generala Chitcani",277,167,156,11,0,166,1,301,134,64,102,3,15439,0
39,"Vaslui",163137,378,163137,,"COSTESTI",221,"Scoala generala Dinga",115,81,72,9,0,81,0,201,120,25,56,3,15439,0
39,"Vaslui",163137,378,163137,,"COSTESTI",222,"Scoala generala Radesti",131,101,93,8,0,97,4,201,100,40,57,3,15439,0
39,"Vaslui",163137,378,163137,,"COSTESTI",223,"Scoala generala Pirvesti",78,59,47,12,0,58,1,101,42,8,50,3,15439,0
39,"Vaslui",163137,378,163137,,"COSTESTI",224,"Scoala generala Costesti (SAM)",0,83,0,83,0,82,1,151,68,34,48,3,15439,1
39,"Vaslui",167277,378,167277,,"COZMESTI",225,"Scoala cu clasele I-IV, Balesti",622,286,279,7,0,281,5,701,415,74,207,3,15446,0
39,"Vaslui",167277,378,167277,,"COZMESTI",226,"Scoala cu clasele I-IV , Cozmesti",285,130,126,4,0,130,0,401,271,48,82,3,15446,0
39,"Vaslui",167277,378,167277,,"COZMESTI",227,"Scoala de Arte si Meserii, Fistici (fostul sediu al Brigazii Silvice)",955,382,376,6,0,366,16,1000,618,94,272,3,15446,0
39,"Vaslui",167277,378,167277,,"COZMESTI",228,"Scoala cu clasele I-IV, Balesti",0,74,0,74,0,74,0,151,77,26,48,3,15446,1
39,"Vaslui",163208,378,163208,,"CRETESTI",229,"Caminul Cultural Cretesti",564,298,279,8,11,290,6,700,402,101,189,3,15451,0
39,"Vaslui",163208,378,163208,,"CRETESTI",230,"Scoala Cretestii de Sus",489,260,225,11,24,253,7,601,341,91,162,3,15451,0
39,"Vaslui",163208,378,163208,,"CRETESTI",231,"Scoala Satu Nou",263,170,160,10,0,168,2,304,134,76,92,3,15451,0
39,"Vaslui",163208,378,163208,,"CRETESTI",232,"Scoala Budesti",184,104,97,7,0,100,4,203,99,29,71,3,15451,0
39,"Vaslui",163208,378,163208,,"CRETESTI",233,"Caminul Cultural Cretesti",0,79,0,79,0,79,0,152,73,29,50,3,15451,1
39,"Vaslui",163253,378,163253,,"DANESTI",234,"Caminul Cultural Danesti",507,199,195,4,0,192,7,601,402,63,129,3,15456,0
39,"Vaslui",163253,378,163253,,"DANESTI",235,"Scoala cu clasele I-VIII, Emil Racovita",773,307,299,8,0,291,16,801,494,92,199,3,15456,0
39,"Vaslui",163253,378,163253,,"DANESTI",236,"Scoala cu clasele I-IV Bereasa",300,158,152,6,0,155,3,401,243,55,100,3,15456,0
39,"Vaslui",163253,378,163253,,"DANESTI",237,"Scoala cu clasele I-IV Tatarani",197,114,103,11,0,109,5,301,187,48,61,3,15456,0
39,"Vaslui",163253,378,163253,,"DANESTI",238,"Caminul Cultural Danesti",0,43,0,43,0,42,1,151,108,16,26,3,15456,1
39,"Vaslui",163324,378,163324,,"DELENI",239,"Scoala generala cu clasele I-VIII, Deleni",1398,649,637,12,0,634,15,1501,852,277,357,3,15463,0
39,"Vaslui",163324,378,163324,,"DELENI",240,"Scoala generala cu clasele I-IV, Bulboaca",519,263,259,4,0,259,4,601,338,152,107,3,15463,0
39,"Vaslui",163324,378,163324,,"DELENI",241,"Scoala generala cu clasele I-VIII, Deleni",0,115,0,115,0,114,1,146,31,46,68,3,15463,1
39,"Vaslui",163379,378,163379,,"DELESTI",242,"Scoala de Arte si Meserii, Delesti",582,313,301,12,0,307,6,701,388,128,179,3,15468,0
39,"Vaslui",163379,378,163379,,"DELESTI",243,"Scoala generala cu clasele I-IV, Albesti",177,99,89,10,0,99,0,301,202,36,63,3,15468,0
39,"Vaslui",163379,378,163379,,"DELESTI",244,"Scoala cu clasele I-IV, Fundatura",430,217,209,8,0,209,8,501,284,80,129,3,15468,0
39,"Vaslui",163379,378,163379,,"DELESTI",245,"Scoala cu clasele I-VIII, Hirsova",434,251,238,13,0,244,7,501,250,148,96,3,15468,0
39,"Vaslui",163379,378,163379,,"DELESTI",246,"Scoala cu clasele I-IV, Minastirea",122,89,82,7,0,86,3,201,112,63,23,3,15468,0
39,"Vaslui",163379,378,163379,,"DELESTI",247,"Scoala cu clasele I-IV, Raduiesti",173,110,101,9,0,108,2,201,91,46,62,3,15468,0
39,"Vaslui",163379,378,163379,,"DELESTI",248,"Scoala de Arte si Meserii, Delesti",0,63,0,63,0,61,2,151,88,26,35,3,15468,1
39,"Vaslui",164277,378,164277,,"DIMITRIE CANTEMIR",249,"Scoala cu clasele I-VIII Hurdugi",599,305,300,5,0,301,4,701,396,105,196,3,15475,0
39,"Vaslui",164277,378,164277,,"DIMITRIE CANTEMIR",250,"Scoala cu clasele I-IV, Grumezoaia",439,224,214,10,0,217,7,501,277,68,149,3,15475,0
39,"Vaslui",164277,378,164277,,"DIMITRIE CANTEMIR",251,"Scoala cu clasele I-VIII, Gusitei",635,332,322,10,0,330,2,685,353,143,187,3,15475,0
39,"Vaslui",164277,378,164277,,"DIMITRIE CANTEMIR",252,"Scoala cu clasele I-IV Plotonesti",291,160,152,8,0,157,3,404,244,31,126,3,15475,0
39,"Vaslui",164277,378,164277,,"DIMITRIE CANTEMIR",253,"Scoala cu clasele I-IV Urlati",231,151,148,3,0,147,4,301,150,55,92,3,15475,0
39,"Vaslui",164277,378,164277,,"DIMITRIE CANTEMIR",254,"Scoala cu clasele I-VIII Hurdugi",0,35,0,35,0,35,0,151,116,16,19,3,15475,1
39,"Vaslui",167286,378,167286,,"DODESTI",255,"Scoala generala cu clasele I-VIII, Dodesti",1201,595,590,5,0,589,6,1301,706,115,474,3,15481,0
39,"Vaslui",167286,378,167286,,"DODESTI",256,"Scoala generala Urdesti",202,119,112,7,0,119,0,301,182,29,90,3,15481,0
39,"Vaslui",167286,378,167286,,"DODESTI",257,"Scoala generala cu clasele I-VIII, Dodesti",0,55,0,55,0,55,0,151,96,13,42,3,15481,1
39,"Vaslui",163486,378,163486,,"DRAGOMIRESTI",258,"Caminul Cultural, Dragomiresti",487,228,221,7,0,223,5,601,373,47,176,3,15484,0
39,"Vaslui",163486,378,163486,,"DRAGOMIRESTI",259,"Scoala primara cu clasele I-IV, Poiana Pietrei",245,121,113,8,0,119,2,300,179,50,69,3,15484,0
39,"Vaslui",163486,378,163486,,"DRAGOMIRESTI",260,"Scoala generala cu clasele I-VIII, Doagele",769,384,375,9,0,376,8,801,417,103,273,3,15484,0
39,"Vaslui",163486,378,163486,,"DRAGOMIRESTI",261,"Caminul Cultural, Vladia",368,162,155,7,0,161,1,401,239,53,108,3,15484,0
39,"Vaslui",163486,378,163486,,"DRAGOMIRESTI",262,"Scoala primara cu clasele I-IV, Belzeni",185,59,49,10,0,57,2,200,141,9,48,3,15484,0
39,"Vaslui",163486,378,163486,,"DRAGOMIRESTI",263,"Scoala primara cu clasele I-IV, Babuta",118,81,70,11,0,80,1,202,121,26,54,3,15484,0
39,"Vaslui",163486,378,163486,,"DRAGOMIRESTI",264,"Scoala generala cu clasele I-VIII, Radeni",857,362,349,12,1,356,6,1000,638,77,279,3,15484,0
39,"Vaslui",163486,378,163486,,"DRAGOMIRESTI",265,"Scoala primara cu clasele I-IV, Tulesti",156,72,67,5,0,72,0,201,129,15,57,3,15484,0
39,"Vaslui",163486,378,163486,,"DRAGOMIRESTI",266,"Scoala primara cu clasele I-IV, Popesti",316,192,171,21,0,189,3,401,209,54,135,3,15484,0
39,"Vaslui",163486,378,163486,,"DRAGOMIRESTI",267,"Caminul Cultural, Dragomiresti",0,73,0,73,0,73,0,152,79,28,45,3,15484,1
39,"Vaslui",163618,378,163618,,"DRANCENI",268,"S.A.M. Ghermanesti",1723,980,967,12,1,973,7,1801,821,654,319,3,15497,0
39,"Vaslui",163618,378,163618,,"DRANCENI",269,"Scoala cu clasele I-IV, Drinceni",471,219,205,14,0,214,5,500,281,114,100,3,15497,0
39,"Vaslui",163618,378,163618,,"DRANCENI",270,"Scoala cu clasele I-VIII, Rasesti, Corp B",1516,800,770,26,4,791,9,1601,801,367,424,3,15497,0
39,"Vaslui",163618,378,163618,,"DRANCENI",271,"Scoala cu clasele I-VIII, Rasesti, Corp A",0,89,0,89,0,89,0,150,61,51,38,3,15497,1
39,"Vaslui",163681,378,163681,,"DUDA-EPURENI",272,"Scoala generala cu clasele I-VIII Epureni",1281,517,509,8,0,507,10,1401,884,191,316,3,15504,0
39,"Vaslui",163681,378,163681,,"DUDA-EPURENI",273,"Scoala generala cu clasele I-VIII Duda",1147,552,541,11,0,539,13,1201,649,289,250,3,15504,0
39,"Vaslui",163681,378,163681,,"DUDA-EPURENI",274,"Scoala de Arte si Meserii Valea Grecului",1262,506,500,6,0,496,10,1401,895,253,243,3,15504,0
39,"Vaslui",163681,378,163681,,"DUDA-EPURENI",275,"Scoala Gimnaziala Bobesti",119,88,78,10,0,85,3,201,113,28,57,3,15504,0
39,"Vaslui",163681,378,163681,,"DUDA-EPURENI",276,"Scoala generala cu clasele I-VIII Epureni",0,52,0,52,0,52,0,151,99,29,23,3,15504,1
39,"Vaslui",163734,378,163734,,"DUMESTI",277,"Caminul Cultural Dumesti",1859,790,783,7,0,771,19,2001,1211,303,468,3,15509,0
39,"Vaslui",163734,378,163734,,"DUMESTI",278,"Scoala cu clasele I-IV, Dumestii Vechi",322,161,146,15,0,157,4,401,240,75,82,3,15509,0
39,"Vaslui",163734,378,163734,,"DUMESTI",279,"Scoala cu clasele I-IV, Valea Mare (corpul nou)",643,308,294,14,0,302,6,801,493,75,227,3,15509,0
39,"Vaslui",163734,378,163734,,"DUMESTI",280,"Caminul Cultural Dumesti",0,70,0,70,0,70,0,152,82,30,40,3,15509,1
39,"Vaslui",163789,378,163789,,"EPURENI",281,"Caminul Cultural Epureni",809,403,392,11,0,396,7,901,498,137,259,3,15514,0
39,"Vaslui",163789,378,163789,,"EPURENI",282,"Scoala cu clasele I-VIII, Bursuci",720,376,369,7,0,373,3,801,425,112,261,3,15514,0
39,"Vaslui",163789,378,163789,,"EPURENI",283,"Scoala cu clasele I-IV, Barlalesti",621,331,321,10,0,324,7,700,369,120,204,3,15514,0
39,"Vaslui",163789,378,163789,,"EPURENI",284,"Scoala cu clasele I-IV, Horga",350,172,170,2,0,168,4,406,234,81,87,3,15514,0
39,"Vaslui",163789,378,163789,,"EPURENI",285,"Caminul Cultural  Epureni",0,64,0,64,0,64,0,150,86,30,34,3,15514,1
39,"Vaslui",163832,378,163832,,"FALCIU",286,"Scoala de Arte si Meserii, Falciu, Corp A",1159,538,530,8,0,526,12,1201,663,242,284,3,15519,0
39,"Vaslui",163832,378,163832,,"FALCIU",287,"Caminul Cultural, Falciu",929,471,461,10,0,467,4,1001,530,221,246,3,15519,0
39,"Vaslui",163832,378,163832,,"FALCIU",288,"Scoala cu clasele I-IV, Bogdanesti",507,227,218,9,0,223,4,601,374,78,145,3,15519,0
39,"Vaslui",163832,378,163832,,"FALCIU",289,"Scoala generala cu clasele I-VIII, Rinzesti",912,442,434,8,0,433,9,1000,558,169,264,3,15519,0
39,"Vaslui",163832,378,163832,,"FALCIU",290,"Scoala generala cu clasele I-IV, Bozia",398,231,226,5,0,227,4,501,270,79,148,3,15519,0
39,"Vaslui",163832,378,163832,,"FALCIU",291,"Scoala generala cu clasele I-IV, Copaceana",503,276,267,9,0,266,10,601,325,118,148,3,15519,0
39,"Vaslui",163832,378,163832,,"FALCIU",292,"Scoala generala cu clasele I-IV, Odaia Bogdana",281,161,150,11,0,158,3,402,241,52,106,3,15519,0
39,"Vaslui",163832,378,163832,,"FALCIU",293,"Gradinita nr. 2 PIPO Falciu",0,61,0,61,0,60,1,151,90,26,34,3,15519,1
39,"Vaslui",167295,378,167295,,"FERESTI",294,"Centrul Cultural ""SANDU TRIFAN"", Feresti",1679,769,763,6,0,762,7,1801,1032,307,455,3,15526,0
39,"Vaslui",167295,378,167295,,"FERESTI",295,"Scoala cu clasele I-VIII Feresti",0,48,0,48,0,46,2,151,103,26,20,3,15526,1
39,"Vaslui",167231,378,167231,,"FRUNTISENI",296,"Scoala cu clasele I-VIII, Fruntiseni",761,417,411,6,0,410,7,801,384,86,324,3,15528,0
39,"Vaslui",167231,378,167231,,"FRUNTISENI",297,"Scoala cu clasele I-VIII, Grajdeni",636,337,332,5,0,325,12,800,463,95,230,3,15528,0
39,"Vaslui",167231,378,167231,,"FRUNTISENI",298,"Scoala cu clasele I-VIII, Fruntiseni",0,34,0,34,0,34,0,151,117,13,21,3,15528,1
39,"Vaslui",163903,378,163903,,"GAGESTI",299,"Scoala generala cu clasele I-VIII Gagesti",408,240,223,11,6,238,2,501,261,141,97,3,15531,0
39,"Vaslui",163903,378,163903,,"GAGESTI",300,"Gradinita Giurcani",422,227,218,9,0,222,5,501,274,98,124,3,15531,0
39,"Vaslui",163903,378,163903,,"GAGESTI",301,"Scoala cu clasele I-IV Peicani",469,288,284,4,0,286,2,601,313,163,123,3,15531,0
39,"Vaslui",163903,378,163903,,"GAGESTI",302,"Scoala cu clasele I-IV Tupilati",277,171,158,10,3,170,1,301,130,68,102,3,15531,0
39,"Vaslui",163903,378,163903,,"GAGESTI",303,"Scoala generala cu clasele I-VIII Gagesti",0,88,0,88,0,88,0,151,63,47,41,3,15531,1
39,"Vaslui",163967,378,163967,,"GHERGHESTI",304,"Caminul Cultural, Gherghesti",955,435,418,17,0,428,7,1101,666,180,248,3,15544,0
39,"Vaslui",163967,378,163967,,"GHERGHESTI",305,"Scoala generala cu clasele I-IV, Lunca",363,181,179,2,0,171,10,401,220,48,123,3,15544,0
39,"Vaslui",163967,378,163967,,"GHERGHESTI",306,"Scoala generala cu clasele I-IV, Corodesti",230,110,101,9,0,106,4,301,191,32,74,3,15544,0
39,"Vaslui",163967,378,163967,,"GHERGHESTI",307,"Scoala generala cu clasele I-VIII, Chetrosu",426,245,239,6,0,241,4,501,256,83,158,3,15544,0
39,"Vaslui",163967,378,163967,,"GHERGHESTI",308,"Scoala generala cu clasele I-IV, Draxeni",125,72,64,8,0,71,1,201,129,29,42,3,15544,0
39,"Vaslui",163967,378,163967,,"GHERGHESTI",309,"Caminul Cultural, Gherghesti",0,54,0,54,0,53,1,151,97,25,28,3,15544,1
39,"Vaslui",164062,378,164062,,"GARCENI",310,"Caminul Cultural Girceni",821,451,413,8,30,428,23,901,450,107,321,3,15537,0
39,"Vaslui",164062,378,164062,,"GARCENI",311,"Scoala cu clasele I-IV, Dumbraveni",214,142,128,7,7,139,3,300,158,41,98,3,15537,0
39,"Vaslui",164062,378,164062,,"GARCENI",312,"Scoala cu clasele I-IV, Trohan",186,117,105,9,3,115,2,300,183,37,78,3,15537,0
39,"Vaslui",164062,378,164062,,"GARCENI",313,"Scoala cu clasele I-VIII, Racova",181,98,92,6,0,97,1,302,204,38,59,3,15537,0
39,"Vaslui",164062,378,164062,,"GARCENI",314,"Scoala cu clasele I-IV, Racovita",141,77,67,10,0,77,0,201,124,19,58,3,15537,0
39,"Vaslui",164062,378,164062,,"GARCENI",315,"Scoala cu clasele I-IV, Slobozia",303,210,197,13,0,206,4,400,190,37,169,3,15537,0
39,"Vaslui",164062,378,164062,,"GARCENI",316,"Caminul Cultural Girceni",0,92,0,92,0,89,3,151,59,33,56,3,15537,1
39,"Vaslui",164133,378,164133,,"GRIVITA",317,"Scoala cu clasele I-VIII Grivita",1233,792,772,20,0,774,18,1201,409,425,349,3,15554,0
39,"Vaslui",164133,378,164133,,"GRIVITA",318,"Scoala cu clasele I-IV Odaia Bursucani",436,240,233,7,0,236,4,501,261,115,121,3,15554,0
39,"Vaslui",164133,378,164133,,"GRIVITA",319,"Scoala  cu clasele I-VIII Trestiana",1079,583,572,11,0,574,9,1201,618,216,358,3,15554,0
39,"Vaslui",164133,378,164133,,"GRIVITA",320,"Scoala cu clasele I-VIII Grivita",0,167,0,167,0,166,1,251,84,89,77,3,15554,1
39,"Vaslui",164197,378,164197,,"HOCENI",321,"Caminul Cultural Hoceni",495,272,264,8,0,269,3,600,328,88,181,3,15558,0
39,"Vaslui",164197,378,164197,,"HOCENI",322,"Gradinita de copii Barbosi",610,355,347,8,0,348,7,701,346,96,252,3,15558,0
39,"Vaslui",164197,378,164197,,"HOCENI",323,"Gradinita de copii Deleni",404,239,227,12,0,234,5,501,262,85,149,3,15558,0
39,"Vaslui",164197,378,164197,,"HOCENI",324,"Scoala cu clasele I-IV Oteleni",464,278,271,7,0,270,8,501,223,86,184,3,15558,0
39,"Vaslui",164197,378,164197,,"HOCENI",325,"Scoala cu clasele I-IV Siscani",287,168,163,5,0,163,5,401,233,66,97,3,15558,0
39,"Vaslui",164197,378,164197,,"HOCENI",326,"Scoala cu clasele I-IV Tomsa",112,79,68,11,0,78,1,200,121,23,55,3,15558,0
39,"Vaslui",164197,378,164197,,"HOCENI",327,"Caminul Cultural Hoceni",0,86,0,86,0,86,0,151,65,36,50,3,15558,1
39,"Vaslui",164339,378,164339,,"IANA",328,"Scoala de Arte si Meserii Iana",887,420,410,10,0,416,4,1001,581,234,182,3,15566,0
39,"Vaslui",164339,378,164339,,"IANA",329,"Scoala cu clasele I-IV Halaresti",818,391,381,10,0,384,7,901,510,226,158,3,15566,0
39,"Vaslui",164339,378,164339,,"IANA",330,"Scoala cu clasele I-IV Silistea",707,418,413,5,0,413,5,801,383,165,248,3,15566,0
39,"Vaslui",164339,378,164339,,"IANA",331,"Scoala cu clasele I-VIII Recea",275,150,140,10,0,150,0,301,151,57,93,3,15566,0
39,"Vaslui",164339,378,164339,,"IANA",332,"Gradinita Vadurile",243,130,123,7,0,126,4,301,171,60,66,3,15566,0
39,"Vaslui",164339,378,164339,,"IANA",333,"Scoala de Arte si Meserii Iana",0,76,0,76,0,75,1,151,75,41,34,3,15566,1
39,"Vaslui",167222,378,167222,,"IBANESTI",334,"Caminul Cultural Ibanesti",542,305,295,8,2,298,7,601,296,153,145,3,15572,0
39,"Vaslui",167222,378,167222,,"IBANESTI",335,"Scoala cu clasele I-IV, Manzati",524,325,310,8,7,313,12,601,276,181,132,3,15572,0
39,"Vaslui",167222,378,167222,,"IBANESTI",336,"Scoala cu clasele I-IV, Putu Olarului",100,82,73,9,0,76,6,201,119,43,33,3,15572,0
39,"Vaslui",167222,378,167222,,"IBANESTI",337,"Centrul PAPI Ibanesti",0,50,0,50,0,50,0,151,101,27,23,3,15572,1
39,"Vaslui",164393,378,164393,,"IVANESTI",338,"Scoala generala cu clasele I-VIII Ivanesti",1071,466,428,37,1,454,12,1201,735,119,335,3,15576,0
39,"Vaslui",164393,378,164393,,"IVANESTI",339,"Scoala generala cu clasele I-IV Brosteni",449,218,212,6,0,209,9,600,382,65,144,3,15576,0
39,"Vaslui",164393,378,164393,,"IVANESTI",340,"Scoala generala cu clasele I-IV Valea Mare",412,219,208,11,0,216,3,501,282,28,188,3,15576,0
39,"Vaslui",164393,378,164393,,"IVANESTI",341,"Scoala generala cu clasele I-IV  Cosca",302,136,128,8,0,133,3,401,265,36,97,3,15576,0
39,"Vaslui",164393,378,164393,,"IVANESTI",342,"Scoala generala cu clasele I-IV Cosesti",352,168,145,23,0,163,5,401,233,59,104,3,15576,0
39,"Vaslui",164393,378,164393,,"IVANESTI",343,"Scoala generala cu clasele I-IV  Valea Oanei",258,119,112,7,0,116,3,301,182,36,80,3,15576,0
39,"Vaslui",164393,378,164393,,"IVANESTI",344,"Scoala generala cu clasele I-VIII Ursoaia",373,182,170,12,0,178,4,401,219,39,139,3,15576,0
39,"Vaslui",164393,378,164393,,"IVANESTI",345,"Scoala generala cu clasele I-IV Blesca",436,201,188,13,0,199,2,501,300,60,139,3,15576,0
39,"Vaslui",164393,378,164393,,"IVANESTI",346,"Centrul Cultural Ivanesti",0,87,0,87,0,84,3,151,64,24,60,3,15576,1
39,"Vaslui",164543,378,164543,,"IVESTI",347,"Scoala de Arte si Meserii Ivesti, corpul A",1180,499,495,4,0,489,10,1301,802,191,298,3,15591,0
39,"Vaslui",164543,378,164543,,"IVESTI",348,"Scoala de Arte si Meserii Ivesti, corpul B",1035,512,508,4,0,507,5,1201,689,146,361,3,15591,0
39,"Vaslui",164543,378,164543,,"IVESTI",349,"Scoala cu clasele I-VIII Ivesti, P+1E",0,45,0,45,0,45,0,151,106,21,24,3,15591,1
39,"Vaslui",164598,378,164598,,"LAZA",350,"Scoala de Arte si Meserii Laza",1506,648,625,23,0,639,9,1600,952,221,418,3,15593,0
39,"Vaslui",164598,378,164598,,"LAZA",351,"Scoala generala cu clasele I-VIII ,Sauca",880,436,428,8,0,431,5,1000,564,91,340,3,15593,0
39,"Vaslui",164598,378,164598,,"LAZA",352,"Scoala generala cu clasele I-IV, Rasnita",251,98,91,7,0,97,1,301,203,41,56,3,15593,0
39,"Vaslui",164598,378,164598,,"LAZA",353,"Scoala de Arte si Meserii, Laza",0,45,0,45,0,44,1,152,107,21,23,3,15593,1
39,"Vaslui",164687,378,164687,,"LIPOVAT",354,"Scoala generala, Lipovat",1292,714,705,9,0,698,16,1401,687,135,563,3,15598,0
39,"Vaslui",164687,378,164687,,"LIPOVAT",355,"Scoala generala, Corbu",442,244,232,12,0,233,11,501,257,45,188,3,15598,0
39,"Vaslui",164687,378,164687,,"LIPOVAT",356,"Scoala generala, Chitoc",846,407,401,6,0,399,8,1001,594,133,266,3,15598,0
39,"Vaslui",164687,378,164687,,"LIPOVAT",357,"Scoala generala , Capusneni",210,148,136,12,0,146,2,301,153,14,132,3,15598,0
39,"Vaslui",164687,378,164687,,"LIPOVAT",358,"Scoala generala, Fundu Vaii",417,282,261,21,0,277,5,501,219,34,243,3,15598,0
39,"Vaslui",164687,378,164687,,"LIPOVAT",359,"Biblioteca comunei Lipovat",0,69,0,69,0,68,1,151,82,25,43,3,15598,1
39,"Vaslui",164749,378,164749,,"LUNCA BANULUI",360,"Scoala de Arte si Meserii Lunca Banului",1726,808,797,11,0,796,12,1801,993,279,517,3,15604,0
39,"Vaslui",164749,378,164749,,"LUNCA BANULUI",361,"Scoala generala cu clasele I-VIII Otetoaia",650,280,274,6,0,276,4,802,522,98,178,3,15604,0
39,"Vaslui",164749,378,164749,,"LUNCA BANULUI",362,"Scoala generala cu clasele I-IV Lunca Veche",76,48,36,12,0,48,0,101,53,24,24,3,15604,0
39,"Vaslui",164749,378,164749,,"LUNCA BANULUI",363,"Scoala generala  cu clasele I-IV Focsa",140,85,80,5,0,85,0,201,116,25,60,3,15604,0
39,"Vaslui",164749,378,164749,,"LUNCA BANULUI",364,"Scoala generala cu clasele I-VIII  Broscosesti",437,208,202,6,0,206,2,501,293,107,99,3,15604,0
39,"Vaslui",164749,378,164749,,"LUNCA BANULUI",365,"Scoala cu clasele I-VIII Lunca Banului",0,45,0,45,0,45,0,149,104,26,19,3,15604,1
39,"Vaslui",164829,378,164829,,"MALUSTENI",366,"Scoala Veche Malusteni",548,285,274,11,0,281,4,600,315,103,178,3,15612,0
39,"Vaslui",164829,378,164829,,"MALUSTENI",367,"Scoala Centru Tutcani",527,274,270,4,0,272,2,601,327,90,182,3,15612,0
39,"Vaslui",164829,378,164829,,"MALUSTENI",368,"Scoala cu clasele I-IV Minastirea",88,61,45,16,0,60,1,101,40,21,39,3,15612,0
39,"Vaslui",164829,378,164829,,"MALUSTENI",369,"Scoala  cu clasele I-IV Ghireasca",172,94,87,7,0,92,2,202,108,26,66,3,15612,0
39,"Vaslui",164829,378,164829,,"MALUSTENI",370,"Scoala cu clasele I-IV  Lupesti",447,241,235,6,0,237,4,500,259,102,135,3,15612,0
39,"Vaslui",164829,378,164829,,"MALUSTENI",371,"Scoala cu clasele I-IV  Minzatesti",350,189,177,12,0,186,3,401,212,25,161,3,15612,0
39,"Vaslui",164829,378,164829,,"MALUSTENI",372,"Scoala Noua Malusteni",0,60,0,60,0,60,0,152,92,21,39,3,15612,1
39,"Vaslui",164892,378,164892,,"MICLESTI",373,"Caminul Cultural Miclesti",882,386,374,10,2,376,10,1001,615,114,262,3,15619,0
39,"Vaslui",164892,378,164892,,"MICLESTI",374,"Scoala generala ""Ion Creanga"", Chircesti-Deal",654,324,309,15,0,317,7,801,477,95,222,3,15619,0
39,"Vaslui",164892,378,164892,,"MICLESTI",375,"Scoala generala cu clasele I-IV, Chircesti -Vale",390,194,172,20,2,184,10,401,207,51,133,3,15619,0
39,"Vaslui",164892,378,164892,,"MICLESTI",376,"Scoala generala cu clasele I-IV Popesti",389,206,192,9,5,202,4,401,195,35,167,3,15619,0
39,"Vaslui",164892,378,164892,,"MICLESTI",377,"Caminul Cultural Miclesti",0,45,0,45,0,45,0,151,106,19,26,3,15619,1
39,"Vaslui",164936,378,164936,,"MUNTENII DE JOS",378,"Scoala cu clasele I-VIII, Muntenii de Jos",1531,808,801,7,0,797,11,1601,793,380,417,3,15623,0
39,"Vaslui",164936,378,164936,,"MUNTENII DE JOS",379,"Scoala cu clasele I-IV, Minjesti",688,374,367,6,1,360,14,801,427,176,184,3,15623,0
39,"Vaslui",164936,378,164936,,"MUNTENII DE JOS",380,"Scoala cu clasele I-IV, Bacaoani",1008,484,471,13,0,478,6,1201,717,215,263,3,15623,0
39,"Vaslui",164936,378,164936,,"MUNTENII DE JOS",381,"Scoala cu clasele I-VIII, Muntenii de Jos",0,102,0,102,0,102,0,151,49,66,36,3,15623,1
39,"Vaslui",167302,378,167302,,"MUNTENII DE SUS",382,"Scoala cu clasele I-VIII, ""Ion Agarici"", Muntenii de Sus",1215,495,487,8,0,487,8,1300,805,220,267,3,15628,0
39,"Vaslui",167302,378,167302,,"MUNTENII DE SUS",383,"Scoala generala cu clasele I-IV, Satu-Nou",1799,759,753,6,0,748,11,2001,1242,404,344,3,15628,0
39,"Vaslui",167302,378,167302,,"MUNTENII DE SUS",384,"Scoala generala cu clasele I-IV, Satu-Nou",0,26,0,26,0,26,0,151,125,14,12,3,15628,1
39,"Vaslui",165069,378,165069,,"OLTENESTI",385,"Scoala cu clasele I-IV, Oltenesti",406,207,195,12,0,203,4,500,293,86,117,3,15631,0
39,"Vaslui",165069,378,165069,,"OLTENESTI",386,"Scoala cu clasele I-IV, Zgura",85,61,49,12,0,60,1,100,39,22,38,3,15631,0
39,"Vaslui",165069,378,165069,,"OLTENESTI",387,"Scoala cu clasele I-IV, Curteni",204,122,104,18,0,117,5,301,179,47,70,3,15631,0
39,"Vaslui",165069,378,165069,,"OLTENESTI",388,"Scoala cu clasele I-VIII, Vinetesti",567,298,289,9,0,292,6,700,402,92,200,3,15631,0
39,"Vaslui",165069,378,165069,,"OLTENESTI",389,"Scoala cu clasele I-VIII, Tarzii",790,378,367,11,0,375,3,901,523,143,232,3,15631,0
39,"Vaslui",165069,378,165069,,"OLTENESTI",390,"Scoala cu clasele I-IV, Pahna",139,109,90,19,0,106,3,201,92,21,85,3,15631,0
39,"Vaslui",165069,378,165069,,"OLTENESTI",391,"Scoala cu clasele I-IV, Oltenesti",0,62,0,62,0,62,0,151,89,19,43,3,15631,1
39,"Vaslui",165130,378,165130,,"OSESTI",392,"Scoala de Arte si Meserii, Osesti",1086,546,539,7,0,532,14,1200,654,215,317,3,15638,0
39,"Vaslui",165130,378,165130,,"OSESTI",393,"Scoala generala cu clasele I-VIII, Buda",1009,466,458,8,0,454,12,1101,635,172,282,3,15638,0
39,"Vaslui",165130,378,165130,,"OSESTI",394,"Scoala generala cu clasele I-IV, Padureni",218,97,86,11,0,92,5,300,203,63,29,3,15638,0
39,"Vaslui",165130,378,165130,,"OSESTI",395,"Scoala de Arte si Meserii, Osesti",0,54,0,54,0,53,1,151,97,21,32,3,15638,1
39,"Vaslui",165185,378,165185,,"PADURENI",396,"Scoala cu clasele I-IV, Padureni",1019,476,463,13,0,466,10,1202,726,197,269,3,15643,0
39,"Vaslui",165185,378,165185,,"PADURENI",397,"Scoala cu clasele I-IV, Rusca",540,271,262,9,0,267,4,601,330,100,167,3,15643,0
39,"Vaslui",165185,378,165185,,"PADURENI",398,"Scoala cu clasele I-IV, Davidesti",439,216,207,9,0,206,10,501,285,86,120,3,15643,0
39,"Vaslui",165185,378,165185,,"PADURENI",399,"Scoala cu clasele I-IV, Ivanesti",346,210,200,10,0,210,0,401,191,48,162,3,15643,0
39,"Vaslui",165185,378,165185,,"PADURENI",400,"Scoala cu clasele I-IV, Valeni",1001,554,545,9,0,524,30,1101,547,148,376,3,15643,0
39,"Vaslui",165185,378,165185,,"PADURENI",401,"Scoala cu clasele I-IV, Padureni",0,85,0,85,0,84,1,150,65,30,54,3,15643,1
39,"Vaslui",165274,378,165274,,"PERIENI",402,"Scoala cu clasele I-X, Perieni - centru",1244,624,601,23,0,613,11,1401,777,343,270,3,15652,0
39,"Vaslui",165274,378,165274,,"PERIENI",403,"Scoala cu clasele I-IV, Perieni-Satu Nou",1075,596,560,34,2,588,8,1201,605,383,205,3,15652,0
39,"Vaslui",165274,378,165274,,"PERIENI",404,"Scoala cu clasele I-IV, Perieni-vale",449,325,288,37,0,317,8,500,175,224,93,3,15652,0
39,"Vaslui",165274,378,165274,,"PERIENI",405,"Scoala cu clasele I-X, Perieni centru",0,45,0,45,0,44,1,151,106,26,18,3,15652,1
39,"Vaslui",167311,378,167311,,"POCHIDIA",406,"Scoala cu clasele I-IV, Borodesti",221,131,125,6,0,125,6,301,170,32,93,3,15654,0
39,"Vaslui",167311,378,167311,,"POCHIDIA",407,"Scoala cu clasele I-IV, Pochidia",364,175,169,6,0,169,6,401,226,66,103,3,15654,0
39,"Vaslui",167311,378,167311,,"POCHIDIA",408,"Scoala cu clasele I-VIII, Salceni",764,439,403,7,29,428,11,801,362,219,209,3,15654,0
39,"Vaslui",167311,378,167311,,"POCHIDIA",409,"Dispensarul Uman Borodesti",0,72,0,72,0,72,0,150,78,44,28,3,15654,1
39,"Vaslui",165416,378,165416,,"POGANA",410,"Scoala generala cu clasele I-VIII Pogana",595,341,331,10,0,336,5,701,360,133,203,3,15659,0
39,"Vaslui",165416,378,165416,,"POGANA",411,"Scoala generala cu clasele I-VIII Tomesti",663,324,317,7,0,318,6,801,477,151,167,3,15659,0
39,"Vaslui",165416,378,165416,,"POGANA",412,"Scoala generala cu clasele I-IV Bogesti",534,233,222,11,0,227,6,601,368,82,145,3,15659,0
39,"Vaslui",165416,378,165416,,"POGANA",413,"Scoala  generala cu clasele I-VIII Mascurei",582,240,235,5,0,233,7,701,461,133,100,3,15659,0
39,"Vaslui",165416,378,165416,,"POGANA",414,"Scoala generala cu clasele I-VIII Pogana",0,33,0,33,0,33,0,151,118,11,22,3,15659,1
39,"Vaslui",167259,378,167259,,"POGONESTI",415,"Scoala cu clasele I-VIII, Pogonesti",1419,625,624,1,0,613,12,1501,876,187,426,3,15665,0
39,"Vaslui",167259,378,167259,,"POGONESTI",416,"Scoala cu clasele I-VIII, Pogonesti",0,50,0,50,0,50,0,151,101,23,27,3,15665,1
39,"Vaslui",165336,378,165336,,"POIENESTI",417,"Scoala generala cu clasele I-VIII  Poienesti",681,291,285,6,0,291,0,801,510,93,198,3,15669,0
39,"Vaslui",165336,378,165336,,"POIENESTI",418,"Scoala generala cu clasele I-VIII Oprisita",671,293,288,5,0,290,3,801,508,135,155,3,15669,0
39,"Vaslui",165336,378,165336,,"POIENESTI",419,"Scoala cu clasele I-IV Frasinu",296,134,128,6,0,128,6,401,267,42,86,3,15669,0
39,"Vaslui",165336,378,165336,,"POIENESTI",420,"Scoala cu clasele I-IV Poienesti Deal",98,62,52,10,0,61,1,101,39,23,38,3,15669,0
39,"Vaslui",165336,378,165336,,"POIENESTI",421,"Scoala cu clasele I-IV Fundu Vaii",74,49,41,8,0,42,7,101,52,15,27,3,15669,0
39,"Vaslui",165336,378,165336,,"POIENESTI",422,"Scoala generala cu clasele I-VIII  Poienesti",0,49,0,49,0,49,0,152,103,23,26,3,15669,1
39,"Vaslui",165470,378,165470,,"PUIESTI",423,"Scoala generala cu clasele I-VIII Puiesti",1202,492,481,11,0,478,14,1301,809,122,356,3,15677,0
39,"Vaslui",165470,378,165470,,"PUIESTI",424,"Scoala primara cu clasele I-IV Iezer",238,131,117,14,0,130,1,301,170,41,89,3,15677,0
39,"Vaslui",165470,378,165470,,"PUIESTI",425,"Scoala primara cu clasele I-IV Galtesti",101,61,56,5,0,60,1,201,140,12,48,3,15677,0
39,"Vaslui",165470,378,165470,,"PUIESTI",426,"Scoala primara cu clasele I-IV Rusi",297,158,146,12,0,150,8,401,243,47,103,3,15677,0
39,"Vaslui",165470,378,165470,,"PUIESTI",427,"Scoala primara cu clasele I-IV Fantanele",109,64,57,7,0,64,0,201,137,13,51,3,15677,0
39,"Vaslui",165470,378,165470,,"PUIESTI",428,"Scoala primara cu clasele I-IV Calimanesti",268,135,127,8,0,126,9,301,166,33,93,3,15677,0
39,"Vaslui",165470,378,165470,,"PUIESTI",429,"Scoala primara cu clasele I-IV  Fulgu",116,85,78,7,0,85,0,201,116,55,30,3,15677,0
39,"Vaslui",165470,378,165470,,"PUIESTI",430,"Scoala generala cu clasele I-VIII Lalesti",349,196,185,11,0,193,3,401,205,60,133,3,15677,0
39,"Vaslui",165470,378,165470,,"PUIESTI",431,"Scoala cu clasele I-IV Cristesti",333,138,125,13,0,135,3,401,263,61,74,3,15677,0
39,"Vaslui",165470,378,165470,,"PUIESTI",432,"Scoala primara cu clasele I-IV Cetatuia",336,157,152,5,0,155,2,401,244,50,105,3,15677,0
39,"Vaslui",165470,378,165470,,"PUIESTI",433,"Scoala primara cu clasele I-IV Rotari",90,60,52,8,0,59,1,101,41,24,35,3,15677,0
39,"Vaslui",165470,378,165470,,"PUIESTI",434,"Scoala primara cu clasele I-IV Bartalusi Mocani",247,153,143,10,0,147,6,301,148,43,104,3,15677,0
39,"Vaslui",165470,378,165470,,"PUIESTI",435,"Scoala generala cu clasele I-VIII Puiesti",0,104,0,104,0,104,0,151,47,45,59,3,15677,1
39,"Vaslui",165611,378,165611,,"PUNGESTI",436,"Scoala generala cu clasele I-X, Pungesti",743,394,383,11,0,392,2,801,407,106,286,3,15691,0
39,"Vaslui",165611,378,165611,,"PUNGESTI",437,"Scoala cu clasele I-IV, Stejaru",181,155,149,6,0,154,1,201,46,7,147,3,15691,0
39,"Vaslui",165611,378,165611,,"PUNGESTI",438,"Scoala cu clasele I-IV, Silistea",220,155,149,6,0,155,0,301,146,30,125,3,15691,0
39,"Vaslui",165611,378,165611,,"PUNGESTI",439,"Scoala cu clasele I-IV, Armasoaia",478,297,288,9,0,291,6,600,303,82,209,3,15691,0
39,"Vaslui",165611,378,165611,,"PUNGESTI",440,"Scoala cu clasele I-IV, Toporasti",533,285,276,9,0,284,1,601,316,87,197,3,15691,0
39,"Vaslui",165611,378,165611,,"PUNGESTI",441,"Scoala cu clasele I-IV, Cursesti Deal",178,131,114,17,0,128,3,201,70,25,103,3,15691,0
39,"Vaslui",165611,378,165611,,"PUNGESTI",442,"Scoala cu clasele I-IV, Cursesti Vale",219,148,133,15,0,146,2,303,155,56,90,3,15691,0
39,"Vaslui",165611,378,165611,,"PUNGESTI",443,"Scoala generala cu clasele I-X, Pungesti",0,55,0,55,0,54,1,151,95,19,35,3,15691,1
39,"Vaslui",167320,378,167320,,"PUSCASI",444,"Scoala cu clasele I-VIII, Puscasi",1820,758,735,7,16,745,13,2001,1243,261,484,3,15701,0
39,"Vaslui",167320,378,167320,,"PUSCASI",445,"Scoala cu clasele I-IV, Poiana lui Alexa",277,147,127,11,9,147,0,301,154,40,107,3,15701,0
39,"Vaslui",167320,378,167320,,"PUSCASI",446,"Scoala generala I-IV, Teisoru",387,180,170,7,3,162,18,501,321,58,104,3,15701,0
39,"Vaslui",167320,378,167320,,"PUSCASI",447,"Scoala cu clasele I-IV, Valea Targului",145,98,83,7,8,97,1,201,103,13,84,3,15701,0
39,"Vaslui",167320,378,167320,,"PUSCASI",448,"Scoala cu clasele I-VIII, Puscasi",0,61,0,61,0,61,0,152,91,16,45,3,15701,1
39,"Vaslui",167240,378,167240,,"RAFAILA",449,"Scoala cu clasele I-VIII, Rafaila -sediul vechi",1432,718,713,5,0,697,21,1601,883,323,374,3,15706,0
39,"Vaslui",167240,378,167240,,"RAFAILA",450,"Scoala cu clasele I-VIII, Rafaila -sediul nou",0,46,0,46,0,46,0,150,104,24,22,3,15706,1
39,"Vaslui",165719,378,165719,,"REBRICEA",451,"Scoala cu clasele I-VIII, Rebricea",446,181,176,5,0,179,2,500,319,60,119,3,15708,0
39,"Vaslui",165719,378,165719,,"REBRICEA",452,"Caminul Cultural ,Draxeni",669,346,342,4,0,336,10,800,454,84,252,3,15708,0
39,"Vaslui",165719,378,165719,,"REBRICEA",453,"Scoala cu clasele I-IV, Sasova",215,131,126,5,0,129,2,301,170,41,88,3,15708,0
39,"Vaslui",165719,378,165719,,"REBRICEA",454,"Scoala cu clasele I-IV, Tufesti de Jos",291,146,140,6,0,142,4,401,255,44,98,3,15708,0
39,"Vaslui",165719,378,165719,,"REBRICEA",455,"Scoala cu clasele I-IV, Bolati",170,109,100,9,0,106,3,201,92,54,52,3,15708,0
39,"Vaslui",165719,378,165719,,"REBRICEA",456,"Scoala cu clasele I-IV, Craciunesti",274,168,162,6,0,163,5,400,232,76,87,3,15708,0
39,"Vaslui",165719,378,165719,,"REBRICEA",457,"Scoala cu clasele I-IV, Tatomiresti",247,105,96,9,0,104,1,301,196,26,78,3,15708,0
39,"Vaslui",165719,378,165719,,"REBRICEA",458,"Scoala cu clasele I-IV, Ratesu Cuzei",434,227,222,5,0,225,2,501,274,70,155,3,15708,0
39,"Vaslui",165719,378,165719,,"REBRICEA",459,"Gara Rebricea",0,93,0,93,0,92,1,152,59,45,47,3,15708,1
39,"Vaslui",165817,378,165817,,"ROSIESTI",460,"Scoala de Arte si Meserii , Rosiesti",1072,485,482,3,0,478,7,1201,716,222,256,3,15718,0
39,"Vaslui",165817,378,165817,,"ROSIESTI",461,"Scoala generala cu clasele I-IV, Valea lui Darie",513,285,276,9,0,283,2,601,316,66,217,3,15718,0
39,"Vaslui",165817,378,165817,,"ROSIESTI",462,"Scoala generala cu clasele I-IV, Idrici",304,169,161,8,0,164,5,401,232,54,110,3,15718,0
39,"Vaslui",165817,378,165817,,"ROSIESTI",463,"Scoala generala cu clasele I-IV, Gura Idrici",374,176,169,7,0,173,3,401,225,68,105,3,15718,0
39,"Vaslui",165817,378,165817,,"ROSIESTI",464,"Scoala generala cu clasele I-IV, Gara Rosiesti",299,161,157,4,0,158,3,401,240,66,92,3,15718,0
39,"Vaslui",165817,378,165817,,"ROSIESTI",465,"Scoala generala cu clasele I-IV, Rediu",150,90,79,11,0,88,2,202,112,44,44,3,15718,0
39,"Vaslui",165817,378,165817,,"ROSIESTI",466,"Scoala generala cu clasele I-IV, Codreni",96,57,45,12,0,56,1,201,144,32,24,3,15718,0
39,"Vaslui",165817,378,165817,,"ROSIESTI",467,"Scoala generala cu clasele I-IV, Gara Rosiesti",0,90,0,90,0,87,3,151,61,40,47,3,15718,1
39,"Vaslui",165899,378,165899,,"SOLESTI",468,"Caminul Cultural Solesti",926,388,371,16,1,380,8,1001,613,116,264,3,15726,0
39,"Vaslui",165899,378,165899,,"SOLESTI",469,"Scoala cu clasele I-IV Bousori",257,122,116,6,0,118,4,301,179,35,83,3,15726,0
39,"Vaslui",165899,378,165899,,"SOLESTI",470,"Scoala cu casele I-IV Iaz",239,172,158,14,0,165,7,300,128,45,120,3,15726,0
39,"Vaslui",165899,378,165899,,"SOLESTI",471,"Scoala cu clasele I-IV SAT Nou",277,160,152,8,0,154,6,300,140,55,99,3,15726,0
39,"Vaslui",165899,378,165899,,"SOLESTI",472,"Scoala cu clasele I-VIII Serbotesti",668,300,291,9,0,291,9,801,501,97,194,3,15726,0
39,"Vaslui",165899,378,165899,,"SOLESTI",473,"Scoala cu clasele I-IV Stioborani",376,179,170,8,1,177,2,392,213,62,115,3,15726,0
39,"Vaslui",165899,378,165899,,"SOLESTI",474,"Scoala cu clasele I-IV Valea Silistei",275,145,138,7,0,137,8,301,156,48,89,3,15726,0
39,"Vaslui",165899,378,165899,,"SOLESTI",475,"Scoala cu clasele I-VIII Solesti",0,31,0,31,0,31,0,151,120,10,21,3,15726,1
39,"Vaslui",165979,378,165979,,"STANILESTI",476,"Scoala generala cu clasele I-VIII, Stanilesti",1216,533,530,3,0,522,11,1301,768,221,301,3,15734,0
39,"Vaslui",165979,378,165979,,"STANILESTI",477,"Scoala generala cu clasele I-VIII, Stanilesti",1214,549,545,4,0,533,16,1301,752,226,307,3,15734,0
39,"Vaslui",165979,378,165979,,"STANILESTI",478,"Scoala generala cu clasele I-IV, Budu Cantemir",242,146,141,5,0,144,2,301,155,93,51,3,15734,0
39,"Vaslui",165979,378,165979,,"STANILESTI",479,"Scoala generala cu clasele I-IV, Bogdana Voloseni",137,87,80,7,0,86,1,201,114,25,61,3,15734,0
39,"Vaslui",165979,378,165979,,"STANILESTI",480,"Scoala generala cu clasele I-IV, Gura Vaii",355,197,181,16,0,194,3,401,204,98,96,3,15734,0
39,"Vaslui",165979,378,165979,,"STANILESTI",481,"Scoala generala cu clasele I-VIII, Poganesti",887,504,485,19,0,495,9,1001,497,314,181,3,15734,0
39,"Vaslui",165979,378,165979,,"STANILESTI",482,"Scoala generala cu clasele I-IV, Chersacosu",371,222,210,12,0,218,4,401,179,130,88,3,15734,0
39,"Vaslui",165979,378,165979,,"STANILESTI",483,"Scoala generala cu clasele I-VIII, Stanilesti",0,75,0,75,0,74,1,151,76,36,38,3,15734,1
39,"Vaslui",166057,378,166057,,"STEFAN CEL MARE",484,"Caminul Cultural, Stefan cel Mare",580,335,327,8,0,329,6,601,266,73,256,3,15742,0
39,"Vaslui",166057,378,166057,,"STEFAN CEL MARE",485,"Caminul Cultural Birzesti",988,605,593,12,0,594,11,1201,596,206,388,3,15742,0
39,"Vaslui",166057,378,166057,,"STEFAN CEL MARE",486,"Scoala generala cu clasele I-IV, Maraseni",702,443,434,9,0,436,7,814,371,122,314,3,15742,0
39,"Vaslui",166057,378,166057,,"STEFAN CEL MARE",487,"Scoala generala cu clasele I-IV, Brahasoaia",409,228,217,11,0,221,7,501,273,39,182,3,15742,0
39,"Vaslui",166057,378,166057,,"STEFAN CEL MARE",488,"Scoala cu clasele I-VIII Birzesti",0,120,0,120,0,119,1,152,32,28,91,3,15742,1
39,"Vaslui",166137,378,166137,,"SULETEA",489,"Caminul Cultural ""Virgil Caraivan "", Suletea",1017,500,492,8,0,489,11,1101,601,202,287,3,15750,0
39,"Vaslui",166137,378,166137,,"SULETEA",490,"Scoala generala Fedesti",504,264,256,8,0,261,3,601,337,95,166,3,15750,0
39,"Vaslui",166137,378,166137,,"SULETEA",491,"Scoala generala Jigalia",208,131,126,5,0,130,1,301,170,47,83,3,15750,0
39,"Vaslui",166137,378,166137,,"SULETEA",492,"Scoala generala Rascani",205,133,125,8,0,133,0,301,168,85,48,3,15750,0
39,"Vaslui",166137,378,166137,,"SULETEA",493,"Caminul Cultural ""Virgil Caraivan "", Suletea",0,77,0,77,0,77,0,151,74,42,35,3,15750,1
39,"Vaslui",166182,378,166182,,"TANACU",494,"Scoala generala cu clasele I-VIII Tanacu",1421,688,667,21,0,677,11,1601,913,179,498,3,15763,0
39,"Vaslui",166182,378,166182,,"TANACU",495,"Scoala generala Benesti",338,187,174,13,0,177,10,401,214,47,130,3,15763,0
39,"Vaslui",166182,378,166182,,"TANACU",496,"Scoala generala cu clasele I-VIII Tanacu",0,117,0,117,0,117,0,150,33,50,67,3,15763,1
39,"Vaslui",166235,378,166235,,"TACUTA",497,"Caminul Cultural Tacuta",668,380,371,8,1,372,8,800,420,131,241,3,15755,0
39,"Vaslui",166235,378,166235,,"TACUTA",498,"Scoala cu clasele I-IV, Dumasca",310,174,167,7,0,170,4,400,226,49,121,3,15755,0
39,"Vaslui",166235,378,166235,,"TACUTA",499,"Scoala cu clasele I-IV, Mircesti",245,147,137,10,0,143,4,301,154,45,98,3,15755,0
39,"Vaslui",166235,378,166235,,"TACUTA",500,"Scoala cu clasele I-VIII, Focsasca",577,376,367,9,0,367,9,601,225,161,206,3,15755,0
39,"Vaslui",166235,378,166235,,"TACUTA",501,"Scoala cu clasele I-VIII, Protopopesti",693,324,316,8,0,311,13,801,477,119,192,3,15755,0
39,"Vaslui",166235,378,166235,,"TACUTA",502,"Caminul Cultural Tacuta",0,73,0,73,0,72,1,150,77,22,50,3,15755,1
39,"Vaslui",166315,378,166315,,"TATARANI",503,"Caminul Cultural Tatarani",875,349,338,11,0,342,7,1001,652,86,256,3,15766,0
39,"Vaslui",166315,378,166315,,"TATARANI",504,"Scoala ""Ioan Angheluta"", Baltati",480,213,192,21,0,213,0,501,288,76,137,3,15766,0
39,"Vaslui",166315,378,166315,,"TATARANI",505,"Scoala cu clasele I-IV, Stroiesti",452,207,199,8,0,203,4,501,294,52,151,3,15766,0
39,"Vaslui",166315,378,166315,,"TATARANI",506,"Caminul Cultural Tatarani",0,53,0,53,0,52,1,152,99,14,38,3,15766,1
39,"Vaslui",166413,378,166413,,"TODIRESTI",507,"Scoala de Arte si Meserii, Todiresti",329,333,329,3,1,332,1,801,468,128,204,3,15776,0
39,"Vaslui",166413,378,166413,,"TODIRESTI",508,"Scoala cu clasele I-IV, Cotic",258,140,134,6,0,139,1,301,161,32,107,3,15776,0
39,"Vaslui",166413,378,166413,,"TODIRESTI",509,"Scoala Preot C-tin Ghe.Radu Dragesti",284,153,148,5,0,150,3,401,248,31,119,3,15776,0
39,"Vaslui",166413,378,166413,,"TODIRESTI",510,"Scoala cu clasele I-IV, Huc",446,254,246,8,0,247,7,501,247,74,173,3,15776,0
39,"Vaslui",166413,378,166413,,"TODIRESTI",511,"Scoala cu clasele I-IV, Plopoasa",186,111,104,7,0,110,1,201,90,54,56,3,15776,0
39,"Vaslui",166413,378,166413,,"TODIRESTI",512,"Scoala cu clasele I-IV, Silistea",281,167,157,10,0,163,4,301,134,47,116,3,15776,0
39,"Vaslui",166413,378,166413,,"TODIRESTI",513,"Scoala cu clasele I-IV, Sofronesti",130,82,75,7,0,80,2,201,119,21,59,3,15776,0
39,"Vaslui",166413,378,166413,,"TODIRESTI",514,"Scoala cu clasele I-IV, Valea Popii",109,62,57,5,0,62,0,201,139,23,39,3,15776,0
39,"Vaslui",166413,378,166413,,"TODIRESTI",515,"Scoala cu clasele I-IV, Viisoara",108,69,62,7,0,68,1,201,132,27,41,3,15776,0
39,"Vaslui",166413,378,166413,,"TODIRESTI",516,"Caminul Cultural Todiresti",0,61,0,61,0,61,0,151,90,22,39,3,15776,1
39,"Vaslui",166529,378,166529,,"TUTOVA",517,"Caminul Cultural Tutova",1074,519,496,23,0,511,8,1201,682,225,286,3,15786,0
39,"Vaslui",166529,378,166529,,"TUTOVA",518,"Scoala cu clasele I-IV Badeana",991,423,412,11,0,416,7,1101,678,124,292,3,15786,0
39,"Vaslui",166529,378,166529,,"TUTOVA",519,"Scoala cu clasele I-IV Crivesti",430,219,206,13,0,214,5,501,282,78,136,3,15786,0
39,"Vaslui",166529,378,166529,,"TUTOVA",520,"Scoala cu clasele I-IV Ciortolom",142,113,95,18,0,110,3,200,87,45,65,3,15786,0
39,"Vaslui",166529,378,166529,,"TUTOVA",521,"Scoala cu clasele I-IV Coroiu",147,89,79,10,0,87,2,201,112,49,38,3,15786,0
39,"Vaslui",166529,378,166529,,"TUTOVA",522,"Scoala cu clasele I-IV Vizureni",150,110,94,16,0,110,0,201,91,43,67,3,15786,0
39,"Vaslui",166529,378,166529,,"TUTOVA",523,"Scoala cu clasele I-VIII Tutova",0,91,0,91,0,91,0,150,59,43,48,3,15786,1
39,"Vaslui",166636,378,166636,,"VALENI",524,"Scoala cu clasele I-VIII,Valeni",1288,536,534,2,0,522,14,1401,865,251,271,3,15793,0
39,"Vaslui",166636,378,166636,,"VALENI",525,"Scoala cu clasele I-VIII,Valeni",1221,505,499,6,0,500,5,1301,796,238,262,3,15793,0
39,"Vaslui",166636,378,166636,,"VALENI",526,"Scoala cu clasele I-VIII, Moara Domneasca",1134,480,462,18,0,467,13,1203,723,209,258,3,15793,0
39,"Vaslui",166636,378,166636,,"VALENI",527,"Scoala cu clasele I-VIII,Valeni",0,25,0,25,0,25,0,151,126,8,17,3,15793,1
39,"Vaslui",166672,378,166672,,"VETRISOAIA",528,"Caminul Cultural Vetrisoaia",1702,781,769,12,0,759,22,1801,1020,188,571,3,15796,0
39,"Vaslui",166672,378,166672,,"VETRISOAIA",529,"Scoala generala nr. 2, Vetrisoaia",886,488,469,19,0,476,12,1001,513,167,309,3,15796,0
39,"Vaslui",166672,378,166672,,"VETRISOAIA",530,"Scoala generala Bumbata",155,95,84,11,0,92,3,201,106,37,55,3,15796,0
39,"Vaslui",166672,378,166672,,"VETRISOAIA",531,"Dispensarul Uman Vetrisoaia",0,77,0,77,0,77,0,151,74,20,57,3,15796,1
39,"Vaslui",166707,378,166707,,"VIISOARA",532,"Caminul Cultural Viiisoara",989,466,444,3,19,455,11,1101,635,135,320,3,15799,0
39,"Vaslui",166707,378,166707,,"VIISOARA",533,"Scoala generala Viltotesti",188,102,86,9,7,100,2,201,99,31,69,3,15799,0
39,"Vaslui",166707,378,166707,,"VIISOARA",534,"Scoala Valeni",128,72,63,9,0,69,3,201,129,21,48,3,15799,0
39,"Vaslui",166707,378,166707,,"VIISOARA",535,"Scoala Halta Dodesti",168,103,84,17,2,99,4,201,98,49,50,3,15799,0
39,"Vaslui",166707,378,166707,,"VIISOARA",536,"Scoala generala Viisoara",0,71,0,71,0,70,1,151,80,14,56,3,15799,1
39,"Vaslui",166770,378,166770,,"VINDEREI",537,"Scoala cu clasele I-VIII, Vinderei",866,348,345,3,0,343,5,901,553,114,229,3,15804,0
39,"Vaslui",166770,378,166770,,"VINDEREI",538,"Scoala cu clasele I-IV, Bradesti",522,240,231,8,1,232,8,601,361,72,160,3,15804,0
39,"Vaslui",166770,378,166770,,"VINDEREI",539,"Scoala cu clasele I-VIII, Docani",517,195,191,4,0,191,4,601,406,47,144,3,15804,0
39,"Vaslui",166770,378,166770,,"VINDEREI",540,"Scoala cu clasele I-IV, Docaneasa",389,148,144,4,0,148,0,401,253,51,97,3,15804,0
39,"Vaslui",166770,378,166770,,"VINDEREI",541,"Scoala cu clasele I-IV, Obarseni",838,408,399,9,0,398,10,901,493,92,306,3,15804,0
39,"Vaslui",166770,378,166770,,"VINDEREI",542,"Scoala cu clasele I-IV, Valea Lunga",375,171,163,8,0,167,4,401,230,44,123,3,15804,0
39,"Vaslui",166770,378,166770,,"VINDEREI",543,"Scoala de Arte si Meserii Vinderei",0,98,0,98,0,98,0,151,53,31,67,3,15804,1
39,"Vaslui",166869,378,166869,,"VOINESTI",544,"Scoala cu clasele I-VIII, Voinesti",339,171,156,15,0,168,3,401,230,51,117,3,15813,0
39,"Vaslui",166869,378,166869,,"VOINESTI",545,"Scoala cu clasele I-VIII, Avramesti",565,299,289,10,0,293,6,601,302,141,152,3,15813,0
39,"Vaslui",166869,378,166869,,"VOINESTI",546,"Scoala cu clasele I-IV, Marasesti",190,92,87,5,0,90,2,201,109,52,38,3,15813,0
39,"Vaslui",166869,378,166869,,"VOINESTI",547,"Scoala cu clasele I-IV, Bancesti",154,98,86,12,0,96,2,201,103,32,64,3,15813,0
39,"Vaslui",166869,378,166869,,"VOINESTI",548,"Scoala cu clasele I-IV, Stancaseni",169,111,103,8,0,110,1,201,90,64,46,3,15813,0
39,"Vaslui",166869,378,166869,,"VOINESTI",549,"Scoala cu clasele I-IV, Gardesti",399,231,220,11,0,229,2,501,270,164,65,3,15813,0
39,"Vaslui",166869,378,166869,,"VOINESTI",550,"Scoala cu clasele I-IV, Obarseni",255,130,117,13,0,127,3,301,171,20,107,3,15813,0
39,"Vaslui",166869,378,166869,,"VOINESTI",551,"Scoala cu clasele I-VIII, Obarseni-Lingurari",639,370,355,15,0,363,7,701,331,183,180,3,15813,0
39,"Vaslui",166869,378,166869,,"VOINESTI",552,"Caminul Cultural Voinesti",0,33,0,33,0,33,0,151,118,14,19,3,15813,1
39,"Vaslui",166985,378,166985,,"VULTURESTI",553,"Caminul Cultural Vulturesti",795,440,423,17,0,431,9,901,461,153,278,3,15825,0
39,"Vaslui",166985,378,166985,,"VULTURESTI",554,"Caminul Cultural Buhaiesti",693,302,295,7,0,299,3,800,498,113,186,3,15825,0
39,"Vaslui",166985,378,166985,,"VULTURESTI",555,"Scoala generala Voinesti",271,149,144,5,0,145,4,300,151,65,80,3,15825,0
39,"Vaslui",166985,378,166985,,"VULTURESTI",556,"Scoala generala Vulturesti",0,59,0,59,0,59,0,151,92,21,38,3,15825,1
39,"Vaslui",167035,378,167035,,"VUTCANI",557,"Scoala generala nr.1, Vutcani- local reabilitat",1341,725,710,14,1,716,9,1401,676,182,534,3,15830,0
39,"Vaslui",167035,378,167035,,"VUTCANI",558,"Scoala generala Malaiesti",260,201,169,32,0,194,7,301,100,62,132,3,15830,0
39,"Vaslui",167035,378,167035,,"VUTCANI",559,"Scoala generala Posta-Elan",132,84,74,10,0,78,6,201,117,16,62,3,15830,0
39,"Vaslui",167035,378,167035,,"VUTCANI",560,"Scoala generala nr.1, Vutcani- local reabilitat",0,74,0,74,0,74,0,150,76,27,47,3,15830,1
39,"Vaslui",167071,378,167071,,"ZAPODENI",561,"Caminul Cultural Zapodeni",1285,771,721,16,34,736,35,1401,630,170,566,3,15834,0
39,"Vaslui",167071,378,167071,,"ZAPODENI",562,"Scoala cu clasele I-IV, Portari",483,286,266,9,11,279,7,600,314,82,197,3,15834,0
39,"Vaslui",167071,378,167071,,"ZAPODENI",563,"Scoala cu clasele I-IV, Delea",204,121,107,9,5,120,1,301,180,33,87,3,15834,0
39,"Vaslui",167071,378,167071,,"ZAPODENI",564,"Scoala cu clasele I-IV, Ciofeni",135,87,73,7,7,85,2,202,115,18,67,3,15834,0
39,"Vaslui",167071,378,167071,,"ZAPODENI",565,"Scoala cu clasele I-IV, Telejna",288,177,165,5,7,170,7,404,227,33,137,3,15834,0
39,"Vaslui",167071,378,167071,,"ZAPODENI",566,"Scoala cu clasele I-VIII, Butucaria",132,82,68,9,5,79,3,201,119,17,62,3,15834,0
39,"Vaslui",167071,378,167071,,"ZAPODENI",567,"Scoala cu clasele I-IV, Uncesti",333,205,186,9,10,199,6,401,196,32,167,3,15834,0
39,"Vaslui",167071,378,167071,,"ZAPODENI",568,"Scoala cu clasele I-IV, Dobroslovesti",308,202,184,7,11,198,4,400,198,42,156,3,15834,0
39,"Vaslui",167071,378,167071,,"ZAPODENI",569,"Caminul Cultural Zapodeni",0,86,0,86,0,84,2,152,66,20,64,3,15834,1
39,"Vaslui",167179,378,167179,,"ZORLENI",570,"Scoala nr.1 Zorleni",1296,581,546,35,0,577,4,1400,819,202,375,3,15844,0
39,"Vaslui",167179,378,167179,,"ZORLENI",571,"Scoala nr.1 Zorleni",1421,633,614,18,1,623,10,1500,867,181,442,3,15844,0
39,"Vaslui",167179,378,167179,,"ZORLENI",572,"Scoala nr. 2 Zorleni",1401,690,665,25,0,675,15,1600,910,209,466,3,15844,0
39,"Vaslui",167179,378,167179,,"ZORLENI",573,"Scoala cu clasele I-VIII, Popeni",1226,634,622,12,0,621,13,1301,667,197,424,3,15844,0
39,"Vaslui",167179,378,167179,,"ZORLENI",574,"Scoala cu clasele I-VIII, Popeni",925,466,446,20,0,460,6,993,527,156,304,3,15844,0
39,"Vaslui",167179,378,167179,,"ZORLENI",575,"Scoala cu clasele I-IV, Dealu Mare",188,109,99,10,0,105,4,199,90,44,61,3,15844,0
39,"Vaslui",167179,378,167179,,"ZORLENI",576,"Scoala cu clasele I-IV, Simila",875,474,468,6,0,469,5,1002,528,211,258,3,15844,0
39,"Vaslui",167179,378,167179,,"ZORLENI",577,"Caminul Cultural Zorleni",0,111,0,111,0,109,2,151,40,42,67,3,15844,1
40,"Valcea",167473,387,167473,,"MUNICIPIUL RAMNICU VALCEA",1,"Colegiul Tehnic Energetic",1473,850,831,19,0,842,8,1600,750,494,348,1,15850,0
40,"Valcea",167473,387,167473,,"MUNICIPIUL RAMNICU VALCEA",2,"Colegiul Tehnic Energetic",1017,589,581,8,0,581,8,1100,511,279,302,1,15850,0
40,"Valcea",167473,387,167473,,"MUNICIPIUL RAMNICU VALCEA",3,"Grup Scolar ""Antim Ivireanul"" (Sanitar)",1401,713,704,9,0,704,9,1500,787,323,381,1,15850,0
40,"Valcea",167473,387,167473,,"MUNICIPIUL RAMNICU VALCEA",4,"Grup Scolar ""Antim Ivireanul"" (Sanitar)",1326,702,690,12,0,690,12,1500,798,333,357,1,15850,0
40,"Valcea",167473,387,167473,,"MUNICIPIUL RAMNICU VALCEA",5,"Grup Scolar ""Antim Ivireanul"" (Sanitar)",1273,604,598,6,0,598,6,1400,796,319,279,1,15850,0
40,"Valcea",167473,387,167473,,"MUNICIPIUL RAMNICU VALCEA",6,"Gradinita Nord II",1039,528,520,8,0,521,7,1200,672,293,228,1,15850,0
40,"Valcea",167473,387,167473,,"MUNICIPIUL RAMNICU VALCEA",7,"Gradinita Nord II",1104,574,563,11,0,569,5,1205,631,260,309,1,15850,0
40,"Valcea",167473,387,167473,,"MUNICIPIUL RAMNICU VALCEA",8,"Gradinita Nord II",1060,580,572,8,0,573,7,1200,620,251,322,1,15850,0
40,"Valcea",167473,387,167473,,"MUNICIPIUL RAMNICU VALCEA",9,"Grup Scolar ""Henri Coanda""",1216,586,579,7,0,577,9,1300,714,256,321,1,15850,0
40,"Valcea",167473,387,167473,,"MUNICIPIUL RAMNICU VALCEA",10,"Grup Scolar ""Henri Coanda""",1126,599,589,10,0,596,3,1300,701,294,302,1,15850,0
40,"Valcea",167473,387,167473,,"MUNICIPIUL RAMNICU VALCEA",11,"Grup Scolar ""Henri Coanda""",1119,637,631,6,0,628,9,1213,576,310,318,1,15850,0
40,"Valcea",167473,387,167473,,"MUNICIPIUL RAMNICU VALCEA",12,"Grup Scolar ""Henri Coanda""",1106,621,614,7,0,617,4,1203,582,300,317,1,15850,0
40,"Valcea",167473,387,167473,,"MUNICIPIUL RAMNICU VALCEA",13,"Grup Scolar ""Henri Coanda""",887,465,457,8,0,460,5,1000,535,233,227,1,15850,0
40,"Valcea",167473,387,167473,,"MUNICIPIUL RAMNICU VALCEA",14,"Colegiul National de Informatica ""Matei Basarab""",1121,520,511,9,0,514,6,1200,680,263,251,1,15850,0
40,"Valcea",167473,387,167473,,"MUNICIPIUL RAMNICU VALCEA",15,"Colegiul National de Informatica ""Matei Basarab""",917,484,478,6,0,480,4,995,511,214,266,1,15850,0
40,"Valcea",167473,387,167473,,"MUNICIPIUL RAMNICU VALCEA",16,"Colegiul National de Informatica ""Matei Basarab""",1126,570,558,12,0,566,4,1200,630,284,282,1,15850,0
40,"Valcea",167473,387,167473,,"MUNICIPIUL RAMNICU VALCEA",17,"Colegiul National de Informatica ""Matei Basarab""",1184,651,632,19,0,645,6,1300,649,300,345,1,15850,0
40,"Valcea",167473,387,167473,,"MUNICIPIUL RAMNICU VALCEA",18,"Colegiul Tehnic Forestier",1054,659,650,9,0,649,10,1200,541,315,334,1,15850,0
40,"Valcea",167473,387,167473,,"MUNICIPIUL RAMNICU VALCEA",19,"Colegiul Tehnic Forestier",971,514,505,9,0,509,5,1117,603,245,264,1,15850,0
40,"Valcea",167473,387,167473,,"MUNICIPIUL RAMNICU VALCEA",20,"Colegiul Tehnic Forestier",1003,616,610,6,0,604,12,1100,484,252,352,1,15850,0
40,"Valcea",167473,387,167473,,"MUNICIPIUL RAMNICU VALCEA",21,"Scoala cu clasele I-VIII ""Ioan Gh.Duca""",1047,556,545,11,0,549,7,1100,544,293,256,1,15850,0
40,"Valcea",167473,387,167473,,"MUNICIPIUL RAMNICU VALCEA",22,"Scoala cu clasele I-VIII ""Ioan Gh.Duca""",1069,633,626,7,0,622,11,1200,567,283,339,1,15850,0
40,"Valcea",167473,387,167473,,"MUNICIPIUL RAMNICU VALCEA",23,"Scoala cu clasele I-VIII ""Ioan Gh.Duca""",1161,629,618,10,1,617,12,1300,671,254,363,1,15850,0
40,"Valcea",167473,387,167473,,"MUNICIPIUL RAMNICU VALCEA",24,"Scoala cu clasele I-VIII ""Ioan Gh.Duca""",923,509,501,8,0,503,6,1000,491,205,298,1,15850,0
40,"Valcea",167473,387,167473,,"MUNICIPIUL RAMNICU VALCEA",25,"Scoala cu clasele I-VIII ""Ioan Gh.Duca""",882,675,670,5,0,664,11,1200,525,296,368,1,15850,0
40,"Valcea",167473,387,167473,,"MUNICIPIUL RAMNICU VALCEA",26,"Scoala cu clasele I-VIII ""Ioan Gh.Duca""",1197,649,639,10,0,640,9,1300,651,299,341,1,15850,0
40,"Valcea",167473,387,167473,,"MUNICIPIUL RAMNICU VALCEA",27,"Scoala cu clasele I-VIII ""Ioan Gh.Duca""",975,574,564,9,1,568,6,1100,526,271,297,1,15850,0
40,"Valcea",167473,387,167473,,"MUNICIPIUL RAMNICU VALCEA",28,"Scoala Generala ""Take Ionescu""",1115,690,680,10,0,677,13,1200,510,306,371,1,15850,0
40,"Valcea",167473,387,167473,,"MUNICIPIUL RAMNICU VALCEA",29,"Colegiul National ""Alexandru Lahovari""",1222,730,712,18,0,722,8,1400,670,292,430,1,15850,0
40,"Valcea",167473,387,167473,,"MUNICIPIUL RAMNICU VALCEA",30,"Colegiul National ""Alexandru Lahovari""",1617,970,959,11,0,950,20,1800,830,415,535,1,15850,0
40,"Valcea",167473,387,167473,,"MUNICIPIUL RAMNICU VALCEA",31,"Grup Scolar Oltchim",1445,740,732,8,0,732,8,1600,860,349,383,1,15850,0
40,"Valcea",167473,387,167473,,"MUNICIPIUL RAMNICU VALCEA",32,"Grup Scolar Oltchim",1290,720,713,7,0,711,9,1400,680,321,390,1,15850,0
40,"Valcea",167473,387,167473,,"MUNICIPIUL RAMNICU VALCEA",33,"Scoala Generala nr. 5",1067,678,668,10,0,669,9,1200,522,275,394,1,15850,0
40,"Valcea",167473,387,167473,,"MUNICIPIUL RAMNICU VALCEA",34,"D.A.D.P. - blocul A 17 Zona Libertatii",1404,804,795,8,1,795,9,1494,690,366,429,1,15850,0
40,"Valcea",167473,387,167473,,"MUNICIPIUL RAMNICU VALCEA",35,"D.A.P.T. Sediu Piata Centrala",916,576,561,15,0,567,9,1011,435,233,334,1,15850,0
40,"Valcea",167473,387,167473,,"MUNICIPIUL RAMNICU VALCEA",36,"D.A.P.T. Sediu Piata Centrala",774,405,395,10,0,400,5,788,383,156,244,1,15850,0
40,"Valcea",167473,387,167473,,"MUNICIPIUL RAMNICU VALCEA",37,"D.A.P.T. Sediu Piata Centrala",1073,646,633,13,0,641,5,1200,554,269,372,1,15850,0
40,"Valcea",167473,387,167473,,"MUNICIPIUL RAMNICU VALCEA",38,"Gradinita Cozia I",1254,680,668,12,0,666,14,1400,720,314,352,1,15850,0
40,"Valcea",167473,387,167473,,"MUNICIPIUL RAMNICU VALCEA",39,"Gradinita Cozia I",1234,696,686,10,0,690,6,1285,589,352,338,1,15850,0
40,"Valcea",167473,387,167473,,"MUNICIPIUL RAMNICU VALCEA",40,"C.A.R. Pensionari",1231,770,762,8,0,759,11,1300,530,311,448,1,15850,0
40,"Valcea",167473,387,167473,,"MUNICIPIUL RAMNICU VALCEA",41,"Grup Scolar ""Nicolae Plesoianu""",1094,659,649,9,1,655,4,1200,541,300,355,1,15850,0
40,"Valcea",167473,387,167473,,"MUNICIPIUL RAMNICU VALCEA",42,"Scoala Generala nr. 3",1349,808,793,13,2,798,10,1500,692,493,305,1,15850,0
40,"Valcea",167473,387,167473,,"MUNICIPIUL RAMNICU VALCEA",43,"Scoala cu clasele I-VIII Goranu",1598,865,852,13,0,857,8,1700,835,516,341,1,15850,0
40,"Valcea",167473,387,167473,,"MUNICIPIUL RAMNICU VALCEA",44,"Scoala cu clasele I-VIII Goranu",1673,952,934,17,1,937,15,1800,848,516,421,1,15850,0
40,"Valcea",167473,387,167473,,"MUNICIPIUL RAMNICU VALCEA",45,"Scoala cu clasele I-IV Feteni",187,131,109,22,0,131,0,200,69,94,37,1,15850,0
40,"Valcea",167473,387,167473,,"MUNICIPIUL RAMNICU VALCEA",46,"Grup Scolar ""Nicolae Plesoianu""",1621,925,910,15,0,916,9,1700,775,487,429,1,15850,0
40,"Valcea",167473,387,167473,,"MUNICIPIUL RAMNICU VALCEA",47,"Cartier PetriSor - PT 8",1652,807,794,12,1,796,11,1800,993,429,367,1,15850,0
40,"Valcea",167473,387,167473,,"MUNICIPIUL RAMNICU VALCEA",48,"Scoala Generala nr. 4",1114,694,674,9,11,683,11,1200,506,302,381,1,15850,0
40,"Valcea",167473,387,167473,,"MUNICIPIUL RAMNICU VALCEA",49,"Scoala Generala nr. 4",1314,792,775,14,3,783,9,1500,708,315,468,1,15850,0
40,"Valcea",167473,387,167473,,"MUNICIPIUL RAMNICU VALCEA",50,"Scoala Generala nr. 4",1441,879,870,9,0,860,19,1600,721,368,492,1,15850,0
40,"Valcea",167473,387,167473,,"MUNICIPIUL RAMNICU VALCEA",51,"Colegiul Economic - Administrativ",1257,755,748,7,0,740,15,1378,623,317,423,1,15850,0
40,"Valcea",167473,387,167473,,"MUNICIPIUL RAMNICU VALCEA",52,"Colegiul Economic - Administrativ",1055,587,576,10,1,580,7,1200,613,238,342,1,15850,0
40,"Valcea",167473,387,167473,,"MUNICIPIUL RAMNICU VALCEA",53,"Colegiul Economic - Administrativ",1215,636,627,9,0,634,2,1300,664,335,299,1,15850,0
40,"Valcea",167473,387,167473,,"MUNICIPIUL RAMNICU VALCEA",54,"Scoala Generala nr. 10",1389,744,730,12,2,739,5,1502,758,356,383,1,15850,0
40,"Valcea",167473,387,167473,,"MUNICIPIUL RAMNICU VALCEA",55,"Scoala Generala nr. 10",1720,935,925,10,0,928,7,1900,965,448,480,1,15850,0
40,"Valcea",167473,387,167473,,"MUNICIPIUL RAMNICU VALCEA",56,"Scoala Generala nr. 10",1051,485,478,7,0,482,3,1200,715,248,234,1,15850,0
40,"Valcea",167473,387,167473,,"MUNICIPIUL RAMNICU VALCEA",57,"Gradinita Ostroveni I",1379,690,678,12,0,684,6,1500,810,372,312,1,15850,0
40,"Valcea",167473,387,167473,,"MUNICIPIUL RAMNICU VALCEA",58,"Grup Scolar ""Ferdinand I""",859,456,445,11,0,453,3,1000,544,231,222,1,15850,0
40,"Valcea",167473,387,167473,,"MUNICIPIUL RAMNICU VALCEA",59,"Grup Scolar ""Ferdinand I""",1100,546,540,6,0,541,5,1100,554,273,268,1,15850,0
40,"Valcea",167473,387,167473,,"MUNICIPIUL RAMNICU VALCEA",60,"Grup Scolar ""Ferdinand I""",1010,481,476,5,0,475,6,1100,619,258,217,1,15850,0
40,"Valcea",167473,387,167473,,"MUNICIPIUL RAMNICU VALCEA",61,"Grup Scolar ""Ferdinand I""",1260,626,616,9,1,619,7,1430,804,346,273,1,15850,0
40,"Valcea",167473,387,167473,,"MUNICIPIUL RAMNICU VALCEA",62,"Grup Scolar ""Ferdinand I""",1231,655,644,11,0,648,7,1308,653,297,351,1,15850,0
40,"Valcea",167473,387,167473,,"MUNICIPIUL RAMNICU VALCEA",63,"Grup Scolar ""Ferdinand I""",1062,554,545,9,0,548,6,1100,546,241,307,1,15850,0
40,"Valcea",167473,387,167473,,"MUNICIPIUL RAMNICU VALCEA",64,"Gradinita Ostroveni II",993,505,492,13,0,500,5,1100,595,260,240,1,15850,0
40,"Valcea",167473,387,167473,,"MUNICIPIUL RAMNICU VALCEA",65,"Gradinita Ostroveni II",1124,594,584,10,0,585,9,1200,606,337,248,1,15850,0
40,"Valcea",167473,387,167473,,"MUNICIPIUL RAMNICU VALCEA",66,"Gradinita Ostroveni II",1222,564,557,7,0,558,6,1300,736,315,243,1,15850,0
40,"Valcea",167473,387,167473,,"MUNICIPIUL RAMNICU VALCEA",67,"Gradinita Ostroveni II",1132,598,588,10,0,595,3,1200,602,287,308,1,15850,0
40,"Valcea",167473,387,167473,,"MUNICIPIUL RAMNICU VALCEA",68,"Scoala Generala ""Anton Pann"" (fosta nr.9)",1586,916,905,11,0,910,6,1700,784,452,458,1,15850,0
40,"Valcea",167473,387,167473,,"MUNICIPIUL RAMNICU VALCEA",69,"Scoala Generala ""Anton Pann"" (fosta nr.9)",1156,606,596,10,0,603,3,1300,694,292,311,1,15850,0
40,"Valcea",167473,387,167473,,"MUNICIPIUL RAMNICU VALCEA",70,"Scoala Generala ""Anton Pann"" (fosta nr.9)",1066,525,516,9,0,520,5,1200,675,273,247,1,15850,0
40,"Valcea",167473,387,167473,,"MUNICIPIUL RAMNICU VALCEA",71,"Scoala Generala ""Anton Pann"" (fosta nr.9)",963,480,471,9,0,477,3,1100,620,233,244,1,15850,0
40,"Valcea",167473,387,167473,,"MUNICIPIUL RAMNICU VALCEA",72,"Scoala Generala ""Anton Pann"" (fosta nr.9)",966,496,478,18,0,492,4,1100,604,245,247,1,15850,0
40,"Valcea",167473,387,167473,,"MUNICIPIUL RAMNICU VALCEA",73,"Scoala Generala ""Anton Pann"" (fosta nr.9)",1009,564,554,10,0,557,7,1100,536,261,296,1,15850,0
40,"Valcea",167473,387,167473,,"MUNICIPIUL RAMNICU VALCEA",74,"Scoala Generala ""Anton Pann"" (fosta nr.9)",1158,579,573,6,0,572,7,1300,721,276,296,1,15850,0
40,"Valcea",167473,387,167473,,"MUNICIPIUL RAMNICU VALCEA",75,"Scoala Generala ""Anton Pann"" (fosta nr.9)",1361,691,680,11,0,686,5,1500,809,368,318,1,15850,0
40,"Valcea",167473,387,167473,,"MUNICIPIUL RAMNICU VALCEA",76,"Scoala Generala nr. 13",983,496,488,8,0,488,8,1100,604,225,263,1,15850,0
40,"Valcea",167473,387,167473,,"MUNICIPIUL RAMNICU VALCEA",77,"Scoala Generala nr. 13",1223,629,614,15,0,618,11,1300,671,301,317,1,15850,0
40,"Valcea",167473,387,167473,,"MUNICIPIUL RAMNICU VALCEA",78,"Scoala Generala nr. 13",994,546,539,7,0,539,7,1100,554,250,289,1,15850,0
40,"Valcea",167473,387,167473,,"MUNICIPIUL RAMNICU VALCEA",79,"Scoala Generala nr. 13",1049,518,512,6,0,514,4,1096,578,252,262,1,15850,0
40,"Valcea",167473,387,167473,,"MUNICIPIUL RAMNICU VALCEA",80,"Scoala Generala nr. 13",1153,621,611,10,0,615,6,1300,679,315,300,1,15850,0
40,"Valcea",167473,387,167473,,"MUNICIPIUL RAMNICU VALCEA",81,"Scoala Generala nr. 13",1171,628,612,16,0,624,4,1300,672,302,322,1,15850,0
40,"Valcea",167473,387,167473,,"MUNICIPIUL RAMNICU VALCEA",82,"Scoala Generala nr. 13",1082,605,602,3,0,600,5,1193,588,337,263,1,15850,0
40,"Valcea",167473,387,167473,,"MUNICIPIUL RAMNICU VALCEA",83,"Scoala cu clasele I-IV Raureni",778,428,419,9,0,419,9,900,472,174,245,1,15850,0
40,"Valcea",167473,387,167473,,"MUNICIPIUL RAMNICU VALCEA",84,"Scoala cu clasele I-IV Stolniceni",574,270,261,9,0,268,2,596,326,120,148,1,15850,0
40,"Valcea",167473,387,167473,,"MUNICIPIUL RAMNICU VALCEA",85,"Scoala Generala nr. 8 Colonia",1045,592,555,37,0,585,7,1098,506,311,274,1,15850,0
40,"Valcea",167473,387,167473,,"MUNICIPIUL RAMNICU VALCEA",86,"Scoala Generala nr. 6 Copacelu",1777,1066,1036,30,0,1058,8,1900,834,505,553,1,15850,0
40,"Valcea",167473,387,167473,,"MUNICIPIUL RAMNICU VALCEA",87,"Scoala cu clasele I-IV Cazanesti",858,487,477,10,0,481,6,900,413,199,282,1,15850,0
40,"Valcea",167473,387,167473,,"MUNICIPIUL RAMNICU VALCEA",88,"Gara C.F.R. Ramnicu Valcea",0,895,0,895,0,892,3,1090,195,486,406,1,15850,1
40,"Valcea",167473,387,167473,,"MUNICIPIUL RAMNICU VALCEA",89,"Autogara Antares (1 Mai)",0,653,0,653,0,646,7,1000,347,329,317,1,15850,1
40,"Valcea",167473,387,167473,,"MUNICIPIUL RAMNICU VALCEA",90,"Spitalul Judetean nr. 1 Ramnicu Valcea",0,511,0,511,0,506,5,600,89,208,298,1,15850,1
40,"Valcea",167473,387,167473,,"MUNICIPIUL RAMNICU VALCEA",91,"Spitalul de Obstetrica-Ginecologie",0,238,0,238,0,233,5,400,162,125,108,1,15850,1
40,"Valcea",167981,387,167981,,"MUNICIPIUL DRAGASANI",92,"Scoala ""Tudor Vladimirescu""",1523,766,756,10,0,760,6,1600,834,295,465,1,15865,0
40,"Valcea",167981,387,167981,,"MUNICIPIUL DRAGASANI",93,"Grupul Scolar "" Bratianu """,1434,618,606,12,0,610,8,1600,982,300,310,1,15865,0
40,"Valcea",167981,387,167981,,"MUNICIPIUL DRAGASANI",94,"Caminul de copii",1447,691,683,8,0,682,9,1600,909,304,378,1,15865,0
40,"Valcea",167981,387,167981,,"MUNICIPIUL DRAGASANI",95,"Gradinita de copii ""Bratianu""",922,475,466,9,0,472,3,1025,550,150,322,1,15865,0
40,"Valcea",167981,387,167981,,"MUNICIPIUL DRAGASANI",96,"Scoala ""N. Balcescu""",1181,606,599,7,0,599,7,1311,705,242,357,1,15865,0
40,"Valcea",167981,387,167981,,"MUNICIPIUL DRAGASANI",97,"Grupul Scolar "" Bratianu """,1502,767,755,12,0,763,4,1600,833,317,446,1,15865,0
40,"Valcea",167981,387,167981,,"MUNICIPIUL DRAGASANI",98,"Colegiul National ""Gib Mihaescu"" (Liceul Teoretic)",1559,765,757,8,0,756,9,1700,935,324,432,1,15865,0
40,"Valcea",167981,387,167981,,"MUNICIPIUL DRAGASANI",99,"Grupul Scolar "" Bratianu "" Scoala profesionala",1150,641,632,9,0,633,8,1302,661,252,381,1,15865,0
40,"Valcea",167981,387,167981,,"MUNICIPIUL DRAGASANI",100,"Scoala Barsanu",987,609,602,7,0,593,16,1110,501,165,428,1,15865,0
40,"Valcea",167981,387,167981,,"MUNICIPIUL DRAGASANI",101,"Gradinita Colonia Rudari",459,343,334,9,0,335,8,502,159,73,262,1,15865,0
40,"Valcea",167981,387,167981,,"MUNICIPIUL DRAGASANI",102,"Scoala ""N. Balcescu""",1376,728,714,14,0,722,6,1500,772,297,425,1,15865,0
40,"Valcea",167981,387,167981,,"MUNICIPIUL DRAGASANI",103,"Scoala ""Tudor Vladimirescu""",1606,758,750,8,0,754,4,1700,942,296,458,1,15865,0
40,"Valcea",167981,387,167981,,"MUNICIPIUL DRAGASANI",104,"Scoala Momotesti",837,477,465,12,0,467,10,900,423,173,294,1,15865,0
40,"Valcea",167981,387,167981,,"MUNICIPIUL DRAGASANI",105,"Scoala Capu Dealului",824,524,515,7,2,520,4,900,376,195,325,1,15865,0
40,"Valcea",167981,387,167981,,"MUNICIPIUL DRAGASANI",106,"Scoala Zlatarei",1220,767,761,6,0,756,11,1400,633,325,431,1,15865,0
40,"Valcea",167981,387,167981,,"MUNICIPIUL DRAGASANI",107,"Statia C.F.R. Dragasani",0,304,0,304,0,300,4,507,203,108,192,1,15865,1
40,"Valcea",167981,387,167981,,"MUNICIPIUL DRAGASANI",108,"Spitalul Municipal Costache Nicolescu",0,72,0,72,0,72,0,301,229,12,60,1,15865,1
40,"Valcea",167981,387,167981,,"MUNICIPIUL DRAGASANI",109,"Scoala Militara de Subofiteri Jandarmi ""Alexandru Grigore Ghica""",0,143,0,143,0,142,1,298,155,70,72,1,15865,1
40,"Valcea",167641,387,167641,,"ORAS BAILE GOVORA",110,"Sala de casatorii a primariei",1131,685,679,0,6,674,11,1300,615,218,456,1,15878,0
40,"Valcea",167641,387,167641,,"ORAS BAILE GOVORA",111,"Liceul teoretic Baile Govora",1090,688,680,6,2,682,6,1204,516,233,449,1,15878,0
40,"Valcea",167641,387,167641,,"ORAS BAILE GOVORA",112,"Scoala cu cls. I-IV Gatejesti",334,215,207,8,0,214,1,404,189,98,116,1,15878,0
40,"Valcea",167641,387,167641,,"ORAS BAILE GOVORA",113,"Gradinita cu program normal Baile Govora",0,350,0,350,0,349,1,800,450,152,197,1,15878,1
40,"Valcea",167696,387,167696,,"ORAS BAILE OLANESTI",114,"Grupul Scolar Justinian Marina",1800,1086,1072,8,6,1077,9,1800,714,461,616,1,15882,0
40,"Valcea",167696,387,167696,,"ORAS BAILE OLANESTI",115,"Scoala cu clasele I-VIII ,,Prof.Dr.Gh.Olanescu"" Baile Olanesti",1326,872,857,14,1,852,20,1507,635,439,413,1,15882,0
40,"Valcea",167696,387,167696,,"ORAS BAILE OLANESTI",116,"Scoala cu clasele I-VIII Ionescu Cheianu",886,570,559,11,0,562,8,1000,430,229,333,1,15882,0
40,"Valcea",167696,387,167696,,"ORAS BAILE OLANESTI",117,"Grupul Scolar Justinian Marina",0,776,0,776,0,771,5,2000,1224,314,457,1,15882,1
40,"Valcea",168372,387,168372,,"ORAS BABENI",118,"Casa de cultura Babeni",1561,881,839,42,0,875,6,1700,819,444,431,1,15870,0
40,"Valcea",168372,387,168372,,"ORAS BABENI",119,"Liceul industrial Babeni",1437,762,736,26,0,753,9,1600,838,385,368,1,15870,0
40,"Valcea",168372,387,168372,,"ORAS BABENI",120,"Gradinita Gara",590,374,333,41,0,368,6,585,211,157,211,1,15870,0
40,"Valcea",168372,387,168372,,"ORAS BABENI",121,"Scoala gen. cu cls.I-IV Valea Mare",847,465,451,14,0,453,12,898,433,180,273,1,15870,0
40,"Valcea",168372,387,168372,,"ORAS BABENI",122,"Scoala cu cls.V_VIII Valea Mare",1203,645,621,24,0,627,18,1300,655,329,298,1,15870,0
40,"Valcea",168372,387,168372,,"ORAS BABENI",123,"Scoala gen.Tatarani",468,286,279,7,0,281,5,500,214,141,140,1,15870,0
40,"Valcea",168372,387,168372,,"ORAS BABENI",124,"Scoala satul Romani",1099,728,703,25,0,712,16,1208,480,267,445,1,15870,0
40,"Valcea",168372,387,168372,,"ORAS BABENI",125,"Scoala Paduretu",198,148,137,11,0,147,1,200,52,81,66,1,15870,0
40,"Valcea",168372,387,168372,,"ORAS BABENI",126,"Casa de cultura Babeni",0,187,0,187,0,186,1,296,109,98,88,1,15870,1
40,"Valcea",168452,387,168452,,"ORAS BALCESTI",127,"Grup Scolar Petrache Poenaru",1077,573,564,9,0,567,6,1097,524,227,340,1,15891,0
40,"Valcea",168452,387,168452,,"ORAS BALCESTI",128,"Grup Scolar Petrache Poenaru",874,479,454,25,0,476,3,1000,521,168,308,1,15891,0
40,"Valcea",168452,387,168452,,"ORAS BALCESTI",129,"Scoala cu clasele I-IV Benesti",354,228,207,21,0,224,4,400,172,75,149,1,15891,0
40,"Valcea",168452,387,168452,,"ORAS BALCESTI",130,"Scoala cu clasele I-IV Gorunesti",729,398,385,13,0,394,4,800,402,94,300,1,15891,0
40,"Valcea",168452,387,168452,,"ORAS BALCESTI",131,"Scoala Irimesti",538,324,310,14,0,315,9,598,274,95,220,1,15891,0
40,"Valcea",168452,387,168452,,"ORAS BALCESTI",132,"Scoala cu clasele I-VIII Otetelisu",900,561,552,9,0,556,5,1000,439,236,320,1,15891,0
40,"Valcea",168452,387,168452,,"ORAS BALCESTI",133,"Grupul Scolar ""Petrache Poenaru""",0,290,0,290,0,284,6,297,7,104,180,1,15891,1
40,"Valcea",168602,387,168602,,"ORAS BERBESTI",134,"Gradinita nr.1 (PECO)",903,438,429,9,0,433,5,1000,562,185,248,1,15901,0
40,"Valcea",168602,387,168602,,"ORAS BERBESTI",135,"Gradinita nr.2 blocuri",1170,640,632,8,0,634,6,1300,660,282,352,1,15901,0
40,"Valcea",168602,387,168602,,"ORAS BERBESTI",136,"Scoala cu cls. I-VIII Berbesti",1576,1003,998,5,0,993,10,1700,697,316,677,1,15901,0
40,"Valcea",168602,387,168602,,"ORAS BERBESTI",137,"Grup Scolar Preda Buzescu Tg.Gangulesti",954,553,549,4,0,549,4,1000,447,220,329,1,15901,0
40,"Valcea",168602,387,168602,,"ORAS BERBESTI",138,"Gradinita nr. 1 (Peco)",0,117,0,117,0,116,1,307,190,48,68,1,15901,1
40,"Valcea",167794,387,167794,,"ORAS BREZOI",139,"Scoala cu cls. I-IV Pascoaia",150,104,100,4,0,104,0,500,396,31,73,1,15908,0
40,"Valcea",167794,387,167794,,"ORAS BREZOI",140,"Scoala cu cls. I-VIII Valea lui Stan",348,217,209,8,0,212,5,403,186,109,103,1,15908,0
40,"Valcea",167794,387,167794,,"ORAS BREZOI",141,"Scoala cu clasele I-IV Brezoi",1086,643,629,13,1,631,12,1200,557,343,288,1,15908,0
40,"Valcea",167794,387,167794,,"ORAS BREZOI",142,"Gradinita P.N. nr.1",962,448,444,4,0,442,6,1000,552,239,203,1,15908,0
40,"Valcea",167794,387,167794,,"ORAS BREZOI",143,"Gradinita P.N. nr.1",1298,587,582,5,0,578,9,1400,813,306,272,1,15908,0
40,"Valcea",167794,387,167794,,"ORAS BREZOI",144,"Scoala cu clasele I-IV nr.1Brezoi",941,471,465,6,0,463,8,1000,529,287,176,1,15908,0
40,"Valcea",167794,387,167794,,"ORAS BREZOI",145,"Magazin Miniera",485,247,236,11,0,241,6,496,249,103,138,1,15908,0
40,"Valcea",167794,387,167794,,"ORAS BREZOI",146,"Caminul cultural CalineSti",554,306,300,6,0,303,3,600,294,157,146,1,15908,0
40,"Valcea",167794,387,167794,,"ORAS BREZOI",147,"Scoala cu clasele I-IV Brezoi",0,172,0,172,0,170,2,406,234,75,95,1,15908,1
40,"Valcea",167909,387,167909,,"ORAS CALIMANESTI",148,"Scoala cu cls.I-IV Seaca",474,273,260,13,0,271,2,492,219,130,141,1,15918,0
40,"Valcea",167909,387,167909,,"ORAS CALIMANESTI",149,"Grupul Scolar economic ad-tiv si de Servicii Calimamesti",980,583,576,7,0,576,7,1105,522,292,284,1,15918,0
40,"Valcea",167909,387,167909,,"ORAS CALIMANESTI",150,"Scoala cu clasele I-VIII Calimanesti",1113,668,656,12,0,663,5,1200,532,314,349,1,15918,0
40,"Valcea",167909,387,167909,,"ORAS CALIMANESTI",151,"Scoala cu clasele I-IV Calimanesti (Deal)",1100,675,669,6,0,671,4,1200,525,300,371,1,15918,0
40,"Valcea",167909,387,167909,,"ORAS CALIMANESTI",152,"Pavilionul Central Calimanesti",531,303,296,7,0,297,6,604,301,144,153,1,15918,0
40,"Valcea",167909,387,167909,,"ORAS CALIMANESTI",153,"Hotel Traian(Cofetaria)",525,320,303,17,0,317,3,600,280,186,131,1,15918,0
40,"Valcea",167909,387,167909,,"ORAS CALIMANESTI",154,"Scoala cu cls.I-VIII Jiblea Veche",959,495,487,8,0,488,7,1100,605,293,195,1,15918,0
40,"Valcea",167909,387,167909,,"ORAS CALIMANESTI",155,"Scoala cu cls.I-VIII Jiblea Veche",993,519,510,9,0,513,6,1100,581,258,255,1,15918,0
40,"Valcea",167909,387,167909,,"ORAS CALIMANESTI",156,"Scoala cu cls.I-VIII Jiblea Noua",840,429,420,9,0,429,0,991,562,229,200,1,15918,0
40,"Valcea",167909,387,167909,,"ORAS CALIMANESTI",157,"Hotel Caciulata, Baza de tratament",0,972,0,972,0,962,10,3000,2028,437,525,1,15918,1
40,"Valcea",168041,387,168041,,"ORAS HOREZU",158,"Liceul Horezu",1351,806,798,8,0,791,15,1500,694,291,500,1,15925,0
40,"Valcea",168041,387,168041,,"ORAS HOREZU",159,"Clubul Copiilor",1328,821,808,13,0,809,12,1514,693,343,466,1,15925,0
40,"Valcea",168041,387,168041,,"ORAS HOREZU",160,"Casa de cultura Horezu",869,546,538,8,0,538,8,900,354,227,311,1,15925,0
40,"Valcea",168041,387,168041,,"ORAS HOREZU",161,"Scoala cu clasele I-VIII Romanii de jos",645,403,394,9,0,393,10,700,297,178,215,1,15925,0
40,"Valcea",168041,387,168041,,"ORAS HOREZU",162,"Caminul Cultural Romanii de sus",303,210,201,9,0,209,1,408,198,102,107,1,15925,0
40,"Valcea",168041,387,168041,,"ORAS HOREZU",163,"Scoala Saliste",495,325,318,7,0,318,7,490,165,153,165,1,15925,0
40,"Valcea",168041,387,168041,,"ORAS HOREZU",164,"Caminul cultural Ramesti",409,268,261,7,0,267,1,406,138,117,150,1,15925,0
40,"Valcea",168041,387,168041,,"ORAS HOREZU",165,"Camin cultural Ursani",398,242,236,6,0,241,1,411,169,102,139,1,15925,0
40,"Valcea",168041,387,168041,,"ORAS HOREZU",166,"Scoala Tanasesti",156,114,103,11,0,112,2,199,85,51,61,1,15925,0
40,"Valcea",168041,387,168041,,"ORAS HOREZU",167,"Autogara Normandia Horezu",0,223,0,223,0,221,2,407,184,115,106,1,15925,1
40,"Valcea",168130,387,168130,,"ORAS OCNELE MARI",168,"Scoala cu cls.I-VIII Ocnele Mari",1392,852,845,6,1,846,6,1520,668,443,403,1,15933,0
40,"Valcea",168130,387,168130,,"ORAS OCNELE MARI",169,"Scoala cu cls. I-VIII Ocnita",1538,988,980,8,0,981,7,1700,712,416,565,1,15933,0
40,"Valcea",168130,387,168130,,"ORAS OCNELE MARI",170,"Scoala cu clasele I-VIII Ocnele Mari",0,162,0,162,0,161,1,200,38,91,70,1,15933,1
40,"Valcea",168229,387,168229,,"ALUNU",171,"Scoala cu clasele I-VIII Alunu",1488,855,848,7,0,840,15,1600,745,352,488,3,15942,0
40,"Valcea",168229,387,168229,,"ALUNU",172,"Gradinita Bodesti",299,177,171,6,0,169,8,309,132,77,92,3,15942,0
40,"Valcea",168229,387,168229,,"ALUNU",173,"Gradinita Coltesti",1238,781,762,19,0,771,10,1400,619,310,461,3,15942,0
40,"Valcea",168229,387,168229,,"ALUNU",174,"Scoala cu clasele I-IV Rosia",497,274,266,8,0,272,2,500,226,108,164,3,15942,0
40,"Valcea",168229,387,168229,,"ALUNU",175,"Scoala cu clasele I-VIII Alunu",0,102,0,102,0,101,1,200,98,56,45,3,15942,1
40,"Valcea",168309,387,168309,,"AMARASTI",176,"Scoala cu cls. I-VIII Amarasti",975,565,555,10,0,555,10,1121,556,248,307,3,15950,0
40,"Valcea",168309,387,168309,,"AMARASTI",177,"Scoala cu cls. I-VIII Nemoiu",415,246,238,8,0,240,6,500,254,123,117,3,15950,0
40,"Valcea",168309,387,168309,,"AMARASTI",178,"Gradinita Meresesti",275,169,161,8,0,165,4,300,131,75,90,3,15950,0
40,"Valcea",168309,387,168309,,"AMARASTI",179,"Scoala cu clasele I-VIII Amarasti",0,88,0,88,0,88,0,179,91,47,41,3,15950,1
40,"Valcea",168559,387,168559,,"BARBATESTI",180,"Scoala cu clasele I-IV Bodesti",881,534,527,7,0,524,10,979,445,161,363,3,15957,0
40,"Valcea",168559,387,168559,,"BARBATESTI",181,"Caminul cultural Barbatesti",1399,842,835,7,0,834,8,1500,658,260,574,3,15957,0
40,"Valcea",168559,387,168559,,"BARBATESTI",182,"Scoala cu cls.I-IV Barzesti",776,447,438,9,0,444,3,900,453,208,236,3,15957,0
40,"Valcea",168559,387,168559,,"BARBATESTI",183,"Scoala cu clasele I-IV Bodesti",0,102,0,102,0,102,0,206,104,42,60,3,15957,1
40,"Valcea",168675,387,168675,,"BERISLAVESTI",184,"Scoala cu clasele I-VIII Stoenesti",755,470,462,8,0,462,8,805,335,209,253,3,15962,0
40,"Valcea",168675,387,168675,,"BERISLAVESTI",185,"Caminul cultural Dingesti",313,209,199,10,0,207,2,391,182,57,150,3,15962,0
40,"Valcea",168675,387,168675,,"BERISLAVESTI",186,"Caminul cultural Radacinesti",631,379,372,7,0,374,5,694,315,199,175,3,15962,0
40,"Valcea",168675,387,168675,,"BERISLAVESTI",187,"Scoala Scaueni",418,275,267,8,0,272,3,500,225,146,126,3,15962,0
40,"Valcea",168675,387,168675,,"BERISLAVESTI",188,"Caminul cultural Robaia",228,154,146,8,0,147,7,299,145,53,94,3,15962,0
40,"Valcea",168675,387,168675,,"BERISLAVESTI",189,"Scoala cu clasele I-VIII Stoenesti",0,108,0,108,0,107,1,200,92,35,72,3,15962,1
40,"Valcea",168755,387,168755,,"BOISOARA",190,"Scoala cu cls.I-VIII Boisoara",1221,545,540,5,0,536,9,1400,855,313,223,3,15970,0
40,"Valcea",168755,387,168755,,"BOISOARA",191,"Scoala cu cls.I-VIII Boisoara",0,71,0,71,0,70,1,100,29,39,31,3,15970,1
40,"Valcea",168791,387,168791,,"BUDESTI",192,"Caminul cultural Budesti",1117,605,588,17,0,601,4,1185,580,341,260,3,15974,0
40,"Valcea",168791,387,168791,,"BUDESTI",193,"Scoala Racovita",1312,668,652,16,0,656,12,1400,732,327,329,3,15974,0
40,"Valcea",168791,387,168791,,"BUDESTI",194,"Scoala Barza",801,476,469,7,0,473,3,900,424,242,231,3,15974,0
40,"Valcea",168791,387,168791,,"BUDESTI",195,"Scoala Barsesti",737,438,427,11,0,432,6,800,362,171,261,3,15974,0
40,"Valcea",168791,387,168791,,"BUDESTI",196,"Scoala Ruda",463,235,224,11,0,233,2,506,271,104,129,3,15974,0
40,"Valcea",168791,387,168791,,"BUDESTI",197,"Scoala Bercioiu",289,177,169,8,0,172,5,288,111,51,121,3,15974,0
40,"Valcea",168791,387,168791,,"BUDESTI",198,"Scoala Racovita",0,106,0,106,0,105,1,200,94,54,51,3,15974,1
40,"Valcea",168880,387,168880,,"BUJORENI",199,"Scoala cu clasele I-VIII Olteni",1203,694,679,15,0,688,6,1297,603,364,324,3,15983,0
40,"Valcea",168880,387,168880,,"BUJORENI",200,"Scoala cu clasele I-IV Lunca",465,310,293,17,0,307,3,500,190,163,144,3,15983,0
40,"Valcea",168880,387,168880,,"BUJORENI",201,"Scoala cu cls.I-IV Bogdanesti",735,397,374,23,0,389,8,800,403,208,181,3,15983,0
40,"Valcea",168880,387,168880,,"BUJORENI",202,"Scoala cu clasele I-VIII Gura Vai",988,620,551,69,0,613,7,1100,480,288,325,3,15983,0
40,"Valcea",168880,387,168880,,"BUJORENI",203,"Scoala cu clasele I-VIII Olteni",0,112,0,112,0,112,0,293,181,54,58,3,15983,1
40,"Valcea",168960,387,168960,,"BUNESTI",204,"Scoala generala(noua) Bunesti",994,617,610,7,0,609,8,1087,470,226,383,3,15991,0
40,"Valcea",168960,387,168960,,"BUNESTI",205,"Scoala generala(noua) Bunesti",857,517,513,4,0,509,8,900,383,140,369,3,15991,0
40,"Valcea",168960,387,168960,,"BUNESTI",206,"Scoala generala Teiusu",473,214,200,14,0,212,2,494,280,77,135,3,15991,0
40,"Valcea",168960,387,168960,,"BUNESTI",207,"Scoala Generala (noua) Bunesti",0,99,0,99,0,99,0,300,201,39,60,3,15991,1
40,"Valcea",169119,387,169119,,"CAINENI",208,"Scoala Cainenii Mici",524,284,276,8,0,282,2,600,316,177,105,3,15998,0
40,"Valcea",169119,387,169119,,"CAINENI",209,"Scoala Cainenii Mari",571,327,319,8,0,320,7,604,277,212,108,3,15998,0
40,"Valcea",169119,387,169119,,"CAINENI",210,"Gradinita Greblesti",647,395,384,11,0,393,2,700,305,195,198,3,15998,0
40,"Valcea",169119,387,169119,,"CAINENI",211,"Scoala Robesti",177,109,98,11,0,107,2,196,87,58,49,3,15998,0
40,"Valcea",169119,387,169119,,"CAINENI",212,"Scoala Cainenii Mari",0,184,0,184,0,183,1,299,115,115,68,3,15998,1
40,"Valcea",169039,387,169039,,"CERNISOARA",213,"Scoala cu clasele I-VIII Armasesti",519,309,304,5,0,302,7,610,301,154,148,3,16005,0
40,"Valcea",169039,387,169039,,"CERNISOARA",214,"Scoala cu clasele I-VIII Cernisoara",799,522,505,17,0,506,16,895,373,177,329,3,16005,0
40,"Valcea",169039,387,169039,,"CERNISOARA",215,"Scoala cu clasele I-IV Grosi",820,533,526,7,0,523,10,900,367,233,290,3,16005,0
40,"Valcea",169039,387,169039,,"CERNISOARA",216,"Scoala cu clasele I-VIII Madulari",592,394,383,11,0,384,10,603,209,95,289,3,16005,0
40,"Valcea",169039,387,169039,,"CERNISOARA",217,"Scoala cu clasele I-IV Obarsia",458,279,268,11,0,268,11,500,221,62,206,3,16005,0
40,"Valcea",169039,387,169039,,"CERNISOARA",218,"Scoala cu clasele I-VIII Madulari",0,97,0,97,0,96,1,300,203,34,62,3,16005,1
40,"Valcea",169182,387,169182,,"COPACENI",219,"Caminul cultural Ulmetu",1483,711,702,9,0,702,9,1600,889,298,404,3,16013,0
40,"Valcea",169182,387,169182,,"COPACENI",220,"Scoala gen.Vetelu",810,494,474,20,0,489,5,800,306,216,273,3,16013,0
40,"Valcea",169182,387,169182,,"COPACENI",221,"Scoala gen.Ulmetu",0,106,0,106,0,105,1,195,89,53,52,3,16013,1
40,"Valcea",169253,387,169253,,"COSTESTI",222,"Scoala gen.cu cls.I-VIII Costesti",1626,1044,1031,4,9,1031,13,1800,756,428,603,3,16020,0
40,"Valcea",169253,387,169253,,"COSTESTI",223,"Scoala cu cls.I-IV Bistrita",695,363,354,9,0,354,9,811,448,100,254,3,16020,0
40,"Valcea",169253,387,169253,,"COSTESTI",224,"Scoala cu cls.I-IV Pietreni",485,338,327,11,0,332,6,500,162,120,212,3,16020,0
40,"Valcea",169253,387,169253,,"COSTESTI",225,"Scoala gen.cu cls.I-VIII Costesti",0,107,0,107,0,101,6,303,196,40,61,3,16020,1
40,"Valcea",169306,387,169306,,"CRETENI",226,"Scoala cu cls.I-VIII Creteni",1133,581,570,5,6,573,8,1133,552,246,327,3,16025,0
40,"Valcea",169306,387,169306,,"CRETENI",227,"Scoala cu cls.I-IV Izvoru",527,400,391,7,2,323,77,604,204,133,190,3,16025,0
40,"Valcea",169306,387,169306,,"CRETENI",228,"Gradinita Streminoasa",536,320,307,8,5,315,5,600,280,101,214,3,16025,0
40,"Valcea",169306,387,169306,,"CRETENI",229,"Scoala cu clasele I-VIII Creteni",0,92,0,92,0,90,2,200,108,33,57,3,16025,1
40,"Valcea",169351,387,169351,,"DAESTI",230,"Scoala Gen. Daesti",845,517,510,7,0,512,5,882,365,253,259,3,16030,0
40,"Valcea",169351,387,169351,,"DAESTI",231,"Caminul cultural Sanbotin",630,423,419,4,0,415,8,713,290,167,248,3,16030,0
40,"Valcea",169351,387,169351,,"DAESTI",232,"Caminul cultural Fedelesoiu",806,493,488,5,0,484,9,902,409,246,238,3,16030,0
40,"Valcea",169351,387,169351,,"DAESTI",233,"Scoala Babuesti",92,68,59,9,0,67,1,100,32,17,50,3,16030,0
40,"Valcea",169351,387,169351,,"DAESTI",234,"Caminul Cultural Sambotin",0,120,0,120,0,119,1,301,181,45,74,3,16030,1
40,"Valcea",169404,387,169404,,"DANICEI",235,"Scoala cu clasele I-VIII Danicei",818,439,432,7,0,432,7,887,448,160,272,3,16035,0
40,"Valcea",169404,387,169404,,"DANICEI",236,"Scoala cu cls.I-IV Dealul Scheiului",272,168,159,9,0,167,1,328,160,99,68,3,16035,0
40,"Valcea",169404,387,169404,,"DANICEI",237,"Scoala cu cls. I-VIII Launele de jos",404,243,236,7,0,239,4,397,154,78,161,3,16035,0
40,"Valcea",169404,387,169404,,"DANICEI",238,"Scoala cu clasele I-IV Ceretu",340,228,209,19,0,225,3,398,170,83,142,3,16035,0
40,"Valcea",169404,387,169404,,"DANICEI",239,"Scoala cu clasele I-VIII Udresti",0,123,0,123,0,122,1,300,177,42,80,3,16035,1
40,"Valcea",174502,387,174502,,"DICULESTI",240,"Scoala cu cls. I-VIII Babeni Oltetu",945,580,566,14,0,572,8,1000,420,169,403,3,16049,0
40,"Valcea",174502,387,174502,,"DICULESTI",241,"Scoala cu clasele I-IV Budesti",641,392,383,9,0,383,9,706,314,143,240,3,16049,0
40,"Valcea",174502,387,174502,,"DICULESTI",242,"Scoala cu cls. I-VIII Babeni Oltetu",0,79,0,79,0,79,0,101,22,20,59,3,16049,1
40,"Valcea",169547,387,169547,,"DRAGOESTI",243,"Scoala cu clasele I-VIII Dragoesti",780,496,486,10,0,493,3,800,304,262,231,3,16054,0
40,"Valcea",169547,387,169547,,"DRAGOESTI",244,"Scoala cu clasele I-IV Buciumeni",625,402,397,5,0,396,6,670,268,137,259,3,16054,0
40,"Valcea",169547,387,169547,,"DRAGOESTI",245,"Scoala cu clasele I-IV Boncani",449,346,334,12,0,340,6,492,146,154,186,3,16054,0
40,"Valcea",169547,387,169547,,"DRAGOESTI",246,"Scoala cu clasele I-VIII Dragoesti",0,137,0,137,0,136,1,200,63,71,65,3,16054,1
40,"Valcea",169583,387,169583,,"FAURESTI",247,"Scoala cu cls.I-VIII Fauresti",709,438,433,5,0,433,5,804,366,198,235,3,16079,0
40,"Valcea",169583,387,169583,,"FAURESTI",248,"Gradinita Milesti",559,357,352,5,0,351,6,595,238,143,208,3,16079,0
40,"Valcea",169583,387,169583,,"FAURESTI",249,"Scoala cu clasele I-VIII Fauresti",0,127,0,127,0,126,1,194,67,73,53,3,16079,1
40,"Valcea",169681,387,169681,,"FARTATESTI",250,"Primaria Fartatesti",356,250,234,16,0,247,3,398,148,54,193,3,16058,0
40,"Valcea",169681,387,169681,,"FARTATESTI",251,"Scoala cu cls.I-VIII Dejoi",433,254,248,6,0,249,5,505,251,71,178,3,16058,0
40,"Valcea",169681,387,169681,,"FARTATESTI",252,"Gradinita Valea Ursului",179,104,93,10,1,104,0,200,96,26,78,3,16058,0
40,"Valcea",169681,387,169681,,"FARTATESTI",253,"Scoala cu cls.I-IV Catetu",416,259,247,12,0,256,3,500,241,61,195,3,16058,0
40,"Valcea",169681,387,169681,,"FARTATESTI",254,"Scoala cu cls.V-VIII Dozesti",631,370,354,13,3,369,1,739,369,110,259,3,16058,0
40,"Valcea",169681,387,169681,,"FARTATESTI",255,"Gradinita Tanislavi",351,208,196,12,0,207,1,395,187,81,126,3,16058,0
40,"Valcea",169681,387,169681,,"FARTATESTI",256,"Scoala cu cls.I-VIII Rusanesti",756,457,444,11,2,451,6,786,329,143,308,3,16058,0
40,"Valcea",169681,387,169681,,"FARTATESTI",257,"Scoala cu cls.I-IV Giulesti de sus",279,213,201,11,1,211,2,303,90,41,170,3,16058,0
40,"Valcea",169681,387,169681,,"FARTATESTI",258,"Primaria Fartatesti",0,212,0,212,0,210,2,300,88,66,144,3,16058,1
40,"Valcea",169896,387,169896,,"FRANCESTI",259,"Scoala cu clasele I-VIII Francesti",849,496,465,31,0,492,4,900,404,194,298,3,16085,0
40,"Valcea",169896,387,169896,,"FRANCESTI",260,"Scoala cu cls.I-IV Cosani",1155,638,622,15,1,621,17,1283,645,282,339,3,16085,0
40,"Valcea",169896,387,169896,,"FRANCESTI",261,"Scoala cu cls.I-VIII Surpatele",1295,788,758,30,0,771,17,1355,567,385,386,3,16085,0
40,"Valcea",169896,387,169896,,"FRANCESTI",262,"Scoala cu cls.I-VIII Genuneni",1138,622,616,6,0,608,14,1300,678,212,396,3,16085,0
40,"Valcea",169896,387,169896,,"FRANCESTI",263,"Scoala cu clasele I-VIII Francesti",0,140,0,140,0,140,0,292,152,72,68,3,16085,1
40,"Valcea",169994,387,169994,,"GALICEA",264,"Caminul cultural Galicea",988,544,525,19,0,535,9,1091,547,168,367,3,16095,0
40,"Valcea",169994,387,169994,,"GALICEA",265,"Scoala Teiu",366,246,235,11,0,241,5,382,136,65,176,3,16095,0
40,"Valcea",169994,387,169994,,"GALICEA",266,"Scoala Valea Raului",365,237,218,19,0,235,2,386,149,79,156,3,16095,0
40,"Valcea",169994,387,169994,,"GALICEA",267,"Scoala Cocoru",550,312,300,12,0,306,6,600,288,75,231,3,16095,0
40,"Valcea",169994,387,169994,,"GALICEA",268,"Scoala Bratia Vale",420,248,229,19,0,246,2,494,246,94,152,3,16095,0
40,"Valcea",169994,387,169994,,"GALICEA",269,"Scoala Bratia Deal",309,222,210,12,0,218,4,299,77,75,143,3,16095,0
40,"Valcea",169994,387,169994,,"GALICEA",270,"Caminul cultural Cremenari",355,240,219,21,0,238,2,400,160,71,167,3,16095,0
40,"Valcea",169994,387,169994,,"GALICEA",271,"Caminul Cultural Galicea",0,120,0,120,0,120,0,300,180,45,75,3,16095,1
40,"Valcea",170097,387,170097,,"GHIOROIU",272,"Scoala gen. Stirbesti",576,332,324,8,0,323,9,605,273,109,214,3,16105,0
40,"Valcea",170097,387,170097,,"GHIOROIU",273,"Caminul cultural Ghioroiu",600,326,320,6,0,322,4,700,374,127,195,3,16105,0
40,"Valcea",170097,387,170097,,"GHIOROIU",274,"Scoala gen. Poienari",289,182,175,7,0,175,7,291,109,65,110,3,16105,0
40,"Valcea",170097,387,170097,,"GHIOROIU",275,"Caminul Cultural Ghioroiu",0,155,0,155,0,155,0,197,42,58,97,3,16105,1
40,"Valcea",170168,387,170168,,"GLAVILE",276,"Scoala cu cls.I-VIII Glavile",1006,472,470,2,0,461,11,1100,628,169,292,3,16112,0
40,"Valcea",170168,387,170168,,"GLAVILE",277,"Scoala cu cls.I-IV. Aninoasa",232,163,153,10,0,154,9,300,137,78,76,3,16112,0
40,"Valcea",170168,387,170168,,"GLAVILE",278,"Scoala cu cls.I-IV nr.1 Olteanca",693,377,370,7,0,369,8,800,423,90,279,3,16112,0
40,"Valcea",170168,387,170168,,"GLAVILE",279,"Scoala cu cls.I-VIII Glavile",0,100,0,100,0,99,1,196,96,32,67,3,16112,1
40,"Valcea",170220,387,170220,,"GOLESTI",280,"Scoala gen. Popesti",753,434,422,12,0,429,5,800,366,182,247,3,16118,0
40,"Valcea",170220,387,170220,,"GOLESTI",281,"Scoala gen. Blidari",826,560,549,11,0,551,9,900,340,263,288,3,16118,0
40,"Valcea",170220,387,170220,,"GOLESTI",282,"Scoala gen. Poenita",420,221,209,12,0,216,5,506,285,130,86,3,16118,0
40,"Valcea",170220,387,170220,,"GOLESTI",283,"Scoala Vatasesti",214,146,137,9,0,146,0,201,55,70,76,3,16118,0
40,"Valcea",170220,387,170220,,"GOLESTI",284,"Scoala cu clasele I-IV Blidari",0,90,0,90,0,89,1,300,210,37,52,3,16118,1
40,"Valcea",170346,387,170346,,"GRADISTEA",285,"Liceul teoretic Gradistea.",367,214,197,17,0,211,3,394,180,105,106,3,16130,0
40,"Valcea",170346,387,170346,,"GRADISTEA",286,"Scoala Valea Gradistea",152,98,88,10,0,96,2,200,102,48,48,3,16130,0
40,"Valcea",170346,387,170346,,"GRADISTEA",287,"Scoala Dobricea",669,435,424,11,0,430,5,700,265,200,230,3,16130,0
40,"Valcea",170346,387,170346,,"GRADISTEA",288,"Gradinita Tuturu",1115,648,642,5,1,641,7,1200,552,378,263,3,16130,0
40,"Valcea",170346,387,170346,,"GRADISTEA",289,"Liceul teoretic Gradistea",0,115,0,115,0,113,2,290,175,36,77,3,16130,1
40,"Valcea",170444,387,170444,,"GUSOENI",290,"Scoala cu cls.I-VIII Gusoeni",863,505,490,2,13,502,3,1000,495,208,294,3,16140,0
40,"Valcea",170444,387,170444,,"GUSOENI",291,"Scoala Burdalesti",276,176,168,7,1,172,4,300,124,65,107,3,16140,0
40,"Valcea",170444,387,170444,,"GUSOENI",292,"Caminul cultural Gusoianca",273,202,189,9,4,201,1,302,100,50,151,3,16140,0
40,"Valcea",170444,387,170444,,"GUSOENI",293,"Scoala cu clasele I-VIII Sparleni",0,100,0,100,0,98,2,100,0,48,50,3,16140,1
40,"Valcea",170514,387,170514,,"IONESTI",294,"Scoala Ionestii Govorii",1178,630,597,33,0,622,8,1296,666,322,300,3,16147,0
40,"Valcea",170514,387,170514,,"IONESTI",295,"Scoala Fiscalia",944,520,505,15,0,512,8,1000,480,275,237,3,16147,0
40,"Valcea",170514,387,170514,,"IONESTI",296,"Scoala Fotesti",727,449,415,34,0,436,13,800,351,238,198,3,16147,0
40,"Valcea",170514,387,170514,,"IONESTI",297,"Scoala Marcea",730,393,371,22,0,393,0,799,406,161,232,3,16147,0
40,"Valcea",170514,387,170514,,"IONESTI",298,"Scoala Ionestii Govorii",0,166,0,166,0,163,3,300,134,75,88,3,16147,1
40,"Valcea",170612,387,170612,,"LALOSU",299,"Scoala cu cls.I-IV Lalosu",775,372,370,2,0,364,8,800,428,192,172,3,16174,0
40,"Valcea",170612,387,170612,,"LALOSU",300,"Scoala generala cu cls.I-VIII Mologesti",573,400,393,7,0,394,6,600,200,223,171,3,16174,0
40,"Valcea",170612,387,170612,,"LALOSU",301,"Scoala cu cls.I-IV Berbesti",405,230,227,3,0,227,3,399,169,102,125,3,16174,0
40,"Valcea",170612,387,170612,,"LALOSU",302,"Scoala cu cls.I-IV Oltetani",229,159,152,7,0,153,6,300,141,54,99,3,16174,0
40,"Valcea",170612,387,170612,,"LALOSU",303,"Scoala cu cls.I-IV Lalosu",0,118,0,118,0,118,0,196,78,51,67,3,16174,1
40,"Valcea",174511,387,174511,,"LACUSTENI",304,"Scoala cu clasele I-IV Lacusteni",432,295,283,6,6,291,4,500,205,104,187,3,16157,0
40,"Valcea",174511,387,174511,,"LACUSTENI",305,"Scoala cu clasele V-VIII Contea",277,181,173,8,0,173,8,300,119,63,110,3,16157,0
40,"Valcea",174511,387,174511,,"LACUSTENI",306,"Scoala cu clasele I-IV Ganesti",482,315,306,9,0,306,9,500,185,47,259,3,16157,0
40,"Valcea",174511,387,174511,,"LACUSTENI",307,"Scoala cu clasele V-VIII Contea",0,84,0,84,0,84,0,200,116,11,73,3,16157,1
40,"Valcea",170685,387,170685,,"LADESTI",308,"Caminul cultural Ladesti",862,472,465,7,0,466,6,1000,528,156,310,3,16163,0
40,"Valcea",170685,387,170685,,"LADESTI",309,"Scoala gen. Gageni",212,132,123,9,0,131,1,200,68,44,87,3,16163,0
40,"Valcea",170685,387,170685,,"LADESTI",310,"Scoala Chiricesti",460,306,297,9,0,301,5,500,194,105,196,3,16163,0
40,"Valcea",170685,387,170685,,"LADESTI",311,"Scoala Olteanca",92,74,62,12,0,74,0,100,26,16,58,3,16163,0
40,"Valcea",170685,387,170685,,"LADESTI",312,"Caminul Cultural Ladesti",0,172,0,172,0,172,0,200,28,67,105,3,16163,1
40,"Valcea",170792,387,170792,,"LAPUSATA",313,"Scoala cu clasele I-VIII Sarulesti",1273,718,705,7,6,710,8,1413,695,242,468,3,16181,0
40,"Valcea",170792,387,170792,,"LAPUSATA",314,"Scoala cu cls.I-IV Serbanesti",623,361,349,12,0,357,4,718,357,98,259,3,16181,0
40,"Valcea",170792,387,170792,,"LAPUSATA",315,"Scoala cu clasele I-VIII Sarulesti",0,128,0,128,0,127,1,300,172,37,90,3,16181,1
40,"Valcea",170872,387,170872,,"LIVEZI",316,"Caminul cultural Tina",574,334,330,4,0,332,2,587,253,140,192,3,16189,0
40,"Valcea",170872,387,170872,,"LIVEZI",317,"Caminul cultural Piriieni",953,597,585,12,0,590,7,963,366,262,328,3,16189,0
40,"Valcea",170872,387,170872,,"LIVEZI",318,"Scoala cu cls.I-IV Plesoiu",377,177,165,12,0,174,3,400,223,71,103,3,16189,0
40,"Valcea",170872,387,170872,,"LIVEZI",319,"Caminul cultural Piriieni",0,190,0,190,0,188,2,299,109,128,60,3,16189,1
40,"Valcea",170952,387,170952,,"LUNGESTI",320,"Caminul cultural Lungesti",952,473,439,16,18,462,11,996,523,151,311,3,16197,0
40,"Valcea",170952,387,170952,,"LUNGESTI",321,"Scoala Stanesti-Lunca",848,455,446,9,0,443,12,848,393,200,243,3,16197,0
40,"Valcea",170952,387,170952,,"LUNGESTI",322,"Caminul Fumureni",648,346,329,17,0,338,8,706,360,132,206,3,16197,0
40,"Valcea",170952,387,170952,,"LUNGESTI",323,"Scoala cu clasele I-IV Dumbrava",358,238,228,10,0,233,5,396,158,81,152,3,16197,0
40,"Valcea",170952,387,170952,,"LUNGESTI",324,"Caminul cultural Lungesti",0,69,0,69,0,68,1,200,131,37,31,3,16197,1
40,"Valcea",171021,387,171021,,"MALAIA",325,"Scoala cu clasele I-VIII Malaia",907,651,646,5,0,648,3,1000,349,311,337,3,16221,0
40,"Valcea",171021,387,171021,,"MALAIA",326,"Scoala I-IV Ciunget",392,299,291,8,0,297,2,385,86,187,110,3,16221,0
40,"Valcea",171021,387,171021,,"MALAIA",327,"Scoala I-IV Saliste",245,183,181,2,0,183,0,300,117,91,92,3,16221,0
40,"Valcea",171021,387,171021,,"MALAIA",328,"Scoala cu clasele I-VIII Malaia",0,121,0,121,0,121,0,195,74,69,52,3,16221,1
40,"Valcea",171067,387,171067,,"MATEESTI",329,"Caminul cultural Mateesti",1089,682,675,4,3,678,4,1200,518,246,432,3,16230,0
40,"Valcea",171067,387,171067,,"MATEESTI",330,"Scoala cu clasele I-IV Greci",496,295,284,7,4,293,2,503,208,78,215,3,16230,0
40,"Valcea",171067,387,171067,,"MATEESTI",331,"Gradinita Turcesti",1018,596,587,7,2,584,12,1090,494,172,412,3,16230,0
40,"Valcea",171067,387,171067,,"MATEESTI",332,"Caminul Cultural Mateesti",0,124,0,124,0,121,3,200,76,41,80,3,16230,1
40,"Valcea",171101,387,171101,,"MACIUCA",333,"Primaria veche Maciuca",896,554,546,8,0,550,4,1000,446,169,381,3,16204,0
40,"Valcea",171101,387,171101,,"MACIUCA",334,"Scoala gen.Popesti",453,266,257,9,0,260,6,495,229,87,173,3,16204,0
40,"Valcea",171101,387,171101,,"MACIUCA",335,"Dispensarul uman Zavoieni",299,169,162,7,0,167,2,272,103,81,86,3,16204,0
40,"Valcea",171101,387,171101,,"MACIUCA",336,"Liceul Maciuca",0,145,0,145,0,143,2,199,54,46,97,3,16204,1
40,"Valcea",171209,387,171209,,"MADULARI",337,"Scoala cu cls.I-VIII Madulari",721,421,410,11,0,416,5,811,390,218,198,3,16214,0
40,"Valcea",171209,387,171209,,"MADULARI",338,"Scoala cu cls.I-IV Balsoara",347,213,209,4,0,206,7,402,189,94,112,3,16214,0
40,"Valcea",171209,387,171209,,"MADULARI",339,"Scoala cu cls.I-IV Bantesti",300,193,187,6,0,188,5,301,108,92,96,3,16214,0
40,"Valcea",171209,387,171209,,"MADULARI",340,"Scoala cu cls.I-VIII Madulari",0,57,0,57,0,57,0,100,43,21,36,3,16214,1
40,"Valcea",171272,387,171272,,"MALDARESTI",341,"Scoala Maldaresti",1602,961,955,3,3,945,16,1800,839,309,636,3,16225,0
40,"Valcea",171272,387,171272,,"MALDARESTI",342,"Scoala Telechesti",121,98,75,23,0,94,4,200,102,28,66,3,16225,0
40,"Valcea",171272,387,171272,,"MALDARESTI",343,"Scoala Maldaresti - Veche",0,63,0,63,0,59,4,200,137,27,32,3,16225,1
40,"Valcea",171325,387,171325,,"MIHAESTI",344,"Caminul cult. Buleta",1121,689,671,18,0,684,5,1200,511,372,312,3,16234,0
40,"Valcea",171325,387,171325,,"MIHAESTI",345,"Caminul Magura",1597,976,957,19,0,969,7,1700,724,388,581,3,16234,0
40,"Valcea",171325,387,171325,,"MIHAESTI",346,"Caminul cultural Vulpuiesti",1414,900,883,8,9,888,12,1500,600,413,475,3,16234,0
40,"Valcea",171325,387,171325,,"MIHAESTI",347,"Scoala Barsesti",565,320,310,10,0,317,3,607,287,171,146,3,16234,0
40,"Valcea",171325,387,171325,,"MIHAESTI",348,"Gradinita Stuparei",688,436,430,6,0,432,4,806,370,167,265,3,16234,0
40,"Valcea",171325,387,171325,,"MIHAESTI",349,"Caminul Cultural Buleta",0,176,0,176,0,176,0,400,224,99,77,3,16234,1
40,"Valcea",171469,387,171469,,"MILCOIU",350,"Primaria Milcoiu",578,352,342,10,0,347,5,602,250,92,255,3,16248,0
40,"Valcea",171469,387,171469,,"MILCOIU",351,"Scoala cu clasele I-IV Izbasesti",237,161,152,9,0,155,6,301,140,40,115,3,16248,0
40,"Valcea",171469,387,171469,,"MILCOIU",352,"Gradinita Ciutesti",237,141,134,7,0,139,2,300,159,43,96,3,16248,0
40,"Valcea",171469,387,171469,,"MILCOIU",353,"Primaria Milcoiu",0,76,0,76,0,75,1,200,124,14,61,3,16248,1
40,"Valcea",174520,387,174520,,"MITROFANI",354,"Caminul cultural Mitrofani",637,391,378,13,0,387,4,709,318,121,266,3,16255,0
40,"Valcea",174520,387,174520,,"MITROFANI",355,"Scoala Racu",258,161,150,11,0,160,1,299,138,58,102,3,16255,0
40,"Valcea",174520,387,174520,,"MITROFANI",356,"Caminul cultural Mitrofani",0,39,0,39,0,39,0,101,62,16,23,3,16255,1
40,"Valcea",171539,387,171539,,"MUEREASCA",357,"Scoala Muereasca de jos",890,447,443,4,0,437,10,1024,577,206,231,3,16260,0
40,"Valcea",171539,387,171539,,"MUEREASCA",358,"Scoala Muereasca de sus",1227,602,592,10,0,590,12,1288,686,313,277,3,16260,0
40,"Valcea",171539,387,171539,,"MUEREASCA",359,"Scoala cu clasele I-VIII Muereasca",0,70,0,70,0,69,1,201,131,30,39,3,16260,1
40,"Valcea",171628,387,171628,,"NICOLAE BALCESCU",360,"Scoala cu clasele I-VIII Rotarasti",935,588,574,12,2,584,4,1010,422,177,407,3,16269,0
40,"Valcea",171628,387,171628,,"NICOLAE BALCESCU",361,"Scoala cu clasele I-IV Corbi",343,219,207,9,3,219,0,400,181,81,138,3,16269,0
40,"Valcea",171628,387,171628,,"NICOLAE BALCESCU",362,"Scoala I-IV Serbaneasa",744,448,430,18,0,437,11,787,339,139,298,3,16269,0
40,"Valcea",171628,387,171628,,"NICOLAE BALCESCU",363,"Gradinita Predesti",769,483,470,13,0,470,13,800,317,177,293,3,16269,0
40,"Valcea",171628,387,171628,,"NICOLAE BALCESCU",364,"Scoala I-IV Galtofani",190,116,107,9,0,114,2,200,84,44,70,3,16269,0
40,"Valcea",171628,387,171628,,"NICOLAE BALCESCU",365,"Scoala cu clasele I-VIII Rotaresti",0,202,0,202,0,199,3,400,198,94,105,3,16269,1
40,"Valcea",171806,387,171806,,"OLANU",366,"Scoala cu cls I-IV Peret",473,304,282,22,0,299,5,500,196,109,190,3,16287,0
40,"Valcea",171806,387,171806,,"OLANU",367,"Scoala cu cls.I-IV Casa veche",655,391,381,10,0,388,3,700,309,135,253,3,16287,0
40,"Valcea",171806,387,171806,,"OLANU",368,"Scoala cu cls I-IV Cioboti",634,399,392,7,0,393,6,700,301,168,225,3,16287,0
40,"Valcea",171806,387,171806,,"OLANU",369,"Scoala cu cls.I-IV Dragioiu",540,324,311,13,0,317,7,607,283,135,182,3,16287,0
40,"Valcea",171806,387,171806,,"OLANU",370,"Scoala cu cls.I-IV Stoicanesti",373,240,231,9,0,240,0,402,162,89,151,3,16287,0
40,"Valcea",171806,387,171806,,"OLANU",371,"Primaria Olanu-sala de sedinte",0,143,0,143,0,141,2,300,157,53,88,3,16287,1
40,"Valcea",171879,387,171879,,"ORLESTI",372,"Camin cultural(fostul camin cultural din curtea primariei)",1347,779,731,16,32,766,13,1506,727,368,398,3,16294,0
40,"Valcea",171879,387,171879,,"ORLESTI",373,"Scoala cu cls.I-IV Procopoaia",861,567,509,30,28,564,3,1012,445,168,396,3,16294,0
40,"Valcea",171879,387,171879,,"ORLESTI",374,"Scoala cu cls I-IV Auresti",268,168,159,9,0,164,4,301,133,55,109,3,16294,0
40,"Valcea",171879,387,171879,,"ORLESTI",375,"Scoala cu cls.I-IV Scaiosi",238,176,157,6,13,171,5,301,125,68,103,3,16294,0
40,"Valcea",171879,387,171879,,"ORLESTI",376,"Scoala veche Procopoaia",0,107,0,107,0,105,2,299,192,37,68,3,16294,1
40,"Valcea",171931,387,171931,,"OTESANI",377,"Caminul cultural Otesani",1233,778,772,6,0,754,24,1400,622,322,432,3,16300,0
40,"Valcea",171931,387,171931,,"OTESANI",378,"Scoala Cirstanesti",1175,772,762,8,2,759,13,1300,528,421,338,3,16300,0
40,"Valcea",171931,387,171931,,"OTESANI",379,"Caminul cultural Otesani",0,103,0,103,0,103,0,186,83,51,52,3,16300,1
40,"Valcea",171995,387,171995,,"PAUSESTI",380,"Scoala cu cls.I-IV Barcanele",537,380,373,7,0,378,2,595,215,116,262,3,16306,0
40,"Valcea",171995,387,171995,,"PAUSESTI",381,"Caminul cultural Pausesti",809,568,561,7,0,556,12,915,347,233,323,3,16306,0
40,"Valcea",171995,387,171995,,"PAUSESTI",382,"Caminul cultural Serbanesti",599,390,383,7,0,384,6,564,174,199,185,3,16306,0
40,"Valcea",171995,387,171995,,"PAUSESTI",383,"Scoala Serbanesti",446,300,292,8,0,296,4,503,203,149,147,3,16306,0
40,"Valcea",171995,387,171995,,"PAUSESTI",384,"Caminul Cultural Pausesti",0,147,0,147,0,147,0,300,153,71,76,3,16306,1
40,"Valcea",172082,387,172082,,"PAUSESTI-MAGLASI",385,"Caminul cultural Pausesti-Maglasi",1054,728,712,16,0,720,8,1100,372,258,462,3,16315,0
40,"Valcea",172082,387,172082,,"PAUSESTI-MAGLASI",386,"Scoala cu clasele I-VIII Pausesti-Maglasi",1163,743,733,10,0,736,7,1300,557,278,458,3,16315,0
40,"Valcea",172082,387,172082,,"PAUSESTI-MAGLASI",387,"Caminul cultural Valea Cheii",873,469,458,11,0,464,5,900,431,191,273,3,16315,0
40,"Valcea",172082,387,172082,,"PAUSESTI-MAGLASI",388,"Scoala cu clasele I-VIII Pausesti-Maglasi",0,197,0,197,0,197,0,400,203,105,92,3,16315,1
40,"Valcea",172153,387,172153,,"PERISANI",389,"Scoala gen.Perisani",483,309,286,11,12,303,6,500,191,85,218,3,16322,0
40,"Valcea",172153,387,172153,,"PERISANI",390,"Caminul cultural Mlaceni",492,306,292,14,0,304,2,500,194,111,193,3,16322,0
40,"Valcea",172153,387,172153,,"PERISANI",391,"Scoala Poiana",511,299,263,13,23,296,3,600,301,86,210,3,16322,0
40,"Valcea",172153,387,172153,,"PERISANI",392,"Caminul cultural Spinu",361,266,236,13,17,261,5,400,134,85,176,3,16322,0
40,"Valcea",172153,387,172153,,"PERISANI",393,"Scoala Podeni",71,56,46,10,0,55,1,89,33,2,53,3,16322,0
40,"Valcea",172153,387,172153,,"PERISANI",394,"Scoala gen.Perisani",0,77,0,77,0,77,0,300,223,35,42,3,16322,1
40,"Valcea",172279,387,172279,,"PESCEANA",395,"Scoala cu cls.I-IV Pesceana",1539,838,834,4,0,826,12,1675,837,280,546,3,16331,0
40,"Valcea",172279,387,172279,,"PESCEANA",396,"Scoala cu clasele I-IV Pesceana",0,117,0,117,0,117,0,126,9,47,70,3,16331,1
40,"Valcea",172340,387,172340,,"PIETRARI",397,"Scoala cu cls.I-VIII Pietrari",1447,922,912,10,0,909,13,1600,678,443,466,3,16338,0
40,"Valcea",172340,387,172340,,"PIETRARI",398,"Scoala cu cls. I-IV Pietrarii de sus",1199,705,699,6,0,693,12,1300,595,229,464,3,16338,0
40,"Valcea",172340,387,172340,,"PIETRARI",399,"Scoala cu cls.I-VIII Pietrari",0,173,0,173,0,173,0,301,128,107,66,3,16338,1
40,"Valcea",172377,387,172377,,"POPESTI",400,"Scoala gen.Daesti",807,510,500,10,0,504,6,897,387,211,293,3,16341,0
40,"Valcea",172377,387,172377,,"POPESTI",401,"Caminul cultural Popesti",409,273,267,6,0,271,2,390,117,101,170,3,16341,0
40,"Valcea",172377,387,172377,,"POPESTI",402,"Scoala cu cls.I-IV Popesti",505,319,306,13,0,311,8,598,279,113,198,3,16341,0
40,"Valcea",172377,387,172377,,"POPESTI",403,"Scoala gen.Ursi",864,545,535,10,0,540,5,898,353,204,336,3,16341,0
40,"Valcea",172377,387,172377,,"POPESTI",404,"Caminul Cultural Popesti",0,157,0,157,0,157,0,298,141,76,81,3,16341,1
40,"Valcea",172457,387,172457,,"PRUNDENI",405,"Scoala Prundeni",1454,810,792,18,0,804,6,1600,790,298,506,3,16349,0
40,"Valcea",172457,387,172457,,"PRUNDENI",406,"Scoala Calina",1225,631,611,20,0,625,6,1300,669,203,422,3,16349,0
40,"Valcea",172457,387,172457,,"PRUNDENI",407,"Scoala Barbuceni",1093,605,597,8,0,598,7,1200,595,212,386,3,16349,0
40,"Valcea",172457,387,172457,,"PRUNDENI",408,"Scoala Prundeni",0,72,0,72,0,71,1,300,228,30,41,3,16349,1
40,"Valcea",172509,387,172509,,"RACOVITA",409,"Caminul cultural Racovita",801,452,441,11,0,441,11,887,435,202,239,3,16354,0
40,"Valcea",172509,387,172509,,"RACOVITA",410,"Scoala Gruiul Lupului",159,93,87,6,0,90,3,200,107,33,57,3,16354,0
40,"Valcea",172509,387,172509,,"RACOVITA",411,"Sediul Forconcid Cornet",98,78,69,9,0,78,0,101,23,29,49,3,16354,0
40,"Valcea",172509,387,172509,,"RACOVITA",412,"Caminul cultural Balota",279,170,155,15,0,166,4,300,130,56,110,3,16354,0
40,"Valcea",172509,387,172509,,"RACOVITA",413,"Caminul Cultural Racovita",0,115,0,115,0,111,4,200,85,61,50,3,16354,1
40,"Valcea",172581,387,172581,,"ROESTI",414,"Scoala cu cls.I-VIII Ciociltei",538,371,359,5,7,364,7,602,231,138,226,3,16362,0
40,"Valcea",172581,387,172581,,"ROESTI",415,"Scoala cu cls.I-IV Roesti",623,384,365,6,13,377,7,706,322,142,235,3,16362,0
40,"Valcea",172581,387,172581,,"ROESTI",416,"Scoala cu cls.I-VIII Cuieni",491,295,286,8,1,292,3,483,188,137,155,3,16362,0
40,"Valcea",172581,387,172581,,"ROESTI",417,"Scoala cu cls.I-IV Barbarigeni",162,115,105,7,3,113,2,204,89,38,75,3,16362,0
40,"Valcea",172581,387,172581,,"ROESTI",418,"Scoala cu clasele I-IV Roesti",0,112,0,112,0,111,1,191,79,45,66,3,16362,1
40,"Valcea",172698,387,172698,,"ROSIILE",419,"Scoala Rosiile",1020,587,568,19,0,579,8,1100,513,237,342,3,16373,0
40,"Valcea",172698,387,172698,,"ROSIILE",420,"Scoala Romanesti",889,472,465,7,0,464,8,1000,528,215,249,3,16373,0
40,"Valcea",172698,387,172698,,"ROSIILE",421,"Scoala Zgubea",315,203,187,16,0,198,5,300,97,72,126,3,16373,0
40,"Valcea",172698,387,172698,,"ROSIILE",422,"Scoala Pertesti",81,55,46,9,0,55,0,100,45,14,41,3,16373,0
40,"Valcea",172698,387,172698,,"ROSIILE",423,"Scoala Rosiile",0,181,0,181,0,181,0,300,119,74,107,3,16373,1
40,"Valcea",172812,387,172812,,"RUNCU",424,"Scoala cu cls.I-VIII Runcu",541,324,314,9,1,315,9,599,275,128,187,3,16385,0
40,"Valcea",172812,387,172812,,"RUNCU",425,"Scoala cu cls.I-IV Valea Babei",241,148,136,12,0,147,1,300,152,37,110,3,16385,0
40,"Valcea",172812,387,172812,,"RUNCU",426,"Scoala cu clasele I-IV Surpati",125,95,86,9,0,93,2,200,105,19,74,3,16385,0
40,"Valcea",172812,387,172812,,"RUNCU",427,"Scoala cu clasele I-VIII Runcu",0,70,0,70,0,70,0,91,21,24,46,3,16385,1
40,"Valcea",172894,387,172894,,"SALATRUCEL",428,"Caminul Salatrucel",1098,532,530,2,0,526,6,1200,668,247,279,3,16393,0
40,"Valcea",172894,387,172894,,"SALATRUCEL",429,"Scoala Serbanesti",454,220,214,6,0,216,4,504,284,104,112,3,16393,0
40,"Valcea",172894,387,172894,,"SALATRUCEL",430,"Scoala Patesti",107,60,52,8,0,58,2,100,40,37,21,3,16393,0
40,"Valcea",172894,387,172894,,"SALATRUCEL",431,"Scoala Seaca",110,66,58,8,0,64,2,100,34,41,23,3,16393,0
40,"Valcea",172894,387,172894,,"SALATRUCEL",432,"Scoala cu clasele I-VIII Salatrucel",0,80,0,80,0,79,1,200,120,33,46,3,16393,1
40,"Valcea",172947,387,172947,,"SCUNDU",433,"Scoala cu cls.I-VIII Scundu",1067,743,719,5,19,738,5,1200,457,157,581,3,16398,0
40,"Valcea",172947,387,172947,,"SCUNDU",434,"Scoala cu cls.I-VIII Avramesti",691,433,414,10,9,426,7,800,367,129,297,3,16398,0
40,"Valcea",172947,387,172947,,"SCUNDU",435,"Scoala cu clasele I-VIII Scundu",0,128,0,128,0,127,1,197,69,41,86,3,16398,1
40,"Valcea",172992,387,172992,,"SINESTI",436,"Caminul cultural Sinesti",698,395,390,5,0,387,8,795,400,109,278,3,16403,0
40,"Valcea",172992,387,172992,,"SINESTI",437,"Scoala cu cls.I-VIII Urzica",804,471,463,8,0,464,7,900,429,138,326,3,16403,0
40,"Valcea",172992,387,172992,,"SINESTI",438,"Scoala cu cls.I-IV Popesti",517,319,311,8,0,313,6,600,281,91,222,3,16403,0
40,"Valcea",172992,387,172992,,"SINESTI",439,"Scoala cu clasele I-VIII Sinesti",0,91,0,91,0,91,0,200,109,39,52,3,16403,1
40,"Valcea",173061,387,173061,,"SLATIOARA",440,"Casa de cultura Slatioara",862,528,512,16,0,519,9,894,366,164,355,3,16416,0
40,"Valcea",173061,387,173061,,"SLATIOARA",441,"Scoala I-VIII Milostea",690,411,401,10,0,403,8,800,389,154,249,3,16416,0
40,"Valcea",173061,387,173061,,"SLATIOARA",442,"Scoala Rugetu",540,345,330,15,0,342,3,600,255,57,285,3,16416,0
40,"Valcea",173061,387,173061,,"SLATIOARA",443,"Scoala Gorunesti",390,220,209,11,0,219,1,400,180,67,152,3,16416,0
40,"Valcea",173061,387,173061,,"SLATIOARA",444,"Gradinita Cumpene",409,257,247,10,0,255,2,513,256,82,173,3,16416,0
40,"Valcea",173061,387,173061,,"SLATIOARA",445,"Casa de cultura Slatioara",0,119,0,119,0,119,0,300,181,53,66,3,16416,1
40,"Valcea",173132,387,173132,,"STANESTI",446,"Scoala cu cls.I-VIII Stanesti",520,292,286,6,0,288,4,580,288,90,198,3,16423,0
40,"Valcea",173132,387,173132,,"STANESTI",447,"Scoala cu cls.I-IV Varleni",582,340,333,7,0,331,9,619,279,131,200,3,16423,0
40,"Valcea",173132,387,173132,,"STANESTI",448,"Sediul vechi al primariei",0,106,0,106,0,103,3,110,4,43,60,3,16423,1
40,"Valcea",173230,387,173230,,"STOENESTI",449,"Scoala Stoenesti",949,613,602,11,0,609,4,1100,487,272,337,3,16438,0
40,"Valcea",173230,387,173230,,"STOENESTI",450,"Scoala Barlogu",338,254,249,5,0,249,5,400,146,83,166,3,16438,0
40,"Valcea",173230,387,173230,,"STOENESTI",451,"Scoala Dobriceni",1079,689,681,8,0,672,17,1185,496,303,369,3,16438,0
40,"Valcea",173230,387,173230,,"STOENESTI",452,"Scoala Piscu Mare",563,357,350,7,0,351,6,597,240,101,250,3,16438,0
40,"Valcea",173230,387,173230,,"STOENESTI",453,"Scoala Zmeurat",176,128,120,8,0,125,3,205,77,62,63,3,16438,0
40,"Valcea",173230,387,173230,,"STOENESTI",454,"Scoala Stoenesti,",0,144,0,144,0,144,0,200,56,73,71,3,16438,1
40,"Valcea",173374,387,173374,,"STOILESTI",455,"Scoala cls.I-VIII Stoilesti",656,362,346,16,0,356,6,697,335,154,202,3,16452,0
40,"Valcea",173374,387,173374,,"STOILESTI",456,"Scoala Geamana cu cls.I-IV Geamana",812,425,395,30,0,420,5,891,466,183,237,3,16452,0
40,"Valcea",173374,387,173374,,"STOILESTI",457,"Scoal cu cls. I-VIII Ursi",1215,669,649,20,0,662,7,1299,630,265,397,3,16452,0
40,"Valcea",173374,387,173374,,"STOILESTI",458,"Scoala Birsoiu",612,362,345,17,0,358,4,685,323,158,200,3,16452,0
40,"Valcea",173374,387,173374,,"STOILESTI",459,"Scoal cu cls. I-VIII Ursi",0,132,0,132,0,132,0,200,68,52,80,3,16452,1
40,"Valcea",173533,387,173533,,"STROESTI",460,"Caminul cultural Stroesti",763,445,433,12,0,441,4,785,340,144,297,3,16468,0
40,"Valcea",173533,387,173533,,"STROESTI",461,"Scoala Ciresu",667,398,389,9,0,389,9,700,302,131,258,3,16468,0
40,"Valcea",173533,387,173533,,"STROESTI",462,"Scoala Dianu",473,305,295,10,0,299,6,496,191,102,197,3,16468,0
40,"Valcea",173533,387,173533,,"STROESTI",463,"Scoala Pojogi-Cerna",238,152,143,9,0,150,2,300,148,73,77,3,16468,0
40,"Valcea",173533,387,173533,,"STROESTI",464,"Centrul Social Obrocesti",326,161,150,11,0,161,0,400,239,71,90,3,16468,0
40,"Valcea",173533,387,173533,,"STROESTI",465,"Scoala Stroesti",0,119,0,119,0,118,1,196,77,53,65,3,16468,1
40,"Valcea",173597,387,173597,,"SUTESTI",466,"Caminul cultural Sutesti",1483,761,751,10,0,754,7,1600,839,340,414,3,16480,0
40,"Valcea",173597,387,173597,,"SUTESTI",467,"Scoala Verdea",483,258,243,15,0,253,5,500,242,61,192,3,16480,0
40,"Valcea",173597,387,173597,,"SUTESTI",468,"Scoala Sutesti",0,77,0,77,0,76,1,200,123,34,42,3,16480,1
40,"Valcea",173686,387,173686,,"SIRINEASA",469,"Scoala Sirineasa",1277,647,639,8,0,643,4,1400,753,157,486,3,16410,0
40,"Valcea",173686,387,173686,,"SIRINEASA",470,"Scoala Ciorasti",503,305,302,3,0,300,5,600,295,65,235,3,16410,0
40,"Valcea",173686,387,173686,,"SIRINEASA",471,"Scoala Slavitesti",266,147,139,8,0,141,6,300,153,64,77,3,16410,0
40,"Valcea",173686,387,173686,,"SIRINEASA",472,"Scoala Sirineasa",0,83,0,83,0,82,1,200,117,25,57,3,16410,1
40,"Valcea",173748,387,173748,,"STEFANESTI",473,"Scoala cu cls.I-VIII Stefanesti",1028,617,602,15,0,614,3,1100,483,291,323,3,16433,0
40,"Valcea",173748,387,173748,,"STEFANESTI",474,"Scoala cu clasele I-IV Serbanesti",730,438,421,17,0,435,3,800,362,114,321,3,16433,0
40,"Valcea",173748,387,173748,,"STEFANESTI",475,"Scoala cu cls.I-VIII Dobrusa de jos",686,348,334,14,0,346,2,700,352,165,181,3,16433,0
40,"Valcea",173748,387,173748,,"STEFANESTI",476,"Scoala cu cls.I-IV Dobrusa de sus",491,342,289,53,0,340,2,500,158,100,240,3,16433,0
40,"Valcea",173748,387,173748,,"STEFANESTI",477,"Scoala cu clasele I-VIII Stefanesti",0,78,0,78,0,78,0,200,122,27,51,3,16433,1
40,"Valcea",173793,387,173793,,"SUSANI",478,"Caminul cult. Usurei",520,326,318,8,0,318,8,596,270,101,217,3,16474,0
40,"Valcea",173793,387,173793,,"SUSANI",479,"Scoala Susani de sus",605,332,308,24,0,330,2,696,364,120,210,3,16474,0
40,"Valcea",173793,387,173793,,"SUSANI",480,"Scoala Susani de jos",459,353,295,50,8,345,8,500,147,130,215,3,16474,0
40,"Valcea",173793,387,173793,,"SUSANI",481,"Scoala Stoiculesti",342,235,213,22,0,229,6,389,154,103,126,3,16474,0
40,"Valcea",173793,387,173793,,"SUSANI",482,"Scoala Ramesti",961,579,556,23,0,564,15,1100,521,354,210,3,16474,0
40,"Valcea",173793,387,173793,,"SUSANI",483,"Scoala Susani de sus",0,162,0,162,0,162,0,299,137,76,86,3,16474,1
40,"Valcea",173855,387,173855,,"TETOIU",484,"Scoala Baroiu",334,243,223,16,4,242,1,400,157,60,182,3,16485,0
40,"Valcea",173855,387,173855,,"TETOIU",485,"Caminul cultural Tetoiu",590,308,294,11,3,306,2,600,292,92,214,3,16485,0
40,"Valcea",173855,387,173855,,"TETOIU",486,"Scoala cu cls.I-VIII Tepesti",779,402,387,0,15,397,5,900,498,173,224,3,16485,0
40,"Valcea",173855,387,173855,,"TETOIU",487,"Scoala cu cls.I-IV Nenciulesti",308,176,151,10,15,175,1,391,215,101,74,3,16485,0
40,"Valcea",173855,387,173855,,"TETOIU",488,"Scoala cu cls.I-IV Budele",183,115,97,11,7,112,3,200,85,34,78,3,16485,0
40,"Valcea",173855,387,173855,,"TETOIU",489,"Scoala cu clasele I-VIII Tepesti",0,171,0,171,0,169,2,310,139,74,95,3,16485,1
40,"Valcea",174496,387,174496,,"TITESTI",490,"Scoala cu cls.I-VIII Titesti (Scoala de sus)",564,363,350,4,9,355,8,600,237,177,178,3,16493,0
40,"Valcea",174496,387,174496,,"TITESTI",491,"Scoala cu cls.I-IV Bratovesti",198,145,131,10,4,141,4,200,55,53,88,3,16493,0
40,"Valcea",174496,387,174496,,"TITESTI",492,"Scoala cu cls.I-VIII Titesti (Scoa de jos)",0,89,0,89,0,89,0,100,11,41,48,3,16493,1
40,"Valcea",173935,387,173935,,"TOMSANI",493,"Scoala generala Tomsani",1583,1052,1042,9,1,1041,11,1699,647,301,740,3,16497,0
40,"Valcea",173935,387,173935,,"TOMSANI",494,"Scoala Folesti de sus",1048,589,581,8,0,573,16,1082,493,199,374,3,16497,0
40,"Valcea",173935,387,173935,,"TOMSANI",495,"Scoala Folesti de jos",742,451,441,9,1,448,3,789,338,133,315,3,16497,0
40,"Valcea",173935,387,173935,,"TOMSANI",496,"Scoala generala Tomani",0,122,0,122,0,121,1,298,176,44,77,3,16497,1
40,"Valcea",174021,387,174021,,"VAIDEENI",497,"Caminul cultural Vaideeni",980,511,508,1,2,509,2,1100,589,207,302,3,16506,0
40,"Valcea",174021,387,174021,,"VAIDEENI",498,"Caminul cultural Vaideeni",1256,755,744,8,3,739,16,1400,645,302,437,3,16506,0
40,"Valcea",174021,387,174021,,"VAIDEENI",499,"Caminul cultural Izvoru Rece",693,425,417,8,0,416,9,818,393,132,284,3,16506,0
40,"Valcea",174021,387,174021,,"VAIDEENI",500,"Caminul cultural Marita",509,319,313,6,0,317,2,600,281,99,218,3,16506,0
40,"Valcea",174021,387,174021,,"VAIDEENI",501,"Caminul Cultural Vaideeni",0,123,0,123,0,120,3,300,177,54,66,3,16506,1
40,"Valcea",174085,387,174085,,"VALEA MARE",502,"Scoala cu clasele I-IV Delureni",452,247,228,19,0,244,3,500,253,73,171,3,16512,0
40,"Valcea",174085,387,174085,,"VALEA MARE",503,"Gradinita Valea Mare",586,339,331,8,0,337,2,713,374,87,250,3,16512,0
40,"Valcea",174085,387,174085,,"VALEA MARE",504,"Scoala cu cls.I-VIII Batasani",440,274,263,11,0,272,2,494,220,97,175,3,16512,0
40,"Valcea",174085,387,174085,,"VALEA MARE",505,"Scoala cu cls.I-IV Margineni",396,217,208,9,0,210,7,399,182,66,144,3,16512,0
40,"Valcea",174085,387,174085,,"VALEA MARE",506,"Caminul cultural Draganu",498,308,294,13,1,301,7,571,263,80,221,3,16512,0
40,"Valcea",174085,387,174085,,"VALEA MARE",507,"Scoala cu cls.I-VIII Batasani",0,94,0,94,0,93,1,300,206,39,54,3,16512,1
40,"Valcea",174156,387,174156,,"VLADESTI",508,"Caminul cultural Vladesti",1388,929,919,10,0,914,15,1516,587,437,477,3,16519,0
40,"Valcea",174156,387,174156,,"VLADESTI",509,"Scoala Priporu",818,552,544,8,0,545,7,907,355,267,278,3,16519,0
40,"Valcea",174156,387,174156,,"VLADESTI",510,"Caminul cultural Vladesti",0,149,0,149,0,149,0,303,154,68,81,3,16519,1
40,"Valcea",174218,387,174218,,"VOICESTI",511,"Caminul cultural Voicesti",1363,939,891,4,44,921,18,1500,561,322,599,3,16525,0
40,"Valcea",174218,387,174218,,"VOICESTI",512,"Caminul cultural Voicesti",0,66,0,66,0,65,1,200,134,25,40,3,16525,1
40,"Valcea",174254,387,174254,,"VOINEASA",513,"Localul primariei Voineasa",985,590,585,5,0,584,6,1100,510,294,290,3,16529,0
40,"Valcea",174254,387,174254,,"VOINEASA",514,"Scoala cu clasele I-VIII Voineasa",451,279,270,9,0,277,2,494,215,123,154,3,16529,0
40,"Valcea",174254,387,174254,,"VOINEASA",515,"Scoala cu clasele I-VIII Voineasa",0,145,0,145,0,143,2,200,55,70,73,3,16529,1
40,"Valcea",174290,387,174290,,"ZATRENI",516,"Scoala cu cls.I-VIII Zatreni",597,349,345,4,0,345,4,694,345,124,221,3,16533,0
40,"Valcea",174290,387,174290,,"ZATRENI",517,"Scoala cu cls I-IV Stanomiru",406,264,258,6,0,259,5,500,236,83,176,3,16533,0
40,"Valcea",174290,387,174290,,"ZATRENI",518,"Scoala cu cls.I-IV Valeni",415,271,263,8,0,268,3,497,226,110,158,3,16533,0
40,"Valcea",174290,387,174290,,"ZATRENI",519,"Scoala cu cls.I-VIII Dealul Valeni",327,184,178,6,0,183,1,397,213,63,120,3,16533,0
40,"Valcea",174290,387,174290,,"ZATRENI",520,"Scoala cu cls.I-VIII Sascioara",398,272,265,7,0,265,7,404,132,94,171,3,16533,0
40,"Valcea",174290,387,174290,,"ZATRENI",521,"Scoala cu cls.I-VIII Zatreni",0,214,0,214,0,209,5,295,81,87,122,3,16533,1
41,"Vrancea",174744,396,174744,,"MUNICIPIUL FOCSANI",1,"DIRECTIA SILVICA VRANCEA STR.AURORA NR.5",1443,755,742,13,0,746,9,1600,845,366,380,1,16549,0
41,"Vrancea",174744,396,174744,,"MUNICIPIUL FOCSANI",2,"TEATRUL MUNICIPAL FOCSANI STR.REPUBLICII NR.71",1285,752,743,9,0,738,14,1400,648,333,405,1,16549,0
41,"Vrancea",174744,396,174744,,"MUNICIPIUL FOCSANI",3,"BIBL. JUDETEANA ""DUILIU ZAMFIRESCU"" STR.M. KOGALNICEANU NR.12",1705,1024,1011,13,0,1015,9,1800,776,518,497,1,16549,0
41,"Vrancea",174744,396,174744,,"MUNICIPIUL FOCSANI",4,"SCOALA ""STEFAN CEL MARE"" (SCOALA NR.9) INTRAREA PRINCIPALA STR.STEFAN CEL MARE NR.12",1236,607,596,11,0,599,8,1300,693,306,293,1,16549,0
41,"Vrancea",174744,396,174744,,"MUNICIPIUL FOCSANI",5,"SCOALA ""STEFAN CEL MARE"" (SCOALA NR.9)  INTRAREA SECUNDARA STR.STEFAN CEL MARE NR.12",1130,638,627,10,1,632,6,1200,562,306,326,1,16549,0
41,"Vrancea",174744,396,174744,,"MUNICIPIUL FOCSANI",6,"SERVICIUL  PUBLIC LOCAL DE ASISTENTA SOCIALA(FOSTA GRADINITA NR.6)  STR.STEFAN CEL MARE NR.21",1366,773,763,10,0,763,10,1500,727,396,367,1,16549,0
41,"Vrancea",174744,396,174744,,"MUNICIPIUL FOCSANI",7,"GRUP SCOLAR TRANSPORTURI AUTO  STR.COTESTI NR.52",1176,682,666,15,1,678,4,1300,618,355,323,1,16549,0
41,"Vrancea",174744,396,174744,,"MUNICIPIUL FOCSANI",8,"SC C.F. IASI FILIALA FOCSANI STR.PROF.LONGINESCU NR.33BIS",1793,935,924,11,0,932,3,1900,965,492,440,1,16549,0
41,"Vrancea",174744,396,174744,,"MUNICIPIUL FOCSANI",9,"COLEGIUL ECONOMIC ""M.KOGALNICEANU"" - INTRAREA PRINCIPALA BD. GARII NR.25",1726,959,942,17,0,951,8,1900,941,430,521,1,16549,0
41,"Vrancea",174744,396,174744,,"MUNICIPIUL FOCSANI",10,"COLEGIUL ECONOMIC ""M.KOGALNICEANU""  - INTRAREA ELEVILOR BD. GARII NR.25",1962,1050,1037,13,0,1030,20,2100,1050,509,521,1,16549,0
41,"Vrancea",174744,396,174744,,"MUNICIPIUL FOCSANI",11,"CUP SA STR.N.TITULESCU NR.9",991,518,504,13,1,510,8,1094,576,272,238,1,16549,0
41,"Vrancea",174744,396,174744,,"MUNICIPIUL FOCSANI",12,"SCOALA NR.7 ALEEA SCOLII NR.47",1748,904,886,18,0,889,15,1900,996,442,447,1,16549,0
41,"Vrancea",174744,396,174744,,"MUNICIPIUL FOCSANI",13,"GRADINITA NR.15  - INTRAREA PRINCIPALA STR.BIRSEI NR.8",1072,540,532,8,0,534,6,1200,660,259,275,1,16549,0
41,"Vrancea",174744,396,174744,,"MUNICIPIUL FOCSANI",14,"GRADINITA NR.15  - INTRAREA SECUNDARA STR.BIRSEI NR.8",1769,948,936,12,0,937,11,1900,952,460,477,1,16549,0
41,"Vrancea",174744,396,174744,,"MUNICIPIUL FOCSANI",15,"GRUPUL SCOLAR G.G. LONGINESCU(FORESTIER) STR.MARASESTI NR.50",1632,813,791,22,0,801,12,1701,888,391,410,1,16549,0
41,"Vrancea",174744,396,174744,,"MUNICIPIUL FOCSANI",16,"SCOALA ION BASGAN(SCOALA NR.2) STR.MARE A UNIRII NR.30",1485,715,698,17,0,707,8,1600,885,369,338,1,16549,0
41,"Vrancea",174744,396,174744,,"MUNICIPIUL FOCSANI",17,"OCOLUL SILVIC STR. MARE A UNIRII NR.24A",1572,717,708,9,0,702,15,1700,983,412,290,1,16549,0
41,"Vrancea",174744,396,174744,,"MUNICIPIUL FOCSANI",18,"GRUPUL SCOLAR AGRICOL STR.CUZA VODA NR.46",1409,724,713,11,0,715,9,1600,876,365,350,1,16549,0
41,"Vrancea",174744,396,174744,,"MUNICIPIUL FOCSANI",19,"COLEGIUL NATIONAL ""AL.I.CUZA"" STR.CUZA VODA NR.47",1324,685,672,13,0,680,5,1400,715,417,263,1,16549,0
41,"Vrancea",174744,396,174744,,"MUNICIPIUL FOCSANI",20,"SCOALA ANGHEL SALINGY(SCOLA NR.5) - INTRAREA PRINCIPALA STR.MOLDOVA NR.7",1656,888,872,16,0,865,23,1800,912,464,401,1,16549,0
41,"Vrancea",174744,396,174744,,"MUNICIPIUL FOCSANI",21,"SCOALA ANGHEL SALINGY(SCOLA NR.5) -INTRAREA SECUNDARA STR.MOLDOVA NR.7",1507,713,702,11,0,706,7,1600,887,373,333,1,16549,0
41,"Vrancea",174744,396,174744,,"MUNICIPIUL FOCSANI",22,"SCOLA NR.11 MINDRESTI - MUNTENI STR.LACRAMIOAREI NR.19",1277,1000,664,10,326,986,14,1397,397,582,404,1,16549,0
41,"Vrancea",174744,396,174744,,"MUNICIPIUL FOCSANI",23,"AGENTIA NATIONALA  DE IMBUNATATIRI  FUNCIARE STR.BRAILEI NR.121 BIS",1303,578,570,8,0,570,8,1384,806,271,299,1,16549,0
41,"Vrancea",174744,396,174744,,"MUNICIPIUL FOCSANI",24,"GRADINITA NR.16 - INTRAREA PRINCIPALA ALEEA CAMINULUI NR.13",1347,581,572,9,0,573,8,1400,819,273,300,1,16549,0
41,"Vrancea",174744,396,174744,,"MUNICIPIUL FOCSANI",25,"COLEGIUL NATIONAL ""UNIREA"" STR.CEZAR BOLIAC NR.15",1303,571,554,10,7,568,3,1400,829,296,272,1,16549,0
41,"Vrancea",174744,396,174744,,"MUNICIPIUL FOCSANI",26,"SCOALA NR.3 - INTR.PRINCIPALA  STR.DORNEI NR.1",1367,625,617,8,0,621,4,1500,875,324,297,1,16549,0
41,"Vrancea",174744,396,174744,,"MUNICIPIUL FOCSANI",27,"DIRECTIA DE MUNCA,SOLIDARITATE SOCIALA  SI FAMILIEI VRANCEA  STR.BRAILEI NR.3BIS",1590,813,777,36,0,802,11,1701,888,389,413,1,16549,0
41,"Vrancea",174744,396,174744,,"MUNICIPIUL FOCSANI",28,"GRUPUL  SCOLAR EDMOND NICOLAU(  ELECTROTEHNICA )STR.1 DECEMBRIE 1918 NR.10",1160,612,597,15,0,598,14,1300,688,280,318,1,16549,0
41,"Vrancea",174744,396,174744,,"MUNICIPIUL FOCSANI",29,"SALA SPORTURILOR BD.UNIRII NR.12",1400,741,730,9,2,738,3,1501,760,337,401,1,16549,0
41,"Vrancea",174744,396,174744,,"MUNICIPIUL FOCSANI",30,"BIBLIOTECA JUDETEANA DUILIU ZAMFIRESCU STR.M. KOGALNICEANU NR.13",1361,713,701,12,0,701,12,1497,784,379,322,1,16549,0
41,"Vrancea",174744,396,174744,,"MUNICIPIUL FOCSANI",31,"DIRECTIA JUDETEANA A SPORTURILOR BD.UNIRII NR.12",1421,728,718,10,0,724,4,1500,772,353,371,1,16549,0
41,"Vrancea",174744,396,174744,,"MUNICIPIUL FOCSANI",32,"CENTRUL MEDICAL FOCSANI(POLICLINICA 2) STR.BUCEGI NR.28",1280,646,629,16,1,635,11,1400,754,312,323,1,16549,0
41,"Vrancea",174744,396,174744,,"MUNICIPIUL FOCSANI",33,"SCOALA ""DUILIU ZAMFIRESCU""(SC.NR.10) - INTRAREA PRINCIPALA STR.TINERETII NR.2",1601,737,731,6,0,729,8,1701,964,348,381,1,16549,0
41,"Vrancea",174744,396,174744,,"MUNICIPIUL FOCSANI",34,"SCOALA ""DUILIU ZAMFIRESCU""(SC.NR.10) - INTRAREA SECUNDARA STR.TINERETII NR.2",1471,753,730,22,1,746,7,1600,847,390,356,1,16549,0
41,"Vrancea",174744,396,174744,,"MUNICIPIUL FOCSANI",35,"LICEUL PEDAGOGIC SPIRU HARET STR.TIMOTEI CIPARIU NR.5",1614,863,853,10,0,851,12,1700,837,415,436,1,16549,0
41,"Vrancea",174744,396,174744,,"MUNICIPIUL FOCSANI",36,"SC FEDERALCOOP SA STR.UNIREA PRINCIPATELOR NR.2",1599,880,868,12,0,865,15,1700,820,401,464,1,16549,0
41,"Vrancea",174744,396,174744,,"MUNICIPIUL FOCSANI",37,"GRADINITA NR.18 STR.POPA SAPCA NR.4",1274,671,663,8,0,656,15,1400,729,346,310,1,16549,0
41,"Vrancea",174744,396,174744,,"MUNICIPIUL FOCSANI",38,"LOCALUL DIN STR. PROF. LONGINESCU NR. 33 (FOSTUL SC.CF IASI)",1668,825,818,7,0,818,7,1800,975,411,407,1,16549,0
41,"Vrancea",174744,396,174744,,"MUNICIPIUL FOCSANI",39,"GRUPUL SCOLAR DE CONSTR.MONTAJ STR.1 DECEMBRIE 1918 NR.32",942,417,401,16,0,412,5,1000,583,225,187,1,16549,0
41,"Vrancea",174744,396,174744,,"MUNICIPIUL FOCSANI",40,"LOCALUL CRESEI NR.1 ALEEA 1 IUNIE NR.1",1593,685,671,14,0,682,3,1700,1015,328,354,1,16549,0
41,"Vrancea",174744,396,174744,,"MUNICIPIUL FOCSANI",41,"SCOALA NICOLAE IORGA(SCOALA NR.1) - INTRAREA PRINCIPALA  ALEEA 1 IUNIE NR.6",1616,738,723,13,2,724,14,1701,963,326,398,1,16549,0
41,"Vrancea",174744,396,174744,,"MUNICIPIUL FOCSANI",42,"SCOALA NICOLAE IORGA(SCOALA NR.1) - INTRAREA SECUNDARA  ALEEA 1 IUNIE NR.6",1523,717,704,13,0,710,7,1700,983,361,349,1,16549,0
41,"Vrancea",174744,396,174744,,"MUNICIPIUL FOCSANI",43,"GRADINITA NR.13 ALEEA ECHITATII NR.33",1686,771,760,11,0,761,10,1790,1019,419,342,1,16549,0
41,"Vrancea",174744,396,174744,,"MUNICIPIUL FOCSANI",44,"SCOALA ""AL. VLAHUTA""(SCOALA NR.8)  - INTRAREA PRINCIPALA ALEEA 1 IUNIE NR.6",1053,444,437,7,0,440,4,1120,676,233,207,1,16549,0
41,"Vrancea",174744,396,174744,,"MUNICIPIUL FOCSANI",45,"SCOALA ""AL. VLAHUTA""(SCOALA NR.8)  - INTRAREA SECUNDARA  ALEEA 1 IUNIE NR.6",1615,735,724,11,0,727,8,1799,1064,335,392,1,16549,0
41,"Vrancea",174744,396,174744,,"MUNICIPIUL FOCSANI",46,"GRADINITA NR.1 ALEEA 1 IUNIE NR.1",925,500,487,13,0,495,5,994,494,200,295,1,16549,0
41,"Vrancea",174744,396,174744,,"MUNICIPIUL FOCSANI",47,"UNIVERSITATEA GEORGE BARITIU - CENTRUL DE STUDII FOCSANI  BD.BUCURESTI NR.16",800,573,552,21,0,565,8,893,320,248,317,1,16549,0
41,"Vrancea",174744,396,174744,,"MUNICIPIUL FOCSANI",48,"DIRECTIA SANITAR VETERINRA STR.BRAILEI NR.121B",1602,852,831,21,0,840,12,1700,848,447,393,1,16549,0
41,"Vrancea",174744,396,174744,,"MUNICIPIUL FOCSANI",49,"GRADINITA NR.8 STR.AURORA NR.7",1572,792,776,16,0,781,11,1700,908,412,369,1,16549,0
41,"Vrancea",174744,396,174744,,"MUNICIPIUL FOCSANI",50,"GRADINITA NR.4 STR.ANA IPATESCU NR.1",1295,603,594,9,0,594,9,1396,793,316,278,1,16549,0
41,"Vrancea",174744,396,174744,,"MUNICIPIUL FOCSANI",51,"DISPENSARUL MEDICAL  NR. 5-6  STR.REVOLUTIEI NR.12",1799,826,816,10,0,813,13,1900,1074,384,429,1,16549,0
41,"Vrancea",174744,396,174744,,"MUNICIPIUL FOCSANI",52,"GRADINITA NR.13  ALEEA ECHITATII NR.33",1900,969,947,22,0,958,11,2000,1031,457,501,1,16549,0
41,"Vrancea",174744,396,174744,,"MUNICIPIUL FOCSANI",53,"GRADINITA NR.16  - INTRAREA SECUNDARA  AL. CAMINULUI NR.13",1957,832,825,6,1,824,8,2100,1268,357,467,1,16549,0
41,"Vrancea",174744,396,174744,,"MUNICIPIUL FOCSANI",54,"GRADINITA NR.17 BD.UNIRII NR.2A",1498,744,733,11,0,737,7,1600,856,334,403,1,16549,0
41,"Vrancea",174744,396,174744,,"MUNICIPIUL FOCSANI",55,"SCOALA NR.3 - INTRAREA SECUNDARA STR.DORNEI  NR.1",1083,494,483,10,1,493,1,1180,686,233,260,1,16549,0
41,"Vrancea",174744,396,174744,,"MUNICIPIUL FOCSANI",56,"SCOALA AL.VLAHUTA(SCOALA NR.8) ALEEA 1 IUNIE NR.6",993,457,446,11,0,454,3,1100,643,214,240,1,16549,0
41,"Vrancea",174744,396,174744,,"MUNICIPIUL FOCSANI",57,"SCOALA ""DUILIU ZAMFIRESCU""(SC.NR.10) - STR.TINERETII NR.2",1291,681,670,11,0,673,8,1400,719,320,353,1,16549,0
41,"Vrancea",174744,396,174744,,"MUNICIPIUL FOCSANI",58,"DIRECTIA GENERALA A FINANTELOR PUBLICE VRANCEA B-DUL INDEPENDENTEI NR.24 (SPECIALA)",0,458,0,458,0,456,2,1000,542,258,198,1,16549,1
41,"Vrancea",174744,396,174744,,"MUNICIPIUL FOCSANI",59,"STATIA  CFR FOCSANI B-DUL  GARII NR.1 (SPECIALA)",0,789,0,789,0,777,12,1000,211,418,359,1,16549,1
41,"Vrancea",174744,396,174744,,"MUNICIPIUL FOCSANI",60,"SC TRANS COMPANY SA  PIATA VICTORIEI NR.1 (SPECIALA)",0,752,0,752,0,746,6,998,246,392,354,1,16549,1
41,"Vrancea",174860,396,174860,,"MUNICIPIUL ADJUD",61,"ADJUD CASA DE CULTURA STR.LIBERTATII NR.7",1110,517,510,7,0,514,3,1193,676,241,273,1,16553,0
41,"Vrancea",174860,396,174860,,"MUNICIPIUL ADJUD",62,"ADJUD SCOALA  NR.1 STR. 1 MAI NR.35",1194,580,562,18,0,574,6,1300,720,275,299,1,16553,0
41,"Vrancea",174860,396,174860,,"MUNICIPIUL ADJUD",63,"ADJUD SCOALA  NR.4 STR. LIBERTATII NR 2A",1332,660,652,7,1,631,29,1400,740,244,387,1,16553,0
41,"Vrancea",174860,396,174860,,"MUNICIPIUL ADJUD",64,"ADJUD SCOALA  NR.2(A) STR. TUDOR VLADIMIRESCU NR. 7A",1385,598,589,9,0,591,7,1500,902,275,316,1,16553,0
41,"Vrancea",174860,396,174860,,"MUNICIPIUL ADJUD",65,"ADJUD SCOALA  NR.2(B) STR. TUDOR VLADIMIRESCU NR. 7A",1462,642,639,3,0,637,5,1600,958,325,312,1,16553,0
41,"Vrancea",174860,396,174860,,"MUNICIPIUL ADJUD",66,"ADJUD SCOALA  NR.2(C) STR. TUDOR VLADIMIRESCU NR. 7A",1400,551,539,11,1,547,4,1500,949,268,279,1,16553,0
41,"Vrancea",174860,396,174860,,"MUNICIPIUL ADJUD",67,"ADJUD STATIA CFR STR. EROILOR NR.2 FOSTA POSTA",1566,743,734,9,0,737,6,1700,957,355,382,1,16553,0
41,"Vrancea",174860,396,174860,,"MUNICIPIUL ADJUD",68,"ADJUD CRSA STR. AL.I.CUZA NR.330",1172,592,586,6,0,586,6,1300,708,272,314,1,16553,0
41,"Vrancea",174860,396,174860,,"MUNICIPIUL ADJUD",69,"ADJUD SCOALA NR.3 STR. REPUBLICII NR.90",1687,870,857,11,2,853,17,1801,931,399,454,1,16553,0
41,"Vrancea",174860,396,174860,,"MUNICIPIUL ADJUD",70,"ADJUD GRUP SCOLAR AGRICOL(A) STR. REPUBLICII NR.107",1115,573,560,13,0,563,10,1200,627,220,343,1,16553,0
41,"Vrancea",174860,396,174860,,"MUNICIPIUL ADJUD",71,"ADJUD GRUP SCOLAR AGRICOL(B)STR. REPUBLICII NR.107",836,402,396,6,0,397,5,900,498,170,227,1,16553,0
41,"Vrancea",174860,396,174860,,"MUNICIPIUL ADJUD",72,"ADJUD- BURCIOAIA SCOALA GENERALA BURCIOAIA",434,261,250,11,0,252,9,500,239,116,136,1,16553,0
41,"Vrancea",174860,396,174860,,"MUNICIPIUL ADJUD",73,"ADJUD-SISCANI SCOALA GENERALA SISCANI",653,367,348,19,0,361,6,700,333,127,234,1,16553,0
41,"Vrancea",174860,396,174860,,"MUNICIPIUL ADJUD",74,"ADJUDU VECHI SCOALA GENERALA ADJUDU VECHI",1368,719,710,9,0,704,15,1500,781,289,415,1,16553,0
41,"Vrancea",174860,396,174860,,"MUNICIPIUL ADJUD",75,"ADJUD STATIA CFR ADJUD, STATIA DE ASTEPTARE CLASA 1 STR.EROILOR NR.2(SPECIALA)",0,237,0,237,0,232,5,701,464,105,127,1,16553,1
41,"Vrancea",174860,396,174860,,"MUNICIPIUL ADJUD",76,"ADJUD SALA DE SPORT, ZONA STADION STR. REPUBLICII NR.4(SPECIALA)",0,132,0,132,0,131,1,701,569,70,61,1,16553,1
41,"Vrancea",174922,396,174922,,"ORAS MARASESTI",77,"MARASESTI SCOALA GENERALA NR.1 STR.SIRET NR.1",1285,646,639,7,0,636,10,1400,754,347,289,1,16558,0
41,"Vrancea",174922,396,174922,,"ORAS MARASESTI",78,"MARASESTI SCOALA  GENERALA NR.3 STR. MARESAL AL. AVERESCU NR.65",1748,954,941,13,0,934,20,1901,947,653,281,1,16558,0
41,"Vrancea",174922,396,174922,,"ORAS MARASESTI",79,"MARASESTI CLUBUL ELEVILOR STR. MARESAL AL. AVERESCU NR.7",556,299,290,9,0,299,0,600,301,147,152,1,16558,0
41,"Vrancea",174922,396,174922,,"ORAS MARASESTI",80,"MARASESTI CASA DE CULTURA STR. REPUBLICII NR.99",1794,810,802,7,1,802,8,1900,1090,407,395,1,16558,0
41,"Vrancea",174922,396,174922,,"ORAS MARASESTI",81,"MARASESTI GRUP SCOLAR INDUSTRIAL STR. REPUBLICII 74",1710,776,763,13,0,771,5,1900,1124,368,403,1,16558,0
41,"Vrancea",174922,396,174922,,"ORAS MARASESTI",82,"MARASESTI SCOALA GENERALA NR.2 STR. GAROAFEI",1211,560,547,13,0,555,5,1300,740,288,267,1,16558,0
41,"Vrancea",174922,396,174922,,"ORAS MARASESTI",83,"HARET SCOALA GENERALA HARET",493,268,258,10,0,265,3,500,232,128,137,1,16558,0
41,"Vrancea",174922,396,174922,,"ORAS MARASESTI",84,"PADURENI SCOALA GENERALA PADURENI",458,251,243,8,0,246,5,496,245,119,127,1,16558,0
41,"Vrancea",174922,396,174922,,"ORAS MARASESTI",85,"CALIMANESTI SCOALA GENERALA",407,244,235,9,0,238,6,504,260,101,137,1,16558,0
41,"Vrancea",174922,396,174922,,"ORAS MARASESTI",86,"DOAGA SCOALA GENERALA",212,95,85,10,0,94,1,300,205,54,40,1,16558,0
41,"Vrancea",174922,396,174922,,"ORAS MARASESTI",87,"STATIA CFR MARASESTI STR.DOINEI NR.2(SPECIALA)",0,178,0,178,0,175,3,499,321,74,101,1,16558,1
41,"Vrancea",175019,396,175019,,"ORAS ODOBESTI",88,"ODOBESTI BIBLIOTECA ORASENEASCA STR. LIBERTATII NR.122",1582,865,850,15,0,852,13,1700,835,324,528,1,16566,0
41,"Vrancea",175019,396,175019,,"ORAS ODOBESTI",89,"ODOBESTI LICEUL  TEORETIC DUILIU ZAMFIRESCU STR.STEFAN CEL MARE NR.40",1603,880,870,10,0,866,14,1700,820,345,521,1,16566,0
41,"Vrancea",175019,396,175019,,"ORAS ODOBESTI",90,"ODOBESTI GRUP SCOLAR AGRICOL STR. STEFAN CEL MARE NR.42",1596,906,892,14,0,897,9,1700,794,333,564,1,16566,0
41,"Vrancea",175019,396,175019,,"ORAS ODOBESTI",91,"ODOBESTI GRADINITA NR.2 CARAGEA STR. LIBERTATII NR.161",888,557,494,63,0,545,12,1000,443,261,284,1,16566,0
41,"Vrancea",175019,396,175019,,"ORAS ODOBESTI",92,"UNIREA SCOALA GENERALA",970,478,466,12,0,473,5,1100,622,246,227,1,16566,0
41,"Vrancea",175019,396,175019,,"ORAS ODOBESTI",93,"UNIREA GRADINITA NR.3 SAT UNIREA",655,397,385,12,0,387,10,700,303,185,202,1,16566,0
41,"Vrancea",175019,396,175019,,"ORAS ODOBESTI",94,"ODOBESTI PRIMARIA ODOBESTI CORP B-TAXE SI IMPOZITE STR.LIBERTATII NR.113(SPECIALA)",0,294,0,294,0,272,22,512,218,110,162,1,16566,1
41,"Vrancea",175055,396,175055,,"ORAS PANCIU",95,"PANCIU CASA DE CULTURA",1337,637,624,10,3,629,8,1494,857,282,347,1,16569,0
41,"Vrancea",175055,396,175055,,"ORAS PANCIU",96,"PANCIU SCOALA GEN NR.1",1215,635,611,22,2,629,6,1300,665,246,383,1,16569,0
41,"Vrancea",175055,396,175055,,"ORAS PANCIU",97,"PANCIU MAGAZIN UNIVERSAL",1117,578,562,15,1,573,5,1200,622,296,277,1,16569,0
41,"Vrancea",175055,396,175055,,"ORAS PANCIU",98,"PANCIU SPITALUL ORASENESC",1175,631,606,25,0,622,9,1300,669,270,352,1,16569,0
41,"Vrancea",175055,396,175055,,"ORAS PANCIU",99,"SATU NOU SCOALA GENERALA",841,502,488,4,10,490,12,900,398,239,251,1,16569,0
41,"Vrancea",175055,396,175055,,"ORAS PANCIU",100,"CRUCEA DE JOS CLUB DE SOCIALIZARE",399,259,242,8,9,257,2,501,242,104,153,1,16569,0
41,"Vrancea",175055,396,175055,,"ORAS PANCIU",101,"DUMBRAVA SCOALA GENERALA",446,272,257,6,9,266,6,513,241,101,165,1,16569,0
41,"Vrancea",175055,396,175055,,"ORAS PANCIU",102,"CRUCEA DE SUS SCOALA GENERALA",774,457,435,15,7,449,8,900,443,223,226,1,16569,0
41,"Vrancea",175055,396,175055,,"ORAS PANCIU",103,"NEICU CAMIN CULTURAL",575,347,325,9,13,342,5,600,253,125,217,1,16569,0
41,"Vrancea",175055,396,175055,,"ORAS PANCIU",104,"PANCIU FOSTA GRADINITA A COMPLEXULUI COMUNUTAR DE FETE STR.ION HELIADE RADULESCU NR.1(SPECIALA)",0,144,0,144,0,144,0,500,356,36,108,1,16569,1
41,"Vrancea",175055,396,175055,,"ORAS PANCIU",105,"PANCIU LICEUL IOAN SLAVICI  B-DUL INDEPENDENTEI NR.2(SPECIALA)",0,196,0,196,0,190,6,536,340,78,112,1,16569,1
41,"Vrancea",175126,396,175126,,"ANDREIASU DE JOS",106,"SCOALA CU CLS I-VIII ANDREIASU DE JOS SALA A",544,326,305,2,19,322,4,600,274,81,241,3,16576,0
41,"Vrancea",175126,396,175126,,"ANDREIASU DE JOS",107,"RACHITASU SCOALA NR.1 CU CLASELE I-IV",603,339,303,6,30,330,9,702,363,94,236,3,16576,0
41,"Vrancea",175126,396,175126,,"ANDREIASU DE JOS",108,"ANDREIASU DE SUS SCOALA I-VIII",437,268,236,10,22,261,7,505,237,52,209,3,16576,0
41,"Vrancea",175126,396,175126,,"ANDREIASU DE JOS",109,"SCOALA GENERALA CU CLASELE I-VIII (ANDREIASU DE JOS SPECIALA",0,73,0,73,0,72,1,298,225,40,32,3,16576,1
41,"Vrancea",175206,396,175206,,"BALESTI",110,"SCOALA GENERALA CU CLS I-VIII BALESTI (SALA 1)",986,513,513,0,0,505,8,1100,587,206,299,3,16584,0
41,"Vrancea",175206,396,175206,,"BALESTI",111,"SCOALA GENERALA CU CLS I-VIII (SALA 2)",800,456,454,2,0,449,7,901,445,203,246,3,16584,0
41,"Vrancea",175206,396,175206,,"BALESTI",112,"SCOALA GENERALA CU CLS. I-VIII  BALESTI SPECIALA",0,91,0,91,0,91,0,200,109,39,52,3,16584,1
41,"Vrancea",178929,396,178929,,"BILIESTI",113,"BILIESTI SCOALA GENERALA NR.1",1031,533,524,8,1,527,6,1099,566,292,235,3,16589,0
41,"Vrancea",178929,396,178929,,"BILIESTI",114,"SASU SCOALA GENERALA NR.2",1034,478,471,7,0,476,2,1099,621,230,246,3,16589,0
41,"Vrancea",178929,396,178929,,"BILIESTI",115,"PRIMARIA COMUNEI BILIESTI CENTRUL COMUNEI BILIESTI (SPECIALA)",0,126,0,126,0,126,0,301,175,70,56,3,16589,1
41,"Vrancea",175224,396,175224,,"BARSESTI",116,"BARSESTI CAMINUL CULTURAL ZONA A",1240,819,771,2,46,805,14,1400,581,291,514,3,16586,0
41,"Vrancea",175224,396,175224,,"BARSESTI",117,"CAMINUL CULTURAL BIRSESTI(SPECIALA)",0,40,0,40,0,40,0,200,160,17,23,3,16586,1
41,"Vrancea",175260,396,175260,,"BOGHESTI",118,"PRIMARIA BOGHESTI SALA DE SEDINTE",571,273,268,5,0,268,5,599,326,128,140,3,16591,0
41,"Vrancea",175260,396,175260,,"BOGHESTI",119,"PRISECANI SCOALA",338,190,184,6,0,182,8,400,210,61,121,3,16591,0
41,"Vrancea",175260,396,175260,,"BOGHESTI",120,"SCOALA BICHESTI",150,100,93,7,0,96,4,200,100,38,58,3,16591,0
41,"Vrancea",175260,396,175260,,"BOGHESTI",121,"SCOALA CU CLASELE I-IV IUGANI",173,112,103,9,0,111,1,200,88,34,77,3,16591,0
41,"Vrancea",175260,396,175260,,"BOGHESTI",122,"SCOALA CU CLASELE I-IV PLACINTENI",149,88,81,7,0,88,0,197,109,32,56,3,16591,0
41,"Vrancea",175260,396,175260,,"BOGHESTI",123,"PRIMARIA COMUNEI BOGHESTI(SPECIALA)",0,95,0,95,0,92,3,208,113,33,59,3,16591,1
41,"Vrancea",175368,396,175368,,"BOLOTESTI",124,"BOLOTESTI CAMIN CULTURAL BIROU SECRETARIAT",644,379,370,9,0,375,4,700,321,152,223,3,16601,0
41,"Vrancea",175368,396,175368,,"BOLOTESTI",125,"PUTNA SCOALA CU CLASELE I-VIII CLASA A-VIII-A",508,332,326,6,0,323,9,601,269,115,208,3,16601,0
41,"Vrancea",175368,396,175368,,"BOLOTESTI",126,"IVANCESTI SCOALA CU CLASELE I-IV CLASA I-VI",374,161,155,6,0,158,3,400,239,50,108,3,16601,0
41,"Vrancea",175368,396,175368,,"BOLOTESTI",127,"GAGESTI SCOALA  GENERALA CU CLASELE I-VIII HOLUL MARE",1328,712,710,2,0,690,22,1500,788,242,448,3,16601,0
41,"Vrancea",175368,396,175368,,"BOLOTESTI",128,"PIETROASA  SCOALA  CU CLASELE I-VIII  GAGESTI CLASA A-III-B",425,230,223,7,0,224,6,500,270,67,157,3,16601,0
41,"Vrancea",175368,396,175368,,"BOLOTESTI",129," VITANESTII DE SUB MAGURA SCOALA CU CL.I-IV CLASA I-IV",624,333,329,4,0,328,5,700,367,124,204,3,16601,0
41,"Vrancea",175368,396,175368,,"BOLOTESTI",130,"CAMINUL CULTURAL BOLOTESTI(SPECIALA)",0,189,0,189,0,188,1,300,111,63,125,3,16601,1
41,"Vrancea",175439,396,175439,,"BORDESTI",131,"BORDESTI CAMIN CULTURAL",1067,631,595,4,32,617,14,1200,569,307,310,3,16608,0
41,"Vrancea",175439,396,175439,,"BORDESTI",132,"BORDESTI DE JOS SCOALA CU CLS I-IV BORDESTII DE JOS",434,305,278,9,18,304,1,500,195,82,222,3,16608,0
41,"Vrancea",175439,396,175439,,"BORDESTI",133,"SCOALA GENERALA CU CLS. I-VIII BORDESTI(SPECIALA)",0,127,0,127,0,127,0,200,73,72,55,3,16608,1
41,"Vrancea",175466,396,175466,,"BROSTENI",134,"BROSTENI CAMIN CULTURAL",1268,699,679,20,0,687,12,1400,701,304,383,3,16611,0
41,"Vrancea",175466,396,175466,,"BROSTENI",135,"GRADINITA ARVA",517,297,290,7,0,294,3,600,303,133,161,3,16611,0
41,"Vrancea",175466,396,175466,,"BROSTENI",136,"SCOALA GENERALA BROSTENI SPECIALA",0,76,0,76,0,75,1,306,230,38,37,3,16611,1
41,"Vrancea",175509,396,175509,,"CHIOJDENI",137,"GRADINITA CHIOJDENI",795,470,456,7,7,461,9,896,426,187,274,3,16630,0
41,"Vrancea",175509,396,175509,,"CHIOJDENI",138,"CATAUTI SCOALA  CU CLS.I-IV",359,207,198,9,0,202,5,400,193,101,101,3,16630,0
41,"Vrancea",175509,396,175509,,"CHIOJDENI",139,"LUNCILE SCOALA  CU CLS. I-IV",626,413,397,14,2,393,20,700,287,195,198,3,16630,0
41,"Vrancea",175509,396,175509,,"CHIOJDENI",140,"SCOALA DE ARTE SI MESERII  CHIOJDENI SPECIALA",0,63,0,63,0,62,1,210,147,32,30,3,16630,1
41,"Vrancea",175590,396,175590,,"CIORASTI",141,"CIORASTI SALON DE DANS DIN CENTRUL SATULUI CIORASTI",870,483,474,9,0,469,14,1000,517,171,298,3,16639,0
41,"Vrancea",175590,396,175590,,"CIORASTI",142,"CODRESTI MAGAZIN MIXT DIN CENTRUL SATULUI",228,143,131,12,0,142,1,301,158,65,77,3,16639,0
41,"Vrancea",175590,396,175590,,"CIORASTI",143,"MIHALCENI SCOALA  CU CLS. I-VIII DIN CENTRUL SATULUI",701,357,348,9,0,349,8,800,443,133,216,3,16639,0
41,"Vrancea",175590,396,175590,,"CIORASTI",144,"SALCIA NOUA SCOALA GENERALA  CU CLS.I-IV",430,263,254,9,0,255,8,500,237,116,139,3,16639,0
41,"Vrancea",175590,396,175590,,"CIORASTI",145,"SALCIA VECHE SCOALA GENERALA  CU CLS.I-IV",278,199,189,10,0,193,6,300,101,91,102,3,16639,0
41,"Vrancea",175590,396,175590,,"CIORASTI",146,"SATU NOU SCOALA GENERALA  CU CLS.I-IV",241,142,137,5,0,137,5,300,158,48,89,3,16639,0
41,"Vrancea",175590,396,175590,,"CIORASTI",147,"SPATAREASA FOSTA BRUTARIE DIN CENTRUL SATULUI",211,134,125,9,0,131,3,301,167,52,79,3,16639,0
41,"Vrancea",175590,396,175590,,"CIORASTI",148,"FOSTUL SEDIU AL PRIMARIEI CIORASTI SPECIALA",0,141,0,141,0,139,2,200,59,69,70,3,16639,1
41,"Vrancea",174780,396,174780,,"CAMPINEANCA",149,"CAMPINEANCA SCOALA GENERALA I-IV SALA 1",1575,872,870,2,0,853,19,1700,828,464,389,3,16615,0
41,"Vrancea",174780,396,174780,,"CAMPINEANCA",150,"CAMPINEANCA SCOALA GENERALA I-IV SALA 2",1419,769,761,8,0,761,8,1600,831,445,316,3,16615,0
41,"Vrancea",174780,396,174780,,"CAMPINEANCA",151,"SCOALA CU CLS I-IV CAMPINEANCA SPECIALA",0,124,0,124,0,120,4,300,176,75,45,3,16615,1
41,"Vrancea",175670,396,175670,,"CAMPURI",152,"CAMPURI SCOALA NR.2",858,478,458,19,1,466,12,900,422,172,294,3,16619,0
41,"Vrancea",175670,396,175670,,"CAMPURI",153,"CAMPURI SCOALA NR.1",1020,533,508,22,3,527,6,1100,567,199,328,3,16619,0
41,"Vrancea",175670,396,175670,,"CAMPURI",154,"ROTILESTI SCOALA ROTILESTI",536,309,293,16,0,305,4,600,291,79,226,3,16619,0
41,"Vrancea",175670,396,175670,,"CAMPURI",155,"FETESTI SCOALA FETESTI",762,408,382,18,8,401,7,800,392,60,341,3,16619,0
41,"Vrancea",175670,396,175670,,"CAMPURI",156,"CAMINUL CULTURAL CAMPURI SPECIALA",0,87,0,87,0,83,4,300,213,33,50,3,16619,1
41,"Vrancea",175732,396,175732,,"CARLIGELE",157,"CARLIGELE GRADINITA",924,532,500,12,20,528,4,1001,469,193,335,3,16625,0
41,"Vrancea",175732,396,175732,,"CARLIGELE",158,"BONTESTI SCOALA GENERALA",406,265,217,10,38,263,2,501,236,61,202,3,16625,0
41,"Vrancea",175732,396,175732,,"CARLIGELE",159,"BLIDARI SCOALA GENERALA",479,319,289,8,22,316,3,500,181,110,206,3,16625,0
41,"Vrancea",175732,396,175732,,"CARLIGELE",160,"DALHAUTI SCOALA GENERALA",585,394,354,12,28,388,6,600,206,151,237,3,16625,0
41,"Vrancea",175732,396,175732,,"CARLIGELE",161,"CAMINUL CULTURAL MIHAI SAMBOTIN CARLIGELE SPECIALA",0,137,0,137,0,136,1,300,163,57,79,3,16625,1
41,"Vrancea",175787,396,175787,,"CORBITA",162,"SERBANESTI SALA DE SEDINTE A PRIMARIEI CORBITA DIN SAT SERBANESTI",389,243,217,7,19,238,5,400,157,29,209,3,16647,0
41,"Vrancea",175787,396,175787,,"CORBITA",163,"RADACINESTI SCOALA CU CLS I-IV",381,229,201,6,22,217,12,400,171,61,156,3,16647,0
41,"Vrancea",175787,396,175787,,"CORBITA",164,"OCHESESTI CASA AGRONOMULUI",324,214,184,6,24,212,2,400,186,77,135,3,16647,0
41,"Vrancea",175787,396,175787,,"CORBITA",165,"BUDA CAMINUL CULTURAL",470,272,251,3,18,266,6,500,228,101,165,3,16647,0
41,"Vrancea",175787,396,175787,,"CORBITA",166,"CENTRUL DE ZI INSTRUCTIV-EDUCATIV  CORBITA, SAT SERBANESTI SPECIALA",0,90,0,90,0,90,0,200,110,27,63,3,16647,1
41,"Vrancea",175885,396,175885,,"COTESTI",167,"COTESTI   SCOALA NR 1 SALA 1 STANGA",1209,605,585,7,13,604,1,1300,695,258,346,3,16657,0
41,"Vrancea",175885,396,175885,,"COTESTI",168,"COTESTI SCOALA NR.2",491,277,269,6,2,273,4,600,323,107,166,3,16657,0
41,"Vrancea",175885,396,175885,,"COTESTI",169,"BUDESTI CAMIN CULTURAL",1549,889,854,16,19,879,10,1701,812,433,446,3,16657,0
41,"Vrancea",175885,396,175885,,"COTESTI",170,"COTESTI VALEA COTESTI SCOALA VALEA COTESTI",365,207,196,6,5,205,2,400,193,119,86,3,16657,0
41,"Vrancea",175885,396,175885,,"COTESTI",171,"SCOALA GOLESTII DE SUS",327,219,206,8,5,217,2,390,171,100,117,3,16657,0
41,"Vrancea",175885,396,175885,,"COTESTI",172,"SCOALA NR.1 COTESTI SPECIALA",0,202,0,202,0,200,2,303,101,71,129,3,16657,1
41,"Vrancea",175938,396,175938,,"DUMBRAVENI",173,"DUMBRAVENI  CAMIN CULTURAL SALA MARE",1582,897,893,3,1,893,4,1700,803,419,474,3,16662,0
41,"Vrancea",175938,396,175938,,"DUMBRAVENI",174,"CANDESTI SCOALA GENERALA CU CLS I-VIII",1096,625,611,10,4,610,15,1200,575,334,276,3,16662,0
41,"Vrancea",175938,396,175938,,"DUMBRAVENI",175,"DRAGOSLOVENI SCOALA GENERALA I-IV",857,515,502,13,0,505,10,902,387,261,244,3,16662,0
41,"Vrancea",175938,396,175938,,"DUMBRAVENI",176,"CAMINUL CULTURAL  DUMBRAVENI SPECIALA SALA DE LECTURA A BIBLIOTECII",0,177,0,177,0,172,5,300,123,81,91,3,16662,1
41,"Vrancea",175983,396,175983,,"DUMITRESTI",177,"SCOALA PRIMARA  GALOIESTI 1",461,272,262,10,0,267,5,498,226,95,172,3,16667,0
41,"Vrancea",175983,396,175983,,"DUMITRESTI",178,"DUMITRESTI CAMIN CULTURAL",926,535,506,20,9,530,5,1000,465,236,294,3,16667,0
41,"Vrancea",175983,396,175983,,"DUMITRESTI",179,"MOTNAU SCOALA PRIMARA",331,233,211,5,17,228,5,399,166,115,113,3,16667,0
41,"Vrancea",175983,396,175983,,"DUMITRESTI",180,"TRESTIA SCOALA PRIMARA",166,113,97,7,9,111,2,200,87,40,71,3,16667,0
41,"Vrancea",175983,396,175983,,"DUMITRESTI",181,"TINOASA SCOALA PRIMARA",186,131,121,6,4,129,2,198,67,65,64,3,16667,0
41,"Vrancea",175983,396,175983,,"DUMITRESTI",182,"LASTUNI  SCOALA GENERALA",316,216,197,12,7,209,7,397,181,63,146,3,16667,0
41,"Vrancea",175983,396,175983,,"DUMITRESTI",183,"POIENITA  SCOALA PRIMARA",235,178,162,13,3,174,4,297,119,58,116,3,16667,0
41,"Vrancea",175983,396,175983,,"DUMITRESTI",184,"DUMITRESTI FATA SCOALA PRIMARA",211,148,136,9,3,146,2,301,153,73,73,3,16667,0
41,"Vrancea",175983,396,175983,,"DUMITRESTI",185,"BICESTII DE SUS SCOALA PRIMARA VECHE",645,406,399,4,3,401,5,707,301,206,195,3,16667,0
41,"Vrancea",175983,396,175983,,"DUMITRESTI",186,"BICESTII DE JOS SCOALA PRIMARA",551,268,258,10,0,262,6,600,332,56,206,3,16667,0
41,"Vrancea",175983,396,175983,,"DUMITRESTI",187,"GRUPUL SCOLAR  DUMITRESTI SPECIALA",0,129,0,129,0,127,2,300,171,51,76,3,16667,1
41,"Vrancea",176150,396,176150,,"FITIONESTI",188,"FITIONESTI CAMIN CULTURAL",751,384,381,3,0,374,10,800,416,147,227,3,16684,0
41,"Vrancea",176150,396,176150,,"FITIONESTI",189,"FITIONESTI PISC SCOALA DE 4 ANI",600,308,299,9,0,300,8,700,392,116,184,3,16684,0
41,"Vrancea",176150,396,176150,,"FITIONESTI",190,"GHIMICESTI GRADINITA",368,198,191,7,0,194,4,400,202,98,96,3,16684,0
41,"Vrancea",176150,396,176150,,"FITIONESTI",191,"MANASTIOARA ,HOLBANESTI SCOALA DE 8 ANI",532,272,267,5,0,270,2,600,328,94,176,3,16684,0
41,"Vrancea",176150,396,176150,,"FITIONESTI",192,"CIOLANESTI SCOALA DE 4 ANI",138,81,69,12,0,80,1,200,119,42,38,3,16684,0
41,"Vrancea",176150,396,176150,,"FITIONESTI",193,"PRIMARIA  FITIONESTI SPECIALA",0,101,0,101,0,100,1,300,199,44,56,3,16684,1
41,"Vrancea",176212,396,176212,,"GAROAFA",194,"GAROAFA   SCOALA I-VIII",1458,739,731,8,0,725,14,1600,861,406,319,3,16690,0
41,"Vrancea",176212,396,176212,,"GAROAFA",195,"BIZIGHESTI SCOALA  CLASE I-IV",546,299,290,9,0,296,3,600,301,129,167,3,16690,0
41,"Vrancea",176212,396,176212,,"GAROAFA",196,"DOAGA SCOALA CLASE I-IV",412,248,240,8,0,240,8,500,252,111,129,3,16690,0
41,"Vrancea",176212,396,176212,,"GAROAFA",197,"CIUSLEA SCOALA CLASE I-VIII",1287,628,621,7,0,622,6,1400,772,317,305,3,16690,0
41,"Vrancea",176212,396,176212,,"GAROAFA",198,"SALA DE SEDINTE A PRIMARIEI GAROAFA SPECIALA",0,168,0,168,0,166,2,400,232,90,76,3,16690,1
41,"Vrancea",174824,396,174824,,"GOLESTI",199,"GOLESTI   SCOALA GENERALA STR. COTESTI",1398,737,733,4,0,724,13,1501,764,341,383,3,16699,0
41,"Vrancea",174824,396,174824,,"GOLESTI",200,"GOLESTI   CAMIN CULTURAL STR. SOSEAUA NATIONALA",1479,754,747,7,0,745,9,1601,847,335,410,3,16699,0
41,"Vrancea",174824,396,174824,,"GOLESTI CEARDAC",201,"GRADINITA GOLESTI SALA 1 STR.SOSEAUA NATIONALA",442,254,250,4,0,248,6,501,247,123,125,3,16699,0
41,"Vrancea",174824,396,174824,,"GOLESTI",202,"GRADINITA  STR.SOSEAUA NATRIONALA SPECIALA",0,122,0,122,0,122,0,301,179,59,63,3,16699,1
41,"Vrancea",178938,396,178938,,"GOLOGANU",203,"GOLOGANU SCOALA I-VIII CLASA A IV A",1489,895,863,8,24,874,21,1600,705,259,615,3,16702,0
41,"Vrancea",178938,396,178938,,"GOLOGANU",204,"GOLOGANU GRADINITA",1218,689,648,14,27,679,10,1300,611,198,481,3,16702,0
41,"Vrancea",178938,396,178938,,"GOLOGANU",205,"SCOALA CU CLS. I-VIII GOLOGANU SPECIALA",0,59,0,59,0,59,0,200,141,21,38,3,16702,1
41,"Vrancea",176301,396,176301,,"GUGESTI",206,"GUGESTI SCOALA  GENERALA NR.2",1565,887,860,8,19,878,9,1700,813,411,467,3,16704,0
41,"Vrancea",176301,396,176301,,"GUGESTI",207,"GUGESTI  GRADINITA NR.3 POIANA GUGESTI",905,480,465,9,6,469,11,1000,520,205,264,3,16704,0
41,"Vrancea",176301,396,176301,,"GUGESTI",208,"GUGESTI   CAMIN CULTURAL",1613,828,800,9,19,813,15,1801,973,315,498,3,16704,0
41,"Vrancea",176301,396,176301,,"GUGESTI",209,"SCOALA DE ARTE SI MESERII ALEXANDRU VLAHUTA GUGESTI",932,501,490,7,4,495,6,1000,499,214,281,3,16704,0
41,"Vrancea",176301,396,176301,,"GUGESTI",210,"OREAVU SCOALA NR.4",460,253,242,10,1,247,6,500,247,106,141,3,16704,0
41,"Vrancea",176301,396,176301,,"GUGESTI",211,"PRIMARIA  COMUNEI GUGESTI  B-DUL MIHAIL KOGALNICEANU NR.71  SPECIALA",0,141,0,141,0,139,2,300,159,72,67,3,16704,1
41,"Vrancea",176338,396,176338,,"GURA CALITEI",212,"GURA CALITEI SCOALA CU CLS I-VIII SALA DE CLASA",907,416,412,4,0,411,5,1000,584,184,227,3,16707,0
41,"Vrancea",176338,396,176338,,"GURA CALITEI",213,"LACU LUI BABAN SCOALA I-VIII SALA DE CLASA NR.2",441,230,216,14,0,226,4,500,270,84,142,3,16707,0
41,"Vrancea",176338,396,176338,,"GURA CALITEI",214,"POIENILE SCOALA I-IV SALA DE CLASA",359,195,186,9,0,195,0,400,205,77,118,3,16707,0
41,"Vrancea",176338,396,176338,,"GURA CALITEI",215,"PLOPU SCOALA I-IV",316,164,156,8,0,163,1,400,236,60,103,3,16707,0
41,"Vrancea",176338,396,176338,,"GURA CALITEI",216,"DEALU LUNG SCOALA I-VIII",387,193,184,9,0,191,2,501,308,101,90,3,16707,0
41,"Vrancea",176338,396,176338,,"GURA CALITEI",217,"SCOALA CU CLS I-VIII DIN SATUL LACUL LUI BABAN  SPECIALA",0,44,0,44,0,43,1,201,157,24,19,3,16707,1
41,"Vrancea",176445,396,176445,,"HOMOCEA",218,"HOMOCEA SCOALA GENERALA",1350,476,476,0,0,469,7,1500,1024,158,311,3,16718,0
41,"Vrancea",176445,396,176445,,"HOMOCEA",219,"HOMOCEA SCOALA GENERALA CORP NOU CONSTRUIT",1453,526,517,9,0,514,12,1600,1074,201,313,3,16718,0
41,"Vrancea",176445,396,176445,,"HOMOCEA",220,"CAMINUL CULTURAL GEORGE ENESCU",1164,467,454,13,0,458,9,1300,833,213,245,3,16718,0
41,"Vrancea",176445,396,176445,,"HOMOCEA",221,"LESPEZI CAMINUL CULTURAL CIPRIAN PORUMBESCU",1016,449,443,6,0,438,11,1085,636,192,246,3,16718,0
41,"Vrancea",176445,396,176445,,"HOMOCEA",222,"COSTISA SCOALA GENERALA",280,149,140,9,0,149,0,300,151,57,92,3,16718,0
41,"Vrancea",176445,396,176445,,"HOMOCEA",223,"CAMINUL CULTURAL HOMOCEA STR.STEFAN CEL MARE NR.30 SPECIALA",0,66,0,66,0,65,1,300,234,32,33,3,16718,1
41,"Vrancea",176506,396,176506,,"JARISTEA",224,"JARISTEA CAMIN CULTURAL SALA MARE DE LA PARTER",1730,890,833,57,0,871,19,1900,1010,363,508,3,16722,0
41,"Vrancea",176506,396,176506,,"JARISTEA",225,"PADURENI SCOALA GENERALA",410,245,224,21,0,241,4,503,258,67,174,3,16722,0
41,"Vrancea",176506,396,176506,,"JARISTEA",226,"SCANTEIA SCOALA GENERALA",190,125,119,6,0,123,2,192,67,50,73,3,16722,0
41,"Vrancea",176506,396,176506,,"JARISTEA",227,"VARSATURA SCOALA GENERALA",460,282,266,16,0,276,6,500,218,135,141,3,16722,0
41,"Vrancea",176506,396,176506,,"JARISTEA",228,"MARGINEA SCOALA GENERALA",589,386,331,55,0,382,4,700,314,148,234,3,16722,0
41,"Vrancea",176506,396,176506,,"JARISTEA",229,"CAMINUL CULTURAL JARISTEA SPECIALA",0,185,0,185,0,184,1,303,118,98,86,3,16722,1
41,"Vrancea",176551,396,176551,,"JITIA",230,"JITIA  SCOALA CU CLASELE  I-VIII",1048,644,624,1,19,638,6,1200,556,328,310,3,16727,0
41,"Vrancea",176551,396,176551,,"JITIA",231,"JITIA  DE JOS SCOALA GENERAL CU CLS I-IV NR.1",343,210,205,5,0,201,9,400,190,79,122,3,16727,0
41,"Vrancea",176551,396,176551,,"JITIA",232,"SCOALA CU CLS I-VIII  JITIA SPECIALA",0,53,0,53,0,53,0,199,146,25,28,3,16727,1
41,"Vrancea",176613,396,176613,,"MAICANESTI",233,"MAICANESTI  SCOALA GENERALA",1194,658,641,17,0,641,17,1300,642,270,371,3,16733,0
41,"Vrancea",176613,396,176613,,"MAICANESTI",234,"TATARU SCOALA GENERALA",710,407,397,10,0,401,6,800,393,97,304,3,16733,0
41,"Vrancea",176613,396,176613,,"MAICANESTI",235,"RAMNICENI SCOALA GENERALA",1518,879,846,13,20,858,21,1601,722,296,562,3,16733,0
41,"Vrancea",176613,396,176613,,"MAICANESTI",236,"SLOBOZIA BOTESTI SCOALA GENERALA",323,187,173,14,0,183,4,400,213,41,142,3,16733,0
41,"Vrancea",176613,396,176613,,"MAICANESTI",237,"SATU-NOU SCOALA GENERALA",191,130,111,19,0,126,4,200,70,47,79,3,16733,0
41,"Vrancea",176613,396,176613,,"MAICANESTI",238,"STUPINA SCOALA GENERALA",347,237,226,11,0,235,2,400,163,94,141,3,16733,0
41,"Vrancea",176613,396,176613,,"MAICANESTI",239,"CAMIN CULTURAL MAICANESTI SPACIALA",0,143,0,143,0,141,2,302,159,53,88,3,16733,1
41,"Vrancea",176686,396,176686,,"MERA",240,"MERA CAMINUL CULTURAL SALA MARE",1282,600,583,17,0,589,11,1400,800,332,257,3,16740,0
41,"Vrancea",176686,396,176686,,"MERA",241,"ROSIOARA SCOALA",418,209,200,9,0,203,6,501,292,99,104,3,16740,0
41,"Vrancea",176686,396,176686,,"MERA",242,"VULCANEASA SCOALA GENERALA",844,453,438,15,0,445,8,900,447,211,234,3,16740,0
41,"Vrancea",176686,396,176686,,"MERA",243,"SCOALA LIVADA",634,284,266,18,0,279,5,700,416,131,148,3,16740,0
41,"Vrancea",176686,396,176686,,"MERA",244,"CAMIN CULTURAL MERA SALA MICA SPACIALA",0,58,0,58,0,58,0,300,242,32,26,3,16740,1
41,"Vrancea",176748,396,176748,,"MILCOVUL",245,"MILCOVUL GRADINITA DE COPII",1124,688,683,2,3,681,7,1200,512,353,328,3,16746,0
41,"Vrancea",176748,396,176748,,"MILCOVUL",246,"MILCOVUL SCOALA GENERALA",1139,675,667,3,5,660,15,1300,625,294,366,3,16746,0
41,"Vrancea",176748,396,176748,,"MILCOVUL",247,"LAMOTESTI SCOALA  GENERALA",781,493,472,12,9,485,8,900,407,243,242,3,16746,0
41,"Vrancea",176748,396,176748,,"MILCOVUL",248,"PRIMARIA  MILCOVUL SPECIALA",0,119,0,119,0,117,2,300,181,72,45,3,16746,1
41,"Vrancea",176793,396,176793,,"MOVILITA",249,"DIOCHETI- REDIU SCOALA GENERALA",619,361,356,5,0,356,5,700,339,176,180,3,16749,0
41,"Vrancea",176793,396,176793,,"MOVILITA",250,"SPERIETI    SCOALA GENERALA",394,190,181,9,0,190,0,497,307,93,97,3,16749,0
41,"Vrancea",176793,396,176793,,"MOVILITA",251,"MOVILITA    SCOALA GENERALA NR.2",696,304,299,5,0,298,6,798,494,127,171,3,16749,0
41,"Vrancea",176793,396,176793,,"MOVILITA",252,"MOVILITA    SCOALA GENERALA NR.1",773,340,328,11,1,335,5,900,560,176,159,3,16749,0
41,"Vrancea",176793,396,176793,,"MOVILITA",253,"TROTUSANU SCOALA GENERALA",380,180,175,5,0,177,3,395,215,69,108,3,16749,0
41,"Vrancea",176793,396,176793,,"MOVILITA",254,"FRECATEI SCOALA GENERALA",393,180,170,10,0,173,7,500,320,83,90,3,16749,0
41,"Vrancea",176793,396,176793,,"MOVILITA",255,"GRADINITA  CENTRU SAT MOVILITA SPECIALA",0,97,0,97,0,95,2,300,203,50,45,3,16749,1
41,"Vrancea",176855,396,176855,,"NANESTI",256,"NANESTI   CAMINUL CULTURAL",1154,686,645,2,39,672,14,1299,613,309,363,3,16755,0
41,"Vrancea",176855,396,176855,,"NANESTI",257,"CALIENII VECHI CAMINUL CULTURAL",685,407,372,8,27,398,9,800,393,97,301,3,16755,0
41,"Vrancea",176855,396,176855,,"NANESTI",258,"CALIENII NOI SCOALA  CU CLS.I-IV",319,195,185,5,5,191,4,400,205,53,138,3,16755,0
41,"Vrancea",176855,396,176855,,"NANESTI",259,"PRIMARIA  NANESTI SPECIALA",0,125,0,125,0,120,5,300,175,36,84,3,16755,1
41,"Vrancea",176891,396,176891,,"NARUJA",260,"NARUJA CAMINUL CULTURAL SALA MARE",1037,577,564,7,6,568,9,1110,533,190,378,3,16759,0
41,"Vrancea",176891,396,176891,,"NARUJA",261,"PODUL NARUJII SCOALA  GENERALA  CU CLS.I-IV",499,283,268,14,1,277,6,588,305,92,185,3,16759,0
41,"Vrancea",176891,396,176891,,"NARUJA",262,"CAMIN CULTURAL  NARUJA SPECIALA",0,72,0,72,0,71,1,204,132,28,43,3,16759,1
41,"Vrancea",178885,396,178885,,"NEGRILESTI",263,"NEGRILESTI SALA DE FESTIVITATI SI ACTIVITATI SPORTIVE, ZONA A(STANGA DE LA INTRARE)",1523,794,750,4,40,780,14,1700,906,215,565,3,16764,0
41,"Vrancea",178885,396,178885,,"NEGRILESTI",264,"SALA DE FESTIVITATI SI ACTIVITATI SPORTIVE  ZONA B, DREAPTA LA INTRARE SPECIALA",0,31,0,31,0,31,0,204,173,12,19,3,16764,1
41,"Vrancea",176944,396,176944,,"NEREJU",265,"NEREJU SALA SPORTURILOR, SALA MARE",1433,1051,1038,13,0,1045,6,1499,448,158,887,3,16766,0
41,"Vrancea",176944,396,176944,,"NEREJU",266,"NEREJU MIC  SCOALA GENERALA",1842,1273,1240,33,0,1269,4,1809,536,359,910,3,16766,0
41,"Vrancea",176944,396,176944,,"NEREJU",267,"SALA SPORTURILOR  NEREJU SALA MICA SPECIALA",0,64,0,64,0,63,1,200,136,22,41,3,16766,1
41,"Vrancea",177003,396,177003,,"NISTORESTI",268,"NISTORESTI CAMIN CULTURAL",981,544,477,3,64,527,17,1000,456,110,417,3,16772,0
41,"Vrancea",177003,396,177003,,"NISTORESTI",269,"VETRESTI - HERASTRAU CAMINUL CULTURAL",874,498,438,6,54,485,13,1000,502,131,354,3,16772,0
41,"Vrancea",177003,396,177003,,"NISTORESTI",270,"SEDIUL VECHI AL PRIMARIEI  NISTORESTI SPECIALA",0,44,0,44,0,43,1,200,156,20,23,3,16772,1
41,"Vrancea",178947,396,178947,,"OBREJITA",271,"OBREJITA SCOALA GENERALA  CU CLS.I-VIII, SALA 5, LABORATORUL DE CHIMIE",1261,867,808,24,35,844,23,1397,530,294,550,3,16782,0
41,"Vrancea",178947,396,178947,,"OBREJITA",272,"SCOALA GENERALA CU CLS I-VIII  OBREJITA SPECIALA",0,103,0,103,0,103,0,196,93,45,58,3,16782,1
41,"Vrancea",177101,396,177101,,"PALTIN",273,"PALTIN  SALA CLUB - PARTER PRIMARIA PALTIN",1151,628,612,16,0,622,6,1300,672,190,432,3,16784,0
41,"Vrancea",177101,396,177101,,"PALTIN",274,"PRAHUDA CAMIN CULTURAL - SALA MICA",560,331,318,13,0,324,7,600,269,116,208,3,16784,0
41,"Vrancea",177101,396,177101,,"PALTIN",275,"PRIMARIA  PALTIN SPECIALA",0,59,0,59,0,59,0,204,145,24,35,3,16784,1
41,"Vrancea",178910,396,178910,,"PAULESTI",276,"PAULESTI  SALA DE FESTIVITATI CAMIN CULTURAL",709,404,391,6,7,403,1,800,396,123,280,3,16790,0
41,"Vrancea",178910,396,178910,,"PAULESTI",277,"FUNDATURA SCOALA GENERALA",412,246,227,14,5,245,1,500,254,74,171,3,16790,0
41,"Vrancea",178910,396,178910,,"PAULESTI",278,"HAULISCA CAMIN CULTURAL",640,385,371,8,6,378,7,700,315,75,303,3,16790,0
41,"Vrancea",178910,396,178910,,"PAULESTI",279,"CAMIN CULTURAL ET.1 BIROU NR.3   PAULESTI SPECIALA",0,34,0,34,0,34,0,200,166,14,20,3,16790,1
41,"Vrancea",177236,396,177236,,"PAUNESTI",280,"SURLEA SCOALA NR.4",1217,501,449,52,0,487,14,1300,799,310,177,3,16793,0
41,"Vrancea",177236,396,177236,,"PAUNESTI",281,"NOVACESTI SCOALA NR.3",1453,665,626,39,0,653,12,1601,936,471,182,3,16793,0
41,"Vrancea",177236,396,177236,,"PAUNESTI",282,"BOSTANESTI SCOALA NR.2",1013,450,408,42,0,442,8,1100,650,268,174,3,16793,0
41,"Vrancea",177236,396,177236,,"PAUNESTI",283,"VIISOARA SCOALA GENERALA",820,360,351,9,0,351,9,900,540,222,129,3,16793,0
41,"Vrancea",177236,396,177236,,"PAUNESTI",284,"PAUNESTI CAMIN CULTURAL",979,442,402,40,0,432,10,1101,659,260,172,3,16793,0
41,"Vrancea",177236,396,177236,,"PAUNESTI",285,"SEDIUL VECHII PRIMARII  SAT PAUNESTI SPECIALA",0,99,0,99,0,99,0,301,202,59,40,3,16793,1
41,"Vrancea",178894,396,178894,,"PLOSCUTENI",286,"PLOSCUTENI  SCOALA GENERALA NR.1 (CORP A)",997,471,441,0,30,463,8,1100,629,173,290,3,16796,0
41,"Vrancea",178894,396,178894,,"PLOSCUTENI",287,"PLOSCUTENI  SCOALA GENERALA NR.1 (CORP B)",1116,554,509,2,43,545,9,1200,646,137,408,3,16796,0
41,"Vrancea",178894,396,178894,,"PLOSCUTENI",288,"ARGEA SCOALA PRIMARA",268,212,205,7,0,208,4,300,88,44,164,3,16796,0
41,"Vrancea",178894,396,178894,,"PLOSCUTENI",289,"SCOALA GENERALA CU CLS I-VIII  PLOSCUTENI SPECIALA",0,69,0,69,0,68,1,200,131,31,37,3,16796,1
41,"Vrancea",177263,396,177263,,"POIANA CRISTEI",290,"POIANA CRISTEI CAMIN CULTURAL",986,634,626,8,0,624,10,1100,466,361,263,3,16799,0
41,"Vrancea",177263,396,177263,,"POIANA CRISTEI",291,"PODU LACULUI SCOALA CU CLASELE I-IV",586,360,353,7,0,350,10,700,340,192,158,3,16799,0
41,"Vrancea",177263,396,177263,,"POIANA CRISTEI",292,"MAHRIU SCOALA  CU CLS.I-IV",316,231,228,3,0,227,4,403,172,172,55,3,16799,0
41,"Vrancea",177263,396,177263,,"POIANA CRISTEI",293,"PETREANU SCOALA I-IV",146,94,88,6,0,94,0,201,107,69,25,3,16799,0
41,"Vrancea",177263,396,177263,,"POIANA CRISTEI",294,"TIRITU SCOALA CU CLS I-VIII",220,128,122,6,0,128,0,302,174,77,51,3,16799,0
41,"Vrancea",177263,396,177263,,"POIANA CRISTEI",295,"SCOALA GENERALA CU CLS I-IV  POIANA CRISTEI SPECIALA",0,70,0,70,0,70,0,200,130,45,25,3,16799,1
41,"Vrancea",178901,396,178901,,"POPESTI",296,"POPESTI SCOALA CU CLASELE  V-VIII",1830,954,944,6,4,934,20,2000,1046,425,509,3,16808,0
41,"Vrancea",178901,396,178901,,"POPESTI",297,"RUNCU  FOSTA GRADINITA RUNCU",283,134,121,13,0,132,2,300,166,53,79,3,16808,0
41,"Vrancea",178901,396,178901,,"POPESTI",298,"TERCHESTI SCOALA I-IV",397,199,190,9,0,196,3,500,301,61,135,3,16808,0
41,"Vrancea",178901,396,178901,,"POPESTI",299,"SALA DE SEDINTE A PRIMARIEI POPESTI SPECIALA",0,129,0,129,0,128,1,298,169,53,75,3,16808,1
41,"Vrancea",177352,396,177352,,"PUFESTI",300,"PUFESTI SCOALA CU CLASELE  V-VIII",1297,736,718,18,0,724,12,1400,664,438,286,3,16811,0
41,"Vrancea",177352,396,177352,,"PUFESTI",301,"CIORANI SCOALA CU CLASELE I-IV",856,531,520,8,3,525,6,1000,469,270,255,3,16811,0
41,"Vrancea",177352,396,177352,,"PUFESTI",302,"DOMNESTI SCOALA CU CLASELE I-VIII DOMNESTI TARG (SATU NOU)",1159,692,690,2,0,682,10,1300,608,348,334,3,16811,0
41,"Vrancea",177352,396,177352,,"PUFESTI",303,"SCOALA GENERALA CU CLS I-VIII  PUFESTI SPECIALA",0,150,0,150,0,150,0,300,150,66,84,3,16811,1
41,"Vrancea",177405,396,177405,,"RACOASA",304,"GOGOIU SCOALA GENERALA",177,99,92,6,1,98,1,200,101,43,55,3,16816,0
41,"Vrancea",177405,396,177405,,"RACOASA",305,"MARASTI SCOALA GENERALA",521,285,264,8,13,274,11,600,315,153,121,3,16816,0
41,"Vrancea",177405,396,177405,,"RACOASA",306,"RACOASA CAMINUL CULTURAL",951,531,495,24,12,524,7,1000,469,276,248,3,16816,0
41,"Vrancea",177405,396,177405,,"RACOASA",307,"VARNITA SCOALA GENERALA SALA NR.1",462,317,309,5,3,313,4,500,183,55,258,3,16816,0
41,"Vrancea",177405,396,177405,,"RACOASA",308,"VERDEA  SCOALA GENERALA",646,363,346,8,9,358,5,700,337,193,165,3,16816,0
41,"Vrancea",177405,396,177405,,"RACOASA",309,"SCOALA VARNITA SPECIALA",0,112,0,112,0,111,1,300,188,73,38,3,16816,1
41,"Vrancea",178956,396,178956,,"RASTOACA",310,"RASTOACA SCOALA GENERALA CU CLASELE I-VIII - SALA 1",1273,693,665,8,20,681,12,1400,707,224,457,3,16822,0
41,"Vrancea",178956,396,178956,,"RASTOACA",311,"RASTOACA SCOALA GENERALA CU CLASELE I-VIII - SALA 2",844,491,468,8,15,473,18,900,409,155,318,3,16822,0
41,"Vrancea",178956,396,178956,,"RASTOACA",312,"SCOALA GENERALA CU CLS I-VIII  RASTOACA DN 23 KM 7 SPECIALA",0,84,0,84,0,84,0,200,116,35,49,3,16822,1
41,"Vrancea",177469,396,177469,,"REGHIU",313,"SINDRILARI SCOALA DE ARTE SI MESERII NR.1",1218,700,693,7,0,690,10,1300,600,368,322,3,16824,0
41,"Vrancea",177469,396,177469,,"REGHIU",314,"REGHIU SCOALA I-IV",417,244,234,10,0,237,7,500,256,132,105,3,16824,0
41,"Vrancea",177469,396,177469,,"REGHIU",315,"RAIUTI SCOALA I-IV",360,234,223,11,0,231,3,400,166,153,78,3,16824,0
41,"Vrancea",177469,396,177469,,"REGHIU",316,"GRADINITA  REGHIU, SAT SINDRILARI SPECIALA",0,71,0,71,0,68,3,300,229,31,37,3,16824,1
41,"Vrancea",177557,396,177557,,"RUGINESTI",317,"RUGINESTI  SCOALA  GENERALA",1601,832,825,5,2,813,19,1800,968,449,364,3,16833,0
41,"Vrancea",177557,396,177557,,"RUGINESTI",318,"ANGHELESTI  SCOALA GENERALA",972,521,513,8,0,510,11,1100,579,282,228,3,16833,0
41,"Vrancea",177557,396,177557,,"RUGINESTI",319,"COPACESTI SCOALA GENERALA",620,323,316,7,0,311,12,700,377,147,164,3,16833,0
41,"Vrancea",177557,396,177557,,"RUGINESTI",320,"VALENI SCOALA GENERALA",260,128,119,9,0,123,5,300,172,62,61,3,16833,0
41,"Vrancea",177557,396,177557,,"RUGINESTI",321,"CAMIN CULTURAL RUGINESTI SPECIALA",0,133,0,133,0,133,0,300,167,68,65,3,16833,1
41,"Vrancea",177600,396,177600,,"SIHLEA",322,"SIHLEA PRIMARIA",1913,1006,998,8,0,988,18,2100,1094,374,614,3,16838,0
41,"Vrancea",177600,396,177600,,"SIHLEA",323,"CAIATA SCOALA GENERALA",561,292,284,8,0,288,4,600,308,119,169,3,16838,0
41,"Vrancea",177600,396,177600,,"SIHLEA",324,"BOGZA  GRADINITA",808,379,357,22,0,370,9,898,519,123,247,3,16838,0
41,"Vrancea",177600,396,177600,,"SIHLEA",325,"VOETIN SCOALA GENERALA",951,444,435,9,0,431,13,1000,556,141,290,3,16838,0
41,"Vrancea",177600,396,177600,,"SIHLEA",326,"GRADINITA  SIHLEA STR.AL.SIHLEANU NR.1 SPECIALA",0,116,0,116,0,115,1,300,184,47,68,3,16838,1
41,"Vrancea",177655,396,177655,,"SLOBOZIA BRADULUI",327,"SLOBOZIA BRADULUI  SCOALA (SALA A)",1034,504,465,21,18,493,11,1197,693,169,324,3,16843,0
41,"Vrancea",177655,396,177655,,"SLOBOZIA BRADULUI",328,"SCOALA SLOBOZIA BRADULUI (SALA B)",569,259,242,16,1,248,11,603,344,81,167,3,16843,0
41,"Vrancea",177655,396,177655,,"SLOBOZIA BRADULUI",329,"COROTENI SCOALA",761,495,464,4,27,489,6,800,305,193,296,3,16843,0
41,"Vrancea",177655,396,177655,,"SLOBOZIA BRADULUI",330,"CORNETU SCOALA (SALA A)",1221,727,716,8,3,692,35,1300,573,228,464,3,16843,0
41,"Vrancea",177655,396,177655,,"SLOBOZIA BRADULUI",331,"SCOALA CU CLS I-VIII  SLOBOZIZ BRADULUI ETAJ 1 SPECIALA",0,102,0,102,0,102,0,302,200,43,59,3,16843,1
41,"Vrancea",177726,396,177726,,"SLOBOZIA CIORASTI",332,"SLOBOZIA CIORASTI  GRADINITA SALA DE CLASA PARTER",1172,727,650,12,65,715,12,1300,573,170,545,3,16850,0
41,"Vrancea",177726,396,177726,,"SLOBOZIA CIORASTI",333,"JILISTE SCOALA CU CLS I-IV",562,348,324,10,14,338,10,600,252,91,247,3,16850,0
41,"Vrancea",177726,396,177726,,"SLOBOZIA CIORASTI",334,"SLOBOZIA CIORASTI  GRADINITA  SPECIALA",0,109,0,109,0,107,2,300,191,39,68,3,16850,1
41,"Vrancea",177762,396,177762,,"SOVEJA",335,"DRAGOSLOVENI SCOALA GENERALA NR.1 SIMION MEHEDINTI",1253,698,695,3,0,683,15,1400,702,273,410,3,16854,0
41,"Vrancea",177762,396,177762,,"SOVEJA",336,"RUCARENI SCOALA GENERALA NR.2",985,543,533,10,0,531,12,1093,550,269,262,3,16854,0
41,"Vrancea",177762,396,177762,,"SOVEJA",337,"SCOALA GENERALA NR.1 DRAGOSLOVENI SPECIALA",0,93,0,93,0,91,2,303,210,39,52,3,16854,1
41,"Vrancea",178965,396,178965,,"SPULBER",338,"SPULBER CAMIN CULTURAL",1031,623,621,2,0,610,13,1100,477,157,453,3,16857,0
41,"Vrancea",178965,396,178965,,"SPULBER",339,"PRIMARIA  SPULBER SPECIALA",0,28,0,28,0,28,0,200,172,8,20,3,16857,1
41,"Vrancea",177799,396,177799,,"STRAOANE",340,"STRAOANE DE JOS CAMIN CULTURAL SALA MARE",1234,661,653,8,0,651,10,1300,639,254,397,3,16865,0
41,"Vrancea",177799,396,177799,,"STRAOANE",341,"STRAOANE DE SUS CAMIN CULTURAL",833,435,429,6,0,422,13,900,465,218,204,3,16865,0
41,"Vrancea",177799,396,177799,,"STRAOANE",342,"REPEDEA SCOALA GENERALA",308,161,150,11,0,160,1,400,239,54,106,3,16865,0
41,"Vrancea",177799,396,177799,,"STRAOANE",343,"MUNCELU CAMIN CULTURAL",817,475,466,9,0,467,8,900,425,145,322,3,16865,0
41,"Vrancea",177799,396,177799,,"STRAOANE",344,"CAMIN CULTURAL STRAOANE DE JOS SPECIALA",0,123,0,123,0,120,3,300,177,48,72,3,16865,1
41,"Vrancea",177842,396,177842,,"SURAIA",345,"SURAIA SCOALA GENERALA CENTRU STEFAN CEL MARE SI SFANT SALA A",1781,852,762,90,0,840,12,1900,1048,521,319,3,16870,0
41,"Vrancea",177842,396,177842,,"SURAIA",346,"SURAIA-DIMACI  SCOALA GEN NR.2",1529,692,622,70,0,683,9,1700,1008,435,248,3,16870,0
41,"Vrancea",177842,396,177842,,"SURAIA",347,"SURAIA SCOALA VECHE",1664,710,670,40,0,703,7,1800,1090,430,273,3,16870,0
41,"Vrancea",177842,396,177842,,"SURAIA",348,"SURAIA SCOALA  STEFAN CEL MARE SI SFANT SPECIALA",0,105,0,105,0,102,3,300,195,63,39,3,16870,1
41,"Vrancea",177879,396,177879,,"TANASOAIA",349,"TANASOAIA  CAMIN CULTURAL",791,478,454,7,17,466,12,900,422,162,304,3,16878,0
41,"Vrancea",177879,396,177879,,"TANASOAIA",350,"FELDIOARA SCOALA GENERALA",524,303,287,8,8,296,7,600,297,99,197,3,16878,0
41,"Vrancea",177879,396,177879,,"TANASOAIA",351,"COSTISA DE SUS SCOALA GENERALA",245,170,140,7,23,170,0,300,130,53,117,3,16878,0
41,"Vrancea",177879,396,177879,,"TANASOAIA",352,"VLADNICU DE SUS SCOALA GENERALA",224,158,141,12,5,153,5,300,142,35,118,3,16878,0
41,"Vrancea",177879,396,177879,,"TANASOAIA",353,"SCOALA DE ARTE SI MESERII  TANASOAIA SPECIALA",0,114,0,114,0,114,0,300,186,38,76,3,16878,1
41,"Vrancea",177986,396,177986,,"TATARANU",354,"TATARANU  SCOALA",1266,670,663,7,0,663,7,1414,744,351,312,3,16889,0
41,"Vrancea",177986,396,177986,,"TATARANU",355,"MARTINESTI SCOALA",613,334,323,11,0,331,3,700,366,149,182,3,16889,0
41,"Vrancea",177986,396,177986,,"TATARANU",356,"VIJIITOAREA SCOALA",225,161,150,11,0,157,4,300,139,90,67,3,16889,0
41,"Vrancea",177986,396,177986,,"TATARANU",357,"BORDEASCA VECHE 2 SCOALA",735,432,407,25,0,417,15,840,408,173,244,3,16889,0
41,"Vrancea",177986,396,177986,,"TATARANU",358,"BORDEASCA NOUA SCOALA GENERALA",413,234,223,11,0,222,12,503,269,84,138,3,16889,0
41,"Vrancea",177986,396,177986,,"TATARANU",359,"BORDEASCA VECHE 1 SCOALA",865,420,409,11,0,413,7,1000,580,162,251,3,16889,0
41,"Vrancea",177986,396,177986,,"TATARANU",360,"PRIMARIA  TATARANU SPECIALA",0,173,0,173,0,171,2,300,127,75,96,3,16889,1
41,"Vrancea",178046,396,178046,,"TAMBOESTI",361,"TAMBOESTI  PRIMARIA",1052,465,431,7,27,454,11,1200,735,140,314,3,16872,0
41,"Vrancea",178046,396,178046,,"TAMBOESTI",362,"SLIMNIC SCOALA GENERALA",1137,735,659,20,56,722,13,1200,465,189,533,3,16872,0
41,"Vrancea",178046,396,178046,,"TAMBOESTI",363,"TRESTIENI SCOALA GENERALA",132,109,94,8,7,107,2,200,91,33,74,3,16872,0
41,"Vrancea",178046,396,178046,,"TAMBOESTI",364,"CAMIN CULTURAL  TAMBOIESTI SPECIALA",0,120,0,120,0,117,3,302,182,35,82,3,16872,1
41,"Vrancea",178117,396,178117,,"TULNICI",365,"TULNICI  CASA OBSTEI TULNICI A",1131,635,612,2,21,625,10,1200,565,252,373,3,16904,0
41,"Vrancea",178117,396,178117,,"TULNICI",366,"TULNICI CASA OBSTEI TULNICI B",1086,611,585,3,23,602,9,1200,589,224,378,3,16904,0
41,"Vrancea",178117,396,178117,,"TULNICI",367,"COZA SCOALA",711,425,395,9,21,418,7,800,375,117,301,3,16904,0
41,"Vrancea",178117,396,178117,,"TULNICI",368,"SCOALA LEPSA SALA 1",330,223,216,6,1,218,5,400,177,95,123,3,16904,0
41,"Vrancea",178117,396,178117,,"TULNICI",369,"SCOALA LEPSA SPECIALA",0,200,0,200,0,199,1,500,300,110,89,3,16904,1
41,"Vrancea",178180,396,178180,,"TIFESTI",370,"TIFESTI SCOALA GENERALA",924,478,457,9,12,473,5,1000,522,281,192,3,16895,0
41,"Vrancea",178180,396,178180,,"TIFESTI",371,"BATINESTI SCOALA GENERALA",1294,668,650,15,3,660,8,1400,732,366,294,3,16895,0
41,"Vrancea",178180,396,178180,,"TIFESTI",372,"OLESESTI SCOALA GENERALA",744,430,418,6,6,425,5,800,370,222,203,3,16895,0
41,"Vrancea",178180,396,178180,,"TIFESTI",373,"SIRBI SCOALA GENERALA",660,359,341,7,11,358,1,700,341,164,194,3,16895,0
41,"Vrancea",178180,396,178180,,"TIFESTI",374,"CLIPICESTI SCOALA GENERALA",686,318,308,2,8,311,7,800,482,102,209,3,16895,0
41,"Vrancea",178180,396,178180,,"TIFESTI",375,"SCOALA CU CLS I-VIII  TIFESTI SPECIALA",0,160,0,160,0,158,2,300,140,96,62,3,16895,1
41,"Vrancea",178279,396,178279,,"URECHESTI",376,"CONSILIUL LOCAL  URECHESTI",1787,987,979,8,0,968,19,1900,913,483,485,3,16909,0
41,"Vrancea",178279,396,178279,,"URECHESTI",377,"SCOALA CU CLS. I-IV URECHESTI",430,278,270,8,0,275,3,500,222,137,138,3,16909,0
41,"Vrancea",178279,396,178279,,"URECHESTI",378,"SCOALA CU CLS I-IV NR.3 URECHESTI-TOHARCA  SAT TOHARCA SPECIALA",0,168,0,168,0,166,2,301,133,71,95,3,16909,1
41,"Vrancea",178313,396,178313,,"VALEA SARII",379,"VALEA SARII SCOALA GENERALA SALA 1",659,393,386,7,0,389,4,700,307,271,118,3,16911,0
41,"Vrancea",178313,396,178313,,"VALEA SARII",380,"COLACU SCOALA GENERALA",635,385,378,7,0,379,6,692,307,225,154,3,16911,0
41,"Vrancea",178313,396,178313,,"VALEA SARII",381,"PODURI CAMIN CULTURAL",289,178,170,8,0,177,1,292,114,123,54,3,16911,0
41,"Vrancea",178313,396,178313,,"VALEA SARII",382,"PRISACA SCOALA GENERALA",168,110,101,9,0,106,4,200,90,66,40,3,16911,0
41,"Vrancea",178313,396,178313,,"VALEA SARII",383,"SCOALA GENERALA  VALEA SARII SPECIALA",0,50,0,50,0,50,0,307,257,40,10,3,16911,1
41,"Vrancea",178377,396,178377,,"VIDRA",384,"VIDRA   SALA DE SPORT",1522,827,818,2,7,822,5,1700,873,394,428,3,16932,0
41,"Vrancea",178377,396,178377,,"VIDRA",385,"SCOALA GENERALA VOLOSCANI",309,182,175,5,2,177,5,404,222,80,97,3,16932,0
41,"Vrancea",178377,396,178377,,"VIDRA",386,"IRESTI SCOALA GENERALA",811,368,350,6,12,364,4,900,532,181,183,3,16932,0
41,"Vrancea",178377,396,178377,,"VIDRA",387,"SCOALA GENERALA SERBESTI",525,231,222,4,5,226,5,600,369,141,85,3,16932,0
41,"Vrancea",178377,396,178377,,"VIDRA",388,"BURCA1   SCOALA GENERALA BURCA1",673,353,337,10,6,342,11,800,447,143,199,3,16932,0
41,"Vrancea",178377,396,178377,,"VIDRA",389,"BURCA2  SCOALA GENERALA BURCA2",644,322,315,7,0,310,12,700,378,137,173,3,16932,0
41,"Vrancea",178377,396,178377,,"VIDRA",390,"SCOALA GENERALA SCAFARI",355,205,197,8,0,202,3,400,195,104,98,3,16932,0
41,"Vrancea",178377,396,178377,,"VIDRA",391,"TICHIRIS SCOALA GENERALA",681,362,350,6,6,351,11,800,438,161,190,3,16932,0
41,"Vrancea",178377,396,178377,,"VIDRA",392,"VIISOARA SCOALA GENERALA",636,312,305,7,0,303,9,700,388,117,186,3,16932,0
41,"Vrancea",178377,396,178377,,"VIDRA",393,"PRIMARIA  VIDRA SPECIALA",0,201,0,201,0,201,0,500,299,91,110,3,16932,1
41,"Vrancea",178475,396,178475,,"VINTILEASCA",394,"VINTILEASCA  SCOALA",646,393,371,10,12,387,6,700,307,175,212,3,16942,0
41,"Vrancea",178475,396,178475,,"VINTILEASCA",395,"NECULELE GRADINITA",381,211,204,6,1,209,2,500,289,69,140,3,16942,0
41,"Vrancea",178475,396,178475,,"VINTILEASCA",396,"BAHNELE SCOALA",488,274,255,11,8,270,4,611,337,132,138,3,16942,0
41,"Vrancea",178475,396,178475,,"VINTILEASCA",397,"DUPA MAGURA SCOALA",71,55,47,8,0,55,0,100,45,26,29,3,16942,0
41,"Vrancea",178475,396,178475,,"VINTILEASCA",398,"POIANA STOICHII SCOALA POIANA STOICHII",86,54,46,8,0,52,2,100,46,33,19,3,16942,0
41,"Vrancea",178475,396,178475,,"VINTILEASCA",399,"SCOALA DE ARTE SI MESERII VINTILEASACA, SAT VINTILEASCA SPECIALA",0,47,0,47,0,47,0,200,153,20,27,3,16942,1
41,"Vrancea",178545,396,178545,,"VIZANTEA-LIVEZI",400,"VIZANTEA RAZASEASCA SCOALA I-VIII CORP A",689,315,299,15,1,308,7,800,485,131,177,3,16949,0
41,"Vrancea",178545,396,178545,,"VIZANTEA-LIVEZI",401,"VIZANTEA MANASTIREASCA SCOALA",1463,586,562,14,10,580,6,1600,1014,148,432,3,16949,0
41,"Vrancea",178545,396,178545,,"VIZANTEA-LIVEZI",402,"PISCU RADULUI SCOALA",388,172,163,9,0,169,3,500,328,106,63,3,16949,0
41,"Vrancea",178545,396,178545,,"VIZANTEA-LIVEZI",403,"MESTEACANUL SCOALA",318,174,161,11,2,170,4,400,226,80,90,3,16949,0
41,"Vrancea",178545,396,178545,,"VIZANTEA-LIVEZI",404,"LIVEZILE SCOALA",602,320,302,13,5,316,4,700,380,151,165,3,16949,0
41,"Vrancea",178545,396,178545,,"VIZANTEA-LIVEZI",405,"SCOALA CU CLS I-VIII VIZANTEA RAZASEASCA SPECIALA",0,50,0,50,0,50,0,200,150,20,30,3,16949,1
41,"Vrancea",178607,396,178607,,"VANATORI",406,"VANATORI SCOALA GENERALA",901,487,481,6,0,480,7,1000,513,233,247,3,16917,0
41,"Vrancea",178607,396,178607,,"VANATORI",407,"JORASTI SCOALA GENERALA",1284,650,640,10,0,643,7,1400,750,362,281,3,16917,0
41,"Vrancea",178607,396,178607,,"VANATORI",408,"PETRESTI  SCOALA GENERALA",980,523,516,7,0,518,5,1100,577,272,246,3,16917,0
41,"Vrancea",178607,396,178607,,"VANATORI",409,"MIRCESTII NOI SCOALA GENERALA",730,386,379,7,0,377,9,801,415,183,194,3,16917,0
41,"Vrancea",178607,396,178607,,"VANATORI",410,"MIRCESTII VECHI DISPENSARUL UMAN",220,128,124,4,0,128,0,300,172,76,52,3,16917,0
41,"Vrancea",178607,396,178607,,"VANATORI",411,"BALTA RATEI SCOALA GENERALA",195,96,89,7,0,96,0,300,204,44,52,3,16917,0
41,"Vrancea",178607,396,178607,,"VANATORI",412,"RADULESTI SCOALA GENERALA",739,337,331,6,0,328,9,800,463,196,132,3,16917,0
41,"Vrancea",178607,396,178607,,"VANATORI",413,"SCOALA CU CLS I-VIII VANATORI, SAT VANATORI SPECIALA",0,221,0,221,0,221,0,400,179,161,60,3,16917,1
41,"Vrancea",178689,396,178689,,"VARTESCOIU",414,"VARTESCOIU  CAMIN CULTURAL",1447,728,714,14,0,711,17,1600,872,377,334,3,16925,0
41,"Vrancea",178689,396,178689,,"VARTESCOIU",415,"FARAOANE CAMIN CULTURAL",986,533,521,12,0,519,14,1100,567,145,374,3,16925,0
41,"Vrancea",178689,396,178689,,"VARTESCOIU",416,"BECIU SCOALA CU CLASELE I-IV",341,220,206,13,1,219,1,400,180,123,96,3,16925,0
41,"Vrancea",178689,396,178689,,"VARTESCOIU",417,"SCOALA OLTENI CU CLS I-IV  VARTESCOIU SPECIALA",0,103,0,103,0,102,1,300,197,60,42,3,16925,1
41,"Vrancea",178750,396,178750,,"VRANCIOAIA",418,"VRANCIOAIA  CAMIN CULTURAL",556,256,253,3,0,253,3,600,344,64,189,3,16955,0
41,"Vrancea",178750,396,178750,,"VRANCIOAIA",419,"POIANA CORP C PRIMARIE",626,335,324,11,0,333,2,698,363,158,175,3,16955,0
41,"Vrancea",178750,396,178750,,"VRANCIOAIA",420,"SPINESTI SEDIUL OBSTEI CHILIILE ZBOINEI",642,286,283,3,0,284,2,700,414,63,221,3,16955,0
41,"Vrancea",178750,396,178750,,"VRANCIOAIA",421,"MUNCEI SCOALA CU CLASELE I-IV",563,381,364,17,0,370,11,700,319,60,310,3,16955,0
41,"Vrancea",178750,396,178750,,"VRANCIOAIA",422,"SALA DE SEDINTE A CONSILIULUI LOCAL  VRANCIOAIA SPECIALA",0,45,0,45,0,45,0,200,155,16,29,3,16955,1
41,"Vrancea",178821,396,178821,,"VULTURU",423,"VULTURU SCOALA GENERALA",1136,461,456,5,0,454,7,1300,839,192,262,3,16962,0
41,"Vrancea",178821,396,178821,,"VULTURU",424,"VULTURU CAMINUL CULTURAL",1217,494,480,12,2,486,8,1300,806,187,299,3,16962,0
41,"Vrancea",178821,396,178821,,"VULTURU",425,"VULTURU GRADINITA NR.1",1245,489,471,16,2,485,4,1400,911,183,302,3,16962,0
41,"Vrancea",178821,396,178821,,"VULTURU",426,"BOTIRLAU SCOALA GENERALA",1108,459,442,17,0,449,10,1200,741,196,253,3,16962,0
41,"Vrancea",178821,396,178821,,"VULTURU",427,"HINGULESTI SCOALA GENERALA",1034,526,520,6,0,517,9,1100,574,156,361,3,16962,0
41,"Vrancea",178821,396,178821,,"VULTURU",428,"MALURI SCOALA",529,320,297,23,0,311,9,600,280,64,247,3,16962,0
41,"Vrancea",178821,396,178821,,"VULTURU",429,"VADU ROSCA SCOALA",919,340,336,4,0,332,8,1000,660,153,179,3,16962,0
41,"Vrancea",178821,396,178821,,"VULTURU",430,"PRIMARIA  VULTURU SPECIALA",0,135,0,135,0,135,0,300,165,72,63,3,16962,1
42,"Sectorul 1",179141,"#N/A",179141,,"BUCURESTI SECTORUL 1",1,"LICEUL TEORETIC ""N. IORGA"", DIN B-DUL.  MIHALACHE ION NR. 126",1422,893,876,17,0,873,20,1564,671,406,467,1,16970,0
42,"Sectorul 1",179141,"#N/A",179141,,"BUCURESTI SECTORUL 1",2,"LICEUL TEORETIC ""N. IORGA"", DIN B-DUL.  MIHALACHE ION NR. 126",1721,1092,1077,15,0,1080,12,1893,801,446,634,1,16970,0
42,"Sectorul 1",179141,"#N/A",179141,,"BUCURESTI SECTORUL 1",3,"LICEUL TEORETIC ""N. IORGA"", DIN B-DUL.  MIHALACHE ION NR. 126",948,593,579,14,0,581,12,1040,447,261,320,1,16970,0
42,"Sectorul 1",179141,"#N/A",179141,,"BUCURESTI SECTORUL 1",4,"LICEUL TEORETIC ""N. IORGA"", DIN B-DUL.  MIHALACHE ION NR. 126",1228,735,722,13,0,724,11,1351,616,320,404,1,16970,0
42,"Sectorul 1",179141,"#N/A",179141,,"BUCURESTI SECTORUL 1",5,"LICEUL GRECO-CATOLIC ""TIMOTEI CIPARIU"", DIN STR. BUCEGI  NR. 97",1677,1006,996,10,0,992,14,1845,839,486,506,1,16970,0
42,"Sectorul 1",179141,"#N/A",179141,,"BUCURESTI SECTORUL 1",6,"LICEUL GRECO-CATOLIC ""TIMOTEI CIPARIU"", DIN STR. BUCEGI  NR. 97",1003,584,566,18,0,578,6,1103,519,275,303,1,16970,0
42,"Sectorul 1",179141,"#N/A",179141,,"BUCURESTI SECTORUL 1",7,"LICEUL GRECO-CATOLIC ""TIMOTEI CIPARIU"", DIN STR. BUCEGI  NR. 97",1274,685,670,15,0,669,16,1401,716,366,303,1,16970,0
42,"Sectorul 1",179141,"#N/A",179141,,"BUCURESTI SECTORUL 1",8,"SCOALA NR. 13, DIN B-DUL.  PETRILA NR.10-12",894,490,485,5,0,479,11,983,493,250,229,1,16970,0
42,"Sectorul 1",179141,"#N/A",179141,,"BUCURESTI SECTORUL 1",9,"SCOALA NR. 13, DIN B-DUL.  PETRILA NR.10-12",889,493,483,10,0,486,7,989,496,299,187,1,16970,0
42,"Sectorul 1",179141,"#N/A",179141,,"BUCURESTI SECTORUL 1",10,"SCOALA NR. 179, DIN STR. ARDEALULUI NR.34",1406,747,734,13,0,743,4,1547,800,405,338,1,16970,0
42,"Sectorul 1",179141,"#N/A",179141,,"BUCURESTI SECTORUL 1",11,"SCOALA NR. 179, DIN STR. ARDEALULUI NR.34",1533,898,883,15,0,891,7,1686,788,450,441,1,16970,0
42,"Sectorul 1",179141,"#N/A",179141,,"BUCURESTI SECTORUL 1",12,"SCOALA NR. 179, DIN STR. ARDEALULUI NR.34",961,553,542,11,0,544,9,1057,504,248,296,1,16970,0
42,"Sectorul 1",179141,"#N/A",179141,,"BUCURESTI SECTORUL 1",13,"SCOALA NR. 179, DIN STR. ARDEALULUI NR.34",1402,823,810,13,0,811,12,1542,719,416,395,1,16970,0
42,"Sectorul 1",179141,"#N/A",179141,,"BUCURESTI SECTORUL 1",14,"LICEUL TEORETIC ""CONSTANTIN BRANCOVEANU"", DIN STR. PAJUREI NR. 9",1696,922,908,14,0,908,14,1866,944,458,450,1,16970,0
42,"Sectorul 1",179141,"#N/A",179141,,"BUCURESTI SECTORUL 1",15,"LICEUL TEORETIC ""CONSTANTIN BRANCOVEANU"", DIN STR. PAJUREI NR. 9",1027,585,571,14,0,581,4,1135,550,297,284,1,16970,0
42,"Sectorul 1",179141,"#N/A",179141,,"BUCURESTI SECTORUL 1",16,"LICEUL TEORETIC ""CONSTANTIN BRANCOVEANU"", DIN STR. PAJUREI NR. 9",999,536,516,19,1,522,14,1099,563,262,260,1,16970,0
42,"Sectorul 1",179141,"#N/A",179141,,"BUCURESTI SECTORUL 1",17,"LICEUL TEORETIC ""CONSTANTIN BRANCOVEANU"", DIN STR. PAJUREI NR. 9",1582,969,949,20,0,945,24,1740,771,415,530,1,16970,0
42,"Sectorul 1",179141,"#N/A",179141,,"BUCURESTI SECTORUL 1",18,"SCOALA NR. 178, DIN STR. DRIDU NR. 2",1498,849,830,19,0,835,14,1648,799,377,458,1,16970,0
42,"Sectorul 1",179141,"#N/A",179141,,"BUCURESTI SECTORUL 1",19,"SCOALA NR. 178, DIN STR. DRIDU NR. 2",1364,841,825,12,4,826,15,1500,659,389,437,1,16970,0
42,"Sectorul 1",179141,"#N/A",179141,,"BUCURESTI SECTORUL 1",20,"SCOALA NR. 178, DIN STR. DRIDU NR. 2",1083,689,680,9,0,672,17,1228,539,323,349,1,16970,0
42,"Sectorul 1",179141,"#N/A",179141,,"BUCURESTI SECTORUL 1",21,"SCOALA SPECIALA NR. 8, DIN STR. DAIMACA VICTOR NR. 2",804,572,560,12,0,561,11,1251,679,351,210,1,16970,0
42,"Sectorul 1",179141,"#N/A",179141,,"BUCURESTI SECTORUL 1",22,"SCOALA SPECIALA NR. 8, DIN STR. DAIMACA VICTOR NR. 2",1037,659,646,13,0,649,10,1141,482,330,319,1,16970,0
42,"Sectorul 1",179141,"#N/A",179141,,"BUCURESTI SECTORUL 1",23,"SCOALA SPECIALA NR. 8, DIN STR. DAIMACA VICTOR NR. 2",1159,613,594,19,0,602,11,1318,705,294,308,1,16970,0
42,"Sectorul 1",179141,"#N/A",179141,,"BUCURESTI SECTORUL 1",24,"SCOALA NR. 177  N. GRIGORESCU, DIN STR. CORALILOR NR. 1",1458,873,856,17,0,858,15,1604,731,457,401,1,16970,0
42,"Sectorul 1",179141,"#N/A",179141,,"BUCURESTI SECTORUL 1",25,"SCOALA NR. 177  N. GRIGORESCU, DIN STR. CORALILOR NR. 1",1514,885,869,15,1,873,12,1665,780,426,447,1,16970,0
42,"Sectorul 1",179141,"#N/A",179141,,"BUCURESTI SECTORUL 1",26,"CENTRUL SOCIAL SF. LAZAR, DIN B-DUL. APICULTORILOR NR. 3A",1133,666,645,21,0,655,11,1246,580,337,318,1,16970,0
42,"Sectorul 1",179141,"#N/A",179141,,"BUCURESTI SECTORUL 1",27,"CENTRUL SOCIAL SF. LAZAR, DIN B-DUL. APICULTORILOR NR. 3A",1393,949,835,114,0,936,13,1542,593,426,510,1,16970,0
42,"Sectorul 1",179141,"#N/A",179141,,"BUCURESTI SECTORUL 1",28,"SCOALA NR. 6, DIN STR. CONSTANTIN DOBROGEANU GHEREA NR. 74",903,518,506,12,0,510,8,993,475,258,252,1,16970,0
42,"Sectorul 1",179141,"#N/A",179141,,"BUCURESTI SECTORUL 1",29,"SCOALA NR. 6, DIN STR. CONSTANTIN DOBROGEANU GHEREA NR. 74",972,536,512,24,0,529,7,1003,467,281,248,1,16970,0
42,"Sectorul 1",179141,"#N/A",179141,,"BUCURESTI SECTORUL 1",30,"UNIVERSITATEA DE STIINTE AGONOMICE SI MEDICINA VETERINARA BUCURESTI, DIN B-DUL. MARASTI NR. 59",1335,768,730,35,3,751,17,1469,701,360,391,1,16970,0
42,"Sectorul 1",179141,"#N/A",179141,,"BUCURESTI SECTORUL 1",31,"UNIVERSITATEA DE STIINTE AGONOMICE SI MEDICINA VETERINARA BUCURESTI, DIN B-DUL. MARASTI NR. 59",1531,936,917,18,1,917,19,1684,748,407,510,1,16970,0
42,"Sectorul 1",179141,"#N/A",179141,,"BUCURESTI SECTORUL 1",32,"DIRECTIA GENERALA ASISTENTA SOCIALA, DIN B-DUL.  AVERESCU NR. 17",1192,770,753,16,1,755,15,1349,579,351,404,1,16970,0
42,"Sectorul 1",179141,"#N/A",179141,,"BUCURESTI SECTORUL 1",33,"SCOALA NR. 7, DIN STR. NEAGOE VODA NR. 11",1568,937,928,9,0,912,25,1725,788,471,441,1,16970,0
42,"Sectorul 1",179141,"#N/A",179141,,"BUCURESTI SECTORUL 1",34,"SCOALA NR. 7, DIN STR. NEAGOE VODA NR. 11",1542,919,895,23,1,911,8,1696,777,466,445,1,16970,0
42,"Sectorul 1",179141,"#N/A",179141,,"BUCURESTI SECTORUL 1",35,"SCOALA NR. 7, DIN STR. NEAGOE VODA NR. 11",1552,963,951,12,0,947,16,1707,744,518,429,1,16970,0
42,"Sectorul 1",179141,"#N/A",179141,,"BUCURESTI SECTORUL 1",36,"COLEGIUL AGRICOL ""VIECESLAV HARNAJ"", DIN B-DUL.  FICUSULUI NR. 18",1690,972,959,13,0,963,9,1857,885,461,502,1,16970,0
42,"Sectorul 1",179141,"#N/A",179141,,"BUCURESTI SECTORUL 1",37,"COLEGIUL AGRICOL ""VIECESLAV HARNAJ"", DIN B-DUL.  FICUSULUI NR. 18",1625,945,931,13,1,935,10,1788,843,446,489,1,16970,0
42,"Sectorul 1",179141,"#N/A",179141,,"BUCURESTI SECTORUL 1",38,"SCOALA NR. 12 HERASTRAU, DIN STR. BORSA NR. 27",1309,804,776,28,0,788,16,1440,636,355,433,1,16970,0
42,"Sectorul 1",179141,"#N/A",179141,,"BUCURESTI SECTORUL 1",39,"SCOALA NR. 12 HERASTRAU, DIN STR. BORSA NR. 27",991,600,592,8,0,582,18,1141,541,271,311,1,16970,0
42,"Sectorul 1",179141,"#N/A",179141,,"BUCURESTI SECTORUL 1",40,"SCOALA NR. 12 HERASTRAU, DIN STR. BORSA NR. 27",1459,906,892,14,0,886,20,1605,699,407,479,1,16970,0
42,"Sectorul 1",179141,"#N/A",179141,,"BUCURESTI SECTORUL 1",41,"SCOALA NR. 12 HERASTRAU, DIN STR. BORSA NR. 27",1253,768,760,8,0,750,18,1374,606,373,377,1,16970,0
42,"Sectorul 1",179141,"#N/A",179141,,"BUCURESTI SECTORUL 1",42,"SCOALA NR. 12 HERASTRAU, DIN STR. BORSA NR. 27",1617,957,947,9,1,932,25,1779,822,427,505,1,16970,0
42,"Sectorul 1",179141,"#N/A",179141,,"BUCURESTI SECTORUL 1",43,"SCOALA NR. 12 HERASTRAU, DIN STR. BORSA NR. 27",920,545,537,8,0,539,6,1012,467,258,281,1,16970,0
42,"Sectorul 1",179141,"#N/A",179141,,"BUCURESTI SECTORUL 1",44,"SCOALA NR. 12 HERASTRAU, DIN STR. BORSA NR. 27",1144,651,638,13,0,638,13,1256,605,305,333,1,16970,0
42,"Sectorul 1",179141,"#N/A",179141,,"BUCURESTI SECTORUL 1",45,"SCOALA NR. 12 HERASTRAU, DIN STR. BORSA NR. 27",1406,804,786,18,0,796,8,1547,743,404,392,1,16970,0
42,"Sectorul 1",179141,"#N/A",179141,,"BUCURESTI SECTORUL 1",46,"SCOALA NR. 12 HERASTRAU, DIN STR. BORSA NR. 27",1437,907,891,16,0,881,26,1581,674,435,446,1,16970,0
42,"Sectorul 1",179141,"#N/A",179141,,"BUCURESTI SECTORUL 1",47,"SCOALA NR. 12 HERASTRAU, DIN STR. BORSA NR. 27",1190,703,693,10,0,687,16,1288,585,365,322,1,16970,0
42,"Sectorul 1",179141,"#N/A",179141,,"BUCURESTI SECTORUL 1",48,"SCOALA NR. 12 HERASTRAU, DIN STR. BORSA NR. 27",1348,835,826,9,0,817,18,1483,648,366,451,1,16970,0
42,"Sectorul 1",179141,"#N/A",179141,,"BUCURESTI SECTORUL 1",49,"SCOALA NR. 12 HERASTRAU, DIN STR. BORSA NR. 27",1159,647,634,13,0,631,16,1258,611,311,320,1,16970,0
42,"Sectorul 1",179141,"#N/A",179141,,"BUCURESTI SECTORUL 1",50,"SCOALA NR. 17 ""PIA BRATIANU"", DIN STR. AL. PETOFI NR. 16",1343,846,828,18,0,832,14,1477,631,379,453,1,16970,0
42,"Sectorul 1",179141,"#N/A",179141,,"BUCURESTI SECTORUL 1",51,"SCOALA NR. 17 ""PIA BRATIANU"", DIN STR. AL. PETOFI NR. 16",1318,787,777,10,0,780,7,1450,663,337,443,1,16970,0
42,"Sectorul 1",179141,"#N/A",179141,,"BUCURESTI SECTORUL 1",52,"COLEGIUL NATIONAL DE INFORMATICA ""T.VIANU"", DIN STR. ARH. ION MINCU NR. 10",1369,881,868,12,1,866,15,1506,625,408,458,1,16970,0
42,"Sectorul 1",179141,"#N/A",179141,,"BUCURESTI SECTORUL 1",53,"COLEGIUL NATIONAL DE INFORMATICA ""T.VIANU"", DIN STR. ARH. ION MINCU NR. 10",1545,1048,1037,11,0,1025,23,1700,652,515,510,1,16970,0
42,"Sectorul 1",179141,"#N/A",179141,,"BUCURESTI SECTORUL 1",54,"COLEGIUL NATIONAL DE INFORMATICA ""T.VIANU"", DIN STR. ARH. ION MINCU NR. 10",1142,689,679,10,0,672,17,1254,565,325,347,1,16970,0
42,"Sectorul 1",179141,"#N/A",179141,,"BUCURESTI SECTORUL 1",55,"COLEGIUL NATIONAL ""I.L. CARAGIALE"", DIN CAL. DOROBANTILOR NR. 163",1228,706,695,11,0,691,15,1351,645,269,422,1,16970,0
42,"Sectorul 1",179141,"#N/A",179141,,"BUCURESTI SECTORUL 1",56,"COLEGIUL NATIONAL ""I.L. CARAGIALE"", DIN CAL. DOROBANTILOR NR. 163",1282,786,772,13,1,773,13,1410,624,330,443,1,16970,0
42,"Sectorul 1",179141,"#N/A",179141,,"BUCURESTI SECTORUL 1",57,"SCOALA NR. 45 ""TITU MAIORESCU"", DIN CAL. DOROBANTILOR NR. 163",1591,967,948,15,4,957,10,1750,783,399,558,1,16970,0
42,"Sectorul 1",179141,"#N/A",179141,,"BUCURESTI SECTORUL 1",58,"SCOALA NR. 45 ""TITU MAIORESCU"", DIN CAL. DOROBANTILOR NR. 163",1538,958,941,17,0,942,16,1692,734,435,507,1,16970,0
42,"Sectorul 1",179141,"#N/A",179141,,"BUCURESTI SECTORUL 1",59,"LICEUL TEORETIC ""JEAN MONNET"", DIN STR. JEAN MONNET NR. 2",1588,963,944,14,5,947,16,1745,782,342,605,1,16970,0
42,"Sectorul 1",179141,"#N/A",179141,,"BUCURESTI SECTORUL 1",60,"LICEUL TEORETIC ""JEAN MONNET"", DIN STR. JEAN MONNET NR. 2",1466,891,880,10,1,878,13,1613,722,348,530,1,16970,0
42,"Sectorul 1",179141,"#N/A",179141,,"BUCURESTI SECTORUL 1",61,"COLEGIUL ECONOMIC ""V. MADGEARU"", DIN B-DUL. ""DACIA"" NR. 34",1221,687,672,14,1,675,12,1343,656,318,357,1,16970,0
42,"Sectorul 1",179141,"#N/A",179141,,"BUCURESTI SECTORUL 1",62,"COLEGIUL ECONOMIC ""V. MADGEARU"", DIN B-DUL. ""DACIA"" NR. 34",1314,745,732,13,0,733,12,1445,700,338,395,1,16970,0
42,"Sectorul 1",179141,"#N/A",179141,,"BUCURESTI SECTORUL 1",63,"ACADEMIA DE STIINTE ECONOMICE, DIN PIATA ROMANA  NR.6",1181,622,604,18,0,616,6,1299,677,297,319,1,16970,0
42,"Sectorul 1",179141,"#N/A",179141,,"BUCURESTI SECTORUL 1",64,"ACADEMIA DE STIINTE ECONOMICE, DIN PIATA ROMANA  NR.6",882,476,464,12,0,470,6,970,494,196,274,1,16970,0
42,"Sectorul 1",179141,"#N/A",179141,,"BUCURESTI SECTORUL 1",65,"UNIVERSITATEA DE ARHITECTURA SI URBANISM ""ION MINCU"", DIN STR. ACADEMIEI NR.18-20",1103,619,599,17,3,604,15,1210,591,258,346,1,16970,0
42,"Sectorul 1",179141,"#N/A",179141,,"BUCURESTI SECTORUL 1",66,"UNIVERSITATEA DE ARHITECTURA SI URBANISM ""ION MINCU"", DIN STR. ACADEMIEI NR.18-20",1376,695,682,13,0,682,13,1512,817,301,381,1,16970,0
42,"Sectorul 1",179141,"#N/A",179141,,"BUCURESTI SECTORUL 1",67,"SCOALA NR. 5 ""CORNELIU  POPESCU"", DIN CALEA VICTORIEI NR.114",1361,732,717,15,0,720,12,1497,765,312,408,1,16970,0
42,"Sectorul 1",179141,"#N/A",179141,,"BUCURESTI SECTORUL 1",68,"SCOALA NR. 5 ""CORNELIU  POPESCU"", DIN CALEA VICTORIEI NR.114",925,487,475,12,0,482,5,1018,531,215,267,1,16970,0
42,"Sectorul 1",179141,"#N/A",179141,,"BUCURESTI SECTORUL 1",69,"LICEUL DE MUZICA ""GEORGE ENESCU"", DIN STR. GHEORGHE MANU NR.30",1311,693,682,11,0,684,9,1442,749,325,359,1,16970,0
42,"Sectorul 1",179141,"#N/A",179141,,"BUCURESTI SECTORUL 1",70,"LICEUL DE MUZICA ""GEORGE ENESCU"", DIN STR. GHEORGHE MANU NR.30",1539,698,683,15,0,693,5,1692,994,364,329,1,16970,0
42,"Sectorul 1",179141,"#N/A",179141,,"BUCURESTI SECTORUL 1",71,"COLEG. TEHNIC DE ARHITECTURA SI LUCRARI PUBLICE ""I.N. SOCOLESCU"", DIN STR. OCCIDENTULUI NR.12",1170,636,619,17,0,632,4,1287,651,296,336,1,16970,0
42,"Sectorul 1",179141,"#N/A",179141,,"BUCURESTI SECTORUL 1",72,"COLEGIUL NATIONAL ""SF. SAVA"", DIN STR. G-RAL BERTHELOT NR.23",940,488,475,11,2,483,5,1034,546,222,261,1,16970,0
42,"Sectorul 1",179141,"#N/A",179141,,"BUCURESTI SECTORUL 1",73,"COLEGIUL NATIONAL ""SF. SAVA"", DIN STR. G-RAL BERTHELOT NR.23",1153,627,618,9,0,615,12,1268,641,284,331,1,16970,0
42,"Sectorul 1",179141,"#N/A",179141,,"BUCURESTI SECTORUL 1",74,"COLEGIUL NATIONAL ""SF. SAVA"", DIN STR. G-RAL BERTHELOT NR.23",1254,684,668,16,0,674,10,1379,695,252,422,1,16970,0
42,"Sectorul 1",179141,"#N/A",179141,,"BUCURESTI SECTORUL 1",75,"COLEGIUL NATIONAL ""SF. SAVA"", DIN STR. G-RAL BERTHELOT NR.23",1415,725,713,12,0,714,11,1558,833,350,364,1,16970,0
42,"Sectorul 1",179141,"#N/A",179141,,"BUCURESTI SECTORUL 1",76,"UNIVERSITATEA NATIONALA DE MUZICA, DIN STR. STIRBEI VODA NR. 33",1169,551,539,12,0,548,3,1297,746,241,307,1,16970,0
42,"Sectorul 1",179141,"#N/A",179141,,"BUCURESTI SECTORUL 1",77,"UNIVERSITATEA NATIONALA DE MUZICA, DIN STR. STIRBEI VODA NR. 33",1134,598,584,14,0,591,7,1255,657,235,356,1,16970,0
42,"Sectorul 1",179141,"#N/A",179141,,"BUCURESTI SECTORUL 1",78,"LICEUL DE ARTE PLASTICE ""N. TONITZA"", DIN STR. G-RAL BERTHELOT NR.56-58",853,412,403,9,0,407,5,942,530,190,217,1,16970,0
42,"Sectorul 1",179141,"#N/A",179141,,"BUCURESTI SECTORUL 1",79,"LICEUL DE ARTE PLASTICE ""N. TONITZA"", DIN STR. G-RAL BERTHELOT NR.56-58",898,445,432,13,0,441,4,997,552,204,237,1,16970,0
42,"Sectorul 1",179141,"#N/A",179141,,"BUCURESTI SECTORUL 1",80,"CENTRUL NATIONAL DE CALIFICARE SI INSTRUIRE FEROVIARA - CENAFER, DIN CALEA GRIVITEI NR. 193B",1594,864,849,15,0,854,10,1754,890,432,422,1,16970,0
42,"Sectorul 1",179141,"#N/A",179141,,"BUCURESTI SECTORUL 1",81,"SCOALA NR. 3 ""N. TITULESCU"", DIN SOS. N. TITULESCU NR. 50-52",1434,745,727,18,0,728,17,1577,832,357,371,1,16970,0
42,"Sectorul 1",179141,"#N/A",179141,,"BUCURESTI SECTORUL 1",82,"SCOALA NR. 3 ""N. TITULESCU"", DIN SOS. N. TITULESCU NR. 50-52",707,566,557,9,0,560,6,1109,543,285,275,1,16970,0
42,"Sectorul 1",179141,"#N/A",179141,,"BUCURESTI SECTORUL 1",83,"SCOALA NR. 3 ""N. TITULESCU"", DIN SOS. N. TITULESCU NR. 50-52",1596,1042,1027,13,2,1031,11,1756,714,500,531,1,16970,0
42,"Sectorul 1",179141,"#N/A",179141,,"BUCURESTI SECTORUL 1",84,"SCOALA NR. 3 ""N. TITULESCU"", DIN SOS. N. TITULESCU NR. 50-52",1559,1008,993,14,1,992,16,1734,726,466,526,1,16970,0
42,"Sectorul 1",179141,"#N/A",179141,,"BUCURESTI SECTORUL 1",85,"SCOALA NR. 3 ""N. TITULESCU"", DIN SOS. N. TITULESCU NR. 50-52",1428,878,864,12,2,869,9,1572,694,314,555,1,16970,0
42,"Sectorul 1",179141,"#N/A",179141,,"BUCURESTI SECTORUL 1",86,"LICEUL TEORETIC  ""A. VLAHUTA"", DIN STR. SCOALA FLOREASCA NR. 5",1283,754,743,11,0,737,17,1421,667,336,401,1,16970,0
42,"Sectorul 1",179141,"#N/A",179141,,"BUCURESTI SECTORUL 1",87,"LICEUL TEORETIC  ""A. VLAHUTA"", DIN STR. SCOALA FLOREASCA NR. 5",1553,908,893,15,0,896,12,1708,800,458,438,1,16970,0
42,"Sectorul 1",179141,"#N/A",179141,,"BUCURESTI SECTORUL 1",88,"LICEUL TEORETIC  ""A. VLAHUTA"", DIN STR. SCOALA FLOREASCA NR. 5",1380,788,769,19,0,778,10,1518,730,336,442,1,16970,0
42,"Sectorul 1",179141,"#N/A",179141,,"BUCURESTI SECTORUL 1",89,"LICEUL DE ARTE PLASTICE ""N. TONITZA"", DIN B-DUL. IANCU DE HUNEDOARA NR. 27",1325,791,777,13,1,783,8,1458,667,361,422,1,16970,0
42,"Sectorul 1",179141,"#N/A",179141,,"BUCURESTI SECTORUL 1",90,"LICEUL DE ARTE PLASTICE ""N. TONITZA"", DIN B-DUL. IANCU DE HUNEDOARA NR. 27",1408,788,772,16,0,773,15,1549,761,287,486,1,16970,0
42,"Sectorul 1",179141,"#N/A",179141,,"BUCURESTI SECTORUL 1",91,"LICEUL DE ARTE PLASTICE ""N. TONITZA"", DIN B-DUL. IANCU DE HUNEDOARA NR. 27",1565,922,909,13,0,905,17,1722,800,367,538,1,16970,0
42,"Sectorul 1",179141,"#N/A",179141,,"BUCURESTI SECTORUL 1",92,"SCOALA NR. 186 ""E. VACARESCU"", DIN STR. STANISLAV CIHOSCHI NR. 15",1513,723,707,16,0,707,16,1664,941,318,389,1,16970,0
42,"Sectorul 1",179141,"#N/A",179141,,"BUCURESTI SECTORUL 1",93,"COLEGIUL GERMAN ""GOETHE"", DIN STR. STANISLAV CIHOSCHI NR. 17",1136,682,660,21,1,673,9,1253,571,287,386,1,16970,0
42,"Sectorul 1",179141,"#N/A",179141,,"BUCURESTI SECTORUL 1",94,"COLEGIUL GERMAN ""GOETHE"", DIN STR. STANISLAV CIHOSCHI NR. 17",985,469,458,10,1,463,6,1084,615,230,233,1,16970,0
42,"Sectorul 1",179141,"#N/A",179141,,"BUCURESTI SECTORUL 1",95,"COLEGIUL GERMAN ""GOETHE"", DIN STR. STANISLAV CIHOSCHI NR. 17",1009,486,476,10,0,478,8,1110,624,215,263,1,16970,0
42,"Sectorul 1",179141,"#N/A",179141,,"BUCURESTI SECTORUL 1",96,"LICEUL BILINGV TEORETIC ""MIGUEL DE CERVANTES"", DIN CALEA PLEVNEI NR. 38-40",1218,642,620,19,3,636,6,1340,698,281,355,1,16970,0
42,"Sectorul 1",179141,"#N/A",179141,,"BUCURESTI SECTORUL 1",97,"LICEUL BILINGV TEORETIC ""MIGUEL DE CERVANTES"", DIN CALEA PLEVNEI NR. 38-40",1243,628,614,14,0,620,8,1319,691,289,331,1,16970,0
42,"Sectorul 1",179141,"#N/A",179141,,"BUCURESTI SECTORUL 1",98,"SCOALA NR. 152 ""URUGUAY"", DIN STR. VIRGILIU NR. 40",1228,564,553,9,2,559,5,1352,788,291,268,1,16970,0
42,"Sectorul 1",179141,"#N/A",179141,,"BUCURESTI SECTORUL 1",99,"SCOALA NR. 152 ""URUGUAY"", DIN STR. VIRGILIU NR. 40",1098,568,559,9,0,561,7,1208,640,221,340,1,16970,0
42,"Sectorul 1",179141,"#N/A",179141,,"BUCURESTI SECTORUL 1",100,"SCOALA NR. 152 ""URUGUAY"", DIN STR. VIRGILIU NR. 40",1648,976,953,23,0,954,22,1813,837,423,531,1,16970,0
42,"Sectorul 1",179141,"#N/A",179141,,"BUCURESTI SECTORUL 1",101,"SCOALA NR. 152 ""URUGUAY"", DIN STR. VIRGILIU NR. 40",1439,639,624,15,0,626,13,1583,944,286,340,1,16970,0
42,"Sectorul 1",179141,"#N/A",179141,,"BUCURESTI SECTORUL 1",102,"CLUBUL SPORTIV SCOLAR NR. 5, DIN CALEA PLEVNEI NR. 124",1027,489,481,8,0,487,2,1129,640,297,190,1,16970,0
42,"Sectorul 1",179141,"#N/A",179141,,"BUCURESTI SECTORUL 1",103,"CLUBUL SPORTIV SCOLAR NR. 5, DIN CALEA PLEVNEI NR. 124",1080,434,419,15,0,427,7,1188,754,241,186,1,16970,0
42,"Sectorul 1",179141,"#N/A",179141,,"BUCURESTI SECTORUL 1",104,"SCOALA GENERALA NR. 1 ""SFINTII VOIEVOZI"", DIN STR. ATELIERULUI NR. 25",1154,624,614,10,0,608,16,1268,644,269,339,1,16970,0
42,"Sectorul 1",179141,"#N/A",179141,,"BUCURESTI SECTORUL 1",105,"SCOALA GENERALA NR. 1 ""SFINTII VOIEVOZI"", DIN STR. ATELIERULUI NR. 25",1004,559,537,19,3,550,9,1104,545,261,289,1,16970,0
42,"Sectorul 1",179141,"#N/A",179141,,"BUCURESTI SECTORUL 1",106,"SCOALA GENERALA NR. 1 ""SFINTII VOIEVOZI"", DIN STR. ATELIERULUI NR. 25",1007,628,611,14,3,619,9,1275,647,304,315,1,16970,0
42,"Sectorul 1",179141,"#N/A",179141,,"BUCURESTI SECTORUL 1",107,"SCOALA GENERALA NR. 1 ""SFINTII VOIEVOZI"", DIN STR. ATELIERULUI NR. 25",1637,858,832,26,0,847,11,1801,943,363,484,1,16970,0
42,"Sectorul 1",179141,"#N/A",179141,,"BUCURESTI SECTORUL 1",108,"SCOALA GENERALA NR. 1 ""SFINTII VOIEVOZI"", DIN STR. ATELIERULUI NR. 25",1171,571,549,22,0,565,6,1289,718,275,290,1,16970,0
42,"Sectorul 1",179141,"#N/A",179141,,"BUCURESTI SECTORUL 1",109,"LICEUL TEORETIC ""ION NECULCE"", DIN STR. G-RAL VLADOIANU NR. 7",1719,1041,1025,16,0,1025,16,1891,850,473,552,1,16970,0
42,"Sectorul 1",179141,"#N/A",179141,,"BUCURESTI SECTORUL 1",110,"LICEUL TEORETIC ""ION NECULCE"", DIN STR. G-RAL VLADOIANU NR. 7",1456,773,766,7,0,757,16,1602,829,388,369,1,16970,0
42,"Sectorul 1",179141,"#N/A",179141,,"BUCURESTI SECTORUL 1",111,"LICEUL TEORETIC ""ION NECULCE"", DIN STR. G-RAL VLADOIANU NR. 7",1691,922,912,10,0,901,21,1860,938,442,459,1,16970,0
42,"Sectorul 1",179141,"#N/A",179141,,"BUCURESTI SECTORUL 1",112,"LICEUL TEORETIC ""ION NECULCE"", DIN STR. G-RAL VLADOIANU NR. 7",1590,930,899,10,21,918,12,1763,833,508,410,1,16970,0
42,"Sectorul 1",179141,"#N/A",179141,,"BUCURESTI SECTORUL 1",113,"LICEUL TEORETIC ""ION NECULCE"", DIN STR. G-RAL VLADOIANU NR. 7",1559,804,794,10,0,796,8,1715,911,382,414,1,16970,0
42,"Sectorul 1",179141,"#N/A",179141,,"BUCURESTI SECTORUL 1",114,"CENTRUL NATIONAL DE CALIFICARE SI INSTRUIRE FEROVIARA - CENAFER, DIN CALEA GRIVITEI NR. 343",1389,745,732,13,0,733,12,1528,783,336,397,1,16970,0
42,"Sectorul 1",179141,"#N/A",179141,,"BUCURESTI SECTORUL 1",115,"CENTRUL NATIONAL DE CALIFICARE SI INSTRUIRE FEROVIARA - CENAFER, DIN CALEA GRIVITEI NR. 343",1571,867,852,15,0,851,16,1732,865,401,450,1,16970,0
42,"Sectorul 1",179141,"#N/A",179141,,"BUCURESTI SECTORUL 1",116,"SCOALA NR. 170 ""GEO BOGZA"", DIN STR. BARBU LAUTARU NR. 4",1113,587,579,8,0,575,12,1224,637,312,263,1,16970,0
42,"Sectorul 1",179141,"#N/A",179141,,"BUCURESTI SECTORUL 1",117,"SCOALA NR. 170 ""GEO BOGZA"", DIN STR. BARBU LAUTARU NR. 4",1345,757,745,12,0,736,21,1480,723,346,390,1,16970,0
42,"Sectorul 1",179141,"#N/A",179141,,"BUCURESTI SECTORUL 1",118,"SCOALA NR. 170 ""GEO BOGZA"", DIN STR. BARBU LAUTARU NR. 4",987,610,600,10,0,598,12,1053,443,266,332,1,16970,0
42,"Sectorul 1",179141,"#N/A",179141,,"BUCURESTI SECTORUL 1",119,"SCOALA NR. 171 ""PETRE ISPIRESCU"", DIN STR. VASILE GHERGHEL NR. 2",1525,930,910,20,0,918,12,1678,748,393,525,1,16970,0
42,"Sectorul 1",179141,"#N/A",179141,,"BUCURESTI SECTORUL 1",120,"SCOALA NR. 171 ""PETRE ISPIRESCU"", DIN STR. VASILE GHERGHEL NR. 2",1597,975,961,13,1,958,17,1756,781,460,498,1,16970,0
42,"Sectorul 1",179141,"#N/A",179141,,"BUCURESTI SECTORUL 1",121,"SCOALA NR. 171 ""PETRE ISPIRESCU"", DIN STR. VASILE GHERGHEL NR. 2",1398,799,786,13,0,789,10,1537,738,403,386,1,16970,0
42,"Sectorul 1",179141,"#N/A",179141,,"BUCURESTI SECTORUL 1",122,"SCOALA NR. 171 ""PETRE ISPIRESCU"", DIN STR. VASILE GHERGHEL NR. 2",1077,633,621,9,3,625,8,1181,548,352,273,1,16970,0
42,"Sectorul 1",179141,"#N/A",179141,,"BUCURESTI SECTORUL 1",123,"SCOALA NR. 171 ""PETRE ISPIRESCU"", DIN STR. VASILE GHERGHEL NR. 2",1075,596,581,15,0,592,4,1182,586,291,301,1,16970,0
42,"Sectorul 1",179141,"#N/A",179141,,"BUCURESTI SECTORUL 1",124,"SCOALA NR. 175 ""SF. NICOLAE"", DIN STR. LAINICI NR. 4-8",1535,884,869,14,1,870,14,1689,805,411,459,1,16970,0
42,"Sectorul 1",179141,"#N/A",179141,,"BUCURESTI SECTORUL 1",125,"SCOALA NR. 175 ""SF. NICOLAE"", DIN STR. LAINICI NR. 4-8",1378,752,743,9,0,743,9,1504,752,344,399,1,16970,0
42,"Sectorul 1",179141,"#N/A",179141,,"BUCURESTI SECTORUL 1",126,"COLEGIUL NATIONAL ""AUREL VLAICU"", DIN STR. STEPHAN LUDWIG ROTH  NR. 1",1216,707,690,17,0,697,10,1338,631,358,339,1,16970,0
42,"Sectorul 1",179141,"#N/A",179141,,"BUCURESTI SECTORUL 1",127,"COLEGIUL NATIONAL ""AUREL VLAICU"", DIN STR. STEPHAN LUDWIG ROTH  NR. 1",1207,752,741,11,0,741,11,1310,558,371,370,1,16970,0
42,"Sectorul 1",179141,"#N/A",179141,,"BUCURESTI SECTORUL 1",128,"COLEGIUL NATIONAL ""AUREL VLAICU"", DIN STR. STEPHAN LUDWIG ROTH  NR. 1",971,575,564,10,1,562,13,1068,493,268,294,1,16970,0
42,"Sectorul 1",179141,"#N/A",179141,,"BUCURESTI SECTORUL 1",129,"COLEGIUL TEHNIC MECANIC ""GRIVITA"", DIN CALEA GRIVITEI NR. 363",1321,719,710,8,1,709,10,1453,734,343,366,1,16970,0
42,"Sectorul 1",179141,"#N/A",179141,,"BUCURESTI SECTORUL 1",130,"COLEGIUL TEHNIC MECANIC ""GRIVITA"", DIN CALEA GRIVITEI NR. 363",1537,820,807,12,1,811,9,1691,871,416,395,1,16970,0
42,"Sectorul 1",179141,"#N/A",179141,,"BUCURESTI SECTORUL 1",131,"COLEGIUL TEHNIC MECANIC ""GRIVITA"", DIN CALEA GRIVITEI NR. 363",1464,825,806,19,0,814,11,1610,785,402,412,1,16970,0
42,"Sectorul 1",179141,"#N/A",179141,,"BUCURESTI SECTORUL 1",132,"GUPUL SCOLAR INDUSTRIAL TRANSPORTURI CAI FERATE, DIN STR. BUTUCENI NR. 10",1220,558,541,17,0,549,9,1342,784,286,263,1,16970,0
42,"Sectorul 1",179141,"#N/A",179141,,"BUCURESTI SECTORUL 1",133,"GUPUL SCOLAR INDUSTRIAL TRANSPORTURI CAI FERATE, DIN STR. BUTUCENI NR. 10",1270,595,586,9,0,585,10,1397,802,286,299,1,16970,0
42,"Sectorul 1",179141,"#N/A",179141,,"BUCURESTI SECTORUL 1",134,"SCOALA NR. 162, DIN STR. COPSA MICA NR.1",1211,648,629,18,1,645,3,1332,684,325,320,1,16970,0
42,"Sectorul 1",179141,"#N/A",179141,,"BUCURESTI SECTORUL 1",135,"SCOALA NR. 162, DIN STR. COPSA MICA NR.1",1158,591,579,12,0,580,11,1274,683,285,295,1,16970,0
42,"Sectorul 1",179141,"#N/A",179141,,"BUCURESTI SECTORUL 1",136,"SCOALA NR. 182 ""ALEXANDRU COSTESCU"", DIN STR. AMINTIRII NR. 26",1265,731,714,17,0,722,9,1372,641,395,327,1,16970,0
42,"Sectorul 1",179141,"#N/A",179141,,"BUCURESTI SECTORUL 1",137,"SCOALA NR. 182 ""ALEXANDRU COSTESCU"", DIN STR. AMINTIRII NR. 26",1358,769,754,15,0,758,11,1494,725,411,347,1,16970,0
42,"Sectorul 1",179141,"#N/A",179141,,"BUCURESTI SECTORUL 1",138,"SCOALA NR. 182 ""ALEXANDRU COSTESCU"", DIN STR. AMINTIRII NR. 26",1233,755,746,0,9,740,15,1356,601,408,332,1,16970,0
42,"Sectorul 1",179141,"#N/A",179141,,"BUCURESTI SECTORUL 1",139,"SCOALA NR. 182 ""ALEXANDRU COSTESCU"", DIN STR. AMINTIRII NR. 26",1300,651,646,5,0,642,9,1406,755,318,324,1,16970,0
42,"Sectorul 1",179141,"#N/A",179141,,"BUCURESTI SECTORUL 1",140,"SCOALA NR. 183, DIN STR. DUNEI NR. 1",1190,582,569,13,0,576,6,1311,729,301,275,1,16970,0
42,"Sectorul 1",179141,"#N/A",179141,,"BUCURESTI SECTORUL 1",141,"SCOALA NR. 183, DIN STR. DUNEI NR. 1",1280,607,598,9,0,600,7,1430,823,331,269,1,16970,0
42,"Sectorul 1",179141,"#N/A",179141,,"BUCURESTI SECTORUL 1",142,"SCOALA NR. 183, DIN STR. DUNEI NR. 1",1207,626,613,13,0,610,16,1328,702,332,278,1,16970,0
42,"Sectorul 1",179141,"#N/A",179141,,"BUCURESTI SECTORUL 1",143,"SCOALA NR. 183, DIN STR. DUNEI NR. 1",1458,711,701,10,0,694,17,1604,893,376,318,1,16970,0
42,"Sectorul 1",179141,"#N/A",179141,,"BUCURESTI SECTORUL 1",144,"SCOALA NR. 183, DIN STR. DUNEI NR. 1",1500,830,820,10,0,823,7,1650,820,406,417,1,16970,0
42,"Sectorul 1",179141,"#N/A",179141,,"BUCURESTI SECTORUL 1",145,"SCOALA NR. 183, DIN STR. DUNEI NR. 1",987,568,559,9,0,562,6,1086,518,291,271,1,16970,0
42,"Sectorul 1",179141,"#N/A",179141,,"BUCURESTI SECTORUL 1",146,"SCOALA NR. 183, DIN STR. DUNEI NR. 1",1334,766,759,7,0,758,8,1491,725,374,384,1,16970,0
42,"Sectorul 1",179141,"#N/A",179141,,"BUCURESTI SECTORUL 1",147,"SCOALA NR. 153, DIN STR. DRUMUL SABARENI  NR.21, SECTOR 6",1319,593,576,17,0,588,5,1433,840,337,251,1,16970,0
42,"Sectorul 1",179141,"#N/A",179141,,"BUCURESTI SECTORUL 1",148,"SCOALA NR. 184, DIN STR. STEFAN MAGHERI NR. 13",1285,644,630,14,0,636,8,1415,771,329,307,1,16970,0
42,"Sectorul 1",179141,"#N/A",179141,,"BUCURESTI SECTORUL 1",149,"SCOALA NR. 184, DIN STR. STEFAN MAGHERI NR. 13",1516,693,681,12,0,683,10,1668,975,380,303,1,16970,0
42,"Sectorul 1",179141,"#N/A",179141,,"BUCURESTI SECTORUL 1",150,"SCOALA NR. 184, DIN STR. STEFAN MAGHERI NR. 13",1336,658,646,12,0,650,8,1470,812,381,269,1,16970,0
42,"Sectorul 1",179141,"#N/A",179141,,"BUCURESTI SECTORUL 1",151,"SCOALA NR. 184, DIN STR. STEFAN MAGHERI NR. 13",1267,660,646,14,0,651,9,1394,734,365,286,1,16970,0
42,"Sectorul 1",179141,"#N/A",179141,,"BUCURESTI SECTORUL 1",152,"SCOALA NR. 184, DIN STR. STEFAN MAGHERI NR. 13",1367,746,729,17,0,737,9,1504,758,361,376,1,16970,0
42,"Sectorul 1",179141,"#N/A",179141,,"BUCURESTI SECTORUL 1",153,"SCOALA NR. 181, DIN STR. NAZARCEA NR. 30",1234,743,733,10,0,741,2,1357,614,413,328,1,16970,0
42,"Sectorul 1",179141,"#N/A",179141,,"BUCURESTI SECTORUL 1",154,"SCOALA NR. 181, DIN STR. NAZARCEA NR. 30",1362,713,698,15,0,707,6,1498,785,398,309,1,16970,0
42,"Sectorul 1",179141,"#N/A",179141,,"BUCURESTI SECTORUL 1",155,"SCOALA NR. 181, DIN STR. NAZARCEA NR. 30",1271,710,695,15,0,703,7,1398,688,376,327,1,16970,0
42,"Sectorul 1",179141,"#N/A",179141,,"BUCURESTI SECTORUL 1",156,"SCOALA NR. 181, DIN STR. NAZARCEA NR. 30",1064,576,563,13,0,567,9,1170,594,274,293,1,16970,0
42,"Sectorul 1",179141,"#N/A",179141,,"BUCURESTI SECTORUL 1",157,"SCOALA NR. 13, DIN B-DUL. PETRILA NR.10-12",1038,585,563,22,0,576,9,1143,558,294,282,1,16970,0
42,"Sectorul 1",179141,"#N/A",179141,,"BUCURESTI SECTORUL 1",158,"SCOALA NR. 13, DIN B-DUL. PETRILA NR.10-12",931,459,446,13,0,453,6,1025,566,254,199,1,16970,0
42,"Sectorul 1",179141,"#N/A",179141,,"BUCURESTI SECTORUL 1",159,"SCOALA NR. 192, DIN STR. MUNTENIEI NR.28",1399,758,740,18,0,745,13,1539,781,364,381,1,16970,0
42,"Sectorul 1",179141,"#N/A",179141,,"BUCURESTI SECTORUL 1",160,"SCOALA NR. 192, DIN STR. MUNTENIEI NR.28",1345,768,734,17,17,761,7,1480,712,391,370,1,16970,0
42,"Sectorul 1",179141,"#N/A",179141,,"BUCURESTI SECTORUL 1",161,"SCOALA NR. 192, DIN STR. MUNTENIEI NR.28",1394,780,767,13,0,773,7,1533,753,391,382,1,16970,0
42,"Sectorul 1",179141,"#N/A",179141,,"BUCURESTI SECTORUL 1",162,"GARA DE NORD, DIN P-TA GARII DE NORD NR.1-3",0,701,0,701,0,697,4,2200,1499,421,276,1,16970,1
42,"Sectorul 1",179141,"#N/A",179141,,"BUCURESTI SECTORUL 1",163,"SCOALA GENERALA NR. 1 ""SFINTII VOIEVOZI"", DIN STR. ATELIERULUI NR. 25",0,1129,0,1129,0,1115,14,2200,1071,609,506,1,16970,1
42,"Sectorul 1",179141,"#N/A",179141,,"BUCURESTI SECTORUL 1",164,"AEROPORTUL INTERNATIONAL BANEASA BUCURESTI ""AUREL VLAICU"", DIN SOS. BUCURESTI - PLOIESTI NR. 40",0,1198,0,1198,0,1182,16,2200,1002,574,608,1,16970,1
42,"Sectorul 1",179141,"#N/A",179141,,"BUCURESTI SECTORUL 1",165,"COLEGIUL TEHNIC MEDIA, DIN STR. JIULUI NR. 163",0,833,0,833,0,821,12,2200,1367,370,451,1,16970,1
42,"Sectorul 1",179141,"#N/A",179141,,"BUCURESTI SECTORUL 1",166,"UNIVERSITATEA DE STIINTE AGRONOMICE SI MEDICINA VETERINARA BUCURESTI, DIN BD. MARASTI NR. 59",0,1847,0,1847,0,1813,34,2200,353,908,905,1,16970,1
43,"Sectorul 2",179150,"#N/A",179150,,"BUCURESTI SECTORUL 2",167,"SCOALA NR. 28, DIN ALEEA CIRCULUI NR. 1",1755,1065,1054,11,0,1054,11,2000,935,511,543,1,16971,0
43,"Sectorul 2",179150,"#N/A",179150,,"BUCURESTI SECTORUL 2",168,"SCOALA NR. 28, DIN ALEEA CIRCULUI NR. 1",1336,806,796,10,0,798,8,1600,794,407,391,1,16971,0
43,"Sectorul 2",179150,"#N/A",179150,,"BUCURESTI SECTORUL 2",169,"SCOALA NR. 28, DIN ALEEA CIRCULUI NR. 1",1589,908,890,17,1,893,15,1600,692,374,519,1,16971,0
43,"Sectorul 2",179150,"#N/A",179150,,"BUCURESTI SECTORUL 2",170,"SCOALA NR. 10 ""MARIA ROSETTI"", DIN STR. GARIBALDI GIUSEPPE NR. 3",1694,1035,1008,26,1,1015,20,1800,765,445,570,1,16971,0
43,"Sectorul 2",179150,"#N/A",179150,,"BUCURESTI SECTORUL 2",171,"SCOALA NR. 10 ""MARIA ROSETTI"", DIN STR. GARIBALDI GIUSEPPE NR. 3",1065,654,631,23,0,643,11,1200,546,320,323,1,16971,0
43,"Sectorul 2",179150,"#N/A",179150,,"BUCURESTI SECTORUL 2",172,"SCOALA NR. 10 ""MARIA ROSETTI"", DIN STR. GARIBALDI GIUSEPPE NR. 3",1043,578,556,22,0,570,8,1193,615,282,288,1,16971,0
43,"Sectorul 2",179150,"#N/A",179150,,"BUCURESTI SECTORUL 2",173,"LICEUL TEORETIC ""C.A. ROSETTI"", DIN STR. GARIBALDI GIUSEPPE NR. 11",1245,745,717,27,1,722,23,1600,855,339,383,1,16971,0
43,"Sectorul 2",179150,"#N/A",179150,,"BUCURESTI SECTORUL 2",174,"LICEUL TEORETIC ""C.A. ROSETTI"", DIN STR. GARIBALDI GIUSEPPE NR. 11",1431,826,808,18,0,815,11,1600,774,390,425,1,16971,0
43,"Sectorul 2",179150,"#N/A",179150,,"BUCURESTI SECTORUL 2",175,"LICEUL TEORETIC ""C.A. ROSETTI"", DIN STR. GARIBALDI GIUSEPPE NR. 11",1528,874,859,15,0,860,14,1600,726,419,441,1,16971,0
43,"Sectorul 2",179150,"#N/A",179150,,"BUCURESTI SECTORUL 2",176,"COLEGIUL  TEHNIC ""TRAIAN"", DIN STR. GALVANI LUIGI NR. 20",2050,1231,1216,15,0,1213,18,2400,1169,541,672,1,16971,0
43,"Sectorul 2",179150,"#N/A",179150,,"BUCURESTI SECTORUL 2",177,"COLEGIUL  TEHNIC ""TRAIAN"", DIN STR. GALVANI LUIGI NR. 20",2107,1092,1074,17,1,1068,24,2400,1308,504,564,1,16971,0
43,"Sectorul 2",179150,"#N/A",179150,,"BUCURESTI SECTORUL 2",178,"COLEGIUL  TEHNIC ""TRAIAN"", DIN STR. GALVANI LUIGI NR. 20",2018,1076,1057,19,0,1056,20,2400,1324,581,475,1,16971,0
43,"Sectorul 2",179150,"#N/A",179150,,"BUCURESTI SECTORUL 2",179,"COLEGIUL  TEHNIC ""TRAIAN"", DIN STR. GALVANI LUIGI NR. 20",1806,1083,1069,14,0,1062,21,2000,917,536,526,1,16971,0
43,"Sectorul 2",179150,"#N/A",179150,,"BUCURESTI SECTORUL 2",180,"SCOALA NR. 31, DIN BD. LACUL TEI NR. 116",1720,938,919,18,1,921,17,1800,862,441,480,1,16971,0
43,"Sectorul 2",179150,"#N/A",179150,,"BUCURESTI SECTORUL 2",181,"SCOALA NR. 31, DIN BD. LACUL TEI NR. 116",1845,917,899,17,1,903,14,2000,1083,451,452,1,16971,0
43,"Sectorul 2",179150,"#N/A",179150,,"BUCURESTI SECTORUL 2",182,"SCOALA NR. 31, DIN BD. LACUL TEI NR. 116",1964,1058,1046,12,0,1044,14,2002,944,528,516,1,16971,0
43,"Sectorul 2",179150,"#N/A",179150,,"BUCURESTI SECTORUL 2",183,"SCOALA NR. 31, DIN BD. LACUL TEI NR. 116",1845,948,925,23,0,928,20,2000,1052,456,472,1,16971,0
43,"Sectorul 2",179150,"#N/A",179150,,"BUCURESTI SECTORUL 2",184,"SCOALA NR. 31, DIN BD. LACUL TEI NR. 116",1893,999,988,11,0,993,6,2000,1001,491,502,1,16971,0
43,"Sectorul 2",179150,"#N/A",179150,,"BUCURESTI SECTORUL 2",185,"UNIVERSITATEA TEHNICA DE CONSTRUCTII BUCURESTI, DIN BD. LACUL TEI NR. 124",1927,1148,1137,11,0,1132,16,2000,852,512,620,1,16971,0
43,"Sectorul 2",179150,"#N/A",179150,,"BUCURESTI SECTORUL 2",186,"UNIVERSITATEA TEHNICA DE CONSTRUCTII BUCURESTI, DIN BD. LACUL TEI NR. 124",1974,972,958,14,0,960,12,2000,1028,490,470,1,16971,0
43,"Sectorul 2",179150,"#N/A",179150,,"BUCURESTI SECTORUL 2",187,"UNIVERSITATEA TEHNICA DE CONSTRUCTII BUCURESTI, DIN BD. LACUL TEI NR. 124",1786,863,816,45,2,847,16,2000,1137,440,407,1,16971,0
43,"Sectorul 2",179150,"#N/A",179150,,"BUCURESTI SECTORUL 2",188,"UNIVERSITATEA TEHNICA DE CONSTRUCTII BUCURESTI, DIN BD. LACUL TEI NR. 124",1851,912,894,18,0,903,9,2000,1088,433,470,1,16971,0
43,"Sectorul 2",179150,"#N/A",179150,,"BUCURESTI SECTORUL 2",189,"UNIVERSITATEA TEHNICA DE CONSTRUCTII BUCURESTI, DIN BD. LACUL TEI NR. 124",1942,1017,992,24,1,1009,8,2001,984,475,534,1,16971,0
43,"Sectorul 2",179150,"#N/A",179150,,"BUCURESTI SECTORUL 2",190,"UNIVERSITATEA TEHNICA DE CONSTRUCTII BUCURESTI, DIN BD. LACUL TEI NR. 124",2162,1212,1202,10,0,1190,22,2400,1188,647,543,1,16971,0
43,"Sectorul 2",179150,"#N/A",179150,,"BUCURESTI SECTORUL 2",191,"UNIVERSITATEA TEHNICA DE CONSTRUCTII BUCURESTI, DIN BD. LACUL TEI NR. 124",1763,910,896,12,2,895,15,1800,890,403,492,1,16971,0
43,"Sectorul 2",179150,"#N/A",179150,,"BUCURESTI SECTORUL 2",192,"UNIVERSITATEA TEHNICA DE CONSTRUCTII BUCURESTI, DIN BD. LACUL TEI NR. 124",1225,469,456,13,0,456,13,1600,1131,262,194,1,16971,0
43,"Sectorul 2",179150,"#N/A",179150,,"BUCURESTI SECTORUL 2",193,"UNIVERSITATEA TEHNICA DE CONSTRUCTII BUCURESTI, DIN BD. LACUL TEI NR. 124",1550,896,817,79,0,879,17,1600,704,436,443,1,16971,0
43,"Sectorul 2",179150,"#N/A",179150,,"BUCURESTI SECTORUL 2",194,"UNIVERSITATEA TEHNICA DE CONSTRUCTII BUCURESTI, DIN BD. LACUL TEI NR. 124",1686,758,748,10,0,742,16,1800,1042,381,361,1,16971,0
43,"Sectorul 2",179150,"#N/A",179150,,"BUCURESTI SECTORUL 2",195,"GRUPUL SCOLAR  INDUSTRIAL ""C-TIN BRANCUSI"", DIN BD. DIMITRIE POMPEIU NR. 1",814,403,384,19,0,398,5,1000,597,250,148,1,16971,0
43,"Sectorul 2",179150,"#N/A",179150,,"BUCURESTI SECTORUL 2",196,"SCOALA NR. 27 ""PRINCIPESA ILEANA"", DIN STR. MASINA DE PAINE NR. 65-67",1764,865,846,19,0,853,12,2000,1135,412,441,1,16971,0
43,"Sectorul 2",179150,"#N/A",179150,,"BUCURESTI SECTORUL 2",197,"SCOALA NR. 27 ""PRINCIPESA ILEANA"", DIN STR. MASINA DE PAINE NR. 65-67",1695,981,961,20,0,968,13,1800,819,414,554,1,16971,0
43,"Sectorul 2",179150,"#N/A",179150,,"BUCURESTI SECTORUL 2",198,"SCOALA NR. 27 ""PRINCIPESA ILEANA"", DIN STR. MASINA DE PAINE NR. 65-67",1419,740,731,9,0,727,13,1600,860,326,401,1,16971,0
43,"Sectorul 2",179150,"#N/A",179150,,"BUCURESTI SECTORUL 2",199,"SCOALA NR. 27 ""PRINCIPESA ILEANA"", DIN STR. MASINA DE PAINE NR. 65-67",1454,872,859,12,1,860,12,1611,739,385,475,1,16971,0
43,"Sectorul 2",179150,"#N/A",179150,,"BUCURESTI SECTORUL 2",200,"SCOALA NR. 27 ""PRINCIPESA ILEANA"", DIN STR. MASINA DE PAINE NR. 65-67",1079,719,704,14,1,706,13,1600,881,368,338,1,16971,0
43,"Sectorul 2",179150,"#N/A",179150,,"BUCURESTI SECTORUL 2",201,"SCOALA NR. 30, DIN STR. LAPTARI TEI NR. 23",2173,1163,1147,16,0,1148,15,2400,1237,580,568,1,16971,0
43,"Sectorul 2",179150,"#N/A",179150,,"BUCURESTI SECTORUL 2",202,"SCOALA NR. 30, DIN STR. LAPTARI TEI NR. 23",1685,936,925,11,0,924,12,1800,864,456,468,1,16971,0
43,"Sectorul 2",179150,"#N/A",179150,,"BUCURESTI SECTORUL 2",203,"SCOALA NR. 30, DIN STR. LAPTARI TEI NR. 23",1768,945,939,6,0,931,14,2000,1055,460,471,1,16971,0
43,"Sectorul 2",179150,"#N/A",179150,,"BUCURESTI SECTORUL 2",204,"SCOALA NR. 30, DIN STR. LAPTARI TEI NR. 23",2032,967,952,15,0,949,18,2200,1233,479,470,1,16971,0
43,"Sectorul 2",179150,"#N/A",179150,,"BUCURESTI SECTORUL 2",205,"SCOALA NR. 30, DIN STR. LAPTARI TEI NR. 23",1007,1048,962,86,0,1033,15,1800,752,456,577,1,16971,0
43,"Sectorul 2",179150,"#N/A",179150,,"BUCURESTI SECTORUL 2",206,"SCOALA NR. 30, DIN STR. LAPTARI TEI NR. 23",1624,817,799,17,1,806,11,1800,983,431,375,1,16971,0
43,"Sectorul 2",179150,"#N/A",179150,,"BUCURESTI SECTORUL 2",207,"SCOALA NR. 30, DIN STR. LAPTARI TEI NR. 23",1843,785,768,17,0,779,6,2000,1215,411,368,1,16971,0
43,"Sectorul 2",179150,"#N/A",179150,,"BUCURESTI SECTORUL 2",208,"GRADINITA NR. 233, DIN STR. PETRE ANTONESCU NR. 20",1525,880,869,10,1,866,14,1600,720,389,477,1,16971,0
43,"Sectorul 2",179150,"#N/A",179150,,"BUCURESTI SECTORUL 2",209,"GRADINITA NR. 233, DIN STR. PETRE ANTONESCU NR. 20",1445,863,853,10,0,851,12,1600,737,402,449,1,16971,0
43,"Sectorul 2",179150,"#N/A",179150,,"BUCURESTI SECTORUL 2",210,"SCOALA NR. 39, DIN SOS. COLENTINA NR. 91",1730,1002,987,14,1,990,12,2000,998,526,464,1,16971,0
43,"Sectorul 2",179150,"#N/A",179150,,"BUCURESTI SECTORUL 2",211,"SCOALA NR. 39, DIN SOS. COLENTINA NR. 91",1576,881,868,13,0,866,15,1600,719,461,405,1,16971,0
43,"Sectorul 2",179150,"#N/A",179150,,"BUCURESTI SECTORUL 2",212,"SCOALA NR. 39, DIN SOS. COLENTINA NR. 91",1707,765,756,9,0,759,6,1800,1035,419,340,1,16971,0
43,"Sectorul 2",179150,"#N/A",179150,,"BUCURESTI SECTORUL 2",213,"SCOALA NR. 39, DIN SOS. COLENTINA NR. 91",1646,798,785,13,0,789,9,1800,1002,411,378,1,16971,0
43,"Sectorul 2",179150,"#N/A",179150,,"BUCURESTI SECTORUL 2",214,"SCOALA NR. 39, DIN SOS. COLENTINA NR. 91",1747,959,947,10,2,949,10,2000,1041,507,442,1,16971,0
43,"Sectorul 2",179150,"#N/A",179150,,"BUCURESTI SECTORUL 2",215,"SCOALA NR. 39, DIN SOS. COLENTINA NR. 91",1708,823,812,11,0,807,16,1801,978,387,420,1,16971,0
43,"Sectorul 2",179150,"#N/A",179150,,"BUCURESTI SECTORUL 2",216,"SCOALA NR. 39, DIN SOS. COLENTINA NR. 91",1739,936,921,15,0,921,15,2000,1064,448,473,1,16971,0
43,"Sectorul 2",179150,"#N/A",179150,,"BUCURESTI SECTORUL 2",217,"SCOALA NR. 40, DIN STR. PERIS NR. 27",1683,759,749,10,0,754,5,1800,1041,416,338,1,16971,0
43,"Sectorul 2",179150,"#N/A",179150,,"BUCURESTI SECTORUL 2",218,"SCOALA NR. 40, DIN STR. PERIS NR. 27",1508,653,643,10,0,643,10,1600,947,365,278,1,16971,0
43,"Sectorul 2",179150,"#N/A",179150,,"BUCURESTI SECTORUL 2",219,"SCOALA NR. 40, DIN STR. PERIS NR. 27",1706,869,859,10,0,858,11,1800,931,426,432,1,16971,0
43,"Sectorul 2",179150,"#N/A",179150,,"BUCURESTI SECTORUL 2",220,"SCOALA NR. 40, DIN STR. PERIS NR. 27",1695,900,887,10,3,891,9,1800,900,454,437,1,16971,0
43,"Sectorul 2",179150,"#N/A",179150,,"BUCURESTI SECTORUL 2",221,"SCOALA NR. 40, DIN STR. PERIS NR. 27",1588,759,739,20,0,746,13,1600,841,380,366,1,16971,0
43,"Sectorul 2",179150,"#N/A",179150,,"BUCURESTI SECTORUL 2",222,"SCOALA NR. 40, DIN STR. PERIS NR. 27",2312,1166,1148,18,0,1154,12,2400,1234,596,558,1,16971,0
43,"Sectorul 2",179150,"#N/A",179150,,"BUCURESTI SECTORUL 2",223,"SCOALA NR. 41, DIN STR. NICOLAE APOSTOL NR. 2",1577,779,766,13,0,772,7,1600,821,380,392,1,16971,0
43,"Sectorul 2",179150,"#N/A",179150,,"BUCURESTI SECTORUL 2",224,"SCOALA NR. 41, DIN STR. NICOLAE APOSTOL NR. 2",1903,898,884,13,1,880,18,2000,1102,450,430,1,16971,0
43,"Sectorul 2",179150,"#N/A",179150,,"BUCURESTI SECTORUL 2",225,"SCOALA NR. 41, DIN STR. NICOLAE APOSTOL NR. 2",1911,948,934,13,1,938,10,2000,1052,472,466,1,16971,0
43,"Sectorul 2",179150,"#N/A",179150,,"BUCURESTI SECTORUL 2",226,"SCOALA NR. 32, DIN STR. SPORTULUI NR. 21",1660,791,779,12,0,779,12,1800,1009,394,385,1,16971,0
43,"Sectorul 2",179150,"#N/A",179150,,"BUCURESTI SECTORUL 2",227,"SCOALA NR. 32, DIN STR. SPORTULUI NR. 21",1636,910,898,10,2,902,8,1800,890,489,413,1,16971,0
43,"Sectorul 2",179150,"#N/A",179150,,"BUCURESTI SECTORUL 2",228,"SCOALA NR. 32, DIN STR. SPORTULUI NR. 21",1606,823,808,15,0,817,6,1800,977,427,390,1,16971,0
43,"Sectorul 2",179150,"#N/A",179150,,"BUCURESTI SECTORUL 2",229,"SCOALA NR. 32, DIN STR. SPORTULUI NR. 21",1720,836,825,11,0,824,12,2000,1164,382,442,1,16971,0
43,"Sectorul 2",179150,"#N/A",179150,,"BUCURESTI SECTORUL 2",230,"SCOALA NR. 32, DIN STR. SPORTULUI NR. 21",1159,575,557,18,0,569,6,1600,1025,286,283,1,16971,0
43,"Sectorul 2",179150,"#N/A",179150,,"BUCURESTI SECTORUL 2",231,"COLEGIUL NATIONAL ""VICTOR BABES "", DIN SOS. FUNDENI NR. 254",2048,918,897,21,0,907,11,2200,1282,469,438,1,16971,0
43,"Sectorul 2",179150,"#N/A",179150,,"BUCURESTI SECTORUL 2",232,"COLEGIUL NATIONAL ""VICTOR BABES "", DIN SOS. FUNDENI NR. 254",2358,1084,1070,14,0,1072,12,2400,1316,528,544,1,16971,0
43,"Sectorul 2",179150,"#N/A",179150,,"BUCURESTI SECTORUL 2",233,"COLEGIUL NATIONAL ""VICTOR BABES "", DIN SOS. FUNDENI NR. 254",1731,828,816,12,0,816,12,2000,1172,434,382,1,16971,0
43,"Sectorul 2",179150,"#N/A",179150,,"BUCURESTI SECTORUL 2",234,"COLEGIUL NATIONAL ""VICTOR BABES "", DIN SOS. FUNDENI NR. 254",1158,585,574,11,0,579,6,1194,609,290,289,1,16971,0
43,"Sectorul 2",179150,"#N/A",179150,,"BUCURESTI SECTORUL 2",235,"GRADINITA  NR. 11, DIN ALEEA SINAIA NR. 2",1803,981,958,22,1,973,8,2010,1029,495,478,1,16971,0
43,"Sectorul 2",179150,"#N/A",179150,,"BUCURESTI SECTORUL 2",236,"GRADINITA  NR. 11, DIN ALEEA SINAIA NR. 2",1688,822,770,52,0,815,7,1780,958,413,402,1,16971,0
43,"Sectorul 2",179150,"#N/A",179150,,"BUCURESTI SECTORUL 2",237,"SCOALA NR. 145 , DIN STR. HELIADE INTRE VII NR. 36",1792,723,707,16,0,712,11,2000,1277,404,308,1,16971,0
43,"Sectorul 2",179150,"#N/A",179150,,"BUCURESTI SECTORUL 2",238,"SCOALA NR. 145 , DIN STR. HELIADE INTRE VII NR. 36",2575,1286,1273,13,0,1263,23,2800,1514,641,622,1,16971,0
43,"Sectorul 2",179150,"#N/A",179150,,"BUCURESTI SECTORUL 2",239,"SCOALA NR. 145 , DIN STR. HELIADE INTRE VII NR. 36",1837,907,894,13,0,894,13,2000,1093,456,438,1,16971,0
43,"Sectorul 2",179150,"#N/A",179150,,"BUCURESTI SECTORUL 2",240,"SCOALA NR. 145 , DIN STR. HELIADE INTRE VII NR. 36",2195,1001,982,18,1,989,12,2398,1397,554,435,1,16971,0
43,"Sectorul 2",179150,"#N/A",179150,,"BUCURESTI SECTORUL 2",241,"SCOALA NR. 145 , DIN STR. HELIADE INTRE VII NR. 36",1301,552,544,8,0,541,11,1600,1048,326,215,1,16971,0
43,"Sectorul 2",179150,"#N/A",179150,,"BUCURESTI SECTORUL 2",242,"SCOALA NR. 145 , DIN STR. HELIADE INTRE VII NR. 36",1594,830,814,16,0,822,8,1600,770,438,384,1,16971,0
43,"Sectorul 2",179150,"#N/A",179150,,"BUCURESTI SECTORUL 2",243,"SCOALA NR. 145 , DIN STR. HELIADE INTRE VII NR. 36",2927,1135,1106,29,0,1115,20,3200,2065,594,521,1,16971,0
43,"Sectorul 2",179150,"#N/A",179150,,"BUCURESTI SECTORUL 2",244,"SCOALA  NR. 62 , DIN STR. POTARNICHII NR. 3",1754,918,901,16,1,909,9,2000,1082,416,493,1,16971,0
43,"Sectorul 2",179150,"#N/A",179150,,"BUCURESTI SECTORUL 2",245,"SCOALA  NR. 62 , DIN STR. POTARNICHII NR. 3",1357,639,629,10,0,633,6,1601,962,336,297,1,16971,0
43,"Sectorul 2",179150,"#N/A",179150,,"BUCURESTI SECTORUL 2",246,"SCOALA  NR. 62 , DIN STR. POTARNICHII NR. 3",1461,759,747,12,0,750,9,1600,841,363,387,1,16971,0
43,"Sectorul 2",179150,"#N/A",179150,,"BUCURESTI SECTORUL 2",247,"SCOALA  NR. 62 , DIN STR. POTARNICHII NR. 3",1667,844,830,14,0,838,6,1800,956,449,389,1,16971,0
43,"Sectorul 2",179150,"#N/A",179150,,"BUCURESTI SECTORUL 2",248,"SCOALA  NR. 62 , DIN STR. POTARNICHII NR. 3",1522,713,703,10,0,701,12,1600,887,371,330,1,16971,0
43,"Sectorul 2",179150,"#N/A",179150,,"BUCURESTI SECTORUL 2",249,"SCOALA  NR. 62 , DIN STR. POTARNICHII NR. 3",1502,827,812,15,0,817,10,1600,773,383,434,1,16971,0
43,"Sectorul 2",179150,"#N/A",179150,,"BUCURESTI SECTORUL 2",250,"SCOALA  NR. 62 , DIN STR. POTARNICHII NR. 3",1244,622,608,14,0,613,9,1600,978,305,308,1,16971,0
43,"Sectorul 2",179150,"#N/A",179150,,"BUCURESTI SECTORUL 2",251,"GRUP SCOLAR IND. ""SF. PANTELIMON "", DIN STR. HAMBARULUI NR. 12",1931,1096,1084,10,2,1081,15,2000,904,510,571,1,16971,0
43,"Sectorul 2",179150,"#N/A",179150,,"BUCURESTI SECTORUL 2",252,"GRUP SCOLAR IND. ""SF. PANTELIMON "", DIN STR. HAMBARULUI NR. 12",1501,877,859,17,1,864,13,1600,723,417,447,1,16971,0
43,"Sectorul 2",179150,"#N/A",179150,,"BUCURESTI SECTORUL 2",253,"GRUP SCOLAR IND. ""SF. PANTELIMON "", DIN STR. HAMBARULUI NR. 12",1526,838,825,13,0,825,13,1600,762,385,440,1,16971,0
43,"Sectorul 2",179150,"#N/A",179150,,"BUCURESTI SECTORUL 2",254,"GRUP SCOLAR IND. ""SF. PANTELIMON "", DIN STR. HAMBARULUI NR. 12",1835,1029,1013,15,1,1013,16,2000,971,524,489,1,16971,0
43,"Sectorul 2",179150,"#N/A",179150,,"BUCURESTI SECTORUL 2",255,"SCOALA NR. 51, DIN STR. HERTA NR. 1",1638,933,924,9,0,916,17,1799,866,447,469,1,16971,0
43,"Sectorul 2",179150,"#N/A",179150,,"BUCURESTI SECTORUL 2",256,"SCOALA NR. 51, DIN STR. HERTA NR. 1",1639,672,657,14,1,664,8,1800,1128,341,323,1,16971,0
43,"Sectorul 2",179150,"#N/A",179150,,"BUCURESTI SECTORUL 2",257,"SCOALA NR. 51, DIN STR. HERTA NR. 1",1535,874,856,17,1,862,12,1600,726,399,463,1,16971,0
43,"Sectorul 2",179150,"#N/A",179150,,"BUCURESTI SECTORUL 2",258,"GRADINITA NR. 280, DIN STR. COCOSTARCULUI NR. 2",1504,794,777,17,0,787,7,1600,806,396,391,1,16971,0
43,"Sectorul 2",179150,"#N/A",179150,,"BUCURESTI SECTORUL 2",259,"GRADINITA NR. 280, DIN STR. COCOSTARCULUI NR. 2",1773,808,793,12,3,803,5,2000,1192,392,411,1,16971,0
43,"Sectorul 2",179150,"#N/A",179150,,"BUCURESTI SECTORUL 2",260,"SCOALA  NR. 77, DIN SOS. PANTELIMON NR. 289",1591,789,775,13,1,781,8,1800,1011,395,386,1,16971,0
43,"Sectorul 2",179150,"#N/A",179150,,"BUCURESTI SECTORUL 2",261,"SCOALA  NR. 77, DIN SOS. PANTELIMON NR. 289",1611,945,929,15,1,935,10,1799,854,457,478,1,16971,0
43,"Sectorul 2",179150,"#N/A",179150,,"BUCURESTI SECTORUL 2",262,"SCOALA  NR. 77, DIN SOS. PANTELIMON NR. 289",1713,929,921,8,0,911,18,2001,1072,391,520,1,16971,0
43,"Sectorul 2",179150,"#N/A",179150,,"BUCURESTI SECTORUL 2",263,"SCOALA  NR. 77, DIN SOS. PANTELIMON NR. 289",1635,928,917,9,2,915,13,1800,872,441,474,1,16971,0
43,"Sectorul 2",179150,"#N/A",179150,,"BUCURESTI SECTORUL 2",264,"SCOALA  NR. 77, DIN SOS. PANTELIMON NR. 289",1847,935,922,12,1,924,11,2000,1065,434,490,1,16971,0
43,"Sectorul 2",179150,"#N/A",179150,,"BUCURESTI SECTORUL 2",265,"SCOALA  NR. 77, DIN SOS. PANTELIMON NR. 289",1705,941,932,9,0,930,11,2000,1059,447,483,1,16971,0
43,"Sectorul 2",179150,"#N/A",179150,,"BUCURESTI SECTORUL 2",266,"LICEUL TEORETIC ""LUCIAN BLAGA"", DIN SOS. PANTELIMON  NR. 355",1835,914,906,8,0,898,16,2000,1086,463,435,1,16971,0
43,"Sectorul 2",179150,"#N/A",179150,,"BUCURESTI SECTORUL 2",267,"LICEUL TEORETIC ""LUCIAN BLAGA"", DIN SOS. PANTELIMON  NR. 355",2581,939,918,21,0,922,17,2800,1861,531,391,1,16971,0
43,"Sectorul 2",179150,"#N/A",179150,,"BUCURESTI SECTORUL 2",268,"LICEUL TEORETIC ""LUCIAN BLAGA"", DIN SOS. PANTELIMON  NR. 355",1922,991,972,19,0,982,9,2201,1210,487,495,1,16971,0
43,"Sectorul 2",179150,"#N/A",179150,,"BUCURESTI SECTORUL 2",269,"LICEUL TEORETIC ""LUCIAN BLAGA"", DIN SOS. PANTELIMON  NR. 355",1128,907,894,13,0,890,17,2200,1293,480,410,1,16971,0
43,"Sectorul 2",179150,"#N/A",179150,,"BUCURESTI SECTORUL 2",270,"LICEUL TEORETIC ""LUCIAN BLAGA"", DIN SOS. PANTELIMON  NR. 355",1296,695,687,8,0,690,5,1622,927,316,374,1,16971,0
43,"Sectorul 2",179150,"#N/A",179150,,"BUCURESTI SECTORUL 2",271,"SCOALA  NR. 66, DIN STR. LOGOFATUL  DAN NR. 1",1935,959,943,15,1,944,15,2000,1041,510,434,1,16971,0
43,"Sectorul 2",179150,"#N/A",179150,,"BUCURESTI SECTORUL 2",272,"SCOALA  NR. 66, DIN STR. LOGOFATUL  DAN NR. 1",1358,754,745,9,0,750,4,1600,846,364,386,1,16971,0
43,"Sectorul 2",179150,"#N/A",179150,,"BUCURESTI SECTORUL 2",273,"SCOALA  NR. 66, DIN STR. LOGOFATUL  DAN NR. 1",1724,796,783,13,0,790,6,2000,1204,425,365,1,16971,0
43,"Sectorul 2",179150,"#N/A",179150,,"BUCURESTI SECTORUL 2",274,"SCOALA  NR. 66, DIN STR. LOGOFATUL  DAN NR. 1",1481,859,848,11,0,854,5,1600,741,430,424,1,16971,0
43,"Sectorul 2",179150,"#N/A",179150,,"BUCURESTI SECTORUL 2",275,"SCOALA  NR. 66, DIN STR. LOGOFATUL  DAN NR. 1",1948,944,924,20,0,928,16,2000,1056,449,479,1,16971,0
43,"Sectorul 2",179150,"#N/A",179150,,"BUCURESTI SECTORUL 2",276,"GRADINITA NR. 189, DIN SOS. VERGULUI NR. 12",890,446,433,13,0,442,4,1000,554,189,253,1,16971,0
43,"Sectorul 2",179150,"#N/A",179150,,"BUCURESTI SECTORUL 2",277,"GRADINITA NR. 189, DIN SOS. VERGULUI NR. 12",1415,842,828,14,0,828,14,1600,758,341,487,1,16971,0
43,"Sectorul 2",179150,"#N/A",179150,,"BUCURESTI SECTORUL 2",278,"COLEGUL TEHNIC ""DIMITRIE LEONIDA"", DIN BD. BASARABIA NR. 47",1241,719,703,15,1,712,7,1600,881,357,355,1,16971,0
43,"Sectorul 2",179150,"#N/A",179150,,"BUCURESTI SECTORUL 2",279,"COLEGUL TEHNIC ""DIMITRIE LEONIDA"", DIN BD. BASARABIA NR. 47",1559,833,823,10,0,802,31,1800,967,374,428,1,16971,0
43,"Sectorul 2",179150,"#N/A",179150,,"BUCURESTI SECTORUL 2",280,"SCOALA NR. 58, DIN STR. PESCARUSULUI NR. 124",1850,933,920,13,0,923,10,2000,1067,426,497,1,16971,0
43,"Sectorul 2",179150,"#N/A",179150,,"BUCURESTI SECTORUL 2",281,"SCOALA NR. 58, DIN STR. PESCARUSULUI NR. 124",1886,1008,991,17,0,1003,5,2000,992,437,566,1,16971,0
43,"Sectorul 2",179150,"#N/A",179150,,"BUCURESTI SECTORUL 2",282,"SCOALA NR. 58, DIN STR. PESCARUSULUI NR. 124",2081,1137,1121,16,0,1125,12,2400,1263,565,560,1,16971,0
43,"Sectorul 2",179150,"#N/A",179150,,"BUCURESTI SECTORUL 2",283,"SCOALA NR. 58, DIN STR. PESCARUSULUI NR. 124",2155,1199,1181,18,0,1177,22,2400,1201,561,616,1,16971,0
43,"Sectorul 2",179150,"#N/A",179150,,"BUCURESTI SECTORUL 2",284,"SCOALA NR. 58, DIN STR. PESCARUSULUI NR. 12",1993,1049,1037,12,0,1032,17,2000,951,533,499,1,16971,0
43,"Sectorul 2",179150,"#N/A",179150,,"BUCURESTI SECTORUL 2",285,"SCOALA NR. 4, DIN STR. HERTA  NR. 14",1758,972,963,9,0,962,10,2000,1028,482,480,1,16971,0
43,"Sectorul 2",179150,"#N/A",179150,,"BUCURESTI SECTORUL 2",286,"SCOALA NR. 4, DIN STR. HERTA  NR. 14",1898,1062,1037,25,0,1048,14,2000,938,437,611,1,16971,0
43,"Sectorul 2",179150,"#N/A",179150,,"BUCURESTI SECTORUL 2",287,"SCOALA NR. 4, DIN STR. HERTA  NR. 14",1926,1045,1030,15,0,1030,15,2201,1156,530,500,1,16971,0
43,"Sectorul 2",179150,"#N/A",179150,,"BUCURESTI SECTORUL 2",288,"SCOALA NR. 4, DIN STR. HERTA  NR. 14",2108,1105,1097,8,0,1089,16,2400,1295,537,552,1,16971,0
43,"Sectorul 2",179150,"#N/A",179150,,"BUCURESTI SECTORUL 2",289,"SCOALA NR. 4, DIN STR. HERTA  NR. 14",1611,841,834,7,0,827,14,1800,959,460,367,1,16971,0
43,"Sectorul 2",179150,"#N/A",179150,,"BUCURESTI SECTORUL 2",290,"SCOALA NR. 25, DIN STR. SILVIA NR. 54",1731,975,930,45,0,962,13,1797,822,482,480,1,16971,0
43,"Sectorul 2",179150,"#N/A",179150,,"BUCURESTI SECTORUL 2",291,"SCOALA NR. 25, DIN STR. SILVIA NR. 54",1988,1025,1011,14,0,1005,20,2200,1175,536,469,1,16971,0
43,"Sectorul 2",179150,"#N/A",179150,,"BUCURESTI SECTORUL 2",292,"SCOALA NR. 25, DIN STR. SILVIA NR. 54",1824,937,926,11,0,929,8,2000,1063,438,491,1,16971,0
43,"Sectorul 2",179150,"#N/A",179150,,"BUCURESTI SECTORUL 2",293,"SCOALA NR. 25, DIN STR. SILVIA NR. 54",1682,973,957,15,1,957,16,1801,828,448,509,1,16971,0
43,"Sectorul 2",179150,"#N/A",179150,,"BUCURESTI SECTORUL 2",294,"SCOALA  NR. 64, DIN BD. GARII OBOR NR. 16",1573,916,894,22,0,902,14,1600,684,453,449,1,16971,0
43,"Sectorul 2",179150,"#N/A",179150,,"BUCURESTI SECTORUL 2",295,"SCOALA  NR. 64, DIN BD. GARII OBOR NR. 16",1705,923,910,12,1,915,8,2000,1077,446,469,1,16971,0
43,"Sectorul 2",179150,"#N/A",179150,,"BUCURESTI SECTORUL 2",296,"SCOALA  NR. 64, DIN BD. GARII OBOR NR. 16",1319,759,748,11,0,746,13,1600,841,385,361,1,16971,0
43,"Sectorul 2",179150,"#N/A",179150,,"BUCURESTI SECTORUL 2",297,"SCOALA  NR. 64, DIN BD. GARII OBOR NR. 16",1859,977,965,12,0,964,13,2000,1023,516,448,1,16971,0
43,"Sectorul 2",179150,"#N/A",179150,,"BUCURESTI SECTORUL 2",298,"SCOALA  NR. 64, DIN BD. GARII OBOR NR. 16",1534,697,688,9,0,691,6,1600,903,350,341,1,16971,0
43,"Sectorul 2",179150,"#N/A",179150,,"BUCURESTI SECTORUL 2",299,"GRUP SCOLAR  ELECTRONICA INDUSTIALA, DIN SOS. PANTELIMON NR. 25",1765,975,964,11,0,962,13,2000,1025,463,499,1,16971,0
43,"Sectorul 2",179150,"#N/A",179150,,"BUCURESTI SECTORUL 2",300,"GRUP SCOLAR  ELECTRONICA INDUSTIALA, DIN SOS. PANTELIMON NR. 25",1725,993,983,10,0,975,18,1999,1006,483,492,1,16971,0
43,"Sectorul 2",179150,"#N/A",179150,,"BUCURESTI SECTORUL 2",301,"GRUP SCOLAR  ELECTRONICA INDUSTIALA, DIN SOS. PANTELIMON NR. 25",1400,823,815,8,0,815,8,1600,777,387,428,1,16971,0
43,"Sectorul 2",179150,"#N/A",179150,,"BUCURESTI SECTORUL 2",302,"COLEGIUL NATIONAL ""IULIA HASDEU"", DIN BD. FERDINAND I NR. 91",1560,938,925,13,0,924,14,1600,662,420,504,1,16971,0
43,"Sectorul 2",179150,"#N/A",179150,,"BUCURESTI SECTORUL 2",303,"COLEGIUL NATIONAL ""IULIA HASDEU"", DIN BD. FERDINAND I NR. 91",1684,953,930,23,0,933,20,1800,847,451,482,1,16971,0
43,"Sectorul 2",179150,"#N/A",179150,,"BUCURESTI SECTORUL 2",304,"COLEGIUL NATIONAL ""IULIA HASDEU"", DIN BD. FERDINAND I NR. 91",1680,918,901,17,0,896,22,1800,882,436,460,1,16971,0
43,"Sectorul 2",179150,"#N/A",179150,,"BUCURESTI SECTORUL 2",305,"GRUP SCOLAR  INDUSTRIAL MECANICA FINA, DIN STR. POPA LAZAR  NR. 6-8",1349,840,819,20,1,828,12,1600,760,414,414,1,16971,0
43,"Sectorul 2",179150,"#N/A",179150,,"BUCURESTI SECTORUL 2",306,"GRUP SCOLAR  INDUSTRIAL MECANICA FINA, DIN STR. POPA LAZAR  NR. 6-8",1367,762,753,9,0,751,11,1600,838,322,429,1,16971,0
43,"Sectorul 2",179150,"#N/A",179150,,"BUCURESTI SECTORUL 2",307,"GRUP SCOLAR  INDUSTRIAL MECANICA FINA, DIN STR. POPA LAZAR  NR. 6-8",1199,671,659,12,0,655,16,1600,929,328,327,1,16971,0
43,"Sectorul 2",179150,"#N/A",179150,,"BUCURESTI SECTORUL 2",308,"GRUP SCOLAR  INDUSTRIAL MECANICA FINA, DIN STR. POPA LAZAR  NR. 6-8",1710,995,978,15,2,982,13,2000,1005,470,512,1,16971,0
43,"Sectorul 2",179150,"#N/A",179150,,"BUCURESTI SECTORUL 2",309,"CLUB SPORTIV SCOALA NR. 2, DIN BD. FERDINAND I NR. 128",1623,941,929,12,0,929,12,1800,859,482,447,1,16971,0
43,"Sectorul 2",179150,"#N/A",179150,,"BUCURESTI SECTORUL 2",310,"CLUB SPORTIV SCOALA NR. 2, DIN BD. FERDINAND I NR. 128",1570,929,895,34,0,908,21,1600,671,420,488,1,16971,0
43,"Sectorul 2",179150,"#N/A",179150,,"BUCURESTI SECTORUL 2",311,"GRADINITA NR. 201, DIN STR. DRIDU GEORGESCU NR. 2",1596,859,840,19,0,846,13,1600,741,461,385,1,16971,0
43,"Sectorul 2",179150,"#N/A",179150,,"BUCURESTI SECTORUL 2",312,"GRADINITA NR. 201, DIN STR. DRIDU GEORGESCU NR. 2",1758,1081,1065,15,1,1064,17,2000,919,512,552,1,16971,0
43,"Sectorul 2",179150,"#N/A",179150,,"BUCURESTI SECTORUL 2",313,"GRADINITA NR. 201, DIN STR. DRIDU GEORGESCU NR. 2",1512,860,834,25,1,845,15,1600,740,394,451,1,16971,0
43,"Sectorul 2",179150,"#N/A",179150,,"BUCURESTI SECTORUL 2",314,"GRADINITA NR. 201, DIN STR. DRIDU GEORGESCU NR. 2",1400,831,821,10,0,818,13,1601,770,411,407,1,16971,0
43,"Sectorul 2",179150,"#N/A",179150,,"BUCURESTI SECTORUL 2",315,"COLEGIUL NATIONAL ""EMIL RACOVITA"", DIN SOS. MIHAI BRAVU NR. 169",1672,987,966,21,0,978,9,1800,813,393,585,1,16971,0
43,"Sectorul 2",179150,"#N/A",179150,,"BUCURESTI SECTORUL 2",316,"COLEGIUL NATIONAL ""EMIL RACOVITA"", DIN SOS. MIHAI BRAVU NR. 169",1201,771,751,20,0,760,11,1600,829,396,364,1,16971,0
43,"Sectorul 2",179150,"#N/A",179150,,"BUCURESTI SECTORUL 2",317,"COLEGIUL NATIONAL ""EMIL RACOVITA"", DIN SOS. MIHAI BRAVU NR. 169",1915,1089,1068,20,1,1073,16,2000,911,562,511,1,16971,0
43,"Sectorul 2",179150,"#N/A",179150,,"BUCURESTI SECTORUL 2",318,"GRADINITA  NR. 16, DIN SOS. IANCULUI  NR. 4-A",1433,878,863,15,0,870,8,1599,721,422,448,1,16971,0
43,"Sectorul 2",179150,"#N/A",179150,,"BUCURESTI SECTORUL 2",319,"GRADINITA  NR. 16, DIN SOS. IANCULUI  NR. 4-A",1318,818,806,11,1,805,13,1600,782,433,372,1,16971,0
43,"Sectorul 2",179150,"#N/A",179150,,"BUCURESTI SECTORUL 2",320,"GRADINITA NR. 256, DIN STR. ATANASE IONESCU NR. 25",1725,1103,1088,14,1,1086,17,2014,911,528,558,1,16971,0
43,"Sectorul 2",179150,"#N/A",179150,,"BUCURESTI SECTORUL 2",321,"SCOALA NR. 49, DIN STR. VATRA LUMINOASA NR. 99",1274,827,806,20,1,817,10,1600,773,361,456,1,16971,0
43,"Sectorul 2",179150,"#N/A",179150,,"BUCURESTI SECTORUL 2",322,"SCOALA NR. 49, DIN STR. VATRA LUMINOASA NR. 99",1253,792,781,11,0,780,12,1600,808,404,376,1,16971,0
43,"Sectorul 2",179150,"#N/A",179150,,"BUCURESTI SECTORUL 2",323,"SCOALA NR. 46, DIN STR. STANESCU GHEORGHE NR. 2-8",1514,852,841,10,1,834,18,1601,749,393,441,1,16971,0
43,"Sectorul 2",179150,"#N/A",179150,,"BUCURESTI SECTORUL 2",324,"SCOALA NR. 46, DIN STR. STANESCU GHEORGHE NR. 2-8",1736,968,957,11,0,956,12,2000,1032,405,551,1,16971,0
43,"Sectorul 2",179150,"#N/A",179150,,"BUCURESTI SECTORUL 2",325,"SCOALA NR. 46, DIN STR. STANESCU GHEORGHE NR. 2-8",1779,1032,1019,12,1,1020,12,2000,968,466,554,1,16971,0
43,"Sectorul 2",179150,"#N/A",179150,,"BUCURESTI SECTORUL 2",326,"SCOALA NR. 46, DIN STR. STANESCU GHEORGHE NR. 2-8",2069,1224,1203,21,0,1199,25,2197,973,594,605,1,16971,0
43,"Sectorul 2",179150,"#N/A",179150,,"BUCURESTI SECTORUL 2",327,"SCOALA NR. 19, DIN STR. TUDOR ARGHEZI NR. 46-50",1386,779,761,18,0,767,12,1600,821,409,358,1,16971,0
43,"Sectorul 2",179150,"#N/A",179150,,"BUCURESTI SECTORUL 2",328,"SCOALA NR. 19, DIN STR. TUDOR ARGHEZI NR. 46-50",1142,591,575,16,0,585,6,1200,609,247,338,1,16971,0
43,"Sectorul 2",179150,"#N/A",179150,,"BUCURESTI SECTORUL 2",329,"COLEGIUL NATIONAL ""SPIRU HARET"", DIN STR. ITALIANA NR. 17",1426,776,764,11,1,767,9,1600,824,382,385,1,16971,0
43,"Sectorul 2",179150,"#N/A",179150,,"BUCURESTI SECTORUL 2",330,"COLEGIUL NATIONAL ""SPIRU HARET"", DIN STR. ITALIANA NR. 17",1409,732,720,11,1,726,6,1600,868,369,357,1,16971,0
43,"Sectorul 2",179150,"#N/A",179150,,"BUCURESTI SECTORUL 2",331,"COLEGIUL NATIONAL ""CANTEMIR VODA"" , DIN STR. VIITORULUI NR. 60",1137,617,600,13,4,606,11,1200,583,305,301,1,16971,0
43,"Sectorul 2",179150,"#N/A",179150,,"BUCURESTI SECTORUL 2",332,"COLEGIUL NATIONAL ""CANTEMIR VODA"" , DIN STR. VIITORULUI NR. 6060",1425,829,799,29,1,817,12,1600,771,402,415,1,16971,0
43,"Sectorul 2",179150,"#N/A",179150,,"BUCURESTI SECTORUL 2",333,"COLEGIUL NATIONAL ""CANTEMIR VODA"" , DIN STR. VIITORULUI NR. 6060",1487,763,748,13,2,754,9,1600,837,390,364,1,16971,0
43,"Sectorul 2",179150,"#N/A",179150,,"BUCURESTI SECTORUL 2",334,"COLEGIUL NATIONAL ""CANTEMIR VODA"" , DIN STR. VIITORULUI NR. 6060",1754,912,895,16,1,894,18,2000,1088,451,443,1,16971,0
43,"Sectorul 2",179150,"#N/A",179150,,"BUCURESTI SECTORUL 2",335,"SCOALA NR. 24, DIN STR. TUNARI NR. 52",1962,1030,1011,19,0,1018,12,2200,1170,474,544,1,16971,0
43,"Sectorul 2",179150,"#N/A",179150,,"BUCURESTI SECTORUL 2",336,"SCOALA NR. 24, DIN STR. TUNARI NR. 52",1818,982,959,10,13,970,12,2000,1018,489,481,1,16971,0
43,"Sectorul 2",179150,"#N/A",179150,,"BUCURESTI SECTORUL 2",337,"SCOALA PENTRU HIPOACUZICI, DIN STR. BUSOLEI NR. 6",1454,758,739,19,0,746,12,1600,842,380,366,1,16971,0
43,"Sectorul 2",179150,"#N/A",179150,,"BUCURESTI SECTORUL 2",338,"SCOALA PENTRU HIPOACUZICI, DIN STR. BUSOLEI NR. 6",1479,807,785,22,0,785,22,1600,793,401,384,1,16971,0
43,"Sectorul 2",179150,"#N/A",179150,,"BUCURESTI SECTORUL 2",339,"SCOALA NR. 26, DIN STR. COBILITEI NR. 8",1279,656,647,8,1,650,6,1600,944,329,321,1,16971,0
43,"Sectorul 2",179150,"#N/A",179150,,"BUCURESTI SECTORUL 2",340,"SCOALA NR. 26, DIN STR. COBILITEI NR. 8",1501,891,860,31,0,881,10,1600,709,453,428,1,16971,0
43,"Sectorul 2",179150,"#N/A",179150,,"BUCURESTI SECTORUL 2",341,"SCOALA DE ARTE SI MESERII NR. 3, DIN STR. MARCEL IANCU NR. 7",1619,789,776,13,0,777,12,1800,1011,396,381,1,16971,0
43,"Sectorul 2",179150,"#N/A",179150,,"BUCURESTI SECTORUL 2",342,"SCOALA DE ARTE SI MESERII NR. 3, DIN STR. MARCEL IANCU NR. 7",1405,694,685,9,0,683,11,1600,906,308,375,1,16971,0
43,"Sectorul 2",179150,"#N/A",179150,,"BUCURESTI SECTORUL 2",343,"SCOALA NR. 307, DIN STR. LUNCSOARA NR. 17",1325,841,830,11,0,825,16,1599,758,438,387,1,16971,0
43,"Sectorul 2",179150,"#N/A",179150,,"BUCURESTI SECTORUL 2",344,"SCOALA NR. 307, DIN STR. LUNCSOARA NR. 17",1194,621,605,16,0,613,8,1200,579,305,308,1,16971,0
43,"Sectorul 2",179150,"#N/A",179150,,"BUCURESTI SECTORUL 2",345,"SCOALA NR. 307, DIN STR. LUNCSOARA NR. 17",1549,951,931,19,1,929,22,1800,849,462,467,1,16971,0
43,"Sectorul 2",179150,"#N/A",179150,,"BUCURESTI SECTORUL 2",346,"SCOALA NR. 71 ""IOVAN DUCICI"", DIN CALEA MOSILOR NR. 148",1719,826,810,15,1,815,11,2000,1174,424,391,1,16971,0
43,"Sectorul 2",179150,"#N/A",179150,,"BUCURESTI SECTORUL 2",347,"SCOALA NR. 71 ""IOVAN DUCICI"", DIN CALEA MOSILOR NR. 148",1641,846,833,13,0,833,13,1800,954,389,444,1,16971,0
43,"Sectorul 2",179150,"#N/A",179150,,"BUCURESTI SECTORUL 2",348,"COLEGIUL ECONOMIC ""A.D. XENOPOL"", DIN STR. TRAIAN NR. 165",1487,813,798,15,0,801,12,1600,787,393,408,1,16971,0
43,"Sectorul 2",179150,"#N/A",179150,,"BUCURESTI SECTORUL 2",349,"COLEGIUL ECONOMIC ""A.D. XENOPOL"", DIN STR. TRAIAN NR. 165",1192,610,595,15,0,602,8,1600,990,320,282,1,16971,0
43,"Sectorul 2",179150,"#N/A",179150,,"BUCURESTI SECTORUL 2",350,"COLEGIUL ECONOMIC ""A.D. XENOPOL"", DIN STR. TRAIAN NR. 165",1432,788,776,12,0,781,7,1600,812,375,406,1,16971,0
43,"Sectorul 2",179150,"#N/A",179150,,"BUCURESTI SECTORUL 2",351,"COLEGIUL ECONOMIC ""A.D. XENOPOL"", DIN STR. TRAIAN NR. 165",1544,773,764,8,1,762,11,1800,1027,372,390,1,16971,0
43,"Sectorul 2",179150,"#N/A",179150,,"BUCURESTI SECTORUL 2",352,"COLEGIUL NATIONAL ""GEORGE COSBUC"", DIN STR. OLARI NR. 29-31",1694,947,934,12,1,929,18,1798,851,456,473,1,16971,0
43,"Sectorul 2",179150,"#N/A",179150,,"BUCURESTI SECTORUL 2",353,"COLEGIUL NATIONAL ""GEORGE COSBUC"", DIN STR. OLARI NR. 29-31",1812,954,936,17,1,937,17,2000,1046,431,506,1,16971,0
43,"Sectorul 2",179150,"#N/A",179150,,"BUCURESTI SECTORUL 2",354,"SCOALA NR. 50, DIN STR. ION MAIORESCU NR. 32",1646,1034,1026,7,1,1022,12,1800,766,483,539,1,16971,0
43,"Sectorul 2",179150,"#N/A",179150,,"BUCURESTI SECTORUL 2",355,"SCOALA NR. 50, DIN STR. ION MAIORESCU NR. 32",1625,1004,988,16,0,986,18,1800,796,535,451,1,16971,0
43,"Sectorul 2",179150,"#N/A",179150,,"BUCURESTI SECTORUL 2",356,"SCOALA NR. 50, DIN STR. ION MAIORESCU NR. 32",1909,1072,1063,8,1,1061,11,2000,928,520,541,1,16971,0
43,"Sectorul 2",179150,"#N/A",179150,,"BUCURESTI SECTORUL 2",357,"COLEGIUL NATIONAL ""MIHAI VITEAZUL"", DIN BD. PACHE  PROTOPOPESCU NR. 62",1851,931,914,16,1,916,15,2000,1069,441,475,1,16971,0
43,"Sectorul 2",179150,"#N/A",179150,,"BUCURESTI SECTORUL 2",358,"COLEGIUL NATIONAL ""MIHAI VITEAZUL"", DIN BD. PACHE  PROTOPOPESCU NR. 62",1676,880,865,15,0,864,16,1800,920,409,455,1,16971,0
43,"Sectorul 2",179150,"#N/A",179150,,"BUCURESTI SECTORUL 2",359,"SCOALA NR. 56 ""JOSE MARTI"", DIN BD. PACHE  PROTOPOPESCU NR. 109",1588,938,917,21,0,925,13,1800,862,462,463,1,16971,0
43,"Sectorul 2",179150,"#N/A",179150,,"BUCURESTI SECTORUL 2",360,"SCOALA NR. 56 ""JOSE MARTI"", DIN BD. PACHE  PROTOPOPESCU NR. 109",1346,749,732,16,1,739,10,1600,851,367,372,1,16971,0
43,"Sectorul 2",179150,"#N/A",179150,,"BUCURESTI SECTORUL 2",361,"SCOLA NR. 85 ""VASILE BUNESCU"", DIN STR. MEDIC ZLATESCU NR. 7A",1102,640,623,16,1,627,13,1200,560,321,306,1,16971,0
43,"Sectorul 2",179150,"#N/A",179150,,"BUCURESTI SECTORUL 2",362,"SCOLA NR. 85 ""VASILE BUNESCU"", DIN STR. MEDIC ZLATESCU NR. 7A",1440,727,711,16,0,716,11,1600,873,323,393,1,16971,0
43,"Sectorul 2",179150,"#N/A",179150,,"BUCURESTI SECTORUL 2",363,"SCOLA NR. 85 ""VASILE BUNESCU"", DIN STR. MEDIC ZLATESCU NR. 7A",1368,781,758,22,1,760,21,1600,819,292,468,1,16971,0
43,"Sectorul 2",179150,"#N/A",179150,,"BUCURESTI SECTORUL 2",364,"SCOLA NR. 85 ""VASILE BUNESCU"", DIN STR. MEDIC ZLATESCU NR. 7A",1254,782,777,5,0,770,12,1592,810,316,454,1,16971,0
43,"Sectorul 2",179150,"#N/A",179150,,"BUCURESTI SECTORUL 2",365,"SCOLA NR. 85 ""VASILE BUNESCU"", DIN STR. POPA  NAN  NR. 47B",1406,678,662,16,0,666,12,1600,922,335,331,1,16971,0
43,"Sectorul 2",179150,"#N/A",179150,,"BUCURESTI SECTORUL 2",366,"SCOLA NR. 85 ""VASILE BUNESCU"", DIN STR. POPA  NAN  NR. 47B",1604,788,777,11,0,772,16,1699,911,376,396,1,16971,0
43,"Sectorul 2",179150,"#N/A",179150,,"BUCURESTI SECTORUL 2",367,"GARA DE EST (OBOR), DIN B-DUL GARII OBOR NR. 1, SECTOR 2",0,1415,0,1415,0,1407,8,2025,610,876,531,1,16971,1
43,"Sectorul 2",179150,"#N/A",179150,,"BUCURESTI SECTORUL 2",368,"CAMINUL DE STUDENTI NR. 3 - UNIVERSITATEA TEHNICA DE CONSTRUCTII BUCURESTI, DIN STR.INGINERILOR NR.29",0,1563,0,1563,0,1541,22,2000,437,951,590,1,16971,1
43,"Sectorul 2",179150,"#N/A",179150,,"BUCURESTI SECTORUL 2",369,"CAMINUL DE STUDENTI NR. 4 - UNIVERSITATEA TEHNICA DE CONSTRUCTII BUCURESTI, DIN STR.INGINERILOR NR.11",0,1413,0,1413,0,1384,29,2000,587,773,611,1,16971,1
44,"Sectorul 3",179169,"#N/A",179169,,"BUCURESTI SECTORUL 3",370,"SCOALA SUPERIOARA COMERCIALA ""N. KRETZULESCU"", DIN B-DUL HRISTO BOTEV NR. 17",1182,540,529,11,0,527,13,1298,758,229,298,1,16972,0
44,"Sectorul 3",179169,"#N/A",179169,,"BUCURESTI SECTORUL 3",371,"SCOALA SUPERIOARA COMERCIALA ""N. KRETZULESCU"", DIN B-DUL HRISTO BOTEV NR. 17",1355,451,437,14,0,449,2,1494,1043,224,225,1,16972,0
44,"Sectorul 3",179169,"#N/A",179169,,"BUCURESTI SECTORUL 3",372,"SCOALA SUPERIOARA COMERCIALA ""N. KRETZULESCU"", DIN B-DUL HRISTO BOTEV NR. 17",1192,534,525,9,0,524,10,1297,763,218,306,1,16972,0
44,"Sectorul 3",179169,"#N/A",179169,,"BUCURESTI SECTORUL 3",373,"SCOALA SUPERIOARA COMERCIALA ""N. KRETZULESCU"", DIN B-DUL HRISTO BOTEV NR. 17",1530,631,612,14,5,619,12,1700,1069,316,303,1,16972,0
44,"Sectorul 3",179169,"#N/A",179169,,"BUCURESTI SECTORUL 3",374,"SCOALA SUPERIOARA COMERCIALA ""N. KRETZULESCU"", DIN B-DUL HRISTO BOTEV NR. 17",1383,588,579,9,0,579,9,1500,912,314,265,1,16972,0
44,"Sectorul 3",179169,"#N/A",179169,,"BUCURESTI SECTORUL 3",375,"GRUP SCOLAR INDUSTRIAL ""UNIREA"", DIN STR. ZBORULUI NR. 7-9",1688,898,880,18,0,887,11,1900,1002,438,449,1,16972,0
44,"Sectorul 3",179169,"#N/A",179169,,"BUCURESTI SECTORUL 3",376,"SCOALA GENERALA NR. 73, DIN STR. MATEI BASARAB NR. 28",1523,916,900,16,0,897,19,1700,784,331,566,1,16972,0
44,"Sectorul 3",179169,"#N/A",179169,,"BUCURESTI SECTORUL 3",377,"SCOALA GENERALA NR. 73, DIN STR. MATEI BASARAB NR. 28",1502,694,671,21,2,679,15,1700,1006,336,343,1,16972,0
44,"Sectorul 3",179169,"#N/A",179169,,"BUCURESTI SECTORUL 3",378,"COLEGIUL NATIONAL  ""MATEI BASARAB"", DIN STR. MATEI BASARAB NR. 32",1621,743,729,14,0,736,7,1800,1057,340,396,1,16972,0
44,"Sectorul 3",179169,"#N/A",179169,,"BUCURESTI SECTORUL 3",379,"COLEGIUL NATIONAL  ""MATEI BASARAB"", DIN STR. MATEI BASARAB NR. 32",1569,800,788,12,0,783,17,1700,900,312,471,1,16972,0
44,"Sectorul 3",179169,"#N/A",179169,,"BUCURESTI SECTORUL 3",380,"COLEGIUL NATIONAL  ""MATEI BASARAB"", DIN STR. MATEI BASARAB NR. 32",1550,755,733,22,0,745,10,1700,945,311,434,1,16972,0
44,"Sectorul 3",179169,"#N/A",179169,,"BUCURESTI SECTORUL 3",381,"SCOALA SPECIALA NR. 5, DIN STR. TURTURELELOR NR.13",1299,749,730,19,0,740,9,1400,651,309,431,1,16972,0
44,"Sectorul 3",179169,"#N/A",179169,,"BUCURESTI SECTORUL 3",382,"SCOALA SPECIALA NR. 5, DIN STR. TURTURELELOR NR.13",1593,699,683,16,0,689,10,1800,1101,337,352,1,16972,0
44,"Sectorul 3",179169,"#N/A",179169,,"BUCURESTI SECTORUL 3",383,"SCOALA SPECIALA NR. 5, DIN STR. TURTURELELOR NR.13",1029,593,581,12,0,581,12,1100,507,241,340,1,16972,0
44,"Sectorul 3",179169,"#N/A",179169,,"BUCURESTI SECTORUL 3",384,"SCOALA SPECIALA NR. 5, DIN STR. TURTURELELOR NR.13",1370,668,655,13,0,661,7,1500,832,282,379,1,16972,0
44,"Sectorul 3",179169,"#N/A",179169,,"BUCURESTI SECTORUL 3",385,"SCOALA SPECIALA NR. 5, DIN STR. TURTURELELOR NR.13",1306,663,651,12,0,656,7,1400,737,281,375,1,16972,0
44,"Sectorul 3",179169,"#N/A",179169,,"BUCURESTI SECTORUL 3",386,"SCOALA SPECIALA NR. 5, DIN STR. TURTURELELOR NR.13",1541,731,704,25,2,719,12,1700,969,395,324,1,16972,0
44,"Sectorul 3",179169,"#N/A",179169,,"BUCURESTI SECTORUL 3",387,"SCOALA SPECIALA NR. 5, DIN STR. TURTURELELOR NR.13",1133,537,522,15,0,530,7,1300,763,248,282,1,16972,0
44,"Sectorul 3",179169,"#N/A",179169,,"BUCURESTI SECTORUL 3",388,"SCOALA GENERALA NR. 70, DIN INTR. TIGLINA NR. 37",1458,826,812,14,0,814,12,1600,774,368,446,1,16972,0
44,"Sectorul 3",179169,"#N/A",179169,,"BUCURESTI SECTORUL 3",389,"SCOALA GENERALA NR. 70, DIN INTR. TIGLINA NR. 37",1459,888,870,18,0,869,19,1600,712,393,476,1,16972,0
44,"Sectorul 3",179169,"#N/A",179169,,"BUCURESTI SECTORUL 3",390,"SCOALA GENERALA NR. 70, DIN INTR. TIGLINA NR. 37",1436,897,882,13,2,895,2,1600,703,412,483,1,16972,0
44,"Sectorul 3",179169,"#N/A",179169,,"BUCURESTI SECTORUL 3",391,"SCOALA GENERALA NR. 70, DIN INTR. TIGLINA NR. 37",1472,861,845,16,0,849,12,1600,739,421,428,1,16972,0
44,"Sectorul 3",179169,"#N/A",179169,,"BUCURESTI SECTORUL 3",392,"SCOALA GENERALA NR. 70, DIN INTR. TIGLINA NR. 37",1437,877,868,9,0,859,18,1635,758,375,484,1,16972,0
44,"Sectorul 3",179169,"#N/A",179169,,"BUCURESTI SECTORUL 3",393,"SCOALA GENERALA NR. 70, DIN INTR. TIGLINA NR. 37",1467,829,810,19,0,817,12,1600,771,392,425,1,16972,0
44,"Sectorul 3",179169,"#N/A",179169,,"BUCURESTI SECTORUL 3",394,"SCOALA GENERALA NR. 70, DIN INTR. TIGLINA NR. 37",1569,919,904,15,0,900,19,1698,779,447,453,1,16972,0
44,"Sectorul 3",179169,"#N/A",179169,,"BUCURESTI SECTORUL 3",395,"SCOALA GENERALA NR. 70, DIN INTR. TIGLINA NR. 37",1555,915,899,15,1,900,15,1700,785,388,512,1,16972,0
44,"Sectorul 3",179169,"#N/A",179169,,"BUCURESTI SECTORUL 3",396,"SCOALA GENERALA NR. 80, DIN CALEA DUDESTI NR. 191",1473,802,788,14,0,786,16,1600,798,361,425,1,16972,0
44,"Sectorul 3",179169,"#N/A",179169,,"BUCURESTI SECTORUL 3",397,"SCOALA GENERALA NR. 80, DIN CALEA DUDESTI NR. 191",1522,775,749,26,0,761,14,1700,925,359,402,1,16972,0
44,"Sectorul 3",179169,"#N/A",179169,,"BUCURESTI SECTORUL 3",398,"SCOALA GENERALA NR. 80, DIN CALEA DUDESTI NR. 191",1565,855,832,23,0,845,10,1703,848,407,438,1,16972,0
44,"Sectorul 3",179169,"#N/A",179169,,"BUCURESTI SECTORUL 3",399,"SCOALA GENERALA NR. 80, DIN CALEA DUDESTI NR. 191",1668,962,943,18,1,944,18,1800,838,467,477,1,16972,0
44,"Sectorul 3",179169,"#N/A",179169,,"BUCURESTI SECTORUL 3",400,"SCOALA GENERALA NR. 80, DIN CALEA DUDESTI NR. 191",1152,660,648,11,1,643,17,1300,640,315,328,1,16972,0
44,"Sectorul 3",179169,"#N/A",179169,,"BUCURESTI SECTORUL 3",401,"SCOALA GENERALA NR. 80, DIN CALEA DUDESTI NR. 191",1193,662,653,9,0,654,8,1300,638,332,322,1,16972,0
44,"Sectorul 3",179169,"#N/A",179169,,"BUCURESTI SECTORUL 3",402,"SCOALA GENERALA NR. 80, DIN CALEA DUDESTI NR. 191",1017,535,525,10,0,528,7,1100,565,284,244,1,16972,0
44,"Sectorul 3",179169,"#N/A",179169,,"BUCURESTI SECTORUL 3",403,"SCOALA GENERALA NR. 80, DIN CALEA DUDESTI NR. 191",1156,622,606,16,0,610,12,1300,678,286,324,1,16972,0
44,"Sectorul 3",179169,"#N/A",179169,,"BUCURESTI SECTORUL 3",404,"GRUP SCOLAR ""TIMPURI NOI"", DIN SOS. MIHAI BRAVU NR. 428 CORP.""B""",1380,543,533,10,0,537,6,1500,957,279,258,1,16972,0
44,"Sectorul 3",179169,"#N/A",179169,,"BUCURESTI SECTORUL 3",405,"GRUP SCOLAR ""TIMPURI NOI"", DIN SOS. MIHAI BRAVU NR. 428 CORP.""B""",1488,772,757,15,0,759,13,1600,828,358,401,1,16972,0
44,"Sectorul 3",179169,"#N/A",179169,,"BUCURESTI SECTORUL 3",406,"GRUP SCOLAR ""TIMPURI NOI"", DIN SOS. MIHAI BRAVU NR. 428 CORP.""B""",1299,720,702,18,0,714,6,1400,680,317,397,1,16972,0
44,"Sectorul 3",179169,"#N/A",179169,,"BUCURESTI SECTORUL 3",407,"SCOALA GENERALA NR. 81, DIN STR. NERVA TRAIAN NR. 33",1411,866,844,22,0,854,12,1600,734,351,503,1,16972,0
44,"Sectorul 3",179169,"#N/A",179169,,"BUCURESTI SECTORUL 3",408,"SCOALA GENERALA NR. 81, DIN STR. NERVA TRAIAN NR. 33",1312,689,675,14,0,679,10,1500,811,340,339,1,16972,0
44,"Sectorul 3",179169,"#N/A",179169,,"BUCURESTI SECTORUL 3",409,"SCOALA GENERALA NR. 81, DIN STR. NERVA TRAIAN NR. 33",1415,759,748,11,0,750,9,1600,841,410,340,1,16972,0
44,"Sectorul 3",179169,"#N/A",179169,,"BUCURESTI SECTORUL 3",410,"SCOALA GENERALA NR. 81, DIN STR. NERVA TRAIAN NR. 33",1413,739,725,14,0,729,10,1600,861,387,342,1,16972,0
44,"Sectorul 3",179169,"#N/A",179169,,"BUCURESTI SECTORUL 3",411,"SCOALA GENERALA NR. 81, DIN STR. NERVA TRAIAN NR. 33",1197,751,738,13,0,736,15,1300,549,320,416,1,16972,0
44,"Sectorul 3",179169,"#N/A",179169,,"BUCURESTI SECTORUL 3",412,"SCOALA GENERALA NR. 81, DIN STR. NERVA TRAIAN NR. 33",1257,691,674,17,0,683,8,1400,709,302,381,1,16972,0
44,"Sectorul 3",179169,"#N/A",179169,,"BUCURESTI SECTORUL 3",413,"SCOALA GENERALA NR. 81, DIN STR. NERVA TRAIAN NR. 33",1560,853,844,9,0,838,15,1700,847,383,455,1,16972,0
44,"Sectorul 3",179169,"#N/A",179169,,"BUCURESTI SECTORUL 3",414,"SCOALA GENERALA NR. 81, DIN STR. NERVA TRAIAN NR. 33",1455,809,795,14,0,792,17,1600,791,394,398,1,16972,0
44,"Sectorul 3",179169,"#N/A",179169,,"BUCURESTI SECTORUL 3",415,"SCOALA GENERALA NR. 81, DIN STR. NERVA TRAIAN NR. 33",1259,725,705,20,0,710,15,1400,675,358,352,1,16972,0
44,"Sectorul 3",179169,"#N/A",179169,,"BUCURESTI SECTORUL 3",416,"SCOALA GENERALA NR. 95, DIN STR. FOISORULUI NR. 111-113",1413,751,733,18,0,737,14,1600,849,332,405,1,16972,0
44,"Sectorul 3",179169,"#N/A",179169,,"BUCURESTI SECTORUL 3",417,"SCOALA GENERALA NR. 95, DIN STR. FOISORULUI NR. 111-113",1203,555,545,9,1,547,8,1299,744,308,239,1,16972,0
44,"Sectorul 3",179169,"#N/A",179169,,"BUCURESTI SECTORUL 3",418,"SCOALA GENERALA NR. 95, DIN STR. FOISORULUI NR. 111-113",1266,515,489,25,1,514,1,1398,883,288,226,1,16972,0
44,"Sectorul 3",179169,"#N/A",179169,,"BUCURESTI SECTORUL 3",419,"SCOALA GENERALA NR. 95, DIN STR. FOISORULUI NR. 111-113",1147,541,535,6,0,532,9,1300,759,278,254,1,16972,0
44,"Sectorul 3",179169,"#N/A",179169,,"BUCURESTI SECTORUL 3",420,"SCOALA GENERALA NR. 95, DIN STR. FOISORULUI NR. 111-113",1531,820,798,22,0,810,10,1700,880,387,423,1,16972,0
44,"Sectorul 3",179169,"#N/A",179169,,"BUCURESTI SECTORUL 3",421,"SCOALA GENERALA NR. 95, DIN STR. FOISORULUI NR. 111-113",1258,526,496,30,0,519,7,1400,874,277,242,1,16972,0
44,"Sectorul 3",179169,"#N/A",179169,,"BUCURESTI SECTORUL 3",422,"SCOALA GENERALA NR. 95, DIN STR. FOISORULUI NR. 111-113",1370,736,720,16,0,716,20,1500,764,374,342,1,16972,0
44,"Sectorul 3",179169,"#N/A",179169,,"BUCURESTI SECTORUL 3",423,"SCOALA GENERALA NR. 95, DIN STR. FOISORULUI NR. 111-113",1464,820,809,11,0,808,12,1600,780,388,420,1,16972,0
44,"Sectorul 3",179169,"#N/A",179169,,"BUCURESTI SECTORUL 3",424,"SCOALA GENERALA NR. 95, DIN STR. FOISORULUI NR. 111-113",1618,842,829,13,0,823,19,1801,959,409,414,1,16972,0
44,"Sectorul 3",179169,"#N/A",179169,,"BUCURESTI SECTORUL 3",425,"SCOALA GENERALA NR. 95, DIN STR. FOISORULUI NR. 111-113",1490,772,762,10,0,764,8,1600,828,410,354,1,16972,0
44,"Sectorul 3",179169,"#N/A",179169,,"BUCURESTI SECTORUL 3",426,"SCOALA GENERALA NR. 84, DIN CALEA VITAN NR. 135",1102,570,556,13,1,562,8,1200,630,299,263,1,16972,0
44,"Sectorul 3",179169,"#N/A",179169,,"BUCURESTI SECTORUL 3",427,"SCOALA GENERALA NR. 84, DIN CALEA VITAN NR. 135",1431,621,612,9,0,618,3,1600,979,335,283,1,16972,0
44,"Sectorul 3",179169,"#N/A",179169,,"BUCURESTI SECTORUL 3",428,"SCOALA GENERALA NR. 84, DIN CALEA VITAN NR. 135",1580,751,728,23,0,739,12,1700,949,389,350,1,16972,0
44,"Sectorul 3",179169,"#N/A",179169,,"BUCURESTI SECTORUL 3",429,"SCOALA GENERALA NR. 84, DIN CALEA VITAN NR. 135",1460,739,722,14,3,727,12,1599,860,364,363,1,16972,0
44,"Sectorul 3",179169,"#N/A",179169,,"BUCURESTI SECTORUL 3",430,"SCOALA GENERALA NR. 84, DIN CALEA VITAN NR. 135",1654,821,805,16,0,815,6,1800,979,389,426,1,16972,0
44,"Sectorul 3",179169,"#N/A",179169,,"BUCURESTI SECTORUL 3",431,"SCOALA GENERALA NR. 84, DIN CALEA VITAN NR. 135",1496,820,804,15,1,808,12,1700,880,427,381,1,16972,0
44,"Sectorul 3",179169,"#N/A",179169,,"BUCURESTI SECTORUL 3",432,"GRUP SCOLAR CONSTRUCTII MONTAJ ""M. BRAVU"", DIN SOS. MIHAI BRAVU NR. 428 CORP ""A""",1643,888,875,13,0,877,11,1800,912,394,483,1,16972,0
44,"Sectorul 3",179169,"#N/A",179169,,"BUCURESTI SECTORUL 3",433,"GRUP SCOLAR CONSTRUCTII MONTAJ ""M. BRAVU"", DIN SOS. MIHAI BRAVU NR. 428 CORP ""A""",1162,578,566,12,0,566,12,1300,722,258,308,1,16972,0
44,"Sectorul 3",179169,"#N/A",179169,,"BUCURESTI SECTORUL 3",434,"GRUP SCOLAR CONSTRUCTII MONTAJ ""M. BRAVU"", DIN SOS. MIHAI BRAVU NR. 428 CORP ""A""",1586,856,841,15,0,842,14,1800,944,457,385,1,16972,0
44,"Sectorul 3",179169,"#N/A",179169,,"BUCURESTI SECTORUL 3",435,"GRUP SCOLAR CONSTRUCTII MONTAJ ""M. BRAVU"", DIN SOS. MIHAI BRAVU NR. 428 CORP ""A""",1389,729,713,15,1,718,11,1500,771,339,379,1,16972,0
44,"Sectorul 3",179169,"#N/A",179169,,"BUCURESTI SECTORUL 3",436,"GRUP SCOLAR CONSTRUCTII MONTAJ ""M. BRAVU"", DIN SOS. MIHAI BRAVU NR. 428 CORP ""A""",1322,757,742,15,0,746,11,1500,743,341,405,1,16972,0
44,"Sectorul 3",179169,"#N/A",179169,,"BUCURESTI SECTORUL 3",437,"GRUP SCOLAR CONSTRUCTII MONTAJ ""M. BRAVU"", DIN SOS. MIHAI BRAVU NR. 428 CORP ""A""",1378,738,728,10,0,730,8,1500,762,344,386,1,16972,0
44,"Sectorul 3",179169,"#N/A",179169,,"BUCURESTI SECTORUL 3",438,"GRUP SCOLAR CONSTRUCTII MONTAJ ""M. BRAVU"", DIN SOS. MIHAI BRAVU NR. 428 CORP ""A""",1490,810,794,16,0,798,12,1600,790,397,401,1,16972,0
44,"Sectorul 3",179169,"#N/A",179169,,"BUCURESTI SECTORUL 3",439,"GRUP SCOLAR CONSTRUCTII MONTAJ ""M. BRAVU"", DIN SOS. MIHAI BRAVU NR. 428 CORP ""A""",1238,651,636,15,0,638,13,1400,749,308,330,1,16972,0
44,"Sectorul 3",179169,"#N/A",179169,,"BUCURESTI SECTORUL 3",440,"GRUP SCOLAR CONSTRUCTII MONTAJ ""M. BRAVU"", DIN SOS. MIHAI BRAVU NR. 428 CORP ""A""",1514,707,699,8,0,699,8,1700,993,384,315,1,16972,0
44,"Sectorul 3",179169,"#N/A",179169,,"BUCURESTI SECTORUL 3",441,"GRUP SCOLAR CONSTRUCTII MONTAJ ""M. BRAVU"", DIN SOS. MIHAI BRAVU NR. 428 CORP ""A""",1229,707,649,58,0,700,7,1399,692,328,372,1,16972,0
44,"Sectorul 3",179169,"#N/A",179169,,"BUCURESTI SECTORUL 3",442,"SCOALA GENERALA NR. 86, DIN INTR. RECONSTRUCTIEI NR. 6A",1425,793,780,13,0,774,19,1600,807,427,347,1,16972,0
44,"Sectorul 3",179169,"#N/A",179169,,"BUCURESTI SECTORUL 3",443,"SCOALA GENERALA NR. 86, DIN INTR. RECONSTRUCTIEI NR. 6A",1605,926,912,14,0,910,16,1662,736,456,454,1,16972,0
44,"Sectorul 3",179169,"#N/A",179169,,"BUCURESTI SECTORUL 3",444,"SCOALA GENERALA NR. 86, DIN INTR. RECONSTRUCTIEI NR. 6A",1753,1031,1019,9,3,1017,14,1900,869,473,544,1,16972,0
44,"Sectorul 3",179169,"#N/A",179169,,"BUCURESTI SECTORUL 3",445,"SCOALA GENERALA NR. 86, DIN INTR. RECONSTRUCTIEI NR. 6A",1696,1009,991,18,0,992,17,1900,891,525,467,1,16972,0
44,"Sectorul 3",179169,"#N/A",179169,,"BUCURESTI SECTORUL 3",446,"SCOALA GENERALA NR. 86, DIN INTR. RECONSTRUCTIEI NR. 6A",1749,902,888,14,0,891,11,1900,998,466,425,1,16972,0
44,"Sectorul 3",179169,"#N/A",179169,,"BUCURESTI SECTORUL 3",447,"SCOALA GENERALA NR. 86, DIN INTR. RECONSTRUCTIEI NR. 6A",1419,787,775,12,0,774,13,1600,813,375,399,1,16972,0
44,"Sectorul 3",179169,"#N/A",179169,,"BUCURESTI SECTORUL 3",448,"SCOALA GENERALA NR. 86, DIN INTR. RECONSTRUCTIEI NR. 6A",1720,1001,980,21,0,989,12,1900,899,506,483,1,16972,0
44,"Sectorul 3",179169,"#N/A",179169,,"BUCURESTI SECTORUL 3",449,"GRUP SCOLAR INDUSTRIAL ""N. TECLU"", DIN STR. ION TUCULESCU (FOSTA  STR. STEJARULUI) NR. 42",1513,845,828,17,0,833,12,1700,855,442,391,1,16972,0
44,"Sectorul 3",179169,"#N/A",179169,,"BUCURESTI SECTORUL 3",450,"GRUP SCOLAR INDUSTRIAL ""N. TECLU"", DIN STR. ION TUCULESCU (FOSTA  STR. STEJARULUI) NR. 42",1408,764,749,14,1,753,11,1600,836,386,367,1,16972,0
44,"Sectorul 3",179169,"#N/A",179169,,"BUCURESTI SECTORUL 3",451,"GRUP SCOLAR INDUSTRIAL ""N. TECLU"", DIN STR. ION TUCULESCU (FOSTA  STR. STEJARULUI) NR. 42",1459,811,797,13,1,796,15,1600,789,414,382,1,16972,0
44,"Sectorul 3",179169,"#N/A",179169,,"BUCURESTI SECTORUL 3",452,"GRUP SCOLAR INDUSTRIAL ""N. TECLU"", DIN STR. ION TUCULESCU (FOSTA  STR. STEJARULUI) NR. 42",1364,836,823,13,0,823,13,1500,664,416,407,1,16972,0
44,"Sectorul 3",179169,"#N/A",179169,,"BUCURESTI SECTORUL 3",453,"GRUP SCOLAR INDUSTRIAL ""N. TECLU"", DIN STR. ION TUCULESCU (FOSTA  STR. STEJARULUI) NR. 42",1296,754,737,17,0,747,7,1400,646,406,341,1,16972,0
44,"Sectorul 3",179169,"#N/A",179169,,"BUCURESTI SECTORUL 3",454,"SCOALA GENERALA NR. 75, DIN STR. GHE. PETRASCU (FOSTA STR. CAPORAL RUICA)  NR. 49",1213,710,695,14,1,699,11,1300,590,353,346,1,16972,0
44,"Sectorul 3",179169,"#N/A",179169,,"BUCURESTI SECTORUL 3",455,"SCOALA GENERALA NR. 75, DIN STR. GHE. PETRASCU (FOSTA STR. CAPORAL RUICA)  NR. 49",1225,736,722,14,0,726,10,1400,664,370,356,1,16972,0
44,"Sectorul 3",179169,"#N/A",179169,,"BUCURESTI SECTORUL 3",456,"SCOALA GENERALA NR. 75, DIN STR. GHE. PETRASCU (FOSTA STR. CAPORAL RUICA)  NR. 49",1129,676,665,11,0,662,14,1193,517,331,331,1,16972,0
44,"Sectorul 3",179169,"#N/A",179169,,"BUCURESTI SECTORUL 3",457,"SCOALA GENERALA NR. 75, DIN STR. GHE. PETRASCU (FOSTA STR. CAPORAL RUICA)  NR. 49",1227,717,708,9,0,705,12,1400,683,361,344,1,16972,0
44,"Sectorul 3",179169,"#N/A",179169,,"BUCURESTI SECTORUL 3",458,"LICEUL TEORETIC ""BENJAMIN FRANKLIN"", DIN STR. PICTOR GHEORGHE TATTARESCU NR. 1",1332,749,740,9,0,738,11,1499,750,366,372,1,16972,0
44,"Sectorul 3",179169,"#N/A",179169,,"BUCURESTI SECTORUL 3",459,"LICEUL TEORETIC ""BENJAMIN FRANKLIN"", DIN STR. PICTOR GHEORGHE TATTARESCU NR. 1",1114,571,557,14,0,558,13,1196,625,305,253,1,16972,0
44,"Sectorul 3",179169,"#N/A",179169,,"BUCURESTI SECTORUL 3",460,"LICEUL TEORETIC ""BENJAMIN FRANKLIN"", DIN STR. PICTOR GHEORGHE TATTARESCU NR. 1",1043,589,579,10,0,578,11,1194,605,314,264,1,16972,0
44,"Sectorul 3",179169,"#N/A",179169,,"BUCURESTI SECTORUL 3",461,"LICEUL TEORETIC ""BENJAMIN FRANKLIN"", DIN STR. PICTOR GHEORGHE TATTARESCU NR. 1",1196,709,698,11,0,698,11,1300,591,326,372,1,16972,0
44,"Sectorul 3",179169,"#N/A",179169,,"BUCURESTI SECTORUL 3",462,"SCOALA GENERALA NR. 199, DIN B-DUL NICOLAE GRIGORESCU NR. 14",1268,708,692,16,0,694,14,1400,692,368,326,1,16972,0
44,"Sectorul 3",179169,"#N/A",179169,,"BUCURESTI SECTORUL 3",463,"SCOALA GENERALA NR. 199, DIN B-DUL NICOLAE GRIGORESCU NR. 14",1512,861,847,14,0,852,9,1700,839,457,395,1,16972,0
44,"Sectorul 3",179169,"#N/A",179169,,"BUCURESTI SECTORUL 3",464,"SCOALA GENERALA NR. 199, DIN B-DUL NICOLAE GRIGORESCU NR. 14",1694,898,880,18,0,887,11,1900,1002,461,426,1,16972,0
44,"Sectorul 3",179169,"#N/A",179169,,"BUCURESTI SECTORUL 3",465,"SCOALA GENERALA NR. 199, DIN B-DUL NICOLAE GRIGORESCU NR. 14",1336,806,791,15,0,790,16,1500,694,400,390,1,16972,0
44,"Sectorul 3",179169,"#N/A",179169,,"BUCURESTI SECTORUL 3",466,"SCOALA GENERALA NR. 199, DIN B-DUL NICOLAE GRIGORESCU NR. 14",1120,563,545,18,0,552,11,1200,637,283,269,1,16972,0
44,"Sectorul 3",179169,"#N/A",179169,,"BUCURESTI SECTORUL 3",467,"GRUP SCOLAR CONSTRUCTII ""A. SALIGNY"", DIN B-DUL NICOLAE GRIGORESCU NR. 12",1344,749,733,16,0,735,14,1500,751,379,356,1,16972,0
44,"Sectorul 3",179169,"#N/A",179169,,"BUCURESTI SECTORUL 3",468,"GRUP SCOLAR CONSTRUCTII ""A. SALIGNY"", DIN B-DUL NICOLAE GRIGORESCU NR. 12",1150,706,687,19,0,694,12,1300,594,358,336,1,16972,0
44,"Sectorul 3",179169,"#N/A",179169,,"BUCURESTI SECTORUL 3",469,"SCOALA GENERALA NR. 88, DIN STR. ODOBESTI NR. 3",1508,856,837,18,1,845,11,1700,844,445,400,1,16972,0
44,"Sectorul 3",179169,"#N/A",179169,,"BUCURESTI SECTORUL 3",470,"SCOALA GENERALA NR. 88, DIN STR. ODOBESTI NR. 3",1521,834,821,11,2,821,13,1700,866,413,408,1,16972,0
44,"Sectorul 3",179169,"#N/A",179169,,"BUCURESTI SECTORUL 3",471,"SCOALA GENERALA NR. 88, DIN STR. ODOBESTI NR. 3",1449,828,804,24,0,811,17,1600,772,404,407,1,16972,0
44,"Sectorul 3",179169,"#N/A",179169,,"BUCURESTI SECTORUL 3",472,"SCOALA GENERALA NR. 88, DIN STR. ODOBESTI NR. 3",1566,905,892,13,0,885,20,1700,795,455,430,1,16972,0
44,"Sectorul 3",179169,"#N/A",179169,,"BUCURESTI SECTORUL 3",473,"SCOALA GENERALA NR. 88, DIN STR. ODOBESTI NR. 3",1582,932,922,9,1,924,8,1800,868,474,450,1,16972,0
44,"Sectorul 3",179169,"#N/A",179169,,"BUCURESTI SECTORUL 3",474,"SCOALA GENERALA NR. 88, DIN STR. ODOBESTI NR. 3",1515,839,820,19,0,831,8,1700,861,391,440,1,16972,0
44,"Sectorul 3",179169,"#N/A",179169,,"BUCURESTI SECTORUL 3",475,"SCOALA GENERALA NR. 87, DIN STR. RAMNICU VALCEA NR. 32",1326,621,605,16,0,613,8,1500,879,310,303,1,16972,0
44,"Sectorul 3",179169,"#N/A",179169,,"BUCURESTI SECTORUL 3",476,"SCOALA GENERALA NR. 87, DIN STR. RAMNICU VALCEA NR. 32",1223,575,560,15,0,571,4,1400,825,288,283,1,16972,0
44,"Sectorul 3",179169,"#N/A",179169,,"BUCURESTI SECTORUL 3",477,"SCOALA GENERALA NR. 87, DIN STR. RAMNICU VALCEA NR. 32",1484,648,637,11,0,645,3,1600,952,348,297,1,16972,0
44,"Sectorul 3",179169,"#N/A",179169,,"BUCURESTI SECTORUL 3",478,"SCOALA GENERALA NR. 87, DIN STR. RAMNICU VALCEA NR. 32",1559,710,694,16,0,700,10,1700,990,335,365,1,16972,0
44,"Sectorul 3",179169,"#N/A",179169,,"BUCURESTI SECTORUL 3",479,"SCOALA GENERALA NR. 87, DIN STR. RAMNICU VALCEA NR. 32",1623,707,690,17,0,694,13,1798,1091,368,326,1,16972,0
44,"Sectorul 3",179169,"#N/A",179169,,"BUCURESTI SECTORUL 3",480,"SCOALA GENERALA NR. 87, DIN STR. RAMNICU VALCEA NR. 32",1497,755,733,22,0,746,9,1700,945,376,370,1,16972,0
44,"Sectorul 3",179169,"#N/A",179169,,"BUCURESTI SECTORUL 3",481,"SCOALA GENERALA NR. 87, DIN STR. RAMNICU VALCEA NR. 32",1499,752,742,10,0,746,6,1700,948,393,353,1,16972,0
44,"Sectorul 3",179169,"#N/A",179169,,"BUCURESTI SECTORUL 3",482,"SCOALA GENERALA NR. 87, DIN STR. RAMNICU VALCEA NR. 32",1499,740,725,15,0,736,4,1700,960,376,360,1,16972,0
44,"Sectorul 3",179169,"#N/A",179169,,"BUCURESTI SECTORUL 3",483,"SCOALA GENERALA NR. 87, DIN STR. RAMNICU VALCEA NR. 32",1626,816,805,10,1,804,12,1800,984,401,403,1,16972,0
44,"Sectorul 3",179169,"#N/A",179169,,"BUCURESTI SECTORUL 3",484,"SCOALA GENERALA NR. 87, DIN STR. RAMNICU VALCEA NR. 32",1557,834,825,9,0,823,11,1700,866,447,376,1,16972,0
44,"Sectorul 3",179169,"#N/A",179169,,"BUCURESTI SECTORUL 3",485,"SCOALA GENERALA NR. 87, DIN STR. RAMNICU VALCEA NR. 32",1258,556,543,13,0,550,6,1400,844,276,274,1,16972,0
44,"Sectorul 3",179169,"#N/A",179169,,"BUCURESTI SECTORUL 3",486,"GRUP SCOLAR CONSTRUCTII MONTAJ ""ELIE RADU"", DIN B-DUL ENERGETICIENILOR NR. 5",1515,651,638,13,0,647,4,1700,1049,299,348,1,16972,0
44,"Sectorul 3",179169,"#N/A",179169,,"BUCURESTI SECTORUL 3",487,"GRUP SCOLAR CONSTRUCTII MONTAJ ""ELIE RADU"", DIN B-DUL ENERGETICIENILOR NR. 5",1571,720,704,16,0,717,3,1700,980,362,355,1,16972,0
44,"Sectorul 3",179169,"#N/A",179169,,"BUCURESTI SECTORUL 3",488,"GRUP SCOLAR CONSTRUCTII MONTAJ ""ELIE RADU"", DIN B-DUL ENERGETICIENILOR NR. 5",1126,517,507,10,0,509,8,1200,683,280,229,1,16972,0
44,"Sectorul 3",179169,"#N/A",179169,,"BUCURESTI SECTORUL 3",489,"GRUP SCOLAR CONSTRUCTII MONTAJ ""ELIE RADU"", DIN B-DUL ENERGETICIENILOR NR. 5",1642,700,689,11,0,686,14,1800,1100,389,297,1,16972,0
44,"Sectorul 3",179169,"#N/A",179169,,"BUCURESTI SECTORUL 3",490,"GRUP SCOLAR CONSTRUCTII MONTAJ ""ELIE RADU"", DIN B-DUL ENERGETICIENILOR NR. 5",1489,568,550,18,0,561,7,1600,1032,301,260,1,16972,0
44,"Sectorul 3",179169,"#N/A",179169,,"BUCURESTI SECTORUL 3",491,"LICEUL TEORETIC BILINGV ""DECEBAL"", DIN B-DUL ENERGETICIENILOR NR. 9-11",1248,657,646,11,0,651,6,1400,743,285,366,1,16972,0
44,"Sectorul 3",179169,"#N/A",179169,,"BUCURESTI SECTORUL 3",492,"LICEUL TEORETIC BILINGV ""DECEBAL"", DIN B-DUL ENERGETICIENILOR NR. 9-11",1546,698,681,17,0,687,11,1700,1002,358,329,1,16972,0
44,"Sectorul 3",179169,"#N/A",179169,,"BUCURESTI SECTORUL 3",493,"LICEUL TEORETIC BILINGV ""DECEBAL"", DIN B-DUL ENERGETICIENILOR NR. 9-11",1548,632,617,15,0,628,4,1700,1068,339,289,1,16972,0
44,"Sectorul 3",179169,"#N/A",179169,,"BUCURESTI SECTORUL 3",494,"LICEUL TEORETIC BILINGV ""DECEBAL"", DIN B-DUL ENERGETICIENILOR NR. 9-11",1463,459,452,7,0,457,2,1600,1141,269,188,1,16972,0
44,"Sectorul 3",179169,"#N/A",179169,,"BUCURESTI SECTORUL 3",495,"SCOALA GENERALA NR. 54, DIN STR. ISTRIEI NR. 19",1141,544,534,10,0,541,3,1300,756,310,231,1,16972,0
44,"Sectorul 3",179169,"#N/A",179169,,"BUCURESTI SECTORUL 3",496,"SCOALA GENERALA NR. 54, DIN STR. ISTRIEI NR. 19",1414,754,740,14,0,739,15,1600,846,375,364,1,16972,0
44,"Sectorul 3",179169,"#N/A",179169,,"BUCURESTI SECTORUL 3",497,"SCOALA GENERALA NR. 54, DIN STR. ISTRIEI NR. 19",1433,812,797,15,0,801,11,1600,788,422,379,1,16972,0
44,"Sectorul 3",179169,"#N/A",179169,,"BUCURESTI SECTORUL 3",498,"SCOALA GENERALA NR. 54, DIN STR. ISTRIEI NR. 19",1477,831,820,11,0,814,17,1600,769,436,378,1,16972,0
44,"Sectorul 3",179169,"#N/A",179169,,"BUCURESTI SECTORUL 3",499,"SCOALA GENERALA NR. 54, DIN STR. ISTRIEI NR. 19",1477,753,741,12,0,745,8,1601,848,423,322,1,16972,0
44,"Sectorul 3",179169,"#N/A",179169,,"BUCURESTI SECTORUL 3",500,"SCOALA GENERALA NR. 54, DIN STR. ISTRIEI NR. 19",1268,655,644,11,0,652,3,1400,745,350,302,1,16972,0
44,"Sectorul 3",179169,"#N/A",179169,,"BUCURESTI SECTORUL 3",501,"SCOALA GENERALA NR. 54, DIN STR. ISTRIEI NR. 19",1475,723,718,5,0,714,9,1600,877,394,320,1,16972,0
44,"Sectorul 3",179169,"#N/A",179169,,"BUCURESTI SECTORUL 3",502,"SCOALA GENERALA NR. 54, DIN STR. ISTRIEI NR. 19",1281,632,617,14,1,630,2,1400,768,357,273,1,16972,0
44,"Sectorul 3",179169,"#N/A",179169,,"BUCURESTI SECTORUL 3",503,"SCOALA GENERALA NR. 54, DIN STR. ISTRIEI NR. 19",1428,684,675,9,0,673,11,1600,916,305,368,1,16972,0
44,"Sectorul 3",179169,"#N/A",179169,,"BUCURESTI SECTORUL 3",504,"SCOALA GENERALA NR. 54, DIN STR. ISTRIEI NR. 19",1529,764,749,15,0,754,10,1700,936,380,374,1,16972,0
44,"Sectorul 3",179169,"#N/A",179169,,"BUCURESTI SECTORUL 3",505,"SCOALA GENERALA NR. 89 ""NICOLAE LABIS"", DIN STR. FIRIDEI NR. 2",1664,893,874,19,0,875,18,1800,907,410,465,1,16972,0
44,"Sectorul 3",179169,"#N/A",179169,,"BUCURESTI SECTORUL 3",506,"SCOALA GENERALA NR. 89 ""NICOLAE LABIS"", DIN STR. FIRIDEI NR. 2",1412,681,659,22,0,669,12,1600,919,316,353,1,16972,0
44,"Sectorul 3",179169,"#N/A",179169,,"BUCURESTI SECTORUL 3",507,"SCOALA GENERALA NR. 89 ""NICOLAE LABIS"", DIN STR. FIRIDEI NR. 2",1623,756,744,11,1,751,5,1800,1044,410,341,1,16972,0
44,"Sectorul 3",179169,"#N/A",179169,,"BUCURESTI SECTORUL 3",508,"SCOALA GENERALA NR. 89 ""NICOLAE LABIS"", DIN STR. FIRIDEI NR. 2",1509,822,800,22,0,810,12,1700,878,433,377,1,16972,0
44,"Sectorul 3",179169,"#N/A",179169,,"BUCURESTI SECTORUL 3",509,"SCOALA GENERALA NR. 89 ""NICOLAE LABIS"", DIN STR. FIRIDEI NR. 2",1546,800,756,42,2,787,13,1700,900,438,349,1,16972,0
44,"Sectorul 3",179169,"#N/A",179169,,"BUCURESTI SECTORUL 3",510,"SCOALA GENERALA NR. 89 ""NICOLAE LABIS"", DIN STR. FIRIDEI NR. 2",1671,779,764,15,0,770,9,1800,1021,386,384,1,16972,0
44,"Sectorul 3",179169,"#N/A",179169,,"BUCURESTI SECTORUL 3",511,"SCOALA GENERALA NR. 89 ""NICOLAE LABIS"", DIN STR. FIRIDEI NR. 2",1290,784,773,10,1,768,16,1400,616,385,383,1,16972,0
44,"Sectorul 3",179169,"#N/A",179169,,"BUCURESTI SECTORUL 3",512,"SCOALA GENERALA NR. 89 ""NICOLAE LABIS"", DIN STR. FIRIDEI NR. 2",1350,836,818,18,0,820,15,1501,665,371,449,1,16972,0
44,"Sectorul 3",179169,"#N/A",179169,,"BUCURESTI SECTORUL 3",513,"LICEUL TEORETIC ""DANTE ALIGHIERI"", DIN ALEEA FUIORULUI NR. 9",1576,927,914,13,0,911,16,1700,773,446,465,1,16972,0
44,"Sectorul 3",179169,"#N/A",179169,,"BUCURESTI SECTORUL 3",514,"LICEUL TEORETIC ""DANTE ALIGHIERI"", DIN ALEEA FUIORULUI NR. 9",1524,869,856,13,0,851,18,1700,831,433,418,1,16972,0
44,"Sectorul 3",179169,"#N/A",179169,,"BUCURESTI SECTORUL 3",515,"LICEUL TEORETIC ""DANTE ALIGHIERI"", DIN ALEEA FUIORULUI NR. 9",1201,708,690,18,0,697,11,1300,592,332,365,1,16972,0
44,"Sectorul 3",179169,"#N/A",179169,,"BUCURESTI SECTORUL 3",516,"LICEUL TEORETIC ""DANTE ALIGHIERI"", DIN ALEEA FUIORULUI NR. 9",1209,713,693,20,0,697,16,1300,587,312,385,1,16972,0
44,"Sectorul 3",179169,"#N/A",179169,,"BUCURESTI SECTORUL 3",517,"LICEUL TEORETIC ""DANTE ALIGHIERI"", DIN ALEEA FUIORULUI NR. 9",1369,766,752,14,0,750,16,1500,734,364,386,1,16972,0
44,"Sectorul 3",179169,"#N/A",179169,,"BUCURESTI SECTORUL 3",518,"SCOALA GENERALA NR. 195, DIN STR. LUNCA BRADULUI NR. 2",1363,901,882,19,0,885,16,1500,599,457,428,1,16972,0
44,"Sectorul 3",179169,"#N/A",179169,,"BUCURESTI SECTORUL 3",519,"SCOALA GENERALA NR. 195, DIN STR. LUNCA BRADULUI NR. 2",1281,785,773,12,0,772,13,1400,615,392,380,1,16972,0
44,"Sectorul 3",179169,"#N/A",179169,,"BUCURESTI SECTORUL 3",520,"SCOALA GENERALA NR. 195, DIN STR. LUNCA BRADULUI NR. 2",1251,751,733,18,0,744,7,1400,649,362,382,1,16972,0
44,"Sectorul 3",179169,"#N/A",179169,,"BUCURESTI SECTORUL 3",521,"SCOALA GENERALA NR. 195, DIN STR. LUNCA BRADULUI NR. 2",1129,682,670,12,0,673,9,1200,518,294,379,1,16972,0
44,"Sectorul 3",179169,"#N/A",179169,,"BUCURESTI SECTORUL 3",522,"SCOALA GENERALA NR. 195, DIN STR. LUNCA BRADULUI NR. 2",1160,654,641,11,2,642,12,1300,646,331,311,1,16972,0
44,"Sectorul 3",179169,"#N/A",179169,,"BUCURESTI SECTORUL 3",523,"SCOALA GENERALA NR. 112, DIN STR. PATULULUI NR. 2",1403,677,658,19,0,664,13,1600,923,361,303,1,16972,0
44,"Sectorul 3",179169,"#N/A",179169,,"BUCURESTI SECTORUL 3",524,"SCOALA GENERALA NR. 112, DIN STR. PATULULUI NR. 2",1396,713,698,15,0,705,8,1500,787,374,331,1,16972,0
44,"Sectorul 3",179169,"#N/A",179169,,"BUCURESTI SECTORUL 3",525,"SCOALA GENERALA NR. 112, DIN STR. PATULULUI NR. 2",1397,698,684,14,0,689,9,1500,802,353,336,1,16972,0
44,"Sectorul 3",179169,"#N/A",179169,,"BUCURESTI SECTORUL 3",526,"SCOALA GENERALA NR. 112, DIN STR. PATULULUI NR. 2",1610,916,879,37,0,907,9,1800,884,446,461,1,16972,0
44,"Sectorul 3",179169,"#N/A",179169,,"BUCURESTI SECTORUL 3",527,"SCOALA GENERALA NR. 112, DIN STR. PATULULUI NR. 2",1383,748,737,11,0,742,6,1500,752,402,340,1,16972,0
44,"Sectorul 3",179169,"#N/A",179169,,"BUCURESTI SECTORUL 3",528,"SCOALA GENERALA NR. 112, DIN STR. PATULULUI NR. 2",1372,723,710,13,0,704,19,1500,777,342,362,1,16972,0
44,"Sectorul 3",179169,"#N/A",179169,,"BUCURESTI SECTORUL 3",529,"SCOALA GENERALA NR. 112, DIN STR. PATULULUI NR. 2",1123,646,630,16,0,637,9,1500,854,319,318,1,16972,0
44,"Sectorul 3",179169,"#N/A",179169,,"BUCURESTI SECTORUL 3",530,"SCOALA GENERALA NR. 112, DIN STR. PATULULUI NR. 2",1230,640,636,4,0,634,6,1400,760,322,312,1,16972,0
44,"Sectorul 3",179169,"#N/A",179169,,"BUCURESTI SECTORUL 3",531,"SCOALA GENERALA NR. 112, DIN STR. PATULULUI NR. 2",1329,715,698,17,0,709,6,1500,785,328,381,1,16972,0
44,"Sectorul 3",179169,"#N/A",179169,,"BUCURESTI SECTORUL 3",532,"SCOALA GENERALA NR. 112, DIN STR. PATULULUI NR. 2",1349,544,525,19,0,539,5,1500,956,286,253,1,16972,0
44,"Sectorul 3",179169,"#N/A",179169,,"BUCURESTI SECTORUL 3",533,"SCOALA GENERALA NR. 92, DIN ALEEA VLAHITA NR. 1A",1543,832,817,15,0,825,7,1700,868,482,343,1,16972,0
44,"Sectorul 3",179169,"#N/A",179169,,"BUCURESTI SECTORUL 3",534,"SCOALA GENERALA NR. 92, DIN ALEEA VLAHITA NR. 1A",1462,795,769,26,0,786,9,1600,805,381,405,1,16972,0
44,"Sectorul 3",179169,"#N/A",179169,,"BUCURESTI SECTORUL 3",535,"SCOALA GENERALA NR. 92, DIN ALEEA VLAHITA NR. 1A",1546,789,769,20,0,783,6,1700,911,455,328,1,16972,0
44,"Sectorul 3",179169,"#N/A",179169,,"BUCURESTI SECTORUL 3",536,"SCOALA GENERALA NR. 92, DIN ALEEA VLAHITA NR. 1A",1479,837,822,15,0,830,7,1600,763,480,350,1,16972,0
44,"Sectorul 3",179169,"#N/A",179169,,"BUCURESTI SECTORUL 3",537,"SCOALA GENERALA NR. 92, DIN ALEEA VLAHITA NR. 1A",1252,662,644,18,0,649,13,1400,738,295,354,1,16972,0
44,"Sectorul 3",179169,"#N/A",179169,,"BUCURESTI SECTORUL 3",538,"SCOALA GENERALA NR. 92, DIN ALEEA VLAHITA NR. 1A",1614,784,772,12,0,772,12,1800,1016,386,386,1,16972,0
44,"Sectorul 3",179169,"#N/A",179169,,"BUCURESTI SECTORUL 3",539,"SCOALA GENERALA NR. 92, DIN ALEEA VLAHITA NR. 1A",1674,882,876,6,0,871,11,1900,1018,444,427,1,16972,0
44,"Sectorul 3",179169,"#N/A",179169,,"BUCURESTI SECTORUL 3",540,"SCOALA GENERALA NR. 92, DIN ALEEA VLAHITA NR. 1A",1508,777,764,13,0,770,7,1700,923,359,411,1,16972,0
44,"Sectorul 3",179169,"#N/A",179169,,"BUCURESTI SECTORUL 3",541,"SCOALA GENERALA NR. 92, DIN ALEEA VLAHITA NR. 1A",1525,801,776,25,0,789,12,1700,899,405,384,1,16972,0
44,"Sectorul 3",179169,"#N/A",179169,,"BUCURESTI SECTORUL 3",542,"SCOALA GENERALA NR. 20, DIN STR. PREVEDERII NR. 19",1478,794,781,13,0,782,12,1599,805,427,355,1,16972,0
44,"Sectorul 3",179169,"#N/A",179169,,"BUCURESTI SECTORUL 3",543,"SCOALA GENERALA NR. 20, DIN STR. PREVEDERII NR. 19",1631,817,805,12,0,805,12,1800,983,464,341,1,16972,0
44,"Sectorul 3",179169,"#N/A",179169,,"BUCURESTI SECTORUL 3",544,"SCOALA GENERALA NR. 20, DIN STR. PREVEDERII NR. 19",1480,860,845,15,0,852,8,1600,740,455,397,1,16972,0
44,"Sectorul 3",179169,"#N/A",179169,,"BUCURESTI SECTORUL 3",545,"SCOALA GENERALA NR. 20, DIN STR. PREVEDERII NR. 19",1505,843,834,9,0,829,14,1699,856,461,368,1,16972,0
44,"Sectorul 3",179169,"#N/A",179169,,"BUCURESTI SECTORUL 3",546,"SCOALA GENERALA NR. 20, DIN STR. PREVEDERII NR. 19",1587,824,816,8,0,810,14,1800,976,405,405,1,16972,0
44,"Sectorul 3",179169,"#N/A",179169,,"BUCURESTI SECTORUL 3",547,"SCOALA GENERALA NR. 20, DIN STR. PREVEDERII NR. 19",1419,749,735,14,0,742,7,1600,851,410,332,1,16972,0
44,"Sectorul 3",179169,"#N/A",179169,,"BUCURESTI SECTORUL 3",548,"GRUP SCOLAR CHIMIE ""C. D. NENITESCU"", DIN B-DUL THEODOR PALLADY NR. 26",1587,818,798,20,0,812,6,1800,982,482,330,1,16972,0
44,"Sectorul 3",179169,"#N/A",179169,,"BUCURESTI SECTORUL 3",549,"GRUP SCOLAR CHIMIE ""C. D. NENITESCU"", DIN B-DUL THEODOR PALLADY NR. 26",1484,663,644,19,0,655,8,1600,937,328,327,1,16972,0
44,"Sectorul 3",179169,"#N/A",179169,,"BUCURESTI SECTORUL 3",550,"GRUP SCOLAR CHIMIE ""C. D. NENITESCU"", DIN B-DUL THEODOR PALLADY NR. 26",1295,697,677,19,1,689,8,1400,703,346,343,1,16972,0
44,"Sectorul 3",179169,"#N/A",179169,,"BUCURESTI SECTORUL 3",551,"GRUP SCOLAR CHIMIE ""C. D. NENITESCU"", DIN B-DUL THEODOR PALLADY NR. 26",1646,873,855,18,0,861,12,1800,927,460,401,1,16972,0
44,"Sectorul 3",179169,"#N/A",179169,,"BUCURESTI SECTORUL 3",552,"GRUP SCOLAR CHIMIE ""C. D. NENITESCU"", DIN B-DUL THEODOR PALLADY NR. 26",1650,868,861,7,0,859,9,1800,932,484,375,1,16972,0
44,"Sectorul 3",179169,"#N/A",179169,,"BUCURESTI SECTORUL 3",553,"SCOALA GENERALA NR. 149, DIN ALEEA PERISORU NR. 4",1608,922,911,11,0,907,15,1800,878,441,466,1,16972,0
44,"Sectorul 3",179169,"#N/A",179169,,"BUCURESTI SECTORUL 3",554,"SCOALA GENERALA NR. 149, DIN ALEEA PERISORU NR. 4",1503,777,758,19,0,769,8,1700,923,376,393,1,16972,0
44,"Sectorul 3",179169,"#N/A",179169,,"BUCURESTI SECTORUL 3",555,"SCOALA GENERALA NR. 149, DIN ALEEA PERISORU NR. 4",1512,816,796,18,2,800,16,1700,884,422,378,1,16972,0
44,"Sectorul 3",179169,"#N/A",179169,,"BUCURESTI SECTORUL 3",556,"SCOALA GENERALA NR. 82, DIN STR. JEAN ALEXANDRU STERIADI NR. 17",1364,777,743,16,18,770,7,1500,723,386,384,1,16972,0
44,"Sectorul 3",179169,"#N/A",179169,,"BUCURESTI SECTORUL 3",557,"SCOALA GENERALA NR. 82, DIN STR. JEAN ALEXANDRU STERIADI NR. 17",1529,811,799,12,0,801,10,1700,889,444,357,1,16972,0
44,"Sectorul 3",179169,"#N/A",179169,,"BUCURESTI SECTORUL 3",558,"SCOALA GENERALA NR. 82, DIN STR. JEAN ALEXANDRU STERIADI NR. 17",1506,834,819,15,0,826,8,1700,866,363,463,1,16972,0
44,"Sectorul 3",179169,"#N/A",179169,,"BUCURESTI SECTORUL 3",559,"SCOALA GENERALA NR. 82, DIN STR. JEAN ALEXANDRU STERIADI NR. 17",1409,686,679,7,0,673,13,1600,914,348,325,1,16972,0
44,"Sectorul 3",179169,"#N/A",179169,,"BUCURESTI SECTORUL 3",560,"SCOALA GENERALA NR. 82, DIN STR. JEAN ALEXANDRU STERIADI NR. 17",1329,810,787,23,0,800,10,1495,685,381,419,1,16972,0
44,"Sectorul 3",179169,"#N/A",179169,,"BUCURESTI SECTORUL 3",561,"SCOALA GENERALA NR. 82, DIN STR. JEAN ALEXANDRU STERIADI NR. 17",1327,766,740,26,0,762,4,1500,734,369,393,1,16972,0
44,"Sectorul 3",179169,"#N/A",179169,,"BUCURESTI SECTORUL 3",562,"SCOALA GENERALA NR. 82, DIN STR. JEAN ALEXANDRU STERIADI NR. 17",1451,856,835,20,1,846,10,1600,744,431,415,1,16972,0
44,"Sectorul 3",179169,"#N/A",179169,,"BUCURESTI SECTORUL 3",563,"SCOALA GENERALA NR. 82, DIN STR. JEAN ALEXANDRU STERIADI NR. 17",1258,656,640,16,0,648,8,1400,744,321,327,1,16972,0
44,"Sectorul 3",179169,"#N/A",179169,,"BUCURESTI SECTORUL 3",564,"SCOALA GENERALA NR. 116, DIN STR. GURA IALOMITEI NR. 20",1587,833,819,13,1,821,12,1800,967,377,444,1,16972,0
44,"Sectorul 3",179169,"#N/A",179169,,"BUCURESTI SECTORUL 3",565,"SCOALA GENERALA NR. 116, DIN STR. GURA IALOMITEI NR. 20",1514,723,713,9,1,716,7,1700,977,348,368,1,16972,0
44,"Sectorul 3",179169,"#N/A",179169,,"BUCURESTI SECTORUL 3",566,"SCOALA GENERALA NR. 116, DIN STR. GURA IALOMITEI NR. 20",1728,916,905,11,0,905,11,1900,984,453,452,1,16972,0
44,"Sectorul 3",179169,"#N/A",179169,,"BUCURESTI SECTORUL 3",567,"SCOALA GENERALA NR. 116, DIN STR. GURA IALOMITEI NR. 20",1692,817,803,14,0,806,11,1900,1083,384,422,1,16972,0
44,"Sectorul 3",179169,"#N/A",179169,,"BUCURESTI SECTORUL 3",568,"SCOALA GENERALA NR. 116, DIN STR. GURA IALOMITEI NR. 20",1514,779,763,15,1,769,10,1700,921,387,382,1,16972,0
44,"Sectorul 3",179169,"#N/A",179169,,"BUCURESTI SECTORUL 3",569,"SCOALA GENERALA NR. 116, DIN STR. GURA IALOMITEI NR. 20",1454,684,677,7,0,668,16,1600,916,330,338,1,16972,0
44,"Sectorul 3",179169,"#N/A",179169,,"BUCURESTI SECTORUL 3",570,"SCOALA GENERALA NR. 116, DIN STR. GURA IALOMITEI NR. 20",1323,635,619,15,1,627,8,1500,865,335,292,1,16972,0
44,"Sectorul 3",179169,"#N/A",179169,,"BUCURESTI SECTORUL 3",571,"SCOALA GENERALA NR. 200, DIN STR. POSTAVARUL NR. 13",1664,984,969,15,0,969,15,1800,816,437,532,1,16972,0
44,"Sectorul 3",179169,"#N/A",179169,,"BUCURESTI SECTORUL 3",572,"SCOALA GENERALA NR. 200, DIN STR. POSTAVARUL NR. 13",1385,805,792,13,0,792,13,1500,695,420,372,1,16972,0
44,"Sectorul 3",179169,"#N/A",179169,,"BUCURESTI SECTORUL 3",573,"SCOALA GENERALA NR. 200, DIN STR. POSTAVARUL NR. 13",1566,762,744,18,0,748,14,1700,938,349,399,1,16972,0
44,"Sectorul 3",179169,"#N/A",179169,,"BUCURESTI SECTORUL 3",574,"SCOALA GENERALA NR. 200, DIN STR. POSTAVARUL NR. 13",1644,759,746,12,1,746,13,1800,1041,338,408,1,16972,0
44,"Sectorul 3",179169,"#N/A",179169,,"BUCURESTI SECTORUL 3",575,"SCOALA GENERALA NR. 200, DIN STR. POSTAVARUL NR. 13",1617,804,790,13,1,783,21,1799,995,407,376,1,16972,0
44,"Sectorul 3",179169,"#N/A",179169,,"BUCURESTI SECTORUL 3",576,"SCOALA GENERALA NR. 200, DIN STR. POSTAVARUL NR. 13",1463,651,633,18,0,642,9,1596,945,347,295,1,16972,0
44,"Sectorul 3",179169,"#N/A",179169,,"BUCURESTI SECTORUL 3",577,"SCOALA GENERALA NR. 200, DIN STR. POSTAVARUL NR. 13",1576,876,854,22,0,869,7,1700,824,441,428,1,16972,0
44,"Sectorul 3",179169,"#N/A",179169,,"BUCURESTI SECTORUL 3",578,"SCOALA GENERALA NR. 196, DIN STR. COZLA NR. 1",1363,656,643,13,0,649,7,1500,844,319,330,1,16972,0
44,"Sectorul 3",179169,"#N/A",179169,,"BUCURESTI SECTORUL 3",579,"SCOALA GENERALA NR. 196, DIN STR. COZLA NR. 1",1154,703,692,11,0,698,5,1296,593,353,345,1,16972,0
44,"Sectorul 3",179169,"#N/A",179169,,"BUCURESTI SECTORUL 3",580,"SCOALA GENERALA NR. 196, DIN STR. COZLA NR. 1",1283,791,776,14,1,773,18,1400,609,321,452,1,16972,0
44,"Sectorul 3",179169,"#N/A",179169,,"BUCURESTI SECTORUL 3",581,"SCOALA GENERALA NR. 196, DIN STR. COZLA NR. 1",1218,711,697,13,1,702,9,1300,589,351,351,1,16972,0
44,"Sectorul 3",179169,"#N/A",179169,,"BUCURESTI SECTORUL 3",582,"SCOALA GENERALA NR. 196, DIN STR. COZLA NR. 1",1524,839,824,15,0,831,8,1700,861,404,427,1,16972,0
44,"Sectorul 3",179169,"#N/A",179169,,"BUCURESTI SECTORUL 3",583,"SCOALA GENERALA NR. 196, DIN STR. COZLA NR. 1",1395,810,797,13,0,795,15,1500,690,345,450,1,16972,0
44,"Sectorul 3",179169,"#N/A",179169,,"BUCURESTI SECTORUL 3",584,"SCOALA GENERALA NR. 196, DIN STR. COZLA NR. 1",1506,765,747,18,0,755,10,1700,935,388,367,1,16972,0
44,"Sectorul 3",179169,"#N/A",179169,,"BUCURESTI SECTORUL 3",585,"SCOALA GENERALA NR. 22 ""MEXIC"", DIN B-DUL 1 DECEMBRIE 1918 NR. 34",1364,705,698,7,0,698,7,1497,792,385,313,1,16972,0
44,"Sectorul 3",179169,"#N/A",179169,,"BUCURESTI SECTORUL 3",586,"SCOALA GENERALA NR. 22 ""MEXIC"", DIN B-DUL 1 DECEMBRIE 1918 NR. 34",1585,774,763,11,0,763,11,1800,1026,392,371,1,16972,0
44,"Sectorul 3",179169,"#N/A",179169,,"BUCURESTI SECTORUL 3",587,"SCOALA GENERALA NR. 22 ""MEXIC"", DIN B-DUL 1 DECEMBRIE 1918 NR. 34",1521,738,715,23,0,726,12,1700,962,389,337,1,16972,0
44,"Sectorul 3",179169,"#N/A",179169,,"BUCURESTI SECTORUL 3",588,"SCOALA GENERALA NR. 22 ""MEXIC"", DIN B-DUL 1 DECEMBRIE 1918 NR. 34",1588,584,575,9,0,579,5,1800,1216,325,254,1,16972,0
44,"Sectorul 3",179169,"#N/A",179169,,"BUCURESTI SECTORUL 3",589,"SCOALA GENERALA NR. 22 ""MEXIC"", DIN B-DUL 1 DECEMBRIE 1918 NR. 34",1685,822,814,8,0,814,8,1900,1078,359,455,1,16972,0
44,"Sectorul 3",179169,"#N/A",179169,,"BUCURESTI SECTORUL 3",590,"SCOALA GENERALA NR. 22 ""MEXIC"", DIN B-DUL 1 DECEMBRIE 1918 NR. 34",1630,848,832,16,0,837,11,1800,952,453,384,1,16972,0
44,"Sectorul 3",179169,"#N/A",179169,,"BUCURESTI SECTORUL 3",591,"SCOALA GENERALA NR. 22 ""MEXIC"", DIN B-DUL 1 DECEMBRIE 1918 NR. 34",1686,849,840,9,0,834,15,1900,1051,437,397,1,16972,0
44,"Sectorul 3",179169,"#N/A",179169,,"BUCURESTI SECTORUL 3",592,"SCOALA GENERALA NR. 22 ""MEXIC"", DIN B-DUL 1 DECEMBRIE 1918 NR. 34",1618,738,705,33,0,725,13,1800,1062,359,366,1,16972,0
44,"Sectorul 3",179169,"#N/A",179169,,"BUCURESTI SECTORUL 3",593,"SCOALA GENERALA NR. 21, DIN ALEEA BARAJUL ROVINARI NR. 1",1547,789,772,17,0,775,14,1700,911,398,377,1,16972,0
44,"Sectorul 3",179169,"#N/A",179169,,"BUCURESTI SECTORUL 3",594,"SCOALA GENERALA NR. 21, DIN ALEEA BARAJUL ROVINARI NR. 1",1118,648,633,15,0,637,11,1200,552,318,319,1,16972,0
44,"Sectorul 3",179169,"#N/A",179169,,"BUCURESTI SECTORUL 3",595,"LICEUL TEORETIC ""ALEXANDRU IOAN CUZA"", DIN ALEEA BARAJUL DUNARII NR. 5",1595,844,830,13,1,832,12,1800,956,421,411,1,16972,0
44,"Sectorul 3",179169,"#N/A",179169,,"BUCURESTI SECTORUL 3",596,"LICEUL TEORETIC ""ALEXANDRU IOAN CUZA"", DIN ALEEA BARAJUL DUNARII NR. 5",1498,838,828,10,0,832,6,1700,862,418,414,1,16972,0
44,"Sectorul 3",179169,"#N/A",179169,,"BUCURESTI SECTORUL 3",597,"LICEUL TEORETIC ""ALEXANDRU IOAN CUZA"", DIN ALEEA BARAJUL DUNARII NR. 5",1385,824,821,3,0,805,19,1500,676,457,348,1,16972,0
44,"Sectorul 3",179169,"#N/A",179169,,"BUCURESTI SECTORUL 3",598,"LICEUL TEORETIC ""ALEXANDRU IOAN CUZA"", DIN ALEEA BARAJUL DUNARII NR. 5",1422,822,818,4,0,810,12,1600,778,349,461,1,16972,0
44,"Sectorul 3",179169,"#N/A",179169,,"BUCURESTI SECTORUL 3",599,"LICEUL TEORETIC ""ALEXANDRU IOAN CUZA"", DIN ALEEA BARAJUL DUNARII NR. 5",1509,842,828,14,0,830,12,1700,858,402,428,1,16972,0
44,"Sectorul 3",179169,"#N/A",179169,,"BUCURESTI SECTORUL 3",600,"LICEUL TEORETIC ""ALEXANDRU IOAN CUZA"", DIN ALEEA BARAJUL DUNARII NR. 5",1606,926,907,19,0,913,13,1800,874,445,468,1,16972,0
44,"Sectorul 3",179169,"#N/A",179169,,"BUCURESTI SECTORUL 3",601,"SCOALA GENERALA NR. 94, DIN ALEEA BARAJUL IEZERU NR. 8",1229,731,719,12,0,724,7,1400,669,380,344,1,16972,0
44,"Sectorul 3",179169,"#N/A",179169,,"BUCURESTI SECTORUL 3",602,"SCOALA GENERALA NR. 94, DIN ALEEA BARAJUL IEZERU NR. 8",1561,802,783,19,0,790,12,1600,798,341,449,1,16972,0
44,"Sectorul 3",179169,"#N/A",179169,,"BUCURESTI SECTORUL 3",603,"SCOALA GENERALA NR. 94, DIN ALEEA BARAJUL IEZERU NR. 8",1508,714,697,17,0,707,7,1600,886,375,332,1,16972,0
44,"Sectorul 3",179169,"#N/A",179169,,"BUCURESTI SECTORUL 3",604,"LICEUL TEORETIC ""N. STANESCU"", DIN STR. LUCRETIU PATRASCANU NR. 3",1378,706,676,30,0,696,10,1400,694,291,405,1,16972,0
44,"Sectorul 3",179169,"#N/A",179169,,"BUCURESTI SECTORUL 3",605,"LICEUL TEORETIC ""N. STANESCU"", DIN STR. LUCRETIU PATRASCANU NR. 3",1147,563,528,34,1,552,11,1200,637,284,268,1,16972,0
44,"Sectorul 3",179169,"#N/A",179169,,"BUCURESTI SECTORUL 3",606,"LICEUL TEORETIC ""N. STANESCU"", DIN STR. LUCRETIU PATRASCANU NR. 3",1524,747,732,15,0,740,7,1600,853,387,353,1,16972,0
44,"Sectorul 3",179169,"#N/A",179169,,"BUCURESTI SECTORUL 3",607,"SCOALA GENERALA NR. 16, DIN ALEEA BUDACU NR. 4",1545,823,812,11,0,808,15,1600,777,378,430,1,16972,0
44,"Sectorul 3",179169,"#N/A",179169,,"BUCURESTI SECTORUL 3",608,"SCOALA GENERALA NR. 16, DIN ALEEA BUDACU NR. 4",1365,686,673,13,0,678,8,1400,714,303,375,1,16972,0
44,"Sectorul 3",179169,"#N/A",179169,,"BUCURESTI SECTORUL 3",609,"SCOALA GENERALA NR. 16, DIN ALEEA BUDACU NR. 4",1413,769,753,16,0,764,5,1500,731,384,380,1,16972,0
44,"Sectorul 3",179169,"#N/A",179169,,"BUCURESTI SECTORUL 3",610,"SCOALA GENERALA NR. 16, DIN ALEEA BUDACU NR. 4",1576,915,894,21,0,903,12,1600,685,442,461,1,16972,0
44,"Sectorul 3",179169,"#N/A",179169,,"BUCURESTI SECTORUL 3",611,"SCOALA GENERALA NR. 55, DIN STR. INDUSTRIILOR NR. 46",1563,480,471,9,0,479,1,1600,1120,251,228,1,16972,0
44,"Sectorul 3",179169,"#N/A",179169,,"BUCURESTI SECTORUL 3",612,"SCOALA GENERALA NR. 55, DIN STR. INDUSTRIILOR NR. 46",1451,402,392,10,0,394,8,1500,1098,203,191,1,16972,0
44,"Sectorul 3",179169,"#N/A",179169,,"BUCURESTI SECTORUL 3",613,"SCOALA GENERALA NR. 55, DIN STR. INDUSTRIILOR NR. 46",2049,374,360,14,0,369,5,2200,1826,194,175,1,16972,0
44,"Sectorul 3",179169,"#N/A",179169,,"BUCURESTI SECTORUL 3",614,"SCOALA GENERALA NR. 55, DIN STR. INDUSTRIILOR NR. 46",1282,216,210,6,0,215,1,1299,1083,105,110,1,16972,0
44,"Sectorul 3",179169,"#N/A",179169,,"BUCURESTI SECTORUL 3",615,"SCOALA GENERALA NR. 55, DIN STR. INDUSTRIILOR NR. 46",1489,319,312,7,0,314,5,1500,1181,172,142,1,16972,0
44,"Sectorul 3",179169,"#N/A",179169,,"BUCURESTI SECTORUL 3",616,"SCOALA GENERALA NR. 55, DIN STR. INDUSTRIILOR NR. 46",1509,524,512,12,0,511,13,1600,1076,284,227,1,16972,0
44,"Sectorul 3",179169,"#N/A",179169,,"BUCURESTI SECTORUL 3",617,"SCOALA GENERALA NR. 55, DIN STR. INDUSTRIILOR NR. 46",1767,324,315,9,0,320,4,1900,1576,162,158,1,16972,0
44,"Sectorul 3",179169,"#N/A",179169,,"BUCURESTI SECTORUL 3",618,"SCOALA GENERALA NR. 55, DIN STR. INDUSTRIILOR NR. 46",1535,375,360,15,0,373,2,1600,1225,186,187,1,16972,0
44,"Sectorul 3",179169,"#N/A",179169,,"BUCURESTI SECTORUL 3",619,"SCOALA GENERALA NR. 55, DIN STR. INDUSTRIILOR NR. 46",1891,388,381,7,0,383,5,2000,1612,188,195,1,16972,0
44,"Sectorul 3",179169,"#N/A",179169,,"BUCURESTI SECTORUL 3",620,"SCOALA GENERALA NR. 55, DIN STR. INDUSTRIILOR NR. 46",2028,422,410,12,0,415,7,2100,1678,225,190,1,16972,0
44,"Sectorul 3",179169,"#N/A",179169,,"BUCURESTI SECTORUL 3",621,"SCOALA GENERALA NR. 55, DIN STR. INDUSTRIILOR NR. 46",2016,409,399,10,0,407,2,2100,1691,232,175,1,16972,0
44,"Sectorul 3",179169,"#N/A",179169,,"BUCURESTI SECTORUL 3",622,"SCOALA GENERALA NR. 47, DIN SOS. GARII CATELU NR. 130",1920,392,382,10,0,389,3,2000,1608,212,177,1,16972,0
44,"Sectorul 3",179169,"#N/A",179169,,"BUCURESTI SECTORUL 3",623,"SCOALA GENERALA NR. 47, DIN SOS. GARII CATELU NR. 130",1461,371,363,8,0,370,1,1500,1129,211,159,1,16972,0
44,"Sectorul 3",179169,"#N/A",179169,,"BUCURESTI SECTORUL 3",624,"SCOALA GENERALA NR. 47, DIN SOS. GARII CATELU NR. 130",1899,563,552,11,0,556,7,2000,1437,340,216,1,16972,0
44,"Sectorul 3",179169,"#N/A",179169,,"BUCURESTI SECTORUL 3",625,"SCOALA GENERALA NR. 78, DIN SOS. GARII CATELU NR. 50",2132,455,438,17,0,449,6,2300,1845,219,230,1,16972,0
44,"Sectorul 3",179169,"#N/A",179169,,"BUCURESTI SECTORUL 3",626,"SCOALA GENERALA NR. 78, DIN SOS. GARII CATELU NR. 50",1928,699,689,10,0,695,4,2000,1301,343,352,1,16972,0
44,"Sectorul 3",179169,"#N/A",179169,,"BUCURESTI SECTORUL 3",627,"SCOALA GENERALA NR. 78, DIN SOS. GARII CATELU NR. 50",2086,237,229,8,0,237,0,2191,1954,132,105,1,16972,0
44,"Sectorul 3",179169,"#N/A",179169,,"BUCURESTI SECTORUL 3",628,"SCOALA GENERALA NR. 78, DIN SOS. GARII CATELU NR. 50",2012,324,312,12,0,322,2,2100,1776,175,147,1,16972,0
44,"Sectorul 3",179169,"#N/A",179169,,"BUCURESTI SECTORUL 3",629,"SCOALA GENERALA NR. 78, DIN SOS. GARII CATELU NR. 50",2107,351,340,11,0,349,2,2200,1849,177,172,1,16972,0
44,"Sectorul 3",179169,"#N/A",179169,,"BUCURESTI SECTORUL 3",630,"SCOALA GENERALA NR. 67, DIN STR. MAGNETULUI NR. 1-3",1953,777,765,11,1,772,5,2098,1321,387,385,1,16972,0
44,"Sectorul 3",179169,"#N/A",179169,,"BUCURESTI SECTORUL 3",631,"SCOALA GENERALA NR. 67, DIN STR. MAGNETULUI NR. 1-3",1945,823,809,14,0,818,5,2100,1277,489,329,1,16972,0
44,"Sectorul 3",179169,"#N/A",179169,,"BUCURESTI SECTORUL 3",632,"SPITALUL DE PSIHIATRIE ""DR. CONSTANTIN GORGOS"", DIN BD. NICOLAE GRIGORESCU NR.41A",0,1315,0,1315,0,1301,14,1485,170,791,510,1,16972,1
44,"Sectorul 3",179169,"#N/A",179169,,"BUCURESTI SECTORUL 3",633,"SPITALUL JUSTITIEI ""DR. CONSTANTIN ANGELESCU"", DIN ALEEA CAUZASI NR.49-5",0,1025,0,1025,0,1010,15,1485,460,528,482,1,16972,1
44,"Sectorul 3",179169,"#N/A",179169,,"BUCURESTI SECTORUL 3",634,"INSTITUTUL NATIONAL DE RECUPERARE, MEDICINA FIZICA SI BALNEOCLIMATOLOGIE , DIN STR. SF DUMITRU NR.2",0,1021,0,1021,0,999,22,1485,464,530,469,1,16972,1
44,"Sectorul 3",179169,"#N/A",179169,,"BUCURESTI SECTORUL 3",635,"SPITALUL ""COLTEA"", DIN BD. IC BRATIANU NR.1",0,844,0,844,0,831,13,1485,641,513,318,1,16972,1
44,"Sectorul 3",179169,"#N/A",179169,,"BUCURESTI SECTORUL 3",636,"SPITALUL ""CARITAS"", DIN STR. TRAIAN NR. 29",0,1405,0,1405,0,1390,15,1485,80,831,559,1,16972,1
44,"Sectorul 3",179169,"#N/A",179169,,"BUCURESTI SECTORUL 3",637,"SPITALUL CLINIC DE BOLI INFECTIOASE SI TROPICALE ""DR. VICTOR BABES"", DIN SOS. MIHAI BRAVU NR. 281",0,1044,0,1044,0,1033,11,1478,434,605,428,1,16972,1
44,"Sectorul 3",179169,"#N/A",179169,,"BUCURESTI SECTORUL 3",638,"CAMINUL DE BATRANI NR.5, DIN CALEA VITAN 267-269",0,1169,0,1169,0,1161,8,1473,304,670,491,1,16972,1
45,"Sectorul 4",179178,"#N/A",179178,,"BUCURESTI SECTORUL 4",639,"COLEGIUL NATIONAL ""MIHAI EMINESCU"", DIN STR. GEORGE GEORGESCU NR.2",1293,734,727,7,0,726,8,1400,666,297,429,1,16973,0
45,"Sectorul 4",179178,"#N/A",179178,,"BUCURESTI SECTORUL 4",640,"COLEGIUL NATIONAL ""MIHAI EMINESCU"", DIN STR. GEORGE GEORGESCU NR.2",1491,735,644,12,79,717,18,1600,865,324,393,1,16973,0
45,"Sectorul 4",179178,"#N/A",179178,,"BUCURESTI SECTORUL 4",641,"COLEGIUL NATIONAL ""MIHAI EMINESCU"", DIN STR. GEORGE GEORGESCU NR.2",1285,648,629,19,0,642,6,1400,752,284,358,1,16973,0
45,"Sectorul 4",179178,"#N/A",179178,,"BUCURESTI SECTORUL 4",642,"GRADINITA NR. 224, DIN STR. GRAMONT NR.25",1291,627,615,11,1,620,7,1403,776,275,345,1,16973,0
45,"Sectorul 4",179178,"#N/A",179178,,"BUCURESTI SECTORUL 4",643,"GRADINITA NR. 224, DIN STR. GRAMONT NR.25",1334,672,654,18,0,659,13,1495,823,316,343,1,16973,0
45,"Sectorul 4",179178,"#N/A",179178,,"BUCURESTI SECTORUL 4",644,"SCOALA NR. 74 ""IENACHITA VACARESCU"", DIN CALEA SERBAN VODA NR.62-64",1290,719,708,10,1,707,12,1392,673,347,360,1,16973,0
45,"Sectorul 4",179178,"#N/A",179178,,"BUCURESTI SECTORUL 4",645,"SCOALA NR. 74 ""IENACHITA VACARESCU"", DIN CALEA SERBAN VODA NR.62-64",1249,675,656,16,3,662,13,1400,725,315,347,1,16973,0
45,"Sectorul 4",179178,"#N/A",179178,,"BUCURESTI SECTORUL 4",646,"SCOALA NR. 74 ""IENACHITA VACARESCU"", DIN CALEA SERBAN VODA NR.62-64",1198,674,660,13,1,666,8,1300,626,292,374,1,16973,0
45,"Sectorul 4",179178,"#N/A",179178,,"BUCURESTI SECTORUL 4",647,"SCOALA NR. 74 ""IENACHITA VACARESCU"", DIN CALEA SERBAN VODA NR.62-64",1407,711,700,11,0,696,15,1500,789,280,416,1,16973,0
45,"Sectorul 4",179178,"#N/A",179178,,"BUCURESTI SECTORUL 4",648,"SCOALA NR. 79, DIN STR. CUZA VODA NR.51",1092,619,606,12,1,610,9,1208,589,234,376,1,16973,0
45,"Sectorul 4",179178,"#N/A",179178,,"BUCURESTI SECTORUL 4",649,"SCOALA NR. 79, DIN STR. CUZA VODA NR.51",1169,679,669,8,2,669,10,1288,609,271,398,1,16973,0
45,"Sectorul 4",179178,"#N/A",179178,,"BUCURESTI SECTORUL 4",650,"SCOALA NR. 79, DIN STR. CUZA VODA NR.51",1382,702,693,9,0,689,13,1500,798,349,340,1,16973,0
45,"Sectorul 4",179178,"#N/A",179178,,"BUCURESTI SECTORUL 4",651,"COLEGIUL NATIONAL ""ION CREANGA"", DIN STR. CUZA VODA NR.51",1354,710,696,14,0,703,7,1500,790,349,354,1,16973,0
45,"Sectorul 4",179178,"#N/A",179178,,"BUCURESTI SECTORUL 4",652,"COLEGIUL NATIONAL ""ION CREANGA"", DIN STR. CUZA VODA NR.51",1156,671,659,12,0,664,7,1300,629,280,384,1,16973,0
45,"Sectorul 4",179178,"#N/A",179178,,"BUCURESTI SECTORUL 4",653,"GUPUL SCOLAR INDUSTRIAL ""GRIGORE CERCHEZ"", DIN CALEA SERBAN VODA NR.280",1213,690,678,12,0,677,13,1300,610,284,393,1,16973,0
45,"Sectorul 4",179178,"#N/A",179178,,"BUCURESTI SECTORUL 4",654,"GUPUL SCOLAR INDUSTRIAL ""GRIGORE CERCHEZ"", DIN CALEA SERBAN VODA NR.280",1383,724,711,13,0,712,12,1500,776,384,328,1,16973,0
45,"Sectorul 4",179178,"#N/A",179178,,"BUCURESTI SECTORUL 4",655,"COLEGIUL NATIONAL """"GHEORGHE SINCAI"" "", DIN CALEA SERBAN VODA NR.167",1289,765,750,14,1,752,13,1400,635,377,375,1,16973,0
45,"Sectorul 4",179178,"#N/A",179178,,"BUCURESTI SECTORUL 4",656,"COLEGIUL NATIONAL ""GHEORGHE SINCAI"", DIN CALEA SERBAN VODA NR.167",1125,706,696,10,0,699,7,1199,493,348,351,1,16973,0
45,"Sectorul 4",179178,"#N/A",179178,,"BUCURESTI SECTORUL 4",657,"COLEGIUL NATIONAL ""GHEORGHE SINCAI"", DIN CALEA SERBAN VODA NR.167",1470,902,895,7,0,882,20,1600,698,375,507,1,16973,0
45,"Sectorul 4",179178,"#N/A",179178,,"BUCURESTI SECTORUL 4",658,"COLEGIUL NATIONAL ""GHEORGHE SINCAI"", DIN CALEA SERBAN VODA NR.167",1254,806,797,9,0,794,12,1400,594,323,471,1,16973,0
45,"Sectorul 4",179178,"#N/A",179178,,"BUCURESTI SECTORUL 4",659,"COLEGIUL NATIONAL ""GHEORGHE SINCAI"", DIN CALEA SERBAN VODA NR.167",1591,993,979,13,1,979,14,1800,807,434,545,1,16973,0
45,"Sectorul 4",179178,"#N/A",179178,,"BUCURESTI SECTORUL 4",660,"SCOALA NR.97, DIN STR. VIORELE NR.7",1435,856,847,8,1,841,15,1600,744,408,433,1,16973,0
45,"Sectorul 4",179178,"#N/A",179178,,"BUCURESTI SECTORUL 4",661,"SCOALA NR.97, DIN STR. VIORELE NR.7",1504,963,954,6,3,950,13,1699,736,474,476,1,16973,0
45,"Sectorul 4",179178,"#N/A",179178,,"BUCURESTI SECTORUL 4",662,"SCOALA NR.97, DIN STR. VIORELE NR.7",1359,865,853,11,1,850,15,1500,635,388,462,1,16973,0
45,"Sectorul 4",179178,"#N/A",179178,,"BUCURESTI SECTORUL 4",663,"SCOALA NR.97, DIN STR. VIORELE NR.7",1315,830,815,13,2,809,21,1396,566,358,451,1,16973,0
45,"Sectorul 4",179178,"#N/A",179178,,"BUCURESTI SECTORUL 4",664,"SCOALA NR.97, DIN STR. VIORELE NR.7",1078,647,638,9,0,641,6,1209,562,297,344,1,16973,0
45,"Sectorul 4",179178,"#N/A",179178,,"BUCURESTI SECTORUL 4",665,"COLEGIUL TEHNIC ""PETRU RARES"", DIN STR. V.V. STANCIU NR.6",1236,736,724,12,0,727,9,1400,664,326,401,1,16973,0
45,"Sectorul 4",179178,"#N/A",179178,,"BUCURESTI SECTORUL 4",666,"COLEGIUL TEHNIC ""PETRU RARES"", DIN STR. V.V. STANCIU NR.6",1274,809,796,13,0,800,9,1400,591,371,429,1,16973,0
45,"Sectorul 4",179178,"#N/A",179178,,"BUCURESTI SECTORUL 4",667,"COLEGIUL TEHNIC ""PETRU RARES"", DIN STR. V.V. STANCIU NR.6",1216,740,731,9,0,720,20,1300,560,314,406,1,16973,0
45,"Sectorul 4",179178,"#N/A",179178,,"BUCURESTI SECTORUL 4",668,"COLEGIUL TEHNIC ""PETRU RARES"", DIN STR. V.V. STANCIU NR.6",1019,605,595,10,0,589,16,1101,496,292,297,1,16973,0
45,"Sectorul 4",179178,"#N/A",179178,,"BUCURESTI SECTORUL 4",669,"SCOALA NR.100 ""ANDREI SAGUNA"", DIN CALEA VACARESTI NR.296",1416,822,798,24,0,807,15,1600,778,393,414,1,16973,0
45,"Sectorul 4",179178,"#N/A",179178,,"BUCURESTI SECTORUL 4",670,"SCOALA NR.100 ""ANDREI SAGUNA"", DIN CALEA VACARESTI NR.296",1481,858,846,12,0,846,12,1600,742,395,451,1,16973,0
45,"Sectorul 4",179178,"#N/A",179178,,"BUCURESTI SECTORUL 4",671,"SCOALA NR.100 ""ANDREI SAGUNA"", DIN CALEA VACARESTI NR.296",1313,692,679,13,0,686,6,1399,707,320,366,1,16973,0
45,"Sectorul 4",179178,"#N/A",179178,,"BUCURESTI SECTORUL 4",672,"SCOALA NR.100 ""ANDREI SAGUNA"", DIN CALEA VACARESTI NR.296",1552,994,977,17,0,980,14,1700,706,429,551,1,16973,0
45,"Sectorul 4",179178,"#N/A",179178,,"BUCURESTI SECTORUL 4",673,"SCOALA NR.100 ""ANDREI SAGUNA"", DIN CALEA VACARESTI NR.296",1520,967,947,20,0,959,8,1700,733,374,585,1,16973,0
45,"Sectorul 4",179178,"#N/A",179178,,"BUCURESTI SECTORUL 4",674,"GUPUL SCOLAR INDUSTRIAL ""DACIA"", DIN STR. CAP.GRIGORE MARIN NR.42-44",2094,1032,1018,14,0,1020,12,2300,1268,558,462,1,16973,0
45,"Sectorul 4",179178,"#N/A",179178,,"BUCURESTI SECTORUL 4",675,"GUPUL SCOLAR INDUSTRIAL ""DACIA"", DIN STR. CAP.GRIGORE MARIN NR.42-44",1851,911,888,23,0,901,10,2000,1089,516,385,1,16973,0
45,"Sectorul 4",179178,"#N/A",179178,,"BUCURESTI SECTORUL 4",676,"COLEGIUL TEHNIC ""MIRON NICOLESCU"" (FOST I.M.G.B.), DIN BD. METALURGIEI NR.89",2231,1034,1014,20,0,1020,14,2500,1466,492,528,1,16973,0
45,"Sectorul 4",179178,"#N/A",179178,,"BUCURESTI SECTORUL 4",677,"COLEGIUL TEHNIC ""MIRON NICOLESCU"" (FOST I.M.G.B.), DIN BD.  METALURGIEI NR.89",2289,975,956,19,0,957,18,2500,1525,508,449,1,16973,0
45,"Sectorul 4",179178,"#N/A",179178,,"BUCURESTI SECTORUL 4",678,"GRADINITA NR. 166, DIN STR. PANSELELOR NR.38-40",2223,1108,1100,8,0,1092,16,2400,1292,571,521,1,16973,0
45,"Sectorul 4",179178,"#N/A",179178,,"BUCURESTI SECTORUL 4",679,"GRADINITA NR. 166, DIN STR. PANSELELOR NR.38-40",2183,1124,1105,19,0,1107,17,2404,1280,575,532,1,16973,0
45,"Sectorul 4",179178,"#N/A",179178,,"BUCURESTI SECTORUL 4",680,"GRADINITA NR. 166, DIN STR. PANSELELOR NR.38-40",2138,1050,1040,10,0,1029,21,2400,1350,541,488,1,16973,0
45,"Sectorul 4",179178,"#N/A",179178,,"BUCURESTI SECTORUL 4",681,"GRADINITA NR. 166, DIN STR. PANSELELOR NR.38-40",2106,1067,1056,11,0,1052,15,2299,1232,532,520,1,16973,0
45,"Sectorul 4",179178,"#N/A",179178,,"BUCURESTI SECTORUL 4",682,"GRADINITA NR. 166, DIN STR. PANSELELOR NR.38-40",1863,927,916,11,0,916,11,2000,1073,452,464,1,16973,0
45,"Sectorul 4",179178,"#N/A",179178,,"BUCURESTI SECTORUL 4",683,"SCOALA NR.102 ""GENERAL EREMIA GRIGORESCU"", DIN STR. CPT.EREMIA POPESCU NR.27",1816,868,861,7,0,865,3,2000,1132,454,411,1,16973,0
45,"Sectorul 4",179178,"#N/A",179178,,"BUCURESTI SECTORUL 4",684,"SCOALA NR.102 ""GENERAL EREMIA GRIGORESCU"", DIN STR. CPT.EREMIA POPESCU NR.27",1916,1002,993,9,0,988,14,2100,1098,493,495,1,16973,0
45,"Sectorul 4",179178,"#N/A",179178,,"BUCURESTI SECTORUL 4",685,"SCOALA NR.102 ""GENERAL EREMIA GRIGORESCU"", DIN STR. CPT.EREMIA POPESCU NR.27",1834,969,959,10,0,963,6,2000,1031,513,450,1,16973,0
45,"Sectorul 4",179178,"#N/A",179178,,"BUCURESTI SECTORUL 4",686,"SCOALA NR.102 ""GENERAL EREMIA GRIGORESCU"", DIN STR. CPT.EREMIA POPESCU NR.27",1776,926,918,8,0,915,11,2000,1074,462,453,1,16973,0
45,"Sectorul 4",179178,"#N/A",179178,,"BUCURESTI SECTORUL 4",687,"SCOALA NR.102 ""GENERAL EREMIA GRIGORESCU"", DIN STR. CPT.EREMIA POPESCU NR.27",1809,888,878,10,0,878,10,2000,1112,449,429,1,16973,0
45,"Sectorul 4",179178,"#N/A",179178,,"BUCURESTI SECTORUL 4",688,"SCOALA NR.102 ""GENERAL EREMIA GRIGORESCU"", DIN STR. CPT.EREMIA POPESCU NR.27",1882,897,885,12,0,889,8,2100,1203,448,441,1,16973,0
45,"Sectorul 4",179178,"#N/A",179178,,"BUCURESTI SECTORUL 4",689,"SCOALA NR.102 ""GENERAL EREMIA GRIGORESCU"", DIN STR. CPT.EREMIA POPESCU NR.27",1807,882,871,11,0,869,13,2000,1118,459,410,1,16973,0
45,"Sectorul 4",179178,"#N/A",179178,,"BUCURESTI SECTORUL 4",690,"SCOALA NR.133, DIN STR. STANJENEILOR NR.3",1707,904,892,12,0,889,15,1900,996,417,472,1,16973,0
45,"Sectorul 4",179178,"#N/A",179178,,"BUCURESTI SECTORUL 4",691,"SCOALA NR.133, DIN STR. STANJENEILOR NR.3",1770,944,935,8,1,933,11,1899,955,452,481,1,16973,0
45,"Sectorul 4",179178,"#N/A",179178,,"BUCURESTI SECTORUL 4",692,"SCOALA NR.133, DIN STR. STANJENEILOR NR.3",1674,929,911,18,0,917,12,1798,869,429,488,1,16973,0
45,"Sectorul 4",179178,"#N/A",179178,,"BUCURESTI SECTORUL 4",693,"SCOALA NR.133, DIN STR. STANJENEILOR NR.3",1786,934,926,8,0,924,10,2000,1066,466,458,1,16973,0
45,"Sectorul 4",179178,"#N/A",179178,,"BUCURESTI SECTORUL 4",694,"SCOALA NR.133, DIN STR. STANJENEILOR NR.3",1734,861,850,11,0,852,9,1900,1039,427,425,1,16973,0
45,"Sectorul 4",179178,"#N/A",179178,,"BUCURESTI SECTORUL 4",695,"SCOALA NR.133, DIN STR. STANJENEILOR NR.3",1661,916,904,10,2,898,18,1800,884,430,468,1,16973,0
45,"Sectorul 4",179178,"#N/A",179178,,"BUCURESTI SECTORUL 4",696,"SCOALA NR.113, DIN STR. PARINCEA NR.4",1847,1023,1008,14,1,1001,22,2003,980,480,521,1,16973,0
45,"Sectorul 4",179178,"#N/A",179178,,"BUCURESTI SECTORUL 4",697,"SCOALA NR.113, DIN STR. PARINCEA NR.4",1985,1109,1097,12,0,1097,12,2199,1090,584,513,1,16973,0
45,"Sectorul 4",179178,"#N/A",179178,,"BUCURESTI SECTORUL 4",698,"SCOALA NR.113, DIN STR. PARINCEA NR.4",1902,996,989,7,0,979,17,2100,1104,488,491,1,16973,0
45,"Sectorul 4",179178,"#N/A",179178,,"BUCURESTI SECTORUL 4",699,"SCOALA NR.113, DIN STR. PARINCEA NR.4",2088,1174,1166,8,0,1166,8,2300,1126,565,601,1,16973,0
45,"Sectorul 4",179178,"#N/A",179178,,"BUCURESTI SECTORUL 4",700,"SCOALA NR.113, DIN STR. PARINCEA NR.4",2047,1044,1030,14,0,1033,11,2302,1258,493,540,1,16973,0
45,"Sectorul 4",179178,"#N/A",179178,,"BUCURESTI SECTORUL 4",701,"SCOALA NR.113, DIN STR. PARINCEA NR.4",1997,1063,1039,24,0,1043,20,2200,1137,503,540,1,16973,0
45,"Sectorul 4",179178,"#N/A",179178,,"BUCURESTI SECTORUL 4",702,"SCOALA NR.120 ""MARTISOR"", DIN STR. MARTISOR NR.39",1923,951,931,20,0,940,11,2100,1149,456,484,1,16973,0
45,"Sectorul 4",179178,"#N/A",179178,,"BUCURESTI SECTORUL 4",703,"SCOALA NR.120 ""MARTISOR"", DIN STR. MARTISOR NR.39",1359,756,747,9,0,743,13,1500,744,302,441,1,16973,0
45,"Sectorul 4",179178,"#N/A",179178,,"BUCURESTI SECTORUL 4",704,"SCOALA NR.120 ""MARTISOR"", DIN STR. MARTISOR NR.39",1632,854,844,10,0,846,8,1797,943,432,414,1,16973,0
45,"Sectorul 4",179178,"#N/A",179178,,"BUCURESTI SECTORUL 4",705,"SCOALA NR.120 ""MARTISOR"", DIN STR. MARTISOR NR.39",1489,780,768,12,0,768,12,1600,820,370,398,1,16973,0
45,"Sectorul 4",179178,"#N/A",179178,,"BUCURESTI SECTORUL 4",706,"SCOALA NR.120 ""MARTISOR"", DIN STR. MARTISOR NR.39",1492,773,764,9,0,762,11,1600,827,350,412,1,16973,0
45,"Sectorul 4",179178,"#N/A",179178,,"BUCURESTI SECTORUL 4",707,"SCOALA NR.190 ""MARCELA PENES"", DIN STR. SRG.NITU VASILE NR.16",1823,1053,1034,19,0,1034,19,2000,947,445,589,1,16973,0
45,"Sectorul 4",179178,"#N/A",179178,,"BUCURESTI SECTORUL 4",708,"SCOALA NR.190 ""MARCELA PENES"", DIN STR. SRG.NITU VASILE NR.16",1476,853,841,12,0,841,12,1600,747,382,459,1,16973,0
45,"Sectorul 4",179178,"#N/A",179178,,"BUCURESTI SECTORUL 4",709,"SCOALA NR.190 ""MARCELA PENES"", DIN STR. SRG.NITU VASILE NR.16",1396,752,742,10,0,739,13,1501,749,364,375,1,16973,0
45,"Sectorul 4",179178,"#N/A",179178,,"BUCURESTI SECTORUL 4",710,"SCOALA NR.190 ""MARCELA PENES"", DIN STR. SRG.NITU VASILE NR.16",1588,799,786,13,0,786,13,1700,901,329,457,1,16973,0
45,"Sectorul 4",179178,"#N/A",179178,,"BUCURESTI SECTORUL 4",711,"SCOALA NR.190 ""MARCELA PENES"", DIN STR. SRG.NITU VASILE NR.16",1437,765,757,8,0,758,7,1600,835,358,400,1,16973,0
45,"Sectorul 4",179178,"#N/A",179178,,"BUCURESTI SECTORUL 4",712,"SCOALA NR.190 ""MARCELA PENES"", DIN STR. SRG.NITU VASILE NR.16",1333,663,652,11,0,654,9,1500,837,308,346,1,16973,0
45,"Sectorul 4",179178,"#N/A",179178,,"BUCURESTI SECTORUL 4",713,"SCOALA NR.190 ""MARCELA PENES"", DIN STR. SRG.NITU VASILE NR.16",1423,798,782,15,1,790,8,1600,802,379,411,1,16973,0
45,"Sectorul 4",179178,"#N/A",179178,,"BUCURESTI SECTORUL 4",714,"SCOALA NR. 96, DIN STR. REZONANTEI NR. 2",1017,562,554,8,0,555,7,1100,538,268,287,1,16973,0
45,"Sectorul 4",179178,"#N/A",179178,,"BUCURESTI SECTORUL 4",715,"SCOALA NR. 96, DIN STR. REZONANTEI NR. 2",1276,697,687,10,0,687,10,1400,703,312,375,1,16973,0
45,"Sectorul 4",179178,"#N/A",179178,,"BUCURESTI SECTORUL 4",716,"SCOALA NR. 96, DIN STR. REZONANTEI NR. 2",1177,590,573,17,0,582,8,1300,710,283,299,1,16973,0
45,"Sectorul 4",179178,"#N/A",179178,,"BUCURESTI SECTORUL 4",717,"SCOALA NR. 96, DIN STR. REZONANTEI NR. 2",1844,990,979,11,0,983,7,2000,1010,459,524,1,16973,0
45,"Sectorul 4",179178,"#N/A",179178,,"BUCURESTI SECTORUL 4",718,"SCOALA NR. 96, DIN STR. REZONANTEI NR. 2",1332,730,715,15,0,705,25,1500,770,326,379,1,16973,0
45,"Sectorul 4",179178,"#N/A",179178,,"BUCURESTI SECTORUL 4",719,"COLEGIUL NATIONAL ""OCTAV ONICESCU"", DIN STR.TRIVALE NR. 29",1829,947,938,9,0,932,15,1999,1052,464,468,1,16973,0
45,"Sectorul 4",179178,"#N/A",179178,,"BUCURESTI SECTORUL 4",720,"COLEGIUL NATIONAL ""OCTAV ONICESCU"", DIN STR.TRIVALE NR. 29",1313,746,738,8,0,732,14,1400,654,346,386,1,16973,0
45,"Sectorul 4",179178,"#N/A",179178,,"BUCURESTI SECTORUL 4",721,"COLEGIUL NATIONAL ""OCTAV ONICESCU"", DIN STR.TRIVALE NR. 29",1553,783,774,9,0,768,15,1700,917,347,421,1,16973,0
45,"Sectorul 4",179178,"#N/A",179178,,"BUCURESTI SECTORUL 4",722,"COLEGIUL NATIONAL ""OCTAV ONICESCU"", DIN STR.TRIVALE NR. 29",1467,875,864,10,1,867,8,1600,725,369,498,1,16973,0
45,"Sectorul 4",179178,"#N/A",179178,,"BUCURESTI SECTORUL 4",723,"SCOALA NR. 108 ""ALEXANDRU OBREGIA"", DIN STR. VATRA DORNEI NR. 8",1480,870,857,12,1,862,8,1598,728,403,459,1,16973,0
45,"Sectorul 4",179178,"#N/A",179178,,"BUCURESTI SECTORUL 4",724,"SCOALA NR. 108 ""ALEXANDRU OBREGIA"", DIN STR. VATRA DORNEI NR. 8",1446,837,824,13,0,824,13,1600,763,382,442,1,16973,0
45,"Sectorul 4",179178,"#N/A",179178,,"BUCURESTI SECTORUL 4",725,"SCOALA NR. 108 ""ALEXANDRU OBREGIA"", DIN STR. VATRA DORNEI NR. 8",1563,893,884,8,1,883,10,1700,807,445,438,1,16973,0
45,"Sectorul 4",179178,"#N/A",179178,,"BUCURESTI SECTORUL 4",726,"SCOALA NR. 108 ""ALEXANDRU OBREGIA"", DIN STR. VATRA DORNEI NR. 8",1599,891,871,18,2,876,15,1800,909,443,433,1,16973,0
45,"Sectorul 4",179178,"#N/A",179178,,"BUCURESTI SECTORUL 4",727,"SCOALA NR. 108 ""ALEXANDRU OBREGIA"", DIN STR. VATRA DORNEI NR. 8",1477,816,807,9,0,800,16,1600,784,371,429,1,16973,0
45,"Sectorul 4",179178,"#N/A",179178,,"BUCURESTI SECTORUL 4",728,"SCOALA NR. 98 """"AVRAM IANCU"""", DIN STR. STUPILOR NR. 1",1920,1144,1133,10,1,1132,12,2100,956,553,579,1,16973,0
45,"Sectorul 4",179178,"#N/A",179178,,"BUCURESTI SECTORUL 4",729,"SCOALA NR. 98 """"AVRAM IANCU"""", DIN STR. STUPILOR NR. 1",1385,841,829,12,0,827,14,1500,659,349,478,1,16973,0
45,"Sectorul 4",179178,"#N/A",179178,,"BUCURESTI SECTORUL 4",730,"SCOALA NR. 98 """"AVRAM IANCU"""", DIN STR. STUPILOR NR. 1",1269,681,673,8,0,675,6,1400,719,294,381,1,16973,0
45,"Sectorul 4",179178,"#N/A",179178,,"BUCURESTI SECTORUL 4",731,"SCOALA NR. 98 """"AVRAM IANCU"""", DIN STR. STUPILOR NR. 1",986,485,480,5,0,478,7,1100,615,238,240,1,16973,0
45,"Sectorul 4",179178,"#N/A",179178,,"BUCURESTI SECTORUL 4",732,"SCOALA NR. 98 """"AVRAM IANCU"""", DIN STR. STUPILOR NR. 1",1667,965,949,16,0,952,13,1800,835,449,503,1,16973,0
45,"Sectorul 4",179178,"#N/A",179178,,"BUCURESTI SECTORUL 4",733,"SCOALA NR. 189 ""ALEXANDRU ODOBESCU"", DIN ALEEA CICEU NR.12",1177,602,592,10,0,592,10,1300,698,237,355,1,16973,0
45,"Sectorul 4",179178,"#N/A",179178,,"BUCURESTI SECTORUL 4",734,"SCOALA NR. 189 ""ALEXANDRU ODOBESCU"", DIN ALEEA CICEU NR.12",1105,537,518,19,0,528,9,1203,666,233,295,1,16973,0
45,"Sectorul 4",179178,"#N/A",179178,,"BUCURESTI SECTORUL 4",735,"SCOALA NR. 189 ""ALEXANDRU ODOBESCU"", DIN ALEEA CICEU NR.12",1378,730,716,14,0,716,14,1498,768,305,411,1,16973,0
45,"Sectorul 4",179178,"#N/A",179178,,"BUCURESTI SECTORUL 4",736,"SCOALA NR. 189 ""ALEXANDRU ODOBESCU"", DIN ALEEA CICEU NR.12",1201,677,659,18,0,667,10,1308,631,298,369,1,16973,0
45,"Sectorul 4",179178,"#N/A",179178,,"BUCURESTI SECTORUL 4",737,"SCOALA NR. 189 ""ALEXANDRU ODOBESCU"", DIN ALEEA CICEU NR.12",1366,731,721,10,0,720,11,1500,769,344,376,1,16973,0
45,"Sectorul 4",179178,"#N/A",179178,,"BUCURESTI SECTORUL 4",738,"SCOALA NR. 93 ""EMIL RACOVITA"", DIN ALEEA EMIL RACOVITA NR.1",1683,839,829,10,0,835,4,1900,1061,454,381,1,16973,0
45,"Sectorul 4",179178,"#N/A",179178,,"BUCURESTI SECTORUL 4",739,"SCOALA NR. 93 ""EMIL RACOVITA"", DIN ALEEA EMIL RACOVITA NR.1",1587,854,844,10,0,841,13,1700,846,372,469,1,16973,0
45,"Sectorul 4",179178,"#N/A",179178,,"BUCURESTI SECTORUL 4",740,"SCOALA NR. 93 ""EMIL RACOVITA"", DIN ALEEA EMIL RACOVITA NR.1",1662,816,804,12,0,805,11,1800,984,393,412,1,16973,0
45,"Sectorul 4",179178,"#N/A",179178,,"BUCURESTI SECTORUL 4",741,"SCOALA NR. 93 ""EMIL RACOVITA"", DIN ALEEA EMIL RACOVITA NR.1",1630,868,857,11,0,856,12,1800,932,430,426,1,16973,0
45,"Sectorul 4",179178,"#N/A",179178,,"BUCURESTI SECTORUL 4",742,"GRADINITA NR. 264, DIN STR. ALIORULUI NR. 5",1386,736,727,9,0,726,10,1600,864,375,351,1,16973,0
45,"Sectorul 4",179178,"#N/A",179178,,"BUCURESTI SECTORUL 4",743,"GRADINITA NR. 264, DIN STR. ALIORULUI NR. 5",1070,576,559,17,0,569,7,1200,624,253,316,1,16973,0
45,"Sectorul 4",179178,"#N/A",179178,,"BUCURESTI SECTORUL 4",744,"GRADINITA NR. 264, DIN STR. ALIORULUI NR. 5",1553,901,889,12,0,880,21,1700,799,438,442,1,16973,0
45,"Sectorul 4",179178,"#N/A",179178,,"BUCURESTI SECTORUL 4",745,"SCOALA  NR. 194 ""MARIN SORESCU"", DIN BD. ALEXANDRU OBREGIA NR.3A",1089,641,628,13,0,627,14,1204,563,296,331,1,16973,0
45,"Sectorul 4",179178,"#N/A",179178,,"BUCURESTI SECTORUL 4",746,"SCOALA  NR. 194 ""MARIN SORESCU"", DIN BD. ALEXANDRU OBREGIA NR.3A",970,516,506,9,1,506,10,1100,584,201,305,1,16973,0
45,"Sectorul 4",179178,"#N/A",179178,,"BUCURESTI SECTORUL 4",747,"SCOALA  NR. 194 ""MARIN SORESCU"", DIN BD. ALEXANDRU OBREGIA NR.3A",1259,677,667,10,0,671,6,1400,723,329,342,1,16973,0
45,"Sectorul 4",179178,"#N/A",179178,,"BUCURESTI SECTORUL 4",748,"SCOALA  NR. 194 ""MARIN SORESCU"", DIN BD. ALEXANDRU OBREGIA NR.3A",1673,881,874,7,0,872,9,1801,920,423,449,1,16973,0
45,"Sectorul 4",179178,"#N/A",179178,,"BUCURESTI SECTORUL 4",749,"SCOALA  NR. 194 ""MARIN SORESCU"", DIN BD. ALEXANDRU OBREGIA NR.3A",1230,642,631,11,0,635,7,1382,740,298,337,1,16973,0
45,"Sectorul 4",179178,"#N/A",179178,,"BUCURESTI SECTORUL 4",750,"SCOALA  NR. 194 ""MARIN SORESCU"", DIN BD. ALEXANDRU OBREGIA NR.3A",1260,764,735,7,22,760,4,1398,634,314,446,1,16973,0
45,"Sectorul 4",179178,"#N/A",179178,,"BUCURESTI SECTORUL 4",751,"GRADINITA NR. 193, DIN ALEEA TERASEI NR. 8",1071,559,551,8,0,556,3,1216,657,243,313,1,16973,0
45,"Sectorul 4",179178,"#N/A",179178,,"BUCURESTI SECTORUL 4",752,"GRADINITA NR. 193, DIN ALEEA TERASEI NR. 8",1198,713,704,9,0,708,5,1300,587,284,424,1,16973,0
45,"Sectorul 4",179178,"#N/A",179178,,"BUCURESTI SECTORUL 4",753,"SCOALA NR. 111 ""GEORGE BACOVIA""-CLADIRE CORP 2, DIN STR. FAGETULUI NR. 28",1270,680,669,11,0,674,6,1400,720,317,357,1,16973,0
45,"Sectorul 4",179178,"#N/A",179178,,"BUCURESTI SECTORUL 4",754,"SCOALA NR. 111 ""GEORGE BACOVIA""-CLADIRE CORP 2, DIN STR. FAGETULUI NR. 28",1475,825,815,10,0,811,14,1599,774,390,421,1,16973,0
45,"Sectorul 4",179178,"#N/A",179178,,"BUCURESTI SECTORUL 4",755,"SCOALA NR. 111 ""GEORGE BACOVIA"", DIN STR. STOIAN MILITARU NR.72",1999,952,938,14,0,936,16,2200,1248,445,491,1,16973,0
45,"Sectorul 4",179178,"#N/A",179178,,"BUCURESTI SECTORUL 4",756,"SCOALA NR. 111 ""GEORGE BACOVIA"", DIN STR. STOIAN MILITARU NR.72",1718,878,860,18,0,870,8,1910,1032,402,468,1,16973,0
45,"Sectorul 4",179178,"#N/A",179178,,"BUCURESTI SECTORUL 4",757,"SCOALA NR. 111 ""GEORGE BACOVIA"", DIN STR. STOIAN MILITARU NR.72",1949,958,950,8,0,943,15,2100,1142,431,512,1,16973,0
45,"Sectorul 4",179178,"#N/A",179178,,"BUCURESTI SECTORUL 4",758,"SCOALA NR. 111 ""GEORGE BACOVIA"", DIN STR. STOIAN MILITARU NR.72",2095,1039,1030,9,0,1033,6,2300,1261,494,539,1,16973,0
45,"Sectorul 4",179178,"#N/A",179178,,"BUCURESTI SECTORUL 4",759,"SCOALA NR. 111 ""GEORGE BACOVIA"", DIN STR. STOIAN MILITARU NR.72",1841,981,964,15,2,965,16,1997,1016,488,477,1,16973,0
45,"Sectorul 4",179178,"#N/A",179178,,"BUCURESTI SECTORUL 4",760,"GRADINITA NR. 263, DIN STR. STOIAN MILITARU NR.86-90",1228,733,721,12,0,725,8,1400,667,335,390,1,16973,0
45,"Sectorul 4",179178,"#N/A",179178,,"BUCURESTI SECTORUL 4",761,"GRADINITA NR. 263, DIN STR. STOIAN MILITARU NR.86-90",1529,742,727,14,1,732,10,1700,958,315,417,1,16973,0
45,"Sectorul 4",179178,"#N/A",179178,,"BUCURESTI SECTORUL 4",762,"GRADINITA NR.261 (FOSTA ADESGO), DIN STR. IMPARATUL TRAIAN NR.46",2098,1160,1146,14,0,1141,19,2301,1141,601,540,1,16973,0
45,"Sectorul 4",179178,"#N/A",179178,,"BUCURESTI SECTORUL 4",763,"GRADINITA NR.261 (FOSTA ADESGO), DIN STR. IMPARATUL TRAIAN NR.46",2017,1180,1167,13,0,1164,16,2200,1020,594,570,1,16973,0
45,"Sectorul 4",179178,"#N/A",179178,,"BUCURESTI SECTORUL 4",764,"GRADINITA NR.261 (FOSTA ADESGO), DIN STR. IMPARATUL TRAIAN NR.46",2125,917,900,17,0,907,10,2300,1383,519,388,1,16973,0
45,"Sectorul 4",179178,"#N/A",179178,,"BUCURESTI SECTORUL 4",765,"SCOALA NR. 109, DIN STR. PETRE TUTEA NR. 3",1709,712,701,11,0,700,12,1900,1188,405,295,1,16973,0
45,"Sectorul 4",179178,"#N/A",179178,,"BUCURESTI SECTORUL 4",766,"SCOALA NR. 109, DIN STR. PETRE TUTEA NR. 3",1757,899,889,10,0,884,15,1900,1001,449,435,1,16973,0
45,"Sectorul 4",179178,"#N/A",179178,,"BUCURESTI SECTORUL 4",767,"SCOALA NR. 109, DIN STR. PETRE TUTEA NR. 3",1625,821,810,11,0,808,13,1800,979,370,438,1,16973,0
45,"Sectorul 4",179178,"#N/A",179178,,"BUCURESTI SECTORUL 4",768,"SCOALA NR. 109, DIN STR. PETRE TUTEA NR. 3",1464,764,749,15,0,754,10,1600,836,376,378,1,16973,0
45,"Sectorul 4",179178,"#N/A",179178,,"BUCURESTI SECTORUL 4",769,"SCOALA NR. 109, DIN STR. PETRE TUTEA NR. 3",1556,851,837,13,1,838,13,1700,849,461,377,1,16973,0
45,"Sectorul 4",179178,"#N/A",179178,,"BUCURESTI SECTORUL 4",770,"GRADINITA NR. 262, DIN INTRAREA CRISUL ALB NR. 30",1458,714,697,17,0,708,6,1600,886,333,375,1,16973,0
45,"Sectorul 4",179178,"#N/A",179178,,"BUCURESTI SECTORUL 4",771,"GRADINITA NR. 262, DIN INTRAREA CRISUL ALB NR. 30",1273,645,633,12,0,637,8,1400,755,330,307,1,16973,0
45,"Sectorul 4",179178,"#N/A",179178,,"BUCURESTI SECTORUL 4",772,"GRADINITA NR. 228, DIN STR. SPINIS NR. 1",1573,845,831,13,1,834,11,1700,855,449,385,1,16973,0
45,"Sectorul 4",179178,"#N/A",179178,,"BUCURESTI SECTORUL 4",773,"GRADINITA NR. 228, DIN STR. SPINIS NR. 1",1509,863,847,16,0,846,17,1700,837,380,466,1,16973,0
45,"Sectorul 4",179178,"#N/A",179178,,"BUCURESTI SECTORUL 4",774,"SCOALA NR. 308, DIN STR. RAUL SOIMULUI NR.8",1435,778,765,13,0,768,10,1600,822,396,372,1,16973,0
45,"Sectorul 4",179178,"#N/A",179178,,"BUCURESTI SECTORUL 4",775,"SCOALA NR. 308, DIN STR. RAUL SOIMULUI NR.8",1318,682,669,13,0,676,6,1611,929,306,370,1,16973,0
45,"Sectorul 4",179178,"#N/A",179178,,"BUCURESTI SECTORUL 4",776,"SCOALA NR. 308, DIN STR. RAUL SOIMULUI NR.8",1546,728,714,14,0,721,7,1700,972,339,382,1,16973,0
45,"Sectorul 4",179178,"#N/A",179178,,"BUCURESTI SECTORUL 4",777,"SCOALA NR. 308, DIN STR. RAUL SOIMULUI NR.8",1666,724,714,10,0,713,11,1800,1076,386,327,1,16973,0
45,"Sectorul 4",179178,"#N/A",179178,,"BUCURESTI SECTORUL 4",778,"SCOALA NR. 110 ""GEORGE TOPARCEANU"", DIN STR. ARGESELU NR. 6",1623,821,811,10,0,810,11,1800,979,422,388,1,16973,0
45,"Sectorul 4",179178,"#N/A",179178,,"BUCURESTI SECTORUL 4",779,"SCOALA NR. 110 ""GEORGE TOPARCEANU"", DIN STR. ARGESELU NR. 6",1627,827,815,12,0,819,8,1800,973,417,402,1,16973,0
45,"Sectorul 4",179178,"#N/A",179178,,"BUCURESTI SECTORUL 4",780,"SCOALA NR. 110 ""GEORGE TOPARCEANU"", DIN STR. ARGESELU NR. 6",1541,757,744,13,0,746,11,1700,943,384,362,1,16973,0
45,"Sectorul 4",179178,"#N/A",179178,,"BUCURESTI SECTORUL 4",781,"SCOALA NR. 110 ""GEORGE TOPARCEANU"", DIN STR. ARGESELU NR. 6",1731,868,856,12,0,859,9,2000,1132,410,449,1,16973,0
45,"Sectorul 4",179178,"#N/A",179178,,"BUCURESTI SECTORUL 4",782,"SCOALA NR. 129 ""ELENA FARAGO"", DIN STR. IZVORUL CRISULUI NR.6",1552,907,894,13,0,892,15,1700,793,465,427,1,16973,0
45,"Sectorul 4",179178,"#N/A",179178,,"BUCURESTI SECTORUL 4",783,"SCOALA NR. 129 ""ELENA FARAGO"", DIN STR. IZVORUL CRISULUI NR.6",1669,951,940,10,1,941,10,1797,846,486,455,1,16973,0
45,"Sectorul 4",179178,"#N/A",179178,,"BUCURESTI SECTORUL 4",784,"SCOALA NR. 129 ""ELENA FARAGO"", DIN STR. IZVORUL CRISULUI NR.6",1868,973,965,8,0,955,18,2100,1127,468,487,1,16973,0
45,"Sectorul 4",179178,"#N/A",179178,,"BUCURESTI SECTORUL 4",785,"SCOALA NR. 129 ""ELENA FARAGO"", DIN STR. IZVORUL CRISULUI NR.6",1811,1056,1044,11,1,1038,18,2000,944,497,541,1,16973,0
45,"Sectorul 4",179178,"#N/A",179178,,"BUCURESTI SECTORUL 4",786,"GRUPUL SCOLAR ECONOMIC ADMINISTRATIV  ""MIRCEA VULCANESCU"", DIN STR. IZVORUL CRISULUI NR. 4",1546,777,761,16,0,771,6,1700,923,398,373,1,16973,0
45,"Sectorul 4",179178,"#N/A",179178,,"BUCURESTI SECTORUL 4",787,"GRUPUL SCOLAR ECONOMIC ADMINISTRATIV  ""MIRCEA VULCANESCU"", DIN STR. IZVORUL CRISULUI NR. 4",1463,820,803,17,0,810,10,1600,780,398,412,1,16973,0
45,"Sectorul 4",179178,"#N/A",179178,,"BUCURESTI SECTORUL 4",788,"SCOALA NR. 119 ""VASILE VOICULESCU"", DIN STR. ALMASU MIC. NR.4",2207,1262,1249,11,2,1245,17,2421,1159,579,666,1,16973,0
45,"Sectorul 4",179178,"#N/A",179178,,"BUCURESTI SECTORUL 4",789,"SCOALA NR. 119 ""VASILE VOICULESCU"", DIN STR. ALMASU MIC. NR.4",1936,1003,982,21,0,978,25,2100,1097,495,483,1,16973,0
45,"Sectorul 4",179178,"#N/A",179178,,"BUCURESTI SECTORUL 4",790,"SCOALA NR. 119 ""VASILE VOICULESCU"", DIN STR. ALMASU MIC. NR.4",1678,889,875,14,0,878,11,1800,911,416,462,1,16973,0
45,"Sectorul 4",179178,"#N/A",179178,,"BUCURESTI SECTORUL 4",791,"SCOALA NR. 119 ""VASILE VOICULESCU"", DIN STR. ALMASU MIC. NR.4",1745,783,767,16,0,779,4,1905,1122,417,362,1,16973,0
45,"Sectorul 4",179178,"#N/A",179178,,"BUCURESTI SECTORUL 4",792,"SCOALA NR. 36 ""IONEL TEODOREANU"", DIN STR. COSTILA NR. 2",1389,775,759,16,0,764,11,1500,725,347,417,1,16973,0
45,"Sectorul 4",179178,"#N/A",179178,,"BUCURESTI SECTORUL 4",793,"SCOALA NR. 36 ""IONEL TEODOREANU"", DIN STR. COSTILA NR. 2",1487,783,771,12,0,772,11,1706,923,332,440,1,16973,0
45,"Sectorul 4",179178,"#N/A",179178,,"BUCURESTI SECTORUL 4",794,"SCOALA NR. 36 ""IONEL TEODOREANU"", DIN STR. COSTILA NR. 2",1645,796,773,23,0,786,10,1800,1004,432,354,1,16973,0
45,"Sectorul 4",179178,"#N/A",179178,,"BUCURESTI SECTORUL 4",795,"SCOALA NR. 36 ""IONEL TEODOREANU"", DIN STR. COSTILA NR. 2",1876,741,728,13,0,734,7,2100,1359,417,317,1,16973,0
45,"Sectorul 4",179178,"#N/A",179178,,"BUCURESTI SECTORUL 4",796,"SCOALA NR. 36 ""IONEL TEODOREANU"", DIN STR. COSTILA NR. 2",1775,749,734,15,0,743,6,2000,1251,394,349,1,16973,0
45,"Sectorul 4",179178,"#N/A",179178,,"BUCURESTI SECTORUL 4",797,"SCOALA NR. 36 ""IONEL TEODOREANU"", DIN STR. COSTILA NR. 2",1623,844,834,10,0,830,14,1800,956,391,439,1,16973,0
45,"Sectorul 4",179178,"#N/A",179178,,"BUCURESTI SECTORUL 4",798,"SCOALA NR. 99, DIN STR. HUEDIN NR. 13",1644,800,795,5,0,789,11,1800,1000,366,423,1,16973,0
45,"Sectorul 4",179178,"#N/A",179178,,"BUCURESTI SECTORUL 4",799,"SCOALA NR. 99, DIN STR. HUEDIN NR. 13",1957,993,978,15,0,978,15,2201,1208,461,517,1,16973,0
45,"Sectorul 4",179178,"#N/A",179178,,"BUCURESTI SECTORUL 4",800,"SCOALA NR. 99, DIN STR. HUEDIN NR. 13",1668,844,833,11,0,832,12,1800,956,402,430,1,16973,0
45,"Sectorul 4",179178,"#N/A",179178,,"BUCURESTI SECTORUL 4",801,"SCOALA NR. 99, DIN STR. HUEDIN NR. 13",1911,847,830,17,0,838,9,2100,1253,413,425,1,16973,0
45,"Sectorul 4",179178,"#N/A",179178,,"BUCURESTI SECTORUL 4",802,"GRADINITA NR. 167, DIN STR. IZVORUL OLTULUI NR.3",1988,1020,990,30,0,1010,10,2200,1180,492,518,1,16973,0
45,"Sectorul 4",179178,"#N/A",179178,,"BUCURESTI SECTORUL 4",803,"GRADINITA NR. 167, DIN STR. IZVORUL OLTULUI NR.3",2083,1074,1059,15,0,1062,12,2300,1226,540,522,1,16973,0
45,"Sectorul 4",179178,"#N/A",179178,,"BUCURESTI SECTORUL 4",804,"GRADINITA NR. 167, DIN STR. IZVORUL OLTULUI NR.3",1971,978,965,13,0,967,11,2200,1222,516,451,1,16973,0
45,"Sectorul 4",179178,"#N/A",179178,,"BUCURESTI SECTORUL 4",805,"GRADINITA NR. 167, DIN STR. IZVORUL OLTULUI NR.3",1809,832,815,17,0,825,7,2000,1168,387,438,1,16973,0
45,"Sectorul 4",179178,"#N/A",179178,,"BUCURESTI SECTORUL 4",806,"SCOALA NR. 165, DIN ALEEA SLATIOARA NR.8",2052,943,929,14,0,933,10,2300,1357,479,454,1,16973,0
45,"Sectorul 4",179178,"#N/A",179178,,"BUCURESTI SECTORUL 4",807,"SCOALA NR. 165, DIN ALEEA SLATIOARA NR.8",2086,1026,1015,11,0,1013,13,2300,1274,485,528,1,16973,0
45,"Sectorul 4",179178,"#N/A",179178,,"BUCURESTI SECTORUL 4",808,"SCOALA NR. 165, DIN ALEEA SLATIOARA NR.8",2088,855,841,13,1,846,9,2300,1445,408,438,1,16973,0
45,"Sectorul 4",179178,"#N/A",179178,,"BUCURESTI SECTORUL 4",809,"SCOALA NR. 165, DIN ALEEA SLATIOARA NR.8",2072,922,909,13,0,908,14,2300,1378,447,461,1,16973,0
45,"Sectorul 4",179178,"#N/A",179178,,"BUCURESTI SECTORUL 4",810,"GRADINITA NR. 243, DIN STR. ALMASU MARE NR.1",1431,766,753,13,0,754,12,1600,834,372,382,1,16973,0
45,"Sectorul 4",179178,"#N/A",179178,,"BUCURESTI SECTORUL 4",811,"GRADINITA NR. 243, DIN STR. ALMASU MARE NR.1",1324,638,623,15,0,625,13,1500,862,336,289,1,16973,0
45,"Sectorul 4",179178,"#N/A",179178,,"BUCURESTI SECTORUL 4",812,"GRADINITA NR. 28, DIN SOS. GIURGIULUI NR. 247",1739,718,699,19,0,716,2,1900,1182,355,361,1,16973,0
45,"Sectorul 4",179178,"#N/A",179178,,"BUCURESTI SECTORUL 4",813,"GRADINITA NR. 28, DIN SOS. GIURGIULUI NR. 247",1777,838,827,11,0,836,2,2000,1162,441,395,1,16973,0
45,"Sectorul 4",179178,"#N/A",179178,,"BUCURESTI SECTORUL 4",814,"CAMIN STUDENTESC C3 - CAMPUSUL UNIVERSITATII ""SPIRU HARET"", DIN ALEEA MOLDOVITA NR.10",0,1068,0,1068,0,1060,8,1845,777,625,435,1,16973,1
45,"Sectorul 4",179178,"#N/A",179178,,"BUCURESTI SECTORUL 4",815,"SPITALUL CLINIC DE URGENTA ""BAGDASAR-ARSENI"", DIN SOS. BERCENI NR. 12, SECTOR 4",0,1113,0,1113,0,1107,6,1845,732,626,481,1,16973,1
45,"Sectorul 4",179178,"#N/A",179178,,"BUCURESTI SECTORUL 4",816,"AUTOGARA ""FILARET"", DIN PIATA GARII FILARET, NR. 1, SECTOR 4",0,992,0,992,0,985,7,1100,108,523,462,1,16973,1
46,"Sectorul 5",179187,"#N/A",179187,,"BUCURESTI SECTORUL 5",817,"SCOALA CU CLASELE I-VIII NR.134, DIN STR. BACIULUI NR.4",1600,634,618,16,0,630,4,1600,966,330,300,1,16974,0
46,"Sectorul 5",179187,"#N/A",179187,,"BUCURESTI SECTORUL 5",818,"SCOALA CU CLASELE I-VIII NR.134, DIN STR. BACIULUI NR.4",1778,824,814,10,0,815,9,1800,976,446,369,1,16974,0
46,"Sectorul 5",179187,"#N/A",179187,,"BUCURESTI SECTORUL 5",819,"SCOALA CU CLASELE I-VIII NR.134, DIN STR. BACIULUI NR.4",1439,648,634,14,0,640,8,1600,952,301,339,1,16974,0
46,"Sectorul 5",179187,"#N/A",179187,,"BUCURESTI SECTORUL 5",820,"SCOALA CU CLASELE I-VIII NR.134, DIN STR. BACIULUI NR.4",1165,448,435,13,0,443,5,1200,752,253,190,1,16974,0
46,"Sectorul 5",179187,"#N/A",179187,,"BUCURESTI SECTORUL 5",821,"SCOALA CU CLASELE I-VIII NR.134, DIN STR. BACIULUI NR.4",1824,870,854,16,0,862,8,2000,1130,483,379,1,16974,0
46,"Sectorul 5",179187,"#N/A",179187,,"BUCURESTI SECTORUL 5",822,"SCOALA CU CLASELE I-VIII NR.134, DIN STR. BACIULUI NR.4",1738,797,790,7,0,790,7,1800,1003,409,381,1,16974,0
46,"Sectorul 5",179187,"#N/A",179187,,"BUCURESTI SECTORUL 5",823,"SCOALA CU CLASELE I-VIII NR.134, DIN STR. BACIULUI NR.4",1733,733,720,13,0,725,8,1800,1067,346,379,1,16974,0
46,"Sectorul 5",179187,"#N/A",179187,,"BUCURESTI SECTORUL 5",824,"SCOALA CU CLASELE I-VIII NR.134, DIN STR. BACIULUI NR.4",1968,825,800,24,1,811,14,2200,1375,428,383,1,16974,0
46,"Sectorul 5",179187,"#N/A",179187,,"BUCURESTI SECTORUL 5",825,"SCOALA CU CLASELE I-VIII NR.134, DIN STR. BACIULUI NR.4",1151,467,458,9,0,461,6,1200,733,233,228,1,16974,0
46,"Sectorul 5",179187,"#N/A",179187,,"BUCURESTI SECTORUL 5",826,"SCOALA CU CLASELE I-VIII NR.134, DIN STR. BACIULUI NR.4",1910,730,719,11,0,723,7,2000,1270,392,331,1,16974,0
46,"Sectorul 5",179187,"#N/A",179187,,"BUCURESTI SECTORUL 5",827,"SCOALA CU CLASELE I-VIII NR.134, DIN STR. BACIULUI NR.4",1015,403,387,16,0,394,9,1200,797,178,216,1,16974,0
46,"Sectorul 5",179187,"#N/A",179187,,"BUCURESTI SECTORUL 5",828,"SCOALA CU CLASELE I-VIII NR.103, DIN STR. VIGONIEI NR.3-5",1316,644,639,5,0,636,8,1400,756,272,364,1,16974,0
46,"Sectorul 5",179187,"#N/A",179187,,"BUCURESTI SECTORUL 5",829,"SCOALA CU CLASELE I-VIII NR.103, DIN STR. VIGONIEI NR.3-5",1533,824,792,29,3,813,11,1600,776,345,468,1,16974,0
46,"Sectorul 5",179187,"#N/A",179187,,"BUCURESTI SECTORUL 5",830,"SCOALA CU CLASELE I-VIII NR.103, DIN STR. VIGONIEI NR.3-5",1131,600,582,15,3,588,12,1200,600,278,310,1,16974,0
46,"Sectorul 5",179187,"#N/A",179187,,"BUCURESTI SECTORUL 5",831,"SCOALA CU CLASELE I-VIII NR.103, DIN STR. VIGONIEI NR.3-5",1136,611,596,15,0,602,9,1200,589,278,324,1,16974,0
46,"Sectorul 5",179187,"#N/A",179187,,"BUCURESTI SECTORUL 5",832,"GRADINITA NR.245, DIN STR. TUNSU PETRE NR.9",1970,729,708,21,0,725,4,2000,1271,397,328,1,16974,0
46,"Sectorul 5",179187,"#N/A",179187,,"BUCURESTI SECTORUL 5",833,"GRADINITA NR.245, DIN STR. TUNSU PETRE NR.9",1301,534,521,13,0,528,6,1400,866,234,294,1,16974,0
46,"Sectorul 5",179187,"#N/A",179187,,"BUCURESTI SECTORUL 5",834,"GRADINITA NR.245, DIN STR. TUNSU PETRE NR.9",1697,580,557,23,0,572,8,1801,1221,247,325,1,16974,0
46,"Sectorul 5",179187,"#N/A",179187,,"BUCURESTI SECTORUL 5",835,"GRADINITA NR.245, DIN STR. TUNSU PETRE NR.9",1436,566,553,13,0,558,8,1600,1034,291,267,1,16974,0
46,"Sectorul 5",179187,"#N/A",179187,,"BUCURESTI SECTORUL 5",836,"GRADINITA NR.245, DIN STR. TUNSU PETRE NR.9",1639,768,755,13,0,753,15,1800,1032,408,345,1,16974,0
46,"Sectorul 5",179187,"#N/A",179187,,"BUCURESTI SECTORUL 5",837,"GRADINITA NR.245, DIN STR. TUNSU PETRE NR.9",1631,594,584,10,0,588,6,1800,1206,268,320,1,16974,0
46,"Sectorul 5",179187,"#N/A",179187,,"BUCURESTI SECTORUL 5",838,"GRADINITA NR.245, DIN STR. TUNSU PETRE NR.9",1475,635,614,21,0,625,10,1600,965,270,355,1,16974,0
46,"Sectorul 5",179187,"#N/A",179187,,"BUCURESTI SECTORUL 5",839,"GRADINITA NR.34, DIN STR. LACUL BUCURA NR.26",1302,568,557,11,0,565,3,1400,832,284,281,1,16974,0
46,"Sectorul 5",179187,"#N/A",179187,,"BUCURESTI SECTORUL 5",840,"GRADINITA NR.34, DIN STR. LACUL BUCURA NR.26",1600,637,616,21,0,627,10,1600,963,295,332,1,16974,0
46,"Sectorul 5",179187,"#N/A",179187,,"BUCURESTI SECTORUL 5",841,"GRADINITA NR.34, DIN STR. LACUL BUCURA NR.26",1225,572,560,12,0,569,3,1400,828,304,265,1,16974,0
46,"Sectorul 5",179187,"#N/A",179187,,"BUCURESTI SECTORUL 5",842,"GRADINITA NR.34, DIN STR. LACUL BUCURA NR.26",983,472,454,18,0,468,4,1000,528,252,216,1,16974,0
46,"Sectorul 5",179187,"#N/A",179187,,"BUCURESTI SECTORUL 5",843,"GRADINITA NR.34, DIN STR. LACUL BUCURA NR.26",1467,592,579,13,0,587,5,1600,1008,283,304,1,16974,0
46,"Sectorul 5",179187,"#N/A",179187,,"BUCURESTI SECTORUL 5",844,"SCOALA CU CLASELE I-VIII NR.188, DIN STR. TUFISULUI NR.13",1062,527,512,14,1,524,3,1200,673,252,272,1,16974,0
46,"Sectorul 5",179187,"#N/A",179187,,"BUCURESTI SECTORUL 5",845,"SCOALA CU CLASELE I-VIII NR.188, DIN STR. TUFISULUI NR.13",1218,593,575,18,0,588,5,1400,807,271,317,1,16974,0
46,"Sectorul 5",179187,"#N/A",179187,,"BUCURESTI SECTORUL 5",846,"SCOALA CU CLASELE I-VIII NR.188, DIN STR. TUFISULUI NR.13",986,544,529,15,0,531,13,1000,456,238,293,1,16974,0
46,"Sectorul 5",179187,"#N/A",179187,,"BUCURESTI SECTORUL 5",847,"SCOALA CU CLASELE I-VIII NR.188, DIN STR. TUFISULUI NR.13",1062,530,518,11,1,528,2,1200,670,241,287,1,16974,0
46,"Sectorul 5",179187,"#N/A",179187,,"BUCURESTI SECTORUL 5",848,"SCOALA CU CLASELE I-VIII NR.188, DIN STR. TUFISULUI NR.13",823,408,396,12,0,403,5,1000,592,193,210,1,16974,0
46,"Sectorul 5",179187,"#N/A",179187,,"BUCURESTI SECTORUL 5",849,"SCOALA CU CLASELE NR. I-VIII NR. 130, DIN STR.DOINA NR.1",1312,664,659,5,0,652,12,1400,736,339,313,1,16974,0
46,"Sectorul 5",179187,"#N/A",179187,,"BUCURESTI SECTORUL 5",850,"SCOALA CU CLASELE NR. I-VIII NR. 130, DIN STR.DOINA NR.1",1184,598,584,14,0,584,14,1209,611,297,287,1,16974,0
46,"Sectorul 5",179187,"#N/A",179187,,"BUCURESTI SECTORUL 5",851,"SCOALA CU CLASELE NR. I-VIII NR. 130, DIN STR.DOINA NR.1",1088,581,574,7,0,573,8,1200,619,267,306,1,16974,0
46,"Sectorul 5",179187,"#N/A",179187,,"BUCURESTI SECTORUL 5",852,"SCOALA CU CLASELE NR. I-VIII NR. 130, DIN STR.DOINA NR.1",1372,708,697,11,0,701,7,1400,692,318,383,1,16974,0
46,"Sectorul 5",179187,"#N/A",179187,,"BUCURESTI SECTORUL 5",853,"SCOALA CU CLASELE I-VIII NR.135 ""STEFAN CEL MARE"", DIN CAL. FERENTARI NR.72",1046,577,563,14,0,571,6,1200,623,250,321,1,16974,0
46,"Sectorul 5",179187,"#N/A",179187,,"BUCURESTI SECTORUL 5",854,"SCOALA CU CLASELE I-VIII NR.135 ""STEFAN CEL MARE"", DIN CAL. FERENTARI NR.72",1381,710,702,8,0,699,11,1600,890,314,385,1,16974,0
46,"Sectorul 5",179187,"#N/A",179187,,"BUCURESTI SECTORUL 5",855,"SCOALA CU CLASELE I-VIII NR.135 ""STEFAN CEL MARE"", DIN CAL. FERENTARI NR.72",1411,691,675,16,0,680,11,1600,909,337,343,1,16974,0
46,"Sectorul 5",179187,"#N/A",179187,,"BUCURESTI SECTORUL 5",856,"SCOALA CU CLASELE I-VIII NR.135 ""STEFAN CEL MARE"", DIN CAL. FERENTARI NR.72",1586,849,828,20,1,834,15,1600,751,427,407,1,16974,0
46,"Sectorul 5",179187,"#N/A",179187,,"BUCURESTI SECTORUL 5",857,"SCOALA CU CLASELE I-VIII NR.141 ""IOAN C.BRATIANU"", DIN STR. AMURGULUI NR.35",1222,670,657,13,0,657,13,1400,730,351,306,1,16974,0
46,"Sectorul 5",179187,"#N/A",179187,,"BUCURESTI SECTORUL 5",858,"SCOALA CU CLASELE I-VIII NR.141 ""IOAN C.BRATIANU"", DIN STR. AMURGULUI NR.35",1127,603,594,9,0,592,11,1200,597,267,325,1,16974,0
46,"Sectorul 5",179187,"#N/A",179187,,"BUCURESTI SECTORUL 5",859,"SCOALA CU CLASELE I-VIII NR.141 ""IOAN C.BRATIANU"", DIN STR. AMURGULUI NR.35",1566,781,766,15,0,773,8,1600,819,344,429,1,16974,0
46,"Sectorul 5",179187,"#N/A",179187,,"BUCURESTI SECTORUL 5",860,"SCOALA CU CLASELE I-VIII NR.141 ""IOAN C.BRATIANU"", DIN STR. AMURGULUI NR.35",1156,571,560,11,0,564,7,1196,625,274,290,1,16974,0
46,"Sectorul 5",179187,"#N/A",179187,,"BUCURESTI SECTORUL 5",861,"SCOALA CU CLASELE I-VIII NR.141 ""IOAN C.BRATIANU"", DIN STR. AMURGULUI NR.35",1252,643,633,10,0,629,14,1400,757,328,301,1,16974,0
46,"Sectorul 5",179187,"#N/A",179187,,"BUCURESTI SECTORUL 5",862,"SCOALA CU CLASELE I-VIII NR.141 ""IOAN C.BRATIANU"", DIN STR. AMURGULUI NR.35",1518,752,739,13,0,746,6,1600,848,351,395,1,16974,0
46,"Sectorul 5",179187,"#N/A",179187,,"BUCURESTI SECTORUL 5",863,"SCOALA CU CLASELE I-VIII NR.141 ""IOAN C.BRATIANU"", DIN STR. AMURGULUI NR.35",1342,583,568,14,1,568,15,1600,1017,249,319,1,16974,0
46,"Sectorul 5",179187,"#N/A",179187,,"BUCURESTI SECTORUL 5",864,"SCOALA CU CLASELE I-VIII NR.141 ""IOAN C.BRATIANU"", DIN STR. AMURGULUI NR.35",1926,831,806,20,5,821,10,2000,1169,403,418,1,16974,0
46,"Sectorul 5",179187,"#N/A",179187,,"BUCURESTI SECTORUL 5",865,"SCOALA CU CLASELE I-VIII NR.141 ""IOAN C.BRATIANU"", DIN STR. AMURGULUI NR.35",1557,714,691,23,0,701,13,1600,886,293,408,1,16974,0
46,"Sectorul 5",179187,"#N/A",179187,,"BUCURESTI SECTORUL 5",866,"SCOALA CU CLASELE I-VIII NR.141 ""IOAN C.BRATIANU"", DIN STR. AMURGULUI NR.35",1348,647,636,11,0,640,7,1400,753,309,331,1,16974,0
46,"Sectorul 5",179187,"#N/A",179187,,"BUCURESTI SECTORUL 5",867,"SCOALA CU CLASELE I-VIII NR.141 ""IOAN C.BRATIANU"", DIN STR. AMURGULUI NR.35",1134,621,612,8,1,616,5,1400,779,336,280,1,16974,0
46,"Sectorul 5",179187,"#N/A",179187,,"BUCURESTI SECTORUL 5",868,"GRADINITA NR.54, DIN CAL.FERENTARI NR.96",1374,653,644,9,0,642,11,1400,747,343,299,1,16974,0
46,"Sectorul 5",179187,"#N/A",179187,,"BUCURESTI SECTORUL 5",869,"GRADINITA NR.54, DIN CAL.FERENTARI NR.96",1281,601,586,15,0,590,11,1400,799,288,302,1,16974,0
46,"Sectorul 5",179187,"#N/A",179187,,"BUCURESTI SECTORUL 5",870,"GRADINITA NR.54, DIN CAL.FERENTARI NR.96",1382,634,625,9,0,625,9,1400,766,329,296,1,16974,0
46,"Sectorul 5",179187,"#N/A",179187,,"BUCURESTI SECTORUL 5",871,"GRADINITA NR.54, DIN CAL.FERENTARI NR.96",1509,696,684,12,0,692,4,1600,904,342,350,1,16974,0
46,"Sectorul 5",179187,"#N/A",179187,,"BUCURESTI SECTORUL 5",872,"GRADINITA NR.54, DIN CAL.FERENTARI NR.96",1634,769,756,13,0,763,6,1800,1031,341,422,1,16974,0
46,"Sectorul 5",179187,"#N/A",179187,,"BUCURESTI SECTORUL 5",873,"GRADINITA NR.244, DIN STR. HUMULESTI NR.31",1560,728,714,14,0,716,12,1600,872,331,385,1,16974,0
46,"Sectorul 5",179187,"#N/A",179187,,"BUCURESTI SECTORUL 5",874,"GRADINITA NR.244, DIN STR.HUMULESTI NR.31",1625,809,797,12,0,798,11,1800,991,314,484,1,16974,0
46,"Sectorul 5",179187,"#N/A",179187,,"BUCURESTI SECTORUL 5",875,"SCOALA CU CLASELE I-VIII NR.147 ""P.POENARU"", DIN STR. BACAU NR.1",1208,507,493,14,0,496,11,1400,893,237,259,1,16974,0
46,"Sectorul 5",179187,"#N/A",179187,,"BUCURESTI SECTORUL 5",876,"SCOALA CU CLASELE I-VIII NR.147 ""P.POENARU"", DIN STR. BACAU NR.1",1189,590,574,16,0,583,7,1200,610,260,323,1,16974,0
46,"Sectorul 5",179187,"#N/A",179187,,"BUCURESTI SECTORUL 5",877,"SCOALA CU CLASELE I-VIII NR.147 ""P.POENARU"", DIN STR. BACAU NR.1",1226,606,589,17,0,600,6,1400,794,295,305,1,16974,0
46,"Sectorul 5",179187,"#N/A",179187,,"BUCURESTI SECTORUL 5",878,"SCOALA CU CLASELE I-VIII NR.147 ""P.POENARU"", DIN STR. BACAU NR.1",1332,582,567,14,1,576,6,1400,818,278,298,1,16974,0
46,"Sectorul 5",179187,"#N/A",179187,,"BUCURESTI SECTORUL 5",879,"SCOALA CU CLASELE I-VIII NR.147 ""P.POENARU"", DIN STR. BACAU NR.1",1490,649,635,14,0,635,14,1600,951,328,307,1,16974,0
46,"Sectorul 5",179187,"#N/A",179187,,"BUCURESTI SECTORUL 5",880,"SCOALA CU CLASELE I-VIII NR.147 ""P.POENARU"", DIN STR. BACAU NR.1",1435,668,651,17,0,663,5,1600,932,323,340,1,16974,0
46,"Sectorul 5",179187,"#N/A",179187,,"BUCURESTI SECTORUL 5",881,"SCOALA CU CLASELE I-VIII NR.147 ""P.POENARU"", DIN STR. BACAU NR.1",1201,613,598,15,0,605,8,1400,787,328,277,1,16974,0
46,"Sectorul 5",179187,"#N/A",179187,,"BUCURESTI SECTORUL 5",882,"SCOALA CU CLASELE I-VIII NR.114 ""PRINCIPESA MARGARETA"", DIN STR. PANDELE ROSCA NR.2-4",1052,607,587,20,0,594,13,1200,593,331,263,1,16974,0
46,"Sectorul 5",179187,"#N/A",179187,,"BUCURESTI SECTORUL 5",883,"SCOALA CU CLASELE I-VIII NR.114 ""PRINCIPESA MARGARETA"", DIN STR. PANDELE ROSCA NR.2-4",1261,519,510,9,0,512,7,1400,881,251,261,1,16974,0
46,"Sectorul 5",179187,"#N/A",179187,,"BUCURESTI SECTORUL 5",884,"SCOALA CU CLASELE I-VIII NR.114 ""PRINCIPESA MARGARETA"", DIN STR. PANDELE ROSCA NR.2-4",1960,743,725,18,0,735,8,2000,1257,338,397,1,16974,0
46,"Sectorul 5",179187,"#N/A",179187,,"BUCURESTI SECTORUL 5",885,"SCOALA CU CLASELE I-VIII NR.114 ""PRINCIPESA MARGARETA"", DIN STR. PANDELE ROSCA NR.2-4",1026,524,513,9,2,520,4,1200,676,250,270,1,16974,0
46,"Sectorul 5",179187,"#N/A",179187,,"BUCURESTI SECTORUL 5",886,"GRADINITA NR.168, DIN SOS.VIILOR NR.99",1031,533,522,11,0,526,7,1200,667,254,272,1,16974,0
46,"Sectorul 5",179187,"#N/A",179187,,"BUCURESTI SECTORUL 5",887,"GRADINITA NR.168, DIN SOS.VIILOR NR.99",940,531,513,18,0,522,9,1004,473,245,277,1,16974,0
46,"Sectorul 5",179187,"#N/A",179187,,"BUCURESTI SECTORUL 5",888,"CLUBUL COPIILOR SECTOR 5, DIN STR. NASAUD NR.93",1461,775,760,15,0,766,9,1600,825,388,378,1,16974,0
46,"Sectorul 5",179187,"#N/A",179187,,"BUCURESTI SECTORUL 5",889,"CLUBUL COPIILOR SECTOR 5, DIN STR. NASAUD NR.93",1482,762,753,9,0,747,15,1600,838,344,403,1,16974,0
46,"Sectorul 5",179187,"#N/A",179187,,"BUCURESTI SECTORUL 5",890,"SCOALA CU CLASELE I-VIII NR.280 ""M.SEBASTIAN"", DIN STR. GH. DONICI NR. 4A",1497,802,787,15,0,795,7,1600,798,360,435,1,16974,0
46,"Sectorul 5",179187,"#N/A",179187,,"BUCURESTI SECTORUL 5",891,"SCOALA CU CLASELE I-VIII NR.280 ""M.SEBASTIAN"", DIN STR. GH. DONICI NR. 4A",1229,638,618,20,0,627,11,1400,762,290,337,1,16974,0
46,"Sectorul 5",179187,"#N/A",179187,,"BUCURESTI SECTORUL 5",892,"SCOALA CU CLASELE I-VIII NR.280 ""M.SEBASTIAN"", DIN STR. GH. DONICI NR. 4A",1179,631,616,15,0,623,8,1200,569,297,326,1,16974,0
46,"Sectorul 5",179187,"#N/A",179187,,"BUCURESTI SECTORUL 5",893,"SCOALA CU CLASELE I-VIII NR.280 ""M.SEBASTIAN"", DIN STR. GH. DONICI NR. 4A",1177,655,641,14,0,651,4,1200,545,321,330,1,16974,0
46,"Sectorul 5",179187,"#N/A",179187,,"BUCURESTI SECTORUL 5",894,"SCOALA CU CLASELE I-VIII NR.280 ""M.SEBASTIAN"", DIN STR. GH. DONICI NR. 4A",897,469,461,8,0,464,5,1000,531,207,257,1,16974,0
46,"Sectorul 5",179187,"#N/A",179187,,"BUCURESTI SECTORUL 5",895,"SCOALA CU CLASELE I-VIII NR.280 ""M.SEBASTIAN"", DIN STR. GH. DONICI NR. 4A",1390,767,740,27,0,755,12,1600,833,374,381,1,16974,0
46,"Sectorul 5",179187,"#N/A",179187,,"BUCURESTI SECTORUL 5",896,"SCOALA CU CLASELE I-VIII NR.280 ""M.SEBASTIAN"", DIN STR. GH. DONICI NR. 4A",1325,738,708,29,1,732,6,1400,662,362,370,1,16974,0
46,"Sectorul 5",179187,"#N/A",179187,,"BUCURESTI SECTORUL 5",897,"SCOALA CU CLASELE I-VIII NR.280 ""M.SEBASTIAN"", DIN STR. GH. DONICI NR. 4A",1227,648,632,16,0,639,9,1400,752,328,311,1,16974,0
46,"Sectorul 5",179187,"#N/A",179187,,"BUCURESTI SECTORUL 5",898,"SCOALA CU CLASELE I-VIII NR.132, DIN STR. GRIGORE TOCILESCU NR.20",1329,762,746,16,0,753,9,1600,838,358,395,1,16974,0
46,"Sectorul 5",179187,"#N/A",179187,,"BUCURESTI SECTORUL 5",899,"SCOALA CU CLASELE I-VIII NR.132, DIN STR. GRIGORE TOCILESCU NR.20",1397,746,728,18,0,738,8,1400,654,348,390,1,16974,0
46,"Sectorul 5",179187,"#N/A",179187,,"BUCURESTI SECTORUL 5",900,"SCOALA CU CLASELE I-VIII NR.132, DIN STR. GRIGORE TOCILESCU NR.20",1329,715,705,10,0,705,10,1400,685,330,375,1,16974,0
46,"Sectorul 5",179187,"#N/A",179187,,"BUCURESTI SECTORUL 5",901,"GRADINITA NR.205, DIN CAL.FERENTARI NR.2",1505,808,799,9,0,795,13,1600,792,378,417,1,16974,0
46,"Sectorul 5",179187,"#N/A",179187,,"BUCURESTI SECTORUL 5",902,"GRADINITA NR.205, DIN CAL.FERENTARI NR.2",1269,690,673,17,0,681,9,1600,910,313,368,1,16974,0
46,"Sectorul 5",179187,"#N/A",179187,,"BUCURESTI SECTORUL 5",903,"GRADINITA NR.205, DIN CAL.FERENTARI NR.2",1465,754,739,15,0,744,10,1600,846,388,356,1,16974,0
46,"Sectorul 5",179187,"#N/A",179187,,"BUCURESTI SECTORUL 5",904,"GRADINITA NR.205, DIN CAL.FERENTARI NR.2",1174,634,625,9,0,626,8,1200,566,291,335,1,16974,0
46,"Sectorul 5",179187,"#N/A",179187,,"BUCURESTI SECTORUL 5",905,"GRADINITA NR.205, DIN CAL.FERENTARI NR.2",1247,677,666,11,0,667,10,1400,723,329,338,1,16974,0
46,"Sectorul 5",179187,"#N/A",179187,,"BUCURESTI SECTORUL 5",906,"LICEUL TEORETIC ""DIMITRIE BOLINTINEANU"", DIN CAL. RAHOVEI NR.311",1188,633,623,10,0,629,4,1200,567,288,341,1,16974,0
46,"Sectorul 5",179187,"#N/A",179187,,"BUCURESTI SECTORUL 5",907,"LICEUL TEORETIC ""DIMITRIE BOLINTINEANU"", DIN CAL. RAHOVEI NR.311",1034,560,533,27,0,553,7,1200,640,260,293,1,16974,0
46,"Sectorul 5",179187,"#N/A",179187,,"BUCURESTI SECTORUL 5",908,"LICEUL TEORETIC ""DIMITRIE BOLINTINEANU"", DIN CAL. RAHOVEI NR.311",1242,633,618,14,1,624,9,1400,767,301,323,1,16974,0
46,"Sectorul 5",179187,"#N/A",179187,,"BUCURESTI SECTORUL 5",909,"LICEUL TEORETIC ""DIMITRIE BOLINTINEANU"", DIN CAL. RAHOVEI NR.311",1427,728,717,11,0,723,5,1600,872,346,377,1,16974,0
46,"Sectorul 5",179187,"#N/A",179187,,"BUCURESTI SECTORUL 5",910,"LICEUL TEORETIC ""DIMITRIE BOLINTINEANU"", DIN CAL. RAHOVEI NR.311",1387,765,746,18,1,751,14,1600,835,349,402,1,16974,0
46,"Sectorul 5",179187,"#N/A",179187,,"BUCURESTI SECTORUL 5",911,"LICEUL TEORETIC ""DIMITRIE BOLINTINEANU"", DIN CAL. RAHOVEI NR.311",1472,624,608,16,0,618,6,1601,977,278,340,1,16974,0
46,"Sectorul 5",179187,"#N/A",179187,,"BUCURESTI SECTORUL 5",912,"LICEUL TEORETIC ""DIMITRIE BOLINTINEANU"", DIN CAL. RAHOVEI NR.311",1346,694,686,7,1,686,8,1600,906,300,386,1,16974,0
46,"Sectorul 5",179187,"#N/A",179187,,"BUCURESTI SECTORUL 5",913,"LICEUL TEORETIC ""DIMITRIE BOLINTINEANU"", DIN CAL. RAHOVEI NR.311",1381,653,628,25,0,646,7,1600,947,302,344,1,16974,0
46,"Sectorul 5",179187,"#N/A",179187,,"BUCURESTI SECTORUL 5",914,"LICEUL TEORETIC ""DIMITRIE BOLINTINEANU"", DIN CAL. RAHOVEI NR.311",1013,556,548,8,0,547,9,1201,645,239,308,1,16974,0
46,"Sectorul 5",179187,"#N/A",179187,,"BUCURESTI SECTORUL 5",915,"SCOALA CU CLS. I-VIII NR.130, DIN STR. DOINA NR.1",1282,654,646,8,0,644,10,1400,746,341,303,1,16974,0
46,"Sectorul 5",179187,"#N/A",179187,,"BUCURESTI SECTORUL 5",916,"SCOALA CU CLS. I-VIII NR.130, DIN STR. DOINA NR.1",1289,591,577,14,0,582,9,1400,809,312,270,1,16974,0
46,"Sectorul 5",179187,"#N/A",179187,,"BUCURESTI SECTORUL 5",917,"SCOALA CU CLS. I-VIII NR.130, DIN STR. DOINA NR.1",1191,650,632,18,0,637,13,1200,550,303,334,1,16974,0
46,"Sectorul 5",179187,"#N/A",179187,,"BUCURESTI SECTORUL 5",918,"FACULTATEA DE DREPT, DIN BD. M. KOGALNICEANU NR.36-46",740,426,413,13,0,414,12,800,374,190,224,1,16974,0
46,"Sectorul 5",179187,"#N/A",179187,,"BUCURESTI SECTORUL 5",919,"FACULTATEA DE DREPT, DIN BD. M. KOGALNICEANU NR.36-46",710,368,355,12,1,364,4,819,451,171,193,1,16974,0
46,"Sectorul 5",179187,"#N/A",179187,,"BUCURESTI SECTORUL 5",920,"FACULTATEA DE DREPT, DIN BD. M. KOGALNICEANU NR.36-46",742,369,359,10,0,365,4,801,432,162,203,1,16974,0
46,"Sectorul 5",179187,"#N/A",179187,,"BUCURESTI SECTORUL 5",921,"COLEGIUL NATIONAL ""GHEORGHE LAZAR"", DIN BD. REGINA ELISABETA NR.48",911,602,584,18,0,592,10,1000,398,265,327,1,16974,0
46,"Sectorul 5",179187,"#N/A",179187,,"BUCURESTI SECTORUL 5",922,"COLEGIUL NATIONAL ""GHEORGHE LAZAR"", DIN BD. REGINA ELISABETA NR.48",1025,510,499,11,0,499,11,1193,683,223,276,1,16974,0
46,"Sectorul 5",179187,"#N/A",179187,,"BUCURESTI SECTORUL 5",923,"COLEGIUL NATIONAL ""GHEORGHE LAZAR"", DIN BD. REGINA ELISABETA NR.48",877,509,476,33,0,505,4,1027,518,235,270,1,16974,0
46,"Sectorul 5",179187,"#N/A",179187,,"BUCURESTI SECTORUL 5",924,"COLEGIUL NATIONAL ""GHEORGHE LAZAR"", DIN BD. REGINA ELISABETA NR.48",928,502,489,12,1,494,8,1000,498,245,249,1,16974,0
46,"Sectorul 5",179187,"#N/A",179187,,"BUCURESTI SECTORUL 5",925,"COLEGIUL NATIONAL ""GHEORGHE LAZAR"", DIN BD. REGINA ELISABETA NR.48",883,467,452,15,0,462,5,1000,533,207,255,1,16974,0
46,"Sectorul 5",179187,"#N/A",179187,,"BUCURESTI SECTORUL 5",926,"GRADINITA NR.178 ""FLORI DE TEI"", DIN STR. IANCU JIANU NR.26",1797,945,926,19,0,937,8,1800,855,435,502,1,16974,0
46,"Sectorul 5",179187,"#N/A",179187,,"BUCURESTI SECTORUL 5",927,"GRADINITA NR.178 ""FLORI DE TEI"", DIN STR. IANCU JIANU NR.26",1171,571,561,10,0,562,9,1200,629,269,293,1,16974,0
46,"Sectorul 5",179187,"#N/A",179187,,"BUCURESTI SECTORUL 5",928,"GRADINITA NR.178 ""FLORI DE TEI"", DIN S STR. IANCU JIANU NR.26",1999,1012,1003,9,0,999,13,2000,988,465,534,1,16974,0
46,"Sectorul 5",179187,"#N/A",179187,,"BUCURESTI SECTORUL 5",929,"LICEUL TEORETIC ""ION BARBU"", DIN STR. NABUCULUI NR.18",1265,603,592,11,0,597,6,1400,797,268,329,1,16974,0
46,"Sectorul 5",179187,"#N/A",179187,,"BUCURESTI SECTORUL 5",930,"LICEUL TEORETIC ""ION BARBU"", DIN STR. NABUCULUI NR.18",1410,755,743,12,0,744,11,1600,845,378,366,1,16974,0
46,"Sectorul 5",179187,"#N/A",179187,,"BUCURESTI SECTORUL 5",931,"LICEUL TEORETIC ""ION BARBU"", DIN STR. NABUCULUI NR.18",1047,596,584,12,0,586,10,1199,603,281,305,1,16974,0
46,"Sectorul 5",179187,"#N/A",179187,,"BUCURESTI SECTORUL 5",932,"LICEUL TEORETIC ""ION BARBU"", DIN STR. NABUCULUI NR.18",1187,699,688,11,0,693,6,1200,501,286,407,1,16974,0
46,"Sectorul 5",179187,"#N/A",179187,,"BUCURESTI SECTORUL 5",933,"LICEUL TEORETIC ""ION BARBU"", DIN STR. NABUCULUI NR.18",1294,749,732,17,0,732,17,1600,851,322,410,1,16974,0
46,"Sectorul 5",179187,"#N/A",179187,,"BUCURESTI SECTORUL 5",934,"LICEUL TEORETIC ""ION BARBU"", DIN STR. NABUCULUI NR.18",1789,964,957,7,0,945,19,1800,836,443,502,1,16974,0
46,"Sectorul 5",179187,"#N/A",179187,,"BUCURESTI SECTORUL 5",935,"LICEUL TEORETIC ""ION BARBU"", DIN STR. NABUCULUI NR.18",1030,652,637,15,0,644,8,1200,548,280,364,1,16974,0
46,"Sectorul 5",179187,"#N/A",179187,,"BUCURESTI SECTORUL 5",936,"LICEUL TEORETIC ""ION BARBU"", DIN STR. NABUCULUI NR.18",1082,613,604,9,0,604,9,1174,561,314,290,1,16974,0
46,"Sectorul 5",179187,"#N/A",179187,,"BUCURESTI SECTORUL 5",937,"LICEUL TEORETIC ""ION BARBU"", DIN STR. NABUCULUI NR.18",1288,579,563,15,1,567,12,1199,620,267,300,1,16974,0
46,"Sectorul 5",179187,"#N/A",179187,,"BUCURESTI SECTORUL 5",938,"LICEUL TEORETIC ""STEFAN ODOBLEJA"", DIN STR.DORNEASCA NR.7A",1427,855,843,12,0,841,14,1600,745,386,455,1,16974,0
46,"Sectorul 5",179187,"#N/A",179187,,"BUCURESTI SECTORUL 5",939,"LICEUL TEORETIC ""STEFAN ODOBLEJA"", DIN STR.DORNEASCA NR.7A",1313,709,698,10,1,692,17,1600,891,326,366,1,16974,0
46,"Sectorul 5",179187,"#N/A",179187,,"BUCURESTI SECTORUL 5",940,"LICEUL TEORETIC ""STEFAN ODOBLEJA"", DIN STR.DORNEASCA NR.7A",1382,742,729,12,1,730,12,1600,858,349,381,1,16974,0
46,"Sectorul 5",179187,"#N/A",179187,,"BUCURESTI SECTORUL 5",941,"LICEUL TEORETIC ""STEFAN ODOBLEJA"", DIN STR.DORNEASCA NR.7A",1253,732,721,11,0,717,15,1600,868,352,365,1,16974,0
46,"Sectorul 5",179187,"#N/A",179187,,"BUCURESTI SECTORUL 5",942,"LICEUL TEORETIC ""STEFAN ODOBLEJA"", DIN STR.DORNEASCA NR.7A",1179,636,626,10,0,631,5,1200,564,294,337,1,16974,0
46,"Sectorul 5",179187,"#N/A",179187,,"BUCURESTI SECTORUL 5",943,"LICEUL TEORETIC ""STEFAN ODOBLEJA"", DIN STR.DORNEASCA NR.7A",1311,668,657,9,2,645,23,1600,932,301,344,1,16974,0
46,"Sectorul 5",179187,"#N/A",179187,,"BUCURESTI SECTORUL 5",944,"SCOALA CU CLASELE I-VIII NR.146 ""I.GH.DUCA"", DIN SOS. PANDURI NR.42",1112,689,680,9,0,684,5,1200,511,323,361,1,16974,0
46,"Sectorul 5",179187,"#N/A",179187,,"BUCURESTI SECTORUL 5",945,"SCOALA CU CLASELE I-VIII NR.146 ""I.GH.DUCA"", DIN SOS. PANDURI NR.42",949,581,559,22,0,573,8,1031,450,190,383,1,16974,0
46,"Sectorul 5",179187,"#N/A",179187,,"BUCURESTI SECTORUL 5",946,"SCOALA CU CLASELE I-VIII NR.146 ""I.GH.DUCA"", DIN SOS. PANDURI NR.42",1103,664,652,12,0,655,9,1200,536,235,420,1,16974,0
46,"Sectorul 5",179187,"#N/A",179187,,"BUCURESTI SECTORUL 5",947,"SCOALA CU CLASELE I-VIII NR.146 ""I.GH.DUCA"", DIN SOS. PANDURI NR.42",922,589,581,8,0,580,9,982,393,246,334,1,16974,0
46,"Sectorul 5",179187,"#N/A",179187,,"BUCURESTI SECTORUL 5",948,"SCOALA CU CLASELE I-VIII NR.146 ""I.GH.DUCA"", DIN SOS. PANDURI NR.42",942,630,619,10,1,621,9,1000,370,254,367,1,16974,0
46,"Sectorul 5",179187,"#N/A",179187,,"BUCURESTI SECTORUL 5",949,"SCOALA CU CLASELE I-VIII NR.150 ""SF.ELEFTERIE"", DIN BD. EROII SANITARI NR.29-31",838,480,469,9,2,472,8,983,503,218,254,1,16974,0
46,"Sectorul 5",179187,"#N/A",179187,,"BUCURESTI SECTORUL 5",950,"SCOALA CU CLASELE I-VIII NR.150 ""SF.ELEFTERIE"", DIN BD. EROII SANITARI NR.29-31",819,459,446,12,1,454,5,1000,541,173,281,1,16974,0
46,"Sectorul 5",179187,"#N/A",179187,,"BUCURESTI SECTORUL 5",951,"SCOALA CU CLASELE I-VIII NR.150 ""SF.ELEFTERIE"", DIN BD. EROII SANITARI NR.29-31",882,497,491,6,0,482,15,1000,503,244,238,1,16974,0
46,"Sectorul 5",179187,"#N/A",179187,,"BUCURESTI SECTORUL 5",952,"SCOALA CU CLASELE I-VIII NR.150 ""SF.ELEFTERIE"", DIN BD. EROII SANITARI NR.29-31",809,501,491,10,0,492,9,1000,499,222,270,1,16974,0
46,"Sectorul 5",179187,"#N/A",179187,,"BUCURESTI SECTORUL 5",953,"SCOALA CU CLASELE I-VIII NR.150 ""SF.ELEFTERIE"", DIN BD. EROII SANITARI NR.29-31",822,496,486,10,0,490,6,1000,504,227,263,1,16974,0
46,"Sectorul 5",179187,"#N/A",179187,,"BUCURESTI SECTORUL 5",954,"SCOALA CU CLASELE I-VIII NR.150 ""SF.ELEFTERIE"", DIN BD. EROII SANITARI NR.29-31",889,528,515,12,1,519,9,1000,472,264,255,1,16974,0
46,"Sectorul 5",179187,"#N/A",179187,,"BUCURESTI SECTORUL 5",955,"SCOALA CU CLASELE I-VIII NR.128 ""SF.NICOLAE"", DIN STR. ION CREANGA NR.6",866,441,426,15,0,435,6,1022,581,226,209,1,16974,0
46,"Sectorul 5",179187,"#N/A",179187,,"BUCURESTI SECTORUL 5",956,"SCOALA CU CLASELE I-VIII NR.128 ""SF.NICOLAE"", DIN STR. ION CREANGA NR.6",916,361,350,11,0,351,10,1000,639,167,184,1,16974,0
46,"Sectorul 5",179187,"#N/A",179187,,"BUCURESTI SECTORUL 5",957,"SCOALA CU CLASELE I-VIII NR.128 ""SF.NICOLAE"", DIN STR. ION CREANGA NR.6",819,427,415,12,0,421,6,1000,573,170,251,1,16974,0
46,"Sectorul 5",179187,"#N/A",179187,,"BUCURESTI SECTORUL 5",958,"SCOALA CU CLASELE I-VIII NR.128 ""SF.NICOLAE"", DIN STR. ION CREANGA NR.6",819,544,532,12,0,538,6,1010,466,180,358,1,16974,0
46,"Sectorul 5",179187,"#N/A",179187,,"BUCURESTI SECTORUL 5",959,"GRADINITA NR.268, DIN STR. ION CREANGA NR.6",810,544,533,11,0,534,10,1000,456,176,358,1,16974,0
46,"Sectorul 5",179187,"#N/A",179187,,"BUCURESTI SECTORUL 5",960,"GRADINITA NR.268, DIN STR. ION CREANGA NR.6",1321,893,881,12,0,886,7,1600,707,244,642,1,16974,0
46,"Sectorul 5",179187,"#N/A",179187,,"BUCURESTI SECTORUL 5",961,"GRADINITA NR.268, DIN STR. ION CREANGA NR.6",934,611,602,9,0,604,7,1000,389,233,371,1,16974,0
46,"Sectorul 5",179187,"#N/A",179187,,"BUCURESTI SECTORUL 5",962,"SCOALA CU CLASELE I-VIII NR.127, DIN STR. MUNTII CARPATI NR.72",1515,631,619,12,0,623,8,1600,969,305,318,1,16974,0
46,"Sectorul 5",179187,"#N/A",179187,,"BUCURESTI SECTORUL 5",963,"SCOALA CU CLASELE I-VIII NR.127, DIN STR. MUNTII CARPATI NR.72",1395,681,667,13,1,676,5,1600,919,341,335,1,16974,0
46,"Sectorul 5",179187,"#N/A",179187,,"BUCURESTI SECTORUL 5",964,"SCOALA CU CLASELE I-VIII NR.127, DIN STR. MUNTII CARPATI NR.72",1752,879,865,14,0,865,14,1800,921,421,444,1,16974,0
46,"Sectorul 5",179187,"#N/A",179187,,"BUCURESTI SECTORUL 5",965,"SCOALA CU CLASELE I-VIII NR.127, DIN STR. MUNTII CARPATI NR.72",1513,778,760,18,0,768,10,1600,822,365,403,1,16974,0
46,"Sectorul 5",179187,"#N/A",179187,,"BUCURESTI SECTORUL 5",966,"SCOALA CU CLASELE I-VIII NR.127, DIN STR. MUNTII CARPATI NR.72",1610,786,769,17,0,771,15,1800,1014,391,380,1,16974,0
46,"Sectorul 5",179187,"#N/A",179187,,"BUCURESTI SECTORUL 5",967,"SCOALA CU CLASELE I-VIII NR.125, DIN SOS. BUCURESTI-MAGURELE NR.45",1421,768,747,21,0,764,4,1600,832,344,420,1,16974,0
46,"Sectorul 5",179187,"#N/A",179187,,"BUCURESTI SECTORUL 5",968,"SCOALA CU CLASELE I-VIII NR.125, DIN SOS. BUCURESTI-MAGURELE NR.45",1496,708,699,9,0,704,4,1600,892,302,402,1,16974,0
46,"Sectorul 5",179187,"#N/A",179187,,"BUCURESTI SECTORUL 5",969,"SCOALA CU CLASELE I-VIII NR.125, DIN SOS. BUCURESTI-MAGURELE NR.45",1386,659,647,12,0,649,10,1397,738,315,334,1,16974,0
46,"Sectorul 5",179187,"#N/A",179187,,"BUCURESTI SECTORUL 5",970,"SCOALA CU CLASELE I-VIII NR.131, DIN STR. GUTUILOR NR.1",1404,649,634,15,0,645,4,1600,951,320,325,1,16974,0
46,"Sectorul 5",179187,"#N/A",179187,,"BUCURESTI SECTORUL 5",971,"SCOALA CU CLASELE I-VIII NR.131, DIN STR. GUTUILOR NR.1",1508,686,670,16,0,676,10,1600,914,306,370,1,16974,0
46,"Sectorul 5",179187,"#N/A",179187,,"BUCURESTI SECTORUL 5",972,"SCOALA CU CLASELE I-VIII NR.131, DIN STR. GUTUILOR NR.1",1301,589,576,13,0,579,10,1400,811,271,308,1,16974,0
46,"Sectorul 5",179187,"#N/A",179187,,"BUCURESTI SECTORUL 5",973,"SCOALA CU CLASELE I-VIII NR.131, DIN STR. GUTUILOR NR.1",1466,1718,755,11,952,1681,37,2800,1082,886,795,1,16974,0
46,"Sectorul 5",179187,"#N/A",179187,,"BUCURESTI SECTORUL 5",974,"SCOALA CU CLASELE I-VIII NR.131, DIN STR. GUTUILOR NR.1",1350,685,674,11,0,678,7,1416,731,301,377,1,16974,0
46,"Sectorul 5",179187,"#N/A",179187,,"BUCURESTI SECTORUL 5",975,"SCOALA CU CLASELE I-VIII NR.131, DIN STR. GUTUILOR NR.1",1601,705,687,18,0,698,7,1800,1095,323,375,1,16974,0
46,"Sectorul 5",179187,"#N/A",179187,,"BUCURESTI SECTORUL 5",976,"SCOALA CU CLASELE I-VIII NR.126, DIN STR. LERESTI NR.12",1392,810,801,8,1,803,7,1379,569,454,349,1,16974,0
46,"Sectorul 5",179187,"#N/A",179187,,"BUCURESTI SECTORUL 5",977,"SCOALA CU CLASELE I-VIII NR.126, DIN STR. LERESTI NR.12",1399,758,746,12,0,748,10,1600,842,340,408,1,16974,0
46,"Sectorul 5",179187,"#N/A",179187,,"BUCURESTI SECTORUL 5",978,"SCOALA CU CLASELE I-VIII NR.126, DIN STR. LERESTI NR.12",1360,775,763,12,0,765,10,1600,825,378,387,1,16974,0
46,"Sectorul 5",179187,"#N/A",179187,,"BUCURESTI SECTORUL 5",979,"SCOALA CU CLASELE I-VIII NR.126, DIN STR. LERESTI NR.12",1704,766,756,10,0,756,10,1800,1034,381,375,1,16974,0
46,"Sectorul 5",179187,"#N/A",179187,,"BUCURESTI SECTORUL 5",980,"SCOALA CU CLASELE I-VIII NR.139 ""M. SANTIMBREANU"", DIN SOS. ALEXANDRIA NR.21",1102,671,661,10,0,660,11,1287,616,309,351,1,16974,0
46,"Sectorul 5",179187,"#N/A",179187,,"BUCURESTI SECTORUL 5",981,"SCOALA CU CLASELE I-VIII NR.139 ""M. SANTIMBREANU"", DIN SOS. ALEXANDRIA NR.21",1107,569,561,8,0,561,8,1295,726,264,297,1,16974,0
46,"Sectorul 5",179187,"#N/A",179187,,"BUCURESTI SECTORUL 5",982,"SCOALA CU CLASELE I-VIII NR.139 ""M. SANTIMBREANU"", DIN SOS. ALEXANDRIA NR.21",1008,634,623,11,0,630,4,1300,666,322,308,1,16974,0
46,"Sectorul 5",179187,"#N/A",179187,,"BUCURESTI SECTORUL 5",983,"SCOALA CU CLASELE I-VIII NR.139 ""M. SANTIMBREANU"", DIN SOS. ALEXANDRIA NR.21",1115,615,606,8,1,607,8,1297,682,265,342,1,16974,0
46,"Sectorul 5",179187,"#N/A",179187,,"BUCURESTI SECTORUL 5",984,"SCOALA CU CLASELE I-VIII NR.139 ""M. SANTIMBREANU"", DIN SOS. ALEXANDRIA NR.21",1105,610,593,17,0,604,6,1300,690,314,290,1,16974,0
46,"Sectorul 5",179187,"#N/A",179187,,"BUCURESTI SECTORUL 5",985,"SCOALA CU CLASELE I-VIII NR.124 ""VOIEVODUL MIHAI"", DIN STR. MARGEANULUI NR.25",1290,673,660,13,0,663,10,1400,727,348,315,1,16974,0
46,"Sectorul 5",179187,"#N/A",179187,,"BUCURESTI SECTORUL 5",986,"SCOALA CU CLASELE I-VIII NR.124 ""VOIEVODUL MIHAI"", DIN STR. MARGEANULUI NR.25",1234,691,681,10,0,686,5,1400,709,301,385,1,16974,0
46,"Sectorul 5",179187,"#N/A",179187,,"BUCURESTI SECTORUL 5",987,"SCOALA CU CLASELE I-VIII NR.124 ""VOIEVODUL MIHAI"", DIN STR. MARGEANULUI NR.25",1405,737,729,8,0,729,8,1600,863,380,349,1,16974,0
46,"Sectorul 5",179187,"#N/A",179187,,"BUCURESTI SECTORUL 5",988,"SCOALA CU CLASELE I-VIII NR.124 ""VOIEVODUL MIHAI"", DIN STR. MARGEANULUI NR.25",1277,678,669,9,0,671,7,1399,721,290,381,1,16974,0
46,"Sectorul 5",179187,"#N/A",179187,,"BUCURESTI SECTORUL 5",989,"SCOALA CU CLASELE I-VIII NR.124 ""VOIEVODUL MIHAI"", DIN STR. MARGEANULUI NR.25",1291,692,680,12,0,689,3,1395,703,353,336,1,16974,0
46,"Sectorul 5",179187,"#N/A",179187,,"BUCURESTI SECTORUL 5",990,"SCOALA CU CLASELE I-VIII NR.124 ""VOIEVODUL MIHAI"", DIN STR. MARGEANULUI NR.25",1110,591,583,8,0,585,6,1196,605,257,328,1,16974,0
46,"Sectorul 5",179187,"#N/A",179187,,"BUCURESTI SECTORUL 5",991,"SCOALA CU CLASELE I-VIII NR.124 ""VOIEVODUL MIHAI"", DIN STR. MARGEANULUI NR.25",1153,606,593,13,0,597,9,1200,594,250,347,1,16974,0
46,"Sectorul 5",179187,"#N/A",179187,,"BUCURESTI SECTORUL 5",992,"SCOALA CU CLASELE I-VIII NR.124 ""VOIEVODUL MIHAI"", DIN STR. MARGEANULUI NR.25",1252,697,680,17,0,685,12,1387,690,291,394,1,16974,0
46,"Sectorul 5",179187,"#N/A",179187,,"BUCURESTI SECTORUL 5",993,"SCOALA CU CLASELE I-VIII NR.124 ""VOIEVODUL MIHAI"", DIN STR. MARGEANULUI NR.25",1052,621,610,10,1,615,6,1197,576,274,341,1,16974,0
46,"Sectorul 5",179187,"#N/A",179187,,"BUCURESTI SECTORUL 5",994,"SCOALA CU CLASELE I-VIII NR.124 ""VOIEVODUL MIHAI"", DIN STR. MARGEANULUI NR.25",1294,658,647,11,0,649,9,1399,741,291,358,1,16974,0
46,"Sectorul 5",179187,"#N/A",179187,,"BUCURESTI SECTORUL 5",995,"GRADINITA NR.55, DIN STR.MARGEANULUI 81",975,459,445,14,0,455,4,996,537,240,215,1,16974,0
46,"Sectorul 5",179187,"#N/A",179187,,"BUCURESTI SECTORUL 5",996,"GRADINITA NR.55, DIN STR.MARGEANULUI 81",1066,508,493,15,0,505,3,1200,692,260,245,1,16974,0
46,"Sectorul 5",179187,"#N/A",179187,,"BUCURESTI SECTORUL 5",997,"SCOALA CU CLASELE I-VIII NR.144, DIN PREL. GHENCEA NR.87",1921,970,947,23,0,939,31,2000,1030,461,478,1,16974,0
46,"Sectorul 5",179187,"#N/A",179187,,"BUCURESTI SECTORUL 5",998,"SCOALA CU CLASELE I-VIII NR.144, DIN PREL. GHENCEA NR.87",1561,881,862,19,0,867,14,1600,719,473,394,1,16974,0
46,"Sectorul 5",179187,"#N/A",179187,,"BUCURESTI SECTORUL 5",999,"SCOALA CU CLASELE I-VIII NR.143, DIN STR. BANU MARACINE NR.16",1237,686,679,7,0,679,7,1400,714,266,413,1,16974,0
46,"Sectorul 5",179187,"#N/A",179187,,"BUCURESTI SECTORUL 5",1000,"SCOALA CU CLASELE I-VIII NR.143, DIN STR. BANU MARACINE NR.16",1393,666,654,12,0,661,5,1400,734,311,350,1,16974,0
46,"Sectorul 5",179187,"#N/A",179187,,"BUCURESTI SECTORUL 5",1001,"SCOALA CU CLASELE I-VIII NR.143, DIN STR. BANU MARACINE NR.16",1213,617,605,12,0,609,8,1400,783,279,330,1,16974,0
46,"Sectorul 5",179187,"#N/A",179187,,"BUCURESTI SECTORUL 5",1002,"SCOALA CU CLASELE I-VIII NR.143, DIN STR. BANU MARACINE NR.16",1286,646,634,12,0,641,5,1400,754,306,335,1,16974,0
46,"Sectorul 5",179187,"#N/A",179187,,"BUCURESTI SECTORUL 5",1003,"SCOALA CU CLASELE I-VIII NR.143, DIN STR. BANU MARACINE NR.16",1101,603,596,7,0,602,1,1200,597,271,331,1,16974,0
46,"Sectorul 5",179187,"#N/A",179187,,"BUCURESTI SECTORUL 5",1004,"SCOALA CU CLASELE I-VIII NR.143, DIN STR. BANU MARACINE NR.16",1424,781,765,16,0,769,12,1600,819,320,449,1,16974,0
46,"Sectorul 5",179187,"#N/A",179187,,"BUCURESTI SECTORUL 5",1005,"SCOALA CU CLASELE I-VIII NR.143, DIN STR. BANU MARACINE NR.16",1254,710,699,11,0,705,5,1400,690,310,395,1,16974,0
46,"Sectorul 5",179187,"#N/A",179187,,"BUCURESTI SECTORUL 5",1006,"SCOALA CU CLASELE I-VIII NR.143, DIN STR. BANU MARACINE NR.16",1203,617,602,15,0,605,12,1400,783,284,321,1,16974,0
46,"Sectorul 5",179187,"#N/A",179187,,"BUCURESTI SECTORUL 5",1007,"SCOALA CU CLASELE I-VIII NR.143, DIN STR. BANU MARACINE NR.16",1304,688,669,19,0,680,8,1400,712,303,377,1,16974,0
46,"Sectorul 5",179187,"#N/A",179187,,"BUCURESTI SECTORUL 5",1008,"SCOALA CU CLASELE I-VIII NR.143, DIN STR. BANU MARACINE NR.16",1237,629,624,5,0,621,8,1400,771,311,310,1,16974,0
46,"Sectorul 5",179187,"#N/A",179187,,"BUCURESTI SECTORUL 5",1009,"SCOALA CU CLASELE I-VIII NR.143, DIN STR. BANU MARACINE NR.16",1270,663,653,10,0,656,7,1400,737,311,345,1,16974,0
46,"Sectorul 5",179187,"#N/A",179187,,"BUCURESTI SECTORUL 5",1010,"SCOALA CU CLASELE I-VIII NR.143, DIN STR. BANU MARACINE NR.16",1156,587,574,13,0,574,13,1200,613,258,316,1,16974,0
46,"Sectorul 5",179187,"#N/A",179187,,"BUCURESTI SECTORUL 5",1011,"SCOALA CU CLASELE I-VIII NR.143, DIN STR. BANU MARACINE NR.16",1231,562,547,15,0,557,5,1400,838,263,294,1,16974,0
46,"Sectorul 5",179187,"#N/A",179187,,"BUCURESTI SECTORUL 5",1012,"SCOALA CU CLASELE I-VIII NR.143, DIN STR. BANU MARACINE NR.16",1153,618,611,7,0,612,6,1200,582,279,333,1,16974,0
46,"Sectorul 5",179187,"#N/A",179187,,"BUCURESTI SECTORUL 5",1013,"FACULTATEA DE DREPT, DIN BD. MIHAIL KOGALNICEANU NR.36-46",0,950,0,950,0,936,14,2704,1754,627,309,1,16974,1
47,"Sectorul 6",179196,"#N/A",179196,,"BUCURESTI SECTORUL 6",1014,"SERVICIUL STARE CIVILA, DIN DRUMUL SARII NR. 85",1094,638,627,11,0,636,2,1300,662,276,360,1,16975,0
47,"Sectorul 6",179196,"#N/A",179196,,"BUCURESTI SECTORUL 6",1015,"SERVICIUL STARE CIVILA, DIN DRUMUL SARII NR. 85",1283,788,775,13,0,776,12,1400,612,424,352,1,16975,0
47,"Sectorul 6",179196,"#N/A",179196,,"BUCURESTI SECTORUL 6",1016,"SCOALA CU CLASELE I-VIII N. 59 ""DIMITRIE STURZA"", DIN STR. VLADEASA NR. 9",1652,973,957,15,1,961,12,1800,827,442,519,1,16975,0
47,"Sectorul 6",179196,"#N/A",179196,,"BUCURESTI SECTORUL 6",1017,"SCOALA CU CLASELE I-VIII N. 59 ""DIMITRIE STURZA"", DIN STR. VLADEASA NR. 9",1533,803,788,15,0,785,18,1700,897,348,437,1,16975,0
47,"Sectorul 6",179196,"#N/A",179196,,"BUCURESTI SECTORUL 6",1018,"SCOALA CU CLASELE I-VIII N. 59 ""DIMITRIE STURZA"", DIN STR. VLADEASA NR. 9",1658,936,922,14,0,921,15,1800,864,446,475,1,16975,0
47,"Sectorul 6",179196,"#N/A",179196,,"BUCURESTI SECTORUL 6",1019,"SCOALA CU CLASELE I-VIII N. 59 ""DIMITRIE STURZA"", DIN  STR. VLADEASA NR. 9",1717,965,955,10,0,949,16,1900,935,420,529,1,16975,0
47,"Sectorul 6",179196,"#N/A",179196,,"BUCURESTI SECTORUL 6",1020,"SCOALA CU CLASELE I-VIII N. 59 ""DIMITRIE STURZA"", DIN STR. VLADEASA NR. 9",1354,734,718,15,1,725,9,1500,766,389,336,1,16975,0
47,"Sectorul 6",179196,"#N/A",179196,,"BUCURESTI SECTORUL 6",1021,"SCOALA CU CLASELE I-VIII N. 59 ""DIMITRIE STURZA"", DIN STR. VLADEASA NR. 9",1270,760,749,10,1,757,3,1400,640,312,445,1,16975,0
47,"Sectorul 6",179196,"#N/A",179196,,"BUCURESTI SECTORUL 6",1022,"SCOALA CU CLASELE I-VIII N. 59 ""DIMITRIE STURZA"", DIN STR. VLADEASA NR. 9",1056,672,659,12,1,663,9,1197,525,305,358,1,16975,0
47,"Sectorul 6",179196,"#N/A",179196,,"BUCURESTI SECTORUL 6",1023,"SCOALA CU CLASELE I-VIII N. 59 ""DIMITRIE STURZA"", DIN STR. VLADEASA NR. 9",1379,856,843,13,0,840,16,1500,644,403,437,1,16975,0
47,"Sectorul 6",179196,"#N/A",179196,,"BUCURESTI SECTORUL 6",1024,"SCOALA CU CLASELE I-VIII N. 59 ""DIMITRIE STURZA"", DIN STR. VLADEASA NR. 9",1331,702,693,9,0,690,12,1500,798,318,372,1,16975,0
47,"Sectorul 6",179196,"#N/A",179196,,"BUCURESTI SECTORUL 6",1025,"SCOALA CU CLASELE I-VIII N. 59 ""DIMITRIE STURZA"", DIN  STR. VLADEASA NR. 9",1619,881,866,15,0,869,12,1800,919,471,398,1,16975,0
47,"Sectorul 6",179196,"#N/A",179196,,"BUCURESTI SECTORUL 6",1026,"SCOALA CU CLASELE I-VIII N. 59 ""DIMITRIE STURZA"", DIN STR. VLADEASA NR. 9",1310,787,774,13,0,776,11,1500,713,401,375,1,16975,0
47,"Sectorul 6",179196,"#N/A",179196,,"BUCURESTI SECTORUL 6",1027,"SCOALA CU CLASELE I-VIII N. 59 ""DIMITRIE STURZA"", DIN STR. VLADEASA NR. 9",1460,831,818,11,2,817,14,1600,769,384,433,1,16975,0
47,"Sectorul 6",179196,"#N/A",179196,,"BUCURESTI SECTORUL 6",1028,"SCOALA CU CLASELE I-VIII NR. 205, DIN ALEEA VALEA PRAHOVEI NR 1",1365,801,784,16,1,791,10,1500,699,354,437,1,16975,0
47,"Sectorul 6",179196,"#N/A",179196,,"BUCURESTI SECTORUL 6",1029,"SCOALA CU CLASELE I-VIII NR. 205, DIN ALEEA VALEA PRAHOVEI NR 1",1525,873,858,15,0,859,14,1700,827,445,414,1,16975,0
47,"Sectorul 6",179196,"#N/A",179196,,"BUCURESTI SECTORUL 6",1030,"SCOALA CU CLASELE I-VIII NR. 205, DIN ALEEA VALEA PRAHOVEI NR 1",929,452,437,15,0,441,11,1100,648,205,236,1,16975,0
47,"Sectorul 6",179196,"#N/A",179196,,"BUCURESTI SECTORUL 6",1031,"SCOALA CU CLASELE I-VIII NR. 205, DIN ALEEA VALEA PRAHOVEI NR 1",1545,897,886,11,0,879,18,1700,803,400,479,1,16975,0
47,"Sectorul 6",179196,"#N/A",179196,,"BUCURESTI SECTORUL 6",1032,"SCOALA CU CLASELE I-VIII NR. 205, DIN ALEEA VALEA PRAHOVEI NR 1",1497,903,890,13,0,892,11,1700,797,406,486,1,16975,0
47,"Sectorul 6",179196,"#N/A",179196,,"BUCURESTI SECTORUL 6",1033,"SCOALA CU CLASELE I-VIII NR. 205, DIN ALEEA VALEA PRAHOVEI NR 1",1359,714,698,16,0,701,13,1500,786,360,341,1,16975,0
47,"Sectorul 6",179196,"#N/A",179196,,"BUCURESTI SECTORUL 6",1034,"SCOALA CU CLASELE I-VIII NR. 197, DIN STR. OBCINA MARE NR. 2",1686,997,983,14,0,980,17,1900,903,483,497,1,16975,0
47,"Sectorul 6",179196,"#N/A",179196,,"BUCURESTI SECTORUL 6",1035,"SCOALA CU CLASELE I-VIII NR. 197, DIN STR. OBCINA MARE NR. 2",1142,698,684,13,1,688,10,1300,602,328,360,1,16975,0
47,"Sectorul 6",179196,"#N/A",179196,,"BUCURESTI SECTORUL 6",1036,"SCOALA CU CLASELE I-VIII NR. 197, DIN STR. OBCINA MARE NR. 2",1139,724,712,11,1,718,6,1309,585,372,346,1,16975,0
47,"Sectorul 6",179196,"#N/A",179196,,"BUCURESTI SECTORUL 6",1037,"SCOALA CU CLASELE I-VIII NR. 197, DIN STR. OBCINA MARE NR. 2",1511,938,919,17,2,928,10,1700,762,411,517,1,16975,0
47,"Sectorul 6",179196,"#N/A",179196,,"BUCURESTI SECTORUL 6",1038,"SCOALA CU CLASELE I-VIII NR. 197, DIN STR. OBCINA MARE NR. 2",780,755,741,14,0,736,19,1398,643,375,361,1,16975,0
47,"Sectorul 6",179196,"#N/A",179196,,"BUCURESTI SECTORUL 6",1039,"SCOALA CU CLASELE I-VIII NR. 197, DIN STR. OBCINA MARE NR. 2",1175,772,763,9,0,764,8,1297,525,309,455,1,16975,0
47,"Sectorul 6",179196,"#N/A",179196,,"BUCURESTI SECTORUL 6",1040,"SCOALA CU CLASELE I-VIII NR. 197, DIN STR. OBCINA MARE NR. 2",1099,626,617,8,1,618,8,1200,574,306,312,1,16975,0
47,"Sectorul 6",179196,"#N/A",179196,,"BUCURESTI SECTORUL 6",1041,"A.D.P. SI D.U. SECTOR 6, DIN INTR. LT. AV. CARANDA GHEORGHE NR. 9",1395,839,826,12,1,828,10,1600,761,322,506,1,16975,0
47,"Sectorul 6",179196,"#N/A",179196,,"BUCURESTI SECTORUL 6",1042,"SCOALA CU CLASELE I-VIII NR. 193, DIN STR. MIHAELA RUXANDRA MARCU NR.3",1183,743,729,14,0,733,10,1300,557,364,369,1,16975,0
47,"Sectorul 6",179196,"#N/A",179196,,"BUCURESTI SECTORUL 6",1043,"SCOALA CU CLASELE I-VIII NR. 193, DIN STR. MIHAELA RUXANDRA MARCU NR.3",1272,783,767,13,3,771,12,1400,617,374,397,1,16975,0
47,"Sectorul 6",179196,"#N/A",179196,,"BUCURESTI SECTORUL 6",1044,"SCOALA CU CLASELE I-VIII NR. 193, DIN STR. MIHAELA RUXANDRA MARCU NR.3",1119,671,658,13,0,663,8,1200,529,289,374,1,16975,0
47,"Sectorul 6",179196,"#N/A",179196,,"BUCURESTI SECTORUL 6",1045,"SCOALA CU CLASELE I-VIII NR. 193, DIN STR. MIHAELA RUXANDRA MARCU NR.3",1361,795,770,25,0,790,5,1500,705,393,397,1,16975,0
47,"Sectorul 6",179196,"#N/A",179196,,"BUCURESTI SECTORUL 6",1046,"LICEUL TEORETIC ""GRIGORE MOISIL"", DIN B-DUL TIMISOARA NR. 33",1332,811,799,12,0,800,11,1500,689,387,413,1,16975,0
47,"Sectorul 6",179196,"#N/A",179196,,"BUCURESTI SECTORUL 6",1047,"LICEUL TEORETIC ""GRIGORE MOISIL"", DIN B-DUL TIMISOARA NR. 33",1498,814,803,11,0,801,13,1700,886,376,425,1,16975,0
47,"Sectorul 6",179196,"#N/A",179196,,"BUCURESTI SECTORUL 6",1048,"LICEUL TEORETIC ""GRIGORE MOISIL"", DIN B-DUL TIMISOARA NR. 33",1371,768,755,12,1,754,14,1500,732,350,404,1,16975,0
47,"Sectorul 6",179196,"#N/A",179196,,"BUCURESTI SECTORUL 6",1049,"LICEUL TEORETIC ""GRIGORE MOISIL"", DIN B-DUL TIMISOARA NR. 33",1280,724,711,11,2,709,15,1400,676,343,366,1,16975,0
47,"Sectorul 6",179196,"#N/A",179196,,"BUCURESTI SECTORUL 6",1050,"SCOALA CU CLASELE I-VIII NR.164, DIN STR. PRAVAT NR. 22",1208,638,624,14,0,627,11,1300,662,259,368,1,16975,0
47,"Sectorul 6",179196,"#N/A",179196,,"BUCURESTI SECTORUL 6",1051,"SCOALA CU CLASELE I-VIII NR.164, DIN STR. PRAVAT NR. 22",1316,757,742,14,1,741,16,1500,743,321,420,1,16975,0
47,"Sectorul 6",179196,"#N/A",179196,,"BUCURESTI SECTORUL 6",1052,"SCOALA CU CLASELE I-VIII NR.164, DIN STR. PRAVAT NR. 22",1118,660,643,17,0,652,8,1195,535,303,349,1,16975,0
47,"Sectorul 6",179196,"#N/A",179196,,"BUCURESTI SECTORUL 6",1053,"GR. SC. IND. ""GHEORGHE ASACHI"", DIN ALEEA PRAVAT NR. 24",1556,883,867,16,0,872,11,1700,817,429,443,1,16975,0
47,"Sectorul 6",179196,"#N/A",179196,,"BUCURESTI SECTORUL 6",1054,"GR. SC. IND. ""GHEORGHE ASACHI"", DIN ALEEA PRAVAT NR. 24",1278,728,723,4,1,720,8,1400,672,354,366,1,16975,0
47,"Sectorul 6",179196,"#N/A",179196,,"BUCURESTI SECTORUL 6",1055,"GR. SC. IND. ""GHEORGHE ASACHI"", DIN ALEEA PRAVAT NR. 24",1239,767,754,12,1,760,7,1400,633,349,411,1,16975,0
47,"Sectorul 6",179196,"#N/A",179196,,"BUCURESTI SECTORUL 6",1056,"GR. SC. IND. ""GHEORGHE ASACHI"", DIN ALEEA PRAVAT NR. 24",1268,777,769,8,0,766,11,1400,623,339,427,1,16975,0
47,"Sectorul 6",179196,"#N/A",179196,,"BUCURESTI SECTORUL 6",1057,"SCOALA CU CLASELE I-VIII NR. 191, DIN ALEEA POIANA MUNTELUI NR. 1",1405,793,774,19,0,788,5,1600,807,382,406,1,16975,0
47,"Sectorul 6",179196,"#N/A",179196,,"BUCURESTI SECTORUL 6",1058,"SCOALA CU CLASELE I-VIII NR. 191, DIN ALEEA POIANA MUNTELUI NR. 1",1245,766,747,19,0,753,13,1400,634,370,383,1,16975,0
47,"Sectorul 6",179196,"#N/A",179196,,"BUCURESTI SECTORUL 6",1059,"SCOALA CU CLASELE I-VIII NR. 191, DIN ALEEA POIANA MUNTELUI NR. 1",1370,852,834,18,0,839,13,1500,648,393,446,1,16975,0
47,"Sectorul 6",179196,"#N/A",179196,,"BUCURESTI SECTORUL 6",1060,"SCOALA CU CLASELE I-VIII NR. 191, DIN ALEEA POIANA MUNTELUI NR. 1",1344,571,560,11,0,559,12,1500,929,291,268,1,16975,0
47,"Sectorul 6",179196,"#N/A",179196,,"BUCURESTI SECTORUL 6",1061,"SCOALA CU CLASELE I-VIII NR. 191, DIN ALEEA POIANA MUNTELUI NR. 1",1146,667,657,10,0,656,11,1299,632,323,333,1,16975,0
47,"Sectorul 6",179196,"#N/A",179196,,"BUCURESTI SECTORUL 6",1062,"SCOALA CU CLASELE I-VIII NR. 191, DIN ALEEA POIANA MUNTELUI NR. 1",1365,702,692,10,0,696,6,1500,798,315,381,1,16975,0
47,"Sectorul 6",179196,"#N/A",179196,,"BUCURESTI SECTORUL 6",1063,"SCOALA CU CLASELE I-VIII NR. 191, DIN ALEEA POIANA MUNTELUI NR. 1",1448,725,714,11,0,714,11,1600,875,337,377,1,16975,0
47,"Sectorul 6",179196,"#N/A",179196,,"BUCURESTI SECTORUL 6",1064,"SCOALA CU CLASELE I-VIII NR. 169, DIN STR. PASCANI NR. 2",1025,846,833,11,2,832,14,1400,554,438,394,1,16975,0
47,"Sectorul 6",179196,"#N/A",179196,,"BUCURESTI SECTORUL 6",1065,"SCOALA CU CLASELE I-VIII NR. 169, DIN STR. PASCANI NR. 2",1258,709,701,8,0,698,11,1400,691,354,344,1,16975,0
47,"Sectorul 6",179196,"#N/A",179196,,"BUCURESTI SECTORUL 6",1066,"SCOALA CU CLASELE I-VIII NR. 169, DIN STR. PASCANI NR. 2",1430,850,833,17,0,840,10,1600,750,438,402,1,16975,0
47,"Sectorul 6",179196,"#N/A",179196,,"BUCURESTI SECTORUL 6",1067,"SCOALA CU CLASELE I-VIII NR. 169, DIN STR. PASCANI NR. 2",1444,835,824,11,0,823,12,1600,765,442,381,1,16975,0
47,"Sectorul 6",179196,"#N/A",179196,,"BUCURESTI SECTORUL 6",1068,"SCOALA CU CLASELE I-VIII NR. 169, DIN STR. PASCANI NR. 2",1349,830,814,15,1,813,17,1500,670,393,420,1,16975,0
47,"Sectorul 6",179196,"#N/A",179196,,"BUCURESTI SECTORUL 6",1069,"SCOALA CU CLASELE I-VIII NR. 155 ""SF. FECIOARA MARIA"", DIN STR. PASCANI NR. 6",1544,949,936,13,0,932,17,1700,751,445,487,1,16975,0
47,"Sectorul 6",179196,"#N/A",179196,,"BUCURESTI SECTORUL 6",1070,"SCOALA CU CLASELE I-VIII NR. 155 ""SF. FECIOARA MARIA"", DIN STR. PASCANI NR. 6",1389,858,846,12,0,840,18,1500,642,436,404,1,16975,0
47,"Sectorul 6",179196,"#N/A",179196,,"BUCURESTI SECTORUL 6",1071,"SCOALA CU CLASELE I-VIII NR. 155 ""SF. FECIOARA MARIA"", DIN STR. PASCANI NR. 6",1322,749,739,9,1,736,13,1500,751,398,338,1,16975,0
47,"Sectorul 6",179196,"#N/A",179196,,"BUCURESTI SECTORUL 6",1072,"SCOALA CU CLASELE I-VIII NR. 155 ""SF. FECIOARA MARIA"", DIN STR. PASCANI NR. 6",1301,754,745,9,0,742,12,1500,746,325,417,1,16975,0
47,"Sectorul 6",179196,"#N/A",179196,,"BUCURESTI SECTORUL 6",1073,"COLEGIUL NATIONAL ""ELENA CUZA"", DIN STR. PESTERA SCARISOARA NR. 1",1345,791,777,12,2,778,13,1500,709,375,403,1,16975,0
47,"Sectorul 6",179196,"#N/A",179196,,"BUCURESTI SECTORUL 6",1074,"COLEGIUL NATIONAL ""ELENA CUZA, DIN STR. PESTERA SCARISOARA NR. 1",1019,723,702,19,2,705,18,1300,577,354,351,1,16975,0
47,"Sectorul 6",179196,"#N/A",179196,,"BUCURESTI SECTORUL 6",1075,"COLEGIUL NATIONAL ""ELENA CUZA, DIN STR. PESTERA SCARISOARA NR. 1",1252,725,716,9,0,718,7,1400,675,379,339,1,16975,0
47,"Sectorul 6",179196,"#N/A",179196,,"BUCURESTI SECTORUL 6",1076,"COLEGIUL NATIONAL ""ELENA CUZA, DIN STR. PESTERA SCARISOARA NR. 1",1046,628,618,10,0,623,5,1200,572,285,338,1,16975,0
47,"Sectorul 6",179196,"#N/A",179196,,"BUCURESTI SECTORUL 6",1077,"LICEUL TEORETIC ""EUGEN LOVINESCU"", DIN STR. VALEA LUI MIHAI NR. 6",1601,994,988,6,0,980,14,1800,806,503,477,1,16975,0
47,"Sectorul 6",179196,"#N/A",179196,,"BUCURESTI SECTORUL 6",1078,"LICEUL TEORETIC ""EUGEN LOVINESCU"", DIN STR. VALEA LUI MIHAI NR. 6",1422,859,846,13,0,845,14,1600,741,409,436,1,16975,0
47,"Sectorul 6",179196,"#N/A",179196,,"BUCURESTI SECTORUL 6",1079,"LICEUL TEORETIC ""EUGEN LOVINESCU"", DIN STR. VALEA LUI MIHAI NR. 6",1630,994,972,22,0,975,19,1800,806,484,491,1,16975,0
47,"Sectorul 6",179196,"#N/A",179196,,"BUCURESTI SECTORUL 6",1080,"LICEUL TEORETIC ""EUGEN LOVINESCU"", DIN STR. VALEA LUI MIHAI NR. 6",1549,895,886,9,0,882,13,1700,805,415,467,1,16975,0
47,"Sectorul 6",179196,"#N/A",179196,,"BUCURESTI SECTORUL 6",1081,"LICEUL TEORETIC ""EUGEN LOVINESCU"", DIN STR. VALEA LUI MIHAI NR. 6",1307,980,970,9,1,960,20,1700,720,490,470,1,16975,0
47,"Sectorul 6",179196,"#N/A",179196,,"BUCURESTI SECTORUL 6",1082,"LICEUL TEORETIC ""EUGEN LOVINESCU"", DIN STR. VALEA LUI MIHAI NR. 6",1318,775,764,11,0,764,11,1500,725,364,400,1,16975,0
47,"Sectorul 6",179196,"#N/A",179196,,"BUCURESTI SECTORUL 6",1083,"LICEUL TEORETIC ""EUGEN LOVINESCU"", DIN STR. VALEA LUI MIHAI NR. 6",1296,689,677,12,0,675,14,1500,811,331,344,1,16975,0
47,"Sectorul 6",179196,"#N/A",179196,,"BUCURESTI SECTORUL 6",1084,"LICEUL TEORETIC ""EUGEN LOVINESCU"", DIN STR. VALEA LUI MIHAI NR. 6",1360,750,745,4,1,735,15,1499,749,332,403,1,16975,0
47,"Sectorul 6",179196,"#N/A",179196,,"BUCURESTI SECTORUL 6",1085,"LICEUL TEORETIC ""EUGEN LOVINESCU"", DIN STR. VALEA LUI MIHAI NR. 6",922,505,498,6,1,497,8,1000,495,227,270,1,16975,0
47,"Sectorul 6",179196,"#N/A",179196,,"BUCURESTI SECTORUL 6",1086,"SCOALA CU CLASELE I-VIII NR. 279 ""SF. ARHANGHELI MIHAIL SI GAVRIL"", DIN PREL. GHENCEA NR. 24",1560,888,877,11,0,876,12,1700,812,432,444,1,16975,0
47,"Sectorul 6",179196,"#N/A",179196,,"BUCURESTI SECTORUL 6",1087,"SCOALA CU CLASELE I-VIII NR. 279 ""SF. ARHANGHELI MIHAIL SI GAVRIL"", DIN PREL. GHENCEA NR. 24",1653,960,947,13,0,945,15,1800,840,478,467,1,16975,0
47,"Sectorul 6",179196,"#N/A",179196,,"BUCURESTI SECTORUL 6",1088,"SCOALA CU CLASELE I-VIII NR. 279 ""SF. ARHANGHELI MIHAIL SI GAVRIL"", DIN PREL. GHENCEA NR. 24",2144,1183,1165,18,0,1164,19,2400,1217,557,607,1,16975,0
47,"Sectorul 6",179196,"#N/A",179196,,"BUCURESTI SECTORUL 6",1089,"SCOALA CU CLASELE I-VIII NR. 279 ""SF. ARHANGHELI MIHAIL SI GAVRIL"", DIN PREL. GHENCEA NR. 24",1494,868,859,9,0,857,11,1700,832,416,441,1,16975,0
47,"Sectorul 6",179196,"#N/A",179196,,"BUCURESTI SECTORUL 6",1090,"SCOALA PENTRU DEFICIENTI DE AUZ NR. 2 ""SF. MARIA"", DIN ALEEA ISTRU NR. 6",2003,1206,1180,26,0,1163,43,2201,995,593,570,1,16975,0
47,"Sectorul 6",179196,"#N/A",179196,,"BUCURESTI SECTORUL 6",1091,"SCOALA PENTRU DEFICIENTI DE AUZ NR. 2 ""SF. MARIA"", DIN ALEEA ISTRU NR. 6",2009,1132,1109,23,0,1106,26,2200,1068,578,528,1,16975,0
47,"Sectorul 6",179196,"#N/A",179196,,"BUCURESTI SECTORUL 6",1092,"SCOALA SPECIALA NR. 11, DIN ALEEA ISTRU NR. 4",1404,777,766,10,1,764,13,1600,823,394,370,1,16975,0
47,"Sectorul 6",179196,"#N/A",179196,,"BUCURESTI SECTORUL 6",1093,"SCOALA SPECIALA NR. 11, DIN ALEEA ISTRU NR. 4",1352,812,798,14,0,798,14,1500,688,408,390,1,16975,0
47,"Sectorul 6",179196,"#N/A",179196,,"BUCURESTI SECTORUL 6",1094,"SCOALA CU CLASELE I-VIII NR. 172 ""SF. ANDREI"", DIN ALEEA PARVA NR. 3-5",1483,805,797,8,0,790,15,1700,895,378,412,1,16975,0
47,"Sectorul 6",179196,"#N/A",179196,,"BUCURESTI SECTORUL 6",1095,"SCOALA CU CLASELE I-VIII NR. 172 ""SF. ANDREI"", DIN ALEEA PARVA NR. 3-5",1717,944,931,13,0,924,20,1900,956,506,418,1,16975,0
47,"Sectorul 6",179196,"#N/A",179196,,"BUCURESTI SECTORUL 6",1096,"SCOALA CU CLASELE I-VIII NR. 172 ""SF. ANDREI"", DIN ALEEA PARVA NR. 3-5",1554,940,928,11,1,930,10,1700,760,455,475,1,16975,0
47,"Sectorul 6",179196,"#N/A",179196,,"BUCURESTI SECTORUL 6",1097,"SCOALA CU CLASELE I-VIII NR. 172 ""SF. ANDREI"", DIN ALEEA PARVA NR. 3-5",1651,927,918,8,1,912,15,1800,873,480,432,1,16975,0
47,"Sectorul 6",179196,"#N/A",179196,,"BUCURESTI SECTORUL 6",1098,"SCOALA CU CLASELE I-VIII NR. 172 ""SF. ANDREI"", DIN ALEEA PARVA NR. 3-5",1164,719,708,11,0,712,7,1300,581,394,318,1,16975,0
47,"Sectorul 6",179196,"#N/A",179196,,"BUCURESTI SECTORUL 6",1099,"SCOALA CU CLASELE I-VIII NR. 172 ""SF. ANDREI"", DIN ALEEA PARVA NR. 3-5",1491,792,781,11,0,780,12,1700,908,392,388,1,16975,0
47,"Sectorul 6",179196,"#N/A",179196,,"BUCURESTI SECTORUL 6",1100,"SCOALA CU CLASELE I-VIII NR. 172 ""SF. ANDREI"", DIN ALEEA PARVA NR. 3-5",1566,999,990,9,0,985,14,1800,801,490,495,1,16975,0
47,"Sectorul 6",179196,"#N/A",179196,,"BUCURESTI SECTORUL 6",1101,"SCOALA CU CLASELE I-VIII NR. 172 ""SF. ANDREI"", DIN ALEEA PARVA NR. 3-5",1396,854,842,12,0,843,11,1600,746,461,382,1,16975,0
47,"Sectorul 6",179196,"#N/A",179196,,"BUCURESTI SECTORUL 6",1102,"SCOALA CU CLASELE I-VIII NR. 206, DIN ALEEA ARINIS NR. 5",1499,882,865,17,0,866,16,1700,818,473,393,1,16975,0
47,"Sectorul 6",179196,"#N/A",179196,,"BUCURESTI SECTORUL 6",1103,"SCOALA CU CLASELE I-VIII NR. 206, DIN ALEEA ARINIS NR. 5",1621,852,846,6,0,847,5,1800,948,435,412,1,16975,0
47,"Sectorul 6",179196,"#N/A",179196,,"BUCURESTI SECTORUL 6",1104,"SCOALA CU CLASELE I-VIII NR. 206, DIN ALEEA ARINIS NR. 5",1616,785,777,8,0,773,12,1800,1015,426,347,1,16975,0
47,"Sectorul 6",179196,"#N/A",179196,,"BUCURESTI SECTORUL 6",1105,"SCOALA CU CLASELE I-VIII NR. 206, DIN ALEEA ARINIS NR. 5",1421,854,846,8,0,837,17,1600,746,413,424,1,16975,0
47,"Sectorul 6",179196,"#N/A",179196,,"BUCURESTI SECTORUL 6",1106,"SCOALA CU CLASELE I-VIII NR. 206, DIN ALEEA ARINIS NR. 5",1572,880,870,10,0,874,6,1800,920,501,373,1,16975,0
47,"Sectorul 6",179196,"#N/A",179196,,"BUCURESTI SECTORUL 6",1107,"SCOALA CU CLASELE I-VIII NR. 206, DIN ALEEA ARINIS NR. 5",1597,928,923,4,1,910,18,1800,872,471,439,1,16975,0
47,"Sectorul 6",179196,"#N/A",179196,,"BUCURESTI SECTORUL 6",1108,"SCOALA CU CALSELE I-VIII NR. 176 ""SFINTII IMPARATI CONSTANTIN SI ELENA "", DIN STR. LUNCA CERNEI NR. 3",1095,753,741,12,0,741,12,1500,747,363,378,1,16975,0
47,"Sectorul 6",179196,"#N/A",179196,,"BUCURESTI SECTORUL 6",1109,"SCOALA CU CALSELE I-VIII NR. 176 ""SFINTII IMPARATI CONSTANTIN SI ELENA "", DIN STR. LUNCA CERNEI NR. 3",1671,900,887,13,0,889,11,1900,1000,417,472,1,16975,0
47,"Sectorul 6",179196,"#N/A",179196,,"BUCURESTI SECTORUL 6",1110,"SCOALA CU CALSELE I-VIII NR. 176 ""SFINTII IMPARATI CONSTANTIN SI ELENA "", DIN STR. LUNCA CERNEI NR. 3",1287,778,768,10,0,768,10,1400,622,390,378,1,16975,0
47,"Sectorul 6",179196,"#N/A",179196,,"BUCURESTI SECTORUL 6",1111,"SCOALA CU CALSELE I-VIII NR. 176 ""SFINTII IMPARATI CONSTANTIN SI ELENA "", DIN STR. LUNCA CERNEI NR. 3",1469,883,871,12,0,867,16,1600,717,444,423,1,16975,0
47,"Sectorul 6",179196,"#N/A",179196,,"BUCURESTI SECTORUL 6",1112,"SCOALA CU CALSELE I-VIII NR. 176 ""SFINTII IMPARATI CONSTANTIN SI ELENA "", DIN STR. LUNCA CERNEI NR. 3",1583,895,884,11,0,885,10,1800,905,449,436,1,16975,0
47,"Sectorul 6",179196,"#N/A",179196,,"BUCURESTI SECTORUL 6",1113,"SCOALA CU CALSELE I-VIII NR. 176 ""SFINTII IMPARATI CONSTANTIN SI ELENA "", DIN STR. LUNCA CERNEI NR. 3",911,358,349,9,0,353,5,1000,642,190,163,1,16975,0
47,"Sectorul 6",179196,"#N/A",179196,,"BUCURESTI SECTORUL 6",1114,"COLEGIUL TEHNIC DE POSTA SI TELECOMUNICATII ""GHEORGHE ARINEI"", DIN STR. ROMANCIERILOR NR. 1",1426,746,730,16,0,738,8,1599,853,386,352,1,16975,0
47,"Sectorul 6",179196,"#N/A",179196,,"BUCURESTI SECTORUL 6",1115,"COLEGIUL TEHNIC DE POSTA SI TELECOMUNICATII ""GHEORGHE ARINEI"", DIN STR. ROMANCIERILOR NR. 1",1804,906,894,12,0,892,14,2000,1094,445,447,1,16975,0
47,"Sectorul 6",179196,"#N/A",179196,,"BUCURESTI SECTORUL 6",1116,"BLOCUL I , DIN STR. VALEA OLTULUI NR. 139-141",1219,862,825,37,0,839,23,1400,538,430,409,1,16975,0
47,"Sectorul 6",179196,"#N/A",179196,,"BUCURESTI SECTORUL 6",1117,"SCOALA CU CLASELE I-VIII NR. 309 , DIN STR. MOINESTI NR. 9",1694,956,939,17,0,948,8,1900,944,486,462,1,16975,0
47,"Sectorul 6",179196,"#N/A",179196,,"BUCURESTI SECTORUL 6",1118,"SCOALA CU CLASELE I-VIII NR. 309, DIN STR. MOINESTI NR. 9",1705,904,895,9,0,886,18,1900,996,459,427,1,16975,0
47,"Sectorul 6",179196,"#N/A",179196,,"BUCURESTI SECTORUL 6",1119,"SCOALA CU CLASELE I-VIII NR. 309, DIN STR. MOINESTI NR. 9",1627,811,802,9,0,799,12,1800,989,419,380,1,16975,0
47,"Sectorul 6",179196,"#N/A",179196,,"BUCURESTI SECTORUL 6",1120,"SCOALA CU CLASELE I-VIII NR. 309, DIN STR. MOINESTI NR. 9",1357,651,645,6,0,647,4,1500,849,307,340,1,16975,0
47,"Sectorul 6",179196,"#N/A",179196,,"BUCURESTI SECTORUL 6",1121,"SCOALA CU CLASELE I-VIII NR. 309, DIN STR. MOINESTI NR. 9",1372,733,721,12,0,722,11,1500,767,432,290,1,16975,0
47,"Sectorul 6",179196,"#N/A",179196,,"BUCURESTI SECTORUL 6",1122,"SCOALA CU CLASELE I-VIII NR. 309, DIN STR. MOINESTI NR. 9",1908,904,883,21,0,897,7,2100,1196,429,468,1,16975,0
47,"Sectorul 6",179196,"#N/A",179196,,"BUCURESTI SECTORUL 6",1123,"SCOALA CU CLASELE I-VIII NR. 157 ""ION DUMITRU"", DIN STR. HANUL ANCUTEI NR. 4",1392,724,712,12,0,711,13,1500,776,359,352,1,16975,0
47,"Sectorul 6",179196,"#N/A",179196,,"BUCURESTI SECTORUL 6",1124,"SCOALA CU CLASELE I-VIII NR. 157 ""ION DUMITRU"", DIN STR. HANUL ANCUTEI NR. 4",1717,902,888,14,0,889,13,1900,998,437,452,1,16975,0
47,"Sectorul 6",179196,"#N/A",179196,,"BUCURESTI SECTORUL 6",1125,"SCOALA CU CLASELE I-VIII NR. 157 ""ION DUMITRU"", DIN STR. HANUL ANCUTEI NR. 4",1320,695,676,19,0,686,8,1500,806,379,307,1,16975,0
47,"Sectorul 6",179196,"#N/A",179196,,"BUCURESTI SECTORUL 6",1126,"SCOALA CU CLASELE I-VIII NR. 157 ""ION DUMITRU"", DIN STR. HANUL ANCUTEI NR. 4",1687,859,849,10,0,853,6,1895,1036,445,408,1,16975,0
47,"Sectorul 6",179196,"#N/A",179196,,"BUCURESTI SECTORUL 6",1127,"SCOALA CU CLASELE I-VIII NR. 157 ""ION DUMITRU"", DIN STR. HANUL ANCUTEI NR. 4",1529,798,787,11,0,787,11,1700,902,367,420,1,16975,0
47,"Sectorul 6",179196,"#N/A",179196,,"BUCURESTI SECTORUL 6",1128,"SCOALA CU CLASELE I-VIII NR. 157 ""ION DUMITRU"", DIN STR. HANUL ANCUTEI NR. 4",1438,719,703,15,1,709,10,1600,881,347,362,1,16975,0
47,"Sectorul 6",179196,"#N/A",179196,,"BUCURESTI SECTORUL 6",1129,"SCOALA CU CLASELE I-VIII NR. 157 ""ION DUMITRU"", DIN STR. HANUL ANCUTEI NR. 4",1481,667,660,7,0,656,11,1600,933,353,303,1,16975,0
47,"Sectorul 6",179196,"#N/A",179196,,"BUCURESTI SECTORUL 6",1130,"SCOALA CU CLASELE I-VIII NR. 157 ""ION DUMITRU"", DIN STR. HANUL ANCUTEI NR. 4",1639,889,878,10,1,882,7,1800,911,465,417,1,16975,0
47,"Sectorul 6",179196,"#N/A",179196,,"BUCURESTI SECTORUL 6",1131,"SCOALA CU CLASELE I-VIII NR. 157 ""ION DUMITRU"", DIN STR. HANUL ANCUTEI NR. 4",2104,1035,1014,21,0,1026,9,2300,1265,495,531,1,16975,0
47,"Sectorul 6",179196,"#N/A",179196,,"BUCURESTI SECTORUL 6",1132,"SCOALA CU CLASELE I-VIII NR. 157 ""ION DUMITRU"", DIN STR. HANUL ANCUTEI NR. 4",1588,625,612,13,0,615,10,1800,1175,339,276,1,16975,0
47,"Sectorul 6",179196,"#N/A",179196,,"BUCURESTI SECTORUL 6",1133,"CENTRUL CULTURAL EUROPEAN SECTOR 6, DIN B-DUL IULIU MANIU NR. 111, BL. F",2001,1107,1089,18,0,1094,13,2200,1093,510,584,1,16975,0
47,"Sectorul 6",179196,"#N/A",179196,,"BUCURESTI SECTORUL 6",1134,"GR. SC. IND. ""PETRU PONI"", DIN B-DUL PRECIZIEI NR. 18",1999,726,701,25,0,723,3,2200,1474,444,279,1,16975,0
47,"Sectorul 6",179196,"#N/A",179196,,"BUCURESTI SECTORUL 6",1135,"SCOALA CU CLASELE I-VIII NR. 160, DIN STR. GHIRLANDEI NR. 7",2049,981,971,10,0,973,8,2300,1319,558,415,1,16975,0
47,"Sectorul 6",179196,"#N/A",179196,,"BUCURESTI SECTORUL 6",1136,"SCOALA CU CLASELE I-VIII NR. 160, DIN STR. GHIRLANDEI NR. 7",1973,1017,1007,10,0,1007,10,2200,1183,471,536,1,16975,0
47,"Sectorul 6",179196,"#N/A",179196,,"BUCURESTI SECTORUL 6",1137,"SCOALA CU CLASELE I-VIII NR. 160, DIN STR. GHIRLANDEI NR. 7",1303,638,631,7,0,625,13,1500,862,318,307,1,16975,0
47,"Sectorul 6",179196,"#N/A",179196,,"BUCURESTI SECTORUL 6",1138,"SCOALA CU CLASELE I-VIII NR. 160, DIN STR. GHIRLANDEI NR. 7",1803,983,971,11,1,968,15,2000,1017,491,477,1,16975,0
47,"Sectorul 6",179196,"#N/A",179196,,"BUCURESTI SECTORUL 6",1139,"SCOALA CU CLASELE I-VIII NR. 160, DIN STR. GHIRLANDEI NR. 7",1382,769,742,27,0,758,11,1600,831,371,387,1,16975,0
47,"Sectorul 6",179196,"#N/A",179196,,"BUCURESTI SECTORUL 6",1140,"SCOALA CU CLASELE I-VIII NR. 160, DIN STR. GHIRLANDEI NR. 7",1637,812,804,8,0,807,5,1800,988,424,383,1,16975,0
47,"Sectorul 6",179196,"#N/A",179196,,"BUCURESTI SECTORUL 6",1141,"SCOALA CU CLASELE I-VIII NR. 160, DIN STR. GHIRLANDEI NR. 7",1493,834,824,9,1,818,16,1700,866,394,424,1,16975,0
47,"Sectorul 6",179196,"#N/A",179196,,"BUCURESTI SECTORUL 6",1142,"SCOALA CU CLASELE I-VIII NR. 160, DIN STR. GHIRLANDEI NR. 7",1845,910,901,9,0,900,10,2000,1090,458,442,1,16975,0
47,"Sectorul 6",179196,"#N/A",179196,,"BUCURESTI SECTORUL 6",1143,"SCOALA CU CLASELE I-VIII NR. 160, DIN STR. GHIRLANDEI NR. 7",1810,857,848,8,1,848,9,2000,1143,398,450,1,16975,0
47,"Sectorul 6",179196,"#N/A",179196,,"BUCURESTI SECTORUL 6",1144,"SCOALA CU CLASELE I-VIII NR. 160, DIN STR. GHIRLANDEI NR. 7",1632,770,760,10,0,757,13,1800,1030,325,432,1,16975,0
47,"Sectorul 6",179196,"#N/A",179196,,"BUCURESTI SECTORUL 6",1145,"SCOALA CU CLASELE I-VIII NR. 160, DIN STR. GHIRLANDEI NR. 7",1501,817,802,13,2,811,6,1700,883,407,404,1,16975,0
47,"Sectorul 6",179196,"#N/A",179196,,"BUCURESTI SECTORUL 6",1146,"SCOALA CU CLASELE I-VIII NR. 160, DIN STR. GHIRLANDEI NR. 7",1944,967,954,13,0,961,6,2200,1233,521,440,1,16975,0
47,"Sectorul 6",179196,"#N/A",179196,,"BUCURESTI SECTORUL 6",1147,"SCOALA CU CLASELE I-VIII NR. 160, DIN STR. GHIRLANDEI NR. 7",1605,856,842,13,1,845,11,1800,944,421,424,1,16975,0
47,"Sectorul 6",179196,"#N/A",179196,,"BUCURESTI SECTORUL 6",1148,"SCOALA CU CLASELE I-VIII NR. 174 ""CONSTANTIN BRANCUSI"", DIN STR. ROSIA MONTANA NR. 41",1533,845,836,9,0,834,11,1700,855,414,420,1,16975,0
47,"Sectorul 6",179196,"#N/A",179196,,"BUCURESTI SECTORUL 6",1149,"SCOALA CU CLASELE I-VIII NR. 174 ""CONSTANTIN BRANCUSI"", DIN STR. ROSIA MONTANA NR. 41",1413,774,762,12,0,754,20,1600,826,333,421,1,16975,0
47,"Sectorul 6",179196,"#N/A",179196,,"BUCURESTI SECTORUL 6",1150,"SCOALA CU CLASELE I-VIII NR. 174 ""CONSTANTIN BRANCUSI"", DIN STR. ROSIA MONTANA NR. 41",1554,832,821,11,0,819,13,1704,872,378,441,1,16975,0
47,"Sectorul 6",179196,"#N/A",179196,,"BUCURESTI SECTORUL 6",1151,"SCOALA CU CLASELE I-VIII NR. 174 ""CONSTANTIN BRANCUSI"", DIN STR. ROSIA MONTANA NR. 41",1232,694,685,9,0,685,9,1400,706,315,370,1,16975,0
47,"Sectorul 6",179196,"#N/A",179196,,"BUCURESTI SECTORUL 6",1152,"SCOALA CU CLASELE I-VIII NR. 174 ""CONSTANTIN BRANCUSI"", DIN STR. ROSIA MONTANA NR. 41",1970,1077,1061,16,0,1068,9,2200,1123,483,585,1,16975,0
47,"Sectorul 6",179196,"#N/A",179196,,"BUCURESTI SECTORUL 6",1153,"SCOALA CU CLASELE I-VIII NR. 174 ""CONSTANTIN BRANCUSI"", DIN STR. ROSIA MONTANA NR. 41",637,587,571,16,0,579,8,1100,513,268,311,1,16975,0
47,"Sectorul 6",179196,"#N/A",179196,,"BUCURESTI SECTORUL 6",1154,"SCOALA CU CLASELE I-VIII NR. 174 ""CONSTANTIN BRANCUSI"", DIN STR. ROSIA MONTANA NR. 41",1109,639,625,13,1,633,6,1200,561,278,355,1,16975,0
47,"Sectorul 6",179196,"#N/A",179196,,"BUCURESTI SECTORUL 6",1155,"SCOALA CU CLASELE I-VIII NR. 310 , DIN STR. ROSIA MONTANA NR. 42",1576,859,845,14,0,847,12,1700,841,434,413,1,16975,0
47,"Sectorul 6",179196,"#N/A",179196,,"BUCURESTI SECTORUL 6",1156,"SCOALA CU CLASELE I-VIII NR. 310, DIN STR. ROSIA MONTANA NR. 42",1357,707,693,13,1,695,12,1500,793,338,357,1,16975,0
47,"Sectorul 6",179196,"#N/A",179196,,"BUCURESTI SECTORUL 6",1157,"SCOALA CU CLASELE I-VIII NR. 310, DIN STR. ROSIA MONTANA NR. 42",861,474,460,14,0,465,9,1000,526,212,253,1,16975,0
47,"Sectorul 6",179196,"#N/A",179196,,"BUCURESTI SECTORUL 6",1158,"SCOALA CU CLASELE I-VIII NR. 310, DIN STR. ROSIA MONTANA NR. 42",1111,637,622,15,0,628,9,1200,563,307,321,1,16975,0
47,"Sectorul 6",179196,"#N/A",179196,,"BUCURESTI SECTORUL 6",1159,"LICEUL ECONOMIC ""COSTIN C. KIRITESCU"", DIN STR. PESTERA DAMBOVICIOARA NR. 12",1421,715,707,8,0,702,13,1600,885,340,362,1,16975,0
47,"Sectorul 6",179196,"#N/A",179196,,"BUCURESTI SECTORUL 6",1160,"LICEUL ECONOMIC ""COSTIN C. KIRITESCU"", DIN STR. PESTERA DAMBOVICIOARA NR. 12",1412,796,786,10,0,788,8,1600,804,378,410,1,16975,0
47,"Sectorul 6",179196,"#N/A",179196,,"BUCURESTI SECTORUL 6",1161,"LICEUL ECONOMIC ""COSTIN C. KIRITESCU"", DIN STR. PESTERA DAMBOVICIOARA NR. 12",1466,802,778,24,0,790,12,1600,798,347,443,1,16975,0
47,"Sectorul 6",179196,"#N/A",179196,,"BUCURESTI SECTORUL 6",1162,"LICEUL ECONOMIC ""COSTIN C. KIRITESCU"", DIN STR. PESTERA DAMBOVICIOARA NR. 12",1100,735,723,12,0,727,8,1600,865,346,381,1,16975,0
47,"Sectorul 6",179196,"#N/A",179196,,"BUCURESTI SECTORUL 6",1163,"LICEUL ECONOMIC ""COSTIN C. KIRITESCU"", DIN STR. PESTERA DAMBOVICIOARA NR. 12",1569,770,755,15,0,763,7,1698,928,375,388,1,16975,0
47,"Sectorul 6",179196,"#N/A",179196,,"BUCURESTI SECTORUL 6",1164,"LICEUL ECONOMIC ""COSTIN C. KIRITESCU"", DIN STR. PESTERA DAMBOVICIOARA NR. 12",1233,653,644,9,0,636,17,1400,747,278,358,1,16975,0
47,"Sectorul 6",179196,"#N/A",179196,,"BUCURESTI SECTORUL 6",1165,"LICEUL ECONOMIC ""COSTIN C. KIRITESCU"", DIN STR. PESTERA DAMBOVICIOARA NR. 12",1302,831,816,15,0,820,11,1400,569,357,463,1,16975,0
47,"Sectorul 6",179196,"#N/A",179196,,"BUCURESTI SECTORUL 6",1166,"LICEUL ECONOMIC ""COSTIN C. KIRITESCU"", DIN STR. PESTERA DAMBOVICIOARA NR. 12",1182,672,663,9,0,665,7,1300,628,316,349,1,16975,0
47,"Sectorul 6",179196,"#N/A",179196,,"BUCURESTI SECTORUL 6",1167,"SCOALA CU CLASELE I-VIII NR. 142, DIN STR. CENTURII NR. 4",1386,623,615,8,0,622,1,1500,877,325,297,1,16975,0
47,"Sectorul 6",179196,"#N/A",179196,,"BUCURESTI SECTORUL 6",1168,"SCOALA CU CLASELE I-VIII NR. 142, DIN STR. CENTURII NR. 4",1589,903,892,10,1,891,12,1800,897,440,451,1,16975,0
47,"Sectorul 6",179196,"#N/A",179196,,"BUCURESTI SECTORUL 6",1169,"SCOALA CU CLASELE I-VIII NR. 142, DIN STR. CENTURII NR. 4",1593,835,825,10,0,824,11,1800,965,398,426,1,16975,0
47,"Sectorul 6",179196,"#N/A",179196,,"BUCURESTI SECTORUL 6",1170,"SCOALA CU CLASELE I-VIII NR. 142, DIN STR. CENTURII NR. 4",1726,849,824,25,0,836,13,1900,1051,431,405,1,16975,0
47,"Sectorul 6",179196,"#N/A",179196,,"BUCURESTI SECTORUL 6",1171,"SCOALA CU CLASELE I-VIII NR. 142, DIN STR. CENTURII NR. 4",1511,716,699,17,0,710,6,1701,985,377,333,1,16975,0
47,"Sectorul 6",179196,"#N/A",179196,,"BUCURESTI SECTORUL 6",1172,"SCOALA CU CLASELE I-VIII NR. 142, DIN STR. CENTURII NR. 4",1993,983,962,21,0,970,13,2200,1217,487,483,1,16975,0
47,"Sectorul 6",179196,"#N/A",179196,,"BUCURESTI SECTORUL 6",1173,"SCOALA CU CLASELE I-VIII NR. 142, DIN STR. CENTURII NR. 4",1696,869,859,9,1,859,10,1900,1031,483,376,1,16975,0
47,"Sectorul 6",179196,"#N/A",179196,,"BUCURESTI SECTORUL 6",1174,"SCOALA CU CLASELE I-VIII NR. 142, DIN STR. CENTURII NR. 4",1510,753,737,16,0,742,11,1700,947,335,407,1,16975,0
47,"Sectorul 6",179196,"#N/A",179196,,"BUCURESTI SECTORUL 6",1175,"SCOALA CU CLASELE I-VIII NR. 142, DIN STR. CENTURII NR. 4",1624,817,803,14,0,806,11,1800,983,386,420,1,16975,0
47,"Sectorul 6",179196,"#N/A",179196,,"BUCURESTI SECTORUL 6",1176,"SCOALA CU CLASELE NR. I-VIII NR. 156 ""SF. GHEORGHE"", DIN STR. DEALUL TUGULEA NR. 35",1414,790,782,8,0,783,7,1600,810,395,388,1,16975,0
47,"Sectorul 6",179196,"#N/A",179196,,"BUCURESTI SECTORUL 6",1177,"SCOALA CU CLASELE NR. I-VIII NR. 156 ""SF. GHEORGHE"", DIN STR. DEALUL TUGULEA NR. 35",1676,881,867,12,2,865,16,1900,1019,447,418,1,16975,0
47,"Sectorul 6",179196,"#N/A",179196,,"BUCURESTI SECTORUL 6",1178,"SCOALA CU CLASELE NR. I-VIII NR. 156 ""SF. GHEORGHE"", DIN STR. DEALUL TUGULEA NR. 35",1131,562,552,10,0,557,5,1300,738,281,276,1,16975,0
47,"Sectorul 6",179196,"#N/A",179196,,"BUCURESTI SECTORUL 6",1179,"SCOALA CU CLASELE NR. I-VIII NR. 156 ""SF. GHEORGHE"", DIN STR. DEALUL TUGULEA NR. 35",1781,1060,1037,23,0,1046,14,2200,1140,559,487,1,16975,0
47,"Sectorul 6",179196,"#N/A",179196,,"BUCURESTI SECTORUL 6",1180,"SCOALA CU CLASELE NR. I-VIII NR. 156 ""SF. GHEORGHE"", DIN STR. DEALUL TUGULEA NR. 35",1710,1004,994,10,0,996,8,1600,596,513,483,1,16975,0
47,"Sectorul 6",179196,"#N/A",179196,,"BUCURESTI SECTORUL 6",1181,"SCOALA CU CLASELE NR. I-VIII NR. 156 ""SF. GHEORGHE"", DIN STR. DEALUL TUGULEA NR. 35",1703,948,938,10,0,935,13,1900,952,481,454,1,16975,0
47,"Sectorul 6",179196,"#N/A",179196,,"BUCURESTI SECTORUL 6",1182,"SCOALA CU CLASELE NR. I-VIII NR. 156 ""SF. GHEORGHE"", DIN STR. DEALUL TUGULEA NR. 35",1491,808,794,14,0,791,17,1700,892,360,431,1,16975,0
47,"Sectorul 6",179196,"#N/A",179196,,"BUCURESTI SECTORUL 6",1183,"SCOALA CU CLASELE NR. I-VIII NR. 156 ""SF. GHEORGHE"", DIN STR. DEALUL TUGULEA NR. 35",1511,852,835,17,0,841,11,1700,848,387,454,1,16975,0
47,"Sectorul 6",179196,"#N/A",179196,,"BUCURESTI SECTORUL 6",1184,"SCOALA CU CLASELE NR. I-VIII NR. 156 ""SF. GHEORGHE"", DIN STR. DEALUL TUGULEA NR. 35",1997,1009,995,14,0,1003,6,2202,1193,475,528,1,16975,0
47,"Sectorul 6",179196,"#N/A",179196,,"BUCURESTI SECTORUL 6",1185,"SCOALA CU CLASELE NR. I-VIII NR. 156 ""SF. GHEORGHE"", DIN STR. DEALUL TUGULEA NR. 35",1716,869,857,11,1,850,19,1903,1034,425,425,1,16975,0
47,"Sectorul 6",179196,"#N/A",179196,,"BUCURESTI SECTORUL 6",1186,"SCOALA CU CLASELE NR. I-VIII NR. 156 ""SF. GHEORGHE"", DIN STR. DEALUL TUGULEA NR. 35",797,723,711,12,0,717,6,1500,777,326,391,1,16975,0
47,"Sectorul 6",179196,"#N/A",179196,,"BUCURESTI SECTORUL 6",1187,"SCOALA CU CLASELE NR. I-VIII NR. 156 ""SF. GHEORGHE"", DIN STR. DEALUL TUGULEA NR. 35",2012,1124,1111,13,0,1109,15,2200,1076,509,600,1,16975,0
47,"Sectorul 6",179196,"#N/A",179196,,"BUCURESTI SECTORUL 6",1188,"SCOALA CU CLASELE NR. I-VIII NR. 156 ""SF. GHEORGHE"", DIN STR. DEALUL TUGULEA NR. 35",1980,1069,1036,32,1,1054,15,2200,1131,543,511,1,16975,0
47,"Sectorul 6",179196,"#N/A",179196,,"BUCURESTI SECTORUL 6",1189,"SCOALA CU CLASELE I-VIII NR. 117, DIN STR. FABRICII NR. 22",1920,1013,1003,10,0,995,18,2100,1087,514,481,1,16975,0
47,"Sectorul 6",179196,"#N/A",179196,,"BUCURESTI SECTORUL 6",1190,"SCOALA CU CLASELE I-VIII NR. 117, DIN STR. FABRICII NR. 22",1529,846,841,5,0,839,7,1700,854,389,450,1,16975,0
47,"Sectorul 6",179196,"#N/A",179196,,"BUCURESTI SECTORUL 6",1191,"SCOALA CU CLASELE I-VIII NR. 117, DIN STR. FABRICII NR. 22",1173,718,706,12,0,714,4,1300,582,322,392,1,16975,0
47,"Sectorul 6",179196,"#N/A",179196,,"BUCURESTI SECTORUL 6",1192,"SCOALA CU CLASELE I-VIII NR. 117, DIN STR. FABRICII NR. 22",1929,976,962,13,1,957,19,2100,1124,483,474,1,16975,0
47,"Sectorul 6",179196,"#N/A",179196,,"BUCURESTI SECTORUL 6",1193,"SCOALA CU CLASELE I-VIII NR. 117, DIN STR. FABRICII NR. 22",1780,836,822,14,0,821,15,2000,1164,389,432,1,16975,0
47,"Sectorul 6",179196,"#N/A",179196,,"BUCURESTI SECTORUL 6",1194,"SCOALA CU CLASELE I-VIII NR. 117, DIN STR. FABRICII NR. 22",1501,660,649,11,0,655,5,1700,1040,348,307,1,16975,0
47,"Sectorul 6",179196,"#N/A",179196,,"BUCURESTI SECTORUL 6",1195,"SCOALA CU CLASELE I-VIII NR. 117, DIN STR. FABRICII NR. 22",1346,768,762,6,0,761,7,1501,733,376,385,1,16975,0
47,"Sectorul 6",179196,"#N/A",179196,,"BUCURESTI SECTORUL 6",1196,"LICEUL TEORETIC ""TUDOR VLADIMIRESCU"", DIN B-DUL IULIU MANIU NR. 15",1600,807,799,8,0,795,12,1600,793,384,411,1,16975,0
47,"Sectorul 6",179196,"#N/A",179196,,"BUCURESTI SECTORUL 6",1197,"LICEUL TEORETIC ""TUDOR VLADIMIRESCU"", DIN B-DUL IULIU MANIU NR. 15",1200,690,676,14,0,676,14,1300,610,349,327,1,16975,0
47,"Sectorul 6",179196,"#N/A",179196,,"BUCURESTI SECTORUL 6",1198,"LICEUL TEORETIC ""TUDOR VLADIMIRESCU"", DIN B-DUL IULIU MANIU NR. 15",1568,914,887,26,1,899,15,1700,786,434,465,1,16975,0
47,"Sectorul 6",179196,"#N/A",179196,,"BUCURESTI SECTORUL 6",1199,"LICEUL TEORETIC ""TUDOR VLADIMIRESCU"", DIN B-DUL IULIU MANIU NR. 15",1032,605,590,14,1,587,18,1100,495,302,285,1,16975,0
47,"Sectorul 6",179196,"#N/A",179196,,"BUCURESTI SECTORUL 6",1200,"LICEUL TEORETIC ""TUDOR VLADIMIRESCU"", DIN B-DUL IULIU MANIU NR. 15",1439,796,785,11,0,789,7,1598,802,357,432,1,16975,0
47,"Sectorul 6",179196,"#N/A",179196,,"BUCURESTI SECTORUL 6",1201,"CLUBUL SPORTIV SCOLAR NR. 5, DIN CALEA PLEVNEI NR. 124",1478,784,767,17,0,771,13,1600,816,386,385,1,16975,0
47,"Sectorul 6",179196,"#N/A",179196,,"BUCURESTI SECTORUL 6",1202,"SCOALA DE ARTE SI MESERII ""SPIRU HARET"" ( UCECOM), DIN STR. ECONOM CEZARESCU NR. 47",723,305,294,11,0,299,6,800,495,149,150,1,16975,0
47,"Sectorul 6",179196,"#N/A",179196,,"BUCURESTI SECTORUL 6",1203,"SCOALA CU CLASELE I-VIII NR. 168, DIN STR. ALIZEULUI NR. 9",1784,863,847,16,0,850,13,2000,1137,457,393,1,16975,0
47,"Sectorul 6",179196,"#N/A",179196,,"BUCURESTI SECTORUL 6",1204,"SCOALA CU CLASELE I-VIII NR. 168, DIN STR. ALIZEULUI NR. 9",1664,796,779,17,0,779,17,1799,1003,378,401,1,16975,0
47,"Sectorul 6",179196,"#N/A",179196,,"BUCURESTI SECTORUL 6",1205,"SCOALA CU CLASELE I-VIII NR. 168, DIN STR. ALIZEULUI NR. 9",1349,720,709,11,0,711,9,1500,780,378,333,1,16975,0
47,"Sectorul 6",179196,"#N/A",179196,,"BUCURESTI SECTORUL 6",1206,"SCOALA CU CLASELE I-VIII NR. 168, DIN STR. ALIZEULUI NR. 9",1567,809,801,8,0,795,14,1700,891,389,406,1,16975,0
47,"Sectorul 6",179196,"#N/A",179196,,"BUCURESTI SECTORUL 6",1207,"GR. SC. IND. ""DOAMNA STANCA"", DIN STR. PORUMBACU NR. 52",1358,798,785,13,0,789,9,2000,1202,412,377,1,16975,0
47,"Sectorul 6",179196,"#N/A",179196,,"BUCURESTI SECTORUL 6",1208,"GR. SC. IND. ""DOAMNA STANCA"", DIN STR. PORUMBACU NR. 52",1812,939,923,16,0,927,12,2000,1061,443,484,1,16975,0
47,"Sectorul 6",179196,"#N/A",179196,,"BUCURESTI SECTORUL 6",1209,"GR. SC. IND. ""DOAMNA STANCA"", DIN STR. PORUMBACU NR. 52",1916,929,923,6,0,918,11,2100,1171,476,442,1,16975,0
47,"Sectorul 6",179196,"#N/A",179196,,"BUCURESTI SECTORUL 6",1210,"GR. SC. IND. ""DOAMNA STANCA"", DIN STR. PORUMBACU NR. 52",1575,822,810,12,0,805,17,1700,878,370,435,1,16975,0
47,"Sectorul 6",179196,"#N/A",179196,,"BUCURESTI SECTORUL 6",1211,"GR. SC. IND. ""DOAMNA STANCA"", DIN STR. PORUMBACU NR. 52",1343,730,717,13,0,727,3,1500,770,416,311,1,16975,0
47,"Sectorul 6",179196,"#N/A",179196,,"BUCURESTI SECTORUL 6",1212,"GR. SC. IND. ""DOAMNA STANCA"", DIN STR. PORUMBACU NR. 52",1323,649,640,8,1,640,9,1500,851,319,321,1,16975,0
47,"Sectorul 6",179196,"#N/A",179196,,"BUCURESTI SECTORUL 6",1213,"GR. SC. IND. ""DOAMNA STANCA"", DIN STR. PORUMBACU NR. 52",1537,857,847,10,0,836,21,1700,843,454,382,1,16975,0
47,"Sectorul 6",179196,"#N/A",179196,,"BUCURESTI SECTORUL 6",1214,"GR. SC. IND. ""DOAMNA STANCA"", DIN STR. PORUMBACU NR. 52",1456,773,764,9,0,761,12,1600,827,415,346,1,16975,0
47,"Sectorul 6",179196,"#N/A",179196,,"BUCURESTI SECTORUL 6",1215,"GRADINITA DE COPII NR. 40, DIN STR. TABLA BUTII NR. 60",1775,987,969,18,0,974,13,2000,1013,490,484,1,16975,0
47,"Sectorul 6",179196,"#N/A",179196,,"BUCURESTI SECTORUL 6",1216,"GRADINITA DE COPII NR. 40, DIN STR. TABLA BUTII NR. 60",1853,1009,1000,9,0,993,16,2000,991,519,474,1,16975,0
47,"Sectorul 6",179196,"#N/A",179196,,"BUCURESTI SECTORUL 6",1217,"GRADINITA DE COPII NR. 40, DIN STR. TABLA BUTII NR. 60",1364,714,696,18,0,704,10,1500,786,378,326,1,16975,0
47,"Sectorul 6",179196,"#N/A",179196,,"BUCURESTI SECTORUL 6",1218,"GRADINITA DE COPII NR. 40, DIN STR. TABLA BUTII NR. 60",1242,642,622,20,0,635,7,1400,758,313,322,1,16975,0
47,"Sectorul 6",179196,"#N/A",179196,,"BUCURESTI SECTORUL 6",1219,"SCOALA CU CLASELE I-VIII NR. 163, DIN CALEA GIULESTI NR. 54",1391,754,734,20,0,746,8,1500,746,354,392,1,16975,0
47,"Sectorul 6",179196,"#N/A",179196,,"BUCURESTI SECTORUL 6",1220,"SCOALA CU CLASELE I-VIII NR. 163, DIN CALEA GIULESTI NR. 54",1416,723,716,7,0,713,10,1600,877,417,296,1,16975,0
47,"Sectorul 6",179196,"#N/A",179196,,"BUCURESTI SECTORUL 6",1221,"SCOALA CU CLASELE I-VIII NR. 163, DIN CALEA GIULESTI NR. 54",1537,905,891,14,0,895,10,1699,794,420,475,1,16975,0
47,"Sectorul 6",179196,"#N/A",179196,,"BUCURESTI SECTORUL 6",1222,"SCOALA CU CLASELE I-VIII NR. 163, DIN CALEA GIULESTI NR. 54",1196,664,650,14,0,657,7,1300,636,327,330,1,16975,0
47,"Sectorul 6",179196,"#N/A",179196,,"BUCURESTI SECTORUL 6",1223,"SCOALA CU CLASELE I-VIII NR. 163, DIN CALEA GIULESTI NR. 54",1363,776,757,15,4,773,3,1500,724,407,366,1,16975,0
47,"Sectorul 6",179196,"#N/A",179196,,"BUCURESTI SECTORUL 6",1224,"LICEUL TEORETIC ""MARIN PREDA"", DIN STR. RUSETU NR. 17",1723,820,802,17,1,801,19,1900,1080,419,382,1,16975,0
47,"Sectorul 6",179196,"#N/A",179196,,"BUCURESTI SECTORUL 6",1225,"LICEUL TEORETIC ""MARIN PREDA"", DIN STR. RUSETU NR. 17",1395,775,766,9,0,760,15,1500,725,375,385,1,16975,0
47,"Sectorul 6",179196,"#N/A",179196,,"BUCURESTI SECTORUL 6",1226,"LICEUL TEORETIC ""MARIN PREDA"", DIN STR. RUSETU NR. 17",1123,600,592,8,0,594,6,1200,600,303,291,1,16975,0
47,"Sectorul 6",179196,"#N/A",179196,,"BUCURESTI SECTORUL 6",1227,"LICEUL TEORETIC ""MARIN PREDA"", DIN STR. RUSETU NR. 17",1639,842,827,15,0,827,15,1800,958,393,434,1,16975,0
47,"Sectorul 6",179196,"#N/A",179196,,"BUCURESTI SECTORUL 6",1228,"SCOALA CU CLASELE I-VIII NR. 167, DIN CALEA CRANGASI NR. 140",2057,899,878,21,0,891,8,2300,1401,460,431,1,16975,0
47,"Sectorul 6",179196,"#N/A",179196,,"BUCURESTI SECTORUL 6",1229,"SCOALA CU CLASELE I-VIII NR. 167, DIN CALEA CRANGASI NR. 140",1456,595,579,16,0,590,5,1600,1005,317,273,1,16975,0
47,"Sectorul 6",179196,"#N/A",179196,,"BUCURESTI SECTORUL 6",1230,"SCOALA CU CLASELE I-VIII NR. 167, DIN CALEA CRANGASI NR. 140",1710,790,762,28,0,780,10,1900,1110,388,392,1,16975,0
47,"Sectorul 6",179196,"#N/A",179196,,"BUCURESTI SECTORUL 6",1231,"SCOALA CU CLASELE I-VIII NR. 167, DIN CALEA CRANGASI NR. 140",1424,716,701,14,1,706,10,1600,884,379,327,1,16975,0
47,"Sectorul 6",179196,"#N/A",179196,,"BUCURESTI SECTORUL 6",1232,"SCOALA CU CLASELE I-VIII NR. 167, DIN CALEA CRANGASI NR. 140",1264,565,557,8,0,561,4,1400,835,288,273,1,16975,0
47,"Sectorul 6",179196,"#N/A",179196,,"BUCURESTI SECTORUL 6",1233,"SCOALA CU CLASELE I-VIII NR. 167, DIN CALEA CRANGASI NR. 140",1224,652,643,9,0,643,9,1400,748,376,267,1,16975,0
47,"Sectorul 6",179196,"#N/A",179196,,"BUCURESTI SECTORUL 6",1234,"SCOALA CU CLASELE I-VIII NR. 167, DIN CALEA CRANGASI NR. 140",1810,882,872,10,0,869,13,2000,1118,398,471,1,16975,0
47,"Sectorul 6",179196,"#N/A",179196,,"BUCURESTI SECTORUL 6",1235,"SCOALA CU CLASELE I-VIII NR. 167, DIN CALEA CRANGASI NR. 140",1213,620,611,9,0,608,12,1300,680,349,259,1,16975,0
47,"Sectorul 6",179196,"#N/A",179196,,"BUCURESTI SECTORUL 6",1236,"SCOALA CU CLASELE I-VIII NR. 167, DIN CALEA CRANGASI NR. 140",905,662,651,11,0,651,11,1500,838,349,302,1,16975,0
47,"Sectorul 6",179196,"#N/A",179196,,"BUCURESTI SECTORUL 6",1237,"SCOALA CU CLASELE I-VIII NR. 167, DIN CALEA CRANGASI NR. 140",1530,802,789,13,0,785,17,1700,898,424,361,1,16975,0
47,"Sectorul 6",179196,"#N/A",179196,,"BUCURESTI SECTORUL 6",1238,"SCOALA CU CLASELE I-VIII NR. 162, DIN CALEA GIULESTI NR. 254",2001,1016,964,52,0,1001,15,2200,1184,516,485,1,16975,0
47,"Sectorul 6",179196,"#N/A",179196,,"BUCURESTI SECTORUL 6",1239,"SCOALA CU CLASELE I-VIII NR. 153, DIN DRUMUL SABARENI NR. 21",1708,676,667,9,0,668,8,1900,1224,348,320,1,16975,0
47,"Sectorul 6",179196,"#N/A",179196,,"BUCURESTI SECTORUL 6",1240,"SCOALA CU CLASELE I-VIII NR. 153, DIN DRUMUL SABARENI NR. 21",1302,512,499,13,0,510,2,1400,888,296,214,1,16975,0
47,"Sectorul 6",179196,"#N/A",179196,,"BUCURESTI SECTORUL 6",1241,"SCOALA CU CLASELE I-VIII NR. 161, DIN CALEA GIULESTI NR. 486A",1763,682,654,28,0,676,6,2000,1318,375,301,1,16975,0
47,"Sectorul 6",179196,"#N/A",179196,,"BUCURESTI SECTORUL 6",1242,"CAMINUL C-D, DIN SPLAIUL INDEPENDENTEI NR.204",0,786,0,786,0,762,24,1700,914,448,314,1,16975,1
47,"Sectorul 6",179196,"#N/A",179196,,"BUCURESTI SECTORUL 6",1243,"CAMINUL C-D, DIN SPLAIUL INDEPENDENTEI NR.204",0,1375,0,1375,0,1347,28,2000,625,833,514,1,16975,1
47,"Sectorul 6",179196,"#N/A",179196,,"BUCURESTI SECTORUL 6",1244,"COMPLEX CAMINE STUDENTESTI ADMINISTRATE DE ""UNIVERSITATEA POLITEHNICA BUCURESTI"", DIN SPLAIUL INDEPENDENTEI NR.290",0,1298,0,1298,0,1266,32,1299,1,663,603,1,16975,1
47,"Sectorul 6",179196,"#N/A",179196,,"BUCURESTI SECTORUL 6",1245,"COMPLEX CAMINE STUDENTESTI ADMINISTRATE DE ""UNIVERSITATEA POLITEHNICA BUCURESTI"", DIN SPLAIUL INDEPENDENTEI NR.290",0,1394,0,1394,0,1364,30,1500,106,696,668,1,16975,1
47,"Sectorul 6",179196,"#N/A",179196,,"BUCURESTI SECTORUL 6",1246,"COMPLEX CAMINE STUDENTESTI ADMINISTRATE DE ""UNIVERSITATEA POLITEHNICA BUCURESTI"", DIN SPLAIUL INDEPENDENTEI NR.290",0,1288,0,1288,0,1254,34,2000,712,678,576,1,16975,1
47,"Sectorul 6",179196,"#N/A",179196,,"BUCURESTI SECTORUL 6",1247,"COMPLEX CAMINE STUDENTESTI ADMINISTRATE DE ""UNIVERSITATEA POLITEHNICA BUCURESTI"", DIN SPLAIUL INDEPENDENTEI NR.290",0,876,0,876,0,860,16,1600,724,416,444,1,16975,1
47,"Sectorul 6",179196,"#N/A",179196,,"BUCURESTI SECTORUL 6",1248,"COMPLEX CAMINE STUDENTESTI ADMINISTRATE DE ""UNIVERSITATEA POLITEHNICA BUCURESTI"", DIN SPLAIUL INDEPENDENTEI NR.290",0,865,0,865,0,847,18,1700,835,478,369,1,16975,1
47,"Sectorul 6",179196,"#N/A",179196,,"BUCURESTI SECTORUL 6",1249,"COMPLEX CAMINE STUDENTESTI ADMINISTRATE DE ""UNIVERSITATEA POLITEHNICA BUCURESTI"", DIN SPLAIUL INDEPENDENTEI NR.290",0,911,0,911,0,883,28,1800,889,422,461,1,16975,1
47,"Sectorul 6",179196,"#N/A",179196,,"BUCURESTI SECTORUL 6",1250,"COMPLEX CAMINE STUDENTESTI ADMINISTRATE DE ""UNIVERSITATEA POLITEHNICA BUCURESTI"", DIN SPLAIUL INDEPENDENTEI NR.290",0,1084,0,1084,0,1051,33,1900,816,552,499,1,16975,1
47,"Sectorul 6",179196,"#N/A",179196,,"BUCURESTI SECTORUL 6",1251,"COMPLEX CAMINE STUDENTESTI ADMINISTRATE DE ""UNIVERSITATEA POLITEHNICA BUCURESTI"", DIN SPLAIUL INDEPENDENTEI NR.290",0,1061,0,1061,0,1032,29,1700,639,547,485,1,16975,1
47,"Sectorul 6",179196,"#N/A",179196,,"BUCURESTI SECTORUL 6",1252,"COMPLEX CAMINE STUDENTESTI ADMINISTRATE DE ""UNIVERSITATEA POLITEHNICA BUCURESTI"", DIN SPLAIUL INDEPENDENTEI NR.290",0,1470,0,1470,0,1430,40,2000,530,823,607,1,16975,1
47,"Sectorul 6",179196,"#N/A",179196,,"BUCURESTI SECTORUL 6",1253,"CAMIN A3, DIN STR. PASCAL CRISTIAN",0,1446,0,1446,0,1412,34,3100,1654,711,701,1,16975,1
47,"Sectorul 6",179196,"#N/A",179196,,"BUCURESTI SECTORUL 6",1254,"CAMIN A LEU, DIN BD. IULIU MANIU NR. 1-3",0,2183,0,2183,0,2155,28,2400,217,1237,918,1,16975,1
47,"Sectorul 6",179196,"#N/A",179196,,"BUCURESTI SECTORUL 6",1255,"ACADEMIA NATIONALA DE EDUCATIE FIZICA SI SPORT, DIN STR. CONSTANTIN NOICA NR.140",0,942,0,942,0,930,12,997,55,527,403,1,16975,1
47,"Sectorul 6",179196,"#N/A",179196,,"BUCURESTI SECTORUL 6",1256,"SPITALUL CLINIC DE OBSTETRICA SI GINECOLOGIE ""PANAIT SARBU"", DIN CALEA GIULESTI NR. 5",0,1144,0,1144,0,1128,16,1473,329,689,439,1,16975,1
48,"Strainatate",1,,,"ZA","AFRICA DE SUD",1,"PRETORIA",0,71,0,71,0,71,0,200,129,41,30,0,0,2
48,"Strainatate",1,,,"ZA","AFRICA DE SUD",2,"CAPE TOWN",0,50,0,50,0,50,0,200,150,35,15,0,0,2
48,"Strainatate",2,,,"AL","ALBANIA",3,"TIRANA",0,22,0,22,0,22,0,100,78,10,12,0,0,2
48,"Strainatate",3,,,"DZ","ALGERIA",4,"ALGER",0,37,0,37,0,35,2,100,63,16,19,0,0,2
48,"Strainatate",4,,,"AO","ANGOLA",5,"LUANDA",0,18,0,18,0,18,0,100,82,11,7,0,0,2
48,"Strainatate",5,,,"SA","ARABIA SAUDITA",6,"RIAD",0,25,0,25,0,25,0,100,75,18,7,0,0,2
48,"Strainatate",5,,,"SA","ARABIA SAUDITA",7,"JUBAIL",0,45,0,45,0,45,0,202,157,24,21,0,0,2
48,"Strainatate",6,,,"AR","ARGENTINA",8,"BUENOS AIRES",0,39,0,39,0,38,1,200,161,11,27,0,0,2
48,"Strainatate",7,,,"AM","ARMENIA",9,"EREVAN",0,26,0,26,0,26,0,101,75,16,10,0,0,2
48,"Strainatate",8,,,"AU","AUSTRALIA",10,"CANBERRA",0,27,0,27,0,27,0,200,173,20,7,0,0,2
48,"Strainatate",8,,,"AU","AUSTRALIA",11,"SYDNEY",0,172,0,172,0,170,2,1002,830,143,27,0,0,2
48,"Strainatate",8,,,"AU","AUSTRALIA",12,"MELBOURNE",0,347,0,347,0,345,2,1396,1049,307,38,0,0,2
48,"Strainatate",9,,,"AT","AUSTRIA",13,"VIENA",0,1515,0,1515,0,1479,36,4300,2785,1086,393,0,0,2
48,"Strainatate",9,,,"AT","AUSTRIA",14,"GRAZ",0,506,0,506,0,504,2,1500,994,396,108,0,0,2
48,"Strainatate",9,,,"AT","AUSTRIA",15,"SALZBURG",0,191,0,191,0,190,1,600,409,149,41,0,0,2
48,"Strainatate",10,,,"AZ","AZERBAIDJAN",16,"BAKU",0,39,0,39,0,38,1,202,163,22,16,0,0,2
48,"Strainatate",11,,,"BY","BELARUS",17,"MINSK",0,17,0,17,0,17,0,99,82,4,13,0,0,2
48,"Strainatate",12,,,"BE","BELGIA",18,"BRUXELLES 1",0,2196,0,2196,0,2180,16,5000,2804,1697,483,0,0,2
48,"Strainatate",12,,,"BE","BELGIA",19,"BRUXELLES 2",0,1255,0,1255,0,1248,7,3400,2145,957,291,0,0,2
48,"Strainatate",12,,,"BE","BELGIA",20,"LIEGE",0,301,0,301,0,299,2,800,499,228,71,0,0,2
48,"Strainatate",12,,,"BE","BELGIA",21,"ANVERS",0,542,0,542,0,534,8,800,258,430,104,0,0,2
48,"Strainatate",13,,,"BA","BOSNIA - HERZEGOVINA",22,"SARAJEVO",0,62,0,62,0,59,3,500,438,18,41,0,0,2
48,"Strainatate",14,,,"BR","BRAZILIA",23,"BRASILIA",0,14,0,14,0,14,0,200,186,4,10,0,0,2
48,"Strainatate",14,,,"BR","BRAZILIA",24,"RIO DE JANEIRO",0,16,0,16,0,16,0,192,176,5,11,0,0,2
48,"Strainatate",15,,,"BG","BULGARIA",25,"SOFIA",0,128,0,128,0,126,2,1400,1272,67,59,0,0,2
48,"Strainatate",15,,,"BG","BULGARIA",26,"BURGAS",0,5,0,5,0,5,0,200,195,0,5,0,0,2
48,"Strainatate",16,,,"CA","CANADA",27,"OTTAWA",0,261,0,261,0,261,0,1500,1239,182,79,0,0,2
48,"Strainatate",16,,,"CA","CANADA",28,"MONCTON",0,8,0,8,0,8,0,100,92,5,3,0,0,2
48,"Strainatate",16,,,"CA","CANADA",29,"TORONTO",0,1161,0,1161,0,1154,7,3200,2039,916,238,0,0,2
48,"Strainatate",16,,,"CA","CANADA",30,"MONTREAL",0,1514,0,1514,0,1508,6,6000,4486,1290,218,0,0,2
48,"Strainatate",17,,,"CZ","CEHIA",31,"PRAGA",0,386,0,386,0,376,10,1600,1214,198,178,0,0,2
48,"Strainatate",17,,,"CZ","CEHIA",32,"BRNO",0,175,0,175,0,172,3,600,425,107,65,0,0,2
48,"Strainatate",18,,,"CL","CHILE",33,"SANTIAGO DE CHILE",0,24,0,24,0,23,1,200,176,15,8,0,0,2
48,"Strainatate",18,,,"CL","CHILE",34,"COPIAPO",0,41,0,41,0,38,3,200,159,16,22,0,0,2
48,"Strainatate",19,,,"CY","CIPRU",35,"NICOSIA",0,882,0,882,0,880,2,6000,5118,641,239,0,0,2
48,"Strainatate",19,,,"CY","CIPRU",36,"LARNACA",0,367,0,367,0,355,12,2800,2433,266,89,0,0,2
48,"Strainatate",19,,,"CY","CIPRU",37,"LIMASSOL",0,594,0,594,0,586,8,4000,3406,412,174,0,0,2
48,"Strainatate",20,,,"CO","COLUMBIA",38,"BOGOTA",0,36,0,36,0,36,0,100,64,22,14,0,0,2
48,"Strainatate",21,,,"HR","CROATIA",39,"ZAGREB",0,35,0,35,0,35,0,203,168,15,20,0,0,2
48,"Strainatate",22,,,"CU","CUBA",40,"HAVANA",0,10,0,10,0,10,0,100,90,5,5,0,0,2
48,"Strainatate",23,,,"DK","DANEMARCA",41,"COPENHAGA",0,291,0,291,0,288,3,604,313,169,119,0,0,2
48,"Strainatate",24,,,"EG","EGIPT",42,"CAIRO",0,74,0,74,0,73,1,600,526,36,37,0,0,2
48,"Strainatate",24,,,"EG","EGIPT",43,"HURGHADA",0,41,0,41,0,41,0,600,559,24,17,0,0,2
48,"Strainatate",24,,,"EG","EGIPT",44,"SHARM EL SHEIKH",0,52,0,52,0,52,0,400,348,17,35,0,0,2
48,"Strainatate",25,,,"CH","ELVETIA",45,"BERNA",0,397,0,397,0,393,4,3200,2803,298,95,0,0,2
48,"Strainatate",25,,,"CH","ELVETIA",46,"GENEVA",0,575,0,575,0,566,9,1600,1025,409,157,0,0,2
48,"Strainatate",26,,,"AE","EMIRATELE ARABE UNITE",47,"ABU DHABI",0,176,0,176,0,175,1,500,324,126,49,0,0,2
48,"Strainatate",26,,,"AE","EMIRATELE ARABE UNITE",48,"DUBAI",0,265,0,265,0,263,2,1600,1335,175,88,0,0,2
48,"Strainatate",27,,,"ET","ETIOPIA",49,"ADDIS ABEBA",0,14,0,14,0,13,1,100,86,9,4,0,0,2
48,"Strainatate",28,,,"PH","FILIPINE",50,"MANILA",0,18,0,18,0,18,0,100,82,13,5,0,0,2
48,"Strainatate",29,,,"FI","FINLANDA",51,"HELSINKI",0,248,0,248,0,245,3,803,555,172,73,0,0,2
48,"Strainatate",30,,,"FR","FRANTA",52,"PARIS",0,3785,0,3785,0,3747,29,7800,4015,3115,632,0,0,2
48,"Strainatate",30,,,"FR","FRANTA",53,"NANTES",0,260,0,260,0,257,3,1600,1340,194,63,0,0,2
48,"Strainatate",30,,,"FR","FRANTA",54,"BORDEAUX",0,235,0,235,0,233,2,1801,1566,196,37,0,0,2
48,"Strainatate",30,,,"FR","FRANTA",55,"BREST",0,59,0,59,0,58,1,1600,1541,32,26,0,0,2
48,"Strainatate",30,,,"FR","FRANTA",56,"LYON",0,480,0,480,0,473,7,1600,1120,355,118,0,0,2
48,"Strainatate",30,,,"FR","FRANTA",57,"MARSILIA",0,352,0,352,0,346,6,2500,2148,264,82,0,0,2
48,"Strainatate",30,,,"FR","FRANTA",58,"NISA",0,314,0,314,0,313,1,1200,886,207,106,0,0,2
48,"Strainatate",30,,,"FR","FRANTA",59,"TOULOUSE",0,208,0,208,0,203,5,1100,892,123,80,0,0,2
48,"Strainatate",30,,,"FR","FRANTA",60,"STRASBOURG",0,667,0,667,0,653,14,2005,1338,473,180,0,0,2
48,"Strainatate",31,,,"GE","GEORGIA",61,"TBILISI",0,30,0,30,0,29,1,200,170,10,19,0,0,2
48,"Strainatate",32,,,"DE","GERMANIA",62,"BERLIN",0,630,0,630,0,618,12,4000,3370,403,215,0,0,2
48,"Strainatate",32,,,"DE","GERMANIA",63,"HAMBURG",0,376,0,376,0,370,6,2400,2024,284,86,0,0,2
48,"Strainatate",32,,,"DE","GERMANIA",64,"BONN",0,710,0,710,0,710,0,1600,890,505,205,0,0,2
48,"Strainatate",32,,,"DE","GERMANIA",65,"MUNCHEN",0,1413,0,1413,0,1397,16,3200,1787,992,405,0,0,2
48,"Strainatate",32,,,"DE","GERMANIA",66,"STUTTGART",0,806,0,806,0,799,7,1595,789,595,204,0,0,2
48,"Strainatate",33,,,"GR","GRECIA",67,"ATENA 1",0,1534,0,1534,0,1526,8,3800,2266,1221,305,0,0,2
48,"Strainatate",33,,,"GR","GRECIA",68,"ATENA 2",0,1590,0,1590,0,1585,5,3301,1711,1316,269,0,0,2
48,"Strainatate",33,,,"GR","GRECIA",69,"SALONIC",0,220,0,220,0,218,2,601,381,150,68,0,0,2
48,"Strainatate",33,,,"GR","GRECIA",70,"LARISSA",0,157,0,157,0,155,2,500,343,114,41,0,0,2
48,"Strainatate",33,,,"GR","GRECIA",71,"SCALA-LACONIA",0,503,0,503,0,500,3,1600,1097,367,133,0,0,2
48,"Strainatate",33,,,"GR","GRECIA",72,"PYRGOS",0,86,0,86,0,86,0,400,314,67,19,0,0,2
48,"Strainatate",34,,,"IN","INDIA",73,"NEW DELHI",0,42,0,42,0,41,1,100,58,26,15,0,0,2
48,"Strainatate",35,,,"ID","INDONEZIA",74,"JAKARTA",0,19,0,19,0,18,1,100,81,9,9,0,0,2
48,"Strainatate",36,,,"JO","IORDANIA",75,"AMMAN",0,213,0,213,0,213,0,500,287,95,118,0,0,2
48,"Strainatate",37,,,"IQ","IRAK",76,"BAGDAD",0,14,0,14,0,14,0,202,188,2,12,0,0,2
48,"Strainatate",38,,,"IR","IRAN",77,"TEHERAN",0,56,0,56,0,56,0,200,144,30,26,0,0,2
48,"Strainatate",39,,,"IE","IRLANDA",78,"DUBLIN",0,2463,0,2463,0,2452,11,4800,2337,2111,341,0,0,2
48,"Strainatate",40,,,"IL","ISRAEL",79,"TEL AVIV",0,638,0,638,0,635,3,2000,1362,461,174,0,0,2
48,"Strainatate",40,,,"IL","ISRAEL",80,"HAIFA",0,290,0,290,0,290,0,1000,710,200,90,0,0,2
48,"Strainatate",40,,,"IL","ISRAEL",81,"IERUSALIM",0,266,0,266,0,265,1,1000,734,145,120,0,0,2
48,"Strainatate",41,,,"IT","ITALIA",82,"ROMA 1",0,1886,0,1886,0,1872,8,10000,8114,1503,369,0,0,2
48,"Strainatate",41,,,"IT","ITALIA",83,"ROMA 2",0,945,0,945,0,939,6,5001,4056,662,277,0,0,2
48,"Strainatate",41,,,"IT","ITALIA",84,"ROMA 3",0,1569,0,1569,0,1566,3,6000,4431,1253,313,0,0,2
48,"Strainatate",41,,,"IT","ITALIA",85,"ROMA 4",0,467,0,467,0,467,0,4000,3533,352,115,0,0,2
48,"Strainatate",41,,,"IT","ITALIA",86,"LATINA",0,901,0,901,0,888,13,6000,5099,678,210,0,0,2
48,"Strainatate",41,,,"IT","ITALIA",87,"VITERBO",0,494,0,494,0,491,3,4001,3507,338,153,0,0,2
48,"Strainatate",41,,,"IT","ITALIA",88,"MARCELLINA",0,638,0,638,0,635,3,5000,4362,453,182,0,0,2
48,"Strainatate",41,,,"IT","ITALIA",89,"LADISPOLI",0,1448,0,1448,0,1443,5,7000,5552,1161,282,0,0,2
48,"Strainatate",41,,,"IT","ITALIA",90,"TERNI",0,536,0,536,0,533,3,5000,4464,369,164,0,0,2
48,"Strainatate",41,,,"IT","ITALIA",91,"PESCARA",0,497,0,497,0,495,2,5000,4503,373,122,0,0,2
48,"Strainatate",41,,,"IT","ITALIA",92,"REGGIO CALABRIA",0,213,0,213,0,211,2,1000,787,148,63,0,0,2
48,"Strainatate",41,,,"IT","ITALIA",93,"COSENZA",0,98,0,98,0,98,0,1000,902,68,30,0,0,2
48,"Strainatate",41,,,"IT","ITALIA",94,"OLBIA-SARDEGNA",0,546,0,546,0,543,3,5000,4454,428,115,0,0,2
48,"Strainatate",41,,,"IT","ITALIA",95,"ANCONA",0,627,0,627,0,626,1,2502,1875,464,162,0,0,2
48,"Strainatate",41,,,"IT","ITALIA",96,"NAPOLI",0,105,0,105,0,104,1,3001,2896,65,39,0,0,2
48,"Strainatate",41,,,"IT","ITALIA",97,"BARI",0,280,0,280,0,278,2,3001,2721,187,91,0,0,2
48,"Strainatate",41,,,"IT","ITALIA",98,"CATANIA",0,529,0,529,0,525,4,4001,3472,377,148,0,0,2
48,"Strainatate",41,,,"IT","ITALIA",99,"MILANO",0,2034,0,2034,0,2031,3,4200,2166,1604,427,0,0,2
48,"Strainatate",41,,,"IT","ITALIA",100,"PIACENZA",0,848,0,848,0,846,2,2200,1352,700,146,0,0,2
48,"Strainatate",41,,,"IT","ITALIA",101,"ASTI",0,553,0,553,0,553,0,1600,1047,423,130,0,0,2
48,"Strainatate",41,,,"IT","ITALIA",102,"LODI",0,708,0,708,0,702,6,2000,1292,591,111,0,0,2
48,"Strainatate",41,,,"IT","ITALIA",103,"NOVARA",0,321,0,321,0,318,3,1600,1279,224,94,0,0,2
48,"Strainatate",41,,,"IT","ITALIA",104,"RIMINI",0,739,0,739,0,738,1,2000,1261,632,106,0,0,2
48,"Strainatate",41,,,"IT","ITALIA",105,"LIVORNO",0,485,0,485,0,483,2,2000,1515,399,84,0,0,2
48,"Strainatate",41,,,"IT","ITALIA",106,"GROSETTO",0,411,0,411,0,409,2,2000,1589,270,139,0,0,2
48,"Strainatate",41,,,"IT","ITALIA",107,"FERMO",0,161,0,161,0,160,1,2001,1840,126,34,0,0,2
48,"Strainatate",41,,,"IT","ITALIA",108,"TORINO",0,1781,0,1781,0,1780,1,8396,6615,1531,249,0,0,2
48,"Strainatate",41,,,"IT","ITALIA",109,"GENOVA",0,443,0,443,0,442,1,1600,1157,300,142,0,0,2
48,"Strainatate",41,,,"IT","ITALIA",110,"TREVISO",0,1427,0,1427,0,1425,2,3201,1774,1122,303,0,0,2
48,"Strainatate",41,,,"IT","ITALIA",111,"PADOVA",0,1788,0,1788,0,1776,12,3201,1413,1406,370,0,0,2
48,"Strainatate",41,,,"IT","ITALIA",112,"TRENTO",0,734,0,734,0,729,5,5000,4266,554,175,0,0,2
48,"Strainatate",41,,,"IT","ITALIA",113,"TRIESTE",0,412,0,412,0,411,1,4801,4389,247,164,0,0,2
48,"Strainatate",41,,,"IT","ITALIA",114,"BOLOGNA",0,1590,0,1590,0,1580,10,3000,1410,1224,356,0,0,2
48,"Strainatate",41,,,"IT","ITALIA",115,"FLORENTA",0,1367,0,1367,0,1366,1,3000,1633,1067,299,0,0,2
48,"Strainatate",41,,,"IT","ITALIA",116,"BRESCIA",0,1194,0,1194,0,1192,2,3300,2106,980,212,0,0,2
48,"Strainatate",41,,,"IT","ITALIA",117,"CUNEO",0,477,0,477,0,477,0,1600,1123,346,131,0,0,2
48,"Strainatate",41,,,"IT","ITALIA",118,"VICENZA",0,598,0,598,0,598,0,1600,1002,486,112,0,0,2
48,"Strainatate",41,,,"IT","ITALIA",119,"COMO",0,303,0,303,0,301,2,1000,697,228,73,0,0,2
48,"Strainatate",41,,,"IT","ITALIA",120,"BERGAMO",0,939,0,939,0,937,2,2000,1061,755,182,0,0,2
48,"Strainatate",41,,,"IT","ITALIA",121,"VARESE",0,350,0,350,0,348,2,1500,1150,264,84,0,0,2
48,"Strainatate",41,,,"IT","ITALIA",122,"SONDRIO",0,38,0,38,0,38,0,1000,962,24,14,0,0,2
48,"Strainatate",41,,,"IT","ITALIA",123,"LECCO",0,248,0,248,0,248,0,1000,752,196,52,0,0,2
48,"Strainatate",41,,,"IT","ITALIA",124,"UDINE",0,967,0,967,0,962,5,1600,633,747,215,0,0,2
48,"Strainatate",41,,,"IT","ITALIA",125,"PORDENONE",0,1225,0,1225,0,1222,3,3201,1976,897,325,0,0,2
48,"Strainatate",41,,,"IT","ITALIA",126,"VERONA",0,1445,0,1445,0,1440,5,3201,1756,1170,270,0,0,2
48,"Strainatate",41,,,"IT","ITALIA",127,"VENETIA",0,449,0,449,0,446,3,1601,1152,306,140,0,0,2
48,"Strainatate",41,,,"IT","ITALIA",128,"ALESSANDRIA",0,784,0,784,0,780,4,1600,816,633,147,0,0,2
48,"Strainatate",41,,,"IT","ITALIA",129,"AREZZO",0,948,0,948,0,945,3,3000,2052,725,220,0,0,2
48,"Strainatate",41,,,"IT","ITALIA",130,"PERUGIA",0,516,0,516,0,515,1,4000,3484,392,123,0,0,2
48,"Strainatate",41,,,"IT","ITALIA",131,"ACILIA",0,1002,0,1002,0,999,3,5000,3998,802,197,0,0,2
48,"Strainatate",41,,,"IT","ITALIA",132,"ROMA 5",0,821,0,821,0,814,7,6000,5179,607,207,0,0,2
48,"Strainatate",41,,,"IT","ITALIA",133,"FONTE NUOVA",0,875,0,875,0,875,0,5000,4125,716,159,0,0,2
48,"Strainatate",41,,,"IT","ITALIA",134,"GUIDONIA",0,852,0,852,0,851,1,6000,5148,654,197,0,0,2
48,"Strainatate",41,,,"IT","ITALIA",135,"IVREA",0,604,0,604,0,599,5,1600,996,467,132,0,0,2
48,"Strainatate",41,,,"IT","ITALIA",136,"SEZZE",0,460,0,460,0,459,1,6000,5540,364,95,0,0,2
48,"Strainatate",42,,,"JP","JAPONIA",137,"TOKYO",0,80,0,80,0,76,4,300,220,49,27,0,0,2
48,"Strainatate",43,,,"KZ","KAZAHSTAN",138,"ASTANA",0,10,0,10,0,10,0,101,91,7,3,0,0,2
48,"Strainatate",44,,,"KW","KUWEIT",139,"KUWEIT",0,145,0,145,0,145,0,500,355,93,52,0,0,2
48,"Strainatate",45,,,"LB","LIBAN",140,"BEIRUT",0,123,0,123,0,122,1,400,277,63,59,0,0,2
48,"Strainatate",46,,,"LY","LIBIA",141,"TRIPOLI",0,75,0,75,0,75,0,300,225,40,35,0,0,2
48,"Strainatate",47,,,"LT","LITUANIA",142,"VILNIUS",0,16,0,16,0,16,0,100,84,10,6,0,0,2
48,"Strainatate",48,,,"LU","LUXEMBURG",143,"LUXEMBURG",0,601,0,601,0,593,8,2000,1399,414,179,0,0,2
48,"Strainatate",49,,,"MK","MACEDONIA",144,"SKOPJE",0,37,0,37,0,37,0,200,163,12,25,0,0,2
48,"Strainatate",50,,,"MY","MALAEZIA",145,"KUALA LUMPUR",0,43,0,43,0,43,0,300,257,23,20,0,0,2
48,"Strainatate",51,,,"MT","MALTA",146,"VALLETTA",0,55,0,55,0,55,0,1000,945,46,9,0,0,2
48,"Strainatate",52,,,"GB","MAREA BRITANIE",147,"LONDRA 1",0,1109,0,1109,0,1099,10,3200,2091,826,273,0,0,2
48,"Strainatate",52,,,"GB","MAREA BRITANIE",148,"LONDRA 2",0,1487,0,1487,0,1470,17,3200,1713,1179,291,0,0,2
48,"Strainatate",52,,,"GB","MAREA BRITANIE",149,"LONDRA 3",0,2573,0,2573,0,2569,4,3200,627,2121,448,0,0,2
48,"Strainatate",52,,,"GB","MAREA BRITANIE",150,"CANTERBURY",0,198,0,198,0,197,1,1000,802,130,67,0,0,2
48,"Strainatate",52,,,"GB","MAREA BRITANIE",151,"CARDIFF",0,76,0,76,0,75,1,502,426,53,22,0,0,2
48,"Strainatate",52,,,"GB","MAREA BRITANIE",152,"LEEDS",0,165,0,165,0,159,6,550,385,125,34,0,0,2
48,"Strainatate",52,,,"GB","MAREA BRITANIE",153,"BIRMINGHAM",0,255,0,255,0,253,2,2093,1838,167,86,0,0,2
48,"Strainatate",52,,,"GB","MAREA BRITANIE",154,"GLASGOW",0,141,0,141,0,137,4,500,359,100,37,0,0,2
48,"Strainatate",53,,,"MA","MAROC",155,"RABAT",0,88,0,88,0,86,2,500,412,39,47,0,0,2
48,"Strainatate",54,,,"MX","MEXIC",156,"MEXICO CITY",0,35,0,35,0,35,0,200,165,19,16,0,0,2
48,"Strainatate",55,,,"ME","MUNTENEGRU",157,"PODGORITA",0,8,0,8,0,8,0,200,192,2,6,0,0,2
48,"Strainatate",56,,,"NG","NIGERIA",158,"ABUJA",0,22,0,22,0,22,0,200,178,14,8,0,0,2
48,"Strainatate",56,,,"NG","NIGERIA",159,"LAGOS",0,45,0,45,0,45,0,200,155,33,12,0,0,2
48,"Strainatate",57,,,"NO","NORVEGIA",160,"OSLO",0,256,0,256,0,251,5,1000,744,173,78,0,0,2
48,"Strainatate",58,,,"NL","OLANDA",161,"HAGA 1",0,451,0,451,0,448,3,1601,1150,326,122,0,0,2
48,"Strainatate",58,,,"NL","OLANDA",162,"HAGA 2",0,289,0,289,0,287,2,1601,1311,193,94,0,0,2
48,"Strainatate",59,,,"PK","PAKISTAN",163,"ISLAMABAD",0,13,0,13,0,13,0,200,187,4,9,0,0,2
48,"Strainatate",60,,,"PE","PERU",164,"LIMA",0,26,0,26,0,25,1,200,174,15,10,0,0,2
48,"Strainatate",61,,,"PL","POLONIA",165,"VARSOVIA",0,119,0,119,0,117,2,499,380,58,59,0,0,2
48,"Strainatate",62,,,"PT","PORTUGALIA",166,"LISABONA",0,874,0,874,0,858,16,2401,1527,673,185,0,0,2
48,"Strainatate",62,,,"PT","PORTUGALIA",167,"PORTO",0,71,0,71,0,68,3,500,429,48,20,0,0,2
48,"Strainatate",62,,,"PT","PORTUGALIA",168,"ALMANCIL",0,755,0,755,0,748,7,1900,1145,580,168,0,0,2
48,"Strainatate",63,,,"QA","QATAR",169,"DOHA",0,168,0,168,0,167,1,500,332,131,36,0,0,2
48,"Strainatate",64,,,"KR","REP. COREEA",170,"SEUL",0,35,0,35,0,35,0,200,165,24,11,0,0,2
48,"Strainatate",65,,,"MD","REP. MOLDOVA",171,"CHISINAU 1",0,2349,0,2349,0,2339,10,5820,3471,2196,143,0,0,2
48,"Strainatate",65,,,"MD","REP. MOLDOVA",172,"CHISINAU 2",0,2532,0,2532,0,2502,30,6000,3468,2388,114,0,0,2
48,"Strainatate",65,,,"MD","REP. MOLDOVA",173,"CHISINAU 3",0,1691,0,1691,0,1687,4,4000,2309,1631,56,0,0,2
48,"Strainatate",65,,,"MD","REP. MOLDOVA",174,"CHISINAU 4",0,1422,0,1422,0,1421,1,5000,3578,1379,42,0,0,2
48,"Strainatate",65,,,"MD","REP. MOLDOVA",175,"ORHEI",0,892,0,892,0,892,0,5001,4109,839,53,0,0,2
48,"Strainatate",65,,,"MD","REP. MOLDOVA",176,"NISPORENI",0,313,0,313,0,313,0,3000,2687,292,21,0,0,2
48,"Strainatate",65,,,"MD","REP. MOLDOVA",177,"UNGHENI",0,396,0,396,0,394,2,3001,2605,361,33,0,0,2
48,"Strainatate",65,,,"MD","REP. MOLDOVA",178,"BALTI",0,931,0,931,0,929,2,5001,4070,864,65,0,0,2
48,"Strainatate",65,,,"MD","REP. MOLDOVA",179,"CAHUL",0,532,0,532,0,531,1,3001,2469,497,34,0,0,2
48,"Strainatate",65,,,"MD","REP. MOLDOVA",180,"GIURGIULESTI",0,174,0,174,0,174,0,3004,2830,170,4,0,0,2
48,"Strainatate",65,,,"MD","REP. MOLDOVA",181,"ANENII NOI",0,483,0,483,0,483,0,3001,2518,464,19,0,0,2
48,"Strainatate",65,,,"MD","REP. MOLDOVA",182,"CAUSENI",0,275,0,275,0,272,3,3001,2726,246,26,0,0,2
48,"Strainatate",65,,,"MD","REP. MOLDOVA",183,"SOROCA",0,267,0,267,0,267,0,3001,2734,245,22,0,0,2
48,"Strainatate",66,,,"CN","REP. POPULARA CHINEZA",184,"BEIJING",0,94,0,94,0,91,3,280,186,46,45,0,0,2
48,"Strainatate",66,,,"CN","REP. POPULARA CHINEZA",185,"HONG KONG",0,25,0,25,0,25,0,300,275,15,10,0,0,2
48,"Strainatate",66,,,"CN","REP. POPULARA CHINEZA",186,"SHANGHAI",0,56,0,56,0,56,0,300,244,38,18,0,0,2
48,"Strainatate",67,,,"KP","RPD COREEANA",187,"PHENIAN",0,8,0,8,0,8,0,20,12,5,3,0,0,2
48,"Strainatate",68,,,"RU","RUSIA",188,"MOSCOVA",0,120,0,120,0,119,1,1000,880,59,60,0,0,2
48,"Strainatate",68,,,"RU","RUSIA",189,"SANKT PETERSBURG",0,17,0,17,0,16,1,199,182,5,11,0,0,2
48,"Strainatate",68,,,"RU","RUSIA",190,"ROSTOV PE DON",0,7,0,7,0,7,0,200,193,0,7,0,0,2
48,"Strainatate",69,,,"SM","SAN MARINO",191,"SAN MARINO",0,121,0,121,0,120,1,1000,879,93,27,0,0,2
48,"Strainatate",70,,,"US","S.U.A.",192,"WASHINGTON",0,449,0,449,0,444,5,2100,1651,331,113,0,0,2
48,"Strainatate",70,,,"US","S.U.A.",193,"ATLANTA",0,413,0,413,0,411,2,1600,1187,332,79,0,0,2
48,"Strainatate",70,,,"US","S.U.A.",194,"CHARLOTTE",0,107,0,107,0,107,0,600,493,89,18,0,0,2
48,"Strainatate",70,,,"US","S.U.A.",195,"HOLLYWOOD",0,397,0,397,0,396,1,1500,1103,324,72,0,0,2
48,"Strainatate",70,,,"US","S.U.A.",196,"DALLAS",0,112,0,112,0,112,0,600,488,91,21,0,0,2
48,"Strainatate",70,,,"US","S.U.A.",197,"HOUSTON",0,196,0,196,0,196,0,800,604,148,48,0,0,2
48,"Strainatate",70,,,"US","S.U.A.",198,"NORFOLK",0,57,0,57,0,57,0,300,243,31,26,0,0,2
48,"Strainatate",70,,,"US","S.U.A.",199,"NILES",0,284,0,284,0,282,2,1600,1316,242,40,0,0,2
48,"Strainatate",70,,,"US","S.U.A.",200,"MINNEAPOLIS",0,56,0,56,0,56,0,801,745,45,11,0,0,2
48,"Strainatate",70,,,"US","S.U.A.",201,"CLEVELAND",0,284,0,284,0,282,2,1601,1317,224,58,0,0,2
48,"Strainatate",70,,,"US","S.U.A.",202,"LAROSE",0,75,0,75,0,75,0,500,425,41,34,0,0,2
48,"Strainatate",70,,,"US","S.U.A.",203,"NEW YORK",0,1155,0,1155,0,1150,5,3245,2090,899,251,0,0,2
48,"Strainatate",70,,,"US","S.U.A.",204,"PHILADELPHIA",0,165,0,165,0,165,0,500,335,127,38,0,0,2
48,"Strainatate",70,,,"US","S.U.A.",205,"BOSTON",0,304,0,304,0,299,5,601,297,202,97,0,0,2
48,"Strainatate",70,,,"US","S.U.A.",206,"BRIDGEPORT",0,157,0,157,0,157,0,400,243,120,37,0,0,2
48,"Strainatate",70,,,"US","S.U.A.",207,"LOS ANGELES",0,321,0,321,0,321,0,3692,3371,264,57,0,0,2
48,"Strainatate",70,,,"US","S.U.A.",208,"SEATTLE",0,484,0,484,0,480,4,2000,1516,420,60,0,0,2
48,"Strainatate",70,,,"US","S.U.A.",209,"PORTLAND",0,349,0,349,0,348,1,2000,1651,285,63,0,0,2
48,"Strainatate",70,,,"US","S.U.A.",210,"SAN FRANCISCO",0,347,0,347,0,347,0,1000,653,273,74,0,0,2
48,"Strainatate",70,,,"US","S.U.A.",211,"SACRAMENTO",0,216,0,216,0,216,0,1000,784,195,21,0,0,2
48,"Strainatate",70,,,"US","S.U.A.",212,"ORANGE COUNTY",0,369,0,369,0,369,0,2100,1731,323,46,0,0,2
48,"Strainatate",70,,,"US","S.U.A.",213,"LAS VEGAS",0,92,0,92,0,92,0,600,508,75,17,0,0,2
48,"Strainatate",70,,,"US","S.U.A.",214,"PHOENIX",0,268,0,268,0,267,1,2000,1732,230,37,0,0,2
48,"Strainatate",70,,,"US","S.U.A.",215,"CHICAGO 1",0,281,0,281,0,279,2,3200,2919,216,63,0,0,2
48,"Strainatate",70,,,"US","S.U.A.",216,"CHICAGO 2",0,330,0,330,0,330,0,1600,1270,249,81,0,0,2
48,"Strainatate",70,,,"US","S.U.A.",217,"CHICAGO 3",0,136,0,136,0,136,0,801,665,112,24,0,0,2
48,"Strainatate",70,,,"US","S.U.A.",218,"CHICAGO 4",0,519,0,519,0,519,0,1600,1081,399,120,0,0,2
48,"Strainatate",70,,,"US","S.U.A.",219,"DETROIT",0,590,0,590,0,589,1,1600,1010,517,72,0,0,2
48,"Strainatate",71,,,"SN","SENEGAL",220,"DAKAR",0,19,0,19,0,18,1,200,181,12,6,0,0,2
48,"Strainatate",72,,,"RS","SERBIA",221,"BELGRAD",0,80,0,80,0,77,3,500,420,46,31,0,0,2
48,"Strainatate",72,,,"RS","SERBIA",222,"VARSET",0,64,0,64,0,64,0,400,336,40,24,0,0,2
48,"Strainatate",73,,,"SG","SINGAPORE",223,"SINGAPORE",0,79,0,79,0,75,4,303,224,44,31,0,0,2
48,"Strainatate",74,,,"SY","SIRIA",224,"DAMASC",0,83,0,83,0,82,1,496,413,39,43,0,0,2
48,"Strainatate",74,,,"SY","SIRIA",225,"ALEP",0,47,0,47,0,47,0,200,153,23,24,0,0,2
48,"Strainatate",75,,,"SK","SLOVACIA",226,"BRATISLAVA",0,73,0,73,0,71,2,400,327,34,37,0,0,2
48,"Strainatate",76,,,"SI","SLOVENIA",227,"LJUBLJANA",0,51,0,51,0,49,2,300,249,27,22,0,0,2
48,"Strainatate",77,,,"ES","SPANIA",228,"MADRID 1",0,1562,0,1562,0,1559,3,8000,6438,1235,324,0,0,2
48,"Strainatate",77,,,"ES","SPANIA",229,"MADRID 2",0,1466,0,1466,0,1459,7,8000,6534,1155,304,0,0,2
48,"Strainatate",77,,,"ES","SPANIA",230,"BILBAO",0,757,0,757,0,752,5,4801,4044,608,144,0,0,2
48,"Strainatate",77,,,"ES","SPANIA",231,"CIUDAD REAL",0,283,0,283,0,281,2,4801,4518,221,60,0,0,2
48,"Strainatate",77,,,"ES","SPANIA",232,"ROQUETAS DE MAR",0,1874,0,1874,0,1869,5,4800,2926,1585,284,0,0,2
48,"Strainatate",77,,,"ES","SPANIA",233,"ALMERIA",0,327,0,327,0,327,0,4800,4473,274,53,0,0,2
48,"Strainatate",77,,,"ES","SPANIA",234,"BARCELONA",0,1471,0,1471,0,1462,9,5000,3529,1161,301,0,0,2
48,"Strainatate",77,,,"ES","SPANIA",235,"ALCAZAR DE SAN JUAN",0,1099,0,1099,0,1097,2,3201,2102,944,153,0,0,2
48,"Strainatate",77,,,"ES","SPANIA",236,"SANTIAGO DE COMPOSTELA",0,85,0,85,0,84,1,1701,1616,58,26,0,0,2
48,"Strainatate",77,,,"ES","SPANIA",237,"CUENCA",0,540,0,540,0,540,0,3201,2661,447,93,0,0,2
48,"Strainatate",77,,,"ES","SPANIA",238,"GUADALAJARA",0,838,0,838,0,831,7,3201,2363,650,181,0,0,2
48,"Strainatate",77,,,"ES","SPANIA",239,"TOLEDO",0,904,0,904,0,903,1,3201,2297,730,173,0,0,2
48,"Strainatate",77,,,"ES","SPANIA",240,"BADAJOZ",0,81,0,81,0,81,0,1801,1720,72,9,0,0,2
48,"Strainatate",77,,,"ES","SPANIA",241,"GIRONA",0,814,0,814,0,810,4,3400,2586,700,110,0,0,2
48,"Strainatate",77,,,"ES","SPANIA",242,"CORDOBA",0,97,0,97,0,97,0,3200,3103,79,18,0,0,2
48,"Strainatate",77,,,"ES","SPANIA",243,"GRANADA",0,201,0,201,0,197,4,3200,2999,163,34,0,0,2
48,"Strainatate",77,,,"ES","SPANIA",244,"HUESCA",0,403,0,403,0,402,1,3200,2797,336,66,0,0,2
48,"Strainatate",77,,,"ES","SPANIA",245,"ALBACETE",0,353,0,353,0,353,0,3201,2848,276,77,0,0,2
48,"Strainatate",77,,,"ES","SPANIA",246,"ZARAGOZA",0,2329,0,2329,0,2320,9,5800,3471,1900,420,0,0,2
48,"Strainatate",77,,,"ES","SPANIA",247,"SEVILLA",0,359,0,359,0,359,0,4800,4441,268,91,0,0,2
48,"Strainatate",77,,,"ES","SPANIA",248,"CASTELLON DE LA PLANA 1",0,2452,0,2452,0,2430,22,4001,1549,1966,464,0,0,2
48,"Strainatate",77,,,"ES","SPANIA",249,"CASTELLON DE LA PLANA 2",0,1798,0,1798,0,1793,5,4001,2203,1426,367,0,0,2
48,"Strainatate",77,,,"ES","SPANIA",250,"ALCALA DE HENARES",0,2041,0,2041,0,2040,1,3201,1160,1726,314,0,0,2
48,"Strainatate",77,,,"ES","SPANIA",251,"COSLADA",0,2632,0,2632,0,2623,9,3200,568,2048,575,0,0,2
48,"Strainatate",77,,,"ES","SPANIA",252,"VALENCIA",0,1454,0,1454,0,1441,13,3200,1746,1172,269,0,0,2
48,"Strainatate",77,,,"ES","SPANIA",253,"TORREJON DE ARDOZ",0,1764,0,1764,0,1763,1,3201,1437,1463,300,0,0,2
48,"Strainatate",77,,,"ES","SPANIA",254,"LAS PALMAS DE GRAN CANARIA",0,70,0,70,0,70,0,1700,1630,48,22,0,0,2
48,"Strainatate",77,,,"ES","SPANIA",255,"PALMA DE MALLORCA",0,539,0,539,0,538,1,2000,1461,415,123,0,0,2
48,"Strainatate",77,,,"ES","SPANIA",256,"ALICANTE",0,823,0,823,0,813,10,3200,2377,668,145,0,0,2
48,"Strainatate",77,,,"ES","SPANIA",257,"TARRAGONA",0,1023,0,1023,0,1016,7,2000,977,807,209,0,0,2
48,"Strainatate",77,,,"ES","SPANIA",258,"GIJON",0,195,0,195,0,194,1,3201,3006,142,52,0,0,2
48,"Strainatate",77,,,"ES","SPANIA",259,"LERIDA",0,1193,0,1193,0,1191,2,2000,807,1006,185,0,0,2
48,"Strainatate",77,,,"ES","SPANIA",260,"LEPE",0,291,0,291,0,290,1,4800,4509,212,78,0,0,2
48,"Strainatate",77,,,"ES","SPANIA",261,"GETAFE",0,1335,0,1335,0,1332,3,3201,1866,1124,208,0,0,2
48,"Strainatate",77,,,"ES","SPANIA",262,"MURCIA",0,366,0,366,0,365,1,3200,2834,290,75,0,0,2
48,"Strainatate",77,,,"ES","SPANIA",263,"MALAGA",0,396,0,396,0,396,0,4800,4404,317,79,0,0,2
48,"Strainatate",77,,,"ES","SPANIA",264,"LOGRONO",0,1178,0,1178,0,1175,3,3200,2022,890,285,0,0,2
48,"Strainatate",77,,,"ES","SPANIA",265,"BURGOS",0,518,0,518,0,518,0,3200,2682,431,87,0,0,2
48,"Strainatate",78,,,"LK","SRI LANKA",266,"COLOMBO",0,7,0,7,0,7,0,200,193,2,5,0,0,2
48,"Strainatate",79,,,"SD","SUDAN",267,"KHARTOUM",0,14,0,14,0,13,1,200,186,6,7,0,0,2
48,"Strainatate",80,,,"SE","SUEDIA",268,"STOCKHOLM",0,319,0,319,0,315,4,2000,1681,209,106,0,0,2
48,"Strainatate",80,,,"SE","SUEDIA",269,"MALMO",0,129,0,129,0,128,1,1000,871,101,27,0,0,2
48,"Strainatate",81,,,"TH","THAILANDA",270,"BANGKOK",0,31,0,31,0,30,1,200,169,10,20,0,0,2
48,"Strainatate",82,,,"TN","TUNISIA",271,"TUNIS",0,60,0,60,0,60,0,300,240,20,40,0,0,2
48,"Strainatate",83,,,"TR","TURCIA",272,"ANKARA",0,52,0,52,0,51,1,1000,948,28,23,0,0,2
48,"Strainatate",83,,,"TR","TURCIA",273,"ISTANBUL",0,147,0,147,0,147,0,1600,1453,77,70,0,0,2
48,"Strainatate",83,,,"TR","TURCIA",274,"IZMIR",0,42,0,42,0,42,0,1000,958,14,28,0,0,2
48,"Strainatate",84,,,"TM","TURKMENISTAN",275,"ASHGABAT",0,27,0,27,0,27,0,100,73,15,12,0,0,2
48,"Strainatate",85,,,"UA","UCRAINA",276,"KIEV",0,57,0,57,0,57,0,501,444,29,28,0,0,2
48,"Strainatate",85,,,"UA","UCRAINA",277,"CERNAUTI",0,36,0,36,0,34,2,1001,965,25,9,0,0,2
48,"Strainatate",85,,,"UA","UCRAINA",278,"ODESSA",0,19,0,19,0,19,0,500,481,9,10,0,0,2
48,"Strainatate",86,,,"HU","UNGARIA",279,"BUDAPESTA 1",0,648,0,648,0,642,6,5000,4352,393,249,0,0,2
48,"Strainatate",86,,,"HU","UNGARIA",280,"BUDAPESTA 2",0,194,0,194,0,184,10,5000,4806,107,77,0,0,2
48,"Strainatate",86,,,"HU","UNGARIA",281,"GYULA",0,54,0,54,0,54,0,499,445,31,23,0,0,2
48,"Strainatate",86,,,"HU","UNGARIA",282,"SZEGED",0,112,0,112,0,110,2,500,388,53,57,0,0,2
48,"Strainatate",87,,,"UY","URUGUAY",283,"MONTEVIDEO",0,22,0,22,0,22,0,200,178,12,10,0,0,2
48,"Strainatate",88,,,"UZ","UZBEKISTAN",284,"TASKENT",0,8,0,8,0,8,0,100,92,1,7,0,0,2
48,"Strainatate",89,,,"VE","VENEZUELA",285,"CARACAS",0,83,0,83,0,83,0,200,117,33,50,0,0,2
48,"Strainatate",90,,,"VN","VIETNAM",286,"HANOI",0,15,0,15,0,15,0,200,185,13,2,0,0,2
48,"Strainatate",90,,,"VN","VIETNAM",287,"QUANG NGAI",0,2,0,2,0,2,0,200,198,1,1,0,0,2
48,"Strainatate",91,,,"ZW","ZIMBABWE",288,"HARARE",0,10,0,10,0,10,0,100,90,9,1,0,0,2
48,"Strainatate",92,,,"NZ","NOUA ZEELANDA",289,"AUCKLAND",0,175,0,175,0,170,5,700,525,114,56,0,0,2
48,"Strainatate",93,,,"XK","Teatrul de operatiuni KOSOVO",290,"PEC",0,148,0,148,0,147,1,400,252,60,87,0,0,2
48,"Strainatate",93,,,"XK","Teatrul de operatiuni KOSOVO",291,"PRISTINA",0,145,0,145,0,145,0,400,255,80,65,0,0,2
48,"Strainatate",94,,,"AF","Teatrul de operatiuni AFGANISTAN",292,"KABUL",0,65,0,65,0,63,2,160,95,26,37,0,0,2
48,"Strainatate",94,,,"AF","Teatrul de operatiuni AFGANISTAN",293,"KANDAHAR",0,59,0,59,0,58,1,120,61,23,35,0,0,2
48,"Strainatate",94,,,"AF","Teatrul de operatiuni AFGANISTAN",294,"ZABUL",0,602,0,602,0,588,14,956,354,252,336,0,0,2
