"Cod Birou Electoral","Judet","CountyId","LocalityId","CountryId","SV","Adresa","Mediu","Sortare","Localitate","SIRUTA","Numărul total al alegătorilor înscrişi în listele electorale permanente","Numărul total al alegătorilor care s-au prezentat la urne","Numărul total al alegătorilor care s-au prezentat la urne, înscrişi în copiile de pe listele electorale permanente","Numărul total al alegătorilor care au votat în altă secţie de votare decât cea în care au fost arondaţi conform domiciliului","Numărul total al alegătorilor care au votat utilizând urna specială","Numărul total al voturilor valabil exprimate","Numărul total al voturilor nule","Numărul buletinelor de vot primite","Numărul buletinelor de vot neîntrebuinţate şi anulate","VICTOR-VIOREL PONTA","KLAUS-WERNER IOHANNIS"
1,"ALBA",10,1017,,1,"ALBA IULIA / Centrul de zi pentru persoane vârstnice",1,2,"MUNICIPIUL ALBA IULIA",1017,1543,1066,1008,58,0,1057,9,1701,635,328,729
1,"ALBA",10,1017,,2,"ALBA IULIA / Şcoala gimnazială ""Vasile Goldiş""",1,2,"MUNICIPIUL ALBA IULIA",1017,1117,768,698,69,1,758,10,1235,467,227,531
1,"ALBA",10,1017,,3,"ALBA IULIA / Şcoală gimnazială ""Avram Iancu""",1,2,"MUNICIPIUL ALBA IULIA",1017,1346,963,880,65,18,946,17,1488,525,331,615
1,"ALBA",10,1017,,4,"ALBA IULIA / Şcoala gimnazială ""Vasile Goldiş""",1,2,"MUNICIPIUL ALBA IULIA",1017,1465,964,917,46,1,957,7,1613,649,337,620
1,"ALBA",10,1017,,5,"ALBA IULIA / Casa de cultură a studenţilor",1,2,"MUNICIPIUL ALBA IULIA",1017,711,566,431,134,1,557,9,784,218,166,391
1,"ALBA",10,1017,,6,"ALBA IULIA / Şcoală gimnazială ""Avram Iancu""",1,2,"MUNICIPIUL ALBA IULIA",1017,903,631,574,56,1,621,10,991,360,159,462
1,"ALBA",10,1017,,7,"ALBA IULIA / Colegiul Economic""Dionisie Pop Marţian""",1,2,"MUNICIPIUL ALBA IULIA",1017,1271,1024,907,91,26,1016,8,1381,357,283,733
1,"ALBA",10,1017,,8,"ALBA IULIA / Colegiul Naţional ""Horea Cloşca şi Crişan""",1,2,"MUNICIPIUL ALBA IULIA",1017,1143,871,717,111,43,855,16,1257,386,303,552
1,"ALBA",10,1017,,9,"ALBA IULIA / Colegiul Naţional ""Horea Cloşca şi Crişan""",1,2,"MUNICIPIUL ALBA IULIA",1017,1539,1176,1074,102,0,1164,12,1691,515,372,792
1,"ALBA",10,1017,,10,"ALBA IULIA / Colegiul Naţional ""Horea Cloşca şi Crişan""",1,2,"MUNICIPIUL ALBA IULIA",1017,1523,1039,898,141,0,1021,18,1679,640,325,696
1,"ALBA",10,1017,,11,"ALBA IULIA / COLEGIUL TEHNIC ""APULUM""",1,2,"MUNICIPIUL ALBA IULIA",1017,1257,776,711,65,0,769,7,1382,606,214,555
1,"ALBA",10,1017,,12,"ALBA IULIA / Colegiul Naţional ""Horea Cloşca şi Crişan""",1,2,"MUNICIPIUL ALBA IULIA",1017,1051,727,576,151,0,720,7,1167,440,170,550
1,"ALBA",10,1017,,13,"ALBA IULIA / Colegiul Tehnic ""Apulum""",1,2,"MUNICIPIUL ALBA IULIA",1017,1083,628,590,38,0,623,5,1190,562,180,443
1,"ALBA",10,1017,,14,"ALBA IULIA / Grădiniţa cu program prelungit nr.9",1,2,"MUNICIPIUL ALBA IULIA",1017,1447,926,768,157,1,919,7,1621,695,241,678
1,"ALBA",10,1017,,15,"ALBA IULIA / Colegiul Tehnic ""Apulum""",1,2,"MUNICIPIUL ALBA IULIA",1017,1167,674,609,65,0,664,10,1282,608,199,465
1,"ALBA",10,1017,,16,"ALBA IULIA / Cinematograful ""Dacia""",1,2,"MUNICIPIUL ALBA IULIA",1017,1437,1326,874,274,178,1306,20,1575,249,381,925
1,"ALBA",10,1017,,17,"ALBA IULIA / Şcoala gimnazială""Ion Agârbiceanu""",1,2,"MUNICIPIUL ALBA IULIA",1017,1020,744,626,118,0,734,10,1114,370,233,501
1,"ALBA",10,1017,,18,"ALBA IULIA / Şcoala gimnazială""Ion Agârbiceanu""",1,2,"MUNICIPIUL ALBA IULIA",1017,959,714,626,83,5,703,11,1060,346,240,463
1,"ALBA",10,1017,,19,"ALBA IULIA / Grădiniţa cu program prelungit nr.11",1,2,"MUNICIPIUL ALBA IULIA",1017,1433,897,744,153,0,886,11,1579,682,242,644
1,"ALBA",10,1017,,20,"ALBA IULIA / Grădiniţa cu program prelungit nr.12",1,2,"MUNICIPIUL ALBA IULIA",1017,1160,708,674,34,0,699,9,1278,570,228,471
1,"ALBA",10,1017,,21,"ALBA IULIA / Grădiniţa cu program prelungit nr.12",1,2,"MUNICIPIUL ALBA IULIA",1017,1102,773,695,78,0,766,7,1212,439,240,526
1,"ALBA",10,1017,,22,"ALBA IULIA / Şcoala gimnazială ""Mihai Eminescu""",1,2,"MUNICIPIUL ALBA IULIA",1017,1352,1015,883,131,1,1011,4,1495,480,291,720
1,"ALBA",10,1017,,23,"ALBA IULIA / Şcoala gimnazială ""Mihai Eminescu""",1,2,"MUNICIPIUL ALBA IULIA",1017,1614,1131,1015,116,0,1117,14,1769,638,290,827
1,"ALBA",10,1017,,24,"ALBA IULIA / Grădiniţa cu program prelungit nr.13",1,2,"MUNICIPIUL ALBA IULIA",1017,1158,766,709,57,0,753,13,1278,512,199,554
1,"ALBA",10,1017,,25,"ALBA IULIA / Grădiniţa cu program prelungit nr.13",1,2,"MUNICIPIUL ALBA IULIA",1017,1306,853,800,53,0,848,5,1439,586,252,596
1,"ALBA",10,1017,,26,"ALBA IULIA / Liceul cu program sportiv",1,2,"MUNICIPIUL ALBA IULIA",1017,1469,1008,889,118,1,998,10,1623,615,250,748
1,"ALBA",10,1017,,27,"ALBA IULIA / Bazin Olimpic",1,2,"MUNICIPIUL ALBA IULIA",1017,1252,960,771,188,1,947,13,1379,419,196,751
1,"ALBA",10,1017,,28,"ALBA IULIA / Liceul cu program sportiv",1,2,"MUNICIPIUL ALBA IULIA",1017,1174,814,718,96,0,800,14,1293,479,233,567
1,"ALBA",10,1017,,29,"ALBA IULIA / Liceul cu program sportiv",1,2,"MUNICIPIUL ALBA IULIA",1017,1451,979,935,44,0,969,10,1604,625,255,714
1,"ALBA",10,1017,,30,"ALBA IULIA / Liceul cu program sportiv",1,2,"MUNICIPIUL ALBA IULIA",1017,1376,999,936,58,5,988,11,1517,518,280,708
1,"ALBA",10,1017,,31,"ALBA IULIA / Stadion municipal ""Cetate""",1,2,"MUNICIPIUL ALBA IULIA",1017,1485,991,897,93,1,984,7,1635,644,233,751
1,"ALBA",10,1017,,32,"ALBA IULIA / Gradinita nr. 10",1,2,"MUNICIPIUL ALBA IULIA",1017,1655,1018,965,52,1,1003,15,1814,796,381,622
1,"ALBA",10,1017,,33,"ALBA IULIA / GRĂDINIŢA NR. 10",1,2,"MUNICIPIUL ALBA IULIA",1017,1466,929,864,65,0,925,4,1616,687,373,552
1,"ALBA",10,1017,,34,"ALBA IULIA / Bazin Olimpic",1,2,"MUNICIPIUL ALBA IULIA",1017,1480,834,772,62,0,832,2,1624,790,226,606
1,"ALBA",10,1017,,35,"ALBA IULIA / Colegiul Tehnic ""Dorin Pavel"" Scoala generala nr. 9",1,2,"MUNICIPIUL ALBA IULIA",1017,1279,911,829,82,0,905,6,1400,489,303,602
1,"ALBA",10,1017,,36,"ALBA IULIA / Colegiul Tehnic ""Dorin Pavel""",1,2,"MUNICIPIUL ALBA IULIA",1017,956,647,557,90,0,642,5,1052,405,149,493
1,"ALBA",10,1017,,37,"ALBA IULIA / Grădiniţa cu program prelungit nr.16",1,2,"MUNICIPIUL ALBA IULIA",1017,1649,1059,945,114,0,1049,10,1820,761,211,838
1,"ALBA",10,1017,,38,"ALBA IULIA / Colegiul Tehnic ""Alexandru Domsa""",1,2,"MUNICIPIUL ALBA IULIA",1017,1012,674,630,44,0,665,9,1102,428,168,497
1,"ALBA",10,1017,,39,"ALBA IULIA / Colegiul Tehnic ""Alexandru Domsa""",1,2,"MUNICIPIUL ALBA IULIA",1017,1691,1001,942,58,1,993,8,1864,863,243,750
1,"ALBA",10,1017,,40,"ALBA IULIA / Colegiul Tehnic ""Alexandru Domsa""",1,2,"MUNICIPIUL ALBA IULIA",1017,1388,822,782,40,0,809,13,1523,701,169,640
1,"ALBA",10,1017,,41,"ALBA IULIA / SC Florida Impex  SRL",1,2,"MUNICIPIUL ALBA IULIA",1017,1371,881,817,63,1,874,7,1486,605,255,619
1,"ALBA",10,1017,,42,"ALBA IULIA / Grădiniţa cu program normal nr.5Partoş",1,2,"MUNICIPIUL ALBA IULIA",1017,796,556,525,31,0,550,6,875,319,144,406
1,"ALBA",10,1017,,43,"ALBA IULIA / Căminul pentru persoane vârstnice",1,2,"MUNICIPIUL ALBA IULIA",1017,843,629,552,74,3,624,5,926,297,194,430
1,"ALBA",10,1017,,44,"BĂRĂBANŢ / Grădiniţa Bărăbanţ",1,2,"MUNICIPIUL ALBA IULIA",1017,1009,655,619,32,4,651,4,1101,446,171,480
1,"ALBA",10,1017,,45,"BĂRĂBANŢ / Grădiniţa Bărăbanţ",1,2,"MUNICIPIUL ALBA IULIA",1017,1168,785,743,37,5,781,4,1272,487,191,590
1,"ALBA",10,1017,,46,"MICEŞTI / Şcoala gimnazială Miceşti",1,2,"MUNICIPIUL ALBA IULIA",1017,773,566,519,47,0,560,6,837,271,164,396
1,"ALBA",10,1017,,47,"MICEŞTI / Şcoala gimnazială Miceşti",1,2,"MUNICIPIUL ALBA IULIA",1017,1192,853,804,49,0,847,6,1310,457,224,623
1,"ALBA",10,1017,,48,"OARDA / Căminul Cultural Oarda de jos",1,2,"MUNICIPIUL ALBA IULIA",1017,1241,898,843,55,0,894,4,1363,465,215,679
1,"ALBA",10,1017,,49,"OARDA / Grădiniţa cu program normal Oarda de sus",1,2,"MUNICIPIUL ALBA IULIA",1017,703,438,421,17,0,431,7,772,334,92,339
1,"ALBA",10,1017,,50,"PÎCLIŞA / Şcoala primară Pâclişa",1,2,"MUNICIPIUL ALBA IULIA",1017,832,543,506,37,0,533,10,916,373,155,378
1,"ALBA",10,1213,,51,"AIUD / Centrul Cultural ""Liviu Rebreanu""",1,8,"MUNICIPIUL AIUD",1213,1493,902,836,65,1,898,4,1540,638,341,557
1,"ALBA",10,1213,,52,"AIUD / Gradiniţa cu program prelungit Primii Paşi",1,8,"MUNICIPIUL AIUD",1213,1018,952,583,35,334,939,13,1425,473,500,439
1,"ALBA",10,1213,,53,"AIUD / Grădiniţa cu program prelungit Primii Paşi",1,8,"MUNICIPIUL AIUD",1213,1068,1032,633,33,366,1021,11,1461,429,617,404
1,"ALBA",10,1213,,54,"AIUD / Creşa de copii Micro III",1,8,"MUNICIPIUL AIUD",1213,1339,818,770,48,0,815,3,1378,560,317,498
1,"ALBA",10,1213,,55,"AIUD / Grădiniţa cu Program Prelungit nr.2",1,8,"MUNICIPIUL AIUD",1213,1436,892,868,24,0,884,8,1480,588,387,497
1,"ALBA",10,1213,,56,"AIUD / Şc. Generală nr. 3 ""Axente Sever""",1,8,"MUNICIPIUL AIUD",1213,1306,805,744,61,0,800,5,1443,638,240,560
1,"ALBA",10,1213,,57,"AIUD / Şc. Generală nr. 3 ""Axente Sever""",1,8,"MUNICIPIUL AIUD",1213,1297,746,699,47,0,740,6,1325,579,282,458
1,"ALBA",10,1213,,58,"AIUD / Şc. Generală nr. 3 ""Axente Sever""",1,8,"MUNICIPIUL AIUD",1213,1189,702,677,25,0,696,6,1305,603,260,436
1,"ALBA",10,1213,,59,"AIUD / Colegiul ""Titu Maiorescu""",1,8,"MUNICIPIUL AIUD",1213,1460,1000,859,48,93,996,4,1502,502,337,659
1,"ALBA",10,1213,,60,"AIUD / Colegiul Tehnic",1,8,"MUNICIPIUL AIUD",1213,841,512,484,28,0,507,5,922,410,184,323
1,"ALBA",10,1213,,61,"AIUD / Colegiul Tehnic",1,8,"MUNICIPIUL AIUD",1213,812,485,462,23,0,481,4,900,415,174,307
1,"ALBA",10,1213,,62,"AIUD / Fosta Grădiniţa nr.1",1,8,"MUNICIPIUL AIUD",1213,1482,890,856,33,1,883,7,1637,747,279,604
1,"ALBA",10,1213,,63,"AIUD / Şc. Generală nr. 1 ""Ovidiu Hulea""",1,8,"MUNICIPIUL AIUD",1213,1128,633,595,38,0,624,9,1242,609,217,407
1,"ALBA",10,1213,,64,"AIUD / Şc. Generală nr. 1 ""Ovidiu Hulea""",1,8,"MUNICIPIUL AIUD",1213,1250,761,688,73,0,749,12,1274,513,236,513
1,"ALBA",10,1213,,65,"AIUDUL DE SUS / Şc. Generală nr. 2",1,8,"MUNICIPIUL AIUD",1213,898,493,472,21,0,487,6,992,499,199,288
1,"ALBA",10,1213,,66,"AIUDUL DE SUS / Şc. Generală nr. 2",1,8,"MUNICIPIUL AIUD",1213,1115,566,538,28,0,556,10,1229,663,220,336
1,"ALBA",10,1213,,67,"CIUMBRUD / Şc. Generală Ciumbrud",1,8,"MUNICIPIUL AIUD",1213,1040,669,649,20,0,665,4,1143,474,235,430
1,"ALBA",10,1213,,68,"GÎMBAŞ / Şc. Generală Gîmbaş",1,8,"MUNICIPIUL AIUD",1213,428,285,270,15,0,284,1,470,185,62,222
1,"ALBA",10,1213,,69,"GÎRBOVA DE JOS / Şc. Generală Gîrbova de Jos",1,8,"MUNICIPIUL AIUD",1213,435,259,230,29,0,258,1,476,217,67,191
1,"ALBA",10,1213,,70,"GÎRBOVA DE SUS / Şc. Generală Gîrbova de Sus",1,8,"MUNICIPIUL AIUD",1213,239,178,153,25,0,176,2,265,87,63,113
1,"ALBA",10,1213,,71,"GÎRBOVIŢA / Şc.Generală Gîrboviţa",1,8,"MUNICIPIUL AIUD",1213,95,84,63,21,0,83,1,108,24,25,58
1,"ALBA",10,1213,,72,"MĂGINA / Şc. Generală Măgina",1,8,"MUNICIPIUL AIUD",1213,464,327,296,31,0,324,3,509,182,110,214
1,"ALBA",10,1213,,73,"PĂGIDA / Căminul Cultural Păgida",1,8,"MUNICIPIUL AIUD",1213,95,81,63,18,0,80,1,108,27,21,59
1,"ALBA",10,1213,,74,"SÎNCRAI / Şc. Generală Sîncrai",1,8,"MUNICIPIUL AIUD",1213,575,386,372,14,0,384,2,637,251,175,209
1,"ALBA",10,1348,,75,"BLAJ / Piaţa Agroalimentară ,",1,20,"MUNICIPIUL BLAJ",1348,1040,628,591,37,0,622,6,1139,511,138,484
1,"ALBA",10,1348,,76,"BLAJ / SC Apa CTTA",1,20,"MUNICIPIUL BLAJ",1348,656,428,388,33,7,424,4,721,293,73,351
1,"ALBA",10,1348,,77,"BLAJ / Gradiniţa de copii cu program prelungit nr.3,",1,20,"MUNICIPIUL BLAJ",1348,1292,794,757,37,0,790,4,1429,635,232,558
1,"ALBA",10,1348,,78,"BLAJ / Şcoala Generală nr.1",1,20,"MUNICIPIUL BLAJ",1348,1278,775,717,55,3,771,4,1413,638,248,523
1,"ALBA",10,1348,,79,"BLAJ / Centrul Cultural ,,IACOB MUREŞIANU''",1,20,"MUNICIPIUL BLAJ",1348,858,593,538,49,6,590,3,948,355,198,392
1,"ALBA",10,1348,,80,"BLAJ / Grup Şcolar Agricol",1,20,"MUNICIPIUL BLAJ",1348,641,426,362,64,0,424,2,705,279,116,308
1,"ALBA",10,1348,,81,"BLAJ / Universitatea ,, Spiru Haret''",1,20,"MUNICIPIUL BLAJ",1348,524,369,337,29,3,368,1,576,207,111,257
1,"ALBA",10,1348,,82,"BLAJ / PIATA AGROALIMENTARA",1,20,"MUNICIPIUL BLAJ",1348,655,449,387,60,2,448,1,721,272,130,318
1,"ALBA",10,1348,,83,"BLAJ / AJVPS",1,20,"MUNICIPIUL BLAJ",1348,335,213,198,14,1,212,1,368,155,41,171
1,"ALBA",10,1348,,84,"BLAJ / Grup Şcolar,, Timotei Cipariu",1,20,"MUNICIPIUL BLAJ",1348,1530,1041,983,48,10,1036,5,1689,648,302,734
1,"ALBA",10,1348,,85,"BLAJ / Colegiul Naţional,,I.M Clain''",1,20,"MUNICIPIUL BLAJ",1348,1381,945,874,67,4,936,9,1519,574,251,685
1,"ALBA",10,1348,,86,"BLAJ / Şcoala Generală nr.4",1,20,"MUNICIPIUL BLAJ",1348,1599,1037,985,46,6,1025,12,1767,730,267,758
1,"ALBA",10,1348,,87,"BLAJ / Şcoala Generală nr. 2 Izvoarele",1,20,"MUNICIPIUL BLAJ",1348,1322,660,641,19,0,644,16,1448,788,196,448
1,"ALBA",10,1348,,88,"BLAJ / Grădiniţa de Copii",1,20,"MUNICIPIUL BLAJ",1348,1335,807,781,25,1,803,4,1468,661,185,618
1,"ALBA",10,1348,,89,"MĂNĂRADE / Scoala Generala Manarade",1,20,"MUNICIPIUL BLAJ",1348,873,463,438,25,0,461,2,961,498,114,347
1,"ALBA",10,1348,,90,"PETRISAT / Scoala Generala Petrisat",1,20,"MUNICIPIUL BLAJ",1348,475,324,308,16,0,321,3,520,196,16,305
1,"ALBA",10,1348,,91,"TIUR / Scoala Generala Tiur",1,20,"MUNICIPIUL BLAJ",1348,1341,891,861,30,0,888,3,1472,581,209,679
1,"ALBA",10,1874,,92,"SEBEŞ / SERVICIUL PUBLIC DE ADMINISTRARE A PATRIMONIULUI SEBES",1,30,"MUNICIPIUL SEBEŞ",1874,1638,1119,1065,49,5,1108,11,1802,683,298,810
1,"ALBA",10,1874,,93,"SEBEŞ / GRUP ŞCOLAR INDUSTRIAL SEBEŞ",1,30,"MUNICIPIUL SEBEŞ",1874,1305,587,545,39,3,573,14,1436,849,279,294
1,"ALBA",10,1874,,94,"SEBEŞ / GRUP ŞCOLAR INDUSTRIAL SEBEŞ",1,30,"MUNICIPIUL SEBEŞ",1874,1610,1144,1000,139,5,1132,12,1772,628,279,853
1,"ALBA",10,1874,,95,"SEBEŞ / LICEUL CU PROGRAM SPORTIV SEBEŞ",1,30,"MUNICIPIUL SEBEŞ",1874,1611,981,932,48,1,977,4,1774,793,236,741
1,"ALBA",10,1874,,96,"SEBEŞ / LICEUL CU PROGRAM SPORTIV SEBEŞ",1,30,"MUNICIPIUL SEBEŞ",1874,1536,1053,967,81,5,1047,6,1691,638,283,764
1,"ALBA",10,1874,,97,"SEBEŞ / LICEUL CU PROGRAM SPORTIV SEBEŞ",1,30,"MUNICIPIUL SEBEŞ",1874,1515,909,858,50,1,906,3,1670,761,240,666
1,"ALBA",10,1874,,98,"SEBEŞ / ŞCOALA GIMNAZIALĂ  NR.2 SEBEŞ",1,30,"MUNICIPIUL SEBEŞ",1874,1429,1033,928,91,14,1023,10,1576,543,239,784
1,"ALBA",10,1874,,99,"SEBEŞ / COLEGIUL NATIONAL LUCIAN BLAGA SEBES",1,30,"MUNICIPIUL SEBEŞ",1874,1303,889,836,52,1,883,6,1434,545,206,677
1,"ALBA",10,1874,,100,"SEBEŞ / COLEGIUL NAŢIONAL LUCIAN BLAGA SEBEŞ",1,30,"MUNICIPIUL SEBEŞ",1874,1221,824,802,22,0,817,7,1333,509,171,646
1,"ALBA",10,1874,,101,"SEBEŞ / ŞCOALA GIMNAZIALĂ ""SILVIU CĂRPINIŞIANU ""SEBEŞ",1,30,"MUNICIPIUL SEBEŞ",1874,1012,693,652,41,0,686,7,1118,425,178,508
1,"ALBA",10,1874,,102,"SEBEŞ / ŞCOALA GIMNAZIALĂ ""SILVIU CĂRPINIŞIANU ""SEBEŞ",1,30,"MUNICIPIUL SEBEŞ",1874,1007,649,601,47,1,646,3,1108,459,113,533
1,"ALBA",10,1874,,103,"SEBEŞ / ŞCOALA GIMNAZIALĂ ""MIHAIL KOGĂLNICEANU ""SEBEŞ",1,30,"MUNICIPIUL SEBEŞ",1874,1154,706,658,48,0,705,1,1274,568,180,525
1,"ALBA",10,1874,,104,"SEBEŞ / ŞCOALA GIMNAZIALĂ ""MIHAIL KOGĂLNICEANU "" SEBEŞ",1,30,"MUNICIPIUL SEBEŞ",1874,1103,656,616,40,0,652,4,1209,553,165,487
1,"ALBA",10,1874,,105,"SEBEŞ / ŞCOALA GIMNAZIALĂ ""MIHAIL KOGĂLNICEANU "" SEBEŞ",1,30,"MUNICIPIUL SEBEŞ",1874,1185,679,640,39,0,675,4,1305,626,179,496
1,"ALBA",10,1874,,106,"SEBEŞ / ŞCOALA GIMNAZIALĂ ""MIHAIL KOGĂLNICEANU "" SEBEŞ",1,30,"MUNICIPIUL SEBEŞ",1874,1124,613,589,23,1,612,1,1241,628,170,442
1,"ALBA",10,1874,,107,"LANCRĂM / ŞCOALA GIMNAZIALĂ LANCRĂM",1,30,"MUNICIPIUL SEBEŞ",1874,1396,948,895,53,0,946,2,1536,588,223,723
1,"ALBA",10,1874,,108,"PETREŞTI / ŞCOALA GIMNAZIALĂ PETREŞTI",1,30,"MUNICIPIUL SEBEŞ",1874,1374,890,837,53,0,883,7,1504,614,157,726
1,"ALBA",10,1874,,109,"PETREŞTI / ŞCOALA GIMNAZIALĂ PETREŞTI",1,30,"MUNICIPIUL SEBEŞ",1874,1305,783,732,51,0,780,3,1432,649,171,609
1,"ALBA",10,1874,,110,"PETREŞTI / ŞCOALA GIMNAZIALĂ PETREŞTI",1,30,"MUNICIPIUL SEBEŞ",1874,1299,792,762,30,0,788,4,1425,633,120,668
1,"ALBA",10,1874,,111,"RĂHĂU / ŞCOALA GIMNAZIALĂ  RĂHĂU",1,30,"MUNICIPIUL SEBEŞ",1874,860,554,522,32,0,551,3,945,391,112,439
1,"ALBA",10,1151,,112,"ABRUD / Şcoala Gimnazială ,,Avram Iancu''",1,35,"ORAŞ ABRUD",1151,1186,802,737,57,8,783,19,1305,503,368,415
1,"ALBA",10,1151,,113,"ABRUD / Şcoala de aplicaţie",1,35,"ORAŞ ABRUD",1151,1144,716,670,42,4,700,16,1261,545,392,308
1,"ALBA",10,1151,,114,"ABRUD / Grădiniţa cu program prelungit nr.1",1,35,"ORAŞ ABRUD",1151,1329,777,722,55,0,769,8,1465,688,388,381
1,"ALBA",10,1151,,115,"ABRUD / Liceul ,,Horea,Cloşca şi Crişan'",1,35,"ORAŞ ABRUD",1151,1129,713,632,73,8,700,13,1247,534,309,391
1,"ALBA",10,2915,,116,"BAIA DE ARIEŞ / ŞCOALA GENERALĂ CLS. V-VIII",1,40,"ORAŞ BAIA DE ARIEŞ",2915,903,552,497,48,7,548,4,1000,448,242,306
1,"ALBA",10,2915,,117,"BAIA DE ARIEŞ / CASA DE CULTURĂ BAIA DE ARIEŞ",1,40,"ORAŞ BAIA DE ARIEŞ",2915,688,399,380,19,0,395,4,758,359,178,217
1,"ALBA",10,2915,,118,"BAIA DE ARIEŞ / CASA DE CULTURĂ BAIA DE ARIEŞ",1,40,"ORAŞ BAIA DE ARIEŞ",2915,913,475,430,43,2,474,1,1007,532,195,279
1,"ALBA",10,2915,,119,"BRĂZEŞTI / SCOALA PRIMARĂ BRĂZEŞTI",1,40,"ORAŞ BAIA DE ARIEŞ",2915,221,144,126,18,0,142,2,244,100,76,66
1,"ALBA",10,2915,,120,"CIOARA DE SUS / CĂMINUL CULTURAL CIOARA DE SUS",1,40,"ORAŞ BAIA DE ARIEŞ",2915,201,127,114,13,0,126,1,219,92,48,78
1,"ALBA",10,2915,,121,"MUNCELU / CĂMINUL CULTURAL MUNCELU",1,40,"ORAŞ BAIA DE ARIEŞ",2915,317,198,182,16,0,197,1,349,151,72,125
1,"ALBA",10,2915,,122,"SARTĂŞ / CĂMINUL CULTURAL SARTĂŞ",1,40,"ORAŞ BAIA DE ARIEŞ",2915,323,189,171,18,0,188,1,357,168,72,116
1,"ALBA",10,1455,,123,"CÎMPENI / Primăria oraşului Cîmpeni",1,47,"ORAŞ CÎMPENI",1455,1254,989,831,156,2,977,12,1380,391,389,588
1,"ALBA",10,1455,,124,"CÎMPENI / Şcoala cu clasele I-VIII Cîmpeni",1,47,"ORAŞ CÎMPENI",1455,915,690,585,75,30,682,8,1010,320,219,463
1,"ALBA",10,1455,,125,"CÎMPENI / Colegiul Naţional Avram Iancu Cîmpeni",1,47,"ORAŞ CÎMPENI",1455,939,696,624,70,2,690,6,1035,339,265,425
1,"ALBA",10,1455,,126,"CÎMPENI / Colegiul Naţional Avram Iancu Cîmpeni",1,47,"ORAŞ CÎMPENI",1455,875,712,586,86,40,707,5,967,255,316,391
1,"ALBA",10,1455,,127,"CÎMPENI / Ocolul Silvic Valea Arieşului",1,47,"ORAŞ CÎMPENI",1455,870,641,586,53,2,629,12,960,319,256,373
1,"ALBA",10,1455,,128,"CÎMPENI / Şcoala Vîrşi",1,47,"ORAŞ CÎMPENI",1455,604,486,369,117,0,486,0,665,179,216,270
1,"ALBA",10,1455,,129,"CERTEGE / Şcoala Certege",1,47,"ORAŞ CÎMPENI",1455,412,216,203,13,0,216,0,454,238,78,138
1,"ALBA",10,1455,,130,"MIHOEŞTI / Şcoala Mihoieşti",1,47,"ORAŞ CÎMPENI",1455,284,202,179,23,0,201,1,312,110,74,127
1,"ALBA",10,1455,,131,"VALEA BISTRII / Şcoala Valea Bistrii",1,47,"ORAŞ CÎMPENI",1455,388,291,255,36,0,289,2,427,136,68,221
1,"ALBA",10,1696,,132,"CUGIR / Şcoala Gimnazială Nr.3 Cugir (fostă Şcoala cu clasele I-VIII Nr.3 Cugir)",1,70,"ORAŞ CUGIR",1696,1150,661,622,38,1,652,9,1268,607,300,352
1,"ALBA",10,1696,,133,"CUGIR / Şcoala Gimnazială Nr.3 Cugir (fostă Şcoala cu clasele I-VIII Nr.3 Cugir)",1,70,"ORAŞ CUGIR",1696,1427,758,738,19,1,750,8,1575,817,353,397
1,"ALBA",10,1696,,134,"CUGIR / Şcoala Gimnazială Nr.3 Cugir (fostă Şcoala cu clasele I-VIII Nr.3 Cugir)",1,70,"ORAŞ CUGIR",1696,1345,720,692,27,1,713,7,1472,752,300,413
1,"ALBA",10,1696,,135,"CUGIR / Şcoala Gimnazială Nr.3 Cugir (fostă Şcoala cu clasele I-VIII Nr.3 Cugir)",1,70,"ORAŞ CUGIR",1696,1196,640,612,26,2,633,7,1315,675,254,379
1,"ALBA",10,1696,,136,"CUGIR / Grădiniţa cu Program normal nr.5 Cugir (fostă Grădiniţa nr.5 Cugir)",1,70,"ORAŞ CUGIR",1696,1117,622,598,22,2,608,14,1231,609,255,353
1,"ALBA",10,1696,,137,"CUGIR / Colegiul Naţional ""David Prodan"" Cugir",1,70,"ORAŞ CUGIR",1696,1167,596,569,27,0,587,9,1285,689,225,362
1,"ALBA",10,1696,,138,"CUGIR / Colegiul Naţional ""David Prodan Cugir",1,70,"ORAŞ CUGIR",1696,1153,674,653,21,0,663,11,1269,595,283,380
1,"ALBA",10,1696,,139,"CUGIR / Şcoala Gimnazială ""Singidava"" Cugir (fostă Şcoala cu clasele I-VIII ""Singidava"" Cugir)",1,70,"ORAŞ CUGIR",1696,1297,712,684,27,1,704,8,1432,720,321,383
1,"ALBA",10,1696,,140,"CUGIR / Grădiniţa cu Program Normal ""Voinicel"" Cugir (fostă Grădiniţa nr.6 Cugir)",1,70,"ORAŞ CUGIR",1696,1298,772,742,30,0,759,13,1436,664,319,440
1,"ALBA",10,1696,,141,"CUGIR / Colegiul Tehnic ""I.D.Lăzărescu""Cugir",1,70,"ORAŞ CUGIR",1696,1133,660,635,24,1,650,10,1245,585,273,377
1,"ALBA",10,1696,,142,"CUGIR / Şcoala Gimnazială ""Singidava"" Cugir (fostă Şcoala cu clasele I-VIII Nr.2 Cugir)",1,70,"ORAŞ CUGIR",1696,1461,870,828,41,1,858,12,1609,739,358,500
1,"ALBA",10,1696,,143,"CUGIR / Şcoala Gimnazială ""Singidava"" Cugir (fostă Şcoala cu clasele I-VIII Nr.2 Cugir)",1,70,"ORAŞ CUGIR",1696,1172,615,582,32,1,598,17,1285,670,236,362
1,"ALBA",10,1696,,144,"CUGIR / Casa de Cultură a Oraşului Cugir",1,70,"ORAŞ CUGIR",1696,1419,845,811,34,0,831,14,1559,714,369,462
1,"ALBA",10,1696,,145,"CUGIR / Grădiniţa cu Program Normal Nr.2 Cugir (fostă Grădiniţa Nr.2 Cugir)",1,70,"ORAŞ CUGIR",1696,1273,752,721,31,0,739,13,1405,653,278,461
1,"ALBA",10,1696,,146,"CUGIR / Şcoala Gimnazială ""Iosif Pervain"" Cugir (fostă Şcoala cu clasele I-VIII ""Iosif Pervain"" Cugir)",1,70,"ORAŞ CUGIR",1696,1117,687,656,26,5,681,6,1230,543,272,409
1,"ALBA",10,1696,,147,"CUGIR / Şcoala Gimnazială ""Iosif Pervain"" Cugir (fostă Şcoala cu clasele I-VIII ""Iosif Pervain"" Cugir)",1,70,"ORAŞ CUGIR",1696,1174,711,683,27,1,706,5,1290,579,261,445
1,"ALBA",10,1696,,148,"CUGIR / Grădiniţa cu Program Normal Nr.1 Cugir (fostă Grădiniţa nr.1 Cugir)",1,70,"ORAŞ CUGIR",1696,1180,680,647,32,1,670,10,1306,626,315,355
1,"ALBA",10,1696,,149,"BUCURU / Şcoala Primară Bucuru (fostă Şcoala cu clasele I-IV Bucuru)",1,70,"ORAŞ CUGIR",1696,105,59,46,13,0,59,0,120,61,6,53
1,"ALBA",10,1696,,150,"CĂLENE / Şcoala Primară Călene (fostă Şcoala cu clasele I-IV Călene)",1,70,"ORAŞ CUGIR",1696,45,46,34,11,1,46,0,58,12,12,34
1,"ALBA",10,1696,,151,"MUGEŞTI / Şcoala Primară Mugeşti (fostă Şcoala cu clasele I-IV Mugeşti)",1,70,"ORAŞ CUGIR",1696,94,57,43,14,0,57,0,107,50,11,46
1,"ALBA",10,1696,,152,"VINEREA / Şcoala Gimnazială ""Ioan Mihu"" Vinerea (fostă Şcoala cu clasele I-VIII ""Dr.Ioan Mihu"" Vinerea)",1,70,"ORAŞ CUGIR",1696,1073,699,675,23,1,694,5,1184,485,197,497
1,"ALBA",10,1696,,153,"VINEREA / Şcoala Gimnazială ""Ioan Mihu"" Vinerea (fostă Şcoala cu clasele I-VIII ""Dr.Ioan Mihu"" Vinerea)",1,70,"ORAŞ CUGIR",1696,916,635,606,29,0,625,10,1007,372,246,379
1,"ALBA",10,1794,,154,"OCNA MUREŞ / GRĂDINIŢA CU PROGRAM NORMAL NR. 5",1,79,"ORAŞ OCNA MUREŞ",1794,1456,849,825,24,0,843,6,1603,754,283,560
1,"ALBA",10,1794,,155,"OCNA MUREŞ / ŞCOALĂ GENERALĂ LUCIAN BLAGA",1,79,"ORAŞ OCNA MUREŞ",1794,1168,687,661,26,0,680,7,1291,604,236,444
1,"ALBA",10,1794,,156,"OCNA MUREŞ / CASA DE CULTURĂ",1,79,"ORAŞ OCNA MUREŞ",1794,1299,767,698,66,3,761,6,1428,661,250,511
1,"ALBA",10,1794,,157,"OCNA MUREŞ / SEDIUL DSV OCNA MURES",1,79,"ORAŞ OCNA MUREŞ",1794,1145,624,588,36,0,617,7,1264,640,232,385
1,"ALBA",10,1794,,158,"OCNA MUREŞ / LICEUL TEORETIC ""PETRU MAIOR""",1,79,"ORAŞ OCNA MUREŞ",1794,1352,795,747,46,2,788,7,1500,705,254,534
1,"ALBA",10,1794,,159,"OCNA MUREŞ / GRĂDINIŢA CU ORAR NORMAL NR. 3",1,79,"ORAŞ OCNA MUREŞ",1794,1557,908,864,44,0,900,8,1711,803,241,659
1,"ALBA",10,1794,,160,"UIOARA DE JOS / CĂMIN CULTURAL UIOARA DE JOS",1,79,"ORAŞ OCNA MUREŞ",1794,943,582,547,35,0,576,6,1041,459,190,386
1,"ALBA",10,1794,,161,"UIOARA DE SUS / CĂMIN CULTURAL UIOARA DE SUS",1,79,"ORAŞ OCNA MUREŞ",1794,1412,814,774,39,1,808,6,1548,734,275,533
1,"ALBA",10,1794,,162,"CISTEIU DE MUREŞ / ŞCOALA GENERALĂ CISTEIUL DE MUREŞ",1,79,"ORAŞ OCNA MUREŞ",1794,578,291,271,20,0,289,2,634,343,50,239
1,"ALBA",10,1794,,163,"MICOŞLACA / GRĂDINIŢA MICOŞLACA",1,79,"ORAŞ OCNA MUREŞ",1794,249,180,147,32,1,179,1,276,96,85,94
1,"ALBA",10,1794,,164,"RĂZBOIENI-CETATE / CĂMIN CULTURAL RĂZBOIENI CETATE",1,79,"ORAŞ OCNA MUREŞ",1794,1137,682,620,61,1,680,2,1249,567,258,422
1,"ALBA",10,8096,,165,"TEIUŞ / CASA DE CULTURA",1,86,"ORAŞ TEIUŞ",8096,1559,1037,953,80,4,1031,6,1718,681,406,625
1,"ALBA",10,8096,,166,"TEIUŞ / SCOALA GENERALA",1,86,"ORAŞ TEIUŞ",8096,1391,745,702,38,5,735,10,1530,785,316,419
1,"ALBA",10,8096,,167,"TEIUŞ / LICEUL TEORETIC",1,86,"ORAŞ TEIUŞ",8096,1548,1078,997,78,3,1063,15,1701,623,401,662
1,"ALBA",10,8096,,168,"TEIUŞ / GARA CFR",1,86,"ORAŞ TEIUŞ",8096,1063,642,583,57,2,638,4,1171,529,267,371
1,"ALBA",10,8096,,169,"BELDIU / ŞCOALA GENERALĂ",1,86,"ORAŞ TEIUŞ",8096,210,152,130,21,1,150,2,230,78,80,70
1,"ALBA",10,8096,,170,"PEŢELCA / ŞCOALA GENERALĂ",1,86,"ORAŞ TEIUŞ",8096,130,107,81,26,0,104,3,141,34,50,54
1,"ALBA",10,8096,,171,"CĂPUD / CĂMIN CULTURAL",1,86,"ORAŞ TEIUŞ",8096,266,171,150,21,0,169,2,293,122,58,111
1,"ALBA",10,1936,,172,"ZLATNA / Şcoala gimnazială  "" Avram Iancu"" Zlatna",1,92,"ORAŞ ZLATNA",1936,1262,773,730,42,1,764,9,1391,618,337,427
1,"ALBA",10,1936,,173,"ZLATNA / Şcoala gimnazială  "" Avram Iancu"" Zlatna",1,92,"ORAŞ ZLATNA",1936,955,605,585,19,1,601,4,1052,447,244,357
1,"ALBA",10,1936,,174,"ZLATNA / Liceul Corneliu Medrea Zlatna",1,92,"ORAŞ ZLATNA",1936,1377,802,756,46,0,797,5,1514,712,281,516
1,"ALBA",10,1936,,175,"FENEŞ / Şcoala gimnazială "" Sava Albescu "" Sat Feneş",1,92,"ORAŞ ZLATNA",1936,777,624,572,39,13,617,7,855,231,238,379
1,"ALBA",10,1936,,176,"GALAŢI / Şcoala primară , sat Galaţi",1,92,"ORAŞ ZLATNA",1936,315,210,189,21,0,209,1,350,140,81,128
1,"ALBA",10,1936,,177,"IZVORU AMPOIULUI / Cămin cultural, sat Izvorul Ampoiului",1,92,"ORAŞ ZLATNA",1936,445,315,280,32,3,312,3,490,175,124,188
1,"ALBA",10,1936,,178,"PĂTRÎNGENI / Şcoala primară , sat Pătrângeni",1,92,"ORAŞ ZLATNA",1936,521,344,327,17,0,338,6,573,229,180,158
1,"ALBA",10,1936,,179,"PIRITA / Şcoala primară , sat Pirita",1,92,"ORAŞ ZLATNA",1936,344,277,257,20,0,276,1,378,101,135,141
1,"ALBA",10,1936,,180,"TRÎMPOIELE / Şcoala primară , sat Trîmpoiele",1,92,"ORAŞ ZLATNA",1936,359,238,225,13,0,235,3,393,155,79,156
1,"ALBA",10,1936,,181,"VALEA MICĂ / Şcoala primară , sat Valea Mică",1,92,"ORAŞ ZLATNA",1936,350,252,235,17,0,250,2,382,130,100,150
1,"ALBA",10,1936,,182,"VÎLTORI / Cămin cultural, sat Vîltori",1,92,"ORAŞ ZLATNA",1936,190,142,129,13,0,140,2,207,65,54,86
1,"ALBA",10,2130,,183,"ALBAC / CĂMINUL CULTURAL ALBAC",3,112,"ALBAC",2130,787,558,488,70,0,548,10,867,309,169,379
1,"ALBA",10,2130,,184,"CIONEŞTI / ŞCOALA PRIMARĂ CIONEŞTI",3,112,"ALBAC",2130,562,379,359,18,2,376,3,620,241,69,307
1,"ALBA",10,2130,,185,"COSTEŞTI / ŞCOALA PRIMARĂ COSTEŞTI",3,112,"ALBAC",2130,96,64,48,16,0,64,0,109,45,24,40
1,"ALBA",10,2130,,186,"POTIONCI / ŞCOALA PRIMARĂ POTIONCI",3,112,"ALBAC",2130,76,60,50,9,1,60,0,90,30,18,42
1,"ALBA",10,2130,,187,"ROGOZ / ŞCOALA PRIMARĂ ROGOZ",3,112,"ALBAC",2130,230,166,143,22,1,164,2,254,88,43,121
1,"ALBA",10,2309,,188,"ALMAŞU MARE / PRIMARIA COMUNEI ALMSU MARE",3,129,"ALMAŞU MARE",2309,343,226,203,20,3,225,1,376,150,76,149
1,"ALBA",10,2309,,189,"ALMAŞU MARE / SCOALA PRIMARA ALMASU MARE - SUSENI",3,129,"ALMAŞU MARE",2309,234,163,140,16,7,162,1,257,94,66,96
1,"ALBA",10,2309,,190,"ALMAŞU DE MIJLOC / ŞCOALA PRIMARA ALMAŞU DE MIJLOC",3,129,"ALMAŞU MARE",2309,120,90,77,13,0,90,0,133,43,26,64
1,"ALBA",10,2309,,191,"CIB / ŞCOALA PRIMARA CIB",3,129,"ALMAŞU MARE",2309,245,187,167,20,0,185,2,270,83,30,155
1,"ALBA",10,2309,,192,"GLOD / ŞCOALA PRIMARA GLOD",3,129,"ALMAŞU MARE",2309,159,147,115,26,6,147,0,177,30,26,121
1,"ALBA",10,2381,,193,"ARIEŞENI / GRUP ŞCOLAR DE TURISM ARIEŞENI",3,137,"ARIEŞENI",2381,591,472,429,39,4,466,6,646,174,179,287
1,"ALBA",10,2381,,194,"ARIEŞENI / GRUP ŞCOLAR DE TURISM ARIEŞENI",3,137,"ARIEŞENI",2381,558,446,389,54,3,440,6,615,169,211,229
1,"ALBA",10,2381,,195,"ARIEŞENI / ŞCOALA PRIMARĂ CASA DE PIATRĂ",3,137,"ARIEŞENI",2381,93,69,61,8,0,69,0,107,38,26,43
1,"ALBA",10,2381,,196,"ARIEŞENI / ŞCOALA PRIMARĂ COBLEŞ",3,137,"ARIEŞENI",2381,203,151,136,13,2,148,3,223,72,56,92
1,"ALBA",10,2577,,197,"AVRAM IANCU / ŞCOALA GENERALĂ CU CLS. I- VIII AVRAM IANCU",3,156,"AVRAM IANCU",2577,680,424,377,23,24,416,8,747,323,54,362
1,"ALBA",10,2577,,198,"TÎRSA / ŞCOALA GENERALĂ CU CLS. I- VIII TÎRSA",3,156,"AVRAM IANCU",2577,649,505,465,32,8,503,2,712,207,107,396
1,"ALBA",10,2988,,199,"HENIG / CĂMIN CULTURAL",3,190,"BERGHIN",2988,258,191,138,53,0,190,1,282,91,56,134
1,"ALBA",10,2988,,200,"BERGHIN / SCOALA GENERALĂ",3,190,"BERGHIN",2988,706,403,360,41,2,400,3,778,375,74,326
1,"ALBA",10,2988,,201,"GHIRBOM / SCOALA GENERALĂ",3,190,"BERGHIN",2988,462,283,273,10,0,280,3,509,226,64,216
1,"ALBA",10,2988,,202,"STRAJA / SCOALA GENERALĂ",3,190,"BERGHIN",2988,300,215,182,33,0,215,0,328,113,48,167
1,"ALBA",10,3039,,203,"BISTRA / ŞCOALA NICODIM GANEA BISTRA",3,195,"BISTRA",3039,791,489,466,20,3,485,4,870,381,194,291
1,"ALBA",10,3039,,204,"BISTRA / ŞCOALA NICODIM GANEA BISTRA",3,195,"BISTRA",3039,1010,657,630,27,0,649,8,1108,451,200,449
1,"ALBA",10,3039,,205,"BISTRA / ŞCOALA NICODIM GANEA BISTRA",3,195,"BISTRA",3039,886,442,419,21,2,438,4,977,535,136,302
1,"ALBA",10,3039,,206,"CIULDEŞTI / ŞCOALA CU CLASELE I-IV - CIULDEŞTI",3,195,"BISTRA",3039,651,404,384,19,1,403,1,716,312,114,289
1,"ALBA",10,3039,,207,"GÎRDE / ŞCOALA CU CLASELE I-VIII GÎRDE",3,195,"BISTRA",3039,701,406,383,18,5,402,4,773,367,152,250
1,"ALBA",10,3397,,208,"BLANDIANA / Primaria comunei Blandiana",3,231,"BLANDIANA",3397,497,342,297,42,3,342,0,549,207,71,271
1,"ALBA",10,3397,,209,"ACMARIU / Şcoala cu clasele I-IV Acmariu",3,231,"BLANDIANA",3397,311,222,184,32,6,218,4,342,120,68,150
1,"ALBA",10,3397,,210,"RĂCĂTĂU / Şcoala cu clasele I-IV Răcătău",3,231,"BLANDIANA",3397,29,24,16,8,0,24,0,42,18,6,18
1,"ALBA",10,9026,,211,"BUCERDEA GRÂNOASĂ / Căminul cultural Bucerdea Grânoasă",3,237,"BUCERDEA GRÂNOASĂ",9026,1061,818,762,32,24,811,7,1169,351,175,636
1,"ALBA",10,9026,,212,"BUCERDEA GRÂNOASĂ / Grădiniţa cu program normal",3,237,"BUCERDEA GRÂNOASĂ",9026,830,600,561,19,20,594,6,915,315,154,440
1,"ALBA",10,3459,,213,"CIUCULEŞTI / SCOALA CU CLASELE I-IV",3,242,"BUCIUM",3459,380,238,215,18,5,238,0,420,182,123,115
1,"ALBA",10,3459,,214,"BUCIUM-SAT / SCOALA CU CLASELE I-IV",3,242,"BUCIUM",3459,429,271,248,21,2,268,3,472,201,159,109
1,"ALBA",10,3459,,215,"CERBU / SCOALA CU CLASELE I-IV",3,242,"BUCIUM",3459,280,177,166,11,0,175,2,309,132,85,90
1,"ALBA",10,3459,,216,"POIENI / SCOALA CU CLASELE I-IV",3,242,"BUCIUM",3459,292,233,190,40,3,232,1,321,88,106,126
1,"ALBA",10,3761,,217,"CENADE / PRIMĂRIA CENADE",3,276,"CENADE",3761,777,522,440,51,31,518,4,856,334,83,435
1,"ALBA",10,3805,,218,"CERGĂU MARE / ŞCOALA GIMNAZIALĂ ""ARON  COTRUŞ"" CERGĂU MARE",3,280,"CERGĂU",3805,816,620,543,34,43,616,4,897,277,111,505
1,"ALBA",10,3805,,219,"CERGĂU MIC / ŞCOALA CU CLASELE I-IV CERGĂU MIC",3,280,"CERGĂU",3805,272,205,163,31,11,200,5,300,95,41,159
1,"ALBA",10,3805,,220,"LUPU / GRĂDINITĂ LUPU",3,280,"CERGĂU",3805,204,185,141,35,9,185,0,226,41,43,142
1,"ALBA",10,3841,,221,"CERU-BĂCĂINŢI / CĂMINUL CULTURAL",3,284,"CERU-BĂCĂINŢI",3841,229,188,115,73,0,188,0,254,66,65,123
1,"ALBA",10,3958,,222,"CETATEA DE BALTĂ / CĂMIN CULTURAL",3,295,"CETATEA DE BALTĂ",3958,603,300,266,24,10,296,4,663,363,104,192
1,"ALBA",10,3958,,223,"CETATEA DE BALTĂ / CĂMIN CULTURAL",3,295,"CETATEA DE BALTĂ",3958,873,519,471,37,11,516,3,964,445,130,386
1,"ALBA",10,3958,,224,"CRACIUNELU DE SUS / SCOALA GENERALA  CRĂCIUNELU DE SUS",3,295,"CETATEA DE BALTĂ",3958,104,81,65,16,0,79,2,117,36,20,59
1,"ALBA",10,3958,,225,"SÎNTĂMĂRIE / SCOALA GENERALA   SÎNTĂMĂRIE",3,295,"CETATEA DE BALTĂ",3958,248,179,153,26,0,179,0,272,93,41,138
1,"ALBA",10,3958,,226,"TĂTÎRLAUA / CĂMIN CULTURAL TĂTÎRLAUA SALANR.1",3,295,"CETATEA DE BALTĂ",3958,588,273,251,22,0,267,6,644,371,111,156
1,"ALBA",10,1071,,227,"CIUGUD / Şcoala cu clasele I-VIII Ciugud Str.",3,300,"CIUGUD",1071,474,380,302,59,19,370,10,524,144,183,187
1,"ALBA",10,1071,,228,"DRÎMBAR / Grădiniţă Drâmbar",3,300,"CIUGUD",1071,314,256,211,40,5,254,2,343,87,104,150
1,"ALBA",10,1071,,229,"HĂPRIA / Clădire administrativă (fosta Şcoală cu clasele I-VIII Hăpria)",3,300,"CIUGUD",1071,476,400,334,48,18,399,1,524,124,135,264
1,"ALBA",10,1071,,230,"LIMBA / Centru de zi pentru bătrâni (fosta Şcoala cu clasele I-IV Limba)",3,300,"CIUGUD",1071,307,252,205,39,8,248,4,335,83,121,127
1,"ALBA",10,1071,,231,"ŞEUŞA / Şcoala cu claseleI-IV Şeuşa",3,300,"CIUGUD",1071,596,502,425,56,21,496,6,654,152,162,334
1,"ALBA",10,1071,,232,"TELEAC / Grădiniţă-Teleac",3,300,"CIUGUD",1071,322,276,238,22,16,274,2,355,79,119,155
1,"ALBA",10,4008,,233,"BUNINGINEA / ŞCOALA GENERALĂ",3,307,"CIURULEASA",4008,391,258,243,13,2,249,9,431,173,102,147
1,"ALBA",10,4008,,234,"CIURULEASA / PRIMĂRIA COMUNEI CIURULEASA",3,307,"CIURULEASA",4008,621,435,377,49,9,428,7,686,251,193,235
1,"ALBA",10,4106,,235,"CÎLNIC / Primaria comunei Cîlnic",3,273,"CÎLNIC",4106,1080,735,698,37,0,733,2,1185,450,297,436
1,"ALBA",10,4106,,236,"DEAL / Şcoala primară Deal",3,273,"CÎLNIC",4106,292,279,205,68,6,278,1,323,44,43,235
1,"ALBA",10,4188,,237,"CRĂCIUNELU DE JOS / Primăria Crăciunelu de Jos",3,317,"CRĂCIUNELU DE JOS",4188,881,640,593,38,9,635,5,970,330,136,499
1,"ALBA",10,4188,,238,"CRĂCIUNELU DE JOS / Şcoala cls. I-VIII Crăciunelu de Jos",3,317,"CRĂCIUNELU DE JOS",4188,826,600,550,43,7,594,6,907,307,165,429
1,"ALBA",10,4142,,239,"CRICĂU / BIBLIOTECA COMUNALA",3,319,"CRICĂU",4142,1096,740,661,60,19,734,6,1211,471,233,501
1,"ALBA",10,4142,,240,"CRAIVA / ŞCOALA PRIMARA",3,319,"CRICĂU",4142,303,226,204,22,0,226,0,327,101,67,159
1,"ALBA",10,4142,,241,"TIBRU / SALA DE INTRUNIRI",3,319,"CRICĂU",4142,333,256,216,32,8,253,3,367,111,43,210
1,"ALBA",10,9019,,242,"CUT / Şcoala Generală cu cls.I-VIII ,,Septimiu Albini""",3,323,"CUT",9019,1065,756,690,65,1,752,4,1176,420,225,527
1,"ALBA",10,4240,,243,"DAIA ROMÂNĂ / PRIMĂRIA DAIA ROMÂNĂ",3,325,"DAIA ROMÂNĂ",4240,1062,687,645,42,0,684,3,1171,484,91,593
1,"ALBA",10,4240,,244,"DAIA ROMÂNĂ / PRIMĂRIA DAIA ROMÂNĂ",3,325,"DAIA ROMÂNĂ",4240,1456,864,835,29,0,858,6,1602,738,147,711
1,"ALBA",10,4268,,245,"DOŞTAT / ŞCOALA GIMNAZIALĂ DOŞTAT",3,327,"DOŞTAT",4268,417,333,270,59,4,333,0,458,125,81,252
1,"ALBA",10,4268,,246,"BOZ / ŞCOALA PRIMARĂ BOZ",3,327,"DOŞTAT",4268,345,254,223,31,0,251,3,380,126,58,193
1,"ALBA",10,4302,,247,"FĂRĂU / GRĂDINIŢA FĂRĂU",3,331,"FĂRĂU",4302,482,295,260,30,5,293,2,532,237,103,190
1,"ALBA",10,4302,,248,"HERIA / ŞCOALA HERIA",3,331,"FĂRĂU",4302,236,164,141,21,2,163,1,259,95,44,119
1,"ALBA",10,4302,,249,"SÎNBENEDIC / ŞCOALA SANBENEDIC",3,331,"FĂRĂU",4302,204,158,131,21,6,158,0,227,69,29,129
1,"ALBA",10,4302,,250,"MEDVEŞ / ŞCOALA MEDVEŞ",3,331,"FĂRĂU",4302,157,113,95,15,3,111,2,172,59,11,100
1,"ALBA",10,4302,,251,"ŞILEA / ŞCOALA ŞILEA",3,331,"FĂRĂU",4302,274,179,160,15,4,178,1,297,118,47,131
1,"ALBA",10,4366,,252,"GALDA DE JOS / CAMINUL CULTURAL GALDA DE JOS",3,337,"GALDA DE JOS",4366,1546,1027,933,91,3,1017,10,1700,673,255,762
1,"ALBA",10,4366,,253,"BENIC / SCOALA GENERALA BENIC",3,337,"GALDA DE JOS",4366,441,307,276,31,0,302,5,485,178,74,228
1,"ALBA",10,4366,,254,"CETEA / SCOALA GENERALA CETEA",3,337,"GALDA DE JOS",4366,370,254,212,42,0,252,2,405,151,60,192
1,"ALBA",10,4366,,255,"GALDA DE SUS / SCOALA GENERALA GALDA DE SUS",3,337,"GALDA DE JOS",4366,370,242,197,45,0,240,2,410,168,62,178
1,"ALBA",10,4366,,256,"MESENTEA / SCOALA GENERALA MESENTEA",3,337,"GALDA DE JOS",4366,189,133,109,24,0,133,0,210,77,42,91
1,"ALBA",10,4366,,257,"OIEJDEA / CAMINUL CULTURAL OIEJDEA",3,337,"GALDA DE JOS",4366,693,421,381,40,0,421,0,767,346,63,358
1,"ALBA",10,4366,,258,"POIANA GALDEI / SCOALA GENERALA POIANA GALDEI",3,337,"GALDA DE JOS",4366,131,89,68,21,0,86,3,145,56,20,66
1,"ALBA",10,4482,,259,"GÎRBOVA / Primaria com Gîrbova",3,349,"GÎRBOVA",4482,1174,778,712,57,9,770,8,1291,513,164,606
1,"ALBA",10,4482,,260,"CĂRPINIŞ / Clădirea fostei primării",3,349,"GÎRBOVA",4482,209,163,127,36,0,162,1,232,69,50,112
1,"ALBA",10,4482,,261,"RECIU / Clădirea fostei primarii",3,349,"GÎRBOVA",4482,262,172,138,28,6,170,2,288,116,20,150
1,"ALBA",10,4525,,262,"GÎRDA DE SUS / Şcoala gimnazială ""EmilRacoviţă"" Gîrda de Sus",3,353,"GÎRDA DE SUS",4525,862,619,545,73,1,617,2,952,333,174,443
1,"ALBA",10,4525,,263,"BIHARIA / Şcoala sat Biharia",3,353,"GÎRDA DE SUS",4525,139,86,79,7,0,85,1,151,65,22,63
1,"ALBA",10,4525,,264,"GHEŢARI / Şcoala gimnazială Gheţari",3,353,"GÎRDA DE SUS",4525,442,304,285,19,0,303,1,485,181,30,273
1,"ALBA",10,4703,,265,"HOPÎRTA / CĂMIN CULTURAL",3,371,"HOPÎRTA",4703,250,168,138,30,0,168,0,273,105,34,134
1,"ALBA",10,4703,,266,"SILIVAŞ / CĂMIN CULTURAL",3,371,"HOPÎRTA",4703,191,142,125,17,0,141,1,210,68,29,112
1,"ALBA",10,4703,,267,"ŞPĂLNACA / CĂMIN CULTURAL",3,371,"HOPÎRTA",4703,168,130,94,36,0,129,1,184,54,38,91
1,"ALBA",10,4703,,268,"TURDAŞ / CĂMIN CULTURAL",3,371,"HOPÎRTA",4703,164,133,93,40,0,132,1,182,49,25,107
1,"ALBA",10,4703,,269,"VAMA SEACĂ / CĂMIN CULTURAL",3,371,"HOPÎRTA",4703,159,127,107,19,1,127,0,175,48,18,109
1,"ALBA",10,4767,,270,"HOREA / ŞCOALA CLS.I-VIII. HOREA",3,377,"HOREA",4767,643,463,414,46,3,459,4,707,244,132,327
1,"ALBA",10,4767,,271,"DÎRLEŞTI / ŞCOALA CLS.I-IV SAT.DIRLEŞTI",3,377,"HOREA",4767,389,306,292,12,2,303,3,428,122,93,210
1,"ALBA",10,4767,,272,"GIURGIUŢ / ŞCOALA CLS.I-IV SAT.GIURGIUŢ",3,377,"HOREA",4767,128,76,62,14,0,75,1,141,65,20,55
1,"ALBA",10,4767,,273,"MĂTIŞEŞTI / CAMIN CULTURAL SAT.MĂTIŞEŞTI",3,377,"HOREA",4767,353,285,268,13,4,283,2,389,104,56,227
1,"ALBA",10,4767,,274,"PĂTRUŞEŞTI / ŞCOALA CLS.I-IV SAT.PĂTRUŞEŞTI",3,377,"HOREA",4767,142,121,106,14,1,120,1,157,36,24,96
1,"ALBA",10,4767,,275,"PRELUCA / ŞCOALA CLS.I-IV SAT.PRELUCA",3,377,"HOREA",4767,65,67,55,12,0,67,0,78,11,23,44
1,"ALBA",10,4927,,276,"IGHIU / PRIMĂRIA COMUNEI IGHIU",3,393,"IGHIU",4927,1157,800,747,49,4,796,4,1279,479,183,613
1,"ALBA",10,4927,,277,"Bucerdea Vinoasă / ŞCOALA GENERALĂ BUCERDEA VINOASĂ",3,393,"IGHIU",4927,780,575,517,52,6,571,4,862,287,145,426
1,"ALBA",10,4927,,278,"IGHIEL / ŞCOALA GENERALĂ IGHIEL",3,393,"IGHIU",4927,823,530,512,18,0,522,8,908,378,82,440
1,"ALBA",10,4927,,279,"ŞARD / ŞCOALA GENERALĂ ŞARD",3,393,"IGHIU",4927,924,608,559,49,0,601,7,1013,405,161,440
1,"ALBA",10,4927,,280,"ŞARD / ŞCOALA GENERALĂ ŞARD",3,393,"IGHIU",4927,976,606,581,25,0,597,9,1071,465,172,425
1,"ALBA",10,4927,,281,"ŢELNA / ŞCOALĂ GENERALĂ ŢELNA",3,393,"IGHIU",4927,888,509,479,29,1,509,0,975,466,122,387
1,"ALBA",10,4981,,282,"ÎNTREGALDE / ŞCOALA CU CLASELE I-VIII ÎNTREGALDE",3,399,"ÎNTREGALDE",4981,245,143,127,15,1,142,1,269,126,30,112
1,"ALBA",10,4981,,283,"DEALU GEOAGIULUI / ŞCOALA CU CLASELE I-IV DEALUL GEOAGIULUI",3,399,"ÎNTREGALDE",4981,104,61,43,18,0,61,0,116,55,6,55
1,"ALBA",10,4981,,284,"GHIONCANI / ŞCOALA CU CLASELE I-IV  GHIONCANI",3,399,"ÎNTREGALDE",4981,71,54,38,16,0,54,0,84,30,15,39
1,"ALBA",10,4981,,285,"NECRILEŞTI /  ŞCOALA CU CLASELE I-IV NECRILEŞTI",3,399,"ÎNTREGALDE",4981,168,130,108,22,0,130,0,185,55,29,101
1,"ALBA",10,5103,,286,"JIDVEI / CĂMINUL CULTURAL JIDVEI",3,411,"JIDVEI",5103,1052,615,583,31,1,607,8,1157,542,129,478
1,"ALBA",10,5103,,287,"BĂLCACIU / ŞCOALA GENERALĂ BĂLCACIU",3,411,"JIDVEI",5103,1073,617,558,37,22,605,12,1178,561,99,506
1,"ALBA",10,5103,,288,"CĂPÎLNA DE JOS / Scoala Generală Căpâlna de Jos",3,411,"JIDVEI",5103,647,433,405,27,1,431,2,711,278,106,325
1,"ALBA",10,5103,,289,"FEISA / CĂMIN  CULTURAL FEISA",3,411,"JIDVEI",5103,686,481,447,24,10,477,4,755,274,115,362
1,"ALBA",10,5103,,290,"VESEUŞ / CĂMIN  CULTURAL VESEUŞ",3,411,"JIDVEI",5103,752,555,519,19,17,548,7,827,272,53,495
1,"ALBA",10,5167,,291,"LIVEZILE / CĂMIN CULTURAL",3,417,"LIVEZILE",5167,618,432,397,34,1,419,13,678,246,136,283
1,"ALBA",10,5167,,292,"POIANA AIUDULUI / CĂMIN CULTURAL",3,417,"LIVEZILE",5167,297,213,162,51,0,207,6,328,115,75,132
1,"ALBA",10,5167,,293,"IZVOARELE / SCOALA PRIMARĂ",3,417,"LIVEZILE",5167,121,85,52,28,5,85,0,137,52,25,60
1,"ALBA",10,5167,,294,"VĂLIŞOARA / ŞCOALA PRIMARĂ",3,417,"LIVEZILE",5167,124,101,60,41,0,100,1,138,37,27,73
1,"ALBA",10,5210,,295,"LOPADEA NOUĂ / PRIMĂRIA LOPADEA NOUĂ",3,422,"LOPADEA NOUĂ",5210,842,534,497,21,16,532,2,926,392,29,503
1,"ALBA",10,5210,,296,"ASINIP / CĂMIN  CULTURAL",3,422,"LOPADEA NOUĂ",5210,95,85,52,30,3,84,1,110,25,29,55
1,"ALBA",10,5210,,297,"BĂGĂU / CLĂDIRE ANEXĂ PRIMĂRIA LOPADEA NOUĂ",3,422,"LOPADEA NOUĂ",5210,453,313,273,37,3,313,0,502,189,71,242
1,"ALBA",10,5210,,298,"BEŢA / ŞCOLA GENERALĂ  CU CLASELE I-IV BEŢA",3,422,"LOPADEA NOUĂ",5210,326,208,182,22,4,208,0,359,151,20,188
1,"ALBA",10,5210,,299,"CIUGUZEL / CLĂDIRE ANEXĂ  PRIMĂRIA  LOPADEA NOUĂ",3,422,"LOPADEA NOUĂ",5210,546,404,361,34,9,403,1,601,197,98,305
1,"ALBA",10,5210,,300,"ODVEREM / CLĂDIRE ANEXĂ PRIMARIA LOPADEA NOUĂ",3,422,"LOPADEA NOUĂ",5210,48,43,24,19,0,43,0,62,19,15,28
1,"ALBA",10,5309,,301,"LUNCA MUREŞULUI / Şcoala cls. I-VIII ""Simion Lazăr""Lunca Mureşului, Str.Gării nr. 241A",3,431,"LUNCA MUREŞULUI",5309,789,463,427,36,0,462,1,868,405,87,375
1,"ALBA",10,5309,,302,"LUNCA MUREŞULUI / Scoala cls.I-VIII "" Simion Lazar"" Lunca Muresului",3,431,"LUNCA MUREŞULUI",5309,862,522,494,26,2,517,5,949,427,98,419
1,"ALBA",10,5309,,303,"GURA ARIEŞULUI / Şcoala Generală cls.I-IV Gura Arieşului,nr.84",3,431,"LUNCA MUREŞULUI",5309,409,283,252,31,0,279,4,450,167,91,188
1,"ALBA",10,5336,,304,"LUPŞA / CĂMINUL CULTURAL",3,434,"LUPŞA",5336,681,494,440,53,1,491,3,746,252,193,298
1,"ALBA",10,5336,,305,"HĂDĂRĂU / ŞCOALA CU CLASELE I-IV",3,434,"LUPŞA",5336,329,230,211,19,0,229,1,366,136,98,131
1,"ALBA",10,5336,,306,"VALEA LUPŞII / ŞCOALA CU CLASELE I-IV",3,434,"LUPŞA",5336,764,460,432,28,0,456,4,843,383,172,284
1,"ALBA",10,5336,,307,"MUŞCA / SEDIUL FOSTEI PRIMĂRII MUŞCA",3,434,"LUPŞA",5336,1001,565,538,27,0,561,4,1102,537,272,289
1,"ALBA",10,5577,,308,"LUNCA AMPOIŢEI / SCOALA CU CLASELE I-IV",3,458,"METEŞ",5577,219,154,131,23,0,154,0,243,89,32,122
1,"ALBA",10,5577,,309,"PRESACA AMPOIULUI / SCOALA CU CLASELE I-IV",3,458,"METEŞ",5577,332,243,219,19,5,242,1,367,124,85,157
1,"ALBA",10,5577,,310,"METEŞ / SCOALA CU CLASELE I-VIII",3,458,"METEŞ",5577,547,322,293,29,0,316,6,603,281,143,173
1,"ALBA",10,5577,,311,"AMPOIŢA / SCOALA CU CLASELE I-VIII",3,458,"METEŞ",5577,570,384,330,54,0,382,2,629,245,133,249
1,"ALBA",10,5577,,312,"TĂUŢI / SCOALA CU CLASELE I-VIII",3,458,"METEŞ",5577,579,390,361,26,3,390,0,641,251,148,242
1,"ALBA",10,5577,,313,"POIANA AMPOIULUI / CAMINUL CULTURAL POIANA AMPOIULUI",3,458,"METEŞ",5577,229,165,143,22,0,164,1,251,86,81,83
1,"ALBA",10,5700,,314,"MIHALŢ / Şcoala generală Mihalţ",3,471,"MIHALŢ",5700,1031,753,685,50,18,749,4,1139,386,236,513
1,"ALBA",10,5700,,315,"MIHALŢ / Şcoala generală Mihalţ",3,471,"MIHALŢ",5700,840,621,534,70,17,616,5,925,304,270,346
1,"ALBA",10,5700,,316,"CISTEI / Şcoala generală Cistei",3,471,"MIHALŢ",5700,475,363,331,31,1,359,4,524,161,150,209
1,"ALBA",10,5700,,317,"OBREJA / Şcoala generală Obreja",3,471,"MIHALŢ",5700,480,417,349,52,16,416,1,526,109,167,249
1,"ALBA",10,5755,,318,"MIRĂSLĂU / Grădiniţa cu Program Normal Mirăslău",3,476,"MIRĂSLĂU",5755,727,463,412,34,17,459,4,800,337,115,344
1,"ALBA",10,5755,,319,"CICĂU / Şcoala Primară Cicău",3,476,"MIRĂSLĂU",5755,120,88,66,18,4,88,0,133,45,21,67
1,"ALBA",10,5755,,320,"DECEA / Şcoala Primară Decea",3,476,"MIRĂSLĂU",5755,674,412,359,34,19,411,1,739,327,76,335
1,"ALBA",10,5755,,321,"LOPADEA VECHE / Şcoala Primara Lopadea Veche",3,476,"MIRĂSLĂU",5755,247,179,153,22,4,176,3,274,95,60,116
1,"ALBA",10,5755,,322,"ORMENIŞ / Şcoala Primară Ormeniş",3,476,"MIRĂSLĂU",5755,63,59,38,21,0,59,0,77,18,23,36
1,"ALBA",10,5826,,323,"MOGOŞ / CONSILIUL LOCAL AL COMUNEI MOGOŞ",3,483,"MOGOŞ",5826,522,292,248,44,0,288,4,576,284,85,203
1,"ALBA",10,5826,,324,"BUTEŞTI / ŞCOALA  CU  CLASELE  I-IV , SAT  BUTEŞTI",3,483,"MOGOŞ",5826,70,48,35,13,0,48,0,83,35,11,37
1,"ALBA",10,5826,,325,"VALEA BARNII / CĂMINUL CULTURAL SAT VALEA BARNII",3,483,"MOGOŞ",5826,159,81,61,20,0,79,2,174,93,28,51
1,"ALBA",10,6048,,326,"NOŞLAC / PrimĂria Noslac",3,505,"NOŞLAC",6048,977,583,517,65,1,580,3,1083,500,124,456
1,"ALBA",10,6048,,327,"GĂBUD / Şcoala generală Găbud",3,505,"NOŞLAC",6048,207,135,102,33,0,133,2,227,92,38,95
1,"ALBA",10,6048,,328,"STÂNA DE MUREŞ / Şcoala generală  Stîna de Mureş",3,505,"NOŞLAC",6048,322,217,168,44,5,217,0,355,138,53,164
1,"ALBA",10,6119,,329,"OCOLIŞ / Internat Şcolar Ocoliş",3,512,"OCOLIŞ",6119,293,219,165,54,0,216,3,322,103,44,172
1,"ALBA",10,6119,,330,"LUNCA LARGĂ / Tabăra de Creaţie si Odihnă Avram Iancu",3,512,"OCOLIŞ",6119,57,53,38,15,0,52,1,70,17,18,34
1,"ALBA",10,6119,,331,"RUNC / Scoala Primară Runc",3,512,"OCOLIŞ",6119,130,97,84,13,0,96,1,143,46,24,72
1,"ALBA",10,6119,,332,"VIDOLM / Scoala Primară Vidolm",3,512,"OCOLIŞ",6119,65,68,35,33,0,67,1,78,10,26,41
1,"ALBA",10,6164,,333,"OHABA / CONSILIUL LOCAL OHABA",3,517,"OHABA",6164,400,286,234,31,21,284,2,442,156,107,177
1,"ALBA",10,6164,,334,"COLIBI /  ŞCOALA GENERALĂ",3,517,"OHABA",6164,35,38,21,17,0,35,3,48,10,10,25
1,"ALBA",10,6164,,335,"SECĂŞEL / FOSTUL SEDIU  C.A.P.",3,517,"OHABA",6164,182,171,114,46,11,171,0,202,31,43,128
1,"ALBA",10,6217,,336,"PIANU DE SUS / Şcoala Generală cu clasele I-VIII Pianu de Sus",3,522,"PIANU",6217,1387,879,806,57,16,872,7,1528,649,124,748
1,"ALBA",10,6217,,337,"PIANU DE JOS / Şcoala Generală cu clasele I-IV Pianu de Jos",3,522,"PIANU",6217,1116,641,572,64,5,638,3,1227,586,150,488
1,"ALBA",10,6217,,338,"PLAIURI / Şcoala Generală cu clasele I-IV Plaiuri",3,522,"PIANU",6217,43,30,16,14,0,30,0,56,26,5,25
1,"ALBA",10,6217,,339,"PURCĂREŢI / Şcoala Generală cu clasele I-IV Purcăreţi",3,522,"PIANU",6217,223,122,110,12,0,122,0,245,123,22,100
1,"ALBA",10,6217,,340,"STRUNGARI / Şcoala Generală  cu clasele I-VIII Strungari",3,522,"PIANU",6217,181,142,106,36,0,142,0,200,58,31,111
1,"ALBA",10,6271,,341,"POIANA VADULUI / CĂMINUL CULTURAL SAT POIANA VADULUI",3,528,"POIANA VADULUI",6271,907,489,446,43,0,485,4,1002,513,140,345
1,"ALBA",10,6397,,342,"PONOR / PRIMARIA COMUNEI PONOR",3,540,"PONOR",6397,324,248,176,70,2,245,3,361,113,123,122
1,"ALBA",10,6397,,343,"GEOGEL / CAMINUL CULTURAL GEOGEL",3,540,"PONOR",6397,179,121,98,23,0,120,1,197,76,32,88
1,"ALBA",10,6468,,344,"POŞAGA DE JOS / CAMIN CULTURAL",3,547,"POŞAGA",6468,365,228,202,22,4,226,2,401,173,64,162
1,"ALBA",10,6468,,345,"LUNCA / ŞCOALA CU CLASELE I-IV LUNCA",3,547,"POŞAGA",6468,123,96,65,31,0,95,1,136,40,26,69
1,"ALBA",10,6468,,346,"ORĂŞTI / ŞCOALA CU CLASELE I-IV ORĂŞTI",3,547,"POŞAGA",6468,108,83,66,15,2,82,1,121,38,20,62
1,"ALBA",10,6468,,347,"POŞAGA DE SUS / ŞCOALA CU CLASELE I-IV POŞGA DE SUS",3,547,"POŞAGA",6468,154,110,91,13,6,110,0,170,60,31,79
1,"ALBA",10,6468,,348,"SAGAGEA / ŞCOALA CU CLASELE I-IV SĂGAGEA",3,547,"POŞAGA",6468,202,137,119,18,0,135,2,222,85,20,115
1,"ALBA",10,6547,,349,"RĂDEŞTI / CĂMIN CULTURAL RĂDEŞTI",3,555,"RĂDEŞTI",6547,593,427,380,41,6,427,0,653,226,174,253
1,"ALBA",10,6547,,350,"LEORINŢ / ŞC.GEN. CU CLS.I-IV LEORINŢ",3,555,"RĂDEŞTI",6547,254,199,169,29,1,197,2,284,85,43,154
1,"ALBA",10,6547,,351,"MEŞCREAC / ŞC.GEN. CU CLS.I-IV MEŞCREAC",3,555,"RĂDEŞTI",6547,257,196,164,32,0,195,1,283,87,48,147
1,"ALBA",10,6592,,352,"RIMETEA / CĂMINUL CULTURAL RIMETEA",3,574,"RIMETEA",6592,491,346,237,109,0,340,6,538,192,42,298
1,"ALBA",10,6592,,353,"COLŢEŞTI / ŞCOALA CU CLASELE I-IV COLŢEŞTI",3,574,"RIMETEA",6592,468,242,203,39,0,242,0,519,277,18,224
1,"ALBA",10,6627,,354,"RÎMEŢ / PRIMĂRIA COMUNEI RÎMEŢ",3,560,"RÎMEŢ",6627,185,106,73,33,0,103,3,204,98,32,71
1,"ALBA",10,6627,,355,"VALEA INZELULUI / ŞCOALA CU CLS I-IV VALEA INZELULUI",3,560,"RÎMEŢ",6627,84,63,42,21,0,63,0,98,35,23,40
1,"ALBA",10,6627,,356,"BRĂDEŞTI / ŞCOALA CU CLS I-IV BRADESTI",3,560,"RÎMEŢ",6627,96,87,59,28,0,85,2,110,23,54,31
1,"ALBA",10,6627,,357,"VALEA MĂNĂSTIRII / ŞCOALA CU CLS I-IV VALEA MÂNĂSTIRII",3,560,"RÎMEŢ",6627,147,187,92,88,7,178,9,262,75,95,83
1,"ALBA",10,6930,,358,"UNGUREI / CĂMIN CULTURAL",3,577,"ROŞIA DE SECAŞ",6930,259,188,160,28,0,186,2,282,94,77,109
1,"ALBA",10,6930,,359,"ROŞIA DE SECAŞ / PRIMĂRIA ROŞIA DE SECAŞ",3,577,"ROŞIA DE SECAŞ",6930,591,420,356,48,16,416,4,653,233,104,312
1,"ALBA",10,6930,,360,"TĂU / FOSTUL SEDIU CAP",3,577,"ROŞIA DE SECAŞ",6930,384,246,198,42,6,243,3,424,178,59,184
1,"ALBA",10,6761,,361,"GURA ROŞIEI / ŞCOALA CU CLASELE I-IV GURA ROSIEI",3,581,"ROŞIA MONTANĂ",6761,615,469,415,53,1,458,11,677,208,239,219
1,"ALBA",10,6761,,362,"VÎRTOP / ŞCOALA CU CLASELE I-IV VÎRTOP",3,581,"ROŞIA MONTANĂ",6761,178,138,112,26,0,135,3,200,62,51,84
1,"ALBA",10,6761,,363,"ROŞIA MONTANĂ / PRIMĂRIA COMUNEI ROŞIA MONTANĂ",3,581,"ROŞIA MONTANĂ",6761,765,491,447,40,4,484,7,845,354,164,320
1,"ALBA",10,6761,,364,"CĂRPINIŞ / LOCUINŢE SOCIALE CĂRPINIŞ",3,581,"ROŞIA MONTANĂ",6761,698,455,428,26,1,449,6,769,314,172,277
1,"ALBA",10,6761,,365,"CORNA / SCOALA CU CLS I-IV CORNA",3,581,"ROŞIA MONTANĂ",6761,157,138,109,29,0,134,4,172,34,64,70
1,"ALBA",10,6976,,366,"SĂLCIUA DE JOS / ŞCOALA CU CLASELE I-IV SĂLCIUA DE JOS",3,598,"SĂLCIUA",6976,740,503,419,76,8,502,1,817,314,205,297
1,"ALBA",10,6976,,367,"SĂLCIUA DE SUS / SCOALA CU CLASELE I-IV SĂLCIUA DE SUS",3,598,"SĂLCIUA",6976,633,418,370,28,20,417,1,697,279,117,300
1,"ALBA",10,7044,,368,"SĂLIŞTEA / Căminul Cultural",3,605,"SĂLIŞTEA",7044,1021,827,709,78,40,822,5,1129,302,133,689
1,"ALBA",10,7044,,369,"MĂRGINENI / Şcoala Generală Mărgineni",3,605,"SĂLIŞTEA",7044,54,39,20,19,0,39,0,67,28,3,36
1,"ALBA",10,7044,,370,"SĂLIŞTEA-DEAL / Şcoala   Generală Salistea-Deal",3,605,"SĂLIŞTEA",7044,238,181,165,15,1,177,4,261,80,11,166
1,"ALBA",10,7044,,371,"TĂRTĂRIA / Şcoala  Generală  Tărtăria",3,605,"SĂLIŞTEA",7044,575,473,396,63,14,469,4,628,155,132,337
1,"ALBA",10,7099,,372,"CĂPÎLNA / SCOALA CU CLASELE I-IV",3,610,"SĂSCIORI",7099,698,487,455,32,0,485,2,767,280,60,425
1,"ALBA",10,7099,,373,"SĂSCIORI / SCOALA CU CLASELE I-VIII",3,610,"SĂSCIORI",7099,1339,851,788,63,0,845,6,1477,626,154,691
1,"ALBA",10,7099,,374,"LAZ / ŞCOALA CU CLASELE I-IV",3,610,"SĂSCIORI",7099,341,258,227,31,0,257,1,373,115,56,201
1,"ALBA",10,7099,,375,"SEBEŞEL / ŞCOALA CU CLASELE I-IV",3,610,"SĂSCIORI",7099,986,690,642,48,0,681,9,1086,396,78,603
1,"ALBA",10,7099,,376,"LOMAN / ŞCOALA CU CLASELE I-VIII",3,610,"SĂSCIORI",7099,685,407,378,29,0,406,1,754,347,38,368
1,"ALBA",10,7099,,377,"RĂCHITA / ŞCOALA CU CLASELE I-VIII",3,610,"SĂSCIORI",7099,686,532,504,28,0,532,0,758,226,71,461
1,"ALBA",10,7197,,378,"SCĂRIŞOARA / CĂMINUL CULTURAL",3,620,"SCĂRIŞOARA",7197,649,415,369,37,9,404,11,716,301,142,262
1,"ALBA",10,7197,,379,"FAŢA-LĂZEŞTI / ŞCOALA CU CLASELE I-IV",3,620,"SCĂRIŞOARA",7197,71,65,55,10,0,64,1,84,19,12,52
1,"ALBA",10,7197,,380,"NEGEŞTI / ŞCOALA CU CLASELE I-IV",3,620,"SCĂRIŞOARA",7197,156,106,96,8,2,106,0,171,65,33,73
1,"ALBA",10,7197,,381,"RUNC / ŞCOALA CU CLASELE I-IV",3,620,"SCĂRIŞOARA",7197,155,108,100,8,0,107,1,170,62,23,84
1,"ALBA",10,7197,,382,"SFOARTEA / ŞCOALA CU CLASELE I-IV",3,620,"SCĂRIŞOARA",7197,58,57,38,19,0,57,0,71,14,24,33
1,"ALBA",10,7197,,383,"ŞTIULEŢI / ŞCOALA CU CLASELE I-IV",3,620,"SCĂRIŞOARA",7197,127,104,88,12,4,103,1,142,38,21,82
1,"ALBA",10,7197,,384,"LĂZEŞTI / ŞCOALA CU CLASELEI-VIII",3,620,"SCĂRIŞOARA",7197,154,113,87,24,2,113,0,170,57,10,103
1,"ALBA",10,7348,,385,"SÎNCEL / CĂMIN CULTURAL SÎNCEL",3,640,"SÎNCEL",7348,1349,937,856,46,35,932,5,1487,550,193,739
1,"ALBA",10,7348,,386,"ICLOD / ŞCOALA PRIMARĂ ICLOD",3,640,"SÎNCEL",7348,322,176,139,18,19,175,1,353,177,39,136
1,"ALBA",10,7348,,387,"PĂNADE / ŞCOALA PRIMARĂ PĂNADE",3,640,"SÎNCEL",7348,508,383,315,34,34,383,0,558,175,108,275
1,"ALBA",10,7384,,388,"COŞLARIU / ŞCOALA CU CLASELE I-IV",3,644,"SÎNTIMBRU",7384,360,272,219,46,7,267,5,398,126,113,154
1,"ALBA",10,7384,,389,"TOTOI / ŞCOALA CU CLASELE I-IV",3,644,"SÎNTIMBRU",7384,437,295,230,50,15,294,1,480,185,59,235
1,"ALBA",10,7384,,390,"SÎNTIMBRU / PRIMĂRIA COMUNEI SÎNTIMBRU",3,644,"SÎNTIMBRU",7384,1587,1017,916,87,14,1005,12,1751,734,268,737
1,"ALBA",10,7384,,391,"DUMITRA / CENTRU DE ZI PERSOANE VĂRSNICE",3,644,"SÎNTIMBRU",7384,84,67,54,13,0,67,0,99,32,16,51
1,"ALBA",10,7446,,392,"PELEŞ / ŞCOALA GENERALĂ PELEŞ",3,650,"SOHODOL",7446,397,213,198,15,0,209,4,439,226,68,141
1,"ALBA",10,7446,,393,"POIANA / ŞCOALA GENERALĂ POIANA",3,650,"SOHODOL",7446,137,68,53,15,0,68,0,152,84,21,47
1,"ALBA",10,7446,,394,"SOHODOL / CĂMINUL CULTURAL SOHODOL",3,650,"SOHODOL",7446,809,528,477,51,0,520,8,890,362,159,361
1,"ALBA",10,7446,,395,"LAZURI / SC HIDROCONSTRUCŢIA SA SEBEŞ PUNCT DE LUCRU SAT LAZURI",3,650,"SOHODOL",7446,187,123,105,18,0,123,0,206,83,46,77
1,"ALBA",10,7767,,396,"STREMŢ / ŞCOALA GIMNAZIALĂ STREMŢ",3,697,"STREMŢ",7767,1166,882,766,96,20,879,3,1269,387,378,501
1,"ALBA",10,7767,,397,"GEOAGIU DE SUS / ŞCOALA CU CLASELE I-VIII GEOAGIU DE SUS",3,697,"STREMŢ",7767,668,467,425,39,3,461,6,634,167,204,257
1,"ALBA",10,7767,,398,"GEOMAL / ŞCOALA CU CLASELE I-IV GEOMAL",3,697,"STREMŢ",7767,290,223,179,37,7,221,2,320,97,111,110
1,"ALBA",10,7810,,399,"ŞIBOT / CĂMINUL CULTURAL ŞIBOT",3,635,"ŞIBOT",7810,1176,771,674,88,9,759,12,1294,523,239,520
1,"ALBA",10,7810,,400,"BALOMIRU DE CÎMP / CĂMINUL CULTURAL BALOMIR",3,635,"ŞIBOT",7810,554,386,322,53,11,384,2,608,222,128,256
1,"ALBA",10,7810,,401,"BĂCĂINŢI / ŞCOALA GENERALĂ BĂCĂINŢI",3,635,"ŞIBOT",7810,225,186,133,47,6,186,0,249,63,40,146
1,"ALBA",10,7810,,402,"SĂRĂCSĂU / ŞCOALA GENERALĂ SĂRĂCSĂU",3,635,"ŞIBOT",7810,179,108,86,22,0,107,1,195,87,35,72
1,"ALBA",10,7865,,403,"LUNCA TÎRNAVEI / ŞCOALA CU CLASELE I-IV LUNCA TÎRNAVEI",3,682,"ŞONA",7865,337,227,209,17,1,227,0,368,141,47,180
1,"ALBA",10,7865,,404,"ŞONA / ŞCOALA CU CLASELE I-VIII ŞONA",3,682,"ŞONA",7865,1038,577,542,35,0,574,3,1145,568,174,400
1,"ALBA",10,7865,,405,"ALECUŞ / CĂMINUL CULTURAL ALECUŞ",3,682,"ŞONA",7865,120,67,44,23,0,66,1,133,66,21,45
1,"ALBA",10,7865,,406,"BIIA / SALA SPORT BIIA",3,682,"ŞONA",7865,975,621,591,26,4,617,4,1070,449,129,488
1,"ALBA",10,7865,,407,"SÎNMICLĂUŞ / ŞCOALA GIMNAZIALĂ  SÎNMICLĂUŞ",3,682,"ŞONA",7865,1152,724,687,37,0,718,6,1266,542,78,640
1,"ALBA",10,7945,,408,"ŞPRING / Primaria comunei Şpring",3,690,"ŞPRING",7945,607,484,398,59,27,478,6,672,188,110,368
1,"ALBA",10,7945,,409,"CUNŢA / Şcoala cu clasele I-VIII Cunţa",3,690,"ŞPRING",7945,488,361,317,29,15,360,1,535,174,56,304
1,"ALBA",10,7945,,410,"DRAŞOV / Şcoala cu clasele I-IV Draşov",3,690,"ŞPRING",7945,435,310,255,43,12,307,3,480,170,94,213
1,"ALBA",10,7945,,411,"VINGARD / Sediu administrativ Primaria Şpring",3,690,"ŞPRING",7945,575,356,288,41,27,354,2,635,279,106,248
1,"ALBA",10,8014,,412,"DOBRA / SCOALA GENERALĂ",3,702,"ŞUGAG",8014,449,322,299,23,0,320,2,496,174,27,293
1,"ALBA",10,8014,,413,"MĂRTINIE / SCOALA GENERALĂ",3,702,"ŞUGAG",8014,428,344,328,16,0,342,2,474,130,37,305
1,"ALBA",10,8014,,414,"ŞUGAG / PRIMARIE",3,702,"ŞUGAG",8014,1456,1114,1021,90,3,1112,2,1600,486,89,1023
1,"ALBA",10,8158,,415,"UNIREA / ŞCOALA GENERALĂ ""AVRAM IANCU"" UNIREA",3,710,"UNIREA",8158,992,517,472,40,5,511,6,1091,574,171,340
1,"ALBA",10,8158,,416,"UNIREA / ŞCOALA GENERALĂ ""AVRAM IANCU"" UNIREA",3,710,"UNIREA",8158,857,473,420,42,11,468,5,945,472,99,369
1,"ALBA",10,8158,,417,"UNIREA / ŞCOALA GENERALĂ ""GHEORGHE MAIER"" UNIREA",3,710,"UNIREA",8158,1209,761,705,49,7,753,8,1327,566,315,438
1,"ALBA",10,8158,,418,"CIUGUDU DE JOS / ŞCOALA GENERALĂ CIUGUDU DE JOS",3,710,"UNIREA",8158,285,168,140,28,0,167,1,315,147,52,115
1,"ALBA",10,8158,,419,"CIUGUDU DE SUS / ŞCOALA GENERALĂ CIUGUDU DE SUS",3,710,"UNIREA",8158,127,110,79,31,0,108,2,140,30,39,69
1,"ALBA",10,8158,,420,"DUMBRAVA / ŞCOALA GENERALĂ DUMBRAVA",3,710,"UNIREA",8158,305,228,160,46,22,227,1,331,103,115,112
1,"ALBA",10,8158,,421,"INOC / ŞCOALA GENERALĂ INOC",3,710,"UNIREA",8158,185,128,95,33,0,128,0,205,77,60,68
1,"ALBA",10,8158,,422,"MĂHĂCENI / ŞCOALA GENERALĂ MĂHĂCENI",3,710,"UNIREA",8158,234,150,120,30,0,149,1,255,105,53,96
1,"ALBA",10,8229,,423,"VADU MOŢILOR / CĂMIN  CULTURAL",3,717,"VADU MOŢILOR",8229,1137,693,647,44,2,686,7,1250,557,153,533
1,"ALBA",10,8354,,424,"VALEA LUNGĂ / Primăria Valea Lungă",3,730,"VALEA LUNGĂ",8354,1540,974,888,79,7,970,4,1696,722,226,744
1,"ALBA",10,8354,,425,"FĂGET / Casă particulară Făget",3,730,"VALEA LUNGĂ",8354,27,33,17,16,0,33,0,40,7,12,21
1,"ALBA",10,8354,,426,"GLOGOVEŢ / Şcoala primară Glogoveţ",3,730,"VALEA LUNGĂ",8354,136,107,83,24,0,106,1,150,43,34,72
1,"ALBA",10,8354,,427,"LODROMAN / Şcoala primară Lodroman",3,730,"VALEA LUNGĂ",8354,167,129,106,23,0,129,0,183,54,40,89
1,"ALBA",10,8354,,428,"LUNCA / Cămin cultural Lunca",3,730,"VALEA LUNGĂ",8354,379,309,225,81,3,305,4,415,106,92,213
1,"ALBA",10,8354,,429,"TĂUNI / Cămin cultural Tăuni",3,730,"VALEA LUNGĂ",8354,264,215,177,38,0,213,2,290,75,36,177
1,"ALBA",10,8425,,430,"VIDRA / PRIMĂRIA COMUNEI VIDRA",3,737,"VIDRA",8425,326,203,179,22,2,202,1,362,159,42,160
1,"ALBA",10,8425,,431,"GOIEŞTI / ŞCOALA PRIMARĂ GOIEŞTI",3,737,"VIDRA",8425,313,200,184,16,0,199,1,347,147,39,160
1,"ALBA",10,8425,,432,"PONOREL / FOSTUL SEDIU AL PRIMĂRIEI PONOREL",3,737,"VIDRA",8425,771,539,497,42,0,536,3,848,309,227,309
1,"ALBA",10,8826,,433,"VURPĂR / CĂMINUL CULTURAL",3,777,"VINŢU DE JOS",8826,864,564,535,29,0,558,6,953,389,146,412
1,"ALBA",10,8826,,434,"VINŢU DE JOS / CĂMIN CULTURAL VINŢU DE JOS",3,777,"VINŢU DE JOS",8826,1072,735,648,86,1,731,4,1180,445,213,518
1,"ALBA",10,8826,,435,"VINŢU DE JOS / Şcoala cu clasele I - IV IULIU MANIU Vinţu de Jos",3,777,"VINŢU DE JOS",8826,1290,860,791,69,0,854,6,1422,562,307,547
1,"ALBA",10,8826,,436,"VINŢU DE JOS / ŞCOALA GIMNAZIALĂ IULIU MANIU",3,777,"VINŢU DE JOS",8826,583,439,376,63,0,435,4,640,201,105,330
1,"ALBA",10,8826,,437,"INURI / CASA PAROHIALĂ INURI",3,777,"VINŢU DE JOS",8826,189,61,48,13,0,61,0,208,147,8,53
1,"ALBA",10,8826,,438,"MERETEU / CĂMIN CULTURAL MERETEU",3,777,"VINŢU DE JOS",8826,169,120,106,14,0,120,0,186,66,36,84
1,"ALBA",10,8826,,439,"VINŢU DE JOS / ŞCOALA CU CLASELE I-IV IULIU MANIU",3,777,"VINŢU DE JOS",8826,317,180,164,16,0,175,5,350,170,47,128
2,"ARAD",29,9262,,1,"ARAD / Colegiul Economic",1,797,"MUNICIPIUL ARAD",9262,939,692,486,205,1,681,11,1040,348,224,457
2,"ARAD",29,9262,,2,"ARAD / Policlinica Municipală",1,797,"MUNICIPIUL ARAD",9262,1231,771,699,72,0,746,25,1360,589,289,457
2,"ARAD",29,9262,,3,"ARAD / Spitalul Clinic Municipal  - Secţia ORL",1,797,"MUNICIPIUL ARAD",9262,1214,924,717,102,105,917,7,1340,416,361,556
2,"ARAD",29,9262,,4,"ARAD / Colegiul Naţional ""Vasile Goldiş"" (fosta Şcoala Generală nr. 4)",1,797,"MUNICIPIUL ARAD",9262,1381,896,809,85,2,887,9,1520,624,333,554
2,"ARAD",29,9262,,5,"ARAD / Colegiul Naţional ""Vasile Goldiş"" (fosta Şcoala Generala nr. 4)",1,797,"MUNICIPIUL ARAD",9262,1286,839,768,69,2,830,9,1420,581,299,531
2,"ARAD",29,9262,,6,"ARAD / Colegiul Naţional ""Vasile Goldiş"" (fosta Şcoala Generala nr. 4)",1,797,"MUNICIPIUL ARAD",9262,1005,675,597,78,0,667,8,1100,425,253,414
2,"ARAD",29,9262,,7,"ARAD / Colegiul Naţional ""Vasile Goldiş"" (fosta Şcoala Generala nr. 4)",1,797,"MUNICIPIUL ARAD",9262,1017,698,632,65,1,685,13,1120,422,277,408
2,"ARAD",29,9262,,8,"ARAD / Colegiul Naţional ""Vasile Goldiş""",1,797,"MUNICIPIUL ARAD",9262,1706,1431,1001,226,204,1412,19,1870,439,479,933
2,"ARAD",29,9262,,9,"ARAD / Liceul de Arte ""Sabin Drăgoi""",1,797,"MUNICIPIUL ARAD",9262,1090,848,672,176,0,834,14,1200,352,299,535
2,"ARAD",29,9262,,10,"ARAD / Liceul de Arte ""Sabin Drăgoi""",1,797,"MUNICIPIUL ARAD",9262,1297,912,780,132,0,905,7,1430,518,337,568
2,"ARAD",29,9262,,11,"ARAD / Liceul Tehnologic de Electronică şi Automatizări ""Caius Iacob""",1,797,"MUNICIPIUL ARAD",9262,1437,951,872,79,0,930,21,1580,629,348,582
2,"ARAD",29,9262,,12,"ARAD / Liceul Teologic Baptist ""Alexa Popovici""",1,797,"MUNICIPIUL ARAD",9262,904,643,570,72,1,633,10,1000,357,238,395
2,"ARAD",29,9262,,13,"ARAD / Liceul Teologic Baptist ""Alexa Popovici""",1,797,"MUNICIPIUL ARAD",9262,1080,633,613,20,0,625,8,1180,547,267,358
2,"ARAD",29,9262,,14,"ARAD / Licul Tehnlogic ""Iuliu Maniu""",1,797,"MUNICIPIUL ARAD",9262,1447,1001,872,129,0,981,20,1590,589,337,644
2,"ARAD",29,9262,,15,"ARAD / Sala Polivalentă",1,797,"MUNICIPIUL ARAD",9262,1018,697,635,62,0,685,12,1120,423,260,425
2,"ARAD",29,9262,,16,"ARAD / Sala Polivalentă",1,797,"MUNICIPIUL ARAD",9262,957,663,617,46,0,652,11,1060,397,228,424
2,"ARAD",29,9262,,17,"ARAD / Universitatea ""Aurel Vlaicu""",1,797,"MUNICIPIUL ARAD",9262,1411,947,868,78,1,917,30,1550,603,272,645
2,"ARAD",29,9262,,18,"ARAD / Universitatea ""Aurel Vlaicu""",1,797,"MUNICIPIUL ARAD",9262,1433,948,888,59,1,938,10,1570,622,337,601
2,"ARAD",29,9262,,19,"ARAD / Universitatea ""Aurel Vlaicu""",1,797,"MUNICIPIUL ARAD",9262,1347,867,836,30,1,854,13,1490,623,315,539
2,"ARAD",29,9262,,20,"ARAD / Universitatea ""Aurel Vlaicu'' Arad",1,797,"MUNICIPIUL ARAD",9262,1450,890,799,91,0,876,14,1600,710,285,591
2,"ARAD",29,9262,,21,"ARAD / Gradinita P.N. nr.18",1,797,"MUNICIPIUL ARAD",9262,1676,1165,1064,101,0,1143,22,1850,685,371,772
2,"ARAD",29,9262,,22,"ARAD / Şcoala Gimnazială ""Regina Maria"" (fosta Şcoala Generală nr. 12)",1,797,"MUNICIPIUL ARAD",9262,1598,1046,963,83,0,1029,17,1770,724,384,645
2,"ARAD",29,9262,,23,"ARAD / Şcoala Gimnazială ""Regina Maria"" (fosta Şcoala Generală nr. 12)",1,797,"MUNICIPIUL ARAD",9262,1405,815,728,86,1,800,15,1550,735,332,468
2,"ARAD",29,9262,,24,"ARAD / Şcoala Gimnazială ""Regina Maria"" (fosta Şcoala Generală nr. 12)",1,797,"MUNICIPIUL ARAD",9262,1522,965,900,65,0,947,18,1680,715,330,617
2,"ARAD",29,9262,,25,"ARAD / Scoala Gimnaziala ""Caius Iacob"" (fosta Şcoala Generală nr. 22)",1,797,"MUNICIPIUL ARAD",9262,1479,884,853,31,0,876,8,1630,746,289,587
2,"ARAD",29,9262,,26,"ARAD / Scoala Gimnaziala ''Caius Iacob'' (fosta Şcoala Generală nr. 22)",1,797,"MUNICIPIUL ARAD",9262,1344,767,721,45,1,759,8,1480,713,257,502
2,"ARAD",29,9262,,27,"ARAD / Scoala Gimnaziala ''Caius Iacob'' (fosta Şcoala Generală nr. 22)",1,797,"MUNICIPIUL ARAD",9262,1455,971,902,68,1,957,14,1600,629,324,633
2,"ARAD",29,9262,,28,"ARAD / Scoala Gimnaziala ''Caius Iacob'' (fosta Şcoala Generală nr. 22)",1,797,"MUNICIPIUL ARAD",9262,1540,946,837,108,1,938,8,1690,744,290,648
2,"ARAD",29,9262,,29,"ARAD / Scoala Gimnaziala ''Caius Iacob'' (fosta Şcoala Generală nr. 22)",1,797,"MUNICIPIUL ARAD",9262,1357,882,798,84,0,872,10,1490,608,308,564
2,"ARAD",29,9262,,30,"ARAD / Scoala Gimnaziala ""Caius Iacob'' (fosta Şcoala Generală nr. 22)",1,797,"MUNICIPIUL ARAD",9262,1438,930,884,46,0,917,13,1580,650,248,669
2,"ARAD",29,9262,,31,"ARAD / Direcţia de Dezvoltare şi Asistenţă Comunitară Arad",1,797,"MUNICIPIUL ARAD",9262,1523,1144,1009,134,1,1132,12,1680,536,365,767
2,"ARAD",29,9262,,32,"ARAD / Grădiniţa PP nr. 7",1,797,"MUNICIPIUL ARAD",9262,1595,1009,942,66,1,994,15,1670,661,327,667
2,"ARAD",29,9262,,33,"ARAD / Grădiniţa P.P. nr. 7",1,797,"MUNICIPIUL ARAD",9262,1612,905,838,67,0,895,10,1780,875,321,574
2,"ARAD",29,9262,,34,"ARAD / Grădiniţa P.N.18",1,797,"MUNICIPIUL ARAD",9262,1492,980,921,59,0,971,9,1640,660,293,678
2,"ARAD",29,9262,,35,"ARAD / Şcoala Generală ""Aron  Cotruş"" (fosta Şcoala Generală nr. 13)",1,797,"MUNICIPIUL ARAD",9262,1133,742,697,44,1,734,8,1250,508,226,508
2,"ARAD",29,9262,,36,"ARAD / Şcoala Generală ""Aron  Cotruş"" (fosta Şcoala Generală nr. 13)",1,797,"MUNICIPIUL ARAD",9262,1767,1113,1069,43,1,1094,19,1940,827,397,697
2,"ARAD",29,9262,,37,"ARAD / Şcoala Generală ""Aron  Cotruş"" (fosta Şcoala Generală nr. 13)",1,797,"MUNICIPIUL ARAD",9262,1233,883,800,83,0,874,9,1360,477,303,571
2,"ARAD",29,9262,,38,"ARAD / Şcoala Generală ""Aron  Cotruş"" (fosta Şcoala Generală nr. 13)",1,797,"MUNICIPIUL ARAD",9262,1418,935,874,61,0,916,19,1550,615,315,601
2,"ARAD",29,9262,,39,"ARAD / Grădiniţa P.P. nr. 11",1,797,"MUNICIPIUL ARAD",9262,1368,832,799,33,0,821,11,1510,678,237,584
2,"ARAD",29,9262,,40,"ARAD / Şcoala Generală ""Aron Cotruş"" (fosta Şcoala Generală nr. 13)",1,797,"MUNICIPIUL ARAD",9262,888,568,485,83,0,563,5,970,402,147,416
2,"ARAD",29,9262,,41,"ARAD / Şcoala Generală ""Aron Cotruş"" (fosta Şcoala Generală nr. 13)",1,797,"MUNICIPIUL ARAD",9262,1227,844,796,48,0,834,10,1350,506,299,535
2,"ARAD",29,9262,,42,"ARAD / Şcoala Generală  ""Aron Cotruş"" (fosta Şcoala Generală nr. 13)",1,797,"MUNICIPIUL ARAD",9262,1403,933,880,51,2,924,9,1540,607,299,625
2,"ARAD",29,9262,,43,"ARAD / Grădiniţa cu Program Normal nr. 9",1,797,"MUNICIPIUL ARAD",9262,627,817,368,63,386,808,9,840,23,507,301
2,"ARAD",29,9262,,44,"ARAD / Gradinita P.S. nr.1",1,797,"MUNICIPIUL ARAD",9262,1305,989,697,78,214,963,26,1290,301,444,519
2,"ARAD",29,9262,,45,"ARAD / Şcoala Generală ""Aurel Vlaicu""(fosta Şcoala Generală nr. 21)",1,797,"MUNICIPIUL ARAD",9262,1369,914,794,120,0,902,12,1510,596,297,605
2,"ARAD",29,9262,,46,"ARAD / Şcoala Generală ""Aurel Vlaicu""(fosta Şcoala Generală nr. 21)",1,797,"MUNICIPIUL ARAD",9262,1126,853,717,136,0,835,18,1230,377,282,553
2,"ARAD",29,9262,,47,"ARAD / Şcoala Generală ""Aurel Vlaicu"" (fosta Şcoala Generală nr.21)",1,797,"MUNICIPIUL ARAD",9262,1299,877,802,75,0,867,10,1430,553,306,561
2,"ARAD",29,9262,,48,"ARAD / Scoala Gimnaziala ''Nicolae Balcescu''(fosta Sc. Gen: nr.11)",1,797,"MUNICIPIUL ARAD",9262,1783,1082,1022,60,0,1065,17,1960,878,361,704
2,"ARAD",29,9262,,49,"ARAD / Scoala Gimnaziala  ''Nicolae Balcescu''(fosta Sc. Gen.nr.11)",1,797,"MUNICIPIUL ARAD",9262,1737,1003,924,79,0,983,20,1910,907,311,672
2,"ARAD",29,9262,,50,"ARAD / Şcoala Gimnazială ""Nicolae Bălcescu"" (fosta Sc. Gen.nr.11)",1,797,"MUNICIPIUL ARAD",9262,1342,763,731,32,0,755,8,1480,717,275,480
2,"ARAD",29,9262,,51,"ARAD / Grădiniţa PP nr.17",1,797,"MUNICIPIUL ARAD",9262,1669,1081,993,87,1,1061,20,1840,759,398,663
2,"ARAD",29,9262,,52,"ARAD / Grădiniţa PP nr.17",1,797,"MUNICIPIUL ARAD",9262,1678,1045,953,91,1,1027,18,1840,795,352,675
2,"ARAD",29,9262,,53,"ARAD / Centrul de Vârstnici",1,797,"MUNICIPIUL ARAD",9262,1604,988,872,116,0,981,7,1770,782,350,631
2,"ARAD",29,9262,,54,"ARAD / Grădiniţa P.N. nr. 8",1,797,"MUNICIPIUL ARAD",9262,1696,1117,1038,79,0,1104,13,1860,743,281,823
2,"ARAD",29,9262,,55,"ARAD / Grădiniţa P.P. nr. 8",1,797,"MUNICIPIUL ARAD",9262,1653,983,939,44,0,966,17,1810,827,209,757
2,"ARAD",29,9262,,56,"ARAD / Şcoala Gimnazială ""Fraţii Neumann"" (fosta Şcoala Generala nr. 10)",1,797,"MUNICIPIUL ARAD",9262,883,541,510,31,0,534,7,970,429,141,393
2,"ARAD",29,9262,,57,"ARAD / Şcoala Gimnazială ""Fraţii Neumann"" (fosta Şcoala Generala nr. 10)",1,797,"MUNICIPIUL ARAD",9262,1399,898,837,59,2,883,15,1540,642,263,620
2,"ARAD",29,9262,,58,"ARAD / Liceul cu Program Sportiv (fosta Şcoala Generala nr. 9)",1,797,"MUNICIPIUL ARAD",9262,1550,941,902,39,0,932,9,1710,769,257,675
2,"ARAD",29,9262,,59,"ARAD / Liceul cu Program Sportiv (fosta Şcoala Generala nr. 9)",1,797,"MUNICIPIUL ARAD",9262,1263,699,671,28,0,687,12,1390,691,178,509
2,"ARAD",29,9262,,60,"ARAD / Liceul cu Program Sportiv (fosta Şcoala Generala nr. 9)",1,797,"MUNICIPIUL ARAD",9262,1492,793,763,30,0,789,4,1640,847,204,585
2,"ARAD",29,9262,,61,"ARAD / Liceul cu Program Sportiv (fosta Şcoala Generala nr. 9)",1,797,"MUNICIPIUL ARAD",9262,1211,678,653,25,0,670,8,1330,652,162,508
2,"ARAD",29,9262,,62,"ARAD / Grădiniţa P.P. nr. 16",1,797,"MUNICIPIUL ARAD",9262,1740,1042,973,68,1,1033,9,1920,878,319,714
2,"ARAD",29,9262,,63,"ARAD / Grădiniţa P.P. nr. 16",1,797,"MUNICIPIUL ARAD",9262,1664,936,860,76,0,922,14,1830,894,317,605
2,"ARAD",29,9262,,64,"ARAD / Colegiul Tehnic de Construcţii şi Protectia Mediului (fosta Şcoala Generală nr.6)",1,797,"MUNICIPIUL ARAD",9262,1526,952,862,90,0,936,16,1670,718,325,611
2,"ARAD",29,9262,,65,"ARAD / Colegiul Tehnic de Construcţii şi Protectia Mediului (fosta Şcoala Generală nr. 6)",1,797,"MUNICIPIUL ARAD",9262,1583,990,904,85,1,983,7,1737,747,359,624
2,"ARAD",29,9262,,66,"ARAD / Grădiniţa P.P. nr. 10",1,797,"MUNICIPIUL ARAD",9262,1755,1012,960,52,0,996,16,1930,918,355,641
2,"ARAD",29,9262,,67,"ARAD / Gradinita P.P. nr.10",1,797,"MUNICIPIUL ARAD",9262,1488,987,936,51,0,971,16,1640,653,368,603
2,"ARAD",29,9262,,68,"ARAD / Şcoala Gimnazială ""Avram Iancu"" (fosta Şcoala Generală nr. 18)",1,797,"MUNICIPIUL ARAD",9262,1230,836,750,86,0,832,4,1350,514,307,525
2,"ARAD",29,9262,,69,"ARAD / Şcoala Gimnazială ""Avram Iancu"" (fosta Şcoala Generală nr. 18)",1,797,"MUNICIPIUL ARAD",9262,1509,962,906,56,0,943,19,1660,698,321,622
2,"ARAD",29,9262,,70,"ARAD / Grădiniţa P.N. nr. 16",1,797,"MUNICIPIUL ARAD",9262,1344,806,767,39,0,792,14,1470,664,211,581
2,"ARAD",29,9262,,71,"ARAD / Colegiul Tehnic de Construcţii şi Protectia Mediului",1,797,"MUNICIPIUL ARAD",9262,1386,829,732,96,1,817,12,1520,691,225,592
2,"ARAD",29,9262,,72,"ARAD / Colegiul Tehnic de Construcţii şi Protecţia Mediului",1,797,"MUNICIPIUL ARAD",9262,1494,836,770,65,1,832,4,1640,804,239,593
2,"ARAD",29,9262,,73,"ARAD / Şcoala Gimnazială ""Ilarion Felea"" (fosta Şcoala Geneală nr. 8)",1,797,"MUNICIPIUL ARAD",9262,1460,737,684,53,0,727,10,1600,863,260,467
2,"ARAD",29,9262,,74,"ARAD / Agentia Natională de Administrare Fiscală, fosta Directie Vamală",1,797,"MUNICIPIUL ARAD",9262,1148,694,599,95,0,684,10,1270,576,223,461
2,"ARAD",29,9262,,75,"ARAD / Agentia Natională de Administrare Fiscală, fosta Directie Vamală",1,797,"MUNICIPIUL ARAD",9262,1084,710,613,96,1,701,9,1180,470,169,532
2,"ARAD",29,9262,,76,"ARAD / Grădiniţa  P.N. nr. 12",1,797,"MUNICIPIUL ARAD",9262,1682,1025,898,63,64,1003,22,1850,825,347,656
2,"ARAD",29,9262,,77,"ARAD / Gradinita P.N. nr.12",1,797,"MUNICIPIUL ARAD",9262,1295,765,645,37,83,750,15,1430,665,266,484
2,"ARAD",29,9262,,78,"ARAD / Centru pentru acordarea ajutoarelor băneşti pentru încălzirea locuinţelor",1,797,"MUNICIPIUL ARAD",9262,1625,944,822,120,2,931,13,1780,836,255,676
2,"ARAD",29,9262,,79,"ARAD / Şcoala Gimnazială ""Iosif Moldovan"" (fosta Şcoala Generală nr. 3)",1,797,"MUNICIPIUL ARAD",9262,1592,924,879,44,1,915,9,1750,826,255,660
2,"ARAD",29,9262,,80,"ARAD / Şcoala Gimnazială ""Iosif Moldovan"" (fosta Şcoala Generală nr. 3)",1,797,"MUNICIPIUL ARAD",9262,1762,1019,965,53,1,1009,10,1940,921,263,746
2,"ARAD",29,9262,,81,"ARAD / Şcoala Gimnazială ""Iosif Moldovan"" (fosta Şcoala Generală nr. 3)",1,797,"MUNICIPIUL ARAD",9262,1301,803,736,67,0,791,12,1430,627,240,551
2,"ARAD",29,9262,,82,"ARAD / Şcoala Gimnazială ""Iosif Moldovan"" (fosta Şcoala Generală nr. 3)",1,797,"MUNICIPIUL ARAD",9262,1260,825,753,72,0,810,15,1390,565,223,587
2,"ARAD",29,9262,,83,"ARAD / Şcoala Gimnazială ""Iosif Moldovan"" (fosta Şcoala Generală nr. 3)",1,797,"MUNICIPIUL ARAD",9262,1415,836,784,52,0,821,15,1560,724,231,590
2,"ARAD",29,9262,,84,"ARAD / Şcoală Gimnazială ""Iosif Moldovan"" (fosta Şcoala Generală nr. 3)",1,797,"MUNICIPIUL ARAD",9262,1550,805,748,57,0,792,13,1710,905,245,547
2,"ARAD",29,9262,,85,"ARAD / Caminul Social",1,797,"MUNICIPIUL ARAD",9262,1726,964,900,64,0,952,12,1900,936,277,675
2,"ARAD",29,9262,,86,"ARAD / Grădiniţa P.P. nr.9",1,797,"MUNICIPIUL ARAD",9262,1272,696,608,88,0,687,9,1400,704,183,504
2,"ARAD",29,9262,,87,"ARAD / Grădiniţa P.P. nr. 9",1,797,"MUNICIPIUL ARAD",9262,1421,825,776,49,0,807,18,1560,735,243,564
2,"ARAD",29,9262,,88,"ARAD / SCPCB Mureşul",1,797,"MUNICIPIUL ARAD",9262,346,257,207,30,20,253,4,380,123,98,155
2,"ARAD",29,9262,,89,"ARAD / Liceul Tehnologic de Transporturi Auto ""Henri Coandă""",1,797,"MUNICIPIUL ARAD",9262,1028,596,556,39,1,588,8,1130,534,195,393
2,"ARAD",29,9262,,90,"ARAD / Şcoala Gimnazială ""Mihai Eminescu"" (fosta Sc. Gen. nr. 1)",1,797,"MUNICIPIUL ARAD",9262,1582,977,811,67,99,962,15,1730,753,305,657
2,"ARAD",29,9262,,91,"ARAD / Liceul Tehnologic de Industrie Alimentară",1,797,"MUNICIPIUL ARAD",9262,1600,954,846,58,50,928,26,1760,806,290,638
2,"ARAD",29,9262,,92,"ARAD / Liceul Tehnologic de Industrie Alimentară",1,797,"MUNICIPIUL ARAD",9262,1058,599,529,70,0,584,15,1170,571,181,403
2,"ARAD",29,9262,,93,"ARAD / Colegiul ""Csiky Gergely""",1,797,"MUNICIPIUL ARAD",9262,1239,735,636,80,19,722,13,1360,625,233,489
2,"ARAD",29,9262,,94,"ARAD / Liceul Tehnologic ""Francisc Neumann""",1,797,"MUNICIPIUL ARAD",9262,1202,445,417,28,0,443,2,1320,875,132,311
2,"ARAD",29,9262,,95,"ARAD / Liceul Tehnologic ""Francisc Neumann""",1,797,"MUNICIPIUL ARAD",9262,1451,725,691,34,0,708,17,1590,865,230,478
2,"ARAD",29,9262,,96,"ARAD / Liceul Tehnologic ''Francisc Neumann''",1,797,"MUNICIPIUL ARAD",9262,1355,742,671,70,1,729,13,1490,748,254,475
2,"ARAD",29,9262,,97,"ARAD / Primaria Municipiului Arad, Directia Venituri",1,797,"MUNICIPIUL ARAD",9262,1557,856,779,76,1,838,18,1710,854,268,570
2,"ARAD",29,9262,,98,"ARAD / Colegiul Tehnic ""Aurel Vlaicu""",1,797,"MUNICIPIUL ARAD",9262,1097,707,638,69,0,700,7,1200,493,262,438
2,"ARAD",29,9262,,99,"ARAD / Liceul Tehnologic ""Francisc Neumann"" (internat)",1,797,"MUNICIPIUL ARAD",9262,1043,721,650,68,3,714,7,1150,429,244,470
2,"ARAD",29,9262,,100,"ARAD / Grădiniţa P.P. nr. 14",1,797,"MUNICIPIUL ARAD",9262,1266,800,718,82,0,788,12,1390,590,275,513
2,"ARAD",29,9262,,101,"ARAD / Grădiniţa P.N. nr. 13",1,797,"MUNICIPIUL ARAD",9262,502,293,263,30,0,289,4,550,257,93,196
2,"ARAD",29,9262,,102,"ARAD / Patinoarul Municipal Arad",1,797,"MUNICIPIUL ARAD",9262,697,490,448,42,0,483,7,760,270,145,338
2,"ARAD",29,9262,,103,"ARAD / Liceul Teoretic ""Adam M. Guttenbrunn""(fosta Sc. Generala nr. 20)",1,797,"MUNICIPIUL ARAD",9262,1673,1056,989,67,0,1034,22,1830,774,294,740
2,"ARAD",29,9262,,104,"ARAD / imobil fosta Grădiniţa P.N. nr. 25",1,797,"MUNICIPIUL ARAD",9262,723,485,474,11,0,480,5,790,305,124,356
2,"ARAD",29,9262,,105,"ARAD / Liceul Teoretic ""Adam M. Guttenbrunn"", clasele I-VIII",1,797,"MUNICIPIUL ARAD",9262,1029,586,539,47,0,578,8,1130,544,143,435
2,"ARAD",29,9262,,106,"ARAD / Grădiniţa P.P. nr. 3",1,797,"MUNICIPIUL ARAD",9262,1569,953,888,65,0,936,17,1720,767,290,646
2,"ARAD",29,9262,,107,"ARAD / Liceul Teoretic ""Adam M. Guttenbrunn""",1,797,"MUNICIPIUL ARAD",9262,1099,616,560,56,0,610,6,1210,594,190,420
2,"ARAD",29,9262,,108,"ARAD / Liceul Tehnologic ""Iuliu Moldovan"" (fost Grup Şcolar Forestier)",1,797,"MUNICIPIUL ARAD",9262,1570,864,789,74,1,850,14,1720,856,217,633
2,"ARAD",29,9262,,109,"ARAD / Gradinita P.N. nr.26",1,797,"MUNICIPIUL ARAD",9262,1074,645,592,53,0,639,6,1180,535,182,457
2,"ARAD",29,9262,,110,"ARAD / Gradinita P.N. nr.26",1,797,"MUNICIPIUL ARAD",9262,940,536,504,32,0,527,9,1030,494,185,342
2,"ARAD",29,9262,,111,"ARAD / Şcoala Gimnazială ""Adam Nicolae"" (fosta Şcoala Generală nr. 7)",1,797,"MUNICIPIUL ARAD",9262,1566,802,757,45,0,795,7,1720,918,304,491
2,"ARAD",29,9262,,112,"ARAD / Şcoala Gimnazială ""Adam Nicolae"" (fosta Şcoala Generală nr. 7)",1,797,"MUNICIPIUL ARAD",9262,1269,694,674,20,0,689,5,1400,706,216,473
2,"ARAD",29,9262,,113,"ARAD / Scoala Gimnaziala ''Adam Nicolae'' (fosta Şcoala Generală nr. 7)",1,797,"MUNICIPIUL ARAD",9262,1553,871,833,38,0,863,8,1710,839,281,582
2,"ARAD",29,9262,,114,"ARAD / Câmpul Dumbrava Roşie",1,797,"MUNICIPIUL ARAD",9262,175,110,84,26,0,110,0,200,90,28,82
2,"ARAD",29,9262,,115,"ARAD / Câmpul Albinelor",1,797,"MUNICIPIUL ARAD",9262,142,123,105,18,0,123,0,152,29,25,98
2,"ARAD",29,9459,,116,"CHIŞINEU-CRIŞ / Liceul Teoretic ""Mihai Veliciu"", str.Primaverii nr.3",1,799,"ORAŞ CHIŞINEU-CRIŞ",9459,1376,903,849,54,0,893,10,1510,607,343,550
2,"ARAD",29,9459,,117,"CHIŞINEU-CRIŞ / Liceul Teoretic ""Mihai Veliciu"", str.Primaverii nr.3",1,799,"ORAŞ CHIŞINEU-CRIŞ",9459,957,566,537,29,0,560,6,1060,494,258,302
2,"ARAD",29,9459,,118,"CHIŞINEU-CRIŞ / Scoala  Generală, str.Oituz nr.4",1,799,"ORAŞ CHIŞINEU-CRIŞ",9459,1519,938,880,58,0,934,4,1670,732,374,560
2,"ARAD",29,9459,,119,"CHIŞINEU-CRIŞ / Grădiniţa Pădureni, str.Înfrăţirii nr.14",1,799,"ORAŞ CHIŞINEU-CRIŞ",9459,1624,1006,931,73,2,998,8,1790,784,313,685
2,"ARAD",29,9459,,120,"NADAB / Şcoala Generală, Nădab nr.313",1,799,"ORAŞ CHIŞINEU-CRIŞ",9459,1446,937,871,66,0,927,10,1600,663,510,417
2,"ARAD",29,9495,,121,"CURTICI / Casa de Cultură Curtici",1,802,"ORAŞ CURTICI",9495,1366,838,767,71,0,829,9,1510,672,215,614
2,"ARAD",29,9495,,122,"CURTICI / Grădiniţa Veseliei",1,802,"ORAŞ CURTICI",9495,1375,743,684,59,0,720,23,1520,777,157,563
2,"ARAD",29,9495,,123,"CURTICI / Liceul Tehnologic Ion Creanga",1,802,"ORAŞ CURTICI",9495,1369,668,636,32,0,654,14,1510,842,170,484
2,"ARAD",29,9495,,124,"CURTICI / Liceul Tehnologic Ion Creanga",1,802,"ORAŞ CURTICI",9495,1363,553,505,48,0,545,8,1500,947,144,401
2,"ARAD",29,9495,,125,"CURTICI / Liceul Tehnologic Ion Creanga",1,802,"ORAŞ CURTICI",9495,1395,762,707,55,0,752,10,1530,768,184,568
2,"ARAD",29,9538,,126,"INEU / Scoala Generala clasele V-VIII",1,804,"ORAŞ INEU",9538,1518,979,904,74,1,970,9,1670,691,407,563
2,"ARAD",29,9538,,127,"INEU / Gradinita PN",1,804,"ORAŞ INEU",9538,1518,1009,942,57,10,997,12,1680,671,297,700
2,"ARAD",29,9538,,128,"INEU / Liceul ''Mihai Viteazul''",1,804,"ORAŞ INEU",9538,1604,1047,954,65,28,1041,6,1770,723,377,664
2,"ARAD",29,9538,,129,"INEU / Căminul Cultural din Cartierul Tratian",1,804,"ORAŞ INEU",9538,1390,898,851,41,6,889,9,1529,631,262,627
2,"ARAD",29,9538,,130,"INEU / Sala de sport",1,804,"ORAŞ INEU",9538,1385,969,858,88,23,965,4,1530,561,408,557
2,"ARAD",29,9538,,131,"MOCREA / Şcoala Generală clasele I-IV",1,804,"ORAŞ INEU",9538,674,396,355,41,0,392,4,745,349,150,242
2,"ARAD",29,9574,,132,"LIPOVA / Scoala cu cls. I-IV",1,807,"ORAŞ LIPOVA",9574,961,572,520,51,1,564,8,1060,488,264,300
2,"ARAD",29,9574,,133,"LIPOVA / sediu Asociaţia Caritas Banat Sanctus Gerhardus",1,807,"ORAŞ LIPOVA",9574,1176,677,643,34,0,674,3,1290,613,253,421
2,"ARAD",29,9574,,134,"LIPOVA / fosta Şcoala cu cls. I-IV",1,807,"ORAŞ LIPOVA",9574,1037,709,605,81,23,701,8,1140,431,300,401
2,"ARAD",29,9574,,135,"LIPOVA / Şcoala cu cls. I-IV",1,807,"ORAŞ LIPOVA",9574,1064,719,636,83,0,714,5,1170,451,315,399
2,"ARAD",29,9574,,136,"LIPOVA / clădire fosta Judecătorie - Centru de informare turistică",1,807,"ORAŞ LIPOVA",9574,964,600,545,55,0,588,12,1070,470,254,334
2,"ARAD",29,9574,,137,"LIPOVA / Grădiniţa P.P. Lipova",1,807,"ORAŞ LIPOVA",9574,1727,998,956,41,1,992,6,1910,912,355,637
2,"ARAD",29,9574,,138,"ŞOIMOŞ / Şcoala cu cls. I-IV Şoimoş",1,807,"ORAŞ LIPOVA",9574,581,398,324,74,0,393,5,640,242,119,274
2,"ARAD",29,9574,,139,"RADNA / sediu A.P.I.A.",1,807,"ORAŞ LIPOVA",9574,1147,669,621,48,0,663,6,1260,591,193,470
2,"ARAD",29,9574,,140,"RADNA / Şcoala cu cls. I-VIII",1,807,"ORAŞ LIPOVA",9574,982,679,566,92,21,675,4,1080,401,256,419
2,"ARAD",29,9627,,141,"NĂDLAC / Grupul Şcolar Ind.Jozef Gregor Tajovsky (Liceul Teoretic Jozef Gregor Tajovsky Nădlac)",1,811,"ORAŞ NĂDLAC",9627,1682,1128,906,220,2,1120,8,1850,722,195,925
2,"ARAD",29,9627,,142,"NĂDLAC / Casa de Cultură (Primăria oraş Nădlac)",1,811,"ORAŞ NĂDLAC",9627,1549,888,797,90,1,882,6,1710,822,224,658
2,"ARAD",29,9627,,143,"NĂDLAC / Şcoala Generală nr.3 Grupul Şcolar Ind. Jozef Gregor Tajovsky (Liceul Teoretic Jozef Gregor Tajovsky Nădlac)",1,811,"ORAŞ NĂDLAC",9627,1776,1060,981,76,3,1052,8,1950,890,268,784
2,"ARAD",29,9627,,144,"NĂDLAC / Pichet Grăniceri (Direcţia Poliţiei de frontieră Oradea)",1,811,"ORAŞ NĂDLAC",9627,1713,997,946,49,2,983,14,1880,883,179,804
2,"ARAD",29,11584,,145,"PECICA / Casa De Cultura Doru Ioan  Petescu",1,813,"ORAŞ PECICA",11584,1078,750,651,99,0,736,14,1190,440,238,498
2,"ARAD",29,11584,,146,"PECICA / Liceu Teoretic""Gheorghe Lazăr""",1,813,"ORAŞ PECICA",11584,1738,1103,942,161,0,1087,16,1920,817,305,782
2,"ARAD",29,11584,,147,"PECICA / I.A.S.",1,813,"ORAŞ PECICA",11584,1404,724,678,45,1,715,9,1539,815,181,534
2,"ARAD",29,11584,,148,"PECICA / Primăria Pecica",1,813,"ORAŞ PECICA",11584,1246,769,644,108,17,755,14,1380,611,166,589
2,"ARAD",29,11584,,149,"PECICA / Şcoala Primară 2",1,813,"ORAŞ PECICA",11584,1453,759,718,41,0,751,8,1600,841,132,619
2,"ARAD",29,11584,,150,"PECICA / Şcoala Primară 3",1,813,"ORAŞ PECICA",11584,1604,785,674,109,2,776,9,1760,975,225,551
2,"ARAD",29,11584,,151,"PECICA / Şcoala Primară 1",1,813,"ORAŞ PECICA",11584,1644,975,932,42,1,963,12,1810,835,287,676
2,"ARAD",29,11584,,152,"TURNU / Primăria Turnu",1,813,"ORAŞ PECICA",11584,1026,691,546,140,5,686,5,1130,439,137,549
2,"ARAD",29,11584,,153,"SEDERHAT / Şcoala Primară Sederhat",1,813,"ORAŞ PECICA",11584,263,170,151,17,2,168,2,290,120,18,150
2,"ARAD",29,9654,,154,"PÎNCOTA / Clădire ""Bucuria copiilor"" (Primăria Oraşului Pîncota)",1,818,"ORAŞ PÎNCOTA",9654,1022,600,536,58,6,593,7,1130,530,177,416
2,"ARAD",29,9654,,155,"PÎNCOTA / LICEUL TEORETIC PINCOTA ,  STRADA VASILE GOLDIS (23 AUGUST) ,  NR.67",1,818,"ORAŞ PÎNCOTA",9654,1370,761,701,59,1,756,5,1505,744,191,565
2,"ARAD",29,9654,,156,"PÎNCOTA / Liceul Teoretic Pîncota",1,818,"ORAŞ PÎNCOTA",9654,1505,751,721,30,0,746,5,1660,909,172,574
2,"ARAD",29,9654,,157,"PÎNCOTA / Grădiniţa PN (Liceul Teoretic Pîncota)",1,818,"ORAŞ PÎNCOTA",9654,1244,586,554,31,1,581,5,1370,784,189,392
2,"ARAD",29,9654,,158,"MĂDERAT / Şcoala Generală Măderat (Liceul Teoretic Pîncota)",1,818,"ORAŞ PÎNCOTA",9654,1230,689,623,63,3,686,3,1350,661,251,435
2,"ARAD",29,12091,,159,"SÂNTANA / Scoala Gimnaziala Sfanta Ana Santana - Sectia Germana",1,821,"ORAŞ SÂNTANA",12091,1321,552,516,36,0,549,3,1460,908,166,383
2,"ARAD",29,12091,,160,"SÂNTANA / Liceul Tehnologic Santana",1,821,"ORAŞ SÂNTANA",12091,1774,722,665,57,0,711,11,1950,1228,223,488
2,"ARAD",29,12091,,161,"SÂNTANA / Clubul Copiilor si Elevilor",1,821,"ORAŞ SÂNTANA",12091,1056,442,403,39,0,438,4,1160,718,139,299
2,"ARAD",29,12091,,162,"SÂNTANA / Scoala Gimnaziala Santana",1,821,"ORAŞ SÂNTANA",12091,1424,706,665,40,1,697,9,1560,854,293,404
2,"ARAD",29,12091,,163,"SÂNTANA / Gradinita PP nr. 2 Santana",1,821,"ORAŞ SÂNTANA",12091,1296,654,624,30,0,646,8,1430,776,251,395
2,"ARAD",29,12091,,164,"SÂNTANA / Gradinita PP nr. 2 Santana",1,821,"ORAŞ SÂNTANA",12091,1619,510,465,45,0,504,6,1770,1260,172,332
2,"ARAD",29,12091,,165,"SÂNTANA / Biblioteca Orasului Santana",1,821,"ORAŞ SÂNTANA",12091,978,375,317,58,0,364,11,1080,705,165,199
2,"ARAD",29,12091,,166,"SÂNTANA / Camin Cultural Satu Nou",1,821,"ORAŞ SÂNTANA",12091,1101,710,667,43,0,705,5,1210,500,289,416
2,"ARAD",29,12091,,167,"SÂNTANA / Gradinita PP nr. 1 Santana",1,821,"ORAŞ SÂNTANA",12091,916,518,496,22,0,512,6,1005,487,225,287
2,"ARAD",29,12091,,168,"CAPORAL ALEXA / Cămin Cultural",1,821,"ORAŞ SÂNTANA",12091,1078,604,540,64,0,599,5,1190,586,228,371
2,"ARAD",29,9690,,169,"SEBIŞ / Universitatea de Vest ,, Vasile Goldiş'' -Filiala Sebiş",1,824,"ORAŞ SEBIŞ",9690,1576,906,838,67,1,895,11,1730,824,270,625
2,"ARAD",29,9690,,170,"SEBIŞ / Liceul Sebiş",1,824,"ORAŞ SEBIŞ",9690,1542,924,872,51,1,914,10,1700,776,342,572
2,"ARAD",29,9690,,171,"SEBIŞ / Şcoala Generală",1,824,"ORAŞ SEBIŞ",9690,1342,785,738,47,0,775,10,1480,695,249,526
2,"ARAD",29,9690,,172,"SEBIŞ / Şcoala Cu Clasele I-IV Prăjeşti",1,824,"ORAŞ SEBIŞ",9690,204,169,119,50,0,168,1,225,56,57,111
2,"ARAD",29,9690,,173,"PRUNIŞOR / Şcoala Cu Clasele I-IV Prunişor",1,824,"ORAŞ SEBIŞ",9690,484,343,296,46,1,334,9,530,187,75,259
2,"ARAD",29,9690,,174,"DONCENI / Şcoala Cu Clasele I-IV Donceni",1,824,"ORAŞ SEBIŞ",9690,128,103,83,20,0,98,5,145,42,23,75
2,"ARAD",29,9690,,175,"SĂLĂJENI / Căminul Cultural Sălăjeni",1,824,"ORAŞ SEBIŞ",9690,161,128,106,22,0,128,0,180,52,22,106
2,"ARAD",29,9743,,176,"ALMAŞ / Căminul Cultural Almaş",3,829,"ALMAŞ",9743,1166,764,677,46,41,755,9,1290,526,332,423
2,"ARAD",29,9743,,177,"CIL / Căminul Cultural Cil",3,829,"ALMAŞ",9743,499,323,291,26,6,318,5,550,227,108,210
2,"ARAD",29,9743,,178,"RĂDEŞTI / Căminul Cultural Rădeşti",3,829,"ALMAŞ",9743,358,293,248,38,7,286,7,400,107,87,199
2,"ARAD",29,9743,,179,"JOIA MARE / Căminul Cultural Joia Mare",3,829,"ALMAŞ",9743,165,119,97,22,0,118,1,185,66,36,82
2,"ARAD",29,9798,,180,"APATEU / Şcoala Generală ""Gheorghe Popovici""",3,834,"APATEU",9798,940,603,568,18,17,601,2,1030,427,171,430
2,"ARAD",29,9798,,181,"APATEU / Şcoala Generală ""Gheorghe Popovici""",3,834,"APATEU",9798,962,560,510,31,19,555,5,1060,500,161,394
2,"ARAD",29,9798,,182,"BERECHIU / Şcoala Generală Berechiu",3,834,"APATEU",9798,650,395,327,45,23,389,6,720,325,191,198
2,"ARAD",29,9798,,183,"MOŢIORI / Şcoala Generală Moţiori",3,834,"APATEU",9798,255,187,176,11,0,186,1,280,93,113,73
2,"ARAD",29,9832,,184,"ARCHIŞ / Primăria Archiş",3,838,"ARCHIŞ",9832,312,257,219,38,0,255,2,340,83,146,109
2,"ARAD",29,9832,,185,"NERMIŞ / Grădiniţa Nermiş",3,838,"ARCHIŞ",9832,153,134,114,16,4,134,0,175,41,68,66
2,"ARAD",29,9832,,186,"BÎRZEŞTI / Grădiniţa Bîrzeşti",3,838,"ARCHIŞ",9832,130,127,101,26,0,127,0,145,18,47,80
2,"ARAD",29,9832,,187,"GROŞENI / Şcoala Generală I-VIII Groşeni",3,838,"ARCHIŞ",9832,643,416,385,31,0,411,5,710,294,217,194
2,"ARAD",29,9887,,188,"BATA / Primăria Bata",3,843,"BATA",9887,343,277,224,53,0,276,1,375,98,103,173
2,"ARAD",29,9887,,189,"ŢELA / Şcoala Generală Ţela",3,843,"BATA",9887,270,163,135,28,0,161,2,300,137,62,99
2,"ARAD",29,9887,,190,"BACĂU DE MIJLOC / Căminul Cultural Bacăul de Mijloc",3,843,"BATA",9887,138,83,72,11,0,83,0,155,72,13,70
2,"ARAD",29,9887,,191,"BULCI / Căminul Cultural Bulci",3,843,"BATA",9887,97,77,49,28,0,76,1,110,33,36,40
2,"ARAD",29,9930,,192,"BELIU / Primăria Beliu",3,848,"BELIU",9930,1462,1006,914,82,10,992,14,1610,604,403,589
2,"ARAD",29,9930,,193,"TĂGĂDĂU / Căminul Cultural Tăgădău",3,848,"BELIU",9930,397,268,243,24,1,267,1,440,172,108,159
2,"ARAD",29,9930,,194,"BENEŞTI / Căminul Cultural Beneşti",3,848,"BELIU",9930,93,81,68,13,0,81,0,105,24,24,57
2,"ARAD",29,9930,,195,"BOCHIA / Căminul Cultural Bochia",3,848,"BELIU",9930,50,46,30,16,0,46,0,55,9,17,29
2,"ARAD",29,9930,,196,"SECACI / Căminul Cultural Secaci",3,848,"BELIU",9930,126,104,92,12,0,102,2,140,36,34,68
2,"ARAD",29,9930,,197,"VASILE GOLDIŞ / Căminul Cultural Vasile Goldiş",3,848,"BELIU",9930,401,302,262,34,6,299,3,440,138,137,162
2,"ARAD",29,10006,,198,"BIRCHIŞ / Căminul Cultural Birchiş",3,855,"BIRCHIŞ",10006,556,341,282,58,1,336,5,610,269,113,223
2,"ARAD",29,10006,,199,"CĂPĂLNAŞ / Şcoala Generală I-VIII Căpîlnaş",3,855,"BIRCHIŞ",10006,765,462,387,75,0,458,4,840,378,224,234
2,"ARAD",29,10006,,200,"OSTROV / Căminul Cultural Ostrov",3,855,"BIRCHIŞ",10006,222,149,116,33,0,146,3,245,96,47,99
2,"ARAD",29,10051,,201,"BÎRSA / Grădiniţa PN Bîrsa",3,860,"BÎRSA",10051,819,599,534,56,9,597,2,900,301,221,376
2,"ARAD",29,10051,,202,"ALDEŞTI / Cămin Cultural Aldeşti",3,860,"BÎRSA",10051,442,304,267,35,2,301,3,490,186,149,152
2,"ARAD",29,10051,,203,"HODIŞ / fosta Şcoală cu clasele I-IV Hodiş",3,860,"BÎRSA",10051,152,114,92,22,0,112,2,170,56,39,73
2,"ARAD",29,10051,,204,"VOIVODENI / fosta Şcoală cu clasele I-IV Voivodeni",3,860,"BÎRSA",10051,144,112,90,20,2,111,1,160,48,41,70
2,"ARAD",29,10104,,205,"BÎRZAVA / Primăria Bîrzava",3,865,"BÎRZAVA",10104,771,577,431,128,18,571,6,850,273,250,321
2,"ARAD",29,10104,,206,"MONOROŞTIA / Şcoala Generală Monoroştia",3,865,"BÎRZAVA",10104,254,167,148,17,2,166,1,280,113,82,84
2,"ARAD",29,10104,,207,"CĂPRUŢA / Centru Local de Informare şi Promovare Turistica Căpruţa",3,865,"BÎRZAVA",10104,224,193,135,44,14,191,2,250,57,111,80
2,"ARAD",29,10104,,208,"DUMBRĂVIŢA / Căminul Cultural  Dumbrăviţa",3,865,"BÎRZAVA",10104,242,198,159,22,17,194,4,270,72,100,94
2,"ARAD",29,10104,,209,"GROŞII NOI / Şcoala Generală Groşii-Noi",3,865,"BÎRZAVA",10104,194,164,107,43,14,163,1,215,51,97,66
2,"ARAD",29,10104,,210,"SLATINA DE MUREŞ / Cămin Cultural Slatina de Mureş",3,865,"BÎRZAVA",10104,139,103,82,15,6,102,1,155,52,59,43
2,"ARAD",29,10104,,211,"BĂTUŢA / Şcoala Generală Bătuţa",3,865,"BÎRZAVA",10104,65,47,28,19,0,46,1,75,28,25,21
2,"ARAD",29,10104,,212,"LALAŞINŢ / Şcoala Generală Lalaşinţ",3,865,"BÎRZAVA",10104,285,197,135,44,18,195,2,315,118,105,90
2,"ARAD",29,10195,,213,"BOCSIG / Căminul Cultural Bocsig",3,874,"BOCSIG",10195,1562,877,796,81,0,872,5,1720,843,510,362
2,"ARAD",29,10195,,214,"BOCSIG / Scoala Generală I-IV din Bocsig Cartier",3,874,"BOCSIG",10195,345,227,190,37,0,226,1,380,153,110,116
2,"ARAD",29,10195,,215,"MÎNERĂU / Cămin Cultural Mînerău",3,874,"BOCSIG",10195,287,208,185,23,0,208,0,320,112,118,90
2,"ARAD",29,10195,,216,"RĂPSIG / Şcoala Nouă Răpsig",3,874,"BOCSIG",10195,598,399,361,38,0,398,1,660,261,194,204
2,"ARAD",29,10239,,217,"BRAZII / Primăria Brazii",3,878,"BRAZII",10239,79,68,49,19,0,68,0,90,22,41,27
2,"ARAD",29,10239,,218,"IACOBINI / Căminul Cultural Iacobini",3,878,"BRAZII",10239,160,118,94,24,0,118,0,175,57,43,75
2,"ARAD",29,10239,,219,"SECAŞ / Căminul Cultural Secaş",3,878,"BRAZII",10239,385,259,237,21,1,256,3,420,161,92,164
2,"ARAD",29,10239,,220,"BUCEAVA-ŞOIMUŞ / camin cultural Buceava",3,878,"BRAZII",10239,77,52,39,13,0,52,0,90,38,18,34
2,"ARAD",29,10239,,221,"BUCEAVA-ŞOIMUŞ / camin cultural Soimus",3,878,"BRAZII",10239,75,73,49,24,0,73,0,85,12,39,34
2,"ARAD",29,10239,,222,"MĂDRIGEŞTI / Căminul Cultural Mădrigeşti",3,878,"BRAZII",10239,223,148,129,19,0,147,1,245,97,56,91
2,"ARAD",29,10293,,223,"BUTENI / Primăria Buteni",3,884,"BUTENI",10293,807,540,494,33,13,535,5,890,350,170,365
2,"ARAD",29,10293,,224,"BUTENI / Cămin Cultural Buteni",3,884,"BUTENI",10293,977,645,566,53,26,634,11,1080,435,232,402
2,"ARAD",29,10293,,225,"CUIED / fosta Primarie Cuied",3,884,"BUTENI",10293,578,417,360,26,31,414,3,640,223,139,275
2,"ARAD",29,10293,,226,"PĂULIAN / CAMINUL CULTURAL",3,884,"BUTENI",10293,274,146,133,13,0,143,3,305,159,47,96
2,"ARAD",29,10293,,227,"BERINDIA / Cămin Cultural Berindia",3,884,"BUTENI",10293,175,153,123,30,0,152,1,195,42,58,94
2,"ARAD",29,10346,,228,"CĂRAND / Cămin cultural Cărand",3,889,"CĂRAND",10346,547,372,328,42,2,368,4,600,228,174,194
2,"ARAD",29,10346,,229,"SELIŞTEA / Cămin cultural Seliştea",3,889,"CĂRAND",10346,433,255,234,18,3,253,2,480,225,129,124
2,"ARAD",29,10373,,230,"CERMEI / Primăria comunei Cermei",3,892,"CERMEI",10373,1516,904,801,100,3,890,14,1670,766,410,480
2,"ARAD",29,10373,,231,"ŞOMOŞCHEŞ / FOSTA PRIMARIE SOMOŞCHEŞ, NR. 339",3,892,"CERMEI",10373,730,401,371,30,0,395,6,800,399,208,187
2,"ARAD",29,10417,,232,"CHISINDIA / Primăria comunei Chisindia",3,896,"CHISINDIA",10417,745,466,425,40,1,462,4,820,354,131,331
2,"ARAD",29,10417,,233,"PĂIUŞENI / Cămin cultural Păiuşeni",3,896,"CHISINDIA",10417,341,233,213,20,0,228,5,380,147,133,95
2,"ARAD",29,10417,,234,"VĂSOAIA / Cămin cultural Văsoaia",3,896,"CHISINDIA",10417,52,44,19,25,0,44,0,60,16,8,36
2,"ARAD",29,10453,,235,"CONOP / Şcoala Generală Conop",3,900,"CONOP",10453,483,335,284,44,7,334,1,530,195,173,161
2,"ARAD",29,10453,,236,"BELOTINŢ / Şcoala cu clasele I-IV Belotinţ",3,900,"CONOP",10453,253,152,115,37,0,152,0,280,128,59,93
2,"ARAD",29,10453,,237,"CHELMAC / Şcoala cu clasele I-IV Chelmac",3,900,"CONOP",10453,254,192,140,52,0,190,2,280,88,91,99
2,"ARAD",29,10453,,238,"MILOVA / Şcoala cu clasele I-IV Milova",3,900,"CONOP",10453,439,313,281,32,0,312,1,480,167,126,186
2,"ARAD",29,10453,,239,"ODVOŞ / Şcoala cu clasele I-IV Odvoş",3,900,"CONOP",10453,378,253,207,46,0,252,1,420,167,66,186
2,"ARAD",29,10514,,240,"COVĂSINŢ / Cămin cultural Covăsînţ",3,906,"COVĂSINŢ",10514,1082,561,521,38,2,556,5,1190,629,148,408
2,"ARAD",29,10514,,241,"COVĂSINŢ / Primăria comunei Covăsînţ",3,906,"COVĂSINŢ",10514,1030,466,418,41,7,457,9,1130,664,141,316
2,"ARAD",29,10532,,242,"CRAIVA / Primăria comunei Craiva",3,908,"CRAIVA",10532,469,304,256,40,8,299,5,520,216,110,189
2,"ARAD",29,10532,,243,"CHIŞLACA / Şcoala din Chişlaca",3,908,"CRAIVA",10532,555,392,325,43,24,387,5,610,218,129,258
2,"ARAD",29,10532,,244,"MĂRĂUŞ / Şcoala din Mărăuş",3,908,"CRAIVA",10532,250,182,156,18,8,182,0,275,93,49,133
2,"ARAD",29,10532,,245,"STOINEŞTI / Şcoala din Stoineşti",3,908,"CRAIVA",10532,142,101,93,8,0,101,0,155,54,27,74
2,"ARAD",29,10532,,246,"SUSAG / SCOALA DIN SUSAG",3,908,"CRAIVA",10532,305,225,179,38,8,225,0,330,105,96,129
2,"ARAD",29,10532,,247,"COROI / Cămin cultural Coroi",3,908,"CRAIVA",10532,120,103,69,30,4,103,0,135,32,27,76
2,"ARAD",29,10532,,248,"ŞIAD / Şcoala din Şiad",3,908,"CRAIVA",10532,211,168,144,21,3,166,2,235,67,60,106
2,"ARAD",29,10532,,249,"ROGOZ DE BELIU / Şcoala din Rogoz de Beliu",3,908,"CRAIVA",10532,122,88,70,15,3,87,1,135,47,35,52
2,"ARAD",29,10532,,250,"CIUNTEŞTI / Şcoala din Ciunteşti",3,908,"CRAIVA",10532,126,82,70,12,0,81,1,145,63,24,57
2,"ARAD",29,10649,,251,"DEZNA / Camin Cultural Dezna",3,919,"DEZNA",10649,676,546,461,59,26,542,4,750,204,269,273
2,"ARAD",29,10649,,252,"BUHANI / Cămin cultural Buhani",3,919,"DEZNA",10649,152,138,94,40,4,136,2,170,32,67,69
2,"ARAD",29,10649,,253,"NEAGRA / Cămin cultural Neagra",3,919,"DEZNA",10649,94,95,64,28,3,95,0,105,10,50,45
2,"ARAD",29,10649,,254,"SLATINA DE CRIŞ / Şcoala Generală din Slatina de Criş",3,919,"DEZNA",10649,125,120,81,32,7,120,0,140,20,70,50
2,"ARAD",29,10649,,255,"LAZ / Căminul cultural Laz",3,919,"DEZNA",10649,55,34,23,10,1,33,1,65,31,16,17
2,"ARAD",29,10701,,256,"DIECI / Camin Cultural Dieci",3,925,"DIECI",10701,644,590,459,92,39,585,5,710,120,278,307
2,"ARAD",29,10701,,257,"CROCNA / Cămin cultural Crocna",3,925,"DIECI",10701,347,288,230,26,32,287,1,385,97,164,123
2,"ARAD",29,10701,,258,"REVETIŞ / Cămin cultural Revetiş",3,925,"DIECI",10701,254,209,165,33,11,208,1,280,71,85,123
2,"ARAD",29,10701,,259,"ROŞIA / Cămin cultural Roşia",3,925,"DIECI",10701,50,40,20,18,2,40,0,55,15,18,22
2,"ARAD",29,12912,,260,"DOROBANŢI / Cămin cultural Dorobanţi",3,931,"DOROBANŢI",12912,1381,760,649,58,53,759,1,1520,760,76,683
2,"ARAD",29,9280,,261,"FÂNTÂNELE / Primăria Comunei Fîntînele",3,933,"FÂNTÂNELE",9280,1221,753,686,63,4,744,9,1340,587,253,491
2,"ARAD",29,9280,,262,"FÂNTÂNELE / Şcoala Generală Fîntînele",3,933,"FÂNTÂNELE",9280,984,598,548,43,7,592,6,1080,482,247,345
2,"ARAD",29,9280,,263,"TISA NOUĂ / Cămin Cultural Tisa Nouă",3,933,"FÂNTÂNELE",9280,824,542,500,39,3,536,6,905,363,276,260
2,"ARAD",29,10827,,264,"FELNAC / Scoala Gimnaziala  Aurel Sebesan Felnac",3,936,"FELNAC",10827,1135,721,656,52,13,714,7,1250,529,322,392
2,"ARAD",29,10827,,265,"FELNAC / Scoala Gimnaziala  Aurel Sebesan Felnac",3,936,"FELNAC",10827,1091,732,671,52,9,724,8,1200,468,403,321
2,"ARAD",29,10827,,266,"CĂLUGĂRENI / SCOALA CU CLASELE I-IV CALUGARENI",3,936,"FELNAC",10827,205,158,118,33,7,158,0,225,67,88,70
2,"ARAD",29,12920,,267,"FRUMUŞENI / Cămin cultural Frumuşeni",3,939,"FRUMUŞENI",12920,1488,819,752,67,0,813,6,1640,821,290,523
2,"ARAD",29,12920,,268,"ALUNIŞ / Cămin cultural Aluniş",3,939,"FRUMUŞENI",12920,830,524,474,50,0,516,8,910,386,89,427
2,"ARAD",29,10872,,269,"GHIOROC / Primăria Ghioroc",3,942,"GHIOROC",10872,1559,961,839,115,7,956,5,1710,749,312,644
2,"ARAD",29,10872,,270,"CUVIN / Cămin cultural Cuvin",3,942,"GHIOROC",10872,1347,732,668,64,0,723,9,1480,748,226,497
2,"ARAD",29,10872,,271,"MINIŞ / Cămin cultural Miniş",3,942,"GHIOROC",10872,563,419,355,64,0,418,1,620,201,167,251
2,"ARAD",29,10916,,272,"GRĂNICERI / Primăria comunei Grăniceri",3,946,"GRĂNICERI",10916,1095,655,598,36,21,651,4,1200,545,212,439
2,"ARAD",29,10916,,273,"ŞICLĂU / Şcoala Generală Şiclău",3,946,"GRĂNICERI",10916,953,500,425,40,35,496,4,1050,550,166,330
2,"ARAD",29,10943,,274,"GURAHONŢ / Primăria Gurahonţ",3,949,"GURAHONŢ",10943,782,558,466,53,39,549,9,860,302,168,381
2,"ARAD",29,10943,,275,"GURAHONŢ / Primăria Gurahonţ",3,949,"GURAHONŢ",10943,746,530,470,44,16,526,4,819,289,201,325
2,"ARAD",29,10943,,276,"BONŢEŞTI / Cămin cultural Bonţeşti",3,949,"GURAHONŢ",10943,577,388,336,44,8,384,4,635,247,141,243
2,"ARAD",29,10943,,277,"FENIŞ / Cămin cultural Feniş",3,949,"GURAHONŢ",10943,106,90,75,11,4,90,0,120,30,38,52
2,"ARAD",29,10943,,278,"HONŢIŞOR / Cămin cultural Honţişor",3,949,"GURAHONŢ",10943,266,194,168,26,0,188,6,295,101,91,97
2,"ARAD",29,10943,,279,"IOSAŞ / Cămin cultural Iosaş",3,949,"GURAHONŢ",10943,209,161,143,15,3,160,1,230,69,67,93
2,"ARAD",29,10943,,280,"PESCARI / Cămin cultural Pescari",3,949,"GURAHONŢ",10943,243,183,153,24,6,181,2,270,87,60,121
2,"ARAD",29,10943,,281,"ZIMBRU / Cămin cultural Zimbru",3,949,"GURAHONŢ",10943,416,303,277,14,12,299,4,460,157,111,188
2,"ARAD",29,11058,,282,"POIENARI / Şcoala Generală",3,966,"HĂLMAGIU",11058,169,121,107,14,0,120,1,190,69,41,79
2,"ARAD",29,11058,,283,"TISA / Şcoala Generală",3,966,"HĂLMAGIU",11058,180,145,118,24,3,145,0,200,55,64,81
2,"ARAD",29,11058,,284,"LEASA / Şcoala Generală",3,966,"HĂLMAGIU",11058,186,128,107,21,0,128,0,210,82,70,58
2,"ARAD",29,11058,,285,"BRUSTURI / Şcoala Generală",3,966,"HĂLMAGIU",11058,340,223,203,18,2,220,3,380,157,58,162
2,"ARAD",29,11058,,286,"HĂLMAGIU / Primăria Hălmagiu",3,966,"HĂLMAGIU",11058,1072,664,580,78,6,660,4,1180,516,292,368
2,"ARAD",29,11058,,287,"ŢĂRMURE / Cămin cultural Ţărmure",3,966,"HĂLMAGIU",11058,309,203,180,23,0,202,1,340,137,95,107
2,"ARAD",29,11058,,288,"BĂNEŞTI / Şcoala Generală Băneşti",3,966,"HĂLMAGIU",11058,277,211,186,19,6,210,1,310,99,69,141
2,"ARAD",29,11174,,289,"HĂLMĂGEL / Primăria Hălmăgel",3,960,"HĂLMĂGEL",11174,533,361,312,45,4,357,4,590,229,191,166
2,"ARAD",29,11174,,290,"LUNCŞOARA / Şcoala clasele I-IV Luncşoara",3,960,"HĂLMĂGEL",11174,358,217,201,16,0,212,5,400,183,99,113
2,"ARAD",29,11174,,291,"SÎRBI / Şcoala clasele I-IV Sîrbi",3,960,"HĂLMĂGEL",11174,88,81,57,24,0,81,0,100,19,43,38
2,"ARAD",29,11174,,292,"TÎRNĂVIŢA / Şcoala clasele I-IV Tîrnăviţa",3,960,"HĂLMĂGEL",11174,141,136,109,27,0,135,1,155,19,78,57
2,"ARAD",29,11236,,293,"HĂŞMAŞ / Cămin Cultural Hăşmaş",3,978,"HĂŞMAŞ",11236,363,290,247,33,10,288,2,400,110,134,154
2,"ARAD",29,11236,,294,"COMĂNEŞTI / Cămin Cultural Comăneşti",3,978,"HĂŞMAŞ",11236,92,81,64,16,1,79,2,105,24,33,46
2,"ARAD",29,11236,,295,"AGRIŞU MIC / Cămin Cultural Agrişu Mic",3,978,"HĂŞMAŞ",11236,142,128,107,18,3,126,2,165,37,44,82
2,"ARAD",29,11236,,296,"BOTFEI / Cămin Cultural Botfei",3,978,"HĂŞMAŞ",11236,193,144,120,22,2,143,1,210,66,60,83
2,"ARAD",29,11236,,297,"URVIŞU DE BELIU / Cămin cultural Urvişu de Beliu",3,978,"HĂŞMAŞ",11236,183,150,136,11,3,148,2,205,55,69,79
2,"ARAD",29,11236,,298,"CLIT / Cămin cultural Clit",3,978,"HĂŞMAŞ",11236,66,54,42,10,2,54,0,75,21,17,37
2,"ARAD",29,11307,,299,"IGNEŞTI / Cămin cultural Igneşti",3,985,"IGNEŞTI",11307,233,170,156,14,0,168,2,260,90,87,81
2,"ARAD",29,11307,,300,"MINEAD / Cămin cultural Minead",3,985,"IGNEŞTI",11307,86,75,58,16,1,74,1,95,20,24,50
2,"ARAD",29,11307,,301,"NĂDĂLBEŞTI / Şcoala Generală Nădălbeşti",3,985,"IGNEŞTI",11307,109,73,65,8,0,72,1,120,47,21,51
2,"ARAD",29,11307,,302,"SUSANI / Şcoala Generală Susani",3,985,"IGNEŞTI",11307,184,125,111,14,0,124,1,205,80,41,83
2,"ARAD",29,11352,,303,"IRATOŞU / Consiliul Local Iratoşu",3,990,"IRATOŞU",11352,1642,813,745,60,8,811,2,1810,997,157,654
2,"ARAD",29,11352,,304,"VARIAŞU MARE / Şcoala Generală din Variaşu Mare",3,990,"IRATOŞU",11352,402,244,195,49,0,242,2,440,196,44,198
2,"ARAD",29,11352,,305,"VARIAŞU MIC / Şcoala Generală din Variaşu Mic",3,990,"IRATOŞU",11352,111,62,48,14,0,62,0,125,63,10,52
2,"ARAD",29,9333,,306,"LIVADA / Şcoala Gimnazială Livada",3,994,"LIVADA",9333,1385,889,802,86,1,884,5,1520,631,261,623
2,"ARAD",29,9333,,307,"SÎNLEANI / Şcoala Sînleani (Şcoala Gimnazială Livada)",3,994,"LIVADA",9333,1421,850,791,58,1,839,11,1560,710,236,603
2,"ARAD",29,11398,,308,"MACEA / Şcoala Generală Macea",3,997,"MACEA",11398,1803,1025,941,78,6,1014,11,1980,955,360,654
2,"ARAD",29,11398,,309,"MACEA / Şcoala Generală Macea",3,997,"MACEA",11398,1837,911,852,58,1,903,8,2020,1109,364,539
2,"ARAD",29,11398,,310,"SÎNMARTIN / Şcoala Generală Macea-sat Sînmartin",3,997,"MACEA",11398,1126,505,428,77,0,498,7,1240,735,150,348
2,"ARAD",29,11398,,311,"SÎNMARTIN / Şcoala Generală Macea-sat Sînmartin",3,997,"MACEA",11398,966,439,416,23,0,436,3,1060,621,150,286
2,"ARAD",29,11423,,312,"MIŞCA / Primăria Comunei Mişca",3,1000,"MIŞCA",11423,957,573,517,56,0,563,10,1050,477,329,234
2,"ARAD",29,11423,,313,"SATU NOU / Sat Satu-Nou",3,1000,"MIŞCA",11423,665,378,330,32,16,373,5,740,362,68,305
2,"ARAD",29,11423,,314,"VÎNĂTORI / Sat Vânători",3,1000,"MIŞCA",11423,901,541,506,35,0,537,4,990,449,297,240
2,"ARAD",29,11423,,315,"ZERINDU MIC / Şcoala din Zerindu-Mic",3,1000,"MIŞCA",11423,152,99,79,20,0,99,0,170,71,19,80
2,"ARAD",29,11478,,316,"MONEASA / Cămin cultural Moneasa",3,1005,"MONEASA",11478,631,697,397,281,19,688,9,760,63,302,386
2,"ARAD",29,11478,,317,"RĂNUŞA / Şcoala din Rănuşa",3,1005,"MONEASA",11478,213,182,153,24,5,182,0,260,78,100,82
2,"ARAD",29,11502,,318,"OLARI / Primăria Comunei Olari",3,1008,"OLARI",11502,1289,700,648,52,0,696,4,1420,720,252,444
2,"ARAD",29,11502,,319,"SINTEA MICĂ / Şcoala cu clasele I-IV Sintea Mică",3,1008,"OLARI",11502,326,208,177,31,0,207,1,360,152,60,147
2,"ARAD",29,11539,,320,"PĂULIŞ / Primăria Comunei Păuliş, parter",3,1011,"PĂULIŞ",11539,1534,1044,889,140,15,1030,14,1690,646,291,739
2,"ARAD",29,11539,,321,"SÎMBĂTENI / Căminul cultural Sîmbăteni",3,1011,"PĂULIŞ",11539,1545,962,837,102,23,953,9,1699,737,228,725
2,"ARAD",29,11539,,322,"CLADOVA / Căminul cultural Cladova",3,1011,"PĂULIŞ",11539,277,170,143,27,0,169,1,305,135,46,123
2,"ARAD",29,11539,,323,"BARAŢCA / Centrul local de informare turistica Baratca",3,1011,"PĂULIŞ",11539,208,148,121,27,0,148,0,230,82,51,97
2,"ARAD",29,11637,,324,"PEREGU MARE / Primăria Comunei Peregu Mare",3,1016,"PEREGU MARE",11637,792,397,338,45,14,393,4,870,473,98,295
2,"ARAD",29,11637,,325,"PEREGU MIC / Sat Peregu Mic",3,1016,"PEREGU MARE",11637,804,361,332,29,0,360,1,880,519,43,317
2,"ARAD",29,11664,,326,"PETRIŞ / Primăria Petriş",3,1019,"PETRIŞ",11664,397,268,212,56,0,264,4,440,172,103,161
2,"ARAD",29,11664,,327,"ILTEU / Căminul Cultural Ilteu",3,1019,"PETRIŞ",11664,202,181,112,69,0,180,1,225,44,50,130
2,"ARAD",29,11664,,328,"SELIŞTE / Căminul Cultural Selişte",3,1019,"PETRIŞ",11664,103,80,67,13,0,78,2,115,35,33,45
2,"ARAD",29,11664,,329,"CORBEŞTI / Căminul Cultural Corbeşti",3,1019,"PETRIŞ",11664,155,117,90,27,0,116,1,170,53,46,70
2,"ARAD",29,11664,,330,"ROŞIA NOUĂ / Căminul Cultural Roşia Nouă",3,1019,"PETRIŞ",11664,239,126,117,9,0,125,1,265,139,48,77
2,"ARAD",29,11664,,331,"OBÎRŞIA / Căminul Cultural Obîrşia",3,1019,"PETRIŞ",11664,98,63,52,11,0,63,0,110,47,29,34
2,"ARAD",29,11735,,332,"PILU / Primăria Pilu",3,1026,"PILU",11735,848,579,498,73,8,573,6,930,351,261,312
2,"ARAD",29,11735,,333,"VĂRŞAND / Şcoala Gimnazială clasele I-IV",3,1026,"PILU",11735,747,505,423,75,7,502,3,820,315,184,318
2,"ARAD",29,11762,,334,"PLEŞCUŢA / Primăria Pleşcuţa",3,1029,"PLEŞCUŢA",11762,256,194,159,35,0,194,0,285,91,66,128
2,"ARAD",29,11762,,335,"TĂLAGIU / Căminul Cultural Talagiu",3,1029,"PLEŞCUŢA",11762,350,242,212,30,0,240,2,390,148,133,107
2,"ARAD",29,11762,,336,"ACIUŢA / Căminul Cultural Aciuţa",3,1029,"PLEŞCUŢA",11762,175,117,98,19,0,117,0,195,78,49,68
2,"ARAD",29,11762,,337,"GURA VĂII / Căminul Cultural Gura Văii",3,1029,"PLEŞCUŢA",11762,244,154,137,17,0,153,1,265,111,49,104
2,"ARAD",29,11842,,338,"SĂVÎRŞIN / Primăria Săvârşin",3,1043,"SĂVÎRŞIN",11842,1265,970,754,183,33,961,9,1400,430,454,507
2,"ARAD",29,11842,,339,"PÎRNEŞTI / Şcoala Primară Pîrneşti",3,1043,"SĂVÎRŞIN",11842,151,114,101,10,3,114,0,170,56,60,54
2,"ARAD",29,11842,,340,"TROAŞ / Şcoala Primară Troaş",3,1043,"SĂVÎRŞIN",11842,146,116,98,18,0,114,2,160,44,65,49
2,"ARAD",29,11842,,341,"TEMEŞEŞTI / Căminul Cultural Temeşeşti",3,1043,"SĂVÎRŞIN",11842,119,95,77,17,1,92,3,130,35,49,43
2,"ARAD",29,11842,,342,"TOC / Şcoala Primară Toc",3,1043,"SĂVÎRŞIN",11842,373,278,232,46,0,276,2,410,132,136,140
2,"ARAD",29,11842,,343,"CĂPRIOARA / Şcoala Primară Căprioara",3,1043,"SĂVÎRŞIN",11842,232,168,128,34,6,168,0,255,87,78,90
2,"ARAD",29,11842,,344,"VALEA MARE / Cămin Cultural Valea Mare",3,1043,"SĂVÎRŞIN",11842,177,133,105,26,2,133,0,195,62,61,72
2,"ARAD",29,11940,,345,"SECUSIGIU / PRIMARIA SECUSIGIU",3,1053,"SECUSIGIU",11940,890,456,411,45,0,453,3,985,529,163,290
2,"ARAD",29,11940,,346,"SECUSIGIU / SCOALA GENERALA SECUSIGIU",3,1053,"SECUSIGIU",11940,939,449,411,38,0,447,2,1030,581,148,299
2,"ARAD",29,11940,,347,"SATU MARE / FOSTUL SEDIU CAP",3,1053,"SECUSIGIU",11940,823,468,419,48,1,467,1,910,442,135,332
2,"ARAD",29,11940,,348,"MUNAR / CAMINUL CULTURAL MUNAR",3,1053,"SECUSIGIU",11940,413,323,273,50,0,322,1,450,127,122,200
2,"ARAD",29,11940,,349,"SÎNPETRU GERMAN / REMIZA PSI SINPETRU GERMAN",3,1053,"SECUSIGIU",11940,869,448,417,31,0,445,3,960,512,164,281
2,"ARAD",29,11940,,350,"SÎNPETRU GERMAN / SCOALA GENERALA SINPETRU GERMAN",3,1053,"SECUSIGIU",11940,865,477,441,36,0,468,9,950,473,206,262
2,"ARAD",29,11995,,351,"SELEUŞ / Primăria comunei Seleuş",3,1060,"SELEUŞ",11995,1557,1042,995,47,0,1036,6,1720,678,259,777
2,"ARAD",29,11995,,352,"IERMATA / Şcoala Generală din Iermata",3,1060,"SELEUŞ",11995,337,262,226,36,0,262,0,370,108,42,220
2,"ARAD",29,11995,,353,"MORODA / Sediul Secundar al Primariei Seleuş din satul Moroda",3,1060,"SELEUŞ",11995,574,378,352,26,0,375,3,630,252,103,272
2,"ARAD",29,12037,,354,"SEMLAC / SCOALA GENERALA DR. IOAN DANICICO",3,1064,"SEMLAC",12037,1726,879,791,87,1,875,4,1890,1011,228,647
2,"ARAD",29,12037,,355,"SEMLAC / SCOALA GENERALA CLASELE I-IV",3,1064,"SEMLAC",12037,1611,777,709,61,7,766,11,1770,993,222,544
2,"ARAD",29,12055,,356,"SINTEA MARE / Grădiniţa Sintea Mare",3,1080,"SINTEA MARE",12055,1007,601,547,53,1,597,4,1100,499,194,403
2,"ARAD",29,12055,,357,"ADEA / Căminul cultural din Adea",3,1080,"SINTEA MARE",12055,836,378,352,26,0,371,7,920,542,112,259
2,"ARAD",29,12055,,358,"ŢIPAR / Clădirea administrativă a Primăriei Sintea Mare",3,1080,"SINTEA MARE",12055,1147,623,582,41,0,617,6,1260,637,153,464
2,"ARAD",29,12126,,359,"SOCODOR / PRIMARIA SOCODOR",3,1093,"SOCODOR",12126,917,740,629,71,40,732,8,1000,260,254,478
2,"ARAD",29,12126,,360,"SOCODOR / Căminul cultural",3,1093,"SOCODOR",12126,916,693,603,38,52,692,1,1010,317,206,486
2,"ARAD",29,12144,,361,"ŞAGU / PRIMARIA SAGU",3,1037,"ŞAGU",12144,1283,791,731,60,0,784,7,1410,619,182,602
2,"ARAD",29,12144,,362,"ŞAGU / PRIMARIA SAGU",3,1037,"ŞAGU",12144,528,329,299,30,0,328,1,580,251,64,264
2,"ARAD",29,12144,,363,"CRUCENI / Şcoala Generală",3,1037,"ŞAGU",12144,592,317,282,34,1,312,5,650,333,107,205
2,"ARAD",29,12144,,364,"FIRITEAZ / Şcoala Generală",3,1037,"ŞAGU",12144,370,242,211,31,0,239,3,410,168,79,160
2,"ARAD",29,12144,,365,"FISCUT / Şcoala Generală",3,1037,"ŞAGU",12144,420,266,232,34,0,263,3,460,194,81,182
2,"ARAD",29,12144,,366,"HUNEDOARA TIMIŞANĂ / CAMIN CULTURAL",3,1037,"ŞAGU",12144,172,115,97,18,0,115,0,190,75,34,81
2,"ARAD",29,12206,,367,"ŞEITIN / PRIMARIA SEITIN",3,1058,"ŞEITIN",12206,1211,787,690,74,23,775,12,1330,543,331,444
2,"ARAD",29,12206,,368,"ŞEITIN / SCOALA GIMNAZIALA STEFAN BOZIAN SEITIN",3,1058,"ŞEITIN",12206,1225,731,671,51,9,720,11,1350,619,249,471
2,"ARAD",29,12224,,369,"ŞEPREUŞ / ŞCOALA GENERALĂ  ŞEPREUŞ",3,1066,"ŞEPREUŞ",12224,1002,557,496,50,11,551,6,1090,533,245,306
2,"ARAD",29,12224,,370,"ŞEPREUŞ / ŞCOALA GENERALĂ  ŞEPREUŞ",3,1066,"ŞEPREUŞ",12224,1140,546,503,37,6,540,6,1240,694,217,323
2,"ARAD",29,12242,,371,"GURBA / Şcoala Generală",3,1068,"ŞICULA",12242,922,547,489,58,0,546,1,1020,473,230,316
2,"ARAD",29,12242,,372,"CHERELUŞ / Şcoala Generală",3,1068,"ŞICULA",12242,754,480,435,45,0,474,6,830,350,206,268
2,"ARAD",29,12242,,373,"ŞICULA / CLUB CAMIN SICULA",3,1068,"ŞICULA",12242,941,552,501,51,0,547,5,1040,488,233,314
2,"ARAD",29,12242,,374,"ŞICULA / SCOALA GENERALA SICULA",3,1068,"ŞICULA",12242,967,489,446,39,4,487,2,1060,571,179,308
2,"ARAD",29,12288,,375,"ŞILINDIA / Căminul cultural",3,1072,"ŞILINDIA",12288,710,539,400,110,29,534,5,780,241,151,383
2,"ARAD",29,12340,,376,"ŞIMAND / Scoala Gimnaziala Şimand",3,1078,"ŞIMAND",12340,1384,781,712,69,0,772,9,1520,739,302,470
2,"ARAD",29,12340,,377,"ŞIMAND / Scoala Primara Şimand",3,1078,"ŞIMAND",12340,1202,772,719,52,1,759,13,1330,558,377,382
2,"ARAD",29,12340,,378,"ŞIMAND / Scoala primara Satu-Nou",3,1078,"ŞIMAND",12340,815,425,403,22,0,421,4,900,475,132,289
2,"ARAD",29,12368,,379,"ŞIRIA / CĂMIN CULTURAL",3,1084,"ŞIRIA",12368,1362,684,599,85,0,678,6,1490,806,231,447
2,"ARAD",29,12368,,380,"ŞIRIA / CĂMIN CULTURAL",3,1084,"ŞIRIA",12368,1371,650,590,59,1,646,4,1510,860,214,432
2,"ARAD",29,12368,,381,"GALŞA / CĂMIN CULTURAL",3,1084,"ŞIRIA",12368,809,478,445,31,2,476,2,890,412,152,324
2,"ARAD",29,12368,,382,"GALŞA / CĂMIN CULTURAL",3,1084,"ŞIRIA",12368,1071,603,562,41,0,596,7,1180,577,168,428
2,"ARAD",29,12368,,383,"ŞIRIA / SCOALA GENERALA CU CLASELE I-IV",3,1084,"ŞIRIA",12368,1732,628,582,45,1,613,15,1900,1272,182,431
2,"ARAD",29,12368,,384,"MÎSCA / CĂMIN CULTURAL",3,1084,"ŞIRIA",12368,773,535,483,52,0,528,7,850,315,268,260
2,"ARAD",29,12402,,385,"ŞIŞTAROVĂŢ / Primăria Şiştarovăţ",3,1088,"ŞIŞTAROVĂŢ",12402,265,197,162,35,0,195,2,295,98,105,90
2,"ARAD",29,9360,,386,"ŞOFRONEA / Căminul cultural",3,1095,"ŞOFRONEA",9360,1728,1179,1001,162,16,1162,17,1900,721,353,809
2,"ARAD",29,9360,,387,"SÎNPAUL / Şcoala cu clasele I-IV",3,1095,"ŞOFRONEA",9360,580,401,328,66,7,397,4,640,239,139,258
2,"ARAD",29,12457,,388,"MINIŞEL / Şcoala Generală",3,1098,"TAUŢ",12457,133,89,75,14,0,88,1,150,61,35,53
2,"ARAD",29,12457,,389,"TAUŢ / Căminul cultural",3,1098,"TAUŢ",12457,592,437,312,95,30,432,5,650,213,173,259
2,"ARAD",29,12457,,390,"NADĂŞ / Căminul cultural",3,1098,"TAUŢ",12457,662,449,402,39,8,439,10,730,281,207,232
2,"ARAD",29,12457,,391,"MINIŞU DE SUS / Căminul cultural",3,1098,"TAUŢ",12457,71,65,41,24,0,64,1,80,15,32,32
2,"ARAD",29,12509,,392,"TÎRNOVA / Căminul cultural Tirnova",3,1103,"TÎRNOVA",12509,1517,1120,947,130,43,1104,16,1670,550,417,687
2,"ARAD",29,12509,,393,"CHIER / Şcoala Generală Chier",3,1103,"TÎRNOVA",12509,968,613,514,72,27,611,2,1060,447,208,403
2,"ARAD",29,12509,,394,"AGRIŞU MARE / Căminul cultural Agrisu Mare",3,1103,"TÎRNOVA",12509,907,658,580,56,22,653,5,1000,342,74,579
2,"ARAD",29,12509,,395,"ARĂNEAG / Căminul cultural Araneag",3,1103,"TÎRNOVA",12509,318,291,216,54,21,288,3,350,59,100,188
2,"ARAD",29,12509,,396,"DRAUŢ / Căminul cultural Draut",3,1103,"TÎRNOVA",12509,700,622,475,113,34,616,6,770,148,266,350
2,"ARAD",29,12509,,397,"DUD / Căminul cultural Dud",3,1103,"TÎRNOVA",12509,535,395,338,44,13,388,7,590,195,98,290
2,"ARAD",29,10765,,398,"PĂTÂRŞ / Şcoala Generală",3,1110,"USUSĂU",10765,29,38,19,19,0,38,0,40,2,12,26
2,"ARAD",29,10765,,399,"USUSĂU / Şcoala Gimnaziala ""Teodor Pacatian"" Ususau",3,1110,"USUSĂU",10765,476,319,289,30,0,316,3,520,201,100,216
2,"ARAD",29,10765,,400,"DORGOŞ / Gradinita cu Program Normal Dorgos",3,1110,"USUSĂU",10765,196,131,108,23,0,130,1,215,84,65,65
2,"ARAD",29,10765,,401,"ZĂBALŢ / Scoala Primara Zabalt",3,1110,"USUSĂU",10765,252,165,130,33,2,165,0,275,110,72,93
2,"ARAD",29,10765,,402,"BRUZNIC / Gradinita cu Program Normal Bruznic",3,1110,"USUSĂU",10765,93,60,46,14,0,60,0,105,45,13,47
2,"ARAD",29,12572,,403,"VĂRĂDIA DE MUREŞ / Căminul cultural",3,1116,"VĂRĂDIA DE MUREŞ",12572,503,291,238,52,1,289,2,560,269,114,175
2,"ARAD",29,12572,,404,"LUPEŞTI / Căminul cultural",3,1116,"VĂRĂDIA DE MUREŞ",12572,228,166,148,18,0,164,2,250,84,53,111
2,"ARAD",29,12572,,405,"BAIA / Căminul cultural",3,1116,"VĂRĂDIA DE MUREŞ",12572,102,89,77,12,0,89,0,115,26,47,42
2,"ARAD",29,12572,,406,"JULIŢA / Şcoala cu clasele I-IV",3,1116,"VĂRĂDIA DE MUREŞ",12572,316,229,183,46,0,225,4,350,121,89,136
2,"ARAD",29,12572,,407,"NICOLAE BĂLCESCU / Şcoala cu clasele I-IV",3,1116,"VĂRĂDIA DE MUREŞ",12572,209,135,109,26,0,134,1,230,95,60,74
2,"ARAD",29,12572,,408,"STEJAR / Şcoala  cu clasele I-IV",3,1116,"VĂRĂDIA DE MUREŞ",12572,116,87,68,19,0,86,1,130,43,35,51
2,"ARAD",29,12643,,409,"VINGA / Primaria Vinga",3,1123,"VINGA",12643,901,532,460,71,1,527,5,1000,468,165,362
2,"ARAD",29,12643,,410,"VINGA / Şcoala nr. 2 Vinga",3,1123,"VINGA",12643,1191,678,577,101,0,670,8,1310,632,222,448
2,"ARAD",29,12643,,411,"VINGA / Grădiniţa PN Vinga",3,1123,"VINGA",12643,1516,781,725,56,0,774,7,1670,889,224,550
2,"ARAD",29,12643,,412,"MAILAT / Şcoala Generală Mailat",3,1123,"VINGA",12643,830,486,398,88,0,479,7,910,424,96,383
2,"ARAD",29,12643,,413,"MĂNĂŞTUR / Şcoala Generală Mănăştur",3,1123,"VINGA",12643,948,572,509,63,0,566,6,1040,468,146,420
2,"ARAD",29,12689,,414,"VÎRFURILE / Primăria Vîrfurile",3,1127,"VÎRFURILE",12689,1060,637,589,44,4,630,7,1160,523,258,372
2,"ARAD",29,12689,,415,"AVRAM IANCU / Şcoala Generală Avram Iancu",3,1127,"VÎRFURILE",12689,703,469,427,42,0,464,5,770,301,170,294
2,"ARAD",29,12689,,416,"LAZURI / Cămin Cultural Lazuri",3,1127,"VÎRFURILE",12689,683,414,372,42,0,411,3,750,336,178,233
2,"ARAD",29,9397,,417,"MÎNDRULOC / Şcoala Generală",3,1136,"VLADIMIRESCU",9397,1060,665,582,83,0,656,9,1160,495,190,466
2,"ARAD",29,9397,,418,"CICIR / Şcoala Generală",3,1136,"VLADIMIRESCU",9397,791,537,471,66,0,531,6,870,333,188,343
2,"ARAD",29,9397,,419,"VLADIMIRESCU / Cămin cultural",3,1136,"VLADIMIRESCU",9397,1614,839,762,77,0,831,8,1760,921,201,630
2,"ARAD",29,9397,,420,"VLADIMIRESCU / Primaria Vladimirescu",3,1136,"VLADIMIRESCU",9397,1535,826,723,103,0,818,8,1690,864,192,626
2,"ARAD",29,9397,,421,"VLADIMIRESCU / Centru de zi vârstnici",3,1136,"VLADIMIRESCU",9397,1748,1013,923,87,3,1002,11,1900,887,245,757
2,"ARAD",29,9397,,422,"VLADIMIRESCU / Şcoala Generală",3,1136,"VLADIMIRESCU",9397,1492,892,823,69,0,875,17,1640,748,205,670
2,"ARAD",29,9397,,423,"HORIA / Şcoala Generală",3,1136,"VLADIMIRESCU",9397,1090,671,617,54,0,662,9,1200,529,250,412
2,"ARAD",29,9397,,424,"HORIA / Cladire taxe şi impozite",3,1136,"VLADIMIRESCU",9397,1071,582,550,32,0,575,7,1170,588,188,387
2,"ARAD",29,12778,,425,"NEUDORF / Cămin Cultural",3,1141,"ZĂBRANI",12778,865,499,428,68,3,489,10,950,451,164,325
2,"ARAD",29,12778,,426,"ZĂBRANI / CĂMIN  CULTURAL",3,1141,"ZĂBRANI",12778,1028,561,509,52,0,558,3,1140,579,162,396
2,"ARAD",29,12778,,427,"ZĂBRANI / GRĂDINIŢA CU PROGRAM NORMAL ZĂBRANI",3,1141,"ZĂBRANI",12778,930,503,469,34,0,499,4,1020,517,188,311
2,"ARAD",29,12778,,428,"CHESINŢ / Grădiniţa PN",3,1141,"ZĂBRANI",12778,973,592,537,55,0,588,4,1070,478,159,429
2,"ARAD",29,12938,,429,"BODROGU NOU / Cămin Cultural",3,1145,"ZĂDĂRENI",12938,233,151,115,36,0,149,2,261,110,43,106
2,"ARAD",29,12938,,430,"ZĂDĂRENI / Sala de Şedinţe a Consiliului Local Zădăreni",3,1145,"ZĂDĂRENI",12938,964,523,469,51,3,520,3,1050,527,168,352
2,"ARAD",29,12938,,431,"ZĂDĂRENI / Sediu S.V.S.U. Zădăreni",3,1145,"ZĂDĂRENI",12938,1051,663,593,66,4,658,5,1160,497,203,455
2,"ARAD",29,12812,,432,"CINTEI / Şcoala Generală",3,1148,"ZĂRAND",12812,948,595,554,39,2,590,5,1040,445,181,409
2,"ARAD",29,12812,,433,"ZĂRAND / Primăria Zărand",3,1148,"ZĂRAND",12812,1110,729,650,79,0,713,16,1220,491,435,278
2,"ARAD",29,12849,,434,"ZERIND / Primăria Comunei Zerind",3,1151,"ZERIND",12849,725,340,298,42,0,337,3,790,450,63,274
2,"ARAD",29,12849,,435,"IERMATA NEAGRĂ / Şcoala Generală I-IV",3,1151,"ZERIND",12849,445,216,180,36,0,215,1,490,274,33,182
2,"ARAD",29,12876,,436,"ZIMANDU NOU / CĂMIN CULTURAL",3,1154,"ZIMANDU NOU",12876,1407,859,760,74,25,853,6,1550,691,107,746
2,"ARAD",29,12876,,437,"ANDREI ŞAGUNA / Căminul Cultural",3,1154,"ZIMANDU NOU",12876,1240,887,772,98,17,879,8,1360,473,166,713
2,"ARAD",29,12876,,438,"ZIMANDCUZ / Căminul Cultural",3,1154,"ZIMANDU NOU",12876,1218,690,634,56,0,683,7,1340,650,190,493
2,"ARAD",29,12876,,439,"ZIMANDU NOU / SCOALA GENERALA  I-IV",3,1154,"ZIMANDU NOU",12876,216,162,125,37,0,161,1,234,72,31,130
3,"ARGEŞ","#N/A",13169,,1,"PITEŞTI / BIBLIOTECA JUDEŢEANĂ ARGEŞ ""DINICU GOLESCU""",1,1159,"MUNICIPIUL PITEŞTI",13169,1351,1110,825,285,0,1088,22,1515,405,533,555
3,"ARGEŞ","#N/A",13169,,2,"PITEŞTI / COLEGIUL ECONOMIC ""MARIA TEIULEANU""",1,1159,"MUNICIPIUL PITEŞTI",13169,1179,903,783,120,0,894,9,1300,397,398,496
3,"ARGEŞ","#N/A",13169,,3,"PITEŞTI / ŞCOALA GIMNAZIALĂ ""ION PILLAT"" ( FOSTĂ ŞCOALĂ NR.3)",1,1159,"MUNICIPIUL PITEŞTI",13169,1042,657,618,39,0,641,16,1100,443,304,337
3,"ARGEŞ","#N/A",13169,,4,"PITEŞTI / COLEGIUL ECONOMIC ""MARIA TEIULEANU"" (fost LICEUL TEHNOLOGIC ""ION MINCU"")",1,1159,"MUNICIPIUL PITEŞTI",13169,1534,1018,952,65,1,1002,16,1700,682,499,503
3,"ARGEŞ","#N/A",13169,,5,"PITEŞTI / ŞCOALA GIMNAZIALĂ "" NEGRU VODĂ"" ( FOSTĂ ŞCOALA NR. 12)",1,1159,"MUNICIPIUL PITEŞTI",13169,1827,1161,1066,95,0,1137,24,2000,839,602,535
3,"ARGEŞ","#N/A",13169,,6,"PITEŞTI / ŞCOALA GIMNAZIALĂ "" NEGRU VODĂ"" ( FOSTĂ ŞCOALA NR. 12)",1,1159,"MUNICIPIUL PITEŞTI",13169,1681,969,930,38,1,947,22,1900,931,501,446
3,"ARGEŞ","#N/A",13169,,7,"PITEŞTI / ŞCOALA GIMNAZIALĂ "" NEGRU VODĂ"" ( FOSTĂ ŞCOALA NR. 12)",1,1159,"MUNICIPIUL PITEŞTI",13169,1897,1057,1007,50,0,1039,18,2100,1043,544,495
3,"ARGEŞ","#N/A",13169,,8,"PITEŞTI / ŞCOALA GIMNAZIALĂ "" NEGRU VODĂ"" ( FOSTĂ ŞCOALA NR. 12)",1,1159,"MUNICIPIUL PITEŞTI",13169,1899,1119,1078,41,0,1100,19,2100,981,637,463
3,"ARGEŞ","#N/A",13169,,9,"PITEŞTI / GRĂDINIŢA  CU PROGRAM PRELUNGIT "" MICUL PRINŢ"" (FOSTA GRĂDINIŢA  CU PROGRAM PRELUNGIT NR. 13",1,1159,"MUNICIPIUL PITEŞTI",13169,1983,1207,1144,63,0,1186,21,2200,993,604,582
3,"ARGEŞ","#N/A",13169,,10,"PITEŞTI / ŞCOALA  GIMNAZIALĂ ""MIRCEA CEL  BĂTRAN"" (FOSTĂ ŞCOALA  NR. 13)",1,1159,"MUNICIPIUL PITEŞTI",13169,1958,1246,1177,69,0,1224,22,2100,854,669,555
3,"ARGEŞ","#N/A",13169,,11,"PITEŞTI / ŞCOALA  GIMNAZIALĂ ""MIRCEA CEL  BĂTRAN"" (FOSTĂ ŞCOALA  NR. 13)",1,1159,"MUNICIPIUL PITEŞTI",13169,1938,1177,1125,52,0,1155,22,2100,923,664,491
3,"ARGEŞ","#N/A",13169,,12,"PITEŞTI / ŞCOALA  GIMNAZIALĂ ""MIRCEA CEL  BĂTRAN"" (FOSTĂ ŞCOALA  NR. 13)",1,1159,"MUNICIPIUL PITEŞTI",13169,1963,1249,1177,69,3,1232,17,2100,851,693,539
3,"ARGEŞ","#N/A",13169,,13,"PITEŞTI / ŞCOALA  GIMNAZIALĂ ""MIRCEA CEL  BĂTRAN"" (FOSTĂ ŞCOALA  NR. 13)",1,1159,"MUNICIPIUL PITEŞTI",13169,1908,1257,1161,96,0,1236,21,2100,843,662,574
3,"ARGEŞ","#N/A",13169,,14,"PITEŞTI / GRĂDINIŢA CU PROGRAM PRELUNGIT ""LUMINIŞUL PĂDURII"" (FOSTĂ GRĂDINIŢĂ  NR. 6)",1,1159,"MUNICIPIUL PITEŞTI",13169,1494,999,940,58,1,972,27,1600,601,538,434
3,"ARGEŞ","#N/A",13169,,15,"PITEŞTI / GRĂDINIŢA CU PROGRAM PRELUNGIT ""LUMINIŞUL PĂDURII"" (FOSTĂ GRĂDINIŢĂ  NR. 6)",1,1159,"MUNICIPIUL PITEŞTI",13169,1761,1120,1078,42,0,1102,18,1900,780,600,502
3,"ARGEŞ","#N/A",13169,,16,"PITEŞTI / LICEUL TEHNOLOGIC ""DACIA"" (FOST GRUP ŞCOLAR INDUSTRIAL CONSTRUCŢII MAŞINI)",1,1159,"MUNICIPIUL PITEŞTI",13169,1569,1090,987,103,0,1068,22,1700,610,512,556
3,"ARGEŞ","#N/A",13169,,17,"PITEŞTI / COLEGIUL NAŢIONAL ""I.C. BRĂTIANU""",1,1159,"MUNICIPIUL PITEŞTI",13169,977,713,608,105,0,704,9,1100,387,319,385
3,"ARGEŞ","#N/A",13169,,18,"PITEŞTI / ŞCOALA GIMNAZIALĂ ""N. BĂLCESCU""(fosta ŞCOALA GIMNAZIALĂ NR.9)",1,1159,"MUNICIPIUL PITEŞTI",13169,1665,1125,1046,47,32,1105,20,1800,675,632,473
3,"ARGEŞ","#N/A",13169,,19,"PITEŞTI / ŞCOALA GIMNAZIALĂ ""N. BĂLCESCU"" (fosta ŞCOALA GIMNAZIALĂ NR.9)",1,1159,"MUNICIPIUL PITEŞTI",13169,1694,1164,1048,74,42,1142,22,1900,736,589,553
3,"ARGEŞ","#N/A",13169,,20,"PITEŞTI / GARDA NAŢIONALĂ DE MEDIU - COMISARIATUL REGIONAL ARGEŞ",1,1159,"MUNICIPIUL PITEŞTI",13169,1648,963,925,38,0,944,19,1800,837,538,406
3,"ARGEŞ","#N/A",13169,,21,"PITEŞTI / SC GROSMETCHIM SA",1,1159,"MUNICIPIUL PITEŞTI",13169,1225,762,726,35,1,750,12,1300,538,444,306
3,"ARGEŞ","#N/A",13169,,22,"PITEŞTI / ŞCOALA GIMNAZIALĂ  ""N. Bălcescu"" ( FOSTA ŞCOALĂ NR.6)",1,1159,"MUNICIPIUL PITEŞTI",13169,1924,1195,1144,51,0,1168,27,2100,905,614,554
3,"ARGEŞ","#N/A",13169,,23,"PITEŞTI / ŞCOALA GIMNAZIALĂ  ""N. Bălcescu"" ( FOSTA ŞCOALĂ NR.6)",1,1159,"MUNICIPIUL PITEŞTI",13169,1801,1037,982,55,0,1017,20,2000,963,597,420
3,"ARGEŞ","#N/A",13169,,24,"PITEŞTI / ŞCOALA GIMNAZIALĂ  ""N. Bălcescu"" ( FOSTA ŞCOALĂ NR.6)",1,1159,"MUNICIPIUL PITEŞTI",13169,1857,1183,1110,73,0,1165,18,1900,717,658,507
3,"ARGEŞ","#N/A",13169,,25,"PITEŞTI / ŞCOALA GIMNAZIALĂ  ""N. Bălcescu"" ( FOSTA ŞCOALĂ NR.6)",1,1159,"MUNICIPIUL PITEŞTI",13169,1859,1168,1102,66,0,1151,17,2000,832,596,555
3,"ARGEŞ","#N/A",13169,,26,"PITEŞTI / GRĂDINIŢA CU PROGRAM PRELUNGIT ""ALBĂ CA ZĂPADA"" ( FOSTA GRĂDINIŢĂ  NR. 10)",1,1159,"MUNICIPIUL PITEŞTI",13169,1945,1176,1113,62,1,1151,25,2097,921,674,477
3,"ARGEŞ","#N/A",13169,,27,"PITEŞTI / ŞCOALA GIMNAZIALĂ  ""ADRIAN PĂUNESCU"" (FOSTĂ ŞCOALA NR. 15 )",1,1159,"MUNICIPIUL PITEŞTI",13169,1865,1146,1086,60,0,1126,20,2002,856,644,482
3,"ARGEŞ","#N/A",13169,,28,"PITEŞTI / ŞCOALA GIMNAZIALĂ  ""ADRIAN PĂUNESCU"" (FOSTĂ ŞCOALA NR. 15 )",1,1159,"MUNICIPIUL PITEŞTI",13169,1870,1179,1084,95,0,1154,25,2100,921,705,449
3,"ARGEŞ","#N/A",13169,,29,"PITEŞTI / GRĂDINIŢA CU PROGRAM NORMAL NR. 22",1,1159,"MUNICIPIUL PITEŞTI",13169,1848,1189,1135,54,0,1164,25,2000,811,603,561
3,"ARGEŞ","#N/A",13169,,30,"PITEŞTI / S.C.  LISA DRAXLMAIER  S.A.",1,1159,"MUNICIPIUL PITEŞTI",13169,1909,1203,1140,62,1,1179,24,2000,797,627,552
3,"ARGEŞ","#N/A",13169,,31,"PITEŞTI / S.C.  LISA DRAXLMAIER  S.A.",1,1159,"MUNICIPIUL PITEŞTI",13169,1934,1320,1203,117,0,1297,23,2100,780,699,598
3,"ARGEŞ","#N/A",13169,,32,"PITEŞTI / LICEUL TEORETIC ""ION CANTACUZINIO""",1,1159,"MUNICIPIUL PITEŞTI",13169,1836,1207,1078,129,0,1187,20,2000,793,621,566
3,"ARGEŞ","#N/A",13169,,33,"PITEŞTI / LICEUL TEORETIC ""ION CANTACUZINIO""",1,1159,"MUNICIPIUL PITEŞTI",13169,1973,1338,1270,68,0,1314,24,2200,862,716,598
3,"ARGEŞ","#N/A",13169,,34,"PITEŞTI / LICEUL TEORETIC "" ION CANTACUZINO""",1,1159,"MUNICIPIUL PITEŞTI",13169,1879,1060,1016,44,0,1045,15,2100,1040,628,417
3,"ARGEŞ","#N/A",13169,,35,"PITEŞTI / Policlinica Spitalului Judeţean",1,1159,"MUNICIPIUL PITEŞTI",13169,1727,1414,1065,147,202,1384,30,1800,386,842,542
3,"ARGEŞ","#N/A",13169,,36,"PITEŞTI / ŞCOALA GIMNAZIALĂ ""MATEI BASARAB"" ( FOSTA ŞCOALA NR. 19)",1,1159,"MUNICIPIUL PITEŞTI",13169,1728,1203,1113,90,0,1183,20,1900,697,591,592
3,"ARGEŞ","#N/A",13169,,37,"PITEŞTI / ŞCOALA GIMNAZIALĂ ""MATEI BASARAB"" ( FOSTA ŞCOALA NR. 19)",1,1159,"MUNICIPIUL PITEŞTI",13169,1782,1243,1143,100,0,1218,25,2000,757,611,607
3,"ARGEŞ","#N/A",13169,,38,"PITEŞTI / ŞCOALA GIMNAZIALĂ ""MATEI BASARAB""  (fosta Şcoală nr.19)",1,1159,"MUNICIPIUL PITEŞTI",13169,1613,1013,954,57,2,989,24,1800,787,505,484
3,"ARGEŞ","#N/A",13169,,39,"PITEŞTI / UNIVERSITATEA ""CONSTANTIN BRÂNCOVEANU""",1,1159,"MUNICIPIUL PITEŞTI",13169,1508,914,867,46,1,900,14,1700,786,476,424
3,"ARGEŞ","#N/A",13169,,40,"PITEŞTI / Universitatea ""Constantin Brâncoveanu""",1,1159,"MUNICIPIUL PITEŞTI",13169,1671,1087,993,94,0,1065,22,1800,713,569,496
3,"ARGEŞ","#N/A",13169,,41,"PITEŞTI / ŞCOALA GIMNAZIALĂ ""ALEXANDRU DAVILA"" (FOSTĂ ŞCOALĂ NR.14)",1,1159,"MUNICIPIUL PITEŞTI",13169,1927,1258,1155,103,0,1232,26,2100,842,637,595
3,"ARGEŞ","#N/A",13169,,42,"PITEŞTI / ŞCOALA GIMNAZIALĂ  ""MARIN PREDA"" (FOSTA ŞCOALĂ NR.10)",1,1159,"MUNICIPIUL PITEŞTI",13169,1792,1237,1158,79,0,1225,12,2000,763,639,586
3,"ARGEŞ","#N/A",13169,,43,"PITEŞTI / ŞCOALA GIMNAZIALĂ  ""MARIN PREDA"" (FOSTA ŞCOALĂ NR.10)",1,1159,"MUNICIPIUL PITEŞTI",13169,1545,1090,980,110,0,1071,19,1700,610,590,481
3,"ARGEŞ","#N/A",13169,,44,"PITEŞTI / ŞCOALA GIMNAZIALĂ  ""MARIN PREDA"" (FOSTA ŞCOALĂ NR.10)",1,1159,"MUNICIPIUL PITEŞTI",13169,1732,1216,1144,72,0,1195,21,1900,684,644,551
3,"ARGEŞ","#N/A",13169,,45,"PITEŞTI / COLEGIUL TEHNIC "" ARMAND CĂLINESCU""",1,1159,"MUNICIPIUL PITEŞTI",13169,804,575,486,64,25,565,10,900,325,271,294
3,"ARGEŞ","#N/A",13169,,46,"PITEŞTI / COLEGIUL TEHNIC "" ARMAND CĂLINESCU""",1,1159,"MUNICIPIUL PITEŞTI",13169,1505,1046,960,56,30,1033,13,1699,653,519,514
3,"ARGEŞ","#N/A",13169,,47,"PITEŞTI / ŞCOALA GIMNAZIALĂ ""NICOLAE SIMONIDE"" (FOSTĂ ŞCOALĂ NR.1)",1,1159,"MUNICIPIUL PITEŞTI",13169,1224,839,793,46,0,821,18,1400,561,475,346
3,"ARGEŞ","#N/A",13169,,48,"PITEŞTI / ŞCOALA GIMNAZIALĂ ""NICOLAE SIMONIDE"" (FOSTĂ ŞCOALĂ NR.1)",1,1159,"MUNICIPIUL PITEŞTI",13169,1651,1073,996,76,1,1053,20,1800,727,514,539
3,"ARGEŞ","#N/A",13169,,49,"PITEŞTI / ŞCOALA GIMNAZIALĂ ""NICOLAE SIMONIDE"" (FOSTĂ ŞCOALĂ NR.1)",1,1159,"MUNICIPIUL PITEŞTI",13169,959,671,621,50,0,657,14,1100,429,355,302
3,"ARGEŞ","#N/A",13169,,50,"PITEŞTI / DIRECŢIA APELOR ARGEŞ-VEDEA",1,1159,"MUNICIPIUL PITEŞTI",13169,970,631,590,41,0,617,14,1100,469,345,272
3,"ARGEŞ","#N/A",13169,,51,"PITEŞTI / DISPENSARUL NR. 16 (în clădirea creşei nr. 9)",1,1159,"MUNICIPIUL PITEŞTI",13169,1833,1205,1152,53,0,1171,34,2000,795,588,583
3,"ARGEŞ","#N/A",13169,,52,"PITEŞTI / ŞCOALA GIMNAZIALĂ ""NICOLAE IORGA""(FOSTĂ ŞCOALĂ NR.5)",1,1159,"MUNICIPIUL PITEŞTI",13169,1524,1080,1005,75,0,1058,22,1700,620,497,561
3,"ARGEŞ","#N/A",13169,,53,"PITEŞTI / ŞCOALA GIMNAZIALĂ ""NICOLAE IORGA""(FOSTĂ ŞCOALĂ NR.5)",1,1159,"MUNICIPIUL PITEŞTI",13169,1070,724,670,54,0,709,15,1200,476,305,404
3,"ARGEŞ","#N/A",13169,,54,"PITEŞTI / ŞCOALA GIMNAZIALĂ ""TUDOR VLADIMIRESCU"" ( FOSTĂ ŞCOALĂ NR.20)",1,1159,"MUNICIPIUL PITEŞTI",13169,1748,1103,1042,61,0,1082,21,1900,797,572,510
3,"ARGEŞ","#N/A",13169,,55,"PITEŞTI / ŞCOALA GIMNAZIALĂ ""TUDOR VLADIMIRESCU"" ( FOSTĂ ŞCOALĂ NR.20)",1,1159,"MUNICIPIUL PITEŞTI",13169,1705,1045,977,68,0,1026,19,1900,855,495,531
3,"ARGEŞ","#N/A",13169,,56,"PITEŞTI / ŞCOALA GIMNAZIALĂ "" TUDOR VLADIMIRESCU"" ( FOSTĂ ŞCOALĂ NR.20)",1,1159,"MUNICIPIUL PITEŞTI",13169,1905,1215,1172,43,0,1181,34,2100,885,622,559
3,"ARGEŞ","#N/A",13169,,57,"PITEŞTI / ŞCOALA GIMNAZIALĂ "" MIRCEA ELIADE"" ( FOSTĂ ŞCOALĂ NR.18)",1,1159,"MUNICIPIUL PITEŞTI",13169,1790,1070,1009,61,0,1062,8,2000,930,560,502
3,"ARGEŞ","#N/A",13169,,58,"PITEŞTI / ŞCOALA GIMNAZIALĂ "" MIRCEA ELIADE"" ( FOSTĂ ŞCOALĂ NR.18)",1,1159,"MUNICIPIUL PITEŞTI",13169,1782,1005,967,37,1,984,21,2000,995,542,442
3,"ARGEŞ","#N/A",13169,,59,"PITEŞTI / ŞCOALA GIMNAZIALĂ "" TUDOR ARGHEZI"" ( FOSTĂ ŞCOALĂ NR.7)",1,1159,"MUNICIPIUL PITEŞTI",13169,1881,1083,1015,68,0,1064,19,2100,1017,546,518
3,"ARGEŞ","#N/A",13169,,60,"PITEŞTI / ŞCOALA GIMNAZIALĂ "" TUDOR ARGHEZI"" ( FOSTĂ ŞCOALĂ NR.7)",1,1159,"MUNICIPIUL PITEŞTI",13169,1878,1238,1112,126,0,1209,29,2100,862,634,575
3,"ARGEŞ","#N/A",13169,,61,"PITEŞTI / ŞCOALA GIMNAZIALĂ "" TUDOR ARGHEZI"" ( FOSTĂ ŞCOALĂ NR.7)",1,1159,"MUNICIPIUL PITEŞTI",13169,1960,1342,1253,89,0,1316,26,2200,858,694,622
3,"ARGEŞ","#N/A",13169,,62,"PITEŞTI / ŞCOALA GIMNAZIALĂ "" TUDOR ARGHEZI"" ( FOSTĂ ŞCOALĂ NR.7)",1,1159,"MUNICIPIUL PITEŞTI",13169,1913,1196,1132,64,0,1167,29,2100,904,681,486
3,"ARGEŞ","#N/A",13169,,63,"PITEŞTI / COLEGIUL TEHNIC ""CD NENIŢESCU""",1,1159,"MUNICIPIUL PITEŞTI",13169,1605,979,867,112,0,964,15,1798,819,537,427
3,"ARGEŞ","#N/A",13169,,64,"PITEŞTI / COLEGIUL TEHNIC ""CD NENIŢESCU""",1,1159,"MUNICIPIUL PITEŞTI",13169,1671,1074,1025,49,0,1054,20,1800,726,596,458
3,"ARGEŞ","#N/A",13169,,65,"PITEŞTI / COLEGIUL TEHNIC ""CD NENIŢESCU""",1,1159,"MUNICIPIUL PITEŞTI",13169,1767,1092,1043,49,0,1069,23,1900,808,630,439
3,"ARGEŞ","#N/A",13169,,66,"PITEŞTI / ŞCOALA NR. 8",1,1159,"MUNICIPIUL PITEŞTI",13169,1865,1383,1241,140,2,1358,25,2100,717,686,672
3,"ARGEŞ","#N/A",13169,,67,"PITEŞTI / CLUBUL PENSIONARILOR",1,1159,"MUNICIPIUL PITEŞTI",13169,1925,1210,1156,54,0,1196,14,2100,890,672,524
3,"ARGEŞ","#N/A",13169,,68,"PITEŞTI / ŞCOALA GIMNAZIALĂ ""MIHAI EMINESCU"" (FOSTA ŞCOALA NR.11)",1,1159,"MUNICIPIUL PITEŞTI",13169,1578,1058,979,79,0,1036,22,1700,642,574,462
3,"ARGEŞ","#N/A",13169,,69,"PITEŞTI / ŞCOALA GIMNAZIALĂ ""MIHAI EMINESCU"" (FOSTA ŞCOALA NR.11)",1,1159,"MUNICIPIUL PITEŞTI",13169,1450,1023,897,126,0,1000,23,1600,577,531,469
3,"ARGEŞ","#N/A",13169,,70,"PITEŞTI / GRĂDINIŢA CU PROGRAM PRELUNGIT "" FLOARE DE COLŢ"" ( FOSTA GRĂDINIŢĂ NR.5)",1,1159,"MUNICIPIUL PITEŞTI",13169,1227,861,803,58,0,838,23,1400,539,445,393
3,"ARGEŞ","#N/A",13169,,71,"PITEŞTI / UNIVERSITATEA PITEŞTI",1,1159,"MUNICIPIUL PITEŞTI",13169,1831,1283,1136,147,0,1257,26,2000,717,642,615
3,"ARGEŞ","#N/A",13169,,72,"PITEŞTI / COLEGIUL NAŢIONAL ""ALEXANDRU ODOBESCU""",1,1159,"MUNICIPIUL PITEŞTI",13169,1930,1268,1202,66,0,1246,22,2100,832,706,540
3,"ARGEŞ","#N/A",13169,,73,"PITEŞTI / COLEGIUL NAŢIONAL ""ALEXANDRU ODOBESCU""",1,1159,"MUNICIPIUL PITEŞTI",13169,1792,1075,1020,55,0,1047,28,1999,924,567,480
3,"ARGEŞ","#N/A",13169,,74,"PITEŞTI / GRĂDINIŢA CU PROGRAM PRELUNGIT "" ARMONIA"" ( FOSTA GRĂDINIŢĂ NR.8)",1,1159,"MUNICIPIUL PITEŞTI",13169,1939,1048,962,86,0,1031,17,2100,1052,598,433
3,"ARGEŞ","#N/A",13169,,75,"PITEŞTI / ŞCOALA GIMNAZIALĂ ""ION MINULESCU"" (FOSTA ŞCOALĂ NR.2)",1,1159,"MUNICIPIUL PITEŞTI",13169,1573,973,879,94,0,950,23,1700,727,519,431
3,"ARGEŞ","#N/A",13169,,76,"PITEŞTI / ŞCOALA GIMNAZIALĂ ""ION MINULESCU"" (FOSTA ŞCOALĂ NR.2)",1,1159,"MUNICIPIUL PITEŞTI",13169,1810,1218,1114,103,1,1195,23,2000,782,697,498
3,"ARGEŞ","#N/A",13169,,77,"PITEŞTI / COLEGIUL TEHNIC ""DIMITRIE DIMA""",1,1159,"MUNICIPIUL PITEŞTI",13169,1905,1229,1137,92,0,1199,30,2100,871,651,548
3,"ARGEŞ","#N/A",13169,,78,"PITEŞTI / COLEGIUL TEHNIC ""DIMITRIE DIMA""",1,1159,"MUNICIPIUL PITEŞTI",13169,2096,1190,1116,74,0,1165,25,2300,1110,715,450
3,"ARGEŞ","#N/A",13169,,79,"PITEŞTI / ŞCOALA GIMNAZIALĂ "" TUDOR MUŞATESCU"" (FOSTA ŞCOALA NR. 17)",1,1159,"MUNICIPIUL PITEŞTI",13169,2007,1112,1057,55,0,1089,23,2000,888,615,474
3,"ARGEŞ","#N/A",13169,,80,"PITEŞTI / LICEUL TEHNOLOGIC "" CONSTANTIN BRÂNCUŞI"" ( FOST LICEU TEHNOLOGIC DE  INDUSTRIALIZAREA LEMNULUI)",1,1159,"MUNICIPIUL PITEŞTI",13169,1776,1170,1110,60,0,1150,20,2000,830,607,543
3,"ARGEŞ","#N/A",13169,,81,"PITEŞTI / LICEUL TEHNOLOGIC "" CONSTANTIN BRÂNCUŞI"" ( FOST LICEU TEHNOLOGIC DE  INDUSTRIALIZAREA LEMNULUI)",1,1159,"MUNICIPIUL PITEŞTI",13169,1764,1170,1118,52,0,1136,34,1900,730,604,532
3,"ARGEŞ","#N/A",13169,,82,"PITEŞTI / GRĂDINIŢA CU PROGRAM NORMAL "" ACADEMIA ISTEŢEL"" ( FOSTA GRĂDINIŢĂ NR.4)",1,1159,"MUNICIPIUL PITEŞTI",13169,1795,1098,1058,40,0,1079,19,2000,902,615,464
3,"ARGEŞ","#N/A",13169,,83,"PITEŞTI / GRĂDINIŢA CU PROGRAM PRELUNGIT "" ARIPILE DESCHISE"" ( FOSTA GRĂDINIŢĂ NR.14)",1,1159,"MUNICIPIUL PITEŞTI",13169,1786,1131,1084,47,0,1109,22,2000,869,604,505
3,"ARGEŞ","#N/A",13169,,84,"PITEŞTI / ŞCOALA GIMNAZIALĂ ""I. L. CARAGIALE"" (FOSTĂ ŞCOALĂ NR.16)",1,1159,"MUNICIPIUL PITEŞTI",13169,1750,1091,1010,81,0,1071,20,1900,809,594,477
3,"ARGEŞ","#N/A",13169,,85,"PITEŞTI / ŞCOALA GIMNAZIALĂ ""I. L. CARAGIALE"" (FOSTĂ ŞCOALĂ NR.16)",1,1159,"MUNICIPIUL PITEŞTI",13169,1825,1076,1041,35,0,1054,22,2000,924,603,451
3,"ARGEŞ","#N/A",13169,,86,"PITEŞTI / ŞCOALA GIMNAZIALĂ ""I. L. CARAGIALE"" (FOSTĂ ŞCOALĂ NR.16)",1,1159,"MUNICIPIUL PITEŞTI",13169,1776,1117,1086,31,0,1097,20,2000,883,602,495
3,"ARGEŞ","#N/A",13169,,87,"PITEŞTI / ŞCOALA GIMNAZIALĂ "" TRAIAN"" ( FOSTĂ ŞCOALĂ NR.4)",1,1159,"MUNICIPIUL PITEŞTI",13169,1504,1064,985,79,0,1040,24,1700,636,563,477
3,"ARGEŞ","#N/A",13169,,88,"PITEŞTI / ŞCOALA GIMNAZIALĂ "" TRAIAN"" ( FOSTĂ ŞCOALĂ NR.4)",1,1159,"MUNICIPIUL PITEŞTI",13169,1760,1202,1092,108,2,1172,30,1900,698,627,545
3,"ARGEŞ","#N/A",13490,,89,"CÂMPULUNG / SCOALA GENERALA NR. 1 - I",1,1161,"MUNICIPIUL CÂMPULUNG",13490,854,602,528,74,0,596,6,1000,398,285,311
3,"ARGEŞ","#N/A",13490,,90,"CÂMPULUNG / ŞCOALA GENERALĂ NR. 1 - II",1,1161,"MUNICIPIUL CÂMPULUNG",13490,976,652,600,51,1,641,11,1100,448,325,316
3,"ARGEŞ","#N/A",13490,,91,"CÂMPULUNG / LICEUL INDUSTRIAL NR. 1",1,1161,"MUNICIPIUL CÂMPULUNG",13490,1263,932,775,130,27,926,6,1400,468,435,491
3,"ARGEŞ","#N/A",13490,,92,"CÂMPULUNG / BIBLIOTECA GRUI",1,1161,"MUNICIPIUL CÂMPULUNG",13490,1773,979,911,67,1,962,17,1900,921,408,554
3,"ARGEŞ","#N/A",13490,,93,"CÂMPULUNG / GRADINITA CU PROGRAM NORMAL NR 12 - I",1,1161,"MUNICIPIUL CÂMPULUNG",13490,1708,907,866,40,1,892,15,1900,993,416,476
3,"ARGEŞ","#N/A",13490,,94,"CÂMPULUNG / GRADINITA CU PROGRAM NORMAL NR. 12 - II",1,1161,"MUNICIPIUL CÂMPULUNG",13490,1536,848,820,28,0,832,16,1700,852,407,425
3,"ARGEŞ","#N/A",13490,,95,"CÂMPULUNG / GRADINITA CU PROGRAM NORMAL NR. 12 - III",1,1161,"MUNICIPIUL CÂMPULUNG",13490,1595,890,856,34,0,872,18,1700,810,441,431
3,"ARGEŞ","#N/A",13490,,96,"CÂMPULUNG / ŞCOALA GENERALĂ NR. 5",1,1161,"MUNICIPIUL CÂMPULUNG",13490,1091,657,615,42,0,651,6,1200,543,311,340
3,"ARGEŞ","#N/A",13490,,97,"CÂMPULUNG / S.C. HIDROELECTRICA S.A",1,1161,"MUNICIPIUL CÂMPULUNG",13490,944,618,585,33,0,610,8,1000,382,366,244
3,"ARGEŞ","#N/A",13490,,98,"CÂMPULUNG / ŞCOALA GENERALĂ NR. 7 VIŞOI - I",1,1161,"MUNICIPIUL CÂMPULUNG",13490,1521,892,842,50,0,878,14,1700,808,427,451
3,"ARGEŞ","#N/A",13490,,99,"CÂMPULUNG / ŞCOALA GENERALĂ NR. 7 VIŞOI - II",1,1161,"MUNICIPIUL CÂMPULUNG",13490,1227,672,640,32,0,658,14,1400,728,365,293
3,"ARGEŞ","#N/A",13490,,100,"CÂMPULUNG / ŞCOALA GENERALĂ NR. 7 VIŞOI - III",1,1161,"MUNICIPIUL CÂMPULUNG",13490,1378,730,706,23,1,717,13,1500,770,379,338
3,"ARGEŞ","#N/A",13490,,101,"CÂMPULUNG / CĂMINUL DE COPII NR. 2 - I",1,1161,"MUNICIPIUL CÂMPULUNG",13490,1500,803,784,19,0,790,13,1600,797,433,357
3,"ARGEŞ","#N/A",13490,,102,"CÂMPULUNG / CĂMINUL DE COPII NR. 2 - II",1,1161,"MUNICIPIUL CÂMPULUNG",13490,1404,745,725,20,0,730,15,1500,755,386,344
3,"ARGEŞ","#N/A",13490,,103,"CÂMPULUNG / CĂMINUL DE COPII NR.2-III",1,1161,"MUNICIPIUL CÂMPULUNG",13490,1705,856,821,34,1,841,15,1900,1044,461,380
3,"ARGEŞ","#N/A",13490,,104,"CÂMPULUNG / GRADINITA CU PROGRAM NORMAL NR. 13-I",1,1161,"MUNICIPIUL CÂMPULUNG",13490,1724,854,801,53,0,843,11,1900,1046,508,335
3,"ARGEŞ","#N/A",13490,,105,"CÂMPULUNG / GRADINITA CU PROGRAM NORMAL NR. 13-II",1,1161,"MUNICIPIUL CÂMPULUNG",13490,1541,949,903,46,0,934,15,1700,751,487,447
3,"ARGEŞ","#N/A",13490,,106,"VALEA RUMÂNEŞTILOR / GRĂDINIŢA VALEA ROMÂNEŞTILOR",1,1161,"MUNICIPIUL CÂMPULUNG",13490,404,243,227,16,0,241,2,500,257,151,90
3,"ARGEŞ","#N/A",13490,,107,"CÂMPULUNG / LICEUL DAN BARBILIAN",1,1161,"MUNICIPIUL CÂMPULUNG",13490,1109,692,640,52,0,674,18,1200,508,369,305
3,"ARGEŞ","#N/A",13490,,108,"CÂMPULUNG / ŞCOALA NORMALĂ CAROL I",1,1161,"MUNICIPIUL CÂMPULUNG",13490,782,512,473,39,0,506,6,900,388,281,225
3,"ARGEŞ","#N/A",13490,,109,"CÂMPULUNG / SERVICIUL ÎNTREŢINERE DRUMURI SI STRĂZI",1,1161,"MUNICIPIUL CÂMPULUNG",13490,990,579,562,17,0,576,3,1100,521,327,249
3,"ARGEŞ","#N/A",13490,,110,"CÂMPULUNG / LICEUL MINIER NR.2",1,1161,"MUNICIPIUL CÂMPULUNG",13490,1313,659,626,33,0,653,6,1400,741,433,220
3,"ARGEŞ","#N/A",13490,,111,"CÂMPULUNG / ŞCOALA GENERALĂ NR.4 "" APA SĂRATĂ""",1,1161,"MUNICIPIUL CÂMPULUNG",13490,799,382,360,22,0,378,4,900,518,197,181
3,"ARGEŞ","#N/A",13490,,112,"CÂMPULUNG / ŞCOALA GENERALĂ MĂRCUŞI",1,1161,"MUNICIPIUL CÂMPULUNG",13490,547,301,283,18,0,296,5,600,299,145,151
3,"ARGEŞ","#N/A",13490,,113,"CÂMPULUNG / LICEUL DINICU GOLESCU",1,1161,"MUNICIPIUL CÂMPULUNG",13490,1395,964,840,123,1,951,13,1500,536,493,458
3,"ARGEŞ","#N/A",13490,,114,"CÂMPULUNG / ŞCOALA GENERALĂ NR. 2",1,1161,"MUNICIPIUL CÂMPULUNG",13490,980,755,577,82,96,744,11,1100,345,434,310
3,"ARGEŞ","#N/A",13622,,115,"CURTEA DE ARGEŞ / SCOALA GENERALA NR.2-I",1,1164,"MUNICIPIUL CURTEA DE ARGEŞ",13622,1537,943,871,72,0,927,16,1700,757,479,448
3,"ARGEŞ","#N/A",13622,,116,"CURTEA DE ARGEŞ / SCOALA GENERALA NR.2 - II -",1,1164,"MUNICIPIUL CURTEA DE ARGEŞ",13622,1272,727,690,37,0,717,10,1400,673,333,384
3,"ARGEŞ","#N/A",13622,,117,"CURTEA DE ARGEŞ / SCOALA GENERALA NR.2 -III-",1,1164,"MUNICIPIUL CURTEA DE ARGEŞ",13622,1669,1075,992,35,48,1058,17,1800,725,545,513
3,"ARGEŞ","#N/A",13622,,118,"CURTEA DE ARGEŞ / GRUP SCOLAR FERDINAND I",1,1164,"MUNICIPIUL CURTEA DE ARGEŞ",13622,1698,954,897,57,0,943,11,1900,946,492,451
3,"ARGEŞ","#N/A",13622,,119,"CURTEA DE ARGEŞ / GRUP SCOLAR CONSTANTIN DOBRESCU ARGES - I -",1,1164,"MUNICIPIUL CURTEA DE ARGEŞ",13622,1504,779,734,45,0,769,10,1700,921,438,331
3,"ARGEŞ","#N/A",13622,,120,"CURTEA DE ARGEŞ / GRUP SCOLAR CONSTANTIN DOBRESCU ARGES - II -",1,1164,"MUNICIPIUL CURTEA DE ARGEŞ",13622,1839,1003,948,55,0,981,22,2000,997,510,471
3,"ARGEŞ","#N/A",13622,,121,"CURTEA DE ARGEŞ / SCOALA GENERALA NR.6",1,1164,"MUNICIPIUL CURTEA DE ARGEŞ",13622,1468,883,828,55,0,865,18,1600,717,461,404
3,"ARGEŞ","#N/A",13622,,122,"CURTEA DE ARGEŞ / GRUP SCOLAR FORESTIER -I",1,1164,"MUNICIPIUL CURTEA DE ARGEŞ",13622,1537,883,861,21,1,878,5,1700,817,452,426
3,"ARGEŞ","#N/A",13622,,123,"CURTEA DE ARGEŞ / GRUP SCOLAR FORESTIER-II",1,1164,"MUNICIPIUL CURTEA DE ARGEŞ",13622,1626,930,855,75,0,920,10,1800,870,551,369
3,"ARGEŞ","#N/A",13622,,124,"CURTEA DE ARGEŞ / CASA DE CULTURA-I",1,1164,"MUNICIPIUL CURTEA DE ARGEŞ",13622,1587,1028,920,108,0,1017,11,1800,772,552,465
3,"ARGEŞ","#N/A",13622,,125,"CURTEA DE ARGEŞ / SCOALA GENERALA NR.4",1,1164,"MUNICIPIUL CURTEA DE ARGEŞ",13622,1444,911,833,78,0,898,13,1600,689,480,418
3,"ARGEŞ","#N/A",13622,,126,"CURTEA DE ARGEŞ / SCOALA GENERALA NR.1",1,1164,"MUNICIPIUL CURTEA DE ARGEŞ",13622,1225,716,680,36,0,710,6,1298,582,322,388
3,"ARGEŞ","#N/A",13622,,127,"CURTEA DE ARGEŞ / SCOALA GENERALA NR.1",1,1164,"MUNICIPIUL CURTEA DE ARGEŞ",13622,1581,869,806,63,0,855,14,1700,831,417,438
3,"ARGEŞ","#N/A",13622,,128,"CURTEA DE ARGEŞ / SCOALA GENERALA NR.5 - I -",1,1164,"MUNICIPIUL CURTEA DE ARGEŞ",13622,1450,826,757,67,2,818,8,1600,774,423,395
3,"ARGEŞ","#N/A",13622,,129,"CURTEA DE ARGEŞ / SCOALA GENERALA NR 5 -II-",1,1164,"MUNICIPIUL CURTEA DE ARGEŞ",13622,1134,627,576,51,0,619,8,1200,573,308,311
3,"ARGEŞ","#N/A",13622,,130,"CURTEA DE ARGEŞ / SCOALA GENERALA VALEA SASULUI",1,1164,"MUNICIPIUL CURTEA DE ARGEŞ",13622,903,599,577,22,0,592,7,1000,401,350,242
3,"ARGEŞ","#N/A",13622,,131,"CURTEA DE ARGEŞ / GRUP SCOLAR AUTO",1,1164,"MUNICIPIUL CURTEA DE ARGEŞ",13622,1832,1059,1017,42,0,1044,15,2000,941,572,472
3,"ARGEŞ","#N/A",13622,,132,"CURTEA DE ARGEŞ / CASA DE CULTURA-II",1,1164,"MUNICIPIUL CURTEA DE ARGEŞ",13622,1561,938,899,39,0,927,11,1700,762,459,468
3,"ARGEŞ","#N/A",13622,,133,"CURTEA DE ARGEŞ / SCOALA GENERALA NR.3",1,1164,"MUNICIPIUL CURTEA DE ARGEŞ",13622,1405,780,736,44,0,763,17,1600,820,400,363
3,"ARGEŞ","#N/A",13622,,134,"NOAPTEŞ / SCOALA GENERALA NOAPTES",1,1164,"MUNICIPIUL CURTEA DE ARGEŞ",13622,714,453,439,14,0,448,5,800,347,261,187
3,"ARGEŞ","#N/A",13668,,135,"COSTEŞTI / PRIMĂRIA ORAŞULUI COSTEŞTI",1,1167,"ORAŞ COSTEŞTI",13668,1910,1141,1077,64,0,1129,12,2100,959,616,513
3,"ARGEŞ","#N/A",13668,,136,"COSTEŞTI / CASA DE CULTURĂ COSTEŞTI",1,1167,"ORAŞ COSTEŞTI",13668,1850,1122,1048,74,0,1107,15,2000,878,580,527
3,"ARGEŞ","#N/A",13668,,137,"COSTEŞTI / LICEUL TEORETIC COSTEŞTI",1,1167,"ORAŞ COSTEŞTI",13668,1584,925,833,44,48,916,9,1700,775,494,422
3,"ARGEŞ","#N/A",13668,,138,"COSTEŞTI / ŞCOALA TELEŞTI",1,1167,"ORAŞ COSTEŞTI",13668,812,472,444,28,0,463,9,900,428,305,158
3,"ARGEŞ","#N/A",13668,,139,"COSTEŞTI / ŞCOALA GENERALĂ ZORILE",1,1167,"ORAŞ COSTEŞTI",13668,896,521,489,32,0,512,9,1000,479,298,214
3,"ARGEŞ","#N/A",13668,,140,"BROŞTENI / ŞCOALA GENERALĂ BROŞTENI",1,1167,"ORAŞ COSTEŞTI",13668,725,454,404,50,0,451,3,800,346,311,140
3,"ARGEŞ","#N/A",13668,,141,"PODU BROŞTENI / ŞCOALA GENERALĂ PODU BROŞTENI",1,1167,"ORAŞ COSTEŞTI",13668,523,341,285,54,2,339,2,600,259,187,152
3,"ARGEŞ","#N/A",13668,,142,"PÎRVU ROŞU / ŞCOALA GENERALĂ PÂRVU ROŞU",1,1167,"ORAŞ COSTEŞTI",13668,541,314,283,31,0,313,1,600,286,222,91
3,"ARGEŞ","#N/A",13668,,143,"STÎRCI / ŞCOALA GENERALĂ STÂRCI",1,1167,"ORAŞ COSTEŞTI",13668,204,119,106,13,0,116,3,300,181,54,62
3,"ARGEŞ","#N/A",13301,,144,"MIOVENI / Grădiniţa din A-uri  ""Florile Soarelui""-Intrare 1",1,1175,"ORAŞ MIOVENI",13301,1535,931,886,44,1,910,19,1600,669,463,447
3,"ARGEŞ","#N/A",13301,,145,"MIOVENI / Liceul Teoretic ""Iulia Zamfirescu"" - Intrare C",1,1175,"ORAŞ MIOVENI",13301,1519,973,910,63,0,961,12,1600,627,558,403
3,"ARGEŞ","#N/A",13301,,146,"MIOVENI / SEDIUL FOSTEI GRADINITE DIN BLOCUL M6",1,1175,"ORAŞ MIOVENI",13301,1795,1123,1062,61,0,1106,17,1900,777,640,466
3,"ARGEŞ","#N/A",13301,,147,"MIOVENI / gradinita ""Florile Soarelui""- intrare 2",1,1175,"ORAŞ MIOVENI",13301,1502,1035,999,36,0,1015,20,1600,565,597,418
3,"ARGEŞ","#N/A",13301,,148,"MIOVENI / DISPENSAR UMAN",1,1175,"ORAŞ MIOVENI",13301,1567,1022,969,53,0,1001,21,1700,678,596,405
3,"ARGEŞ","#N/A",13301,,149,"MIOVENI / Şcoala Generală ""Liviu Rebreanu"" (Cămin Şcoală) - Corp B",1,1175,"ORAŞ MIOVENI",13301,1855,1210,1126,84,0,1193,17,1999,789,720,473
3,"ARGEŞ","#N/A",13301,,150,"MIOVENI / Liceul Teoretic ""Iulia Zamfirescu"" - Intrare B",1,1175,"ORAŞ MIOVENI",13301,1575,991,939,52,0,971,20,1700,709,575,396
3,"ARGEŞ","#N/A",13301,,151,"MIOVENI / SCOALA GENERALĂ ""LIVIU REBREANU"" - INTRARE ELEVI",1,1175,"ORAŞ MIOVENI",13301,1034,663,620,43,0,642,21,1100,437,328,314
3,"ARGEŞ","#N/A",13301,,152,"MIOVENI / SCOALA GENERALĂ ""LIVIU REBREANU"" - INTRARE PROFESORI",1,1175,"ORAŞ MIOVENI",13301,1231,801,765,36,0,778,23,1300,499,429,349
3,"ARGEŞ","#N/A",13301,,153,"MIOVENI / Grădiniţa  ""Tic-Pitic""(Cresa Camin)",1,1175,"ORAŞ MIOVENI",13301,1163,788,735,53,0,774,14,1200,412,420,354
3,"ARGEŞ","#N/A",13301,,154,"MIOVENI / GRĂDINIŢA DIN BLOCUL F9",1,1175,"ORAŞ MIOVENI",13301,1248,804,761,43,0,787,17,1400,596,458,329
3,"ARGEŞ","#N/A",13301,,155,"MIOVENI / SC ""CONSTRUCŢII-REPARAŢII MIOVENI"" SRL",1,1175,"ORAŞ MIOVENI",13301,1460,971,912,59,0,949,22,1600,629,511,438
3,"ARGEŞ","#N/A",13301,,156,"MIOVENI / Casa de Cultură a Sindicatelor Automobile Dacia",1,1175,"ORAŞ MIOVENI",13301,1336,947,892,55,0,926,21,1400,453,516,410
3,"ARGEŞ","#N/A",13301,,157,"MIOVENI / GRADINIŢA DIN BLOCUL T6",1,1175,"ORAŞ MIOVENI",13301,1651,1065,1031,34,0,1035,30,1800,735,522,513
3,"ARGEŞ","#N/A",13301,,158,"MIOVENI / FOSTUL SEDIU AL  GRADINIŢEI ""CAMPIONII"" DIN BLOCUL T2A",1,1175,"ORAŞ MIOVENI",13301,1428,934,889,44,1,925,9,1600,666,548,377
3,"ARGEŞ","#N/A",13301,,159,"MIOVENI / GRADINITA CAMPIONII",1,1175,"ORAŞ MIOVENI",13301,1798,1136,1084,52,0,1122,14,1900,764,602,520
3,"ARGEŞ","#N/A",13301,,160,"MIOVENI / ŞCOALA GENERALĂ ""GEORGE TOPÂRCEANU""",1,1175,"ORAŞ MIOVENI",13301,965,1210,610,75,525,1187,23,1500,290,832,355
3,"ARGEŞ","#N/A",13301,,161,"RACOVIŢA / ŞCOALA GENERALĂ ""MARIN SORESCU"" RACOVIŢA",1,1175,"ORAŞ MIOVENI",13301,832,647,582,62,3,641,6,902,255,457,184
3,"ARGEŞ","#N/A",13301,,162,"RACOVIŢA / SEDIUL FOSTEI ŞCOLI RACOVIŢA DE SUS",1,1175,"ORAŞ MIOVENI",13301,677,479,450,28,1,472,7,800,321,349,123
3,"ARGEŞ","#N/A",13301,,163,"COLIBAŞI / ŞCOALA GENERALĂ COLIBAŞI",1,1175,"ORAŞ MIOVENI",13301,1132,811,752,58,1,796,15,1197,386,513,283
3,"ARGEŞ","#N/A",13301,,164,"COLIBAŞI / CĂMINUL CULTURAL COLIBAŞI",1,1175,"ORAŞ MIOVENI",13301,689,515,490,24,1,511,4,800,285,334,177
3,"ARGEŞ","#N/A",13301,,165,"CLUCEREASA / FOSTUL SEDIU AL SCOLII CLUCEREASA",1,1175,"ORAŞ MIOVENI",13301,295,217,201,16,0,217,0,400,183,162,55
3,"ARGEŞ","#N/A",13301,,166,"FĂGETU / ŞCOALA PRIMARĂ FĂGETU",1,1175,"ORAŞ MIOVENI",13301,703,532,519,13,0,524,8,800,268,457,67
3,"ARGEŞ","#N/A",13301,,167,"FĂGETU / CAMINUL CULTURAL FAGETU",1,1175,"ORAŞ MIOVENI",13301,211,181,162,19,0,180,1,300,119,140,40
3,"ARGEŞ","#N/A",13392,,168,"ENCULEŞTI / Şcoala Primară Enculeşti",1,1181,"ORAŞ ŞTEFĂNEŞTI",13392,473,304,269,35,0,298,6,600,296,193,105
3,"ARGEŞ","#N/A",13392,,169,"VALEA MARE-PODGORIA / Căminul Cultural Valea Mare",1,1181,"ORAŞ ŞTEFĂNEŞTI",13392,1304,736,678,58,0,725,11,1400,664,402,323
3,"ARGEŞ","#N/A",13392,,170,"VALEA MARE-PODGORIA / Şcoala Generală ""Constantin Brâncoveanu"" Valea Mare",1,1181,"ORAŞ ŞTEFĂNEŞTI",13392,1554,937,814,123,0,928,9,1700,763,479,449
3,"ARGEŞ","#N/A",13392,,171,"VALEA MARE-PODGORIA / S.C. ANA-IMEP S.A.",1,1181,"ORAŞ ŞTEFĂNEŞTI",13392,1474,1127,869,258,0,1113,14,1600,473,512,601
3,"ARGEŞ","#N/A",13392,,172,"ŞTEFĂNEŞTII NOI / Liceul Tehnologic ""Dinu Brătianu""",1,1181,"ORAŞ ŞTEFĂNEŞTI",13392,1503,1030,916,114,0,1018,12,1700,670,517,501
3,"ARGEŞ","#N/A",13392,,173,"ŞTEFĂNEŞTII NOI / Liceul Tehnologic ""Dinu Brătianu""",1,1181,"ORAŞ ŞTEFĂNEŞTI",13392,1380,852,742,91,19,846,6,1500,648,475,371
3,"ARGEŞ","#N/A",13392,,174,"IZVORANI / Şcoala Generală nr.1 Ştefăneşti, Corp C (Grădiniţă)",1,1181,"ORAŞ ŞTEFĂNEŞTI",13392,919,614,539,75,0,609,5,1000,386,288,321
3,"ARGEŞ","#N/A",13392,,175,"ŞTEFĂNEŞTI / Casa de Cultură Ştefăneşti",1,1181,"ORAŞ ŞTEFĂNEŞTI",13392,1116,716,621,95,0,704,12,1200,484,380,324
3,"ARGEŞ","#N/A",13392,,176,"ŞTEFĂNEŞTI / Şcoala Primară Ştefăneşti",1,1181,"ORAŞ ŞTEFĂNEŞTI",13392,1376,973,885,88,0,960,13,1500,527,565,395
3,"ARGEŞ","#N/A",13392,,177,"GOLEŞTI / Şcoala Primară Goleşti",1,1181,"ORAŞ ŞTEFĂNEŞTI",13392,991,635,572,63,0,622,13,1100,465,363,259
3,"ARGEŞ","#N/A",13757,,178,"TOPOLOVENI / Şcoala Primară Goleştii-Badii",1,1190,"ORAŞ TOPOLOVENI",13757,863,598,559,39,0,587,11,900,302,331,256
3,"ARGEŞ","#N/A",13757,,179,"TOPOLOVENI / Liceul Teoretic ,,Ion Mihalache'' Topoloveni",1,1190,"ORAŞ TOPOLOVENI",13757,1076,741,656,84,1,730,11,1200,459,386,344
3,"ARGEŞ","#N/A",13757,,180,"TOPOLOVENI /  Liceul Teoretic ,,Ion Mihalache'' Topoloveni",1,1190,"ORAŞ TOPOLOVENI",13757,886,634,588,46,0,622,12,1000,366,342,280
3,"ARGEŞ","#N/A",13757,,181,"TOPOLOVENI / Centrul de zi Topoloveni",1,1190,"ORAŞ TOPOLOVENI",13757,668,448,428,20,0,437,11,700,252,247,190
3,"ARGEŞ","#N/A",13757,,182,"TOPOLOVENI / Şcoala Gimnazială ""Nicolae Cristescu"" Topoloveni",1,1190,"ORAŞ TOPOLOVENI",13757,872,614,559,55,0,599,15,1000,386,330,269
3,"ARGEŞ","#N/A",13757,,183,"TOPOLOVENI / Şcoala Gimnazială ""Nicolae Cristescu"" Topoloveni",1,1190,"ORAŞ TOPOLOVENI",13757,996,615,582,33,0,599,16,1100,485,296,303
3,"ARGEŞ","#N/A",13757,,184,"TOPOLOVENI / Şcoala gimnazială "" Nicolae Cristescu"" sala de sport",1,1190,"ORAŞ TOPOLOVENI",13757,1067,736,692,43,1,728,8,1100,364,342,386
3,"ARGEŞ","#N/A",13757,,185,"TOPOLOVENI / Şcoala primară Inuri",1,1190,"ORAŞ TOPOLOVENI",13757,240,179,168,11,0,177,2,300,121,122,55
3,"ARGEŞ","#N/A",13757,,186,"ŢIGĂNEŞTI / Şcoala  Primară Ţigăneşti- Linie",1,1190,"ORAŞ TOPOLOVENI",13757,633,440,416,24,0,430,10,700,260,268,162
3,"ARGEŞ","#N/A",13757,,187,"ŢIGĂNEŞTI / Şcoala Generală Ţigăneşti - centru",1,1190,"ORAŞ TOPOLOVENI",13757,700,492,455,37,0,481,11,800,308,306,175
3,"ARGEŞ","#N/A",13819,,188,"ALBEŞTII PAMÎNTENI / Casa de Cultură Albeştii de Argeş",3,1196,"ALBEŞTII DE ARGEŞ",13819,1538,949,891,58,0,933,16,1700,751,538,395
3,"ARGEŞ","#N/A",13819,,189,"ALBEŞTII UNGURENI / Şcoala Gen. Albeşti -Ungureni",3,1196,"ALBEŞTII DE ARGEŞ",13819,1255,751,730,21,0,730,21,1400,649,393,337
3,"ARGEŞ","#N/A",13819,,190,"ALBEŞTII UNGURENI / Şcoala Gen. Albeşti-Ungureni",3,1196,"ALBEŞTII DE ARGEŞ",13819,750,453,436,17,0,446,7,800,347,222,224
3,"ARGEŞ","#N/A",13819,,191,"BRĂTEŞTI / Şcoala Gen. Brăteşti",3,1196,"ALBEŞTII DE ARGEŞ",13819,623,414,384,30,0,413,1,700,286,274,139
3,"ARGEŞ","#N/A",13819,,192,"DOBROTU / Căminul Cultural Dobrotu",3,1196,"ALBEŞTII DE ARGEŞ",13819,848,553,507,46,0,551,2,900,347,252,299
3,"ARGEŞ","#N/A",13891,,193,"ALBEŞTI / Şcoala Gen.I-VIII Albeşti",3,1204,"ALBEŞTII DE MUSCEL",13891,958,691,607,64,20,686,5,1001,310,332,354
3,"ARGEŞ","#N/A",13891,,194,"CÎNDEŞTI / Şcoala Gen. I-IV Cândeşti",3,1204,"ALBEŞTII DE MUSCEL",13891,365,305,262,43,0,302,3,500,195,158,144
3,"ARGEŞ","#N/A",13935,,195,"ALBOTA / Şcoala Gimnazială Sandală Movilă Albota",3,1207,"ALBOTA",13935,1781,1199,1062,137,0,1183,16,1900,701,699,484
3,"ARGEŞ","#N/A",13935,,196,"MAREŞ / Şcoala Gimnazială Mareş",3,1207,"ALBOTA",13935,866,628,565,63,0,622,6,1000,372,455,167
3,"ARGEŞ","#N/A",13935,,197,"CERBU / Şcoala Primară Cerbu",3,1207,"ALBOTA",13935,598,467,411,56,0,457,10,700,233,332,125
3,"ARGEŞ","#N/A",13999,,198,"ANINOASA / Şcoala cu clasele I-IV Aninoasa",3,1213,"ANINOASA",13999,1261,901,836,63,2,889,12,1400,499,647,242
3,"ARGEŞ","#N/A",13999,,199,"VALEA SILIŞTII / Cămin Cultural  Valea Siliştii",3,1213,"ANINOASA",13999,538,410,348,61,1,407,3,600,190,280,127
3,"ARGEŞ","#N/A",13999,,200,"SLĂNIC / Şcoala Gen. Slănic",3,1213,"ANINOASA",13999,901,648,600,48,0,636,12,1000,352,450,186
3,"ARGEŞ","#N/A",14049,,201,"AREFU / Căminul Cultural Arefu",3,1218,"AREFU",14049,1105,689,627,62,0,687,2,1200,511,350,337
3,"ARGEŞ","#N/A",14049,,202,"CĂPĂŢÎNENII PĂMÂNTENI / Şcoala Gen. Geeorge Stephănescu",3,1218,"AREFU",14049,1005,716,609,105,2,708,8,1200,484,309,399
3,"ARGEŞ","#N/A",13187,,203,"BASCOV / Gradinita nr. 1 Bascov",3,1249,"BASCOV",13187,1537,1050,927,122,1,1030,20,1650,600,523,507
3,"ARGEŞ","#N/A",13187,,204,"BASCOV / Şcoala Gen. Bascov, clădirea veche",3,1249,"BASCOV",13187,1722,1192,1115,77,0,1174,18,1800,608,689,485
3,"ARGEŞ","#N/A",13187,,205,"BASCOV / Şcoala Gen. Bascov, clădirea nouă",3,1249,"BASCOV",13187,1170,858,760,98,0,847,11,1300,442,495,352
3,"ARGEŞ","#N/A",13187,,206,"SCHIAU / Şcoala Gen.Schiau",3,1249,"BASCOV",13187,1354,897,813,79,5,878,19,1500,603,508,370
3,"ARGEŞ","#N/A",13187,,207,"GLÎMBOCU / Şcoala Gen Glîmbocu",3,1249,"BASCOV",13187,697,507,458,49,0,496,11,800,293,293,203
3,"ARGEŞ","#N/A",13187,,208,"VALEA URSULUI / Şcoala Gen. Valea Ursului",3,1249,"BASCOV",13187,1599,1115,984,131,0,1099,16,1800,685,630,469
3,"ARGEŞ","#N/A",13187,,209,"MICA / Şcoala Gen. Mica",3,1249,"BASCOV",13187,492,399,360,39,0,392,7,550,151,270,122
3,"ARGEŞ","#N/A",14085,,210,"BĂBANA / SCOALA BABANA",3,1222,"BĂBANA",14085,765,509,454,54,1,503,6,800,291,292,211
3,"ARGEŞ","#N/A",14085,,211,"SLĂATIOARELE / Şcoala Slătioarele",3,1222,"BĂBANA",14085,660,471,408,63,0,468,3,699,228,328,140
3,"ARGEŞ","#N/A",14085,,212,"BĂBANA / Biblioteca Comunală",3,1222,"BĂBANA",14085,580,546,405,141,0,540,6,600,54,410,130
3,"ARGEŞ","#N/A",14085,,213,"GROŞI / Şcoala Groşi",3,1222,"BĂBANA",14085,385,300,236,64,0,296,4,500,200,208,88
3,"ARGEŞ","#N/A",14165,,214,"BĂICULEŞTI / Primăria Băiculeşti",3,1230,"BĂICULEŞTI",14165,1408,847,781,66,0,843,4,1500,653,539,304
3,"ARGEŞ","#N/A",14165,,215,"MĂNICEŞTI / Şcoala Măniceşti",3,1230,"BĂICULEŞTI",14165,605,408,375,33,0,403,5,700,292,289,114
3,"ARGEŞ","#N/A",14165,,216,"ZIGONENI / Şcoala Zigoneni",3,1230,"BĂICULEŞTI",14165,813,543,500,43,0,538,5,900,357,296,242
3,"ARGEŞ","#N/A",14165,,217,"VALEA LUI ENACHE / Şcoala Valea lui Enache",3,1230,"BĂICULEŞTI",14165,696,511,467,44,0,504,7,700,189,328,176
3,"ARGEŞ","#N/A",14165,,218,"TUTANA / Şcoala Tutana",3,1230,"BĂICULEŞTI",14165,1586,912,846,66,0,904,8,1800,888,539,365
3,"ARGEŞ","#N/A",14272,,219,"BĂLILEŞTI / Cămin cultural Bălileşti",3,1241,"BĂLILEŞTI",14272,944,617,560,57,0,600,17,1000,383,413,187
3,"ARGEŞ","#N/A",14272,,220,"BĂJEŞTI / Cămin Cultural Băjeşti",3,1241,"BĂLILEŞTI",14272,885,660,584,76,0,654,6,1000,340,434,220
3,"ARGEŞ","#N/A",14272,,221,"POIENIŢA / Cămin Cultural Poieniţa",3,1241,"BĂLILEŞTI",14272,1021,693,654,39,0,689,4,1100,407,499,190
3,"ARGEŞ","#N/A",14272,,222,"GOLEŞTI / Şcoala Goleşti",3,1241,"BĂLILEŞTI",14272,565,372,321,51,0,371,1,700,328,231,140
3,"ARGEŞ","#N/A",14352,,223,"BELEŢI / Cămin Cultural Beleţi",3,1258,"BELEŢI-NEGREŞTI",14352,557,373,338,35,0,369,4,600,227,207,162
3,"ARGEŞ","#N/A",14352,,224,"NEGREŞTI / Cămin Cultural Negreşti",3,1258,"BELEŢI-NEGREŞTI",14352,1015,698,643,55,0,690,8,1100,402,395,295
3,"ARGEŞ","#N/A",14405,,225,"BEREVOEŞTI / Cămin Cultural Berevoeşti-Pămînteni",3,1263,"BEREVOEŞTI",14405,1742,1121,1046,75,0,1102,19,1900,779,790,312
3,"ARGEŞ","#N/A",14405,,226,"GĂMĂCEŞTI / Şcoala Gămăceşti",3,1263,"BEREVOEŞTI",14405,809,504,475,29,0,479,25,900,396,319,160
3,"ARGEŞ","#N/A",14405,,227,"BRATIA / Şcoala Bratia",3,1263,"BEREVOEŞTI",14405,162,125,109,16,0,124,1,200,75,106,18
3,"ARGEŞ","#N/A",14450,,228,"URLUENI / Şcoala Urluieni",3,1268,"BÎRLA",14450,1096,548,446,102,0,543,5,1200,652,362,181
3,"ARGEŞ","#N/A",14450,,229,"MÎNDRA / Şcoala Mîndra",3,1268,"BÎRLA",14450,701,331,262,69,0,329,2,800,469,198,131
3,"ARGEŞ","#N/A",14450,,230,"BÎRLA / Şcoala Bîrla",3,1268,"BÎRLA",14450,850,475,375,100,0,475,0,900,425,339,136
3,"ARGEŞ","#N/A",14450,,231,"MOZĂCENII-VALE / Şcoala Mozăceni-Vale",3,1268,"BÎRLA",14450,1022,489,403,86,0,483,6,1100,611,262,221
3,"ARGEŞ","#N/A",14450,,232,"BĂDEŞTI / Şcoala Bădeşti",3,1268,"BÎRLA",14450,269,184,154,30,0,183,1,300,116,87,96
3,"ARGEŞ","#N/A",14584,,233,"BOGAŢI /  Şcoala Bogaţi",3,1281,"BOGAŢI",14584,1431,961,836,100,25,950,11,1600,639,584,366
3,"ARGEŞ","#N/A",14584,,234,"GLÎMBOCELU /  Şcoala GLÎMBOCELU",3,1281,"BOGAŢI",14584,586,404,338,66,0,399,5,600,196,264,135
3,"ARGEŞ","#N/A",14584,,235,"CHIŢEŞTI / Şcoala  Chiţeşti",3,1281,"BOGAŢI",14584,248,189,143,42,4,188,1,300,111,116,72
3,"ARGEŞ","#N/A",14584,,236,"BUJOI / Grădiniţa Bujoi",3,1281,"BOGAŢI",14584,511,353,325,26,2,349,4,600,247,193,156
3,"ARGEŞ","#N/A",14584,,237,"SUSENI / Şcoala Suseni",3,1281,"BOGAŢI",14584,858,557,510,26,21,551,6,900,343,355,196
3,"ARGEŞ","#N/A",14584,,238,"GLÎMBOCEL / Şcoala Glîmbocel",3,1281,"BOGAŢI",14584,161,124,102,22,0,122,2,200,76,52,70
3,"ARGEŞ","#N/A",14673,,239,"BOTENI / Cămin Cultural Boteni",3,1290,"BOTENI",14673,1608,1053,945,83,25,1036,17,1800,747,682,354
3,"ARGEŞ","#N/A",14673,,240,"LUNCA / Şcoala Primară Lunca",3,1290,"BOTENI",14673,512,361,332,26,3,360,1,600,239,257,103
3,"ARGEŞ","#N/A",14726,,241,"BOŢEŞTI / Şcoala Gimnazială Boţeşti",3,1295,"BOŢEŞTI",14726,697,556,478,78,0,549,7,800,244,288,261
3,"ARGEŞ","#N/A",14726,,242,"BOŢEŞTI / Şcoala Primară Moşteni-Greci",3,1295,"BOŢEŞTI",14726,261,205,158,47,0,203,2,300,95,106,97
3,"ARGEŞ","#N/A",13276,,243,"BRADU / Căminul Cultural Bradu",3,1298,"BRADU",13276,916,603,518,85,0,596,7,999,396,344,252
3,"ARGEŞ","#N/A",13276,,244,"BRADU / Şcoala nr. 1 Bradu",3,1298,"BRADU",13276,787,515,469,46,0,507,8,900,385,363,144
3,"ARGEŞ","#N/A",13276,,245,"BRADU / Gradinita de la Scoala Gen. Nr. 2",3,1298,"BRADU",13276,1846,1143,1068,73,2,1129,14,2000,857,731,398
3,"ARGEŞ","#N/A",13276,,246,"GEAMĂNA / Şcoala Primară Geamăna",3,1298,"BRADU",13276,768,490,440,50,0,482,8,800,310,258,224
3,"ARGEŞ","#N/A",13276,,247,"GEAMĂNA / Gradinita Geamana",3,1298,"BRADU",13276,1892,1248,1156,92,0,1226,22,2100,852,681,545
3,"ARGEŞ","#N/A",14753,,248,"BRĂDULEŢ / Cămin Cultural Brăduleţ",3,1301,"BRĂDULEŢ",14753,482,359,301,58,0,355,4,500,141,220,135
3,"ARGEŞ","#N/A",14753,,249,"GALEŞU / Căminul Cultural Galeşu",3,1301,"BRĂDULEŢ",14753,778,523,480,43,0,520,3,800,277,363,157
3,"ARGEŞ","#N/A",14753,,250,"BRĂDETU / Şcoala Primară Brădetu",3,1301,"BRĂDULEŢ",14753,333,299,198,101,0,292,7,400,101,191,101
3,"ARGEŞ","#N/A",14851,,251,"BUDEASA MARE / Şcoala Gen.Budeasa Mare",3,1311,"BUDEASA",14851,1065,689,618,71,0,684,5,1100,411,395,289
3,"ARGEŞ","#N/A",14851,,252,"BUDEASA MICĂ / Şcoala Gen. Budeasa Mică",3,1311,"BUDEASA",14851,693,476,418,58,0,473,3,800,324,294,179
3,"ARGEŞ","#N/A",14851,,253,"GĂLĂŞEŞTI / Şcoala Gen. Găleşeşti",3,1311,"BUDEASA",14851,781,535,496,39,0,533,2,900,365,361,172
3,"ARGEŞ","#N/A",14851,,254,"CALOTEŞTI / Şcoala Gen.Caloteşti",3,1311,"BUDEASA",14851,842,512,446,66,0,509,3,900,388,354,155
3,"ARGEŞ","#N/A",14922,,255,"BUGHEA DE JOS / SCOALA GIMNAZIALA BUGHEA DE JOS",3,1318,"BUGHEA DE JOS",14922,1378,862,821,41,0,856,6,1500,638,473,383
3,"ARGEŞ","#N/A",14922,,256,"BUGHEA DE JOS / SCOALA PRIMARA MLACI",3,1318,"BUGHEA DE JOS",14922,515,362,332,30,0,356,6,600,238,187,169
3,"ARGEŞ","#N/A",14922,,257,"BUGHEA DE JOS / SCOALA PRIMARA HULUBESTI",3,1318,"BUGHEA DE JOS",14922,471,297,270,27,0,292,5,500,203,178,114
3,"ARGEŞ","#N/A",20063,,258,"BUGHEA DE SUS / Şcoala Gimnazială nr. 1 Bughea de Sus",3,1320,"BUGHEA DE SUS",20063,1688,1041,970,66,5,1028,13,1900,859,541,487
3,"ARGEŞ","#N/A",20063,,259,"BUGHEA DE SUS / Grădiniţa Grui",3,1320,"BUGHEA DE SUS",20063,704,505,470,31,4,498,7,800,295,244,254
3,"ARGEŞ","#N/A",14940,,260,"ŞERBOENI / Căminul cultural Şerboieni",3,1322,"BUZOEŞTI",14940,1257,742,688,54,0,731,11,1300,558,511,220
3,"ARGEŞ","#N/A",14940,,261,"IONEŞTI / Grădiniţa Ioneşti",3,1322,"BUZOEŞTI",14940,628,361,317,44,0,355,6,700,339,231,124
3,"ARGEŞ","#N/A",14940,,262,"TOMŞANCA / Şcoala Tomşanca",3,1322,"BUZOEŞTI",14940,320,168,141,27,0,168,0,400,232,119,49
3,"ARGEŞ","#N/A",14940,,263,"VULPEŞTI / Şcoala Vulpeşti",3,1322,"BUZOEŞTI",14940,840,399,359,40,0,396,3,900,501,227,169
3,"ARGEŞ","#N/A",14940,,264,"CORNĂŢEL / Şcoala Cornăţel",3,1322,"BUZOEŞTI",14940,862,450,394,56,0,448,2,1000,550,327,121
3,"ARGEŞ","#N/A",14940,,265,"BUZOEŞTI / Căminul cultural Buzoeşti",3,1322,"BUZOEŞTI",14940,913,537,439,98,0,531,6,1000,463,344,187
3,"ARGEŞ","#N/A",15064,,266,"CĂLDĂRARU / Şcoala Gen. Cu cls. I-VIII Căldăraru",3,1334,"CĂLDĂRARU",15064,753,440,356,84,0,437,3,800,360,283,154
3,"ARGEŞ","#N/A",15064,,267,"STRÎMBENI / ŞcoalaGen cu cls. I-VIII Strîmbeni",3,1334,"CĂLDĂRARU",15064,746,448,370,78,0,443,5,800,352,343,100
3,"ARGEŞ","#N/A",15064,,268,"BURDEA / Şcoala Gen. Cu cls.I-IV Burdea",3,1334,"CĂLDĂRARU",15064,507,317,271,46,0,312,5,600,283,233,79
3,"ARGEŞ","#N/A",15108,,269,"VRĂNEŞTI / SCOALA GENERALA VRANESTI",3,1338,"CĂLINEŞTI",15108,1601,1011,936,75,0,996,15,1800,789,596,400
3,"ARGEŞ","#N/A",15108,,270,"CĂLINEŞTI / SCOALA CALINESTI",3,1338,"CĂLINEŞTI",15108,1659,969,876,93,0,964,5,1800,831,606,358
3,"ARGEŞ","#N/A",15108,,271,"CÎRSTIENI / SCOALA CIRSTIENI",3,1338,"CĂLINEŞTI",15108,1428,766,720,46,0,747,19,1600,834,571,176
3,"ARGEŞ","#N/A",15108,,272,"CIOCĂNEŞTI / SCOALA CIOCANESTI",3,1338,"CĂLINEŞTI",15108,762,514,454,60,0,511,3,800,286,293,218
3,"ARGEŞ","#N/A",15108,,273,"GLODU / SCOALA GLODU",3,1338,"CĂLINEŞTI",15108,633,393,366,27,0,389,4,700,307,235,154
3,"ARGEŞ","#N/A",15108,,274,"GORGANU / SCOALA GORGANU",3,1338,"CĂLINEŞTI",15108,860,513,467,46,0,509,4,900,387,294,215
3,"ARGEŞ","#N/A",15108,,275,"RADU NEGRU / SCOALA RADU NEGRU",3,1338,"CĂLINEŞTI",15108,487,308,282,26,0,305,3,600,292,183,122
3,"ARGEŞ","#N/A",15108,,276,"URLUCEA / SCOALA RINCACIOV",3,1338,"CĂLINEŞTI",15108,548,320,295,25,0,320,0,600,280,202,118
3,"ARGEŞ","#N/A",15108,,277,"VĂLENI-PODGORIA / SCOALA VALENI",3,1338,"CĂLINEŞTI",15108,912,589,547,42,0,586,3,1000,411,379,207
3,"ARGEŞ","#N/A",15233,,278,"CĂTEASCA / Căminul Cultural Căteasca",3,1351,"CĂTEASCA",15233,741,501,408,93,0,496,5,800,299,286,210
3,"ARGEŞ","#N/A",15233,,279,"SILIŞTEA / Căminul Cultural Siliştea",3,1351,"CĂTEASCA",15233,420,283,250,32,1,276,7,500,217,183,93
3,"ARGEŞ","#N/A",15233,,280,"GRUIU / Căminul Cultural GRUIU",3,1351,"CĂTEASCA",15233,536,341,296,45,0,336,5,600,259,200,136
3,"ARGEŞ","#N/A",15233,,281,"CIREŞU / Cămin cultural Cireşu",3,1351,"CĂTEASCA",15233,582,425,356,66,3,420,5,600,175,306,114
3,"ARGEŞ","#N/A",15233,,282,"CATANELE / Căminul Cultural Cătanele",3,1351,"CĂTEASCA",15233,758,511,456,55,0,503,8,800,289,298,205
3,"ARGEŞ","#N/A",15313,,283,"CEPARII PĂMÎNTENI / Căminul Cultural Cepari",3,1359,"CEPARI",15313,729,434,392,40,2,428,6,750,316,241,187
3,"ARGEŞ","#N/A",15313,,284,"CĂRPENIŞ / Şcoala Cărpeniş",3,1359,"CEPARI",15313,612,367,329,35,3,364,3,750,383,191,173
3,"ARGEŞ","#N/A",15313,,285,"URLUIEŞTI / Şcoala Urluieşti",3,1359,"CEPARI",15313,253,165,140,25,0,163,2,300,135,79,84
3,"ARGEŞ","#N/A",15313,,286,"CEPARII UNGURENI / Şcoala Cepari - Ungureni",3,1359,"CEPARI",15313,289,225,192,33,0,222,3,300,75,117,105
3,"ARGEŞ","#N/A",15402,,287,"CETĂŢENI / Cămin Cultural Cetăţeni",3,1368,"CETĂŢENI",15402,1009,647,592,55,0,641,6,1100,453,419,222
3,"ARGEŞ","#N/A",15402,,288,"LĂICĂI / Grădiniţa Lăicăi",3,1368,"CETĂŢENI",15402,695,432,396,36,0,430,2,800,368,245,185
3,"ARGEŞ","#N/A",15402,,289,"VALEA CETĂŢUIA / Şcoala I-IV Valea Cetăţuia",3,1368,"CETĂŢENI",15402,643,376,363,13,0,368,8,700,324,189,179
3,"ARGEŞ","#N/A",15448,,290,"CICĂNEŞTI / Şcoala Gimnazială Cicăneşti",3,1372,"CICĂNEŞTI",15448,1763,1201,1148,53,0,1194,7,1900,699,783,411
3,"ARGEŞ","#N/A",15493,,291,"CIOFRÎNGENI / Cămin Cultural Ciofrîngeni",3,1377,"CIOFRINGENI",15493,1093,696,613,81,2,689,7,1200,504,396,293
3,"ARGEŞ","#N/A",15493,,292,"LACURILE / Cămin Cultural Lacurile",3,1377,"CIOFRINGENI",15493,558,387,342,45,0,382,5,600,213,230,152
3,"ARGEŞ","#N/A",15493,,293,"BURLUŞI / Cămin Cultural Burluşi",3,1377,"CIOFRINGENI",15493,436,296,252,44,0,293,3,500,204,173,120
3,"ARGEŞ","#N/A",15554,,294,"BRATIA / Şcoala cu cls. I-VIII Bratia",3,1383,"CIOMĂGEŞTI",15554,360,332,229,94,9,330,2,400,68,196,134
3,"ARGEŞ","#N/A",15554,,295,"CIOMĂGEŞTI / Şcoala cu cls. I-IV Ciomăgeşti-sat",3,1383,"CIOMĂGEŞTI",15554,362,265,205,56,4,262,3,400,135,129,133
3,"ARGEŞ","#N/A",15554,,296,"DOGARI / Şcoala Dogari",3,1383,"CIOMĂGEŞTI",15554,208,137,111,26,0,136,1,300,163,73,63
3,"ARGEŞ","#N/A",15652,,297,"COCU / Şcoala Gen. Cocu",3,1393,"COCU",15652,541,332,257,75,0,330,2,600,268,239,91
3,"ARGEŞ","#N/A",15652,,298,"CRUCIŞOARA / Şcoala Gen. Crucişoara",3,1393,"COCU",15652,258,204,156,48,0,203,1,300,96,150,53
3,"ARGEŞ","#N/A",15652,,299,"RĂCHIŢELE DE JOS / Şcoala Gen. Richiţele de Jos",3,1393,"COCU",15652,332,232,182,50,0,230,2,400,168,165,65
3,"ARGEŞ","#N/A",15652,,300,"RĂCHIŢELE DE SUS / Şcoala Gen. Richiţele de Sus",3,1393,"COCU",15652,338,211,173,38,0,209,2,400,189,144,65
3,"ARGEŞ","#N/A",15652,,301,"BĂRBĂTEŞTI / Şcoala Gen. Bărbăteşti",3,1393,"COCU",15652,487,289,244,45,0,286,3,500,211,209,77
3,"ARGEŞ","#N/A",15741,,302,"OEŞTII UNGURENI / Şcoala Gimnazială Prof. Dr. Vasile Vasilescu",3,1402,"CORBENI",15741,850,528,483,45,0,519,9,900,372,304,215
3,"ARGEŞ","#N/A",15741,,303,"OEŞTII PAMÎNTENI / Şcoala Gimnazială Prof. Dr. Vasile Vasilescu",3,1402,"CORBENI",15741,1189,714,683,31,0,706,8,1300,586,440,266
3,"ARGEŞ","#N/A",15741,,304,"ROTUNDA / Grădiniţa nr. 1 Corbeni",3,1402,"CORBENI",15741,608,350,323,27,0,341,9,700,350,230,111
3,"ARGEŞ","#N/A",15741,,305,"CORBENI / Şcoala Gimnazială nr. 1 Corbeni",3,1402,"CORBENI",15741,1417,872,790,82,0,857,15,1600,728,442,415
3,"ARGEŞ","#N/A",15741,,306,"BERINDEŞTI / Şcoala Primară Berindeşti",3,1402,"CORBENI",15741,632,378,342,36,0,374,4,700,322,202,172
3,"ARGEŞ","#N/A",15830,,307,"CORBI / Cămin Cultural Corbi",3,1411,"CORBI",15830,1723,1157,1060,94,3,1136,21,1900,743,550,586
3,"ARGEŞ","#N/A",15830,,308,"CORBŞORI / Cămin Cultural Corbşori",3,1411,"CORBI",15830,752,588,463,123,2,580,8,800,212,247,333
3,"ARGEŞ","#N/A",15830,,309,"STĂNEŞTI / Cămin Cultural Stăneşti",3,1411,"CORBI",15830,960,679,610,67,2,673,6,1100,421,385,288
3,"ARGEŞ","#N/A",15901,,310,"PETREŞTI / Şcoala Petreşti",3,1418,"COŞEŞTI",15901,744,523,444,79,0,521,2,800,277,421,100
3,"ARGEŞ","#N/A",15901,,311,"COŞEŞTI / Cămin Cultural Coşeşti",3,1418,"COŞEŞTI",15901,858,548,498,50,0,540,8,900,352,347,193
3,"ARGEŞ","#N/A",15901,,312,"LEICEŞTI / Cămin Cultural Leiceşti",3,1418,"COŞEŞTI",15901,1595,973,902,70,1,967,6,1700,727,660,307
3,"ARGEŞ","#N/A",15901,,313,"JUPÎNEŞTI / Cămin Cultural Jupîneşti",3,1418,"COŞEŞTI",15901,872,496,454,42,0,484,12,1000,504,341,143
3,"ARGEŞ","#N/A",15901,,314,"LĂPUŞANI / Căminul Cultural Lăpuşani",3,1418,"COŞEŞTI",15901,317,217,195,22,0,214,3,400,183,161,53
3,"ARGEŞ","#N/A",15983,,315,"COTMEANA / Centru de Informare Turistică Cotmeana",3,1426,"COTMEANA",15983,838,481,413,68,0,479,2,900,419,332,147
3,"ARGEŞ","#N/A",15983,,316,"LINTEŞTI / Şcoala Linteşti",3,1426,"COTMEANA",15983,353,235,190,45,0,233,2,400,165,163,70
3,"ARGEŞ","#N/A",15983,,317,"BASCOVELE / Şcoala Bascovele",3,1426,"COTMEANA",15983,449,250,192,58,0,249,1,500,250,101,148
3,"ARGEŞ","#N/A",16132,,318,"CUCA / Şcoala Gen. Cuca",3,1441,"CUCA",16132,429,314,254,60,0,310,4,500,186,203,107
3,"ARGEŞ","#N/A",16132,,319,"TEODOREŞTI / Şcoala Gen. Teodoreşti",3,1441,"CUCA",16132,531,340,273,67,0,335,5,600,260,245,90
3,"ARGEŞ","#N/A",16132,,320,"MĂCĂI / Şcoala Primară Măcăi",3,1441,"CUCA",16132,528,400,325,75,0,398,2,600,200,273,125
3,"ARGEŞ","#N/A",16132,,321,"CÎRCEŞTI / Şcoala Primară Cîrceşti",3,1441,"CUCA",16132,266,210,182,28,0,209,1,300,90,157,52
3,"ARGEŞ","#N/A",16285,,322,"DAVIDEŞTI / Şcoala Davideşti",3,1456,"DAVIDEŞTI",16285,490,353,303,50,0,348,5,500,147,230,118
3,"ARGEŞ","#N/A",16285,,323,"VOROVENI / Şcoala Voroveni",3,1456,"DAVIDEŞTI",16285,477,335,315,20,0,330,5,500,165,257,73
3,"ARGEŞ","#N/A",16285,,324,"CONŢEŞTI / Şcoala Conţeşti nr.1",3,1456,"DAVIDEŞTI",16285,673,427,402,25,0,379,48,800,373,285,94
3,"ARGEŞ","#N/A",16285,,325,"CONŢEŞTI / Şcoala Olteanca",3,1456,"DAVIDEŞTI",16285,730,444,417,27,0,427,17,800,356,366,61
3,"ARGEŞ","#N/A",16329,,326,"PODU DÎMBOVIŢEI / Căminul Cultural Podu Dîmboviţei",3,1460,"DÎMBOVICIOARA",16329,465,445,341,104,0,444,1,600,155,220,224
3,"ARGEŞ","#N/A",16329,,327,"DÎMBOVICIOARA / Fostul sediu al Primăriei Dîmbovicioara",3,1460,"DÎMBOVICIOARA",16329,273,229,176,53,0,229,0,400,171,120,109
3,"ARGEŞ","#N/A",16329,,328,"CIOCANU / Şcoala Ciocanu",3,1460,"DÎMBOVICIOARA",16329,65,86,43,43,0,86,0,200,114,47,39
3,"ARGEŞ","#N/A",16365,,329,"PISCANI / Şcoala Piscani",3,1464,"DÎRMĂNEŞTI",16365,1303,852,789,63,0,848,4,1400,548,591,257
3,"ARGEŞ","#N/A",16365,,330,"DÎRMĂNEŞTI / Şcoala Dîrmăneşti",3,1464,"DÎRMĂNEŞTI",16365,1088,642,591,51,0,637,5,1200,558,445,192
3,"ARGEŞ","#N/A",16365,,331,"VALEA NANDRII / Şcoala Valea Nandrii",3,1464,"DÎRMĂNEŞTI",16365,598,411,366,45,0,409,2,700,289,281,128
3,"ARGEŞ","#N/A",16427,,332,"DOBREŞTI / Cămin Cultural Dobreşti",3,1470,"DOBREŞTI",16427,773,583,477,101,5,578,5,800,217,347,231
3,"ARGEŞ","#N/A",16427,,333,"FUREŞTI / Şcoala Gen. I-IV Fureşti",3,1470,"DOBREŞTI",16427,704,443,413,28,2,439,4,800,357,309,130
3,"ARGEŞ","#N/A",16454,,334,"DOMNEŞTI / Caminul Cultural  ""Petre Ionescu Muscel""",3,1473,"DOMNEŞTI",16454,1291,950,825,100,25,939,11,1400,450,601,338
3,"ARGEŞ","#N/A",16454,,335,"DOMNEŞTI / Caminul Cultural ""Petre Ionescu Muscel"" -",3,1473,"DOMNEŞTI",16454,1399,1027,919,79,29,1015,12,1500,473,692,323
3,"ARGEŞ","#N/A",16472,,336,"DRAGOSLAVELE / Şcoala Gimnazială Iosif Catrinescu cls. V-VIII",3,1480,"DRAGOSLAVELE",16472,701,477,440,36,1,474,3,800,323,287,187
3,"ARGEŞ","#N/A",16472,,337,"DRAGOSLAVELE / ŞcoalaPrimară Dragoslavele",3,1480,"DRAGOSLAVELE",16472,931,619,578,41,0,615,4,1000,381,286,329
3,"ARGEŞ","#N/A",16472,,338,"VALEA HOTARULUI / Şcoala Valea Hotarului",3,1480,"DRAGOSLAVELE",16472,473,377,353,24,0,370,7,500,123,282,88
3,"ARGEŞ","#N/A",16506,,339,"DRĂGANU-OLTENI / Cămin Cultural Drăganu",3,1475,"DRĂGANU",16506,1613,1104,899,193,12,1093,11,1800,696,678,415
3,"ARGEŞ","#N/A",16551,,340,"GODENI / Şcoala Godeni",3,1483,"GODENI",16551,1104,769,692,74,3,760,9,1200,431,536,224
3,"ARGEŞ","#N/A",16551,,341,"COTEŞTI / Şcoala Coteşti",3,1483,"GODENI",16551,1509,942,875,66,1,925,17,1600,658,620,305
3,"ARGEŞ","#N/A",16659,,342,"HÂRTIEŞTI / Cămin Cultural Hîrtieşti",3,1489,"HÂRTIEŞTI",16659,799,562,521,41,0,556,6,900,338,407,149
3,"ARGEŞ","#N/A",16659,,343,"DEALU / Primăria Veche Hîrtieşti",3,1489,"HÂRTIEŞTI",16659,293,221,190,31,0,219,2,300,79,159,60
3,"ARGEŞ","#N/A",16659,,344,"LUCIENI / Şcoala Lucieni",3,1489,"HÂRTIEŞTI",16659,280,202,174,28,0,199,3,300,98,157,42
3,"ARGEŞ","#N/A",16659,,345,"LESPEZI / Centrul de zi Lespezi",3,1489,"HÂRTIEŞTI",16659,330,234,220,14,0,232,2,400,166,205,27
3,"ARGEŞ","#N/A",16613,,346,"HÎRSEŞTI / Şcoala cu cls. I-VIII Hîrseşti",3,1494,"HÎRSEŞTI",16613,1388,822,660,162,0,809,13,1500,678,598,211
3,"ARGEŞ","#N/A",16613,,347,"MARTALOGI / Şcoala  Martalogi",3,1494,"HÎRSEŞTI",16613,607,409,327,82,0,405,4,700,291,301,104
3,"ARGEŞ","#N/A",16739,,348,"IZVORU / Şcoala Gen cu cls.I-VIII Izvoru",3,1498,"IZVORU",16739,967,526,461,65,0,517,9,1100,574,367,150
3,"ARGEŞ","#N/A",16739,,349,"IZVORU / Şcoala Gen cu cls.I-VIII Izvoru",3,1498,"IZVORU",16739,927,454,416,38,0,447,7,1000,546,330,117
3,"ARGEŞ","#N/A",16757,,350,"LEORDENI / PRIMARIE",3,1500,"LEORDENI",16757,1462,1012,864,116,32,999,13,1600,588,654,345
3,"ARGEŞ","#N/A",16757,,351,"BUDIŞTENI / CAMIN CULTURAL BUDISTENI",3,1500,"LEORDENI",16757,1103,650,602,45,3,645,5,1200,550,491,154
3,"ARGEŞ","#N/A",16757,,352,"GLÎMBOCATA / SCOALA CU CLASELE I-VIII",3,1500,"LEORDENI",16757,938,602,528,74,0,588,14,1000,398,391,197
3,"ARGEŞ","#N/A",16757,,353,"CIULNIŢA / SCOALA CIULNITA",3,1500,"LEORDENI",16757,963,646,563,76,7,640,6,1100,454,417,223
3,"ARGEŞ","#N/A",16757,,354,"COTU MALULUI / SCOALA COTU MALULUI",3,1500,"LEORDENI",16757,356,226,203,21,2,224,2,400,174,197,27
3,"ARGEŞ","#N/A",16908,,355,"LEREŞTI / SCOALA  GIMNAZIALA nR. 1 LERESTI",3,1515,"LEREŞTI",16908,1446,958,904,54,0,947,11,1600,642,576,371
3,"ARGEŞ","#N/A",16908,,356,"VOINEŞTI / Scoala Generala Voinesti",3,1515,"LEREŞTI",16908,1393,1037,939,93,5,1027,10,1500,463,624,403
3,"ARGEŞ","#N/A",16908,,357,"LEREŞTI / CAMIN CULTURAL LERESTI",3,1515,"LEREŞTI",16908,1114,753,701,52,0,734,19,1200,447,536,198
3,"ARGEŞ","#N/A",16944,,358,"LUNCA CORBULUI / Şcoala Lunca Corbului",3,1519,"LUNCA CORBULUI",16944,842,538,444,94,0,535,3,900,362,275,260
3,"ARGEŞ","#N/A",16944,,359,"SILIŞTENI / Şcoala Silişteni",3,1519,"LUNCA CORBULUI",16944,234,160,121,39,0,158,2,300,140,73,85
3,"ARGEŞ","#N/A",16944,,360,"PĂDUREŢI / Şcoala Pădureţi",3,1519,"LUNCA CORBULUI",16944,918,504,405,99,0,500,4,1000,496,340,160
3,"ARGEŞ","#N/A",16944,,361,"MÎRGHIA DE SUS / Şcoala Mîrghia de Sus",3,1519,"LUNCA CORBULUI",16944,369,337,225,112,0,332,5,400,63,233,99
3,"ARGEŞ","#N/A",17049,,362,"MĂLURENI / Şcoala Mălureni",3,1529,"MĂLURENI",17049,557,371,297,74,0,363,8,600,229,246,117
3,"ARGEŞ","#N/A",17049,,363,"MĂLURENI / Cămin Cultural Bădiceni",3,1529,"MĂLURENI",17049,423,330,215,115,0,322,8,500,170,185,137
3,"ARGEŞ","#N/A",17049,,364,"TOPLIŢA / Şcoala  Bohari",3,1529,"MĂLURENI",17049,311,222,164,58,0,222,0,400,178,143,79
3,"ARGEŞ","#N/A",17049,,365,"TOPLIŢA / Şcoala Topliţa",3,1529,"MĂLURENI",17049,350,228,174,54,0,226,2,400,172,190,36
3,"ARGEŞ","#N/A",17049,,366,"ZĂRNEŞTI / Şcoala  Zărneşti",3,1529,"MĂLURENI",17049,773,503,422,81,0,501,2,800,297,353,148
3,"ARGEŞ","#N/A",17049,,367,"BUNEŞTI / Şcoala Buneşti",3,1529,"MĂLURENI",17049,564,357,266,91,0,353,4,600,243,246,107
3,"ARGEŞ","#N/A",17049,,368,"PĂULEASCA / Tabara Păuleasca",3,1529,"MĂLURENI",17049,573,281,268,13,0,270,11,600,319,220,50
3,"ARGEŞ","#N/A",13365,,369,"MĂRĂCINENI / Şcoala Generală nr.1",3,1535,"MĂRĂCINENI",13365,1806,1198,1137,61,0,1184,14,2000,802,741,443
3,"ARGEŞ","#N/A",13365,,370,"MĂRĂCINENI / Şcoala Generală nr.1",3,1535,"MĂRĂCINENI",13365,929,557,497,60,0,550,7,1000,443,320,230
3,"ARGEŞ","#N/A",13365,,371,"ARGEŞELU / Şcoala Generală Argeşelu",3,1535,"MĂRĂCINENI",13365,1516,1055,926,129,0,1045,10,1700,645,674,371
3,"ARGEŞ","#N/A",17101,,372,"DOBROGOSTEA / Şcoala Primară Dobrogostea",3,1538,"MERIŞANI",17101,1007,614,561,53,0,612,2,1100,486,443,169
3,"ARGEŞ","#N/A",17101,,373,"BORLEŞTI / Şcoala Gen.Borlesti",3,1538,"MERIŞANI",17101,504,343,306,37,0,339,4,600,257,185,154
3,"ARGEŞ","#N/A",17101,,374,"MERIŞANI / Cămin Cultural Merişani",3,1538,"MERIŞANI",17101,709,435,385,50,0,433,2,800,365,265,168
3,"ARGEŞ","#N/A",17101,,375,"MALU VÎNĂT / Şcoala Primară Malu Vânăt",3,1538,"MERIŞANI",17101,591,300,265,35,0,293,7,700,400,217,76
3,"ARGEŞ","#N/A",17101,,376,"VÎLCELELE / Cămin Cultural Vâlcele",3,1538,"MERIŞANI",17101,764,515,445,70,0,514,1,800,285,334,180
3,"ARGEŞ","#N/A",17209,,377,"MICEŞTI / Şcoala Gimnaziala nr.1 Miceşti",3,1548,"MICEŞTI",17209,1432,905,859,46,0,891,14,1600,695,542,349
3,"ARGEŞ","#N/A",17209,,378,"PURCĂRENI / Cămin Cultural Purcăreni",3,1548,"MICEŞTI",17209,1349,865,814,51,0,854,11,1500,635,551,303
3,"ARGEŞ","#N/A",17209,,379,"PĂULEASCA / Şcoala Primara nr.2 Păuleasca",3,1548,"MICEŞTI",17209,716,433,402,31,0,419,14,800,367,227,192
3,"ARGEŞ","#N/A",17254,,380,"MIHĂEŞTI / Cămin Cultural Mihăeşti",3,1553,"MIHĂEŞTI",17254,1926,1117,1047,70,0,1100,17,2000,883,766,334
3,"ARGEŞ","#N/A",17254,,381,"VALEA POPII / Cămin Cultural Valea Popii",3,1553,"MIHĂEŞTI",17254,797,587,543,44,0,582,5,900,313,430,152
3,"ARGEŞ","#N/A",17254,,382,"DRĂGHICI / Şcoala Gen. Drăghici",3,1553,"MIHĂEŞTI",17254,892,584,527,57,0,579,5,1000,416,416,163
3,"ARGEŞ","#N/A",17254,,383,"VĂCAREA / Şcoala Gen. Văcarea",3,1553,"MIHĂEŞTI",17254,483,411,369,42,0,410,1,600,189,285,125
3,"ARGEŞ","#N/A",17254,,384,"FURNICOŞI / Caminul Cultural Furnicosi",3,1553,"MIHĂEŞTI",17254,713,511,474,37,0,505,6,800,289,319,186
3,"ARGEŞ","#N/A",17334,,385,"MĂŢĂU / Cămin Cultural Măţău",3,1561,"MIOARELE",17334,1031,673,617,56,0,665,8,1100,427,387,278
3,"ARGEŞ","#N/A",17334,,386,"SUSLĂNEŞTI / Şcoala Primară I-IV Suslăneşti",3,1561,"MIOARELE",17334,342,259,231,28,0,255,4,400,141,150,105
3,"ARGEŞ","#N/A",17398,,387,"MIROŞI / Cămin Cultural Miroşi",3,1567,"MIROŞI",17398,1286,719,644,75,0,716,3,1400,681,543,173
3,"ARGEŞ","#N/A",17398,,388,"SURDULEŞTI / Şcoala Surduleşti",3,1567,"MIROŞI",17398,796,502,439,63,0,499,3,900,398,373,126
3,"ARGEŞ","#N/A",17423,,389,"MORĂREŞTI / Şcoala Generală cu clasele I-VIII Morăreşti",3,1570,"MORĂREŞTI",17423,946,645,536,109,0,640,5,1100,455,345,295
3,"ARGEŞ","#N/A",17423,,390,"DEDULEŞTI / Şcoala cu clasele I-IV Deduleşti",3,1570,"MORĂREŞTI",17423,656,422,310,97,15,414,8,700,278,229,185
3,"ARGEŞ","#N/A",17496,,391,"MOŞOAIA / Cămin Cultural Moşoaia",3,1577,"MOŞOAIA",17496,1393,888,793,95,0,878,10,1510,622,559,319
3,"ARGEŞ","#N/A",17496,,392,"HINŢEŞTI / Şcoala cu clasele I-VIII Hinţeşti",3,1577,"MOŞOAIA",17496,910,613,527,86,0,603,10,1000,387,381,222
3,"ARGEŞ","#N/A",17496,,393,"SMEURA / Şcoala cu clasele I-IV Smeura",3,1577,"MOŞOAIA",17496,1112,782,690,92,0,768,14,1200,418,404,364
3,"ARGEŞ","#N/A",17496,,394,"CIOCĂNĂI / Şcoala cu clasele I-IV Ciocănăi",3,1577,"MOŞOAIA",17496,535,370,334,36,0,364,6,600,230,243,121
3,"ARGEŞ","#N/A",17496,,395,"SMEURA / SC BUILDING ASTROM SRL",3,1577,"MOŞOAIA",17496,624,438,414,24,0,434,4,700,262,195,239
3,"ARGEŞ","#N/A",17575,,396,"MOZĂCENI / LICEUL TEHNOLOGIC LIVIU REBREANU Mozăceni",3,1585,"MOZĂCENI",17575,1292,809,710,99,0,804,5,1400,591,620,184
3,"ARGEŞ","#N/A",17575,,397,"MOZĂCENI / Şcoala Generală Mişei",3,1585,"MOZĂCENI",17575,563,299,242,57,0,291,8,600,301,191,100
3,"ARGEŞ","#N/A",17619,,398,"MUSĂŢEŞTI / Cămin Cultural Constantin Dobrescu Arges - Robaia",3,1589,"MUŞĂTEŞTI",17619,1253,817,747,69,1,794,23,1400,583,493,301
3,"ARGEŞ","#N/A",17619,,399,"VÎLSĂNEŞTI / Sediul primariei vechi - Vilsanesti",3,1589,"MUŞĂTEŞTI",17619,447,301,237,64,0,300,1,500,199,209,91
3,"ARGEŞ","#N/A",17619,,400,"COSTEŞTI-VÎSLAN / Şcoala Generală Costeşti - Vîlsan",3,1589,"MUŞĂTEŞTI",17619,583,411,345,65,1,406,5,600,189,248,158
3,"ARGEŞ","#N/A",17619,,401,"STROEŞTI / Şcoala Generală Stroeşti",3,1589,"MUŞĂTEŞTI",17619,880,603,530,58,15,598,5,1000,397,452,146
3,"ARGEŞ","#N/A",17726,,402,"NEGRAŞI / Şcoala Negraşi",3,1600,"NEGRAŞI",17726,668,419,351,68,0,412,7,700,281,298,114
3,"ARGEŞ","#N/A",17726,,403,"BÎRLOGU / Grădiniţa Bîrlogu",3,1600,"NEGRAŞI",17726,716,436,330,104,2,429,7,800,364,309,120
3,"ARGEŞ","#N/A",17726,,404,"MOZACU / Şcoala Mozacu",3,1600,"NEGRAŞI",17726,265,206,158,48,0,206,0,300,94,150,56
3,"ARGEŞ","#N/A",17726,,405,"BUTA / Şcoala Buta",3,1600,"NEGRAŞI",17726,158,123,91,32,0,121,2,200,77,80,41
3,"ARGEŞ","#N/A",17771,,406,"NUCŞOARA / Cămin Cultural Nucşoara",3,1605,"NUCŞOARA",17771,413,308,275,33,0,305,3,500,192,205,100
3,"ARGEŞ","#N/A",17771,,407,"SBOGHIŢEŞTI / Cămin Cultural Sboghiţeşti",3,1605,"NUCŞOARA",17771,357,284,241,43,0,281,3,400,116,183,98
3,"ARGEŞ","#N/A",17771,,408,"SLATINA / CAMIN CULTURAL SLATINA",3,1605,"NUCŞOARA",17771,439,313,278,35,0,307,6,500,187,211,96
3,"ARGEŞ","#N/A",17824,,409,"OARJA / Şcoala Gimnazială ""D. Rădulescu"" Oarja",3,1610,"OARJA",17824,1429,1033,923,106,4,1021,12,1600,567,604,417
3,"ARGEŞ","#N/A",17824,,410,"OARJA / Şcoala Primară Oarja Sat",3,1610,"OARJA",17824,819,565,518,45,2,557,8,900,335,318,239
3,"ARGEŞ","#N/A",17851,,411,"PIETROŞANI / Sala de Sport Pietroşani",3,1613,"PIETROŞANI",17851,1493,962,910,52,0,960,2,1700,738,639,321
3,"ARGEŞ","#N/A",17851,,412,"BĂDEŞTI / Cămin Cultural Bădeşti",3,1613,"PIETROŞANI",17851,1277,870,826,44,0,859,11,1400,530,592,267
3,"ARGEŞ","#N/A",17851,,413,"RETEVOIEŞTI / Şcoala Generală cu clasele I-IV Retevoieşti",3,1613,"PIETROŞANI",17851,1451,877,823,54,0,870,7,1600,723,610,260
3,"ARGEŞ","#N/A",17851,,414,"GĂNEŞTI / ŞcoalaGenerală cu clasele I-IV Găneşti",3,1613,"PIETROŞANI",17851,549,344,319,25,0,340,4,600,256,258,82
3,"ARGEŞ","#N/A",18028,,415,"POIANA LACULUI / Şcoala cu clasele I-VIII Poiana Lacului",3,1619,"POIANA LACULUI",18028,1601,947,839,108,0,927,20,1700,753,553,374
3,"ARGEŞ","#N/A",18028,,416,"DINCULEŞTI / Şcoala cu clasele  I-IV Dinculeşti",3,1619,"POIANA LACULUI",18028,278,190,172,18,0,187,3,300,110,112,75
3,"ARGEŞ","#N/A",18028,,417,"CĂTUNAŞI / Şcoala cu clasele I-IV Cătunaşi",3,1619,"POIANA LACULUI",18028,387,327,257,70,0,324,3,500,173,146,178
3,"ARGEŞ","#N/A",18028,,418,"SĂMARA / Şcoala cu clasele I-VIII Sămara",3,1619,"POIANA LACULUI",18028,827,510,459,51,0,504,6,900,390,229,275
3,"ARGEŞ","#N/A",18028,,419,"METOFU / Şcoala cu clasele I-IV Metofu",3,1619,"POIANA LACULUI",18028,225,150,135,15,0,147,3,300,150,106,41
3,"ARGEŞ","#N/A",18028,,420,"DEALU VIILOR / Şcoala cu clasele I-IV Dealul Viilor",3,1619,"POIANA LACULUI",18028,287,215,175,40,0,212,3,300,85,71,141
3,"ARGEŞ","#N/A",18028,,421,"PĂDUROIU DIN DEAL / Grădiniţa Păduroiu  din Deal",3,1619,"POIANA LACULUI",18028,749,438,402,36,0,435,3,800,362,269,166
3,"ARGEŞ","#N/A",18028,,422,"PĂDUROIU DIN VALE / Grădiniţa Păduroiu  din Vale",3,1619,"POIANA LACULUI",18028,636,370,342,28,0,364,6,700,330,188,176
3,"ARGEŞ","#N/A",18028,,423,"GĂRDINEŞTI / Şcoala cu clasele I-IV Gărdineşti",3,1619,"POIANA LACULUI",18028,378,283,232,51,0,278,5,400,117,144,134
3,"ARGEŞ","#N/A",17913,,424,"POIENARI / Cămin Cultural Poienari",3,1633,"POIENARII DE ARGEŞ",17913,698,519,428,87,4,515,4,800,281,214,301
3,"ARGEŞ","#N/A",17913,,425,"IOANICEŞTI / Şcoala Generală I-IV Ioaniceşti",3,1633,"POIENARII DE ARGEŞ",17913,185,142,117,25,0,142,0,200,58,61,81
3,"ARGEŞ","#N/A",17968,,426,"POIENARI / Şcoala Gimnaziala nr.1 Poienarii de Muscel",3,1638,"POIENARII DE MUSCEL",17968,1280,709,642,65,2,703,6,1400,691,451,252
3,"ARGEŞ","#N/A",17968,,427,"JUGUR / Şcoala Primară nr.1  Jugur",3,1638,"POIENARII DE MUSCEL",17968,968,546,509,37,0,542,4,1100,554,340,202
3,"ARGEŞ","#N/A",17968,,428,"GROŞANI / Grădiniţa cu program normal nr.2 Groşani",3,1638,"POIENARII DE MUSCEL",17968,608,366,347,19,0,362,4,700,334,221,141
3,"ARGEŞ","#N/A",18162,,429,"POPEŞTI / Şcoala Popeşti",3,1644,"POPEŞTI",18162,562,380,306,74,0,376,4,600,220,300,76
3,"ARGEŞ","#N/A",18162,,430,"SLOBOZIA / Şcoala Slobozia",3,1644,"POPEŞTI",18162,687,350,297,53,0,348,2,800,450,270,78
3,"ARGEŞ","#N/A",18162,,431,"PURCĂRENI / Şcoala Purcăreni",3,1644,"POPEŞTI",18162,534,354,306,48,0,347,5,600,246,270,77
3,"ARGEŞ","#N/A",18242,,432,"PRIBOIENI / Scoala gimnaziala C. Radulescu Codin",3,1649,"PRIBOIENI",18242,1467,1003,957,45,1,994,9,1600,597,693,301
3,"ARGEŞ","#N/A",18242,,433,"PRIBOIENI / Clubul Tineretului Priboieni",3,1649,"PRIBOIENI",18242,1548,1131,1068,61,2,1119,12,1700,569,721,398
3,"ARGEŞ","#N/A",18331,,434,"TIGVENI / Căminul Cultural Tigveni",3,1662,"RĂTEŞTI",18331,678,402,356,46,0,396,6,700,298,288,108
3,"ARGEŞ","#N/A",18331,,435,"FURDUEŞTI / Şcoala cu clasele  I-IV Furdueşti",3,1662,"RĂTEŞTI",18331,452,277,243,34,0,276,1,500,223,152,124
3,"ARGEŞ","#N/A",18331,,436,"NEJLOVELU / Şcoala cu clasele  I-IV Nejlovelu",3,1662,"RĂTEŞTI",18331,424,265,202,63,0,261,4,500,235,170,91
3,"ARGEŞ","#N/A",18331,,437,"PĂTULENI / Şcoala cu clasele  I-IV Pătuleni",3,1662,"RĂTEŞTI",18331,780,521,459,62,0,515,6,800,279,399,116
3,"ARGEŞ","#N/A",18331,,438,"MAVRODOLU / Şcoala cu clasele  I-IV Mavrodolu",3,1662,"RĂTEŞTI",18331,143,104,75,29,0,104,0,200,96,62,42
3,"ARGEŞ","#N/A",20048,,439,"RÂCA / Caminul Cultural Râca",3,1658,"RÂCA",20048,928,780,630,150,0,776,4,1000,220,695,81
3,"ARGEŞ","#N/A",18411,,440,"RECEA / Şcoala Generala nr. 1 Recea",3,1670,"RECEA",18411,1544,979,836,143,0,970,9,1600,621,646,324
3,"ARGEŞ","#N/A",18411,,441,"DEAGU DE JOS / Şcoala cu clasele I-VIII Deagurile",3,1670,"RECEA",18411,847,526,447,79,0,524,2,1000,474,386,138
3,"ARGEŞ","#N/A",18475,,442,"ROCIU / Şcoala Gen. Rociu",3,1676,"ROCIU",18475,402,355,251,71,33,343,12,450,95,281,62
3,"ARGEŞ","#N/A",18475,,443,"GLIGANU DE JOS / Şcoala Gen. Gliganu de Jos",3,1676,"ROCIU",18475,381,347,237,94,16,343,4,400,53,269,74
3,"ARGEŞ","#N/A",18475,,444,"GLIGANU DE SUS / Şcoala Gen. Gliganu de Sus",3,1676,"ROCIU",18475,590,570,404,108,58,514,56,650,80,416,98
3,"ARGEŞ","#N/A",18475,,445,"ŞERBĂNEŞTI / Şcoala Gen. Şerbăneşti",3,1676,"ROCIU",18475,795,664,547,88,29,611,53,900,236,491,120
3,"ARGEŞ","#N/A",18527,,446,"RUCĂR / Liceul Tehnologic "" Victor Slavescu"" - Sala de Sport",3,1681,"RUCĂR",18527,1303,912,853,53,6,912,0,1400,488,498,414
3,"ARGEŞ","#N/A",18527,,447,"RUCĂR / Şcoala Generală nr.2 - Clasa nr. 1",3,1681,"RUCĂR",18527,1053,869,717,149,3,858,11,1200,331,468,390
3,"ARGEŞ","#N/A",18527,,448,"RUCĂR / Şcoala Gimnaziala ""Nae A Ghica"" -  Clasa Sala de Sport",3,1681,"RUCĂR",18527,1023,745,662,81,2,741,4,1100,355,400,341
3,"ARGEŞ","#N/A",18527,,449,"SĂTIC / Şcoala  Sătic",3,1681,"RUCĂR",18527,104,149,61,88,0,149,0,200,51,62,87
3,"ARGEŞ","#N/A",18527,,450,"RUCĂR / Scoala Gimnaziala 'Nae A. Ghica' - Sala clasa pregatitoare",3,1681,"RUCĂR",18527,1492,1123,1017,103,3,1096,27,1600,477,559,537
3,"ARGEŞ","#N/A",18554,,451,"SĂLĂTRUCU / Căminul Cultural Sălătrucu Centru",3,1684,"SĂLĂTRUCU",18554,1236,774,699,75,0,759,15,1300,526,407,352
3,"ARGEŞ","#N/A",18554,,452,"VĂLENI / Şcoala cu clasele  I-IV Văleni",3,1684,"SĂLĂTRUCU",18554,567,357,324,33,0,353,4,700,343,191,162
3,"ARGEŞ","#N/A",18581,,453,"DEALU BRADULUI / Şcoala generală Dealu Bradului",3,1687,"SĂPATA",18581,176,130,107,20,3,130,0,200,70,67,63
3,"ARGEŞ","#N/A",18581,,454,"POPEŞTI / Cămin Cultural Popeşti",3,1687,"SĂPATA",18581,682,540,430,105,5,537,3,700,160,355,182
3,"ARGEŞ","#N/A",18581,,455,"BĂNĂREŞTI / Şcoala Gimnazială Dumitru Udrescu Săpata",3,1687,"SĂPATA",18581,324,258,190,63,5,255,3,400,142,168,87
3,"ARGEŞ","#N/A",18581,,456,"MÎRŢEŞTI / Imobil proprietate Miu Cosmin",3,1687,"SĂPATA",18581,244,199,144,55,0,199,0,300,101,145,54
3,"ARGEŞ","#N/A",18670,,457,"LĂZĂREŞTI / Şcoala cu clasele V-VIII Lăzăreşti",3,1696,"SCHITU GOLEŞTI",18670,1112,654,617,35,2,647,7,1200,546,425,222
3,"ARGEŞ","#N/A",18670,,458,"SCHITU GOLEŞTI / Cămin Cultural Schitu Goleşti",3,1696,"SCHITU GOLEŞTI",18670,1235,813,746,66,1,800,13,1400,587,552,248
3,"ARGEŞ","#N/A",18670,,459,"LĂZĂREŞTI / Cămin Cultural Lăzăreşti",3,1696,"SCHITU GOLEŞTI",18670,1731,941,886,55,0,929,12,1900,959,603,326
3,"ARGEŞ","#N/A",18741,,460,"SLOBOZIA / Şcoala Gen.Nr.2 clasele I-IV",3,1703,"SLOBOZIA",18741,1920,1046,980,66,0,1027,19,2100,1054,611,416
3,"ARGEŞ","#N/A",18741,,461,"NIGRIŞOARA / Şcoala Nigrişoara",3,1703,"SLOBOZIA",18741,239,154,135,19,0,154,0,300,146,84,70
3,"ARGEŞ","#N/A",18741,,462,"SLOBOZIA / Şoala generală din centrul comunei",3,1703,"SLOBOZIA",18741,1752,990,927,63,0,980,10,1900,910,708,272
3,"ARGEŞ","#N/A",18778,,463,"STÎLPENI / Grădiniţa cu Program Prelungit Stîlpeni",3,1709,"STÎLPENI",18778,1614,1117,1019,92,6,1110,7,1800,683,794,316
3,"ARGEŞ","#N/A",18778,,464,"LIVEZENI / Caminul Cultural Livezeni",3,1709,"STÎLPENI",18778,1219,865,794,64,7,853,12,1300,435,603,250
3,"ARGEŞ","#N/A",18778,,465,"RĂDEŞTI / Caminul Cultural Rădeşti",3,1709,"STÎLPENI",18778,1419,999,901,97,1,991,8,1600,601,784,207
3,"ARGEŞ","#N/A",18858,,466,"STOENEŞTI / Cămin Cultural Stoeneşti",3,1717,"STOENEŞTI",18858,1124,771,665,105,1,770,1,1200,429,379,391
3,"ARGEŞ","#N/A",18858,,467,"BĂDENI / Cămin Cultural Bădeni",3,1717,"STOENEŞTI",18858,1503,907,854,53,0,899,8,1600,693,507,392
3,"ARGEŞ","#N/A",18858,,468,"PIATRA / Cămin Cultural Piatra",3,1717,"STOENEŞTI",18858,419,274,252,22,0,269,5,500,226,173,96
3,"ARGEŞ","#N/A",18858,,469,"VALEA BĂDENILOR / Şcoala Gen. Valea Bădenilor",3,1717,"STOENEŞTI",18858,623,422,399,23,0,412,10,700,278,296,116
3,"ARGEŞ","#N/A",18938,,470,"STOLNICI / Gradinita cu program normal Stolnici",3,1725,"STOLNICI",18938,1573,879,734,145,0,874,5,1700,821,653,221
3,"ARGEŞ","#N/A",18938,,471,"FÎLFANI / Scoala primara Fîlfani",3,1725,"STOLNICI",18938,1115,654,499,155,0,647,7,1200,546,433,214
3,"ARGEŞ","#N/A",19007,,472,"CERŞANI / Şcoala Primară Ioan Rizescu",3,1739,"SUSENI",19007,626,414,341,73,0,408,6,700,286,255,153
3,"ARGEŞ","#N/A",19007,,473,"SUSENI / Şcoala Gimnazială Marin Branişte",3,1739,"SUSENI",19007,889,558,462,96,0,552,6,1000,442,331,221
3,"ARGEŞ","#N/A",19007,,474,"ŢUŢULEŞTI / Şcoala Primară Gheoghe Toma",3,1739,"SUSENI",19007,1078,699,588,111,0,690,9,1200,501,353,337
3,"ARGEŞ","#N/A",19114,,475,"ŞTEFAN CEL MARE / Şcoala cu clasele I-VIII  Ştefan cel Mare",3,1706,"ŞTEFAN CEL MARE",19114,718,425,380,45,0,422,3,800,375,320,102
3,"ARGEŞ","#N/A",19114,,476,"ŞTEFAN CEL MARE / Şcoala cu clasele I-VIII  Ştefan cel Mare",3,1706,"ŞTEFAN CEL MARE",19114,876,540,492,48,0,531,9,1000,460,367,164
3,"ARGEŞ","#N/A",19114,,477,"GLAVACIOC / Şcoala Glavacioc",3,1706,"ŞTEFAN CEL MARE",19114,382,230,184,46,0,227,3,400,170,173,54
3,"ARGEŞ","#N/A",19141,,478,"ŞUICI / Cămin Cultural Şuici",3,1732,"ŞUICI",19141,1069,711,644,53,14,704,7,1200,489,395,309
3,"ARGEŞ","#N/A",19141,,479,"RUDENI / Şcoala Primară Rudeni",3,1732,"ŞUICI",19141,724,501,463,36,2,497,4,800,299,314,183
3,"ARGEŞ","#N/A",19141,,480,"IANCULEŞTI / Şcoala Ianculeşti",3,1732,"ŞUICI",19141,250,149,129,20,0,147,2,300,151,90,57
3,"ARGEŞ","#N/A",19141,,481,"VALEA CALULUI / Şcoala Primară Valea Calului",3,1732,"ŞUICI",19141,78,56,46,10,0,56,0,100,44,34,22
3,"ARGEŞ","#N/A",19212,,482,"TEIU / Cămin Cultural Teiu",3,1750,"TEIU",19212,995,630,503,127,0,615,15,1000,370,462,153
3,"ARGEŞ","#N/A",19212,,483,"LEŞILE / Şcoala Generală Leşile",3,1750,"TEIU",19212,174,138,95,43,0,134,4,300,162,105,29
3,"ARGEŞ","#N/A",19249,,484,"TIGVENI / Primăria Tigveni",3,1753,"TIGVENI",19249,1518,870,803,67,0,849,21,1583,713,566,283
3,"ARGEŞ","#N/A",19249,,485,"BÎRSEŞTII DE JOS / Cămin Cultural Bîrseştii de Jos",3,1753,"TIGVENI",19249,1047,591,552,39,0,588,3,1200,609,371,217
3,"ARGEŞ","#N/A",19249,,486,"VLĂDEŞTI / Şcoala cuclasele I-IV Vlădeşti",3,1753,"TIGVENI",19249,220,151,125,26,0,151,0,300,149,120,31
3,"ARGEŞ","#N/A",19338,,487,"BUCŞENEŞTI-LOTAŞI / PRIMĂRIA COM. ŢIŢEŞTI",3,1762,"ŢIŢEŞTI",19338,1208,769,704,52,13,763,6,1300,531,505,258
3,"ARGEŞ","#N/A",19338,,488,"VALEA STÎNII / ŞCOALA CU CLASELE I-IV VALEA STÂNII",3,1762,"ŢIŢEŞTI",19338,822,617,568,46,3,610,7,900,283,414,196
3,"ARGEŞ","#N/A",19338,,489,"ŢIŢEŞTI / ŞCOALA CU CLASELE I-IV ŢIŢEŞTI",3,1762,"ŢIŢEŞTI",19338,976,594,557,33,4,588,6,1100,506,384,204
3,"ARGEŞ","#N/A",19338,,490,"VALEA MĂNĂSTIRII / ŞCOALA CU CLASELE I-IV VALEA MĂNĂSTIRII",3,1762,"ŢIŢEŞTI",19338,721,334,310,24,0,322,12,800,466,260,62
3,"ARGEŞ","#N/A",19392,,491,"UDA / Şcoala I-VIII Uda",3,1768,"UDA",19392,598,379,290,77,12,379,0,700,321,289,90
3,"ARGEŞ","#N/A",19392,,492,"COTU /  Şcoala Cotu",3,1768,"UDA",19392,236,229,147,82,0,229,0,300,71,138,91
3,"ARGEŞ","#N/A",19392,,493,"SĂLIŞTEA / Şcoala I - IV Săliştea",3,1768,"UDA",19392,495,328,251,77,0,326,2,500,172,236,90
3,"ARGEŞ","#N/A",19392,,494,"RÎJLEŢU-GOVORA / Cămin Cultural Govora",3,1768,"UDA",19392,402,292,215,77,0,291,1,400,108,224,67
3,"ARGEŞ","#N/A",19560,,495,"UNGHENI / Şcoala cu clasele I-VIII Ungheni",3,1785,"UNGHENI",19560,645,423,341,82,0,417,6,700,277,283,134
3,"ARGEŞ","#N/A",19560,,496,"COLŢU / Şcoala Colţu",3,1785,"UNGHENI",19560,644,477,393,84,0,477,0,700,223,422,55
3,"ARGEŞ","#N/A",19560,,497,"HUMELE / Societatea Agricola Albina",3,1785,"UNGHENI",19560,1207,740,613,127,0,733,7,1300,560,555,178
3,"ARGEŞ","#N/A",19631,,498,"VALEA DANULUI / Cămin Cultural Valea Danului",3,1792,"VALEA DANULUI",19631,1665,1116,1036,79,1,1102,14,1800,684,544,558
3,"ARGEŞ","#N/A",19631,,499,"VERNEŞTI / Caminul cultural Verneşti",3,1792,"VALEA DANULUI",19631,893,621,577,44,0,616,5,1000,379,353,263
3,"ARGEŞ","#N/A",19695,,500,"VALEA IAŞULUI / Şcoala Gimnazială Valea Iaşului",3,1798,"VALEA IAŞULUI",19695,860,575,493,26,56,566,9,900,325,331,235
3,"ARGEŞ","#N/A",19695,,501,"BOROVINEŞTI / Grădiniţa Borovineşti",3,1798,"VALEA IAŞULUI",19695,191,139,117,22,0,138,1,300,161,69,69
3,"ARGEŞ","#N/A",19695,,502,"MUSTĂŢEŞTI / Şcoala Primară Mustăteşti",3,1798,"VALEA IAŞULUI",19695,976,628,595,32,1,620,8,1100,472,330,290
3,"ARGEŞ","#N/A",19695,,503,"CERBURENI / Grădiniţa Cerbureni",3,1798,"VALEA IAŞULUI",19695,358,220,202,18,0,217,3,400,180,114,103
3,"ARGEŞ","#N/A",13524,,504,"VALEA MARE PRAVĂŢ / Cămin Cultural Valea Mare Pravăţ",3,1808,"VALEA MARE PRAVĂŢ",13524,1267,884,806,75,3,871,13,1400,516,438,433
3,"ARGEŞ","#N/A",13524,,505,"NĂMĂEŞTI / Cămin Cultural Nămăeşti",3,1808,"VALEA MARE PRAVĂŢ",13524,520,395,349,46,0,391,4,600,205,196,195
3,"ARGEŞ","#N/A",13524,,506,"BILCEŞTI / Şcoala Bilceşti",3,1808,"VALEA MARE PRAVĂŢ",13524,752,455,436,19,0,447,8,800,345,242,205
3,"ARGEŞ","#N/A",13524,,507,"GURA PRAVĂŢ / Şcoala Gura Pravăţ",3,1808,"VALEA MARE PRAVĂŢ",13524,797,613,587,26,0,581,32,900,287,321,260
3,"ARGEŞ","#N/A",19793,,508,"VEDEA / Grupul Şcolar ""I. Ghe. Duca""-Vedea",3,1817,"VEDEA",19793,776,595,407,117,71,590,5,800,205,417,173
3,"ARGEŞ","#N/A",19793,,509,"VAŢA / Şcoala Vaţa",3,1817,"VEDEA",19793,580,380,308,72,0,379,1,604,224,225,154
3,"ARGEŞ","#N/A",19793,,510,"PRODANI / Şcoala Prodani",3,1817,"VEDEA",19793,624,443,373,69,1,437,6,697,254,293,144
3,"ARGEŞ","#N/A",19793,,511,"FATA / Şcoala Fata",3,1817,"VEDEA",19793,491,342,286,56,0,339,3,599,257,273,66
3,"ARGEŞ","#N/A",19793,,512,"IZVORU DE SUS / Şcoala Izvoru de Sus",3,1817,"VEDEA",19793,308,226,178,47,1,226,0,401,175,165,61
3,"ARGEŞ","#N/A",19793,,513,"FRĂTICI / Şcoala Frătici",3,1817,"VEDEA",19793,372,240,205,35,0,233,7,399,159,148,85
3,"ARGEŞ","#N/A",19999,,514,"VLĂDEŞTI / Grădiniţa nr.3 Vlădeşti",3,1837,"VLĂDEŞTI",19999,1671,1084,1029,55,0,1074,10,1800,716,753,321
3,"ARGEŞ","#N/A",19999,,515,"VLĂDEŞTI / Scoala primara nr.2",3,1837,"VLĂDEŞTI",19999,840,567,546,21,0,557,10,900,333,413,144
3,"ARGEŞ","#N/A",20055,,516,"VULTUREŞTI / Primăria Vultureşti",3,1842,"VULTUREŞTI",20055,1591,945,846,82,17,932,13,1700,755,664,268
3,"ARGEŞ","#N/A",20055,,517,"BÂRZEŞTI / Căminul Cultural Bârzeşti",3,1842,"VULTUREŞTI",20055,453,392,314,42,36,385,7,500,108,262,123
3,"ARGEŞ","#N/A",20055,,518,"HULUBA / Şcoala Primară Huluba",3,1842,"VULTUREŞTI",20055,193,170,142,28,0,170,0,200,30,144,26
4,"BACĂU","#N/A",20297,,1,"BACĂU / Şcoala nr.9",1,1847,"MUNICIPIUL BACĂU",20297,989,591,531,60,0,582,9,1100,509,193,389
4,"BACĂU","#N/A",20297,,2,"BACĂU / Şcoala nr.9",1,1847,"MUNICIPIUL BACĂU",20297,1088,622,572,50,0,616,6,1300,678,215,401
4,"BACĂU","#N/A",20297,,3,"BACĂU / Şcoala Gimnaziala ,,Maria şi Mircea Cancicov,,",1,1847,"MUNICIPIUL BACĂU",20297,1620,734,699,35,0,720,14,1798,1064,220,500
4,"BACĂU","#N/A",20297,,4,"BACĂU / Şcoala Gimnaziala ,,Maria şi Mircea Cancicov,,",1,1847,"MUNICIPIUL BACĂU",20297,1381,706,668,38,0,693,13,1500,794,219,474
4,"BACĂU","#N/A",20297,,5,"BACĂU / S.C.E-ON Electrica",1,1847,"MUNICIPIUL BACĂU",20297,1447,810,698,112,0,798,12,1600,790,272,526
4,"BACĂU","#N/A",20297,,6,"BACĂU / Grădiniţa Crai Nou nr.37",1,1847,"MUNICIPIUL BACĂU",20297,1123,523,468,55,0,518,5,1201,678,170,348
4,"BACĂU","#N/A",20297,,7,"BACĂU / Grădiniţa Crai Nou nr.37",1,1847,"MUNICIPIUL BACĂU",20297,1145,585,520,65,0,575,10,1291,706,180,395
4,"BACĂU","#N/A",20297,,8,"BACĂU / Scoala Mihail Sadoveanu",1,1847,"MUNICIPIUL BACĂU",20297,1451,689,619,69,1,676,13,1600,911,249,427
4,"BACĂU","#N/A",20297,,9,"BACĂU / Şcoala Mihail Sadoveanu",1,1847,"MUNICIPIUL BACĂU",20297,1471,695,662,33,0,687,8,1600,905,221,466
4,"BACĂU","#N/A",20297,,10,"BACĂU / Şcoala Mihail Sadoveanu",1,1847,"MUNICIPIUL BACĂU",20297,1454,743,693,50,0,735,8,1600,857,239,496
4,"BACĂU","#N/A",20297,,11,"BACĂU / Şcoala MihailSadoveanu",1,1847,"MUNICIPIUL BACĂU",20297,1290,599,556,43,0,593,6,1400,801,166,427
4,"BACĂU","#N/A",20297,,12,"BACĂU / Scoala Georgeta M.Cancicov",1,1847,"MUNICIPIUL BACĂU",20297,1532,826,748,69,9,817,9,1700,874,350,467
4,"BACĂU","#N/A",20297,,13,"BACĂU / Şcoala Georgeta M.Cancicov",1,1847,"MUNICIPIUL BACĂU",20297,1439,757,718,39,0,741,16,1600,843,294,447
4,"BACĂU","#N/A",20297,,14,"BACĂU / Grădiniţa Georgeta M.Cancicov",1,1847,"MUNICIPIUL BACĂU",20297,1215,598,565,33,0,586,12,1300,702,215,371
4,"BACĂU","#N/A",20297,,15,"BACĂU / Grădiniţa Georgeta M.Cancicov",1,1847,"MUNICIPIUL BACĂU",20297,1250,618,582,34,2,608,10,1400,782,210,398
4,"BACĂU","#N/A",20297,,16,"BACĂU / Scoala Mihai Dragan",1,1847,"MUNICIPIUL BACĂU",20297,1214,711,660,51,0,698,13,1300,589,280,418
4,"BACĂU","#N/A",20297,,17,"BACĂU / Şcoala Mihai Drăgan",1,1847,"MUNICIPIUL BACĂU",20297,1273,684,612,72,0,675,9,1400,716,266,409
4,"BACĂU","#N/A",20297,,18,"BACĂU / Şcoala Mihai Drăgan",1,1847,"MUNICIPIUL BACĂU",20297,1227,675,626,49,0,664,11,1300,625,295,369
4,"BACĂU","#N/A",20297,,19,"BACĂU / Gradinita 35",1,1847,"MUNICIPIUL BACĂU",20297,1064,600,568,32,0,583,17,1200,600,248,335
4,"BACĂU","#N/A",20297,,20,"BACĂU / Gradinita nr.35",1,1847,"MUNICIPIUL BACĂU",20297,1478,763,727,34,2,751,12,1600,837,327,424
4,"BACĂU","#N/A",20297,,21,"BACĂU / Administraţia Finanţelor Publice",1,1847,"MUNICIPIUL BACĂU",20297,1084,574,535,39,0,567,7,1200,626,239,328
4,"BACĂU","#N/A",20297,,22,"BACĂU / Colegiul Naţional Gheorghe Vrânceanu",1,1847,"MUNICIPIUL BACĂU",20297,1407,913,852,60,1,901,12,1500,587,280,621
4,"BACĂU","#N/A",20297,,23,"BACĂU / Colegiul NaţionalGheorghe Vrânceanu",1,1847,"MUNICIPIUL BACĂU",20297,956,553,507,46,0,544,9,1000,447,188,356
4,"BACĂU","#N/A",20297,,24,"BACĂU / Şcoala Al.Ioan Cuza",1,1847,"MUNICIPIUL BACĂU",20297,1358,937,815,118,4,923,14,1500,563,396,527
4,"BACĂU","#N/A",20297,,25,"BACĂU / Colegiul Naţional Ferdiand I",1,1847,"MUNICIPIUL BACĂU",20297,1364,772,670,102,0,760,12,1500,728,267,493
4,"BACĂU","#N/A",20297,,26,"BACĂU / Colegiul Naţional Ferdiand I",1,1847,"MUNICIPIUL BACĂU",20297,1012,604,524,41,39,590,14,1133,529,231,359
4,"BACĂU","#N/A",20297,,27,"BACĂU / Colegiul Naţional Ferdiand I",1,1847,"MUNICIPIUL BACĂU",20297,1635,922,876,45,1,913,9,1800,878,390,523
4,"BACĂU","#N/A",20297,,28,"BACĂU / Direcţia pt.Agricultură Bacău",1,1847,"MUNICIPIUL BACĂU",20297,1573,863,822,40,1,858,5,1699,836,292,566
4,"BACĂU","#N/A",20297,,29,"BACĂU / Gradinita nr.29",1,1847,"MUNICIPIUL BACĂU",20297,1276,666,621,44,1,655,11,1394,728,260,395
4,"BACĂU","#N/A",20297,,30,"BACĂU / Grădiniţa nr.29",1,1847,"MUNICIPIUL BACĂU",20297,1141,622,579,43,0,608,14,1202,580,223,385
4,"BACĂU","#N/A",20297,,31,"BACĂU / Grădiniţa nr.29",1,1847,"MUNICIPIUL BACĂU",20297,1168,650,602,48,0,641,9,1300,650,258,383
4,"BACĂU","#N/A",20297,,32,"BACĂU / Grădiniţa nr.40",1,1847,"MUNICIPIUL BACĂU",20297,1327,701,673,28,0,696,5,1500,799,283,413
4,"BACĂU","#N/A",20297,,33,"BACĂU / Grădiniţa nr.40",1,1847,"MUNICIPIUL BACĂU",20297,1678,944,891,52,1,930,14,1800,856,387,543
4,"BACĂU","#N/A",20297,,34,"BACĂU / Scoala Ion Creanga",1,1847,"MUNICIPIUL BACĂU",20297,1405,729,679,50,0,712,17,1500,771,279,433
4,"BACĂU","#N/A",20297,,35,"BACĂU / Şcoala Ion Creangă",1,1847,"MUNICIPIUL BACĂU",20297,1474,766,719,46,1,749,17,1600,834,259,490
4,"BACĂU","#N/A",20297,,36,"BACĂU / Şcoala Ion Creangă",1,1847,"MUNICIPIUL BACĂU",20297,1256,745,700,45,0,733,12,1400,655,244,489
4,"BACĂU","#N/A",20297,,37,"BACĂU / Grup Scolar Posta si Telecomunicatii N.V. Karpen",1,1847,"MUNICIPIUL BACĂU",20297,1403,850,771,79,0,832,18,1500,650,306,526
4,"BACĂU","#N/A",20297,,38,"BACĂU / Grup Scolar Posta si Telecomunicatii N.V. Karpen",1,1847,"MUNICIPIUL BACĂU",20297,1349,733,661,72,0,717,16,1500,767,305,412
4,"BACĂU","#N/A",20297,,39,"BACĂU / Grup Scolar Posta si Telecomunicatii N.V. Karpen",1,1847,"MUNICIPIUL BACĂU",20297,2063,769,722,47,0,766,3,2199,1430,311,455
4,"BACĂU","#N/A",20297,,40,"BACĂU / Grup Şcolar Poştă şi Telecomunicaţii N.V.Karpen",1,1847,"MUNICIPIUL BACĂU",20297,1474,763,723,40,0,746,17,1600,837,280,466
4,"BACĂU","#N/A",20297,,41,"BACĂU / Scoala Dimitrie Leonida",1,1847,"MUNICIPIUL BACĂU",20297,1356,1054,703,50,301,1036,18,1500,446,607,429
4,"BACĂU","#N/A",20297,,42,"BACĂU / Şcoala Dimitrie Leonida nr.6",1,1847,"MUNICIPIUL BACĂU",20297,1243,985,641,43,301,965,20,1389,404,604,361
4,"BACĂU","#N/A",20297,,43,"BACĂU / Grup Scolar ''Mihai Eminescu""",1,1847,"MUNICIPIUL BACĂU",20297,1153,758,644,114,0,753,5,1300,542,340,413
4,"BACĂU","#N/A",20297,,44,"BACĂU / Grup Şcolar Mihai Eminescu",1,1847,"MUNICIPIUL BACĂU",20297,1527,704,646,57,1,693,11,1700,996,330,363
4,"BACĂU","#N/A",20297,,45,"BACĂU / Scoala Alexandru cel Bun",1,1847,"MUNICIPIUL BACĂU",20297,1377,852,797,52,3,842,10,1500,648,343,499
4,"BACĂU","#N/A",20297,,46,"BACĂU / Grădiniţa cu progr.prelungit nr.12",1,1847,"MUNICIPIUL BACĂU",20297,1104,674,620,54,0,660,14,1200,526,346,314
4,"BACĂU","#N/A",20297,,47,"BACĂU / Colegiul National Vasile Alecsandri",1,1847,"MUNICIPIUL BACĂU",20297,926,605,547,57,1,594,11,1000,395,259,335
4,"BACĂU","#N/A",20297,,48,"BACĂU / Colegiul Naţional Vasile Alecsandri",1,1847,"MUNICIPIUL BACĂU",20297,906,590,538,51,1,579,11,1000,410,243,336
4,"BACĂU","#N/A",20297,,49,"BACĂU / Şcoala de Arte George Apostu",1,1847,"MUNICIPIUL BACĂU",20297,846,608,532,71,5,597,11,900,292,257,340
4,"BACĂU","#N/A",20297,,50,"BACĂU / Colegiul Pedagogic Ştefan cel Mare",1,1847,"MUNICIPIUL BACĂU",20297,1449,1048,755,106,187,1023,25,1600,552,429,594
4,"BACĂU","#N/A",20297,,51,"BACĂU / Colegiul Pedagogic Ştefan cel Mare",1,1847,"MUNICIPIUL BACĂU",20297,1546,983,778,116,89,964,19,1700,717,423,541
4,"BACĂU","#N/A",20297,,52,"BACĂU / Şcoala George Bacovia",1,1847,"MUNICIPIUL BACĂU",20297,1353,773,712,61,0,759,14,1500,727,291,468
4,"BACĂU","#N/A",20297,,53,"BACĂU / Şcoala George Bacovia",1,1847,"MUNICIPIUL BACĂU",20297,1352,736,701,34,1,721,15,1500,764,306,415
4,"BACĂU","#N/A",20297,,54,"BACĂU / Grădiniţa cu progr.prelungit nr.28",1,1847,"MUNICIPIUL BACĂU",20297,1150,733,688,44,1,717,16,1300,567,324,393
4,"BACĂU","#N/A",20297,,55,"BACĂU / Grădiniţa cu progr.prelungit nr.28",1,1847,"MUNICIPIUL BACĂU",20297,1297,645,595,50,0,632,13,1398,753,293,339
4,"BACĂU","#N/A",20297,,56,"BACĂU / Grădiniţa cu progr.prelungit nr.28",1,1847,"MUNICIPIUL BACĂU",20297,1289,649,616,33,0,639,10,1400,751,252,387
4,"BACĂU","#N/A",20297,,57,"BACĂU / Şcoala Domniţa Maria",1,1847,"MUNICIPIUL BACĂU",20297,1452,845,778,67,0,835,10,1600,755,376,459
4,"BACĂU","#N/A",20297,,58,"BACĂU / Şcoala Domniţa Maria",1,1847,"MUNICIPIUL BACĂU",20297,1331,742,694,48,0,726,16,1500,758,271,455
4,"BACĂU","#N/A",20297,,59,"BACĂU / Şcoala Domniţa Maria",1,1847,"MUNICIPIUL BACĂU",20297,1500,811,764,47,0,803,8,1700,889,351,452
4,"BACĂU","#N/A",20297,,60,"BACĂU / Scoala Domnita Maria",1,1847,"MUNICIPIUL BACĂU",20297,1407,742,685,57,0,732,10,1500,758,319,413
4,"BACĂU","#N/A",20297,,61,"BACĂU / Scoala Domnita Maria",1,1847,"MUNICIPIUL BACĂU",20297,1478,914,870,44,0,901,13,1600,686,375,526
4,"BACĂU","#N/A",20297,,62,"BACĂU / Şcoala nr.15",1,1847,"MUNICIPIUL BACĂU",20297,1399,668,591,77,0,654,14,1500,832,286,368
4,"BACĂU","#N/A",20297,,63,"BACĂU / Scoala Nr.15",1,1847,"MUNICIPIUL BACĂU",20297,1464,775,733,41,1,765,10,1600,825,332,433
4,"BACĂU","#N/A",20297,,64,"BACĂU / Gradinita cu Program Prelungit nr.24",1,1847,"MUNICIPIUL BACĂU",20297,1986,911,853,58,0,891,20,2198,1287,425,466
4,"BACĂU","#N/A",20297,,65,"BACĂU / Colegiul ""Grigore Antipa""",1,1847,"MUNICIPIUL BACĂU",20297,1462,775,707,68,0,759,16,1599,824,321,438
4,"BACĂU","#N/A",20297,,66,"BACĂU / Grup Scolar Industrial ""Letea""",1,1847,"MUNICIPIUL BACĂU",20297,1672,837,811,25,1,823,14,1798,961,348,475
4,"BACĂU","#N/A",20297,,67,"BACĂU / Şcoala nr.10",1,1847,"MUNICIPIUL BACĂU",20297,1444,844,806,38,0,836,8,1600,756,429,407
4,"BACĂU","#N/A",20297,,68,"BACĂU / Colegiul ,,Grigore Antipa"" Bacau",1,1847,"MUNICIPIUL BACĂU",20297,1474,765,708,55,2,746,19,1600,835,308,438
4,"BACĂU","#N/A",20297,,69,"BACĂU / Grup Şcolar Ind.Constr.de Maşini Dumitru Mangeron",1,1847,"MUNICIPIUL BACĂU",20297,1180,663,559,103,1,655,8,1300,637,253,402
4,"BACĂU","#N/A",20297,,70,"BACĂU / Grup Scolar Ind.Constr.de Masini Dumitru mangeron",1,1847,"MUNICIPIUL BACĂU",20297,1252,666,637,29,0,650,16,1400,734,230,420
4,"BACĂU","#N/A",20297,,71,"BACĂU / Şcoala din cartier Izvoare",1,1847,"MUNICIPIUL BACĂU",20297,1031,471,442,28,1,467,4,1100,629,229,238
4,"BACĂU","#N/A",20297,,72,"BACĂU / Şcoala din cartier Izvoare",1,1847,"MUNICIPIUL BACĂU",20297,989,440,423,17,0,432,8,1100,660,195,237
4,"BACĂU","#N/A",20297,,73,"BACĂU / Scoala nr.1 ''Octavian Voicu""",1,1847,"MUNICIPIUL BACĂU",20297,1167,568,519,49,0,560,8,1300,732,224,336
4,"BACĂU","#N/A",20297,,74,"BACĂU / Şcoala nr.1 Octavian Voicu",1,1847,"MUNICIPIUL BACĂU",20297,1091,549,513,36,0,534,15,1200,651,205,329
4,"BACĂU","#N/A",20297,,75,"BACĂU / Şcoala nr.1 Octavian Voicu",1,1847,"MUNICIPIUL BACĂU",20297,1288,638,610,28,0,626,12,1400,762,244,382
4,"BACĂU","#N/A",20297,,76,"BACĂU / Şcoala nr.1 Octavian Voicu",1,1847,"MUNICIPIUL BACĂU",20297,1276,625,597,28,0,621,4,1400,775,241,380
4,"BACĂU","#N/A",20297,,77,"BACĂU / Grădiniţa cu progr.prelungit nr.32",1,1847,"MUNICIPIUL BACĂU",20297,1279,602,566,35,1,597,5,1400,798,252,345
4,"BACĂU","#N/A",20297,,78,"BACĂU / Grădiniţa cu progr.prelungit nr.32",1,1847,"MUNICIPIUL BACĂU",20297,1191,548,524,24,0,535,13,1300,752,246,289
4,"BACĂU","#N/A",20297,,79,"BACĂU / Grădiniţa cu progr.prelungit nr.31",1,1847,"MUNICIPIUL BACĂU",20297,1119,574,535,39,0,564,10,1200,626,256,308
4,"BACĂU","#N/A",20297,,80,"BACĂU / Şcoala 21 Nicolae Iorga",1,1847,"MUNICIPIUL BACĂU",20297,1350,666,616,50,0,650,16,1500,834,302,348
4,"BACĂU","#N/A",20297,,81,"BACĂU / Şcoala 21 Nicolae Iorga",1,1847,"MUNICIPIUL BACĂU",20297,1251,612,558,54,0,600,12,1400,788,258,342
4,"BACĂU","#N/A",20297,,82,"BACĂU / Scoala nr.21 Nicolae Iorga",1,1847,"MUNICIPIUL BACĂU",20297,1470,753,728,24,1,741,12,1600,847,331,410
4,"BACĂU","#N/A",20297,,83,"BACĂU / Scoala 21 Nicolae Iorga",1,1847,"MUNICIPIUL BACĂU",20297,1570,773,750,23,0,759,14,1700,927,328,431
4,"BACĂU","#N/A",20297,,84,"BACĂU / Grupul Şcolar Ind. Letea",1,1847,"MUNICIPIUL BACĂU",20297,1669,889,842,44,3,862,27,1800,911,351,511
4,"BACĂU","#N/A",20297,,85,"BACĂU / Grupul Şcolar Ind. Letea",1,1847,"MUNICIPIUL BACĂU",20297,1771,837,800,37,0,817,20,1898,1061,327,490
4,"BACĂU","#N/A",20297,,86,"BACĂU / Şcoala nr.10",1,1847,"MUNICIPIUL BACĂU",20297,1299,809,754,54,1,800,9,1400,591,371,429
4,"BACĂU","#N/A",20297,,87,"BACĂU / Şcoala nr.10",1,1847,"MUNICIPIUL BACĂU",20297,825,539,504,34,1,530,9,898,359,219,311
4,"BACĂU","#N/A",20297,,88,"BACĂU / Grădiniţa cu program prelungit nr.21 (Corpul I)",1,1847,"MUNICIPIUL BACĂU",20297,910,583,529,54,0,569,14,1000,417,251,318
4,"BACĂU","#N/A",20297,,89,"BACĂU / Universitatea Vasile Alecsandri",1,1847,"MUNICIPIUL BACĂU",20297,1026,706,564,142,0,691,15,1200,494,250,441
4,"BACĂU","#N/A",20297,,90,"BACĂU / Universitatea Bacău",1,1847,"MUNICIPIUL BACĂU",20297,931,563,476,86,1,554,9,1100,537,231,323
4,"BACĂU","#N/A",20297,,91,"BACĂU / Grădniţa cu progr.prelungit nr.30",1,1847,"MUNICIPIUL BACĂU",20297,1168,610,571,38,1,595,15,1300,690,288,307
4,"BACĂU","#N/A",20297,,92,"BACĂU / Grădniţa cu progr.prelungit nr.30",1,1847,"MUNICIPIUL BACĂU",20297,1027,567,531,36,0,564,3,1100,533,283,281
4,"BACĂU","#N/A",20297,,93,"BACĂU / Şcoala Ion Luca",1,1847,"MUNICIPIUL BACĂU",20297,983,521,471,50,0,512,9,1100,579,222,290
4,"BACĂU","#N/A",20297,,94,"BACĂU / Şcoala Ion Luca",1,1847,"MUNICIPIUL BACĂU",20297,1434,763,733,30,0,755,8,1600,837,324,431
4,"BACĂU","#N/A",20297,,95,"BACĂU / Şcoala Ion Luca",1,1847,"MUNICIPIUL BACĂU",20297,1385,674,628,46,0,661,13,1500,826,294,367
4,"BACĂU","#N/A",20297,,96,"BACĂU / Scoala Ion Luca",1,1847,"MUNICIPIUL BACĂU",20297,1193,589,557,31,1,583,6,1300,711,280,303
4,"BACĂU","#N/A",20297,,97,"BACĂU / Grădiniţa cu progr.prelungit nr.27",1,1847,"MUNICIPIUL BACĂU",20297,1317,669,625,43,1,657,12,1400,731,316,341
4,"BACĂU","#N/A",20297,,98,"BACĂU / Grădiniţa cu progr.prelungit nr.27",1,1847,"MUNICIPIUL BACĂU",20297,1418,718,668,50,0,707,11,1600,882,284,423
4,"BACĂU","#N/A",20297,,99,"BACĂU / Şcoala Alecu Russo",1,1847,"MUNICIPIUL BACĂU",20297,1457,770,721,49,0,761,9,1600,830,369,392
4,"BACĂU","#N/A",20297,,100,"BACĂU / Şcoala Alecu Russo",1,1847,"MUNICIPIUL BACĂU",20297,1474,719,681,37,1,708,11,1600,881,330,378
4,"BACĂU","#N/A",20297,,101,"BACĂU / Şcoala Alecu Russo",1,1847,"MUNICIPIUL BACĂU",20297,1386,667,633,34,0,656,11,1500,833,280,376
4,"BACĂU","#N/A",20297,,102,"BACĂU / Bazinul de înot acoperit",1,1847,"MUNICIPIUL BACĂU",20297,1268,639,589,50,0,627,12,1400,761,271,356
4,"BACĂU","#N/A",20297,,103,"BACĂU / Bazinul de înot acoperit",1,1847,"MUNICIPIUL BACĂU",20297,1766,546,503,43,0,531,15,1900,1354,276,255
4,"BACĂU","#N/A",20297,,104,"BACĂU / Universitatea George Bacovia",1,1847,"MUNICIPIUL BACĂU",20297,1753,942,888,54,0,928,14,1900,958,395,533
4,"BACĂU","#N/A",20297,,105,"BACĂU / Căminutl pt.Persoane vârstnice",1,1847,"MUNICIPIUL BACĂU",20297,1448,923,790,133,0,907,16,1600,677,437,470
4,"BACĂU","#N/A",20297,,106,"BACĂU / Şcoala Miron Costin",1,1847,"MUNICIPIUL BACĂU",20297,1332,624,587,37,0,614,10,1500,876,273,341
4,"BACĂU","#N/A",20297,,107,"BACĂU / Şcoala Miron Costin",1,1847,"MUNICIPIUL BACĂU",20297,1470,796,771,24,1,789,7,1600,804,294,495
4,"BACĂU","#N/A",20297,,108,"BACĂU / Şcoala Miron Costin",1,1847,"MUNICIPIUL BACĂU",20297,1394,831,792,38,1,815,16,1500,669,396,419
4,"BACĂU","#N/A",20297,,109,"BACĂU / Grădiniţa cu progr.prelungit nr.23",1,1847,"MUNICIPIUL BACĂU",20297,1215,601,566,35,0,584,17,1300,699,255,329
4,"BACĂU","#N/A",20297,,110,"BACĂU / Grădiniţa cu progr.prelungit nr.23",1,1847,"MUNICIPIUL BACĂU",20297,1320,707,648,59,0,696,11,1400,693,321,375
4,"BACĂU","#N/A",20297,,111,"BACĂU / Grădiniţa cu progr.prelungit nr.33",1,1847,"MUNICIPIUL BACĂU",20297,1386,797,724,73,0,775,22,1500,703,294,481
4,"BACĂU","#N/A",20297,,112,"BACĂU / Liceul cu program sportiv",1,1847,"MUNICIPIUL BACĂU",20297,1165,747,647,99,1,740,7,1300,553,307,433
4,"BACĂU","#N/A",20297,,113,"BACĂU / Liceul cu program sportiv",1,1847,"MUNICIPIUL BACĂU",20297,1355,797,703,93,1,780,17,1500,703,269,511
4,"BACĂU","#N/A",20297,,114,"BACĂU / Liceul cu program sportiv",1,1847,"MUNICIPIUL BACĂU",20297,1227,759,680,79,0,750,9,1300,541,278,472
4,"BACĂU","#N/A",20297,,115,"BACĂU / Şcoala nr.2",1,1847,"MUNICIPIUL BACĂU",20297,1553,912,831,80,1,894,18,1700,788,338,556
4,"BACĂU","#N/A",20297,,116,"BACĂU / Şcoala nr.2",1,1847,"MUNICIPIUL BACĂU",20297,1411,933,868,64,1,918,15,1600,667,396,522
4,"BACĂU","#N/A",20297,,117,"BACĂU / Scoala Generala nr.2",1,1847,"MUNICIPIUL BACĂU",20297,1389,836,764,72,0,825,11,1500,664,315,510
4,"BACĂU","#N/A",20297,,118,"BACĂU / Colegiul Economic Ion Ghica",1,1847,"MUNICIPIUL BACĂU",20297,905,684,533,150,1,670,14,1000,316,248,422
4,"BACĂU","#N/A",20297,,119,"BACĂU / Colegiul Economic Ion Ghica",1,1847,"MUNICIPIUL BACĂU",20297,1142,549,467,82,0,545,4,1300,751,237,308
4,"BACĂU","#N/A",20297,,120,"BACĂU / Scoala de Arte si Meserii",1,1847,"MUNICIPIUL BACĂU",20297,1487,827,776,51,0,803,24,1600,773,340,463
4,"BACĂU","#N/A",20297,,121,"BACĂU / Scoala de Arte si Meserii",1,1847,"MUNICIPIUL BACĂU",20297,1285,714,664,50,0,703,11,1399,685,323,380
4,"BACĂU","#N/A",20297,,122,"BACĂU / Şcoala Nicu Enea",1,1847,"MUNICIPIUL BACĂU",20297,1204,657,609,48,0,649,8,1298,641,259,390
4,"BACĂU","#N/A",20297,,123,"BACĂU / Scoala Nicu Enea",1,1847,"MUNICIPIUL BACĂU",20297,1223,701,658,43,0,688,13,1290,589,288,400
4,"BACĂU","#N/A",20297,,124,"BACĂU / Scoala Nicu Enea",1,1847,"MUNICIPIUL BACĂU",20297,1272,724,691,33,0,712,12,1402,678,280,432
4,"BACĂU","#N/A",20876,,125,"MOINEŞTI / Liceul Spiru Haret",1,1849,"MUNICIPIUL MOINEŞTI",20876,994,563,530,29,4,549,14,1100,537,315,234
4,"BACĂU","#N/A",20876,,126,"MOINEŞTI / Liceul Spiru Haret",1,1849,"MUNICIPIUL MOINEŞTI",20876,1114,621,568,53,0,620,1,1200,579,325,295
4,"BACĂU","#N/A",20876,,127,"MOINEŞTI / Sala de sport a Liceului Spiru Haret",1,1849,"MUNICIPIUL MOINEŞTI",20876,1343,918,681,52,185,910,8,1500,582,444,466
4,"BACĂU","#N/A",20876,,128,"MOINEŞTI / Şcoala Ştefan Luchian",1,1849,"MUNICIPIUL MOINEŞTI",20876,1260,668,659,9,0,659,9,1400,732,331,328
4,"BACĂU","#N/A",20876,,129,"MOINEŞTI / Şcoala Ştefan Luchian",1,1849,"MUNICIPIUL MOINEŞTI",20876,334,218,178,40,0,214,4,398,180,102,112
4,"BACĂU","#N/A",20876,,130,"MOINEŞTI / Biblioteca Municipala",1,1849,"MUNICIPIUL MOINEŞTI",20876,1347,779,737,42,0,769,10,1500,721,356,413
4,"BACĂU","#N/A",20876,,131,"MOINEŞTI / Şcoala George Enescu",1,1849,"MUNICIPIUL MOINEŞTI",20876,1587,852,803,49,0,828,24,1792,940,477,351
4,"BACĂU","#N/A",20876,,132,"MOINEŞTI / Şcoala George Enescu",1,1849,"MUNICIPIUL MOINEŞTI",20876,1312,655,611,44,0,643,12,1500,845,383,260
4,"BACĂU","#N/A",20876,,133,"MOINEŞTI / Şcoala George Enescu",1,1849,"MUNICIPIUL MOINEŞTI",20876,1248,705,668,37,0,697,8,1400,695,338,359
4,"BACĂU","#N/A",20876,,134,"MOINEŞTI / Clubul Elevilor",1,1849,"MUNICIPIUL MOINEŞTI",20876,1383,765,734,31,0,750,15,1500,735,465,285
4,"BACĂU","#N/A",20876,,135,"MOINEŞTI / Şcoala Tristan Tzara",1,1849,"MUNICIPIUL MOINEŞTI",20876,1290,722,703,19,0,710,12,1400,678,386,324
4,"BACĂU","#N/A",20876,,136,"MOINEŞTI / Şcoala Tristan Tzara",1,1849,"MUNICIPIUL MOINEŞTI",20876,1375,714,691,21,2,705,9,1500,786,371,334
4,"BACĂU","#N/A",20876,,137,"MOINEŞTI / Clădire Grădiniţa Micleasca",1,1849,"MUNICIPIUL MOINEŞTI",20876,828,498,467,31,0,494,4,900,402,271,223
4,"BACĂU","#N/A",20876,,138,"MOINEŞTI / Clădire Şcoala Lunca",1,1849,"MUNICIPIUL MOINEŞTI",20876,1166,612,583,27,2,604,8,1300,688,322,282
4,"BACĂU","#N/A",20876,,139,"MOINEŞTI / Şcoala Alexandru Sever",1,1849,"MUNICIPIUL MOINEŞTI",20876,678,429,414,14,1,419,10,701,272,281,138
4,"BACĂU","#N/A",20876,,140,"MOINEŞTI / Şcoala Alexandru Sever",1,1849,"MUNICIPIUL MOINEŞTI",20876,1057,637,600,22,15,626,11,1200,563,442,184
4,"BACĂU","#N/A",20876,,141,"MOINEŞTI / Şcoala Alexandru Sever Hangani",1,1849,"MUNICIPIUL MOINEŞTI",20876,1147,657,630,21,6,640,17,1300,643,437,203
4,"BACĂU","#N/A",20876,,142,"MOINEŞTI / Clădire Şcoala Găzărie",1,1849,"MUNICIPIUL MOINEŞTI",20876,1043,586,555,31,0,577,9,1100,514,300,277
4,"BACĂU","#N/A",20563,,143,"ONEŞTI / Colegiul Naţional ""Grigore C.Moisil""",1,1852,"MUNICIPIUL ONEŞTI",20563,1462,796,747,46,3,777,19,1600,804,437,340
4,"BACĂU","#N/A",20563,,144,"ONEŞTI / Colegiul Naţional ""Grigore C.Moisil""",1,1852,"MUNICIPIUL ONEŞTI",20563,1185,595,561,34,0,578,17,1300,705,325,253
4,"BACĂU","#N/A",20563,,145,"ONEŞTI / Colegiul Naţional ""Grigore C.Moisil""",1,1852,"MUNICIPIUL ONEŞTI",20563,1007,581,537,42,2,576,5,1100,519,379,197
4,"BACĂU","#N/A",20563,,146,"ONEŞTI / Şcoala gimnazială ""Sfântul Voievod Ştefan cel Mare"" (fosta nr.9)",1,1852,"MUNICIPIUL ONEŞTI",20563,1344,720,669,50,1,707,13,1500,780,398,309
4,"BACĂU","#N/A",20563,,147,"ONEŞTI / Şcoala gimnazială ""Sfântul Voievod Ştefan cel Mare""(fosta nr.9)",1,1852,"MUNICIPIUL ONEŞTI",20563,1390,759,732,27,0,741,18,1500,741,441,300
4,"BACĂU","#N/A",20563,,148,"ONEŞTI / Şcoala gimnazială ""Emil Racoviţă"" (fosta nr.10)",1,1852,"MUNICIPIUL ONEŞTI",20563,1270,652,614,37,1,640,12,1400,748,362,278
4,"BACĂU","#N/A",20563,,149,"ONEŞTI / Şcoala gimnazială  ""Emil Racoviţă"" (fosta nr.10)",1,1852,"MUNICIPIUL ONEŞTI",20563,1348,676,658,18,0,653,23,1500,824,384,269
4,"BACĂU","#N/A",20563,,150,"ONEŞTI / Şcoala gimnazială  ""Emil Racoviţă"" (fosta nr.10)",1,1852,"MUNICIPIUL ONEŞTI",20563,1073,528,490,37,1,512,16,1200,672,296,216
4,"BACĂU","#N/A",20563,,151,"ONEŞTI / Liceul Tehnologic (fosta nr.7)",1,1852,"MUNICIPIUL ONEŞTI",20563,1325,565,519,46,0,555,10,1498,933,276,279
4,"BACĂU","#N/A",20563,,152,"ONEŞTI / Liceul Tehnologic (fosta nr.7)",1,1852,"MUNICIPIUL ONEŞTI",20563,1271,564,545,19,0,553,11,1401,837,278,275
4,"BACĂU","#N/A",20563,,153,"ONEŞTI / Liceul Tehnologic (fosta nr.7)",1,1852,"MUNICIPIUL ONEŞTI",20563,1329,611,588,23,0,599,12,1500,889,322,277
4,"BACĂU","#N/A",20563,,154,"ONEŞTI / Liceul Tehnologic (fosta nr.7)",1,1852,"MUNICIPIUL ONEŞTI",20563,1293,625,606,19,0,614,11,1400,775,333,281
4,"BACĂU","#N/A",20563,,155,"ONEŞTI / Şcoala gimnazială ""Ghiţă Mocanu"" (fostă nr.5)",1,1852,"MUNICIPIUL ONEŞTI",20563,1288,677,650,27,0,669,8,1400,723,369,300
4,"BACĂU","#N/A",20563,,156,"ONEŞTI / Şcoala gimnazială ""Ghiţă Mocanu"" (fostă nr.7)",1,1852,"MUNICIPIUL ONEŞTI",20563,851,479,443,36,0,468,11,900,421,212,256
4,"BACĂU","#N/A",20563,,157,"ONEŞTI / Şcoala gimnazială ""Ghiţă Mocanu"" (fostă nr.5)",1,1852,"MUNICIPIUL ONEŞTI",20563,1540,883,842,40,1,872,11,1700,817,497,375
4,"BACĂU","#N/A",20563,,158,"ONEŞTI / Şcoala gimnazială ""Ghiţă Mocanu"" (fostă nr.5)",1,1852,"MUNICIPIUL ONEŞTI",20563,1638,854,811,43,0,840,14,1804,950,509,331
4,"BACĂU","#N/A",20563,,159,"ONEŞTI / Şcoala gimnazială nr.1",1,1852,"MUNICIPIUL ONEŞTI",20563,1051,573,527,45,1,561,12,1200,627,341,220
4,"BACĂU","#N/A",20563,,160,"ONEŞTI / Şcoala gimnazială nr.1",1,1852,"MUNICIPIUL ONEŞTI",20563,1396,790,718,72,0,783,7,1500,710,357,426
4,"BACĂU","#N/A",20563,,161,"ONEŞTI / Şcoala gimnazială nr.1",1,1852,"MUNICIPIUL ONEŞTI",20563,1362,782,743,39,0,768,14,1500,718,413,355
4,"BACĂU","#N/A",20563,,162,"ONEŞTI / Colegiul Sportiv ""Nadia Comăneci""",1,1852,"MUNICIPIUL ONEŞTI",20563,1146,828,633,31,164,817,11,1300,472,500,317
4,"BACĂU","#N/A",20563,,163,"ONEŞTI / Colegiul Sportiv ""Nadia Comăneci""",1,1852,"MUNICIPIUL ONEŞTI",20563,1245,681,634,46,1,665,16,1400,719,351,314
4,"BACĂU","#N/A",20563,,164,"ONEŞTI / Colegiul Sportiv ""Nadia Comăneci""",1,1852,"MUNICIPIUL ONEŞTI",20563,1492,801,758,42,1,790,11,1700,899,437,353
4,"BACĂU","#N/A",20563,,165,"ONEŞTI / Colegiu Naţional ""Dimitrie Cantemir""",1,1852,"MUNICIPIUL ONEŞTI",20563,1248,615,576,39,0,600,15,1400,785,291,309
4,"BACĂU","#N/A",20563,,166,"ONEŞTI / Colegiu Naţional ""Dimitrie Cantemir""",1,1852,"MUNICIPIUL ONEŞTI",20563,1492,748,701,47,0,737,11,1600,852,360,377
4,"BACĂU","#N/A",20563,,167,"ONEŞTI / Colegiu Naţional ""Dimitrie Cantemir""",1,1852,"MUNICIPIUL ONEŞTI",20563,1261,540,512,27,1,530,10,1414,874,272,258
4,"BACĂU","#N/A",20563,,168,"ONEŞTI / Colegiul Tehnic ""Petru Poni""",1,1852,"MUNICIPIUL ONEŞTI",20563,1009,529,494,35,0,521,8,1200,671,292,229
4,"BACĂU","#N/A",20563,,169,"ONEŞTI / Colegiul Tehnic ""Petru Poni""",1,1852,"MUNICIPIUL ONEŞTI",20563,965,455,406,48,1,446,9,1100,645,247,199
4,"BACĂU","#N/A",20563,,170,"ONEŞTI / Şcoala gimnazială ""George Călinescu"" (fostă nr.8)",1,1852,"MUNICIPIUL ONEŞTI",20563,1523,784,741,43,0,773,11,1700,916,439,334
4,"BACĂU","#N/A",20563,,171,"ONEŞTI / Şcoala gimnazială ""George Călinescu"" (fostă nr.8)",1,1852,"MUNICIPIUL ONEŞTI",20563,1396,731,682,49,0,718,13,1499,768,374,344
4,"BACĂU","#N/A",20563,,172,"ONEŞTI / Colegiul Tehnic ""Gheorghe Asachi""",1,1852,"MUNICIPIUL ONEŞTI",20563,1360,699,646,53,0,688,11,1500,801,366,322
4,"BACĂU","#N/A",20563,,173,"ONEŞTI / Colegiul Tehnic ""Gheorghe Asachi""",1,1852,"MUNICIPIUL ONEŞTI",20563,1292,687,642,45,0,672,15,1501,814,363,309
4,"BACĂU","#N/A",20563,,174,"ONEŞTI / Liceul Tehnologic (TCR)",1,1852,"MUNICIPIUL ONEŞTI",20563,956,505,486,19,0,493,12,1000,495,288,205
4,"BACĂU","#N/A",20563,,175,"ONEŞTI / Sera Borzeşti",1,1852,"MUNICIPIUL ONEŞTI",20563,863,405,385,20,0,400,5,900,495,226,174
4,"BACĂU","#N/A",20563,,176,"SLOBOZIA / Centrul Social Slobozia",1,1852,"MUNICIPIUL ONEŞTI",20563,1045,630,599,31,0,623,7,1100,470,442,181
4,"BACĂU","#N/A",20563,,177,"ONEŞTI / Grădiniţa ""Sfântul Paul""",1,1852,"MUNICIPIUL ONEŞTI",20563,1350,695,664,30,1,688,7,1500,805,375,313
4,"BACĂU","#N/A",20563,,178,"ONEŞTI / Grădiniţa ""Sfântul Paul""",1,1852,"MUNICIPIUL ONEŞTI",20563,1314,683,654,29,0,669,14,1400,717,385,284
4,"BACĂU","#N/A",20778,,179,"BUHUŞI / Primăria oraş Buhuşi",1,1856,"ORAŞ BUHUŞI",20778,1395,701,670,31,0,683,18,1500,799,394,289
4,"BACĂU","#N/A",20778,,180,"BUHUŞI / Colegiul Tehnic Ion Borcea",1,1856,"ORAŞ BUHUŞI",20778,1439,660,633,26,1,647,13,1600,940,389,258
4,"BACĂU","#N/A",20778,,181,"BUHUŞI / Colegiul Tehnic Ion Borcea",1,1856,"ORAŞ BUHUŞI",20778,1393,622,547,33,42,614,8,1600,978,355,259
4,"BACĂU","#N/A",20778,,182,"BUHUŞI / Casa de Cultură",1,1856,"ORAŞ BUHUŞI",20778,1606,786,713,72,1,768,18,1800,1014,401,367
4,"BACĂU","#N/A",20778,,183,"BUHUŞI / Şcoala gimnazială M.Eminescu",1,1856,"ORAŞ BUHUŞI",20778,1635,780,744,36,0,756,24,1800,1020,432,324
4,"BACĂU","#N/A",20778,,184,"BUHUŞI / Biblioteca orăşenească George Bacovia",1,1856,"ORAŞ BUHUŞI",20778,1439,709,664,36,9,699,10,1600,891,419,280
4,"BACĂU","#N/A",20778,,185,"BUHUŞI / Şcoala gimnazială nr.2",1,1856,"ORAŞ BUHUŞI",20778,1409,655,643,12,0,642,13,1500,845,345,297
4,"BACĂU","#N/A",20778,,186,"BUHUŞI / Complexul de Servicii Comunitare",1,1856,"ORAŞ BUHUŞI",20778,1434,605,588,17,0,597,8,1600,995,339,258
4,"BACĂU","#N/A",20778,,187,"BUHUŞI / Şcoala gimnazială Ştefan cel Mare",1,1856,"ORAŞ BUHUŞI",20778,1248,577,519,43,15,566,11,1400,823,330,236
4,"BACĂU","#N/A",20778,,188,"BUHUŞI / Şcoala gimnazială Mihai Andrei",1,1856,"ORAŞ BUHUŞI",20778,1414,654,626,28,0,634,20,1600,946,443,191
4,"BACĂU","#N/A",20778,,189,"BUHUŞI / Sala Polivalentă Moldova",1,1856,"ORAŞ BUHUŞI",20778,1510,708,678,30,0,702,6,1700,992,326,376
4,"BACĂU","#N/A",20778,,190,"BUHUŞI / Şcoala gimnazială",1,1856,"ORAŞ BUHUŞI",20778,1335,548,537,11,0,529,19,1500,952,367,162
4,"BACĂU","#N/A",20821,,191,"COMĂNEŞTI / Clubul elevilor",1,1860,"ORAŞ COMĂNEŞTI",20821,1146,667,624,40,3,651,16,1300,633,370,281
4,"BACĂU","#N/A",20821,,192,"COMĂNEŞTI / Şcoala Ciprian Porumbescu",1,1860,"ORAŞ COMĂNEŞTI",20821,1352,724,673,51,0,711,13,1500,776,437,274
4,"BACĂU","#N/A",20821,,193,"COMĂNEŞTI / Şcoala Ciprian Porumbescu",1,1860,"ORAŞ COMĂNEŞTI",20821,1337,869,694,71,104,855,14,1500,631,516,339
4,"BACĂU","#N/A",20821,,194,"COMĂNEŞTI / SCOALA CIPRIAN PORUMBESCU",1,1860,"ORAŞ COMĂNEŞTI",20821,493,298,238,60,0,296,2,610,312,153,143
4,"BACĂU","#N/A",20821,,195,"COMĂNEŞTI / Biblioteca oraşului",1,1860,"ORAŞ COMĂNEŞTI",20821,1533,819,757,62,0,801,18,1700,881,386,415
4,"BACĂU","#N/A",20821,,196,"COMĂNEŞTI / Scoala Liviu Rebreanu",1,1860,"ORAŞ COMĂNEŞTI",20821,1691,795,769,26,0,779,16,1900,1105,378,401
4,"BACĂU","#N/A",20821,,197,"COMĂNEŞTI / Şcoala Liviu Rebreanu",1,1860,"ORAŞ COMĂNEŞTI",20821,1018,461,414,47,0,447,14,1100,639,188,259
4,"BACĂU","#N/A",20821,,198,"COMĂNEŞTI / Şcoala Liviu Rebreanu",1,1860,"ORAŞ COMĂNEŞTI",20821,662,310,295,15,0,302,8,702,392,161,141
4,"BACĂU","#N/A",20821,,199,"COMĂNEŞTI / Primăria orăşenească",1,1860,"ORAŞ COMĂNEŞTI",20821,1459,736,698,38,0,726,10,1600,864,388,338
4,"BACĂU","#N/A",20821,,200,"COMĂNEŞTI / Şcoala Şupan",1,1860,"ORAŞ COMĂNEŞTI",20821,1476,800,775,25,0,786,14,1600,800,512,274
4,"BACĂU","#N/A",20821,,201,"COMĂNEŞTI / Şcoala Lăloaia",1,1860,"ORAŞ COMĂNEŞTI",20821,1211,774,723,48,3,758,16,1300,526,518,240
4,"BACĂU","#N/A",20821,,202,"COMĂNEŞTI / Şcoala nr.5 bis Sublăloaia",1,1860,"ORAŞ COMĂNEŞTI",20821,1505,864,792,68,4,842,22,1600,736,470,372
4,"BACĂU","#N/A",20821,,203,"COMĂNEŞTI / Şcoala Costachi S.Ciocan Lăloaia",1,1860,"ORAŞ COMĂNEŞTI",20821,751,413,387,24,2,408,5,800,387,256,152
4,"BACĂU","#N/A",20821,,204,"COMĂNEŞTI / Şcoala nr.3 Leorda",1,1860,"ORAŞ COMĂNEŞTI",20821,1294,712,686,26,0,695,17,1401,689,485,210
4,"BACĂU","#N/A",20821,,205,"COMĂNEŞTI / Şcoala Dimitrie Ghica Zăvoi",1,1860,"ORAŞ COMĂNEŞTI",20821,1304,670,635,34,1,658,12,1400,730,414,244
4,"BACĂU","#N/A",20821,,206,"COMĂNEŞTI / Şcoala Vermeşti",1,1860,"ORAŞ COMĂNEŞTI",20821,1091,537,502,35,0,527,10,1205,668,285,242
4,"BACĂU","#N/A",20821,,207,"COMĂNEŞTI / Clădire Şipoteni",1,1860,"ORAŞ COMĂNEŞTI",20821,641,358,327,31,0,354,4,700,342,172,182
4,"BACĂU","#N/A",22166,,208,"DĂRMĂNEŞTI / Şcoala nr.2",1,1864,"ORAŞ DĂRMĂNEŞTI",22166,1378,841,806,27,8,829,12,1500,659,465,364
4,"BACĂU","#N/A",22166,,209,"DĂRMĂNEŞTI / Liceul  Tehnologic",1,1864,"ORAŞ DĂRMĂNEŞTI",22166,1544,902,823,65,14,884,18,1700,798,516,368
4,"BACĂU","#N/A",22166,,210,"DĂRMĂNEŞTI / CLUB SC BETACOM SRL",1,1864,"ORAŞ DĂRMĂNEŞTI",22166,771,474,432,40,2,466,8,800,326,246,220
4,"BACĂU","#N/A",22166,,211,"DĂRMĂNEŞTI / CLUB SC. BETACOM SRL",1,1864,"ORAŞ DĂRMĂNEŞTI",22166,1030,596,568,24,4,579,17,1100,504,284,295
4,"BACĂU","#N/A",22166,,212,"DĂRMĂNEŞTI / Şcoala nr.3",1,1864,"ORAŞ DĂRMĂNEŞTI",22166,752,416,389,20,7,410,6,800,384,258,152
4,"BACĂU","#N/A",22166,,213,"DĂRMĂNEŞTI / Şcoala nr.3",1,1864,"ORAŞ DĂRMĂNEŞTI",22166,953,517,496,19,2,502,15,1000,483,341,161
4,"BACĂU","#N/A",22166,,214,"LĂPOŞ / Scoala Lapoş",1,1864,"ORAŞ DĂRMĂNEŞTI",22166,828,506,468,16,22,502,4,900,394,356,146
4,"BACĂU","#N/A",22166,,215,"PLOPU / Şcoala cl.I-VIII",1,1864,"ORAŞ DĂRMĂNEŞTI",22166,1254,646,607,30,9,641,5,1400,754,459,182
4,"BACĂU","#N/A",22166,,216,"DĂRMĂNEŞTI / Grădiniţa Sălătruc",1,1864,"ORAŞ DĂRMĂNEŞTI",22166,634,419,364,40,15,416,3,697,278,241,175
4,"BACĂU","#N/A",22166,,217,"DĂRMĂNEŞTI / Şcoala cl.I-IV Păgubeni",1,1864,"ORAŞ DĂRMĂNEŞTI",22166,311,225,198,17,10,223,2,397,172,172,51
4,"BACĂU","#N/A",22166,,218,"DĂRMĂNEŞTI / Primărie",1,1864,"ORAŞ DĂRMĂNEŞTI",22166,1282,747,706,39,2,737,10,1400,653,444,293
4,"BACĂU","#N/A",22166,,219,"DĂRMĂNEŞTI / Scoala cu cls I-IV Dărmăneasca",1,1864,"ORAŞ DĂRMĂNEŞTI",22166,695,410,388,20,2,405,5,800,390,241,164
4,"BACĂU","#N/A",20910,,220,"CERDAC / SCOALA GIMNAZIALA NR. 3",1,1871,"ORAŞ SLĂNIC-MOLDOVA",20910,1107,637,590,37,10,633,4,1202,565,262,371
4,"BACĂU","#N/A",20910,,221,"SLĂNIC-MOLDOVA / SCOALA NR. 1 SLĂNIC",1,1871,"ORAŞ SLĂNIC-MOLDOVA",20910,1581,992,762,214,16,978,14,1799,807,477,501
4,"BACĂU","#N/A",20910,,222,"CIREŞOAIA / SCOALA NR. 2 CIRESOAIA",1,1871,"ORAŞ SLĂNIC-MOLDOVA",20910,1494,896,842,24,30,887,9,1600,704,410,477
4,"BACĂU","#N/A",20965,,223,"TÎRGU OCNA / Scoala generala nr. 1",1,1875,"ORAŞ TÎRGU OCNA",20965,1437,886,782,54,50,873,13,1600,714,450,423
4,"BACĂU","#N/A",20965,,224,"TÎRGU OCNA / Casa de Cultura",1,1875,"ORAŞ TÎRGU OCNA",20965,1438,1055,805,249,1,1031,24,1600,545,472,559
4,"BACĂU","#N/A",20965,,225,"TÎRGU OCNA / Colegiul National Costache Negri",1,1875,"ORAŞ TÎRGU OCNA",20965,1558,967,844,123,0,942,25,1700,733,445,497
4,"BACĂU","#N/A",20965,,226,"TÎRGU OCNA / Scoala generala nr. 2",1,1875,"ORAŞ TÎRGU OCNA",20965,1609,862,808,54,0,844,18,1800,938,404,440
4,"BACĂU","#N/A",20965,,227,"TÎRGU OCNA / Scoala generala nr. 3",1,1875,"ORAŞ TÎRGU OCNA",20965,1016,584,538,43,3,569,15,1100,516,286,283
4,"BACĂU","#N/A",20965,,228,"TÎRGU OCNA / Scoala generala nr. 4",1,1875,"ORAŞ TÎRGU OCNA",20965,1242,877,739,108,30,867,10,1400,523,464,403
4,"BACĂU","#N/A",20965,,229,"POIENI / Scoala generala nr. 5",1,1875,"ORAŞ TÎRGU OCNA",20965,797,470,432,38,0,467,3,900,430,246,221
4,"BACĂU","#N/A",20965,,230,"VÎLCELE / Scoala generala nr. 6",1,1875,"ORAŞ TÎRGU OCNA",20965,1033,584,558,26,0,573,11,1100,516,282,291
4,"BACĂU","#N/A",20965,,231,"TÎRGU OCNA / Scoala generala nr. 3-Sala de sport",1,1875,"ORAŞ TÎRGU OCNA",20965,913,529,492,34,3,524,5,1000,471,262,262
4,"BACĂU","#N/A",21007,,232,"AGĂŞ / Consiliul local Agăş",3,1879,"AGĂŞ",21007,1021,548,505,42,1,542,6,1100,552,319,223
4,"BACĂU","#N/A",21007,,233,"COTUMBA / Şcoala cl.I-IV Cotumba",3,1879,"AGĂŞ",21007,1154,599,565,34,0,587,12,1300,701,389,198
4,"BACĂU","#N/A",21007,,234,"SULŢA / Şcoala generală Sulţa",3,1879,"AGĂŞ",21007,874,446,405,41,0,440,6,1000,554,232,208
4,"BACĂU","#N/A",21007,,235,"COŞNEA / Căminul cultural Coşnea",3,1879,"AGĂŞ",21007,383,235,201,34,0,232,3,400,165,92,140
4,"BACĂU","#N/A",21007,,236,"PRELUCI / Şcoala generală Preluci",3,1879,"AGĂŞ",21007,986,490,466,24,0,486,4,1100,610,322,164
4,"BACĂU","#N/A",21007,,237,"GOIOASA / Şcoala generală Goioasa",3,1879,"AGĂŞ",21007,744,348,327,21,0,344,4,800,452,204,140
4,"BACĂU","#N/A",21098,,238,"ARDEOANI / Şcoala nr.1 Ardeoani",3,1888,"ARDEOANI",21098,1322,806,659,138,9,795,11,1410,604,557,238
4,"BACĂU","#N/A",21098,,239,"LEONTINEŞTI / Şcoala Leontineşti",3,1888,"ARDEOANI",21098,699,438,391,45,2,431,7,800,362,303,128
4,"BACĂU","#N/A",21123,,240,"ASĂU / Şcoala gen.cu cl.I-VIII Asău",3,1891,"ASĂU",21123,905,499,472,27,0,497,2,1000,501,321,176
4,"BACĂU","#N/A",21123,,241,"ASĂU / Şcoala gen.cu cl.I-VIII Asău",3,1891,"ASĂU",21123,935,520,485,35,0,509,11,1000,480,325,184
4,"BACĂU","#N/A",21123,,242,"LUNCA ASĂU / Şcoala cu cl.I-IV Lunca Asău",3,1891,"ASĂU",21123,671,392,369,23,0,388,4,700,308,279,109
4,"BACĂU","#N/A",21123,,243,"STRAJA / Şcoala cu cl.I-IV Straja",3,1891,"ASĂU",21123,1031,489,462,27,0,482,7,1100,611,322,160
4,"BACĂU","#N/A",21123,,244,"CIOBĂNUŞ / Şcoala cu cl.I-IV Ciobănuş",3,1891,"ASĂU",21123,465,247,221,26,0,246,1,500,253,158,88
4,"BACĂU","#N/A",21123,,245,"APA ASĂU / Şcoala gen.cu cl.I-VIII Apa-Asău",3,1891,"ASĂU",21123,658,351,337,14,0,346,5,700,349,218,128
4,"BACĂU","#N/A",21123,,246,"APA ASĂU / Şcoala gen.cu cl.I-VIII Apa-Asău",3,1891,"ASĂU",21123,604,330,312,18,0,321,8,700,370,223,98
4,"BACĂU","#N/A",21123,,247,"PĂLTINIŞ / Şcoala cu cl.I-IV Păltiniş",3,1891,"ASĂU",21123,547,314,292,22,0,310,4,587,273,196,114
4,"BACĂU","#N/A",21196,,248,"BALCANI / Primăria Balcani",3,1898,"BALCANI",21196,1183,641,594,21,26,633,8,1292,651,416,217
4,"BACĂU","#N/A",21196,,249,"FRUMOASA / Grădiniţa Frumoasa",3,1898,"BALCANI",21196,1035,461,427,24,10,456,5,1100,639,234,222
4,"BACĂU","#N/A",21196,,250,"FRUMOASA / Grădiniţa Frumoasa",3,1898,"BALCANI",21196,1431,659,611,25,23,653,6,1600,941,378,275
4,"BACĂU","#N/A",21196,,251,"FRUMOASA / Grădiniţa Frumoasa",3,1898,"BALCANI",21196,528,245,225,12,8,243,2,600,355,169,74
4,"BACĂU","#N/A",21196,,252,"SCHITU FRUMOASA / Gradinita nr.2 Schitu-Frumoasa",3,1898,"BALCANI",21196,651,370,321,27,22,368,2,699,329,273,95
4,"BACĂU","#N/A",21196,,253,"SCHITU FRUMOASA / Şcoala Gimnaziala  Schitu-Frumoasa",3,1898,"BALCANI",21196,962,551,479,36,36,544,7,1103,552,411,133
4,"BACĂU","#N/A",21196,,254,"LUDAŞI / Şcoala Gimnaziala  Ludaşi",3,1898,"BALCANI",21196,810,422,366,16,40,418,4,900,478,282,136
4,"BACĂU","#N/A",21249,,255,"BEREŞTI-BISTRIŢA / Căminul Cultural Bereşti-Bistriţa",3,1903,"BEREŞTI-BISTRIŢA",21249,944,609,527,80,2,601,8,1000,391,387,214
4,"BACĂU","#N/A",21249,,256,"PĂDURENI / Scoala cu cl.I-IV Pădureni",3,1903,"BEREŞTI-BISTRIŢA",21249,372,227,194,33,0,225,2,405,178,167,58
4,"BACĂU","#N/A",21249,,257,"CLIMEŞTI / Şcoala cu cl.I-IV Climeşti",3,1903,"BEREŞTI-BISTRIŢA",21249,262,196,151,44,1,192,4,309,113,144,48
4,"BACĂU","#N/A",21249,,258,"BRAD / Şcoala cu cl.I-IV Brad",3,1903,"BEREŞTI-BISTRIŢA",21249,141,122,85,37,0,121,1,200,78,77,44
4,"BACĂU","#N/A",21338,,259,"BEREŞTI-TAZLĂU / Şcoala cu cl.I-VIII Bereşti-Tazlău",3,1908,"BEREŞTI-TAZLĂU",21338,1001,594,520,37,37,587,7,1100,506,485,102
4,"BACĂU","#N/A",21338,,260,"BOŞOTENI / Şcoala generală Boşoteni",3,1908,"BEREŞTI-TAZLĂU",21338,357,283,239,26,18,279,4,400,117,217,62
4,"BACĂU","#N/A",21338,,261,"ENĂCHEŞTI / Şcoala generală Enăcheşti",3,1908,"BEREŞTI-TAZLĂU",21338,658,406,364,22,20,399,7,700,294,300,99
4,"BACĂU","#N/A",21338,,262,"PRISACA / Şcoala generală Prisaca",3,1908,"BEREŞTI-TAZLĂU",21338,426,273,243,16,14,271,2,500,227,206,65
4,"BACĂU","#N/A",21338,,263,"ROMÂNEŞTI / Şcoala generală Româneşti",3,1908,"BEREŞTI-TAZLĂU",21338,367,280,240,27,13,277,3,400,120,237,40
4,"BACĂU","#N/A",21338,,264,"TESCANI / Şcoala generală Tescani",3,1908,"BEREŞTI-TAZLĂU",21338,621,438,384,33,21,429,9,700,262,328,101
4,"BACĂU","#N/A",21338,,265,"TURLUIANU / Şcoala generală Turluianu",3,1908,"BEREŞTI-TAZLĂU",21338,1010,521,488,14,19,518,3,1100,579,408,110
4,"BACĂU","#N/A",21418,,266,"BERZUNŢI / Şcoala cl.I-VIII Alexandru cel Bun Berzunţi",3,1916,"BERZUNŢI",21418,1445,754,729,25,0,746,8,1600,846,531,215
4,"BACĂU","#N/A",21418,,267,"BERZUNŢI / Şcoala cu clasele I-IV nr. 2 Berzunţi",3,1916,"BERZUNŢI",21418,689,379,354,23,2,376,3,800,421,244,132
4,"BACĂU","#N/A",21418,,268,"DRAGOMIR / Scoala cu clasele I-IV nr. 1 Dragomir",3,1916,"BERZUNŢI",21418,976,484,464,20,0,483,1,1100,616,320,163
4,"BACĂU","#N/A",21418,,269,"DRAGOMIR / Şcoala cl.I-VIII nr.2 Dragomir",3,1916,"BERZUNŢI",21418,663,290,278,12,0,285,5,700,410,272,13
4,"BACĂU","#N/A",21418,,270,"BUDA / Scoala cu clasele I-IV Buda",3,1916,"BERZUNŢI",21418,436,277,226,51,0,272,5,500,223,215,57
4,"BACĂU","#N/A",21454,,271,"BÎRSĂNEŞTI / Primăria Bîrsăneşti",3,1920,"BÎRSĂNEŞTI",21454,1482,802,745,57,0,793,9,1600,798,490,303
4,"BACĂU","#N/A",21454,,272,"ALBELE / Şcoala gimnazială Albele",3,1920,"BÎRSĂNEŞTI",21454,542,292,263,29,0,291,1,600,308,162,129
4,"BACĂU","#N/A",21454,,273,"BRĂTEŞTI / Şcoala gimnazială Brăteşti",3,1920,"BÎRSĂNEŞTI",21454,969,542,508,34,0,538,4,1100,558,295,243
4,"BACĂU","#N/A",21454,,274,"CARACLĂU / Şcoala gimnazială Caraclău",3,1920,"BÎRSĂNEŞTI",21454,964,586,550,36,0,579,7,1100,514,387,192
4,"BACĂU","#N/A",21506,,275,"BLĂGEŞTI / Şcoala cl.I-VIII nr.1 Blăgeşti",3,1925,"BLĂGEŞTI",21506,960,460,440,20,0,455,5,1100,640,288,167
4,"BACĂU","#N/A",21506,,276,"BLĂGEŞTI / Şcoala cl.I-VIII nr.1 Blăgeşti",3,1925,"BLĂGEŞTI",21506,944,431,407,24,0,428,3,1000,569,267,161
4,"BACĂU","#N/A",21506,,277,"BUDA / Şcoala cl.I-VIII nr.1 Buda",3,1925,"BLĂGEŞTI",21506,1601,729,683,46,0,718,11,1800,1071,473,245
4,"BACĂU","#N/A",21506,,278,"VALEA LUI ION / Şcoala cl.I-VIII nr.1 Valea lui Ion",3,1925,"BLĂGEŞTI",21506,1138,570,527,43,0,560,10,1200,630,372,188
4,"BACĂU","#N/A",21506,,279,"ŢÎRDENII MARI / Şcoala cl.I-VIII nr.1 Ţîrdenii Mari",3,1925,"BLĂGEŞTI",21506,589,341,313,28,0,334,7,600,259,202,132
4,"BACĂU","#N/A",21506,,280,"POIANA NEGUSTORULUI / Şcoala cl.I-VIII nr.1 Poiana Negustorului",3,1925,"BLĂGEŞTI",21506,478,320,304,16,0,298,22,500,180,248,50
4,"BACĂU","#N/A",21560,,281,"BOGDĂNEŞTI / Şcoala Gimnazială Bogdăneşti",3,1931,"BOGDĂNEŞTI",21560,934,520,461,59,0,515,5,1000,480,319,196
4,"BACĂU","#N/A",21560,,282,"BOGDĂNEŞTI / Şcoala Gimnazială Bogdăneşti",3,1931,"BOGDĂNEŞTI",21560,895,467,454,13,0,461,6,1000,533,297,164
4,"BACĂU","#N/A",21560,,283,"FILIPEŞTI / Grădiniţa Filipeşti",3,1931,"BOGDĂNEŞTI",21560,520,337,292,44,1,334,3,600,263,198,136
4,"BACĂU","#N/A",21597,,284,"BRUSTUROASA / Primăria Brusturoasa",3,1934,"BRUSTUROASA",21597,1313,724,689,35,0,709,15,1500,776,452,257
4,"BACĂU","#N/A",21597,,285,"CAMENCA / Şcoala primară Camenca",3,1934,"BRUSTUROASA",21597,778,486,457,29,0,474,12,900,414,290,184
4,"BACĂU","#N/A",21597,,286,"BRUSTUROASA / Şcoala primară Cuchiniş",3,1934,"BRUSTUROASA",21597,649,388,371,17,0,382,6,700,312,268,114
4,"BACĂU","#N/A",26338,,287,"BUCIUMI / Şcoala gimnazială Buciumi",3,1941,"BUCIUMI",26338,1222,843,733,72,38,839,4,1299,456,587,252
4,"BACĂU","#N/A",26338,,288,"RĂCĂUŢI / Şcoala gimnazială Răcăuţi",3,1941,"BUCIUMI",26338,1193,773,708,50,15,754,19,1300,527,593,161
4,"BACĂU","#N/A",21668,,289,"BUHOCI / Şcoala cu cl.I-VIII Buhoci",3,1944,"BUHOCI",21668,1366,769,646,123,0,757,12,1500,731,309,448
4,"BACĂU","#N/A",21668,,290,"BIJGHIR / Scoala cu clasele I-VIII Bijghir",3,1944,"BUHOCI",21668,1071,494,467,27,0,482,12,1200,706,133,349
4,"BACĂU","#N/A",21668,,291,"BIJGHIR / Scoala cu clasele I-VIII Bijghir",3,1944,"BUHOCI",21668,903,376,359,17,0,370,6,1000,624,103,267
4,"BACĂU","#N/A",21668,,292,"COTENI / Şcoala cu cl.I-IV Coteni",3,1944,"BUHOCI",21668,616,349,320,29,0,344,5,700,351,156,188
4,"BACĂU","#N/A",21720,,293,"CAŞIN / Şcoala gimnazială N.Pâslaru Caşin",3,1960,"CAŞIN",21720,1341,716,675,41,0,703,13,1500,784,380,323
4,"BACĂU","#N/A",21720,,294,"CAŞIN / Şcoala gimnazială N.Pâslaru Caşin",3,1960,"CAŞIN",21720,1206,607,574,33,0,597,10,1300,693,323,274
4,"BACĂU","#N/A",21720,,295,"CURIŢA / Grădiniţa Curiţa",3,1960,"CAŞIN",21720,651,412,384,28,0,406,6,700,288,182,224
4,"BACĂU","#N/A",21757,,296,"CĂIUŢI / PUBLICA",3,1950,"CĂIUŢI",21757,1368,847,765,77,5,832,15,1500,653,539,293
4,"BACĂU","#N/A",21757,,297,"POPENI / Şcoala Popeni",3,1950,"CĂIUŢI",21757,664,405,381,24,0,400,5,702,297,202,198
4,"BACĂU","#N/A",21757,,298,"BLIDARI / Şcoala Blidari",3,1950,"CĂIUŢI",21757,614,377,344,33,0,375,2,700,323,265,110
4,"BACĂU","#N/A",21757,,299,"PRALEA / Şcoala Pralea",3,1950,"CĂIUŢI",21757,726,451,437,14,0,448,3,800,349,251,197
4,"BACĂU","#N/A",21757,,300,"BOIŞTEA / Şcoala Boiştea",3,1950,"CĂIUŢI",21757,144,96,81,15,0,96,0,200,104,54,42
4,"BACĂU","#N/A",21757,,301,"HELTIU / Şcoala Heltiu",3,1950,"CĂIUŢI",21757,339,224,199,25,0,222,2,400,176,100,122
4,"BACĂU","#N/A",21757,,302,"VRÎNCENI / Şcoala Vrânceni",3,1950,"CĂIUŢI",21757,322,178,149,29,0,173,5,396,218,88,85
4,"BACĂU","#N/A",21757,,303,"MĂRCEŞTI / SCOALA PRIMARA MARCESTI",3,1950,"CĂIUŢI",21757,105,79,67,12,0,75,4,202,123,62,13
4,"BACĂU","#N/A",21855,,304,"CLEJA / Şcoala nr.1 Cleja",3,1963,"CLEJA",21855,1290,556,531,25,0,537,19,1400,844,175,362
4,"BACĂU","#N/A",21855,,305,"CLEJA / Scoala nr.1 Cleja",3,1963,"CLEJA",21855,1286,585,555,30,0,571,14,1400,815,175,396
4,"BACĂU","#N/A",21855,,306,"CLEJA / Şcoala nr.2 Cleja",3,1963,"CLEJA",21855,1122,562,539,23,0,552,10,1200,638,146,406
4,"BACĂU","#N/A",21855,,307,"SOMUŞCA / Şcoala Somuşca",3,1963,"CLEJA",21855,1199,572,554,18,0,552,20,1300,728,209,343
4,"BACĂU","#N/A",21855,,308,"VALEA MICĂ / Şcoala Valea Mică",3,1963,"CLEJA",21855,559,277,252,25,0,273,4,600,323,104,169
4,"BACĂU","#N/A",21891,,309,"COLONEŞTI / Şcoala gimnazială Coloneşti",3,1967,"COLONEŞTI",21891,1069,664,608,56,0,652,12,1200,536,520,132
4,"BACĂU","#N/A",21891,,310,"SPRIA / Şcoala gimnazială Spria",3,1967,"COLONEŞTI",21891,275,218,177,41,0,215,3,301,83,138,77
4,"BACĂU","#N/A",21891,,311,"SATU NOU / Şcoala primară Satu Nou",3,1967,"COLONEŞTI",21891,268,176,159,17,0,172,4,300,124,146,26
4,"BACĂU","#N/A",21971,,312,"CORBASCA / Cămin cultural Corbasca",3,1975,"CORBASCA",21971,608,319,290,28,1,315,4,698,379,188,127
4,"BACĂU","#N/A",21971,,313,"SCĂRIŞOARA / Şcoala cu cl.I-VIII Scărişoara",3,1975,"CORBASCA",21971,620,343,306,37,0,335,8,700,357,205,130
4,"BACĂU","#N/A",21971,,314,"MARVILA / Şcoala cu cl.I-IV Marvila",3,1975,"CORBASCA",21971,481,224,198,26,0,221,3,500,276,122,99
4,"BACĂU","#N/A",21971,,315,"VÎLCELE / Şcoala cu cl.I-IV Vîlcele",3,1975,"CORBASCA",21971,455,199,191,8,0,195,4,500,301,96,99
4,"BACĂU","#N/A",21971,,316,"BĂCIOIU / Şcoala cu cl.I-VIII Băcioiu",3,1975,"CORBASCA",21971,1475,389,363,26,0,375,14,1600,1211,258,117
4,"BACĂU","#N/A",21971,,317,"ROGOAZA / Şcoala cu cl.I-IV Rogoaza",3,1975,"CORBASCA",21971,260,150,130,20,0,150,0,300,150,84,66
4,"BACĂU","#N/A",22059,,318,"COŢOFĂNEŞTI / Primăria  Coţofăneşti",3,1983,"COŢOFĂNEŞTI",22059,962,710,639,67,4,690,20,1100,390,514,176
4,"BACĂU","#N/A",22059,,319,"BORŞANI / Şcoala cu cl.I-VIII Borşani",3,1983,"COŢOFĂNEŞTI",22059,610,435,388,41,6,432,3,700,265,294,138
4,"BACĂU","#N/A",22059,,320,"BÎLCA / Şcoala cu cl.I-IV Bîlca",3,1983,"COŢOFĂNEŞTI",22059,586,394,356,38,0,389,5,601,207,302,87
4,"BACĂU","#N/A",22059,,321,"TĂMĂŞOAIA / Şcoala cu cl.I-IV Tămăsoaia",3,1983,"COŢOFĂNEŞTI",22059,332,241,220,21,0,240,1,400,159,202,38
4,"BACĂU","#N/A",22111,,322,"DĂMIENEŞTI / Şcoala gen.cu cl.I-IV Dămieneşti",3,1989,"DĂMIENEŞTI",22111,476,282,240,42,0,277,5,501,219,199,78
4,"BACĂU","#N/A",22111,,323,"CĂLUGĂRENI / Şcoala gen.cu cl.I-VIII Călugăreni",3,1989,"DĂMIENEŞTI",22111,799,449,429,20,0,445,4,900,451,287,158
4,"BACĂU","#N/A",22111,,324,"DRĂGEŞTI / Şcoala gen.cu cl.I-IV Drăgeşti",3,1989,"DĂMIENEŞTI",22111,235,188,147,41,0,186,2,300,112,142,44
4,"BACĂU","#N/A",22237,,325,"DEALU MORII / Gradinita",3,1994,"DEALU MORII",22237,941,606,528,62,16,603,3,1000,394,423,180
4,"BACĂU","#N/A",22237,,326,"CĂUIA / Şcoala cu cl.I-IV Căuia",3,1994,"DEALU MORII",22237,549,401,352,40,9,396,5,600,199,280,116
4,"BACĂU","#N/A",22237,,327,"NEGULEŞTI / Şcoala cu cl.I-VIII Neguleşti",3,1994,"DEALU MORII",22237,499,358,296,48,14,349,9,500,142,189,160
4,"BACĂU","#N/A",22237,,328,"TĂVĂDĂREŞTI / Şcoala Tăvădărăşti",3,1994,"DEALU MORII",22237,323,240,197,34,9,235,5,403,163,180,55
4,"BACĂU","#N/A",22380,,329,"DOFTEANA / Şcoala Scarlat Longhin Dofteana",3,2009,"DOFTEANA",22380,1272,629,590,22,17,626,3,1400,771,370,256
4,"BACĂU","#N/A",22380,,330,"DOFTEANA / Şcoala Scarlat Longhin Dofteana",3,2009,"DOFTEANA",22380,1239,673,634,29,10,672,1,1400,727,386,286
4,"BACĂU","#N/A",22380,,331,"HĂGHIAC / Şcoala gen.cu cl.I-VIII Hăghiac",3,2009,"DOFTEANA",22380,1215,719,699,17,3,708,11,1300,581,384,324
4,"BACĂU","#N/A",22380,,332,"BOGATA / Căminul cultural Bogada",3,2009,"DOFTEANA",22380,720,416,374,31,11,412,4,800,384,260,152
4,"BACĂU","#N/A",22380,,333,"CUCUIEŢI / Şcoala gen.cu cl.I-VIII Cucuieţi",3,2009,"DOFTEANA",22380,900,563,545,13,5,560,3,1000,437,370,190
4,"BACĂU","#N/A",22380,,334,"CUCUIEŢI / Şcoala gen.cu cl.I-VIII Cucuieţi",3,2009,"DOFTEANA",22380,1045,672,639,18,15,645,27,1100,428,473,172
4,"BACĂU","#N/A",22380,,335,"LARGA / Şcoala gen.cu cl.I-VIII Larga",3,2009,"DOFTEANA",22380,1042,624,586,17,21,613,11,1100,476,376,237
4,"BACĂU","#N/A",22380,,336,"ŞTEFAN VODĂ / Şcoala gen.cu cl.I-IV Ştefan Vodă",3,2009,"DOFTEANA",22380,959,537,515,13,9,531,6,1000,463,282,249
4,"BACĂU","#N/A",22380,,337,"SEACA / Şcoala gen.cucl.I-IV Seaca",3,2009,"DOFTEANA",22380,394,252,230,17,5,250,2,400,148,145,105
4,"BACĂU","#N/A",22460,,338,"FARAOANI / Şcoalagen.nr.1 Faraoani",3,2017,"FARAOANI",22460,1341,616,582,30,4,609,7,1499,883,193,416
4,"BACĂU","#N/A",22460,,339,"FARAOANI / Şcoala gen.nr.1 Faraoani",3,2017,"FARAOANI",22460,1142,536,502,33,1,521,15,1308,772,185,336
4,"BACĂU","#N/A",22460,,340,"FARAOANI / Şcoala gen.nr.2 Faraoani",3,2017,"FARAOANI",22460,1005,512,463,24,25,508,4,1120,608,222,286
4,"BACĂU","#N/A",22460,,341,"FARAOANI / Şcoala gen.nr.2 Faraoani",3,2017,"FARAOANI",22460,892,444,400,24,20,439,5,1000,556,199,240
4,"BACĂU","#N/A",22488,,342,"FILIPENI / Primăria Filipeni",3,2019,"FILIPENI",22488,571,393,331,62,0,390,3,600,207,287,103
4,"BACĂU","#N/A",22488,,343,"MĂRĂŞTI / Şcoala cu cl.I-IV Mărăşti",3,2019,"FILIPENI",22488,595,333,271,62,0,327,6,700,367,186,141
4,"BACĂU","#N/A",22488,,344,"FRUNTEŞTI / Şcoala cu cl.I-IV Frunteşti",3,2019,"FILIPENI",22488,637,391,346,45,0,386,5,700,309,208,178
4,"BACĂU","#N/A",22576,,345,"FILIPEŞTI / Şcoala Filipeşti",3,2028,"FILIPEŞTI",22576,824,488,390,98,0,481,7,900,412,261,220
4,"BACĂU","#N/A",22576,,346,"GALBENI / Şcoala Galbeni",3,2028,"FILIPEŞTI",22576,711,432,367,65,0,429,3,800,368,271,158
4,"BACĂU","#N/A",22576,,347,"CÎRLIGI / Şcoala Cîrligi",3,2028,"FILIPEŞTI",22576,946,550,474,76,0,547,3,1000,450,287,260
4,"BACĂU","#N/A",22576,,348,"ONIŞCANI / Şcoala Onişcani",3,2028,"FILIPEŞTI",22576,403,243,197,46,0,239,4,498,255,138,101
4,"BACĂU","#N/A",22576,,349,"BOANŢA / Şcoala Boanţa",3,2028,"FILIPEŞTI",22576,264,165,126,39,0,164,1,297,132,78,86
4,"BACĂU","#N/A",22576,,350,"HÎRLEŞTI / Şcoala Hîrleşti",3,2028,"FILIPEŞTI",22576,593,431,372,59,0,426,5,600,169,249,177
4,"BACĂU","#N/A",22665,,351,"GĂICEANA / Primăria Găiceana",3,2037,"GĂICEANA",22665,767,544,473,52,19,540,4,800,256,344,196
4,"BACĂU","#N/A",22665,,352,"ARINI / Şcoala Arini",3,2037,"GĂICEANA",22665,1008,579,551,17,11,573,6,1100,521,358,215
4,"BACĂU","#N/A",22665,,353,"POPEŞTI / Şcoala Huţu",3,2037,"GĂICEANA",22665,509,417,343,49,25,414,3,600,183,295,119
4,"BACĂU","#N/A",22718,,354,"FĂGET / Primăria Făget",3,2042,"GHIMEŞ-FĂGET",22718,1106,590,527,63,0,579,11,1200,610,153,426
4,"BACĂU","#N/A",22718,,355,"TĂRHĂUŞI / Şcoala gen.cu cl.I-VIII Tărhăuşi",3,2042,"GHIMEŞ-FĂGET",22718,652,391,363,28,0,387,4,700,309,130,257
4,"BACĂU","#N/A",22718,,356,"GHIMEŞ / Şcoala gen.cu cl.I-VIII Ghimeş",3,2042,"GHIMEŞ-FĂGET",22718,869,490,441,49,0,484,6,900,410,143,341
4,"BACĂU","#N/A",22718,,357,"FĂGETU DE SUS / Şcoala gen.cu cl.I-IV Făgetul de Sus",3,2042,"GHIMEŞ-FĂGET",22718,208,148,128,20,0,146,2,300,152,58,88
4,"BACĂU","#N/A",22718,,358,"BOLOVĂNIŞ / Şcoala gen.cu cl.I-VIII Bolovăniş",3,2042,"GHIMEŞ-FĂGET",22718,767,374,354,20,0,372,2,800,426,71,301
4,"BACĂU","#N/A",22718,,359,"RĂCHITIŞ / Şcoala gen.cu cl.I-IV Răchitiş",3,2042,"GHIMEŞ-FĂGET",22718,195,140,115,25,0,138,2,200,60,61,77
4,"BACĂU","#N/A",26346,,360,"GIOSENI / Şcoala gen.cu cl.I-VIII Ion Strat Gioseni",3,2049,"GIOSENI",26346,1061,567,528,38,1,564,3,1200,633,288,276
4,"BACĂU","#N/A",26346,,361,"GIOSENI / Şcoala gen.cu cl.I-VIII Ion Strat Gioseni",3,2049,"GIOSENI",26346,972,513,478,35,0,507,6,1100,587,260,247
4,"BACĂU","#N/A",26346,,362,"GIOSENI / Scoala Gen. cu cl I-VIII GIOSENI",3,2049,"GIOSENI",26346,1036,498,473,25,0,493,5,1100,602,234,259
4,"BACĂU","#N/A",22781,,363,"GÎRLENII DE SUS / Şcoala cu cl.I-VIII Gîrlenii de Sus",3,2051,"GÎRLENI",22781,1382,597,561,36,0,589,8,1500,903,173,416
4,"BACĂU","#N/A",22781,,364,"GÎRLENI / Şcoala cu cl.I-VIII Gîrleni",3,2051,"GÎRLENI",22781,987,483,448,35,0,478,5,1100,617,200,278
4,"BACĂU","#N/A",22781,,365,"GÎRLENI / Şcoala cu cl.I-VIII Gîrleni",3,2051,"GÎRLENI",22781,893,459,406,53,0,456,3,1000,541,213,243
4,"BACĂU","#N/A",22781,,366,"LESPEZI / Şcoala cu cl.I-VIII Lespezi",3,2051,"GÎRLENI",22781,1020,452,426,26,0,449,3,1100,648,148,301
4,"BACĂU","#N/A",22781,,367,"LESPEZI / Şcoala cu cl.I-VIII Lespezi",3,2051,"GÎRLENI",22781,1202,552,521,31,0,548,4,1300,748,195,353
4,"BACĂU","#N/A",22834,,368,"GLĂVĂNEŞTI / Căminul cultural Glăvăneşti",3,2056,"GLĂVĂNEŞTI",22834,1505,830,768,62,0,824,6,1700,870,531,293
4,"BACĂU","#N/A",22834,,369,"FRUMUŞELU / Căminul cultural Frumuşelu",3,2056,"GLĂVĂNEŞTI",22834,1089,626,552,74,0,618,8,1200,574,481,137
4,"BACĂU","#N/A",22834,,370,"MUNCELU / Scoala Muncelu",3,2056,"GLĂVĂNEŞTI",22834,200,150,122,28,0,146,4,200,50,109,37
4,"BACĂU","#N/A",20607,,371,"GURA VĂII / Primăria Gura Văii",3,2062,"GURA VĂII",20607,1303,709,664,45,0,705,4,1400,691,342,363
4,"BACĂU","#N/A",20607,,372,"GURA VĂII / Grădiniţa Pătrăşcani",3,2062,"GURA VĂII",20607,310,206,180,26,0,203,3,400,194,101,102
4,"BACĂU","#N/A",20607,,373,"MOTOCEŞTI / Inst.de cult (Casa Prăznicală B.O.Sf.Treime) Motoceşti",3,2062,"GURA VĂII",20607,131,102,84,18,0,102,0,203,101,64,38
4,"BACĂU","#N/A",20607,,374,"TEMELIA / Şcoala Temelia",3,2062,"GURA VĂII",20607,723,301,276,25,0,294,7,800,499,109,185
4,"BACĂU","#N/A",20607,,375,"PĂLTINATA / Şcoala Păltinata",3,2062,"GURA VĂII",20607,403,247,221,26,0,246,1,500,253,155,91
4,"BACĂU","#N/A",20607,,376,"DUMBRAVA / SCOALA GENERALA CU CLASELE I-VIII",3,2062,"GURA VĂII",20607,1027,608,570,36,2,601,7,1100,492,421,180
4,"BACĂU","#N/A",20607,,377,"CAPĂTA / Şcoala Capăta",3,2062,"GURA VĂII",20607,294,174,162,12,0,171,3,300,126,109,62
4,"BACĂU","#N/A",22898,,378,"HELEGIU / Şcoala gimnazială Helegiu",3,2069,"HELEGIU",22898,945,466,417,49,0,462,4,1000,534,286,176
4,"BACĂU","#N/A",22898,,379,"BRĂTILA / Şcoala gimnazială Brătila 2",3,2069,"HELEGIU",22898,709,403,368,34,1,389,14,800,397,234,155
4,"BACĂU","#N/A",22898,,380,"BRĂTILA / Scoala cu clasele I-VIII Bratila 1",3,2069,"HELEGIU",22898,846,462,419,43,0,461,1,900,438,280,181
4,"BACĂU","#N/A",22898,,381,"DELENI / SCOALA",3,2069,"HELEGIU",22898,1446,672,635,37,0,662,10,1600,928,414,248
4,"BACĂU","#N/A",22898,,382,"DRĂGUGEŞTI / Şcoala gimnazială nr.1 Drăgugeşti",3,2069,"HELEGIU",22898,1298,650,589,61,0,640,10,1400,750,421,219
4,"BACĂU","#N/A",22898,,383,"DRĂGUGEŞTI / Şcoala primară nr.2 Drăgugeşti",3,2069,"HELEGIU",22898,350,185,158,27,0,176,9,400,215,141,35
4,"BACĂU","#N/A",20313,,384,"HEMEIUŞ / Căminul cultural Hemeiuş",3,2074,"HEMEIUŞ",20313,1257,731,623,108,0,723,8,1400,669,271,452
4,"BACĂU","#N/A",20313,,385,"HEMEIUŞ / Şcoala gen.Grigore Tăbăcaru Hemeiuş",3,2074,"HEMEIUŞ",20313,672,491,399,92,0,482,9,700,209,185,297
4,"BACĂU","#N/A",20313,,386,"LILIECI / Scoala gen.Ion Simionescu, Lilieci",3,2074,"HEMEIUŞ",20313,1302,755,659,96,0,742,13,1400,645,223,519
4,"BACĂU","#N/A",20313,,387,"LILIECI / Şcoala gen.Ion Simionescu Lilieci",3,2074,"HEMEIUŞ",20313,950,583,529,54,0,581,2,1000,417,196,385
4,"BACĂU","#N/A",22941,,388,"HORGEŞTI / Primăria Horgeşti",3,2078,"HORGEŞTI",22941,1429,720,649,71,0,712,8,1600,880,417,295
4,"BACĂU","#N/A",22941,,389,"SOHODOR / Şcoala Sohodor",3,2078,"HORGEŞTI",22941,836,440,423,17,0,433,7,900,460,351,82
4,"BACĂU","#N/A",22941,,390,"RECEA / Şcoala Recea",3,2078,"HORGEŞTI",22941,645,394,357,37,0,385,9,700,306,310,75
4,"BACĂU","#N/A",22941,,391,"RĂCĂTĂU-RĂZEŞI / Şcoala Răcătău",3,2078,"HORGEŞTI",22941,862,453,421,32,0,449,4,900,447,348,101
4,"BACĂU","#N/A",23047,,392,"HURUIEŞTI / Primăria Huruieşti",3,2087,"HURUIEŞTI",23047,617,323,291,32,0,317,6,700,377,196,121
4,"BACĂU","#N/A",23047,,393,"PERCHIU / Fostul local al şcolii Perchiu",3,2087,"HURUIEŞTI",23047,132,114,97,17,0,113,1,200,86,62,51
4,"BACĂU","#N/A",23047,,394,"PRĂDAIŞ / Fostul local al şcolii Pradaiş",3,2087,"HURUIEŞTI",23047,273,178,144,34,0,177,1,300,122,135,42
4,"BACĂU","#N/A",23047,,395,"CĂPOTEŞTI / Fostul local al şcolii Capoteşti",3,2087,"HURUIEŞTI",23047,195,146,114,32,0,144,2,200,54,99,45
4,"BACĂU","#N/A",23047,,396,"OCHENI / Localul Şcolii Ocheni",3,2087,"HURUIEŞTI",23047,306,250,223,27,0,233,17,400,150,221,12
4,"BACĂU","#N/A",23047,,397,"FLOREŞTI / Fostul local al şcolii Floreşti",3,2087,"HURUIEŞTI",23047,148,118,94,24,0,117,1,200,82,79,38
4,"BACĂU","#N/A",23047,,398,"FUNDOAIA / Localul Şcolii Fundoaia",3,2087,"HURUIEŞTI",23047,347,215,195,20,0,212,3,400,185,162,50
4,"BACĂU","#N/A",26379,,399,"ITEŞTI / Şcoala cl.I-VIII Iteşti",3,2095,"ITEŞTI",26379,689,481,406,64,11,474,7,800,319,204,270
4,"BACĂU","#N/A",26379,,400,"DUMBRAVA / Şcoala Dumbrava",3,2095,"ITEŞTI",26379,355,262,193,69,0,260,2,400,138,137,123
4,"BACĂU","#N/A",26379,,401,"CIUMAŞI / Căminul cultural Ciumaşi",3,2095,"ITEŞTI",26379,142,132,90,42,0,131,1,200,68,63,68
4,"BACĂU","#N/A",23127,,402,"IZVORU BERHECIULUI / Şcoala Constantin Moscu Izv.Berheciului",3,2100,"IZVORU BERHECIULUI",23127,670,375,339,36,0,370,5,700,325,216,154
4,"BACĂU","#N/A",23127,,403,"ANTOHEŞTI / Şcoala generală Antoheşti",3,2100,"IZVORU BERHECIULUI",23127,310,190,153,37,0,186,4,400,210,105,81
4,"BACĂU","#N/A",23127,,404,"OBÎRŞIA / Şcoala generală Obîrşia",3,2100,"IZVORU BERHECIULUI",23127,321,237,171,66,0,237,0,400,163,115,122
4,"BACĂU","#N/A",20359,,405,"LETEA VECHE / Şcoala coordonatoare Letea Veche",3,2108,"LETEA VECHE",20359,1029,694,554,133,7,681,13,1100,406,389,292
4,"BACĂU","#N/A",20359,,406,"LETEA VECHE / Scoala coordonatoare Letea Veche",3,2108,"LETEA VECHE",20359,1756,1170,1033,135,2,1145,25,1900,730,467,678
4,"BACĂU","#N/A",20359,,407,"HOLT / Şcoala Holt",3,2108,"LETEA VECHE",20359,1421,974,837,132,5,956,18,1600,626,542,414
4,"BACĂU","#N/A",20359,,408,"RADOMIREŞTI / Şcoala Radomireşti",3,2108,"LETEA VECHE",20359,313,185,163,20,2,180,5,400,215,107,73
4,"BACĂU","#N/A",20359,,409,"RUŞI-CIUTEA / Şcoala Ruşi Ciutea",3,2108,"LETEA VECHE",20359,519,576,321,255,0,565,11,600,24,341,224
4,"BACĂU","#N/A",20359,,410,"SIRETU / Şcoala Siretu",3,2108,"LETEA VECHE",20359,409,398,264,134,0,391,7,500,102,246,145
4,"BACĂU","#N/A",23207,,411,"LIPOVA / Şcoala cl.I-VIII M.Eminescu Lipova",3,2114,"LIPOVA",23207,534,359,301,41,17,357,2,601,242,253,104
4,"BACĂU","#N/A",23207,,412,"VALEA HOGEI / Şcoala cu cl.I-IV Valea Hogei",3,2114,"LIPOVA",23207,233,180,133,35,12,175,5,299,119,118,57
4,"BACĂU","#N/A",23207,,413,"SATU NOU / Şcoala cu cl.I-VIII Satu Nou",3,2114,"LIPOVA",23207,383,262,245,14,3,260,2,397,135,216,44
4,"BACĂU","#N/A",23207,,414,"VALEA CASELOR / Şcoala cu cl.I-IV Valea Caselor",3,2114,"LIPOVA",23207,352,249,214,30,5,248,1,397,148,192,56
4,"BACĂU","#N/A",23207,,415,"MÎLOSU / Şcoala cu cl.I-VIII Mîlosu",3,2114,"LIPOVA",23207,715,420,390,22,8,413,7,800,380,352,61
4,"BACĂU","#N/A",23289,,416,"LIVEZI / Şcoala gimnazială nr.1 Livezi",3,2122,"LIVEZI",23289,786,363,328,35,0,360,3,900,537,247,113
4,"BACĂU","#N/A",23289,,417,"ORĂŞA / Şcoala primară Orăşa",3,2122,"LIVEZI",23289,736,414,397,17,0,409,5,800,386,300,109
4,"BACĂU","#N/A",23289,,418,"PRAJOAIA / Şcoala primară Prăjoaia",3,2122,"LIVEZI",23289,763,394,372,22,0,386,8,800,406,296,90
4,"BACĂU","#N/A",23289,,419,"SCĂRIGA / Şcoala primară Scăriga",3,2122,"LIVEZI",23289,447,280,263,17,0,278,2,494,214,173,105
4,"BACĂU","#N/A",23289,,420,"POIANA / Şcoala gimnazială Poiana",3,2122,"LIVEZI",23289,715,357,334,23,0,356,1,800,443,206,150
4,"BACĂU","#N/A",23289,,421,"BĂLĂNEASA / Şcoala primară Bălăneasa",3,2122,"LIVEZI",23289,897,411,389,22,0,408,3,1000,589,270,138
4,"BACĂU","#N/A",23350,,422,"LUIZI-CĂLUGĂRA / Şcoala cu cl.I-VIII Luizi Călugăra",3,2129,"LUIZI-CĂLUGĂRA",23350,1263,557,510,47,0,545,12,1400,843,196,349
4,"BACĂU","#N/A",23350,,423,"LUIZI-CĂLUGĂRA / Şcoala cu cl.I-VIII Luizi Călugăra",3,2129,"LUIZI-CĂLUGĂRA",23350,1259,490,461,29,0,482,8,1400,910,168,314
4,"BACĂU","#N/A",23350,,424,"OSEBIŢI / Şcoala cu cl.I-VIII Osebiţi",3,2129,"LUIZI-CĂLUGĂRA",23350,866,365,337,28,0,360,5,900,535,117,243
4,"BACĂU","#N/A",23350,,425,"OSEBIŢI / Şcoala cu cl.I-VIII Osebiţi",3,2129,"LUIZI-CĂLUGĂRA",23350,856,387,365,22,0,380,7,900,513,136,244
4,"BACĂU","#N/A",23387,,426,"MĂGIREŞTI / Caminul Cultural Magiresi",3,2132,"MĂGIREŞTI",23387,1522,816,773,42,1,805,11,1700,884,323,482
4,"BACĂU","#N/A",23387,,427,"STĂNEŞTI / Şcoala cu cl.I-IV Stăneşti",3,2132,"MĂGIREŞTI",23387,503,293,275,18,0,289,4,600,307,120,169
4,"BACĂU","#N/A",23387,,428,"VALEA ARINILOR / Şcoala cu cl.I-VIII Valea Arinilor",3,2132,"MĂGIREŞTI",23387,984,610,588,22,0,599,11,1100,490,200,399
4,"BACĂU","#N/A",23387,,429,"PRĂJEŞTI / SCOALA I-IV PRAJESTI",3,2132,"MĂGIREŞTI",23387,522,327,297,30,0,316,11,599,272,121,195
4,"BACĂU","#N/A",20411,,430,"MĂGURA / Şcoala nr.2 Măgura-sala 1",3,2138,"MĂGURA",20411,824,541,474,67,0,528,13,900,359,207,321
4,"BACĂU","#N/A",20411,,431,"MĂGURA / SCOALA NR.2 SAT MAGURA - SALA 2",3,2138,"MĂGURA",20411,590,403,332,71,0,395,8,604,201,157,238
4,"BACĂU","#N/A",20411,,432,"MĂGURA / Şcoala gen.nr.1 Emil Brăiescu Măgura",3,2138,"MĂGURA",20411,1633,907,756,151,0,900,7,1800,893,356,544
4,"BACĂU","#N/A",20411,,433,"CRIHAN / Şcoala generală Crihan",3,2138,"MĂGURA",20411,983,527,445,82,0,525,2,1100,573,164,361
4,"BACĂU","#N/A",23449,,434,"MĂNĂSTIREA CAŞIN / Căminul culturalsatul Mănăstirea Caşin",3,2143,"MĂNĂSTIREA CAŞIN",23449,1857,959,903,53,3,947,12,2000,1041,523,424
4,"BACĂU","#N/A",23449,,435,"PÎRVULEŞTI / Căminul culturalsatul Mănăstirea Caşin",3,2143,"MĂNĂSTIREA CAŞIN",23449,586,309,298,9,2,300,9,600,291,178,122
4,"BACĂU","#N/A",23449,,436,"SCUTARU / Şcoala gen.nr.2 Mănăstirea Caşin",3,2143,"MĂNĂSTIREA CAŞIN",23449,1452,757,725,26,6,743,14,1600,843,429,314
4,"BACĂU","#N/A",23449,,437,"LUPEŞTI / Şcoala Lupeşti",3,2143,"MĂNĂSTIREA CAŞIN",23449,620,336,313,23,0,333,3,700,364,165,168
4,"BACĂU","#N/A",20466,,438,"MĂRGINENI / Şcoala cu cl.I-VIII Mărgineni",3,2148,"MĂRGINENI",20466,1098,584,531,53,0,578,6,1200,616,222,356
4,"BACĂU","#N/A",20466,,439,"MĂRGINENI / Şcoala cu cl.I-VIII Mărgineni",3,2148,"MĂRGINENI",20466,1153,500,442,58,0,496,4,1283,783,199,297
4,"BACĂU","#N/A",20466,,440,"MĂRGINENI / Şcoala cu cl.I-VIII Mărgineni",3,2148,"MĂRGINENI",20466,1040,490,449,41,0,481,9,1100,610,214,267
4,"BACĂU","#N/A",20466,,441,"BARAŢI / Şcoala cu cl.I-VIII Baraţi",3,2148,"MĂRGINENI",20466,1624,906,795,111,0,899,7,1804,898,439,460
4,"BACĂU","#N/A",20466,,442,"TREBEŞ / Şcoala cu cl.I-VIII Trebeş",3,2148,"MĂRGINENI",20466,721,395,344,51,0,385,10,800,405,210,175
4,"BACĂU","#N/A",20466,,443,"VALEA BUDULUI / ŞCOALA CU CLASELE I -IV VALEA-BUDULUI",3,2148,"MĂRGINENI",20466,391,234,205,29,0,229,5,400,166,89,140
4,"BACĂU","#N/A",20466,,444,"PĂDURENI / ŞCOALA CU CLASELE I - IV PĂDURENI",3,2148,"MĂRGINENI",20466,319,264,159,105,0,262,2,400,136,164,98
4,"BACĂU","#N/A",20466,,445,"LUNCANI / Şcoala cu cl.I-VIII Luncani",3,2148,"MĂRGINENI",20466,957,600,504,96,0,592,8,1000,400,340,252
4,"BACĂU","#N/A",20466,,446,"PODIŞ / ŞCOALA CU CLASELE I - IV PODIŞ",3,2148,"MĂRGINENI",20466,499,469,291,178,0,464,5,500,31,317,147
4,"BACĂU","#N/A",23494,,447,"MOTOŞENI / Primăria Motoşeni",3,2157,"MOTOŞENI",23494,879,557,493,64,0,548,9,1000,443,392,156
4,"BACĂU","#N/A",23494,,448,"ŢEPOAIA / Şcoala satul Ţepoaia",3,2157,"MOTOŞENI",23494,469,285,259,26,0,281,4,500,215,215,66
4,"BACĂU","#N/A",23494,,449,"COCIU / Şcoala satul Cociu",3,2157,"MOTOŞENI",23494,265,181,148,33,0,179,2,300,119,141,38
4,"BACĂU","#N/A",23494,,450,"POIANA / Şcoala satul Poiana",3,2157,"MOTOŞENI",23494,307,249,198,51,0,243,6,400,151,196,47
4,"BACĂU","#N/A",23494,,451,"FÎNTÎNELE / Şcoala satul Fîntînele",3,2157,"MOTOŞENI",23494,552,400,318,82,0,399,1,600,200,301,98
4,"BACĂU","#N/A",23494,,452,"ŞENDREŞTI / Şcoala satul Şendreşti",3,2157,"MOTOŞENI",23494,317,242,195,47,0,240,2,400,158,184,56
4,"BACĂU","#N/A",23644,,453,"NEGRI / Şcoala Costache Negri satul Negri",3,2172,"NEGRI",23644,1097,595,505,89,1,591,4,1200,605,397,194
4,"BACĂU","#N/A",23644,,454,"POIANA / Şcoala Ion Ionescu de la Brad satul Poiana-Negri",3,2172,"NEGRI",23644,1239,609,583,26,0,601,8,1400,791,418,183
4,"BACĂU","#N/A",23715,,455,"NICOLAE BĂLCESCU / Scoala Nicolae Balcescu",3,2179,"NICOLAE BĂLCESCU",23715,1174,554,510,44,0,547,7,1300,746,174,373
4,"BACĂU","#N/A",23715,,456,"NICOLAE BĂLCESCU / Scoala Nicolae Balcescu",3,2179,"NICOLAE BĂLCESCU",23715,1456,681,633,48,0,672,9,1600,919,233,439
4,"BACĂU","#N/A",23715,,457,"NICOLAE BĂLCESCU / Scoala Nicolae Balcescu",3,2179,"NICOLAE BĂLCESCU",23715,1476,633,595,38,0,621,12,1600,967,212,409
4,"BACĂU","#N/A",23715,,458,"GALBENI / Şcoala satul Galbeni",3,2179,"NICOLAE BĂLCESCU",23715,1169,638,601,37,0,626,12,1300,662,166,460
4,"BACĂU","#N/A",23715,,459,"VALEA SEACĂ / Gradinita nr.1 Valea Seaca",3,2179,"NICOLAE BĂLCESCU",23715,804,368,333,32,3,360,8,900,532,183,177
4,"BACĂU","#N/A",23715,,460,"VALEA SEACĂ / Gradinita nr.1 Valea Seaca",3,2179,"NICOLAE BĂLCESCU",23715,924,465,426,32,7,451,14,1000,535,240,211
4,"BACĂU","#N/A",23715,,461,"VALEA SEACĂ / Gradinita nr.1 Valea Seaca",3,2179,"NICOLAE BĂLCESCU",23715,695,334,302,26,6,328,6,800,466,174,154
4,"BACĂU","#N/A",23715,,462,"LĂRGUŢA / Şcoala satul Lărguţa",3,2179,"NICOLAE BĂLCESCU",23715,184,120,111,9,0,120,0,200,80,85,35
4,"BACĂU","#N/A",26353,,463,"ODOBEŞTI / Şcoala cu cl.I-IV Odobeşti",3,2185,"ODOBEŞTI",26353,375,249,211,38,0,247,2,400,151,164,83
4,"BACĂU","#N/A",26353,,464,"TISA-SILVESTRI / Şcoala cu cl.I-VIII Tisa Silvestri",3,2185,"ODOBEŞTI",26353,823,551,486,60,5,542,9,900,349,398,144
4,"BACĂU","#N/A",26353,,465,"CIUTUREŞTI / Şcoala cu cl.I-VIII Ciutureşti",3,2185,"ODOBEŞTI",26353,620,376,353,23,0,370,6,700,324,234,136
4,"BACĂU","#N/A",23797,,466,"OITUZ / Scoala Gimnaziala, Comuna Oituz",3,2190,"OITUZ",23797,533,251,225,26,0,246,5,600,349,136,110
4,"BACĂU","#N/A",23797,,467,"OITUZ / Scoala gimnaziala nr. 1 Oituz",3,2190,"OITUZ",23797,1404,710,658,52,0,705,5,1500,790,439,266
4,"BACĂU","#N/A",23797,,468,"OITUZ / Gradinita nr. 1 Oituz",3,2190,"OITUZ",23797,1551,696,675,21,0,685,11,1700,1004,428,257
4,"BACĂU","#N/A",23797,,469,"OITUZ / Gradinita nr. 2 Oituz",3,2190,"OITUZ",23797,945,524,483,41,0,515,9,1000,476,314,201
4,"BACĂU","#N/A",23797,,470,"OITUZ / Gradinita nr.3 Oituz",3,2190,"OITUZ",23797,1041,492,462,30,0,479,13,1100,608,285,194
4,"BACĂU","#N/A",23797,,471,"MARGINEA / Grădiniţa Marginea",3,2190,"OITUZ",23797,614,321,298,23,0,315,6,700,379,254,61
4,"BACĂU","#N/A",23797,,472,"CĂLCÎI / Grădiniţa Călcâi",3,2190,"OITUZ",23797,380,197,181,16,0,192,5,398,201,95,97
4,"BACĂU","#N/A",23797,,473,"FERESTRĂU-OITUZ / Şcoala gimnaziala Ferestrau",3,2190,"OITUZ",23797,849,491,446,45,0,487,4,900,409,255,232
4,"BACĂU","#N/A",23797,,474,"HÎRJA / Aşezământ filantropic ""Sfântul Voievod Ştefan cel Mare"" Hîrja",3,2190,"OITUZ",23797,271,204,124,80,0,197,7,298,94,133,64
4,"BACĂU","#N/A",23797,,475,"POIANA SĂRATĂ / Scoala Poiana-Sărată",3,2190,"OITUZ",23797,219,171,117,54,0,169,2,300,129,86,83
4,"BACĂU","#N/A",23868,,476,"ONCEŞTI / Căminul cultural satul Onceşti",3,2197,"ONCEŞTI",23868,767,508,426,82,0,495,12,800,292,249,246
4,"BACĂU","#N/A",23868,,477,"TARNIŢA / Sala de festivităţi satul Tarniţa",3,2197,"ONCEŞTI",23868,541,349,321,28,0,346,3,600,251,175,171
4,"BACĂU","#N/A",23948,,478,"ORBENI / Şcoala cu cl.I-VIII satul Orbeni",3,2205,"ORBENI",23948,925,538,447,88,3,531,7,1000,462,303,228
4,"BACĂU","#N/A",23948,,479,"ORBENI / Şcoala primară nr.2 satul Orbeni",3,2205,"ORBENI",23948,715,391,340,48,3,386,5,800,409,229,157
4,"BACĂU","#N/A",23948,,480,"SCURTA / Şcoala veche satul Scurta",3,2205,"ORBENI",23948,1430,779,701,77,1,765,14,1600,821,496,269
4,"BACĂU","#N/A",23975,,481,"PALANCA / Primăria Palanca",3,2208,"PALANCA",23975,1281,813,726,87,0,796,17,1400,587,523,273
4,"BACĂU","#N/A",23975,,482,"CIUGHEŞ / Căminul cultural satul Ciugheş",3,2208,"PALANCA",23975,1489,894,819,74,1,880,14,1600,706,721,159
4,"BACĂU","#N/A",23975,,483,"CĂDĂREŞTI / Şcoala satul Cădărăşti",3,2208,"PALANCA",23975,86,73,49,24,0,72,1,99,26,45,27
4,"BACĂU","#N/A",24034,,484,"PARAVA / Şcoala gimnazială satul Parava",3,2214,"PARAVA",24034,724,409,350,59,0,403,6,800,391,220,183
4,"BACĂU","#N/A",24034,,485,"DRĂGUŞANI / Şcoala gimnazială satul Drăguşani",3,2214,"PARAVA",24034,730,444,349,95,0,438,6,800,356,248,190
4,"BACĂU","#N/A",24034,,486,"RĂDOAIA / Şcoala gimnazială satul Rădoaia",3,2214,"PARAVA",24034,931,290,270,20,0,284,6,1000,710,233,51
4,"BACĂU","#N/A",24034,,487,"TEIUŞ / Şcoala primară satul Teiuş",3,2214,"PARAVA",24034,202,141,113,28,0,141,0,298,157,86,55
4,"BACĂU","#N/A",24089,,488,"PARINCEA / LICEUL TEHNOLOGIC ""G.J.Cancicov"" PARINCEA",3,2219,"PARINCEA",24089,767,381,338,43,0,367,14,800,419,187,180
4,"BACĂU","#N/A",24089,,489,"VĂLENI / Şcoala Văleni",3,2219,"PARINCEA",24089,457,215,187,28,0,205,10,500,285,89,116
4,"BACĂU","#N/A",24089,,490,"VLADNIC / Şcoala Vladnic",3,2219,"PARINCEA",24089,699,395,355,40,0,393,2,800,405,168,225
4,"BACĂU","#N/A",24089,,491,"NĂNEŞTI / Şcoala Năneşti",3,2219,"PARINCEA",24089,603,384,330,54,0,379,5,700,316,236,143
4,"BACĂU","#N/A",24089,,492,"POIENI / Şcoala Poieni",3,2219,"PARINCEA",24089,238,120,100,20,0,120,0,300,180,75,45
4,"BACĂU","#N/A",24089,,493,"MILEŞTII DE SUS / Şcoala  Mileştii de Jos",3,2219,"PARINCEA",24089,220,126,99,27,0,120,6,300,174,68,52
4,"BACĂU","#N/A",24338,,494,"PÂRJOL / Şcoala satul Pîrjol",3,2230,"PÂRJOL",24338,743,402,356,46,0,398,4,800,398,216,182
4,"BACĂU","#N/A",24338,,495,"TĂRÎŢA / Şcoala satul Tariţa",3,2230,"PÂRJOL",24338,829,414,369,37,8,407,7,900,486,227,180
4,"BACĂU","#N/A",24338,,496,"BĂHNĂŞENI / Şcoala satul Băhnăşeni",3,2230,"PÂRJOL",24338,735,420,385,35,0,407,13,800,380,302,105
4,"BACĂU","#N/A",24338,,497,"BĂRNEŞTI / Şcoala satul Bărneşti",3,2230,"PÂRJOL",24338,199,127,109,17,1,126,1,200,73,84,42
4,"BACĂU","#N/A",24338,,498,"BĂSĂŞTI / Şcoala satul Băseşti",3,2230,"PÂRJOL",24338,526,258,224,31,3,254,4,600,342,163,91
4,"BACĂU","#N/A",24338,,499,"HÂINEALA / Şcoala satul Hăineala",3,2230,"PÂRJOL",24338,221,130,98,32,0,127,3,300,170,103,24
4,"BACĂU","#N/A",24338,,500,"CÎMPENI / Şcoala satul Cîmpeni",3,2230,"PÂRJOL",24338,526,276,245,23,8,272,4,600,324,154,118
4,"BACĂU","#N/A",24338,,501,"PUSTIANA / Grădiniţa Pustiana",3,2230,"PÂRJOL",24338,700,343,291,28,24,340,3,800,457,232,108
4,"BACĂU","#N/A",24338,,502,"PUSTIANA / Şcoala cu cl.I-VIII Pustiana",3,2230,"PÂRJOL",24338,904,436,384,21,31,434,2,1000,564,248,186
4,"BACĂU","#N/A",24187,,503,"PÎNCEŞTI / Şcoala nr.1 Pînceşti",3,2240,"PÎNCEŞTI",24187,1187,511,461,50,0,498,13,1300,789,295,203
4,"BACĂU","#N/A",24187,,504,"DIENEŢ / Şcoala satul Dieneţ",3,2240,"PÎNCEŞTI",24187,529,271,235,36,0,271,0,600,329,154,117
4,"BACĂU","#N/A",24187,,505,"PETREŞTI / Şcoala generală satul Petreşti",3,2240,"PÎNCEŞTI",24187,664,319,286,33,0,312,7,700,381,195,117
4,"BACĂU","#N/A",24187,,506,"SOCI / Şcoala generală satul Soci",3,2240,"PÎNCEŞTI",24187,611,335,283,52,0,333,2,700,365,179,154
4,"BACĂU","#N/A",24187,,507,"FULGERIŞ / Şcoala generală satul Fulgeriş",3,2240,"PÎNCEŞTI",24187,383,177,161,16,0,171,6,400,223,107,64
4,"BACĂU","#N/A",24276,,508,"PÎRÎU BOGHII / Grădiniţa cu progr.normal satul Pîrîu Boghii",3,2249,"PÎRGĂREŞTI",24276,376,258,231,27,0,258,0,400,142,172,86
4,"BACĂU","#N/A",24276,,509,"PÎRGĂREŞTI / Şcoala gimnazială Dumitru Mărtinaş satul Pîrgăreşti",3,2249,"PÎRGĂREŞTI",24276,840,376,354,22,0,371,5,900,524,225,146
4,"BACĂU","#N/A",24276,,510,"SATU NOU / Şcoala gimnazială Vasile Gh.Radusatul Satu Nou",3,2249,"PÎRGĂREŞTI",24276,1392,572,556,16,0,566,6,1500,928,304,262
4,"BACĂU","#N/A",24276,,511,"NICOREŞTI / Şcoala gimnazială Constantin Muşat satul Nicoreşti",3,2249,"PÎRGĂREŞTI",24276,807,352,341,11,0,348,4,900,548,149,199
4,"BACĂU","#N/A",24276,,512,"BAHNA / Grădiniţa cu progr.normal Bahna",3,2249,"PÎRGĂREŞTI",24276,478,245,223,22,0,243,2,500,255,130,113
4,"BACĂU","#N/A",24427,,513,"PLOPANA / Primăria Plopana",3,2255,"PLOPANA",24427,781,439,376,54,9,431,8,900,461,313,118
4,"BACĂU","#N/A",24427,,514,"FUNDU TUTOVEI / Şcoala cu cl.I-IV satul Fundu Tutovei",3,2255,"PLOPANA",24427,489,289,253,27,9,284,5,500,211,218,66
4,"BACĂU","#N/A",24427,,515,"IŢCANI / Şcoala cu cl.I-IV satul Iţcani",3,2255,"PLOPANA",24427,628,419,366,47,6,412,7,700,281,346,66
4,"BACĂU","#N/A",24427,,516,"RUSENII DE SUS / Şcoala cu cl.I-VIII satul Rusenii-Răzeşi",3,2255,"PLOPANA",24427,323,237,190,39,8,232,5,399,162,155,77
4,"BACĂU","#N/A",24427,,517,"STRĂMINOASA / Şcoala cu cl.I-IV satul Stăminoasa",3,2255,"PLOPANA",24427,351,241,210,29,2,237,4,421,180,201,36
4,"BACĂU","#N/A",24524,,518,"PODU TURCULUI / Căminul Cultural Podu Turcului",3,2265,"PODU TURCULUI",24524,1860,1205,1058,111,36,1193,12,2100,895,744,449
4,"BACĂU","#N/A",24524,,519,"PODU TURCULUI / Şcoala Generală nr. 3 Podu Turcului",3,2265,"PODU TURCULUI",24524,528,352,336,16,0,350,2,600,248,244,106
4,"BACĂU","#N/A",24524,,520,"CĂBEŞTI / Căminul cultural satul Căbeşti",3,2265,"PODU TURCULUI",24524,798,534,457,77,0,524,10,900,366,290,234
4,"BACĂU","#N/A",24524,,521,"LEHANCEA / Şcoala generală satul Lehancea",3,2265,"PODU TURCULUI",24524,538,310,276,34,0,305,5,600,290,208,97
4,"BACĂU","#N/A",24524,,522,"SÎRBI / Şcoala generală satul Sîrbi",3,2265,"PODU TURCULUI",24524,391,275,258,16,1,273,2,399,124,214,59
4,"BACĂU","#N/A",24631,,523,"PODURI / Şcoala satul Poduri",3,2276,"PODURI",24631,1190,632,609,23,0,620,12,1300,668,346,274
4,"BACĂU","#N/A",24631,,524,"PODURI / Şcoala satul Poduri",3,2276,"PODURI",24631,987,553,512,41,0,543,10,1100,547,341,202
4,"BACĂU","#N/A",24631,,525,"VALEA ŞOŞII / Şcoala satul Valea Şosii",3,2276,"PODURI",24631,947,522,481,41,0,516,6,1000,478,335,181
4,"BACĂU","#N/A",24631,,526,"PROHOZEŞTI / Şcoala satul Prohozeşti",3,2276,"PODURI",24631,841,473,432,41,0,466,7,900,427,243,223
4,"BACĂU","#N/A",24631,,527,"BUCŞEŞTI / Şcoala satul Bucşeşti",3,2276,"PODURI",24631,1329,714,669,45,0,704,10,1500,786,353,351
4,"BACĂU","#N/A",24631,,528,"CERNU / Şcoala satul Cernu",3,2276,"PODURI",24631,1192,623,562,61,0,618,5,1300,677,442,176
4,"BACĂU","#N/A",26361,,529,"PRĂJEŞTI / Scoala Gimnaziala Gheorghe Avramescu Prajesti-Sala de Sport",3,2284,"PRĂJEŞTI",26361,965,457,386,71,0,446,11,1100,643,201,245
4,"BACĂU","#N/A",26361,,530,"PRĂJEŞTI / SCOALA GIMNAZIALA GHEORGHE AVRAMESCU PRĂJEŞTI - SALA CANCELARIEI",3,2284,"PRĂJEŞTI",26361,974,436,360,76,0,428,8,1100,664,193,235
4,"BACĂU","#N/A",24711,,531,"RACOVA / Şcoala nr.1 Ioan Borcea Racova",3,2309,"RACOVA",24711,1311,739,668,71,0,730,9,1400,661,475,255
4,"BACĂU","#N/A",24711,,532,"RACOVA / Şcoala nr.2 Racova-Şes",3,2309,"RACOVA",24711,595,383,343,40,0,382,1,600,217,228,154
4,"BACĂU","#N/A",24711,,533,"GURA VĂII / Şcoala satul Gura Văii",3,2309,"RACOVA",24711,1031,551,486,65,0,546,5,1100,549,375,171
4,"BACĂU","#N/A",24766,,534,"RĂCĂCIUNI / Casa de cultură Nicolae Stroesatul Răcăciuni",3,2286,"RĂCĂCIUNI",24766,1446,729,667,59,3,721,8,1600,871,279,442
4,"BACĂU","#N/A",24766,,535,"RĂCĂCIUNI / Grădiniţa nr.2 satul Răcăciuni",3,2286,"RĂCĂCIUNI",24766,1263,584,537,47,0,579,5,1400,816,294,285
4,"BACĂU","#N/A",24766,,536,"GHEORGHE DOJA / Şcoala cu cl.I-VIII satul Gheorghe Doja",3,2286,"RĂCĂCIUNI",24766,927,413,387,26,0,408,5,1000,587,151,257
4,"BACĂU","#N/A",24766,,537,"GÎŞTENI / Şcoala cu cl.I-VIII satul Gîşteni",3,2286,"RĂCĂCIUNI",24766,726,445,381,64,0,435,10,800,355,189,246
4,"BACĂU","#N/A",24766,,538,"FUNDU RĂCĂCIUNI / Şcoala cu cl.I-VIII satul Fundu Răcăciuni",3,2286,"RĂCĂCIUNI",24766,1518,698,679,19,0,685,13,1700,1002,267,418
4,"BACĂU","#N/A",24766,,539,"CIUCANI / Şcoala cu cl.I-IV satul Ciucani",3,2286,"RĂCĂCIUNI",24766,453,261,245,16,0,258,3,500,239,53,205
4,"BACĂU","#N/A",24837,,540,"RĂCHITOASA / Căminul cultural satul Răchitoasa",3,2293,"RĂCHITOASA",24837,1201,648,566,55,27,646,2,1300,652,477,169
4,"BACĂU","#N/A",24837,,541,"FUNDĂTURA RĂCHITOASA / Şcoala cu cl.I-IV satul Fundătura-Răchitoasa",3,2293,"RĂCHITOASA",24837,233,145,128,17,0,144,1,300,155,101,43
4,"BACĂU","#N/A",24837,,542,"DUMBRAVA / Şcoala cu cl.I-VIII satul Dumbrava",3,2293,"RĂCHITOASA",24837,534,322,303,19,0,317,5,600,278,264,53
4,"BACĂU","#N/A",24837,,543,"BURDUSACI / Şcoala cu cl.I-VIII satul Burdusaci",3,2293,"RĂCHITOASA",24837,732,431,370,50,11,424,7,800,369,314,110
4,"BACĂU","#N/A",24837,,544,"BARCANA / Şcoala cu cl.I-IV satul Barcana",3,2293,"RĂCHITOASA",24837,511,248,231,17,0,246,2,600,352,206,40
4,"BACĂU","#N/A",24837,,545,"BUDA / Şcoala cu cl.I-VIII satul Buda",3,2293,"RĂCHITOASA",24837,539,361,308,53,0,355,6,600,239,299,56
4,"BACĂU","#N/A",24999,,546,"ROŞIORI / Şcoala gimnazială nr.1 satul Roşiori",3,2314,"ROŞIORI",24999,989,650,575,63,12,645,5,1100,450,446,199
4,"BACĂU","#N/A",24999,,547,"POIENI / Şcoala primară satul Poieni",3,2314,"ROŞIORI",24999,279,185,153,28,4,182,3,300,115,119,63
4,"BACĂU","#N/A",24999,,548,"VALEA MARE / Şcoala primară satul Valea Mare",3,2314,"ROŞIORI",24999,459,315,257,50,8,311,4,500,185,240,71
4,"BACĂU","#N/A",25068,,549,"SASCUT / Liceul J.M.Elias Sascut",3,2332,"SASCUT",25068,1326,734,620,107,7,728,6,1500,766,323,405
4,"BACĂU","#N/A",25068,,550,"SASCUT / Liceul J.M.Elias Sascut",3,2332,"SASCUT",25068,1276,872,668,195,9,866,6,1400,528,428,438
4,"BACĂU","#N/A",25068,,551,"BEREŞTI / Căminul cultural  Bereşti",3,2332,"SASCUT",25068,1188,739,658,62,19,729,10,1300,561,302,427
4,"BACĂU","#N/A",25068,,552,"CONŢEŞTI / Scoala cu cl. I-IV satul Contesti",3,2332,"SASCUT",25068,454,346,296,44,6,336,10,500,154,183,153
4,"BACĂU","#N/A",25068,,553,"PĂNCEŞTI / Şcoala cu cl.I-VIII nr.1 satul Pănceşti",3,2332,"SASCUT",25068,1493,822,702,114,6,816,6,1600,778,348,468
4,"BACĂU","#N/A",25068,,554,"PĂNCEŞTI / Şcoala cu cl.I-VIII nr.2 satul Pănceşti",3,2332,"SASCUT",25068,781,452,409,43,0,450,2,900,448,175,275
4,"BACĂU","#N/A",25068,,555,"SASCUT-SAT / Şcoala cu cl.I-VIII satul Sascut-Sat",3,2332,"SASCUT",25068,941,587,530,48,9,585,2,1000,413,304,281
4,"BACĂU","#N/A",25068,,556,"SASCUT-SAT / Şcoala cu cl.I-VIII satul Sascut-Sat",3,2332,"SASCUT",25068,836,497,457,32,8,485,12,900,403,258,227
4,"BACĂU","#N/A",25148,,557,"SĂNDULENI / Şcoala gen.cu cl.I-VIII satul Sănduleni",3,2321,"SĂNDULENI",25148,1566,832,743,73,16,824,8,1695,863,580,244
4,"BACĂU","#N/A",25148,,558,"VERŞEŞTI / Şcoala gen.cu cl.I-VIII satul Verşeşti",3,2321,"SĂNDULENI",25148,684,429,383,40,6,426,3,700,271,364,62
4,"BACĂU","#N/A",25148,,559,"COMAN / Şcoala gen.cu cl.I-VIII satul Coman",3,2321,"SĂNDULENI",25148,1049,547,501,26,20,540,7,1193,646,400,140
4,"BACĂU","#N/A",25148,,560,"STUFU / Şcoala gen.cu cl.I-IV satul Stufu",3,2321,"SĂNDULENI",25148,300,178,159,19,0,176,2,400,222,96,80
4,"BACĂU","#N/A",26320,,561,"SĂRATA / Scoala nr. 1 Sărata",3,2329,"SĂRATA",26320,500,322,270,47,5,315,7,500,178,194,121
4,"BACĂU","#N/A",26320,,562,"BĂLŢATA / Scoala nr. 2 Sărata (scoala din catun Dealu Nou)",3,2329,"SĂRATA",26320,793,527,449,72,6,515,12,899,372,284,231
4,"BACĂU","#N/A",26320,,563,"SĂRATA / Scoala nr. 3 Sărata (scoala din catun Talpa)",3,2329,"SĂRATA",26320,454,261,231,24,6,259,2,495,234,142,117
4,"BACĂU","#N/A",25228,,564,"SĂUCEŞTI / Şcoala I.S.Sturza satul Săuceşti",3,2340,"SĂUCEŞTI",25228,1074,692,582,94,16,680,12,1200,508,376,304
4,"BACĂU","#N/A",25228,,565,"SĂUCEŞTI / Şcoala I.S.Sturza satul Săuceşti",3,2340,"SĂUCEŞTI",25228,931,606,521,85,0,590,16,1000,394,317,273
4,"BACĂU","#N/A",25228,,566,"SCHINENI / Şcoala satul Schineni",3,2340,"SĂUCEŞTI",25228,670,436,359,77,0,430,6,699,263,260,170
4,"BACĂU","#N/A",25228,,567,"SIRETU / Şcoala satul Siretu",3,2340,"SĂUCEŞTI",25228,638,447,357,83,7,436,11,700,253,263,173
4,"BACĂU","#N/A",25228,,568,"ŞERBEŞTI / Şcoala satul Şerbeşti",3,2340,"SĂUCEŞTI",25228,464,311,261,50,0,305,6,499,188,176,129
4,"BACĂU","#N/A",25228,,569,"BOGDAN VODĂ / Şcoala satul Bogdan Vodă",3,2340,"SĂUCEŞTI",25228,479,388,316,71,1,383,5,498,110,178,205
4,"BACĂU","#N/A",25291,,570,"SCORŢENI / Şcoala cu cl.I-VIII satul Scorţeni",3,2347,"SCORŢENI",25291,1254,597,565,32,0,591,6,1400,803,344,247
4,"BACĂU","#N/A",25291,,571,"GRIGORENI / Şcoala veche satul Grigoreni",3,2347,"SCORŢENI",25291,687,383,306,77,0,378,5,700,317,216,162
4,"BACĂU","#N/A",25291,,572,"FLOREŞTI / Şcoala cu cl.I-IV satul Floreşti",3,2347,"SCORŢENI",25291,548,266,233,33,0,261,5,600,334,137,124
4,"BACĂU","#N/A",25362,,573,"SECUIENI / Şcoala gimnazială satul Secuieni",3,2354,"SECUIENI",25362,1058,642,563,79,0,634,8,1200,558,331,303
4,"BACĂU","#N/A",25362,,574,"FUNDENI / Şcoala satul Fundeni",3,2354,"SECUIENI",25362,313,226,176,50,0,222,4,400,174,145,77
4,"BACĂU","#N/A",25362,,575,"CHITICENI / Şcoala satul Chiticeni",3,2354,"SECUIENI",25362,142,121,86,35,0,117,4,200,79,82,35
4,"BACĂU","#N/A",25362,,576,"GLODIŞOARELE / Şcoala satul Glodişoarele",3,2354,"SECUIENI",25362,202,132,117,15,0,131,1,300,168,89,42
4,"BACĂU","#N/A",25488,,577,"SOLONŢ / Şcoala cu cl.I-VIII satul Solonţ",3,2362,"SOLONŢ",25488,1271,706,652,48,6,697,9,1400,694,504,193
4,"BACĂU","#N/A",25488,,578,"SĂRATA / Şcoala cu cl.I-IV satul Sărata",3,2362,"SOLONŢ",25488,684,339,325,14,0,334,5,694,355,267,67
4,"BACĂU","#N/A",25488,,579,"CUCUIEŢI / Şcoala cu cl.I-VIII satul Cucuieşti",3,2362,"SOLONŢ",25488,1045,603,567,34,2,589,14,1100,497,463,126
4,"BACĂU","#N/A",25521,,580,"STĂNIŞEŞTI / Primăria Stănişeşti",3,2366,"STĂNIŞEŞTI",25521,823,480,432,48,0,476,4,902,422,351,125
4,"BACĂU","#N/A",25521,,581,"BENEŞTI / Şcoala satul Beneşti",3,2366,"STĂNIŞEŞTI",25521,411,249,238,11,0,243,6,496,247,189,54
4,"BACĂU","#N/A",25521,,582,"CRĂIEŞTI / Scoala satul Crăieşti",3,2366,"STĂNIŞEŞTI",25521,383,257,215,42,0,254,3,400,143,210,44
4,"BACĂU","#N/A",25521,,583,"SLOBOZIA / Şcoala 1 satul Slobozia",3,2366,"STĂNIŞEŞTI",25521,1254,590,547,43,0,585,5,1395,805,433,152
4,"BACĂU","#N/A",25521,,584,"SLOBOZIA NOUĂ / Şcoala satul Slobozia Nouă",3,2366,"STĂNIŞEŞTI",25521,541,295,274,21,0,291,4,600,305,221,70
4,"BACĂU","#N/A",25629,,585,"STRUGARI / Şcoala generală satul Strugari",3,2383,"STRUGARI",25629,1103,659,568,52,39,647,12,1200,541,472,175
4,"BACĂU","#N/A",25629,,586,"RĂCHITIŞU / Şcoala generală satul Răchitiş",3,2383,"STRUGARI",25629,336,237,183,21,33,233,4,390,153,181,52
4,"BACĂU","#N/A",25629,,587,"PETRICICA / Şcoala generală satul Petricica",3,2383,"STRUGARI",25629,581,344,278,54,12,339,5,600,256,231,108
4,"BACĂU","#N/A",20670,,588,"ŞTEFAN CEL MARE / Grădiniţa cu progr.normal satul Ştefan cel Mare",3,2376,"ŞTEFAN CEL MARE",20670,723,460,406,53,1,452,8,800,340,277,175
4,"BACĂU","#N/A",20670,,589,"BOGDANA / Grădiniţa cu progr.normal satul Bogdana",3,2376,"ŞTEFAN CEL MARE",20670,536,396,353,38,5,389,7,599,203,293,96
4,"BACĂU","#N/A",20670,,590,"NEGOIEŞTI / Biblioteca comunală satul Negoieşti",3,2376,"ŞTEFAN CEL MARE",20670,737,477,423,53,1,470,7,800,323,301,169
4,"BACĂU","#N/A",20670,,591,"VIIŞOARA / Grădiniţa cu progr.normal satul Viişoara",3,2376,"ŞTEFAN CEL MARE",20670,508,316,273,39,4,314,2,600,284,195,119
4,"BACĂU","#N/A",20670,,592,"GUTINAŞ / Grădiniţa cu progr.normal satul Gutinaş",3,2376,"ŞTEFAN CEL MARE",20670,365,256,212,43,1,252,4,400,144,202,50
4,"BACĂU","#N/A",20670,,593,"RĂDEANA / Grădiniţa cu progr.normal satul Rădeana",3,2376,"ŞTEFAN CEL MARE",20670,1125,795,745,44,6,763,32,1200,405,600,163
4,"BACĂU","#N/A",25692,,594,"TAMAŞI / Centrul educaţional Înv.Dumitru Nediţă Tamaşi",3,2390,"TAMAŞI",25692,1211,855,739,108,8,844,11,1301,446,621,223
4,"BACĂU","#N/A",25692,,595,"CHETRIŞ / Şcoala cu cl.I-VIII satul Chetriş",3,2390,"TAMAŞI",25692,634,492,398,90,4,488,4,702,210,315,173
4,"BACĂU","#N/A",25692,,596,"FURNICARI / Şcoala cu cl.I-IV satul Furnicari",3,2390,"TAMAŞI",25692,506,329,292,34,3,325,4,605,276,256,69
4,"BACĂU","#N/A",25745,,597,"TĂTĂRĂŞTI / Primăria Tătărăşti",3,2394,"TĂTĂRĂŞTI",25745,376,244,203,41,0,239,5,400,156,158,81
4,"BACĂU","#N/A",25745,,598,"CORNII DE SUS / Şcoala gen.de 8 ani satul Cornii de Sus",3,2394,"TĂTĂRĂŞTI",25745,773,399,362,37,0,384,15,800,401,287,97
4,"BACĂU","#N/A",25745,,599,"GIURGENI / Şcoala gen.de 4 ani satul Giurgeni",3,2394,"TĂTĂRĂŞTI",25745,192,140,121,19,0,136,4,200,60,104,32
4,"BACĂU","#N/A",25745,,600,"DRĂGEŞTI / Şcoala gen.de 4 ani satul Drăgeşti",3,2394,"TĂTĂRĂŞTI",25745,317,204,189,15,0,202,2,400,196,147,55
4,"BACĂU","#N/A",25745,,601,"GHERDANA / Şcoala gen.de 8 ani satul Gherdana",3,2394,"TĂTĂRĂŞTI",25745,308,197,173,24,0,195,2,400,203,146,49
4,"BACĂU","#N/A",25825,,602,"VIIŞOARA / Grădiniţa cu progr.normal satul Viişoara",3,2402,"TÎRGU TROTUŞ",25825,945,548,503,45,0,539,9,1000,452,318,221
4,"BACĂU","#N/A",25825,,603,"TÎRGU TROTUŞ / Grădiniţa cu progr.normal Tg.Trotuş",3,2402,"TÎRGU TROTUŞ",25825,927,533,471,62,0,529,4,1000,467,325,204
4,"BACĂU","#N/A",25825,,604,"TÎRGU TROTUŞ / Grădiniţa cu progr.normal Tg.Trotuş",3,2402,"TÎRGU TROTUŞ",25825,921,546,491,55,0,539,7,1000,454,327,212
4,"BACĂU","#N/A",25825,,605,"TUTA / Grădiniţa cu progr.normal satul Tuta",3,2402,"TÎRGU TROTUŞ",25825,833,472,461,10,1,469,3,900,428,279,190
4,"BACĂU","#N/A",25825,,606,"TUTA / Grădiniţa cu progr.normal satul Tuta",3,2402,"TÎRGU TROTUŞ",25825,928,534,518,16,0,530,4,1000,466,321,209
4,"BACĂU","#N/A",25861,,607,"TRAIAN / Şcoala cu cl.I-VIII satul Traian",3,2406,"TRAIAN",25861,1356,677,553,117,7,668,9,1500,823,250,418
4,"BACĂU","#N/A",25861,,608,"BOGDĂNEŞTI / Şcoala cu cl.I-IV satul Bogdăneşti",3,2406,"TRAIAN",25861,451,239,200,39,0,236,3,500,261,63,173
4,"BACĂU","#N/A",25861,,609,"ZĂPODIA / Şcoala cu cl.I-IV satul Zăpodia",3,2406,"TRAIAN",25861,498,225,188,37,0,222,3,500,275,75,147
4,"BACĂU","#N/A",25861,,610,"HERTIOANA DE JOS / Şcoala cu cl.I-IV satul Herţioana de Jos",3,2406,"TRAIAN",25861,161,106,65,41,0,105,1,200,94,33,72
4,"BACĂU","#N/A",25932,,611,"UNGURENI / Căminul cultural Ungureni",3,2412,"UNGURENI",25932,799,446,360,82,4,439,7,900,454,323,116
4,"BACĂU","#N/A",25932,,612,"VIFORENI / Căminul cultural satul Viforeni",3,2412,"UNGURENI",25932,375,233,193,32,8,228,5,400,167,171,57
4,"BACĂU","#N/A",25932,,613,"BĂRTĂŞEŞTI / Şcoala satul Bărtăşeşti",3,2412,"UNGURENI",25932,278,166,149,17,0,166,0,300,134,137,29
4,"BACĂU","#N/A",25932,,614,"BOTEŞTI / Căminul cultural satul Boteşti",3,2412,"UNGURENI",25932,665,355,318,26,11,354,1,700,345,254,100
4,"BACĂU","#N/A",25932,,615,"BIBIREŞTI / Căminul cultural satulBibireşti II",3,2412,"UNGURENI",25932,756,475,425,50,0,471,4,800,325,307,164
4,"BACĂU","#N/A",26029,,616,"URECHEŞTI / Sala de ceremonii",3,2421,"URECHEŞTI",26029,1422,868,776,92,0,855,13,1600,732,393,462
4,"BACĂU","#N/A",26029,,617,"CORNĂŢEL / Căminul cultural satul Cornăţel",3,2421,"URECHEŞTI",26029,703,404,360,44,0,392,12,800,396,203,189
4,"BACĂU","#N/A",26029,,618,"SLOBOZIA / Grădiniţa satul Slobozia",3,2421,"URECHEŞTI",26029,456,291,254,37,0,284,7,501,210,118,166
4,"BACĂU","#N/A",26029,,619,"LUNCA DOCHIEI / Şcoala gen.cu cl.I-IV satul Lunca Dochiei",3,2421,"URECHEŞTI",26029,293,165,143,22,0,161,4,299,134,82,79
4,"BACĂU","#N/A",26029,,620,"SATU NOU / Şcoala gen.cu cl.I-IV satul Satu Nou",3,2421,"URECHEŞTI",26029,267,191,164,26,1,188,3,300,109,129,59
4,"BACĂU","#N/A",26083,,621,"VALEA SEACĂ / Şcoala gimnazială nr.1 Valea Seacă",3,2427,"VALEA SEACĂ",26083,938,462,407,46,9,459,3,1000,538,377,82
4,"BACĂU","#N/A",26083,,622,"VALEA SEACĂ / Şcoala primară nr.2 Valea Seacă",3,2427,"VALEA SEACĂ",26083,629,414,346,62,6,413,1,700,286,304,109
4,"BACĂU","#N/A",26083,,623,"VALEA SEACĂ / Şcoala primară nr.3 Valea Seacă",3,2427,"VALEA SEACĂ",26083,761,424,362,46,16,424,0,800,376,364,60
4,"BACĂU","#N/A",26083,,624,"CUCOVA / Şcoala primară Cucova",3,2427,"VALEA SEACĂ",26083,579,357,285,65,7,353,4,600,243,259,94
4,"BACĂU","#N/A",26118,,625,"VULTURENI / scoala Vultureni",3,2430,"VULTURENI",26118,420,247,207,39,1,242,5,500,253,138,104
4,"BACĂU","#N/A",26118,,626,"LICHITIŞENI / SOCIETATEA AREAL SA",3,2430,"VULTURENI",26118,472,263,242,21,0,258,5,500,237,149,109
4,"BACĂU","#N/A",26118,,627,"GODINEŞTII DE JOS / Centrul Educaţional ComunitarGodineştii de Jos",3,2430,"VULTURENI",26118,311,207,170,33,4,204,3,400,193,117,87
4,"BACĂU","#N/A",26118,,628,"MEDELENI / Şcoala Medeleni",3,2430,"VULTURENI",26118,159,115,91,24,0,112,3,200,85,48,64
4,"BACĂU","#N/A",26118,,629,"GHILĂVEŞTI / Şcoala Ghilăveşti",3,2430,"VULTURENI",26118,235,165,151,14,0,162,3,300,135,70,92
4,"BACĂU","#N/A",26289,,630,"ZEMEŞ / Şcoala Mihai Eminescu Zemeş",3,2447,"ZEMEŞ",26289,1078,644,601,43,0,639,5,1200,556,347,292
4,"BACĂU","#N/A",26289,,631,"ZEMEŞ / Şcoala Stefan cel Mare Zemeş",3,2447,"ZEMEŞ",26289,1968,1212,1162,48,2,1191,21,2200,988,646,545
4,"BACĂU","#N/A",26289,,632,"BOLĂTĂU / Şcoala Ion Creangă Zemeş",3,2447,"ZEMEŞ",26289,889,528,507,21,0,522,6,1000,472,305,217
5,"BIHOR",56,26564,,1,"ORADEA / Universitatea Parţium",1,2451,"MUNICIPIUL ORADEA",26564,1113,707,620,87,0,703,4,1225,518,188,515
5,"BIHOR",56,26564,,2,"ORADEA / Şcoala Gimnazială ""Lucreţia Suciu""",1,2451,"MUNICIPIUL ORADEA",26564,1245,668,635,33,0,660,8,1371,703,186,474
5,"BIHOR",56,26564,,3,"ORADEA / Liceul Tehnologic Sanitar  ""Vasile Voiculescu""",1,2451,"MUNICIPIUL ORADEA",26564,1342,839,730,37,72,827,12,1477,638,281,546
5,"BIHOR",56,26564,,4,"ORADEA / Liceul Tehnologic Sanitar  ""Vasile Voiculescu""",1,2451,"MUNICIPIUL ORADEA",26564,1400,716,687,29,0,708,8,1542,826,182,526
5,"BIHOR",56,26564,,5,"ORADEA / Grădiniţa cu Program Prelungit nr.22",1,2451,"MUNICIPIUL ORADEA",26564,1504,729,676,53,0,727,2,1654,925,210,517
5,"BIHOR",56,26564,,6,"ORADEA / Grădiniţa cu Program Prelungit nr.22",1,2451,"MUNICIPIUL ORADEA",26564,1566,947,887,60,0,934,13,1724,777,286,648
5,"BIHOR",56,26564,,7,"ORADEA / Grădiniţa cu Program Normal nr.1",1,2451,"MUNICIPIUL ORADEA",26564,1022,541,506,35,0,538,3,1125,584,202,336
5,"BIHOR",56,26564,,8,"ORADEA / Grădiniţa cu Program Normal nr.1",1,2451,"MUNICIPIUL ORADEA",26564,1162,663,629,34,0,657,6,1281,618,217,440
5,"BIHOR",56,26564,,9,"ORADEA / Creşa nr.2 - ""Picioruşe Vesele""",1,2451,"MUNICIPIUL ORADEA",26564,1318,736,694,42,0,726,10,1451,715,186,540
5,"BIHOR",56,26564,,10,"ORADEA / Şcoala Gimnazială ""Ioan Slavici""",1,2451,"MUNICIPIUL ORADEA",26564,1433,921,841,80,0,907,14,1577,656,319,588
5,"BIHOR",56,26564,,11,"ORADEA / Şcoala Gimnazială ""Ioan Slavici""",1,2451,"MUNICIPIUL ORADEA",26564,1638,1036,986,50,0,1015,21,1803,767,411,604
5,"BIHOR",56,26564,,12,"ORADEA / Şcoala Gimnazială ""Ioan Slavici""",1,2451,"MUNICIPIUL ORADEA",26564,1218,730,682,48,0,728,2,1341,611,201,527
5,"BIHOR",56,26564,,13,"ORADEA / Şcoala Gimnazială  ""Ioan Slavici""",1,2451,"MUNICIPIUL ORADEA",26564,1373,695,643,51,1,685,10,1511,816,222,463
5,"BIHOR",56,26564,,14,"ORADEA / Şcoala Gimnazială  ""Ioan Slavici""",1,2451,"MUNICIPIUL ORADEA",26564,781,411,388,23,0,405,6,860,449,118,287
5,"BIHOR",56,26564,,15,"ORADEA / Grădiniţa cu program prelungit nr.25",1,2451,"MUNICIPIUL ORADEA",26564,688,386,359,27,0,382,4,758,372,132,250
5,"BIHOR",56,26564,,16,"ORADEA / Grădiniţa cu program prelungit nr.25",1,2451,"MUNICIPIUL ORADEA",26564,1153,585,545,40,0,577,8,1269,684,173,404
5,"BIHOR",56,26564,,17,"ORADEA / Şcoala Gimnazială ""Dimitrie Cantemir""",1,2451,"MUNICIPIUL ORADEA",26564,726,548,443,105,0,543,5,800,252,177,366
5,"BIHOR",56,26564,,18,"ORADEA / Şcoala Gimnazială ""Dimitrie Cantemir""",1,2451,"MUNICIPIUL ORADEA",26564,1140,739,696,43,0,731,8,1255,516,202,529
5,"BIHOR",56,26564,,19,"ORADEA / Şcoala Gimnazială ""Dimitrie Cantemir""",1,2451,"MUNICIPIUL ORADEA",26564,1519,917,882,35,0,913,4,1672,755,256,657
5,"BIHOR",56,26564,,20,"ORADEA / Grădiniţa cu program prelungit nr.24",1,2451,"MUNICIPIUL ORADEA",26564,1501,945,875,69,1,935,10,1652,707,322,613
5,"BIHOR",56,26564,,21,"ORADEA / Căminul de bătrâni ""Sfântul Martin""",1,2451,"MUNICIPIUL ORADEA",26564,1924,1181,1054,127,0,1168,13,2117,936,320,848
5,"BIHOR",56,26564,,22,"ORADEA / Grădiniţa cu program normal nr.2",1,2451,"MUNICIPIUL ORADEA",26564,1773,1173,979,194,0,1162,11,1951,778,335,827
5,"BIHOR",56,26564,,23,"ORADEA / Grădiniţa cu program prelungit nr. 56",1,2451,"MUNICIPIUL ORADEA",26564,1822,1180,1124,56,0,1165,15,2005,825,379,786
5,"BIHOR",56,26564,,24,"ORADEA / Grădiniţa cu program prelungit nr. 56",1,2451,"MUNICIPIUL ORADEA",26564,1680,942,881,61,0,928,14,1849,907,297,631
5,"BIHOR",56,26564,,25,"ORADEA / Grădiniţa cu program prelungit nr. 56",1,2451,"MUNICIPIUL ORADEA",26564,1946,1152,1089,62,1,1141,11,2142,990,402,739
5,"BIHOR",56,26564,,26,"ORADEA / Grădiniţa cu program prelungit nr. 56",1,2451,"MUNICIPIUL ORADEA",26564,1965,1170,1117,53,0,1153,17,2163,993,375,778
5,"BIHOR",56,26564,,27,"ORADEA / Liceul teoretic ""Onisifor Ghibu""",1,2451,"MUNICIPIUL ORADEA",26564,1091,677,589,88,0,669,8,1201,524,257,412
5,"BIHOR",56,26564,,28,"ORADEA / Liceul teoretic ""Onisifor Ghibu""",1,2451,"MUNICIPIUL ORADEA",26564,968,566,517,49,0,563,3,1066,500,182,381
5,"BIHOR",56,26564,,29,"ORADEA / Liceul teoretic ""Onisifor Ghibu""",1,2451,"MUNICIPIUL ORADEA",26564,1319,720,616,103,1,714,6,1452,732,193,521
5,"BIHOR",56,26564,,30,"ORADEA / Liceul teoretic ""Onisifor Ghibu""",1,2451,"MUNICIPIUL ORADEA",26564,1539,900,845,55,0,891,9,1694,794,297,594
5,"BIHOR",56,26564,,31,"ORADEA / Liceul teoretic ""Onisifor Ghibu""",1,2451,"MUNICIPIUL ORADEA",26564,1610,909,862,46,1,896,13,1772,863,273,623
5,"BIHOR",56,26564,,32,"ORADEA / Grădiniţa cu program prelungit nr. 28",1,2451,"MUNICIPIUL ORADEA",26564,1544,934,863,71,0,923,11,1699,765,308,615
5,"BIHOR",56,26564,,33,"ORADEA / Grădiniţa cu program prelungit nr. 28",1,2451,"MUNICIPIUL ORADEA",26564,1675,961,891,70,0,953,8,1844,883,303,650
5,"BIHOR",56,26564,,34,"ORADEA / Creşa nr.13 "" Lizuca şi Patrocle""",1,2451,"MUNICIPIUL ORADEA",26564,1370,899,842,55,2,892,7,1508,609,290,602
5,"BIHOR",56,26564,,35,"ORADEA / Creşa nr.13 "" Lizuca şi Patrocle""",1,2451,"MUNICIPIUL ORADEA",26564,1324,831,771,60,0,822,9,1457,626,296,526
5,"BIHOR",56,26564,,36,"ORADEA / Şcoala Gimnazială  ""Dimitrie Cantemir""",1,2451,"MUNICIPIUL ORADEA",26564,1383,819,750,68,1,812,7,1522,703,270,542
5,"BIHOR",56,26564,,37,"ORADEA / Şcoala Gimnazială  ""Dimitrie Cantemir""",1,2451,"MUNICIPIUL ORADEA",26564,1503,860,799,60,1,852,8,1654,794,287,565
5,"BIHOR",56,26564,,38,"ORADEA / Grădiniţa cu program prelungit nr.46",1,2451,"MUNICIPIUL ORADEA",26564,1292,729,702,27,0,719,10,1422,692,241,478
5,"BIHOR",56,26564,,39,"ORADEA / Grădiniţa cu program prelungit nr.46",1,2451,"MUNICIPIUL ORADEA",26564,1237,650,592,57,1,642,8,1362,712,246,396
5,"BIHOR",56,26564,,40,"ORADEA / Şcoala Gimnazială ""Nicolae Bălcescu""",1,2451,"MUNICIPIUL ORADEA",26564,1161,753,686,62,5,740,13,1278,525,245,495
5,"BIHOR",56,26564,,41,"ORADEA / Colegiul Economic ""Partenie Cosma""",1,2451,"MUNICIPIUL ORADEA",26564,679,575,363,212,0,569,6,748,173,141,428
5,"BIHOR",56,26564,,42,"ORADEA / Şcoala Gimnazială  ""Oltea Doamna""",1,2451,"MUNICIPIUL ORADEA",26564,428,235,226,9,0,234,1,472,237,45,189
5,"BIHOR",56,26564,,43,"ORADEA / Grădiniţa cu program prelungit nr.53",1,2451,"MUNICIPIUL ORADEA",26564,868,517,454,63,0,514,3,956,439,121,393
5,"BIHOR",56,26564,,44,"ORADEA / Grădiniţa cu program prelungit nr.53",1,2451,"MUNICIPIUL ORADEA",26564,879,505,480,24,1,497,8,968,463,160,337
5,"BIHOR",56,26564,,45,"ORADEA / Grădiniţa cu program prelungit nr.52",1,2451,"MUNICIPIUL ORADEA",26564,914,435,409,26,0,425,10,1006,571,144,281
5,"BIHOR",56,26564,,46,"ORADEA / Grădiniţa cu program prelungit nr.52",1,2451,"MUNICIPIUL ORADEA",26564,1391,743,713,29,1,736,7,1530,787,226,510
5,"BIHOR",56,26564,,47,"ORADEA / Grădiniţa cu program prelungit nr.52",1,2451,"MUNICIPIUL ORADEA",26564,1070,533,499,34,0,526,7,1178,645,153,373
5,"BIHOR",56,26564,,48,"ORADEA / Şcoala Gimnaziala nr.16",1,2451,"MUNICIPIUL ORADEA",26564,1082,690,622,68,0,679,11,1191,501,235,444
5,"BIHOR",56,26564,,49,"ORADEA / Şcoala Gimnazială nr.16",1,2451,"MUNICIPIUL ORADEA",26564,894,541,515,26,0,536,5,987,446,180,356
5,"BIHOR",56,26564,,50,"ORADEA / Şcoala Gimnazială nr.16",1,2451,"MUNICIPIUL ORADEA",26564,1057,671,603,68,0,656,15,1164,493,201,455
5,"BIHOR",56,26564,,51,"ORADEA / Şcoala  Gimnazială nr.16",1,2451,"MUNICIPIUL ORADEA",26564,1525,857,815,42,0,843,14,1679,822,243,600
5,"BIHOR",56,26564,,52,"ORADEA / Liceul Teoretic ""Lucian Blaga""",1,2451,"MUNICIPIUL ORADEA",26564,1341,834,734,100,0,818,16,1476,642,278,540
5,"BIHOR",56,26564,,53,"ORADEA / Liceul Teoretic ""Lucian Blaga""",1,2451,"MUNICIPIUL ORADEA",26564,1653,961,890,71,0,950,11,1819,858,265,685
5,"BIHOR",56,26564,,54,"ORADEA / Liceul Teoretic ""Lucian Blaga""",1,2451,"MUNICIPIUL ORADEA",26564,1396,849,812,36,1,833,16,1536,687,302,531
5,"BIHOR",56,26564,,55,"ORADEA / Liceul Teoretic ""Lucian Blaga""",1,2451,"MUNICIPIUL ORADEA",26564,1467,789,747,42,0,785,4,1615,826,264,521
5,"BIHOR",56,26564,,56,"ORADEA / Grădiniţa cu program normal nr.17",1,2451,"MUNICIPIUL ORADEA",26564,1716,1014,961,51,2,998,16,1889,875,322,676
5,"BIHOR",56,26564,,57,"ORADEA / Grădiniţa cu program prelungit nr.20",1,2451,"MUNICIPIUL ORADEA",26564,1506,868,775,92,1,863,5,1658,790,283,580
5,"BIHOR",56,26564,,58,"ORADEA / Liceul Ortodox ""Episcop Roman Ciorogariu""",1,2451,"MUNICIPIUL ORADEA",26564,844,502,438,64,0,496,6,967,465,170,326
5,"BIHOR",56,26564,,59,"ORADEA / Liceul Ortodox ""Episcop Roman Ciorogariu""",1,2451,"MUNICIPIUL ORADEA",26564,837,547,494,52,1,540,7,922,375,155,385
5,"BIHOR",56,26564,,60,"ORADEA / Liceul Ortodox ""Episcop Roman Ciorogariu""",1,2451,"MUNICIPIUL ORADEA",26564,967,580,535,45,0,574,6,1065,485,173,401
5,"BIHOR",56,26564,,61,"ORADEA / Liceul Ortodox ""Episcop Roman Ciorogariu""",1,2451,"MUNICIPIUL ORADEA",26564,1317,748,713,35,0,740,8,1450,702,201,539
5,"BIHOR",56,26564,,62,"ORADEA / Liceul Ortodox ""Episcop Roman Ciorogariu""",1,2451,"MUNICIPIUL ORADEA",26564,1508,878,837,41,0,866,12,1660,782,270,596
5,"BIHOR",56,26564,,63,"ORADEA / Liceul Ortodox ""Episcop Roman Ciorogariu""",1,2451,"MUNICIPIUL ORADEA",26564,1368,854,831,23,0,843,11,1506,652,260,583
5,"BIHOR",56,26564,,64,"ORADEA / Grădiniţa cu program prelungit nr. 54",1,2451,"MUNICIPIUL ORADEA",26564,1044,721,652,69,0,716,5,1149,428,291,425
5,"BIHOR",56,26564,,65,"ORADEA / Grădiniţa cu program prelungit nr. 54",1,2451,"MUNICIPIUL ORADEA",26564,1098,698,655,41,2,694,4,1208,510,202,492
5,"BIHOR",56,26564,,66,"ORADEA / Grădiniţa cu program prelungit nr. 37 ( fosta Gradinita "" Metalica "")",1,2451,"MUNICIPIUL ORADEA",26564,1432,934,838,96,0,922,12,1575,641,276,646
5,"BIHOR",56,26564,,67,"ORADEA / Grădiniţa cu program prelungit nr. 37 ( fosta Gradinita "" Metalica "")",1,2451,"MUNICIPIUL ORADEA",26564,1446,945,851,91,3,935,10,1591,646,291,644
5,"BIHOR",56,26564,,68,"ORADEA / Gradinita cu program prelungit nr. 37 ( fosta Gradinita "" Metalica "")",1,2451,"MUNICIPIUL ORADEA",26564,1578,930,889,41,0,917,13,1737,807,291,626
5,"BIHOR",56,26564,,69,"ORADEA / Grădiniţa cu program prelungit nr. 45",1,2451,"MUNICIPIUL ORADEA",26564,1092,745,663,81,1,737,8,1201,456,235,502
5,"BIHOR",56,26564,,70,"ORADEA / Grădiniţa cu program prelungit nr. 45",1,2451,"MUNICIPIUL ORADEA",26564,1419,906,838,68,0,890,16,1562,656,292,598
5,"BIHOR",56,26564,,71,"ORADEA / Grădiniţa cu program prelungit nr. 45",1,2451,"MUNICIPIUL ORADEA",26564,1490,877,845,30,2,870,7,1640,763,306,564
5,"BIHOR",56,26564,,72,"ORADEA / Grădiniţa cu program prelungit nr. 45",1,2451,"MUNICIPIUL ORADEA",26564,1252,775,730,45,0,765,10,1377,602,247,518
5,"BIHOR",56,26564,,73,"ORADEA / Colegiul Tehnic ""Constantin Brâncuşi""",1,2451,"MUNICIPIUL ORADEA",26564,1410,864,825,39,0,855,9,1552,688,252,603
5,"BIHOR",56,26564,,74,"ORADEA / Colegiul Tehnic ""Constantin Brâncuşi""",1,2451,"MUNICIPIUL ORADEA",26564,1600,1000,914,85,1,986,14,1761,761,308,678
5,"BIHOR",56,26564,,75,"ORADEA / Colegiul Tehnic ""Constantin Brâncuşi""",1,2451,"MUNICIPIUL ORADEA",26564,1676,1060,984,76,0,1051,9,1845,785,304,747
5,"BIHOR",56,26564,,76,"ORADEA / Şcoala Gimnazială ""Dacia""",1,2451,"MUNICIPIUL ORADEA",26564,1330,845,766,78,1,837,8,1464,619,343,494
5,"BIHOR",56,26564,,77,"ORADEA / Şcoala Gimnazială ""Dacia""",1,2451,"MUNICIPIUL ORADEA",26564,1573,872,806,66,0,856,16,1731,859,273,583
5,"BIHOR",56,26564,,78,"ORADEA / Şcoala Gimnazială ""Dacia""",1,2451,"MUNICIPIUL ORADEA",26564,1152,745,653,92,0,730,15,1268,523,198,532
5,"BIHOR",56,26564,,79,"ORADEA / Orăşelul  Copiilor",1,2451,"MUNICIPIUL ORADEA",26564,1645,1214,948,117,149,1196,18,1812,598,366,830
5,"BIHOR",56,26564,,80,"ORADEA / Grădiniţa cu program normal nr. 15",1,2451,"MUNICIPIUL ORADEA",26564,1756,938,900,38,0,931,7,1933,995,152,779
5,"BIHOR",56,26564,,81,"ORADEA / Şcoala Gimnazială  ""Juhasz Gyula""",1,2451,"MUNICIPIUL ORADEA",26564,936,514,485,29,0,509,5,1031,517,90,419
5,"BIHOR",56,26564,,82,"ORADEA / Şcoala Gimnazială ""Juhasz Gyula""",1,2451,"MUNICIPIUL ORADEA",26564,1096,551,531,20,0,547,4,1207,656,79,468
5,"BIHOR",56,26564,,83,"ORADEA / Sala Sporturilor",1,2451,"MUNICIPIUL ORADEA",26564,1642,1066,983,83,0,1052,14,1807,741,348,704
5,"BIHOR",56,26564,,84,"ORADEA / Sala Sporturilor",1,2451,"MUNICIPIUL ORADEA",26564,910,645,520,125,0,637,8,1002,357,217,420
5,"BIHOR",56,26564,,85,"ORADEA / Sala Sporturilor",1,2451,"MUNICIPIUL ORADEA",26564,1435,921,855,66,0,907,14,1580,659,278,629
5,"BIHOR",56,26564,,86,"ORADEA / Şcoala Gimnazială  ""Octavian Goga""",1,2451,"MUNICIPIUL ORADEA",26564,1509,974,890,84,0,965,9,1661,687,324,641
5,"BIHOR",56,26564,,87,"ORADEA / Şcoala Gimnazială ""Octavian Goga""",1,2451,"MUNICIPIUL ORADEA",26564,1516,901,842,59,0,883,18,1669,768,296,587
5,"BIHOR",56,26564,,88,"ORADEA / Colegiul Tehnic ""Transilvania""",1,2451,"MUNICIPIUL ORADEA",26564,1626,957,901,56,0,949,8,1790,833,357,592
5,"BIHOR",56,26564,,89,"ORADEA / Colegiul Tehnic ""Transilvania""",1,2451,"MUNICIPIUL ORADEA",26564,1625,1006,938,68,0,1001,5,1789,783,324,677
5,"BIHOR",56,26564,,90,"ORADEA / Colegiul Tehnic ""Traian Vuia""",1,2451,"MUNICIPIUL ORADEA",26564,1013,650,591,57,2,642,8,1115,465,231,411
5,"BIHOR",56,26564,,91,"ORADEA / Grădiniţa cu program prelungit  nr. 55",1,2451,"MUNICIPIUL ORADEA",26564,1192,805,766,39,0,795,10,1312,507,304,491
5,"BIHOR",56,26564,,92,"ORADEA / Fundaţia de scleroză multiplă",1,2451,"MUNICIPIUL ORADEA",26564,1264,729,693,36,0,724,5,1391,662,194,530
5,"BIHOR",56,26564,,93,"ORADEA / Fundaţia de scleroză multiplă",1,2451,"MUNICIPIUL ORADEA",26564,1367,725,689,36,0,720,5,1504,779,233,487
5,"BIHOR",56,26564,,94,"ORADEA / Grădiniţa cu program prelungit  nr. 35",1,2451,"MUNICIPIUL ORADEA",26564,1251,702,619,83,0,698,4,1377,675,197,501
5,"BIHOR",56,26564,,95,"ORADEA / Grădiniţa cu program prelungit nr. 35",1,2451,"MUNICIPIUL ORADEA",26564,1063,656,618,38,0,643,13,1170,514,214,429
5,"BIHOR",56,26564,,96,"ORADEA / Centrul de Îngrijire de Zi",1,2451,"MUNICIPIUL ORADEA",26564,1651,969,935,33,1,961,8,1817,848,289,672
5,"BIHOR",56,26564,,97,"ORADEA / Centrul de Îngrijire de Zi",1,2451,"MUNICIPIUL ORADEA",26564,1310,740,705,35,0,731,9,1442,702,251,480
5,"BIHOR",56,26564,,98,"ORADEA / Centru Şcolar Pentru Educaţie Incluzivă ""Orizont""",1,2451,"MUNICIPIUL ORADEA",26564,1472,811,770,40,1,810,1,1620,809,268,542
5,"BIHOR",56,26564,,99,"ORADEA / Şcoala Gimnazială nr. 11",1,2451,"MUNICIPIUL ORADEA",26564,1149,729,621,107,1,724,5,1265,536,205,519
5,"BIHOR",56,26564,,100,"ORADEA / Şcoala Gimnazială nr. 11",1,2451,"MUNICIPIUL ORADEA",26564,1640,982,898,84,0,970,12,1805,823,323,647
5,"BIHOR",56,26564,,101,"ORADEA / Şcoala Gimnazială nr. 11",1,2451,"MUNICIPIUL ORADEA",26564,1265,778,725,53,0,766,12,1393,615,271,495
5,"BIHOR",56,26564,,102,"ORADEA / Şcoala Gimnazială nr. 11",1,2451,"MUNICIPIUL ORADEA",26564,1084,609,581,27,1,599,10,1195,586,190,409
5,"BIHOR",56,26564,,103,"ORADEA / Şcoala Gimnazială nr. 11",1,2451,"MUNICIPIUL ORADEA",26564,1565,953,915,38,0,941,12,1723,770,329,612
5,"BIHOR",56,26564,,104,"ORADEA / Şcoala Gimnazială nr. 11",1,2451,"MUNICIPIUL ORADEA",26564,1419,887,830,56,1,877,10,1562,675,276,601
5,"BIHOR",56,26564,,105,"ORADEA / Şcoala Gimnazială nr. 11",1,2451,"MUNICIPIUL ORADEA",26564,839,520,487,33,0,519,1,923,403,162,357
5,"BIHOR",56,26564,,106,"ORADEA / Şcoala Gimnazială nr. 11",1,2451,"MUNICIPIUL ORADEA",26564,1430,815,781,34,0,810,5,1574,759,267,543
5,"BIHOR",56,26564,,107,"ORADEA / Grădiniţa cu program prelungit nr. 41",1,2451,"MUNICIPIUL ORADEA",26564,1821,1078,1017,61,0,1068,10,2004,926,270,798
5,"BIHOR",56,26564,,108,"ORADEA / Grădiniţa cu program prelungit nr. 41",1,2451,"MUNICIPIUL ORADEA",26564,1492,876,831,45,0,869,7,1642,766,237,632
5,"BIHOR",56,26564,,109,"ORADEA / Şcoala Gimnazială  ""Ion Bogdan""",1,2451,"MUNICIPIUL ORADEA",26564,1802,1152,1084,68,0,1137,15,1983,831,295,842
5,"BIHOR",56,26564,,110,"ORADEA / Şcoala Gimnazială  ""Ion Bogdan""",1,2451,"MUNICIPIUL ORADEA",26564,1917,1309,1136,59,114,1290,19,2110,801,385,905
5,"BIHOR",56,26564,,111,"ORADEA / Grădiniţa ""Waldorf "" ( fostă Şcoala Gimnazială ""Dacia"")",1,2451,"MUNICIPIUL ORADEA",26564,1194,794,763,31,0,783,11,1314,520,206,577
5,"BIHOR",56,26564,,112,"ORADEA / Grădiniţa ""Waldorf "" ( fostă Şcoala Gimnazială ""Dacia"")",1,2451,"MUNICIPIUL ORADEA",26564,1173,738,691,47,0,731,7,1291,553,212,519
5,"BIHOR",56,26564,,113,"ORADEA / Grădiniţa cu program prelungit nr. 23",1,2451,"MUNICIPIUL ORADEA",26564,1101,783,592,97,94,770,13,1212,429,209,561
5,"BIHOR",56,26564,,114,"ORADEA / Grădiniţa cu program prelungit nr. 23",1,2451,"MUNICIPIUL ORADEA",26564,1698,1099,1054,45,0,1084,15,1869,770,280,804
5,"BIHOR",56,26564,,115,"ORADEA / Grădiniţa cu program normal nr. 16",1,2451,"MUNICIPIUL ORADEA",26564,1989,1286,1183,100,3,1277,9,2189,903,336,941
5,"BIHOR",56,26564,,116,"ORADEA / Universitatea din  Oradea Facultatea de Textile-Pielărie",1,2451,"MUNICIPIUL ORADEA",26564,1152,774,648,37,89,768,6,1268,494,218,550
5,"BIHOR",56,26564,,117,"ORADEA / Universitatea din  Oradea Facultatea de Textile-Pielărie",1,2451,"MUNICIPIUL ORADEA",26564,1017,757,637,28,92,748,9,1120,363,281,467
5,"BIHOR",56,26564,,118,"ORADEA / Liceul de artă",1,2451,"MUNICIPIUL ORADEA",26564,1082,689,608,70,11,683,6,1191,502,190,493
5,"BIHOR",56,26564,,119,"ORADEA / Palatul Copiilor şi Elevilor",1,2451,"MUNICIPIUL ORADEA",26564,1482,1075,800,246,29,1061,14,1631,556,344,717
5,"BIHOR",56,26564,,120,"ORADEA / Colegiul Naţional ""Mihai Eminescu""",1,2451,"MUNICIPIUL ORADEA",26564,1564,835,765,69,1,824,11,1721,886,185,639
5,"BIHOR",56,26564,,121,"ORADEA / Şcoala Gimnazială ""Szacsvay Imre""",1,2451,"MUNICIPIUL ORADEA",26564,1416,883,788,50,45,877,6,1559,676,252,625
5,"BIHOR",56,26564,,122,"ORADEA / Liceul Teoretic ""Ady Endre""",1,2451,"MUNICIPIUL ORADEA",26564,1345,1149,735,159,255,1135,14,1481,332,458,677
5,"BIHOR",56,26564,,123,"ORADEA / Liceul Reformat ""Lorantffy Zsuzsanna""",1,2451,"MUNICIPIUL ORADEA",26564,1570,1230,862,87,281,1212,18,1728,498,559,653
5,"BIHOR",56,26564,,124,"ORADEA / Colegiul Naţional ""Emanuil Gojdu""",1,2451,"MUNICIPIUL ORADEA",26564,1324,799,748,51,0,788,11,1458,659,253,535
5,"BIHOR",56,26564,,125,"ORADEA / Colegiul Naţional ""Emanuil Gojdu""",1,2451,"MUNICIPIUL ORADEA",26564,872,609,511,98,0,608,1,960,351,206,402
5,"BIHOR",56,26564,,126,"ORADEA / Liceul Teoretic "" Aurel Lazăr """,1,2451,"MUNICIPIUL ORADEA",26564,1305,520,447,73,0,513,7,1437,917,177,336
5,"BIHOR",56,26564,,127,"ORADEA / Liceul Greco-Catolic ""Iuliu Maniu""",1,2451,"MUNICIPIUL ORADEA",26564,1138,555,519,36,0,549,6,1255,700,142,407
5,"BIHOR",56,26564,,128,"ORADEA / Liceul Greco-Catolic ""Iuliu Maniu""",1,2451,"MUNICIPIUL ORADEA",26564,1076,517,473,44,0,513,4,1185,668,139,374
5,"BIHOR",56,26564,,129,"ORADEA / Colegiul Naţional ""Iosif Vulcan""",1,2451,"MUNICIPIUL ORADEA",26564,868,500,440,60,0,494,6,955,455,121,373
5,"BIHOR",56,26564,,130,"ORADEA / Colegiul Naţional ""Iosif Vulcan""",1,2451,"MUNICIPIUL ORADEA",26564,1010,583,502,79,2,575,8,1112,529,161,414
5,"BIHOR",56,26564,,131,"ORADEA / Liceul Teoretic German ""Friedrich Schiller""",1,2451,"MUNICIPIUL ORADEA",26564,869,503,479,24,0,500,3,957,454,110,390
5,"BIHOR",56,26564,,132,"ORADEA / Liceul Teoretic German ""Friedrich Schiller""",1,2451,"MUNICIPIUL ORADEA",26564,1593,805,769,36,0,797,8,1753,948,228,569
5,"BIHOR",56,26564,,133,"ORADEA / Liceul Teoretic German ""Friedrich Schiller""",1,2451,"MUNICIPIUL ORADEA",26564,883,510,447,62,1,506,4,972,462,141,365
5,"BIHOR",56,26564,,134,"ORADEA / Liceul Teoretic German ""Friedrich Schiller""",1,2451,"MUNICIPIUL ORADEA",26564,1022,667,600,67,0,656,11,1127,460,207,449
5,"BIHOR",56,26564,,135,"ORADEA / Colegiul Tehnic ""Andrei Şaguna""",1,2451,"MUNICIPIUL ORADEA",26564,1724,1138,974,164,0,1124,14,1897,759,354,770
5,"BIHOR",56,26564,,136,"ORADEA / Colegiul Tehnic ""Andrei Şaguna""",1,2451,"MUNICIPIUL ORADEA",26564,1349,912,816,96,0,894,17,1485,573,303,591
5,"BIHOR",56,26564,,137,"ORADEA / Colegiul Tehnic ""Andrei Şaguna""",1,2451,"MUNICIPIUL ORADEA",26564,1197,765,717,48,0,759,6,1318,553,243,516
5,"BIHOR",56,26564,,138,"ORADEA / Colegiul Tehnic ""Andrei Şaguna""",1,2451,"MUNICIPIUL ORADEA",26564,1213,746,699,46,1,740,6,1334,588,250,490
5,"BIHOR",56,26564,,139,"ORADEA / Şcoala Gimnazială ""Avram Iancu""",1,2451,"MUNICIPIUL ORADEA",26564,1134,735,703,32,0,724,11,1224,489,297,427
5,"BIHOR",56,26564,,140,"ORADEA / Şcoala Gimnazială ""Avram Iancu""",1,2451,"MUNICIPIUL ORADEA",26564,1097,719,701,17,1,705,14,1208,489,277,428
5,"BIHOR",56,26564,,141,"ORADEA / Grădiniţa cu program prelungit nr. 44",1,2451,"MUNICIPIUL ORADEA",26564,1330,1034,896,138,0,1020,14,1445,411,369,651
5,"BIHOR",56,26564,,142,"ORADEA / Grădiniţa cu program prelungit nr. 44",1,2451,"MUNICIPIUL ORADEA",26564,1659,1186,1074,112,0,1176,10,1826,640,457,719
5,"BIHOR",56,26564,,143,"ORADEA / Imprimeria de Vest",1,2451,"MUNICIPIUL ORADEA",26564,1917,1300,1204,96,0,1284,16,2003,703,374,910
5,"BIHOR",56,26804,,144,"BEIUŞ / Primaria Beius",1,2453,"MUNICIPIUL BEIUŞ",26804,1365,973,828,141,4,954,19,1503,530,345,609
5,"BIHOR",56,26804,,145,"BEIUŞ / Liceul Pedagogic",1,2453,"MUNICIPIUL BEIUŞ",26804,1305,885,812,67,6,874,11,1437,552,343,531
5,"BIHOR",56,26804,,146,"BEIUŞ / Gradinita cu program prelungit",1,2453,"MUNICIPIUL BEIUŞ",26804,1331,801,724,65,12,789,12,1465,664,351,438
5,"BIHOR",56,26804,,147,"BEIUŞ / Colegiul Tehnic Ioan Ciordaş",1,2453,"MUNICIPIUL BEIUŞ",26804,1277,865,776,79,10,855,10,1406,541,332,523
5,"BIHOR",56,26804,,148,"BEIUŞ / Sc. Gimnaziala N.Popoviciu",1,2453,"MUNICIPIUL BEIUŞ",26804,1517,1120,980,125,15,1108,12,1670,550,472,636
5,"BIHOR",56,26804,,149,"BEIUŞ / Gradinita Floarea de Colt",1,2453,"MUNICIPIUL BEIUŞ",26804,1419,906,849,51,6,898,8,1562,656,378,520
5,"BIHOR",56,26804,,150,"BEIUŞ / Bloc parter",1,2453,"MUNICIPIUL BEIUŞ",26804,1174,805,742,62,1,795,10,1294,489,342,453
5,"BIHOR",56,26804,,151,"DELANI / Caminul Cultural",1,2453,"MUNICIPIUL BEIUŞ",26804,304,227,213,14,0,224,3,335,108,103,121
5,"BIHOR",56,26877,,152,"MARGHITA / Colegiul National O.Goga",1,2456,"MUNICIPIUL MARGHITA",26877,1567,950,882,46,22,940,10,1725,775,292,648
5,"BIHOR",56,26877,,153,"MARGHITA / Colegiul National O.Goga",1,2456,"MUNICIPIUL MARGHITA",26877,1427,790,744,46,0,782,8,1571,781,269,513
5,"BIHOR",56,26877,,154,"MARGHITA / Colegiul National O.Goga",1,2456,"MUNICIPIUL MARGHITA",26877,1356,729,687,41,1,717,12,1494,765,198,519
5,"BIHOR",56,26877,,155,"MARGHITA / Colegiul National O.Goga",1,2456,"MUNICIPIUL MARGHITA",26877,1300,731,697,34,0,725,6,1432,701,246,479
5,"BIHOR",56,26877,,156,"MARGHITA / Colegiul National O.Goga",1,2456,"MUNICIPIUL MARGHITA",26877,1404,727,696,31,0,719,8,1545,818,231,488
5,"BIHOR",56,26877,,157,"MARGHITA / Primaria municipiului Marghita",1,2456,"MUNICIPIUL MARGHITA",26877,1338,620,596,24,0,617,3,1474,854,195,422
5,"BIHOR",56,26877,,158,"MARGHITA / Clubul Copiilor",1,2456,"MUNICIPIUL MARGHITA",26877,1383,673,645,28,0,669,4,1522,849,199,470
5,"BIHOR",56,26877,,159,"MARGHITA / Grup Scolar "" Horvath Janos",1,2456,"MUNICIPIUL MARGHITA",26877,1431,735,703,32,0,727,8,1576,841,217,510
5,"BIHOR",56,26877,,160,"MARGHITA / SC Bihoreana SRL",1,2456,"MUNICIPIUL MARGHITA",26877,1089,557,532,24,1,553,4,1199,642,191,362
5,"BIHOR",56,26877,,161,"MARGHITA / SC Bihoreana SRL",1,2456,"MUNICIPIUL MARGHITA",26877,1310,723,690,33,0,715,8,1443,720,185,530
5,"BIHOR",56,26877,,162,"CHEŢ / Scoala cu clasele I-VIII Chet",1,2456,"MUNICIPIUL MARGHITA",26877,891,430,403,27,0,420,10,981,551,173,247
5,"BIHOR",56,26877,,163,"GHENETEA / Scoala cu clasele I-VIII Ghenetea",1,2456,"MUNICIPIUL MARGHITA",26877,613,307,277,30,0,305,2,675,368,135,170
5,"BIHOR",56,26975,,164,"SALONTA / Fostul magazin Wagner",1,2460,"MUNICIPIUL SALONTA",26975,1512,780,752,28,0,773,7,1664,884,202,571
5,"BIHOR",56,26975,,165,"SALONTA / Grădiniţa Floarea Soarelui",1,2460,"MUNICIPIUL SALONTA",26975,1565,754,688,25,41,748,6,1723,969,199,549
5,"BIHOR",56,26975,,166,"SALONTA / Liceul Teoretic Arany Janos",1,2460,"MUNICIPIUL SALONTA",26975,1217,602,564,28,10,600,2,1341,739,146,454
5,"BIHOR",56,26975,,167,"SALONTA / Grădiniţa Curcubeu",1,2460,"MUNICIPIUL SALONTA",26975,781,387,374,13,0,386,1,860,473,86,300
5,"BIHOR",56,26975,,168,"SALONTA / Casa de Cultura ZILAHY LAJOS",1,2460,"MUNICIPIUL SALONTA",26975,1478,678,631,47,0,676,2,1628,949,199,477
5,"BIHOR",56,26975,,169,"SALONTA / Gr[dini'a Toldi",1,2460,"MUNICIPIUL SALONTA",26975,1171,632,543,88,1,628,4,1289,657,196,432
5,"BIHOR",56,26975,,170,"SALONTA / Colegiul  National TEODOR NEŞ",1,2460,"MUNICIPIUL SALONTA",26975,768,359,331,28,0,358,1,845,486,96,262
5,"BIHOR",56,26975,,171,"SALONTA / Grădiniţa Ursuleţ",1,2460,"MUNICIPIUL SALONTA",26975,1412,723,696,25,2,714,9,1555,832,282,432
5,"BIHOR",56,26975,,172,"SALONTA / Gădiniţa Ursuleţ",1,2460,"MUNICIPIUL SALONTA",26975,659,299,259,37,3,288,11,727,428,120,168
5,"BIHOR",56,26975,,173,"SALONTA / Casa Sfântul Anton",1,2460,"MUNICIPIUL SALONTA",26975,499,266,254,12,0,265,1,550,284,77,188
5,"BIHOR",56,26975,,174,"SALONTA / Şcoala Generală",1,2460,"MUNICIPIUL SALONTA",26975,1124,567,530,37,0,564,3,1237,670,184,380
5,"BIHOR",56,26975,,175,"SALONTA / Grădiniţa Fluieraşul Fermecat",1,2460,"MUNICIPIUL SALONTA",26975,1633,823,792,31,0,820,3,1798,975,208,612
5,"BIHOR",56,26975,,176,"SALONTA / Liceul Tehnologic nr.1",1,2460,"MUNICIPIUL SALONTA",26975,862,503,457,44,2,501,2,950,447,195,306
5,"BIHOR",56,26975,,177,"SALONTA / Grădiniţa Prichindel",1,2460,"MUNICIPIUL SALONTA",26975,865,462,437,25,0,457,5,952,490,146,311
5,"BIHOR",56,26975,,178,"SALONTA / Şcoala generală Füveskert",1,2460,"MUNICIPIUL SALONTA",26975,777,415,400,15,0,412,3,857,442,147,265
5,"BIHOR",56,26699,,179,"ALEŞD / Primaria Alesd-Sala Mare",1,2462,"ORAŞ ALEŞD",26699,1250,910,764,124,22,900,10,1377,467,229,671
5,"BIHOR",56,26699,,180,"ALEŞD / Liceul Teoretic Constantin Serban",1,2462,"ORAŞ ALEŞD",26699,1583,928,854,73,1,920,8,1742,814,238,682
5,"BIHOR",56,26699,,181,"ALEŞD / Colegiul Tehnic Alexandru Roman",1,2462,"ORAŞ ALEŞD",26699,1560,901,817,84,0,897,4,1717,816,206,691
5,"BIHOR",56,26699,,182,"ALEŞD / Gradinita cu program normal nr. 1",1,2462,"ORAŞ ALEŞD",26699,1214,798,743,52,3,789,9,1336,538,164,625
5,"BIHOR",56,26699,,183,"PĂDUREA NEAGRĂ / Scoala primara nr.2",1,2462,"ORAŞ ALEŞD",26699,646,322,299,23,0,319,3,713,391,70,249
5,"BIHOR",56,26699,,184,"PEŞTIŞ / Scoala gimnaziala nr.1",1,2462,"ORAŞ ALEŞD",26699,1151,705,669,36,0,703,2,1267,562,177,526
5,"BIHOR",56,26699,,185,"TINĂUD / Gradinita cu program normal nr. 4",1,2462,"ORAŞ ALEŞD",26699,662,453,414,39,0,452,1,730,277,118,334
5,"BIHOR",56,26699,,186,"ALEŞD / Centrul Multifuncţional",1,2462,"ORAŞ ALEŞD",26699,936,627,597,30,0,597,30,1031,404,163,434
5,"BIHOR",56,26920,,187,"NUCET / casa de cultura",1,2467,"ORAŞ NUCET",26920,1216,873,786,84,3,863,10,1338,465,389,474
5,"BIHOR",56,26920,,188,"BĂIŢA / Caminul Cultural Baita",1,2467,"ORAŞ NUCET",26920,559,422,350,60,12,415,7,616,194,186,229
5,"BIHOR",56,30915,,189,"CADEA / ŞCOALA GENERALĂ",1,2471,"ORAŞ SĂCUENI",30915,912,340,318,22,0,332,8,1006,666,88,244
5,"BIHOR",56,30915,,190,"CUBULCUT / ŞCOALA GENERALĂ",1,2471,"ORAŞ SĂCUENI",30915,739,255,243,12,0,245,10,814,559,108,137
5,"BIHOR",56,30915,,191,"OLOSIG / ŞCOALA GENERALĂ",1,2471,"ORAŞ SĂCUENI",30915,448,174,165,9,0,170,4,491,317,56,114
5,"BIHOR",56,30915,,192,"SÂNNICOLAU DE MUNTE / ŞCOALA GENERALĂ",1,2471,"ORAŞ SĂCUENI",30915,694,297,283,14,0,287,10,766,469,118,169
5,"BIHOR",56,30915,,193,"SĂCUENI / UNITATE DE INVATAMANT",1,2471,"ORAŞ SĂCUENI",30915,1119,506,478,28,0,492,14,1234,728,104,388
5,"BIHOR",56,30915,,194,"SĂCUENI / UNITATE DE INVATAMANT",1,2471,"ORAŞ SĂCUENI",30915,1305,700,675,24,1,665,35,1437,737,345,320
5,"BIHOR",56,30915,,195,"SĂCUENI / UNITATE DE INVATAMANT",1,2471,"ORAŞ SĂCUENI",30915,1242,523,504,19,0,521,2,1369,846,88,433
5,"BIHOR",56,30915,,196,"SĂCUENI / UNITATE DE INVATAMANT",1,2471,"ORAŞ SĂCUENI",30915,956,402,385,17,0,399,3,1053,651,116,283
5,"BIHOR",56,30915,,197,"SĂCUENI / UNITATE DE CULTURA",1,2471,"ORAŞ SĂCUENI",30915,1500,670,631,39,0,654,16,1651,981,163,491
5,"BIHOR",56,30915,,198,"CIOCAIA / CLUBUL TINERETULUI",1,2471,"ORAŞ SĂCUENI",30915,770,349,329,20,0,337,12,848,499,98,239
5,"BIHOR",56,26840,,199,"ŞTEI / CASA DE CULTURĂ ""MIRON POMPILIU"" ŞTEI",1,2478,"ORAŞ ŞTEI",26840,1208,834,629,203,2,824,10,1329,495,416,408
5,"BIHOR",56,26840,,200,"ŞTEI / ŞCOALA GIMNAZIALĂ CU CLASELE I-VIII ""MIRON POMPILIU"" ŞTEI - ŞCOALA MICĂ",1,2478,"ORAŞ ŞTEI",26840,1042,625,583,41,1,618,7,1146,521,327,291
5,"BIHOR",56,26840,,201,"ŞTEI / COLEGIUL TEHNIC""UNIREA"" ŞTEI",1,2478,"ORAŞ ŞTEI",26840,1326,747,694,52,1,738,9,1459,712,341,397
5,"BIHOR",56,26840,,202,"ŞTEI / COLEGIUL TEHNIC ""UNIREA"" ŞTEI - ŞCOALA DE ŞOFERI",1,2478,"ORAŞ ŞTEI",26840,1476,853,734,113,6,846,7,1624,771,317,529
5,"BIHOR",56,26840,,203,"ŞTEI / ŞCOALA GIMNAZIALĂ CU CLASELE I-VIII ""MIRON POMPILI"" ŞTEI",1,2478,"ORAŞ ŞTEI",26840,1334,835,770,64,1,823,12,1470,635,406,417
5,"BIHOR",56,32027,,204,"VALEA LUI MIHAI / ŞCOALA GIMNAZIALĂ VALEA LUI MIHAI",1,2480,"ORAŞ VALEA LUI MIHAI",32027,1291,543,508,34,1,538,5,1421,878,124,414
5,"BIHOR",56,32027,,205,"VALEA LUI MIHAI / ŞCOALA GIMNAZIALĂ VALEA LUI MIHAI",1,2480,"ORAŞ VALEA LUI MIHAI",32027,1411,570,540,30,0,566,4,1553,983,144,422
5,"BIHOR",56,32027,,206,"VALEA LUI MIHAI / ŞCOALA GIMNAZIALĂ VALEA LUI MIHAI",1,2480,"ORAŞ VALEA LUI MIHAI",32027,1275,606,568,37,1,602,4,1404,798,149,453
5,"BIHOR",56,32027,,207,"VALEA LUI MIHAI / ŞCOALA GIMNAZIALĂ VALEA LUI MIHAI",1,2480,"ORAŞ VALEA LUI MIHAI",32027,1342,420,409,11,0,418,2,1477,1057,126,292
5,"BIHOR",56,32027,,208,"VALEA LUI MIHAI / ŞCOALA GIMNAZIALĂ VALEA LUI MIHAI",1,2480,"ORAŞ VALEA LUI MIHAI",32027,1153,476,458,10,8,462,14,1270,794,173,289
5,"BIHOR",56,32027,,209,"VALEA LUI MIHAI / ŞCOALA GIMNAZIALĂ VALEA LUI MIHAI",1,2480,"ORAŞ VALEA LUI MIHAI",32027,1315,465,449,16,0,464,1,1448,983,130,334
5,"BIHOR",56,32027,,210,"VALEA LUI MIHAI / ŞCOALA GIMNAZIALĂ VALEA LUI MIHAI (Grădiniţă)",1,2480,"ORAŞ VALEA LUI MIHAI",32027,1253,470,448,22,0,466,4,1379,909,96,370
5,"BIHOR",56,27007,,211,"VAŞCĂU / SALA DE SPORT",1,2482,"ORAŞ VAŞCĂU",27007,1434,1024,907,100,17,1008,16,1578,554,451,557
5,"BIHOR",56,27007,,212,"CÎMP / CĂMIN   CULTURAL",1,2482,"ORAŞ VAŞCĂU",27007,216,196,171,24,1,194,2,239,43,67,127
5,"BIHOR",56,27007,,213,"COLEŞTI / CĂMIN   CULTURAL",1,2482,"ORAŞ VAŞCĂU",27007,120,117,95,21,1,116,1,133,16,67,49
5,"BIHOR",56,27007,,214,"VĂRZARII DE JOS / CĂMIN   CULTURAL",1,2482,"ORAŞ VAŞCĂU",27007,193,147,123,23,1,145,2,212,65,78,67
5,"BIHOR",56,27007,,215,"VĂRZARII DE SUS / CĂMIN   CULTURAL",1,2482,"ORAŞ VAŞCĂU",27007,113,90,73,17,0,89,1,125,35,36,53
5,"BIHOR",56,27007,,216,"CÎMP-MOŢI / ŞCOALĂ  GENERALĂ",1,2482,"ORAŞ VAŞCĂU",27007,54,51,35,15,1,51,0,60,9,33,18
5,"BIHOR",56,27070,,217,"ABRAM / PRIMARIA ABRAM",3,2489,"ABRAM",27070,767,438,399,39,0,433,5,844,406,129,304
5,"BIHOR",56,27070,,218,"DIJIR / CAMIN CULTURAL",3,2489,"ABRAM",27070,232,164,137,27,0,164,0,256,92,42,122
5,"BIHOR",56,27070,,219,"ITEU / CAMIN CULTURAL",3,2489,"ABRAM",27070,267,162,144,18,0,160,2,295,133,113,47
5,"BIHOR",56,27070,,220,"SATU BARBĂ / CAMIN CULTURAL",3,2489,"ABRAM",27070,220,163,146,17,0,162,1,242,79,72,90
5,"BIHOR",56,27070,,221,"ITEU NOU / SCOALA",3,2489,"ABRAM",27070,126,91,77,14,0,90,1,140,49,49,41
5,"BIHOR",56,27070,,222,"MARGINE / SCOALA PRIMARA nr. 1",3,2489,"ABRAM",27070,419,279,257,22,0,270,9,462,183,118,152
5,"BIHOR",56,27070,,223,"SUIUG / SCOALA PRIMARA nr. 3",3,2489,"ABRAM",27070,481,342,299,43,0,341,1,529,187,115,226
5,"BIHOR",56,27169,,224,"ABRĂMUŢ / SCOALA GENERALA  ABRAMUT",3,2498,"ABRĂMUŢ",27169,386,224,198,26,0,222,2,426,202,56,166
5,"BIHOR",56,27169,,225,"CRESTUR / CAMIN CULTURAL CRESTUR",3,2498,"ABRĂMUŢ",27169,352,193,180,13,0,186,7,388,195,26,160
5,"BIHOR",56,27169,,226,"FĂNCICA / SCOALA GENERALA FANCICA",3,2498,"ABRĂMUŢ",27169,276,161,139,22,0,158,3,304,143,64,94
5,"BIHOR",56,27169,,227,"PETREU / GRADINITA CU PROGRAM NORMAL NR.1 PETREU",3,2498,"ABRĂMUŢ",27169,1385,723,690,33,0,710,13,1524,801,127,583
5,"BIHOR",56,26742,,228,"CHISTAG / CAMIN CULTURAL",3,2503,"AŞTILEU",26742,504,370,323,47,0,370,0,554,184,154,216
5,"BIHOR",56,26742,,229,"AŞTILEU / SCOALA GIMNAZIALA NR 1 ASTILEU",3,2503,"AŞTILEU",26742,1275,835,766,69,0,827,8,1404,569,254,573
5,"BIHOR",56,26742,,230,"CĂLĂŢEA / SCOALA GIMNAZIALA NR 2 CALATEA",3,2503,"AŞTILEU",26742,337,243,217,26,0,241,2,372,129,94,147
5,"BIHOR",56,26742,,231,"CĂLĂŢEA / BLOC CORNET",3,2503,"AŞTILEU",26742,239,161,144,17,0,161,0,264,103,33,128
5,"BIHOR",56,26742,,232,"PEŞTERE / SCOALA PRIMARA NR2 PEŞTERE",3,2503,"AŞTILEU",26742,689,515,473,37,5,510,5,759,244,209,301
5,"BIHOR",56,27212,,233,"AUŞEU / PRIMĂRIA COMUNEI AUŞEU",3,2508,"AUŞEU",27212,776,575,495,60,20,570,5,855,280,152,418
5,"BIHOR",56,27212,,234,"GROŞI / ŞCOALA PRIMARĂ",3,2508,"AUŞEU",27212,849,529,478,43,8,521,8,935,406,192,329
5,"BIHOR",56,27212,,235,"LUNCŞOARA / CĂMIN CULTURAL",3,2508,"AUŞEU",27212,746,537,482,47,8,528,9,822,285,216,312
5,"BIHOR",56,27285,,236,"AVRAM IANCU / SALA  SPORT SCOALA",3,2515,"AVRAM IANCU",27285,1551,1063,977,76,10,1050,13,1707,644,620,430
5,"BIHOR",56,27285,,237,"ANT / CAMIN",3,2515,"AVRAM IANCU",27285,162,106,62,44,0,106,0,178,72,39,67
5,"BIHOR",56,27285,,238,"TĂMAŞDA / SCOALA NOUA",3,2515,"AVRAM IANCU",27285,859,562,524,38,0,550,12,946,384,363,187
5,"BIHOR",56,27329,,239,"BALC / CĂMIN CULTURAL BALC",3,2519,"BALC",27329,1060,551,515,36,0,540,11,1167,616,165,375
5,"BIHOR",56,27329,,240,"ALMAŞU MARE / ŞCOALA GIMNAZIALĂ NR.2  ALMAŞU MARE",3,2519,"BALC",27329,632,425,378,47,0,416,9,696,271,202,214
5,"BIHOR",56,27329,,241,"ALMAŞU MIC / ŞCOALA PRIMARĂ NR.1 ALMAŞU MIC",3,2519,"BALC",27329,297,199,182,17,0,195,4,327,128,62,133
5,"BIHOR",56,27329,,242,"SĂLDĂBAGIU DE BARCĂU / ŞCOALA GIMNAZIALĂ NR.3 SĂLDĂBAGIU DE BARCĂU",3,2519,"BALC",27329,427,279,246,33,0,273,6,471,192,156,117
5,"BIHOR",56,27329,,243,"GHIDA / ŞCOALA PRIMARĂ NR.2  GHIDA",3,2519,"BALC",27329,131,88,61,27,0,86,2,144,56,51,35
5,"BIHOR",56,27383,,244,"BATĂR / Scoala Gimnaziala nr.1",3,2525,"BATĂR",27383,1292,558,502,56,0,543,15,1422,864,299,244
5,"BIHOR",56,27383,,245,"ARPĂŞEL / Scoala Gimnaziala nr.4",3,2525,"BATĂR",27383,729,251,237,14,0,250,1,803,552,54,196
5,"BIHOR",56,27383,,246,"TALPOŞ / Gradinita Talpos",3,2525,"BATĂR",27383,1280,642,592,50,0,637,5,1409,767,425,212
5,"BIHOR",56,27383,,247,"TĂUT / Gradinita cu program normal Taut",3,2525,"BATĂR",27383,754,471,418,52,1,469,2,830,359,273,196
5,"BIHOR",56,27436,,248,"BIHARIA / Şcoala Generală cu cls V - VIII ""Gaspar Andras"" Biharia""",3,2530,"BIHARIA",27436,1557,868,800,68,0,860,8,1714,846,126,734
5,"BIHOR",56,27436,,249,"BIHARIA / Grădiniţa de copii Biharia",3,2530,"BIHARIA",27436,1514,754,714,40,0,749,5,1666,912,82,667
5,"BIHOR",56,27436,,250,"CAUACEU / Şcoala generală cu cls. I - IV Cauaceu",3,2530,"BIHARIA",27436,619,345,316,29,0,343,2,682,337,46,297
5,"BIHOR",56,27506,,251,"BOIANU MARE / SCOALA CU CLASELE I- IV, BOIANU-MARE",3,2533,"BOIANU MARE",27506,498,290,275,15,0,283,7,548,258,122,161
5,"BIHOR",56,27506,,252,"PĂGAIA / SCOALA CU CLASELE I- VIII ,,INV. GALGAU IOSIF"" PAGAIA",3,2533,"BOIANU MARE",27506,557,362,331,31,0,360,2,615,253,153,207
5,"BIHOR",56,27560,,253,"BOROD / CAMIN CULTURAL BOROD",3,2539,"BOROD",27560,1267,911,794,117,0,899,12,1395,484,471,428
5,"BIHOR",56,27560,,254,"BOROZEL / ŞCOALA CLS I-VIII",3,2539,"BOROD",27560,517,410,384,26,0,407,3,570,160,197,210
5,"BIHOR",56,27560,,255,"CETEA / GRADINITA CETEA",3,2539,"BOROD",27560,192,194,138,56,0,194,0,211,17,122,72
5,"BIHOR",56,27560,,256,"CORNIŢEL / ŞCOALA CLS I-IV",3,2539,"BOROD",27560,434,335,294,41,0,334,1,478,143,176,158
5,"BIHOR",56,27560,,257,"VALEA MARE DE CRIŞ / SCOALA CLS I-IV",3,2539,"BOROD",27560,384,339,288,51,0,337,2,422,83,103,234
5,"BIHOR",56,27560,,258,"ŞERANI / SCOALA CLS I-IV",3,2539,"BOROD",27560,105,77,55,22,0,77,0,116,39,28,49
5,"BIHOR",56,27560,,259,"ŞERANI / SCOALA  CLS. I-VIII",3,2539,"BOROD",27560,237,155,120,35,0,152,3,262,107,61,91
5,"BIHOR",56,27631,,260,"BORŞ / CAMINUL CULTURAL Borş",3,2546,"BORŞ",27631,1198,789,653,134,2,788,1,1319,530,133,655
5,"BIHOR",56,27631,,261,"SÂNTION / Grădiniţa Sîntion",3,2546,"BORŞ",27631,1535,919,855,64,0,913,6,1690,771,69,844
5,"BIHOR",56,27631,,262,"SANTĂUL MARE / Şcoala Generală Santăul Mare",3,2546,"BORŞ",27631,313,218,168,45,5,217,1,345,127,27,190
5,"BIHOR",56,27631,,263,"SANTĂUL MIC / Cămin cultural Santăul Mic",3,2546,"BORŞ",27631,442,273,246,27,0,268,5,487,214,46,222
5,"BIHOR",56,27686,,264,"BRATCA / Clubul Căminului Cultural",3,2551,"BRATCA",27686,1289,907,789,109,9,898,9,1419,512,450,448
5,"BIHOR",56,27686,,265,"BEZNEA / Şcoala cu cls.I-VIII",3,2551,"BRATCA",27686,1087,665,602,63,0,656,9,1198,533,240,416
5,"BIHOR",56,27686,,266,"DAMIŞ / Căminul Cultural",3,2551,"BRATCA",27686,477,351,307,44,0,351,0,526,175,156,195
5,"BIHOR",56,27686,,267,"PONOARĂ / Căminul Cultural",3,2551,"BRATCA",27686,497,393,359,34,0,391,2,548,155,57,334
5,"BIHOR",56,27686,,268,"LORĂU / Căminul Cultural",3,2551,"BRATCA",27686,353,239,216,23,0,236,3,389,150,82,154
5,"BIHOR",56,27686,,269,"VALEA CRIŞULUI / Căminul Cultural",3,2551,"BRATCA",27686,370,284,246,36,2,282,2,408,124,108,174
5,"BIHOR",56,27757,,270,"BRUSTURI / CAMINUL CULTURAL BRUSTURI",3,2558,"BRUSTURI",27757,991,632,546,86,0,627,5,1091,459,313,314
5,"BIHOR",56,27757,,271,"CUIEŞD / ŞCOALA CUIEŞD",3,2558,"BRUSTURI",27757,408,271,213,57,1,268,3,450,179,101,167
5,"BIHOR",56,27757,,272,"ORVIŞELE / ŞCOALA  ORVIŞELE",3,2558,"BRUSTURI",27757,353,199,164,35,0,198,1,390,191,54,144
5,"BIHOR",56,27757,,273,"PĂULEŞTI / CAMINUL CULTURAL PAULESTI",3,2558,"BRUSTURI",27757,275,160,130,29,1,159,1,304,144,82,77
5,"BIHOR",56,27757,,274,"PICLEU / CAMINUL CULTURAL PICLEU",3,2558,"BRUSTURI",27757,721,469,398,69,2,466,3,794,325,240,226
5,"BIHOR",56,27757,,275,"ŢIGĂNEŞTII DE CRIŞ / ŞCOALA  ŢIGĂNEŞTII DE CRIŞ",3,2558,"BRUSTURI",27757,289,210,155,55,0,208,2,319,109,129,79
5,"BIHOR",56,27846,,276,"BUDUREASA / Camin cultural",3,2567,"BUDUREASA",27846,875,685,626,55,4,678,7,964,279,265,413
5,"BIHOR",56,27846,,277,"BURDA / cAMIN CULTURAL",3,2567,"BUDUREASA",27846,323,249,228,20,1,247,2,356,107,101,146
5,"BIHOR",56,27846,,278,"SACA / cAMIN CULTURAL",3,2567,"BUDUREASA",27846,171,137,116,21,0,136,1,189,52,32,104
5,"BIHOR",56,27846,,279,"TELEAC / cAMIN CULTURAL",3,2567,"BUDUREASA",27846,143,134,109,25,0,131,3,158,24,45,86
5,"BIHOR",56,27846,,280,"SĂLIŞTE DE BEIUŞ / cAMIN CULTURAL",3,2567,"BUDUREASA",27846,210,180,159,21,0,180,0,233,53,72,108
5,"BIHOR",56,27846,,281,"BUDUREASA / Scoala I-IV Budureasa",3,2567,"BUDUREASA",27846,355,293,282,11,0,289,4,392,99,99,190
5,"BIHOR",56,27908,,282,"BUDUSLĂU / PRIMARIA BUDUSLAU",3,2573,"BUDUSLĂU",27908,813,320,300,20,0,319,1,895,575,123,196
5,"BIHOR",56,27908,,283,"ALBIŞ / SCOALA GENERALA BUDUSLAU",3,2573,"BUDUSLĂU",27908,772,278,262,16,0,274,4,850,572,56,218
5,"BIHOR",56,27935,,284,"BULZ / PRIMĂRIA COMUNEI BULZ",3,2576,"BULZ",27935,716,523,450,72,1,518,5,791,268,216,302
5,"BIHOR",56,27935,,285,"MUNTENI / SCOALA PRIMARĂ NR.3 MUNTENI",3,2576,"BULZ",27935,433,337,303,32,2,336,1,476,139,126,210
5,"BIHOR",56,27935,,286,"REMEŢI / ŞCOALA GIMNAZIALĂ NR.2 REMEŢI",3,2576,"BULZ",27935,644,655,448,199,8,655,0,709,54,215,440
5,"BIHOR",56,27971,,287,"BUNTEŞTI / CĂMIN CULTURAL",3,2580,"BUNTEŞTI",27971,488,435,357,67,11,434,1,538,103,128,306
5,"BIHOR",56,27971,,288,"BRĂDET / Gradinita",3,2580,"BUNTEŞTI",27971,582,475,424,42,9,471,4,620,145,175,296
5,"BIHOR",56,27971,,289,"DUMBRĂVANI / CĂMIN CULTURAL",3,2580,"BUNTEŞTI",27971,254,189,176,13,0,187,2,280,91,78,109
5,"BIHOR",56,27971,,290,"POIENII DE JOS / SCOALA CU CLASELE I-VIII",3,2580,"BUNTEŞTI",27971,511,383,339,43,1,381,2,562,179,135,246
5,"BIHOR",56,27971,,291,"POIENII DE SUS / CĂMIN CULTURAL",3,2580,"BUNTEŞTI",27971,567,424,396,24,4,414,10,624,200,157,257
5,"BIHOR",56,27971,,292,"FERICE / ŞC. CU CLASELE I-IV",3,2580,"BUNTEŞTI",27971,397,279,260,17,2,279,0,437,158,75,204
5,"BIHOR",56,27971,,293,"LELEŞTI / ŞC. CU CLASELE I-IV",3,2580,"BUNTEŞTI",27971,358,311,277,29,5,306,5,395,84,138,168
5,"BIHOR",56,27971,,294,"SĂUD / ŞC. CU CLASELE I-IV",3,2580,"BUNTEŞTI",27971,331,263,249,13,1,262,1,364,101,87,175
5,"BIHOR",56,27971,,295,"STÎNCEŞTI / ŞC. CU CLASELE I-VIII",3,2580,"BUNTEŞTI",27971,263,300,205,88,7,297,3,310,10,129,168
5,"BIHOR",56,28077,,296,"CĂBEŞTI / CAMINUL CULTURAL",3,2590,"CĂBEŞTI",28077,725,459,420,39,0,456,3,799,340,192,264
5,"BIHOR",56,28077,,297,"GOILA / CAMINUL CULTURAL",3,2590,"CĂBEŞTI",28077,167,124,107,17,0,123,1,185,61,50,73
5,"BIHOR",56,28077,,298,"SOHODOL / CAMINUL CULTURAL",3,2590,"CĂBEŞTI",28077,245,176,158,17,1,174,2,271,95,88,86
5,"BIHOR",56,28077,,299,"JOSANI / Scoala cu cls. I-IV Josani",3,2590,"CĂBEŞTI",28077,399,271,240,31,0,269,2,439,168,145,124
5,"BIHOR",56,28139,,300,"CĂPÎLNA / PRIMARIA CAPILNA",3,2596,"CĂPÎLNA",28139,264,256,172,66,18,256,0,289,33,198,58
5,"BIHOR",56,28139,,301,"ROHANI / SCOALA GENERALA",3,2596,"CĂPÎLNA",28139,104,95,60,29,6,94,1,116,21,53,41
5,"BIHOR",56,28139,,302,"GINTA / SCOALA GENERALA",3,2596,"CĂPÎLNA",28139,246,176,117,59,0,176,0,272,96,43,133
5,"BIHOR",56,28139,,303,"SĂLDĂBAGIU MIC / SCOALA GENERALA",3,2596,"CĂPÎLNA",28139,372,322,243,79,0,322,0,410,88,195,127
5,"BIHOR",56,28139,,304,"SUPLACU DE TINCA / SCOALA GENERALA",3,2596,"CĂPÎLNA",28139,338,297,233,54,10,295,2,373,76,174,121
5,"BIHOR",56,28193,,305,"CĂRPINET / camin cultural Carpinet",3,2602,"CĂRPINET",28193,452,326,277,49,0,323,3,497,171,170,153
5,"BIHOR",56,28193,,306,"CĂLUGĂRI / Scoala Gimnaziala nr.1 Calugari",3,2602,"CĂRPINET",28193,425,370,300,63,7,362,8,560,190,173,189
5,"BIHOR",56,28193,,307,"IZBUC / Gradinita cu Progr. Normal Izbuc",3,2602,"CĂRPINET",28193,444,367,333,24,10,366,1,491,124,185,181
5,"BIHOR",56,28193,,308,"LEHECENI / camin cultural Leheceni",3,2602,"CĂRPINET",28193,323,246,200,45,1,245,1,357,111,87,158
5,"BIHOR",56,28246,,309,"CEFA / CENTRUL DE AFACERI",3,2607,"CEFA",28246,1036,757,659,82,16,750,7,1141,384,348,402
5,"BIHOR",56,28246,,310,"ATEAŞ / GRADINITA",3,2607,"CEFA",28246,153,140,103,37,0,140,0,168,28,30,110
5,"BIHOR",56,28246,,311,"INAND / CAMIN CULTURAL",3,2607,"CEFA",28246,705,513,452,61,0,509,4,776,263,254,255
5,"BIHOR",56,28335,,312,"CEICA / PRIMARIA COMUNEI CEICA",3,2611,"CEICA",28335,763,492,437,55,0,491,1,841,349,224,267
5,"BIHOR",56,28335,,313,"BUCIUM / SCOALA BUCIUM",3,2611,"CEICA",28335,183,130,108,22,0,130,0,201,71,78,52
5,"BIHOR",56,28335,,314,"CEIŞOARA / SCOALA CEISOARA",3,2611,"CEICA",28335,477,299,269,30,0,295,4,525,226,118,177
5,"BIHOR",56,28335,,315,"CORBEŞTI / SCOALA CORBESTI",3,2611,"CEICA",28335,393,241,217,24,0,239,2,422,181,78,161
5,"BIHOR",56,28335,,316,"COTIGLET / SCOALA COTIGLET",3,2611,"CEICA",28335,340,207,179,28,0,205,2,374,167,100,105
5,"BIHOR",56,28335,,317,"DUŞEŞTI / CAMIN CULTURAL  DUSESTI",3,2611,"CEICA",28335,423,313,267,46,0,310,3,465,152,136,174
5,"BIHOR",56,28335,,318,"INCEŞTI / SCOALA INCESTI",3,2611,"CEICA",28335,300,230,191,39,0,227,3,332,102,114,113
5,"BIHOR",56,28415,,319,"ŞIŞTEREA / Şcoala Generală",3,2619,"CETARIU",28415,495,229,193,36,0,229,0,546,317,28,201
5,"BIHOR",56,28415,,320,"ŞUŞTUROGI / Şcoala Generală",3,2619,"CETARIU",28415,197,125,85,40,0,123,2,217,92,76,47
5,"BIHOR",56,28415,,321,"CETARIU / Cămin cultural",3,2619,"CETARIU",28415,942,414,376,38,0,413,1,1038,624,66,347
5,"BIHOR",56,28415,,322,"TĂUTELEC / Cămin cultural",3,2619,"CETARIU",28415,196,115,85,30,0,113,2,217,102,25,88
5,"BIHOR",56,28497,,323,"CHERECHIU / Şcoala gimnazială ,, Bocskai Istvan,,",3,2624,"CHERECHIU",28497,582,198,185,13,0,195,3,641,443,42,153
5,"BIHOR",56,28497,,324,"CHEŞEREU / Şcoala gimnazială ,, Bocskai Istvan,,",3,2624,"CHERECHIU",28497,797,303,281,22,0,296,7,878,575,74,222
5,"BIHOR",56,28497,,325,"TÎRGUŞOR / Şcoala gimnazială ,, Bocskai Istvan,,",3,2624,"CHERECHIU",28497,448,260,238,22,0,255,5,493,233,48,207
5,"BIHOR",56,28530,,326,"CHIŞLAZ / Şcoala gimnazială Chişlaz",3,2628,"CHIŞLAZ",28530,402,182,155,27,0,181,1,443,261,84,97
5,"BIHOR",56,28530,,327,"CHIRALEU / Şcoala primara Chiraleu",3,2628,"CHIŞLAZ",28530,496,319,291,25,3,316,3,548,229,145,171
5,"BIHOR",56,28530,,328,"HĂUCEŞTI / Fost sediu şcoală primară",3,2628,"CHIŞLAZ",28530,37,33,19,14,0,33,0,42,9,11,22
5,"BIHOR",56,28530,,329,"MIŞCA / Grădiniţa Mişca",3,2628,"CHIŞLAZ",28530,763,366,349,17,0,360,6,843,477,57,303
5,"BIHOR",56,28530,,330,"POCLUŞA DE BARCĂU / Şcoala Pocluşa de Barcău",3,2628,"CHIŞLAZ",28530,306,141,115,26,0,140,1,338,197,40,100
5,"BIHOR",56,28530,,331,"SĂRSIG / Cămin cultural Sărsig",3,2628,"CHIŞLAZ",28530,231,154,125,29,0,154,0,254,100,72,82
5,"BIHOR",56,28530,,332,"SÎNLAZĂR / Şcoala primară Sînlazăr",3,2628,"CHIŞLAZ",28530,347,224,185,39,0,224,0,382,158,99,125
5,"BIHOR",56,28665,,333,"CIUMEGHIU / PRIMARIA COM.CIUMEGHIU",3,2642,"CIUMEGHIU",28665,1454,791,726,65,0,781,10,1602,811,460,321
5,"BIHOR",56,28665,,334,"BOIU / GRADINITA DIN SATUL  BOIU",3,2642,"CIUMEGHIU",28665,611,351,304,46,1,350,1,673,322,162,188
5,"BIHOR",56,28665,,335,"GHIORAC / SCOALA GENERALA GHIORAC",3,2642,"CIUMEGHIU",28665,1317,636,579,57,0,629,7,1451,815,316,313
5,"BIHOR",56,28709,,336,"CÎMPANI / CAMINUL CULTURAL CIMPANI",3,2636,"CÎMPANI",28709,720,527,490,32,5,522,5,793,266,193,329
5,"BIHOR",56,28709,,337,"FÎNAŢE /  SCOALA PRIMARA FINATE",3,2636,"CÎMPANI",28709,543,474,427,46,1,469,5,598,124,179,290
5,"BIHOR",56,28709,,338,"HÎRSEŞTI / SCOALA PRIMARA HIRSESTI",3,2636,"CÎMPANI",28709,288,219,197,18,4,217,2,319,100,95,122
5,"BIHOR",56,28709,,339,"SIGHIŞTEL / SCOALA PRIMARA SIGHISTEL",3,2636,"CÎMPANI",28709,270,214,185,29,0,213,1,298,84,84,129
5,"BIHOR",56,28709,,340,"VALEA DE SUS / SC.PRIMARA VALEA DE SUS",3,2636,"CÎMPANI",28709,261,195,179,16,0,195,0,288,93,119,76
5,"BIHOR",56,28763,,341,"COCIUBA MARE / Caminul Cultural",3,2646,"COCIUBA MARE",28763,757,551,471,56,24,543,8,833,282,195,348
5,"BIHOR",56,28763,,342,"CHEŞA / Caminul Cultural",3,2646,"COCIUBA MARE",28763,484,384,313,59,12,377,7,535,151,133,244
5,"BIHOR",56,28763,,343,"CĂRĂSĂU / Caminul Cultural",3,2646,"COCIUBA MARE",28763,574,339,283,33,23,339,0,632,293,130,209
5,"BIHOR",56,28763,,344,"PETID / Gradinita Petid",3,2646,"COCIUBA MARE",28763,511,462,346,89,27,460,2,562,100,195,265
5,"BIHOR",56,28816,,345,"BUCUROAIA / Scoala Gimnaziala nr.2",3,2651,"COPĂCEL",28816,304,226,200,26,0,221,5,334,108,87,134
5,"BIHOR",56,28816,,346,"CHIJIC / Camin Cultural",3,2651,"COPĂCEL",28816,214,229,148,77,4,227,2,285,56,98,129
5,"BIHOR",56,28816,,347,"SURDUC / Camin Cultural",3,2651,"COPĂCEL",28816,351,284,220,64,0,284,0,387,103,134,150
5,"BIHOR",56,28816,,348,"COPĂCEL / Gradinita cu program normal nr.3",3,2651,"COPĂCEL",28816,344,317,215,98,4,315,2,380,63,165,150
5,"BIHOR",56,28816,,349,"POIANA TĂŞAD / Scoala primara nr.4",3,2651,"COPĂCEL",28816,132,116,88,28,0,113,3,146,30,63,50
5,"BIHOR",56,28816,,350,"SĂRAND / Scoala Primara nr.1",3,2651,"COPĂCEL",28816,399,313,241,69,3,311,2,439,126,172,139
5,"BIHOR",56,28889,,351,"CRIŞTIORU DE JOS / Caminul cultural",3,2658,"CRIŞTIORU DE JOS",28889,296,236,182,45,9,234,2,327,91,166,68
5,"BIHOR",56,28889,,352,"CRIŞTIORU DE SUS / Caminul cultural",3,2658,"CRIŞTIORU DE JOS",28889,80,65,45,17,3,64,1,89,24,43,21
5,"BIHOR",56,28889,,353,"POIANA / Camin Cultural",3,2658,"CRIŞTIORU DE JOS",28889,411,293,259,33,1,290,3,453,160,178,112
5,"BIHOR",56,28889,,354,"SĂLIŞTE DE VAŞCĂU / Scoala cu Clasele I-VIII",3,2658,"CRIŞTIORU DE JOS",28889,363,297,230,50,17,295,2,400,103,174,121
5,"BIHOR",56,28941,,355,"CURĂŢELE / Scoalla Generala cu clasele V-VIII",3,2664,"CURĂŢELE",28941,646,427,387,33,7,424,3,712,285,173,251
5,"BIHOR",56,28941,,356,"BEIUŞELE / Scoalla Generala cu clasele I-IV",3,2664,"CURĂŢELE",28941,375,307,282,20,5,304,3,414,107,77,227
5,"BIHOR",56,28941,,357,"CRESUIA / Scoala Generala cu clasele I-IV",3,2664,"CURĂŢELE",28941,372,281,256,20,5,280,1,411,130,119,161
5,"BIHOR",56,28941,,358,"NIMĂIEŞTI / Camin Cultural Nimaiesti",3,2664,"CURĂŢELE",28941,681,539,489,48,2,534,5,749,210,234,300
5,"BIHOR",56,29001,,359,"CURTUIŞENI / SCOALA GENERALA",3,2670,"CURTUIŞENI",29001,1033,402,382,20,0,399,3,1137,735,109,290
5,"BIHOR",56,29001,,360,"VĂŞAD / SCOALA GENERALA",3,2670,"CURTUIŞENI",29001,679,542,454,88,0,534,8,747,205,362,172
5,"BIHOR",56,29001,,361,"CURTUIŞENI / PRIMARIA CURTUISENI",3,2670,"CURTUIŞENI",29001,1244,483,468,15,0,473,10,1369,886,123,350
5,"BIHOR",56,29038,,362,"DERNA / PRIMARIA DERNA",3,2673,"DERNA",29038,783,407,373,30,4,402,5,862,455,191,211
5,"BIHOR",56,29038,,363,"DERNIŞOARA / SCOALA GENERALA",3,2673,"DERNA",29038,428,261,233,28,0,256,5,471,210,110,146
5,"BIHOR",56,29038,,364,"SACALASĂU / SCOALA GENERALA",3,2673,"DERNA",29038,475,268,239,29,0,265,3,524,256,131,134
5,"BIHOR",56,29038,,365,"SACALASĂU NOU / SCOALA GENERALA",3,2673,"DERNA",29038,234,72,60,12,0,71,1,258,186,49,22
5,"BIHOR",56,29038,,366,"TRIA / SCOALA GENERALA",3,2673,"DERNA",29038,261,162,138,24,0,159,3,289,127,99,60
5,"BIHOR",56,29092,,367,"DIOSIG / PRIMARIA COMUNEI DIOSIG,",3,2679,"DIOSIG",29092,975,390,368,22,0,389,1,1074,684,127,262
5,"BIHOR",56,29092,,368,"DIOSIG / SCOALA NOUA CENTRU DIOSIG,",3,2679,"DIOSIG",29092,919,378,353,25,0,374,4,1012,634,75,299
5,"BIHOR",56,29092,,369,"DIOSIG / SCOALA CU CLASELE I-IV",3,2679,"DIOSIG",29092,945,412,398,14,0,411,1,1042,630,92,319
5,"BIHOR",56,29092,,370,"DIOSIG / SCOALA CU CLASELE I-IV",3,2679,"DIOSIG",29092,1352,735,676,59,0,729,6,1488,753,286,443
5,"BIHOR",56,29092,,371,"DIOSIG / SCOALA CU CLASELE I-IV",3,2679,"DIOSIG",29092,989,572,548,24,0,556,16,1089,517,396,160
5,"BIHOR",56,29092,,372,"DIOSIG / SCOALA CU CLASELE I-IV IANCA,",3,2679,"DIOSIG",29092,240,104,90,14,0,104,0,264,160,21,83
5,"BIHOR",56,29154,,373,"DOBREŞTI / CAMIN CULTURAL DOBRESTI",3,2682,"DOBREŞTI",29154,1485,900,839,61,0,891,9,1636,736,428,463
5,"BIHOR",56,29154,,374,"LUNCASPRIE / CAMIN CULTURAL LUNCASPRIE",3,2682,"DOBREŞTI",29154,801,508,467,41,0,503,5,882,374,173,330
5,"BIHOR",56,29154,,375,"HIDIŞEL / CAMIN CULTURAL HIDISEL",3,2682,"DOBREŞTI",29154,533,334,297,37,0,333,1,587,253,144,189
5,"BIHOR",56,29154,,376,"CRÎNCEŞTI / CAMIN CULTURAL CRINCESTI",3,2682,"DOBREŞTI",29154,347,229,200,29,0,228,1,383,154,141,87
5,"BIHOR",56,29154,,377,"CORNIŞEŞTI / CAMIN CULTURAL CORNISESTI",3,2682,"DOBREŞTI",29154,187,150,122,28,0,149,1,207,57,81,68
5,"BIHOR",56,29154,,378,"TOPA DE JOS / SCOALA S04 TOPA DE JOS",3,2682,"DOBREŞTI",29154,155,119,97,22,0,118,1,172,53,58,60
5,"BIHOR",56,29154,,379,"TOPA DE SUS / CAMIN CULTURAL TOPA DE SUS",3,2682,"DOBREŞTI",29154,488,315,289,26,0,312,3,538,223,173,139
5,"BIHOR",56,29243,,380,"DRĂGĂNEŞTI / Primaria Draganesti",3,2691,"DRĂGĂNEŞTI",29243,363,261,238,23,0,261,0,400,139,159,102
5,"BIHOR",56,29243,,381,"BELEJENI / Scoala primara Belejeni",3,2691,"DRĂGĂNEŞTI",29243,249,189,179,10,0,187,2,273,84,114,73
5,"BIHOR",56,29243,,382,"GRĂDINARI / Scoala romana Gradinari",3,2691,"DRĂGĂNEŞTI",29243,367,236,211,25,0,236,0,404,168,61,175
5,"BIHOR",56,29243,,383,"LIVADA BEIUŞULUI / Scoala primara Livada",3,2691,"DRĂGĂNEŞTI",29243,108,85,75,10,0,85,0,119,34,49,36
5,"BIHOR",56,29243,,384,"MIZIEŞ / Fostul Sfat Popular  Mizies",3,2691,"DRĂGĂNEŞTI",29243,419,299,276,22,1,298,1,462,163,176,122
5,"BIHOR",56,29243,,385,"PĂNTĂŞEŞTI / Caminul cultural Pantasesti",3,2691,"DRĂGĂNEŞTI",29243,118,115,91,23,1,115,0,130,15,47,68
5,"BIHOR",56,29243,,386,"ŞEBIŞ / Scoala  Sebis",3,2691,"DRĂGĂNEŞTI",29243,263,195,179,16,0,193,2,289,94,104,89
5,"BIHOR",56,29243,,387,"TALPE / Scoala primara Talpe",3,2691,"DRĂGĂNEŞTI",29243,209,156,142,14,0,155,1,230,74,78,77
5,"BIHOR",56,29243,,388,"ŢIGĂNEŞTII DE BEIUŞ / Caminul cultural Tiganesti",3,2691,"DRĂGĂNEŞTI",29243,128,81,77,4,0,80,1,141,60,47,33
5,"BIHOR",56,29243,,389,"PĂCĂLEŞTI / Caminul cultural Pacalesti",3,2691,"DRĂGĂNEŞTI",29243,169,155,129,26,0,154,1,186,31,86,68
5,"BIHOR",56,29341,,390,"DRĂGEŞTI / PRIMĂRIA DRĂGEŞTI",3,2702,"DRĂGEŞTI",29341,285,202,165,35,2,199,3,314,112,92,107
5,"BIHOR",56,29341,,391,"DICĂNEŞTI / CĂMINUL CULTURAL",3,2702,"DRĂGEŞTI",29341,207,181,139,40,2,181,0,228,47,57,124
5,"BIHOR",56,29341,,392,"STRACOŞ / ŞCOALA CU CLS.I-IV",3,2702,"DRĂGEŞTI",29341,193,176,129,39,8,174,2,213,37,93,81
5,"BIHOR",56,29341,,393,"TĂŞAD / ŞCOALA CU CLS.I-VIIi",3,2702,"DRĂGEŞTI",29341,950,682,589,90,3,677,5,1046,364,283,394
5,"BIHOR",56,29341,,394,"TOPEŞTI / ŞCOALA CU CLS.I-IV",3,2702,"DRĂGEŞTI",29341,179,125,104,21,0,125,0,198,73,54,71
5,"BIHOR",56,29403,,395,"FINIŞ / Primaria Finis",3,2708,"FINIŞ",29403,1359,877,838,39,0,868,9,1495,618,307,561
5,"BIHOR",56,29403,,396,"FIZIŞ / Gradinita Fizis",3,2708,"FINIŞ",29403,193,150,136,14,0,149,1,212,62,88,61
5,"BIHOR",56,29403,,397,"IOANIŞ / Scoala Generala Ioanis",3,2708,"FINIŞ",29403,577,382,363,19,0,381,1,635,253,199,182
5,"BIHOR",56,29403,,398,"ŞUNCUIŞ / Gradinita Suncuis",3,2708,"FINIŞ",29403,648,357,336,21,0,355,2,714,357,156,199
5,"BIHOR",56,32195,,399,"GEPIU / SCOALA CU CLS I.-VIII GEPIU",3,2714,"GEPIU",32195,961,890,638,246,6,882,8,1058,168,531,351
5,"BIHOR",56,32195,,400,"BICACI / SCOALA CU CLS I.-IV BICACI",3,2714,"GEPIU",32195,470,353,296,57,0,350,3,518,165,144,206
5,"BIHOR",56,29467,,401,"GIRIŞU DE CRIŞ / Primăria Girişu de Criş",3,2717,"GIRIŞU DE CRIŞ",29467,1238,753,667,86,0,747,6,1363,610,299,448
5,"BIHOR",56,29467,,402,"TĂRIAN / Grădiniţa Tărian",3,2717,"GIRIŞU DE CRIŞ",29467,968,623,571,52,0,615,8,1066,443,111,504
5,"BIHOR",56,29467,,403,"TĂRIAN / Cămin cultural Tărian",3,2717,"GIRIŞU DE CRIŞ",29467,828,430,387,43,0,426,4,912,482,183,243
5,"BIHOR",56,29519,,404,"HIDIŞELU DE SUS / CAMIN CULTURAL HIDISELU DE SUS",3,2720,"HIDIŞELU DE SUS",29519,857,755,599,154,2,753,2,944,189,333,420
5,"BIHOR",56,29519,,405,"HIDIŞELU DE JOS / SCOALA PRIMARA HIDISELU DE JOS",3,2720,"HIDIŞELU DE SUS",29519,474,389,330,59,0,389,0,522,133,137,252
5,"BIHOR",56,29519,,406,"MIERLĂU / CAMIN CULTURAL MIERLAU",3,2720,"HIDIŞELU DE SUS",29519,605,466,407,58,1,463,3,668,202,201,262
5,"BIHOR",56,29519,,407,"SÎNTELEC / SCOALA PRIMARA SINTELEC",3,2720,"HIDIŞELU DE SUS",29519,303,232,203,29,0,231,1,333,101,110,121
5,"BIHOR",56,29519,,408,"ŞUMUGIU / CAMIN CULTURAL SUMUGIU",3,2720,"HIDIŞELU DE SUS",29519,329,279,189,74,16,277,2,363,84,78,199
5,"BIHOR",56,29573,,409,"DUMBRAVA / CAMIN CULTURAL",3,2726,"HOLOD",29573,464,410,307,47,56,407,3,511,101,282,125
5,"BIHOR",56,29573,,410,"DUMBRĂVIŢA / CAMIN CULTURAL",3,2726,"HOLOD",29573,167,143,101,41,1,143,0,184,41,76,67
5,"BIHOR",56,29573,,411,"FOROSIG / CAMIN CULTURAL",3,2726,"HOLOD",29573,131,106,79,25,2,106,0,144,38,53,53
5,"BIHOR",56,29573,,412,"LUPOAIA / CAMIN CULTURAL",3,2726,"HOLOD",29573,410,189,142,42,5,188,1,452,263,122,66
5,"BIHOR",56,29573,,413,"VINTERE / GRADINITA",3,2726,"HOLOD",29573,615,486,390,66,30,484,2,678,192,316,168
5,"BIHOR",56,29573,,414,"HOLOD / SCOALA GIMNAZIALA IOSIF VULCAN",3,2726,"HOLOD",29573,402,383,248,109,26,379,4,412,29,248,131
5,"BIHOR",56,29573,,415,"HODIŞ / CĂMIN CULTURAL HODIŞ",3,2726,"HOLOD",29573,154,157,96,45,16,157,0,169,12,114,43
5,"BIHOR",56,29573,,416,"VALEA MARE DE CODRU / SCOALA CU CLS I-IV",3,2726,"HOLOD",29573,65,95,44,51,0,94,1,103,8,57,37
5,"BIHOR",56,29662,,417,"HUSASĂU DE TINCA / GRADINITA DE COPII",3,2735,"HUSASĂU DE TINCA",29662,606,422,318,88,16,422,0,668,246,269,153
5,"BIHOR",56,29662,,418,"FONĂU / SCOALA CU CLS.I-IV FONAU",3,2735,"HUSASĂU DE TINCA",29662,148,117,95,22,0,116,1,164,47,88,28
5,"BIHOR",56,29662,,419,"MIERSIG / SCOALA CU CLS.I-IV MIERSIG",3,2735,"HUSASĂU DE TINCA",29662,308,217,160,57,0,214,3,340,123,93,121
5,"BIHOR",56,29662,,420,"OŞAND / SCOLA CU CLS.I-IV OSAND",3,2735,"HUSASĂU DE TINCA",29662,352,224,188,31,5,221,3,388,164,157,64
5,"BIHOR",56,29662,,421,"SITITELEC / SCOALA CU CLS.I-IV SITITELEC",3,2735,"HUSASĂU DE TINCA",29662,274,205,130,62,13,204,1,301,96,102,102
5,"BIHOR",56,29724,,422,"INEU / caminul cultural Ineu",3,2741,"INEU",29724,852,599,510,89,0,589,10,938,339,183,406
5,"BIHOR",56,29724,,423,"INEU / Gradinita Ineu",3,2741,"INEU",29724,980,550,504,46,0,541,9,1079,529,415,126
5,"BIHOR",56,29724,,424,"BOTEAN / sCOALA NR.1Botean",3,2741,"INEU",29724,541,283,257,26,0,280,3,596,313,133,147
5,"BIHOR",56,29724,,425,"HUSASĂU DE CRIŞ / Caminul cultural   Husasau",3,2741,"INEU",29724,870,565,488,77,0,561,4,958,393,308,253
5,"BIHOR",56,29760,,426,"LAZURI DE BEIUŞ / Primaria",3,2754,"LAZURI DE BEIUŞ",29760,287,251,216,30,5,251,0,316,65,51,200
5,"BIHOR",56,29760,,427,"HINCHIRIŞ / Camin Cultural",3,2754,"LAZURI DE BEIUŞ",29760,542,461,411,46,4,457,4,595,134,105,352
5,"BIHOR",56,29760,,428,"CUSUIUŞ / Scoala cu. Cls. I-IV",3,2754,"LAZURI DE BEIUŞ",29760,380,261,232,27,2,260,1,419,158,91,169
5,"BIHOR",56,29760,,429,"BĂLENI / Scoala cu cls. I-IV",3,2754,"LAZURI DE BEIUŞ",29760,176,145,126,18,1,143,2,195,50,50,93
5,"BIHOR",56,29813,,430,"GEPIŞ / CAMIN CULTURAL",3,2745,"LĂZĂRENI",29813,512,379,292,83,4,376,3,554,175,269,107
5,"BIHOR",56,29813,,431,"GRUILUNG / CAMIN CULTURAL",3,2745,"LĂZĂRENI",29813,93,71,42,29,0,70,1,103,32,36,34
5,"BIHOR",56,29813,,432,"MIHELEU / CAMIN CULTURAL",3,2745,"LĂZĂRENI",29813,141,132,81,51,0,132,0,156,24,81,51
5,"BIHOR",56,29813,,433,"LĂZĂRENI / CAMIN CULTURAL LAZARENI",3,2745,"LĂZĂRENI",29813,600,510,432,74,4,505,5,661,151,338,167
5,"BIHOR",56,29813,,434,"CĂRĂNDENI / SCOALA PRIMARA",3,2745,"LĂZĂRENI",29813,328,236,188,48,0,236,0,363,127,132,104
5,"BIHOR",56,29813,,435,"CĂRĂNZEL / CAMIN CULTURAL CARANZEL",3,2745,"LĂZĂRENI",29813,77,88,43,39,6,86,2,95,7,54,32
5,"BIHOR",56,29813,,436,"CALEA MARE / SCOALA GIMNAZIALA",3,2745,"LĂZĂRENI",29813,498,367,318,47,2,364,3,549,182,208,156
5,"BIHOR",56,29902,,437,"LUGAŞU DE JOS / Cămin cultural Lugaşu de Jos",3,2759,"LUGAŞU DE JOS",29902,1243,937,801,97,39,925,12,1367,430,550,375
5,"BIHOR",56,29902,,438,"LUGAŞU DE SUS / Cămin cultural Lugaşu de Sus",3,2759,"LUGAŞU DE JOS",29902,673,496,452,40,4,492,4,741,245,222,270
5,"BIHOR",56,29902,,439,"URVIND / Cămin cultural Urvind",3,2759,"LUGAŞU DE JOS",29902,773,596,482,80,34,592,4,850,254,339,253
5,"BIHOR",56,29948,,440,"LUNCA / CĂMINUL CULTURAL LUNCA",3,2763,"LUNCA",29948,782,637,518,112,7,633,4,861,224,274,359
5,"BIHOR",56,29948,,441,"BRIHENI / CĂMINUL CULTURAL BRIHENI",3,2763,"LUNCA",29948,279,237,205,23,9,236,1,308,71,68,168
5,"BIHOR",56,29948,,442,"HOTĂREL / CĂMINUL CULTURAL HOTĂREL",3,2763,"LUNCA",29948,253,237,187,47,3,233,4,279,42,111,122
5,"BIHOR",56,29948,,443,"SEGHIŞTE / CĂMINUL CULTURAL SEGHIŞTE",3,2763,"LUNCA",29948,496,450,391,47,12,446,4,546,96,107,339
5,"BIHOR",56,29948,,444,"SÎRBEŞTI / CAMINUL CULTURAL SIRBESTI",3,2763,"LUNCA",29948,249,207,173,32,2,204,3,274,67,89,115
5,"BIHOR",56,29948,,445,"ŞUŞTIU / CĂMINUL CULTURAL ŞUŞTIU",3,2763,"LUNCA",29948,387,326,259,61,6,320,6,427,101,167,153
5,"BIHOR",56,30014,,446,"MARŢIHAZ / CĂMIN CULTURAL",3,2770,"MĂDĂRAŞ",30014,163,117,89,28,0,116,1,179,62,44,72
5,"BIHOR",56,30014,,447,"MĂDĂRAŞ / SCOALA CU CLS I.-VIII",3,2770,"MĂDĂRAŞ",30014,768,495,425,66,4,494,1,846,351,172,322
5,"BIHOR",56,30014,,448,"HOMOROG / FOSTA SCOALA CU CLS I.-IV",3,2770,"MĂDĂRAŞ",30014,588,409,340,69,0,406,3,648,239,198,208
5,"BIHOR",56,30014,,449,"IANOŞDA / ŞCOALA CU CLASELE I-VIII",3,2770,"MĂDĂRAŞ",30014,744,482,414,68,0,478,4,821,339,248,230
5,"BIHOR",56,30069,,450,"MĂGEŞTI / PRIMARIA MAGESTI",3,2775,"MĂGEŞTI",30069,226,170,147,23,0,166,4,250,80,55,111
5,"BIHOR",56,30069,,451,"BUTANI / SCOALA GENERALA",3,2775,"MĂGEŞTI",30069,299,226,215,11,0,223,3,329,103,71,152
5,"BIHOR",56,30069,,452,"ORTITEAG / SCOALA GENERALA",3,2775,"MĂGEŞTI",30069,407,293,266,27,0,291,2,448,155,143,148
5,"BIHOR",56,30069,,453,"CACUCIU NOU / SCOALA GENERALA",3,2775,"MĂGEŞTI",30069,279,230,193,37,0,228,2,308,78,55,173
5,"BIHOR",56,30069,,454,"JOSANI / SCOALA GENERALA",3,2775,"MĂGEŞTI",30069,297,205,189,15,1,203,2,327,122,69,134
5,"BIHOR",56,30069,,455,"DOBRICIONEŞTI / CAMIN CULTURAL",3,2775,"MĂGEŞTI",30069,449,320,293,26,1,316,4,494,174,121,195
5,"BIHOR",56,30069,,456,"GĂLĂŞENI / SCOALA GENERALA",3,2775,"MĂGEŞTI",30069,238,158,143,15,0,158,0,262,104,52,106
5,"BIHOR",56,30149,,457,"NOJORID / UNITATE DE INVĂŢĂMÂNT",3,2783,"NOJORID",30149,1669,1268,1093,174,1,1252,16,1837,569,399,853
5,"BIHOR",56,30149,,458,"APATEU / Sc Apateu",3,2783,"NOJORID",30149,201,210,130,80,0,207,3,222,12,81,126
5,"BIHOR",56,30149,,459,"CHIŞIRID / Sc Chi;irid",3,2783,"NOJORID",30149,191,177,95,82,0,175,2,210,33,58,117
5,"BIHOR",56,30149,,460,"LEŞ / Sc cu Cl I-VIII Leş",3,2783,"NOJORID",30149,617,405,332,73,0,404,1,680,275,103,301
5,"BIHOR",56,30149,,461,"LIVADA DE BIHOR / Grădiniţă Livada de Bihor",3,2783,"NOJORID",30149,1104,733,648,85,0,723,10,1215,482,179,544
5,"BIHOR",56,30149,,462,"PĂUŞA / Şcoală Păuşa",3,2783,"NOJORID",30149,231,200,146,54,0,199,1,255,55,104,95
5,"BIHOR",56,30149,,463,"ŞAUAIEU / Şc . Şauaieu",3,2783,"NOJORID",30149,224,197,139,58,0,196,1,246,49,53,143
5,"BIHOR",56,30229,,464,"OLCEA / SCOALA CU CLS. I-VIII OLCEA",3,2791,"OLCEA",30229,462,317,286,25,6,313,4,509,192,108,205
5,"BIHOR",56,30229,,465,"CĂLACEA / SCOALA CU CLS.I-VIII CALACEA",3,2791,"OLCEA",30229,954,660,615,42,3,647,13,1050,390,272,375
5,"BIHOR",56,30229,,466,"HODIŞEL / SCOALA CU CLS. I-VIII HODISEL",3,2791,"OLCEA",30229,281,189,166,13,10,189,0,310,121,79,110
5,"BIHOR",56,30229,,467,"UCURIŞ / SCOALA CU CLS. I-IV UCURIS",3,2791,"OLCEA",30229,438,247,204,42,1,246,1,484,237,94,152
5,"BIHOR",56,30274,,468,"OŞORHEI / SCOALA GIMNAZIALA NR. 1 OSORHEI",3,2796,"OŞORHEI",30274,1273,763,663,100,0,758,5,1351,588,139,619
5,"BIHOR",56,30274,,469,"OŞORHEI / SCOALA GIMNAZIALA NR. 1 OSORHEI",3,2796,"OŞORHEI",30274,1312,796,707,89,0,784,12,1394,598,208,576
5,"BIHOR",56,30274,,470,"ALPAREA /  Şcoala Primară nr.1 Alparea",3,2796,"OŞORHEI",30274,829,670,552,118,0,662,8,913,243,263,399
5,"BIHOR",56,30274,,471,"CHERIU / Şcoala Primară nr.2 Cheriu",3,2796,"OŞORHEI",30274,566,380,320,60,0,370,10,624,244,135,235
5,"BIHOR",56,30274,,472,"FELCHERIU / Cămin Cultural Felcheriu",3,2796,"OŞORHEI",30274,272,290,196,94,0,288,2,350,60,119,169
5,"BIHOR",56,30274,,473,"FUGHIU / Cămin Cultural Fughiu",3,2796,"OŞORHEI",30274,901,580,514,66,0,576,4,992,412,100,476
5,"BIHOR",56,32161,,474,"PALEU / Scoala cu cls. I-IV",3,2802,"PALEU",32161,1044,709,594,115,0,706,3,1149,440,127,579
5,"BIHOR",56,32161,,475,"UILEACU DE MUNTE / Scoala cu cls. I-IV",3,2802,"PALEU",32161,424,236,219,17,0,234,2,466,230,43,191
5,"BIHOR",56,32161,,476,"SĂLDĂBAGIU DE MUNTE / Scoala cu cls. I-IV",3,2802,"PALEU",32161,663,411,370,41,0,405,6,730,319,36,369
5,"BIHOR",56,30336,,477,"PIETROASA / Şcoala gimnazială nr.1 Pietroasa",3,2806,"PIETROASA",30336,666,493,444,49,0,485,8,734,241,308,177
5,"BIHOR",56,30336,,478,"GURANI / Scoala primară nr.1 Gurani",3,2806,"PIETROASA",30336,525,378,343,35,0,374,4,579,201,178,196
5,"BIHOR",56,30336,,479,"COCIUBA MICĂ / Scoala primară nr.2 Cociuba Mică",3,2806,"PIETROASA",30336,355,228,212,16,0,227,1,392,164,110,117
5,"BIHOR",56,30336,,480,"CHIŞCĂU / Scoala gimnazială nr.2 Chişcău",3,2806,"PIETROASA",30336,611,379,348,31,0,376,3,673,294,176,200
5,"BIHOR",56,30336,,481,"GIULEŞTI / Şcoala primară nr.4 Giuleşti",3,2806,"PIETROASA",30336,137,101,93,8,0,101,0,151,50,52,49
5,"BIHOR",56,30336,,482,"MĂGURA / Scoala primară nr.3 Măgura",3,2806,"PIETROASA",30336,249,167,156,11,0,167,0,274,107,103,64
5,"BIHOR",56,30336,,483,"MOŢEŞTI / Scoala primară nr.5 Moţeşti",3,2806,"PIETROASA",30336,78,60,52,8,0,60,0,87,27,31,29
5,"BIHOR",56,30416,,484,"POIETARI / CAMINUL CULTURAL POCOLA",3,2814,"POCOLA",30416,439,367,310,57,0,365,2,483,116,226,139
5,"BIHOR",56,30416,,485,"FENERIŞ / CAMINUL  CULTURAL FENERIŞ",3,2814,"POCOLA",30416,303,302,226,76,0,294,8,334,32,184,110
5,"BIHOR",56,30416,,486,"PETRANI / CAMIN CULTURAL PETRANI",3,2814,"POCOLA",30416,287,259,206,53,0,258,1,317,58,154,104
5,"BIHOR",56,30416,,487,"SÎNMARTIN DE BEIUŞ / CAMIN CULTURAL SINMARTIN DE BEIUŞ",3,2814,"POCOLA",30416,204,172,147,25,0,171,1,226,54,86,85
5,"BIHOR",56,30470,,488,"COŞDENI / CAMIN CULTURAL",3,2820,"POMEZEU",30470,474,293,268,25,0,289,4,521,228,171,118
5,"BIHOR",56,30470,,489,"HIDIŞ / CAMIN CULTURAL",3,2820,"POMEZEU",30470,292,232,196,36,0,230,2,322,90,116,114
5,"BIHOR",56,30470,,490,"SPINUŞ DE POMEZEU / CAMIN CULTURAL",3,2820,"POMEZEU",30470,195,168,138,30,0,168,0,215,47,50,118
5,"BIHOR",56,30470,,491,"VĂLANI DE POMEZEU / CAMIN CULTURAL",3,2820,"POMEZEU",30470,482,303,281,22,0,301,2,531,228,127,174
5,"BIHOR",56,30470,,492,"SITANI / SCOALA GENERALA",3,2820,"POMEZEU",30470,376,272,241,31,0,270,2,414,142,113,157
5,"BIHOR",56,30470,,493,"POMEZEU / SC.GEN.POMEZEU",3,2820,"POMEZEU",30470,120,105,87,18,0,105,0,133,28,41,64
5,"BIHOR",56,30470,,494,"LACU SĂRAT / SC.GEN.POMEZEU",3,2820,"POMEZEU",30470,39,35,25,10,0,35,0,43,8,19,16
5,"BIHOR",56,30470,,495,"CÎMPANI DE POMEZEU / SALA DE FESTIVITATI",3,2820,"POMEZEU",30470,359,230,205,25,0,230,0,395,165,105,125
5,"BIHOR",56,30568,,496,"POPEŞTI / LICEUL TEHNOLOGIC NR 1 POPESTI",3,2829,"POPEŞTI",30568,919,492,457,34,1,485,7,1012,520,242,243
5,"BIHOR",56,30568,,497,"POPEŞTI / LICEUL TEHNOLOGIC NR 1 POPESTI",3,2829,"POPEŞTI",30568,1014,635,568,30,37,627,8,1115,480,361,266
5,"BIHOR",56,30568,,498,"VOIVOZI / ŞCOALA GENERALĂ VOIVOZI",3,2829,"POPEŞTI",30568,789,504,485,18,1,504,0,869,365,327,177
5,"BIHOR",56,30568,,499,"VOIVOZI / ŞCOALA GENERALĂ VOIVOZI",3,2829,"POPEŞTI",30568,650,383,367,16,0,380,3,717,334,236,144
5,"BIHOR",56,30568,,500,"BISTRA / SCOALA GENERALA BISTRA",3,2829,"POPEŞTI",30568,847,502,476,26,0,490,12,933,431,277,213
5,"BIHOR",56,30568,,501,"BUDOI / LICEUL JOSEF KOZACEK BUDOI",3,2829,"POPEŞTI",30568,767,287,267,19,1,282,5,844,557,164,118
5,"BIHOR",56,30568,,502,"CUZAP / SCOALA GENERALA CUZAP",3,2829,"POPEŞTI",30568,971,570,532,38,0,562,8,1069,499,335,227
5,"BIHOR",56,30568,,503,"VARVIZ / SCOALA GENERALA VARVIZ",3,2829,"POPEŞTI",30568,431,314,296,18,0,313,1,475,161,184,129
5,"BIHOR",56,30568,,504,"VĂRZARI / SCOALA GENERALA VARZARI",3,2829,"POPEŞTI",30568,253,132,122,10,0,130,2,279,147,58,72
5,"BIHOR",56,30648,,505,"RĂBĂGANI / Căminul Cultural",3,2837,"RĂBĂGANI",30648,513,370,315,52,3,367,3,565,195,157,210
5,"BIHOR",56,30648,,506,"ALBEŞTI / Căminul Cultural",3,2837,"RĂBĂGANI",30648,230,199,157,39,3,197,2,254,55,110,87
5,"BIHOR",56,30648,,507,"SALIŞTE DE POMEZEU / Căminul Cultural",3,2837,"RĂBĂGANI",30648,100,89,67,22,0,89,0,111,22,33,56
5,"BIHOR",56,30648,,508,"SĂUCANI / Căminul Cultural",3,2837,"RĂBĂGANI",30648,374,286,234,52,0,286,0,414,128,167,119
5,"BIHOR",56,30648,,509,"VĂRĂŞENI / Căminul Cultural",3,2837,"RĂBĂGANI",30648,329,213,183,29,1,212,1,363,150,141,71
5,"BIHOR",56,30648,,510,"BRĂTEŞTI / Fosta G.P.N.",3,2837,"RĂBĂGANI",30648,111,104,74,30,0,102,2,123,19,47,55
5,"BIHOR",56,30719,,511,"REMETEA / SCOALA GIMNAZIALA NR 1",3,2844,"REMETEA",30719,671,516,449,67,0,512,4,739,223,209,303
5,"BIHOR",56,30719,,512,"MEZIAD / SCOALA GIMNAZIALA NR 2",3,2844,"REMETEA",30719,919,763,694,62,7,757,6,937,174,598,159
5,"BIHOR",56,30719,,513,"DRĂGOTENI / SCOALA PRIMARĂ nr. 2",3,2844,"REMETEA",30719,323,297,243,54,0,293,4,356,59,161,132
5,"BIHOR",56,30719,,514,"PETREASA / SCOALA PRIMARĂ nr. 1",3,2844,"REMETEA",30719,336,267,203,64,0,266,1,371,104,150,116
5,"BIHOR",56,30719,,515,"SOIMUŞ / CĂMINUL CULTURAL ŞOIMUŞ",3,2844,"REMETEA",30719,104,121,75,46,0,121,0,189,68,54,67
5,"BIHOR",56,30773,,516,"RIENI / CAMIN CULTURAL RIENI",3,2850,"RIENI",30773,458,405,304,80,21,400,5,505,100,139,261
5,"BIHOR",56,30773,,517,"GHIGHIŞENI / CAMIN CULTURAL GHIGHISENI",3,2850,"RIENI",30773,795,655,547,87,21,651,4,875,220,236,415
5,"BIHOR",56,30773,,518,"VALEA DE JOS / CAMIN CULTURAL VALEA DE JOS",3,2850,"RIENI",30773,470,441,345,84,12,441,0,517,76,199,242
5,"BIHOR",56,30773,,519,"PETRILENI / CAMIN CULTURAL PETRILENI",3,2850,"RIENI",30773,484,328,259,60,9,320,8,533,205,130,190
5,"BIHOR",56,30773,,520,"SUDRIGIU / CAMIN CULTURAL SUDRIGIU",3,2850,"RIENI",30773,281,243,196,42,5,239,4,309,66,66,173
5,"BIHOR",56,30844,,521,"ROŞIA / CAMINUL CULTURAL",3,2857,"ROŞIA",30844,1611,1248,1169,78,1,1245,3,1774,526,612,633
5,"BIHOR",56,30844,,522,"LAZURI / SCOALA CU CLS. I-IV",3,2857,"ROŞIA",30844,328,273,258,15,0,269,4,362,89,132,137
5,"BIHOR",56,32187,,523,"ROŞIORI /  ŞCOALA GIMNAZIALĂ ""JAKO ZSIGMOND""",3,2860,"ROŞIORI",32187,1135,530,492,38,0,528,2,1250,720,144,384
5,"BIHOR",56,32187,,524,"MIHAI BRAVU /  ŞCOALA GIMNAZIALĂ NR.1",3,2860,"ROŞIORI",32187,841,489,435,54,0,488,1,927,438,197,291
5,"BIHOR",56,32187,,525,"VAIDA /  ŞCOALA PRIMARANR.1",3,2860,"ROŞIORI",32187,406,196,159,37,0,192,4,447,251,46,146
5,"BIHOR",56,30871,,526,"SĂCĂDAT / Cămin Cultural",3,2864,"SĂCĂDAT",30871,729,576,419,138,19,572,4,802,226,326,246
5,"BIHOR",56,30871,,527,"SĂBOLCIU / Cămin cultural",3,2864,"SĂCĂDAT",30871,574,389,323,66,0,385,4,631,242,135,250
5,"BIHOR",56,30871,,528,"BORŞA / Fosta Şcoală cu cls.I-IV",3,2864,"SĂCĂDAT",30871,129,118,66,51,1,117,1,142,24,65,52
5,"BIHOR",56,30988,,529,"OTOMANI / CĂMINUL CULTURAL",3,2868,"SĂLACEA",30988,601,257,231,26,0,255,2,662,405,44,211
5,"BIHOR",56,30988,,530,"SĂLACEA / PRIMĂRIA SĂLACEA",3,2868,"SĂLACEA",30988,967,351,339,12,0,349,2,1065,714,101,248
5,"BIHOR",56,30988,,531,"SĂLACEA / Scoală Generală",3,2868,"SĂLACEA",30988,904,310,299,11,0,305,5,995,685,66,239
5,"BIHOR",56,31011,,532,"HODOŞ / SCOALA PRIMARA NR.1",3,2871,"SĂLARD",31011,609,236,213,23,0,234,2,671,435,25,209
5,"BIHOR",56,31011,,533,"SĂLARD / LICEUL TEHNOLOGIC SZALARDI JANOS",3,2871,"SĂLARD",31011,1221,575,530,45,0,571,4,1344,769,146,425
5,"BIHOR",56,31011,,534,"SĂLARD / LICEUL TEHNOLOGIC SZALARDI JANOS",3,2871,"SĂLARD",31011,1241,579,556,23,0,574,5,1366,787,182,392
5,"BIHOR",56,31011,,535,"SÎNTIMREU / SCOALA PRIMARA NR. 2",3,2871,"SĂLARD",31011,480,192,166,26,0,190,2,529,337,41,149
5,"BIHOR",56,32179,,536,"SÂNNICOLAU ROMÂN / CAMIN CULTURAL",3,2880,"SĂNNICOLAU ROMĂN",32179,901,631,502,99,30,625,6,992,361,341,284
5,"BIHOR",56,32179,,537,"BERECHIU / SCOALA GENERALA",3,2880,"SĂNNICOLAU ROMĂN",32179,268,191,159,32,0,190,1,296,105,115,75
5,"BIHOR",56,32179,,538,"ROIT / GRADINITA",3,2880,"SĂNNICOLAU ROMĂN",32179,513,336,304,30,2,332,4,565,229,208,124
5,"BIHOR",56,28610,,539,"CIUHOI / Şcoala Generală",3,2875,"SÂNIOB",28610,286,167,135,32,0,164,3,315,148,64,100
5,"BIHOR",56,28610,,540,"CENALOŞ / Şcoala Generală",3,2875,"SÂNIOB",28610,214,137,112,25,0,136,1,236,99,59,77
5,"BIHOR",56,28610,,541,"SFÂRNAŞ / Şcoala Generală",3,2875,"SÂNIOB",28610,219,142,110,32,0,141,1,242,99,48,93
5,"BIHOR",56,28610,,542,"SÂNIOB / casa de nunta",3,2875,"SÂNIOB",28610,1036,608,559,41,8,602,6,1142,534,112,490
5,"BIHOR",56,31057,,543,"SÎMBĂTA / CAMINUL CULTURAL",3,2884,"SÎMBĂTA",31057,293,274,193,57,24,270,4,323,49,141,129
5,"BIHOR",56,31057,,544,"COPĂCENI / CAMINUL CULTURAL",3,2884,"SÎMBĂTA",31057,105,116,74,38,4,114,2,137,21,66,48
5,"BIHOR",56,31057,,545,"OGEŞTI / CAMINUL CULTURAL",3,2884,"SÎMBĂTA",31057,175,150,124,25,1,148,2,173,23,81,67
5,"BIHOR",56,31057,,546,"ROTĂREŞTI / CAMINUL CULTURAL",3,2884,"SÎMBĂTA",31057,129,120,78,33,9,120,0,143,23,69,51
5,"BIHOR",56,31057,,547,"ROGOZ / CAMINUL CULTURAL",3,2884,"SÎMBĂTA",31057,244,223,170,47,6,222,1,238,15,139,83
5,"BIHOR",56,31057,,548,"ZĂVOIU / CAMINUL CULTURAL",3,2884,"SÎMBĂTA",31057,191,227,155,67,5,222,5,241,14,122,100
5,"BIHOR",56,26582,,549,"BETFIA / Scoala cu clasele I-IV",3,2895,"SÎNMARTIN",26582,376,289,230,59,0,287,2,416,127,89,198
5,"BIHOR",56,26582,,550,"SÎNMARTIN / Grădiniţa Sânmartin",3,2895,"SÎNMARTIN",26582,1651,1114,970,144,0,1106,8,1418,304,303,803
5,"BIHOR",56,26582,,551,"SÎNMARTIN / Scoala cu cls. I-VIII",3,2895,"SÎNMARTIN",26582,1633,1310,1055,255,0,1298,12,1547,237,309,989
5,"BIHOR",56,26582,,552,"BĂILE FELIX / Gradinita Baile Felix",3,2895,"SÎNMARTIN",26582,494,1600,321,1201,78,1584,16,1870,270,607,977
5,"BIHOR",56,26582,,553,"CIHEI / Sc. Generala cu cls.I-IV",3,2895,"SÎNMARTIN",26582,1006,743,655,88,0,738,5,808,65,238,500
5,"BIHOR",56,26582,,554,"HAIEU / Sc. Generala cu cls.I-IV",3,2895,"SÎNMARTIN",26582,957,1091,658,431,2,1083,8,1354,263,335,748
5,"BIHOR",56,26582,,555,"RONTĂU / Sc. Generala cu cls.I-IV",3,2895,"SÎNMARTIN",26582,847,576,537,39,0,568,8,934,358,292,276
5,"BIHOR",56,26582,,556,"CORDĂU / Sc. Generala cu cls.I-VIII",3,2895,"SÎNMARTIN",26582,1204,806,723,83,0,798,8,926,120,287,511
5,"BIHOR",56,26653,,557,"SÎNTANDREI / SCOALA GIMNAZIALA NR.1 SINTANDREI",3,2903,"SÎNTANDREI",26653,1983,1435,1255,180,0,1421,14,2182,747,472,949
5,"BIHOR",56,26653,,558,"SÎNTANDREI / SCOALA GIMNAZIALA NR.1 SINTANDREI",3,2903,"SÎNTANDREI",26653,1755,1282,1104,178,0,1271,11,1931,649,396,875
5,"BIHOR",56,26653,,559,"PALOTA / CAMIN CULTURAL PALOTA",3,2903,"SÎNTANDREI",26653,589,353,319,34,0,349,4,648,295,42,307
5,"BIHOR",56,31128,,560,"SÎRBI / CAMIN CULTURAL",3,2911,"SÎRBI",31128,841,626,509,95,22,620,6,926,300,321,299
5,"BIHOR",56,31128,,561,"BURZUC / CAMIN CULTURAL",3,2911,"SÎRBI",31128,627,476,403,70,3,470,6,691,215,224,246
5,"BIHOR",56,31128,,562,"ALMAŞU MIC / SCOALA GENERALA",3,2911,"SÎRBI",31128,97,87,60,27,0,86,1,107,20,47,39
5,"BIHOR",56,31128,,563,"CHIOAG / SCOALA GENERALA",3,2911,"SÎRBI",31128,132,84,70,14,0,84,0,146,62,30,54
5,"BIHOR",56,31128,,564,"FEGERNIC / SCOALA GENERALA",3,2911,"SÎRBI",31128,303,210,168,42,0,208,2,334,124,102,106
5,"BIHOR",56,31128,,565,"SARCĂU / SCOALA GENERALA",3,2911,"SÎRBI",31128,61,38,28,10,0,38,0,68,30,27,11
5,"BIHOR",56,31208,,566,"SPINUŞ / Scoala Gimnaziala nr.1 Spinus",3,2928,"SPINUŞ",31208,307,205,165,40,0,203,2,339,134,115,88
5,"BIHOR",56,31208,,567,"NĂDAR / Fosta Scoala cu clasele I-IV Nădar",3,2928,"SPINUŞ",31208,174,116,92,24,0,110,6,192,76,72,38
5,"BIHOR",56,31208,,568,"CIULEŞTI / Fosta Scoala cu clasele I-IV Ciuleşti",3,2928,"SPINUŞ",31208,169,136,101,35,0,135,1,187,51,66,69
5,"BIHOR",56,31208,,569,"SĂLIŞTE / Scoala Primară nr.1 Sălişte",3,2928,"SPINUŞ",31208,210,133,91,42,0,133,0,231,98,74,59
5,"BIHOR",56,31208,,570,"GURBEŞTI / Fosta Scoala cu clasele I-IV Gurbeşti",3,2928,"SPINUŞ",31208,102,72,54,18,0,72,0,113,41,30,42
5,"BIHOR",56,31262,,571,"BORUMLACA / Camin Cultural",3,2939,"SUPLACU DE BARCĂU",31262,749,532,513,19,0,521,11,825,293,202,319
5,"BIHOR",56,31262,,572,"VALEA CERULUI / Scoala Primara nr. 3",3,2939,"SUPLACU DE BARCĂU",31262,368,200,188,12,0,197,3,406,206,78,119
5,"BIHOR",56,31262,,573,"DOLEA / Scoala Primara nr. 2",3,2939,"SUPLACU DE BARCĂU",31262,137,88,74,14,0,87,1,151,63,10,77
5,"BIHOR",56,31262,,574,"SUPLACU DE BARCĂU / Lic. Tehnologic Nr1 Suplacu de Barcau",3,2939,"SUPLACU DE BARCĂU",31262,960,555,519,36,0,548,7,1057,502,103,445
5,"BIHOR",56,31262,,575,"SUPLACU DE BARCĂU / Fost Sediu Primarie",3,2939,"SUPLACU DE BARCĂU",31262,1042,668,585,83,0,659,9,1147,479,138,521
5,"BIHOR",56,31262,,576,"FOGLAŞ / Scoala Primara nr. 5",3,2939,"SUPLACU DE BARCĂU",31262,159,108,90,18,0,107,1,177,69,28,79
5,"BIHOR",56,31262,,577,"VÎLCELELE / Scoala Primara nr. 4",3,2939,"SUPLACU DE BARCĂU",31262,202,126,114,12,0,126,0,223,97,39,87
5,"BIHOR",56,31333,,578,"ŞIMIAN / GRADINITA CU PROGRAM NORMAL NR.3",3,2891,"ŞIMIAN",31333,233,95,84,11,0,94,1,257,162,42,52
5,"BIHOR",56,31333,,579,"ŞIMIAN / Scoala Gimnaziala Kazinczy Ferenc",3,2891,"ŞIMIAN",31333,1670,657,634,23,0,638,19,1838,1181,187,451
5,"BIHOR",56,31333,,580,"ŞIMIAN / FOSTA SCOALA PRIMARA I-IV",3,2891,"ŞIMIAN",31333,141,86,73,13,0,86,0,156,70,27,59
5,"BIHOR",56,31333,,581,"ŞILINDRU / Şcoala primară nr.1",3,2891,"ŞIMIAN",31333,753,397,338,59,0,389,8,829,432,187,202
5,"BIHOR",56,31333,,582,"VOIVOZI / Şcoala primară nr.2",3,2891,"ŞIMIAN",31333,344,165,117,48,0,160,5,379,214,82,78
5,"BIHOR",56,31379,,583,"ŞINTEU / PRIMARIA Comunei Sinteu",3,2906,"ŞINTEU",31379,996,395,310,85,0,393,2,1097,702,97,296
5,"BIHOR",56,31422,,584,"ŞOIMI / Sediul Primariei Soimi",3,2919,"ŞOIMI",31422,540,242,183,51,8,242,0,595,353,120,122
5,"BIHOR",56,31422,,585,"SÎNNICOLAU DE BEIUŞ /  Fosta Scoala cls.I-IV",3,2919,"ŞOIMI",31422,115,110,73,34,3,109,1,128,18,69,40
5,"BIHOR",56,31422,,586,"URSAD /  Scoala cu cls. I - IV",3,2919,"ŞOIMI",31422,135,129,91,38,0,127,2,150,21,77,50
5,"BIHOR",56,31422,,587,"POCLUŞA DE BEIUŞ / Scoala cu cls.I-IV",3,2919,"ŞOIMI",31422,82,77,61,16,0,76,1,90,13,29,47
5,"BIHOR",56,31422,,588,"CODRU / Scoala cu cls.I-IV",3,2919,"ŞOIMI",31422,136,122,91,31,0,121,1,151,29,49,72
5,"BIHOR",56,31422,,589,"BORZ / Scoala cu cls.I-IV",3,2919,"ŞOIMI",31422,167,114,97,17,0,109,5,185,71,60,49
5,"BIHOR",56,31422,,590,"URVIŞ DE BEIUŞ / Scoala cu cls.I- VIII",3,2919,"ŞOIMI",31422,543,385,344,41,0,385,0,598,213,182,203
5,"BIHOR",56,31422,,591,"DUMBRĂVIŢA DE CODRU / Scoala cu cls.I - IV",3,2919,"ŞOIMI",31422,315,187,167,20,0,187,0,348,161,98,89
5,"BIHOR",56,31510,,592,"ŞUNCUIUŞ / Liceul Tehnologic nr. 1 - Şuncuiuş",3,2934,"ŞUNCUIUŞ",31510,1297,984,813,141,30,974,10,1428,444,355,619
5,"BIHOR",56,31510,,593,"ŞUNCUIUŞ / Scoala cu Cls. I+IV ""Pojorata""",3,2934,"ŞUNCUIUŞ",31510,102,87,57,22,8,85,2,112,25,34,51
5,"BIHOR",56,31510,,594,"BĂLNACA / Scoala cu clasele I-VIII Balnaca",3,2934,"ŞUNCUIUŞ",31510,805,611,565,42,4,607,4,887,276,183,424
5,"BIHOR",56,31510,,595,"BĂLNACA-GROŞI / Camin Cultural sat Balnaca Grosi",3,2934,"ŞUNCUIUŞ",31510,62,57,42,15,0,56,1,69,12,12,44
5,"BIHOR",56,31510,,596,"ZECE HOTARE / Camin cultural catun Carmazan",3,2934,"ŞUNCUIUŞ",31510,156,93,83,10,0,93,0,172,79,26,67
5,"BIHOR",56,31510,,597,"ZECE HOTARE / Scoala cu clasele I-VIII Zecehotare",3,2934,"ŞUNCUIUŞ",31510,157,132,109,23,0,128,4,174,42,66,62
5,"BIHOR",56,31565,,598,"TARCEA / CĂMINUL CULTURAL",3,2956,"TARCEA",31565,741,310,269,41,0,305,5,816,506,116,189
5,"BIHOR",56,31565,,599,"ADONI / Grădiniţa de copii",3,2956,"TARCEA",31565,618,287,271,16,0,286,1,681,394,66,220
5,"BIHOR",56,31565,,600,"GALOŞPETREU / CASA ROTH",3,2956,"TARCEA",31565,775,258,236,22,0,250,8,854,596,89,161
5,"BIHOR",56,32153,,601,"SATU NOU / ŞCOALA GENERALĂ",3,2946,"TĂMĂŞEU",32153,196,140,110,30,0,140,0,217,77,44,96
5,"BIHOR",56,32153,,602,"PARHIDA / ŞCOALA GENERALĂ",3,2946,"TĂMĂŞEU",32153,409,212,184,28,0,207,5,450,238,80,127
5,"BIHOR",56,32153,,603,"TĂMĂŞEU / CĂMINUL CULTURAL",3,2946,"TĂMĂŞEU",32153,885,509,467,42,0,503,6,975,466,85,418
5,"BIHOR",56,32153,,604,"NIUVED / CĂMINUL CULTURAL",3,2946,"TĂMĂŞEU",32153,197,134,107,27,0,133,1,218,84,35,98
5,"BIHOR",56,31609,,605,"TĂRCĂIŢA / CAMIN CULTURAL",3,2951,"TĂRCAIA",31609,350,265,223,38,4,264,1,385,120,207,57
5,"BIHOR",56,31609,,606,"TOTORENI / CAMIN CULTURAL",3,2951,"TĂRCAIA",31609,235,208,177,31,0,201,7,260,52,110,91
5,"BIHOR",56,31609,,607,"MIERAG / SCOALA CU CLASELE I-IV",3,2951,"TĂRCAIA",31609,175,127,113,14,0,124,3,194,67,66,58
5,"BIHOR",56,31609,,608,"TĂRCAIA / PRIMARIA TARCAIA",3,2951,"TĂRCAIA",31609,946,604,589,15,0,602,2,1042,438,74,528
5,"BIHOR",56,31654,,609,"CIUTELEC / Camin Cultural",3,2960,"TĂUTEU",31654,585,325,291,25,9,322,3,645,320,184,138
5,"BIHOR",56,31654,,610,"POIANA / Scoala Primara",3,2960,"TĂUTEU",31654,194,113,99,14,0,113,0,213,100,22,91
5,"BIHOR",56,31654,,611,"TĂUTEU / Scoala Gimnaziala",3,2960,"TĂUTEU",31654,932,441,423,18,0,439,2,1026,585,77,362
5,"BIHOR",56,31654,,612,"BOGEI / Scoala Gimnaziala",3,2960,"TĂUTEU",31654,1124,557,536,21,0,542,15,1237,680,345,197
5,"BIHOR",56,31654,,613,"CHIRIBIŞ / Scoala Gimnaziala",3,2960,"TĂUTEU",31654,615,384,349,35,0,382,2,678,294,115,267
5,"BIHOR",56,31716,,614,"TILEAGD / SCOALA GIMNAZIALA NR.1",3,2971,"TILEAGD",31716,1808,1012,926,86,0,996,16,1990,978,296,700
5,"BIHOR",56,31716,,615,"TILEAGD / SCOALA CU CLS.I-IV",3,2971,"TILEAGD",31716,1444,774,723,51,0,765,9,1589,815,239,526
5,"BIHOR",56,31716,,616,"CĂLĂTANI / SCOALA CU CLS.I-IV",3,2971,"TILEAGD",31716,169,120,103,17,0,118,2,186,66,35,83
5,"BIHOR",56,31716,,617,"BĂLAIA / SCOALA CU CLS.I-IV",3,2971,"TILEAGD",31716,538,382,341,34,7,379,3,593,211,140,239
5,"BIHOR",56,31716,,618,"TILECUŞ / COMUNA TILEAGD",3,2971,"TILEAGD",31716,663,478,406,72,0,476,2,730,252,170,306
5,"BIHOR",56,31716,,619,"POŞOLOACA / COMUNA TILEAGD",3,2971,"TILEAGD",31716,338,201,176,25,0,199,2,373,172,52,147
5,"BIHOR",56,31716,,620,"UILEACU DE CRIŞ / COMUNA TILEAGD",3,2971,"TILEAGD",31716,673,398,342,56,0,396,2,742,344,72,324
5,"BIHOR",56,31789,,621,"TINCA / GRADINITA CU PROGRAM PRELUNGIT",3,2978,"TINCA",31789,1128,718,637,60,21,714,4,1242,524,214,500
5,"BIHOR",56,31789,,622,"GURBEDIU / SCOALA GENERALA",3,2978,"TINCA",31789,895,608,523,61,24,602,6,986,378,292,310
5,"BIHOR",56,31789,,623,"RÎPA / SCOALA GENERALA",3,2978,"TINCA",31789,448,353,239,60,54,352,1,493,140,157,195
5,"BIHOR",56,31789,,624,"TINCA / LICEUL TEORETIC N.JIGA",3,2978,"TINCA",31789,1311,700,617,43,40,683,17,1444,744,266,417
5,"BIHOR",56,31789,,625,"TINCA / SCOALA PRIMARA I-IV",3,2978,"TINCA",31789,1241,788,691,66,31,783,5,1366,578,260,523
5,"BIHOR",56,31789,,626,"GIRIŞU NEGRU / SCOALA PRIMARA I-IV",3,2978,"TINCA",31789,594,394,301,57,36,383,11,654,260,196,187
5,"BIHOR",56,31789,,627,"BELFIR / SCOALA PRIMARA I-IV",3,2978,"TINCA",31789,497,209,182,22,5,207,2,548,339,34,173
5,"BIHOR",56,32201,,628,"TOBOLIU / SCOALA GIMNAZIALA TOBOLIU",3,2984,"TOBOLIU",32201,809,493,436,41,16,488,5,891,398,200,288
5,"BIHOR",56,32201,,629,"CHERESIG / SCOALA GENERALA CHERESIG",3,2984,"TOBOLIU",32201,915,589,504,70,15,584,5,1009,420,219,365
5,"BIHOR",56,31841,,630,"TULCA / Caminul Cultural Tulca",3,2987,"TULCA",31841,1551,1075,962,94,19,1068,7,1708,633,457,611
5,"BIHOR",56,31841,,631,"TULCA / Scoala cu clasele I-IV Tulca Noua",3,2987,"TULCA",31841,230,207,151,56,0,205,2,254,47,86,119
5,"BIHOR",56,31841,,632,"CĂUAŞD / Caminul Cultural Cauasd",3,2987,"TULCA",31841,372,285,237,48,0,283,2,410,125,81,202
5,"BIHOR",56,31878,,633,"ŢEŢCHEA / Cămin cultural",3,2966,"ŢEŢCHEA",31878,643,442,393,49,0,437,5,707,265,227,210
5,"BIHOR",56,31878,,634,"SUBPIATRĂ / Cămin cultural",3,2966,"ŢEŢCHEA",31878,488,346,302,44,0,342,4,538,192,154,188
5,"BIHOR",56,31878,,635,"TELECHIU / Cămin cultural",3,2966,"ŢEŢCHEA",31878,614,372,353,19,0,369,3,675,303,175,194
5,"BIHOR",56,31878,,636,"HOTAR / Cămin cutural",3,2966,"ŢEŢCHEA",31878,716,479,425,54,0,476,3,789,310,304,172
5,"BIHOR",56,31921,,637,"FORĂU / ŞCOALA PRIMARĂ NR.1",3,2990,"UILEACU DE BEIUŞ",31921,700,573,519,44,10,562,11,771,198,380,182
5,"BIHOR",56,31921,,638,"UILEACU DE BEIUŞ / ŞCOALA GIMNAZIALĂ NR.1",3,2990,"UILEACU DE BEIUŞ",31921,500,412,355,53,4,409,3,551,139,181,228
5,"BIHOR",56,31921,,639,"PRISACA / GRĂDINIŢA CU PROGRAM NORMAL Nr.3",3,2990,"UILEACU DE BEIUŞ",31921,370,319,276,37,6,318,1,408,89,244,74
5,"BIHOR",56,31921,,640,"VĂLANII DE BEIUŞ / GRĂDINIŢA CU PROGRAM NORMAL Nr.4",3,2990,"UILEACU DE BEIUŞ",31921,217,178,160,18,0,178,0,240,62,121,57
5,"BIHOR",56,31976,,641,"VADU CRIŞULUI / CAMIN CULTURAL VADU CRISULUI",3,2995,"VADU CRIŞULUI",31976,1523,938,869,67,2,929,9,1676,738,259,670
5,"BIHOR",56,31976,,642,"VADU CRIŞULUI / SCOALA GENERALA VADU CRISULUI",3,2995,"VADU CRIŞULUI",31976,794,468,417,49,2,460,8,874,406,153,307
5,"BIHOR",56,31976,,643,"TOMNATIC / SCOALA GENERALA TOMNATIC",3,2995,"VADU CRIŞULUI",31976,249,136,123,13,0,134,2,272,136,61,73
5,"BIHOR",56,31976,,644,"TOPA DE CRIŞ / SCOALA GENERALA TOPA DE CRIS",3,2995,"VADU CRIŞULUI",31976,365,241,208,33,0,240,1,403,162,93,147
5,"BIHOR",56,31976,,645,"BIRTIN / CAMIN CULTURAL BIRTIN",3,2995,"VADU CRIŞULUI",31976,300,245,216,29,0,244,1,330,85,99,145
5,"BIHOR",56,32090,,646,"SURDUCEL / CAMINUL CULTURAL",3,3000,"VÂRCIOROG",32090,903,596,544,52,0,593,3,994,398,171,422
5,"BIHOR",56,32090,,647,"FÂŞCA / SCOALA GIMNAZIALA NR.2",3,3000,"VÂRCIOROG",32090,362,274,247,27,0,272,2,399,125,58,214
5,"BIHOR",56,32090,,648,"ŞERGHIŞ / GRADINITA DE COPII cu program normal",3,3000,"VÂRCIOROG",32090,451,362,291,71,0,350,12,497,135,127,223
5,"BIHOR",56,32045,,649,"VIIŞOARA / CAMIN CULTURAL",3,3005,"VIIŞOARA",32045,812,515,494,21,0,509,6,894,379,133,376
5,"BIHOR",56,32045,,650,"IZVOARELE / CAMIN CULTURAL",3,3005,"VIIŞOARA",32045,166,89,76,13,0,89,0,185,96,26,63
5,"BIHOR",56,32045,,651,"REGHEA / CAMIN CULTURAL",3,3005,"VIIŞOARA",32045,39,40,20,20,0,40,0,43,3,21,19
6,"BISTRIŢA-NĂSĂUD","#N/A",32394,,1,"BISTRIŢA / CLUBUL SPORTIV MUNICIPAL BISTRIŢA",1,3011,"MUNICIPIUL BISTRIŢA",32394,1360,905,819,75,11,895,10,1500,595,328,567
6,"BISTRIŢA-NĂSĂUD","#N/A",32394,,2,"BISTRIŢA / GRĂDINIŢA CU PROGRAM SĂPTĂMÂNAL ""DUMBRAVA MINUNATĂ""",1,3011,"MUNICIPIUL BISTRIŢA",32394,1235,697,639,58,0,690,7,1400,703,226,464
6,"BISTRIŢA-NĂSĂUD","#N/A",32394,,3,"BISTRIŢA / LICEUL DE MUZICĂ ""TUDOR JARDA""",1,3011,"MUNICIPIUL BISTRIŢA",32394,1251,792,686,66,40,787,5,1400,608,239,548
6,"BISTRIŢA-NĂSĂUD","#N/A",32394,,4,"BISTRIŢA / PRIMĂRIA MUNICIPIULUI BISTRIŢA, DIRECŢIA ECONOMICĂ- VENITURI",1,3011,"MUNICIPIUL BISTRIŢA",32394,1555,959,889,69,1,951,8,1700,741,291,660
6,"BISTRIŢA-NĂSĂUD","#N/A",32394,,5,"BISTRIŢA / GRĂDINIŢA CU PROGRAM PRELUNGIT NR. 6",1,3011,"MUNICIPIUL BISTRIŢA",32394,1556,913,852,61,0,908,5,1700,787,258,650
6,"BISTRIŢA-NĂSĂUD","#N/A",32394,,6,"BISTRIŢA / GRĂDINIŢA CU PROGRAM PRELUNGIT NR. 6",1,3011,"MUNICIPIUL BISTRIŢA",32394,1484,818,777,39,2,811,7,1600,782,222,589
6,"BISTRIŢA-NĂSĂUD","#N/A",32394,,7,"BISTRIŢA / LICEUL TEHNOLOGIC SPECIAL SFÂNTA MARIA BISTRIŢA",1,3011,"MUNICIPIUL BISTRIŢA",32394,1348,869,741,64,64,855,14,1500,631,248,607
6,"BISTRIŢA-NĂSĂUD","#N/A",32394,,8,"BISTRIŢA / ŞCOALA GIMNAZIALĂ NR. 1",1,3011,"MUNICIPIUL BISTRIŢA",32394,1137,686,617,69,0,681,5,1200,514,216,465
6,"BISTRIŢA-NĂSĂUD","#N/A",32394,,9,"BISTRIŢA / GRĂDINIŢA CU PROGRAM NORMAL NR. 10",1,3011,"MUNICIPIUL BISTRIŢA",32394,1456,895,810,85,0,887,8,1600,705,264,623
6,"BISTRIŢA-NĂSĂUD","#N/A",32394,,10,"BISTRIŢA / ŞCOALA GIMNAZIALĂ""LUCIAN BLAGA""",1,3011,"MUNICIPIUL BISTRIŢA",32394,1712,1049,954,94,1,1045,4,1900,851,296,749
6,"BISTRIŢA-NĂSĂUD","#N/A",32394,,11,"BISTRIŢA / ŞCOALA GIMNAZIALĂ""LUCIAN BLAGA""",1,3011,"MUNICIPIUL BISTRIŢA",32394,1645,938,889,49,0,934,4,1800,862,250,684
6,"BISTRIŢA-NĂSĂUD","#N/A",32394,,12,"BISTRIŢA / ŞCOALA GIMNAZIALĂ""LUCIAN BLAGA""",1,3011,"MUNICIPIUL BISTRIŢA",32394,1722,994,953,41,0,990,4,1902,908,269,721
6,"BISTRIŢA-NĂSĂUD","#N/A",32394,,13,"BISTRIŢA / COLEGIUL TEHNIC ""GRIGORE MOISIL""",1,3011,"MUNICIPIUL BISTRIŢA",32394,1592,927,890,36,1,923,4,1700,773,251,672
6,"BISTRIŢA-NĂSĂUD","#N/A",32394,,14,"BISTRIŢA / GRĂDINIŢA CU PROGRAM NORMAL NR. 18",1,3011,"MUNICIPIUL BISTRIŢA",32394,1077,647,576,71,0,637,10,1201,554,148,489
6,"BISTRIŢA-NĂSĂUD","#N/A",32394,,15,"BISTRIŢA / GRĂDINIŢA CU PROGRAM NORMAL NR.18",1,3011,"MUNICIPIUL BISTRIŢA",32394,1406,742,709,33,0,736,6,1500,758,213,523
6,"BISTRIŢA-NĂSĂUD","#N/A",32394,,16,"BISTRIŢA / COLEGIUL TEHNIC ""GRIGORE MOISIL""",1,3011,"MUNICIPIUL BISTRIŢA",32394,1412,852,792,60,0,844,8,1500,648,265,579
6,"BISTRIŢA-NĂSĂUD","#N/A",32394,,17,"BISTRIŢA / ŞCOALA GIMNAZIALĂ NR. 1",1,3011,"MUNICIPIUL BISTRIŢA",32394,1267,740,690,50,0,733,7,1399,659,237,496
6,"BISTRIŢA-NĂSĂUD","#N/A",32394,,18,"BISTRIŢA / ŞCOALA GIMNAZIALĂ NR. 1",1,3011,"MUNICIPIUL BISTRIŢA",32394,1512,900,833,67,0,893,7,1700,800,288,605
6,"BISTRIŢA-NĂSĂUD","#N/A",32394,,19,"BISTRIŢA / ŞCOALA GIMNAZIALĂ NR. 1",1,3011,"MUNICIPIUL BISTRIŢA",32394,1268,836,812,23,1,829,7,1400,564,343,486
6,"BISTRIŢA-NĂSĂUD","#N/A",32394,,20,"BISTRIŢA / GRĂDINIŢA CU PROGRAM PRELUNGIT ""TRENULEŢUL VESELIEI""",1,3011,"MUNICIPIUL BISTRIŢA",32394,1400,948,803,105,40,940,8,1500,552,306,634
6,"BISTRIŢA-NĂSĂUD","#N/A",32394,,21,"BISTRIŢA / LICEUL TEHNOLOGIC FORESTIER",1,3011,"MUNICIPIUL BISTRIŢA",32394,1561,901,842,59,0,896,5,1700,799,255,641
6,"BISTRIŢA-NĂSĂUD","#N/A",32394,,22,"BISTRIŢA / GRĂDINIŢA CĂSUŢA CU POVEŞTI",1,3011,"MUNICIPIUL BISTRIŢA",32394,1648,1343,1007,117,219,1325,18,1800,457,455,870
6,"BISTRIŢA-NĂSĂUD","#N/A",32394,,23,"BISTRIŢA / COLEGIUL NAŢIONAL ""ANDREI MUREŞANU""",1,3011,"MUNICIPIUL BISTRIŢA",32394,1503,921,822,99,0,913,8,1600,679,286,627
6,"BISTRIŢA-NĂSĂUD","#N/A",32394,,24,"BISTRIŢA / GRĂDINIŢA CU PROGRAM PRELUNGIT ""CĂSUŢA CU POVEŞTI""",1,3011,"MUNICIPIUL BISTRIŢA",32394,1377,990,728,44,218,978,12,1500,510,447,531
6,"BISTRIŢA-NĂSĂUD","#N/A",32394,,25,"BISTRIŢA / GRĂDINIŢA CU PROGRAM NORMAL NR. 15",1,3011,"MUNICIPIUL BISTRIŢA",32394,1188,672,616,55,1,666,6,1300,628,202,464
6,"BISTRIŢA-NĂSĂUD","#N/A",32394,,26,"BISTRIŢA / COLEGIUL NAŢIONAL ""LIVIU REBREANU""",1,3011,"MUNICIPIUL BISTRIŢA",32394,1369,780,722,56,2,774,6,1500,720,242,532
6,"BISTRIŢA-NĂSĂUD","#N/A",32394,,27,"BISTRIŢA / COLEGIUL NAŢIONAL ""LIVIU REBREANU""",1,3011,"MUNICIPIUL BISTRIŢA",32394,1434,895,799,96,0,886,9,1600,705,337,549
6,"BISTRIŢA-NĂSĂUD","#N/A",32394,,28,"BISTRIŢA / GRĂDINIŢA CU PROGRAM NORMAL NR. 9",1,3011,"MUNICIPIUL BISTRIŢA",32394,1312,849,777,72,0,841,8,1400,551,265,576
6,"BISTRIŢA-NĂSĂUD","#N/A",32394,,29,"BISTRIŢA / COLEGIUL UNIVERSITAR BISTRIŢA",1,3011,"MUNICIPIUL BISTRIŢA",32394,1669,1034,951,71,12,1020,14,1800,766,349,671
6,"BISTRIŢA-NĂSĂUD","#N/A",32394,,30,"BISTRIŢA / COLEGIUL UNIVERSITAR BISTRIŢA",1,3011,"MUNICIPIUL BISTRIŢA",32394,1595,942,860,82,0,937,5,1700,758,272,665
6,"BISTRIŢA-NĂSĂUD","#N/A",32394,,31,"BISTRIŢA / ŞCOALA GIMNAZIALĂ NR. 4",1,3011,"MUNICIPIUL BISTRIŢA",32394,1772,1133,1047,86,0,1122,11,1900,767,315,807
6,"BISTRIŢA-NĂSĂUD","#N/A",32394,,32,"BISTRIŢA / ŞCOALA GIMNAZIALĂ NR. 4",1,3011,"MUNICIPIUL BISTRIŢA",32394,1329,856,750,106,0,853,3,1400,544,252,601
6,"BISTRIŢA-NĂSĂUD","#N/A",32394,,33,"BISTRIŢA / GRĂDINIŢA CU PROGRAM NORMAL NR. 5",1,3011,"MUNICIPIUL BISTRIŢA",32394,1415,796,742,54,0,794,2,1500,704,232,562
6,"BISTRIŢA-NĂSĂUD","#N/A",32394,,34,"BISTRIŢA / GRĂDINIŢA CU PROGRAM PRELUNGIT NR. 12",1,3011,"MUNICIPIUL BISTRIŢA",32394,1434,840,800,39,1,835,5,1602,762,317,518
6,"BISTRIŢA-NĂSĂUD","#N/A",32394,,35,"BISTRIŢA / GRĂDINIŢA CU PROGRAM NORMAL NR. 16",1,3011,"MUNICIPIUL BISTRIŢA",32394,1346,846,803,43,0,839,7,1500,654,224,615
6,"BISTRIŢA-NĂSĂUD","#N/A",32394,,36,"BISTRIŢA / ŞCOALA GIMNAZIALĂ NR. 3 ""AVRAM IANCU""",1,3011,"MUNICIPIUL BISTRIŢA",32394,1401,870,828,42,0,860,10,1500,630,328,532
6,"BISTRIŢA-NĂSĂUD","#N/A",32394,,37,"BISTRIŢA / ŞCOALA GIMNAZIALĂ NR. 3 ""AVRAM IANCU""",1,3011,"MUNICIPIUL BISTRIŢA",32394,1342,865,812,53,0,852,13,1500,635,265,587
6,"BISTRIŢA-NĂSĂUD","#N/A",32394,,38,"BISTRIŢA / GRĂDINIŢA CU PROGRAM PRELUNGIT NR. 13",1,3011,"MUNICIPIUL BISTRIŢA",32394,1438,888,840,47,1,877,11,1600,712,252,625
6,"BISTRIŢA-NĂSĂUD","#N/A",32394,,39,"BISTRIŢA / ŞCOALA GIMNAZIALĂ ""ŞTEFAN CEL MARE""",1,3011,"MUNICIPIUL BISTRIŢA",32394,1370,991,811,46,134,977,14,1500,509,304,673
6,"BISTRIŢA-NĂSĂUD","#N/A",32394,,40,"BISTRIŢA / ŞCOALA GIMNAZIALĂ ""ŞTEFAN CEL MARE""",1,3011,"MUNICIPIUL BISTRIŢA",32394,1502,894,824,70,0,886,8,1700,806,264,622
6,"BISTRIŢA-NĂSĂUD","#N/A",32394,,41,"BISTRIŢA / GRĂDINIŢA CU PROGRAM PRELUNGIT NR. 3",1,3011,"MUNICIPIUL BISTRIŢA",32394,1554,919,861,57,1,913,6,1700,781,264,649
6,"BISTRIŢA-NĂSĂUD","#N/A",32394,,42,"BISTRIŢA / CREŞA NR. 3",1,3011,"MUNICIPIUL BISTRIŢA",32394,1033,576,540,36,0,573,3,1100,524,193,380
6,"BISTRIŢA-NĂSĂUD","#N/A",32394,,43,"BISTRIŢA / GRĂDINIŢA CU PROGRAM NORMAL NR. 7",1,3011,"MUNICIPIUL BISTRIŢA",32394,1214,827,750,76,1,819,8,1300,473,225,594
6,"BISTRIŢA-NĂSĂUD","#N/A",32394,,44,"BISTRIŢA / GRĂDINIŢA CU PROGRAM NORMAL NR. 7",1,3011,"MUNICIPIUL BISTRIŢA",32394,943,563,524,38,1,561,2,1000,437,171,390
6,"BISTRIŢA-NĂSĂUD","#N/A",32394,,45,"BISTRIŢA / SEDIUL ASOCIAŢIEI ROTARY CLUB BISTRIŢA",1,3011,"MUNICIPIUL BISTRIŢA",32394,1499,1064,924,119,21,1044,20,1600,536,258,786
6,"BISTRIŢA-NĂSĂUD","#N/A",32394,,46,"BISTRIŢA / GRĂDINIŢA CU PROGRAM PRELUNGIT ""RAZA DE SOARE""",1,3011,"MUNICIPIUL BISTRIŢA",32394,1453,879,812,67,0,872,7,1600,721,224,648
6,"BISTRIŢA-NĂSĂUD","#N/A",32394,,47,"BISTRIŢA / COLEGIUL TEHNIC INFOEL",1,3011,"MUNICIPIUL BISTRIŢA",32394,1664,973,905,68,0,967,6,1800,827,320,647
6,"BISTRIŢA-NĂSĂUD","#N/A",32394,,48,"BISTRIŢA / LICEUL CU PROGRAM SPORTIV",1,3011,"MUNICIPIUL BISTRIŢA",32394,1221,715,625,90,0,711,4,1300,585,198,513
6,"BISTRIŢA-NĂSĂUD","#N/A",32394,,49,"BISTRIŢA / LICEUL CU PROGRAM SPORTIV",1,3011,"MUNICIPIUL BISTRIŢA",32394,1230,807,742,65,0,802,5,1300,493,202,600
6,"BISTRIŢA-NĂSĂUD","#N/A",32394,,50,"UNIREA / ŞCOALA PRIMARĂ UNIREA",1,3011,"MUNICIPIUL BISTRIŢA",32394,1186,770,713,57,0,766,4,1300,530,222,544
6,"BISTRIŢA-NĂSĂUD","#N/A",32394,,51,"UNIREA / ŞCOALA PRIMARĂ UNIREA",1,3011,"MUNICIPIUL BISTRIŢA",32394,1206,812,753,59,0,803,9,1300,488,258,545
6,"BISTRIŢA-NĂSĂUD","#N/A",32394,,52,"SLĂTINIŢA / ŞCOALA PRIMARĂ ""DIMITRIE COJOCARU""  SLĂTINIŢA",1,3011,"MUNICIPIUL BISTRIŢA",32394,600,315,296,19,0,312,3,700,385,104,208
6,"BISTRIŢA-NĂSĂUD","#N/A",32394,,53,"GHINDA / GRĂDINIŢA CU PROGRAM NORMAL GHINDA",1,3011,"MUNICIPIUL BISTRIŢA",32394,619,368,352,16,0,365,3,701,333,87,278
6,"BISTRIŢA-NĂSĂUD","#N/A",32394,,54,"SIGMIR / CASA DE CULTURĂ SIGMIR",1,3011,"MUNICIPIUL BISTRIŢA",32394,749,461,438,22,1,457,4,800,339,144,313
6,"BISTRIŢA-NĂSĂUD","#N/A",32394,,55,"VIIŞOARA / ŞCOALA GIMNAZIALĂ NR. 7 MUNICIPIUL BISTRIŢA",1,3011,"MUNICIPIUL BISTRIŢA",32394,1009,634,572,61,1,628,6,1100,466,177,451
6,"BISTRIŢA-NĂSĂUD","#N/A",32394,,56,"VIIŞOARA / ŞCOALA GIMANIALĂ NR.7 MUNICIPIUL BISTRIŢA",1,3011,"MUNICIPIUL BISTRIŢA",32394,1031,647,617,25,5,643,4,1100,453,223,420
6,"BISTRIŢA-NĂSĂUD","#N/A",32394,,57,"SĂRATA / ŞCOALA PRIMARĂ SĂRATA",1,3011,"MUNICIPIUL BISTRIŢA",32394,912,566,512,54,0,561,5,1000,434,204,357
6,"BISTRIŢA-NĂSĂUD","#N/A",32483,,58,"BECLEAN / SALA DE CASATORII",1,3019,"ORAŞ BECLEAN",32483,1525,1008,926,77,5,1000,8,1599,591,454,546
6,"BISTRIŢA-NĂSĂUD","#N/A",32483,,59,"BECLEAN / POLICLINICA ORĂŞENEASCĂ BECLEAN",1,3019,"ORAŞ BECLEAN",32483,1452,1022,824,91,107,1012,10,1599,577,507,505
6,"BISTRIŢA-NĂSĂUD","#N/A",32483,,60,"BECLEAN / CLUBUL COPIILOR BECLEAN",1,3019,"ORAŞ BECLEAN",32483,869,526,487,34,5,521,5,1000,474,226,295
6,"BISTRIŢA-NĂSĂUD","#N/A",32483,,61,"BECLEAN / CLUBUL COPIILOR BECLEAN",1,3019,"ORAŞ BECLEAN",32483,891,502,471,27,4,496,6,1000,498,211,285
6,"BISTRIŢA-NĂSĂUD","#N/A",32483,,62,"BECLEAN / ŞCOALA GIMNAZIALĂ ""GRIGORE SILAŞI""",1,3019,"ORAŞ BECLEAN",32483,1533,1050,954,79,17,1045,5,1700,650,460,585
6,"BISTRIŢA-NĂSĂUD","#N/A",32483,,63,"BECLEAN / CASA DE CULTURĂ ""R. SĂPLĂCAN"" BECLEAN",1,3019,"ORAŞ BECLEAN",32483,1540,892,831,55,6,885,7,1700,808,420,465
6,"BISTRIŢA-NĂSĂUD","#N/A",32483,,64,"BECLEAN / ŞCOALA GENERALĂ BECLENUŢ, BECLEAN",1,3019,"ORAŞ BECLEAN",32483,340,253,220,26,7,251,2,400,147,112,139
6,"BISTRIŢA-NĂSĂUD","#N/A",32483,,65,"BECLEAN / ŞCOALA GENERALĂ VALEA VIILOR, BECLEAN",1,3019,"ORAŞ BECLEAN",32483,371,263,247,16,0,261,2,400,137,116,145
6,"BISTRIŢA-NĂSĂUD","#N/A",32483,,66,"COLDĂU / ŞCOALA GENERALĂ COLDĂU, BECLEAN",1,3019,"ORAŞ BECLEAN",32483,628,401,355,28,18,398,3,700,299,156,242
6,"BISTRIŢA-NĂSĂUD","#N/A",32483,,67,"FIGA / ŞCOALA GENERALĂ FIGA, BECLEAN",1,3019,"ORAŞ BECLEAN",32483,418,328,294,19,15,327,1,500,172,265,62
6,"BISTRIŢA-NĂSĂUD","#N/A",32483,,68,"RUSU DE JOS / ŞCOALA GENERALĂ RUSU DE JOS, BECLEAN",1,3019,"ORAŞ BECLEAN",32483,300,220,199,19,2,217,3,400,180,126,91
6,"BISTRIŢA-NĂSĂUD","#N/A",32544,,69,"NĂSĂUD / ŞCOALA DE APLICAŢIE",1,3024,"ORAŞ NĂSĂUD",32544,1390,945,885,59,1,937,8,1500,555,379,558
6,"BISTRIŢA-NĂSĂUD","#N/A",32544,,70,"NĂSĂUD / ŞCOALA GIMNAZIALĂ ""MIHAI EMINESCU""",1,3024,"ORAŞ NĂSĂUD",32544,1453,899,800,51,48,893,6,1600,701,315,578
6,"BISTRIŢA-NĂSĂUD","#N/A",32544,,71,"NĂSĂUD / COLEGIUL ECONOMIC",1,3024,"ORAŞ NĂSĂUD",32544,1178,631,598,33,0,628,3,1300,669,209,419
6,"BISTRIŢA-NĂSĂUD","#N/A",32544,,72,"NĂSĂUD / COLEGIUL SILVIC ""TRANSILVANIA""",1,3024,"ORAŞ NĂSĂUD",32544,1565,856,797,55,4,855,1,1700,844,329,526
6,"BISTRIŢA-NĂSĂUD","#N/A",32544,,73,"NĂSĂUD / AUTOGARA CĂLĂTORI",1,3024,"ORAŞ NĂSĂUD",32544,1743,1009,887,121,1,998,11,1900,891,355,643
6,"BISTRIŢA-NĂSĂUD","#N/A",32544,,74,"NĂSĂUD / ŞCOALA GENERALĂ VALEA SPINULUI",1,3024,"ORAŞ NĂSĂUD",32544,1037,637,589,46,2,628,9,1100,463,274,354
6,"BISTRIŢA-NĂSĂUD","#N/A",32544,,75,"LIVIU REBREANU / CĂMINUL CULTURAL LIVIU REBREANU",1,3024,"ORAŞ NĂSĂUD",32544,616,437,421,13,3,434,3,700,263,218,216
6,"BISTRIŢA-NĂSĂUD","#N/A",32544,,76,"LUŞCA / CĂMINUL CULTURAL LUŞCA",1,3024,"ORAŞ NĂSĂUD",32544,518,315,301,14,0,314,1,600,285,119,195
6,"BISTRIŢA-NĂSĂUD","#N/A",32599,,77,"SÎNGEORZ-BĂI / SCOALA GENERALA ""ARTEMIU PUBLIU ALEXI"" SINGEORZ-BAI",1,3028,"ORAŞ SÎNGEORZ-BĂI",32599,1371,764,718,46,0,762,2,1500,736,244,518
6,"BISTRIŢA-NĂSĂUD","#N/A",32599,,78,"SÎNGEORZ-BĂI / ŞCOALA GENERALĂ ""ARTEMIU PUBLIU ALEXI"" SÎNGEORZ-BĂI",1,3028,"ORAŞ SÎNGEORZ-BĂI",32599,1389,792,770,22,0,785,7,1500,708,273,512
6,"BISTRIŢA-NĂSĂUD","#N/A",32599,,79,"SÎNGEORZ-BĂI / ŞCOALA GENERALĂ ""ARTEMIU PUBLIU ALEXI"" SÎNGEORZ-BĂI",1,3028,"ORAŞ SÎNGEORZ-BĂI",32599,1264,691,666,25,0,690,1,1400,709,188,502
6,"BISTRIŢA-NĂSĂUD","#N/A",32599,,80,"SÎNGEORZ-BĂI / CLUBUL TINERETULUI SÎNGEORZ-BĂI",1,3028,"ORAŞ SÎNGEORZ-BĂI",32599,1320,803,783,20,0,801,2,1400,597,202,599
6,"BISTRIŢA-NĂSĂUD","#N/A",32599,,81,"SÎNGEORZ-BĂI / LICEUL TEORETIC ""SOLOMON HALIŢĂ""",1,3028,"ORAŞ SÎNGEORZ-BĂI",32599,1263,694,668,26,0,693,1,1400,706,206,487
6,"BISTRIŢA-NĂSĂUD","#N/A",32599,,82,"SÎNGEORZ-BĂI / GRADINITA CU PROGRAM NORMAL, SÎNGEORZ-BĂI",1,3028,"ORAŞ SÎNGEORZ-BĂI",32599,1295,793,730,63,0,790,3,1400,607,157,633
6,"BISTRIŢA-NĂSĂUD","#N/A",32599,,83,"CORMAIA / ŞCOALA GENERALĂ CORMAIA",1,3028,"ORAŞ SÎNGEORZ-BĂI",32599,660,387,358,29,0,376,11,700,313,129,247
6,"BISTRIŢA-NĂSĂUD","#N/A",32633,,84,"BISTRIŢA BÎRGĂULUI / PRIMĂRIA COMUNEI BISTRIŢA BÎRGĂULUI",3,3032,"BISTRIŢA BÎRGĂULUI",32633,1331,945,878,65,2,935,10,1400,455,326,609
6,"BISTRIŢA-NĂSĂUD","#N/A",32633,,85,"BISTRIŢA BÎRGĂULUI / ŞCOALA GENERALĂ NR. 2 BISTRIŢA BÎRGĂULUI - PUSTA",3,3032,"BISTRIŢA BÎRGĂULUI",32633,955,571,545,26,0,570,1,1000,429,163,407
6,"BISTRIŢA-NĂSĂUD","#N/A",32633,,86,"BISTRIŢA BÎRGĂULUI / SALA DE NUNŢI BISTRIŢA BÎRGĂULUI - PUSTA",3,3032,"BISTRIŢA BÎRGĂULUI",32633,1068,649,596,52,1,645,4,1200,551,137,508
6,"BISTRIŢA-NĂSĂUD","#N/A",32633,,87,"COLIBIŢA / SCOALA GENERALA COLIBITA",3,3032,"BISTRIŢA BÎRGĂULUI",32633,233,202,129,73,0,201,1,300,98,57,144
6,"BISTRIŢA-NĂSĂUD","#N/A",32660,,88,"BRANIŞTEA / PRIMĂRIA COMUNEI BRANIŞTEA",3,3035,"BRANIŞTEA",32660,965,645,584,50,11,644,1,1100,455,159,485
6,"BISTRIŢA-NĂSĂUD","#N/A",32660,,89,"CIREŞOAIA / CĂMINUL CULTURAL CIREŞOAIA",3,3035,"BRANIŞTEA",32660,1222,623,560,34,29,621,2,1300,677,173,448
6,"BISTRIŢA-NĂSĂUD","#N/A",32660,,90,"MĂLUŢ / CĂMINUL CULTURAL MĂLUŢ",3,3035,"BRANIŞTEA",32660,491,372,333,31,8,371,1,500,128,191,180
6,"BISTRIŢA-NĂSĂUD","#N/A",32704,,91,"BUDACU DE JOS / PRIMĂRIA COMUNEI BUDACU DE JOS",3,3039,"BUDACU DE JOS",32704,751,418,378,40,0,418,0,800,382,224,194
6,"BISTRIŢA-NĂSĂUD","#N/A",32704,,92,"BUDUŞ / ŞCOALA GENERALĂ BUDUŞ",3,3039,"BUDACU DE JOS",32704,445,332,269,45,18,330,2,500,168,174,156
6,"BISTRIŢA-NĂSĂUD","#N/A",32704,,93,"JELNA / GRĂDINIŢA DE COPII JELNA",3,3039,"BUDACU DE JOS",32704,747,513,448,62,3,510,3,800,287,271,239
6,"BISTRIŢA-NĂSĂUD","#N/A",32704,,94,"MONARIU / ŞCOALA GENERALĂ MONARIU",3,3039,"BUDACU DE JOS",32704,404,306,251,52,3,302,4,500,194,122,180
6,"BISTRIŢA-NĂSĂUD","#N/A",32704,,95,"SIMIONEŞTI / ŞCOALA GENERALĂ SIMIONEŞTI",3,3039,"BUDACU DE JOS",32704,189,159,109,39,11,159,0,200,41,86,73
6,"BISTRIŢA-NĂSĂUD","#N/A",32768,,96,"BUDEŞTI / ŞCOALA GENERALĂ BUDEŞTI",3,3045,"BUDEŞTI",32768,507,332,288,40,4,329,3,600,268,126,203
6,"BISTRIŢA-NĂSĂUD","#N/A",32768,,97,"BUDEŞTI-FÂNAŢE / ŞCOALA GENERALĂ BUDEŞTI-FÎNAŢE",3,3045,"BUDEŞTI",32768,256,187,160,26,1,185,2,300,113,68,117
6,"BISTRIŢA-NĂSĂUD","#N/A",32768,,98,"ŢAGU / ŞCOALA GENERALĂ ŢAGU",3,3045,"BUDEŞTI",32768,503,357,313,39,5,352,5,600,243,188,164
6,"BISTRIŢA-NĂSĂUD","#N/A",32768,,99,"ŢĂGŞORU / ŞCOALA GENERALĂ ŢĂGŞORU",3,3045,"BUDEŞTI",32768,221,160,139,21,0,160,0,304,144,91,69
6,"BISTRIŢA-NĂSĂUD","#N/A",32811,,100,"CĂIANU MIC / PRIMĂRIA COMUNEI CĂIANU MIC",3,3050,"CĂIANU MIC",32811,1235,717,666,28,23,710,7,1300,583,421,289
6,"BISTRIŢA-NĂSĂUD","#N/A",32811,,101,"CĂIANU MARE / SCOALA GENERALA CĂIANU MARE",3,3050,"CĂIANU MIC",32811,474,329,308,16,5,326,3,500,171,221,105
6,"BISTRIŢA-NĂSĂUD","#N/A",32811,,102,"DOBRIC / CĂMINUL CULTURAL DOBRIC",3,3050,"CĂIANU MIC",32811,1027,544,490,28,26,541,3,1100,556,347,194
6,"BISTRIŢA-NĂSĂUD","#N/A",32811,,103,"CICEU-POIENI / CĂMINUL CULTURAL CICEU-POIENI",3,3050,"CĂIANU MIC",32811,599,381,333,32,16,379,2,700,319,291,88
6,"BISTRIŢA-NĂSĂUD","#N/A",32884,,104,"SATU NOU / BIBLIOTECA COMUNALĂ SATU NOU",3,3055,"CETATE",32884,591,447,375,44,28,447,0,599,152,298,149
6,"BISTRIŢA-NĂSĂUD","#N/A",32884,,105,"PETRIŞ / ŞCOALA VECHE, DIN CENTRU,  CLASELE I - IV PETRIŞ",3,3055,"CETATE",32884,957,662,588,48,26,660,2,1000,338,367,293
6,"BISTRIŢA-NĂSĂUD","#N/A",32884,,106,"ORHEIU BISTRIŢEI / CĂMINUL CULTURAL ORHEIU BISTRIŢEI",3,3055,"CETATE",32884,611,445,391,53,1,439,6,700,255,254,185
6,"BISTRIŢA-NĂSĂUD","#N/A",33015,,107,"CHIOCHIŞ / PRIMĂRIA COMUNEI CHIOCHIŞ",3,3059,"CHIOCHIŞ",33015,339,193,171,22,0,191,2,400,207,92,99
6,"BISTRIŢA-NĂSĂUD","#N/A",33015,,108,"APATIU / ŞCOALA GENERALĂ APATIU",3,3059,"CHIOCHIŞ",33015,273,190,173,11,6,190,0,300,110,72,118
6,"BISTRIŢA-NĂSĂUD","#N/A",33015,,109,"STRUGURENI / ŞCOALA GENERALĂ STRUGURENI",3,3059,"CHIOCHIŞ",33015,165,126,105,21,0,125,1,200,74,14,111
6,"BISTRIŢA-NĂSĂUD","#N/A",33015,,110,"BOZIEŞ / ŞCOALA GENERALĂ BOZIEŞ",3,3059,"CHIOCHIŞ",33015,534,332,300,32,0,330,2,600,268,101,229
6,"BISTRIŢA-NĂSĂUD","#N/A",33015,,111,"CHEŢIU / ŞCOALA GENERALĂ CHEŢIU",3,3059,"CHIOCHIŞ",33015,267,186,159,27,0,186,0,300,114,56,130
6,"BISTRIŢA-NĂSĂUD","#N/A",33015,,112,"SÎNNICOARĂ / ŞCOALA GENERALĂ SÎNNICOARĂ",3,3059,"CHIOCHIŞ",33015,102,104,71,33,0,104,0,200,96,41,63
6,"BISTRIŢA-NĂSĂUD","#N/A",33015,,113,"ŢENTEA / ŞCOALA GENERALĂ ŢENTEA",3,3059,"CHIOCHIŞ",33015,127,88,70,18,0,88,0,200,112,34,54
6,"BISTRIŢA-NĂSĂUD","#N/A",33015,,114,"MANIC / ŞCOALA GENERALĂ MANIC",3,3059,"CHIOCHIŞ",33015,215,172,150,22,0,172,0,300,128,52,120
6,"BISTRIŢA-NĂSĂUD","#N/A",33015,,115,"JIMBOR / ŞCOALA GENERALĂ JIMBOR",3,3059,"CHIOCHIŞ",33015,375,246,217,29,0,240,6,400,154,81,159
6,"BISTRIŢA-NĂSĂUD","#N/A",33015,,116,"BUZA CĂTUN / ŞCOALA GENERALĂ BUZA CĂTUN",3,3059,"CHIOCHIŞ",33015,104,80,70,10,0,78,2,200,120,42,36
6,"BISTRIŢA-NĂSĂUD","#N/A",33122,,117,"CHIUZA / ŞCOALA GENERALĂ CHIUZA",3,3070,"CHIUZA",33122,715,479,430,31,18,478,1,800,321,277,201
6,"BISTRIŢA-NĂSĂUD","#N/A",33122,,118,"SĂSARM / CĂMINUL CULTURAL SĂSARM",3,3070,"CHIUZA",33122,572,396,346,34,16,394,2,600,204,155,239
6,"BISTRIŢA-NĂSĂUD","#N/A",33122,,119,"PIATRA / ŞCOALA PRIMARĂ PIATRA",3,3070,"CHIUZA",33122,398,269,236,16,17,269,0,500,231,137,132
6,"BISTRIŢA-NĂSĂUD","#N/A",33122,,120,"MIREŞ / CĂMIN MIREŞ",3,3070,"CHIUZA",33122,115,103,78,19,6,103,0,200,97,81,22
6,"BISTRIŢA-NĂSĂUD","#N/A",179953,,121,"CICEU-MIHĂIEŞTI / CĂMINUL CULTURAL CICEU-MIHĂIEŞTI",3,3075,"CICEU - MIHĂIEŞTI",179953,725,443,374,69,0,442,1,800,357,189,253
6,"BISTRIŢA-NĂSĂUD","#N/A",179953,,122,"LELEŞTI / ŞCOALA GENERALĂ LELEŞTI",3,3075,"CICEU - MIHĂIEŞTI",179953,127,129,78,51,0,129,0,200,71,78,51
6,"BISTRIŢA-NĂSĂUD","#N/A",179953,,123,"CICEU-CORABIA / ŞCOALA GENERALĂ CICEU-CORABIA",3,3075,"CICEU - MIHĂIEŞTI",179953,117,121,83,38,0,119,2,200,79,53,66
6,"BISTRIŢA-NĂSĂUD","#N/A",32955,,124,"CICEU-GIURGEŞTI / ŞCOALA GIMNAZIALĂ CICEU-GIURGEŞTI",3,3079,"CICEU-GIURGEŞTI",32955,778,492,422,55,15,491,1,900,408,182,309
6,"BISTRIŢA-NĂSĂUD","#N/A",32955,,125,"DUMBRĂVENI / CĂMINUL CULTURAL DUMBRĂVENI",3,3079,"CICEU-GIURGEŞTI",32955,556,436,366,53,17,435,1,600,164,249,186
6,"BISTRIŢA-NĂSĂUD","#N/A",33177,,126,"COŞBUC / ŞCOALA GENERALĂ COŞBUC",3,3082,"COŞBUC",33177,1652,963,924,37,2,959,4,1800,837,532,427
6,"BISTRIŢA-NĂSĂUD","#N/A",33202,,127,"DUMITRA / ŞCOALA GENERALĂ DUMITRA",3,3084,"DUMITRA",33202,1063,580,528,51,1,575,5,1200,620,203,372
6,"BISTRIŢA-NĂSĂUD","#N/A",33202,,128,"DUMITRA / ŞCOALA GENERALĂ DUMITRA",3,3084,"DUMITRA",33202,1207,711,658,52,1,709,2,1300,589,213,496
6,"BISTRIŢA-NĂSĂUD","#N/A",33202,,129,"CEPARI / ŞCOALA GENERALĂ CEPARI",3,3084,"DUMITRA",33202,844,490,443,43,4,486,4,900,410,110,376
6,"BISTRIŢA-NĂSĂUD","#N/A",33202,,130,"TĂRPIU / ŞCOALA GENERALĂ TĂRPIU",3,3084,"DUMITRA",33202,723,342,301,41,0,338,4,800,458,108,230
6,"BISTRIŢA-NĂSĂUD","#N/A",179686,,131,"DUMITRIŢA / ŞCOALA GENERALĂ DUMITRIŢA",3,3088,"DUMITRIŢA",179686,982,601,556,40,5,593,8,1100,499,147,446
6,"BISTRIŢA-NĂSĂUD","#N/A",179686,,132,"BUDACU DE SUS / ŞCOALA DE ARTE ŞI MESERII BUDACU DE SUS",3,3088,"DUMITRIŢA",179686,1435,826,775,46,5,819,7,1501,675,221,598
6,"BISTRIŢA-NĂSĂUD","#N/A",33248,,133,"FELDRU / PRIMĂRIA COMUNEI FELDRU",3,3092,"FELDRU",33248,1513,793,758,34,1,791,2,1600,807,197,594
6,"BISTRIŢA-NĂSĂUD","#N/A",33248,,134,"FELDRU / GRUP ŞCOLAR FELDRU",3,3092,"FELDRU",33248,1427,688,658,29,1,683,5,1600,912,193,490
6,"BISTRIŢA-NĂSĂUD","#N/A",33248,,135,"FELDRU / CĂMINUL CULTURAL FELDRU",3,3092,"FELDRU",33248,1385,739,707,29,3,733,6,1500,761,200,533
6,"BISTRIŢA-NĂSĂUD","#N/A",33248,,136,"FELDRU / ŞCOALA GENERALĂ PODEREI",3,3092,"FELDRU",33248,340,184,172,12,0,183,1,400,216,42,141
6,"BISTRIŢA-NĂSĂUD","#N/A",33248,,137,"NEPOS / SCOALA GENERALA CLASELE V-VIII",3,3092,"FELDRU",33248,1498,778,725,52,1,771,7,1600,822,186,585
6,"BISTRIŢA-NĂSĂUD","#N/A",33275,,138,"GALAŢII BISTRIŢEI / CĂMINUL CULTURAL GALAŢII BISTRIŢEI",3,3095,"GALAŢII BISTRIŢEI",33275,541,387,334,42,11,387,0,600,213,202,185
6,"BISTRIŢA-NĂSĂUD","#N/A",33275,,139,"DIPŞA / ŞCOALA GENERALĂ DIPŞA CLASELE I - IV",3,3095,"GALAŢII BISTRIŢEI",33275,682,465,401,45,19,463,2,800,335,280,183
6,"BISTRIŢA-NĂSĂUD","#N/A",33275,,140,"HERINA / ŞCOALA GENERALĂ HERINA CLASELE I - IV",3,3095,"GALAŢII BISTRIŢEI",33275,427,348,284,57,7,347,1,501,153,250,97
6,"BISTRIŢA-NĂSĂUD","#N/A",33275,,141,"ALBEŞTII BISTRIŢEI / ŞCOALA GENERALĂ ALBEŞTII BISTRIŢEI",3,3095,"GALAŢII BISTRIŢEI",33275,123,116,76,35,5,116,0,200,84,73,43
6,"BISTRIŢA-NĂSĂUD","#N/A",33275,,142,"TONCIU / ŞCOALA GENERALĂ TONCIU",3,3095,"GALAŢII BISTRIŢEI",33275,187,146,104,37,5,145,1,200,54,60,85
6,"BISTRIŢA-NĂSĂUD","#N/A",33337,,143,"ILVA MARE / Sediul Primariei comunei Ilva Mare",3,3101,"ILVA MARE",33337,1074,737,695,25,17,733,4,1202,465,230,503
6,"BISTRIŢA-NĂSĂUD","#N/A",33337,,144,"ILVA MARE / Sediul Primariei comunei Ilva Mare",3,3101,"ILVA MARE",33337,916,558,512,26,20,550,8,1000,442,137,413
6,"BISTRIŢA-NĂSĂUD","#N/A",33364,,145,"ILVA MICA / SCOALA GENERALĂ",3,3104,"ILVA MICA",33364,1329,730,676,43,11,727,3,1400,670,263,464
6,"BISTRIŢA-NĂSĂUD","#N/A",33364,,146,"ILVA MICA / SCOALA GENERALĂ",3,3104,"ILVA MICA",33364,1463,864,829,26,9,858,6,1600,736,358,500
6,"BISTRIŢA-NĂSĂUD","#N/A",33382,,147,"JOSENII BÎRGĂULUI / Cămin cultural",3,3106,"JOSENII BÎRGĂULUI",33382,830,492,464,28,0,487,5,900,408,109,378
6,"BISTRIŢA-NĂSĂUD","#N/A",33382,,148,"JOSENII BÎRGĂULUI / Şcoala generală Josenii Bîrgăului",3,3106,"JOSENII BÎRGĂULUI",33382,849,506,484,21,1,498,8,900,394,140,358
6,"BISTRIŢA-NĂSĂUD","#N/A",33382,,149,"MIJLOCENII BÎRGĂULUI / CĂMINUL CULTURAL MIJLOCENII BÎRGĂULUI",3,3106,"JOSENII BÎRGĂULUI",33382,1414,849,794,54,1,846,3,1500,651,340,506
6,"BISTRIŢA-NĂSĂUD","#N/A",33382,,150,"RUSU BÎRGĂULUI / CĂMINUL CULTURAL RUSU BÎRGĂULUI",3,3106,"JOSENII BÎRGĂULUI",33382,759,483,445,38,0,479,4,800,317,197,282
6,"BISTRIŢA-NĂSĂUD","#N/A",33382,,151,"STRÎMBA / ŞCOALA PRIMARĂ STRÎMBA",3,3106,"JOSENII BÎRGĂULUI",33382,308,200,167,33,0,199,1,400,200,56,143
6,"BISTRIŢA-NĂSĂUD","#N/A",33435,,152,"LECHINŢA / PRIMARIA COMUNEI LECHINTA",3,3111,"LECHINŢA",33435,1202,772,679,80,13,770,2,1300,528,508,262
6,"BISTRIŢA-NĂSĂUD","#N/A",33435,,153,"LECHINŢA / SCOALA PROFESIONALA LECHINTA, NR.394",3,3111,"LECHINŢA",33435,1198,775,715,50,10,765,10,1300,525,473,292
6,"BISTRIŢA-NĂSĂUD","#N/A",33435,,154,"SÎNGEORZU NOU / CAMIN CULTURAL SÎNGEORZU NOU",3,3111,"LECHINŢA",33435,811,526,457,57,12,525,1,900,374,279,246
6,"BISTRIŢA-NĂSĂUD","#N/A",33435,,155,"CHIRALEŞ / CAMIN CULTURAL CHIRALEŞ",3,3111,"LECHINŢA",33435,392,318,226,84,8,316,2,400,82,188,128
6,"BISTRIŢA-NĂSĂUD","#N/A",33435,,156,"SÎNIACOB / ŞCOALA PRIMARĂ SÎNIACOB",3,3111,"LECHINŢA",33435,185,162,127,29,6,161,1,200,38,110,51
6,"BISTRIŢA-NĂSĂUD","#N/A",33435,,157,"ŢIGĂU / ŞCOALA PRIMARĂ ŢIGĂU",3,3111,"LECHINŢA",33435,356,221,203,18,0,220,1,400,179,64,156
6,"BISTRIŢA-NĂSĂUD","#N/A",33435,,158,"VERMEŞ / CĂMINUL CULTURAL VERMEŞ",3,3111,"LECHINŢA",33435,745,485,429,50,6,482,3,800,315,366,116
6,"BISTRIŢA-NĂSĂUD","#N/A",33514,,159,"LEŞU / SEDIUL PRIMĂRIEI VECHI LEŞU",3,3119,"LEŞU",33514,1395,818,713,79,26,818,0,1500,682,387,431
6,"BISTRIŢA-NĂSĂUD","#N/A",33514,,160,"LUNCA LEŞULUI / ŞCOALA GENERALĂ NR. 2 LUNCA LEŞULUI",3,3119,"LEŞU",33514,920,512,461,28,23,506,6,999,487,163,343
6,"BISTRIŢA-NĂSĂUD","#N/A",33541,,161,"LIVEZILE / CAMIN CULTURAL",3,3122,"LIVEZILE",33541,1204,652,614,38,0,645,7,1300,648,158,487
6,"BISTRIŢA-NĂSĂUD","#N/A",33541,,162,"LIVEZILE / SCOALA GENERALA LIVEZILE",3,3122,"LIVEZILE",33541,1145,645,591,54,0,644,1,1200,555,126,518
6,"BISTRIŢA-NĂSĂUD","#N/A",33541,,163,"DOROLEA / SCOALA GENERALA DOROLEA",3,3122,"LIVEZILE",33541,570,308,282,26,0,307,1,599,291,86,221
6,"BISTRIŢA-NĂSĂUD","#N/A",33541,,164,"CUŞMA / SCOALA GENERALA CUSMA",3,3122,"LIVEZILE",33541,533,378,339,32,7,375,3,600,222,177,198
6,"BISTRIŢA-NĂSĂUD","#N/A",33541,,165,"VALEA POENII / ŞCOALA GENERALĂ VALEA POIENII",3,3122,"LIVEZILE",33541,121,98,83,15,0,95,3,200,102,56,39
6,"BISTRIŢA-NĂSĂUD","#N/A",33541,,166,"DUMBRAVA / ŞCOALA GENERALĂ DUMBRAVA",3,3122,"LIVEZILE",33541,270,166,148,18,0,166,0,300,134,73,93
6,"BISTRIŢA-NĂSĂUD","#N/A",33603,,167,"LUNCA ILVEI / CĂMIN CULTURAL",3,3128,"LUNCA ILVEI",33603,1480,885,846,39,0,880,5,1600,715,298,582
6,"BISTRIŢA-NĂSĂUD","#N/A",33603,,168,"LUNCA ILVEI / CĂMINUL CULTURAL LUNCA ILVEI",3,3128,"LUNCA ILVEI",33603,1165,680,649,31,0,672,8,1300,620,262,410
6,"BISTRIŢA-NĂSĂUD","#N/A",33621,,169,"MAIERU / GRUP ŞCOLAR  MAIERU, LOCAL 1",3,3133,"MAIERU",33621,985,646,624,22,0,643,3,1100,454,205,438
6,"BISTRIŢA-NĂSĂUD","#N/A",33621,,170,"MAIERU / GRUP ŞCOLAR MAIERU, LOCAL 2",3,3133,"MAIERU",33621,1276,819,798,21,0,817,2,1400,581,202,615
6,"BISTRIŢA-NĂSĂUD","#N/A",33621,,171,"MAIERU / GRUP ŞCOLAR MAIERU, LOCAL 2",3,3133,"MAIERU",33621,943,549,535,14,0,545,4,1000,451,181,364
6,"BISTRIŢA-NĂSĂUD","#N/A",33621,,172,"MAIERU / CĂMINUL CULTURAL MAIERU",3,3133,"MAIERU",33621,1536,934,908,26,0,928,6,1700,766,301,627
6,"BISTRIŢA-NĂSĂUD","#N/A",33621,,173,"ANIEŞ / ŞCOALA GENERALĂ ANIEŞ",3,3133,"MAIERU",33621,1416,939,903,36,0,936,3,1500,561,287,649
6,"BISTRIŢA-NĂSĂUD","#N/A",33658,,174,"MATEI / ŞCOALA GENERALĂ MATEI",3,3144,"MATEI",33658,587,509,457,43,9,506,3,600,91,173,333
6,"BISTRIŢA-NĂSĂUD","#N/A",33658,,175,"BIDIU / GRĂDINIŢA BIDIU",3,3144,"MATEI",33658,182,123,101,22,0,120,3,200,77,63,57
6,"BISTRIŢA-NĂSĂUD","#N/A",33658,,176,"CORVINEŞTI / ŞCOALA GENERALĂ CORVINEŞTI",3,3144,"MATEI",33658,547,405,351,54,0,403,2,600,195,139,264
6,"BISTRIŢA-NĂSĂUD","#N/A",33658,,177,"ENCIU / GRĂDINIŢA ENCIU",3,3144,"MATEI",33658,163,121,108,13,0,118,3,200,79,50,68
6,"BISTRIŢA-NĂSĂUD","#N/A",33658,,178,"FÎNTÎNELE / ŞCOALA GENERALĂ FÎNTÎNELE",3,3144,"MATEI",33658,498,346,310,36,0,345,1,600,254,113,232
6,"BISTRIŢA-NĂSĂUD","#N/A",33658,,179,"MORUŢ / ŞCOALA GENERALĂ MORUŢ",3,3144,"MATEI",33658,172,139,110,29,0,135,4,200,61,73,62
6,"BISTRIŢA-NĂSĂUD","#N/A",33729,,180,"MĂGURA ILVEI / CĂMINUL CULTURAL MĂGURA ILVEI",3,3130,"MĂGURA ILVEI",33729,1398,805,763,42,0,800,5,1500,695,315,485
6,"BISTRIŢA-NĂSĂUD","#N/A",33729,,181,"ARŞIŢA / CĂMINUL CULTURAL ARŞIŢA",3,3130,"MĂGURA ILVEI",33729,329,231,220,11,0,228,3,400,169,85,143
6,"BISTRIŢA-NĂSĂUD","#N/A",33765,,182,"MĂGURELE / ŞCOALA GIMAZIALĂ MĂRIŞELU",3,3136,"MĂRIŞELU",33765,558,365,320,42,3,364,1,600,235,101,263
6,"BISTRIŢA-NĂSĂUD","#N/A",33765,,183,"DOMNEŞTI / Scoala Gimaziala Domnesti",3,3136,"MĂRIŞELU",33765,680,416,364,50,2,411,5,700,284,210,201
6,"BISTRIŢA-NĂSĂUD","#N/A",33765,,184,"BÎRLA / CĂMINUL CULTURAL BÎRLA",3,3136,"MĂRIŞELU",33765,305,198,178,20,0,198,0,400,202,118,80
6,"BISTRIŢA-NĂSĂUD","#N/A",33765,,185,"SÎNTIOANA / ŞCOALA GIMAZIALĂ SÎNTIOANA",3,3136,"MĂRIŞELU",33765,389,255,232,23,0,255,0,400,145,129,126
6,"BISTRIŢA-NĂSĂUD","#N/A",33765,,186,"JEICA / Societatea Agricola",3,3136,"MĂRIŞELU",33765,97,88,52,36,0,87,1,200,112,22,65
6,"BISTRIŢA-NĂSĂUD","#N/A",33845,,187,"MICEŞTII DE CÎMPIE / CĂMINUL CULTURAL MICEŞTII DE CÎMPIE",3,3151,"MICEŞTII DE CÎMPIE",33845,267,223,175,48,0,219,4,300,77,129,90
6,"BISTRIŢA-NĂSĂUD","#N/A",33845,,188,"FÎNTÎNIŢA / ŞCOALA GENERALĂ FÎNTÎNIŢA",3,3151,"MICEŞTII DE CÎMPIE",33845,323,188,166,22,0,188,0,400,212,28,160
6,"BISTRIŢA-NĂSĂUD","#N/A",33845,,189,"VISUIA / CĂMINUL CULTURAL VISUIA",3,3151,"MICEŞTII DE CÎMPIE",33845,345,203,178,25,0,202,1,400,197,74,128
6,"BISTRIŢA-NĂSĂUD","#N/A",33881,,190,"MILAŞ / PRIMĂRIA COMUNEI MILAŞ",3,3155,"MILAŞ",33881,621,509,409,100,0,506,3,700,191,351,155
6,"BISTRIŢA-NĂSĂUD","#N/A",33881,,191,"OROSFAIA / ŞCOALA GENERALĂ OROSFAIA",3,3155,"MILAŞ",33881,336,262,222,40,0,261,1,400,138,147,114
6,"BISTRIŢA-NĂSĂUD","#N/A",33881,,192,"COMLOD / CĂMINUL CULTURAL COMLOD",3,3155,"MILAŞ",33881,118,103,80,23,0,102,1,200,97,74,28
6,"BISTRIŢA-NĂSĂUD","#N/A",33952,,193,"MONOR / CĂMINUL CULTURAL MONOR",3,3162,"MONOR",33952,749,555,496,46,13,553,2,800,245,288,265
6,"BISTRIŢA-NĂSĂUD","#N/A",33952,,194,"GLEDIN / CĂMINUL CULTURAL GLEDIN",3,3162,"MONOR",33952,450,330,293,30,7,329,1,500,170,184,145
6,"BISTRIŢA-NĂSĂUD","#N/A",179659,,195,"NEGRILEŞTI / ŞCOALA GIMNAZIALĂ NEGRILEŞTI",3,3165,"NEGRILEŞTI",179659,1024,682,566,71,45,678,4,1100,418,390,288
6,"BISTRIŢA-NĂSĂUD","#N/A",179659,,196,"PURCĂRETE / ŞCOALA GENERALĂ PURCĂRETE",3,3165,"NEGRILEŞTI",179659,172,122,106,16,0,122,0,200,78,51,71
6,"BISTRIŢA-NĂSĂUD","#N/A",179659,,197,"BREAZA / ŞCOALA GIMNAZIALĂ ""VICTOR MOTOGNA"" BREAZA",3,3165,"NEGRILEŞTI",179659,814,533,475,23,35,533,0,900,367,289,244
6,"BISTRIŢA-NĂSĂUD","#N/A",33989,,198,"NIMIGEA DE JOS / ŞCOALA GIMNAZIALĂ NIMIGEA DE JOS",3,3169,"NIMIGEA",33989,1326,868,763,93,12,864,4,1400,532,355,509
6,"BISTRIŢA-NĂSĂUD","#N/A",33989,,199,"MOCOD / CĂMINUL CULTURAL MOCOD",3,3169,"NIMIGEA",33989,521,335,296,39,0,332,3,600,265,122,210
6,"BISTRIŢA-NĂSĂUD","#N/A",33989,,200,"MITITEI / ŞCOALA GIMNAZIALĂ MITITEI",3,3169,"NIMIGEA",33989,596,377,342,30,5,377,0,700,323,184,193
6,"BISTRIŢA-NĂSĂUD","#N/A",33989,,201,"NIMIGEA DE SUS / ŞCOALA PRIMARĂ NIMIGEA DE SUS",3,3169,"NIMIGEA",33989,496,311,277,29,5,308,3,600,289,159,149
6,"BISTRIŢA-NĂSĂUD","#N/A",33989,,202,"MINTIU / ŞCOALA PRIMARĂ MINTIU",3,3169,"NIMIGEA",33989,331,216,174,42,0,216,0,400,184,74,142
6,"BISTRIŢA-NĂSĂUD","#N/A",33989,,203,"TĂURE / ŞCOALA PRIMARĂ TĂURE",3,3169,"NIMIGEA",33989,365,236,202,34,0,234,2,400,164,132,102
6,"BISTRIŢA-NĂSĂUD","#N/A",33989,,204,"MOGOŞENI / ŞCOALA PRIMARĂ MOGOŞENI",3,3169,"NIMIGEA",33989,271,198,169,24,5,196,2,300,102,77,119
6,"BISTRIŢA-NĂSĂUD","#N/A",33989,,205,"FLOREŞTI / ŞCOALA PRIMARĂ FLOREŞTI",3,3169,"NIMIGEA",33989,387,231,208,23,0,230,1,400,169,103,127
6,"BISTRIŢA-NĂSĂUD","#N/A",34075,,206,"NUŞENI / PRIMĂRIA COMUNEI NUŞENI",3,3178,"NUŞENI",34075,730,653,476,121,56,648,5,800,147,201,447
6,"BISTRIŢA-NĂSĂUD","#N/A",34075,,207,"BEUDIU / ŞCOALA GENERALĂ BEUDIU",3,3178,"NUŞENI",34075,507,395,342,32,21,391,4,600,205,103,288
6,"BISTRIŢA-NĂSĂUD","#N/A",34075,,208,"FELEAC / CAMIN CULTURAL FELEAC",3,3178,"NUŞENI",34075,272,244,203,41,0,244,0,300,56,70,174
6,"BISTRIŢA-NĂSĂUD","#N/A",34075,,209,"MALIN / ŞCOALA GENERALĂ MALIN",3,3178,"NUŞENI",34075,373,274,220,32,22,274,0,400,126,71,203
6,"BISTRIŢA-NĂSĂUD","#N/A",34075,,210,"RUSU DE SUS / GRĂDINIŢA DE COPII RUSU DE SUS",3,3178,"NUŞENI",34075,239,210,172,27,11,210,0,300,90,71,139
6,"BISTRIŢA-NĂSĂUD","#N/A",34075,,211,"VIŢA / ŞCOALA GENERALĂ VIŢA",3,3178,"NUŞENI",34075,299,186,145,24,17,184,2,300,114,21,163
6,"BISTRIŢA-NĂSĂUD","#N/A",34155,,212,"PARVA / ŞCOALA GENERALĂ CLASELE V - VIII PARVA",3,3186,"PARVA",34155,950,522,502,17,3,516,6,1000,478,238,278
6,"BISTRIŢA-NĂSĂUD","#N/A",34155,,213,"PARVA / SCOALA GENERALA V-VIII",3,3186,"PARVA",34155,920,434,412,22,0,432,2,1000,566,165,267
6,"BISTRIŢA-NĂSĂUD","#N/A",34173,,214,"RETEAG / PRIMĂRIA COMUNEI PETRU RAREŞ",3,3188,"PETRU RAREŞ",34173,1467,926,835,83,8,920,6,1600,674,426,494
6,"BISTRIŢA-NĂSĂUD","#N/A",34173,,215,"RETEAG / ŞCOALA GENERALĂ RETEAG POIENI, CLASELE I - IV",3,3188,"PETRU RAREŞ",34173,760,306,279,27,0,305,1,800,494,198,107
6,"BISTRIŢA-NĂSĂUD","#N/A",34173,,216,"BAŢA / CĂMINUL CULTURAL BAŢA",3,3188,"PETRU RAREŞ",34173,705,472,439,33,0,469,3,800,328,178,291
6,"BISTRIŢA-NĂSĂUD","#N/A",179720,,217,"POIANA ILVEI / ŞCOALA GENERALĂ ""SEVER POP"" POIANA ILVEI",3,3191,"POIANA ILVEI",179720,1282,878,822,41,15,874,4,1400,522,378,496
6,"BISTRIŢA-NĂSĂUD","#N/A",34235,,218,"PRUNDU BÎRGĂULUI / ŞCOALA GENERALĂ PRUNDU BÎRGĂULUI",3,3193,"PRUNDU BÎRGĂULUI",34235,1240,782,728,54,0,780,2,1400,618,221,559
6,"BISTRIŢA-NĂSĂUD","#N/A",34235,,219,"PRUNDU BÎRGĂULUI / CĂMINUL CULTURAL PRUNDU BÎRGĂULUI",3,3193,"PRUNDU BÎRGĂULUI",34235,1592,1146,1028,118,0,1143,3,1700,554,324,819
6,"BISTRIŢA-NĂSĂUD","#N/A",34235,,220,"PRUNDU BÎRGĂULUI / SCOALA GENERALA PRUNDU BARGAULUI",3,3193,"PRUNDU BÎRGĂULUI",34235,1370,859,805,54,0,850,9,1499,640,273,577
6,"BISTRIŢA-NĂSĂUD","#N/A",34235,,221,"SUSENII BÎRGĂULUI / ŞCOALA GENERALĂ SUSENII BÎRGĂULUI",3,3193,"PRUNDU BÎRGĂULUI",34235,1108,728,654,56,18,727,1,1200,472,261,466
6,"BISTRIŢA-NĂSĂUD","#N/A",34262,,222,"REBRA / SCOALA GENERALA REBRA",3,3196,"REBRA",34262,974,463,451,12,0,462,1,1100,637,120,342
6,"BISTRIŢA-NĂSĂUD","#N/A",34262,,223,"REBRA / SCOALA GENERALA REBRA",3,3196,"REBRA",34262,1048,458,442,16,0,452,6,1200,742,105,347
6,"BISTRIŢA-NĂSĂUD","#N/A",34280,,224,"REBRIŞOARA / CAMIN CULTURAL REBRISOARA",3,3198,"REBRIŞOARA",34280,1478,820,779,39,2,813,7,1600,780,283,530
6,"BISTRIŢA-NĂSĂUD","#N/A",34280,,225,"REBRIŞOARA / SCOALA GENERALA CLS.I-IV REBRISOARA",3,3198,"REBRIŞOARA",34280,1615,810,777,33,0,804,6,1700,890,244,560
6,"BISTRIŢA-NĂSĂUD","#N/A",34280,,226,"GERSA I / SCOALA GENERALA SAT GERSA I",3,3198,"REBRIŞOARA",34280,573,319,303,16,0,315,4,600,281,60,255
6,"BISTRIŢA-NĂSĂUD","#N/A",34280,,227,"GERSA II / SCOALA GENERALA VALEA BABII",3,3198,"REBRIŞOARA",34280,153,94,84,10,0,94,0,200,106,17,77
6,"BISTRIŢA-NĂSĂUD","#N/A",34333,,228,"RODNA / ŞCOALA GENERALĂ NR. 2 ""FLORIAN PORCIUS"" RODNA",3,3203,"RODNA",34333,994,610,580,25,5,604,6,1100,490,298,306
6,"BISTRIŢA-NĂSĂUD","#N/A",34333,,229,"RODNA / ŞCOALA GENERALĂ NR. 2 ""FLORIAN PORCIUS"" RODNA",3,3203,"RODNA",34333,997,605,589,16,0,604,1,1100,495,285,319
6,"BISTRIŢA-NĂSĂUD","#N/A",34333,,230,"RODNA / PRIMĂRIA COMUNEI RODNA",3,3203,"RODNA",34333,1456,967,918,38,11,966,1,1600,633,356,610
6,"BISTRIŢA-NĂSĂUD","#N/A",34333,,231,"RODNA / CĂMINUL CULTURAL ""GHERASIM DOMIDE"" RODNA",3,3203,"RODNA",34333,1429,884,846,34,4,876,8,1500,616,456,420
6,"BISTRIŢA-NĂSĂUD","#N/A",34333,,232,"VALEA VINULUI / ŞCOALA GENERALĂ VALEA VINULUI",3,3203,"RODNA",34333,167,115,99,14,2,115,0,200,85,71,44
6,"BISTRIŢA-NĂSĂUD","#N/A",34360,,233,"ROMULI / ŞCOALA GENERALĂ CLS. I - VIII ROMULI",3,3206,"ROMULI",34360,1025,741,687,54,0,737,4,1100,359,492,245
6,"BISTRIŢA-NĂSĂUD","#N/A",34360,,234,"DEALU ŞTEFĂNIŢEI / ŞCOALA GENERALĂ CLS. I - IV DEALU ŞTEFĂNIŢEI",3,3206,"ROMULI",34360,351,255,236,19,0,255,0,400,145,123,132
6,"BISTRIŢA-NĂSĂUD","#N/A",179944,,235,"RUNCU SALVEI / PRIMĂRIA COMUNEI RUNCU SALVEI",3,3209,"RUNCU SALVEI",179944,1065,758,732,16,10,748,10,1200,442,146,602
6,"BISTRIŢA-NĂSĂUD","#N/A",34397,,236,"SALVA / PRIMĂRIA COMUNEI SALVA",3,3211,"SALVA",34397,1120,717,673,19,25,710,7,1200,483,389,321
6,"BISTRIŢA-NĂSĂUD","#N/A",34397,,237,"SALVA / ŞCOALA GIMANZIALĂ SALVA",3,3211,"SALVA",34397,1263,825,760,30,35,815,10,1400,575,457,358
6,"BISTRIŢA-NĂSĂUD","#N/A",34422,,238,"SILIVAŞU DE CÎMPIE / CĂMINUL CULTURAL SILIVAŞU DE CÎMPIE",3,3242,"SILIVAŞU DE CÎMPIE",34422,816,568,501,66,1,566,2,900,332,304,262
6,"BISTRIŢA-NĂSĂUD","#N/A",34477,,239,"SÎNMIHAIU DE CÎMPIE / CĂMINUL CULTURAL SÎNMIHAIU DE CÎMPIE",3,3247,"SÎNMIHAIU DE CÎMPIE",34477,581,408,354,43,11,405,3,700,292,234,171
6,"BISTRIŢA-NĂSĂUD","#N/A",34477,,240,"BRĂTENI / CĂMINUL CULTURAL BRĂTENI",3,3247,"SÎNMIHAIU DE CÎMPIE",34477,79,79,49,23,7,79,0,100,21,50,29
6,"BISTRIŢA-NĂSĂUD","#N/A",34477,,241,"SĂLCUŢA / CĂMINUL CULTURAL SĂLCUŢA",3,3247,"SÎNMIHAIU DE CÎMPIE",34477,96,82,51,23,8,82,0,100,18,48,34
6,"BISTRIŢA-NĂSĂUD","#N/A",34477,,242,"STUPINI / SCOALA GIMNAZIALA STUPINI",3,3247,"SÎNMIHAIU DE CÎMPIE",34477,184,171,113,34,24,170,1,200,29,129,41
6,"BISTRIŢA-NĂSĂUD","#N/A",34477,,243,"ZORENI / CĂMINUL CULTURAL ZORENI",3,3247,"SÎNMIHAIU DE CÎMPIE",34477,255,188,153,22,13,186,2,300,112,107,79
6,"BISTRIŢA-NĂSĂUD","#N/A",34547,,244,"SPERMEZEU / PRIMĂRIA COMUNEI SPERMEZEU",3,3262,"SPERMEZEU",34547,1476,765,724,35,6,762,3,1600,835,167,595
6,"BISTRIŢA-NĂSĂUD","#N/A",34547,,245,"SITA / ŞCOALA GIMNAZIALĂ SITA",3,3262,"SPERMEZEU",34547,273,182,175,7,0,182,0,300,118,30,152
6,"BISTRIŢA-NĂSĂUD","#N/A",34547,,246,"HĂLMĂSĂU / ŞCOALA PRIMARĂ HĂLMĂSĂU",3,3262,"SPERMEZEU",34547,228,137,132,5,0,136,1,300,163,12,124
6,"BISTRIŢA-NĂSĂUD","#N/A",34547,,247,"DUMBRĂVIŢA / ŞCOALA GIMNAZIALĂ ""TEODOR COTUŢIU"" DUMBRĂVIŢA",3,3262,"SPERMEZEU",34547,667,418,388,26,4,413,5,700,282,98,315
6,"BISTRIŢA-NĂSĂUD","#N/A",34547,,248,"DOBRICEL / ŞCOALA PRIMARĂ DOBRICEL",3,3262,"SPERMEZEU",34547,460,319,292,18,9,318,1,500,181,75,243
6,"BISTRIŢA-NĂSĂUD","#N/A",34618,,249,"ŞANŢ / GRĂDINIŢA NR. 1 ŞANŢ",3,3213,"ŞANŢ",34618,1277,970,910,51,9,964,6,1396,426,604,360
6,"BISTRIŢA-NĂSĂUD","#N/A",34618,,250,"ŞANŢ / CĂMINUL CULTURAL ŞANŢ",3,3213,"ŞANŢ",34618,1122,795,761,23,11,788,7,1200,405,489,299
6,"BISTRIŢA-NĂSĂUD","#N/A",34618,,251,"VALEA MARE / ŞCOALA VALEA MARE",3,3213,"ŞANŢ",34618,242,220,184,31,5,219,1,300,80,142,77
6,"BISTRIŢA-NĂSĂUD","#N/A",34645,,252,"ŞIEU / PRIMĂRIA COMUNEI ŞIEU",3,3216,"ŞIEU",34645,1110,714,661,51,2,712,2,1200,486,248,464
6,"BISTRIŢA-NĂSĂUD","#N/A",34645,,253,"ARDAN / ŞCOALA GENERALĂ ARDAN",3,3216,"ŞIEU",34645,601,362,341,21,0,362,0,700,338,210,152
6,"BISTRIŢA-NĂSĂUD","#N/A",34645,,254,"POSMUŞ / ŞCOALA GENERALĂ POSMUŞ",3,3216,"ŞIEU",34645,562,327,306,21,0,325,2,601,274,130,195
6,"BISTRIŢA-NĂSĂUD","#N/A",34645,,255,"ŞOIMUŞ / CĂMINUL CULTURAL ŞOIMUŞ",3,3216,"ŞIEU",34645,139,106,96,10,0,105,1,200,94,41,64
6,"BISTRIŢA-NĂSĂUD","#N/A",34690,,256,"ŞIEU-MĂGHERUŞ / CĂMINUL CULTURAL ŞIEU-MĂGHERUŞ",3,3221,"ŞIEU-MĂGHERUŞ",34690,941,553,508,44,1,548,5,1000,447,197,351
6,"BISTRIŢA-NĂSĂUD","#N/A",34690,,257,"CHINTELNIC / CAMIN CULTURAL ""GRIGORE PLETOSU""",3,3221,"ŞIEU-MĂGHERUŞ",34690,546,360,312,46,2,359,1,600,240,105,254
6,"BISTRIŢA-NĂSĂUD","#N/A",34690,,258,"CRAINIMĂT / CĂMINUL CULTURAL CRAINIMĂT",3,3221,"ŞIEU-MĂGHERUŞ",34690,764,454,404,50,0,445,9,801,347,138,307
6,"BISTRIŢA-NĂSĂUD","#N/A",34690,,259,"SĂRĂŢEL / CĂMINUL CULTURAL SĂRĂŢEL",3,3221,"ŞIEU-MĂGHERUŞ",34690,469,294,243,47,4,292,2,500,206,87,205
6,"BISTRIŢA-NĂSĂUD","#N/A",34690,,260,"ARCALIA / ŞCOALA GENERALĂ ARCALIA, CLASELE V-VIII",3,3221,"ŞIEU-MĂGHERUŞ",34690,686,415,361,54,0,411,4,800,385,125,286
6,"BISTRIŢA-NĂSĂUD","#N/A",34770,,261,"ŞIEU-ODORHEI / PRIMĂRIA COMUNEI ŞIEU-ODORHEI",3,3229,"ŞIEU-ODORHEI",34770,615,461,381,68,12,456,5,700,239,188,268
6,"BISTRIŢA-NĂSĂUD","#N/A",34770,,262,"AGRIŞU DE JOS / ŞCOALA GENERALĂ AGRIŞU DE JOS",3,3229,"ŞIEU-ODORHEI",34770,305,218,203,15,0,216,2,400,182,151,65
6,"BISTRIŢA-NĂSĂUD","#N/A",34770,,263,"AGRIŞU DE SUS / ŞCOALA GENERALĂ AGRIŞU DE SUS",3,3229,"ŞIEU-ODORHEI",34770,140,107,86,21,0,106,1,200,93,70,36
6,"BISTRIŢA-NĂSĂUD","#N/A",34770,,264,"BRETEA / CĂMINUL CULTURAL BRETEA",3,3229,"ŞIEU-ODORHEI",34770,153,156,90,52,14,156,0,200,44,80,76
6,"BISTRIŢA-NĂSĂUD","#N/A",34770,,265,"COASTA / CĂMINUL CULTURAL COASTA",3,3229,"ŞIEU-ODORHEI",34770,156,132,99,32,1,131,1,200,68,63,68
6,"BISTRIŢA-NĂSĂUD","#N/A",34770,,266,"CRISTUR-ŞIEU / ŞCOALA GENERALĂ CRISTUR-ŞIEU",3,3229,"ŞIEU-ODORHEI",34770,392,281,236,45,0,279,2,400,119,97,182
6,"BISTRIŢA-NĂSĂUD","#N/A",34770,,267,"ŞIRIOARA / ŞCOALA GENERALĂ ŞIRIOARA",3,3229,"ŞIEU-ODORHEI",34770,216,182,141,41,0,181,1,300,118,69,112
6,"BISTRIŢA-NĂSĂUD","#N/A",34850,,268,"ŞIEUŢ / PRIMĂRIA COMUNEI ŞIEUŢ",3,3237,"ŞIEUŢ",34850,576,432,376,39,17,428,4,600,168,220,208
6,"BISTRIŢA-NĂSĂUD","#N/A",34850,,269,"RUŞTIOR / ŞCOALA GENERALĂ RUŞTIOR",3,3237,"ŞIEUŢ",34850,506,364,339,12,13,362,2,600,236,158,204
6,"BISTRIŢA-NĂSĂUD","#N/A",34850,,270,"SEBIŞ / SCOALA GIMNAZIALA  SEBIŞ",3,3237,"ŞIEUŢ",34850,708,485,464,17,4,482,3,800,315,208,274
6,"BISTRIŢA-NĂSĂUD","#N/A",34850,,271,"LUNCA / ŞCOALA GENERALĂ LUNCA",3,3237,"ŞIEUŢ",34850,317,211,188,16,7,211,0,400,189,137,74
6,"BISTRIŢA-NĂSĂUD","#N/A",34903,,272,"ŞINTEREAG / PRIMĂRIA COMUNEI ŞINTEREAG",3,3254,"ŞINTEREAG",34903,838,661,508,123,30,657,4,900,239,271,386
6,"BISTRIŢA-NĂSĂUD","#N/A",34903,,273,"CAILA / ŞCOALA PRIMARĂ CLASELE I-IV (fostul sediu)",3,3254,"ŞINTEREAG",34903,253,205,172,33,0,203,2,300,95,81,122
6,"BISTRIŢA-NĂSĂUD","#N/A",34903,,274,"COCIU / ŞCOALA GIMNAZIALĂ COCIU",3,3254,"ŞINTEREAG",34903,910,653,592,45,16,651,2,1000,347,319,332
6,"BISTRIŢA-NĂSĂUD","#N/A",34903,,275,"BLĂJENII DE JOS / CĂMINUL CULTURAL  BLĂJENII DE JOS",3,3254,"ŞINTEREAG",34903,316,258,174,63,21,257,1,400,142,110,147
6,"BISTRIŢA-NĂSĂUD","#N/A",34903,,276,"BLĂJENII DE SUS / ŞCOALA PRIMARĂ NICOLAE BĂLAN BLĂJENII DE SUS",3,3254,"ŞINTEREAG",34903,315,261,178,82,1,261,0,400,139,139,122
6,"BISTRIŢA-NĂSĂUD","#N/A",34903,,277,"ŞIEU-SFÎNTU / ŞCOALA PRIMARĂ CLASELE I-IV ŞIEU-SFÎNTU (FOSTUL SEDIU)",3,3254,"ŞINTEREAG",34903,392,335,256,62,17,335,0,400,65,193,142
6,"BISTRIŢA-NĂSĂUD","#N/A",34985,,278,"ARCHIUD / ŞCOALA GENERALĂ ARCHIUD",3,3271,"TEACA",34985,474,351,313,38,0,349,2,500,149,266,83
6,"BISTRIŢA-NĂSĂUD","#N/A",34985,,279,"BUDURLENI / CĂMINUL CULTURAL BUDURLENI",3,3271,"TEACA",34985,88,86,64,22,0,85,1,100,14,64,21
6,"BISTRIŢA-NĂSĂUD","#N/A",34985,,280,"OCNIŢA / CĂMINUL CULTURAL OCNIŢA",3,3271,"TEACA",34985,898,498,468,30,0,493,5,1000,502,202,291
6,"BISTRIŢA-NĂSĂUD","#N/A",34985,,281,"PINTICU / FOST SEDIU C.A.P. PINTICU",3,3271,"TEACA",34985,627,322,300,22,0,315,7,700,378,162,153
6,"BISTRIŢA-NĂSĂUD","#N/A",34985,,282,"TEACA / Căminul cultural Teaca",3,3271,"TEACA",34985,889,521,469,35,17,519,2,1000,479,203,316
6,"BISTRIŢA-NĂSĂUD","#N/A",34985,,283,"TEACA / Primăria comunei Teaca",3,3271,"TEACA",34985,762,524,447,76,1,521,3,800,276,180,341
6,"BISTRIŢA-NĂSĂUD","#N/A",34985,,284,"VIILE TECII / ŞCOALA GENERALĂ VIILE TECII",3,3271,"TEACA",34985,812,459,418,41,0,455,4,900,441,234,221
6,"BISTRIŢA-NĂSĂUD","#N/A",35054,,285,"TELCIU / LICEUL TEHNOLOGIC TELCIU",3,3278,"TELCIU",35054,1221,637,606,31,0,634,3,1300,663,137,497
6,"BISTRIŢA-NĂSĂUD","#N/A",35054,,286,"TELCIU / CAMINUL CULTURAL TELCIU",3,3278,"TELCIU",35054,1004,599,563,35,1,591,8,1100,501,117,474
6,"BISTRIŢA-NĂSĂUD","#N/A",35054,,287,"TELCIU / OCOLUL SILVIC TELCIU",3,3278,"TELCIU",35054,973,526,503,23,0,524,2,1100,574,136,388
6,"BISTRIŢA-NĂSĂUD","#N/A",35054,,288,"TELCIŞOR / ŞCOALA GENERALĂ TELCIŞOR",3,3278,"TELCIU",35054,847,465,437,27,1,464,1,900,435,45,419
6,"BISTRIŢA-NĂSĂUD","#N/A",35054,,289,"FIAD / ŞCOALA GENERALĂ FIAD",3,3278,"TELCIU",35054,196,111,100,11,0,109,2,200,89,33,76
6,"BISTRIŢA-NĂSĂUD","#N/A",35054,,290,"BICHIGIU / ŞCOALA GENERALĂ BICHIGIU",3,3278,"TELCIU",35054,687,402,379,23,0,401,1,800,398,201,200
6,"BISTRIŢA-NĂSĂUD","#N/A",35090,,291,"TIHA BÎRGĂULUI / CĂMINUL CULTURAL TIHA BÎRGĂULUI",3,3283,"TIHA BÎRGĂULUI",35090,1336,867,786,81,0,867,0,1400,533,156,711
6,"BISTRIŢA-NĂSĂUD","#N/A",35090,,292,"TUREAC / SALA DE SPORT TUREAC",3,3283,"TIHA BÎRGĂULUI",35090,521,345,317,28,0,339,6,600,255,99,240
6,"BISTRIŢA-NĂSĂUD","#N/A",35090,,293,"TUREAC / Scoala Generala Tureac",3,3283,"TIHA BÎRGĂULUI",35090,1531,902,835,67,0,892,10,1600,698,116,776
6,"BISTRIŢA-NĂSĂUD","#N/A",35090,,294,"MUREŞENII BÎRGĂULUI / ŞCOALA GENERALĂ MUREŞENII BÎRGĂULUI",3,3283,"TIHA BÎRGĂULUI",35090,1347,851,787,63,1,851,0,1500,649,87,764
6,"BISTRIŢA-NĂSĂUD","#N/A",35090,,295,"PIATRA FÎNTÎNELE / ŞCOALA GENERALĂ PIATRA FÎNTÎNELE",3,3283,"TIHA BÎRGĂULUI",35090,326,232,151,81,0,232,0,400,168,16,216
6,"BISTRIŢA-NĂSĂUD","#N/A",35152,,296,"TÎRLIŞUA / ŞCOALA GENERALĂ TÎRLIŞUA",3,3289,"TÎRLIŞUA",35152,1247,736,667,49,20,728,8,1374,638,298,430
6,"BISTRIŢA-NĂSĂUD","#N/A",35152,,297,"BORLEASA / ŞCOALA GENERALĂ BORLEASA",3,3289,"TÎRLIŞUA",35152,328,209,190,17,2,205,4,362,153,113,92
6,"BISTRIŢA-NĂSĂUD","#N/A",35152,,298,"LUNCA SĂTEASCA / ŞCOALA GENERALĂ LUNCA SĂTEASCĂ",3,3289,"TÎRLIŞUA",35152,263,160,146,14,0,160,0,292,132,56,104
6,"BISTRIŢA-NĂSĂUD","#N/A",35152,,299,"AGRIEŞ / ŞCOALA GENERALĂ AGRIEŞ",3,3289,"TÎRLIŞUA",35152,803,570,531,25,14,564,6,900,330,333,231
6,"BISTRIŢA-NĂSĂUD","#N/A",35152,,300,"MOLIŞET / ŞCOALA GENERALĂ MOLIŞET (COASTEASA)",3,3289,"TÎRLIŞUA",35152,186,143,127,16,0,143,0,200,57,73,70
6,"BISTRIŢA-NĂSĂUD","#N/A",35269,,301,"URIU / ŞCOALA GENERALĂ URIU",3,3300,"URIU",35269,1177,884,766,84,34,879,5,1301,417,299,580
6,"BISTRIŢA-NĂSĂUD","#N/A",35269,,302,"CRISTEŞTII CICEULUI / ŞCOALA GENERALĂ CRISTEŞTII CICEULUI",3,3300,"URIU",35269,976,665,552,85,28,661,4,1100,435,306,355
6,"BISTRIŢA-NĂSĂUD","#N/A",35269,,303,"ILIŞUA / ŞCOALA GENERALĂ ILIŞUA",3,3300,"URIU",35269,582,466,405,49,12,465,1,600,134,221,244
6,"BISTRIŢA-NĂSĂUD","#N/A",35269,,304,"HĂŞMAŞU CICEULUI / ŞCOALA GENERALĂ HĂŞMAŞU CICEULUI",3,3300,"URIU",35269,210,164,131,33,0,162,2,300,136,78,84
6,"BISTRIŢA-NĂSĂUD","#N/A",35312,,305,"URMENIŞ / SALA DE SPORT URMENIŞ",3,3305,"URMENIŞ",35312,778,496,442,54,0,492,4,900,404,246,246
6,"BISTRIŢA-NĂSĂUD","#N/A",35312,,306,"ŞOPTERIU / ŞCOALA GENERALĂ ŞOPTERIU",3,3305,"URMENIŞ",35312,323,206,178,28,0,203,3,400,194,89,114
6,"BISTRIŢA-NĂSĂUD","#N/A",35312,,307,"DELURENI / ŞCOALA GENERALĂ  DELURENI",3,3305,"URMENIŞ",35312,277,163,135,28,0,162,1,300,137,61,101
6,"BISTRIŢA-NĂSĂUD","#N/A",35312,,308,"FÎNAŢE / CĂMINUL CULTURAL FÎNAŢE",3,3305,"URMENIŞ",35312,162,121,100,21,0,117,4,200,79,41,76
6,"BISTRIŢA-NĂSĂUD","#N/A",35429,,309,"ZAGRA / ŞCOALA GENERALĂ ZAGRA",3,3316,"ZAGRA",35429,906,640,569,41,30,637,3,1000,360,336,301
6,"BISTRIŢA-NĂSĂUD","#N/A",35429,,310,"POIENILE ZAGREI / ŞCOALA GENERALĂ POIENILE ZAGREI",3,3316,"ZAGRA",35429,698,454,402,23,29,453,1,800,346,234,219
6,"BISTRIŢA-NĂSĂUD","#N/A",35429,,311,"SUPLAI / ŞCOALA GENERALĂ SUPLAI",3,3316,"ZAGRA",35429,510,333,308,8,17,331,2,600,267,221,110
6,"BISTRIŢA-NĂSĂUD","#N/A",35429,,312,"PERIŞOR / ŞCOALA GENERALĂ PERIŞOR",3,3316,"ZAGRA",35429,459,308,280,11,17,304,4,500,192,145,159
6,"BISTRIŢA-NĂSĂUD","#N/A",35429,,313,"ALUNIŞUL / ŞCOALA GENERALĂ ALUNIŞUL",3,3316,"ZAGRA",35429,187,138,114,12,12,138,0,200,62,85,53
7,"BOTOŞANI","#N/A",35731,,1,"BOTOŞANI / Liceul de Artă ,, Ştefan Luchian""",1,3323,"MUNICIPIUL BOTOŞANI",35731,917,751,457,31,263,740,11,1028,277,495,245
7,"BOTOŞANI","#N/A",35731,,2,"BOTOŞANI / Liceul de Artă ,, Ştefan Luchian""",1,3323,"MUNICIPIUL BOTOŞANI",35731,1367,955,841,84,30,936,19,1505,550,498,438
7,"BOTOŞANI","#N/A",35731,,3,"BOTOŞANI / Şcoala Generală nr. 4",1,3323,"MUNICIPIUL BOTOŞANI",35731,1517,947,907,39,1,929,18,1673,726,577,352
7,"BOTOŞANI","#N/A",35731,,4,"BOTOŞANI / Şcoala Generală nr. 4",1,3323,"MUNICIPIUL BOTOŞANI",35731,1481,895,870,24,1,881,14,1632,737,531,350
7,"BOTOŞANI","#N/A",35731,,5,"BOTOŞANI / Şcoala Generală nr. 7",1,3323,"MUNICIPIUL BOTOŞANI",35731,1142,643,603,39,1,632,11,1267,624,401,231
7,"BOTOŞANI","#N/A",35731,,6,"BOTOŞANI / Şcoala Generală nr. 7",1,3323,"MUNICIPIUL BOTOŞANI",35731,1157,661,613,48,0,652,9,1277,616,373,279
7,"BOTOŞANI","#N/A",35731,,7,"BOTOŞANI / Grădiniţa de Copii nr. 19",1,3323,"MUNICIPIUL BOTOŞANI",35731,1034,588,559,29,0,574,14,1141,553,333,241
7,"BOTOŞANI","#N/A",35731,,8,"BOTOŞANI / Grădiniţa de Copii nr. 19",1,3323,"MUNICIPIUL BOTOŞANI",35731,1160,620,596,24,0,608,12,1280,660,378,230
7,"BOTOŞANI","#N/A",35731,,9,"BOTOŞANI / Şcoala Generală nr. 17",1,3323,"MUNICIPIUL BOTOŞANI",35731,1550,918,864,53,1,904,14,1706,788,527,377
7,"BOTOŞANI","#N/A",35731,,10,"BOTOŞANI / Liceul de Ştiinţe ale Naturii ""GrigoreAntipa""",1,3323,"MUNICIPIUL BOTOŞANI",35731,1609,988,929,57,2,962,26,1774,786,619,343
7,"BOTOŞANI","#N/A",35731,,11,"BOTOŞANI / Liceul de Ştiinţe ale Naturii ""GrigoreAntipa""",1,3323,"MUNICIPIUL BOTOŞANI",35731,1498,906,862,37,7,893,13,1654,748,529,364
7,"BOTOŞANI","#N/A",35731,,12,"BOTOŞANI / Şcoala Generală nr. 16",1,3323,"MUNICIPIUL BOTOŞANI",35731,1571,857,812,45,0,833,24,1731,874,464,369
7,"BOTOŞANI","#N/A",35731,,13,"BOTOŞANI / Şcoala Generală nr. 16",1,3323,"MUNICIPIUL BOTOŞANI",35731,1446,744,708,36,0,732,12,1591,847,422,310
7,"BOTOŞANI","#N/A",35731,,14,"BOTOŞANI / Şcoala Generală nr. 16",1,3323,"MUNICIPIUL BOTOŞANI",35731,1288,632,604,28,0,617,15,1416,784,344,273
7,"BOTOŞANI","#N/A",35731,,15,"BOTOŞANI / Şcoala Generală nr. 13",1,3323,"MUNICIPIUL BOTOŞANI",35731,1412,771,718,53,0,752,19,1557,786,442,310
7,"BOTOŞANI","#N/A",35731,,16,"BOTOŞANI / Şcoala Generală nr. 13",1,3323,"MUNICIPIUL BOTOŞANI",35731,1549,803,766,36,1,789,14,1705,902,448,341
7,"BOTOŞANI","#N/A",35731,,17,"BOTOŞANI / Colegiul Naţional ""Mihai Eminescu""",1,3323,"MUNICIPIUL BOTOŞANI",35731,1359,716,693,23,0,704,12,1502,786,422,282
7,"BOTOŞANI","#N/A",35731,,18,"BOTOŞANI / Colegiul Naţional ""Mihai Eminescu""",1,3323,"MUNICIPIUL BOTOŞANI",35731,1154,691,659,32,0,678,13,1267,576,417,261
7,"BOTOŞANI","#N/A",35731,,19,"BOTOŞANI / Colegiul Naţional ""Mihai Eminescu""",1,3323,"MUNICIPIUL BOTOŞANI",35731,1518,888,843,45,0,869,19,1670,782,507,362
7,"BOTOŞANI","#N/A",35731,,20,"BOTOŞANI / Colegiul Naţional ""Mihai Eminescu""",1,3323,"MUNICIPIUL BOTOŞANI",35731,1230,635,616,19,0,616,19,1356,721,342,274
7,"BOTOŞANI","#N/A",35731,,21,"BOTOŞANI / Şcoala Generală nr. 12",1,3323,"MUNICIPIUL BOTOŞANI",35731,1030,563,525,38,0,552,11,1135,572,323,229
7,"BOTOŞANI","#N/A",35731,,22,"BOTOŞANI / Şcoala Generală nr. 12",1,3323,"MUNICIPIUL BOTOŞANI",35731,856,452,429,23,0,442,10,943,491,252,190
7,"BOTOŞANI","#N/A",35731,,23,"BOTOŞANI / Şcoala Generală nr. 12",1,3323,"MUNICIPIUL BOTOŞANI",35731,1383,748,719,26,3,733,15,1520,772,429,304
7,"BOTOŞANI","#N/A",35731,,24,"BOTOŞANI / Grădiniţa de Copii nr. 23",1,3323,"MUNICIPIUL BOTOŞANI",35731,1349,699,660,39,0,688,11,1481,782,432,256
7,"BOTOŞANI","#N/A",35731,,25,"BOTOŞANI / Grupul Şcolar Industrial ""Ghe.Asachi""(Liceul Electrocontact)",1,3323,"MUNICIPIUL BOTOŞANI",35731,722,427,371,56,0,420,7,795,368,242,178
7,"BOTOŞANI","#N/A",35731,,26,"BOTOŞANI / Grupul Şcolar Industrial ""Ghe.Asachi""(Liceul Electrocontact)",1,3323,"MUNICIPIUL BOTOŞANI",35731,1050,560,542,17,1,542,18,1159,599,326,216
7,"BOTOŞANI","#N/A",35731,,27,"BOTOŞANI / Grupul Şcolar Industrial ""Ghe.Asachi""(Şcoala Profesională Electrocontact)",1,3323,"MUNICIPIUL BOTOŞANI",35731,1215,561,544,17,0,551,10,1337,776,281,270
7,"BOTOŞANI","#N/A",35731,,28,"BOTOŞANI / Grupul Şcolar Industrial ""Ghe.Asachi""(Şcoala Profesională Electrocontact)",1,3323,"MUNICIPIUL BOTOŞANI",35731,1107,636,595,41,0,626,10,1233,597,326,300
7,"BOTOŞANI","#N/A",35731,,29,"BOTOŞANI / Grupul Şcolar Industrial ""Ghe.Asachi""(Şcoala Profesională Electrocontact)",1,3323,"MUNICIPIUL BOTOŞANI",35731,857,464,441,23,0,455,9,942,478,232,223
7,"BOTOŞANI","#N/A",35731,,30,"BOTOŞANI / Grupul Şcolar de Industrie Uşoară (Liceul Textil)",1,3323,"MUNICIPIUL BOTOŞANI",35731,1439,765,701,48,16,748,17,1585,820,412,336
7,"BOTOŞANI","#N/A",35731,,31,"BOTOŞANI / Grupul Şcolar de Industrie Uşoară (Liceul Textil)",1,3323,"MUNICIPIUL BOTOŞANI",35731,856,573,468,32,73,563,10,937,364,324,239
7,"BOTOŞANI","#N/A",35731,,32,"BOTOŞANI / Grupul Şcolar de Industrie Uşoară (Liceul Textil)",1,3323,"MUNICIPIUL BOTOŞANI",35731,845,451,428,23,0,445,6,933,482,231,214
7,"BOTOŞANI","#N/A",35731,,33,"BOTOŞANI / Şcoala Generală nr. 14",1,3323,"MUNICIPIUL BOTOŞANI",35731,865,479,452,27,0,466,13,948,469,270,196
7,"BOTOŞANI","#N/A",35731,,34,"BOTOŞANI / Şcoala Generală nr. 14",1,3323,"MUNICIPIUL BOTOŞANI",35731,1533,840,810,27,3,822,18,1687,847,464,358
7,"BOTOŞANI","#N/A",35731,,35,"BOTOŞANI / Şcoala Generală nr. 14",1,3323,"MUNICIPIUL BOTOŞANI",35731,667,361,333,28,0,355,6,741,380,209,146
7,"BOTOŞANI","#N/A",35731,,36,"BOTOŞANI / Şcoala Generală nr. 14",1,3323,"MUNICIPIUL BOTOŞANI",35731,1150,623,603,20,0,612,11,1268,645,334,278
7,"BOTOŞANI","#N/A",35731,,37,"BOTOŞANI / Şcoala Generală nr. 14",1,3323,"MUNICIPIUL BOTOŞANI",35731,1103,532,514,18,0,522,10,1210,678,301,221
7,"BOTOŞANI","#N/A",35731,,38,"BOTOŞANI / Şcoala Generală nr. 14",1,3323,"MUNICIPIUL BOTOŞANI",35731,1211,572,546,26,0,557,15,1331,759,321,236
7,"BOTOŞANI","#N/A",35731,,39,"BOTOŞANI / Grădiniţa de Copii nr. 22",1,3323,"MUNICIPIUL BOTOŞANI",35731,1211,572,552,20,0,554,18,1334,762,336,218
7,"BOTOŞANI","#N/A",35731,,40,"BOTOŞANI / Grădiniţa de Copii nr. 22",1,3323,"MUNICIPIUL BOTOŞANI",35731,844,517,499,18,0,506,11,932,415,280,226
7,"BOTOŞANI","#N/A",35731,,41,"BOTOŞANI / Grădiniţa de Copii nr. 22",1,3323,"MUNICIPIUL BOTOŞANI",35731,991,504,490,13,1,495,9,1098,594,264,231
7,"BOTOŞANI","#N/A",35731,,42,"BOTOŞANI / Grădiniţa de Copii nr. 22",1,3323,"MUNICIPIUL BOTOŞANI",35731,1007,527,513,14,0,516,11,1106,579,285,231
7,"BOTOŞANI","#N/A",35731,,43,"BOTOŞANI / Şcoala Generală nr.8",1,3323,"MUNICIPIUL BOTOŞANI",35731,1286,679,642,37,0,661,18,1415,736,336,325
7,"BOTOŞANI","#N/A",35731,,44,"BOTOŞANI / Şcoala Generală nr.8",1,3323,"MUNICIPIUL BOTOŞANI",35731,1422,811,745,65,1,797,14,1564,753,425,372
7,"BOTOŞANI","#N/A",35731,,45,"BOTOŞANI / Şcoala Generală nr.8",1,3323,"MUNICIPIUL BOTOŞANI",35731,1056,559,526,33,0,544,15,1164,605,307,237
7,"BOTOŞANI","#N/A",35731,,46,"BOTOŞANI / Şcoala Generală nr.8",1,3323,"MUNICIPIUL BOTOŞANI",35731,1375,696,655,41,0,677,19,1518,822,389,288
7,"BOTOŞANI","#N/A",35731,,47,"BOTOŞANI / Şcoala Generală nr. 11",1,3323,"MUNICIPIUL BOTOŞANI",35731,1200,692,652,40,0,678,14,1320,628,376,302
7,"BOTOŞANI","#N/A",35731,,48,"BOTOŞANI / Şcoala Generală nr. 11",1,3323,"MUNICIPIUL BOTOŞANI",35731,906,540,489,50,1,527,13,997,457,258,269
7,"BOTOŞANI","#N/A",35731,,49,"BOTOŞANI / Şcoala Generală nr. 11",1,3323,"MUNICIPIUL BOTOŞANI",35731,1263,734,702,32,0,708,26,1389,655,339,369
7,"BOTOŞANI","#N/A",35731,,50,"BOTOŞANI / Şcoala Generală nr. 11",1,3323,"MUNICIPIUL BOTOŞANI",35731,1006,586,541,45,0,577,9,1107,521,336,241
7,"BOTOŞANI","#N/A",35731,,51,"BOTOŞANI / Şcoala Generală nr. 2",1,3323,"MUNICIPIUL BOTOŞANI",35731,1150,597,562,34,1,584,13,1265,668,327,257
7,"BOTOŞANI","#N/A",35731,,52,"BOTOŞANI / Şcoala Generală nr. 2",1,3323,"MUNICIPIUL BOTOŞANI",35731,677,371,345,26,0,364,7,747,376,204,160
7,"BOTOŞANI","#N/A",35731,,53,"BOTOŞANI / Şcoala Generală nr. 2",1,3323,"MUNICIPIUL BOTOŞANI",35731,1276,629,617,12,0,620,9,1399,770,374,246
7,"BOTOŞANI","#N/A",35731,,54,"BOTOŞANI / Şcoala Generală nr. 2",1,3323,"MUNICIPIUL BOTOŞANI",35731,1318,610,593,17,0,598,12,1458,848,300,298
7,"BOTOŞANI","#N/A",35731,,55,"BOTOŞANI / Grupul Şcolar Economic şi Administrativ ""Octav Onicescu""",1,3323,"MUNICIPIUL BOTOŞANI",35731,1072,550,501,49,0,532,18,1179,629,300,232
7,"BOTOŞANI","#N/A",35731,,56,"BOTOŞANI / Grupul Şcolar Economic şi Administrativ ""Octav Onicescu""",1,3323,"MUNICIPIUL BOTOŞANI",35731,1063,621,586,35,0,614,7,1168,547,337,277
7,"BOTOŞANI","#N/A",35731,,57,"BOTOŞANI / Grădiniţa nr. 20",1,3323,"MUNICIPIUL BOTOŞANI",35731,1091,699,669,29,1,677,22,1197,498,305,372
7,"BOTOŞANI","#N/A",35731,,58,"BOTOŞANI / Şcoala Generală nr. 10",1,3323,"MUNICIPIUL BOTOŞANI",35731,1356,798,742,56,0,777,21,1492,694,412,365
7,"BOTOŞANI","#N/A",35731,,59,"BOTOŞANI / Şcoala Generală nr. 10",1,3323,"MUNICIPIUL BOTOŞANI",35731,1485,790,751,39,0,775,15,1647,857,418,357
7,"BOTOŞANI","#N/A",35731,,60,"BOTOŞANI / Şcoala Generală nr. 10",1,3323,"MUNICIPIUL BOTOŞANI",35731,1298,785,755,30,0,774,11,1428,643,377,397
7,"BOTOŞANI","#N/A",35731,,61,"BOTOŞANI / Colegiul Naţional ""A.T. Laurian""",1,3323,"MUNICIPIUL BOTOŞANI",35731,1399,883,781,53,49,863,20,1537,654,507,356
7,"BOTOŞANI","#N/A",35731,,62,"BOTOŞANI / Colegiul Naţional ""A.T. Laurian""",1,3323,"MUNICIPIUL BOTOŞANI",35731,1424,777,702,72,3,761,16,1571,794,379,382
7,"BOTOŞANI","#N/A",35731,,63,"BOTOŞANI / Local Clubul Pensionarilor",1,3323,"MUNICIPIUL BOTOŞANI",35731,1112,643,580,62,1,632,11,1220,577,334,298
7,"BOTOŞANI","#N/A",35731,,64,"BOTOŞANI / Şcoala Generală nr. 1",1,3323,"MUNICIPIUL BOTOŞANI",35731,1338,771,723,47,1,754,17,1474,703,389,365
7,"BOTOŞANI","#N/A",35731,,65,"BOTOŞANI / Şcoala Generală nr. 1",1,3323,"MUNICIPIUL BOTOŞANI",35731,1049,567,536,31,0,552,15,1157,590,288,264
7,"BOTOŞANI","#N/A",35731,,66,"BOTOŞANI / Şcoala Generală nr. 1",1,3323,"MUNICIPIUL BOTOŞANI",35731,1403,776,751,25,0,759,17,1542,766,412,347
7,"BOTOŞANI","#N/A",35731,,67,"BOTOŞANI / Grup Şcolar Economic şi Administrativ ,, Octav Onicescu""",1,3323,"MUNICIPIUL BOTOŞANI",35731,1501,877,851,26,0,862,15,1650,773,436,426
7,"BOTOŞANI","#N/A",35731,,68,"BOTOŞANI / Grupul Şcolar Industrial ""Construcţii de Maşini"" (Liceul Industrial nr. 1)",1,3323,"MUNICIPIUL BOTOŞANI",35731,1415,775,750,25,0,760,15,1563,788,427,333
7,"BOTOŞANI","#N/A",35731,,69,"BOTOŞANI / Grupul Şcolar Industrial ""Construcţii de Maşini"" (Liceul Industrial nr. 1)",1,3323,"MUNICIPIUL BOTOŞANI",35731,1327,748,718,27,3,730,18,1460,712,393,337
7,"BOTOŞANI","#N/A",35731,,70,"BOTOŞANI / Grupul Şcolar Industrial ""Construcţii de Maşini"" (Liceul Industrial nr. 1)",1,3323,"MUNICIPIUL BOTOŞANI",35731,1185,659,633,26,0,648,11,1304,645,359,289
7,"BOTOŞANI","#N/A",35731,,71,"BOTOŞANI / Şcoala Generală nr. 6",1,3323,"MUNICIPIUL BOTOŞANI",35731,1063,580,534,46,0,568,12,1172,592,314,254
7,"BOTOŞANI","#N/A",35731,,72,"BOTOŞANI / Şcoala Generală nr. 6",1,3323,"MUNICIPIUL BOTOŞANI",35731,883,489,450,39,0,481,8,970,481,250,231
7,"BOTOŞANI","#N/A",35731,,73,"BOTOŞANI / Şcoala Generală nr. 6",1,3323,"MUNICIPIUL BOTOŞANI",35731,1251,666,646,19,1,650,16,1378,712,434,216
7,"BOTOŞANI","#N/A",35731,,74,"BOTOŞANI / Şcoala Generală nr. 6",1,3323,"MUNICIPIUL BOTOŞANI",35731,1149,616,598,18,0,605,10,1266,650,378,227
7,"BOTOŞANI","#N/A",35731,,75,"BOTOŞANI / Şcoala Generală nr. 6",1,3323,"MUNICIPIUL BOTOŞANI",35731,855,446,423,23,0,441,5,938,492,249,192
7,"BOTOŞANI","#N/A",35731,,76,"BOTOŞANI / Şcoala Generală nr.11",1,3323,"MUNICIPIUL BOTOŞANI",35731,648,414,357,56,1,403,11,713,299,192,211
7,"BOTOŞANI","#N/A",35731,,77,"BOTOŞANI / Şcoala Generală nr. 3",1,3323,"MUNICIPIUL BOTOŞANI",35731,1493,736,706,30,0,716,20,1649,913,437,279
7,"BOTOŞANI","#N/A",35731,,78,"BOTOŞANI / Grădiniţa de Copii nr. 8",1,3323,"MUNICIPIUL BOTOŞANI",35731,1534,839,812,27,0,818,21,1690,851,440,378
7,"BOTOŞANI","#N/A",35731,,79,"BOTOŞANI / Şcoala Generală nr. 9",1,3323,"MUNICIPIUL BOTOŞANI",35731,883,532,509,21,2,526,6,974,442,274,252
7,"BOTOŞANI","#N/A",35731,,80,"BOTOŞANI / Grupul Şcolar Agricol (Liceul Agroindustrial)",1,3323,"MUNICIPIUL BOTOŞANI",35731,1132,920,571,32,317,902,18,1265,345,611,291
7,"BOTOŞANI","#N/A",35731,,81,"BOTOŞANI / Grupul Şcolar Agricol (Liceul Agroindustrial)",1,3323,"MUNICIPIUL BOTOŞANI",35731,1500,776,750,26,0,759,17,1658,882,439,320
7,"BOTOŞANI","#N/A",35731,,82,"BOTOŞANI / Liceul Pedagogic ""Nicolae Iorga""",1,3323,"MUNICIPIUL BOTOŞANI",35731,1211,758,644,35,79,740,18,1355,597,418,322
7,"BOTOŞANI","#N/A",35731,,83,"BOTOŞANI / Liceul Pedagogic ""Nicolae Iorga""",1,3323,"MUNICIPIUL BOTOŞANI",35731,1429,1031,711,33,287,1007,24,1595,564,695,312
7,"BOTOŞANI","#N/A",35731,,84,"BOTOŞANI / Liceul Pedagogic ""Nicolae Iorga""",1,3323,"MUNICIPIUL BOTOŞANI",35731,1132,909,601,16,292,899,10,1275,366,570,329
7,"BOTOŞANI","#N/A",35731,,85,"BOTOŞANI / Liceul de artă Ştefan Luchian",1,3323,"MUNICIPIUL BOTOŞANI",35731,1382,865,827,37,1,848,17,1518,653,513,335
7,"BOTOŞANI","#N/A",36006,,86,"DOROHOI / COLEGIUL NATIONAL ""GRIGORE GHICA"" DOROHOI",1,3325,"MUNICIPIUL DOROHOI",36006,1445,801,752,47,2,792,9,1594,793,521,271
7,"BOTOŞANI","#N/A",36006,,87,"DOROHOI / CLADIREA STĂRII CIVILE DOROHOI",1,3325,"MUNICIPIUL DOROHOI",36006,1225,668,613,53,2,657,11,1349,681,450,207
7,"BOTOŞANI","#N/A",36006,,88,"DOROHOI / BIBLIOTECA MUNICIPALĂ DOROHOI",1,3325,"MUNICIPIUL DOROHOI",36006,1627,948,922,25,1,933,15,1791,843,634,299
7,"BOTOŞANI","#N/A",36006,,89,"DOROHOI / ŞCOALA GIMNAZIALĂ ,,SPIRU HARET""  DOROHOI",1,3325,"MUNICIPIUL DOROHOI",36006,1487,829,778,51,0,815,14,1645,816,548,267
7,"BOTOŞANI","#N/A",36006,,90,"DOROHOI / GRĂDINIŢA CU PROGRAM NORMAL NR.4 DOROHOI",1,3325,"MUNICIPIUL DOROHOI",36006,1012,557,534,21,2,545,12,1112,555,378,167
7,"BOTOŞANI","#N/A",36006,,91,"DOROHOI / ŞCOALA GIMNAZIALĂ NR.1 DOROHOI",1,3325,"MUNICIPIUL DOROHOI",36006,1270,771,700,71,0,760,11,1403,632,458,302
7,"BOTOŞANI","#N/A",36006,,92,"DOROHOI / CASA MUNICIPALĂ DE CULTURĂ DOROHOI",1,3325,"MUNICIPIUL DOROHOI",36006,1205,705,636,34,35,686,19,1327,622,398,288
7,"BOTOŞANI","#N/A",36006,,93,"DOROHOI / ŞCOALA GIMNAZIALĂ ,,ŞTEFAN CEL MARE"" DOROHOI",1,3325,"MUNICIPIUL DOROHOI",36006,1128,625,597,25,3,618,7,1243,618,420,198
7,"BOTOŞANI","#N/A",36006,,94,"DOROHOI / ŞCOALA GIMNAZIALĂ ,, ŞTEFAN CEL MARE"" DOROHOI",1,3325,"MUNICIPIUL DOROHOI",36006,1065,581,555,26,0,576,5,1174,593,382,194
7,"BOTOŞANI","#N/A",36006,,95,"DOROHOI / ŞCOALA GIMNAZIALĂ ,,ALEXANDRU IOAN CUZA"" DOROHOI",1,3325,"MUNICIPIUL DOROHOI",36006,1154,526,501,24,1,524,2,1275,749,353,171
7,"BOTOŞANI","#N/A",36006,,96,"DOROHOI / ŞCOALA GIMNAZIALĂ ,,ALEXANDRU IOAN CUZA"" DOROHOI",1,3325,"MUNICIPIUL DOROHOI",36006,1360,641,609,32,0,630,11,1497,856,410,220
7,"BOTOŞANI","#N/A",36006,,97,"DOROHOI / LICEUL  ,,REGINA MARIA"" DOROHOI",1,3325,"MUNICIPIUL DOROHOI",36006,1250,644,624,20,0,632,12,1378,734,436,196
7,"BOTOŞANI","#N/A",36006,,98,"DOROHOI / LICEUL  ,,REGINA MARIA"" DOROHOI",1,3325,"MUNICIPIUL DOROHOI",36006,1302,642,611,31,0,632,10,1437,795,438,194
7,"BOTOŞANI","#N/A",36006,,99,"DOROHOI / ŞCOALA GIMNAZIALĂ ,,MIHAIL KOGĂLNICEANU"" DOROHOI",1,3325,"MUNICIPIUL DOROHOI",36006,1366,673,657,16,0,665,8,1506,833,440,225
7,"BOTOŞANI","#N/A",36006,,100,"DOROHOI / ŞCOALA GIMNAZIALĂ ,,MIHAIL KOGĂLNICEANU"" DOROHOI",1,3325,"MUNICIPIUL DOROHOI",36006,1262,600,564,36,0,593,7,1393,793,431,162
7,"BOTOŞANI","#N/A",36006,,101,"DOROHOI / GRĂDINIŢA CU PROGRAM PRELUNGIT ,, ALBA CA ZĂPADA"" DOROHOI",1,3325,"MUNICIPIUL DOROHOI",36006,1114,570,537,33,0,564,6,1230,660,397,167
7,"BOTOŞANI","#N/A",36006,,102,"DOROHOI / GRĂDINIŢA CU PROGRAM PRELUNGIT,,ALBA CA ZĂPADA"" DOROHOI",1,3325,"MUNICIPIUL DOROHOI",36006,1504,800,776,23,1,790,10,1657,857,554,236
7,"BOTOŞANI","#N/A",36006,,103,"DOROHOI / SALA POLIVALENTĂ  DOROHOI",1,3325,"MUNICIPIUL DOROHOI",36006,821,528,432,31,65,516,12,928,400,378,138
7,"BOTOŞANI","#N/A",36006,,104,"DOROHOI / ŞCOALA GIMNAZIALĂ ,, DIMITRIE ROMANESCU"" DOROHOI",1,3325,"MUNICIPIUL DOROHOI",36006,1047,573,554,19,0,568,5,1154,581,391,177
7,"BOTOŞANI","#N/A",36006,,105,"DOROHOI / ŞCOALA GIMNAZIALĂ ,,DIMITRIE ROMANESCU"" DOROHOI",1,3325,"MUNICIPIUL DOROHOI",36006,1105,592,567,25,0,578,14,1214,622,419,159
7,"BOTOŞANI","#N/A",36006,,106,"DOROHOI / GRĂDINIŢA CU PROGRAM NORMAL NR.12 DOROHOI",1,3325,"MUNICIPIUL DOROHOI",36006,758,387,367,20,0,386,1,834,447,283,103
7,"BOTOŞANI","#N/A",36006,,107,"LOTURI ENESCU / GRĂDINIŢA CU PROGRAM NORMAL NR.1 LOTURI ENESCU",1,3325,"MUNICIPIUL DOROHOI",36006,330,201,193,8,0,200,1,362,161,130,70
7,"BOTOŞANI","#N/A",36453,,108,"BUCECEA / Scoala Nr,1 Bucecea",1,3330,"ORAŞ BUCECEA",36453,707,387,331,41,15,383,4,777,390,208,175
7,"BOTOŞANI","#N/A",36453,,109,"BUCECEA / Centrul Cultural Bucecea",1,3330,"ORAŞ BUCECEA",36453,1633,833,790,39,4,821,12,1780,947,521,300
7,"BOTOŞANI","#N/A",36453,,110,"BUCECEA / Scoala Nr,2 Bucecea",1,3330,"ORAŞ BUCECEA",36453,1452,786,744,33,9,773,13,1608,822,555,218
7,"BOTOŞANI","#N/A",36453,,111,"CĂLINEŞTI / Scoala Calinesti",1,3330,"ORAŞ BUCECEA",36453,532,300,266,32,2,298,2,584,284,219,79
7,"BOTOŞANI","#N/A",35946,,112,"DARABANI / Liceul,,Dimitrie Cantemir",1,3334,"ORAŞ DARABANI",35946,1274,683,645,29,9,674,9,1401,718,388,286
7,"BOTOŞANI","#N/A",35946,,113,"DARABANI / Şcoala Gimnazială,,Leon Dănăilă""",1,3334,"ORAŞ DARABANI",35946,1535,776,742,34,0,761,15,1694,918,509,252
7,"BOTOŞANI","#N/A",35946,,114,"DARABANI / Şcoala Gimnazială ,,Leon Dănăilă""",1,3334,"ORAŞ DARABANI",35946,1488,716,692,24,0,704,12,1629,913,437,267
7,"BOTOŞANI","#N/A",35946,,115,"DARABANI / Grădiniţa nr.2",1,3334,"ORAŞ DARABANI",35946,1503,741,697,43,1,731,10,1650,909,449,282
7,"BOTOŞANI","#N/A",35946,,116,"DARABANI / Şcoala Corneşti",1,3334,"ORAŞ DARABANI",35946,1009,529,508,17,4,521,8,1109,580,324,197
7,"BOTOŞANI","#N/A",35946,,117,"BAJURA / Şcoalal Bajura",1,3334,"ORAŞ DARABANI",35946,1470,727,704,23,0,712,15,1619,892,425,287
7,"BOTOŞANI","#N/A",35946,,118,"DARABANI / Şcoala Teioasa",1,3334,"ORAŞ DARABANI",35946,1149,620,585,31,4,614,6,1261,641,464,150
7,"BOTOŞANI","#N/A",35946,,119,"LISMĂNIŢA / Şcoala Lişmăniţa",1,3334,"ORAŞ DARABANI",35946,542,323,309,14,0,321,2,597,274,236,85
7,"BOTOŞANI","#N/A",35946,,120,"EŞANCA / Şcoala Eşanca",1,3334,"ORAŞ DARABANI",35946,283,149,133,15,1,149,0,312,163,103,46
7,"BOTOŞANI","#N/A",37280,,121,"FLAMÂNZI / SC.GIMNAZIALA ""MIHAIL STURZA""",1,3339,"ORAŞ FLĂMÂNZI",37280,635,308,287,21,0,306,2,703,395,186,120
7,"BOTOŞANI","#N/A",37280,,122,"FLAMÂNZI / SC.GIMNAZIALA ""MIHAIL STURZA""",1,3339,"ORAŞ FLĂMÂNZI",37280,823,382,372,10,0,377,5,903,521,201,176
7,"BOTOŞANI","#N/A",37280,,123,"FLAMÂNZI / SC.GIMNAZIALA ""ION BOJOI""",1,3339,"ORAŞ FLĂMÂNZI",37280,1104,586,557,29,0,573,13,1218,632,337,236
7,"BOTOŞANI","#N/A",37280,,124,"FLAMÂNZI / CASA DE CULTURA ""NICOLAE SEVEREANU""",1,3339,"ORAŞ FLĂMÂNZI",37280,1124,518,465,53,0,513,5,1241,723,246,267
7,"BOTOŞANI","#N/A",37280,,125,"POIANA / SC.GIMNAZIALA ""CONSTANTIN COMICESCU""",1,3339,"ORAŞ FLĂMÂNZI",37280,1446,728,693,28,7,723,5,1588,860,392,331
7,"BOTOŞANI","#N/A",37280,,126,"NICOLAE BĂLCESCU / GRADINITA NR.1 N.BALCESCU",1,3339,"ORAŞ FLĂMÂNZI",37280,1020,572,506,43,23,568,4,1123,551,229,339
7,"BOTOŞANI","#N/A",37280,,127,"NICOLAE BĂLCESCU / LICEUL TEHNOLOGIC N.BALCESCU",1,3339,"ORAŞ FLĂMÂNZI",37280,1176,662,627,28,7,654,8,1287,625,332,322
7,"BOTOŞANI","#N/A",37280,,128,"NICOLAE BĂLCESCU / ŞCOALA TAMBA",1,3339,"ORAŞ FLĂMÂNZI",37280,1001,601,560,32,9,595,6,1103,502,236,359
7,"BOTOŞANI","#N/A",37280,,129,"CHIŢOVENI / SC.PRIMARA ""GHEORGHE PRICOP""",1,3339,"ORAŞ FLĂMÂNZI",37280,449,278,261,15,2,276,2,494,216,155,121
7,"BOTOŞANI","#N/A",37280,,130,"PRISĂCANI / SC.GIMNAZIALA ""PETRU ZAMFIRESCU""",1,3339,"ORAŞ FLĂMÂNZI",37280,521,280,270,10,0,276,4,574,294,159,117
7,"BOTOŞANI","#N/A",36060,,131,"SĂVENI / Liceul Teoretic Dr. M. Ciuca Saveni",1,3345,"ORAŞ SĂVENI",36060,1194,695,599,52,44,685,10,1316,621,514,171
7,"BOTOŞANI","#N/A",36060,,132,"SĂVENI / Liceul Teoretic Dr. M.Ciuca Saveni",1,3345,"ORAŞ SĂVENI",36060,890,502,444,30,28,499,3,980,478,360,139
7,"BOTOŞANI","#N/A",36060,,133,"SĂVENI / Scoala generala nr. 1 Saveni",1,3345,"ORAŞ SĂVENI",36060,1509,827,779,39,9,817,10,1667,840,586,231
7,"BOTOŞANI","#N/A",36060,,134,"SĂVENI / Scoala Generala nr. 2 Saveni",1,3345,"ORAŞ SĂVENI",36060,1385,779,724,33,22,774,5,1530,751,592,182
7,"BOTOŞANI","#N/A",36060,,135,"PETRICANI / Scoala Generala Petricani",1,3345,"ORAŞ SĂVENI",36060,1074,617,559,44,14,612,5,1181,564,443,169
7,"BOTOŞANI","#N/A",36060,,136,"BODEASA / Scoala Generala Bodeasa",1,3345,"ORAŞ SĂVENI",36060,334,201,186,10,5,198,3,367,166,180,18
7,"BOTOŞANI","#N/A",36060,,137,"BOZIENI / Scoala Generala Bozieni",1,3345,"ORAŞ SĂVENI",36060,214,136,116,16,4,135,1,235,99,121,14
7,"BOTOŞANI","#N/A",39168,,138,"BOBULEŞTI / Scoala gimnaziala Bobulesti",1,3352,"ORAŞ ŞTEFĂNEŞTI",39168,1048,632,578,48,6,622,10,1156,524,426,196
7,"BOTOŞANI","#N/A",39168,,139,"BĂDIUŢI / Scoala primara Badiuti",1,3352,"ORAŞ ŞTEFĂNEŞTI",39168,775,444,417,27,0,432,12,847,403,284,148
7,"BOTOŞANI","#N/A",39168,,140,"ŞTEFĂNEŞTI / Liceul teoretic ""Stefan D. Luchian""",1,3352,"ORAŞ ŞTEFĂNEŞTI",39168,985,557,494,39,24,552,5,1085,528,351,201
7,"BOTOŞANI","#N/A",39168,,141,"ŞTEFĂNEŞTI / Liceul teoretic ""Stefan D. Luchian""",1,3352,"ORAŞ ŞTEFĂNEŞTI",39168,966,530,476,51,3,521,9,1063,533,330,191
7,"BOTOŞANI","#N/A",39168,,142,"STÂNCA / Scoala primara Stanca",1,3352,"ORAŞ ŞTEFĂNEŞTI",39168,751,475,382,81,12,472,3,827,352,249,223
7,"BOTOŞANI","#N/A",40035,,143,"ADĂŞENI / SCOALA GIMNAZIALA nr.1 ADASENI",3,3358,"ADĂŞENI",40035,822,428,375,26,27,420,8,907,479,273,147
7,"BOTOŞANI","#N/A",40035,,144,"ZOIŢANI / SCOALA ZOITANI",3,3358,"ADĂŞENI",40035,311,180,158,22,0,177,3,343,163,109,68
7,"BOTOŞANI","#N/A",36131,,145,"ALBEŞTI / Camin cultural Albesti",3,3361,"ALBEŞTI",36131,981,522,481,40,1,513,9,1089,567,322,191
7,"BOTOŞANI","#N/A",36131,,146,"ALBEŞTI / Scoala cu cl.I-IV nr.2",3,3361,"ALBEŞTI",36131,636,385,352,33,0,381,4,699,314,214,167
7,"BOTOŞANI","#N/A",36131,,147,"BUIMĂCENI / Scoala cu cl.I-IV",3,3361,"ALBEŞTI",36131,597,338,309,29,0,329,9,657,319,192,137
7,"BOTOŞANI","#N/A",36131,,148,"COŞTIUGENI / Scoala cu cl.I-IV",3,3361,"ALBEŞTI",36131,482,243,213,30,0,238,5,530,287,154,84
7,"BOTOŞANI","#N/A",36131,,149,"JIJIA / Scoala cu cl.I-IV",3,3361,"ALBEŞTI",36131,491,276,247,29,0,276,0,543,267,191,85
7,"BOTOŞANI","#N/A",36131,,150,"MĂŞCĂTENI / Scoala cu cl.I-IV",3,3361,"ALBEŞTI",36131,306,165,148,17,0,162,3,336,171,97,65
7,"BOTOŞANI","#N/A",36131,,151,"TUDOR VLADIMIRESCU / Scoala cu cl.I-VIII",3,3361,"ALBEŞTI",36131,659,341,320,21,0,336,5,723,382,191,145
7,"BOTOŞANI","#N/A",36131,,152,"TUDOR VLADIMIRESCU / Scoala cu cl.I-VIII",3,3361,"ALBEŞTI",36131,666,335,316,19,0,333,2,733,398,174,159
7,"BOTOŞANI","#N/A",36202,,153,"AVRĂMENI / SCOALA CU CLASELE 1 -8 AVRAMENI",3,3368,"AVRĂMENI",36202,1133,611,575,36,0,606,5,1250,639,462,144
7,"BOTOŞANI","#N/A",36202,,154,"PANAITOAIA / SCOALA CU CLASELE 1-8 PANAITOAIA",3,3368,"AVRĂMENI",36202,555,356,320,36,0,351,5,612,256,257,94
7,"BOTOŞANI","#N/A",36202,,155,"TUDOR VLADIMIRESCU / SCOALA CU CLASELE 1-8 TUDOR VLADIMIRESCU",3,3368,"AVRĂMENI",36202,602,363,336,27,0,359,4,663,300,270,89
7,"BOTOŞANI","#N/A",36202,,156,"AUREL VLAICU / SCOALA CU CLASELE 1-8 AUREL VLAICU",3,3368,"AVRĂMENI",36202,479,269,255,14,0,266,3,530,261,196,70
7,"BOTOŞANI","#N/A",36202,,157,"ICHIMENI / SCOALA CU CLASELE 1-4 ICHIMENI",3,3368,"AVRĂMENI",36202,121,68,53,15,0,68,0,133,65,52,16
7,"BOTOŞANI","#N/A",36300,,158,"BĂLUŞENI / SCOALA BALUSENI",3,3376,"BĂLUŞENI",36300,1186,671,586,53,32,666,5,1305,634,494,172
7,"BOTOŞANI","#N/A",36300,,159,"BĂLUŞENII NOI / SCOALA BALUSENII NOI",3,3376,"BĂLUŞENI",36300,242,140,126,14,0,140,0,266,126,97,43
7,"BOTOŞANI","#N/A",36300,,160,"BUZENI / SCOALA BUZENI",3,3376,"BĂLUŞENI",36300,563,303,280,21,2,297,6,618,315,224,73
7,"BOTOŞANI","#N/A",36300,,161,"DRAXINI / SCOALA DRAXINI",3,3376,"BĂLUŞENI",36300,1516,863,789,47,27,856,7,1668,805,624,232
7,"BOTOŞANI","#N/A",36300,,162,"ZĂICEŞTI / SCOALA ZAICESTI",3,3376,"BĂLUŞENI",36300,560,330,299,31,0,322,8,615,285,192,130
7,"BOTOŞANI","#N/A",39983,,163,"BLÂNDEŞTI / SCOALA GIMNAZIALA NR. 1",3,3383,"BLÂNDEŞTI",39983,637,366,328,37,1,363,3,700,334,275,88
7,"BOTOŞANI","#N/A",39983,,164,"CERCHEJENI / GRADINITA CU PROGRAM NORMAL NR. 2",3,3383,"BLÂNDEŞTI",39983,678,382,345,31,6,378,4,750,368,255,123
7,"BOTOŞANI","#N/A",39983,,165,"ŞOLDĂNEŞTI / SCOLA PRIMARA NR. 3",3,3383,"BLÂNDEŞTI",39983,350,250,226,24,0,245,5,385,135,168,77
7,"BOTOŞANI","#N/A",36373,,166,"BRĂEŞTI / CĂMIN CULTURAL BRĂEŞTI",3,3387,"BRĂEŞTI",36373,1142,664,576,82,6,658,6,1258,594,389,269
7,"BOTOŞANI","#N/A",36373,,167,"POIANA / SCOALA POIANA 2",3,3387,"BRĂEŞTI",36373,348,224,196,24,4,223,1,384,160,154,69
7,"BOTOŞANI","#N/A",36373,,168,"POPENI / ŞCOALA POPENI",3,3387,"BRĂEŞTI",36373,211,144,128,16,0,143,1,232,88,103,40
7,"BOTOŞANI","#N/A",36426,,169,"BROSCĂUŢI / SCOALA DIMITRIE POMPEIU BROSCAUTI",3,3392,"BROSCĂUŢI",36426,1496,857,791,66,0,851,6,1652,795,637,214
7,"BOTOŞANI","#N/A",36426,,170,"BROSCĂUŢI / GRADINITA BROSCAUTI",3,3392,"BROSCĂUŢI",36426,1348,742,703,39,0,735,7,1482,740,538,197
7,"BOTOŞANI","#N/A",36499,,171,"CĂLĂRAŞI / CAMIN CULTURAL CALARASI",3,3395,"CĂLĂRAŞI",36499,960,595,547,48,0,590,5,1055,460,276,314
7,"BOTOŞANI","#N/A",36499,,172,"CĂLĂRAŞI / SCOALA CALARASI",3,3395,"CĂLĂRAŞI",36499,943,588,547,41,0,580,8,1037,449,275,305
7,"BOTOŞANI","#N/A",36499,,173,"PLEŞANI / SCOALA PLESANI",3,3395,"CĂLĂRAŞI",36499,496,337,304,33,0,336,1,543,206,133,203
7,"BOTOŞANI","#N/A",36499,,174,"LIBERTATEA / SCOALA LIBERTATEA",3,3395,"CĂLĂRAŞI",36499,391,279,256,23,0,276,3,431,152,146,130
7,"BOTOŞANI","#N/A",39967,,175,"CÂNDEŞTI / SCOALA GIMNAZIALĂ CÂNDEŞTI",3,3399,"CÂNDEŞTI",39967,867,530,442,88,0,521,9,955,425,309,212
7,"BOTOŞANI","#N/A",39967,,176,"TALPA / ŞCOALA PRIMARĂ TALPA",3,3399,"CÂNDEŞTI",39967,550,312,287,25,0,308,4,605,293,238,70
7,"BOTOŞANI","#N/A",39967,,177,"VIŢCANI / ŞCOLA PRIMARĂ VIŢCANI",3,3399,"CÂNDEŞTI",39967,273,188,162,26,0,187,1,298,110,95,92
7,"BOTOŞANI","#N/A",36532,,178,"CONCEŞTI / CĂMINUL CULTURAL",3,3404,"CONCEŞTI",36532,1264,792,701,42,49,782,10,1400,608,616,166
7,"BOTOŞANI","#N/A",36532,,179,"MOVILENI / CAMIN CULTURAL",3,3404,"CONCEŞTI",36532,266,200,166,18,16,200,0,293,93,174,26
7,"BOTOŞANI","#N/A",36569,,180,"COPĂLĂU / ŞC. 1 COPALAU",3,3407,"COPĂLĂU",36569,1111,711,641,63,7,700,11,1217,506,370,330
7,"BOTOŞANI","#N/A",36569,,181,"COPĂLĂU / ŞC. 1 COPALAU",3,3407,"COPĂLĂU",36569,1105,617,590,22,5,601,16,1217,600,303,298
7,"BOTOŞANI","#N/A",36569,,182,"COTU / ŞC. 2 COTU",3,3407,"COPĂLĂU",36569,508,348,298,46,4,344,4,559,211,223,121
7,"BOTOŞANI","#N/A",36569,,183,"CERBU / ŞC. 3 CERBU",3,3407,"COPĂLĂU",36569,620,356,336,20,0,353,3,681,325,222,131
7,"BOTOŞANI","#N/A",36649,,184,"CORDĂRENI / CAMINUL CULTURAL CORDARENI",3,3411,"CORDĂRENI",36649,811,488,452,36,0,478,10,901,413,302,176
7,"BOTOŞANI","#N/A",36649,,185,"GRIVIŢA / SCOALA GRIVITA",3,3411,"CORDĂRENI",36649,392,263,235,28,0,260,3,432,169,160,100
7,"BOTOŞANI","#N/A",36649,,186,"SLOBOZIA / SCOALA SLOBOZIA",3,3411,"CORDĂRENI",36649,300,219,190,29,0,218,1,332,113,144,74
7,"BOTOŞANI","#N/A",36676,,187,"CORLĂTENI / PRIMARIA CORLATENI",3,3415,"CORLĂTENI",36676,537,354,302,52,0,350,4,594,240,206,144
7,"BOTOŞANI","#N/A",36676,,188,"CARASA / GRADINITA CARASA",3,3415,"CORLĂTENI",36676,479,290,248,42,0,286,4,528,238,225,61
7,"BOTOŞANI","#N/A",36676,,189,"VLĂDENI / SCOALA VLADENI",3,3415,"CORLĂTENI",36676,385,224,193,31,0,222,2,427,203,145,77
7,"BOTOŞANI","#N/A",36676,,190,"PODENI / SCOALA PODENI",3,3415,"CORLĂTENI",36676,365,220,199,21,0,218,2,400,180,115,103
7,"BOTOŞANI","#N/A",36756,,191,"CORNI / SCOALA O. BANCILA",3,3420,"CORNI",36756,1317,664,630,34,0,659,5,1445,781,478,181
7,"BOTOŞANI","#N/A",36756,,192,"CORNI / SCOALA O. BANCILA",3,3420,"CORNI",36756,881,470,452,18,0,465,5,977,507,316,149
7,"BOTOŞANI","#N/A",36756,,193,"CORNI / SCOALA O. BANCILA",3,3420,"CORNI",36756,1043,569,539,30,0,560,9,1146,577,407,153
7,"BOTOŞANI","#N/A",36756,,194,"SARAFINEŞTI / SCOALA CU CL I-VIII SARAFINESTI",3,3420,"CORNI",36756,1199,598,576,22,0,588,10,1323,725,422,166
7,"BOTOŞANI","#N/A",36756,,195,"MESTEACĂN / SCOALA CU CL I-IV MESTEACAN",3,3420,"CORNI",36756,323,183,172,11,0,179,4,356,173,100,79
7,"BOTOŞANI","#N/A",36756,,196,"BALTA ARSĂ / SCOALA CU CL I-IV BALTA ARSA",3,3420,"CORNI",36756,332,206,181,25,0,204,2,365,159,179,25
7,"BOTOŞANI","#N/A",39975,,197,"COŞULA / Grădiniţa *Prichindel* Coşula",3,3425,"COŞULA",39975,932,513,470,42,1,508,5,1030,517,384,124
7,"BOTOŞANI","#N/A",39975,,198,"BUDA / Şcoala cu clasele I-IV Buda",3,3425,"COŞULA",39975,221,136,115,20,1,133,3,243,107,102,31
7,"BOTOŞANI","#N/A",39975,,199,"PĂDURENI / Şcoala cu Clasele I-IV Pădureni",3,3425,"COŞULA",39975,469,270,255,14,1,265,5,514,244,165,100
7,"BOTOŞANI","#N/A",39975,,200,"ŞUPITCA / Şcoala cu Clasele I-IV Şupitca",3,3425,"COŞULA",39975,658,374,346,28,0,368,6,776,402,266,102
7,"BOTOŞANI","#N/A",36809,,201,"COŢUŞCA / Sc. Generala",3,3430,"COŢUŞCA",36809,1399,734,692,42,0,724,10,1512,778,462,262
7,"BOTOŞANI","#N/A",36809,,202,"GHIRENI / Sc. Generala",3,3430,"COŢUŞCA",36809,526,318,299,19,0,316,2,580,262,204,112
7,"BOTOŞANI","#N/A",36809,,203,"COTU MICULINŢI / Sc. Generala",3,3430,"COŢUŞCA",36809,344,216,187,29,0,215,1,377,161,159,56
7,"BOTOŞANI","#N/A",36809,,204,"CRASNALEUCA / Sc. Generala",3,3430,"COŢUŞCA",36809,510,307,285,22,0,306,1,564,257,207,99
7,"BOTOŞANI","#N/A",36809,,205,"PUŢURENI / Sc. Generala",3,3430,"COŢUŞCA",36809,478,247,229,18,0,245,2,528,281,166,79
7,"BOTOŞANI","#N/A",36809,,206,"NICHITENI / Sc. Generala",3,3430,"COŢUŞCA",36809,700,448,416,32,0,445,3,774,326,207,238
7,"BOTOŞANI","#N/A",36907,,207,"CRISTEŞTI / Scoala Gimnaziala nr. 1 Sat  Crisetsti , fost sediu al Primariei Cristesti",3,3440,"CRISTEŞTI",36907,1387,673,621,47,5,668,5,1533,860,442,226
7,"BOTOŞANI","#N/A",36907,,208,"CRISTEŞTI / Scoala Primara nr. 1 Sat Cristesti  , denumire uzuala scoala din Ghilanesti",3,3440,"CRISTEŞTI",36907,603,347,318,29,0,344,3,655,308,242,102
7,"BOTOŞANI","#N/A",36907,,209,"ONEAGA / Scoala Gimnaziala nr. 2 Sat  Oneaga",3,3440,"CRISTEŞTI",36907,1187,611,578,29,4,596,15,1307,696,432,164
7,"BOTOŞANI","#N/A",36907,,210,"SCHIT-ORĂŞENI / Scoala Primara nr. 3 Sat Schit - Oraseni",3,3440,"CRISTEŞTI",36907,459,256,228,28,0,253,3,505,249,135,118
7,"BOTOŞANI","#N/A",36952,,211,"CRISTINEŞTI / CAMINUL CULTURAL CRISTINESTI",3,3445,"CRISTINEŞTI",36952,1248,744,676,68,0,735,9,1377,633,424,311
7,"BOTOŞANI","#N/A",36952,,212,"DRAGALINA / SCOALA DRAGALINA",3,3445,"CRISTINEŞTI",36952,505,386,297,89,0,381,5,554,168,218,163
7,"BOTOŞANI","#N/A",36952,,213,"FUNDU HERŢII / SCOALA FUNDU HERTII",3,3445,"CRISTINEŞTI",36952,601,444,393,51,0,441,3,663,219,307,134
7,"BOTOŞANI","#N/A",36952,,214,"BARANCA / SCOALA BARANCA",3,3445,"CRISTINEŞTI",36952,492,318,293,25,0,312,6,542,224,200,112
7,"BOTOŞANI","#N/A",35759,,215,"CURTEŞTI / GRADINITA CURTESTI",3,3452,"CURTEŞTI",35759,834,460,415,45,0,449,11,908,448,235,214
7,"BOTOŞANI","#N/A",35759,,216,"AGAFTON / SPATIU SCOALA AGAFTON",3,3452,"CURTEŞTI",35759,209,159,129,30,0,156,3,228,69,123,33
7,"BOTOŞANI","#N/A",35759,,217,"BĂICENI / SCOALA GEN.BAICENI",3,3452,"CURTEŞTI",35759,744,362,326,36,0,357,5,817,455,262,95
7,"BOTOŞANI","#N/A",35759,,218,"MĂNĂSTIREA DOAMNEI / SCOALA GEN. MANASTIREA DOAMNEI",3,3452,"CURTEŞTI",35759,839,466,438,28,0,461,5,919,453,289,172
7,"BOTOŞANI","#N/A",35759,,219,"ORĂŞENI-DEAL / SCOALA GEN.ORASENI DEAL",3,3452,"CURTEŞTI",35759,931,532,480,51,1,523,9,1021,489,338,185
7,"BOTOŞANI","#N/A",35759,,220,"ORĂŞENI-VALE / SCOALA GEN.ORASENI VALE",3,3452,"CURTEŞTI",35759,585,272,242,30,0,269,3,647,375,162,107
7,"BOTOŞANI","#N/A",37011,,221,"DERSCA / CAMIN CULTURAL",3,3460,"DERSCA",37011,1385,765,681,56,28,751,14,1527,762,474,277
7,"BOTOŞANI","#N/A",37011,,222,"DERSCA / SCOALA GENERALĂ DERSCA",3,3460,"DERSCA",37011,1161,611,570,37,4,604,7,1283,672,363,241
7,"BOTOŞANI","#N/A",39959,,223,"MATEIENI / CAMIN CULTURAL",3,3462,"DIMĂCHENI",39959,216,167,138,21,8,167,0,237,70,134,33
7,"BOTOŞANI","#N/A",39959,,224,"DIMĂCHENI / PRIMARIA",3,3462,"DIMĂCHENI",39959,877,588,516,43,29,582,6,963,375,506,76
7,"BOTOŞANI","#N/A",37057,,225,"DÎNGENI / Scoala Gimnaziala nr.1 Dingeni",3,3466,"DÎNGENI",37057,1048,672,611,49,12,661,11,1155,483,337,324
7,"BOTOŞANI","#N/A",37057,,226,"HULUB / Scoala Primara nr.1 Hulub",3,3466,"DÎNGENI",37057,462,338,301,28,9,337,1,510,172,173,164
7,"BOTOŞANI","#N/A",37057,,227,"IACOBENI / Scoala Gimnaziala  nr.2 Iacobeni",3,3466,"DÎNGENI",37057,829,577,531,37,9,563,14,916,339,273,290
7,"BOTOŞANI","#N/A",37100,,228,"DOBÂRCENI / ŞCOALA DOBIRCENI",3,3471,"DOBÂRCENI",37100,694,453,423,30,0,447,6,761,308,237,210
7,"BOTOŞANI","#N/A",37100,,229,"BIVOLARI / SCOALA BIVOLARI",3,3471,"DOBÂRCENI",37100,147,105,90,15,0,103,2,161,56,48,55
7,"BOTOŞANI","#N/A",37100,,230,"BRĂTENI / ŞCOALA  BRATENI",3,3471,"DOBÂRCENI",37100,551,300,279,21,0,298,2,607,307,120,178
7,"BOTOŞANI","#N/A",37100,,231,"CIŞMĂNEŞTI / SCOALA CISMANESTI",3,3471,"DOBÂRCENI",37100,323,228,210,18,0,225,3,358,130,164,61
7,"BOTOŞANI","#N/A",37100,,232,"LIVADA / SCOALA MURGUTA",3,3471,"DOBÂRCENI",37100,362,252,238,14,0,247,5,398,146,82,165
7,"BOTOŞANI","#N/A",37173,,233,"DRĂGUŞENI / SCOALA CU CLAS.I-VIII DRAGUSENI",3,3478,"DRĂGUŞENI",37173,1219,645,619,26,0,639,6,1342,697,485,154
7,"BOTOŞANI","#N/A",37173,,234,"PODRIGA / SCOALA CU CLAS.I-IV PODRIGA",3,3478,"DRĂGUŞENI",37173,763,459,431,28,0,456,3,836,377,350,106
7,"BOTOŞANI","#N/A",37173,,235,"SARATA-DRĂGUŞENI / SCOALA CU CLS.I-IV SARATA",3,3478,"DRĂGUŞENI",37173,120,76,67,9,0,76,0,131,55,62,14
7,"BOTOŞANI","#N/A",37217,,236,"DURNEŞTI / SCOALA VECHE",3,3482,"DURNEŞTI",37217,935,604,544,60,0,597,7,1036,432,309,288
7,"BOTOŞANI","#N/A",37217,,237,"CUCUTENI / SCOALA",3,3482,"DURNEŞTI",37217,676,434,411,23,0,427,7,745,311,176,251
7,"BOTOŞANI","#N/A",37217,,238,"GURANDA / SCOALA",3,3482,"DURNEŞTI",37217,868,476,438,38,0,473,3,958,482,220,253
7,"BOTOŞANI","#N/A",37217,,239,"BĂBICENI / GRADINITA",3,3482,"DURNEŞTI",37217,611,353,321,32,0,343,10,675,322,201,142
7,"BOTOŞANI","#N/A",37324,,240,"FRUMUŞICA / SCOALA",3,3489,"FRUMUŞICA",37324,639,341,320,20,1,336,5,706,365,228,108
7,"BOTOŞANI","#N/A",37324,,241,"STOREŞTI / SCOALA",3,3489,"FRUMUŞICA",37324,854,454,431,22,1,443,11,942,488,322,121
7,"BOTOŞANI","#N/A",37324,,242,"ŞENDRENI / SCOALA",3,3489,"FRUMUŞICA",37324,563,297,273,24,0,295,2,622,325,221,74
7,"BOTOŞANI","#N/A",37324,,243,"VLĂDENI-DEAL / SCOALA",3,3489,"FRUMUŞICA",37324,1324,592,576,16,0,584,8,1454,862,444,140
7,"BOTOŞANI","#N/A",37324,,244,"BOSCOTENI / SCOALA",3,3489,"FRUMUŞICA",37324,522,282,264,18,0,273,9,575,293,183,90
7,"BOTOŞANI","#N/A",37324,,245,"RĂDENI / SCOALA RADENI",3,3489,"FRUMUŞICA",37324,780,415,381,34,0,405,10,860,445,282,123
7,"BOTOŞANI","#N/A",37397,,246,"DUMENI / SEDIUL PRIMARIEI COMUNEI GEORGE ENESCU",3,3496,"GEORGE ENESCU",37397,570,371,324,47,0,367,4,630,259,219,148
7,"BOTOŞANI","#N/A",37397,,247,"DUMENI / SCOALA GENERALA NR.2 DUMENI",3,3496,"GEORGE ENESCU",37397,914,626,561,65,0,617,9,1009,383,343,274
7,"BOTOŞANI","#N/A",37397,,248,"ARBOREA / SCOALA GENERALA ARBOREA",3,3496,"GEORGE ENESCU",37397,381,244,211,33,0,236,8,421,177,113,123
7,"BOTOŞANI","#N/A",37397,,249,"POPENI / SCOALA GENERALA POPENI",3,3496,"GEORGE ENESCU",37397,396,273,234,39,0,272,1,436,163,180,92
7,"BOTOŞANI","#N/A",37397,,250,"STÎNCA / SCOALA GENERALA STINCA",3,3496,"GEORGE ENESCU",37397,306,210,186,24,0,210,0,338,128,87,123
7,"BOTOŞANI","#N/A",37459,,251,"GORBĂNEŞTI / SCOALA  GORBANESTI",3,3502,"GORBĂNEŞTI",37459,859,561,526,31,4,552,9,952,391,390,162
7,"BOTOŞANI","#N/A",37459,,252,"BĂTRÎNEŞTI / ŞCOALA  GENERALA BATRANESTI",3,3502,"GORBĂNEŞTI",37459,215,140,123,17,0,138,2,237,97,111,27
7,"BOTOŞANI","#N/A",37459,,253,"GEORGE COŞBUC / ŞCOALA GENERALĂ  GEORGE  COSBUC",3,3502,"GORBĂNEŞTI",37459,192,142,122,20,0,139,3,213,71,107,32
7,"BOTOŞANI","#N/A",37459,,254,"SOCRUJENI / SCOALA GENERALA SOCRUJENI",3,3502,"GORBĂNEŞTI",37459,635,383,347,35,1,375,8,702,319,277,98
7,"BOTOŞANI","#N/A",37459,,255,"VÎNĂTORI / CAMIN CULTURAL VANATORI",3,3502,"GORBĂNEŞTI",37459,467,289,267,22,0,281,8,513,224,163,118
7,"BOTOŞANI","#N/A",37459,,256,"SILIŞCANI / SCOALA GENERALA  SILISCANI",3,3502,"GORBĂNEŞTI",37459,267,176,150,26,0,175,1,294,118,99,76
7,"BOTOŞANI","#N/A",37547,,257,"HAVÎRNA / SCOALA  GIMNAZIALA  ,, IOAN CERNAT,, HAVIRNA -CORPUL 3 DE LANGA GRADINITA",3,3517,"HAVÎRNA",37547,1014,503,475,28,0,491,12,1118,615,336,155
7,"BOTOŞANI","#N/A",37547,,258,"HAVÎRNA / GRADINITA  CU PROGRAM  NORMAL Nr.2  HAVIRNA(CATUN BASEU)",3,3517,"HAVÎRNA",37547,629,328,314,14,0,326,2,692,364,204,122
7,"BOTOŞANI","#N/A",37547,,259,"HAVÎRNA / SCOALA  GIMNAZIALA  ,, IOAN CERNAT,, HAVIRNA -CORPUL Nr.2",3,3517,"HAVÎRNA",37547,1073,497,466,31,0,490,7,1185,688,323,167
7,"BOTOŞANI","#N/A",37547,,260,"BALINŢI / SCOALA PRIMARA ,,DUMITRU  POMPAS"" BALINTI",3,3517,"HAVÎRNA",37547,433,212,190,22,0,212,0,476,264,153,59
7,"BOTOŞANI","#N/A",37547,,261,"TĂTĂRĂŞENI / SCOALA  GIMNAZIALA ,, IANCU  MUNTEANU"" TATARASENI",3,3517,"HAVÎRNA",37547,675,396,365,31,0,392,4,744,348,264,128
7,"BOTOŞANI","#N/A",37618,,262,"HĂNEŞTI / CAMIN CULTURAL",3,3511,"HĂNEŞTI",37618,1074,570,531,39,0,565,5,1186,616,358,207
7,"BOTOŞANI","#N/A",37618,,263,"SARATA-BASARAB / ŞCOALA CU CLASEL I-IV SĂRATA BASARAB",3,3511,"HĂNEŞTI",37618,336,208,196,12,0,204,4,371,163,120,84
7,"BOTOŞANI","#N/A",37618,,264,"BOROLEA / SC CL I-IV BOROLEA",3,3511,"HĂNEŞTI",37618,298,182,161,21,0,181,1,327,145,110,71
7,"BOTOŞANI","#N/A",37672,,265,"HILIŞEU-HORIA / Scoala Gimnaziala nr. 1 Hiliseu Horia",3,3524,"HILIŞEU-HORIA",37672,1107,621,579,42,0,621,0,1221,600,512,109
7,"BOTOŞANI","#N/A",37672,,266,"HILIŞEU-CRIŞAN / Scoala Gimnaziala nr. 2 Hiliseu Crisan",3,3524,"HILIŞEU-HORIA",37672,1089,702,638,64,0,691,11,1198,496,554,137
7,"BOTOŞANI","#N/A",37672,,267,"HILIŞEU-CLOŞCA / Scoala Primara nr. 4 Hiliseu Closca",3,3524,"HILIŞEU-HORIA",37672,524,349,309,40,0,345,4,576,227,274,71
7,"BOTOŞANI","#N/A",37734,,268,"HLIPICENI / Scoala cu cl.I-VIII Hlipiceni",3,3530,"HLIPICENI",37734,1406,775,700,75,0,770,5,1547,772,423,347
7,"BOTOŞANI","#N/A",37734,,269,"DRAGALINA / Scoala cu cl .I-IV Dragalina",3,3530,"HLIPICENI",37734,300,197,184,13,0,197,0,333,136,126,71
7,"BOTOŞANI","#N/A",37734,,270,"VICTORIA / Scoala cu cl.I-VIII Victoria",3,3530,"HLIPICENI",37734,1131,641,590,51,0,635,6,1246,605,428,207
7,"BOTOŞANI","#N/A",37770,,271,"HUDEŞTI / CĂMIN CULTURAL",3,3534,"HUDEŞTI",37770,945,577,516,53,8,570,7,1035,458,397,173
7,"BOTOŞANI","#N/A",37770,,272,"VATRA / CĂMIN CULTURAL",3,3534,"HUDEŞTI",37770,947,628,584,39,5,619,8,1047,419,506,113
7,"BOTOŞANI","#N/A",37770,,273,"ALBA / CĂMIN CULTURAL",3,3534,"HUDEŞTI",37770,1146,812,749,56,7,805,7,1258,446,553,252
7,"BOTOŞANI","#N/A",37770,,274,"MLENĂUŢI / ŞCOALA MLENĂUŢI",3,3534,"HUDEŞTI",37770,586,421,357,64,0,417,4,645,224,234,183
7,"BOTOŞANI","#N/A",37770,,275,"BAŞEU / ŞCOALĂ BAŞEU",3,3534,"HUDEŞTI",37770,405,246,215,31,0,245,1,448,202,180,65
7,"BOTOŞANI","#N/A",37770,,276,"BARANCA / ŞCOALA BARANCA",3,3534,"HUDEŞTI",37770,745,522,495,27,0,521,1,820,298,373,148
7,"BOTOŞANI","#N/A",37823,,277,"DUMBRĂVIŢA / SCOALA",3,3541,"IBĂNEŞTI",37823,733,456,419,37,0,450,6,805,349,290,160
7,"BOTOŞANI","#N/A",37823,,278,"DUMBRĂVIŢA / SCOALA",3,3541,"IBĂNEŞTI",37823,723,410,384,26,0,406,4,794,384,274,132
7,"BOTOŞANI","#N/A",37823,,279,"IBĂNEŞTI / GRADINITA",3,3541,"IBĂNEŞTI",37823,831,491,450,41,0,483,8,916,425,303,180
7,"BOTOŞANI","#N/A",37823,,280,"IBĂNEŞTI / GRADINITA",3,3541,"IBĂNEŞTI",37823,941,540,485,55,0,536,4,1031,491,357,179
7,"BOTOŞANI","#N/A",37850,,281,"LEORDA / SCOALA GENERALA NR. 1 LEORDA",3,3544,"LEORDA",37850,1170,854,720,93,41,846,8,1285,431,476,370
7,"BOTOŞANI","#N/A",37850,,282,"COSTINEŞTI / SCOALA GENERALA CU CLASELE I-IV COSTINESTI",3,3544,"LEORDA",37850,172,164,134,30,0,162,2,189,25,90,72
7,"BOTOŞANI","#N/A",37850,,283,"DOLINA / SCOALA GENERALA CU CLASELE I-IV DOLINA",3,3544,"LEORDA",37850,723,478,424,54,0,477,1,796,318,257,220
7,"BOTOŞANI","#N/A",39942,,284,"LOZNA / CAMIN CULTURAL",3,3550,"LOZNA",39942,831,571,488,72,11,565,6,915,344,399,166
7,"BOTOŞANI","#N/A",39942,,285,"STRĂTENI / CAMIN CULTURAL",3,3550,"LOZNA",39942,711,442,406,31,5,425,17,779,337,344,81
7,"BOTOŞANI","#N/A",37912,,286,"LUNCA / Caminul Cultural Lunca",3,3553,"LUNCA",37912,624,335,314,21,0,329,6,693,358,264,65
7,"BOTOŞANI","#N/A",37912,,287,"LUNCA / Caminul Cultural Biznoasa",3,3553,"LUNCA",37912,683,403,376,27,0,401,2,748,345,321,80
7,"BOTOŞANI","#N/A",37912,,288,"STROIEŞTI / Caminul Cultural Stroiesti",3,3553,"LUNCA",37912,730,386,360,26,0,383,3,807,421,260,123
7,"BOTOŞANI","#N/A",37912,,289,"ZLĂTUNOAIA / Scoala Generala Zlatunoaia",3,3553,"LUNCA",37912,1382,725,677,48,0,717,8,1522,797,418,299
7,"BOTOŞANI","#N/A",37912,,290,"ZLĂTUNOAIA / Scoala generala Stanesti",3,3553,"LUNCA",37912,153,135,94,41,0,134,1,172,37,77,57
7,"BOTOŞANI","#N/A",37958,,291,"MANOLEASA / SCOALA MANOLEASA",3,3557,"MANOLEASA",37958,507,268,246,22,0,267,1,557,289,168,99
7,"BOTOŞANI","#N/A",37958,,292,"FLONDORA / SCOALA FLONDORA",3,3557,"MANOLEASA",37958,422,269,246,21,2,268,1,464,195,139,129
7,"BOTOŞANI","#N/A",37958,,293,"SADOVENI / SCOALA SADOVENI",3,3557,"MANOLEASA",37958,361,255,222,33,0,250,5,398,143,206,44
7,"BOTOŞANI","#N/A",37958,,294,"ZAHORENI / SCOALA ZAHORENI",3,3557,"MANOLEASA",37958,442,258,235,23,0,255,3,492,234,175,80
7,"BOTOŞANI","#N/A",37958,,295,"LIVENI / SCOALA LIVENI",3,3557,"MANOLEASA",37958,567,301,257,43,1,298,3,624,323,175,123
7,"BOTOŞANI","#N/A",37958,,296,"LOTURI / SCOALA LOTURI",3,3557,"MANOLEASA",37958,128,106,75,31,0,105,1,142,36,61,44
7,"BOTOŞANI","#N/A",37958,,297,"MANOLEASA-PRUT / FOSTA SCOALA MANOLEASA PRUT",3,3557,"MANOLEASA",37958,117,105,65,38,2,105,0,130,25,78,27
7,"BOTOŞANI","#N/A",38063,,298,"IPOTEŞTI / SCOALA IPOTEŞTI",3,3568,"MIHAI EMINESCU",38063,519,365,328,37,0,361,4,571,206,170,191
7,"BOTOŞANI","#N/A",38063,,299,"CUCORĂNI / SCOALA CUCORĂNI",3,3568,"MIHAI EMINESCU",38063,698,423,395,23,5,418,5,769,346,216,202
7,"BOTOŞANI","#N/A",38063,,300,"CERVICEŞTI / SCOALA CERVICEŞTI",3,3568,"MIHAI EMINESCU",38063,701,458,431,27,0,454,4,768,310,244,210
7,"BOTOŞANI","#N/A",38063,,301,"CĂTĂMĂREŞTI-DEAL / SCOALA CĂTĂMĂREŞTI DEAL",3,3568,"MIHAI EMINESCU",38063,1204,705,656,49,0,691,14,1324,619,338,353
7,"BOTOŞANI","#N/A",38063,,302,"CĂTĂMĂREŞTI-DEAL / SCOALA CĂTĂMĂREŞTI DEAL",3,3568,"MIHAI EMINESCU",38063,1246,721,665,56,0,708,13,1367,646,374,334
7,"BOTOŞANI","#N/A",38063,,303,"STÎNCEŞTI / ŞCOALA STÎNCEŞTI",3,3568,"MIHAI EMINESCU",38063,1268,697,653,44,0,687,10,1398,701,406,281
7,"BOTOŞANI","#N/A",38063,,304,"CĂTĂMĂREŞTI / ŞCOALA CĂTĂMĂREŞTI",3,3568,"MIHAI EMINESCU",38063,519,348,315,33,0,345,3,572,224,238,107
7,"BOTOŞANI","#N/A",38161,,305,"MIHĂILENI / Scoala cl I-IV Mihaileni",3,3578,"MIHĂILENI",38161,1184,686,579,68,39,679,7,1305,619,486,193
7,"BOTOŞANI","#N/A",38161,,306,"ROGOJEŞTI / Şcoala Generală Rogojesti",3,3578,"MIHĂILENI",38161,476,344,275,49,20,339,5,528,184,153,186
7,"BOTOŞANI","#N/A",38161,,307,"PÂRÂU NEGRU / ŞcoalaGenerală Parau Negru",3,3578,"MIHĂILENI",38161,405,236,194,29,13,234,2,444,208,148,86
7,"BOTOŞANI","#N/A",38241,,308,"MIHĂLĂŞENI / SCOALA MIHALASENI",3,3582,"MIHĂLĂŞENI",38241,619,364,333,31,0,361,3,685,321,170,191
7,"BOTOŞANI","#N/A",38241,,309,"SARATA / SCOALA SARATA",3,3582,"MIHĂLĂŞENI",38241,399,225,203,22,0,224,1,440,215,78,146
7,"BOTOŞANI","#N/A",38241,,310,"NEGREŞTI / SCOALA NEGRESTI",3,3582,"MIHĂLĂŞENI",38241,364,274,246,28,0,272,2,399,125,140,132
7,"BOTOŞANI","#N/A",38241,,311,"NĂSTASE / SCOALA NASTASE",3,3582,"MIHĂLĂŞENI",38241,360,233,208,25,0,228,5,393,160,110,118
7,"BOTOŞANI","#N/A",38321,,312,"MILEANCA / Scoala Gimnaziala nr.1 Mileanca",3,3590,"MILEANCA",38321,1330,775,718,49,8,770,5,1466,691,475,295
7,"BOTOŞANI","#N/A",38321,,313,"CODRENI / Scoala Gimnaziala Nr.2 Codreni",3,3590,"MILEANCA",38321,297,192,164,28,0,190,2,327,135,150,40
7,"BOTOŞANI","#N/A",38321,,314,"SCUTARI / Scoala cu clasele I-IV Scutari",3,3590,"MILEANCA",38321,229,151,136,15,0,150,1,252,101,83,67
7,"BOTOŞANI","#N/A",38321,,315,"SELIŞTEA / Scoala cu clasele I-IV  Seliştea",3,3590,"MILEANCA",38321,330,200,186,14,0,193,7,361,161,135,58
7,"BOTOŞANI","#N/A",38376,,316,"MITOC / Şcoala Gimnazială ""Florică Murariu"" Mitoc",3,3595,"MITOC",38376,981,491,454,37,0,488,3,1081,590,387,101
7,"BOTOŞANI","#N/A",38376,,317,"HORIA / Şcoala Primară nr. 1 Horia",3,3595,"MITOC",38376,419,238,217,21,0,237,1,462,224,205,32
7,"BOTOŞANI","#N/A",38456,,318,"NICŞENI / CAMINCULTURALNICŞENI",3,3598,"NICŞENI",38456,788,486,452,34,0,481,5,866,380,283,198
7,"BOTOŞANI","#N/A",38456,,319,"DOROBANŢI / CAMINCULTURALDOROBANŢI",3,3598,"NICŞENI",38456,1204,642,576,66,0,638,4,1324,682,454,184
7,"BOTOŞANI","#N/A",38456,,320,"DACIA / ŞCOALA DACIA",3,3598,"NICŞENI",38456,121,82,70,12,0,81,1,134,52,43,38
7,"BOTOŞANI","#N/A",38492,,321,"PĂLTINIŞ / CAMIN CULTURAL PALTINIS",3,3602,"PĂLTINIŞ",38492,838,534,463,67,4,524,10,908,374,245,279
7,"BOTOŞANI","#N/A",38492,,322,"PĂLTINIŞ / ŞCOALA GRIVIŢA",3,3602,"PĂLTINIŞ",38492,228,183,150,30,3,182,1,253,70,77,105
7,"BOTOŞANI","#N/A",38492,,323,"PĂLTINIŞ / CĂMIN CULTURAL IVANCĂUŢI",3,3602,"PĂLTINIŞ",38492,523,358,299,58,1,352,6,574,216,167,185
7,"BOTOŞANI","#N/A",38492,,324,"CUZLĂU / ŞCOALA CUZLĂU",3,3602,"PĂLTINIŞ",38492,355,226,200,25,1,225,1,391,165,119,106
7,"BOTOŞANI","#N/A",38492,,325,"HORODIŞTEA / ŞCOALA CU CL I-VIII HORODIŞTEA",3,3602,"PĂLTINIŞ",38492,568,396,309,80,7,390,6,629,233,194,196
7,"BOTOŞANI","#N/A",38544,,326,"POMÎRLA / Liceul Teoretic Anastasie Başotă",3,3607,"POMÎRLA",38544,978,622,535,66,21,616,6,1079,457,481,135
7,"BOTOŞANI","#N/A",38544,,327,"POMÎRLA / Scoala Primara nr. 1  Pomîrla",3,3607,"POMÎRLA",38544,892,585,544,32,9,575,10,983,398,440,135
7,"BOTOŞANI","#N/A",38544,,328,"RACOVĂŢ / Soala Primara nr. 2 Racovăţ",3,3607,"POMÎRLA",38544,269,201,177,24,0,201,0,296,95,176,25
7,"BOTOŞANI","#N/A",38580,,329,"PRĂJENI / ŞCOALA CU CLASELE I-IV SALA I",3,3611,"PRĂJENI",38580,977,495,482,13,0,494,1,1074,579,312,182
7,"BOTOŞANI","#N/A",38580,,330,"CÎMPENI / ŞCOALA CU CLASELE I-IV",3,3611,"PRĂJENI",38580,526,306,270,36,0,302,4,580,274,203,99
7,"BOTOŞANI","#N/A",38580,,331,"LUPĂRIA / ŞCOALA GENERALĂ LUPARIA",3,3611,"PRĂJENI",38580,599,343,322,21,0,340,3,661,318,200,140
7,"BOTOŞANI","#N/A",38580,,332,"MILETIN / ŞCOALA GENERALĂ MILETIN",3,3611,"PRĂJENI",38580,460,268,256,12,0,266,2,507,239,153,113
7,"BOTOŞANI","#N/A",35839,,333,"RĂCHIŢI / Şcoala Gimnazială nr. 1 Răchiţi",3,3616,"RĂCHIŢI",35839,1394,927,798,125,4,910,17,1532,605,529,381
7,"BOTOŞANI","#N/A",35839,,334,"COSTEŞTI / Şcoala Gimnazială ""Petre Şuşter""",3,3616,"RĂCHIŢI",35839,1246,785,715,70,0,777,8,1375,590,550,227
7,"BOTOŞANI","#N/A",35839,,335,"ROŞIORI / Şcoala Gimnazială nr. 2 Roşiori",3,3616,"RĂCHIŢI",35839,1182,668,628,40,0,658,9,1301,634,425,233
7,"BOTOŞANI","#N/A",38633,,336,"RĂDĂUŢI-PRUT / CAMIN CULTURAL RADAUTI-PRUT",3,3621,"RĂDĂUŢI-PRUT",38633,702,420,349,71,0,413,7,770,350,271,142
7,"BOTOŞANI","#N/A",38633,,337,"REDIU / CAMINUL CULTURAL SAT  REDIU",3,3621,"RĂDĂUŢI-PRUT",38633,767,470,423,47,0,462,8,844,374,306,156
7,"BOTOŞANI","#N/A",38633,,338,"MIORCANI / CAMIN CULTURAL MIORCANI",3,3621,"RĂDĂUŢI-PRUT",38633,781,433,403,30,0,428,5,859,426,258,170
7,"BOTOŞANI","#N/A",38633,,339,"MIORCANI / CAMIN CULTURAL MIORCANI",3,3621,"RĂDĂUŢI-PRUT",38633,714,398,373,25,0,392,6,793,395,198,194
7,"BOTOŞANI","#N/A",38679,,340,"RĂUSENI / CAMIN CULTURAL RAUSENI",3,3625,"RĂUSENI",38679,1246,679,609,70,0,666,13,1372,693,463,203
7,"BOTOŞANI","#N/A",38679,,341,"DOINA / SCOALA GENERALA DOINA",3,3625,"RĂUSENI",38679,427,258,234,24,0,255,3,472,214,201,54
7,"BOTOŞANI","#N/A",38679,,342,"REDIU / SCOALA GENERALA REDIU",3,3625,"RĂUSENI",38679,467,224,212,12,0,218,6,512,288,159,59
7,"BOTOŞANI","#N/A",38731,,343,"RIPICENI / CĂMINUL  CULTURAL",3,3631,"RIPICENI",38731,857,502,467,35,0,497,5,938,436,282,215
7,"BOTOŞANI","#N/A",38731,,344,"RIPICENI / GRĂDINIŢA  DE  COPII",3,3631,"RIPICENI",38731,780,500,460,40,0,497,3,862,362,277,220
7,"BOTOŞANI","#N/A",38811,,345,"ROMA / SCOALA NR. 1 ROMA",3,3639,"ROMA",38811,1355,880,784,62,34,873,7,1493,613,594,279
7,"BOTOŞANI","#N/A",38811,,346,"ROMA / SCOALA NR.2 ROMA",3,3639,"ROMA",38811,872,604,541,42,21,593,11,957,353,418,175
7,"BOTOŞANI","#N/A",38811,,347,"COTÎRGACI / SCOALA NR. 4 COTIRGACI",3,3639,"ROMA",38811,377,244,204,34,6,244,0,413,169,162,82
7,"BOTOŞANI","#N/A",38848,,348,"ROMÂNEŞTI / CĂMINUL CULTURAL",3,3642,"ROMÂNEŞTI",38848,1168,759,663,70,26,751,8,1285,526,596,155
7,"BOTOŞANI","#N/A",38848,,349,"DĂMIDENI / SCOALA PRIMARĂ NR 1",3,3642,"ROMÂNEŞTI",38848,508,293,256,29,8,290,3,559,266,218,72
7,"BOTOŞANI","#N/A",38893,,350,"SANTA MARE / CAMINUL CULTURAL SANTA MARE",3,3647,"SANTA MARE",38893,1017,665,616,49,0,642,23,1120,455,240,402
7,"BOTOŞANI","#N/A",38893,,351,"BERZA / SCOALA GENERALA BERZA",3,3647,"SANTA MARE",38893,180,116,98,18,0,115,1,198,82,42,73
7,"BOTOŞANI","#N/A",38893,,352,"BOGDĂNEŞTI / SCOALA GENERALA BOGDANESTI",3,3647,"SANTA MARE",38893,318,200,173,27,0,197,3,354,154,97,100
7,"BOTOŞANI","#N/A",38893,,353,"RÎNGHILEŞTI / SCOALA GENERALA RINGHILESTI",3,3647,"SANTA MARE",38893,317,183,165,18,0,181,2,349,166,80,101
7,"BOTOŞANI","#N/A",38893,,354,"ILIŞENI / SCOALA GENERALA ILISENI",3,3647,"SANTA MARE",38893,316,203,169,34,0,203,0,350,147,138,65
7,"BOTOŞANI","#N/A",35884,,355,"STĂUCENI / CAMIN CULTURAL",3,3660,"STĂUCENI",35884,1068,599,537,54,8,592,7,1177,578,378,214
7,"BOTOŞANI","#N/A",35884,,356,"SILIŞTEA / SCOALA GENERALA CU CLASELE I-IV",3,3660,"STĂUCENI",35884,373,208,193,14,1,207,1,408,200,132,75
7,"BOTOŞANI","#N/A",35884,,357,"VICTORIA / SCOALA GENERALA CU CLASELE I-IV",3,3660,"STĂUCENI",35884,440,246,225,21,0,243,3,481,235,115,128
7,"BOTOŞANI","#N/A",35884,,358,"TOCILENI / SCOALA GENERALA CU CLASELE I-VIII PATRIARH TEOCTIST ARAPASU",3,3660,"STĂUCENI",35884,894,541,483,47,11,535,6,983,442,382,153
7,"BOTOŞANI","#N/A",38982,,359,"SUHARĂU / SCOALA PRIMARA NR. 3 SUHARAU",3,3669,"SUHARĂU",38982,1027,652,566,63,23,642,10,1115,463,507,135
7,"BOTOŞANI","#N/A",38982,,360,"SUHARĂU / SCOALA GIMNAZIALA NR. 2 SUHARAU",3,3669,"SUHARĂU",38982,590,334,299,35,0,332,2,673,339,252,80
7,"BOTOŞANI","#N/A",38982,,361,"LIŞNA / GRADINITA LISNA",3,3669,"SUHARĂU",38982,757,493,460,33,0,488,5,824,331,301,187
7,"BOTOŞANI","#N/A",38982,,362,"OROFTIANA / SCOALA GENERALA NR. 4 OROFTIANA",3,3669,"SUHARĂU",38982,770,437,377,60,0,434,3,850,413,264,170
7,"BOTOŞANI","#N/A",38982,,363,"SMÎRDAN / GRADINITA SMARDAN",3,3669,"SUHARĂU",38982,661,514,384,129,1,513,1,729,215,286,227
7,"BOTOŞANI","#N/A",39051,,364,"SULIŢA / SCOALA CU CL I-VIII SULITA",3,3676,"SULIŢA",39051,1338,783,709,65,9,777,6,1478,695,524,253
7,"BOTOŞANI","#N/A",39051,,365,"DRACŞANI / SCOALA CU CL. I - VIII DRACSANI",3,3676,"SULIŢA",39051,1208,725,679,46,0,717,8,1333,608,527,190
7,"BOTOŞANI","#N/A",39122,,366,"ŞENDRICENI / Şcoala nr.1",3,3656,"ŞENDRICENI",39122,1112,614,570,44,0,609,5,1194,580,375,234
7,"BOTOŞANI","#N/A",39122,,367,"ŞENDRICENI / Şcoala Generală Cobîla",3,3656,"ŞENDRICENI",39122,765,424,398,26,0,422,2,866,442,287,135
7,"BOTOŞANI","#N/A",39122,,368,"HORLĂCENI / Şcoala Generală",3,3656,"ŞENDRICENI",39122,472,291,246,45,0,284,7,520,229,194,90
7,"BOTOŞANI","#N/A",39122,,369,"PĂDURENI / Şcoala  Generală",3,3656,"ŞENDRICENI",39122,899,469,436,33,0,465,4,989,520,274,191
7,"BOTOŞANI","#N/A",39220,,370,"ŞTIUBIENI / SALA DE SPORT ŞTIUBIENI",3,3665,"ŞTIUBIENI",39220,1488,808,736,48,24,801,7,1639,831,513,288
7,"BOTOŞANI","#N/A",39220,,371,"NEGRENI / ŞCOALA NEGRENI",3,3665,"ŞTIUBIENI",39220,627,431,363,57,11,428,3,690,259,244,184
7,"BOTOŞANI","#N/A",39266,,372,"TODIRENI / Cămin cultural Todireni",3,3680,"TODIRENI",39266,1202,675,622,53,0,670,5,1333,658,495,175
7,"BOTOŞANI","#N/A",39266,,373,"TODIRENI / Şcoala cu clasele I-IV nr.2 Todireni",3,3680,"TODIRENI",39266,482,252,226,26,0,248,4,525,273,125,123
7,"BOTOŞANI","#N/A",39266,,374,"CERNEŞTI / Şcoala cu clasele I-VIII Cerneşti",3,3680,"TODIRENI",39266,667,412,372,36,4,410,2,736,324,318,92
7,"BOTOŞANI","#N/A",39266,,375,"IUREŞTI / Şcoala cu clasele I-IV  Iureşti",3,3680,"TODIRENI",39266,443,250,220,30,0,248,2,485,235,198,50
7,"BOTOŞANI","#N/A",39328,,376,"TRUŞEŞTI / ŞCOALA GENERALĂ NR. 1 TRUŞEŞTI",3,3686,"TRUŞEŞTI",39328,1043,655,583,39,33,645,10,1151,496,362,283
7,"BOTOŞANI","#N/A",39328,,377,"TRUŞEŞTI / ŞCOALA GENERALĂ NR. 1 TRUŞEŞTI",3,3686,"TRUŞEŞTI",39328,1047,581,532,47,2,572,9,1148,567,354,218
7,"BOTOŞANI","#N/A",39328,,378,"BUHĂCENI / ŞCOALA GENERALĂ NR. 4 BUHĂCENI",3,3686,"TRUŞEŞTI",39328,657,397,371,26,0,388,9,729,332,273,115
7,"BOTOŞANI","#N/A",39328,,379,"DRISLEA / ŞCOALA GENERALĂ NR. 3 DRISLEA",3,3686,"TRUŞEŞTI",39328,846,485,454,29,2,477,8,930,445,300,177
7,"BOTOŞANI","#N/A",39328,,380,"IONĂŞENI / ŞCOALA GENERALĂ NR. 2 IONĂŞENI",3,3686,"TRUŞEŞTI",39328,821,504,459,45,0,501,3,884,380,315,186
7,"BOTOŞANI","#N/A",39391,,381,"TUDORA / SCOALA TIBERIU CRUDU CORP B SALA 1",3,3693,"TUDORA",39391,1464,846,806,32,8,842,4,1616,770,652,190
7,"BOTOŞANI","#N/A",39391,,382,"TUDORA / SCOAL TIBERIU CRUDU CORP B SALA 2",3,3693,"TUDORA",39391,1136,592,536,52,4,588,4,1252,660,400,188
7,"BOTOŞANI","#N/A",39391,,383,"TUDORA / SCOALA CU CLASELE I-VIII ARINI",3,3693,"TUDORA",39391,1386,702,653,40,9,692,10,1524,822,474,218
7,"BOTOŞANI","#N/A",39417,,384,"UNGURENI / Şcoala nr.1",3,3695,"UNGURENI",39417,1204,621,557,62,2,611,10,1324,703,375,236
7,"BOTOŞANI","#N/A",39417,,385,"UNGURENI / Şcoala nr.2",3,3695,"UNGURENI",39417,1072,549,527,22,0,540,9,1180,631,253,287
7,"BOTOŞANI","#N/A",39417,,386,"MIHAI VITEAZU / Şcoala",3,3695,"UNGURENI",39417,374,243,222,19,2,240,3,410,167,115,125
7,"BOTOŞANI","#N/A",39417,,387,"BORZEŞTI / Şcoala",3,3695,"UNGURENI",39417,1147,561,531,30,0,560,1,1289,728,372,188
7,"BOTOŞANI","#N/A",39417,,388,"PLOPENII MARI / SAM",3,3695,"UNGURENI",39417,824,385,364,19,2,378,7,908,523,259,119
7,"BOTOŞANI","#N/A",39417,,389,"CĂLUGĂRENI / Scoala Calugareni",3,3695,"UNGURENI",39417,601,328,294,34,0,323,5,635,307,215,108
7,"BOTOŞANI","#N/A",39532,,390,"UNŢENI / ŞCOALA Gimnazială nr.1 Unţeni",3,3707,"UNŢENI",39532,987,600,557,36,7,595,5,1086,486,423,172
7,"BOTOŞANI","#N/A",39532,,391,"MÎNĂSTIRENI / ŞCOALA Gimnazială nr.2 Mînăstireni",3,3707,"UNŢENI",39532,659,354,318,26,10,350,4,729,375,199,151
7,"BOTOŞANI","#N/A",39532,,392,"BURLEŞTI / ŞCOALA Primară nr.3 Burleşti",3,3707,"UNŢENI",39532,602,359,316,43,0,357,2,666,307,259,98
7,"BOTOŞANI","#N/A",39612,,393,"VĂCULEŞTI / SCOALA VACULESTI",3,3715,"VĂCULEŞTI",39612,896,627,514,81,32,622,5,988,361,451,171
7,"BOTOŞANI","#N/A",39612,,394,"SAUCENIŢA / SCOALA SAUCENITA",3,3715,"VĂCULEŞTI",39612,738,470,409,47,14,465,5,811,341,330,135
7,"BOTOŞANI","#N/A",39612,,395,"GOROVEI / SCOALA GOROVEI",3,3715,"VĂCULEŞTI",39612,30,37,24,13,0,37,0,40,3,30,7
7,"BOTOŞANI","#N/A",39694,,396,"MAGHERA / Şc.cu clasele I-VIII nr.1",3,3719,"VÂRFU CÂMPULUI",39694,503,426,355,70,1,421,5,548,122,196,225
7,"BOTOŞANI","#N/A",39694,,397,"VÂRFU CÂMPULUI / Şc.cu clasele I-VIII George Hazgan",3,3719,"VÂRFU CÂMPULUI",39694,1083,733,667,62,4,721,12,1200,467,478,243
7,"BOTOŞANI","#N/A",39694,,398,"IONĂŞENI / Şc.cu clasele I-VIII Ionăşeni",3,3719,"VÂRFU CÂMPULUI",39694,683,418,375,43,0,417,1,750,332,244,173
7,"BOTOŞANI","#N/A",39694,,399,"LUNCA / Şc.cu clasele I-IV Lunca",3,3719,"VÂRFU CÂMPULUI",39694,572,428,347,80,1,424,4,635,207,251,173
7,"BOTOŞANI","#N/A",39658,,400,"VIIŞOARA / CĂMINUL CULTURAL VIIŞOARA",3,3726,"VIIŞOARA",39658,740,443,414,29,0,437,6,817,374,277,160
7,"BOTOŞANI","#N/A",39658,,401,"CUZA VODĂ / ŞCOLA CU CLASELE I-IV CUZA VODĂ",3,3726,"VIIŞOARA",39658,461,290,267,23,0,288,2,508,218,201,87
7,"BOTOŞANI","#N/A",39658,,402,"VIIŞOARA MICĂ / ŞCOLA CU CLASELE I-IV VIIŞOARA MICĂ",3,3726,"VIIŞOARA",39658,440,253,232,21,0,250,3,484,231,187,63
7,"BOTOŞANI","#N/A",39738,,403,"VLĂDENI / SCOALA CU CLASELE I-VIII VLADENI(CORP VECHI)",3,3730,"VLĂDENI",39738,1473,771,705,66,0,764,7,1624,853,579,185
7,"BOTOŞANI","#N/A",39738,,404,"BREHUIEŞTI / SCOALA CU CLASELE I-VIII BREHUIESTI(Corpul B)",3,3730,"VLĂDENI",39738,1321,729,665,64,0,725,4,1454,725,515,210
7,"BOTOŞANI","#N/A",39738,,405,"MÎNDREŞTI / SCOALA CU CLASELE I-VIII MANDRESTI",3,3730,"VLĂDENI",39738,1119,558,521,37,0,556,2,1239,681,377,179
7,"BOTOŞANI","#N/A",39792,,406,"VLĂSINEŞTI / ŞCOALA CU CLASELE I-VIII GHEORGHE BURAC",3,3736,"VLĂSINEŞTI",39792,1259,897,722,65,110,889,8,1392,495,743,146
7,"BOTOŞANI","#N/A",39792,,407,"SÎRBI / ŞCOALA CU CLASELE I-IV",3,3736,"VLĂSINEŞTI",39792,836,596,524,33,39,592,4,924,328,482,110
7,"BOTOŞANI","#N/A",39792,,408,"MIRON COSTIN / ŞCOALA CU CLASELE I-IV",3,3736,"VLĂSINEŞTI",39792,324,269,191,69,9,263,6,356,87,175,88
7,"BOTOŞANI","#N/A",39836,,409,"VORNICENI / SCOALA NR.1 VORNICENI",3,3740,"VORNICENI",39836,1215,616,583,33,0,605,11,1339,723,350,255
7,"BOTOŞANI","#N/A",39836,,410,"VORNICENI / SCOALA NR.2 VORNICENI",3,3740,"VORNICENI",39836,842,427,399,28,0,419,8,933,506,227,192
7,"BOTOŞANI","#N/A",39836,,411,"VORNICENI / SCOALA NR.3 VORNICENI",3,3740,"VORNICENI",39836,857,485,455,29,1,481,4,953,468,298,183
7,"BOTOŞANI","#N/A",39836,,412,"DEALU CRUCII / SCOALA DEALU CRUCII",3,3740,"VORNICENI",39836,294,173,154,19,0,172,1,320,147,127,45
7,"BOTOŞANI","#N/A",39872,,413,"VORONA / Sc. cu Cl. I-VIII Al I. Cuza Vorona",3,3744,"VORONA",39872,795,442,403,39,0,438,4,867,425,270,168
7,"BOTOŞANI","#N/A",39872,,414,"VORONA / Lic. Tehnologic  Stefan cel Mare Vorona",3,3744,"VORONA",39872,806,475,403,71,1,461,14,884,409,316,145
7,"BOTOŞANI","#N/A",39872,,415,"VORONA / Sc. cu cl. I-VIII Ionita Pancul Vorona",3,3744,"VORONA",39872,569,301,277,23,1,295,6,616,315,188,107
7,"BOTOŞANI","#N/A",39872,,416,"VORONA MARE / Sc. cu cl. I-VIII Luca Arbore Vorona Mare",3,3744,"VORONA",39872,924,511,430,67,14,502,9,1027,516,379,123
7,"BOTOŞANI","#N/A",39872,,417,"JOLDEŞTI / Sc. cu cl. I-VIII Raluca Iurascu Joldesti",3,3744,"VORONA",39872,1023,537,485,43,9,530,7,1125,588,392,138
7,"BOTOŞANI","#N/A",39872,,418,"ICUŞENI / Gradinita nr. 2 Icuseni",3,3744,"VORONA",39872,253,161,138,21,2,157,4,278,117,126,31
7,"BOTOŞANI","#N/A",39872,,419,"ICUŞENI / Sc. cu cl. I-VIII Al. cel Bun Icuseni",3,3744,"VORONA",39872,792,438,395,39,4,430,8,875,437,328,102
7,"BOTOŞANI","#N/A",39872,,420,"POIANA / Sc. cu cl. I-VIII Nicolae Iorga Poiana",3,3744,"VORONA",39872,1022,483,446,34,3,477,6,1131,648,363,114
8,"BRAŞOV","#N/A",40198,,1,"BRAŞOV / SEMINARUL TEOLOGIC LICEAL ORTODOX ""DUMITRU STĂNILOAIE""",1,3752,"MUNICIPIUL BRAŞOV",40198,1483,948,907,40,1,927,21,1600,652,325,602
8,"BRAŞOV","#N/A",40198,,2,"BRAŞOV / SEMINARUL TEOLOGIC LICEAL ORTODOX ""DUMITRU STĂNILOAIE""",1,3752,"MUNICIPIUL BRAŞOV",40198,1274,816,771,43,2,799,17,1400,584,254,545
8,"BRAŞOV","#N/A",40198,,3,"BRAŞOV / GRĂDINIŢA CU PROGRAM PRELUNGIT Nr. 2",1,3752,"MUNICIPIUL BRAŞOV",40198,1106,746,691,54,1,736,10,1200,454,260,476
8,"BRAŞOV","#N/A",40198,,4,"BRAŞOV / GRĂDINIŢA CU PROGRAM PRELUNGIT Nr. 2",1,3752,"MUNICIPIUL BRAŞOV",40198,1135,796,700,69,27,784,12,1300,504,235,549
8,"BRAŞOV","#N/A",40198,,5,"BRAŞOV / LICEUL ""ANDREI MUREŞANU""",1,3752,"MUNICIPIUL BRAŞOV",40198,1500,1154,931,155,68,1125,29,1600,446,411,714
8,"BRAŞOV","#N/A",40198,,6,"BRAŞOV / LICEUL ""ANDREI MUREŞANU""",1,3752,"MUNICIPIUL BRAŞOV",40198,1530,979,844,132,3,967,12,1600,621,349,618
8,"BRAŞOV","#N/A",40198,,7,"BRAŞOV / COLEGIUL TEHNIC ""MARIA BAIULESCU""",1,3752,"MUNICIPIUL BRAŞOV",40198,1441,880,787,92,1,852,28,1500,620,261,591
8,"BRAŞOV","#N/A",40198,,8,"BRAŞOV / COLEGIUL TEHNIC ""MARIA BAIULESCU""",1,3752,"MUNICIPIUL BRAŞOV",40198,1642,991,849,141,1,969,22,1700,709,337,632
8,"BRAŞOV","#N/A",40198,,9,"BRAŞOV / COLEGIUL NAŢIONAL ""APRILY LAJOS""",1,3752,"MUNICIPIUL BRAŞOV",40198,1105,711,576,133,2,696,15,1200,489,223,473
8,"BRAŞOV","#N/A",40198,,10,"BRAŞOV / COLEGIUL NAŢIONAL ""APRILY LAJOS""",1,3752,"MUNICIPIUL BRAŞOV",40198,1061,811,624,186,1,793,18,1200,389,239,554
8,"BRAŞOV","#N/A",40198,,11,"BRAŞOV / COLEGIUL NAŢIONAL ""APRILY LAJOS""",1,3752,"MUNICIPIUL BRAŞOV",40198,798,542,454,88,0,527,15,900,358,172,355
8,"BRAŞOV","#N/A",40198,,12,"BRAŞOV / COLEGIUL NAŢIONAL ""UNIREA""",1,3752,"MUNICIPIUL BRAŞOV",40198,1328,1303,802,451,50,1274,29,1600,297,405,869
8,"BRAŞOV","#N/A",40198,,13,"BRAŞOV / COLEGIUL NAŢIONAL ""UNIREA""",1,3752,"MUNICIPIUL BRAŞOV",40198,1329,1245,767,478,0,1218,27,1600,355,410,808
8,"BRAŞOV","#N/A",40198,,14,"BRAŞOV / ŞCOALA GIMNAZIALĂ Nr. 8",1,3752,"MUNICIPIUL BRAŞOV",40198,1030,750,677,71,2,741,9,1100,350,250,491
8,"BRAŞOV","#N/A",40198,,15,"BRAŞOV / ŞCOALA GIMNAZIALĂ Nr. 8",1,3752,"MUNICIPIUL BRAŞOV",40198,1111,752,636,87,29,732,20,1200,448,267,465
8,"BRAŞOV","#N/A",40198,,16,"BRAŞOV / ŞCOALA GIMNAZIALĂ Nr. 8",1,3752,"MUNICIPIUL BRAŞOV",40198,1244,812,763,49,0,794,18,1298,486,277,517
8,"BRAŞOV","#N/A",40198,,17,"BRAŞOV / ŞCOALA GIMNAZIALĂ Nr. 8",1,3752,"MUNICIPIUL BRAŞOV",40198,1766,1117,1067,48,2,1095,22,1900,783,420,675
8,"BRAŞOV","#N/A",40198,,18,"BRAŞOV / ŞCOALA GIMNAZIALĂ Nr.5",1,3752,"MUNICIPIUL BRAŞOV",40198,1536,1132,965,156,11,1110,22,1700,568,352,758
8,"BRAŞOV","#N/A",40198,,19,"BRAŞOV / ŞCOALA GIMNAZIALĂ Nr.5",1,3752,"MUNICIPIUL BRAŞOV",40198,1744,1201,1036,104,61,1170,31,1900,699,424,746
8,"BRAŞOV","#N/A",40198,,20,"BRAŞOV / ŞCOALA GIMNAZIALĂ Nr. 15",1,3752,"MUNICIPIUL BRAŞOV",40198,1665,1341,1040,262,39,1311,30,1800,459,466,845
8,"BRAŞOV","#N/A",40198,,21,"BRAŞOV / ŞCOALA GIMNAZIALĂ Nr. 15",1,3752,"MUNICIPIUL BRAŞOV",40198,1640,1212,1011,201,0,1183,29,1800,588,450,733
8,"BRAŞOV","#N/A",40198,,22,"BRAŞOV / ŞCOALA GIMNAZIALĂ Nr. 15",1,3752,"MUNICIPIUL BRAŞOV",40198,1658,1273,1069,204,0,1253,20,1800,527,429,824
8,"BRAŞOV","#N/A",40198,,23,"BRAŞOV / LICEUL DE MUZICĂ ""TUDOR CIORTEA""",1,3752,"MUNICIPIUL BRAŞOV",40198,1438,1136,860,174,102,1119,17,1600,464,366,753
8,"BRAŞOV","#N/A",40198,,24,"BRAŞOV / ŞCOALA GIMNAZIALĂ Nr. 12",1,3752,"MUNICIPIUL BRAŞOV",40198,1151,774,646,126,2,764,10,1300,526,213,551
8,"BRAŞOV","#N/A",40198,,25,"BRAŞOV / ŞCOALA GIMNAZIALĂ Nr. 12",1,3752,"MUNICIPIUL BRAŞOV",40198,1497,950,892,58,0,927,23,1600,650,310,617
8,"BRAŞOV","#N/A",40198,,26,"BRAŞOV / GRĂDINIŢA CU PROGRAM PRELUNGIT ""CASUTA BUCURIEI"" Nr. 11",1,3752,"MUNICIPIUL BRAŞOV",40198,916,541,500,41,0,530,11,1000,459,219,311
8,"BRAŞOV","#N/A",40198,,27,"BRAŞOV / GRĂDINIŢA CU PROGRAM PRELUNGIT ""CASUTA BUCURIEI"" Nr. 11",1,3752,"MUNICIPIUL BRAŞOV",40198,907,657,594,63,0,639,18,1000,343,256,383
8,"BRAŞOV","#N/A",40198,,28,"BRAŞOV / COLEGIUL ""EMIL RACOVIŢĂ""",1,3752,"MUNICIPIUL BRAŞOV",40198,1666,1136,1028,106,2,1108,28,1700,564,394,714
8,"BRAŞOV","#N/A",40198,,29,"BRAŞOV / COLEGIUL ""EMIL RACOVIŢĂ""",1,3752,"MUNICIPIUL BRAŞOV",40198,1493,989,921,64,4,974,15,1600,611,405,569
8,"BRAŞOV","#N/A",40198,,30,"BRAŞOV / COLEGIUL ""EMIL RACOVIŢĂ""",1,3752,"MUNICIPIUL BRAŞOV",40198,1342,902,811,90,1,888,14,1500,598,302,586
8,"BRAŞOV","#N/A",40198,,31,"BRAŞOV / COLEGIUL ""EMIL RACOVIŢĂ""",1,3752,"MUNICIPIUL BRAŞOV",40198,899,651,599,52,0,637,14,1000,349,204,433
8,"BRAŞOV","#N/A",40198,,32,"BRAŞOV / ŞCOALA GIMNAZIALĂ Nr. 15",1,3752,"MUNICIPIUL BRAŞOV",40198,1509,1019,943,76,0,987,32,1700,681,328,659
8,"BRAŞOV","#N/A",40198,,33,"BRAŞOV / ŞCOALA GIMNAZIALĂ Nr. 15",1,3752,"MUNICIPIUL BRAŞOV",40198,1398,882,826,55,1,863,19,1500,618,300,563
8,"BRAŞOV","#N/A",40198,,34,"BRAŞOV / ŞCOALA GIMNAZIALĂ Nr. 15",1,3752,"MUNICIPIUL BRAŞOV",40198,1286,799,771,28,0,779,20,1400,601,290,489
8,"BRAŞOV","#N/A",40198,,35,"BRAŞOV / COLEGIUL NAŢIONAL ""DR. I. MEŞOTĂ""",1,3752,"MUNICIPIUL BRAŞOV",40198,1756,1246,1140,105,1,1224,22,1900,654,478,746
8,"BRAŞOV","#N/A",40198,,36,"BRAŞOV / COLEGIUL NAŢIONAL ""DR. I. MEŞOTĂ""",1,3752,"MUNICIPIUL BRAŞOV",40198,1031,755,641,113,1,734,21,1100,345,227,507
8,"BRAŞOV","#N/A",40198,,37,"BRAŞOV / COLEGIUL NAŢIONAL ""DR. I. MEŞOTĂ""",1,3752,"MUNICIPIUL BRAŞOV",40198,1653,1120,993,127,0,1091,29,1800,680,385,706
8,"BRAŞOV","#N/A",40198,,38,"BRAŞOV / ŞCOALA GIMNAZIALĂ Nr. 19",1,3752,"MUNICIPIUL BRAŞOV",40198,1196,1036,786,249,1,1016,20,1300,264,376,640
8,"BRAŞOV","#N/A",40198,,39,"BRAŞOV / ŞCOALA GIMNAZIALĂ Nr. 19",1,3752,"MUNICIPIUL BRAŞOV",40198,1396,939,857,80,2,925,14,1495,556,402,523
8,"BRAŞOV","#N/A",40198,,40,"BRAŞOV / ŞCOALA GIMNAZIALĂ Nr. 19",1,3752,"MUNICIPIUL BRAŞOV",40198,1025,736,628,108,0,721,15,1100,364,293,428
8,"BRAŞOV","#N/A",40198,,41,"BRAŞOV / ŞCOALA GIMNAZIALĂ Nr. 19",1,3752,"MUNICIPIUL BRAŞOV",40198,1624,1132,1025,105,2,1103,29,1800,668,485,618
8,"BRAŞOV","#N/A",40198,,42,"BRAŞOV / ŞCOALA GIMNAZIALĂ Nr. 19",1,3752,"MUNICIPIUL BRAŞOV",40198,1433,954,885,69,0,944,10,1600,646,372,572
8,"BRAŞOV","#N/A",40198,,43,"BRAŞOV / Vila Orizont",1,3752,"MUNICIPIUL BRAŞOV",40198,330,668,170,498,0,654,14,900,232,169,485
8,"BRAŞOV","#N/A",40198,,44,"BRAŞOV / ŞCOALA GIMNAZIALĂ Nr. 27 ""ANATOL GHERMANSCHI""",1,3752,"MUNICIPIUL BRAŞOV",40198,1570,1097,971,126,0,1090,7,1800,703,373,717
8,"BRAŞOV","#N/A",40198,,45,"BRAŞOV / ŞCOALA GIMNAZIALĂ Nr. 27 ""ANATOL GHERMANSCHI""",1,3752,"MUNICIPIUL BRAŞOV",40198,1560,1031,945,85,1,1003,28,1700,669,345,658
8,"BRAŞOV","#N/A",40198,,46,"BRAŞOV / ŞCOALA GIMNAZIALĂ Nr. 27 ""ANATOL GHERMANSCHI""",1,3752,"MUNICIPIUL BRAŞOV",40198,678,583,437,146,0,581,2,900,317,208,373
8,"BRAŞOV","#N/A",40198,,47,"BRAŞOV / ŞCOALA GIMNAZIALĂ Nr. 27 ""ANATOL GHERMANSCHI""",1,3752,"MUNICIPIUL BRAŞOV",40198,1644,1107,1010,96,1,1078,29,1800,693,457,621
8,"BRAŞOV","#N/A",40198,,48,"BRAŞOV / ŞCOALA GIMNAZIALĂ Nr. 27 ""ANATOL GHERMANSCHI""",1,3752,"MUNICIPIUL BRAŞOV",40198,1538,1044,947,96,1,1025,19,1700,656,380,645
8,"BRAŞOV","#N/A",40198,,49,"BRAŞOV / ŞCOALA GIMNAZIALĂ Nr. 27 ""ANATOL GHERMANSCHI""",1,3752,"MUNICIPIUL BRAŞOV",40198,1610,1041,983,58,0,1008,33,1800,759,402,606
8,"BRAŞOV","#N/A",40198,,50,"BRAŞOV / ŞCOALA GIMNAZIALĂ Nr. 27 ""ANATOL GHERMANSCHI""",1,3752,"MUNICIPIUL BRAŞOV",40198,1665,1114,1046,68,0,1106,8,1800,686,455,651
8,"BRAŞOV","#N/A",40198,,51,"BRAŞOV / ŞCOALA GIMNAZIALĂ Nr. 11 ""ST.O.IOSIF""",1,3752,"MUNICIPIUL BRAŞOV",40198,1249,842,771,71,0,819,23,1400,558,296,523
8,"BRAŞOV","#N/A",40198,,52,"BRAŞOV / ŞCOALA GIMNAZIALĂ Nr. 11 ""ST.O.IOSIF""",1,3752,"MUNICIPIUL BRAŞOV",40198,1606,969,918,51,0,954,15,1700,731,358,596
8,"BRAŞOV","#N/A",40198,,53,"BRAŞOV / ŞCOALĂ GENERALĂ nr. 11 ŞTEFAN OCTAVIAN IOSIF",1,3752,"MUNICIPIUL BRAŞOV",40198,1470,855,815,40,0,834,21,1600,745,343,491
8,"BRAŞOV","#N/A",40198,,54,"BRAŞOV / ŞCOALĂ GENERALĂ nr. 11 ŞTEFAN OCTAVIAN IOSIF",1,3752,"MUNICIPIUL BRAŞOV",40198,1030,653,640,13,0,642,11,1100,447,241,401
8,"BRAŞOV","#N/A",40198,,55,"BRAŞOV / ŞCOALA GIMNAZIALĂ Nr. 11 ""ST.O.IOSIF""",1,3752,"MUNICIPIUL BRAŞOV",40198,1147,684,644,40,0,667,17,1300,616,291,376
8,"BRAŞOV","#N/A",40198,,56,"BRAŞOV / ŞCOALA GIMNAZIALĂ Nr. 11 ""ST.O.IOSIF""",1,3752,"MUNICIPIUL BRAŞOV",40198,985,508,477,31,0,502,6,1100,592,195,307
8,"BRAŞOV","#N/A",40198,,57,"BRAŞOV / ŞCOALA GIMNAZIALĂ Nr. 11 ""ST.O.IOSIF""",1,3752,"MUNICIPIUL BRAŞOV",40198,1557,881,842,39,0,858,23,1600,719,335,523
8,"BRAŞOV","#N/A",40198,,58,"BRAŞOV / ŞCOALA GIMNAZIALĂ Nr. 11 ""ST.O.IOSIF""",1,3752,"MUNICIPIUL BRAŞOV",40198,1445,810,785,25,0,799,11,1600,790,308,491
8,"BRAŞOV","#N/A",40198,,59,"BRAŞOV / ŞCOALA GIMNAZIALĂ Nr. 11",1,3752,"MUNICIPIUL BRAŞOV",40198,1307,829,778,51,0,816,13,1408,579,333,483
8,"BRAŞOV","#N/A",40198,,60,"BRAŞOV / ŞCOALA GIMNAZIALĂ Nr. 11",1,3752,"MUNICIPIUL BRAŞOV",40198,1405,916,857,58,1,897,19,1600,684,390,507
8,"BRAŞOV","#N/A",40198,,61,"BRAŞOV / ŞCOALA GIMNAZIALĂ Nr. 11",1,3752,"MUNICIPIUL BRAŞOV",40198,1304,826,759,67,0,807,19,1401,575,309,498
8,"BRAŞOV","#N/A",40198,,62,"BRAŞOV / ŞCOALA GIMNAZIALĂ Nr. 11",1,3752,"MUNICIPIUL BRAŞOV",40198,1332,814,787,27,0,794,20,1500,686,299,495
8,"BRAŞOV","#N/A",40198,,63,"BRAŞOV / ŞCOALA GIMNAZIALĂ Nr. 11",1,3752,"MUNICIPIUL BRAŞOV",40198,1651,1019,978,41,0,999,20,1800,781,329,670
8,"BRAŞOV","#N/A",40198,,64,"BRAŞOV / ŞCOALA GIMNAZIALĂ Nr. 11",1,3752,"MUNICIPIUL BRAŞOV",40198,1580,932,900,32,0,914,18,1700,768,358,556
8,"BRAŞOV","#N/A",40198,,65,"BRAŞOV / ŞCOALA GIMNAZIALĂ Nr. 25",1,3752,"MUNICIPIUL BRAŞOV",40198,1611,1091,968,123,0,1076,15,1800,709,378,698
8,"BRAŞOV","#N/A",40198,,66,"BRAŞOV / ŞCOALA GIMNAZIALĂ Nr. 25",1,3752,"MUNICIPIUL BRAŞOV",40198,1672,999,910,89,0,981,18,1800,801,325,656
8,"BRAŞOV","#N/A",40198,,67,"BRAŞOV / ŞCOALA GIMNAZIALĂ Nr. 25",1,3752,"MUNICIPIUL BRAŞOV",40198,899,607,538,69,0,591,16,1000,393,212,379
8,"BRAŞOV","#N/A",40198,,68,"BRAŞOV / ŞCOALA GIMNAZIALĂ Nr. 25",1,3752,"MUNICIPIUL BRAŞOV",40198,1676,1017,959,57,1,985,32,1800,783,323,662
8,"BRAŞOV","#N/A",40198,,69,"BRAŞOV / LICEUL DE ARTE PLASTICE ""HANS MATTIS-TEUTSCH""",1,3752,"MUNICIPIUL BRAŞOV",40198,1367,928,796,131,1,905,23,1500,572,317,588
8,"BRAŞOV","#N/A",40198,,70,"BRAŞOV / LICEUL DE ARTE PLASTICE ""HANS MATTIS-TEUTSCH""",1,3752,"MUNICIPIUL BRAŞOV",40198,1325,885,789,95,1,868,17,1500,615,292,576
8,"BRAŞOV","#N/A",40198,,71,"BRAŞOV / LICEUL DE ARTE PLASTICE ""HANS MATTIS-TEUTSCH""",1,3752,"MUNICIPIUL BRAŞOV",40198,1641,1046,995,51,0,1022,24,1800,754,380,642
8,"BRAŞOV","#N/A",40198,,72,"BRAŞOV / ŞCOALA GIMNAZIALĂ Nr. 4",1,3752,"MUNICIPIUL BRAŞOV",40198,1500,912,874,38,0,894,18,1700,788,308,586
8,"BRAŞOV","#N/A",40198,,73,"BRAŞOV / ŞCOALA GIMNAZIALĂ Nr. 4",1,3752,"MUNICIPIUL BRAŞOV",40198,1135,731,677,53,1,712,19,1201,470,223,489
8,"BRAŞOV","#N/A",40198,,74,"BRAŞOV / ŞCOALA GIMNAZIALĂ Nr. 4",1,3752,"MUNICIPIUL BRAŞOV",40198,1320,866,806,60,0,842,24,1500,634,335,507
8,"BRAŞOV","#N/A",40198,,75,"BRAŞOV / ŞCOALA GIMNAZIALĂ Nr. 4",1,3752,"MUNICIPIUL BRAŞOV",40198,1368,871,776,95,0,855,16,1500,629,309,546
8,"BRAŞOV","#N/A",40198,,76,"BRAŞOV / ŞCOALA GIMNAZIALĂ Nr. 4",1,3752,"MUNICIPIUL BRAŞOV",40198,1667,1040,992,48,0,1022,18,1800,760,343,679
8,"BRAŞOV","#N/A",40198,,77,"BRAŞOV / ŞCOALA GIMNAZIALĂ Nr. 4",1,3752,"MUNICIPIUL BRAŞOV",40198,1126,724,668,56,0,709,15,1200,476,236,473
8,"BRAŞOV","#N/A",40198,,78,"BRAŞOV / ŞCOALA GIMNAZIALĂ Nr. 9 ""NICOLAE ORGHIDAN""",1,3752,"MUNICIPIUL BRAŞOV",40198,1619,868,803,65,0,853,15,1704,836,293,560
8,"BRAŞOV","#N/A",40198,,79,"BRAŞOV / ŞCOALA GIMNAZIALĂ Nr. 9 ""NICOLAE ORGHIDAN""",1,3752,"MUNICIPIUL BRAŞOV",40198,1721,991,928,63,0,973,18,1901,910,339,634
8,"BRAŞOV","#N/A",40198,,80,"BRAŞOV / ŞCOALA GIMNAZIALĂ Nr. 9 ""NICOLAE ORGHIDAN""",1,3752,"MUNICIPIUL BRAŞOV",40198,1526,952,882,36,34,934,18,1700,748,367,567
8,"BRAŞOV","#N/A",40198,,81,"BRAŞOV / ŞCOALA GIMNAZIALĂ Nr. 9",1,3752,"MUNICIPIUL BRAŞOV",40198,1610,976,868,108,0,956,20,1700,724,324,632
8,"BRAŞOV","#N/A",40198,,82,"BRAŞOV / ŞCOALA GIMNAZIALĂ Nr. 9",1,3752,"MUNICIPIUL BRAŞOV",40198,1125,684,608,76,0,666,18,1200,516,272,394
8,"BRAŞOV","#N/A",40198,,83,"BRAŞOV / ŞCOALA GIMNAZIALĂ Nr. 9",1,3752,"MUNICIPIUL BRAŞOV",40198,1248,733,693,40,0,715,18,1400,667,264,451
8,"BRAŞOV","#N/A",40198,,84,"BRAŞOV / ŞCOALĂ GENERALĂ nr. 9",1,3752,"MUNICIPIUL BRAŞOV",40198,1356,795,740,55,0,781,14,1500,705,244,537
8,"BRAŞOV","#N/A",40198,,85,"BRAŞOV / ŞCOALA GIMNAZIALĂ Nr. 9",1,3752,"MUNICIPIUL BRAŞOV",40198,1477,814,758,55,1,792,22,1600,786,315,477
8,"BRAŞOV","#N/A",40198,,86,"BRAŞOV / ŞCOALA GIMNAZIALĂ Nr. 9",1,3752,"MUNICIPIUL BRAŞOV",40198,1663,956,922,34,0,935,21,1800,844,353,582
8,"BRAŞOV","#N/A",40198,,87,"BRAŞOV / ŞCOALA GIMNAZIALĂ Nr. 9",1,3752,"MUNICIPIUL BRAŞOV",40198,1606,935,886,48,1,912,23,1800,865,354,558
8,"BRAŞOV","#N/A",40198,,88,"BRAŞOV / ŞCOALA GIMNAZIALĂ Nr. 9",1,3752,"MUNICIPIUL BRAŞOV",40198,1595,889,857,32,0,864,25,1700,811,356,508
8,"BRAŞOV","#N/A",40198,,89,"BRAŞOV / ŞCOALA GIMNAZIALĂ Nr. 3 ""GHEORGHE LAZĂR""",1,3752,"MUNICIPIUL BRAŞOV",40198,1674,1143,1040,102,1,1117,26,1800,657,438,679
8,"BRAŞOV","#N/A",40198,,90,"BRAŞOV / ŞCOALA GIMNAZIALĂ Nr. 3 ""GHEORGHE LAZĂR""",1,3752,"MUNICIPIUL BRAŞOV",40198,1701,1022,968,54,0,1002,20,1800,778,399,603
8,"BRAŞOV","#N/A",40198,,91,"BRAŞOV / ŞCOALA GIMNAZIALĂ Nr. 3 ""GHEORGHE LAZĂR""",1,3752,"MUNICIPIUL BRAŞOV",40198,1760,1166,1064,100,2,1138,28,1900,734,479,659
8,"BRAŞOV","#N/A",40198,,92,"BRAŞOV / ŞCOALA GIMNAZIALĂ Nr. 3 ""GHEORGHE LAZĂR""",1,3752,"MUNICIPIUL BRAŞOV",40198,1360,847,814,32,1,833,14,1500,653,358,475
8,"BRAŞOV","#N/A",40198,,93,"BRAŞOV / ŞCOALA GIMNAZIALĂ Nr. 3 ""GHEORGHE LAZĂR""",1,3752,"MUNICIPIUL BRAŞOV",40198,1631,1012,972,38,2,988,24,1800,788,400,588
8,"BRAŞOV","#N/A",40198,,94,"BRAŞOV / ŞCOALA GIMNAZIALĂ Nr. 3 ""GHEORGHE LAZĂR""",1,3752,"MUNICIPIUL BRAŞOV",40198,1577,1044,944,100,0,1022,22,1700,656,380,642
8,"BRAŞOV","#N/A",40198,,95,"BRAŞOV / ŞCOALA GIMNAZIALĂ Nr. 3 ""GHEORGHE LAZĂR""",1,3752,"MUNICIPIUL BRAŞOV",40198,1779,1209,1093,110,6,1195,14,2000,791,436,759
8,"BRAŞOV","#N/A",40198,,96,"BRAŞOV / LICEUL TEHNOLOGIC SILVIC ""DOCTOR NICOLAE RUCĂREANU""",1,3752,"MUNICIPIUL BRAŞOV",40198,1156,750,685,65,0,737,13,1304,554,300,437
8,"BRAŞOV","#N/A",40198,,97,"BRAŞOV / LICEUL TEHNOLOGIC SILVIC ""DOCTOR NICOLAE RUCĂREANU""",1,3752,"MUNICIPIUL BRAŞOV",40198,1453,978,909,67,2,953,25,1600,622,390,563
8,"BRAŞOV","#N/A",40198,,98,"BRAŞOV / LICEUL TEHNOLOGIC SILVIC ""DOCTOR NICOLAE RUCĂREANU""",1,3752,"MUNICIPIUL BRAŞOV",40198,888,559,536,23,0,547,12,1000,441,232,315
8,"BRAŞOV","#N/A",40198,,99,"BRAŞOV / LICEUL TEHNOLOGIC SILVIC ""DOCTOR NICOLAE RUCĂREANU""",1,3752,"MUNICIPIUL BRAŞOV",40198,1569,963,936,27,0,941,22,1700,737,418,523
8,"BRAŞOV","#N/A",40198,,100,"BRAŞOV / ŞCOALA GIMNAZIALĂ Nr. 2",1,3752,"MUNICIPIUL BRAŞOV",40198,1616,1035,928,104,3,1011,24,1800,765,441,570
8,"BRAŞOV","#N/A",40198,,101,"BRAŞOV / ŞCOALA GIMNAZIALĂ Nr. 2",1,3752,"MUNICIPIUL BRAŞOV",40198,1551,1077,957,120,0,1051,26,1700,623,417,634
8,"BRAŞOV","#N/A",40198,,102,"BRAŞOV / ŞCOALA GIMNAZIALĂ Nr. 2",1,3752,"MUNICIPIUL BRAŞOV",40198,1562,1070,996,73,1,1050,20,1700,630,445,605
8,"BRAŞOV","#N/A",40198,,103,"BRAŞOV / ŞCOALA GIMNAZIALĂ Nr. 2",1,3752,"MUNICIPIUL BRAŞOV",40198,1658,1073,974,97,2,1050,23,1800,727,425,625
8,"BRAŞOV","#N/A",40198,,104,"BRAŞOV / ŞCOALA GIMNAZIALĂ NR. 2",1,3752,"MUNICIPIUL BRAŞOV",40198,1856,1209,1089,118,2,1188,21,2000,791,473,715
8,"BRAŞOV","#N/A",40198,,105,"BRAŞOV / ŞCOALA GIMNAZIALĂ Nr. 2",1,3752,"MUNICIPIUL BRAŞOV",40198,1579,934,850,84,0,912,22,1697,763,372,540
8,"BRAŞOV","#N/A",40198,,106,"BRAŞOV / COLEGIUL DE ŞTIINŢE ""GRIGORE ANTIPA""",1,3752,"MUNICIPIUL BRAŞOV",40198,1576,1088,902,118,68,1066,22,1700,612,399,667
8,"BRAŞOV","#N/A",40198,,107,"BRAŞOV / COLEGIUL DE ŞTIINŢE ""GRIGORE ANTIPA""",1,3752,"MUNICIPIUL BRAŞOV",40198,1526,1039,887,90,62,1017,22,1700,661,351,666
8,"BRAŞOV","#N/A",40198,,108,"BRAŞOV / COLEGIUL DE ŞTIINŢE ""GRIGORE ANTIPA""",1,3752,"MUNICIPIUL BRAŞOV",40198,1482,988,834,98,56,962,26,1600,612,301,661
8,"BRAŞOV","#N/A",40198,,109,"BRAŞOV / COLEGIUL DE ŞTIINŢE ""GRIGORE ANTIPA""",1,3752,"MUNICIPIUL BRAŞOV",40198,1280,919,809,57,53,902,17,1400,481,331,571
8,"BRAŞOV","#N/A",40198,,110,"BRAŞOV / COLEGIUL NAŢIONAL DE INFORMATICĂ ""GRIGORE MOISIL""",1,3752,"MUNICIPIUL BRAŞOV",40198,1309,861,757,104,0,848,13,1400,539,331,517
8,"BRAŞOV","#N/A",40198,,111,"BRAŞOV / COLEGIUL NAŢIONAL DE INFORMATICĂ ""GRIGORE MOISIL""",1,3752,"MUNICIPIUL BRAŞOV",40198,1490,1061,869,169,23,1039,22,1600,539,378,661
8,"BRAŞOV","#N/A",40198,,112,"BRAŞOV / COLEGIUL NAŢIONAL DE INFORMATICĂ ""GRIGORE MOISIL""",1,3752,"MUNICIPIUL BRAŞOV",40198,1671,1024,899,125,0,1000,24,1700,647,381,619
8,"BRAŞOV","#N/A",40198,,113,"BRAŞOV / COLEGIUL NAŢIONAL DE INFORMATICĂ ""GRIGORE MOISIL""",1,3752,"MUNICIPIUL BRAŞOV",40198,1432,920,843,77,0,906,14,1600,680,353,553
8,"BRAŞOV","#N/A",40198,,114,"BRAŞOV / COLEGIUL NAŢIONAL DE INFORMATICĂ ""GRIGORE MOISIL""",1,3752,"MUNICIPIUL BRAŞOV",40198,1728,1185,1105,80,0,1170,15,1900,715,436,734
8,"BRAŞOV","#N/A",40198,,115,"BRAŞOV / COLEGIUL NAŢIONAL DE INFORMATICĂ ""GRIGORE MOISIL""",1,3752,"MUNICIPIUL BRAŞOV",40198,1074,671,589,82,0,661,10,1200,529,253,408
8,"BRAŞOV","#N/A",40198,,116,"BRAŞOV / COLEGIUL NAŢIONAL DE INFORMATICĂ ""GRIGORE MOISIL""",1,3752,"MUNICIPIUL BRAŞOV",40198,1345,910,790,120,0,889,21,1500,590,342,547
8,"BRAŞOV","#N/A",40198,,117,"BRAŞOV / COLEGIUL NAŢIONAL DE INFORMATICĂ ""GRIGORE MOISIL""",1,3752,"MUNICIPIUL BRAŞOV",40198,1601,1135,997,137,1,1112,23,1800,665,411,701
8,"BRAŞOV","#N/A",40198,,118,"BRAŞOV / LICEUL CU PROGRAM SPORTIV",1,3752,"MUNICIPIUL BRAŞOV",40198,1660,1115,1027,87,1,1086,29,1800,685,443,643
8,"BRAŞOV","#N/A",40198,,119,"BRAŞOV / LICEUL CU PROGRAM SPORTIV",1,3752,"MUNICIPIUL BRAŞOV",40198,1132,698,649,48,1,683,15,1200,502,255,428
8,"BRAŞOV","#N/A",40198,,120,"BRAŞOV / LICEUL CU PROGRAM SPORTIV",1,3752,"MUNICIPIUL BRAŞOV",40198,1335,838,799,39,0,825,13,1500,662,310,515
8,"BRAŞOV","#N/A",40198,,121,"BRAŞOV / LICEUL CU PROGRAM SPORTIV",1,3752,"MUNICIPIUL BRAŞOV",40198,1586,947,923,24,0,927,20,1700,753,394,533
8,"BRAŞOV","#N/A",40198,,122,"BRAŞOV / LICEUL CU PROGRAM SPORTIV",1,3752,"MUNICIPIUL BRAŞOV",40198,1496,971,898,73,0,939,32,1600,629,397,542
8,"BRAŞOV","#N/A",40198,,123,"BRAŞOV / ŞCOALA GIMNAZIALĂ Nr. 1",1,3752,"MUNICIPIUL BRAŞOV",40198,1555,1006,948,56,2,987,19,1700,694,406,581
8,"BRAŞOV","#N/A",40198,,124,"BRAŞOV / ŞCOALA GIMNAZIALĂ Nr. 1",1,3752,"MUNICIPIUL BRAŞOV",40198,1470,928,881,47,0,907,21,1600,672,373,534
8,"BRAŞOV","#N/A",40198,,125,"BRAŞOV / ŞCOALA GIMNAZIALĂ Nr. 1",1,3752,"MUNICIPIUL BRAŞOV",40198,1458,954,861,93,0,926,28,1600,646,348,578
8,"BRAŞOV","#N/A",40198,,126,"BRAŞOV / ŞCOALA GIMNAZIALĂ Nr. 1",1,3752,"MUNICIPIUL BRAŞOV",40198,1793,1110,1029,76,5,1091,19,1900,790,377,714
8,"BRAŞOV","#N/A",40198,,127,"BRAŞOV / ŞCOALA GIMNAZIALĂ Nr. 1",1,3752,"MUNICIPIUL BRAŞOV",40198,1632,952,912,40,0,931,21,1700,748,407,524
8,"BRAŞOV","#N/A",40198,,128,"BRAŞOV / ŞCOALA GIMNAZIALĂ Nr. 1",1,3752,"MUNICIPIUL BRAŞOV",40198,990,642,610,32,0,627,15,1100,458,254,373
8,"BRAŞOV","#N/A",40198,,129,"BRAŞOV / ŞCOALA GIMNAZIALĂ Nr. 1",1,3752,"MUNICIPIUL BRAŞOV",40198,1080,671,635,36,0,664,7,1200,529,306,358
8,"BRAŞOV","#N/A",40198,,130,"BRAŞOV / ŞCOALA GIMNAZIALĂ Nr. 1",1,3752,"MUNICIPIUL BRAŞOV",40198,1715,1079,1030,49,0,1060,19,1900,821,411,649
8,"BRAŞOV","#N/A",40198,,131,"BRAŞOV / CENTRUL REGIONAL DE FORMARE PROFESIONALĂ BRAŞOV",1,3752,"MUNICIPIUL BRAŞOV",40198,1043,574,520,52,2,556,18,1100,526,212,344
8,"BRAŞOV","#N/A",40198,,132,"BRAŞOV / CENTRUL REGIONAL DE FORMARE PROFESIONALĂ BRAŞOV",1,3752,"MUNICIPIUL BRAŞOV",40198,1358,803,742,60,1,786,17,1500,697,337,449
8,"BRAŞOV","#N/A",40198,,133,"BRAŞOV / ŞCOALA GIMNAZIALĂ Nr.  15",1,3752,"MUNICIPIUL BRAŞOV",40198,1182,832,718,114,0,818,14,1300,468,222,596
8,"BRAŞOV","#N/A",40198,,134,"BRAŞOV / CANTINA STUDENŢEASCĂ",1,3752,"MUNICIPIUL BRAŞOV",40198,1767,1929,1062,867,0,1902,27,2500,571,477,1425
8,"BRAŞOV","#N/A",40198,,135,"BRAŞOV / COLEGIUL NAŢIONAL ECONOMIC ""ANDREI BÂRSEANU""",1,3752,"MUNICIPIUL BRAŞOV",40198,1434,900,836,64,0,878,22,1600,700,273,605
8,"BRAŞOV","#N/A",40198,,136,"BRAŞOV / COLEGIUL NAŢIONAL ECONOMIC ""ANDREI BÂRSEANU""",1,3752,"MUNICIPIUL BRAŞOV",40198,1306,837,755,80,2,822,15,1400,563,243,579
8,"BRAŞOV","#N/A",40198,,137,"BRAŞOV / COLEGIUL NAŢIONAL ECONOMIC ""ANDREI BÂRSEANU""",1,3752,"MUNICIPIUL BRAŞOV",40198,1228,856,756,59,41,842,14,1400,544,236,606
8,"BRAŞOV","#N/A",40198,,138,"BRAŞOV / ŞCOALA GIMNAZIALĂ Nr. 14",1,3752,"MUNICIPIUL BRAŞOV",40198,1357,781,687,94,0,769,12,1500,719,238,531
8,"BRAŞOV","#N/A",40198,,139,"BRAŞOV / ŞCOALA GIMNAZIALĂ Nr. 14",1,3752,"MUNICIPIUL BRAŞOV",40198,1518,844,787,57,0,827,17,1600,756,270,557
8,"BRAŞOV","#N/A",40198,,140,"BRAŞOV / ŞCOALA GIMNAZIALĂ Nr. 14",1,3752,"MUNICIPIUL BRAŞOV",40198,1703,1034,951,82,1,1022,12,1800,766,377,645
8,"BRAŞOV","#N/A",40198,,141,"BRAŞOV / ŞCOALA GIMNAZIALĂ Nr. 14",1,3752,"MUNICIPIUL BRAŞOV",40198,1531,943,808,135,0,926,17,1700,757,286,640
8,"BRAŞOV","#N/A",40198,,142,"BRAŞOV / ŞCOALA GIMNAZIALĂ Nr. 14",1,3752,"MUNICIPIUL BRAŞOV",40198,1381,875,755,120,0,862,13,1500,625,253,609
8,"BRAŞOV","#N/A",40198,,143,"BRAŞOV / ŞCOALA GIMNAZIALĂ Nr. 14",1,3752,"MUNICIPIUL BRAŞOV",40198,1703,989,920,69,0,977,12,1800,811,284,693
8,"BRAŞOV","#N/A",40198,,144,"BRAŞOV / ŞCOALA GIMNAZIALĂ Nr. 14",1,3752,"MUNICIPIUL BRAŞOV",40198,1580,976,896,80,0,965,11,1700,724,252,713
8,"BRAŞOV","#N/A",40198,,145,"BRAŞOV / ŞCOALA GIMNAZIALĂ Nr. 14",1,3752,"MUNICIPIUL BRAŞOV",40198,1634,964,900,64,0,944,20,1800,836,277,667
8,"BRAŞOV","#N/A",40198,,146,"BRAŞOV / ŞCOALA GIMNAZIALĂ Nr. 14",1,3752,"MUNICIPIUL BRAŞOV",40198,1578,964,851,113,0,953,11,1700,736,321,632
8,"BRAŞOV","#N/A",40198,,147,"BRAŞOV / ŞCOALA GIMNAZIALĂ Nr. 14",1,3752,"MUNICIPIUL BRAŞOV",40198,1765,1104,996,108,0,1078,26,1800,696,300,778
8,"BRAŞOV","#N/A",40198,,148,"BRAŞOV / ŞCOALA GIMNAZIALĂ Nr. 14",1,3752,"MUNICIPIUL BRAŞOV",40198,1428,839,753,86,0,823,16,1600,761,224,599
8,"BRAŞOV","#N/A",40198,,149,"BRAŞOV / ŞCOALA GIMNAZIALĂ Nr. 14",1,3752,"MUNICIPIUL BRAŞOV",40198,1660,1203,1117,85,1,1190,13,1800,597,274,916
8,"BRAŞOV","#N/A",40198,,150,"BRAŞOV / ŞCOALA GIMNAZIALĂ Nr. 14",1,3752,"MUNICIPIUL BRAŞOV",40198,1311,847,809,38,0,841,6,1400,553,203,638
8,"BRAŞOV","#N/A",40198,,151,"BRAŞOV / ŞCOALA GIMNAZIALĂ Nr. 30",1,3752,"MUNICIPIUL BRAŞOV",40198,1677,1089,1047,41,1,1062,27,1800,707,381,681
8,"BRAŞOV","#N/A",40198,,152,"BRAŞOV / ŞCOALA GIMNAZIALĂ Nr. 30",1,3752,"MUNICIPIUL BRAŞOV",40198,1745,1205,1132,73,0,1188,17,1900,695,402,786
8,"BRAŞOV","#N/A",40198,,153,"BRAŞOV / ŞCOALA GIMNAZIALĂ Nr. 30",1,3752,"MUNICIPIUL BRAŞOV",40198,1737,1176,1085,90,1,1148,28,1900,724,440,708
8,"BRAŞOV","#N/A",40198,,154,"BRAŞOV / ŞCOALA GIMNAZIALĂ Nr. 30",1,3752,"MUNICIPIUL BRAŞOV",40198,1646,1013,939,74,0,993,20,1797,784,385,608
8,"BRAŞOV","#N/A",40198,,155,"BRAŞOV / ŞCOALA GIMNAZIALĂ Nr. 13",1,3752,"MUNICIPIUL BRAŞOV",40198,1418,956,810,139,7,932,24,1600,644,383,549
8,"BRAŞOV","#N/A",40198,,156,"BRAŞOV / ŞCOALA GIMNAZIALĂ Nr. 13",1,3752,"MUNICIPIUL BRAŞOV",40198,1320,988,828,107,53,971,17,1500,512,396,575
8,"BRAŞOV","#N/A",40198,,157,"BRAŞOV / ŞCOALA GIMNAZIALĂ Nr. 13",1,3752,"MUNICIPIUL BRAŞOV",40198,1629,1082,1015,67,0,1070,12,1800,718,434,636
8,"BRAŞOV","#N/A",40198,,158,"BRAŞOV / ŞCOALA GIMNAZIALĂ Nr. 13",1,3752,"MUNICIPIUL BRAŞOV",40198,1619,993,942,51,0,981,12,1800,807,368,613
8,"BRAŞOV","#N/A",40198,,159,"BRAŞOV / ŞCOALA GIMNAZIALĂ Nr. 13",1,3752,"MUNICIPIUL BRAŞOV",40198,1745,1084,1029,55,0,1063,21,1800,716,487,576
8,"BRAŞOV","#N/A",40198,,160,"BRAŞOV / COLEGIUL ""NICOLAE TITULESCU""",1,3752,"MUNICIPIUL BRAŞOV",40198,1726,949,820,129,0,936,13,1800,851,369,567
8,"BRAŞOV","#N/A",40198,,161,"BRAŞOV / COLEGIUL ""NICOLAE TITULESCU""",1,3752,"MUNICIPIUL BRAŞOV",40198,1588,930,849,81,0,915,15,1702,772,417,498
8,"BRAŞOV","#N/A",40198,,162,"BRAŞOV / COLEGIUL ""NICOLAE TITULESCU""",1,3752,"MUNICIPIUL BRAŞOV",40198,1555,918,850,68,0,906,12,1700,782,357,549
8,"BRAŞOV","#N/A",40198,,163,"BRAŞOV / COLEGIUL ""NICOLAE TITULESCU""",1,3752,"MUNICIPIUL BRAŞOV",40198,1560,914,870,44,0,903,11,1696,782,370,533
8,"BRAŞOV","#N/A",40198,,164,"BRAŞOV / COLEGIUL ""NICOLAE TITULESCU""",1,3752,"MUNICIPIUL BRAŞOV",40198,1735,1024,970,53,1,1003,21,1800,776,393,610
8,"BRAŞOV","#N/A",40198,,165,"BRAŞOV / COLEGIUL ""NICOLAE TITULESCU""",1,3752,"MUNICIPIUL BRAŞOV",40198,1604,871,831,40,0,862,9,1700,829,337,525
8,"BRAŞOV","#N/A",40198,,166,"BRAŞOV / ŞCOALA PROFESIONALĂ GERMANĂ ""KRONSTADT""",1,3752,"MUNICIPIUL BRAŞOV",40198,777,530,479,51,0,522,8,900,370,177,345
8,"BRAŞOV","#N/A",40198,,167,"BRAŞOV / COLEGIUL TEHNIC DE TRANSPORTURI",1,3752,"MUNICIPIUL BRAŞOV",40198,802,514,436,78,0,504,10,900,386,157,347
8,"BRAŞOV","#N/A",40198,,168,"BRAŞOV / COLEGIUL TEHNIC DE TRANSPORTURI",1,3752,"MUNICIPIUL BRAŞOV",40198,1228,745,712,32,1,728,17,1400,655,341,387
8,"BRAŞOV","#N/A",40198,,169,"BRAŞOV / COLEGIUL TEHNIC DE TRANSPORTURI",1,3752,"MUNICIPIUL BRAŞOV",40198,1671,996,961,34,1,982,14,1800,804,392,590
8,"BRAŞOV","#N/A",40198,,170,"BRAŞOV / ŞCOALA GIMNAZIALĂ Nr. 31",1,3752,"MUNICIPIUL BRAŞOV",40198,1416,868,824,42,2,850,18,1600,732,356,494
8,"BRAŞOV","#N/A",40198,,171,"BRAŞOV / ŞCOALA GIMNAZIALĂ Nr. 31",1,3752,"MUNICIPIUL BRAŞOV",40198,1455,906,847,59,0,880,26,1600,694,360,520
8,"BRAŞOV","#N/A",40198,,172,"BRAŞOV / ŞCOALA GIMNAZIALĂ Nr. 31",1,3752,"MUNICIPIUL BRAŞOV",40198,1272,749,704,45,0,730,19,1400,651,334,396
8,"BRAŞOV","#N/A",40198,,173,"BRAŞOV / COLEGIUL TEHNIC ""REMUS RĂDULEŢ""",1,3752,"MUNICIPIUL BRAŞOV",40198,614,382,303,79,0,379,3,700,318,127,252
8,"BRAŞOV","#N/A",40198,,174,"BRAŞOV / COLEGIUL TEHNIC ""REMUS RĂDULEŢ""",1,3752,"MUNICIPIUL BRAŞOV",40198,1107,649,609,40,0,637,12,1200,551,233,404
8,"BRAŞOV","#N/A",40198,,175,"BRAŞOV / COLEGIUL TEHNIC ""REMUS RĂDULEŢ""",1,3752,"MUNICIPIUL BRAŞOV",40198,1120,601,568,33,0,587,14,1200,599,199,388
8,"BRAŞOV","#N/A",40198,,176,"BRAŞOV / COLEGIUL TEHNIC ""REMUS RĂDULEŢ""",1,3752,"MUNICIPIUL BRAŞOV",40198,1151,656,626,30,0,640,16,1300,644,227,413
8,"BRAŞOV","#N/A",40198,,177,"BRAŞOV / COLEGIUL TEHNIC ""REMUS RĂDULEŢ""",1,3752,"MUNICIPIUL BRAŞOV",40198,1121,629,608,21,0,619,10,1200,571,277,342
8,"BRAŞOV","#N/A",40241,,178,"CODLEA / COLEGIUL TEHNIC SIMION MEHEDINŢI",1,3755,"MUNICIPIUL CODLEA",40241,976,561,516,45,0,556,5,1100,539,212,344
8,"BRAŞOV","#N/A",40241,,179,"CODLEA / COLEGIUL TEHNIC SIMION MEHEDINŢI",1,3755,"MUNICIPIUL CODLEA",40241,1213,662,635,27,0,653,9,1300,638,255,398
8,"BRAŞOV","#N/A",40241,,180,"CODLEA / COLEGIUL TEHNIC SIMION MEHEDINŢI",1,3755,"MUNICIPIUL CODLEA",40241,1133,687,651,36,0,679,8,1200,513,332,347
8,"BRAŞOV","#N/A",40241,,181,"CODLEA / COLEGIUL TEHNIC SIMION MEHEDINTI",1,3755,"MUNICIPIUL CODLEA",40241,1064,611,557,54,0,589,22,1200,589,217,372
8,"BRAŞOV","#N/A",40241,,182,"CODLEA / ŞCOALA GENERALA NR.2",1,3755,"MUNICIPIUL CODLEA",40241,1047,886,560,41,285,868,18,1300,414,415,453
8,"BRAŞOV","#N/A",40241,,183,"CODLEA / GRADINITA NR.1",1,3755,"MUNICIPIUL CODLEA",40241,1179,1013,665,43,305,992,21,1400,387,573,419
8,"BRAŞOV","#N/A",40241,,184,"CODLEA / GRADINITA NR.1",1,3755,"MUNICIPIUL CODLEA",40241,1238,711,657,54,0,698,13,1400,689,238,460
8,"BRAŞOV","#N/A",40241,,185,"CODLEA / GRUP SCOLAR FORESTIER",1,3755,"MUNICIPIUL CODLEA",40241,1534,958,872,85,1,949,9,1700,742,355,594
8,"BRAŞOV","#N/A",40241,,186,"CODLEA / ŞCOALA GENERALA NR.1",1,3755,"MUNICIPIUL CODLEA",40241,1392,786,721,51,14,782,4,1500,714,353,429
8,"BRAŞOV","#N/A",40241,,187,"CODLEA / GRADINITA NR.4",1,3755,"MUNICIPIUL CODLEA",40241,1372,697,678,19,0,689,8,1500,803,269,420
8,"BRAŞOV","#N/A",40241,,188,"CODLEA / GRADINITA NR.4",1,3755,"MUNICIPIUL CODLEA",40241,1731,1041,996,45,0,1023,18,1800,759,466,557
8,"BRAŞOV","#N/A",40241,,189,"CODLEA / ŞCOALA GENERALA NR. 3",1,3755,"MUNICIPIUL CODLEA",40241,1004,582,530,52,0,571,11,1100,518,197,374
8,"BRAŞOV","#N/A",40241,,190,"CODLEA / ŞCOALA GENERALA NR. 3",1,3755,"MUNICIPIUL CODLEA",40241,1470,779,759,20,0,764,15,1600,821,333,431
8,"BRAŞOV","#N/A",40241,,191,"CODLEA / ŞCOALA GENERALA NR. 3",1,3755,"MUNICIPIUL CODLEA",40241,1091,583,562,21,0,574,9,1200,617,236,338
8,"BRAŞOV","#N/A",40241,,192,"CODLEA / LICEUL TEORETIC",1,3755,"MUNICIPIUL CODLEA",40241,1279,797,750,47,0,788,9,1400,603,321,467
8,"BRAŞOV","#N/A",40241,,193,"CODLEA / ŞCOALA DE ARTE SI MESERII",1,3755,"MUNICIPIUL CODLEA",40241,1065,674,643,30,1,668,6,1200,526,272,396
8,"BRAŞOV","#N/A",40241,,194,"CODLEA / ŞCOALA DE ARTE SI MESERII",1,3755,"MUNICIPIUL CODLEA",40241,1317,749,719,30,0,721,28,1400,651,358,363
8,"BRAŞOV","#N/A",40278,,195,"FĂGĂRAŞ / Serviciul Public de Asistenta Sociala, Str. T. Vladimirescu nr.8",1,3757,"MUNICIPIUL FĂGĂRAŞ",40278,1676,781,719,61,1,771,10,1700,919,292,479
8,"BRAŞOV","#N/A",40278,,196,"FĂGĂRAŞ / Gradinita cu Program Normal ""Voinicelul""",1,3757,"MUNICIPIUL FĂGĂRAŞ",40278,1809,860,808,51,1,848,12,1900,1040,357,491
8,"BRAŞOV","#N/A",40278,,197,"FĂGĂRAŞ / Casa  Municipală de Cultură",1,3757,"MUNICIPIUL FĂGĂRAŞ",40278,1511,847,767,80,0,836,11,1700,853,284,552
8,"BRAŞOV","#N/A",40278,,198,"FĂGĂRAŞ / Casa  Municipală de Cultură",1,3757,"MUNICIPIUL FĂGĂRAŞ",40278,1445,776,656,120,0,769,7,1500,724,239,530
8,"BRAŞOV","#N/A",40278,,199,"FĂGĂRAŞ / Şcoala Gimnazială "" Ovid Densuşianu"" - Şcoala Generală nr.4",1,3757,"MUNICIPIUL FĂGĂRAŞ",40278,1161,710,682,27,1,698,12,1300,590,318,380
8,"BRAŞOV","#N/A",40278,,200,"FĂGĂRAŞ / Fundaţia Culturală ""Negru Voda""",1,3757,"MUNICIPIUL FĂGĂRAŞ",40278,1018,590,532,58,0,582,8,1100,510,211,371
8,"BRAŞOV","#N/A",40278,,201,"FĂGĂRAŞ / Colegiul Naţional ""D-na Stanca""",1,3757,"MUNICIPIUL FĂGĂRAŞ",40278,1608,865,801,64,0,855,10,1700,835,294,561
8,"BRAŞOV","#N/A",40278,,202,"FĂGĂRAŞ / Colegiul Naţional ""D-na Stanca""",1,3757,"MUNICIPIUL FĂGĂRAŞ",40278,1472,766,718,46,2,756,10,1600,834,270,486
8,"BRAŞOV","#N/A",40278,,203,"FĂGĂRAŞ / Colegiul Naţional ""Radu Negru"" - Şcoala Generală nr.1",1,3757,"MUNICIPIUL FĂGĂRAŞ",40278,1239,713,651,62,0,707,6,1400,687,228,479
8,"BRAŞOV","#N/A",40278,,204,"FĂGĂRAŞ / Colegiul Naţional ""Radu Negru"" - Şcoala Generală nr.1",1,3757,"MUNICIPIUL FĂGĂRAŞ",40278,1445,857,744,47,66,853,4,1600,743,346,507
8,"BRAŞOV","#N/A",40278,,205,"FĂGĂRAŞ / Colegiul Naţional ""Radu Negru""",1,3757,"MUNICIPIUL FĂGĂRAŞ",40278,1243,637,565,72,0,628,9,1400,763,216,412
8,"BRAŞOV","#N/A",40278,,206,"FĂGĂRAŞ / Colegiul Naţional ""Radu Negru""",1,3757,"MUNICIPIUL FĂGĂRAŞ",40278,1513,753,710,43,0,737,16,1600,847,240,497
8,"BRAŞOV","#N/A",40278,,207,"FĂGĂRAŞ / Colegiul Naţional ""D-na Stanca""-Şcoala Gimnazială nr.7",1,3757,"MUNICIPIUL FĂGĂRAŞ",40278,1705,760,720,39,1,752,8,1800,1040,288,464
8,"BRAŞOV","#N/A",40278,,208,"FĂGĂRAŞ / Colegiul Naţional ""D-na Stanca""-Şcoala Gimnazială nr.7",1,3757,"MUNICIPIUL FĂGĂRAŞ",40278,1738,766,743,23,0,758,8,1800,1034,283,475
8,"BRAŞOV","#N/A",40278,,209,"FĂGĂRAŞ / Colegiul Naţional ""D-na Stanca""-Şcoala Gimnazială nr. 7",1,3757,"MUNICIPIUL FĂGĂRAŞ",40278,1677,833,786,47,0,824,9,1800,967,313,511
8,"BRAŞOV","#N/A",40278,,210,"FĂGĂRAŞ / Colegiul ""Aurel Vijoli""",1,3757,"MUNICIPIUL FĂGĂRAŞ",40278,1499,643,608,35,0,633,10,1600,957,310,323
8,"BRAŞOV","#N/A",40278,,211,"FĂGĂRAŞ / Colegiul ""Aurel Vijoli""",1,3757,"MUNICIPIUL FĂGĂRAŞ",40278,1180,507,460,47,0,502,5,1300,793,242,260
8,"BRAŞOV","#N/A",40278,,212,"FĂGĂRAŞ / SC Apa Canal Sibiu SA Sucursala Fagaras",1,3757,"MUNICIPIUL FĂGĂRAŞ",40278,1249,594,554,40,0,587,7,1400,806,206,381
8,"BRAŞOV","#N/A",40278,,213,"FĂGĂRAŞ / Liceul Teologic Ortodox ""Sf. Constantin Brâncoveanu""",1,3757,"MUNICIPIUL FĂGĂRAŞ",40278,1321,679,638,39,2,674,5,1500,821,230,444
8,"BRAŞOV","#N/A",40278,,214,"FĂGĂRAŞ / Liceul Teologic Ortodox "" Sf.. Constantin Brâncoveanu""",1,3757,"MUNICIPIUL FĂGĂRAŞ",40278,1596,740,697,43,0,726,14,1700,960,264,462
8,"BRAŞOV","#N/A",40278,,215,"FĂGĂRAŞ / Liceul Teologic Ortodox "" Sf.. Constantin Brâncoveanu""",1,3757,"MUNICIPIUL FĂGĂRAŞ",40278,1727,813,792,21,0,806,7,1800,987,275,531
8,"BRAŞOV","#N/A",40278,,216,"FĂGĂRAŞ / Liceul Teologic Ortodox "" Sf.. Constantin Brâncoveanu"" -Grădiniţa cu program normal ""Mateiaş Brâncoveanu"",",1,3757,"MUNICIPIUL FĂGĂRAŞ",40278,1315,678,636,42,0,671,7,1400,722,243,428
8,"BRAŞOV","#N/A",40278,,217,"FĂGĂRAŞ / Şcoala Gimnazială "" Ovid Densuşianu""",1,3757,"MUNICIPIUL FĂGĂRAŞ",40278,1173,703,636,66,1,698,5,1300,597,271,427
8,"BRAŞOV","#N/A",40438,,218,"SĂCELE / Şcoala generală   nr. 1, Corpul nr. 1, (lângă grădiniţă)",1,3759,"MUNICIPIUL SĂCELE",40438,1831,1282,1195,86,1,1264,18,2000,718,344,920
8,"BRAŞOV","#N/A",40438,,219,"SĂCELE / Şcoala Generală   nr. 1Corpul 2",1,3759,"MUNICIPIUL SĂCELE",40438,1698,989,890,99,0,971,18,1800,811,406,565
8,"BRAŞOV","#N/A",40438,,220,"SĂCELE / Şcoala generalănr. 2",1,3759,"MUNICIPIUL SĂCELE",40438,1708,1059,986,72,1,1043,16,1900,841,318,725
8,"BRAŞOV","#N/A",40438,,221,"SĂCELE / Liceu Zajzoni Rab Istvan",1,3759,"MUNICIPIUL SĂCELE",40438,1607,995,954,40,1,977,18,1800,805,256,721
8,"BRAŞOV","#N/A",40438,,222,"SĂCELE / Şcoala generală nr.6",1,3759,"MUNICIPIUL SĂCELE",40438,1647,1130,1085,44,1,1124,6,1800,670,231,893
8,"BRAŞOV","#N/A",40438,,223,"SĂCELE / Şcoala generală nr.6",1,3759,"MUNICIPIUL SĂCELE",40438,1519,969,885,84,0,949,20,1700,731,275,674
8,"BRAŞOV","#N/A",40438,,224,"SĂCELE / Sala de Sport",1,3759,"MUNICIPIUL SĂCELE",40438,1534,881,846,33,2,873,8,1700,819,329,544
8,"BRAŞOV","#N/A",40438,,225,"SĂCELE / Sala de Sport",1,3759,"MUNICIPIUL SĂCELE",40438,1368,829,800,29,0,817,12,1500,671,367,450
8,"BRAŞOV","#N/A",40438,,226,"SĂCELE / Liceul George Moroianu",1,3759,"MUNICIPIUL SĂCELE",40438,1669,1100,1041,59,0,1085,15,1800,700,219,866
8,"BRAŞOV","#N/A",40438,,227,"SĂCELE / Şcoala generală nr.4",1,3759,"MUNICIPIUL SĂCELE",40438,1676,1124,1056,67,1,1110,14,1800,676,355,755
8,"BRAŞOV","#N/A",40438,,228,"SĂCELE / Grup Şcolar Industrial Victor Jinga",1,3759,"MUNICIPIUL SĂCELE",40438,1074,558,535,22,1,543,15,1200,642,212,331
8,"BRAŞOV","#N/A",40438,,229,"SĂCELE / Grup Şcolar Industrial Victor Jinga",1,3759,"MUNICIPIUL SĂCELE",40438,1175,677,659,18,0,665,12,1300,623,322,343
8,"BRAŞOV","#N/A",40438,,230,"SĂCELE / Şcoala generală, nr.4",1,3759,"MUNICIPIUL SĂCELE",40438,1518,910,859,51,0,898,12,1600,690,340,558
8,"BRAŞOV","#N/A",40438,,231,"SĂCELE / Şcoala generală, nr.4",1,3759,"MUNICIPIUL SĂCELE",40438,1404,858,818,40,0,844,14,1500,642,377,467
8,"BRAŞOV","#N/A",40438,,232,"SĂCELE / Şcoala generală, nr.4",1,3759,"MUNICIPIUL SĂCELE",40438,1196,742,712,30,0,728,14,1300,558,279,449
8,"BRAŞOV","#N/A",40438,,233,"SĂCELE / Şcoala generală, nr.5",1,3759,"MUNICIPIUL SĂCELE",40438,1083,651,627,23,1,645,6,1200,549,174,471
8,"BRAŞOV","#N/A",40438,,234,"SĂCELE / Şcoala generală, nr.5",1,3759,"MUNICIPIUL SĂCELE",40438,1027,593,584,9,0,559,34,1100,507,310,249
8,"BRAŞOV","#N/A",40438,,235,"SĂCELE / Şcoala generală, nr.5",1,3759,"MUNICIPIUL SĂCELE",40438,1027,672,661,11,0,612,60,1100,428,448,164
8,"BRAŞOV","#N/A",40438,,236,"SĂCELE / Şcoala generală, nr.5",1,3759,"MUNICIPIUL SĂCELE",40438,1170,837,810,27,0,791,46,1300,463,447,344
8,"BRAŞOV","#N/A",40214,,237,"GHIMBAV / PRIMĂRIA GHIMBAV",1,3761,"ORAŞ GHIMBAV",40214,1618,1014,921,93,0,1000,14,2000,986,436,564
8,"BRAŞOV","#N/A",40214,,238,"GHIMBAV / ŞCOALA GENERALĂ  GHIMBAV CLASELE V-VIII",1,3761,"ORAŞ GHIMBAV",40214,1689,1137,1023,112,2,1116,21,1900,763,390,726
8,"BRAŞOV","#N/A",40214,,239,"GHIMBAV / ŞCOALA GENERALĂ  GHIMBAV CLASELE I-IV",1,3761,"ORAŞ GHIMBAV",40214,1620,1002,919,82,1,995,7,1800,798,337,658
8,"BRAŞOV","#N/A",40303,,240,"PREDEAL / CENTRUL DE CULTURĂ MIHAIL SAULESCU",1,3763,"ORAŞ PREDEAL",40303,1367,1578,784,793,1,1552,26,1900,322,528,1024
8,"BRAŞOV","#N/A",40303,,241,"PREDEAL / liceul teoretic Mihail Saulescu",1,3763,"ORAŞ PREDEAL",40303,1069,775,605,170,0,762,13,1200,425,292,470
8,"BRAŞOV","#N/A",40303,,242,"PREDEAL / LICEUL TEORETIC MIHAIL SĂULESCU",1,3763,"ORAŞ PREDEAL",40303,1159,990,711,278,1,970,20,1302,312,357,613
8,"BRAŞOV","#N/A",40303,,243,"TIMIŞU DE SUS / AGENŢIA POŞTALĂ",1,3763,"ORAŞ PREDEAL",40303,301,202,166,34,2,201,1,401,199,49,152
8,"BRAŞOV","#N/A",40303,,244,"TIMIŞU DE JOS / ŞCOALĂ GENERALĂ",1,3763,"ORAŞ PREDEAL",40303,370,211,195,15,1,208,3,400,189,49,159
8,"BRAŞOV","#N/A",40303,,245,"PREDEAL / CLUBUL DÂMBUL MORII",1,3763,"ORAŞ PREDEAL",40303,201,176,133,43,0,173,3,300,124,68,105
8,"BRAŞOV","#N/A",40367,,246,"RÂŞNOV / Şcoala Generală nr. 1 Râşnov",1,3768,"ORAŞ RÂŞNOV",40367,1608,1006,953,52,1,989,17,1800,794,406,583
8,"BRAŞOV","#N/A",40367,,247,"RÂŞNOV / Şcoala Generală nr. 1 Râşnov",1,3768,"ORAŞ RÂŞNOV",40367,1178,751,699,52,0,737,14,1300,549,404,333
8,"BRAŞOV","#N/A",40367,,248,"RÂŞNOV / Şcoala Generală nr. 3 Râşnov",1,3768,"ORAŞ RÂŞNOV",40367,1242,943,851,92,0,923,20,1400,457,417,506
8,"BRAŞOV","#N/A",40367,,249,"RÂŞNOV / Şcoala Generală nr. 3 Râşnov",1,3768,"ORAŞ RÂŞNOV",40367,1480,1022,948,74,0,1008,14,1600,578,430,578
8,"BRAŞOV","#N/A",40367,,250,"RÂŞNOV / S.C. Agroindustriala S.A.",1,3768,"ORAŞ RÂŞNOV",40367,943,552,521,31,0,541,11,1000,448,205,336
8,"BRAŞOV","#N/A",40367,,251,"RÂŞNOV / Şcoala Generală nr. 2 Râşnov",1,3768,"ORAŞ RÂŞNOV",40367,1655,984,898,86,0,952,32,1700,716,356,596
8,"BRAŞOV","#N/A",40367,,252,"RÂŞNOV / Şcoala Generală nr. 2 Râşnov",1,3768,"ORAŞ RÂŞNOV",40367,1469,920,838,81,1,902,18,1600,680,324,578
8,"BRAŞOV","#N/A",40367,,253,"RÂŞNOV / Şcoala Generală nr. 2 Râşnov",1,3768,"ORAŞ RÂŞNOV",40367,1282,814,741,72,1,801,13,1400,586,302,499
8,"BRAŞOV","#N/A",40367,,254,"RÂŞNOV / Grup Şcolar Industrial Râşnov",1,3768,"ORAŞ RÂŞNOV",40367,1865,1336,1178,158,0,1307,29,2000,664,488,819
8,"BRAŞOV","#N/A",40367,,255,"RÂŞNOV / Grup Şcolar Industrial Râşnov",1,3768,"ORAŞ RÂŞNOV",40367,1616,1059,913,146,0,1036,23,1800,741,440,596
8,"BRAŞOV","#N/A",40394,,256,"RUPEA / Şcoala Generala I",1,3770,"ORAŞ RUPEA",40394,1168,614,577,37,0,603,11,1300,686,198,405
8,"BRAŞOV","#N/A",40394,,257,"RUPEA / Casa Oraseneasca de Cultura",1,3770,"ORAŞ RUPEA",40394,1268,720,612,90,18,712,8,1400,680,266,446
8,"BRAŞOV","#N/A",40394,,258,"RUPEA / Scoala Generala II",1,3770,"ORAŞ RUPEA",40394,1513,830,767,63,0,819,11,1600,770,303,516
8,"BRAŞOV","#N/A",40394,,259,"RUPEA / Club Muncitoresc Brafor Gara Rupea",1,3770,"ORAŞ RUPEA",40394,553,361,322,39,0,358,3,600,239,164,194
8,"BRAŞOV","#N/A",40394,,260,"FIŞER / Scoala Primara Fiser",1,3770,"ORAŞ RUPEA",40394,382,241,206,26,9,238,3,400,159,106,132
8,"BRAŞOV","#N/A",40465,,261,"VICTORIA / Clădirea Primăriei",1,3773,"ORAŞ VICTORIA",40465,1308,705,627,75,3,702,3,1400,695,205,497
8,"BRAŞOV","#N/A",40465,,262,"VICTORIA / Corp  Ciclu Primar",1,3773,"ORAŞ VICTORIA",40465,1154,594,559,35,0,588,6,1300,706,175,413
8,"BRAŞOV","#N/A",40465,,263,"VICTORIA / LICEUL TEORETIC I.C. DRĂGUŞANU",1,3773,"ORAŞ VICTORIA",40465,1379,630,579,51,0,625,5,1400,770,163,462
8,"BRAŞOV","#N/A",40465,,264,"VICTORIA / Şcoala Generală",1,3773,"ORAŞ VICTORIA",40465,958,527,483,43,1,519,8,1100,573,129,390
8,"BRAŞOV","#N/A",40465,,265,"VICTORIA / Colegiul Tehnic Dr. Alexandru Bărbat",1,3773,"ORAŞ VICTORIA",40465,1065,608,530,57,21,598,10,1200,592,194,404
8,"BRAŞOV","#N/A",40465,,266,"VICTORIA / Grădiniţa nr. 1",1,3773,"ORAŞ VICTORIA",40465,1571,697,646,50,1,690,7,1600,903,176,514
8,"BRAŞOV","#N/A",40492,,267,"ZĂRNEŞTI / GRĂDINIŢA BOBOCEL",1,3775,"ORAŞ ZĂRNEŞTI",40492,1460,878,847,29,2,857,21,1600,722,385,472
8,"BRAŞOV","#N/A",40492,,268,"ZĂRNEŞTI / LICEUL TEORETIC M.I.MEŢIANU - corp A",1,3775,"ORAŞ ZĂRNEŞTI",40492,1318,908,810,98,0,890,18,1488,580,424,466
8,"BRAŞOV","#N/A",40492,,269,"ZĂRNEŞTI / LICEUL TEORETIC M.I.MEŢIANU - corp B",1,3775,"ORAŞ ZĂRNEŞTI",40492,1346,963,889,73,1,950,13,1500,537,442,508
8,"BRAŞOV","#N/A",40492,,270,"ZĂRNEŞTI / LICEUL TEORETIC M.I.MEŢIANU - corp B",1,3775,"ORAŞ ZĂRNEŞTI",40492,1603,1104,1018,86,0,1090,14,1800,696,539,551
8,"BRAŞOV","#N/A",40492,,271,"ZĂRNEŞTI / CASA DE CULTURĂ",1,3775,"ORAŞ ZĂRNEŞTI",40492,1282,855,801,54,0,843,12,1400,545,360,483
8,"BRAŞOV","#N/A",40492,,272,"ZĂRNEŞTI / GRĂDINIŢA VOINICELUL",1,3775,"ORAŞ ZĂRNEŞTI",40492,1313,818,764,54,0,801,17,1400,582,324,477
8,"BRAŞOV","#N/A",40492,,273,"ZĂRNEŞTI / CLUBUL PENSIONARILOR - Caraiman",1,3775,"ORAŞ ZĂRNEŞTI",40492,1502,921,888,33,0,902,19,1700,779,369,533
8,"BRAŞOV","#N/A",40492,,274,"ZĂRNEŞTI / CLUBUL PENSIONARILOR",1,3775,"ORAŞ ZĂRNEŞTI",40492,1361,861,833,27,1,850,11,1500,639,449,401
8,"BRAŞOV","#N/A",40492,,275,"ZĂRNEŞTI / ŞCOALA GIMNAZIALĂ POMPILIU DAN-corp A",1,3775,"ORAŞ ZĂRNEŞTI",40492,929,661,587,74,0,653,8,1000,339,228,425
8,"BRAŞOV","#N/A",40492,,276,"ZĂRNEŞTI / SPITALUL ORĂŞENESC DR. CAIUS TIBERIU SPÂRCHEZ",1,3775,"ORAŞ ZĂRNEŞTI",40492,1341,949,869,49,31,930,19,1500,551,494,436
8,"BRAŞOV","#N/A",40492,,277,"ZĂRNEŞTI / ŞCOALA GIMNAZIALĂ GHEORGHE  CRĂCIUN corp B",1,3775,"ORAŞ ZĂRNEŞTI",40492,1397,913,859,41,13,900,13,1500,587,461,439
8,"BRAŞOV","#N/A",40492,,278,"ZĂRNEŞTI / ŞCOALA GIMNAZIALĂ GHEORGHE  CRĂCIUN",1,3775,"ORAŞ ZĂRNEŞTI",40492,1373,890,855,30,5,876,14,1500,610,412,464
8,"BRAŞOV","#N/A",40492,,279,"ZĂRNEŞTI / LICEUL TEHNOLOGIC  MALAXA",1,3775,"ORAŞ ZĂRNEŞTI",40492,1158,581,551,29,1,574,7,1300,719,261,313
8,"BRAŞOV","#N/A",40492,,280,"ZĂRNEŞTI / CĂMINUL CULTURAL",1,3775,"ORAŞ ZĂRNEŞTI",40492,1890,846,810,35,1,815,31,2000,1154,387,428
8,"BRAŞOV","#N/A",40492,,281,"TOHANU NOU / CĂMINUL CULTURAL",1,3775,"ORAŞ ZĂRNEŞTI",40492,1170,972,851,121,0,956,16,1300,328,386,570
8,"BRAŞOV","#N/A",40492,,282,"ZĂRNEŞTI / GRĂDINIŢA VOINICELUL (VECHEA PRIMĂRIE TOHANUL VECHI)",1,3775,"ORAŞ ZĂRNEŞTI",40492,1297,822,776,46,0,802,20,1400,578,376,426
8,"BRAŞOV","#N/A",40526,,283,"APAŢA / CĂMINUL CULTURAL",3,3778,"APAŢA",40526,1160,628,584,44,0,615,13,1300,672,120,495
8,"BRAŞOV","#N/A",40526,,284,"APAŢA / CĂMINUL CULTURAL",3,3778,"APAŢA",40526,1144,626,599,27,0,623,3,1300,674,131,492
8,"BRAŞOV","#N/A",42498,,285,"AUGUSTIN / SCOALA GENERALĂ AUGUSTIN",3,3780,"AUGUSTIN",42498,1209,743,682,59,2,728,15,1300,557,322,406
8,"BRAŞOV","#N/A",40544,,286,"BECLEAN / CAMIN CULTURAL BECLEAN",3,3782,"BECLEAN",40544,610,382,283,99,0,375,7,700,318,180,195
8,"BRAŞOV","#N/A",40544,,287,"HUREZ / CAMIN CULTURAL HUREZ",3,3782,"BECLEAN",40544,361,287,231,53,3,286,1,399,112,144,142
8,"BRAŞOV","#N/A",40544,,288,"BOHOLŢ / CAMIN CULTURAL BOHOLT",3,3782,"BECLEAN",40544,153,114,90,24,0,113,1,200,86,28,85
8,"BRAŞOV","#N/A",40544,,289,"CALBOR / CAMIN CULTURAL CALBOR",3,3782,"BECLEAN",40544,191,136,96,40,0,134,2,199,63,37,97
8,"BRAŞOV","#N/A",40544,,290,"LUŢA / CAMIN CULTURAL LUTA",3,3782,"BECLEAN",40544,56,68,36,32,0,67,1,200,132,25,42
8,"BRAŞOV","#N/A",40606,,291,"BOD / Primăria comunei Bod",3,3788,"BOD",40606,1180,751,645,106,0,742,9,1300,549,260,482
8,"BRAŞOV","#N/A",40606,,292,"BOD / Căminul cultural Bod",3,3788,"BOD",40606,847,534,468,66,0,527,7,900,366,233,294
8,"BRAŞOV","#N/A",40606,,293,"COLONIA BOD / Grădiniţa Bod Colonie",3,3788,"BOD",40606,894,580,486,94,0,570,10,1000,420,186,384
8,"BRAŞOV","#N/A",40606,,294,"COLONIA BOD / SCOALA GENERALA COLONIA BOD",3,3788,"BOD",40606,903,598,539,59,0,594,4,1000,402,188,406
8,"BRAŞOV","#N/A",40633,,295,"BRAN / Primăria comunei Bran",3,3791,"BRAN",40633,808,1116,467,648,1,1092,24,1400,284,296,796
8,"BRAŞOV","#N/A",40633,,296,"BRAN / Căminul Cultural Poarta",3,3791,"BRAN",40633,906,631,546,85,0,624,7,1000,369,248,376
8,"BRAŞOV","#N/A",40633,,297,"PREDELUŢ / Şcoala Generală Predeluţ",3,3791,"BRAN",40633,826,772,572,200,0,757,15,900,128,295,462
8,"BRAŞOV","#N/A",40633,,298,"SOHODOL / Căminul Cultural Sohodol",3,3791,"BRAN",40633,941,624,533,90,1,619,5,800,176,160,459
8,"BRAŞOV","#N/A",40633,,299,"ŞIMON / Căminul Cultural Şimon",3,3791,"BRAN",40633,1041,820,681,139,0,810,10,1100,280,221,589
8,"BRAŞOV","#N/A",40688,,300,"BUDILA / ŞCOALĂ GENERALĂ",3,3796,"BUDILA",40688,838,666,638,28,0,639,27,900,234,225,414
8,"BRAŞOV","#N/A",40688,,301,"BUDILA / ŞCOALĂ GENERALĂ",3,3796,"BUDILA",40688,1109,667,619,47,1,654,13,1200,533,194,460
8,"BRAŞOV","#N/A",40688,,302,"BUDILA / PRIMĂRIE",3,3796,"BUDILA",40688,883,651,617,34,0,619,32,1000,349,203,416
8,"BRAŞOV","#N/A",40704,,303,"BUNEŞTI / Primăria Buneşti",3,3798,"BUNEŞTI",40704,601,410,354,56,0,404,6,700,290,167,237
8,"BRAŞOV","#N/A",40704,,304,"CRIŢ / Şcoala primară Criţ",3,3798,"BUNEŞTI",40704,528,347,310,37,0,345,2,600,253,124,221
8,"BRAŞOV","#N/A",40704,,305,"MEŞENDORF / Căminul cultural Meşendorf",3,3798,"BUNEŞTI",40704,262,151,130,21,0,150,1,302,151,72,78
8,"BRAŞOV","#N/A",40704,,306,"ROADEŞ / Şcoala primară Roadeş",3,3798,"BUNEŞTI",40704,222,145,125,20,0,144,1,300,155,68,76
8,"BRAŞOV","#N/A",40704,,307,"VISCRI / Şcoala primară Viscri",3,3798,"BUNEŞTI",40704,344,218,193,25,0,213,5,400,182,73,140
8,"BRAŞOV","#N/A",40768,,308,"CAŢA / Căminul cultural Caţa",3,3804,"CAŢA",40768,1005,624,594,23,7,613,11,1100,476,258,355
8,"BRAŞOV","#N/A",40768,,309,"BEIA / Şcoala generală Beia",3,3804,"CAŢA",40768,324,190,157,28,5,188,2,400,210,50,138
8,"BRAŞOV","#N/A",40768,,310,"DRĂUŞENI / Grădiniţa Drăuşeni",3,3804,"CAŢA",40768,419,253,230,19,4,253,0,500,247,36,217
8,"BRAŞOV","#N/A",40768,,311,"IONEŞTI / Căminul cultural Ioneşti",3,3804,"CAŢA",40768,109,87,75,12,0,86,1,200,113,8,78
8,"BRAŞOV","#N/A",40768,,312,"PALOŞ / Şcoala generală Paloş",3,3804,"CAŢA",40768,209,159,111,42,6,157,2,300,141,48,109
8,"BRAŞOV","#N/A",40820,,313,"CINCU / CAMINUL CULTURAL CINCU",3,3810,"CINCU",40820,1265,983,722,235,26,974,9,1400,417,321,653
8,"BRAŞOV","#N/A",40820,,314,"TOARCLA / ŞCOALA GENERALĂ TOARCLA",3,3810,"CINCU",40820,267,169,143,17,9,166,3,305,136,44,122
8,"BRAŞOV","#N/A",40857,,315,"COMANA DE JOS / Căminul Cultural Comăna de Jos",3,3813,"COMANA",40857,839,440,390,49,1,429,11,901,461,116,313
8,"BRAŞOV","#N/A",40857,,316,"COMANA DE SUS / Căminul Cultural Comăna de Sus",3,3813,"COMANA",40857,284,216,160,56,0,215,1,305,89,36,179
8,"BRAŞOV","#N/A",40857,,317,"CRIHALMA / Căminul Cultural Crihalma",3,3813,"COMANA",40857,551,362,339,23,0,356,6,600,238,113,243
8,"BRAŞOV","#N/A",40857,,318,"TICUŞU NOU / Căminul Cultural Ticuşu Nou",3,3813,"COMANA",40857,424,329,308,21,0,327,2,500,171,157,170
8,"BRAŞOV","#N/A",40900,,319,"CRISTIAN / GRADINITA DE COPII CRISTIAN",3,3818,"CRISTIAN",40900,1331,1008,812,193,3,992,16,1500,492,332,660
8,"BRAŞOV","#N/A",40900,,320,"CRISTIAN / CAMINUL CULTURAL NR. 1",3,3818,"CRISTIAN",40900,1255,847,720,123,4,839,8,1400,553,348,491
8,"BRAŞOV","#N/A",40900,,321,"CRISTIAN / SCOALA GENERALA, CORP B",3,3818,"CRISTIAN",40900,1494,1171,994,177,0,1153,18,1600,429,390,763
8,"BRAŞOV","#N/A",42456,,322,"CRIZBAV / CĂMINUL CULTURAL",3,3820,"CRIZBAV",42456,1269,997,849,126,22,982,15,1400,403,527,455
8,"BRAŞOV","#N/A",42456,,323,"CUTUŞ / Şcoala primară Cutuş",3,3820,"CRIZBAV",42456,488,311,269,41,1,306,5,488,177,223,83
8,"BRAŞOV","#N/A",42480,,324,"DRĂGUŞ / Primăria Drăguş",3,3823,"DRĂGUŞ",42480,925,803,607,159,37,800,3,1000,197,82,718
8,"BRAŞOV","#N/A",40928,,325,"DUMBRĂVIŢA / Primăria Comunei Dumbrăviţa",3,3825,"DUMBRĂVIŢA",40928,1572,961,889,72,0,954,7,1700,739,254,700
8,"BRAŞOV","#N/A",40928,,326,"DUMBRĂVIŢA / Grădiniţa cu program normal Dumbrăviţa",3,3825,"DUMBRĂVIŢA",40928,1734,1081,1042,39,0,1070,11,1800,719,291,779
8,"BRAŞOV","#N/A",40928,,327,"VLĂDENI / Şcoala Generală sat Vlădeni",3,3825,"DUMBRĂVIŢA",40928,712,502,374,128,0,497,5,800,298,160,337
8,"BRAŞOV","#N/A",40955,,328,"FELDIOARA / CĂMINUL CULTURAL FELDIOARA",3,3828,"FELDIOARA",40955,1825,1072,978,94,0,1052,20,1903,831,406,646
8,"BRAŞOV","#N/A",40955,,329,"FELDIOARA / LICEUL TEORETIC PETRU RAREŞ FELDIOARA",3,3828,"FELDIOARA",40955,1223,818,750,66,2,810,8,1300,482,275,535
8,"BRAŞOV","#N/A",40955,,330,"FELDIOARA / LICEUL TEORETIC PETRU RAREŞ FELDIOARA",3,3828,"FELDIOARA",40955,1173,661,619,40,2,649,12,1300,639,231,418
8,"BRAŞOV","#N/A",40955,,331,"ROTBAV / CAMINUL CULTURAL ROTBAV",3,3828,"FELDIOARA",40955,998,805,635,168,2,788,17,1100,295,286,502
8,"BRAŞOV","#N/A",40955,,332,"COLONIA RECONSTRUCŢIA / CAMINUL CULTURAL RECONSTRUCTIA",3,3828,"FELDIOARA",40955,567,397,365,32,0,390,7,599,202,99,291
8,"BRAŞOV","#N/A",40991,,333,"FUNDATA / Şcoala generală Fundata",3,3832,"FUNDATA",40991,468,433,308,124,1,429,4,500,67,144,285
8,"BRAŞOV","#N/A",40991,,334,"ŞIRNEA / Şcoala generală Şirnea",3,3832,"FUNDATA",40991,233,164,109,54,1,163,1,300,136,35,128
8,"BRAŞOV","#N/A",41033,,335,"HĂLCHIU / CĂMINUL CULTURAL",3,3836,"HĂLCHIU",41033,1444,903,829,74,0,889,14,1600,697,341,548
8,"BRAŞOV","#N/A",41033,,336,"HĂLCHIU / LOCAŢIA KREDENT",3,3836,"HĂLCHIU",41033,1389,941,833,104,4,929,12,1500,559,313,616
8,"BRAŞOV","#N/A",41033,,337,"SATU NOU / Camin Cultural",3,3836,"HĂLCHIU",41033,965,619,552,67,0,613,6,1100,481,213,400
8,"BRAŞOV","#N/A",41088,,338,"PODU OLTULUI / Căminul cultural",3,3839,"HĂRMAN",41088,612,486,385,101,0,480,6,700,214,136,344
8,"BRAŞOV","#N/A",41088,,339,"HĂRMAN / Scoala Gimnaziala Harman",3,3839,"HĂRMAN",41088,1485,939,836,103,0,923,16,1600,661,294,629
8,"BRAŞOV","#N/A",41088,,340,"HĂRMAN / Scoala Gimnaziala Harman",3,3839,"HĂRMAN",41088,1425,908,797,111,0,894,14,1500,592,343,551
8,"BRAŞOV","#N/A",41088,,341,"HĂRMAN / Scoala Gimnaziala Harman",3,3839,"HĂRMAN",41088,1387,920,824,96,0,909,11,1500,580,331,578
8,"BRAŞOV","#N/A",41113,,342,"HÂRSENI / Scoala Harseni",3,3842,"HÂRSENI",41113,458,333,261,70,2,329,4,500,167,142,187
8,"BRAŞOV","#N/A",41113,,343,"SEBEŞ / Grădiniţa Sebeş",3,3842,"HÂRSENI",41113,632,437,370,67,0,432,5,700,263,165,267
8,"BRAŞOV","#N/A",41113,,344,"MĂRGINENI / Grădiniţa Mărgineni",3,3842,"HÂRSENI",41113,247,238,175,63,0,231,7,400,162,79,152
8,"BRAŞOV","#N/A",41113,,345,"COPĂCEL / Grădiniţa Copăcel",3,3842,"HÂRSENI",41113,512,382,314,65,3,378,4,600,218,139,239
8,"BRAŞOV","#N/A",41177,,346,"HOGHIZ / Căminul Cultural Hoghiz",3,3848,"HOGHIZ",41177,1029,602,554,48,0,599,3,1100,498,152,447
8,"BRAŞOV","#N/A",41177,,347,"HOGHIZ / Căminul Cultural Hoghiz",3,3848,"HOGHIZ",41177,786,396,385,11,0,392,4,900,504,103,289
8,"BRAŞOV","#N/A",41177,,348,"BOGATA OLTEANĂ / Căminul Cultural Bogata",3,3848,"HOGHIZ",41177,323,252,228,24,0,249,3,396,144,112,137
8,"BRAŞOV","#N/A",41177,,349,"CUCIULATA / Căminul Cultural Cuciulata",3,3848,"HOGHIZ",41177,1082,687,631,55,1,677,10,1200,513,413,264
8,"BRAŞOV","#N/A",41177,,350,"DOPCA / Căminul Cultural Dopca",3,3848,"HOGHIZ",41177,406,291,276,15,0,287,4,400,109,102,185
8,"BRAŞOV","#N/A",41177,,351,"FÂNTÂNA / Cămunul Cultural Fântâna",3,3848,"HOGHIZ",41177,236,203,172,31,0,200,3,300,97,75,125
8,"BRAŞOV","#N/A",41177,,352,"LUPŞA / Căminul Cultural Lupşa",3,3848,"HOGHIZ",41177,79,67,48,19,0,66,1,200,133,31,35
8,"BRAŞOV","#N/A",42472,,353,"HOLBAV / Primaria Comunei Holbav",3,3855,"HOLBAV",42472,1037,659,618,39,2,648,11,1100,441,289,359
8,"BRAŞOV","#N/A",41248,,354,"HOMOROD / CAMIN CULTURAL HOMOROD",3,3857,"HOMOROD",41248,1163,613,568,45,0,608,5,1300,687,198,410
8,"BRAŞOV","#N/A",41248,,355,"MERCHEAŞA / CAMIN CULTURAL MERCHEASA",3,3857,"HOMOROD",41248,410,284,249,35,0,282,2,500,216,82,200
8,"BRAŞOV","#N/A",41248,,356,"JIMBOR / CAMIN CULTURAL JIMBOR",3,3857,"HOMOROD",41248,382,244,223,21,0,241,3,400,156,34,207
8,"BRAŞOV","#N/A",41284,,357,"JIBERT / Şcoala Generală Jibert",3,3861,"JIBERT",41284,602,290,251,39,0,288,2,700,410,55,233
8,"BRAŞOV","#N/A",41284,,358,"DACIA / Şcoala Generală Dacia",3,3861,"JIBERT",41284,590,327,304,23,0,325,2,600,273,170,155
8,"BRAŞOV","#N/A",41284,,359,"LOVNIC / Şcoala Generală Lovnic",3,3861,"JIBERT",41284,439,221,194,25,2,218,3,500,279,84,134
8,"BRAŞOV","#N/A",41284,,360,"GRÎNARI / Şcoala Generală Grânari",3,3861,"JIBERT",41284,291,219,193,21,5,218,1,300,81,10,208
8,"BRAŞOV","#N/A",41284,,361,"VĂLENI / Şcoala Generală Văleni",3,3861,"JIBERT",41284,145,112,76,36,0,111,1,200,88,33,78
8,"BRAŞOV","#N/A",41346,,362,"LISA / Căminul Cultural Lisa",3,3867,"LISA",41346,866,636,511,124,1,627,9,1000,364,182,445
8,"BRAŞOV","#N/A",41346,,363,"BREAZA / Căminul Cultural Breaza",3,3867,"LISA",41346,578,476,359,117,0,474,2,600,124,109,365
8,"BRAŞOV","#N/A",41382,,364,"MĂIERUŞ / CAMINUL CULTURAL MAIERUS",3,3871,"MĂIERUŞ",41382,1423,995,869,92,34,982,13,1600,605,241,741
8,"BRAŞOV","#N/A",41382,,365,"ARINI / CAMINUL CULTURAL ARINI",3,3871,"MĂIERUŞ",41382,685,525,474,48,3,514,11,800,275,149,365
8,"BRAŞOV","#N/A",41417,,366,"MÂNDRA /  Scoala Generala Mândra",3,3874,"MÂNDRA",41417,926,616,499,97,20,607,9,1000,384,332,275
8,"BRAŞOV","#N/A",41417,,367,"ILENI / Aşezamânt cultural",3,3874,"MÂNDRA",41417,625,531,355,175,1,526,5,700,169,223,303
8,"BRAŞOV","#N/A",41417,,368,"RÂUŞOR / Aşezamânt cultural",3,3874,"MÂNDRA",41417,390,306,245,60,1,299,7,400,94,113,186
8,"BRAŞOV","#N/A",41417,,369,"TODERIŢA / Aşezamânt cultural",3,3874,"MÂNDRA",41417,238,212,126,78,8,206,6,300,88,110,96
8,"BRAŞOV","#N/A",41417,,370,"ŞONA / Aşezamânt cultural",3,3874,"MÂNDRA",41417,196,172,115,55,2,169,3,300,128,57,112
8,"BRAŞOV","#N/A",41471,,371,"MOIECIU DE JOS / Primăria comunei Moieciu",3,3880,"MOIECIU",41471,1036,873,665,207,1,867,6,1200,327,313,554
8,"BRAŞOV","#N/A",41471,,372,"MOIECIU DE JOS / Primăria comunei Moieciu",3,3880,"MOIECIU",41471,1260,1114,853,261,0,1106,8,1400,286,348,758
8,"BRAŞOV","#N/A",41471,,373,"MOIECIU DE SUS / Şcoala Generală Moieciu de Sus",3,3880,"MOIECIU",41471,739,805,486,319,0,794,11,1000,195,346,448
8,"BRAŞOV","#N/A",41471,,374,"PEŞTERA / Şcoala Generală Peştera",3,3880,"MOIECIU",41471,381,335,221,114,0,333,2,398,63,149,184
8,"BRAŞOV","#N/A",41471,,375,"MĂGURA / Şcoala Generală Măgura",3,3880,"MOIECIU",41471,448,335,282,53,0,328,7,502,167,140,188
8,"BRAŞOV","#N/A",41541,,376,"ORMENIŞ / Dispensar medical Ormeniş",3,3887,"ORMENIŞ",41541,1547,1045,970,44,31,1024,21,1700,655,433,591
8,"BRAŞOV","#N/A",41578,,377,"PĂRĂU / Căminul Cultural Părău",3,3889,"PĂRĂU",41578,504,329,260,69,0,325,4,600,271,172,153
8,"BRAŞOV","#N/A",41578,,378,"GRID / Şcoala primară Grid",3,3889,"PĂRĂU",41578,259,225,152,71,2,224,1,300,75,92,132
8,"BRAŞOV","#N/A",41578,,379,"VENEŢIA DE JOS / Clădirea fostei primării",3,3889,"PĂRĂU",41578,554,352,300,52,0,349,3,600,248,132,217
8,"BRAŞOV","#N/A",41578,,380,"VENEŢIA DE SUS / Clădirea fostei primării",3,3889,"PĂRĂU",41578,361,247,211,36,0,243,4,400,153,51,192
8,"BRAŞOV","#N/A",41621,,381,"POIANA MĂRULUI / SCOALA GIMNAZIALA CORP A2 POIANA MARULUI",3,3894,"POIANA MĂRULUI",41621,1272,887,826,61,0,874,13,1400,513,265,609
8,"BRAŞOV","#N/A",41621,,382,"POIANA MĂRULUI / ŞCOALĂ GENERALĂ nr. 1 Corp B",3,3894,"POIANA MĂRULUI",41621,1106,641,571,70,0,632,9,1200,559,159,473
8,"BRAŞOV","#N/A",41621,,383,"POIANA MĂRULUI / ŞCOALĂ GENERALĂ nr. 2 catun Intre-Vai",3,3894,"POIANA MĂRULUI",41621,293,139,100,37,2,139,0,300,161,30,109
8,"BRAŞOV","#N/A",41667,,384,"PREJMER / PRIMARIA COMUNEI PREJMER",3,3896,"PREJMER",41667,1607,986,881,105,0,976,10,1800,814,394,582
8,"BRAŞOV","#N/A",41667,,385,"PREJMER / PRIMARIA COMUNEI PREJMER",3,3896,"PREJMER",41667,1742,1174,1047,127,0,1149,25,1900,726,477,672
8,"BRAŞOV","#N/A",41667,,386,"PREJMER / PRIMARIA COMUNEI PREJMER",3,3896,"PREJMER",41667,1731,1106,1005,101,0,1092,14,1900,794,325,767
8,"BRAŞOV","#N/A",41667,,387,"LUNCA CALNICULUI / SCOALA GENERALA LUNCA CALNICULUI SAT",3,3896,"PREJMER",41667,1273,780,717,63,0,766,14,1400,620,263,503
8,"BRAŞOV","#N/A",41667,,388,"LUNCA CALNICULUI / SCOALA GENERALA LUNCA CALNICULUI COLONIE",3,3896,"PREJMER",41667,1360,832,755,75,2,822,10,1500,668,315,507
8,"BRAŞOV","#N/A",41701,,389,"MATEIAŞ / CAMIN CULTURAL",3,3900,"RACOŞ",41701,389,260,221,39,0,259,1,398,138,126,133
8,"BRAŞOV","#N/A",41701,,390,"RACOŞ / Scoala Generala ""Bethlen Samuel""",3,3900,"RACOŞ",41701,1017,526,502,24,0,514,12,1100,574,296,218
8,"BRAŞOV","#N/A",41701,,391,"RACOŞ / Primăria comunei Racos",3,3900,"RACOŞ",41701,1051,534,513,21,0,527,7,1200,666,107,420
8,"BRAŞOV","#N/A",41738,,392,"RECEA / Caminul Cultural Recea",3,3903,"RECEA",41738,1502,984,776,208,0,965,19,1700,716,267,698
8,"BRAŞOV","#N/A",41738,,393,"BERIVOI / Caminul Cultural Berivoi",3,3903,"RECEA",41738,470,343,251,91,1,341,2,500,157,114,227
8,"BRAŞOV","#N/A",41738,,394,"SĂVĂSTRENI / Caminul Cultural Săvăstreni",3,3903,"RECEA",41738,565,414,299,115,0,409,5,600,186,121,288
8,"BRAŞOV","#N/A",42464,,395,"SÂMBĂTA DE SUS / SCOALA GENERALA",3,3911,"SÂMBĂTĂ DE SUS",42464,1299,1164,803,355,6,1151,13,1400,236,428,723
8,"BRAŞOV","#N/A",41925,,396,"SÎNPETRU / Şcoala Gimnazială Sânpetru",3,3928,"SÎNPETRU",41925,1384,1022,898,122,2,1002,20,1500,478,356,646
8,"BRAŞOV","#N/A",41925,,397,"SÎNPETRU / Gradinita cu program normal 4ore Sanpetru",3,3928,"SÎNPETRU",41925,1576,1151,960,190,1,1129,22,1700,549,309,820
8,"BRAŞOV","#N/A",41925,,398,"SÎNPETRU / Căminul cultural al Bisericii Ortodoxe",3,3928,"SÎNPETRU",41925,1384,978,797,111,70,949,29,1495,517,324,625
8,"BRAŞOV","#N/A",41818,,399,"ŞERCAIA / Cămin Cultural Şercaia",3,3914,"ŞERCAIA",41818,1385,748,662,86,0,738,10,1500,752,149,589
8,"BRAŞOV","#N/A",41818,,400,"VAD / Cămin Cultural Vad",3,3914,"ŞERCAIA",41818,451,341,257,84,0,338,3,500,159,94,244
8,"BRAŞOV","#N/A",41818,,401,"HĂLMEAG / Fostul sediu CAP",3,3914,"ŞERCAIA",41818,379,224,180,42,2,223,1,400,176,22,201
8,"BRAŞOV","#N/A",41854,,402,"VÂLCEA / ŞCOALĂ GENERALĂ",3,3918,"ŞINCA",41854,182,120,105,15,0,120,0,200,80,31,89
8,"BRAŞOV","#N/A",41854,,403,"BUCIUM / CĂMINUL CULTURAL",3,3918,"ŞINCA",41854,213,178,125,53,0,177,1,300,122,41,136
8,"BRAŞOV","#N/A",41854,,404,"OHABA / CĂMINUL CULTURAL",3,3918,"ŞINCA",41854,259,171,126,45,0,170,1,300,129,40,130
8,"BRAŞOV","#N/A",41854,,405,"PERŞANI / CĂMINUL CULTURAL",3,3918,"ŞINCA",41854,847,543,451,92,0,536,7,900,357,164,372
8,"BRAŞOV","#N/A",41854,,406,"ŞERCĂIŢA / CĂMINUL CULTURAL",3,3918,"ŞINCA",41854,555,405,318,85,2,401,4,600,195,175,226
8,"BRAŞOV","#N/A",41854,,407,"ŞINCA VECHE / PRIMĂRIE",3,3918,"ŞINCA",41854,712,521,415,106,0,519,2,800,279,145,374
8,"BRAŞOV","#N/A",42449,,408,"ŞINCA NOUĂ / ŞCOALĂ GENERALĂ",3,3925,"ŞINCA NOUĂ",42449,170,144,120,22,2,143,1,296,152,18,125
8,"BRAŞOV","#N/A",42449,,409,"ŞINCA NOUĂ / CĂMINUL CULTURAL",3,3925,"ŞINCA NOUĂ",42449,1009,836,719,87,30,832,4,1100,264,160,672
8,"BRAŞOV","#N/A",42449,,410,"PALTIN / ŞCOALA PRIMARĂ PALTIN",3,3925,"ŞINCA NOUĂ",42449,126,171,95,76,0,167,4,296,125,38,129
8,"BRAŞOV","#N/A",41943,,411,"ŞOARŞ / PRIMARIA COMUNEI SOARS",3,3930,"ŞOARŞ",41943,481,303,267,33,3,301,2,500,197,56,245
8,"BRAŞOV","#N/A",41943,,412,"FELMER / SCOALA GENERALA FELMER",3,3930,"ŞOARŞ",41943,368,269,221,45,3,263,6,400,131,88,175
8,"BRAŞOV","#N/A",41943,,413,"BĂRCUT / SCOALA GENERALA BARCUT",3,3930,"ŞOARŞ",41943,339,189,161,24,4,188,1,400,211,51,137
8,"BRAŞOV","#N/A",41943,,414,"RODBAV / SCOALA GENERALA RODBAV",3,3930,"ŞOARŞ",41943,234,166,144,20,2,166,0,300,134,33,133
8,"BRAŞOV","#N/A",41943,,415,"SELIŞTAT / SCOALA GENERALA SELISTAT",3,3930,"ŞOARŞ",41943,163,105,88,17,0,105,0,200,95,26,79
8,"BRAŞOV","#N/A",42003,,416,"TĂRLUNGENI / Camin Cultural",3,3936,"TĂRLUNGENI",42003,1432,907,829,78,0,896,11,1600,693,274,622
8,"BRAŞOV","#N/A",42003,,417,"TĂRLUNGENI / Gradinita program prelungit",3,3936,"TĂRLUNGENI",42003,1559,916,850,66,0,904,12,1600,684,299,605
8,"BRAŞOV","#N/A",42003,,418,"PURCĂRENI / Scoala Generala Purcareni",3,3936,"TĂRLUNGENI",42003,1264,846,766,79,1,837,9,1400,554,256,581
8,"BRAŞOV","#N/A",42003,,419,"ZIZIN / Scoala Generala Zizin",3,3936,"TĂRLUNGENI",42003,906,655,611,44,0,645,10,1000,345,360,285
8,"BRAŞOV","#N/A",42003,,420,"ZIZIN / Scoala Generala Zizin",3,3936,"TĂRLUNGENI",42003,1013,727,698,29,0,715,12,1100,373,410,305
8,"BRAŞOV","#N/A",42003,,421,"CĂRPINIŞ / Scoala Generala Carpinis",3,3936,"TĂRLUNGENI",42003,372,308,234,74,0,307,1,400,92,113,194
8,"BRAŞOV","#N/A",42058,,422,"TELIU / ŞCOALĂ GENERALĂ TELIU",3,3941,"TELIU",42058,1253,867,820,47,0,845,22,1400,533,515,330
8,"BRAŞOV","#N/A",42058,,423,"TELIU / CĂMINUL CULTURAL TELIU",3,3941,"TELIU",42058,1069,686,613,72,1,680,6,1200,514,184,496
8,"BRAŞOV","#N/A",42058,,424,"TELIU / ŞCOALĂ GENERALĂ TELIU VALE",3,3941,"TELIU",42058,788,604,547,50,7,602,2,900,296,279,323
8,"BRAŞOV","#N/A",42076,,425,"TICUŞU VECHI / Căminul Cultural Ticuşu Vechi",3,3943,"TICUŞU",42076,561,377,343,34,0,373,4,600,223,179,194
8,"BRAŞOV","#N/A",42076,,426,"COBOR / Şcoala Primară Cobor",3,3943,"TICUŞU",42076,182,131,109,21,1,131,0,200,69,39,92
8,"BRAŞOV","#N/A",42101,,427,"UCEA DE JOS / Căminul cultural Ucea de Jos",3,3946,"UCEA",42101,734,446,359,86,1,445,1,800,354,81,364
8,"BRAŞOV","#N/A",42101,,428,"UCEA DE SUS / Şcoala generală Ucea de Sus",3,3946,"UCEA",42101,810,552,496,56,0,550,2,900,348,83,467
8,"BRAŞOV","#N/A",42101,,429,"FELDIOARA / Grădiniţa Feldioara",3,3946,"UCEA",42101,181,140,95,45,0,139,1,200,60,49,90
8,"BRAŞOV","#N/A",42101,,430,"CORBI / Camin cultural Corbi",3,3946,"UCEA",42101,150,121,92,29,0,121,0,199,78,35,86
8,"BRAŞOV","#N/A",42156,,431,"UNGRA / Şcoala Generală Ungra",3,3951,"UNGRA",42156,1058,563,539,24,0,558,5,1200,637,248,310
8,"BRAŞOV","#N/A",42156,,432,"DĂIŞOARA / Grădiniţa Dăişoara",3,3951,"UNGRA",42156,541,434,396,38,0,427,7,600,166,349,78
8,"BRAŞOV","#N/A",42183,,433,"VAMA BUZĂULUI / Căminul Cultural Vama Buzăului",3,3954,"VAMA BUZĂULUI",42183,1339,789,719,70,0,778,11,1500,711,360,418
8,"BRAŞOV","#N/A",42183,,434,"ACRIŞ / Căminul Cultural Acriş",3,3954,"VAMA BUZĂULUI",42183,899,552,516,36,0,541,11,1001,449,205,336
8,"BRAŞOV","#N/A",42183,,435,"BUZĂIEL / Şcoala Primară Buzăiel",3,3954,"VAMA BUZĂULUI",42183,452,237,218,19,0,236,1,500,263,117,119
8,"BRAŞOV","#N/A",42236,,436,"VIŞTEA DE JOS / Primăria Comunei Viştea",3,3959,"VIŞTEA",42236,610,368,296,67,5,362,6,700,332,85,277
8,"BRAŞOV","#N/A",42236,,437,"VIŞTEA DE SUS / Grădiniţa Viştea de Sus",3,3959,"VIŞTEA",42236,510,380,312,65,3,378,2,600,220,90,288
8,"BRAŞOV","#N/A",42236,,438,"OLTEŢ / Şcoala Generală Olteţ",3,3959,"VIŞTEA",42236,284,199,136,62,1,198,1,400,201,43,155
8,"BRAŞOV","#N/A",42236,,439,"RUCĂR / Gradiniţa Rucăr",3,3959,"VIŞTEA",42236,317,259,192,67,0,257,2,400,141,54,203
8,"BRAŞOV","#N/A",42307,,440,"VOILA / PRIMARIA VOILA",3,3965,"VOILA",42307,619,418,322,92,4,414,4,700,282,177,237
8,"BRAŞOV","#N/A",42307,,441,"CINCŞOR / CAMINUL CULTURAL CINCSOR",3,3965,"VOILA",42307,642,444,355,86,3,439,5,700,256,198,241
8,"BRAŞOV","#N/A",42307,,442,"DRIDIF / CAMINUL CULTURAL DRIDIF",3,3965,"VOILA",42307,327,240,186,52,2,238,2,400,160,114,124
8,"BRAŞOV","#N/A",42307,,443,"LUDIŞOR / CAMINUL CULTURAL LUDISOR",3,3965,"VOILA",42307,138,143,79,64,0,142,1,299,156,45,97
8,"BRAŞOV","#N/A",42307,,444,"SÂMBĂTA DE JOS / CAMINUL CULTURAL SAMBATA DE JOS",3,3965,"VOILA",42307,419,269,200,67,2,266,3,500,231,86,180
8,"BRAŞOV","#N/A",42307,,445,"VOIVODENI / CAMINUL CULTURAL VOIVODENII MARI",3,3965,"VOILA",42307,355,314,217,97,0,314,0,400,86,125,189
8,"BRAŞOV","#N/A",42398,,446,"VULCAN / CAMINUL CULTURAL VULCAN",3,3972,"VULCAN",42398,1661,1145,1051,90,4,1132,13,1800,655,404,728
8,"BRAŞOV","#N/A",42398,,447,"VULCAN / CAMINUL CULTURAL VULCAN",3,3972,"VULCAN",42398,1500,918,848,69,1,903,15,1500,582,399,504
8,"BRAŞOV","#N/A",42398,,448,"COLONIA 1 MAI / CAMINUL CULTURAL 1 MAI",3,3972,"VULCAN",42398,634,407,360,43,4,402,5,700,293,128,274
9,"BRĂILA","#N/A",42682,,1,"BRĂILA / Şcoala Generală nr. 31 ""Mihai Viteazul""",1,3976,"MUNICIPIUL BRĂILA",42682,1274,717,684,33,0,706,11,1411,694,436,270
9,"BRĂILA","#N/A",42682,,2,"BRĂILA / Şcoala Generală nr. 31 ""Mihai Viteazul""",1,3976,"MUNICIPIUL BRĂILA",42682,1296,770,745,25,0,763,7,1433,663,440,323
9,"BRĂILA","#N/A",42682,,3,"BRĂILA / Şcoala Generală nr. 31 ""Mihai Viteazul""",1,3976,"MUNICIPIUL BRĂILA",42682,1142,656,635,21,0,641,15,1259,603,395,246
9,"BRĂILA","#N/A",42682,,4,"BRĂILA / Şcoala Generală nr. 31 ""Mihai Viteazul""",1,3976,"MUNICIPIUL BRĂILA",42682,1321,756,738,18,0,747,9,1465,709,433,314
9,"BRĂILA","#N/A",42682,,5,"BRĂILA / Grădiniţa nr.61 ""Bobocel""",1,3976,"MUNICIPIUL BRĂILA",42682,1234,755,728,27,0,740,15,1352,597,442,298
9,"BRĂILA","#N/A",42682,,6,"BRĂILA / Grădiniţa nr.61 ""Bobocel""",1,3976,"MUNICIPIUL BRĂILA",42682,1291,760,751,9,0,751,9,1418,658,467,284
9,"BRĂILA","#N/A",42682,,7,"BRĂILA / Şcoala Generală nr.1 ""Vlaicu Vodă""",1,3976,"MUNICIPIUL BRĂILA",42682,1464,921,896,25,0,904,17,1610,689,514,390
9,"BRĂILA","#N/A",42682,,8,"BRĂILA / Şcoala Generală nr.1 ""Vlaicu Vodă""",1,3976,"MUNICIPIUL BRĂILA",42682,1530,952,920,32,0,939,13,1689,737,544,395
9,"BRĂILA","#N/A",42682,,9,"BRĂILA / Grădiniţa nr.12 ""Sf. Nicolae""",1,3976,"MUNICIPIUL BRĂILA",42682,1725,1018,1001,17,0,1002,16,1907,889,590,412
9,"BRĂILA","#N/A",42682,,10,"BRĂILA / Grădiniţa nr.12 ""Sf. Nicolae""",1,3976,"MUNICIPIUL BRĂILA",42682,1580,927,905,22,0,916,11,1734,807,503,413
9,"BRĂILA","#N/A",42682,,11,"BRĂILA / Şcoala Generală nr.27 ""Aurel Vlaicu""",1,3976,"MUNICIPIUL BRĂILA",42682,1403,857,823,34,0,838,19,1538,681,405,433
9,"BRĂILA","#N/A",42682,,12,"BRĂILA / Şcoala Generală nr.27 ""Aurel Vlaicu""",1,3976,"MUNICIPIUL BRĂILA",42682,1574,885,866,19,0,872,13,1725,840,494,378
9,"BRĂILA","#N/A",42682,,13,"BRĂILA / Şcoala Generală nr.27 ""Aurel Vlaicu""",1,3976,"MUNICIPIUL BRĂILA",42682,1402,815,794,19,2,802,13,1545,730,411,391
9,"BRĂILA","#N/A",42682,,14,"BRĂILA / Şcoala Generală nr.27 ""Aurel Vlaicu""",1,3976,"MUNICIPIUL BRĂILA",42682,1443,810,794,16,0,796,14,1587,777,375,421
9,"BRĂILA","#N/A",42682,,15,"BRĂILA / Şcoala Generală nr.2 ""Fănuş Neagu""",1,3976,"MUNICIPIUL BRĂILA",42682,973,720,494,58,168,709,11,1067,347,408,301
9,"BRĂILA","#N/A",42682,,16,"BRĂILA / Şcoala Generală nr.2 ""Fănuş Neagu""",1,3976,"MUNICIPIUL BRĂILA",42682,1174,654,631,22,1,647,7,1292,638,350,297
9,"BRĂILA","#N/A",42682,,17,"BRĂILA / Şcoala Generală nr.2 ""Fănuş Neagu""",1,3976,"MUNICIPIUL BRĂILA",42682,1099,717,656,24,37,701,16,1207,490,357,344
9,"BRĂILA","#N/A",42682,,18,"BRĂILA / Şcoala Generală nr.2 ""Fănuş Neagu""",1,3976,"MUNICIPIUL BRĂILA",42682,1401,855,836,19,0,839,16,1545,690,395,444
9,"BRĂILA","#N/A",42682,,19,"BRĂILA / Şcoala Generală nr.2 ""Fănuş Neagu""",1,3976,"MUNICIPIUL BRĂILA",42682,1219,740,715,25,0,722,18,1349,609,358,364
9,"BRĂILA","#N/A",42682,,20,"BRĂILA / Grădiniţa nr. 39 ""Căsuţa Fermecată""",1,3976,"MUNICIPIUL BRĂILA",42682,1367,829,812,17,0,813,16,1514,685,477,336
9,"BRĂILA","#N/A",42682,,21,"BRĂILA / Grădiniţa nr. 39 ""Căsuţa Fermecată""",1,3976,"MUNICIPIUL BRĂILA",42682,1267,692,673,19,0,679,13,1393,701,396,283
9,"BRĂILA","#N/A",42682,,22,"BRĂILA / Grădiniţa nr. 39 ""Căsuţa Fermecată""",1,3976,"MUNICIPIUL BRĂILA",42682,1235,684,670,14,0,675,9,1356,672,375,300
9,"BRĂILA","#N/A",42682,,23,"BRĂILA / Grădiniţa nr. 39 ""Căsuţa Fermecată""",1,3976,"MUNICIPIUL BRĂILA",42682,1170,698,679,19,0,687,11,1293,595,434,253
9,"BRĂILA","#N/A",42682,,24,"BRĂILA / Şcoala Generală nr.28 ""Vasile Alecsandri""",1,3976,"MUNICIPIUL BRĂILA",42682,1161,700,676,24,0,695,5,1276,576,400,295
9,"BRĂILA","#N/A",42682,,25,"BRĂILA / Şcoala Generală nr.28 ""Vasile Alecsandri""",1,3976,"MUNICIPIUL BRĂILA",42682,1052,574,533,41,0,562,12,1157,583,303,259
9,"BRĂILA","#N/A",42682,,26,"BRĂILA / Şcoala Generală nr.28 ""Vasile Alecsandri""",1,3976,"MUNICIPIUL BRĂILA",42682,1050,599,581,18,0,590,9,1166,567,338,252
9,"BRĂILA","#N/A",42682,,27,"BRĂILA / Şcoala Generală nr.28 ""Vasile Alecsandri""",1,3976,"MUNICIPIUL BRĂILA",42682,1412,857,833,24,0,848,9,1553,696,475,373
9,"BRĂILA","#N/A",42682,,28,"BRĂILA / Şcoala Generală nr.28 ""Vasile Alecsandri""",1,3976,"MUNICIPIUL BRĂILA",42682,970,537,518,19,0,526,11,1069,532,326,200
9,"BRĂILA","#N/A",42682,,29,"BRĂILA / Grădiniţa nr. 38 ""Iris""",1,3976,"MUNICIPIUL BRĂILA",42682,1233,751,710,41,0,737,14,1362,611,443,294
9,"BRĂILA","#N/A",42682,,30,"BRĂILA / Şcoala Generală nr.29 ""Mihail Sadoveanu""",1,3976,"MUNICIPIUL BRĂILA",42682,709,441,405,36,0,434,7,784,343,243,191
9,"BRĂILA","#N/A",42682,,31,"BRĂILA / Şcoala Generală nr.29 ""Mihail Sadoveanu""",1,3976,"MUNICIPIUL BRĂILA",42682,1303,705,676,29,0,693,12,1438,733,403,290
9,"BRĂILA","#N/A",42682,,32,"BRĂILA / Şcoala Generală nr.29 ""Mihail Sadoveanu""",1,3976,"MUNICIPIUL BRĂILA",42682,1472,805,783,22,0,796,9,1623,818,471,325
9,"BRĂILA","#N/A",42682,,33,"BRĂILA / Grădiniţa nr. 53 ""Nu mă uita""",1,3976,"MUNICIPIUL BRĂILA",42682,1612,894,861,32,1,881,13,1777,883,509,372
9,"BRĂILA","#N/A",42682,,34,"BRĂILA / Căminul de Bătrâni ""Lacu Sărat""",1,3976,"MUNICIPIUL BRĂILA",42682,390,412,163,249,0,408,4,570,158,266,142
9,"BRĂILA","#N/A",42682,,35,"BRĂILA / Grup Scolar ""Ana Aslan""",1,3976,"MUNICIPIUL BRĂILA",42682,984,460,435,24,1,445,15,1085,625,232,213
9,"BRĂILA","#N/A",42682,,36,"BRĂILA / Grup Scolar ""Ana Aslan""",1,3976,"MUNICIPIUL BRĂILA",42682,1441,787,770,17,0,775,12,1583,796,412,363
9,"BRĂILA","#N/A",42682,,37,"BRĂILA / Grupul Şcolar ""Ana Aslan""",1,3976,"MUNICIPIUL BRĂILA",42682,1092,625,588,37,0,616,9,1207,582,292,324
9,"BRĂILA","#N/A",42682,,38,"BRĂILA / Grupul Şcolar ""Ana Aslan""",1,3976,"MUNICIPIUL BRĂILA",42682,1509,850,825,25,0,834,16,1669,819,448,386
9,"BRĂILA","#N/A",42682,,39,"BRĂILA / Grupul Şcolar ""Ana Aslan""",1,3976,"MUNICIPIUL BRĂILA",42682,1603,794,764,30,0,778,16,1760,966,418,360
9,"BRĂILA","#N/A",42682,,40,"BRĂILA / Grupul Şcolar ""Edmond Nicolau""",1,3976,"MUNICIPIUL BRĂILA",42682,1622,928,852,41,35,909,19,1781,853,535,374
9,"BRĂILA","#N/A",42682,,41,"BRĂILA / Grupul Şcolar ""Edmond Nicolau""",1,3976,"MUNICIPIUL BRĂILA",42682,1160,675,660,15,0,665,10,1281,606,392,273
9,"BRĂILA","#N/A",42682,,42,"BRĂILA / CUP ""DUNĂREA""",1,3976,"MUNICIPIUL BRĂILA",42682,1477,855,820,35,0,837,18,1643,788,449,388
9,"BRĂILA","#N/A",42682,,43,"BRĂILA / Şcoala Generală nr.4 ""Alexandru Ioan Cuza""",1,3976,"MUNICIPIUL BRĂILA",42682,1244,813,752,61,0,807,6,1367,554,395,412
9,"BRĂILA","#N/A",42682,,44,"BRĂILA / Şcoala Generală nr.4 ""Alexandru Ioan Cuza""",1,3976,"MUNICIPIUL BRĂILA",42682,1420,900,876,24,0,890,10,1568,668,464,426
9,"BRĂILA","#N/A",42682,,45,"BRĂILA / Şcoala Generală nr.4 ""Alexandru Ioan Cuza""",1,3976,"MUNICIPIUL BRĂILA",42682,1198,765,736,29,0,749,16,1320,555,361,388
9,"BRĂILA","#N/A",42682,,46,"BRĂILA / Şcoala Waldorf",1,3976,"MUNICIPIUL BRĂILA",42682,1511,945,916,28,1,932,13,1659,714,487,445
9,"BRĂILA","#N/A",42682,,47,"BRĂILA / Şcoala Waldorf",1,3976,"MUNICIPIUL BRĂILA",42682,995,733,613,46,74,723,10,1092,359,371,352
9,"BRĂILA","#N/A",42682,,48,"BRĂILA / Şcoala Generală nr.8 ""Ion Băncilă""",1,3976,"MUNICIPIUL BRĂILA",42682,1617,979,941,36,2,962,17,1779,800,510,452
9,"BRĂILA","#N/A",42682,,49,"BRĂILA / Şcoala Generală nr.8 ""Ion Băncilă""",1,3976,"MUNICIPIUL BRĂILA",42682,1227,750,729,21,0,739,11,1352,602,362,377
9,"BRĂILA","#N/A",42682,,50,"BRĂILA / Şcoala Generală nr.8 ""Ion Băncilă""",1,3976,"MUNICIPIUL BRĂILA",42682,782,496,471,25,0,490,6,875,379,256,234
9,"BRĂILA","#N/A",42682,,51,"BRĂILA / Şcoala Generală nr.8 ""Ion Băncilă""",1,3976,"MUNICIPIUL BRĂILA",42682,1065,639,616,23,0,632,7,1172,533,340,292
9,"BRĂILA","#N/A",42682,,52,"BRĂILA / Şcoala Generală nr.8 ""Ion Băncilă""",1,3976,"MUNICIPIUL BRĂILA",42682,1549,911,882,29,0,902,9,1713,802,446,456
9,"BRĂILA","#N/A",42682,,53,"BRĂILA / Liceul ""Panait Cerna""",1,3976,"MUNICIPIUL BRĂILA",42682,979,640,587,52,1,629,11,1078,438,340,289
9,"BRĂILA","#N/A",42682,,54,"BRĂILA / Liceul ""Panait Cerna""",1,3976,"MUNICIPIUL BRĂILA",42682,1090,691,637,54,0,682,9,1199,508,369,313
9,"BRĂILA","#N/A",42682,,55,"BRĂILA / Liceul ""Panait Cerna""",1,3976,"MUNICIPIUL BRĂILA",42682,996,629,587,42,0,621,8,1098,469,343,278
9,"BRĂILA","#N/A",42682,,56,"BRĂILA / Liceul ""Panait Cerna""",1,3976,"MUNICIPIUL BRĂILA",42682,1435,760,724,36,0,750,10,1581,821,435,315
9,"BRĂILA","#N/A",42682,,57,"BRĂILA / Liceul ""Gheorghe Munteanu Murgoci""",1,3976,"MUNICIPIUL BRĂILA",42682,1320,901,851,50,0,893,8,1447,546,432,461
9,"BRĂILA","#N/A",42682,,58,"BRĂILA / Liceul ""Gheorghe Munteanu Murgoci""",1,3976,"MUNICIPIUL BRĂILA",42682,1308,818,755,63,0,800,18,1444,626,391,409
9,"BRĂILA","#N/A",42682,,59,"BRĂILA / Şcoala Generală nr.7 ""Ion Creangă""",1,3976,"MUNICIPIUL BRĂILA",42682,1294,794,752,40,2,782,12,1419,625,392,390
9,"BRĂILA","#N/A",42682,,60,"BRĂILA / Şcoala Generală nr.7 ""Ion Creangă""",1,3976,"MUNICIPIUL BRĂILA",42682,1072,642,624,18,0,631,11,1174,532,286,345
9,"BRĂILA","#N/A",42682,,61,"BRĂILA / Şcoala Generală nr.7 ""Ion Creangă""",1,3976,"MUNICIPIUL BRĂILA",42682,1029,659,582,24,53,655,4,1140,481,341,314
9,"BRĂILA","#N/A",42682,,62,"BRĂILA / Liceul ""Nicolae Iorga""",1,3976,"MUNICIPIUL BRĂILA",42682,908,498,457,24,17,491,7,1016,518,248,243
9,"BRĂILA","#N/A",42682,,63,"BRĂILA / Şcoala Generală nr.5",1,3976,"MUNICIPIUL BRĂILA",42682,1104,599,580,19,0,592,7,1212,613,272,320
9,"BRĂILA","#N/A",42682,,64,"BRĂILA / Colegiul Naţional ""Nicolae Bălcescu""",1,3976,"MUNICIPIUL BRĂILA",42682,1478,882,831,50,1,867,15,1643,761,458,409
9,"BRĂILA","#N/A",42682,,65,"BRĂILA / Liceul de Artă ""Haricleea Darclee""",1,3976,"MUNICIPIUL BRĂILA",42682,1550,909,852,55,2,893,16,1711,802,403,490
9,"BRĂILA","#N/A",42682,,66,"BRĂILA / Liceul de Arte ""Hariclea Darclee""",1,3976,"MUNICIPIUL BRĂILA",42682,1533,938,860,47,31,925,13,1691,753,471,454
9,"BRĂILA","#N/A",42682,,67,"BRĂILA / Grupul Şcolar ""Grigore Moisil"" (fosta Şcoala Generală nr. 25)",1,3976,"MUNICIPIUL BRĂILA",42682,1592,1123,860,42,221,1107,16,1753,630,640,467
9,"BRĂILA","#N/A",42682,,68,"BRĂILA / Şcoala Generală nr.17 ""Ecaterina Teodoroiu""",1,3976,"MUNICIPIUL BRĂILA",42682,1352,1004,829,12,163,989,15,1473,469,545,444
9,"BRĂILA","#N/A",42682,,69,"BRĂILA / Şcoala Generală nr.17 ""Ecaterina Teodoroiu""",1,3976,"MUNICIPIUL BRĂILA",42682,1602,969,930,37,2,959,10,1759,790,509,450
9,"BRĂILA","#N/A",42682,,70,"BRĂILA / Grupul Şcolar Industrial ""Panait Istrati""",1,3976,"MUNICIPIUL BRĂILA",42682,1451,888,862,25,1,869,19,1598,710,461,408
9,"BRĂILA","#N/A",42682,,71,"BRĂILA / Grupul Şcolar Industrial ""Panait Istrati""",1,3976,"MUNICIPIUL BRĂILA",42682,974,633,599,31,3,624,9,1070,437,338,286
9,"BRĂILA","#N/A",42682,,72,"BRĂILA / Grupul Şcolar Industrial ""Panait Istrati""",1,3976,"MUNICIPIUL BRĂILA",42682,1322,754,731,23,0,736,18,1458,704,349,387
9,"BRĂILA","#N/A",42682,,73,"BRĂILA / Şcoala Generală nr.18 ""Mihu Dragomir""",1,3976,"MUNICIPIUL BRĂILA",42682,1102,668,631,36,1,664,4,1234,566,388,276
9,"BRĂILA","#N/A",42682,,74,"BRĂILA / Şcoala Generală nr.18 ""Mihu Dragomir""",1,3976,"MUNICIPIUL BRĂILA",42682,1334,762,733,29,0,755,7,1465,703,418,337
9,"BRĂILA","#N/A",42682,,75,"BRĂILA / Grădiniţa nr. 21 ""Pescăruşu""",1,3976,"MUNICIPIUL BRĂILA",42682,1372,810,776,34,0,803,7,1513,703,435,368
9,"BRĂILA","#N/A",42682,,76,"BRĂILA / Grădiniţa nr. 21 ""Pescăruşu""",1,3976,"MUNICIPIUL BRĂILA",42682,1108,600,590,10,0,592,8,1217,617,333,259
9,"BRĂILA","#N/A",42682,,77,"BRĂILA / Grădiniţa nr. 21 ""Pescăruşu""",1,3976,"MUNICIPIUL BRĂILA",42682,1323,712,696,14,2,699,13,1466,754,347,352
9,"BRĂILA","#N/A",42682,,78,"BRĂILA / Şcoala Generală nr.6 ""C. Sandu Aldea""",1,3976,"MUNICIPIUL BRĂILA",42682,1351,889,836,53,0,871,18,1491,602,427,444
9,"BRĂILA","#N/A",42682,,79,"BRĂILA / Şcoala Generală nr.6 ""C. Sandu Aldea""",1,3976,"MUNICIPIUL BRĂILA",42682,1248,790,754,36,0,771,19,1372,582,423,348
9,"BRĂILA","#N/A",42682,,80,"BRĂILA / Şcoala Generală nr.6 ""C. Sandu Aldea""",1,3976,"MUNICIPIUL BRĂILA",42682,1273,834,794,39,1,821,13,1404,570,423,398
9,"BRĂILA","#N/A",42682,,81,"BRĂILA / Şcoala Generală nr.6 ""C.Sandu Aldea""",1,3976,"MUNICIPIUL BRĂILA",42682,1391,861,838,23,0,843,18,1535,674,395,448
9,"BRĂILA","#N/A",42682,,82,"BRĂILA / Grupul Şcolar ""Anghel Saligny"" (fosta Şcoala Generală nr. 12)",1,3976,"MUNICIPIUL BRĂILA",42682,1325,861,813,48,0,851,10,1464,603,419,432
9,"BRĂILA","#N/A",42682,,83,"BRĂILA / Grupul Şcolar ""Anghel Saligny"" (fosta Şcoala Generală nr. 12)",1,3976,"MUNICIPIUL BRĂILA",42682,1110,685,664,21,0,678,7,1232,547,341,337
9,"BRĂILA","#N/A",42682,,84,"BRĂILA / Grupul Şcolar ""Anghel Saligny"" (fosta Şcoala Generală nr. 12)",1,3976,"MUNICIPIUL BRĂILA",42682,1342,816,781,29,6,803,13,1473,657,391,412
9,"BRĂILA","#N/A",42682,,85,"BRĂILA / Colegiul Economic ""Ion Ghica""",1,3976,"MUNICIPIUL BRĂILA",42682,1183,720,684,35,1,705,15,1294,574,339,366
9,"BRĂILA","#N/A",42682,,86,"BRĂILA / Colegiul Economic ""Ion Ghica""",1,3976,"MUNICIPIUL BRĂILA",42682,1451,830,799,24,7,816,14,1601,771,400,416
9,"BRĂILA","#N/A",42682,,87,"BRĂILA / Casa Corpului Didactic",1,3976,"MUNICIPIUL BRĂILA",42682,1267,778,746,32,0,760,18,1401,623,374,386
9,"BRĂILA","#N/A",42682,,88,"BRĂILA / Şcoala Generală nr.32 ""Dimitrie Cantemir""",1,3976,"MUNICIPIUL BRĂILA",42682,1307,719,679,40,0,706,13,1436,717,391,315
9,"BRĂILA","#N/A",42682,,89,"BRĂILA / Şcoala Generală nr.32 ""Dimitrie Cantemir""",1,3976,"MUNICIPIUL BRĂILA",42682,1493,911,877,34,0,895,16,1637,726,506,389
9,"BRĂILA","#N/A",42682,,90,"BRĂILA / Şcoala Generală nr.32 ""Dimitrie Cantemir""",1,3976,"MUNICIPIUL BRĂILA",42682,943,549,534,15,0,543,6,1040,491,334,209
9,"BRĂILA","#N/A",42682,,91,"BRĂILA / Şcoala Generală nr.32 ""Dimitrie Cantemir""",1,3976,"MUNICIPIUL BRĂILA",42682,1344,774,756,16,2,763,11,1478,704,479,284
9,"BRĂILA","#N/A",42682,,92,"BRĂILA / Şcoala Generală nr.32 ""Dimitrie Cantemir""",1,3976,"MUNICIPIUL BRĂILA",42682,1537,938,922,15,1,915,23,1693,755,501,414
9,"BRĂILA","#N/A",42682,,93,"BRĂILA / Grădiniţa ""Furnicuţa""",1,3976,"MUNICIPIUL BRĂILA",42682,1500,870,845,24,1,861,9,1657,787,453,408
9,"BRĂILA","#N/A",42682,,94,"BRĂILA / Grădiniţa nr.48 ""Luceafărul""",1,3976,"MUNICIPIUL BRĂILA",42682,1316,833,804,29,0,821,12,1448,615,449,372
9,"BRĂILA","#N/A",42682,,95,"BRĂILA / Grădiniţa nr.48 ""Luceafărul""",1,3976,"MUNICIPIUL BRĂILA",42682,1275,768,749,19,0,757,11,1402,634,445,312
9,"BRĂILA","#N/A",42682,,96,"BRĂILA / Grădiniţa nr. 37",1,3976,"MUNICIPIUL BRĂILA",42682,1231,1002,758,47,197,977,25,1350,348,616,361
9,"BRĂILA","#N/A",42682,,97,"BRĂILA / Grădiniţa nr. 37",1,3976,"MUNICIPIUL BRĂILA",42682,1848,1131,1091,39,1,1120,11,2032,901,567,553
9,"BRĂILA","#N/A",42682,,98,"BRĂILA / Grădiniţa nr. 37",1,3976,"MUNICIPIUL BRĂILA",42682,1383,839,796,43,0,832,7,1526,687,427,405
9,"BRĂILA","#N/A",42682,,99,"BRĂILA / Liceul Pedagogic ""D.P. Perpessicius""",1,3976,"MUNICIPIUL BRĂILA",42682,1146,695,653,40,2,685,10,1270,575,366,319
9,"BRĂILA","#N/A",42682,,100,"BRĂILA / Liceul Pedagogic ""D.P. Perpessicius""",1,3976,"MUNICIPIUL BRĂILA",42682,1550,949,929,20,0,936,13,1720,771,559,377
9,"BRĂILA","#N/A",42682,,101,"BRĂILA / Liceul Pedagogic ""D.P. Perpessicius""",1,3976,"MUNICIPIUL BRĂILA",42682,1553,996,972,24,0,982,14,1713,717,586,396
9,"BRĂILA","#N/A",42682,,102,"BRĂILA / Şcoala Generală nr.23 ""Mihai Eminescu""",1,3976,"MUNICIPIUL BRĂILA",42682,1076,557,509,48,0,551,6,1191,634,327,224
9,"BRĂILA","#N/A",42682,,103,"BRĂILA / Şcoala Generală nr.23 ""Mihai Eminescu""",1,3976,"MUNICIPIUL BRĂILA",42682,1415,732,707,25,0,720,12,1566,834,421,299
9,"BRĂILA","#N/A",42682,,104,"BRĂILA / Şcoala Generală nr.23 ""Mihai Eminescu""",1,3976,"MUNICIPIUL BRĂILA",42682,1261,782,745,37,0,770,12,1392,610,446,324
9,"BRĂILA","#N/A",42682,,105,"BRĂILA / Şcoala Generală nr.9",1,3976,"MUNICIPIUL BRĂILA",42682,1139,593,564,29,0,582,11,1250,657,373,209
9,"BRĂILA","#N/A",42682,,106,"BRĂILA / Şcoala Generală nr.9",1,3976,"MUNICIPIUL BRĂILA",42682,1235,613,589,24,0,592,21,1358,745,371,221
9,"BRĂILA","#N/A",42682,,107,"BRĂILA / Şcoala Generală nr.9",1,3976,"MUNICIPIUL BRĂILA",42682,1264,673,654,19,0,658,15,1392,719,373,285
9,"BRĂILA","#N/A",42682,,108,"BRĂILA / Şcoala Generală nr.9",1,3976,"MUNICIPIUL BRĂILA",42682,1214,638,626,11,1,630,8,1338,700,345,285
9,"BRĂILA","#N/A",42682,,109,"BRĂILA / Şcoala Generală nr.13",1,3976,"MUNICIPIUL BRĂILA",42682,1339,761,729,31,1,750,11,1473,712,399,351
9,"BRĂILA","#N/A",42682,,110,"BRĂILA / Şcoala Generală nr.13",1,3976,"MUNICIPIUL BRĂILA",42682,1342,789,767,22,0,770,19,1476,687,455,315
9,"BRĂILA","#N/A",42682,,111,"BRĂILA / Şcoala Generală nr.22",1,3976,"MUNICIPIUL BRĂILA",42682,1394,798,775,23,0,787,11,1535,737,492,295
9,"BRĂILA","#N/A",42682,,112,"BRĂILA / Şcoala Generală nr.22",1,3976,"MUNICIPIUL BRĂILA",42682,1414,803,792,11,0,794,9,1558,755,491,303
9,"BRĂILA","#N/A",42682,,113,"BRĂILA / Şcoala Generală nr.22",1,3976,"MUNICIPIUL BRĂILA",42682,1297,727,714,13,0,716,11,1426,699,384,332
9,"BRĂILA","#N/A",42682,,114,"BRĂILA / Şcoala Generală nr.22",1,3976,"MUNICIPIUL BRĂILA",42682,1248,715,697,18,0,704,11,1373,658,417,287
9,"BRĂILA","#N/A",42682,,115,"BRĂILA / Şcoala Generală nr.22",1,3976,"MUNICIPIUL BRĂILA",42682,1232,714,700,14,0,702,12,1360,646,397,305
9,"BRĂILA","#N/A",42682,,116,"BRĂILA / Caminul Cultural",1,3976,"MUNICIPIUL BRĂILA",42682,1455,789,759,30,0,778,11,1604,815,501,277
9,"BRĂILA","#N/A",42682,,117,"BRĂILA / Şcoala Generală nr.24",1,3976,"MUNICIPIUL BRĂILA",42682,1405,724,693,31,0,709,15,1554,830,400,309
9,"BRĂILA","#N/A",42682,,118,"BRĂILA / Şcoala Generală nr.24",1,3976,"MUNICIPIUL BRĂILA",42682,1549,833,814,19,0,824,9,1702,869,486,338
9,"BRĂILA","#N/A",42682,,119,"BRĂILA / Şcoala Generală nr.24",1,3976,"MUNICIPIUL BRĂILA",42682,1366,832,809,22,1,824,8,1505,673,444,380
9,"BRĂILA","#N/A",42682,,120,"BRĂILA / S.C. AISE ELECTROSERV",1,3976,"MUNICIPIUL BRĂILA",42682,1451,734,697,28,9,723,11,1598,864,404,319
9,"BRĂILA","#N/A",42682,,121,"BRĂILA / Grădiniţa nr. 8 ""Scufita Rosie""",1,3976,"MUNICIPIUL BRĂILA",42682,1312,740,720,19,1,731,9,1443,703,420,311
9,"BRĂILA","#N/A",42682,,122,"BRĂILA / Grădiniţa nr. 8 ""Scufita Rosie""",1,3976,"MUNICIPIUL BRĂILA",42682,1291,705,689,16,0,693,12,1416,711,389,304
9,"BRĂILA","#N/A",42682,,123,"BRĂILA / Şcoala Generală nr.11 ""I.L.Caragiale""",1,3976,"MUNICIPIUL BRĂILA",42682,1253,696,665,31,0,676,20,1382,686,365,311
9,"BRĂILA","#N/A",42682,,124,"BRĂILA / Şcoala Generală nr.11 ""I.L. Caragiale""",1,3976,"MUNICIPIUL BRĂILA",42682,1345,718,706,12,0,705,13,1490,772,396,309
9,"BRĂILA","#N/A",42682,,125,"BRĂILA / Şcoala Generală nr.19 ""Mihail Kogălniceanu""",1,3976,"MUNICIPIUL BRĂILA",42682,1429,846,821,25,0,830,16,1576,730,436,394
9,"BRĂILA","#N/A",42682,,126,"BRĂILA / Şcoala Generală nr.19 ""Mihail Kogălniceanu""",1,3976,"MUNICIPIUL BRĂILA",42682,1301,703,681,22,0,688,15,1435,732,410,278
9,"BRĂILA","#N/A",42682,,127,"BRĂILA / Şcoala Generală nr.19 ""Mihail Kogălniceanu""",1,3976,"MUNICIPIUL BRĂILA",42682,1428,770,761,9,0,763,7,1570,800,415,348
9,"BRĂILA","#N/A",42682,,128,"BRĂILA / Şcoala Generală nr.19 ""Mihail Kogălniceanu""",1,3976,"MUNICIPIUL BRĂILA",42682,1477,828,801,27,0,816,12,1609,781,414,402
9,"BRĂILA","#N/A",42682,,129,"BRĂILA / Şcoala Generală nr.21",1,3976,"MUNICIPIUL BRĂILA",42682,1305,645,620,25,0,628,17,1440,795,280,348
9,"BRĂILA","#N/A",42682,,130,"BRĂILA / Şcoala Generală nr.21",1,3976,"MUNICIPIUL BRĂILA",42682,1345,707,690,17,0,696,11,1481,774,358,338
9,"BRĂILA","#N/A",42682,,131,"BRĂILA / Şcoala Generală nr.20 ""George Coşbuc""",1,3976,"MUNICIPIUL BRĂILA",42682,1483,827,800,26,1,816,11,1631,804,465,351
9,"BRĂILA","#N/A",42682,,132,"BRĂILA / Şcoala Generală nr.20 ""George Coşbuc""",1,3976,"MUNICIPIUL BRĂILA",42682,1274,717,709,8,0,712,5,1402,685,413,299
9,"BRĂILA","#N/A",42682,,133,"BRĂILA / Şcoala Generală nr.20 ""George Coşbuc""",1,3976,"MUNICIPIUL BRĂILA",42682,1453,829,814,15,0,813,16,1603,774,471,342
9,"BRĂILA","#N/A",42682,,134,"BRĂILA / Grupul Şcolar Industrial ""Constantin Brâncoveanu""",1,3976,"MUNICIPIUL BRĂILA",42682,1116,666,633,33,0,661,5,1227,561,359,302
9,"BRĂILA","#N/A",42682,,135,"BRĂILA / Grupul Şcolar Industrial ""Constantin Brâncoveanu""",1,3976,"MUNICIPIUL BRĂILA",42682,1660,853,814,39,0,841,12,1826,973,490,351
9,"BRĂILA","#N/A",42682,,136,"BRĂILA / Grupul Şcolar Industrial ""Constantin Brâncoveanu""",1,3976,"MUNICIPIUL BRĂILA",42682,1399,804,754,50,0,794,10,1547,743,440,354
9,"BRĂILA","#N/A",42682,,137,"BRĂILA / Grupul Şcolar Industrial ""Constantin Brâncoveanu""",1,3976,"MUNICIPIUL BRĂILA",42682,1298,753,736,17,0,742,11,1427,674,443,299
9,"BRĂILA","#N/A",42682,,138,"BRĂILA / Grupul Şcolar Industrial ""Constantin Brâncoveanu""",1,3976,"MUNICIPIUL BRĂILA",42682,1266,598,584,14,0,587,11,1394,796,373,214
9,"BRĂILA","#N/A",42682,,139,"BRĂILA / Şcoala Generală nr.33 ""Sf.Andrei""",1,3976,"MUNICIPIUL BRĂILA",42682,1179,668,648,20,0,653,15,1296,628,335,318
9,"BRĂILA","#N/A",42682,,140,"BRĂILA / Şcoala Generală nr.33 ""Sf.Andrei""",1,3976,"MUNICIPIUL BRĂILA",42682,1461,778,757,20,1,772,6,1617,839,421,351
9,"BRĂILA","#N/A",42682,,141,"BRĂILA / Şcoala Generală nr.33 ""Sf.Andrei""",1,3976,"MUNICIPIUL BRĂILA",42682,1222,680,664,16,0,667,13,1346,666,394,273
9,"BRĂILA","#N/A",42753,,142,"FĂUREI / Casa de Cultură Făurei",1,3978,"ORAŞ FĂUREI",42753,1514,932,839,81,12,920,12,1677,745,551,369
9,"BRĂILA","#N/A",42753,,143,"FĂUREI / Şcoala Generală nr.1 Făurei",1,3978,"ORAŞ FĂUREI",42753,1432,852,798,34,20,838,14,1576,724,468,370
9,"BRĂILA","#N/A",42753,,144,"FĂUREI / Şcoala Generală nr.2 Făurei",1,3978,"ORAŞ FĂUREI",42753,538,315,290,23,2,305,10,613,298,180,125
9,"BRĂILA","#N/A",43331,,145,"IANCA / Scoala Gimnaziala Ianca",1,3980,"ORAŞ IANCA",43331,1120,628,603,24,1,619,9,1240,612,400,219
9,"BRĂILA","#N/A",43331,,146,"IANCA / Scoala Gimnaziala Ianca",1,3980,"ORAŞ IANCA",43331,1246,676,646,29,1,670,6,1371,695,399,271
9,"BRĂILA","#N/A",43331,,147,"IANCA / Casa de Cultura ""Ion Theodorescu Sion""",1,3980,"ORAŞ IANCA",43331,1203,757,640,117,0,747,10,1324,567,451,296
9,"BRĂILA","#N/A",43331,,148,"IANCA / Liceul teoretic ""Constantin Angelescu""",1,3980,"ORAŞ IANCA",43331,1060,577,546,26,5,571,6,1169,592,357,214
9,"BRĂILA","#N/A",43331,,149,"IANCA / Liceul teoretic ""Constantin Angelescu""",1,3980,"ORAŞ IANCA",43331,977,610,554,45,11,602,8,1076,466,385,217
9,"BRĂILA","#N/A",43331,,150,"PLOPU / Şcoala gimnazială Plopu",1,3980,"ORAŞ IANCA",43331,1267,722,687,35,0,715,7,1395,673,562,153
9,"BRĂILA","#N/A",43331,,151,"OPRIŞENEŞTI / Şcoala primară Oprişeneşti",1,3980,"ORAŞ IANCA",43331,673,421,375,46,0,416,5,742,321,242,174
9,"BRĂILA","#N/A",43331,,152,"PERIŞORU / Şcoala gimnazială Perişoru",1,3980,"ORAŞ IANCA",43331,879,573,528,37,8,569,4,966,393,391,178
9,"BRĂILA","#N/A",43331,,153,"TÎRLELE FILIU / Şcoala primară Tîrlele Filiu",1,3980,"ORAŞ IANCA",43331,471,329,274,55,0,325,4,521,192,219,106
9,"BRĂILA","#N/A",43331,,154,"BERLEŞTI / Şcoala primară Berleşti",1,3980,"ORAŞ IANCA",43331,279,184,160,23,1,181,3,307,123,122,59
9,"BRĂILA","#N/A",43411,,155,"ÎNSURĂŢEI / Şcoala generală cu clasele I - VIII  - locaţia nr. 1",1,3988,"ORAŞ ÎNSURĂŢEI",43411,1189,510,484,26,0,502,8,1312,802,360,142
9,"BRĂILA","#N/A",43411,,156,"ÎNSURĂŢEI / Şcoala generală cu clasele I-VIII - locaţia nr. 1",1,3988,"ORAŞ ÎNSURĂŢEI",43411,1052,543,510,33,0,539,4,1160,617,376,163
9,"BRĂILA","#N/A",43411,,157,"ÎNSURĂŢEI / Grupul Şcolar Industrial Însurăţei - Şcoala anexa",1,3988,"ORAŞ ÎNSURĂŢEI",43411,1038,544,505,38,1,539,5,1141,597,319,220
9,"BRĂILA","#N/A",43411,,158,"ÎNSURĂŢEI / Grupul Şcolar Industrial Însurăţei - Şcoala anexa",1,3988,"ORAŞ ÎNSURĂŢEI",43411,878,439,411,28,0,431,8,965,526,289,142
9,"BRĂILA","#N/A",43411,,159,"ÎNSURĂŢEI / Şcoala generală cu clasele I-VIII - locaţia nr 2",1,3988,"ORAŞ ÎNSURĂŢEI",43411,1328,690,658,32,0,680,10,1459,769,488,192
9,"BRĂILA","#N/A",43411,,160,"LACU REZII / Şcoala cu clasele I - IV  - sat Lacu Rezii",1,3988,"ORAŞ ÎNSURĂŢEI",43411,390,171,156,15,0,170,1,429,258,117,53
9,"BRĂILA","#N/A",42824,,161,"BĂRĂGANUL / ŞCOALA CU CLASELE I - VIII BĂRĂGANUL",3,3993,"BĂRĂGANUL",42824,1320,677,624,53,0,663,14,1456,779,437,226
9,"BRĂILA","#N/A",42824,,162,"BĂRĂGANUL / SCOALA CU CLS. I - VIII BĂRĂGANUL - SALA DE CLASĂ NR. 1",3,3993,"BĂRĂGANUL",42824,1339,728,667,61,0,712,16,1477,749,506,206
9,"BRĂILA","#N/A",42842,,163,"BERTEŞTII DE JOS / Căminul Cultural Berteştii de Jos",3,3995,"BERTEŞTII DE JOS",42842,719,392,368,24,0,391,1,799,407,179,212
9,"BRĂILA","#N/A",42842,,164,"SPIRU HARET / Căminul Cultural Spiru Haret",3,3995,"BERTEŞTII DE JOS",42842,1244,596,562,34,0,591,5,1374,778,381,210
9,"BRĂILA","#N/A",42842,,165,"BERTEŞTII DE SUS / Căminul Cultural Berteştii de Sus",3,3995,"BERTEŞTII DE JOS",42842,280,177,158,19,0,175,2,307,130,122,53
9,"BRĂILA","#N/A",42842,,166,"GURA CĂLMĂŢUI / Şcoala Gura Călmăţui",3,3995,"BERTEŞTII DE JOS",42842,273,177,154,23,0,177,0,300,123,78,99
9,"BRĂILA","#N/A",42913,,167,"BORDEI VERDE / Şcoala cu clasele I-VIII Bordei Verde",3,4002,"BORDEI VERDE",42913,1172,827,761,65,1,821,6,1293,466,465,356
9,"BRĂILA","#N/A",42913,,168,"CONSTANTIN GABRIELESCU / Şcoala cu clasele I-IV Constantin Gabrielescu",3,4002,"BORDEI VERDE",42913,601,366,340,24,2,365,1,663,297,207,158
9,"BRĂILA","#N/A",42913,,169,"LIŞCOTEANCA / Căminul Cultural Lişcoteanca",3,4002,"BORDEI VERDE",42913,455,304,273,31,0,300,4,501,197,182,118
9,"BRĂILA","#N/A",44560,,170,"CAZASU / Scoala cu clasele I-IV Cazasu (Satuc)",3,4007,"CAZASU",44560,1198,728,671,57,0,714,14,1317,589,331,383
9,"BRĂILA","#N/A",44560,,171,"CAZASU / Scoala cu clasele I-VIII Cazasu",3,4007,"CAZASU",44560,1555,929,867,62,0,920,9,1716,787,431,489
9,"BRĂILA","#N/A",42708,,172,"CHIŞCANI / Scoala cu clasele I-VIII chiscani - centru",3,4009,"CHIŞCANI",42708,1451,744,693,51,0,731,13,1600,856,434,297
9,"BRĂILA","#N/A",42708,,173,"CHIŞCANI / Scoala cu clasele I-IV chiscani - cartier",3,4009,"CHIŞCANI",42708,1861,958,893,65,0,940,18,2055,1097,511,429
9,"BRĂILA","#N/A",42708,,174,"LACU SĂRAT / SCOALA CU CLASE I-V LACU SARAT",3,4009,"CHIŞCANI",42708,1397,824,767,57,0,815,9,1533,709,443,372
9,"BRĂILA","#N/A",42968,,175,"CIOCILE / CAMINUL CULTURAL CIOCILE",3,4013,"CIOCILE",42968,830,507,471,36,0,500,7,910,403,334,166
9,"BRĂILA","#N/A",42968,,176,"CIOCILE / CAMINUL CULTURAL CIOCILE",3,4013,"CIOCILE",42968,878,537,500,37,0,520,17,967,430,391,129
9,"BRĂILA","#N/A",42968,,177,"CHICHINEŢU / Şcoala generală Chichineţu",3,4013,"CIOCILE",42968,458,274,250,24,0,271,3,504,230,210,61
9,"BRĂILA","#N/A",43019,,178,"CIREŞU / Şcoala cu clasele I-VIII Cireşu",3,4018,"CIREŞU",43019,786,457,409,48,0,453,4,867,410,192,261
9,"BRĂILA","#N/A",43019,,179,"BATOGU / Şcoala cu clasele I-VIII Batogu",3,4018,"CIREŞU",43019,546,352,308,44,0,350,2,601,249,169,181
9,"BRĂILA","#N/A",43019,,180,"SCĂRLĂTEŞTI / Şcoala cu clasele I-VIII Scărlăteşti",3,4018,"CIREŞU",43019,732,437,409,28,0,433,4,808,371,207,226
9,"BRĂILA","#N/A",43019,,181,"VULTURENI / Şcoala cu clasele I-VIII Vultureni",3,4018,"CIREŞU",43019,503,340,308,32,0,337,3,553,213,190,147
9,"BRĂILA","#N/A",43073,,182,"DUDEŞTI / Căminul Cultural Dudeşti",3,4024,"DUDEŞTI",43073,1406,742,698,44,0,736,6,1549,807,547,189
9,"BRĂILA","#N/A",43073,,183,"TĂTARU / Şcoala cu clasele V-VIII Tătaru",3,4024,"DUDEŞTI",43073,1184,687,644,43,0,681,6,1308,621,522,159
9,"BRĂILA","#N/A",43073,,184,"TĂTARU / ŞCOALA CU CLASELE I-IV TATARU",3,4024,"DUDEŞTI",43073,418,246,216,30,0,244,2,458,212,180,64
9,"BRĂILA","#N/A",43117,,185,"AGAUA / Şcoala cu clasele I-IV Agaua",3,4028,"FRECĂŢEI",43117,433,303,274,29,0,299,4,477,174,134,165
9,"BRĂILA","#N/A",43117,,186,"FRECĂŢEI / Şcoala cu clasele I-VIII Frecăţei",3,4028,"FRECĂŢEI",43117,305,198,179,19,0,198,0,335,137,94,104
9,"BRĂILA","#N/A",43117,,187,"TITCOV / Şcoala cu clasele I-IV Titcov",3,4028,"FRECĂŢEI",43117,368,228,208,19,1,227,1,406,178,89,138
9,"BRĂILA","#N/A",43180,,188,"GALBENU / Şcoala gimnaziala ""TOMA TAMPEANU"" Galbenu",3,4035,"GALBENU",43180,798,433,381,52,0,431,2,884,451,329,102
9,"BRĂILA","#N/A",43180,,189,"SĂTUC / Şcoala generală Sătuc",3,4035,"GALBENU",43180,594,315,281,34,0,310,5,653,338,239,71
9,"BRĂILA","#N/A",43180,,190,"ZAMFIREŞTI / Şcoala generală Zamfireşti",3,4035,"GALBENU",43180,302,189,162,27,0,183,6,333,144,143,40
9,"BRĂILA","#N/A",43180,,191,"DROGU / Şcoala generală Drogu",3,4035,"GALBENU",43180,694,402,356,46,0,396,6,763,361,324,72
9,"BRĂILA","#N/A",43180,,192,"PÎNTECANI / Şcoala generală Pântecani",3,4035,"GALBENU",43180,141,114,92,22,0,114,0,157,43,85,29
9,"BRĂILA","#N/A",43242,,193,"GEMENELE / Şcoala gimnazială cu clasele I-VIII",3,4041,"GEMENELE",43242,1493,992,922,70,0,988,4,1647,655,708,280
9,"BRĂILA","#N/A",43279,,194,"GRADIŞTEA / CAMIN CULTURAL GRADISTEA",3,4044,"GRADIŞTEA",43279,1030,651,566,85,0,639,12,1133,482,247,392
9,"BRĂILA","#N/A",43279,,195,"IBRIANU / CAMINUL CULTURAL IBRIANU",3,4044,"GRADIŞTEA",43279,544,350,312,38,0,345,5,602,252,155,190
9,"BRĂILA","#N/A",43279,,196,"MARALOIU / CAMINUL CULTURAL MARALOIU",3,4044,"GRADIŞTEA",43279,253,193,151,42,0,192,1,279,86,92,100
9,"BRĂILA","#N/A",43313,,197,"GROPENI / CAMIN CULTURAL",3,4048,"GROPENI",43313,1431,841,759,80,2,830,11,1569,728,523,307
9,"BRĂILA","#N/A",43313,,198,"GROPENI / Scoala Gimnaziala Gropeni",3,4048,"GROPENI",43313,1402,818,754,64,0,806,12,1544,726,480,326
9,"BRĂILA","#N/A",43466,,199,"JIRLĂU / Căminul Cultural",3,4050,"JIRLĂU",43466,948,470,431,39,0,463,7,1078,608,335,128
9,"BRĂILA","#N/A",43466,,200,"JIRLĂU / Scoala nr.1",3,4050,"JIRLĂU",43466,1639,752,709,43,0,748,4,1775,1023,467,281
9,"BRĂILA","#N/A",43493,,201,"MĂRAŞU / Căminul Cultural Măraşu",3,4053,"MĂRAŞU",43493,807,460,428,32,0,451,9,888,428,240,211
9,"BRĂILA","#N/A",43493,,202,"BĂNDOIU / Şcoala gimnazială I-IV Băndoiu",3,4053,"MĂRAŞU",43493,349,222,209,13,0,220,2,388,166,115,105
9,"BRĂILA","#N/A",43493,,203,"ŢĂCĂU / Şcoala gimnazială I-VIII Ţăcău",3,4053,"MĂRAŞU",43493,602,337,317,20,0,332,5,665,328,159,173
9,"BRĂILA","#N/A",43493,,204,"MĂGURENI / Căminul Cultural Măgureni",3,4053,"MĂRAŞU",43493,437,235,220,15,0,232,3,480,245,113,119
9,"BRĂILA","#N/A",43493,,205,"PLOPI / Şcoala gimnazială I-IV Plopi",3,4053,"MĂRAŞU",43493,166,123,110,13,0,123,0,186,63,64,59
9,"BRĂILA","#N/A",43563,,206,"MĂXINENI / Şcoala generală cu clasele I-VIII Măxineni",3,4060,"MĂXINENI",43563,1245,719,650,69,0,717,2,1372,653,344,373
9,"BRĂILA","#N/A",43563,,207,"CORBU NOU / Căminul Cultural Corbu Nou",3,4060,"MĂXINENI",43563,724,384,316,68,0,383,1,794,410,255,128
9,"BRĂILA","#N/A",43563,,208,"CORBU VECHI / Căminul Cultural Corbu Vechi",3,4060,"MĂXINENI",43563,245,164,151,13,0,164,0,271,107,86,78
9,"BRĂILA","#N/A",43563,,209,"LATINU / CAMIN CULTURAL LATINU",3,4060,"MĂXINENI",43563,628,342,303,39,0,336,6,688,346,222,114
9,"BRĂILA","#N/A",43625,,210,"MIRCEA VODĂ / SCOALA GIMNAZIALA MIRCEA VODA, JUDEŢUL BRAILA",3,4066,"MIRCEA VODĂ",43625,932,537,505,31,1,529,8,1023,486,317,212
9,"BRĂILA","#N/A",43625,,211,"MIRCEA VODĂ / SCOALA GIMNAZIALA MIRCEA VODA, JUDETUL BRAILA",3,4066,"MIRCEA VODĂ",43625,1064,572,523,48,1,561,11,1173,601,339,222
9,"BRĂILA","#N/A",43625,,212,"DEDULEŞTI / SCOALA GIMNAZIALA SAT DEDULESTI",3,4066,"MIRCEA VODĂ",43625,758,445,404,41,0,441,4,835,390,242,199
9,"BRĂILA","#N/A",43652,,213,"MOVILA MIRESII / SCOALA VECHE",3,4069,"MOVILA MIRESII",43652,1170,740,678,62,0,728,12,1293,553,573,155
9,"BRĂILA","#N/A",43652,,214,"MOVILA MIRESII / CAMIN CULTURAL M.MIRESII",3,4069,"MOVILA MIRESII",43652,1162,765,693,72,0,752,13,1282,517,584,168
9,"BRĂILA","#N/A",43652,,215,"ŢEPEŞ VODĂ / SCOALA TEPES VODA",3,4069,"MOVILA MIRESII",43652,786,456,418,38,0,453,3,864,408,346,107
9,"BRĂILA","#N/A",43652,,216,"ESNA / SCOALA ESNA",3,4069,"MOVILA MIRESII",43652,266,180,164,16,0,175,5,294,114,154,21
9,"BRĂILA","#N/A",43698,,217,"RACOVIŢĂ / Căminul Cultural Racoviţa",3,4073,"RACOVIŢĂ",43698,967,593,540,53,0,590,3,1071,478,445,145
9,"BRĂILA","#N/A",43732,,218,"RÎMNICELU / Şcoala cu clasele I-VIII Rîmnicelu",3,4077,"RÎMNICELU",43732,1176,614,552,62,0,612,2,1289,675,436,176
9,"BRĂILA","#N/A",43732,,219,"CONSTANTINEŞTI / Şcoala cu clasele I-IV Constantineşti",3,4077,"RÎMNICELU",43732,265,179,143,36,0,177,2,291,112,142,35
9,"BRĂILA","#N/A",43732,,220,"MIHAIL KOGĂLNICEANU / Şcoala cu clasele I-IV Mihail Kogălniceanu",3,4077,"RÎMNICELU",43732,213,141,112,29,0,140,1,235,94,100,40
9,"BRĂILA","#N/A",43787,,221,"ROMANU / Şcoala cu clasele I-VIII Romanu",3,4082,"ROMANU",43787,1198,672,586,84,2,664,8,1320,648,386,278
9,"BRĂILA","#N/A",43787,,222,"OANCEA / Şcoala cu clasele I-IV Oancea",3,4082,"ROMANU",43787,346,202,171,31,0,200,2,383,181,139,61
9,"BRĂILA","#N/A",43812,,223,"ROŞIORI / Casa de Cultură Roşiori",3,4085,"ROŞIORI",43812,1354,758,699,59,0,742,16,1494,736,599,143
9,"BRĂILA","#N/A",43812,,224,"COLŢEA / Şcoala cu clasele I-VIII Colţea",3,4085,"ROŞIORI",43812,884,553,505,48,0,550,3,972,419,463,87
9,"BRĂILA","#N/A",43867,,225,"SALCIA TUDOR / Căminul Cultural Salcia Tudor",3,4090,"SALCIA TUDOR",43867,612,411,370,41,0,409,2,677,266,170,239
9,"BRĂILA","#N/A",43867,,226,"CUZA VODĂ / Şcoala generală Cuza Vodă",3,4090,"SALCIA TUDOR",43867,762,413,376,37,0,413,0,845,432,221,192
9,"BRĂILA","#N/A",43867,,227,"GULIANCA / Căminul Cultural Gulianca",3,4090,"SALCIA TUDOR",43867,342,189,165,24,0,184,5,378,189,85,99
9,"BRĂILA","#N/A",43867,,228,"OLĂNEASCA / Căminul Cultural Olăneasca",3,4090,"SALCIA TUDOR",43867,351,196,178,18,0,194,2,389,193,108,86
9,"BRĂILA","#N/A",43867,,229,"ARICIU / Căminul Cultural Ariciu",3,4090,"SALCIA TUDOR",43867,135,95,79,16,0,94,1,149,54,54,40
9,"BRĂILA","#N/A",43929,,230,"SCORŢARU NOU / Şcoala gimnazială Scorţaru Nou",3,4096,"SCORŢARU NOU",43929,710,450,385,65,0,440,10,779,329,203,237
9,"BRĂILA","#N/A",43929,,231,"SIHLEANU / Grădiniţa cu program normal Sihleanu",3,4096,"SCORŢARU NOU",43929,397,265,226,39,0,262,3,437,172,150,112
9,"BRĂILA","#N/A",43992,,232,"SILIŞTEA / Căminul Cultural Siliştea",3,4103,"SILIŞTEA",43992,897,573,488,85,0,572,1,988,415,377,195
9,"BRĂILA","#N/A",43992,,233,"MUCHEA / Şcoala generală Muchea",3,4103,"SILIŞTEA",43992,328,282,229,53,0,278,4,360,78,205,73
9,"BRĂILA","#N/A",43992,,234,"COTU LUNG / Şcoala generală Cotu Lung",3,4103,"SILIŞTEA",43992,251,189,137,52,0,187,2,275,86,127,60
9,"BRĂILA","#N/A",44060,,235,"STĂNCUŢA / Şcoala gimnaziala Stăncuţa",3,4110,"STĂNCUŢA",44060,1319,802,741,61,0,794,8,1454,652,610,184
9,"BRĂILA","#N/A",44060,,236,"CUZA VODĂ / Căminul Cultural Cuza Vodă",3,4110,"STĂNCUŢA",44060,1216,736,698,36,2,725,11,1339,603,473,252
9,"BRĂILA","#N/A",44060,,237,"STANCA / Şcoala  Stanca",3,4110,"STĂNCUŢA",44060,387,260,218,42,0,259,1,425,165,191,68
9,"BRĂILA","#N/A",44113,,238,"SURDILA-GĂISEANCA / Căminul Cultural Surdila Găiseanca",3,4115,"SURDILA-GĂISEANCA",44113,1367,881,820,61,0,871,10,1507,626,611,260
9,"BRĂILA","#N/A",44113,,239,"FILIPEŞTI / Şcoala generală cu clasele I-IV Filipeşti",3,4115,"SURDILA-GĂISEANCA",44113,665,454,373,81,0,449,5,733,279,285,164
9,"BRĂILA","#N/A",42771,,240,"SURDILA-GRECI / Şcoala cu clasele I-VIII Surdila Greci",3,4118,"SURDILA-GRECI",42771,629,431,356,75,0,430,1,694,263,191,239
9,"BRĂILA","#N/A",42771,,241,"FĂUREI SAT / Şcoala cu clasele I-IV Făurei - Sat",3,4118,"SURDILA-GRECI",42771,288,214,179,35,0,214,0,315,101,115,99
9,"BRĂILA","#N/A",42771,,242,"HORIA / Şcoala cu clasele I-IV Horia",3,4118,"SURDILA-GRECI",42771,335,256,228,28,0,252,4,369,113,109,143
9,"BRĂILA","#N/A",44140,,243,"ŞUŢEŞTI / CĂMINUL CULTURAL ŞUŢEŞTi",3,4123,"ŞUŢEŞTI",44140,1199,621,576,45,0,613,8,1327,706,367,246
9,"BRĂILA","#N/A",44140,,244,"ŞUŢEŞTI / ŞCOALA GIMNAZIALĂ ŞUŢEŞTI (ŞCOALA DE ARTE ŞI MESERII)",3,4123,"ŞUŢEŞTI",44140,1280,682,630,51,1,677,5,1418,736,410,267
9,"BRĂILA","#N/A",44140,,245,"ŞUŢEŞTI / ŞCOALA GIMNAZIALĂ ŞUŢEŞTI (ŞCOALA DE ARTE ŞI MESERII)",3,4123,"ŞUŢEŞTI",44140,966,477,452,25,0,473,4,1065,588,277,196
9,"BRĂILA","#N/A",44140,,246,"MIHAIL KOGĂLNICEANU / ŞCOALA CU CLASELE I-IV MIHAIL KOGĂLNICEANU",3,4123,"ŞUŢEŞTI",44140,289,182,153,29,0,177,5,322,140,110,67
9,"BRĂILA","#N/A",44177,,247,"TICHILEŞTI / SCOALA CU CLASELE I-VIII TICHILESTI",3,4126,"TICHILEŞTI",44177,1455,954,768,50,136,944,10,1603,649,526,418
9,"BRĂILA","#N/A",44177,,248,"TICHILEŞTI / SCOALA CU CLASELE I-VIII TICHILESTI",3,4126,"TICHILEŞTI",44177,1426,775,730,45,0,767,8,1570,795,387,380
9,"BRĂILA","#N/A",44177,,249,"ALBINA / Şcoala generală Albina",3,4126,"TICHILEŞTI",44177,256,215,149,66,0,213,2,281,66,88,125
9,"BRĂILA","#N/A",44202,,250,"TRAIAN / Şcoala cu clasele I-VIII Traian",3,4129,"TRAIAN",44202,931,561,478,83,0,551,10,1022,461,357,194
9,"BRĂILA","#N/A",44202,,251,"SILISTRARU / Grădiniţa Silistraru",3,4129,"TRAIAN",44202,622,389,333,56,0,383,6,686,297,254,129
9,"BRĂILA","#N/A",44202,,252,"URLEASCA / Grădiniţa Urleasca",3,4129,"TRAIAN",44202,1048,509,478,31,0,502,7,1154,645,369,133
9,"BRĂILA","#N/A",44202,,253,"CĂLDĂRUŞA / Fosta Şcoală Căldăruşa",3,4129,"TRAIAN",44202,159,110,98,12,0,110,0,175,65,84,26
9,"BRĂILA","#N/A",44257,,254,"TUDOR VLADIMIRESCU / Şcoala Gimnazială Tudor Vladimirescu",3,4134,"TUDOR VLADIMIRESCU",44257,820,500,438,61,1,489,11,906,406,277,212
9,"BRĂILA","#N/A",44257,,255,"SCORŢARU VECHI / Căminul Cultural Scorţaru Vechi",3,4134,"TUDOR VLADIMIRESCU",44257,787,576,502,63,11,567,9,867,291,415,152
9,"BRĂILA","#N/A",44257,,256,"COMĂNEASCA / Căminul Cultural Comăneasca",3,4134,"TUDOR VLADIMIRESCU",44257,175,133,119,14,0,131,2,192,59,106,25
9,"BRĂILA","#N/A",44300,,257,"TUFEŞTI / SCOALA PETRE CARP TUFESTI",3,4138,"TUFEŞTI",44300,930,573,514,59,0,567,6,1023,450,391,176
9,"BRĂILA","#N/A",44300,,258,"TUFEŞTI / CLADIREA FOSTEI GRADINITE TUFESTI",3,4138,"TUFEŞTI",44300,899,539,494,45,0,530,9,993,454,387,143
9,"BRĂILA","#N/A",44300,,259,"TUFEŞTI / camin cultural din fostul sat Tibanesti",3,4138,"TUFEŞTI",44300,1202,679,637,42,0,674,5,1327,648,440,234
9,"BRĂILA","#N/A",44300,,260,"TUFEŞTI / SCOALA PETRE CARP din fostul sat Tibanesti",3,4138,"TUFEŞTI",44300,1405,837,783,54,0,821,16,1550,713,578,243
9,"BRĂILA","#N/A",44328,,261,"ULMU / Caminul Cultural Ulmu",3,4140,"ULMU",44328,1333,802,731,71,0,791,11,1465,663,419,372
9,"BRĂILA","#N/A",44328,,262,"ULMU / Caminul Cultural Mohreanu",3,4140,"ULMU",44328,1019,641,608,32,1,636,5,1118,477,483,153
9,"BRĂILA","#N/A",44328,,263,"JUGUREANU / Caminul Cultural Jugureanu",3,4140,"ULMU",44328,856,487,448,39,0,477,10,949,462,388,89
9,"BRĂILA","#N/A",44355,,264,"UNIREA / SCOALA UNIREA",3,4143,"UNIREA",44355,923,610,530,80,0,602,8,1018,408,280,322
9,"BRĂILA","#N/A",44355,,265,"VALEA CÎNEPII / SCOALA VALEA CINEPII",3,4143,"UNIREA",44355,1045,701,607,94,0,690,11,1155,454,420,270
9,"BRĂILA","#N/A",44391,,266,"VĂDENI / SCOALA GIMNAZIALA  CU CLASELE I-VIII VADENI -SALA A",3,4147,"VĂDENI",44391,964,555,503,52,0,550,5,1060,505,341,209
9,"BRĂILA","#N/A",44391,,267,"VĂDENI / SCOALA GIMNAZIALA  CU CLASELE I-VIII-VADENI-SALA B",3,4147,"VĂDENI",44391,989,628,573,55,0,623,5,1089,461,377,246
9,"BRĂILA","#N/A",44391,,268,"BALDOVINEŞTI / SCOALA GIMNAZIALA CU CLASELE I-VIII BALDOVINESTI",3,4147,"VĂDENI",44391,944,499,437,62,0,492,7,1039,540,311,181
9,"BRĂILA","#N/A",44391,,269,"PIETROIU / SCOALA CU CLASELE I-IV  PIETROIU",3,4147,"VĂDENI",44391,413,288,250,38,0,286,2,456,168,159,127
9,"BRĂILA","#N/A",44435,,270,"VICTORIA / SCOALA GIMNAZIALA VICTORIA",3,4151,"VICTORIA",44435,925,584,549,35,0,583,1,1016,432,309,274
9,"BRĂILA","#N/A",44435,,271,"VICTORIA / SCOALA GIMNAZIALA VICTORIA",3,4151,"VICTORIA",44435,845,559,532,27,0,553,6,930,371,286,267
9,"BRĂILA","#N/A",44435,,272,"MIHAI BRAVU / SCOALA GIMNAZIALA  MIHAI BRAVU",3,4151,"VICTORIA",44435,1218,670,613,57,0,667,3,1346,676,447,220
9,"BRĂILA","#N/A",44462,,273,"VIŞANI / Şcoala gimnazială Vişani",3,4154,"VIŞANI",44462,1479,1024,916,108,0,1012,12,1628,604,785,227
9,"BRĂILA","#N/A",44462,,274,"CÎINENI-BĂI / Şcoala primară Câineni-Băi",3,4154,"VIŞANI",44462,500,350,292,58,0,349,1,552,202,276,73
9,"BRĂILA","#N/A",44505,,275,"VIZIRU / SCOALA CU CLASELE I-VIII  VIZIRU",3,4158,"VIZIRU",44505,1457,808,720,88,0,796,12,1605,797,478,318
9,"BRĂILA","#N/A",44505,,276,"VIZIRU / ANEXA LA SCOALA CU CLASELE I-VIII",3,4158,"VIZIRU",44505,1773,984,881,103,0,970,14,1943,959,602,368
9,"BRĂILA","#N/A",44505,,277,"LANURILE / Scoala Lanurile - SALA DE SPORT",3,4158,"VIZIRU",44505,947,527,491,36,0,516,11,1042,515,341,175
9,"BRĂILA","#N/A",44505,,278,"LANURILE / Scoala Lanurile FOST ATELIER SCOALA",3,4158,"VIZIRU",44505,883,539,504,35,0,529,10,976,437,381,148
9,"BRĂILA","#N/A",44532,,279,"ZĂVOAIA / CAMIN CULTURAL ZAVOAIA",3,4161,"ZĂVOAIA",44532,992,654,611,43,0,647,7,1094,440,320,327
9,"BRĂILA","#N/A",44532,,280,"ZĂVOAIA / Căminul Cultural Zăvoaia",3,4161,"ZĂVOAIA",44532,930,604,567,36,1,597,7,1026,422,328,269
9,"BRĂILA","#N/A",44532,,281,"DUDESCU / Căminul Cultural Dudescu",3,4161,"ZĂVOAIA",44532,640,484,431,53,0,480,4,703,219,207,273
10,"BUZĂU","#N/A",44818,,1,"BUZĂU / Şcoala gimnazială ""Ep.Dionisie Romano""",1,4165,"MUNICIPIUL BUZĂU",44818,1665,1168,1014,154,0,1152,16,1900,732,525,627
10,"BUZĂU","#N/A",44818,,2,"BUZĂU / Şcoala gimnazială nr.11",1,4165,"MUNICIPIUL BUZĂU",44818,1485,996,860,136,0,982,14,1600,604,493,489
10,"BUZĂU","#N/A",44818,,3,"BUZĂU / Şcoala gimnazială nr.11",1,4165,"MUNICIPIUL BUZĂU",44818,1632,1041,993,48,0,1028,13,1800,759,520,508
10,"BUZĂU","#N/A",44818,,4,"BUZĂU / Şcoala gimnazială nr.11",1,4165,"MUNICIPIUL BUZĂU",44818,1739,1102,1060,41,1,1076,26,1900,798,543,533
10,"BUZĂU","#N/A",44818,,5,"BUZĂU / Şcoala gimnazială nr.11",1,4165,"MUNICIPIUL BUZĂU",44818,1729,1026,988,37,1,1009,17,1900,874,524,485
10,"BUZĂU","#N/A",44818,,6,"BUZĂU / Direcţia de Asistenţă Socială",1,4165,"MUNICIPIUL BUZĂU",44818,1096,661,613,48,0,645,16,1200,539,305,340
10,"BUZĂU","#N/A",44818,,7,"BUZĂU / Direcţia de Asistenţă Socială",1,4165,"MUNICIPIUL BUZĂU",44818,1157,661,629,32,0,645,16,1300,639,330,315
10,"BUZĂU","#N/A",44818,,8,"BUZĂU / Liceul Tehnologic ""Grigore Moisil""",1,4165,"MUNICIPIUL BUZĂU",44818,1719,1073,1015,58,0,1058,15,1900,827,567,491
10,"BUZĂU","#N/A",44818,,9,"BUZĂU / Liceul Tehnologic ""Grigore Moisil""",1,4165,"MUNICIPIUL BUZĂU",44818,1542,924,882,42,0,898,26,1700,776,461,437
10,"BUZĂU","#N/A",44818,,10,"BUZĂU / Liceul Tehnologic ""Grigore Moisil""",1,4165,"MUNICIPIUL BUZĂU",44818,1365,782,741,41,0,770,12,1500,718,386,384
10,"BUZĂU","#N/A",44818,,11,"BUZĂU / Liceul Tehnologic ""Grigore Moisil""",1,4165,"MUNICIPIUL BUZĂU",44818,1578,892,860,32,0,877,15,1700,808,479,398
10,"BUZĂU","#N/A",44818,,12,"BUZĂU / Colegiul  Universitar Economic",1,4165,"MUNICIPIUL BUZĂU",44818,1744,1071,1013,58,0,1046,25,1900,829,538,508
10,"BUZĂU","#N/A",44818,,13,"BUZĂU / Şcoala gimnazială nr. 7",1,4165,"MUNICIPIUL BUZĂU",44818,1850,1029,994,35,0,1004,25,2001,972,506,498
10,"BUZĂU","#N/A",44818,,14,"BUZĂU / Şcoala gimnazială nr. 7",1,4165,"MUNICIPIUL BUZĂU",44818,1858,1120,1055,65,0,1101,19,2051,931,541,560
10,"BUZĂU","#N/A",44818,,15,"BUZĂU / Şcoala gimnazială ""General Grigore Baştan""",1,4165,"MUNICIPIUL BUZĂU",44818,1031,596,555,41,0,587,9,1100,504,299,288
10,"BUZĂU","#N/A",44818,,16,"BUZĂU / Şcoala gimnazială ""General Grigore Baştan""",1,4165,"MUNICIPIUL BUZĂU",44818,1020,611,571,39,1,601,10,1100,489,278,323
10,"BUZĂU","#N/A",44818,,17,"BUZĂU / Şcoala gimnazială ""General Grigore Baştan""",1,4165,"MUNICIPIUL BUZĂU",44818,1871,1093,1067,26,0,1066,27,2100,1007,560,506
10,"BUZĂU","#N/A",44818,,18,"BUZĂU / Şcoala gimnazială ""General Grigore Baştan""",1,4165,"MUNICIPIUL BUZĂU",44818,1362,786,765,21,0,765,21,1500,714,374,391
10,"BUZĂU","#N/A",44818,,19,"BUZĂU / Liceul teoretic ""Alexandru Marghiloman""",1,4165,"MUNICIPIUL BUZĂU",44818,1440,884,827,57,0,854,30,1601,717,400,454
10,"BUZĂU","#N/A",44818,,20,"BUZĂU / Liceul teoretic ""Alexandru Marghiloman""",1,4165,"MUNICIPIUL BUZĂU",44818,1359,806,752,51,3,795,11,1500,694,423,372
10,"BUZĂU","#N/A",44818,,21,"BUZĂU / Liceul teoretic ""Alexandru Marghiloman""",1,4165,"MUNICIPIUL BUZĂU",44818,1481,909,864,44,1,890,19,1600,691,425,465
10,"BUZĂU","#N/A",44818,,22,"BUZĂU / Liceul Tehnologic ""Henri Coandă""",1,4165,"MUNICIPIUL BUZĂU",44818,1321,702,684,18,0,693,9,1500,798,412,281
10,"BUZĂU","#N/A",44818,,23,"BUZĂU / Liceul Tehnologic ""Henri Coandă""",1,4165,"MUNICIPIUL BUZĂU",44818,1294,572,519,53,0,558,14,1401,829,373,185
10,"BUZĂU","#N/A",44818,,24,"BUZĂU / Liceul Tehnologic ""Henri Coandă""",1,4165,"MUNICIPIUL BUZĂU",44818,1166,711,674,14,23,693,18,1300,589,406,287
10,"BUZĂU","#N/A",44818,,25,"BUZĂU / Liceul Tehnologic ""Henri Coandă""",1,4165,"MUNICIPIUL BUZĂU",44818,1393,776,750,26,0,769,7,1500,724,381,388
10,"BUZĂU","#N/A",44818,,26,"BUZĂU / Şcoala gimnazială ""Ion Creangă""",1,4165,"MUNICIPIUL BUZĂU",44818,1707,1010,985,25,0,991,19,1900,890,520,471
10,"BUZĂU","#N/A",44818,,27,"BUZĂU / Şcoala gimnazială ""Ion Creangă""",1,4165,"MUNICIPIUL BUZĂU",44818,1460,888,849,39,0,872,16,1600,712,484,388
10,"BUZĂU","#N/A",44818,,28,"BUZĂU / Şcoala gimnazială ""Ion Creangă""",1,4165,"MUNICIPIUL BUZĂU",44818,1751,1032,985,46,1,1015,17,1900,868,523,492
10,"BUZĂU","#N/A",44818,,29,"BUZĂU / Şcoala gimnazială ""Ion Creangă""",1,4165,"MUNICIPIUL BUZĂU",44818,1406,906,870,36,0,885,21,1450,544,527,358
10,"BUZĂU","#N/A",44818,,30,"BUZĂU / Colegiul Tehnic",1,4165,"MUNICIPIUL BUZĂU",44818,913,591,543,48,0,582,9,1000,409,331,251
10,"BUZĂU","#N/A",44818,,31,"BUZĂU / Colegiul Tehnic",1,4165,"MUNICIPIUL BUZĂU",44818,1014,635,567,19,49,620,15,1100,465,335,285
10,"BUZĂU","#N/A",44818,,32,"BUZĂU / Liceul de arte ""Margareta Sterian""",1,4165,"MUNICIPIUL BUZĂU",44818,1543,1012,964,48,0,982,30,1700,688,500,482
10,"BUZĂU","#N/A",44818,,33,"BUZĂU / Colegiul Naţional ""B.P. Haşdeu""",1,4165,"MUNICIPIUL BUZĂU",44818,1466,958,861,75,22,939,19,1601,643,458,481
10,"BUZĂU","#N/A",44818,,34,"BUZĂU / Şcoala gimnazială ""P.H. Zangopol""",1,4165,"MUNICIPIUL BUZĂU",44818,1048,592,552,40,0,573,19,1200,608,310,263
10,"BUZĂU","#N/A",44818,,35,"BUZĂU / Şcoala gimnazială ""P.H. Zangopol""",1,4165,"MUNICIPIUL BUZĂU",44818,1284,751,729,22,0,734,17,1400,649,405,329
10,"BUZĂU","#N/A",44818,,36,"BUZĂU / Şcoala gimnazială ""P.H. Zangopol""",1,4165,"MUNICIPIUL BUZĂU",44818,1629,980,950,30,0,964,16,1800,820,539,425
10,"BUZĂU","#N/A",44818,,37,"BUZĂU / Liceul Tehnologic ""Dimitrie Filipescu""",1,4165,"MUNICIPIUL BUZĂU",44818,1496,911,845,65,1,888,23,1600,689,496,392
10,"BUZĂU","#N/A",44818,,38,"BUZĂU / Liceul Tehnologic ""Dimitrie Filipescu""",1,4165,"MUNICIPIUL BUZĂU",44818,1579,849,781,68,0,840,9,1700,851,411,429
10,"BUZĂU","#N/A",44818,,39,"BUZĂU / Colegiul Agricol ""Dr. C. Angelescu""",1,4165,"MUNICIPIUL BUZĂU",44818,1400,924,854,55,15,906,18,1600,676,427,479
10,"BUZĂU","#N/A",44818,,40,"BUZĂU / Şcoala gimnazială ""N.Constantinescu""",1,4165,"MUNICIPIUL BUZĂU",44818,1102,704,660,44,0,683,21,1201,497,345,338
10,"BUZĂU","#N/A",44818,,41,"BUZĂU / Şcoala gimnazială ""N.Constantinescu""",1,4165,"MUNICIPIUL BUZĂU",44818,1029,697,602,95,0,680,17,1100,403,338,342
10,"BUZĂU","#N/A",44818,,42,"BUZĂU / Şcoala gimnazială ""N.Constantinescu""",1,4165,"MUNICIPIUL BUZĂU",44818,1759,1083,1014,69,0,1059,24,1900,817,542,517
10,"BUZĂU","#N/A",44818,,43,"BUZĂU / Grădiniţa cu program prelungit nr. 8",1,4165,"MUNICIPIUL BUZĂU",44818,1073,664,621,42,1,650,14,1198,534,303,347
10,"BUZĂU","#N/A",44818,,44,"BUZĂU / Grădiniţa cu program prelungit nr. 8",1,4165,"MUNICIPIUL BUZĂU",44818,934,628,554,74,0,615,13,1000,372,306,309
10,"BUZĂU","#N/A",44818,,45,"BUZĂU / Grădiniţa cu program prelungit nr. 8",1,4165,"MUNICIPIUL BUZĂU",44818,1748,1036,1000,35,1,1022,14,1900,864,538,484
10,"BUZĂU","#N/A",44818,,46,"BUZĂU / Colegiul Naţional ""M. Eminescu""",1,4165,"MUNICIPIUL BUZĂU",44818,1773,1035,977,57,1,1017,18,2000,965,515,502
10,"BUZĂU","#N/A",44818,,47,"BUZĂU / Colegiul Naţional ""M. Eminescu""",1,4165,"MUNICIPIUL BUZĂU",44818,1604,1104,995,109,0,1080,24,1700,596,455,625
10,"BUZĂU","#N/A",44818,,48,"BUZĂU / Liceul pedagogic ""Spiru Haret""",1,4165,"MUNICIPIUL BUZĂU",44818,948,596,528,68,0,582,14,1100,504,329,253
10,"BUZĂU","#N/A",44818,,49,"BUZĂU / Liceul pedagogic ""Spiru Haret""",1,4165,"MUNICIPIUL BUZĂU",44818,882,556,494,62,0,553,3,1001,445,269,284
10,"BUZĂU","#N/A",44818,,50,"BUZĂU / Liceul pedagogic ""Spiru Haret""",1,4165,"MUNICIPIUL BUZĂU",44818,1497,938,882,55,1,924,14,1700,762,510,414
10,"BUZĂU","#N/A",44818,,51,"BUZĂU / Liceul pedagogic ""Spiru Haret""",1,4165,"MUNICIPIUL BUZĂU",44818,1239,860,797,62,1,844,16,1300,440,460,384
10,"BUZĂU","#N/A",44818,,52,"BUZĂU / Şcoala gimnazială ""dr. George Emil Palade""",1,4165,"MUNICIPIUL BUZĂU",44818,1619,997,942,55,0,980,17,1800,803,541,439
10,"BUZĂU","#N/A",44818,,53,"BUZĂU / Şcoala gimnazială ""dr. George Emil Palade""",1,4165,"MUNICIPIUL BUZĂU",44818,1353,929,864,65,0,919,10,1500,571,432,487
10,"BUZĂU","#N/A",44818,,54,"BUZĂU / Şcoala gimnazială ""dr. George Emil Palade""",1,4165,"MUNICIPIUL BUZĂU",44818,1660,1038,967,69,2,1019,19,1800,762,492,527
10,"BUZĂU","#N/A",44818,,55,"BUZĂU / Şcoala gimnazială ""dr. George Emil Palade""",1,4165,"MUNICIPIUL BUZĂU",44818,1196,798,741,57,0,780,18,1300,502,379,401
10,"BUZĂU","#N/A",44818,,56,"BUZĂU / Şcoala gimnazială ""dr. George Emil Palade""",1,4165,"MUNICIPIUL BUZĂU",44818,1316,747,705,42,0,732,15,1501,754,365,367
10,"BUZĂU","#N/A",44818,,57,"BUZĂU / Colegiul Economic",1,4165,"MUNICIPIUL BUZĂU",44818,1282,873,814,59,0,852,21,1400,527,415,437
10,"BUZĂU","#N/A",44818,,58,"BUZĂU / Şcoala gimnazială ""Cpt. av. Mircea T. Bădulescu""",1,4165,"MUNICIPIUL BUZĂU",44818,1398,969,891,77,1,949,20,1600,631,419,530
10,"BUZĂU","#N/A",44818,,59,"BUZĂU / Şcoala gimnazială ""Cpt. av. Mircea T. Bădulescu""",1,4165,"MUNICIPIUL BUZĂU",44818,1498,1026,914,111,1,999,27,1700,674,465,534
10,"BUZĂU","#N/A",44818,,60,"BUZĂU / Şcoala gimnazială ""Cpt. av. Mircea T. Bădulescu""",1,4165,"MUNICIPIUL BUZĂU",44818,1060,664,596,68,0,649,15,1200,536,315,334
10,"BUZĂU","#N/A",44818,,61,"BUZĂU / Şcoala gimnazială ""Cpt. av. Mircea T. Bădulescu""",1,4165,"MUNICIPIUL BUZĂU",44818,1430,947,886,59,2,929,18,1600,653,444,485
10,"BUZĂU","#N/A",44818,,62,"BUZĂU / Grădiniţa cu program prelungit nr.4",1,4165,"MUNICIPIUL BUZĂU",44818,1425,952,897,55,0,934,18,1600,648,512,422
10,"BUZĂU","#N/A",44818,,63,"BUZĂU / Şcoala gimnazială ""N.Titulescu""",1,4165,"MUNICIPIUL BUZĂU",44818,1376,923,854,69,0,904,19,1500,577,427,477
10,"BUZĂU","#N/A",44818,,64,"BUZĂU / Şcoala gimnazială ""N.Titulescu""",1,4165,"MUNICIPIUL BUZĂU",44818,1539,973,937,35,1,946,27,1700,727,436,510
10,"BUZĂU","#N/A",44818,,65,"BUZĂU / Şcoala gimnazială ""Sf.Apostol Andrei""",1,4165,"MUNICIPIUL BUZĂU",44818,1431,1019,802,80,137,1002,17,1601,582,560,442
10,"BUZĂU","#N/A",44818,,66,"BUZĂU / Şcoala gimnazială ""Sf.Apostol Andrei""",1,4165,"MUNICIPIUL BUZĂU",44818,1491,951,882,69,0,930,21,1600,649,494,436
10,"BUZĂU","#N/A",44818,,67,"BUZĂU / Şcoala gimnazială ""Sf.Apostol Andrei""",1,4165,"MUNICIPIUL BUZĂU",44818,1679,985,934,50,1,966,19,1900,915,536,430
10,"BUZĂU","#N/A",44818,,68,"BUZĂU / Şcoala gimnazială ""Sf.Apostol Andrei""",1,4165,"MUNICIPIUL BUZĂU",44818,1857,1131,1087,43,1,1118,13,2001,870,614,504
10,"BUZĂU","#N/A",44818,,69,"BUZĂU / Liceul cu program sportiv ""I.Balaş-Söter""",1,4165,"MUNICIPIUL BUZĂU",44818,993,562,528,29,5,542,20,1100,538,322,220
10,"BUZĂU","#N/A",44818,,70,"BUZĂU / Liceul cu program sportiv ""I.Balaş- Söter """,1,4165,"MUNICIPIUL BUZĂU",44818,1393,830,794,36,0,816,14,1450,620,447,369
10,"BUZĂU","#N/A",44818,,71,"BUZĂU / Liceul cu program sportiv ""I.Balaş- Söter """,1,4165,"MUNICIPIUL BUZĂU",44818,1173,674,618,55,1,661,13,1300,626,358,303
10,"BUZĂU","#N/A",44818,,72,"BUZĂU / Grădiniţa cu program prelungit ""Boboceii din Micro III""",1,4165,"MUNICIPIUL BUZĂU",44818,1469,995,897,98,0,976,19,1601,606,481,495
10,"BUZĂU","#N/A",44818,,73,"BUZĂU / Seminarul Teologic Ortodox ""Chesarie Episcopul""",1,4165,"MUNICIPIUL BUZĂU",44818,1957,1275,1179,70,26,1245,30,2100,825,610,635
10,"BUZĂU","#N/A",44818,,74,"BUZĂU / Seminarul Teologic Ortodox ""Chesarie Episcopul""",1,4165,"MUNICIPIUL BUZĂU",44818,1812,1132,1045,85,2,1112,20,2000,868,553,559
10,"BUZĂU","#N/A",44818,,75,"BUZĂU / Liceul Tehnologic ""Costin Neniţescu""",1,4165,"MUNICIPIUL BUZĂU",44818,1912,960,897,63,0,938,22,2100,1140,495,443
10,"BUZĂU","#N/A",44818,,76,"BUZĂU / Liceul Tehnologic Meserii şi Servicii",1,4165,"MUNICIPIUL BUZĂU",44818,1750,853,797,56,0,833,20,1900,1047,474,359
10,"BUZĂU","#N/A",44818,,77,"BUZĂU / Liceul Tehnologic Meserii şi Servicii",1,4165,"MUNICIPIUL BUZĂU",44818,962,466,434,32,0,457,9,1100,634,249,208
10,"BUZĂU","#N/A",44818,,78,"BUZĂU / Şcoala gimnazială "" M. Kogălniceanu""",1,4165,"MUNICIPIUL BUZĂU",44818,1688,908,854,54,0,889,19,1900,992,519,370
10,"BUZĂU","#N/A",44818,,79,"BUZĂU / Şcoala gimnazială "" M. Kogălniceanu""",1,4165,"MUNICIPIUL BUZĂU",44818,1718,793,760,33,0,772,21,1900,1107,540,232
10,"BUZĂU","#N/A",44818,,80,"BUZĂU / Şcoala gimnazială "" M. Kogălniceanu""",1,4165,"MUNICIPIUL BUZĂU",44818,1601,717,691,26,0,694,23,1800,1083,477,217
10,"BUZĂU","#N/A",44845,,81,"RÂMNICU SĂRAT / Centrul de recuperare pentru persoane cu handicap",1,4167,"MUNICIPIUL RÂMNICU SĂRAT",44845,1959,1077,1043,33,1,1057,20,2197,1120,699,358
10,"BUZĂU","#N/A",44845,,82,"RÂMNICU SĂRAT / Şcoala cu clasele I-VIII nr. 3",1,4167,"MUNICIPIUL RÂMNICU SĂRAT",44845,1697,808,789,19,0,789,19,1903,1095,682,107
10,"BUZĂU","#N/A",44845,,83,"RÂMNICU SĂRAT / Şcoala cu clasele I-VIII nr. 5 ""Vasile Cristoforeanu""",1,4167,"MUNICIPIUL RÂMNICU SĂRAT",44845,1654,973,924,47,2,955,18,1800,827,651,304
10,"BUZĂU","#N/A",44845,,84,"RÂMNICU SĂRAT / Şcoala cu clasele I-VIII nr. 5 ""Vasile Cristoforeanu""",1,4167,"MUNICIPIUL RÂMNICU SĂRAT",44845,1685,967,895,70,2,962,5,1901,934,594,368
10,"BUZĂU","#N/A",44845,,85,"RÂMNICU SĂRAT / Şcoala cu clasele I-VIII nr. 5 ""Vasile Cristoforeanu""",1,4167,"MUNICIPIUL RÂMNICU SĂRAT",44845,1551,981,924,57,0,969,12,1701,720,550,419
10,"BUZĂU","#N/A",44845,,86,"RÂMNICU SĂRAT / Gradinita cu program normal ""Orizont""",1,4167,"MUNICIPIUL RÂMNICU SĂRAT",44845,1626,987,918,67,2,970,17,1800,813,590,380
10,"BUZĂU","#N/A",44845,,87,"RÂMNICU SĂRAT / Grup Şcolar Industrial",1,4167,"MUNICIPIUL RÂMNICU SĂRAT",44845,1709,881,803,76,2,862,19,1900,1019,560,302
10,"BUZĂU","#N/A",44845,,88,"RÂMNICU SĂRAT / Colegiul Naţional Alexandru Vlahuţă",1,4167,"MUNICIPIUL RÂMNICU SĂRAT",44845,1306,755,709,46,0,739,16,1401,646,442,297
10,"BUZĂU","#N/A",44845,,89,"RÂMNICU SĂRAT / Colegiul Naţional Alexandru Vlahuţă",1,4167,"MUNICIPIUL RÂMNICU SĂRAT",44845,1398,885,825,58,2,877,8,1500,615,557,320
10,"BUZĂU","#N/A",44845,,90,"RÂMNICU SĂRAT / Gradinita cu program prelungit nr. 3",1,4167,"MUNICIPIUL RÂMNICU SĂRAT",44845,1579,842,801,41,0,831,11,1700,858,532,299
10,"BUZĂU","#N/A",44845,,91,"RÂMNICU SĂRAT / Gradinita cu program prelungit nr. 3",1,4167,"MUNICIPIUL RÂMNICU SĂRAT",44845,1767,940,917,22,1,914,26,2001,1061,565,349
10,"BUZĂU","#N/A",44845,,92,"RÂMNICU SĂRAT / Gradinita cu program prelungit nr. 3",1,4167,"MUNICIPIUL RÂMNICU SĂRAT",44845,1917,1029,982,47,0,1017,12,2100,1071,574,443
10,"BUZĂU","#N/A",44845,,93,"RÂMNICU SĂRAT / Şcoala cu clasele I-VIII nr. 6",1,4167,"MUNICIPIUL RÂMNICU SĂRAT",44845,1814,1078,1007,70,1,1059,19,2001,923,639,420
10,"BUZĂU","#N/A",44845,,94,"RÂMNICU SĂRAT / Liceul Teoretic Ştefan cel Mare",1,4167,"MUNICIPIUL RÂMNICU SĂRAT",44845,1294,811,773,38,0,796,15,1400,589,480,316
10,"BUZĂU","#N/A",44845,,95,"RÂMNICU SĂRAT / Grup Şcolar Agricol",1,4167,"MUNICIPIUL RÂMNICU SĂRAT",44845,1417,960,814,51,95,944,16,1600,640,595,349
10,"BUZĂU","#N/A",44845,,96,"RÂMNICU SĂRAT / Cantina de Ajutor Social",1,4167,"MUNICIPIUL RÂMNICU SĂRAT",44845,1408,819,795,24,0,809,10,1501,682,512,297
10,"BUZĂU","#N/A",44845,,97,"RÂMNICU SĂRAT / Şcoala cu clasele I-VIII nr. 1",1,4167,"MUNICIPIUL RÂMNICU SĂRAT",44845,1246,785,736,40,9,772,13,1404,619,494,278
10,"BUZĂU","#N/A",44845,,98,"RÂMNICU SĂRAT / Şcoala cu clasele I-VIII nr. 2",1,4167,"MUNICIPIUL RÂMNICU SĂRAT",44845,1811,985,931,37,17,966,19,2000,1015,647,319
10,"BUZĂU","#N/A",44845,,99,"RÂMNICU SĂRAT / S.C.OILREG S.A.",1,4167,"MUNICIPIUL RÂMNICU SĂRAT",44845,1838,1006,974,32,0,984,22,1998,992,662,322
10,"BUZĂU","#N/A",44845,,100,"RÂMNICU SĂRAT / Gradinita cu program prelungit nr.2",1,4167,"MUNICIPIUL RÂMNICU SĂRAT",44845,1578,878,843,35,0,869,9,1700,822,479,390
10,"BUZĂU","#N/A",44845,,101,"RÂMNICU SĂRAT / Grup Scolar Economic",1,4167,"MUNICIPIUL RÂMNICU SĂRAT",44845,1625,910,858,52,0,889,21,1800,890,461,428
10,"BUZĂU","#N/A",47916,,102,"NEHOIU / Casa de Cultură GEORGE BĂICULESCU Nehoiu",1,4169,"ORAŞ NEHOIU",47916,1204,798,705,92,1,788,10,1300,502,324,464
10,"BUZĂU","#N/A",47916,,103,"NEHOIU / Grup Scolar Tehnic Nehoiu Str. Scolii",1,4169,"ORAŞ NEHOIU",47916,1112,698,637,22,39,691,7,1200,502,316,375
10,"BUZĂU","#N/A",47916,,104,"NEHOIU / Sala de sport a orasului",1,4169,"ORAŞ NEHOIU",47916,739,512,485,20,7,508,4,800,288,265,243
10,"BUZĂU","#N/A",47916,,105,"NEHOIU / Cămin Cultural Bădârlegi",1,4169,"ORAŞ NEHOIU",47916,122,93,82,9,2,91,2,150,57,55,36
10,"BUZĂU","#N/A",47916,,106,"NEHOIU / Clădirea Fosta secţie confecţionat încălţăminte Dâmboviţa (lângă Biserica Ortodoxă) str. Valea Nehoiului",1,4169,"ORAŞ NEHOIU",47916,600,404,368,24,12,393,11,700,296,182,211
10,"BUZĂU","#N/A",47916,,107,"NEHOIU / Cămin Cultural Valea Nehoiului",1,4169,"ORAŞ NEHOIU",47916,882,603,567,19,17,594,9,900,297,318,276
10,"BUZĂU","#N/A",47916,,108,"NEHOIU / Şcoala Primară Nehoiaşu",1,4169,"ORAŞ NEHOIU",47916,370,267,241,18,8,265,2,400,133,174,91
10,"BUZĂU","#N/A",47916,,109,"NEHOIU / Cămin Cultural Lunca Pripor",1,4169,"ORAŞ NEHOIU",47916,669,489,443,29,17,479,10,700,211,233,246
10,"BUZĂU","#N/A",47916,,110,"LUNCA PRIPORULUI / Scoala cu clasele I-IV Prund",1,4169,"ORAŞ NEHOIU",47916,365,286,261,20,5,279,7,400,114,154,125
10,"BUZĂU","#N/A",47916,,111,"BÎSCA ROZILEI / Cămin Cultural Bîsca Rozilei",1,4169,"ORAŞ NEHOIU",47916,600,423,399,18,6,415,8,700,277,198,217
10,"BUZĂU","#N/A",47916,,112,"BÎSCA ROZILEI / Grădinita Pod Vinetis - veche",1,4169,"ORAŞ NEHOIU",47916,506,359,337,22,0,351,8,601,242,216,135
10,"BUZĂU","#N/A",47916,,113,"VINEŢIŞU / Cămin Cultural Vinetis",1,4169,"ORAŞ NEHOIU",47916,142,117,104,10,3,115,2,200,83,85,30
10,"BUZĂU","#N/A",47916,,114,"PĂLTINENI / Cămin Cultural Păltineni",1,4169,"ORAŞ NEHOIU",47916,705,495,463,25,7,483,12,800,305,264,219
10,"BUZĂU","#N/A",47916,,115,"MLĂJET / Cămin Cultural Mlăjet",1,4169,"ORAŞ NEHOIU",47916,753,510,458,32,20,503,7,801,291,278,225
10,"BUZĂU","#N/A",47916,,116,"CHIRLEŞTI / Scoala cu clasele I-IV Chirlesti",1,4169,"ORAŞ NEHOIU",47916,639,434,388,32,14,431,3,702,268,230,201
10,"BUZĂU","#N/A",47916,,117,"CURMĂTURA / Cămin Cultural Curmătura",1,4169,"ORAŞ NEHOIU",47916,160,128,101,17,10,128,0,203,75,81,47
10,"BUZĂU","#N/A",48325,,118,"PĂTÂRLAGELE / Liceul Tehnologic Pătârlagele",1,4180,"ORAŞ PĂTÂRLAGELE",48325,1011,647,564,68,15,636,11,1100,453,348,288
10,"BUZĂU","#N/A",48325,,119,"PĂTÂRLAGELE / Liceul Tehnologic Pătârlagele",1,4180,"ORAŞ PĂTÂRLAGELE",48325,1171,723,647,76,0,717,6,1300,577,395,322
10,"BUZĂU","#N/A",48325,,120,"POIENILE / Şcoală Primară",1,4180,"ORAŞ PĂTÂRLAGELE",48325,264,164,142,22,0,160,4,300,136,99,61
10,"BUZĂU","#N/A",48325,,121,"MĂRUNŢIŞU / Şcoala Generală",1,4180,"ORAŞ PĂTÂRLAGELE",48325,1214,765,699,66,0,759,6,1300,535,500,259
10,"BUZĂU","#N/A",48325,,122,"MUŞCEL / Şcoala Generală",1,4180,"ORAŞ PĂTÂRLAGELE",48325,633,384,363,21,0,383,1,700,316,267,116
10,"BUZĂU","#N/A",48325,,123,"VALEA LUPULUI / Şcoala Primară",1,4180,"ORAŞ PĂTÂRLAGELE",48325,391,276,233,43,0,267,9,400,124,166,101
10,"BUZĂU","#N/A",48325,,124,"VALEA VIEI / Şcoala Primară",1,4180,"ORAŞ PĂTÂRLAGELE",48325,429,295,260,32,3,292,3,500,205,192,100
10,"BUZĂU","#N/A",48325,,125,"MĂNĂSTIREA / Şcoala Primară",1,4180,"ORAŞ PĂTÂRLAGELE",48325,72,52,36,16,0,52,0,100,48,36,16
10,"BUZĂU","#N/A",48325,,126,"CRÂNG / Şcoala Primară",1,4180,"ORAŞ PĂTÂRLAGELE",48325,535,334,314,20,0,328,6,600,266,234,94
10,"BUZĂU","#N/A",48325,,127,"SIBICIU DE SUS / Şcoala Primară",1,4180,"ORAŞ PĂTÂRLAGELE",48325,730,522,479,43,0,518,4,801,279,322,196
10,"BUZĂU","#N/A",48325,,128,"VALEA SIBICIULUI / Şcoala Primară",1,4180,"ORAŞ PĂTÂRLAGELE",48325,189,155,126,29,0,155,0,200,45,85,70
10,"BUZĂU","#N/A",48744,,129,"POGOANELE / Liceul Teoretic Pogoanele",1,4196,"ORAŞ POGOANELE",48744,1550,1020,897,57,66,993,27,1700,680,728,265
10,"BUZĂU","#N/A",48744,,130,"POGOANELE / Clubul Copiilor Pogoanele",1,4196,"ORAŞ POGOANELE",48744,1460,986,847,108,31,974,12,1600,614,715,259
10,"BUZĂU","#N/A",48744,,131,"POGOANELE / Şcoala Generală nr.2 Pogoanele",1,4196,"ORAŞ POGOANELE",48744,1543,999,891,36,72,980,19,1703,704,766,214
10,"BUZĂU","#N/A",48744,,132,"CĂLDĂRĂŞTI / Şcoala Generală Căldărăşti",1,4196,"ORAŞ POGOANELE",48744,1608,1063,955,51,57,1051,12,1801,738,866,185
10,"BUZĂU","#N/A",44863,,133,"AMARU / Şcoala generala Amaru",3,4199,"AMARU",44863,1014,627,561,65,1,620,7,1100,473,399,221
10,"BUZĂU","#N/A",44863,,134,"DULBANU / Şcoala generala  Dulbanu",3,4199,"AMARU",44863,440,277,237,38,2,275,2,500,223,216,59
10,"BUZĂU","#N/A",44863,,135,"LUNCA / Caminul cultural  Lunca",3,4199,"AMARU",44863,335,216,167,47,2,215,1,400,184,175,40
10,"BUZĂU","#N/A",44863,,136,"LACU SINAIA / Şcoala generala Lacu Sinaia",3,4199,"AMARU",44863,209,161,138,23,0,157,4,250,89,139,18
10,"BUZĂU","#N/A",44934,,137,"BALTA ALBĂ / Gradinita cu program normal Balta Albă",3,4208,"BALTA ALBĂ",44934,480,323,277,46,0,320,3,502,179,178,142
10,"BUZĂU","#N/A",44934,,138,"BĂILE / CAMINUL CULTURAL BAILE",3,4208,"BALTA ALBĂ",44934,396,260,204,56,0,257,3,400,140,118,139
10,"BUZĂU","#N/A",44934,,139,"AMARA / Şcoala gimnaziala  Amara",3,4208,"BALTA ALBĂ",44934,1267,772,672,100,0,763,9,1401,629,396,367
10,"BUZĂU","#N/A",44989,,140,"BĂLĂCEANU / Primaria Comunei Bălăceanu",3,4206,"BĂLĂCEANU",44989,1324,911,780,78,53,901,10,1500,589,673,228
10,"BUZĂU","#N/A",45003,,141,"BECENI / Şcoala cu cls.I-IV Beceni",3,4213,"BECENI",45003,824,522,443,62,17,514,8,900,378,361,153
10,"BUZĂU","#N/A",45003,,142,"GURA DIMIENII / Şcoala cu cls.I-VIIII Gura Dimienii",3,4213,"BECENI",45003,814,582,502,61,19,578,4,900,318,387,191
10,"BUZĂU","#N/A",45003,,143,"VALEA PĂRULUI / Şcoala cu cls.I-VIIII  Valea Părului",3,4213,"BECENI",45003,1228,760,663,90,7,755,5,1300,540,518,237
10,"BUZĂU","#N/A",45003,,144,"IZVORU DULCE / Şcoala cu cls.I-IV Izvoru Dulce",3,4213,"BECENI",45003,685,482,411,69,2,477,5,800,318,306,171
10,"BUZĂU","#N/A",45003,,145,"FLOREŞTI / Şcoala cu cls.I-IV  Floreşti",3,4213,"BECENI",45003,223,146,122,21,3,143,3,301,155,119,24
10,"BUZĂU","#N/A",45101,,146,"BERCA / Casa de cultură Berca-Parter",3,4223,"BERCA",45101,1217,788,720,65,3,774,14,1300,512,346,428
10,"BUZĂU","#N/A",45101,,147,"BERCA / Casa de cultură Berca-Etaj 1",3,4223,"BERCA",45101,1200,729,693,36,0,715,14,1300,571,311,404
10,"BUZĂU","#N/A",45101,,148,"BERCA / LICEUL TEHNOLOGIC Sf.Mucenic Sava, Berca",3,4223,"BERCA",45101,622,478,395,82,1,468,10,700,222,196,272
10,"BUZĂU","#N/A",45101,,149,"SĂTUC / Grădiniţa Sătuc",3,4223,"BERCA",45101,560,436,360,73,3,429,7,600,164,204,225
10,"BUZĂU","#N/A",45101,,150,"RĂTEŞTI / Şcoala Răteşti",3,4223,"BERCA",45101,878,514,467,44,3,503,11,1000,486,266,237
10,"BUZĂU","#N/A",45101,,151,"PÎCLELE / Camin Cultural Pîcle",3,4223,"BERCA",45101,153,103,81,22,0,102,1,200,97,52,50
10,"BUZĂU","#N/A",45101,,152,"JOSENI / CAMIN CULTURAL Joseni",3,4223,"BERCA",45101,785,494,439,55,0,487,7,900,406,278,209
10,"BUZĂU","#N/A",45101,,153,"PLEŞEŞTI / Şcoala Pleşeşti",3,4223,"BERCA",45101,789,486,450,36,0,481,5,900,414,238,243
10,"BUZĂU","#N/A",45101,,154,"PLEŞCOI / Cămin Cultural Pleşcoi",3,4223,"BERCA",45101,762,503,456,47,0,499,4,800,297,253,246
10,"BUZĂU","#N/A",45101,,155,"VALEA NUCULUI / Şcoala Valea Nucului",3,4223,"BERCA",45101,600,401,353,48,0,395,6,700,299,223,172
10,"BUZĂU","#N/A",45245,,156,"BISOCA / Sala de festivitati a primariei Bisoca",3,4237,"BISOCA",45245,506,236,222,14,0,231,5,600,364,148,83
10,"BUZĂU","#N/A",45245,,157,"RECEA / Campus pentru copii Sf.Sava - Recea",3,4237,"BISOCA",45245,833,411,379,32,0,410,1,900,489,325,85
10,"BUZĂU","#N/A",45245,,158,"PLEŞI / Şcoala Generală Pleşi",3,4237,"BISOCA",45245,357,203,186,17,0,203,0,401,198,163,40
10,"BUZĂU","#N/A",45245,,159,"SĂRILE / Şcoala Generală Sările",3,4237,"BISOCA",45245,421,272,251,21,0,267,5,500,228,208,59
10,"BUZĂU","#N/A",45334,,160,"BLĂJANI / Căminul Cultural Blăjani",3,4246,"BLĂJANI",45334,667,570,464,68,38,568,2,700,130,465,103
10,"BUZĂU","#N/A",45334,,161,"SOREŞTI / Căminul Cultural Soreşti",3,4246,"BLĂJANI",45334,249,222,176,31,15,220,2,300,78,186,34
10,"BUZĂU","#N/A",45361,,162,"BOLDU / CLUBUL  PRIMĂRIEI  BOLDU",3,4249,"BOLDU",45361,989,777,673,70,34,771,6,1100,323,577,194
10,"BUZĂU","#N/A",45361,,163,"BOLDU / GRĂDINIŢA DE COPII BOLDU",3,4249,"BOLDU",45361,871,643,550,51,42,637,6,1000,357,487,150
10,"BUZĂU","#N/A",45389,,164,"BOZIORU / Şcoala cu cls.I-IV Bozioru",3,4251,"BOZIORU",45389,541,366,309,40,17,360,6,601,235,249,111
10,"BUZĂU","#N/A",45389,,165,"FIŞICI / Şcoala cu cls.I-IV Fişici",3,4251,"BOZIORU",45389,347,229,191,36,2,226,3,400,171,119,107
10,"BUZĂU","#N/A",45496,,166,"BRĂDEANU / Şcoala Generală Brădeanu",3,4262,"BRĂDEANU",45496,921,608,530,75,3,603,5,1000,392,361,242
10,"BUZĂU","#N/A",45496,,167,"SMÎRDAN / Şcoala Generală Smîrdan",3,4262,"BRĂDEANU",45496,741,553,466,74,13,549,4,800,247,395,154
10,"BUZĂU","#N/A",45496,,168,"MITROPOLIA / Şcoala Generală Mitropolia",3,4262,"BRĂDEANU",45496,368,275,239,36,0,271,4,400,125,182,89
10,"BUZĂU","#N/A",45539,,169,"BRĂEŞTI / Sala mare a cladirii fostului sediu C.A.P. - sat Braesti",3,4266,"BRĂEŞTI",45539,410,308,259,25,24,307,1,451,143,234,73
10,"BUZĂU","#N/A",45539,,170,"BRĂTILEŞTI / Caminul cultural  Brătileşti",3,4266,"BRĂEŞTI",45539,1149,637,611,26,0,622,15,1201,564,424,198
10,"BUZĂU","#N/A",45539,,171,"PINU / CAMINUL CULTURAL PINU",3,4266,"BRĂEŞTI",45539,337,225,179,19,27,224,1,400,175,164,60
10,"BUZĂU","#N/A",45619,,172,"BREAZA / Gradinita cu program normal Breaza",3,4274,"BREAZA",45619,830,480,427,53,0,470,10,901,421,293,177
10,"BUZĂU","#N/A",45619,,173,"GRECEANCA / Şcoala Generală Greceanca",3,4274,"BREAZA",45619,832,481,406,75,0,474,7,900,419,280,194
10,"BUZĂU","#N/A",45619,,174,"VISPEŞTI / Şcoala Primară Vispeşti",3,4274,"BREAZA",45619,622,400,339,61,0,388,12,699,299,243,145
10,"BUZĂU","#N/A",45673,,175,"BUDA / Şcoala Buda",3,4280,"BUDA",45673,945,615,549,53,13,605,10,1000,385,367,238
10,"BUZĂU","#N/A",45673,,176,"ALEXANDRU ODOBESCU / Şcoala Alexandru Odobescu",3,4280,"BUDA",45673,948,592,510,55,27,586,6,1101,509,406,180
10,"BUZĂU","#N/A",45673,,177,"TOROPĂLEŞTI / GRADINITA PN PIETROIU",3,4280,"BUDA",45673,535,333,300,22,11,325,8,600,267,234,91
10,"BUZĂU","#N/A",45815,,178,"C.A. ROSETTI / Scoala cu clasele I-VIII C.A.Rosetti",3,4288,"C.A. ROSETTI",45815,765,482,419,58,5,477,5,800,318,348,129
10,"BUZĂU","#N/A",45815,,179,"BĂLTENI / Şcoala cu cls.I-IV Bălteni",3,4288,"C.A. ROSETTI",45815,407,277,236,41,0,271,6,450,173,212,59
10,"BUZĂU","#N/A",45815,,180,"BÎLHACU / Căminul Cultural Bîlhacu",3,4288,"C.A. ROSETTI",45815,186,134,115,19,0,134,0,201,67,101,33
10,"BUZĂU","#N/A",45815,,181,"COTU CIORII / Şcoala cu cls.I-IV Cotu Ciorii",3,4288,"C.A. ROSETTI",45815,502,324,263,61,0,320,4,600,276,228,92
10,"BUZĂU","#N/A",45815,,182,"LUNCA / Scoala cu clasele I-VIII Lunca",3,4288,"C.A. ROSETTI",45815,913,623,559,46,18,616,7,1000,377,522,94
10,"BUZĂU","#N/A",45815,,183,"VIZIRENI / Şcoala cu cls.I-IV Vizireni",3,4288,"C.A. ROSETTI",45815,380,245,213,32,0,243,2,400,155,164,79
10,"BUZĂU","#N/A",45753,,184,"CALVINI / CAMIN CULTURAL CALVINI",3,4295,"CALVINI",45753,794,445,391,54,0,444,1,900,455,254,190
10,"BUZĂU","#N/A",45753,,185,"BÎSCENII DE JOS / SCOALA GIMNAZIALA ""DUMITRU I. IONESCU"" CALVINI",3,4295,"CALVINI",45753,1445,505,478,26,1,491,14,1600,1095,363,128
10,"BUZĂU","#N/A",45753,,186,"BÎSCENII DE JOS / SCOALA PRIMARA BÎSCENII DE JOS",3,4295,"CALVINI",45753,488,340,314,26,0,335,5,500,160,261,74
10,"BUZĂU","#N/A",45753,,187,"BÎSCENII DE SUS / SCOALA GIMNAZIALA BÎSCENII DE SUS",3,4295,"CALVINI",45753,746,478,430,47,1,474,4,800,322,244,230
10,"BUZĂU","#N/A",45888,,188,"CĂNEŞTI / SCOALA GIMNAZIALA CANESTI",3,4301,"CĂNEŞTI",45888,515,364,292,45,27,358,6,600,236,146,212
10,"BUZĂU","#N/A",45888,,189,"NEGOŞINA / SCOALA PRIMARA NEGOSINA",3,4301,"CĂNEŞTI",45888,186,149,122,17,10,148,1,200,51,74,74
10,"BUZĂU","#N/A",45959,,190,"CĂTINA / Şcoala Gimnazială nr.1 Cătina",3,4308,"CĂTINA",45959,638,441,386,38,17,440,1,700,259,229,211
10,"BUZĂU","#N/A",45959,,191,"CORBU / Şcoala Gimnazială nr.2 Corbu",3,4308,"CĂTINA",45959,675,488,414,55,19,482,6,700,212,233,249
10,"BUZĂU","#N/A",45959,,192,"VALEA CĂTINEI / Şcoala Primară nr.1 Valea Cătinei",3,4308,"CĂTINA",45959,402,300,259,25,16,297,3,450,150,152,145
10,"BUZĂU","#N/A",45959,,193,"SLOBOZIA / Şcoala cu cls.I-IV Slobozia",3,4308,"CĂTINA",45959,157,119,100,15,4,116,3,200,81,49,67
10,"BUZĂU","#N/A",45959,,194,"ZELETIN / Şcoala Primară nr.2  Zeletin",3,4308,"CĂTINA",45959,162,55,26,29,0,55,0,200,145,26,29
10,"BUZĂU","#N/A",46019,,195,"CERNĂTEŞTI / Gradinita cu program normal Cernatesti",3,4314,"CERNĂTEŞTI",46019,953,620,560,56,4,611,9,1001,381,316,295
10,"BUZĂU","#N/A",46019,,196,"ZĂRNEŞTII DE SLĂNIC / Căminul Cultural din satul Zărneşti Slănic",3,4314,"CERNĂTEŞTI",46019,1111,720,639,78,3,706,14,1200,480,440,266
10,"BUZĂU","#N/A",46019,,197,"ALDENI / Căminul Cultural din satul Aldeni",3,4314,"CERNĂTEŞTI",46019,674,471,406,63,2,461,10,701,230,318,143
10,"BUZĂU","#N/A",46019,,198,"FULGA / Şcoala Primara din satul Fulga",3,4314,"CERNĂTEŞTI",46019,423,268,234,34,0,268,0,501,233,156,112
10,"BUZĂU","#N/A",46108,,199,"CHILIILE / Caminul Cultural Chiliile",3,4323,"CHILIILE",46108,312,256,208,30,18,252,4,350,94,207,45
10,"BUZĂU","#N/A",46108,,200,"TRESTIOARA / Şcoala Trestioara",3,4323,"CHILIILE",46108,195,139,116,14,9,139,0,200,61,121,18
10,"BUZĂU","#N/A",46180,,201,"CHIOJDU / Gradinita din satul Chiojdu",3,4331,"CHIOJDU",46180,819,521,436,80,5,510,11,901,380,272,238
10,"BUZĂU","#N/A",46180,,202,"BÎSCA CHIOJDULUI / Şcoala generală din satul Bisca Chiojdului",3,4331,"CHIOJDU",46180,986,613,570,43,0,611,2,1100,487,323,288
10,"BUZĂU","#N/A",46180,,203,"PLESCIOARA / Şcoala generală din Pleşcioara",3,4331,"CHIOJDU",46180,134,85,75,7,3,85,0,200,115,64,21
10,"BUZĂU","#N/A",46180,,204,"CĂTIAŞU / Şcoala generală din satul Căţiaşu",3,4331,"CHIOJDU",46180,323,200,173,27,0,199,1,400,200,160,39
10,"BUZĂU","#N/A",46180,,205,"LERA / Şcoala Generală din satul Lera",3,4331,"CHIOJDU",46180,368,233,215,18,0,233,0,400,167,166,67
10,"BUZĂU","#N/A",46180,,206,"POENIŢELE / Şcoala Generală din satul Poieniţele",3,4331,"CHIOJDU",46180,211,116,101,15,0,114,2,250,134,86,28
10,"BUZĂU","#N/A",46251,,207,"CILIBIA / Primăria comuna  Cilibia - la parter",3,4338,"CILIBIA",46251,1193,831,693,107,31,819,12,1301,470,304,515
10,"BUZĂU","#N/A",46251,,208,"MOVILA OII / Şcoala  Primară din satul  Movila Oii",3,4338,"CILIBIA",46251,326,294,226,55,13,292,2,400,106,135,157
10,"BUZĂU","#N/A",46313,,209,"CISLĂU / Gradinita cu program normal Cislau nr. 1",3,4344,"CISLĂU",46313,1881,1226,1142,77,7,1210,16,2100,874,787,423
10,"BUZĂU","#N/A",46313,,210,"SCĂRIŞOARA / Scoala Gimnaziala Scarisoara, comuna Cislau",3,4344,"CISLĂU",46313,1070,779,714,61,4,767,12,1200,421,422,345
10,"BUZĂU","#N/A",46313,,211,"BUDA CRĂCIUNEŞTI / Centrul de zi ""Doamna Neaga"" pentru copii cu varste cuprinse intre 3-6 ani",3,4344,"CISLĂU",46313,666,434,401,33,0,430,4,700,266,293,137
10,"BUZĂU","#N/A",46313,,212,"GURA BÎSCEI / Scoala primara Gura Bascei, comuna Cislau",3,4344,"CISLĂU",46313,298,202,177,25,0,201,1,300,98,156,45
10,"BUZĂU","#N/A",46377,,213,"COCHIRLEANCA / Scoala gimnaziala Cochirleanca nr.1",3,4350,"COCHIRLEANCA",46377,1341,707,656,51,0,704,3,1500,793,456,248
10,"BUZĂU","#N/A",46377,,214,"COCHIRLEANCA / Scoala gimnaziala Cochirleanca nr.2",3,4350,"COCHIRLEANCA",46377,801,498,439,59,0,495,3,800,302,296,199
10,"BUZĂU","#N/A",46377,,215,"BOBOC / Scoala gimnaziala  Boboc",3,4350,"COCHIRLEANCA",46377,1353,740,680,60,0,730,10,1501,761,477,253
10,"BUZĂU","#N/A",46377,,216,"ROŞIORU / Scoala primara  Rosioru",3,4350,"COCHIRLEANCA",46377,566,334,302,32,0,333,1,600,266,220,113
10,"BUZĂU","#N/A",46377,,217,"GARA BOBOCU / Scoala primara Gara Bobocu",3,4350,"COCHIRLEANCA",46377,276,211,163,48,0,208,3,300,89,109,99
10,"BUZĂU","#N/A",46377,,218,"TÎRLELE / Scoala primara Tarlele",3,4350,"COCHIRLEANCA",46377,43,46,28,18,0,46,0,100,54,31,15
10,"BUZĂU","#N/A",46439,,219,"COLŢI / Şcoala Colti",3,4356,"COLŢI",46439,441,296,268,24,4,295,1,501,205,177,118
10,"BUZĂU","#N/A",46439,,220,"ALUNIŞ / Şcoala Alunis",3,4356,"COLŢI",46439,131,109,92,17,0,109,0,201,92,54,55
10,"BUZĂU","#N/A",46439,,221,"MUSCELU CĂRĂMĂNEŞTI / Căminul Cultural Muscelul Cărămăneşti",3,4356,"COLŢI",46439,105,78,65,13,0,78,0,150,72,60,18
10,"BUZĂU","#N/A",46439,,222,"COLŢII DE JOS / Şcoala Coltii de jos",3,4356,"COLŢI",46439,273,195,174,13,8,194,1,301,106,122,72
10,"BUZĂU","#N/A",46484,,223,"COSTEŞTI / Şcoala Nouă Costeşti",3,4361,"COSTEŞTI",46484,1257,841,732,109,0,834,7,1300,459,486,348
10,"BUZĂU","#N/A",46484,,224,"PIETROSU / Grădiniţa Nouă Pietrosu",3,4361,"COSTEŞTI",46484,1152,626,579,47,0,620,6,1200,574,466,154
10,"BUZĂU","#N/A",46484,,225,"BUDIŞTENI / Şcoala Budişteni",3,4361,"COSTEŞTI",46484,416,270,241,29,0,268,2,500,230,164,104
10,"BUZĂU","#N/A",46484,,226,"SPĂTARU / Şcoala Spătaru",3,4361,"COSTEŞTI",46484,994,694,617,77,0,684,10,1100,406,445,239
10,"BUZĂU","#N/A",46484,,227,"GOMOEŞTI / Şcoala Gomoeşti",3,4361,"COSTEŞTI",46484,200,154,118,36,0,152,2,303,149,104,48
10,"BUZĂU","#N/A",46554,,228,"COZIENI / Şcoala Cozieni",3,4368,"COZIENI",46554,536,341,295,46,0,338,3,600,259,224,114
10,"BUZĂU","#N/A",46554,,229,"BĂLĂNEŞTI / Şcoala Bălăneşti",3,4368,"COZIENI",46554,657,427,361,66,0,426,1,700,273,289,137
10,"BUZĂU","#N/A",46554,,230,"TRESTIA / Căminul Cultural Trestia",3,4368,"COZIENI",46554,361,235,205,30,0,232,3,401,166,146,86
10,"BUZĂU","#N/A",46554,,231,"PIETRARU / Şcoala Pietraru",3,4368,"COZIENI",46554,209,129,104,25,0,126,3,300,171,99,27
10,"BUZĂU","#N/A",50564,,232,"FLORICA / Şcoala Gimnaziala Florica",3,4389,"FLORICA",50564,1183,818,678,109,31,808,10,1300,482,584,224
10,"BUZĂU","#N/A",46769,,233,"GĂLBINAŞI / Şcoala cu cls. I-VIII Gălbinaşi",3,4391,"GĂLBINAŞI",46769,1076,711,637,72,2,703,8,1200,489,452,251
10,"BUZĂU","#N/A",46769,,234,"BENTU / Căminul Cultural Bentu",3,4391,"GĂLBINAŞI",46769,789,537,483,54,0,534,3,901,364,277,257
10,"BUZĂU","#N/A",46769,,235,"TĂBĂRĂŞTI / Scoala nr.1 Tabarastii-Vechi",3,4391,"GĂLBINAŞI",46769,716,479,429,50,0,467,12,800,321,308,159
10,"BUZĂU","#N/A",46769,,236,"TĂBĂRĂŞTI / GRADINITA NR.2 TABARASTII NOI",3,4391,"GĂLBINAŞI",46769,934,610,547,63,0,593,17,1000,390,392,201
10,"BUZĂU","#N/A",46803,,237,"GHERĂSENI / Gradinita cu program normal Gheraseni",3,4395,"GHERĂSENI",46803,1487,1036,942,94,0,1031,5,1600,564,594,437
10,"BUZĂU","#N/A",46803,,238,"GHERĂSENI / Şcoala cu clasele I-IV Gheraseni",3,4395,"GHERĂSENI",46803,896,649,607,42,0,636,13,1000,351,419,217
10,"BUZĂU","#N/A",46803,,239,"SUDIŢI / Şcoala cu cls.I-IV Suditi",3,4395,"GHERĂSENI",46803,463,265,241,24,0,263,2,500,235,171,92
10,"BUZĂU","#N/A",46830,,240,"GHERGHEASA / Şcoala Generală Ghergheasa",3,4398,"GHERGHEASA",46830,1050,698,596,69,33,691,7,1101,403,500,191
10,"BUZĂU","#N/A",46830,,241,"SĂLCIOARA / Şcoala Generală Sălcioara",3,4398,"GHERGHEASA",46830,886,682,581,75,26,678,4,1000,318,515,163
10,"BUZĂU","#N/A",46867,,242,"GLODEANU SĂRAT / Căminul Cultural Glodeanu Sărat",3,4401,"GLODEANU SĂRAT",46867,1825,1088,999,89,0,1071,17,2000,912,708,363
10,"BUZĂU","#N/A",46867,,243,"ILEANA / Şcoala cu cls.I-IV Ileana",3,4401,"GLODEANU SĂRAT",46867,367,245,210,35,0,236,9,451,206,152,84
10,"BUZĂU","#N/A",46867,,244,"PITULICEA / Şcoala cu cls.I-VIII Pitulicea",3,4401,"GLODEANU SĂRAT",46867,771,500,453,47,0,494,6,900,400,264,230
10,"BUZĂU","#N/A",46867,,245,"CĂLDĂRUŞEANCA / Căminul Cultural Căldăruşanca",3,4401,"GLODEANU SĂRAT",46867,484,376,310,66,0,373,3,500,124,225,148
10,"BUZĂU","#N/A",46910,,246,"GLODEANU-SILIŞTEA / Căminul Cultural Gl.Siliştea",3,4406,"GLODEANU-SILIŞTEA",46910,1197,789,671,118,0,770,19,1300,511,510,260
10,"BUZĂU","#N/A",46910,,247,"COTORCA / Căminul Cultural Cotorca",3,4406,"GLODEANU-SILIŞTEA",46910,841,522,461,61,0,515,7,900,378,345,170
10,"BUZĂU","#N/A",46910,,248,"CÎRLIGU MARE / Şcoala Cîrligu Mare",3,4406,"GLODEANU-SILIŞTEA",46910,387,267,218,48,1,264,3,400,133,177,87
10,"BUZĂU","#N/A",46910,,249,"VĂCĂREASCA / Şcoala Văcăreasca",3,4406,"GLODEANU-SILIŞTEA",46910,451,294,227,67,0,288,6,501,207,187,101
10,"BUZĂU","#N/A",46910,,250,"CASOTA / Grădiniţa Caşota",3,4406,"GLODEANU-SILIŞTEA",46910,286,201,159,42,0,199,2,300,99,125,74
10,"BUZĂU","#N/A",47006,,251,"GREBĂNU / Şcoala Gimnaziala Grebanu",3,4415,"GREBĂNU",47006,1793,1028,954,74,0,1014,14,2000,972,649,365
10,"BUZĂU","#N/A",47006,,252,"HOMEŞTI / Şcoala primara Homesti",3,4415,"GREBĂNU",47006,788,448,395,53,0,445,3,900,452,303,142
10,"BUZĂU","#N/A",47006,,253,"LIVADA / Şcoala primara Livada Mare",3,4415,"GREBĂNU",47006,598,440,339,101,0,436,4,701,261,316,120
10,"BUZĂU","#N/A",47006,,254,"PLEVNA / Şcoala Gimnaziala Plevna",3,4415,"GREBĂNU",47006,1189,800,740,60,0,798,2,1300,500,551,247
10,"BUZĂU","#N/A",47079,,255,"PĂLTINIŞ / Şcoala Generală cu cls.I-VIII Păltiniş",3,4422,"GURA TEGHII",47079,560,393,353,39,1,389,4,601,208,163,226
10,"BUZĂU","#N/A",47079,,256,"FURTUNEŞTI / Căminul Cultural sat Furtuneşti",3,4422,"GURA TEGHII",47079,794,535,500,32,3,530,5,900,365,260,270
10,"BUZĂU","#N/A",47079,,257,"GURA TEGHII / CAMINUL CULTURAL SATUL GURA TEGHII",3,4422,"GURA TEGHII",47079,1118,795,729,52,14,789,6,1200,405,380,409
10,"BUZĂU","#N/A",47079,,258,"VARLAAM / Şcoala Generală cu cls.I-IV Varlaam",3,4422,"GURA TEGHII",47079,476,314,280,27,7,310,4,500,186,179,131
10,"BUZĂU","#N/A",47159,,259,"LARGU / Primaria Largu",3,4430,"LARGU",47159,1314,795,726,69,0,786,9,1400,605,628,158
10,"BUZĂU","#N/A",47186,,260,"LOPĂTARI / Primaria Lopătari",3,4433,"LOPĂTARI",47186,1058,755,631,87,37,750,5,1200,445,442,308
10,"BUZĂU","#N/A",47186,,261,"LUNCILE / Şcoala cu clasele I-IV Luncile",3,4433,"LOPĂTARI",47186,692,422,371,26,25,414,8,800,378,248,166
10,"BUZĂU","#N/A",47186,,262,"TERCA / Căminul Cultural Terca",3,4433,"LOPĂTARI",47186,396,266,232,21,13,261,5,400,134,146,115
10,"BUZĂU","#N/A",47186,,263,"PLOŞTINA / Şcoala cu clasele I-IV Ploştina",3,4433,"LOPĂTARI",47186,434,264,236,17,11,260,4,500,236,166,94
10,"BUZĂU","#N/A",47186,,264,"PLAIU NUCULUI / Căminul Cultural din satul Plaiu Nucului",3,4433,"LOPĂTARI",47186,622,352,309,33,10,351,1,700,348,248,103
10,"BUZĂU","#N/A",47300,,265,"LUCIU / Căminul Cultural Luciu",3,4445,"LUCIU",47300,1600,1057,994,62,1,1041,16,1800,743,881,160
10,"BUZĂU","#N/A",47300,,266,"CARAGELE / Şcoala Caragele",3,4445,"LUCIU",47300,715,535,485,50,0,533,2,800,265,466,67
10,"BUZĂU","#N/A",47337,,267,"MĂGURA / Scoala gimnaziala Magura",3,4448,"MĂGURA",47337,1129,928,734,97,97,913,15,1200,272,604,309
10,"BUZĂU","#N/A",47337,,268,"CIUTA / Şcoala Generală Ciuta",3,4448,"MĂGURA",47337,611,494,442,38,14,484,10,700,206,350,134
10,"BUZĂU","#N/A",47373,,269,"MĂRĂCINENI / SCOALA GENERALA MARACINENI",3,4451,"MĂRĂCINENI",47373,1327,892,830,62,0,873,19,1400,508,526,347
10,"BUZĂU","#N/A",47373,,270,"MĂRĂCINENI / ŞCOALA GENERALĂ MĂRĂCINENI",3,4451,"MĂRĂCINENI",47373,1164,734,683,51,0,719,15,1300,566,382,337
10,"BUZĂU","#N/A",47373,,271,"CĂPĂŢÎNEŞTI / ŞCOALA GENERALĂ CĂPĂŢÎNEŞTI",3,4451,"MĂRĂCINENI",47373,1377,887,843,44,0,879,8,1500,613,500,379
10,"BUZĂU","#N/A",47373,,272,"CĂPĂŢÎNEŞTI / GRĂDINIŢA CU PROGRAM NORMAL CĂPĂŢÎNEŞTI",3,4451,"MĂRĂCINENI",47373,1428,943,884,59,0,929,14,1600,657,544,385
10,"BUZĂU","#N/A",47373,,273,"POTOCENI / ŞCOALA GENERALĂ POTOCENI",3,4451,"MĂRĂCINENI",47373,1632,1125,1034,88,3,1113,12,1800,675,641,472
10,"BUZĂU","#N/A",47417,,274,"MĂRGĂRITEŞTI / Primaria Mărgăriteşti",3,4455,"MĂRGĂRITEŞTI",47417,607,447,371,59,17,445,2,701,254,322,123
10,"BUZĂU","#N/A",47453,,275,"MEREI / Şcoala Generală Merei",3,4459,"MEREI",47453,942,578,497,81,0,569,9,1000,422,330,239
10,"BUZĂU","#N/A",47453,,276,"LIPIA / Şcoala Generală Lipia",3,4459,"MEREI",47453,1605,1143,990,122,31,1125,18,1801,658,784,341
10,"BUZĂU","#N/A",47453,,277,"SĂRATA-MONTEORU / Şcoala Generală Sarata Monteoru",3,4459,"MEREI",47453,714,724,427,297,0,717,7,800,76,398,319
10,"BUZĂU","#N/A",47453,,278,"GURA SĂRĂŢII / Şcoala Generală Gura Sărăţii",3,4459,"MEREI",47453,154,130,90,40,0,127,3,200,70,79,48
10,"BUZĂU","#N/A",47453,,279,"DEALUL VIEI / Şcoala Generală Dealul Viei",3,4459,"MEREI",47453,637,450,395,55,0,441,9,701,251,268,173
10,"BUZĂU","#N/A",47453,,280,"IZVORU DULCE / Şcoala Generală Izvoru Dulce",3,4459,"MEREI",47453,788,464,396,68,0,461,3,900,436,297,164
10,"BUZĂU","#N/A",47453,,281,"NENCIULEŞTI / Şcoala Generală Nenciuleşti",3,4459,"MEREI",47453,239,167,136,31,0,163,4,300,133,98,65
10,"BUZĂU","#N/A",47453,,282,"OGRĂZILE / Şcoala Generală Ogrăzile",3,4459,"MEREI",47453,596,435,359,76,0,432,3,651,216,290,142
10,"BUZĂU","#N/A",47578,,283,"MIHĂILEŞTI / Şcoala Gimnaziala Mihailesti",3,4471,"MIHĂILEŞTI",47578,1003,519,451,67,1,511,8,1100,581,317,194
10,"BUZĂU","#N/A",47578,,284,"MĂRGINEANU / Şcoala Primara Mărgineanu",3,4471,"MIHĂILEŞTI",47578,644,372,336,31,5,364,8,700,328,305,59
10,"BUZĂU","#N/A",47630,,285,"MÎNZĂLEŞTI / Şcoala Mînzăleşti",3,4476,"MÎNZĂLEŞTI",47630,679,413,381,31,1,412,1,701,288,268,144
10,"BUZĂU","#N/A",47630,,286,"BEŞLII / Şcoala Beşlii",3,4476,"MÎNZĂLEŞTI",47630,499,337,287,46,4,330,7,601,264,220,110
10,"BUZĂU","#N/A",47630,,287,"VALEA COTOAREI / Şcoala Valea Cotoarei",3,4476,"MÎNZĂLEŞTI",47630,170,124,112,12,0,124,0,201,77,60,64
10,"BUZĂU","#N/A",47630,,288,"GURA BĂDICULUI / Şcoala Gura Bădicului",3,4476,"MÎNZĂLEŞTI",47630,416,241,209,31,1,238,3,500,259,141,97
10,"BUZĂU","#N/A",47630,,289,"TRESTIOARA / Şcoala Trestioara",3,4476,"MÎNZĂLEŞTI",47630,294,165,148,17,0,163,2,301,136,77,86
10,"BUZĂU","#N/A",47774,,290,"MOVILA BANULUI / Caminul Cultural Movila Banului",3,4490,"MOVILA BANULUI",47774,1066,715,598,105,12,707,8,1100,385,540,167
10,"BUZĂU","#N/A",47774,,291,"LIMPEZIŞ / Caminul Cultural Limpeziş",3,4490,"MOVILA BANULUI",47774,841,588,492,78,18,575,13,900,312,386,189
10,"BUZĂU","#N/A",47774,,292,"CIORANCA / Şcoala Generala Cioranca",3,4490,"MOVILA BANULUI",47774,216,166,126,34,6,164,2,300,134,94,70
10,"BUZĂU","#N/A",47818,,293,"MURGEŞTI / Primăria Murgeşti",3,4494,"MURGEŞTI",47818,798,616,536,80,0,612,4,900,284,447,165
10,"BUZĂU","#N/A",47854,,294,"NĂENI / Caminul Cultural Năeni",3,4498,"NĂENI",47854,489,308,262,46,0,300,8,500,192,214,86
10,"BUZĂU","#N/A",47854,,295,"FINŢEŞTI / Caminul Cultural Finţeşti",3,4498,"NĂENI",47854,484,321,275,46,0,320,1,499,178,201,119
10,"BUZĂU","#N/A",47854,,296,"VÎRF / Şcoala Vîrf",3,4498,"NĂENI",47854,231,151,133,18,0,151,0,300,149,107,44
10,"BUZĂU","#N/A",47854,,297,"PROŞCA / Grădiniţa Prosca",3,4498,"NĂENI",47854,196,147,113,34,0,144,3,200,53,80,64
10,"BUZĂU","#N/A",48021,,298,"ODĂILE / Şcoala cu cls.I-VIII Odăile",3,4504,"ODĂILE",48021,734,509,411,62,36,505,4,800,291,391,114
10,"BUZĂU","#N/A",48138,,299,"PADINA / SCOALA NR.2 PADINA",3,4515,"PADINA",48138,1313,759,695,64,0,748,11,1401,642,547,201
10,"BUZĂU","#N/A",48138,,300,"PADINA / Căminul Cultural Padina",3,4515,"PADINA",48138,1009,597,516,81,0,588,9,1101,504,423,165
10,"BUZĂU","#N/A",48138,,301,"PADINA / Şcoala nr.1 Padina",3,4515,"PADINA",48138,1090,703,583,120,0,694,9,1201,498,515,179
10,"BUZĂU","#N/A",48165,,302,"PARDOŞI / Şcoala Pardoşi",3,4528,"PARDOŞI",48165,381,272,231,41,0,272,0,400,128,207,65
10,"BUZĂU","#N/A",48227,,303,"PĂNĂTĂU / Şcoala Gimnazială Pănătău",3,4518,"PĂNĂTĂU",48227,1294,887,794,93,0,879,8,1400,513,660,219
10,"BUZĂU","#N/A",48227,,304,"TEGA / Şcoala Tega",3,4518,"PĂNĂTĂU",48227,567,378,333,45,0,370,8,600,222,293,77
10,"BUZĂU","#N/A",48227,,305,"BEGU / CAMIN CULTURAL BEGU",3,4518,"PĂNĂTĂU",48227,195,150,131,19,0,147,3,200,50,127,20
10,"BUZĂU","#N/A",48487,,306,"PIETROASELE / Şcoala Gimnazială Pietroasele",3,4534,"PIETROASELE",48487,1603,966,833,132,1,957,9,1801,835,550,407
10,"BUZĂU","#N/A",48487,,307,"ŞARÎNGA / Grădiniţa cu program normal din satul Şarînga",3,4534,"PIETROASELE",48487,1190,712,611,101,0,703,9,1301,589,421,282
10,"BUZĂU","#N/A",48557,,308,"PÎRSCOV / Căminul cultural  Pîrscov",3,4541,"PÎRSCOV",48557,1271,756,659,97,0,745,11,1400,644,464,281
10,"BUZĂU","#N/A",48557,,309,"PÎRSCOV / Căminul cultural  Pîrscov",3,4541,"PÎRSCOV",48557,1261,738,691,47,0,732,6,1400,662,453,279
10,"BUZĂU","#N/A",48557,,310,"BADILA / Şcoala generală Bădila",3,4541,"PÎRSCOV",48557,671,395,368,27,0,387,8,700,305,217,170
10,"BUZĂU","#N/A",48557,,311,"LUNCA FRUMOASĂ / Şcoala Lunca Frumoasa",3,4541,"PÎRSCOV",48557,941,586,539,47,0,582,4,1000,414,358,224
10,"BUZĂU","#N/A",48557,,312,"ROBEŞTI / Şcoala generală Robeşti",3,4541,"PÎRSCOV",48557,515,367,311,56,0,365,2,600,233,226,139
10,"BUZĂU","#N/A",48557,,313,"TRESTIENI / Fostul Magazin Trestieni",3,4541,"PÎRSCOV",48557,56,36,15,21,0,36,0,100,64,28,8
10,"BUZĂU","#N/A",48682,,314,"PLEŞEŞTI / Şcoala Pleşeşti",3,4554,"PODGORIA",48682,324,179,150,29,0,179,0,400,221,84,95
10,"BUZĂU","#N/A",48682,,315,"PODGORIA / Şcoala Podgoria",3,4554,"PODGORIA",48682,1291,838,753,71,14,831,7,1400,562,579,252
10,"BUZĂU","#N/A",48682,,316,"COŢATCU / Şcoala Coţatcu",3,4554,"PODGORIA",48682,985,634,555,79,0,630,4,1100,466,439,191
10,"BUZĂU","#N/A",48771,,317,"POŞTA CÎLNĂU / Grădiniţa de copii Poşta Cîlnău",3,4560,"POŞTA CÎLNĂU",48771,1056,688,625,53,10,684,4,1201,513,394,290
10,"BUZĂU","#N/A",48771,,318,"POŞTA CÎLNĂU / Grădiniţa de copii Poşta Cîlnău",3,4560,"POŞTA CÎLNĂU",48771,988,644,602,39,3,634,10,1101,457,348,286
10,"BUZĂU","#N/A",48771,,319,"POTÎRNICHEŞTI / SCOALA GENERALA DIN POTIRNICHESTI",3,4560,"POŞTA CÎLNĂU",48771,383,237,206,31,0,234,3,401,164,123,111
10,"BUZĂU","#N/A",48771,,320,"ZILIŞTEANCA / Şcoala Generală Zilişteanca",3,4560,"POŞTA CÎLNĂU",48771,1099,685,631,50,4,675,10,1200,515,424,251
10,"BUZĂU","#N/A",48771,,321,"SUDIŢI / Şcoala Generală, satul Sudiţi",3,4560,"POŞTA CÎLNĂU",48771,1502,915,838,72,5,893,22,1701,786,510,383
10,"BUZĂU","#N/A",48842,,322,"PUIEŞTII DE SUS / Şcoala din satul Puieştii de Sus",3,4567,"PUIEŞTI",48842,335,214,182,32,0,213,1,400,186,131,82
10,"BUZĂU","#N/A",48842,,323,"PUIEŞTII DE JOS / Şcoala Gimnaziala din satul Puieştii de Jos",3,4567,"PUIEŞTI",48842,1147,729,635,92,2,716,13,1300,571,409,307
10,"BUZĂU","#N/A",48842,,324,"NICOLEŞTI / Şcoala Gimnaziala din satul Nicoleşti",3,4567,"PUIEŞTI",48842,678,380,352,28,0,374,6,700,320,250,124
10,"BUZĂU","#N/A",48842,,325,"DĂSCĂLEŞTI / Grădiniţa din satul Dăscăleşti",3,4567,"PUIEŞTI",48842,651,389,332,57,0,384,5,701,312,262,122
10,"BUZĂU","#N/A",48842,,326,"MĂCRINA / Şcoala din satul Măcrina",3,4567,"PUIEŞTI",48842,488,305,252,53,0,301,4,501,196,206,95
10,"BUZĂU","#N/A",48922,,327,"RACOVIŢENI / Primăria Racoviţeni",3,4575,"RACOVIŢENI",48922,1086,712,632,80,0,696,16,1201,489,504,192
10,"BUZĂU","#N/A",48968,,328,"RÎMNICELU / SCOALA GIMNAZIALA NR.1",3,4579,"RÎMNICELU",48968,995,610,581,28,1,602,8,1100,490,339,263
10,"BUZĂU","#N/A",48968,,329,"RÎMNICELU / Scoala nr.2 sat Ramnicelu",3,4579,"RÎMNICELU",48968,1376,737,706,29,2,733,4,1500,763,399,334
10,"BUZĂU","#N/A",48968,,330,"ŞTIUBEI / Scoala sat Ştiubei",3,4579,"RÎMNICELU",48968,488,389,341,48,0,384,5,500,111,277,107
10,"BUZĂU","#N/A",48968,,331,"COLIBAŞI / Şcoala sat Colibaşi",3,4579,"RÎMNICELU",48968,332,264,220,31,13,262,2,400,136,194,68
10,"BUZĂU","#N/A",48968,,332,"FOTIN / Şcoala sat Fotin",3,4579,"RÎMNICELU",48968,162,131,109,22,0,127,4,200,69,96,31
10,"BUZĂU","#N/A",49019,,333,"ROBEASCA / Şcoala Robeasca",3,4584,"ROBEASCA",49019,594,409,325,36,48,402,7,700,291,341,61
10,"BUZĂU","#N/A",49019,,334,"MOŞEŞTI / Caminul cultural Moşeşti",3,4584,"ROBEASCA",49019,293,233,137,53,43,232,1,301,68,201,31
10,"BUZĂU","#N/A",49046,,335,"RUŞEŢU / LICEUL TEHNOLOGIC RUSETU",3,4587,"RUŞEŢU",49046,1090,748,681,61,6,740,8,1200,452,422,318
10,"BUZĂU","#N/A",49046,,336,"RUŞEŢU / CLĂDIREA GRĂDINIŢEI CU PROGRAM NORMAL",3,4587,"RUŞEŢU",49046,1007,623,590,29,4,620,3,1100,477,398,222
10,"BUZĂU","#N/A",49046,,337,"RUŞEŢU / Căminul cultural din localitatea Ruşeţu",3,4587,"RUŞEŢU",49046,993,730,639,86,5,718,12,1100,370,425,293
10,"BUZĂU","#N/A",49046,,338,"SERGENT IONEL ŞTEFAN / Şcoala primară din satul serg.Ionel Ştefan, str. Unirii nr. 16",3,4587,"RUŞEŢU",49046,184,183,127,56,0,180,3,201,18,97,83
10,"BUZĂU","#N/A",49073,,339,"SĂGEATA / Şcoala  Săgeata",3,4590,"SĂGEATA",49073,1216,926,808,62,56,918,8,1300,374,677,241
10,"BUZĂU","#N/A",49073,,340,"DÎMBROCA / Şcoala Dîmbroca",3,4590,"SĂGEATA",49073,1016,753,659,53,41,738,15,1100,347,501,237
10,"BUZĂU","#N/A",49073,,341,"BORDUŞANI / Şcoala  Borduşani",3,4590,"SĂGEATA",49073,356,300,250,50,0,295,5,400,100,198,97
10,"BUZĂU","#N/A",49073,,342,"BEILIC / Şcoala  Beilic",3,4590,"SĂGEATA",49073,325,254,218,28,8,253,1,400,146,202,51
10,"BUZĂU","#N/A",49073,,343,"GĂVĂNEŞTI / Şcoala Găvăneşti",3,4590,"SĂGEATA",49073,923,628,530,59,39,618,10,1000,372,475,143
10,"BUZĂU","#N/A",49073,,344,"BANIŢA / Scoala  Baniţa",3,4590,"SĂGEATA",49073,279,244,176,40,28,242,2,300,56,165,77
10,"BUZĂU","#N/A",49153,,345,"SĂHĂTENI / Caminul Cultural Săhăteni",3,4598,"SĂHĂTENI",49153,1298,764,709,55,0,751,13,1400,636,475,276
10,"BUZĂU","#N/A",49153,,346,"ISTRIŢA DE JOS / Şcoala cu cls.I-IV Istriţa de Jos",3,4598,"SĂHĂTENI",49153,272,188,159,29,0,184,4,300,112,92,92
10,"BUZĂU","#N/A",49153,,347,"GĂGENI / Şcoala cu cls.I-IV Găgeni",3,4598,"SĂHĂTENI",49153,364,245,220,25,0,240,5,388,143,169,71
10,"BUZĂU","#N/A",49153,,348,"VINTILEANCA / Şcoala cls.I-VIII Vintileanca",3,4598,"SĂHĂTENI",49153,756,375,341,34,0,370,5,800,425,225,145
10,"BUZĂU","#N/A",49206,,349,"SĂPOCA / Scoala elementara sat Sapoca",3,4603,"SĂPOCA",49206,1451,1145,859,129,157,1127,18,1600,455,727,400
10,"BUZĂU","#N/A",49206,,350,"MĂTEŞTI / Camin cultural sat Matesti",3,4603,"SĂPOCA",49206,1399,992,883,96,13,976,16,1500,508,577,399
10,"BUZĂU","#N/A",49233,,351,"SĂRULEŞTI / Căminul cultural Săruleşti",3,4606,"SĂRULEŞTI",49233,1134,729,657,72,0,724,5,1200,471,526,198
10,"BUZĂU","#N/A",49313,,352,"SCORŢOASA / SALA DE FESTIVITĂŢI SCORTOASA",3,4614,"SCORŢOASA",49313,1036,621,539,82,0,619,2,1100,479,373,246
10,"BUZĂU","#N/A",49313,,353,"GURA VĂII / Şcoala cu cls.I-IV din satul Gura Văii",3,4614,"SCORŢOASA",49313,192,139,107,32,0,138,1,200,61,86,52
10,"BUZĂU","#N/A",49313,,354,"PLOPEASA / Şcoala cu cls. I-IV  din satul Plopeasa de Sus",3,4614,"SCORŢOASA",49313,205,119,93,26,0,118,1,250,131,97,21
10,"BUZĂU","#N/A",49313,,355,"GRABICINA DE JOS / Şcoala cu cls.I-IV Grabicina de Jos",3,4614,"SCORŢOASA",49313,200,127,106,21,0,126,1,300,173,98,28
10,"BUZĂU","#N/A",49313,,356,"GOLU GRABICINA / Şcoala cu cls.I-IV Golu Grabicina",3,4614,"SCORŢOASA",49313,251,154,120,34,0,150,4,300,146,121,29
10,"BUZĂU","#N/A",49313,,357,"BALTA TOCILA / SCOALA CU CLASELE I-VIII BALTA TOCILA",3,4614,"SCORŢOASA",49313,278,152,123,29,0,150,2,300,148,109,41
10,"BUZĂU","#N/A",49313,,358,"BECIU / Şcoala cu cls.I-IV Beciu",3,4614,"SCORŢOASA",49313,139,104,84,20,0,104,0,200,96,78,26
10,"BUZĂU","#N/A",49439,,359,"SCUTELNICI / Căminul Cultural din satul Scutelnici",3,4626,"SCUTELNICI",49439,955,542,470,72,0,531,11,1001,459,371,160
10,"BUZĂU","#N/A",49439,,360,"BRĂGĂREASA / Grădiniţa din satul Brăgăreasa",3,4626,"SCUTELNICI",49439,578,355,313,42,0,348,7,695,340,240,108
10,"BUZĂU","#N/A",49439,,361,"ARCANU / Şcoala generală cu cls. I-IV din satul Arcanu",3,4626,"SCUTELNICI",49439,369,231,209,22,0,222,9,394,163,184,38
10,"BUZĂU","#N/A",49484,,362,"LUNCA JARIŞTEI / Şcoala Gimnaziala comuna Siriu, Judetul Buzau,din satul Lunca Jaristei",3,4631,"SIRIU",49484,1468,971,909,56,6,957,14,1600,629,496,461
10,"BUZĂU","#N/A",49484,,363,"COLŢU PIETRII / Şcoala Primară sat Colţu Pietrii,comuna Siriu,judetul Buzău",3,4631,"SIRIU",49484,1105,786,748,35,3,777,9,1200,414,412,365
10,"BUZĂU","#N/A",49545,,364,"SMEENI / Căminul de nunti Smeeni",3,4637,"SMEENI",49545,1232,724,668,42,14,712,12,1300,576,440,272
10,"BUZĂU","#N/A",49545,,365,"SMEENI / Gradinita Smeeni",3,4637,"SMEENI",49545,1082,673,586,79,8,667,6,1200,527,445,222
10,"BUZĂU","#N/A",49545,,366,"SMEENI / Şcoala Sălcioara",3,4637,"SMEENI",49545,559,346,305,41,0,342,4,601,255,218,124
10,"BUZĂU","#N/A",49545,,367,"MOISICA / Grădiniţa Moisica",3,4637,"SMEENI",49545,289,196,164,24,8,193,3,300,104,143,50
10,"BUZĂU","#N/A",49545,,368,"ALBEŞTI / Şcoala Albeşti",3,4637,"SMEENI",49545,727,500,447,50,3,496,4,801,301,387,109
10,"BUZĂU","#N/A",49545,,369,"UDAŢI-MÂNZU / Gradinita Udaţi Mânzu",3,4637,"SMEENI",49545,748,491,443,35,13,489,2,800,309,398,91
10,"BUZĂU","#N/A",49545,,370,"CĂLŢUNA / Şcoala Călţuna",3,4637,"SMEENI",49545,445,285,259,23,3,283,2,500,215,206,77
10,"BUZĂU","#N/A",49545,,371,"UDAŢI-LUCIENI / Şcoala Lucieni",3,4637,"SMEENI",49545,347,223,193,22,8,222,1,400,177,160,62
10,"BUZĂU","#N/A",49625,,372,"STÎLPU / SCOALA GIMNAZIALA STILPU",3,4645,"STÎLPU",49625,1418,920,861,59,0,911,9,1600,680,640,271
10,"BUZĂU","#N/A",49625,,373,"STÎLPU / PRIMARIA STILPU",3,4645,"STÎLPU",49625,1195,793,714,79,0,783,10,1300,507,556,227
10,"BUZĂU","#N/A",49643,,374,"GRĂJDANA / CAMINUL CULTURAL SAT GRAJDANA",3,4652,"TISĂU",49643,995,668,595,69,4,659,9,1096,428,383,276
10,"BUZĂU","#N/A",49643,,375,"IZVORANU / SCOALA CU INVATAMANT PRIMAR SAT IZVORANU",3,4652,"TISĂU",49643,95,68,47,20,1,68,0,100,32,44,24
10,"BUZĂU","#N/A",49643,,376,"VALEA SĂLCIILOR / SCOALA CU INVATAMANT PRIMAR SAT VALEA SALCIILOR",3,4652,"TISĂU",49643,473,320,278,38,4,315,5,500,180,181,134
10,"BUZĂU","#N/A",49643,,377,"HALEŞ / ŞCOALA  GIMNAZIALA SAT HALEŞ",3,4652,"TISĂU",49643,778,524,463,57,4,514,10,800,276,284,230
10,"BUZĂU","#N/A",49643,,378,"PĂDURENII / GRADINITA CU PROGRAM NORMAL SAT  PADURENI",3,4652,"TISĂU",49643,531,320,298,22,0,313,7,600,280,192,121
10,"BUZĂU","#N/A",49643,,379,"TISĂU / GRADINIŢĂ CU PROGRAM NORMAL SAT TISĂU",3,4652,"TISĂU",49643,637,451,400,51,0,444,7,701,250,269,175
10,"BUZĂU","#N/A",49643,,380,"STREZENI / SCOALA CU INVĂŢĂMÂNT PRIMAR SAT STREZENI",3,4652,"TISĂU",49643,441,313,268,42,3,308,5,500,187,167,141
10,"BUZĂU","#N/A",49769,,381,"POŞTA / Şcoala Poşta",3,4664,"TOPLICENI",49769,425,285,247,38,0,280,5,501,216,152,128
10,"BUZĂU","#N/A",49769,,382,"TOPLICENI / Şcoala Generală Topliceni",3,4664,"TOPLICENI",49769,1053,615,563,52,0,608,7,1201,586,373,235
10,"BUZĂU","#N/A",49769,,383,"RĂDUCEŞTI / Şcoala Răduceşti",3,4664,"TOPLICENI",49769,360,244,214,30,0,238,6,400,156,143,95
10,"BUZĂU","#N/A",49769,,384,"BĂBENI / Şcoala Băbeni",3,4664,"TOPLICENI",49769,855,530,490,40,0,525,5,901,371,262,263
10,"BUZĂU","#N/A",49769,,385,"DEDULEŞTI / Şcoala Deduleşti",3,4664,"TOPLICENI",49769,806,522,463,59,0,518,4,901,379,314,204
10,"BUZĂU","#N/A",49769,,386,"GURA FĂGETULUI / SCOALA GURA FAGETULUI",3,4664,"TOPLICENI",49769,145,123,98,25,0,123,0,201,78,63,60
10,"BUZĂU","#N/A",49849,,387,"ŢINTEŞTI / Şcoala Generală din Ţinteşti",3,4647,"ŢINTEŞTI",49849,1858,1148,1064,84,0,1136,12,2000,852,804,332
10,"BUZĂU","#N/A",49849,,388,"MAXENU / Spaţiul de utilitate publică din satul Maxenu",3,4647,"ŢINTEŞTI",49849,1826,1167,1077,90,0,1152,15,2000,833,886,266
10,"BUZĂU","#N/A",49894,,389,"ULMENI / Şcoala Generală ""Constantin Dinca"" Ulmeni",3,4672,"ULMENI",49894,1240,788,666,88,34,775,13,1301,513,528,247
10,"BUZĂU","#N/A",49894,,390,"CLONDIRU / Localul Fostului Sfat Popular Clondiru",3,4672,"ULMENI",49894,1354,889,765,94,30,878,11,1501,612,593,285
10,"BUZĂU","#N/A",50549,,391,"UNGURIU / Scoala Gimnaziala Ing. Oprisan Iarca Unguriu",3,4678,"UNGURIU",50549,942,600,514,81,5,591,9,1001,401,347,244
10,"BUZĂU","#N/A",50549,,392,"UNGURIU / Scoala Gimnaziala Ing. Oprisan Iarca Unguriu",3,4678,"UNGURIU",50549,979,673,548,0,125,657,16,1101,428,412,245
10,"BUZĂU","#N/A",49956,,393,"VADU PAŞII / Scoala Gimnaziala Vadu Paşii",3,4681,"VADU PAŞII",49956,1881,1325,1213,112,0,1305,20,2100,775,774,531
10,"BUZĂU","#N/A",49956,,394,"VADU PAŞII / Grădiniţa cu Program Normal Vadu Paşii",3,4681,"VADU PAŞII",49956,1434,928,864,64,0,923,5,1600,672,561,362
10,"BUZĂU","#N/A",49956,,395,"FOCŞĂNEI / Scoala Focşănei",3,4681,"VADU PAŞII",49956,1124,742,661,81,0,735,7,1200,458,435,300
10,"BUZĂU","#N/A",49956,,396,"SCURTEŞTI / Scoala Ciocârlia",3,4681,"VADU PAŞII",49956,563,384,352,32,0,382,2,600,216,271,111
10,"BUZĂU","#N/A",49956,,397,"SCURTEŞTI / Scoala Gimnaziala Scurteşti",3,4681,"VADU PAŞII",49956,1622,986,925,61,0,977,9,1800,814,689,288
10,"BUZĂU","#N/A",49956,,398,"STĂNCEŞTI / Şcoala Gimnaziala Stănceşti",3,4681,"VADU PAŞII",49956,1256,769,727,42,0,764,5,1401,632,545,219
10,"BUZĂU","#N/A",50022,,399,"OREAVUL / Gradinita cu program normal Oreavu",3,4688,"VALEA RÎMNICULUI",50022,1979,1228,1145,70,13,1220,8,2200,972,768,452
10,"BUZĂU","#N/A",50022,,400,"VALEA RÎMNICULUI / Scoala Gimnaziala Valea Ramnicului",3,4688,"VALEA RÎMNICULUI",50022,1798,1146,1063,53,30,1135,11,2001,855,718,417
10,"BUZĂU","#N/A",50022,,401,"RUBLA / Gradinita cu program normal Rubla",3,4688,"VALEA RÎMNICULUI",50022,1004,681,622,39,20,672,9,1100,419,464,208
10,"BUZĂU","#N/A",50068,,402,"VALEA SALCIEI / Căminul Cultural Valea Salciei",3,4692,"VALEA SALCIEI",50068,637,386,361,24,1,385,1,700,314,206,179
10,"BUZĂU","#N/A",50102,,403,"VERNEŞTI / Şcoala Generală Verneşti",3,4696,"VERNEŞTI",50102,1883,1120,1020,100,0,1106,14,2101,981,601,505
10,"BUZĂU","#N/A",50102,,404,"CÎNDEŞTI / Şcoala Generală Cindeşti",3,4696,"VERNEŞTI",50102,1360,779,725,54,0,763,16,1501,722,469,294
10,"BUZĂU","#N/A",50102,,405,"CÎNDEŞTI / Şcoala Generală Cindeşti",3,4696,"VERNEŞTI",50102,1318,752,713,39,0,730,22,1500,748,441,289
10,"BUZĂU","#N/A",50102,,406,"ZOREŞTI / Şcoala Generală Zoreşti",3,4696,"VERNEŞTI",50102,1099,753,656,97,0,744,9,1200,447,446,298
10,"BUZĂU","#N/A",50102,,407,"NIŞCOV / Şcoala Generală Nişcov",3,4696,"VERNEŞTI",50102,1084,626,562,64,0,617,9,1200,574,373,244
10,"BUZĂU","#N/A",50102,,408,"SĂSENII NOI / Şcoala Generală Săsenii Noi",3,4696,"VERNEŞTI",50102,297,200,164,36,0,195,5,300,100,114,81
10,"BUZĂU","#N/A",50102,,409,"MIEREA / Gradinita Mierea",3,4696,"VERNEŞTI",50102,359,246,205,41,0,245,1,400,154,115,130
10,"BUZĂU","#N/A",50228,,410,"VINTILĂ VODĂ / Şcoala Vintilă Vodă",3,4710,"VINTILĂ VODĂ",50228,1340,875,748,88,39,868,7,1501,626,598,270
10,"BUZĂU","#N/A",50228,,411,"NICULEŞTI / Şcoala Generală Niculeşti",3,4710,"VINTILĂ VODĂ",50228,1006,584,496,81,7,580,4,1100,516,415,165
10,"BUZĂU","#N/A",50228,,412,"COCA-ANTIMIREŞTI / Şcoala Generală Coca Antimiresti",3,4710,"VINTILĂ VODĂ",50228,231,102,87,15,0,101,1,300,198,77,24
10,"BUZĂU","#N/A",50326,,413,"VIPEREŞTI / Şcoala Gimnaziala Vipereşti",3,4720,"VIPEREŞTI",50326,878,565,491,49,25,551,14,1000,435,398,153
10,"BUZĂU","#N/A",50326,,414,"TRONARI / Şcoala Primara Tronari",3,4720,"VIPEREŞTI",50326,766,514,452,40,22,504,10,800,286,421,83
10,"BUZĂU","#N/A",50326,,415,"URSOAIA / Şcoala Gimnaziala Ursoaia",3,4720,"VIPEREŞTI",50326,927,617,489,73,55,609,8,1001,384,404,205
10,"BUZĂU","#N/A",50326,,416,"MUSCEL / Şcoala Primara Muşcel",3,4720,"VIPEREŞTI",50326,125,110,62,28,20,109,1,200,90,77,32
10,"BUZĂU","#N/A",50399,,417,"VÎLCELELE / Căminul Cultural Vîlcelele",3,4708,"VÎLCELELE",50399,1267,825,717,107,1,820,5,1400,575,539,281
10,"BUZĂU","#N/A",50415,,418,"FUNDENI / Scoala Generala Fundeni",3,4727,"ZĂRNEŞTI",50415,1893,1340,1187,110,43,1325,15,2100,760,1013,312
10,"BUZĂU","#N/A",50415,,419,"PRUNENI / Grădiniţa de copii Pruneni",3,4727,"ZĂRNEŞTI",50415,328,288,219,54,15,286,2,376,88,236,50
10,"BUZĂU","#N/A",50415,,420,"VADU SOREŞTI / Grădiniţa de copii Vadu Soreşti",3,4727,"ZĂRNEŞTI",50415,1101,735,631,80,24,720,15,1200,465,529,191
10,"BUZĂU","#N/A",50415,,421,"ZĂRNEŞTI / Grădiniţa de copii Zărneşti",3,4727,"ZĂRNEŞTI",50415,883,737,594,106,37,723,14,1000,263,536,187
10,"BUZĂU","#N/A",50479,,422,"ZIDURI / Sala de şedinţe Primăria Ziduri",3,4733,"ZIDURI",50479,829,488,450,38,0,483,5,900,412,321,162
10,"BUZĂU","#N/A",50479,,423,"LANURILE / Căminul cultural Lanurile",3,4733,"ZIDURI",50479,614,361,315,35,11,360,1,700,339,277,83
10,"BUZĂU","#N/A",50479,,424,"HELIADE RĂDULESCU / Şcoala generală cu cls. I-IV Heliade Rădulescu",3,4733,"ZIDURI",50479,726,508,418,51,39,507,1,800,292,398,109
10,"BUZĂU","#N/A",50479,,425,"COSTIENI / Şcoala generală cu cls. I-IV  Costieni",3,4733,"ZIDURI",50479,645,473,411,38,24,468,5,700,227,380,88
10,"BUZĂU","#N/A",50479,,426,"ZOIŢA / Căminul Cultural Zoiţa",3,4733,"ZIDURI",50479,491,349,285,36,28,342,7,501,152,264,78
10,"BUZĂU","#N/A",50479,,427,"CUCULEASA / Şcoala generală cu cls. I-IV Cuculeasa",3,4733,"ZIDURI",50479,392,258,227,25,6,252,6,399,141,170,82
11,"CARAŞ-SEVERIN","#N/A",50790,,1,"REŞIŢA / Şcoala Gimnazială nr. 5",1,4741,"MUNICIPIUL REŞIŢA",50790,1301,650,556,38,56,640,10,1429,779,290,350
11,"CARAŞ-SEVERIN","#N/A",50790,,2,"REŞIŢA / Centrul de Zi ""Maria""",1,4741,"MUNICIPIUL REŞIŢA",50790,633,263,250,13,0,256,7,697,434,118,138
11,"CARAŞ-SEVERIN","#N/A",50790,,3,"REŞIŢA / Grădiniţa cu Program Normal Nr. 2",1,4741,"MUNICIPIUL REŞIŢA",50790,1075,512,484,27,1,506,6,1180,668,209,297
11,"CARAŞ-SEVERIN","#N/A",50790,,4,"REŞIŢA / Şcoala Gimnazială Nr. 1 (Beton)",1,4741,"MUNICIPIUL REŞIŢA",50790,638,355,331,24,0,348,7,701,346,129,219
11,"CARAŞ-SEVERIN","#N/A",50790,,5,"REŞIŢA / Şcoala Gimnazială Nr. 1 (Beton)",1,4741,"MUNICIPIUL REŞIŢA",50790,1089,513,483,28,2,504,9,1197,684,214,290
11,"CARAŞ-SEVERIN","#N/A",50790,,6,"REŞIŢA / Şcoala Gimnazială Nr. 1 (Casa Muncitorească)",1,4741,"MUNICIPIUL REŞIŢA",50790,1526,691,673,18,0,675,16,1682,991,274,401
11,"CARAŞ-SEVERIN","#N/A",50790,,7,"REŞIŢA / Şcoala Gimnazială Nr. 1 (Casa Muncitorească)",1,4741,"MUNICIPIUL REŞIŢA",50790,1124,458,438,20,0,447,11,1241,783,184,263
11,"CARAŞ-SEVERIN","#N/A",50790,,8,"REŞIŢA / Şcoala Primară Dealu Mare",1,4741,"MUNICIPIUL REŞIŢA",50790,729,294,278,16,0,293,1,801,507,117,176
11,"CARAŞ-SEVERIN","#N/A",50790,,9,"REŞIŢA / Şcoala Primară Dealu Mare",1,4741,"MUNICIPIUL REŞIŢA",50790,828,368,348,20,0,366,2,904,536,186,180
11,"CARAŞ-SEVERIN","#N/A",50790,,10,"REŞIŢA / Şcoala Gimnazială nr. 2",1,4741,"MUNICIPIUL REŞIŢA",50790,1082,586,507,51,28,580,6,1189,603,277,303
11,"CARAŞ-SEVERIN","#N/A",50790,,11,"REŞIŢA / Şcoala Gimnazială nr. 2",1,4741,"MUNICIPIUL REŞIŢA",50790,1293,719,657,62,0,702,17,1427,708,303,399
11,"CARAŞ-SEVERIN","#N/A",50790,,12,"REŞIŢA / Şcoala Gimnazială nr. 2",1,4741,"MUNICIPIUL REŞIŢA",50790,1212,640,608,32,0,628,12,1337,697,275,353
11,"CARAŞ-SEVERIN","#N/A",50790,,13,"REŞIŢA / Colegiul Naţional ""Traian Lalescu"" - Şcoala Primară",1,4741,"MUNICIPIUL REŞIŢA",50790,642,288,264,24,0,286,2,710,422,168,118
11,"CARAŞ-SEVERIN","#N/A",50790,,14,"REŞIŢA / Grădiniţa cu Program Prelungit ""Palatul Fermecat""",1,4741,"MUNICIPIUL REŞIŢA",50790,1044,607,554,52,1,601,6,1145,538,250,351
11,"CARAŞ-SEVERIN","#N/A",50790,,15,"REŞIŢA / Grădiniţa cu Program Prelungit ""Palatul Fermecat""",1,4741,"MUNICIPIUL REŞIŢA",50790,1267,731,702,29,0,721,10,1397,666,286,435
11,"CARAŞ-SEVERIN","#N/A",50790,,16,"REŞIŢA / Grădiniţa cu Program Prelungit ""Palatul Fermecat""",1,4741,"MUNICIPIUL REŞIŢA",50790,1440,719,681,38,0,702,17,1584,865,295,407
11,"CARAŞ-SEVERIN","#N/A",50790,,17,"REŞIŢA / Consiliul Judeţean fost sediu al S.C. Drumuri şi Poduri S.A.",1,4741,"MUNICIPIUL REŞIŢA",50790,1041,552,472,23,57,547,5,1146,594,241,306
11,"CARAŞ-SEVERIN","#N/A",50790,,18,"REŞIŢA / Universitatea ""Eftimie Murgu""",1,4741,"MUNICIPIUL REŞIŢA",50790,566,337,269,67,1,329,8,619,282,153,176
11,"CARAŞ-SEVERIN","#N/A",50790,,19,"REŞIŢA / Universitatea ""Eftimie Murgu""",1,4741,"MUNICIPIUL REŞIŢA",50790,1175,637,589,46,2,624,13,1297,660,305,319
11,"CARAŞ-SEVERIN","#N/A",50790,,20,"REŞIŢA / Colegiul Naţional ""Traian Lalescu""",1,4741,"MUNICIPIUL REŞIŢA",50790,1225,595,573,22,0,584,11,1349,754,253,331
11,"CARAŞ-SEVERIN","#N/A",50790,,21,"REŞIŢA / Colegiul Naţional ""Traian Lalescu""",1,4741,"MUNICIPIUL REŞIŢA",50790,1006,530,487,42,1,515,15,1107,577,224,291
11,"CARAŞ-SEVERIN","#N/A",50790,,22,"REŞIŢA / Colegiul Naţional ""Traian Lalescu""",1,4741,"MUNICIPIUL REŞIŢA",50790,1372,658,621,37,0,644,14,1509,851,265,379
11,"CARAŞ-SEVERIN","#N/A",50790,,23,"REŞIŢA / Colegiul Naţional ""Traian Lalescu""",1,4741,"MUNICIPIUL REŞIŢA",50790,805,465,442,22,1,458,7,887,422,202,256
11,"CARAŞ-SEVERIN","#N/A",50790,,24,"REŞIŢA / Şcoala Gimnazială ""Mihai Peia""",1,4741,"MUNICIPIUL REŞIŢA",50790,951,562,516,44,2,546,16,1049,487,250,296
11,"CARAŞ-SEVERIN","#N/A",50790,,25,"REŞIŢA / Şcoala Gimnazială ""Mihai Peia""",1,4741,"MUNICIPIUL REŞIŢA",50790,814,429,412,17,0,421,8,898,469,194,227
11,"CARAŞ-SEVERIN","#N/A",50790,,26,"REŞIŢA / Şcoala Gimnazială ""Mihai Peia""",1,4741,"MUNICIPIUL REŞIŢA",50790,991,504,482,16,6,500,4,1099,595,224,276
11,"CARAŞ-SEVERIN","#N/A",50790,,27,"REŞIŢA / Colegiul Tehnic Reşiţa",1,4741,"MUNICIPIUL REŞIŢA",50790,1301,696,660,35,1,678,18,1432,736,309,369
11,"CARAŞ-SEVERIN","#N/A",50790,,28,"REŞIŢA / Colegiul Tehnic Reşiţa",1,4741,"MUNICIPIUL REŞIŢA",50790,805,472,429,43,0,469,3,890,418,179,290
11,"CARAŞ-SEVERIN","#N/A",50790,,29,"REŞIŢA / Colegiul Tehnic Reşiţa",1,4741,"MUNICIPIUL REŞIŢA",50790,1091,556,536,20,0,543,13,1207,651,231,312
11,"CARAŞ-SEVERIN","#N/A",50790,,30,"REŞIŢA / Grădiniţa cu Program Normal ""Ciupercuţa""",1,4741,"MUNICIPIUL REŞIŢA",50790,708,343,317,26,0,335,8,770,427,127,208
11,"CARAŞ-SEVERIN","#N/A",50790,,31,"REŞIŢA / Grădiniţa cu Program Normal ""Degeţica""",1,4741,"MUNICIPIUL REŞIŢA",50790,1201,598,559,39,0,586,12,1338,740,276,310
11,"CARAŞ-SEVERIN","#N/A",50790,,32,"REŞIŢA / Liceul Teoretic ""Traian Vuia""",1,4741,"MUNICIPIUL REŞIŢA",50790,1450,662,600,62,0,649,13,1588,926,266,383
11,"CARAŞ-SEVERIN","#N/A",50790,,33,"REŞIŢA / Liceul Teoretic ""Traian Vuia""",1,4741,"MUNICIPIUL REŞIŢA",50790,958,474,442,32,0,466,8,1053,579,176,290
11,"CARAŞ-SEVERIN","#N/A",50790,,34,"REŞIŢA / Liceul Teoretic ""Traian Vuia""",1,4741,"MUNICIPIUL REŞIŢA",50790,1540,677,655,22,0,666,11,1697,1020,288,378
11,"CARAŞ-SEVERIN","#N/A",50790,,35,"REŞIŢA / Liceul Teoretic ""Traian Vuia""",1,4741,"MUNICIPIUL REŞIŢA",50790,1136,592,575,16,1,586,6,1255,663,273,313
11,"CARAŞ-SEVERIN","#N/A",50790,,36,"REŞIŢA / Liceul Teoretic ""Traian Vuia""",1,4741,"MUNICIPIUL REŞIŢA",50790,1171,583,562,21,0,569,14,1283,700,231,338
11,"CARAŞ-SEVERIN","#N/A",50790,,37,"REŞIŢA / Liceul Teoretic ""Traian Vuia""",1,4741,"MUNICIPIUL REŞIŢA",50790,898,346,317,29,0,343,3,989,643,124,219
11,"CARAŞ-SEVERIN","#N/A",50790,,38,"REŞIŢA / Şcoala Gimnazială nr. 8",1,4741,"MUNICIPIUL REŞIŢA",50790,1335,686,637,49,0,676,10,1469,783,320,356
11,"CARAŞ-SEVERIN","#N/A",50790,,39,"REŞIŢA / Şcoala Gimnazială nr. 8",1,4741,"MUNICIPIUL REŞIŢA",50790,1508,780,754,26,0,759,21,1674,894,325,434
11,"CARAŞ-SEVERIN","#N/A",50790,,40,"REŞIŢA / Şcoala Gimnazială nr. 8",1,4741,"MUNICIPIUL REŞIŢA",50790,1163,592,565,26,1,582,10,1282,690,268,314
11,"CARAŞ-SEVERIN","#N/A",50790,,41,"REŞIŢA / Colegiul Naţional""Mircea Eliade""Reşiţa",1,4741,"MUNICIPIUL REŞIŢA",50790,1105,520,486,34,0,512,8,1224,704,226,286
11,"CARAŞ-SEVERIN","#N/A",50790,,42,"REŞIŢA / Colegiul Naţional""Mircea Eliade"",Reşiţa",1,4741,"MUNICIPIUL REŞIŢA",50790,1003,553,523,30,0,544,9,1106,553,245,299
11,"CARAŞ-SEVERIN","#N/A",50790,,43,"REŞIŢA / Colegiul Tehnic Cărăşan, Reşiţa",1,4741,"MUNICIPIUL REŞIŢA",50790,1221,665,636,29,0,657,8,1345,680,284,373
11,"CARAŞ-SEVERIN","#N/A",50790,,44,"REŞIŢA / Colegiul Tehnic Cărăşan, Reşiţa",1,4741,"MUNICIPIUL REŞIŢA",50790,991,501,479,22,0,497,4,1093,592,211,286
11,"CARAŞ-SEVERIN","#N/A",50790,,45,"REŞIŢA / Şcoala Gimnazială nr. 7,Corp B",1,4741,"MUNICIPIUL REŞIŢA",50790,1474,759,734,25,0,732,27,1626,867,327,405
11,"CARAŞ-SEVERIN","#N/A",50790,,46,"REŞIŢA / Şcoala Gimnazială nr. 7,Corp B",1,4741,"MUNICIPIUL REŞIŢA",50790,1234,665,635,30,0,656,9,1354,689,310,346
11,"CARAŞ-SEVERIN","#N/A",50790,,47,"REŞIŢA / Şcoala Gimnazială nr. 7,Corp B",1,4741,"MUNICIPIUL REŞIŢA",50790,1138,600,572,25,3,589,11,1258,658,302,287
11,"CARAŞ-SEVERIN","#N/A",50790,,48,"REŞIŢA / Şcoala Gimnazială nr. 7,Corp B",1,4741,"MUNICIPIUL REŞIŢA",50790,885,429,404,24,1,419,10,978,549,160,259
11,"CARAŞ-SEVERIN","#N/A",50790,,49,"REŞIŢA / Şcoala Gimnazială nr. 7,Corp A",1,4741,"MUNICIPIUL REŞIŢA",50790,1426,738,675,62,1,724,14,1568,830,335,389
11,"CARAŞ-SEVERIN","#N/A",50790,,50,"REŞIŢA / Şcoala Gimnazială nr. 7,Corp A",1,4741,"MUNICIPIUL REŞIŢA",50790,1221,561,518,42,1,545,16,1341,780,250,295
11,"CARAŞ-SEVERIN","#N/A",50790,,51,"REŞIŢA / Şcoala Gimnazială nr. 7,Corp A",1,4741,"MUNICIPIUL REŞIŢA",50790,1630,880,834,45,1,867,13,1798,918,402,465
11,"CARAŞ-SEVERIN","#N/A",50790,,52,"REŞIŢA / Şcoala Gimnazială nr. 7,Corp A",1,4741,"MUNICIPIUL REŞIŢA",50790,1077,511,483,28,0,504,7,1189,678,251,253
11,"CARAŞ-SEVERIN","#N/A",50790,,53,"REŞIŢA / Şcoala Gimnazială nr. 9",1,4741,"MUNICIPIUL REŞIŢA",50790,1134,517,498,19,0,505,12,1252,735,232,273
11,"CARAŞ-SEVERIN","#N/A",50790,,54,"REŞIŢA / Şcoala Gimnazială nr. 9",1,4741,"MUNICIPIUL REŞIŢA",50790,1526,822,769,52,1,807,14,1681,860,361,446
11,"CARAŞ-SEVERIN","#N/A",50790,,55,"REŞIŢA / Şcoala Gimnazială nr. 9",1,4741,"MUNICIPIUL REŞIŢA",50790,1238,662,614,48,0,649,13,1363,701,293,356
11,"CARAŞ-SEVERIN","#N/A",50790,,56,"REŞIŢA / Şcoala Gimnazială nr. 9",1,4741,"MUNICIPIUL REŞIŢA",50790,1542,750,726,23,1,729,21,1696,946,342,387
11,"CARAŞ-SEVERIN","#N/A",50790,,57,"REŞIŢA / Liceul de Arte ""Sabin Păuţa""",1,4741,"MUNICIPIUL REŞIŢA",50790,1041,586,478,48,60,579,7,1146,560,263,316
11,"CARAŞ-SEVERIN","#N/A",50790,,58,"REŞIŢA / Liceul de Arte ""Sabin Păuţa""",1,4741,"MUNICIPIUL REŞIŢA",50790,1320,746,649,33,64,739,7,1448,702,294,445
11,"CARAŞ-SEVERIN","#N/A",50790,,59,"REŞIŢA / Liceul de Arte ""Sabin Păuţa""",1,4741,"MUNICIPIUL REŞIŢA",50790,1423,776,745,31,0,768,8,1560,784,352,416
11,"CARAŞ-SEVERIN","#N/A",50790,,60,"REŞIŢA / Liceul de Arte ""Sabin Păuţa""",1,4741,"MUNICIPIUL REŞIŢA",50790,1190,615,593,22,0,610,5,1308,693,275,335
11,"CARAŞ-SEVERIN","#N/A",50790,,61,"REŞIŢA / Şcoala Gimnazială nr. 12",1,4741,"MUNICIPIUL REŞIŢA",50790,1233,649,626,21,2,630,19,1355,706,241,389
11,"CARAŞ-SEVERIN","#N/A",50790,,62,"REŞIŢA / Şcoala Gimnazială nr. 12",1,4741,"MUNICIPIUL REŞIŢA",50790,1441,738,664,74,0,727,11,1586,848,262,465
11,"CARAŞ-SEVERIN","#N/A",50790,,63,"REŞIŢA / Şcoala Gimnazială nr. 12",1,4741,"MUNICIPIUL REŞIŢA",50790,1278,558,532,26,0,545,13,1406,848,224,321
11,"CARAŞ-SEVERIN","#N/A",50790,,64,"REŞIŢA / Şcoala Gimnazială nr. 12",1,4741,"MUNICIPIUL REŞIŢA",50790,1054,520,500,20,0,512,8,1163,643,224,288
11,"CARAŞ-SEVERIN","#N/A",50790,,65,"CÎLNIC / Căminul  Cultural Cîlnic",1,4741,"MUNICIPIUL REŞIŢA",50790,1394,727,691,36,0,721,6,1533,806,332,389
11,"CARAŞ-SEVERIN","#N/A",50790,,66,"CUPTOARE / Căminul Cultural Cuptoare",1,4741,"MUNICIPIUL REŞIŢA",50790,296,174,156,18,0,173,1,325,151,92,81
11,"CARAŞ-SEVERIN","#N/A",50790,,67,"DOMAN / Grădiniţa cu Program Normal Doman",1,4741,"MUNICIPIUL REŞIŢA",50790,626,298,280,18,0,296,2,688,390,78,218
11,"CARAŞ-SEVERIN","#N/A",50790,,68,"SECU / Liceul Teoretic ""Diaconovici Tietz"" - Şcoala cu cls I-IV",1,4741,"MUNICIPIUL REŞIŢA",50790,445,193,170,23,0,191,2,490,297,66,125
11,"CARAŞ-SEVERIN","#N/A",50790,,69,"ŢEROVA / Cămin Cultural Ţerova",1,4741,"MUNICIPIUL REŞIŢA",50790,462,226,218,8,0,220,6,509,283,97,123
11,"CARAŞ-SEVERIN","#N/A",50790,,70,"MONIOM / Căminul Cultural Moniom",1,4741,"MUNICIPIUL REŞIŢA",50790,281,182,158,24,0,179,3,314,132,69,110
11,"CARAŞ-SEVERIN","#N/A",51010,,71,"CARANSEBEŞ / Şcoala Primară clasele I-IV",1,4749,"MUNICIPIUL CARANSEBEŞ",51010,1187,680,588,92,0,673,7,1311,631,280,393
11,"CARAŞ-SEVERIN","#N/A",51010,,72,"CARANSEBEŞ / Grădiniţa cu Program Normal nr. 3 Teiuş",1,4749,"MUNICIPIUL CARANSEBEŞ",51010,523,311,283,28,0,300,11,576,265,92,208
11,"CARAŞ-SEVERIN","#N/A",51010,,73,"CARANSEBEŞ / Muzeul de Etnogafie şi al Regimentului de Graniţă",1,4749,"MUNICIPIUL CARANSEBEŞ",51010,1461,901,812,88,1,883,18,1613,712,360,523
11,"CARAŞ-SEVERIN","#N/A",51010,,74,"CARANSEBEŞ / Şcoala Generală nr. 8",1,4749,"MUNICIPIUL CARANSEBEŞ",51010,1193,701,642,59,0,684,17,1318,617,297,387
11,"CARAŞ-SEVERIN","#N/A",51010,,75,"CARANSEBEŞ / Liceul Tehnologic ""Dacia""",1,4749,"MUNICIPIUL CARANSEBEŞ",51010,1452,843,762,81,0,834,9,1600,757,334,500
11,"CARAŞ-SEVERIN","#N/A",51010,,76,"CARANSEBEŞ / Casa Municipală de Cultură ""George Suru""",1,4749,"MUNICIPIUL CARANSEBEŞ",51010,1251,789,668,120,1,775,14,1376,587,326,449
11,"CARAŞ-SEVERIN","#N/A",51010,,77,"CARANSEBEŞ / Grădiniţa cu Program Normal nr. 1",1,4749,"MUNICIPIUL CARANSEBEŞ",51010,1648,983,827,55,101,969,14,1815,832,397,572
11,"CARAŞ-SEVERIN","#N/A",51010,,78,"CARANSEBEŞ / Şcoala Generală nr.  7",1,4749,"MUNICIPIUL CARANSEBEŞ",51010,1244,627,541,54,32,616,11,1372,745,234,382
11,"CARAŞ-SEVERIN","#N/A",51010,,79,"CARANSEBEŞ / Şcoala Generală nr.  7",1,4749,"MUNICIPIUL CARANSEBEŞ",51010,1217,627,578,49,0,616,11,1342,715,232,384
11,"CARAŞ-SEVERIN","#N/A",51010,,80,"CARANSEBEŞ / Clubul Sportiv Şcolar",1,4749,"MUNICIPIUL CARANSEBEŞ",51010,1287,614,566,45,3,605,9,1417,803,256,349
11,"CARAŞ-SEVERIN","#N/A",51010,,81,"CARANSEBEŞ / Grădiniţa nr. 4",1,4749,"MUNICIPIUL CARANSEBEŞ",51010,1298,591,553,38,0,582,9,1439,848,233,349
11,"CARAŞ-SEVERIN","#N/A",51010,,82,"CARANSEBEŞ / Şcoala Generală nr. 2",1,4749,"MUNICIPIUL CARANSEBEŞ",51010,1355,723,652,71,0,714,9,1493,770,250,464
11,"CARAŞ-SEVERIN","#N/A",51010,,83,"CARANSEBEŞ / Şcoala Generală nr. 2",1,4749,"MUNICIPIUL CARANSEBEŞ",51010,1207,586,560,26,0,578,8,1331,745,229,349
11,"CARAŞ-SEVERIN","#N/A",51010,,84,"CARANSEBEŞ / Liceul Tehnologic ""Decebal""",1,4749,"MUNICIPIUL CARANSEBEŞ",51010,1391,722,654,68,0,709,13,1539,817,306,403
11,"CARAŞ-SEVERIN","#N/A",51010,,85,"CARANSEBEŞ / Liceul Tehnologic ""Decebal""",1,4749,"MUNICIPIUL CARANSEBEŞ",51010,1398,632,593,39,0,622,10,1545,913,230,392
11,"CARAŞ-SEVERIN","#N/A",51010,,86,"CARANSEBEŞ / Liceul Tehnologic ""Decebal""",1,4749,"MUNICIPIUL CARANSEBEŞ",51010,1516,847,800,47,0,838,9,1665,818,299,539
11,"CARAŞ-SEVERIN","#N/A",51010,,87,"CARANSEBEŞ / Liceul Pedagogic ""C.D. Loga""",1,4749,"MUNICIPIUL CARANSEBEŞ",51010,1583,846,770,75,1,831,15,1745,899,324,507
11,"CARAŞ-SEVERIN","#N/A",51010,,88,"CARANSEBEŞ / Grădiniţa cu Program Normal nr.5",1,4749,"MUNICIPIUL CARANSEBEŞ",51010,1162,607,575,32,0,599,8,1278,671,244,355
11,"CARAŞ-SEVERIN","#N/A",51010,,89,"CARANSEBEŞ / Grădiniţa cu Program Prelungit nr. 3",1,4749,"MUNICIPIUL CARANSEBEŞ",51010,761,422,399,23,0,415,7,837,415,190,225
11,"CARAŞ-SEVERIN","#N/A",51010,,90,"CARANSEBEŞ / Şcoala Generală nr. 1",1,4749,"MUNICIPIUL CARANSEBEŞ",51010,1156,624,574,50,0,620,4,1265,641,277,343
11,"CARAŞ-SEVERIN","#N/A",51010,,91,"JUPA / Şcoala Primară",1,4749,"MUNICIPIUL CARANSEBEŞ",51010,498,336,283,53,0,333,3,546,210,122,211
11,"CARAŞ-SEVERIN","#N/A",50889,,92,"ANINA / CASA DE CULTURĂ ANINA",1,4752,"ORAŞ ANINA",50889,925,446,382,38,26,435,11,1016,570,208,227
11,"CARAŞ-SEVERIN","#N/A",50889,,93,"ANINA / CENTRUL DE AFACERI ANINA",1,4752,"ORAŞ ANINA",50889,932,466,438,25,3,454,12,1026,560,230,224
11,"CARAŞ-SEVERIN","#N/A",50889,,94,"ANINA / GRĂDINIŢA CELNIC",1,4752,"ORAŞ ANINA",50889,659,303,281,21,1,298,5,727,424,176,122
11,"CARAŞ-SEVERIN","#N/A",50889,,95,"ANINA / SEDIUL S.C. GOSTRANS S.A.",1,4752,"ORAŞ ANINA",50889,550,301,274,26,1,291,10,608,307,145,146
11,"CARAŞ-SEVERIN","#N/A",50889,,96,"ANINA / GRĂDINIŢA ORAŞUL NOU",1,4752,"ORAŞ ANINA",50889,671,277,262,15,0,273,4,740,463,117,156
11,"CARAŞ-SEVERIN","#N/A",50889,,97,"ANINA / CENTRUL DE ZI ANINA",1,4752,"ORAŞ ANINA",50889,697,333,306,25,2,329,4,770,437,163,166
11,"CARAŞ-SEVERIN","#N/A",50889,,98,"ANINA / SEDIUL DEPOZITUL FINAL CÂNTAR",1,4752,"ORAŞ ANINA",50889,651,322,302,16,4,319,3,716,394,128,191
11,"CARAŞ-SEVERIN","#N/A",50889,,99,"ANINA / GRĂDINIŢA SIGISMUND",1,4752,"ORAŞ ANINA",50889,572,236,217,19,0,231,5,632,396,103,128
11,"CARAŞ-SEVERIN","#N/A",50889,,100,"ANINA / ŞCOALA STEIERDORF",1,4752,"ORAŞ ANINA",50889,1150,527,484,34,9,519,8,1269,742,224,295
11,"CARAŞ-SEVERIN","#N/A",50889,,101,"ANINA / GRĂDINIŢA STEIERDORF",1,4752,"ORAŞ ANINA",50889,583,291,248,27,16,287,4,641,350,97,190
11,"CARAŞ-SEVERIN","#N/A",50889,,102,"ANINA / ŞCOALA GENERALĂ BRĂDET",1,4752,"ORAŞ ANINA",50889,296,153,138,15,0,150,3,326,173,101,49
11,"CARAŞ-SEVERIN","#N/A",50923,,103,"BĂILE HERCULANE / Protopopiat Ortodox Român",1,4755,"ORAŞ BĂILE HERCULANE",50923,350,226,169,56,1,219,7,385,159,111,108
11,"CARAŞ-SEVERIN","#N/A",50923,,104,"BĂILE HERCULANE / SCOALA GENERALA",1,4755,"ORAŞ BĂILE HERCULANE",50923,1533,1484,786,697,1,1462,22,1686,202,714,748
11,"CARAŞ-SEVERIN","#N/A",50923,,105,"BĂILE HERCULANE / Liceul Hercules",1,4755,"ORAŞ BĂILE HERCULANE",50923,994,613,501,112,0,600,13,1097,484,299,301
11,"CARAŞ-SEVERIN","#N/A",50923,,106,"BĂILE HERCULANE / Liceul Hercules",1,4755,"ORAŞ BĂILE HERCULANE",50923,1186,640,575,65,0,637,3,1309,669,292,345
11,"CARAŞ-SEVERIN","#N/A",50923,,107,"PECINIŞCA / Căminul Cultural",1,4755,"ORAŞ BĂILE HERCULANE",50923,532,354,325,29,0,352,2,584,230,167,185
11,"CARAŞ-SEVERIN","#N/A",50969,,108,"BOCŞA / Şcoala Generală nr. 1",1,4758,"ORAŞ BOCŞA",50969,1343,666,616,49,1,661,5,1477,811,274,387
11,"CARAŞ-SEVERIN","#N/A",50969,,109,"BOCŞA / Şcoala Generală nr. 1",1,4758,"ORAŞ BOCŞA",50969,1242,675,627,47,1,667,8,1366,691,299,368
11,"CARAŞ-SEVERIN","#N/A",50969,,110,"BOCŞA / Şcoala Generală nr. 1",1,4758,"ORAŞ BOCŞA",50969,1295,703,667,35,1,691,12,1423,720,303,388
11,"CARAŞ-SEVERIN","#N/A",50969,,111,"BOCŞA / Liceul Teoretic Tata Oancea",1,4758,"ORAŞ BOCŞA",50969,1264,664,606,46,12,657,7,1393,729,266,391
11,"CARAŞ-SEVERIN","#N/A",50969,,112,"BOCŞA / Liceul Teoretic Tata Oancea",1,4758,"ORAŞ BOCŞA",50969,1116,565,537,27,1,556,9,1233,668,266,290
11,"CARAŞ-SEVERIN","#N/A",50969,,113,"BOCŞA / Liceul Teoretic Tata Oancea",1,4758,"ORAŞ BOCŞA",50969,843,407,381,26,0,399,8,928,521,185,214
11,"CARAŞ-SEVERIN","#N/A",50969,,114,"BOCŞA / Grădiniţa de copii nr. 4",1,4758,"ORAŞ BOCŞA",50969,1486,834,788,43,3,827,7,1637,803,330,497
11,"CARAŞ-SEVERIN","#N/A",50969,,115,"BOCŞA / Şcoala Generală nr. 3Măgura",1,4758,"ORAŞ BOCŞA",50969,1182,658,650,8,0,649,9,1299,641,220,429
11,"CARAŞ-SEVERIN","#N/A",50969,,116,"BOCŞA / Liceul Tehnologic Bocsa",1,4758,"ORAŞ BOCŞA",50969,1611,847,795,52,0,836,11,1781,934,344,492
11,"CARAŞ-SEVERIN","#N/A",50969,,117,"BOCŞA / Grădiniţa nr. 6",1,4758,"ORAŞ BOCŞA",50969,1251,641,601,40,0,634,7,1371,730,316,318
11,"CARAŞ-SEVERIN","#N/A",50969,,118,"BOCŞA / Serviciu Public de Gospodărie Comunală",1,4758,"ORAŞ BOCŞA",50969,1261,586,561,24,1,578,8,1394,808,252,326
11,"CARAŞ-SEVERIN","#N/A",50969,,119,"BOCŞA / Clubul Elevilor",1,4758,"ORAŞ BOCŞA",50969,1398,718,674,32,12,711,7,1543,825,343,368
11,"CARAŞ-SEVERIN","#N/A",51056,,120,"MOLDOVA NOUĂ / Şcoala Generală nr.1",1,4760,"ORAŞ MOLDOVA NOUĂ",51056,1318,765,709,54,2,755,10,1456,691,416,339
11,"CARAŞ-SEVERIN","#N/A",51056,,121,"MOLDOVA NOUĂ / Casa de Cultură",1,4760,"ORAŞ MOLDOVA NOUĂ",51056,945,535,499,31,5,526,9,1042,507,314,212
11,"CARAŞ-SEVERIN","#N/A",51056,,122,"MOLDOVA NOUĂ / Grădiniţa nr. 2",1,4760,"ORAŞ MOLDOVA NOUĂ",51056,525,352,332,20,0,348,4,581,229,187,161
11,"CARAŞ-SEVERIN","#N/A",51056,,123,"MOLDOVA NOUĂ / Şcoala Generală nr.3",1,4760,"ORAŞ MOLDOVA NOUĂ",51056,1248,625,579,44,2,614,11,1421,796,367,247
11,"CARAŞ-SEVERIN","#N/A",51056,,124,"MOLDOVA NOUĂ / Grădiniţa PP nr.2",1,4760,"ORAŞ MOLDOVA NOUĂ",51056,1171,525,495,30,0,514,11,1239,714,313,201
11,"CARAŞ-SEVERIN","#N/A",51056,,125,"MOLDOVA NOUĂ / S.C. Moldomin S.A. - S.C. Dunărea S.A.",1,4760,"ORAŞ MOLDOVA NOUĂ",51056,1414,643,590,52,1,634,9,1558,915,365,269
11,"CARAŞ-SEVERIN","#N/A",51056,,126,"MOLDOVA NOUĂ / Şcoala Generală nr.4",1,4760,"ORAŞ MOLDOVA NOUĂ",51056,1062,501,472,29,0,495,6,1173,672,284,211
11,"CARAŞ-SEVERIN","#N/A",51056,,127,"MOLDOVA NOUĂ / Grădiniţa PP nr.1 (Clubul Copiilor şi Elevilor)",1,4760,"ORAŞ MOLDOVA NOUĂ",51056,1028,488,427,47,14,483,5,1130,642,290,193
11,"CARAŞ-SEVERIN","#N/A",51056,,128,"MOLDOVA NOUĂ / Liceul",1,4760,"ORAŞ MOLDOVA NOUĂ",51056,862,406,355,51,0,404,2,950,544,233,171
11,"CARAŞ-SEVERIN","#N/A",51056,,129,"MĂCEŞTI / Şcoala Generală",1,4760,"ORAŞ MOLDOVA NOUĂ",51056,468,322,283,39,0,319,3,514,191,184,135
11,"CARAŞ-SEVERIN","#N/A",51056,,130,"MOLDOVA VECHE / Cămin Cultural",1,4760,"ORAŞ MOLDOVA NOUĂ",51056,1301,728,670,58,0,717,11,1436,708,392,325
11,"CARAŞ-SEVERIN","#N/A",51056,,131,"MOLDOVIŢA / Cămin Cultural",1,4760,"ORAŞ MOLDOVA NOUĂ",51056,191,152,134,18,0,152,0,212,60,113,39
11,"CARAŞ-SEVERIN","#N/A",51118,,132,"AGADICI / Şcoala Generală",1,4765,"ORAŞ ORAVIŢA",51118,168,122,94,28,0,119,3,186,64,56,63
11,"CARAŞ-SEVERIN","#N/A",51118,,133,"BRĂDIŞORU DE JOS / Şcoala Generală",1,4765,"ORAŞ ORAVIŢA",51118,474,216,195,20,1,211,5,524,308,112,99
11,"CARAŞ-SEVERIN","#N/A",51118,,134,"RĂCHITOVA / Şcoala Generală",1,4765,"ORAŞ ORAVIŢA",51118,293,153,139,14,0,150,3,322,169,80,70
11,"CARAŞ-SEVERIN","#N/A",51118,,135,"CICLOVA MONTANĂ / Cămin Cultural",1,4765,"ORAŞ ORAVIŢA",51118,463,270,228,40,2,266,4,513,243,139,127
11,"CARAŞ-SEVERIN","#N/A",51118,,136,"BROŞTENI / Cămin Cultural",1,4765,"ORAŞ ORAVIŢA",51118,538,309,293,16,0,303,6,592,283,181,122
11,"CARAŞ-SEVERIN","#N/A",51118,,137,"ORAVIŢA / Şcoala Generală nr. 3",1,4765,"ORAŞ ORAVIŢA",51118,1096,520,496,23,1,512,8,1106,586,255,257
11,"CARAŞ-SEVERIN","#N/A",51118,,138,"ORAVIŢA / Liceul Teoretic ""General Dragalina""",1,4765,"ORAŞ ORAVIŢA",51118,889,499,446,45,8,493,6,980,481,226,267
11,"CARAŞ-SEVERIN","#N/A",51118,,139,"ORAVIŢA / Grădiniţa PN nr. 2",1,4765,"ORAŞ ORAVIŢA",51118,943,537,515,22,0,531,6,1042,505,277,254
11,"CARAŞ-SEVERIN","#N/A",51118,,140,"ORAVIŢA / Grupul Şcolar Agricol",1,4765,"ORAŞ ORAVIŢA",51118,1164,670,552,67,51,661,9,1285,615,349,312
11,"CARAŞ-SEVERIN","#N/A",51118,,141,"ORAVIŢA / Şcoala Generală nr. 1",1,4765,"ORAŞ ORAVIŢA",51118,1307,656,599,57,0,644,12,1442,786,333,311
11,"CARAŞ-SEVERIN","#N/A",51118,,142,"ORAVIŢA / Şcoala Generală nr. 1",1,4765,"ORAŞ ORAVIŢA",51118,1623,718,688,30,0,708,10,1792,1074,385,323
11,"CARAŞ-SEVERIN","#N/A",51118,,143,"ORAVIŢA / Şcoala Generală nr. 1",1,4765,"ORAŞ ORAVIŢA",51118,1124,508,461,47,0,499,9,1236,728,248,251
11,"CARAŞ-SEVERIN","#N/A",51118,,144,"ORAVIŢA / Creşa cămin",1,4765,"ORAŞ ORAVIŢA",51118,1202,593,520,71,2,586,7,1319,726,337,249
11,"CARAŞ-SEVERIN","#N/A",51118,,145,"MARILA / Centrul Administrativ",1,4765,"ORAŞ ORAVIŢA",51118,35,77,17,56,4,77,0,139,62,38,39
11,"CARAŞ-SEVERIN","#N/A",51207,,146,"OŢELU ROŞU / Casa de Cultură",1,4773,"ORAŞ OŢELU ROŞU",51207,962,545,474,69,2,537,8,1058,513,260,277
11,"CARAŞ-SEVERIN","#N/A",51207,,147,"OŢELU ROŞU / Casa de Cultură",1,4773,"ORAŞ OŢELU ROŞU",51207,780,407,376,31,0,397,10,860,453,193,204
11,"CARAŞ-SEVERIN","#N/A",51207,,148,"OŢELU ROŞU / Scoala generala nr. 3",1,4773,"ORAŞ OŢELU ROŞU",51207,1437,735,704,28,3,721,14,1590,855,354,367
11,"CARAŞ-SEVERIN","#N/A",51207,,149,"OŢELU ROŞU / Grădiniţa cu Program Prelungit nr. 3",1,4773,"ORAŞ OŢELU ROŞU",51207,1171,633,607,26,0,625,8,1290,657,308,317
11,"CARAŞ-SEVERIN","#N/A",51207,,150,"OŢELU ROŞU / Cantina de Ajutor Social",1,4773,"ORAŞ OŢELU ROŞU",51207,859,476,419,39,18,469,7,942,466,194,275
11,"CARAŞ-SEVERIN","#N/A",51207,,151,"OŢELU ROŞU / GRĂDINIŢA CU PROGRAM NORMAL NR.2",1,4773,"ORAŞ OŢELU ROŞU",51207,1154,655,628,27,0,640,15,1271,616,288,352
11,"CARAŞ-SEVERIN","#N/A",51207,,152,"OŢELU ROŞU / Grădiniţa cu Program Normal Gai",1,4773,"ORAŞ OŢELU ROŞU",51207,1112,637,608,25,4,624,13,1223,586,300,324
11,"CARAŞ-SEVERIN","#N/A",51207,,153,"OŢELU ROŞU / Grădiniţa cu Program Normal Valea Ohăbii",1,4773,"ORAŞ OŢELU ROŞU",51207,540,308,281,26,1,306,2,596,288,161,145
11,"CARAŞ-SEVERIN","#N/A",51207,,154,"OŢELU ROŞU / S.C. ""Romflex"" S.A.",1,4773,"ORAŞ OŢELU ROŞU",51207,336,208,183,25,0,201,7,370,162,78,123
11,"CARAŞ-SEVERIN","#N/A",51207,,155,"OŢELU ROŞU / S.C. ""Romflex"" S.A.",1,4773,"ORAŞ OŢELU ROŞU",51207,1276,664,626,38,0,654,10,1400,736,313,341
11,"CARAŞ-SEVERIN","#N/A",51207,,156,"OŢELU ROŞU / Căminul Cultural Cireşa",1,4773,"ORAŞ OŢELU ROŞU",51207,646,412,388,23,1,405,7,711,299,197,208
11,"CARAŞ-SEVERIN","#N/A",51207,,157,"MAL / Căminul Cultural Mal",1,4773,"ORAŞ OŢELU ROŞU",51207,308,243,223,17,3,241,2,337,94,145,96
11,"CARAŞ-SEVERIN","#N/A",51243,,158,"SUB MARGINE / Căminul Cultural",3,4777,"ARMENIŞ",51243,157,139,124,9,6,139,0,174,35,85,54
11,"CARAŞ-SEVERIN","#N/A",51243,,159,"ARMENIŞ / Şcoala Gimnazială",3,4777,"ARMENIŞ",51243,1131,860,780,63,17,853,7,1246,386,449,404
11,"CARAŞ-SEVERIN","#N/A",51243,,160,"FENEŞ / SCOALA PRIMARA FENES",3,4777,"ARMENIŞ",51243,479,382,327,49,6,375,7,527,145,204,171
11,"CARAŞ-SEVERIN","#N/A",51243,,161,"SAT BĂTRÎN / Şcoala Primară",3,4777,"ARMENIŞ",51243,323,254,234,14,6,250,4,356,102,124,126
11,"CARAŞ-SEVERIN","#N/A",51305,,162,"BĂNIA / Căminul Cultural",3,4783,"BĂNIA",51305,989,612,572,31,9,602,10,1079,467,235,367
11,"CARAŞ-SEVERIN","#N/A",51305,,163,"GÎRBOVĂŢ / fosta primarie",3,4783,"BĂNIA",51305,498,294,252,42,0,293,1,550,256,166,127
11,"CARAŞ-SEVERIN","#N/A",51332,,164,"BĂUŢAR / Casa Culturală Băuţarul de Jos",3,4786,"BĂUŢAR",51332,688,468,418,38,12,460,8,758,290,240,220
11,"CARAŞ-SEVERIN","#N/A",51332,,165,"BĂUŢAR / Casa Culturală Băuţarul de Sus",3,4786,"BĂUŢAR",51332,707,490,457,26,7,485,5,777,287,237,248
11,"CARAŞ-SEVERIN","#N/A",51332,,166,"BUCOVA / Casa Culturală",3,4786,"BĂUŢAR",51332,767,529,476,49,4,523,6,843,314,291,232
11,"CARAŞ-SEVERIN","#N/A",51387,,167,"BERLIŞTE / Şcoala Gimnazială Berlişte",3,4791,"BERLIŞTE",51387,299,197,163,31,3,193,4,330,133,113,80
11,"CARAŞ-SEVERIN","#N/A",51387,,168,"IAM / Şcoala Primară Iam",3,4791,"BERLIŞTE",51387,311,193,157,33,3,191,2,344,151,119,72
11,"CARAŞ-SEVERIN","#N/A",51387,,169,"MILCOVENI / Şcoala Primară Milcoveni",3,4791,"BERLIŞTE",51387,211,151,120,30,1,147,4,234,83,81,66
11,"CARAŞ-SEVERIN","#N/A",51387,,170,"RUSOVA NOUĂ / Şcoala Primară Rusova-Nouă",3,4791,"BERLIŞTE",51387,152,130,84,46,0,128,2,166,36,53,75
11,"CARAŞ-SEVERIN","#N/A",51449,,171,"BERZASCA / Casa Culturală-Berzasca",3,4797,"BERZASCA",51449,1209,655,553,101,1,650,5,1327,672,381,269
11,"CARAŞ-SEVERIN","#N/A",51449,,172,"BIGĂR / Şcoala Gimnazială-Bigar",3,4797,"BERZASCA",51449,186,82,67,15,0,82,0,206,124,59,23
11,"CARAŞ-SEVERIN","#N/A",51449,,173,"LIUBCOVA / GRADINITA LIUBCOVA",3,4797,"BERZASCA",51449,937,530,448,82,0,524,6,1031,501,258,266
11,"CARAŞ-SEVERIN","#N/A",51500,,174,"BERZOVIA / Liceul Tehnologic Berzovia",3,4803,"BERZOVIA",51500,885,432,388,44,0,425,7,975,543,187,238
11,"CARAŞ-SEVERIN","#N/A",51500,,175,"BERZOVIA / Liceul Tehnologic Berzovia",3,4803,"BERZOVIA",51500,880,372,320,52,0,362,10,966,594,177,185
11,"CARAŞ-SEVERIN","#N/A",51500,,176,"FIZEŞ / Şcoala Gimnaziala Fizes",3,4803,"BERZOVIA",51500,649,314,270,44,0,313,1,719,405,112,201
11,"CARAŞ-SEVERIN","#N/A",51500,,177,"GHERTENIŞ / Şcoala Primara Ghertenis",3,4803,"BERZOVIA",51500,794,403,337,65,1,400,3,877,474,165,235
11,"CARAŞ-SEVERIN","#N/A",51546,,178,"BOLVAŞNIŢA / Clubul Tineretului",3,4807,"BOLVAŞNIŢA",51546,395,287,257,21,9,284,3,442,155,93,191
11,"CARAŞ-SEVERIN","#N/A",51546,,179,"VÎRCIOROVA / Clubul Tineretului",3,4807,"BOLVAŞNIŢA",51546,788,532,486,43,3,526,6,871,339,216,310
11,"CARAŞ-SEVERIN","#N/A",51573,,180,"BOZOVICI / Scoala clasele I-IV",3,4810,"BOZOVICI",51573,1252,839,713,93,33,827,12,1382,543,531,296
11,"CARAŞ-SEVERIN","#N/A",51573,,181,"BOZOVICI / liceul teoretic Bozovici",3,4810,"BOZOVICI",51573,702,526,374,132,20,521,5,772,246,322,199
11,"CARAŞ-SEVERIN","#N/A",51573,,182,"PRILIPEŢ / Şcoala cu clasele I - VIII",3,4810,"BOZOVICI",51573,631,489,392,75,22,482,7,697,208,251,231
11,"CARAŞ-SEVERIN","#N/A",51626,,183,"APADIA / Căminul Cultural",3,4815,"BREBU",51626,208,160,114,46,0,160,0,230,70,54,106
11,"CARAŞ-SEVERIN","#N/A",51626,,184,"BREBU / Şcoala Generală cu clasele I - VIII ""Sf. Iacob""",3,4815,"BREBU",51626,588,399,303,96,0,394,5,653,254,196,198
11,"CARAŞ-SEVERIN","#N/A",51626,,185,"VALEADENI / Şcoala cu clasele I - IV",3,4815,"BREBU",51626,202,160,96,64,0,160,0,222,62,92,68
11,"CARAŞ-SEVERIN","#N/A",51662,,186,"GĂRÎNA / Căminul Cultural",3,4819,"BREBU NOU",51662,278,139,53,86,0,137,2,308,169,34,103
11,"CARAŞ-SEVERIN","#N/A",51699,,187,"POIANA / Şcoala cu clasele I - VIII",3,4822,"BUCHIN",51699,524,414,361,33,20,408,6,582,168,287,121
11,"CARAŞ-SEVERIN","#N/A",51699,,188,"BUCHIN / Şcoala cu clasele I - IV",3,4822,"BUCHIN",51699,732,418,356,58,4,416,2,807,389,176,240
11,"CARAŞ-SEVERIN","#N/A",51699,,189,"VALEA TIMIŞULUI / Grădiniţa",3,4822,"BUCHIN",51699,447,305,265,37,3,304,1,495,190,124,180
11,"CARAŞ-SEVERIN","#N/A",51751,,190,"BUCOŞNIŢA / Căminul Cultural",3,4828,"BUCOŞNIŢA",51751,603,450,411,39,0,448,2,664,214,394,54
11,"CARAŞ-SEVERIN","#N/A",51751,,191,"PETROŞNIŢA / Şcoala cu clasele I - VIII",3,4828,"BUCOŞNIŢA",51751,772,500,456,40,4,498,2,850,350,303,195
11,"CARAŞ-SEVERIN","#N/A",51751,,192,"GOLEŢ / Şcoala cu clasele I - IV",3,4828,"BUCOŞNIŢA",51751,450,356,341,15,0,344,12,498,142,270,74
11,"CARAŞ-SEVERIN","#N/A",51751,,193,"VĂLIŞOARA / Şcoala cu clasele I - IV",3,4828,"BUCOŞNIŢA",51751,554,354,331,23,0,350,4,606,252,156,194
11,"CARAŞ-SEVERIN","#N/A",51804,,194,"CARAŞOVA / Căminul Cultural",3,4833,"CARAŞOVA",51804,901,405,374,29,2,398,7,993,588,124,274
11,"CARAŞ-SEVERIN","#N/A",51804,,195,"IABALCEA / Şcoala cu clasele I - IV",3,4833,"CARAŞOVA",51804,165,126,99,27,0,125,1,182,56,65,60
11,"CARAŞ-SEVERIN","#N/A",51804,,196,"NERMED / Şcoala cu clasele I - IV",3,4833,"CARAŞOVA",51804,446,231,213,18,0,228,3,494,263,39,189
11,"CARAŞ-SEVERIN","#N/A",51804,,197,"CARAŞOVA / Şcoala cu clasele I - IV nr. 1",3,4833,"CARAŞOVA",51804,1040,375,351,24,0,367,8,1143,768,111,256
11,"CARAŞ-SEVERIN","#N/A",51840,,198,"CĂRBUNARI / Şcoala Gimnazială",3,4837,"CĂRBUNARI",51840,576,388,317,48,23,386,2,637,249,293,93
11,"CARAŞ-SEVERIN","#N/A",51840,,199,"ŞTINĂPARI / Şcoala Primară",3,4837,"CĂRBUNARI",51840,292,226,171,49,6,224,2,323,97,180,44
11,"CARAŞ-SEVERIN","#N/A",51948,,200,"CICLOVA ROMÂNĂ / Şcoala cu clasele I - VIII",3,4840,"CICLOVA ROMÂNĂ",51948,944,518,450,53,15,512,6,1041,523,312,200
11,"CARAŞ-SEVERIN","#N/A",51948,,201,"ILIDIA / Şcoala cu clasele I - IV",3,4840,"CICLOVA ROMÂNĂ",51948,297,198,138,56,4,193,5,327,129,109,84
11,"CARAŞ-SEVERIN","#N/A",51948,,202,"SOCOLARI / Sediul fostei Primării  din Socolari",3,4840,"CICLOVA ROMÂNĂ",51948,123,109,68,41,0,108,1,136,27,52,56
11,"CARAŞ-SEVERIN","#N/A",51984,,203,"CIUCHICI / Casa de Cultură",3,4844,"CIUCHICI",51984,422,278,223,55,0,272,6,446,168,143,129
11,"CARAŞ-SEVERIN","#N/A",51984,,204,"MACOVIŞTE / Casa de Cultură",3,4844,"CIUCHICI",51984,88,103,64,37,2,100,3,118,15,56,44
11,"CARAŞ-SEVERIN","#N/A",51984,,205,"PETRILOVA / Casa de Cultură",3,4844,"CIUCHICI",51984,120,111,75,28,8,108,3,132,21,73,35
11,"CARAŞ-SEVERIN","#N/A",51984,,206,"NICOLINŢ / Sediul fostei Primării Nicolinţ",3,4844,"CIUCHICI",51984,247,154,133,21,0,148,6,275,121,86,62
11,"CARAŞ-SEVERIN","#N/A",52035,,207,"JITIN / Căminul Cultural",3,4849,"CIUDANOVIŢA",52035,110,104,74,30,0,102,2,122,18,50,52
11,"CARAŞ-SEVERIN","#N/A",52035,,208,"CIUDANOVIŢA / Şcoala Gimnazială",3,4849,"CIUDANOVIŢA",52035,443,237,219,18,0,234,3,491,254,165,69
11,"CARAŞ-SEVERIN","#N/A",51877,,209,"MACIOVA / Şcoala cu clasele I - VIII",3,4852,"CONSTANTIN DAICOVICIU",51877,375,235,204,26,5,233,2,411,176,91,142
11,"CARAŞ-SEVERIN","#N/A",51877,,210,"ZĂGUJENI / Şcoala cu clasele I - VIII",3,4852,"CONSTANTIN DAICOVICIU",51877,449,322,267,47,8,319,3,495,173,117,202
11,"CARAŞ-SEVERIN","#N/A",51877,,211,"MÎTNICU MARE / Şcoala cu clasele I - IV",3,4852,"CONSTANTIN DAICOVICIU",51877,308,269,213,49,7,262,7,339,70,108,154
11,"CARAŞ-SEVERIN","#N/A",51877,,212,"PEŞTERE / Şcoala cu clasele I - IV",3,4852,"CONSTANTIN DAICOVICIU",51877,192,133,108,22,3,131,2,212,79,41,90
11,"CARAŞ-SEVERIN","#N/A",51877,,213,"PRISACA / Şcoala cu clasele I - IV",3,4852,"CONSTANTIN DAICOVICIU",51877,366,261,212,36,13,260,1,404,143,62,198
11,"CARAŞ-SEVERIN","#N/A",51877,,214,"CĂVĂRAN / Grădiniţa din cadrul Şcolii cu clasele I - VIII",3,4852,"CONSTANTIN DAICOVICIU",51877,594,427,355,54,18,420,7,650,223,184,236
11,"CARAŞ-SEVERIN","#N/A",52062,,215,"COPĂCELE / Şcoala cu clasele I - VIII",3,4859,"COPĂCELE",52062,320,214,160,54,0,213,1,352,138,120,93
11,"CARAŞ-SEVERIN","#N/A",52062,,216,"OHABA-MÎTNIC / Şcoala cu clasele I - IV",3,4859,"COPĂCELE",52062,221,150,122,28,0,147,3,244,94,74,73
11,"CARAŞ-SEVERIN","#N/A",52062,,217,"RUGINOSU / Şcoala cu clasele I - IV",3,4859,"COPĂCELE",52062,92,73,56,17,0,73,0,103,30,26,47
11,"CARAŞ-SEVERIN","#N/A",52062,,218,"ZORILE / Şcoala cu clasele I - IV",3,4859,"COPĂCELE",52062,355,215,170,43,2,215,0,393,178,123,92
11,"CARAŞ-SEVERIN","#N/A",52115,,219,"CORNEA / Şcoala cu clasele I - VIII CORNEA",3,4864,"CORNEA",52115,649,391,355,36,0,388,3,715,324,151,237
11,"CARAŞ-SEVERIN","#N/A",52115,,220,"CRUŞOVĂŢ / Şcoala cu clasele I - IV CRUSOVAT",3,4864,"CORNEA",52115,399,288,251,37,0,285,3,440,152,120,165
11,"CARAŞ-SEVERIN","#N/A",52115,,221,"CUPTOARE / Şcoala cu clasele I - VIII CUPTOARE",3,4864,"CORNEA",52115,529,360,323,37,0,358,2,580,220,163,195
11,"CARAŞ-SEVERIN","#N/A",52160,,222,"CORNEREVA / Centru de zi After School Cornereva",3,4869,"CORNEREVA",52160,578,348,298,26,24,345,3,641,293,179,166
11,"CARAŞ-SEVERIN","#N/A",52160,,223,"BOGÎLTIN / Şcoala Bogîltin",3,4869,"CORNEREVA",52160,363,232,191,36,5,229,3,400,168,119,110
11,"CARAŞ-SEVERIN","#N/A",52160,,224,"DOBRAIA / Şcoala Dobraia",3,4869,"CORNEREVA",52160,65,43,34,9,0,43,0,70,27,26,17
11,"CARAŞ-SEVERIN","#N/A",52160,,225,"DOLINA / Şcoala Dolina",3,4869,"CORNEREVA",52160,631,469,445,21,3,464,5,692,223,307,157
11,"CARAŞ-SEVERIN","#N/A",52160,,226,"GRUNI / Şcoala Gruni",3,4869,"CORNEREVA",52160,717,494,463,31,0,491,3,791,297,226,265
11,"CARAŞ-SEVERIN","#N/A",52160,,227,"INELEŢ / Şcoala Ineleţ",3,4869,"CORNEREVA",52160,77,62,45,17,0,62,0,85,23,40,22
11,"CARAŞ-SEVERIN","#N/A",53489,,228,"SFÎNTA ELENA / Căminul Cultural",3,4910,"CORONINI",53489,445,220,196,24,0,219,1,491,271,128,91
11,"CARAŞ-SEVERIN","#N/A",53489,,229,"CORONINI / Şcoala cu clasele I - VIII",3,4910,"CORONINI",53489,1137,846,785,52,9,840,6,1249,403,553,287
11,"CARAŞ-SEVERIN","#N/A",52570,,230,"DALBOŞEŢ / Căminul Cultural-DALBOSET",3,4913,"DALBOŞEŢ",52570,892,603,555,38,10,600,3,983,380,308,292
11,"CARAŞ-SEVERIN","#N/A",52570,,231,"ŞOPOTU VECHI / Căminul Cultural-SOPOTU VECHI",3,4913,"DALBOŞEŢ",52570,544,402,353,46,3,399,3,594,192,251,148
11,"CARAŞ-SEVERIN","#N/A",52650,,232,"DOCLIN / Şcoala Primară Doclin",3,4921,"DOCLIN",52650,446,286,240,46,0,286,0,494,208,136,150
11,"CARAŞ-SEVERIN","#N/A",52650,,233,"BINIŞ / Şcoala Primară Biniş",3,4921,"DOCLIN",52650,661,368,326,42,0,367,1,727,359,174,193
11,"CARAŞ-SEVERIN","#N/A",52650,,234,"TIROL / Şcoala Gimnazială Tirol",3,4921,"DOCLIN",52650,533,238,213,25,0,235,3,587,349,102,133
11,"CARAŞ-SEVERIN","#N/A",52696,,235,"CALINA / Căminul Cultural",3,4925,"DOGNECEA",52696,89,82,53,29,0,81,1,98,16,35,46
11,"CARAŞ-SEVERIN","#N/A",52696,,236,"DOGNECEA / SCOALA GIMNAZIALA DOGNECEA",3,4925,"DOGNECEA",52696,970,622,549,66,7,616,6,1070,448,236,380
11,"CARAŞ-SEVERIN","#N/A",52696,,237,"DOGNECEA / SCOALA GIMNAZIALA",3,4925,"DOGNECEA",52696,553,394,362,32,0,392,2,606,212,79,313
11,"CARAŞ-SEVERIN","#N/A",52721,,238,"DOMAŞNEA / Căminul Cultural",3,4928,"DOMAŞNEA",52721,842,564,476,71,17,559,5,928,364,341,218
11,"CARAŞ-SEVERIN","#N/A",52721,,239,"CĂNICEA / Căminul Cultural",3,4928,"DOMAŞNEA",52721,305,209,190,16,3,207,2,334,125,118,89
11,"CARAŞ-SEVERIN","#N/A",53700,,240,"EFTIMIE MURGU / Căminul Cultural",3,4931,"EFTIMIE MURGU",53700,1392,1009,955,41,13,996,13,1532,523,481,515
11,"CARAŞ-SEVERIN","#N/A",52758,,241,"EZERIŞ / CASA DE CULTURA EZERIS",3,4933,"EZERIŞ",52758,541,383,285,80,18,382,1,601,218,146,236
11,"CARAŞ-SEVERIN","#N/A",52758,,242,"SOCENI / CASA DE CULTURA SOCENI",3,4933,"EZERIŞ",52758,545,477,373,85,19,474,3,602,125,151,323
11,"CARAŞ-SEVERIN","#N/A",52785,,243,"FÎRLIUG / Şcoala Gimnazială Fîrliug",3,4936,"FÎRLIUG",52785,671,531,400,92,39,526,5,657,126,141,385
11,"CARAŞ-SEVERIN","#N/A",52785,,244,"DEZEŞTI / Şcoala cu clasele I - IV",3,4936,"FÎRLIUG",52785,165,211,113,82,16,211,0,262,51,49,162
11,"CARAŞ-SEVERIN","#N/A",52785,,245,"DULEU / Căminul Cultural",3,4936,"FÎRLIUG",52785,156,166,103,57,6,163,3,172,6,81,82
11,"CARAŞ-SEVERIN","#N/A",52785,,246,"REMETEA-POGĂNICI / Şcoala cu clasele I - IV",3,4936,"FÎRLIUG",52785,163,166,101,52,13,166,0,181,15,45,121
11,"CARAŞ-SEVERIN","#N/A",52785,,247,"SCĂIUŞ / Căminul Cultural",3,4936,"FÎRLIUG",52785,257,229,155,59,15,228,1,285,56,66,162
11,"CARAŞ-SEVERIN","#N/A",52785,,248,"VALEA MARE / Căminul Cultural",3,4936,"FÎRLIUG",52785,96,105,64,38,3,105,0,107,2,24,81
11,"CARAŞ-SEVERIN","#N/A",52856,,249,"COMORÎŞTE / Şcoala cu clasele I - IV",3,4943,"FOROTIC",52856,491,276,243,33,0,269,7,541,265,125,144
11,"CARAŞ-SEVERIN","#N/A",52856,,250,"SURDUCU MARE / Şcoala cu clasele I - IV",3,4943,"FOROTIC",52856,382,245,199,43,3,241,4,422,177,122,119
11,"CARAŞ-SEVERIN","#N/A",52856,,251,"FOROTIC / Şcoala Gimnazială ""Petru Oallde""",3,4943,"FOROTIC",52856,579,309,268,34,7,307,2,641,332,122,185
11,"CARAŞ-SEVERIN","#N/A",52909,,252,"GÎRNIC / Casa Culturală ""Petr Glaser""",3,4948,"GÎRNIC",52909,410,186,163,11,12,183,3,457,271,88,95
11,"CARAŞ-SEVERIN","#N/A",52909,,253,"PADINA MATEI / Casa Culturala Padina-Matei",3,4948,"GÎRNIC",52909,765,614,543,49,22,614,0,840,226,553,61
11,"CARAŞ-SEVERIN","#N/A",52936,,254,"GLIMBOCA / Căminul Cultural",3,4951,"GLIMBOCA",52936,1522,1154,1032,77,45,1119,35,1676,522,319,800
11,"CARAŞ-SEVERIN","#N/A",52954,,255,"GORUIA / Căminul Cultural",3,4953,"GORUIA",52954,310,258,203,47,8,257,1,341,83,120,137
11,"CARAŞ-SEVERIN","#N/A",52954,,256,"GIURGIOVA / Şcoala cu clasele I - IV",3,4953,"GORUIA",52954,137,80,63,17,0,79,1,151,71,60,19
11,"CARAŞ-SEVERIN","#N/A",52954,,257,"GÎRLIŞTE / Dispensarul medical",3,4953,"GORUIA",52954,242,230,144,83,3,228,2,265,35,107,121
11,"CARAŞ-SEVERIN","#N/A",52990,,258,"GRĂDINARI / Şcoala Gimnaziala Pavel Bordan",3,4957,"GRĂDINARI",52990,872,515,421,84,10,500,15,957,442,264,236
11,"CARAŞ-SEVERIN","#N/A",52990,,259,"GREONI / Cladire Primarie Greoni",3,4957,"GRĂDINARI",52990,802,447,402,42,3,445,2,882,435,190,255
11,"CARAŞ-SEVERIN","#N/A",53023,,260,"IABLANIŢA / Căminul Cultural",3,4960,"IABLANIŢA",53023,662,470,398,68,4,468,2,733,263,352,116
11,"CARAŞ-SEVERIN","#N/A",53023,,261,"GLOBU CRAIOVEI / Şcoala Primară",3,4960,"IABLANIŢA",53023,583,384,337,46,1,384,0,638,254,237,147
11,"CARAŞ-SEVERIN","#N/A",53023,,262,"PETNIC / Şcoala Primară",3,4960,"IABLANIŢA",53023,660,390,356,34,0,389,1,728,338,195,194
11,"CARAŞ-SEVERIN","#N/A",53069,,263,"LĂPUŞNICEL / Căminul Cultural",3,4964,"LĂPUŞNICEL",53069,435,295,269,26,0,292,3,480,185,201,91
11,"CARAŞ-SEVERIN","#N/A",53069,,264,"PÎRVOVA / Şcoala Generală",3,4964,"LĂPUŞNICEL",53069,380,333,265,68,0,331,2,418,85,280,51
11,"CARAŞ-SEVERIN","#N/A",53069,,265,"ŞUMIŢA / Şcoala Generală",3,4964,"LĂPUŞNICEL",53069,81,85,71,14,0,84,1,90,5,65,19
11,"CARAŞ-SEVERIN","#N/A",53103,,266,"LĂPUŞNICU MARE / Căminul Cultural",3,4968,"LĂPUŞNICU MARE",53103,951,565,530,35,0,555,10,1051,486,320,235
11,"CARAŞ-SEVERIN","#N/A",53103,,267,"MOCERIŞ / Căminul Cultural",3,4968,"LĂPUŞNICU MARE",53103,495,276,247,29,0,270,6,556,280,131,139
11,"CARAŞ-SEVERIN","#N/A",53130,,268,"LUNCAVIŢA / GRADINITA CU PROGRAM NORMAL  LUNCAVITA",3,4971,"LUNCAVIŢA",53130,702,377,355,22,0,376,1,779,402,152,224
11,"CARAŞ-SEVERIN","#N/A",53130,,269,"VERENDIN / SCOALA CU CLASELE I-VIII VERENDIN",3,4971,"LUNCAVIŢA",53130,1383,810,760,50,0,807,3,1521,711,353,454
11,"CARAŞ-SEVERIN","#N/A",53167,,270,"LUPAC / Şcoala cu clasele I - VIII",3,4974,"LUPAC",53167,750,331,310,21,0,329,2,825,494,119,210
11,"CARAŞ-SEVERIN","#N/A",53167,,271,"CLOCOTICI / Şcoala cu clasele I - VIII",3,4974,"LUPAC",53167,721,359,314,45,0,358,1,796,437,68,290
11,"CARAŞ-SEVERIN","#N/A",53167,,272,"RAFNIC / Şcoala cu clasele I - IV",3,4974,"LUPAC",53167,439,192,184,8,0,189,3,483,291,65,124
11,"CARAŞ-SEVERIN","#N/A",53167,,273,"VODNIC / Şcoala cu clasele I - IV",3,4974,"LUPAC",53167,358,151,141,10,0,151,0,394,243,48,103
11,"CARAŞ-SEVERIN","#N/A",53210,,274,"MARGA / Căminul Cultural",3,4979,"MARGA",53210,954,705,609,60,36,705,0,1052,347,535,170
11,"CARAŞ-SEVERIN","#N/A",53247,,275,"MĂURENI / Căminul Cultural",3,4982,"MĂURENI",53247,1479,751,683,61,7,748,3,1629,878,298,450
11,"CARAŞ-SEVERIN","#N/A",53247,,276,"ŞOŞDEA / Clădirea administrativă",3,4982,"MĂURENI",53247,699,441,378,63,0,438,3,766,325,207,231
11,"CARAŞ-SEVERIN","#N/A",53274,,277,"GLOBURĂU / Şcoala Generală",3,4985,"MEHADIA",53274,204,143,117,26,0,141,2,224,81,49,92
11,"CARAŞ-SEVERIN","#N/A",53274,,278,"PLUGOVA / Şcoala Generală",3,4985,"MEHADIA",53274,704,446,403,43,0,441,5,776,330,270,171
11,"CARAŞ-SEVERIN","#N/A",53274,,279,"VALEA BOLVAŞNIŢA / Şcoala Generală",3,4985,"MEHADIA",53274,602,334,278,56,0,334,0,662,328,171,163
11,"CARAŞ-SEVERIN","#N/A",53274,,280,"MEHADIA / Liceul Tehnologic ""Nicolae Stoica de Hateg""",3,4985,"MEHADIA",53274,1190,706,639,67,0,703,3,1313,607,357,346
11,"CARAŞ-SEVERIN","#N/A",53274,,281,"MEHADIA / Liceul Tehnologic ""Nicolae Stoica de Hateg""",3,4985,"MEHADIA",53274,775,424,354,70,0,417,7,856,432,186,231
11,"CARAŞ-SEVERIN","#N/A",53327,,282,"MEHADICA / Şcoala Generală cu clasele I - VIII",3,4990,"MEHADICA",53327,641,463,382,81,0,462,1,706,243,204,258
11,"CARAŞ-SEVERIN","#N/A",53345,,283,"LESCOVIŢA / Căminul Cultural",3,4992,"NAIDĂŞ",53345,217,191,130,50,11,189,2,240,49,98,91
11,"CARAŞ-SEVERIN","#N/A",53345,,284,"NAIDĂŞ / Primăria veche",3,4992,"NAIDĂŞ",53345,687,540,430,89,21,535,5,756,216,282,253
11,"CARAŞ-SEVERIN","#N/A",53372,,285,"OBREJA / Şcoala cu clasele I - VIII",3,4995,"OBREJA",53372,1483,903,850,52,1,893,10,1628,725,431,462
11,"CARAŞ-SEVERIN","#N/A",53372,,286,"CIUTA / Şcoala cu clasele I - IV",3,4995,"OBREJA",53372,295,217,191,26,0,217,0,327,109,145,72
11,"CARAŞ-SEVERIN","#N/A",53372,,287,"IAZ / Şcoala cu clasele I - IV",3,4995,"OBREJA",53372,573,444,366,78,0,444,0,628,184,267,177
11,"CARAŞ-SEVERIN","#N/A",53372,,288,"VAR / Şcoala cu clasele I - IV",3,4995,"OBREJA",53372,323,267,224,43,0,266,1,355,88,187,79
11,"CARAŞ-SEVERIN","#N/A",50987,,289,"OCNA DE FIER / Şcoala Gimnazială",3,5000,"OCNA DE FIER",50987,597,389,314,70,5,387,2,653,264,166,221
11,"CARAŞ-SEVERIN","#N/A",53425,,290,"PĂLTINIŞ / Căminul Cultural",3,5002,"PĂLTINIŞ",53425,559,332,305,27,0,330,2,617,285,106,224
11,"CARAŞ-SEVERIN","#N/A",53425,,291,"CORNUŢEL / Şcoala Generală",3,5002,"PĂLTINIŞ",53425,827,423,395,28,0,420,3,915,492,134,286
11,"CARAŞ-SEVERIN","#N/A",53425,,292,"DELINEŞTI / Şcoala Generală",3,5002,"PĂLTINIŞ",53425,359,255,203,50,2,255,0,400,145,90,165
11,"CARAŞ-SEVERIN","#N/A",53425,,293,"OHABIŢA / Şcoala Primară",3,5002,"PĂLTINIŞ",53425,69,65,43,22,0,65,0,77,12,25,40
11,"CARAŞ-SEVERIN","#N/A",53425,,294,"RUGI / Şcoala Primară",3,5002,"PĂLTINIŞ",53425,227,154,128,26,0,154,0,251,97,78,76
11,"CARAŞ-SEVERIN","#N/A",53513,,295,"POJEJENA / Şcoala cu clasele I - VIII",3,5008,"POJEJENA",53513,975,663,571,48,44,626,37,1075,412,454,172
11,"CARAŞ-SEVERIN","#N/A",53513,,296,"BELOBREŞCA / Şcoala cu clasele I - VIII",3,5008,"POJEJENA",53513,516,355,311,28,16,351,4,570,215,260,91
11,"CARAŞ-SEVERIN","#N/A",53513,,297,"RADIMNA / Şcoala cu clasele I - IV",3,5008,"POJEJENA",53513,436,322,271,39,12,319,3,481,159,247,72
11,"CARAŞ-SEVERIN","#N/A",53513,,298,"DIVICI / Grădiniţa cu program normal",3,5008,"POJEJENA",53513,232,191,145,34,12,189,2,257,66,137,52
11,"CARAŞ-SEVERIN","#N/A",53513,,299,"ŞUŞCA / Grădiniţa cu program normal",3,5008,"POJEJENA",53513,363,247,208,31,8,238,9,399,152,137,101
11,"CARAŞ-SEVERIN","#N/A",53577,,300,"BORLOVENII VECHI / Căminul Cultural",3,5014,"PRIGOR",53577,389,265,231,34,0,263,2,428,163,180,83
11,"CARAŞ-SEVERIN","#N/A",53577,,301,"BORLOVENII NOI / Şcoala Generală",3,5014,"PRIGOR",53577,351,228,204,24,0,226,2,387,159,65,161
11,"CARAŞ-SEVERIN","#N/A",53577,,302,"PĂTAŞ / Şcoala Generală",3,5014,"PRIGOR",53577,484,298,268,24,6,297,1,534,236,110,187
11,"CARAŞ-SEVERIN","#N/A",53577,,303,"PUTNA / Şcoala Generală",3,5014,"PRIGOR",53577,135,123,103,20,0,123,0,147,24,77,46
11,"CARAŞ-SEVERIN","#N/A",53577,,304,"PRIGOR / Şcoala veche",3,5014,"PRIGOR",53577,755,560,489,66,5,555,5,833,273,323,232
11,"CARAŞ-SEVERIN","#N/A",53639,,305,"RAMNA / Şcoala Gimnazială RAMNA",3,5023,"RAMNA",53639,997,590,494,71,25,587,3,1099,509,200,387
11,"CARAŞ-SEVERIN","#N/A",53639,,306,"VALEAPAI / Şcoala cu clasele I - IV - VALEAPAI",3,5023,"RAMNA",53639,351,216,168,43,5,214,2,387,171,87,127
11,"CARAŞ-SEVERIN","#N/A",53675,,307,"RĂCĂŞDIA / Căminul Cultural",3,5020,"RĂCĂŞDIA",53675,1390,637,582,55,0,632,5,1529,892,270,362
11,"CARAŞ-SEVERIN","#N/A",53675,,308,"VRĂNIUŢ / Clădirea fostei Primării Vrăniuţ",3,5020,"RĂCĂŞDIA",53675,287,114,68,46,0,112,2,316,202,51,61
11,"CARAŞ-SEVERIN","#N/A",53728,,309,"RUSCA MONTANĂ / Şcoala Generală",3,5027,"RUSCA MONTANĂ",53728,1349,807,738,47,22,794,13,1485,678,440,354
11,"CARAŞ-SEVERIN","#N/A",53728,,310,"RUŞCHIŢA / Grădiniţa",3,5027,"RUSCA MONTANĂ",53728,303,167,149,16,2,164,3,334,167,114,50
11,"CARAŞ-SEVERIN","#N/A",53755,,311,"TINCOVA / Grădiniţa",3,5030,"SACU",53755,377,228,200,26,2,226,2,418,190,113,113
11,"CARAŞ-SEVERIN","#N/A",53755,,312,"SACU / Club Cămin Cultural",3,5030,"SACU",53755,698,481,395,75,11,471,10,771,290,188,283
11,"CARAŞ-SEVERIN","#N/A",53755,,313,"SĂLBĂGELU NOU / Şcoala",3,5030,"SACU",53755,197,126,113,13,0,123,3,217,91,44,79
11,"CARAŞ-SEVERIN","#N/A",53791,,314,"BOGODINŢ / Căminul Cultural",3,5034,"SASCA MONTANĂ",53791,90,100,54,43,3,97,3,129,29,59,38
11,"CARAŞ-SEVERIN","#N/A",53791,,315,"SASCA ROMÂNĂ / Căminul Cultural",3,5034,"SASCA MONTANĂ",53791,310,207,175,29,3,201,6,342,135,80,121
11,"CARAŞ-SEVERIN","#N/A",53791,,316,"SLATINA-NERA / Căminul Cultural",3,5034,"SASCA MONTANĂ",53791,283,159,97,59,3,159,0,283,124,89,70
11,"CARAŞ-SEVERIN","#N/A",53791,,317,"SASCA MONTANĂ / Şcoala cu clasele I - VIII",3,5034,"SASCA MONTANĂ",53791,410,269,184,72,13,266,3,454,185,167,99
11,"CARAŞ-SEVERIN","#N/A",53791,,318,"POTOC / Şcoala cu clasele I - IV",3,5034,"SASCA MONTANĂ",53791,224,168,122,36,10,165,3,247,79,73,92
11,"CARAŞ-SEVERIN","#N/A",53853,,319,"GORNEA / Grădiniţa",3,5040,"SICHEVIŢA",53853,484,333,290,26,17,333,0,534,201,200,133
11,"CARAŞ-SEVERIN","#N/A",53853,,320,"SICHEVIŢA / CAMIN CULTURAL SICHEVITA",3,5040,"SICHEVIŢA",53853,1272,934,840,71,23,918,16,1400,466,378,540
11,"CARAŞ-SEVERIN","#N/A",53853,,321,"LIBORAJDEA / CENTRU DE INFORMARE TURISTICA COMUNA SICHEVITA",3,5040,"SICHEVIŢA",53853,97,65,46,17,2,65,0,108,43,20,45
11,"CARAŞ-SEVERIN","#N/A",54056,,322,"SLATINA-TIMIŞ / Căminul Cultural",3,5060,"SLATINA-TIMIŞ",54056,1402,909,856,53,0,898,11,1544,635,469,429
11,"CARAŞ-SEVERIN","#N/A",54056,,323,"ILOVA / Şcoala cu clasele I - IV",3,5060,"SLATINA-TIMIŞ",54056,640,344,320,24,0,343,1,704,360,163,180
11,"CARAŞ-SEVERIN","#N/A",54056,,324,"SADOVA NOUĂ / Şcoala cu clasele I - IV",3,5060,"SLATINA-TIMIŞ",54056,204,135,113,22,0,135,0,224,89,57,78
11,"CARAŞ-SEVERIN","#N/A",54056,,325,"SADOVA VECHE / Şcoala cu clasele I - IV",3,5060,"SLATINA-TIMIŞ",54056,320,166,135,31,0,164,2,352,186,66,98
11,"CARAŞ-SEVERIN","#N/A",54109,,326,"SOCOL / Şcoala Gimnazială ""Sf. Sava"" - SOCOL",3,5065,"SOCOL",54109,609,403,325,46,32,402,1,671,268,292,110
11,"CARAŞ-SEVERIN","#N/A",54109,,327,"BAZIAŞ / Căminul Cultural - BAZIAŞ",3,5065,"SOCOL",54109,55,48,27,16,5,44,4,61,13,30,14
11,"CARAŞ-SEVERIN","#N/A",54109,,328,"CÎMPIA / Şcoala Primară CÎMPIA",3,5065,"SOCOL",54109,472,276,225,33,18,273,3,521,245,163,110
11,"CARAŞ-SEVERIN","#N/A",54109,,329,"ZLATIŢA / Şcoala Gimnazială- ZLATITA",3,5065,"SOCOL",54109,615,472,369,72,31,469,3,674,202,392,77
11,"CARAŞ-SEVERIN","#N/A",54163,,330,"ŞOPOTU NOU / Căminul Cultural-SOPOTU NOU",3,5071,"ŞOPOTU NOU",54163,284,209,185,22,2,206,3,315,106,119,87
11,"CARAŞ-SEVERIN","#N/A",54163,,331,"RAVENSCA / Căminul Cultural-RAVENSCA",3,5071,"ŞOPOTU NOU",54163,116,58,48,10,0,58,0,128,70,35,23
11,"CARAŞ-SEVERIN","#N/A",54163,,332,"RĂCHITA / Şcoala-RACHITA",3,5071,"ŞOPOTU NOU",54163,110,72,58,14,0,72,0,121,49,52,20
11,"CARAŞ-SEVERIN","#N/A",54163,,333,"STĂNCILOVA / CAMININUL CULTURAL-STANCILOVA  DE JOS",3,5071,"ŞOPOTU NOU",54163,96,67,57,10,0,66,1,106,39,43,23
11,"CARAŞ-SEVERIN","#N/A",54163,,334,"STĂNCILOVA / CAMINNUL CULTURAL STANCILOVA DE SUS",3,5071,"ŞOPOTU NOU",54163,142,92,80,12,0,91,1,157,65,45,46
11,"CARAŞ-SEVERIN","#N/A",54163,,335,"VALEA ROŞIE / Căminul Cultural-VALEA ROSIE",3,5071,"ŞOPOTU NOU",54163,214,120,111,9,0,120,0,237,117,70,50
11,"CARAŞ-SEVERIN","#N/A",54270,,336,"TEREGOVA / Căminul Cultural",3,5082,"TEREGOVA",54270,1252,897,828,47,22,893,4,1379,482,658,235
11,"CARAŞ-SEVERIN","#N/A",54270,,337,"TEREGOVA / Liceul Tehnologic ""Sf. Dimitrie""",3,5082,"TEREGOVA",54270,1207,901,811,53,37,886,15,1332,431,654,232
11,"CARAŞ-SEVERIN","#N/A",54270,,338,"RUSCA / Oficiul Primăriei",3,5082,"TEREGOVA",54270,967,687,619,44,24,681,6,1066,379,396,285
11,"CARAŞ-SEVERIN","#N/A",54305,,339,"CÎRNECEA / Şcoala cu clasele I - IV",3,5085,"TICVANIU MARE",54305,267,208,133,61,14,206,2,294,86,119,87
11,"CARAŞ-SEVERIN","#N/A",54305,,340,"SECĂŞENI / Şcoala cu clasele I - IV",3,5085,"TICVANIU MARE",54305,278,184,139,41,4,178,6,307,123,108,70
11,"CARAŞ-SEVERIN","#N/A",54305,,341,"TICVANIU MIC / Şcoala cu clasele I - IV",3,5085,"TICVANIU MARE",54305,271,179,142,33,4,177,2,299,120,71,106
11,"CARAŞ-SEVERIN","#N/A",54305,,342,"TICVANIU MARE / Casa de Cultură ""Virgil Birou""",3,5085,"TICVANIU MARE",54305,684,271,225,36,10,267,4,755,484,158,109
11,"CARAŞ-SEVERIN","#N/A",54350,,343,"TÎRNOVA / Şcoala Gimnazială TÎRNOVA",3,5090,"TÎRNOVA",54350,1417,827,721,88,18,817,10,1564,737,391,426
11,"CARAŞ-SEVERIN","#N/A",54387,,344,"TOPLEŢ / Căminul Cultural",3,5093,"TOPLEŢ",54387,1181,713,645,68,0,709,4,1301,588,308,401
11,"CARAŞ-SEVERIN","#N/A",54387,,345,"BÎRZA / Şcoala cu clasele I - IV",3,5093,"TOPLEŢ",54387,1060,624,538,85,1,618,6,1165,541,301,317
11,"CARAŞ-SEVERIN","#N/A",54412,,346,"TURNU RUIENI / Căminul Cultural Turnu Ruieni",3,5096,"TURNU RUIENI",54412,700,375,349,26,0,374,1,770,395,101,273
11,"CARAŞ-SEVERIN","#N/A",54412,,347,"BORLOVA / Căminul Cultural-Borlova",3,5096,"TURNU RUIENI",54412,1133,638,600,38,0,638,0,1253,615,209,429
11,"CARAŞ-SEVERIN","#N/A",54412,,348,"DALCI / Şcoala-Dalci",3,5096,"TURNU RUIENI",54412,222,164,149,15,0,163,1,244,80,79,84
11,"CARAŞ-SEVERIN","#N/A",54412,,349,"ZERVEŞTI / Căminul Cultural Zervesti",3,5096,"TURNU RUIENI",54412,438,307,275,32,0,303,4,482,175,162,141
11,"CARAŞ-SEVERIN","#N/A",54412,,350,"ZLAGNA / Căminul Cultural-Zlagna",3,5096,"TURNU RUIENI",54412,249,202,183,19,0,201,1,273,71,94,107
11,"CARAŞ-SEVERIN","#N/A",54485,,351,"VĂLIUG / Şcoala Gimnazială ""Petre Sava Bălean""",3,5103,"VĂLIUG",54485,666,477,351,126,0,475,2,737,260,189,286
11,"CARAŞ-SEVERIN","#N/A",54500,,352,"VĂRĂDIA / Căminul Cultural Vărădia",3,5105,"VĂRĂDIA",54500,662,415,337,64,14,412,3,728,313,270,142
11,"CARAŞ-SEVERIN","#N/A",54500,,353,"MERCINA / Clădirea administraţiei locale",3,5105,"VĂRĂDIA",54500,475,294,242,42,10,289,5,523,229,156,133
11,"CARAŞ-SEVERIN","#N/A",54537,,354,"ERSIG / Şcoala cu clasele I - IV",3,5108,"VERMEŞ",54537,248,179,139,40,0,176,3,274,95,57,119
11,"CARAŞ-SEVERIN","#N/A",54537,,355,"IZGAR / Şcoala cu clasele I - IV",3,5108,"VERMEŞ",54537,250,171,137,34,0,169,2,276,105,92,77
11,"CARAŞ-SEVERIN","#N/A",54537,,356,"VERMEŞ / Sala de Sport",3,5108,"VERMEŞ",54537,828,623,539,64,20,613,10,922,299,394,219
11,"CARAŞ-SEVERIN","#N/A",54573,,357,"VRANI / Căminul Cultural Vrani",3,5112,"VRANI",54573,735,499,394,70,35,497,2,809,310,253,244
11,"CARAŞ-SEVERIN","#N/A",54573,,358,"CIORTEA / Şcoala cu clasele I - IV Ciortea",3,5112,"VRANI",54573,145,126,94,30,2,125,1,162,36,72,53
11,"CARAŞ-SEVERIN","#N/A",54617,,359,"ZĂVOI / Căminul Cultural-ZAVOI",3,5116,"ZĂVOI",54617,1502,852,813,39,0,846,6,1556,704,438,408
11,"CARAŞ-SEVERIN","#N/A",54617,,360,"MĂGURA / Căminul Cultural- MAGURA",3,5116,"ZĂVOI",54617,436,320,297,23,0,314,6,482,162,212,102
11,"CARAŞ-SEVERIN","#N/A",54617,,361,"MĂRU / Şcoala cu clasele I - VIII- MARU",3,5116,"ZĂVOI",54617,902,606,557,49,0,602,4,993,387,317,285
11,"CARAŞ-SEVERIN","#N/A",54617,,362,"POIANA MĂRULUI / OCOLUL SILVIC",3,5116,"ZĂVOI",54617,53,88,23,65,0,87,1,158,70,35,52
11,"CARAŞ-SEVERIN","#N/A",54617,,363,"VOISLOVA / Şcoala cu claselel I - IV- VOISLOVA",3,5116,"ZĂVOI",54617,472,370,332,37,1,368,2,518,148,284,84
11,"CARAŞ-SEVERIN","#N/A",54699,,364,"ZORLENCIOR / Căminul Cultural",3,5124,"ZORLENŢU MARE",54699,101,94,60,34,0,93,1,114,20,24,69
11,"CARAŞ-SEVERIN","#N/A",54699,,365,"ZORLENŢU MARE / Şcoala cu clasele I - VIII",3,5124,"ZORLENŢU MARE",54699,654,490,324,166,0,486,4,717,227,148,338
12,"CĂLĂRAŞI","#N/A",92569,,1,"CĂLĂRAŞI / Scoala Gimnaziala CAROL I Calarasi",1,5128,"MUNICIPIUL CĂLĂRAŞI",92569,1499,925,881,24,20,906,19,1432,507,500,406
12,"CĂLĂRAŞI","#N/A",92569,,2,"CĂLĂRAŞI / Scoala Gimnaziala CAROL I Calarasi",1,5128,"MUNICIPIUL CĂLĂRAŞI",92569,712,496,413,83,0,490,6,790,294,229,261
12,"CĂLĂRAŞI","#N/A",92569,,3,"CĂLĂRAŞI / Scoala Gimnaziala CAROL I Calarasi",1,5128,"MUNICIPIUL CĂLĂRAŞI",92569,1071,710,602,41,67,698,12,1200,490,344,354
12,"CĂLĂRAŞI","#N/A",92569,,4,"CĂLĂRAŞI / Scoala Gimnaziala CAROL I Calarasi",1,5128,"MUNICIPIUL CĂLĂRAŞI",92569,830,609,483,52,74,601,8,938,329,290,311
12,"CĂLĂRAŞI","#N/A",92569,,5,"CĂLĂRAŞI / Colegiul Naţional ,,Barbu Ştirbei,,",1,5128,"MUNICIPIUL CĂLĂRAŞI",92569,1162,796,726,52,18,781,15,1488,692,363,418
12,"CĂLĂRAŞI","#N/A",92569,,6,"CĂLĂRAŞI / Colegiul Naţional ,,Barbu Ştirbei,,",1,5128,"MUNICIPIUL CĂLĂRAŞI",92569,1077,567,527,40,0,557,10,1200,633,312,245
12,"CĂLĂRAŞI","#N/A",92569,,7,"CĂLĂRAŞI / Grădiniţa cu pr.normal nr.5 Calarasi",1,5128,"MUNICIPIUL CĂLĂRAŞI",92569,1335,736,694,41,1,725,11,1766,1030,401,324
12,"CĂLĂRAŞI","#N/A",92569,,8,"CĂLĂRAŞI / Grădiniţa cu pr.normal nr.4 Calarasi",1,5128,"MUNICIPIUL CĂLĂRAŞI",92569,1523,809,746,62,1,792,17,1755,946,452,340
12,"CĂLĂRAŞI","#N/A",92569,,9,"CĂLĂRAŞI / Grădiniţa cu pr. Prel.(Micro6)",1,5128,"MUNICIPIUL CĂLĂRAŞI",92569,1476,825,786,39,0,811,14,1327,502,444,367
12,"CĂLĂRAŞI","#N/A",92569,,10,"CĂLĂRAŞI / Colegiul agricol ,,Sandu Aldea,, Calarasi",1,5128,"MUNICIPIUL CĂLĂRAŞI",92569,1249,707,639,68,0,695,12,1360,653,352,343
12,"CĂLĂRAŞI","#N/A",92569,,11,"CĂLĂRAŞI / Colegiul agricol ,,Sandu Aldea,, Calarasi",1,5128,"MUNICIPIUL CĂLĂRAŞI",92569,1143,675,632,42,1,658,17,1269,594,300,358
12,"CĂLĂRAŞI","#N/A",92569,,12,"CĂLĂRAŞI / Colegiul agricol ,,Sandu Aldea,, Calarasi",1,5128,"MUNICIPIUL CĂLĂRAŞI",92569,1032,508,489,19,0,492,16,1131,623,252,240
12,"CĂLĂRAŞI","#N/A",92569,,13,"CĂLĂRAŞI / Lic. Teoretic ,,Mihai Eminescu,,",1,5128,"MUNICIPIUL CĂLĂRAŞI",92569,1126,689,644,45,0,675,14,1228,539,346,329
12,"CĂLĂRAŞI","#N/A",92569,,14,"CĂLĂRAŞI / Lic. Teoretic ,,Mihai Eminescu,,",1,5128,"MUNICIPIUL CĂLĂRAŞI",92569,1490,818,781,36,1,801,17,1642,824,417,384
12,"CĂLĂRAŞI","#N/A",92569,,15,"CĂLĂRAŞI / Lic. Teoretic ,,Mihai Eminescu,,",1,5128,"MUNICIPIUL CĂLĂRAŞI",92569,1333,774,739,35,0,759,15,1466,692,387,372
12,"CĂLĂRAŞI","#N/A",92569,,16,"CĂLĂRAŞI / Şcoala gimnaziala Mihai Viteazul Calarasi",1,5128,"MUNICIPIUL CĂLĂRAŞI",92569,1318,762,708,54,0,748,14,1440,678,333,415
12,"CĂLĂRAŞI","#N/A",92569,,17,"CĂLĂRAŞI / Şcoala gimnaziala Mihai Viteazul Calarasi",1,5128,"MUNICIPIUL CĂLĂRAŞI",92569,1275,695,668,27,0,678,17,1400,705,335,343
12,"CĂLĂRAŞI","#N/A",92569,,18,"CĂLĂRAŞI / Şcoala gimnaziala Mihai Viteazul Calarasi",1,5128,"MUNICIPIUL CĂLĂRAŞI",92569,1407,805,777,28,0,791,14,1516,711,378,413
12,"CĂLĂRAŞI","#N/A",92569,,19,"CĂLĂRAŞI / Şcoala gimnaziala Mihai Viteazul Calarasi",1,5128,"MUNICIPIUL CĂLĂRAŞI",92569,816,461,442,19,0,456,5,900,439,216,240
12,"CĂLĂRAŞI","#N/A",92569,,20,"CĂLĂRAŞI / Sala de sport a scolii gimnaziale Nicolae Titulescu",1,5128,"MUNICIPIUL CĂLĂRAŞI",92569,850,531,485,46,0,521,10,788,257,255,266
12,"CĂLĂRAŞI","#N/A",92569,,21,"CĂLĂRAŞI / Sala de sport a scolii gimnaziale Nicolae Titulescu",1,5128,"MUNICIPIUL CĂLĂRAŞI",92569,1559,774,750,24,0,759,15,1716,942,410,349
12,"CĂLĂRAŞI","#N/A",92569,,22,"CĂLĂRAŞI / Grădiniţa cu pr.prel.nr.1",1,5128,"MUNICIPIUL CĂLĂRAŞI",92569,1174,698,663,35,0,688,10,1279,581,379,309
12,"CĂLĂRAŞI","#N/A",92569,,23,"CĂLĂRAŞI / Grădiniţa cu program normal nr.2 Calarasi",1,5128,"MUNICIPIUL CĂLĂRAŞI",92569,1863,969,928,41,0,956,13,1851,882,503,453
12,"CĂLĂRAŞI","#N/A",92569,,24,"CĂLĂRAŞI / Liceul Danubius Calarasi",1,5128,"MUNICIPIUL CĂLĂRAŞI",92569,1674,828,775,53,0,812,16,1746,918,378,434
12,"CĂLĂRAŞI","#N/A",92569,,25,"CĂLĂRAŞI / Liceul Danubius Calarasi",1,5128,"MUNICIPIUL CĂLĂRAŞI",92569,1639,854,823,31,0,839,15,1702,848,438,401
12,"CĂLĂRAŞI","#N/A",92569,,26,"CĂLĂRAŞI / Liceul Danubius Calarasi",1,5128,"MUNICIPIUL CĂLĂRAŞI",92569,1921,892,859,33,0,868,24,1909,1017,412,456
12,"CĂLĂRAŞI","#N/A",92569,,27,"CĂLĂRAŞI / Liceul Danubius Calarasi",1,5128,"MUNICIPIUL CĂLĂRAŞI",92569,1523,495,477,18,0,478,17,1703,1208,330,148
12,"CĂLĂRAŞI","#N/A",92569,,28,"CĂLĂRAŞI / Creşa săptămânală cu 100 locuri",1,5128,"MUNICIPIUL CĂLĂRAŞI",92569,1453,672,648,24,0,659,13,1602,930,333,326
12,"CĂLĂRAŞI","#N/A",92569,,29,"CĂLĂRAŞI / Creşa săptămânală cu 100 locuri",1,5128,"MUNICIPIUL CĂLĂRAŞI",92569,806,365,342,23,0,361,4,887,522,185,176
12,"CĂLĂRAŞI","#N/A",92569,,30,"CĂLĂRAŞI / Şcoala gimnaziala T.Vladimirescu",1,5128,"MUNICIPIUL CĂLĂRAŞI",92569,1447,815,783,32,0,794,21,1587,772,398,396
12,"CĂLĂRAŞI","#N/A",92569,,31,"CĂLĂRAŞI / Şcoala gimnaziala T.Vladimirescu",1,5128,"MUNICIPIUL CĂLĂRAŞI",92569,1268,763,720,43,0,753,10,1423,660,412,341
12,"CĂLĂRAŞI","#N/A",92569,,32,"CĂLĂRAŞI / Şcoala gimnaziala T.Vladimirescu",1,5128,"MUNICIPIUL CĂLĂRAŞI",92569,1374,827,784,43,0,810,17,1526,699,385,425
12,"CĂLĂRAŞI","#N/A",92569,,33,"CĂLĂRAŞI / Şcoala gimnaziala T.Vladimirescu",1,5128,"MUNICIPIUL CĂLĂRAŞI",92569,1445,812,789,23,0,801,11,1600,788,418,383
12,"CĂLĂRAŞI","#N/A",92569,,34,"CĂLĂRAŞI / Sala de sport de la şc.12",1,5128,"MUNICIPIUL CĂLĂRAŞI",92569,1346,760,724,36,0,748,12,1480,720,318,430
12,"CĂLĂRAŞI","#N/A",92569,,35,"CĂLĂRAŞI / Sala de sport de la şc.12",1,5128,"MUNICIPIUL CĂLĂRAŞI",92569,1216,632,600,32,0,623,9,1333,701,281,342
12,"CĂLĂRAŞI","#N/A",92569,,36,"CĂLĂRAŞI / Şcoala gimnaziala Mircea Vodă",1,5128,"MUNICIPIUL CĂLĂRAŞI",92569,1238,777,730,47,0,760,17,1370,593,353,407
12,"CĂLĂRAŞI","#N/A",92569,,37,"CĂLĂRAŞI / Şcoala gimnaziala Mircea Vodă",1,5128,"MUNICIPIUL CĂLĂRAŞI",92569,1113,563,505,58,0,555,8,1226,663,285,270
12,"CĂLĂRAŞI","#N/A",92569,,38,"CĂLĂRAŞI / Şcoala gimnaziala Mircea Vodă",1,5128,"MUNICIPIUL CĂLĂRAŞI",92569,1641,968,919,47,2,954,14,1800,832,408,546
12,"CĂLĂRAŞI","#N/A",92569,,39,"CĂLĂRAŞI / Şcoala gimnaziala Mircea Vodă",1,5128,"MUNICIPIUL CĂLĂRAŞI",92569,1121,598,573,25,0,583,15,1216,618,316,267
12,"CĂLĂRAŞI","#N/A",92569,,40,"CĂLĂRAŞI / Gradinita cu program prelungit nr.9 Voinicel",1,5128,"MUNICIPIUL CĂLĂRAŞI",92569,1527,879,844,35,0,864,15,1700,821,453,411
12,"CĂLĂRAŞI","#N/A",92569,,41,"CĂLĂRAŞI / Gradinita cu program prelungit nr.9 Voinicel",1,5128,"MUNICIPIUL CĂLĂRAŞI",92569,1113,598,576,20,2,588,10,1230,632,339,249
12,"CĂLĂRAŞI","#N/A",92569,,42,"CĂLĂRAŞI / Grădiniţa cu pr.prelungit nr.5 Aricel Calarasi",1,5128,"MUNICIPIUL CĂLĂRAŞI",92569,845,522,491,31,0,517,5,931,409,252,265
12,"CĂLĂRAŞI","#N/A",92569,,43,"CĂLĂRAŞI / Colegiul Economic sediul B",1,5128,"MUNICIPIUL CĂLĂRAŞI",92569,1180,702,669,33,0,691,10,1351,649,353,338
12,"CĂLĂRAŞI","#N/A",92569,,44,"CĂLĂRAŞI / Liceul Tehnologic Transporturi Auto Calarasi",1,5128,"MUNICIPIUL CĂLĂRAŞI",92569,1228,743,682,37,24,734,9,1328,585,443,291
12,"CĂLĂRAŞI","#N/A",92569,,45,"CĂLĂRAŞI / Şcoala gimnaziala C-tin Brâncoveanu",1,5128,"MUNICIPIUL CĂLĂRAŞI",92569,1483,939,843,41,55,924,15,1627,688,514,410
12,"CĂLĂRAŞI","#N/A",92569,,46,"CĂLĂRAŞI / Şcoala gimnaziala C-tin Brâncoveanu",1,5128,"MUNICIPIUL CĂLĂRAŞI",92569,1134,525,501,24,0,516,9,1252,727,288,228
12,"CĂLĂRAŞI","#N/A",92569,,47,"CĂLĂRAŞI / Şcoala gimnaziala C-tin Brâncoveanu",1,5128,"MUNICIPIUL CĂLĂRAŞI",92569,1220,734,713,21,0,723,11,1349,615,389,334
12,"CĂLĂRAŞI","#N/A",92569,,48,"CĂLĂRAŞI / Şcoala primara nr.6",1,5128,"MUNICIPIUL CĂLĂRAŞI",92569,1028,636,620,16,0,628,8,1129,493,296,332
12,"CĂLĂRAŞI","#N/A",92569,,49,"CĂLĂRAŞI / Şcoala primara nr.6",1,5128,"MUNICIPIUL CĂLĂRAŞI",92569,1034,554,524,30,0,545,9,1141,587,267,278
12,"CĂLĂRAŞI","#N/A",92569,,50,"CĂLĂRAŞI / Oborul Duminical",1,5128,"MUNICIPIUL CĂLĂRAŞI",92569,650,373,339,34,0,355,18,713,340,244,111
12,"CĂLĂRAŞI","#N/A",92569,,51,"CĂLĂRAŞI / Colegiul Economic sediu",1,5128,"MUNICIPIUL CĂLĂRAŞI",92569,1559,1085,989,94,2,1071,14,1677,592,579,492
12,"CĂLĂRAŞI","#N/A",100610,,52,"OLTENIŢA / Scoala cu cls.I-VIII ""Al.D.Ghica""",1,5130,"MUNICIPIUL OLTENIŢA",100610,1936,1097,1051,46,0,1076,21,2130,1033,814,262
12,"CĂLĂRAŞI","#N/A",100610,,53,"OLTENIŢA / Cantina de ajutor social",1,5130,"MUNICIPIUL OLTENIŢA",100610,1348,815,786,29,0,797,18,1485,670,584,213
12,"CĂLĂRAŞI","#N/A",100610,,54,"OLTENIŢA / Scoala cu cls.I-VIII ""Nr.2",1,5130,"MUNICIPIUL OLTENIŢA",100610,1296,708,677,31,0,689,19,1429,721,493,196
12,"CĂLĂRAŞI","#N/A",100610,,55,"OLTENIŢA / Scoala cu cls.I-VIII ""Nr.2",1,5130,"MUNICIPIUL OLTENIŢA",100610,1593,949,888,61,0,942,7,1745,796,613,329
12,"CĂLĂRAŞI","#N/A",100610,,56,"OLTENIŢA / Primaria Municipiului Oltenita",1,5130,"MUNICIPIUL OLTENIŢA",100610,1835,1165,1067,79,19,1152,13,2028,863,770,382
12,"CĂLĂRAŞI","#N/A",100610,,57,"OLTENIŢA / Primaria Municipiului Oltenita",1,5130,"MUNICIPIUL OLTENIŢA",100610,1922,1113,1062,50,1,1101,12,2118,1005,691,410
12,"CĂLĂRAŞI","#N/A",100610,,58,"OLTENIŢA / Scoala cu clasele nr.I-VIII  Spiru Haret",1,5130,"MUNICIPIUL OLTENIŢA",100610,1950,1061,1015,45,1,1046,15,2147,1086,751,295
12,"CĂLĂRAŞI","#N/A",100610,,59,"OLTENIŢA / Liceul Neagoe Basarab",1,5130,"MUNICIPIUL OLTENIŢA",100610,1933,1140,1032,85,23,1128,12,2125,985,753,375
12,"CĂLĂRAŞI","#N/A",100610,,60,"OLTENIŢA / Scoala cu cls I-VIII nr 6",1,5130,"MUNICIPIUL OLTENIŢA",100610,1821,880,843,37,0,865,15,2008,1128,629,236
12,"CĂLĂRAŞI","#N/A",100610,,61,"OLTENIŢA / Gradinita nr.4",1,5130,"MUNICIPIUL OLTENIŢA",100610,1826,948,905,43,0,937,11,2015,1067,634,303
12,"CĂLĂRAŞI","#N/A",100610,,62,"OLTENIŢA / Scoala cu cls I-VIIInr2",1,5130,"MUNICIPIUL OLTENIŢA",100610,1836,903,872,31,0,885,18,2027,1124,601,284
12,"CĂLĂRAŞI","#N/A",100610,,63,"OLTENIŢA / Scoala cu cls I-IV Constantin Deculescu",1,5130,"MUNICIPIUL OLTENIŢA",100610,1797,661,634,27,0,648,13,1980,1319,440,208
12,"CĂLĂRAŞI","#N/A",100610,,64,"OLTENIŢA / Scoala cu Cls I-VIII Mircea Eliade",1,5130,"MUNICIPIUL OLTENIŢA",100610,1357,781,765,15,1,777,4,1500,719,540,237
12,"CĂLĂRAŞI","#N/A",100610,,65,"OLTENIŢA / Gradinita nr.2",1,5130,"MUNICIPIUL OLTENIŢA",100610,1684,963,943,18,2,952,11,1856,893,676,276
12,"CĂLĂRAŞI","#N/A",101458,,66,"BUDEŞTI / scoala gimnaziala gheorghe manu",1,5132,"ORAŞ BUDEŞTI",101458,1873,1019,921,98,0,992,27,2062,1043,638,354
12,"CĂLĂRAŞI","#N/A",101458,,67,"BUDEŞTI / scoala gimnaziala gheorghe manu",1,5132,"ORAŞ BUDEŞTI",101458,1907,1033,935,98,0,1003,30,2107,1074,679,324
12,"CĂLĂRAŞI","#N/A",101458,,68,"APROZI / Scoala Gimnaziala nr.1Aprozi",1,5132,"ORAŞ BUDEŞTI",101458,816,553,436,117,0,544,9,900,347,372,172
12,"CĂLĂRAŞI","#N/A",101458,,69,"BUCIUMENI / Scoala Primara nr.2 Buciumeni",1,5132,"ORAŞ BUDEŞTI",101458,540,449,363,86,0,444,5,600,151,253,191
12,"CĂLĂRAŞI","#N/A",101458,,70,"GRUIU / Scoala Primara nr.1 Gruiu",1,5132,"ORAŞ BUDEŞTI",101458,636,491,354,137,0,485,6,704,213,248,237
12,"CĂLĂRAŞI","#N/A",103032,,71,"FUNDULEA / Liceul tehnologic nr. 1",1,5137,"ORAŞ FUNDULEA",103032,963,779,654,124,1,768,11,1059,280,405,363
12,"CĂLĂRAŞI","#N/A",103032,,72,"FUNDULEA / Gradinita cu Program Prelungit",1,5137,"ORAŞ FUNDULEA",103032,1420,1119,908,211,0,1094,25,1570,451,637,457
12,"CĂLĂRAŞI","#N/A",103032,,73,"FUNDULEA / Scoala Gimnaziala Mircea Nedelciu",1,5137,"ORAŞ FUNDULEA",103032,1074,886,693,193,0,868,18,1181,295,534,334
12,"CĂLĂRAŞI","#N/A",103032,,74,"FUNDULEA / Gradinita cu Program Normal  nr. 2 Crangu",1,5137,"ORAŞ FUNDULEA",103032,1336,1022,869,153,0,1009,13,1474,452,550,459
12,"CĂLĂRAŞI","#N/A",103032,,75,"GOSTILELE / Scoala Gimnaziala nr. 1 Gostilele",1,5137,"ORAŞ FUNDULEA",103032,548,460,339,121,0,453,7,602,142,306,147
12,"CĂLĂRAŞI","#N/A",93888,,76,"LEHLIU-GARĂ / PRIMARIE",1,5141,"ORAŞ LEHLIU GARĂ",93888,1596,1334,1025,276,33,1312,22,1755,421,741,571
12,"CĂLĂRAŞI","#N/A",93888,,77,"LEHLIU-GARĂ / CASA DE CULTURA",1,5141,"ORAŞ LEHLIU GARĂ",93888,1603,1368,1049,316,3,1350,18,1767,399,728,622
12,"CĂLĂRAŞI","#N/A",93888,,78,"RĂZVANI / SCOALA CU CLS. I-VIII",1,5141,"ORAŞ LEHLIU GARĂ",93888,832,495,448,46,1,490,5,916,421,276,214
12,"CĂLĂRAŞI","#N/A",93888,,79,"RĂZVANI / SCOALA CU CLS. I-IV",1,5141,"ORAŞ LEHLIU GARĂ",93888,1009,621,570,51,0,609,12,1110,489,320,289
12,"CĂLĂRAŞI","#N/A",93888,,80,"BUZOENI / SCOALA CU CLS. I-IV",1,5141,"ORAŞ LEHLIU GARĂ",93888,378,343,242,101,0,337,6,416,73,221,116
12,"CĂLĂRAŞI","#N/A",94125,,81,"NICOLAE BĂLCESCU / SCOALA GIMNAZIALA NR1 NICOLAE BALCESCU",3,5146,"ALEXANDRU ODOBESCU",94125,1066,864,724,107,33,859,5,1177,313,344,515
12,"CĂLĂRAŞI","#N/A",94125,,82,"ALEXANDRU ODOBESCU / SCOALA GIMNAZIALA NR. 2 ALEXANDRU ODOBESCU",3,5146,"ALEXANDRU ODOBESCU",94125,922,724,601,94,29,713,11,1008,284,278,435
12,"CĂLĂRAŞI","#N/A",94125,,83,"GĂLĂŢUI / GRADINITA CU PROGRAM NORMAL NR.3 GALATUI",3,5146,"ALEXANDRU ODOBESCU",94125,281,256,167,76,13,251,5,302,46,135,116
12,"CĂLĂRAŞI","#N/A",101083,,84,"BELCIUGATELE / SCOALA GIMNAZIALA NR. 1 BELCIUGATELE",3,5150,"BELCIUGATELE",101083,1319,1157,817,338,2,1134,23,1458,301,476,658
12,"CĂLĂRAŞI","#N/A",101083,,85,"MĂRIUŢA / SCOALA PRIMARA MARIUTA",3,5150,"BELCIUGATELE",101083,438,382,246,136,0,377,5,482,100,191,186
12,"CĂLĂRAŞI","#N/A",92961,,86,"BORCEA / Scoala gimnaziala nr. 3 Borcea",3,5156,"BORCEA",92961,1017,576,491,85,0,569,7,1121,545,291,278
12,"CĂLĂRAŞI","#N/A",92961,,87,"BORCEA / Gradinita cu program normal nr. 3 Borcea",3,5156,"BORCEA",92961,1062,654,536,118,0,646,8,1200,546,320,326
12,"CĂLĂRAŞI","#N/A",92961,,88,"BORCEA / Liceul tehnologic nr. 1 Borcea clasele I-IV sala A",3,5156,"BORCEA",92961,1534,932,794,138,0,921,11,1725,793,458,463
12,"CĂLĂRAŞI","#N/A",92961,,89,"BORCEA / Liceul tehnologic nr. 1 Borcea clasele I-IV sala B",3,5156,"BORCEA",92961,1640,1001,879,122,0,989,12,1776,775,562,427
12,"CĂLĂRAŞI","#N/A",92961,,90,"BORCEA / Scoala gimnaziala nr. 2 Borcea",3,5156,"BORCEA",92961,1732,928,839,89,0,919,9,1877,949,538,381
12,"CĂLĂRAŞI","#N/A",101724,,91,"CĂSCIOARELE / CAMINUL CULTURAL",3,5158,"CĂSCIOARELE",101724,1597,985,882,91,12,976,9,1762,777,477,499
12,"CĂLĂRAŞI","#N/A",101804,,92,"CHIRNOGI / Scoala cu clasele I-VIII, nr.1",3,5160,"CHIRNOGI",101804,1547,716,657,59,0,687,29,1707,991,425,262
12,"CĂLĂRAŞI","#N/A",101804,,93,"CHIRNOGI / Scoala cu clasele I-VIII, nr.2",3,5160,"CHIRNOGI",101804,1700,941,894,47,0,920,21,1866,925,562,358
12,"CĂLĂRAŞI","#N/A",101804,,94,"CHIRNOGI / Scoala cu clasele I-VIII, nr.2",3,5160,"CHIRNOGI",101804,1621,828,801,27,0,818,10,1780,952,548,270
12,"CĂLĂRAŞI","#N/A",101804,,95,"CHIRNOGI / Scoala cu clasele I-VIII, nr.3",3,5160,"CHIRNOGI",101804,1323,659,615,44,0,654,5,1468,809,405,249
12,"CĂLĂRAŞI","#N/A",101822,,96,"CHISELET / Şcoala Generală nr. 1",3,5162,"CHISELET",101822,644,399,294,105,0,395,4,728,329,243,152
12,"CĂLĂRAŞI","#N/A",101822,,97,"CHISELET / Şcoala Generală nr. 1",3,5162,"CHISELET",101822,1325,641,599,42,0,632,9,1465,824,367,265
12,"CĂLĂRAŞI","#N/A",101822,,98,"CHISELET / Şcoala Generală nr. 2",3,5162,"CHISELET",101822,741,445,382,63,0,437,8,789,344,275,162
12,"CĂLĂRAŞI","#N/A",93085,,99,"CIOCĂNEŞTI / SCOALA SMARDAN",3,5164,"CIOCĂNEŞTI",93085,819,554,429,106,19,545,9,905,351,281,264
12,"CĂLĂRAŞI","#N/A",93085,,100,"CIOCĂNEŞTI / SCOALA MARGINENI",3,5164,"CIOCĂNEŞTI",93085,781,498,393,77,28,492,6,863,365,294,198
12,"CĂLĂRAŞI","#N/A",93085,,101,"CIOCĂNEŞTI / GRADINITA NR.1 SARBI",3,5164,"CIOCĂNEŞTI",93085,1072,740,625,102,13,733,7,1180,440,340,393
12,"CĂLĂRAŞI","#N/A",93085,,102,"CIOCĂNEŞTI / SCOALA ANDOLINA",3,5164,"CIOCĂNEŞTI",93085,881,635,471,103,61,634,1,972,337,303,331
12,"CĂLĂRAŞI","#N/A",180055,,103,"CRIVĂŢ / SCOALA  GIMNAZIALA ""NICOLAE PETRESCU""",3,5166,"CRIVĂŢ",180055,854,572,491,81,0,566,6,942,370,255,311
12,"CĂLĂRAŞI","#N/A",180055,,104,"CRIVĂŢ / SCOALA  GIMNAZIALA ""NICOLAE PETRESCU""",3,5166,"CRIVĂŢ",180055,937,584,506,78,0,577,7,1032,448,254,323
12,"CĂLĂRAŞI","#N/A",102419,,105,"CURCANI / Scoala nr. 1",3,5168,"CURCANI",102419,1083,711,603,107,1,697,14,1190,479,444,253
12,"CĂLĂRAŞI","#N/A",102419,,106,"CURCANI / Scoala nr. 1",3,5168,"CURCANI",102419,943,623,536,87,0,612,11,1039,416,375,237
12,"CĂLĂRAŞI","#N/A",102419,,107,"CURCANI / Scoala nr. 1",3,5168,"CURCANI",102419,1064,681,605,76,0,669,12,1175,494,437,232
12,"CĂLĂRAŞI","#N/A",102419,,108,"CURCANI / Scoala nr. 2",3,5168,"CURCANI",102419,1171,882,749,133,0,871,11,1300,418,412,459
12,"CĂLĂRAŞI","#N/A",93281,,109,"CEACU / ŞCOALA CEACU",3,5171,"CUZA VODA",93281,1094,725,636,89,0,715,10,1200,475,403,312
12,"CĂLĂRAŞI","#N/A",93281,,110,"CUZA VODĂ / ŞCOALA CUZA VODĂ",3,5171,"CUZA VODA",93281,1671,1046,927,119,0,1037,9,1845,799,612,425
12,"CĂLĂRAŞI","#N/A",93281,,111,"CĂLĂRAŞII VECHI / ŞCOALA CĂLĂRAŞI VECHI",3,5171,"CUZA VODA",93281,548,407,350,57,0,403,4,602,195,262,141
12,"CĂLĂRAŞI","#N/A",93325,,112,"DICHISENI / ŞC. GIMNAZIALĂ NR.1 DICHISENI",3,5175,"DICHISENI",93325,771,637,488,117,32,627,10,853,216,250,377
12,"CĂLĂRAŞI","#N/A",93325,,113,"COSLOGENI / ŞC. PRIMARĂ NR.1",3,5175,"DICHISENI",93325,687,512,414,73,25,508,4,750,238,227,281
12,"CĂLĂRAŞI","#N/A",93370,,114,"DOR MĂRUNT / Scoala Nr.2 Dor Marunt Gara",3,5180,"DOR MĂRUNT",93370,1750,918,791,127,0,899,19,1924,1006,390,509
12,"CĂLĂRAŞI","#N/A",93370,,115,"DOR MĂRUNT / Scoala nr.1 Dor Marunt Sat",3,5180,"DOR MĂRUNT",93370,1180,709,565,144,0,702,7,1299,590,300,402
12,"CĂLĂRAŞI","#N/A",93370,,116,"OGORU / Proprietate privata",3,5180,"DOR MĂRUNT",93370,291,251,198,53,0,247,4,318,67,87,160
12,"CĂLĂRAŞI","#N/A",93370,,117,"ÎNFRĂŢIREA / Scoala Infratirea",3,5180,"DOR MĂRUNT",93370,286,203,137,66,0,196,7,317,114,81,115
12,"CĂLĂRAŞI","#N/A",93370,,118,"PELINU / Scoala Pelinu",3,5180,"DOR MĂRUNT",93370,93,62,38,24,0,62,0,112,50,39,23
12,"CĂLĂRAŞI","#N/A",93370,,119,"DÎLGA-GARĂ / Scoala Dalga Gara",3,5180,"DOR MĂRUNT",93370,1065,682,591,91,0,666,16,1180,498,128,538
12,"CĂLĂRAŞI","#N/A",93370,,120,"DÎLGA / Scoala Dalga Sat",3,5180,"DOR MĂRUNT",93370,566,501,370,131,0,497,4,614,113,75,422
12,"CĂLĂRAŞI","#N/A",93441,,121,"DOROBANŢU / Şcoala cu clasele I-VIII Dorobanţu",3,5187,"DOROBANŢU",93441,1248,956,780,176,0,939,14,1378,425,436,503
12,"CĂLĂRAŞI","#N/A",93441,,122,"VĂRĂŞTI / Şcoala cu clasele I-IV Vărăşti",3,5187,"DOROBANŢU",93441,820,648,550,95,3,645,3,900,252,286,359
12,"CĂLĂRAŞI","#N/A",93441,,123,"BOŞNEAGU / Şcoala cu clasele I-IV Boşneagu",3,5187,"DOROBANŢU",93441,326,279,209,70,0,278,1,357,78,121,157
12,"CĂLĂRAŞI","#N/A",93487,,124,"DRAGALINA / Scoala Gimnaziala nr.1 Dragalina",3,5191,"DRAGALINA",93487,1215,617,565,50,2,608,9,1349,732,398,210
12,"CĂLĂRAŞI","#N/A",93487,,125,"DRAGALINA / Scoala Gimnaziala nr.1 Dragalina",3,5191,"DRAGALINA",93487,1233,619,574,44,1,617,2,1360,741,347,270
12,"CĂLĂRAŞI","#N/A",93487,,126,"DRAGALINA / Scoala Gimnaziala nr.1 Dragalina",3,5191,"DRAGALINA",93487,1426,780,720,60,0,773,7,1569,789,539,234
12,"CĂLĂRAŞI","#N/A",93487,,127,"DRAGALINA / Scoala Gimnaziala nr.1 Dragalina",3,5191,"DRAGALINA",93487,1019,504,473,31,0,500,4,1106,602,304,196
12,"CĂLĂRAŞI","#N/A",93487,,128,"DRAJNA NOUĂ / Scoala Gimnaziala nr.1 Drajna Noua",3,5191,"DRAGALINA",93487,1065,645,558,87,0,641,4,1179,534,291,350
12,"CĂLĂRAŞI","#N/A",93487,,129,"CONSTANTIN BRÂNCOVEANU / Scoala Gimnaziala nr.2 Constantin Brancoveanu",3,5191,"DRAGALINA",93487,793,491,380,111,0,490,1,876,385,341,149
12,"CĂLĂRAŞI","#N/A",93539,,130,"DRAGOŞ VODĂ / Scoala gimnaziala nr.1",3,5195,"DRAGOŞ VODĂ",93539,1056,745,645,91,9,741,4,1167,422,341,400
12,"CĂLĂRAŞI","#N/A",93539,,131,"DRAGOŞ VODĂ / Scoala gimnaziala nr.1",3,5195,"DRAGOŞ VODĂ",93539,1050,642,539,103,0,637,5,1151,509,281,356
12,"CĂLĂRAŞI","#N/A",93539,,132,"SOCOALELE / Gradinita cu program normal nr.3",3,5195,"DRAGOŞ VODĂ",93539,199,157,113,44,0,156,1,240,83,50,106
12,"CĂLĂRAŞI","#N/A",102838,,133,"FRĂSINET / Scoala gimnaziala nr.1 Frasinet",3,5199,"FRĂSINET",102838,914,547,439,108,0,537,10,1012,465,248,289
12,"CĂLĂRAŞI","#N/A",102838,,134,"LUPTĂTORI / Scoala primara nr.1 Luptatori",3,5199,"FRĂSINET",102838,497,411,279,132,0,408,3,553,142,173,235
12,"CĂLĂRAŞI","#N/A",102945,,135,"PASĂREA / Scoala Generala Pasarea",3,5206,"FRUMUŞANI",102945,509,448,318,130,0,439,9,561,113,254,185
12,"CĂLĂRAŞI","#N/A",102945,,136,"FRUMUŞANI / Scoala Generala nr 1.Frumusani",3,5206,"FRUMUŞANI",102945,954,568,435,133,0,550,18,1052,484,304,246
12,"CĂLĂRAŞI","#N/A",102945,,137,"FRUMUŞANI / Scoala Generala nr 1.Frumusani",3,5206,"FRUMUŞANI",102945,1006,661,481,180,0,641,20,1107,446,360,281
12,"CĂLĂRAŞI","#N/A",102945,,138,"PĂDURIŞU / Scoala Generala Padurisu",3,5206,"FRUMUŞANI",102945,406,389,194,195,0,386,3,443,54,178,208
12,"CĂLĂRAŞI","#N/A",102945,,139,"ORĂŞTI / Scoala Generala Orasti",3,5206,"FRUMUŞANI",102945,846,587,391,196,0,576,11,932,345,337,239
12,"CĂLĂRAŞI","#N/A",103014,,140,"FUNDENI / Scoala clasele 1-8 Nr. 1",3,5213,"FUNDENI",103014,1261,900,722,178,0,889,11,1400,500,514,375
12,"CĂLĂRAŞI","#N/A",103014,,141,"FUNDENI / Scoala clasele 1-4 Nr. 2",3,5213,"FUNDENI",103014,1252,926,641,285,0,908,18,1377,451,631,277
12,"CĂLĂRAŞI","#N/A",103014,,142,"FUNDENI / Scoala clasele 1-4 Nr. 3",3,5213,"FUNDENI",103014,1238,770,635,135,0,752,18,1360,590,533,219
12,"CĂLĂRAŞI","#N/A",179962,,143,"GĂLBINAŞI / Scoala nr. 1 Galbinasi",3,5215,"GĂLBINAŞI",179962,1836,1304,1098,206,0,1294,10,2021,717,1138,156
12,"CĂLĂRAŞI","#N/A",179962,,144,"GĂLBINAŞI / Scoala nr. 2 Galbinasi",3,5215,"GĂLBINAŞI",179962,832,626,527,99,0,615,11,909,283,510,105
12,"CĂLĂRAŞI","#N/A",93664,,145,"GRĂDIŞTEA / ŞCOALA VECHE",3,5217,"GRĂDIŞTEA",93664,1760,1306,1116,188,2,1297,9,1939,633,546,751
12,"CĂLĂRAŞI","#N/A",93664,,146,"RASA / ŞCOALA VECHE",3,5217,"GRĂDIŞTEA",93664,1045,801,634,164,3,792,9,1149,348,299,493
12,"CĂLĂRAŞI","#N/A",93664,,147,"CUNEŞTI / ŞCOALA CUNEŞTI",3,5217,"GRĂDIŞTEA",93664,724,602,469,130,3,594,8,800,198,282,312
12,"CĂLĂRAŞI","#N/A",93664,,148,"BOGATA / ŞCOALA BOGATA",3,5217,"GRĂDIŞTEA",93664,471,394,313,81,0,384,10,519,125,154,230
12,"CĂLĂRAŞI","#N/A",103568,,149,"GURBĂNEŞTI / SCOALA GIMNAZIALA NR. 1 GURBANESTI",3,5222,"GURBĂNEŞTI",103568,512,411,272,139,0,408,3,581,170,154,254
12,"CĂLĂRAŞI","#N/A",103568,,150,"COŢOFANCA / GRADINITA CU PROGRAM NORMAL COTOFANCA",3,5222,"GURBĂNEŞTI",103568,321,288,182,106,0,283,5,312,24,148,135
12,"CĂLĂRAŞI","#N/A",103568,,151,"VALEA PRESNEI / GRADINITA CU PROGRAM NORMAL VALEA PRESNEI",3,5222,"GURBĂNEŞTI",103568,166,175,104,71,0,175,0,218,43,91,84
12,"CĂLĂRAŞI","#N/A",103764,,152,"ILEANA / SCOALA ILEANA",3,5229,"ILEANA",103764,839,508,379,129,0,500,8,933,425,400,100
12,"CĂLĂRAŞI","#N/A",103764,,153,"FLORICA / SCOALA FLORICA",3,5229,"ILEANA",103764,526,319,249,70,0,313,6,578,259,233,80
12,"CĂLĂRAŞI","#N/A",103764,,154,"ŞTEFĂNEŞTI / SCOALA STEFANESTI",3,5229,"ILEANA",103764,623,407,296,111,0,398,9,690,283,254,144
12,"CĂLĂRAŞI","#N/A",103764,,155,"ARŢARI / SCOALA ARTARI",3,5229,"ILEANA",103764,524,317,241,76,0,312,5,576,259,255,57
12,"CĂLĂRAŞI","#N/A",93771,,156,"INDEPENDENŢA / GRADINITA DE COPII",3,5239,"INDEPENDENŢA",93771,1785,1261,1137,124,0,1243,18,1966,705,662,581
12,"CĂLĂRAŞI","#N/A",93771,,157,"VIŞINII / GRADINITA DE COPII",3,5239,"INDEPENDENŢA",93771,427,305,255,50,0,302,3,466,161,124,178
12,"CĂLĂRAŞI","#N/A",93771,,158,"POTCOAVA / SCOALA GENERALA",3,5239,"INDEPENDENŢA",93771,687,505,404,101,0,503,2,756,251,287,216
12,"CĂLĂRAŞI","#N/A",93815,,159,"JEGĂLIA / SCOALA GIMNAZIALA NR. 1",3,5243,"JEGĂLIA",93815,1629,1068,973,84,11,1060,8,1800,732,422,638
12,"CĂLĂRAŞI","#N/A",93815,,160,"GÎLDĂU / SCOALA PRIMARA NR. 1",3,5243,"JEGĂLIA",93815,1157,734,675,58,1,730,4,1287,553,334,396
12,"CĂLĂRAŞI","#N/A",93815,,161,"IEZERU / SCOALA PRIMARA NR. 2",3,5243,"JEGĂLIA",93815,780,580,504,74,2,577,3,849,269,260,317
12,"CĂLĂRAŞI","#N/A",93851,,162,"LEHLIU / CAMIN CULTURAL",3,5247,"LEHLIU",93851,1419,839,733,106,0,824,15,1566,727,432,392
12,"CĂLĂRAŞI","#N/A",93851,,163,"SĂPUNARI / SCOALA SAPUNARI",3,5247,"LEHLIU",93851,723,423,337,58,28,417,6,800,377,232,185
12,"CĂLĂRAŞI","#N/A",104083,,164,"LUICA / SCOALA CU CLASELE I-VIII LUICA",3,5250,"LUICA",104083,1423,772,660,112,0,755,17,1570,798,487,268
12,"CĂLĂRAŞI","#N/A",104083,,165,"VALEA STÎNII / SCOALA CU CLASELE I-IV VALEA STANII",3,5250,"LUICA",104083,335,265,163,102,0,262,3,369,104,142,120
12,"CĂLĂRAŞI","#N/A",93931,,166,"NUCETU / Gradinita cu program normal nr.4 Nucetu",3,5253,"LUPŞANU",93931,540,381,315,61,5,378,3,590,209,284,94
12,"CĂLĂRAŞI","#N/A",93931,,167,"LUPŞANU / Gradinita cu program normal nr.3 Lupsanu",3,5253,"LUPŞANU",93931,561,310,271,39,0,308,2,623,313,210,98
12,"CĂLĂRAŞI","#N/A",93931,,168,"RADU VODĂ / Scoala Gimnaziala nr.1 Radu-Voda",3,5253,"LUPŞANU",93931,1022,621,524,84,13,614,7,1126,505,463,151
12,"CĂLĂRAŞI","#N/A",93931,,169,"PLEVNA / Scoala Primara nr.1 Plevna",3,5253,"LUPŞANU",93931,562,339,256,83,0,336,3,619,280,243,93
12,"CĂLĂRAŞI","#N/A",104181,,170,"MÂNĂSTIREA / Liceul Tehnologic Matei Basarab",3,5259,"MÂNĂSTIREA",104181,1414,773,710,62,1,752,21,1559,786,384,368
12,"CĂLĂRAŞI","#N/A",104181,,171,"MÂNĂSTIREA / Liceul Tehnologic Matei Basarab",3,5259,"MÂNĂSTIREA",104181,1540,824,767,57,0,815,9,1700,876,418,397
12,"CĂLĂRAŞI","#N/A",104181,,172,"COCONI / Şcoala Generală Coconi",3,5259,"MÂNĂSTIREA",104181,786,436,374,62,0,423,13,866,430,257,166
12,"CĂLĂRAŞI","#N/A",104181,,173,"SULTANA / Şcoala Gimnazială nr. 2 Sultana",3,5259,"MÂNĂSTIREA",104181,802,502,421,81,0,493,9,815,313,268,225
12,"CĂLĂRAŞI","#N/A",100638,,174,"MITRENI / SCOALA GIMNAZIALA NR. 2 MITRENI",3,5263,"MITRENI",100638,1234,766,675,91,0,755,11,1363,597,483,272
12,"CĂLĂRAŞI","#N/A",100638,,175,"VALEA ROŞIE / SCOALA GIMNAZIALA NR. 1 VALEA ROSIE",3,5263,"MITRENI",100638,1919,1081,969,112,0,1066,15,2111,1030,755,311
12,"CĂLĂRAŞI","#N/A",100638,,176,"CLĂTEŞTI / GRADINITA CU PROGRAM NORMAL NR. 3 CLATESTI",3,5263,"MITRENI",100638,466,299,256,43,0,296,3,519,220,166,130
12,"CĂLĂRAŞI","#N/A",92587,,177,"MODELU / SCOALA GENERALA NR.1",3,5267,"MODELU",92587,1596,1042,931,108,3,1031,11,1764,722,451,580
12,"CĂLĂRAŞI","#N/A",92587,,178,"MODELU / SCOALA GENERALA NR.1",3,5267,"MODELU",92587,1710,944,903,39,2,940,4,1880,936,416,524
12,"CĂLĂRAŞI","#N/A",92587,,179,"MODELU / CAMIN CULTURAL",3,5267,"MODELU",92587,1496,907,859,48,0,899,8,1646,739,356,543
12,"CĂLĂRAŞI","#N/A",92587,,180,"MODELU / SCOALA GENERALA NR.2",3,5267,"MODELU",92587,1598,993,949,44,0,984,9,1755,762,466,518
12,"CĂLĂRAŞI","#N/A",92587,,181,"TONEA / SCOALA TONEA",3,5267,"MODELU",92587,1444,806,733,73,0,789,17,1587,781,290,499
12,"CĂLĂRAŞI","#N/A",104323,,182,"NANA / Scoala Gimnaziala nr. 1",3,5272,"NANA",104323,1017,563,470,79,14,556,7,1119,556,365,191
12,"CĂLĂRAŞI","#N/A",104323,,183,"NANA / Scoala Gimnaziala nr. 1",3,5272,"NANA",104323,915,536,478,38,20,528,8,1008,472,379,149
12,"CĂLĂRAŞI","#N/A",104341,,184,"NICOLAE BĂLCESCU / Scoala cu clasele I-VIII",3,5274,"NICOLAE BĂLCESCU",104341,1004,608,503,105,0,599,9,1110,502,294,305
12,"CĂLĂRAŞI","#N/A",104341,,185,"FÎNTÎNA DOAMNEI / Scoala cu clasele  I-IV",3,5274,"NICOLAE BĂLCESCU",104341,257,192,140,52,0,187,5,286,94,111,76
12,"CĂLĂRAŞI","#N/A",94223,,186,"PERIŞORU / PRIMARIA PERISORU",3,5278,"PERIŞORU",94223,1736,973,900,73,0,964,9,1914,941,567,397
12,"CĂLĂRAŞI","#N/A",94223,,187,"PERIŞORU / PRIMARIA PERISORU",3,5278,"PERIŞORU",94223,1886,1014,947,67,0,1006,8,2133,1119,650,356
12,"CĂLĂRAŞI","#N/A",94223,,188,"TUDOR VLADIMIRESCU / SCOALA TUDOR VLADIMIRESCU",3,5278,"PERIŞORU",94223,580,357,313,44,0,354,3,585,228,194,160
12,"CĂLĂRAŞI","#N/A",104635,,189,"PLĂTĂREŞTI / PRIMĂRIA PLĂTĂREŞTI",3,5282,"PLĂTĂREŞTI",104635,1134,938,648,279,11,924,14,1256,318,461,463
12,"CĂLĂRAŞI","#N/A",104635,,190,"DOROBANŢU / ŞCOALA GENERALĂ DOROBANTU",3,5282,"PLĂTĂREŞTI",104635,797,624,424,200,0,617,7,880,256,339,278
12,"CĂLĂRAŞI","#N/A",104635,,191,"CUCUIEŢI / ŞCOALA GENERALĂ CUCUIETI",3,5282,"PLĂTĂREŞTI",104635,480,409,296,113,0,403,6,530,121,194,209
12,"CĂLĂRAŞI","#N/A",104635,,192,"PODU PITARULUI / ŞCOALA GENERALĂ PODUL PITARULUI",3,5282,"PLĂTĂREŞTI",104635,342,364,223,140,1,357,7,380,16,162,195
12,"CĂLĂRAŞI","#N/A",104751,,193,"RADOVANU / Scoala cu clasele I-VIII,,DI GHICA ,, Radovanu",3,5287,"RADOVANU",104751,1025,641,559,71,11,635,6,1127,486,323,312
12,"CĂLĂRAŞI","#N/A",104751,,194,"RADOVANU / Scoala cu clasele I-VIII,,DI GHICA ,, Radovanu",3,5287,"RADOVANU",104751,1042,722,607,113,2,713,9,1163,441,371,342
12,"CĂLĂRAŞI","#N/A",104751,,195,"RADOVANU / Scoala cu clasele I-IV COADELE",3,5287,"RADOVANU",104751,1060,731,630,99,2,723,8,1163,432,390,333
12,"CĂLĂRAŞI","#N/A",104751,,196,"VALEA POPII / Scoala cu clasele I-IV VALEA POPII",3,5287,"RADOVANU",104751,499,357,305,51,1,352,5,546,189,241,111
12,"CĂLĂRAŞI","#N/A",94312,,197,"ROSEŢI / Scoala Generala cu cls I-IV-sector",3,5290,"ROSEŢI",94312,1755,1074,1013,61,0,1042,32,1936,862,539,503
12,"CĂLĂRAŞI","#N/A",94312,,198,"ROSEŢI / Scoala Gimnaziala Iancu Rosetti-centru",3,5290,"ROSEŢI",94312,1313,859,781,78,0,854,5,1446,587,431,423
12,"CĂLĂRAŞI","#N/A",94312,,199,"ROSEŢI / Scoala cu cls. I-IV-Deal",3,5290,"ROSEŢI",94312,1829,1147,1093,54,0,1137,10,2013,866,578,559
12,"CĂLĂRAŞI","#N/A",104886,,200,"SĂRULEŞTI-GARĂ / Gradinita cu 4 grupe",3,5292,"SĂRULEŞTI",104886,1132,830,712,118,0,816,14,1246,416,606,210
12,"CĂLĂRAŞI","#N/A",104886,,201,"SĂNDULIŢA / Scoala cu clasele I-IV",3,5292,"SĂRULEŞTI",104886,477,408,315,93,0,404,4,528,120,304,100
12,"CĂLĂRAŞI","#N/A",104886,,202,"SĂRULEŞTI / Scoala cu clasele I-IV",3,5292,"SĂRULEŞTI",104886,407,287,212,75,0,284,3,455,168,187,97
12,"CĂLĂRAŞI","#N/A",104886,,203,"SOLACOLU / Scoala cu clasele I-IV",3,5292,"SĂRULEŞTI",104886,221,192,144,48,0,189,3,245,53,126,63
12,"CĂLĂRAŞI","#N/A",105222,,204,"SOHATU / Şcoala Generala nr.1",3,5300,"SOHATU",105222,1398,766,586,180,0,749,17,1561,795,486,263
12,"CĂLĂRAŞI","#N/A",105222,,205,"PROGRESU / Şcoala Generala nr.2",3,5300,"SOHATU",105222,837,522,372,150,0,515,7,908,386,377,138
12,"CĂLĂRAŞI","#N/A",105259,,206,"SPANŢOV / SCOALA SPANTOV",3,5306,"SPANŢOV",105259,879,518,457,61,0,509,9,985,467,303,206
12,"CĂLĂRAŞI","#N/A",105259,,207,"CETATEA VECHE / SCOALA CETATEA VECHE",3,5306,"SPANŢOV",105259,715,436,398,38,0,433,3,780,344,277,156
12,"CĂLĂRAŞI","#N/A",105259,,208,"STANCEA / SCOALA  STANCEA",3,5306,"SPANŢOV",105259,1278,634,581,53,0,628,6,1443,809,398,230
12,"CĂLĂRAŞI","#N/A",105259,,209,"STANCEA / SCOALA CLINCIU",3,5306,"SPANŢOV",105259,790,470,440,30,0,466,4,831,361,255,211
12,"CĂLĂRAŞI","#N/A",105384,,210,"ŞOLDANU / ŞCOALA GIMNAZIALĂ ,,CONSTANTIN TEODORESCU'' ŞOLDANU",3,5303,"ŞOLDANU",105384,1811,1278,1097,165,16,1257,21,2000,722,727,530
12,"CĂLĂRAŞI","#N/A",105384,,211,"NEGOEŞTI / ŞCOALA PRIMARĂ NR.1 NEGOEŞTI",3,5303,"ŞOLDANU",105384,838,676,529,143,4,667,9,917,241,362,305
12,"CĂLĂRAŞI","#N/A",94562,,212,"ŞTEFAN CEL MARE / SCOALA GIMNAZIALA DRAGOS MARIN",3,5310,"ŞTEFAN CEL MARE",94562,1554,927,862,51,14,917,10,1711,784,640,277
12,"CĂLĂRAŞI","#N/A",94562,,213,"ŞTEFAN CEL MARE / SCOALA GIMNAZIALA DRAGOS MARIN",3,5310,"ŞTEFAN CEL MARE",94562,1122,703,632,58,13,691,12,1236,533,461,230
12,"CĂLĂRAŞI","#N/A",94580,,214,"ŞTEFAN VODĂ / ŞCOALA CU CLS. I-VIII ŞTEFAN VODĂ",3,5312,"ŞTEFAN VODĂ",94580,1074,771,630,127,14,764,7,1183,412,356,408
12,"CĂLĂRAŞI","#N/A",94580,,215,"ŞTEFAN VODĂ / ŞCOALA CU CLS. I-VIII ŞTEFAN VODĂ",3,5312,"ŞTEFAN VODĂ",94580,823,600,507,83,10,596,4,901,301,277,319
12,"CĂLĂRAŞI","#N/A",105455,,216,"TĂMĂDĂU MARE / Scoala Gimnaziala nr.1",3,5314,"TĂMĂDĂU MARE",105455,1187,759,600,159,0,749,10,1306,547,344,405
12,"CĂLĂRAŞI","#N/A",105455,,217,"PLUMBUITA / Scoala Primara nr.2",3,5314,"TĂMĂDĂU MARE",105455,763,480,374,106,0,471,9,844,364,260,211
12,"CĂLĂRAŞI","#N/A",105605,,218,"ULMENI / Scoala Gimnaziala Grigore Moisil",3,5322,"ULMENI",105605,1414,779,669,110,0,765,14,1561,782,489,276
12,"CĂLĂRAŞI","#N/A",105605,,219,"ULMENI / Scoala Gimnaziala nr.2 Ulmeni",3,5322,"ULMENI",105605,1474,886,639,247,0,877,9,1636,750,374,503
12,"CĂLĂRAŞI","#N/A",105605,,220,"ULMENI / Scoala Primara nr.3 Ulmeni",3,5322,"ULMENI",105605,1349,797,703,94,0,783,14,1467,670,539,244
12,"CĂLĂRAŞI","#N/A",94606,,221,"ULMU / Scoala cu clasele I-VIII Ulmu",3,5324,"ULMU",94606,757,691,493,135,63,677,14,831,140,233,444
12,"CĂLĂRAŞI","#N/A",94606,,222,"FĂUREI / Scoala cu clasele I-IV Faurei",3,5324,"ULMU",94606,372,367,255,80,32,359,8,412,45,100,259
12,"CĂLĂRAŞI","#N/A",94606,,223,"ZIMBRU / Fosta scoala primara Zimbru",3,5324,"ULMU",94606,91,100,62,37,1,100,0,120,20,42,58
12,"CĂLĂRAŞI","#N/A",94651,,224,"UNIREA / SCOALA GIMNAZIALA NR 1 (local langa biserica)",3,5329,"UNIREA",94651,1136,849,712,107,30,844,5,1260,411,537,307
12,"CĂLĂRAŞI","#N/A",94651,,225,"UNIREA / SCOALA GIMNAZIALA NR 1 (local langa Caminul Cultural)",3,5329,"UNIREA",94651,1189,848,746,70,32,842,6,1305,457,480,362
12,"CĂLĂRAŞI","#N/A",105712,,226,"VALEA ARGOVEI / Scoala Gimnaziala Valea Argovei",3,5332,"VALEA ARGOVEI",105712,1414,899,733,162,4,890,9,1565,666,391,499
12,"CĂLĂRAŞI","#N/A",105712,,227,"SILIŞTEA / Scoala Generala Silistea",3,5332,"VALEA ARGOVEI",105712,576,476,369,106,1,469,7,636,160,257,212
12,"CĂLĂRAŞI","#N/A",105829,,228,"VASILAŢI / Scoala Constantin Brancoveanu",3,5338,"VASILAŢI",105829,1089,721,526,159,36,711,10,1200,479,398,313
12,"CĂLĂRAŞI","#N/A",105829,,229,"VASILAŢI / Scoala Constantin Brancoveanu",3,5338,"VASILAŢI",105829,1694,1335,1071,210,54,1315,20,1870,535,911,404
12,"CĂLĂRAŞI","#N/A",105829,,230,"NUCI / Scoala Gimnaziala Nuci",3,5338,"VASILAŢI",105829,288,265,191,69,5,259,6,318,53,179,80
12,"CĂLĂRAŞI","#N/A",105829,,231,"POPEŞTI / Scoala Gimnaziala Popesti",3,5338,"VASILAŢI",105829,295,218,152,66,0,217,1,326,108,134,83
12,"CĂLĂRAŞI","#N/A",94731,,232,"VÎLCELELE / SCOALA GIMNAZIALA                                     FLORENTA ALBU  VILCELELE",3,5342,"VÎLCELELE",94731,972,1324,652,603,69,1312,12,1470,146,555,757
12,"CĂLĂRAŞI","#N/A",94731,,233,"FLOROAICA / CONSILIUL LOCAL VILCELELE",3,5342,"VÎLCELELE",94731,497,794,329,443,22,790,4,853,59,249,541
12,"CĂLĂRAŞI","#N/A",94768,,234,"VLAD ŢEPEŞ / ŞCOALA VLAD ŢEPEŞ",3,5345,"VLAD ŢEPEŞ",94768,1384,861,655,193,13,846,15,1527,666,423,423
12,"CĂLĂRAŞI","#N/A",94768,,235,"MIHAI VITEAZU / GRĂDINIŢA MIHAI VITEAZU",3,5345,"VLAD ŢEPEŞ",94768,400,403,212,191,0,402,1,444,41,198,204
13,"CLUJ",127,54975,,1,"CLUJ-NAPOCA / Colegiul Economic ""Iulian Pop""",1,5349,"MUNICIPIUL CLUJ-NAPOCA",54975,1055,565,23,542,0,559,6,1181,616,46,513
13,"CLUJ",127,54975,,2,"CLUJ-NAPOCA / Colegiul Economic ""Iulian Pop""",1,5349,"MUNICIPIUL CLUJ-NAPOCA",54975,1357,817,748,68,1,801,16,1498,681,198,603
13,"CLUJ",127,54975,,3,"CLUJ-NAPOCA / Colegiul Tehnic de Telecomunicatii  ""Augustin Maior"",",1,5349,"MUNICIPIUL CLUJ-NAPOCA",54975,1670,1355,953,275,127,1338,17,1840,485,277,1061
13,"CLUJ",127,54975,,4,"CLUJ-NAPOCA / Colegiul Tehnic de Telecomunicatii  ""Augustin Maior"",",1,5349,"MUNICIPIUL CLUJ-NAPOCA",54975,1518,1394,922,463,9,1372,22,1670,276,287,1085
13,"CLUJ",127,54975,,5,"CLUJ-NAPOCA / Şcoala  ""Ion Creangă"" ,",1,5349,"MUNICIPIUL CLUJ-NAPOCA",54975,1104,970,721,249,0,956,14,1214,244,243,713
13,"CLUJ",127,54975,,6,"CLUJ-NAPOCA / Şcoala  ""Ion Creangă"" ,",1,5349,"MUNICIPIUL CLUJ-NAPOCA",54975,1626,1278,1048,230,0,1266,12,1600,322,348,918
13,"CLUJ",127,54975,,7,"CLUJ-NAPOCA / Şcoala  ""Ion Creangă"" ,",1,5349,"MUNICIPIUL CLUJ-NAPOCA",54975,1294,925,782,143,0,917,8,1433,508,215,702
13,"CLUJ",127,54975,,8,"CLUJ-NAPOCA / Gradinita Dumbrava Minunata",1,5349,"MUNICIPIUL CLUJ-NAPOCA",54975,1357,842,755,86,1,834,8,1293,451,189,645
13,"CLUJ",127,54975,,9,"CLUJ-NAPOCA / Gradinita ""Dumbrava Minunată""",1,5349,"MUNICIPIUL CLUJ-NAPOCA",54975,1668,1251,1089,162,0,1235,16,1842,591,349,886
13,"CLUJ",127,54975,,10,"CLUJ-NAPOCA / Grădiniţa ""Dumbrava Minunată"" (fosta 66),",1,5349,"MUNICIPIUL CLUJ-NAPOCA",54975,1568,1025,919,105,1,1012,13,1730,705,234,778
13,"CLUJ",127,54975,,11,"CLUJ-NAPOCA / Şcoala ""Iuliu Haţieganu"" (fostă nr.21)",1,5349,"MUNICIPIUL CLUJ-NAPOCA",54975,999,723,583,140,0,719,4,1104,381,150,569
13,"CLUJ",127,54975,,12,"CLUJ-NAPOCA / Grădiniţa ""Albinuţa"" (fostă Căsuţa Poveştilor), str. Grigore Alexandrescu, nr.21/A",1,5349,"MUNICIPIUL CLUJ-NAPOCA",54975,1696,1074,1001,70,3,1059,15,1564,490,315,744
13,"CLUJ",127,54975,,13,"CLUJ-NAPOCA / Şcoala ""Iuliu Haţieganu"" (fostă nr.21)",1,5349,"MUNICIPIUL CLUJ-NAPOCA",54975,915,921,559,227,135,908,13,1009,88,254,654
13,"CLUJ",127,54975,,14,"CLUJ-NAPOCA / Şcoala ""Iuliu Haţieganu"" (fostă nr.21),",1,5349,"MUNICIPIUL CLUJ-NAPOCA",54975,1654,1101,956,145,0,1094,7,1770,669,246,848
13,"CLUJ",127,54975,,15,"CLUJ-NAPOCA / Şcoala ""Iuliu Haţieganu"" (fostă nr.21),",1,5349,"MUNICIPIUL CLUJ-NAPOCA",54975,1960,1234,1152,82,0,1218,16,1755,521,296,922
13,"CLUJ",127,54975,,16,"CLUJ-NAPOCA / Şcoala ""Iuliu Haţieganu"" (fostă nr.21),",1,5349,"MUNICIPIUL CLUJ-NAPOCA",54975,1378,1071,833,237,1,1062,9,1522,451,265,797
13,"CLUJ",127,54975,,17,"CLUJ-NAPOCA / Colegiul Tehnic Napoca",1,5349,"MUNICIPIUL CLUJ-NAPOCA",54975,1610,1346,1001,344,1,1326,20,1773,427,309,1017
13,"CLUJ",127,54975,,18,"CLUJ-NAPOCA / Liceul cu Program Sportiv (fosta Scoala nr.20).",1,5349,"MUNICIPIUL CLUJ-NAPOCA",54975,1659,1295,1132,163,0,1281,14,1823,528,263,1018
13,"CLUJ",127,54975,,19,"CLUJ-NAPOCA / Liceul cu Program Sportiv (fosta Scoala nr.20).",1,5349,"MUNICIPIUL CLUJ-NAPOCA",54975,1590,1141,994,147,0,1126,15,1749,608,210,916
13,"CLUJ",127,54975,,20,"CLUJ-NAPOCA / Liceul cu Program Sportiv (fosta Scoala nr.20).",1,5349,"MUNICIPIUL CLUJ-NAPOCA",54975,1630,1126,1026,100,0,1106,20,1795,669,280,826
13,"CLUJ",127,54975,,21,"CLUJ-NAPOCA / Liceul Teoretic ""Eugen Pora""",1,5349,"MUNICIPIUL CLUJ-NAPOCA",54975,1686,1243,1069,174,0,1224,19,1859,616,317,907
13,"CLUJ",127,54975,,22,"CLUJ-NAPOCA / Liceul Teoretic ""Eugen Pora""",1,5349,"MUNICIPIUL CLUJ-NAPOCA",54975,1695,1249,1098,149,2,1236,13,1870,621,303,933
13,"CLUJ",127,54975,,23,"CLUJ-NAPOCA / Liceul Teoretic ""Eugen Pora""",1,5349,"MUNICIPIUL CLUJ-NAPOCA",54975,957,836,579,255,2,824,12,1053,217,167,657
13,"CLUJ",127,54975,,24,"CLUJ-NAPOCA / Liceul Teoretic ""Eugen Pora""",1,5349,"MUNICIPIUL CLUJ-NAPOCA",54975,1837,1356,1078,278,0,1344,12,2029,673,389,955
13,"CLUJ",127,54975,,25,"CLUJ-NAPOCA / Grădiniţa ""Rază de Soare""",1,5349,"MUNICIPIUL CLUJ-NAPOCA",54975,1591,1663,1056,607,0,1643,20,1743,80,288,1355
13,"CLUJ",127,54975,,26,"CLUJ-NAPOCA / Liceul Teoretic ""Eugen Pora"", str.Mogoşoaia nr.6",1,5349,"MUNICIPIUL CLUJ-NAPOCA",54975,1663,1361,1013,347,1,1345,16,1838,477,325,1020
13,"CLUJ",127,54975,,27,"CLUJ-NAPOCA / Grădiniţa ""Rază de Soare""",1,5349,"MUNICIPIUL CLUJ-NAPOCA",54975,1452,1479,881,598,0,1456,23,1691,212,215,1241
13,"CLUJ",127,54975,,28,"CLUJ-NAPOCA / Grădiniţa ""Rază de Soare""",1,5349,"MUNICIPIUL CLUJ-NAPOCA",54975,1407,1325,804,431,90,1305,20,1553,228,277,1028
13,"CLUJ",127,54975,,29,"CLUJ-NAPOCA / Grădiniţa ""Rază de Soare""",1,5349,"MUNICIPIUL CLUJ-NAPOCA",54975,1264,1200,802,397,1,1180,20,1394,194,265,915
13,"CLUJ",127,54975,,30,"CLUJ-NAPOCA / Sala Sporturilor ""Horea Demian""",1,5349,"MUNICIPIUL CLUJ-NAPOCA",54975,973,771,601,169,1,767,4,1072,301,212,555
13,"CLUJ",127,54975,,31,"CLUJ-NAPOCA / Sala Sporturilor ""Horea Demian""",1,5349,"MUNICIPIUL CLUJ-NAPOCA",54975,1451,1066,888,178,0,1055,11,1594,528,204,851
13,"CLUJ",127,54975,,32,"CLUJ-NAPOCA / Sala Sporturilor ""Horea Demian""",1,5349,"MUNICIPIUL CLUJ-NAPOCA",54975,1383,1168,853,314,1,1153,15,1522,354,209,944
13,"CLUJ",127,54975,,33,"CLUJ-NAPOCA / Centrul Regional de Excelenţă,",1,5349,"MUNICIPIUL CLUJ-NAPOCA",54975,1695,1277,1008,129,140,1260,17,1875,598,343,917
13,"CLUJ",127,54975,,34,"CLUJ-NAPOCA / Liceul Teoretic ""Onisifor Ghibu"",",1,5349,"MUNICIPIUL CLUJ-NAPOCA",54975,1696,1318,1155,163,0,1309,9,1875,557,341,968
13,"CLUJ",127,54975,,35,"CLUJ-NAPOCA / Gradiniţa"" Mica Sirena"" (fostă 64),",1,5349,"MUNICIPIUL CLUJ-NAPOCA",54975,1508,1072,963,109,0,1054,18,1661,589,252,802
13,"CLUJ",127,54975,,36,"CLUJ-NAPOCA / Liceul Teoretic ""Onisifor Ghibu"",",1,5349,"MUNICIPIUL CLUJ-NAPOCA",54975,1541,1089,937,152,0,1079,10,1699,610,267,812
13,"CLUJ",127,54975,,37,"CLUJ-NAPOCA / Liceul Teoretic ""Onisifor Ghibu"",",1,5349,"MUNICIPIUL CLUJ-NAPOCA",54975,1272,953,825,127,1,945,8,1406,453,221,724
13,"CLUJ",127,54975,,38,"CLUJ-NAPOCA / Liceul Teoretic ""Onisifor Ghibu"",",1,5349,"MUNICIPIUL CLUJ-NAPOCA",54975,1750,1378,1155,223,0,1363,15,1932,554,353,1010
13,"CLUJ",127,54975,,39,"CLUJ-NAPOCA / Liceul Teoretic ""Onisifor Ghibu"",",1,5349,"MUNICIPIUL CLUJ-NAPOCA",54975,1338,1091,896,192,3,1079,12,1481,390,307,772
13,"CLUJ",127,54975,,40,"CLUJ-NAPOCA / Gradiniţa ""Licurici"" (fosta Steluţa Fermecată), str.Fântânele nr.46",1,5349,"MUNICIPIUL CLUJ-NAPOCA",54975,1422,1095,924,171,0,1086,9,1569,474,265,821
13,"CLUJ",127,54975,,41,"CLUJ-NAPOCA / Gradiniţa ""Licurici"" (fosta Steluţa Fermecată), str.Fântânele nr.46",1,5349,"MUNICIPIUL CLUJ-NAPOCA",54975,1729,1263,1087,83,93,1255,8,1908,645,296,959
13,"CLUJ",127,54975,,42,"CLUJ-NAPOCA / Institutul de Cercetari în Chimie ""Raluca Ripan""",1,5349,"MUNICIPIUL CLUJ-NAPOCA",54975,1752,1298,1146,152,0,1287,11,1935,637,261,1026
13,"CLUJ",127,54975,,43,"CLUJ-NAPOCA / Gradinita Mica Sirena (fosta 12)",1,5349,"MUNICIPIUL CLUJ-NAPOCA",54975,1508,1082,958,123,1,1073,9,1665,583,314,759
13,"CLUJ",127,54975,,44,"CLUJ-NAPOCA / Institutul de Cercetari în Chimie"" Raluca Ripan"",",1,5349,"MUNICIPIUL CLUJ-NAPOCA",54975,1543,1216,1067,146,3,1209,7,1701,485,258,951
13,"CLUJ",127,54975,,45,"CLUJ-NAPOCA / Institutul de Cercetari în Chimie"" Raluca Ripan"",",1,5349,"MUNICIPIUL CLUJ-NAPOCA",54975,1883,1373,1168,205,0,1359,14,2071,698,324,1035
13,"CLUJ",127,54975,,46,"CLUJ-NAPOCA / Colegiul Tehnic ""Edmond Nicolau""",1,5349,"MUNICIPIUL CLUJ-NAPOCA",54975,916,773,594,179,0,763,10,1005,232,132,631
13,"CLUJ",127,54975,,47,"CLUJ-NAPOCA / Scoala"" Radu Stanca"" (fosta nr. 10),",1,5349,"MUNICIPIUL CLUJ-NAPOCA",54975,1669,1252,1052,199,1,1239,13,1838,586,226,1013
13,"CLUJ",127,54975,,48,"CLUJ-NAPOCA / Scoala"" Radu Stanca"" (fosta nr. 10),",1,5349,"MUNICIPIUL CLUJ-NAPOCA",54975,1621,1322,1065,257,0,1309,13,1792,470,265,1044
13,"CLUJ",127,54975,,49,"CLUJ-NAPOCA / Asociaţia ""Caritatea""",1,5349,"MUNICIPIUL CLUJ-NAPOCA",54975,1506,1430,1086,343,1,1418,12,1634,204,237,1181
13,"CLUJ",127,54975,,50,"CLUJ-NAPOCA / Scoala"" Radu Stanca"" (fosta nr. 10),",1,5349,"MUNICIPIUL CLUJ-NAPOCA",54975,1751,1509,1142,366,1,1499,10,1777,268,296,1203
13,"CLUJ",127,54975,,51,"CLUJ-NAPOCA / Scoala"" Radu Stanca"" (fosta nr. 10),",1,5349,"MUNICIPIUL CLUJ-NAPOCA",54975,1440,1144,948,196,0,1125,19,1587,443,187,938
13,"CLUJ",127,54975,,52,"CLUJ-NAPOCA / Scoala"" Radu Stanca"" (fosta nr. 10),",1,5349,"MUNICIPIUL CLUJ-NAPOCA",54975,1291,1124,824,300,0,1115,9,1429,305,205,910
13,"CLUJ",127,54975,,53,"CLUJ-NAPOCA / Gradiniţa ""Zîna Zorilor"", str.L.Pasteur nr.12",1,5349,"MUNICIPIUL CLUJ-NAPOCA",54975,1937,1638,1179,326,133,1619,19,2130,492,329,1290
13,"CLUJ",127,54975,,54,"CLUJ-NAPOCA / Facultatea de Arhitectură şi Urbanism, str.Observatorului nr.72",1,5349,"MUNICIPIUL CLUJ-NAPOCA",54975,1623,1635,989,646,0,1616,19,1981,346,254,1362
13,"CLUJ",127,54975,,55,"CLUJ-NAPOCA / Facultatea de Arhitectură şi Urbanism, str.Observatorului nr.72",1,5349,"MUNICIPIUL CLUJ-NAPOCA",54975,1451,1453,870,583,0,1438,15,1602,149,232,1206
13,"CLUJ",127,54975,,56,"CLUJ-NAPOCA / Facultatea de Arhitectură şi Urbanism, str.Observatorului nr.72",1,5349,"MUNICIPIUL CLUJ-NAPOCA",54975,1062,1052,699,353,0,1036,16,1172,120,149,887
13,"CLUJ",127,54975,,57,"CLUJ-NAPOCA / Facultatea de Arhitectură şi Urbanism, str.Observatorului nr.72",1,5349,"MUNICIPIUL CLUJ-NAPOCA",54975,1375,1225,877,348,0,1218,7,1518,293,183,1035
13,"CLUJ",127,54975,,58,"CLUJ-NAPOCA / Liceul Informatica ""T.Popoviciu""",1,5349,"MUNICIPIUL CLUJ-NAPOCA",54975,1672,1513,1066,447,0,1499,14,1828,315,262,1237
13,"CLUJ",127,54975,,59,"CLUJ-NAPOCA / Liceul Informatica ""T.Popoviciu""",1,5349,"MUNICIPIUL CLUJ-NAPOCA",54975,1881,1742,1355,387,0,1732,10,2048,306,261,1471
13,"CLUJ",127,54975,,60,"CLUJ-NAPOCA / Liceul Informatica ""T.Popoviciu""",1,5349,"MUNICIPIUL CLUJ-NAPOCA",54975,1328,1090,833,257,0,1072,18,1455,365,182,890
13,"CLUJ",127,54975,,61,"CLUJ-NAPOCA / Palatul Copiilor",1,5349,"MUNICIPIUL CLUJ-NAPOCA",54975,1661,1515,954,464,97,1495,20,1818,303,368,1127
13,"CLUJ",127,54975,,62,"CLUJ-NAPOCA / Scoala  ""Ioan Bob""",1,5349,"MUNICIPIUL CLUJ-NAPOCA",54975,1632,1395,902,491,2,1376,19,1802,407,278,1098
13,"CLUJ",127,54975,,63,"CLUJ-NAPOCA / Colegiul Naţional ""G.Coşbuc""",1,5349,"MUNICIPIUL CLUJ-NAPOCA",54975,1253,998,847,148,3,991,7,1385,387,231,760
13,"CLUJ",127,54975,,64,"CLUJ-NAPOCA / Liceul Teoretic ""Gh. Sincai""",1,5349,"MUNICIPIUL CLUJ-NAPOCA",54975,1627,1509,1109,397,3,1480,29,1800,291,289,1191
13,"CLUJ",127,54975,,65,"CLUJ-NAPOCA / Liceul Teoretic ""Gh. Sincai""",1,5349,"MUNICIPIUL CLUJ-NAPOCA",54975,1487,1349,1081,267,1,1334,15,1630,281,317,1017
13,"CLUJ",127,54975,,66,"CLUJ-NAPOCA / Colegiul Tehnic "" Edmond Nicolau"",",1,5349,"MUNICIPIUL CLUJ-NAPOCA",54975,1452,1160,994,166,0,1151,9,1587,427,178,973
13,"CLUJ",127,54975,,67,"CLUJ-NAPOCA / Colegiul Tehnic "" Edmond Nicolau"",",1,5349,"MUNICIPIUL CLUJ-NAPOCA",54975,1523,992,901,91,0,979,13,1675,683,258,721
13,"CLUJ",127,54975,,68,"CLUJ-NAPOCA / Colegiul Tehnic "" Edmond Nicolau"",",1,5349,"MUNICIPIUL CLUJ-NAPOCA",54975,1548,1035,930,105,0,1023,12,1707,672,275,748
13,"CLUJ",127,54975,,69,"CLUJ-NAPOCA / Colegiul Tehnic "" Edmond Nicolau"",",1,5349,"MUNICIPIUL CLUJ-NAPOCA",54975,1565,1046,973,73,0,1033,13,1725,679,279,754
13,"CLUJ",127,54975,,70,"CLUJ-NAPOCA / Şcoala ""Liviu Rebreanu""",1,5349,"MUNICIPIUL CLUJ-NAPOCA",54975,1659,1261,990,271,0,1248,13,1828,567,317,931
13,"CLUJ",127,54975,,71,"CLUJ-NAPOCA / Gradiniţa ""Universul Copiilor"" (fostă  nr.71)",1,5349,"MUNICIPIUL CLUJ-NAPOCA",54975,1513,1072,909,163,0,1060,12,1665,593,301,759
13,"CLUJ",127,54975,,72,"CLUJ-NAPOCA / Şcoala ""Liviu Rebreanu""",1,5349,"MUNICIPIUL CLUJ-NAPOCA",54975,1689,1148,1030,117,1,1141,7,1862,714,288,853
13,"CLUJ",127,54975,,73,"CLUJ-NAPOCA / Şcoala "" Liviu Rebreanu""( fosta Constantin Brâncoveanu),Aleea Retezat nr.4",1,5349,"MUNICIPIUL CLUJ-NAPOCA",54975,1646,1168,978,190,0,1155,13,1612,444,249,906
13,"CLUJ",127,54975,,74,"CLUJ-NAPOCA / Şcoala "" Liviu Rebreanu"" ( fosta Constantin Brâncoveanu), Aleea Retezat nr.4",1,5349,"MUNICIPIUL CLUJ-NAPOCA",54975,1180,823,726,97,0,815,8,1299,476,183,632
13,"CLUJ",127,54975,,75,"CLUJ-NAPOCA / Şcoala "" Liviu Rebreanu"" ( fosta Constantin Brâncoveanu), Aleea Retezat nr.4",1,5349,"MUNICIPIUL CLUJ-NAPOCA",54975,1460,948,880,68,0,940,8,1614,666,230,710
13,"CLUJ",127,54975,,76,"CLUJ-NAPOCA / Şcoala ""Liviu Rebreanu""",1,5349,"MUNICIPIUL CLUJ-NAPOCA",54975,1731,1094,989,105,0,1087,7,1907,813,274,813
13,"CLUJ",127,54975,,77,"CLUJ-NAPOCA / Şcoala "" Liviu Rebreanu"" ( fosta Constantin Brâncoveanu), Aleea Retezat nr.4",1,5349,"MUNICIPIUL CLUJ-NAPOCA",54975,1036,696,615,81,0,691,5,1139,443,141,550
13,"CLUJ",127,54975,,78,"CLUJ-NAPOCA / Gradiniţa"" Buburuza"" (fostă nr. 70),",1,5349,"MUNICIPIUL CLUJ-NAPOCA",54975,1198,851,694,157,0,844,7,1321,470,202,642
13,"CLUJ",127,54975,,79,"CLUJ-NAPOCA / Gradiniţa"" Buburuza"" (fostă nr. 70),",1,5349,"MUNICIPIUL CLUJ-NAPOCA",54975,1734,1137,1040,97,0,1129,8,1909,772,296,833
13,"CLUJ",127,54975,,80,"CLUJ-NAPOCA / Gradiniţa ""Academia Piticilor""(fostă nr. 72),",1,5349,"MUNICIPIUL CLUJ-NAPOCA",54975,1837,1347,1144,202,1,1332,15,1706,359,361,971
13,"CLUJ",127,54975,,81,"CLUJ-NAPOCA / Gradiniţa ""Academia Piticilor""(fostă nr. 72),",1,5349,"MUNICIPIUL CLUJ-NAPOCA",54975,1576,1049,918,130,1,1036,13,1734,685,259,777
13,"CLUJ",127,54975,,82,"CLUJ-NAPOCA / Fosta Şcoală nr.6,",1,5349,"MUNICIPIUL CLUJ-NAPOCA",54975,1552,987,858,129,0,979,8,1701,714,194,785
13,"CLUJ",127,54975,,83,"CLUJ-NAPOCA / Fosta Şcoală nr.6,",1,5349,"MUNICIPIUL CLUJ-NAPOCA",54975,1632,1102,1027,75,0,1093,9,1797,695,287,806
13,"CLUJ",127,54975,,84,"CLUJ-NAPOCA / Fosta Şcoală nr.6,",1,5349,"MUNICIPIUL CLUJ-NAPOCA",54975,1658,1164,1024,140,0,1155,9,1829,665,309,846
13,"CLUJ",127,54975,,85,"CLUJ-NAPOCA / Fosta Şcoală nr.6,",1,5349,"MUNICIPIUL CLUJ-NAPOCA",54975,1281,874,815,59,0,865,9,1416,542,233,632
13,"CLUJ",127,54975,,86,"CLUJ-NAPOCA / Şcoala ""Octavian Goga""",1,5349,"MUNICIPIUL CLUJ-NAPOCA",54975,1582,1236,951,285,0,1215,21,1741,505,284,931
13,"CLUJ",127,54975,,87,"CLUJ-NAPOCA / Şcoala ""Octavian Goga""",1,5349,"MUNICIPIUL CLUJ-NAPOCA",54975,1525,1115,868,247,0,1106,9,1685,570,208,898
13,"CLUJ",127,54975,,88,"CLUJ-NAPOCA / Şcoala ""Octavian Goga""",1,5349,"MUNICIPIUL CLUJ-NAPOCA",54975,1631,1049,902,147,0,1043,6,1798,749,229,814
13,"CLUJ",127,54975,,89,"CLUJ-NAPOCA / Colegiul Naţional""George Coşbuc"",",1,5349,"MUNICIPIUL CLUJ-NAPOCA",54975,1210,1195,751,279,165,1178,17,1629,434,302,876
13,"CLUJ",127,54975,,90,"CLUJ-NAPOCA / Gradiniţa ""Poieniţa"",",1,5349,"MUNICIPIUL CLUJ-NAPOCA",54975,1724,1355,1153,201,1,1332,23,1894,539,325,1007
13,"CLUJ",127,54975,,91,"CLUJ-NAPOCA / Colegiul Naţional""George Coşbuc"",",1,5349,"MUNICIPIUL CLUJ-NAPOCA",54975,1049,850,653,195,2,838,12,1152,302,193,645
13,"CLUJ",127,54975,,92,"CLUJ-NAPOCA / Gradiniţa ""Poienţa"",",1,5349,"MUNICIPIUL CLUJ-NAPOCA",54975,1380,1205,976,228,1,1190,15,1498,293,213,977
13,"CLUJ",127,54975,,93,"CLUJ-NAPOCA / Gradiniţa ""Poienţa"",",1,5349,"MUNICIPIUL CLUJ-NAPOCA",54975,1738,1304,1076,227,1,1287,17,1909,605,227,1060
13,"CLUJ",127,54975,,94,"CLUJ-NAPOCA / Şcoala ""Constantin Brâncuşi""",1,5349,"MUNICIPIUL CLUJ-NAPOCA",54975,1436,1164,895,261,8,1150,14,1572,408,251,899
13,"CLUJ",127,54975,,95,"CLUJ-NAPOCA / Şcoala ""Constantin Brâncuşi""",1,5349,"MUNICIPIUL CLUJ-NAPOCA",54975,1658,1219,1077,139,3,1209,10,1832,613,287,922
13,"CLUJ",127,54975,,96,"CLUJ-NAPOCA / Şcoala ""Constantin Brâncuşi""",1,5349,"MUNICIPIUL CLUJ-NAPOCA",54975,871,660,557,102,1,651,9,963,303,189,462
13,"CLUJ",127,54975,,97,"CLUJ-NAPOCA / Şcoala ""Constantin Brâncuşi""",1,5349,"MUNICIPIUL CLUJ-NAPOCA",54975,1571,1131,967,164,0,1119,12,1730,599,314,805
13,"CLUJ",127,54975,,98,"CLUJ-NAPOCA / Grădiniţa ""Lumea Copiilor"", str.Septimiu Albini nr 53",1,5349,"MUNICIPIUL CLUJ-NAPOCA",54975,985,785,644,140,1,772,13,1082,297,141,631
13,"CLUJ",127,54975,,99,"CLUJ-NAPOCA / Creşa ""Castelul Fermecat"", str.Septimiu Albini nr.91",1,5349,"MUNICIPIUL CLUJ-NAPOCA",54975,1518,1180,995,179,6,1162,18,1673,493,255,907
13,"CLUJ",127,54975,,100,"CLUJ-NAPOCA / Creşa ""Castelul Fermecat"", str.Septimiu Albini nr.91",1,5349,"MUNICIPIUL CLUJ-NAPOCA",54975,1627,1091,1000,90,1,1074,17,1796,705,256,818
13,"CLUJ",127,54975,,101,"CLUJ-NAPOCA / Grădiniţa "" Lumea Copiilor"" (fostă nr. 20),",1,5349,"MUNICIPIUL CLUJ-NAPOCA",54975,1761,1164,967,196,1,1148,16,1942,778,266,882
13,"CLUJ",127,54975,,102,"CLUJ-NAPOCA / Grădiniţa "" Lumea Copiilor"" (fostă nr. 20),",1,5349,"MUNICIPIUL CLUJ-NAPOCA",54975,1647,1194,1002,192,0,1173,21,1811,617,239,934
13,"CLUJ",127,54975,,103,"CLUJ-NAPOCA / Liceul Teoretic ""Lucian Blaga""",1,5349,"MUNICIPIUL CLUJ-NAPOCA",54975,1698,1292,1041,250,1,1287,5,1865,573,316,971
13,"CLUJ",127,54975,,104,"CLUJ-NAPOCA / Liceul Teoretic ""Lucian Blaga""",1,5349,"MUNICIPIUL CLUJ-NAPOCA",54975,1399,1131,896,233,2,1114,17,1547,416,310,804
13,"CLUJ",127,54975,,105,"CLUJ-NAPOCA / Liceul Teoretic ""Lucian Blaga""",1,5349,"MUNICIPIUL CLUJ-NAPOCA",54975,1371,933,812,121,0,915,18,1513,580,240,675
13,"CLUJ",127,54975,,106,"CLUJ-NAPOCA / Liceul Teoretic ""Lucian Blaga""",1,5349,"MUNICIPIUL CLUJ-NAPOCA",54975,1573,1121,976,145,0,1110,11,1734,613,304,806
13,"CLUJ",127,54975,,107,"CLUJ-NAPOCA / Şcoala "" N.Titulescu""",1,5349,"MUNICIPIUL CLUJ-NAPOCA",54975,1759,1266,1048,218,0,1259,7,1934,668,343,916
13,"CLUJ",127,54975,,108,"CLUJ-NAPOCA / Liceul Tehnologic ""Al. Borza""",1,5349,"MUNICIPIUL CLUJ-NAPOCA",54975,1360,1263,899,364,0,1253,10,1490,227,274,979
13,"CLUJ",127,54975,,109,"CLUJ-NAPOCA / Şcoala "" N.Titulescu""",1,5349,"MUNICIPIUL CLUJ-NAPOCA",54975,1563,1127,961,165,1,1111,16,1720,593,343,768
13,"CLUJ",127,54975,,110,"CLUJ-NAPOCA / Colegiul Tehnic de Transporturi"" Transilvania""",1,5349,"MUNICIPIUL CLUJ-NAPOCA",54975,1565,1223,1003,220,0,1214,9,1723,500,284,930
13,"CLUJ",127,54975,,111,"CLUJ-NAPOCA / Colegiul Tehnic de Transporturi"" Transilvania""",1,5349,"MUNICIPIUL CLUJ-NAPOCA",54975,1959,1483,1324,159,0,1475,8,2165,682,327,1148
13,"CLUJ",127,54975,,112,"CLUJ-NAPOCA / Colegiul tehnic ""Energetic""",1,5349,"MUNICIPIUL CLUJ-NAPOCA",54975,1663,1414,1106,307,1,1400,14,1832,418,401,999
13,"CLUJ",127,54975,,113,"CLUJ-NAPOCA / Liceul Tehnologic ""Al. Borza""",1,5349,"MUNICIPIUL CLUJ-NAPOCA",54975,1085,997,673,323,1,985,12,1192,195,221,764
13,"CLUJ",127,54975,,114,"CLUJ-NAPOCA / Universitatea ""Babes-Bolyai"" - Facultatea de Ştiinţe Economice şi Gestiunea Afacerilor,",1,5349,"MUNICIPIUL CLUJ-NAPOCA",54975,1909,2140,1237,903,0,2122,18,2399,259,335,1787
13,"CLUJ",127,54975,,115,"CLUJ-NAPOCA / Universitatea ""Babes-Bolyai"" - Facultatea de Ştiinţe Economice şi Gestiunea Afacerilor,",1,5349,"MUNICIPIUL CLUJ-NAPOCA",54975,1386,1524,825,699,0,1500,24,2175,651,285,1215
13,"CLUJ",127,54975,,116,"CLUJ-NAPOCA / Şcoala ""Ion Agârbiceanu"",",1,5349,"MUNICIPIUL CLUJ-NAPOCA",54975,1311,1069,837,232,0,1061,8,1447,378,225,836
13,"CLUJ",127,54975,,117,"CLUJ-NAPOCA / Şcoala ""Ion Agârbiceanu"",",1,5349,"MUNICIPIUL CLUJ-NAPOCA",54975,1429,1035,911,124,0,1026,9,1570,535,214,812
13,"CLUJ",127,54975,,118,"CLUJ-NAPOCA / Şcoala ""Ion Agârbiceanu"",",1,5349,"MUNICIPIUL CLUJ-NAPOCA",54975,1494,1128,937,191,0,1119,9,1641,513,228,891
13,"CLUJ",127,54975,,119,"CLUJ-NAPOCA / Şcoala ""Ion Agârbiceanu"",",1,5349,"MUNICIPIUL CLUJ-NAPOCA",54975,1429,1429,918,511,0,1420,9,1584,155,266,1154
13,"CLUJ",127,54975,,120,"CLUJ-NAPOCA / Grădinţa ""Mămaruţa""  (fostă nr. 42),",1,5349,"MUNICIPIUL CLUJ-NAPOCA",54975,1704,1318,1117,201,0,1307,11,1873,555,290,1017
13,"CLUJ",127,54975,,121,"CLUJ-NAPOCA / Colegiul tehnic ""Anghel Saligny"",",1,5349,"MUNICIPIUL CLUJ-NAPOCA",54975,1513,1426,962,464,0,1404,22,1864,438,319,1085
13,"CLUJ",127,54975,,122,"CLUJ-NAPOCA / Colegiul tehnic ""Anghel Saligny"",",1,5349,"MUNICIPIUL CLUJ-NAPOCA",54975,1305,1154,854,300,0,1137,17,1638,484,256,881
13,"CLUJ",127,54975,,123,"CLUJ-NAPOCA / Colegiul tehnic ""Anghel Saligny"",",1,5349,"MUNICIPIUL CLUJ-NAPOCA",54975,1582,1255,986,221,48,1244,11,1546,291,243,1001
13,"CLUJ",127,54975,,124,"CLUJ-NAPOCA / Şcoala ""Ion Agârbiceanu"",",1,5349,"MUNICIPIUL CLUJ-NAPOCA",54975,1466,1091,933,158,0,1079,12,1610,519,236,843
13,"CLUJ",127,54975,,125,"CLUJ-NAPOCA / Şcoala ""Ion Agârbiceanu"",",1,5349,"MUNICIPIUL CLUJ-NAPOCA",54975,1415,968,880,88,0,956,12,1557,589,194,762
13,"CLUJ",127,54975,,126,"CLUJ-NAPOCA / Liceul Teoretic ""MihaI Eminescu""",1,5349,"MUNICIPIUL CLUJ-NAPOCA",54975,1648,1192,969,196,27,1177,15,1810,618,284,893
13,"CLUJ",127,54975,,127,"CLUJ-NAPOCA / Liceul de Arte Plastice""Romulus Ladea"",",1,5349,"MUNICIPIUL CLUJ-NAPOCA",54975,1773,1590,1108,376,106,1574,16,1959,369,494,1080
13,"CLUJ",127,54975,,128,"CLUJ-NAPOCA / Liceul de Arte Plastice""Romulus Ladea"",",1,5349,"MUNICIPIUL CLUJ-NAPOCA",54975,1192,1098,833,265,0,1080,18,1310,212,257,823
13,"CLUJ",127,54975,,129,"CLUJ-NAPOCA / Liceul de Arte Plastice""Romulus Ladea"",",1,5349,"MUNICIPIUL CLUJ-NAPOCA",54975,1471,1173,956,217,0,1161,12,1618,445,235,926
13,"CLUJ",127,54975,,130,"CLUJ-NAPOCA / Liceul de Arte Plastice""Romulus Ladea"",",1,5349,"MUNICIPIUL CLUJ-NAPOCA",54975,1349,1023,852,171,0,1013,10,1475,452,204,809
13,"CLUJ",127,54975,,131,"CLUJ-NAPOCA / Liceul de Muzică ""Sigismund Toduţă"" (fostul Grup Scolar de Material Rulant- Unirea)",1,5349,"MUNICIPIUL CLUJ-NAPOCA",54975,1688,1337,1063,274,0,1323,14,1854,517,266,1057
13,"CLUJ",127,54975,,132,"CLUJ-NAPOCA / Liceul Teoretic ""A. Iancu"",",1,5349,"MUNICIPIUL CLUJ-NAPOCA",54975,1530,1154,930,224,0,1138,16,1681,527,260,878
13,"CLUJ",127,54975,,133,"CLUJ-NAPOCA / Liceul de Muzică ""Sigismund Toduţă"" (fostul Grup Scolar de Material Rulant- Unirea)",1,5349,"MUNICIPIUL CLUJ-NAPOCA",54975,944,706,532,173,1,699,7,1039,333,190,509
13,"CLUJ",127,54975,,134,"CLUJ-NAPOCA /  Liceul ""Victor Babeş"" (fosta Scoala ""David Prodan""),",1,5349,"MUNICIPIUL CLUJ-NAPOCA",54975,1644,1048,959,89,0,1036,12,1807,759,189,847
13,"CLUJ",127,54975,,135,"CLUJ-NAPOCA / Seminarul Teologic Ortodox (fostă Şcoala ""David Prodan""),",1,5349,"MUNICIPIUL CLUJ-NAPOCA",54975,1524,1057,908,149,0,1049,8,1664,607,187,862
13,"CLUJ",127,54975,,136,"CLUJ-NAPOCA / Şcoala ""Horea""",1,5349,"MUNICIPIUL CLUJ-NAPOCA",54975,1629,1447,918,529,0,1432,15,1796,349,344,1088
13,"CLUJ",127,54975,,137,"CLUJ-NAPOCA / Liceul Teoretic ""N. Balcescu"",",1,5349,"MUNICIPIUL CLUJ-NAPOCA",54975,1464,1540,809,600,131,1520,20,1823,283,366,1154
13,"CLUJ",127,54975,,138,"CLUJ-NAPOCA / Liceul  Teoretic Unitarian"" Janos Zsigmond""",1,5349,"MUNICIPIUL CLUJ-NAPOCA",54975,1420,1810,781,1026,3,1790,20,1873,63,261,1529
13,"CLUJ",127,54975,,139,"CLUJ-NAPOCA / Şcoala ""Ion Agârbiceanu"",",1,5349,"MUNICIPIUL CLUJ-NAPOCA",54975,830,556,462,94,0,550,6,910,354,124,426
13,"CLUJ",127,54975,,140,"CLUJ-NAPOCA / Pavilionul ""Expo Transilvania""",1,5349,"MUNICIPIUL CLUJ-NAPOCA",54975,1828,1347,1162,185,0,1327,20,2004,657,287,1040
13,"CLUJ",127,54975,,141,"CLUJ-NAPOCA / Pavilionul ""Expo Transilvania""",1,5349,"MUNICIPIUL CLUJ-NAPOCA",54975,1085,952,687,265,0,937,15,1197,245,195,742
13,"CLUJ",127,54975,,142,"CLUJ-NAPOCA / Pavilionul ""Expo Transilvania""",1,5349,"MUNICIPIUL CLUJ-NAPOCA",54975,1663,1376,1095,280,1,1362,14,1838,462,290,1072
13,"CLUJ",127,54975,,143,"CLUJ-NAPOCA / Pavilionul ""Expo Transilvania""",1,5349,"MUNICIPIUL CLUJ-NAPOCA",54975,1536,1088,925,163,0,1071,17,1685,597,228,843
13,"CLUJ",127,54975,,144,"CLUJ-NAPOCA / Pavilionul ""Expo Transilvania""",1,5349,"MUNICIPIUL CLUJ-NAPOCA",54975,1480,1103,844,259,0,1098,5,1632,529,185,913
13,"CLUJ",127,54975,,145,"CLUJ-NAPOCA / Pavilionul ""Expo Transilvania""",1,5349,"MUNICIPIUL CLUJ-NAPOCA",54975,1622,1199,931,267,1,1188,11,1783,584,227,961
13,"CLUJ",127,54975,,146,"CLUJ-NAPOCA / Pavilionul ""Expo Transilvania""",1,5349,"MUNICIPIUL CLUJ-NAPOCA",54975,1814,1327,1101,226,0,1311,16,1994,667,282,1029
13,"CLUJ",127,54975,,147,"CLUJ-NAPOCA / Grădiniţa ""Degeţica""  (fostă nr. 53),",1,5349,"MUNICIPIUL CLUJ-NAPOCA",54975,1479,1061,908,153,0,1045,16,1636,575,216,829
13,"CLUJ",127,54975,,148,"CLUJ-NAPOCA / Grădiniţa ""Degeţica""  (fostă nr. 53),",1,5349,"MUNICIPIUL CLUJ-NAPOCA",54975,1634,1112,986,126,0,1100,12,1800,688,176,924
13,"CLUJ",127,54975,,149,"CLUJ-NAPOCA / Şcoala "" Al.Vaida Voevod"",",1,5349,"MUNICIPIUL CLUJ-NAPOCA",54975,1716,1249,1058,191,0,1242,7,1882,633,216,1026
13,"CLUJ",127,54975,,150,"CLUJ-NAPOCA / Şcoala "" Al.Vaida Voevod"",",1,5349,"MUNICIPIUL CLUJ-NAPOCA",54975,1676,1151,1065,86,0,1143,8,1851,700,197,946
13,"CLUJ",127,54975,,151,"CLUJ-NAPOCA / Şcoala "" Al.Vaida Voevod"",",1,5349,"MUNICIPIUL CLUJ-NAPOCA",54975,1460,973,893,80,0,967,6,1605,632,195,772
13,"CLUJ",127,54975,,152,"CLUJ-NAPOCA / Şcoala "" Al.Vaida Voevod"",",1,5349,"MUNICIPIUL CLUJ-NAPOCA",54975,1266,889,755,134,0,881,8,1392,503,181,700
13,"CLUJ",127,54975,,153,"CLUJ-NAPOCA / Şcoala "" Al.Vaida Voevod"",",1,5349,"MUNICIPIUL CLUJ-NAPOCA",54975,1313,960,770,190,0,951,9,1443,483,177,774
13,"CLUJ",127,54975,,154,"CLUJ-NAPOCA / Grup Şcolar  ""Samus""",1,5349,"MUNICIPIUL CLUJ-NAPOCA",54975,1754,1267,1082,185,0,1257,10,1940,673,290,967
13,"CLUJ",127,54975,,155,"CLUJ-NAPOCA / Grup Şcolar  ""Samus""",1,5349,"MUNICIPIUL CLUJ-NAPOCA",54975,1664,1185,1014,171,0,1179,6,1830,645,210,969
13,"CLUJ",127,54975,,156,"CLUJ-NAPOCA / Grup Şcolar  ""Samus""",1,5349,"MUNICIPIUL CLUJ-NAPOCA",54975,1629,1216,982,234,0,1207,9,1799,583,280,927
13,"CLUJ",127,54975,,157,"CLUJ-NAPOCA / Colegiul tehnic ""Ana Aslan""( fostul Grup Sc. Chimie Ind ""Terapia"" ),",1,5349,"MUNICIPIUL CLUJ-NAPOCA",54975,1642,1061,815,181,65,1043,18,1807,746,249,794
13,"CLUJ",127,54975,,158,"CLUJ-NAPOCA / Colegiul tehnic ""Ana Aslan""( fostul Grup Sc. Chimie Ind ""Terapia"" ),",1,5349,"MUNICIPIUL CLUJ-NAPOCA",54975,1613,1069,950,117,2,1059,10,1779,710,281,778
13,"CLUJ",127,54975,,159,"CLUJ-NAPOCA / Eparhia Reformată din Ardeal , str.Horea nr.51",1,5349,"MUNICIPIUL CLUJ-NAPOCA",54975,1315,1003,701,300,2,996,7,1453,450,242,754
13,"CLUJ",127,54975,,160,"CLUJ-NAPOCA / Şcoala ""Horea"" (fostă nr.27)",1,5349,"MUNICIPIUL CLUJ-NAPOCA",54975,1604,1230,1028,201,1,1214,16,1769,539,227,987
13,"CLUJ",127,54975,,161,"CLUJ-NAPOCA / Liceul Teologic ""Emanuel""",1,5349,"MUNICIPIUL CLUJ-NAPOCA",54975,1651,1248,1076,172,0,1235,13,1808,560,243,992
13,"CLUJ",127,54975,,162,"CLUJ-NAPOCA / Liceul Teologic ""Emanuel""",1,5349,"MUNICIPIUL CLUJ-NAPOCA",54975,1581,1012,959,53,0,1005,7,1741,729,198,807
13,"CLUJ",127,54975,,163,"CLUJ-NAPOCA / Grădiniţa ""Neghiniţă""",1,5349,"MUNICIPIUL CLUJ-NAPOCA",54975,1675,1095,980,115,0,1087,8,1834,739,233,854
13,"CLUJ",127,54975,,164,"CLUJ-NAPOCA / Grădiniţa ""Neghiniţă""",1,5349,"MUNICIPIUL CLUJ-NAPOCA",54975,1406,859,791,68,0,855,4,1551,692,169,686
13,"CLUJ",127,54975,,165,"CLUJ-NAPOCA / Grădiniţa ""Neghiniţă""",1,5349,"MUNICIPIUL CLUJ-NAPOCA",54975,1594,1167,995,172,0,1154,13,1750,583,239,915
13,"CLUJ",127,54975,,166,"CLUJ-NAPOCA / Grădiniţa ""Neghiniţă""",1,5349,"MUNICIPIUL CLUJ-NAPOCA",54975,1652,1130,1012,117,1,1122,8,1817,687,255,867
13,"CLUJ",127,54975,,167,"CLUJ-NAPOCA / Şcoala ""Emil Isac""",1,5349,"MUNICIPIUL CLUJ-NAPOCA",54975,1575,1098,991,105,2,1089,9,1738,640,220,869
13,"CLUJ",127,54975,,168,"CLUJ-NAPOCA / Şcoala ""Emil Isac""",1,5349,"MUNICIPIUL CLUJ-NAPOCA",54975,1015,681,581,99,1,673,8,1120,439,184,489
13,"CLUJ",127,54975,,169,"CLUJ-NAPOCA / Şcoala ""Nicolae Iorga""",1,5349,"MUNICIPIUL CLUJ-NAPOCA",54975,1637,1177,956,221,0,1170,7,1800,623,246,924
13,"CLUJ",127,54975,,170,"CLUJ-NAPOCA / Şcoala ""Nicolae Iorga""",1,5349,"MUNICIPIUL CLUJ-NAPOCA",54975,1609,1034,949,85,0,1032,2,1770,736,225,807
13,"CLUJ",127,54975,,171,"CLUJ-NAPOCA / Şcoala ""Nicolae Iorga""",1,5349,"MUNICIPIUL CLUJ-NAPOCA",54975,1648,1206,1019,65,122,1196,10,1810,604,248,948
13,"CLUJ",127,54975,,172,"CLUJ-NAPOCA / Şcoala ""Nicolae Iorga""",1,5349,"MUNICIPIUL CLUJ-NAPOCA",54975,1450,915,843,72,0,906,9,1581,666,147,759
13,"CLUJ",127,54975,,173,"CLUJ-NAPOCA / Liceul Tehnologic nr.1 (fostul Grup Şcolar Tehnofrig), str.Maramureşului nr.165/A",1,5349,"MUNICIPIUL CLUJ-NAPOCA",54975,1675,961,845,116,0,952,9,1637,676,173,779
13,"CLUJ",127,54975,,174,"CLUJ-NAPOCA / Liceul Tehnologic nr.1 (fostul Grup Şcolar Tehnofrig), str.Maramureşului nr.165/A",1,5349,"MUNICIPIUL CLUJ-NAPOCA",54975,1375,964,795,169,0,958,6,1497,533,157,801
13,"CLUJ",127,54975,,175,"CLUJ-NAPOCA / Liceul Tehnologic ""Aurel Vlaicu""",1,5349,"MUNICIPIUL CLUJ-NAPOCA",54975,1184,848,671,176,1,842,6,1302,454,131,711
13,"CLUJ",127,54975,,176,"CLUJ-NAPOCA / Liceul Tehnologic  ""Aurel Vlaicu""",1,5349,"MUNICIPIUL CLUJ-NAPOCA",54975,1681,987,914,73,0,984,3,1848,861,174,810
13,"CLUJ",127,54975,,177,"CLUJ-NAPOCA / Garaje Compania de Transport Public Cluj-Napoca S.A.",1,5349,"MUNICIPIUL CLUJ-NAPOCA",54975,1775,1156,1067,89,0,1141,15,1950,794,197,944
13,"CLUJ",127,54975,,178,"CLUJ-NAPOCA / Şcoala ""Traian Darjan""",1,5349,"MUNICIPIUL CLUJ-NAPOCA",54975,1633,1272,995,169,108,1262,10,1793,521,291,971
13,"CLUJ",127,54975,,179,"CLUJ-NAPOCA / Şcoala ""Traian Darjan""",1,5349,"MUNICIPIUL CLUJ-NAPOCA",54975,1622,1246,1019,128,99,1233,13,1779,533,243,990
13,"CLUJ",127,54975,,180,"CLUJ-NAPOCA / Şcoala ""Traian Darjan""",1,5349,"MUNICIPIUL CLUJ-NAPOCA",54975,1703,1213,1092,57,64,1206,7,1867,654,257,949
13,"CLUJ",127,54975,,181,"CLUJ-NAPOCA / Şcoala ""Traian Darjan""",1,5349,"MUNICIPIUL CLUJ-NAPOCA",54975,1361,1008,876,63,69,998,10,1495,487,228,770
13,"CLUJ",127,55357,,182,"CÂMPIA TURZII / Colegiul Tehnic Victor Ungureanu",1,5351,"MUNICIPIUL CÂMPIA TURZII",55357,1222,561,513,48,0,553,8,1343,782,227,326
13,"CLUJ",127,55357,,183,"CÂMPIA TURZII / Colegiul Tehnic Victor Ungureanu",1,5351,"MUNICIPIUL CÂMPIA TURZII",55357,1239,693,655,38,0,684,9,1365,672,240,444
13,"CLUJ",127,55357,,184,"CÂMPIA TURZII / Colegiul Tehnic Victor Ungureanu",1,5351,"MUNICIPIUL CÂMPIA TURZII",55357,1294,684,650,34,0,676,8,1422,738,244,432
13,"CLUJ",127,55357,,185,"CÂMPIA TURZII / Liceul Teroretic Pavel Dan",1,5351,"MUNICIPIUL CÂMPIA TURZII",55357,932,551,520,31,0,548,3,1025,474,174,374
13,"CLUJ",127,55357,,186,"CÂMPIA TURZII / Liceul Teroretic Pavel Dan",1,5351,"MUNICIPIUL CÂMPIA TURZII",55357,976,523,500,22,1,515,8,1075,552,186,329
13,"CLUJ",127,55357,,187,"CÂMPIA TURZII / Liceul Teroretic Pavel Dan",1,5351,"MUNICIPIUL CÂMPIA TURZII",55357,1036,554,509,45,0,547,7,1143,589,200,347
13,"CLUJ",127,55357,,188,"CÂMPIA TURZII / Liceul Teroretic Pavel Dan",1,5351,"MUNICIPIUL CÂMPIA TURZII",55357,1405,803,756,47,0,792,11,1547,744,228,564
13,"CLUJ",127,55357,,189,"CÂMPIA TURZII / Liceul Teroretic Pavel Dan",1,5351,"MUNICIPIUL CÂMPIA TURZII",55357,1120,648,556,92,0,642,6,1237,589,246,396
13,"CLUJ",127,55357,,190,"CÂMPIA TURZII / Liceul Teroretic Pavel Dan",1,5351,"MUNICIPIUL CÂMPIA TURZII",55357,1231,720,662,58,0,706,14,1348,628,259,447
13,"CLUJ",127,55357,,191,"CÂMPIA TURZII / Scoala Gimnaziala Avram Iancu",1,5351,"MUNICIPIUL CÂMPIA TURZII",55357,1289,760,712,48,0,754,6,1423,663,269,485
13,"CLUJ",127,55357,,192,"CÂMPIA TURZII / Scoala Gimnaziala Avram Iancu",1,5351,"MUNICIPIUL CÂMPIA TURZII",55357,1335,808,756,34,18,797,11,1466,658,279,518
13,"CLUJ",127,55357,,193,"CÂMPIA TURZII / Scoala Gimnaziala Avram Iancu",1,5351,"MUNICIPIUL CÂMPIA TURZII",55357,1161,686,656,30,0,680,6,1280,594,211,469
13,"CLUJ",127,55357,,194,"CÂMPIA TURZII / Gradinita Pinochio",1,5351,"MUNICIPIUL CÂMPIA TURZII",55357,1365,775,738,33,4,765,10,1500,725,256,509
13,"CLUJ",127,55357,,195,"CÂMPIA TURZII / Gradinita Pinochio",1,5351,"MUNICIPIUL CÂMPIA TURZII",55357,1417,771,741,30,0,765,6,1560,789,228,537
13,"CLUJ",127,55357,,196,"CÂMPIA TURZII / Gradinita Pinochio",1,5351,"MUNICIPIUL CÂMPIA TURZII",55357,1391,777,744,33,0,767,10,1524,747,258,509
13,"CLUJ",127,55357,,197,"CÂMPIA TURZII / Scoala Gimnaziala Mihai Viteazu",1,5351,"MUNICIPIUL CÂMPIA TURZII",55357,1151,647,615,32,0,639,8,1267,620,198,441
13,"CLUJ",127,55357,,198,"CÂMPIA TURZII / Scoala Gimnaziala Mihai Viteazu",1,5351,"MUNICIPIUL CÂMPIA TURZII",55357,1624,876,825,51,0,872,4,1786,910,323,549
13,"CLUJ",127,55357,,199,"CÂMPIA TURZII / Scoala Gimnaziala Mihai Viteazu",1,5351,"MUNICIPIUL CÂMPIA TURZII",55357,1484,819,784,34,1,807,12,1640,821,299,508
13,"CLUJ",127,55357,,200,"CÂMPIA TURZII / Scoala Gimnaziala Mihai Viteazu",1,5351,"MUNICIPIUL CÂMPIA TURZII",55357,1306,634,596,38,0,632,2,1433,799,200,432
13,"CLUJ",127,55008,,201,"DEJ / S.C. VASROM S.R.L DEJ",1,5353,"MUNICIPIUL DEJ",55008,1249,743,700,43,0,732,11,1370,627,300,432
13,"CLUJ",127,55008,,202,"DEJ / SCOALA GENERALA NR.1 DEJ",1,5353,"MUNICIPIUL DEJ",55008,1481,991,848,79,64,983,8,1548,557,348,635
13,"CLUJ",127,55008,,203,"DEJ / SCOALA MIHAI EMINESCU DEJ",1,5353,"MUNICIPIUL DEJ",55008,853,582,413,41,128,573,9,933,351,179,394
13,"CLUJ",127,55008,,204,"DEJ / SCOALA MIHAI EMINESCU DEJ",1,5353,"MUNICIPIUL DEJ",55008,1012,614,585,27,2,605,9,1115,501,212,393
13,"CLUJ",127,55008,,205,"DEJ / SCOALA GENERALA NR.3 DEJ",1,5353,"MUNICIPIUL DEJ",55008,1594,1151,1048,102,1,1136,15,1755,604,429,707
13,"CLUJ",127,55008,,206,"DEJ / LICEUL AL.P.ILARIAN DIN DEJ",1,5353,"MUNICIPIUL DEJ",55008,1584,955,908,47,0,950,5,1745,790,356,594
13,"CLUJ",127,55008,,207,"DEJ / CAMINUL DE COPII DIN DEJ",1,5353,"MUNICIPIUL DEJ",55008,1543,979,929,49,1,970,9,1695,716,389,581
13,"CLUJ",127,55008,,208,"DEJ / OCOLUL SILVIC DEJ",1,5353,"MUNICIPIUL DEJ",55008,1433,892,840,50,2,885,7,1576,684,294,591
13,"CLUJ",127,55008,,209,"DEJ / AGENŢIA PLĂŢI INTERVENŢII AGRICULTURA",1,5353,"MUNICIPIUL DEJ",55008,1509,932,895,36,1,919,13,1664,732,320,599
13,"CLUJ",127,55008,,210,"DEJ / SCOALA GENERALA DEJ",1,5353,"MUNICIPIUL DEJ",55008,762,506,481,24,1,500,6,838,332,214,286
13,"CLUJ",127,55008,,211,"DEJ / SCOALA GENERALA AVRAM IANCU DEJ",1,5353,"MUNICIPIUL DEJ",55008,1507,856,822,29,5,851,5,1659,803,315,536
13,"CLUJ",127,55008,,212,"DEJ / SCOALA GENERALA AVRAM IANCU DEJ",1,5353,"MUNICIPIUL DEJ",55008,1570,883,845,38,0,879,4,1735,852,311,568
13,"CLUJ",127,55008,,213,"DEJ / SERVICIUL DE ADMINISTRARE AL DOMENIULUI PUBLIC DEJ",1,5353,"MUNICIPIUL DEJ",55008,1597,953,904,49,0,947,6,1755,802,328,619
13,"CLUJ",127,55008,,214,"DEJ / SCOALA GENERALA NR.5 DEJ",1,5353,"MUNICIPIUL DEJ",55008,1621,926,868,56,2,921,5,1786,860,334,587
13,"CLUJ",127,55008,,215,"DEJ / SCOALA GENERALA NR.5 DEJ",1,5353,"MUNICIPIUL DEJ",55008,1506,934,904,29,1,930,4,1660,726,409,521
13,"CLUJ",127,55008,,216,"DEJ / CREŞA DE COPII DIN DEJ",1,5353,"MUNICIPIUL DEJ",55008,1013,622,594,28,0,620,2,1111,489,218,402
13,"CLUJ",127,55008,,217,"DEJ / CREŞA DE COPII DIN DEJ",1,5353,"MUNICIPIUL DEJ",55008,1273,746,710,36,0,739,7,1407,661,277,462
13,"CLUJ",127,55008,,218,"DEJ / CREŞA DE COPII DIN DEJ",1,5353,"MUNICIPIUL DEJ",55008,1430,864,817,46,1,857,7,1569,705,335,522
13,"CLUJ",127,55008,,219,"DEJ / CAMINUL DE COPII AL S.C SOMES S.A. DEJ",1,5353,"MUNICIPIUL DEJ",55008,1302,788,741,47,0,778,10,1432,644,286,492
13,"CLUJ",127,55008,,220,"DEJ / SCOALA GENERALA NR.4 DEJ",1,5353,"MUNICIPIUL DEJ",55008,1470,791,755,34,2,784,7,1623,832,295,489
13,"CLUJ",127,55008,,221,"DEJ / SCOALA GENERALA NR.4 DEJ",1,5353,"MUNICIPIUL DEJ",55008,1478,884,852,32,0,876,8,1624,740,312,564
13,"CLUJ",127,55008,,222,"DEJ / SCOALA GENERALA OCNA DEJ",1,5353,"MUNICIPIUL DEJ",55008,1062,656,634,21,1,651,5,1173,517,202,449
13,"CLUJ",127,55008,,223,"DEJ / SCOALA GENERALA OCNA DEJ",1,5353,"MUNICIPIUL DEJ",55008,1108,663,638,25,0,657,6,1221,558,217,440
13,"CLUJ",127,55008,,224,"DEJ / SCOALA GENERALA VIILE DEJULUI",1,5353,"MUNICIPIUL DEJ",55008,1387,805,784,21,0,801,4,1533,728,264,537
13,"CLUJ",127,55008,,225,"ŞOMCUTU MIC / SCOALA GENERALA SOMCUTU MIC",1,5353,"MUNICIPIUL DEJ",55008,491,331,305,26,0,331,0,537,206,138,193
13,"CLUJ",127,55008,,226,"PINTIC / ŞCOALA GENERALĂ PINTIC",1,5353,"MUNICIPIUL DEJ",55008,217,93,73,20,0,91,2,239,146,45,46
13,"CLUJ",127,55384,,227,"GHERLA / LICEUL TEORETIC PETRU MAIOR GHERLA",1,5359,"MUNICIPIUL GHERLA",55384,1567,1211,914,66,231,1196,15,1726,515,597,599
13,"CLUJ",127,55384,,228,"GHERLA / LICEUL TEORETIC PETRU MAIOR GHERLA",1,5359,"MUNICIPIUL GHERLA",55384,1585,1200,908,67,225,1192,8,1746,546,550,642
13,"CLUJ",127,55384,,229,"GHERLA / SCOALA GIMNAZIALA NR. 2",1,5359,"MUNICIPIUL GHERLA",55384,1508,930,879,50,1,924,6,1660,730,321,603
13,"CLUJ",127,55384,,230,"GHERLA / ŞCOALA GIMNAZIALĂ NR.1",1,5359,"MUNICIPIUL GHERLA",55384,1074,650,615,35,0,650,0,1183,533,233,417
13,"CLUJ",127,55384,,231,"GHERLA / SCOALA GIMNAZIALA NR. 1",1,5359,"MUNICIPIUL GHERLA",55384,1396,826,776,50,0,818,8,1540,714,309,509
13,"CLUJ",127,55384,,232,"GHERLA / SCOALA GIMNAZIALA NR. 1",1,5359,"MUNICIPIUL GHERLA",55384,1264,753,731,22,0,749,4,1389,636,279,470
13,"CLUJ",127,55384,,233,"GHERLA / ŞCOALA GIMNAZIALĂ NR.2",1,5359,"MUNICIPIUL GHERLA",55384,1679,989,936,51,2,982,7,1783,794,304,678
13,"CLUJ",127,55384,,234,"GHERLA / ŞCOALA GIMNAZIALĂ NR.2",1,5359,"MUNICIPIUL GHERLA",55384,930,558,508,36,14,554,4,1021,463,201,353
13,"CLUJ",127,55384,,235,"GHERLA / LICEUL TEORETIC ANA IPĂTESCU",1,5359,"MUNICIPIUL GHERLA",55384,1596,970,909,41,20,959,11,1669,699,328,631
13,"CLUJ",127,55384,,236,"GHERLA / LICEUL TEORETIC ANA IPĂTESCU",1,5359,"MUNICIPIUL GHERLA",55384,1457,844,785,59,0,837,7,1606,762,279,558
13,"CLUJ",127,55384,,237,"GHERLA / LICEUL TEORETIC ANA IPATESCU",1,5359,"MUNICIPIUL GHERLA",55384,1491,935,881,54,0,925,10,1640,705,295,630
13,"CLUJ",127,55384,,238,"GHERLA / LICEUL TEORETIC ANA IPATESCU",1,5359,"MUNICIPIUL GHERLA",55384,1466,805,774,31,0,800,5,1618,813,274,526
13,"CLUJ",127,55384,,239,"GHERLA / CLUBUL COPIILOR GHERLA",1,5359,"MUNICIPIUL GHERLA",55384,1593,893,828,65,0,889,4,1750,857,274,615
13,"CLUJ",127,55384,,240,"GHERLA / SCOALA CLS. I - IV BAITA",1,5359,"MUNICIPIUL GHERLA",55384,387,220,200,20,0,219,1,427,207,71,148
13,"CLUJ",127,55384,,241,"HĂŞDATE / ŞCOALA CLS. I - IV HĂŞDATE",1,5359,"MUNICIPIUL GHERLA",55384,270,173,150,23,0,172,1,295,122,49,123
13,"CLUJ",127,55384,,242,"SILIVAŞ / ŞCOALA CLS. I - IV SILIVAŞ",1,5359,"MUNICIPIUL GHERLA",55384,161,87,74,13,0,85,2,177,90,33,52
13,"CLUJ",127,55259,,243,"TURDA / LICEUL TEORETIC JOSIKA MIKLOS",1,5364,"MUNICIPIUL TURDA",55259,1027,589,542,45,2,574,15,1132,543,211,363
13,"CLUJ",127,55259,,244,"TURDA / LICEUL TEORETIC JOSIKA MIKLOS",1,5364,"MUNICIPIUL TURDA",55259,1272,833,780,52,1,828,5,1400,567,240,588
13,"CLUJ",127,55259,,245,"TURDA / SCOALA GIMNAZIALĂ TEODOR MURĂŞANU",1,5364,"MUNICIPIUL TURDA",55259,2036,1145,1103,42,0,1129,16,2171,1026,348,781
13,"CLUJ",127,55259,,246,"TURDA / COLEGIUL TEHNIC ""DR. I.RATIU"" TURDA",1,5364,"MUNICIPIUL TURDA",55259,1388,739,715,24,0,730,9,1530,791,204,526
13,"CLUJ",127,55259,,247,"TURDA / ŞCOALA GIMNAZIALĂ ""TEODOR MURESANU"" TURDA",1,5364,"MUNICIPIUL TURDA",55259,752,464,382,81,1,459,5,827,363,122,337
13,"CLUJ",127,55259,,248,"TURDA / ŞCOALA GIMNAZIALĂ TEODOR MURĂŞANU",1,5364,"MUNICIPIUL TURDA",55259,1302,753,681,72,0,748,5,1440,687,231,517
13,"CLUJ",127,55259,,249,"TURDA / SCOALA GIMNAZIALA "" TEODOR MURESANU"" TURDA",1,5364,"MUNICIPIUL TURDA",55259,1160,663,640,22,1,657,6,1273,610,189,468
13,"CLUJ",127,55259,,250,"TURDA / COLEGIUL TEHNIC",1,5364,"MUNICIPIUL TURDA",55259,1272,786,728,57,1,778,8,1398,612,228,550
13,"CLUJ",127,55259,,251,"TURDA / COLEGIUL TEHNIC",1,5364,"MUNICIPIUL TURDA",55259,1238,858,680,93,85,849,9,1362,504,268,581
13,"CLUJ",127,55259,,252,"TURDA / COLEGIUL NAŢIONAL ""MIHAI VITEAZU""",1,5364,"MUNICIPIUL TURDA",55259,1099,633,576,57,0,625,8,1212,579,183,442
13,"CLUJ",127,55259,,253,"TURDA / COLEGIUL ""EMIL NEGRUŢIU",1,5364,"MUNICIPIUL TURDA",55259,1299,819,722,96,1,813,6,1430,611,214,599
13,"CLUJ",127,55259,,254,"TURDA / ŞCOALA GIMNAZIALĂ ANDREI ŞAGUNA",1,5364,"MUNICIPIUL TURDA",55259,1284,665,634,31,0,659,6,1415,750,216,443
13,"CLUJ",127,55259,,255,"TURDA / ŞCOALA GIMNAZIALĂ ANDREI ŞAGUNA",1,5364,"MUNICIPIUL TURDA",55259,976,607,553,54,0,605,2,1071,464,190,415
13,"CLUJ",127,55259,,256,"TURDA / ŞCOALA GIMNAZIALĂ ANDREI ŞAGUNA",1,5364,"MUNICIPIUL TURDA",55259,1097,618,587,31,0,614,4,1205,587,171,443
13,"CLUJ",127,55259,,257,"TURDA / COLEGIUL TEHNIC""DR.I.RAŢIU",1,5364,"MUNICIPIUL TURDA",55259,1112,537,501,36,0,525,12,1223,686,265,260
13,"CLUJ",127,55259,,258,"TURDA / COLEGIUL TEHNIC""DR.I.RAŢIU",1,5364,"MUNICIPIUL TURDA",55259,1096,530,484,44,2,527,3,1200,670,226,301
13,"CLUJ",127,55259,,259,"TURDA / ŞCOALA GIMNAZIALĂ ""AVRAM IANCU""",1,5364,"MUNICIPIUL TURDA",55259,1041,662,590,72,0,654,8,1148,486,261,393
13,"CLUJ",127,55259,,260,"TURDA / ŞCOALA GIMNAZIALĂ ""AVRAM IANCU""",1,5364,"MUNICIPIUL TURDA",55259,1206,686,643,42,1,673,13,1328,642,230,443
13,"CLUJ",127,55259,,261,"TURDA / ŞCOALA GIMNAZIALĂ ""AVRAM IANCU""",1,5364,"MUNICIPIUL TURDA",55259,1241,709,681,24,4,700,9,1368,659,243,457
13,"CLUJ",127,55259,,262,"TURDA / ŞCOALA GIMNAZIALĂ ""AVRAM IANCU""",1,5364,"MUNICIPIUL TURDA",55259,1301,693,662,31,0,681,12,1436,743,270,411
13,"CLUJ",127,55259,,263,"TURDA / ŞCOALA GIMNAZIALĂ ""ION OPRIŞ""",1,5364,"MUNICIPIUL TURDA",55259,1296,814,736,78,0,800,14,1430,616,278,522
13,"CLUJ",127,55259,,264,"TURDA / ŞCOALA GIMNAZIALĂ ""ION OPRIŞ""",1,5364,"MUNICIPIUL TURDA",55259,1068,619,609,10,0,613,6,1170,551,246,367
13,"CLUJ",127,55259,,265,"TURDA / ŞCOALA GIMNAZIALĂ ""ION OPRIŞ""",1,5364,"MUNICIPIUL TURDA",55259,1425,794,760,33,1,784,10,1572,778,272,512
13,"CLUJ",127,55259,,266,"TURDA / LICEUL TEORETIC""LIVIU REBREANU""",1,5364,"MUNICIPIUL TURDA",55259,1490,886,834,52,0,882,4,1641,755,286,596
13,"CLUJ",127,55259,,267,"TURDA / LICEUL TEORETIC""LIVIU REBREANU""",1,5364,"MUNICIPIUL TURDA",55259,1520,807,742,65,0,792,15,1675,868,274,518
13,"CLUJ",127,55259,,268,"TURDA / LICEUL TEORETIC""LIVIU REBREANU""",1,5364,"MUNICIPIUL TURDA",55259,1471,772,756,16,0,765,7,1612,840,261,504
13,"CLUJ",127,55259,,269,"TURDA / LICEUL TEORETIC""LIVIU REBREANU""",1,5364,"MUNICIPIUL TURDA",55259,1328,731,693,38,0,721,10,1458,727,209,512
13,"CLUJ",127,55259,,270,"TURDA / LICEUL TEORETIC""LIVIU REBREANU""",1,5364,"MUNICIPIUL TURDA",55259,1527,795,773,22,0,787,8,1686,891,247,540
13,"CLUJ",127,55259,,271,"TURDA / LICEUL TEORETIC""LIVIU REBREANU""",1,5364,"MUNICIPIUL TURDA",55259,1120,561,542,19,0,556,5,1232,671,206,350
13,"CLUJ",127,55259,,272,"TURDA / ŞCOALA GIMNAZIALĂ ""HOREA.CLOŞCA ŞI CRIŞAN""",1,5364,"MUNICIPIUL TURDA",55259,1438,842,757,85,0,826,16,1581,739,247,579
13,"CLUJ",127,55259,,273,"TURDA / ŞCOALA GIMNAZIALĂ ""HOREA.CLOŞCA ŞI CRIŞAN""",1,5364,"MUNICIPIUL TURDA",55259,1415,775,726,49,0,766,9,1561,786,281,485
13,"CLUJ",127,55259,,274,"TURDA / ŞCOALA GIMNAZIALĂ ""HOREA.CLOŞCA ŞI CRIŞAN""",1,5364,"MUNICIPIUL TURDA",55259,1323,707,688,19,0,701,6,1447,740,250,451
13,"CLUJ",127,55259,,275,"TURDA / ŞCOALA GIMNAZIALĂ ""HOREA.CLOŞCA ŞI CRIŞAN""",1,5364,"MUNICIPIUL TURDA",55259,1402,766,734,32,0,754,12,1543,777,259,495
13,"CLUJ",127,55259,,276,"TURDA / ŞCOALA GIMNAZIALĂ ""HOREA.CLOŞCA ŞI CRIŞAN""",1,5364,"MUNICIPIUL TURDA",55259,1259,651,631,20,0,643,8,1378,727,198,445
13,"CLUJ",127,55259,,277,"TURDA / ŞCOALA GIMNAZIALĂ ""HOREA.CLOŞCA ŞI CRIŞAN""",1,5364,"MUNICIPIUL TURDA",55259,1267,671,655,16,0,658,13,1405,734,226,432
13,"CLUJ",127,55259,,278,"TURDA / ŞCOALA GIMNAZIALĂ ""HOREA.CLOŞCA ŞI CRIŞAN""",1,5364,"MUNICIPIUL TURDA",55259,1419,725,699,26,0,717,8,1560,835,221,496
13,"CLUJ",127,55259,,279,"TURDA / ŞCOALA PROFESIONALĂ POIANA",1,5364,"MUNICIPIUL TURDA",55259,1288,769,748,21,0,764,5,1421,652,217,547
13,"CLUJ",127,55259,,280,"TURDA / ŞCOALA PROFESIONALĂ POIANA",1,5364,"MUNICIPIUL TURDA",55259,1411,824,801,23,0,815,9,1547,723,251,564
13,"CLUJ",127,55446,,281,"HUEDIN / SCOALA NOUA CU 16 SALI DE CLASA",1,5366,"ORAŞ HUEDIN",55446,990,647,583,64,0,637,10,1089,442,146,491
13,"CLUJ",127,55446,,282,"HUEDIN / GRUPUL SCOLAR HUEDIN",1,5366,"ORAŞ HUEDIN",55446,1516,852,749,50,53,843,9,1664,812,211,632
13,"CLUJ",127,55446,,283,"HUEDIN / CASA DE COPII",1,5366,"ORAŞ HUEDIN",55446,1663,1110,1028,82,0,1106,4,1838,728,312,794
13,"CLUJ",127,55446,,284,"HUEDIN / PRIMARIA ORAS HUEDIN",1,5366,"ORAŞ HUEDIN",55446,1412,862,756,104,2,853,9,1428,566,187,666
13,"CLUJ",127,55446,,285,"HUEDIN / LICEUL TEORETIC OCTAVIAN GOGA",1,5366,"ORAŞ HUEDIN",55446,1476,956,846,110,0,952,4,1586,630,196,756
13,"CLUJ",127,55446,,286,"HUEDIN / CAMIN CULTURAL",1,5366,"ORAŞ HUEDIN",55446,378,125,110,15,0,120,5,414,289,38,82
13,"CLUJ",127,55446,,287,"BICĂLATU / CAMIN CULTURAL",1,5366,"ORAŞ HUEDIN",55446,277,174,149,25,0,174,0,306,132,22,152
13,"CLUJ",127,55473,,288,"AGHIREŞU / SCOALA GENERALA AGHIRESU",3,5369,"AGHIREŞU",55473,1081,588,508,80,0,578,10,1188,600,152,426
13,"CLUJ",127,55473,,289,"AGHIREŞU-FABRICI / SEDIU CONSILIU LOCAL",3,5369,"AGHIREŞU",55473,1237,726,666,60,0,725,1,1355,629,195,530
13,"CLUJ",127,55473,,290,"AGHIREŞU-FABRICI / SCOALA GENERALA AGHIRESU-FABRICI",3,5369,"AGHIREŞU",55473,1391,729,678,51,0,724,5,1540,811,157,567
13,"CLUJ",127,55473,,291,"ARGHIŞU / CAMIN CULTURAL  ARGHISU",3,5369,"AGHIREŞU",55473,121,85,54,31,0,84,1,131,46,11,73
13,"CLUJ",127,55473,,292,"BĂGARA / SCOALA GENERALA BAGARA",3,5369,"AGHIREŞU",55473,324,179,160,19,0,177,2,357,178,32,145
13,"CLUJ",127,55473,,293,"DÎNCU / SCOALA GENERALA DANCU",3,5369,"AGHIREŞU",55473,68,51,28,23,0,50,1,75,24,28,22
13,"CLUJ",127,55473,,294,"DOROLŢU / CAMIN CULTURAL DOROLTU",3,5369,"AGHIREŞU",55473,76,72,55,17,0,71,1,82,10,8,63
13,"CLUJ",127,55473,,295,"INUCU / SCOALA GENERALA INUCU",3,5369,"AGHIREŞU",55473,283,176,146,30,0,175,1,311,135,23,152
13,"CLUJ",127,55473,,296,"LEGHIA / SCOALA GENERALA LEGHIA",3,5369,"AGHIREŞU",55473,416,250,226,24,0,250,0,458,208,32,218
13,"CLUJ",127,55473,,297,"MACĂU / IMOBIL CONSILIU nr. 7",3,5369,"AGHIREŞU",55473,511,332,301,31,0,331,1,560,228,26,305
13,"CLUJ",127,55473,,298,"TICU / SCOALA GENERALA TICU",3,5369,"AGHIREŞU",55473,66,44,30,14,0,44,0,70,26,23,21
13,"CLUJ",127,55473,,299,"TICU-COLONIE / SCOALA GENERALA TICU-COLONIE",3,5369,"AGHIREŞU",55473,147,98,75,23,0,96,2,162,64,24,72
13,"CLUJ",127,55598,,300,"AITON / CAMIN CULTURAL AITON",3,5381,"AITON",55598,528,394,298,75,21,386,8,582,188,163,223
13,"CLUJ",127,55598,,301,"REDIU / CAMIN CULTURAL REDIU",3,5381,"AITON",55598,416,303,221,70,12,302,1,455,152,82,220
13,"CLUJ",127,55623,,302,"ALUNIŞ / CAMIN CULTURAL ALUNIS",3,5384,"ALUNIŞ",55623,472,244,200,44,0,244,0,518,274,69,175
13,"CLUJ",127,55623,,303,"CORNENI / CAMIN CULTURAL CORNENI",3,5384,"ALUNIŞ",55623,122,63,46,17,0,62,1,136,73,31,31
13,"CLUJ",127,55623,,304,"GHIROLT / SEDIU ADMINISTRATIV GHIROLT",3,5384,"ALUNIŞ",55623,341,204,179,25,0,202,2,374,170,56,146
13,"CLUJ",127,55623,,305,"VALE / CAMIN CULTURAL VALE",3,5384,"ALUNIŞ",55623,81,95,42,53,0,95,0,118,23,37,58
13,"CLUJ",127,55687,,306,"APAHIDA / SALA SPORT LICEU TEHNOLOGIC ST. PASCU",3,5390,"APAHIDA",55687,1496,1009,893,116,0,1000,9,1642,633,235,765
13,"CLUJ",127,55687,,307,"APAHIDA / SALA SPORT LICEU TEHNOLOGIC ST. PASCU",3,5390,"APAHIDA",55687,1335,903,788,115,0,896,7,1462,559,219,677
13,"CLUJ",127,55687,,308,"APAHIDA / SALA SPORT LICEU TEHNOLOGIC ST. PASCU",3,5390,"APAHIDA",55687,1433,956,866,90,0,950,6,1571,615,214,736
13,"CLUJ",127,55687,,309,"APAHIDA / SALA SPORT LICEU TEHNOLOGIC ST. PASCU",3,5390,"APAHIDA",55687,1132,738,648,90,0,735,3,1242,504,184,551
13,"CLUJ",127,55687,,310,"SÎNNICOARĂ / Scoala gimnaziala  Sânnicoară",3,5390,"APAHIDA",55687,1610,1209,1034,175,0,1203,6,1770,561,271,932
13,"CLUJ",127,55687,,311,"DEZMIR / Sediu Primarie Dezmir",3,5390,"APAHIDA",55687,1221,923,783,140,0,906,17,1338,415,247,659
13,"CLUJ",127,55687,,312,"PATA / Sediu Primarie Pata",3,5390,"APAHIDA",55687,478,370,291,79,0,365,5,525,155,147,218
13,"CLUJ",127,55687,,313,"CORPADEA / Caminul Cultural Corpadea",3,5390,"APAHIDA",55687,356,260,200,60,0,259,1,391,131,105,154
13,"CLUJ",127,55687,,314,"CÎMPENEŞTI / Sediu sector Piscicola",3,5390,"APAHIDA",55687,56,77,26,51,0,77,0,108,31,28,49
13,"CLUJ",127,55776,,315,"AŞCHILEU MARE / Gradinita Aschileu Mare, nr. 180",3,5399,"AŞCHILEU",55776,484,292,235,57,0,288,4,534,242,109,179
13,"CLUJ",127,55776,,316,"AŞCHILEU MIC / Caminul Cultural Aschileu Mic, nr. 38",3,5399,"AŞCHILEU",55776,252,159,125,34,0,156,3,276,117,81,75
13,"CLUJ",127,55776,,317,"CRISTOREL / Scoala Primara Cristorel, nr. 172",3,5399,"AŞCHILEU",55776,314,192,160,32,0,191,1,350,158,67,124
13,"CLUJ",127,55776,,318,"FODORA / Scoala Primara Fodora, nr. 34",3,5399,"AŞCHILEU",55776,226,180,132,48,0,179,1,247,67,61,118
13,"CLUJ",127,55838,,319,"BACIU / Spaţiu Comercial",3,5405,"BACIU",55838,998,895,613,282,0,886,9,1086,191,134,752
13,"CLUJ",127,55838,,320,"BACIU / Casa de Cultură Baciu",3,5405,"BACIU",55838,1259,1004,799,205,0,996,8,1370,366,203,793
13,"CLUJ",127,55838,,321,"BACIU / Casa de Cultură Baciu",3,5405,"BACIU",55838,1641,1157,1092,65,0,1143,14,1808,651,204,939
13,"CLUJ",127,55838,,322,"BACIU / Casa de Cultură Baciu",3,5405,"BACIU",55838,1056,547,514,33,0,540,7,1356,809,142,398
13,"CLUJ",127,55838,,323,"CORUŞU / Scoala Corusu",3,5405,"BACIU",55838,437,350,273,77,0,348,2,476,126,138,210
13,"CLUJ",127,55838,,324,"MERA / Scoala Mera",3,5405,"BACIU",55838,1266,800,723,73,4,793,7,1390,590,102,691
13,"CLUJ",127,55838,,325,"POPEŞTI / Scoala Popesti",3,5405,"BACIU",55838,486,361,312,49,0,355,6,533,172,97,258
13,"CLUJ",127,55838,,326,"SĂLIŞTEA NOUĂ / Scoala Salistea Noua",3,5405,"BACIU",55838,140,141,98,43,0,140,1,152,11,40,100
13,"CLUJ",127,55838,,327,"SUCEAGU / Scoala Suceagu",3,5405,"BACIU",55838,1084,676,606,70,0,669,7,1193,517,186,483
13,"CLUJ",127,55918,,328,"BĂIŞOARA / Scoala Generala Baisoara",3,5413,"BĂIŞOARA",55918,876,586,510,68,8,581,5,960,374,184,397
13,"CLUJ",127,55918,,329,"SĂCEL / Scoala Primara Sacel",3,5413,"BĂIŞOARA",55918,331,248,213,33,2,243,5,363,115,57,186
13,"CLUJ",127,55918,,330,"MUNTELE BĂIŞORII / Scoala Primara Muntele Baisorii",3,5413,"BĂIŞOARA",55918,299,234,168,66,0,234,0,330,96,56,178
13,"CLUJ",127,55918,,331,"MUNTELE CACOVEI / Scoala Primara Muntele Cacovei",3,5413,"BĂIŞOARA",55918,83,65,54,11,0,63,2,90,25,25,38
13,"CLUJ",127,55918,,332,"MUNTELE SĂCELULUI / Scoala Primara Muntele Sacelului",3,5413,"BĂIŞOARA",55918,59,49,31,18,0,49,0,63,14,15,34
13,"CLUJ",127,55918,,333,"MOARA DE PĂDURE / Gospodaria d-nei Irimie Paraschiva, sat Moara de Padure, nr. 21",3,5413,"BĂIŞOARA",55918,122,123,65,58,0,122,1,135,12,34,88
13,"CLUJ",127,56014,,334,"BELIŞ / Primaria Belis",3,5423,"BELIŞ",56014,504,583,284,299,0,578,5,656,73,183,395
13,"CLUJ",127,56014,,335,"BĂLCEŞTI / Scoala Generala Balcesti",3,5423,"BELIŞ",56014,120,135,80,55,0,135,0,161,26,27,108
13,"CLUJ",127,56014,,336,"DEALU BOTII / Scoala Generala Dealu Botii",3,5423,"BELIŞ",56014,52,46,34,12,0,46,0,56,10,16,30
13,"CLUJ",127,56014,,337,"SMIDA / Scoala Generala Smida",3,5423,"BELIŞ",56014,35,46,15,31,0,45,1,73,27,15,30
13,"CLUJ",127,56014,,338,"GIURCUŢA DE SUS / Scoala Gen. Giurcuta de Sus",3,5423,"BELIŞ",56014,133,95,82,12,1,94,1,145,50,44,50
13,"CLUJ",127,56014,,339,"POIANA HOREA / Scoala Gen. Poiana Horea",3,5423,"BELIŞ",56014,313,262,203,59,0,259,3,344,82,93,166
13,"CLUJ",127,56096,,340,"BĂBDIU / SCOLA  GENERALA  BABDIU",3,5431,"BOBÎLNA",56096,140,103,69,34,0,103,0,153,50,53,50
13,"CLUJ",127,56096,,341,"BOBÎLNA / SCOALA GENERALA BOBÎLNA",3,5431,"BOBÎLNA",56096,339,237,192,45,0,236,1,373,136,156,80
13,"CLUJ",127,56096,,342,"MAIA / SCOALA GENERALA MAIA",3,5431,"BOBÎLNA",56096,211,133,109,24,0,132,1,228,95,69,63
13,"CLUJ",127,56096,,343,"OŞORHEL / SCOALA GENERALA OSORHEL",3,5431,"BOBÎLNA",56096,112,90,46,44,0,90,0,122,32,41,49
13,"CLUJ",127,56096,,344,"PRUNI / CAMINUL CULTURAL PRUNI",3,5431,"BOBÎLNA",56096,35,38,20,18,0,38,0,38,0,24,14
13,"CLUJ",127,56096,,345,"RĂZBUNENI / SCOALA GENERALA RAZBUNENI",3,5431,"BOBÎLNA",56096,194,160,131,29,0,158,2,212,52,80,78
13,"CLUJ",127,56096,,346,"SUARĂŞ / CAMINUL CULTURAL SUARĂŞ",3,5431,"BOBÎLNA",56096,121,102,73,29,0,101,1,134,32,58,43
13,"CLUJ",127,56096,,347,"VÎLCELELE / SCOALA GENERALA VÎLCELELE",3,5431,"BOBÎLNA",56096,95,75,50,25,0,75,0,104,29,33,42
13,"CLUJ",127,56210,,348,"BONŢIDA / CAMIN CULTURAL BONTIDA",3,5443,"BONŢIDA",56210,1542,979,873,97,9,966,13,1699,720,274,692
13,"CLUJ",127,56210,,349,"BONŢIDA / CLUBUL TINERETULUI",3,5443,"BONŢIDA",56210,826,516,457,55,4,514,2,911,395,120,394
13,"CLUJ",127,56210,,350,"RĂSCRUCI / SCOALA GENERALA RASCRUCI",3,5443,"BONŢIDA",56210,1270,859,746,113,0,849,10,1400,541,136,713
13,"CLUJ",127,56210,,351,"COASTA / SCOALA GENERALA COASTA",3,5443,"BONŢIDA",56210,102,80,52,28,0,78,2,111,31,34,44
13,"CLUJ",127,56210,,352,"TĂUŞENI / CAMINUL CULTURAL  TAUSENI",3,5443,"BONŢIDA",56210,56,48,21,27,0,46,2,62,14,19,27
13,"CLUJ",127,56265,,353,"BORŞA-CĂTUN / CONSILIUL LOCAL BORSA",3,5448,"BORŞA",56265,929,862,589,210,63,854,8,1025,163,134,720
13,"CLUJ",127,56265,,354,"GIULA / CAMINUL CULTURAL GIULA",3,5448,"BORŞA",56265,129,137,84,51,2,136,1,160,23,33,103
13,"CLUJ",127,56265,,355,"CIUMĂFAIA / SCOALA GENERALA CIUMĂFAIA",3,5448,"BORŞA",56265,124,99,68,31,0,98,1,135,36,26,72
13,"CLUJ",127,56327,,356,"BUZA / CAMINUL CULTURAL BUZA",3,5454,"BUZA",56327,1052,614,567,47,0,605,9,1155,541,147,458
13,"CLUJ",127,56354,,357,"CĂIANU MIC / SCOALA GIMNAZIALA CAIANU MIC",3,5457,"CĂIANU",56354,620,351,296,55,0,350,1,683,332,120,230
13,"CLUJ",127,56354,,358,"BĂRĂI / CAMINUL CULTURAL BĂRĂI",3,5457,"CĂIANU",56354,224,166,121,45,0,166,0,247,81,55,111
13,"CLUJ",127,56354,,359,"CĂIANU-VAMĂ / SCOALA GENERALĂ CĂIANU VAMĂ",3,5457,"CĂIANU",56354,444,275,239,36,0,274,1,488,213,63,211
13,"CLUJ",127,56354,,360,"VAIDA-CĂMĂRAŞ / PRIMARIA VAIDA CĂMĂRAS",3,5457,"CĂIANU",56354,746,393,351,42,0,392,1,822,429,42,350
13,"CLUJ",127,56425,,361,"CĂLĂRAŞI / CAMIN CULTURAL CALARASI",3,5464,"CĂLĂRAŞI",56425,811,431,397,31,3,429,2,892,461,67,362
13,"CLUJ",127,56425,,362,"BOGATA / CĂMINUL CULTURAL BOGATA",3,5464,"CĂLĂRAŞI",56425,938,509,481,28,0,500,9,1032,523,172,328
13,"CLUJ",127,56425,,363,"CĂLĂRAŞI-GARĂ / CAMINUL CULTURAL CALARASI -GARA",3,5464,"CĂLĂRAŞI",56425,335,198,182,16,0,197,1,365,167,43,154
13,"CLUJ",127,56461,,364,"CĂLĂŢELE / ŞCOALA DIN CĂLĂŢELE",3,5468,"CĂLĂŢELE",56461,710,392,348,44,0,385,7,780,388,170,215
13,"CLUJ",127,56461,,365,"CĂLĂŢELE / CAMINUL CULTURAL CĂLĂŢELE PĂDURE",3,5468,"CĂLĂŢELE",56461,213,169,145,24,0,169,0,231,62,79,90
13,"CLUJ",127,56461,,366,"CĂLATA / SCOALA  CĂLATA",3,5468,"CĂLĂŢELE",56461,313,228,193,35,0,228,0,345,117,98,130
13,"CLUJ",127,56461,,367,"VĂLENI / CĂMINUL  CULTURAL  VĂLENI",3,5468,"CĂLĂŢELE",56461,274,184,156,28,0,184,0,301,117,27,157
13,"CLUJ",127,56461,,368,"FINCIU / CĂMINUL  CULTURAL  FINCIU",3,5468,"CĂLĂŢELE",56461,120,101,81,20,0,100,1,131,30,20,80
13,"CLUJ",127,56461,,369,"DEALU NEGRU / ŞCOALA DIN DEALU NEGRU",3,5468,"CĂLĂŢELE",56461,349,321,227,94,0,319,2,382,61,61,258
13,"CLUJ",127,56522,,370,"CĂMĂRAŞU / CAMIN CULTURAL CAMARASU",3,5474,"CĂMĂRAŞU",56522,1186,699,637,62,0,686,13,1305,606,326,360
13,"CLUJ",127,56522,,371,"NĂOIU / CĂMINUL CULTURAL NAOIU",3,5474,"CĂMĂRAŞU",56522,396,247,224,23,0,245,2,437,190,158,87
13,"CLUJ",127,56522,,372,"SÎMBOLENI / SCOALA PRIMARA SÎMBOLENI",3,5474,"CĂMĂRAŞU",56522,490,306,275,30,1,306,0,543,237,186,120
13,"CLUJ",127,56568,,373,"CĂPUŞU MARE / CĂMINUL CULTURAL CĂPUŞU MARE",3,5478,"CĂPUŞU MARE",56568,694,464,399,65,0,458,6,764,300,55,403
13,"CLUJ",127,56568,,374,"CĂPUŞU MIC / CĂMINUL CULTURAL",3,5478,"CĂPUŞU MARE",56568,631,403,324,79,0,396,7,693,290,80,316
13,"CLUJ",127,56568,,375,"AGÎRBICIU / CĂMINUL CULTURAL",3,5478,"CĂPUŞU MARE",56568,402,314,280,33,1,313,1,441,127,100,213
13,"CLUJ",127,56568,,376,"DUMBRAVA / FOSTUL SEDIU  CAP",3,5478,"CĂPUŞU MARE",56568,290,211,166,45,0,211,0,319,108,63,148
13,"CLUJ",127,56568,,377,"PĂNICENI / ŞCOLA CU CLASELE I-IV",3,5478,"CĂPUŞU MARE",56568,235,160,116,44,0,158,2,260,100,51,107
13,"CLUJ",127,56568,,378,"DÎNGĂU MARE / ŞCOLA CU CLASELE I-IV DÎNGĂUL MARE",3,5478,"CĂPUŞU MARE",56568,414,299,235,64,0,298,1,454,155,104,194
13,"CLUJ",127,56666,,379,"CĂŞEIU / CĂMINUL CULTURAL",3,5488,"CĂŞEIU",56666,1189,754,668,86,0,746,8,1308,554,330,416
13,"CLUJ",127,56666,,380,"COPLEAN / ŞCOALA COPLEAN",3,5488,"CĂŞEIU",56666,342,227,185,42,0,225,2,376,149,87,138
13,"CLUJ",127,56666,,381,"RUGĂŞEŞTI / ŞCOALA GIMNAZIALĂ RUGĂŞEŞTI",3,5488,"CĂŞEIU",56666,880,548,512,36,0,540,8,968,420,257,283
13,"CLUJ",127,56666,,382,"GUGA / ŞCOALA GUGA",3,5488,"CĂŞEIU",56666,252,146,123,23,0,144,2,276,130,71,73
13,"CLUJ",127,56666,,383,"GÎRBĂU DEJULUI / ŞCOALA GARBĂUL DEJULUI",3,5488,"CĂŞEIU",56666,204,124,91,33,0,124,0,226,102,63,61
13,"CLUJ",127,56666,,384,"SĂLĂTRUC / ŞCOALA SĂLĂTRUC",3,5488,"CĂŞEIU",56666,125,72,60,12,0,72,0,136,64,25,47
13,"CLUJ",127,56666,,385,"URIŞOR / ŞCOALA PRIMARĂ URIŞOR",3,5488,"CĂŞEIU",56666,812,508,470,38,0,504,4,895,387,210,294
13,"CLUJ",127,56773,,386,"CĂTINA / PRIMĂRIA COM.CĂTINA",3,5499,"CĂTINA",56773,995,576,502,74,0,571,5,1094,518,260,311
13,"CLUJ",127,56773,,387,"FELDIOARA / ŞCOLA CU CLS.I-IV FELDIOARA",3,5499,"CĂTINA",56773,454,239,207,32,0,238,1,498,259,88,150
13,"CLUJ",127,56773,,388,"COPRU / CĂMINUL CULTURAL COPRU",3,5499,"CĂTINA",56773,104,76,59,17,0,76,0,113,37,27,49
13,"CLUJ",127,56844,,389,"CEANU MARE / CAMIN CULTURAL CEANU MARE",3,5506,"CEANU MARE",56844,1203,586,531,55,0,582,4,1328,742,189,393
13,"CLUJ",127,56844,,390,"BOIAN / GRADINITA BOIAN",3,5506,"CEANU MARE",56844,749,406,377,29,0,398,8,824,418,120,278
13,"CLUJ",127,56844,,391,"BOLDUŢ / CAMIN CULTURAL BOLDUT",3,5506,"CEANU MARE",56844,687,366,336,30,0,361,5,752,386,161,200
13,"CLUJ",127,56844,,392,"IACOBENI / CAMIN CULTURAL IACOBENI",3,5506,"CEANU MARE",56844,535,316,283,33,0,312,4,585,269,100,212
13,"CLUJ",127,56844,,393,"DOSU NAPULUI / SCOALA DOSU NAPULUI",3,5506,"CEANU MARE",56844,131,78,49,29,0,78,0,144,66,34,44
13,"CLUJ",127,56988,,394,"CHINTENI / PRIMARIA COMUNEI CHINTENI",3,5520,"CHINTENI",56988,1140,888,696,187,5,883,5,1257,369,266,617
13,"CLUJ",127,56988,,395,"DEUŞU / SCOALA CLS.I-IV DEUSU",3,5520,"CHINTENI",56988,597,436,332,98,6,434,2,663,227,109,325
13,"CLUJ",127,56988,,396,"MĂCICAŞU / SCOALA CLS.I-IV MACICASU",3,5520,"CHINTENI",56988,374,263,219,39,5,260,3,415,152,129,131
13,"CLUJ",127,56988,,397,"FEIURDENI / PUNCT LUCRU FEIURDENI AL PRIMARIEI COMUNEI CHINTENI",3,5520,"CHINTENI",56988,378,290,187,102,1,288,2,413,123,172,116
13,"CLUJ",127,57083,,398,"CHIUIEŞTI / SCOALA GIMNAZ. CHIUIESTI",3,5530,"CHIUIEŞTI",57083,1310,895,818,76,1,888,7,1444,549,190,698
13,"CLUJ",127,57083,,399,"MĂGOAJA / SCOALA PRIMARA MAGOAJA",3,5530,"CHIUIEŞTI",57083,324,270,216,47,7,270,0,359,89,130,140
13,"CLUJ",127,57083,,400,"STRÎMBU / SCOALA PRIMARA STRAMBU",3,5530,"CHIUIEŞTI",57083,369,240,206,34,0,226,14,404,164,65,161
13,"CLUJ",127,57083,,401,"HUTA / SCOALA PRIMARA HUTA",3,5530,"CHIUIEŞTI",57083,105,72,63,9,0,72,0,115,43,23,49
13,"CLUJ",127,57163,,402,"CIUCEA / SCOALA CU CL. I - VIII, CIUCEA",3,5542,"CIUCEA",57163,778,590,496,94,0,584,6,856,266,237,347
13,"CLUJ",127,57163,,403,"CIUCEA / scoala clasele I - IV Calea Lata",3,5542,"CIUCEA",57163,217,132,111,21,0,129,3,240,108,42,87
13,"CLUJ",127,57163,,404,"VÂNĂTORI / SCOALA CLS.I-IV VANATORI",3,5542,"CIUCEA",57163,374,244,228,16,0,242,2,410,166,61,181
13,"CLUJ",127,57225,,405,"CIURILA / CONSILIUL LOCAL CIURILA",3,5545,"CIURILA",57225,184,140,90,50,0,138,2,202,62,58,80
13,"CLUJ",127,57225,,406,"FILEA DE JOS / SCOALA GIMNAZIALA",3,5545,"CIURILA",57225,270,182,137,45,0,180,2,296,114,79,101
13,"CLUJ",127,57225,,407,"SĂLICEA / SCOALA GIMNAZIALA",3,5545,"CIURILA",57225,290,323,158,165,0,321,2,367,44,43,278
13,"CLUJ",127,57225,,408,"ŞUTU / SCOALA GIMNAZIALA",3,5545,"CIURILA",57225,311,207,139,66,2,203,4,342,135,67,136
13,"CLUJ",127,57225,,409,"SĂLIŞTE / PAROHIA ORTODOXA SALISTE",3,5545,"CIURILA",57225,79,66,41,25,0,66,0,86,20,23,43
13,"CLUJ",127,57314,,410,"CÎŢCĂU / CĂMINUL CULTURAL CÎŢCĂU",3,5538,"CÎŢCĂU",57314,1261,901,779,82,40,901,0,1394,493,288,613
13,"CLUJ",127,57314,,411,"MUNCEL / ŞCOAL GEN. MUNCEL",3,5538,"CÎŢCĂU",57314,185,152,112,33,7,152,0,204,52,46,106
13,"CLUJ",127,57314,,412,"SĂLIŞCA / ŞCOALA GEN. SĂLIŞCA",3,5538,"CÎŢCĂU",57314,472,438,348,75,15,438,0,520,82,88,350
13,"CLUJ",127,57350,,413,"COJOCNA / Şcoala Gimnazială Cojocna sala nr.4",3,5554,"COJOCNA",57350,1012,624,523,101,0,619,5,1111,487,153,466
13,"CLUJ",127,57350,,414,"COJOCNA / Şcoala Gimnazială Cojocna sala nr.7",3,5554,"COJOCNA",57350,855,512,450,62,0,508,4,943,431,138,370
13,"CLUJ",127,57350,,415,"BOJU / Şcoala Boju",3,5554,"COJOCNA",57350,475,362,270,85,7,361,1,522,160,96,265
13,"CLUJ",127,57350,,416,"CARA / Biroul Primăriei Cara",3,5554,"COJOCNA",57350,631,382,328,54,0,379,3,688,306,139,240
13,"CLUJ",127,57350,,417,"IURIU DE CÎMPIE / Căminul Cultural Iuriu de Cîmpie",3,5554,"COJOCNA",57350,337,214,160,54,0,214,0,371,157,75,139
13,"CLUJ",127,57449,,418,"IGRIŢIA / CAMIN CULTURAL IGRITIA",3,5563,"CORNEŞTI",57449,38,46,25,21,0,45,1,70,24,27,18
13,"CLUJ",127,57449,,419,"TIOCU DE SUS / SCOALA GENERALA TIOCU DE SUS                                                     PRINCIPALA",3,5563,"CORNEŞTI",57449,89,87,52,35,0,87,0,122,35,57,30
13,"CLUJ",127,57449,,420,"TIOCU DE JOS / CAMIN CULTURAL TIOCU DE JOS",3,5563,"CORNEŞTI",57449,107,88,63,25,0,87,1,119,31,38,49
13,"CLUJ",127,57449,,421,"CORNEŞTI / SCOALA GIMNAZIALA LIA MANOLIU CORNESTI                         PRINCIPALA",3,5563,"CORNEŞTI",57449,189,127,102,25,0,125,2,210,83,46,79
13,"CLUJ",127,57449,,422,"STOIANA / COOPERATIVA VECHE- STOIANA",3,5563,"CORNEŞTI",57449,168,126,90,36,0,123,3,184,58,47,76
13,"CLUJ",127,57449,,423,"MORĂU / CAMIN CULTURAL MORAU",3,5563,"CORNEŞTI",57449,46,61,25,36,0,60,1,78,17,30,30
13,"CLUJ",127,57449,,424,"LUJERDIU / CENTRUL DE INFORMARE SI PROMOVARE TURISTICA LUJERDIU                                           PRINCIPALA                                      54",3,5563,"CORNEŞTI",57449,291,186,136,50,0,183,3,321,135,68,115
13,"CLUJ",127,57449,,425,"BÎRLEA / CAMIN CULTURAL BARLEA",3,5563,"CORNEŞTI",57449,135,126,91,35,0,124,2,149,23,78,46
13,"CLUJ",127,57449,,426,"TIOLTIUR / CAMIN CULTURAL TIOLTIUR",3,5563,"CORNEŞTI",57449,154,122,99,23,0,121,1,167,45,61,60
13,"CLUJ",127,55062,,427,"CUZDRIOARA / CĂMINUL CULTURAL",3,5573,"CUZDRIOARA",55062,904,589,510,72,7,584,5,995,406,276,308
13,"CLUJ",127,55062,,428,"CUZDRIOARA / CĂMINUL CULTURAL",3,5573,"CUZDRIOARA",55062,849,512,470,41,1,503,9,934,422,212,291
13,"CLUJ",127,55062,,429,"MĂNĂŞTUREL / CĂMINUL CULTURAL",3,5573,"CUZDRIOARA",55062,648,272,240,32,0,269,3,714,442,111,158
13,"CLUJ",127,57546,,430,"DĂBÎCA / SCOALA CLS.I-IV GELU ROMANU",3,5577,"DĂBÎCA",57546,600,366,288,78,0,366,0,660,294,139,227
13,"CLUJ",127,57546,,431,"LUNA DE JOS / SCOALA GEN.LUNA DE JOS",3,5577,"DĂBÎCA",57546,536,352,269,74,9,345,7,588,236,97,248
13,"CLUJ",127,57546,,432,"PÎGLIŞA / CAMINUL CULT.PAGLISA",3,5577,"DĂBÎCA",57546,88,74,45,29,0,72,2,95,21,21,51
13,"CLUJ",127,57582,,433,"FELEACU / CAMINUL CULTURAL FELEACU DIN LOCALITATEA FELEACU",3,5581,"FELEACU",57582,1463,1031,872,158,1,1017,13,1560,529,172,845
13,"CLUJ",127,57582,,434,"GHEORGHIENI / CAMINUL CULTURAL DIN LOCALITATEA GHEORGHENI",3,5581,"FELEACU",57582,858,554,468,86,0,549,5,942,388,31,518
13,"CLUJ",127,57582,,435,"VÎLCELE / FOSTUL SEDIU CAP VILCELE DIN LOCALITATEA VILCELE",3,5581,"FELEACU",57582,828,551,455,96,0,548,3,907,356,93,455
13,"CLUJ",127,57644,,436,"FIZEŞU GHERLII / CAMINUL CULT.FIZESU GHERLII",3,5587,"FIZEŞU GHERLII",57644,1124,523,478,45,0,517,6,1236,713,130,387
13,"CLUJ",127,57644,,437,"NICULA / SCOALA CLS.I-IV",3,5587,"FIZEŞU GHERLII",57644,545,268,225,43,0,264,4,601,333,123,141
13,"CLUJ",127,57644,,438,"BONŢ / SCOALA CLS.I-IV BONT",3,5587,"FIZEŞU GHERLII",57644,305,158,139,19,0,157,1,338,180,71,86
13,"CLUJ",127,57644,,439,"SĂCĂLAIA / SCOALA CLS.I-IV SACALAIA",3,5587,"FIZEŞU GHERLII",57644,198,141,115,26,0,141,0,217,76,51,90
13,"CLUJ",127,57706,,440,"FLOREŞTI / PRIMARIA COMUNEI FLORESTI",3,5593,"FLOREŞTI",57706,1306,1148,709,439,0,1147,1,1420,272,186,961
13,"CLUJ",127,57706,,441,"FLOREŞTI / PRIMARIA COMUNEI FLORESTI",3,5593,"FLOREŞTI",57706,1351,1140,839,301,0,1130,10,1442,302,153,977
13,"CLUJ",127,57706,,442,"FLOREŞTI / PRIMARIA COMUNEI FLORESTI",3,5593,"FLOREŞTI",57706,1269,1213,749,461,3,1206,7,1394,181,209,997
13,"CLUJ",127,57706,,443,"FLOREŞTI / SCOALA  GH. SINCAI",3,5593,"FLOREŞTI",57706,1468,1160,972,188,0,1148,12,1585,425,332,816
13,"CLUJ",127,57706,,444,"FLOREŞTI / SCOALA  GH. SINCAI",3,5593,"FLOREŞTI",57706,1334,1057,794,263,0,1047,10,1460,403,264,783
13,"CLUJ",127,57706,,445,"FLOREŞTI / GRADINITA NR.1",3,5593,"FLOREŞTI",57706,827,699,501,198,0,696,3,896,197,169,527
13,"CLUJ",127,57706,,446,"FLOREŞTI / GRADINITA NR.1",3,5593,"FLOREŞTI",57706,1373,1079,872,207,0,1066,13,1468,389,164,902
13,"CLUJ",127,57706,,447,"FLOREŞTI / GRADINITA NR.2",3,5593,"FLOREŞTI",57706,1524,1198,994,204,0,1190,8,1657,459,256,934
13,"CLUJ",127,57706,,448,"FLOREŞTI / GRADINITA NR.2",3,5593,"FLOREŞTI",57706,1572,1306,1045,261,0,1292,14,1703,397,195,1097
13,"CLUJ",127,57706,,449,"FLOREŞTI / SALA DE SPORT CETATEA FETEI",3,5593,"FLOREŞTI",57706,1117,987,653,333,1,977,10,1210,223,136,841
13,"CLUJ",127,57706,,450,"FLOREŞTI / SALA DE SPORT CETATEA FETEI",3,5593,"FLOREŞTI",57706,1192,962,708,254,0,958,4,1278,316,127,831
13,"CLUJ",127,57706,,451,"FLOREŞTI / SALA DE SPORT CETATEA FETEI",3,5593,"FLOREŞTI",57706,1339,1098,808,290,0,1092,6,1449,351,164,928
13,"CLUJ",127,57706,,452,"FLOREŞTI / SALA DE SPORT CETATEA FETEI",3,5593,"FLOREŞTI",57706,1424,1226,918,307,1,1218,8,1527,301,169,1049
13,"CLUJ",127,57706,,453,"LUNA DE SUS / SCOALA LUNA DE SUS",3,5593,"FLOREŞTI",57706,822,576,503,73,0,572,4,904,328,71,501
13,"CLUJ",127,57706,,454,"LUNA DE SUS / SCOALA LUNA DE SUS",3,5593,"FLOREŞTI",57706,961,691,625,66,0,684,7,1056,365,57,627
13,"CLUJ",127,57706,,455,"TĂUŢI / CAMINUL CULTURAL TAUTI",3,5593,"FLOREŞTI",57706,177,176,90,86,0,173,3,243,67,29,144
13,"CLUJ",127,57742,,456,"FRATA / CAMINUL CULTURAL FRATA",3,5597,"FRATA",57742,1634,802,719,83,0,798,4,1802,1000,239,559
13,"CLUJ",127,57742,,457,"BERCHIEŞU / CAMINUL CULTURAL BERCHIESU",3,5597,"FRATA",57742,539,279,235,44,0,274,5,595,316,131,143
13,"CLUJ",127,57742,,458,"POIANA FRĂŢII / CAMINUL CULTURAL POIANA FRATII",3,5597,"FRATA",57742,174,102,90,12,0,100,2,192,90,27,73
13,"CLUJ",127,57742,,459,"SOPORU DE CÎMPIE / CAMINUL CULTURAL SOPORUL DE CAMPIE",3,5597,"FRATA",57742,1002,484,447,37,0,478,6,1102,618,210,268
13,"CLUJ",127,57831,,460,"GEACA / CAMIN CULTURAL GEACA",3,5606,"GEACA",57831,469,319,259,50,10,317,2,516,197,110,207
13,"CLUJ",127,57831,,461,"SUCUTARD / CAMINUL CULTURAL SUCUTARD",3,5606,"GEACA",57831,298,195,154,41,0,193,2,327,132,62,131
13,"CLUJ",127,57831,,462,"LACU / CAMINUL CULTURAL LACU",3,5606,"GEACA",57831,239,175,145,21,9,174,1,264,89,24,150
13,"CLUJ",127,57831,,463,"LEGII / CAMINUL CULTURAL LEGII",3,5606,"GEACA",57831,135,116,88,28,0,112,4,149,33,47,65
13,"CLUJ",127,57831,,464,"CHIRIŞ / SCOALA CHIRIS",3,5606,"GEACA",57831,75,52,36,16,0,52,0,81,29,13,39
13,"CLUJ",127,57831,,465,"PUINI / CAMINUL CULTURAL PUINI",3,5606,"GEACA",57831,81,58,44,14,0,58,0,86,28,18,40
13,"CLUJ",127,57902,,466,"GILĂU / CASA DE CULTURA ""DUMITRU SOPON""",3,5613,"GILĂU",57902,1837,1354,1121,231,2,1344,10,2014,660,339,1005
13,"CLUJ",127,57902,,467,"GILĂU / CAMINUL CULTURAL VECHI GILAU",3,5613,"GILĂU",57902,1675,1176,1019,156,1,1167,9,1843,667,272,895
13,"CLUJ",127,57902,,468,"GILĂU / LICEUL TEORETIC ""GELU VOIEVOD"", CLADIREA INTERNAT",3,5613,"GILĂU",57902,1938,1233,1128,104,1,1229,4,2125,892,377,852
13,"CLUJ",127,57902,,469,"SOMEŞU RECE / SCOALA GENERALA SOMESUL RECE",3,5613,"GILĂU",57902,1030,762,576,184,2,756,6,1136,374,197,559
13,"CLUJ",127,57902,,470,"SOMEŞU RECE / SCOALA  SOMESUL RECE- UZINA ELECTRICA",3,5613,"GILĂU",57902,560,288,251,37,0,287,1,615,327,99,188
13,"CLUJ",127,57948,,471,"GÎRBĂU / CAMINUL CULTURAL GARBAU",3,5617,"GÎRBĂU",57948,587,393,342,50,1,393,0,646,253,121,272
13,"CLUJ",127,57948,,472,"VIŞTEA / SCOALA PRIMARA VISTEA",3,5617,"GÎRBĂU",57948,620,459,402,57,0,454,5,682,223,37,417
13,"CLUJ",127,57948,,473,"TUREA / CAMINUL CULTURAL TUREA",3,5617,"GÎRBĂU",57948,418,269,236,33,0,265,4,460,191,34,231
13,"CLUJ",127,57948,,474,"NĂDĂŞELU / SCOALA CU CLASELE I-IV NADASEL",3,5617,"GÎRBĂU",57948,218,169,127,42,0,169,0,239,70,43,126
13,"CLUJ",127,57948,,475,"CORNEŞTI / CAMINUL CULTURAL CORNESTI",3,5617,"GÎRBĂU",57948,107,112,56,56,0,111,1,115,3,28,83
13,"CLUJ",127,58008,,476,"AGRIŞ / SCOALA",3,5623,"IARA",58008,348,177,155,22,0,176,1,383,206,30,146
13,"CLUJ",127,58008,,477,"BORZEŞTI / CASA",3,5623,"IARA",58008,56,50,26,24,0,49,1,60,10,25,24
13,"CLUJ",127,58008,,478,"BURU / SCOALA",3,5623,"IARA",58008,157,118,89,29,0,114,4,173,55,34,80
13,"CLUJ",127,58008,,479,"CACOVA IERII / SCOALA",3,5623,"IARA",58008,370,191,172,19,0,191,0,406,215,55,136
13,"CLUJ",127,58008,,480,"FĂGETU IERII / SCOALA",3,5623,"IARA",58008,265,118,105,13,0,118,0,290,172,42,76
13,"CLUJ",127,58008,,481,"IARA / SCOALA",3,5623,"IARA",58008,817,410,366,43,1,406,4,900,490,177,229
13,"CLUJ",127,58008,,482,"IARA / SCOALA",3,5623,"IARA",58008,887,434,405,28,1,430,4,978,544,188,242
13,"CLUJ",127,58008,,483,"LUNGEŞTI / CASA",3,5623,"IARA",58008,40,52,24,28,0,52,0,95,43,28,24
13,"CLUJ",127,58008,,484,"MAŞCA / SCOALA",3,5623,"IARA",58008,148,81,59,22,0,81,0,162,81,23,58
13,"CLUJ",127,58008,,485,"MĂGURA IERII / CASA",3,5623,"IARA",58008,28,30,17,13,0,29,1,30,0,13,16
13,"CLUJ",127,58008,,486,"OCOLIŞEL / SCOALA",3,5623,"IARA",58008,109,60,45,15,0,59,1,119,59,23,36
13,"CLUJ",127,58008,,487,"SURDUC / SCOALA",3,5623,"IARA",58008,257,161,136,25,0,160,1,280,119,66,94
13,"CLUJ",127,58008,,488,"VALEA VADULUI / SCOALA",3,5623,"IARA",58008,42,35,19,16,0,35,0,45,10,18,17
13,"CLUJ",127,58142,,489,"ICLOD / SCOALA DIN ICLOD",3,5637,"ICLOD",58142,1641,1001,902,97,2,994,7,1805,804,368,626
13,"CLUJ",127,58142,,490,"FUNDĂTURA / SCOALA DIN FUNDATURA",3,5637,"ICLOD",58142,583,410,346,64,0,409,1,642,232,148,261
13,"CLUJ",127,58142,,491,"LIVADA / SCOALA DIN LIVADA",3,5637,"ICLOD",58142,843,535,471,64,0,527,8,926,391,167,360
13,"CLUJ",127,58142,,492,"ORMAN / SCOALA DIN ORMAN",3,5637,"ICLOD",58142,464,257,216,41,0,255,2,511,254,74,181
13,"CLUJ",127,58204,,493,"NADĂŞU / Căminul Cultural",3,5643,"IZVORU CRIŞULUI",58204,210,144,120,24,0,144,0,231,87,54,90
13,"CLUJ",127,58204,,494,"IZVORU CRIŞULUI / Primăria Comunei",3,5643,"IZVORU CRIŞULUI",58204,787,465,429,36,0,459,6,867,402,39,420
13,"CLUJ",127,58204,,495,"ŞAULA / Şcoala Generală",3,5643,"IZVORU CRIŞULUI",58204,327,224,201,23,0,224,0,359,135,22,202
13,"CLUJ",127,55106,,496,"JICHIŞU DE JOS / Căminul Cultural",3,5648,"JICHIŞU DE JOS",55106,346,260,210,48,2,256,4,381,121,122,134
13,"CLUJ",127,55106,,497,"CODOR / Căminul Cultural",3,5648,"JICHIŞU DE JOS",55106,344,231,209,22,0,228,3,376,145,107,121
13,"CLUJ",127,55106,,498,"JICHIŞU DE SUS / Şcoala Generală",3,5648,"JICHIŞU DE JOS",55106,199,151,120,31,0,150,1,219,68,98,52
13,"CLUJ",127,55106,,499,"TĂRPIU / Şcoala Generală",3,5648,"JICHIŞU DE JOS",55106,96,84,60,24,0,84,0,107,23,54,30
13,"CLUJ",127,55106,,500,"ŞIGĂU / Şcoala Generală",3,5648,"JICHIŞU DE JOS",55106,23,30,13,17,0,30,0,39,9,19,11
13,"CLUJ",127,58259,,501,"JUCU DE SUS / Primăria Comunei",3,5654,"JUCU",58259,1312,807,659,148,0,801,6,1445,638,231,570
13,"CLUJ",127,58259,,502,"JUCU DE MIJLOC / Şcoala Generală",3,5654,"JUCU",58259,844,538,445,93,0,532,6,924,386,99,433
13,"CLUJ",127,58259,,503,"GĂDĂLIN / Şcoala Generală",3,5654,"JUCU",58259,512,406,298,108,0,398,8,564,158,146,252
13,"CLUJ",127,58259,,504,"VIŞEA / Şcoala Generală",3,5654,"JUCU",58259,479,284,255,29,0,282,2,527,243,67,215
13,"CLUJ",127,58259,,505,"JUC-HERGHELIE / Şcoala Generală",3,5654,"JUCU",58259,369,249,213,36,0,248,1,405,156,65,183
13,"CLUJ",127,58311,,506,"LUNA / Căminul Cultural ""Prof. Nicolae Mazare"" Luna",3,5660,"LUNA",58311,1143,610,565,35,10,604,6,1255,645,146,458
13,"CLUJ",127,58311,,507,"LUNA / Căminul Cultural ""Prof. Nicolae Mazare"" Luna",3,5660,"LUNA",58311,993,588,541,43,4,584,4,1100,512,191,393
13,"CLUJ",127,58311,,508,"LUNCANI / Caminul Cultural Luncani",3,5660,"LUNA",58311,1257,621,572,40,9,620,1,1383,762,138,482
13,"CLUJ",127,58311,,509,"GLIGOREŞTI / Grădiniţa Gligoresti",3,5660,"LUNA",58311,470,283,261,21,1,282,1,515,232,83,199
13,"CLUJ",127,58357,,510,"MUNTELE RECE / Căminul Cultural",3,5664,"MĂGURI-RĂCĂTĂU",58357,433,278,194,84,0,276,2,476,198,91,185
13,"CLUJ",127,58357,,511,"MĂGURI-RĂCĂTĂU / Primăria Comunei",3,5664,"MĂGURI-RĂCĂTĂU",58357,681,379,324,55,0,377,2,744,365,98,279
13,"CLUJ",127,58357,,512,"MĂGURI / Şcoala Generală",3,5664,"MĂGURI-RĂCĂTĂU",58357,735,456,436,20,0,456,0,810,354,98,358
13,"CLUJ",127,58393,,513,"MĂNĂSTIRENI / Primăria Comunei",3,5668,"MĂNĂSTIRENI",58393,793,560,475,85,0,556,4,874,314,151,405
13,"CLUJ",127,58393,,514,"BEDECIU / Şcoala Generală",3,5668,"MĂNĂSTIRENI",58393,454,375,332,43,0,373,2,500,125,190,183
13,"CLUJ",127,58464,,515,"SCRIND-FRĂSINET / Şcoala Generală",3,5675,"MĂRGĂU",58464,151,129,99,30,0,129,0,165,36,35,94
13,"CLUJ",127,58464,,516,"BUTENI / Camin Cultural",3,5675,"MĂRGĂU",58464,189,151,106,45,0,151,0,208,57,55,96
13,"CLUJ",127,58464,,517,"MĂRGĂU / Primaria Comunei Margau",3,5675,"MĂRGĂU",58464,378,282,228,54,0,279,3,411,129,115,164
13,"CLUJ",127,58464,,518,"RĂCHIŢELE / Clădire propr. Primăriei",3,5675,"MĂRGĂU",58464,612,425,354,71,0,422,3,673,248,100,322
13,"CLUJ",127,58534,,519,"MĂRIŞEL / Şcoala Generală",3,5682,"MĂRIŞEL",58534,91,148,62,86,0,147,1,150,2,16,131
13,"CLUJ",127,58534,,520,"MĂRIŞEL / Şcoala Generală",3,5682,"MĂRIŞEL",58534,1055,783,688,95,0,772,11,1160,377,200,572
13,"CLUJ",127,58534,,521,"MĂRIŞEL / Şcoala Generală",3,5682,"MĂRIŞEL",58534,161,96,83,13,0,91,5,178,82,23,68
13,"CLUJ",127,55160,,522,"MICA / Căminul Cultural",3,5684,"MICA",55160,597,463,402,56,5,459,4,656,193,207,252
13,"CLUJ",127,55160,,523,"MĂNĂSTIREA / Căminul Cultural",3,5684,"MICA",55160,584,448,365,70,13,447,1,642,194,142,305
13,"CLUJ",127,55160,,524,"SÎNMĂRGHITA / Şcoala Generală",3,5684,"MICA",55160,883,551,499,44,8,543,8,972,421,121,422
13,"CLUJ",127,55160,,525,"NIREŞ / Fostul sediu CAP",3,5684,"MICA",55160,929,607,549,57,1,603,4,1020,413,234,369
13,"CLUJ",127,55277,,526,"MIHAI VITEAZU / Şcoala Generală",3,5692,"MIHAI VITEAZU",55277,1500,852,785,67,0,845,7,1653,801,236,609
13,"CLUJ",127,55277,,527,"CHEIA / Şcoala Generală",3,5692,"MIHAI VITEAZU",55277,481,255,217,38,0,254,1,528,273,72,182
13,"CLUJ",127,55277,,528,"CORNEŞTI / Şcoala Generală",3,5692,"MIHAI VITEAZU",55277,626,395,343,52,0,386,9,687,292,121,265
13,"CLUJ",127,55277,,529,"MIHAI VITEAZU / Grădiniţa cu program prelungit",3,5692,"MIHAI VITEAZU",55277,1364,757,691,65,1,748,9,1500,743,166,582
13,"CLUJ",127,55277,,530,"MIHAI VITEAZU / Sala de sport",3,5692,"MIHAI VITEAZU",55277,995,566,523,43,0,562,4,1093,527,146,416
13,"CLUJ",127,58552,,531,"MINTIU GHERLII / Primăria Comunei",3,5696,"MINTIU GHERLII",58552,1272,786,719,67,0,779,7,1405,619,396,383
13,"CLUJ",127,58552,,532,"BUNEŞTI / Şcoala Generală",3,5696,"MINTIU GHERLII",58552,763,428,382,46,0,423,5,840,412,143,280
13,"CLUJ",127,58552,,533,"NIMA / Şcoala Generală",3,5696,"MINTIU GHERLII",58552,605,383,344,39,0,383,0,667,284,183,200
13,"CLUJ",127,58552,,534,"PĂDURENII / Şcoala Generală",3,5696,"MINTIU GHERLII",58552,86,81,55,26,0,80,1,93,12,53,27
13,"CLUJ",127,58552,,535,"PETREŞTI / Şcoala Generală",3,5696,"MINTIU GHERLII",58552,197,126,102,24,0,125,1,216,90,67,58
13,"CLUJ",127,58552,,536,"SALATIU / Şcoala Generală",3,5696,"MINTIU GHERLII",58552,214,136,109,27,0,135,1,235,99,76,59
13,"CLUJ",127,58623,,537,"MOCIU / Căminul Cultural",3,5703,"MOCIU",58623,1364,928,790,123,15,923,5,1505,577,351,572
13,"CLUJ",127,58623,,538,"CHESĂU / Şcoala Generală",3,5703,"MOCIU",58623,288,243,169,32,42,241,2,317,74,73,168
13,"CLUJ",127,58623,,539,"CRIŞENI / Şcoala Generală",3,5703,"MOCIU",58623,216,171,136,35,0,166,5,237,66,85,81
13,"CLUJ",127,58623,,540,"GHIRIŞU ROMÂN / Şcoala Generală",3,5703,"MOCIU",58623,298,239,187,39,13,238,1,328,89,70,168
13,"CLUJ",127,58623,,541,"BOTENI / Sală multifuncţională",3,5703,"MOCIU",58623,181,127,91,27,9,126,1,200,73,61,65
13,"CLUJ",127,58623,,542,"ROŞIENI / Sală multifuncţională",3,5703,"MOCIU",58623,157,111,91,20,0,109,2,172,61,60,49
13,"CLUJ",127,58623,,543,"ZORENII DE VALE / Grădiniţa",3,5703,"MOCIU",58623,278,207,174,33,0,206,1,305,98,83,123
13,"CLUJ",127,58721,,544,"PIETROASA / Căminul Cultural",3,5713,"MOLDOVENEŞTI",58721,111,72,50,22,0,71,1,121,49,14,57
13,"CLUJ",127,58721,,545,"MOLDOVENEŞTI / Primăria Comunei",3,5713,"MOLDOVENEŞTI",58721,589,325,289,36,0,322,3,648,323,82,240
13,"CLUJ",127,58721,,546,"MOLDOVENEŞTI / Şcoala cu clasele I-VIII",3,5713,"MOLDOVENEŞTI",58721,406,239,216,23,0,239,0,444,205,48,191
13,"CLUJ",127,58721,,547,"PLĂIEŞTI / Şcoala cu clasele I-IV",3,5713,"MOLDOVENEŞTI",58721,530,272,247,25,0,271,1,583,311,22,249
13,"CLUJ",127,58721,,548,"PODENI / Şcoala cu clasele I-IV",3,5713,"MOLDOVENEŞTI",58721,403,255,201,54,0,253,2,443,188,97,156
13,"CLUJ",127,58721,,549,"BĂDENI / Casa satului",3,5713,"MOLDOVENEŞTI",58721,571,313,276,35,2,311,2,630,317,40,271
13,"CLUJ",127,58721,,550,"STEJERIŞ / Clădirea Primăriei",3,5713,"MOLDOVENEŞTI",58721,145,94,61,33,0,92,2,155,61,28,64
13,"CLUJ",127,60169,,551,"NEGRENI / Căminul cultural",3,5720,"NEGRENI",60169,1343,1019,878,141,0,1014,5,1485,466,210,804
13,"CLUJ",127,60169,,552,"BUCEA / Clădire şcoală",3,5720,"NEGRENI",60169,596,443,395,48,0,438,5,658,215,139,299
13,"CLUJ",127,60169,,553,"PRELUCELE / Scoala cu clasele I-IV",3,5720,"NEGRENI",60169,97,79,66,13,0,78,1,105,26,15,63
13,"CLUJ",127,58856,,554,"SĂRATA / Căminul Cultural",3,5730,"PANTICEU",58856,232,112,77,35,0,109,3,253,141,39,70
13,"CLUJ",127,58856,,555,"PANTICEU / Primăria Comunei",3,5730,"PANTICEU",58856,539,331,255,76,0,331,0,591,260,130,201
13,"CLUJ",127,58856,,556,"CUBLEŞU SOMEŞAN / Şcoala generală",3,5730,"PANTICEU",58856,332,200,150,44,6,197,3,365,165,119,78
13,"CLUJ",127,58856,,557,"DÎRJA / Şcoala generală",3,5730,"PANTICEU",58856,173,128,92,36,0,127,1,190,62,43,84
13,"CLUJ",127,58856,,558,"CĂTĂLINA / CAMIN CULTURAL",3,5730,"PANTICEU",58856,61,68,34,33,1,67,1,112,44,28,39
13,"CLUJ",127,58794,,559,"PĂLATCA / Şcoala Pălatca",3,5724,"PĂLATCA",58794,704,428,350,78,0,422,6,776,348,126,296
13,"CLUJ",127,58794,,560,"SAVA / Şcoala generală Sava",3,5724,"PĂLATCA",58794,270,170,118,52,0,168,2,298,128,59,109
13,"CLUJ",127,58918,,561,"PLAIURI / Căminul Cultural",3,5736,"PETREŞTII DE JOS",58918,112,98,57,41,0,98,0,123,25,41,57
13,"CLUJ",127,58918,,562,"PETREŞTII DE MIJLOC / Şcoala generală",3,5736,"PETREŞTII DE JOS",58918,122,69,50,18,1,69,0,134,65,15,54
13,"CLUJ",127,58918,,563,"DELENI / Şcoala Generală",3,5736,"PETREŞTII DE JOS",58918,189,155,110,39,6,155,0,209,54,43,112
13,"CLUJ",127,58918,,564,"CRĂEŞTI / Şcoala generală",3,5736,"PETREŞTII DE JOS",58918,173,134,105,29,0,134,0,190,56,27,107
13,"CLUJ",127,58918,,565,"PETREŞTII DE JOS / Cămin Cultural",3,5736,"PETREŞTII DE JOS",58918,525,354,286,53,15,353,1,578,224,78,275
13,"CLUJ",127,58918,,566,"LIVADA / SC DANEPAN S.A.",3,5736,"PETREŞTII DE JOS",58918,159,107,80,27,0,107,0,175,68,34,73
13,"CLUJ",127,58918,,567,"PETREŞTII DE SUS / CAMINUL CULTURAL",3,5736,"PETREŞTII DE JOS",58918,85,70,48,19,3,70,0,94,24,14,56
13,"CLUJ",127,58990,,568,"PLOSCOŞ / Căminul Cultural",3,5744,"PLOSCOŞ",58990,358,215,174,41,0,215,0,397,182,41,174
13,"CLUJ",127,58990,,569,"VALEA FLORILOR / Şcoala cu clasele I-IV",3,5744,"PLOSCOŞ",58990,237,153,127,26,0,151,2,259,106,56,95
13,"CLUJ",127,59041,,570,"POIENI / Primăria Comunei",3,5749,"POIENI",59041,992,614,541,73,0,613,1,1091,477,208,405
13,"CLUJ",127,59041,,571,"BOLOGA / Şcoala  BOLOGA",3,5749,"POIENI",59041,532,401,338,63,0,399,2,586,185,144,255
13,"CLUJ",127,59041,,572,"MORLACA / Şcoala MORLACA",3,5749,"POIENI",59041,669,419,387,32,0,418,1,737,318,104,314
13,"CLUJ",127,59041,,573,"HODIŞU / Şcoala HODIŞU",3,5749,"POIENI",59041,325,222,192,30,0,222,0,358,136,48,174
13,"CLUJ",127,59041,,574,"VALEA DRĂGANULUI / Şcoala VALEA DRĂGANULUI",3,5749,"POIENI",59041,1339,887,768,119,0,877,10,1472,585,334,543
13,"CLUJ",127,59041,,575,"TRANIŞU / Şcoala TRANIŞU",3,5749,"POIENI",59041,317,180,153,27,0,179,1,348,168,57,122
13,"CLUJ",127,59041,,576,"LUNCA VIŞAGULUI / Şcoala LUNCA VIŞAGULUI",3,5749,"POIENI",59041,199,103,89,14,0,102,1,219,116,54,48
13,"CLUJ",127,59130,,577,"RECEA-CRISTUR / Sediul Primăriei Sala de Sedinţe",3,5758,"RECEA-CRISTUR",59130,552,455,321,111,23,448,7,610,155,95,353
13,"CLUJ",127,59130,,578,"ELCIU / Şcoala",3,5758,"RECEA-CRISTUR",59130,105,102,61,41,0,101,1,116,14,35,66
13,"CLUJ",127,59130,,579,"PUSTUŢA / Şcoala",3,5758,"RECEA-CRISTUR",59130,83,80,50,27,3,80,0,105,25,19,61
13,"CLUJ",127,59130,,580,"OSOI / Şcoala",3,5758,"RECEA-CRISTUR",59130,102,113,78,35,0,110,3,127,14,31,79
13,"CLUJ",127,59130,,581,"CIUBĂNCUŢA / Şcoala",3,5758,"RECEA-CRISTUR",59130,141,101,84,17,0,97,4,156,55,30,67
13,"CLUJ",127,59130,,582,"CIUBANCA / Şcoala",3,5758,"RECEA-CRISTUR",59130,92,85,60,25,0,84,1,101,16,30,54
13,"CLUJ",127,59238,,583,"RÎŞCA / Şcoala Gimnazială  cu clasele I-VIII",3,5768,"RÎŞCA",59238,836,498,433,63,2,493,5,917,419,119,374
13,"CLUJ",127,59238,,584,"DEALU MARE / Şcoala primară cu clasele I-IV",3,5768,"RÎŞCA",59238,336,204,181,23,0,201,3,372,168,38,163
13,"CLUJ",127,59238,,585,"MĂRCEŞTI / Şcoala primară cu clasele I-IV",3,5768,"RÎŞCA",59238,174,128,112,16,0,128,0,193,65,38,90
13,"CLUJ",127,59283,,586,"SĂCUIEU / Căminul Cultural",3,5773,"SĂCUIEU",59283,454,267,230,36,1,258,9,500,233,63,195
13,"CLUJ",127,59283,,587,"ROGOJEL / Căminul Cultural",3,5773,"SĂCUIEU",59283,556,366,330,36,0,363,3,611,245,26,337
13,"CLUJ",127,59283,,588,"VIŞAGU / Şcoala Generală cu clasele I-IV",3,5773,"SĂCUIEU",59283,231,160,141,19,0,158,2,255,95,53,105
13,"CLUJ",127,55311,,589,"SĂNDULEŞTI / Şcoala",3,5783,"SĂNDULEŞTI",55311,557,339,283,56,0,334,5,614,275,126,208
13,"CLUJ",127,55311,,590,"COPĂCENI / Şcoala Simion Balint",3,5783,"SĂNDULEŞTI",55311,1107,693,600,93,0,686,7,1222,529,185,501
13,"CLUJ",127,59327,,591,"SĂVĂDISLA / Căminul Cultural",3,5795,"SĂVĂDISLA",59327,868,587,488,91,8,583,4,950,363,49,534
13,"CLUJ",127,59327,,592,"LITA / Căminul Cultural",3,5795,"SĂVĂDISLA",59327,258,178,132,46,0,177,1,284,106,46,131
13,"CLUJ",127,59327,,593,"VĂLIŞOARA / Căminul Cultural",3,5795,"SĂVĂDISLA",59327,55,71,29,42,0,71,0,80,9,24,47
13,"CLUJ",127,59327,,594,"VLAHA / Căminul Cultural",3,5795,"SĂVĂDISLA",59327,728,539,432,107,0,536,3,803,264,29,507
13,"CLUJ",127,59327,,595,"HĂŞDATE / Şcoala cu clasele I-VIII",3,5795,"SĂVĂDISLA",59327,417,285,237,48,0,282,3,460,175,49,233
13,"CLUJ",127,59327,,596,"FINIŞEL / Şcoala cu clasele I-IV",3,5795,"SĂVĂDISLA",59327,677,450,390,60,0,449,1,741,291,184,265
13,"CLUJ",127,59327,,597,"LITENI / Şcoala cu clasele I-IV",3,5795,"SĂVĂDISLA",59327,342,208,187,21,0,208,0,376,168,10,198
13,"CLUJ",127,59327,,598,"STOLNA / Şcoala cu clasele I-IV",3,5795,"SĂVĂDISLA",59327,197,175,129,46,0,175,0,215,40,43,132
13,"CLUJ",127,59434,,599,"SÂNCRAIU / SANCRAIU NR.330 CAMINUL CULTURAL",3,5777,"SÂNCRAIU",59434,965,681,601,55,25,677,4,1064,383,121,556
13,"CLUJ",127,59434,,600,"ALUNIŞU / ALUNISU NR.74 CAMINUL CULTURAL",3,5777,"SÂNCRAIU",59434,99,106,67,30,9,106,0,106,0,29,77
13,"CLUJ",127,59434,,601,"DOMOŞU / DOMOSU NR.22 CAMINUL CULTURAL",3,5777,"SÂNCRAIU",59434,285,224,200,20,4,224,0,315,91,34,190
13,"CLUJ",127,59498,,602,"SÂNMĂRTIN / PRIMARIA SANMARTIN",3,5786,"SÂNMĂRTIN",59498,188,147,110,37,0,147,0,205,58,80,67
13,"CLUJ",127,59498,,603,"CEABA / SC. PRIM. Ceaba",3,5786,"SÂNMĂRTIN",59498,194,175,133,42,0,172,3,215,40,124,48
13,"CLUJ",127,59498,,604,"CUTCA / SC. GIMNAZIALA CUTCA",3,5786,"SÂNMĂRTIN",59498,348,312,243,69,0,311,1,384,72,259,52
13,"CLUJ",127,59498,,605,"SÎMBOIENI / CAMIN CULT. SAMBOIENI",3,5786,"SÂNMĂRTIN",59498,134,133,103,30,0,132,1,147,14,118,14
13,"CLUJ",127,59498,,606,"TÎRGUŞOR / SC. PRIM. TARGUSOR",3,5786,"SÂNMĂRTIN",59498,99,104,61,43,0,103,1,117,13,80,23
13,"CLUJ",127,59498,,607,"MĂHAL / SC. PRIM. MAHAL",3,5786,"SÂNMĂRTIN",59498,76,84,49,33,2,83,1,93,9,57,26
13,"CLUJ",127,59498,,608,"DIVICIORII MARI / SC. PRIM. DIV-MARI",3,5786,"SÂNMĂRTIN",59498,140,148,93,55,0,147,1,154,6,107,40
13,"CLUJ",127,59498,,609,"DIVICIORII MICI / SC. PRIM. DIV-MICI",3,5786,"SÂNMĂRTIN",59498,55,62,35,27,0,62,0,69,7,50,12
13,"CLUJ",127,59416,,610,"SIC / CAMIN CULTURAL SIC",3,5804,"SIC",59416,807,285,260,25,0,281,4,885,600,25,256
13,"CLUJ",127,59416,,611,"SIC / CAMIN CULTURAL SIC",3,5804,"SIC",59416,1289,385,373,12,0,383,2,1419,1034,25,358
13,"CLUJ",127,59586,,612,"SÎNPAUL / Sediul Primariei",3,5806,"SÎNPAUL",59586,704,539,465,71,3,532,7,775,236,128,404
13,"CLUJ",127,59586,,613,"ŞARDU / Sediul Şcolii Gen Sardu",3,5806,"SÎNPAUL",59586,343,266,217,49,0,264,2,374,108,44,220
13,"CLUJ",127,59586,,614,"BERINDU / Sediul Şcolii gen Berindu",3,5806,"SÎNPAUL",59586,356,265,207,58,0,263,2,395,130,128,135
13,"CLUJ",127,59586,,615,"MIHĂIEŞTI / Sediul Şcolii Gen Mihăieşti",3,5806,"SÎNPAUL",59586,238,197,147,50,0,195,2,261,64,45,150
13,"CLUJ",127,59586,,616,"TOPA MICĂ / Magazinul  Cooperaţiei",3,5806,"SÎNPAUL",59586,206,124,87,35,2,123,1,227,103,36,87
13,"CLUJ",127,59657,,617,"SUATU / Sediul administrativ al Primariei Suatu",3,5813,"SUATU",59657,1137,684,573,111,0,679,5,1256,572,113,566
13,"CLUJ",127,59657,,618,"ARUNCUTA / Sediul administrativ din Aruncuta",3,5813,"SUATU",59657,288,186,149,37,0,186,0,317,131,77,109
13,"CLUJ",127,59693,,619,"TRITENII DE JOS / SCOALA PAVEL DAN",3,5823,"TRITENII DE JOS",59693,1265,706,659,46,1,698,8,1394,688,234,464
13,"CLUJ",127,59693,,620,"TRITENII DE SUS / SCOALA PRIMARA",3,5823,"TRITENII DE JOS",59693,894,520,489,31,0,517,3,985,465,167,350
13,"CLUJ",127,59693,,621,"PĂDURENI / CAMIN CULTURAL",3,5823,"TRITENII DE JOS",59693,1001,493,453,40,0,491,2,1104,611,188,303
13,"CLUJ",127,59693,,622,"COLONIA / CAMIN CULTURAL",3,5823,"TRITENII DE JOS",59693,402,248,228,20,0,248,0,443,195,30,218
13,"CLUJ",127,59693,,623,"TRITENII-HOTAR / SCOALA CU CLS I-IV",3,5823,"TRITENII DE JOS",59693,251,163,138,23,2,160,3,276,113,44,116
13,"CLUJ",127,59693,,624,"CLAPA / CASA PARTICULARA",3,5823,"TRITENII DE JOS",59693,68,49,35,14,0,49,0,74,25,18,31
13,"CLUJ",127,59764,,625,"TURENI / PRIMARIA COMUNEI TURENI , NR. 243",3,5830,"TURENI",59764,795,529,447,82,0,529,0,875,346,74,455
13,"CLUJ",127,59764,,626,"CEANU MIC / CAMINUL CULTURAL CEANU MIC , NR.184",3,5830,"TURENI",59764,344,165,136,29,0,163,2,380,215,36,127
13,"CLUJ",127,59764,,627,"COMŞEŞTI / SCOALA CU CLS. I-IV COMSESTI , NR.111",3,5830,"TURENI",59764,194,130,94,36,0,130,0,212,82,38,92
13,"CLUJ",127,59764,,628,"MĂRTINEŞTI / SCOALA CU CLS. I-IV MĂRTINEŞTI ,NR.60",3,5830,"TURENI",59764,296,211,171,40,0,210,1,323,112,28,182
13,"CLUJ",127,59764,,629,"MICEŞTI / SCOALA CU CLS. I - IV MICESTI , NR.57",3,5830,"TURENI",59764,257,179,125,54,0,176,3,283,104,54,122
13,"CLUJ",127,59826,,630,"ŢAGA / Primăria Ţaga",3,5817,"ŢAGA",59826,633,399,361,38,0,394,5,697,298,120,274
13,"CLUJ",127,59826,,631,"SÎNTIOANA / Scoala I-IV Sîntioara",3,5817,"ŢAGA",59826,466,270,239,31,0,269,1,516,246,101,168
13,"CLUJ",127,59826,,632,"NĂSAL / fosta Şcoala I-IV Năsal",3,5817,"ŢAGA",59826,294,179,144,35,0,177,2,322,143,85,92
13,"CLUJ",127,59826,,633,"SÎNTEJUDE / Căminul cultural Sîntejude",3,5817,"ŢAGA",59826,204,158,110,48,0,155,3,222,64,45,110
13,"CLUJ",127,59880,,634,"UNGURAŞ / Caminul Cultural Unguras",3,5836,"UNGURAŞ",59880,1554,713,683,29,1,708,5,1709,996,83,625
13,"CLUJ",127,59880,,635,"BATIN / Scoala Batin",3,5836,"UNGURAŞ",59880,598,392,348,27,17,389,3,659,267,146,243
13,"CLUJ",127,59880,,636,"VALEA UNGURAŞULUI / Scoala Valea Ungurasului",3,5836,"UNGURAŞ",59880,195,139,118,21,0,137,2,216,77,29,108
13,"CLUJ",127,59942,,637,"VAD / CAMIN CULTURAL VAD",3,5842,"VAD",59942,279,244,165,61,18,243,1,307,63,78,165
13,"CLUJ",127,59942,,638,"CETAN / SCOALA CETAN",3,5842,"VAD",59942,463,361,291,65,5,360,1,505,144,125,235
13,"CLUJ",127,59942,,639,"BOGATA DE JOS / CAMIN CULTURAL BOGATA DE JOS",3,5842,"VAD",59942,214,188,145,35,8,185,3,234,46,52,133
13,"CLUJ",127,59942,,640,"CURTUIUŞU DEJULUI / SCOALA CURTUIUS",3,5842,"VAD",59942,150,139,101,26,12,138,1,164,25,21,117
13,"CLUJ",127,59942,,641,"BOGATA DE SUS / SCOALA BOGATA DE SUS",3,5842,"VAD",59942,217,206,163,29,14,203,3,241,35,33,170
13,"CLUJ",127,59942,,642,"VALEA GROŞILOR / SCOALA VALEA GROSILOR",3,5842,"VAD",59942,218,189,116,61,12,187,2,240,51,68,119
13,"CLUJ",127,59942,,643,"CALNA / SCOALA CALNA",3,5842,"VAD",59942,118,100,82,18,0,99,1,129,29,27,72
13,"CLUJ",127,60026,,644,"VALEA IERII / SCOLA GIMNAZIALA VALEA IERII",3,5850,"VALEA IERII",60026,834,647,558,88,1,639,8,917,270,155,484
13,"CLUJ",127,60062,,645,"VIIŞOARA / SCOALA GEN CLS I-VIII",3,5854,"VIIŞOARA",60062,1438,798,751,44,3,789,9,1582,784,96,693
13,"CLUJ",127,60062,,646,"VIIŞOARA / scola gen cls I-IV",3,5854,"VIIŞOARA",60062,1393,796,729,44,23,789,7,1532,736,289,500
13,"CLUJ",127,60062,,647,"VIIŞOARA / scola gen cls I-IV",3,5854,"VIIŞOARA",60062,1215,624,590,23,11,614,10,1342,718,296,318
13,"CLUJ",127,60062,,648,"URCA / SCOALA GEN CLS I-VIII Urca",3,5854,"VIIŞOARA",60062,830,476,428,40,8,476,0,916,440,180,296
13,"CLUJ",127,60099,,649,"VULTURENI / PRIMARIA COMUNEI VULTURENI",3,5857,"VULTURENI",60099,318,235,165,70,0,231,4,350,115,59,172
13,"CLUJ",127,60099,,650,"BĂBUŢIU / SCOALA BABUTIU",3,5857,"VULTURENI",60099,164,138,106,32,0,137,1,180,42,40,97
13,"CLUJ",127,60099,,651,"BĂDEŞTI / CAMINUL CULTURAL BADESTI",3,5857,"VULTURENI",60099,104,99,71,27,1,99,0,114,15,17,82
13,"CLUJ",127,60099,,652,"CHIDEA / FUNDATIA KIDE",3,5857,"VULTURENI",60099,102,88,50,38,0,88,0,111,23,16,72
13,"CLUJ",127,60099,,653,"FĂURENI / CAMINUL CULTURAL FAURENI",3,5857,"VULTURENI",60099,149,133,94,39,0,133,0,165,32,22,111
13,"CLUJ",127,60099,,654,"ŞOIMENI / SCOALA SOIMENI",3,5857,"VULTURENI",60099,280,201,152,48,1,199,2,308,107,65,134
14,"CONSTANŢA","#N/A",60419,,1,"CONSTANŢA / COLEGIUL NATIONAL "" MIHAI EMINESCU""",1,5865,"MUNICIPIUL CONSTANŢA",60419,905,556,423,133,0,546,10,1000,444,201,345
14,"CONSTANŢA","#N/A",60419,,2,"CONSTANŢA / COLEGIUL NATIONAL "" MIHAI EMINESCU""",1,5865,"MUNICIPIUL CONSTANŢA",60419,731,514,394,119,1,505,9,800,286,189,316
14,"CONSTANŢA","#N/A",60419,,3,"CONSTANŢA / ŞCOALA GIMNAZIALA NR.2",1,5865,"MUNICIPIUL CONSTANŢA",60419,1065,655,566,89,0,647,8,1200,545,231,416
14,"CONSTANŢA","#N/A",60419,,4,"CONSTANŢA / COLEGIUL NAŢIONAL MIRCEA CEL BĂTRÂN",1,5865,"MUNICIPIUL CONSTANŢA",60419,714,554,438,115,1,547,7,800,246,208,339
14,"CONSTANŢA","#N/A",60419,,5,"CONSTANŢA / COLEGIUL NAŢIONAL MIRCEA CEL BĂTRÂN",1,5865,"MUNICIPIUL CONSTANŢA",60419,640,533,409,122,2,531,2,700,167,172,359
14,"CONSTANŢA","#N/A",60419,,6,"CONSTANŢA / ŞCOALA GIMNAZIALA NR.28 "" DAN BARBILIAN""",1,5865,"MUNICIPIUL CONSTANŢA",60419,498,320,286,32,2,313,7,500,180,122,191
14,"CONSTANŢA","#N/A",60419,,7,"CONSTANŢA / COLEGIUL COMERCIAL ""CAROL I""",1,5865,"MUNICIPIUL CONSTANŢA",60419,1510,1046,993,53,0,1026,20,1600,554,345,681
14,"CONSTANŢA","#N/A",60419,,8,"CONSTANŢA / COLEGIUL COMERCIAL ""CAROL I""",1,5865,"MUNICIPIUL CONSTANŢA",60419,958,655,583,72,0,646,9,1000,345,225,421
14,"CONSTANŢA","#N/A",60419,,9,"CONSTANŢA / COLEGIUL NATIONAL PEDAGOGIC ""CONSTANTIN BRĂTESCU""",1,5865,"MUNICIPIUL CONSTANŢA",60419,1688,1113,1054,59,0,1104,9,1800,687,405,699
14,"CONSTANŢA","#N/A",60419,,10,"CONSTANŢA / COLEGIUL NATIONAL PEDAGOGIC ""CONSTANTIN BRĂTESCU""",1,5865,"MUNICIPIUL CONSTANŢA",60419,1347,875,787,88,0,855,20,1400,525,300,555
14,"CONSTANŢA","#N/A",60419,,11,"CONSTANŢA / COLEGIUL NATIONAL PEDAGOGIC ""CONSTANTIN BRĂTESCU""",1,5865,"MUNICIPIUL CONSTANŢA",60419,1379,903,856,47,0,888,15,1400,497,329,559
14,"CONSTANŢA","#N/A",60419,,12,"CONSTANŢA / LICEUL TEHNOLOGIC ""IOAN N.ROMAN"" (ŞCOALA NR.25)",1,5865,"MUNICIPIUL CONSTANŢA",60419,1329,826,760,66,0,815,11,1400,574,284,531
14,"CONSTANŢA","#N/A",60419,,13,"CONSTANŢA / LICEUL TEHNOLOGIC ""IOAN N.ROMAN"" (ŞCOALA NR.25)",1,5865,"MUNICIPIUL CONSTANŢA",60419,1216,769,703,65,1,754,15,1300,531,312,442
14,"CONSTANŢA","#N/A",60419,,14,"CONSTANŢA / TEATRUL DE STAT CONSTANŢA (TEATRUL ""FANTASIO"" )",1,5865,"MUNICIPIUL CONSTANŢA",60419,710,534,467,66,1,523,11,800,266,224,299
14,"CONSTANŢA","#N/A",60419,,15,"CONSTANŢA / TEATRUL DE STAT CONSTANŢA (TEATRUL ""FANTASIO"" )",1,5865,"MUNICIPIUL CONSTANŢA",60419,843,587,521,66,0,573,14,900,313,220,353
14,"CONSTANŢA","#N/A",60419,,16,"CONSTANŢA / LICEUL TEORETIC ""TRAIAN""",1,5865,"MUNICIPIUL CONSTANŢA",60419,881,646,551,94,1,637,9,900,254,256,381
14,"CONSTANŢA","#N/A",60419,,17,"CONSTANŢA / LICEUL TEORETIC ""TRAIAN""",1,5865,"MUNICIPIUL CONSTANŢA",60419,488,378,317,29,32,371,7,500,122,136,235
14,"CONSTANŢA","#N/A",60419,,18,"CONSTANŢA / LICEUL TEORETIC ""TRAIAN""",1,5865,"MUNICIPIUL CONSTANŢA",60419,1330,950,860,90,0,937,13,1400,450,283,654
14,"CONSTANŢA","#N/A",60419,,19,"CONSTANŢA / ŞCOALA  GIMNAZIALA NR. 24 ""ION JALEA""",1,5865,"MUNICIPIUL CONSTANŢA",60419,1293,876,796,80,0,869,7,1400,524,337,532
14,"CONSTANŢA","#N/A",60419,,20,"CONSTANŢA / ŞCOALA  GIMNAZIALA NR. 24 ""ION JALEA""",1,5865,"MUNICIPIUL CONSTANŢA",60419,1248,909,849,60,0,896,13,1300,391,345,551
14,"CONSTANŢA","#N/A",60419,,21,"CONSTANŢA / ŞCOALA  GIMNAZIALA NR. 24 ""ION JALEA""",1,5865,"MUNICIPIUL CONSTANŢA",60419,1372,952,888,64,0,936,16,1400,448,358,578
14,"CONSTANŢA","#N/A",60419,,22,"CONSTANŢA / LICEUL CU PROGRAM SPORTIV ""NICOLAE ROTARU "" (ŞCOALA NR.34)",1,5865,"MUNICIPIUL CONSTANŢA",60419,1501,1049,986,63,0,1029,20,1600,551,391,638
14,"CONSTANŢA","#N/A",60419,,23,"CONSTANŢA / LICEUL CU PROGRAM SPORTIV ""NICOLAE ROTARU "" (ŞCOALA NR.34)",1,5865,"MUNICIPIUL CONSTANŢA",60419,1262,838,779,59,0,827,11,1300,462,343,484
14,"CONSTANŢA","#N/A",60419,,24,"CONSTANŢA / LICEUL CU PROGRAM SPORTIV ""NICOLAE ROTARU "" (ŞCOALA NR.34)",1,5865,"MUNICIPIUL CONSTANŢA",60419,1361,941,858,82,1,921,20,1400,459,390,531
14,"CONSTANŢA","#N/A",60419,,25,"CONSTANŢA / LICEUL CU PROGRAM SPORTIV ""NICOLAE ROTARU "" (ŞCOALA NR.34)",1,5865,"MUNICIPIUL CONSTANŢA",60419,1583,1130,1073,57,0,1112,18,1700,570,445,667
14,"CONSTANŢA","#N/A",60419,,26,"CONSTANŢA / COLEGIUL NAŢIONAL  DE ARTE ""REGINA MARIA"" (ŞCOALA NR. 42)",1,5865,"MUNICIPIUL CONSTANŢA",60419,1049,691,663,28,0,678,13,1100,409,266,412
14,"CONSTANŢA","#N/A",60419,,27,"CONSTANŢA / COLEGIUL NAŢIONAL  DE ARTE ""REGINA MARIA"" (ŞCOALA NR. 42)",1,5865,"MUNICIPIUL CONSTANŢA",60419,992,718,685,33,0,700,18,1100,382,229,471
14,"CONSTANŢA","#N/A",60419,,28,"CONSTANŢA / COLEGIUL NAŢIONAL  DE ARTE ""REGINA MARIA"" (ŞCOALA NR. 42)",1,5865,"MUNICIPIUL CONSTANŢA",60419,1127,789,726,63,0,782,7,1200,411,310,472
14,"CONSTANŢA","#N/A",60419,,29,"CONSTANŢA / COLEGIUL NAŢIONAL  DE ARTE ""REGINA MARIA"" (ŞCOALA NR. 42)",1,5865,"MUNICIPIUL CONSTANŢA",60419,640,533,425,108,0,526,7,700,167,208,318
14,"CONSTANŢA","#N/A",60419,,30,"CONSTANŢA / LICEUL TEORETIC  ""OVIDIUS""",1,5865,"MUNICIPIUL CONSTANŢA",60419,1580,1069,983,85,1,1051,18,1600,531,389,662
14,"CONSTANŢA","#N/A",60419,,31,"CONSTANŢA / LICEUL TEORETIC  ""OVIDIUS""",1,5865,"MUNICIPIUL CONSTANŢA",60419,1235,940,812,128,0,924,16,1300,360,373,551
14,"CONSTANŢA","#N/A",60419,,32,"CONSTANŢA / ANEXĂ ŞCOALA GIMNAZIALĂ NR.8",1,5865,"MUNICIPIUL CONSTANŢA",60419,999,655,635,20,0,646,9,1100,445,284,362
14,"CONSTANŢA","#N/A",60419,,33,"CONSTANŢA / ANEXĂ ŞCOALA GIMNAZIALĂ NR.8",1,5865,"MUNICIPIUL CONSTANŢA",60419,1791,1133,1099,34,0,1116,17,1800,667,525,591
14,"CONSTANŢA","#N/A",60419,,34,"CONSTANŢA / ANEXĂ ŞCOALA GIMNAZIALĂ NR.8",1,5865,"MUNICIPIUL CONSTANŢA",60419,1644,887,856,30,1,872,15,1700,813,434,438
14,"CONSTANŢA","#N/A",60419,,35,"CONSTANŢA / ANEXĂ ŞCOALA GIMNAZIALĂ NR.8",1,5865,"MUNICIPIUL CONSTANŢA",60419,1525,1012,957,55,0,997,15,1600,588,480,517
14,"CONSTANŢA","#N/A",60419,,36,"CONSTANŢA / ANEXĂ ŞCOALA GIMNAZIALĂ NR.8",1,5865,"MUNICIPIUL CONSTANŢA",60419,1370,919,849,70,0,909,10,1400,481,420,489
14,"CONSTANŢA","#N/A",60419,,37,"CONSTANŢA / ANEXĂ ŞCOALA GIMNAZIALĂ NR.8",1,5865,"MUNICIPIUL CONSTANŢA",60419,1821,1121,1044,77,0,1104,17,1900,779,499,605
14,"CONSTANŢA","#N/A",60419,,38,"CONSTANŢA / LICEUL TEORETIC  ""C.A.ROSETTI""",1,5865,"MUNICIPIUL CONSTANŢA",60419,1194,864,763,70,31,848,16,1200,336,277,571
14,"CONSTANŢA","#N/A",60419,,39,"CONSTANŢA / LICEUL TEORETIC  ""C.A.ROSETTI""",1,5865,"MUNICIPIUL CONSTANŢA",60419,1107,736,661,74,1,721,15,1200,464,238,483
14,"CONSTANŢA","#N/A",60419,,40,"CONSTANŢA / LICEUL TEORETIC  ""C.A.ROSETTI""",1,5865,"MUNICIPIUL CONSTANŢA",60419,926,648,584,64,0,638,10,1000,352,251,387
14,"CONSTANŢA","#N/A",60419,,41,"CONSTANŢA / LICEUL TEORETIC  ""C.A.ROSETTI""",1,5865,"MUNICIPIUL CONSTANŢA",60419,1297,819,752,67,0,804,15,1400,581,315,489
14,"CONSTANŢA","#N/A",60419,,42,"CONSTANŢA / ŞCOALA GIMNAZIALA NR. 16",1,5865,"MUNICIPIUL CONSTANŢA",60419,1695,1160,1057,102,1,1141,19,1900,740,477,664
14,"CONSTANŢA","#N/A",60419,,43,"CONSTANŢA / ŞCOALA GIMNAZIALA NR. 16",1,5865,"MUNICIPIUL CONSTANŢA",60419,1690,1055,1004,51,0,1042,13,1900,845,460,582
14,"CONSTANŢA","#N/A",60419,,44,"CONSTANŢA / ŞCOALA GIMNAZIALA NR. 16",1,5865,"MUNICIPIUL CONSTANŢA",60419,1743,1212,1093,117,2,1191,21,1900,688,475,716
14,"CONSTANŢA","#N/A",60419,,45,"CONSTANŢA / ŞCOALA GIMNAZIALA NR. 16",1,5865,"MUNICIPIUL CONSTANŢA",60419,1629,977,877,100,0,963,14,1800,823,376,587
14,"CONSTANŢA","#N/A",60419,,46,"CONSTANŢA / ŞCOALA GIMNAZIALA NR. 16",1,5865,"MUNICIPIUL CONSTANŢA",60419,1640,1076,1002,74,0,1048,28,1800,724,436,612
14,"CONSTANŢA","#N/A",60419,,47,"CONSTANŢA / LICEUL TEORETIC "" LUCIAN BLAGA""",1,5865,"MUNICIPIUL CONSTANŢA",60419,1953,1294,1118,176,0,1269,25,2200,906,539,730
14,"CONSTANŢA","#N/A",60419,,48,"CONSTANŢA / COLEGIUL TEHNIC DE MARINĂ ""ALEXANDRU IOAN CUZA"" (LICEUL DE MARINA)",1,5865,"MUNICIPIUL CONSTANŢA",60419,1836,1059,1008,51,0,1041,18,2000,941,437,604
14,"CONSTANŢA","#N/A",60419,,49,"CONSTANŢA / COLEGIUL TEHNIC DE MARINĂ ""ALEXANDRU IOAN CUZA"" (LICEUL DE MARINA)",1,5865,"MUNICIPIUL CONSTANŢA",60419,1720,1049,1004,45,0,1033,16,1900,851,455,578
14,"CONSTANŢA","#N/A",60419,,50,"CONSTANŢA / COLEGIUL TEHNIC DE MARINĂ ""ALEXANDRU IOAN CUZA"" (LICEUL DE MARINA)",1,5865,"MUNICIPIUL CONSTANŢA",60419,1679,1128,1053,75,0,1106,22,1900,772,485,621
14,"CONSTANŢA","#N/A",60419,,51,"CONSTANŢA / COLEGIUL TEHNIC DE MARINĂ ""ALEXANDRU IOAN CUZA"" (LICEUL DE MARINA)",1,5865,"MUNICIPIUL CONSTANŢA",60419,1698,1093,1029,64,0,1079,14,1900,807,448,631
14,"CONSTANŢA","#N/A",60419,,52,"CONSTANŢA / COLEGIUL TEHNIC DE MARINĂ ""ALEXANDRU IOAN CUZA"" (LICEUL DE MARINA)",1,5865,"MUNICIPIUL CONSTANŢA",60419,1672,1095,992,103,0,1067,28,1784,689,461,606
14,"CONSTANŢA","#N/A",60419,,53,"CONSTANŢA / COLEGIUL TEHNIC DE MARINĂ ""ALEXANDRU IOAN CUZA"" (LICEUL DE MARINA)",1,5865,"MUNICIPIUL CONSTANŢA",60419,1512,962,924,38,0,943,19,1700,738,371,572
14,"CONSTANŢA","#N/A",60419,,54,"CONSTANŢA / SCOALA GIMNAZIALA ""GRIGORE ANTIPA"" (ŞCOALA NR. 15 )",1,5865,"MUNICIPIUL CONSTANŢA",60419,1572,1045,995,50,0,1023,22,1700,655,436,587
14,"CONSTANŢA","#N/A",60419,,55,"CONSTANŢA / SCOALA GIMNAZIALA ""GRIGORE ANTIPA"" (ŞCOALA NR. 15 )",1,5865,"MUNICIPIUL CONSTANŢA",60419,1774,1153,1100,53,0,1137,16,1983,830,471,666
14,"CONSTANŢA","#N/A",60419,,56,"CONSTANŢA / SCOALA GIMNAZIALA ""GRIGORE ANTIPA"" (ŞCOALA NR. 15 )",1,5865,"MUNICIPIUL CONSTANŢA",60419,822,573,517,56,0,564,9,900,327,230,334
14,"CONSTANŢA","#N/A",60419,,57,"CONSTANŢA / ŞCOALA GIMNAZIALA NR. 17 ""ION MINULESCU""",1,5865,"MUNICIPIUL CONSTANŢA",60419,1747,1169,1061,108,0,1150,19,1900,731,442,708
14,"CONSTANŢA","#N/A",60419,,58,"CONSTANŢA / ŞCOALA GIMNAZIALA NR. 17 ""ION MINULESCU""",1,5865,"MUNICIPIUL CONSTANŢA",60419,1802,1181,1108,72,1,1155,26,2000,819,397,758
14,"CONSTANŢA","#N/A",60419,,59,"CONSTANŢA / ŞCOALA GIMNAZIALA NR. 17 ""ION MINULESCU""",1,5865,"MUNICIPIUL CONSTANŢA",60419,1829,1122,1077,43,2,1114,8,2000,878,445,669
14,"CONSTANŢA","#N/A",60419,,60,"CONSTANŢA / ŞCOALA GIMNAZIALA NR. 17 ""ION MINULESCU""",1,5865,"MUNICIPIUL CONSTANŢA",60419,1792,1211,1154,56,1,1194,17,1998,787,446,748
14,"CONSTANŢA","#N/A",60419,,61,"CONSTANŢA / ŞCOALA GIMNAZIALA NR. 33 ""ANGHEL SALIGNY""",1,5865,"MUNICIPIUL CONSTANŢA",60419,1334,837,807,29,1,824,13,1500,663,428,396
14,"CONSTANŢA","#N/A",60419,,62,"CONSTANŢA / ŞCOALA GIMNAZIALA NR. 33 ""ANGHEL SALIGNY""",1,5865,"MUNICIPIUL CONSTANŢA",60419,1752,1155,1096,58,1,1128,27,1900,745,532,596
14,"CONSTANŢA","#N/A",60419,,63,"CONSTANŢA / ŞCOALA GIMNAZIALA NR. 33 ""ANGHEL SALIGNY""",1,5865,"MUNICIPIUL CONSTANŢA",60419,1015,664,634,30,0,652,12,1100,436,304,348
14,"CONSTANŢA","#N/A",60419,,64,"CONSTANŢA / ŞCOALA GIMNAZIALA NR. 33 ""ANGHEL SALIGNY""",1,5865,"MUNICIPIUL CONSTANŢA",60419,1082,722,695,27,0,703,19,1200,478,356,347
14,"CONSTANŢA","#N/A",60419,,65,"CONSTANŢA / ŞCOALA GIMNAZIALA  NR. 37",1,5865,"MUNICIPIUL CONSTANŢA",60419,1259,911,790,121,0,893,18,1400,489,399,494
14,"CONSTANŢA","#N/A",60419,,66,"CONSTANŢA / ŞCOALA GIMNAZIALA  NR. 37",1,5865,"MUNICIPIUL CONSTANŢA",60419,1380,896,848,48,0,882,14,1500,604,386,496
14,"CONSTANŢA","#N/A",60419,,67,"CONSTANŢA / ŞCOALA GIMNAZIALA  NR. 37",1,5865,"MUNICIPIUL CONSTANŢA",60419,1360,885,842,42,1,872,13,1500,615,413,459
14,"CONSTANŢA","#N/A",60419,,68,"CONSTANŢA / ŞCOALA GIMNAZIALA NR. 18 ""JEAN BART""",1,5865,"MUNICIPIUL CONSTANŢA",60419,1389,909,819,90,0,891,18,1500,591,390,501
14,"CONSTANŢA","#N/A",60419,,69,"CONSTANŢA / ŞCOALA GIMNAZIALA NR. 18 ""JEAN BART""",1,5865,"MUNICIPIUL CONSTANŢA",60419,1883,1200,1150,50,0,1177,23,2100,900,506,671
14,"CONSTANŢA","#N/A",60419,,70,"CONSTANŢA / ŞCOALA GIMNAZIALA NR. 18 ""JEAN BART""",1,5865,"MUNICIPIUL CONSTANŢA",60419,1339,879,853,26,0,866,13,1500,621,348,518
14,"CONSTANŢA","#N/A",60419,,71,"CONSTANŢA / ŞCOALA GIMNAZIALA NR. 18 ""JEAN BART""",1,5865,"MUNICIPIUL CONSTANŢA",60419,1106,729,693,31,5,718,11,1190,461,274,444
14,"CONSTANŢA","#N/A",60419,,72,"CONSTANŢA / LICEUL TEHNOLOGIC ""GHEORGHE MIRON COSTIN"" (INDUSTRIE ALIMENTARA)",1,5865,"MUNICIPIUL CONSTANŢA",60419,1406,912,862,50,0,894,18,1600,688,340,554
14,"CONSTANŢA","#N/A",60419,,73,"CONSTANŢA / LICEUL TEHNOLOGIC ""GHEORGHE MIRON COSTIN"" (INDUSTRIE ALIMENTARA)",1,5865,"MUNICIPIUL CONSTANŢA",60419,1644,1035,943,92,0,1011,24,1800,765,444,567
14,"CONSTANŢA","#N/A",60419,,74,"CONSTANŢA / LICEUL TEHNOLOGIC  ""DIMITRIE LEONIDA""",1,5865,"MUNICIPIUL CONSTANŢA",60419,1913,1202,1147,54,1,1171,31,2100,898,450,721
14,"CONSTANŢA","#N/A",60419,,75,"CONSTANŢA / LICEUL TEHNOLOGIC  ""DIMITRIE LEONIDA""",1,5865,"MUNICIPIUL CONSTANŢA",60419,1831,1176,1105,71,0,1155,21,2000,824,489,666
14,"CONSTANŢA","#N/A",60419,,76,"CONSTANŢA / ŞCOALA GIMNAZIALA NR. 40 ""AUREL VLAICU""",1,5865,"MUNICIPIUL CONSTANŢA",60419,1702,985,925,60,0,967,18,1900,915,425,542
14,"CONSTANŢA","#N/A",60419,,77,"CONSTANŢA / ŞCOALA GIMNAZIALA NR. 40 ""AUREL VLAICU""",1,5865,"MUNICIPIUL CONSTANŢA",60419,873,582,534,48,0,566,16,1000,418,259,307
14,"CONSTANŢA","#N/A",60419,,78,"CONSTANŢA / ŞCOALA GIMNAZIALA NR. 40 ""AUREL VLAICU""",1,5865,"MUNICIPIUL CONSTANŢA",60419,1525,989,918,70,1,977,12,1700,711,397,580
14,"CONSTANŢA","#N/A",60419,,79,"CONSTANŢA / ŞCOALA GIMNAZIALA NR. 40 ""AUREL VLAICU""",1,5865,"MUNICIPIUL CONSTANŢA",60419,1696,1039,1000,39,0,1019,20,1900,861,421,598
14,"CONSTANŢA","#N/A",60419,,80,"CONSTANŢA / ŞCOALA GIMNAZIALA NR. 40 ""AUREL VLAICU""",1,5865,"MUNICIPIUL CONSTANŢA",60419,945,610,546,64,0,592,18,1000,390,246,346
14,"CONSTANŢA","#N/A",60419,,81,"CONSTANŢA / ŞCOALA GIMNAZIALA NR. 40 ""AUREL VLAICU""",1,5865,"MUNICIPIUL CONSTANŢA",60419,961,570,533,37,0,556,14,1100,530,262,294
14,"CONSTANŢA","#N/A",60419,,82,"CONSTANŢA / ŞCOALA GIMNAZIALA NR. 40 ""AUREL VLAICU""",1,5865,"MUNICIPIUL CONSTANŢA",60419,1280,668,617,51,0,657,11,1400,732,344,313
14,"CONSTANŢA","#N/A",60419,,83,"CONSTANŢA / ŞCOALA GIMNAZIALA NR. 19",1,5865,"MUNICIPIUL CONSTANŢA",60419,1679,1074,1020,54,0,1049,25,1900,826,466,583
14,"CONSTANŢA","#N/A",60419,,84,"CONSTANŢA / ŞCOALA GIMNAZIALA NR. 19",1,5865,"MUNICIPIUL CONSTANŢA",60419,1351,877,828,49,0,870,7,1500,623,383,487
14,"CONSTANŢA","#N/A",60419,,85,"CONSTANŢA / ŞCOALA GIMNAZIALA NR. 31",1,5865,"MUNICIPIUL CONSTANŢA",60419,1696,1057,977,79,1,1039,18,1900,843,510,529
14,"CONSTANŢA","#N/A",60419,,86,"CONSTANŢA / ŞCOALA GIMNAZIALA NR. 31",1,5865,"MUNICIPIUL CONSTANŢA",60419,1237,790,736,54,0,775,15,1400,610,440,335
14,"CONSTANŢA","#N/A",60419,,87,"CONSTANŢA / ŞCOALA GIMNAZIALA NR. 31",1,5865,"MUNICIPIUL CONSTANŢA",60419,1306,731,686,45,0,719,12,1400,669,443,276
14,"CONSTANŢA","#N/A",60419,,88,"CONSTANŢA / LICEUL TEHNOLOGIC  ""GHEORGHE DUCA""",1,5865,"MUNICIPIUL CONSTANŢA",60419,1673,1099,995,103,1,1082,17,1800,701,566,516
14,"CONSTANŢA","#N/A",60419,,89,"CONSTANŢA / ŞCOALA GIMNAZIALA ""MARIN SORESCU"" (SCOALA NR. 20 )",1,5865,"MUNICIPIUL CONSTANŢA",60419,872,555,514,41,0,549,6,1000,445,245,304
14,"CONSTANŢA","#N/A",60419,,90,"CONSTANŢA / ŞCOALA  GIMNAZIALA NR. 22 ""I.C.BRATIANU""",1,5865,"MUNICIPIUL CONSTANŢA",60419,1847,1135,1087,48,0,1116,19,2000,865,510,606
14,"CONSTANŢA","#N/A",60419,,91,"CONSTANŢA / ŞCOALA  GIMNAZIALA NR. 22 ""I.C.BRATIANU""",1,5865,"MUNICIPIUL CONSTANŢA",60419,1253,882,812,70,0,867,15,1400,518,338,529
14,"CONSTANŢA","#N/A",60419,,92,"CONSTANŢA / CENTRUL SCOLAR PENTRU EDUCATIE INCLUZIVA""MARIA MONTESSORI"" (ŞCOALA AJUTATOARE NR. 2)",1,5865,"MUNICIPIUL CONSTANŢA",60419,1710,1094,1067,27,0,1078,16,1900,806,510,568
14,"CONSTANŢA","#N/A",60419,,93,"CONSTANŢA / CENTRUL SCOLAR PENTRU EDUCATIE INCLUZIVA""MARIA MONTESSORI"" (ŞCOALA AJUTATOARE NR. 2)",1,5865,"MUNICIPIUL CONSTANŢA",60419,848,571,529,42,0,564,7,900,329,209,355
14,"CONSTANŢA","#N/A",60419,,94,"CONSTANŢA / CENTRUL SCOLAR PENTRU EDUCATIE INCLUZIVA""MARIA MONTESSORI"" (ŞCOALA AJUTATOARE NR. 2)",1,5865,"MUNICIPIUL CONSTANŢA",60419,1132,731,674,57,0,716,15,1200,469,233,483
14,"CONSTANŢA","#N/A",60419,,95,"CONSTANŢA / CENTRUL SCOLAR PENTRU EDUCATIE INCLUZIVA""MARIA MONTESSORI"" (ŞCOALA AJUTATOARE NR. 2)",1,5865,"MUNICIPIUL CONSTANŢA",60419,935,579,552,27,0,572,7,1000,421,213,359
14,"CONSTANŢA","#N/A",60419,,96,"CONSTANŢA / ŞCOALA GIMNAZIALA NR. 8",1,5865,"MUNICIPIUL CONSTANŢA",60419,1759,1122,1030,92,0,1105,17,1900,778,433,672
14,"CONSTANŢA","#N/A",60419,,97,"CONSTANŢA / ŞCOALA GIMNAZIALA NR. 8",1,5865,"MUNICIPIUL CONSTANŢA",60419,1618,1148,1016,132,0,1121,27,1800,652,416,705
14,"CONSTANŢA","#N/A",60419,,98,"CONSTANŢA / ŞCOALA GIMNAZIALA NR. 8",1,5865,"MUNICIPIUL CONSTANŢA",60419,1658,1144,1049,93,2,1121,23,1800,656,428,693
14,"CONSTANŢA","#N/A",60419,,99,"CONSTANŢA / ŞCOALA GIMNAZIALA NR. 8",1,5865,"MUNICIPIUL CONSTANŢA",60419,1554,1063,1001,61,1,1043,20,1700,637,372,671
14,"CONSTANŢA","#N/A",60419,,100,"CONSTANŢA / ŞCOALA GIMNAZIALA NR.23 ""CONSTANTIN BRÂNCOVEANU""",1,5865,"MUNICIPIUL CONSTANŢA",60419,1658,1146,1014,130,2,1127,19,1798,652,440,687
14,"CONSTANŢA","#N/A",60419,,101,"CONSTANŢA / ŞCOALA GIMNAZIALA NR.23 ""CONSTANTIN BRÂNCOVEANU""",1,5865,"MUNICIPIUL CONSTANŢA",60419,1157,962,748,214,0,942,20,1300,338,360,582
14,"CONSTANŢA","#N/A",60419,,102,"CONSTANŢA / ŞCOALA GIMNAZIALA NR.23 ""CONSTANTIN BRÂNCOVEANU""",1,5865,"MUNICIPIUL CONSTANŢA",60419,920,743,586,157,0,730,13,1001,258,190,540
14,"CONSTANŢA","#N/A",60419,,103,"CONSTANŢA / ŞCOALA GIMNAZIALA NR. 39 ""NICOLAE TONITZA""",1,5865,"MUNICIPIUL CONSTANŢA",60419,1940,1318,1236,82,0,1301,17,2100,782,570,731
14,"CONSTANŢA","#N/A",60419,,104,"CONSTANŢA / ŞCOALA GIMNAZIALA NR. 39 ""NICOLAE TONITZA""",1,5865,"MUNICIPIUL CONSTANŢA",60419,1646,1143,1075,68,0,1121,22,1800,657,436,685
14,"CONSTANŢA","#N/A",60419,,105,"CONSTANŢA / ŞCOALA GIMNAZIALA NR. 39 ""NICOLAE TONITZA""",1,5865,"MUNICIPIUL CONSTANŢA",60419,1802,1173,1127,46,0,1158,15,2000,827,478,680
14,"CONSTANŢA","#N/A",60419,,106,"CONSTANŢA / ŞCOALA GIMNAZIALA NR. 39 ""NICOLAE TONITZA""",1,5865,"MUNICIPIUL CONSTANŢA",60419,1964,1329,1240,89,0,1312,17,2200,871,518,794
14,"CONSTANŢA","#N/A",60419,,107,"CONSTANŢA / CENTRUL DE PERFECŢIONARE AL MARINEI CIVILE",1,5865,"MUNICIPIUL CONSTANŢA",60419,1774,1222,1052,170,0,1207,15,1900,678,426,781
14,"CONSTANŢA","#N/A",60419,,108,"CONSTANŢA / CENTRUL DE PERFECŢIONARE AL MARINEI CIVILE",1,5865,"MUNICIPIUL CONSTANŢA",60419,1957,1270,1210,60,0,1252,18,2200,930,451,801
14,"CONSTANŢA","#N/A",60419,,109,"CONSTANŢA / CENTRUL DE PERFECŢIONARE AL MARINEI CIVILE",1,5865,"MUNICIPIUL CONSTANŢA",60419,1257,853,787,66,0,833,20,1400,547,314,519
14,"CONSTANŢA","#N/A",60419,,110,"CONSTANŢA / ŞCOALA GIMNAZIALA  NR. 10  ""MIHAIL KOICIU""",1,5865,"MUNICIPIUL CONSTANŢA",60419,1535,1009,951,58,0,984,25,1700,691,385,599
14,"CONSTANŢA","#N/A",60419,,111,"CONSTANŢA / ŞCOALA GIMNAZIALA  NR. 10  ""MIHAIL KOICIU""",1,5865,"MUNICIPIUL CONSTANŢA",60419,1311,911,851,60,0,900,11,1400,489,319,581
14,"CONSTANŢA","#N/A",60419,,112,"CONSTANŢA / ŞCOALA GIMNAZIALA  NR. 10  ""MIHAIL KOICIU""",1,5865,"MUNICIPIUL CONSTANŢA",60419,1942,1319,1255,63,1,1295,24,2100,781,509,786
14,"CONSTANŢA","#N/A",60419,,113,"CONSTANŢA / ŞCOALA GIMNAZIALA  NR. 10  ""MIHAIL KOICIU""",1,5865,"MUNICIPIUL CONSTANŢA",60419,1644,1090,1040,50,0,1065,25,1800,710,406,659
14,"CONSTANŢA","#N/A",60419,,114,"CONSTANŢA / ŞCOALA GIMNAZIALA NR. 10  ""MIHAIL KOICIU""",1,5865,"MUNICIPIUL CONSTANŢA",60419,1634,1049,1014,35,0,1039,10,1800,751,406,633
14,"CONSTANŢA","#N/A",60419,,115,"CONSTANŢA / CENTRUL ŞCOLAR ""ALBATROS""",1,5865,"MUNICIPIUL CONSTANŢA",60419,1198,861,786,75,0,850,11,1300,439,304,546
14,"CONSTANŢA","#N/A",60419,,116,"CONSTANŢA / CENTRUL ŞCOLAR ""ALBATROS""",1,5865,"MUNICIPIUL CONSTANŢA",60419,1790,1226,1139,87,0,1203,23,1999,773,483,720
14,"CONSTANŢA","#N/A",60419,,117,"CONSTANŢA / CENTRUL ŞCOLAR ""ALBATROS""",1,5865,"MUNICIPIUL CONSTANŢA",60419,1053,631,616,14,1,620,11,1200,569,291,329
14,"CONSTANŢA","#N/A",60419,,118,"CONSTANŢA / CENTRUL ŞCOLAR ""ALBATROS""",1,5865,"MUNICIPIUL CONSTANŢA",60419,1055,717,691,26,0,709,8,1200,483,276,433
14,"CONSTANŢA","#N/A",60419,,119,"CONSTANŢA / CENTRUL ŞCOLAR ""ALBATROS""",1,5865,"MUNICIPIUL CONSTANŢA",60419,834,548,529,19,0,540,8,900,352,235,305
14,"CONSTANŢA","#N/A",60419,,120,"CONSTANŢA / CENTRUL SCOLAR PENTRU EDUCATIE INCLUZIVA  ""DELFINUL"" (ŞCOALA AJUTATOARE NR. 1)",1,5865,"MUNICIPIUL CONSTANŢA",60419,1741,1092,1041,51,0,1071,21,1900,808,423,648
14,"CONSTANŢA","#N/A",60419,,121,"CONSTANŢA / CENTRUL SCOLAR PENTRU EDUCATIE INCLUZIVA  ""DELFINUL"" (ŞCOALA AJUTATOARE NR. 1)",1,5865,"MUNICIPIUL CONSTANŢA",60419,1744,1101,1040,60,1,1087,14,1900,799,475,612
14,"CONSTANŢA","#N/A",60419,,122,"CONSTANŢA / ŞCOALA GIMNAZIALA NR. 12 ""B. P. HASDEU""",1,5865,"MUNICIPIUL CONSTANŢA",60419,1887,1346,1250,96,0,1324,22,2100,754,479,845
14,"CONSTANŢA","#N/A",60419,,123,"CONSTANŢA / ŞCOALA GIMNAZIALA NR. 12 ""B. P. HASDEU""",1,5865,"MUNICIPIUL CONSTANŢA",60419,1551,1094,926,167,1,1077,17,1700,606,417,660
14,"CONSTANŢA","#N/A",60419,,124,"CONSTANŢA / ŞCOALA GIMNAZIALA ""DIMITRIE ŞTIUBEI"" (ŞCOALA NR.36 )",1,5865,"MUNICIPIUL CONSTANŢA",60419,1230,894,777,117,0,874,20,1400,506,291,583
14,"CONSTANŢA","#N/A",60419,,125,"CONSTANŢA / SCOALA GIMNAZIALA ""DIMITRIE ŞTIUBEI"" (ŞCOALA NR.36)",1,5865,"MUNICIPIUL CONSTANŢA",60419,1754,1109,1066,43,0,1090,19,1897,788,419,671
14,"CONSTANŢA","#N/A",60419,,126,"CONSTANŢA / SCOALA GIMNAZIALA ""DIMITRIE ŞTIUBEI"" (ŞCOALA NR.36)",1,5865,"MUNICIPIUL CONSTANŢA",60419,1963,1305,1249,54,2,1275,30,2200,895,504,771
14,"CONSTANŢA","#N/A",60419,,127,"CONSTANŢA / SCOALA GIMNAZIALA ""DIMITRIE ŞTIUBEI"" (ŞCOALA NR.36)",1,5865,"MUNICIPIUL CONSTANŢA",60419,1223,890,772,117,1,870,20,1300,410,342,528
14,"CONSTANŢA","#N/A",60419,,128,"CONSTANŢA / SCOALA GIMNAZIALA ""DIMITRIE ŞTIUBEI"" (ŞCOALA NR.36)",1,5865,"MUNICIPIUL CONSTANŢA",60419,1972,1289,1232,57,0,1272,17,2200,911,527,745
14,"CONSTANŢA","#N/A",60419,,129,"CONSTANŢA / GRĂDINIŢA CU PROGRAM PRELUNGIT ""MUGUREL"" (GRĂDINIŢA NR. 43)",1,5865,"MUNICIPIUL CONSTANŢA",60419,1515,978,925,51,2,972,6,1696,718,444,528
14,"CONSTANŢA","#N/A",60419,,130,"CONSTANŢA / GRĂDINIŢA CU PROGRAM PRELUNGIT ""MUGUREL"" (GRĂDINIŢA NR. 43)",1,5865,"MUNICIPIUL CONSTANŢA",60419,1689,1144,1085,59,0,1127,17,1898,754,487,640
14,"CONSTANŢA","#N/A",60419,,131,"CONSTANŢA / GRĂDINIŢA CU PROGRAM NORMAL NR. 51",1,5865,"MUNICIPIUL CONSTANŢA",60419,1608,1079,949,128,2,1058,21,1800,721,447,611
14,"CONSTANŢA","#N/A",60419,,132,"CONSTANŢA / GRĂDINIŢA CU PROGRAM NORMAL NR. 51",1,5865,"MUNICIPIUL CONSTANŢA",60419,1669,1134,1073,60,1,1115,19,1800,666,444,671
14,"CONSTANŢA","#N/A",60419,,133,"CONSTANŢA / AGENŢIA FISCALĂ NR.1-4",1,5865,"MUNICIPIUL CONSTANŢA",60419,1686,1160,1068,91,1,1144,16,1900,740,425,719
14,"CONSTANŢA","#N/A",60419,,134,"CONSTANŢA / AGENŢIA FISCALĂ NR.1-4",1,5865,"MUNICIPIUL CONSTANŢA",60419,1558,1082,1004,78,0,1071,11,1700,618,458,613
14,"CONSTANŢA","#N/A",60419,,135,"CONSTANŢA / LICEUL TEORETIC  ""GEORGE CĂLINESCU""",1,5865,"MUNICIPIUL CONSTANŢA",60419,1216,832,760,71,1,816,16,1300,468,356,460
14,"CONSTANŢA","#N/A",60419,,136,"CONSTANŢA / LICEUL TEORETIC  ""GEORGE CĂLINESCU""",1,5865,"MUNICIPIUL CONSTANŢA",60419,1152,884,803,80,1,868,16,1300,416,352,516
14,"CONSTANŢA","#N/A",60419,,137,"CONSTANŢA / LICEUL TEORETIC  ""GEORGE CĂLINESCU""",1,5865,"MUNICIPIUL CONSTANŢA",60419,1159,825,769,56,0,810,15,1300,475,284,526
14,"CONSTANŢA","#N/A",60419,,138,"CONSTANŢA / ŞCOALA GIMNAZIALA NR.14",1,5865,"MUNICIPIUL CONSTANŢA",60419,1668,1051,1033,16,2,1036,15,1800,749,377,659
14,"CONSTANŢA","#N/A",60419,,139,"CONSTANŢA / ŞCOALA GIMNAZIALA NR.14",1,5865,"MUNICIPIUL CONSTANŢA",60419,1826,1204,1085,66,53,1188,16,2000,796,513,675
14,"CONSTANŢA","#N/A",60419,,140,"CONSTANŢA / ŞCOALA GIMNAZIALA NR.14",1,5865,"MUNICIPIUL CONSTANŢA",60419,857,578,451,98,29,575,3,900,322,296,279
14,"CONSTANŢA","#N/A",60419,,141,"CONSTANŢA / ŞCOALA  GIMNAZIALA NR. 38 ""DIMITRIE CANTEMIR""",1,5865,"MUNICIPIUL CONSTANŢA",60419,1067,795,690,104,1,787,8,1200,405,343,444
14,"CONSTANŢA","#N/A",60419,,142,"CONSTANŢA / ŞCOALA  GIMNAZIALA NR. 38 ""DIMITRIE CANTEMIR""",1,5865,"MUNICIPIUL CONSTANŢA",60419,1098,758,715,43,0,743,15,1200,442,344,399
14,"CONSTANŢA","#N/A",60419,,143,"CONSTANŢA / LICEUL TEORETIC ""DECEBAL""",1,5865,"MUNICIPIUL CONSTANŢA",60419,1010,706,658,48,0,692,14,1100,394,305,387
14,"CONSTANŢA","#N/A",60419,,144,"CONSTANŢA / LICEUL TEORETIC ""DECEBAL""",1,5865,"MUNICIPIUL CONSTANŢA",60419,651,497,394,103,0,494,3,700,203,198,296
14,"CONSTANŢA","#N/A",60419,,145,"CONSTANŢA / LICEUL TEORETIC ""DECEBAL""",1,5865,"MUNICIPIUL CONSTANŢA",60419,629,481,387,92,2,477,4,700,219,166,311
14,"CONSTANŢA","#N/A",60419,,146,"CONSTANŢA / LICEUL TEORETIC ""DECEBAL""",1,5865,"MUNICIPIUL CONSTANŢA",60419,941,623,549,74,0,612,11,1000,377,253,359
14,"CONSTANŢA","#N/A",60419,,147,"CONSTANŢA / LICEUL TEHNOLOGIC ""VIRGIL MADGEARU"" (ŞCOALA NR.35)",1,5865,"MUNICIPIUL CONSTANŢA",60419,943,680,563,116,1,668,12,1000,320,284,384
14,"CONSTANŢA","#N/A",60419,,148,"CONSTANŢA / LICEUL TEHNOLOGIC ""VIRGIL MADGEARU"" (ŞCOALA NR.35)",1,5865,"MUNICIPIUL CONSTANŢA",60419,1209,871,750,121,0,858,13,1300,429,330,528
14,"CONSTANŢA","#N/A",60419,,149,"CONSTANŢA / LICEUL TEHNOLOGIC ""VIRGIL MADGEARU"" (ŞCOALA NR.35)",1,5865,"MUNICIPIUL CONSTANŢA",60419,865,691,560,130,1,682,9,1000,309,323,359
14,"CONSTANŢA","#N/A",60419,,150,"CONSTANŢA / GRĂDINIŢA CU PROGRAM PRELUNGIT""AMICII"" (GRĂDINIŢA  NR.12 )",1,5865,"MUNICIPIUL CONSTANŢA",60419,1309,933,810,123,0,906,27,1400,467,407,499
14,"CONSTANŢA","#N/A",60419,,151,"CONSTANŢA / ŞCOALA GIMNAZIALA NR. 29 ""MIHAI VITEAZUL""",1,5865,"MUNICIPIUL CONSTANŢA",60419,747,593,442,150,1,582,11,800,207,240,342
14,"CONSTANŢA","#N/A",60419,,152,"CONSTANŢA / ŞCOALA GIMNAZIALA NR. 29 ""MIHAI VITEAZUL""",1,5865,"MUNICIPIUL CONSTANŢA",60419,787,632,512,120,0,616,16,900,268,277,339
14,"CONSTANŢA","#N/A",60419,,153,"CONSTANŢA / ŞCOALA GIMNAZIALA NR. 29 ""MIHAI VITEAZUL""",1,5865,"MUNICIPIUL CONSTANŢA",60419,1283,826,782,44,0,816,10,1400,574,365,451
14,"CONSTANŢA","#N/A",60419,,154,"CONSTANŢA / ŞCOALA NR. 29 ""MIHAI VITEAZU""",1,5865,"MUNICIPIUL CONSTANŢA",60419,719,520,491,29,0,515,5,800,280,237,278
14,"CONSTANŢA","#N/A",60419,,155,"CONSTANŢA / ŞCOALA GIMNAZIALA NR. 7 ""REMUS OPREANU""",1,5865,"MUNICIPIUL CONSTANŢA",60419,1278,977,848,128,1,970,7,1400,423,368,602
14,"CONSTANŢA","#N/A",60419,,156,"CONSTANŢA / ŞCOALA GIMNAZIALA NR. 7 ""REMUS OPREANU""",1,5865,"MUNICIPIUL CONSTANŢA",60419,828,535,479,55,1,532,3,900,365,204,328
14,"CONSTANŢA","#N/A",60419,,157,"CONSTANŢA / ŞCOALA GIMNAZIALA NR. 7 ""REMUS OPREANU""",1,5865,"MUNICIPIUL CONSTANŢA",60419,1362,976,907,69,0,960,16,1499,523,421,539
14,"CONSTANŢA","#N/A",60419,,158,"CONSTANŢA / ŞCOALA GIMNAZIALA NR. 7 ""REMUS OPREANU""",1,5865,"MUNICIPIUL CONSTANŢA",60419,1462,1099,978,121,0,1089,10,1600,501,427,662
14,"CONSTANŢA","#N/A",60419,,159,"CONSTANŢA / ŞCOALA GIMNAZIALA NR. 7 ""REMUS OPREANU""",1,5865,"MUNICIPIUL CONSTANŢA",60419,1288,929,866,63,0,911,18,1400,471,374,537
14,"CONSTANŢA","#N/A",60419,,160,"CONSTANŢA / ŞCOALA GIMNAZIALA NR.6 ""NICOLAE TITULESCU""",1,5865,"MUNICIPIUL CONSTANŢA",60419,1027,782,680,102,0,770,12,1100,318,279,491
14,"CONSTANŢA","#N/A",60419,,161,"CONSTANŢA / ŞCOALA GIMNAZIALA NR.6 ""NICOLAE TITULESCU""",1,5865,"MUNICIPIUL CONSTANŢA",60419,1187,847,810,36,1,833,14,1300,453,299,534
14,"CONSTANŢA","#N/A",60419,,162,"CONSTANŢA / ŞCOALA GIMNAZIALA NR.6 ""NICOLAE TITULESCU""",1,5865,"MUNICIPIUL CONSTANŢA",60419,1092,832,726,106,0,820,12,1200,368,251,569
14,"CONSTANŢA","#N/A",60419,,163,"CONSTANŢA / ŞCOALA GIMNAZIALA NR.6 ""NICOLAE TITULESCU""",1,5865,"MUNICIPIUL CONSTANŢA",60419,1079,734,691,43,0,726,8,1200,466,219,507
14,"CONSTANŢA","#N/A",60419,,164,"CONSTANŢA / GRĂDINIŢA CU PROGRAM PRELUNGIT ""NOROCEL""(GRĂDINIŢA NR.13)",1,5865,"MUNICIPIUL CONSTANŢA",60419,950,695,618,74,3,681,14,1000,305,312,369
14,"CONSTANŢA","#N/A",60419,,165,"CONSTANŢA / GRĂDINIŢA CU PROGRAM PRELUNGIT ""NOROCEL""(GRĂDINIŢA NR.13)",1,5865,"MUNICIPIUL CONSTANŢA",60419,1084,804,742,62,0,788,16,1200,396,309,479
14,"CONSTANŢA","#N/A",60419,,166,"CONSTANŢA / PALATUL COPIILOR",1,5865,"MUNICIPIUL CONSTANŢA",60419,745,530,508,22,0,520,10,800,270,203,317
14,"CONSTANŢA","#N/A",60419,,167,"CONSTANŢA / PALATUL COPIILOR",1,5865,"MUNICIPIUL CONSTANŢA",60419,629,428,375,53,0,419,9,699,271,164,255
14,"CONSTANŢA","#N/A",60419,,168,"CONSTANŢA / SCOALA GIMNAZIALA ""SPECTRUM"" (ŞCOALA NR.27)",1,5865,"MUNICIPIUL CONSTANŢA",60419,1472,1058,941,117,0,1048,10,1600,542,388,660
14,"CONSTANŢA","#N/A",60419,,169,"CONSTANŢA / COLEGIUL TEHNIC ""TOMIS""",1,5865,"MUNICIPIUL CONSTANŢA",60419,1085,762,723,39,0,746,16,1200,438,243,503
14,"CONSTANŢA","#N/A",60419,,170,"CONSTANŢA / SCOALA GIMNAZIALA  ""SPECTRUM"" (ŞCOALA NR.27)",1,5865,"MUNICIPIUL CONSTANŢA",60419,1681,1121,1046,74,1,1101,20,1900,779,348,753
14,"CONSTANŢA","#N/A",60419,,171,"CONSTANŢA / COLEGIUL TEHNIC ""TOMIS""",1,5865,"MUNICIPIUL CONSTANŢA",60419,1018,769,645,124,0,758,11,1100,331,272,486
14,"CONSTANŢA","#N/A",60419,,172,"CONSTANŢA / COLEGIUL TEHNIC ""TOMIS""",1,5865,"MUNICIPIUL CONSTANŢA",60419,674,525,422,103,0,520,5,700,175,175,345
14,"CONSTANŢA","#N/A",60419,,173,"CONSTANŢA / COLEGIUL TEHNIC ""TOMIS""",1,5865,"MUNICIPIUL CONSTANŢA",60419,1079,996,748,48,200,980,16,1200,204,392,588
14,"CONSTANŢA","#N/A",60419,,174,"CONSTANŢA / ŞCOALA GIMNAZIALA NR.30 ""GHEORGHE ŢIŢEICA""",1,5865,"MUNICIPIUL CONSTANŢA",60419,1243,768,719,49,0,750,18,1400,632,278,472
14,"CONSTANŢA","#N/A",60419,,175,"CONSTANŢA / ŞCOALA NR.1",1,5865,"MUNICIPIUL CONSTANŢA",60419,1266,868,829,39,0,862,6,1400,532,268,594
14,"CONSTANŢA","#N/A",60419,,176,"CONSTANŢA / ŞCOALA NR.1",1,5865,"MUNICIPIUL CONSTANŢA",60419,1001,698,639,59,0,687,11,1100,402,222,465
14,"CONSTANŢA","#N/A",60419,,177,"CONSTANŢA / ŞCOALA NR.1",1,5865,"MUNICIPIUL CONSTANŢA",60419,1064,764,690,74,0,750,14,1200,436,286,464
14,"CONSTANŢA","#N/A",60419,,178,"CONSTANŢA / CĂMINUL DE PENSIONARI",1,5865,"MUNICIPIUL CONSTANŢA",60419,1186,906,738,168,0,887,19,1300,394,306,581
14,"CONSTANŢA","#N/A",60419,,179,"CONSTANŢA / CĂMINUL DE PENSIONARI",1,5865,"MUNICIPIUL CONSTANŢA",60419,1773,1101,1052,48,1,1083,18,2000,899,376,707
14,"CONSTANŢA","#N/A",60419,,180,"CONSTANŢA / COLEGIUL TEHNIC ENERGETIC",1,5865,"MUNICIPIUL CONSTANŢA",60419,1257,880,789,91,0,864,16,1400,520,292,572
14,"CONSTANŢA","#N/A",60419,,181,"CONSTANŢA / COLEGIUL TEHNIC ENERGETIC",1,5865,"MUNICIPIUL CONSTANŢA",60419,787,675,479,195,1,655,20,900,225,208,447
14,"CONSTANŢA","#N/A",60419,,182,"CONSTANŢA / COLEGIUL TEHNIC ENERGETIC",1,5865,"MUNICIPIUL CONSTANŢA",60419,1268,921,806,115,0,914,7,1400,479,322,592
14,"CONSTANŢA","#N/A",60419,,183,"CONSTANŢA / COLEGIUL TEHNIC ENERGETIC",1,5865,"MUNICIPIUL CONSTANŢA",60419,1756,1193,1118,75,0,1173,20,1900,707,433,740
14,"CONSTANŢA","#N/A",60419,,184,"CONSTANŢA / ŞCOALA GIMNAZIALA  NR. 3 ""CIPRIAN PORUMBESCU""",1,5865,"MUNICIPIUL CONSTANŢA",60419,1516,1077,989,88,0,1056,21,1700,623,376,680
14,"CONSTANŢA","#N/A",60419,,185,"CONSTANŢA / ŞCOALA GIMNAZIALA  NR. 3 ""CIPRIAN PORUMBESCU""",1,5865,"MUNICIPIUL CONSTANŢA",60419,1181,861,755,106,0,847,14,1300,439,319,528
14,"CONSTANŢA","#N/A",60419,,186,"CONSTANŢA / ŞCOALA GIMNAZIALA  NR. 3 ""CIPRIAN PORUMBESCU""",1,5865,"MUNICIPIUL CONSTANŢA",60419,1075,758,691,67,0,736,22,1200,442,240,496
14,"CONSTANŢA","#N/A",60419,,187,"CONSTANŢA / GRĂDINIŢA NR.45",1,5865,"MUNICIPIUL CONSTANŢA",60419,929,740,622,118,0,724,16,1000,260,246,478
14,"CONSTANŢA","#N/A",60419,,188,"CONSTANŢA / UNIVERSITATEA ""OVIDIUS""",1,5865,"MUNICIPIUL CONSTANŢA",60419,1850,1208,1130,78,0,1190,18,2000,792,424,766
14,"CONSTANŢA","#N/A",60419,,189,"CONSTANŢA / UNIVERSITATEA ""OVIDIUS""",1,5865,"MUNICIPIUL CONSTANŢA",60419,1104,914,694,220,0,903,11,1200,286,280,623
14,"CONSTANŢA","#N/A",60419,,190,"CONSTANŢA / UNIVERSITATEA ""OVIDIUS""",1,5865,"MUNICIPIUL CONSTANŢA",60419,1156,860,713,103,44,848,12,1300,440,303,545
14,"CONSTANŢA","#N/A",60419,,191,"CONSTANŢA / UNIVERSITATEA ""OVIDIUS""",1,5865,"MUNICIPIUL CONSTANŢA",60419,56,145,35,110,0,143,2,300,155,33,110
14,"CONSTANŢA","#N/A",60419,,192,"CONSTANŢA / ŞCOALA GIMNAZIALA NR. 43  ""FERDINAND""",1,5865,"MUNICIPIUL CONSTANŢA",60419,675,600,461,139,0,587,13,700,100,177,410
14,"CONSTANŢA","#N/A",60419,,193,"CONSTANŢA / ŞCOALA GIMNAZIALA  NR.5 ""NICOLAE IORGA""",1,5865,"MUNICIPIUL CONSTANŢA",60419,1549,1040,953,48,39,1025,15,1700,660,318,707
14,"CONSTANŢA","#N/A",60419,,194,"CONSTANŢA / ŞCOALA GIMNAZIALA  NR.5 ""NICOLAE IORGA""",1,5865,"MUNICIPIUL CONSTANŢA",60419,806,567,508,59,0,557,10,900,333,202,355
14,"CONSTANŢA","#N/A",60419,,195,"CONSTANŢA / ŞCOALA GIMNAZIALA  NR.5 ""NICOLAE IORGA""",1,5865,"MUNICIPIUL CONSTANŢA",60419,507,348,308,38,2,347,1,600,252,150,197
14,"CONSTANŢA","#N/A",60419,,196,"CONSTANŢA / ANEXĂ LA COLEGIUL NAŢIONAL ""MIRCEA CEL BĂTRÂN""",1,5865,"MUNICIPIUL CONSTANŢA",60419,660,509,461,48,0,501,8,700,191,217,284
14,"CONSTANŢA","#N/A",60419,,197,"CONSTANŢA / ANEXĂ LA COLEGIUL NAŢIONAL ""MIRCEA CEL BĂTRÂN""",1,5865,"MUNICIPIUL CONSTANŢA",60419,651,484,399,83,2,471,13,700,216,149,322
14,"CONSTANŢA","#N/A",60419,,198,"CONSTANŢA / GRĂDINIŢA CU PROGRAM PRELUNGIT NR. 8 (TOMIS II)",1,5865,"MUNICIPIUL CONSTANŢA",60419,845,616,561,54,1,603,13,900,284,253,350
14,"CONSTANŢA","#N/A",60419,,199,"CONSTANŢA / ATELIER ŞCOALĂ",1,5865,"MUNICIPIUL CONSTANŢA",60419,788,550,506,44,0,542,8,900,350,218,324
14,"CONSTANŢA","#N/A",60419,,200,"CONSTANŢA / GRĂDINIŢA NR.6",1,5865,"MUNICIPIUL CONSTANŢA",60419,821,559,510,48,1,552,7,850,291,249,303
14,"CONSTANŢA","#N/A",60419,,201,"CONSTANŢA / ŞCOALA GIMNAZIALA  NR.30 ""GHEORGHE ŢIŢEICA""",1,5865,"MUNICIPIUL CONSTANŢA",60419,904,689,645,44,0,682,7,1000,311,247,435
14,"CONSTANŢA","#N/A",60419,,202,"CONSTANŢA / ŞCOALA GIMNAZIALA  NR.30 ""GHEORGHE ŢIŢEICA""",1,5865,"MUNICIPIUL CONSTANŢA",60419,917,628,591,37,0,618,10,1000,372,236,382
14,"CONSTANŢA","#N/A",60419,,203,"CONSTANŢA / ŞCOALA GIMNAZIALA NR. 11 ""DR.CONSTANTIN ANGELESCU""",1,5865,"MUNICIPIUL CONSTANŢA",60419,1316,973,877,94,2,959,14,1400,427,301,658
14,"CONSTANŢA","#N/A",60419,,204,"CONSTANŢA / ŞCOALA GIMNAZIALA NR. 11 ""DR.CONSTANTIN ANGELESCU""",1,5865,"MUNICIPIUL CONSTANŢA",60419,1591,1150,1067,83,0,1130,20,1800,650,491,639
14,"CONSTANŢA","#N/A",60419,,205,"CONSTANŢA / LICEUL TEHNOLOGIC DE ELECTROTEHNICA SI TELECOMUNICAŢII",1,5865,"MUNICIPIUL CONSTANŢA",60419,1348,1002,901,101,0,989,13,1500,498,337,652
14,"CONSTANŢA","#N/A",60419,,206,"CONSTANŢA / UNIVERSITATEA ""ANDREI ŞAGUNA""",1,5865,"MUNICIPIUL CONSTANŢA",60419,845,621,554,66,1,611,10,900,279,221,390
14,"CONSTANŢA","#N/A",60419,,207,"CONSTANŢA / CARTIER TOMIS PLUS",1,5865,"MUNICIPIUL CONSTANŢA",60419,854,695,582,113,0,686,9,900,205,143,543
14,"CONSTANŢA","#N/A",60419,,208,"MAMAIA / VILA 26",1,5865,"MUNICIPIUL CONSTANŢA",60419,166,179,84,95,0,177,2,200,21,70,107
14,"CONSTANŢA","#N/A",60419,,209,"CONSTANŢA / ŞCOALA GIMNAZIALA  NR. 23  ""CONSTANTIN BRÂNCOVEANU""",1,5865,"MUNICIPIUL CONSTANŢA",60419,1085,793,684,109,0,783,10,1200,407,279,504
14,"CONSTANŢA","#N/A",60482,,210,"MANGALIA / Casa Municipală de Cultură",1,5869,"MUNICIPIUL MANGALIA",60482,1676,1265,1008,256,1,1240,25,1900,635,588,652
14,"CONSTANŢA","#N/A",60482,,211,"MANGALIA / Grup Şcolar Economic",1,5869,"MUNICIPIUL MANGALIA",60482,1306,869,762,106,1,850,19,1400,531,326,524
14,"CONSTANŢA","#N/A",60482,,212,"MANGALIA / Grup Şcolar Industrial ""Ion Bănescu""",1,5869,"MUNICIPIUL MANGALIA",60482,1172,841,659,182,0,823,18,1300,459,281,542
14,"CONSTANŢA","#N/A",60482,,213,"MANGALIA / Grup Şcolar Industrial ""Ion Bănescu""",1,5869,"MUNICIPIUL MANGALIA",60482,1661,998,928,70,0,978,20,1800,802,401,577
14,"CONSTANŢA","#N/A",60482,,214,"MANGALIA / Baza Spotivă Pescăruş",1,5869,"MUNICIPIUL MANGALIA",60482,1263,782,713,69,0,770,12,1400,618,359,411
14,"CONSTANŢA","#N/A",60482,,215,"MANGALIA / Şcoala Generală Nr.3",1,5869,"MUNICIPIUL MANGALIA",60482,1644,1065,992,73,0,1048,17,1799,734,443,605
14,"CONSTANŢA","#N/A",60482,,216,"MANGALIA / Şcoala Generală Nr.3",1,5869,"MUNICIPIUL MANGALIA",60482,1604,979,925,53,1,887,92,1800,821,378,509
14,"CONSTANŢA","#N/A",60482,,217,"MANGALIA / Grădiniţa Nr.3",1,5869,"MUNICIPIUL MANGALIA",60482,1655,970,908,62,0,940,30,1800,830,484,456
14,"CONSTANŢA","#N/A",60482,,218,"MANGALIA / Şcoala Generală Nr.2",1,5869,"MUNICIPIUL MANGALIA",60482,1562,959,907,51,1,934,25,1700,741,419,515
14,"CONSTANŢA","#N/A",60482,,219,"MANGALIA / Şcoala Generală Nr.2",1,5869,"MUNICIPIUL MANGALIA",60482,1722,980,938,42,0,966,14,1900,920,431,535
14,"CONSTANŢA","#N/A",60482,,220,"MANGALIA / Sediu s.c. ECO GOLD S.A.",1,5869,"MUNICIPIUL MANGALIA",60482,1714,1097,1031,65,1,1083,14,1900,803,397,686
14,"CONSTANŢA","#N/A",60482,,221,"MANGALIA / Şc. Generală Nr.1",1,5869,"MUNICIPIUL MANGALIA",60482,1879,1206,1136,70,0,1179,27,2100,894,484,695
14,"CONSTANŢA","#N/A",60482,,222,"MANGALIA / Şc Generală Nr.1",1,5869,"MUNICIPIUL MANGALIA",60482,1925,1134,1079,55,0,1117,17,2101,967,480,637
14,"CONSTANŢA","#N/A",60482,,223,"MANGALIA / Bloc A01",1,5869,"MUNICIPIUL MANGALIA",60482,1099,630,595,35,0,616,14,1200,570,383,233
14,"CONSTANŢA","#N/A",60482,,224,"MANGALIA / Fundatia pentru Tineret",1,5869,"MUNICIPIUL MANGALIA",60482,1493,982,892,90,0,961,21,1600,618,382,579
14,"CONSTANŢA","#N/A",60482,,225,"MANGALIA / ŞC Generală nr.5",1,5869,"MUNICIPIUL MANGALIA",60482,1063,702,637,65,0,695,7,1200,498,263,432
14,"CONSTANŢA","#N/A",60482,,226,"MANGALIA / ŞC Generală nr.5",1,5869,"MUNICIPIUL MANGALIA",60482,1704,1123,1043,80,0,1112,11,1900,777,461,651
14,"CONSTANŢA","#N/A",60482,,227,"MANGALIA / Fundaţia pentru Tineret",1,5869,"MUNICIPIUL MANGALIA",60482,1285,775,718,57,0,764,11,1400,625,348,416
14,"CONSTANŢA","#N/A",60482,,228,"MANGALIA / Hotel Mangalia",1,5869,"MUNICIPIUL MANGALIA",60482,1350,983,781,202,0,964,19,1501,518,455,509
14,"CONSTANŢA","#N/A",60482,,229,"MANGALIA / Club spital Mangalia",1,5869,"MUNICIPIUL MANGALIA",60482,976,641,575,66,0,629,12,1098,457,248,381
14,"CONSTANŢA","#N/A",60482,,230,"MANGALIA / Grădiniţa Callatis",1,5869,"MUNICIPIUL MANGALIA",60482,1804,1003,938,65,0,993,10,2000,997,418,575
14,"CONSTANŢA","#N/A",60482,,231,"MANGALIA / Liceul Callatis",1,5869,"MUNICIPIUL MANGALIA",60482,1791,1226,1056,113,57,1208,18,2000,774,526,682
14,"CONSTANŢA","#N/A",60482,,232,"NEPTUN / Gradinita nr.4 Neptun",1,5869,"MUNICIPIUL MANGALIA",60482,1447,794,709,85,0,785,9,1600,806,292,493
14,"CONSTANŢA","#N/A",60482,,233,"NEPTUN / Incinta Fruvileg",1,5869,"MUNICIPIUL MANGALIA",60482,504,344,257,87,0,338,6,600,256,85,253
14,"CONSTANŢA","#N/A",60847,,234,"MEDGIDIA / CASA DE CULTURĂ  ""I.N.ROMAN""",1,5877,"MUNICIPIUL MEDGIDIA",60847,887,571,532,39,0,561,10,1001,430,312,249
14,"CONSTANŢA","#N/A",60847,,235,"MEDGIDIA / GRĂDINIŢA NR.1 -BILINGVĂ ROMANO-TURCA",1,5877,"MUNICIPIUL MEDGIDIA",60847,839,504,467,37,0,497,7,900,396,260,237
14,"CONSTANŢA","#N/A",60847,,236,"MEDGIDIA / GRADINITA NR.1",1,5877,"MUNICIPIUL MEDGIDIA",60847,889,492,469,23,0,489,3,1000,508,278,211
14,"CONSTANŢA","#N/A",60847,,237,"MEDGIDIA / ŞCOALA ""MIHAIL SADOVEANU""",1,5877,"MUNICIPIUL MEDGIDIA",60847,948,489,464,25,0,486,3,1000,511,300,186
14,"CONSTANŢA","#N/A",60847,,238,"MEDGIDIA / ŞCOALA ""MIHAIL SADOVEANU""",1,5877,"MUNICIPIUL MEDGIDIA",60847,1502,560,538,22,0,541,19,1700,1140,359,182
14,"CONSTANŢA","#N/A",60847,,239,"MEDGIDIA / SALA DE SPORT -ŞCOALA ""MIHAIL SADOVEANU""",1,5877,"MUNICIPIUL MEDGIDIA",60847,1157,455,439,16,0,434,21,1300,845,276,158
14,"CONSTANŢA","#N/A",60847,,240,"MEDGIDIA / GRĂDINIŢA NR.8",1,5877,"MUNICIPIUL MEDGIDIA",60847,1379,682,653,29,0,669,13,1500,818,374,295
14,"CONSTANŢA","#N/A",60847,,241,"MEDGIDIA / LICEUL TEHNOLOGIC ""DRAGOMIR HURMUZESCU""",1,5877,"MUNICIPIUL MEDGIDIA",60847,1226,602,575,25,2,584,18,1384,782,310,274
14,"CONSTANŢA","#N/A",60847,,242,"MEDGIDIA / ŞCOALA ""CONSTANTIN BRÂNCUŞI""",1,5877,"MUNICIPIUL MEDGIDIA",60847,1063,614,599,14,1,606,8,1200,586,318,288
14,"CONSTANŢA","#N/A",60847,,243,"MEDGIDIA / ŞCOALA ""CONSTANTIN BRÂNCUŞI""",1,5877,"MUNICIPIUL MEDGIDIA",60847,1081,620,586,33,1,608,12,1200,580,348,260
14,"CONSTANŢA","#N/A",60847,,244,"MEDGIDIA / LICEUL TEORETIC ""NICOLAE BĂLCESCU""",1,5877,"MUNICIPIUL MEDGIDIA",60847,875,513,462,18,33,506,7,1000,487,266,240
14,"CONSTANŢA","#N/A",60847,,245,"MEDGIDIA / LICEUL TEORETIC ""NICOLAE BĂLCESCU""",1,5877,"MUNICIPIUL MEDGIDIA",60847,816,581,503,33,45,570,11,900,319,322,248
14,"CONSTANŢA","#N/A",60847,,246,"MEDGIDIA / SCOALA ""MIRCEA DRAGOMIRESCU""",1,5877,"MUNICIPIUL MEDGIDIA",60847,917,551,526,25,0,545,6,1000,449,332,213
14,"CONSTANŢA","#N/A",60847,,247,"MEDGIDIA / ŞCOALA ""MIRCEA DRAGOMIRESCU""",1,5877,"MUNICIPIUL MEDGIDIA",60847,839,525,489,36,0,520,5,900,375,339,181
14,"CONSTANŢA","#N/A",60847,,248,"MEDGIDIA / GRĂDINIŢA ""TUNA""",1,5877,"MUNICIPIUL MEDGIDIA",60847,1241,813,781,32,0,804,9,1400,587,407,397
14,"CONSTANŢA","#N/A",60847,,249,"MEDGIDIA / GRĂDINIŢA NR.2",1,5877,"MUNICIPIUL MEDGIDIA",60847,968,628,594,34,0,624,4,1100,472,364,260
14,"CONSTANŢA","#N/A",60847,,250,"MEDGIDIA / GRĂDINIŢA NR.11",1,5877,"MUNICIPIUL MEDGIDIA",60847,802,543,511,31,1,533,10,900,357,290,243
14,"CONSTANŢA","#N/A",60847,,251,"MEDGIDIA / COLEGIUL ""KEMAL ATATURK""",1,5877,"MUNICIPIUL MEDGIDIA",60847,999,639,604,35,0,630,9,1100,461,312,318
14,"CONSTANŢA","#N/A",60847,,252,"MEDGIDIA / HOTEL ""STADION""",1,5877,"MUNICIPIUL MEDGIDIA",60847,931,561,550,11,0,554,7,1000,439,298,256
14,"CONSTANŢA","#N/A",60847,,253,"MEDGIDIA / HOTEL ""STADION""",1,5877,"MUNICIPIUL MEDGIDIA",60847,928,603,572,31,0,587,16,1000,397,337,250
14,"CONSTANŢA","#N/A",60847,,254,"MEDGIDIA / HOTEL ""STADION""",1,5877,"MUNICIPIUL MEDGIDIA",60847,1139,654,626,27,1,648,6,1300,646,411,237
14,"CONSTANŢA","#N/A",60847,,255,"MEDGIDIA / ANEXA - COLEGIUL ""KEMAL ATATURK""",1,5877,"MUNICIPIUL MEDGIDIA",60847,977,551,518,33,0,547,4,1100,549,336,211
14,"CONSTANŢA","#N/A",60847,,256,"MEDGIDIA / ANEXA - COLEGIUL ""KEMAL ATATURK""",1,5877,"MUNICIPIUL MEDGIDIA",60847,809,484,473,11,0,481,3,900,416,285,196
14,"CONSTANŢA","#N/A",60847,,257,"MEDGIDIA / ŞCOALA ""LUCIAN GRIGORESCU""",1,5877,"MUNICIPIUL MEDGIDIA",60847,1110,670,641,29,0,665,5,1199,529,358,307
14,"CONSTANŢA","#N/A",60847,,258,"MEDGIDIA / ŞCOALA ""LUCIAN GRIGORESCU""",1,5877,"MUNICIPIUL MEDGIDIA",60847,684,452,435,17,0,443,9,800,348,236,207
14,"CONSTANŢA","#N/A",60847,,259,"MEDGIDIA / PF AGIOMER MUZECHIR",1,5877,"MUNICIPIUL MEDGIDIA",60847,703,424,388,36,0,421,3,800,376,255,166
14,"CONSTANŢA","#N/A",60847,,260,"MEDGIDIA / ŞCOALA ""I.L.CARAGIALE""",1,5877,"MUNICIPIUL MEDGIDIA",60847,1055,675,624,51,0,668,7,1200,525,330,338
14,"CONSTANŢA","#N/A",60847,,261,"MEDGIDIA / SCOALA ""I.L.CARAGIALE""",1,5877,"MUNICIPIUL MEDGIDIA",60847,1079,575,548,27,0,565,10,1200,625,332,233
14,"CONSTANŢA","#N/A",60847,,262,"MEDGIDIA / SCOALA ""I.L.CARAGIALE""",1,5877,"MUNICIPIUL MEDGIDIA",60847,1068,616,595,21,0,613,3,1200,584,375,238
14,"CONSTANŢA","#N/A",60847,,263,"MEDGIDIA / COLEGIUL TEHNIC ""NICOLAE TITULESCU""",1,5877,"MUNICIPIUL MEDGIDIA",60847,1048,578,545,33,0,574,4,1200,622,345,229
14,"CONSTANŢA","#N/A",60847,,264,"MEDGIDIA / COLEGIUL TEHNIC ""NICOLAE TITULESCU""",1,5877,"MUNICIPIUL MEDGIDIA",60847,1338,814,789,25,0,803,11,1500,686,425,378
14,"CONSTANŢA","#N/A",60847,,265,"MEDGIDIA / ŞCOALA ""SPIRU HARET""",1,5877,"MUNICIPIUL MEDGIDIA",60847,1127,682,633,46,3,669,13,1200,518,426,243
14,"CONSTANŢA","#N/A",60847,,266,"MEDGIDIA / ŞCOALA ""SPIRU HARET""",1,5877,"MUNICIPIUL MEDGIDIA",60847,1234,685,663,22,0,676,9,1400,715,460,216
14,"CONSTANŢA","#N/A",60847,,267,"MEDGIDIA / ŞCOALA ""SPIRU HARET""",1,5877,"MUNICIPIUL MEDGIDIA",60847,1308,767,739,28,0,758,9,1401,634,431,327
14,"CONSTANŢA","#N/A",60847,,268,"MEDGIDIA / GRADINIŢA NR.7",1,5877,"MUNICIPIUL MEDGIDIA",60847,1424,904,866,38,0,894,10,1600,696,450,444
14,"CONSTANŢA","#N/A",60847,,269,"VALEA DACILOR / ŞCOALA ""IULIU PRODAN""",1,5877,"MUNICIPIUL MEDGIDIA",60847,1222,671,648,23,0,668,3,1300,629,355,313
14,"CONSTANŢA","#N/A",60847,,270,"REMUS OPREANU / S.C. ""MAXICOMP"" SRL",1,5877,"MUNICIPIUL MEDGIDIA",60847,293,157,145,12,0,152,5,302,145,60,92
14,"CONSTANŢA","#N/A",61069,,271,"BĂNEASA / ŞCOALA GENERALĂ NR 1 BĂNEASA",1,5881,"ORAŞ BĂNEASA",61069,1010,628,565,39,24,620,8,1100,472,290,330
14,"CONSTANŢA","#N/A",61069,,272,"BĂNEASA / LICEUL TEORETIC BĂNEASA",1,5881,"ORAŞ BĂNEASA",61069,1813,1224,1112,79,33,1211,13,1900,676,529,682
14,"CONSTANŢA","#N/A",61069,,273,"NEGURENI / ŞCOALA GENERALĂ NEGURENI",1,5881,"ORAŞ BĂNEASA",61069,565,367,334,22,11,360,7,600,233,181,179
14,"CONSTANŢA","#N/A",61069,,274,"FĂUREI / ŞCOALA GENERALĂ FĂUREI",1,5881,"ORAŞ BĂNEASA",61069,924,437,408,25,4,422,15,1000,563,158,264
14,"CONSTANŢA","#N/A",60776,,275,"CERNAVODĂ / Şcoala Generală nr. 1",1,5886,"ORAŞ CERNAVODĂ",60776,1686,864,820,44,0,852,12,1900,1036,402,450
14,"CONSTANŢA","#N/A",60776,,276,"CERNAVODĂ / Şcoala Generală nr. 1",1,5886,"ORAŞ CERNAVODĂ",60776,1494,753,719,34,0,749,4,1600,847,384,365
14,"CONSTANŢA","#N/A",60776,,277,"CERNAVODĂ / Grădiniţa nr. 1",1,5886,"ORAŞ CERNAVODĂ",60776,1642,858,830,27,1,848,10,1800,942,366,482
14,"CONSTANŢA","#N/A",60776,,278,"CERNAVODĂ / Şcoala Generală nr. 2",1,5886,"ORAŞ CERNAVODĂ",60776,1511,907,871,36,0,895,12,1700,793,431,464
14,"CONSTANŢA","#N/A",60776,,279,"CERNAVODĂ / Şcoala Generală nr. 3",1,5886,"ORAŞ CERNAVODĂ",60776,1627,1130,977,153,0,1117,13,1800,670,524,593
14,"CONSTANŢA","#N/A",60776,,280,"CERNAVODĂ / Şcoala Generală nr. 3",1,5886,"ORAŞ CERNAVODĂ",60776,1650,1119,986,133,0,1100,19,1800,681,458,642
14,"CONSTANŢA","#N/A",60776,,281,"CERNAVODĂ / Grădiniţa nr. 4",1,5886,"ORAŞ CERNAVODĂ",60776,1412,745,706,22,17,735,10,1600,855,304,431
14,"CONSTANŢA","#N/A",60776,,282,"CERNAVODĂ / Creşa din strada Tudor Vladimirescu",1,5886,"ORAŞ CERNAVODĂ",60776,1021,571,555,15,1,566,5,1100,529,292,274
14,"CONSTANŢA","#N/A",60776,,283,"CERNAVODĂ / Grupul Şcolar Industrial Energetic",1,5886,"ORAŞ CERNAVODĂ",60776,1557,887,813,74,0,876,11,1700,813,363,513
14,"CONSTANŢA","#N/A",60776,,284,"CERNAVODĂ / Grupul Şcolar Industrial Energetic",1,5886,"ORAŞ CERNAVODĂ",60776,1258,755,690,64,1,738,17,1400,645,226,512
14,"CONSTANŢA","#N/A",60776,,285,"CERNAVODĂ / Şcoala Generală nr. 4",1,5886,"ORAŞ CERNAVODĂ",60776,1165,772,652,120,0,760,12,1300,528,296,464
14,"CONSTANŢA","#N/A",60455,,286,"EFORIE SUD / LICEUL CARMEN SILVA EFORIE SUD",1,5888,"ORAŞ EFORIE",60455,1477,1044,926,116,2,1029,15,1600,556,345,684
14,"CONSTANŢA","#N/A",60455,,287,"EFORIE SUD / SEDIUL POLITIEI LOCALE EFORIE SUD",1,5888,"ORAŞ EFORIE",60455,1579,1044,936,106,2,1033,11,1700,656,453,580
14,"CONSTANŢA","#N/A",60455,,288,"EFORIE SUD / GRĂDINIŢA DE COPII EFORIE SUD",1,5888,"ORAŞ EFORIE",60455,1042,683,590,93,0,673,10,1200,517,253,420
14,"CONSTANŢA","#N/A",60455,,289,"EFORIE NORD / HOTEL ""TRAIAN"" EFORIE NORD",1,5888,"ORAŞ EFORIE",60455,1472,922,818,101,3,912,10,1600,678,276,636
14,"CONSTANŢA","#N/A",60455,,290,"EFORIE NORD / SALA DE SPORT  EFORIE NORD",1,5888,"ORAŞ EFORIE",60455,1500,1072,878,194,0,1064,8,1600,528,300,764
14,"CONSTANŢA","#N/A",60455,,291,"EFORIE NORD / ŞCOALA GENERALĂ EFORIE NORD",1,5888,"ORAŞ EFORIE",60455,1641,1154,1045,106,3,1142,12,1800,646,328,814
14,"CONSTANŢA","#N/A",60455,,292,"EFORIE NORD / ŞCOALA GENERALĂ EFORIE NORD",1,5888,"ORAŞ EFORIE",60455,552,431,296,135,0,428,3,600,169,124,304
14,"CONSTANŢA","#N/A",60801,,293,"HÂRŞOVA / Casa de Cultura",1,5891,"ORAŞ HÂRŞOVA",60801,782,504,436,68,0,499,5,900,396,260,239
14,"CONSTANŢA","#N/A",60801,,294,"HÂRŞOVA / Liceul Teoretic ""Ioan Cotovu""",1,5891,"ORAŞ HÂRŞOVA",60801,1488,788,746,41,1,781,7,1600,812,433,348
14,"CONSTANŢA","#N/A",60801,,295,"HÂRŞOVA / CENTRUL PERMANENT PENTRU PERSOANE ABUZATE",1,5891,"ORAŞ HÂRŞOVA",60801,1278,665,637,21,7,653,12,1400,735,340,313
14,"CONSTANŢA","#N/A",60801,,296,"HÂRŞOVA / Şcoala Port Hârşova",1,5891,"ORAŞ HÂRŞOVA",60801,1192,581,548,31,2,577,4,1300,719,304,273
14,"CONSTANŢA","#N/A",60801,,297,"HÂRŞOVA / Şcoala Generală nr. 1",1,5891,"ORAŞ HÂRŞOVA",60801,1175,638,598,38,2,624,14,1300,662,373,251
14,"CONSTANŢA","#N/A",60801,,298,"HÂRŞOVA / Centrul permanent de îngrijire persoane în vârstă",1,5891,"ORAŞ HÂRŞOVA",60801,1418,840,804,23,13,832,8,1600,760,524,308
14,"CONSTANŢA","#N/A",60801,,299,"HÂRŞOVA / Gradiniţa Varoş",1,5891,"ORAŞ HÂRŞOVA",60801,1258,632,611,17,4,617,15,1400,768,370,247
14,"CONSTANŢA","#N/A",60801,,300,"VADU OII / Şcoala Primară Vadu Oii",1,5891,"ORAŞ HÂRŞOVA",60801,320,186,167,19,0,185,1,400,214,117,68
14,"CONSTANŢA","#N/A",62360,,301,"MURFATLAR / LICEUL TEORETIC MURFATLAR",1,5894,"ORAŞ MURFATLAR",62360,1477,892,842,50,0,879,13,1600,708,422,457
14,"CONSTANŢA","#N/A",62360,,302,"MURFATLAR / LICEUL TEORETIC MURFATLAR",1,5894,"ORAŞ MURFATLAR",62360,1231,793,759,31,3,783,10,1400,607,356,427
14,"CONSTANŢA","#N/A",62360,,303,"MURFATLAR / SALA DE SPORT",1,5894,"ORAŞ MURFATLAR",62360,1277,810,741,69,0,793,17,1400,590,341,452
14,"CONSTANŢA","#N/A",62360,,304,"MURFATLAR / ŞCOALA GENERALĂ NR.2 MURFATLAR",1,5894,"ORAŞ MURFATLAR",62360,1797,1225,1141,83,1,1209,16,2000,775,514,695
14,"CONSTANŢA","#N/A",62360,,305,"MURFATLAR / CLUB TINERET MURFATLAR",1,5894,"ORAŞ MURFATLAR",62360,1611,1018,965,52,1,999,19,1800,782,434,565
14,"CONSTANŢA","#N/A",62360,,306,"MURFATLAR / S.C.U.G   S.A. MURFATLAR",1,5894,"ORAŞ MURFATLAR",62360,1003,722,631,91,0,710,12,1100,378,332,378
14,"CONSTANŢA","#N/A",62360,,307,"SIMINOC / CĂMIN CULTURAL SIMINOC",1,5894,"ORAŞ MURFATLAR",62360,917,699,623,68,8,681,18,1000,301,303,378
14,"CONSTANŢA","#N/A",60507,,308,"NĂVODARI / Grădiniţa ,,Peştişorul de Aur""",1,5897,"ORAŞ NĂVODARI",60507,1692,953,879,71,3,942,11,1900,947,393,549
14,"CONSTANŢA","#N/A",60507,,309,"NĂVODARI / Liceul ""Lazăr Edeleanu"", Năvodari",1,5897,"ORAŞ NĂVODARI",60507,1402,877,789,85,3,868,9,1500,623,351,517
14,"CONSTANŢA","#N/A",60507,,310,"NĂVODARI / Liceul ""Lazăr Edeleanu"", Năvodari",1,5897,"ORAŞ NĂVODARI",60507,1262,753,683,69,1,742,11,1400,647,273,469
14,"CONSTANŢA","#N/A",60507,,311,"NĂVODARI / Liceul ""Lazăr Edeleanu"", Năvodari",1,5897,"ORAŞ NĂVODARI",60507,1786,1017,966,50,1,999,18,2000,983,417,582
14,"CONSTANŢA","#N/A",60507,,312,"NĂVODARI / Liceul ""Lazăr Edeleanu"", Năvodari",1,5897,"ORAŞ NĂVODARI",60507,1548,891,830,55,6,874,17,1700,809,321,553
14,"CONSTANŢA","#N/A",60507,,313,"NĂVODARI / Şcoala nr. 1, Năvodari",1,5897,"ORAŞ NĂVODARI",60507,1662,1044,935,109,0,1025,19,1800,756,397,628
14,"CONSTANŢA","#N/A",60507,,314,"NĂVODARI / Şcoala nr. 1, Năvodari",1,5897,"ORAŞ NĂVODARI",60507,1791,1101,1029,72,0,1080,21,2000,899,386,694
14,"CONSTANŢA","#N/A",60507,,315,"NĂVODARI / Creşa nr. 20, Năvodari",1,5897,"ORAŞ NĂVODARI",60507,1874,965,801,164,0,951,14,2100,1135,436,515
14,"CONSTANŢA","#N/A",60507,,316,"NĂVODARI / Şcoala nr. 2, Năvodari",1,5897,"ORAŞ NĂVODARI",60507,1919,1060,1033,27,0,1042,18,2101,1041,467,575
14,"CONSTANŢA","#N/A",60507,,317,"NĂVODARI / Şcoala nr. 2, Năvodari",1,5897,"ORAŞ NĂVODARI",60507,1062,572,533,39,0,557,15,1200,628,236,321
14,"CONSTANŢA","#N/A",60507,,318,"NĂVODARI / Şcoala nr. 2, Năvodari",1,5897,"ORAŞ NĂVODARI",60507,987,546,503,42,1,536,10,1100,554,261,275
14,"CONSTANŢA","#N/A",60507,,319,"NĂVODARI / Grădiniţa Albatros nr. 4",1,5897,"ORAŞ NĂVODARI",60507,1621,939,885,52,2,922,17,1800,861,425,497
14,"CONSTANŢA","#N/A",60507,,320,"NĂVODARI / Clubul Petromidia S.A. Năvodari",1,5897,"ORAŞ NĂVODARI",60507,1473,948,860,88,0,932,16,1600,652,334,598
14,"CONSTANŢA","#N/A",60507,,321,"NĂVODARI / Şcoala nr. 3",1,5897,"ORAŞ NĂVODARI",60507,1007,623,568,54,1,612,11,1100,477,200,412
14,"CONSTANŢA","#N/A",60507,,322,"NĂVODARI / Şcoala nr. 3",1,5897,"ORAŞ NĂVODARI",60507,1007,536,500,36,0,522,14,1100,564,220,302
14,"CONSTANŢA","#N/A",60507,,323,"NĂVODARI / Casa Căsătoriilor, Năvodari",1,5897,"ORAŞ NĂVODARI",60507,1578,967,837,130,0,955,12,1700,733,418,537
14,"CONSTANŢA","#N/A",60507,,324,"NĂVODARI / Centrul Cultural, Năvodari",1,5897,"ORAŞ NĂVODARI",60507,1586,1013,917,96,0,992,21,1700,687,354,638
14,"CONSTANŢA","#N/A",60507,,325,"NĂVODARI / Centrul Cultural, Năvodari",1,5897,"ORAŞ NĂVODARI",60507,1850,1076,1009,66,1,1065,11,2000,924,421,644
14,"CONSTANŢA","#N/A",60507,,326,"NĂVODARI / Clubul Pensionarilor Năvodari",1,5897,"ORAŞ NĂVODARI",60507,1457,1025,959,66,0,1016,9,1600,575,408,608
14,"CONSTANŢA","#N/A",60507,,327,"NĂVODARI / Clubul Pensionarilor Năvodari",1,5897,"ORAŞ NĂVODARI",60507,443,321,230,91,0,317,4,501,180,126,191
14,"CONSTANŢA","#N/A",60507,,328,"NĂVODARI / Coloana Auto -Ecoterm , Năvodari",1,5897,"ORAŞ NĂVODARI",60507,1655,994,936,58,0,982,12,1800,806,402,580
14,"CONSTANŢA","#N/A",60507,,329,"NĂVODARI / Scoală Peninsula, Năvodari",1,5897,"ORAŞ NĂVODARI",60507,443,196,178,18,0,195,1,500,304,94,101
14,"CONSTANŢA","#N/A",60507,,330,"NĂVODARI / Dispensar Tasaul, Năvodari",1,5897,"ORAŞ NĂVODARI",60507,1049,604,556,48,0,596,8,1200,596,274,322
14,"CONSTANŢA","#N/A",60507,,331,"NĂVODARI / Dispensar Năvodari, Năvodari",1,5897,"ORAŞ NĂVODARI",60507,1788,1194,1103,90,1,1172,22,2000,806,435,737
14,"CONSTANŢA","#N/A",62397,,332,"NEGRU VODĂ / CASA DE CULTURĂ",1,5900,"ORAŞ NEGRU VODĂ",62397,1256,713,675,38,0,708,5,1300,587,386,322
14,"CONSTANŢA","#N/A",62397,,333,"NEGRU VODĂ / ŞCOALA GENERALĂ",1,5900,"ORAŞ NEGRU VODĂ",62397,1129,632,563,62,7,622,10,1200,568,370,252
14,"CONSTANŢA","#N/A",62397,,334,"NEGRU VODĂ / CĂMIN CULTURAL",1,5900,"ORAŞ NEGRU VODĂ",62397,1240,642,592,41,9,628,14,1300,658,381,247
14,"CONSTANŢA","#N/A",62397,,335,"NEGRU VODĂ / GRĂDINIŢA CU PROGRAM NORMAL",1,5900,"ORAŞ NEGRU VODĂ",62397,117,97,74,23,0,95,2,200,103,38,57
14,"CONSTANŢA","#N/A",62397,,336,"DARABANI / Sediu Administrativ al Primariei",1,5900,"ORAŞ NEGRU VODĂ",62397,600,284,259,25,0,281,3,700,416,159,122
14,"CONSTANŢA","#N/A",62397,,337,"VÎLCELELE / SCOALA GENERALĂ CLASELE I-IV",1,5900,"ORAŞ NEGRU VODĂ",62397,201,100,82,18,0,96,4,300,200,39,57
14,"CONSTANŢA","#N/A",60687,,338,"OVIDIU / LICEUL TEORETIC OVIDIU",1,5905,"ORAŞ OVIDIU",60687,1821,1157,1034,123,0,1145,12,2000,843,480,665
14,"CONSTANŢA","#N/A",60687,,339,"OVIDIU / LICEUL TEORETIC OVIDIU",1,5905,"ORAŞ OVIDIU",60687,1953,1185,1091,93,1,1155,30,2200,1015,474,681
14,"CONSTANŢA","#N/A",60687,,340,"OVIDIU / ŞCOALA NR. 2 OVIDIU",1,5905,"ORAŞ OVIDIU",60687,1732,1167,1089,78,0,1147,20,1900,733,422,725
14,"CONSTANŢA","#N/A",60687,,341,"OVIDIU / ŞCOALA NR. 2 OVIDIU",1,5905,"ORAŞ OVIDIU",60687,1631,1071,1011,60,0,1054,17,1800,729,382,672
14,"CONSTANŢA","#N/A",60687,,342,"OVIDIU / ŞCOALA NR. 2 OVIDIU",1,5905,"ORAŞ OVIDIU",60687,1758,1144,1072,71,1,1132,12,1900,756,362,770
14,"CONSTANŢA","#N/A",60687,,343,"OVIDIU / CENTRUL CULTURAL OVIDIU",1,5905,"ORAŞ OVIDIU",60687,1796,1230,1112,118,0,1207,23,2000,770,450,757
14,"CONSTANŢA","#N/A",60687,,344,"POIANA / ŞCOALA GENERALĂ  DIN SATUL POIANA",1,5905,"ORAŞ OVIDIU",60687,788,576,499,76,1,572,4,900,324,211,361
14,"CONSTANŢA","#N/A",60687,,345,"CULMEA / SCOALA GENERALA DIN SATUL CULMEA",1,5905,"ORAŞ OVIDIU",60687,977,607,556,51,0,601,6,1100,493,364,237
14,"CONSTANŢA","#N/A",60534,,346,"TECHIRGHIOL / SALA DE SPORT",1,5909,"ORAŞ TECHIRGHIOL",60534,1856,1524,1081,426,17,1494,30,2000,476,613,881
14,"CONSTANŢA","#N/A",60534,,347,"TECHIRGHIOL / GRĂDINIŢA NR.1",1,5909,"ORAŞ TECHIRGHIOL",60534,1695,1133,1038,93,2,1120,13,1903,770,367,753
14,"CONSTANŢA","#N/A",60534,,348,"TECHIRGHIOL / GRĂDINIŢA NR.2",1,5909,"ORAŞ TECHIRGHIOL",60534,1708,1114,1020,94,0,1094,20,1896,782,373,721
14,"CONSTANŢA","#N/A",60534,,349,"TECHIRGHIOL / LICEUL ""EMIL RACOVIŢĂ""",1,5909,"ORAŞ TECHIRGHIOL",60534,1376,917,795,122,0,898,19,1500,583,238,660
14,"CONSTANŢA","#N/A",60598,,350,"23 August / Şcoala cu clasele I-VIII, localitatea 23 August",3,5911,"23 August",60598,1296,808,708,100,0,802,6,1400,592,338,464
14,"CONSTANŢA","#N/A",60598,,351,"23 August / Şcoala cu clasele I-VIII, localitatea 23 August",3,5911,"23 August",60598,1320,806,738,68,0,795,11,1500,694,295,500
14,"CONSTANŢA","#N/A",60598,,352,"DULCEŞTI / Şcoala cu clasele I-VIII, localitatea Dulceşti",3,5911,"23 August",60598,1051,701,642,59,0,698,3,1200,499,194,504
14,"CONSTANŢA","#N/A",60598,,353,"MOŞNENI / Şcoala cu clasele I-VIII, localitatea Moşneni",3,5911,"23 August",60598,990,536,510,26,0,531,5,1100,564,213,318
14,"CONSTANŢA","#N/A",60883,,354,"ADAMCLISI / CĂMIN CULTURAL ADAMCLISI",3,5915,"ADAMCLISI",60883,980,655,590,54,11,649,6,1000,345,312,337
14,"CONSTANŢA","#N/A",60883,,355,"ZORILE / CĂMIN CULTURAL ZORILE",3,5915,"ADAMCLISI",60883,512,335,296,22,17,332,3,600,265,201,131
14,"CONSTANŢA","#N/A",60883,,356,"URLUIA / ŞCOALA GENERALĂ URLUIA",3,5915,"ADAMCLISI",60883,274,205,164,38,3,201,4,300,95,121,80
14,"CONSTANŢA","#N/A",60883,,357,"ABRUD / ŞCOALA GENERALĂ ABRUD",3,5915,"ADAMCLISI",60883,113,88,67,19,2,88,0,200,112,48,40
14,"CONSTANŢA","#N/A",60570,,358,"AGIGEA / Scoala Ion Borcea- Laboratorul de Istorie",3,5921,"AGIGEA",60570,1252,954,799,155,0,941,13,1400,446,359,582
14,"CONSTANŢA","#N/A",60570,,359,"AGIGEA / Scoala Ion Borcea- Laboratorul de  Chimie",3,5921,"AGIGEA",60570,1052,864,738,125,1,849,15,1100,236,299,550
14,"CONSTANŢA","#N/A",60570,,360,"AGIGEA / Gradinita Agigea-Grupa Fluturasilor",3,5921,"AGIGEA",60570,1076,825,735,89,1,812,13,1200,375,363,449
14,"CONSTANŢA","#N/A",60570,,361,"AGIGEA / Gradinita Agigea-Grupa Ratustelor",3,5921,"AGIGEA",60570,1181,836,771,65,0,816,20,1300,464,299,517
14,"CONSTANŢA","#N/A",60570,,362,"AGIGEA / Spitalul de Ftiziologie",3,5921,"AGIGEA",60570,401,336,243,92,1,326,10,499,163,173,153
14,"CONSTANŢA","#N/A",60570,,363,"LAZU / Gradinita Lazu",3,5921,"AGIGEA",60570,1373,1060,889,170,1,1030,30,1400,340,370,660
14,"CONSTANŢA","#N/A",60945,,364,"ALBEŞTI / ŞCOALA GENERALĂ ALBEŞTI",3,5926,"ALBEŞTI",60945,1276,866,747,117,2,855,11,1301,435,255,600
14,"CONSTANŢA","#N/A",60945,,365,"ARSA / ŞCOALA GENERALĂ ARSA",3,5926,"ALBEŞTI",60945,477,297,266,31,0,293,4,500,203,111,182
14,"CONSTANŢA","#N/A",60945,,366,"COTU VĂII / SCOALA GENERALA COTU-VAII",3,5926,"ALBEŞTI",60945,881,536,495,41,0,529,7,900,364,217,312
14,"CONSTANŢA","#N/A",60945,,367,"COROANA / SCOALA GENERALA COROANA",3,5926,"ALBEŞTI",60945,105,71,55,16,0,71,0,200,129,36,35
14,"CONSTANŢA","#N/A",60945,,368,"VÎRTOP / ŞCOALA GENERALĂ VÎRTOP",3,5926,"ALBEŞTI",60945,203,157,134,23,0,155,2,300,143,47,108
14,"CONSTANŢA","#N/A",61005,,369,"ALIMAN / SCOALA GIMNAZIALA ""DAN SPATARU"" ALIMAN",3,5932,"ALIMAN",61005,658,371,332,39,0,369,2,700,329,162,207
14,"CONSTANŢA","#N/A",61005,,370,"DUNĂRENI / SCOALA GIMNAZIALA NR. 1 DUNARENI",3,5932,"ALIMAN",61005,1131,629,606,21,2,623,6,1200,571,298,325
14,"CONSTANŢA","#N/A",61005,,371,"VLAHII / SCOALA PRIMARA NR.2 VLAHII",3,5932,"ALIMAN",61005,406,256,238,18,0,255,1,410,154,149,106
14,"CONSTANŢA","#N/A",63198,,372,"AMZACEA / ŞCOALA AMZACEA",3,5937,"AMZACEA",63198,1137,703,641,62,0,696,7,1200,497,343,353
14,"CONSTANŢA","#N/A",63198,,373,"GENERAL SCĂRIŞOREANU / SCOALA GENERALA G-RAL SCĂRIŞOREANU",3,5937,"AMZACEA",63198,780,449,393,56,0,445,4,900,451,288,157
14,"CONSTANŢA","#N/A",63198,,374,"CASICEA / CĂMIN CULTURAL CASICEA",3,5937,"AMZACEA",63198,337,172,153,18,1,168,4,400,228,84,84
14,"CONSTANŢA","#N/A",63294,,375,"BĂRĂGANU / ŞCOALA CU CLS I - VIII ""EMIL GÂRLEANU""",3,5941,"BĂRĂGANU",63294,913,525,481,44,0,521,4,1000,475,290,231
14,"CONSTANŢA","#N/A",63294,,376,"LANURILE / ŞCOALA GENERALĂ LANURILE",3,5941,"BĂRĂGANU",63294,748,458,407,51,0,451,7,800,342,215,236
14,"CONSTANŢA","#N/A",61121,,377,"CASTELU / Căminul cultural",3,5944,"CASTELU",61121,1170,676,634,42,0,660,16,1300,624,337,323
14,"CONSTANŢA","#N/A",61121,,378,"CASTELU / Căminul cultural",3,5944,"CASTELU",61121,1296,704,677,25,2,688,16,1400,696,378,310
14,"CONSTANŢA","#N/A",61121,,379,"NISIPARI / Cămin cultural",3,5944,"CASTELU",61121,1500,994,925,69,0,987,7,1600,606,312,675
14,"CONSTANŢA","#N/A",61167,,380,"CERCHEZU / CĂMINUL CULTURAL CERCHEZU",3,5947,"CERCHEZU",61167,424,302,262,40,0,302,0,502,200,222,80
14,"CONSTANŢA","#N/A",61167,,381,"CĂSCIOARELE / CĂMINUL CULTURAL CĂSCIOARELE",3,5947,"CERCHEZU",61167,239,189,169,20,0,186,3,300,111,146,40
14,"CONSTANŢA","#N/A",61167,,382,"VIROAGA / CĂMINUL CULTURAL VIROAGA",3,5947,"CERCHEZU",61167,387,269,235,34,0,264,5,402,133,110,154
14,"CONSTANŢA","#N/A",61167,,383,"MĂGURA / CASA AGRONOMULUI MĂGURA",3,5947,"CERCHEZU",61167,86,95,61,33,1,93,2,100,5,52,41
14,"CONSTANŢA","#N/A",61210,,384,"CHIRNOGENI / ŞCOALA GIMNAZIALĂ  NR.1 CHIRNOGENI",3,5952,"CHIRNOGENI",61210,1525,852,780,69,3,843,9,1700,848,432,411
14,"CONSTANŢA","#N/A",61210,,385,"PLOPENI / ŞCOALA GIMNAZIALĂ NR.2 PLOPENI",3,5952,"CHIRNOGENI",61210,898,458,408,49,1,457,1,1000,542,250,207
14,"CONSTANŢA","#N/A",61210,,386,"CREDINŢA / ŞCOALA PRIMARĂ NR.3 CREDINŢA",3,5952,"CHIRNOGENI",61210,243,142,130,12,0,142,0,300,158,66,76
14,"CONSTANŢA","#N/A",61256,,387,"CIOBANU / LICEUL TEHNOLOGIC CIOBANU -SALA CLASA 1",3,5956,"CIOBANU",61256,1257,665,633,32,0,661,4,1400,735,324,337
14,"CONSTANŢA","#N/A",61256,,388,"CIOBANU / LICEUL TEHNOLOGIC CIOBANU -SALA CLASA 2",3,5956,"CIOBANU",61256,1291,650,630,20,0,645,5,1400,750,294,351
14,"CONSTANŢA","#N/A",61256,,389,"MIORIŢA / SCOALA GENERALA MIORIŢA",3,5956,"CIOBANU",61256,265,152,126,26,0,150,2,300,148,58,92
14,"CONSTANŢA","#N/A",61283,,390,"CIOCÎRLIA / CĂMIN CULTURAL SAT CIOCÎRLIA",3,5959,"CIOCÎRLIA",61283,1261,790,722,68,0,773,17,1400,610,345,428
14,"CONSTANŢA","#N/A",61283,,391,"CIOCÎRLIA DE SUS / CĂMIN CULTURAL SAT CIOCÎRLIA DE SUS",3,5959,"CIOCÎRLIA",61283,1143,668,604,64,0,661,7,1300,632,303,358
14,"CONSTANŢA","#N/A",61318,,392,"COBADIN / CĂMIN CULTURAL COBADIN",3,5962,"COBADIN",61318,1898,1059,966,93,0,1049,10,2100,1041,511,538
14,"CONSTANŢA","#N/A",61318,,393,"COBADIN / ŞCOALA TĂTARĂ COBADIN",3,5962,"COBADIN",61318,1798,1015,930,84,1,1006,9,2000,985,517,489
14,"CONSTANŢA","#N/A",61318,,394,"COBADIN / SEDIUL FOSTULUI C.A.P. COBADIN",3,5962,"COBADIN",61318,1702,871,820,51,0,864,7,1900,1029,480,384
14,"CONSTANŢA","#N/A",61318,,395,"CONACU / ŞCOALA GENERALĂ CONACU",3,5962,"COBADIN",61318,288,135,118,17,0,134,1,300,165,63,71
14,"CONSTANŢA","#N/A",61318,,396,"NEGREŞTI / CĂMIN CULTURAL NEGREŞTI",3,5962,"COBADIN",61318,389,226,201,25,0,223,3,400,174,130,93
14,"CONSTANŢA","#N/A",61318,,397,"VIIŞOARA / GRĂDINIŢA VIIŞOARA",3,5962,"COBADIN",61318,1247,730,669,61,0,716,14,1400,670,349,367
14,"CONSTANŢA","#N/A",61372,,398,"COGEALAC / GRĂDINIŢA COGEALAC",3,5968,"COGEALAC",61372,1612,957,891,62,4,951,6,1800,843,579,372
14,"CONSTANŢA","#N/A",61372,,399,"COGEALAC / GRUP ŞCOLAR  COGEALAC",3,5968,"COGEALAC",61372,1353,843,778,56,9,832,11,1501,658,476,356
14,"CONSTANŢA","#N/A",61372,,400,"TARIVERDE / ŞCOALA GENERALĂ  TARIVERDE",3,5968,"COGEALAC",61372,861,526,468,48,10,521,5,900,374,265,256
14,"CONSTANŢA","#N/A",61372,,401,"RÎMNICU DE JOS / ŞCOALA GENERALĂ  RÂMNICU DE JOS",3,5968,"COGEALAC",61372,662,342,315,27,0,340,2,700,358,160,180
14,"CONSTANŢA","#N/A",61452,,402,"COMANA / SCOALA CU CLASELE I-VIII COMANA",3,5974,"COMANA",61452,766,429,391,38,0,427,2,800,371,162,265
14,"CONSTANŢA","#N/A",61452,,403,"TĂTARU / ŞCOALA GENERALĂ""NEGIP HAGI FAZAL"" TĂTARU",3,5974,"COMANA",61452,506,240,220,20,0,238,2,600,360,115,123
14,"CONSTANŢA","#N/A",61452,,404,"PELINU / ŞCOALA CU CLS. I - IV PELINU",3,5974,"COMANA",61452,235,137,123,14,0,135,2,300,163,53,82
14,"CONSTANŢA","#N/A",61513,,405,"CORBU / ŞCOALA GIMNAZIALĂ ""GHEORGHE LAZĂR""",3,5978,"CORBU",61513,1448,910,784,123,3,901,9,1600,690,300,601
14,"CONSTANŢA","#N/A",61513,,406,"CORBU / GRĂDINIŢA CU PROGRAM NORMAL NR. 1",3,5978,"CORBU",61513,1323,773,678,93,2,766,7,1400,627,266,500
14,"CONSTANŢA","#N/A",61513,,407,"CORBU / CĂMIN CULTURAL CORBU DE SUS",3,5978,"CORBU",61513,1635,960,890,70,0,950,10,1800,840,391,559
14,"CONSTANŢA","#N/A",61513,,408,"VADU / SCOALA PRIMARA VADU",3,5978,"CORBU",61513,548,383,310,73,0,373,10,600,217,107,266
14,"CONSTANŢA","#N/A",63286,,409,"COSTINEŞTI / SCOALA COSTINESTI",3,5982,"COSTINEŞTI",63286,905,732,567,164,1,717,15,1000,268,244,473
14,"CONSTANŢA","#N/A",63286,,410,"SCHITU / SCOALA SCHITU",3,5982,"COSTINEŞTI",63286,1696,1205,1078,127,0,1191,14,1900,695,475,716
14,"CONSTANŢA","#N/A",61559,,411,"CRUCEA / CAMIN CULTURAL",3,5985,"CRUCEA",61559,947,448,409,39,0,442,6,1000,552,217,225
14,"CONSTANŢA","#N/A",61559,,412,"GĂLBIORI / CAMIN CULTURAL",3,5985,"CRUCEA",61559,246,154,134,20,0,152,2,300,146,42,110
14,"CONSTANŢA","#N/A",61559,,413,"BĂLTĂGEŞTI / ŞCOALA  PRIMARĂ NR.1",3,5985,"CRUCEA",61559,359,175,156,19,0,175,0,400,225,126,49
14,"CONSTANŢA","#N/A",61559,,414,"CRIŞAN / ŞCOALA PRIMARĂ NR.2",3,5985,"CRUCEA",61559,299,157,142,15,0,152,5,300,143,73,79
14,"CONSTANŢA","#N/A",61559,,415,"STUPINA / ŞCOALA PRIMARĂ NR.4",3,5985,"CRUCEA",61559,563,270,244,26,0,270,0,600,330,177,93
14,"CONSTANŢA","#N/A",61559,,416,"ŞIRIU / ŞCOALA PRIMARĂ NR.3",3,5985,"CRUCEA",61559,185,87,77,10,0,86,1,200,113,41,45
14,"CONSTANŢA","#N/A",61620,,417,"CUMPĂNA / SCOALA NOUA(BANCA MONDIALA)",3,5992,"CUMPĂNA",61620,1535,1015,849,166,0,1003,12,1700,685,464,539
14,"CONSTANŢA","#N/A",61620,,418,"CUMPĂNA / ŞCOALA VECHE CU ETAJ",3,5992,"CUMPĂNA",61620,1652,1057,988,68,1,1046,11,1800,743,469,577
14,"CONSTANŢA","#N/A",61620,,419,"CUMPĂNA / ŞCOALA VECHE FĂRĂ ETAJ",3,5992,"CUMPĂNA",61620,1429,930,872,57,1,914,16,1600,670,412,502
14,"CONSTANŢA","#N/A",61620,,420,"CUMPĂNA / SALA DE SPORT 1",3,5992,"CUMPĂNA",61620,1473,993,934,59,0,979,14,1600,607,417,562
14,"CONSTANŢA","#N/A",61620,,421,"CUMPĂNA / SALA DE SPORT 1",3,5992,"CUMPĂNA",61620,1647,1077,974,103,0,1038,39,1800,723,450,588
14,"CONSTANŢA","#N/A",61620,,422,"CUMPĂNA / GRĂDINIŢA ""FLORILOR""",3,5992,"CUMPĂNA",61620,1517,970,872,97,1,962,8,1700,730,462,500
14,"CONSTANŢA","#N/A",61620,,423,"CUMPĂNA / ANEXA ŞCOLII GENERALE LÂNGĂ BISERICA ""SFÂNTA MARIA""",3,5992,"CUMPĂNA",61620,1500,1038,931,106,1,1020,18,1600,562,425,595
14,"CONSTANŢA","#N/A",63300,,424,"CUZA VODĂ / SCOALA GIMNAZIALA NR 1",3,5995,"CUZA VODA",63300,1355,661,623,38,0,655,6,1500,839,334,321
14,"CONSTANŢA","#N/A",63300,,425,"CUZA VODĂ / ŞCOALA GIMNAZIALĂ NR. 1",3,5995,"CUZA VODA",63300,1526,731,704,27,0,724,7,1700,969,422,302
14,"CONSTANŢA","#N/A",61675,,426,"DELENI / Cămin  Cultural Deleni",3,5997,"DELENI",61675,338,269,236,27,6,266,3,400,131,131,135
14,"CONSTANŢA","#N/A",61675,,427,"PIETRENI / Fost Sediu C.A.P. Pietreni",3,5997,"DELENI",61675,699,487,431,36,20,480,7,800,313,291,189
14,"CONSTANŢA","#N/A",61675,,428,"ŞIPOTELE / Scoala Generala  Şipotele",3,5997,"DELENI",61675,433,335,280,47,8,332,3,500,165,189,143
14,"CONSTANŢA","#N/A",61675,,429,"PETROŞANI / Fost  Sediu  C.A.P.  Petroşani",3,5997,"DELENI",61675,464,320,290,23,7,318,2,501,181,176,142
14,"CONSTANŢA","#N/A",61737,,430,"DOBROMIR / CĂMINUL CULTURAL DOBROMIR -",3,6002,"DOBROMIR",61737,677,452,425,27,0,444,8,700,248,297,147
14,"CONSTANŢA","#N/A",61737,,431,"DOBROMIRU DIN DEAL / ŞCOALA GEN CU CLS. I - IV DOBROMIR DEAL",3,6002,"DOBROMIR",61737,273,193,179,14,0,193,0,301,108,77,116
14,"CONSTANŢA","#N/A",61737,,432,"LESPEZI / ŞCOALA GEN CU CLS. I - IV LESPEZI",3,6002,"DOBROMIR",61737,353,275,250,23,2,273,2,399,124,167,106
14,"CONSTANŢA","#N/A",61737,,433,"VĂLENI / ŞCOALA GEN CU CLS. I - IV VĂLENI",3,6002,"DOBROMIR",61737,548,324,313,11,0,319,5,600,276,240,79
14,"CONSTANŢA","#N/A",61737,,434,"PĂDURENI / ŞCOALA GEN CU CLS. I - IV PĂDURENI",3,6002,"DOBROMIR",61737,120,80,63,17,0,80,0,200,120,32,48
14,"CONSTANŢA","#N/A",61737,,435,"CETATEA / SCOALA GENERALA SAT CETATEA",3,6002,"DOBROMIR",61737,173,146,134,12,0,143,3,202,56,59,84
14,"CONSTANŢA","#N/A",63161,,436,"DUMBRĂVENI / CĂMINUL CULTURAL DUMBRĂVENI",3,6009,"DUMBRĂVENI",63161,398,247,205,42,0,247,0,400,153,119,128
14,"CONSTANŢA","#N/A",63161,,437,"FURNICA / GRĂDINIŢA DE COPII FURNICA",3,6009,"DUMBRĂVENI",63161,59,59,40,19,0,58,1,100,41,35,23
14,"CONSTANŢA","#N/A",63334,,438,"FÎNTÎNELE / ŞCOALA CU CLS. I - VIII FÂNTÂNELE",3,6012,"FÎNTÎNELE",63334,1346,939,867,72,0,928,11,1400,461,487,441
14,"CONSTANŢA","#N/A",61808,,439,"GÂRLICIU / CENTRUL CULTURAL",3,6014,"GÂRLICIU",61808,1385,781,723,58,0,775,6,1500,719,439,336
14,"CONSTANŢA","#N/A",61826,,440,"GHINDĂREŞTI / Căminul cultural  GHINDĂREŞTI",3,6016,"GHINDĂREŞTI",61826,1134,553,525,28,0,547,6,1300,747,213,334
14,"CONSTANŢA","#N/A",61826,,441,"GHINDĂREŞTI / Căminul cultural  GHINDĂREŞTI",3,6016,"GHINDĂREŞTI",61826,1117,498,466,32,0,495,3,1200,702,203,292
14,"CONSTANŢA","#N/A",63326,,442,"GRĂDINA / ŞCOALA  CU CLS. I - VIII GRĂDINA",3,6018,"GRĂDINA",63326,614,438,394,34,10,428,10,700,262,254,174
14,"CONSTANŢA","#N/A",63326,,443,"CHEIA / ŞCOALA  CU CLS. I - IV  CHEIA",3,6018,"GRĂDINA",63326,323,271,203,63,5,269,2,400,129,165,104
14,"CONSTANŢA","#N/A",63278,,444,"HORIA / CĂMIN CULTURAL HORIA",3,6022,"HORIA",63278,708,437,381,32,24,431,6,800,363,258,173
14,"CONSTANŢA","#N/A",63278,,445,"TICHILEŞTI / ŞCOALA GIMNAZIALĂ  TICHILEŞTI",3,6022,"HORIA",63278,277,189,157,25,7,189,0,300,111,95,94
14,"CONSTANŢA","#N/A",61871,,446,"INDEPENDENŢA / LICEUL TEHNOLOGIC",3,6026,"INDEPENDENŢA",61871,1000,604,563,41,0,594,10,1000,396,334,260
14,"CONSTANŢA","#N/A",61871,,447,"MOVILA VERDE / SCOALA GENERALĂ",3,6026,"INDEPENDENŢA",61871,497,314,292,22,0,312,2,501,187,145,167
14,"CONSTANŢA","#N/A",61871,,448,"OLTENI / SCOALA GENERALĂ",3,6026,"INDEPENDENŢA",61871,315,218,180,38,0,215,3,400,182,104,111
14,"CONSTANŢA","#N/A",61871,,449,"TUFANI / SCOALA GENERALĂ",3,6026,"INDEPENDENŢA",61871,288,202,195,7,0,201,1,300,98,106,95
14,"CONSTANŢA","#N/A",61871,,450,"FÎNTÎNA MARE / SCOALA GENERALĂ",3,6026,"INDEPENDENŢA",61871,284,160,148,12,0,159,1,300,140,78,81
14,"CONSTANŢA","#N/A",61951,,451,"ION CORVIN / ŞCOALA  CU  CLS. I - VIII  ION CORVIN",3,6032,"ION CORVIN",61951,511,300,260,35,5,292,8,600,300,172,120
14,"CONSTANŢA","#N/A",61951,,452,"VIILE / ŞCOALA  CU  CLS. I - VIII  VIILE",3,6032,"ION CORVIN",61951,803,516,467,22,27,508,8,901,385,296,212
14,"CONSTANŢA","#N/A",61951,,453,"RARIŞTEA / ŞCOALA  CU  CLS. I - IV  RARIŞTEA",3,6032,"ION CORVIN",61951,204,143,124,19,0,143,0,300,157,87,56
14,"CONSTANŢA","#N/A",61951,,454,"CRÎNGU / ŞCOALA  CRÂNGU",3,6032,"ION CORVIN",61951,94,75,51,24,0,75,0,100,25,51,24
14,"CONSTANŢA","#N/A",62020,,455,"ISTRIA / Şcoala Gimnazială nr. 1  Istria",3,6038,"ISTRIA",62020,1138,715,652,63,0,694,21,1200,485,302,392
14,"CONSTANŢA","#N/A",62020,,456,"NUNTAŞI / Şcoala Gimnazială nr. 2 Nuntaşi",3,6038,"ISTRIA",62020,864,609,552,57,0,602,7,1000,391,223,379
14,"CONSTANŢA","#N/A",60632,,457,"LIMANU / Scoala Generală cu cls. I - VIII Limanu",3,6041,"LIMANU",60632,1280,797,717,78,2,783,14,1400,603,335,448
14,"CONSTANŢA","#N/A",60632,,458,"LIMANU / Scoala Generală cu cls. I - VIII Limanu",3,6041,"LIMANU",60632,1353,770,720,50,0,754,16,1500,730,293,461
14,"CONSTANŢA","#N/A",60632,,459,"2 Mai / Scoala Generală cu cls. I - VIII 2 Mai",3,6041,"LIMANU",60632,1244,843,702,141,0,837,6,1400,557,289,548
14,"CONSTANŢA","#N/A",60632,,460,"2 Mai / Scoala Generală cu cls. I - VIII 2 Mai",3,6041,"LIMANU",60632,1398,908,831,77,0,902,6,1500,592,327,575
14,"CONSTANŢA","#N/A",62057,,461,"LIPNIŢA / Camin Cultural Lipnita",3,6046,"LIPNIŢA",62057,791,449,406,43,0,441,8,900,451,133,308
14,"CONSTANŢA","#N/A",62057,,462,"COSLUGEA / ŞCOALA CU CLS.  I - VIII COSLUGEA",3,6046,"LIPNIŢA",62057,616,309,292,17,0,306,3,700,391,160,146
14,"CONSTANŢA","#N/A",62057,,463,"CANLIA / CĂMINUL CULTURAL CANLIA",3,6046,"LIPNIŢA",62057,443,261,226,35,0,260,1,500,239,124,136
14,"CONSTANŢA","#N/A",62057,,464,"CARVĂN / ŞCOALA GENERALĂ CARVĂN",3,6046,"LIPNIŢA",62057,369,195,171,23,1,191,4,400,205,121,70
14,"CONSTANŢA","#N/A",62057,,465,"IZVOARELE / ŞCOALA GENERALĂ CU CLS. I - IV  IZVOARELE",3,6046,"LIPNIŢA",62057,99,84,57,27,0,84,0,100,16,37,47
14,"CONSTANŢA","#N/A",62057,,466,"GORUNI / ŞCOALA GENERALĂ CU CLS. I - IV  GORUNI",3,6046,"LIPNIŢA",62057,89,58,40,18,0,57,1,100,42,32,25
14,"CONSTANŢA","#N/A",62057,,467,"CUIUGIUC / ŞCOALA GENERALĂ CU CLS. I - IV  CUIUGIUC",3,6046,"LIPNIŢA",62057,154,84,77,7,0,84,0,200,116,38,46
14,"CONSTANŢA","#N/A",63152,,468,"LUMINA / ŞCOALA VECHE LUMINA",3,6054,"LUMINA",63152,1904,1154,1050,104,0,1131,23,2100,946,420,711
14,"CONSTANŢA","#N/A",63152,,469,"LUMINA / ŞCOALA NOUĂ  LUMINA",3,6054,"LUMINA",63152,1393,889,780,109,0,876,13,1500,611,334,542
14,"CONSTANŢA","#N/A",63152,,470,"LUMINA / GRĂDINIŢA LUMINA",3,6054,"LUMINA",63152,1975,1228,1135,93,0,1213,15,2200,972,445,768
14,"CONSTANŢA","#N/A",63152,,471,"LUMINA / CĂMINUL CULTURAL LUMINA",3,6054,"LUMINA",63152,1862,1156,1050,104,2,1137,19,2000,844,466,671
14,"CONSTANŢA","#N/A",63152,,472,"OITUZ / ŞCOALA OITUZ",3,6054,"LUMINA",63152,661,419,372,47,0,415,4,700,281,100,315
14,"CONSTANŢA","#N/A",63152,,473,"SIBIOARA / ŞCOALA SIBIOARA",3,6054,"LUMINA",63152,363,240,198,42,0,240,0,390,150,129,111
14,"CONSTANŢA","#N/A",62137,,474,"MERENI / Şcoala Nichita Stănescu",3,6058,"MERENI",62137,1090,678,592,70,16,666,12,1200,522,250,416
14,"CONSTANŢA","#N/A",62137,,475,"OSMANCEA / Şcoala  cu clasele  I - VIII",3,6058,"MERENI",62137,486,293,275,18,0,293,0,500,207,87,206
14,"CONSTANŢA","#N/A",62137,,476,"CIOBĂNIŢA / Şcoala  cu clasele I -IV",3,6058,"MERENI",62137,250,172,148,24,0,171,1,300,128,91,80
14,"CONSTANŢA","#N/A",62253,,477,"MIHAI VITEAZU / LICEUL  TEHNOLOGIC ,, MIHAI VITEAZUL""",3,6063,"MIHAI VITEAZU",62253,1547,811,776,34,1,800,11,1700,889,387,413
14,"CONSTANŢA","#N/A",62253,,478,"SINOIE / SCOALA CU CLASELE I-VII SINOE",3,6063,"MIHAI VITEAZU",62253,1101,748,683,62,3,738,10,1200,452,188,550
14,"CONSTANŢA","#N/A",62191,,479,"MIHAIL KOGĂLNICEANU / Gradinita Domino",3,6066,"MIHAIL KOGĂLNICEANU",62191,1245,786,706,78,2,778,8,1400,614,218,560
14,"CONSTANŢA","#N/A",62191,,480,"MIHAIL KOGĂLNICEANU / Grădiniţa Pinochio",3,6066,"MIHAIL KOGĂLNICEANU",62191,1145,782,696,77,9,777,5,1300,518,205,572
14,"CONSTANŢA","#N/A",62191,,481,"MIHAIL KOGĂLNICEANU / Scoala Generală nr.2",3,6066,"MIHAIL KOGĂLNICEANU",62191,1283,845,777,66,2,837,8,1400,555,282,555
14,"CONSTANŢA","#N/A",62191,,482,"MIHAIL KOGĂLNICEANU / Liceu Teoretic M.Kogalniceanu",3,6066,"MIHAIL KOGĂLNICEANU",62191,1431,840,766,73,1,824,16,1600,760,301,523
14,"CONSTANŢA","#N/A",62191,,483,"MIHAIL KOGĂLNICEANU / Gradinita Piticot",3,6066,"MIHAIL KOGĂLNICEANU",62191,811,476,423,53,0,467,9,900,424,152,315
14,"CONSTANŢA","#N/A",62191,,484,"MIHAIL KOGĂLNICEANU / Gradinita Piticot",3,6066,"MIHAIL KOGĂLNICEANU",62191,792,525,476,49,0,520,5,900,375,261,259
14,"CONSTANŢA","#N/A",62191,,485,"MIHAIL KOGĂLNICEANU / Scoala Generala Ceres",3,6066,"MIHAIL KOGĂLNICEANU",62191,378,230,202,28,0,227,3,399,169,71,156
14,"CONSTANŢA","#N/A",62191,,486,"PIATRA / U.A. Sibioara",3,6066,"MIHAIL KOGĂLNICEANU",62191,334,247,195,52,0,244,3,402,155,67,177
14,"CONSTANŢA","#N/A",62191,,487,"PIATRA / Scoala Generală cu cls. I - VIII Piatra",3,6066,"MIHAIL KOGĂLNICEANU",62191,698,467,395,72,0,458,9,800,333,128,330
14,"CONSTANŢA","#N/A",62191,,488,"PALAZU MIC / Scoala Generală Palazu Mic",3,6066,"MIHAIL KOGĂLNICEANU",62191,256,182,138,44,0,180,2,300,118,46,134
14,"CONSTANŢA","#N/A",62280,,489,"MIRCEA VODĂ / SCOALA GIMNAZIALA NR.1 MIRCEA VODA",3,6070,"MIRCEA VODĂ",62280,1650,958,894,64,0,950,8,1800,842,506,444
14,"CONSTANŢA","#N/A",62280,,490,"SATU NOU / ŞCOALA GIMNAZIALĂ NR.2 SAT NOU",3,6070,"MIRCEA VODĂ",62280,1036,616,588,28,0,609,7,1200,584,424,185
14,"CONSTANŢA","#N/A",62280,,491,"SATU NOU / ŞCOALA GIMNAZIALĂ NR.2 SAT NOU",3,6070,"MIRCEA VODĂ",62280,1169,689,651,37,1,682,7,1300,611,425,257
14,"CONSTANŢA","#N/A",62440,,492,"NICOLAE BĂLCESCU / LICEUL ""I.C. BRĂTIANU"" NICOLAE BĂLCESCU",3,6075,"NICOLAE BĂLCESCU",62440,1298,760,677,83,0,757,3,1400,640,280,477
14,"CONSTANŢA","#N/A",62440,,493,"NICOLAE BĂLCESCU / LICEUL ""I.C. BRĂTIANU"" NICOLAE BĂLCESCU",3,6075,"NICOLAE BĂLCESCU",62440,1459,811,775,35,1,803,8,1600,789,333,470
14,"CONSTANŢA","#N/A",62440,,494,"DOROBANŢU / ŞCOALA GENERALĂ DOROBANŢU",3,6075,"NICOLAE BĂLCESCU",62440,1473,847,785,62,0,842,5,1600,753,401,441
14,"CONSTANŢA","#N/A",62486,,495,"OLTINA / ŞCOALA CU CLS. I - VIII OLTINA",3,6078,"OLTINA",62486,1512,818,756,60,2,803,15,1700,882,358,445
14,"CONSTANŢA","#N/A",62486,,496,"RĂZOARELE / ŞCOALA CU CLS. I - VIII  RĂZOARELE",3,6078,"OLTINA",62486,516,357,328,28,1,353,4,600,243,139,214
14,"CONSTANŢA","#N/A",62486,,497,"SATU NOU / ŞCOALA CU CLS. I - IV  SATU NOU",3,6078,"OLTINA",62486,185,122,98,24,0,120,2,200,78,90,30
14,"CONSTANŢA","#N/A",62538,,498,"OSTROV / CĂMIN CULTURAL OSTROV",3,6083,"OSTROV",62538,1090,659,574,84,1,654,5,1100,441,308,346
14,"CONSTANŢA","#N/A",62538,,499,"OSTROV / CĂMIN CULTURAL OSTROV",3,6083,"OSTROV",62538,1103,693,649,44,0,689,4,1200,507,279,410
14,"CONSTANŢA","#N/A",62538,,500,"ALMĂLĂU / CĂMIN CULTURAL ALMĂLĂU",3,6083,"OSTROV",62538,717,483,411,72,0,477,6,799,316,268,209
14,"CONSTANŢA","#N/A",62538,,501,"ESECHIOI / ŞCOALA GENERALĂ ESECHIOI",3,6083,"OSTROV",62538,205,148,133,15,0,146,2,300,152,107,39
14,"CONSTANŢA","#N/A",62538,,502,"GÎRLIŢA / CĂMIN CULTURAL GÎRLIŢA",3,6083,"OSTROV",62538,253,198,180,18,0,196,2,300,102,140,56
14,"CONSTANŢA","#N/A",62538,,503,"GALIŢA / CĂMIN CULTURAL GALIŢA",3,6083,"OSTROV",62538,524,283,261,22,0,281,2,600,317,174,107
14,"CONSTANŢA","#N/A",62538,,504,"BUGEAC / ŞCOALA GENERALĂ BUGEAC",3,6083,"OSTROV",62538,161,118,95,23,0,118,0,200,82,62,56
14,"CONSTANŢA","#N/A",62609,,505,"PANTELIMON / ŞCOALA GIMNAZIALĂ NR.1  PANTELIMON",3,6090,"PANTELIMON",62609,596,371,327,31,13,365,6,600,229,224,141
14,"CONSTANŢA","#N/A",62609,,506,"PANTELIMON DE JOS / ŞCOALA CU CLS. I - IV PANTELIMON DE JOS",3,6090,"PANTELIMON",62609,206,117,102,15,0,117,0,300,183,61,56
14,"CONSTANŢA","#N/A",62609,,507,"RUNCU / ŞCOALA CU CLS. I - IV  RUNCU",3,6090,"PANTELIMON",62609,326,227,206,21,0,219,8,400,173,159,60
14,"CONSTANŢA","#N/A",62609,,508,"NISTOREŞTI / ŞCOALA CU CLS. I - IV  NISTOREŞTI",3,6090,"PANTELIMON",62609,210,125,106,19,0,125,0,300,175,71,54
14,"CONSTANŢA","#N/A",62672,,509,"PECINEAGA / CĂMIN CULTURAL PECINEAGA",3,6096,"PECINEAGA",62672,1309,764,687,69,8,751,13,1400,636,332,419
14,"CONSTANŢA","#N/A",62672,,510,"PECINEAGA / ŞCOALA GENERALA PECINEAGA",3,6096,"PECINEAGA",62672,1337,704,651,49,4,695,9,1500,796,342,353
14,"CONSTANŢA","#N/A",62707,,511,"PEŞTERA / CAMIN CULTURAL PESTERA",3,6099,"PEŞTERA",62707,1481,837,786,51,0,830,7,1600,763,473,357
14,"CONSTANŢA","#N/A",62707,,512,"IVRINEZU MARE / CAMIN CULTURAL IVRINEZU MARE",3,6099,"PEŞTERA",62707,686,383,352,31,0,379,4,800,417,213,166
14,"CONSTANŢA","#N/A",62707,,513,"IZVORU MARE / CAMIN CULTURAL IZVORU MARE",3,6099,"PEŞTERA",62707,579,263,240,23,0,257,6,600,337,119,138
14,"CONSTANŢA","#N/A",62761,,514,"POARTA ALBĂ / SCOALA PUBLICA NR. 1 CLASA IB",3,6105,"POARTA ALBĂ",62761,1420,1130,820,80,230,1120,10,1600,470,514,606
14,"CONSTANŢA","#N/A",62761,,515,"POARTA ALBĂ / SCOALA PUBLICA NR. 1 CLASA IA",3,6105,"POARTA ALBĂ",62761,1391,1089,752,70,267,1078,11,1500,411,544,534
14,"CONSTANŢA","#N/A",62761,,516,"POARTA ALBĂ / CAMIN CULTURAL CARTIER VIA",3,6105,"POARTA ALBĂ",62761,966,914,563,57,294,903,11,1100,186,572,331
14,"CONSTANŢA","#N/A",62761,,517,"NAZARCEA / SCOALA PRIMARA",3,6105,"POARTA ALBĂ",62761,400,272,243,29,0,271,1,400,128,76,195
14,"CONSTANŢA","#N/A",62798,,518,"RASOVA / SCOALA GIMNAZIALA NR.2 RASOVA",3,6108,"RASOVA",62798,1078,495,474,21,0,489,6,1100,605,279,210
14,"CONSTANŢA","#N/A",62798,,519,"RASOVA / SCOALA GIMNAZIALA NR.2 RASOVA",3,6108,"RASOVA",62798,941,436,416,20,0,427,9,1000,564,259,168
14,"CONSTANŢA","#N/A",62798,,520,"COCHIRLENI / SCOALA GIMNAZIALA COCHIRLENI",3,6108,"RASOVA",62798,937,513,475,38,0,507,6,1000,487,279,228
14,"CONSTANŢA","#N/A",63318,,521,"FĂCLIA / SCOALA PRIMARA NR 2 FACLIA",3,6114,"SALIGNY",63318,661,425,388,37,0,422,3,700,275,221,201
14,"CONSTANŢA","#N/A",63318,,522,"SALIGNY / ŞCOALA   GIMNAZIALA NR 1 SALIGNY",3,6114,"SALIGNY",63318,694,492,451,40,1,490,2,800,308,268,222
14,"CONSTANŢA","#N/A",63318,,523,"ŞTEFAN CEL MARE / ŞCOALA   PRIMARA NR 3 STEFAN CEL MARE",3,6114,"SALIGNY",63318,431,272,235,37,0,270,2,500,228,138,132
14,"CONSTANŢA","#N/A",62823,,524,"SARAIU / ŞCOALA    ""NICOLAE MARALOI"" SARAIU",3,6118,"SARAIU",62823,656,463,389,42,32,454,9,700,237,303,151
14,"CONSTANŢA","#N/A",62823,,525,"DULGHERU / ŞCOALA   CU  CLS.  I - IV  DULGHERU",3,6118,"SARAIU",62823,441,300,251,35,14,294,6,500,200,156,138
14,"CONSTANŢA","#N/A",62878,,526,"SĂCELE / ŞCOALA  DE ARTE ŞI MESERII",3,6111,"SĂCELE",62878,1883,1199,1107,78,14,1184,15,2100,901,509,675
14,"CONSTANŢA","#N/A",62903,,527,"SEIMENII MICI / SCOALA CU CLS. I-IV SEIMENII MICI",3,6122,"SEIMENI",62903,705,349,321,28,0,345,4,800,451,149,196
14,"CONSTANŢA","#N/A",62903,,528,"SEIMENI / ŞCOALA CU CLS I-VIII SEIMENI",3,6122,"SEIMENI",62903,473,292,250,42,0,290,2,501,209,116,174
14,"CONSTANŢA","#N/A",62903,,529,"DUNĂREA / GRĂDINIŢA SAT DUNĂREA",3,6122,"SEIMENI",62903,566,356,308,48,0,353,3,600,244,149,204
14,"CONSTANŢA","#N/A",62949,,530,"SILIŞTEA / SCOALA GIMNAZIALA NR. 1",3,6126,"SILIŞTEA",62949,545,374,332,42,0,367,7,600,226,239,128
14,"CONSTANŢA","#N/A",62949,,531,"TEPEŞ VODĂ / SCOALA PRIMARA NR. 2",3,6126,"SILIŞTEA",62949,613,374,338,35,1,367,7,700,326,215,152
14,"CONSTANŢA","#N/A",62985,,532,"TÂRGUŞOR / CONSILIULUI LOCAL TÎRGUŞOR",3,6129,"TÂRGUŞOR",62985,1097,683,635,48,0,679,4,1200,517,326,353
14,"CONSTANŢA","#N/A",62985,,533,"MIREASA / ŞCOALA   CU CLS. I -  IV  MIREASA",3,6129,"TÂRGUŞOR",62985,254,172,154,18,0,170,2,300,128,66,104
14,"CONSTANŢA","#N/A",63045,,534,"TOPALU / ŞCOALA GENERALĂ TOPALU",3,6132,"TOPALU",63045,1473,1039,921,102,16,1030,9,1600,561,567,463
14,"CONSTANŢA","#N/A",63072,,535,"TOPRAISAR / Liceul tehnologic Topraisar",3,6135,"TOPRAISAR",63072,1374,868,766,102,0,844,24,1500,632,493,351
14,"CONSTANŢA","#N/A",63072,,536,"TOPRAISAR / Şcoala Veche Topraisar",3,6135,"TOPRAISAR",63072,1497,955,857,98,0,943,12,1600,645,539,404
14,"CONSTANŢA","#N/A",63072,,537,"BIRUINŢA / Şcoala I-VIII Biruinţa",3,6135,"TOPRAISAR",63072,601,335,311,24,0,332,3,700,365,191,141
14,"CONSTANŢA","#N/A",63072,,538,"MOVILIŢA / Şcoala I-VIII Moviliţa",3,6135,"TOPRAISAR",63072,856,566,493,72,1,559,7,900,334,195,364
14,"CONSTANŢA","#N/A",63072,,539,"POTÎRNICHEA / Şcoala I-IV Potârnichea",3,6135,"TOPRAISAR",63072,397,243,187,56,0,241,2,400,157,144,97
14,"CONSTANŢA","#N/A",63189,,540,"TORTOMAN / CĂMINUL CULTURAL TORTOMAN",3,6140,"TORTOMAN",63189,1418,817,787,29,1,806,11,1600,783,495,311
14,"CONSTANŢA","#N/A",60721,,541,"TUZLA / GRADINITA  VECHE",3,6143,"TUZLA",60721,1151,790,667,123,0,781,9,1300,510,315,466
14,"CONSTANŢA","#N/A",60721,,542,"TUZLA / Şcoala Mică Tuzla",3,6143,"TUZLA",60721,1681,1068,994,74,0,1058,10,1900,832,389,669
14,"CONSTANŢA","#N/A",60721,,543,"TUZLA / Şcoala Mare Tuzla",3,6143,"TUZLA",60721,1664,1120,1041,79,0,1105,15,1800,680,422,683
14,"CONSTANŢA","#N/A",60721,,544,"TUZLA / Grădiniţă Nouă",3,6143,"TUZLA",60721,1338,874,812,62,0,870,4,1500,626,323,547
14,"CONSTANŢA","#N/A",63125,,545,"VALU LUI TRAIAN / GRĂDINIŢA nr.2",3,6145,"VALU LUI TRAIAN",63125,1904,1489,1148,140,201,1470,19,2100,611,620,850
14,"CONSTANŢA","#N/A",63125,,546,"VALU LUI TRAIAN / SALA  DE  SPORT",3,6145,"VALU LUI TRAIAN",63125,1717,1152,1085,64,3,1141,11,1900,748,351,790
14,"CONSTANŢA","#N/A",63125,,547,"VALU LUI TRAIAN / SCOALA GIMNAZIALĂ nr.1",3,6145,"VALU LUI TRAIAN",63125,1843,1327,1141,186,0,1305,22,2000,673,458,847
14,"CONSTANŢA","#N/A",63125,,548,"VALU LUI TRAIAN / GRĂDINIŢA  nr.1",3,6145,"VALU LUI TRAIAN",63125,1985,1343,1177,166,0,1330,13,2200,857,415,915
14,"CONSTANŢA","#N/A",63125,,549,"VALU LUI TRAIAN / COMPLEX",3,6145,"VALU LUI TRAIAN",63125,1902,1314,1204,109,1,1301,13,2100,786,436,865
14,"CONSTANŢA","#N/A",63125,,550,"VALU LUI TRAIAN / ŞCOALA GIMNAZIALĂ ""VICEAMIRAL IOAN MURGESCU""",3,6145,"VALU LUI TRAIAN",63125,1847,1458,1101,155,202,1436,22,2000,542,572,864
14,"CONSTANŢA","#N/A",63170,,551,"VULTURU / CAMIN CULTURAL VULTURU",3,6147,"VULTURU",63170,570,315,290,25,0,308,7,600,285,207,101
14,"CONSTANŢA","#N/A",60419,,552,"CONSTANŢA / CAMPUS SOCIAL ""HENRI COANDĂ""",1,5865,"MUNICIPIUL CONSTANŢA",60419,1329,1117,1046,67,4,1102,15,1400,283,917,185
15,"COVASNA",145,63394,,1,"SFÎNTU GHEORGHE / Casa de cultură ""Kónya Ádám""",1,6150,"MUNICIPIUL SFÎNTU GHEORGHE",63394,1168,486,462,24,0,477,9,1177,691,101,376
15,"COVASNA",145,63394,,2,"SFÎNTU GHEORGHE / Liceul Tehnologic  ""Kós Károly""",1,6150,"MUNICIPIUL SFÎNTU GHEORGHE",63394,646,359,325,34,0,357,2,700,341,35,322
15,"COVASNA",145,63394,,3,"SFÎNTU GHEORGHE / Liceul Tehnologic   ""Kós Károly""",1,6150,"MUNICIPIUL SFÎNTU GHEORGHE",63394,1378,732,679,38,15,724,8,1395,663,95,629
15,"COVASNA",145,63394,,4,"SFÎNTU GHEORGHE / Liceul Teoretic ""Székely Mikó""",1,6150,"MUNICIPIUL SFÎNTU GHEORGHE",63394,785,488,403,85,0,485,3,800,312,58,427
15,"COVASNA",145,63394,,5,"SFÎNTU GHEORGHE / Direcţia Finanţe Publice Municipale",1,6150,"MUNICIPIUL SFÎNTU GHEORGHE",63394,785,431,388,43,0,428,3,900,469,67,361
15,"COVASNA",145,63394,,6,"SFÎNTU GHEORGHE / Liceul Tehnologic Economic, Administrativ ""Berde Áron""",1,6150,"MUNICIPIUL SFÎNTU GHEORGHE",63394,683,330,302,28,0,325,5,700,370,51,274
15,"COVASNA",145,63394,,7,"SFÎNTU GHEORGHE / Liceul Tehnologic Economic, Administrativ ""Berde Áron""",1,6150,"MUNICIPIUL SFÎNTU GHEORGHE",63394,1679,869,835,34,0,861,8,1700,831,150,711
15,"COVASNA",145,63394,,8,"SFÎNTU GHEORGHE / Liceul Tehnologic Economic, Administrativ ""Berde Áron""",1,6150,"MUNICIPIUL SFÎNTU GHEORGHE",63394,971,535,511,24,0,531,4,1000,465,86,445
15,"COVASNA",145,63394,,9,"SFÎNTU GHEORGHE / Liceul Teoretic ""Mikes Kelemen""",1,6150,"MUNICIPIUL SFÎNTU GHEORGHE",63394,706,356,330,26,0,352,4,800,444,75,277
15,"COVASNA",145,63394,,10,"SFÎNTU GHEORGHE / Grădiniţa cu program prelungit ""Gulliver""",1,6150,"MUNICIPIUL SFÎNTU GHEORGHE",63394,1379,716,683,32,1,707,9,1400,684,69,638
15,"COVASNA",145,63394,,11,"SFÎNTU GHEORGHE / Grădiniţa cu program prelungit ""Gulliver""",1,6150,"MUNICIPIUL SFÎNTU GHEORGHE",63394,1046,544,518,26,0,534,10,1100,556,65,469
15,"COVASNA",145,63394,,12,"SFÎNTU GHEORGHE / Grădiniţa cu program prelungit ""Gulliver""",1,6150,"MUNICIPIUL SFÎNTU GHEORGHE",63394,1041,522,496,26,0,521,1,1100,578,57,464
15,"COVASNA",145,63394,,13,"SFÎNTU GHEORGHE / Grădiniţa cu program prelungit ""Gulliver""",1,6150,"MUNICIPIUL SFÎNTU GHEORGHE",63394,1395,676,652,24,0,666,10,1500,824,87,579
15,"COVASNA",145,63394,,14,"SFÎNTU GHEORGHE / Colegiul Naţional ""Mihai Viteazul""",1,6150,"MUNICIPIUL SFÎNTU GHEORGHE",63394,1009,523,487,35,1,520,3,1100,577,78,442
15,"COVASNA",145,63394,,15,"SFÎNTU GHEORGHE / Colegiul Naţional ""Mihai Viteazul""",1,6150,"MUNICIPIUL SFÎNTU GHEORGHE",63394,944,412,384,28,0,406,6,1000,588,63,343
15,"COVASNA",145,63394,,16,"SFÎNTU GHEORGHE / Colegiul Naţional ""Mihai Viteazul""",1,6150,"MUNICIPIUL SFÎNTU GHEORGHE",63394,905,464,439,25,0,460,4,1000,536,57,403
15,"COVASNA",145,63394,,17,"SFÎNTU GHEORGHE / Sala de sport",1,6150,"MUNICIPIUL SFÎNTU GHEORGHE",63394,1485,923,888,35,0,910,13,1500,577,104,806
15,"COVASNA",145,63394,,18,"SFÎNTU GHEORGHE / Gradiniţa cu program prelungit ""Hófehérke""",1,6150,"MUNICIPIUL SFÎNTU GHEORGHE",63394,839,466,449,17,0,464,2,900,434,64,400
15,"COVASNA",145,63394,,19,"SFÎNTU GHEORGHE / Şcoala gimnazială ""Váradi József""",1,6150,"MUNICIPIUL SFÎNTU GHEORGHE",63394,562,328,306,22,0,326,2,600,272,38,288
15,"COVASNA",145,63394,,20,"SFÎNTU GHEORGHE / Şcoala gimnazială ""Váradi József""",1,6150,"MUNICIPIUL SFÎNTU GHEORGHE",63394,1254,833,672,36,125,827,6,1300,467,112,715
15,"COVASNA",145,63394,,21,"SFÎNTU GHEORGHE / Liceul de Arte ""Plugor Sándor""",1,6150,"MUNICIPIUL SFÎNTU GHEORGHE",63394,787,471,436,32,3,464,7,800,329,70,394
15,"COVASNA",145,63394,,22,"SFÎNTU GHEORGHE / Liceul de Arte ""Plugor Sándor""",1,6150,"MUNICIPIUL SFÎNTU GHEORGHE",63394,1072,563,545,18,0,539,24,1100,537,94,445
15,"COVASNA",145,63394,,23,"SFÎNTU GHEORGHE / Şcoala Ajutătoare",1,6150,"MUNICIPIUL SFÎNTU GHEORGHE",63394,710,380,364,16,0,375,5,800,420,27,348
15,"COVASNA",145,63394,,24,"SFÎNTU GHEORGHE / Grădiniţa cu program prelungit ""Árvácska""",1,6150,"MUNICIPIUL SFÎNTU GHEORGHE",63394,1283,572,555,17,0,566,6,1300,728,141,425
15,"COVASNA",145,63394,,25,"SFÎNTU GHEORGHE / Grădiniţa cu program prelungit ""Árvácska""",1,6150,"MUNICIPIUL SFÎNTU GHEORGHE",63394,869,342,318,24,0,340,2,900,558,64,276
15,"COVASNA",145,63394,,26,"SFÎNTU GHEORGHE / Şcoala gimnazială ""Gödri Ferenc""",1,6150,"MUNICIPIUL SFÎNTU GHEORGHE",63394,1394,528,508,20,0,526,2,1500,972,87,439
15,"COVASNA",145,63394,,27,"SFÎNTU GHEORGHE / Şcoala gimnazială ""Gödri Ferenc""",1,6150,"MUNICIPIUL SFÎNTU GHEORGHE",63394,936,428,409,19,0,426,2,1000,572,71,355
15,"COVASNA",145,63394,,28,"SFÎNTU GHEORGHE / Căminul ""Zathureczky Berta""",1,6150,"MUNICIPIUL SFÎNTU GHEORGHE",63394,1276,648,625,23,0,643,5,1300,652,63,580
15,"COVASNA",145,63394,,29,"SFÎNTU GHEORGHE / Căminul ""Zathureczky Berta""",1,6150,"MUNICIPIUL SFÎNTU GHEORGHE",63394,1725,895,825,45,25,885,10,1800,905,184,701
15,"COVASNA",145,63394,,30,"SFÎNTU GHEORGHE / Creşa cu program de lucru zilnic",1,6150,"MUNICIPIUL SFÎNTU GHEORGHE",63394,693,359,323,36,0,354,5,800,441,69,285
15,"COVASNA",145,63394,,31,"SFÎNTU GHEORGHE / Creşa cu program de lucru zilnic",1,6150,"MUNICIPIUL SFÎNTU GHEORGHE",63394,1219,653,620,33,0,650,3,1300,647,122,528
15,"COVASNA",145,63394,,32,"SFÎNTU GHEORGHE / Grădiniţa cu program prelungit ""Pinocchio""",1,6150,"MUNICIPIUL SFÎNTU GHEORGHE",63394,1776,789,757,31,1,781,8,1900,1111,183,598
15,"COVASNA",145,63394,,33,"SFÎNTU GHEORGHE / Grădiniţa cu program prelungit ""Pinocchio""",1,6150,"MUNICIPIUL SFÎNTU GHEORGHE",63394,1314,613,590,23,0,609,4,1399,786,129,480
15,"COVASNA",145,63394,,34,"SFÎNTU GHEORGHE / Grădiniţa cu program prelungit ""Benedek Elek""",1,6150,"MUNICIPIUL SFÎNTU GHEORGHE",63394,1622,895,846,49,0,880,15,1700,805,156,724
15,"COVASNA",145,63394,,35,"SFÎNTU GHEORGHE / Fostul Centru de Informare pentru Cetăţeni",1,6150,"MUNICIPIUL SFÎNTU GHEORGHE",63394,1304,678,630,48,0,675,3,1400,722,123,552
15,"COVASNA",145,63394,,36,"SFÎNTU GHEORGHE / Liceul Tehnologic ""Puskás Tivadar""",1,6150,"MUNICIPIUL SFÎNTU GHEORGHE",63394,1551,812,781,31,0,798,14,1600,788,161,637
15,"COVASNA",145,63394,,37,"SFÎNTU GHEORGHE / Liceul Tehnologic ""Puskás Tivadar""",1,6150,"MUNICIPIUL SFÎNTU GHEORGHE",63394,1373,703,659,44,0,697,6,1400,697,173,524
15,"COVASNA",145,63394,,38,"SFÎNTU GHEORGHE / Şcoala gimnazială ""Nicolae Colan""",1,6150,"MUNICIPIUL SFÎNTU GHEORGHE",63394,1170,598,566,32,0,594,4,1200,602,147,447
15,"COVASNA",145,63394,,39,"SFÎNTU GHEORGHE / Şcoala gimnazială ""Nicolae Colan""",1,6150,"MUNICIPIUL SFÎNTU GHEORGHE",63394,1131,533,487,46,0,527,6,1200,667,103,424
15,"COVASNA",145,63394,,40,"SFÎNTU GHEORGHE / Şcoala gimnazială ""Nicolae Colan""",1,6150,"MUNICIPIUL SFÎNTU GHEORGHE",63394,1236,577,551,26,0,573,4,1300,723,141,432
15,"COVASNA",145,63394,,41,"SFÎNTU GHEORGHE / Ştrand Municipal Sfântu Gheorghe",1,6150,"MUNICIPIUL SFÎNTU GHEORGHE",63394,1280,662,626,36,0,654,8,1300,638,171,483
15,"COVASNA",145,63394,,42,"SFÎNTU GHEORGHE / Ştrand Municipal Sfântu Gheorghe",1,6150,"MUNICIPIUL SFÎNTU GHEORGHE",63394,1268,625,587,37,1,619,6,1300,675,132,487
15,"COVASNA",145,63394,,43,"SFÎNTU GHEORGHE / Şcoala gimnazială ""Ady Endre""",1,6150,"MUNICIPIUL SFÎNTU GHEORGHE",63394,845,458,418,39,1,449,9,1000,542,135,314
15,"COVASNA",145,63394,,44,"SFÎNTU GHEORGHE / Şcoala gimnazială ""Ady Endre""",1,6150,"MUNICIPIUL SFÎNTU GHEORGHE",63394,868,424,412,12,0,421,3,1000,576,115,306
15,"COVASNA",145,63394,,45,"SFÎNTU GHEORGHE / Şcoala gimnazială ""Ady Endre""",1,6150,"MUNICIPIUL SFÎNTU GHEORGHE",63394,1310,664,635,27,2,657,7,1400,736,137,520
15,"COVASNA",145,63394,,46,"SFÎNTU GHEORGHE / Grădiniţa de copii cu program normal nr. 6",1,6150,"MUNICIPIUL SFÎNTU GHEORGHE",63394,1152,562,506,56,0,558,4,1200,638,107,451
15,"COVASNA",145,63394,,47,"SFÎNTU GHEORGHE / Grădiniţa cu program prelungit ""Napsugár""",1,6150,"MUNICIPIUL SFÎNTU GHEORGHE",63394,1187,522,491,30,1,519,3,1300,778,172,347
15,"COVASNA",145,63394,,48,"SFÎNTU GHEORGHE / Şcoala generală CÂMPUL FRUMOS",1,6150,"MUNICIPIUL SFÎNTU GHEORGHE",63394,340,199,179,20,0,198,1,399,200,48,150
15,"COVASNA",145,63394,,49,"CHILIENI / Cămin Cultural",1,6150,"MUNICIPIUL SFÎNTU GHEORGHE",63394,683,363,347,16,0,362,1,800,437,34,328
15,"COVASNA",145,63394,,50,"COŞENI / Cămin Cultural",1,6150,"MUNICIPIUL SFÎNTU GHEORGHE",63394,443,254,244,10,0,253,1,500,246,31,222
15,"COVASNA",145,63740,,51,"TÂRGU SECUIESC / Casa Municipală de Cultură ""VIGADÓ""",1,6154,"MUNICIPIUL TÂRGU SECUIESC",63740,1333,649,611,37,1,640,9,1400,751,83,557
15,"COVASNA",145,63740,,52,"TÂRGU SECUIESC / Liceul Teoretic ""Nagy Mózes""",1,6154,"MUNICIPIUL TÂRGU SECUIESC",63740,1093,450,427,23,0,444,6,1200,750,55,389
15,"COVASNA",145,63740,,53,"TÂRGU SECUIESC / Liceul Pedagogic ""Bod Péter""",1,6154,"MUNICIPIUL TÂRGU SECUIESC",63740,1273,579,557,22,0,571,8,1400,821,55,516
15,"COVASNA",145,63740,,54,"TÂRGU SECUIESC / Liceul Vocaţional Reformat",1,6154,"MUNICIPIUL TÂRGU SECUIESC",63740,1311,607,579,28,0,604,3,1400,793,54,550
15,"COVASNA",145,63740,,55,"TÂRGU SECUIESC / Grădiniţa cu program normal ""Benedek Elek""",1,6154,"MUNICIPIUL TÂRGU SECUIESC",63740,1424,693,652,41,0,686,7,1500,807,101,585
15,"COVASNA",145,63740,,56,"TÂRGU SECUIESC / Şcoala Gimnazială ""Petőfi Sándor""",1,6154,"MUNICIPIUL TÂRGU SECUIESC",63740,1316,614,595,19,0,606,8,1400,786,56,550
15,"COVASNA",145,63740,,57,"TÂRGU SECUIESC / Grădiniţa cu program prelungit ""Csipkerózsika""",1,6154,"MUNICIPIUL TÂRGU SECUIESC",63740,1408,676,648,28,0,669,7,1500,824,74,595
15,"COVASNA",145,63740,,58,"TÂRGU SECUIESC / Şcoala Gimnazială ""Turoczi Mózes""",1,6154,"MUNICIPIUL TÂRGU SECUIESC",63740,1405,617,584,33,0,615,2,1500,883,83,532
15,"COVASNA",145,63740,,59,"TÂRGU SECUIESC / Grădiniţa cu program prelungit ""Manócska""",1,6154,"MUNICIPIUL TÂRGU SECUIESC",63740,1405,622,600,22,0,618,4,1500,878,67,551
15,"COVASNA",145,63740,,60,"TÂRGU SECUIESC / Grădiniţa cu program normal nr. 3",1,6154,"MUNICIPIUL TÂRGU SECUIESC",63740,908,453,426,27,0,450,3,1000,547,53,397
15,"COVASNA",145,63740,,61,"TÂRGU SECUIESC / Liceul Tehnologic ""Gábor Áron""",1,6154,"MUNICIPIUL TÂRGU SECUIESC",63740,1225,539,515,24,0,535,4,1300,761,65,470
15,"COVASNA",145,63740,,62,"TÂRGU SECUIESC / Şcoala Gimnazială ""Molnár Jozsiás""",1,6154,"MUNICIPIUL TÂRGU SECUIESC",63740,1273,612,594,18,0,609,3,1400,788,57,552
15,"COVASNA",145,63740,,63,"TÂRGU SECUIESC / Şcoala Primară Ruseni",1,6154,"MUNICIPIUL TÂRGU SECUIESC",63740,499,259,241,18,0,259,0,600,341,30,229
15,"COVASNA",145,63740,,64,"LUNGA / Căminul Cultural Tinoasa",1,6154,"MUNICIPIUL TÂRGU SECUIESC",63740,320,176,150,26,0,176,0,400,224,15,161
15,"COVASNA",145,63740,,65,"LUNGA / Căminul Cultural Lunga",1,6154,"MUNICIPIUL TÂRGU SECUIESC",63740,980,347,329,18,0,343,4,1100,753,48,295
15,"COVASNA",145,63447,,66,"BIBORŢENI / CĂMIN CULTURAL",1,6157,"ORAŞ BARAOLT",63447,611,322,301,21,0,320,2,700,378,14,306
15,"COVASNA",145,63447,,67,"BODOŞ / CĂMIN CULTURAL",1,6157,"ORAŞ BARAOLT",63447,336,160,148,12,0,160,0,399,239,15,145
15,"COVASNA",145,63447,,68,"CĂPENI / CĂMIN CULTURAL",1,6157,"ORAŞ BARAOLT",63447,903,397,389,8,0,396,1,1000,603,52,344
15,"COVASNA",145,63447,,69,"RACOŞUL DE SUS / CĂMIN CULTURAL",1,6157,"ORAŞ BARAOLT",63447,734,354,336,18,0,351,3,800,446,67,284
15,"COVASNA",145,63447,,70,"BARAOLT / PRIMĂRIA  ORAŞULUI BARAOLT",1,6157,"ORAŞ BARAOLT",63447,1125,532,500,31,1,530,2,1200,668,43,487
15,"COVASNA",145,63447,,71,"BARAOLT / CASA DE CULTURĂ BARAOLT",1,6157,"ORAŞ BARAOLT",63447,1163,600,560,28,12,595,5,1200,600,45,550
15,"COVASNA",145,63447,,72,"BARAOLT / ŞCOALA CU CL I-VIII GAAL MOZES",1,6157,"ORAŞ BARAOLT",63447,1233,599,584,14,1,597,2,1300,701,58,539
15,"COVASNA",145,63447,,73,"BARAOLT / GRĂDINIŢA DE COPII CIMBORA",1,6157,"ORAŞ BARAOLT",63447,1244,614,588,25,1,613,1,1300,686,52,561
15,"COVASNA",145,63447,,74,"MICLOŞOARA / GRĂDINIŢA DE COPII",1,6157,"ORAŞ BARAOLT",63447,386,204,184,20,0,203,1,500,296,21,182
15,"COVASNA",145,63526,,75,"CHIURUŞ / Casa de Cultură-Chiuruş",1,6164,"ORAŞ COVASNA",63526,389,233,213,20,0,224,9,400,167,47,177
15,"COVASNA",145,63526,,76,"COVASNA / Grădiniţa de Copii nr.1 cu Program Prelungit -",1,6164,"ORAŞ COVASNA",63526,1326,649,612,37,0,642,7,1400,751,92,550
15,"COVASNA",145,63526,,77,"COVASNA / Clubul orăşenesc-",1,6164,"ORAŞ COVASNA",63526,1346,1057,628,427,2,1047,10,1901,844,281,766
15,"COVASNA",145,63526,,78,"COVASNA / Liceul ""Kőrösi Csoma Sándor"" -Corp A-",1,6164,"ORAŞ COVASNA",63526,1149,937,571,366,0,931,6,1600,663,237,694
15,"COVASNA",145,63526,,79,"COVASNA / Liceul ""Kőrösi Csoma Sándor"" -Corp B",1,6164,"ORAŞ COVASNA",63526,1264,750,635,114,1,746,4,1700,950,125,621
15,"COVASNA",145,63526,,80,"COVASNA / Căminul de zi-",1,6164,"ORAŞ COVASNA",63526,1588,831,787,44,0,818,13,1700,869,137,681
15,"COVASNA",145,63526,,81,"COVASNA / Şcoala generală ""Avram Iancu""",1,6164,"ORAŞ COVASNA",63526,1247,725,669,54,2,711,14,1600,875,240,471
15,"COVASNA",145,63526,,82,"COVASNA / Şcoala generală ""Avram Iancu""-",1,6164,"ORAŞ COVASNA",63526,1131,1046,668,362,16,1029,17,1700,654,416,613
15,"COVASNA",145,63580,,83,"ÎNTORSURA BUZĂULUI / ŞCOALA GENERALĂ CU CLASELE I-VIII ""MIHAIL SADOVEANU""",1,6167,"ORAŞ ÎNTORSURA BUZĂULUI",63580,1108,632,573,22,37,623,9,1200,568,253,370
15,"COVASNA",145,63580,,84,"ÎNTORSURA BUZĂULUI / ŞCOALA GENERALĂ CU CLASELE I-VIII ""MIHAIL SADOVEANU""",1,6167,"ORAŞ ÎNTORSURA BUZĂULUI",63580,1168,640,594,42,4,625,15,1200,560,239,386
15,"COVASNA",145,63580,,85,"ÎNTORSURA BUZĂULUI / CASA DE CULTURA",1,6167,"ORAŞ ÎNTORSURA BUZĂULUI",63580,984,539,471,68,0,536,3,1100,561,215,321
15,"COVASNA",145,63580,,86,"ÎNTORSURA BUZĂULUI / DISTRICTUL  DN",1,6167,"ORAŞ ÎNTORSURA BUZĂULUI",63580,1209,640,611,29,0,632,8,1300,660,278,354
15,"COVASNA",145,63580,,87,"ÎNTORSURA BUZĂULUI / SCOALA PRIMARĂ",1,6167,"ORAŞ ÎNTORSURA BUZĂULUI",63580,706,494,481,13,0,488,6,800,306,253,235
15,"COVASNA",145,63580,,88,"BRĂDET / Şcoala Generală Învaţător Gheorghe Zaharia Bradet nr.66",1,6167,"ORAŞ ÎNTORSURA BUZĂULUI",63580,956,536,502,32,2,533,3,1001,465,246,287
15,"COVASNA",145,63580,,89,"FLOROAIA / CAMIN CULTURAL FLOROAIA",1,6167,"ORAŞ ÎNTORSURA BUZĂULUI",63580,1167,621,601,20,0,614,7,1197,576,241,373
15,"COVASNA",145,63777,,90,"AITA MARE / SEDIUL PRIMĂRIEI COMUNEI AITA MARE",3,6172,"AITA MARE",63777,742,373,343,30,0,372,1,800,427,38,334
15,"COVASNA",145,63777,,91,"AITA MEDIE / CĂMINUL CULTURAL AITA MEDIE",3,6172,"AITA MARE",63777,621,291,245,46,0,289,2,700,409,38,251
15,"COVASNA",145,65113,,92,"ARCUŞ / SEDIUL CONSILIULUI LOCAL ARCUŞ",3,6175,"ARCUŞ",65113,1267,798,697,57,44,795,3,1400,602,151,644
15,"COVASNA",145,63633,,93,"BARCANI / CĂMINUL CULTURAL  BARCANI",3,6177,"BARCANI",63633,970,604,558,26,20,600,4,1100,496,283,317
15,"COVASNA",145,63633,,94,"BARCANI / CĂMINUL CULTURAL  BARCANI",3,6177,"BARCANI",63633,1001,582,555,18,9,575,7,1100,518,317,258
15,"COVASNA",145,63633,,95,"LĂDĂUŢI / ŞCOALA CU CLASELE I-VIII LĂDĂUŢI",3,6177,"BARCANI",63633,543,309,288,18,3,304,5,600,291,146,158
15,"COVASNA",145,63633,,96,"SĂRĂMĂŞ / ŞCOALA CU CLASELE I-VIII SĂRĂMAŞ",3,6177,"BARCANI",63633,560,348,287,61,0,341,7,600,252,146,195
15,"COVASNA",145,63802,,97,"BĂŢANII MARI / CLĂDIRE PRIMARIEI CĂMINUL CULTURAL BAŢANII MARI",3,6181,"BĂŢANI",63802,1595,721,696,25,0,710,11,1700,979,89,621
15,"COVASNA",145,63802,,98,"BĂŢANII MICI / CĂMINUL CULTURAL BAŢANII MICI",3,6181,"BĂŢANI",63802,441,228,208,20,0,224,4,500,272,33,191
15,"COVASNA",145,63802,,99,"HERCULIAN / SEDIUL DE DEPLASARE AL PRIMARIEI ÎN SATUL HERCULIAN",3,6181,"BĂŢANI",63802,866,430,409,21,0,414,16,1000,570,197,217
15,"COVASNA",145,63802,,100,"AITA SEACĂ / SEDIUL DE DEPLASARE AL PRIMARIEI ÎN AITA SEACĂ",3,6181,"BĂŢANI",63802,574,165,151,14,0,163,2,700,535,42,121
15,"COVASNA",145,63866,,101,"BELIN / FOSTA CLĂDIREA A PRIMARIEI BELIN",3,6187,"BELIN",63866,1071,572,495,77,0,566,6,1200,628,87,479
15,"COVASNA",145,63866,,102,"BELIN-VALE / CENTRUL MULTIFUNCŢIONAL BELIN VALE",3,6187,"BELIN",63866,994,554,539,15,0,528,26,1100,546,415,113
15,"COVASNA",145,65121,,103,"BIXAD / CĂMINUL CULTURAL DIN BIXAD",3,6190,"BIXAD",65121,1467,611,556,55,0,608,3,1600,989,65,543
15,"COVASNA",145,63893,,104,"BODOC / CĂMINUL CULTURAL DIN BODOC",3,6192,"BODOC",63893,963,526,493,31,2,523,3,1100,574,70,453
15,"COVASNA",145,63893,,105,"ZĂLAN / ŞCOALA CU CLASELE I-IV ""DÁVID JÓZSEF"" ZĂLAN",3,6192,"BODOC",63893,512,218,176,42,0,213,5,600,382,42,171
15,"COVASNA",145,63893,,106,"OLTENI / IMOBILUL PRIMĂRIEI DIN OLTENI",3,6192,"BODOC",63893,536,252,225,27,0,245,7,600,348,61,184
15,"COVASNA",145,63937,,107,"BOROŞNEU MIC / CONSILIUL LOCAL BOROSNEU MARE",3,6196,"BOROŞNEU MARE",63937,1242,278,253,25,0,273,5,1300,1022,53,220
15,"COVASNA",145,63937,,108,"BOROŞNEU MIC / ŞCOALA GENERALĂ BOROŞNEU MIC",3,6196,"BOROŞNEU MARE",63937,345,158,136,22,0,157,1,400,242,67,90
15,"COVASNA",145,63937,,109,"DOBOLII DE SUS / CĂMINUL CULTURAL DOBOLII DE SUS",3,6196,"BOROŞNEU MARE",63937,180,86,70,16,0,86,0,300,214,35,51
15,"COVASNA",145,63937,,110,"LEŢ / ŞCOLALA GENERALĂ LEŢ",3,6196,"BOROŞNEU MARE",63937,510,161,141,20,0,161,0,600,439,44,117
15,"COVASNA",145,63937,,111,"ŢUFALĂU / CĂMINUL CULTURAL ŢUFALAU",3,6196,"BOROŞNEU MARE",63937,174,109,79,30,0,105,4,300,191,13,92
15,"COVASNA",145,64005,,112,"BRATEŞ / SALA DE FESTIVITĂŢI   A  CONSILIULUI  LOCAL BRATEŞ",3,6208,"BRATEŞ",64005,493,258,231,27,0,257,1,600,342,21,236
15,"COVASNA",145,64005,,113,"TELECHIA / CĂMINUL CULTURAL TELECHIA",3,6208,"BRATEŞ",64005,463,170,155,15,0,168,2,500,330,26,142
15,"COVASNA",145,64005,,114,"PACHIA / CĂMINUL CULTURAL PACHIA",3,6208,"BRATEŞ",64005,261,142,119,23,0,142,0,300,158,24,118
15,"COVASNA",145,64041,,115,"BRĂDUŢ / CLUBUL CĂMINULUI CULTURAL BRĂDUŢ",3,6203,"BRĂDUŢ",64041,739,326,305,16,5,321,5,800,474,59,262
15,"COVASNA",145,64041,,116,"TĂLIŞOARA / CĂMINUL CULTURAL TĂLIŞOARA",3,6203,"BRĂDUŢ",64041,605,310,296,14,0,310,0,700,390,24,286
15,"COVASNA",145,64041,,117,"DOBOŞENI / CLUBUL CĂMINULUI CULTURAL  DOBOŞENI",3,6203,"BRĂDUŢ",64041,1286,606,580,21,5,579,27,1400,794,253,326
15,"COVASNA",145,64041,,118,"FILIA / CLUBUL CĂMINULUI CULTURAL FILIA",3,6203,"BRĂDUŢ",64041,1003,426,398,27,1,423,3,1100,674,97,326
15,"COVASNA",145,64096,,119,"BREŢCU / CENTRUL CULTURAL BREŢCU",3,6212,"BREŢCU",64096,1216,538,509,29,0,532,6,1300,762,94,438
15,"COVASNA",145,64096,,120,"BREŢCU / CENTRUL CULTURAL BREŢCU",3,6212,"BREŢCU",64096,880,406,375,28,3,398,8,1000,594,172,226
15,"COVASNA",145,64096,,121,"MĂRTĂNUŞ / ŞCOALA CU CLASELE I-IV  MĂRTĂNUŞ",3,6212,"BREŢCU",64096,638,302,272,30,0,299,3,700,398,54,245
15,"COVASNA",145,64096,,122,"OITUZ / ŞCOALA CU CLASELE I-VIII OITUZ",3,6212,"BREŢCU",64096,264,139,121,18,0,135,4,300,161,45,90
15,"COVASNA",145,64130,,123,"CATALINA / CĂMINUL CULTURAL CATALINA",3,6216,"CATALINA",64130,1120,489,455,34,0,478,11,1200,711,99,379
15,"COVASNA",145,64130,,124,"IMENI / CĂMINUL CULTURAL IMENI",3,6216,"CATALINA",64130,256,107,88,19,0,105,2,300,193,28,77
15,"COVASNA",145,64130,,125,"HĂTUICA / CĂMINUL CULTURAL HĂTIUCA",3,6216,"CATALINA",64130,366,215,199,16,0,213,2,500,285,28,185
15,"COVASNA",145,64130,,126,"MĂRTINENI / CĂMINUL CULTURAL MĂRTINENI",3,6216,"CATALINA",64130,492,197,176,21,0,194,3,600,403,47,147
15,"COVASNA",145,64130,,127,"MĂRCUŞA / CĂMINUL CULTURAL MĂRCUŞA",3,6216,"CATALINA",64130,528,226,213,13,0,221,5,600,374,31,190
15,"COVASNA",145,64194,,128,"CERNAT / GRĂDINIŢA DE COPII NR.3 CERNAT",3,6222,"CERNAT",64194,660,266,248,18,0,261,5,700,434,23,238
15,"COVASNA",145,64194,,129,"CERNAT / ŞCOALA GIMNAZIALĂ ""VÉGH ANTAL"" CERNAT",3,6222,"CERNAT",64194,1184,430,393,33,4,426,4,1300,870,72,354
15,"COVASNA",145,64194,,130,"CERNAT / ŞCOALA GIMNAZIALĂ ""BOD PÉTER"" CERNAT",3,6222,"CERNAT",64194,912,439,373,22,44,430,9,1000,561,98,332
15,"COVASNA",145,64194,,131,"ALBIŞ / CLĂDIREA CONSILIULUI LOCAL CERNAT, ALBIŞ",3,6222,"CERNAT",64194,342,133,116,17,0,132,1,400,267,23,109
15,"COVASNA",145,64194,,132,"ICAFALĂU / CĂMINUL CULTURAL ICAFALĂU",3,6222,"CERNAT",64194,221,109,88,11,10,108,1,300,191,21,87
15,"COVASNA",145,64238,,133,"CHICHIŞ / Căminul cultural Chichiş",3,6226,"CHICHIŞ",64238,868,520,449,63,8,512,8,1000,480,100,412
15,"COVASNA",145,64238,,134,"BĂCEL / Căminul cultural Băcel",3,6226,"CHICHIŞ",64238,458,220,186,34,0,218,2,498,278,69,149
15,"COVASNA",145,63553,,135,"COMANDĂU / SEDIUL PRIMARIEI COMANDĂU",3,6229,"COMANDĂU",63553,823,434,399,35,0,428,6,1000,566,78,350
15,"COVASNA",145,65147,,136,"DALNIC / CĂMINUL CULTURAL DALNIC",3,6231,"DALNIC",65147,771,286,264,22,0,280,6,900,614,78,202
15,"COVASNA",145,64265,,137,"DOBÎRLĂU / CĂMINUL CULTURAL DOBÂRLĂU",3,6233,"DOBÎRLĂU",64265,862,602,529,55,18,598,4,1000,398,271,327
15,"COVASNA",145,64265,,138,"VALEA DOBÎRLĂULUI / ŞCOALA PRIMARĂ VALEA DOBÂRLĂULUI",3,6233,"DOBÎRLĂU",64265,241,152,121,25,6,151,1,300,148,44,107
15,"COVASNA",145,64265,,139,"MĂRCUŞ / ŞCOALA PRIMARĂ MĂRCUŞ",3,6233,"DOBÎRLĂU",64265,345,266,206,60,0,265,1,400,134,83,182
15,"COVASNA",145,64265,,140,"LUNCA MĂRCUŞULUI / ŞCOALA PRIMARĂ LUNCA MĂRCUŞULUI",3,6233,"DOBÎRLĂU",64265,296,207,178,28,1,207,0,400,193,61,146
15,"COVASNA",145,65154,,141,"ESTELNIC / CĂMINUL CULTURAL ESTELNIC",3,6238,"ESTELNIC",65154,669,284,248,19,17,282,2,800,516,42,240
15,"COVASNA",145,65154,,142,"VALEA SCURTĂ / CĂMINUL CULTURAL VALEA SCURTĂ",3,6238,"ESTELNIC",65154,206,117,97,16,4,115,2,300,183,18,97
15,"COVASNA",145,64318,,143,"GHELINŢA / ŞCOALA GIMNAZIALĂ ""JANCSÓ BENEDEK"" GHELINŢA",3,6242,"GHELINŢA",64318,1462,625,597,28,0,614,11,1600,975,98,516
15,"COVASNA",145,64318,,144,"GHELINŢA / ŞCOALA GIMNAZIALĂ ""JANCSÓ BENEDEK"" GHELINŢA",3,6242,"GHELINŢA",64318,1332,468,454,14,0,449,19,1400,932,148,301
15,"COVASNA",145,64318,,145,"GHELINŢA / ŞCOALA PRIMARĂ NR.2 GHELINŢA",3,6242,"GHELINŢA",64318,1055,424,406,18,0,413,11,1100,676,75,338
15,"COVASNA",145,64318,,146,"HARALE / ŞCOALA PRIMARĂ HARALE",3,6242,"GHELINŢA",64318,200,89,74,15,0,87,2,300,211,13,74
15,"COVASNA",145,64345,,147,"GHIDFALĂU / CĂMINUL CULTURAL DIN SATUL GHIDFALĂU",3,6245,"GHIDFALĂU",64345,903,349,329,20,0,341,8,1000,651,83,258
15,"COVASNA",145,64345,,148,"ANGHELUŞ / CLĂDIRE AFLATĂ ÎN DOMENIUL PUBLIC AL COMUNEI GHIDFALĂU, SAT ANGHELUŞ",3,6245,"GHIDFALĂU",64345,562,204,180,24,0,203,1,600,396,27,176
15,"COVASNA",145,64345,,149,"ZOLTAN / CLĂDIRE AFLATĂ ÎN DOMENIUL PRIVAT AL COMUNEI GHIDFALĂU, SAT ZOLTAN",3,6245,"GHIDFALĂU",64345,340,199,184,15,0,197,2,400,201,35,162
15,"COVASNA",145,64345,,150,"FOTOŞ / CĂMINUL CULTURAL DIN SATUL FOTOŞ",3,6245,"GHIDFALĂU",64345,298,132,118,14,0,132,0,400,268,3,129
15,"COVASNA",145,64390,,151,"HĂGHIG / CĂMINUL CULTURAL HĂGHIG",3,6250,"HĂGHIG",64390,1320,828,682,115,31,820,8,1400,572,382,438
15,"COVASNA",145,64390,,152,"IARĂŞ / SCOALA GENERALĂ IARĂŞ",3,6250,"HĂGHIG",64390,336,273,204,60,9,270,3,400,127,154,116
15,"COVASNA",145,64425,,153,"ILIENI / CĂMINUL CULTURAL AL COMUNEI ILIENI",3,6253,"ILIENI",64425,881,504,466,38,0,500,4,1000,496,52,448
15,"COVASNA",145,64425,,154,"SÎNCRAIU / ŞCOALA GENERALĂ A SATULUI SÂNCRAIU",3,6253,"ILIENI",64425,305,193,163,30,0,192,1,400,207,30,162
15,"COVASNA",145,64425,,155,"DOBOLII DE JOS / ŞCOALA GENERALĂ  A SATULUI DOBOLII DE JOS",3,6253,"ILIENI",64425,461,257,222,35,0,252,5,500,243,39,213
15,"COVASNA",145,64461,,156,"LEMNIA / SEDIUL PRIMARIEI LEMNIA",3,6257,"LEMNIA",64461,723,294,273,21,0,291,3,800,506,18,273
15,"COVASNA",145,64461,,157,"LEMNIA / SCOALA CU CLASELE I-IV LEMNIA DE SUS",3,6257,"LEMNIA",64461,876,366,330,36,0,361,5,1000,634,39,322
15,"COVASNA",145,64504,,158,"MALNAŞ / CĂMINUL CULTURAL MALNAŞ",3,6259,"MALNAŞ",64504,434,260,225,34,1,256,4,500,240,16,240
15,"COVASNA",145,64504,,159,"MALNAŞ-BĂI / ŞCOALA GENERALĂ CU CLASELE I-IV MALNAŞ BĂI",3,6259,"MALNAŞ",64504,370,198,163,35,0,197,1,400,202,26,171
15,"COVASNA",145,64504,,160,"VALEA ZĂLANULUI / ŞCOALA PRIMARĂ VALEA ZĂLANULUI",3,6259,"MALNAŞ",64504,108,87,67,20,0,84,3,200,113,6,78
15,"COVASNA",145,65105,,161,"MERENI / CĂMINUL CULTURAL MERENI",3,6263,"MERENI",65105,727,381,358,23,0,378,3,800,419,46,332
15,"COVASNA",145,65105,,162,"LUTOASA / CĂMINUL CULTURAL LUTOASA",3,6263,"MERENI",65105,356,163,146,17,0,160,3,400,237,21,139
15,"COVASNA",145,65139,,163,"MICFALĂU / CĂMINUL CULTURAL MICFALĂU",3,6266,"MICFALĂU",65139,1510,684,641,43,0,677,7,1600,916,77,600
15,"COVASNA",145,64568,,164,"MOACŞA / ŞCOALA CLASELE I-VIII ""ORBAN BALAZS"" MOACŞA",3,6268,"MOACŞA",64568,563,227,189,38,0,226,1,700,473,36,190
15,"COVASNA",145,64568,,165,"MOACŞA / CLĂDIREA FOSTEI ŞCOALI GENERALĂ CU CLASELE I-IV ERESTEGHIN",3,6268,"MOACŞA",64568,175,80,60,20,0,78,2,300,220,10,68
15,"COVASNA",145,64568,,166,"PĂDURENI / CĂMINUL CULTURAL PĂDURENI",3,6268,"MOACŞA",64568,251,107,75,32,0,105,2,300,193,13,92
15,"COVASNA",145,64602,,167,"OJDULA / CĂMINUL CULTURAL ''ZSÖGÖN ZOLTÁN'' OJDULA CLUBUL TINERETULUI",3,6271,"OJDULA",64602,1355,467,444,23,0,464,3,1400,933,141,323
15,"COVASNA",145,64602,,168,"OJDULA / CĂMINUL CULTURAL ''ZSÖGÖN ZOLTÁN'' OJDULA SALA MARE",3,6271,"OJDULA",64602,1302,590,562,28,0,580,10,1400,810,88,492
15,"COVASNA",145,64602,,169,"HILIB / CĂMINUL CULTURAL HILIB",3,6271,"OJDULA",64602,209,126,111,15,0,123,3,300,174,20,103
15,"COVASNA",145,64639,,170,"OZUN / CĂMINUL CULTURAL OZUN",3,6274,"OZUN",64639,938,402,348,47,7,397,5,1000,598,81,316
15,"COVASNA",145,64639,,171,"OZUN / CENTRUL DE INFORMARE ASUPRA U.E.",3,6274,"OZUN",64639,1235,661,625,36,0,659,2,1300,639,77,582
15,"COVASNA",145,64639,,172,"SÎNTIONLUNCA / ŞCOALA GENERALĂ SÎNTIONLUNCA",3,6274,"OZUN",64639,618,273,240,33,0,271,2,700,427,26,245
15,"COVASNA",145,64639,,173,"LISNĂU / CĂMINUL CULTURAL  LISNĂU",3,6274,"OZUN",64639,439,231,183,48,0,231,0,499,268,36,195
15,"COVASNA",145,64639,,174,"BICFALĂU / CĂMINUL CULTURAL  BICFALĂU",3,6274,"OZUN",64639,296,198,154,44,0,195,3,399,201,42,153
15,"COVASNA",145,64639,,175,"MĂGHERUŞ / CĂMINUL CULTURAL",3,6274,"OZUN",64639,78,59,38,21,0,59,0,100,41,10,49
15,"COVASNA",145,64639,,176,"LUNCA OZUNULUI / FOSTUL SEDIU AL ŞCOLII",3,6274,"OZUN",64639,142,125,90,35,0,124,1,200,75,41,83
15,"COVASNA",145,64719,,177,"POIAN / CAMIN CULTURAL",3,6282,"POIAN",64719,1037,403,369,24,10,398,5,1100,697,34,364
15,"COVASNA",145,64719,,178,"BELANI / SCOALA GENERALA",3,6282,"POIAN",64719,386,200,174,17,9,199,1,500,300,20,179
15,"COVASNA",145,64773,,179,"RECI / CĂMINUL CULTURAL RECI",3,6285,"RECI",64773,1142,522,438,84,0,515,7,1300,778,80,435
15,"COVASNA",145,64773,,180,"ANINOASA / ŞCOALA CU CLASELE I-IV ANINOASA",3,6285,"RECI",64773,337,163,140,22,1,160,3,400,237,43,117
15,"COVASNA",145,64773,,181,"BITA / ŞCOALA CU CLASELE I-IV BITA",3,6285,"RECI",64773,238,103,88,15,0,102,1,300,197,9,93
15,"COVASNA",145,64773,,182,"SACIOVA / CĂMINUL CULTURAL SACIOVA",3,6285,"RECI",64773,109,91,57,34,0,90,1,200,109,7,83
15,"COVASNA",145,63688,,183,"SITA BUZĂULUI / PRIMARIA SITA BUZAULUI",3,6295,"SITA BUZĂULUI",63688,1238,707,662,43,2,691,16,1300,593,286,405
15,"COVASNA",145,63688,,184,"SITA BUZĂULUI / ŞCOALA GENERALĂ NR.2 CIUMERNIC",3,6295,"SITA BUZĂULUI",63688,831,438,414,22,2,437,1,900,462,205,232
15,"COVASNA",145,63688,,185,"SITA BUZĂULUI / ŞCOALA GENERALĂ NR.3 BOBOCEA",3,6295,"SITA BUZĂULUI",63688,856,451,432,19,0,444,7,900,449,232,212
15,"COVASNA",145,63688,,186,"ZĂBRĂTĂU / ŞCOALA GENERALĂ ZĂBRĂTĂU",3,6295,"SITA BUZĂULUI",63688,454,242,221,21,0,237,5,500,258,105,132
15,"COVASNA",145,63688,,187,"CRASNA / ŞCOALA GENERALĂ CRASNA",3,6295,"SITA BUZĂULUI",63688,444,237,217,20,0,234,3,500,263,90,144
15,"COVASNA",145,64826,,188,"SÎNZIENI / SALA DE ŞEDINŢE AL CONSILIULUI LOCAL SÂNZIENI",3,6290,"SÎNZIENI",64826,1252,485,469,14,2,482,3,1300,815,38,444
15,"COVASNA",145,64826,,189,"SÎNZIENI / CLUBUL CĂMINULUI  CULTURAL SÂNZIENI",3,6290,"SÎNZIENI",64826,1004,419,389,30,0,415,4,1100,681,73,342
15,"COVASNA",145,64826,,190,"CAŞINU MIC / CĂMINUL CULTURAL CASINU MIC",3,6290,"SÎNZIENI",64826,222,77,65,12,0,76,1,300,223,10,66
15,"COVASNA",145,64826,,191,"PETRICENI / CĂMINUL CULTURAL PETRICENI",3,6290,"SÎNZIENI",64826,746,263,252,11,0,255,8,800,537,67,188
15,"COVASNA",145,64826,,192,"VALEA SEACĂ / CĂMINUL CULTURAL VALEA SEACĂ",3,6290,"SÎNZIENI",64826,514,209,186,23,0,206,3,600,391,28,178
15,"COVASNA",145,64871,,193,"TURIA / CĂMINUL CULTURAL TURIA",3,6300,"TURIA",64871,1019,343,316,27,0,337,6,1100,757,86,251
15,"COVASNA",145,64871,,194,"TURIA / ŞCOALA PRIMARĂ ""JÓKAI MÓR"" TURIA",3,6300,"TURIA",64871,685,318,271,47,0,316,2,800,482,58,258
15,"COVASNA",145,64871,,195,"TURIA / ŞCOALA PRIMARĂ NR.3 TURIA",3,6300,"TURIA",64871,1236,417,390,27,0,403,14,1300,883,122,281
15,"COVASNA",145,64871,,196,"ALUNGENI / ŞCOALA PRIMARĂ ""REMÉNYIK SÁNDOR"" ALUNGENI",3,6300,"TURIA",64871,253,122,105,17,0,119,3,300,178,29,90
15,"COVASNA",145,64906,,197,"VALEA CRIŞULUI / PRIMĂRIA COMUNEI VALEA CRIŞULUI",3,6303,"VALEA CRIŞULUI",64906,1390,610,569,40,1,599,11,1500,890,143,456
15,"COVASNA",145,64906,,198,"CALNIC / ŞCOALA PRIMARĂ ""DR. BEDŐ ALBERT"" CALNIC",3,6303,"VALEA CRIŞULUI",64906,411,220,192,28,0,219,1,500,280,14,205
15,"COVASNA",145,65099,,199,"VALEA MARE / CLĂDIREA CĂMINULUI CULTURAL VALEA MARE",3,6306,"VALEA MARE",65099,908,426,392,28,6,423,3,1000,574,263,160
15,"COVASNA",145,64942,,200,"ARACI / SEDIUL PRIMĂRIEI ÎN SATUL ARACI-CORPUL A",3,6308,"VÎLCELE",64942,828,435,394,40,1,414,21,900,465,239,175
15,"COVASNA",145,64942,,201,"ARACI / SEDIUL PRIMĂRIEI ÎN SATUL ARACI-CORPUL B",3,6308,"VÎLCELE",64942,563,303,280,23,0,295,8,600,297,183,112
15,"COVASNA",145,64942,,202,"ARIUŞD / ŞCOALA GENERALĂ ARIUŞD",3,6308,"VÎLCELE",64942,364,266,225,41,0,263,3,400,134,100,163
15,"COVASNA",145,64942,,203,"HETEA / ŞCOALA GENERALĂ HETEA",3,6308,"VÎLCELE",64942,195,108,93,15,0,103,5,300,192,91,12
15,"COVASNA",145,64942,,204,"VÎLCELE / ŞCOALA GENERALĂ VÂLCELE",3,6308,"VÎLCELE",64942,948,651,562,78,11,642,9,1100,449,296,346
15,"COVASNA",145,64997,,205,"VÎRGHIŞ / CĂMINUL CULTURAL VÂRGHIS",3,6313,"VÎRGHIŞ",64997,1548,656,644,12,0,643,13,1600,944,50,593
15,"COVASNA",145,65011,,206,"ZAGON / CĂMINUL CULTURAL NR.1 ZAGON",3,6320,"ZAGON",65011,1670,1008,884,62,62,996,12,1700,692,144,852
15,"COVASNA",145,65011,,207,"ZAGON / ŞCOALA PRIMARĂ ""GEORGE COŞBUC"" ZAGON",3,6320,"ZAGON",65011,1552,742,709,33,0,738,4,1600,858,263,475
15,"COVASNA",145,65011,,208,"PĂPĂUŢI / CĂMINUL CULTURAL PĂPĂUŢI",3,6320,"ZAGON",65011,1043,596,545,28,23,589,7,1100,504,149,440
15,"COVASNA",145,65048,,209,"ZĂBALA / CAMIN CULTURAL ZABALA",3,6315,"ZĂBALA",65048,1280,485,458,27,0,477,8,1400,915,76,401
15,"COVASNA",145,65048,,210,"ZĂBALA / CLUBUL NR.2 ZĂBALA",3,6315,"ZĂBALA",65048,852,369,345,24,0,349,20,900,531,161,188
15,"COVASNA",145,65048,,211,"ZĂBALA / CĂMINUL CULTURAL ZĂBALA (PAVA)",3,6315,"ZĂBALA",65048,701,204,191,13,0,200,4,800,596,47,153
15,"COVASNA",145,65048,,212,"TAMAŞFALĂU / CĂMINUL CULTURAL TAMAŞFALĂU",3,6315,"ZĂBALA",65048,422,237,217,20,0,235,2,500,263,11,224
15,"COVASNA",145,65048,,213,"SURCEA / CĂMINUL CULTURAL SURCEA",3,6315,"ZĂBALA",65048,498,251,238,13,0,249,2,600,349,26,223
15,"COVASNA",145,65048,,214,"PETENI / CĂMINUL CULTURAL PETENI",3,6315,"ZĂBALA",65048,111,82,63,19,0,72,10,200,118,30,42
16,"DÂMBOVIŢA","#N/A",65342,,1,"TÎRGOVIŞTE / Casa Corpului Didactic",1,6324,"MUNICIPIUL TÎRGOVIŞTE",65342,1338,889,805,84,0,872,17,1470,581,383,489
16,"DÂMBOVIŢA","#N/A",65342,,2,"TÎRGOVIŞTE / Casa Corpului Didactic",1,6324,"MUNICIPIUL TÎRGOVIŞTE",65342,1581,969,936,32,1,961,8,1720,751,444,517
16,"DÂMBOVIŢA","#N/A",65342,,3,"TÎRGOVIŞTE / Gradinita nr. 2",1,6324,"MUNICIPIUL TÎRGOVIŞTE",65342,1586,879,847,32,0,864,15,1730,851,418,446
16,"DÂMBOVIŢA","#N/A",65342,,4,"TÎRGOVIŞTE / SCOALA RADU CEL MARE",1,6324,"MUNICIPIUL TÎRGOVIŞTE",65342,1259,638,587,51,0,625,13,1380,742,296,329
16,"DÂMBOVIŢA","#N/A",65342,,5,"TÎRGOVIŞTE / SCOALA RADU CEL MARE",1,6324,"MUNICIPIUL TÎRGOVIŞTE",65342,1378,731,697,32,2,715,16,1520,789,316,399
16,"DÂMBOVIŢA","#N/A",65342,,6,"TÎRGOVIŞTE / SCOALA RADU CEL MARE",1,6324,"MUNICIPIUL TÎRGOVIŞTE",65342,1402,747,709,37,1,736,11,1540,793,363,373
16,"DÂMBOVIŢA","#N/A",65342,,7,"TÎRGOVIŞTE / SCOALA RADU CEL MARE",1,6324,"MUNICIPIUL TÎRGOVIŞTE",65342,1439,900,811,89,0,884,16,1580,680,430,454
16,"DÂMBOVIŢA","#N/A",65342,,8,"TÎRGOVIŞTE / Liceul tehnologic Spiru Haret",1,6324,"MUNICIPIUL TÎRGOVIŞTE",65342,1259,680,623,57,0,676,4,1390,710,332,344
16,"DÂMBOVIŢA","#N/A",65342,,9,"TÎRGOVIŞTE / Liceul tehnologic Spiru Haret",1,6324,"MUNICIPIUL TÎRGOVIŞTE",65342,1022,596,516,80,0,585,11,1130,534,283,302
16,"DÂMBOVIŢA","#N/A",65342,,10,"TÎRGOVIŞTE / Liceul tehnologic Spiru Haret",1,6324,"MUNICIPIUL TÎRGOVIŞTE",65342,1332,845,758,87,0,833,12,1460,615,343,490
16,"DÂMBOVIŢA","#N/A",65342,,11,"TÎRGOVIŞTE / Liceul de Muzica si arte Balasa Doamna",1,6324,"MUNICIPIUL TÎRGOVIŞTE",65342,1181,698,634,64,0,683,15,1300,602,289,394
16,"DÂMBOVIŢA","#N/A",65342,,12,"TÎRGOVIŞTE / Liceul Petru Cercel",1,6324,"MUNICIPIUL TÎRGOVIŞTE",65342,1630,1029,959,68,2,1003,26,1760,731,495,508
16,"DÂMBOVIŢA","#N/A",65342,,13,"TÎRGOVIŞTE / Colegiul C-tin Carabela",1,6324,"MUNICIPIUL TÎRGOVIŞTE",65342,1186,723,682,40,1,707,16,1300,577,325,382
16,"DÂMBOVIŢA","#N/A",65342,,14,"TÎRGOVIŞTE / Scoala Matei Basarab",1,6324,"MUNICIPIUL TÎRGOVIŞTE",65342,909,626,539,87,0,614,12,1000,374,251,363
16,"DÂMBOVIŢA","#N/A",65342,,15,"TÎRGOVIŞTE / Scoala Matei Basarab",1,6324,"MUNICIPIUL TÎRGOVIŞTE",65342,908,536,496,40,0,522,14,1000,464,200,322
16,"DÂMBOVIŢA","#N/A",65342,,16,"TÎRGOVIŞTE / Scoala Matei Basarab",1,6324,"MUNICIPIUL TÎRGOVIŞTE",65342,1467,842,793,49,0,832,10,1600,758,332,500
16,"DÂMBOVIŢA","#N/A",65342,,17,"TÎRGOVIŞTE / Scoala Tudor Vladimirescu",1,6324,"MUNICIPIUL TÎRGOVIŞTE",65342,1489,805,735,70,0,783,22,1630,825,338,445
16,"DÂMBOVIŢA","#N/A",65342,,18,"TÎRGOVIŞTE / Scoala Tudor Vladimirescu",1,6324,"MUNICIPIUL TÎRGOVIŞTE",65342,1234,691,662,28,1,673,18,1360,669,301,372
16,"DÂMBOVIŢA","#N/A",65342,,19,"TÎRGOVIŞTE / Liceul tehnologic C-tin Brancoveanu",1,6324,"MUNICIPIUL TÎRGOVIŞTE",65342,872,492,429,63,0,482,10,960,468,214,268
16,"DÂMBOVIŢA","#N/A",65342,,20,"TÎRGOVIŞTE / Liceul tehnologic C-tin Brancoveanu",1,6324,"MUNICIPIUL TÎRGOVIŞTE",65342,953,476,419,57,0,457,19,1050,574,246,211
16,"DÂMBOVIŢA","#N/A",65342,,21,"TÎRGOVIŞTE / Liceul tehnologic C-tin Brancoveanu",1,6324,"MUNICIPIUL TÎRGOVIŞTE",65342,1517,828,799,27,2,808,20,1660,832,380,428
16,"DÂMBOVIŢA","#N/A",65342,,22,"TÎRGOVIŞTE / Liceul tehnologic C-tin Brancoveanu",1,6324,"MUNICIPIUL TÎRGOVIŞTE",65342,849,432,406,26,0,424,8,940,508,191,233
16,"DÂMBOVIŢA","#N/A",65342,,23,"TÎRGOVIŞTE / Liceul tehnologic C-tin Brancoveanu",1,6324,"MUNICIPIUL TÎRGOVIŞTE",65342,798,419,369,50,0,410,9,880,461,179,231
16,"DÂMBOVIŢA","#N/A",65342,,24,"TÎRGOVIŞTE / Cantina de Ajutor Social",1,6324,"MUNICIPIUL TÎRGOVIŞTE",65342,1070,616,546,70,0,602,14,1190,574,300,302
16,"DÂMBOVIŢA","#N/A",65342,,25,"TÎRGOVIŞTE / Scoala Paul Banica",1,6324,"MUNICIPIUL TÎRGOVIŞTE",65342,1231,719,636,81,2,708,11,1350,631,312,396
16,"DÂMBOVIŢA","#N/A",65342,,26,"TÎRGOVIŞTE / Scoala Paul Banica",1,6324,"MUNICIPIUL TÎRGOVIŞTE",65342,1121,797,536,35,226,778,19,1330,533,374,404
16,"DÂMBOVIŢA","#N/A",65342,,27,"TÎRGOVIŞTE / Liceul teoretic I. H. Radulescu",1,6324,"MUNICIPIUL TÎRGOVIŞTE",65342,989,653,566,86,1,642,11,1090,437,268,374
16,"DÂMBOVIŢA","#N/A",65342,,28,"TÎRGOVIŞTE / Liceul teoretic I. H. Radulescu",1,6324,"MUNICIPIUL TÎRGOVIŞTE",65342,1209,734,690,42,2,719,15,1330,596,332,387
16,"DÂMBOVIŢA","#N/A",65342,,29,"TÎRGOVIŞTE / Birouri Primarie",1,6324,"MUNICIPIUL TÎRGOVIŞTE",65342,885,599,510,89,0,589,10,970,371,233,356
16,"DÂMBOVIŢA","#N/A",65342,,30,"TÎRGOVIŞTE / Birouri Primarie",1,6324,"MUNICIPIUL TÎRGOVIŞTE",65342,888,609,535,73,1,598,11,970,361,237,361
16,"DÂMBOVIŢA","#N/A",65342,,31,"TÎRGOVIŞTE / Birouri Primarie",1,6324,"MUNICIPIUL TÎRGOVIŞTE",65342,1069,807,668,138,1,798,9,1180,373,252,546
16,"DÂMBOVIŢA","#N/A",65342,,32,"TÎRGOVIŞTE / Colegiul Ion Ghica",1,6324,"MUNICIPIUL TÎRGOVIŞTE",65342,1104,730,649,81,0,723,7,1210,480,311,412
16,"DÂMBOVIŢA","#N/A",65342,,33,"TÎRGOVIŞTE / Colegiul Ion Ghica",1,6324,"MUNICIPIUL TÎRGOVIŞTE",65342,1214,787,725,60,2,772,15,1270,483,325,447
16,"DÂMBOVIŢA","#N/A",65342,,34,"TÎRGOVIŞTE / Colegiul Ienachita Vacarescu",1,6324,"MUNICIPIUL TÎRGOVIŞTE",65342,1553,1047,948,98,1,1028,19,1680,633,381,647
16,"DÂMBOVIŢA","#N/A",65342,,35,"TÎRGOVIŞTE / Scoala I. Al. Bratescu-Voinesti",1,6324,"MUNICIPIUL TÎRGOVIŞTE",65342,1184,748,674,61,13,735,13,1300,552,340,395
16,"DÂMBOVIŢA","#N/A",65342,,36,"TÎRGOVIŞTE / Scoala I. Al. Bratescu-Voinesti",1,6324,"MUNICIPIUL TÎRGOVIŞTE",65342,978,652,586,66,0,634,18,1080,428,273,361
16,"DÂMBOVIŢA","#N/A",65342,,37,"TÎRGOVIŞTE / Scoala I. Al. Bratescu-Voinesti",1,6324,"MUNICIPIUL TÎRGOVIŞTE",65342,929,460,404,54,2,447,13,1020,560,231,216
16,"DÂMBOVIŢA","#N/A",65342,,38,"TÎRGOVIŞTE / Liceul tehnologic  Voievoul Mircea",1,6324,"MUNICIPIUL TÎRGOVIŞTE",65342,1608,1138,888,178,72,1118,20,1750,612,535,583
16,"DÂMBOVIŢA","#N/A",65342,,39,"TÎRGOVIŞTE / Scoala Coresi",1,6324,"MUNICIPIUL TÎRGOVIŞTE",65342,1246,829,746,77,6,814,15,1370,541,404,410
16,"DÂMBOVIŢA","#N/A",65342,,40,"TÎRGOVIŞTE / Liceul tehnologic Nicolae Mihaescu",1,6324,"MUNICIPIUL TÎRGOVIŞTE",65342,1244,765,686,78,1,745,20,1370,605,287,458
16,"DÂMBOVIŢA","#N/A",65342,,41,"TÎRGOVIŞTE / Liceul tehnologic Nicolae Mihaescu",1,6324,"MUNICIPIUL TÎRGOVIŞTE",65342,1480,750,701,48,1,738,12,1620,870,321,417
16,"DÂMBOVIŢA","#N/A",65342,,42,"TÎRGOVIŞTE / Liceul tehnologic Nicolae Mihaescu",1,6324,"MUNICIPIUL TÎRGOVIŞTE",65342,1394,823,788,35,0,804,19,1530,707,276,528
16,"DÂMBOVIŢA","#N/A",65342,,43,"TÎRGOVIŞTE / Liceul tehnologic Nicolae Mihaescu",1,6324,"MUNICIPIUL TÎRGOVIŞTE",65342,1451,781,754,27,0,767,14,1600,819,318,449
16,"DÂMBOVIŢA","#N/A",65342,,44,"TÎRGOVIŞTE / Liceul tehnologic Nicolae Mihaescu",1,6324,"MUNICIPIUL TÎRGOVIŞTE",65342,1375,699,677,22,0,673,26,1520,821,303,370
16,"DÂMBOVIŢA","#N/A",65342,,45,"TÎRGOVIŞTE / Liceul Nicolae Cioranescu",1,6324,"MUNICIPIUL TÎRGOVIŞTE",65342,1384,725,668,57,0,707,18,1520,795,330,377
16,"DÂMBOVIŢA","#N/A",65342,,46,"TÎRGOVIŞTE / Liceul Nicolae Cioranescu",1,6324,"MUNICIPIUL TÎRGOVIŞTE",65342,1274,837,791,46,0,826,11,1400,563,369,457
16,"DÂMBOVIŢA","#N/A",65342,,47,"TÎRGOVIŞTE / Liceul Nicolae Cioranescu",1,6324,"MUNICIPIUL TÎRGOVIŞTE",65342,917,520,482,37,1,512,8,1070,550,257,255
16,"DÂMBOVIŢA","#N/A",65342,,48,"TÎRGOVIŞTE / Liceul Nicolae Cioranescu",1,6324,"MUNICIPIUL TÎRGOVIŞTE",65342,870,507,472,35,0,501,6,960,453,264,237
16,"DÂMBOVIŢA","#N/A",65342,,49,"TÎRGOVIŞTE / Scoala Mihai Viteazu",1,6324,"MUNICIPIUL TÎRGOVIŞTE",65342,1273,742,684,58,0,735,7,1410,668,376,359
16,"DÂMBOVIŢA","#N/A",65342,,50,"TÎRGOVIŞTE / Scoala Mihai Viteazu",1,6324,"MUNICIPIUL TÎRGOVIŞTE",65342,1262,722,655,65,2,711,11,1390,668,348,363
16,"DÂMBOVIŢA","#N/A",65342,,51,"TÎRGOVIŞTE / Colegiul National Constantin Cantacuzino",1,6324,"MUNICIPIUL TÎRGOVIŞTE",65342,1419,706,663,42,1,689,17,1560,854,363,326
16,"DÂMBOVIŢA","#N/A",65342,,52,"TÎRGOVIŞTE / Colegiul National Constantin Cantacuzino",1,6324,"MUNICIPIUL TÎRGOVIŞTE",65342,1556,822,796,26,0,807,15,1700,878,370,437
16,"DÂMBOVIŢA","#N/A",65342,,53,"TÎRGOVIŞTE / Colegiul National Constantin Cantacuzino",1,6324,"MUNICIPIUL TÎRGOVIŞTE",65342,730,426,378,48,0,418,8,810,384,205,213
16,"DÂMBOVIŢA","#N/A",65342,,54,"TÎRGOVIŞTE / Colegiul National Constantin Cantacuzino",1,6324,"MUNICIPIUL TÎRGOVIŞTE",65342,907,513,465,48,0,499,14,1000,487,227,272
16,"DÂMBOVIŢA","#N/A",65342,,55,"TÎRGOVIŞTE / Scoala Grigore Alexandrescu",1,6324,"MUNICIPIUL TÎRGOVIŞTE",65342,1506,773,708,65,0,757,16,1640,867,346,411
16,"DÂMBOVIŢA","#N/A",65342,,56,"TÎRGOVIŞTE / Scoala Grigore Alexandrescu",1,6324,"MUNICIPIUL TÎRGOVIŞTE",65342,1376,689,664,25,0,672,17,1520,831,332,340
16,"DÂMBOVIŢA","#N/A",65342,,57,"TÎRGOVIŞTE / Scoala Grigore Alexandrescu",1,6324,"MUNICIPIUL TÎRGOVIŞTE",65342,853,480,460,20,0,468,12,940,460,234,234
16,"DÂMBOVIŢA","#N/A",65342,,58,"TÎRGOVIŞTE / Scoala Grigore Alexandrescu",1,6324,"MUNICIPIUL TÎRGOVIŞTE",65342,829,480,451,29,0,466,14,910,430,226,240
16,"DÂMBOVIŢA","#N/A",65342,,59,"TÎRGOVIŞTE / Scoala Smaranda Gheorghiu",1,6324,"MUNICIPIUL TÎRGOVIŞTE",65342,1538,942,873,69,0,931,11,1690,748,378,553
16,"DÂMBOVIŢA","#N/A",65342,,60,"TÎRGOVIŞTE / Scoala Smaranda Gheorghiu",1,6324,"MUNICIPIUL TÎRGOVIŞTE",65342,1690,957,885,72,0,933,24,1860,903,422,511
16,"DÂMBOVIŢA","#N/A",65342,,61,"TÎRGOVIŞTE / Scoala Smaranda Gheorghiu",1,6324,"MUNICIPIUL TÎRGOVIŞTE",65342,1378,785,751,34,0,764,21,1510,725,326,438
16,"DÂMBOVIŢA","#N/A",65342,,62,"TÎRGOVIŞTE / Scoala Smaranda Gheorghiu",1,6324,"MUNICIPIUL TÎRGOVIŞTE",65342,850,443,421,22,0,438,5,940,497,215,223
16,"DÂMBOVIŢA","#N/A",65342,,63,"TÎRGOVIŞTE / Scoala Smaranda Gheorghiu",1,6324,"MUNICIPIUL TÎRGOVIŞTE",65342,1134,648,594,54,0,630,18,1250,602,390,240
16,"DÂMBOVIŢA","#N/A",65342,,64,"TÎRGOVIŞTE / Casa de Cultura a Municipiului Targoviste",1,6324,"MUNICIPIUL TÎRGOVIŞTE",65342,1550,959,931,28,0,935,24,1700,741,359,576
16,"DÂMBOVIŢA","#N/A",65342,,65,"TÎRGOVIŞTE / Gradinita Priseaca",1,6324,"MUNICIPIUL TÎRGOVIŞTE",65342,959,588,552,35,1,576,12,1056,468,324,252
16,"DÂMBOVIŢA","#N/A",65841,,66,"MORENI / Scoala Gimnaziala nr.2",1,6327,"MUNICIPIUL MORENI",65841,1135,653,619,31,3,637,16,1240,587,368,269
16,"DÂMBOVIŢA","#N/A",65841,,67,"MORENI / Club Cristian (U.A.Moreni)",1,6327,"MUNICIPIUL MORENI",65841,748,443,422,15,6,434,9,820,377,254,180
16,"DÂMBOVIŢA","#N/A",65841,,68,"MORENI / Gradinita cu program normal nr.7 Tuicani",1,6327,"MUNICIPIUL MORENI",65841,433,227,212,15,0,225,2,480,253,125,100
16,"DÂMBOVIŢA","#N/A",65841,,69,"MORENI / Gradinita cu program normal nr.2",1,6327,"MUNICIPIUL MORENI",65841,753,485,445,36,4,476,9,830,345,245,231
16,"DÂMBOVIŢA","#N/A",65841,,70,"MORENI / Club Flacara nr.2",1,6327,"MUNICIPIUL MORENI",65841,861,520,491,29,0,514,6,950,430,249,265
16,"DÂMBOVIŢA","#N/A",65841,,71,"MORENI / Gradinita cu program normal Tisa",1,6327,"MUNICIPIUL MORENI",65841,504,356,321,34,1,350,6,550,194,217,133
16,"DÂMBOVIŢA","#N/A",65841,,72,"MORENI / Scoala Gimnaziala nr.3",1,6327,"MUNICIPIUL MORENI",65841,1315,822,792,29,1,804,18,1450,628,429,375
16,"DÂMBOVIŢA","#N/A",65841,,73,"MORENI / Scoala Gimnaziala nr.3",1,6327,"MUNICIPIUL MORENI",65841,849,470,421,45,4,465,5,930,460,214,251
16,"DÂMBOVIŢA","#N/A",65841,,74,"MORENI / Scoala Gimnaziala nr.3",1,6327,"MUNICIPIUL MORENI",65841,800,447,426,21,0,442,5,880,433,223,219
16,"DÂMBOVIŢA","#N/A",65841,,75,"MORENI / Scoala Gimnaziala nr.3",1,6327,"MUNICIPIUL MORENI",65841,997,602,563,21,18,595,7,1100,498,274,321
16,"DÂMBOVIŢA","#N/A",65841,,76,"MORENI / Scoala Gimnaziala nr.3",1,6327,"MUNICIPIUL MORENI",65841,1027,627,598,27,2,613,14,1130,502,292,321
16,"DÂMBOVIŢA","#N/A",65841,,77,"MORENI / Scoala Gimnaziala nr.4",1,6327,"MUNICIPIUL MORENI",65841,1058,594,570,24,0,587,7,1160,566,278,309
16,"DÂMBOVIŢA","#N/A",65841,,78,"MORENI / Scoala Gimnaziala nr.4",1,6327,"MUNICIPIUL MORENI",65841,717,361,337,24,0,356,5,790,429,166,190
16,"DÂMBOVIŢA","#N/A",65841,,79,"MORENI / Scoala Gimnaziala nr.4",1,6327,"MUNICIPIUL MORENI",65841,1000,597,541,54,2,585,12,1100,503,308,277
16,"DÂMBOVIŢA","#N/A",65841,,80,"MORENI / Scoala Gimnaziala nr.4",1,6327,"MUNICIPIUL MORENI",65841,968,558,540,17,1,545,13,1060,502,256,289
16,"DÂMBOVIŢA","#N/A",65841,,81,"MORENI / Scoala Gimnaziala nr.4",1,6327,"MUNICIPIUL MORENI",65841,883,504,471,32,1,494,10,970,466,270,224
16,"DÂMBOVIŢA","#N/A",65841,,82,"MORENI / Sala de Sport",1,6327,"MUNICIPIUL MORENI",65841,771,448,421,26,1,439,9,850,402,256,183
16,"DÂMBOVIŢA","#N/A",65841,,83,"MORENI / Sala de Sport",1,6327,"MUNICIPIUL MORENI",65841,653,375,353,20,2,368,7,720,345,150,218
16,"DÂMBOVIŢA","#N/A",65841,,84,"MORENI / Liceul Teoretic ""I.L.Caragiale""",1,6327,"MUNICIPIUL MORENI",65841,728,540,427,63,50,528,12,800,260,279,249
16,"DÂMBOVIŢA","#N/A",65841,,85,"MORENI / Liceul Tehnologic de Petrol",1,6327,"MUNICIPIUL MORENI",65841,1442,845,746,96,3,826,19,1590,745,412,414
16,"DÂMBOVIŢA","#N/A",65609,,86,"COSTEŞTI / GRADINITA ""PINOCHIO"" COSTESTI",1,6329,"ORAŞ FIENI",65609,698,422,385,32,5,420,2,760,338,198,222
16,"DÂMBOVIŢA","#N/A",65609,,87,"BEREVOEŞTI / GRADINITA ""PITICII"" BERIVOIESTI",1,6329,"ORAŞ FIENI",65609,563,359,336,18,5,356,3,620,261,154,202
16,"DÂMBOVIŢA","#N/A",65609,,88,"FIENI / SCOALA GENERALA DIACONU CORESI FIENI",1,6329,"ORAŞ FIENI",65609,1580,941,869,71,1,931,10,1740,799,282,649
16,"DÂMBOVIŢA","#N/A",65609,,89,"FIENI / GRUP SCOLAR INDUSTRIAL ""ING.AUREL RAINU"" FIENI-CORP B",1,6329,"ORAŞ FIENI",65609,1573,791,752,35,4,781,10,1740,949,324,457
16,"DÂMBOVIŢA","#N/A",65609,,90,"FIENI / GRADINITA ""DUMBRAVA MINUNATA"" FIENI",1,6329,"ORAŞ FIENI",65609,646,303,272,30,1,297,6,710,407,135,162
16,"DÂMBOVIŢA","#N/A",65609,,91,"FIENI / GRUP SCOLAR INDUSTRIAL ""ING.AUREL RAINU"" FIENI-CORP A",1,6329,"ORAŞ FIENI",65609,1569,845,798,44,3,839,6,1720,875,321,518
16,"DÂMBOVIŢA","#N/A",65681,,92,"GĂEŞTI / Scoala nr. 1 Gaesti",1,6333,"ORAŞ GĂEŞTI",65681,941,647,574,72,1,642,5,1040,393,407,235
16,"DÂMBOVIŢA","#N/A",65681,,93,"GĂEŞTI / Scoala nr. 1 Gaesti",1,6333,"ORAŞ GĂEŞTI",65681,899,908,544,41,323,894,14,1190,282,678,216
16,"DÂMBOVIŢA","#N/A",65681,,94,"GĂEŞTI / Grupul Scolar Agricol G. Angelescu",1,6333,"ORAŞ GĂEŞTI",65681,1287,910,846,62,2,902,8,1410,500,614,288
16,"DÂMBOVIŢA","#N/A",65681,,95,"GĂEŞTI / Colegiul Vladimir Streinu",1,6333,"ORAŞ GĂEŞTI",65681,1455,1013,915,98,0,996,17,1600,587,560,436
16,"DÂMBOVIŢA","#N/A",65681,,96,"GĂEŞTI / Scoala nr. 6 Serban Cioculescu",1,6333,"ORAŞ GĂEŞTI",65681,1396,900,814,86,0,883,17,1540,640,441,442
16,"DÂMBOVIŢA","#N/A",65681,,97,"GĂEŞTI / Scoala nr. 6 Serban Cioculescu",1,6333,"ORAŞ GĂEŞTI",65681,898,537,488,46,3,532,5,990,453,296,236
16,"DÂMBOVIŢA","#N/A",65681,,98,"GĂEŞTI / Scoala nr. 6 Serban Cioculescu",1,6333,"ORAŞ GĂEŞTI",65681,1289,779,718,61,0,769,10,1420,641,444,325
16,"DÂMBOVIŢA","#N/A",65681,,99,"GĂEŞTI / Scoala nr.6 Serban Cioculescu",1,6333,"ORAŞ GĂEŞTI",65681,1432,849,814,33,2,842,7,1570,721,475,367
16,"DÂMBOVIŢA","#N/A",65681,,100,"GĂEŞTI / Scoala nr.3 Radu cel Mare",1,6333,"ORAŞ GĂEŞTI",65681,830,610,487,87,36,602,8,910,300,347,255
16,"DÂMBOVIŢA","#N/A",65681,,101,"GĂEŞTI / Scoala nr.3 Radu cel Mare",1,6333,"ORAŞ GĂEŞTI",65681,1082,697,655,41,1,682,15,1190,493,395,287
16,"DÂMBOVIŢA","#N/A",65681,,102,"GĂEŞTI / Scoala nr.3 Radu cel Mare",1,6333,"ORAŞ GĂEŞTI",65681,1583,1005,964,41,0,979,26,1740,735,536,443
16,"DÂMBOVIŢA","#N/A",65921,,103,"PUCIOASA / Şcoala genenerală nr. 2 Pucioasa",1,6335,"ORAŞ PUCIOASA",65921,1286,836,785,51,0,831,5,1400,564,372,459
16,"DÂMBOVIŢA","#N/A",65921,,104,"DIACONEŞTI / Grădiniţa Diaconeşti",1,6335,"ORAŞ PUCIOASA",65921,832,553,498,55,0,547,6,920,367,285,262
16,"DÂMBOVIŢA","#N/A",65921,,105,"PUCIOASA / Scoala Generala nr.1 Pucioasa",1,6335,"ORAŞ PUCIOASA",65921,1080,867,629,236,2,857,10,1190,323,404,453
16,"DÂMBOVIŢA","#N/A",65921,,106,"PUCIOASA / Şcoala genenerală nr. 1 Pucioasa(2)",1,6335,"ORAŞ PUCIOASA",65921,1165,761,644,115,2,749,12,1280,519,310,439
16,"DÂMBOVIŢA","#N/A",65921,,107,"PUCIOASA / Grădiniţa nr. 1 Pucioasa",1,6335,"ORAŞ PUCIOASA",65921,922,656,522,133,1,646,10,1010,354,308,338
16,"DÂMBOVIŢA","#N/A",65921,,108,"PUCIOASA / Scoala generala nr.4 Pucioasa",1,6335,"ORAŞ PUCIOASA",65921,1401,893,739,73,81,875,18,1540,647,388,487
16,"DÂMBOVIŢA","#N/A",65921,,109,"PUCIOASA / Colegiul Naţional Nicolae Titulescu Pucioasa",1,6335,"ORAŞ PUCIOASA",65921,1207,722,666,54,2,710,12,1320,598,335,375
16,"DÂMBOVIŢA","#N/A",65921,,110,"PUCIOASA / Grădiniţa nr. 2",1,6335,"ORAŞ PUCIOASA",65921,1188,705,640,43,22,692,13,1310,605,297,395
16,"DÂMBOVIŢA","#N/A",65921,,111,"PUCIOASA / Grădiniţa nr. 3 Pucioasa",1,6335,"ORAŞ PUCIOASA",65921,1207,677,646,30,1,673,4,1320,643,338,335
16,"DÂMBOVIŢA","#N/A",65921,,112,"PUCIOASA / Şcoala genenerală nr. 3 Pucioasa",1,6335,"ORAŞ PUCIOASA",65921,1257,691,658,33,0,685,6,1380,689,385,300
16,"DÂMBOVIŢA","#N/A",65921,,113,"GLODENI / Şcoala genenerală nr. 5 Glodeni.",1,6335,"ORAŞ PUCIOASA",65921,1067,655,630,25,0,644,11,1170,515,345,299
16,"DÂMBOVIŢA","#N/A",65921,,114,"MALURILE / Şcoala genenerală Maluri",1,6335,"ORAŞ PUCIOASA",65921,121,79,68,11,0,79,0,130,51,56,23
16,"DÂMBOVIŢA","#N/A",65921,,115,"PUCIOASA-SAT / Şcoala genenerală Pucioasa Sat",1,6335,"ORAŞ PUCIOASA",65921,348,235,219,13,3,231,4,380,145,120,111
16,"DÂMBOVIŢA","#N/A",68627,,116,"RĂCARI / Liceul Teoretic Ion Ghica Racari",1,6343,"ORAŞ RĂCARI",68627,909,720,579,127,14,704,16,1000,280,378,326
16,"DÂMBOVIŢA","#N/A",68627,,117,"RĂCARI / Liceul Teoretic Ion Ghica Racari",1,6343,"ORAŞ RĂCARI",68627,828,649,533,97,19,640,9,910,261,342,298
16,"DÂMBOVIŢA","#N/A",68627,,118,"RĂCARI / Scoala gen.Ghergani",1,6343,"ORAŞ RĂCARI",68627,636,532,368,80,84,525,7,700,168,246,279
16,"DÂMBOVIŢA","#N/A",68627,,119,"RĂCARI / Gradinita Mavrodin",1,6343,"ORAŞ RĂCARI",68627,787,561,480,79,2,556,5,870,309,240,316
16,"DÂMBOVIŢA","#N/A",68627,,120,"RĂCARI / Caminul Cultural Ghimpati",1,6343,"ORAŞ RĂCARI",68627,638,586,454,113,19,581,5,700,114,233,348
16,"DÂMBOVIŢA","#N/A",68627,,121,"RĂCARI / Scoala  Generala Colacu",1,6343,"ORAŞ RĂCARI",68627,740,575,453,84,38,560,15,810,235,362,198
16,"DÂMBOVIŢA","#N/A",68627,,122,"RĂCARI / Gradinita Sabiesti",1,6343,"ORAŞ RĂCARI",68627,670,514,413,74,27,510,4,740,226,333,177
16,"DÂMBOVIŢA","#N/A",66081,,123,"FUSEA / Şcoala Generală Nr. 2 Titu",1,6352,"ORAŞ TITU",66081,1269,909,800,109,0,881,28,1390,481,659,222
16,"DÂMBOVIŢA","#N/A",66081,,124,"TITU / Şcoala Generală Nr. 2 Titu",1,6352,"ORAŞ TITU",66081,1017,698,663,35,0,683,15,1120,422,469,214
16,"DÂMBOVIŢA","#N/A",66081,,125,"SĂLCUŢA / Şcoala Sălcuţa",1,6352,"ORAŞ TITU",66081,1151,815,715,100,0,806,9,1260,445,559,247
16,"DÂMBOVIŢA","#N/A",66081,,126,"TITU / Şcoala Generală Pictor Nicolae Grigorescu",1,6352,"ORAŞ TITU",66081,1333,1001,876,124,1,984,17,1460,459,596,388
16,"DÂMBOVIŢA","#N/A",66081,,127,"TITU / Liceul Teoretic I.C.Visarion",1,6352,"ORAŞ TITU",66081,1182,731,671,60,0,716,15,1300,569,454,262
16,"DÂMBOVIŢA","#N/A",66081,,128,"TITU / Liceul Teoretic I.C.Visarion",1,6352,"ORAŞ TITU",66081,1351,829,756,73,0,808,21,1490,661,526,282
16,"DÂMBOVIŢA","#N/A",66081,,129,"TITU / Liceul Teoretic I.C.Visarion",1,6352,"ORAŞ TITU",66081,1201,822,763,59,0,809,13,1330,508,480,329
16,"DÂMBOVIŢA","#N/A",65379,,130,"ANINOASA / Scoala cu clasele I-VIII comuna Aninoasa",3,6359,"ANINOASA",65379,931,681,573,91,17,670,11,1020,339,385,285
16,"DÂMBOVIŢA","#N/A",65379,,131,"ANINOASA / Scoala cu clasele I-VIII  comuna Aninoasa",3,6359,"ANINOASA",65379,1071,778,714,52,12,767,11,1180,402,494,273
16,"DÂMBOVIŢA","#N/A",65379,,132,"VIFORÎTA / Scoala cu clasele I-VIII  comuna Aninoasa",3,6359,"ANINOASA",65379,1096,799,686,88,25,779,20,1200,401,485,294
16,"DÂMBOVIŢA","#N/A",65379,,133,"SĂTENI / Scoala cu clasele I-VIII  comuna Aninoasa",3,6359,"ANINOASA",65379,1265,841,777,56,8,823,18,1390,549,552,271
16,"DÂMBOVIŢA","#N/A",65379,,134,"VIFORÎTA / Scoala cu clasele I-VIII comuna  Aninoasa",3,6359,"ANINOASA",65379,856,584,504,59,21,573,11,940,356,310,263
16,"DÂMBOVIŢA","#N/A",66198,,135,"BĂLENI-ROMÂNI / ŞCOALA PROFESIONALĂ BĂLENI",3,6363,"BĂLENI",66198,1588,982,908,74,0,973,9,1750,768,553,420
16,"DÂMBOVIŢA","#N/A",66198,,136,"BĂLENI-ROMÂNI / LIC.TEHNOLOGIC UDREA BĂLEANU",3,6363,"BĂLENI",66198,1418,873,851,22,0,863,10,1560,687,576,287
16,"DÂMBOVIŢA","#N/A",66198,,137,"BĂLENI-SÎRBI / LIC.TEHNOLOGIC UDREA BĂLEANU",3,6363,"BĂLENI",66198,881,564,510,54,0,552,12,960,396,358,194
16,"DÂMBOVIŢA","#N/A",66198,,138,"BĂLENI-SÎRBI / CĂMINUL CULTURAL BĂLENI SÂRBI",3,6363,"BĂLENI",66198,1383,780,742,38,0,770,10,1520,740,441,329
16,"DÂMBOVIŢA","#N/A",66198,,139,"BĂLENI-SÎRBI / FOSTA PRIMĂRIE BĂLENI SÂRBI",3,6363,"BĂLENI",66198,1294,855,815,40,0,830,25,1420,565,485,345
16,"DÂMBOVIŢA","#N/A",66223,,140,"GURA BĂRBULEŢULUI / Scoala Gura Barbuletului corp nou",3,6366,"BĂRBULEŢU",66223,432,334,289,44,1,328,6,450,116,205,123
16,"DÂMBOVIŢA","#N/A",66223,,141,"BĂRBULEŢU / Scoala cu clasele I - VIII Barbuletu",3,6366,"BĂRBULEŢU",66223,1441,889,829,60,0,880,9,1610,721,480,400
16,"DÂMBOVIŢA","#N/A",66330,,142,"BEZDEAD / SCOALA GIMNAZIALA ,,GRIGORE RADULESCU"" BEZDEAD",3,6370,"BEZDEAD",66330,1594,974,894,78,2,963,11,1760,786,373,590
16,"DÂMBOVIŢA","#N/A",66330,,143,"BEZDEAD / SCOALA GIMNAZIALA ,,VASILE VOICULESCU"" BEZDEAD",3,6370,"BEZDEAD",66330,1442,877,818,59,0,864,13,1580,703,365,499
16,"DÂMBOVIŢA","#N/A",66330,,144,"BROŞTENI / SCOALA MAGURA",3,6370,"BEZDEAD",66330,872,535,464,70,1,530,5,960,425,261,269
16,"DÂMBOVIŢA","#N/A",66401,,145,"BILCIUREŞTI / Caminul Cultural",3,6377,"BILCIUREŞTI",66401,1435,1122,935,183,4,1106,16,1580,458,605,501
16,"DÂMBOVIŢA","#N/A",66152,,146,"BRANIŞTEA / SCOALA""SPIRU HARET""BRANISTEA,CLASELE I-IV,SALA DE CLASA NR.1",3,6383,"BRANIŞTEA",66152,1262,895,787,91,17,884,11,1390,495,605,279
16,"DÂMBOVIŢA","#N/A",66152,,147,"BRANIŞTEA / SCOALA""SPIRU HARET""BRANISTEA,CLASELE I-IV,SALA DE CLASA NR.2",3,6383,"BRANIŞTEA",66152,1182,857,771,64,22,847,10,1300,443,560,287
16,"DÂMBOVIŢA","#N/A",66152,,148,"DÎMBOVICIOARA / SCOALA""SPIRU HARET""BRANISTEA,CLASELE I-IV,DIMBOVICIOARA",3,6383,"BRANIŞTEA",66152,908,619,534,73,12,610,9,1000,381,402,208
16,"DÂMBOVIŢA","#N/A",66152,,149,"SĂVEŞTI / SCOALA""SPIRU HARET""BRANISTEA,CLASELE I-IV,SAVESTI",3,6383,"BRANIŞTEA",66152,148,113,86,27,0,112,1,170,57,99,13
16,"DÂMBOVIŢA","#N/A",66009,,150,"BRĂNEŞTI / Caminul Cultural",3,6380,"BRĂNEŞTI",66009,1336,855,793,62,0,845,10,1440,585,409,436
16,"DÂMBOVIŢA","#N/A",66009,,151,"BRĂNEŞTI / Sc.Generala ""Spiru Haret""",3,6380,"BRĂNEŞTI",66009,1508,862,811,51,0,844,18,1690,828,443,401
16,"DÂMBOVIŢA","#N/A",66009,,152,"BRĂNEŞTI / Scoala Generala",3,6380,"BRĂNEŞTI",66009,828,548,519,29,0,543,5,910,362,270,273
16,"DÂMBOVIŢA","#N/A",101341,,153,"BREZOAELE / ŞCOALA GIMNAZIALĂ BREZOAELE",3,6387,"BREZOAELE",101341,1163,958,793,165,0,940,18,1280,322,630,310
16,"DÂMBOVIŢA","#N/A",101341,,154,"BREZOAIA / ŞCOALA GIMNAZIALĂ BREZOAIA",3,6387,"BREZOAELE",101341,794,615,548,67,0,607,8,870,255,377,230
16,"DÂMBOVIŢA","#N/A",101341,,155,"BREZOAIA / ŞCOALA GIMNAZIALĂ BREZOAIA",3,6387,"BREZOAELE",101341,991,751,685,66,0,742,9,1090,339,532,210
16,"DÂMBOVIŢA","#N/A",66438,,156,"BUCIUMENI / GRADINITA CU PROGRAM NORMAL  SAT BUCIUMENI NR.293",3,6390,"BUCIUMENI",66438,1524,900,861,35,4,891,9,1680,780,372,519
16,"DÂMBOVIŢA","#N/A",66438,,157,"DEALU MARE / SCOALA GENERALA SAT DEALU MARE NR.101",3,6390,"BUCIUMENI",66438,1226,771,728,38,5,762,9,1350,579,379,383
16,"DÂMBOVIŢA","#N/A",66438,,158,"VALEA LEURZII / SCOALA PRIMARA SI GRADINITA CU PROGRAM NORMAL SAT VALEA LEURZII NR. 56",3,6390,"BUCIUMENI",66438,1117,639,608,30,1,634,5,1230,591,430,204
16,"DÂMBOVIŢA","#N/A",66474,,159,"BUCŞANI / Scoala Generala Dora Dalles Bucsani",3,6394,"BUCŞANI",66474,1496,958,917,41,0,949,9,1650,692,577,372
16,"DÂMBOVIŢA","#N/A",66474,,160,"BUCŞANI / Scoala Generala Dora Dalles Bucsani",3,6394,"BUCŞANI",66474,1535,953,907,46,0,945,8,1680,727,560,385
16,"DÂMBOVIŢA","#N/A",66474,,161,"HĂBENI / Scoala Generala Habeni",3,6394,"BUCŞANI",66474,1161,763,719,44,0,752,11,1280,517,427,325
16,"DÂMBOVIŢA","#N/A",66474,,162,"RACOVIŢA / Scoala Generala Racovita",3,6394,"BUCŞANI",66474,1022,668,603,58,7,661,7,1120,452,423,238
16,"DÂMBOVIŢA","#N/A",66474,,163,"RĂŢOAIA / Scoala Generala Ratoaia",3,6394,"BUCŞANI",66474,395,308,290,18,0,307,1,430,122,208,99
16,"DÂMBOVIŢA","#N/A",101564,,164,"BUTIMANU / Scoala Gimnaziala Butimanu",3,6399,"BUTIMANU",101564,1411,1125,926,199,0,1108,17,1550,425,704,404
16,"DÂMBOVIŢA","#N/A",101564,,165,"LUCIANCA / Scoala Gimnaziala Lucianca",3,6399,"BUTIMANU",101564,390,373,269,104,0,368,5,430,57,246,122
16,"DÂMBOVIŢA","#N/A",101840,,166,"CIOCĂNEŞTI / SCOALA CU CLASELE I-VIII CIOCANESTI",3,6410,"CIOCĂNEŞTI",101840,757,539,467,72,0,531,8,840,301,310,221
16,"DÂMBOVIŢA","#N/A",101840,,167,"CIOCĂNEŞTI / SCOALA CU CLASELE I - VIII CIOCANESTI",3,6410,"CIOCĂNEŞTI",101840,925,703,601,102,0,699,4,1050,347,422,277
16,"DÂMBOVIŢA","#N/A",101840,,168,"DECINDEA / GRADINITA DE COPII",3,6410,"CIOCĂNEŞTI",101840,409,354,308,46,0,343,11,410,56,207,136
16,"DÂMBOVIŢA","#N/A",101840,,169,"URZICEANCA / SCOALA CU CLASELE I-VIII URZICEANCA",3,6410,"CIOCĂNEŞTI",101840,1166,1052,857,195,0,1042,10,1280,228,830,212
16,"DÂMBOVIŢA","#N/A",101840,,170,"VIZUREŞTI / SCOALA CU CLASELE I-VIII ""SMARANDA ROMAN"" VIZURESTI",3,6410,"CIOCĂNEŞTI",101840,788,583,497,86,0,573,10,860,277,427,146
16,"DÂMBOVIŢA","#N/A",66526,,171,"CÎNDEŞTI-VALE / CAMIN CULTURAL CANDESTI VALE",3,6404,"CÎNDEŞTI",66526,986,797,694,93,10,792,5,1090,293,390,402
16,"DÂMBOVIŢA","#N/A",66526,,172,"DRAGODĂNEŞTI / SCOALA CU CLASELE I-IV DRAGODANESTI",3,6404,"CÎNDEŞTI",66526,672,513,466,45,2,506,7,760,247,338,168
16,"DÂMBOVIŢA","#N/A",66526,,173,"CÎNDEŞTI DEAL / SCOALA CU CLASELE I-IV CANDESTI DEAL",3,6404,"CÎNDEŞTI",66526,183,152,125,27,0,151,1,200,48,94,57
16,"DÂMBOVIŢA","#N/A",66526,,174,"VALEA MARE / SCOALA CU CLASELE I-IV VALEA MARE",3,6404,"CÎNDEŞTI",66526,119,114,92,22,0,112,2,130,16,74,38
16,"DÂMBOVIŢA","#N/A",66526,,175,"DRAGODĂNEŞTI / SCOALA CU CLASELE I-IV STURZENI",3,6404,"CÎNDEŞTI",66526,421,311,269,30,12,310,1,440,129,212,98
16,"DÂMBOVIŢA","#N/A",66580,,176,"MĂNĂSTIREA / SCOALA MANASTIREA",3,6416,"COBIA",66580,411,318,286,19,13,314,4,450,132,230,84
16,"DÂMBOVIŢA","#N/A",66580,,177,"GHERGHIŢEŞTI / GRADINITA GHERGHITESTI",3,6416,"COBIA",66580,938,714,612,77,25,701,13,1030,316,532,169
16,"DÂMBOVIŢA","#N/A",66580,,178,"MISLEA / GRADINITA MISLEA",3,6416,"COBIA",66580,681,511,452,49,10,506,5,750,239,342,164
16,"DÂMBOVIŢA","#N/A",66580,,179,"FRASIN DEAL / SCOALA FRASIN DEAL",3,6416,"COBIA",66580,585,422,379,32,11,417,5,640,218,302,115
16,"DÂMBOVIŢA","#N/A",66697,,180,"COJASCA / Şcoala Gimnazială Cojasca",3,6427,"COJASCA",66697,929,700,595,105,0,688,12,1020,320,444,244
16,"DÂMBOVIŢA","#N/A",66697,,181,"COJASCA / Şcoala Gimnazială Cojasca",3,6427,"COJASCA",66697,599,461,357,104,0,454,7,660,199,309,145
16,"DÂMBOVIŢA","#N/A",66697,,182,"IAZU / ŞCOALA PRIMARA IAZU",3,6427,"COJASCA",66697,1291,778,748,30,0,755,23,1420,642,439,316
16,"DÂMBOVIŢA","#N/A",66697,,183,"IAZU / ŞCOALA PRIMARA IAZU",3,6427,"COJASCA",66697,671,415,403,12,0,394,21,740,325,263,131
16,"DÂMBOVIŢA","#N/A",66697,,184,"FÎNTÎNELE / ŞCOALA GIMNAZIALĂ FÂNTNELE",3,6427,"COJASCA",66697,876,467,361,106,0,460,7,970,503,404,56
16,"DÂMBOVIŢA","#N/A",66697,,185,"FÎNTÎNELE / ŞCOALA GIMNAZIALĂ FÂNTNELE",3,6427,"COJASCA",66697,770,385,328,57,0,383,2,840,455,352,31
16,"DÂMBOVIŢA","#N/A",66731,,186,"LAZURI / Caminul Cultural",3,6431,"COMIŞANI",66731,1550,1076,964,112,0,1058,18,1710,634,644,414
16,"DÂMBOVIŢA","#N/A",66731,,187,"COMIŞANI / Caminul Cultural Comisani(str.suseni,nr.219)",3,6431,"COMIŞANI",66731,1591,1002,920,82,0,988,14,1750,748,663,325
16,"DÂMBOVIŢA","#N/A",66731,,188,"COMIŞANI / Scoala Generala I-Iv Comisani(str.Helesteului nr.2)",3,6431,"COMIŞANI",66731,1237,767,724,43,0,759,8,1360,593,477,282
16,"DÂMBOVIŢA","#N/A",66768,,189,"CONŢEŞTI / Sc.cls. I-IV Contesti",3,6434,"CONŢEŞTI",66768,743,529,404,125,0,526,3,820,291,350,176
16,"DÂMBOVIŢA","#N/A",66768,,190,"CONŢEŞTI / Sala festivitati Contesti",3,6434,"CONŢEŞTI",66768,437,321,224,97,0,314,7,480,159,178,136
16,"DÂMBOVIŢA","#N/A",66768,,191,"BOTENI / Sc.cls I-IV Boteni",3,6434,"CONŢEŞTI",66768,687,478,407,62,9,472,6,760,282,337,135
16,"DÂMBOVIŢA","#N/A",66768,,192,"BĂLTENI / Centru zi pt copiii romi",3,6434,"CONŢEŞTI",66768,614,438,418,20,0,428,10,680,242,291,137
16,"DÂMBOVIŢA","#N/A",66768,,193,"BĂLTENI / Gradinita Balteni",3,6434,"CONŢEŞTI",66768,817,579,479,100,0,576,3,900,321,398,178
16,"DÂMBOVIŢA","#N/A",66857,,194,"CORBII MARI / ŞCOALA CORBII MARI",3,6443,"CORBII MARI",66857,1374,955,795,160,0,933,22,1510,555,613,320
16,"DÂMBOVIŢA","#N/A",66857,,195,"VADU STANCHII / ŞCOALA VADU STANCHII",3,6443,"CORBII MARI",66857,372,256,207,49,0,255,1,410,154,190,65
16,"DÂMBOVIŢA","#N/A",66857,,196,"PETREŞTI / ŞCOALA PETREŞTI",3,6443,"CORBII MARI",66857,1013,742,614,128,0,738,4,1130,388,488,250
16,"DÂMBOVIŢA","#N/A",66857,,197,"GROZĂVEŞTI / SCOALA GROZAVESTI I",3,6443,"CORBII MARI",66857,568,314,259,55,0,311,3,630,316,206,105
16,"DÂMBOVIŢA","#N/A",66857,,198,"GROZĂVEŞTI / ŞCOALA GROZAVESTI",3,6443,"CORBII MARI",66857,884,636,501,135,0,631,5,970,334,492,139
16,"DÂMBOVIŢA","#N/A",66857,,199,"UNGURENI / ŞCOALA UNGURENI NR. 1",3,6443,"CORBII MARI",66857,862,600,544,56,0,591,9,950,350,355,236
16,"DÂMBOVIŢA","#N/A",66857,,200,"UNGURENI / ŞCOALA UNGURENI NR. 2",3,6443,"CORBII MARI",66857,617,500,419,81,0,500,0,680,180,246,254
16,"DÂMBOVIŢA","#N/A",66857,,201,"SATU NOU / ŞCOALA SATU NOU",3,6443,"CORBII MARI",66857,414,307,275,32,0,304,3,460,153,157,147
16,"DÂMBOVIŢA","#N/A",66955,,202,"CORNĂŢELU / ŞCOALA CU CLASELE I - VIII CORNĂŢELU",3,6453,"CORNĂŢELU",66955,324,368,229,127,12,363,5,410,42,268,95
16,"DÂMBOVIŢA","#N/A",66955,,203,"BOLOVANI / ŞCOALA CU CLASELE I - IV BOLOVANI",3,6453,"CORNĂŢELU",66955,548,587,386,178,23,577,10,600,13,386,191
16,"DÂMBOVIŢA","#N/A",66955,,204,"ALUNIŞU / ŞCOALA CU CLASELE I - IV ALUNIŞU",3,6453,"CORNĂŢELU",66955,258,241,190,51,0,241,0,280,39,195,46
16,"DÂMBOVIŢA","#N/A",67014,,205,"BUJOREANCA / SCOALA BUJOREANCA",3,6459,"CORNEŞTI",67014,375,327,231,96,0,322,5,410,83,206,116
16,"DÂMBOVIŢA","#N/A",67014,,206,"CĂTUNU / CAMIN CULTURAL CATUNU",3,6459,"CORNEŞTI",67014,685,611,442,169,0,603,8,750,139,335,268
16,"DÂMBOVIŢA","#N/A",67014,,207,"CORNEŞTI / SCOALA CORNESTI",3,6459,"CORNEŞTI",67014,1387,997,819,178,0,984,13,1530,533,500,484
16,"DÂMBOVIŢA","#N/A",67014,,208,"CRIVĂŢU / SCOALA CRIVAT",3,6459,"CORNEŞTI",67014,229,218,161,54,3,218,0,250,32,164,54
16,"DÂMBOVIŢA","#N/A",67014,,209,"FRASINU / SCOALA FRASINU",3,6459,"CORNEŞTI",67014,501,358,295,63,0,355,3,550,192,172,183
16,"DÂMBOVIŢA","#N/A",67014,,210,"IBRIANU / SCOALA IBRIANU",3,6459,"CORNEŞTI",67014,662,510,446,64,0,508,2,730,220,314,194
16,"DÂMBOVIŢA","#N/A",67014,,211,"POSTÎRNACU / SCOALA POSTARNACU",3,6459,"CORNEŞTI",67014,729,482,407,75,0,473,9,800,318,220,253
16,"DÂMBOVIŢA","#N/A",67014,,212,"UNGURENI / SCOALA UNGURENI",3,6459,"CORNEŞTI",67014,716,471,434,37,0,470,1,790,319,244,226
16,"DÂMBOVIŢA","#N/A",67121,,213,"COSTEŞTII DIN VALE / Gradinita de copii",3,6470,"COSTEŞTII DIN VALE",67121,439,314,288,22,4,310,4,480,166,243,67
16,"DÂMBOVIŢA","#N/A",67121,,214,"COSTEŞTII DIN VALE / Scoala cu cls. I - VIII",3,6470,"COSTEŞTII DIN VALE",67121,1247,732,687,42,3,716,16,1380,648,527,189
16,"DÂMBOVIŢA","#N/A",67121,,215,"TOMŞANI / Scoala cu cls. I - VIII",3,6470,"COSTEŞTII DIN VALE",67121,1058,738,647,86,5,728,10,1170,432,564,164
16,"DÂMBOVIŢA","#N/A",102286,,216,"CREVEDIA / Scoala Gimnaziala Crevedia",3,6474,"CREVEDIA",102286,1271,968,748,220,0,957,11,1400,432,544,413
16,"DÂMBOVIŢA","#N/A",102286,,217,"CREVEDIA / Camin cultural",3,6474,"CREVEDIA",102286,625,632,391,241,0,619,13,680,48,334,285
16,"DÂMBOVIŢA","#N/A",102286,,218,"DÎRZA / Scoala Gimnaziala Darza",3,6474,"CREVEDIA",102286,1388,1174,878,296,0,1160,14,1530,356,505,655
16,"DÂMBOVIŢA","#N/A",102286,,219,"SAMURCAŞI / Gradinita cu program normal",3,6474,"CREVEDIA",102286,1108,1063,674,389,0,1055,8,1220,157,479,576
16,"DÂMBOVIŢA","#N/A",102286,,220,"COCANI / Scoala cu clasele I-IV",3,6474,"CREVEDIA",102286,350,295,178,117,0,288,7,390,95,169,119
16,"DÂMBOVIŢA","#N/A",67167,,221,"BĂDULEŞTI / Scoala Generala Badulesti",3,6480,"CRÎNGURILE",67167,1139,807,709,98,0,800,7,1260,453,519,281
16,"DÂMBOVIŢA","#N/A",67167,,222,"PĂTROAIA VALE / Scoala Generala Patroaia Vale",3,6480,"CRÎNGURILE",67167,913,658,527,131,0,646,12,1010,352,509,137
16,"DÂMBOVIŢA","#N/A",67167,,223,"VOIA / Scoala Primara Voia",3,6480,"CRÎNGURILE",67167,483,262,229,33,0,259,3,530,268,191,68
16,"DÂMBOVIŢA","#N/A",67256,,224,"DĂRMĂNEŞTI / SCOALA DARMANESTI",3,6489,"DĂRMĂNEŞTI",67256,1434,885,825,60,0,870,15,1580,695,382,488
16,"DÂMBOVIŢA","#N/A",67256,,225,"DĂRMĂNEŞTI / Cămin Cultural  -                                 Club",3,6489,"DĂRMĂNEŞTI",67256,1647,1075,996,79,0,1060,15,1800,725,511,549
16,"DÂMBOVIŢA","#N/A",67256,,226,"MĂRGINENII DE SUS / Şcoala Mărginenii de Sus",3,6489,"DĂRMĂNEŞTI",67256,908,585,525,60,0,572,13,1000,415,343,229
16,"DÂMBOVIŢA","#N/A",67292,,227,"DOBRA / Scoala Preot Panait Georgescu",3,6492,"DOBRA",67292,1483,982,895,87,0,973,9,1630,648,619,354
16,"DÂMBOVIŢA","#N/A",67292,,228,"MĂRCEŞTI / Scoala inv Iulian Rusu",3,6492,"DOBRA",67292,1563,1049,967,82,0,1036,13,1720,671,670,366
16,"DÂMBOVIŢA","#N/A",65413,,229,"DOICEŞTI / SCOALA GIMNAZIALA NR.3",3,6495,"DOICEŞTI",65413,1542,841,811,30,0,834,7,1690,849,477,357
16,"DÂMBOVIŢA","#N/A",65413,,230,"DOICEŞTI / SCOALA GIMNAZIALA NR.1",3,6495,"DOICEŞTI",65413,1525,923,879,44,0,916,7,1670,747,559,357
16,"DÂMBOVIŢA","#N/A",65413,,231,"DOICEŞTI / GRADINITA CU PROGRAM NORMAL NR. 3",3,6495,"DOICEŞTI",65413,880,512,490,22,0,506,6,970,458,329,177
16,"DÂMBOVIŢA","#N/A",67327,,232,"DRAGODANA / SCOALA DRAGODANA",3,6497,"DRAGODANA",67327,1335,773,716,57,0,766,7,1460,687,456,310
16,"DÂMBOVIŢA","#N/A",67327,,233,"CUPARU / SCOALA BURDUCA",3,6497,"DRAGODANA",67327,1030,650,591,59,0,648,2,1130,480,378,270
16,"DÂMBOVIŢA","#N/A",67327,,234,"PICIOR DE MUNTE / SCOALA NR.1 PICIOR DE MUNTE - PAUNEI",3,6497,"DRAGODANA",67327,1367,803,774,29,0,796,7,1510,707,443,353
16,"DÂMBOVIŢA","#N/A",67327,,235,"PICIOR DE MUNTE / SCOALA NR.2 PICIOR DE MUNTE - BOBOCI",3,6497,"DRAGODANA",67327,1083,640,617,23,0,628,12,1190,550,377,251
16,"DÂMBOVIŢA","#N/A",67327,,236,"BOBOCI / SCOALA NR.2 PICIOR DE MUNTE - BOBOCI",3,6497,"DRAGODANA",67327,728,452,413,39,0,446,6,800,348,241,205
16,"DÂMBOVIŢA","#N/A",67407,,237,"DRAGOMIREŞTI / SCOALA CU CLASELE I-VIII DRAGOMIRESTI",3,6505,"DRAGOMIREŞTI",67407,1686,1067,1002,65,0,1044,23,1850,783,579,465
16,"DÂMBOVIŢA","#N/A",67407,,238,"DECINDENI / SCOALA CU CLASELE I-VII DECINDENI",3,6505,"DRAGOMIREŞTI",67407,954,657,618,39,0,646,11,1050,393,385,261
16,"DÂMBOVIŢA","#N/A",67407,,239,"DECINDENI / SCOALA CU CLASELE I-VIII DECINDENI",3,6505,"DRAGOMIREŞTI",67407,998,712,678,34,0,706,6,1100,388,436,270
16,"DÂMBOVIŢA","#N/A",67407,,240,"RÎNCĂCIOV / SCOALA CU CLASELE I-VIII RANCACIOV",3,6505,"DRAGOMIREŞTI",67407,932,583,533,50,0,575,8,1020,437,306,269
16,"DÂMBOVIŢA","#N/A",67407,,241,"RÎNCĂCIOV / SCOALA CU CLASELE I-VIII RANCACIOV",3,6505,"DRAGOMIREŞTI",67407,649,380,363,17,0,374,6,710,330,189,185
16,"DÂMBOVIŢA","#N/A",67407,,242,"UNGURENI / ŞCOALA CU CLASELE I-VIII UNGURENI",3,6505,"DRAGOMIREŞTI",67407,1042,588,550,38,0,580,8,1150,562,301,279
16,"DÂMBOVIŢA","#N/A",67407,,243,"MOGOŞEŞTI / SCOALA  MOGOSESTI",3,6505,"DRAGOMIREŞTI",67407,480,355,317,38,0,353,2,530,175,267,86
16,"DÂMBOVIŢA","#N/A",67407,,244,"GEANGOEŞTI / GRADINITA GEANGOESTI",3,6505,"DRAGOMIREŞTI",67407,265,185,159,26,0,182,3,291,106,89,93
16,"DÂMBOVIŢA","#N/A",67470,,245,"FINTA MARE / Scoala Finta Mare",3,6512,"FINTA",67470,1063,709,663,46,0,701,8,1170,461,319,382
16,"DÂMBOVIŢA","#N/A",67470,,246,"BECHINEŞTI / Scoala Bechinesti",3,6512,"FINTA",67470,655,432,378,54,0,428,4,720,288,224,204
16,"DÂMBOVIŢA","#N/A",67470,,247,"GHEBOAIA / Scoala Gheboaia",3,6512,"FINTA",67470,957,660,626,34,0,656,4,1050,390,311,345
16,"DÂMBOVIŢA","#N/A",67470,,248,"GHEBOAIA / Scoala Gheboaia",3,6512,"FINTA",67470,804,507,471,36,0,496,11,880,373,229,267
16,"DÂMBOVIŢA","#N/A",67522,,249,"GUŞOIU / SCOALA BUICA IONESCU",3,6517,"GLODENI",67522,1755,1005,961,44,0,994,11,1930,925,551,443
16,"DÂMBOVIŢA","#N/A",67522,,250,"SCHELA / Scoala Buica Ionescu",3,6517,"GLODENI",67522,1126,677,646,30,1,668,9,1240,563,365,303
16,"DÂMBOVIŢA","#N/A",67522,,251,"LĂCULEŢE / GRADINITA LACULETE",3,6517,"GLODENI",67522,693,490,445,45,0,482,8,760,270,259,223
16,"DÂMBOVIŢA","#N/A",65707,,252,"GURA FOII / Scoala Gura Foii",3,6524,"GURA FOII",65707,1240,916,831,85,0,903,13,1370,454,633,270
16,"DÂMBOVIŢA","#N/A",65707,,253,"GURA FOII / Gradinita Bumbuia",3,6524,"GURA FOII",65707,359,290,266,24,0,284,6,400,110,200,84
16,"DÂMBOVIŢA","#N/A",65707,,254,"GURA FOII / Sala de festivitati  Fagetu",3,6524,"GURA FOII",65707,289,257,221,36,0,253,4,320,63,169,84
16,"DÂMBOVIŢA","#N/A",67595,,255,"GURA OCNIŢEI / SCOALA CL. I-VIII GURA OCNITEI",3,6529,"GURA OCNIŢEI",67595,1400,809,735,74,0,795,14,1540,731,487,308
16,"DÂMBOVIŢA","#N/A",67595,,256,"GURA OCNIŢEI / SCOALA CL. I-VIII GURA OCNITEI",3,6529,"GURA OCNIŢEI",67595,1573,1006,897,108,1,981,25,1740,734,538,443
16,"DÂMBOVIŢA","#N/A",67595,,257,"ADÎNCA / SCOALA CL. I-VIII ADANCA",3,6529,"GURA OCNIŢEI",67595,1600,1012,948,64,0,997,15,1750,738,632,365
16,"DÂMBOVIŢA","#N/A",67595,,258,"SĂCUENI / SCOALA CL. I-VIII SACUENI",3,6529,"GURA OCNIŢEI",67595,1550,1022,915,107,0,1007,15,1699,677,615,392
16,"DÂMBOVIŢA","#N/A",67648,,259,"GURA ŞUŢII / Scoala Gimnaziala Gura Sutii",3,6534,"GURA ŞUŢII",67648,889,580,534,46,0,576,4,980,400,374,202
16,"DÂMBOVIŢA","#N/A",67648,,260,"GURA ŞUŢII / Scoala Gimnaziala Gura Sutii",3,6534,"GURA ŞUŢII",67648,874,605,544,61,0,601,4,980,375,449,152
16,"DÂMBOVIŢA","#N/A",67648,,261,"GURA ŞUŢII / Gradinita Nr.2 Gura Sutii",3,6534,"GURA ŞUŢII",67648,997,687,660,25,2,677,10,1090,403,507,170
16,"DÂMBOVIŢA","#N/A",67648,,262,"SPERIEŢENI / Scoala Gimnaziala Sperieteni",3,6534,"GURA ŞUŢII",67648,1513,844,809,34,1,843,1,1660,816,577,266
16,"DÂMBOVIŢA","#N/A",67675,,263,"HULUBEŞTI / GRADINITA HULUBESTI",3,6537,"HULUBEŞTI",67675,723,517,455,62,0,508,9,800,283,296,212
16,"DÂMBOVIŢA","#N/A",67675,,264,"MĂGURA / GRADINITA MAGURA",3,6537,"HULUBEŞTI",67675,529,444,385,59,0,431,13,590,146,324,107
16,"DÂMBOVIŢA","#N/A",67675,,265,"BUTOIU DE JOS / SCOALA BUTOIU DE JOS",3,6537,"HULUBEŞTI",67675,778,447,414,33,0,440,7,860,413,322,118
16,"DÂMBOVIŢA","#N/A",67675,,266,"BUTOIU DE SUS / GRADINITA BUTOIU DE SUS",3,6537,"HULUBEŞTI",67675,640,454,422,32,0,446,8,700,246,299,147
16,"DÂMBOVIŢA","#N/A",67737,,267,"GHIRDOVENI / ŞCOALA 1 GHIRDOVENI",3,6543,"I. L. CARAGIALE",67737,1503,1005,920,85,0,988,17,1650,645,608,380
16,"DÂMBOVIŢA","#N/A",67737,,268,"GHIRDOVENI / ŞCOALA 2 GHIRDOVENI",3,6543,"I. L. CARAGIALE",67737,1299,876,821,55,0,865,11,1440,564,567,298
16,"DÂMBOVIŢA","#N/A",67737,,269,"I. L. CARAGIALE / CLUB PENITENCIAR I.L.CARAGIALE",3,6543,"I. L. CARAGIALE",67737,746,1096,458,53,585,1082,14,1220,124,919,163
16,"DÂMBOVIŢA","#N/A",67737,,270,"I. L. CARAGIALE / CĂMINUL CULTURAL I.L.CARAGIALE",3,6543,"I. L. CARAGIALE",67737,1329,932,878,54,0,915,17,1460,528,721,194
16,"DÂMBOVIŢA","#N/A",67737,,271,"MIJA / SCOALA PRIMARA MIJA",3,6543,"I. L. CARAGIALE",67737,660,382,353,29,0,377,5,730,348,280,97
16,"DÂMBOVIŢA","#N/A",65869,,272,"IEDERA DE JOS / SCOALA GIMNAZIALA IEDERA DE JOS",3,6547,"IEDERA",65869,1237,778,722,55,1,767,11,1360,582,389,378
16,"DÂMBOVIŢA","#N/A",65869,,273,"COLIBAŞI / GRADINITA CU PROGRAM NORMAL COLIBASI",3,6547,"IEDERA",65869,456,300,271,29,0,299,1,500,200,190,109
16,"DÂMBOVIŢA","#N/A",65869,,274,"CRICOVU DULCE / GRADINITA CU PROGRAM NORMAL CRICOVU DULCE",3,6547,"IEDERA",65869,342,239,214,23,2,235,4,380,141,149,86
16,"DÂMBOVIŢA","#N/A",65869,,275,"IEDERA DE SUS / SCOALA CU CLASELE I-IV IEDERA DE SUS",3,6547,"IEDERA",65869,1110,738,702,32,4,725,13,1220,482,468,257
16,"DÂMBOVIŢA","#N/A",67773,,276,"LUCIENI / ŞCOALA LUCIENI",3,6552,"LUCIENI",67773,960,602,575,27,0,598,4,1050,448,332,266
16,"DÂMBOVIŢA","#N/A",67773,,277,"LUCIENI / ŞCOALA LUCIENI",3,6552,"LUCIENI",67773,1078,657,624,33,0,648,9,1190,533,383,265
16,"DÂMBOVIŢA","#N/A",67773,,278,"OLTENI / ŞCOALA OLTENI",3,6552,"LUCIENI",67773,439,322,280,42,0,321,1,480,158,173,148
16,"DÂMBOVIŢA","#N/A",67835,,279,"TELEŞTI / ŞCOALA GIMNAZIALĂ TELEŞTI",3,6555,"LUDEŞTI",67835,1390,918,817,101,0,914,4,1530,612,669,245
16,"DÂMBOVIŢA","#N/A",67835,,280,"POTOCELU / ŞCOALA PRIMARĂ POTOCELU",3,6555,"LUDEŞTI",67835,837,557,537,20,0,552,5,920,363,400,152
16,"DÂMBOVIŢA","#N/A",67835,,281,"SCHEIU DE JOS / ŞCOALA GIMNAZIALA SCHEIU DE JOS",3,6555,"LUDEŞTI",67835,867,588,534,54,0,582,6,970,382,314,268
16,"DÂMBOVIŢA","#N/A",67835,,282,"SCHEIU DE SUS / ŞCOALA PRIMARĂ SCHEIU DE SUS",3,6555,"LUDEŞTI",67835,797,472,438,34,0,463,9,870,398,294,169
16,"DÂMBOVIŢA","#N/A",67906,,283,"LUNGULEŢU / Scoala Gimnaziala nr. 2 Lunguletu",3,6562,"LUNGULEŢU",67906,789,476,437,39,0,472,4,860,384,308,164
16,"DÂMBOVIŢA","#N/A",67906,,284,"LUNGULEŢU / Scoala Gimnaziala nr.2 Lunguletu",3,6562,"LUNGULEŢU",67906,1144,713,636,77,0,703,10,1260,547,420,283
16,"DÂMBOVIŢA","#N/A",67906,,285,"LUNGULEŢU / Scoala nr. 1 Lunguletu",3,6562,"LUNGULEŢU",67906,1432,878,826,52,0,873,5,1600,722,637,236
16,"DÂMBOVIŢA","#N/A",67906,,286,"SERDANU / Scoala generala Serdanu",3,6562,"LUNGULEŢU",67906,1049,685,607,78,0,675,10,1140,455,506,169
16,"DÂMBOVIŢA","#N/A",67942,,287,"MALU CU FLORI / SCOALA GENERALA CU CLASELE 1-VIII MALU CU FRLORI",3,6566,"MALU CU FLORI",67942,1212,988,838,138,12,975,13,1350,362,653,322
16,"DÂMBOVIŢA","#N/A",67942,,288,"MALU CU FLORI / SCOALA GENERALA CU CLASELE I-VIII MICLOSANII MICI",3,6566,"MALU CU FLORI",67942,791,586,524,49,13,580,6,850,264,402,178
16,"DÂMBOVIŢA","#N/A",68002,,289,"MĂNEŞTI / SCOALA GIMNAZIALA MANESTI",3,6572,"MĂNEŞTI",68002,1074,725,680,45,0,716,9,1180,455,455,261
16,"DÂMBOVIŢA","#N/A",68002,,290,"DRĂGĂEŞTI UNGURENI / SCOALA GIMNAZIALA DRAGAESTI-UNGURENI",3,6572,"MĂNEŞTI",68002,1037,703,649,54,0,695,8,1150,447,410,285
16,"DÂMBOVIŢA","#N/A",68002,,291,"DRĂGĂEŞTI PĂMÎNTENI / SCOALA GIMNAZIALA DRAGAESTI-PAMANTENI",3,6572,"MĂNEŞTI",68002,1708,1150,1103,47,0,1130,20,1870,720,736,394
16,"DÂMBOVIŢA","#N/A",68048,,292,"MĂTĂSARU / SC. GEN. MATASARU",3,6576,"MĂTĂSARU",68048,934,563,508,55,0,561,2,1030,467,423,138
16,"DÂMBOVIŢA","#N/A",68048,,293,"ODAIA TURCULUI / SC. PRIM. OAIA-TURCULUI",3,6576,"MĂTĂSARU",68048,904,644,585,59,0,633,11,990,346,455,178
16,"DÂMBOVIŢA","#N/A",68048,,294,"TEŢCOIU / GRADINITA TETCOIU",3,6576,"MĂTĂSARU",68048,1086,662,597,65,0,651,11,1190,528,458,193
16,"DÂMBOVIŢA","#N/A",68048,,295,"POROINICA / SC. GEN. POROINICA",3,6576,"MĂTĂSARU",68048,672,406,367,39,0,401,5,750,344,269,132
16,"DÂMBOVIŢA","#N/A",68048,,296,"PUŢU CU SALCIE / SC. PRIM. PUTU CU SALCIE",3,6576,"MĂTĂSARU",68048,767,449,405,44,0,441,8,850,401,316,125
16,"DÂMBOVIŢA","#N/A",68128,,297,"MOGOŞANI / SC. GEN. MOGOSANI",3,6584,"MOGOŞANI",68128,1404,937,858,79,0,924,13,1550,613,454,470
16,"DÂMBOVIŢA","#N/A",68128,,298,"COJOCARU / SCOALA COJOCARU",3,6584,"MOGOŞANI",68128,648,450,410,40,0,445,5,710,260,311,134
16,"DÂMBOVIŢA","#N/A",68128,,299,"MERII / SCOALA MERI",3,6584,"MOGOŞANI",68128,809,582,539,43,0,578,4,890,308,296,282
16,"DÂMBOVIŢA","#N/A",68128,,300,"ZĂVOIU / SCOALA ZAVOIU",3,6584,"MOGOŞANI",68128,722,565,499,66,0,558,7,800,235,259,299
16,"DÂMBOVIŢA","#N/A",68182,,301,"LUNCA / Scoala veche-Gradinita",3,6590,"MOROENI",68182,1020,695,643,50,2,681,14,1120,425,311,370
16,"DÂMBOVIŢA","#N/A",68182,,302,"MOROENI / Scoala ""Ion Cioranescu""",3,6590,"MOROENI",68182,1287,816,755,53,8,801,15,1420,604,425,376
16,"DÂMBOVIŢA","#N/A",68182,,303,"PUCHENI / Panait Petre",3,6590,"MOROENI",68182,494,342,300,42,0,340,2,530,188,161,179
16,"DÂMBOVIŢA","#N/A",68182,,304,"GLOD / Scoala Glod",3,6590,"MOROENI",68182,1317,966,892,39,35,948,18,1450,484,648,300
16,"DÂMBOVIŢA","#N/A",68182,,305,"MUŞCEL / Scoala Muscel",3,6590,"MOROENI",68182,63,49,40,9,0,49,0,70,21,28,21
16,"DÂMBOVIŢA","#N/A",68253,,306,"MORTENI / GRADINITA MORTENI CENTRU",3,6597,"MORTENI",68253,1213,899,819,80,0,882,17,1330,431,624,258
16,"DÂMBOVIŢA","#N/A",68253,,307,"NEAJLOVU / GRADINITA MORTENI CENTRU",3,6597,"MORTENI",68253,1160,866,791,75,0,856,10,1280,414,582,274
16,"DÂMBOVIŢA","#N/A",65645,,308,"MOŢĂIENI / CAMIN CULTURAL MOTAIENI",3,6600,"MOŢĂIENI",65645,1432,948,864,76,8,931,17,1579,631,437,494
16,"DÂMBOVIŢA","#N/A",65645,,309,"CUCUTENI / SCOALA CUCUTENI",3,6600,"MOŢĂIENI",65645,392,293,258,33,2,289,4,420,127,106,183
16,"DÂMBOVIŢA","#N/A",104387,,310,"NICULEŞTI / SCOALA CU CLASELE I - VIII NICULESTI",3,6603,"NICULEŞTI",104387,1017,753,658,95,0,741,12,1120,367,565,176
16,"DÂMBOVIŢA","#N/A",104387,,311,"NICULEŞTI / SCOALA CU CLASELE I - VIII NICULESTI",3,6603,"NICULEŞTI",104387,848,643,564,79,0,635,8,940,297,501,134
16,"DÂMBOVIŢA","#N/A",104387,,312,"MOVILA / SCOALA CU CLASELE I-IV MOVILA",3,6603,"NICULEŞTI",104387,477,450,287,140,23,445,5,530,80,267,178
16,"DÂMBOVIŢA","#N/A",104387,,313,"CIOCĂNARI / SCOALA CU CLASELE I-VIII CIOCANARI",3,6603,"NICULEŞTI",104387,979,639,565,74,0,624,15,1080,441,357,267
16,"DÂMBOVIŢA","#N/A",68280,,314,"NUCET / SC.GENERALA NUCET",3,6607,"NUCET",68280,931,681,590,81,10,671,10,1020,339,493,178
16,"DÂMBOVIŢA","#N/A",68280,,315,"NUCET / SC.GENERALA NUCET",3,6607,"NUCET",68280,872,617,543,58,16,612,5,960,343,457,155
16,"DÂMBOVIŢA","#N/A",68280,,316,"CAZACI / SC.GENERALA CAZACI",3,6607,"NUCET",68280,1194,814,731,71,12,807,7,1320,506,551,256
16,"DÂMBOVIŢA","#N/A",68280,,317,"ILFOVENI / SC. PRIMARA ILFOVENI",3,6607,"NUCET",68280,437,311,281,18,12,309,2,480,169,180,129
16,"DÂMBOVIŢA","#N/A",68324,,318,"OCNIŢA / GRADINITA NR.1 OCNITA",3,6611,"OCNIŢA",68324,1172,727,663,46,18,714,13,1280,553,392,322
16,"DÂMBOVIŢA","#N/A",68324,,319,"OCNIŢA / SCOALA GENERALA OCNITA",3,6611,"OCNIŢA",68324,1387,853,814,35,4,840,13,1530,677,441,399
16,"DÂMBOVIŢA","#N/A",68324,,320,"OCNIŢA / SCOALA FUNDUL OCNII",3,6611,"OCNIŢA",68324,1023,572,543,21,8,568,4,1130,558,326,242
16,"DÂMBOVIŢA","#N/A",68342,,321,"ODOBEŞTI / SCOALA GIMNAZIALA ODOBESTI",3,6613,"ODOBEŞTI",68342,1253,874,784,90,0,854,20,1440,566,526,328
16,"DÂMBOVIŢA","#N/A",68342,,322,"BRÎNCOVEANU / SCOALA PRIMARA BRANCOVEANU",3,6613,"ODOBEŞTI",68342,539,418,377,41,0,413,5,560,142,300,113
16,"DÂMBOVIŢA","#N/A",68342,,323,"MIULEŞTI / SCOALA PRIMARA MIULESTI",3,6613,"ODOBEŞTI",68342,405,259,226,33,0,257,2,420,161,215,42
16,"DÂMBOVIŢA","#N/A",68342,,324,"CROVU / GRADINITA CU PROGRAM NORMAL CROVU",3,6613,"ODOBEŞTI",68342,1042,747,697,50,0,737,10,1170,423,594,143
16,"DÂMBOVIŢA","#N/A",68342,,325,"ZIDURILE / SCOALA PRIMARA ZIDURILE",3,6613,"ODOBEŞTI",68342,640,490,421,69,0,486,4,680,190,334,152
16,"DÂMBOVIŢA","#N/A",179935,,326,"PERŞINARI / GRADINITA PERSINARI",3,6619,"PERŞINARI",179935,1177,729,624,75,30,719,10,1300,571,467,252
16,"DÂMBOVIŢA","#N/A",179935,,327,"PERŞINARI / GRADINITA PERSINARI",3,6619,"PERŞINARI",179935,1157,714,646,39,29,702,12,1270,556,433,269
16,"DÂMBOVIŢA","#N/A",65752,,328,"PUNTEA DE GRECI / CAMIN CULTURAL",3,6621,"PETREŞTI",65752,585,482,425,57,0,477,5,640,158,277,200
16,"DÂMBOVIŢA","#N/A",65752,,329,"PETREŞTI / SCOLA CU CLS. I VII PETREŞTI",3,6621,"PETREŞTI",65752,1208,792,721,71,0,784,8,1330,538,477,307
16,"DÂMBOVIŢA","#N/A",65752,,330,"GRECI / SCOALA CU CLS. I  IV GRECI",3,6621,"PETREŞTI",65752,1268,869,802,67,0,860,9,1400,531,520,340
16,"DÂMBOVIŢA","#N/A",65752,,331,"IONEŞTI / GRADINITA IONESTI",3,6621,"PETREŞTI",65752,1547,1080,1005,75,0,1064,16,1700,620,625,439
16,"DÂMBOVIŢA","#N/A",65752,,332,"POTLOGENI-DEAL / GRADINITA POTLOGENI DEAL",3,6621,"PETREŞTI",65752,139,126,107,19,0,126,0,150,24,72,54
16,"DÂMBOVIŢA","#N/A",179908,,333,"PIETRARI / CAMINUL CULTURAL PIETRARI",3,6629,"PIETRARI",179908,1491,1049,955,94,0,1035,14,1640,591,550,485
16,"DÂMBOVIŢA","#N/A",179908,,334,"VALEA / SCOALA VALEA                                                                      DC                DC138",3,6629,"PIETRARI",179908,497,392,342,50,0,389,3,550,158,260,129
16,"DÂMBOVIŢA","#N/A",68404,,335,"PIETROŞIŢA / SC.PIETROSITA,NR.327A",3,6635,"PIETROŞIŢA",68404,923,625,568,57,0,615,10,1010,385,349,266
16,"DÂMBOVIŢA","#N/A",68404,,336,"PIETROŞIŢA / SC.PIETROSITA,NR.327B",3,6635,"PIETROŞIŢA",68404,924,613,582,31,0,603,10,1020,407,321,282
16,"DÂMBOVIŢA","#N/A",68404,,337,"DEALU FRUMOS / SC.DEALU-FRUMOS, NR.78",3,6635,"PIETROŞIŢA",68404,863,589,504,85,0,582,7,960,371,310,272
16,"DÂMBOVIŢA","#N/A",68431,,338,"POIANA / Scoala nr.1 Poiana, sat Poiana",3,6638,"POIANA",68431,1375,934,895,39,0,916,18,1520,586,639,277
16,"DÂMBOVIŢA","#N/A",68431,,339,"POIANA / Scoala  Nr.1 Poiana",3,6638,"POIANA",68431,608,472,389,83,0,465,7,670,198,308,157
16,"DÂMBOVIŢA","#N/A",68431,,340,"POIANA / Scoala Nr.2 Poiana",3,6638,"POIANA",68431,919,673,597,76,0,661,12,1000,327,455,206
16,"DÂMBOVIŢA","#N/A",68468,,341,"POTLOGI / SCOALA POTLOGI",3,6641,"POTLOGI",68468,1281,925,810,115,0,912,13,1410,485,600,312
16,"DÂMBOVIŢA","#N/A",68468,,342,"POTLOGI / SCOALA POTLOGI",3,6641,"POTLOGI",68468,1179,762,688,74,0,751,11,1300,538,514,237
16,"DÂMBOVIŢA","#N/A",68468,,343,"PITARU / SCOALA PITARU",3,6641,"POTLOGI",68468,727,534,453,81,0,524,10,800,266,397,127
16,"DÂMBOVIŢA","#N/A",68468,,344,"VLĂSCENI / SCOALA VLASCENI",3,6641,"POTLOGI",68468,555,490,361,129,0,485,5,610,120,357,128
16,"DÂMBOVIŢA","#N/A",68468,,345,"ROMÂNEŞTI / SCOALA ROMANESTI",3,6641,"POTLOGI",68468,1459,664,602,62,0,650,14,1600,936,526,124
16,"DÂMBOVIŢA","#N/A",68468,,346,"ROMÂNEŞTI / SCOALA ROMANESTI",3,6641,"POTLOGI",68468,1289,579,534,45,0,572,7,1420,841,451,121
16,"DÂMBOVIŢA","#N/A",68529,,347,"PRODULEŞTI / PRIMĂRIA-CĂMIN CULTURAL",3,6647,"PRODULEŞTI",68529,1518,963,879,64,20,953,10,1670,707,581,372
16,"DÂMBOVIŢA","#N/A",68529,,348,"BROŞTENI / Şcoala primară BROŞTENI",3,6647,"PRODULEŞTI",68529,511,349,315,34,0,345,4,560,211,223,122
16,"DÂMBOVIŢA","#N/A",68529,,349,"COSTEŞTII DIN DEAL / Şcoala primară COSTEŞTII DIN DEAL",3,6647,"PRODULEŞTI",68529,740,546,471,75,0,540,6,820,274,414,126
16,"DÂMBOVIŢA","#N/A",68565,,350,"PUCHENI / CĂMIN CULTURAL",3,6651,"PUCHENI",68565,1378,991,919,57,15,979,12,1520,529,714,265
16,"DÂMBOVIŢA","#N/A",68565,,351,"VALEA LARGĂ / SCOALA VALEA LARGA",3,6651,"PUCHENI",68565,215,162,138,24,0,160,2,240,78,89,71
16,"DÂMBOVIŢA","#N/A",179891,,352,"RACIU / Şcoala Gimnazială Raciu",3,6657,"RACIU",179891,1233,817,745,58,14,804,13,1350,533,466,338
16,"DÂMBOVIŢA","#N/A",179891,,353,"ŞUŢA SEACĂ / Şcoala Gimnazială Şuţa Seacă - Raciu",3,6657,"RACIU",179891,729,520,483,34,3,511,9,800,280,316,195
16,"DÂMBOVIŢA","#N/A",179891,,354,"SILIŞTEA / Şcoala Primară Siliştea - Raciu",3,6657,"RACIU",179891,728,515,482,26,7,513,2,800,285,351,162
16,"DÂMBOVIŢA","#N/A",179926,,355,"RĂSCĂEŢI / Şcoala primară  Drăghineasca",3,6661,"RĂSCĂEŢI",179926,801,642,584,45,13,638,4,880,238,513,125
16,"DÂMBOVIŢA","#N/A",179926,,356,"RĂSCĂEŢI / Şcoala Gimnazială Răscăeţi",3,6661,"RĂSCĂEŢI",179926,1032,799,702,74,23,785,14,1140,341,567,218
16,"DÂMBOVIŢA","#N/A",65431,,357,"RĂZVAD / BIBLIOTECA",3,6667,"RĂZVAD",65431,1500,1042,966,76,0,1026,16,1640,598,572,454
16,"DÂMBOVIŢA","#N/A",65431,,358,"RĂZVAD / SCOALA RAZVAD DE JOS",3,6667,"RĂZVAD",65431,1100,769,702,67,0,761,8,1220,451,399,362
16,"DÂMBOVIŢA","#N/A",65431,,359,"RĂZVAD / CENTRUL DE EDUCARE COPII SARACI",3,6667,"RĂZVAD",65431,1141,770,686,84,0,757,13,1250,480,392,365
16,"DÂMBOVIŢA","#N/A",65431,,360,"VALEA VOIVOZILOR / SCOALA VALEA VOIEVOZILOR",3,6667,"RĂZVAD",65431,1248,890,798,92,0,874,16,1370,480,376,498
16,"DÂMBOVIŢA","#N/A",65431,,361,"VALEA VOIVOZILOR / SCOALA VALEA VOIEVOZILOR",3,6667,"RĂZVAD",65431,1300,904,802,101,1,884,20,1430,526,405,479
16,"DÂMBOVIŢA","#N/A",65431,,362,"GORGOTA / SCOALA GORGOTA",3,6667,"RĂZVAD",65431,1083,631,589,42,0,624,7,1200,569,341,283
16,"DÂMBOVIŢA","#N/A",179917,,363,"RÂU ALB DE JOS / cămin cultural",3,6664,"RÂU ALB",179917,1230,873,750,123,0,865,8,1350,477,555,310
16,"DÂMBOVIŢA","#N/A",68716,,364,"RUNCU / Gradinita Runcu",3,6671,"RUNCU",68716,1208,672,640,31,1,665,7,1330,658,330,335
16,"DÂMBOVIŢA","#N/A",68716,,365,"RUNCU / Scoala gimnaziala Runcu",3,6671,"RUNCU",68716,1092,636,582,51,3,628,8,1210,574,332,296
16,"DÂMBOVIŢA","#N/A",68716,,366,"BĂDENI / Gradinita Badeni",3,6671,"RUNCU",68716,842,502,446,53,3,497,5,930,428,325,172
16,"DÂMBOVIŢA","#N/A",68716,,367,"BREBU / Scoala Brebu",3,6671,"RUNCU",68716,546,354,340,14,0,352,2,600,246,223,129
16,"DÂMBOVIŢA","#N/A",68789,,368,"BĂNEŞTI / SCOALA GENERAL BANESTI",3,6678,"SĂLCIOARA",68789,362,247,198,49,0,243,4,400,153,140,103
16,"DÂMBOVIŢA","#N/A",68789,,369,"PODU RIZII / SCOALA GENERALA PODU-RIZII",3,6678,"SĂLCIOARA",68789,608,469,415,54,0,466,3,670,201,330,136
16,"DÂMBOVIŢA","#N/A",68789,,370,"MIRCEA VODĂ / SCOALA GENERALA MIRCEA-SALA 1",3,6678,"SĂLCIOARA",68789,933,617,543,74,0,612,5,1020,403,386,226
16,"DÂMBOVIŢA","#N/A",68789,,371,"GHINEŞTI / SCOALA GENERALA GHINESTI  SALA1",3,6678,"SĂLCIOARA",68789,1005,664,592,72,0,654,10,1100,436,444,210
16,"DÂMBOVIŢA","#N/A",68789,,372,"CUZA VODĂ / SCOALA GENERALA CUZA-VODA",3,6678,"SĂLCIOARA",68789,309,231,174,57,0,228,3,340,109,162,66
16,"DÂMBOVIŢA","#N/A",105142,,373,"SLOBOZIA MOARĂ / SCOALA GIMNAZIALA SLOBOZIA MOARA",3,6692,"SLOBOZIA MOARĂ",105142,875,650,562,88,0,639,11,970,320,464,175
16,"DÂMBOVIŢA","#N/A",105142,,374,"SLOBOZIA MOARĂ / SCOALA GIMNAZIALA SLOBOZIA MOARA",3,6692,"SLOBOZIA MOARĂ",105142,835,592,510,82,0,582,10,920,328,392,190
16,"DÂMBOVIŢA","#N/A",68887,,375,"ŞELARU / SCOALA GIMNAZIALA SELARU",3,6688,"ŞELARU",68887,766,535,404,131,0,531,4,850,315,362,169
16,"DÂMBOVIŢA","#N/A",68887,,376,"FIERBINŢI / SCOALA GIMNAZIALA",3,6688,"ŞELARU",68887,1268,901,781,120,0,895,6,1399,498,703,192
16,"DÂMBOVIŢA","#N/A",68887,,377,"GLOGOVEANU / GRADINITA CU PROGRAM NORMAL, GLOGOVEANU",3,6688,"ŞELARU",68887,595,430,352,78,0,419,11,650,220,293,126
16,"DÂMBOVIŢA","#N/A",65477,,378,"ŞOTÎNGA / GRADINITA NR. 2",3,6694,"ŞOTÎNGA",65477,1061,622,581,41,0,610,12,1160,538,475,135
16,"DÂMBOVIŢA","#N/A",65477,,379,"TEIŞ / CĂMIN CULTURAL TEIŞ",3,6694,"ŞOTÎNGA",65477,1277,795,753,42,0,790,5,1400,605,518,272
16,"DÂMBOVIŢA","#N/A",65477,,380,"TEIŞ / Scoala Teiul Doamnei",3,6694,"ŞOTÎNGA",65477,861,566,525,41,0,559,7,950,384,312,247
16,"DÂMBOVIŢA","#N/A",65477,,381,"ŞOTÎNGA / ŞCOALA PROF.ILIE POPESCU",3,6694,"ŞOTÎNGA",65477,1543,918,870,48,0,907,11,1690,770,617,290
16,"DÂMBOVIŢA","#N/A",65477,,382,"ŞOTÎNGA / CĂMIN CULTURAL ŞOTÂNGA",3,6694,"ŞOTÎNGA",65477,1180,722,678,44,0,717,5,1300,578,491,226
16,"DÂMBOVIŢA","#N/A",105534,,383,"TĂRTĂŞEŞTI / Scoala Generala cu clasele",3,6697,"TĂRTĂŞEŞTI",105534,830,713,532,181,0,695,18,910,197,386,309
16,"DÂMBOVIŢA","#N/A",105534,,384,"BÎLDANA / Scoala Generala cu clasele",3,6697,"TĂRTĂŞEŞTI",105534,1445,1026,840,186,0,1012,14,1590,564,514,498
16,"DÂMBOVIŢA","#N/A",105534,,385,"GULIA / Scoala Generala cu clasele",3,6697,"TĂRTĂŞEŞTI",105534,925,982,659,322,1,969,13,1020,38,632,337
16,"DÂMBOVIŢA","#N/A",105534,,386,"TĂRTĂŞEŞTI / Grup Scolar Tartasesti",3,6697,"TĂRTĂŞEŞTI",105534,875,798,567,231,0,789,9,960,162,418,371
16,"DÂMBOVIŢA","#N/A",68921,,387,"TĂTĂRANI / SALA DE FESTIVITATI A PRIMARIEI TATARANI",3,6701,"TĂTĂRANI",68921,910,701,601,68,32,695,6,1010,309,473,222
16,"DÂMBOVIŢA","#N/A",68921,,388,"GHEBOIENI / GRADINITA DE COPII GHEBOIENI",3,6701,"TĂTĂRANI",68921,1313,914,763,89,62,904,10,1440,526,506,398
16,"DÂMBOVIŢA","#N/A",68921,,389,"CĂPRIORU / CAMIN CULTURAL SAT CAPRIORU",3,6701,"TĂTĂRANI",68921,1370,963,853,55,55,946,17,1510,547,651,295
16,"DÂMBOVIŢA","#N/A",68921,,390,"PRIBOIU / GRADINITA PRIBOIU",3,6701,"TĂTĂRANI",68921,787,665,558,59,48,656,9,860,195,492,164
16,"DÂMBOVIŢA","#N/A",68976,,391,"ULIEŞTI / SCOALA ULIESTI",3,6706,"ULIEŞTI",68976,1110,825,718,99,8,810,15,1250,425,565,245
16,"DÂMBOVIŢA","#N/A",68976,,392,"CROITORI / GRADINITA CROITORI",3,6706,"ULIEŞTI",68976,700,502,425,77,0,497,5,770,268,306,191
16,"DÂMBOVIŢA","#N/A",68976,,393,"JUGURENI / SCOALA JUGURENI",3,6706,"ULIEŞTI",68976,1296,996,857,139,0,987,9,1390,394,681,306
16,"DÂMBOVIŢA","#N/A",68976,,394,"HANU LUI PALĂ / SCOALA HANU LUI PALA",3,6706,"ULIEŞTI",68976,260,205,166,39,0,204,1,290,85,153,51
16,"DÂMBOVIŢA","#N/A",65501,,395,"ULMI / SCOALA GIMNAZIALA ULMI",3,6715,"ULMI",65501,1072,667,591,76,0,658,9,1180,513,375,283
16,"DÂMBOVIŢA","#N/A",65501,,396,"DUMBRAVA / GRADINITA DUMBRAVA",3,6715,"ULMI",65501,905,567,521,46,0,559,8,990,423,283,276
16,"DÂMBOVIŢA","#N/A",65501,,397,"VIIŞOARA / SCOALA GIMNAZIALA VIISOARA",3,6715,"ULMI",65501,1088,715,665,50,0,703,12,1200,485,424,279
16,"DÂMBOVIŢA","#N/A",65501,,398,"MATRACA / GRADINITA MATRACA",3,6715,"ULMI",65501,525,369,335,34,0,362,7,580,211,220,142
16,"DÂMBOVIŢA","#N/A",69063,,399,"VALEA LUNGĂ-CRICOV / SCOALA GIMNAZIALA VALEA LUNGA CRICOV",3,6728,"VALEA LUNGĂ",69063,1036,679,610,67,2,667,12,1140,461,425,242
16,"DÂMBOVIŢA","#N/A",69063,,400,"VALEA MARE / SCOALA PRIMARA VALEA AMARE",3,6728,"VALEA LUNGĂ",69063,448,282,261,21,0,280,2,500,218,148,132
16,"DÂMBOVIŢA","#N/A",69063,,401,"VALEA LUNGĂ OGREA / SCOALA PRIMARA VALEA LUNGA OGREA",3,6728,"VALEA LUNGĂ",69063,1115,730,679,51,0,712,18,1230,500,373,339
16,"DÂMBOVIŢA","#N/A",69063,,402,"VALEA LUNGĂ GORGOTA / SCOALA GIMNAZIALA ION HARALMBIE VALEA LUNGA GORGOTA",3,6728,"VALEA LUNGĂ",69063,1066,655,602,53,0,645,10,1180,525,354,291
16,"DÂMBOVIŢA","#N/A",69063,,403,"ŞTUBEIE TISA / GRADINITA CU PROGRAM NORMAL STUBEIE TISA",3,6728,"VALEA LUNGĂ",69063,360,256,236,20,0,255,1,390,134,166,89
16,"DÂMBOVIŢA","#N/A",69170,,404,"VALEA MARE / Scoala Gimnaziala Valea Mare",3,6739,"VALEA MARE",69170,1252,949,842,107,0,935,14,1370,421,668,267
16,"DÂMBOVIŢA","#N/A",69170,,405,"VALEA CASELOR / Scoala Valea Caselor",3,6739,"VALEA MARE",69170,634,466,424,42,0,458,8,710,244,326,132
16,"DÂMBOVIŢA","#N/A",69250,,406,"VĂCĂREŞTI / SCOLA GENERALA IANCU VACARESCU",3,6724,"VĂCĂREŞTI",69250,1410,818,766,52,0,805,13,1540,722,446,359
16,"DÂMBOVIŢA","#N/A",69250,,407,"VĂCĂREŞTI / SCOALA GENERALA ""IANCU VACARESCU""",3,6724,"VĂCĂREŞTI",69250,1167,725,673,52,0,718,7,1290,565,362,356
16,"DÂMBOVIŢA","#N/A",69250,,408,"BUNGETU / SCOALA GENERALA BUNGETU",3,6724,"VĂCĂREŞTI",69250,1135,738,685,53,0,726,12,1250,512,442,284
16,"DÂMBOVIŢA","#N/A",69250,,409,"BRĂTEŞTII DE JOS / SCOALA GENERALA BRATESTII DE JOS",3,6724,"VĂCĂREŞTI",69250,565,321,293,28,0,319,2,620,299,185,134
16,"DÂMBOVIŢA","#N/A",69303,,410,"VĂLENI-DÎMBOVIŢA / Scoala Generala Valeni Dimbovita, parter sala a doua",3,6747,"VĂLENI-DÎMBOVIŢA",69303,963,615,573,42,0,612,3,1060,445,343,269
16,"DÂMBOVIŢA","#N/A",69303,,411,"VĂLENI-DÎMBOVIŢA / Scoala Generala Valeni Dimbovita, parter sala PATRU",3,6747,"VĂLENI-DÎMBOVIŢA",69303,1019,670,610,59,1,667,3,1120,450,396,271
16,"DÂMBOVIŢA","#N/A",69303,,412,"MESTEACĂN / Scoala noua Generala Mesteacan",3,6747,"VĂLENI-DÎMBOVIŢA",69303,238,200,177,23,0,199,1,260,60,148,51
16,"DÂMBOVIŢA","#N/A",69330,,413,"VIŞINA / CAMIN CULTURAL",3,6758,"VIŞINA",69330,1385,929,855,74,0,920,9,1520,591,572,348
16,"DÂMBOVIŢA","#N/A",69330,,414,"VIŞINA / GRADINITA NR. 1 - VISINA",3,6758,"VIŞINA",69330,972,702,625,77,0,696,6,1070,368,444,252
16,"DÂMBOVIŢA","#N/A",69330,,415,"BROŞTENI / GRADINITA BROSTENI",3,6758,"VIŞINA",69330,943,630,548,82,0,626,4,1040,410,435,191
16,"DÂMBOVIŢA","#N/A",69394,,416,"VIŞINEŞTI / SCOALA GIMNAZIALA VISINESTI",3,6762,"VIŞINEŞTI",69394,850,574,512,62,0,562,12,940,366,305,257
16,"DÂMBOVIŢA","#N/A",69394,,417,"URSEIU / SCOALA URSEIU",3,6762,"VIŞINEŞTI",69394,585,436,364,67,5,428,8,640,204,268,160
16,"DÂMBOVIŢA","#N/A",69394,,418,"SULTANU / SCOALA SULTANU",3,6762,"VIŞINEŞTI",69394,269,192,161,31,0,187,5,300,108,119,68
16,"DÂMBOVIŢA","#N/A",69447,,419,"CÎRLĂNEŞTI / Căminul  Cultural",3,6750,"VÎRFURI",69447,1580,919,838,81,0,899,20,1730,811,472,427
16,"DÂMBOVIŢA","#N/A",179711,,420,"VLĂDENI / NULL",3,6767,"VLĂDENI",179711,1325,847,782,65,0,830,17,1450,603,408,422
16,"DÂMBOVIŢA","#N/A",179711,,421,"VLĂDENI / NULL",3,6767,"VLĂDENI",179711,991,644,592,52,0,636,8,1090,446,270,366
16,"DÂMBOVIŢA","#N/A",69526,,422,"GEMENEA BRĂTULEŞTI / CAMINUL CULTURAL",3,6769,"VOINEŞTI",69526,970,672,615,57,0,668,4,1060,388,418,250
16,"DÂMBOVIŢA","#N/A",69526,,423,"ONCEŞTI / GRADINITA DE COPII",3,6769,"VOINEŞTI",69526,721,625,522,103,0,615,10,800,175,375,240
16,"DÂMBOVIŢA","#N/A",69526,,424,"VOINEŞTI / SCOALA CU CLASELE I-VIII",3,6769,"VOINEŞTI",69526,1371,1033,924,109,0,1017,16,1510,477,687,330
16,"DÂMBOVIŢA","#N/A",69526,,425,"SUDULENI / SCOALA CU CLASELE I-VIII",3,6769,"VOINEŞTI",69526,1305,882,792,90,0,867,15,1440,558,591,276
16,"DÂMBOVIŢA","#N/A",69526,,426,"MANGA / SCOAL CU CLASELE I-IV",3,6769,"VOINEŞTI",69526,664,474,406,68,0,464,10,730,256,333,131
16,"DÂMBOVIŢA","#N/A",69615,,427,"VULCANA-BĂI / Grădiniţa de copii ""Albă ca zăpada""",3,6778,"VULCANA-BĂI",69615,1286,845,795,50,0,836,9,1410,565,446,390
16,"DÂMBOVIŢA","#N/A",69615,,428,"VULCANA DE SUS / Grădiniţa de copii ""Paradisul copiilor""",3,6778,"VULCANA-BĂI",69615,1182,663,629,34,0,654,9,1300,637,357,297
16,"DÂMBOVIŢA","#N/A",179640,,429,"VULCANA-PANDELE / CAMINUL CULTURAL ""IZVOR DE APA VIE""",3,6782,"VULCANA-PANDELE",179640,1293,822,764,58,0,805,17,1420,598,506,299
16,"DÂMBOVIŢA","#N/A",179640,,430,"VULCANA-PANDELE / SCOALA GENERALA VULCANA PANDELE",3,6782,"VULCANA-PANDELE",179640,1237,610,585,24,1,601,9,1370,760,415,186
16,"DÂMBOVIŢA","#N/A",179640,,431,"GURA VULCANEI / SCOALA GENERALA GURA VULCANEI",3,6782,"VULCANA-PANDELE",179640,891,558,530,28,0,549,9,990,432,315,234
16,"DÂMBOVIŢA","#N/A",179640,,432,"GURA VULCANEI / SCOALA GENERALA GURA VULCANEI",3,6782,"VULCANA-PANDELE",179640,815,470,435,35,0,465,5,900,430,257,208
17,"DOLJ",163,69900,,1,"CRAIOVA / COLEGIUL NAŢIONAL ""ELENA CUZA""",1,6788,"MUNICIPIUL CRAIOVA",69900,1327,885,792,90,3,864,21,1422,537,416,448
17,"DOLJ",163,69900,,2,"CRAIOVA / CASA DE CULTURA A STUDENŢILOR",1,6788,"MUNICIPIUL CRAIOVA",69900,1626,936,872,63,1,925,11,1700,764,450,475
17,"DOLJ",163,69900,,3,"CRAIOVA / PRIMARIA CRAIOVA- DIRECŢIA DE ASISTENŢĂ ŞI PROTECŢIE SOCIALĂ",1,6788,"MUNICIPIUL CRAIOVA",69900,1411,847,774,71,2,821,26,1500,653,382,439
17,"DOLJ",163,69900,,4,"CRAIOVA / LICEUL CU PROGRAM SPORTIV ""PETRACHE TRIŞCU""",1,6788,"MUNICIPIUL CRAIOVA",69900,1817,1153,1111,42,0,1133,20,1900,747,525,608
17,"DOLJ",163,69900,,5,"CRAIOVA / LICEUL TEORETIC ""TRAIAN VUIA""",1,6788,"MUNICIPIUL CRAIOVA",69900,1240,819,722,97,0,808,11,1300,481,392,416
17,"DOLJ",163,69900,,6,"CRAIOVA / LICEUL TEORETIC ""TRAIAN VUIA""",1,6788,"MUNICIPIUL CRAIOVA",69900,1069,762,654,108,0,743,19,1100,338,381,362
17,"DOLJ",163,69900,,7,"CRAIOVA / LICEUL TEORETIC ""CHARLES LAUGIER""",1,6788,"MUNICIPIUL CRAIOVA",69900,1837,1217,1159,58,0,1207,10,1900,683,538,669
17,"DOLJ",163,69900,,8,"CRAIOVA / LICEUL TEORETIC ""CHARLES LAUGIER""",1,6788,"MUNICIPIUL CRAIOVA",69900,1801,1266,1164,98,4,1242,24,1900,634,603,639
17,"DOLJ",163,69900,,9,"CRAIOVA / UNIVERSITATEA DIN CRAIOVA",1,6788,"MUNICIPIUL CRAIOVA",69900,1051,746,623,120,3,730,16,1100,354,344,386
17,"DOLJ",163,69900,,10,"CRAIOVA / UNIVERSITATEA DIN CRAIOVA",1,6788,"MUNICIPIUL CRAIOVA",69900,1083,843,702,139,2,828,15,1200,357,373,455
17,"DOLJ",163,69900,,11,"CRAIOVA / ŞCOALA GIMNAZIALĂ NR.22 ""MIRCEA ELIADE""",1,6788,"MUNICIPIUL CRAIOVA",69900,1268,832,750,82,0,823,9,1300,468,394,429
17,"DOLJ",163,69900,,12,"CRAIOVA / ŞCOALA GIMNAZIALĂ ""MIRCEA ELIADE""",1,6788,"MUNICIPIUL CRAIOVA",69900,1575,1088,1018,68,2,1071,17,1700,612,514,557
17,"DOLJ",163,69900,,13,"CRAIOVA / GRADINIŢA DE COPII CU PROGRAM PRELUNGIT ""DUMBRAVA MINUNATA"" ( FOSTĂ NR.37)",1,6788,"MUNICIPIUL CRAIOVA",69900,1896,1213,1151,61,1,1188,25,2000,787,595,593
17,"DOLJ",163,69900,,14,"CRAIOVA / GRADINIŢA DE COPII CU PROGRAM PRELUNGIT  ""DUMBRAVA MINUNATA""(FOSTĂ NR.37)",1,6788,"MUNICIPIUL CRAIOVA",69900,1828,1061,943,116,2,1037,24,1900,839,492,545
17,"DOLJ",163,69900,,15,"CRAIOVA / ŞCOALA GIMNAZIALĂ ""MIHAI EMINESCU""(FOSTA NR.37",1,6788,"MUNICIPIUL CRAIOVA",69900,1337,794,720,74,0,780,14,1400,606,352,428
17,"DOLJ",163,69900,,16,"CRAIOVA / ŞCOALA GIMNAZIALĂ ""MIHAI EMINESCU""(FOSTA NR.37)",1,6788,"MUNICIPIUL CRAIOVA",69900,1483,862,793,69,0,852,10,1600,738,431,421
17,"DOLJ",163,69900,,17,"CRAIOVA / ŞCOALA GIMNAZIALĂ ""MIHAI EMINESCU""(FOSTA NR. 37)",1,6788,"MUNICIPIUL CRAIOVA",69900,1339,785,701,84,0,766,19,1400,615,370,396
17,"DOLJ",163,69900,,18,"CRAIOVA / GRADINIŢA  ""PRICHINDEL""(FOSTA NR. 55)",1,6788,"MUNICIPIUL CRAIOVA",69900,1043,628,568,60,0,622,6,1100,472,351,271
17,"DOLJ",163,69900,,19,"CRAIOVA / GRADINIŢA  ""PRICHINDEL""(FOSTA NR.55)",1,6788,"MUNICIPIUL CRAIOVA",69900,1354,727,655,69,3,714,13,1400,673,376,338
17,"DOLJ",163,69900,,20,"CRAIOVA / LICEUL TEORETIC ""HENRI COANDĂ""",1,6788,"MUNICIPIUL CRAIOVA",69900,1716,908,855,53,0,892,16,1811,903,412,480
17,"DOLJ",163,69900,,21,"CRAIOVA / LICEUL TEORETIC ""HENRI COANDĂ""",1,6788,"MUNICIPIUL CRAIOVA",69900,1511,1075,906,105,64,1055,20,1700,625,558,497
17,"DOLJ",163,69900,,22,"CRAIOVA / LICEUL TEORETIC ""HENRI COANDĂ""",1,6788,"MUNICIPIUL CRAIOVA",69900,1563,993,884,58,51,977,16,1700,707,473,504
17,"DOLJ",163,69900,,23,"CRAIOVA / LICEUL UCECOM ""SPIRU HARET""",1,6788,"MUNICIPIUL CRAIOVA",69900,1826,1126,1052,74,0,1097,29,1900,774,493,604
17,"DOLJ",163,69900,,24,"CRAIOVA / COLEGIUL ""ŞTEFAN ODOBLEJA""",1,6788,"MUNICIPIUL CRAIOVA",69900,1901,1075,1006,66,3,1056,19,2000,925,482,574
17,"DOLJ",163,69900,,25,"CRAIOVA / COLEGIUL ""ŞTEFAN ODOBLEJA""",1,6788,"MUNICIPIUL CRAIOVA",69900,1850,898,859,39,0,882,16,1900,1002,414,468
17,"DOLJ",163,69900,,26,"CRAIOVA / GRADINIŢA DE COPII CU PROGRAM PRELUNGIT  ""ELENA FARAGO""(FOSTA NR.41)",1,6788,"MUNICIPIUL CRAIOVA",69900,964,608,554,54,0,593,15,1100,492,293,300
17,"DOLJ",163,69900,,27,"CRAIOVA / GRADINIŢA DE COPII CU PROGRAM PRELUNGIT  ""ELENA FARAGO""(FOSTA NR. 41)",1,6788,"MUNICIPIUL CRAIOVA",69900,1346,732,667,64,1,718,14,1400,668,379,339
17,"DOLJ",163,69900,,28,"CRAIOVA / ŞCOALA GIMNAZIALĂ ""NICOLAE ROMANESCU""",1,6788,"MUNICIPIUL CRAIOVA",69900,1605,1053,988,63,2,1032,21,1700,647,496,536
17,"DOLJ",163,69900,,29,"CRAIOVA / GRADINIŢA DE COPII CU PROGRAM PRELUNGIT  ""ION CREANGA"" (FOSTA NR. 42)",1,6788,"MUNICIPIUL CRAIOVA",69900,1359,861,797,62,2,848,13,1400,539,422,426
17,"DOLJ",163,69900,,30,"CRAIOVA / ŞCOALA GIMNAZIALĂ ""NICOLAE  ROMANESCU"" (FOSTA NR. 29)",1,6788,"MUNICIPIUL CRAIOVA",69900,1575,874,784,90,0,858,16,1700,826,430,428
17,"DOLJ",163,69900,,31,"CRAIOVA / ŞCOALA GIMNAZIALĂ ""NICOLAE  ROMANESCU"" (FOSTA NR. 29)",1,6788,"MUNICIPIUL CRAIOVA",69900,1368,890,769,48,73,875,15,1600,710,495,380
17,"DOLJ",163,69900,,32,"CRAIOVA / ŞCOALA GIMNAZIALĂ ""NICOLAE  ROMANESCU"" (FOSTA NR. 29)",1,6788,"MUNICIPIUL CRAIOVA",69900,1356,958,675,23,260,946,12,1700,742,620,326
17,"DOLJ",163,69900,,33,"CRAIOVA / UNIVERSITATEA DE MEDICINĂ ŞI FARMACIE, (SEDIUL VECHI)",1,6788,"MUNICIPIUL CRAIOVA",69900,1086,739,586,45,108,726,13,1400,661,362,364
17,"DOLJ",163,69900,,34,"CRAIOVA / UNIVERSITATEA DE MEDICINĂ ŞI FARMACIE, (SEDIUL VECHI)",1,6788,"MUNICIPIUL CRAIOVA",69900,1064,747,593,23,131,739,8,1400,653,353,386
17,"DOLJ",163,69900,,35,"CRAIOVA / LICEUL TEHNOLOGIC DE TRANSPORTURI AUTO",1,6788,"MUNICIPIUL CRAIOVA",69900,1555,812,775,25,12,794,18,1700,888,394,400
17,"DOLJ",163,69900,,36,"CRAIOVA / LICEUL TEHNOLOGIC DE TRANSPORTURI AUTO",1,6788,"MUNICIPIUL CRAIOVA",69900,1640,858,739,118,1,840,18,1700,842,460,380
17,"DOLJ",163,69900,,37,"CRAIOVA / LICEUL TEHNOLOGIC DE TRANSPORTURI AUTO",1,6788,"MUNICIPIUL CRAIOVA",69900,1561,828,777,51,0,815,13,1600,772,424,391
17,"DOLJ",163,69900,,38,"CRAIOVA / LICEUL TEHNOLOGIC DE TRANSPORTURI AUTO",1,6788,"MUNICIPIUL CRAIOVA",69900,1551,863,798,65,0,854,9,1600,737,440,414
17,"DOLJ",163,69900,,39,"CRAIOVA / LICEUL TEHNOLOGIC DE TRANSPORTURI AUTO, (FOSTA ŞCOALĂ CU CLASELE I-VIII NR.25 FĂCĂI)",1,6788,"MUNICIPIUL CRAIOVA",69900,1534,779,666,39,74,766,13,1700,921,475,291
17,"DOLJ",163,69900,,40,"CRAIOVA / SCOALA GIMNAZIALA ""GHEORGHE BIBESCU"", (FOSTA NR. 36, FOSTA SCOALA CU CLASELE I - IV, NR 27 POPOVENI)",1,6788,"MUNICIPIUL CRAIOVA",69900,864,577,485,92,0,570,7,1000,423,330,240
17,"DOLJ",163,69900,,41,"CRAIOVA / ŞCOALA GIMNAZIALA ""GHEORGHE BIBESCU"" (FOSTA NR. 36)",1,6788,"MUNICIPIUL CRAIOVA",69900,1390,849,801,48,0,836,13,1500,651,429,407
17,"DOLJ",163,69900,,42,"CRAIOVA / ŞCOALA GIMNAZIALA ""GHEORGHE BIBESCU"" (FOSTA NR. 36)",1,6788,"MUNICIPIUL CRAIOVA",69900,1756,969,911,58,0,958,11,1800,831,497,461
17,"DOLJ",163,69900,,43,"CRAIOVA / ŞCOALA GIMNAZIALA ""GHEORGHE BIBESCU"" (FOSTA NR. 36)",1,6788,"MUNICIPIUL CRAIOVA",69900,1796,1060,979,81,0,1039,21,1900,840,475,564
17,"DOLJ",163,69900,,44,"CRAIOVA / ŞCOALA GIMNAZIALA ""GHEORGHE BIBESCU"" (FOSTA NR. 36)",1,6788,"MUNICIPIUL CRAIOVA",69900,1599,951,903,47,1,941,10,1700,749,482,459
17,"DOLJ",163,69900,,45,"CRAIOVA / COLEGIUL NAŢIONAL ECONOMIC ""GHEORGHE CHIŢU""",1,6788,"MUNICIPIUL CRAIOVA",69900,1581,926,814,112,0,913,13,1700,774,439,474
17,"DOLJ",163,69900,,46,"CRAIOVA / COLEGIUL NAŢIONAL ECONOMIC ""GHEORGHE CHIŢU""",1,6788,"MUNICIPIUL CRAIOVA",69900,1462,859,782,77,0,838,21,1600,741,398,440
17,"DOLJ",163,69900,,47,"CRAIOVA / COLEGIUL NAŢIONAL ECONOMIC ""GHEORGHE CHIŢU""",1,6788,"MUNICIPIUL CRAIOVA",69900,1725,962,931,31,0,945,17,1800,838,475,470
17,"DOLJ",163,69900,,48,"CRAIOVA / UNIVERSITATEA DE MEDICINA SI FARMACIE, (SEDIUL NOU)",1,6788,"MUNICIPIUL CRAIOVA",69900,1681,1391,983,262,146,1366,25,1800,409,621,745
17,"DOLJ",163,69900,,49,"CRAIOVA / ŞCOALA GIMNAZIALĂ ""SFÂNTUL DUMITRU"" (FOSTA NR. 18)",1,6788,"MUNICIPIUL CRAIOVA",69900,1225,1012,786,79,147,1004,8,1600,588,519,485
17,"DOLJ",163,69900,,50,"CRAIOVA / LICEUL DE ARTE ""MARIN SORESCU""",1,6788,"MUNICIPIUL CRAIOVA",69900,1450,1164,930,96,138,1144,20,1600,436,584,560
17,"DOLJ",163,69900,,51,"CRAIOVA / LICEUL DE ARTE ""MARIN SORESCU""",1,6788,"MUNICIPIUL CRAIOVA",69900,1364,888,827,61,0,878,10,1500,612,420,458
17,"DOLJ",163,69900,,52,"CRAIOVA / COLEGIUL NATIONAL ""FRAŢII BUZEŞTI""",1,6788,"MUNICIPIUL CRAIOVA",69900,1899,1240,1122,105,13,1222,18,2000,760,600,622
17,"DOLJ",163,69900,,53,"CRAIOVA / COLEGIUL NATIONAL ""FRAŢII BUZEŞTI""",1,6788,"MUNICIPIUL CRAIOVA",69900,1885,1188,1116,69,3,1174,14,2000,812,595,579
17,"DOLJ",163,69900,,54,"CRAIOVA / ŞCOALA GIMNAZIALĂ  ""LASCĂR CATARGIU"" (FOSTA NR. 19)",1,6788,"MUNICIPIUL CRAIOVA",69900,1724,855,806,49,0,837,18,1800,945,431,406
17,"DOLJ",163,69900,,55,"CRAIOVA / ŞCOALA GIMNAZIALĂ  ""LASCĂR CATARGIU"" (FOSTA NR. 19)",1,6788,"MUNICIPIUL CRAIOVA",69900,1674,919,881,38,0,906,13,1800,881,531,375
17,"DOLJ",163,69900,,56,"CRAIOVA / ŞCOALA GIMNAZIALĂ  ""LASCĂR CATARGIU"" (FOSTA NR. 19)",1,6788,"MUNICIPIUL CRAIOVA",69900,1649,921,866,52,3,906,15,1700,779,477,429
17,"DOLJ",163,69900,,57,"CRAIOVA / ŞCOALA GIMNAZIALĂ  ""LASCĂR CATARGIU"" (FOSTA NR. 19)",1,6788,"MUNICIPIUL CRAIOVA",69900,1676,988,958,30,0,975,13,1800,812,520,455
17,"DOLJ",163,69900,,58,"CRAIOVA / ŞCOALA GIMNAZIALĂ ""ANTON PAN"" (FOSTA ŞCOALA GIMNAZIALA NR. 26 MOFLENI)",1,6788,"MUNICIPIUL CRAIOVA",69900,1288,786,687,91,8,772,14,1400,614,464,308
17,"DOLJ",163,69900,,59,"CRAIOVA / S.C. PENTRU LUCRARI DE DRUMURI ŞI PODURI DOLJ S.A",1,6788,"MUNICIPIUL CRAIOVA",69900,1936,742,637,105,0,733,9,1600,858,500,233
17,"DOLJ",163,69900,,60,"CRAIOVA / ŞCOALA GIMNAZIALĂ ""ANTON PAN"" (FOSTA NR.13 BUCOVĂŢ)",1,6788,"MUNICIPIUL CRAIOVA",69900,1959,830,788,42,0,813,17,2100,1270,427,386
17,"DOLJ",163,69900,,61,"CRAIOVA / COLEGIUL NAŢIONAL ""CAROL I""",1,6788,"MUNICIPIUL CRAIOVA",69900,1020,716,631,84,1,702,14,1100,384,302,400
17,"DOLJ",163,69900,,62,"CRAIOVA / COLEGIUL NAŢIONAL ""CAROL I""",1,6788,"MUNICIPIUL CRAIOVA",69900,1337,827,719,107,1,804,23,1400,573,364,440
17,"DOLJ",163,69900,,63,"CRAIOVA / FACULTATEA DE AGRONOMIE",1,6788,"MUNICIPIUL CRAIOVA",69900,1932,1074,970,104,0,1048,26,2000,926,514,534
17,"DOLJ",163,69900,,64,"CRAIOVA / FACULTATEA DE AGRONOMIE",1,6788,"MUNICIPIUL CRAIOVA",69900,1894,1236,1136,99,1,1205,31,2000,764,494,711
17,"DOLJ",163,69900,,65,"CRAIOVA / GRADINIŢA CU PROGRAM PRELUNGIT  ""PARADISUL COPIILOR"" (FOSTA NR. 24)",1,6788,"MUNICIPIUL CRAIOVA",69900,1216,662,619,42,1,651,11,1300,638,326,325
17,"DOLJ",163,69900,,66,"CRAIOVA / GRADINIŢA CU PROGRAM PRELUNGIT  ""PARADISUL COPIILOR"", (FOSTA NR. 24)",1,6788,"MUNICIPIUL CRAIOVA",69900,1063,682,638,44,0,673,9,1100,418,318,355
17,"DOLJ",163,69900,,67,"CRAIOVA / COLEGIUL TEHNIC DE INDUSTRIE ALIMENTARĂ",1,6788,"MUNICIPIUL CRAIOVA",69900,1896,1098,1023,75,0,1077,21,2000,902,502,575
17,"DOLJ",163,69900,,68,"CRAIOVA / COLEGIUL TEHNIC DE INDUSTRIE ALIMENTARĂ",1,6788,"MUNICIPIUL CRAIOVA",69900,1752,885,853,31,1,872,13,1900,1015,514,358
17,"DOLJ",163,69900,,69,"CRAIOVA / COLEGIUL TEHNIC DE INDUSTRIE ALIMENTARĂ",1,6788,"MUNICIPIUL CRAIOVA",69900,1912,1037,962,73,2,1020,17,2000,963,515,505
17,"DOLJ",163,69900,,70,"CRAIOVA / ŞCOALA GIMNAZIALĂ  ""ION CREANGĂ"" (FOSTA NR.16)",1,6788,"MUNICIPIUL CRAIOVA",69900,1672,884,843,41,0,869,15,1800,916,468,401
17,"DOLJ",163,69900,,71,"CRAIOVA / ŞCOALA GIMNAZIALĂ  ""ION CREANGĂ"" (FOSTA NR.16)",1,6788,"MUNICIPIUL CRAIOVA",69900,1551,903,843,60,0,892,11,1600,697,436,456
17,"DOLJ",163,69900,,72,"CRAIOVA / ŞCOALA GIMNAZIALĂ  ""ION CREANGĂ"" (FOSTA NR.16)",1,6788,"MUNICIPIUL CRAIOVA",69900,1708,899,869,30,0,880,19,1800,901,511,369
17,"DOLJ",163,69900,,73,"CRAIOVA / GRĂDINITA CU PROGRAM NORMAL  ""CASA CU PITICI"" (FOSTA NR. 15)",1,6788,"MUNICIPIUL CRAIOVA",69900,1674,892,816,76,0,882,10,1800,908,471,411
17,"DOLJ",163,69900,,74,"CRAIOVA / REGIA AUTONOMA DE TRANSPORT CRAIOVA",1,6788,"MUNICIPIUL CRAIOVA",69900,1652,884,856,28,0,862,22,1700,816,456,406
17,"DOLJ",163,69900,,75,"CRAIOVA / ŞCOALA GIMNAZIALĂ ""ELENA FARAGO"" (FOSTA SCOALA GIMNAZIALA NR.34)",1,6788,"MUNICIPIUL CRAIOVA",69900,1560,912,856,53,3,900,12,1700,788,474,426
17,"DOLJ",163,69900,,76,"CRAIOVA / ŞCOALA GIMNAZIALĂ ""ELENA FARAGO"" (FOSTA SCOALA GIMNAZIALA NR.34)",1,6788,"MUNICIPIUL CRAIOVA",69900,1589,862,822,40,0,851,11,1700,838,422,429
17,"DOLJ",163,69900,,77,"CRAIOVA / ŞCOALA GIMNAZIALĂ ""ELENA FARAGO"" (FOSTA SCOALA GIMNAZIALA NR.34)",1,6788,"MUNICIPIUL CRAIOVA",69900,1563,857,799,57,1,847,10,1600,743,412,435
17,"DOLJ",163,69900,,78,"CRAIOVA / ŞCOALA GIMNAZIALĂ ""ELENA FARAGO"" (FOSTA SCOALA GIMNAZIALA NR.34)",1,6788,"MUNICIPIUL CRAIOVA",69900,1768,962,932,30,0,941,21,1900,938,446,495
17,"DOLJ",163,69900,,79,"CRAIOVA / ŞCOALA GIMNAZIALĂ ""ELENA FARAGO"" (FOSTA SCOALA GIMNAZIALA NR.33)",1,6788,"MUNICIPIUL CRAIOVA",69900,1856,1025,926,99,0,1008,17,1900,875,517,491
17,"DOLJ",163,69900,,80,"CRAIOVA / ŞCOALA GIMNAZIALĂ ""ELENA FARAGO"" (FOSTA SCOALA GIMNAZIALA NR.33)",1,6788,"MUNICIPIUL CRAIOVA",69900,1808,963,918,45,0,945,18,1900,937,496,449
17,"DOLJ",163,69900,,81,"CRAIOVA / ŞCOALA GIMNAZIALĂ ""ELENA FARAGO"" (FOSTA SCOALA GIMNAZIALA NR.33)",1,6788,"MUNICIPIUL CRAIOVA",69900,1758,931,870,61,0,918,13,1900,969,476,442
17,"DOLJ",163,69900,,82,"CRAIOVA / GRADINIŢA CU PROGRAM PRELUNGIT ""PITICOT"" (FOSTA NR.45)",1,6788,"MUNICIPIUL CRAIOVA",69900,1772,1017,924,93,0,1007,10,1900,883,516,491
17,"DOLJ",163,69900,,83,"CRAIOVA / GRADINIŢA CU PROGRAM PRELUNGIT ""PITICOT"" (FOSTA NR.45)",1,6788,"MUNICIPIUL CRAIOVA",69900,1264,667,649,18,0,661,6,1400,733,335,326
17,"DOLJ",163,69900,,84,"CRAIOVA / GRADINIŢA CU PROGRAM PRELUNGIT ""PITICOT"" (FOSTA NR.45)",1,6788,"MUNICIPIUL CRAIOVA",69900,1130,623,585,38,0,616,7,1200,577,331,285
17,"DOLJ",163,69900,,85,"CRAIOVA / GRADINIŢA CU PROGRAM PRELUNGIT ""FLOAREA SOARELUI"" (FOSTA NR.51)",1,6788,"MUNICIPIUL CRAIOVA",69900,1349,839,753,85,1,826,13,1400,561,434,392
17,"DOLJ",163,69900,,86,"CRAIOVA / GRADINIŢA CU PROGRAM PRELUNGIT ""FLOAREA SOARELUI"" (FOSTA NR.51)",1,6788,"MUNICIPIUL CRAIOVA",69900,1417,724,691,33,0,711,13,1500,776,363,348
17,"DOLJ",163,69900,,87,"CRAIOVA / GRADINIŢA CU PROGRAM PRELUNGIT ""FLOAREA SOARELUI"" (FOSTA NR.51)",1,6788,"MUNICIPIUL CRAIOVA",69900,1398,809,739,69,1,796,13,1500,691,447,349
17,"DOLJ",163,69900,,88,"CRAIOVA / ŞCOALA GIMNAZIALĂ  ""ALEXANDRU MACEDONSKI"" (FOSTA NR.32)",1,6788,"MUNICIPIUL CRAIOVA",69900,1752,964,922,42,0,952,12,1769,805,513,439
17,"DOLJ",163,69900,,89,"CRAIOVA / ŞCOALA GIMNAZIALĂ  ""ALEXANDRU MACEDONSKI"" (FOSTA NR.32)",1,6788,"MUNICIPIUL CRAIOVA",69900,1809,936,892,44,0,918,18,1900,964,468,450
17,"DOLJ",163,69900,,90,"CRAIOVA / ŞCOALA GIMNAZIALĂ  ""ALEXANDRU MACEDONSKI"" (FOSTA NR.32)",1,6788,"MUNICIPIUL CRAIOVA",69900,1892,1023,933,90,0,1011,12,1996,973,490,521
17,"DOLJ",163,69900,,91,"CRAIOVA / ŞCOALA GIMNAZIALĂ  ""ALEXANDRU MACEDONSKI"" (FOSTA NR.32)",1,6788,"MUNICIPIUL CRAIOVA",69900,1737,991,911,80,0,981,10,1802,811,533,448
17,"DOLJ",163,69900,,92,"CRAIOVA / GRĂDINIŢA CU PROGRAM PRELUNGIT ""FLOARE ALBASTRA"" (FOSTA NR.40)",1,6788,"MUNICIPIUL CRAIOVA",69900,1430,758,707,50,1,746,12,1500,742,366,380
17,"DOLJ",163,69900,,93,"CRAIOVA / GRĂDINIŢA CU PROGRAM PRELUNGIT ""FLOARE ALBASTRA"" (FOSTA NR.40)",1,6788,"MUNICIPIUL CRAIOVA",69900,1682,898,836,62,0,890,8,1800,902,480,410
17,"DOLJ",163,69900,,94,"CRAIOVA / ŞCOALA GIMNAZIALĂ  ""MIHAI VITEAZU"" (FOSTA NR.30)",1,6788,"MUNICIPIUL CRAIOVA",69900,1487,867,780,86,1,851,16,1600,733,417,434
17,"DOLJ",163,69900,,95,"CRAIOVA / ŞCOALA GIMNAZIALĂ  ""MIHAI VITEAZU"" (FOSTA NR.30)",1,6788,"MUNICIPIUL CRAIOVA",69900,1658,847,800,46,1,828,19,1800,953,468,360
17,"DOLJ",163,69900,,96,"CRAIOVA / ŞCOALA GIMNAZIALĂ  ""MIHAI VITEAZU"" (FOSTA NR.30)",1,6788,"MUNICIPIUL CRAIOVA",69900,1587,881,797,82,2,874,7,1700,819,491,383
17,"DOLJ",163,69900,,97,"CRAIOVA / ŞCOALA GIMNAZIALĂ  ""MIHAI VITEAZU"" (FOSTA NR.30)",1,6788,"MUNICIPIUL CRAIOVA",69900,1472,823,776,46,1,806,17,1600,777,421,385
17,"DOLJ",163,69900,,98,"CRAIOVA / ŞCOALA GIMNAZIALĂ  ""MIHAI VITEAZU"" (FOSTA NR.30)",1,6788,"MUNICIPIUL CRAIOVA",69900,1516,798,760,33,5,791,7,1600,802,438,353
17,"DOLJ",163,69900,,99,"CRAIOVA / LICEUL TEHNOLOGIC  ""GEORGE BIBESCU""",1,6788,"MUNICIPIUL CRAIOVA",69900,1325,791,671,120,0,781,10,1400,609,411,370
17,"DOLJ",163,69900,,100,"CRAIOVA / LICEUL TEHNOLOGIC  ""GEORGE BIBESCU""",1,6788,"MUNICIPIUL CRAIOVA",69900,1272,835,662,173,0,822,13,1400,565,457,365
17,"DOLJ",163,69900,,101,"CRAIOVA / GRADINIŢA CU PROGRAM PRELUNGIT ""PHOENIX"" (FOSTA NR.52)",1,6788,"MUNICIPIUL CRAIOVA",69900,1322,731,704,26,1,723,8,1500,769,359,364
17,"DOLJ",163,69900,,102,"CRAIOVA / GRADINITA CU PROGRAM PRELUNGIT ""PHOENIX"" (FOSTA NR. 52)",1,6788,"MUNICIPIUL CRAIOVA",69900,1218,673,634,39,0,664,9,1399,726,342,322
17,"DOLJ",163,69900,,103,"CRAIOVA / COLEGIUL TEHNIC ""COSTIN D. NENITESCU""",1,6788,"MUNICIPIUL CRAIOVA",69900,1902,1245,1113,132,0,1222,23,2000,755,641,581
17,"DOLJ",163,69900,,104,"CRAIOVA / COLEGIUL TEHNIC ""COSTIN D. NENIŢESCU""",1,6788,"MUNICIPIUL CRAIOVA",69900,1774,1093,930,163,0,1076,17,1902,809,582,494
17,"DOLJ",163,69900,,105,"CRAIOVA / COLEGIUL TEHNIC ""COSTIN D. NENIŢESCU""",1,6788,"MUNICIPIUL CRAIOVA",69900,1531,948,871,77,0,940,8,1700,752,487,453
17,"DOLJ",163,69900,,106,"CRAIOVA / COLEGIUL TEHNIC ""COSTIN D. NENIŢESCU""",1,6788,"MUNICIPIUL CRAIOVA",69900,1464,861,811,50,0,851,10,1600,739,373,478
17,"DOLJ",163,69900,,107,"CRAIOVA / COLEGIUL TEHNIC ""COSTIN D. NENIŢESCU""",1,6788,"MUNICIPIUL CRAIOVA",69900,1706,942,889,52,1,927,15,1800,858,442,485
17,"DOLJ",163,69900,,108,"CRAIOVA / ŞCOALA GIMNAZIALĂ  ""DECEBAL"" (FOSTA NR. 12)",1,6788,"MUNICIPIUL CRAIOVA",69900,1574,946,875,71,0,927,19,1700,754,455,472
17,"DOLJ",163,69900,,109,"CRAIOVA / ŞCOALA GIMNAZIALĂ  ""DECEBAL"" (FOSTA NR. 12)",1,6788,"MUNICIPIUL CRAIOVA",69900,1476,926,869,57,0,907,19,1600,674,389,518
17,"DOLJ",163,69900,,110,"CRAIOVA / ŞCOALA GIMNAZIALĂ  ""DECEBAL"" (FOSTA NR. 12)",1,6788,"MUNICIPIUL CRAIOVA",69900,1516,910,850,60,0,896,14,1600,690,434,462
17,"DOLJ",163,69900,,111,"CRAIOVA / COLEGIUL TEHNIC ENERGETIC",1,6788,"MUNICIPIUL CRAIOVA",69900,1440,879,828,51,0,861,18,1600,721,395,466
17,"DOLJ",163,69900,,112,"CRAIOVA / COLEGIUL TEHNIC ENERGETIC",1,6788,"MUNICIPIUL CRAIOVA",69900,1544,888,827,61,0,869,19,1700,812,418,451
17,"DOLJ",163,69900,,113,"CRAIOVA / COLEGIUL TEHNIC ENERGETIC",1,6788,"MUNICIPIUL CRAIOVA",69900,1385,880,807,73,0,866,14,1500,620,420,446
17,"DOLJ",163,69900,,114,"CRAIOVA / COLEGIUL NAŢIONAL PEDAGOGIC ""ŞTEFAN VELOVAN""",1,6788,"MUNICIPIUL CRAIOVA",69900,1992,1229,1106,96,27,1214,15,2100,871,601,613
17,"DOLJ",163,69900,,115,"CRAIOVA / COLEGIUL NAŢIONAL PEDAGOGIC ""ŞTEFAN VELOVAN""",1,6788,"MUNICIPIUL CRAIOVA",69900,1690,1040,973,67,0,1032,8,1800,760,513,519
17,"DOLJ",163,69900,,116,"CRAIOVA / GRĂDINIŢA CU PROGRAM PRELUNGIT ""CASUTA CU POVESTI"" (FOSTA NR.43)",1,6788,"MUNICIPIUL CRAIOVA",69900,1729,996,905,89,2,980,16,1800,804,519,461
17,"DOLJ",163,69900,,117,"CRAIOVA / GRADINITA CU PROGRAM PRELUNGIT ""CASUTA CU POVESTI"" (FOSTA NR. 43)",1,6788,"MUNICIPIUL CRAIOVA",69900,1583,1024,941,82,1,1007,17,1700,676,488,519
17,"DOLJ",163,69900,,118,"CRAIOVA / GRĂDINIŢA CU PROGRAM PRELUNGIT ""VOINICEII"" (FOSTA NR.32)",1,6788,"MUNICIPIUL CRAIOVA",69900,1550,957,895,61,1,942,15,1700,743,454,488
17,"DOLJ",163,69900,,119,"CRAIOVA / GRĂDINIŢA CU PROGRAM PRELUNGIT ""VOINICEII"" (FOSTA NR.32)",1,6788,"MUNICIPIUL CRAIOVA",69900,1347,834,733,99,2,813,21,1400,566,401,412
17,"DOLJ",163,69900,,120,"CRAIOVA / ŞCOALA GIMNAZIALĂ  ""SFÂNTU GHEORGHE"" (FOSTA NR.24)",1,6788,"MUNICIPIUL CRAIOVA",69900,1841,1219,1099,119,1,1195,24,1900,681,577,618
17,"DOLJ",163,69900,,121,"CRAIOVA / ŞCOALA GIMNAZIALĂ  ""SFÂNTU GHEORGHE"" (FOSTA NR.24)",1,6788,"MUNICIPIUL CRAIOVA",69900,1750,1080,1002,76,2,1057,23,1800,720,546,511
17,"DOLJ",163,69900,,122,"CRAIOVA / ŞCOALA GIMNAZIALĂ  ""SFÂNTU GHEORGHE"" (FOSTA NR.24)",1,6788,"MUNICIPIUL CRAIOVA",69900,1707,1044,956,86,2,1024,20,1800,756,523,501
17,"DOLJ",163,69900,,123,"CRAIOVA / LICEUL TEHNOLOGIC TRANSPORTURI CĂI FERATE",1,6788,"MUNICIPIUL CRAIOVA",69900,994,972,614,144,214,954,18,1200,228,503,451
17,"DOLJ",163,69900,,124,"CRAIOVA / LICEUL TEHNOLOGIC TRANSPORTURI CĂI FERATE",1,6788,"MUNICIPIUL CRAIOVA",69900,1084,754,649,105,0,735,19,1200,446,369,366
17,"DOLJ",163,69900,,125,"CRAIOVA / COLEGIUL NAŢIONAL ""NICOLAE Titulescu""",1,6788,"MUNICIPIUL CRAIOVA",69900,1765,1191,1085,105,1,1174,17,1900,709,576,598
17,"DOLJ",163,69900,,126,"CRAIOVA / ŞCOALA GIMNAZIALĂ  ""TRAIAN"" (FOSTA NR. 2)",1,6788,"MUNICIPIUL CRAIOVA",69900,1025,794,661,131,2,785,9,1100,306,375,410
17,"DOLJ",163,69900,,127,"CRAIOVA / ŞCOALA GIMNAZIALĂ  ""TRAIAN"" (FOSTA NR.2)",1,6788,"MUNICIPIUL CRAIOVA",69900,1245,870,812,57,1,853,17,1300,430,356,497
17,"DOLJ",163,69900,,128,"CRAIOVA / GRĂDINIŢA CU PROGRAM PRELUNGIT ""TUDOR VLADIMIRESCU"" (FOSTA NR.21)",1,6788,"MUNICIPIUL CRAIOVA",69900,1769,1166,1094,71,1,1152,14,1800,634,523,629
17,"DOLJ",163,69900,,129,"CRAIOVA / ŞCOALA GIMNAZIALĂ  ""SF. GHEORGHE"" (FOSTA SCOALA CU CLASELE I - VIII NR.23)",1,6788,"MUNICIPIUL CRAIOVA",69900,1853,1154,1108,43,3,1125,29,1900,746,577,548
17,"DOLJ",163,69900,,130,"CRAIOVA / ŞCOALA GIMNAZIALĂ  ""SF. GHEORGHE"" (FOSTA SCOALA CU CLASELE I - VIII NR.23)",1,6788,"MUNICIPIUL CRAIOVA",69900,1811,1167,1093,74,0,1146,21,1900,733,541,605
17,"DOLJ",163,69900,,131,"CRAIOVA / ŞCOALA GIMNAZIALĂ  ""SF. GHEORGHE"" (FOSTA SCOALA CU CLASELE I - VIII NR.23)",1,6788,"MUNICIPIUL CRAIOVA",69900,1748,1126,1051,74,1,1110,16,1800,674,502,608
17,"DOLJ",163,69900,,132,"CRAIOVA / DIRECŢIA  DE SĂNĂTATE PUBLICĂ DOLJ",1,6788,"MUNICIPIUL CRAIOVA",69900,1320,788,746,42,0,774,14,1400,612,381,393
17,"DOLJ",163,69900,,133,"CRAIOVA / DIRECŢIA  DE SĂNĂTATE PUBLICĂ DOLJ",1,6788,"MUNICIPIUL CRAIOVA",69900,1822,1115,1063,52,0,1092,23,1900,785,550,542
17,"DOLJ",163,69900,,134,"CRAIOVA / ŞCOALA GIMNAZIALĂ  ""ION ŢUCULESCU"" (FOSTA NR. 14)",1,6788,"MUNICIPIUL CRAIOVA",69900,1806,1043,1005,38,0,1025,18,1900,857,536,489
17,"DOLJ",163,69900,,135,"CRAIOVA / ŞCOALA GIMNAZIALĂ  ""ION ŢUCULESCU"" (FOSTA NR. 14)",1,6788,"MUNICIPIUL CRAIOVA",69900,1834,1157,1093,64,0,1134,23,1900,743,551,583
17,"DOLJ",163,69900,,136,"CRAIOVA / ŞCOALA GIMNAZIALĂ  ""ION ŢUCULESCU"" (FOSTA NR. 14)",1,6788,"MUNICIPIUL CRAIOVA",69900,1602,894,863,31,0,881,13,1700,806,456,425
17,"DOLJ",163,69900,,137,"CRAIOVA / SCOALA GIMNAZIALA ""ION TUCULESCU"" (ŞCOALA CU CLASELE I-IV NR.28 ŞIMNICUL DE JOS)",1,6788,"MUNICIPIUL CRAIOVA",69900,1397,1011,801,48,162,1002,9,1700,689,590,412
17,"DOLJ",163,69900,,138,"CRAIOVA / GRĂDINIŢA CU PROGRAM NORMAL  ""ÎNGERAŞII"" ( FOSTA NR. 5)",1,6788,"MUNICIPIUL CRAIOVA",69900,1345,870,827,43,0,859,11,1400,530,435,424
17,"DOLJ",163,69900,,139,"CRAIOVA / GRĂDINIŢA CU PROGRAM NORMAL  ""ÎNGERAŞII"" ( FOSTA NR. 5)",1,6788,"MUNICIPIUL CRAIOVA",69900,1148,656,622,34,0,647,9,1200,544,346,301
17,"DOLJ",163,69900,,140,"CRAIOVA / SUCURSALA REGIONALĂ CF CRAIOVA",1,6788,"MUNICIPIUL CRAIOVA",69900,1330,1068,843,223,2,1053,15,1500,432,527,526
17,"DOLJ",163,69900,,141,"CRAIOVA / SUCURSALA REGIONALĂ CF CRAIOVA",1,6788,"MUNICIPIUL CRAIOVA",69900,1618,1171,936,231,4,1155,16,1800,629,597,558
17,"DOLJ",163,69900,,142,"CRAIOVA / GRĂDINIŢA CU PROGRAM PRELUNGIT  ""SF. LUCIA"" (FOSTA NR.50)",1,6788,"MUNICIPIUL CRAIOVA",69900,1031,685,638,46,1,675,10,1100,415,302,373
17,"DOLJ",163,69900,,143,"CRAIOVA / GRĂDINIŢA CU PROGRAM PRELUNGIT  ""SF. LUCIA"" (FOSTA NR.50)",1,6788,"MUNICIPIUL CRAIOVA",69900,980,650,618,32,0,644,6,1100,450,323,321
17,"DOLJ",163,69900,,144,"CRAIOVA / GRĂDINIŢA CU PROGRAM PRELUNGIT ""PETRACHE POENARU"" (FOSTA SCOALA CU CLASELE I  VIII NR.9 PETRACHE POENARU)",1,6788,"MUNICIPIUL CRAIOVA",69900,1682,1369,1041,53,275,1343,26,2000,631,742,601
17,"DOLJ",163,69900,,145,"CRAIOVA / GRĂDINIŢA CU PROGRAM PRELUNGIT ""PETRACHE POENARU"" (FOSTA SCOALA CU CLASELE I  VIII NR.9 PETRACHE POENARU)",1,6788,"MUNICIPIUL CRAIOVA",69900,1262,1063,786,69,208,1033,30,1600,537,571,462
17,"DOLJ",163,69900,,146,"CRAIOVA / ŞCOALA GIMNAZIALĂ  ""GHEORGHE ŢIŢEICA"" (FOSTA NR. 21)",1,6788,"MUNICIPIUL CRAIOVA",69900,1592,1109,952,156,1,1077,32,1700,591,525,552
17,"DOLJ",163,69900,,147,"CRAIOVA / ŞCOALA GIMNAZIALĂ  ""GHEORGHE ŢIŢEICA"" (FOSTA NR. 21)",1,6788,"MUNICIPIUL CRAIOVA",69900,1556,1033,933,97,3,1015,18,1600,567,520,495
17,"DOLJ",163,69900,,148,"CRAIOVA / GRĂDINIŢA CU PROGRAM PRELUNGIT ""PINOCHIO""",1,6788,"MUNICIPIUL CRAIOVA",69900,1229,848,743,103,2,827,21,1299,451,405,422
17,"DOLJ",163,69900,,149,"CRAIOVA / PRIMĂRIA MUNICIPIULUI CRAIOVA, (FOSTA ŞCOALA CU CLASELE I-VIII  NR.35  ""I.D. SÎRBU"")""",1,6788,"MUNICIPIUL CRAIOVA",69900,1200,821,713,108,0,801,20,1300,479,382,419
17,"DOLJ",163,69900,,150,"CRAIOVA / PRIMĂRIA MUNICIPIULUI CRAIOVA, (FOSTA ŞCOALA CU CLASELE I-VIII  NR.35  ""I.D. SÎRBU"")",1,6788,"MUNICIPIUL CRAIOVA",69900,1115,723,643,79,1,706,17,1200,477,366,340
17,"DOLJ",163,69900,,151,"CRAIOVA / PRIMĂRIA MUNICIPIULUI CRAIOVA, (FOSTA ŞCOALA CU CLASELE I-VIII  NR.35  ""I.D. SÎRBU"")",1,6788,"MUNICIPIUL CRAIOVA",69900,1309,827,766,61,0,817,10,1400,573,378,439
17,"DOLJ",163,69900,,152,"CRAIOVA / LICEUL  ""MATEI BASARAB""",1,6788,"MUNICIPIUL CRAIOVA",69900,1030,946,604,81,261,935,11,1500,554,595,340
17,"DOLJ",163,69900,,153,"CRAIOVA / LICEUL  ""MATEI BASARAB""",1,6788,"MUNICIPIUL CRAIOVA",69900,975,800,535,36,229,787,13,1400,600,523,264
17,"DOLJ",163,69900,,154,"CRAIOVA / LICEUL TEORETIC ""TUDOR ARGHEZI""",1,6788,"MUNICIPIUL CRAIOVA",69900,1384,899,778,121,0,893,6,1500,601,424,469
17,"DOLJ",163,69900,,155,"CRAIOVA / LICEUL TEORETIC ""TUDOR ARGHEZI""",1,6788,"MUNICIPIUL CRAIOVA",69900,1429,906,821,82,3,895,11,1500,594,479,416
17,"DOLJ",163,69900,,156,"CRAIOVA / LICEUL TEORETIC ""TUDOR ARGHEZI""",1,6788,"MUNICIPIUL CRAIOVA",69900,1470,923,863,59,1,901,22,1600,677,437,464
17,"DOLJ",163,69900,,157,"CRAIOVA / ŞCOALA GIMNAZIALĂ  ""NICOLAE BĂLCESCU"" (FOSTA NR.39)",1,6788,"MUNICIPIUL CRAIOVA",69900,1516,936,897,39,0,909,27,1600,664,475,434
17,"DOLJ",163,69900,,158,"CRAIOVA / ŞCOALA GIMNAZIALĂ  ""NICOLAE BĂLCESCU"" (FOSTA NR.39)",1,6788,"MUNICIPIUL CRAIOVA",69900,1386,857,792,65,0,838,19,1500,643,415,423
17,"DOLJ",163,69900,,159,"CRAIOVA / ŞCOALA GIMNAZIALĂ  ""NICOLAE BĂLCESCU"" (FOSTA NR.39)",1,6788,"MUNICIPIUL CRAIOVA",69900,1580,1115,933,181,1,1097,18,1700,585,487,610
17,"DOLJ",163,69900,,160,"CRAIOVA / ŞCOALA GIMNAZIALĂ  ""NICOLAE BĂLCESCU"" (FOSTA NR.39)",1,6788,"MUNICIPIUL CRAIOVA",69900,1534,922,843,79,0,903,19,1600,678,444,459
17,"DOLJ",163,69900,,161,"CRAIOVA / GRĂDINIŢA CU PROGRAM NORMAL ""LUCEAFĂRUL"" (FOSTA NR.14)",1,6788,"MUNICIPIUL CRAIOVA",69900,1576,1017,952,62,3,989,28,1700,683,469,520
17,"DOLJ",163,69900,,162,"CRAIOVA / FACULTATEA DE MECANICĂ",1,6788,"MUNICIPIUL CRAIOVA",69900,1152,908,705,123,80,900,8,1399,491,418,482
17,"DOLJ",163,69900,,163,"CRAIOVA / LICEUL TEHNOLOGIC AUTO",1,6788,"MUNICIPIUL CRAIOVA",69900,1724,1089,965,124,0,1074,15,1800,711,527,547
17,"DOLJ",163,69900,,164,"CRAIOVA / LICEUL TEHNOLOGIC AUTO",1,6788,"MUNICIPIUL CRAIOVA",69900,1434,796,754,42,0,781,15,1500,704,368,413
17,"DOLJ",163,69900,,165,"CRAIOVA / PUNCTUL TERMIC NR.1 LĂPUŞ (LÂNGĂ BL.23 - BLD. DECEBAL NR.66)",1,6788,"MUNICIPIUL CRAIOVA",69900,1303,787,723,64,0,768,19,1400,613,365,403
17,"DOLJ",163,69900,,166,"CRAIOVA / PUNCTUL TERMIC NR.2 LĂPUŞ (LÂNGĂ BL. 59 - BLD. DECEBAL NR.55)",1,6788,"MUNICIPIUL CRAIOVA",69900,1340,822,766,56,0,811,11,1400,578,412,399
17,"DOLJ",163,69900,,167,"CRAIOVA / PRIMĂRIA MUNICIPIULUI CRAIOVA DIRECŢIA DE ASISTENŢĂ ŞI PROTECŢIE SOCIALĂ",1,6788,"MUNICIPIUL CRAIOVA",69900,1516,981,826,155,0,963,18,1600,619,454,509
17,"DOLJ",163,69900,,168,"CRAIOVA / PRIMĂRIA MUNICIPIULUI CRAIOVA-DIRECŢIA DE ASISTENŢĂ ŞI PROTECŢIE SOCIALĂ",1,6788,"MUNICIPIUL CRAIOVA",69900,1369,852,795,56,1,837,15,1500,648,395,442
17,"DOLJ",163,69900,,169,"CRAIOVA / ŞCOALA GIMNAZIALĂ NR.38",1,6788,"MUNICIPIUL CRAIOVA",69900,1471,858,806,52,0,841,17,1600,742,425,416
17,"DOLJ",163,69900,,170,"CRAIOVA / ŞCOALA GIMNAZIALĂ NR.38",1,6788,"MUNICIPIUL CRAIOVA",69900,1444,785,747,38,0,773,12,1500,715,427,346
17,"DOLJ",163,69900,,171,"CRAIOVA / ŞCOALA GIMNAZIALĂ NR.38",1,6788,"MUNICIPIUL CRAIOVA",69900,1498,727,672,55,0,713,14,1600,873,415,298
17,"DOLJ",163,69900,,172,"CRAIOVA / GRĂDINIŢA CU PROGRAM NORMAL ROVINE",1,6788,"MUNICIPIUL CRAIOVA",69900,542,339,315,24,0,336,3,600,261,190,146
17,"DOLJ",163,69900,,173,"CRAIOVA / ŞCOALA PRIMARĂ IZVORUL RECE",1,6788,"MUNICIPIUL CRAIOVA",69900,535,328,304,24,0,328,0,600,272,171,157
17,"DOLJ",163,70316,,174,"BĂILEŞTI / Şcoala gimnazială nr. 1",1,6798,"MUNICIPIUL BĂILEŞTI",70316,1459,633,608,24,1,623,10,1499,866,353,270
17,"DOLJ",163,70316,,175,"BĂILEŞTI / Grădiniţa de copii nr. 3",1,6798,"MUNICIPIUL BĂILEŞTI",70316,1171,512,487,25,0,508,4,1300,788,314,194
17,"DOLJ",163,70316,,176,"BĂILEŞTI / Şcoala gimnazială nr. 3",1,6798,"MUNICIPIUL BĂILEŞTI",70316,610,226,207,19,0,226,0,700,474,131,95
17,"DOLJ",163,70316,,177,"BĂILEŞTI / Şcoala gimnazială nr. 3",1,6798,"MUNICIPIUL BĂILEŞTI",70316,908,425,410,15,0,419,6,1000,575,245,174
17,"DOLJ",163,70316,,178,"BĂILEŞTI / Şcoala gimnazială nr. 5",1,6798,"MUNICIPIUL BĂILEŞTI",70316,1080,499,462,37,0,495,4,1200,701,295,200
17,"DOLJ",163,70316,,179,"BĂILEŞTI / Grădiniţa de copii nr. 7",1,6798,"MUNICIPIUL BĂILEŞTI",70316,781,441,415,26,0,439,2,900,459,276,163
17,"DOLJ",163,70316,,180,"BĂILEŞTI / Liceul Mihai Viteazul",1,6798,"MUNICIPIUL BĂILEŞTI",70316,1045,519,488,29,2,516,3,1100,581,291,225
17,"DOLJ",163,70316,,181,"BĂILEŞTI / Grădiniţa de copii nr. 5",1,6798,"MUNICIPIUL BĂILEŞTI",70316,675,313,294,18,1,309,4,800,487,187,122
17,"DOLJ",163,70316,,182,"BĂILEŞTI / Şcoala gimnazială nr. 4",1,6798,"MUNICIPIUL BĂILEŞTI",70316,1469,704,679,25,0,698,6,1600,896,426,272
17,"DOLJ",163,70316,,183,"BĂILEŞTI / Şcoala gimnazială nr. 4",1,6798,"MUNICIPIUL BĂILEŞTI",70316,997,518,470,47,1,511,7,1100,582,303,208
17,"DOLJ",163,70316,,184,"BĂILEŞTI / Grădiniţa de copii nr. 8",1,6798,"MUNICIPIUL BĂILEŞTI",70316,1436,725,692,27,6,721,4,1500,775,434,287
17,"DOLJ",163,70316,,185,"BĂILEŞTI / Liceul Tehnologic Ştefan Anghel",1,6798,"MUNICIPIUL BĂILEŞTI",70316,625,309,276,33,0,306,3,700,391,175,131
17,"DOLJ",163,70316,,186,"BĂILEŞTI / Grădiniţa de copii nr. 2",1,6798,"MUNICIPIUL BĂILEŞTI",70316,1053,454,438,16,0,446,8,1100,646,289,157
17,"DOLJ",163,70316,,187,"BĂILEŞTI / Agrozind S.A.",1,6798,"MUNICIPIUL BĂILEŞTI",70316,879,462,433,29,0,460,2,1000,538,262,198
17,"DOLJ",163,70316,,188,"BĂILEŞTI / Şcoala gimnazială nr. 6",1,6798,"MUNICIPIUL BĂILEŞTI",70316,1395,728,650,47,31,716,12,1600,872,385,331
17,"DOLJ",163,70316,,189,"BALASAN / Şcoala gimnazială Balasan",1,6798,"MUNICIPIUL BĂILEŞTI",70316,479,293,271,22,0,289,4,600,307,137,152
17,"DOLJ",163,70352,,190,"GOLENŢI / Caminul Cultural Golenti  (din cadrul Casei de Cultura Calafat )",1,6801,"MUNICIPIUL CALAFAT",70352,433,274,243,31,0,269,5,500,226,198,71
17,"DOLJ",163,70352,,191,"BASARABI / Caminul Cultural Basarabi (din cadrul Casei de Cultura Calafat )",1,6801,"MUNICIPIUL CALAFAT",70352,921,592,547,44,1,584,8,1002,410,365,219
17,"DOLJ",163,70352,,192,"CIUPERCENII VECHI / Caminul Cultural Ciupercenii Vechii ( din cadrul Casei de Cultura Calafat )",1,6801,"MUNICIPIUL CALAFAT",70352,1871,1030,958,53,19,1024,6,2000,970,750,274
17,"DOLJ",163,70352,,193,"CALAFAT / Sc. Generala nr. 1 Calafat",1,6801,"MUNICIPIUL CALAFAT",70352,1665,925,812,62,51,915,10,1900,975,569,346
17,"DOLJ",163,70352,,194,"CALAFAT / Liceul Teoretic Independenta",1,6801,"MUNICIPIUL CALAFAT",70352,1990,1183,1115,59,9,1169,14,2100,917,821,348
17,"DOLJ",163,70352,,195,"CALAFAT / Local alimentatie publica",1,6801,"MUNICIPIUL CALAFAT",70352,1555,873,836,36,1,861,12,1600,727,592,269
17,"DOLJ",163,70352,,196,"CALAFAT / Sc. Generala nr. 2 Calafat",1,6801,"MUNICIPIUL CALAFAT",70352,1872,962,869,92,1,952,10,2000,1038,638,314
17,"DOLJ",163,70352,,197,"CALAFAT / Sc.Generala nr. 2 Calafat",1,6801,"MUNICIPIUL CALAFAT",70352,1641,773,724,49,0,769,4,1700,927,472,297
17,"DOLJ",163,70352,,198,"CALAFAT / Gradinita nr. 4 ( din cadrul Sc.Generale nr.1 Calafat )",1,6801,"MUNICIPIUL CALAFAT",70352,1855,853,795,58,0,843,10,1900,1047,500,343
17,"DOLJ",163,70352,,199,"CALAFAT / Local alimentatie publica Partener 3",1,6801,"MUNICIPIUL CALAFAT",70352,1899,942,888,54,0,941,1,2000,1058,557,384
17,"DOLJ",163,70879,,200,"BECHET / LICEUL TEORETIC BECHET",1,6806,"ORAŞ BECHET",70879,1359,715,638,70,7,707,8,1500,785,467,240
17,"DOLJ",163,70879,,201,"BECHET / SCOALA PRIMARA BECHET VALE",1,6806,"ORAŞ BECHET",70879,686,493,412,50,31,490,3,800,307,352,138
17,"DOLJ",163,70879,,202,"BECHET / BIBLIOTECA ORASENEASCA BECHET",1,6806,"ORAŞ BECHET",70879,1193,649,528,80,41,643,6,1300,651,477,166
17,"DOLJ",163,72007,,203,"DĂBULENI / Structura Scolii Gimnaziale nr. 1 Dabuleni",1,6808,"ORAŞ DĂBULENI",72007,1712,1226,1171,49,6,1204,22,1800,574,850,354
17,"DOLJ",163,72007,,204,"DĂBULENI / Clubul Copiilor Dabuleni",1,6808,"ORAŞ DĂBULENI",72007,1629,1209,1094,65,50,1190,19,1800,591,828,362
17,"DOLJ",163,72007,,205,"DĂBULENI / SCOALA GIMNAZIALA CU CLASELE I-VIII NR.1 DABULENI, NORD",1,6808,"ORAŞ DĂBULENI",72007,1625,1173,1099,59,15,1161,12,1700,527,855,306
17,"DOLJ",163,72007,,206,"DĂBULENI / SCOALA GIMNAZIALA CU CLASELE I-VIII NR.1 DABULENI, SUD",1,6808,"ORAŞ DĂBULENI",72007,1786,1290,1225,52,13,1277,13,1900,610,894,383
17,"DOLJ",163,72007,,207,"DĂBULENI / Liceul Teoretic Constantin Brancoveanu",1,6808,"ORAŞ DĂBULENI",72007,1193,903,823,57,23,894,9,1300,397,627,267
17,"DOLJ",163,72007,,208,"DĂBULENI / Liceul Teoretic Constantin Brancoveanu (fosta Scoala nr. 3, intrare elevi)",1,6808,"ORAŞ DĂBULENI",72007,1366,1062,993,61,8,1046,16,1500,438,758,288
17,"DOLJ",163,72007,,209,"DĂBULENI / Liceul Teoretic Constantin Brancoveanu (fosta Scoala nr. 3, intrare profesori)",1,6808,"ORAŞ DĂBULENI",72007,1317,944,863,52,29,932,12,1400,456,696,236
17,"DOLJ",163,70414,,210,"FILIAŞI / SCOALA GIMNAZIALA FILIASI",1,6811,"ORAŞ FILIAŞI",70414,1290,752,707,45,0,737,15,1400,648,470,267
17,"DOLJ",163,70414,,211,"FILIAŞI / PRIMĂRIA ORAŞULUI FILIAŞI",1,6811,"ORAŞ FILIAŞI",70414,1848,1033,986,45,2,1014,19,1900,867,609,405
17,"DOLJ",163,70414,,212,"FILIAŞI / LICEUL TEHNOLOGIC DIMITRIE FILIŞANU",1,6811,"ORAŞ FILIAŞI",70414,1552,787,724,63,0,777,10,1700,913,524,253
17,"DOLJ",163,70414,,213,"FILIAŞI / GRĂDINIŢA NR.2 FILIAŞI",1,6811,"ORAŞ FILIAŞI",70414,1825,976,859,70,47,959,17,2000,1024,615,344
17,"DOLJ",163,70414,,214,"FILIAŞI / CASA DE CULTURĂ",1,6811,"ORAŞ FILIAŞI",70414,1437,870,727,141,2,862,8,1500,630,481,381
17,"DOLJ",163,70414,,215,"FILIAŞI / GRĂDINIŢA NR.3 FILIAŞI",1,6811,"ORAŞ FILIAŞI",70414,1368,731,693,36,2,725,6,1500,769,432,293
17,"DOLJ",163,70414,,216,"FILIAŞI / GRĂDINIŢA NR.1 FILIAŞI",1,6811,"ORAŞ FILIAŞI",70414,1885,1072,1012,56,4,1052,20,2000,928,648,404
17,"DOLJ",163,70414,,217,"RĂCARII DE SUS / SCOALA RĂCARII DE SUS",1,6811,"ORAŞ FILIAŞI",70414,962,623,546,77,0,621,2,1100,477,452,169
17,"DOLJ",163,70414,,218,"FILIAŞI / SCOALA GIMNAZIALA FRATOŞTIŢA -CORP 1",1,6811,"ORAŞ FILIAŞI",70414,1283,709,685,23,1,703,6,1400,691,458,245
17,"DOLJ",163,70414,,219,"FILIAŞI / ŞCOALA GIMNAZIALĂ FRATOŞTITA -CORP 2",1,6811,"ORAŞ FILIAŞI",70414,797,434,401,33,0,422,12,900,466,262,160
17,"DOLJ",163,70414,,220,"FILIAŞI / SCOALA BÎLTA",1,6811,"ORAŞ FILIAŞI",70414,927,623,584,32,7,617,6,1000,377,435,182
17,"DOLJ",163,70502,,221,"SEGARCEA / LICEUL TEHNOLOGIC HORIA VINTILĂ",1,6819,"ORAŞ SEGARCEA",70502,1728,1046,921,104,21,1033,13,1900,854,810,223
17,"DOLJ",163,70502,,222,"SEGARCEA / SCOALA CU CLASELE I-VIII",1,6819,"ORAŞ SEGARCEA",70502,1444,670,630,40,0,663,7,1500,830,492,171
17,"DOLJ",163,70502,,223,"SEGARCEA / BIBLIOTECA ORĂŞENEASCĂ MIRCEA RĂDINA",1,6819,"ORAŞ SEGARCEA",70502,1615,1014,941,73,0,1003,11,1700,686,751,252
17,"DOLJ",163,70502,,224,"SEGARCEA / CLUBUL COPIILOR",1,6819,"ORAŞ SEGARCEA",70502,1656,932,858,74,0,915,17,1800,868,686,229
17,"DOLJ",163,70520,,225,"AFUMAŢI / Consiliul Local Afumati",3,6821,"AFUMAŢI",70520,1000,613,515,94,4,606,7,1100,487,328,278
17,"DOLJ",163,70520,,226,"BOURENI / Caminul Cultural Boureni",3,6821,"AFUMAŢI",70520,899,630,498,102,30,626,4,1000,370,445,181
17,"DOLJ",163,70520,,227,"COVEI / Caminul Cultural Covei",3,6821,"AFUMAŢI",70520,423,329,255,67,7,327,2,500,171,239,88
17,"DOLJ",163,70566,,228,"ALMĂJ / Şcoala Gimnazială ""Ion Ghe. Pleşa""",3,6825,"ALMĂJ",70566,1163,916,696,220,0,909,7,1300,384,459,450
17,"DOLJ",163,70566,,229,"ŞITOAIA / Şcoala Primară Şitoaia",3,6825,"ALMĂJ",70566,528,431,326,105,0,426,5,600,169,289,137
17,"DOLJ",163,70637,,230,"AMĂRĂŞTII DE JOS / caminul cultural Amarastii de Jos",3,6830,"AMĂRĂŞTII DE JOS",70637,1248,952,792,105,55,946,6,1298,346,584,362
17,"DOLJ",163,70637,,231,"AMĂRĂŞTII DE JOS / GRADINITA TOSCA",3,6830,"AMĂRĂŞTII DE JOS",70637,1086,754,660,70,24,746,8,1200,446,521,225
17,"DOLJ",163,70637,,232,"PRAPOR / GRĂDINIŢA PRAPOR",3,6830,"AMĂRĂŞTII DE JOS",70637,1164,818,739,54,25,809,9,1300,482,610,199
17,"DOLJ",163,70637,,233,"OCOLNA / ŞCOALA GENERALĂ OCOLNA",3,6830,"AMĂRĂŞTII DE JOS",70637,884,617,601,16,0,606,11,1000,383,539,67
17,"DOLJ",163,70673,,234,"AMĂRĂŞTII DE SUS / Căminul Cultural",3,6834,"AMĂRĂŞTII DE SUS",70673,1378,1299,986,235,78,1291,8,1500,201,1026,265
17,"DOLJ",163,70726,,235,"APELE VII / Căminul Cultural",3,6837,"APELE VII",70726,1768,1421,1114,307,0,1399,22,1900,479,672,727
17,"DOLJ",163,70744,,236,"ARGETOAIA / ŞCOALA PROFESIONALĂ C-TIN ARGETOAIANU",3,6839,"ARGETOAIA",70744,1059,805,566,238,1,798,7,1200,395,632,166
17,"DOLJ",163,70744,,237,"ARGETOAIA / ŞCOALA PROFESIONALĂ C-TIN ARGETOAIANU",3,6839,"ARGETOAIA",70744,672,481,366,115,0,476,5,800,319,385,91
17,"DOLJ",163,70744,,238,"SALCIA / ŞCOALA. GIMNAZIALĂ SALCIA",3,6839,"ARGETOAIA",70744,976,802,659,142,1,794,8,1100,298,595,199
17,"DOLJ",163,70744,,239,"PIRIA / ŞCOALA. PRIMARĂ PIRIA",3,6839,"ARGETOAIA",70744,326,250,218,32,0,248,2,400,150,226,22
17,"DOLJ",163,70744,,240,"LEORDOASA / ŞCOALA. PRIMARĂ LEORDOASA",3,6839,"ARGETOAIA",70744,367,305,226,79,0,303,2,500,195,215,88
17,"DOLJ",163,70744,,241,"NOVAC / GRĂDINIŢA CU PROGRAM NORMAL NOVACU",3,6839,"ARGETOAIA",70744,209,150,134,16,0,149,1,300,150,107,42
17,"DOLJ",163,70897,,242,"BISTREŢ / ŞCOALA GIMNAZIALĂ BISTREŢ",3,6854,"BISTREŢ",70897,1280,946,747,199,0,938,8,1400,454,723,215
17,"DOLJ",163,70897,,243,"BISTREŢ / ŞCOALA GIMNAZIALĂ BISTREŢ",3,6854,"BISTREŢ",70897,616,539,383,156,0,530,9,700,161,390,140
17,"DOLJ",163,70897,,244,"BISTREŢU NOU / ŞCOALA PRIMARĂ BISTRETU NOU",3,6854,"BISTREŢ",70897,655,447,339,108,0,442,5,800,353,336,106
17,"DOLJ",163,70897,,245,"PLOSCA / ŞCOALA PRIMARĂ PLOSCA",3,6854,"BISTREŢ",70897,804,632,525,107,0,628,4,900,268,481,147
17,"DOLJ",163,70940,,246,"BÎRCA / Căminul Cultural",3,6852,"BÎRCA",70940,1703,1061,930,131,0,1054,7,1800,739,690,364
17,"DOLJ",163,70940,,247,"BÎRCA / Grădiniţa de copii",3,6852,"BÎRCA",70940,1462,886,778,108,0,879,7,1600,714,467,412
17,"DOLJ",163,70968,,248,"BOTOŞEŞTI-PAIA / CĂMINUL CULTURAL",3,6859,"BOTOŞEŞTI-PAIA",70968,626,603,418,110,75,596,7,700,97,461,135
17,"DOLJ",163,70986,,249,"BRABOVA / CĂMINUL CULTURAL BRABOVA",3,6861,"BRABOVA",70986,478,392,289,103,0,389,3,600,208,286,103
17,"DOLJ",163,70986,,250,"URDINIŢA / CĂMINUL CULTURAL URDINIŢA",3,6861,"BRABOVA",70986,275,234,178,56,0,234,0,399,165,179,55
17,"DOLJ",163,70986,,251,"RĂCHITA DE JOS / CĂMINUL CULTURAL RĂCHITA DE JOS",3,6861,"BRABOVA",70986,253,185,138,47,0,185,0,300,115,130,55
17,"DOLJ",163,70986,,252,"MOSNA / ŞCOALA CU CLASELE I-IV MOSNA",3,6861,"BRABOVA",70986,152,115,91,24,0,115,0,200,85,74,41
17,"DOLJ",163,71126,,253,"BRALOŞTIŢA / SALA DE SEDINŢE A CONSILIULUI LOCAL BRALOŞTIŢA",3,6875,"BRALOŞTIŢA",71126,624,427,381,46,0,421,6,700,273,316,105
17,"DOLJ",163,71126,,254,"SFÎRCEA / SCOALA DIN SATUL SFIRCEA",3,6875,"BRALOŞTIŢA",71126,827,576,525,51,0,573,3,1000,424,343,230
17,"DOLJ",163,71126,,255,"VALEA FÎNTÎNILOR / ŞCOALA DIN SATUL VALEA FÎNTÎNILOR",3,6875,"BRALOŞTIŢA",71126,519,327,309,18,0,325,2,600,273,142,183
17,"DOLJ",163,71126,,256,"CIOCANELE / ŞCOALA DIN SATUL CIOCANE",3,6875,"BRALOŞTIŢA",71126,601,391,381,10,0,385,6,700,309,209,176
17,"DOLJ",163,71126,,257,"SCHITU / ŞCOALA DIN SATUL SCHITU",3,6875,"BRALOŞTIŢA",71126,382,236,221,15,0,232,4,500,264,142,90
17,"DOLJ",163,71199,,258,"BĂDOŞI / ŞCOALA PRIMARĂ BĂDOŞI",3,6882,"BRATOVOEŞTI",71199,736,599,502,89,8,590,9,900,301,458,132
17,"DOLJ",163,71199,,259,"PRUNET / ŞCOALA PRIMARĂ PRUNET",3,6882,"BRATOVOEŞTI",71199,463,380,313,67,0,378,2,600,220,265,113
17,"DOLJ",163,71199,,260,"BRATOVOEŞTI / ŞCOALA GIMNAZIALĂ BRATOVOEŞTI",3,6882,"BRATOVOEŞTI",71199,1078,769,690,79,0,762,7,1200,431,548,214
17,"DOLJ",163,71199,,261,"GEOROCU MARE / ŞCOALA PRIMARĂ GEOROCU MARE",3,6882,"BRATOVOEŞTI",71199,409,331,263,63,5,330,1,497,165,251,79
17,"DOLJ",163,71055,,262,"BRĂDEŞTI / Scoala Generala Bradesti",3,6868,"BRĂDEŞTI",71055,1506,1147,889,258,0,1144,3,1700,553,796,348
17,"DOLJ",163,71055,,263,"BRĂDEŞTII BĂTRÎNI / Scoala  Generala  Bradesti Batrini",3,6868,"BRĂDEŞTI",71055,327,261,209,52,0,259,2,400,139,195,64
17,"DOLJ",163,71055,,264,"TATOMIREŞTI / Scoala  Generala Tatomiresti",3,6868,"BRĂDEŞTI",71055,824,581,547,34,0,571,10,1000,419,438,133
17,"DOLJ",163,71055,,265,"RĂCARII DE JOS / Scoala  Generala Racarii de  jos",3,6868,"BRĂDEŞTI",71055,905,746,648,98,0,740,6,1000,254,611,129
17,"DOLJ",163,71055,,266,"PISCANI / Scoala   Generala  Piscani",3,6868,"BRĂDEŞTI",71055,94,60,49,11,0,60,0,201,141,41,19
17,"DOLJ",163,71260,,267,"BREASTA / ŞCOALA BREASTA",3,6887,"BREASTA",71260,1146,650,550,100,0,645,5,1300,650,323,322
17,"DOLJ",163,71260,,268,"BREASTA / ŞCOALA BREASTA",3,6887,"BREASTA",71260,928,611,495,116,0,602,9,1100,489,286,316
17,"DOLJ",163,71260,,269,"VALEA LUNGULUI / ŞCOALA VALEA LUNGULUI",3,6887,"BREASTA",71260,520,281,260,21,0,279,2,599,318,173,106
17,"DOLJ",163,71260,,270,"OBEDIN / ŞCOALA OBEDIN",3,6887,"BREASTA",71260,650,309,271,38,0,302,7,800,491,151,151
17,"DOLJ",163,69964,,271,"BUCOVĂŢ / Scoala Generala cu clasele l-Vlll Bucovat",3,6895,"BUCOVĂŢ",69964,1562,1145,915,229,1,1138,7,1700,555,641,497
17,"DOLJ",163,69964,,272,"LEAMNA DE JOS / Scoala Generala cu clasele l-lV Leamna de Jos",3,6895,"BUCOVĂŢ",69964,281,248,189,59,0,246,2,400,152,156,90
17,"DOLJ",163,69964,,273,"LEAMNA DE SUS / Scoala Generala cu clasele l-lV Leamna de Sus",3,6895,"BUCOVĂŢ",69964,321,333,196,97,40,330,3,500,167,217,113
17,"DOLJ",163,69964,,274,"SĂRBĂTOAREA / Scoala Generala cu clasele l-Vlll Sarbatoarea",3,6895,"BUCOVĂŢ",69964,603,414,322,92,0,406,8,700,286,291,115
17,"DOLJ",163,69964,,275,"PALILULA / Scoala Generala cu clasele l-Vlll Palilula",3,6895,"BUCOVĂŢ",69964,628,368,308,60,0,360,8,700,332,203,157
17,"DOLJ",163,71340,,276,"BULZEŞTI / Căminul Cultural",3,6903,"BULZEŞTI",71340,677,525,385,140,0,521,4,800,275,365,156
17,"DOLJ",163,71340,,277,"SĂLIŞTE / Punct informare, Primăria Bulzeşti",3,6903,"BULZEŞTI",71340,564,456,328,126,2,454,2,700,244,324,130
17,"DOLJ",163,71457,,278,"CALOPĂR / Şcoala cu cls.I-VIII Calopăr",3,6917,"CALOPĂR",71457,1080,716,558,158,0,710,6,1200,484,511,199
17,"DOLJ",163,71457,,279,"BELCINU / Şcoala cu cls I-VIII Belcinu",3,6917,"CALOPĂR",71457,457,317,264,53,0,316,1,600,283,219,97
17,"DOLJ",163,71457,,280,"PANAGHIA / Şcoala cu cls I-IV Panaghia",3,6917,"CALOPĂR",71457,559,397,328,69,0,394,3,700,303,251,143
17,"DOLJ",163,71457,,281,"SĂLCUŢA / Cămin Cultural Sălcuţa",3,6917,"CALOPĂR",71457,824,417,348,69,0,415,2,1000,583,375,40
17,"DOLJ",163,71518,,282,"CARAULA / Căminul Cultural",3,6923,"CARAULA",71518,1932,1405,1256,117,32,1389,16,2100,695,1201,188
17,"DOLJ",163,71536,,283,"CARPEN / Căminul Cultural Carpen",3,6929,"CARPEN",71536,828,797,728,69,0,797,0,1000,203,740,57
17,"DOLJ",163,71536,,284,"CLEANOV / Căminul Cultural Cleanov",3,6929,"CARPEN",71536,1141,837,770,67,0,826,11,1300,463,665,161
17,"DOLJ",163,71572,,285,"CASTRANOVA / Caminul Cultural",3,6933,"CASTRANOVA",71572,1523,1061,921,140,0,1045,16,1700,639,517,528
17,"DOLJ",163,71572,,286,"PUŢURI / Şcoala Puţuri",3,6933,"CASTRANOVA",71572,1093,800,637,163,0,797,3,1200,400,457,340
17,"DOLJ",163,74842,,287,"CATANE / SCOALA GIMNAZIALA CATANE",3,6936,"CATANE",74842,1403,953,776,111,66,939,14,1500,547,708,231
17,"DOLJ",163,71607,,288,"CĂLĂRAŞI / CĂMINUL CULTURAL",3,6914,"CĂLĂRAŞI",71607,1521,1057,924,92,41,1049,8,1700,643,735,314
17,"DOLJ",163,71607,,289,"CĂLĂRAŞI / ŞCOALA  GIMNAZIALĂ  NR. 1 CĂLĂRAŞI",3,6914,"CĂLĂRAŞI",71607,1844,1245,1116,88,41,1230,15,2000,755,902,328
17,"DOLJ",163,71607,,290,"SĂRATA / ŞCOALA GIMNAZIALĂ SĂRATA",3,6914,"CĂLĂRAŞI",71607,1691,1244,1133,74,37,1234,10,1800,556,963,271
17,"DOLJ",163,74859,,291,"CÂRCEA / FOSTA SCOALA GENERALA CARCEA",3,6925,"CÂRCEA",74859,1841,1655,1177,403,75,1639,16,2100,445,1033,606
17,"DOLJ",163,74867,,292,"CÂRNA / SCOALA CU CLS. I-VIII CÂRNA",3,6927,"CÂRNA",74867,1164,833,693,125,15,824,9,1300,467,546,278
17,"DOLJ",163,71634,,293,"CELARU / SCOALA NOUA CELARU",3,6939,"CELARU",71634,1547,988,852,103,33,979,9,1700,712,706,273
17,"DOLJ",163,71634,,294,"MAROTINU DE JOS / CAMIN CULTURAL MAROTINU DE JOS",3,6939,"CELARU",71634,459,362,289,63,10,355,7,600,238,254,101
17,"DOLJ",163,71634,,295,"GHIZDĂVEŞTI / CAMIN CULTURAL GHIZDAVESTI",3,6939,"CELARU",71634,1242,810,672,117,21,795,15,1400,590,550,245
17,"DOLJ",163,71634,,296,"MAROTINU DE SUS / CAMIN CULTURAL MAROTINU DE SUS",3,6939,"CELARU",71634,456,340,250,85,5,337,3,600,260,233,104
17,"DOLJ",163,71698,,297,"CERĂT / CAMINUL CULTURAL CERAT",3,6945,"CERĂT",71698,1912,1259,1080,165,14,1242,17,2100,841,972,270
17,"DOLJ",163,71698,,298,"CERĂT / SCOALA GIMNAZIALA CERĂT - LOCALUL NR. 3",3,6945,"CERĂT",71698,1145,512,456,46,10,499,13,1300,788,376,123
17,"DOLJ",163,71723,,299,"CERNĂTEŞTI / Căminul Cultural",3,6948,"CERNĂTEŞTI",71723,426,316,246,55,15,313,3,500,184,192,121
17,"DOLJ",163,71723,,300,"ŢIU / Grădiniţă",3,6948,"CERNĂTEŞTI",71723,393,328,265,56,7,323,5,500,172,223,100
17,"DOLJ",163,71723,,301,"CORNIŢA / Şcoala Generală",3,6948,"CERNĂTEŞTI",71723,246,186,158,25,3,184,2,300,114,145,39
17,"DOLJ",163,71723,,302,"RASNICU OGHIAN / Şcoala Generală",3,6948,"CERNĂTEŞTI",71723,430,330,275,54,1,328,2,500,170,231,97
17,"DOLJ",163,71787,,303,"CETATE / SCOALA CU CLS. I-IV CETATE",3,6954,"CETATE",71787,1683,1282,1203,72,7,1267,15,1800,518,1106,161
17,"DOLJ",163,71787,,304,"CETATE / CĂMINUL CULTURAL CETATE",3,6954,"CETATE",71787,1437,963,820,87,56,954,9,1600,637,807,147
17,"DOLJ",163,71787,,305,"CETATE / SCOALA CU CLS. I-VIII F-B",3,6954,"CETATE",71787,809,417,364,50,3,416,1,1000,583,329,87
17,"DOLJ",163,71787,,306,"MORENI / SCOALA CU CLS. I-IV MORENI",3,6954,"CETATE",71787,480,357,329,28,0,353,4,600,243,281,72
17,"DOLJ",163,71812,,307,"CIOROIAŞI / ŞCOALA CU CLASELE I-VIII CIOROIAŞI",3,6957,"CIOROIAŞI",71812,896,638,512,126,0,632,6,1000,362,403,229
17,"DOLJ",163,71812,,308,"CIOROIU NOU / ŞCOALA CU CLASELE I-IV CIOROIU NOU",3,6957,"CIOROIAŞI",71812,415,376,254,121,1,373,3,500,124,253,120
17,"DOLJ",163,71858,,309,"CIUPERCENII NOI / CAMIN CULTURAL CIUPERCENII NOI",3,6961,"CIUPERCENII NOI",71858,1544,1103,1009,77,17,1096,7,1700,597,912,184
17,"DOLJ",163,71858,,310,"CIUPERCENII NOI / SCOALA GENERALA CIUPERCENII NOI",3,6961,"CIUPERCENII NOI",71858,1888,1268,1147,100,21,1253,15,2000,732,960,293
17,"DOLJ",163,71858,,311,"SMÎRDAN / SCOALA GENERALA SMÎRDAN",3,6961,"CIUPERCENII NOI",71858,1074,650,580,59,11,641,9,1200,550,449,192
17,"DOLJ",163,71885,,312,"COŞOVENI / Camin Cultural",3,6964,"COŞOVENI",71885,883,698,528,160,10,694,4,1000,302,387,307
17,"DOLJ",163,71885,,313,"COŞOVENI / GRADINITA NR. 1",3,6964,"COŞOVENI",71885,1072,830,718,105,7,819,11,1200,370,511,308
17,"DOLJ",163,71885,,314,"COŞOVENI / GRADINITA NR. 2",3,6964,"COŞOVENI",71885,679,587,431,145,11,576,11,800,213,380,196
17,"DOLJ",163,71910,,315,"COŢOFENII DIN DOS / Scoala Gimnaziala Cotofenii din Dos",3,6966,"COŢOFENII DIN DOS",71910,859,583,528,55,0,578,5,1000,417,351,227
17,"DOLJ",163,71910,,316,"POTMELŢU / Gradinita cu pogram normal Potmeltu",3,6966,"COŢOFENII DIN DOS",71910,435,300,271,29,0,296,4,500,200,144,152
17,"DOLJ",163,71910,,317,"MIHĂIŢA / Scoala Gimnaziala Mihaita",3,6966,"COŢOFENII DIN DOS",71910,646,409,356,53,0,404,5,800,391,253,151
17,"DOLJ",163,74875,,318,"COŢOFENII DIN FAŢĂ / ŞCOALA CU CLASELE I-VIII COŢOFENII DIN FAŢĂ",3,6970,"COŢOFENII DIN FAŢĂ",74875,1252,915,693,222,0,907,8,1400,485,625,282
17,"DOLJ",163,74875,,319,"BEHARCA / ŞCOALA CU CLASELE I-IV",3,6970,"COŢOFENII DIN FAŢĂ",74875,258,243,174,69,0,240,3,300,57,144,96
17,"DOLJ",163,71956,,320,"DANEŢI / Căminul Cultural Daneţi",3,6973,"DANEŢI",71956,1718,899,824,75,0,887,12,1900,1001,540,347
17,"DOLJ",163,71956,,321,"DANEŢI / Şcoala Profesională Daneţi",3,6973,"DANEŢI",71956,1472,846,733,113,0,837,9,1600,754,462,375
17,"DOLJ",163,71956,,322,"BRANIŞTE / Şcoala Generală cu clasele I-VIII Branişte",3,6973,"DANEŢI",71956,514,326,268,58,0,321,5,600,274,184,137
17,"DOLJ",163,71956,,323,"LOCUSTENI / Şcoala Generală cu clasele I-IV Locusteni",3,6973,"DANEŢI",71956,500,301,246,55,0,300,1,600,299,177,123
17,"DOLJ",163,71956,,324,"BRABEŢI / Şcoala Generală cu clasele I-VIII Brabeţi",3,6973,"DANEŢI",71956,842,612,496,116,0,606,6,1000,388,289,317
17,"DOLJ",163,72034,,325,"DESA / Şcoala Gimnazială Desa",3,6978,"DESA",72034,1184,727,681,46,0,722,5,1304,577,537,185
17,"DOLJ",163,72034,,326,"DESA / Şcoala Gimnazială Desa",3,6978,"DESA",72034,1369,872,838,34,0,870,2,1500,628,696,174
17,"DOLJ",163,72034,,327,"DESA / Şcoala Gimnazială Desa",3,6978,"DESA",72034,1338,801,774,27,0,793,8,1500,699,629,164
17,"DOLJ",163,72052,,328,"DIOŞTI / CLUB CAMIN CULTURAL DIOSTI",3,6980,"DIOŞTI",72052,1013,732,585,110,37,728,4,1200,468,467,261
17,"DOLJ",163,72052,,329,"RADOMIR / SCOALA GENERALA CU CLASELE I-IV RADOMIR",3,6980,"DIOŞTI",72052,889,570,477,63,30,564,6,1000,430,439,125
17,"DOLJ",163,72052,,330,"CIOCĂNEŞTI / SCOALA GENERALA CU CLASELE I-VIII CIOCANESTI",3,6980,"DIOŞTI",72052,616,427,337,68,22,423,4,700,273,299,124
17,"DOLJ",163,72098,,331,"DOBREŞTI / ŞCOALA DOBREŞTI",3,6984,"DOBREŞTI",72098,344,257,188,66,3,254,3,396,139,161,93
17,"DOLJ",163,72098,,332,"MURTA / ŞCOALA MURTA",3,6984,"DOBREŞTI",72098,733,483,399,81,3,483,0,900,417,296,187
17,"DOLJ",163,72098,,333,"TOCENI / ŞCOALA TOCENI",3,6984,"DOBREŞTI",72098,533,420,336,65,19,419,1,600,180,332,87
17,"DOLJ",163,72098,,334,"CĂCIULĂTEŞTI / ŞCOALA CĂCIULĂTEŞTI",3,6984,"DOBREŞTI",72098,418,306,250,53,3,304,2,500,194,207,97
17,"DOLJ",163,74883,,335,"DOBROTEŞTI / Căminul Cultural",3,6990,"DOBROTEŞTI",74883,1426,978,843,135,0,961,17,1600,622,595,366
17,"DOLJ",163,72150,,336,"VIIŞOARA / Scoala cu cls. I - IV Viişoara",3,6993,"DRĂGOTEŞTI",72150,431,360,290,58,12,355,5,502,142,261,94
17,"DOLJ",163,72150,,337,"DRĂGOTEŞTI / Scoala veche Drăgoteşti",3,6993,"DRĂGOTEŞTI",72150,389,340,269,56,15,334,6,500,160,250,84
17,"DOLJ",163,72150,,338,"BENEŞTI / Scoala cu cls. I - IV Beneşti",3,6993,"DRĂGOTEŞTI",72150,359,289,238,41,10,285,4,397,108,233,52
17,"DOLJ",163,72150,,339,"POPÎNZĂLEŞTI / Scoala cu cls. I - IV Popînzăleşti",3,6993,"DRĂGOTEŞTI",72150,470,416,307,92,17,410,6,600,184,259,151
17,"DOLJ",163,72150,,340,"BUZDUC / Scoala cu cls. I - IV Buzduc",3,6993,"DRĂGOTEŞTI",72150,126,130,81,38,11,126,4,200,70,102,24
17,"DOLJ",163,72221,,341,"DRĂNIC / CAMINUL CULTURAL DRANIC",3,7000,"DRĂNIC",72221,882,669,520,143,6,662,7,1000,331,330,332
17,"DOLJ",163,72221,,342,"PADEA / CAMINUL CULTURAL PADEA",3,7000,"DRĂNIC",72221,696,563,432,124,7,557,6,800,237,303,254
17,"DOLJ",163,72221,,343,"BOOVENI / SCOALA CU CLASELE I-IV BOOVENI",3,7000,"DRĂNIC",72221,286,239,185,54,0,239,0,407,168,170,69
17,"DOLJ",163,72221,,344,"FOIŞOR / SCOALA CU CLASELE I-IV FOISOR",3,7000,"DRĂNIC",72221,247,210,158,50,2,208,2,300,90,129,79
17,"DOLJ",163,72276,,345,"FĂRCAŞ / CAMINUL CULTURAL FARCAS",3,7005,"FĂRCAŞ",72276,1002,685,601,84,0,681,4,1200,515,512,169
17,"DOLJ",163,72276,,346,"GOLUMBU / SCOALA GENERALA GOLUMBU",3,7005,"FĂRCAŞ",72276,646,504,431,73,0,500,4,800,296,416,84
17,"DOLJ",163,72383,,347,"GALICEA MARE / ŞCOALA GIMNAZIALĂ CORP 3",3,7011,"GALICEA MARE",72383,1223,871,718,153,0,865,6,1400,529,423,442
17,"DOLJ",163,72383,,348,"GALICEA MARE / ŞCOALA GIMNAZIALĂ -CORP 4",3,7011,"GALICEA MARE",72383,946,616,536,80,0,611,5,1100,484,294,317
17,"DOLJ",163,72383,,349,"GALICEA MARE / ŞCOALA GIMNAZIALĂ - CORP 4",3,7011,"GALICEA MARE",72383,1261,879,789,90,0,879,0,1400,521,458,421
17,"DOLJ",163,74891,,350,"GALICIUICA / CAMINUL CULTURAL",3,7013,"GALICIUICA",74891,1150,1101,772,302,27,1089,12,1300,199,858,231
17,"DOLJ",163,72409,,351,"GHERCEŞTI / Căminul Cultural",3,7015,"GHERCEŞTI",72409,768,852,526,315,11,841,11,900,48,463,378
17,"DOLJ",163,72409,,352,"GÎRLEŞTI / Şcoala Generală Gârleşti",3,7015,"GHERCEŞTI",72409,361,337,252,81,4,335,2,500,163,203,132
17,"DOLJ",163,72409,,353,"UNGURENI / Şcoala Generală Ungureni",3,7015,"GHERCEŞTI",72409,277,329,184,143,2,326,3,400,71,212,114
17,"DOLJ",163,74907,,354,"GHIDICI / Căminul Cultural",3,7021,"GHIDICI",74907,1804,1441,1171,141,129,1427,14,2000,559,1196,231
17,"DOLJ",163,74915,,355,"GHINDENI / CAMIN CULTURAL",3,7023,"GHINDENI",74915,1527,1335,1029,306,0,1325,10,1700,365,574,751
17,"DOLJ",163,72463,,356,"GIGHERA / CĂMINUL CULTURAL GIGHERA",3,7025,"GIGHERA",72463,987,625,516,82,27,617,8,1099,474,499,118
17,"DOLJ",163,72463,,357,"NEDEIA / CĂMINUL CULTURAL NEDEIA",3,7025,"GIGHERA",72463,768,565,415,134,16,561,4,900,335,417,144
17,"DOLJ",163,72463,,358,"ZĂVAL / CĂMINUL CULTURAL ZĂVAL",3,7025,"GIGHERA",72463,656,467,375,77,15,458,9,800,333,339,119
17,"DOLJ",163,72506,,359,"GIUBEGA / Camin Cultural",3,7032,"GIUBEGA",72506,900,549,468,81,0,543,6,1000,451,266,277
17,"DOLJ",163,72506,,360,"GIUBEGA / scoala veche",3,7032,"GIUBEGA",72506,861,531,464,67,0,528,3,1000,469,201,327
17,"DOLJ",163,72533,,361,"GIURGIŢA / SCOALA GIMNAZIALA GIURGITA",3,7034,"GIURGIŢA",72533,992,746,552,194,0,742,4,1100,354,590,152
17,"DOLJ",163,72533,,362,"GIURGIŢA / GRADINITA PORTARESTI",3,7034,"GIURGIŢA",72533,942,608,530,78,0,602,6,1100,492,498,104
17,"DOLJ",163,72533,,363,"CURMĂTURA / GRADINITA CURMATURA",3,7034,"GIURGIŢA",72533,478,341,254,87,0,339,2,600,259,263,76
17,"DOLJ",163,72579,,364,"GÎNGIOVA / CĂMINUL CULTURAL GÎNGIOVA",3,7029,"GÎNGIOVA",72579,1159,719,614,105,0,712,7,1300,581,508,204
17,"DOLJ",163,72579,,365,"COMOŞTENI / CĂMINUL CULTURAL COMOŞTENI",3,7029,"GÎNGIOVA",72579,882,487,432,55,0,481,6,1000,513,359,122
17,"DOLJ",163,72604,,366,"GOGOŞU / CĂMINUL CULTURAL GOGOŞU",3,7038,"GOGOŞU",72604,219,311,142,161,8,308,3,400,89,176,132
17,"DOLJ",163,72604,,367,"GOGOŞIŢA / ŞCOALA CU CLASELE I-IV",3,7038,"GOGOŞU",72604,171,226,113,112,1,224,2,250,24,124,100
17,"DOLJ",163,72604,,368,"ŞTEFĂNEL / ŞCOALA CU CLASELE I-IV",3,7038,"GOGOŞU",72604,175,280,139,138,3,277,3,350,70,161,116
17,"DOLJ",163,72640,,369,"GOICEA / GRĂDINIŢA NR.1",3,7042,"GOICEA",72640,1288,1081,819,205,57,1071,10,1400,319,795,276
17,"DOLJ",163,72640,,370,"GOICEA / GRĂDINIŢA NR.2",3,7042,"GOICEA",72640,942,738,578,123,37,726,12,1000,262,439,287
17,"DOLJ",163,72677,,371,"GOIEŞTI / CAMIN CULTURAL GOIESTI SALA",3,7044,"GOIEŞTI",72677,1162,813,640,173,0,801,12,1300,487,390,411
17,"DOLJ",163,72677,,372,"MOGOŞEŞTI / SCOALA CLS I-IV MOGOSESTI SALA",3,7044,"GOIEŞTI",72677,466,334,272,62,0,332,2,600,266,168,164
17,"DOLJ",163,72677,,373,"MĂLĂEŞTI / SCOALA CU CLS I-IV MALAESTI SALA",3,7044,"GOIEŞTI",72677,474,382,326,56,0,379,3,600,218,141,238
17,"DOLJ",163,72677,,374,"ŢANDĂRA / SCOALA CU CLS I-VIII TANDARA SALA",3,7044,"GOIEŞTI",72677,460,271,224,47,0,263,8,600,329,103,160
17,"DOLJ",163,72819,,375,"BĂRBOI / ŞCOALA BĂRBOI",3,7058,"GRECEŞTI",72819,309,272,193,67,12,268,4,400,128,190,78
17,"DOLJ",163,72819,,376,"GRECEŞTI / ŞCOALA GRECEŞTI",3,7058,"GRECEŞTI",72819,224,245,154,73,18,243,2,300,55,172,71
17,"DOLJ",163,72819,,377,"BUSU / ŞCOALA BUSU",3,7058,"GRECEŞTI",72819,548,486,384,73,29,480,6,699,213,352,128
17,"DOLJ",163,72819,,378,"GROPANELE / ŞCOALA GROPANELE",3,7058,"GRECEŞTI",72819,257,168,135,32,1,167,1,300,132,119,48
17,"DOLJ",163,70094,,379,"IŞALNIŢA / Fosta scoala cu cls. I-VIII Isalnita",3,7067,"IŞALNIŢA",70094,1656,1502,1132,308,62,1482,20,1800,298,1026,456
17,"DOLJ",163,70094,,380,"IŞALNIŢA / Fosta scoala cu cls. I-VIII Isalnita",3,7067,"IŞALNIŢA",70094,1714,1544,1164,315,65,1532,12,1779,235,1145,387
17,"DOLJ",163,72882,,381,"IZVOARE / GRADINITA IZVOARE",3,7069,"IZVOARE",72882,1068,855,632,223,0,854,1,1200,345,462,392
17,"DOLJ",163,72882,,382,"CORLATE / SCOALA CLASELE I-IV",3,7069,"IZVOARE",72882,281,232,178,54,0,231,1,400,168,162,69
17,"DOLJ",163,74923,,383,"ÎNTORSURA / Scoala Gimnaziala N. GH. Popescu",3,7065,"ÎNTORSURA",74923,1268,930,755,175,0,920,10,1400,470,680,240
17,"DOLJ",163,72926,,384,"LEU / Scoala de fete Leu",3,7073,"LEU",72926,1456,1090,882,201,7,1069,21,1600,510,759,310
17,"DOLJ",163,72926,,385,"LEU / Gradina de vara Leu",3,7073,"LEU",72926,1589,1201,973,214,14,1181,20,1700,499,712,469
17,"DOLJ",163,72926,,386,"ZĂNOAGA / Gradinita  Zănoaga",3,7073,"LEU",72926,988,662,550,99,13,649,13,1100,438,452,197
17,"DOLJ",163,72953,,387,"LIPOVU / SCOALA GIMNAZIALA CLASELE I-VIII  PETRE MANARCESCU",3,7076,"LIPOVU",72953,1313,568,496,72,0,556,12,1500,932,455,101
17,"DOLJ",163,72953,,388,"LIPOVU / LOCAL PRIMĂRIE",3,7076,"LIPOVU",72953,812,381,322,59,0,375,6,900,519,293,82
17,"DOLJ",163,72953,,389,"LIPOVU DE SUS / SCOALA PRIMARA CLSELE I-VIII",3,7076,"LIPOVU",72953,178,94,77,17,0,92,2,200,106,72,20
17,"DOLJ",163,73031,,390,"MAGLAVIT / scoala cu clasele I-VIII MAGLAVIT",3,7084,"MAGLAVIT",73031,1832,1126,981,135,10,1111,15,2000,874,843,268
17,"DOLJ",163,73031,,391,"MAGLAVIT / SCOALA CLASELE I-IV MAGLAVIT",3,7084,"MAGLAVIT",73031,1113,959,836,111,12,959,0,1300,341,768,191
17,"DOLJ",163,73031,,392,"MAGLAVIT / SAT HUNIA",3,7084,"MAGLAVIT",73031,1155,778,655,108,15,775,3,1300,522,597,178
17,"DOLJ",163,73068,,393,"MALU MARE / Liceul Tehnologic ""ing. Ionete Aurelian""",3,7087,"MALU MARE",73068,2010,1257,1026,203,28,1243,14,2100,843,790,453
17,"DOLJ",163,73068,,394,"PREAJBA / Şcoala Primară Preajba",3,7087,"MALU MARE",73068,1317,798,643,155,0,784,14,1500,702,406,378
17,"DOLJ",163,72980,,395,"MĂCEŞU DE JOS / PRIMĂRIA MĂCEŞU DE JOS",3,7079,"MĂCEŞU DE JOS",72980,821,693,560,126,7,680,13,1000,307,527,153
17,"DOLJ",163,72980,,396,"SĂPATA / ŞCOALA SĂPATA",3,7079,"MĂCEŞU DE JOS",72980,273,183,157,26,0,181,2,400,217,121,60
17,"DOLJ",163,73013,,397,"MĂCEŞU DE SUS / CENTRUL CULTURAL",3,7082,"MĂCEŞU DE SUS",73013,1102,909,770,131,8,896,13,1300,391,486,410
17,"DOLJ",163,73102,,398,"MELINEŞTI / CĂMINUL CULTURAL MELINEŞTI",3,7090,"MELINEŞTI",73102,972,697,555,115,27,685,12,1200,503,429,256
17,"DOLJ",163,73102,,399,"NEGOIEŞTI / ŞCOALA  GENERALĂ NEGOIEŞTI",3,7090,"MELINEŞTI",73102,1180,798,678,120,0,790,8,1300,502,510,280
17,"DOLJ",163,73102,,400,"BODĂIEŞTI / SEDIUL FOSTEI ŞCOLI GENERALE BODAIESTI",3,7090,"MELINEŞTI",73102,644,413,365,48,0,404,9,800,387,293,111
17,"DOLJ",163,73102,,401,"BODĂIEŞTII DE SUS / ŞCOALA GENERALĂ BODĂIEŞTII DE SUS",3,7090,"MELINEŞTI",73102,234,177,139,38,0,174,3,300,123,100,74
17,"DOLJ",163,73102,,402,"SPINENI / ŞCOALA GENERALĂ SPINENI",3,7090,"MELINEŞTI",73102,254,205,174,31,0,203,2,300,95,176,27
17,"DOLJ",163,73246,,403,"MISCHII / ŞCOALA GENERALĂ MISCHII",3,7106,"MISCHII",73246,490,486,292,151,43,469,17,600,114,227,242
17,"DOLJ",163,73246,,404,"MLECĂNEŞTI / ŞCOALA GENERALĂ MLECĂNEŞTI",3,7106,"MISCHII",73246,456,397,281,78,38,393,4,516,119,211,182
17,"DOLJ",163,73246,,405,"URECHEŞTI / ŞCOALA GENERALĂ URECHEŞTI",3,7106,"MISCHII",73246,435,390,260,112,18,386,4,500,110,180,206
17,"DOLJ",163,73246,,406,"CĂLINEŞTI / ŞCOALA GENERALĂ CĂLINEŞTI",3,7106,"MISCHII",73246,117,124,66,47,11,124,0,200,76,66,58
17,"DOLJ",163,73317,,407,"MÎRŞANI / Şcoala Generală nr. 2 Mîrşani",3,7104,"MÎRŞANI",73317,1451,1250,1065,134,51,1237,13,1600,350,981,256
17,"DOLJ",163,73317,,408,"MÎRŞANI / Şcoala Generală nr. 1 Mîrşani",3,7104,"MÎRŞANI",73317,1128,939,786,112,41,928,11,1300,361,717,211
17,"DOLJ",163,73317,,409,"MÎRŞANI / Şcoala Generală nr. 3 Mîrşani",3,7104,"MÎRŞANI",73317,1263,1064,905,96,63,1052,12,1400,336,778,274
17,"DOLJ",163,73335,,410,"MOŢĂŢEI GARĂ / ŞCOALA MOŢĂŢEI GARĂ",3,7113,"MOŢĂŢEI",73335,691,410,377,33,0,406,4,800,390,288,118
17,"DOLJ",163,73335,,411,"MOŢĂŢEI / GRĂDINIŢA NR. 2 MOŢĂŢEI",3,7113,"MOŢĂŢEI",73335,1874,1080,1006,74,0,1062,18,2000,920,750,312
17,"DOLJ",163,73335,,412,"MOŢĂŢEI / ŞCOALA NR. 1 MOŢĂŢEI",3,7113,"MOŢĂŢEI",73335,1202,664,590,74,0,657,7,1300,636,476,181
17,"DOLJ",163,73335,,413,"MOŢĂŢEI / GRĂDINIŢA NR. 3 MOŢĂŢEI",3,7113,"MOŢĂŢEI",73335,1637,968,890,78,0,959,9,1800,832,650,309
17,"DOLJ",163,73335,,414,"DOBRIDOR / GRĂDINIŢA NR. 2 DOBRIDOR",3,7113,"MOŢĂŢEI",73335,665,411,350,61,0,404,7,800,389,301,103
17,"DOLJ",163,73371,,415,"MURGAŞI / ŞCOALA CU CLASELE I-VIII MURGAŞI",3,7117,"MURGAŞI",73371,875,697,537,160,0,688,9,1000,303,434,254
17,"DOLJ",163,73371,,416,"BALOTA DE JOS / GRĂDINIŢA BALOTA DE JOS",3,7117,"MURGAŞI",73371,734,540,458,82,0,529,11,900,360,320,209
17,"DOLJ",163,73371,,417,"VELESTI / ŞCOALA CU CLASELE I-IV VELEŞTI",3,7117,"MURGAŞI",73371,420,361,283,77,1,356,5,510,149,188,168
17,"DOLJ",163,73460,,418,"NEGOI / SCOALA GIMNAZIALA NEGOI",3,7126,"NEGOI",73460,918,700,552,92,56,692,8,1100,400,558,134
17,"DOLJ",163,73460,,419,"NEGOI / SCOALA GIMNAZIALA NEGOI",3,7126,"NEGOI",73460,811,527,445,57,25,513,14,900,373,409,104
17,"DOLJ",163,73503,,420,"ORODEL / ŞCOALA GENERALĂ ORODEL",3,7128,"ORODEL",73503,967,691,595,79,17,688,3,1100,409,548,140
17,"DOLJ",163,73503,,421,"CORNU / ŞCOALA GENERALĂ  CORNU",3,7128,"ORODEL",73503,441,406,287,106,13,404,2,500,94,308,96
17,"DOLJ",163,73503,,422,"TEIU / ŞCOALA GENERALĂ  TEIU",3,7128,"ORODEL",73503,199,156,139,16,1,151,5,300,144,112,39
17,"DOLJ",163,73503,,423,"CĂLUGĂREI / ŞCOALA GENERALĂ CĂLUGĂREI",3,7128,"ORODEL",73503,572,467,365,53,49,463,4,700,233,382,81
17,"DOLJ",163,73567,,424,"OSTROVENI / CĂMINUL CULTURAL OSTROVENI",3,7134,"OSTROVENI",73567,1168,732,630,98,4,725,7,1300,568,576,149
17,"DOLJ",163,73567,,425,"OSTROVENI / GRĂDINIŢA DE COPII ORĂŞANI",3,7134,"OSTROVENI",73567,1193,797,693,81,23,796,1,1300,503,662,134
17,"DOLJ",163,73567,,426,"OSTROVENI / GRĂDINIŢA DE COPII GRINDENI",3,7134,"OSTROVENI",73567,588,462,390,68,4,462,0,700,238,434,28
17,"DOLJ",163,73567,,427,"LIŞTEAVA / GRĂDINIŢA DE COPII LISTEAVA",3,7134,"OSTROVENI",73567,1227,644,561,78,5,638,6,1300,656,526,112
17,"DOLJ",163,73594,,428,"PERIŞOR / ŞCOALA PRIMARĂ(LOCAL VECHI)",3,7137,"PERIŞOR",73594,1203,841,610,208,23,834,7,1300,459,552,282
17,"DOLJ",163,73594,,429,"MĂRĂCINELE / ŞCOALA PRIMARĂ CL. I-IV",3,7137,"PERIŞOR",73594,215,175,98,75,2,171,4,300,125,109,62
17,"DOLJ",163,73629,,430,"PIELEŞTI / Şcoala Gimnazială  Pieleşti",3,7140,"PIELEŞTI",73629,1211,685,584,101,0,673,12,1300,615,325,348
17,"DOLJ",163,73629,,431,"PIELEŞTI / SEDIUL FOSTEI ŞCOLI GENERALE NR 2 PIELEŞTI",3,7140,"PIELEŞTI",73629,1150,649,539,110,0,639,10,1300,651,306,333
17,"DOLJ",163,73629,,432,"CÎMPENI / Şcoala Gimnazială Pieleşti",3,7140,"PIELEŞTI",73629,655,382,333,49,0,378,4,800,418,236,142
17,"DOLJ",163,73665,,433,"PISCU VECHI / CAMINUL CULTURAL PISCU VECHI",3,7144,"PISCU VECHI",73665,1990,1359,1240,119,0,1347,12,2100,741,905,442
17,"DOLJ",163,73665,,434,"PISCULEŢ / SCOALA PISCULET",3,7144,"PISCU VECHI",73665,250,223,149,74,0,221,2,300,77,175,46
17,"DOLJ",163,73709,,435,"PLENIŢA / LICEUL TEHNOLOGIC C.N. PLOPSOR",3,7147,"PLENIŢA",73709,1080,729,631,86,12,718,11,1200,471,490,228
17,"DOLJ",163,73709,,436,"PLENIŢA / SCOALA CU CALSELE I-VIII LOCAL B POIANA",3,7147,"PLENIŢA",73709,1008,632,554,61,17,619,13,1100,468,432,187
17,"DOLJ",163,73709,,437,"PLENIŢA / GRADINITA ""ALBA CA ZAPADA""",3,7147,"PLENIŢA",73709,1057,716,594,74,48,691,25,1200,484,454,237
17,"DOLJ",163,73709,,438,"CASTRELE TRAIANE / SCOALA CU CLASELEI-IV DIN SATUL CASTRELE TRAIANE",3,7147,"PLENIŢA",73709,689,495,402,47,46,491,4,800,305,378,113
17,"DOLJ",163,74931,,439,"PLEŞOI / SCOALA GIMNAZIALA PLEŞOI",3,7150,"PLEŞOI",74931,1073,863,719,144,0,854,9,1200,337,759,95
17,"DOLJ",163,70110,,440,"BRANIŞTE / Şcoala generală Branişte",3,7155,"PODARI",70110,666,459,390,69,0,457,2,800,341,413,44
17,"DOLJ",163,70110,,441,"BALTA VERDE / Şcoala generală Balta Verde",3,7155,"PODARI",70110,392,284,245,39,0,280,4,500,216,197,83
17,"DOLJ",163,70110,,442,"PODARI / Primăria Podari",3,7155,"PODARI",70110,1444,834,758,76,0,822,12,1500,666,545,277
17,"DOLJ",163,70110,,443,"PODARI / Şcoala generală Podari",3,7155,"PODARI",70110,1864,929,849,79,1,921,8,1900,971,638,283
17,"DOLJ",163,70110,,444,"LIVEZI / Şcoala generală Livezi",3,7155,"PODARI",70110,762,402,347,55,0,401,1,900,498,315,86
17,"DOLJ",163,70110,,445,"GURA VĂII / Şcoala generală Gura Văii",3,7155,"PODARI",70110,353,273,217,56,0,270,3,400,127,238,32
17,"DOLJ",163,73736,,446,"POIANA MARE / ŞCOALA PRIMARĂ I-IV SÎRBI",3,7161,"POIANA MARE",73736,1550,955,911,44,0,943,12,1700,745,697,246
17,"DOLJ",163,73736,,447,"POIANA MARE / ŞCOALA GENERALĂ DRAGU",3,7161,"POIANA MARE",73736,1625,913,852,61,0,905,8,1800,887,635,270
17,"DOLJ",163,73736,,448,"POIANA MARE / ŞCOALA GENERALĂ 3 CENTRU",3,7161,"POIANA MARE",73736,1396,831,742,89,0,814,17,1500,669,546,268
17,"DOLJ",163,73736,,449,"POIANA MARE / LICEUL GEORGE  ST. MARINCU",3,7161,"POIANA MARE",73736,1336,776,736,40,0,771,5,1500,724,504,267
17,"DOLJ",163,73736,,450,"POIANA MARE / ŞCOALA GENERALĂ TRAISTARU",3,7161,"POIANA MARE",73736,1719,1003,956,47,0,995,8,1800,797,667,328
17,"DOLJ",163,73736,,451,"TUNARII VECHI / ŞCOALA GENERALĂ TUNARII VECHI",3,7161,"POIANA MARE",73736,1109,658,601,57,0,651,7,1197,539,420,231
17,"DOLJ",163,73736,,452,"TUNARII NOI / ŞCOALA GENERALĂ TUNARII NOI",3,7161,"POIANA MARE",73736,427,269,241,27,1,264,5,500,231,194,70
17,"DOLJ",163,73772,,453,"PREDEŞTI / ŞC.GIMNAZIALĂ PREDEŞTI",3,7165,"PREDEŞTI",73772,1683,1014,891,123,0,996,18,1800,786,408,588
17,"DOLJ",163,73852,,454,"RADOVAN / ŞCOALA GIMNAZIALA RADOVAN",3,7169,"RADOVAN",73852,791,617,443,173,1,612,5,900,283,459,153
17,"DOLJ",163,73852,,455,"FÎNTÎNELE / CAMIN CULTURAL FÂNTÂNELE",3,7169,"RADOVAN",73852,81,87,51,36,0,86,1,100,13,48,38
17,"DOLJ",163,73852,,456,"TÎRNAVA / CAMIN CULTURAL TÂRNAVA",3,7169,"RADOVAN",73852,150,157,81,76,0,157,0,200,43,79,78
17,"DOLJ",163,73905,,457,"RAST / SALA 1",3,7173,"RAST",73905,1830,1200,1119,81,0,1187,13,1500,300,779,408
17,"DOLJ",163,73905,,458,"RAST / SEDIUL NOU PRIMĂRIE",3,7173,"RAST",73905,1034,696,628,68,0,693,3,1500,804,552,141
17,"DOLJ",163,73923,,459,"ROBĂNEŞTII DE JOS / Cămin Cultural",3,7175,"ROBĂNEŞTI",73923,528,341,279,62,0,336,5,600,259,251,85
17,"DOLJ",163,73923,,460,"GOLFIN / Şcoala Golfin",3,7175,"ROBĂNEŞTI",73923,534,312,259,53,0,309,3,600,288,244,65
17,"DOLJ",163,73923,,461,"LĂCRIŢA MARE / Şcoala Lăcriţa Mare",3,7175,"ROBĂNEŞTI",73923,480,356,288,68,0,353,3,600,244,195,158
17,"DOLJ",163,73923,,462,"ROBĂNEŞTII DE SUS / Şcoala Robăneştii de Sus",3,7175,"ROBĂNEŞTI",73923,477,333,281,52,0,332,1,600,267,208,124
17,"DOLJ",163,74949,,463,"ROJIŞTE / Scoala gimnaziala Rojiste",3,7182,"ROJIŞTE",74949,1382,1055,884,149,22,1051,4,1500,445,369,682
17,"DOLJ",163,74949,,464,"TÂMBUREŞTI / Şcoala cu  cls.I-IV",3,7182,"ROJIŞTE",74949,522,479,373,85,21,474,5,600,121,234,240
17,"DOLJ",163,73996,,465,"SADOVA / SCOALA GIMNAZIALA STRUCTURA RAIETI",3,7185,"SADOVA",73996,541,326,290,36,0,318,8,600,274,179,139
17,"DOLJ",163,73996,,466,"SADOVA / SCOALA GIMNAZIALA STRUCTURA RAIETI",3,7185,"SADOVA",73996,1191,250,233,17,0,247,3,1300,1050,133,114
17,"DOLJ",163,73996,,467,"SADOVA / SCOALA GIMNAZIALA SADOVA LOCAL VALE",3,7185,"SADOVA",73996,1103,667,625,42,0,658,9,1200,533,367,291
17,"DOLJ",163,73996,,468,"SADOVA / Scoala gimnaziala Sadova, local deal",3,7185,"SADOVA",73996,1230,800,747,29,24,788,12,1300,500,377,411
17,"DOLJ",163,73996,,469,"SADOVA / Şcoala Gimnazială structura Damian",3,7185,"SADOVA",73996,1392,915,820,95,0,902,13,1500,585,394,508
17,"DOLJ",163,73996,,470,"PISCU SADOVEI / Şcoala Gimnazială Sadova, structura Piscu - Sadovei local vechi",3,7185,"SADOVA",73996,994,779,639,126,14,773,6,1100,321,434,339
17,"DOLJ",163,74028,,471,"SĂLCUŢA / ŞCOALA VECHE SĂLCUŢA",3,7188,"SĂLCUŢA",74028,906,482,385,97,0,475,7,1000,518,295,180
17,"DOLJ",163,74028,,472,"TENCĂNĂU / ŞCOALA VECHE TENCĂNĂU",3,7188,"SĂLCUŢA",74028,665,418,322,96,0,416,2,800,382,323,93
17,"DOLJ",163,74073,,473,"SCĂEŞTI / Şcoala generală Scaeşti",3,7193,"SCĂEŞTI",74073,913,702,575,83,44,694,8,1000,298,435,259
17,"DOLJ",163,74073,,474,"VALEA LUI PĂTRU / Şcoala generală Valea lui Pătru",3,7193,"SCĂEŞTI",74073,764,491,447,44,0,487,4,900,409,253,234
17,"DOLJ",163,74108,,475,"SEACA DE CÎMP / Şcoala Gimnazială cu clasele I-VIII din Seaca de Cîmp",3,7196,"SEACA DE CÎMP",74108,803,687,550,87,50,682,5,900,213,490,192
17,"DOLJ",163,74108,,476,"PISCU NOU / Şcoala Gimnazială cu clasele I-VIII Seaca de Cîmp",3,7196,"SEACA DE CÎMP",74108,801,652,538,77,37,646,6,900,248,476,170
17,"DOLJ",163,74135,,477,"SEACA DE PĂDURE / ŞCOALA SEACA DE PĂDURE",3,7199,"SEACA DE PĂDURE",74135,355,399,260,124,15,396,3,400,1,365,31
17,"DOLJ",163,74135,,478,"VELENI / ŞCOALA VELENI",3,7199,"SEACA DE PĂDURE",74135,373,304,231,62,11,295,9,500,196,224,71
17,"DOLJ",163,74135,,479,"RĂCHITA DE SUS / ŞCOALA RĂCHITA DE SUS",3,7199,"SEACA DE PĂDURE",74135,158,143,92,37,14,143,0,200,57,122,21
17,"DOLJ",163,74171,,480,"SECU / ŞCOALA GEN.CLASELE I-IV SECU",3,7203,"SECU",74171,648,500,425,70,5,499,1,800,300,276,223
17,"DOLJ",163,74171,,481,"SMADOVICIOARA DE SECU / ŞCOALA GENERALĂ CU CLS. I-IV SMADOVICIOARA",3,7203,"SECU",74171,174,144,119,25,0,144,0,200,56,57,87
17,"DOLJ",163,74224,,482,"SILIŞTEA CRUCII / CĂMINUL CULTURAL",3,7208,"SILIŞTEA CRUCII",74224,1270,1025,803,213,9,1013,12,1400,375,495,518
17,"DOLJ",163,74242,,483,"SOPOT / SCOALA CU CLASELE I-IV SOPOT",3,7223,"SOPOT",74242,434,284,228,56,0,278,6,500,216,211,67
17,"DOLJ",163,74242,,484,"BELOŢ / SCOALA CU CLASELE I-VIII BELOŢ",3,7223,"SOPOT",74242,265,214,163,51,0,214,0,300,86,166,48
17,"DOLJ",163,74242,,485,"SÎRSCA / SCOALA SÎRSCA",3,7223,"SOPOT",74242,149,101,81,20,0,100,1,200,99,52,48
17,"DOLJ",163,74242,,486,"BAŞCOV / SCOALA CU CLASELE I-IV BAŞCOV",3,7223,"SOPOT",74242,300,213,185,28,0,210,3,400,187,156,54
17,"DOLJ",163,74242,,487,"PIETROAIA / SCOALA CU CLASELE I-IV PIETROAIA",3,7223,"SOPOT",74242,332,246,179,67,0,241,5,400,154,121,120
17,"DOLJ",163,70174,,488,"ALBEŞTI / GRADINITA ALBESTI",3,7210,"ŞIMNICU DE SUS",70174,724,532,390,142,0,525,7,800,268,294,231
17,"DOLJ",163,70174,,489,"DUDOVICEŞTI / SCOALA DUDOVICESTI",3,7210,"ŞIMNICU DE SUS",70174,655,444,326,118,0,431,13,800,356,203,228
17,"DOLJ",163,70174,,490,"FLOREŞTI / CAMIN CULTURAL FLORESTI",3,7210,"ŞIMNICU DE SUS",70174,495,350,260,90,0,348,2,600,250,199,149
17,"DOLJ",163,70174,,491,"IZVOR / SCOALA IZVOR",3,7210,"ŞIMNICU DE SUS",70174,516,405,313,92,0,390,15,600,195,227,163
17,"DOLJ",163,70174,,492,"LEŞILE / GRADINITA LESILE",3,7210,"ŞIMNICU DE SUS",70174,748,498,394,104,0,492,6,800,302,281,211
17,"DOLJ",163,70174,,493,"MILEŞTI / SCOALA MILESTI",3,7210,"ŞIMNICU DE SUS",70174,724,407,345,62,0,404,3,800,393,260,144
17,"DOLJ",163,74956,,494,"TĂLPAŞ / Scoala Gimnaziala Tălpaş",3,7231,"TĂLPAŞ",74956,1032,779,644,135,0,769,10,1200,421,533,236
17,"DOLJ",163,74322,,495,"TEASC / ŞCOALA GIMNAZIALĂ TEASC",3,7237,"TEASC",74322,1400,1033,839,188,6,1027,6,1500,467,669,358
17,"DOLJ",163,74322,,496,"SECUI / ŞCOALA GIMNAZIALĂ SECUI",3,7237,"TEASC",74322,1178,813,709,102,2,805,8,1300,487,484,321
17,"DOLJ",163,74359,,497,"TERPEZIŢA / ŞCOALA GENERALĂ TERPEZIŢA",3,7240,"TERPEZIŢA",74359,756,899,509,366,24,894,5,998,99,713,181
17,"DOLJ",163,74359,,498,"CĂCIULATU / ŞCOALA CU CLASELE I-IV CĂCIULATU",3,7240,"TERPEZIŢA",74359,305,278,216,49,13,275,3,399,121,225,50
17,"DOLJ",163,74359,,499,"LAZU / ŞCOALA CU CLASELE I-IV LAZU",3,7240,"TERPEZIŢA",74359,275,410,169,238,3,405,5,600,190,237,168
17,"DOLJ",163,74411,,500,"TESLUI / SCOALA GIMNAZIALA TESLUI",3,7246,"TESLUI",74411,512,305,267,38,0,300,5,600,295,212,88
17,"DOLJ",163,74411,,501,"PREAJBA DE PĂDURE / ŞCOALA GENERALĂ CLASELE V-VIII PREAJBA DE PĂDURE",3,7246,"TESLUI",74411,689,531,438,93,0,525,6,800,269,324,201
17,"DOLJ",163,74411,,502,"ŢĂRŢĂL / ŞCOALA CLASELE I-IV ŢĂRŢĂL",3,7246,"TESLUI",74411,295,252,205,47,0,250,2,400,148,155,95
17,"DOLJ",163,74411,,503,"URIENI / SCOALA VIISOARA MOSNENI",3,7246,"TESLUI",74411,460,376,308,68,0,372,4,600,224,247,125
17,"DOLJ",163,74509,,504,"ŢUGLUI / Şcoala Gimnazială Ţuglui",3,7255,"ŢUGLUI",74509,1314,871,765,106,0,863,8,1400,529,606,257
17,"DOLJ",163,74509,,505,"ŢUGLUI / Grădiniţa nr 2 Ţuglui",3,7255,"ŢUGLUI",74509,872,667,601,66,0,660,7,900,233,460,200
17,"DOLJ",163,74509,,506,"JIUL / Şcoala cu clasele I-IV Jiul",3,7255,"ŢUGLUI",74509,215,180,138,42,0,179,1,300,120,142,37
17,"DOLJ",163,74536,,507,"UNIREA / SCOALA DIN VALE NR.1",3,7258,"UNIREA",74536,1644,1330,1082,205,43,1313,17,1700,370,994,319
17,"DOLJ",163,74536,,508,"UNIREA / SCOALA NR.2",3,7258,"UNIREA",74536,1465,1075,901,147,27,1063,12,1600,525,721,342
17,"DOLJ",163,74554,,509,"URZICUŢA / Scoala cu cls. I-VIII Barbu Ionescu Urzicuta",3,7260,"URZICUŢA",74554,1873,1136,967,154,15,1122,14,2000,864,903,219
17,"DOLJ",163,74554,,510,"URZICA MARE / Scoala cu cls. I-IV Urzica Mare",3,7260,"URZICUŢA",74554,453,327,265,59,3,325,2,600,273,239,86
17,"DOLJ",163,74581,,511,"VALEA STANCIULUI / Scoala cu clasele I-VIII",3,7263,"VALEA STANCIULUI",74581,1265,827,711,116,0,819,8,1400,573,548,271
17,"DOLJ",163,74581,,512,"HOREZU POENARI / Scoala cu Clasele I-VIII",3,7263,"VALEA STANCIULUI",74581,1325,824,744,80,0,821,3,1400,576,602,219
17,"DOLJ",163,74581,,513,"VALEA STANCIULUI / Gradinita Tuguresti",3,7263,"VALEA STANCIULUI",74581,579,415,340,75,0,413,2,700,285,251,162
17,"DOLJ",163,74581,,514,"VALEA STANCIULUI / Caminul Cultural Birza",3,7263,"VALEA STANCIULUI",74581,676,464,390,74,0,460,4,800,336,341,119
17,"DOLJ",163,74581,,515,"HOREZU POENARI / Scoala cu clasele I-IV",3,7263,"VALEA STANCIULUI",74581,624,469,383,86,0,461,8,700,231,314,147
17,"DOLJ",163,74616,,516,"VELA / ŞCOALA CU CLASELE I-VIII VELA",3,7266,"VELA",74616,391,416,255,135,26,412,4,500,84,361,51
17,"DOLJ",163,74616,,517,"BUCOVICIOR / ŞCOALA CU CLASELE I-IV BUCOVICIOR",3,7266,"VELA",74616,338,297,211,59,27,296,1,400,103,210,86
17,"DOLJ",163,74616,,518,"ŞTIUBEI / ŞCOALA CU CLASELE I-IV STIUBEI",3,7266,"VELA",74616,95,97,60,26,11,96,1,200,103,71,25
17,"DOLJ",163,74616,,519,"GUBAUCEA / ŞCOALA CU CLASELE I-VIII GUBAUCEA",3,7266,"VELA",74616,516,388,320,40,28,387,1,600,212,328,59
17,"DOLJ",163,74616,,520,"SUHARU / ŞCOALA CU CLASELE I-IV SUHARU",3,7266,"VELA",74616,209,222,171,42,9,220,2,300,78,151,69
17,"DOLJ",163,74705,,521,"VERBIŢA / ŞCOALA GIMNAZIALĂ",3,7275,"VERBIŢA",74705,663,429,349,66,14,423,6,800,371,334,89
17,"DOLJ",163,74705,,522,"VERBICIOARA / GRĂDINIŢA CU PROGRAM NORMAL",3,7275,"VERBIŢA",74705,396,303,248,48,7,300,3,500,197,251,49
17,"DOLJ",163,74732,,523,"VÎRTOP / ŞCOALA GIMNAZIALĂ VÎRTOP",3,7278,"VÎRTOP",74732,1352,975,773,202,0,953,22,1400,425,816,137
17,"DOLJ",163,74750,,524,"VÎRVOR / ŞCOALA CU CLASELE I-IV VÎRVOR",3,7280,"VÎRVORU DE JOS",74750,541,437,296,131,10,429,8,600,163,297,132
17,"DOLJ",163,74750,,525,"VÎRVORU DE JOS / ŞCOALA CU CLASELE I-VIII VÎRVORU DE JOS",3,7280,"VÎRVORU DE JOS",74750,974,833,622,180,31,830,3,1100,267,656,174
17,"DOLJ",163,74750,,526,"CIUTURA / SCOALA CU CLASELE I-IV CIUTURA",3,7280,"VÎRVORU DE JOS",74750,625,545,356,167,22,537,8,700,155,380,157
18,"GALAŢI","#N/A",75098,,1,"GALAŢI / Şcoala generală Ion Creangă (şcoala gen.nr.26)",1,7290,"MUNICIPIUL GALAŢI",75098,1294,822,762,60,0,808,14,1415,593,407,401
18,"GALAŢI","#N/A",75098,,2,"GALAŢI / Şcoala generală Ion Creangă (şcoala gen.nr.26)",1,7290,"MUNICIPIUL GALAŢI",75098,1214,792,748,44,0,783,9,1342,550,366,417
18,"GALAŢI","#N/A",75098,,3,"GALAŢI / Şcoala generală Mihai Eminescu (şcoala gen.nr.28)",1,7290,"MUNICIPIUL GALAŢI",75098,1236,890,815,75,0,879,11,1358,468,356,523
18,"GALAŢI","#N/A",75098,,4,"GALAŢI / Şcoala generală Mihai Eminescu (şcoala gen.nr.28)",1,7290,"MUNICIPIUL GALAŢI",75098,1157,783,716,66,1,764,19,1281,498,344,420
18,"GALAŢI","#N/A",75098,,5,"GALAŢI / Şcoala generală Mihai Eminescu (şcoala gen.nr.28)",1,7290,"MUNICIPIUL GALAŢI",75098,1410,900,858,40,2,889,11,1550,650,399,490
18,"GALAŢI","#N/A",75098,,6,"GALAŢI / Şcoala generală Mihai Eminescu (şcoala gen.nr.28)",1,7290,"MUNICIPIUL GALAŢI",75098,1398,931,886,43,2,915,16,1540,609,415,500
18,"GALAŢI","#N/A",75098,,7,"GALAŢI / Şcoala generală Mihai Eminescu (şcoala gen.nr.28)",1,7290,"MUNICIPIUL GALAŢI",75098,932,606,571,35,0,589,17,1025,419,254,335
18,"GALAŢI","#N/A",75098,,8,"GALAŢI / S.C. ""APA-CANAL"" S.A.",1,7290,"MUNICIPIUL GALAŢI",75098,1324,864,815,48,1,846,18,1453,589,386,460
18,"GALAŢI","#N/A",75098,,9,"GALAŢI / S.C. ""APA-CANAL"" S.A.",1,7290,"MUNICIPIUL GALAŢI",75098,1671,1018,982,34,2,997,21,1830,812,421,576
18,"GALAŢI","#N/A",75098,,10,"GALAŢI / S.C. ""APA-CANAL"" S.A.",1,7290,"MUNICIPIUL GALAŢI",75098,1445,895,862,30,3,877,18,1589,694,383,494
18,"GALAŢI","#N/A",75098,,11,"GALAŢI / Scoala generală nr.2",1,7290,"MUNICIPIUL GALAŢI",75098,1563,933,881,51,1,918,15,1725,792,381,537
18,"GALAŢI","#N/A",75098,,12,"GALAŢI / Scoala generală nr.2",1,7290,"MUNICIPIUL GALAŢI",75098,1613,1022,986,35,1,1012,10,1781,759,507,505
18,"GALAŢI","#N/A",75098,,13,"GALAŢI / Liceul Emil Racoviţă (sc gen nr. 6)",1,7290,"MUNICIPIUL GALAŢI",75098,1659,1041,1000,41,0,1019,22,1825,784,458,561
18,"GALAŢI","#N/A",75098,,14,"GALAŢI / Liceul Emil Racoviţă (sc gen nr. 6)",1,7290,"MUNICIPIUL GALAŢI",75098,1342,754,718,34,2,736,18,1477,723,391,345
18,"GALAŢI","#N/A",75098,,15,"GALAŢI / Liceul Emil Racoviţă (sc gen nr. 6)",1,7290,"MUNICIPIUL GALAŢI",75098,1181,635,596,39,0,624,11,1299,664,289,335
18,"GALAŢI","#N/A",75098,,16,"GALAŢI / Colegiul National ""Mihail Kogălniceanu""",1,7290,"MUNICIPIUL GALAŢI",75098,1119,582,521,60,1,575,7,1235,653,275,300
18,"GALAŢI","#N/A",75098,,17,"GALAŢI / Colegiul National ""Mihail Kogălniceanu""",1,7290,"MUNICIPIUL GALAŢI",75098,1230,757,703,52,2,738,19,1356,599,322,416
18,"GALAŢI","#N/A",75098,,18,"GALAŢI / Casa de Cultura a Sindicatelor",1,7290,"MUNICIPIUL GALAŢI",75098,1618,1043,949,92,2,1027,16,1779,736,465,562
18,"GALAŢI","#N/A",75098,,19,"GALAŢI / Casa de Cultura a Sindicatelor",1,7290,"MUNICIPIUL GALAŢI",75098,1602,1024,927,96,1,1004,20,1767,743,435,569
18,"GALAŢI","#N/A",75098,,20,"GALAŢI / Scoala nr.15",1,7290,"MUNICIPIUL GALAŢI",75098,1470,838,799,38,1,821,17,1622,784,389,432
18,"GALAŢI","#N/A",75098,,21,"GALAŢI / Scoala nr.15",1,7290,"MUNICIPIUL GALAŢI",75098,1686,908,855,46,7,900,8,1857,949,459,441
18,"GALAŢI","#N/A",75098,,22,"GALAŢI / Gradinita nr. 15",1,7290,"MUNICIPIUL GALAŢI",75098,1435,768,730,38,0,756,12,1575,807,359,397
18,"GALAŢI","#N/A",75098,,23,"GALAŢI / Gradinita nr. 15",1,7290,"MUNICIPIUL GALAŢI",75098,1410,780,744,35,1,770,10,1547,767,371,399
18,"GALAŢI","#N/A",75098,,24,"GALAŢI / Liceul AL.I.Cuza",1,7290,"MUNICIPIUL GALAŢI",75098,1048,644,581,62,1,629,15,1161,517,289,340
18,"GALAŢI","#N/A",75098,,25,"GALAŢI / Scoala generala Nicolae Balcescu (scoala gen.nr.16)",1,7290,"MUNICIPIUL GALAŢI",75098,1509,890,855,34,1,865,25,1666,776,403,462
18,"GALAŢI","#N/A",75098,,26,"GALAŢI / Scoala generala Nicolae Balcescu (scoala gen.nr.16)",1,7290,"MUNICIPIUL GALAŢI",75098,1339,713,693,20,0,699,14,1482,769,364,335
18,"GALAŢI","#N/A",75098,,27,"GALAŢI / Scoala generala Nicolae Balcescu (scoala gen.nr.16)",1,7290,"MUNICIPIUL GALAŢI",75098,1379,870,824,46,0,854,16,1522,652,333,521
18,"GALAŢI","#N/A",75098,,28,"GALAŢI / Scoala generala Nicolae Balcescu (scoala gen.nr.16)",1,7290,"MUNICIPIUL GALAŢI",75098,1333,778,753,25,0,768,10,1455,677,342,426
18,"GALAŢI","#N/A",75098,,29,"GALAŢI / Colegiul National Vasile Alecsandri",1,7290,"MUNICIPIUL GALAŢI",75098,1444,869,797,71,1,856,13,1586,717,349,507
18,"GALAŢI","#N/A",75098,,30,"GALAŢI / Colegiul National Vasile Alecsandri",1,7290,"MUNICIPIUL GALAŢI",75098,1406,840,792,48,0,821,19,1548,708,357,464
18,"GALAŢI","#N/A",75098,,31,"GALAŢI / Scoala generala Petru Rares (sc gen nr. 25)",1,7290,"MUNICIPIUL GALAŢI",75098,1546,875,803,72,0,859,16,1700,825,404,455
18,"GALAŢI","#N/A",75098,,32,"GALAŢI / Scoala generala Petru Rares (sc gen nr. 25)",1,7290,"MUNICIPIUL GALAŢI",75098,1524,949,886,63,0,931,18,1676,727,412,519
18,"GALAŢI","#N/A",75098,,33,"GALAŢI / Scoala generala Petru Rares (sc gen nr. 25)",1,7290,"MUNICIPIUL GALAŢI",75098,1352,799,742,57,0,783,16,1486,687,354,429
18,"GALAŢI","#N/A",75098,,34,"GALAŢI / Universitatea Galaţi",1,7290,"MUNICIPIUL GALAŢI",75098,1671,1096,892,183,21,1078,18,1835,739,435,643
18,"GALAŢI","#N/A",75098,,35,"GALAŢI / Scoala generala nr. 19",1,7290,"MUNICIPIUL GALAŢI",75098,1453,801,749,50,2,790,11,1598,797,336,454
18,"GALAŢI","#N/A",75098,,36,"GALAŢI / Scoala generala nr. 19",1,7290,"MUNICIPIUL GALAŢI",75098,1567,1223,848,23,352,1207,16,1721,498,758,449
18,"GALAŢI","#N/A",75098,,37,"GALAŢI / Grup Scolar Industrial Traian (Liceul Industrial nr. 1)",1,7290,"MUNICIPIUL GALAŢI",75098,1249,1051,691,37,323,1037,14,1378,327,651,386
18,"GALAŢI","#N/A",75098,,38,"GALAŢI / Grup Scolar Elena Doamna",1,7290,"MUNICIPIUL GALAŢI",75098,1535,1006,757,154,95,991,15,1690,684,410,581
18,"GALAŢI","#N/A",75098,,39,"GALAŢI / Grup Scolar Elena Doamna",1,7290,"MUNICIPIUL GALAŢI",75098,1863,1090,921,148,21,1072,18,2038,948,448,624
18,"GALAŢI","#N/A",75098,,40,"GALAŢI / Grup Scolar Radu Negru",1,7290,"MUNICIPIUL GALAŢI",75098,1607,969,913,56,0,956,13,1764,795,408,548
18,"GALAŢI","#N/A",75098,,41,"GALAŢI / Scoala generala nr. 20 Traian",1,7290,"MUNICIPIUL GALAŢI",75098,1687,979,936,42,1,963,16,1851,872,432,531
18,"GALAŢI","#N/A",75098,,42,"GALAŢI / Scoala generala nr. 20 Traian",1,7290,"MUNICIPIUL GALAŢI",75098,941,604,531,73,0,591,13,1030,426,274,317
18,"GALAŢI","#N/A",75098,,43,"GALAŢI / Scoala generala nr. 20 Traian",1,7290,"MUNICIPIUL GALAŢI",75098,1595,1062,887,29,146,1050,12,1750,688,487,563
18,"GALAŢI","#N/A",75098,,44,"GALAŢI / Scoala generala nr. 24",1,7290,"MUNICIPIUL GALAŢI",75098,1639,1081,1023,56,2,1064,17,1809,728,435,629
18,"GALAŢI","#N/A",75098,,45,"GALAŢI / Grup Scolar Industrial de Marina (liceul de marina)",1,7290,"MUNICIPIUL GALAŢI",75098,1361,685,644,41,0,672,13,1497,812,335,337
18,"GALAŢI","#N/A",75098,,46,"GALAŢI / Grup Scolar Industrial de Marina (liceul de marina)",1,7290,"MUNICIPIUL GALAŢI",75098,1511,849,756,93,0,829,20,1660,811,382,447
18,"GALAŢI","#N/A",75098,,47,"GALAŢI / Grup Scolar Industrial de Marina (liceul de marina)",1,7290,"MUNICIPIUL GALAŢI",75098,1362,828,774,54,0,815,13,1505,677,351,464
18,"GALAŢI","#N/A",75098,,48,"GALAŢI / Grădiniţa nr. 59 (Fosta Şcoala  Generala  Nr. 8)",1,7290,"MUNICIPIUL GALAŢI",75098,1407,861,837,24,0,844,17,1548,687,359,485
18,"GALAŢI","#N/A",75098,,49,"GALAŢI / Gradinita nr. 59 (Fosta Şcoala  Generala  Nr. 8)",1,7290,"MUNICIPIUL GALAŢI",75098,1550,904,894,10,0,886,18,1719,815,459,427
18,"GALAŢI","#N/A",75098,,50,"GALAŢI / Gradinita nr. 59 (Fosta Şcoala  Generala  Nr. 8)",1,7290,"MUNICIPIUL GALAŢI",75098,1502,919,860,57,2,904,15,1654,735,403,501
18,"GALAŢI","#N/A",75098,,51,"GALAŢI / Gradinita nr. 59 (Fosta Şcoala  Generala  Nr. 8)",1,7290,"MUNICIPIUL GALAŢI",75098,1450,757,734,21,2,739,18,1593,836,363,376
18,"GALAŢI","#N/A",75098,,52,"GALAŢI / Liceul cu program de Educatie Fizica (lic.Ind.nr.12)",1,7290,"MUNICIPIUL GALAŢI",75098,1571,930,782,35,113,912,18,1728,798,492,420
18,"GALAŢI","#N/A",75098,,53,"GALAŢI / Liceul cu program de Educatie Fizica (lic.Ind.nr.12)",1,7290,"MUNICIPIUL GALAŢI",75098,1617,986,830,46,110,967,19,1783,797,453,514
18,"GALAŢI","#N/A",75098,,54,"GALAŢI / Liceul cu program de Educatie Fizica (lic.Ind.nr.12)",1,7290,"MUNICIPIUL GALAŢI",75098,1638,1010,856,40,114,997,13,1804,793,526,471
18,"GALAŢI","#N/A",75098,,55,"GALAŢI / Liceul cu program de Educatie Fizica (lic.Ind.nr.12)",1,7290,"MUNICIPIUL GALAŢI",75098,1656,1047,901,33,113,1028,19,1826,779,562,466
18,"GALAŢI","#N/A",75098,,56,"GALAŢI / Scoala Generala Nichita Stanescu (sc.gen.nr.17)",1,7290,"MUNICIPIUL GALAŢI",75098,1374,707,675,32,0,689,18,1520,813,361,328
18,"GALAŢI","#N/A",75098,,57,"GALAŢI / Scoala Generala Nichita Stanescu (sc.gen.nr.17)",1,7290,"MUNICIPIUL GALAŢI",75098,1480,799,758,41,0,789,10,1630,831,430,359
18,"GALAŢI","#N/A",75098,,58,"GALAŢI / Scoala Generala Nichita Stanescu (sc.gen.nr.17)",1,7290,"MUNICIPIUL GALAŢI",75098,1325,677,618,59,0,666,11,1461,784,343,323
18,"GALAŢI","#N/A",75098,,59,"GALAŢI / Grup Scolar Economic Administrativ Virgil Madgearu",1,7290,"MUNICIPIUL GALAŢI",75098,1373,796,742,54,0,777,19,1511,715,401,376
18,"GALAŢI","#N/A",75098,,60,"GALAŢI / Scoala Generala Sfanta Ana (Scoala Generala nr. 29)",1,7290,"MUNICIPIUL GALAŢI",75098,1409,785,738,44,3,775,10,1552,767,422,353
18,"GALAŢI","#N/A",75098,,61,"GALAŢI / Scoala Generala Sfanta Ana (sc. Nr. 29)",1,7290,"MUNICIPIUL GALAŢI",75098,1373,791,757,34,0,775,16,1514,723,398,377
18,"GALAŢI","#N/A",75098,,62,"GALAŢI / Scoala Generala Sfanta Ana (sc. Nr. 29)",1,7290,"MUNICIPIUL GALAŢI",75098,1426,789,765,23,1,779,10,1574,785,410,369
18,"GALAŢI","#N/A",75098,,63,"GALAŢI / Scoala Generala Sfanta Ana (sc. Nr. 29)",1,7290,"MUNICIPIUL GALAŢI",75098,1536,893,874,19,0,881,12,1691,798,430,451
18,"GALAŢI","#N/A",75098,,64,"GALAŢI / Scoala Generala Dimitrie Cantemir (sc.gen.nr.22)",1,7290,"MUNICIPIUL GALAŢI",75098,1568,879,817,62,0,861,18,1728,849,455,406
18,"GALAŢI","#N/A",75098,,65,"GALAŢI / Scoala Generala Dimitrie Cantemir (sc.gen.nr.22)",1,7290,"MUNICIPIUL GALAŢI",75098,1557,941,910,30,1,923,18,1715,774,499,424
18,"GALAŢI","#N/A",75098,,66,"GALAŢI / Scoala Generala Dimitrie Cantemir (sc.gen.nr.22)",1,7290,"MUNICIPIUL GALAŢI",75098,1620,873,847,26,0,854,19,1788,915,459,395
18,"GALAŢI","#N/A",75098,,67,"GALAŢI / Gradinita Prichindel (gradinita nr. 62)",1,7290,"MUNICIPIUL GALAŢI",75098,1583,948,902,44,2,926,22,1747,799,468,458
18,"GALAŢI","#N/A",75098,,68,"GALAŢI / Gradinita Prichindel (gradinita nr. 62)",1,7290,"MUNICIPIUL GALAŢI",75098,1565,897,841,56,0,879,18,1725,828,473,406
18,"GALAŢI","#N/A",75098,,69,"GALAŢI / Gradinita Prichindel (gradinita nr. 62)",1,7290,"MUNICIPIUL GALAŢI",75098,1482,816,774,42,0,797,19,1631,815,388,409
18,"GALAŢI","#N/A",75098,,70,"GALAŢI / Gara CFR Barbosi",1,7290,"MUNICIPIUL GALAŢI",75098,479,290,253,37,0,284,6,526,236,158,126
18,"GALAŢI","#N/A",75098,,71,"GALAŢI / Scoala Generala Dan Barbilian (sc gen nr. 43)",1,7290,"MUNICIPIUL GALAŢI",75098,1668,954,905,49,0,946,8,1834,880,509,437
18,"GALAŢI","#N/A",75098,,72,"GALAŢI / Scoala Generala Dan Barbilian (sc gen nr. 43)",1,7290,"MUNICIPIUL GALAŢI",75098,1580,899,850,49,0,882,17,1744,845,470,412
18,"GALAŢI","#N/A",75098,,73,"GALAŢI / Scoala Generala Dan Barbilian (sc gen nr. 43)",1,7290,"MUNICIPIUL GALAŢI",75098,1547,813,793,19,1,794,19,1702,889,372,422
18,"GALAŢI","#N/A",75098,,74,"GALAŢI / Scoala Generala Dan Barbilian (sc gen nr. 43)",1,7290,"MUNICIPIUL GALAŢI",75098,1670,867,848,19,0,846,21,1841,974,408,438
18,"GALAŢI","#N/A",75098,,75,"GALAŢI / Scoala Generala Dan Barbilian (sc gen nr. 43)",1,7290,"MUNICIPIUL GALAŢI",75098,1627,823,808,15,0,810,13,1783,960,434,376
18,"GALAŢI","#N/A",75098,,76,"GALAŢI / Scoala Generala Dan Barbilian (sc gen nr. 43)",1,7290,"MUNICIPIUL GALAŢI",75098,1549,844,817,27,0,829,15,1714,870,392,437
18,"GALAŢI","#N/A",75098,,77,"GALAŢI / Scoala Generala Dan Barbilian (sc gen nr. 43)",1,7290,"MUNICIPIUL GALAŢI",75098,1641,874,853,21,0,857,17,1800,926,428,429
18,"GALAŢI","#N/A",75098,,78,"GALAŢI / Scoala Generala nr. 3",1,7290,"MUNICIPIUL GALAŢI",75098,1584,946,897,49,0,927,19,1747,801,419,508
18,"GALAŢI","#N/A",75098,,79,"GALAŢI / Scoala Generala nr. 3",1,7290,"MUNICIPIUL GALAŢI",75098,1693,912,893,19,0,885,27,1863,951,438,447
18,"GALAŢI","#N/A",75098,,80,"GALAŢI / Scoala Generala nr. 3",1,7290,"MUNICIPIUL GALAŢI",75098,1624,899,853,46,0,884,15,1786,887,413,471
18,"GALAŢI","#N/A",75098,,81,"GALAŢI / Scoala Generala nr. 3",1,7290,"MUNICIPIUL GALAŢI",75098,1734,1001,953,48,0,985,16,1913,912,480,505
18,"GALAŢI","#N/A",75098,,82,"GALAŢI / Scoala Generala nr. 3",1,7290,"MUNICIPIUL GALAŢI",75098,1464,852,825,26,1,843,9,1606,754,358,485
18,"GALAŢI","#N/A",75098,,83,"GALAŢI / Scoala Generala Iulia Hasdeu (sc.gen nr. 40)",1,7290,"MUNICIPIUL GALAŢI",75098,1532,902,852,50,0,886,16,1684,782,420,466
18,"GALAŢI","#N/A",75098,,84,"GALAŢI / Scoala Generala Iulia Hasdeu (sc.gen nr. 40)",1,7290,"MUNICIPIUL GALAŢI",75098,1421,783,743,40,0,767,16,1571,788,400,367
18,"GALAŢI","#N/A",75098,,85,"GALAŢI / Scoala Generala Iulia Hasdeu (sc.gen nr. 40)",1,7290,"MUNICIPIUL GALAŢI",75098,1535,814,798,16,0,791,23,1695,881,420,371
18,"GALAŢI","#N/A",75098,,86,"GALAŢI / Scoala Generala Iulia Hasdeu (sc.gen nr. 40)",1,7290,"MUNICIPIUL GALAŢI",75098,1457,817,787,30,0,804,13,1608,791,366,438
18,"GALAŢI","#N/A",75098,,87,"GALAŢI / Scoala Generala Iulia Hasdeu (sc.gen nr. 40)",1,7290,"MUNICIPIUL GALAŢI",75098,1656,964,926,38,0,949,15,1823,859,428,521
18,"GALAŢI","#N/A",75098,,88,"GALAŢI / Scoala Generala Iulia Hasdeu (sc.gen nr. 40)",1,7290,"MUNICIPIUL GALAŢI",75098,1273,725,705,19,1,716,9,1399,674,351,365
18,"GALAŢI","#N/A",75098,,89,"GALAŢI / Gradinita LICURICI",1,7290,"MUNICIPIUL GALAŢI",75098,1509,939,904,34,1,921,18,1665,726,455,466
18,"GALAŢI","#N/A",75098,,90,"GALAŢI / Gradinita LICURICI",1,7290,"MUNICIPIUL GALAŢI",75098,1349,775,738,35,2,759,16,1485,710,388,371
18,"GALAŢI","#N/A",75098,,91,"GALAŢI / Gradinita LICURICI",1,7290,"MUNICIPIUL GALAŢI",75098,1423,818,802,16,0,800,18,1576,758,420,380
18,"GALAŢI","#N/A",75098,,92,"GALAŢI / Scoala Generala Nicolae Mantu (  sc. nr.1)",1,7290,"MUNICIPIUL GALAŢI",75098,1627,953,901,51,1,941,12,1789,836,413,528
18,"GALAŢI","#N/A",75098,,93,"GALAŢI / Scoala Generala Nicolae Mantu ( sc. nr.1)",1,7290,"MUNICIPIUL GALAŢI",75098,1522,881,834,47,0,867,14,1672,791,385,482
18,"GALAŢI","#N/A",75098,,94,"GALAŢI / Scoala Generala Cuza Voda (sc.gen.nr.5)",1,7290,"MUNICIPIUL GALAŢI",75098,1612,866,805,60,1,849,17,1772,906,372,477
18,"GALAŢI","#N/A",75098,,95,"GALAŢI / Scoala Generala Cuza Voda (sc.gen.nr.5)",1,7290,"MUNICIPIUL GALAŢI",75098,1311,766,727,38,1,756,10,1444,678,352,404
18,"GALAŢI","#N/A",75098,,96,"GALAŢI / Scoala Generala Cuza Voda (sc.gen.nr.5)",1,7290,"MUNICIPIUL GALAŢI",75098,1671,888,851,36,1,870,18,1830,942,418,452
18,"GALAŢI","#N/A",75098,,97,"GALAŢI / Scoala Generala Cuza Voda (sc.gen.nr.5)",1,7290,"MUNICIPIUL GALAŢI",75098,1460,853,825,24,4,840,13,1602,749,400,440
18,"GALAŢI","#N/A",75098,,98,"GALAŢI / Liceul Teoretic Dunarea",1,7290,"MUNICIPIUL GALAŢI",75098,1418,891,791,66,34,875,16,1559,668,413,462
18,"GALAŢI","#N/A",75098,,99,"GALAŢI / Liceul Teoretic Dunarea",1,7290,"MUNICIPIUL GALAŢI",75098,1366,795,741,54,0,781,14,1504,705,404,377
18,"GALAŢI","#N/A",75098,,100,"GALAŢI / Liceul Teoretic Dunarea",1,7290,"MUNICIPIUL GALAŢI",75098,1446,813,777,35,1,794,19,1593,780,393,401
18,"GALAŢI","#N/A",75098,,101,"GALAŢI / Scoala Generala Mihail Sadoveanu (sc gen nr.11)",1,7290,"MUNICIPIUL GALAŢI",75098,1584,947,912,35,0,931,16,1735,788,482,449
18,"GALAŢI","#N/A",75098,,102,"GALAŢI / Scoala Generala Mihail Sadoveanu (sc gen nr.11)",1,7290,"MUNICIPIUL GALAŢI",75098,1569,911,869,42,0,890,21,1728,817,445,445
18,"GALAŢI","#N/A",75098,,103,"GALAŢI / Scoala Generala Mihail Sadoveanu (sc gen nr.11)",1,7290,"MUNICIPIUL GALAŢI",75098,1248,733,703,29,1,721,12,1378,645,369,352
18,"GALAŢI","#N/A",75098,,104,"GALAŢI / Scoala Generala Mihail Sadoveanu (sc gen nr.11)",1,7290,"MUNICIPIUL GALAŢI",75098,1508,802,783,18,1,781,21,1663,861,363,418
18,"GALAŢI","#N/A",75098,,105,"GALAŢI / Scoala Generala Mihail Sadoveanu (sc gen nr.11)",1,7290,"MUNICIPIUL GALAŢI",75098,1447,898,871,27,0,891,7,1592,694,430,461
18,"GALAŢI","#N/A",75098,,106,"GALAŢI / Scoala Generala Mihail Sadoveanu (sc gen nr.11)",1,7290,"MUNICIPIUL GALAŢI",75098,1441,862,838,24,0,838,24,1585,723,445,393
18,"GALAŢI","#N/A",75098,,107,"GALAŢI / Scoala Generala Petre Tutea (sc gen nr. 10)",1,7290,"MUNICIPIUL GALAŢI",75098,1451,843,824,19,0,827,16,1594,751,436,391
18,"GALAŢI","#N/A",75098,,108,"GALAŢI / Scoala Generala Petre Tutea (sc gen nr. 10)",1,7290,"MUNICIPIUL GALAŢI",75098,1521,848,811,37,0,826,22,1671,823,419,407
18,"GALAŢI","#N/A",75098,,109,"GALAŢI / Scoala Generala Petre Tutea (sc gen nr. 10)",1,7290,"MUNICIPIUL GALAŢI",75098,1460,807,765,42,0,791,16,1611,804,403,388
18,"GALAŢI","#N/A",75098,,110,"GALAŢI / Scoala Generala Petre Tutea (sc gen nr. 10)",1,7290,"MUNICIPIUL GALAŢI",75098,1542,870,840,30,0,852,18,1698,828,420,432
18,"GALAŢI","#N/A",75098,,111,"GALAŢI / Scoala Generala Petre Tutea (sc gen nr. 10)",1,7290,"MUNICIPIUL GALAŢI",75098,1573,885,858,27,0,864,21,1745,860,443,421
18,"GALAŢI","#N/A",75098,,112,"GALAŢI / Grupul Scolar Industrial de Transporturi Auto (grup scolar ITA)",1,7290,"MUNICIPIUL GALAŢI",75098,1393,863,818,45,0,853,10,1534,671,409,444
18,"GALAŢI","#N/A",75098,,113,"GALAŢI / Colegiul Tehnic ""Traian Vuia"" (Grup Şcolar Transporturi Auto)",1,7290,"MUNICIPIUL GALAŢI",75098,1477,893,851,40,2,879,14,1626,733,385,494
18,"GALAŢI","#N/A",75098,,114,"GALAŢI / Colegiul Tehnic ""Traian Vuia"" (Grup Şcolar Transporturi Auto)",1,7290,"MUNICIPIUL GALAŢI",75098,1396,848,799,49,0,831,17,1544,696,430,401
18,"GALAŢI","#N/A",75098,,115,"GALAŢI / Scoala Generala Sfintii Imparati (sc gen nr. 42)",1,7290,"MUNICIPIUL GALAŢI",75098,1453,861,823,38,0,845,16,1602,741,414,431
18,"GALAŢI","#N/A",75098,,116,"GALAŢI / Scoala Generala Sfintii Imparati (sc gen nr. 42)",1,7290,"MUNICIPIUL GALAŢI",75098,1661,1003,979,24,0,990,13,1834,831,423,567
18,"GALAŢI","#N/A",75098,,117,"GALAŢI / Scoala Generala Sfintii Imparati (sc gen nr. 42)",1,7290,"MUNICIPIUL GALAŢI",75098,1483,863,825,38,0,847,16,1633,770,430,417
18,"GALAŢI","#N/A",75098,,118,"GALAŢI / Scoala Generala Sf.Grigore Teologul (sc gen nr. 41)",1,7290,"MUNICIPIUL GALAŢI",75098,1625,946,929,16,1,941,5,1802,856,489,452
18,"GALAŢI","#N/A",75098,,119,"GALAŢI / Scoala Generala Sf.Grigore Teologul (sc gen nr. 41)",1,7290,"MUNICIPIUL GALAŢI",75098,1600,876,849,27,0,861,15,1749,873,420,441
18,"GALAŢI","#N/A",75098,,120,"GALAŢI / Scoala Generala Sf.Grigore Teologul (sc gen nr. 41)",1,7290,"MUNICIPIUL GALAŢI",75098,1591,911,856,54,1,894,17,1753,842,450,444
18,"GALAŢI","#N/A",75098,,121,"GALAŢI / Scoala Generala Sf.Grigore Teologul (sc gen nr. 41)",1,7290,"MUNICIPIUL GALAŢI",75098,1634,945,890,55,0,931,14,1803,858,457,474
18,"GALAŢI","#N/A",75098,,122,"GALAŢI / Grup Scolar Industrial Anghel Saligny (liceul industrial nr.9)",1,7290,"MUNICIPIUL GALAŢI",75098,1632,928,892,35,1,910,18,1790,862,461,449
18,"GALAŢI","#N/A",75098,,123,"GALAŢI / Grup Scolar Industrial Anghel Saligny (liceul industrial nr.9)",1,7290,"MUNICIPIUL GALAŢI",75098,1680,916,882,34,0,899,17,1847,931,432,467
18,"GALAŢI","#N/A",75098,,124,"GALAŢI / Grup Scolar Industrial Anghel Saligny (liceul industrial nr.9)",1,7290,"MUNICIPIUL GALAŢI",75098,1533,777,737,40,0,767,10,1685,908,394,373
18,"GALAŢI","#N/A",75098,,125,"GALAŢI / Grup Scolar Industrial Anghel Saligny (liceul industrial nr.9)",1,7290,"MUNICIPIUL GALAŢI",75098,1667,799,774,25,0,782,17,1831,1032,390,392
18,"GALAŢI","#N/A",75098,,126,"GALAŢI / Grup Scolar Industrial Sfanta Maria (lic ind.nr.10)",1,7290,"MUNICIPIUL GALAŢI",75098,1159,765,703,62,0,746,19,1276,511,364,382
18,"GALAŢI","#N/A",75098,,127,"GALAŢI / Grup Scolar Industrial Sfanta Maria (lic ind.nr.10)",1,7290,"MUNICIPIUL GALAŢI",75098,1588,899,870,28,1,885,14,1753,854,417,468
18,"GALAŢI","#N/A",75098,,128,"GALAŢI / Scoala Generala Stefan cel Mare (sc gen nr. 13)",1,7290,"MUNICIPIUL GALAŢI",75098,1606,916,870,45,1,905,11,1774,858,482,423
18,"GALAŢI","#N/A",75098,,129,"GALAŢI / Scoala Generala Stefan cel Mare (sc gen nr. 13)",1,7290,"MUNICIPIUL GALAŢI",75098,1656,1031,1002,27,2,1012,19,1831,800,525,487
18,"GALAŢI","#N/A",75098,,130,"GALAŢI / Liceul Pedagogic ""C. Negri""",1,7290,"MUNICIPIUL GALAŢI",75098,1596,1004,933,71,0,987,17,1751,747,439,548
18,"GALAŢI","#N/A",75098,,131,"GALAŢI / Liceul Pedagogic ""C. Negri""",1,7290,"MUNICIPIUL GALAŢI",75098,1599,1040,960,74,6,1015,25,1763,723,493,522
18,"GALAŢI","#N/A",75098,,132,"GALAŢI / Liceul Pedagogic ""C. Negri""",1,7290,"MUNICIPIUL GALAŢI",75098,1528,993,931,62,0,982,11,1686,693,474,508
18,"GALAŢI","#N/A",75098,,133,"GALAŢI / Scoala Generala Grigore Moisil (sc.gen.nr. 38)",1,7290,"MUNICIPIUL GALAŢI",75098,1610,950,921,29,0,926,24,1764,814,464,462
18,"GALAŢI","#N/A",75098,,134,"GALAŢI / Scoala Generala Grigore Moisil (sc.gen.nr. 38)",1,7290,"MUNICIPIUL GALAŢI",75098,1447,855,818,37,0,834,21,1599,744,451,383
18,"GALAŢI","#N/A",75098,,135,"GALAŢI / Scoala Generala Grigore Moisil (sc.gen.nr. 38)",1,7290,"MUNICIPIUL GALAŢI",75098,1519,841,816,25,0,829,12,1680,839,396,433
18,"GALAŢI","#N/A",75098,,136,"GALAŢI / Scoala Generala Grigore Moisil (sc.gen.nr. 38)",1,7290,"MUNICIPIUL GALAŢI",75098,1802,995,975,18,2,976,19,1970,973,521,455
18,"GALAŢI","#N/A",75098,,137,"GALAŢI / Scoala Generala Ghe.Munteanu (sc gen.nr. 31)",1,7290,"MUNICIPIUL GALAŢI",75098,1590,933,902,30,1,919,14,1749,816,477,442
18,"GALAŢI","#N/A",75098,,138,"GALAŢI / Scoala Generala Ghe.Munteanu (sc gen.nr. 31)",1,7290,"MUNICIPIUL GALAŢI",75098,1572,832,805,27,0,815,17,1727,895,444,371
18,"GALAŢI","#N/A",75098,,139,"GALAŢI / Scoala Generala Ghe.Munteanu (sc gen.nr. 31)",1,7290,"MUNICIPIUL GALAŢI",75098,1532,860,831,29,0,843,17,1681,821,432,411
18,"GALAŢI","#N/A",75098,,140,"GALAŢI / Gradinita Filesti (gradinita nr.29)",1,7290,"MUNICIPIUL GALAŢI",75098,440,276,248,28,0,274,2,483,207,130,144
18,"GALAŢI","#N/A",75098,,141,"GALAŢI / Colegiul Tehnic ""Paul Dimo"" (Liceul Energetic Nr.4)",1,7290,"MUNICIPIUL GALAŢI",75098,1490,783,734,48,1,769,14,1643,860,395,374
18,"GALAŢI","#N/A",75098,,142,"GALAŢI / Colegiul Tehnic ""Paul Dimo"" (Liceul Energetic Nr.4)",1,7290,"MUNICIPIUL GALAŢI",75098,1560,829,801,28,0,818,11,1715,886,430,388
18,"GALAŢI","#N/A",75098,,143,"GALAŢI / Colegiul Tehnic ""Paul Dimo"" (Liceul Energetic Nr.4)",1,7290,"MUNICIPIUL GALAŢI",75098,1537,816,790,26,0,801,15,1684,868,452,349
18,"GALAŢI","#N/A",75098,,144,"GALAŢI / Colegiul Tehnic ""Paul Dimo"" (Liceul Energetic Nr.4)",1,7290,"MUNICIPIUL GALAŢI",75098,1181,650,628,21,1,640,10,1303,653,345,295
18,"GALAŢI","#N/A",75098,,145,"GALAŢI / Scoala Generala Sfantul Dumitru (sc.gen nr.33)",1,7290,"MUNICIPIUL GALAŢI",75098,1492,856,810,46,0,843,13,1642,786,451,392
18,"GALAŢI","#N/A",75098,,146,"GALAŢI / Scoala Generala Sfantul Dumitru (sc.gen nr.33)",1,7290,"MUNICIPIUL GALAŢI",75098,1622,862,826,36,0,852,10,1773,911,426,426
18,"GALAŢI","#N/A",75098,,147,"GALAŢI / Scoala Generala Sfantul Dumitru (sc.gen nr.33)",1,7290,"MUNICIPIUL GALAŢI",75098,1509,818,790,28,0,802,16,1660,842,414,388
18,"GALAŢI","#N/A",75098,,148,"GALAŢI / Scoala Generala Sfantul Dumitru (sc.gen nr.33)",1,7290,"MUNICIPIUL GALAŢI",75098,1450,779,741,35,3,772,7,1603,824,416,356
18,"GALAŢI","#N/A",75098,,149,"GALAŢI / Scoala Generala  Mihai Viteazul ( sc.nr. 34)",1,7290,"MUNICIPIUL GALAŢI",75098,1620,882,842,40,0,874,8,1784,902,453,421
18,"GALAŢI","#N/A",75098,,150,"GALAŢI / Scoala Generala  Mihai Viteazul ( sc.nr. 34)",1,7290,"MUNICIPIUL GALAŢI",75098,1410,754,725,29,0,741,13,1550,796,380,361
18,"GALAŢI","#N/A",75098,,151,"GALAŢI / Scoala nr. 18",1,7290,"MUNICIPIUL GALAŢI",75098,1633,886,857,29,0,868,18,1807,921,412,456
18,"GALAŢI","#N/A",75098,,152,"GALAŢI / Scoala nr. 18",1,7290,"MUNICIPIUL GALAŢI",75098,1522,780,756,24,0,759,21,1683,903,410,349
18,"GALAŢI","#N/A",75098,,153,"GALAŢI / Scoala nr. 18",1,7290,"MUNICIPIUL GALAŢI",75098,1536,733,693,40,0,717,16,1691,958,341,376
18,"GALAŢI","#N/A",75098,,154,"GALAŢI / Scoala nr. 18",1,7290,"MUNICIPIUL GALAŢI",75098,1646,644,616,28,0,636,8,1811,1167,333,303
18,"GALAŢI","#N/A",75098,,155,"GALAŢI / Grup Scolar Metalurgic (lic ind nr. 3 )",1,7290,"MUNICIPIUL GALAŢI",75098,1345,689,632,57,0,678,11,1484,795,342,336
18,"GALAŢI","#N/A",75098,,156,"GALAŢI / Grup Scolar Metalurgic (lic ind nr. 3 )",1,7290,"MUNICIPIUL GALAŢI",75098,1482,748,713,34,1,736,12,1628,880,413,323
18,"GALAŢI","#N/A",75098,,157,"GALAŢI / Grup Scolar Metalurgic (lic ind nr. 3 )",1,7290,"MUNICIPIUL GALAŢI",75098,1596,902,868,34,0,894,8,1749,847,448,446
18,"GALAŢI","#N/A",75098,,158,"GALAŢI / Grup Scolar Metalurgic (lic ind nr. 3 )",1,7290,"MUNICIPIUL GALAŢI",75098,1460,703,673,30,0,689,14,1613,910,374,315
18,"GALAŢI","#N/A",75098,,159,"GALAŢI / Grup Scolar Industrial Gh. Asachi (lic ind nr. 8)",1,7290,"MUNICIPIUL GALAŢI",75098,1429,760,705,55,0,737,23,1564,804,365,372
18,"GALAŢI","#N/A",75098,,160,"GALAŢI / Grup Scolar Industrial Gh. Asachi (lic ind nr. 8)",1,7290,"MUNICIPIUL GALAŢI",75098,1346,739,723,16,0,724,15,1482,743,320,404
18,"GALAŢI","#N/A",75098,,161,"GALAŢI / Grup Scolar Industrial Gh. Asachi (lic ind nr. 8)",1,7290,"MUNICIPIUL GALAŢI",75098,1422,704,672,32,0,690,14,1564,860,339,351
18,"GALAŢI","#N/A",75098,,162,"GALAŢI / Grup Scolar Industrial Transporturi CF (liceul CFR)",1,7290,"MUNICIPIUL GALAŢI",75098,1533,817,772,45,0,803,14,1694,877,337,466
18,"GALAŢI","#N/A",75098,,163,"GALAŢI / Grup Scolar Industrial Transporturi CF (liceul CFR)",1,7290,"MUNICIPIUL GALAŢI",75098,1532,861,830,31,0,846,15,1684,823,382,464
18,"GALAŢI","#N/A",75098,,164,"GALAŢI / Grup Scolar Industrial Transporturi CF (liceul CFR)",1,7290,"MUNICIPIUL GALAŢI",75098,1631,849,817,31,1,841,8,1801,952,402,439
18,"GALAŢI","#N/A",75098,,165,"GALAŢI / Scoala Generala Miron Costin (sc gen nr. 12)",1,7290,"MUNICIPIUL GALAŢI",75098,1543,875,857,18,0,861,14,1705,830,411,450
18,"GALAŢI","#N/A",75098,,166,"GALAŢI / Scoala Generala Miron Costin (sc gen nr. 12)",1,7290,"MUNICIPIUL GALAŢI",75098,1548,853,806,47,0,831,22,1707,854,392,439
18,"GALAŢI","#N/A",75098,,167,"GALAŢI / Scoala Generala Miron Costin (sc gen nr. 12)",1,7290,"MUNICIPIUL GALAŢI",75098,1604,902,810,92,0,889,13,1772,870,397,492
18,"GALAŢI","#N/A",75098,,168,"GALAŢI / Scoala Generala Miron Costin (sc gen nr. 12)",1,7290,"MUNICIPIUL GALAŢI",75098,1595,890,856,33,1,868,22,1770,880,370,498
18,"GALAŢI","#N/A",75098,,169,"GALAŢI / Scoala Generala Miron Costin (sc gen nr. 12)",1,7290,"MUNICIPIUL GALAŢI",75098,1549,862,836,26,0,847,15,1705,843,391,456
18,"GALAŢI","#N/A",75098,,170,"GALAŢI / Scoala Generala Miron Costin (sc gen nr. 12)",1,7290,"MUNICIPIUL GALAŢI",75098,1567,896,867,28,1,883,13,1729,833,402,481
18,"GALAŢI","#N/A",75098,,171,"GALAŢI / Scoala Generala Miron Costin (sc gen nr. 12)",1,7290,"MUNICIPIUL GALAŢI",75098,1525,857,830,27,0,843,14,1678,821,433,410
18,"GALAŢI","#N/A",75098,,172,"GALAŢI / Scoala Generala Miron Costin (sc gen nr. 12)",1,7290,"MUNICIPIUL GALAŢI",75098,1560,896,864,32,0,878,18,1716,820,376,502
18,"GALAŢI","#N/A",75098,,173,"GALAŢI / Scoala Generala nr. 12 ""Miron Costin""",1,7290,"MUNICIPIUL GALAŢI",75098,1551,885,852,33,0,868,17,1702,817,397,471
18,"GALAŢI","#N/A",75098,,174,"GALAŢI / Scoala Generala nr. 12 ""Miron Costin""",1,7290,"MUNICIPIUL GALAŢI",75098,1421,784,759,25,0,772,12,1566,782,355,417
18,"GALAŢI","#N/A",75098,,175,"GALAŢI / Gradinita nr. 20 (Anexa Scolii nr. 12)",1,7290,"MUNICIPIUL GALAŢI",75098,1489,872,815,57,0,852,20,1639,767,330,522
18,"GALAŢI","#N/A",75098,,176,"GALAŢI / Gradinita nr. 20 (Anexa Scolii nr. 12)",1,7290,"MUNICIPIUL GALAŢI",75098,1411,775,736,38,1,763,12,1563,788,394,369
18,"GALAŢI","#N/A",75203,,177,"TECUCI / Şcoala nr.1",1,7292,"MUNICIPIUL TECUCI",75203,1356,778,741,37,0,759,19,1493,715,368,391
18,"GALAŢI","#N/A",75203,,178,"TECUCI / Şcoala nr.1",1,7292,"MUNICIPIUL TECUCI",75203,1322,680,657,22,1,672,8,1454,774,430,242
18,"GALAŢI","#N/A",75203,,179,"TECUCI / Şcoala nr.1",1,7292,"MUNICIPIUL TECUCI",75203,1559,812,792,20,0,793,19,1718,906,408,385
18,"GALAŢI","#N/A",75203,,180,"TECUCI / Şcoala nr.10",1,7292,"MUNICIPIUL TECUCI",75203,1224,705,658,47,0,690,15,1343,638,398,292
18,"GALAŢI","#N/A",75203,,181,"TECUCI / Şcoala nr.10",1,7292,"MUNICIPIUL TECUCI",75203,754,421,401,20,0,415,6,836,415,239,176
18,"GALAŢI","#N/A",75203,,182,"TECUCI / Şcoala nr.2",1,7292,"MUNICIPIUL TECUCI",75203,1269,642,595,46,1,629,13,1401,759,380,249
18,"GALAŢI","#N/A",75203,,183,"TECUCI / Şcoala nr.2",1,7292,"MUNICIPIUL TECUCI",75203,1461,752,730,22,0,743,9,1604,852,437,306
18,"GALAŢI","#N/A",75203,,184,"TECUCI / Birou Obor",1,7292,"MUNICIPIUL TECUCI",75203,1383,757,703,53,1,733,24,1525,768,386,347
18,"GALAŢI","#N/A",75203,,185,"TECUCI / Şcoala nr.4",1,7292,"MUNICIPIUL TECUCI",75203,1064,665,570,49,46,656,9,1173,508,354,302
18,"GALAŢI","#N/A",75203,,186,"TECUCI / Şcoala Nr.4",1,7292,"MUNICIPIUL TECUCI",75203,825,474,443,30,1,457,17,912,438,276,181
18,"GALAŢI","#N/A",75203,,187,"TECUCI / Liceul Spiru Haret",1,7292,"MUNICIPIUL TECUCI",75203,1395,834,766,68,0,817,17,1532,698,428,389
18,"GALAŢI","#N/A",75203,,188,"TECUCI / Liceul Spiru Haret",1,7292,"MUNICIPIUL TECUCI",75203,727,400,378,22,0,393,7,805,405,212,181
18,"GALAŢI","#N/A",75203,,189,"TECUCI / Colegiul Agricol",1,7292,"MUNICIPIUL TECUCI",75203,1149,618,553,64,1,605,13,1266,648,338,267
18,"GALAŢI","#N/A",75203,,190,"TECUCI / Colegiul Agricol",1,7292,"MUNICIPIUL TECUCI",75203,1414,799,764,34,1,788,11,1558,759,437,351
18,"GALAŢI","#N/A",75203,,191,"TECUCI / Grădiniţa nr.17",1,7292,"MUNICIPIUL TECUCI",75203,895,482,457,25,0,471,11,986,504,255,216
18,"GALAŢI","#N/A",75203,,192,"TECUCI / Grădiniţa nr.17",1,7292,"MUNICIPIUL TECUCI",75203,1127,571,534,37,0,566,5,1240,669,269,297
18,"GALAŢI","#N/A",75203,,193,"TECUCI / Şcoala nr.11",1,7292,"MUNICIPIUL TECUCI",75203,907,468,438,29,1,460,8,1001,533,225,235
18,"GALAŢI","#N/A",75203,,194,"TECUCI / Şcoala nr.11",1,7292,"MUNICIPIUL TECUCI",75203,1338,670,629,39,2,655,15,1472,802,340,315
18,"GALAŢI","#N/A",75203,,195,"TECUCI / Şcoala nr.11",1,7292,"MUNICIPIUL TECUCI",75203,1056,590,542,48,0,577,13,1163,573,266,311
18,"GALAŢI","#N/A",75203,,196,"TECUCI / Şcoala nr.8",1,7292,"MUNICIPIUL TECUCI",75203,1315,753,721,32,0,742,11,1448,695,399,343
18,"GALAŢI","#N/A",75203,,197,"TECUCI / Şcoala nr.6",1,7292,"MUNICIPIUL TECUCI",75203,1282,768,735,32,1,751,17,1417,649,385,366
18,"GALAŢI","#N/A",75203,,198,"TECUCI / Şcoala nr.6",1,7292,"MUNICIPIUL TECUCI",75203,1299,759,695,53,11,746,13,1432,673,359,387
18,"GALAŢI","#N/A",75203,,199,"TECUCI / Şcoala nr.7",1,7292,"MUNICIPIUL TECUCI",75203,1144,610,558,52,0,597,13,1258,648,361,236
18,"GALAŢI","#N/A",75203,,200,"TECUCI / Şcoala nr.7",1,7292,"MUNICIPIUL TECUCI",75203,1069,589,553,34,2,569,20,1177,588,287,282
18,"GALAŢI","#N/A",75203,,201,"TECUCI / Grădiniţa  din cartierul N Balcescu",1,7292,"MUNICIPIUL TECUCI",75203,979,539,519,19,1,529,10,1080,541,268,261
18,"GALAŢI","#N/A",75203,,202,"TECUCI / Grădiniţa 18",1,7292,"MUNICIPIUL TECUCI",75203,1345,714,672,41,1,699,15,1487,773,379,320
18,"GALAŢI","#N/A",75203,,203,"TECUCI / Grădiniţa nr.2",1,7292,"MUNICIPIUL TECUCI",75203,972,555,501,53,1,548,7,1069,514,292,256
18,"GALAŢI","#N/A",75203,,204,"TECUCI / Grădiniţa nr.2",1,7292,"MUNICIPIUL TECUCI",75203,1312,745,706,38,1,730,15,1452,707,408,322
18,"GALAŢI","#N/A",75203,,205,"TECUCI / Liceul Calistrat Hogaş",1,7292,"MUNICIPIUL TECUCI",75203,938,458,406,52,0,451,7,1035,577,218,233
18,"GALAŢI","#N/A",75203,,206,"TECUCI / Liceul Calistrat Hogaş",1,7292,"MUNICIPIUL TECUCI",75203,963,550,514,36,0,537,13,1062,512,315,222
18,"GALAŢI","#N/A",75203,,207,"TECUCI / Grădiniţa nr.3",1,7292,"MUNICIPIUL TECUCI",75203,938,451,426,25,0,446,5,1034,583,260,186
18,"GALAŢI","#N/A",75203,,208,"TECUCI / CAMINUL NR. 15",1,7292,"MUNICIPIUL TECUCI",75203,871,435,394,41,0,430,5,959,524,250,180
18,"GALAŢI","#N/A",75203,,209,"TECUCI / Şcoala nr.9",1,7292,"MUNICIPIUL TECUCI",75203,982,558,536,22,0,542,16,1079,521,275,267
18,"GALAŢI","#N/A",75338,,210,"BEREŞTI / Casa de cultura ION CREANGĂ"" Beresti",1,7294,"ORAŞ BEREŞTI",75338,1364,778,714,52,12,767,11,1502,724,534,233
18,"GALAŢI","#N/A",75338,,211,"BEREŞTI / Liceul teoretic ""PAUL BUJOR"" Beresti",1,7294,"ORAŞ BEREŞTI",75338,1418,847,774,45,28,835,12,1561,714,657,178
18,"GALAŢI","#N/A",75472,,212,"TÎRGU BUJOR / Gradiniţa nr.2 Căsuţa Piticilor",1,7296,"ORAŞ TÎRGU BUJOR",75472,746,493,438,41,14,491,2,822,329,390,101
18,"GALAŢI","#N/A",75472,,213,"TÎRGU BUJOR / Gradiniţa nr.2 Căsuţa Piticilor",1,7296,"ORAŞ TÎRGU BUJOR",75472,850,434,385,23,26,431,3,933,499,342,89
18,"GALAŢI","#N/A",75472,,214,"TÎRGU BUJOR / Scoala Generală nr.2 Grigore Hagiu",1,7296,"ORAŞ TÎRGU BUJOR",75472,1421,856,742,64,50,848,8,1565,709,581,267
18,"GALAŢI","#N/A",75472,,215,"TÎRGU BUJOR / Grup Scolar Eremia Grigorescu",1,7296,"ORAŞ TÎRGU BUJOR",75472,1125,715,620,89,6,703,12,1236,521,407,296
18,"GALAŢI","#N/A",75472,,216,"MOSCU / Scoala generală Moscu",1,7296,"ORAŞ TÎRGU BUJOR",75472,1051,714,612,67,35,704,10,1162,448,576,128
18,"GALAŢI","#N/A",75472,,217,"UMBRĂREŞTI / Scoala generală Umbrăreşti",1,7296,"ORAŞ TÎRGU BUJOR",75472,929,565,509,43,13,559,6,1022,457,431,128
18,"GALAŢI","#N/A",75515,,218,"BARCEA / Scoala nr.2 Barcea",3,7315,"BARCEA",75515,770,460,407,53,0,457,3,858,398,160,297
18,"GALAŢI","#N/A",75515,,219,"BARCEA / Scoala nr. 2 Barcea",3,7315,"BARCEA",75515,921,506,478,28,0,497,9,1005,499,228,269
18,"GALAŢI","#N/A",75515,,220,"BARCEA / Scoala nr. 3 Barcea",3,7315,"BARCEA",75515,1014,578,536,42,0,570,8,1096,518,216,354
18,"GALAŢI","#N/A",75515,,221,"BARCEA / Scoala nr. 1 Barcea",3,7315,"BARCEA",75515,1126,600,572,28,0,596,4,1247,647,239,357
18,"GALAŢI","#N/A",75515,,222,"PODOLENI / Scoala nr. 4, Podoleni",3,7315,"BARCEA",75515,1186,709,677,32,0,701,8,1316,607,292,409
18,"GALAŢI","#N/A",75542,,223,"BĂLĂBĂNEŞTI / Căminul Cultural Bălăbăneşti",3,7300,"BĂLĂBĂNEŞTI",75542,651,492,379,98,15,487,5,717,225,358,129
18,"GALAŢI","#N/A",75542,,224,"BURSUCANI / Scoala cu clasele I-IV Bursucani",3,7300,"BĂLĂBĂNEŞTI",75542,498,313,266,41,6,311,2,533,220,214,97
18,"GALAŢI","#N/A",75542,,225,"LUNGEŞTI / Scoala generală Lungeşti",3,7300,"BĂLĂBĂNEŞTI",75542,471,329,248,71,10,323,6,519,190,235,88
18,"GALAŢI","#N/A",75613,,226,"BĂLĂŞEŞTI / Căminul Cultural Bălăşeşti",3,7305,"BĂLĂŞEŞTI",75613,960,612,552,47,13,604,8,1056,444,448,156
18,"GALAŢI","#N/A",75613,,227,"CIUREŞTII NOI / Gradinita Ciureştii Noi",3,7305,"BĂLĂŞEŞTI",75613,401,336,240,88,8,331,5,441,105,219,112
18,"GALAŢI","#N/A",75613,,228,"CIUREŞTI / Scoala generală Ciureşti",3,7305,"BĂLĂŞEŞTI",75613,289,207,149,53,5,203,4,316,109,152,51
18,"GALAŢI","#N/A",75613,,229,"PUPEZENI / Scoala generală Pupezeni",3,7305,"BĂLĂŞEŞTI",75613,156,125,84,33,8,125,0,169,44,101,24
18,"GALAŢI","#N/A",75668,,230,"BĂLENI / SCOALA GIMNAZIALA BALENI",3,7310,"BĂLENI",75668,1250,728,610,98,20,723,5,1378,650,518,205
18,"GALAŢI","#N/A",75668,,231,"BĂLENI / Scoala gimnazială Băleni",3,7310,"BĂLENI",75668,806,483,421,52,10,475,8,887,404,330,145
18,"GALAŢI","#N/A",75686,,232,"ROŞCANI / SCOALA PRIMARA ,,ION VODA CEL VITEAZ ROSCANI",3,7312,"BĂNEASA",75686,520,326,287,35,4,326,0,571,245,172,154
18,"GALAŢI","#N/A",75686,,233,"BĂNEASA / Gradinita de copii Baneasa",3,7312,"BĂNEASA",75686,1226,786,696,61,29,767,19,1351,565,499,268
18,"GALAŢI","#N/A",75356,,234,"BEREŞTI-MERIA / Şcoala Gimnazială nr. 1 sat Bereşti - Meria",3,7318,"BEREŞTI-MERIA",75356,435,294,240,54,0,292,2,480,186,195,97
18,"GALAŢI","#N/A",75356,,235,"SLIVNA / Şcoala  Gimnazială nr. 1 sat Slivna",3,7318,"BEREŞTI-MERIA",75356,590,367,315,52,0,363,4,647,280,271,92
18,"GALAŢI","#N/A",75356,,236,"PURICANI / Şcoala Gimnazială nr.1 sat Puricani",3,7318,"BEREŞTI-MERIA",75356,243,196,136,60,0,194,2,266,70,138,56
18,"GALAŢI","#N/A",75356,,237,"ALDEŞTI / Şcoala Primară Andronachi Goga nr. 1 sat Aldeşti",3,7318,"BEREŞTI-MERIA",75356,392,217,193,24,0,213,4,432,215,170,43
18,"GALAŢI","#N/A",75356,,238,"PLEŞA / Grădiniţa cu program normal nr. 1 sat Pleşa",3,7318,"BEREŞTI-MERIA",75356,577,342,308,34,0,339,3,636,294,216,123
18,"GALAŢI","#N/A",75356,,239,"BALINTEŞTI / Şcoala gimnazială nr. 1 sat Balinteşti",3,7318,"BEREŞTI-MERIA",75356,818,529,461,68,0,521,8,899,370,387,134
18,"GALAŢI","#N/A",75711,,240,"BRANIŞTEA / Gradinita de copii",3,7334,"BRANIŞTEA",75711,1215,701,642,58,1,694,7,1339,638,342,352
18,"GALAŢI","#N/A",75711,,241,"BRANIŞTEA / Gradinita de copii",3,7334,"BRANIŞTEA",75711,989,579,517,60,2,564,15,1088,509,299,265
18,"GALAŢI","#N/A",75711,,242,"VASILE ALECSANDRI / Scoala generala Vasile Alecsandri",3,7334,"BRANIŞTEA",75711,857,503,459,44,0,502,1,937,434,247,255
18,"GALAŢI","#N/A",75711,,243,"TRAIAN / Scoala generală Traian",3,7334,"BRANIŞTEA",75711,445,299,247,52,0,295,4,488,189,143,152
18,"GALAŢI","#N/A",75766,,244,"BRĂHĂŞEŞTI / Scoala gimnaziala nr.1 Brăhăşeşti",3,7329,"BRĂHĂŞEŞTI",75766,1169,607,536,45,26,594,13,1283,676,426,168
18,"GALAŢI","#N/A",75766,,245,"BRĂHĂŞEŞTI / Scoala gimnaziala nr.1 Brăhăşeşti",3,7329,"BRĂHĂŞEŞTI",75766,968,530,461,51,18,525,5,1068,538,354,171
18,"GALAŢI","#N/A",75766,,246,"TOFLEA / Scoala gimnaziala Toflea",3,7329,"BRĂHĂŞEŞTI",75766,1405,601,535,61,5,595,6,1546,945,579,16
18,"GALAŢI","#N/A",75766,,247,"TOFLEA / Scoala gimnaziala Toflea",3,7329,"BRĂHĂŞEŞTI",75766,1020,435,381,51,3,432,3,1126,691,421,11
18,"GALAŢI","#N/A",75766,,248,"TOFLEA / Scoala gimnaziala Toflea",3,7329,"BRĂHĂŞEŞTI",75766,1310,539,486,45,8,536,3,1442,903,520,16
18,"GALAŢI","#N/A",75819,,249,"BUCIUMENI / SCOALA NATALIA NEGRU",3,7339,"BUCIUMENI",75819,908,567,516,42,9,553,14,1000,433,327,226
18,"GALAŢI","#N/A",75819,,250,"HĂNŢEŞTI / SCOALA SMARANDA BRAESCU",3,7339,"BUCIUMENI",75819,416,267,210,53,4,265,2,460,193,142,123
18,"GALAŢI","#N/A",75819,,251,"VIZUREŞTI / SCOALA CU CLASE I-IV",3,7339,"BUCIUMENI",75819,320,198,177,19,2,194,4,352,154,117,77
18,"GALAŢI","#N/A",75819,,252,"TECUCELU SEC / SCOALA CU CLASE I-IV",3,7339,"BUCIUMENI",75819,381,256,219,35,2,251,5,419,163,140,111
18,"GALAŢI","#N/A",75864,,253,"CAVADINEŞTI / Scoala primara nr.3",3,7344,"CAVADINEŞTI",75864,178,142,97,37,8,139,3,189,47,106,33
18,"GALAŢI","#N/A",75864,,254,"CAVADINEŞTI / Scoala gimnazială nr.2",3,7344,"CAVADINEŞTI",75864,908,643,519,102,22,639,4,993,350,498,141
18,"GALAŢI","#N/A",75864,,255,"GĂNEŞTI / Scoala gimnaziala Găneşti",3,7344,"CAVADINEŞTI",75864,767,459,379,74,6,455,4,859,400,356,99
18,"GALAŢI","#N/A",75864,,256,"VĂDENI / Scoala generală Vădeni",3,7344,"CAVADINEŞTI",75864,409,278,221,35,22,273,5,453,175,226,47
18,"GALAŢI","#N/A",75864,,257,"COMĂNEŞTI / Scoala generală Comăneşti",3,7344,"CAVADINEŞTI",75864,197,125,107,18,0,125,0,216,91,98,27
18,"GALAŢI","#N/A",75917,,258,"CERŢEŞTI / SCOALA GIMNAZIALA GEORGE IVASCU",3,7349,"CERŢEŞTI",75917,692,474,414,60,0,470,4,765,291,187,283
18,"GALAŢI","#N/A",75917,,259,"CÎRLOMĂNEŞTI / SCOALA GIMNAZIALA",3,7349,"CERŢEŞTI",75917,618,421,379,42,0,412,9,681,260,151,261
18,"GALAŢI","#N/A",75917,,260,"COTOROAIA / SCOALA PRIMARA",3,7349,"CERŢEŞTI",75917,583,457,397,60,0,449,8,647,190,250,199
18,"GALAŢI","#N/A",76004,,261,"CORNI / Scoala Noua - sat Corni",3,7353,"CORNI",76004,733,470,405,42,23,466,4,930,460,333,133
18,"GALAŢI","#N/A",76004,,262,"MĂCIŞENI / Scoala generala Măcişeni",3,7353,"CORNI",76004,701,474,419,47,8,466,8,694,220,169,297
18,"GALAŢI","#N/A",76004,,263,"URLEŞTI / Scoala generala Urleşti",3,7353,"CORNI",76004,401,254,224,23,7,250,4,398,144,176,74
18,"GALAŢI","#N/A",75953,,264,"COROD / Şcoala nr.2 Corod",3,7357,"COROD",75953,1232,659,622,37,0,653,6,1362,703,258,395
18,"GALAŢI","#N/A",75953,,265,"COROD / Cămin Cultural Corod",3,7357,"COROD",75953,1316,728,660,68,0,720,8,1449,721,259,461
18,"GALAŢI","#N/A",75953,,266,"COROD / Şcoala nr.3 Corod",3,7357,"COROD",75953,1573,782,749,33,0,773,9,1734,952,318,455
18,"GALAŢI","#N/A",75953,,267,"BLÎNZI / Şcoala Blînzi",3,7357,"COROD",75953,978,452,428,24,0,448,4,1080,628,238,210
18,"GALAŢI","#N/A",75953,,268,"BRĂTULEŞTI / Şcoala Brătuleşti",3,7357,"COROD",75953,520,223,215,8,0,220,3,566,343,126,94
18,"GALAŢI","#N/A",75953,,269,"CĂRĂPCEŞTI / Şcoala Cărăpceşti",3,7357,"COROD",75953,645,370,331,39,0,363,7,707,337,189,174
18,"GALAŢI","#N/A",76040,,270,"COSMEŞTI / Căminul Cultural Cosmeşti",3,7362,"COSMEŞTI",76040,1295,715,613,102,0,707,8,1433,718,443,264
18,"GALAŢI","#N/A",76040,,271,"COSMEŞTII-VALE / Şcoala cu clasele I-VIII Cosmeşti Vale",3,7362,"COSMEŞTI",76040,964,625,570,55,0,595,30,1057,432,410,185
18,"GALAŢI","#N/A",76040,,272,"BĂLTĂREŢI / Şcoala cu calsele I-IV Băltăreţi",3,7362,"COSMEŞTI",76040,752,416,380,36,0,415,1,824,408,249,166
18,"GALAŢI","#N/A",76040,,273,"FURCENII VECHI / CAMIN CULTURAL din sat Furcenii Vechi",3,7362,"COSMEŞTI",76040,1291,654,604,50,0,645,9,1422,768,379,266
18,"GALAŢI","#N/A",76040,,274,"FURCENII NOI / Scoala cu clasele I-VIII Furcenii Noi",3,7362,"COSMEŞTI",76040,1302,586,556,30,0,577,9,1433,847,330,247
18,"GALAŢI","#N/A",76111,,275,"COSTACHE NEGRI / SCOALA GIMNAZIALA COSTACHE NEGRI",3,7369,"COSTACHE NEGRI",76111,1109,715,626,69,20,706,9,1222,507,422,284
18,"GALAŢI","#N/A",76111,,276,"COSTACHE NEGRI / SCOALA GIMNAZIALA COSTACHE NEGRI",3,7369,"COSTACHE NEGRI",76111,1020,685,581,82,22,680,5,1126,441,411,269
18,"GALAŢI","#N/A",76139,,277,"CUCA / Căminul Cultural Cuca",3,7371,"CUCA",76139,1012,655,547,91,17,647,8,1115,460,448,199
18,"GALAŢI","#N/A",76139,,278,"CUCA / Şcoala generală Cuca",3,7371,"CUCA",76139,952,578,502,55,21,573,5,1051,473,422,151
18,"GALAŢI","#N/A",76157,,279,"CUDALBI / Şcoala gimnaziala nr.1,  Cudalbi",3,7373,"CUDALBI",76157,1729,1020,931,68,21,1001,19,1918,898,677,324
18,"GALAŢI","#N/A",76157,,280,"CUDALBI / Şcoala gimnaziala nr.1 Cudalbi, ,",3,7373,"CUDALBI",76157,1500,889,786,79,24,860,29,1630,741,572,288
18,"GALAŢI","#N/A",76157,,281,"CUDALBI / Şcoala gimnaziala nr.1 Cudalbi, ,",3,7373,"CUDALBI",76157,1328,709,680,27,2,696,13,1483,774,440,256
18,"GALAŢI","#N/A",76157,,282,"CUDALBI / Şcoala gimnaziala nr.2 Cudalbi",3,7373,"CUDALBI",76157,1739,954,885,54,15,930,24,1915,961,571,359
18,"GALAŢI","#N/A",77595,,283,"CUZA VODĂ / Şcoala gimnaziala Elena Doamna,",3,7375,"CUZA VODĂ",77595,1246,776,694,42,40,770,6,1376,600,533,237
18,"GALAŢI","#N/A",77595,,284,"CUZA VODĂ / Şcoala gimnaziala Elena Doamna,",3,7375,"CUZA VODĂ",77595,1114,685,604,42,39,677,8,1228,543,459,218
18,"GALAŢI","#N/A",75221,,285,"DRĂGĂNEŞTI / Scoala din satul Drăgăneşti",3,7377,"DRĂGĂNEŞTI",75221,1844,955,915,36,4,948,7,2022,1067,472,476
18,"GALAŢI","#N/A",75221,,286,"DRĂGĂNEŞTI / Caminul cultural din satul Drăgăneşti",3,7377,"DRĂGĂNEŞTI",75221,1701,873,820,53,0,862,11,1854,981,421,441
18,"GALAŢI","#N/A",75221,,287,"MALU ALB / Scoala din Malul Alb",3,7377,"DRĂGĂNEŞTI",75221,1682,942,879,58,5,923,19,1872,930,308,615
18,"GALAŢI","#N/A",76175,,288,"DRĂGUŞENI / Şcoala Drăguşeni",3,7380,"DRĂGUŞENI",76175,1463,787,721,66,0,774,13,1649,862,541,233
18,"GALAŢI","#N/A",76175,,289,"FUNDEANU / Scoala Fundeanu",3,7380,"DRĂGUŞENI",76175,750,383,357,26,0,381,2,812,429,237,144
18,"GALAŢI","#N/A",76175,,290,"NICOPOLE / Scoala Nicopole",3,7380,"DRĂGUŞENI",76175,452,217,193,24,0,215,2,483,266,141,74
18,"GALAŢI","#N/A",76175,,291,"CĂUIEŞTI / Scoala Căuieşti",3,7380,"DRĂGUŞENI",76175,471,261,237,24,0,257,4,485,224,189,68
18,"GALAŢI","#N/A",76175,,292,"ŞTIEŢEŞTI / Scoala Ştieteşti",3,7380,"DRĂGUŞENI",76175,250,162,140,22,0,162,0,270,108,62,100
18,"GALAŢI","#N/A",76175,,293,"ADAM / Scoala Adam",3,7380,"DRĂGUŞENI",76175,589,351,293,58,0,349,2,680,329,191,158
18,"GALAŢI","#N/A",76175,,294,"GHINGHEŞTI / Scoala Ghingheşti",3,7380,"DRĂGUŞENI",76175,229,148,132,16,0,144,4,253,105,115,29
18,"GALAŢI","#N/A",76255,,295,"FÎRŢĂNEŞTI / Caminul Cultural Firtanesti",3,7388,"FÎRŢĂNEŞTI",76255,1394,798,718,80,0,790,8,1535,737,640,150
18,"GALAŢI","#N/A",76255,,296,"FÎRŢĂNEŞTI / Caminul Cultural Firtanesti",3,7388,"FÎRŢĂNEŞTI",76255,1425,783,741,41,1,778,5,1558,775,600,178
18,"GALAŢI","#N/A",76255,,297,"VIILE / Căminul Cultural Viile",3,7388,"FÎRŢĂNEŞTI",76255,1305,810,735,75,0,807,3,1439,629,653,154
18,"GALAŢI","#N/A",76282,,298,"FOLTEŞTI / Caminul Cultural",3,7391,"FOLTEŞTI",76282,919,498,431,63,4,495,3,1012,514,343,152
18,"GALAŢI","#N/A",76282,,299,"FOLTEŞTI / Caminul Cultural",3,7391,"FOLTEŞTI",76282,926,548,478,61,9,541,7,1024,476,354,187
18,"GALAŢI","#N/A",76282,,300,"STOICANI / Scoala Gimnaziala nr.1 Stoicani",3,7391,"FOLTEŞTI",76282,854,550,469,72,9,545,5,939,389,381,164
18,"GALAŢI","#N/A",76317,,301,"FRUMUŞIŢA / Şcoala generala nr.1 Frumuşiţa (Şcoala  din centru)",3,7394,"FRUMUŞIŢA",76317,1848,957,895,62,0,943,14,2055,1098,655,288
18,"GALAŢI","#N/A",76317,,302,"FRUMUŞIŢA / Scoala generală nr.2 Petru Rareş",3,7394,"FRUMUŞIŢA",76317,864,494,442,52,0,488,6,920,426,368,120
18,"GALAŢI","#N/A",76317,,303,"IJDILENI / Scoala generala Ijdileni",3,7394,"FRUMUŞIŢA",76317,757,352,322,30,0,350,2,862,510,248,102
18,"GALAŢI","#N/A",76317,,304,"TĂMĂOANI / Scoala generala Tămăoani",3,7394,"FRUMUŞIŢA",76317,959,506,450,56,0,502,4,1049,543,361,141
18,"GALAŢI","#N/A",76353,,305,"FUNDENI / Şcoala generala Fundeni",3,7398,"FUNDENI",76353,676,491,426,60,5,485,6,734,243,255,230
18,"GALAŢI","#N/A",76353,,306,"LUNGOCI / Scoala elementara Lungoci",3,7398,"FUNDENI",76353,459,336,275,57,4,335,1,505,169,233,102
18,"GALAŢI","#N/A",76353,,307,"HANU CONACHI / Şcoala generala Hanu Conachi",3,7398,"FUNDENI",76353,1248,740,679,54,7,731,9,1379,639,376,355
18,"GALAŢI","#N/A",76353,,308,"HANU CONACHI / Şcoala generala Hanu Conachi",3,7398,"FUNDENI",76353,870,534,470,58,6,528,6,956,422,302,226
18,"GALAŢI","#N/A",76406,,309,"GHIDIGENI / Grădiniţa Ghidigeni",3,7403,"GHIDIGENI",76406,1609,934,872,62,0,919,15,1777,843,476,443
18,"GALAŢI","#N/A",76406,,310,"GEFU / Şcoala  Gefu",3,7403,"GHIDIGENI",76406,757,546,527,19,0,539,7,836,290,264,275
18,"GALAŢI","#N/A",76406,,311,"GÎRBOVĂŢ / Şcoala Gârbovăţ",3,7403,"GHIDIGENI",76406,220,131,106,25,0,130,1,243,112,68,62
18,"GALAŢI","#N/A",76406,,312,"TĂLPIGI / Şcoala  Tălpigi",3,7403,"GHIDIGENI",76406,1635,1042,989,53,0,1023,19,1795,753,381,642
18,"GALAŢI","#N/A",76406,,313,"SLOBOZIA CORNI / Şcoala  Slobozia",3,7403,"GHIDIGENI",76406,601,409,376,33,0,406,3,661,252,183,223
18,"GALAŢI","#N/A",76497,,314,"GOHOR / Şcoala Gimnaziala nr.1 Gohor",3,7412,"GOHOR",76497,1409,836,750,82,4,823,13,1555,719,522,301
18,"GALAŢI","#N/A",76497,,315,"IREASCA / Şcoala cu clasele I-IV Ireasca",3,7412,"GOHOR",76497,232,156,119,37,0,154,2,252,96,113,41
18,"GALAŢI","#N/A",76497,,316,"NĂRTEŞTI / Şcoala cu clasele I-IV Nărteşti",3,7412,"GOHOR",76497,683,427,379,48,0,420,7,752,325,283,137
18,"GALAŢI","#N/A",76497,,317,"GARA BERHECI / Şcoala gimnaziala - sat Gara Berheci",3,7412,"GOHOR",76497,521,327,274,53,0,323,4,570,243,229,94
18,"GALAŢI","#N/A",76558,,318,"GRIVIŢA / Scoala Noua Grivita",3,7418,"GRIVIŢA",76558,1514,775,705,55,15,764,11,1674,899,437,327
18,"GALAŢI","#N/A",76558,,319,"GRIVIŢA / Şcoala Veche Griviţa",3,7418,"GRIVIŢA",76558,1030,582,530,46,6,575,7,1125,543,339,236
18,"GALAŢI","#N/A",76558,,320,"CĂLMĂŢUI / Scoala Primara, sat Călmăţui",3,7418,"GRIVIŢA",76558,553,308,283,25,0,301,7,609,301,155,146
18,"GALAŢI","#N/A",76585,,321,"INDEPENDENŢA / SCOALA GIMNAZIALA NR. 1",3,7421,"INDEPENDENŢA",76585,1381,861,770,75,16,848,13,1518,657,503,345
18,"GALAŢI","#N/A",76585,,322,"INDEPENDENŢA / Scoala Gimnaziala nr. 2",3,7421,"INDEPENDENŢA",76585,1621,1026,919,88,19,1018,8,1784,758,540,478
18,"GALAŢI","#N/A",76585,,323,"INDEPENDENŢA / Cladirea Gradinita nr.1",3,7421,"INDEPENDENŢA",76585,915,525,446,70,9,517,8,1007,482,302,215
18,"GALAŢI","#N/A",76601,,324,"IVEŞTI / Şcoala nr.2 Iveşti",3,7423,"IVEŞTI",76601,722,417,364,40,13,413,4,785,368,281,132
18,"GALAŢI","#N/A",76601,,325,"IVEŞTI / Şcoala gimnaziala nr.3 Iveşti",3,7423,"IVEŞTI",76601,1479,939,858,80,1,923,16,1625,686,737,186
18,"GALAŢI","#N/A",76601,,326,"IVEŞTI / Liceul Tehnologic ""Hortensia Papadat - Bengescu""",3,7423,"IVEŞTI",76601,1002,558,482,68,8,552,6,1087,529,403,149
18,"GALAŢI","#N/A",76601,,327,"IVEŞTI / Liceul Tehnologic ""Hortensia Papadat - Bengescu""",3,7423,"IVEŞTI",76601,957,650,581,60,9,635,15,1049,399,555,80
18,"GALAŢI","#N/A",76601,,328,"BUCEŞTI / Şcoala Gimnaziala ""Negoiţă Dănăilă""",3,7423,"IVEŞTI",76601,1915,954,870,79,5,942,12,2103,1149,587,355
18,"GALAŢI","#N/A",76601,,329,"BUCEŞTI / Şcoala Gimnaziala ""Gen.Eremia Grigorescu""",3,7423,"IVEŞTI",76601,1768,960,866,90,4,948,12,1979,1019,515,433
18,"GALAŢI","#N/A",76638,,330,"JORĂŞTI / CAMINUL CULTURAL JORASTI",3,7426,"JORĂŞTI",76638,928,586,515,59,12,582,4,1027,441,443,139
18,"GALAŢI","#N/A",76638,,331,"LUNCA / SALA INTRUNIR LUNCA",3,7426,"JORĂŞTI",76638,182,134,109,25,0,133,1,199,65,99,34
18,"GALAŢI","#N/A",76638,,332,"ZĂRNEŞTI / CAMIN CULTURAL ZARNESTI",3,7426,"JORĂŞTI",76638,297,206,181,24,1,205,1,327,121,89,116
18,"GALAŢI","#N/A",76674,,333,"LIEŞTI / Şcoala gimn. Nr. 1",3,7430,"LIEŞTI",76674,1463,828,759,69,0,819,9,1610,782,352,467
18,"GALAŢI","#N/A",76674,,334,"LIEŞTI / Şcoala gimn. Nr. 2",3,7430,"LIEŞTI",76674,1534,779,731,48,0,762,17,1714,935,341,421
18,"GALAŢI","#N/A",76674,,335,"LIEŞTI / Şcoala gimn. Nr. 2",3,7430,"LIEŞTI",76674,1613,933,862,64,7,918,15,1770,837,371,547
18,"GALAŢI","#N/A",76674,,336,"LIEŞTI / Şcoala gimn. Nr. 3",3,7430,"LIEŞTI",76674,1369,794,720,71,3,788,6,1487,693,347,441
18,"GALAŢI","#N/A",76674,,337,"LIEŞTI / Gradinita nr. 3",3,7430,"LIEŞTI",76674,1403,780,702,78,0,765,15,1532,752,278,487
18,"GALAŢI","#N/A",76674,,338,"LIEŞTI / Scoala gimnazială ""Sf.Nicolae""",3,7430,"LIEŞTI",76674,1573,881,813,65,3,874,7,1748,867,353,521
18,"GALAŢI","#N/A",76692,,339,"MATCA / Şcoala nr.2 Matca",3,7435,"MATCA",76692,1477,947,815,132,0,929,18,1626,679,302,627
18,"GALAŢI","#N/A",76692,,340,"MATCA / Şcoala nr.1 Suseni",3,7435,"MATCA",76692,1752,1045,940,105,0,1029,16,1925,880,375,654
18,"GALAŢI","#N/A",76692,,341,"MATCA / Scoala nr.1 Matca",3,7435,"MATCA",76692,1526,855,809,46,0,838,17,1487,632,281,557
18,"GALAŢI","#N/A",76692,,342,"MATCA / Scoala nr.1 Matca",3,7435,"MATCA",76692,1562,872,813,59,0,859,13,1724,852,279,580
18,"GALAŢI","#N/A",76692,,343,"MATCA / Şcoala nr.1 Matca",3,7435,"MATCA",76692,1660,901,824,77,0,880,21,1824,923,351,529
18,"GALAŢI","#N/A",76692,,344,"MATCA / Scoala nr.3 Matca",3,7435,"MATCA",76692,1784,1094,963,131,0,1083,11,1962,868,424,659
18,"GALAŢI","#N/A",76718,,345,"MĂSTĂCANI / SCOALA GIMNAZIALA NR 1 GHE. POALELUNGI MASTACANI",3,7432,"MĂSTĂCANI",76718,997,545,460,74,11,539,6,1091,546,414,125
18,"GALAŢI","#N/A",76718,,346,"MĂSTĂCANI / SCOALA GIMNAZIALA NR. 3 MĂSTĂCANI",3,7432,"MĂSTĂCANI",76718,833,474,410,60,4,470,4,926,452,295,175
18,"GALAŢI","#N/A",76718,,347,"CHIRAFTEI / SCOALA GIMNAZIALA NR. 1 CHIRAFTEI",3,7432,"MĂSTĂCANI",76718,1093,632,555,66,11,618,14,1191,559,470,148
18,"GALAŢI","#N/A",76718,,348,"CHIRAFTEI / SCOALA GIMNAZIALA NR. 2 CHIRAFTEI",3,7432,"MĂSTĂCANI",76718,1105,574,505,52,17,564,10,1229,655,392,172
18,"GALAŢI","#N/A",76745,,349,"MOVILENI / CAMIN CULTURAL",3,7437,"MOVILENI",76745,1518,713,662,49,2,704,9,1658,945,382,322
18,"GALAŢI","#N/A",76745,,350,"MOVILENI / SCOALA NR.2 MOVILENI",3,7437,"MOVILENI",76745,1181,583,558,25,0,570,13,1272,689,272,298
18,"GALAŢI","#N/A",75258,,351,"MUNTENI / Caminul  cultural  Munteni",3,7439,"MUNTENI",75258,1390,847,800,47,0,836,11,1540,693,448,388
18,"GALAŢI","#N/A",75258,,352,"MUNTENI / Scoala generală nr.1 sat Munteni",3,7439,"MUNTENI",75258,1587,922,876,46,0,905,17,1745,823,453,452
18,"GALAŢI","#N/A",75258,,353,"FRUNZEASCA / Scoala generală Frunzeasca",3,7439,"MUNTENI",75258,1008,624,603,20,1,616,8,1099,475,278,338
18,"GALAŢI","#N/A",75258,,354,"ŢIGĂNEŞTI / Scoala generală - sat Ţigăneşti",3,7439,"MUNTENI",75258,837,526,487,39,0,518,8,920,394,227,291
18,"GALAŢI","#N/A",75258,,355,"UNGURENI / Scoala generală Ungureni",3,7439,"MUNTENI",75258,1136,629,602,27,0,616,13,1254,625,347,269
18,"GALAŢI","#N/A",76763,,356,"NĂMOLOASA / SCOALA GENERALA NAMOLOASA",3,7444,"NĂMOLOASA",76763,841,611,513,72,26,603,8,925,314,422,181
18,"GALAŢI","#N/A",76763,,357,"NĂMOLOASA SAT / SCOALA GENERALA NAMOLOASA SAT",3,7444,"NĂMOLOASA",76763,966,674,547,91,36,666,8,1064,390,525,141
18,"GALAŢI","#N/A",77579,,358,"NEGRILEŞTI / Căminul cultural din satul Negrileşti",3,7448,"NEGRILEŞTI",77579,1426,986,890,60,36,955,31,1572,586,658,297
18,"GALAŢI","#N/A",77579,,359,"SLOBOZIA BLĂNEASA / Scoala generală Slobozia Blăneasa",3,7448,"NEGRILEŞTI",77579,706,544,495,40,9,524,20,778,234,323,201
18,"GALAŢI","#N/A",76807,,360,"NICOREŞTI / Şcoala Nicoreşti",3,7451,"NICOREŞTI",76807,1216,707,597,108,2,703,4,1346,639,267,436
18,"GALAŢI","#N/A",76807,,361,"FÎNTÎNI / Şcoala Fîntâni",3,7451,"NICOREŞTI",76807,499,330,276,52,2,322,8,548,218,152,170
18,"GALAŢI","#N/A",76807,,362,"COASTA LUPEI / Şcoala Coasta Lupei",3,7451,"NICOREŞTI",76807,266,195,143,52,0,194,1,293,98,87,107
18,"GALAŢI","#N/A",76807,,363,"PISCU CORBULUI / Şcoala Piscu Corbului",3,7451,"NICOREŞTI",76807,226,157,131,26,0,156,1,249,92,80,76
18,"GALAŢI","#N/A",76807,,364,"MĂLURENI / Şcoala Mălureni",3,7451,"NICOREŞTI",76807,160,125,97,22,6,123,2,176,51,55,68
18,"GALAŢI","#N/A",76807,,365,"IONĂŞEŞTI / Şcoala Ionăşeşti",3,7451,"NICOREŞTI",76807,552,336,302,22,12,334,2,607,271,99,235
18,"GALAŢI","#N/A",76807,,366,"DOBRINEŞTI / Şcoala Dobrineşti.",3,7451,"NICOREŞTI",76807,390,242,200,42,0,239,3,424,182,85,154
18,"GALAŢI","#N/A",76932,,367,"OANCEA / Scoala Gimnaziala Oancea",3,7462,"OANCEA",76932,1166,974,712,191,71,964,10,1286,312,397,567
18,"GALAŢI","#N/A",76969,,368,"PECHEA / Scoala nr.1 Pechea",3,7465,"PECHEA",76969,1356,764,691,72,1,757,7,1495,731,442,315
18,"GALAŢI","#N/A",76969,,369,"PECHEA / Scoala nr.2 Pechea",3,7465,"PECHEA",76969,1432,808,712,94,2,798,10,1571,763,550,248
18,"GALAŢI","#N/A",76969,,370,"PECHEA / Scoala nr.3 Pechea",3,7465,"PECHEA",76969,1408,786,742,44,0,778,8,1594,808,519,259
18,"GALAŢI","#N/A",76969,,371,"PECHEA / Grădiniţa nr.2 Pechea",3,7465,"PECHEA",76969,1353,714,676,38,0,702,12,1475,761,452,250
18,"GALAŢI","#N/A",76969,,372,"PECHEA / Căminul Cultural Pechea",3,7465,"PECHEA",76969,1843,983,914,69,0,972,11,2019,1036,626,346
18,"GALAŢI","#N/A",76969,,373,"PECHEA / Scoala nr.4 Pechea",3,7465,"PECHEA",76969,1677,945,882,54,9,930,15,1833,888,676,254
18,"GALAŢI","#N/A",76996,,374,"PISCU / Căminul Cultural Piscu",3,7468,"PISCU",76996,1126,714,630,84,0,708,6,1249,535,471,237
18,"GALAŢI","#N/A",76996,,375,"PISCU / Scoala generala nr. 1",3,7468,"PISCU",76996,951,605,544,60,1,594,11,1049,444,359,235
18,"GALAŢI","#N/A",76996,,376,"PISCU / Scoala generală nr.2 Piscu",3,7468,"PISCU",76996,1545,970,897,72,1,951,19,1701,731,531,420
18,"GALAŢI","#N/A",76996,,377,"VAMEŞ / scoala vameş",3,7468,"PISCU",76996,449,266,223,42,1,261,5,493,227,158,103
18,"GALAŢI","#N/A",77587,,378,"POIANA / Scola Gimnaziala cu clase I-VIII",3,7471,"POIANA",77587,1010,762,643,95,24,759,3,1114,352,514,245
18,"GALAŢI","#N/A",77587,,379,"VIŞINA / Scola PrimaraVisina",3,7471,"POIANA",77587,379,279,232,36,11,274,5,418,139,192,82
18,"GALAŢI","#N/A",77028,,380,"PRIPONEŞTI / SCOALA GIMNAZIALĂ",3,7474,"PRIPONEŞTI",77028,816,435,379,56,0,432,3,903,468,285,147
18,"GALAŢI","#N/A",77028,,381,"CIORĂŞTI / CĂMIN CULTURAL",3,7474,"PRIPONEŞTI",77028,843,527,438,89,0,525,2,928,401,390,135
18,"GALAŢI","#N/A",77028,,382,"LIEŞTI / ŞCOALA PRIMARĂ",3,7474,"PRIPONEŞTI",77028,175,124,81,43,0,124,0,191,67,88,36
18,"GALAŢI","#N/A",77561,,383,"RĂDEŞTI / Căminul Cultural Rădeşti",3,7480,"RĂDEŞTI",77561,995,624,544,80,0,613,11,1097,473,472,141
18,"GALAŢI","#N/A",77561,,384,"CRUCEANU / Grădiniţa Cruceanu",3,7480,"RĂDEŞTI",77561,251,166,138,28,0,163,3,276,110,129,34
18,"GALAŢI","#N/A",77082,,385,"REDIU / Scoala Gimnaziala Nr. 1 Rediu",3,7483,"REDIU",77082,1401,899,715,118,66,893,6,1543,644,607,286
18,"GALAŢI","#N/A",77082,,386,"PLEVNA / Scoala Nr1 Plevna",3,7483,"REDIU",77082,466,306,242,48,16,302,4,511,205,233,69
18,"GALAŢI","#N/A",77153,,387,"SCHELA / GRADINITA DE COPII SCHELA",3,7486,"SCHELA",77153,1353,942,847,66,29,929,13,1485,543,573,356
18,"GALAŢI","#N/A",77153,,388,"SCHELA / GRADINITA DE COPII SCHELA",3,7486,"SCHELA",77153,1138,788,691,66,31,779,9,1250,462,470,309
18,"GALAŢI","#N/A",77153,,389,"NEGREA / Scoala generala Negrea",3,7486,"SCHELA",77153,549,424,310,78,36,419,5,605,181,290,129
18,"GALAŢI","#N/A",77126,,390,"SCÎNTEIEŞTI / CAMINUL CULTURAL",3,7489,"SCÎNTEIEŞTI",77126,746,496,394,70,32,485,11,816,320,341,144
18,"GALAŢI","#N/A",77126,,391,"FÎNTÎNELE / CAMINUL CULTURAL",3,7489,"SCÎNTEIEŞTI",77126,1336,841,723,75,43,826,15,1481,640,602,224
18,"GALAŢI","#N/A",77180,,392,"SLOBOZIA CONACHI / Scoala Gimnaziala slobozia-Conachi",3,7496,"SLOBOZIA CONACHI",77180,1414,887,789,42,56,877,10,1582,695,563,314
18,"GALAŢI","#N/A",77180,,393,"SLOBOZIA CONACHI / Centrul de Formare Profesionala",3,7496,"SLOBOZIA CONACHI",77180,1242,798,690,79,29,792,6,1405,607,509,283
18,"GALAŢI","#N/A",77180,,394,"IZVOARELE / Scoala Gimnaziala Izvoarele",3,7496,"SLOBOZIA CONACHI",77180,864,580,475,73,32,576,4,892,312,389,187
18,"GALAŢI","#N/A",77224,,395,"SMÎRDAN / Scoala generală ""Sfânta Cuvioasă Parascheva"" Smîrdan",3,7499,"SMÎRDAN",77224,1250,785,685,100,0,776,9,1374,589,443,333
18,"GALAŢI","#N/A",77224,,396,"SMÎRDAN / Şcoala generală  ""Sfânta Cuvioasă Parascheva"" Smârdan",3,7499,"SMÎRDAN",77224,1077,613,527,86,0,597,16,1177,564,357,240
18,"GALAŢI","#N/A",77224,,397,"MIHAIL KOGĂLNICEANU / Scoala gimnazială ""Mihail şi Gavril"" M.Kogălniceanu",3,7499,"SMÎRDAN",77224,795,504,455,47,2,496,8,871,367,335,161
18,"GALAŢI","#N/A",77224,,398,"CIŞMELE / Scoala primară ""Mihail şi Gavril"" din satul Cişmele",3,7499,"SMÎRDAN",77224,1164,686,640,35,11,684,2,1275,589,470,214
18,"GALAŢI","#N/A",77260,,399,"SMULŢI / GRADINITA SMULTI",3,7503,"SMULŢI",77260,1216,799,664,119,16,788,11,1341,542,594,194
18,"GALAŢI","#N/A",77288,,400,"SUCEVENI / Căminul Cultural Suceveni",3,7505,"SUCEVENI",77288,1002,803,591,185,27,789,14,1104,301,560,229
18,"GALAŢI","#N/A",77288,,401,"ROGOJENI / Scoala gimnazială Rogojeni",3,7505,"SUCEVENI",77288,508,362,282,71,9,356,6,557,195,243,113
18,"GALAŢI","#N/A",77601,,402,"SUHURLUI / Scoala gimnazială nr.1 Suhurlui",3,7508,"SUHURLUI",77601,1191,676,563,78,35,672,4,1309,633,375,297
18,"GALAŢI","#N/A",75114,,403,"ŞENDRENI / Scoala Gimnaziala nr. 1",3,7492,"ŞENDRENI",75114,1343,911,782,115,14,905,6,1477,566,430,475
18,"GALAŢI","#N/A",75114,,404,"ŞENDRENI / Scoala Gimnaziala nr. 1",3,7492,"ŞENDRENI",75114,988,754,612,136,6,742,12,1084,330,345,397
18,"GALAŢI","#N/A",75114,,405,"MOVILENI / Gradinita Movileni",3,7492,"ŞENDRENI",75114,567,371,309,49,13,367,4,624,253,185,182
18,"GALAŢI","#N/A",75114,,406,"ŞERBEŞTII VECHI / Gradinita Serbestii Vechi",3,7492,"ŞENDRENI",75114,579,377,314,63,0,376,1,636,259,161,215
18,"GALAŢI","#N/A",77313,,407,"TUDOR VLADIMIRESCU / Scoala generală de 8 ani T.Vladimirescu (moara)",3,7513,"TUDOR VLADIMIRESCU",77313,811,476,414,62,0,469,7,893,417,278,191
18,"GALAŢI","#N/A",77313,,408,"TUDOR VLADIMIRESCU / Grădiniţa Tudor Vladimirescu,",3,7513,"TUDOR VLADIMIRESCU",77313,1377,877,782,95,0,866,11,1513,636,495,371
18,"GALAŢI","#N/A",77313,,409,"TUDOR VLADIMIRESCU / Scoala generala de 4 ani - Prival",3,7513,"TUDOR VLADIMIRESCU",77313,959,635,561,74,0,622,13,1058,423,435,187
18,"GALAŢI","#N/A",77313,,410,"TUDOR VLADIMIRESCU / Liceul Tehnologic ""Tudor Vladimirescu""",3,7513,"TUDOR VLADIMIRESCU",77313,1250,787,710,77,0,780,7,1379,592,445,335
18,"GALAŢI","#N/A",77331,,411,"TULUCEŞTI / GRADINITA TULUCESTI",3,7515,"TULUCEŞTI",77331,1708,988,887,98,3,975,13,1884,896,569,406
18,"GALAŢI","#N/A",77331,,412,"TULUCEŞTI / SCOALA TULUCESTI",3,7515,"TULUCEŞTI",77331,1792,1021,905,115,1,1010,11,1968,947,591,419
18,"GALAŢI","#N/A",77331,,413,"TĂTARCA / SCOALA TATARCA",3,7515,"TULUCEŞTI",77331,765,407,378,29,0,401,6,858,451,242,159
18,"GALAŢI","#N/A",77331,,414,"ŞIVIŢA / SCOALA SIVITA",3,7515,"TULUCEŞTI",77331,1049,604,556,44,4,597,7,1151,547,397,200
18,"GALAŢI","#N/A",77331,,415,"ŞIVIŢA / GRADINITA SIVITA",3,7515,"TULUCEŞTI",77331,1064,553,506,47,0,547,6,1165,612,346,201
18,"GALAŢI","#N/A",77377,,416,"ŢEPU / SCOALA TUDOR PAMFILE",3,7510,"ŢEPU",77377,1249,785,716,63,6,773,12,1377,592,365,408
18,"GALAŢI","#N/A",77377,,417,"ŢEPU / GRĂDINIŢA PROFESOR IOAN BASOC",3,7510,"ŢEPU",77377,860,570,539,27,4,559,11,947,377,312,247
18,"GALAŢI","#N/A",77402,,418,"UMBRĂREŞTI / SC.GEN. UMBRARESTI",3,7519,"UMBRĂREŞTI",77402,1715,803,743,60,0,795,8,1925,1122,499,296
18,"GALAŢI","#N/A",77402,,419,"UMBRĂREŞTI-DEAL / SC.GEN. UMBRARESTI-DEAL",3,7519,"UMBRĂREŞTI",77402,1170,639,611,28,0,631,8,1273,634,375,256
18,"GALAŢI","#N/A",77402,,420,"UMBRĂREŞTI-DEAL / SC.GEN. UMBRARESTI-DEAL",3,7519,"UMBRĂREŞTI",77402,817,421,400,21,0,413,8,889,468,273,140
18,"GALAŢI","#N/A",77402,,421,"TORCEŞTI / SC. TORCESTI",3,7519,"UMBRĂREŞTI",77402,575,372,338,34,0,367,5,617,245,240,127
18,"GALAŢI","#N/A",77402,,422,"CONDREA / SC. CONDREA",3,7519,"UMBRĂREŞTI",77402,547,289,249,40,0,285,4,612,323,176,109
18,"GALAŢI","#N/A",77402,,423,"SALCIA / SC. SALCIA",3,7519,"UMBRĂREŞTI",77402,710,338,310,28,0,330,8,774,436,191,139
18,"GALAŢI","#N/A",77402,,424,"SILIŞTEA / SC. SILISTEA",3,7519,"UMBRĂREŞTI",77402,294,166,140,26,0,166,0,325,159,85,81
18,"GALAŢI","#N/A",77475,,425,"VALEA MĂRULUI / ŞCOALA GIMNAZIALĂ NR.1",3,7526,"VALEA MĂRULUI",77475,981,629,553,61,15,623,6,1079,450,431,192
18,"GALAŢI","#N/A",77475,,426,"VALEA MĂRULUI / ŞCOALA GIMNAZIALĂ NR. 1",3,7526,"VALEA MĂRULUI",77475,806,498,451,33,14,490,8,893,395,370,120
18,"GALAŢI","#N/A",77475,,427,"VALEA MĂRULUI / ŞCOALA COASTA VĂII",3,7526,"VALEA MĂRULUI",77475,358,248,224,15,9,245,3,392,144,173,72
18,"GALAŢI","#N/A",77475,,428,"MÎNDREŞTI / ŞCOALA MÎNDRESTI",3,7526,"VALEA MĂRULUI",77475,823,518,463,48,7,510,8,909,391,391,119
18,"GALAŢI","#N/A",75150,,429,"VÎNĂTORI / SCOALA SFINTUL NICOLAE",3,7529,"VÎNĂTORI",75150,1072,704,613,90,1,701,3,1176,472,368,333
18,"GALAŢI","#N/A",75150,,430,"VÎNĂTORI / SCOALA SFINTUL NICOLAE",3,7529,"VÎNĂTORI",75150,1023,696,618,78,0,686,10,1122,426,393,293
18,"GALAŢI","#N/A",75150,,431,"ODAIA MANOLACHE / SCOALA Maria Grecu",3,7529,"VÎNĂTORI",75150,1453,979,906,73,0,974,5,1596,617,601,373
18,"GALAŢI","#N/A",75150,,432,"COSTI / Gradinita copii",3,7529,"VÎNĂTORI",75150,795,605,486,119,0,588,17,862,257,286,302
18,"GALAŢI","#N/A",77509,,433,"VÎRLEZI / Scoala gimnazială Vîrlezi",3,7533,"VÎRLEZI",77509,939,690,537,90,63,682,8,1035,345,473,209
18,"GALAŢI","#N/A",77509,,434,"CRĂIEŞTI / Grădiniţa Crăieşti",3,7533,"VÎRLEZI",77509,672,503,434,58,11,491,12,738,235,335,156
18,"GALAŢI","#N/A",77536,,435,"VLĂDEŞTI / Căminul Cultural Vlădeşti",3,7536,"VLĂDEŞTI",77536,1020,723,548,129,46,709,14,1120,397,407,302
18,"GALAŢI","#N/A",77536,,436,"BRĂNEŞTI / ŞCOALA GIMNAZIALĂ BRĂNEŞTI",3,7536,"VLĂDEŞTI",77536,802,516,394,106,16,506,10,876,360,281,225
19,"GIURGIU",528,100521,,1,"GIURGIU / Şcoala Generală nr.1",1,7540,"MUNICIPIUL GIURGIU",100521,1244,797,747,50,0,771,26,1378,581,472,299
19,"GIURGIU",528,100521,,2,"GIURGIU / Galeriile de artă",1,7540,"MUNICIPIUL GIURGIU",100521,1077,749,695,54,0,728,21,1188,439,459,269
19,"GIURGIU",528,100521,,3,"GIURGIU / S.C. EUROTEHNOGRUP S.R.L.",1,7540,"MUNICIPIUL GIURGIU",100521,1234,725,681,44,0,699,26,1357,632,418,281
19,"GIURGIU",528,100521,,4,"GIURGIU / Liceul ""Tudor Vianu""",1,7540,"MUNICIPIUL GIURGIU",100521,1264,787,755,32,0,771,16,1405,618,521,250
19,"GIURGIU",528,100521,,5,"GIURGIU / Şcoala Generală nr.2",1,7540,"MUNICIPIUL GIURGIU",100521,1344,846,812,33,1,832,14,1475,629,560,272
19,"GIURGIU",528,100521,,6,"GIURGIU / Liceul de Chimie",1,7540,"MUNICIPIUL GIURGIU",100521,1193,588,564,24,0,576,12,1321,733,379,197
19,"GIURGIU",528,100521,,7,"GIURGIU / Cantina Seminarului ""Sf. Ioan Valahul""",1,7540,"MUNICIPIUL GIURGIU",100521,900,516,480,36,0,506,10,993,477,362,144
19,"GIURGIU",528,100521,,8,"GIURGIU / Colegiul Tehnic Viceamiral Ioan Bălănescu",1,7540,"MUNICIPIUL GIURGIU",100521,999,562,540,21,1,556,6,1100,538,404,152
19,"GIURGIU",528,100521,,9,"GIURGIU / Liceul ""Nicolae Cartojan""",1,7540,"MUNICIPIUL GIURGIU",100521,1295,745,709,36,0,724,21,1431,686,525,199
19,"GIURGIU",528,100521,,10,"GIURGIU / Liceul ""Nicolae Cartojan""",1,7540,"MUNICIPIUL GIURGIU",100521,1149,619,584,35,0,615,4,1268,649,451,164
19,"GIURGIU",528,100521,,11,"GIURGIU / Palatul Copiilor (Parcul Elevilor)",1,7540,"MUNICIPIUL GIURGIU",100521,1249,824,690,36,98,816,8,1376,552,603,213
19,"GIURGIU",528,100521,,12,"GIURGIU / Şcoala Generală nr.3",1,7540,"MUNICIPIUL GIURGIU",100521,1387,847,679,25,143,834,13,1527,680,650,184
19,"GIURGIU",528,100521,,13,"GIURGIU / Grădiniţa nr.8",1,7540,"MUNICIPIUL GIURGIU",100521,1340,916,750,29,137,902,14,1472,556,691,211
19,"GIURGIU",528,100521,,14,"GIURGIU / Direcţia pentru Agricultură Judeţeană",1,7540,"MUNICIPIUL GIURGIU",100521,1450,669,520,16,133,651,18,1609,940,539,112
19,"GIURGIU",528,100521,,15,"GIURGIU / Direcţia pentru Agricultură Judeţeană",1,7540,"MUNICIPIUL GIURGIU",100521,1182,742,575,24,143,735,7,1310,568,589,146
19,"GIURGIU",528,100521,,16,"GIURGIU / Fosta Şcoală nr.9",1,7540,"MUNICIPIUL GIURGIU",100521,1721,892,862,30,0,877,15,1895,1003,629,248
19,"GIURGIU",528,100521,,17,"GIURGIU / A.J.O.F.M. Giurgiu",1,7540,"MUNICIPIUL GIURGIU",100521,1583,959,910,48,1,934,25,1749,790,596,338
19,"GIURGIU",528,100521,,18,"GIURGIU / A.J.O.F.M. Giurgiu",1,7540,"MUNICIPIUL GIURGIU",100521,1193,773,680,43,50,751,22,1314,541,483,268
19,"GIURGIU",528,100521,,19,"GIURGIU / Spitalul Judeţean",1,7540,"MUNICIPIUL GIURGIU",100521,1854,1114,978,97,39,1098,16,2043,929,800,298
19,"GIURGIU",528,100521,,20,"GIURGIU / Clubul cadrelor militare în retragere",1,7540,"MUNICIPIUL GIURGIU",100521,1682,991,899,69,23,975,16,1856,865,631,344
19,"GIURGIU",528,100521,,21,"GIURGIU / Şcoala Generală nr.8",1,7540,"MUNICIPIUL GIURGIU",100521,1190,677,648,29,0,666,11,1315,638,432,234
19,"GIURGIU",528,100521,,22,"GIURGIU / Şcoala Generală nr.8",1,7540,"MUNICIPIUL GIURGIU",100521,1215,700,681,19,0,683,17,1336,636,454,229
19,"GIURGIU",528,100521,,23,"GIURGIU / Şcoala Generală nr.8",1,7540,"MUNICIPIUL GIURGIU",100521,1357,764,719,45,0,754,10,1493,729,488,266
19,"GIURGIU",528,100521,,24,"GIURGIU / Şcoala Generală nr.8",1,7540,"MUNICIPIUL GIURGIU",100521,1095,664,639,25,0,648,16,1210,546,433,215
19,"GIURGIU",528,100521,,25,"GIURGIU / Grădiniţa nr.6",1,7540,"MUNICIPIUL GIURGIU",100521,1353,733,701,31,1,715,18,1490,757,466,249
19,"GIURGIU",528,100521,,26,"GIURGIU / Şcoala Generală nr.10",1,7540,"MUNICIPIUL GIURGIU",100521,1171,618,578,40,0,611,7,1290,672,383,228
19,"GIURGIU",528,100521,,27,"GIURGIU / Şcoala Generală nr.10",1,7540,"MUNICIPIUL GIURGIU",100521,1165,634,592,42,0,627,7,1285,651,391,236
19,"GIURGIU",528,100521,,28,"GIURGIU / Şcoala Generală nr.10",1,7540,"MUNICIPIUL GIURGIU",100521,1185,640,621,19,0,629,11,1308,668,422,207
19,"GIURGIU",528,100521,,29,"GIURGIU / Şcoala Generală nr.10",1,7540,"MUNICIPIUL GIURGIU",100521,960,501,479,22,0,496,5,1061,560,348,148
19,"GIURGIU",528,100521,,30,"GIURGIU / Şcoala Generală nr.5",1,7540,"MUNICIPIUL GIURGIU",100521,959,526,496,30,0,521,5,1058,532,329,192
19,"GIURGIU",528,100521,,31,"GIURGIU / Şcoala Generală nr.5",1,7540,"MUNICIPIUL GIURGIU",100521,1256,622,602,20,0,618,4,1390,768,404,214
19,"GIURGIU",528,100521,,32,"GIURGIU / Şcoala Generală nr.5",1,7540,"MUNICIPIUL GIURGIU",100521,1238,679,641,38,0,670,9,1359,680,442,228
19,"GIURGIU",528,100521,,33,"GIURGIU / Dispensar Urban nr.5",1,7540,"MUNICIPIUL GIURGIU",100521,1312,729,685,44,0,714,15,1445,716,478,236
19,"GIURGIU",528,100521,,34,"GIURGIU / Punctul Termic nr.63",1,7540,"MUNICIPIUL GIURGIU",100521,858,447,425,21,1,439,8,947,500,321,118
19,"GIURGIU",528,100521,,35,"GIURGIU / Punctul Termic nr.63",1,7540,"MUNICIPIUL GIURGIU",100521,1160,627,594,31,2,613,14,1276,649,383,230
19,"GIURGIU",528,100521,,36,"GIURGIU / Grădiniţa cu PP nr.9",1,7540,"MUNICIPIUL GIURGIU",100521,1041,527,499,28,0,513,14,1149,622,345,168
19,"GIURGIU",528,100521,,37,"GIURGIU / Grădiniţa cu PP nr.9",1,7540,"MUNICIPIUL GIURGIU",100521,1031,551,515,35,1,538,13,1260,709,359,179
19,"GIURGIU",528,100521,,38,"GIURGIU / Grădiniţa cu PP nr.4",1,7540,"MUNICIPIUL GIURGIU",100521,1131,574,540,34,0,567,7,1246,672,394,173
19,"GIURGIU",528,100521,,39,"GIURGIU / Cantina de Ajutor Social",1,7540,"MUNICIPIUL GIURGIU",100521,1069,509,467,42,0,494,15,1044,535,345,149
19,"GIURGIU",528,100521,,40,"GIURGIU / Şcoala Generală nr.6",1,7540,"MUNICIPIUL GIURGIU",100521,1404,792,749,43,0,778,14,1546,754,563,215
19,"GIURGIU",528,100521,,41,"GIURGIU / Şcoala Generală nr.6",1,7540,"MUNICIPIUL GIURGIU",100521,1186,649,625,24,0,638,11,1313,664,464,174
19,"GIURGIU",528,100521,,42,"GIURGIU / Liceul Economic",1,7540,"MUNICIPIUL GIURGIU",100521,1224,682,645,37,0,672,10,1348,666,450,222
19,"GIURGIU",528,100521,,43,"GIURGIU / Casa Armatei",1,7540,"MUNICIPIUL GIURGIU",100521,1182,656,615,41,0,649,7,1293,637,424,225
19,"GIURGIU",528,100521,,44,"GIURGIU / Liceul ""Ion Maiorescu""",1,7540,"MUNICIPIUL GIURGIU",100521,1218,823,767,56,0,808,15,1273,450,477,331
19,"GIURGIU",528,100521,,45,"GIURGIU / Liceul ""Ion Maiorescu""",1,7540,"MUNICIPIUL GIURGIU",100521,893,626,570,55,1,618,8,1111,485,418,200
19,"GIURGIU",528,100521,,46,"GIURGIU / Şcoala Generală nr.7",1,7540,"MUNICIPIUL GIURGIU",100521,1332,876,801,64,11,860,16,1418,542,547,313
19,"GIURGIU",528,100521,,47,"GIURGIU / Şcoala Generală nr.4",1,7540,"MUNICIPIUL GIURGIU",100521,1442,935,859,76,0,921,14,1603,668,590,331
19,"GIURGIU",528,100521,,48,"GIURGIU / Grădiniţa cu PN",1,7540,"MUNICIPIUL GIURGIU",100521,1392,777,750,27,0,767,10,1551,774,531,236
19,"GIURGIU",528,101190,,49,"BOLINTIN-VALE / Şcoala cu Clasele I-VIII Bolintin-Vale",1,7542,"ORAŞ BOLINTIN-VALE",101190,1242,928,773,150,5,911,17,1362,434,409,502
19,"GIURGIU",528,101190,,50,"BOLINTIN-VALE / Şcoala cu Clasele I-VIII Bolintin-Vale",1,7542,"ORAŞ BOLINTIN-VALE",101190,1291,497,470,27,0,487,10,1420,923,347,140
19,"GIURGIU",528,101190,,51,"BOLINTIN-VALE / Şcoala cu Clasele I-VIII Bolintin-Vale",1,7542,"ORAŞ BOLINTIN-VALE",101190,1536,517,488,28,1,491,26,1684,1167,358,133
19,"GIURGIU",528,101190,,52,"BOLINTIN-VALE / Grup şcolar ""Dimitrie Bolintineanu"" Bolintin -Vale",1,7542,"ORAŞ BOLINTIN-VALE",101190,874,656,535,119,2,648,8,964,308,320,328
19,"GIURGIU",528,101190,,53,"BOLINTIN-VALE / Primărie",1,7542,"ORAŞ BOLINTIN-VALE",101190,1666,987,826,143,18,974,13,1842,855,482,492
19,"GIURGIU",528,101190,,54,"MALU SPART / Şcoala cu Clasele I-VIII Malu Spart",1,7542,"ORAŞ BOLINTIN-VALE",101190,1382,735,703,32,0,728,7,1524,789,402,326
19,"GIURGIU",528,101190,,55,"MALU SPART / Şcoala cu Clasele I-VIII Malu Spart",1,7542,"ORAŞ BOLINTIN-VALE",101190,1579,769,724,45,0,761,8,1734,965,402,359
19,"GIURGIU",528,101190,,56,"CRIVINA / Grădiniţa Crivina",1,7542,"ORAŞ BOLINTIN-VALE",101190,749,443,379,64,0,439,4,821,378,269,170
19,"GIURGIU",528,104136,,57,"MIHĂILEŞTI / Şcoala Generală nr. 1 Mihăileşti",1,7547,"ORAŞ MIHĂILEŞTI",104136,1940,1539,1359,180,0,1525,14,2129,590,981,544
19,"GIURGIU",528,104136,,58,"MIHĂILEŞTI / Şcoala Generală nr. 1 Mihăileşti",1,7547,"ORAŞ MIHĂILEŞTI",104136,890,891,637,254,0,874,17,979,88,557,317
19,"GIURGIU",528,104136,,59,"MIHĂILEŞTI / Şcoala Generală nr. 2 Tufa",1,7547,"ORAŞ MIHĂILEŞTI",104136,1061,965,755,210,0,959,6,1165,200,707,252
19,"GIURGIU",528,104136,,60,"MIHĂILEŞTI / Şcoala Generală nr. 3 Drăgănescu",1,7547,"ORAŞ MIHĂILEŞTI",104136,368,366,283,83,0,362,4,403,37,239,123
19,"GIURGIU",528,104136,,61,"POPEŞTI / Şcoala Generală nr. 4 Popeşti",1,7547,"ORAŞ MIHĂILEŞTI",104136,869,838,724,114,0,833,5,960,122,645,188
19,"GIURGIU",528,104136,,62,"NOVACI / Şcoala Generală nr. 5 Novaci",1,7547,"ORAŞ MIHĂILEŞTI",104136,917,894,745,149,0,881,13,1015,121,660,221
19,"GIURGIU",528,100781,,63,"ADUNAŢII-COPĂCENI / Şcoala Generală nr. 1 Adunaţii Copăceni",3,7552,"ADUNAŢII-COPĂCENI",100781,1508,1010,800,210,0,988,22,1648,638,531,457
19,"GIURGIU",528,100781,,64,"ADUNAŢII-COPĂCENI / Şcoala Generală nr. 2 Adunaţii Copăceni",3,7552,"ADUNAŢII-COPĂCENI",100781,1121,725,602,123,0,717,8,1243,518,408,309
19,"GIURGIU",528,100781,,65,"DĂRĂŞTI-VLAŞCA / Şcoala Generală nr. 1 Dărăşti Vlaşca",3,7552,"ADUNAŢII-COPĂCENI",100781,1636,1058,832,226,0,1037,21,1807,749,697,340
19,"GIURGIU",528,100781,,66,"VARLAAM / Şcoala Generală nr. 1 Varlaam",3,7552,"ADUNAŢII-COPĂCENI",100781,470,390,314,76,0,387,3,516,126,237,150
19,"GIURGIU",528,100781,,67,"MOGOŞEŞTI / Şcoala Generală nr. 1 Mogoşeşti",3,7552,"ADUNAŢII-COPĂCENI",100781,383,314,229,85,0,310,4,421,107,191,119
19,"GIURGIU",528,101001,,68,"BĂNEASA / Şcoala Generală nr. 1 Băneasa",3,7557,"BĂNEASA",101001,1137,784,700,84,0,771,13,1254,470,559,212
19,"GIURGIU",528,101001,,69,"BĂNEASA / Şcoala Generală nr.5 Băneasa",3,7557,"BĂNEASA",101001,592,394,339,55,0,391,3,653,259,291,100
19,"GIURGIU",528,101001,,70,"BĂNEASA / Şcoala Generală nr.2 Băneasa",3,7557,"BĂNEASA",101001,892,585,528,57,0,582,3,983,398,452,130
19,"GIURGIU",528,101001,,71,"PIETRELE / Şcoala Generală nr. 4 Pietrele",3,7557,"BĂNEASA",101001,945,656,577,79,0,647,9,1041,385,493,154
19,"GIURGIU",528,101001,,72,"FRASINU / Şcoala Generală nr. 3 Frasinu",3,7557,"BĂNEASA",101001,396,278,204,74,0,276,2,438,160,192,84
19,"GIURGIU",528,101001,,73,"SFÎNTU GHEORGHE / Şcoala Generală nr. 6  Sf. Gheorghe",3,7557,"BĂNEASA",101001,208,230,149,81,0,228,2,230,0,203,25
19,"GIURGIU",528,101163,,74,"BOLINTIN-DEAL / Căminul Cultural Bolintin - Deal",3,7562,"BOLINTIN-DEAL",101163,1412,841,671,170,0,824,17,1555,714,373,451
19,"GIURGIU",528,101163,,75,"BOLINTIN-DEAL / Şcoala Gimnazială cu Clasele I-VIII nr. 1 Bolintin - Deal",3,7562,"BOLINTIN-DEAL",101163,1207,652,529,123,0,647,5,1328,676,244,403
19,"GIURGIU",528,101163,,76,"BOLINTIN-DEAL / Şcoala Gimnazială cu Clasele I-VIII nr. 1 - Grădiniţa de copii Bolintin - Deal",3,7562,"BOLINTIN-DEAL",101163,956,481,397,84,0,476,5,1054,573,170,306
19,"GIURGIU",528,101163,,77,"MIHAI VODĂ / Şcoala Gimnazială cu Clasele I-VIII nr. 2 Mihai Vodă",3,7562,"BOLINTIN-DEAL",101163,1565,1009,862,147,0,992,17,1725,716,404,588
19,"GIURGIU",528,101378,,78,"BUCŞANI / Şcoala Generală cu clasele I-VIII Bucşani",3,7565,"BUCŞANI",101378,813,580,458,95,27,574,6,892,312,403,171
19,"GIURGIU",528,101378,,79,"VADU LAT / Şcoala Generală cu clasele I-VIII Vadu - Lat",3,7565,"BUCŞANI",101378,552,416,334,82,0,414,2,608,192,276,138
19,"GIURGIU",528,101378,,80,"PODIŞOR / Şcoala Generală cu clasele I-IV Podişor",3,7565,"BUCŞANI",101378,443,391,303,88,0,388,3,486,95,287,101
19,"GIURGIU",528,101378,,81,"OBEDENI / Şcoala Generală cu clasele I-IV Obedeni",3,7565,"BUCŞANI",101378,363,242,186,56,0,241,1,401,159,173,68
19,"GIURGIU",528,101378,,82,"UIEŞTI / Şcoala Generală cu clasele I-IV Uieşti",3,7565,"BUCŞANI",101378,268,224,169,45,10,222,2,294,70,181,41
19,"GIURGIU",528,101378,,83,"GOLEASCA / Şcoala Generală cu clasele I-IV Goleasca",3,7565,"BUCŞANI",101378,362,283,238,45,0,279,4,402,119,229,50
19,"GIURGIU",528,101519,,84,"BULBUCATA / Căminul Cultural Bulbucata",3,7573,"BULBUCATA",101519,1080,1080,756,321,3,1074,6,1190,110,796,278
19,"GIURGIU",528,101617,,85,"BUTURUGENI / Şcoala Buturugeni",3,7578,"BUTURUGENI",101617,1018,785,677,108,0,776,9,1173,388,426,350
19,"GIURGIU",528,101617,,86,"BUTURUGENI / Şcoala Prisiceni",3,7578,"BUTURUGENI",101617,593,516,440,76,0,508,8,593,77,336,172
19,"GIURGIU",528,101617,,87,"PĂDURENI / Şcoala Pădureni",3,7578,"BUTURUGENI",101617,1218,836,728,108,0,830,6,1344,508,585,245
19,"GIURGIU",528,101617,,88,"POŞTA / Şcoala Poşta",3,7578,"BUTURUGENI",101617,347,246,201,45,0,242,4,377,131,140,102
19,"GIURGIU",528,101662,,89,"CĂLUGĂRENI / Şcoala Veche Călugăreni",3,7583,"CĂLUGĂRENI",101662,1446,1170,833,335,2,1142,28,1595,425,735,407
19,"GIURGIU",528,101662,,90,"BRĂNIŞTARI / Şcoala Generală Brăniştari",3,7583,"CĂLUGĂRENI",101662,654,608,382,226,0,598,10,726,118,446,152
19,"GIURGIU",528,101662,,91,"UZUNU / Şcoala cu Clasele I-VIII Uzunu",3,7583,"CĂLUGĂRENI",101662,1214,751,626,123,2,742,9,1334,583,468,274
19,"GIURGIU",528,101662,,92,"HULUBEŞTI / Căminul Cultural Hulubeşti",3,7583,"CĂLUGĂRENI",101662,1335,970,835,131,4,951,19,1471,501,714,237
19,"GIURGIU",528,101984,,93,"CLEJANI / Căminul Cultural Clejani",3,7589,"CLEJANI",101984,1387,1288,935,309,44,1269,19,1527,239,953,316
19,"GIURGIU",528,101984,,94,"NEAJLOVU / Grădiniţa cu PN nr.3 Neajlov",3,7589,"CLEJANI",101984,1098,1110,847,220,43,1095,15,1209,99,954,141
19,"GIURGIU",528,102071,,95,"COLIBAŞI / Şcoala nr. 1 Colibaşi",3,7594,"COLIBAŞI",102071,901,850,743,107,0,832,18,997,147,635,197
19,"GIURGIU",528,102071,,96,"COLIBAŞI / Şcoala nr. 3 Colibaşi",3,7594,"COLIBAŞI",102071,764,687,597,90,0,676,11,842,155,454,222
19,"GIURGIU",528,102071,,97,"CÎMPURELU / Şcoala nr. 2 Câmpurelu",3,7594,"COLIBAŞI",102071,1119,852,743,109,0,820,32,1231,379,581,239
19,"GIURGIU",528,102106,,98,"COMANA / Şcoala Comana",3,7597,"COMANA",102106,852,735,554,169,12,730,5,944,209,579,151
19,"GIURGIU",528,102106,,99,"COMANA / Şcoala Comana",3,7597,"COMANA",102106,875,766,589,152,25,757,9,966,200,562,195
19,"GIURGIU",528,102106,,100,"BUDENI / Şcoala Budeni",3,7597,"COMANA",102106,578,605,377,228,0,588,17,639,34,415,173
19,"GIURGIU",528,102106,,101,"FALAŞTOACA / Şcoala Falaştoaca",3,7597,"COMANA",102106,633,591,394,188,9,580,11,701,110,355,225
19,"GIURGIU",528,102106,,102,"GRĂDIŞTEA / Şcoala Grădiştea",3,7597,"COMANA",102106,1267,889,704,185,0,876,13,1398,509,572,304
19,"GIURGIU",528,102106,,103,"VLAD ŢEPEŞ / Şcoala Vlad Ţepeş",3,7597,"COMANA",102106,1400,1211,981,200,30,1197,14,1547,336,1027,170
19,"GIURGIU",528,179748,,104,"COSOBA / Grădiniţa de copii Cosoba",3,7603,"COSOBA",179748,1049,646,566,79,1,635,11,1154,508,345,290
19,"GIURGIU",528,179748,,105,"COSOBA / Grădiniţa de copii Cosoba",3,7603,"COSOBA",179748,1036,653,593,59,1,644,9,1142,489,328,316
19,"GIURGIU",528,102348,,106,"CREVEDIA MARE / Şcoala cu Clasele I-VIII Nicolae Crevedia",3,7605,"CREVEDIA MARE",102348,1210,866,730,136,0,858,8,1340,474,596,262
19,"GIURGIU",528,102348,,107,"DEALU / Şcoala cu clasele I-IVDealu",3,7605,"CREVEDIA MARE",102348,1011,651,589,62,0,645,6,1110,459,516,129
19,"GIURGIU",528,102348,,108,"CREVEDIA MICĂ / Şcoala cu clasele I-IV Crevedia Mică",3,7605,"CREVEDIA MARE",102348,1564,1038,930,108,0,1024,14,1727,689,708,316
19,"GIURGIU",528,102446,,109,"DAIA / CAMIN CULTURAL",3,7612,"DAIA",102446,549,358,305,53,0,356,2,660,302,245,111
19,"GIURGIU",528,102446,,110,"DAIA / Şcoala cu clasele I-IV Daia",3,7612,"DAIA",102446,302,204,167,37,0,201,3,278,74,142,59
19,"GIURGIU",528,102446,,111,"PLOPŞORU / Grădiniţă Plopşoru",3,7612,"DAIA",102446,636,385,315,70,0,381,4,841,456,201,180
19,"GIURGIU",528,102446,,112,"PLOPŞORU / Şcoala cu clasele I-VIII Dăita",3,7612,"DAIA",102446,750,417,318,99,0,408,9,695,278,294,114
19,"GIURGIU",528,102794,,113,"STOENEŞTI / Şcoala Generală Stoeneşti",3,7615,"FLOREŞTI-STOENEŞTI",102794,1564,764,662,102,0,752,12,1721,957,353,399
19,"GIURGIU",528,102794,,114,"FLOREŞTI / Şcoala Veche Floreşti",3,7615,"FLOREŞTI-STOENEŞTI",102794,1073,633,554,79,0,625,8,1183,550,316,309
19,"GIURGIU",528,102794,,115,"FLOREŞTI / Şcoala Veche Floreşti",3,7615,"FLOREŞTI-STOENEŞTI",102794,995,568,506,62,0,564,4,1103,535,293,271
19,"GIURGIU",528,102794,,116,"FLOREŞTI / Şcoala  Nouă Floreşti",3,7615,"FLOREŞTI-STOENEŞTI",102794,1207,670,617,53,0,660,10,1337,667,335,325
19,"GIURGIU",528,102794,,117,"PALANCA / Şcoala Generală Palanca",3,7615,"FLOREŞTI-STOENEŞTI",102794,1198,737,689,47,1,728,9,1318,581,251,477
19,"GIURGIU",528,102794,,118,"PALANCA / Şcoala Generală Palanca",3,7615,"FLOREŞTI-STOENEŞTI",102794,970,623,568,55,0,620,3,1070,447,177,443
19,"GIURGIU",528,102909,,119,"FRĂTEŞTI / Căminul Cultural Frăteşti",3,7619,"FRĂTEŞTI",102909,1449,833,728,105,0,824,9,1599,766,671,153
19,"GIURGIU",528,102909,,120,"FRĂTEŞTI / Şcoala nr.2 Lunca Frăteşti",3,7619,"FRĂTEŞTI",102909,631,386,337,49,0,382,4,691,305,296,86
19,"GIURGIU",528,102909,,121,"REMUŞ / Căminul Cultural Remuş",3,7619,"FRĂTEŞTI",102909,1685,1099,966,133,0,1084,15,1865,766,677,407
19,"GIURGIU",528,102909,,122,"CETATEA / Şcoala cu clasele I-IV Cetatea",3,7619,"FRĂTEŞTI",102909,408,288,225,63,0,283,5,445,157,234,49
19,"GIURGIU",528,102909,,123,"CETATEA / Şcoala cu clasele I-IV  Cetatea (Bălănoaia)",3,7619,"FRĂTEŞTI",102909,237,154,108,44,2,149,5,263,109,114,35
19,"GIURGIU",528,103087,,124,"GĂISENI / Şcoala  Gimnaziala nr. 1    sat Găiseni , com Găiseni .",3,7623,"GĂISENI",103087,968,560,510,47,3,553,7,1064,504,386,167
19,"GIURGIU",528,103087,,125,"GĂISENI / Şcoala  Gimnaziala nr. 1    sat Găiseni , com Găiseni ,",3,7623,"GĂISENI",103087,843,479,416,63,0,475,4,926,447,296,179
19,"GIURGIU",528,103087,,126,"CĂSCIOARELE / Şcoala  Gimnaziala nr. 2 ,  sat Căscioarele com Găiseni",3,7623,"GĂISENI",103087,879,571,501,70,0,564,7,966,395,423,141
19,"GIURGIU",528,103087,,127,"CĂSCIOARELE / Şcoala  Gimnaziala nr. 2    sat Căscioarele  ,  com Găiseni",3,7623,"GĂISENI",103087,755,491,437,54,0,484,7,833,342,320,164
19,"GIURGIU",528,103087,,128,"CĂRPENIŞU / Şcoala  Primară nr. 3   sat Cărpenişu , com Găiseni",3,7623,"GĂISENI",103087,666,487,412,75,0,479,8,734,247,349,130
19,"GIURGIU",528,103087,,129,"PODU POPA NAE / Fosta Şcoala cu clasele I-IV Podu Popa Nae",3,7623,"GĂISENI",103087,138,101,85,16,0,100,1,154,53,83,17
19,"GIURGIU",528,103194,,130,"CETĂŢUIA / Şcoala  din Cetătuia",3,7628,"GĂUJANI",103194,157,118,83,35,0,118,0,173,55,98,20
19,"GIURGIU",528,103194,,131,"GĂUJANI / Şcoala Gimnazială ""Drăghici Davila""",3,7628,"GĂUJANI",103194,1001,626,543,78,5,617,9,1108,482,504,113
19,"GIURGIU",528,103194,,132,"PIETRIŞU / Grădiniţa cu PN nr.1",3,7628,"GĂUJANI",103194,773,481,417,64,0,467,14,850,369,378,89
19,"GIURGIU",528,103238,,133,"GHIMPAŢI / Şcoala cu clasele I-VIII Ghimpaţi",3,7632,"GHIMPAŢI",103238,1266,1160,994,106,60,1149,11,1441,281,964,185
19,"GIURGIU",528,103238,,134,"GHIMPAŢI / Cladirea Primariei Ghimpati",3,7632,"GHIMPAŢI",103238,588,609,422,122,65,608,1,632,23,533,75
19,"GIURGIU",528,103238,,135,"COPACIU / Grădiniţa Copaciu",3,7632,"GHIMPAŢI",103238,801,753,623,69,61,752,1,856,103,628,124
19,"GIURGIU",528,103238,,136,"NAIPU / Şcoala cu clasele I-VIII Naipu",3,7632,"GHIMPAŢI",103238,1310,1080,816,166,98,1034,46,1451,371,859,175
19,"GIURGIU",528,103238,,137,"VALEA PLOPILOR / Şcoala cu clasele I-IV Valea Plopilor",3,7632,"GHIMPAŢI",103238,493,461,375,68,18,458,3,543,82,361,97
19,"GIURGIU",528,103309,,138,"GOGOŞARI / Căminul Cultural Gogoşari",3,7637,"GOGOŞARI",103309,691,407,343,63,1,406,1,727,320,287,119
19,"GIURGIU",528,103309,,139,"RĂLEŞTI / Şcoala Generală Răleşti",3,7637,"GOGOŞARI",103309,126,109,65,42,2,108,1,139,30,85,23
19,"GIURGIU",528,103309,,140,"DRĂGHICEANU / Fosta Primărie",3,7637,"GOGOŞARI",103309,87,99,50,49,0,98,1,126,27,64,34
19,"GIURGIU",528,103309,,141,"IZVORU / Punctul Sanitar Izvoru",3,7637,"GOGOŞARI",103309,574,369,302,67,0,364,5,631,262,271,93
19,"GIURGIU",528,103372,,142,"GOSTINARI / Şcoala cu clasele I-VIII Gostinari",3,7642,"GOSTINARI",103372,1507,1265,996,189,80,1232,33,1658,393,776,456
19,"GIURGIU",528,103372,,143,"MIRONEŞTI / Şcoala cu clasele I-IV Mironeşti",3,7642,"GOSTINARI",103372,373,328,193,105,30,324,4,414,86,185,139
19,"GIURGIU",528,103354,,144,"GOSTINU / Gradinita Gostinu",3,7645,"GOSTINU",103354,808,657,511,87,59,657,0,889,232,504,153
19,"GIURGIU",528,103354,,145,"GOSTINU / Gradinita Gostinu",3,7645,"GOSTINU",103354,883,740,612,71,57,722,18,973,233,637,85
19,"GIURGIU",528,103407,,146,"GRĂDINARI / Şcoala cu clasele I-VIII Grădinari",3,7647,"GRĂDINARI",103407,882,614,519,95,0,609,5,973,359,414,195
19,"GIURGIU",528,103407,,147,"TÎNTAVA / Şcoala cu clasele I-VIII Tântava",3,7647,"GRĂDINARI",103407,967,616,503,113,0,610,6,1064,448,374,236
19,"GIURGIU",528,103407,,148,"ZORILE / Şcoala cu clasele I-IV Zorile",3,7647,"GRĂDINARI",103407,846,524,448,76,0,517,7,931,407,307,210
19,"GIURGIU",528,103470,,149,"GREACA / Şcoala Gimnazială nr.1 Greaca",3,7651,"GREACA",103470,1494,1038,885,153,0,1024,14,1650,612,701,323
19,"GIURGIU",528,103470,,150,"PUŢU GRECI / Şcoala Puţu Greci",3,7651,"GREACA",103470,274,202,166,36,0,197,5,303,101,148,49
19,"GIURGIU",528,103470,,151,"ZBOIU / Şcoala Zboiu",3,7651,"GREACA",103470,255,206,163,43,0,200,6,278,72,163,37
19,"GIURGIU",528,179757,,152,"HERĂŞTI / Şcoala Gimnazială ""Elina Basarab"" Herăşti",3,7655,"HERĂŞTI",179757,1702,1194,954,240,0,1176,18,1881,687,757,419
19,"GIURGIU",528,103639,,153,"HOTARELE / Şcoala Generală Hotarele-Vale",3,7658,"HOTARELE",103639,1161,790,627,163,0,781,9,1281,491,516,265
19,"GIURGIU",528,103639,,154,"HOTARELE / Şcoala Generală Hotarele-Deal",3,7658,"HOTARELE",103639,625,469,369,100,0,463,6,684,215,316,147
19,"GIURGIU",528,103639,,155,"HOTARELE / Liceul ""Udrişte Năsturel""",3,7658,"HOTARELE",103639,678,437,340,97,0,428,9,747,310,261,167
19,"GIURGIU",528,103639,,156,"HOTARELE / Şcoala Generală Scărişoara",3,7658,"HOTARELE",103639,646,438,377,61,0,435,3,709,271,281,154
19,"GIURGIU",528,103693,,157,"IEPUREŞTI / Căminul Cultural Iepureşti",3,7660,"IEPUREŞTI",103693,858,834,566,268,0,830,4,943,109,593,237
19,"GIURGIU",528,103693,,158,"GORNENI / Şcoala cu clasele I-IV Gorneni",3,7660,"IEPUREŞTI",103693,549,441,316,125,0,438,3,603,162,326,112
19,"GIURGIU",528,103693,,159,"STÎLPU / Şcoala Stâlpu",3,7660,"IEPUREŞTI",103693,199,205,132,73,0,202,3,219,14,123,79
19,"GIURGIU",528,179766,,160,"ISVOARELE / Şcoala cu clasele I-VIII Isvoarele",3,7667,"ISVOARELE",179766,1176,754,598,156,0,741,13,1297,543,524,217
19,"GIURGIU",528,179766,,161,"TEIUŞU / Şcoala Teiuşu",3,7667,"ISVOARELE",179766,175,156,120,36,0,154,2,196,40,127,27
19,"GIURGIU",528,103899,,162,"IZVOARELE / Şcoala Generală Izvoarele",3,7670,"IZVOARELE",103899,1102,639,543,93,3,632,7,1179,540,432,200
19,"GIURGIU",528,103899,,163,"CHIRIACU / Şcoala Generală Chiriacu",3,7670,"IZVOARELE",103899,1091,826,674,126,26,826,0,1143,317,678,148
19,"GIURGIU",528,103899,,164,"PETRU RAREŞ / Şcoala Generală Petru Rareş",3,7670,"IZVOARELE",103899,78,116,56,60,0,114,2,148,32,89,25
19,"GIURGIU",528,103899,,165,"VALEA BUJORULUI / Şcoala Generală Valea Bujorului",3,7670,"IZVOARELE",103899,407,249,194,55,0,248,1,450,201,189,59
19,"GIURGIU",528,103899,,166,"DIMITRIE CANTEMIR / Sediul fostei Secţii de Mecanizare a satului Dimitrie Cantemir",3,7670,"IZVOARELE",103899,153,101,68,33,0,101,0,212,111,82,19
19,"GIURGIU",528,103899,,167,"RADU VODĂ / Şcoala Generală Radu Vodă",3,7670,"IZVOARELE",103899,191,188,118,70,0,184,4,209,21,143,41
19,"GIURGIU",528,103997,,168,"JOIŢA / Primărie",3,7677,"JOIŢA",103997,1705,1110,860,250,0,1100,10,1887,777,506,594
19,"GIURGIU",528,103997,,169,"BÎCU / Şcoala cu clasele I-VIII Bâcu",3,7677,"JOIŢA",103997,1066,1001,651,350,0,981,20,1168,167,541,440
19,"GIURGIU",528,104047,,170,"LETCA NOUĂ / Căminul Cultural Letca Nouă",3,7680,"LETCA NOUĂ",104047,718,588,454,134,0,582,6,790,202,446,136
19,"GIURGIU",528,104047,,171,"LETCA VECHE / Căminul Cultural Letca Veche",3,7680,"LETCA NOUĂ",104047,800,506,417,89,0,496,10,886,380,381,115
19,"GIURGIU",528,104047,,172,"MILCOVĂŢU / Căminul Cultural Milcovăţu",3,7680,"LETCA NOUĂ",104047,1064,732,611,121,0,726,6,1172,440,553,173
19,"GIURGIU",528,179739,,173,"MALU / Căminul Cultural Malu",3,7684,"MALU",179739,1037,635,548,87,0,628,7,1150,515,474,154
19,"GIURGIU",528,179739,,174,"MALU / Grădiniţa Malu",3,7684,"MALU",179739,931,601,487,113,1,593,8,1020,419,449,144
19,"GIURGIU",528,104225,,175,"MÂRŞA / Şcoala Gimnazială Mârşa",3,7686,"MÂRŞA",104225,970,626,583,43,0,620,6,1066,440,494,126
19,"GIURGIU",528,104225,,176,"MÂRŞA / Şcoala Gimnazială Mârşa",3,7686,"MÂRŞA",104225,1225,850,774,76,0,838,12,1354,504,620,218
19,"GIURGIU",528,104118,,177,"MIHAI BRAVU / Şcoala cu clasele I-VIII Mihai Bravu",3,7688,"MIHAI BRAVU",104118,1097,950,660,227,63,935,15,1197,247,730,205
19,"GIURGIU",528,104118,,178,"MIHAI BRAVU / Şcoala cu clasele I-IV Mihai Bravu",3,7688,"MIHAI BRAVU",104118,897,715,533,153,29,705,10,935,220,533,172
19,"GIURGIU",528,104485,,179,"OGREZENI / Şcoala ""SF. Nectarie"" nr.1 Ogrezeni",3,7690,"OGREZENI",104485,992,583,470,112,1,577,6,1102,519,308,269
19,"GIURGIU",528,104485,,180,"OGREZENI / Şcoala cu clasele I-VIII nr.2 Ogrezeni",3,7690,"OGREZENI",104485,1233,716,581,135,0,704,12,1352,636,399,305
19,"GIURGIU",528,104485,,181,"OGREZENI / Grădiniţa cu PN nr. 3 Ogrezeni",3,7690,"OGREZENI",104485,839,555,449,106,0,549,6,919,364,311,238
19,"GIURGIU",528,104485,,182,"HOBAIA / Şcoala generală nr. 4 Hobaia",3,7690,"OGREZENI",104485,762,495,426,69,0,491,4,842,347,344,147
19,"GIURGIU",528,104519,,183,"OINACU / Căminul Cultural Oinacu",3,7693,"OINACU",104519,1523,984,864,120,0,972,12,1679,695,678,294
19,"GIURGIU",528,104519,,184,"BRANIŞTEA / Şcoala Braniştea",3,7693,"OINACU",104519,898,552,480,72,0,542,10,1006,454,408,134
19,"GIURGIU",528,104519,,185,"COMASCA / Şcoala Comasca",3,7693,"OINACU",104519,504,324,293,31,0,321,3,538,214,187,134
19,"GIURGIU",528,104680,,186,"PRUNDU / Căminul Cultural Prundu",3,7697,"PRUNDU",104680,1730,1407,1184,223,0,1387,20,1905,498,1124,263
19,"GIURGIU",528,104680,,187,"PRUNDU / Şcoala Primară nr.1 Prundu",3,7697,"PRUNDU",104680,1137,833,759,74,0,826,7,1250,417,688,138
19,"GIURGIU",528,104680,,188,"PUIENI / Şcoala Primară nr.1 Puieni",3,7697,"PRUNDU",104680,632,534,448,86,0,523,11,694,160,449,74
19,"GIURGIU",528,104715,,189,"PUTINEIU / Casa de Cultură Putineiu",3,7700,"PUTINEIU",104715,1069,845,713,132,0,836,9,1184,339,754,82
19,"GIURGIU",528,104715,,190,"HODIVOAIA / Şcoala Hodivoaia",3,7700,"PUTINEIU",104715,321,300,211,89,0,295,5,361,61,212,83
19,"GIURGIU",528,104715,,191,"VIERU / Şcoala Vieru",3,7700,"PUTINEIU",104715,591,462,335,127,0,453,9,653,191,374,79
19,"GIURGIU",528,104788,,192,"RĂSUCENI / Şcoala cu Etaj Răsuceni",3,7704,"RĂSUCENI",104788,842,711,567,144,0,705,6,936,225,638,67
19,"GIURGIU",528,104788,,193,"RĂSUCENI / Şcoala cu clasele I-IV Răsuceni",3,7704,"RĂSUCENI",104788,327,308,212,96,0,307,1,351,43,279,28
19,"GIURGIU",528,104788,,194,"CUCURUZU / Şcoala cu Etaj Cucuruzu",3,7704,"RĂSUCENI",104788,749,579,460,119,0,571,8,829,250,496,75
19,"GIURGIU",528,104831,,195,"ROATA MICĂ / Grădiniţa cu PN",3,7709,"ROATA DE JOS",104831,401,269,215,54,0,265,4,443,174,208,57
19,"GIURGIU",528,104831,,196,"ROATA DE JOS / Grădiniţa cu PN",3,7709,"ROATA DE JOS",104831,908,618,534,84,0,606,12,1005,387,427,179
19,"GIURGIU",528,104831,,197,"CARTOJANI / Grădiniţa cu PN",3,7709,"ROATA DE JOS",104831,801,414,381,33,0,410,4,884,470,279,131
19,"GIURGIU",528,104831,,198,"ROATA DE JOS / Şcoala cu clasele I-VIII  Roata de Jos",3,7709,"ROATA DE JOS",104831,1043,662,599,63,0,656,6,1151,489,481,175
19,"GIURGIU",528,104831,,199,"SADINA / Şcoala cu clasele I-IV Sadina",3,7709,"ROATA DE JOS",104831,1211,808,727,81,0,805,3,1334,526,591,214
19,"GIURGIU",528,104831,,200,"CARTOJANI / Şcoala cu clasele I-VIII  Cartojani",3,7709,"ROATA DE JOS",104831,1039,528,498,30,0,518,10,1144,616,355,163
19,"GIURGIU",528,104831,,201,"CARTOJANI / Şcoala cu clasele I-VIII  Cartojani",3,7709,"ROATA DE JOS",104831,1142,554,517,37,0,548,6,1259,705,353,195
19,"GIURGIU",528,179775,,202,"SĂBĂRENI / Şcoala cu clasele I-VIII  Săbăreni",3,7714,"SĂBĂRENI",179775,1015,922,695,227,0,914,8,1113,191,455,459
19,"GIURGIU",528,179775,,203,"SĂBĂRENI / Şcoala cu clasele I-VIII  Săbăreni",3,7714,"SĂBĂRENI",179775,1062,858,691,167,0,836,22,1168,310,396,440
19,"GIURGIU",528,104975,,204,"SCHITU / Şcoala  Schitu",3,7716,"SCHITU",104975,186,153,99,54,0,149,4,205,52,112,37
19,"GIURGIU",528,104975,,205,"BILA / Şcoala Bila",3,7716,"SCHITU",104975,391,258,209,48,1,253,5,430,172,198,55
19,"GIURGIU",528,104975,,206,"CĂMINEASCA / Şcoala Cămineasca",3,7716,"SCHITU",104975,461,380,271,99,10,375,5,508,128,270,105
19,"GIURGIU",528,104975,,207,"VLAŞIN / Şcoala Vlaşin",3,7716,"SCHITU",104975,424,328,264,64,0,324,4,473,145,245,79
19,"GIURGIU",528,105106,,208,"SINGURENI / Primaria Singureni",3,7721,"SINGURENI",105106,1274,930,699,192,39,917,13,1394,464,653,264
19,"GIURGIU",528,105106,,209,"CRÎNGURI / Şcoala cu clasele I-IV Crînguri",3,7721,"SINGURENI",105106,631,524,414,95,15,516,8,694,170,367,149
19,"GIURGIU",528,105106,,210,"STEJARU / Grădiniţa Stejaru",3,7721,"SINGURENI",105106,620,577,443,114,20,574,3,681,104,462,112
19,"GIURGIU",528,100549,,211,"SLOBOZIA / Şcoala Gimnazială nr.1 Slobozia",3,7725,"SLOBOZIA",100549,823,504,447,57,0,494,10,906,402,396,98
19,"GIURGIU",528,100549,,212,"SLOBOZIA / Grădiniţa de copii Slobozia",3,7725,"SLOBOZIA",100549,1172,700,596,103,1,697,3,1294,594,550,147
19,"GIURGIU",528,105295,,213,"STĂNEŞTI / Şcoala Gimnazială nr. 1 Stăneşti",3,7727,"STĂNEŞTI",105295,1105,740,601,139,0,722,18,1223,483,591,131
19,"GIURGIU",528,105295,,214,"GHIZDARU / Şcoala Generală Ghizdaru",3,7727,"STĂNEŞTI",105295,450,320,268,52,0,318,2,497,177,259,59
19,"GIURGIU",528,105295,,215,"BĂLANU / Şcoala Generală Bălanu",3,7727,"STĂNEŞTI",105295,397,285,203,82,0,281,4,436,151,230,51
19,"GIURGIU",528,105295,,216,"ONCEŞTI / Grădiniţa Onceşti",3,7727,"STĂNEŞTI",105295,286,250,176,74,0,244,6,318,68,208,36
19,"GIURGIU",528,105348,,217,"IANCULEŞTI / Şcoala cu clasele I-IV Ianculeşti",3,7732,"STOENEŞTI",105348,214,163,139,20,4,156,7,238,75,127,29
19,"GIURGIU",528,105348,,218,"STOENEŞTI / Căminul Cultural Stoeneşti",3,7732,"STOENEŞTI",105348,960,946,582,348,16,938,8,1061,115,728,210
19,"GIURGIU",528,105348,,219,"STOENEŞTI / Şcoala cu clasele I-IV Stoeneşti",3,7732,"STOENEŞTI",105348,406,343,248,80,15,341,2,446,103,272,69
19,"GIURGIU",528,105348,,220,"MIRĂU / Şcoala cu clasele I-IV Mirău",3,7732,"STOENEŞTI",105348,139,143,88,44,11,141,2,153,10,119,22
19,"GIURGIU",528,154709,,221,"TOPORU / Căminul Cultural Toporu",3,7736,"TOPORU",154709,1116,816,623,123,70,800,16,1239,423,599,201
19,"GIURGIU",528,154709,,222,"TOMULEŞTI / Şcoala Generală Tomuleşti",3,7736,"TOPORU",154709,526,538,329,129,80,529,9,579,41,454,75
19,"GIURGIU",528,105623,,223,"ULMI / Şcoala Ulmi",3,7739,"ULMI",105623,899,559,468,91,0,551,8,988,429,246,305
19,"GIURGIU",528,105623,,224,"POENARI / Şcoala Poenari",3,7739,"ULMI",105623,1131,784,658,126,0,774,10,1246,462,345,429
19,"GIURGIU",528,105623,,225,"TRESTIENI / Şcoala ""Nicolae Lahovary""",3,7739,"ULMI",105623,984,587,511,76,0,574,13,1081,494,349,225
19,"GIURGIU",528,105623,,226,"TRESTIENI / Şcoala ""Nicolae Lahovary""",3,7739,"ULMI",105623,1000,617,528,89,0,608,9,1102,485,399,209
19,"GIURGIU",528,105623,,227,"DRĂGĂNEASCA / Grădiniţa ""Marin Mogescu""",3,7739,"ULMI",105623,614,444,358,86,0,439,5,675,231,305,134
19,"GIURGIU",528,105623,,228,"ICOANA / Şcoala Icoana",3,7739,"ULMI",105623,900,587,562,25,0,583,4,990,403,307,276
19,"GIURGIU",528,105623,,229,"GHIONEA / Grădiniţa Ghionea",3,7739,"ULMI",105623,443,305,248,57,0,303,2,489,184,129,174
19,"GIURGIU",528,105776,,230,"VALEA DRAGULUI / Şcoala generală Valea Dragului",3,7748,"VALEA DRAGULUI",105776,1290,916,765,151,0,897,19,1422,506,492,405
19,"GIURGIU",528,105776,,231,"VALEA DRAGULUI / Şcoala Generală sector Ciocoveni",3,7748,"VALEA DRAGULUI",105776,1125,852,693,159,0,843,9,1245,393,558,285
19,"GIURGIU",528,105874,,232,"VĂRĂŞTI / Sediul PAPI",3,7759,"VĂRĂŞTI",105874,1111,675,548,127,0,664,11,1223,548,381,283
19,"GIURGIU",528,105874,,233,"VĂRĂŞTI / Şcoala Gimnazială nr.1 Vărăşti",3,7759,"VĂRĂŞTI",105874,887,568,469,99,0,560,8,978,410,335,225
19,"GIURGIU",528,105874,,234,"VĂRĂŞTI / Şcoala Primară nr.3 Obedeni",3,7759,"VĂRĂŞTI",105874,943,573,483,90,0,565,8,1040,467,380,185
19,"GIURGIU",528,105874,,235,"DOBRENI / Şcoala Gimnazială nr.2 Dobreni",3,7759,"VĂRĂŞTI",105874,1866,976,859,117,0,965,11,2053,1077,680,285
19,"GIURGIU",528,105972,,236,"VÂNĂTORII MICI / Şcoala Gimnazială nr. 1 Vânătorii Mici",3,7750,"VÂNĂTORII MICI",105972,830,516,421,95,0,514,2,913,397,360,154
19,"GIURGIU",528,105972,,237,"IZVORU / Şcoala Gimnazială nr. 2 Izvoru",3,7750,"VÂNĂTORII MICI",105972,634,447,328,81,38,442,5,701,254,321,121
19,"GIURGIU",528,105972,,238,"VÎNĂTORII MARI / Şcoala Gimnazială nr. 3 Vânătorii Mari",3,7750,"VÂNĂTORII MICI",105972,968,589,500,89,0,582,7,1067,478,477,105
19,"GIURGIU",528,105972,,239,"POIANA LUI STÎNGĂ / Şcoala Primară nr.5 Poiana lui Stângă",3,7750,"VÂNĂTORII MICI",105972,549,359,305,54,0,356,3,604,245,190,166
19,"GIURGIU",528,105972,,240,"CORBEANCA / Şcoala Primară nr.6 Corbeanca",3,7750,"VÂNĂTORII MICI",105972,376,232,196,36,0,227,5,414,182,160,67
19,"GIURGIU",528,105972,,241,"CUPELE / Şcoala Primară nr.7 Cupele",3,7750,"VÂNĂTORII MICI",105972,377,255,211,44,0,251,4,415,160,196,55
19,"GIURGIU",528,105909,,242,"VEDEA / Şcoala Japca",3,7762,"VEDEA",105909,676,369,314,54,1,368,1,748,379,286,82
19,"GIURGIU",528,105909,,243,"VEDEA / Cămin Cultural Vedea",3,7762,"VEDEA",105909,793,486,391,95,0,480,6,878,392,387,93
19,"GIURGIU",528,105909,,244,"VEDEA / Şcoala Generală ""Apostol Arsache""  Vedea",3,7762,"VEDEA",105909,837,469,395,74,0,462,7,925,456,387,75
20,"GORJ",181,77812,,1,"TÎRGU JIU / UNIVERSITATEA ""CONSTANTIN BRÂNCUŞI""",1,7765,"MUNICIPIUL TÎRGU JIU",77812,1907,1277,1089,79,109,1265,12,2100,823,670,595
20,"GORJ",181,77812,,2,"TÎRGU JIU / COLEGIUL NATIONAL TUDOR VLADIMIRESCU",1,7765,"MUNICIPIUL TÎRGU JIU",77812,1117,848,695,152,1,827,21,1200,352,385,442
20,"GORJ",181,77812,,3,"TÎRGU JIU / COLEGIUL NAŢIONAL TUDOR VLADIMIRESCU",1,7765,"MUNICIPIUL TÎRGU JIU",77812,948,640,593,47,0,635,5,1000,360,308,327
20,"GORJ",181,77812,,4,"TÎRGU JIU / ŞCOALA GIMNAZIALĂ CONSTANTIN SĂVOIU",1,7765,"MUNICIPIUL TÎRGU JIU",77812,1676,1012,959,53,0,1001,11,1800,788,462,539
20,"GORJ",181,77812,,5,"TÎRGU JIU / ŞCOALA GIMNAZIALĂ CONSTANTIN SĂVOIU",1,7765,"MUNICIPIUL TÎRGU JIU",77812,1301,836,726,110,0,821,15,1400,564,393,428
20,"GORJ",181,77812,,6,"TÎRGU JIU / COLEGIUL TEHNIC NR.2",1,7765,"MUNICIPIUL TÎRGU JIU",77812,1737,1102,978,124,0,1080,22,1900,798,511,569
20,"GORJ",181,77812,,7,"ROMANEŞTI / Şcoala Primară din Localitatea Componentă Romaneşti",1,7765,"MUNICIPIUL TÎRGU JIU",77812,698,458,418,40,0,449,9,800,342,234,215
20,"GORJ",181,77812,,8,"TÎRGU JIU / ŞCOALA GIMNAZIALĂ ALEXANDRU ŞTEFULESCU",1,7765,"MUNICIPIUL TÎRGU JIU",77812,985,669,615,54,0,654,15,1100,431,368,286
20,"GORJ",181,77812,,9,"TÎRGU JIU / UNIVERSITATEA CONSTANTIN BRÂNCUŞI",1,7765,"MUNICIPIUL TÎRGU JIU",77812,1561,979,917,62,0,964,15,1700,721,602,362
20,"GORJ",181,77812,,10,"DRĂGOENI / ŞCOALA PRIMARĂ DIN LOCALITATEA COMPONENTĂ DRĂGOENI",1,7765,"MUNICIPIUL TÎRGU JIU",77812,1364,845,806,38,1,835,10,1500,655,522,313
20,"GORJ",181,77812,,11,"TÎRGU JIU / CASA TINERETULUI",1,7765,"MUNICIPIUL TÎRGU JIU",77812,1257,818,740,78,0,805,13,1400,582,398,407
20,"GORJ",181,77812,,12,"TÎRGU JIU / COLEGIUL NAŢIONAL SPIRU HARET",1,7765,"MUNICIPIUL TÎRGU JIU",77812,1124,663,610,53,0,658,5,1200,537,321,337
20,"GORJ",181,77812,,13,"TÎRGU JIU / COLEGIUL NAŢIONAL SPIRU HARET",1,7765,"MUNICIPIUL TÎRGU JIU",77812,1642,938,870,68,0,925,13,1800,862,445,480
20,"GORJ",181,77812,,14,"TÎRGU JIU / COLEGIUL NAŢIONAL SPIRU HARET",1,7765,"MUNICIPIUL TÎRGU JIU",77812,1536,836,789,47,0,820,16,1700,864,425,395
20,"GORJ",181,77812,,15,"TÎRGU JIU / COLEGIUL NAŢIONAL SPIRU HARET",1,7765,"MUNICIPIUL TÎRGU JIU",77812,1274,737,658,78,1,723,14,1400,663,365,358
20,"GORJ",181,77812,,16,"TÎRGU JIU / PALATUL COPIILOR",1,7765,"MUNICIPIUL TÎRGU JIU",77812,1211,893,731,62,100,883,10,1300,407,440,443
20,"GORJ",181,77812,,17,"TÎRGU JIU / LICEUL TEOLOGIC",1,7765,"MUNICIPIUL TÎRGU JIU",77812,1683,1046,954,54,38,1036,10,1800,754,511,525
20,"GORJ",181,77812,,18,"TÎRGU JIU / LICEUL TEOLOGIC",1,7765,"MUNICIPIUL TÎRGU JIU",77812,1586,814,767,47,0,807,7,1685,871,429,378
20,"GORJ",181,77812,,19,"TÎRGU JIU / LICEUL TEOLOGIC",1,7765,"MUNICIPIUL TÎRGU JIU",77812,1510,941,830,110,1,925,16,1700,759,486,439
20,"GORJ",181,77812,,20,"TÎRGU JIU / ŞCOALA GIMNAZIALĂ GHEORGHE TĂTĂRĂSCU",1,7765,"MUNICIPIUL TÎRGU JIU",77812,1696,984,921,62,1,955,29,1900,916,496,459
20,"GORJ",181,77812,,21,"TÎRGU JIU / ŞCOALA GIMNAZIALĂ GHEORGHE TĂTĂRĂSCU",1,7765,"MUNICIPIUL TÎRGU JIU",77812,1701,1026,990,36,0,1011,15,1900,874,589,422
20,"GORJ",181,77812,,22,"TÎRGU JIU / ŞCOALA GIMNAZIALĂ POMPILIU MARCEA",1,7765,"MUNICIPIUL TÎRGU JIU",77812,1829,948,868,80,0,928,20,2000,1052,471,457
20,"GORJ",181,77812,,23,"TÎRGU JIU / ŞCOALA GIMNAZIALĂ POMPILIU MARCEA",1,7765,"MUNICIPIUL TÎRGU JIU",77812,1849,1022,956,66,0,1003,19,2000,978,540,463
20,"GORJ",181,77812,,24,"TÎRGU JIU / ŞCOALA GIMNAZIALĂ CONSTANTIN BRÂNCUŞI",1,7765,"MUNICIPIUL TÎRGU JIU",77812,1933,1130,1058,71,1,1102,28,2100,970,591,511
20,"GORJ",181,77812,,25,"TÎRGU JIU / ŞCOALA GIMNAZIALĂ CONSTANTIN BRÂNCUŞI",1,7765,"MUNICIPIUL TÎRGU JIU",77812,1696,987,921,65,1,972,15,1900,913,513,459
20,"GORJ",181,77812,,26,"TÎRGU JIU / ŞCOALA GIMNAZIALĂ CONSTANTIN BRÂNCUŞI",1,7765,"MUNICIPIUL TÎRGU JIU",77812,1335,731,698,33,0,719,12,1500,769,364,355
20,"GORJ",181,77812,,27,"TÎRGU JIU / ŞCOALA GIMNAZIALĂ CONSTANTIN BRÂNCUŞI",1,7765,"MUNICIPIUL TÎRGU JIU",77812,1990,1042,1007,35,0,1026,16,2200,1158,542,484
20,"GORJ",181,77812,,28,"TÎRGU JIU / COLEGIUL NATIONAL ECATERINA TEODOROIU",1,7765,"MUNICIPIUL TÎRGU JIU",77812,1514,855,784,71,0,846,9,1700,845,453,393
20,"GORJ",181,77812,,29,"TÎRGU JIU / COLEGIUL NAŢIONAL ECATERINA TEODOROIU",1,7765,"MUNICIPIUL TÎRGU JIU",77812,1671,965,894,71,0,946,19,1800,835,497,449
20,"GORJ",181,77812,,30,"TÎRGU JIU / COLEGIUL NAŢIONAL ECATERINA TEODOROIU",1,7765,"MUNICIPIUL TÎRGU JIU",77812,1601,898,830,67,1,884,14,1800,902,476,408
20,"GORJ",181,77812,,31,"TÎRGU JIU / LICEUL CU PROGRAM SPORTIV",1,7765,"MUNICIPIUL TÎRGU JIU",77812,980,615,543,72,0,606,9,1100,485,328,278
20,"GORJ",181,77812,,32,"TÎRGU JIU / LICEUL CU PROGRAM SPORTIV",1,7765,"MUNICIPIUL TÎRGU JIU",77812,1015,615,541,74,0,606,9,1100,485,313,293
20,"GORJ",181,77812,,33,"TÎRGU JIU / COLEGIUL ECONOMIC VIRGIL MADGEARU",1,7765,"MUNICIPIUL TÎRGU JIU",77812,1977,1241,1181,60,0,1214,27,2200,959,675,539
20,"GORJ",181,77812,,34,"TÎRGU JIU / COLEGIUL ECONOMIC ""VIRGIL MADGEARU""",1,7765,"MUNICIPIUL TÎRGU JIU",77812,1573,1067,1018,48,1,1054,13,1700,633,590,464
20,"GORJ",181,77812,,35,"TÎRGU JIU / LICEUL  DE ARTE CONSTANTIN BRĂILOIU",1,7765,"MUNICIPIUL TÎRGU JIU",77812,1244,811,724,87,0,794,17,1400,589,421,373
20,"GORJ",181,77812,,36,"TÎRGU JIU / LICEUL DE ARTE  CONSTANTIN BRĂILOIU",1,7765,"MUNICIPIUL TÎRGU JIU",77812,1792,1122,1063,58,1,1098,24,2000,878,560,538
20,"GORJ",181,77812,,37,"TÎRGU JIU / LICEUL DE ARTE CONSTANTIN BRĂILOIU",1,7765,"MUNICIPIUL TÎRGU JIU",77812,1414,811,771,40,0,790,21,1600,789,568,222
20,"GORJ",181,77812,,38,"TÎRGU JIU / LICEUL DE ARTE CONSTANTIN BRĂILOIU",1,7765,"MUNICIPIUL TÎRGU JIU",77812,1017,651,618,33,0,645,6,1100,449,347,298
20,"GORJ",181,77812,,39,"TÎRGU JIU / CASA DE CULTURĂ A SINDICATELOR",1,7765,"MUNICIPIUL TÎRGU JIU",77812,1203,802,692,101,9,785,17,1300,498,381,404
20,"GORJ",181,77812,,40,"TÎRGU JIU / ŞCOALA GIMNAZIALĂ SFÂNTUL NICOLAE",1,7765,"MUNICIPIUL TÎRGU JIU",77812,1794,1472,1072,43,357,1446,26,2000,528,912,534
20,"GORJ",181,77812,,41,"TÎRGU JIU / ŞCOALA GIMNAZIALĂ SFÂNTU NICOLAE",1,7765,"MUNICIPIUL TÎRGU JIU",77812,1008,618,570,48,0,605,13,1100,482,343,262
20,"GORJ",181,77812,,42,"TÎRGU JIU / ŞCOALA GIMNAZIALĂ SFÂNTU NICOLAE",1,7765,"MUNICIPIUL TÎRGU JIU",77812,1126,733,692,38,3,725,8,1200,467,404,321
20,"GORJ",181,77812,,43,"TÎRGU JIU / ŞCOALA GENERALĂ ECATERINA TEODOROIU",1,7765,"MUNICIPIUL TÎRGU JIU",77812,1617,1000,884,115,1,987,13,1800,800,538,449
20,"GORJ",181,77812,,44,"TÎRGU JIU / COLEGIUL TEHNIC ION MINCU",1,7765,"MUNICIPIUL TÎRGU JIU",77812,1834,997,973,24,0,972,25,2000,1003,488,484
20,"GORJ",181,77812,,45,"TÎRGU JIU / COLEGIUL TEHNIC ION MINCU",1,7765,"MUNICIPIUL TÎRGU JIU",77812,895,528,468,60,0,517,11,1000,472,275,242
20,"GORJ",181,77812,,46,"TÎRGU JIU / COLEGIUL TEHNIC GEN.GHEORGHE MAGHERU",1,7765,"MUNICIPIUL TÎRGU JIU",77812,1775,927,848,79,0,917,10,1900,973,463,454
20,"GORJ",181,77812,,47,"TÎRGU JIU / COLEGIUL TEHNIC GEN.GHEORGHE MAGHERU",1,7765,"MUNICIPIUL TÎRGU JIU",77812,1803,947,887,60,0,928,19,2000,1053,408,520
20,"GORJ",181,77812,,48,"TÎRGU JIU / ŞCOALA GIMNAZIALĂ NR.7",1,7765,"MUNICIPIUL TÎRGU JIU",77812,1174,834,768,66,0,822,12,1300,466,456,366
20,"GORJ",181,77812,,49,"TÎRGU JIU / ŞCOALA GIMNAZIALĂ NR.7",1,7765,"MUNICIPIUL TÎRGU JIU",77812,2021,1053,994,59,0,1035,18,2200,1147,605,430
20,"GORJ",181,77812,,50,"TÎRGU JIU / ŞCOALA GIMNAZIALĂ VOIEVOD LITOVOI",1,7765,"MUNICIPIUL TÎRGU JIU",77812,1894,1184,1144,40,0,1167,17,2000,816,570,597
20,"GORJ",181,77812,,51,"TÎRGU JIU / ŞCOALA GIMNAZIALĂ VOIEVOD LITOVOI",1,7765,"MUNICIPIUL TÎRGU JIU",77812,1679,1149,1094,52,3,1134,15,1800,651,734,400
20,"GORJ",181,77812,,52,"TÎRGU JIU / ŞCOALA GIMNAZIALĂ VOIEVOD LITOVOI",1,7765,"MUNICIPIUL TÎRGU JIU",77812,1479,937,895,42,0,926,11,1600,663,601,325
20,"GORJ",181,77812,,53,"BÎRSEŞTI / ŞCOALA GIMNAZIALĂ NR.9",1,7765,"MUNICIPIUL TÎRGU JIU",77812,1755,1082,1057,25,0,1067,15,1900,818,576,491
20,"GORJ",181,77812,,54,"IEZURENI / IMOBIL NR.42",1,7765,"MUNICIPIUL TÎRGU JIU",77812,699,474,438,36,0,472,2,800,326,282,190
20,"GORJ",181,77812,,55,"URSAŢI / ŞCOALA PRIMARĂ ŞI GRĂDINIŢA DE COPII URSAŢI",1,7765,"MUNICIPIUL TÎRGU JIU",77812,552,395,375,20,0,394,1,600,205,255,139
20,"GORJ",181,77812,,56,"TÎRGU JIU / COLEGIUL TEHNIC HENRI COANDĂ",1,7765,"MUNICIPIUL TÎRGU JIU",77812,830,532,481,51,0,522,10,900,368,247,275
20,"GORJ",181,78141,,57,"MOTRU / ŞCOALA GENERALĂ NR. 2 MOTRU",1,7775,"MUNICIPIUL MOTRU",78141,1586,858,792,66,0,838,20,1700,842,448,390
20,"GORJ",181,78141,,58,"MOTRU / COLEGIUL TEHNIC MOTRU",1,7775,"MUNICIPIUL MOTRU",78141,1030,594,558,36,0,585,9,1100,506,313,272
20,"GORJ",181,78141,,59,"MOTRU / CASA SINDICATELOR MOTRU",1,7775,"MUNICIPIUL MOTRU",78141,1819,999,915,84,0,976,23,1900,901,498,478
20,"GORJ",181,78141,,60,"MOTRU / COLEGIUL NAŢIONAL GEORGE COŞBUC MOTRU",1,7775,"MUNICIPIUL MOTRU",78141,1611,870,801,67,2,854,16,1800,930,442,412
20,"GORJ",181,78141,,61,"MOTRU / ŞCOALA GENERALĂ NR.1 MOTRU",1,7775,"MUNICIPIUL MOTRU",78141,1725,980,866,58,56,964,16,1900,920,547,417
20,"GORJ",181,78141,,62,"MOTRU / GRĂDINIŢA ""VILE"" MOTRU",1,7775,"MUNICIPIUL MOTRU",78141,1219,672,619,50,3,659,13,1300,628,325,334
20,"GORJ",181,78141,,63,"MOTRU / GRĂDINIŢA CATOLICĂ MOTRU",1,7775,"MUNICIPIUL MOTRU",78141,1843,961,918,43,0,944,17,2000,1039,534,410
20,"GORJ",181,78141,,64,"MOTRU / GRĂDINIŢA CREŞĂ NR.1 MOTRU",1,7775,"MUNICIPIUL MOTRU",78141,1851,1017,945,72,0,1002,15,2000,983,533,469
20,"GORJ",181,78141,,65,"MOTRU / SEDIUL  ITL  MOTRU",1,7775,"MUNICIPIUL MOTRU",78141,1819,1047,909,138,0,1026,21,2000,953,568,458
20,"GORJ",181,78141,,66,"MOTRU / CASA MULTICULTURALĂ MOTRU",1,7775,"MUNICIPIUL MOTRU",78141,1772,984,915,68,1,959,25,1900,916,503,456
20,"GORJ",181,78141,,67,"LEURDA / ŞCOALA LEURDA",1,7775,"MUNICIPIUL MOTRU",78141,652,451,433,18,0,441,10,700,249,309,132
20,"GORJ",181,78141,,68,"HORĂŞTI / ŞCOALA HORĂŞTI",1,7775,"MUNICIPIUL MOTRU",78141,413,278,267,11,0,276,2,500,222,140,136
20,"GORJ",181,78141,,69,"PLOŞTINA / ŞCOALA PRIMARĂ PLOŞTINA",1,7775,"MUNICIPIUL MOTRU",78141,1130,730,702,27,1,717,13,1300,570,432,285
20,"GORJ",181,78141,,70,"ROŞIUŢA / ŞCOALA PRIMARĂ ROŞIUŢA",1,7775,"MUNICIPIUL MOTRU",78141,522,372,341,31,0,363,9,600,228,226,137
20,"GORJ",181,78141,,71,"RÎPA / ŞCOALA RÂPA",1,7775,"MUNICIPIUL MOTRU",78141,296,227,206,21,0,224,3,300,73,127,97
20,"GORJ",181,79308,,72,"BUMBEŞTI-JIU / SALA DE SPORT A ORASULUI",1,7785,"ORAŞ BUMBEŞTI-JIU",79308,1143,681,611,70,0,670,11,1300,619,453,217
20,"GORJ",181,79308,,73,"BUMBEŞTI-JIU / GRADINITA BUMBESTI JIU",1,7785,"ORAŞ BUMBEŞTI-JIU",79308,1213,652,609,41,2,643,9,1300,648,383,260
20,"GORJ",181,79308,,74,"BUMBEŞTI-JIU / SCOALA GENERALA NR.1 BUMBESTI-JIU",1,7785,"ORAŞ BUMBEŞTI-JIU",79308,1641,856,787,69,0,844,12,1800,944,560,284
20,"GORJ",181,79308,,75,"BUMBEŞTI-JIU / SCOALA GENERALA NR.1 BUMBESTI-JIU",1,7785,"ORAŞ BUMBEŞTI-JIU",79308,1045,519,481,38,0,514,5,1200,681,354,160
20,"GORJ",181,79308,,76,"BUMBEŞTI-JIU / COLEGIUL MIHAI VITEAZUL BUMBESTI JIU",1,7785,"ORAŞ BUMBEŞTI-JIU",79308,1015,565,526,39,0,558,7,1100,535,365,193
20,"GORJ",181,79308,,77,"BUMBEŞTI-JIU / SCOALA PRIMARA BUMBESTI JIU",1,7785,"ORAŞ BUMBEŞTI-JIU",79308,944,543,512,31,0,541,2,1000,457,340,201
20,"GORJ",181,79308,,78,"TETILA / SCOALA PRIMARA TETILA",1,7785,"ORAŞ BUMBEŞTI-JIU",79308,1077,566,515,51,0,563,3,1200,634,354,209
20,"GORJ",181,79308,,79,"CURTIŞOARA / SCOALA GENERALA CURTISOARA",1,7785,"ORAŞ BUMBEŞTI-JIU",79308,648,416,368,47,1,412,4,700,284,254,158
20,"GORJ",181,78258,,80,"NOVACI / SCOALA GENERALA NR. 1 NOVACI",1,7791,"ORAŞ NOVACI",78258,1668,1312,1068,235,9,1295,17,1800,488,538,757
20,"GORJ",181,78258,,81,"NOVACI / CLUBUL ELEVILOR",1,7791,"ORAŞ NOVACI",78258,1138,771,707,63,1,765,6,1300,529,262,503
20,"GORJ",181,78258,,82,"POCIOVALIŞTEA / SCOALA GENERALA POCIOVALISTEA",1,7791,"ORAŞ NOVACI",78258,1475,940,864,74,2,926,14,1600,660,459,467
20,"GORJ",181,78258,,83,"BERCEŞTI / GRADINITA BERCESTI",1,7791,"ORAŞ NOVACI",78258,573,377,359,15,3,371,6,600,223,181,190
20,"GORJ",181,82895,,84,"ROVINARI / ŞCOALA GIMNAZIALĂ NR. 1 ROVINARI",1,7797,"ORAŞ ROVINARI",82895,1440,769,707,62,0,751,18,1600,831,332,419
20,"GORJ",181,82895,,85,"ROVINARI / ŞCOALA GIMNAZIALĂ NR. 1 ROVINARI",1,7797,"ORAŞ ROVINARI",82895,1375,692,655,37,0,682,10,1500,808,268,414
20,"GORJ",181,82895,,86,"ROVINARI / ŞCOALA GIMNAZIALĂ NR. 3 ROVINARI",1,7797,"ORAŞ ROVINARI",82895,1227,605,567,38,0,589,16,1300,695,224,365
20,"GORJ",181,82895,,87,"ROVINARI / ŞCOALA GIMNAZIALĂ NR. 3 ROVINARI",1,7797,"ORAŞ ROVINARI",82895,1276,643,604,39,0,629,14,1400,757,266,363
20,"GORJ",181,82895,,88,"ROVINARI / COLEGIUL ""GHEORGHE TĂTĂRESCU"" ROVINARI",1,7797,"ORAŞ ROVINARI",82895,1267,691,577,72,42,678,13,1400,709,301,377
20,"GORJ",181,82895,,89,"ROVINARI / COLEGIUL ""GHEORGHE TĂTĂRESCU"" ROVINARI",1,7797,"ORAŞ ROVINARI",82895,1199,681,568,113,0,664,17,1300,619,273,391
20,"GORJ",181,82895,,90,"ROVINARI / GRĂDINIŢA NR. 3 ROVINARI",1,7797,"ORAŞ ROVINARI",82895,1335,743,704,39,0,727,16,1500,757,279,448
20,"GORJ",181,82895,,91,"ROVINARI / GRĂDINIŢA NR. 3 ROVINARI",1,7797,"ORAŞ ROVINARI",82895,1310,640,611,29,0,630,10,1500,860,240,390
20,"GORJ",181,82895,,92,"VÎRT / GRĂDINIŢA CARTIER VÎRT",1,7797,"ORAŞ ROVINARI",82895,560,422,361,61,0,413,9,600,178,180,233
20,"GORJ",181,82430,,93,"TISMANA / SCOALA GENERALA TISMANA",1,7814,"ORAŞ TISMANA",82430,1802,1103,972,130,1,1085,18,2000,897,568,517
20,"GORJ",181,82430,,94,"CELEI / SCOALA GENERALA CELEI",1,7814,"ORAŞ TISMANA",82430,769,452,388,64,0,445,7,900,448,229,216
20,"GORJ",181,82430,,95,"TOPEŞTI / SCOALA GENERALA TOPESTI",1,7814,"ORAŞ TISMANA",82430,882,604,544,60,0,598,6,1000,396,344,254
20,"GORJ",181,82430,,96,"POCRUIA / SCOALA GENERALA POCRUIA",1,7814,"ORAŞ TISMANA",82430,892,688,583,104,1,684,4,1000,312,383,301
20,"GORJ",181,82430,,97,"SOHODOL / SCOALA GENERALA SOHODOL",1,7814,"ORAŞ TISMANA",82430,799,514,472,42,0,502,12,900,386,291,211
20,"GORJ",181,82430,,98,"COSTENI / SCOALA GENERALA COSTENI",1,7814,"ORAŞ TISMANA",82430,912,592,497,95,0,580,12,1000,408,364,216
20,"GORJ",181,78329,,99,"TÎRGU CĂRBUNEŞTI / ŞCOALA GIMNAZIALĂ GEORGE USCĂTESCU",1,7802,"ORAŞ TÎRGU CĂRBUNEŞTI",78329,1066,600,507,93,0,588,12,1200,600,326,262
20,"GORJ",181,78329,,100,"TÎRGU CĂRBUNEŞTI / ŞCOALA GIMNAZIALĂ  GEORGE USCĂTESCU",1,7802,"ORAŞ TÎRGU CĂRBUNEŞTI",78329,1740,907,846,61,0,894,13,1900,993,461,433
20,"GORJ",181,78329,,101,"TÎRGU CĂRBUNEŞTI / COLEGIU NAŢIONAL TUDOR ARGHEZI",1,7802,"ORAŞ TÎRGU CĂRBUNEŞTI",78329,1431,856,713,49,94,848,8,1600,744,453,395
20,"GORJ",181,78329,,102,"CREŢEŞTI / SC.GENERALA CRETESTI",1,7802,"ORAŞ TÎRGU CĂRBUNEŞTI",78329,764,465,439,26,0,455,10,900,435,270,185
20,"GORJ",181,78329,,103,"POJOGENI / SC. GENERALA POJOGENI",1,7802,"ORAŞ TÎRGU CĂRBUNEŞTI",78329,610,403,332,71,0,399,4,700,297,244,155
20,"GORJ",181,78329,,104,"ŞTEFĂNEŞTI / SC.PRIMARA STEFANESTI",1,7802,"ORAŞ TÎRGU CĂRBUNEŞTI",78329,444,297,257,38,2,293,4,500,203,195,98
20,"GORJ",181,78329,,105,"CĂRBUNEŞTI-SAT / CAMIN CULTURAL",1,7802,"ORAŞ TÎRGU CĂRBUNEŞTI",78329,576,395,352,43,0,390,5,600,205,184,206
20,"GORJ",181,78329,,106,"POJOGENI / SC.PRIMARA POJOGENI CERAT",1,7802,"ORAŞ TÎRGU CĂRBUNEŞTI",78329,246,189,156,32,1,189,0,300,111,101,88
20,"GORJ",181,78329,,107,"COJANI / SC.PRIMARA COJANI",1,7802,"ORAŞ TÎRGU CĂRBUNEŞTI",78329,316,219,189,28,2,217,2,400,181,113,104
20,"GORJ",181,82617,,108,"TURCENI / CASA DE CULTURĂ TURCENI",1,7826,"ORAŞ TURCENI",82617,925,652,531,121,0,637,15,1000,348,391,246
20,"GORJ",181,82617,,109,"TURCENI / CASA DE CULTURĂ TURCENI",1,7826,"ORAŞ TURCENI",82617,1954,1159,958,188,13,1140,19,2100,941,550,590
20,"GORJ",181,82617,,110,"TURCENI / GRĂDINIŢA CU PROGRAM NORMAL NR. 2 TURCENI",1,7826,"ORAŞ TURCENI",82617,616,492,355,134,3,489,3,700,208,325,164
20,"GORJ",181,82617,,111,"TURCENI / ŞCOALA GENERALĂ STOLOJANI",1,7826,"ORAŞ TURCENI",82617,576,374,327,44,3,367,7,600,226,252,115
20,"GORJ",181,82617,,112,"MURGEŞTI / ŞCOALA GENERALĂ MURGEŞTI",1,7826,"ORAŞ TURCENI",82617,625,511,441,70,0,504,7,700,189,342,162
20,"GORJ",181,82617,,113,"GÂRBOVU / ŞCOALA GENERALĂ GÂRBOVU",1,7826,"ORAŞ TURCENI",82617,744,490,456,32,2,479,11,800,310,317,162
20,"GORJ",181,82617,,114,"STRÂMBA JIU / ŞCOALA GENERALĂ STRÂMBA JIU",1,7826,"ORAŞ TURCENI",82617,1278,823,756,66,1,811,12,1400,577,459,352
20,"GORJ",181,78454,,115,"ŢICLENI / GRADINITA NR. 2 TUNSI",1,7800,"ORAŞ ŢICLENI",78454,879,595,565,30,0,590,5,1000,405,332,258
20,"GORJ",181,78454,,116,"ŢICLENI / SCOALA GENERALA NR. 1 TICLENI",1,7800,"ORAŞ ŢICLENI",78454,1992,1329,1239,89,1,1319,10,2200,871,669,650
20,"GORJ",181,78454,,117,"ŢICLENI / GRADINITA NR. 3 RASINA",1,7800,"ORAŞ ŢICLENI",78454,1140,692,662,30,0,682,10,1300,608,383,299
20,"GORJ",181,78472,,118,"ALBENI / CAMINUL CULTURAL ALBENI",3,7833,"ALBENI",78472,1146,679,598,81,0,672,7,1300,621,426,246
20,"GORJ",181,78472,,119,"ALBENI / SCOALA PRIMARA ALBENI",3,7833,"ALBENI",78472,559,286,265,21,0,276,10,600,314,150,126
20,"GORJ",181,78472,,120,"BOLBOCEŞTI / SCOALA PRIMARA BOLBOCESTI",3,7833,"ALBENI",78472,454,279,245,34,0,276,3,500,221,194,82
20,"GORJ",181,78472,,121,"PRUNEŞTI / SCOALA PRIMARA PRUNESTI",3,7833,"ALBENI",78472,147,83,69,14,0,83,0,200,117,69,14
20,"GORJ",181,78542,,122,"ALIMPEŞTI / ŞCOALA  GENERALĂ ""ION LOTREANU "" ALIMPEŞTI, SAT. ALIMPEŞTI,",3,7840,"ALIMPEŞTI",78542,896,630,539,85,6,623,7,1000,370,399,224
20,"GORJ",181,78542,,123,"ALIMPEŞTI /  ŞCOALA  GENERALĂ  SÎRBEŞTI , SAT.SÎRBEŞTI",3,7840,"ALIMPEŞTI",78542,674,461,404,57,0,458,3,700,239,279,179
20,"GORJ",181,78604,,124,"ANINOASA / ŞCOALA GENERALĂ",3,7846,"ANINOASA",78604,1106,720,616,104,0,710,10,1200,480,496,214
20,"GORJ",181,78604,,125,"GROŞEREA / ŞCOALA GENERALĂ",3,7846,"ANINOASA",78604,494,355,293,62,0,348,7,600,245,236,112
20,"GORJ",181,78604,,126,"COSTEŞTI / ŞCOALA PRIMARĂ",3,7846,"ANINOASA",78604,812,457,416,41,0,448,9,900,443,283,165
20,"GORJ",181,78604,,127,"STERPOAIA / ŞCOALA PRIMARĂ NR.2",3,7846,"ANINOASA",78604,705,468,408,59,1,454,14,800,332,331,123
20,"GORJ",181,78668,,128,"ARCANI / CĂMINUL CULTURAL",3,7852,"ARCANI",78668,1107,872,653,196,23,868,4,1238,366,430,438
20,"GORJ",181,78711,,129,"BAIA DE FIER / SCOALA GENERALA BAIA DE FIER",3,7857,"BAIA DE FIER",78711,1361,910,867,43,0,897,13,1500,590,657,240
20,"GORJ",181,78711,,130,"BAIA DE FIER / SCOALA GENERALĂ  BAIA DE FIER",3,7857,"BAIA DE FIER",78711,1441,995,913,82,0,980,15,1600,605,739,241
20,"GORJ",181,78711,,131,"CERNĂDIA / ŞCOALA GENERALĂ CERNĂDIA",3,7857,"BAIA DE FIER",78711,692,446,409,36,1,440,6,800,354,255,185
20,"GORJ",181,78748,,132,"BĂLĂNEŞTI / SCOALA PRIMARA BALANESTI",3,7860,"BĂLĂNEŞTI",78748,630,466,379,86,1,456,10,700,234,285,171
20,"GORJ",181,78748,,133,"VOITEŞTII DE VALE / PRIMARIE",3,7860,"BĂLĂNEŞTI",78748,532,512,356,156,0,512,0,600,88,392,120
20,"GORJ",181,78748,,134,"GLODENI / SCOALA PRIMARA GLODENI",3,7860,"BĂLĂNEŞTI",78748,658,496,414,82,0,491,5,700,204,368,123
20,"GORJ",181,77910,,135,"CORNEŞTI / ŞCOALA PRIMARĂ",3,7868,"BĂLEŞTI",77910,615,421,348,73,0,417,4,700,279,278,139
20,"GORJ",181,77910,,136,"RASOVA / ŞCOALA PRIMARĂ",3,7868,"BĂLEŞTI",77910,388,287,240,47,0,285,2,400,113,141,144
20,"GORJ",181,77910,,137,"STOLOJANI / ŞCOALA PRIMARĂ",3,7868,"BĂLEŞTI",77910,528,366,284,82,0,366,0,600,234,199,167
20,"GORJ",181,77910,,138,"TĂLPĂŞEŞTI / ŞCOALA PRIMARĂ",3,7868,"BĂLEŞTI",77910,464,338,279,59,0,329,9,500,162,202,127
20,"GORJ",181,77910,,139,"TĂMĂŞEŞTI / ŞCOALA PRIMARĂ",3,7868,"BĂLEŞTI",77910,526,354,313,41,0,347,7,600,246,202,145
20,"GORJ",181,77910,,140,"BĂLEŞTI / CĂMIN CULTURAL BĂLEŞTI",3,7868,"BĂLEŞTI",77910,1716,1087,1011,75,1,1077,10,1900,813,570,507
20,"GORJ",181,77910,,141,"CEAURU / ŞCOALA GIMNAZIALĂ ""ANTONIE MOGOŞ""",3,7868,"BĂLEŞTI",77910,1905,1226,1150,76,0,1209,17,2100,874,740,469
20,"GORJ",181,78828,,142,"BĂRBĂTEŞTI / ŞC. GIMNAZIALĂ BĂRBĂTEŞTI",3,7878,"BĂRBĂTEŞTI",78828,758,513,436,77,0,510,3,800,287,263,247
20,"GORJ",181,78828,,143,"PETREŞTI / ŞC. PRIMARĂ PETREŞTI",3,7878,"BĂRBĂTEŞTI",78828,681,461,364,95,2,456,5,700,239,258,198
20,"GORJ",181,78873,,144,"BENGEŞTI / CĂMIN CULTURAL BENGEŞTI",3,7883,"BENGEŞTI-CIOCADIA",78873,926,454,383,71,0,450,4,1000,546,296,154
20,"GORJ",181,78873,,145,"BENGEŞTI / CĂMIN CULTURAL BENGEŞTI",3,7883,"BENGEŞTI-CIOCADIA",78873,304,211,182,29,0,208,3,300,89,146,62
20,"GORJ",181,78873,,146,"BĂLCEŞTI / CĂMIN CULTURAL BĂLCEŞTI",3,7883,"BENGEŞTI-CIOCADIA",78873,620,478,386,91,1,469,9,700,222,348,121
20,"GORJ",181,78873,,147,"CIOCADIA / CĂMIN CULTURAL CIOCADIA",3,7883,"BENGEŞTI-CIOCADIA",78873,854,474,399,75,0,467,7,900,426,299,168
20,"GORJ",181,78926,,148,"BERLEŞTI / SCOALA PRIMARA BERLESTI",3,7888,"BERLEŞTI",78926,703,438,386,52,0,430,8,800,362,274,156
20,"GORJ",181,78926,,149,"PÎRÎU VIU / CAMINUL CULTURAL PIRIU VIU",3,7888,"BERLEŞTI",78926,1035,692,603,89,0,684,8,1100,408,451,233
20,"GORJ",181,79004,,150,"BÎLTENI / PRIMARIA COMUNEI BILTENI",3,7896,"BÎLTENI",79004,1699,1076,1017,59,0,1060,16,1900,824,564,496
20,"GORJ",181,79004,,151,"PEŞTEANA JIU / SCOALA PRIMARĂ NR.2 PESTEANA-JIU",3,7896,"BÎLTENI",79004,1730,1059,996,62,1,1048,11,1900,841,632,416
20,"GORJ",181,79004,,152,"MOI / SCOALA GENERALA MOI",3,7896,"BÎLTENI",79004,838,586,536,48,2,576,10,900,314,287,289
20,"GORJ",181,79004,,153,"COCORENI / SCOALA PRIMARA COCORENI",3,7896,"BÎLTENI",79004,1049,657,625,32,0,651,6,1200,543,338,313
20,"GORJ",181,79004,,154,"VLĂDULENI / Şcoala Primară Vlăduleni",3,7896,"BÎLTENI",79004,862,572,535,37,0,568,4,900,328,276,292
20,"GORJ",181,79077,,155,"BOLBOŞI / SCOALA PRIMARA BOLBOSI",3,7902,"BOLBOŞI",79077,931,592,539,53,0,585,7,1000,408,373,212
20,"GORJ",181,79077,,156,"BĂLĂCEŞTI / SCOALA PRIMARA BALACESTI",3,7902,"BOLBOŞI",79077,548,302,283,19,0,300,2,600,298,183,117
20,"GORJ",181,79077,,157,"VALEA / SCOALA GENERALA VALEA",3,7902,"BOLBOŞI",79077,1119,545,520,25,0,544,1,1200,655,322,222
20,"GORJ",181,79157,,158,"BORĂSCU / ŞCOALA GENERALĂ CU CLASELE I-IV BORĂSCU",3,7910,"BORĂSCU",79157,953,602,531,71,0,591,11,1100,498,343,248
20,"GORJ",181,79157,,159,"MENŢII DIN DOS / ŞCOALA GENERALĂ CU CLASELE I-IV MENŢII DIN DOS",3,7910,"BORĂSCU",79157,591,389,357,32,0,388,1,700,311,217,171
20,"GORJ",181,79157,,160,"MILUTA / ŞCOALA GENERALĂ CU CLASELE I-IV MILUTA",3,7910,"BORĂSCU",79157,510,255,225,30,0,252,3,600,345,180,72
20,"GORJ",181,79157,,161,"CALAPĂRU / ŞCOALA GENERALĂ CALAPĂRU",3,7910,"BORĂSCU",79157,678,394,362,32,0,392,2,700,306,211,181
20,"GORJ",181,79237,,162,"CAPU DEALULUI / SCOALA GENERALA CU CLS. I-VIII",3,7918,"BRĂNEŞTI",79237,665,475,410,58,7,466,9,700,225,302,164
20,"GORJ",181,79237,,163,"BRĂNEŞTI / SCOALA PRIMARA CU CLS. I-IV",3,7918,"BRĂNEŞTI",79237,539,344,285,59,0,340,4,600,256,232,108
20,"GORJ",181,79237,,164,"PÎRÎU / SCOALA  PRIMARA CU CLS I-IV GILORTU",3,7918,"BRĂNEŞTI",79237,481,321,265,47,9,317,4,500,179,228,89
20,"GORJ",181,79237,,165,"BĂDEŞTI / SCOALA  PRIMARA CU CLS I-IV",3,7918,"BRĂNEŞTI",79237,194,118,94,24,0,115,3,201,83,72,43
20,"GORJ",181,79362,,166,"BUMBEŞTI-PIŢIC / CĂMINUL CULTURAL BUMBEŞTI-PIŢIC",3,7925,"BUMBEŞTI-PIŢIC",79362,1041,629,539,90,0,622,7,1100,471,379,243
20,"GORJ",181,79362,,167,"CÎRLIGEI / GRĂDINIŢA CÂRLIGEI",3,7925,"BUMBEŞTI-PIŢIC",79362,189,151,95,56,0,151,0,200,49,76,75
20,"GORJ",181,79362,,168,"POIENARI / ŞCOALA GENERALĂ POIENARI",3,7925,"BUMBEŞTI-PIŢIC",79362,630,384,350,34,0,380,4,700,316,228,152
20,"GORJ",181,79406,,169,"BUSTUCHIN / GRUP ŞCOLAR INDUSTRIAL BUSTUCHIN",3,7929,"BUSTUCHIN",79406,887,721,641,65,15,714,7,1000,279,585,129
20,"GORJ",181,79406,,170,"POIANA SECIURI / ŞCOALA GENERALĂ POIANA-SECIURI",3,7929,"BUSTUCHIN",79406,745,548,511,33,4,544,4,800,252,451,93
20,"GORJ",181,79406,,171,"VALEA POJARULUI / ŞCOALA PRIMARĂ VALEA POJARULUI",3,7929,"BUSTUCHIN",79406,340,289,236,45,8,285,4,400,111,245,40
20,"GORJ",181,79406,,172,"POIENIŢA / ŞCOALA PRIMARĂ POIENIŢA",3,7929,"BUSTUCHIN",79406,315,295,235,45,15,292,3,400,105,261,31
20,"GORJ",181,79406,,173,"POJARU / ŞCOALA GENERALĂ POJARU",3,7929,"BUSTUCHIN",79406,398,304,242,55,7,302,2,400,96,248,54
20,"GORJ",181,79497,,174,"CĂPRENI / ŞCOALA GENERALĂ CĂPRENI",3,7938,"CĂPRENI",79497,816,567,465,88,14,563,4,900,333,351,212
20,"GORJ",181,79497,,175,"SATU NOU / ŞCOALA PRIMARĂ CĂPRENI DE SUS",3,7938,"CĂPRENI",79497,542,381,315,50,16,379,2,600,219,246,133
20,"GORJ",181,79497,,176,"BULBUCENI / ŞCOALA PRIMARĂ BULBUCENI",3,7938,"CĂPRENI",79497,391,272,231,41,0,266,6,400,128,182,84
20,"GORJ",181,79585,,177,"VALEA PERILOR / GRĂDINIŢA VALEA PERILOR",3,7947,"CĂTUNELE",79585,592,346,312,34,0,339,7,700,354,205,134
20,"GORJ",181,79585,,178,"VALEA MÎNĂSTIRII / ŞCOALA GENERALĂ VALEA MÎNĂSTIRII",3,7947,"CĂTUNELE",79585,356,226,212,14,0,219,7,400,174,133,86
20,"GORJ",181,79585,,179,"LUPOAIA / CĂMINUL CULTURAL LUPOAIA",3,7947,"CĂTUNELE",79585,767,512,475,36,1,512,0,800,288,293,219
20,"GORJ",181,79585,,180,"DEALU VIILOR / ŞCOALA PRIMARĂ DEALU VIILOR",3,7947,"CĂTUNELE",79585,500,332,285,47,0,332,0,600,268,190,142
20,"GORJ",181,79656,,181,"CIUPERCENI / SCOALA GENERALA CIUPERCENI",3,7964,"CIUPERCENI",79656,445,382,286,96,0,377,5,500,118,186,191
20,"GORJ",181,79656,,182,"STRÎMBA VULCAN / SCOALA PRIMARA STRIMBA VULCAN",3,7964,"CIUPERCENI",79656,302,217,176,41,0,214,3,300,83,115,99
20,"GORJ",181,79656,,183,"VÎRTOPU / SCOALA PRIMARA VIRTOPU",3,7964,"CIUPERCENI",79656,316,267,204,63,0,266,1,400,133,129,137
20,"GORJ",181,79656,,184,"PEŞTEANA VULCAN / SCOALA PRIMARA PESTEANA VULCAN",3,7964,"CIUPERCENI",79656,257,267,171,96,0,267,0,300,33,154,113
20,"GORJ",181,79736,,185,"CÎLNIC / CAMINUL CULTURAL CILNIC",3,7954,"CÎLNIC",79736,611,624,428,183,13,614,10,700,76,256,358
20,"GORJ",181,79736,,186,"CÎLNICU DE SUS / SCOALA PRIMARA CILNICU DE SUS",3,7954,"CÎLNIC",79736,613,480,418,60,2,477,3,700,220,162,315
20,"GORJ",181,79736,,187,"HODOREASCA / SCOALA PRIMARA HODOREASCA",3,7954,"CÎLNIC",79736,310,292,226,63,3,286,6,400,108,138,148
20,"GORJ",181,79736,,188,"PINOASA / SCOALA PRIMARA PINOASA",3,7954,"CÎLNIC",79736,245,188,156,24,8,185,3,300,112,83,102
20,"GORJ",181,79834,,189,"CĂRPINIŞ / CĂMINUL CULTURAL CĂRPINIŞ",3,7972,"CRASNA",79834,1608,1110,969,141,0,1098,12,1800,690,639,459
20,"GORJ",181,79834,,190,"DRĂGOIEŞTI / ŞCOALA PRIMARĂ DRĂGOIEŞTI",3,7972,"CRASNA",79834,1081,687,625,62,0,681,6,1200,513,363,318
20,"GORJ",181,79834,,191,"DUMBRĂVENI / CĂMINUL CULTURAL DUMBRĂVENI",3,7972,"CRASNA",79834,751,511,453,58,0,507,4,800,289,323,184
20,"GORJ",181,79834,,192,"ANINIŞU DIN VALE / CĂMINUL CULTURAL ANINIŞ",3,7972,"CRASNA",79834,746,465,406,55,4,462,3,800,335,260,202
20,"GORJ",181,79932,,193,"CRUŞET / SCOALA PRIMARA CRUSET",3,7982,"CRUŞET",79932,1370,931,764,167,0,903,28,1500,569,552,351
20,"GORJ",181,79932,,194,"MĂIAG / CAMINUL CULTURAL MAIAG",3,7982,"CRUŞET",79932,636,381,323,58,0,379,2,700,319,255,124
20,"GORJ",181,79932,,195,"SLĂVUŢA / CAMINUL CULTURAL SLAVUTA",3,7982,"CRUŞET",79932,540,350,294,56,0,349,1,600,250,231,118
20,"GORJ",181,80043,,196,"DĂNCIULEŞTI / ŞCOALA DĂNCIULEŞTI",3,7993,"DĂNCIULEŞTI",80043,669,500,375,115,10,498,2,700,200,310,188
20,"GORJ",181,80043,,197,"RĂDINEŞTI / ŞCOALA RĂDINEŞTI",3,7993,"DĂNCIULEŞTI",80043,563,389,318,65,6,384,5,600,211,191,193
20,"GORJ",181,80043,,198,"OBÎRŞIA / ŞCOALA  OBÂRŞIA",3,7993,"DĂNCIULEŞTI",80043,497,309,260,43,6,305,4,597,288,146,159
20,"GORJ",181,80123,,199,"BRĂTUIA / ŞCOALA GENERALĂ",3,8001,"DĂNEŞTI",80123,768,411,352,59,0,409,2,800,389,213,196
20,"GORJ",181,80123,,200,"DĂNEŞTI / ŞCOALA PRIMARĂ",3,8001,"DĂNEŞTI",80123,1104,693,628,65,0,688,5,1200,507,360,328
20,"GORJ",181,80123,,201,"VĂCAREA / ŞCOALA PRIMARĂ",3,8001,"DĂNEŞTI",80123,693,485,432,53,0,479,6,800,315,242,237
20,"GORJ",181,80123,,202,"ŞASA / ŞCOALA PRIMARĂ",3,8001,"DĂNEŞTI",80123,552,360,284,76,0,357,3,600,240,193,164
20,"GORJ",181,80249,,203,"DRĂGOTEŞTI / CAMIN",3,8013,"DRĂGOTEŞTI",80249,995,743,674,69,0,736,7,1100,357,477,259
20,"GORJ",181,80249,,204,"COROBĂI / SCOALA GEN.COROBĂI",3,8013,"DRĂGOTEŞTI",80249,1142,670,624,45,1,665,5,1200,530,435,230
20,"GORJ",181,78016,,205,"DRĂGUŢEŞTI / ŞCOALA GENERALĂ DRĂGUŢEŞTI",3,8017,"DRĂGUŢEŞTI",78016,880,592,552,40,0,584,8,1000,408,347,237
20,"GORJ",181,78016,,206,"IAŞI-GORJ / CĂMIN CULTURAL",3,8017,"DRĂGUŢEŞTI",78016,833,626,545,79,2,619,7,900,274,298,321
20,"GORJ",181,78016,,207,"URECHEŞTI / ŞCOALA GENERALĂ URECHEŞTI",3,8017,"DRĂGUŢEŞTI",78016,736,469,430,38,1,459,10,800,331,280,179
20,"GORJ",181,78016,,208,"TÎLVEŞTI / ŞCOALA PRIMARĂ TÎLVEŞTI",3,8017,"DRĂGUŢEŞTI",78016,530,368,338,30,0,361,7,600,232,227,134
20,"GORJ",181,78016,,209,"CÎRBEŞTI / ŞCOALA GENERALĂ CÎRBEŞTI",3,8017,"DRĂGUŢEŞTI",78016,1253,842,783,59,0,829,13,1400,558,463,366
20,"GORJ",181,80285,,210,"PEŞTEANA DE JOS / GRĂDINIŢA PEŞTEANA DE JOS",3,8024,"FĂRCĂŞEŞTI",80285,714,519,466,52,1,512,7,800,281,345,167
20,"GORJ",181,80285,,211,"VALEA CU APĂ / ŞCOALA GENERALĂ VICTOR POPESCU",3,8024,"FĂRCĂŞEŞTI",80285,618,473,424,49,0,459,14,700,227,270,189
20,"GORJ",181,80285,,212,"FĂRCĂŞEŞTI / ŞCOALA PRIMARĂ FĂRCĂŞEŞTI",3,8024,"FĂRCĂŞEŞTI",80285,585,445,378,67,0,431,14,700,255,255,176
20,"GORJ",181,80285,,213,"ROŞIA JIU / LICEU ROŞIA JIU",3,8024,"FĂRCĂŞEŞTI",80285,687,469,440,29,0,466,3,800,331,316,150
20,"GORJ",181,80285,,214,"TIMIŞENI / ŞCOALA PRIMARĂ TIMIŞENI",3,8024,"FĂRCĂŞEŞTI",80285,126,115,74,41,0,115,0,200,85,59,56
20,"GORJ",181,80365,,215,"IORMĂNEŞTI / PRIMARIA GLOGOVA",3,8032,"GLOGOVA",80365,1598,1294,1047,223,24,1284,10,1700,406,816,468
20,"GORJ",181,80427,,216,"GODINEŞTI / PRIMĂRIA GODINEŞTI",3,8038,"GODINEŞTI",80427,898,637,508,129,0,635,2,1000,363,368,267
20,"GORJ",181,80427,,217,"CÎLCEŞTI / ŞCOALA CILCEŞTI",3,8038,"GODINEŞTI",80427,258,216,137,79,0,213,3,299,83,135,78
20,"GORJ",181,80427,,218,"PÎRÎU DE PRIPOR / ŞCOALA PIRIU DE PRIPOR",3,8038,"GODINEŞTI",80427,308,235,208,27,0,230,5,400,165,191,39
20,"GORJ",181,80427,,219,"PÎRÎU DE VALE / SCOALA PIRIU DE VALE",3,8038,"GODINEŞTI",80427,180,156,105,51,0,155,1,200,44,123,32
20,"GORJ",181,80506,,220,"HUREZANI / CĂMINUL CULTURAL HUREZANI",3,8046,"HUREZANI",80506,1161,879,734,142,3,864,15,1300,421,492,372
20,"GORJ",181,80506,,221,"PLOPU / ŞCOALA PRIMARĂ PLOPU",3,8046,"HUREZANI",80506,169,126,98,28,0,122,4,200,74,80,42
20,"GORJ",181,80560,,222,"IONEŞTI / SCOALA GENERALA IONESTI",3,8052,"IONEŞTI",80560,947,681,620,61,0,677,4,1000,319,507,170
20,"GORJ",181,80560,,223,"ILIEŞTI / SCOALA PRIMARA ILIESTI",3,8052,"IONEŞTI",80560,437,313,276,37,0,312,1,500,187,228,84
20,"GORJ",181,80560,,224,"PICU / SCOALA PRIMARA PICU",3,8052,"IONEŞTI",80560,542,368,346,22,0,363,5,600,232,274,89
20,"GORJ",181,80613,,225,"VIDIN / ŞCOALA PRIMARĂ VIDIN",3,8057,"JUPÎNEŞTI",80613,237,136,112,24,0,136,0,302,166,94,42
20,"GORJ",181,80613,,226,"PÎRÎU BOIA / ŞCOALA PRIMARĂ PÎRÎU-BOIA",3,8057,"JUPÎNEŞTI",80613,293,175,144,31,0,170,5,300,125,120,50
20,"GORJ",181,80613,,227,"JUPÎNEŞTI / CĂMIN CULTURAL JUPÎNEŞTI",3,8057,"JUPÎNEŞTI",80613,578,366,332,34,0,360,6,600,234,248,112
20,"GORJ",181,80613,,228,"VIERŞANI / SCOALA PRIMARĂ VIERŞANI",3,8057,"JUPÎNEŞTI",80613,665,387,305,82,0,382,5,700,313,244,138
20,"GORJ",181,80677,,229,"LELEŞTI / ŞCOALA GENERALA ,,ION GRIGOROIU,, LELEŞTI",3,8063,"LELEŞTI",80677,1038,906,688,205,13,899,7,1100,194,596,303
20,"GORJ",181,80677,,230,"FRĂTEŞTI / CĂMINUL CULTURAL FRĂTEŞTI",3,8063,"LELEŞTI",80677,262,261,160,98,3,261,0,300,39,188,73
20,"GORJ",181,80677,,231,"RASOVIŢA / ŞCOALA PRIMARĂ RASOVIŢA",3,8063,"LELEŞTI",80677,177,171,123,48,0,168,3,200,29,104,64
20,"GORJ",181,80711,,232,"LICURICI / ŞCOALA PRIMARĂ CU CLASELE I-IV LICURICI",3,8067,"LICURICI",80711,618,386,334,52,0,380,6,700,314,234,146
20,"GORJ",181,80711,,233,"NEGRENI / ŞCOALA COORDONATOARE NEGRENI CU CLASELE I-VIII",3,8067,"LICURICI",80711,579,349,287,62,0,337,12,600,251,217,120
20,"GORJ",181,80711,,234,"TOTEA / ŞCOALA GENERALĂ CU CLASELE I-VIII TOTEA",3,8067,"LICURICI",80711,609,332,279,53,0,327,5,701,369,187,140
20,"GORJ",181,80766,,235,"FRUNZA / CAMIN CULTURAL FRUNZA",3,8072,"LOGREŞTI",80766,603,397,339,58,0,388,9,700,303,239,149
20,"GORJ",181,80766,,236,"TÎRGU LOGREŞTI / CAMIN CULTURAL TG LOGRESTI",3,8072,"LOGREŞTI",80766,588,398,314,84,0,392,6,700,302,266,126
20,"GORJ",181,80766,,237,"LOGREŞTI MOŞTENI / SCOALA PRIMARA MOSTENI",3,8072,"LOGREŞTI",80766,456,336,285,51,0,332,4,500,164,222,110
20,"GORJ",181,80766,,238,"MĂRU / SCOALA PRIMARA MARU",3,8072,"LOGREŞTI",80766,291,238,178,60,0,235,3,300,62,157,78
20,"GORJ",181,80766,,239,"SEACA / SCOALA PRIMARA SEACA",3,8072,"LOGREŞTI",80766,257,202,153,49,0,201,1,300,98,156,45
20,"GORJ",181,80846,,240,"MĂTĂSARI / GRADINITA MATASARI",3,8080,"MĂTĂSARI",80846,1014,539,491,47,1,531,8,1100,561,247,284
20,"GORJ",181,80846,,241,"MĂTĂSARI /  GRADINITA MATASARI",3,8080,"MĂTĂSARI",80846,1504,771,672,99,0,761,10,1600,829,358,403
20,"GORJ",181,80846,,242,"MĂTĂSARI / SCOALA NR.2",3,8080,"MĂTĂSARI",80846,597,448,381,67,0,446,2,699,251,244,202
20,"GORJ",181,80846,,243,"BRĂDET / SCOALA PRIMARA BRADET",3,8080,"MĂTĂSARI",80846,547,472,384,84,4,464,8,600,128,246,218
20,"GORJ",181,80846,,244,"RUNCUREL / SCOALA PRIMARA RUNCUREL",3,8080,"MĂTĂSARI",80846,286,249,212,37,0,245,4,299,50,110,135
20,"GORJ",181,80846,,245,"CROICI / SCOALA PRIMARA CROICI",3,8080,"MĂTĂSARI",80846,318,226,193,33,0,217,9,400,174,146,71
20,"GORJ",181,80908,,246,"MUŞETEŞTI / CĂMINUL CULTURAL",3,8086,"MUŞETEŞTI",80908,770,518,458,60,0,512,6,900,382,331,181
20,"GORJ",181,80908,,247,"STĂNCEŞTI / ŞCOLA PRIMARĂ STĂNCEŞTI",3,8086,"MUŞETEŞTI",80908,473,266,238,28,0,263,3,500,234,125,138
20,"GORJ",181,80908,,248,"GRUI / ŞCOLA PRIMARĂ GRUI",3,8086,"MUŞETEŞTI",80908,470,311,269,42,0,309,2,500,189,178,131
20,"GORJ",181,80980,,249,"NEGOMIR / SCOALA GENERALA NR.1 NEGOMIR",3,8094,"NEGOMIR",80980,1105,799,735,64,0,782,17,1200,401,491,291
20,"GORJ",181,80980,,250,"ARTANU / SCOALA PRIMARA ARTANU",3,8094,"NEGOMIR",80980,956,666,628,38,0,658,8,1100,434,396,262
20,"GORJ",181,80980,,251,"CONDEIEŞTI / SCOALA GENERALA  RACI",3,8094,"NEGOMIR",80980,803,597,555,42,0,593,4,900,303,399,194
20,"GORJ",181,81095,,252,"CĂLUGĂRENI / CAMIN CULTURAL",3,8105,"PADEŞ",81095,930,573,536,37,0,569,4,1000,427,313,256
20,"GORJ",181,81095,,253,"PADEŞ / SC GEN PADES",3,8105,"PADEŞ",81095,1278,682,605,77,0,675,7,1400,718,369,306
20,"GORJ",181,81095,,254,"MOTRU SEC / SC GEN MOTRU SEC",3,8105,"PADEŞ",81095,1662,982,902,80,0,967,15,1800,818,510,457
20,"GORJ",181,81095,,255,"CERNA-SAT / SC GEN CERNA SAT",3,8105,"PADEŞ",81095,58,49,19,30,0,49,0,100,51,10,39
20,"GORJ",181,81184,,256,"PEŞTIŞANI / GRUP SCOLAR INDUSTRIAL MINIER CONSTANTIN BRANCUSI",3,8114,"PEŞTIŞANI",81184,1324,900,753,143,4,891,9,1400,500,470,421
20,"GORJ",181,81184,,257,"PEŞTIŞANI / SCOALA GENERALA PESTISANI",3,8114,"PEŞTIŞANI",81184,1348,954,779,173,2,944,10,1500,546,567,377
20,"GORJ",181,81184,,258,"BRĂDICENI / SCOALA PRIMARA BRADICENI",3,8114,"PEŞTIŞANI",81184,529,493,347,146,0,490,3,600,107,319,171
20,"GORJ",181,81264,,259,"PLOPŞORU / SCOALA GENERALA PLOPSORU",3,8122,"PLOPŞORU",81264,2003,1330,1226,79,25,1316,14,2100,770,814,502
20,"GORJ",181,81264,,260,"PISCURI / SCOALA  GENERALA PISCURI",3,8122,"PLOPŞORU",81264,972,701,623,59,19,697,4,1100,399,580,117
20,"GORJ",181,81264,,261,"VĂLENI / SCOALA PRIMARA  VALENI",3,8122,"PLOPŞORU",81264,1446,876,824,37,15,864,12,1600,724,558,306
20,"GORJ",181,81264,,262,"BROŞTENI / SCOALA PRIMARA BROSTENI",3,8122,"PLOPŞORU",81264,831,592,532,52,8,581,11,900,308,382,199
20,"GORJ",181,81380,,263,"POLOVRAGI / ŞCOALA CU CLS.V-VIII",3,8134,"POLOVRAGI",81380,1897,1238,1152,81,5,1210,28,2100,862,829,381
20,"GORJ",181,81380,,264,"RACOVIŢA / ŞCOALA PRIMARĂ",3,8134,"POLOVRAGI",81380,383,307,257,50,0,303,4,400,93,211,92
20,"GORJ",181,81415,,265,"PRIGORIA / ŞCOALA GENERALĂ",3,8137,"PRIGORIA",81415,369,247,199,48,0,246,1,400,153,190,56
20,"GORJ",181,81415,,266,"CĂLUGĂREASA / ŞCOALA CU CLASELE I-IV",3,8137,"PRIGORIA",81415,488,334,278,56,0,330,4,500,166,210,120
20,"GORJ",181,81415,,267,"NEGOIEŞTI / ŞCOALA CU CLASELE I-IV",3,8137,"PRIGORIA",81415,268,153,132,21,0,152,1,300,147,96,56
20,"GORJ",181,81415,,268,"DOBRANA / ŞCOALA CU CLASELE I-IV",3,8137,"PRIGORIA",81415,336,215,174,41,0,214,1,400,185,103,111
20,"GORJ",181,81415,,269,"BUCŞANA / ŞCOALA CU CLASELE I-IV",3,8137,"PRIGORIA",81415,699,387,366,21,0,385,2,800,413,218,167
20,"GORJ",181,81415,,270,"ZORLEŞTI / ŞCOALA CU CLASELE I-IV",3,8137,"PRIGORIA",81415,360,254,203,51,0,250,4,400,146,178,72
20,"GORJ",181,81497,,271,"ROŞIA DE AMARADIA / CĂMINUL CULTURAL ""IZVORUL""",3,8145,"ROŞIA DE AMARADIA",81497,1141,801,732,69,0,795,6,1200,399,410,385
20,"GORJ",181,81497,,272,"SECIURILE / ŞCOALA PRIMARĂ SECIURILE",3,8145,"ROŞIA DE AMARADIA",81497,599,386,352,34,0,384,2,700,314,210,174
20,"GORJ",181,81497,,273,"RUGET / ŞCOALA PRIMARĂ RUGET",3,8145,"ROŞIA DE AMARADIA",81497,494,330,305,25,0,328,2,500,170,170,158
20,"GORJ",181,81497,,274,"ŞITOAIA / GRĂDINIŢA ŞITOAIA",3,8145,"ROŞIA DE AMARADIA",81497,280,174,158,16,0,174,0,300,126,105,69
20,"GORJ",181,81576,,275,"VALEA MARE / ŞCOALA PRIMARĂ VALEA-MARE",3,8153,"RUNCU",81576,701,517,447,70,0,511,6,800,283,276,235
20,"GORJ",181,81576,,276,"BÎLTA / CĂMINUL CULTURAL BÎLTA",3,8153,"RUNCU",81576,1405,1040,912,128,0,1029,11,1500,460,637,392
20,"GORJ",181,81576,,277,"RUNCU / ŞCOALA GENERALĂ RUNCU",3,8153,"RUNCU",81576,1160,886,728,158,0,873,13,1300,414,474,399
20,"GORJ",181,81576,,278,"DOBRIŢA / CĂMINUL CULTURAL DOBRIŢA",3,8153,"RUNCU",81576,816,678,514,126,38,671,7,900,192,456,215
20,"GORJ",181,81576,,279,"SUSENI / CENTRUL DE ÎNGRIJIRE ŞI ASISTENŢĂ SUSENI",3,8153,"RUNCU",81576,229,296,138,62,96,295,1,330,34,199,96
20,"GORJ",181,81656,,280,"SAMARINEŞTI / ŞCOALA GENERALĂ CU CLASELE V-VIII SAMARINEŞTI",3,8167,"SAMARINEŞTI",81656,1112,829,751,78,0,825,4,1200,371,558,267
20,"GORJ",181,81656,,281,"LARGA / ŞCOALA PRIMARĂ LARGA",3,8167,"SAMARINEŞTI",81656,355,249,214,35,0,248,1,400,151,166,82
20,"GORJ",181,81754,,282,"SĂCELU / ŞCOALA GENERALĂ SĂCELU",3,8161,"SĂCELU",81754,802,525,425,100,0,517,8,900,375,329,188
20,"GORJ",181,81754,,283,"MAGHEREŞTI / ŞCOALA PRIMARĂ MAGHEREŞTI",3,8161,"SĂCELU",81754,489,358,252,106,0,357,1,500,142,228,129
20,"GORJ",181,81816,,284,"SĂULEŞTI / SC GEN SAULESTI",3,8177,"SĂULEŞTI",81816,1269,879,701,154,24,866,13,1400,521,655,211
20,"GORJ",181,81816,,285,"BIBEŞTI / SCOALA PRIMARA BIBESTI",3,8177,"SĂULEŞTI",81816,627,431,342,80,9,421,10,700,269,287,134
20,"GORJ",181,81987,,286,"SÎMBOTIN / FOSTA ŞCOALA PRIMARĂ SÎMBOTIN",3,8182,"SCHELA",81987,479,341,308,33,0,337,4,600,259,216,121
20,"GORJ",181,81987,,287,"GORNĂCEL / ŞCOALA PRIMARĂ  CU CLASELE I - IV GORNACEL",3,8182,"SCHELA",81987,507,312,281,31,0,311,1,600,288,203,108
20,"GORJ",181,81987,,288,"SCHELA / FOSTA ŞCOALĂ GENERALĂ CU CLASELE I - VIII SCHELA",3,8182,"SCHELA",81987,540,338,298,40,0,335,3,600,262,210,125
20,"GORJ",181,81861,,289,"BUDIENI / SCOALA GENERALA BUDIENI",3,8188,"SCOARŢA",81861,565,405,317,84,4,397,8,600,195,261,136
20,"GORJ",181,81861,,290,"PIŞTEŞTII DIN DEAL / SCOALA PRIMARA PISTESTII DIN DEAL",3,8188,"SCOARŢA",81861,826,318,285,33,0,314,4,900,582,247,67
20,"GORJ",181,81861,,291,"COPĂCIOASA / SCOALA PRIMARA  COPACIOASA",3,8188,"SCOARŢA",81861,698,477,375,101,1,472,5,784,307,286,186
20,"GORJ",181,81861,,292,"SCOARŢA / CAMINUL CULTURAL SCOARTA",3,8188,"SCOARŢA",81861,766,497,382,114,1,483,14,900,403,292,191
20,"GORJ",181,81861,,293,"BOBU / LOCALUL FOSTEI PRIMARII BOBU",3,8188,"SCOARŢA",81861,992,686,549,137,0,682,4,1100,414,386,296
20,"GORJ",181,82047,,294,"SLIVILEŞTI / ŞCOALA PRIMARĂ SLIVILEŞTI  CU CLASELE I-IV",3,8200,"SLIVILEŞTI",82047,894,635,535,100,0,627,8,1000,365,432,195
20,"GORJ",181,82047,,295,"STRÎMTU / ŞCOALA PRIMARĂ STRÎMTU  CU CLASELE I-IV",3,8200,"SLIVILEŞTI",82047,432,273,231,42,0,270,3,500,227,171,99
20,"GORJ",181,82047,,296,"MICULEŞTI / SALA DE SPORT",3,8200,"SLIVILEŞTI",82047,813,549,499,50,0,545,4,900,351,384,161
20,"GORJ",181,82047,,297,"SURA / ŞCOALA PRIMARĂ SURA  CU CLASELE I-IV",3,8200,"SLIVILEŞTI",82047,622,394,344,50,0,389,5,700,306,292,97
20,"GORJ",181,82136,,298,"STĂNEŞTI / PRIMĂRIA STĂNEŞTI",3,8209,"STĂNEŞTI",82136,1163,783,677,106,0,774,9,1300,517,410,364
20,"GORJ",181,82136,,299,"CURPEN / ŞCOALA GENERALĂ CURPEN",3,8209,"STĂNEŞTI",82136,778,539,440,99,0,529,10,900,361,329,200
20,"GORJ",181,82243,,300,"STEJARI / CENTRUL CULTURAL ""GH.ZAMFIR""",3,8220,"STEJARI",82243,831,589,484,103,2,583,6,900,311,350,233
20,"GORJ",181,82243,,301,"PISCOIU / CĂMINUL CULTURAL PISCOIU",3,8220,"STEJARI",82243,743,450,409,41,0,444,6,800,350,246,198
20,"GORJ",181,82243,,302,"BALOŞANI / ŞCOALA PRIMARĂ BALOŞANI",3,8220,"STEJARI",82243,402,283,232,51,0,279,4,500,217,197,82
20,"GORJ",181,82314,,303,"STOINA / CAMINUL CULTURAL STOINA.",3,8227,"STOINA",82314,1212,890,714,176,0,877,13,1300,410,565,312
20,"GORJ",181,82314,,304,"PĂIŞANI / SCOALA CU CLASELE I-IV PAISANI",3,8227,"STOINA",82314,671,468,421,47,0,461,7,800,332,271,190
20,"GORJ",181,82396,,305,"TELEŞTI / CLADIREA DE LANGA SEDIUL PRIMARIEI COM. TELESTI- SALA DE SEDINTE A CONSILIULUI LOCAL TELESTI",3,8235,"TELEŞTI",82396,475,404,287,115,2,399,5,500,96,244,155
20,"GORJ",181,82396,,306,"TELEŞTI / SCOALA PRIMARA TELESTI",3,8235,"TELEŞTI",82396,568,405,352,51,2,404,1,600,195,296,108
20,"GORJ",181,82396,,307,"BUDUHALA / SCOALA PRIMARA BUDUHALA NR.1",3,8235,"TELEŞTI",82396,651,428,355,73,0,424,4,700,272,318,106
20,"GORJ",181,82396,,308,"ŞOMĂNEŞTI / SCOALA PRIMARA SOMANESTI",3,8235,"TELEŞTI",82396,565,451,391,58,2,448,3,600,149,299,149
20,"GORJ",181,82555,,309,"TURBUREA / SC. PRIMARA TURBUREA",3,8244,"TURBUREA",82555,434,332,279,46,7,327,5,500,168,252,75
20,"GORJ",181,82555,,310,"TURBUREA / SC.GEN.TURBUREA",3,8244,"TURBUREA",82555,681,500,416,83,1,496,4,700,200,331,165
20,"GORJ",181,82555,,311,"ŞIPOTU / SC.PRIMARA  ŞIPOTU",3,8244,"TURBUREA",82555,737,514,453,58,3,500,14,800,286,372,128
20,"GORJ",181,82555,,312,"POIANA / ŞC .GEN. POIANA",3,8244,"TURBUREA",82555,1220,854,746,95,13,846,8,1300,446,645,201
20,"GORJ",181,82555,,313,"COCOROVA / SC. PRIMARĂ COCOROVA",3,8244,"TURBUREA",82555,410,262,225,37,0,259,3,500,238,176,83
20,"GORJ",181,78089,,314,"TURCINEŞTI / PRIMĂRIA",3,8250,"TURCINEŞTI",78089,1315,942,822,119,1,929,13,1400,458,558,371
20,"GORJ",181,78089,,315,"RUGI / ŞCOALA PRIMARĂ RUGI",3,8250,"TURCINEŞTI",78089,508,435,315,119,1,434,1,600,165,248,186
20,"GORJ",181,82680,,316,"ŢÎNŢĂRENI / ŞCOALA COORDONATOARE ŢÎNŢĂRENI",3,8239,"ŢÎNŢĂRENI",82680,1853,1193,1075,96,22,1180,13,2000,807,788,392
20,"GORJ",181,82680,,317,"FLOREŞTI / SCOALA PRIMARA FLORESTI NR. 2",3,8239,"ŢÎNŢĂRENI",82680,975,754,684,57,13,748,6,1100,346,514,234
20,"GORJ",181,82680,,318,"FLOREŞTI / SCOALA GENERALA FLORESTI NR 1",3,8239,"ŢÎNŢĂRENI",82680,1361,948,852,69,27,941,7,1500,552,645,296
20,"GORJ",181,82680,,319,"CHICIORA / ŞCOALA PRIMARĂ CHICIORA",3,8239,"ŢÎNŢĂRENI",82680,253,205,170,21,14,204,1,300,95,152,52
20,"GORJ",181,82733,,320,"FÎNTÎNELE / ŞCOALA GENERALĂ FÎNTÎNELE",3,8255,"URDARI",82733,783,561,525,36,0,557,4,900,339,356,201
20,"GORJ",181,82733,,321,"URDARI / ŞCOALA GENERALĂ NR. 1 URDARI",3,8255,"URDARI",82733,1307,868,833,35,0,860,8,1400,532,578,282
20,"GORJ",181,82733,,322,"HOTĂROASA / ŞCOALA PRIMARĂ NR.2 URDARI",3,8255,"URDARI",82733,450,315,291,24,0,309,6,500,185,172,137
20,"GORJ",181,82779,,323,"VĂGIULEŞTI / SCOALA GENERALA NR.1 VAGIULESTI",3,8259,"VĂGIULEŞTI",82779,1135,692,613,79,0,686,6,1200,508,433,253
20,"GORJ",181,82779,,324,"COVRIGI / CAMINUL CULTURAL COVRIGI",3,8259,"VĂGIULEŞTI",82779,1054,627,556,70,1,622,5,1200,573,364,258
20,"GORJ",181,82831,,325,"ANDREEŞTI / CAMINUL CULTURAL",3,8265,"VLADIMIR",82831,854,601,517,80,4,598,3,1000,399,353,245
20,"GORJ",181,82831,,326,"VLADIMIR / SCOALA GENERALA VLADIMIR",3,8265,"VLADIMIR",82831,948,670,537,123,10,660,10,1000,330,426,234
20,"GORJ",181,82831,,327,"FRASIN / SCOALA GENERALA NR 2 FRASIN",3,8265,"VLADIMIR",82831,590,396,316,77,3,395,1,700,304,239,156
21,"HARGHITA",190,83320,,1,"MIERCUREA CIUC / TEATRUL MUNICIPAL ""CSIKI JÁTÉKSZÍN""",1,8271,"MUNICIPIUL MIERCUREA CIUC",83320,1547,895,791,82,22,880,15,1600,705,127,753
21,"HARGHITA",190,83320,,2,"MIERCUREA CIUC / LICEUL DE ARTĂ ""NAGY ISTVÁN """,1,8271,"MUNICIPIUL MIERCUREA CIUC",83320,1627,916,842,74,0,900,16,1700,784,180,720
21,"HARGHITA",190,83320,,3,"MIERCUREA CIUC / UNIVERSITATEA SAPIENTIA",1,8271,"MUNICIPIUL MIERCUREA CIUC",83320,1696,1032,852,180,0,1015,17,1800,768,166,849
21,"HARGHITA",190,83320,,4,"MIERCUREA CIUC / ŞCOALA GENERALĂ ""NAGY IMRE""",1,8271,"MUNICIPIUL MIERCUREA CIUC",83320,1630,902,812,90,0,896,6,1700,798,164,732
21,"HARGHITA",190,83320,,5,"MIERCUREA CIUC / ŞCOALA GENERALĂ ""NAGY IMRE""",1,8271,"MUNICIPIUL MIERCUREA CIUC",83320,1689,880,837,43,0,871,9,1800,920,131,740
21,"HARGHITA",190,83320,,6,"MIERCUREA CIUC / SALA SPORTURILOR",1,8271,"MUNICIPIUL MIERCUREA CIUC",83320,1762,1005,936,69,0,997,8,1800,795,134,863
21,"HARGHITA",190,83320,,7,"MIERCUREA CIUC / ŞCOALA GENERALĂ ""PETŐFI SÁNDOR""",1,8271,"MUNICIPIUL MIERCUREA CIUC",83320,1499,737,686,51,0,720,17,1600,863,103,617
21,"HARGHITA",190,83320,,8,"MIERCUREA CIUC / ŞCOALA GENERALĂ ""PETŐFI SÁNDOR""",1,8271,"MUNICIPIUL MIERCUREA CIUC",83320,1493,734,686,48,0,728,6,1600,866,151,577
21,"HARGHITA",190,83320,,9,"MIERCUREA CIUC / ŞCOALA GENERALĂ ""LIVIU REBREANU""",1,8271,"MUNICIPIUL MIERCUREA CIUC",83320,1678,956,861,95,0,946,10,1800,844,171,775
21,"HARGHITA",190,83320,,10,"MIERCUREA CIUC / GRĂDINIŢA CU PROGRAM PRELUNGIT NR. 1 ""NAPRAFORGÓ""",1,8271,"MUNICIPIUL MIERCUREA CIUC",83320,1548,924,854,70,0,919,5,1600,676,141,778
21,"HARGHITA",190,83320,,11,"MIERCUREA CIUC / S.C. GOSCOM S.A",1,8271,"MUNICIPIUL MIERCUREA CIUC",83320,1482,716,652,64,0,706,10,1600,884,109,597
21,"HARGHITA",190,83320,,12,"MIERCUREA CIUC / ŞCOALA  GENERALĂ ""JÓZSEF ATTILA""",1,8271,"MUNICIPIUL MIERCUREA CIUC",83320,1497,1136,783,77,276,1116,20,1900,764,394,722
21,"HARGHITA",190,83320,,13,"MIERCUREA CIUC / ŞCOALA  GENERALĂ ""JÓZSEF ATTILA""",1,8271,"MUNICIPIUL MIERCUREA CIUC",83320,1611,838,796,42,0,819,19,1700,862,134,685
21,"HARGHITA",190,83320,,14,"MIERCUREA CIUC / ŞCOALA  GENERALĂ ""JÓZSEF ATTILA""",1,8271,"MUNICIPIUL MIERCUREA CIUC",83320,1662,828,786,42,0,819,9,1700,872,174,645
21,"HARGHITA",190,83320,,15,"MIERCUREA CIUC / SALA DE SPORT A ŞCOLII GENERALE ""JÓZSEF ATTILA""",1,8271,"MUNICIPIUL MIERCUREA CIUC",83320,1642,866,813,53,0,860,6,1700,834,173,687
21,"HARGHITA",190,83320,,16,"MIERCUREA CIUC / SALA DE SPORT A ŞCOLII GENERALE ""JÓZSEF ATTILA""",1,8271,"MUNICIPIUL MIERCUREA CIUC",83320,1591,983,799,74,110,975,8,1800,817,228,747
21,"HARGHITA",190,83320,,17,"MIERCUREA CIUC / CĂMINUL DE ZI ""ARANYALMA""",1,8271,"MUNICIPIUL MIERCUREA CIUC",83320,1768,807,740,67,0,803,4,1900,1093,150,653
21,"HARGHITA",190,83320,,18,"MIERCUREA CIUC / GRUPUL ŞCOLAR INDUSTRIAL ""SZÉKELY KÁROLY""",1,8271,"MUNICIPIUL MIERCUREA CIUC",83320,1511,790,739,51,0,782,8,1600,810,101,681
21,"HARGHITA",190,83320,,19,"MIERCUREA CIUC / GRUPUL ŞCOLAR INDUSTRIAL ""SZÉKELY KÁROLY""",1,8271,"MUNICIPIUL MIERCUREA CIUC",83320,1510,795,731,63,1,791,4,1600,805,98,693
21,"HARGHITA",190,83320,,20,"MIERCUREA CIUC / CASA DE CULTURĂ JIGODIN",1,8271,"MUNICIPIUL MIERCUREA CIUC",83320,1195,617,575,42,0,611,6,1300,683,43,568
21,"HARGHITA",190,83320,,21,"MIERCUREA CIUC / SEDIUL ASOCIAŢIEI ""CSÍKSOMLYÓ""",1,8271,"MUNICIPIUL MIERCUREA CIUC",83320,1686,927,828,85,14,919,8,1900,973,105,814
21,"HARGHITA",190,83320,,22,"MIERCUREA CIUC / CASA DE CULTURĂ TOPLIŢA",1,8271,"MUNICIPIUL MIERCUREA CIUC",83320,1595,904,871,33,0,893,11,1700,796,70,823
21,"HARGHITA",190,83320,,23,"HARGHITA-BĂI / ŞCOALA GENERALĂ ""NYÍRŐ JÓZSEF""",1,8271,"MUNICIPIUL MIERCUREA CIUC",83320,186,106,77,29,0,106,0,300,194,13,93
21,"HARGHITA",190,83561,,24,"GHEORGHENI / Şcoala Gimnazială ""Kós Károly""",1,8276,"MUNICIPIUL GHEORGHENI",83561,1852,833,794,39,0,823,10,2000,1167,145,678
21,"HARGHITA",190,83561,,25,"GHEORGHENI / Şcoala Gimnazială ""Kós Károly""",1,8276,"MUNICIPIUL GHEORGHENI",83561,1846,811,756,55,0,809,2,2000,1189,112,697
21,"HARGHITA",190,83561,,26,"GHEORGHENI / Şcoala Gimnazială ""Kós Károly""",1,8276,"MUNICIPIUL GHEORGHENI",83561,1886,810,786,24,0,802,8,2000,1190,126,676
21,"HARGHITA",190,83561,,27,"GHEORGHENI / Şcoala Gimnazială ""Vaskertes""",1,8276,"MUNICIPIUL GHEORGHENI",83561,1843,892,863,29,0,892,0,1900,1008,114,778
21,"HARGHITA",190,83561,,28,"GHEORGHENI / Şcoala Gimnazială ""Vaskertes""",1,8276,"MUNICIPIUL GHEORGHENI",83561,1771,744,714,29,1,739,5,1900,1156,108,631
21,"HARGHITA",190,83561,,29,"GHEORGHENI / Şcoala Gimnazială ""Vaskertes""",1,8276,"MUNICIPIUL GHEORGHENI",83561,1920,912,884,28,0,907,5,2000,1088,81,826
21,"HARGHITA",190,83561,,30,"GHEORGHENI / Liceul Teoretic ""Salamon Erno""",1,8276,"MUNICIPIUL GHEORGHENI",83561,1824,972,859,85,28,958,14,2000,1028,154,804
21,"HARGHITA",190,83561,,31,"GHEORGHENI / Liceul Tehnologic Fogarasy Mihály",1,8276,"MUNICIPIUL GHEORGHENI",83561,1787,861,818,43,0,855,6,1900,1039,98,757
21,"HARGHITA",190,83561,,32,"GHEORGHENI / Colegiul Tehnic ""Batthyány Ignác""",1,8276,"MUNICIPIUL GHEORGHENI",83561,1952,810,783,27,0,806,4,2100,1290,74,732
21,"HARGHITA",190,83561,,33,"LACU ROŞU / Corp de clădire cu 20 de apartamente",1,8276,"MUNICIPIUL GHEORGHENI",83561,76,104,35,69,0,104,0,300,196,29,75
21,"HARGHITA",190,83133,,34,"ODORHEIU SECUIESC / Colegiul Tehnic Bányai  János",1,8292,"MUNICIPIUL ODORHEIU SECUIESC",83133,1475,679,631,48,0,672,7,1600,921,138,534
21,"HARGHITA",190,83133,,35,"ODORHEIU SECUIESC / Colegiul Tehnic Bányai  János",1,8292,"MUNICIPIUL ODORHEIU SECUIESC",83133,1357,653,630,23,0,649,4,1400,747,81,568
21,"HARGHITA",190,83133,,36,"ODORHEIU SECUIESC / Grădiniţa Zsibongó",1,8292,"MUNICIPIUL ODORHEIU SECUIESC",83133,1371,641,609,32,0,637,4,1500,859,99,538
21,"HARGHITA",190,83133,,37,"ODORHEIU SECUIESC / Liceul Reformat ""Baczkamadarasi Kis Gergely""",1,8292,"MUNICIPIUL ODORHEIU SECUIESC",83133,1366,679,616,63,0,671,8,1500,821,50,621
21,"HARGHITA",190,83133,,38,"ODORHEIU SECUIESC / Liceul Reformat ""Baczkamadarasi Kis Gergely""",1,8292,"MUNICIPIUL ODORHEIU SECUIESC",83133,1223,440,405,35,0,440,0,1300,860,58,382
21,"HARGHITA",190,83133,,39,"ODORHEIU SECUIESC / Casă de Cultură",1,8292,"MUNICIPIUL ODORHEIU SECUIESC",83133,1453,723,657,66,0,713,10,1500,777,99,614
21,"HARGHITA",190,83133,,40,"ODORHEIU SECUIESC / Liceul Kós Károly",1,8292,"MUNICIPIUL ODORHEIU SECUIESC",83133,1594,820,777,43,0,816,4,1700,880,62,754
21,"HARGHITA",190,83133,,41,"ODORHEIU SECUIESC / Liceul Kós Károly",1,8292,"MUNICIPIUL ODORHEIU SECUIESC",83133,1636,810,778,32,0,807,3,1700,890,72,735
21,"HARGHITA",190,83133,,42,"ODORHEIU SECUIESC / Imobilul din strada Bethlen Gábor nr. 50",1,8292,"MUNICIPIUL ODORHEIU SECUIESC",83133,1356,856,645,88,123,846,10,1700,844,127,719
21,"HARGHITA",190,83133,,43,"ODORHEIU SECUIESC / Şc. Gen. Orbán Balázs",1,8292,"MUNICIPIUL ODORHEIU SECUIESC",83133,1469,668,645,23,0,667,1,1600,932,79,588
21,"HARGHITA",190,83133,,44,"ODORHEIU SECUIESC / Şc. Gen. Orbán Balázs",1,8292,"MUNICIPIUL ODORHEIU SECUIESC",83133,1276,620,584,36,0,615,5,1400,780,76,539
21,"HARGHITA",190,83133,,45,"ODORHEIU SECUIESC / Şc. Gen. Orbán Balázs",1,8292,"MUNICIPIUL ODORHEIU SECUIESC",83133,1089,569,532,37,0,566,3,1200,631,47,519
21,"HARGHITA",190,83133,,46,"ODORHEIU SECUIESC / Şc.Gen.Bethlen Gábor",1,8292,"MUNICIPIUL ODORHEIU SECUIESC",83133,1483,767,716,51,0,761,6,1600,833,68,693
21,"HARGHITA",190,83133,,47,"ODORHEIU SECUIESC / Şc.Gen.Bethlen Gábor",1,8292,"MUNICIPIUL ODORHEIU SECUIESC",83133,1444,704,672,32,0,702,2,1500,796,81,621
21,"HARGHITA",190,83133,,48,"ODORHEIU SECUIESC / Şc.Gen.Bethlen Gábor",1,8292,"MUNICIPIUL ODORHEIU SECUIESC",83133,1414,749,720,29,0,747,2,1500,751,72,675
21,"HARGHITA",190,83133,,49,"ODORHEIU SECUIESC / Şc.Gen.Bethlen Gábor",1,8292,"MUNICIPIUL ODORHEIU SECUIESC",83133,1520,749,731,18,0,745,4,1600,851,69,676
21,"HARGHITA",190,83133,,50,"ODORHEIU SECUIESC / Şc.Gen.Bethlen Gábor",1,8292,"MUNICIPIUL ODORHEIU SECUIESC",83133,1506,582,561,21,0,576,6,1600,1018,60,516
21,"HARGHITA",190,83133,,51,"ODORHEIU SECUIESC / Şc.Gen.Móra Ferenc",1,8292,"MUNICIPIUL ODORHEIU SECUIESC",83133,1616,786,730,56,0,781,5,1700,914,66,715
21,"HARGHITA",190,83133,,52,"ODORHEIU SECUIESC / Şc.Gen.Móra Ferenc",1,8292,"MUNICIPIUL ODORHEIU SECUIESC",83133,1589,751,719,31,1,749,2,1700,949,67,682
21,"HARGHITA",190,83133,,53,"ODORHEIU SECUIESC / Şc.Gen.Móra Ferenc",1,8292,"MUNICIPIUL ODORHEIU SECUIESC",83133,1599,746,716,30,0,744,2,1700,954,45,699
21,"HARGHITA",190,83133,,54,"ODORHEIU SECUIESC / Şc.Gen.Móra Ferenc",1,8292,"MUNICIPIUL ODORHEIU SECUIESC",83133,1671,815,787,28,0,814,1,1800,985,65,749
21,"HARGHITA",190,83133,,55,"ODORHEIU SECUIESC / Clubul Casei de Cultură Beclean",1,8292,"MUNICIPIUL ODORHEIU SECUIESC",83133,1555,817,774,43,0,812,5,1700,883,99,713
21,"HARGHITA",190,83632,,56,"TOPLIŢA / Şcoala Generală nr.8 ""Miron Cristea""",1,8282,"MUNICIPIUL TOPLIŢA",83632,1509,924,798,64,62,912,12,1700,776,348,564
21,"HARGHITA",190,83632,,57,"TOPLIŢA / Şcoala Generală nr.8 ""Miron Cristea""",1,8282,"MUNICIPIUL TOPLIŢA",83632,1582,887,847,40,0,881,6,1700,813,298,583
21,"HARGHITA",190,83632,,58,"TOPLIŢA / Liceul Teoretic ""Kemeny Janos""",1,8282,"MUNICIPIUL TOPLIŢA",83632,1418,798,763,35,0,789,9,1500,702,254,535
21,"HARGHITA",190,83632,,59,"TOPLIŢA / Grădiniţa Voinicelu",1,8282,"MUNICIPIUL TOPLIŢA",83632,1033,524,489,35,0,517,7,1100,576,178,339
21,"HARGHITA",190,83632,,60,"ZENCANI / Şcoala Generală nr.2 Zencani",1,8282,"MUNICIPIUL TOPLIŢA",83632,1542,830,796,34,0,826,4,1600,770,303,523
21,"HARGHITA",190,83632,,61,"VALE / Şcoala Generală ""Andrei Şoguna""",1,8282,"MUNICIPIUL TOPLIŢA",83632,1592,980,937,42,1,968,12,1700,720,375,593
21,"HARGHITA",190,83632,,62,"TOPLIŢA / Colegiul Naţional ""Mihai Eminescu""",1,8282,"MUNICIPIUL TOPLIŢA",83632,994,587,539,48,0,586,1,1100,513,169,417
21,"HARGHITA",190,83632,,63,"TOPLIŢA / Şcoala Generală nr.4 ""Sf. Ilie""",1,8282,"MUNICIPIUL TOPLIŢA",83632,1163,599,567,32,0,595,4,1200,601,169,426
21,"HARGHITA",190,83632,,64,"TOPLIŢA / Liceul ""O.C.Tăslăuanu""",1,8282,"MUNICIPIUL TOPLIŢA",83632,1362,646,625,21,0,640,6,1500,854,193,447
21,"HARGHITA",190,83632,,65,"CĂLIMĂNEL / Şcoala Generală ""Andrei Şaguna""",1,8282,"MUNICIPIUL TOPLIŢA",83632,998,588,565,23,0,586,2,1100,512,213,373
21,"HARGHITA",190,83632,,66,"SECU / Şcoala Generală Secu",1,8282,"MUNICIPIUL TOPLIŢA",83632,67,50,34,14,2,49,1,200,150,6,43
21,"HARGHITA",190,83428,,67,"BĂILE TUŞNAD / SEDIU PRIMARIE",1,8294,"ORAŞ BĂILE TUŞNAD",83428,1406,943,629,314,0,933,10,1600,657,122,811
21,"HARGHITA",190,83464,,68,"BĂLAN / Casa de cultură",1,8297,"ORAŞ BĂLAN",83464,1313,501,471,29,1,493,8,1400,899,170,323
21,"HARGHITA",190,83464,,69,"BĂLAN / Scoala Generala Nr. 1",1,8297,"ORAŞ BĂLAN",83464,1395,445,428,17,0,438,7,1500,1055,173,265
21,"HARGHITA",190,83464,,70,"BĂLAN / Scoala Generala ""Geo Bogza""",1,8297,"ORAŞ BĂLAN",83464,1286,392,372,20,0,386,6,1400,1008,213,173
21,"HARGHITA",190,83464,,71,"BĂLAN / Gradinita ""Licurici""",1,8297,"ORAŞ BĂLAN",83464,1281,396,379,17,0,391,5,1400,1004,217,174
21,"HARGHITA",190,83464,,72,"BĂLAN / Clubul Elevilor",1,8297,"ORAŞ BĂLAN",83464,1420,483,464,18,1,477,6,1500,1017,266,211
21,"HARGHITA",190,83491,,73,"BORSEC / Liceul Tehnologic Zimmethausen",1,8299,"ORAŞ BORSEC",83491,893,527,491,36,0,526,1,1000,473,59,467
21,"HARGHITA",190,83491,,74,"BORSEC / Sediul Consiliului local",1,8299,"ORAŞ BORSEC",83491,1423,910,868,42,0,907,3,1500,590,115,792
21,"HARGHITA",190,83525,,75,"BETEŞTI / Căminul Cultural Beteşti",1,8301,"ORAŞ CRISTURU SECUIESC",83525,594,210,187,23,0,208,2,700,490,42,166
21,"HARGHITA",190,83525,,76,"CRISTURU SECUIESC / Şcoala generală Petőfi Sándor",1,8301,"ORAŞ CRISTURU SECUIESC",83525,1237,502,488,14,0,501,1,1300,798,65,436
21,"HARGHITA",190,83525,,77,"CRISTURU SECUIESC / Parohia Romano-catolică",1,8301,"ORAŞ CRISTURU SECUIESC",83525,1506,670,642,28,0,668,2,1600,930,67,601
21,"HARGHITA",190,83525,,78,"CRISTURU SECUIESC / Primăria oraşului Cristuru Secuiesc",1,8301,"ORAŞ CRISTURU SECUIESC",83525,1495,696,660,36,0,692,4,1600,904,56,636
21,"HARGHITA",190,83525,,79,"CRISTURU SECUIESC / Şcoala gimnazială Petofi Sandor",1,8301,"ORAŞ CRISTURU SECUIESC",83525,1551,792,745,46,1,788,4,1800,1008,64,724
21,"HARGHITA",190,83525,,80,"CRISTURU SECUIESC / Liceul Teologic Unitarian ""Berde Mózes""",1,8301,"ORAŞ CRISTURU SECUIESC",83525,1637,693,660,33,0,689,4,1700,1007,81,608
21,"HARGHITA",190,83525,,81,"FILIAŞ / Centrul de planificare a familiei",1,8301,"ORAŞ CRISTURU SECUIESC",83525,900,457,440,17,0,448,9,1000,543,105,343
21,"HARGHITA",190,83749,,82,"VLĂHIŢA / Şcoala generală ""Mártonffi János""",1,8305,"ORAŞ VLĂHIŢA",83749,1322,573,558,15,0,565,8,1400,827,127,438
21,"HARGHITA",190,83749,,83,"VLĂHIŢA / Şcoala generală ""Mártonffi János""",1,8305,"ORAŞ VLĂHIŢA",83749,1464,683,659,24,0,681,2,1600,917,45,636
21,"HARGHITA",190,83749,,84,"VLĂHIŢA / Şcoala Generală ""Tamási Áron""",1,8305,"ORAŞ VLĂHIŢA",83749,1053,400,382,18,0,396,4,1100,700,52,344
21,"HARGHITA",190,83749,,85,"VLĂHIŢA / Grupul Şcolar ""Gábor Áron""",1,8305,"ORAŞ VLĂHIŢA",83749,1094,502,477,25,0,495,7,1200,698,55,440
21,"HARGHITA",190,83749,,86,"VLĂHIŢA / Casa de cultură ""Bartók Béla""",1,8305,"ORAŞ VLĂHIŢA",83749,1190,455,437,18,0,450,5,1400,945,44,406
21,"HARGHITA",190,83785,,87,"ATID / Primaria Atid",3,8309,"ATID",83785,1012,338,319,19,0,322,16,1100,762,153,169
21,"HARGHITA",190,83785,,88,"CRIŞENI / Primaria Atid",3,8309,"ATID",83785,573,237,209,28,0,232,5,600,363,103,129
21,"HARGHITA",190,83785,,89,"CUŞMED / Primaria Atid",3,8309,"ATID",83785,321,140,122,18,0,128,12,400,260,31,97
21,"HARGHITA",190,83785,,90,"ŞICLOD / Primaria Atid",3,8309,"ATID",83785,183,84,60,24,0,83,1,300,216,19,64
21,"HARGHITA",190,83785,,91,"INLĂCENI / Composesorat Inlaceni",3,8309,"ATID",83785,129,63,47,16,0,63,0,200,137,17,46
21,"HARGHITA",190,83847,,92,"AVRĂMEŞTI / Sediul Primăriei",3,8315,"AVRĂMEŞTI",83847,855,310,286,24,0,307,3,900,590,126,181
21,"HARGHITA",190,83847,,93,"CECHEŞTI / Şcoala generala",3,8315,"AVRĂMEŞTI",83847,467,223,211,12,0,218,5,500,277,60,158
21,"HARGHITA",190,83847,,94,"GOAGIU / Şcoala generala",3,8315,"AVRĂMEŞTI",83847,555,200,190,10,0,199,1,600,400,55,144
21,"HARGHITA",190,83847,,95,"FIRTĂNUŞ / Şcoala generala",3,8315,"AVRĂMEŞTI",83847,279,64,57,7,0,62,2,300,236,19,43
21,"HARGHITA",190,83936,,96,"BILBOR / CĂMINUL CULTURAL",3,8324,"BILBOR",83936,875,544,511,33,0,541,3,1000,456,270,271
21,"HARGHITA",190,83936,,97,"BILBOR / CĂMINUL CULTURAL",3,8324,"BILBOR",83936,1394,861,816,44,1,861,0,1500,639,437,424
21,"HARGHITA",190,83151,,98,"BRĂDEŞTI / ŞCOALA GIMNAZIALĂ MARTON ARON BRĂDEŞTI",3,8327,"BRĂDEŞTI",83151,955,559,523,36,0,559,0,1000,441,146,413
21,"HARGHITA",190,83151,,99,"TÎRNOVIŢA / SCOALA PRIMARA TIRNOVITA",3,8327,"BRĂDEŞTI",83151,615,395,370,25,0,388,7,700,305,124,264
21,"HARGHITA",190,83963,,100,"CĂPÎLNIŢA / Căminul cultural ""Sütő András""",3,8330,"CĂPÎLNIŢA",83963,824,310,295,15,0,307,3,900,590,51,256
21,"HARGHITA",190,83963,,101,"CĂPÎLNIŢA / Căminul cultural ""Sütő András""",3,8330,"CĂPÎLNIŢA",83963,816,253,244,9,0,250,3,900,647,83,167
21,"HARGHITA",190,86461,,102,"CICEU / PAROHIA ROM.CAT.",3,8335,"CICEU",86461,1477,714,682,32,0,708,6,1600,886,90,618
21,"HARGHITA",190,86461,,103,"CICEU / PAROHIA ROM.CAT.",3,8335,"CICEU",86461,768,293,283,10,0,291,2,800,507,29,262
21,"HARGHITA",190,83981,,104,"CIUCSÎNGEORGIU / Şcoala Generală ""Gal Sandor"" Ciucsângeorgiu",3,8338,"CIUCSÎNGEORGIU",83981,828,304,282,22,0,300,4,900,596,97,203
21,"HARGHITA",190,83981,,105,"CIUCSÎNGEORGIU / Şcoala Generală ""Gal Sandor"" Ciucsângeorgiu",3,8338,"CIUCSÎNGEORGIU",83981,749,247,234,13,0,237,10,800,553,33,204
21,"HARGHITA",190,83981,,106,"ARMĂŞENII NOI / Căminul Cultural Armăşeni-Noi",3,8338,"CIUCSÎNGEORGIU",83981,250,155,138,17,0,153,2,300,145,56,97
21,"HARGHITA",190,83981,,107,"ARMĂŞENI / Căminul Cultural Armăşeni",3,8338,"CIUCSÎNGEORGIU",83981,723,361,346,15,0,356,5,800,439,80,276
21,"HARGHITA",190,83981,,108,"BANCU / ŞCOALA GENERALĂ ""MARTON FERENC"" BANCU",3,8338,"CIUCSÎNGEORGIU",83981,1082,359,328,31,0,355,4,1200,841,53,302
21,"HARGHITA",190,83981,,109,"EGHERSEC / CĂMINUL CULTURAL EGHERSEC-CINOD",3,8338,"CIUCSÎNGEORGIU",83981,127,85,72,13,0,81,4,200,115,31,50
21,"HARGHITA",190,83981,,110,"EGHERSEC / CĂMINUL CULTURAL EGHERSEC",3,8338,"CIUCSÎNGEORGIU",83981,75,50,38,12,0,49,1,200,150,15,34
21,"HARGHITA",190,84086,,111,"CIUMANI / Şcoala primară Kollo Miklos nr.1",3,8348,"CIUMANI",84086,1389,582,561,21,0,579,3,1500,918,55,524
21,"HARGHITA",190,84086,,112,"CIUMANI / Şcoala primară Kollo Miklos nr.1",3,8348,"CIUMANI",84086,1142,440,417,23,0,433,7,1200,760,58,375
21,"HARGHITA",190,84086,,113,"CIUMANI / Şcoala Primara Kollo Miklos nr.4",3,8348,"CIUMANI",84086,1175,480,464,16,0,477,3,1300,820,61,416
21,"HARGHITA",190,84102,,114,"CÎRŢA / Primăria Cîrţa",3,8332,"CÎRŢA",84102,829,478,423,55,0,474,4,900,422,68,406
21,"HARGHITA",190,84102,,115,"INEU / Composesorat",3,8332,"CÎRŢA",84102,1465,588,575,13,0,581,7,1600,1012,76,505
21,"HARGHITA",190,84148,,116,"CORBU / CĂMINUL CULTURAL",3,8350,"CORBU",84148,777,423,385,38,0,419,4,900,477,171,248
21,"HARGHITA",190,84148,,117,"CAPU CORBULUI / CĂMINUL CULTURAL",3,8350,"CORBU",84148,408,238,216,22,0,236,2,500,262,105,131
21,"HARGHITA",190,84175,,118,"CORUND / GRĂDINIŢA DE COPII NR.1 CORUND",3,8353,"CORUND",84175,1374,548,535,13,0,541,7,1500,952,153,388
21,"HARGHITA",190,84175,,119,"CORUND / ŞCOALA GENERALĂ CORUND",3,8353,"CORUND",84175,1235,614,583,28,3,610,4,1300,686,160,450
21,"HARGHITA",190,84175,,120,"CORUND / ŞCOALA GENERALĂ  CORUND",3,8353,"CORUND",84175,1570,602,580,21,1,597,5,1700,1098,251,346
21,"HARGHITA",190,84175,,121,"ATIA / SEDIUL FOSTEI PRIMĂRII",3,8353,"CORUND",84175,180,103,89,14,0,103,0,200,97,21,82
21,"HARGHITA",190,84175,,122,"FÎNTÎNA BRAZILOR / ŞCOALA GENERALĂ",3,8353,"CORUND",84175,248,111,98,13,0,111,0,300,189,42,69
21,"HARGHITA",190,84175,,123,"VALEA LUI PAVEL / ŞCOALA GENERALĂ",3,8353,"CORUND",84175,292,107,95,12,0,106,1,400,293,33,73
21,"HARGHITA",190,86446,,124,"COZMENI / COMUNA COZMENI",3,8359,"COZMENI",86446,1126,607,575,32,0,593,14,1200,593,262,331
21,"HARGHITA",190,86446,,125,"LĂZĂREŞTI / COMUNA COZMENI",3,8359,"COZMENI",86446,488,197,173,24,0,193,4,600,403,45,148
21,"HARGHITA",190,84237,,126,"DĂNEŞTI / CAMINUL CULTURAL",3,8362,"DĂNEŞTI",84237,907,390,360,30,0,389,1,1000,610,55,334
21,"HARGHITA",190,84237,,127,"DĂNEŞTI / Clădirea căminului cultural Dăneşti",3,8362,"DĂNEŞTI",84237,977,419,405,14,0,417,2,1100,681,32,385
21,"HARGHITA",190,84264,,128,"DEALU / CASA SOCIALĂ",3,8364,"DEALU",84264,1555,710,678,32,0,707,3,1700,990,96,611
21,"HARGHITA",190,84264,,129,"SÎNCRAI / CAMIN CULTURAL",3,8364,"DEALU",84264,1067,515,495,20,0,508,7,1200,685,87,421
21,"HARGHITA",190,84264,,130,"ULCANI / CASĂ COMUNALĂ",3,8364,"DEALU",84264,541,254,224,30,0,251,3,600,346,52,199
21,"HARGHITA",190,84344,,131,"DITRĂU / Şcoala Gimnazială ""Siklody Lorinc"" Ditrău clasele V - VIII",3,8375,"DITRĂU",84344,1609,700,680,20,0,696,4,1700,1000,76,620
21,"HARGHITA",190,84344,,132,"DITRĂU / Şcoala Gimnazială ""Siklody Lorinc"" Ditrău ALSZEG",3,8375,"DITRĂU",84344,890,356,338,18,0,353,3,1000,644,48,305
21,"HARGHITA",190,84344,,133,"DITRĂU / Şcoala Gimnazială ""Csiby Andor"" Ditrău clasele I - IV ""KOHID""",3,8375,"DITRĂU",84344,965,361,351,10,0,356,5,1100,739,44,312
21,"HARGHITA",190,84344,,134,"DITRĂU / Şcoala Gimnazială ""Csiby Andor"" Ditrău clasele V - VIII",3,8375,"DITRĂU",84344,910,326,312,14,0,324,2,1000,674,64,260
21,"HARGHITA",190,84344,,135,"JOLOTCA / Şcoala Gimnazială Jolotca",3,8375,"DITRĂU",84344,510,156,147,9,0,154,2,600,444,29,125
21,"HARGHITA",190,84380,,136,"DÎRJIU / CĂMIN CULTURAL",3,8372,"DÎRJIU",84380,550,213,183,30,0,211,2,600,387,27,184
21,"HARGHITA",190,84380,,137,"MUJNA / CĂMIN CULTURAL",3,8372,"DÎRJIU",84380,285,169,140,29,0,169,0,400,231,42,127
21,"HARGHITA",190,83197,,138,"FELICENI / Şcoala Gimnazială ""Fulop Aron"" Feliceni",3,8379,"FELICENI",83197,938,485,459,26,0,483,2,1000,515,33,450
21,"HARGHITA",190,83197,,139,"TĂURENI / Şcoala Generală Tăureni",3,8379,"FELICENI",83197,568,291,268,23,0,291,0,600,309,30,261
21,"HARGHITA",190,83197,,140,"HOGHIA / Şcoala generală Hoghia",3,8379,"FELICENI",83197,228,117,100,17,0,117,0,300,183,21,96
21,"HARGHITA",190,83197,,141,"FORŢENI / Şcoala Generală Forţeni",3,8379,"FELICENI",83197,442,229,211,18,0,225,4,500,271,74,151
21,"HARGHITA",190,83197,,142,"POLONIŢA / Şcoala Generală Poloniţa",3,8379,"FELICENI",83197,271,168,133,35,0,168,0,300,132,24,144
21,"HARGHITA",190,83197,,143,"TELEAC / Şcoala Generală Teleac",3,8379,"FELICENI",83197,189,134,117,17,0,134,0,300,166,43,91
21,"HARGHITA",190,84415,,144,"BÎRZAVA / Căminul cultural",3,8391,"FRUMOASA",84415,540,270,252,18,0,269,1,600,330,25,244
21,"HARGHITA",190,84415,,145,"FRUMOASA / Primăria comunei Frumoasa",3,8391,"FRUMOASA",84415,1502,600,568,32,0,593,7,1600,1000,67,526
21,"HARGHITA",190,84415,,146,"NICOLEŞTI / Şcoala primară",3,8391,"FRUMOASA",84415,921,452,426,26,0,451,1,1000,548,88,363
21,"HARGHITA",190,84460,,147,"GĂLĂUŢAŞ / ŞCOALA GIMNAZIALĂ  ""DUMITRU GAFTON"" GĂLĂUŢAŞ",3,8396,"GĂLĂUŢAŞ",84460,994,536,495,26,15,533,3,1100,564,182,351
21,"HARGHITA",190,84460,,148,"GĂLĂUŢAŞ / ŞCOALA GIMNAZIALĂ ""DUMITRU GAFTON"" GĂLĂUŢAŞ",3,8396,"GĂLĂUŢAŞ",84460,727,335,314,18,3,331,4,800,465,118,213
21,"HARGHITA",190,84460,,149,"GĂLĂUŢAŞ-PÎRÎU / ŞCOALA PRIMARĂ GĂLĂUŢAŞ-PÎRÂU",3,8396,"GĂLĂUŢAŞ",84460,316,206,187,12,7,205,1,400,194,99,106
21,"HARGHITA",190,84558,,150,"JOSENI / Gr.Sc.SOVER ELEK",3,8405,"JOSENI",84558,1250,550,528,22,0,546,4,1300,750,66,480
21,"HARGHITA",190,84558,,151,"JOSENI / Gr.Sc.SOVER ELEK",3,8405,"JOSENI",84558,1474,620,585,34,1,615,5,1600,980,78,537
21,"HARGHITA",190,84558,,152,"JOSENI / CAMIN CULTURAL",3,8405,"JOSENI",84558,1402,608,585,23,0,598,10,1500,892,85,513
21,"HARGHITA",190,84558,,153,"BORZONT / Sc.Gen.BORZONT",3,8405,"JOSENI",84558,696,325,305,20,0,322,3,800,475,37,285
21,"HARGHITA",190,84594,,154,"LĂZAREA / ŞCOALA GENERALĂ NR.2",3,8409,"LĂZAREA",84594,1693,638,603,35,0,631,7,1701,1063,75,556
21,"HARGHITA",190,84594,,155,"LĂZAREA / ŞCOALA GENERALĂ NR.3",3,8409,"LĂZAREA",84594,1129,394,380,14,0,390,4,1200,806,39,351
21,"HARGHITA",190,84594,,156,"GHIDUŢ / ŞCOALA GENERALĂ NR.4",3,8409,"LĂZAREA",84594,138,60,44,16,0,59,1,200,140,13,46
21,"HARGHITA",190,86479,,157,"LELICENI / Caminul Cultural",3,8412,"LELICENI",86479,341,225,197,28,0,224,1,400,175,23,201
21,"HARGHITA",190,86479,,158,"MISENTEA / Sediu Administrativ",3,8412,"LELICENI",86479,854,336,316,20,0,332,4,900,564,75,257
21,"HARGHITA",190,86479,,159,"FITOD / Caminul Cultural",3,8412,"LELICENI",86479,399,237,224,13,0,232,5,500,263,33,199
21,"HARGHITA",190,84629,,160,"LUETA / SEDIUL PRIMĂRIEI",3,8417,"LUETA",84629,1512,433,425,8,0,430,3,1600,1167,68,362
21,"HARGHITA",190,84629,,161,"LUETA / CĂMINUL CULTURAL",3,8417,"LUETA",84629,1554,471,445,26,0,463,8,1600,1129,75,388
21,"HARGHITA",190,84656,,162,"VALEA RECE / CĂMINUL CULTURAL",3,8420,"LUNCA DE JOS",84656,1220,559,546,13,0,553,6,1300,741,124,429
21,"HARGHITA",190,84656,,163,"LUNCA DE JOS / Clădirea Primăriei",3,8420,"LUNCA DE JOS",84656,631,294,272,22,0,289,5,700,406,51,238
21,"HARGHITA",190,84656,,164,"LUNCA DE JOS / ŞCOALA GENERALĂ MAJLATH G. KAROLY",3,8420,"LUNCA DE JOS",84656,1439,491,474,17,0,488,3,1500,1009,61,427
21,"HARGHITA",190,84656,,165,"VALEA RECE / ŞCOALA GENERALĂ NR.8",3,8420,"LUNCA DE JOS",84656,876,505,488,17,0,499,6,1000,495,127,372
21,"HARGHITA",190,84656,,166,"PUNTEA LUPULUI / ŞCOALA PUNTEA LUPULUI",3,8420,"LUNCA DE JOS",84656,101,98,72,26,0,97,1,200,102,12,85
21,"HARGHITA",190,84754,,167,"COMIAT / ŞCOALA GENERALĂ COMIAT",3,8430,"LUNCA DE SUS",84754,298,147,136,11,0,146,1,400,253,23,123
21,"HARGHITA",190,84754,,168,"IZVORUL TROTUŞULUI / ŞCOALA GENERALĂ  IZVORUL TROTUŞULUI",3,8430,"LUNCA DE SUS",84754,568,253,245,8,0,250,3,600,347,56,194
21,"HARGHITA",190,84754,,169,"LUNCA DE SUS / PRIMĂRIA LUNCA DE SUS",3,8430,"LUNCA DE SUS",84754,1379,575,555,20,0,568,7,1500,925,85,483
21,"HARGHITA",190,84754,,170,"PĂLTINIŞ-CIUC / ŞCOALA GENERALĂ PĂLTINIŞ-CIUC",3,8430,"LUNCA DE SUS",84754,453,240,215,25,0,236,4,500,260,24,212
21,"HARGHITA",190,84825,,171,"MORĂRENI / Casa de Cultură",3,8437,"LUPENI",84825,656,346,323,23,0,341,5,700,354,72,269
21,"HARGHITA",190,84825,,172,"PĂLTINIŞ / Casa de Cultură",3,8437,"LUPENI",84825,426,188,171,17,0,185,3,500,312,31,154
21,"HARGHITA",190,84825,,173,"LUPENI / ŞCOALA GENERALĂ ""TAMASI ARON"" LUPENI",3,8437,"LUPENI",84825,1566,756,732,24,0,749,7,1700,944,166,583
21,"HARGHITA",190,84825,,174,"BISERICANI / Scoala generala ""Benedek Fidel"" Bisericani",3,8437,"LUPENI",84825,592,331,306,25,0,325,6,700,369,54,271
21,"HARGHITA",190,84825,,175,"BULGĂRENI / Scoala generală",3,8437,"LUPENI",84825,223,157,134,23,0,156,1,300,143,40,116
21,"HARGHITA",190,84825,,176,"PĂULENI / Scoala generală",3,8437,"LUPENI",84825,298,102,87,15,0,102,0,400,298,40,62
21,"HARGHITA",190,86438,,177,"MĂDĂRAŞ / ŞCOALA PRIMARĂ MĂDĂRAŞ",3,8447,"MĂDĂRAŞ",86438,1012,483,464,19,0,480,3,1100,617,50,430
21,"HARGHITA",190,86438,,178,"MĂDĂRAŞ / ŞCOALA PRIMARĂ MĂDĂRAŞ",3,8447,"MĂDĂRAŞ",86438,806,350,337,13,0,346,4,900,550,26,320
21,"HARGHITA",190,84923,,179,"MĂRTINIŞ / Caminul Cultural",3,8449,"MĂRTINIŞ",84923,547,278,230,48,0,269,9,600,322,73,196
21,"HARGHITA",190,84923,,180,"CHINUŞU / Caminul Cultural",3,8449,"MĂRTINIŞ",84923,116,66,41,25,0,66,0,200,134,11,55
21,"HARGHITA",190,84923,,181,"ALDEA / Scoala generala",3,8449,"MĂRTINIŞ",84923,318,156,125,31,0,154,2,400,244,88,66
21,"HARGHITA",190,84923,,182,"BĂDENI / Scoala generala",3,8449,"MĂRTINIŞ",84923,169,91,76,15,0,90,1,200,109,19,71
21,"HARGHITA",190,84923,,183,"SÎNPAUL / Scoala generala",3,8449,"MĂRTINIŞ",84923,419,249,219,30,0,244,5,500,251,60,184
21,"HARGHITA",190,84923,,184,"GHIPEŞ / Scoala generala",3,8449,"MĂRTINIŞ",84923,168,64,54,10,0,63,1,200,136,15,48
21,"HARGHITA",190,84923,,185,"COMĂNEŞTI / Scoala Generala",3,8449,"MĂRTINIŞ",84923,180,91,71,20,0,89,2,200,109,21,68
21,"HARGHITA",190,84923,,186,"RAREŞ / Scoala Generala",3,8449,"MĂRTINIŞ",84923,109,88,64,24,0,88,0,200,112,11,77
21,"HARGHITA",190,84923,,187,"ORĂŞENI / Gradinita de copii",3,8449,"MĂRTINIŞ",84923,206,144,124,20,0,144,0,300,156,30,114
21,"HARGHITA",190,84923,,188,"PETRENI / Scola Generala",3,8449,"MĂRTINIŞ",84923,144,108,87,21,0,107,1,200,92,21,86
21,"HARGHITA",190,85056,,189,"MEREŞTI / Primăria Mereşti",3,8462,"MEREŞTI",85056,1111,528,472,54,2,520,8,1200,672,138,382
21,"HARGHITA",190,85074,,190,"MIHĂILENI / Sc.Gim. Arany Janos",3,8464,"MIHĂILENI",85074,782,275,256,19,0,273,2,900,625,46,227
21,"HARGHITA",190,85074,,191,"VĂCĂREŞTI / Scoala Primara",3,8464,"MIHĂILENI",85074,489,236,217,19,0,236,0,600,364,33,203
21,"HARGHITA",190,85074,,192,"NĂDEJDEA / Scoala Primara",3,8464,"MIHĂILENI",85074,495,229,201,28,0,227,2,600,371,40,187
21,"HARGHITA",190,85074,,193,"LIVEZI / Scoala Gimnaziala",3,8464,"MIHĂILENI",85074,439,201,169,31,1,201,0,500,299,116,85
21,"HARGHITA",190,85127,,194,"MUGENI / Primăria Comunei Mugeni",3,8469,"MUGENI",85127,878,484,438,29,17,483,1,1000,516,156,327
21,"HARGHITA",190,85127,,195,"LUTIŢA /  Căminul Cultural Lutiţa",3,8469,"MUGENI",85127,615,377,340,21,16,371,6,700,323,149,222
21,"HARGHITA",190,85127,,196,"MĂTIŞENI /  Căminul Cultural Mătişeni",3,8469,"MUGENI",85127,107,80,67,12,1,79,1,200,120,9,70
21,"HARGHITA",190,85127,,197,"DEJUŢIU /  Căminul Cultural Dejuţiu",3,8469,"MUGENI",85127,157,96,78,17,1,95,1,200,104,45,50
21,"HARGHITA",190,85127,,198,"ALUNIŞ /  Căminul Cultural Aluniş",3,8469,"MUGENI",85127,121,98,84,11,3,98,0,200,102,31,67
21,"HARGHITA",190,85127,,199,"BETA /  Căminul Cultural Beta",3,8469,"MUGENI",85127,266,144,127,16,1,143,1,300,156,46,97
21,"HARGHITA",190,85127,,200,"DOBENI /  Căminul Cultural Dobeni",3,8469,"MUGENI",85127,485,249,222,23,4,246,3,600,351,93,153
21,"HARGHITA",190,85127,,201,"TĂIETURA /  Căminul Cultural Tăietura",3,8469,"MUGENI",85127,233,114,85,20,9,114,0,300,186,32,82
21,"HARGHITA",190,85243,,202,"CRĂCIUNEL / Căminul cultural",3,8478,"OCLAND",85243,395,188,158,30,0,185,3,500,312,59,126
21,"HARGHITA",190,85243,,203,"OCLAND / CAMINUL CULTURAL  Ocland",3,8478,"OCLAND",85243,618,242,222,20,0,240,2,700,458,57,183
21,"HARGHITA",190,83375,,204,"PĂULENI-CIUC / Camin cultural",3,8482,"PĂULENI-CIUC",83375,516,273,247,23,3,271,2,600,327,37,234
21,"HARGHITA",190,83375,,205,"DELNIŢA / Scoala Generala",3,8482,"PĂULENI-CIUC",83375,523,289,272,17,0,286,3,600,311,35,251
21,"HARGHITA",190,83375,,206,"ŞOIMENI / Scoala Generala",3,8482,"PĂULENI-CIUC",83375,462,222,197,25,0,222,0,500,278,18,204
21,"HARGHITA",190,85289,,207,"PLĂIEŞII DE JOS / Primăria comunei Plăieşii de Jos",3,8486,"PLĂIEŞII DE JOS",85289,658,304,235,56,13,301,3,700,396,39,262
21,"HARGHITA",190,85289,,208,"PLĂIEŞII DE SUS / Şcoala Generală Dr.Lukács Mihály",3,8486,"PLĂIEŞII DE JOS",85289,611,340,300,25,15,323,17,700,360,125,198
21,"HARGHITA",190,85289,,209,"IACOBENI / Şcoala Generală Dr.Lukács Mihály",3,8486,"PLĂIEŞII DE JOS",85289,306,108,90,18,0,107,1,400,292,43,64
21,"HARGHITA",190,85289,,210,"CASINU NOU / Şcoala Generală Dr.Lukács Mihály",3,8486,"PLĂIEŞII DE JOS",85289,572,262,228,28,6,254,8,600,338,78,176
21,"HARGHITA",190,86487,,211,"PORUMBENII MARI / Camin Cultural",3,8492,"PORUMBENI",86487,995,543,516,27,0,538,5,1100,557,129,409
21,"HARGHITA",190,86487,,212,"PORUMBENII MICI / Sala de manifestatii",3,8492,"PORUMBENI",86487,403,240,204,36,0,236,4,500,260,58,178
21,"HARGHITA",190,85341,,213,"PRAID / PRIMARIA COMUNEI PRAID- SALA DE SEDINTE AL CONS.LOCAL",3,8495,"PRAID",85341,1467,693,592,99,2,688,5,1700,1007,107,581
21,"HARGHITA",190,85341,,214,"PRAID / CAMINUL CULTURAL PRAID",3,8495,"PRAID",85341,1484,631,575,55,1,611,20,1600,969,212,399
21,"HARGHITA",190,85341,,215,"OCNA DE JOS / Şcoala Generală ""Sukosd Ferenc"" Ocna de Jos",3,8495,"PRAID",85341,1313,539,501,38,0,528,11,1400,861,142,386
21,"HARGHITA",190,85341,,216,"OCNA DE SUS / Şcoala Generală ""Szekely Mozes"" Ocna de Sus",3,8495,"PRAID",85341,1080,358,339,19,0,352,6,1200,842,96,256
21,"HARGHITA",190,85341,,217,"BECAŞ / Şcoala Generală Becaş",3,8495,"PRAID",85341,105,52,42,10,0,52,0,200,148,14,38
21,"HARGHITA",190,86495,,218,"RACU / Casa de Cultură Racu",3,8502,"RACU",86495,907,419,392,27,0,410,9,1000,581,67,343
21,"HARGHITA",190,86495,,219,"GÂRCIU / Grădiniţa de copii",3,8502,"RACU",86495,387,161,154,7,0,159,2,500,339,29,130
21,"HARGHITA",190,85412,,220,"REMETEA / Şcoala Generala ""Balás Jenő""",3,8505,"REMETEA",85412,1133,548,530,16,2,543,5,1200,652,119,424
21,"HARGHITA",190,85412,,221,"REMETEA / Grădinita de Copii Alszeg",3,8505,"REMETEA",85412,1375,679,658,21,0,664,15,1500,821,81,583
21,"HARGHITA",190,85412,,222,"REMETEA / Scola Gimnaziala Fráter György",3,8505,"REMETEA",85412,1374,669,647,20,2,662,7,1500,831,90,572
21,"HARGHITA",190,85412,,223,"REMETEA / Gradiniţa de Copii Tulamaros",3,8505,"REMETEA",85412,1255,521,494,25,2,513,8,1300,779,92,421
21,"HARGHITA",190,86501,,224,"SATU MARE / CAMINUL CULTURAL SATU MARE",3,8531,"SATU MARE",86501,815,387,357,30,0,383,4,900,513,97,286
21,"HARGHITA",190,86501,,225,"SATU MARE / CAMINUL CULTURAL SATU MARE",3,8531,"SATU MARE",86501,796,265,254,11,0,261,4,893,628,121,140
21,"HARGHITA",190,85467,,226,"SĂCEL / ŞCOALA GENERALĂ",3,8510,"SĂCEL",85467,100,51,39,12,0,48,3,200,149,20,28
21,"HARGHITA",190,85467,,227,"VIDACUT / CĂMIN CULTURAL",3,8510,"SĂCEL",85467,246,136,111,25,0,135,1,300,164,86,49
21,"HARGHITA",190,85467,,228,"ŞOIMUŞU MIC / CĂMIN CULTURAL",3,8510,"SĂCEL",85467,357,148,130,18,0,147,1,400,252,38,109
21,"HARGHITA",190,85467,,229,"ŞOIMUŞU MARE / CĂMIN CULTURAL",3,8510,"SĂCEL",85467,266,116,101,15,0,113,3,300,184,51,62
21,"HARGHITA",190,85528,,230,"HODOŞA / Scoala generală cu clasele I-VIII",3,8525,"SĂRMAŞ",85528,1257,681,658,21,2,676,5,1300,619,206,470
21,"HARGHITA",190,85528,,231,"PLATONEŞTI / ŞCOALA GENERALĂ CU CLASELE I-IV",3,8525,"SĂRMAŞ",85528,409,289,255,30,4,285,4,500,211,132,153
21,"HARGHITA",190,85528,,232,"FUNDOAIA / Şcoala generală cu clasele I-IV",3,8525,"SĂRMAŞ",85528,490,328,314,13,1,325,3,600,272,134,191
21,"HARGHITA",190,85528,,233,"SĂRMAŞ / ŞCOALA GENERALĂ CU CLASELE I-VIII",3,8525,"SĂRMAŞ",85528,1191,751,707,42,2,744,7,1300,549,258,486
21,"HARGHITA",190,85680,,234,"SÂNCRĂIENI / ŞCOALA GENERALĂ SÂNCRĂIENI",3,8516,"SÂNCRĂIENI",85680,1130,524,503,21,0,517,7,1200,676,91,426
21,"HARGHITA",190,85680,,235,"SÂNCRĂIENI / ŞCOALA GENERALĂ SÂNCRĂIENI",3,8516,"SÂNCRĂIENI",85680,939,449,423,26,0,444,5,1000,551,51,393
21,"HARGHITA",190,85788,,236,"SÂNMARTIN / PRIMARIA SÎNMARTIN",3,8518,"SÂNMARTIN",85788,962,438,394,44,0,428,10,1000,562,58,370
21,"HARGHITA",190,85788,,237,"SÂNMARTIN / PRIMARIA SÎNMARTIN",3,8518,"SÂNMARTIN",85788,854,321,294,26,1,303,18,900,579,68,235
21,"HARGHITA",190,86519,,238,"SÂNTIMBRU / ŞCOALA GENERALĂ ""ARANY JANOS""",3,8522,"SÂNTIMBRU",86519,960,474,453,21,0,467,7,988,514,65,402
21,"HARGHITA",190,86519,,239,"SÂNTIMBRU / ŞCOALA GENERALĂ ""ARANY JANOS""",3,8522,"SÂNTIMBRU",86519,718,295,273,22,0,295,0,800,505,66,229
21,"HARGHITA",190,85582,,240,"SECUIENI / CAMIN CULTURAL",3,8533,"SECUIENI",85582,615,290,266,24,0,288,2,700,410,75,213
21,"HARGHITA",190,85582,,241,"ELISENI / CAMIN CULTURAL",3,8533,"SECUIENI",85582,905,366,342,24,0,357,9,1000,634,117,240
21,"HARGHITA",190,85582,,242,"BODOGAIA / BIROU ADMINISTRATIV",3,8533,"SECUIENI",85582,687,330,311,19,0,329,1,800,470,46,283
21,"HARGHITA",190,85626,,243,"SICULENI / Primăria Comunei Siculeni",3,8537,"SICULENI",85626,911,471,439,32,0,465,6,1000,529,102,363
21,"HARGHITA",190,85626,,244,"SICULENI / Şcoala Generală Zold Peter",3,8537,"SICULENI",85626,1385,606,587,19,0,598,8,1500,894,114,484
21,"HARGHITA",190,85760,,245,"SÎNDOMINIC / Primăria Sîndominic",3,8554,"SÎNDOMINIC",85760,1541,544,537,7,0,538,6,1600,1056,65,473
21,"HARGHITA",190,85760,,246,"SÎNDOMINIC / Primăria Sîndominic",3,8554,"SÎNDOMINIC",85760,1492,560,547,13,0,555,5,1600,1040,60,495
21,"HARGHITA",190,85760,,247,"SÎNDOMINIC / Scoala generală Marton Aron  Sîndominic",3,8554,"SÎNDOMINIC",85760,1099,389,384,5,0,386,3,1200,811,57,329
21,"HARGHITA",190,85760,,248,"SÎNDOMINIC / Şcoala generală ""Márton Áron"" Sîndominic",3,8554,"SÎNDOMINIC",85760,1110,388,367,21,0,383,5,1200,812,36,347
21,"HARGHITA",190,85840,,249,"SÎNSIMION / Căminul cultural",3,8556,"SÎNSIMION",85840,755,319,297,22,0,316,3,900,581,37,279
21,"HARGHITA",190,85840,,250,"SÎNSIMION / Căminul cultural",3,8556,"SÎNSIMION",85840,1169,520,486,34,0,515,5,1300,780,89,426
21,"HARGHITA",190,85840,,251,"CETĂŢUIA / Cămin cultural",3,8556,"SÎNSIMION",85840,810,420,389,31,0,413,7,900,480,49,364
21,"HARGHITA",190,85877,,252,"SUBCETATE / LICEUL MIRON CRISTEA SUBCETATE",3,8559,"SUBCETATE",85877,1562,897,835,62,0,887,10,1700,803,356,531
21,"HARGHITA",190,85920,,253,"SUSENI / Primăria comunei Suseni",3,8564,"SUSENI",85920,863,357,334,23,0,356,1,900,543,24,332
21,"HARGHITA",190,85920,,254,"SUSENI / Primăria comunei Suseni",3,8564,"SUSENI",85920,860,363,353,10,0,361,2,900,537,24,337
21,"HARGHITA",190,85920,,255,"SUSENI / Scoala Generala Mures sat",3,8564,"SUSENI",85920,732,301,288,13,0,298,3,801,500,26,272
21,"HARGHITA",190,85920,,256,"CHILENI / Scoala Generala Chileni",3,8564,"SUSENI",85920,651,301,288,13,0,299,2,800,499,27,272
21,"HARGHITA",190,85920,,257,"VALEA STRÎMBĂ / Scoala Generala Valea Stramba",3,8564,"SUSENI",85920,1110,403,377,25,1,400,3,1200,797,47,353
21,"HARGHITA",190,85920,,258,"LIBAN / Scoala Generala Liban",3,8564,"SUSENI",85920,58,61,19,42,0,61,0,200,139,6,55
21,"HARGHITA",190,85984,,259,"RUGĂNEŞTI / Caminul cultural",3,8539,"ŞIMONEŞTI",85984,686,316,299,17,0,313,3,800,484,145,168
21,"HARGHITA",190,85984,,260,"COBĂTEŞTI / Caminul cultural",3,8539,"ŞIMONEŞTI",85984,448,270,248,22,0,267,3,500,230,123,144
21,"HARGHITA",190,85984,,261,"CEHEŢEL / Caminul cultural",3,8539,"ŞIMONEŞTI",85984,108,59,44,15,0,59,0,200,141,27,32
21,"HARGHITA",190,85984,,262,"TURDENI / Caminul cultural",3,8539,"ŞIMONEŞTI",85984,72,69,51,18,0,68,1,200,131,32,36
21,"HARGHITA",190,85984,,263,"TĂRCEŞTI / Caminul cultural",3,8539,"ŞIMONEŞTI",85984,175,117,103,14,0,115,2,200,83,32,83
21,"HARGHITA",190,85984,,264,"MIHĂILENI / Caminul cultural",3,8539,"ŞIMONEŞTI",85984,438,314,260,54,0,312,2,500,186,65,247
21,"HARGHITA",190,85984,,265,"ŞIMONEŞTI / Cladirea Primariei",3,8539,"ŞIMONEŞTI",85984,1084,560,539,21,0,556,4,1200,640,208,348
21,"HARGHITA",190,85984,,266,"MEDIŞORU MARE / Scoala Generala",3,8539,"ŞIMONEŞTI",85984,101,79,62,17,0,78,1,200,121,18,60
21,"HARGHITA",190,86453,,267,"TOMEŞTI / Clădirea căminului cultural Tomeşti",3,8570,"TOMEŞTI",86453,1116,414,397,17,0,409,5,1200,786,41,368
21,"HARGHITA",190,86453,,268,"TOMEŞTI / Clădirea Primăriei comunei Tomeşti",3,8570,"TOMEŞTI",86453,1027,343,329,12,2,342,1,1100,757,45,297
21,"HARGHITA",190,86133,,269,"TULGHEŞ / Şcoala gimnazială Tulgheş",3,8572,"TULGHEŞ",86133,1395,895,744,150,1,887,8,1500,605,291,596
21,"HARGHITA",190,86133,,270,"TULGHEŞ / Şcoala primară Putna",3,8572,"TULGHEŞ",86133,460,267,244,22,1,267,0,500,233,141,126
21,"HARGHITA",190,86133,,271,"RECEA / Şcoala primară Recea",3,8572,"TULGHEŞ",86133,195,140,118,22,0,140,0,300,160,25,115
21,"HARGHITA",190,86133,,272,"TULGHEŞ / Şcoala primară Valea Frumoasă",3,8572,"TULGHEŞ",86133,597,295,270,25,0,292,3,700,405,102,190
21,"HARGHITA",190,86188,,273,"TUŞNAD / CLĂDIREA PRIMRIEI",3,8577,"TUŞNAD",86188,744,309,285,24,0,296,13,800,491,76,220
21,"HARGHITA",190,86188,,274,"TUŞNADU NOU / CĂMINUL CULTURAL",3,8577,"TUŞNAD",86188,800,381,350,31,0,374,7,900,519,88,286
21,"HARGHITA",190,86188,,275,"VRABIA / CĂMINUL CULTURAL",3,8577,"TUŞNAD",86188,180,90,74,16,0,90,0,200,110,17,73
21,"HARGHITA",190,86222,,276,"ULIEŞ / CĂMINUL CULTURAL",3,8581,"ULIEŞ",86222,280,143,124,19,0,143,0,300,157,24,119
21,"HARGHITA",190,86222,,277,"NICOLEŞTI / CĂMINUL CULTURAL",3,8581,"ULIEŞ",86222,178,78,64,14,0,78,0,200,122,14,64
21,"HARGHITA",190,86222,,278,"DAIA / SCOALA GENERALĂ",3,8581,"ULIEŞ",86222,208,81,63,18,0,79,2,300,219,33,46
21,"HARGHITA",190,86222,,279,"IGHIU / CĂMIN ULCULTURAL",3,8581,"ULIEŞ",86222,52,43,25,18,0,43,0,200,157,14,29
21,"HARGHITA",190,86222,,280,"PETECU / CĂMIN UL CULTURAL",3,8581,"ULIEŞ",86222,200,91,65,26,0,87,4,300,209,36,51
21,"HARGHITA",190,86311,,281,"VĂRŞAG / Primăria comunei Vărşag",3,8590,"VĂRŞAG",86311,1040,502,464,38,0,499,3,1100,598,63,436
21,"HARGHITA",190,86311,,282,"VĂRŞAG / Scoala generala Solyomko",3,8590,"VĂRŞAG",86311,243,141,131,10,0,140,1,300,159,20,120
21,"HARGHITA",190,86339,,283,"VOŞLĂBENI / Scoala Generala nr.1 ,,Teodor Chindea""",3,8592,"VOŞLĂBENI",86339,1001,540,478,57,5,538,2,1100,560,222,316
21,"HARGHITA",190,86339,,284,"IZVORU MUREŞULUI / Scoala Generala  ,,Ion Creanga""",3,8592,"VOŞLĂBENI",86339,642,412,331,81,0,409,3,800,388,143,266
21,"HARGHITA",190,86366,,285,"ZETEA / Grădiniţa cu program normal Alszeg",3,8595,"ZETEA",86366,1220,681,662,19,0,673,8,1300,619,145,528
21,"HARGHITA",190,86366,,286,"ZETEA / Primăria Zetea",3,8595,"ZETEA",86366,1287,573,543,30,0,571,2,1300,727,75,496
21,"HARGHITA",190,86366,,287,"ZETEA / Şcoala Generală        nr. 7",3,8595,"ZETEA",86366,1205,581,557,24,0,578,3,1300,719,107,471
21,"HARGHITA",190,86366,,288,"SUB CETATE / Şcoala Generală Jokai Mor",3,8595,"ZETEA",86366,639,288,246,42,0,286,2,700,412,36,250
21,"HARGHITA",190,86366,,289,"ŞICASĂU / Cămin Cultural Şicasău",3,8595,"ZETEA",86366,134,55,39,16,0,55,0,215,160,8,47
21,"HARGHITA",190,86366,,290,"IZVOARE / Şcoala Generală Szekely Janos",3,8595,"ZETEA",86366,305,131,97,34,0,128,3,400,269,15,113
22,"HUNEDOARA",207,86687,,1,"DEVA / Casa de cultură",1,8603,"MUNICIPIUL DEVA",86687,1731,1146,1077,69,0,1130,16,1870,724,439,691
22,"HUNEDOARA",207,86687,,2,"DEVA / Casa de cultură",1,8603,"MUNICIPIUL DEVA",86687,1342,959,802,157,0,942,17,1500,541,388,554
22,"HUNEDOARA",207,86687,,3,"DEVA / Casa de cultură",1,8603,"MUNICIPIUL DEVA",86687,1611,976,939,36,1,954,22,1780,804,385,569
22,"HUNEDOARA",207,86687,,4,"DEVA / Şcoala gimnazială ""Andrei Şaguna""",1,8603,"MUNICIPIUL DEVA",86687,1456,852,826,25,1,835,17,1550,698,337,498
22,"HUNEDOARA",207,86687,,5,"DEVA / Şcoala gimnazială ""Andrei Şaguna""",1,8603,"MUNICIPIUL DEVA",86687,1496,879,818,61,0,861,18,1600,721,347,514
22,"HUNEDOARA",207,86687,,6,"DEVA / Şcoala gimnazială ""Andrei Şaguna""",1,8603,"MUNICIPIUL DEVA",86687,1487,904,855,48,1,887,17,1600,696,349,538
22,"HUNEDOARA",207,86687,,7,"DEVA / Grădiniţa nr.7",1,8603,"MUNICIPIUL DEVA",86687,1272,869,806,60,3,854,15,1400,531,362,492
22,"HUNEDOARA",207,86687,,8,"DEVA / Liceul Teoretic Sabin Drăgoi",1,8603,"MUNICIPIUL DEVA",86687,1216,816,736,79,1,797,19,1300,484,302,495
22,"HUNEDOARA",207,86687,,9,"DEVA / Liceul de Arte Sigismund Toduta (fosta Şcoala generală "" Lucian Blaga"" nr.2)",1,8603,"MUNICIPIUL DEVA",86687,1342,843,778,64,1,833,10,1480,637,377,456
22,"HUNEDOARA",207,86687,,10,"DEVA / Galeria FORMA",1,8603,"MUNICIPIUL DEVA",86687,1381,926,842,83,1,912,14,1500,574,398,514
22,"HUNEDOARA",207,86687,,11,"DEVA / Colegiul Naţional ""Decebal""",1,8603,"MUNICIPIUL DEVA",86687,1251,832,772,59,1,817,15,1350,518,327,490
22,"HUNEDOARA",207,86687,,12,"DEVA / Colegiul Naţional Sportiv Cetate Deva",1,8603,"MUNICIPIUL DEVA",86687,1437,1004,934,70,0,990,14,1550,546,362,628
22,"HUNEDOARA",207,86687,,13,"DEVA / Şcoală  primara Viile Noi",1,8603,"MUNICIPIUL DEVA",86687,879,551,511,40,0,540,11,980,429,225,315
22,"HUNEDOARA",207,86687,,14,"DEVA / Liceul de Arte Sigismund Toduţa (fosta Şcoala generală ""Lucian Blaga"" nr.2)",1,8603,"MUNICIPIUL DEVA",86687,1272,855,786,69,0,838,17,1350,495,371,467
22,"HUNEDOARA",207,86687,,15,"DEVA / Direcţia Generală de Asistenţă Socială şi Protecţia Copilului",1,8603,"MUNICIPIUL DEVA",86687,986,658,582,75,1,648,9,1100,442,258,390
22,"HUNEDOARA",207,86687,,16,"DEVA / Direcţia Silvică Deva",1,8603,"MUNICIPIUL DEVA",86687,1393,894,844,49,1,877,17,1500,606,385,492
22,"HUNEDOARA",207,86687,,17,"DEVA / Spital judeţean Deva",1,8603,"MUNICIPIUL DEVA",86687,1400,1064,824,239,1,1049,15,1600,536,452,597
22,"HUNEDOARA",207,86687,,18,"DEVA / Şcoala gimnazială  ""Andrei Şaguna""",1,8603,"MUNICIPIUL DEVA",86687,1312,859,796,63,0,838,21,1400,541,364,474
22,"HUNEDOARA",207,86687,,19,"DEVA / Şcoala gimnazială  ""Andrei Şaguna""",1,8603,"MUNICIPIUL DEVA",86687,1541,961,926,33,2,941,20,1650,689,403,538
22,"HUNEDOARA",207,86687,,20,"DEVA / Sala Sporturilor",1,8603,"MUNICIPIUL DEVA",86687,1401,850,772,77,1,838,12,1500,650,311,527
22,"HUNEDOARA",207,86687,,21,"DEVA / Colegiul Tehnic ""TRANSILVANIA""",1,8603,"MUNICIPIUL DEVA",86687,999,660,552,108,0,649,11,1100,440,249,400
22,"HUNEDOARA",207,86687,,22,"DEVA / Colegiul Tehnic ""TRANSILVANIA""",1,8603,"MUNICIPIUL DEVA",86687,1707,990,915,75,0,976,14,1848,858,388,588
22,"HUNEDOARA",207,86687,,23,"DEVA / Colegiul Tehnic ""TRANSILVANIA""",1,8603,"MUNICIPIUL DEVA",86687,794,499,454,45,0,492,7,900,401,175,317
22,"HUNEDOARA",207,86687,,24,"DEVA / Liceul de Arte ""Sigismund Toduţă""",1,8603,"MUNICIPIUL DEVA",86687,1248,828,749,79,0,803,25,1350,522,363,440
22,"HUNEDOARA",207,86687,,25,"DEVA / Colegiul Tehnic ""TRANSILVANIA"" (fosta  Şcoală generală)",1,8603,"MUNICIPIUL DEVA",86687,1606,1032,941,90,1,1020,12,1750,718,399,621
22,"HUNEDOARA",207,86687,,26,"DEVA / Colegiul Tehnic ""TRANSILVANIA"" (fosta  Şcoală generală)",1,8603,"MUNICIPIUL DEVA",86687,1371,820,759,61,0,805,15,1500,680,316,489
22,"HUNEDOARA",207,86687,,27,"DEVA / Colegiul Tehnic ""TRANSILVANIA"" (fosta  Şcoală generală)",1,8603,"MUNICIPIUL DEVA",86687,1759,1033,970,63,0,1018,15,1700,667,423,595
22,"HUNEDOARA",207,86687,,28,"DEVA / Colegiul Tehnic"" TRANSILVANIA""",1,8603,"MUNICIPIUL DEVA",86687,1581,960,904,34,22,946,14,1700,740,426,520
22,"HUNEDOARA",207,86687,,29,"DEVA / Club Şcolar Sportiv",1,8603,"MUNICIPIUL DEVA",86687,1416,917,860,55,2,910,7,1560,643,338,572
22,"HUNEDOARA",207,86687,,30,"DEVA / Casa Maghiară Deva ( fosta Casa Armatei)",1,8603,"MUNICIPIUL DEVA",86687,1092,878,642,55,181,869,9,1399,521,396,473
22,"HUNEDOARA",207,86687,,31,"DEVA / Casa Maghiară Deva (fosta Casa Armatei)",1,8603,"MUNICIPIUL DEVA",86687,986,820,596,36,188,800,17,1178,358,388,412
22,"HUNEDOARA",207,86687,,32,"DEVA / Colegiul Ion Mincu (fosta Şcoală generală ""Octavian Goga"")",1,8603,"MUNICIPIUL DEVA",86687,1467,738,700,38,0,726,12,1600,862,287,439
22,"HUNEDOARA",207,86687,,33,"DEVA / Colegiul Ion Mincu (fosta Şcoală generală ""Octavian Goga"")",1,8603,"MUNICIPIUL DEVA",86687,1742,975,938,36,1,954,21,1850,875,383,571
22,"HUNEDOARA",207,86687,,34,"DEVA / Colegiul Ion Mincu (fosta Şcoală generală ""Octavian Goga"")",1,8603,"MUNICIPIUL DEVA",86687,1518,799,737,62,0,787,12,1650,851,313,474
22,"HUNEDOARA",207,86687,,35,"DEVA / Gradiniţa P.N. nr.3",1,8603,"MUNICIPIUL DEVA",86687,1655,926,884,42,0,910,16,1800,874,363,547
22,"HUNEDOARA",207,86687,,36,"DEVA / Gradiniţa P.N. nr.3",1,8603,"MUNICIPIUL DEVA",86687,1631,929,890,39,0,912,17,1750,821,389,523
22,"HUNEDOARA",207,86687,,37,"DEVA / Colegiul ""Ioan Mincu"" (fostul Grup Şcolar de Construcţii)",1,8603,"MUNICIPIUL DEVA",86687,1573,983,925,56,2,967,16,1700,717,388,579
22,"HUNEDOARA",207,86687,,38,"DEVA / Liceul Tehnologic ""Grigore Moisil""(fostul Liceu Minier)",1,8603,"MUNICIPIUL DEVA",86687,869,591,530,61,0,580,11,950,359,245,335
22,"HUNEDOARA",207,86687,,39,"DEVA / Şcoala gimnazială ""Andrei Mureşanu""(fosta Şcoală generală. nr.5)",1,8603,"MUNICIPIUL DEVA",86687,1345,760,709,51,0,749,11,1450,690,311,438
22,"HUNEDOARA",207,86687,,40,"DEVA / Şcoala gimnazială ""Andrei Mureşanu""(fosta Şcoală generală. nr.5)",1,8603,"MUNICIPIUL DEVA",86687,1021,610,574,36,0,597,13,1100,490,244,353
22,"HUNEDOARA",207,86687,,41,"DEVA / Şcoala gimnazială ""Andrei Mureşanu""(fosta Şcoală generală. nr.5)",1,8603,"MUNICIPIUL DEVA",86687,942,568,539,29,0,562,6,1040,472,248,314
22,"HUNEDOARA",207,86687,,42,"CRISTUR / Şcoala Primară Cristur",1,8603,"MUNICIPIUL DEVA",86687,1409,1053,807,25,221,1044,9,1700,647,495,549
22,"HUNEDOARA",207,86687,,43,"SÎNTUHALM / Căminul Cultural Sîntuhalm",1,8603,"MUNICIPIUL DEVA",86687,597,569,352,23,194,559,10,850,281,312,247
22,"HUNEDOARA",207,86687,,44,"DEVA / Şcoală  Primară Viile Noi",1,8603,"MUNICIPIUL DEVA",86687,901,543,520,23,0,539,4,990,447,214,325
22,"HUNEDOARA",207,86687,,45,"DEVA / Autogara Deva",1,8603,"MUNICIPIUL DEVA",86687,904,663,492,170,1,644,19,1100,437,311,333
22,"HUNEDOARA",207,86687,,46,"DEVA / Liceul Tehnologic ""Grigore Moisil"" (fost Liceu Miner)",1,8603,"MUNICIPIUL DEVA",86687,1065,689,665,24,0,670,19,1150,461,286,384
22,"HUNEDOARA",207,87291,,47,"BRAD / Casa de Cultura",1,8613,"MUNICIPIUL BRAD",87291,969,606,547,59,0,603,3,1150,544,298,305
22,"HUNEDOARA",207,87291,,48,"BRAD / Casa de Cultura",1,8613,"MUNICIPIUL BRAD",87291,1049,651,605,46,0,644,7,1150,499,361,283
22,"HUNEDOARA",207,87291,,49,"BRAD / Şcoala Generală ""Mircea Sântimbreanu""",1,8613,"MUNICIPIUL BRAD",87291,1668,965,916,45,4,952,13,1800,835,496,456
22,"HUNEDOARA",207,87291,,50,"BRAD / Şcoala Generală ""Mircea Sântimbreanu""",1,8613,"MUNICIPIUL BRAD",87291,1377,834,783,51,0,827,7,1500,666,434,393
22,"HUNEDOARA",207,87291,,51,"BRAD / Şcoala Generală ""Mircea Sântimbreanu""",1,8613,"MUNICIPIUL BRAD",87291,1304,771,734,37,0,766,5,1400,629,416,350
22,"HUNEDOARA",207,87291,,52,"BRAD / Şcoala Generală ""Mircea Sântimbreanu""",1,8613,"MUNICIPIUL BRAD",87291,1381,823,770,42,11,806,17,1500,677,419,387
22,"HUNEDOARA",207,87291,,53,"BRAD / Colegiul ""Avram Iancu"" Brad",1,8613,"MUNICIPIUL BRAD",87291,1020,585,556,29,0,577,8,1100,515,298,279
22,"HUNEDOARA",207,87291,,54,"BRAD / Colegiul ""Avram Iancu"" Brad",1,8613,"MUNICIPIUL BRAD",87291,1078,669,641,27,1,662,7,1150,481,333,329
22,"HUNEDOARA",207,87291,,55,"BRAD / Căminul de copii cu program prelungit",1,8613,"MUNICIPIUL BRAD",87291,1191,796,698,27,71,788,8,1400,604,424,364
22,"HUNEDOARA",207,87291,,56,"BRAD / Şcoala Generală ""Horea Cloşca şi Crişan""",1,8613,"MUNICIPIUL BRAD",87291,1071,671,598,73,0,664,7,1180,509,315,349
22,"HUNEDOARA",207,87291,,57,"VALEA BRADULUI / Şcoala Generală Valea Bradului",1,8613,"MUNICIPIUL BRAD",87291,675,421,405,16,0,414,7,750,329,213,201
22,"HUNEDOARA",207,87291,,58,"ŢĂRĂŢEL / Căminul Cultural Ţărăţel",1,8613,"MUNICIPIUL BRAD",87291,634,412,368,44,0,408,4,700,288,181,227
22,"HUNEDOARA",207,87291,,59,"MESTEACĂN / Căminul Cultural Mesteacăn",1,8613,"MUNICIPIUL BRAD",87291,483,278,256,19,3,276,2,530,252,138,138
22,"HUNEDOARA",207,87291,,60,"RUDA-BRAD / Căminul Cultural Ruda-Brad",1,8613,"MUNICIPIUL BRAD",87291,171,116,103,13,0,112,4,200,84,76,36
22,"HUNEDOARA",207,86810,,61,"HUNEDOARA / Şcoala Generală Nr.12",1,8620,"MUNICIPIUL HUNEDOARA",86810,1553,781,751,30,0,758,23,1700,919,381,377
22,"HUNEDOARA",207,86810,,62,"HUNEDOARA / Şcoala Generală Nr.12",1,8620,"MUNICIPIUL HUNEDOARA",86810,1415,644,620,24,0,631,13,1550,906,304,327
22,"HUNEDOARA",207,86810,,63,"HUNEDOARA / Şcoala Generală Nr.12",1,8620,"MUNICIPIUL HUNEDOARA",86810,1487,675,654,21,0,666,9,1600,925,326,340
22,"HUNEDOARA",207,86810,,64,"HUNEDOARA / Şcoala Gimnazială Nr. 1 (FOSTA ŞCOALĂ GENERALĂ NR. 9)",1,8620,"MUNICIPIUL HUNEDOARA",86810,1537,781,736,45,0,764,17,1700,919,409,355
22,"HUNEDOARA",207,86810,,65,"HUNEDOARA / Şcoala Gimnazială Nr. 1 (FOSTA ŞCOALĂ GENERALĂ NR. 9)",1,8620,"MUNICIPIUL HUNEDOARA",86810,1531,777,753,24,0,760,17,1650,873,411,349
22,"HUNEDOARA",207,86810,,66,"HUNEDOARA / Şcoala Gimnazială Nr. 1 (FOSTA ŞCOALĂ GENERALĂ NR. 9)",1,8620,"MUNICIPIUL HUNEDOARA",86810,1629,765,744,21,0,747,18,1750,985,384,363
22,"HUNEDOARA",207,86810,,67,"HUNEDOARA / Şcoala Gimnazială Nr. 1 (FOSTA ŞCOALĂ GENERALĂ NR. 9)",1,8620,"MUNICIPIUL HUNEDOARA",86810,1504,777,748,29,0,764,13,1640,863,369,395
22,"HUNEDOARA",207,86810,,68,"HUNEDOARA / Şcoala Gimnazială Nr. 1 (FOSTA ŞCOALĂ GENERALĂ NR. 9)",1,8620,"MUNICIPIUL HUNEDOARA",86810,1349,690,677,13,0,673,17,1450,760,334,339
22,"HUNEDOARA",207,86810,,69,"HUNEDOARA / Grădiniţa cu program normal Micro VII PN6",1,8620,"MUNICIPIUL HUNEDOARA",86810,1268,621,602,19,0,608,13,1400,779,303,305
22,"HUNEDOARA",207,86810,,70,"HUNEDOARA / Colegiul Economic ""Emanuil Gojdu"" (FOSTUL LICEU NR. 2)",1,8620,"MUNICIPIUL HUNEDOARA",86810,1326,789,739,50,0,772,17,1450,661,356,416
22,"HUNEDOARA",207,86810,,71,"HUNEDOARA / Liceul Tehnologic ""Constantin Bursan"" (FOSTUL LICEU NR. 3)",1,8620,"MUNICIPIUL HUNEDOARA",86810,1337,749,720,29,0,735,14,1450,701,336,399
22,"HUNEDOARA",207,86810,,72,"HUNEDOARA / Colegiul Naţional  de Informatică ""Traian Lalescu"" (CLĂDIREA NOUĂ)",1,8620,"MUNICIPIUL HUNEDOARA",86810,1435,926,816,34,76,912,14,1650,724,439,473
22,"HUNEDOARA",207,86810,,73,"HUNEDOARA / Colegiul Naţional  de Informatică ""Traian Lalescu"" ( CLĂDIREA ŞCOLII GENERALE NR. 4)",1,8620,"MUNICIPIUL HUNEDOARA",86810,1146,816,710,36,70,805,11,1400,584,383,422
22,"HUNEDOARA",207,86810,,74,"HUNEDOARA / Colegiul Naţional  de Informatică ""Traian Lalescu"" ( CLĂDIREA ŞCOLII GENERALE NR. 4)",1,8620,"MUNICIPIUL HUNEDOARA",86810,1389,834,738,25,71,823,11,1700,866,389,434
22,"HUNEDOARA",207,86810,,75,"HUNEDOARA / Şcoala Generală Nr.5",1,8620,"MUNICIPIUL HUNEDOARA",86810,1507,804,760,44,0,781,23,1650,846,386,395
22,"HUNEDOARA",207,86810,,76,"HUNEDOARA / Şcoala Generală Nr.5",1,8620,"MUNICIPIUL HUNEDOARA",86810,1147,588,552,36,0,574,14,1249,661,246,328
22,"HUNEDOARA",207,86810,,77,"HUNEDOARA / Şcoala Generală Nr.5",1,8620,"MUNICIPIUL HUNEDOARA",86810,1264,804,760,44,0,797,7,1400,596,357,440
22,"HUNEDOARA",207,86810,,78,"HĂŞDAT / Şcoala Generală Hăşdat",1,8620,"MUNICIPIUL HUNEDOARA",86810,348,211,193,18,0,207,4,400,189,92,115
22,"HUNEDOARA",207,86810,,79,"HUNEDOARA / Şcoala Generală Nr.6",1,8620,"MUNICIPIUL HUNEDOARA",86810,1629,984,940,44,0,964,20,1800,816,454,510
22,"HUNEDOARA",207,86810,,80,"HUNEDOARA / Şcoala Generală Nr.6",1,8620,"MUNICIPIUL HUNEDOARA",86810,1610,870,843,27,0,851,19,1750,880,402,449
22,"HUNEDOARA",207,86810,,81,"HUNEDOARA / Colegiul Tehnic ""Matei Corvin"" (FOSTUL LICEU NR. 1)",1,8620,"MUNICIPIUL HUNEDOARA",86810,1188,745,714,30,1,735,10,1300,555,389,346
22,"HUNEDOARA",207,86810,,82,"HUNEDOARA / Grădiniţa cu program normal nr.4 Micro I (LÂNGĂ ŞCOALA GENERALĂ NR. 3)",1,8620,"MUNICIPIUL HUNEDOARA",86810,1631,910,869,40,1,894,16,1800,890,442,452
22,"HUNEDOARA",207,86810,,83,"HUNEDOARA / Grădiniţa cu program prelungit ""Piticot""",1,8620,"MUNICIPIUL HUNEDOARA",86810,939,565,537,28,0,553,12,1030,465,300,253
22,"HUNEDOARA",207,86810,,84,"HUNEDOARA / Grădiniţa cu program prelungit ""Piticot""",1,8620,"MUNICIPIUL HUNEDOARA",86810,1284,697,670,27,0,686,11,1400,703,325,361
22,"HUNEDOARA",207,86810,,85,"HUNEDOARA / Colegiul Economic ""Emanuil Gojdu"" (ŞCOALA GENERALĂ NR. 3)",1,8620,"MUNICIPIUL HUNEDOARA",86810,1451,885,844,39,2,874,11,1600,715,405,469
22,"HUNEDOARA",207,86810,,86,"HUNEDOARA / Colegiul Economic ""Emanuil Gojdu"" (ŞCOALA GENERALĂ NR. 3)",1,8620,"MUNICIPIUL HUNEDOARA",86810,1443,880,862,18,0,868,12,1600,720,412,456
22,"HUNEDOARA",207,86810,,87,"HUNEDOARA / Şcoala Generală Nr. 7",1,8620,"MUNICIPIUL HUNEDOARA",86810,1234,700,682,18,0,686,14,1350,650,334,352
22,"HUNEDOARA",207,86810,,88,"HUNEDOARA / Şcoala Generală Nr. 7",1,8620,"MUNICIPIUL HUNEDOARA",86810,1290,728,696,32,0,708,20,1400,672,345,363
22,"HUNEDOARA",207,86810,,89,"HUNEDOARA / Şcoala Generală Nr.7",1,8620,"MUNICIPIUL HUNEDOARA",86810,1245,710,669,39,2,695,15,1350,640,344,351
22,"HUNEDOARA",207,86810,,90,"HUNEDOARA / Şcoala Generală Nr.8",1,8620,"MUNICIPIUL HUNEDOARA",86810,1214,661,640,21,0,653,8,1350,689,355,298
22,"HUNEDOARA",207,86810,,91,"HUNEDOARA / Şcoala Generală Nr.8",1,8620,"MUNICIPIUL HUNEDOARA",86810,1100,619,598,21,0,606,13,1200,581,316,290
22,"HUNEDOARA",207,86810,,92,"HUNEDOARA / Grădiniţa cu program prelungit PP4 ""Floarea Soarelui""",1,8620,"MUNICIPIUL HUNEDOARA",86810,1211,649,615,33,1,638,11,1298,649,319,319
22,"HUNEDOARA",207,86810,,93,"HUNEDOARA / Grădiniţa cu orar normal Micro III PN 2 ""Zori de zi""",1,8620,"MUNICIPIUL HUNEDOARA",86810,1365,798,763,35,0,785,13,1500,702,376,409
22,"HUNEDOARA",207,86810,,94,"HUNEDOARA / Şcoala Gimnazială Nr. 2 ( ŞCOALA GENERALĂ NR. 2)",1,8620,"MUNICIPIUL HUNEDOARA",86810,1590,919,899,19,1,902,17,1750,831,476,426
22,"HUNEDOARA",207,86810,,95,"HUNEDOARA / Şcoala Gimnazială Nr. 2 ( ŞCOALA GENERALĂ NR. 2)",1,8620,"MUNICIPIUL HUNEDOARA",86810,1594,945,909,36,0,931,14,1750,805,434,497
22,"HUNEDOARA",207,86810,,96,"HUNEDOARA / Şcoala Gimnazială Nr. 2 ( ŞCOALA GENERALĂ NR. 2)",1,8620,"MUNICIPIUL HUNEDOARA",86810,1412,844,823,21,0,826,18,1550,706,408,418
22,"HUNEDOARA",207,86810,,97,"HUNEDOARA / Şcoala Gimnazială Nr. 2 ( ŞCOALA GENERALĂ NR. 2)",1,8620,"MUNICIPIUL HUNEDOARA",86810,1577,900,875,24,1,875,25,1700,800,458,417
22,"HUNEDOARA",207,86810,,98,"HUNEDOARA / Centrul Şcolar pentru Educaţie Incluzivă ""Rudolf Steiner"" (FOSTUL CENTRU DE ZI)",1,8620,"MUNICIPIUL HUNEDOARA",86810,1227,627,600,27,0,616,11,1350,723,350,266
22,"HUNEDOARA",207,86810,,99,"HUNEDOARA / Centrul Şcolar pentru Educaţie Incluzivă ""Rudolf Steiner"" (FOSTUL CENTRU DE ZI)",1,8620,"MUNICIPIUL HUNEDOARA",86810,1212,607,588,19,0,596,11,1300,693,264,332
22,"HUNEDOARA",207,86810,,100,"HUNEDOARA / Şcoala Generală Nr.11",1,8620,"MUNICIPIUL HUNEDOARA",86810,1424,809,758,51,0,800,9,1550,741,382,418
22,"HUNEDOARA",207,86810,,101,"HUNEDOARA / Şcoala Generală Nr.11",1,8620,"MUNICIPIUL HUNEDOARA",86810,1539,848,808,40,0,837,11,1700,852,413,424
22,"HUNEDOARA",207,86810,,102,"HUNEDOARA / Şcoala Generală Nr. 11",1,8620,"MUNICIPIUL HUNEDOARA",86810,1306,705,671,34,0,690,15,1400,695,356,334
22,"HUNEDOARA",207,86810,,103,"HUNEDOARA / Şcoala Generală Nr. 11",1,8620,"MUNICIPIUL HUNEDOARA",86810,1323,741,726,15,0,728,13,1450,709,309,419
22,"HUNEDOARA",207,86810,,104,"HUNEDOARA / Cămin Cultural Buituri",1,8620,"MUNICIPIUL HUNEDOARA",86810,663,408,398,10,0,405,3,730,322,194,211
22,"HUNEDOARA",207,86810,,105,"HUNEDOARA / sediul Primăriei Municipiului Hunedoara (FOSTA B.R.D.)",1,8620,"MUNICIPIUL HUNEDOARA",86810,1673,1083,941,142,0,1051,32,1800,717,413,638
22,"HUNEDOARA",207,86810,,106,"RĂCĂŞTIA / Şcoala Generală Răcăştia",1,8620,"MUNICIPIUL HUNEDOARA",86810,524,312,300,12,0,309,3,580,268,93,216
22,"HUNEDOARA",207,86810,,107,"HUNEDOARA / Şcoala Generală  Zlaşti",1,8620,"MUNICIPIUL HUNEDOARA",86810,450,282,266,16,0,279,3,500,218,107,172
22,"HUNEDOARA",207,86810,,108,"BOŞ / Cămin Cultural Boş (GRĂDINIŢA)",1,8620,"MUNICIPIUL HUNEDOARA",86810,493,288,282,6,0,284,4,550,262,107,177
22,"HUNEDOARA",207,86810,,109,"PEŞTIŞU MARE / Şcoala Generală Peştişu Mare",1,8620,"MUNICIPIUL HUNEDOARA",86810,1080,677,645,32,0,667,10,1200,523,278,389
22,"HUNEDOARA",207,87059,,110,"LUPENI / Şcoala Generală nr. 1, Corpul II",1,8627,"MUNICIPIUL LUPENI",87059,1651,904,880,24,0,887,17,1800,896,628,259
22,"HUNEDOARA",207,87059,,111,"LUPENI / Şcoala Generală nr. 1",1,8627,"MUNICIPIUL LUPENI",87059,1458,789,745,28,16,774,15,1700,911,494,280
22,"HUNEDOARA",207,87059,,112,"LUPENI / Şcoala Generală nr. 1",1,8627,"MUNICIPIUL LUPENI",87059,1208,619,604,15,0,607,12,1350,731,446,161
22,"HUNEDOARA",207,87059,,113,"LUPENI / Şcoala Generală nr. 1",1,8627,"MUNICIPIUL LUPENI",87059,911,444,432,12,0,435,9,1000,556,328,107
22,"HUNEDOARA",207,87059,,114,"LUPENI / SPCLEP Lupeni",1,8627,"MUNICIPIUL LUPENI",87059,1791,1050,1005,45,0,1033,17,1900,850,663,370
22,"HUNEDOARA",207,87059,,115,"LUPENI / Şcoala Generală nr. 3",1,8627,"MUNICIPIUL LUPENI",87059,1024,618,591,27,0,605,13,1150,532,387,218
22,"HUNEDOARA",207,87059,,116,"LUPENI / Şcoala Generală nr. 3",1,8627,"MUNICIPIUL LUPENI",87059,1095,585,561,24,0,578,7,1200,615,389,189
22,"HUNEDOARA",207,87059,,117,"LUPENI / Grădiniţa cu Program Normal ""Lumea Copiilor""",1,8627,"MUNICIPIUL LUPENI",87059,1381,713,692,19,2,689,24,1500,787,483,206
22,"HUNEDOARA",207,87059,,118,"LUPENI / SC AUTOCOM AMICII GLC SRL (fosta TESMA)",1,8627,"MUNICIPIUL LUPENI",87059,1734,1036,1012,20,4,1020,16,1899,863,707,313
22,"HUNEDOARA",207,87059,,119,"LUPENI / Grădiniţa nr. 6",1,8627,"MUNICIPIUL LUPENI",87059,1698,847,827,20,0,829,18,1850,1003,620,209
22,"HUNEDOARA",207,87059,,120,"LUPENI / Liceul Teoretic",1,8627,"MUNICIPIUL LUPENI",87059,1519,798,749,49,0,779,19,1650,852,572,207
22,"HUNEDOARA",207,87059,,121,"LUPENI / Liceul Teoretic",1,8627,"MUNICIPIUL LUPENI",87059,987,465,432,33,0,457,8,1100,635,319,138
22,"HUNEDOARA",207,87059,,122,"LUPENI / Şcoala Generală nr. 2",1,8627,"MUNICIPIUL LUPENI",87059,1342,731,707,23,1,719,12,1450,719,525,194
22,"HUNEDOARA",207,87059,,123,"LUPENI / Şcoala Generală nr. 2",1,8627,"MUNICIPIUL LUPENI",87059,1139,651,629,21,1,646,5,1250,599,449,197
22,"HUNEDOARA",207,87059,,124,"LUPENI / Grădiniţa PN nr. 2",1,8627,"MUNICIPIUL LUPENI",87059,1017,559,527,32,0,543,16,1100,541,382,161
22,"HUNEDOARA",207,87059,,125,"LUPENI / Grădiniţa PN nr. 2",1,8627,"MUNICIPIUL LUPENI",87059,966,486,475,11,0,479,7,1102,616,339,140
22,"HUNEDOARA",207,87059,,126,"LUPENI / Grădiniţa PN nr. 2",1,8627,"MUNICIPIUL LUPENI",87059,1333,643,627,16,0,632,11,1450,807,445,187
22,"HUNEDOARA",207,87059,,127,"LUPENI / SC Universal Edil SA",1,8627,"MUNICIPIUL LUPENI",87059,801,415,394,21,0,413,2,900,485,259,154
22,"HUNEDOARA",207,87638,,128,"ORĂŞTIE / Casa de Cultură",1,8629,"MUNICIPIUL ORĂŞTIE",87638,1643,1003,944,57,2,989,14,1800,797,440,549
22,"HUNEDOARA",207,87638,,129,"ORĂŞTIE / Creşa Municipală",1,8629,"MUNICIPIUL ORĂŞTIE",87638,1698,900,811,45,44,893,7,2000,1100,362,531
22,"HUNEDOARA",207,87638,,130,"ORĂŞTIE / Grădiniţa ""Scufiţa Roşie""",1,8629,"MUNICIPIUL ORĂŞTIE",87638,1518,828,766,62,0,821,7,1650,822,354,467
22,"HUNEDOARA",207,87638,,131,"ORĂŞTIE / Şc. Gim. ""D.Stanca""",1,8629,"MUNICIPIUL ORĂŞTIE",87638,1547,848,793,55,0,835,13,1700,852,336,499
22,"HUNEDOARA",207,87638,,132,"ORĂŞTIE / Complex Servicii Pentru Vârstnici",1,8629,"MUNICIPIUL ORĂŞTIE",87638,1756,995,919,76,0,984,11,1900,905,422,562
22,"HUNEDOARA",207,87638,,133,"ORĂŞTIE / Şc.Gim. ""dr. Aurel Vlad""",1,8629,"MUNICIPIUL ORĂŞTIE",87638,1556,895,854,41,0,886,9,1700,805,362,524
22,"HUNEDOARA",207,87638,,134,"ORĂŞTIE / Şc.Gim. I-IV Gară",1,8629,"MUNICIPIUL ORĂŞTIE",87638,1543,953,853,100,0,943,10,1700,747,374,569
22,"HUNEDOARA",207,87638,,135,"ORĂŞTIE / Oficiul de Gospodărire a Apelor",1,8629,"MUNICIPIUL ORĂŞTIE",87638,1731,1133,1088,45,0,1126,7,1900,767,499,627
22,"HUNEDOARA",207,87638,,136,"ORĂŞTIE / Lic.tehnologic ""N.Olahus""",1,8629,"MUNICIPIUL ORĂŞTIE",87638,1486,821,790,31,0,811,10,1600,779,368,443
22,"HUNEDOARA",207,87638,,137,"ORĂŞTIE / Colegiul Naţional ""Aurel Vlaicu""",1,8629,"MUNICIPIUL ORĂŞTIE",87638,1310,794,747,46,1,786,8,1400,606,347,439
22,"HUNEDOARA",207,87638,,138,"ORĂŞTIE / Primăria Municipiului Orăştie",1,8629,"MUNICIPIUL ORĂŞTIE",87638,1459,900,845,54,1,887,13,1600,700,435,452
22,"HUNEDOARA",207,87638,,139,"ORĂŞTIE / Serviciul Public de Asistenţă Socială",1,8629,"MUNICIPIUL ORĂŞTIE",87638,1834,1012,970,40,2,997,15,1999,987,429,568
22,"HUNEDOARA",207,86990,,140,"PETROŞANI / Şcoala Gimnazială ""I. G. Duca"" (Şcoala Generală nr.1) Sediul vechi",1,8631,"MUNICIPIUL PETROŞANI",86990,1736,1080,1024,53,3,1055,25,1900,820,555,500
22,"HUNEDOARA",207,86990,,141,"PETROŞANI / Şcoala Gimnazială I.G.Duca (Şcoala generală nr. 1 - Sediul vechi)",1,8631,"MUNICIPIUL PETROŞANI",86990,1593,976,929,47,0,956,20,1750,774,552,404
22,"HUNEDOARA",207,86990,,142,"PETROŞANI / Şcoala Gimnazială I.G. Duca (Şcoala Generală nr. 1 - Sediul nou)",1,8631,"MUNICIPIUL PETROŞANI",86990,1410,883,832,51,0,866,17,1550,667,492,374
22,"HUNEDOARA",207,86990,,143,"PETROŞANI / Amfiteatrul Universităţii",1,8631,"MUNICIPIUL PETROŞANI",86990,1466,849,787,62,0,835,14,1600,751,448,387
22,"HUNEDOARA",207,86990,,144,"PETROŞANI / Club Sportiv Şcolar",1,8631,"MUNICIPIUL PETROŞANI",86990,1050,683,618,65,0,663,20,1150,467,387,276
22,"HUNEDOARA",207,86990,,145,"PETROŞANI / Şcoala Gimnazială Avram Stanca (Şcoala Generală nr.4)",1,8631,"MUNICIPIUL PETROŞANI",86990,1115,702,662,40,0,681,21,1200,498,385,296
22,"HUNEDOARA",207,86990,,146,"PETROŞANI / Şcoala Gimnazială Avram Stanca (Şcoala Generală nr.4)",1,8631,"MUNICIPIUL PETROŞANI",86990,1721,1038,983,53,2,1023,15,1900,862,552,471
22,"HUNEDOARA",207,86990,,147,"PETROŞANI / Colegiul Naţional ""Mihai Eminescu"" (Liceul Teoretic)",1,8631,"MUNICIPIUL PETROŞANI",86990,1851,1030,993,36,1,1003,27,2000,970,619,384
22,"HUNEDOARA",207,86990,,148,"PETROŞANI / Grădiniţa nr.3 cu program prelungit",1,8631,"MUNICIPIUL PETROŞANI",86990,979,687,601,29,57,678,9,1250,563,406,272
22,"HUNEDOARA",207,86990,,149,"PETROŞANI / Colegiul Naţional de Informatică Carmen Sylva (Liceul de Informatică)",1,8631,"MUNICIPIUL PETROŞANI",86990,1505,915,834,24,57,900,15,1800,885,479,421
22,"HUNEDOARA",207,86990,,150,"PETROŞANI / Colegiul Economic ""Hermes """,1,8631,"MUNICIPIUL PETROŞANI",86990,1558,982,875,33,74,964,18,1850,868,622,342
22,"HUNEDOARA",207,86990,,151,"PETROŞANI / Şcoala Gimnazială I.G.Duca (Şcoala Generală nr.5)",1,8631,"MUNICIPIUL PETROŞANI",86990,1675,984,946,38,0,970,14,1850,866,619,351
22,"HUNEDOARA",207,86990,,152,"PETROŞANI / Şcoala Gimnazială ""I.G. Duca"" (Şcoala Generală nr.5)",1,8631,"MUNICIPIUL PETROŞANI",86990,1535,871,844,26,1,849,22,1650,779,535,314
22,"HUNEDOARA",207,86990,,153,"PETROŞANI / Şcoala Gimnazială Carmen Sylva (Şcoala Generală nr.6)",1,8631,"MUNICIPIUL PETROŞANI",86990,1694,1004,974,30,0,987,17,1850,846,640,347
22,"HUNEDOARA",207,86990,,154,"PETROŞANI / Şcoala Gimnazială Carmen Sylva (Şcoala Generală nr.6)",1,8631,"MUNICIPIUL PETROŞANI",86990,1804,838,819,19,0,815,23,1950,1112,592,223
22,"HUNEDOARA",207,86990,,155,"PETROŞANI / Grădiniţa cu program prelungit Aeroport",1,8631,"MUNICIPIUL PETROŞANI",86990,947,509,485,24,0,504,5,1050,541,328,176
22,"HUNEDOARA",207,86990,,156,"PETROŞANI / Grădiniţa cu program normal nr. 2 Aeroport",1,8631,"MUNICIPIUL PETROŞANI",86990,1586,859,829,28,2,834,25,1750,891,555,279
22,"HUNEDOARA",207,86990,,157,"PETROŞANI / Grădiniţa cu program normal nr.2 Aeroport",1,8631,"MUNICIPIUL PETROŞANI",86990,1855,866,849,17,0,839,27,1950,1084,563,276
22,"HUNEDOARA",207,86990,,158,"PETROŞANI / Şcoala Gimnazială nr.7",1,8631,"MUNICIPIUL PETROŞANI",86990,1871,952,896,55,1,926,26,1950,998,639,287
22,"HUNEDOARA",207,86990,,159,"PETROŞANI / Şcoala Gimnazială nr.7",1,8631,"MUNICIPIUL PETROŞANI",86990,1908,959,919,39,1,943,16,2000,1041,664,279
22,"HUNEDOARA",207,86990,,160,"PETROŞANI / S.C. General Trans S.A.",1,8631,"MUNICIPIUL PETROŞANI",86990,672,390,370,20,0,375,15,750,360,241,134
22,"HUNEDOARA",207,86990,,161,"PETROŞANI / Casa Pensionarilor",1,8631,"MUNICIPIUL PETROŞANI",86990,1487,790,769,20,1,776,14,1600,810,508,268
22,"HUNEDOARA",207,86990,,162,"PETROŞANI / Casa Pensionarilor",1,8631,"MUNICIPIUL PETROŞANI",86990,1048,568,553,15,0,553,15,1150,582,382,171
22,"HUNEDOARA",207,86990,,163,"PETROŞANI / Şcoala Gimnazială nr. 2",1,8631,"MUNICIPIUL PETROŞANI",86990,1249,647,628,19,0,637,10,1350,703,424,213
22,"HUNEDOARA",207,86990,,164,"PETROŞANI / Sediul S.C. Termoficare",1,8631,"MUNICIPIUL PETROŞANI",86990,1183,663,640,23,0,642,21,1300,637,407,235
22,"HUNEDOARA",207,86990,,165,"PETROŞANI / Şcoala Generală Dâlja Mare",1,8631,"MUNICIPIUL PETROŞANI",86990,191,122,110,12,0,119,3,250,128,99,20
22,"HUNEDOARA",207,87175,,166,"VULCAN / GRĂDINIŢA NR. 1",1,8609,"MUNICIPIUL VULCAN",87175,1241,657,634,23,0,650,7,1350,693,432,218
22,"HUNEDOARA",207,87175,,167,"VULCAN / ŞCOALĂ GIMNAZIALĂ NR. 4",1,8609,"MUNICIPIUL VULCAN",87175,1091,610,599,11,0,602,8,1300,690,423,179
22,"HUNEDOARA",207,87175,,168,"VULCAN / ŞCOALA GIMNAZIALĂ NR. 4",1,8609,"MUNICIPIUL VULCAN",87175,1144,661,642,19,0,651,10,1250,589,470,181
22,"HUNEDOARA",207,87175,,169,"VULCAN / CANTINA DE AJUTOR SOCIAL",1,8609,"MUNICIPIUL VULCAN",87175,1364,716,695,21,0,701,15,1500,784,500,201
22,"HUNEDOARA",207,87175,,170,"VULCAN / COLEGIUL TEHNIC MIHAI VITEAZU",1,8609,"MUNICIPIUL VULCAN",87175,1132,643,598,45,0,637,6,1250,607,427,210
22,"HUNEDOARA",207,87175,,171,"VULCAN / COLEGIUL TEHNIC MIHAI VITEAZU",1,8609,"MUNICIPIUL VULCAN",87175,1106,610,590,20,0,599,11,1200,590,441,158
22,"HUNEDOARA",207,87175,,172,"VULCAN / ŞCOALA GIMNAZIALĂ NR. 5",1,8609,"MUNICIPIUL VULCAN",87175,1389,770,746,23,1,760,10,1530,760,516,244
22,"HUNEDOARA",207,87175,,173,"VULCAN / ŞCOALA GIMNAZIALĂ NR. 5",1,8609,"MUNICIPIUL VULCAN",87175,1523,899,868,29,2,876,23,1650,751,613,263
22,"HUNEDOARA",207,87175,,174,"VULCAN / STADIONUL CENTRAL",1,8609,"MUNICIPIUL VULCAN",87175,1305,765,748,17,0,756,9,1450,685,489,267
22,"HUNEDOARA",207,87175,,175,"VULCAN / SALA DE SPORT",1,8609,"MUNICIPIUL VULCAN",87175,1537,813,786,27,0,796,17,1700,887,549,247
22,"HUNEDOARA",207,87175,,176,"VULCAN / ŞCOALA GIMNAZIALĂ NR. 6",1,8609,"MUNICIPIUL VULCAN",87175,1331,592,570,22,0,579,13,1450,858,445,134
22,"HUNEDOARA",207,87175,,177,"VULCAN / ŞCOALA GIMNAZIALĂ NR. 6",1,8609,"MUNICIPIUL VULCAN",87175,1468,688,671,17,0,678,10,1600,912,472,206
22,"HUNEDOARA",207,87175,,178,"VULCAN / ŞCOALA GIMNAZIALĂ NR. 6,",1,8609,"MUNICIPIUL VULCAN",87175,1520,755,734,21,0,744,11,1650,895,561,183
22,"HUNEDOARA",207,87175,,179,"VULCAN / GRĂDINIŢA CU PROGRAM NORMAL DIN CADRUL ŞCOLII GIMNAZIALE NR. 6",1,8609,"MUNICIPIUL VULCAN",87175,1354,681,648,33,0,670,11,1500,819,494,176
22,"HUNEDOARA",207,87175,,180,"VULCAN / ŞCOALA GIMNAZIALĂ TEODORA LUCACIU",1,8609,"MUNICIPIUL VULCAN",87175,1222,653,631,22,0,645,8,1350,697,467,178
22,"HUNEDOARA",207,87175,,181,"VULCAN / ŞCOALA GIMNAZIALĂ TEODORA LUCACIU",1,8609,"MUNICIPIUL VULCAN",87175,1006,561,543,18,0,554,7,1100,539,362,192
22,"HUNEDOARA",207,87175,,182,"VULCAN / CLUBUL COPIILOR ŞI ELEVILOR",1,8609,"MUNICIPIUL VULCAN",87175,972,556,529,27,0,548,8,1070,514,341,207
22,"HUNEDOARA",207,87175,,183,"VULCAN / ŞCOALA NR. 2",1,8609,"MUNICIPIUL VULCAN",87175,869,495,481,14,0,481,14,970,475,367,114
22,"HUNEDOARA",207,87175,,184,"VULCAN / ŞCOALA GIMNAZIALĂ NR. 3",1,8609,"MUNICIPIUL VULCAN",87175,1457,888,856,30,2,873,15,1600,712,557,316
22,"HUNEDOARA",207,87219,,185,"ANINOASA / Scoala Gimnaziala ""Sf. Varvara"" Aninoasa",1,8637,"ORAŞ ANINOASA",87219,1628,845,812,25,8,836,9,1780,935,633,203
22,"HUNEDOARA",207,87219,,186,"ANINOASA / Stadionul ""Minerul Aninoasa""",1,8637,"ORAŞ ANINOASA",87219,941,552,530,21,1,550,2,1050,498,413,137
22,"HUNEDOARA",207,87219,,187,"ISCRONI / Scoala Gimnaziala Iscroni",1,8637,"ORAŞ ANINOASA",87219,1350,796,744,47,5,783,13,1500,704,484,299
22,"HUNEDOARA",207,87424,,188,"CĂLAN / Consiliul local Călan",1,8640,"ORAŞ CĂLAN",87424,1078,626,575,42,9,622,4,1150,524,240,382
22,"HUNEDOARA",207,87424,,189,"CĂLAN / Şcoala Generală nr.2",1,8640,"ORAŞ CĂLAN",87424,1170,649,615,27,7,641,8,1250,601,288,353
22,"HUNEDOARA",207,87424,,190,"CĂLAN / Şcoala Generală nr.1",1,8640,"ORAŞ CĂLAN",87424,1477,738,711,24,3,721,17,1620,882,286,435
22,"HUNEDOARA",207,87424,,191,"CĂLAN / GRUP SCOLAR OVID DENSUSIANU",1,8640,"ORAŞ CĂLAN",87424,1606,881,836,41,4,867,14,1750,869,322,545
22,"HUNEDOARA",207,87424,,192,"CĂLAN / Policlinica",1,8640,"ORAŞ CĂLAN",87424,1528,799,775,23,1,789,10,1650,851,268,521
22,"HUNEDOARA",207,87424,,193,"CĂLAN / Casa Căsătoriilor",1,8640,"ORAŞ CĂLAN",87424,1437,792,753,38,1,782,10,1550,758,378,404
22,"HUNEDOARA",207,87424,,194,"NĂDĂŞTIA DE JOS / Căminul cultural",1,8640,"ORAŞ CĂLAN",87424,257,213,178,30,5,211,2,300,87,45,166
22,"HUNEDOARA",207,87424,,195,"NĂDĂŞTIA DE SUS / Căminul cultural",1,8640,"ORAŞ CĂLAN",87424,238,184,159,25,0,183,1,300,116,102,81
22,"HUNEDOARA",207,87424,,196,"STREI / Căminul cultural",1,8640,"ORAŞ CĂLAN",87424,323,199,174,24,1,197,2,370,171,65,132
22,"HUNEDOARA",207,87424,,197,"STREI-SĂCEL / Căminul cultural",1,8640,"ORAŞ CĂLAN",87424,161,119,104,13,2,114,5,200,81,44,70
22,"HUNEDOARA",207,87424,,198,"VALEA SÎNGEORGIULUI / Căminul cultural",1,8640,"ORAŞ CĂLAN",87424,259,174,162,12,0,172,2,300,126,50,122
22,"HUNEDOARA",207,87424,,199,"BATIZ / Şcoala primară",1,8640,"ORAŞ CĂLAN",87424,485,277,247,30,0,273,4,530,253,97,176
22,"HUNEDOARA",207,87424,,200,"GRID / Şcoala primară",1,8640,"ORAŞ CĂLAN",87424,203,157,141,16,0,154,3,250,93,71,83
22,"HUNEDOARA",207,87424,,201,"SÎNCRAI / Căminul cultural Sîncrai",1,8640,"ORAŞ CĂLAN",87424,269,169,150,19,0,168,1,300,131,68,100
22,"HUNEDOARA",207,87424,,202,"SÎNTĂMĂRIA DE PIATRĂ / Casă particulară nr.97 Sîntămăria de Piatră",1,8640,"ORAŞ CĂLAN",87424,150,112,94,16,2,112,0,190,78,47,65
22,"HUNEDOARA",207,87424,,203,"STREISÎNGEORGIU / Căminul cultural STREISÎNGEORGIU",1,8640,"ORAŞ CĂLAN",87424,651,437,409,28,0,431,6,720,283,168,263
22,"HUNEDOARA",207,89561,,204,"GEOAGIU / Sediul Primariei Geoagiu",1,8654,"ORAŞ GEOAGIU",89561,1198,840,724,83,33,833,7,1100,260,373,460
22,"HUNEDOARA",207,89561,,205,"GEOAGIU / Grădiniţa nr.1 Geoagiu,",1,8654,"ORAŞ GEOAGIU",89561,1171,794,742,49,3,786,8,1250,456,482,304
22,"HUNEDOARA",207,89561,,206,"AUREL VLAICU / Căminul cultural Aurel Vlaicu",1,8654,"ORAŞ GEOAGIU",89561,770,516,441,74,1,510,6,850,334,189,321
22,"HUNEDOARA",207,89561,,207,"BOZEŞ / Căminul cultural Bozes",1,8654,"ORAŞ GEOAGIU",89561,183,144,118,26,0,141,3,210,66,85,56
22,"HUNEDOARA",207,89561,,208,"CIGMĂU / Şcoala Primară Cigmau",1,8654,"ORAŞ GEOAGIU",89561,91,165,47,33,85,165,0,300,135,90,75
22,"HUNEDOARA",207,89561,,209,"GEOAGIU-BĂI / Scoala Primara Geoagiu Bai",1,8654,"ORAŞ GEOAGIU",89561,390,591,225,364,2,579,12,700,109,260,319
22,"HUNEDOARA",207,89561,,210,"GELMAR / Şcoala Primară Gelmar",1,8654,"ORAŞ GEOAGIU",89561,401,327,247,65,15,323,4,440,113,175,148
22,"HUNEDOARA",207,89561,,211,"HOMOROD / Căminul cultural Homorod",1,8654,"ORAŞ GEOAGIU",89561,300,201,177,24,0,201,0,340,139,96,105
22,"HUNEDOARA",207,89561,,212,"RENGHET / Căminul cultural Renghet",1,8654,"ORAŞ GEOAGIU",89561,182,151,122,25,4,149,2,200,49,74,75
22,"HUNEDOARA",207,89561,,213,"VĂLENI / Şcoala Primară Văleni",1,8654,"ORAŞ GEOAGIU",89561,47,27,15,12,0,27,0,60,33,11,16
22,"HUNEDOARA",207,87576,,214,"HAŢEG / Primăria oraşului Haţeg",1,8666,"ORAŞ HAŢEG",87576,1618,1148,1008,136,4,1131,17,1780,632,548,583
22,"HUNEDOARA",207,87576,,215,"HAŢEG / Şcoala Gimnazială ""Ovid Densuşianu"", Haţeg",1,8666,"ORAŞ HAŢEG",87576,1627,1176,977,162,37,1149,27,1850,674,501,648
22,"HUNEDOARA",207,87576,,216,"HAŢEG / Şcoala Gimnazială ""Aron Densuşianu"", Haţeg",1,8666,"ORAŞ HAŢEG",87576,1697,1040,938,99,3,1030,10,1850,810,428,602
22,"HUNEDOARA",207,87576,,217,"HAŢEG / Colegiul Naţional ,,I.C.Brătianu"" Haţeg",1,8666,"ORAŞ HAŢEG",87576,1697,1059,1004,54,1,1046,13,1850,791,444,602
22,"HUNEDOARA",207,87576,,218,"HAŢEG / Cantina socială Haţeg",1,8666,"ORAŞ HAŢEG",87576,1745,1146,1075,70,1,1127,19,1900,754,482,645
22,"HUNEDOARA",207,87576,,219,"NĂLAŢVAD / Şcoala Primară Nălaţvad",1,8666,"ORAŞ HAŢEG",87576,287,183,169,14,0,181,2,320,137,78,103
22,"HUNEDOARA",207,87576,,220,"SILVAŞU DE JOS / Scoala Primară Sivaşu de Jos",1,8666,"ORAŞ HAŢEG",87576,338,290,215,75,0,287,3,370,80,121,166
22,"HUNEDOARA",207,87576,,221,"SILVAŞU DE SUS / Căminul Cultural Silvaşu de Sus",1,8666,"ORAŞ HAŢEG",87576,277,213,168,45,0,206,7,310,97,83,123
22,"HUNEDOARA",207,87077,,222,"PETRILA / Casa de Cultura ""Ladislau Schmidt""",1,8671,"ORAŞ PETRILA",87077,1574,882,841,41,0,864,18,1750,868,514,350
22,"HUNEDOARA",207,87077,,223,"PETRILA / SC EDIL URBAN SERV SA",1,8671,"ORAŞ PETRILA",87077,1475,760,734,25,1,738,22,1620,860,451,287
22,"HUNEDOARA",207,87077,,224,"PETRILA / Gradinita nr.1",1,8671,"ORAŞ PETRILA",87077,1434,782,751,31,0,766,16,1550,768,499,267
22,"HUNEDOARA",207,87077,,225,"PETRILA / Scoala Generala I.D. SARBU",1,8671,"ORAŞ PETRILA",87077,1317,736,702,33,1,727,9,1450,714,503,224
22,"HUNEDOARA",207,87077,,226,"PETRILA / Clubul Copiilor",1,8671,"ORAŞ PETRILA",87077,1409,803,777,26,0,793,10,1550,747,543,250
22,"HUNEDOARA",207,87077,,227,"PETRILA / Scoala Generala NR. 6  Sectia 1",1,8671,"ORAŞ PETRILA",87077,1351,782,757,25,0,771,11,1500,718,540,231
22,"HUNEDOARA",207,87077,,228,"PETRILA / Scoala Generala NR. 6 Sectia 2",1,8671,"ORAŞ PETRILA",87077,976,541,525,16,0,537,4,1100,559,373,164
22,"HUNEDOARA",207,87077,,229,"PETRILA / Scoala Generala NR. 5  Sectia 1",1,8671,"ORAŞ PETRILA",87077,1481,786,766,20,0,771,15,1600,814,519,252
22,"HUNEDOARA",207,87077,,230,"PETRILA / Scoala Generala NR. 5  Sectia 2",1,8671,"ORAŞ PETRILA",87077,1415,696,675,21,0,685,11,1550,854,496,189
22,"HUNEDOARA",207,87077,,231,"PETRILA / Gradinita PN",1,8671,"ORAŞ PETRILA",87077,1404,695,671,23,1,681,14,1550,855,484,197
22,"HUNEDOARA",207,87077,,232,"PETRILA / Colegiul Constantin Brancusi",1,8671,"ORAŞ PETRILA",87077,983,611,592,19,0,598,13,1100,489,391,207
22,"HUNEDOARA",207,87077,,233,"PETRILA / Casa Pensionarilor Lonea",1,8671,"ORAŞ PETRILA",87077,1149,756,730,25,1,749,7,1250,494,525,224
22,"HUNEDOARA",207,87077,,234,"PETRILA / Scoala Generala: Ana Colda",1,8671,"ORAŞ PETRILA",87077,1514,926,898,25,3,913,13,1650,724,686,227
22,"HUNEDOARA",207,87077,,235,"CIMPA / Scoala Generala NR. 3 Cimpa",1,8671,"ORAŞ PETRILA",87077,1456,989,965,23,1,983,6,1600,611,754,229
22,"HUNEDOARA",207,87077,,236,"PETRILA / Gradinita Ana Colda",1,8671,"ORAŞ PETRILA",87077,1216,805,766,23,16,790,15,1350,545,530,260
22,"HUNEDOARA",207,87077,,237,"JIEŢ / Scoala Generala NR. 4 Jiet",1,8671,"ORAŞ PETRILA",87077,574,428,398,30,0,424,4,650,222,299,125
22,"HUNEDOARA",207,87665,,238,"SIMERIA / Scoala Gimnaziala ,,Sigismund Toduta '' Simeria",1,8677,"ORAŞ SIMERIA",87665,1658,1080,996,65,19,1061,19,1900,820,457,604
22,"HUNEDOARA",207,87665,,239,"SIMERIA / Scoala Gimnaziala ,,Sigismund Toduta '' Simeria",1,8677,"ORAŞ SIMERIA",87665,1537,1046,987,56,3,1023,23,1650,604,484,539
22,"HUNEDOARA",207,87665,,240,"SIMERIA / Gradinita cu Program Normal nr.1 Simeria",1,8677,"ORAŞ SIMERIA",87665,1548,967,910,56,1,956,11,1650,683,443,513
22,"HUNEDOARA",207,87665,,241,"SIMERIA / Gradinita Waldorf",1,8677,"ORAŞ SIMERIA",87665,1557,1045,981,62,2,1029,16,1650,605,450,579
22,"HUNEDOARA",207,87665,,242,"SIMERIA / Ocolul Silvic Simeria",1,8677,"ORAŞ SIMERIA",87665,1403,832,785,47,0,816,16,1500,668,407,409
22,"HUNEDOARA",207,87665,,243,"SIMERIA / Colegiul Tehnic de Transport Feroviar ,,Anghel Saligny'' Simeria",1,8677,"ORAŞ SIMERIA",87665,1269,805,742,59,4,794,11,1400,595,359,435
22,"HUNEDOARA",207,87665,,244,"SIMERIA / Statia CFR Simeria",1,8677,"ORAŞ SIMERIA",87665,1065,796,664,131,1,783,13,1300,504,304,479
22,"HUNEDOARA",207,87665,,245,"SIMERIA VECHE / Scoala Generala Simeria Veche",1,8677,"ORAŞ SIMERIA",87665,359,271,240,30,1,266,5,400,129,148,118
22,"HUNEDOARA",207,87665,,246,"UROI / Casa satului Uroi",1,8677,"ORAŞ SIMERIA",87665,531,374,331,42,1,371,3,600,226,146,225
22,"HUNEDOARA",207,87665,,247,"SÎNTANDREI / Scoala Generala Sîntandrei",1,8677,"ORAŞ SIMERIA",87665,937,653,579,74,0,647,6,1030,377,381,266
22,"HUNEDOARA",207,87139,,248,"URICANI / S.C. GOSCOMLOC S.A. Uricani",1,8685,"ORAŞ URICANI",87139,1921,1030,1001,25,4,1020,10,2100,1070,647,373
22,"HUNEDOARA",207,87139,,249,"URICANI / Scoala Gimnaziala ""Bucura""",1,8685,"ORAŞ URICANI",87139,1957,963,911,52,0,947,16,2150,1187,656,291
22,"HUNEDOARA",207,87139,,250,"URICANI / Liceul Tehnologic ""Retezat""",1,8685,"ORAŞ URICANI",87139,1886,968,924,41,3,953,15,2050,1082,648,305
22,"HUNEDOARA",207,87139,,251,"URICANI / Casa de cultura, Uricani,  sala parter",1,8685,"ORAŞ URICANI",87139,1763,908,867,29,12,895,13,1950,1042,626,269
22,"HUNEDOARA",207,87139,,252,"CÎMPU LUI NEAG / Şcoala Primară Cîmpu lui Neag",1,8685,"ORAŞ URICANI",87139,421,330,260,70,0,325,5,470,140,133,192
22,"HUNEDOARA",207,87745,,253,"BAIA DE CRIŞ / ŞCOALA GENERALA BAIA DE CRIŞ",3,8694,"BAIA DE CRIŞ",87745,645,426,378,45,3,424,2,698,272,199,225
22,"HUNEDOARA",207,87745,,254,"LUNCA / SCOALA PRIMARA LUNCA",3,8694,"BAIA DE CRIŞ",87745,237,174,147,27,0,173,1,263,89,64,109
22,"HUNEDOARA",207,87745,,255,"CĂRĂSTĂU / SCOALA PRIMARA CARASTAU",3,8694,"BAIA DE CRIŞ",87745,178,123,98,25,0,122,1,200,77,55,67
22,"HUNEDOARA",207,87745,,256,"RIŞCA / CAMIN CULTURAL RISCA",3,8694,"BAIA DE CRIŞ",87745,210,148,124,24,0,147,1,242,94,67,80
22,"HUNEDOARA",207,87745,,257,"RIŞCULIŢA / SCOALA PRIMARA RISCULITA",3,8694,"BAIA DE CRIŞ",87745,431,262,231,31,0,260,2,478,216,123,137
22,"HUNEDOARA",207,87745,,258,"ŢEBEA / SCOALA PRIMARA TEBEA",3,8694,"BAIA DE CRIŞ",87745,633,435,393,42,0,430,5,699,264,208,222
22,"HUNEDOARA",207,87843,,259,"BALŞA / BALŞA, SEDIUL PRIMĂRIEI COMUNEI",3,8716,"BALŞA",87843,250,196,146,47,3,195,1,270,74,59,136
22,"HUNEDOARA",207,87843,,260,"ARDEU / ARDEU, CĂMINUL CULTURAL",3,8716,"BALŞA",87843,45,55,34,20,1,55,0,60,5,12,43
22,"HUNEDOARA",207,87843,,261,"MADA / MADA, CĂMINUL CULTURAL",3,8716,"BALŞA",87843,96,81,48,33,0,81,0,110,29,19,62
22,"HUNEDOARA",207,87843,,262,"VOIA / VOIA, CĂMINUL CULTURAL",3,8716,"BALŞA",87843,82,84,55,28,1,81,3,100,16,29,52
22,"HUNEDOARA",207,87843,,263,"VĂLIŞOARA / VĂLIŞOARA, ŞCOALA GENERALĂ",3,8716,"BALŞA",87843,44,37,20,17,0,36,1,60,23,12,24
22,"HUNEDOARA",207,87843,,264,"ALMAŞU MIC DE MUNTE / ALMAŞU MIC DE MUNTE, ŞCOALA GENERALĂ",3,8716,"BALŞA",87843,66,58,38,20,0,58,0,80,22,35,23
22,"HUNEDOARA",207,87843,,265,"POIANA / POIANA, CĂMINUL CULTURAL",3,8716,"BALŞA",87843,96,80,53,24,3,80,0,110,30,33,47
22,"HUNEDOARA",207,87843,,266,"POIENIŢA / POIENIŢA, CĂMINUL CULTURAL",3,8716,"BALŞA",87843,77,65,49,11,5,65,0,90,25,28,37
22,"HUNEDOARA",207,87996,,267,"BARU / SCOALA PRIMARĂ BARU",3,8735,"BARU",87996,1604,1098,943,134,21,1089,9,1700,602,370,719
22,"HUNEDOARA",207,87996,,268,"LIVADIA / SCOALA PRIMARĂ LIVADIA",3,8735,"BARU",87996,519,413,338,61,14,412,1,580,167,112,300
22,"HUNEDOARA",207,87996,,269,"VALEA LUPULUI / SCOALA PRIMARĂ VALEA LUPULUI",3,8735,"BARU",87996,182,148,123,20,5,147,1,210,62,50,97
22,"HUNEDOARA",207,88047,,270,"BĂCIA / Căminul Cultural Băcia, nr. 235",3,8689,"BĂCIA",88047,820,621,517,104,0,613,8,900,279,307,306
22,"HUNEDOARA",207,88047,,271,"TOTIA / Şcoala primară Totia, nr.3",3,8689,"BĂCIA",88047,79,74,47,27,0,74,0,100,26,23,51
22,"HUNEDOARA",207,88047,,272,"TÎMPA / Şcoala primară Tîmpa, nr.28",3,8689,"BĂCIA",88047,654,457,407,50,0,446,11,710,253,267,179
22,"HUNEDOARA",207,88092,,273,"BĂIŢA / Căminul cultural Băiţa",3,8704,"BĂIŢA",88092,1026,708,615,93,0,701,7,1130,422,370,331
22,"HUNEDOARA",207,88092,,274,"HĂRŢĂGANI / Şcoala Generală Hărţăgani",3,8704,"BĂIŢA",88092,674,415,375,40,0,410,5,740,325,253,157
22,"HUNEDOARA",207,88092,,275,"CĂINELU DE SUS / Căminul cultural Căinelu de Sus",3,8704,"BĂIŢA",88092,347,247,219,27,1,245,2,390,143,139,106
22,"HUNEDOARA",207,88092,,276,"ORMINDEA / Şcoala Primară Ormindea",3,8704,"BĂIŢA",88092,497,367,320,47,0,363,4,550,183,222,141
22,"HUNEDOARA",207,88092,,277,"FIZEŞ / Căminul Cultural Fizeş",3,8704,"BĂIŢA",88092,272,231,195,35,1,231,0,300,69,123,108
22,"HUNEDOARA",207,88092,,278,"LUNCA / Căminul cultural Lunca",3,8704,"BĂIŢA",88092,257,204,172,32,0,199,5,280,76,121,78
22,"HUNEDOARA",207,87246,,279,"BĂNIŢA / CĂMIN CULTURAL BĂNIŢA",3,8731,"BĂNIŢA",87246,963,715,637,78,0,707,8,1060,345,343,364
22,"HUNEDOARA",207,88216,,280,"BĂTRÎNA / PRIMARIA COMUNEI BĂTRÎNA",3,8740,"BĂTRÎNA",88216,121,102,83,18,1,102,0,150,48,26,76
22,"HUNEDOARA",207,88261,,281,"BERIU / CAMINUL CULTURAL",3,8745,"BERIU",88261,564,367,325,42,0,363,4,600,233,103,260
22,"HUNEDOARA",207,88261,,282,"CĂSTĂU / SCOALA  PRIMARĂ",3,8745,"BERIU",88261,1025,626,579,47,0,618,8,1100,474,182,436
22,"HUNEDOARA",207,88261,,283,"CUCUIŞ / SCOALA PRIMARĂ",3,8745,"BERIU",88261,117,98,77,21,0,97,1,150,52,20,77
22,"HUNEDOARA",207,88261,,284,"ORĂŞTIOARA DE JOS / SCOALA PRIMARĂ",3,8745,"BERIU",88261,276,202,174,28,0,201,1,310,108,87,114
22,"HUNEDOARA",207,88261,,285,"SERECA / SCOALA PRIMARĂ",3,8745,"BERIU",88261,189,140,117,23,0,139,1,210,70,44,95
22,"HUNEDOARA",207,88261,,286,"SIBIŞEL / SCOALA PRIMARĂ SIBIŞEL",3,8745,"BERIU",88261,585,368,321,47,0,368,0,650,282,117,251
22,"HUNEDOARA",207,88350,,287,"BLĂJENI / CAMINUL CULTURAL BLAJENI",3,8754,"BLĂJENI",88350,557,354,322,30,2,352,2,610,256,188,164
22,"HUNEDOARA",207,88350,,288,"CRIŞ / SCOALA PRIMARA CRIS",3,8754,"BLĂJENI",88350,287,179,152,27,0,179,0,320,141,99,80
22,"HUNEDOARA",207,88350,,289,"BLĂJENI-VULCAN / SCOALA PRIMARA BLAJENI VULCAN",3,8754,"BLĂJENI",88350,83,61,48,13,0,61,0,100,39,31,30
22,"HUNEDOARA",207,88350,,290,"REŢ / SCOALA PRIMARA RET",3,8754,"BLĂJENI",88350,86,62,51,11,0,62,0,100,38,30,32
22,"HUNEDOARA",207,88449,,291,"BOŞOROD / Căminul cultural Bosorod",3,8763,"BOŞOROD",88449,783,626,566,58,2,618,8,850,224,248,370
22,"HUNEDOARA",207,88449,,292,"CHITID / Căminul cultural Chitid",3,8763,"BOŞOROD",88449,485,327,301,24,2,325,2,530,203,143,182
22,"HUNEDOARA",207,88449,,293,"LUNCANI / Căminul cultural Luncani",3,8763,"BOŞOROD",88449,104,87,73,14,0,87,0,120,33,40,47
22,"HUNEDOARA",207,88449,,294,"URSICI / Căminul cultural Ursici",3,8763,"BOŞOROD",88449,56,41,30,11,0,41,0,80,39,22,19
22,"HUNEDOARA",207,88449,,295,"ALUN / Scoala Primara Alun",3,8763,"BOŞOROD",88449,69,59,41,18,0,57,2,90,31,37,20
22,"HUNEDOARA",207,88449,,296,"TÎRSA / Căminul cultural Tirsa",3,8763,"BOŞOROD",88449,182,134,119,15,0,134,0,200,66,73,61
22,"HUNEDOARA",207,88546,,297,"BRĂNIŞCA / CĂMIN CULTURAL BRĂNIŞCA",3,8773,"BRĂNIŞCA",88546,523,390,305,72,13,383,7,570,180,178,205
22,"HUNEDOARA",207,88546,,298,"BOZ / CĂMIN CULTURAL BOZ",3,8773,"BRĂNIŞCA",88546,373,281,224,57,0,279,2,409,128,133,146
22,"HUNEDOARA",207,88546,,299,"ROVINA / ŞCOALA PRIMARĂ ROVINA",3,8773,"BRĂNIŞCA",88546,179,134,105,29,0,133,1,200,66,64,69
22,"HUNEDOARA",207,88546,,300,"TÎRNAVA / CĂMIN CULTURAL TÎRNAVA",3,8773,"BRĂNIŞCA",88546,109,81,60,21,0,81,0,120,39,40,41
22,"HUNEDOARA",207,88546,,301,"TÎRNĂVIŢA / CĂMIN CULTURAL TÎRNĂVIŢA",3,8773,"BRĂNIŞCA",88546,149,119,94,25,0,118,1,170,51,34,84
22,"HUNEDOARA",207,88546,,302,"BĂRĂŞTII ILIEI / CĂMIN CULTURAL FURCŞOARA",3,8773,"BRĂNIŞCA",88546,52,38,20,18,0,38,0,60,22,14,24
22,"HUNEDOARA",207,88644,,303,"BRETEA ROMÂNĂ / ŞCOALA GENERALĂ",3,8783,"BRETEA ROMÂNĂ",88644,231,174,143,28,3,173,1,251,77,73,100
22,"HUNEDOARA",207,88644,,304,"BRETEA STREIULUI / CĂMIN CULTURAL",3,8783,"BRETEA ROMÂNĂ",88644,190,161,117,44,0,156,5,210,49,64,92
22,"HUNEDOARA",207,88644,,305,"RUŞI / CĂMIN CULTURAL",3,8783,"BRETEA ROMÂNĂ",88644,216,183,152,31,0,182,1,239,56,99,83
22,"HUNEDOARA",207,88644,,306,"BĂŢĂLAR / ŞCOALA PRIMARA",3,8783,"BRETEA ROMÂNĂ",88644,200,138,106,32,0,135,3,220,82,51,84
22,"HUNEDOARA",207,88644,,307,"OCOLIŞU MARE / ŞCOALA PRIMARA",3,8783,"BRETEA ROMÂNĂ",88644,180,168,127,41,0,167,1,200,32,80,87
22,"HUNEDOARA",207,88644,,308,"COVRAGIU / CĂMIN CULTURAL COVRAGIU",3,8783,"BRETEA ROMÂNĂ",88644,146,117,90,27,0,117,0,171,54,53,64
22,"HUNEDOARA",207,88644,,309,"GÎNŢAGA / ŞCOALĂ PRIMARĂ",3,8783,"BRETEA ROMÂNĂ",88644,232,175,158,17,0,174,1,259,84,48,126
22,"HUNEDOARA",207,88644,,310,"MĂCEU / ŞCOALĂ PRIMARĂ",3,8783,"BRETEA ROMÂNĂ",88644,285,212,182,30,0,204,8,310,98,99,105
22,"HUNEDOARA",207,88644,,311,"PLOPI / ŞCOALĂ PRIMARĂ",3,8783,"BRETEA ROMÂNĂ",88644,230,182,148,34,0,181,1,250,68,78,103
22,"HUNEDOARA",207,88644,,312,"VÎLCELELE BUNE / ŞCOALĂ PRIMARĂ",3,8783,"BRETEA ROMÂNĂ",88644,332,221,192,29,0,218,3,360,139,76,142
22,"HUNEDOARA",207,88644,,313,"VÎLCELE / ŞCOALĂ PRIMARĂ VÎLCELE",3,8783,"BRETEA ROMÂNĂ",88644,217,195,150,45,0,193,2,240,45,127,66
22,"HUNEDOARA",207,88788,,314,"BUCEŞ / Camin cultural Buces",3,8797,"BUCEŞ",88788,132,114,93,21,0,114,0,151,37,73,41
22,"HUNEDOARA",207,88788,,315,"BUCEŞ-VULCAN / Scoala Primara Buces-Vulcan",3,8797,"BUCEŞ",88788,200,136,119,17,0,135,1,220,84,80,55
22,"HUNEDOARA",207,88788,,316,"DUPĂPIATRĂ / Scoala Primara Dupapiatra",3,8797,"BUCEŞ",88788,429,291,261,30,0,290,1,470,179,146,144
22,"HUNEDOARA",207,88788,,317,"GROHOŢELE / Scoala Primara Grohotele",3,8797,"BUCEŞ",88788,182,156,144,12,0,155,1,200,44,104,51
22,"HUNEDOARA",207,88788,,318,"MIHĂILENI / Scoala Primara Mihaileni",3,8797,"BUCEŞ",88788,378,269,238,30,1,267,2,420,151,157,110
22,"HUNEDOARA",207,88788,,319,"STĂNIJA / Scoala Primara Stanija",3,8797,"BUCEŞ",88788,333,209,194,15,0,206,3,360,151,130,76
22,"HUNEDOARA",207,88868,,320,"BUCUREŞCI / Caminul Cultural",3,8805,"BUCUREŞCI",88868,534,440,366,64,10,432,8,580,140,194,238
22,"HUNEDOARA",207,88868,,321,"CURECHIU / Caminul Cultural",3,8805,"BUCUREŞCI",88868,291,226,194,32,0,225,1,320,94,82,143
22,"HUNEDOARA",207,88868,,322,"ROVINA / Caminul Cultural",3,8805,"BUCUREŞCI",88868,145,112,89,23,0,110,2,160,48,79,31
22,"HUNEDOARA",207,88868,,323,"MERIŞOR / Caminul Cultural",3,8805,"BUCUREŞCI",88868,80,72,56,13,3,70,2,100,28,38,32
22,"HUNEDOARA",207,88868,,324,"ŞESURI / Caminul Cultural",3,8805,"BUCUREŞCI",88868,364,303,271,29,3,301,2,400,97,77,224
22,"HUNEDOARA",207,88920,,325,"BULZEŞTII DE SUS / PRIMARIA BULZESTII DE SUS  SALA DE SEDINTA",3,8811,"BULZEŞTII DE SUS",88920,152,128,87,41,0,128,0,170,42,87,41
22,"HUNEDOARA",207,88920,,326,"BULZEŞTII DE JOS / SCOALA PRIMARA BULZESTII DE JOS",3,8811,"BULZEŞTII DE SUS",88920,101,71,56,15,0,71,0,120,49,49,22
22,"HUNEDOARA",207,89026,,327,"BUNILA / Căminul cultural Bunila",3,8821,"BUNILA",89026,66,62,35,27,0,61,1,80,18,34,27
22,"HUNEDOARA",207,89026,,328,"CERNIŞOARA FLORESE / cladire dispensar medical Cernisoara Florese",3,8821,"BUNILA",89026,162,118,92,26,0,118,0,180,62,71,47
22,"HUNEDOARA",207,89026,,329,"POIENIŢA VOINII / Caminul cultural Poienita Voinii",3,8821,"BUNILA",89026,72,84,52,29,3,83,1,100,16,29,54
22,"HUNEDOARA",207,89080,,330,"BURJUC / Camin cultural Burjuc",3,8827,"BURJUC",89080,139,120,83,37,0,120,0,160,40,72,48
22,"HUNEDOARA",207,89080,,331,"TĂTĂRĂŞTI / Camin cultural  Tătărăşti",3,8827,"BURJUC",89080,154,112,84,27,1,109,3,170,58,36,73
22,"HUNEDOARA",207,89080,,332,"TISA / Camin cultural Tisa",3,8827,"BURJUC",89080,100,83,50,33,0,81,2,110,27,49,32
22,"HUNEDOARA",207,89080,,333,"GLODGHILEŞTI / Şcoala  primara Glodghileşti",3,8827,"BURJUC",89080,164,117,100,17,0,116,1,180,63,73,43
22,"HUNEDOARA",207,89080,,334,"BRĂDĂŢEL / Şcoala  primara Brădăţel",3,8827,"BURJUC",89080,138,83,68,15,0,83,0,150,67,47,36
22,"HUNEDOARA",207,86749,,335,"CÂRJIŢI / Căminul cultural Cîrjiţi",3,8834,"CÂRJIŢI",86749,104,90,55,33,2,90,0,120,30,33,57
22,"HUNEDOARA",207,86749,,336,"CHERGHEŞ / Căminul cultural Chergheş",3,8834,"CÂRJIŢI",86749,74,51,39,12,0,50,1,90,39,16,34
22,"HUNEDOARA",207,86749,,337,"POPEŞTI / Căminul cultural Popeşti",3,8834,"CÂRJIŢI",86749,121,103,80,23,0,102,1,130,27,49,53
22,"HUNEDOARA",207,86749,,338,"ALMAŞU SEC / Căminul cultural Almaşu Sec",3,8834,"CÂRJIŢI",86749,159,171,118,53,0,170,1,200,29,41,129
22,"HUNEDOARA",207,86749,,339,"COZIA / Căminul cultural Cozia",3,8834,"CÂRJIŢI",86749,128,101,73,28,0,101,0,140,39,30,71
22,"HUNEDOARA",207,89151,,340,"CERBĂL / Casa Comunală Cerbăl-Sala de Şedinţă a Consiliului local Cerbăl",3,8840,"CERBĂL",89151,181,159,130,29,0,159,0,200,41,56,103
22,"HUNEDOARA",207,89151,,341,"FEREGI / Şcoala primară Feregi",3,8840,"CERBĂL",89151,137,102,83,19,0,101,1,150,48,44,57
22,"HUNEDOARA",207,89151,,342,"POIANA RĂCHIŢELII / Şcoala primară Poiana Răchiţelii",3,8840,"CERBĂL",89151,105,105,80,25,0,105,0,120,15,61,44
22,"HUNEDOARA",207,89240,,343,"CERTEJU DE SUS / Caminul cultural",3,8849,"CERTEJU DE SUS",89240,1268,836,755,73,8,832,4,1400,564,335,497
22,"HUNEDOARA",207,89240,,344,"HONDOL / Caminul cultural",3,8849,"CERTEJU DE SUS",89240,444,332,285,44,3,328,4,480,148,143,185
22,"HUNEDOARA",207,89240,,345,"BOCŞA MICĂ / Scoala Generala Bocşa Mică",3,8849,"CERTEJU DE SUS",89240,96,70,52,17,1,70,0,110,40,21,49
22,"HUNEDOARA",207,89240,,346,"SĂCĂRÎMB / Caminul cultural",3,8849,"CERTEJU DE SUS",89240,147,115,79,36,0,114,1,160,45,47,67
22,"HUNEDOARA",207,89240,,347,"MĂGURA-TOPLIŢA / Scoala Generala",3,8849,"CERTEJU DE SUS",89240,82,86,60,24,2,84,2,100,14,44,40
22,"HUNEDOARA",207,89240,,348,"TOPLIŢA MUREŞULUI / Scoala Generala",3,8849,"CERTEJU DE SUS",89240,74,82,48,34,0,80,2,90,8,15,65
22,"HUNEDOARA",207,89240,,349,"NOJAG / Scoala Generala",3,8849,"CERTEJU DE SUS",89240,222,156,125,31,0,155,1,240,84,76,79
22,"HUNEDOARA",207,89240,,350,"VĂRMAGA / Scoala Generala",3,8849,"CERTEJU DE SUS",89240,264,229,158,70,1,228,1,290,61,108,120
22,"HUNEDOARA",207,87362,,351,"ZDRAPŢI / Caminul Cultural",3,8859,"CRIŞCIOR",87362,755,519,470,49,0,515,4,830,311,238,277
22,"HUNEDOARA",207,87362,,352,"CRIŞCIOR / Scoala Generala nr 1 Crişcior",3,8859,"CRIŞCIOR",87362,1393,1035,934,99,2,1020,15,1530,495,440,580
22,"HUNEDOARA",207,87362,,353,"CRIŞCIOR / Liceul Tehnologic Crişan Crişcior",3,8859,"CRIŞCIOR",87362,1279,904,821,81,2,893,11,1400,496,407,486
22,"HUNEDOARA",207,89348,,354,"DENSUŞ / Scoala Gimnaziala Densus",3,8864,"DENSUŞ",89348,514,414,340,70,4,408,6,560,146,213,195
22,"HUNEDOARA",207,89348,,355,"PEŞTEANA / Caminul Cultural Pesteana",3,8864,"DENSUŞ",89348,308,257,219,36,2,255,2,330,73,138,117
22,"HUNEDOARA",207,89348,,356,"PEŞTENIŢA / Scoala primara Pestenita",3,8864,"DENSUŞ",89348,227,159,147,12,0,159,0,250,91,51,108
22,"HUNEDOARA",207,89348,,357,"ŞTEI / Caminul Cultural Stei",3,8864,"DENSUŞ",89348,161,152,118,30,4,151,1,180,28,108,43
22,"HUNEDOARA",207,89348,,358,"POIENI / Scoala Primara Poieni",3,8864,"DENSUŞ",89348,79,72,57,13,2,71,1,100,28,27,44
22,"HUNEDOARA",207,89428,,359,"DOBRA / CĂMINUL  CULTURAL  DOBRA",3,8872,"DOBRA",89428,1332,1025,847,161,17,1008,17,1450,425,512,496
22,"HUNEDOARA",207,89428,,360,"LĂPUŞNIC / CĂMINUL  CULTURAL  LAPUSNIC",3,8872,"DOBRA",89428,408,291,231,51,9,288,3,450,159,124,164
22,"HUNEDOARA",207,89428,,361,"RĂDULEŞTI / CAMINUL CULTURAL RADULESTI",3,8872,"DOBRA",89428,176,148,114,23,11,146,2,200,52,67,79
22,"HUNEDOARA",207,89428,,362,"STÎNCEŞTI / CĂMINUL  CULTURAL  STANCESTI",3,8872,"DOBRA",89428,107,81,60,20,1,81,0,120,39,53,28
22,"HUNEDOARA",207,89428,,363,"ROŞCANI / SCOALA GENERALA ROSCANI",3,8872,"DOBRA",89428,582,476,383,74,19,473,3,640,164,225,248
22,"HUNEDOARA",207,89428,,364,"PANC / CĂMINUL CULTURAL PANC",3,8872,"DOBRA",89428,164,124,99,25,0,122,2,190,66,59,63
22,"HUNEDOARA",207,91731,,365,"GENERAL BERTHELOT / SALA DE SEDINTE CONSILIUL LOCAL",3,8886,"GENERAL BERTHELOT",91731,552,391,351,37,3,389,2,600,209,173,216
22,"HUNEDOARA",207,91731,,366,"TUŞTEA / SCOALA PRIMARA TUSTEA",3,8886,"GENERAL BERTHELOT",91731,236,176,152,23,1,175,1,271,95,76,99
22,"HUNEDOARA",207,86883,,367,"GHELARI / PRIMARIA GHELARI",3,8892,"GHELARI",86883,659,458,408,43,7,455,3,710,252,240,215
22,"HUNEDOARA",207,86883,,368,"GHELARI / CLUB MINERUL",3,8892,"GHELARI",86883,916,463,432,24,7,458,5,970,507,277,181
22,"HUNEDOARA",207,86883,,369,"RUDA / CAMIN CULTURAL",3,8892,"GHELARI",86883,142,102,86,16,0,100,2,160,58,70,30
22,"HUNEDOARA",207,86883,,370,"PLOP / MAGAZIN ABC",3,8892,"GHELARI",86883,25,35,11,23,1,35,0,40,5,28,7
22,"HUNEDOARA",207,86883,,371,"GOVĂJDIA / DISPENSAR",3,8892,"GHELARI",86883,82,77,38,38,1,77,0,100,23,30,47
22,"HUNEDOARA",207,89687,,372,"GURASADA / SALĂ DE ŞEDINŢE PRIMARIA COMUNEI GURASADA",3,8897,"GURASADA",89687,655,480,390,90,0,476,4,710,230,278,198
22,"HUNEDOARA",207,89687,,373,"CÎMPURI-SURDUC / CĂMIN CULTURAL CÎMPURI-SURDUC",3,8897,"GURASADA",89687,385,279,207,72,0,275,4,418,139,165,110
22,"HUNEDOARA",207,89687,,374,"BOIU DE SUS / CĂMIN CULTURAL BOIU DE SUS",3,8897,"GURASADA",89687,120,85,72,13,0,85,0,141,56,58,27
22,"HUNEDOARA",207,89687,,375,"CĂRMĂZĂNEŞTI / ŞCOALA GENERALĂ CĂRMĂZĂNEŞTI",3,8897,"GURASADA",89687,116,79,66,13,0,78,1,130,51,56,22
22,"HUNEDOARA",207,89801,,376,"HĂRĂU / Căminul cultural Hărău",3,8909,"HĂRĂU",89801,633,436,373,63,0,432,4,700,264,174,258
22,"HUNEDOARA",207,89801,,377,"BÎRSĂU / Şcoala Generală Bîrsău",3,8909,"HĂRĂU",89801,441,333,275,54,4,329,4,480,147,117,212
22,"HUNEDOARA",207,89801,,378,"CHIMINDIA / Şcoala Generală Chimindia",3,8909,"HĂRĂU",89801,303,257,217,40,0,251,6,330,73,147,104
22,"HUNEDOARA",207,89801,,379,"BANPOTOC / Căminul cultural Banpotoc",3,8909,"HĂRĂU",89801,378,299,260,39,0,294,5,420,121,120,174
22,"HUNEDOARA",207,89856,,380,"ILIA / CĂMINUL CULTURAL  DIN ILIA",3,8914,"ILIA",89856,1473,1165,983,151,31,1148,17,1600,435,434,714
22,"HUNEDOARA",207,89856,,381,"BRETEA MUREŞANĂ / CĂMINUL CULTURAL DIN BRETEA MUREŞANĂ",3,8914,"ILIA",89856,522,447,347,88,12,444,2,570,123,197,247
22,"HUNEDOARA",207,89856,,382,"SÎRBI / CĂMINUL CULTURAL DIN SÎRBI",3,8914,"ILIA",89856,375,304,259,37,8,299,5,417,113,94,205
22,"HUNEDOARA",207,89856,,383,"VALEA LUNGĂ / CĂMINUL CULTURAL DINVALEA LUNGĂ",3,8914,"ILIA",89856,101,111,76,35,0,111,0,120,9,37,74
22,"HUNEDOARA",207,89856,,384,"BACEA / CĂMINUL CULTURAL DIN BACEA",3,8914,"ILIA",89856,309,210,185,25,0,203,7,342,132,58,145
22,"HUNEDOARA",207,89856,,385,"BRÎZNIC / CĂMINUL CULTURAL DIN BRÎZNIC",3,8914,"ILIA",89856,201,190,134,49,7,187,3,230,40,59,128
22,"HUNEDOARA",207,89856,,386,"SĂCĂMAŞ / CĂMINUL CULTURAL DIN SĂCĂMAŞ",3,8914,"ILIA",89856,190,191,138,45,8,189,2,210,19,66,123
22,"HUNEDOARA",207,89954,,387,"LĂPUGIU DE JOS / CĂMINUL CULTURAL LĂPUGIU DE JOS",3,8924,"LĂPUGIU DE JOS",89954,399,332,221,104,7,330,2,440,108,144,186
22,"HUNEDOARA",207,89954,,388,"OHABA / CĂMINUL CULTURAL OHABA",3,8924,"LĂPUGIU DE JOS",89954,417,290,199,91,0,287,3,460,170,116,171
22,"HUNEDOARA",207,89954,,389,"LĂPUGIU DE SUS / CĂMINUL CULTURAL LĂPUGIU DE SUS",3,8924,"LĂPUGIU DE JOS",89954,324,197,168,27,2,197,0,360,163,116,81
22,"HUNEDOARA",207,90066,,390,"LELESE / Primaria comunei Lelese, sala Biblionet",3,8935,"LELESE",90066,161,118,94,23,1,117,1,181,63,84,33
22,"HUNEDOARA",207,90066,,391,"CERIŞOR / CĂMINUL CULTURAL CERIŞOR",3,8935,"LELESE",90066,97,91,67,23,1,90,1,110,19,80,10
22,"HUNEDOARA",207,90066,,392,"RUNCU MARE / Camin Cultural Runcu Mare",3,8935,"LELESE",90066,104,86,74,12,0,85,1,120,34,47,38
22,"HUNEDOARA",207,90119,,393,"LUNCA CERNII DE JOS / Şcoala Gimnazială Lunca Cernii de Jos",3,8940,"LUNCA CERNII DE JOS",90119,393,289,255,34,0,289,0,430,141,98,191
22,"HUNEDOARA",207,90119,,394,"NEGOIU / Cămin cultural Negoiu",3,8940,"LUNCA CERNII DE JOS",90119,162,99,87,12,0,99,0,180,81,38,61
22,"HUNEDOARA",207,90119,,395,"MERIA / Cămin cultural Meria",3,8940,"LUNCA CERNII DE JOS",90119,241,166,145,21,0,166,0,270,104,64,102
22,"HUNEDOARA",207,90208,,396,"LUNCOIU DE JOS / CAMIN UL CULTURAL LUNCOIU DE JOS",3,8949,"LUNCOIU DE JOS",90208,893,633,576,57,0,631,2,980,347,305,326
22,"HUNEDOARA",207,90208,,397,"LUNCOIU DE SUS / CAMINUL CULTURAL LUNCOIU DE SUS",3,8949,"LUNCOIU DE JOS",90208,670,489,441,48,0,486,3,740,251,235,251
22,"HUNEDOARA",207,90262,,398,"MĂRTINEŞTI / Scoala primara Mărtineşti",3,8955,"MĂRTINEŞTI",90262,224,182,130,52,0,182,0,240,58,81,101
22,"HUNEDOARA",207,90262,,399,"DÎNCU MARE / SCOALA PRIMARA DINCU MARE",3,8955,"MĂRTINEŞTI",90262,204,189,146,42,1,188,1,228,39,103,85
22,"HUNEDOARA",207,90262,,400,"DÎNCU MIC / Camin Cultural Dâncu Mic",3,8955,"MĂRTINEŞTI",90262,98,113,62,49,2,112,1,136,23,61,51
22,"HUNEDOARA",207,90262,,401,"JELEDINŢI / Camin Cultural Jeledinţi",3,8955,"MĂRTINEŞTI",90262,207,132,105,27,0,131,1,205,73,34,97
22,"HUNEDOARA",207,90262,,402,"TĂMĂŞASA / Camin Cultural Tămăşasa",3,8955,"MĂRTINEŞTI",90262,97,73,56,17,0,71,2,109,36,30,41
22,"HUNEDOARA",207,90342,,403,"ORĂŞTIOARA DE SUS / CAMIN CULTURAL ORASTIOARA DE SUS",3,8963,"ORĂŞTIOARA DE SUS",90342,420,309,262,46,1,309,0,460,151,97,212
22,"HUNEDOARA",207,90342,,404,"BUCIUM / CAMIN CULTURAL BUCIUM",3,8963,"ORĂŞTIOARA DE SUS",90342,275,232,187,43,2,231,1,310,78,84,147
22,"HUNEDOARA",207,90342,,405,"LUDEŞTII DE JOS / SCOALA PRIMARA LUDESTII DE JOS",3,8963,"ORĂŞTIOARA DE SUS",90342,270,181,147,34,0,177,4,300,119,57,120
22,"HUNEDOARA",207,90342,,406,"COSTEŞTI / CAMIN CULTURAL COSTESTI",3,8963,"ORĂŞTIOARA DE SUS",90342,424,328,282,46,0,326,2,460,132,120,206
22,"HUNEDOARA",207,90342,,407,"GRĂDIŞTEA DE MUNTE / SCOALA PRIMARA GRADISTE",3,8963,"ORĂŞTIOARA DE SUS",90342,144,101,78,23,0,101,0,160,59,45,56
22,"HUNEDOARA",207,90342,,408,"OCOLIŞU MIC / SCOALA PRIMARA OCOLISU MIC",3,8963,"ORĂŞTIOARA DE SUS",90342,295,224,190,31,3,223,1,318,94,52,171
22,"HUNEDOARA",207,90431,,409,"PESTIŞU MIC / ŞCOALA PRIMARĂ PESTIŞU MIC",3,8972,"PESTIŞU MIC",90431,170,136,122,13,1,134,2,190,54,56,78
22,"HUNEDOARA",207,90431,,410,"ALMAŞU MIC / CĂMINUL CULTURAL ALMAŞU MIC",3,8972,"PESTIŞU MIC",90431,55,68,39,29,0,68,0,80,12,21,47
22,"HUNEDOARA",207,90431,,411,"CIULPĂZ / CĂMINUL  CULTURAL  CIULPĂZ",3,8972,"PESTIŞU MIC",90431,100,76,60,16,0,76,0,110,34,37,39
22,"HUNEDOARA",207,90431,,412,"JOSANI / CĂMINUL CULTURAL JOSANI",3,8972,"PESTIŞU MIC",90431,178,154,126,28,0,152,2,191,37,48,104
22,"HUNEDOARA",207,90431,,413,"MĂNERĂU / CĂMINUL CULTURAL MĂNERĂU",3,8972,"PESTIŞU MIC",90431,250,166,147,16,3,164,2,259,93,99,65
22,"HUNEDOARA",207,90431,,414,"NANDRU / CĂMINUL CULTURAL NANDRU",3,8972,"PESTIŞU MIC",90431,147,120,96,24,0,119,1,160,40,47,72
22,"HUNEDOARA",207,90431,,415,"VALEA NANDRULUI / CĂMINUL CULTURAL VALEA NANDRULUI",3,8972,"PESTIŞU MIC",90431,129,105,89,15,1,103,2,151,46,54,49
22,"HUNEDOARA",207,90538,,416,"PUI / Şcoala Gimnazială Pui",3,8982,"PUI",90538,699,461,399,62,0,453,8,770,309,164,289
22,"HUNEDOARA",207,90538,,417,"RUŞOR / Şcoala primară Ruşor",3,8982,"PUI",90538,263,203,179,19,5,198,5,290,87,77,121
22,"HUNEDOARA",207,90538,,418,"BĂIEŞTI / Şcoala Primară Băieşti",3,8982,"PUI",90538,193,136,107,29,0,135,1,210,74,48,87
22,"HUNEDOARA",207,90538,,419,"GALAŢI / Şcoala primară Galaţi",3,8982,"PUI",90538,394,302,258,38,6,298,4,430,128,81,217
22,"HUNEDOARA",207,90538,,420,"FIZEŞTI / Căminul Cultural Fizeşti",3,8982,"PUI",90538,285,196,183,13,0,194,2,310,114,98,96
22,"HUNEDOARA",207,90538,,421,"ŞEREL / Căminul Cultural Şerel",3,8982,"PUI",90538,373,252,217,35,0,250,2,410,158,90,160
22,"HUNEDOARA",207,90538,,422,"RÎU BĂRBAT / Cămin cultural Rîu-Bărbat",3,8982,"PUI",90538,157,143,97,26,20,143,0,180,37,20,123
22,"HUNEDOARA",207,90538,,423,"HOBIŢA / Căminul Cultural Hobiţa",3,8982,"PUI",90538,143,129,108,16,5,128,1,160,31,32,96
22,"HUNEDOARA",207,90538,,424,"URIC / Căminul Cultural Uric",3,8982,"PUI",90538,232,193,173,16,4,193,0,250,57,78,115
22,"HUNEDOARA",207,90538,,425,"PONOR / Şcoala primară Ponor",3,8982,"PUI",90538,367,236,212,22,2,231,5,400,164,83,148
22,"HUNEDOARA",207,90538,,426,"OHABA-PONOR / Căminul Cultural Ohaba Ponor",3,8982,"PUI",90538,232,152,136,12,4,150,2,260,108,44,106
22,"HUNEDOARA",207,90538,,427,"FEDERI / Căminul Cultural Federi",3,8982,"PUI",90538,210,116,107,9,0,113,3,231,115,26,87
22,"HUNEDOARA",207,90663,,428,"BOIU / SCOALA PRIMARA",3,9003,"RAPOLTU MARE",90663,135,94,73,21,0,94,0,150,56,34,60
22,"HUNEDOARA",207,90663,,429,"BOBÎLNA / CAMIN CULTURAL",3,9003,"RAPOLTU MARE",90663,401,267,232,34,1,265,2,440,173,113,152
22,"HUNEDOARA",207,90663,,430,"FOLT / CAMIN CULTURAL",3,9003,"RAPOLTU MARE",90663,144,116,89,27,0,114,2,160,44,44,70
22,"HUNEDOARA",207,90663,,431,"RAPOLŢEL / CAMIN CULTURAL",3,9003,"RAPOLTU MARE",90663,187,139,107,32,0,137,2,210,71,44,93
22,"HUNEDOARA",207,90663,,432,"RAPOLTU MARE / PRIMARIA RAPOLTU MARE",3,9003,"RAPOLTU MARE",90663,771,503,455,45,3,498,5,850,347,193,305
22,"HUNEDOARA",207,90725,,433,"RĂCHITOVA / CAMINUL CULTURAL RĂCHITOVA",3,8995,"RĂCHITOVA",90725,554,391,348,43,0,390,1,600,209,171,219
22,"HUNEDOARA",207,90725,,434,"BOIŢA / SCOALA PRIMARA BOIŢA",3,8995,"RĂCHITOVA",90725,391,313,266,47,0,312,1,430,117,96,216
22,"HUNEDOARA",207,90725,,435,"VĂLIOARA / SCOALA PRIMARA VĂLIOARA",3,8995,"RĂCHITOVA",90725,200,168,135,33,0,168,0,220,52,71,97
22,"HUNEDOARA",207,90878,,436,"RÂU DE MORI / Şcoala Generală Rîu de Mori",3,9009,"RÂU DE MORI",90878,848,633,556,75,2,627,6,930,297,178,449
22,"HUNEDOARA",207,90878,,437,"CLOPOTIVA / Şcoala Primară Clopotiva",3,9009,"RÂU DE MORI",90878,694,521,467,51,3,514,7,760,239,172,342
22,"HUNEDOARA",207,90878,,438,"OSTROV / Şcoala Primară Ostrov",3,9009,"RÂU DE MORI",90878,406,329,288,38,3,327,2,440,111,100,227
22,"HUNEDOARA",207,90878,,439,"VALEA DÎLJII / Şcoala Primară Valea Dîljii",3,9009,"RÂU DE MORI",90878,217,174,155,16,3,171,3,240,66,31,140
22,"HUNEDOARA",207,90878,,440,"UNCIUC / Şcoala Primară Unciuc",3,9009,"RÂU DE MORI",90878,175,156,129,26,1,155,1,200,44,45,110
22,"HUNEDOARA",207,90878,,441,"SIBIŞEL / Şcoala Primară Sibişel",3,9009,"RÂU DE MORI",90878,300,233,201,30,2,230,3,330,97,51,179
22,"HUNEDOARA",207,90805,,442,"RIBIŢA / CĂMINUL CULTURAL RIBIŢA",3,9021,"RIBIŢA",90805,508,396,359,31,6,395,1,530,134,150,245
22,"HUNEDOARA",207,90805,,443,"CRIŞAN / CĂMINUL CULTURAL CRIŞANCladire parter",3,9021,"RIBIŢA",90805,372,314,277,30,7,310,4,400,86,171,139
22,"HUNEDOARA",207,90805,,444,"DUMBRAVA DE JOS / ŞCOALA PRIMARĂ DUMBRAVA DE JOS",3,9021,"RIBIŢA",90805,154,115,99,14,2,115,0,170,55,80,35
22,"HUNEDOARA",207,90805,,445,"DUMBRAVA DE SUS / ŞCOALA PRIMARĂ DUMBRAVA DE SUS",3,9021,"RIBIŢA",90805,56,66,34,32,0,64,2,90,24,52,12
22,"HUNEDOARA",207,90805,,446,"UIBĂREŞTI / CĂMINUL CULTURAL UIBĂREŞTI",3,9021,"RIBIŢA",90805,63,58,42,16,0,57,1,80,22,34,23
22,"HUNEDOARA",207,90994,,447,"ROMOS / SCOALA GENERALA ROMOS CLASELE I-IV",3,9028,"ROMOS",90994,978,666,604,62,0,657,9,1070,404,169,488
22,"HUNEDOARA",207,90994,,448,"ROMOŞEL / SCOALA GENERALA ROMOSEL CLASELE I-IV",3,9028,"ROMOS",90994,620,425,388,37,0,422,3,680,255,77,345
22,"HUNEDOARA",207,90994,,449,"VAIDEI / SCOALA GENERALA VAIDEI CLASELE I-IV",3,9028,"ROMOS",90994,551,363,297,66,0,360,3,600,237,92,268
22,"HUNEDOARA",207,90994,,450,"PIŞCHINŢI / SCOALA GENERALA PISCHINTI CLASELE I-IV",3,9028,"ROMOS",90994,186,154,131,23,0,152,2,210,56,62,90
22,"HUNEDOARA",207,91054,,451,"SARMIZEGETUSA / CAMINUL CULTURAL SARMIZEGETUSA",3,9056,"SARMIZEGETUSA",91054,477,459,357,85,17,455,4,520,61,177,278
22,"HUNEDOARA",207,91054,,452,"BREAZOVA / SCOALA PRIMARA BREAZOVA",3,9056,"SARMIZEGETUSA",91054,153,137,118,19,0,134,3,170,33,65,69
22,"HUNEDOARA",207,91054,,453,"HOBIŢA-GRĂDIŞTE / SCOALA PRIMARA HOBITA-GRADISTE",3,9056,"SARMIZEGETUSA",91054,117,118,95,14,9,117,1,130,12,21,96
22,"HUNEDOARA",207,91054,,454,"PĂUCINEŞTI / CAMINUL CULTURAL PAUCINESTI",3,9056,"SARMIZEGETUSA",91054,162,155,126,22,7,155,0,180,25,68,87
22,"HUNEDOARA",207,91054,,455,"ZEICANI / CAMINUL CULTURAL ZEICANI",3,9056,"SARMIZEGETUSA",91054,121,121,84,35,2,119,2,140,19,41,78
22,"HUNEDOARA",207,91116,,456,"SĂLAŞU DE SUS / Birou agricol",3,9034,"SĂLAŞU DE SUS",91116,447,354,267,84,3,351,3,490,136,161,190
22,"HUNEDOARA",207,91116,,457,"SĂLAŞU DE JOS / Şcoala generală Sălaşu de Jos",3,9034,"SĂLAŞU DE SUS",91116,191,150,133,16,1,148,2,210,60,97,51
22,"HUNEDOARA",207,91116,,458,"OHABA DE SUB PIATRĂ / Şcoala generală Ohaba de sub Piatră",3,9034,"SĂLAŞU DE SUS",91116,171,140,106,33,1,140,0,190,50,59,81
22,"HUNEDOARA",207,91116,,459,"RÎU ALB / Şcoala generală Rîu Alb",3,9034,"SĂLAŞU DE SUS",91116,162,139,116,22,1,139,0,179,40,103,36
22,"HUNEDOARA",207,91116,,460,"COROIEŞTI / Cămin cultural Coroieşti",3,9034,"SĂLAŞU DE SUS",91116,162,133,115,18,0,132,1,180,47,100,32
22,"HUNEDOARA",207,91116,,461,"PAROŞ / Şcoala generală Paroş",3,9034,"SĂLAŞU DE SUS",91116,290,215,190,23,2,214,1,310,95,122,92
22,"HUNEDOARA",207,91116,,462,"NUCŞOARA / Şcoala generală Nucşoara",3,9034,"SĂLAŞU DE SUS",91116,251,155,136,19,0,154,1,270,115,64,90
22,"HUNEDOARA",207,91116,,463,"MĂLĂIEŞTI / Cămin cultural Mălăieşti",3,9034,"SĂLAŞU DE SUS",91116,122,113,102,11,0,111,2,140,27,55,56
22,"HUNEDOARA",207,91116,,464,"ZĂVOI / Cămin cultural Zăvoi",3,9034,"SĂLAŞU DE SUS",91116,103,88,66,22,0,88,0,120,32,41,47
22,"HUNEDOARA",207,91116,,465,"RÎU MIC / Şcoala generală Rîu Mic",3,9034,"SĂLAŞU DE SUS",91116,138,123,109,14,0,123,0,150,27,65,58
22,"HUNEDOARA",207,91232,,466,"SÂNTĂMĂRIA-ORLEA / Căminul Cultural Sîntămăria-Orlea",3,9046,"SÂNTĂMĂRIA-ORLEA",91232,606,435,387,48,0,429,6,660,225,187,242
22,"HUNEDOARA",207,91232,,467,"SUBCETATE / Şcoala Primară Subcetate",3,9046,"SÂNTĂMĂRIA-ORLEA",91232,475,337,303,32,2,334,3,520,183,183,151
22,"HUNEDOARA",207,91232,,468,"BUCIUM-ORLEA / Căminul Cultural Bucium",3,9046,"SÂNTĂMĂRIA-ORLEA",91232,172,132,116,15,1,131,1,190,58,68,63
22,"HUNEDOARA",207,91232,,469,"BALOMIR / Căminul Cultural Balomir",3,9046,"SÂNTĂMĂRIA-ORLEA",91232,283,200,189,11,0,198,2,312,112,103,95
22,"HUNEDOARA",207,91232,,470,"CIOPEIA / Şcoala Primară Ciopeia",3,9046,"SÂNTĂMĂRIA-ORLEA",91232,332,200,178,20,2,200,0,360,160,138,62
22,"HUNEDOARA",207,91232,,471,"BĂRĂŞTII HAŢEGULUI / Şcoala Primară Bărăştii-Haţegului",3,9046,"SÂNTĂMĂRIA-ORLEA",91232,323,229,204,23,2,229,0,360,131,93,136
22,"HUNEDOARA",207,91232,,472,"SĂCEL / Şcoala  Săcel",3,9046,"SÂNTĂMĂRIA-ORLEA",91232,230,137,130,7,0,134,3,250,113,50,84
22,"HUNEDOARA",207,91232,,473,"SÎNPETRU / Căminul Cultural Sînpetru",3,9046,"SÂNTĂMĂRIA-ORLEA",91232,213,167,148,19,0,166,1,240,73,91,75
22,"HUNEDOARA",207,91330,,474,"ŞOIMUŞ / Cămin cultural,sat Şoimuşnr. 310",3,9062,"ŞOIMUŞ",91330,1106,940,737,203,0,927,13,1160,220,366,561
22,"HUNEDOARA",207,91330,,475,"BĂLATA / Cămin cultural,sat Bălatanr. 37",3,9062,"ŞOIMUŞ",91330,351,304,234,69,1,300,4,390,86,117,183
22,"HUNEDOARA",207,91330,,476,"BOHOLŢ / Cămin cultural sat Boholt, nr. 39",3,9062,"ŞOIMUŞ",91330,275,278,197,77,4,275,3,300,22,103,172
22,"HUNEDOARA",207,91330,,477,"FORNĂDIA / Cămin cultural sat Fornădia, nr. 71",3,9062,"ŞOIMUŞ",91330,190,247,136,109,2,244,3,260,12,126,118
22,"HUNEDOARA",207,91330,,478,"SULIGHETE / Şcoala Primară sat Sulighete nr. 88",3,9062,"ŞOIMUŞ",91330,237,269,178,86,5,265,4,300,31,111,154
22,"HUNEDOARA",207,91330,,479,"PĂULIŞ / Cămin cultural , sat Păuliş, nr. 61",3,9062,"ŞOIMUŞ",91330,569,525,401,116,8,518,7,620,95,214,304
22,"HUNEDOARA",207,91330,,480,"CHIŞCĂDAGA / Cămin cultural sat Chişcădaga, nr. 94",3,9062,"ŞOIMUŞ",91330,304,325,237,88,0,320,5,500,175,103,217
22,"HUNEDOARA",207,86936,,481,"TELIUCU INFERIOR / PRIMARIA COMUNEI TELIUCU INFERIOR",3,9073,"TELIUCU INFERIOR",86936,1217,812,723,81,8,800,12,1340,528,356,444
22,"HUNEDOARA",207,86936,,482,"CINCIŞ-CERNA / SCOALA PRIMARA CINCIŞ-CERNA",3,9073,"TELIUCU INFERIOR",86936,575,413,368,44,1,411,2,630,217,194,217
22,"HUNEDOARA",207,86936,,483,"IZVOARELE / Camin Cultural",3,9073,"TELIUCU INFERIOR",86936,90,78,55,23,0,78,0,110,32,41,37
22,"HUNEDOARA",207,86936,,484,"TELIUCU SUPERIOR / Camin Cultural  si Recreativ Plosca",3,9073,"TELIUCU INFERIOR",86936,263,182,158,24,0,180,2,290,108,67,113
22,"HUNEDOARA",207,91447,,485,"LIVADA / CĂMIN CULTURAL",3,9078,"TOMEŞTI",91447,95,59,51,8,0,59,0,110,51,34,25
22,"HUNEDOARA",207,91447,,486,"TOMEŞTI / Căminul Cultural Tomeşti",3,9078,"TOMEŞTI",91447,471,318,293,25,0,317,1,520,202,129,188
22,"HUNEDOARA",207,91447,,487,"DOBROŢ / CĂMIN CULTURAL DOBROŢ",3,9078,"TOMEŞTI",91447,352,266,235,31,0,264,2,380,114,152,112
22,"HUNEDOARA",207,91535,,488,"TOPLIŢA / CAMINUL  CULTURAL  TOPLITA",3,9087,"TOPLIŢA",91535,146,165,95,67,3,165,0,180,15,60,105
22,"HUNEDOARA",207,91535,,489,"HĂŞDĂU / SCOALA  PRIMARA  HASDAU",3,9087,"TOPLIŢA",91535,312,230,211,19,0,230,0,339,109,103,127
22,"HUNEDOARA",207,91535,,490,"DĂBÎCA / CAMINUL  CULTURAL  DABICA",3,9087,"TOPLIŢA",91535,144,112,94,18,0,111,1,141,29,50,61
22,"HUNEDOARA",207,91535,,491,"DEALU MIC / CAMINUL  CULTURAL  DEALU  MIC",3,9087,"TOPLIŢA",91535,46,45,26,19,0,44,1,60,15,29,15
22,"HUNEDOARA",207,91535,,492,"VĂLARI / CASA PARTICULARA  NR. 3 (MUNTEAN ROZICA)",3,9087,"TOPLIŢA",91535,34,45,25,20,0,45,0,50,5,24,21
22,"HUNEDOARA",207,91624,,493,"TOTEŞTI / Camin Cultural Totesti",3,9096,"TOTEŞTI",91624,360,316,268,40,8,313,3,401,85,216,97
22,"HUNEDOARA",207,91624,,494,"CÎRNEŞTI / Scoala cls.I-IV Cirnesti",3,9096,"TOTEŞTI",91624,386,304,262,36,6,304,0,420,116,182,122
22,"HUNEDOARA",207,91624,,495,"PĂCLIŞA / Scoala cls.I-IV Paclisa",3,9096,"TOTEŞTI",91624,512,378,304,59,15,366,12,560,182,214,152
22,"HUNEDOARA",207,91624,,496,"REEA / Scoala cls. I-IV Reea",3,9096,"TOTEŞTI",91624,340,261,220,37,4,259,2,370,109,187,72
22,"HUNEDOARA",207,91688,,497,"TURDAŞ / Căminul cultural TURDAŞ",3,9102,"TURDAŞ",91688,409,313,273,40,0,308,5,450,137,110,198
22,"HUNEDOARA",207,91688,,498,"PRICAZ / Căminul cultural PRICAZ",3,9102,"TURDAŞ",91688,1032,668,609,56,3,665,3,1130,462,312,353
22,"HUNEDOARA",207,91688,,499,"SPINI / Şcoala primară SPINI",3,9102,"TURDAŞ",91688,252,167,138,28,1,166,1,280,113,57,109
22,"HUNEDOARA",207,91795,,500,"VAŢA DE JOS / SCOALA GIMNAZIALA VAŢA DE JOS",3,9112,"VAŢA DE JOS",91795,937,578,544,34,0,571,7,1020,442,290,281
22,"HUNEDOARA",207,91795,,501,"CĂZĂNEŞTI / ŞCOALA PRIMARA",3,9112,"VAŢA DE JOS",91795,174,111,100,11,0,111,0,200,89,25,86
22,"HUNEDOARA",207,91795,,502,"PRIHODIŞTE / ŞCOALA PRIMARA PRIHODIŞTE",3,9112,"VAŢA DE JOS",91795,354,253,236,17,0,252,1,390,137,158,94
22,"HUNEDOARA",207,91795,,503,"BIRTIN / ŞCOALA PRIMARA",3,9112,"VAŢA DE JOS",91795,235,163,140,23,0,163,0,260,97,70,93
22,"HUNEDOARA",207,91795,,504,"TÎRNAVA DE CRIŞ / ŞCOALA PRIMARA TÎRNAVA DE CRIŞ",3,9112,"VAŢA DE JOS",91795,702,497,463,33,1,492,5,770,273,210,282
22,"HUNEDOARA",207,91795,,505,"OCIU / ŞCOALA PRIMARA OCIU",3,9112,"VAŢA DE JOS",91795,415,260,231,28,1,257,3,450,190,102,155
22,"HUNEDOARA",207,91795,,506,"PRĂVĂLENI / ŞCOALA PRIMARA",3,9112,"VAŢA DE JOS",91795,253,168,154,12,2,166,2,280,112,72,94
22,"HUNEDOARA",207,91795,,507,"CIUNGANI / ŞCOALA PRIMARA",3,9112,"VAŢA DE JOS",91795,216,140,128,12,0,138,2,240,100,63,75
22,"HUNEDOARA",207,91937,,508,"VĂLIŞOARA / Căminul Cultural Vălişoara",3,9107,"VĂLIŞOARA",91937,673,481,405,76,0,477,4,740,259,167,310
22,"HUNEDOARA",207,91937,,509,"DEALU MARE / Căminul Cultural Dealu Mare",3,9107,"VĂLIŞOARA",91937,177,150,106,44,0,143,7,200,50,52,91
22,"HUNEDOARA",207,91937,,510,"SĂLIŞTIOARA / Căminul Cultural Săliştioara",3,9107,"VĂLIŞOARA",91937,251,216,183,33,0,214,2,280,64,70,144
22,"HUNEDOARA",207,91982,,511,"VEŢEL / CĂMINUL CULTURAL VEŢEL",3,9126,"VEŢEL",91982,891,662,538,121,3,651,11,980,318,302,349
22,"HUNEDOARA",207,91982,,512,"MINTIA / CĂMINUL CULTURAL MINTIA",3,9126,"VEŢEL",91982,857,579,519,60,0,575,4,940,361,237,338
22,"HUNEDOARA",207,91982,,513,"LEŞNIC / CĂMINUL CULTURAL LEŞNIC",3,9126,"VEŢEL",91982,457,394,316,78,0,393,1,500,106,201,192
22,"HUNEDOARA",207,91982,,514,"MUNCELU MIC / ŞCOALA PRIMARĂ MUNCELU MIC",3,9126,"VEŢEL",91982,112,77,56,21,0,74,3,131,54,42,32
22,"HUNEDOARA",207,91982,,515,"MUNCELU MARE / CĂMIN CULTURAL MUNCELU MARE",3,9126,"VEŢEL",91982,73,54,38,16,0,53,1,90,36,36,17
22,"HUNEDOARA",207,92097,,516,"VORŢA / Căminul cultural Vorta",3,9137,"VORŢA",92097,142,133,102,31,0,129,4,160,27,59,70
22,"HUNEDOARA",207,92097,,517,"VISCA / Şcoala gimnaziala Visca",3,9137,"VORŢA",92097,319,265,228,37,0,261,4,340,75,78,183
22,"HUNEDOARA",207,92097,,518,"VALEA POIENII / Scoala Primara Valea Poienii",3,9137,"VORŢA",92097,129,94,77,17,0,94,0,150,56,53,41
22,"HUNEDOARA",207,92097,,519,"COAJA / Imobilul nr 9 din satul Coaja",3,9137,"VORŢA",92097,121,88,78,10,0,86,2,140,52,41,45
22,"HUNEDOARA",207,92177,,520,"ZAM / Căminul cultural Zam",3,9145,"ZAM",92177,570,548,338,177,33,544,4,824,276,242,302
22,"HUNEDOARA",207,92177,,521,"POGĂNEŞTI / Şcoala primară Pogăneşti",3,9145,"ZAM",92177,234,157,119,38,0,155,2,250,93,86,69
22,"HUNEDOARA",207,92177,,522,"ALMAŞ-SĂLIŞTE / Căminul cultural Almaş Sălişte",3,9145,"ZAM",92177,136,100,83,17,0,98,2,150,50,32,66
22,"HUNEDOARA",207,92177,,523,"GODINEŞTI / Căminul cultural Godineşti",3,9145,"ZAM",92177,123,83,74,9,0,83,0,140,57,25,58
22,"HUNEDOARA",207,92177,,524,"SĂLCIVA / Căminul cultural Sălciva",3,9145,"ZAM",92177,403,308,240,68,0,306,2,440,132,132,174
23,"IALOMIŢA","#N/A",92658,,1,"SLOBOZIA / Grupul Şcolar ""Alexandru Ioan Cuza""  (Liceul de construcţii),",1,9160,"MUNICIPIUL SLOBOZIA",92658,1498,919,731,39,149,906,13,1640,721,566,340
23,"IALOMIŢA","#N/A",92658,,2,"SLOBOZIA / Grupul Şcolar ""Alexandru Ioan Cuza""  (Liceul de construcţii),",1,9160,"MUNICIPIUL SLOBOZIA",92658,1398,951,778,32,141,938,13,1540,589,559,379
23,"IALOMIŢA","#N/A",92658,,3,"SLOBOZIA / Şcoala Generala nr.3,",1,9160,"MUNICIPIUL SLOBOZIA",92658,1215,885,700,57,128,874,11,1337,452,496,378
23,"IALOMIŢA","#N/A",92658,,4,"SLOBOZIA / Şcoala Generala nr.3,",1,9160,"MUNICIPIUL SLOBOZIA",92658,1014,583,544,39,0,571,12,1118,535,329,242
23,"IALOMIŢA","#N/A",92658,,5,"SLOBOZIA / Colegiul Naţional ,,Mihai Viteazu"" (Liceul de matematica - fizica)",1,9160,"MUNICIPIUL SLOBOZIA",92658,1259,801,737,64,0,793,8,1394,593,445,348
23,"IALOMIŢA","#N/A",92658,,6,"SLOBOZIA / Liceul Pedagogic ,,Matei Basarab"" (Şcoala Normala)",1,9160,"MUNICIPIUL SLOBOZIA",92658,1631,1013,952,61,0,994,19,1791,778,536,458
23,"IALOMIŢA","#N/A",92658,,7,"SLOBOZIA / Muzeul Agriculturii",1,9160,"MUNICIPIUL SLOBOZIA",92658,1693,940,885,53,2,928,12,1870,930,499,429
23,"IALOMIŢA","#N/A",92658,,8,"SLOBOZIA / Şcoala Generala nr.6",1,9160,"MUNICIPIUL SLOBOZIA",92658,1658,907,871,36,0,896,11,1829,922,488,408
23,"IALOMIŢA","#N/A",92658,,9,"SLOBOZIA / Şcoala Generala nr.6",1,9160,"MUNICIPIUL SLOBOZIA",92658,1413,793,737,56,0,783,10,1554,761,460,323
23,"IALOMIŢA","#N/A",92658,,10,"SLOBOZIA / Liceu Tehnologic",1,9160,"MUNICIPIUL SLOBOZIA",92658,1588,911,870,41,0,898,13,1747,836,573,325
23,"IALOMIŢA","#N/A",92658,,11,"SLOBOZIA /  Clubul Tineretului",1,9160,"MUNICIPIUL SLOBOZIA",92658,1123,586,549,37,0,575,11,1235,649,325,250
23,"IALOMIŢA","#N/A",92658,,12,"SLOBOZIA / Seminarul Teologic,",1,9160,"MUNICIPIUL SLOBOZIA",92658,1048,728,629,73,26,719,9,1151,423,392,327
23,"IALOMIŢA","#N/A",92658,,13,"SLOBOZIA / Casa de Cultură Municipală (fostul Cinema ""Galax"")",1,9160,"MUNICIPIUL SLOBOZIA",92658,1493,859,790,68,1,847,12,1646,787,454,393
23,"IALOMIŢA","#N/A",92658,,14,"SLOBOZIA / Liceul ,,Mihai Eminescu"" (Liceul de Chimie)",1,9160,"MUNICIPIUL SLOBOZIA",92658,1199,794,628,54,112,781,13,1329,535,469,312
23,"IALOMIŢA","#N/A",92658,,15,"SLOBOZIA / Şcoala Generala nr.4",1,9160,"MUNICIPIUL SLOBOZIA",92658,1713,1004,944,60,0,990,14,1881,877,520,470
23,"IALOMIŢA","#N/A",92658,,16,"SLOBOZIA / Şcoala Generala nr.4",1,9160,"MUNICIPIUL SLOBOZIA",92658,1577,829,783,46,0,815,14,1733,904,431,384
23,"IALOMIŢA","#N/A",92658,,17,"SLOBOZIA / Grădiniţa cu program prelungit",1,9160,"MUNICIPIUL SLOBOZIA",92658,1653,1048,1008,40,0,1029,19,1818,770,505,524
23,"IALOMIŢA","#N/A",92658,,18,"SLOBOZIA / SCELIF",1,9160,"MUNICIPIUL SLOBOZIA",92658,1534,922,872,49,1,911,11,1690,768,486,425
23,"IALOMIŢA","#N/A",92658,,19,"SLOBOZIA / Şcoala Generala nr.2",1,9160,"MUNICIPIUL SLOBOZIA",92658,1684,1067,1033,34,0,1048,19,1854,787,576,472
23,"IALOMIŢA","#N/A",92658,,20,"SLOBOZIA / Şcoala Generala nr.2",1,9160,"MUNICIPIUL SLOBOZIA",92658,1551,1055,954,101,0,1031,24,1707,652,553,478
23,"IALOMIŢA","#N/A",92658,,21,"SLOBOZIA / S.C. Drumuri şi Poduri Ialomiţa",1,9160,"MUNICIPIUL SLOBOZIA",92658,1711,1124,1075,49,0,1108,16,1879,755,540,568
23,"IALOMIŢA","#N/A",92658,,22,"SLOBOZIA / Palatul Copiilor şi elevilor Slobozia",1,9160,"MUNICIPIUL SLOBOZIA",92658,1554,1019,952,67,0,1007,12,1720,701,537,470
23,"IALOMIŢA","#N/A",92658,,23,"SLOBOZIA / Palatul Copiilor şi elevilor Slobozia",1,9160,"MUNICIPIUL SLOBOZIA",92658,1334,853,821,32,0,841,12,1476,623,444,397
23,"IALOMIŢA","#N/A",92658,,24,"SLOBOZIA / Şcoala Generala nr.1",1,9160,"MUNICIPIUL SLOBOZIA",92658,1010,648,590,58,0,642,6,1113,465,316,326
23,"IALOMIŢA","#N/A",92658,,25,"SLOBOZIA / Şcoala Generala nr.1",1,9160,"MUNICIPIUL SLOBOZIA",92658,982,624,595,29,0,615,9,1085,461,289,326
23,"IALOMIŢA","#N/A",92658,,26,"SLOBOZIA / Liceul de Arta",1,9160,"MUNICIPIUL SLOBOZIA",92658,1186,731,689,42,0,723,8,1308,577,354,369
23,"IALOMIŢA","#N/A",92658,,27,"SLOBOZIA / Liceul de Arta",1,9160,"MUNICIPIUL SLOBOZIA",92658,1521,929,900,29,0,909,20,1674,745,425,484
23,"IALOMIŢA","#N/A",92658,,28,"SLOBOZIA / Gradiniţa cu program prelungit nr.3",1,9160,"MUNICIPIUL SLOBOZIA",92658,1465,911,852,57,2,899,12,1607,696,509,390
23,"IALOMIŢA","#N/A",92658,,29,"SLOBOZIA / Atelierele de creaţie ale Liceului de Artă",1,9160,"MUNICIPIUL SLOBOZIA",92658,1735,1031,975,56,0,1020,11,1900,869,570,450
23,"IALOMIŢA","#N/A",92658,,30,"BORA / Şcoala Generala Bora",1,9160,"MUNICIPIUL SLOBOZIA",92658,736,320,304,16,0,314,6,807,487,240,74
23,"IALOMIŢA","#N/A",92658,,31,"BORA / Şcoala Generala Bora",1,9160,"MUNICIPIUL SLOBOZIA",92658,866,477,452,25,0,470,7,952,475,336,134
23,"IALOMIŢA","#N/A",92658,,32,"SLOBOZIA NOUĂ / Şcoala Generala nr.5 Slobozia Noua",1,9160,"MUNICIPIUL SLOBOZIA",92658,1105,676,648,28,0,666,10,1214,538,397,269
23,"IALOMIŢA","#N/A",92658,,33,"SLOBOZIA NOUĂ / Şcoala Generala nr.5 Slobozia Noua",1,9160,"MUNICIPIUL SLOBOZIA",92658,938,556,530,26,0,550,6,1031,475,309,241
23,"IALOMIŢA","#N/A",92701,,34,"FETEŞTI / Şcoala nr.3 Buliga",1,9164,"MUNICIPIUL FETEŞTI",92701,931,594,570,24,0,589,5,1018,424,422,167
23,"IALOMIŢA","#N/A",92701,,35,"FETEŞTI / Şcoala nr.6 Feteşti",1,9164,"MUNICIPIUL FETEŞTI",92701,1477,699,676,23,0,688,11,1628,929,493,195
23,"IALOMIŢA","#N/A",92701,,36,"FETEŞTI / Şcoala nr.6 Feteşti",1,9164,"MUNICIPIUL FETEŞTI",92701,1065,548,523,25,0,548,0,1170,622,347,201
23,"IALOMIŢA","#N/A",92701,,37,"FETEŞTI / SC COCOLINO SRL",1,9164,"MUNICIPIUL FETEŞTI",92701,1058,558,523,35,0,556,2,1166,608,361,195
23,"IALOMIŢA","#N/A",92701,,38,"FETEŞTI / Şcoala nr.2 Feteşti",1,9164,"MUNICIPIUL FETEŞTI",92701,995,549,528,20,1,539,10,1090,541,316,223
23,"IALOMIŢA","#N/A",92701,,39,"FETEŞTI / Fostul Parchet",1,9164,"MUNICIPIUL FETEŞTI",92701,1127,625,595,30,0,617,8,1240,615,400,217
23,"IALOMIŢA","#N/A",92701,,40,"FETEŞTI /  Şcoala nr.1 Feteşti",1,9164,"MUNICIPIUL FETEŞTI",92701,1005,452,433,19,0,444,8,1109,657,276,168
23,"IALOMIŢA","#N/A",92701,,41,"FETEŞTI / Şcoala nr.4 Vlaşca",1,9164,"MUNICIPIUL FETEŞTI",92701,854,443,425,18,0,432,10,943,500,273,159
23,"IALOMIŢA","#N/A",92701,,42,"FETEŞTI / Şcoala nr.4 Vlaşca",1,9164,"MUNICIPIUL FETEŞTI",92701,921,534,498,36,0,506,28,1012,478,339,167
23,"IALOMIŢA","#N/A",92701,,43,"FETEŞTI / Grup Şcolar CCF Feteşti",1,9164,"MUNICIPIUL FETEŞTI",92701,1149,710,631,41,38,704,6,1262,552,446,258
23,"IALOMIŢA","#N/A",92701,,44,"FETEŞTI / Liceul Teoretic Feteşti",1,9164,"MUNICIPIUL FETEŞTI",92701,1275,686,649,37,0,673,13,1412,726,375,298
23,"IALOMIŢA","#N/A",92701,,45,"FETEŞTI / Şcoala nr.7 Feteşti",1,9164,"MUNICIPIUL FETEŞTI",92701,1309,839,781,58,0,824,15,1428,589,471,353
23,"IALOMIŢA","#N/A",92701,,46,"FETEŞTI / Grup Şcolar Industrie Alimentara",1,9164,"MUNICIPIUL FETEŞTI",92701,1584,832,805,27,0,822,10,1747,915,459,363
23,"IALOMIŢA","#N/A",92701,,47,"FETEŞTI / Grădiniţa VOINICEL",1,9164,"MUNICIPIUL FETEŞTI",92701,1305,695,662,31,2,685,10,1427,732,398,287
23,"IALOMIŢA","#N/A",92701,,48,"FETEŞTI / Sala de sport",1,9164,"MUNICIPIUL FETEŞTI",92701,1016,614,579,32,3,609,5,1133,519,366,243
23,"IALOMIŢA","#N/A",92701,,49,"FETEŞTI / Şcoala nr.8 Feteşti",1,9164,"MUNICIPIUL FETEŞTI",92701,950,596,558,38,0,589,7,1053,457,390,199
23,"IALOMIŢA","#N/A",92701,,50,"FETEŞTI / Şcoala nr.8 Fetesti",1,9164,"MUNICIPIUL FETEŞTI",92701,1014,536,503,29,4,522,14,1137,601,350,172
23,"IALOMIŢA","#N/A",92701,,51,"FETEŞTI / Grădiniţa nr.1 Feteşti",1,9164,"MUNICIPIUL FETEŞTI",92701,1318,873,775,95,3,858,15,1423,550,505,353
23,"IALOMIŢA","#N/A",92701,,52,"FETEŞTI / Şcoala nr.3 Fetesti",1,9164,"MUNICIPIUL FETEŞTI",92701,1353,799,778,21,0,789,10,1489,690,471,318
23,"IALOMIŢA","#N/A",92701,,53,"FETEŞTI / Şcoala nr.3 Feteşti",1,9164,"MUNICIPIUL FETEŞTI",92701,1006,578,549,29,0,571,7,1111,533,307,264
23,"IALOMIŢA","#N/A",92701,,54,"FETEŞTI / Şcoala nr.3 Feteşti",1,9164,"MUNICIPIUL FETEŞTI",92701,963,552,536,15,1,548,4,1074,522,327,221
23,"IALOMIŢA","#N/A",92701,,55,"FETEŞTI / PF IORDAN",1,9164,"MUNICIPIUL FETEŞTI",92701,1359,684,658,25,1,676,8,1496,812,414,262
23,"IALOMIŢA","#N/A",92701,,56,"FETEŞTI / AGROSEM",1,9164,"MUNICIPIUL FETEŞTI",92701,1311,592,574,18,0,583,9,1450,858,363,220
23,"IALOMIŢA","#N/A",92701,,57,"FETEŞTI / Şcoala nr.5 Fetesti",1,9164,"MUNICIPIUL FETEŞTI",92701,1307,600,581,19,0,589,11,1427,827,323,266
23,"IALOMIŢA","#N/A",92701,,58,"FETEŞTI / Şcoala nr.5 Feteşti",1,9164,"MUNICIPIUL FETEŞTI",92701,1119,516,499,17,0,512,4,1228,712,272,240
23,"IALOMIŢA","#N/A",100683,,59,"URZICENI / Grădiniţa cu program prelungit",1,9169,"MUNICIPIUL URZICENI",100683,761,498,468,30,0,489,9,836,338,252,237
23,"IALOMIŢA","#N/A",100683,,60,"URZICENI / Şcolii cu clasele I-VIII nr.3 din Urziceni",1,9169,"MUNICIPIUL URZICENI",100683,1407,747,708,39,0,737,10,1553,806,420,317
23,"IALOMIŢA","#N/A",100683,,61,"URZICENI /  Grădiniţa de copii",1,9169,"MUNICIPIUL URZICENI",100683,1171,728,618,109,1,714,14,1289,561,333,381
23,"IALOMIŢA","#N/A",100683,,62,"URZICENI / Casa de Cultură",1,9169,"MUNICIPIUL URZICENI",100683,1263,741,699,42,0,734,7,1389,648,370,364
23,"IALOMIŢA","#N/A",100683,,63,"URZICENI / Grupul Şcolar ''Sf. Ecaterina''",1,9169,"MUNICIPIUL URZICENI",100683,1406,895,811,84,0,884,11,1547,652,452,432
23,"IALOMIŢA","#N/A",100683,,64,"URZICENI / Şcoala Generală nr. 1",1,9169,"MUNICIPIUL URZICENI",100683,1245,770,715,55,0,761,9,1371,601,334,427
23,"IALOMIŢA","#N/A",100683,,65,"URZICENI / Clubul Sindicatelor",1,9169,"MUNICIPIUL URZICENI",100683,1777,1116,995,121,0,1100,16,1956,840,536,564
23,"IALOMIŢA","#N/A",100683,,66,"URZICENI / Şcoala Generală nr. 2",1,9169,"MUNICIPIUL URZICENI",100683,1674,951,884,67,0,942,9,1846,895,452,490
23,"IALOMIŢA","#N/A",100683,,67,"URZICENI / Şcoala Generală nr. 2",1,9169,"MUNICIPIUL URZICENI",100683,1370,813,725,88,0,803,10,1518,705,433,370
23,"IALOMIŢA","#N/A",100683,,68,"URZICENI / Internatul Liceului Teoretic, str. Al. I. Cuza, nr. 11",1,9169,"MUNICIPIUL URZICENI",100683,1223,718,677,40,1,711,7,1350,632,349,362
23,"IALOMIŢA","#N/A",100683,,69,"URZICENI / Fabrica de Ceramică",1,9169,"MUNICIPIUL URZICENI",100683,1551,794,746,48,0,776,18,1708,914,392,384
23,"IALOMIŢA","#N/A",92836,,70,"AMARA / GRADINITA DE COPII",1,9171,"ORAŞ AMARA",92836,1342,630,596,32,2,623,7,1476,846,374,249
23,"IALOMIŢA","#N/A",92836,,71,"AMARA / GRADINITA DE COPII",1,9171,"ORAŞ AMARA",92836,1064,534,495,39,0,526,8,1175,641,322,204
23,"IALOMIŢA","#N/A",92836,,72,"AMARA / SCOALA GIMNAZIALA GEORGE VALSAN",1,9171,"ORAŞ AMARA",92836,1406,723,652,71,0,720,3,1544,821,415,305
23,"IALOMIŢA","#N/A",92836,,73,"AMARA / SCOALA GIMNAZIALA GEORGE VALSAN",1,9171,"ORAŞ AMARA",92836,1423,707,614,93,0,702,5,1570,863,417,285
23,"IALOMIŢA","#N/A",92836,,74,"AMARA / CASA DE CULTURA JAN CACIULA",1,9171,"ORAŞ AMARA",92836,1439,759,658,101,0,750,9,1588,829,452,298
23,"IALOMIŢA","#N/A",93067,,75,"CĂZĂNEŞTI / Liceul Tehnologic  - Corp B",1,9174,"ORAŞ CĂZĂNEŞTI",93067,1544,787,735,52,0,777,10,1700,913,542,235
23,"IALOMIŢA","#N/A",93067,,76,"CĂZĂNEŞTI / Liceul Tehnologic",1,9174,"ORAŞ CĂZĂNEŞTI",93067,1381,666,629,37,0,660,6,1519,853,447,213
23,"IALOMIŢA","#N/A",102749,,77,"FIERBINŢI-TÂRG / Căminul Cultural",1,9176,"ORAŞ FIERBINŢI-TÂRG",102749,1357,956,735,208,13,945,11,1493,537,572,373
23,"IALOMIŢA","#N/A",102749,,78,"FIERBINŢII DE SUS / Şcoala Generală cu clasele I-IV Firbinţi de Sus",1,9176,"ORAŞ FIERBINŢI-TÂRG",102749,1589,1005,881,109,15,989,16,1752,747,584,405
23,"IALOMIŢA","#N/A",102749,,79,"FIERBINŢII DE JOS / Şcoala Generală cu clasele I-IV Firbinţi de Jos",1,9176,"ORAŞ FIERBINŢI-TÂRG",102749,947,634,571,63,0,629,5,1040,406,316,313
23,"IALOMIŢA","#N/A",92765,,80,"ŢĂNDĂREI / Grupul Scolar Agricol",1,9181,"ORAŞ ŢĂNDĂREI",92765,1440,692,640,52,0,685,7,1582,890,402,283
23,"IALOMIŢA","#N/A",92765,,81,"ŢĂNDĂREI / Liceul Teoretic ''Paul Georgescu''",1,9181,"ORAŞ ŢĂNDĂREI",92765,1141,519,465,33,21,507,12,1262,743,349,158
23,"IALOMIŢA","#N/A",92765,,82,"ŢĂNDĂREI / Liceul Teoretic ''Paul Georgescu''",1,9181,"ORAŞ ŢĂNDĂREI",92765,937,436,414,21,1,428,8,1040,604,242,186
23,"IALOMIŢA","#N/A",92765,,83,"ŢĂNDĂREI / Şcoala nr. 2",1,9181,"ORAŞ ŢĂNDĂREI",92765,1718,855,806,48,1,851,4,1894,1039,508,343
23,"IALOMIŢA","#N/A",92765,,84,"ŢĂNDĂREI / Şcoala nr. 2",1,9181,"ORAŞ ŢĂNDĂREI",92765,1453,599,579,19,1,594,5,1594,995,426,168
23,"IALOMIŢA","#N/A",92765,,85,"ŢĂNDĂREI / Şcoala nr. 1 Ţăndărei",1,9181,"ORAŞ ŢĂNDĂREI",92765,1456,634,587,45,2,624,10,1603,969,413,211
23,"IALOMIŢA","#N/A",92765,,86,"ŢĂNDĂREI / Fost sediu Primărie",1,9181,"ORAŞ ŢĂNDĂREI",92765,1510,698,645,40,13,692,6,1669,971,488,204
23,"IALOMIŢA","#N/A",92765,,87,"ŢĂNDĂREI / Şcoala nr. 1",1,9181,"ORAŞ ŢĂNDĂREI",92765,956,223,206,17,0,222,1,1053,830,181,41
23,"IALOMIŢA","#N/A",92765,,88,"ŢĂNDĂREI / CONSUMCOOP",1,9181,"ORAŞ ŢĂNDĂREI",92765,762,135,122,13,0,133,2,842,707,113,20
23,"IALOMIŢA","#N/A",100754,,89,"ADÂNCATA / Sala de Sport de lângă Primaria comunei  Adâncata",3,9183,"ADÂNCATA",100754,1460,958,810,141,7,942,16,1617,659,555,387
23,"IALOMIŢA","#N/A",100754,,90,"PATRU FRAŢI / Şcoala Generală Adâncata",3,9183,"ADÂNCATA",100754,677,556,393,135,28,547,9,743,187,366,181
23,"IALOMIŢA","#N/A",92783,,91,"ALBEŞTI / Scoala Albesti situata in Albesti",3,9186,"ALBEŞTI",92783,557,493,356,117,20,489,4,615,122,321,168
23,"IALOMIŢA","#N/A",92783,,92,"MARSILIENI / Scoala Marsilieni,situata in sat Marsilieni",3,9186,"ALBEŞTI",92783,471,333,279,41,13,329,4,517,184,229,100
23,"IALOMIŢA","#N/A",100852,,93,"ALEXENI / Şcoala Veche",3,9190,"ALEXENI",100852,914,490,444,46,0,482,8,1010,520,272,210
23,"IALOMIŢA","#N/A",100852,,94,"ALEXENI / Şcoala Veche",3,9190,"ALEXENI",100852,1004,541,489,48,4,537,4,1106,565,314,223
23,"IALOMIŢA","#N/A",92872,,95,"ANDRĂŞEŞTI / Şcoala Generala Andrăşeşti",3,9192,"ANDRĂŞEŞTI",92872,1524,914,814,82,18,905,9,1687,773,620,285
23,"IALOMIŢA","#N/A",92872,,96,"ORBOEŞTI / Şcoala Orboeşti",3,9192,"ANDRĂŞEŞTI",92872,287,162,114,48,0,160,2,310,148,107,53
23,"IALOMIŢA","#N/A",100870,,97,"ARMĂŞEŞTI / Şcoala Generală Armăşeşti",3,9195,"ARMĂŞEŞTI",100870,651,348,290,58,0,346,2,721,373,215,131
23,"IALOMIŢA","#N/A",100870,,98,"MALU ROŞU / Şcoala Generală Malu Roşu",3,9195,"ARMĂŞEŞTI",100870,1272,656,588,68,0,647,9,1403,747,440,207
23,"IALOMIŢA","#N/A",100923,,99,"AXINTELE / Primarie",3,9199,"AXINTELE",100923,583,411,307,104,0,404,7,642,231,307,97
23,"IALOMIŢA","#N/A",100923,,100,"AXINTELE / Scoala  Frumuşica",3,9199,"AXINTELE",100923,818,499,413,86,0,490,9,901,402,295,195
23,"IALOMIŢA","#N/A",100923,,101,"HORIA / Şcoala Horia",3,9199,"AXINTELE",100923,533,325,259,66,0,322,3,595,270,266,56
23,"IALOMIŢA","#N/A",92907,,102,"BALACIU / Camin  Cultural",3,9203,"BALACIU",92907,411,329,219,92,18,327,2,454,125,224,103
23,"IALOMIŢA","#N/A",92907,,103,"BALACIU / Şcoala Gimnazială ,,Arhimandrit Teofil,, Balaciu",3,9203,"BALACIU",92907,353,253,191,62,0,252,1,391,138,150,102
23,"IALOMIŢA","#N/A",92907,,104,"CRĂSANII DE JOS / sală festivităţi",3,9203,"BALACIU",92907,304,197,131,66,0,194,3,336,139,135,59
23,"IALOMIŢA","#N/A",92907,,105,"COPUZU / Gradinita Copuzu",3,9203,"BALACIU",92907,282,183,148,35,0,180,3,310,127,76,104
23,"IALOMIŢA","#N/A",180064,,106,"BĂRBULEŞTI / Şcoala Gimnazială Bărbuleşti",3,9208,"BĂRBULEŞTI",180064,724,236,192,44,0,229,7,796,560,142,87
23,"IALOMIŢA","#N/A",180064,,107,"BĂRBULEŞTI / Şcoala Gimnazială Bărbuleşti",3,9208,"BĂRBULEŞTI",180064,839,226,226,0,0,217,9,922,696,155,62
23,"IALOMIŢA","#N/A",180064,,108,"BĂRBULEŞTI / Şcoala Gimnazială Bărbuleşti",3,9208,"BĂRBULEŞTI",180064,876,243,243,0,0,233,10,963,720,162,71
23,"IALOMIŢA","#N/A",180064,,109,"BĂRBULEŞTI / Şcoala Gimnazială Bărbuleşti",3,9208,"BĂRBULEŞTI",180064,901,271,271,0,0,266,5,987,716,185,81
23,"IALOMIŢA","#N/A",101056,,110,"BĂRCĂNEŞTI / Şcoala Gimnaziala Bărcăneşti",3,9210,"BĂRCĂNEŞTI",101056,1413,821,681,140,0,808,13,1559,738,496,312
23,"IALOMIŢA","#N/A",101056,,111,"CONDEEŞTI / Şcoala Gimnazială Condeeşti",3,9210,"BĂRCĂNEŞTI",101056,1375,656,553,103,0,642,14,1519,863,409,233
23,"IALOMIŢA","#N/A",179784,,112,"BORĂNEŞTI / Şcoala Gimnazială",3,9213,"BORĂNEŞTI",179784,967,522,494,28,0,510,12,1064,542,332,178
23,"IALOMIŢA","#N/A",179784,,113,"BORĂNEŞTI / Şcoala Gimnazială",3,9213,"BORĂNEŞTI",179784,602,369,331,38,0,363,6,661,292,241,122
23,"IALOMIŢA","#N/A",179784,,114,"SINTEŞTI / Fosta Şcoală Sinteşti",3,9213,"BORĂNEŞTI",179784,234,203,153,50,0,203,0,260,57,143,60
23,"IALOMIŢA","#N/A",92989,,115,"BORDUŞANI / localul Şcolii Vechi din centrul satului",3,9216,"BORDUŞANI",92989,1477,613,552,38,23,606,7,1626,1013,373,233
23,"IALOMIŢA","#N/A",92989,,116,"BORDUŞANI / localul Grupului Şcolar Borduşani (zona ""moară"")",3,9216,"BORDUŞANI",92989,1488,659,597,30,32,649,10,1651,992,386,263
23,"IALOMIŢA","#N/A",92989,,117,"CEGANI / localul Şcolii cu clasele I- VIII Cegani",3,9216,"BORDUŞANI",92989,1082,549,501,46,2,545,4,1190,641,278,267
23,"IALOMIŢA","#N/A",93021,,118,"BUCU / Căminul Cultural",3,9219,"BUCU",93021,979,564,497,66,1,556,8,1091,527,227,329
23,"IALOMIŢA","#N/A",93021,,119,"BUCU / Căminul Cultural",3,9219,"BUCU",93021,1071,597,518,79,0,594,3,1177,580,280,314
23,"IALOMIŢA","#N/A",179793,,120,"BUEŞTI / Şcoala cu Clasele I - IV Bueşti",3,9221,"BUEŞTI",179793,894,721,611,86,24,716,5,985,264,583,133
23,"IALOMIŢA","#N/A",100709,,121,"CIOCÂRLIA / Şcoala Generală Ciocârlia",3,9223,"CIOCÂRLIA",100709,656,379,323,55,1,378,1,721,342,251,127
23,"IALOMIŢA","#N/A",93101,,122,"CIOCHINA / Căminul Cultural din satul Ciochina",3,9226,"CIOCHINA",93101,1285,803,692,111,0,791,12,1415,612,504,287
23,"IALOMIŢA","#N/A",93101,,123,"BORDUŞELU / Căminul Cultural din satul Borduşelu",3,9226,"CIOCHINA",93101,635,436,374,62,0,433,3,706,270,206,227
23,"IALOMIŢA","#N/A",93101,,124,"OREZU / Căminul Cultural din satul Orezu",3,9226,"CIOCHINA",93101,663,406,351,55,0,403,3,730,324,235,168
23,"IALOMIŢA","#N/A",93156,,125,"CIULNIŢA / Cămin Cultural Ciulniţa",3,9231,"CIULNIŢA",93156,905,479,430,49,0,478,1,996,517,342,136
23,"IALOMIŢA","#N/A",93156,,126,"ION GHICA / Cămin Cultural Ion Ghica",3,9231,"CIULNIŢA",93156,472,243,208,35,0,243,0,517,274,175,68
23,"IALOMIŢA","#N/A",93156,,127,"POIANA / Şcoala Poiana",3,9231,"CIULNIŢA",93156,425,226,199,27,0,224,2,482,256,152,72
23,"IALOMIŢA","#N/A",93156,,128,"POIANA / Cămin Cultural Ghimpaţi",3,9231,"CIULNIŢA",93156,229,136,111,25,0,134,2,242,106,106,28
23,"IALOMIŢA","#N/A",93209,,129,"COCORA / Şcoala Veche",3,9236,"COCORA",93209,835,555,485,45,25,547,8,923,368,403,144
23,"IALOMIŢA","#N/A",93209,,130,"COCORA / Primaria Cocora",3,9236,"COCORA",93209,881,587,480,71,36,583,4,978,391,415,168
23,"IALOMIŢA","#N/A",179971,,131,"COLELIA / Şcoala cu Clasele I-VIII Colelia",3,9238,"COLELIA",179971,997,767,613,61,93,760,7,1098,331,671,89
23,"IALOMIŢA","#N/A",93236,,132,"COSÂMBEŞTI / Caminul cultural din satul Cosâmbeşti",3,9240,"COSÂMBEŞTI",93236,822,597,488,69,40,591,6,901,304,399,192
23,"IALOMIŢA","#N/A",93236,,133,"GIMBĂŞANI / Şcoala Gimbăşani",3,9240,"COSÂMBEŞTI",93236,748,604,491,68,45,597,7,825,221,460,137
23,"IALOMIŢA","#N/A",102240,,134,"COŞERENI / Caminul Cultural Cosereni",3,9243,"COŞERENI",102240,1416,894,775,114,5,883,11,1562,668,465,418
23,"IALOMIŢA","#N/A",102240,,135,"COŞERENI / Şcoala Generală Cosereni",3,9243,"COŞERENI",102240,1251,770,693,63,14,763,7,1374,604,461,302
23,"IALOMIŢA","#N/A",102240,,136,"COŞERENI / Gradiniţa Pătrime",3,9243,"COŞERENI",102240,1080,650,606,43,1,645,5,1192,542,390,255
23,"IALOMIŢA","#N/A",102641,,137,"DRĂGOEŞTI / Căminul Cultural Drăgoeşti",3,9245,"DRĂGOEŞTI",102641,775,711,497,180,34,695,16,854,143,448,247
23,"IALOMIŢA","#N/A",102703,,138,"DRIDU / Şcoala gimnazială Dridu",3,9251,"DRIDU",102703,970,659,503,156,0,649,10,1059,400,327,322
23,"IALOMIŢA","#N/A",102703,,139,"DRIDU / Grădiniţa Dridu - Moară",3,9251,"DRIDU",102703,814,563,466,97,0,554,9,884,321,341,213
23,"IALOMIŢA","#N/A",102703,,140,"DRIDU / Grădiniţa Dridu - Movila",3,9251,"DRIDU",102703,683,411,314,95,2,404,7,771,360,196,208
23,"IALOMIŢA","#N/A",102703,,141,"DRIDU-SNAGOV / Grădiniţa Dridu -Snagov",3,9251,"DRIDU",102703,381,210,172,38,0,204,6,422,212,119,85
23,"IALOMIŢA","#N/A",93575,,142,"FĂCĂENI / SAM FACAENI",3,9254,"FĂCĂENI",93575,1276,772,691,69,12,753,19,1418,646,385,368
23,"IALOMIŢA","#N/A",93575,,143,"FĂCĂENI / SCOALA GENERALA FACAENI - CORP B",3,9254,"FĂCĂENI",93575,1693,944,865,55,24,930,14,1859,915,427,503
23,"IALOMIŢA","#N/A",93575,,144,"FĂCĂENI / SCOALA GENERALA FACAENI - CORP C",3,9254,"FĂCĂENI",93575,1002,577,540,32,5,568,9,1096,519,276,292
23,"IALOMIŢA","#N/A",93575,,145,"PROGRESU / SEDIUL ADMINISTRATIV PRIMARIA FACAENI",3,9254,"FĂCĂENI",93575,533,335,300,19,16,331,4,592,257,169,162
23,"IALOMIŢA","#N/A",103283,,146,"GÂRBOVI / Şcoala cu clasele I-VIII Gârbovi,",3,9257,"GÂRBOVI",103283,1070,509,447,62,0,506,3,1183,674,330,176
23,"IALOMIŢA","#N/A",103283,,147,"GÂRBOVI / Şcoala cu clasele I-VIII Gârbovi,",3,9257,"GÂRBOVI",103283,1100,557,511,46,0,545,12,1211,654,340,205
23,"IALOMIŢA","#N/A",103283,,148,"GÂRBOVI / Scoala cu clasele I-VIII Garbovi",3,9257,"GÂRBOVI",103283,1163,559,523,36,0,544,15,1280,721,327,217
23,"IALOMIŢA","#N/A",93600,,149,"GHEORGHE DOJA / Şcoala gimnazială Gheorghe Doja  situată în   Gheorghe Doja",3,9259,"GHEORGHE DOJA",93600,1126,696,616,63,17,690,6,1236,540,475,215
23,"IALOMIŢA","#N/A",93600,,150,"GHEORGHE DOJA / Şcoala gimnazială Gheorghe Doja  situată în   Gheorghe Doja",3,9259,"GHEORGHE DOJA",93600,1139,688,625,52,11,685,3,1257,569,449,236
23,"IALOMIŢA","#N/A",93628,,151,"GHEORGHE LAZĂR / Şcoala Generală Gheorghe Lazăr",3,9261,"GHEORGHE LAZĂR",93628,1105,690,616,53,21,680,10,1222,532,501,179
23,"IALOMIŢA","#N/A",93628,,152,"GHEORGHE LAZĂR / Şcoala Generală Gheorghe Lazăr",3,9261,"GHEORGHE LAZĂR",93628,814,562,480,67,15,556,6,902,340,397,159
23,"IALOMIŢA","#N/A",93646,,153,"GIURGENI / Şcoala Gimnazială Giurgeni",3,9263,"GIURGENI",93646,1217,799,706,36,57,786,13,1343,544,481,305
23,"IALOMIŢA","#N/A",93717,,154,"GRINDU / Căminul Cultural",3,9265,"GRINDU",93717,883,502,442,60,0,496,6,974,472,372,124
23,"IALOMIŢA","#N/A",93717,,155,"GRINDU / Căminul Cultural",3,9265,"GRINDU",93717,873,487,431,56,0,480,7,960,473,369,111
23,"IALOMIŢA","#N/A",93735,,156,"GRIVIŢA / Liceul Tehnologic Areta Teodorescu",3,9267,"GRIVIŢA",93735,1032,596,543,52,1,592,4,1144,548,318,274
23,"IALOMIŢA","#N/A",93735,,157,"GRIVIŢA / Liceul Tehnologic Areta Teodorescu",3,9267,"GRIVIŢA",93735,995,553,514,36,3,546,7,1098,545,288,258
23,"IALOMIŢA","#N/A",93735,,158,"SMIRNA / Şcoala cu clasele I-IV",3,9267,"GRIVIŢA",93735,836,472,396,73,3,468,4,921,449,290,178
23,"IALOMIŢA","#N/A",180046,,159,"GURA IALOMIŢEI / Scoala Gimnaziala Constantin Gurgu Nr. 1",3,9270,"GURA IALOMIŢEI",180046,1034,575,528,47,0,574,1,1139,564,374,200
23,"IALOMIŢA","#N/A",180046,,160,"LUCIU / Şcoala Generala Luciu",3,9270,"GURA IALOMIŢEI",180046,1138,599,559,40,0,595,4,1254,655,430,165
23,"IALOMIŢA","#N/A",103862,,161,"ION ROATĂ / Şcoala Gimnaziala cu clasele I-VIII Ion Roata",3,9273,"ION ROATĂ",103862,951,500,431,69,0,494,6,1049,549,244,250
23,"IALOMIŢA","#N/A",103862,,162,"ION ROATĂ / Gradinita Ion Roata  (localul vechi Colinele)",3,9273,"ION ROATĂ",103862,817,412,373,39,0,405,7,906,494,239,166
23,"IALOMIŢA","#N/A",103862,,163,"BROŞTENI / Şcoala Gimnaziala cu clasele I-VIII Ion Roata(structura Brosteni)",3,9273,"ION ROATĂ",103862,1194,565,534,31,0,558,7,1320,755,379,179
23,"IALOMIŢA","#N/A",103960,,164,"JILAVELE / Şcoala nr.1 Jilavele",3,9276,"JILAVELE",103960,1279,824,707,117,0,820,4,1409,585,600,220
23,"IALOMIŢA","#N/A",103960,,165,"JILAVELE / Şcoala nr.2 Jilavele",3,9276,"JILAVELE",103960,1317,732,664,68,0,721,11,1446,714,454,267
23,"IALOMIŢA","#N/A",103960,,166,"SLĂTIOARELE / Şcoala din satul Slătioarele",3,9276,"JILAVELE",103960,342,229,193,36,0,228,1,378,149,161,67
23,"IALOMIŢA","#N/A",179800,,167,"MAIA / Şcoala cu clasele I-VIII, ""Barbu Catargiu"", Maia",3,9279,"MAIA",179800,1411,992,837,148,7,981,11,1551,559,627,354
23,"IALOMIŢA","#N/A",100736,,168,"MANASIA / Şcoala Nouă",3,9281,"MANASIA",100736,1345,686,641,45,0,680,6,1488,802,366,314
23,"IALOMIŢA","#N/A",100736,,169,"MANASIA / Şcoala Nouă",3,9281,"MANASIA",100736,1004,531,508,23,0,525,6,1106,575,288,237
23,"IALOMIŢA","#N/A",100736,,170,"MANASIA / Şcoala Nouă",3,9281,"MANASIA",100736,1520,811,771,40,0,801,10,1673,862,449,352
23,"IALOMIŢA","#N/A",179980,,171,"MĂRCULEŞTI / localul Şcolii Gimnaziale din comuna Mărculeşti",3,9283,"MĂRCULEŞTI",179980,1355,938,835,60,43,932,6,1498,560,698,234
23,"IALOMIŢA","#N/A",93995,,172,"MIHAIL KOGĂLNICEANU / Cămin Cultural Mihail Kogălniceanu",3,9285,"MIHAIL KOGĂLNICEANU",93995,1395,838,760,78,0,824,14,1532,694,558,266
23,"IALOMIŢA","#N/A",93995,,173,"MIHAIL KOGĂLNICEANU / Liceul tehnologic Mihail Kogălniceanu",3,9285,"MIHAIL KOGĂLNICEANU",93995,1304,660,609,51,0,649,11,1428,768,401,248
23,"IALOMIŢA","#N/A",94045,,174,"MILOŞEŞTI / ŞCOALA GIMNAZIALA MILOŞEŞTI",3,9288,"MILOŞEŞTI",94045,1553,775,711,48,16,766,9,1707,932,557,209
23,"IALOMIŢA","#N/A",94045,,175,"NICOLEŞTI / Şcoala Generală Nicoleşti",3,9288,"MILOŞEŞTI",94045,364,184,150,34,0,183,1,403,219,90,93
23,"IALOMIŢA","#N/A",94045,,176,"TOVĂRĂŞIA / Şcoala Generala Tovărăşia",3,9288,"MILOŞEŞTI",94045,317,199,145,51,3,198,1,349,150,132,66
23,"IALOMIŢA","#N/A",179999,,177,"MOLDOVENI / Şcoala cu clasele I-VIII Moldoveni",3,9292,"MOLDOVENI",179999,953,831,632,169,30,829,2,1048,217,617,212
23,"IALOMIŢA","#N/A",94081,,178,"MOVILA / Şcoala cu clasele I-VIII, Movila",3,9294,"MOVILA",94081,1629,1074,971,68,35,1057,17,1789,715,698,359
23,"IALOMIŢA","#N/A",104270,,179,"MOVILIŢA / Scoala gimnaziala Movilita",3,9296,"MOVILIŢA",104270,1147,636,480,156,0,627,9,1265,629,328,299
23,"IALOMIŢA","#N/A",104270,,180,"MOVILIŢA / Scoala gimnaziala Movilita",3,9296,"MOVILIŢA",104270,826,466,370,96,0,459,7,911,445,259,200
23,"IALOMIŢA","#N/A",94107,,181,"MUNTENI-BUZĂU / Şcoala Generală Nr. 1",3,9300,"MUNTENI-BUZĂU",94107,1565,1095,919,155,21,1078,17,1723,628,746,332
23,"IALOMIŢA","#N/A",94107,,182,"MUNTENI-BUZĂU / Şcoala Generală Nr. 2",3,9300,"MUNTENI-BUZĂU",94107,1332,838,728,71,39,830,8,1471,633,526,304
23,"IALOMIŢA","#N/A",179819,,183,"OGRADA / Imobilul Şcolii cu clasele I-VIII ,, Ionel Perlea """,3,9302,"OGRADA",179819,1225,698,645,28,25,688,10,1353,655,470,218
23,"IALOMIŢA","#N/A",179819,,184,"OGRADA /  Imobilul Scolii cu clasele I-VIII ,, Ionel Perlea """,3,9302,"OGRADA",179819,1076,638,566,49,23,630,8,1185,547,429,201
23,"IALOMIŢA","#N/A",94161,,185,"PERIEŢI / scoala generala",3,9304,"PERIEŢI",94161,1087,451,404,47,0,448,3,1199,748,269,179
23,"IALOMIŢA","#N/A",94161,,186,"PĂLTINIŞU / scoala generala",3,9304,"PERIEŢI",94161,896,472,424,46,2,467,5,986,514,263,204
23,"IALOMIŢA","#N/A",94161,,187,"FUNDATA / scoala generala",3,9304,"PERIEŢI",94161,388,209,168,40,1,206,3,429,220,119,87
23,"IALOMIŢA","#N/A",94161,,188,"MISLEANU / scoala generala",3,9304,"PERIEŢI",94161,692,370,334,36,0,365,5,769,399,228,137
23,"IALOMIŢA","#N/A",180000,,189,"PLATONEŞTI / Grădiniţa cu program normal Platoneşti",3,9310,"PLATONEŞTI",180000,787,465,418,47,0,461,4,868,403,359,102
23,"IALOMIŢA","#N/A",180000,,190,"LĂCUSTENI / Grădiniţa cu Program normal",3,9310,"PLATONEŞTI",180000,829,507,471,36,0,500,7,916,409,366,134
23,"IALOMIŢA","#N/A",101243,,191,"BRAZII / Căminul Cultural situată în sat Brazii",3,9313,"RADULEŞTI",101243,759,656,513,143,0,650,6,838,182,545,105
23,"IALOMIŢA","#N/A",101243,,192,"RĂSIMNICEA / Şcoala Generală cu clasele I-IV Răsimnicea",3,9313,"RADULEŞTI",101243,220,211,144,67,0,208,3,249,38,173,35
23,"IALOMIŢA","#N/A",94269,,193,"REVIGA / Şcoala Reviga",3,9317,"REVIGA",94269,1136,602,522,79,1,595,7,1254,652,407,188
23,"IALOMIŢA","#N/A",94269,,194,"ROVINE / Şcoala Rovine",3,9317,"REVIGA",94269,798,452,387,64,1,448,4,881,429,274,174
23,"IALOMIŢA","#N/A",94269,,195,"CRUNŢI / Şcoala Crunţi",3,9317,"REVIGA",94269,420,251,214,37,0,249,2,465,214,139,110
23,"IALOMIŢA","#N/A",179828,,196,"ROŞIORI / Scoala cu clasele I-VIII  Roşiori",3,9322,"ROŞIORI",179828,908,589,503,77,9,586,3,1000,411,336,250
23,"IALOMIŢA","#N/A",179828,,197,"ROŞIORI / Şcoala cu clasele I-VIII  Roşiori",3,9322,"ROŞIORI",179828,643,404,322,80,2,397,7,707,303,216,181
23,"IALOMIŢA","#N/A",94330,,198,"SĂLCIOARA / Şcoala Gimnazială",3,9324,"SĂLCIOARA",94330,937,453,394,58,1,447,6,1034,581,219,228
23,"IALOMIŢA","#N/A",94330,,199,"RAŞI / Şcoala  primară",3,9324,"SĂLCIOARA",94330,875,577,448,114,15,570,7,964,387,432,138
23,"IALOMIŢA","#N/A",180019,,200,"SĂRĂŢENI / Scoala Primara Sarateni",3,9327,"SĂRĂŢENI",180019,1030,645,569,65,11,639,6,1141,496,334,305
23,"IALOMIŢA","#N/A",94376,,201,"SĂVENI / Şcoala Şăveni",3,9329,"SĂVENI",94376,1270,734,666,68,0,726,8,1416,682,558,168
23,"IALOMIŢA","#N/A",94376,,202,"SĂVENI / Gradiniţa Săveni",3,9329,"SĂVENI",94376,1248,656,597,59,0,645,11,1372,716,489,156
23,"IALOMIŢA","#N/A",94376,,203,"FRĂŢILEŞTI / Şcoala Frăţileşti",3,9329,"SĂVENI",94376,346,216,185,31,0,215,1,381,165,156,59
23,"IALOMIŢA","#N/A",94429,,204,"SCÂNTEIA / Gradiniţa Scânteia",3,9332,"SCÂNTEIA",94429,1185,745,693,52,0,739,6,1305,560,575,164
23,"IALOMIŢA","#N/A",94429,,205,"SCÂNTEIA / Şcoala Generală Scânteia",3,9332,"SCÂNTEIA",94429,1115,686,628,58,0,681,5,1229,543,548,133
23,"IALOMIŢA","#N/A",94429,,206,"IAZU / Scoala cu clasele  I-IV Iazu",3,9332,"SCÂNTEIA",94429,902,488,445,43,0,485,3,996,508,369,116
23,"IALOMIŢA","#N/A",94456,,207,"SFÂNTU GHEORGHE / Centrul Social de zi pentru copii Viitorul situată  în   Sfântu Gheorghe",3,9335,"SFÂNTU GHEORGHE",94456,677,407,339,68,0,401,6,735,328,230,171
23,"IALOMIŢA","#N/A",94456,,208,"MALU / Căminul Cultural Malu,salonul de nunţi situată în Malu",3,9335,"SFÂNTU GHEORGHE",94456,903,552,478,74,0,548,4,1009,457,351,197
23,"IALOMIŢA","#N/A",105026,,209,"SINEŞTI / Căminul Cultural situată în Satul Sineşti,   Sineşti",3,9339,"SINEŞTI",105026,1199,816,644,172,0,807,9,1321,505,395,412
23,"IALOMIŢA","#N/A",105026,,210,"LILIECI / Şcoala cu cl.I-IV  situată în Satul Lilieci,   Sineşti",3,9339,"SINEŞTI",105026,869,553,376,177,0,547,6,954,401,325,222
23,"IALOMIŢA","#N/A",94492,,211,"STELNICA / Primăria Stelnica",3,9346,"STELNICA",94492,1501,889,831,47,11,870,19,1649,760,647,223
23,"IALOMIŢA","#N/A",94535,,212,"SUDIŢI / Scoala Gimnazială ""Apostol D Culea""",3,9350,"SUDIŢI",94535,866,470,428,38,4,466,4,959,489,327,139
23,"IALOMIŢA","#N/A",94535,,213,"SUDIŢI / Scoala Gimnazială ""Apostol D Culea""",3,9350,"SUDIŢI",94535,870,468,419,45,4,462,6,958,490,283,179
23,"IALOMIŢA","#N/A",179702,,214,"TRAIAN / Grădiniţa cu program normal Traian",3,9353,"TRAIAN",179702,1270,718,661,57,0,706,12,1405,687,499,207
23,"IALOMIŢA","#N/A",179702,,215,"TRAIAN / Şcola Profesională Traian",3,9353,"TRAIAN",179702,1228,685,640,45,0,678,7,1352,667,557,121
23,"IALOMIŢA","#N/A",94688,,216,"VALEA CIORII / Primaria  Valea  Ciorii",3,9355,"VALEA CIORII",94688,1516,1008,927,61,20,995,13,1673,665,755,240
23,"IALOMIŢA","#N/A",105794,,217,"VALEA MĂCRIŞULUI / Cămin Cultural",3,9360,"VALEA MĂCRIŞULUI",105794,1029,647,561,69,17,632,15,1141,494,457,175
23,"IALOMIŢA","#N/A",105794,,218,"GRINDAŞI / Cămin Cultural",3,9360,"VALEA MĂCRIŞULUI",105794,426,279,210,63,6,278,1,468,189,166,112
23,"IALOMIŢA","#N/A",94795,,219,"VLĂDENI / Căminul cultural",3,9363,"VLĂDENI",94795,911,599,558,41,0,595,4,994,395,419,176
23,"IALOMIŢA","#N/A",94795,,220,"VLĂDENI / Căminul cultural",3,9363,"VLĂDENI",94795,814,515,489,26,0,511,4,897,382,368,143
24,"IAŞI","#N/A",95060,,1,"IAŞI / GRĂDINIŢA NR. 15",1,9366,"MUNICIPIUL IAŞI",95060,1515,1014,907,107,0,994,20,1600,586,353,641
24,"IAŞI","#N/A",95060,,2,"IAŞI / GRĂDINIŢA NR. 15",1,9366,"MUNICIPIUL IAŞI",95060,1362,790,690,100,0,779,11,1500,710,316,463
24,"IAŞI","#N/A",95060,,3,"IAŞI / ŞCOALA GIMNAZIALĂ ""ELENA CUZA""",1,9366,"MUNICIPIUL IAŞI",95060,1479,1024,880,143,1,1006,18,1600,576,405,601
24,"IAŞI","#N/A",95060,,4,"IAŞI / ŞCOALA GIMNAZIALĂ ""ELENA CUZA""",1,9366,"MUNICIPIUL IAŞI",95060,1227,1096,711,383,2,1071,25,1300,204,384,687
24,"IAŞI","#N/A",95060,,5,"IAŞI / ŞCOALA GIMNAZIALĂ ""ELENA CUZA""",1,9366,"MUNICIPIUL IAŞI",95060,1571,1009,867,142,0,987,22,1600,591,433,554
24,"IAŞI","#N/A",95060,,6,"IAŞI / ŞCOALA GIMNAZIALĂ ""ELENA CUZA""",1,9366,"MUNICIPIUL IAŞI",95060,1537,928,855,71,2,912,16,1600,672,364,548
24,"IAŞI","#N/A",95060,,7,"IAŞI / ŞCOALA GIMNAZIALĂ ""ELENA CUZA""",1,9366,"MUNICIPIUL IAŞI",95060,1401,906,834,71,1,891,15,1400,494,367,524
24,"IAŞI","#N/A",95060,,8,"IAŞI / ŞCOALA GIMNAZIALĂ ""ELENA CUZA""",1,9366,"MUNICIPIUL IAŞI",95060,1500,899,844,55,0,885,14,1600,701,390,495
24,"IAŞI","#N/A",95060,,9,"IAŞI / ŞCOALA GIMNAZIALĂ ""ELENA CUZA""",1,9366,"MUNICIPIUL IAŞI",95060,1676,1005,959,46,0,992,13,1700,695,363,629
24,"IAŞI","#N/A",95060,,10,"IAŞI / ŞCOALA GIMNAZIALĂ ""ELENA CUZA""",1,9366,"MUNICIPIUL IAŞI",95060,1649,951,905,46,0,935,16,1700,749,407,528
24,"IAŞI","#N/A",95060,,11,"IAŞI / ŞCOALA  GIMNAZIALĂ ""ION CREANGĂ""",1,9366,"MUNICIPIUL IAŞI",95060,1246,704,598,106,0,687,17,1300,596,295,392
24,"IAŞI","#N/A",95060,,12,"IAŞI / ŞCOALA  GIMNAZIALĂ ""ION CREANGĂ""",1,9366,"MUNICIPIUL IAŞI",95060,1167,874,721,153,0,862,12,1200,326,331,531
24,"IAŞI","#N/A",95060,,13,"IAŞI / ŞCOALA  GIMNAZIALĂ ""ION CREANGĂ""",1,9366,"MUNICIPIUL IAŞI",95060,1194,872,732,139,1,862,10,1200,328,318,544
24,"IAŞI","#N/A",95060,,14,"IAŞI / ŞCOALA  GIMNAZIALĂ ""ION CREANGĂ""",1,9366,"MUNICIPIUL IAŞI",95060,1079,708,644,64,0,696,12,1100,392,271,425
24,"IAŞI","#N/A",95060,,15,"IAŞI / ŞCOALA GIMNAZIALĂ ""PETRU PONI""",1,9366,"MUNICIPIUL IAŞI",95060,1484,1081,890,191,0,1065,16,1500,419,373,692
24,"IAŞI","#N/A",95060,,16,"IAŞI / ŞCOALA GIMNAZIALĂ ""PETRU PONI""",1,9366,"MUNICIPIUL IAŞI",95060,1092,746,617,129,0,736,10,1100,354,291,445
24,"IAŞI","#N/A",95060,,17,"IAŞI / ŞCOALA GIMNAZIALĂ ""PETRU PONI""",1,9366,"MUNICIPIUL IAŞI",95060,1470,1030,870,159,1,1011,19,1500,470,365,646
24,"IAŞI","#N/A",95060,,18,"IAŞI / ŞCOALA GIMNAZIALĂ ""PETRU PONI""",1,9366,"MUNICIPIUL IAŞI",95060,1125,847,741,106,0,839,8,1100,253,303,536
24,"IAŞI","#N/A",95060,,19,"IAŞI / ŞCOALA  GIMNAZIALĂ ""ŞTEFAN BÂRSĂNESCU""",1,9366,"MUNICIPIUL IAŞI",95060,1268,1065,817,248,0,1050,15,1300,235,340,710
24,"IAŞI","#N/A",95060,,20,"IAŞI / ŞCOALA  GIMNAZIALĂ ""ŞTEFAN BÂRSĂNESCU""",1,9366,"MUNICIPIUL IAŞI",95060,1201,726,571,155,0,714,12,1200,474,203,511
24,"IAŞI","#N/A",95060,,21,"IAŞI / ŞCOALA  GIMNAZIALĂ ""ŞTEFAN BÂRSĂNESCU""",1,9366,"MUNICIPIUL IAŞI",95060,1951,863,780,83,0,850,13,1900,1037,378,472
24,"IAŞI","#N/A",95060,,22,"IAŞI / ŞCOALA  GIMNAZIALĂ ""ŞTEFAN BÂRSĂNESCU""",1,9366,"MUNICIPIUL IAŞI",95060,1073,964,657,307,0,944,20,1300,336,318,626
24,"IAŞI","#N/A",95060,,23,"IAŞI / CASA STUDENŢILOR",1,9366,"MUNICIPIUL IAŞI",95060,1354,1434,808,623,3,1414,20,1900,466,392,1022
24,"IAŞI","#N/A",95060,,24,"IAŞI / COLEGIUL NAŢIONAL",1,9366,"MUNICIPIUL IAŞI",95060,1062,979,687,292,0,961,18,1201,222,356,605
24,"IAŞI","#N/A",95060,,25,"IAŞI / COLEGIUL NAŢIONAL",1,9366,"MUNICIPIUL IAŞI",95060,999,971,599,372,0,953,18,1403,432,357,596
24,"IAŞI","#N/A",95060,,26,"IAŞI / COLEGIUL NAŢIONAL",1,9366,"MUNICIPIUL IAŞI",95060,1563,923,757,69,97,907,16,1690,767,392,515
24,"IAŞI","#N/A",95060,,27,"IAŞI / COLEGIUL NAŢIONAL",1,9366,"MUNICIPIUL IAŞI",95060,1160,766,661,100,5,756,10,1300,534,268,488
24,"IAŞI","#N/A",95060,,28,"IAŞI / GRĂDINIŢA CU PROGRAM PRELUNGIT NR.4",1,9366,"MUNICIPIUL IAŞI",95060,1557,1051,944,106,1,1037,14,1700,649,396,641
24,"IAŞI","#N/A",95060,,29,"IAŞI / ŞCOALA  NR. 1  ""GH. ASACHI""",1,9366,"MUNICIPIUL IAŞI",95060,1116,1226,545,679,2,1200,26,1600,374,356,844
24,"IAŞI","#N/A",95060,,30,"IAŞI / COLEGIUL ""COSTACHE NEGRUZZI''",1,9366,"MUNICIPIUL IAŞI",95060,1032,1219,594,623,2,1201,18,1500,281,291,910
24,"IAŞI","#N/A",95060,,31,"IAŞI / COLEGIUL ""COSTACHE NEGRUZZI''",1,9366,"MUNICIPIUL IAŞI",95060,921,1283,613,530,140,1269,14,1800,517,392,877
24,"IAŞI","#N/A",95060,,32,"IAŞI / COLEGIUL NATIONAL ""GARABET IBRĂILEANU""",1,9366,"MUNICIPIUL IAŞI",95060,931,1172,577,355,240,1147,25,1400,228,554,593
24,"IAŞI","#N/A",95060,,33,"IAŞI / COLEGIUL NATIONAL ""GARABET IBRĂILEANU""",1,9366,"MUNICIPIUL IAŞI",95060,997,1307,679,357,271,1286,19,1494,187,567,719
24,"IAŞI","#N/A",95060,,34,"IAŞI / COLEGIUL NATIONAL ""GARABET IBRĂILEANU""",1,9366,"MUNICIPIUL IAŞI",95060,965,1383,583,415,385,1362,21,1500,117,719,643
24,"IAŞI","#N/A",95060,,35,"IAŞI / COLEGIUL NATIONAL ""GARABET IBRĂILEANU""",1,9366,"MUNICIPIUL IAŞI",95060,970,843,509,333,1,830,13,1100,257,237,593
24,"IAŞI","#N/A",95060,,36,"IAŞI / UNIVERSITATEA AGRONOMICĂ ""ION IONESCU DE LA BRAD""",1,9366,"MUNICIPIUL IAŞI",95060,1644,1716,1107,608,1,1691,25,2200,484,524,1167
24,"IAŞI","#N/A",95060,,37,"IAŞI / LICEUL TEORETIC DE INFORMATICĂ ""GRIGORE MOISIL""",1,9366,"MUNICIPIUL IAŞI",95060,1456,1626,797,651,178,1605,21,2400,774,499,1106
24,"IAŞI","#N/A",95060,,38,"IAŞI / COLEGIUL NAŢIONAL ""MIHAI EMINESCU""",1,9366,"MUNICIPIUL IAŞI",95060,1058,820,678,88,54,811,9,1200,380,306,505
24,"IAŞI","#N/A",95060,,39,"IAŞI / COLEGIUL NAŢIONAL ""MIHAI EMINESCU""",1,9366,"MUNICIPIUL IAŞI",95060,926,713,559,63,91,705,8,1100,387,282,423
24,"IAŞI","#N/A",95060,,40,"IAŞI / ŞCOALA GIMNAZIALĂ""MIHAI CODREANU""",1,9366,"MUNICIPIUL IAŞI",95060,516,475,314,48,113,466,9,600,125,197,269
24,"IAŞI","#N/A",95060,,41,"IAŞI / ŞCOALA GIMNAZIALĂ""MIHAI CODREANU""",1,9366,"MUNICIPIUL IAŞI",95060,593,499,350,37,112,491,8,698,199,227,264
24,"IAŞI","#N/A",95060,,42,"IAŞI / GRUP ŞCOLAR U.C.E.C.O.M.",1,9366,"MUNICIPIUL IAŞI",95060,1322,739,648,91,0,726,13,1400,661,290,436
24,"IAŞI","#N/A",95060,,43,"IAŞI / GRUP ŞCOLAR U.C.E.C.O.M.",1,9366,"MUNICIPIUL IAŞI",95060,1000,686,568,81,37,677,9,1100,414,271,406
24,"IAŞI","#N/A",95060,,44,"IAŞI / GRUP ŞCOLAR U.C.E.C.O.M.",1,9366,"MUNICIPIUL IAŞI",95060,1051,603,537,66,0,597,6,1200,597,218,379
24,"IAŞI","#N/A",95060,,45,"IAŞI / COLEGIUL ECONOMIC ADMINISTRATIV NR. 1",1,9366,"MUNICIPIUL IAŞI",95060,998,825,576,135,114,812,13,1098,273,295,517
24,"IAŞI","#N/A",95060,,46,"IAŞI / COLEGIUL ECONOMIC ADMINISTRATIV NR. 1",1,9366,"MUNICIPIUL IAŞI",95060,977,811,621,74,116,793,18,1100,289,336,457
24,"IAŞI","#N/A",95060,,47,"IAŞI / LICEUL TEORETIC ''V. ALECSANDRI''",1,9366,"MUNICIPIUL IAŞI",95060,1201,1036,774,260,2,1021,15,1300,264,391,630
24,"IAŞI","#N/A",95060,,48,"IAŞI / LICEUL TEORETIC ''V. ALECSANDRI''",1,9366,"MUNICIPIUL IAŞI",95060,638,621,374,247,0,614,7,700,79,178,436
24,"IAŞI","#N/A",95060,,49,"IAŞI / LICEUL TEORETIC ''V. ALECSANDRI''",1,9366,"MUNICIPIUL IAŞI",95060,1349,1018,795,220,3,1004,14,1497,479,395,609
24,"IAŞI","#N/A",95060,,50,"IAŞI / GRUP ŞCOLAR NR. 4 ""V. PAVELCU""",1,9366,"MUNICIPIUL IAŞI",95060,814,570,477,91,2,562,8,900,330,225,337
24,"IAŞI","#N/A",95060,,51,"IAŞI / GRUP ŞCOLAR NR. 4 ""V. PAVELCU""",1,9366,"MUNICIPIUL IAŞI",95060,709,509,435,73,1,500,7,800,291,189,311
24,"IAŞI","#N/A",95060,,52,"IAŞI / COLEGIUL NATIONAL DE ARTĂ ""O. BĂNCILĂ""",1,9366,"MUNICIPIUL IAŞI",95060,802,608,499,107,2,592,16,900,292,233,359
24,"IAŞI","#N/A",95060,,53,"IAŞI / COLEGIUL NATIONAL DE ARTĂ ""O. BĂNCILĂ""",1,9366,"MUNICIPIUL IAŞI",95060,840,739,469,202,68,729,10,900,161,270,459
24,"IAŞI","#N/A",95060,,54,"IAŞI / ŞCOALA  NR.34  ""I. SIMIONESCU""",1,9366,"MUNICIPIUL IAŞI",95060,975,798,575,223,0,782,16,1100,302,299,483
24,"IAŞI","#N/A",95060,,55,"IAŞI / ŞCOALA  NR.34  ""I. SIMIONESCU""",1,9366,"MUNICIPIUL IAŞI",95060,1044,632,538,93,1,619,13,1100,468,249,370
24,"IAŞI","#N/A",95060,,56,"IAŞI / ŞCOALA  NR.34  ""I. SIMIONESCU""",1,9366,"MUNICIPIUL IAŞI",95060,1290,772,721,51,0,761,11,1400,628,347,414
24,"IAŞI","#N/A",95060,,57,"IAŞI / ŞCOALA  NR.34  ""I. SIMIONESCU""",1,9366,"MUNICIPIUL IAŞI",95060,1133,642,613,29,0,629,13,1200,558,301,328
24,"IAŞI","#N/A",95060,,58,"IAŞI / ŞCOALA  NR.34  ""I. SIMIONESCU""",1,9366,"MUNICIPIUL IAŞI",95060,1064,865,644,21,200,852,13,1200,335,405,447
24,"IAŞI","#N/A",95060,,59,"IAŞI / ŞCOALA  NR.34  ""I. SIMIONESCU""",1,9366,"MUNICIPIUL IAŞI",95060,1439,816,787,29,0,800,16,1500,684,404,396
24,"IAŞI","#N/A",95060,,60,"IAŞI / ŞCOALA  NR.34  ""I. SIMIONESCU""",1,9366,"MUNICIPIUL IAŞI",95060,1305,766,733,31,2,753,13,1400,634,346,407
24,"IAŞI","#N/A",95060,,61,"IAŞI / ŞCOALA  NR.34  ""I. SIMIONESCU""",1,9366,"MUNICIPIUL IAŞI",95060,1649,937,879,58,0,921,16,1700,763,370,551
24,"IAŞI","#N/A",95060,,62,"IAŞI / ŞCOALA  NR.34  ""I. SIMIONESCU""",1,9366,"MUNICIPIUL IAŞI",95060,1670,970,919,51,0,956,14,1700,730,369,587
24,"IAŞI","#N/A",95060,,63,"IAŞI / GRĂDINIŢA CU PROGRAM PRELUNGIT NR. 25",1,9366,"MUNICIPIUL IAŞI",95060,1515,1015,929,86,0,999,16,1600,585,460,539
24,"IAŞI","#N/A",95060,,64,"IAŞI / GRĂDINIŢA CU PROGRAM PRELUNGIT NR. 25",1,9366,"MUNICIPIUL IAŞI",95060,1317,661,626,35,0,648,13,1400,739,292,356
24,"IAŞI","#N/A",95060,,65,"IAŞI / GRĂDINIŢA CU PROGRAM NORMAL  NR.21",1,9366,"MUNICIPIUL IAŞI",95060,835,585,507,78,0,576,9,900,315,251,325
24,"IAŞI","#N/A",95060,,66,"IAŞI / GRĂDINIŢA CU PROGRAM NORMAL  NR.21",1,9366,"MUNICIPIUL IAŞI",95060,834,586,469,117,0,578,8,900,314,252,326
24,"IAŞI","#N/A",95060,,67,"IAŞI / GRĂDINIŢA CU PROGRAM NORMAL  NR.21",1,9366,"MUNICIPIUL IAŞI",95060,920,541,451,90,0,535,6,1000,459,241,294
24,"IAŞI","#N/A",95060,,68,"IAŞI / GRĂDINIŢA CU PROGRAM NORMAL  NR.21",1,9366,"MUNICIPIUL IAŞI",95060,895,546,497,49,0,535,11,900,354,262,273
24,"IAŞI","#N/A",95060,,69,"IAŞI / GRĂDINIŢA CU PROGRAM PRELUNGIT  NR.21",1,9366,"MUNICIPIUL IAŞI",95060,1026,635,577,58,0,623,12,1100,465,285,338
24,"IAŞI","#N/A",95060,,70,"IAŞI / GRĂDINIŢA CU PROGRAM PRELUNGIT  NR.21",1,9366,"MUNICIPIUL IAŞI",95060,931,667,581,86,0,652,15,1000,333,256,396
24,"IAŞI","#N/A",95060,,71,"IAŞI / GRĂDINIŢA CU PROGRAM NORMAL NR. 7",1,9366,"MUNICIPIUL IAŞI",95060,691,434,367,67,0,423,11,700,266,181,242
24,"IAŞI","#N/A",95060,,72,"IAŞI / GRĂDINIŢA CU PROGRAM NORMAL NR. 7",1,9366,"MUNICIPIUL IAŞI",95060,776,465,403,62,0,456,9,800,335,197,259
24,"IAŞI","#N/A",95060,,73,"IAŞI / LICEUL TEHNOLOGIC  ""VIRGIL MADGEARU""",1,9366,"MUNICIPIUL IAŞI",95060,1200,758,637,121,0,738,20,1300,542,353,385
24,"IAŞI","#N/A",95060,,74,"IAŞI / LICEUL TEHNOLOGIC  ""VIRGIL MADGEARU""",1,9366,"MUNICIPIUL IAŞI",95060,1198,647,608,0,39,639,8,1300,653,304,335
24,"IAŞI","#N/A",95060,,75,"IAŞI / LICEUL TEHNOLOGIC  ""VIRGIL MADGEARU""",1,9366,"MUNICIPIUL IAŞI",95060,1223,697,662,34,1,684,13,1300,603,309,375
24,"IAŞI","#N/A",95060,,76,"IAŞI / LICEUL TEHNOLOGIC  ""VIRGIL MADGEARU""",1,9366,"MUNICIPIUL IAŞI",95060,1261,750,630,119,1,729,21,1300,550,335,394
24,"IAŞI","#N/A",95060,,77,"IAŞI / LICEUL TEHNOLOGIC  ""VIRGIL MADGEARU""",1,9366,"MUNICIPIUL IAŞI",95060,1299,818,712,106,0,798,20,1400,582,370,428
24,"IAŞI","#N/A",95060,,78,"IAŞI / ŞCOALA  GIMNAZIALĂ ""ALEXANDRU CEL BUN""",1,9366,"MUNICIPIUL IAŞI",95060,1191,717,601,113,3,704,13,1200,483,301,403
24,"IAŞI","#N/A",95060,,79,"IAŞI / ŞCOALA  GIMNAZIALĂ ""ALEXANDRU CEL BUN""",1,9366,"MUNICIPIUL IAŞI",95060,1359,948,815,132,1,941,7,1400,452,416,525
24,"IAŞI","#N/A",95060,,80,"IAŞI / ŞCOALA  GIMNAZIALĂ ""ALEXANDRU CEL BUN""",1,9366,"MUNICIPIUL IAŞI",95060,1438,863,827,36,0,854,9,1500,637,434,420
24,"IAŞI","#N/A",95060,,81,"IAŞI / ŞCOALA  GIMNAZIALĂ ""ALEXANDRU CEL BUN""",1,9366,"MUNICIPIUL IAŞI",95060,1462,694,654,38,2,675,19,1500,806,294,381
24,"IAŞI","#N/A",95060,,82,"IAŞI / ŞCOALA  GIMNAZIALĂ ""ALEXANDRU CEL BUN""",1,9366,"MUNICIPIUL IAŞI",95060,1224,626,585,40,1,610,16,1300,674,287,323
24,"IAŞI","#N/A",95060,,83,"IAŞI / LICEUL TEHNOLOGIC ECONOMIC DE TURISM""",1,9366,"MUNICIPIUL IAŞI",95060,1029,573,538,34,1,569,4,1100,527,253,316
24,"IAŞI","#N/A",95060,,84,"IAŞI / LICEUL TEHNOLOGIC ECONOMIC DE TURISM""",1,9366,"MUNICIPIUL IAŞI",95060,1395,779,686,93,0,766,13,1400,621,342,424
24,"IAŞI","#N/A",95060,,85,"IAŞI / LICEUL TEHNOLOGIC ECONOMIC DE TURISM""",1,9366,"MUNICIPIUL IAŞI",95060,1143,812,714,98,0,797,15,1200,388,324,473
24,"IAŞI","#N/A",95060,,86,"IAŞI / LICEUL TEHNOLOGIC ECONOMIC DE TURISM""",1,9366,"MUNICIPIUL IAŞI",95060,1085,583,539,44,0,569,14,1100,517,270,299
24,"IAŞI","#N/A",95060,,87,"IAŞI / ŞCOALA  GIMNAZIALĂ ""GEORGE COŞBUC""",1,9366,"MUNICIPIUL IAŞI",95060,1177,749,639,110,0,736,13,1199,450,329,407
24,"IAŞI","#N/A",95060,,88,"IAŞI / ŞCOALA  GIMNAZIALĂ ""GEORGE COŞBUC""",1,9366,"MUNICIPIUL IAŞI",95060,1176,783,659,124,0,766,17,1200,417,314,452
24,"IAŞI","#N/A",95060,,89,"IAŞI / ŞCOALA  GIMNAZIALĂ ""GEORGE COŞBUC""",1,9366,"MUNICIPIUL IAŞI",95060,1155,503,451,52,0,495,8,1200,697,209,286
24,"IAŞI","#N/A",95060,,90,"IAŞI / ŞCOALA  GIMNAZIALĂ ""GEORGE COŞBUC""",1,9366,"MUNICIPIUL IAŞI",95060,1320,686,649,37,0,676,10,1400,714,319,357
24,"IAŞI","#N/A",95060,,91,"IAŞI / ŞCOALA  GIMNAZIALĂ ""GEORGE COŞBUC""",1,9366,"MUNICIPIUL IAŞI",95060,1223,737,689,48,0,724,13,1300,563,355,369
24,"IAŞI","#N/A",95060,,92,"IAŞI / ŞCOALA  GIMNAZIALĂ ""GEORGE COŞBUC""",1,9366,"MUNICIPIUL IAŞI",95060,1265,718,695,23,0,712,6,1398,680,366,346
24,"IAŞI","#N/A",95060,,93,"IAŞI / ŞCOALA  GIMNAZIALĂ ""GEORGE COŞBUC""",1,9366,"MUNICIPIUL IAŞI",95060,1036,629,590,37,2,621,8,1100,471,294,327
24,"IAŞI","#N/A",95060,,94,"IAŞI / ŞCOALA  GIMNAZIALĂ ""GEORGE COŞBUC""",1,9366,"MUNICIPIUL IAŞI",95060,1068,608,580,27,1,599,9,1100,492,276,323
24,"IAŞI","#N/A",95060,,95,"IAŞI / ŞCOALA  GIMNAZIALĂ ""GEORGE COŞBUC""",1,9366,"MUNICIPIUL IAŞI",95060,1071,565,546,19,0,557,8,1100,535,269,288
24,"IAŞI","#N/A",95060,,96,"IAŞI / ŞCOALA  GIMNAZIALĂ ""ALEXANDRU VLAHUŢĂ""",1,9366,"MUNICIPIUL IAŞI",95060,1089,737,623,114,0,725,12,1100,363,352,373
24,"IAŞI","#N/A",95060,,97,"IAŞI / ŞCOALA  GIMNAZIALĂ ""ALEXANDRU VLAHUŢĂ""",1,9366,"MUNICIPIUL IAŞI",95060,832,482,425,56,1,477,5,900,418,189,288
24,"IAŞI","#N/A",95060,,98,"IAŞI / ŞCOALA  GIMNAZIALĂ ""ALEXANDRU VLAHUŢĂ""",1,9366,"MUNICIPIUL IAŞI",95060,946,562,532,30,0,554,8,1000,438,293,261
24,"IAŞI","#N/A",95060,,99,"IAŞI / ŞCOALA  GIMNAZIALĂ ""ALEXANDRU VLAHUŢĂ""",1,9366,"MUNICIPIUL IAŞI",95060,1093,645,618,27,0,632,13,1100,455,262,370
24,"IAŞI","#N/A",95060,,100,"IAŞI / ŞCOALA  GIMNAZIALĂ ""ALEXANDRU VLAHUŢĂ""",1,9366,"MUNICIPIUL IAŞI",95060,789,485,456,29,0,476,9,800,315,168,308
24,"IAŞI","#N/A",95060,,101,"IAŞI / ŞCOALA  GIMNAZIALĂ ""GEORGE CĂLINESCU""",1,9366,"MUNICIPIUL IAŞI",95060,1128,732,646,86,0,719,13,1200,468,305,414
24,"IAŞI","#N/A",95060,,102,"IAŞI / ŞCOALA  GIMNAZIALĂ ""GEORGE CĂLINESCU""",1,9366,"MUNICIPIUL IAŞI",95060,1486,1067,909,158,0,1056,11,1499,432,458,598
24,"IAŞI","#N/A",95060,,103,"IAŞI / ŞCOALA  GIMNAZIALĂ ""GEORGE CĂLINESCU""",1,9366,"MUNICIPIUL IAŞI",95060,1582,956,815,140,1,945,11,1600,644,382,563
24,"IAŞI","#N/A",95060,,104,"IAŞI / ŞCOALA  GIMNAZIALĂ ""GEORGE CĂLINESCU""",1,9366,"MUNICIPIUL IAŞI",95060,1253,707,643,64,0,697,10,1300,593,285,412
24,"IAŞI","#N/A",95060,,105,"IAŞI / ŞCOALA  GIMNAZIALĂ ""GEORGE CĂLINESCU""",1,9366,"MUNICIPIUL IAŞI",95060,1393,841,787,54,0,831,10,1400,559,324,507
24,"IAŞI","#N/A",95060,,106,"IAŞI / ŞCOALA  GIMNAZIALĂ ""GEORGE CĂLINESCU""",1,9366,"MUNICIPIUL IAŞI",95060,1228,748,701,46,1,735,13,1300,552,307,428
24,"IAŞI","#N/A",95060,,107,"IAŞI / LICEUL TEHNOLOGIC ECONOMIC DE TURISM",1,9366,"MUNICIPIUL IAŞI",95060,1214,788,615,173,0,775,13,1300,512,324,451
24,"IAŞI","#N/A",95060,,108,"IAŞI / LICEUL TEHNOLOGIC ECONOMIC DE TURISM",1,9366,"MUNICIPIUL IAŞI",95060,1395,733,666,67,0,720,13,1400,667,304,416
24,"IAŞI","#N/A",95060,,109,"IAŞI / LICEUL TEHNOLOGIC ECONOMIC DE TURISM",1,9366,"MUNICIPIUL IAŞI",95060,1441,861,791,70,0,851,10,1500,639,388,463
24,"IAŞI","#N/A",95060,,110,"IAŞI / LICEUL TEHNOLOGIC ECONOMIC DE TURISM",1,9366,"MUNICIPIUL IAŞI",95060,1235,743,689,54,0,721,22,1300,557,294,427
24,"IAŞI","#N/A",95060,,111,"IAŞI / LICEUL TEHNOLOGIC ECONOMIC DE TURISM",1,9366,"MUNICIPIUL IAŞI",95060,1371,736,689,47,0,721,15,1400,664,315,406
24,"IAŞI","#N/A",95060,,112,"IAŞI / LICEUL TEHNOLOGIC ECONOMIC DE TURISM",1,9366,"MUNICIPIUL IAŞI",95060,1402,682,643,33,6,674,8,1400,718,345,329
24,"IAŞI","#N/A",95060,,113,"IAŞI / LICEUL TEHNOLOGIC ECONOMIC DE TURISM",1,9366,"MUNICIPIUL IAŞI",95060,1356,557,536,21,0,548,9,1400,843,234,314
24,"IAŞI","#N/A",95060,,114,"IAŞI / ŞCOALA  GIMNAZIALĂ ""CARMEN SYLVA""",1,9366,"MUNICIPIUL IAŞI",95060,1480,1081,898,180,3,1060,21,1500,419,432,628
24,"IAŞI","#N/A",95060,,115,"IAŞI / ŞCOALA  GIMNAZIALĂ ""CARMEN SYLVA""",1,9366,"MUNICIPIUL IAŞI",95060,1101,862,665,145,52,844,18,1100,238,345,499
24,"IAŞI","#N/A",95060,,116,"IAŞI / ŞCOALA NR. 5 ""CALISTRAT HOGAŞ""",1,9366,"MUNICIPIUL IAŞI",95060,1563,985,903,82,0,973,12,1600,615,387,586
24,"IAŞI","#N/A",95060,,117,"IAŞI / ŞCOALA NR. 5 ""CALISTRAT HOGAŞ""",1,9366,"MUNICIPIUL IAŞI",95060,1922,655,611,41,3,646,9,2000,1345,289,357
24,"IAŞI","#N/A",95060,,118,"IAŞI / ŞCOALA NR. 5 ""CALISTRAT HOGAŞ""",1,9366,"MUNICIPIUL IAŞI",95060,1819,852,791,59,2,842,10,1900,1048,335,507
24,"IAŞI","#N/A",95060,,119,"IAŞI / ŞCOALA NR. 30 ""C. NEGRI""",1,9366,"MUNICIPIUL IAŞI",95060,1444,911,804,107,0,900,11,1500,589,347,553
24,"IAŞI","#N/A",95060,,120,"IAŞI / ŞCOALA NR. 30 ""C. NEGRI""",1,9366,"MUNICIPIUL IAŞI",95060,1354,792,669,122,1,782,10,1500,708,318,464
24,"IAŞI","#N/A",95060,,121,"IAŞI / ŞCOALA  GIMNAZIALĂ ""B. P. HAŞDEU""",1,9366,"MUNICIPIUL IAŞI",95060,1415,1006,772,227,7,987,19,1500,494,367,620
24,"IAŞI","#N/A",95060,,122,"IAŞI / ŞCOALA  GIMNAZIALĂ ""B. P. HAŞDEU""",1,9366,"MUNICIPIUL IAŞI",95060,1556,906,731,175,0,884,22,1600,694,367,517
24,"IAŞI","#N/A",95060,,123,"IAŞI / ŞCOALA  GIMNAZIALĂ ""B. P. HAŞDEU""",1,9366,"MUNICIPIUL IAŞI",95060,2058,908,706,143,59,896,12,2000,1092,352,544
24,"IAŞI","#N/A",95060,,124,"IAŞI / LICEUL TEORETIC ""AL.I.CUZA""",1,9366,"MUNICIPIUL IAŞI",95060,1170,781,713,66,2,770,11,1200,419,330,440
24,"IAŞI","#N/A",95060,,125,"IAŞI / LICEUL TEORETIC ""AL.I.CUZA""",1,9366,"MUNICIPIUL IAŞI",95060,1064,758,666,91,1,744,14,1100,342,308,436
24,"IAŞI","#N/A",95060,,126,"IAŞI / LICEUL TEORETIC ""AL.I.CUZA""",1,9366,"MUNICIPIUL IAŞI",95060,1243,619,547,68,4,605,14,1300,681,277,328
24,"IAŞI","#N/A",95060,,127,"IAŞI / LICEUL TEORETIC ""AL.I.CUZA""",1,9366,"MUNICIPIUL IAŞI",95060,1410,851,788,61,2,837,14,1500,649,399,438
24,"IAŞI","#N/A",95060,,128,"IAŞI / ŞCOALA PRIMARA ""COSTACHE CONACHI""",1,9366,"MUNICIPIUL IAŞI",95060,1335,819,676,141,2,803,16,1400,581,311,492
24,"IAŞI","#N/A",95060,,129,"IAŞI / ŞCOALA PRIMARA ""COSTACHE CONACHI""",1,9366,"MUNICIPIUL IAŞI",95060,1394,910,778,132,0,895,15,1400,490,308,587
24,"IAŞI","#N/A",95060,,130,"IAŞI / ŞCOALA PRIMARA ""COSTACHE CONACHI""",1,9366,"MUNICIPIUL IAŞI",95060,1308,737,665,72,0,731,6,1400,663,297,434
24,"IAŞI","#N/A",95060,,131,"IAŞI / ŞCOALA PRIMARA ""COSTACHE CONACHI""",1,9366,"MUNICIPIUL IAŞI",95060,1431,795,744,51,0,781,14,1500,705,317,464
24,"IAŞI","#N/A",95060,,132,"IAŞI / ŞCOALA PRIMARA ""COSTACHE CONACHI""",1,9366,"MUNICIPIUL IAŞI",95060,1571,758,669,88,1,747,11,1600,842,305,442
24,"IAŞI","#N/A",95060,,133,"IAŞI / DIRECTIA JUDETEANA PENTRU SPORT SI TINERET",1,9366,"MUNICIPIUL IAŞI",95060,1107,846,570,275,1,835,11,1200,354,286,549
24,"IAŞI","#N/A",95060,,134,"IAŞI / DIRECTIA JUDETEANA PENTRU SPORT SI TINERET",1,9366,"MUNICIPIUL IAŞI",95060,1479,1046,792,254,0,1024,22,1500,454,374,650
24,"IAŞI","#N/A",95060,,135,"IAŞI / DIRECTIA JUDETEANA PENTRU SPORT SI TINERET",1,9366,"MUNICIPIUL IAŞI",95060,1630,1032,742,290,0,1020,12,1700,668,342,678
24,"IAŞI","#N/A",95060,,136,"IAŞI / DIRECTIA JUDETEANA PENTRU SPORT SI TINERET",1,9366,"MUNICIPIUL IAŞI",95060,1406,1060,814,214,32,1038,22,1500,440,438,600
24,"IAŞI","#N/A",95060,,137,"IAŞI / DIRECTIA JUDETEANA PENTRU SPORT SI TINERET",1,9366,"MUNICIPIUL IAŞI",95060,1242,892,690,202,0,882,10,1300,408,358,524
24,"IAŞI","#N/A",95060,,138,"IAŞI / DIRECTIA JUDETEANA PENTRU SPORT SI TINERET",1,9366,"MUNICIPIUL IAŞI",95060,1302,905,742,160,3,889,16,1398,493,355,534
24,"IAŞI","#N/A",95060,,139,"IAŞI / ŞCOALA  GIMNAZIALĂ ""IONEL TEODOREANU""",1,9366,"MUNICIPIUL IAŞI",95060,1673,868,756,108,4,850,18,1700,832,341,509
24,"IAŞI","#N/A",95060,,140,"IAŞI / ŞCOALA  GIMNAZIALĂ ""IONEL TEODOREANU""",1,9366,"MUNICIPIUL IAŞI",95060,1229,747,627,118,2,733,14,1300,553,302,431
24,"IAŞI","#N/A",95060,,141,"IAŞI / ŞCOALA  GIMNAZIALĂ ""IONEL TEODOREANU""",1,9366,"MUNICIPIUL IAŞI",95060,1434,847,697,147,3,827,20,1500,653,337,490
24,"IAŞI","#N/A",95060,,142,"IAŞI / ŞCOALA  GIMNAZIALĂ ""IONEL TEODOREANU""",1,9366,"MUNICIPIUL IAŞI",95060,1561,924,817,104,3,911,13,1600,676,424,487
24,"IAŞI","#N/A",95060,,143,"IAŞI / ŞCOALA  GIMNAZIALĂ ""IONEL TEODOREANU""",1,9366,"MUNICIPIUL IAŞI",95060,1391,746,633,106,7,738,8,1400,654,334,404
24,"IAŞI","#N/A",95060,,144,"IAŞI / ŞCOALA  GIMNAZIALĂ ""GH.I. BRĂTIANU""",1,9366,"MUNICIPIUL IAŞI",95060,1753,852,771,78,3,834,18,1799,947,355,479
24,"IAŞI","#N/A",95060,,145,"IAŞI / ŞCOALA  GIMNAZIALĂ ""GH.I. BRĂTIANU""",1,9366,"MUNICIPIUL IAŞI",95060,1372,822,688,120,14,792,30,1400,578,357,435
24,"IAŞI","#N/A",95060,,146,"IAŞI / ŞCOALA  GIMNAZIALĂ ""GH.I. BRĂTIANU""",1,9366,"MUNICIPIUL IAŞI",95060,1448,952,863,89,0,938,14,1500,548,300,638
24,"IAŞI","#N/A",95060,,147,"IAŞI / ŞCOALA  GIMNAZIALĂ ""GH.I. BRĂTIANU""",1,9366,"MUNICIPIUL IAŞI",95060,1919,1207,1123,84,0,1192,15,2000,793,445,747
24,"IAŞI","#N/A",95060,,148,"IAŞI / ŞCOALA  GIMNAZIALĂ ""GH.I. BRĂTIANU""",1,9366,"MUNICIPIUL IAŞI",95060,2231,347,275,72,0,343,4,2200,1853,140,203
24,"IAŞI","#N/A",95060,,149,"IAŞI / UNIVERSITATEA TEHNICĂ ""GH. ASACHI""",1,9366,"MUNICIPIUL IAŞI",95060,1672,2267,507,1759,1,2225,42,3000,733,469,1756
24,"IAŞI","#N/A",95060,,150,"IAŞI / UNIVERSITATEA TEHNICĂ ""GH. ASACHI""",1,9366,"MUNICIPIUL IAŞI",95060,815,845,477,368,0,829,16,1300,455,302,527
24,"IAŞI","#N/A",95060,,151,"IAŞI / UNIVERSITATEA TEHNICĂ ""GH. ASACHI""",1,9366,"MUNICIPIUL IAŞI",95060,797,665,499,164,2,657,8,1300,635,254,403
24,"IAŞI","#N/A",95060,,152,"IAŞI / UNIVERSITATEA TEHNICĂ ""GH. ASACHI""",1,9366,"MUNICIPIUL IAŞI",95060,1169,916,715,199,2,905,11,1700,784,286,619
24,"IAŞI","#N/A",95060,,153,"IAŞI / ŞCOALA  GIMNAZIALĂ ""ION GHICA""",1,9366,"MUNICIPIUL IAŞI",95060,1560,973,821,150,2,960,13,1700,727,433,527
24,"IAŞI","#N/A",95060,,154,"IAŞI / ŞCOALA  GIMNAZIALĂ ""ION GHICA""",1,9366,"MUNICIPIUL IAŞI",95060,630,493,357,136,0,491,2,700,207,210,281
24,"IAŞI","#N/A",95060,,155,"IAŞI / ŞCOALA  GIMNAZIALĂ ""ION GHICA""",1,9366,"MUNICIPIUL IAŞI",95060,608,414,338,75,1,409,5,700,286,177,232
24,"IAŞI","#N/A",95060,,156,"IAŞI / CASA DE CULTURA A SINDICATELOR",1,9366,"MUNICIPIUL IAŞI",95060,1124,472,345,120,7,469,3,1179,707,159,310
24,"IAŞI","#N/A",95060,,157,"IAŞI / CASA DE CULTURA A SINDICATELOR",1,9366,"MUNICIPIUL IAŞI",95060,1084,587,468,119,0,572,15,1100,513,226,346
24,"IAŞI","#N/A",95060,,158,"IAŞI / CASA DE CULTURA A SINDICATELOR",1,9366,"MUNICIPIUL IAŞI",95060,897,503,397,106,0,491,12,1000,497,180,311
24,"IAŞI","#N/A",95060,,159,"IAŞI / CASA DE CULTURA A SINDICATELOR",1,9366,"MUNICIPIUL IAŞI",95060,968,598,478,120,0,584,14,1100,502,237,347
24,"IAŞI","#N/A",95060,,160,"IAŞI / COLEGIUL TEHNIC ""IOAN C.ŞTEFĂNESCU""",1,9366,"MUNICIPIUL IAŞI",95060,947,610,496,114,0,604,6,1100,490,272,332
24,"IAŞI","#N/A",95060,,161,"IAŞI / COLEGIUL TEHNIC ""IOAN C.ŞTEFĂNESCU""",1,9366,"MUNICIPIUL IAŞI",95060,1559,548,459,89,0,538,10,1600,1052,228,310
24,"IAŞI","#N/A",95060,,162,"IAŞI / COLEGIUL TEHNIC ""IOAN C.ŞTEFĂNESCU""",1,9366,"MUNICIPIUL IAŞI",95060,958,446,373,73,0,438,8,1000,554,193,245
24,"IAŞI","#N/A",95060,,163,"IAŞI / LICEUL TEHNOLOGIC ""ANGHEL SALIGNY""",1,9366,"MUNICIPIUL IAŞI",95060,1039,630,502,128,0,622,8,1100,470,278,344
24,"IAŞI","#N/A",95060,,164,"IAŞI / LICEUL TEHNOLOGIC ""ANGHEL SALIGNY""",1,9366,"MUNICIPIUL IAŞI",95060,1016,642,524,117,1,634,8,1100,458,291,343
24,"IAŞI","#N/A",95060,,165,"IAŞI / LICEUL TEHNOLOGIC ""ANGHEL SALIGNY""",1,9366,"MUNICIPIUL IAŞI",95060,848,475,422,52,1,472,3,900,425,227,245
24,"IAŞI","#N/A",95060,,166,"IAŞI / LICEUL TEHNOLOGIC ""ANGHEL SALIGNY""",1,9366,"MUNICIPIUL IAŞI",95060,874,507,445,62,0,501,6,900,393,226,275
24,"IAŞI","#N/A",95060,,167,"IAŞI / COLEGIUL TEHNIC ELECTRONICĂ ŞI TELECOMUNICAŢII",1,9366,"MUNICIPIUL IAŞI",95060,1474,952,759,192,1,934,18,1600,648,368,566
24,"IAŞI","#N/A",95060,,168,"IAŞI / COLEGIUL TEHNIC ELECTRONICĂ ŞI TELECOMUNICAŢII",1,9366,"MUNICIPIUL IAŞI",95060,1396,638,551,87,0,630,8,1500,862,271,359
24,"IAŞI","#N/A",95060,,169,"IAŞI / ŞCOALA  GIMNAZIALĂ ""VERONICA MICLE""",1,9366,"MUNICIPIUL IAŞI",95060,1657,1350,1038,154,158,1334,16,1800,450,513,821
24,"IAŞI","#N/A",95060,,170,"IAŞI / ŞCOALA  GIMNAZIALĂ ""VERONICA MICLE""",1,9366,"MUNICIPIUL IAŞI",95060,1289,900,794,104,2,887,13,1300,400,293,594
24,"IAŞI","#N/A",95060,,171,"IAŞI / ŞCOALA  GIMNAZIALĂ ""VERONICA MICLE""",1,9366,"MUNICIPIUL IAŞI",95060,1757,1159,1063,96,0,1139,20,1800,641,373,766
24,"IAŞI","#N/A",95060,,172,"IAŞI / LICEUL TEHNOLOGIC ""DIMITRIE MANGERON""",1,9366,"MUNICIPIUL IAŞI",95060,1122,741,698,42,1,730,11,1200,459,257,473
24,"IAŞI","#N/A",95060,,173,"IAŞI / LICEUL TEHNOLOGIC ""DIMITRIE MANGERON""",1,9366,"MUNICIPIUL IAŞI",95060,945,507,481,25,1,495,12,1000,493,193,302
24,"IAŞI","#N/A",95060,,174,"IAŞI / LICEUL TEHNOLOGIC ""DIMITRIE MANGERON""",1,9366,"MUNICIPIUL IAŞI",95060,919,520,453,66,1,507,13,984,464,220,287
24,"IAŞI","#N/A",95060,,175,"IAŞI / LICEUL TEHNOLOGIC ""DIMITRIE MANGERON""",1,9366,"MUNICIPIUL IAŞI",95060,840,273,259,14,0,268,5,900,627,97,171
24,"IAŞI","#N/A",95060,,176,"IAŞI / LICEUL TEHNOLOGIC ""DIMITRIE MANGERON""",1,9366,"MUNICIPIUL IAŞI",95060,1006,483,457,26,0,478,5,1100,617,169,309
24,"IAŞI","#N/A",95060,,177,"IAŞI / LICEUL TEHNOLOGIC ""DIMITRIE MANGERON""",1,9366,"MUNICIPIUL IAŞI",95060,1175,525,401,123,1,521,4,1200,675,204,317
24,"IAŞI","#N/A",95060,,178,"IAŞI / ŞCOALA GIMNAZIALĂ  ""DIMITRIE A.STURDZA""",1,9366,"MUNICIPIUL IAŞI",95060,926,614,516,97,1,599,15,1102,488,228,371
24,"IAŞI","#N/A",95060,,179,"IAŞI / ŞCOALA GIMNAZIALĂ  ""DIMITRIE A.STURDZA""",1,9366,"MUNICIPIUL IAŞI",95060,1216,658,583,72,3,647,11,1300,642,250,397
24,"IAŞI","#N/A",95060,,180,"IAŞI / ŞCOALA GIMNAZIALĂ  ""DIMITRIE A.STURDZA""",1,9366,"MUNICIPIUL IAŞI",95060,1291,760,662,98,0,743,17,1300,540,273,470
24,"IAŞI","#N/A",95060,,181,"IAŞI / ŞCOALA GIMNAZIALĂ  ""DIMITRIE A.STURDZA""",1,9366,"MUNICIPIUL IAŞI",95060,1551,898,836,61,1,886,12,1600,702,345,541
24,"IAŞI","#N/A",95060,,182,"IAŞI / ŞCOALA GIMNAZIALĂ ""ALECU RUSSO""",1,9366,"MUNICIPIUL IAŞI",95060,1183,667,606,61,0,659,8,1200,533,249,410
24,"IAŞI","#N/A",95060,,183,"IAŞI / ŞCOALA GIMNAZIALĂ ""ALECU RUSSO""",1,9366,"MUNICIPIUL IAŞI",95060,1316,826,755,71,0,812,14,1400,574,318,494
24,"IAŞI","#N/A",95060,,184,"IAŞI / ŞCOALA GIMNAZIALĂ ""ALECU RUSSO""",1,9366,"MUNICIPIUL IAŞI",95060,1195,713,622,91,0,703,10,1200,487,261,442
24,"IAŞI","#N/A",95060,,185,"IAŞI / ŞCOALA GIMNAZIALĂ ""ALECU RUSSO""",1,9366,"MUNICIPIUL IAŞI",95060,1420,833,737,95,1,817,16,1500,667,331,486
24,"IAŞI","#N/A",95060,,186,"IAŞI / ŞCOALA GIMNAZIALĂ ""ALECU RUSSO""",1,9366,"MUNICIPIUL IAŞI",95060,1622,566,446,120,0,552,14,1700,1134,197,355
24,"IAŞI","#N/A",95060,,187,"IAŞI / ŞCOALA GIMNAZIALĂ "" ALECU RUSSO""",1,9366,"MUNICIPIUL IAŞI",95060,1103,654,599,55,0,644,10,1200,546,257,387
24,"IAŞI","#N/A",95060,,188,"IAŞI / ŞCOALA PRIMARA  ""GHEORGHE GHIBANESCU""",1,9366,"MUNICIPIUL IAŞI",95060,1164,735,628,106,1,728,7,1200,465,252,476
24,"IAŞI","#N/A",95060,,189,"IAŞI / ŞCOALA PRIMARA  ""GHEORGHE GHIBANESCU""",1,9366,"MUNICIPIUL IAŞI",95060,1183,780,689,91,0,766,14,1200,420,264,502
24,"IAŞI","#N/A",95060,,190,"IAŞI / ŞCOALA PRIMARA  ""GHEORGHE GHIBANESCU""",1,9366,"MUNICIPIUL IAŞI",95060,1135,711,643,67,1,700,11,1200,489,254,446
24,"IAŞI","#N/A",95060,,191,"IAŞI / ŞCOALA PRIMARA  ""GHEORGHE GHIBANESCU""",1,9366,"MUNICIPIUL IAŞI",95060,1327,852,777,75,0,841,11,1400,548,270,571
24,"IAŞI","#N/A",95060,,192,"IAŞI / ŞCOALA PRIMARA  ""GHEORGHE GHIBANESCU""",1,9366,"MUNICIPIUL IAŞI",95060,1185,734,674,59,1,723,11,1200,466,262,461
24,"IAŞI","#N/A",95060,,193,"IAŞI / GRĂDINIŢA CU PROGRAM PRELUNGIT NR.1",1,9366,"MUNICIPIUL IAŞI",95060,868,688,514,174,0,682,6,900,212,240,442
24,"IAŞI","#N/A",95060,,194,"IAŞI / GRĂDINIŢA CU PROGRAM PRELUNGIT NR.1",1,9366,"MUNICIPIUL IAŞI",95060,1050,809,620,189,0,794,15,1100,291,248,546
24,"IAŞI","#N/A",95060,,195,"IAŞI / ŞCOALA  GIMNAZIALĂ ""NICOLAE IORGA""",1,9366,"MUNICIPIUL IAŞI",95060,1485,854,777,77,0,851,3,1500,646,323,528
24,"IAŞI","#N/A",95060,,196,"IAŞI / ŞCOALA  GIMNAZIALĂ ""NICOLAE IORGA""",1,9366,"MUNICIPIUL IAŞI",95060,1643,927,879,47,1,920,7,1700,773,290,630
24,"IAŞI","#N/A",95060,,197,"IAŞI / ŞCOALA  GIMNAZIALĂ ""NICOLAE IORGA""",1,9366,"MUNICIPIUL IAŞI",95060,1466,1024,856,117,51,1000,24,1500,476,345,655
24,"IAŞI","#N/A",95060,,198,"IAŞI / ŞCOALA  GIMNAZIALĂ ""NICOLAE IORGA""",1,9366,"MUNICIPIUL IAŞI",95060,1868,839,734,103,2,825,14,1700,861,274,551
24,"IAŞI","#N/A",95060,,199,"IAŞI / ŞCOALA  GIMNAZIALĂ ""NICOLAE IORGA""",1,9366,"MUNICIPIUL IAŞI",95060,1669,972,862,110,0,955,17,1700,728,303,652
24,"IAŞI","#N/A",95060,,200,"IAŞI / ŞCOALA  GIMNAZIALĂ ""NICOLAE IORGA""",1,9366,"MUNICIPIUL IAŞI",95060,1768,1072,975,97,0,1050,22,1800,728,341,709
24,"IAŞI","#N/A",95060,,201,"IAŞI / PARCUL ŞTIINŢIFIC ŞI TEHNOLOGIC",1,9366,"MUNICIPIUL IAŞI",95060,1208,741,685,56,0,734,7,1300,559,251,483
24,"IAŞI","#N/A",95060,,202,"IAŞI / PARCUL ŞTIINŢIFIC ŞI TEHNOLOGIC",1,9366,"MUNICIPIUL IAŞI",95060,1231,671,639,32,0,664,7,1300,629,223,441
24,"IAŞI","#N/A",95060,,203,"IAŞI / ŞCOALA  GIMNAZIALĂ ""OTILIA CAZIMIR""",1,9366,"MUNICIPIUL IAŞI",95060,1234,758,686,72,0,740,18,1300,542,300,440
24,"IAŞI","#N/A",95060,,204,"IAŞI / ŞCOALA  GIMNAZIALĂ ""OTILIA CAZIMIR""",1,9366,"MUNICIPIUL IAŞI",95060,1126,752,631,120,1,741,11,1200,448,290,451
24,"IAŞI","#N/A",95060,,205,"IAŞI / ŞCOALA  GIMNAZIALĂ ""OTILIA CAZIMIR""",1,9366,"MUNICIPIUL IAŞI",95060,1247,752,635,116,1,737,15,1300,548,307,430
24,"IAŞI","#N/A",95060,,206,"IAŞI / ŞCOALA  GIMNAZIALĂ ""OTILIA CAZIMIR""",1,9366,"MUNICIPIUL IAŞI",95060,1322,841,748,90,3,827,14,1400,559,373,454
24,"IAŞI","#N/A",95060,,207,"IAŞI / COLEGIUL  NATIONAL ""EMIL RACOVIŢĂ""",1,9366,"MUNICIPIUL IAŞI",95060,1462,747,534,212,1,734,13,1500,753,280,454
24,"IAŞI","#N/A",95060,,208,"IAŞI / COLEGIUL  NATIONAL ""EMIL RACOVIŢĂ""",1,9366,"MUNICIPIUL IAŞI",95060,1176,887,659,227,1,861,26,1200,313,366,495
24,"IAŞI","#N/A",95060,,209,"IAŞI / COLEGIUL  NATIONAL ""EMIL RACOVIŢĂ""",1,9366,"MUNICIPIUL IAŞI",95060,1113,775,648,125,2,759,16,1200,425,335,424
24,"IAŞI","#N/A",95060,,210,"IAŞI / COLEGIUL  NATIONAL ""EMIL RACOVIŢĂ""",1,9366,"MUNICIPIUL IAŞI",95060,1124,758,669,89,0,744,14,1200,442,324,420
24,"IAŞI","#N/A",95060,,211,"IAŞI / LICEUL TEORETIC ""DIMITRIE CANTEMIR""",1,9366,"MUNICIPIUL IAŞI",95060,1303,917,779,137,1,899,18,1300,383,402,497
24,"IAŞI","#N/A",95060,,212,"IAŞI / LICEUL TEORETIC ""DIMITRIE CANTEMIR""",1,9366,"MUNICIPIUL IAŞI",95060,1342,826,750,75,1,809,17,1400,574,355,454
24,"IAŞI","#N/A",95060,,213,"IAŞI / LICEUL TEORETIC ""DIMITRIE CANTEMIR""",1,9366,"MUNICIPIUL IAŞI",95060,1271,881,768,113,0,861,20,1300,419,349,512
24,"IAŞI","#N/A",95060,,214,"IAŞI / LICEUL TEORETIC ""DIMITRIE CANTEMIR""",1,9366,"MUNICIPIUL IAŞI",95060,1337,860,779,81,0,847,13,1400,540,353,494
24,"IAŞI","#N/A",95060,,215,"IAŞI / ŞCOALA  GIMNAZIALĂ  ""TITU MAIORESCU""",1,9366,"MUNICIPIUL IAŞI",95060,784,565,429,136,0,559,6,800,235,189,370
24,"IAŞI","#N/A",95060,,216,"IAŞI / ŞCOALA  GIMNAZIALĂ  ""TITU MAIORESCU""",1,9366,"MUNICIPIUL IAŞI",95060,786,517,409,108,0,502,15,784,267,215,287
24,"IAŞI","#N/A",95060,,217,"IAŞI / ŞCOALA  GIMNAZIALĂ  ""TITU MAIORESCU""",1,9366,"MUNICIPIUL IAŞI",95060,1123,633,585,47,1,623,10,1200,567,264,359
24,"IAŞI","#N/A",95060,,218,"IAŞI / GRĂDINIŢA CU PROGRAM PRELUNGIT NR.23",1,9366,"MUNICIPIUL IAŞI",95060,853,721,476,244,1,707,14,899,178,246,461
24,"IAŞI","#N/A",95060,,219,"IAŞI / ŞCOALA  GIMNAZIALĂ ""ION NECULCE""",1,9366,"MUNICIPIUL IAŞI",95060,1305,735,649,86,0,720,15,1400,665,299,421
24,"IAŞI","#N/A",95060,,220,"IAŞI / ŞCOALA  GIMNAZIALĂ ""ION NECULCE""",1,9366,"MUNICIPIUL IAŞI",95060,1087,712,656,56,0,705,7,1200,488,318,387
24,"IAŞI","#N/A",95060,,221,"IAŞI / ŞCOALA  GIMNAZIALĂ ""ION NECULCE""",1,9366,"MUNICIPIUL IAŞI",95060,1148,772,724,48,0,761,11,1200,428,332,429
24,"IAŞI","#N/A",95060,,222,"IAŞI / ŞCOALA  GIMNAZIALĂ ""ION NECULCE""",1,9366,"MUNICIPIUL IAŞI",95060,1200,542,515,27,0,529,13,1300,758,254,275
24,"IAŞI","#N/A",95060,,223,"IAŞI / ŞCOALA  PRIMARA NR.36",1,9366,"MUNICIPIUL IAŞI",95060,831,493,404,89,0,481,12,900,407,168,313
24,"IAŞI","#N/A",95060,,224,"IAŞI / ŞCOALA  PRIMARA NR.36",1,9366,"MUNICIPIUL IAŞI",95060,1282,803,684,119,0,794,9,1300,497,326,468
24,"IAŞI","#N/A",95060,,225,"IAŞI / ŞCOALA  PRIMARA NR.36",1,9366,"MUNICIPIUL IAŞI",95060,1859,894,792,102,0,880,14,1901,1007,363,517
24,"IAŞI","#N/A",95060,,226,"IAŞI / ŞCOALA  GIMNAZIALĂ ""VASILE CONTA""",1,9366,"MUNICIPIUL IAŞI",95060,1483,920,745,175,0,909,11,1500,580,344,565
24,"IAŞI","#N/A",95060,,227,"IAŞI / ŞCOALA  GIMNAZIALĂ ""VASILE CONTA""",1,9366,"MUNICIPIUL IAŞI",95060,1533,896,812,83,1,883,13,1600,704,318,565
24,"IAŞI","#N/A",95060,,228,"IAŞI / ŞCOALA  GIMNAZIALĂ ""VASILE CONTA""",1,9366,"MUNICIPIUL IAŞI",95060,1539,903,724,179,0,887,16,1600,697,301,586
24,"IAŞI","#N/A",95060,,229,"IAŞI / ŞCOALA  GIMNAZIALĂ ""VASILE CONTA""",1,9366,"MUNICIPIUL IAŞI",95060,1557,994,902,91,1,978,16,1600,606,395,583
24,"IAŞI","#N/A",95060,,230,"IAŞI / CENTRUL ŞCOLAR  NR.2 ""ION HOLBAN""",1,9366,"MUNICIPIUL IAŞI",95060,1654,1052,927,124,1,1039,13,1699,647,436,603
24,"IAŞI","#N/A",95060,,231,"IAŞI / CENTRUL ŞCOLAR  NR.2 ""ION HOLBAN""",1,9366,"MUNICIPIUL IAŞI",95060,1339,779,644,135,0,762,17,1400,621,324,438
24,"IAŞI","#N/A",95060,,232,"IAŞI / CENTRUL ŞCOLAR  NR.2 ""ION HOLBAN""",1,9366,"MUNICIPIUL IAŞI",95060,1598,747,646,101,0,735,12,1600,853,312,423
24,"IAŞI","#N/A",95060,,233,"IAŞI / LICEUL TEORETIC ""MIRON COSTIN""",1,9366,"MUNICIPIUL IAŞI",95060,1379,1056,797,258,1,1042,14,1400,344,406,636
24,"IAŞI","#N/A",95060,,234,"IAŞI / LICEUL TEORETIC ""MIRON COSTIN""",1,9366,"MUNICIPIUL IAŞI",95060,1294,916,809,107,0,905,11,1300,384,388,517
24,"IAŞI","#N/A",95060,,235,"IAŞI / LICEUL TEORETIC ""MIRON COSTIN""",1,9366,"MUNICIPIUL IAŞI",95060,1485,821,763,58,0,814,7,1500,679,407,407
24,"IAŞI","#N/A",95060,,236,"IAŞI / LICEUL TEORETIC ""MIRON COSTIN""",1,9366,"MUNICIPIUL IAŞI",95060,1569,923,868,53,2,905,18,1600,677,441,464
24,"IAŞI","#N/A",95391,,237,"PAŞCANI / CASA DE CULTURA  MIHAIL SADOVEANU",1,9368,"MUNICIPIUL PAŞCANI",95391,1304,744,699,44,1,732,12,1400,656,371,361
24,"IAŞI","#N/A",95391,,238,"PAŞCANI / CASA DE CULTURA  MIHAIL SADOVEANU",1,9368,"MUNICIPIUL PAŞCANI",95391,1410,776,728,47,1,758,18,1500,724,446,312
24,"IAŞI","#N/A",95391,,239,"PAŞCANI / SCOALA ION CREANGA",1,9368,"MUNICIPIUL PAŞCANI",95391,1392,797,754,43,0,777,20,1500,703,410,367
24,"IAŞI","#N/A",95391,,240,"PAŞCANI / GRADINITA NR. 1",1,9368,"MUNICIPIUL PAŞCANI",95391,1243,662,631,28,3,650,12,1400,738,407,243
24,"IAŞI","#N/A",95391,,241,"PAŞCANI / SCOALA  NR.3 IORDACHI CANTACUZINO",1,9368,"MUNICIPIUL PAŞCANI",95391,1568,900,859,41,0,885,15,1700,800,439,446
24,"IAŞI","#N/A",95391,,242,"PAŞCANI / SCOALA NR.3 IORDACHI CANTACUZINO",1,9368,"MUNICIPIUL PAŞCANI",95391,1259,731,614,47,70,710,21,1395,664,343,367
24,"IAŞI","#N/A",95391,,243,"PAŞCANI / GRADINITA VATRA",1,9368,"MUNICIPIUL PAŞCANI",95391,1370,711,671,40,0,702,9,1500,789,359,343
24,"IAŞI","#N/A",95391,,244,"PAŞCANI / COLEGIUL NATIONAL MIHAIL SADOVEANU",1,9368,"MUNICIPIUL PAŞCANI",95391,1406,747,705,42,0,739,8,1501,754,425,314
24,"IAŞI","#N/A",95391,,245,"PAŞCANI / COLEGIUL NATIONAL MIHAIL SADOVEANU",1,9368,"MUNICIPIUL PAŞCANI",95391,1445,816,768,48,0,796,20,1600,784,374,422
24,"IAŞI","#N/A",95391,,246,"PAŞCANI / GRADINITA  SIIRETUL",1,9368,"MUNICIPIUL PAŞCANI",95391,1670,794,761,32,1,772,22,1800,1006,419,353
24,"IAŞI","#N/A",95391,,247,"PAŞCANI / SCOALA DE ARTE SI MESERII NICOLAE IORGA",1,9368,"MUNICIPIUL PAŞCANI",95391,1657,922,833,60,29,905,17,1786,864,425,480
24,"IAŞI","#N/A",95391,,248,"PAŞCANI / SCOALA SPECIALA",1,9368,"MUNICIPIUL PAŞCANI",95391,1784,906,880,26,0,877,29,1900,994,514,363
24,"IAŞI","#N/A",95391,,249,"PAŞCANI / COLEGIU TEHNIC DE CAI FERATE UNIREA",1,9368,"MUNICIPIUL PAŞCANI",95391,1597,781,736,45,0,766,15,1700,919,434,332
24,"IAŞI","#N/A",95391,,250,"PAŞCANI / COLEGIU TEHNIC DE CAI FERATE UNIREA",1,9368,"MUNICIPIUL PAŞCANI",95391,1244,644,622,22,0,626,18,1400,756,317,309
24,"IAŞI","#N/A",95391,,251,"PAŞCANI / GRADINITA CU PROGRAM PRELUNGIT NR. 3",1,9368,"MUNICIPIUL PAŞCANI",95391,1135,562,537,25,0,555,7,1200,638,343,212
24,"IAŞI","#N/A",95391,,252,"PAŞCANI / GRADINITA CU PROGRAM PRELUNGIT NR. 3",1,9368,"MUNICIPIUL PAŞCANI",95391,1421,703,668,35,0,685,18,1600,897,387,298
24,"IAŞI","#N/A",95391,,253,"PAŞCANI / LICEUL  MIRON COSTIN",1,9368,"MUNICIPIUL PAŞCANI",95391,1462,738,659,78,1,721,17,1600,862,372,349
24,"IAŞI","#N/A",95391,,254,"PAŞCANI / LICEUL  MIRON COSTIN",1,9368,"MUNICIPIUL PAŞCANI",95391,1365,701,667,34,0,687,14,1500,799,450,237
24,"IAŞI","#N/A",95391,,255,"PAŞCANI / GRUP SCOLAR MIHAI BUSUIOC",1,9368,"MUNICIPIUL PAŞCANI",95391,1346,702,663,38,1,687,15,1500,798,368,319
24,"IAŞI","#N/A",95391,,256,"PAŞCANI / GRUP SCOLAR MIHAI BUSUIOC",1,9368,"MUNICIPIUL PAŞCANI",95391,1171,566,551,15,0,553,13,1300,734,298,255
24,"IAŞI","#N/A",95391,,257,"BLĂGEŞTI / SCOALA BLAGESTI",1,9368,"MUNICIPIUL PAŞCANI",95391,1208,701,664,23,14,682,19,1295,594,384,298
24,"IAŞI","#N/A",95391,,258,"GÂŞTEŞTI / SCOALA GISTESTI",1,9368,"MUNICIPIUL PAŞCANI",95391,1045,546,535,11,0,534,12,1200,654,295,239
24,"IAŞI","#N/A",95391,,259,"GÂŞTEŞTI / GRADINITA GISTESTI",1,9368,"MUNICIPIUL PAŞCANI",95391,1476,802,774,28,0,788,14,1600,798,497,291
24,"IAŞI","#N/A",95391,,260,"LUNCA / SCOALA LUNCA",1,9368,"MUNICIPIUL PAŞCANI",95391,1100,620,604,16,0,616,4,1200,580,487,129
24,"IAŞI","#N/A",95391,,261,"LUNCA / SCOALA LUNCA",1,9368,"MUNICIPIUL PAŞCANI",95391,1054,607,589,18,0,599,8,1200,593,453,146
24,"IAŞI","#N/A",95391,,262,"SODOMENI / SCOALA SODOMENI",1,9368,"MUNICIPIUL PAŞCANI",95391,998,542,526,15,1,536,6,1100,558,342,194
24,"IAŞI","#N/A",95391,,263,"BOŞTENI / SCOALA BOSTENI",1,9368,"MUNICIPIUL PAŞCANI",95391,1185,690,670,20,0,684,6,1300,610,422,262
24,"IAŞI","#N/A",95355,,264,"HÎRLĂU / Liceul Tehnologic Hîrlău",1,9375,"ORAŞ HÎRLĂU",95355,1448,694,627,53,14,681,13,1600,906,487,194
24,"IAŞI","#N/A",95355,,265,"HÎRLĂU / Colegiul Naţional Ştefan cel Mare Hîrlău",1,9375,"ORAŞ HÎRLĂU",95355,1250,662,589,50,23,653,9,1400,738,439,214
24,"IAŞI","#N/A",95355,,266,"HÎRLĂU / Şcoala Gimnazială Petru Rareş - corp vechi",1,9375,"ORAŞ HÎRLĂU",95355,1342,740,689,50,1,731,9,1500,760,440,291
24,"IAŞI","#N/A",95355,,267,"HÎRLĂU / Şcoala Gimnazială Petru Rareş-corp grădiniţă cu program prelungit",1,9375,"ORAŞ HÎRLĂU",95355,1331,743,699,44,0,738,5,1500,757,447,291
24,"IAŞI","#N/A",95355,,268,"HÎRLĂU / Şcoala Gimnazială Petru Rareş - corp nou",1,9375,"ORAŞ HÎRLĂU",95355,1443,822,782,40,0,809,13,1600,778,587,222
24,"IAŞI","#N/A",95355,,269,"PÎRCOVACI / Şcoala Gimnazială Pîrcovaci - corp gradiniţă",1,9375,"ORAŞ HÎRLĂU",95355,1469,901,879,22,0,891,10,1600,699,696,195
24,"IAŞI","#N/A",95355,,270,"PÎRCOVACI / Şcoala Gimnazială Pîrcovaci - corp şcoală",1,9375,"ORAŞ HÎRLĂU",95355,1263,690,679,11,0,680,10,1400,710,539,141
24,"IAŞI","#N/A",98373,,271,"PODU ILOAIEI / ŞCOALA AL. I. CUZA",1,9378,"ORAŞ PODU ILOAIEI",98373,839,406,389,17,0,402,4,900,494,157,245
24,"IAŞI","#N/A",98373,,272,"PODU ILOAIEI / ŞCOALA AL. I. CUZA",1,9378,"ORAŞ PODU ILOAIEI",98373,1308,662,633,29,0,646,16,1500,838,261,385
24,"IAŞI","#N/A",98373,,273,"PODU ILOAIEI / ŞCOALA AL. I. CUZA",1,9378,"ORAŞ PODU ILOAIEI",98373,888,476,419,57,0,469,7,1000,524,267,202
24,"IAŞI","#N/A",98373,,274,"PODU ILOAIEI / ŞCOALA AL. I. CUZA",1,9378,"ORAŞ PODU ILOAIEI",98373,896,470,425,45,0,456,14,1000,530,208,248
24,"IAŞI","#N/A",98373,,275,"PODU ILOAIEI / ŞCOALA AL. I. CUZA",1,9378,"ORAŞ PODU ILOAIEI",98373,897,437,415,22,0,425,12,1000,563,187,238
24,"IAŞI","#N/A",98373,,276,"PODU ILOAIEI / ŞCOALA AL. I. CUZA",1,9378,"ORAŞ PODU ILOAIEI",98373,943,465,441,24,0,458,7,1000,535,171,287
24,"IAŞI","#N/A",98373,,277,"PODU ILOAIEI / ŞCOALA HENCI",1,9378,"ORAŞ PODU ILOAIEI",98373,433,207,184,23,0,204,3,500,293,92,112
24,"IAŞI","#N/A",98373,,278,"HOLM / ŞCOALA HOLM",1,9378,"ORAŞ PODU ILOAIEI",98373,225,119,105,14,0,117,2,300,181,48,69
24,"IAŞI","#N/A",98373,,279,"SCOBÂLŢENI / ŞCOALA SCOBÂLŢENI",1,9378,"ORAŞ PODU ILOAIEI",98373,916,418,394,24,0,417,1,1000,582,200,217
24,"IAŞI","#N/A",98373,,280,"BUDĂI / ŞCOALA BUDĂI",1,9378,"ORAŞ PODU ILOAIEI",98373,696,391,354,37,0,388,3,800,409,169,219
24,"IAŞI","#N/A",98373,,281,"COSIŢENI / ŞCOALA COSIŢENI",1,9378,"ORAŞ PODU ILOAIEI",98373,250,161,137,24,0,160,1,285,124,99,61
24,"IAŞI","#N/A",95471,,282,"TÂRGU FRUMOS / SCOALA GENERALA ION CREANGA",1,9384,"ORAŞ TÂRGU FRUMOS",95471,1673,854,814,40,0,842,12,1776,922,472,370
24,"IAŞI","#N/A",95471,,283,"TÂRGU FRUMOS / SCOALA GENERALA ION CREANGA",1,9384,"ORAŞ TÂRGU FRUMOS",95471,844,415,348,67,0,410,5,900,485,250,160
24,"IAŞI","#N/A",95471,,284,"TÂRGU FRUMOS / SCOALA GENERALA GARABET IBRAILEANU",1,9384,"ORAŞ TÂRGU FRUMOS",95471,1468,614,571,42,1,606,8,1600,986,341,265
24,"IAŞI","#N/A",95471,,285,"TÂRGU FRUMOS / SCOALA GENERALA GARABET IBRAILEANU",1,9384,"ORAŞ TÂRGU FRUMOS",95471,1234,626,581,45,0,619,7,1400,774,320,299
24,"IAŞI","#N/A",95471,,286,"TÂRGU FRUMOS / COMPLEX SERVICII SOCIALE  PENTRU COPII - TARGU FRUMOS",1,9384,"ORAŞ TÂRGU FRUMOS",95471,1497,798,761,35,2,778,20,1600,802,406,372
24,"IAŞI","#N/A",95471,,287,"TÂRGU FRUMOS / CASA DE CULTURA ""GARABET IBRAILEANU""",1,9384,"ORAŞ TÂRGU FRUMOS",95471,1676,829,763,66,0,814,15,1800,971,365,449
24,"IAŞI","#N/A",95471,,288,"TÂRGU FRUMOS / CASA DE CULTURA ""GARABET IBRAILEANU""",1,9384,"ORAŞ TÂRGU FRUMOS",95471,1826,932,869,62,1,919,13,2000,1068,489,430
24,"IAŞI","#N/A",95471,,289,"TÂRGU FRUMOS / LICEUL TEORETIC ""ION NECULCE""",1,9384,"ORAŞ TÂRGU FRUMOS",95471,1468,874,736,135,3,859,15,1600,726,441,418
24,"IAŞI","#N/A",95612,,290,"ALEXANDRU I. CUZA / Scoala primara Al.I.Cuza",3,9386,"ALEXANDRU I. CUZA",95612,604,436,362,66,8,431,5,700,264,327,104
24,"IAŞI","#N/A",95612,,291,"SCHEIA / Scoala gimnaziala Scheia",3,9386,"ALEXANDRU I. CUZA",95612,1073,547,482,56,9,541,6,1200,653,403,138
24,"IAŞI","#N/A",95612,,292,"VOLINTIREŞTI / Scoala primara Volintiresti",3,9386,"ALEXANDRU I. CUZA",95612,617,454,392,57,5,449,5,715,261,387,62
24,"IAŞI","#N/A",95667,,293,"ANDRIEŞENI / SCOALA GH. CIOBANU ANDRIESENI",3,9391,"ANDRIEŞENI",95667,1334,831,769,61,1,817,14,1500,669,367,450
24,"IAŞI","#N/A",95667,,294,"BUHĂENI / SCOALA BUHAENI",3,9391,"ANDRIEŞENI",95667,531,276,237,39,0,269,7,600,324,150,119
24,"IAŞI","#N/A",95667,,295,"SPINENI / SCOLA SPINENI",3,9391,"ANDRIEŞENI",95667,813,475,406,69,0,468,7,900,425,295,173
24,"IAŞI","#N/A",95667,,296,"GLĂVĂNEŞTI / SCOALA GLAVANESTI",3,9391,"ANDRIEŞENI",95667,562,274,246,28,0,271,3,600,326,154,117
24,"IAŞI","#N/A",95747,,297,"ARONEANU / SCOALA ARON VODA",3,9399,"ARONEANU",95747,1164,829,661,168,0,818,11,1286,457,313,505
24,"IAŞI","#N/A",95747,,298,"DOROBANŢ / SCOALA DOROBANŢ",3,9399,"ARONEANU",95747,1079,668,579,89,0,654,14,1200,532,222,432
24,"IAŞI","#N/A",95747,,299,"REDIU ALDEI / SCOALA  REDIU  ALDEI",3,9399,"ARONEANU",95747,330,231,207,24,0,228,3,410,179,75,153
24,"IAŞI","#N/A",95747,,300,"ŞOROGARI / Baza Sportivă Multifuncţională - ŞOROGARI",3,9399,"ARONEANU",95747,338,194,124,70,0,193,1,408,214,57,136
24,"IAŞI","#N/A",100273,,301,"BALŞ / Scoala Gimnaziala clasele I-VIII Bals",3,9404,"BALŞ",100273,1149,581,543,38,0,573,8,1300,719,422,151
24,"IAŞI","#N/A",100273,,302,"BOURENI / Scoala Gimnaziala clasele I-VIII Boureni",3,9404,"BALŞ",100273,1345,687,648,39,0,675,12,1500,813,444,231
24,"IAŞI","#N/A",100273,,303,"COASTA MĂGURII / Scoala Primara clasele I-IV Coasta Magurii",3,9404,"BALŞ",100273,185,91,76,15,0,88,3,200,109,51,37
24,"IAŞI","#N/A",95792,,304,"BĂLŢAŢI / Centru de zi Bălţaţi",3,9408,"BĂLŢAŢI",95792,1493,883,814,64,5,874,9,1600,717,459,415
24,"IAŞI","#N/A",95792,,305,"MĂDÎRJEŞTI / Şcoala Primară - sat Mădîrjeşti",3,9408,"BĂLŢAŢI",95792,974,518,437,61,20,512,6,1100,582,258,254
24,"IAŞI","#N/A",95792,,306,"PODIŞU / Şcoala Primară - sat Podişu",3,9408,"BĂLŢAŢI",95792,468,274,246,28,0,273,1,500,226,145,128
24,"IAŞI","#N/A",95792,,307,"SÎRCA / Şcoala Gimnazială - sat Sîrca",3,9408,"BĂLŢAŢI",95792,838,533,491,42,0,531,2,951,418,249,282
24,"IAŞI","#N/A",95792,,308,"VALEA OILOR / Şcoala Gimnazială - sat Valea Oilor",3,9408,"BĂLŢAŢI",95792,521,340,303,27,10,332,8,600,260,175,157
24,"IAŞI","#N/A",95872,,309,"BELCEŞTI / Scoal Belceşti",3,9416,"BELCEŞTI",95872,1403,661,614,47,0,654,7,1500,839,405,249
24,"IAŞI","#N/A",95872,,310,"BELCEŞTI / Scoal Belceşti",3,9416,"BELCEŞTI",95872,882,475,416,59,0,472,3,1000,525,274,198
24,"IAŞI","#N/A",95872,,311,"BELCEŞTI / Scoala Rusi",3,9416,"BELCEŞTI",95872,1251,642,565,77,0,635,7,1400,758,381,254
24,"IAŞI","#N/A",95872,,312,"SATU NOU / Şcoala Satu - Nou",3,9416,"BELCEŞTI",95872,1539,734,678,56,0,722,12,1700,966,447,275
24,"IAŞI","#N/A",95872,,313,"MUNTENI / Şcoala Munteni",3,9416,"BELCEŞTI",95872,876,424,377,47,0,421,3,1000,576,307,114
24,"IAŞI","#N/A",95872,,314,"TANSA / Magazin CONSUMCOOP",3,9416,"BELCEŞTI",95872,842,439,389,50,0,431,8,900,461,266,165
24,"IAŞI","#N/A",95872,,315,"LITENI / Şcoala Liteni",3,9416,"BELCEŞTI",95872,1076,526,483,43,0,522,4,1200,674,324,198
24,"IAŞI","#N/A",95872,,316,"ULMI / Scoala Ulmi",3,9416,"BELCEŞTI",95872,530,329,298,31,0,325,4,600,271,152,173
24,"IAŞI","#N/A",95943,,317,"BIVOLARI / ŞCOALA GIMNAZIALĂ CU CLASELE I-VIII BIVOLARI",3,9430,"BIVOLARI",95943,946,459,412,47,0,453,6,1000,541,262,191
24,"IAŞI","#N/A",95943,,318,"BIVOLARI / ŞCOALA GIMNAZIALĂ CU CLASELE I-VIII BIVOLARI",3,9430,"BIVOLARI",95943,929,454,405,23,26,449,5,1000,546,271,178
24,"IAŞI","#N/A",95943,,319,"TABĂRA / ŞCOALA GIMNAZIALĂ CU CLASELE I-VIII TABĂRA",3,9430,"BIVOLARI",95943,938,487,407,80,0,486,1,1000,513,329,157
24,"IAŞI","#N/A",95943,,320,"SOLONEŢ / ŞCOALA CU CLASELE I - IV SOLONEŢ",3,9430,"BIVOLARI",95943,583,308,278,29,1,306,2,600,292,214,92
24,"IAŞI","#N/A",95088,,321,"BÎRNOVA / CAMIN  CULTURAL BIRNOVA",3,9423,"BÎRNOVA",95088,1023,716,546,169,1,698,18,1100,384,345,353
24,"IAŞI","#N/A",95088,,322,"CERCU / SCOALA PRIMARA CERCU",3,9423,"BÎRNOVA",95088,497,289,251,38,0,282,7,500,211,113,169
24,"IAŞI","#N/A",95088,,323,"PĂUN / CAMIN CULTURAL PAUN",3,9423,"BÎRNOVA",95088,984,704,530,174,0,698,6,1100,396,295,403
24,"IAŞI","#N/A",95088,,324,"PIETRĂRIA / SCOALA PRIMARA PIETRARIA",3,9423,"BÎRNOVA",95088,683,438,348,90,0,430,8,679,241,170,260
24,"IAŞI","#N/A",95088,,325,"TODIREL / SCOALA PRIMARA TODIREL",3,9423,"BÎRNOVA",95088,432,281,242,39,0,278,3,500,219,125,153
24,"IAŞI","#N/A",95088,,326,"VIŞAN / SCOALA PRIMARA VISAN",3,9423,"BÎRNOVA",95088,1013,457,409,48,0,456,1,1100,643,168,288
24,"IAŞI","#N/A",96058,,327,"BRĂEŞTI / LICEUL TEHNOLOGIC BRAESTI",3,9436,"BRĂEŞTI",96058,894,451,399,52,0,437,14,1000,549,235,202
24,"IAŞI","#N/A",96058,,328,"BUDA / Scoala cu Clasele I-IV",3,9436,"BRĂEŞTI",96058,195,112,97,15,0,110,2,200,88,50,60
24,"IAŞI","#N/A",96058,,329,"CRISTEŞTI / ŞCOALA GENERALĂ CRISTEŞTI",3,9436,"BRĂEŞTI",96058,784,379,349,30,0,375,4,900,521,180,195
24,"IAŞI","#N/A",96058,,330,"ALBEŞTI / ŞCOALA CU CL. I-IV ALBEŞTI",3,9436,"BRĂEŞTI",96058,529,278,245,33,0,275,3,600,322,188,87
24,"IAŞI","#N/A",96110,,331,"BUTEA / CAMIN CULTURAL BUTEA",3,9442,"BUTEA",96110,1643,557,508,49,0,555,2,1793,1236,250,305
24,"IAŞI","#N/A",96110,,332,"BUTEA / GRADINITA BUTEA",3,9442,"BUTEA",96110,1568,530,495,33,2,521,9,1698,1168,254,267
24,"IAŞI","#N/A",96110,,333,"MICLĂUŞENI / SCOALA PRIMARA MICLAUSENI",3,9442,"BUTEA",96110,317,160,122,38,0,156,4,389,229,94,62
24,"IAŞI","#N/A",96147,,334,"CEPLENIŢA / SCOALA GIMNAZIALA ""GRICORE URECHE"" CEPLENITA",3,9445,"CEPLENIŢA",96147,1184,628,589,38,1,618,10,1300,672,384,234
24,"IAŞI","#N/A",96147,,335,"BUHALNIŢA / SCOALA GIMNAZIALA ""NICOLAE IORGA"" BUHALNITA",3,9445,"CEPLENIŢA",96147,1226,644,600,43,1,639,5,1300,656,383,256
24,"IAŞI","#N/A",96147,,336,"POIANA MĂRULUI / SCOALA GIMNAZIALA POIANA MARULUI",3,9445,"CEPLENIŢA",96147,781,410,376,34,0,406,4,900,490,216,190
24,"IAŞI","#N/A",96147,,337,"ZLODICA / GRADINITA CU PROGRAM NORMAL ZLODICA",3,9445,"CEPLENIŢA",96147,241,144,126,18,0,139,5,300,156,62,77
24,"IAŞI","#N/A",100362,,338,"CIOHORĂNI / Căminul Cultural Ciohorăni",3,9450,"CIOHORĂNI",100362,1508,834,776,52,6,818,16,1600,766,620,198
24,"IAŞI","#N/A",96192,,339,"CIORTEŞTI / CAMINUL CULTURAL",3,9452,"CIORTEŞTI",96192,967,520,463,57,0,515,5,1100,580,372,143
24,"IAŞI","#N/A",96192,,340,"COROPCENI / ;COALA COROPCENI",3,9452,"CIORTEŞTI",96192,924,520,491,29,0,512,8,1000,480,336,176
24,"IAŞI","#N/A",96192,,341,"DELENI / ŞCOALA DELENI",3,9452,"CIORTEŞTI",96192,412,233,215,18,0,230,3,501,268,151,79
24,"IAŞI","#N/A",96192,,342,"ROTĂRIA / ŞCOALA ROTĂRIA",3,9452,"CIORTEŞTI",96192,314,191,174,17,0,190,1,394,203,160,30
24,"IAŞI","#N/A",96192,,343,"ŞERBEŞTI / ŞCOALA ŞERBEŞTI",3,9452,"CIORTEŞTI",96192,661,365,341,24,0,355,10,700,335,268,87
24,"IAŞI","#N/A",96254,,344,"CIUREA / SCOALA  CIUREA",3,9458,"CIUREA",96254,1007,496,463,33,0,490,6,1100,604,238,252
24,"IAŞI","#N/A",96254,,345,"CIUREA / SCOALA  CIUREA",3,9458,"CIUREA",96254,994,504,471,33,0,499,5,1100,596,209,290
24,"IAŞI","#N/A",96254,,346,"CURĂTURI / SCOALA  CURATURI",3,9458,"CIUREA",96254,201,139,106,32,1,137,2,289,150,73,64
24,"IAŞI","#N/A",96254,,347,"DUMBRAVA / CORP C SCOALA DUMBRAVA",3,9458,"CIUREA",96254,1111,593,546,47,0,586,7,1200,607,241,345
24,"IAŞI","#N/A",96254,,348,"HLINCEA / PROPR  MACOVEI",3,9458,"CIUREA",96254,349,271,183,88,0,269,2,406,135,88,181
24,"IAŞI","#N/A",96254,,349,"LUNCA CETĂŢUII / SCOALA NR.1 LUNCA  CETATUII",3,9458,"CIUREA",96254,1098,722,562,160,0,717,5,1200,478,271,446
24,"IAŞI","#N/A",96254,,350,"LUNCA CETĂŢUII / SCOALA NR.1 LUNCA  CETATUII",3,9458,"CIUREA",96254,1347,789,720,69,0,779,10,1500,711,313,466
24,"IAŞI","#N/A",96254,,351,"LUNCA CETĂŢUII / SCOALA NR.1 LUNCA  CETATUII",3,9458,"CIUREA",96254,1578,885,817,66,2,878,7,1699,814,350,528
24,"IAŞI","#N/A",96254,,352,"LUNCA CETĂŢUII / SCOALA NR.1 LUNCA  CETATUII",3,9458,"CIUREA",96254,1724,973,926,47,0,965,8,1800,827,310,655
24,"IAŞI","#N/A",96254,,353,"LUNCA CETĂŢUII / SCOALA NR.2 LUNCA CETAŢUII(  ZANEA)",3,9458,"CIUREA",96254,471,303,290,13,0,291,12,500,197,266,25
24,"IAŞI","#N/A",96254,,354,"PICIORU LUPULUI / SCOALA PICIORU LUPULUI",3,9458,"CIUREA",96254,491,294,255,38,1,289,5,500,206,173,116
24,"IAŞI","#N/A",96254,,355,"SLOBOZIA / SCOALA  SLOBOZIA",3,9458,"CIUREA",96254,375,247,218,29,0,243,4,396,149,139,104
24,"IAŞI","#N/A",96334,,356,"COARNELE CAPREI / SCOALA gENERALA Nr. 1",3,9466,"COARNELE CAPREI",96334,949,474,453,16,5,471,3,1000,526,378,93
24,"IAŞI","#N/A",96334,,357,"COARNELE CAPREI / Scoala Generala Nr.1",3,9466,"COARNELE CAPREI",96334,837,438,407,25,6,436,2,900,462,362,74
24,"IAŞI","#N/A",96334,,358,"ARAMA / ŞCOALA ARAMA",3,9466,"COARNELE CAPREI",96334,382,228,203,16,9,225,3,400,172,162,63
24,"IAŞI","#N/A",96334,,359,"PETROŞICA / ŞCOALA PIETROŞICA",3,9466,"COARNELE CAPREI",96334,76,57,39,18,0,57,0,97,40,52,5
24,"IAŞI","#N/A",96370,,360,"OSOI / ŞCOALA OSOI",3,9470,"COMARNA",96370,1574,1005,848,141,16,994,11,1706,701,464,530
24,"IAŞI","#N/A",96370,,361,"STÎNCA / ŞCOALA STÂNCA",3,9470,"COMARNA",96370,182,113,87,26,0,112,1,215,102,74,38
24,"IAŞI","#N/A",96370,,362,"COMARNA / SCOALA CLASELE I-VII COMARNA I",3,9470,"COMARNA",96370,1604,669,542,92,35,660,9,1700,1031,341,319
24,"IAŞI","#N/A",96370,,363,"COMARNA / SCOALA CLASELE I-IV COMARNA II",3,9470,"COMARNA",96370,754,526,416,100,10,519,7,801,275,310,209
24,"IAŞI","#N/A",96370,,364,"CURAGĂU / ŞCOALA CURAGĂU",3,9470,"COMARNA",96370,114,96,76,20,0,95,1,201,105,69,26
24,"IAŞI","#N/A",100282,,365,"COSTEŞTI / SCOALA GIMNAZIALA NR.1 COSTESTI",3,9475,"COSTEŞTI",100282,1068,694,626,68,0,678,16,1200,506,517,161
24,"IAŞI","#N/A",100282,,366,"GIURGEŞTI / SCOALA PRIMARA GIURGESTI",3,9475,"COSTEŞTI",100282,364,221,183,38,0,220,1,409,188,152,68
24,"IAŞI","#N/A",96423,,367,"COSTULENI / Scoala Costuleni",3,9478,"COSTULENI",96423,1361,715,634,81,0,709,6,1500,785,522,187
24,"IAŞI","#N/A",96423,,368,"COVASNA / Scoala Covasna",3,9478,"COSTULENI",96423,953,577,522,55,0,567,10,1100,523,429,138
24,"IAŞI","#N/A",96423,,369,"COZIA / Scoala Cozia",3,9478,"COSTULENI",96423,893,499,444,52,3,492,7,1000,501,283,209
24,"IAŞI","#N/A",96423,,370,"HILIŢA / Scoala Hilita",3,9478,"COSTULENI",96423,602,347,312,35,0,339,8,700,353,185,154
24,"IAŞI","#N/A",96478,,371,"COTNARI / CAMIN CULTURAL COTNARI",3,9483,"COTNARI",96478,1466,753,679,74,0,738,15,1600,847,343,395
24,"IAŞI","#N/A",96478,,372,"BAHLUIU / CASA DE PRAZNUIRE BAHLUI",3,9483,"COTNARI",96478,257,128,107,21,0,126,2,300,172,76,50
24,"IAŞI","#N/A",96478,,373,"HODORA / SCOALA HODORA",3,9483,"COTNARI",96478,1273,598,562,36,0,595,3,1400,802,415,180
24,"IAŞI","#N/A",96478,,374,"HORODIŞTEA / SCOALA HORODISTEA",3,9483,"COTNARI",96478,482,242,199,43,0,240,2,500,258,151,89
24,"IAŞI","#N/A",96478,,375,"CÎRJOAIA / SCOALA CIRJOAIA",3,9483,"COTNARI",96478,1400,628,586,42,0,621,7,1500,872,341,280
24,"IAŞI","#N/A",96478,,376,"VALEA RACULUI / SCOALA VALEA RACULUI",3,9483,"COTNARI",96478,274,137,124,13,0,133,3,300,163,73,60
24,"IAŞI","#N/A",96478,,377,"ZBERENI / SCOALA ZBERENI",3,9483,"COTNARI",96478,630,291,264,27,0,285,6,700,409,165,120
24,"IAŞI","#N/A",96478,,378,"LUPĂRIA / SCOALA LUPARIA",3,9483,"COTNARI",96478,285,171,148,23,0,171,0,300,129,125,46
24,"IAŞI","#N/A",96593,,379,"COZMEŞTI / GRUP ŞCOLAR  COZMESTI",3,9495,"COZMEŞTI",96593,1214,703,632,71,0,680,23,1300,597,395,285
24,"IAŞI","#N/A",96593,,380,"PODOLENII DE SUS / SCOALA NOUĂ PODOLENII DE SUS",3,9495,"COZMEŞTI",96593,778,418,384,34,0,415,3,898,480,212,203
24,"IAŞI","#N/A",96593,,381,"PODOLENII DE JOS / SCOALA  PODOLENII DE JOS",3,9495,"COZMEŞTI",96593,260,171,146,25,0,169,2,300,129,85,84
24,"IAŞI","#N/A",96637,,382,"CRISTEŞTI / Liceul Tehnologic Cristeşti",3,9499,"CRISTEŞTI",96637,1288,716,682,34,0,692,24,1400,684,570,122
24,"IAŞI","#N/A",96637,,383,"CRISTEŞTI / Liceul Tehnologic Cristeşti",3,9499,"CRISTEŞTI",96637,1061,570,542,27,1,566,4,1200,630,452,114
24,"IAŞI","#N/A",96637,,384,"CRISTEŞTI / Şcoala Hereşti",3,9499,"CRISTEŞTI",96637,610,383,348,35,0,379,4,700,317,300,79
24,"IAŞI","#N/A",96637,,385,"HOMIŢA / şcoala Homiţa",3,9499,"CRISTEŞTI",96637,290,196,160,36,0,193,3,300,104,142,51
24,"IAŞI","#N/A",96664,,386,"CUCUTENI / GRĂDINIŢA CUCUTENI",3,9502,"CUCUTENI",96664,694,381,300,42,39,377,4,800,419,251,126
24,"IAŞI","#N/A",96664,,387,"BĂRBĂTEŞTI / ŞCOALA SĂCĂREŞTI",3,9502,"CUCUTENI",96664,355,260,196,35,29,256,4,400,140,204,52
24,"IAŞI","#N/A",96717,,388,"DAGÎŢA / Scoala Profesionala",3,9507,"DAGÎŢA",96717,1305,778,707,71,0,771,7,1400,622,362,409
24,"IAŞI","#N/A",96717,,389,"MĂNĂSTIREA / Scoala Minastirea",3,9507,"DAGÎŢA",96717,943,475,431,44,0,470,5,1000,525,294,176
24,"IAŞI","#N/A",96717,,390,"BĂLUŞEŞTI / Scoala Balusesti",3,9507,"DAGÎŢA",96717,147,112,90,22,0,112,0,200,88,68,44
24,"IAŞI","#N/A",96717,,391,"BOATCA / Scoala  Boatca",3,9507,"DAGÎŢA",96717,204,136,122,14,0,136,0,300,164,50,86
24,"IAŞI","#N/A",96717,,392,"PISCU RUSULUI / Scoala Piscu Rusului",3,9507,"DAGÎŢA",96717,394,206,182,24,0,205,1,393,187,91,114
24,"IAŞI","#N/A",96717,,393,"POIENILE / Scoala Poienile",3,9507,"DAGÎŢA",96717,201,144,127,17,0,144,0,300,156,24,120
24,"IAŞI","#N/A",96717,,394,"ZECE PRĂJINI / Scoala Zece Prajini",3,9507,"DAGÎŢA",96717,397,233,209,24,0,226,7,400,167,87,139
24,"IAŞI","#N/A",96815,,395,"DELENI / SCOALA DELENI",3,9517,"DELENI",96815,1597,805,751,54,0,793,12,1700,895,415,378
24,"IAŞI","#N/A",96815,,396,"DELENI / GRADINITA DELENI",3,9517,"DELENI",96815,1745,852,813,39,0,844,8,1900,1048,408,436
24,"IAŞI","#N/A",96815,,397,"MAXUT / SCOALA MAXUT",3,9517,"DELENI",96815,1050,551,516,35,0,541,10,1200,649,319,222
24,"IAŞI","#N/A",96815,,398,"MAXUT / GRADINITA MAXUT",3,9517,"DELENI",96815,794,407,372,34,1,400,7,900,493,246,154
24,"IAŞI","#N/A",96815,,399,"SLOBOZIA / GRADINITA SLOBOZIA",3,9517,"DELENI",96815,1002,465,440,25,0,461,4,1100,635,265,196
24,"IAŞI","#N/A",96815,,400,"FEREDENI / SCOALA FEREDENI",3,9517,"DELENI",96815,676,378,349,29,0,375,3,700,322,185,190
24,"IAŞI","#N/A",96815,,401,"POIANA / GRADINITA POIANA",3,9517,"DELENI",96815,923,510,464,46,0,506,4,1000,490,292,214
24,"IAŞI","#N/A",96888,,402,"DOBROVĂŢ / ŞCOALA GENERALĂ NR.1 MOLDOVENI",3,9524,"DOBROVĂŢ",96888,1136,648,558,85,5,637,11,1300,652,427,210
24,"IAŞI","#N/A",96888,,403,"DOBROVĂŢ / CENTRU DE ZI AFRER SCOOL RUSI",3,9524,"DOBROVĂŢ",96888,810,456,398,56,2,449,7,900,444,301,148
24,"IAŞI","#N/A",96904,,404,"DOLHEŞTI / ŞCOALA DOLHEŞTI",3,9526,"DOLHEŞTI",96904,572,365,340,25,0,363,2,600,235,160,203
24,"IAŞI","#N/A",96904,,405,"BRĂDICEŞTI / ŞCOALA BRĂDICEŞTI",3,9526,"DOLHEŞTI",96904,824,478,417,61,0,469,9,900,422,257,212
24,"IAŞI","#N/A",96904,,406,"PIETRIŞ / ŞCOALA PIETRIŞ",3,9526,"DOLHEŞTI",96904,741,381,351,30,0,373,8,800,419,229,144
24,"IAŞI","#N/A",100308,,407,"DRĂGUŞENI / Grădiniţă Drăguşeni",3,9530,"DRAGUŞENI",100308,738,363,334,29,0,362,1,800,437,268,94
24,"IAŞI","#N/A",100308,,408,"FRENCIUGI / Şcola Frenciugi",3,9530,"DRAGUŞENI",100308,418,220,188,32,0,218,2,500,280,120,98
24,"IAŞI","#N/A",96940,,409,"DUMEŞTI / SCOALA DUMESTI",3,9533,"DUMEŞTI",96940,1411,763,679,83,1,749,14,1506,743,432,317
24,"IAŞI","#N/A",96940,,410,"PĂUŞEŞTI / SCOALA PAUSESTI",3,9533,"DUMEŞTI",96940,1287,707,673,34,0,699,8,1383,676,502,197
24,"IAŞI","#N/A",96940,,411,"CHILIŞOAIA / SCOALA CHILISOAIA",3,9533,"DUMEŞTI",96940,139,95,74,21,0,95,0,200,105,72,23
24,"IAŞI","#N/A",96940,,412,"HOISEŞTI / SCOALA HOISESTI",3,9533,"DUMEŞTI",96940,639,327,296,31,0,323,4,700,373,175,148
24,"IAŞI","#N/A",96940,,413,"BANU / SCOALA BANU",3,9533,"DUMEŞTI",96940,328,187,165,22,0,186,1,369,182,100,86
24,"IAŞI","#N/A",97009,,414,"ERBICENI / SCOALA GENERALA ERBICENI CORP CLADIRE",3,9539,"ERBICENI",97009,862,470,432,38,0,468,2,1000,530,263,205
24,"IAŞI","#N/A",97009,,415,"ERBICENI / SCOALA GENERALA ERBICENI CORP CLADIRE",3,9539,"ERBICENI",97009,1069,558,520,38,0,547,11,1200,642,317,230
24,"IAŞI","#N/A",97009,,416,"BÎRLEŞTI / SCOALA GENERALA BIRLESTI",3,9539,"ERBICENI",97009,560,313,267,46,0,309,4,616,303,183,126
24,"IAŞI","#N/A",97009,,417,"TOTOEŞTI / SCOALA GENERALA  TOTOESTI",3,9539,"ERBICENI",97009,1300,644,589,53,2,635,9,1400,756,357,278
24,"IAŞI","#N/A",97009,,418,"SPINOASA / SCOALA GENERALA SPINOASA",3,9539,"ERBICENI",97009,236,158,124,34,0,154,4,300,142,76,78
24,"IAŞI","#N/A",97009,,419,"SPRÎNCEANA / SCOALA GENERALA SPRINCEANA",3,9539,"ERBICENI",97009,302,172,151,21,0,172,0,400,228,101,71
24,"IAŞI","#N/A",100317,,420,"FÂNTÂNELE / GRĂDINIŢA NR.1 FÂNTÂNELE",3,9545,"FÂNTÂNELE",100317,1518,948,898,40,10,940,8,1600,652,756,184
24,"IAŞI","#N/A",97063,,421,"FOCURI / CĂMINUL CULTURAL",3,9547,"FOCURI",97063,1597,721,638,83,0,709,12,1700,979,470,239
24,"IAŞI","#N/A",97063,,422,"FOCURI / GRĂDINIŢA NR. 2, PĂŞCĂNENI",3,9547,"FOCURI",97063,1424,669,603,66,0,661,8,1600,931,450,211
24,"IAŞI","#N/A",97090,,423,"GOLĂIEŞTI / SCOALA CU CLASELE I-VIII",3,9549,"GOLĂIEŞTI",97090,1523,798,748,49,1,793,5,1700,902,478,315
24,"IAŞI","#N/A",97090,,424,"CILIBIU / SCOALA GRADINARI",3,9549,"GOLĂIEŞTI",97090,707,420,372,48,0,417,3,800,380,264,153
24,"IAŞI","#N/A",97090,,425,"COTU LUI IVAN / SCOALA  COTU LUI IVAN",3,9549,"GOLĂIEŞTI",97090,308,186,168,18,0,186,0,400,214,147,39
24,"IAŞI","#N/A",97090,,426,"PETREŞTI / SCOALA PETRESTI",3,9549,"GOLĂIEŞTI",97090,242,165,146,19,0,164,1,300,135,139,25
24,"IAŞI","#N/A",97090,,427,"PODU JIJIEI / SCOALA PODU JIJIEI",3,9549,"GOLĂIEŞTI",97090,205,149,129,20,0,149,0,300,151,111,38
24,"IAŞI","#N/A",97189,,428,"GORBAN / CĂMINUL CULTURAL",3,9558,"GORBAN",97189,603,336,284,49,3,335,1,713,377,211,124
24,"IAŞI","#N/A",97189,,429,"PODU HAGIULUI / ŞCOALA PRIMARĂ",3,9558,"GORBAN",97189,518,270,242,28,0,260,10,600,330,125,135
24,"IAŞI","#N/A",97189,,430,"SCOPOSENI / ŞCOALA PRIMARĂ",3,9558,"GORBAN",97189,592,343,312,31,0,340,3,698,355,223,117
24,"IAŞI","#N/A",97189,,431,"ZBEROAIA / ŞCOALA PRIMARĂ",3,9558,"GORBAN",97189,271,163,149,14,0,160,3,301,138,114,46
24,"IAŞI","#N/A",97189,,432,"GURA BOHOTIN / ŞCOALA GIMNAZIALĂ",3,9558,"GORBAN",97189,402,216,198,18,0,215,1,519,303,148,67
24,"IAŞI","#N/A",97241,,433,"GRAJDURI / SCOALA GENERALA GRAJDURI",3,9564,"GRAJDURI",97241,1689,543,494,49,0,537,6,1800,1257,311,226
24,"IAŞI","#N/A",97241,,434,"VALEA SATULUI / SC.GENERALA",3,9564,"GRAJDURI",97241,1886,311,285,26,0,305,6,1900,1589,225,80
24,"IAŞI","#N/A",97241,,435,"CĂRBUNARI / SC.GENERALA",3,9564,"GRAJDURI",97241,328,121,105,14,2,119,2,400,279,74,45
24,"IAŞI","#N/A",97241,,436,"PĂDURENI / SC GENERALA",3,9564,"GRAJDURI",97241,1663,217,171,34,12,216,1,1700,1483,107,109
24,"IAŞI","#N/A",97241,,437,"GRAJDURI / SPITAL BARNOVA",3,9564,"GRAJDURI",97241,134,95,49,46,0,95,0,210,115,53,42
24,"IAŞI","#N/A",97321,,438,"GROPNIŢA / Grădiniţa Gropniţa",3,9572,"GROPNIŢA",97321,354,185,156,27,2,182,3,410,225,129,53
24,"IAŞI","#N/A",97321,,439,"BULBUCANI / Sediul Primăriei",3,9572,"GROPNIŢA",97321,536,307,273,34,0,305,2,596,289,218,87
24,"IAŞI","#N/A",97321,,440,"FORĂŞTI / Şcoala Forăşti",3,9572,"GROPNIŢA",97321,414,240,212,25,3,238,2,511,271,197,41
24,"IAŞI","#N/A",97321,,441,"MĂLĂEŞTI / Şcoala Mălăeşti",3,9572,"GROPNIŢA",97321,354,213,177,31,5,210,3,400,187,154,56
24,"IAŞI","#N/A",97321,,442,"SĂVENI / Şcoala Săveni",3,9572,"GROPNIŢA",97321,604,280,251,29,0,279,1,700,420,210,69
24,"IAŞI","#N/A",97321,,443,"SÎNGERI / Şcoala Sîngeri",3,9572,"GROPNIŢA",97321,314,204,183,21,0,202,2,400,196,181,21
24,"IAŞI","#N/A",97394,,444,"GROZEŞTI / Sc. Gimnaziala Grozesti",3,9579,"GROZEŞTI",97394,939,512,461,51,0,506,6,1000,488,362,144
24,"IAŞI","#N/A",97394,,445,"COLŢU CORNII / Gradinita Coltu-Cornii",3,9579,"GROZEŞTI",97394,460,253,224,29,0,253,0,500,247,183,70
24,"IAŞI","#N/A",97438,,446,"HĂLĂUCEŞTI / SCOALA GENRALA HALAUCESTI",3,9583,"HĂLĂUCEŞTI",97438,1432,721,682,39,0,717,4,1600,879,244,473
24,"IAŞI","#N/A",97438,,447,"HĂLĂUCEŞTI / CAMIN CULTURAL HALAUCESTI",3,9583,"HĂLĂUCEŞTI",97438,1347,650,597,51,2,640,10,1500,850,226,414
24,"IAŞI","#N/A",97438,,448,"HĂLĂUCEŞTI / CAMIN CULTURAL HALAUCESTI",3,9583,"HĂLĂUCEŞTI",97438,1205,575,553,22,0,564,11,1300,725,184,380
24,"IAŞI","#N/A",97438,,449,"LUNCAŞI / SCOALA GENRALA LUNCASI",3,9583,"HĂLĂUCEŞTI",97438,786,440,403,37,0,440,0,900,460,81,359
24,"IAŞI","#N/A",100326,,450,"HĂRMĂNEŞTII VECHI / ŞCOALA HĂRMĂNEŞTII VECHI",3,9586,"HĂRMĂNEŞTI",100326,1254,718,669,49,0,714,4,1374,656,482,232
24,"IAŞI","#N/A",100326,,451,"HĂRMĂNEŞTII NOI / Şcoala HĂRMĂNEŞTII NOI",3,9586,"HĂRMĂNEŞTI",100326,625,357,322,35,0,353,4,700,343,217,136
24,"IAŞI","#N/A",97465,,452,"HELEŞTENI / Scoala gimnaziala Helesteni",3,9590,"HELEŞTENI",97465,629,405,375,25,5,390,15,700,295,255,135
24,"IAŞI","#N/A",97465,,453,"HĂRMĂNEASA / Centrul Educativ pentru copii saraci Harmaneasa",3,9590,"HELEŞTENI",97465,570,366,337,27,2,362,4,600,234,248,114
24,"IAŞI","#N/A",97465,,454,"OBOROCENI / Scoala gimnaziala Oboroceni",3,9590,"HELEŞTENI",97465,663,405,375,28,2,395,10,700,295,302,93
24,"IAŞI","#N/A",97465,,455,"MOVILENI / Scoala generala Movileni",3,9590,"HELEŞTENI",97465,161,131,103,28,0,127,4,201,70,84,43
24,"IAŞI","#N/A",95159,,456,"RUSENII VECHI / Scoala cu clasele I-VIII",3,9595,"HOLBOCA",95159,504,269,229,40,0,261,8,600,331,124,137
24,"IAŞI","#N/A",95159,,457,"HOLBOCA / Scoala Holboca",3,9595,"HOLBOCA",95159,1297,679,630,49,0,668,11,1400,721,311,357
24,"IAŞI","#N/A",95159,,458,"HOLBOCA / Scoala Holboca",3,9595,"HOLBOCA",95159,1293,697,654,43,0,687,10,1400,703,308,379
24,"IAŞI","#N/A",95159,,459,"DANCU / Gradinita cu program normal Dancu",3,9595,"HOLBOCA",95159,1318,705,654,51,0,699,6,1400,695,310,389
24,"IAŞI","#N/A",95159,,460,"DANCU / Gradinita cu program normal Dancu",3,9595,"HOLBOCA",95159,1401,799,714,85,0,784,15,1500,701,334,450
24,"IAŞI","#N/A",95159,,461,"DANCU / Scoala Stefan cel Mare",3,9595,"HOLBOCA",95159,1260,734,645,89,0,726,8,1400,666,299,427
24,"IAŞI","#N/A",95159,,462,"DANCU / Scoala Stefan cel Mare",3,9595,"HOLBOCA",95159,1564,819,760,59,0,807,12,1700,881,351,456
24,"IAŞI","#N/A",95159,,463,"DANCU / Scoala Stefan cel Mare",3,9595,"HOLBOCA",95159,1354,772,728,44,0,762,10,1500,728,323,439
24,"IAŞI","#N/A",95159,,464,"RUSENII NOI / Scoala cu clasele I-IV",3,9595,"HOLBOCA",95159,333,201,171,30,0,201,0,400,199,86,115
24,"IAŞI","#N/A",95159,,465,"ORZENI / Scoala cu clasele I-IV",3,9595,"HOLBOCA",95159,609,308,280,28,0,305,3,700,392,147,158
24,"IAŞI","#N/A",95159,,466,"CRISTEŞTI / Scoala cu clasele I-IV",3,9595,"HOLBOCA",95159,569,298,263,35,0,296,2,600,302,132,164
24,"IAŞI","#N/A",95159,,467,"VALEA LUNGĂ / Scaoala Valea Lunga",3,9595,"HOLBOCA",95159,258,180,128,51,1,180,0,300,120,88,92
24,"IAŞI","#N/A",97517,,468,"HORLEŞTI / CAMIN CULTURAL",3,9603,"HORLEŞTI",97517,1170,575,524,51,0,568,7,1300,725,293,275
24,"IAŞI","#N/A",97517,,469,"HORLEŞTI / BIBLIOTECA COMUNALA",3,9603,"HORLEŞTI",97517,402,170,155,15,0,166,4,492,322,100,66
24,"IAŞI","#N/A",97517,,470,"BOGDĂNEŞTI / CAMIN CULTURAL",3,9603,"HORLEŞTI",97517,523,320,252,68,0,310,10,600,280,197,113
24,"IAŞI","#N/A",97517,,471,"SCOPOSENI / SCOALA CL.I-IV",3,9603,"HORLEŞTI",97517,233,128,109,19,0,125,3,296,168,85,40
24,"IAŞI","#N/A",95499,,472,"RĂZBOIENI / SCOALA RAZBOIENI",3,9607,"ION NECULCE",95499,1598,895,855,40,0,893,2,1700,805,474,419
24,"IAŞI","#N/A",95499,,473,"BUZNEA / SCOALA BUZNEA",3,9607,"ION NECULCE",95499,1342,704,660,44,0,701,3,1500,796,400,301
24,"IAŞI","#N/A",95499,,474,"DĂDEŞTI / SCOALA DADESTI",3,9607,"ION NECULCE",95499,218,114,102,12,0,111,3,300,186,66,45
24,"IAŞI","#N/A",95499,,475,"GĂNEŞTI / SCOALA GANESTI",3,9607,"ION NECULCE",95499,600,312,291,21,0,305,7,700,388,187,118
24,"IAŞI","#N/A",95499,,476,"ION NECULCE / CASA SOCIALA",3,9607,"ION NECULCE",95499,142,93,78,15,0,90,3,200,107,34,56
24,"IAŞI","#N/A",95499,,477,"PRIGORENI / SCOALA PRIGORENI",3,9607,"ION NECULCE",95499,526,308,285,23,0,294,14,600,292,210,84
24,"IAŞI","#N/A",97553,,478,"IPATELE / SCOLA GIMNAZIALA""ION HAULICA""IPATELE",3,9614,"IPATELE",97553,544,378,313,50,15,376,2,600,222,300,76
24,"IAŞI","#N/A",97553,,479,"CUZA VODĂ / SCOALA CU CLASELE I-IV CUZA-VODĂ",3,9614,"IPATELE",97553,385,276,220,40,16,270,6,400,124,213,57
24,"IAŞI","#N/A",97553,,480,"BÎCU / SCOALA CU CLASELE I-VIII-BÂCU",3,9614,"IPATELE",97553,448,336,269,47,20,326,10,500,164,253,73
24,"IAŞI","#N/A",97606,,481,"LESPEZI / LICEUL TEHNOLOGIC LESPEZIPARTER",3,9619,"LESPEZI",97606,850,393,345,48,0,390,3,900,507,218,172
24,"IAŞI","#N/A",97606,,482,"HECI / SCOALA GIMNAZIALA HECI",3,9619,"LESPEZI",97606,929,471,435,36,0,469,2,1000,529,273,196
24,"IAŞI","#N/A",97606,,483,"HECI / SCOALA GIMNAZIALA HECI",3,9619,"LESPEZI",97606,872,417,391,26,0,412,5,1000,583,255,157
24,"IAŞI","#N/A",97606,,484,"BUDA / Scoala sat Buda",3,9619,"LESPEZI",97606,885,447,404,43,0,441,6,1000,553,259,182
24,"IAŞI","#N/A",97606,,485,"BURSUC-DEAL / scoala sat Bursuc Deal",3,9619,"LESPEZI",97606,711,374,325,48,1,367,7,800,426,238,129
24,"IAŞI","#N/A",97606,,486,"DUMBRAVA / scoala sat Dumbrava",3,9619,"LESPEZI",97606,556,322,277,45,0,322,0,600,278,200,122
24,"IAŞI","#N/A",97679,,487,"LEŢCANI / Scoala Gimnaziala Letcani",3,9626,"LEŢCANI",97679,1770,1081,1015,66,0,1068,13,1898,817,429,639
24,"IAŞI","#N/A",97679,,488,"LEŢCANI / Scoala Gimnaziala Letcani",3,9626,"LEŢCANI",97679,1579,999,864,135,0,982,17,1700,701,360,622
24,"IAŞI","#N/A",97679,,489,"BOGONOS / Scoala Bogonos",3,9626,"LEŢCANI",97679,618,381,345,36,0,375,6,700,319,176,199
24,"IAŞI","#N/A",97679,,490,"COGEASCA / Scoala Gimnaziala Cogeasca",3,9626,"LEŢCANI",97679,1501,768,726,42,0,762,6,1600,832,398,364
24,"IAŞI","#N/A",97679,,491,"CUCUTENI / Scoala Cucuteni",3,9626,"LEŢCANI",97679,386,216,188,28,0,213,3,399,183,101,112
24,"IAŞI","#N/A",97722,,492,"LUNGANI / CAMIN CULTURAL LUNGANI",3,9631,"LUNGANI",97722,856,476,416,46,14,468,8,900,424,249,219
24,"IAŞI","#N/A",97722,,493,"CRUCEA / CAMIN CULTURAL CRUCEA",3,9631,"LUNGANI",97722,1096,642,604,26,12,627,15,1200,558,524,103
24,"IAŞI","#N/A",97722,,494,"GOEŞTI / CAMIN CULTURAL GOESTI",3,9631,"LUNGANI",97722,735,395,347,24,24,391,4,800,405,281,110
24,"IAŞI","#N/A",97722,,495,"ZMEU / CAMIN CULTURAL ZMEU",3,9631,"LUNGANI",97722,1159,884,869,15,0,884,0,1300,416,726,158
24,"IAŞI","#N/A",97777,,496,"MĂDÎRJAC / ŞCOALA GENERALĂ CU CL. I-VIII",3,9636,"MĂDÎRJAC",97777,1168,707,657,47,3,696,11,1300,593,492,204
24,"IAŞI","#N/A",97811,,497,"MIRCEŞTI / Şcoala Mircesti",3,9640,"MIRCEŞTI",97811,1304,663,604,59,0,654,9,1400,737,357,297
24,"IAŞI","#N/A",97811,,498,"IUGANI / şCOALA GENERALĂ iUGANI",3,9640,"MIRCEŞTI",97811,1278,650,638,12,0,637,13,1400,750,158,479
24,"IAŞI","#N/A",97811,,499,"IUGANI / GRĂDINIŢA IUGANI",3,9640,"MIRCEŞTI",97811,490,236,214,22,0,236,0,500,264,69,167
24,"IAŞI","#N/A",97875,,500,"MIRONEASA / SCOALA GIMNAZIALA MIRONEASA",3,9643,"MIRONEASA",97875,1724,720,680,40,0,713,7,1800,1080,266,447
24,"IAŞI","#N/A",97875,,501,"MIRONEASA / SCOALA GIMNAZIALA MIRONEASA",3,9643,"MIRONEASA",97875,1336,617,605,12,0,604,13,1501,884,260,344
24,"IAŞI","#N/A",97875,,502,"URŞIŢA / SCOALA GIMNAZIALA URSITA",3,9643,"MIRONEASA",97875,428,265,225,40,0,264,1,500,235,126,138
24,"IAŞI","#N/A",97919,,503,"MIROSLAVA / SCOALA G-LA",3,9647,"MIROSLAVA",97919,1344,743,594,149,0,742,1,1500,757,250,492
24,"IAŞI","#N/A",97919,,504,"MIROSLAVA / Scoala Generala",3,9647,"MIROSLAVA",97919,1264,701,611,90,0,688,13,1400,699,238,450
24,"IAŞI","#N/A",97919,,505,"BALCIU / Sediu Primaria veche",3,9647,"MIROSLAVA",97919,761,461,386,75,0,453,8,800,339,159,294
24,"IAŞI","#N/A",97919,,506,"BRĂTULENI / Scoala Generala Brătuleni",3,9647,"MIROSLAVA",97919,295,222,181,41,0,218,4,300,78,90,128
24,"IAŞI","#N/A",97919,,507,"CIURBEŞTI / SC. GL-LA Ciurbesti",3,9647,"MIROSLAVA",97919,866,467,419,48,0,463,4,900,433,188,275
24,"IAŞI","#N/A",97919,,508,"CORNEŞTI / Sc. G-la Cornesti",3,9647,"MIROSLAVA",97919,952,488,450,38,0,484,4,1000,512,161,323
24,"IAŞI","#N/A",97919,,509,"HORPAZ / Sc. G-la Horpaz",3,9647,"MIROSLAVA",97919,1422,921,780,141,0,913,8,1500,579,325,588
24,"IAŞI","#N/A",97919,,510,"URICANI / Sc. G-la Uricani",3,9647,"MIROSLAVA",97919,882,517,461,56,0,511,6,1000,483,260,251
24,"IAŞI","#N/A",97919,,511,"VALEA ADÎNCĂ / sc. Generala V. Adinca",3,9647,"MIROSLAVA",97919,1055,632,562,70,0,623,9,1200,568,238,385
24,"IAŞI","#N/A",97919,,512,"VALEA ADÎNCĂ / Magazin mobila Tofan",3,9647,"MIROSLAVA",97919,1735,1200,1014,186,0,1183,17,1800,600,366,817
24,"IAŞI","#N/A",97919,,513,"VOROVEŞTI / Sc. G-la Vorovesti",3,9647,"MIROSLAVA",97919,658,366,332,34,0,355,11,700,334,187,168
24,"IAŞI","#N/A",98051,,514,"MIROSLOVEŞTI / SCOAL CU CLASELE I-VIII MIROSLOVESTI",3,9661,"MIROSLOVEŞTI",98051,1571,741,657,84,0,727,14,1700,959,478,249
24,"IAŞI","#N/A",98051,,515,"SOCI / SCOALA CU CLASELE I-VIII SOCI",3,9661,"MIROSLOVEŞTI",98051,1091,560,508,52,0,558,2,1200,640,356,202
24,"IAŞI","#N/A",98051,,516,"VERŞENI / SCOALA CU CLASELE I-VIII VERSENI",3,9661,"MIROSLOVEŞTI",98051,1015,448,384,64,0,443,5,1100,652,272,171
24,"IAŞI","#N/A",98113,,517,"MOGOŞEŞTI / LICEUL TEHNOLOGIC  D. POPA",3,9666,"MOGOŞEŞTI",98113,1326,690,626,64,0,685,5,1500,810,404,281
24,"IAŞI","#N/A",98113,,518,"MOGOŞEŞTI / LICEUL TEHNOLOGIC  D. POPA",3,9666,"MOGOŞEŞTI",98113,987,481,429,52,0,469,12,1100,619,260,209
24,"IAŞI","#N/A",98113,,519,"BUDEŞTI / ŞCOALA cls.I-VIII Minjesti",3,9666,"MOGOŞEŞTI",98113,761,380,340,40,0,373,7,800,420,227,146
24,"IAŞI","#N/A",98113,,520,"HADÎMBU / ŞCOALA cls.I-VIII Hadimbu",3,9666,"MOGOŞEŞTI",98113,822,431,385,46,0,425,6,900,469,271,154
24,"IAŞI","#N/A",98168,,521,"MOGOŞEŞTI-SIRET / SCOALA CU CLASELE 1-8 MOGOSESTI-SIRET",3,9671,"MOGOŞEŞTI-SIRET",98168,1405,744,663,77,4,727,17,1501,757,365,362
24,"IAŞI","#N/A",98168,,522,"MUNCELU DE SUS / SCOALA CU CLASELE 1-8 MUNCELU DE SUS",3,9671,"MOGOŞEŞTI-SIRET",98168,925,592,526,59,7,586,6,1001,409,267,319
24,"IAŞI","#N/A",98168,,523,"MUNCELU DE SUS / SCOALA CU CLASELE 1-8 MUNCELU DE SUS",3,9671,"MOGOŞEŞTI-SIRET",98168,843,501,466,29,6,495,6,900,399,199,296
24,"IAŞI","#N/A",98202,,524,"MOŞNA / ŞCOALA GIMNAZIALĂ MOŞNA",3,9675,"MOŞNA",98202,2028,480,452,28,0,478,2,2000,1520,369,109
24,"IAŞI","#N/A",98202,,525,"MOŞNA / SCOALA GIMNAZIALA MOSNA",3,9675,"MOŞNA",98202,1701,343,325,18,0,338,5,1701,1358,266,72
24,"IAŞI","#N/A",98220,,526,"MOŢCA / CĂMIN CULTURAL",3,9677,"MOŢCA",98220,1547,896,856,26,14,884,12,1700,804,643,241
24,"IAŞI","#N/A",98220,,527,"MOŢCA / CĂMIN CULTURAL",3,9677,"MOŢCA",98220,1447,812,773,24,15,802,10,1600,788,594,208
24,"IAŞI","#N/A",98220,,528,"BOURENI / CĂMIN CULTURAL",3,9677,"MOŢCA",98220,1146,625,584,30,11,610,15,1300,675,413,197
24,"IAŞI","#N/A",98257,,529,"MOVILENI / GRADINITA CU  PROGRAM NORMAL  MOVILENI",3,9680,"MOVILENI",98257,447,235,210,25,0,232,3,500,265,171,61
24,"IAŞI","#N/A",98257,,530,"IEPURENI / SCOALA PRIMARA IEPURENI",3,9680,"MOVILENI",98257,696,401,363,38,0,399,2,800,399,287,112
24,"IAŞI","#N/A",98257,,531,"LARGA-JIJIA / SCOALA GIMNAZIALA LARGA JIJIA",3,9680,"MOVILENI",98257,639,335,305,30,0,326,9,700,365,213,113
24,"IAŞI","#N/A",98257,,532,"POTÎNGENI / SCOALA PRIMARA POTINGENI",3,9680,"MOVILENI",98257,748,354,327,27,0,350,4,800,446,247,103
24,"IAŞI","#N/A",98300,,533,"OŢELENI / Cămin cultural - sala I",3,9685,"OŢELENI",98300,1020,519,499,20,0,516,3,1100,581,261,255
24,"IAŞI","#N/A",98300,,534,"OŢELENI / Cămin cultural - sala II",3,9685,"OŢELENI",98300,1054,529,492,36,1,521,8,1200,671,241,280
24,"IAŞI","#N/A",98300,,535,"HÎNDREŞTI / SCOALA HINDRESTI",3,9685,"OŢELENI",98300,912,433,379,54,0,428,5,1000,567,219,209
24,"IAŞI","#N/A",98337,,536,"PLUGARI / LICEUL TEHNOLOGIC PLUGARI",3,9688,"PLUGARI",98337,1475,836,737,46,53,828,8,1600,764,525,303
24,"IAŞI","#N/A",98337,,537,"BOROSOAIA / SCOALA GIMNAZIALA BOROSOAIA",3,9688,"PLUGARI",98337,1208,719,619,60,40,714,5,1300,581,450,264
24,"IAŞI","#N/A",98435,,538,"POPEŞTI / SCOALA GENERAL ,, DIMITRIE STURDZA ''",3,9692,"POPEŞTI",98435,856,476,424,52,0,471,5,900,424,293,178
24,"IAŞI","#N/A",98435,,539,"POPEŞTI / SCOALA GENERALA DIMITRIE STURDZA",3,9692,"POPEŞTI",98435,869,458,433,25,0,456,2,1000,542,311,145
24,"IAŞI","#N/A",98435,,540,"OBRIJENI / Şcoala cu cl. I-IV ""N. Butescu""",3,9692,"POPEŞTI",98435,758,146,109,36,1,145,1,799,653,82,63
24,"IAŞI","#N/A",98435,,541,"DOROŞCANI / Şcoala cu cl. I-IV",3,9692,"POPEŞTI",98435,503,267,240,26,1,264,3,600,333,179,85
24,"IAŞI","#N/A",98435,,542,"HĂRPĂŞEŞTI / Şcoala cu cl. I-VIII",3,9692,"POPEŞTI",98435,733,403,367,34,2,401,2,800,397,303,98
24,"IAŞI","#N/A",98505,,543,"POPRICANI / SCOALA  GIMNAZIALA  POPRICANI",3,9699,"POPRICANI",98505,1172,728,632,87,9,722,6,1300,572,424,298
24,"IAŞI","#N/A",98505,,544,"POPRICANI / SCOALA  GIMNAZIALA  POPRICANI",3,9699,"POPRICANI",98505,1100,622,557,61,4,609,13,1200,578,322,287
24,"IAŞI","#N/A",98505,,545,"MOIMEŞTI / SCOALA POPRICANI",3,9699,"POPRICANI",98505,353,217,193,21,3,217,0,400,183,154,63
24,"IAŞI","#N/A",98505,,546,"ŢIPILEŞTI / SCOALA TIPILESTI",3,9699,"POPRICANI",98505,322,220,186,28,6,215,5,400,180,161,54
24,"IAŞI","#N/A",98505,,547,"COTU MORII / SCOALA COTU MORII",3,9699,"POPRICANI",98505,220,131,113,18,0,130,1,300,169,68,62
24,"IAŞI","#N/A",98505,,548,"VÎNĂTORI / SCOALA VINATORI",3,9699,"POPRICANI",98505,1205,724,620,87,17,715,9,1300,576,394,321
24,"IAŞI","#N/A",98505,,549,"VULTURI / SCOALA VINATORI",3,9699,"POPRICANI",98505,789,470,424,37,9,464,6,900,430,249,215
24,"IAŞI","#N/A",98505,,550,"CÎRLIG / SCOALA CIRLIG",3,9699,"POPRICANI",98505,640,422,340,82,0,417,5,700,278,201,216
24,"IAŞI","#N/A",98505,,551,"CUZA VODĂ / SCOALA CUZA VODA",3,9699,"POPRICANI",98505,474,269,243,26,0,268,1,499,230,169,99
24,"IAŞI","#N/A",98603,,552,"PRISĂCANI / SCOALA GIMNAZIALA PRISACANI",3,9709,"PRISĂCANI",98603,1465,788,728,57,3,786,2,1600,812,464,322
24,"IAŞI","#N/A",98603,,553,"MĂCĂREŞTI / SCOALA GIMNAZIALA MACARESTI",3,9709,"PRISĂCANI",98603,511,299,266,33,0,294,5,600,301,191,103
24,"IAŞI","#N/A",98603,,554,"MORENI / SCOALA PRIMARA MORENI",3,9709,"PRISĂCANI",98603,801,483,444,39,0,479,4,900,417,247,232
24,"IAŞI","#N/A",98649,,555,"PROBOTA / SCOLA GIMNAZIALA'PETRUANGHEL'PROBOTA",3,9713,"PROBOTA",98649,980,508,469,39,0,503,5,1100,592,212,291
24,"IAŞI","#N/A",98649,,556,"BĂLTENI / SCOLA PRIMARA BALTENI",3,9713,"PROBOTA",98649,601,368,323,45,0,366,2,700,332,198,168
24,"IAŞI","#N/A",98649,,557,"PERIENI / SCOLA GIMNAZIALA PERIENI",3,9713,"PROBOTA",98649,1279,767,681,85,1,755,12,1402,635,550,205
24,"IAŞI","#N/A",100335,,558,"RĂCHITENI / Scoala noua Rachiteni",3,9717,"RACHIŢENI",100335,1548,649,625,24,0,646,3,1700,1051,259,387
24,"IAŞI","#N/A",100335,,559,"IZVOARELE / Scoala Izvoarele",3,9717,"RACHIŢENI",100335,1153,530,499,31,0,519,11,1300,770,268,251
24,"IAŞI","#N/A",98685,,560,"RĂDUCĂNENI / LICEUL TEORETIC LASCAR ROSETTI",3,9721,"RĂDUCĂNENI",98685,1243,605,542,63,0,600,5,1400,795,273,327
24,"IAŞI","#N/A",98685,,561,"RĂDUCĂNENI / LICEUL TEORETIC LASCAR ROSETTI",3,9721,"RĂDUCĂNENI",98685,1230,550,522,26,2,543,7,1400,850,331,212
24,"IAŞI","#N/A",98685,,562,"RĂDUCĂNENI / ŞCOALA GENERALA RADUCANENI",3,9721,"RĂDUCĂNENI",98685,1193,575,509,66,0,568,7,1300,725,289,279
24,"IAŞI","#N/A",98685,,563,"RĂDUCĂNENI / ŞCOALA GENERALA BAZGA",3,9721,"RĂDUCĂNENI",98685,1260,648,597,50,1,638,10,1400,752,360,278
24,"IAŞI","#N/A",98685,,564,"BOHOTIN / SCOALA GENERALA BOHOTIN",3,9721,"RĂDUCĂNENI",98685,1347,627,574,53,0,621,6,1500,873,414,207
24,"IAŞI","#N/A",98685,,565,"ROŞU / ŞCOALA GENERALA ROŞU",3,9721,"RĂDUCĂNENI",98685,582,213,199,14,0,209,4,600,387,171,38
24,"IAŞI","#N/A",98685,,566,"ISAIIA / ŞCOALA GENERALĂ ISAIIA",3,9721,"RĂDUCĂNENI",98685,267,145,129,16,0,144,1,300,155,62,82
24,"IAŞI","#N/A",95239,,567,"REDIU / SCOALA GIMNAZIALA REDIU",3,9726,"REDIU",95239,1359,589,513,75,1,587,2,1500,911,284,303
24,"IAŞI","#N/A",95239,,568,"REDIU / SCOALA GIMNAZIALA REDIU",3,9726,"REDIU",95239,1020,381,343,38,0,378,3,1100,719,169,209
24,"IAŞI","#N/A",95239,,569,"BREAZU / GRADINITA CU PROGRAM NORMAL BREAZU",3,9726,"REDIU",95239,1243,749,664,85,0,740,9,1400,651,293,447
24,"IAŞI","#N/A",95239,,570,"HORLEŞTI / SCOALA GIMNAZIALA HORLESTI",3,9726,"REDIU",95239,1010,482,425,57,0,476,6,1100,618,251,225
24,"IAŞI","#N/A",98738,,571,"ROMÂNEŞTI / SCOALA ROMANESTI",3,9731,"ROMÂNEŞTI",98738,765,429,368,44,17,422,7,800,371,251,171
24,"IAŞI","#N/A",98738,,572,"AVÎNTU / SCOALA AVINTU",3,9731,"ROMÂNEŞTI",98738,401,255,178,54,23,250,5,500,245,169,81
24,"IAŞI","#N/A",98738,,573,"URSOAIA / SCOALA URSOAIA",3,9731,"ROMÂNEŞTI",98738,336,222,158,43,21,220,2,400,178,148,72
24,"IAŞI","#N/A",100344,,574,"RĂDENI / GRĂDINITA CU PROGRAM NORMAL  RADENI",3,9735,"ROŞCANI",100344,560,335,303,32,0,331,4,600,265,236,95
24,"IAŞI","#N/A",100344,,575,"ROŞCANI / CLADIREA APARTINAND             IF POPIŢANU GABI",3,9735,"ROŞCANI",100344,557,324,300,24,0,313,11,600,276,249,64
24,"IAŞI","#N/A",98774,,576,"RUGINOASA / Şcoala Gimnazială Ruginoasa",3,9738,"RUGINOASA",98774,910,510,455,55,0,503,7,1000,490,287,216
24,"IAŞI","#N/A",98774,,577,"RUGINOASA / Şcoala Gimnazială Ruginoasa",3,9738,"RUGINOASA",98774,715,347,325,22,0,342,5,800,453,218,124
24,"IAŞI","#N/A",98774,,578,"DUMBRĂVIŢA / Şcoala Gimnazială Dumbrăviţa",3,9738,"RUGINOASA",98774,1103,542,513,29,0,536,6,1200,658,382,154
24,"IAŞI","#N/A",98774,,579,"DUMBRĂVIŢA / Şcoala Gimnazială Dumbrăviţa",3,9738,"RUGINOASA",98774,881,411,390,21,0,410,1,1000,589,286,124
24,"IAŞI","#N/A",98774,,580,"REDIU / Şcoala Gimnazială Rediu",3,9738,"RUGINOASA",98774,970,457,431,26,0,453,4,1100,643,312,141
24,"IAŞI","#N/A",98774,,581,"VASCANI / Şcoala Vascani",3,9738,"RUGINOASA",98774,399,230,210,19,1,228,2,500,270,142,86
24,"IAŞI","#N/A",98916,,582,"SCÂNTEIA / Şcoala gimnazială ""Axinte Uricariul""",3,9758,"SCÂNTEIA",98916,1666,783,733,50,0,781,2,1800,1017,379,402
24,"IAŞI","#N/A",98916,,583,"BODEŞTI / Şcoala gimnazială Bodeşti",3,9758,"SCÂNTEIA",98916,381,210,192,16,2,209,1,400,190,129,80
24,"IAŞI","#N/A",98916,,584,"BOROŞEŞTI / Grădiniţa cu program normal Boroseşti",3,9758,"SCÂNTEIA",98916,751,362,332,29,1,357,5,800,438,201,156
24,"IAŞI","#N/A",98916,,585,"CIOCÎRLEŞTI / Şcoala Primară Ciocârleşti",3,9758,"SCÂNTEIA",98916,256,136,123,13,0,136,0,300,164,84,52
24,"IAŞI","#N/A",98916,,586,"LUNCA RATEŞ / Şcoala Primară Lunca Rateş",3,9758,"SCÂNTEIA",98916,335,164,142,22,0,161,3,400,236,111,50
24,"IAŞI","#N/A",98916,,587,"REDIU / Şcoala Primară Rediu",3,9758,"SCÂNTEIA",98916,165,90,67,23,0,86,4,200,110,37,49
24,"IAŞI","#N/A",98916,,588,"TUFEŞTII DE SUS / Şcoala Primară Tufeştii de Sus",3,9758,"SCÂNTEIA",98916,233,126,105,21,0,124,2,300,174,93,31
24,"IAŞI","#N/A",98827,,589,"SCHITU DUCA / SCOALA CLS I-IV SCHITU DUCA",3,9749,"SCHITU DUCA",98827,519,301,237,64,0,301,0,600,299,179,122
24,"IAŞI","#N/A",98827,,590,"POIENI / SCOALA I-VIII POIENI",3,9749,"SCHITU DUCA",98827,655,429,362,66,1,425,4,700,271,249,176
24,"IAŞI","#N/A",98827,,591,"DUMITREŞTII GĂLĂŢII / SCOALA VICTOR SURDU",3,9749,"SCHITU DUCA",98827,534,378,328,50,0,367,11,601,223,274,93
24,"IAŞI","#N/A",98827,,592,"POCREACA / SCOALA I-VIII POcreaca",3,9749,"SCHITU DUCA",98827,361,259,204,55,0,254,5,400,141,169,85
24,"IAŞI","#N/A",98827,,593,"POIANA / Scoala c cls. I-IV poiana",3,9749,"SCHITU DUCA",98827,377,281,205,76,0,277,4,400,119,158,119
24,"IAŞI","#N/A",98827,,594,"SATU NOU / SCOALA I-VIII Satu Nou",3,9749,"SCHITU DUCA",98827,452,276,235,40,1,274,2,500,224,186,88
24,"IAŞI","#N/A",98827,,595,"SLOBOZIA / SCOALA CLS I-IV Slobozia",3,9749,"SCHITU DUCA",98827,333,247,219,28,0,247,0,400,153,207,40
24,"IAŞI","#N/A",98998,,596,"SCOBINŢI / sat Scobinti, sediu scoala veche Scobinti",3,9766,"SCOBINŢI",98998,1125,552,496,56,0,545,7,1200,648,387,158
24,"IAŞI","#N/A",98998,,597,"SCOBINŢI / sat Scobinti, sediu scoala Zvarici- Scobinti",3,9766,"SCOBINŢI",98998,291,249,152,97,0,248,1,300,51,204,44
24,"IAŞI","#N/A",98998,,598,"BĂDENI / sat Badeni, sediu scoala Badeni",3,9766,"SCOBINŢI",98998,1045,569,513,56,0,559,10,1100,531,392,167
24,"IAŞI","#N/A",98998,,599,"FETEŞTI / sat Fetesti, sediu scoala coord.",3,9766,"SCOBINŢI",98998,1032,512,471,41,0,496,16,1100,588,283,213
24,"IAŞI","#N/A",98998,,600,"STICLĂRIA / sat Sticlaria, sediu scoala Sticlaria",3,9766,"SCOBINŢI",98998,1149,643,587,56,0,638,5,1300,657,469,169
24,"IAŞI","#N/A",98998,,601,"STICLĂRIA / sat Sticlaria, sediu scoala Rediu",3,9766,"SCOBINŢI",98998,287,171,128,43,0,166,5,300,129,117,49
24,"IAŞI","#N/A",98998,,602,"ZAGAVIA / Sat .Zagavia ,cu sediul la scoala Zagavia",3,9766,"SCOBINŢI",98998,929,516,453,63,0,511,5,1000,484,309,202
24,"IAŞI","#N/A",99058,,603,"OSOI / ŞCOALA OSOI",3,9772,"SINEŞTI",99058,783,325,307,18,0,322,3,900,575,180,142
24,"IAŞI","#N/A",99058,,604,"SINEŞTI / SALA DE SPORT SINEŞTI",3,9772,"SINEŞTI",99058,1328,768,676,68,24,753,15,1500,732,286,467
24,"IAŞI","#N/A",99058,,605,"BOCNIŢA / ŞCOALA BOCNIŢA",3,9772,"SINEŞTI",99058,254,175,149,26,0,175,0,300,125,66,109
24,"IAŞI","#N/A",99058,,606,"STORNEŞTI / ŞCOALA STORNEŞTI",3,9772,"SINEŞTI",99058,823,501,451,35,15,488,13,900,399,210,278
24,"IAŞI","#N/A",99101,,607,"SIREŢEL / ŞCOALA GENERALĂ",3,9784,"SIREŢEL",99101,880,405,385,20,0,400,5,1000,595,217,183
24,"IAŞI","#N/A",99101,,608,"SIREŢEL / ŞCOALA GENERALĂ",3,9784,"SIREŢEL",99101,982,417,399,18,0,410,7,1100,683,195,215
24,"IAŞI","#N/A",99101,,609,"SLOBOZIA / ŞCOALA GENERALĂ SLOBOZIA",3,9784,"SIREŢEL",99101,644,300,283,17,0,299,1,700,400,144,155
24,"IAŞI","#N/A",99101,,610,"HUMOSU / ŞCOALA GENERALĂ HUMOSU",3,9784,"SIREŢEL",99101,559,334,317,17,0,330,4,600,266,171,159
24,"IAŞI","#N/A",99165,,611,"STOLNICENI-PRĂJESCU / BIBLIOTECA MATEI  MILLO",3,9790,"STOLNICENI-PRĂJESCU",99165,1239,680,623,57,0,666,14,1400,720,448,218
24,"IAŞI","#N/A",99165,,612,"BRĂTEŞTI / SCOALA CU CLASELE I-IV SALA 1",3,9790,"STOLNICENI-PRĂJESCU",99165,829,488,468,20,0,481,7,900,412,290,191
24,"IAŞI","#N/A",99165,,613,"BRĂTEŞTI / SCOALA CU CLASELE I-VIII SALA  NR.1",3,9790,"STOLNICENI-PRĂJESCU",99165,593,334,315,19,0,329,5,700,366,215,114
24,"IAŞI","#N/A",99165,,614,"COZMEŞTI / SCOALA  GIMNAZIALA  COZMESTI",3,9790,"STOLNICENI-PRĂJESCU",99165,912,478,445,33,0,477,1,1000,522,330,147
24,"IAŞI","#N/A",99165,,615,"COZMEŞTI / SCOALA  GIMNAZIALA  COZMESTI",3,9790,"STOLNICENI-PRĂJESCU",99165,820,395,361,34,0,390,5,900,505,249,141
24,"IAŞI","#N/A",99209,,616,"STRUNGA / Scoala Gimnaziala Strunga",3,9794,"STRUNGA",99209,539,307,275,31,1,306,1,600,293,167,139
24,"IAŞI","#N/A",99209,,617,"BRĂTULEŞTI / Scoala primara Bratulesti",3,9794,"STRUNGA",99209,631,332,288,44,0,322,10,700,368,230,92
24,"IAŞI","#N/A",99209,,618,"CRIVEŞTI / Gradinita cu program normal",3,9794,"STRUNGA",99209,271,151,127,24,0,147,4,295,144,115,32
24,"IAŞI","#N/A",99209,,619,"HĂBĂŞEŞTI / Gradinita cu program normal",3,9794,"STRUNGA",99209,344,219,173,45,1,218,1,399,180,132,86
24,"IAŞI","#N/A",99209,,620,"CUCOVA / Scoala Cucova",3,9794,"STRUNGA",99209,126,84,65,19,0,83,1,199,115,51,32
24,"IAŞI","#N/A",99209,,621,"FĂRCĂŞENI / scoala gimnaziala",3,9794,"STRUNGA",99209,792,332,316,16,0,322,10,900,568,196,126
24,"IAŞI","#N/A",99209,,622,"FĂRCĂŞENI / scoala gimnaziala",3,9794,"STRUNGA",99209,781,323,311,12,0,320,3,900,577,195,125
24,"IAŞI","#N/A",99290,,623,"ŞCHEIA / Grup Scolar Scheia",3,9743,"ŞCHEIA",99290,923,504,459,45,0,501,3,1000,496,341,160
24,"IAŞI","#N/A",99290,,624,"CĂUEŞTI / Scoala Generală Căuesti",3,9743,"ŞCHEIA",99290,440,259,230,29,0,256,3,500,241,160,96
24,"IAŞI","#N/A",99290,,625,"CIOCA-BOCA / Scoala Generală Cioca-Boca",3,9743,"ŞCHEIA",99290,381,214,187,27,0,211,3,400,186,126,85
24,"IAŞI","#N/A",99290,,626,"POIANA ŞCHEII / Scoala Generală Poiana-Scheii",3,9743,"ŞCHEIA",99290,360,228,210,18,0,226,2,400,172,145,81
24,"IAŞI","#N/A",99290,,627,"SATU NOU / Scoala Generală Satu-Nou",3,9743,"ŞCHEIA",99290,281,150,130,20,0,146,4,301,151,62,84
24,"IAŞI","#N/A",99370,,628,"ŞIPOTE / SCOALA SIPOTE",3,9777,"ŞIPOTE",99370,792,432,390,42,0,430,2,900,468,283,147
24,"IAŞI","#N/A",99370,,629,"IAZU NOU / SCOALA IAZU NOU",3,9777,"ŞIPOTE",99370,843,382,361,21,0,380,2,900,518,287,93
24,"IAŞI","#N/A",99370,,630,"CHIŞCĂRENI / SCOALA  CHISCARENI",3,9777,"ŞIPOTE",99370,1248,613,574,39,0,608,5,1400,787,468,140
24,"IAŞI","#N/A",99370,,631,"HĂLCENI / SCOALA HALCENI",3,9777,"ŞIPOTE",99370,1190,544,507,37,0,540,4,1300,756,345,195
24,"IAŞI","#N/A",99441,,632,"TANSA / GRĂDINIŢA TANSA",3,9803,"TANSA",99441,1131,800,688,94,18,782,18,1200,400,494,288
24,"IAŞI","#N/A",99441,,633,"SUHULEŢ / ŞCOALA CL.I-VIII SUHULEŢ",3,9803,"TANSA",99441,971,660,587,64,9,646,14,1100,440,331,315
24,"IAŞI","#N/A",99478,,634,"TĂTĂRUŞI / CAMIN CULTURAL TATARUSI",3,9806,"TĂTĂRUŞI",99478,1449,938,830,95,13,930,8,1600,662,760,170
24,"IAŞI","#N/A",99478,,635,"UDA / SCOALA UDA",3,9806,"TĂTĂRUŞI",99478,1255,714,652,57,5,706,8,1400,686,568,138
24,"IAŞI","#N/A",99478,,636,"PIETROSU / SCOALA PIETROSU",3,9806,"TĂTĂRUŞI",99478,1167,676,635,32,9,672,4,1300,624,503,169
24,"IAŞI","#N/A",99478,,637,"IORCANI / SCOALA IORCANI",3,9806,"TĂTĂRUŞI",99478,684,449,401,39,9,444,5,700,251,325,119
24,"IAŞI","#N/A",99539,,638,"TODIREŞTI / Camin Cultural Todiresti",3,9837,"TODIREŞTI",99539,1826,833,809,24,0,815,18,2000,1167,385,430
24,"IAŞI","#N/A",99539,,639,"TODIREŞTI / Camin Cultural Todiresti",3,9837,"TODIREŞTI",99539,1264,589,569,20,0,585,4,1400,811,271,314
24,"IAŞI","#N/A",99539,,640,"BĂICENI / SCOALA BĂICENI",3,9837,"TODIREŞTI",99539,310,175,160,15,0,170,5,397,222,127,43
24,"IAŞI","#N/A",99539,,641,"STROEŞTI / SCOALA STROESTI",3,9837,"TODIREŞTI",99539,344,179,153,26,0,175,4,400,221,104,71
24,"IAŞI","#N/A",95293,,642,"TOMEŞTI / PRIMARIA COMUNEI TOMESTI",3,9841,"TOMEŞTI",95293,1055,516,442,74,0,512,4,1100,584,231,281
24,"IAŞI","#N/A",95293,,643,"TOMEŞTI / Sediul Sc.D.D.Patrascanu",3,9841,"TOMEŞTI",95293,1526,872,725,147,0,859,13,1700,828,321,538
24,"IAŞI","#N/A",95293,,644,"TOMEŞTI / Sediul Sc.D.D.Patrascanu",3,9841,"TOMEŞTI",95293,1563,808,692,116,0,792,16,1700,892,300,492
24,"IAŞI","#N/A",95293,,645,"TOMEŞTI / Sediul Sc.D.D.Patrascanu",3,9841,"TOMEŞTI",95293,1363,719,655,64,0,703,16,1500,781,287,416
24,"IAŞI","#N/A",95293,,646,"TOMEŞTI / Sediul Sc.D.D.Patrascanu",3,9841,"TOMEŞTI",95293,1864,910,872,38,0,907,3,2000,1090,399,508
24,"IAŞI","#N/A",95293,,647,"TOMEŞTI / Sediul Sc.D.D.Patrascanu",3,9841,"TOMEŞTI",95293,1398,736,699,36,1,720,16,1500,764,308,412
24,"IAŞI","#N/A",95293,,648,"CHICEREA / sediul Sc.Chicerea, sat.Chicerea, com.Tomeşti",3,9841,"TOMEŞTI",95293,1065,551,481,70,0,543,8,1200,649,265,278
24,"IAŞI","#N/A",95293,,649,"GORUNI / Sediul Sc.Goruni, satul Goruni, com.Tomeşti",3,9841,"TOMEŞTI",95293,1013,528,489,39,0,514,14,1100,572,293,221
24,"IAŞI","#N/A",95293,,650,"VLĂDICENI / Sediul Sc.Vladiceni, com.Tomeşti",3,9841,"TOMEŞTI",95293,533,309,251,58,0,308,1,600,291,188,120
24,"IAŞI","#N/A",99600,,651,"TRIFEŞTI / GRĂDINIŢA TRIFEŞTI",3,9846,"TRIFEŞTI",99600,1382,747,682,65,0,739,8,1500,753,348,391
24,"IAŞI","#N/A",99600,,652,"ZABOLOTENI / ŞCOALA ZABOLOTENI",3,9846,"TRIFEŞTI",99600,582,378,363,15,0,373,5,600,222,164,209
24,"IAŞI","#N/A",99600,,653,"HERMEZIU / ŞCOALA HERMEZIU",3,9846,"TRIFEŞTI",99600,747,492,468,24,0,483,9,800,308,237,246
24,"IAŞI","#N/A",99600,,654,"VLADOMIRA / ŞCOALA VLADOMIRA",3,9846,"TRIFEŞTI",99600,192,137,119,18,0,137,0,200,63,53,84
24,"IAŞI","#N/A",99673,,655,"ŢIBANA / ŞCOALA GENERALĂ ŢIBANA",3,9812,"ŢIBANA",99673,724,335,310,25,0,332,3,800,465,211,121
24,"IAŞI","#N/A",99673,,656,"POIANA MĂNĂSTIRII / SCOALA GIMNAZIALĂ POIANA MĂNĂSTIRII",3,9812,"ŢIBANA",99673,361,178,160,18,0,176,2,400,222,119,57
24,"IAŞI","#N/A",99673,,657,"ALEXENI / ŞCOALA DE 8 ANI ALEXENI",3,9812,"ŢIBANA",99673,585,288,261,27,0,284,4,601,313,218,66
24,"IAŞI","#N/A",99673,,658,"POIANA DE SUS / ŞCOALA DE 4 ANI POIANA DE SUS",3,9812,"ŢIBANA",99673,427,232,219,13,0,232,0,500,268,149,83
24,"IAŞI","#N/A",99673,,659,"DOMNIŢA / ŞCOALA DE 8 ANI DOMNIŢA",3,9812,"ŢIBANA",99673,983,372,343,29,0,369,3,1100,728,252,117
24,"IAŞI","#N/A",99673,,660,"RUNCU / ŞCOALA GENERALĂ RUNCU",3,9812,"ŢIBANA",99673,390,240,212,28,0,237,3,400,160,191,46
24,"IAŞI","#N/A",99673,,661,"GÎRBEŞTI / ŞCOALA GENERALĂ DE 8 ANI GÎRBEŞTI",3,9812,"ŢIBANA",99673,757,344,329,15,0,342,2,800,456,238,104
24,"IAŞI","#N/A",99673,,662,"GÎRBEŞTI / ŞCOALA GENERALĂ DE 4 ANI GÎRBEŞTI",3,9812,"ŢIBANA",99673,901,405,370,35,0,397,8,1000,595,304,93
24,"IAŞI","#N/A",99673,,663,"VADU VEJEI / ŞCOALA GENERALĂ DE 4 ANI VADU VEJEI",3,9812,"ŢIBANA",99673,226,151,138,11,2,150,1,300,149,81,69
24,"IAŞI","#N/A",99780,,664,"ŢIBĂNEŞTI / GRĂDINIŢA CU PROGRAM NORMAL ŢIBĂNEŞTI",3,9823,"ŢIBĂNEŞTI",99780,899,455,409,46,0,449,6,1000,545,260,189
24,"IAŞI","#N/A",99780,,665,"ŢIBĂNEŞTI / GRĂDINIŢA CU PROGRAM NORMAL ŢIBĂNEŞTI",3,9823,"ŢIBĂNEŞTI",99780,922,470,452,18,0,465,5,1000,530,229,236
24,"IAŞI","#N/A",99780,,666,"RĂSBOIENI / Şcoala Răsboieni",3,9823,"ŢIBĂNEŞTI",99780,731,347,321,26,0,345,2,800,453,198,147
24,"IAŞI","#N/A",99780,,667,"GLODENII GÎNDULUI / Şcoala Gl.Gîndului",3,9823,"ŢIBĂNEŞTI",99780,965,527,493,34,0,524,3,1100,573,232,292
24,"IAŞI","#N/A",99780,,668,"GLODENII GÎNDULUI / Şcoala Gl.Gîndului",3,9823,"ŢIBĂNEŞTI",99780,923,513,492,21,0,502,11,1000,487,246,256
24,"IAŞI","#N/A",99780,,669,"JIGORENI / Şcoala Jigoreni",3,9823,"ŢIBĂNEŞTI",99780,551,341,316,25,0,338,3,600,259,186,152
24,"IAŞI","#N/A",99780,,670,"VĂLENII / Şcoala Vălenii",3,9823,"ŢIBĂNEŞTI",99780,233,158,132,26,0,153,5,300,142,100,53
24,"IAŞI","#N/A",99780,,671,"TUNGUJEI / Şcoala Tungujei",3,9823,"ŢIBĂNEŞTI",99780,489,254,228,25,1,254,0,500,246,187,67
24,"IAŞI","#N/A",99780,,672,"RECEA / Şcoala Recea",3,9823,"ŢIBĂNEŞTI",99780,132,93,70,23,0,91,2,201,108,51,40
24,"IAŞI","#N/A",99780,,673,"GRIEŞTI / Şcoala Grieşti",3,9823,"ŢIBĂNEŞTI",99780,209,120,100,20,0,119,1,300,180,89,30
24,"IAŞI","#N/A",99879,,674,"CÎRNICENI / Scoala Cirniceni",3,9832,"ŢIGĂNĂŞI",99879,1209,693,628,65,0,680,13,1300,607,463,217
24,"IAŞI","#N/A",99879,,675,"MIHAIL KOGĂLNICEANU / Scoala Mihail Kogalniceanu",3,9832,"ŢIGĂNĂŞI",99879,1004,522,479,43,0,517,5,1100,578,386,131
24,"IAŞI","#N/A",99879,,676,"STEJARII / Scoala Stejarii",3,9832,"ŢIGĂNĂŞI",99879,243,183,142,41,0,182,1,300,117,137,45
24,"IAŞI","#N/A",99879,,677,"ŢIGĂNĂŞI / Scoala Tiganasi",3,9832,"ŢIGĂNĂŞI",99879,1115,663,611,52,0,657,6,1200,537,471,186
24,"IAŞI","#N/A",99922,,678,"ŢUŢORA / scoala gimnaziala Tutora",3,9851,"ŢUŢORA",99922,1757,1188,932,178,78,1160,28,1900,712,637,523
24,"IAŞI","#N/A",96003,,679,"BOSIA / SCOALA GIMANZIALA",3,9855,"UNGHENI",96003,862,421,395,26,0,417,4,1000,579,242,175
24,"IAŞI","#N/A",96003,,680,"BOSIA / SCOALA GIMANZIALA",3,9855,"UNGHENI",96003,730,387,371,16,0,385,2,800,413,213,172
24,"IAŞI","#N/A",96003,,681,"COADA STÎNCII / SCOALA PRIMARA",3,9855,"UNGHENI",96003,524,259,239,20,0,256,3,600,341,123,133
24,"IAŞI","#N/A",96003,,682,"MÎNZĂTEŞTI / SCOALA PRIMARA",3,9855,"UNGHENI",96003,837,447,419,28,0,442,5,900,453,200,242
24,"IAŞI","#N/A",96003,,683,"UNGHENI / SCOALA PRIMARA",3,9855,"UNGHENI",96003,536,335,285,50,0,332,3,600,265,179,153
24,"IAŞI","#N/A",100353,,684,"VALEA LUPULUI / Scoala Valea Lupului",3,9860,"VALEA LUPULUI",100353,1516,1041,950,89,2,1032,9,1600,559,429,603
24,"IAŞI","#N/A",100353,,685,"VALEA LUPULUI / Scoala Valea Lupului",3,9860,"VALEA LUPULUI",100353,1672,1132,1019,113,0,1116,16,1800,668,463,653
24,"IAŞI","#N/A",100353,,686,"VALEA LUPULUI / Scoala Valea Lupului",3,9860,"VALEA LUPULUI",100353,1494,1062,934,128,0,1045,17,1600,538,411,634
24,"IAŞI","#N/A",99968,,687,"VALEA SEACĂ / SCOALA VALEA SEACA",3,9862,"VALEA SEACĂ",99968,1608,859,811,48,0,847,12,1700,841,621,226
24,"IAŞI","#N/A",99968,,688,"CONŢEŞTI / SCOALA CONTESTI",3,9862,"VALEA SEACĂ",99968,1454,778,739,39,0,770,8,1598,820,547,223
24,"IAŞI","#N/A",99968,,689,"TOPILE / SCOALA TOPILE",3,9862,"VALEA SEACĂ",99968,1802,1063,973,70,20,1056,7,1897,834,822,234
24,"IAŞI","#N/A",100004,,690,"STÎNCA / ŞCOALA STÂNCA",3,9866,"VICTORIA",100004,430,217,202,15,0,214,3,500,283,123,91
24,"IAŞI","#N/A",100004,,691,"VICTORIA / GRĂDINIŢA VICTORIA",3,9866,"VICTORIA",100004,1274,646,582,64,0,638,8,1400,754,382,256
24,"IAŞI","#N/A",100004,,692,"FRĂSULENI / ŞCOALA FRĂSULENI",3,9866,"VICTORIA",100004,291,158,139,19,0,157,1,300,142,74,83
24,"IAŞI","#N/A",100004,,693,"ICUŞENI / ŞCOALA ICUŞENI",3,9866,"VICTORIA",100004,399,201,177,24,0,201,0,500,299,134,67
24,"IAŞI","#N/A",100004,,694,"LUCENI / ŞCOALA LUCENI",3,9866,"VICTORIA",100004,440,233,207,26,0,231,2,500,267,169,62
24,"IAŞI","#N/A",100004,,695,"SCULENI / ŞCOALA SCULENI",3,9866,"VICTORIA",100004,301,188,153,35,0,187,1,400,212,100,87
24,"IAŞI","#N/A",100004,,696,"ŞENDRENI / ŞCOALA ŞENDRENI",3,9866,"VICTORIA",100004,246,127,104,23,0,127,0,300,173,73,54
24,"IAŞI","#N/A",100086,,697,"VÎNĂTORI / CAMINUL CULTURAL VINATORI",3,9874,"VÎNĂTORI",100086,1038,592,498,93,1,584,8,1100,508,400,184
24,"IAŞI","#N/A",100086,,698,"CRIVEŞTI / SCOALA CU CLASELE I-VIII  CRIVESTI",3,9874,"VÎNĂTORI",100086,1175,659,572,87,0,649,10,1300,641,376,273
24,"IAŞI","#N/A",100086,,699,"GURA BÎDILIŢEI / SCOALA CU CLASELE I-IV  GURA-BIDILITEI",3,9874,"VÎNĂTORI",100086,546,274,232,41,1,272,2,600,326,175,97
24,"IAŞI","#N/A",100086,,700,"HÎRTOAPE / SCOALA CU CLASELE I -VIII HIRTOAPE",3,9874,"VÎNĂTORI",100086,929,590,488,102,0,583,7,1000,410,406,177
24,"IAŞI","#N/A",100148,,701,"VLĂDENI / LICEUL TEHNOLOGIC VLADENI",3,9880,"VLĂDENI",100148,1456,755,668,87,0,744,11,1600,845,382,362
24,"IAŞI","#N/A",100148,,702,"BORŞA / SCOALA CU CLASELE I-VIII BORSA",3,9880,"VLĂDENI",100148,676,358,322,36,0,356,2,700,342,231,125
24,"IAŞI","#N/A",100148,,703,"IACOBENI / SCOALA CU CLASELE I-IV IACOBENI",3,9880,"VLĂDENI",100148,202,121,92,29,0,120,1,300,179,75,45
24,"IAŞI","#N/A",100148,,704,"ALEXANDRU CEL BUN / SCOALA CU CLASELE I-IV ALEXANDRU CEL BUN",3,9880,"VLĂDENI",100148,401,236,206,30,0,232,4,500,264,151,81
24,"IAŞI","#N/A",100148,,705,"BROŞTENI / SCOALA CU CLASELE I-IV BROSTENI",3,9880,"VLĂDENI",100148,326,170,149,21,0,168,2,400,230,114,54
24,"IAŞI","#N/A",100148,,706,"VÎLCELELE / SCOALA VILCELELE",3,9880,"VLĂDENI",100148,329,201,181,20,0,200,1,400,199,150,50
24,"IAŞI","#N/A",100219,,707,"VOINEŞTI / Şcoala Gimnazială ""Ioanid Roamanescu"" Voineşti",3,9887,"VOINEŞTI",100219,1092,528,485,43,0,524,4,1200,672,302,222
24,"IAŞI","#N/A",100219,,708,"VOINEŞTI / Şcoala Gimnazială ""Ioanid Roamanescu"" VoineştI",3,9887,"VOINEŞTI",100219,745,357,334,23,0,356,1,800,443,220,136
24,"IAŞI","#N/A",100219,,709,"VOINEŞTI / Şcoala Gimnazială ""Ioanid Roamanescu"" VoineştI",3,9887,"VOINEŞTI",100219,936,465,432,33,0,464,1,1000,535,272,192
24,"IAŞI","#N/A",100219,,710,"SLOBOZIA / Şcoala Gimnazială Slobozia Deal",3,9887,"VOINEŞTI",100219,706,345,326,19,0,338,7,800,455,273,65
24,"IAŞI","#N/A",100219,,711,"SLOBOZIA / Şcoala Gimnazială Slobozia Deal",3,9887,"VOINEŞTI",100219,676,338,318,20,0,337,1,700,362,271,66
24,"IAŞI","#N/A",100219,,712,"LUNGANI / Şcoala Primară Lungani",3,9887,"VOINEŞTI",100219,450,251,228,23,0,251,0,500,249,172,79
24,"IAŞI","#N/A",100219,,713,"SCHITU STAVNIC / Şcoala Primară Schitu-Stavnic",3,9887,"VOINEŞTI",100219,432,239,212,27,0,236,3,500,261,165,71
24,"IAŞI","#N/A",100219,,714,"VOCOTEŞTI / A.F. Gheorghiţă",3,9887,"VOINEŞTI",100219,117,106,72,34,0,103,3,200,94,76,27
25,"ILFOV",234,179221,,1,"BRAGADIRU / Primăria oraşului Bragadiru",1,9894,"ORAŞ BRAGADIRU",179221,1663,1579,1033,545,1,1541,38,1700,121,686,855
25,"ILFOV",234,179221,,2,"BRAGADIRU / Primăria oraşului Bragadiru",1,9894,"ORAŞ BRAGADIRU",179221,1769,1415,1150,264,1,1396,19,2000,585,626,770
25,"ILFOV",234,179221,,3,"BRAGADIRU / Primăria oraşului Bragadiru",1,9894,"ORAŞ BRAGADIRU",179221,1474,1134,971,161,2,1102,32,1600,466,470,632
25,"ILFOV",234,179221,,4,"BRAGADIRU / Primăria oraşului Bragadiru",1,9894,"ORAŞ BRAGADIRU",179221,1184,788,729,59,0,771,17,999,211,295,476
25,"ILFOV",234,179221,,5,"BRAGADIRU / Primăria oraşului Bragadiru",1,9894,"ORAŞ BRAGADIRU",179221,1551,1103,979,118,6,1074,29,1700,597,436,638
25,"ILFOV",234,179221,,6,"BRAGADIRU / SC GAD SPECIAL CONSTRUCT SRL",1,9894,"ORAŞ BRAGADIRU",179221,1680,2093,1107,985,1,2048,45,2900,807,645,1403
25,"ILFOV",234,179221,,7,"BRAGADIRU / SC IZOCLASS CONSTRUCT SRL",1,9894,"ORAŞ BRAGADIRU",179221,1766,1477,1012,465,0,1453,24,1600,123,532,921
25,"ILFOV",234,179221,,8,"BRAGADIRU / S.C. SMART BUSINESS & ACCOUNTING CONSULTING SRL",1,9894,"ORAŞ BRAGADIRU",179221,1326,1540,893,647,0,1516,24,1700,160,550,966
25,"ILFOV",234,100576,,9,"BUFTEA / Şcoala Generală nr. 1 Buftea",1,9896,"ORAŞ BUFTEA",100576,1879,1192,1047,129,16,1170,22,1949,757,553,617
25,"ILFOV",234,100576,,10,"BUFTEA / Şcoala Generală nr. 1",1,9896,"ORAŞ BUFTEA",100576,1858,1124,1064,60,0,1099,25,2000,876,526,573
25,"ILFOV",234,100576,,11,"BUFTEA / Şcoala Generală nr. 1",1,9896,"ORAŞ BUFTEA",100576,1766,1061,960,101,0,1028,33,1900,839,498,530
25,"ILFOV",234,100576,,12,"BUFTEA / Grup Şcolar ""Dumitru Dumitrescu""",1,9896,"ORAŞ BUFTEA",100576,1993,1182,1056,126,0,1145,37,1750,568,586,559
25,"ILFOV",234,100576,,13,"BUFTEA / Şcoala Generală nr. 2",1,9896,"ORAŞ BUFTEA",100576,1436,1031,846,185,0,1008,23,1600,569,430,578
25,"ILFOV",234,100576,,14,"BUFTEA / Şcoala Generală nr. 2",1,9896,"ORAŞ BUFTEA",100576,1538,1091,977,114,0,1072,19,1700,609,505,567
25,"ILFOV",234,100576,,15,"BUFTEA / Şcoala Generală nr. 2",1,9896,"ORAŞ BUFTEA",100576,1586,1092,1016,73,3,1070,22,1700,608,499,571
25,"ILFOV",234,100576,,16,"BUFTEA / Şcoala Generală nr. 2 Buftea",1,9896,"ORAŞ BUFTEA",100576,1553,990,921,67,2,966,24,1699,709,451,515
25,"ILFOV",234,100576,,17,"BUFTEA / Şcoala Generală nr. 4",1,9896,"ORAŞ BUFTEA",100576,928,687,621,66,0,673,14,1000,313,256,417
25,"ILFOV",234,100576,,18,"BUFTEA / Sediu Târg - Primăria Buftea",1,9896,"ORAŞ BUFTEA",100576,1231,925,845,80,0,900,25,1300,375,360,540
25,"ILFOV",234,100576,,19,"BUFTEA / Şcoala Generală nr. 3",1,9896,"ORAŞ BUFTEA",100576,1763,1253,1070,182,1,1233,20,1900,647,604,629
25,"ILFOV",234,100576,,20,"BUFTEA / Proprietate privată: Tutunaru Gheorghe",1,9896,"ORAŞ BUFTEA",100576,412,271,207,64,0,267,4,450,179,123,144
25,"ILFOV",234,179285,,21,"CHITILA / Grădiniţa cu program prelungit ""Voinicel""",1,9899,"ORAŞ CHITILA",179285,1292,868,801,67,0,857,11,1400,532,420,437
25,"ILFOV",234,179285,,22,"CHITILA / Şcoala gimnazială cu clasele I-VIII nr.1 ""Prof.Ion Vişoiu""",1,9899,"ORAŞ CHITILA",179285,1615,1337,1016,321,0,1307,30,1700,363,627,680
25,"ILFOV",234,179285,,23,"CHITILA / Şcoala gimnazială cu clasele I-VIII nr.1 ""Prof. Ion Vişoiu""",1,9899,"ORAŞ CHITILA",179285,1418,1133,914,218,1,1118,15,1500,367,441,677
25,"ILFOV",234,179285,,24,"RUDENI / Şcoala gimnazială cu clasele I-VIII nr.1 ""Prof. Ion Vişoiu""",1,9899,"ORAŞ CHITILA",179285,1068,707,590,117,0,691,16,1200,493,343,348
25,"ILFOV",234,179285,,25,"CHITILA / Casa de Cultură ""Tudor Arghezi""",1,9899,"ORAŞ CHITILA",179285,1742,1259,1079,180,0,1225,34,1900,641,576,649
25,"ILFOV",234,179285,,26,"CHITILA / Şcoala gimnazială cu clasele I- VIII nr.1 ""Prof. Ion Vişoiu"" -",1,9899,"ORAŞ CHITILA",179285,1528,993,845,148,0,975,18,1700,707,541,434
25,"ILFOV",234,179285,,27,"CHITILA / Scoala Gimnaziala cu clasele I-VIII nr. 1 Prof. Ion Visoiu, structura cu clasele I-IV si grupe de prescolari Ion Olteanu-Chitila",1,9899,"ORAŞ CHITILA",179285,859,704,545,159,0,684,20,900,196,252,432
25,"ILFOV",234,179285,,28,"CHITILA / Şcoala gimnazială cu clasele I- VIII nr.1 ""Prof. Ion Vişoiu""",1,9899,"ORAŞ CHITILA",179285,1098,786,639,147,0,774,12,1200,414,376,398
25,"ILFOV",234,179285,,29,"CHITILA / Grădiniţa ""Prichindel""",1,9899,"ORAŞ CHITILA",179285,1029,626,563,63,0,613,13,1100,474,337,276
25,"ILFOV",234,179409,,30,"MĂGURELE / GRADINITA NR 2 MAGURELE",1,9902,"ORAŞ MĂGURELE",179409,1357,982,854,128,0,962,20,1500,518,435,527
25,"ILFOV",234,179409,,31,"MĂGURELE / Liceul Teoretic ""Horia Hulubei""",1,9902,"ORAŞ MĂGURELE",179409,949,820,668,152,0,810,10,1000,180,338,472
25,"ILFOV",234,179409,,32,"MĂGURELE / Primăria oraşului Măgurele",1,9902,"ORAŞ MĂGURELE",179409,1317,1471,857,614,0,1437,34,1700,229,590,847
25,"ILFOV",234,179409,,33,"MĂGURELE / Primăria oraşului Măgurele",1,9902,"ORAŞ MĂGURELE",179409,830,808,480,328,0,798,10,900,92,366,432
25,"ILFOV",234,179409,,34,"ALUNIŞU / Clădire Parc Aluniş",1,9902,"ORAŞ MĂGURELE",179409,1135,809,624,185,0,797,12,1199,390,380,417
25,"ILFOV",234,179409,,35,"VÂRTEJU / SCOALA PRIMARA NR 1 VARTEJU",1,9902,"ORAŞ MĂGURELE",179409,859,674,549,125,0,657,17,900,226,337,320
25,"ILFOV",234,179409,,36,"VÂRTEJU / GRADINITA NR 3 VARTEJU",1,9902,"ORAŞ MĂGURELE",179409,1029,993,653,340,0,984,9,1100,107,417,567
25,"ILFOV",234,179409,,37,"DUMITRANA / SCOALA PRIMARA NR 2 DUMITRANA",1,9902,"ORAŞ MĂGURELE",179409,800,690,522,168,0,673,17,900,210,398,275
25,"ILFOV",234,179481,,38,"ODĂILE / Grădiniţia cu program prelungit nr. 2",1,9908,"ORAŞ OTOPENI",179481,1480,1431,993,438,0,1418,13,1500,69,497,921
25,"ILFOV",234,179481,,39,"OTOPENI / Liceul Teoretic ""Ioan Petruş""",1,9908,"ORAŞ OTOPENI",179481,1169,1324,789,534,1,1303,21,1349,25,421,882
25,"ILFOV",234,179481,,40,"OTOPENI / Liceul Teoretic ""Ioan Petruş""",1,9908,"ORAŞ OTOPENI",179481,1001,833,656,177,0,822,11,1100,267,306,516
25,"ILFOV",234,179481,,41,"OTOPENI / Liceul Teoretic ""Ioan Petruş""",1,9908,"ORAŞ OTOPENI",179481,1011,767,629,138,0,752,15,899,132,252,500
25,"ILFOV",234,179481,,42,"OTOPENI / Liceul Teoretic ""Ioan Petruş""",1,9908,"ORAŞ OTOPENI",179481,984,1227,636,591,0,1199,28,1291,64,394,805
25,"ILFOV",234,179481,,43,"OTOPENI / Primăria oraşului Otopeni",1,9908,"ORAŞ OTOPENI",179481,1161,1014,763,251,0,996,18,1300,286,349,647
25,"ILFOV",234,179481,,44,"OTOPENI / Primăria oraşului Otopeni",1,9908,"ORAŞ OTOPENI",179481,1114,855,749,106,0,833,22,1048,193,292,541
25,"ILFOV",234,179481,,45,"OTOPENI / Sala de sport Otopeni",1,9908,"ORAŞ OTOPENI",179481,1304,1072,840,232,0,1056,16,1400,328,341,715
25,"ILFOV",234,179481,,46,"OTOPENI / Grădiniţa cu program normal nr. 2",1,9908,"ORAŞ OTOPENI",179481,1589,1397,1091,306,0,1362,35,1700,303,491,871
25,"ILFOV",234,179481,,47,"OTOPENI / Proprietate privată: Farr Mihaela Dana",1,9908,"ORAŞ OTOPENI",179481,744,835,504,193,138,818,17,1000,165,336,482
25,"ILFOV",234,179515,,48,"PANTELIMON / Şcoala generală nr.1",1,9911,"ORAŞ PANTELIMON",179515,1401,1013,822,191,0,993,20,1500,487,497,496
25,"ILFOV",234,179515,,49,"PANTELIMON / Şcoala generală nr.1",1,9911,"ORAŞ PANTELIMON",179515,1431,977,813,164,0,946,31,1500,523,520,426
25,"ILFOV",234,179515,,50,"PANTELIMON / Şcoala generală nr.1",1,9911,"ORAŞ PANTELIMON",179515,1295,897,775,122,0,888,9,1400,503,403,485
25,"ILFOV",234,179515,,51,"PANTELIMON / Şcoala generală nr.1",1,9911,"ORAŞ PANTELIMON",179515,1575,1010,849,161,0,990,19,1700,690,501,489
25,"ILFOV",234,179515,,52,"PANTELIMON / Şcoala generală nr.1",1,9911,"ORAŞ PANTELIMON",179515,1530,878,782,96,0,849,29,1599,721,513,336
25,"ILFOV",234,179515,,53,"PANTELIMON / Şcoala generală nr.1",1,9911,"ORAŞ PANTELIMON",179515,1274,902,764,138,0,891,11,1400,498,477,414
25,"ILFOV",234,179515,,54,"PANTELIMON / Şcoala generală nr.1",1,9911,"ORAŞ PANTELIMON",179515,1165,669,564,105,0,659,10,1300,631,382,277
25,"ILFOV",234,179515,,55,"PANTELIMON / Şcoala generală nr.1",1,9911,"ORAŞ PANTELIMON",179515,1684,1155,970,185,0,1134,21,1900,745,583,551
25,"ILFOV",234,179515,,56,"PANTELIMON / Şcoala generală nr.1",1,9911,"ORAŞ PANTELIMON",179515,1257,1023,810,213,0,1006,17,1400,377,486,520
25,"ILFOV",234,179515,,57,"PANTELIMON / Şcoala generală nr.1",1,9911,"ORAŞ PANTELIMON",179515,1682,1192,979,213,0,1174,18,1800,608,550,624
25,"ILFOV",234,179515,,58,"PANTELIMON / Grădiniţa de copii nr.1",1,9911,"ORAŞ PANTELIMON",179515,1436,841,717,124,0,831,10,1600,759,411,420
25,"ILFOV",234,179515,,59,"PANTELIMON / Grădiniţa de copii nr.1",1,9911,"ORAŞ PANTELIMON",179515,1155,771,628,143,0,761,10,1199,428,410,351
25,"ILFOV",234,179515,,60,"PANTELIMON / Grădiniţa de copii nr.1",1,9911,"ORAŞ PANTELIMON",179515,1133,737,642,95,0,721,15,1200,463,379,342
25,"ILFOV",234,179515,,61,"PANTELIMON / Grădiniţa de copii nr.1",1,9911,"ORAŞ PANTELIMON",179515,1962,1133,1039,94,0,1108,25,2099,966,617,491
25,"ILFOV",234,179515,,62,"PANTELIMON / Grădiniţa de copii nr.1",1,9911,"ORAŞ PANTELIMON",179515,1106,702,620,82,0,685,17,1200,498,411,274
25,"ILFOV",234,179533,,63,"POPEŞTI LEORDENI / Fundaţia Leonardo Murialdo",1,9913,"ORAŞ POPEŞTI LEORDENI",179533,2114,1795,1199,592,4,1770,25,2000,205,532,1238
25,"ILFOV",234,179533,,64,"POPEŞTI LEORDENI / Fundaţia Leonardo Murialdo",1,9913,"ORAŞ POPEŞTI LEORDENI",179533,2059,1764,1255,509,0,1717,42,1900,136,544,1173
25,"ILFOV",234,179533,,65,"POPEŞTI LEORDENI / Fundatia Leonardo Murialdo",1,9913,"ORAŞ POPEŞTI LEORDENI",179533,908,1333,609,724,0,1316,17,1600,267,451,865
25,"ILFOV",234,179533,,66,"POPEŞTI LEORDENI / Şcoala Gimnazială Ioan Bădescu",1,9913,"ORAŞ POPEŞTI LEORDENI",179533,1296,1481,920,561,0,1440,41,1500,19,791,649
25,"ILFOV",234,179533,,67,"POPEŞTI LEORDENI / Şcoala Gimnazială Ioan Bădescu",1,9913,"ORAŞ POPEŞTI LEORDENI",179533,1482,1634,1073,559,2,1602,32,1800,166,847,755
25,"ILFOV",234,179533,,68,"POPEŞTI LEORDENI / Căminul Cultural",1,9913,"ORAŞ POPEŞTI LEORDENI",179533,1695,1713,1111,602,0,1692,21,1797,84,769,923
25,"ILFOV",234,179533,,69,"POPEŞTI LEORDENI / Liceul Teoretic Radu Popescu",1,9913,"ORAŞ POPEŞTI LEORDENI",179533,1367,1159,932,227,0,1138,21,1350,191,558,580
25,"ILFOV",234,179533,,70,"POPEŞTI LEORDENI / Liceul Teoretic Radu Popescu",1,9913,"ORAŞ POPEŞTI LEORDENI",179533,1878,1467,1316,151,0,1436,31,2000,533,753,683
25,"ILFOV",234,179533,,71,"POPEŞTI LEORDENI / Şcoala generală nr. 4",1,9913,"ORAŞ POPEŞTI LEORDENI",179533,1467,1234,979,255,0,1223,8,1600,366,692,531
25,"ILFOV",234,179533,,72,"POPEŞTI LEORDENI / Şcoala generală nr. 3",1,9913,"ORAŞ POPEŞTI LEORDENI",179533,1261,1073,842,231,0,1056,17,1400,327,615,441
25,"ILFOV",234,179533,,73,"POPEŞTI LEORDENI / Şcoala generală nr. 3",1,9913,"ORAŞ POPEŞTI LEORDENI",179533,1428,1097,893,204,0,1080,17,1600,503,654,426
25,"ILFOV",234,179533,,74,"POPEŞTI LEORDENI / SC Miky&Jasmin SRL",1,9913,"ORAŞ POPEŞTI LEORDENI",179533,1796,1216,1015,198,3,1200,16,1300,84,670,530
25,"ILFOV",234,179533,,75,"POPEŞTI LEORDENI / S.C. Agropol  S.A.",1,9913,"ORAŞ POPEŞTI LEORDENI",179533,447,518,267,251,0,517,1,550,32,338,179
25,"ILFOV",234,179533,,76,"POPEŞTI LEORDENI / S.C. Route Construct S.R.L.",1,9913,"ORAŞ POPEŞTI LEORDENI",179533,761,1032,489,543,0,1016,16,1100,68,364,652
25,"ILFOV",234,179551,,77,"VOLUNTARI / Şcoala Generală nr. 3",1,9915,"ORAŞ VOLUNTARI",179551,1998,1852,1307,545,0,1830,22,2200,348,605,1225
25,"ILFOV",234,179551,,78,"VOLUNTARI / Şcoala Generală nr. 3",1,9915,"ORAŞ VOLUNTARI",179551,1889,1769,1171,598,0,1747,20,2100,331,673,1074
25,"ILFOV",234,179551,,79,"VOLUNTARI / Şcoala Generală nr. 3",1,9915,"ORAŞ VOLUNTARI",179551,1909,1534,1294,239,1,1497,37,2100,566,656,841
25,"ILFOV",234,179551,,80,"VOLUNTARI / Şcoala Generală nr. 3",1,9915,"ORAŞ VOLUNTARI",179551,1446,1283,986,297,0,1262,21,1600,317,474,788
25,"ILFOV",234,179551,,81,"VOLUNTARI / Sala de sport ""Andreea Isărescu""",1,9915,"ORAŞ VOLUNTARI",179551,1706,1367,1147,210,10,1335,32,1900,533,820,515
25,"ILFOV",234,179551,,82,"VOLUNTARI / Şcoala Generală nr. 1",1,9915,"ORAŞ VOLUNTARI",179551,1980,1463,1232,184,47,1432,31,2200,737,713,719
25,"ILFOV",234,179551,,83,"VOLUNTARI / Şcoala Generală nr. 1",1,9915,"ORAŞ VOLUNTARI",179551,1798,1312,1141,169,2,1276,36,2000,688,750,526
25,"ILFOV",234,179551,,84,"VOLUNTARI / Şcoala Generală nr. 1",1,9915,"ORAŞ VOLUNTARI",179551,1714,1421,1136,278,7,1391,30,1900,479,772,619
25,"ILFOV",234,179551,,85,"VOLUNTARI / Şcoala Generală nr. 1",1,9915,"ORAŞ VOLUNTARI",179551,1744,1409,1191,215,3,1377,32,1900,491,840,537
25,"ILFOV",234,179551,,86,"VOLUNTARI / Şcoala Generală nr. 1",1,9915,"ORAŞ VOLUNTARI",179551,1641,1178,1082,72,24,1153,25,1800,622,663,490
25,"ILFOV",234,179551,,87,"VOLUNTARI / Şcoala Generală nr. 1",1,9915,"ORAŞ VOLUNTARI",179551,1875,1405,1262,138,5,1372,33,2000,595,912,460
25,"ILFOV",234,179551,,88,"VOLUNTARI / Şcoala Generală nr. 1",1,9915,"ORAŞ VOLUNTARI",179551,1755,1410,1192,205,13,1392,18,1900,490,836,556
25,"ILFOV",234,179551,,89,"VOLUNTARI / Casa de Cultură",1,9915,"ORAŞ VOLUNTARI",179551,1890,1586,1220,348,18,1542,44,2081,495,909,633
25,"ILFOV",234,179551,,90,"VOLUNTARI / Şcoala Generală nr. 2",1,9915,"ORAŞ VOLUNTARI",179551,1812,1426,1192,211,23,1391,35,2000,574,743,648
25,"ILFOV",234,179551,,91,"VOLUNTARI / Şcoala Generală nr. 2",1,9915,"ORAŞ VOLUNTARI",179551,1958,1523,1342,170,11,1494,29,2100,577,872,622
25,"ILFOV",234,179551,,92,"VOLUNTARI / Şcoala Generală nr. 2",1,9915,"ORAŞ VOLUNTARI",179551,1538,1163,1072,85,6,1152,11,1700,537,669,483
25,"ILFOV",234,179551,,93,"VOLUNTARI / Fostul sediu al primăriei",1,9915,"ORAŞ VOLUNTARI",179551,1677,1620,1182,422,16,1593,27,1800,180,913,680
25,"ILFOV",234,179551,,94,"VOLUNTARI / Primăria oraşului Voluntari",1,9915,"ORAŞ VOLUNTARI",179551,1547,1387,1049,333,5,1370,17,1700,313,887,483
25,"ILFOV",234,102543,,95,"1 Decembrie / Şcoala Gimnaziala Nr. 1, Corp A",3,9917,"1 Decembrie",102543,1869,1422,1123,299,0,1399,23,2000,578,753,646
25,"ILFOV",234,102543,,96,"1 Decembrie / Şcoala Gimnaziala Nr. 1, Corp A",3,9917,"1 Decembrie",102543,1545,964,714,250,0,946,18,1700,736,464,482
25,"ILFOV",234,102543,,97,"1 Decembrie / Şcoala Gimnaziala Nr. 1, Corp B",3,9917,"1 Decembrie",102543,1640,1163,967,196,0,1138,25,1800,637,607,531
25,"ILFOV",234,102543,,98,"1 Decembrie / Şcoala Gimnaziala Nr. 1, Corp B",3,9917,"1 Decembrie",102543,1484,1024,823,201,0,996,28,1600,576,596,400
25,"ILFOV",234,100834,,99,"AFUMAŢI / Şcoala Generală nr.1",3,9919,"AFUMAŢI",100834,826,704,501,200,3,694,10,898,194,308,386
25,"ILFOV",234,100834,,100,"AFUMAŢI / Şcoala Generală nr. 1 cu clasele V - VIII",3,9919,"AFUMAŢI",100834,1156,925,752,170,3,907,18,1300,375,352,555
25,"ILFOV",234,100834,,101,"AFUMAŢI / Şcoala Generală nr. 3 cu clasele I - IV",3,9919,"AFUMAŢI",100834,1574,1234,1060,162,12,1216,18,1700,466,506,710
25,"ILFOV",234,100834,,102,"AFUMAŢI / Şcoala Generală nr. 2 cu clasele I - IV",3,9919,"AFUMAŢI",100834,1522,1153,969,182,2,1132,21,1700,547,444,688
25,"ILFOV",234,100834,,103,"AFUMAŢI / Scoala cu clasele I-IV",3,9919,"AFUMAŢI",100834,1080,885,725,157,3,864,21,1199,314,329,535
25,"ILFOV",234,100969,,104,"BALOTEŞTI / Căminul Cultural",3,9921,"BALOTEŞTI",100969,1250,1153,810,287,56,1131,22,1400,247,511,620
25,"ILFOV",234,100969,,105,"BALOTEŞTI / Şcoala nr. 1 Baloteşti",3,9921,"BALOTEŞTI",100969,1265,903,712,191,0,883,20,1400,497,400,483
25,"ILFOV",234,100969,,106,"BALOTEŞTI / Şcoala nr. 1 Baloteşti",3,9921,"BALOTEŞTI",100969,929,678,592,86,0,672,6,900,222,313,359
25,"ILFOV",234,100969,,107,"BALOTEŞTI / Şcoala nr. 3 Baloteşti",3,9921,"BALOTEŞTI",100969,1912,1554,1227,325,2,1521,33,2100,546,665,856
25,"ILFOV",234,100969,,108,"SĂFTICA / Şcoala nr. 2 SĂFTICA",3,9921,"BALOTEŞTI",100969,1074,979,712,251,16,965,14,1200,221,443,522
25,"ILFOV",234,101145,,109,"BERCENI / Şcoala Primara nr. 2",3,9925,"BERCENI",101145,1421,1399,941,438,20,1379,20,1500,101,708,671
25,"ILFOV",234,101145,,110,"BERCENI / Şcoala Gimnaziala nr. 1",3,9925,"BERCENI",101145,1701,1721,1121,585,15,1692,29,1799,78,850,842
25,"ILFOV",234,101145,,111,"BERCENI / Scoala Primara nr. 2",3,9925,"BERCENI",101145,1415,1463,992,455,16,1432,31,1500,37,795,637
25,"ILFOV",234,101298,,112,"BRĂNEŞTI / Şcoala Generală nr.1",3,9927,"BRĂNEŞTI",101298,797,647,474,173,0,643,4,900,253,306,337
25,"ILFOV",234,101298,,113,"BRĂNEŞTI / Şcoala generală din cartierul Băjenari",3,9927,"BRĂNEŞTI",101298,1638,1146,1002,144,0,1125,21,1800,654,510,615
25,"ILFOV",234,101298,,114,"BRĂNEŞTI / Scoala generala nr.1 Branesti",3,9927,"BRĂNEŞTI",101298,1299,852,753,99,0,835,17,1400,548,455,380
25,"ILFOV",234,101298,,115,"BRĂNEŞTI / Liceul Teoretic ""Traian Lalescu""",3,9927,"BRĂNEŞTI",101298,1739,1439,1087,352,0,1425,14,1900,461,675,750
25,"ILFOV",234,101298,,116,"PASĂREA / Şcoala Generală",3,9927,"BRĂNEŞTI",101298,790,654,457,197,0,639,15,900,246,349,290
25,"ILFOV",234,101298,,117,"ISLAZ / Grădiniţa de copii",3,9927,"BRĂNEŞTI",101298,1142,809,654,155,0,803,6,1300,491,520,283
25,"ILFOV",234,101742,,118,"CERNICA / Şcoala Generală nr.1",3,9932,"CERNICA",101742,919,649,485,164,0,633,16,1000,351,368,265
25,"ILFOV",234,101742,,119,"CERNICA / Şcoala Generală nr.1",3,9932,"CERNICA",101742,954,606,502,104,0,593,13,1100,494,376,217
25,"ILFOV",234,101742,,120,"CERNICA / Şcoala Generală nr.1",3,9932,"CERNICA",101742,1020,644,541,103,0,624,20,1100,456,428,196
25,"ILFOV",234,101742,,121,"BĂLĂCEANCA / Şcoala Generală nr.4",3,9932,"CERNICA",101742,1052,672,550,122,0,651,21,1100,428,425,226
25,"ILFOV",234,101742,,122,"BĂLĂCEANCA / Şcoala Generală nr.4",3,9932,"CERNICA",101742,1054,786,603,166,17,771,15,1100,314,489,282
25,"ILFOV",234,101742,,123,"CĂLDĂRARU / Şcoala Generală nr.2",3,9932,"CERNICA",101742,826,678,507,171,0,660,18,900,222,414,246
25,"ILFOV",234,101742,,124,"TÎNGANU / Şcoala Generală nr.3",3,9932,"CERNICA",101742,1175,697,569,128,0,688,9,1300,603,410,278
25,"ILFOV",234,101742,,125,"TÎNGANU / Şcoala Generală nr.3",3,9932,"CERNICA",101742,1099,684,600,84,0,667,17,1200,516,464,203
25,"ILFOV",234,179249,,126,"CHIAJNA / Sala Sport Concordia",3,9938,"CHIAJNA",179249,1665,1730,1197,533,0,1692,38,1800,70,841,851
25,"ILFOV",234,179249,,127,"CHIAJNA / Sala Sport Concordia",3,9938,"CHIAJNA",179249,1916,1809,1377,432,0,1777,32,2100,291,1076,701
25,"ILFOV",234,179249,,128,"DUDU / Sala de Sport Concordia Chiajna",3,9938,"CHIAJNA",179249,1446,1330,970,360,0,1321,9,1500,170,774,547
25,"ILFOV",234,179249,,129,"ROŞU / Liceul Tehnologic ""Doamna Chiajna""",3,9938,"CHIAJNA",179249,1603,1353,1058,295,0,1231,122,1700,347,635,596
25,"ILFOV",234,179249,,130,"ROŞU / Liceul Tehnologic ""Doamna Chiajna""",3,9938,"CHIAJNA",179249,1304,1025,825,200,0,964,61,1200,175,496,468
25,"ILFOV",234,179249,,131,"ROŞU / Liceul Tehnologic ""Doamna Chiajna""",3,9938,"CHIAJNA",179249,1512,1286,952,334,0,1157,129,1600,314,532,625
25,"ILFOV",234,179249,,132,"ROŞU / Grădiniţa Kids Club",3,9938,"CHIAJNA",179249,1133,1342,765,577,0,1326,16,1400,58,356,970
25,"ILFOV",234,179249,,133,"ROŞU / Gradinita Kids Club",3,9938,"CHIAJNA",179249,1512,1587,978,609,0,1565,22,1600,13,435,1130
25,"ILFOV",234,101902,,134,"CIOLPANI / Căminul Cultural Ciolpani",3,9942,"CIOLPANI",101902,1877,1339,1070,269,0,1329,10,2000,661,522,807
25,"ILFOV",234,101902,,135,"PISCU / Scoala Generală cu clasele I-IV",3,9942,"CIOLPANI",101902,743,570,462,107,1,567,3,800,230,218,349
25,"ILFOV",234,101902,,136,"LUPĂRIA / Scoala Generala cu clasele I-IV Ciolpani",3,9942,"CIOLPANI",101902,1050,817,650,141,26,805,12,1100,283,300,505
25,"ILFOV",234,101902,,137,"IZVORANI / Scoala Generală  cu clasele I-IV",3,9942,"CIOLPANI",101902,526,504,313,190,1,497,7,600,96,190,307
25,"ILFOV",234,101957,,138,"CIOROGÎRLA / Şcoala nr. 1 Ciorogîrla",3,9947,"CIOROGÎRLA",101957,1223,956,655,301,0,943,13,1298,342,446,497
25,"ILFOV",234,101957,,139,"CIOROGÎRLA / Şcoala nr. 1 Ciorogârla",3,9947,"CIOROGÎRLA",101957,1635,1266,900,366,0,1250,16,1800,534,605,645
25,"ILFOV",234,101957,,140,"DÎRVARI / Şcoala nr.  2 Dârvari",3,9947,"CIOROGÎRLA",101957,1594,810,666,144,0,792,18,1799,989,418,374
25,"ILFOV",234,102035,,141,"CLINCENI / Liceul Sportiv Clinceni",3,9950,"CLINCENI",102035,1683,1307,1045,262,0,1287,20,1900,593,587,700
25,"ILFOV",234,102035,,142,"CLINCENI / Liceul Sportiv Clinceni",3,9950,"CLINCENI",102035,1954,1656,1191,464,1,1629,25,2099,443,745,884
25,"ILFOV",234,102035,,143,"OLTENI / Liceul Sportiv Clinceni",3,9950,"CLINCENI",102035,1425,1229,888,341,0,1208,21,1600,371,437,771
25,"ILFOV",234,179588,,144,"COPĂCENI / Aşezământul social al Bisericii Sf. Dumitru",3,9954,"COPĂCENI",179588,1412,1159,859,300,0,1137,22,1600,441,705,432
25,"ILFOV",234,179588,,145,"COPĂCENI / Şcoala Generală",3,9954,"COPĂCENI",179588,881,779,558,221,0,771,8,1000,221,559,212
25,"ILFOV",234,102160,,146,"CORBEANCA / Şcoala gimnazială nr. 1",3,9956,"CORBEANCA",102160,1972,1829,1121,706,2,1808,21,1898,69,713,1095
25,"ILFOV",234,102160,,147,"TAMAŞI / Şcoala gimnazială nr. 2",3,9956,"CORBEANCA",102160,1466,1491,1010,481,0,1473,18,1600,109,707,766
25,"ILFOV",234,102160,,148,"OSTRATU / Clădirea After School",3,9956,"CORBEANCA",102160,825,1249,573,676,0,1229,20,1300,51,408,821
25,"ILFOV",234,102160,,149,"PETREŞTI / Grădiniţa nr. 1",3,9956,"CORBEANCA",102160,584,788,413,375,0,774,14,950,162,329,445
25,"ILFOV",234,102213,,150,"CORNETU / Şcoala gimnazială nr.1",3,9961,"CORNETU",102213,936,666,544,122,0,657,9,800,134,310,347
25,"ILFOV",234,102213,,151,"CORNETU / Şcoala gimnazială nr.1",3,9961,"CORNETU",102213,869,608,503,105,0,602,6,800,192,296,306
25,"ILFOV",234,102213,,152,"CORNETU / Şcoala gimnazială nr.1",3,9961,"CORNETU",102213,892,576,492,84,0,570,6,800,224,244,326
25,"ILFOV",234,102213,,153,"CORNETU / Şcoala gimnazială nr.1",3,9961,"CORNETU",102213,867,622,503,119,0,615,7,800,178,271,344
25,"ILFOV",234,102213,,154,"CORNETU / Şcoala gimnazială nr.1",3,9961,"CORNETU",102213,1042,729,593,136,0,721,8,900,171,334,387
25,"ILFOV",234,102473,,155,"DASCĂLU / Şcoala cu Clasele I-VIII Dacălu",3,9966,"DASCĂLU",102473,1699,1239,979,260,0,1229,10,1900,661,670,559
25,"ILFOV",234,102473,,156,"GAGU / Grădiniţa Nr. 2 Gagu",3,9966,"DASCĂLU",102473,579,438,355,83,0,432,6,600,162,187,245
25,"ILFOV",234,102525,,157,"DĂRĂŞTI-ILFOV / Şcoala Generală nr. 1",3,9964,"DĂRĂŞTI-ILFOV",102525,1086,707,600,107,0,699,8,1200,493,390,309
25,"ILFOV",234,102525,,158,"DĂRĂŞTI-ILFOV / Şcoala Generală nr. 1",3,9964,"DĂRĂŞTI-ILFOV",102525,1212,953,785,168,0,937,16,1300,347,610,327
25,"ILFOV",234,179310,,159,"DOBROEŞTI / Şcoala nr.  1 Dobroeşti",3,9971,"DOBROEŞTI",179310,1320,1035,860,175,0,1012,23,1500,465,541,471
25,"ILFOV",234,179310,,160,"DOBROEŞTI / Şcoala nr.  1 Dobroeşti",3,9971,"DOBROEŞTI",179310,1371,1092,877,215,0,1065,27,1500,408,524,541
25,"ILFOV",234,179310,,161,"DOBROEŞTI / Şcoala nr.  1 Dobroeşti",3,9971,"DOBROEŞTI",179310,1358,1064,884,180,0,1034,30,1500,436,562,472
25,"ILFOV",234,179310,,162,"FUNDENI / Şcoala nr.  2 Fundeni",3,9971,"DOBROEŞTI",179310,1754,1397,1135,262,0,1379,18,1899,502,675,704
25,"ILFOV",234,179310,,163,"FUNDENI / Şcoala nr.  2 Fundeni",3,9971,"DOBROEŞTI",179310,1218,1020,750,270,0,1001,19,1299,279,566,435
25,"ILFOV",234,102570,,164,"DOMNEŞTI / Şcoala gimnazială nr. 1 - Şcoala Cojeşti",3,9974,"DOMNEŞTI",102570,1013,980,542,436,2,964,16,1100,120,374,590
25,"ILFOV",234,102570,,165,"DOMNEŞTI / Şcoala gimnazială nr. 1 - Şcoala Cojeşti",3,9974,"DOMNEŞTI",102570,2022,1565,1221,344,0,1529,36,2050,485,558,971
25,"ILFOV",234,102570,,166,"DOMNEŞTI / Şcoala gimnazială nr. 1 - Şcoala Mare",3,9974,"DOMNEŞTI",102570,1179,1148,638,510,0,1129,19,1299,151,447,682
25,"ILFOV",234,102570,,167,"DOMNEŞTI / Şcoala primară nr. 1 - Şcoala Băleanu",3,9974,"DOMNEŞTI",102570,1657,1528,986,542,0,1497,31,1800,272,560,937
25,"ILFOV",234,102570,,168,"ŢEGHEŞ / Şcoala primară nr. 2 - Şcoala Ţegheş",3,9974,"DOMNEŞTI",102570,570,705,339,366,0,688,17,750,45,265,423
25,"ILFOV",234,102605,,169,"DRAGOMIREŞTI-DEAL / Şcoala Generală nr. 2",3,9977,"DRAGOMIREŞTI-VALE",102605,1213,991,779,212,0,971,20,1300,309,450,521
25,"ILFOV",234,102605,,170,"ZURBAUA / Şcoala Generală nr. 3",3,9977,"DRAGOMIREŞTI-VALE",102605,751,571,464,107,0,561,10,800,229,219,342
25,"ILFOV",234,102605,,171,"DRAGOMIREŞTI-VALE / Grupul Şcolar ""Vintilă Brătianu""",3,9977,"DRAGOMIREŞTI-VALE",102605,1163,920,717,203,0,901,19,1300,380,401,500
25,"ILFOV",234,102605,,172,"DRAGOMIREŞTI-DEAL / Şcoala veche",3,9977,"DRAGOMIREŞTI-VALE",102605,860,746,576,170,0,733,13,900,154,341,392
25,"ILFOV",234,103130,,173,"GĂNEASA / Şcoala Găneasa",3,9981,"GĂNEASA",103130,823,553,388,165,0,547,6,900,347,250,297
25,"ILFOV",234,103130,,174,"MOARA DOMNEASCĂ / Şcoala Moara Domnească",3,9981,"GĂNEASA",103130,512,442,332,110,0,435,7,600,158,176,259
25,"ILFOV",234,103130,,175,"COZIENI / Şcoala Cozieni",3,9981,"GĂNEASA",103130,603,510,420,90,0,497,13,700,190,167,330
25,"ILFOV",234,103130,,176,"ŞINDRILIŢA / Grădiniţa Şindriliţa",3,9981,"GĂNEASA",103130,932,681,595,86,0,669,12,1000,319,397,272
25,"ILFOV",234,103130,,177,"PITEASCA / Şcoala Piteasca",3,9981,"GĂNEASA",103130,950,694,619,75,0,676,18,1000,306,460,216
25,"ILFOV",234,179347,,178,"GLINA / Şcoala nr.   1",3,9987,"GLINA",179347,1531,964,828,135,1,943,21,1700,736,498,445
25,"ILFOV",234,179347,,179,"GLINA / Şcoala nr.   1",3,9987,"GLINA",179347,1197,799,687,110,2,790,9,1300,501,347,443
25,"ILFOV",234,179347,,180,"GLINA / Şcoala nr.   3",3,9987,"GLINA",179347,1455,767,650,117,0,751,16,1600,833,578,173
25,"ILFOV",234,179347,,181,"CĂŢELU / Şcoala nr.   2",3,9987,"GLINA",179347,1257,824,708,116,0,804,20,1400,576,410,394
25,"ILFOV",234,179347,,182,"CĂŢELU / Şcoala nr.   2",3,9987,"GLINA",179347,923,702,570,132,0,684,18,1000,298,330,354
25,"ILFOV",234,103443,,183,"GRĂDIŞTEA / Căminul cultural multifuncţional",3,9991,"GRĂDIŞTEA",103443,1658,1202,963,233,6,1182,20,1800,598,660,522
25,"ILFOV",234,103443,,184,"SITARU / Şcoala primară nr. 1 Sitaru",3,9991,"GRĂDIŞTEA",103443,857,620,486,134,0,603,17,900,280,364,239
25,"ILFOV",234,103513,,185,"LIPIA / Grădiniţa de copii",3,9994,"GRUIU",103513,1753,1210,1044,166,0,1192,18,1900,690,625,567
25,"ILFOV",234,103513,,186,"GRUIU / Şcoala de 4 ani",3,9994,"GRUIU",103513,1624,1235,969,266,0,1229,6,1800,565,566,663
25,"ILFOV",234,103513,,187,"ŞANŢU FLOREŞTI / Şcoala de 4 ani",3,9994,"GRUIU",103513,531,484,389,95,0,476,8,600,116,191,285
25,"ILFOV",234,103513,,188,"SILIŞTEA SNAGOVULUI / Şcoala de 8 ani",3,9994,"GRUIU",103513,1781,1416,1059,357,0,1402,14,1900,484,574,828
25,"ILFOV",234,179383,,189,"JILAVA / S.C. Progresu S.A.",3,9999,"JILAVA",179383,1607,1418,809,191,418,1406,12,2023,605,981,425
25,"ILFOV",234,179383,,190,"JILAVA / Şcoala nr.2",3,9999,"JILAVA",179383,1461,1233,870,101,262,1214,19,1924,691,715,499
25,"ILFOV",234,179383,,191,"JILAVA / Şcoala nr.1",3,9999,"JILAVA",179383,1981,1664,1086,248,330,1633,31,2524,860,979,654
25,"ILFOV",234,179383,,192,"JILAVA / Şcoala nr.3",3,9999,"JILAVA",179383,2001,1475,1087,130,258,1436,28,2539,1064,994,442
25,"ILFOV",234,179383,,193,"JILAVA / Incinta fostului CAP",3,9999,"JILAVA",179383,1538,1272,822,86,364,1262,10,1818,546,864,398
25,"ILFOV",234,104243,,194,"MOARA VLĂSIEI / Şcoala Generală nr. 2 Moara Vlasiei",3,10001,"MOARA VLĂSIEI",104243,1786,1337,1204,133,0,1318,19,1900,563,473,845
25,"ILFOV",234,104243,,195,"MOARA VLĂSIEI / Şcoala Generală nr. 1 Moara Vlasiei",3,10001,"MOARA VLĂSIEI",104243,1714,1265,1120,145,0,1253,12,1900,635,473,780
25,"ILFOV",234,104243,,196,"CĂCIULAŢI / Şcoala Generală nr. 3  ""Al. Dimitrie Ghica """,3,10001,"MOARA VLĂSIEI",104243,1531,1152,975,176,1,1136,16,1699,547,294,842
25,"ILFOV",234,179463,,197,"MOGOŞOAIA / Şcoala Generală nr. 1",3,10004,"MOGOŞOAIA",179463,1087,1048,681,367,0,1039,9,1200,152,372,667
25,"ILFOV",234,179463,,198,"MOGOŞOAIA / Şcoala Generală nr. 1",3,10004,"MOGOŞOAIA",179463,1086,1034,675,359,0,1022,12,1200,166,344,678
25,"ILFOV",234,179463,,199,"MOGOŞOAIA / Şcoala Generală nr. 1",3,10004,"MOGOŞOAIA",179463,849,721,554,167,0,705,16,900,179,257,448
25,"ILFOV",234,179463,,200,"MOGOŞOAIA / Şcoala Generală nr. 1",3,10004,"MOGOŞOAIA",179463,1388,874,839,35,0,860,14,1500,626,146,714
25,"ILFOV",234,179463,,201,"MOGOŞOAIA / Şcoala Generală nr. 1",3,10004,"MOGOŞOAIA",179463,1527,1187,960,227,0,1174,13,1600,413,350,824
25,"ILFOV",234,104421,,202,"MICŞUNEŞTII-MOARĂ / Şcoala din satul Micşuneştii-Moară",3,10006,"NUCI",104421,1340,1200,896,282,22,1184,16,1500,300,884,300
25,"ILFOV",234,104421,,203,"MERII PETCHII / Şcoala din satul Merii Petchii",3,10006,"NUCI",104421,993,854,626,192,36,845,9,1100,246,595,250
25,"ILFOV",234,104546,,204,"PERIŞ / Liceul Periş",3,10012,"PERIŞ",104546,1902,1207,1017,190,0,1184,23,2100,893,543,641
25,"ILFOV",234,104546,,205,"PERIŞ / Şcoala nr. 2 Peris",3,10012,"PERIŞ",104546,1992,1406,1203,203,0,1379,27,2200,794,628,751
25,"ILFOV",234,104546,,206,"PERIŞ / Fosta Şcoala nr. 3 Peris",3,10012,"PERIŞ",104546,609,463,357,106,0,452,11,700,237,188,264
25,"ILFOV",234,104546,,207,"BURIAŞ / Şcoala nr. 4 Buriaş",3,10012,"PERIŞ",104546,1114,897,736,147,14,892,5,1200,303,354,538
25,"ILFOV",234,104546,,208,"BĂLTENI / Şcoala nr. 5 Bălteni",3,10012,"PERIŞ",104546,398,347,265,82,0,344,3,450,103,152,192
25,"ILFOV",234,104582,,209,"PETRĂCHIOAIA / Structura cu grupe de preşcolari",3,10016,"PETRĂCHIOAIA",104582,1574,1260,947,312,1,1245,15,1700,440,521,724
25,"ILFOV",234,104582,,210,"MĂINEASCA / Structura cu clasele I-IV şi grupe de preşcolari",3,10016,"PETRĂCHIOAIA",104582,268,268,187,81,0,262,6,300,32,113,149
25,"ILFOV",234,104582,,211,"VÎNĂTORI / Structura cu clasele I-IV şi grupe de preşcolari",3,10016,"PETRĂCHIOAIA",104582,331,320,217,103,0,311,9,399,79,138,173
25,"ILFOV",234,104582,,212,"SURLARI / Structura cu clasele I-IV şi grupe de preşcolari",3,10016,"PETRĂCHIOAIA",104582,425,353,278,75,0,350,3,450,97,168,182
25,"ILFOV",234,105160,,213,"SNAGOV / Şcoala generală Snagov",3,10021,"SNAGOV",105160,1558,1443,971,472,0,1418,23,1700,257,744,674
25,"ILFOV",234,105160,,214,"GHERMĂNEŞTI / Casa de Cultură Ghermăneşti",3,10021,"SNAGOV",105160,1155,1244,768,476,0,1216,28,1359,115,567,649
25,"ILFOV",234,105160,,215,"GHERMĂNEŞTI / Casa de Cultură Ghermăneşti",3,10021,"SNAGOV",105160,1082,1106,704,402,0,1087,19,1189,83,495,592
25,"ILFOV",234,105160,,216,"CIOFLINCENI / Grădiniţa nr. 1 Ciofliceni",3,10021,"SNAGOV",105160,936,841,618,223,0,832,9,1000,159,385,447
25,"ILFOV",234,105160,,217,"TÎNCĂBEŞTI / Şcoala gimnazială ""Constantin I.Băicoianu""",3,10021,"SNAGOV",105160,1430,1014,806,208,0,995,19,1350,336,515,480
25,"ILFOV",234,105419,,218,"ŞTEFĂNEŞTII DE JOS / Şcoala nr.  1 cu clasele  I-VIII",3,10027,"ŞTEFĂNEŞTII DE JOS",105419,1006,1025,707,317,1,1004,21,1116,91,511,493
25,"ILFOV",234,105419,,219,"ŞTEFĂNEŞTII DE JOS / Şcoala nr.  1 cu clasele  I-VIII",3,10027,"ŞTEFĂNEŞTII DE JOS",105419,1464,1372,954,418,0,1347,25,1599,227,759,588
25,"ILFOV",234,105419,,220,"CREŢULEASCA / Şcoala nr.  1 cu clasele  I-VIII",3,10027,"ŞTEFĂNEŞTII DE JOS",105419,1699,1390,1011,378,1,1366,24,1800,410,623,743
25,"ILFOV",234,105419,,221,"ŞTEFĂNEŞTII DE SUS / Şcoala nr.  1 cu clasele  I-VIII",3,10027,"ŞTEFĂNEŞTII DE JOS",105419,805,795,583,212,0,775,20,900,105,408,367
25,"ILFOV",234,105570,,222,"TUNARI / Scoala nr. 1 Tunari - corp A",3,10031,"TUNARI",105570,1380,1383,859,522,2,1360,23,1500,117,667,693
25,"ILFOV",234,105570,,223,"TUNARI / Şcoala nr. 1 Tunari - corp C",3,10031,"TUNARI",105570,1546,1304,912,390,2,1275,29,1700,396,573,702
25,"ILFOV",234,105570,,224,"TUNARI / Scoala nr. 1 Tunari - corp B",3,10031,"TUNARI",105570,1295,987,823,164,0,976,11,1400,413,481,495
25,"ILFOV",234,105936,,225,"VIDRA / Şcoala Generală nr. 304 Vidra",3,10034,"VIDRA",105936,916,474,356,118,0,471,3,1100,626,171,300
25,"ILFOV",234,105936,,226,"VIDRA / Şcoala Generală nr. 304 Vidra",3,10034,"VIDRA",105936,838,591,468,123,0,581,10,800,209,258,323
25,"ILFOV",234,105936,,227,"VIDRA / Şcoala Generală nr. 301 Vidra",3,10034,"VIDRA",105936,1233,868,698,170,0,861,7,1400,532,331,530
25,"ILFOV",234,105936,,228,"CREŢEŞTI / Şcoala Generală nr. 302 Creţeşti",3,10034,"VIDRA",105936,1171,698,597,101,0,690,8,1300,602,298,392
25,"ILFOV",234,105936,,229,"CREŢEŞTI / Şcoala Generală nr. 302 Creţeşti",3,10034,"VIDRA",105936,831,565,446,118,1,552,13,900,335,226,326
25,"ILFOV",234,105936,,230,"SINTEŞTI / Şcoala Generală nr. 303 Sinteşti",3,10034,"VIDRA",105936,880,534,423,111,0,525,9,1000,466,321,204
25,"ILFOV",234,105936,,231,"SINTEŞTI / Şcoala Generală nr. 303 Sinteşti",3,10034,"VIDRA",105936,968,621,487,134,0,606,15,984,363,503,103
26,"MARAMUREŞ","#N/A",106318,,1,"BAIA MARE / Şcoala Gimnazială nr. 7",1,10039,"MUNICIPIUL BAIA MARE",106318,1831,1034,1000,34,0,1018,16,1996,962,349,669
26,"MARAMUREŞ","#N/A",106318,,2,"BAIA MARE / Şcoala Gimnazială Dr. Victor Babeş",1,10039,"MUNICIPIUL BAIA MARE",106318,1941,1274,1173,101,0,1261,13,2100,826,415,846
26,"MARAMUREŞ","#N/A",106318,,3,"BAIA MARE / Şcoala Gimnazială Dr. Victor Babeş",1,10039,"MUNICIPIUL BAIA MARE",106318,1744,1067,975,92,0,1055,12,1900,833,332,723
26,"MARAMUREŞ","#N/A",106318,,4,"BAIA MARE / Colegiul Tehnic Aurel Vlaicu",1,10039,"MUNICIPIUL BAIA MARE",106318,1421,731,683,48,0,717,14,1600,869,248,469
26,"MARAMUREŞ","#N/A",106318,,5,"BAIA MARE / Colegiul Tehnic Aurel Vlaicu",1,10039,"MUNICIPIUL BAIA MARE",106318,1645,855,804,50,1,847,8,1700,845,295,552
26,"MARAMUREŞ","#N/A",106318,,6,"BAIA MARE / Centrul Universitar Nord - Facultatea Tehnică",1,10039,"MUNICIPIUL BAIA MARE",106318,1413,783,707,75,1,770,13,1600,817,236,534
26,"MARAMUREŞ","#N/A",106318,,7,"BAIA MARE / Şcoala Gimnazială Nichita Stănescu",1,10039,"MUNICIPIUL BAIA MARE",106318,1669,1130,985,105,40,1114,16,1800,670,347,767
26,"MARAMUREŞ","#N/A",106318,,8,"BAIA MARE / Şcoala cu clasele I-VIII Nichita Stănescu",1,10039,"MUNICIPIUL BAIA MARE",106318,1612,937,840,55,42,921,16,1700,763,332,589
26,"MARAMUREŞ","#N/A",106318,,9,"BAIA MARE / Şcoala Gimnazială Avram Iancu",1,10039,"MUNICIPIUL BAIA MARE",106318,1102,651,610,40,1,642,9,1200,549,219,423
26,"MARAMUREŞ","#N/A",106318,,10,"BAIA MARE / Şcoala Gimnazială Avram Iancu",1,10039,"MUNICIPIUL BAIA MARE",106318,1140,704,677,27,0,697,7,1200,496,227,470
26,"MARAMUREŞ","#N/A",106318,,11,"BAIA MARE / Şcoala Gimnazială Avram Iancu",1,10039,"MUNICIPIUL BAIA MARE",106318,1033,618,574,44,0,606,12,1200,582,204,402
26,"MARAMUREŞ","#N/A",106318,,12,"BAIA MARE / Şcoala Gimnazială Avram Iancu",1,10039,"MUNICIPIUL BAIA MARE",106318,1440,886,834,52,0,875,11,1600,714,265,610
26,"MARAMUREŞ","#N/A",106318,,13,"BAIA MARE / Centrul Universitar Nord - Facultatea de Litere",1,10039,"MUNICIPIUL BAIA MARE",106318,1476,914,868,46,0,902,12,1600,686,309,593
26,"MARAMUREŞ","#N/A",106318,,14,"BAIA MARE / Bazinul Olimpic",1,10039,"MUNICIPIUL BAIA MARE",106318,1663,975,921,54,0,966,9,1800,825,311,655
26,"MARAMUREŞ","#N/A",106318,,15,"BAIA MARE / Şcoala Gimnazială George Coşbuc",1,10039,"MUNICIPIUL BAIA MARE",106318,1303,762,723,38,1,748,14,1400,638,255,493
26,"MARAMUREŞ","#N/A",106318,,16,"BAIA MARE / Şcoala Gimnazială George Coşbuc",1,10039,"MUNICIPIUL BAIA MARE",106318,1122,639,598,41,0,628,11,1200,561,229,399
26,"MARAMUREŞ","#N/A",106318,,17,"BAIA MARE / Şcoala Gimnazială Nicolae Iorga",1,10039,"MUNICIPIUL BAIA MARE",106318,956,627,546,80,1,619,8,1000,373,231,388
26,"MARAMUREŞ","#N/A",106318,,18,"BAIA MARE / Grădiniţa cu program prelungit nr. 9",1,10039,"MUNICIPIUL BAIA MARE",106318,1225,754,711,42,1,749,5,1400,646,230,519
26,"MARAMUREŞ","#N/A",106318,,19,"BAIA MARE / Grădiniţa cu program normal nr. 20",1,10039,"MUNICIPIUL BAIA MARE",106318,1628,1044,951,92,1,1024,20,1800,756,373,651
26,"MARAMUREŞ","#N/A",106318,,20,"BAIA MARE / Liceul Teoretic Emil Racoviţă",1,10039,"MUNICIPIUL BAIA MARE",106318,1585,944,833,48,63,932,12,1700,756,307,625
26,"MARAMUREŞ","#N/A",106318,,21,"BAIA MARE / Liceul Teoretic Emil Racoviţă",1,10039,"MUNICIPIUL BAIA MARE",106318,1576,942,824,37,81,935,7,1600,658,307,628
26,"MARAMUREŞ","#N/A",106318,,22,"BAIA MARE / Şcoala Gimnazială Al. I. Cuza",1,10039,"MUNICIPIUL BAIA MARE",106318,1559,948,813,63,72,938,10,1600,652,333,605
26,"MARAMUREŞ","#N/A",106318,,23,"BAIA MARE / Şcoala Gimnazială Al. I. Cuza",1,10039,"MUNICIPIUL BAIA MARE",106318,1651,1007,889,54,64,989,18,1800,793,362,627
26,"MARAMUREŞ","#N/A",106318,,24,"BAIA MARE / Grădiniţa cu program prelungit MICUL PRINŢ",1,10039,"MUNICIPIUL BAIA MARE",106318,1591,874,819,46,9,862,12,1800,926,328,534
26,"MARAMUREŞ","#N/A",106318,,25,"BAIA MARE / Şcoala Gimnazială nr. 18",1,10039,"MUNICIPIUL BAIA MARE",106318,1598,968,860,108,0,958,10,1800,832,271,687
26,"MARAMUREŞ","#N/A",106318,,26,"BAIA MARE / Şcoala Gimnazială nr. 18",1,10039,"MUNICIPIUL BAIA MARE",106318,1573,882,835,47,0,869,13,1700,818,304,565
26,"MARAMUREŞ","#N/A",106318,,27,"BAIA MARE / Şcoala Gimnazială nr. 18",1,10039,"MUNICIPIUL BAIA MARE",106318,1493,658,616,42,0,652,6,1700,1042,222,430
26,"MARAMUREŞ","#N/A",106318,,28,"BAIA MARE / Grădiniţa  cu program prelungit nr. 28",1,10039,"MUNICIPIUL BAIA MARE",106318,1613,851,806,45,0,836,15,1800,949,267,569
26,"MARAMUREŞ","#N/A",106318,,29,"BAIA MARE / Grădiniţa cu program prelungit nr. 25",1,10039,"MUNICIPIUL BAIA MARE",106318,1504,771,705,64,2,761,10,1700,929,227,534
26,"MARAMUREŞ","#N/A",106318,,30,"BAIA MARE / Grădiniţa cu program prelungit nr. 25",1,10039,"MUNICIPIUL BAIA MARE",106318,1370,718,680,38,0,709,9,1600,882,229,480
26,"MARAMUREŞ","#N/A",106318,,31,"BAIA MARE / Şcoala Gimnazială  I.L. Caragiale",1,10039,"MUNICIPIUL BAIA MARE",106318,944,511,482,29,0,502,9,1000,489,180,322
26,"MARAMUREŞ","#N/A",106318,,32,"BAIA MARE / Şcoala Gimnazială  I.L. Caragiale",1,10039,"MUNICIPIUL BAIA MARE",106318,1400,791,742,49,0,788,3,1600,809,263,525
26,"MARAMUREŞ","#N/A",106318,,33,"BAIA MARE / Şcoala Gimnazială  I.L. Caragiale",1,10039,"MUNICIPIUL BAIA MARE",106318,1342,631,590,41,0,621,10,1600,969,215,406
26,"MARAMUREŞ","#N/A",106318,,34,"BAIA MARE / Grădiniţa cu program prelungit nr. 34",1,10039,"MUNICIPIUL BAIA MARE",106318,1513,820,790,30,0,809,11,1700,880,254,555
26,"MARAMUREŞ","#N/A",106318,,35,"BAIA MARE / Grădiniţa cu program prelungit FLOARE DE COLŢ",1,10039,"MUNICIPIUL BAIA MARE",106318,1542,795,761,34,0,788,7,1700,905,276,512
26,"MARAMUREŞ","#N/A",106318,,36,"BAIA MARE / Şcoala Gimnazială Alex. Ivasiuc",1,10039,"MUNICIPIUL BAIA MARE",106318,1540,778,716,62,0,775,3,1700,922,271,504
26,"MARAMUREŞ","#N/A",106318,,37,"BAIA MARE / Şcoala Gimnazială Alex. Ivasiuc",1,10039,"MUNICIPIUL BAIA MARE",106318,1510,847,809,37,1,841,6,1700,853,302,539
26,"MARAMUREŞ","#N/A",106318,,38,"BAIA MARE / Şcoala Gimnazială  D. Cantemir",1,10039,"MUNICIPIUL BAIA MARE",106318,1596,922,831,90,1,909,13,1801,879,330,579
26,"MARAMUREŞ","#N/A",106318,,39,"BAIA MARE / Şcoala Gimnazială  D. Cantemir",1,10039,"MUNICIPIUL BAIA MARE",106318,1496,851,774,77,0,848,3,1700,849,297,551
26,"MARAMUREŞ","#N/A",106318,,40,"BAIA MARE / Şcoala Gimnazială  D. Cantemir",1,10039,"MUNICIPIUL BAIA MARE",106318,1610,860,827,33,0,847,13,1800,940,296,551
26,"MARAMUREŞ","#N/A",106318,,41,"BAIA MARE / Centrul de planificare familială",1,10039,"MUNICIPIUL BAIA MARE",106318,1477,878,809,67,2,869,9,1600,722,298,571
26,"MARAMUREŞ","#N/A",106318,,42,"BAIA MARE / Liceul cu program sportiv",1,10039,"MUNICIPIUL BAIA MARE",106318,1548,889,835,54,0,875,14,1700,811,275,600
26,"MARAMUREŞ","#N/A",106318,,43,"BAIA MARE / Liceul cu program sportiv",1,10039,"MUNICIPIUL BAIA MARE",106318,1344,704,658,46,0,697,7,1600,896,220,477
26,"MARAMUREŞ","#N/A",106318,,44,"BAIA MARE / Liceul cu program sportiv",1,10039,"MUNICIPIUL BAIA MARE",106318,918,525,487,38,0,522,3,1000,475,176,346
26,"MARAMUREŞ","#N/A",106318,,45,"BAIA MARE / Centrul Social ASSOC",1,10039,"MUNICIPIUL BAIA MARE",106318,1604,900,856,44,0,891,9,1800,900,312,579
26,"MARAMUREŞ","#N/A",106318,,46,"BAIA MARE / Administraţia Bazelor Sportive",1,10039,"MUNICIPIUL BAIA MARE",106318,1637,967,903,63,1,953,14,1800,833,326,627
26,"MARAMUREŞ","#N/A",106318,,47,"BAIA MARE / Bazinul Olimpic",1,10039,"MUNICIPIUL BAIA MARE",106318,1433,777,734,43,0,768,9,1600,823,254,514
26,"MARAMUREŞ","#N/A",106318,,48,"BAIA MARE / Centrul Universitar Nord - Facultatea de Litere",1,10039,"MUNICIPIUL BAIA MARE",106318,928,668,581,84,3,662,6,1000,332,175,487
26,"MARAMUREŞ","#N/A",106318,,49,"BAIA MARE / Biblioteca Judeţeană ""Petre Dulfu""",1,10039,"MUNICIPIUL BAIA MARE",106318,1332,864,803,61,0,847,17,1600,736,258,589
26,"MARAMUREŞ","#N/A",106318,,50,"BAIA MARE / Liceul de Arte",1,10039,"MUNICIPIUL BAIA MARE",106318,1118,734,678,56,0,721,13,1300,566,181,540
26,"MARAMUREŞ","#N/A",106318,,51,"BAIA MARE / Liceul de Arte",1,10039,"MUNICIPIUL BAIA MARE",106318,1183,746,713,31,2,743,3,1300,554,151,592
26,"MARAMUREŞ","#N/A",106318,,52,"BAIA MARE / Liceul Teoretic Sanitar",1,10039,"MUNICIPIUL BAIA MARE",106318,1401,797,744,53,0,780,17,1600,803,244,536
26,"MARAMUREŞ","#N/A",106318,,53,"BAIA MARE / Grădiniţa cu program normal nr. 12",1,10039,"MUNICIPIUL BAIA MARE",106318,1674,949,919,30,0,936,13,1800,851,246,690
26,"MARAMUREŞ","#N/A",106318,,54,"BAIA MARE / Şcoala Gimnazială Nicolae Bălcescu",1,10039,"MUNICIPIUL BAIA MARE",106318,1463,769,747,22,0,756,13,1600,831,294,462
26,"MARAMUREŞ","#N/A",106318,,55,"BAIA MARE / Şcoala Gimnazială Nicolae Bălcescu",1,10039,"MUNICIPIUL BAIA MARE",106318,1288,692,662,30,0,671,21,1400,708,304,367
26,"MARAMUREŞ","#N/A",106318,,56,"BAIA MARE / Şcoala Gimnazială Mihail Sadoveanu",1,10039,"MUNICIPIUL BAIA MARE",106318,1148,617,598,19,0,607,10,1200,583,305,302
26,"MARAMUREŞ","#N/A",106318,,57,"BAIA MARE / Şcoala Gimnazială Mihail Sadoveanu",1,10039,"MUNICIPIUL BAIA MARE",106318,1150,655,633,22,0,643,12,1300,645,245,398
26,"MARAMUREŞ","#N/A",106318,,58,"BAIA MARE / Şcoala Gimnazială nr. 13",1,10039,"MUNICIPIUL BAIA MARE",106318,1356,795,760,35,0,789,6,1500,705,360,429
26,"MARAMUREŞ","#N/A",106318,,59,"BAIA MARE / Şcoala Gimnazială Octavian Goga",1,10039,"MUNICIPIUL BAIA MARE",106318,1164,710,643,32,35,705,5,1300,590,194,511
26,"MARAMUREŞ","#N/A",106318,,60,"BAIA MARE / Şcoala Gimnazială Octavian Goga",1,10039,"MUNICIPIUL BAIA MARE",106318,1231,777,673,58,46,768,9,1400,623,218,550
26,"MARAMUREŞ","#N/A",106318,,61,"BAIA MARE / Colegiul Naţional Gheorghe Şincai",1,10039,"MUNICIPIUL BAIA MARE",106318,1691,1078,960,111,7,1066,12,1900,822,350,716
26,"MARAMUREŞ","#N/A",106318,,62,"BAIA MARE / Colegiul Naţional Vasile Lucaciu",1,10039,"MUNICIPIUL BAIA MARE",106318,1572,880,819,61,0,863,17,1700,820,293,570
26,"MARAMUREŞ","#N/A",106318,,63,"BAIA MARE / Colegiul Tehnic George Bariţiu",1,10039,"MUNICIPIUL BAIA MARE",106318,1558,1052,948,103,1,1037,15,1700,648,376,661
26,"MARAMUREŞ","#N/A",106318,,64,"BAIA MARE / Şcoala Gimnazială Lucian Blaga",1,10039,"MUNICIPIUL BAIA MARE",106318,1094,679,615,45,19,671,8,1300,621,231,440
26,"MARAMUREŞ","#N/A",106318,,65,"BAIA MARE / Şcoala Gimnazială Lucian Blaga",1,10039,"MUNICIPIUL BAIA MARE",106318,1099,650,604,46,0,643,7,1300,650,227,416
26,"MARAMUREŞ","#N/A",106318,,66,"BAIA MARE / Şcoala Gimnazială Lucian Blaga",1,10039,"MUNICIPIUL BAIA MARE",106318,1678,1089,1033,54,2,1081,8,1800,711,326,755
26,"MARAMUREŞ","#N/A",106318,,67,"BAIA MARE / Şcoala Gimnazială Lucian Blaga",1,10039,"MUNICIPIUL BAIA MARE",106318,1661,858,825,33,0,849,9,1800,942,213,636
26,"MARAMUREŞ","#N/A",106318,,68,"BAIA MARE / Colegiul Tehnic Anghel Saligny",1,10039,"MUNICIPIUL BAIA MARE",106318,1746,1113,995,118,0,1108,5,1900,787,327,781
26,"MARAMUREŞ","#N/A",106318,,69,"BAIA MARE / SC Drumuri şi Poduri MM SA",1,10039,"MUNICIPIUL BAIA MARE",106318,1475,709,657,51,1,700,9,1599,890,248,452
26,"MARAMUREŞ","#N/A",106318,,70,"BAIA MARE / Protecţia copilului",1,10039,"MUNICIPIUL BAIA MARE",106318,1352,607,575,31,1,598,9,1600,993,178,420
26,"MARAMUREŞ","#N/A",106318,,71,"BAIA MARE / Şcoala Gimnazială V. Alecsandri",1,10039,"MUNICIPIUL BAIA MARE",106318,1554,807,747,60,0,794,13,1701,894,229,565
26,"MARAMUREŞ","#N/A",106318,,72,"BAIA MARE / Şcoala Gimnazială V. Alecsandri",1,10039,"MUNICIPIUL BAIA MARE",106318,1588,824,776,48,0,813,11,1800,976,207,606
26,"MARAMUREŞ","#N/A",106318,,73,"BAIA MARE / Şcoala Gimnazială V. Alecsandri",1,10039,"MUNICIPIUL BAIA MARE",106318,1535,761,718,43,0,752,9,1700,939,210,542
26,"MARAMUREŞ","#N/A",106318,,74,"BAIA MARE / Şcoala Gimnazială V. Alecsandri",1,10039,"MUNICIPIUL BAIA MARE",106318,1640,848,805,43,0,843,5,1800,952,182,661
26,"MARAMUREŞ","#N/A",106318,,75,"BAIA MARE / Şcoala Gimnazială V. Alecsandri",1,10039,"MUNICIPIUL BAIA MARE",106318,1428,709,675,34,0,694,15,1600,891,223,471
26,"MARAMUREŞ","#N/A",106318,,76,"BAIA MARE / Grădiniţa cu program prelungit Otilia Cazimir",1,10039,"MUNICIPIUL BAIA MARE",106318,1704,954,909,45,0,943,11,1900,946,273,670
26,"MARAMUREŞ","#N/A",106318,,77,"BAIA MARE / Grădiniţa cu program prelungit Otilia Cazimir",1,10039,"MUNICIPIUL BAIA MARE",106318,1424,662,614,47,1,656,6,1600,938,227,429
26,"MARAMUREŞ","#N/A",106318,,78,"BAIA MARE / Grădiniţa cu program normal nr. 4",1,10039,"MUNICIPIUL BAIA MARE",106318,1511,744,707,37,0,732,12,1600,856,188,544
26,"MARAMUREŞ","#N/A",106318,,79,"BAIA MARE / Grădiniţa cu program prelungit nr. 27",1,10039,"MUNICIPIUL BAIA MARE",106318,1778,967,887,80,0,954,13,1900,933,233,721
26,"MARAMUREŞ","#N/A",106318,,80,"BAIA MARE / Şcoala Gimnazială Simion Bărnuţiu",1,10039,"MUNICIPIUL BAIA MARE",106318,1598,808,750,58,0,801,7,1700,892,221,580
26,"MARAMUREŞ","#N/A",106318,,81,"BAIA MARE / Şcoala Gimnazială Simion Bărnuţiu",1,10039,"MUNICIPIUL BAIA MARE",106318,1829,1049,1001,47,1,1035,14,1900,851,332,703
26,"MARAMUREŞ","#N/A",106318,,82,"BAIA MARE / Centrul ,, SALVATI FAMILIA""",1,10039,"MUNICIPIUL BAIA MARE",106318,1652,843,800,43,0,834,9,1800,957,221,613
26,"MARAMUREŞ","#N/A",106318,,83,"BAIA MARE / Centrul Comunitar Romanii",1,10039,"MUNICIPIUL BAIA MARE",106318,1169,561,514,46,1,545,16,1300,739,292,253
26,"MARAMUREŞ","#N/A",106318,,84,"BAIA MARE / Colegiul Tehnic C.D. Neniţescu",1,10039,"MUNICIPIUL BAIA MARE",106318,1523,702,660,42,0,691,11,1700,998,240,451
26,"MARAMUREŞ","#N/A",106318,,85,"BAIA MARE / Colegiul Tehnic C.D. Neniţescu",1,10039,"MUNICIPIUL BAIA MARE",106318,1318,727,683,44,0,720,7,1600,873,170,550
26,"MARAMUREŞ","#N/A",106559,,86,"SIGHETU MARMAŢIEI / Scoala generală nr.8",1,10044,"MUNICIPIUL SIGHETU MARMAŢIEI",106559,1156,629,595,32,2,619,10,1300,671,286,333
26,"MARAMUREŞ","#N/A",106559,,87,"SIGHETU MARMAŢIEI / Şcoala generală nr.1 CEARDA",1,10044,"MUNICIPIUL SIGHETU MARMAŢIEI",106559,1420,687,660,27,0,676,11,1600,913,267,409
26,"MARAMUREŞ","#N/A",106559,,88,"SIGHETU MARMAŢIEI / Şcoala generală nr. 11",1,10044,"MUNICIPIUL SIGHETU MARMAŢIEI",106559,1111,577,538,39,0,567,10,1200,623,219,348
26,"MARAMUREŞ","#N/A",106559,,89,"SIGHETU MARMAŢIEI / Grădiniţa nr. 12",1,10044,"MUNICIPIUL SIGHETU MARMAŢIEI",106559,1504,711,679,30,2,703,8,1700,989,267,436
26,"MARAMUREŞ","#N/A",106559,,90,"SIGHETU MARMAŢIEI / Universitatea Babes Bolyai",1,10044,"MUNICIPIUL SIGHETU MARMAŢIEI",106559,1273,601,569,32,0,591,10,1400,799,237,354
26,"MARAMUREŞ","#N/A",106559,,91,"SIGHETU MARMAŢIEI / Universitatea Babes Bolyai",1,10044,"MUNICIPIUL SIGHETU MARMAŢIEI",106559,579,307,260,47,0,304,3,600,293,111,193
26,"MARAMUREŞ","#N/A",106559,,92,"SIGHETU MARMAŢIEI / Liceul Pedagogic",1,10044,"MUNICIPIUL SIGHETU MARMAŢIEI",106559,915,489,406,35,48,485,4,1000,511,180,305
26,"MARAMUREŞ","#N/A",106559,,93,"SIGHETU MARMAŢIEI / Liceul Pedagogic",1,10044,"MUNICIPIUL SIGHETU MARMAŢIEI",106559,1064,643,554,33,56,635,8,1200,557,273,362
26,"MARAMUREŞ","#N/A",106559,,94,"SIGHETU MARMAŢIEI / Casa de cultură",1,10044,"MUNICIPIUL SIGHETU MARMAŢIEI",106559,895,514,465,49,0,504,10,1000,486,178,326
26,"MARAMUREŞ","#N/A",106559,,95,"SIGHETU MARMAŢIEI / Casa de cultură",1,10044,"MUNICIPIUL SIGHETU MARMAŢIEI",106559,815,466,443,21,2,461,5,900,434,148,313
26,"MARAMUREŞ","#N/A",106559,,96,"SIGHETU MARMAŢIEI / Liceul Dragoş Vodă",1,10044,"MUNICIPIUL SIGHETU MARMAŢIEI",106559,1537,806,759,46,1,800,6,1600,794,258,542
26,"MARAMUREŞ","#N/A",106559,,97,"SIGHETU MARMAŢIEI / Liceul Taras Sevcenco",1,10044,"MUNICIPIUL SIGHETU MARMAŢIEI",106559,1334,692,642,49,1,678,14,1500,808,205,473
26,"MARAMUREŞ","#N/A",106559,,98,"SIGHETU MARMAŢIEI / Liceul Taras Sevcenco",1,10044,"MUNICIPIUL SIGHETU MARMAŢIEI",106559,1357,762,684,74,4,754,8,1500,738,269,485
26,"MARAMUREŞ","#N/A",106559,,99,"SIGHETU MARMAŢIEI / Şcoala generală nr.2",1,10044,"MUNICIPIUL SIGHETU MARMAŢIEI",106559,1394,789,753,34,2,780,9,1500,711,281,499
26,"MARAMUREŞ","#N/A",106559,,100,"VALEA CUFUNDOASĂ / Grădiniţa nr.9",1,10044,"MUNICIPIUL SIGHETU MARMAŢIEI",106559,1577,885,857,27,1,873,12,1695,810,289,584
26,"MARAMUREŞ","#N/A",106559,,101,"SIGHETU MARMAŢIEI / Şcoala generală nr.9",1,10044,"MUNICIPIUL SIGHETU MARMAŢIEI",106559,1308,709,640,69,0,701,8,1400,691,284,417
26,"MARAMUREŞ","#N/A",106559,,102,"SIGHETU MARMAŢIEI / Şcoala generală nr.9",1,10044,"MUNICIPIUL SIGHETU MARMAŢIEI",106559,1159,580,548,31,1,572,8,1300,720,202,370
26,"MARAMUREŞ","#N/A",106559,,103,"SIGHETU MARMAŢIEI / Liceul Tehnologic Forestier",1,10044,"MUNICIPIUL SIGHETU MARMAŢIEI",106559,904,451,398,41,12,444,7,1000,549,165,279
26,"MARAMUREŞ","#N/A",106559,,104,"SIGHETU MARMAŢIEI / Liceul Tehnologic Forestier",1,10044,"MUNICIPIUL SIGHETU MARMAŢIEI",106559,1081,591,545,46,0,584,7,1200,609,241,343
26,"MARAMUREŞ","#N/A",106559,,105,"SIGHETU MARMAŢIEI / Şcoala generală nr.6",1,10044,"MUNICIPIUL SIGHETU MARMAŢIEI",106559,1671,799,770,29,0,784,15,1800,1001,338,446
26,"MARAMUREŞ","#N/A",106559,,106,"SIGHETU MARMAŢIEI / Şcoala generală nr.10",1,10044,"MUNICIPIUL SIGHETU MARMAŢIEI",106559,1457,748,703,45,0,737,11,1600,852,291,446
26,"MARAMUREŞ","#N/A",106559,,107,"SIGHETU MARMAŢIEI / Şcoala generală nr.10",1,10044,"MUNICIPIUL SIGHETU MARMAŢIEI",106559,818,463,435,28,0,462,1,900,437,172,290
26,"MARAMUREŞ","#N/A",106559,,108,"SIGHETU MARMAŢIEI / Şcoala generală nr.10",1,10044,"MUNICIPIUL SIGHETU MARMAŢIEI",106559,936,424,394,28,2,418,6,1000,576,130,288
26,"MARAMUREŞ","#N/A",106559,,109,"SIGHETU MARMAŢIEI / Grădiniţa nr 1",1,10044,"MUNICIPIUL SIGHETU MARMAŢIEI",106559,1128,573,545,28,0,560,13,1200,627,227,333
26,"MARAMUREŞ","#N/A",106559,,110,"SIGHETU MARMAŢIEI / Grădiniţa nr 1",1,10044,"MUNICIPIUL SIGHETU MARMAŢIEI",106559,806,390,371,19,0,386,4,900,510,133,253
26,"MARAMUREŞ","#N/A",106559,,111,"SIGHETU MARMAŢIEI / Şcoala generală nr.4",1,10044,"MUNICIPIUL SIGHETU MARMAŢIEI",106559,1100,637,584,52,1,626,11,1200,563,262,364
26,"MARAMUREŞ","#N/A",106559,,112,"SIGHETU MARMAŢIEI / Şcoala generală nr.4",1,10044,"MUNICIPIUL SIGHETU MARMAŢIEI",106559,888,460,422,38,0,455,4,1000,540,200,255
26,"MARAMUREŞ","#N/A",106559,,113,"SIGHETU MARMAŢIEI / Şcoala generală nr.4",1,10044,"MUNICIPIUL SIGHETU MARMAŢIEI",106559,1859,986,937,47,2,973,13,2000,1014,412,561
26,"MARAMUREŞ","#N/A",106559,,114,"SIGHETU MARMAŢIEI / Şcoala generală nr.5",1,10044,"MUNICIPIUL SIGHETU MARMAŢIEI",106559,1185,698,661,37,0,690,8,1300,602,276,414
26,"MARAMUREŞ","#N/A",106559,,115,"LAZU BACIULUI / Şcoala generală nr.5",1,10044,"MUNICIPIUL SIGHETU MARMAŢIEI",106559,1347,701,674,27,0,692,9,1400,699,249,443
26,"MARAMUREŞ","#N/A",106559,,116,"ŞUGĂU / Şcoala generală nr. 7",1,10044,"MUNICIPIUL SIGHETU MARMAŢIEI",106559,847,434,410,24,0,429,5,900,466,148,281
26,"MARAMUREŞ","#N/A",106684,,117,"BAIA SPRIE / Colegiul tehnic de transporturi auto",1,10051,"ORAŞ BAIA SPRIE",106684,1170,651,597,54,0,641,10,1300,649,152,489
26,"MARAMUREŞ","#N/A",106684,,118,"BAIA SPRIE / Colegiul tehnic de transporturi auto",1,10051,"ORAŞ BAIA SPRIE",106684,1221,679,644,34,1,674,5,1300,621,121,553
26,"MARAMUREŞ","#N/A",106684,,119,"BAIA SPRIE / Colegiul tehnic de transporturi auto",1,10051,"ORAŞ BAIA SPRIE",106684,1176,549,509,40,0,544,5,1300,751,142,402
26,"MARAMUREŞ","#N/A",106684,,120,"BAIA SPRIE / Colegiul tehnic de transporturi auto",1,10051,"ORAŞ BAIA SPRIE",106684,1244,663,619,41,3,656,7,1300,637,193,463
26,"MARAMUREŞ","#N/A",106684,,121,"BAIA SPRIE / Şcoala gimnazială",1,10051,"ORAŞ BAIA SPRIE",106684,1602,801,752,49,0,792,9,1700,899,288,504
26,"MARAMUREŞ","#N/A",106684,,122,"BAIA SPRIE / Şcoala gimnazială",1,10051,"ORAŞ BAIA SPRIE",106684,1610,806,776,30,0,800,6,1800,994,236,564
26,"MARAMUREŞ","#N/A",106684,,123,"BAIA SPRIE / Sala de sport",1,10051,"ORAŞ BAIA SPRIE",106684,726,451,415,36,0,446,5,800,349,106,340
26,"MARAMUREŞ","#N/A",106684,,124,"BAIA SPRIE / Sala de sport",1,10051,"ORAŞ BAIA SPRIE",106684,1295,694,660,34,0,689,5,1400,706,211,478
26,"MARAMUREŞ","#N/A",106684,,125,"CHIUZBAIA / Şcoala gimnazială",1,10051,"ORAŞ BAIA SPRIE",106684,557,346,316,30,0,342,4,600,254,134,208
26,"MARAMUREŞ","#N/A",106684,,126,"TĂUŢII DE SUS / Şcoala gimnaziala Ioan Slavici",1,10051,"ORAŞ BAIA SPRIE",106684,1196,823,558,45,220,804,19,1300,477,409,395
26,"MARAMUREŞ","#N/A",106684,,127,"TĂUŢII DE SUS / Şcoala gimnaziala Ioan Slavici",1,10051,"ORAŞ BAIA SPRIE",106684,1113,849,588,31,230,840,9,1200,351,455,385
26,"MARAMUREŞ","#N/A",106684,,128,"SATU NOU DE SUS / Şcoala gimnazială",1,10051,"ORAŞ BAIA SPRIE",106684,880,550,503,47,0,547,3,1000,450,140,407
26,"MARAMUREŞ","#N/A",106746,,129,"BORŞA / SCOALA NR. 1",1,10056,"ORAŞ BORŞA",106746,983,387,375,12,0,384,3,1100,713,119,265
26,"MARAMUREŞ","#N/A",106746,,130,"BORŞA / SCOALA NR.1",1,10056,"ORAŞ BORŞA",106746,952,359,341,17,1,356,3,1100,741,138,218
26,"MARAMUREŞ","#N/A",106746,,131,"BORŞA / UNITATEA MILITARA",1,10056,"ORAŞ BORŞA",106746,1781,773,747,26,0,767,6,2000,1227,244,523
26,"MARAMUREŞ","#N/A",106746,,132,"BORŞA / SCOALA NR. 8",1,10056,"ORAŞ BORŞA",106746,1760,786,744,42,0,777,9,1900,1114,296,481
26,"MARAMUREŞ","#N/A",106746,,133,"BORŞA / SCOALA NR.9",1,10056,"ORAŞ BORŞA",106746,1537,625,585,40,0,618,7,1700,1075,212,406
26,"MARAMUREŞ","#N/A",106746,,134,"BORŞA / SCOALA NR. 9",1,10056,"ORAŞ BORŞA",106746,1038,448,411,37,0,443,5,1100,652,155,288
26,"MARAMUREŞ","#N/A",106746,,135,"BORŞA / SPITALUL BORSA",1,10056,"ORAŞ BORŞA",106746,1055,554,455,47,52,550,4,1200,646,194,356
26,"MARAMUREŞ","#N/A",106746,,136,"BORŞA / SPITALUL BORSA",1,10056,"ORAŞ BORŞA",106746,1004,551,444,43,64,543,8,1100,549,189,354
26,"MARAMUREŞ","#N/A",106746,,137,"BORŞA / SCOALA GARLEA",1,10056,"ORAŞ BORŞA",106746,1017,492,476,16,0,485,7,1100,608,168,317
26,"MARAMUREŞ","#N/A",106746,,138,"BORŞA / CLADIREA ANCUTA",1,10056,"ORAŞ BORŞA",106746,886,365,353,12,0,363,2,1000,635,105,258
26,"MARAMUREŞ","#N/A",106746,,139,"BORŞA / SCOALA REPEDEA",1,10056,"ORAŞ BORŞA",106746,840,350,339,11,0,346,4,900,550,143,203
26,"MARAMUREŞ","#N/A",106746,,140,"BORŞA / SCOALA REPEDEA",1,10056,"ORAŞ BORŞA",106746,942,347,336,11,0,344,3,1000,653,122,222
26,"MARAMUREŞ","#N/A",106746,,141,"BORŞA / SCOALA POIANA",1,10056,"ORAŞ BORŞA",106746,942,424,395,29,0,419,5,1000,576,119,300
26,"MARAMUREŞ","#N/A",106746,,142,"BORŞA / SCOALA POIANA",1,10056,"ORAŞ BORŞA",106746,929,369,355,14,0,365,4,1000,631,97,268
26,"MARAMUREŞ","#N/A",106746,,143,"BORŞA / SCOALA BIRT",1,10056,"ORAŞ BORŞA",106746,1297,563,534,29,0,552,11,1400,837,173,379
26,"MARAMUREŞ","#N/A",106746,,144,"BORŞA / SCOALA FANTANA",1,10056,"ORAŞ BORŞA",106746,1109,504,429,75,0,498,6,1200,696,130,368
26,"MARAMUREŞ","#N/A",106746,,145,"BORŞA / SCOALA ROTUNDU",1,10056,"ORAŞ BORŞA",106746,1107,447,437,10,0,444,3,1200,753,156,288
26,"MARAMUREŞ","#N/A",106746,,146,"BORŞA / SCOALA ROTUNDU",1,10056,"ORAŞ BORŞA",106746,1186,488,474,14,0,482,6,1300,812,190,292
26,"MARAMUREŞ","#N/A",106746,,147,"BĂILE BORŞA / SCOALA NR. 7 BAIA BORSA",1,10056,"ORAŞ BORŞA",106746,1230,530,517,13,0,524,6,1400,870,202,322
26,"MARAMUREŞ","#N/A",106746,,148,"BORŞA / SCOALA NR.7 BAIA BORSA",1,10056,"ORAŞ BORŞA",106746,1404,572,539,33,0,568,4,1500,928,270,298
26,"MARAMUREŞ","#N/A",106782,,149,"CAVNIC / Colegiul Economic Pintea Viteazul",1,10059,"ORAŞ CAVNIC",106782,1842,877,847,29,1,863,14,2000,1123,299,564
26,"MARAMUREŞ","#N/A",106782,,150,"CAVNIC / Şcoala generală nr. 2",1,10059,"ORAŞ CAVNIC",106782,1731,953,846,60,47,937,16,1901,948,447,490
26,"MARAMUREŞ","#N/A",106782,,151,"CAVNIC / Şcoala generală nr. 1",1,10059,"ORAŞ CAVNIC",106782,792,330,301,26,3,325,5,900,570,82,243
26,"MARAMUREŞ","#N/A",108017,,152,"DRAGOMIREŞTI / Sala de sport",1,10061,"ORAŞ DRAGOMIREŞTI",108017,1519,831,788,38,5,825,6,1600,769,349,476
26,"MARAMUREŞ","#N/A",108017,,153,"DRAGOMIREŞTI / CĂMINUL CULTURAL",1,10061,"ORAŞ DRAGOMIREŞTI",108017,1121,579,501,51,27,569,10,1300,721,234,335
26,"MARAMUREŞ","#N/A",108892,,154,"SĂLIŞTEA DE SUS / Casa de Cultură",1,10063,"ORAŞ SĂLIŞTEA DE SUS",108892,1684,895,859,36,0,890,5,1900,1005,366,524
26,"MARAMUREŞ","#N/A",108892,,155,"SĂLIŞTEA DE SUS / Şcoala gimnazială ""M. Eminescu""",1,10063,"ORAŞ SĂLIŞTEA DE SUS",108892,1577,764,738,26,0,759,5,1700,936,316,443
26,"MARAMUREŞ","#N/A",108892,,156,"SĂLIŞTEA DE SUS / Şcoala gimnazială ""M. Eminescu""",1,10063,"ORAŞ SĂLIŞTEA DE SUS",108892,1045,582,552,29,1,578,4,1100,518,275,303
26,"MARAMUREŞ","#N/A",108963,,157,"SEINI / Casa de Cultură",1,10065,"ORAŞ SEINI",108963,1758,1041,926,100,15,1030,11,1900,859,423,607
26,"MARAMUREŞ","#N/A",108963,,158,"SEINI / Şcoala generală nr. 1",1,10065,"ORAŞ SEINI",108963,1744,1087,1001,78,8,1074,13,1900,813,477,597
26,"MARAMUREŞ","#N/A",108963,,159,"SEINI / Grădiniţa de copii nr.1",1,10065,"ORAŞ SEINI",108963,1980,1068,1023,38,7,1057,11,2100,1032,312,745
26,"MARAMUREŞ","#N/A",108963,,160,"SEINI / Şcoala Maghiară",1,10065,"ORAŞ SEINI",108963,1107,661,606,48,7,657,4,1200,539,264,393
26,"MARAMUREŞ","#N/A",108963,,161,"SĂBIŞA / Scoala",1,10065,"ORAŞ SEINI",108963,659,421,389,27,5,413,8,700,279,209,204
26,"MARAMUREŞ","#N/A",108963,,162,"VIILE APEI / Şcoala",1,10065,"ORAŞ SEINI",108963,517,319,284,31,4,315,4,600,281,137,178
26,"MARAMUREŞ","#N/A",109176,,163,"ŞOMCUŢA MARE / Casa de Cultură",1,10069,"ORAŞ ŞOMCUTA MARE",109176,794,479,425,54,0,472,7,900,421,223,249
26,"MARAMUREŞ","#N/A",109176,,164,"ŞOMCUŢA MARE / Şcoala Generală cu clasele I-IV",1,10069,"ORAŞ ŞOMCUTA MARE",109176,782,458,398,60,0,455,3,800,342,214,241
26,"MARAMUREŞ","#N/A",109176,,165,"ŞOMCUŢA MARE / Gradiniţa cu program prelungit",1,10069,"ORAŞ ŞOMCUTA MARE",109176,985,568,513,50,5,561,7,1100,532,295,266
26,"MARAMUREŞ","#N/A",109176,,166,"ŞOMCUŢA MARE / Şcoala generala nr 2",1,10069,"ORAŞ ŞOMCUTA MARE",109176,667,400,375,25,0,397,3,700,300,359,38
26,"MARAMUREŞ","#N/A",109176,,167,"BUCIUMI / Şcoala generală",1,10069,"ORAŞ ŞOMCUTA MARE",109176,656,433,399,32,2,430,3,705,272,232,198
26,"MARAMUREŞ","#N/A",109176,,168,"BUTEASA / Şcoala generală",1,10069,"ORAŞ ŞOMCUTA MARE",109176,316,215,196,19,0,215,0,400,185,97,118
26,"MARAMUREŞ","#N/A",109176,,169,"CIOLT / Şcoala generală",1,10069,"ORAŞ ŞOMCUTA MARE",109176,515,305,283,21,1,304,1,600,295,157,147
26,"MARAMUREŞ","#N/A",109176,,170,"CODRU BUTESII / Şcoala generală",1,10069,"ORAŞ ŞOMCUTA MARE",109176,205,151,135,16,0,150,1,300,149,91,59
26,"MARAMUREŞ","#N/A",109176,,171,"FINTEUŞU MARE / Şcoala generală",1,10069,"ORAŞ ŞOMCUTA MARE",109176,535,398,346,50,2,396,2,600,202,217,179
26,"MARAMUREŞ","#N/A",109176,,172,"HOVRILA / Şcoala generală",1,10069,"ORAŞ ŞOMCUTA MARE",109176,234,162,148,13,1,160,2,300,138,100,60
26,"MARAMUREŞ","#N/A",109176,,173,"VĂLENII ŞOMCUTEI / Şcoala generală",1,10069,"ORAŞ ŞOMCUTA MARE",109176,644,492,420,60,12,488,4,700,208,273,215
26,"MARAMUREŞ","#N/A",106461,,174,"BĂIŢA / Şcoala generală",1,10078,"ORAŞ TĂUŢII-MĂGHERĂUŞ",106461,890,606,560,44,2,593,13,1000,394,176,417
26,"MARAMUREŞ","#N/A",106461,,175,"BOZÂNTA MARE / Şcoala generală",1,10078,"ORAŞ TĂUŢII-MĂGHERĂUŞ",106461,528,330,304,26,0,329,1,600,270,179,150
26,"MARAMUREŞ","#N/A",106461,,176,"NISTRU / Şcoala generală",1,10078,"ORAŞ TĂUŢII-MĂGHERĂUŞ",106461,604,391,362,26,3,385,6,700,309,186,199
26,"MARAMUREŞ","#N/A",106461,,177,"TĂUŢII-MĂGHERĂUŞ / Sala Multifunctionala Magheraus",1,10078,"ORAŞ TĂUŢII-MĂGHERĂUŞ",106461,919,646,589,56,1,634,12,1000,354,189,445
26,"MARAMUREŞ","#N/A",106461,,178,"TĂUŢII-MĂGHERĂUŞ / Liceul Tehnologic ""Traian Vuia"" Tautii Magheraus",1,10078,"ORAŞ TĂUŢII-MĂGHERĂUŞ",106461,936,704,579,125,0,692,12,1000,296,235,457
26,"MARAMUREŞ","#N/A",106461,,179,"TĂUŢII-MĂGHERĂUŞ / Gradinita Hosteze",1,10078,"ORAŞ TĂUŢII-MĂGHERĂUŞ",106461,727,495,448,47,0,490,5,800,305,181,309
26,"MARAMUREŞ","#N/A",106461,,180,"BĂIŢA / Cantonul Silvic",1,10078,"ORAŞ TĂUŢII-MĂGHERĂUŞ",106461,206,172,148,23,1,172,0,300,128,72,100
26,"MARAMUREŞ","#N/A",106461,,181,"BĂIŢA / Grădiniţa Roşti",1,10078,"ORAŞ TĂUŢII-MĂGHERĂUŞ",106461,450,326,284,42,0,323,3,500,174,135,188
26,"MARAMUREŞ","#N/A",106461,,182,"BUŞAG / Cămin cultural",1,10078,"ORAŞ TĂUŢII-MĂGHERĂUŞ",106461,510,318,281,37,0,315,3,600,282,136,179
26,"MARAMUREŞ","#N/A",106461,,183,"MERIŞOR / Cămin Cultural",1,10078,"ORAŞ TĂUŢII-MĂGHERĂUŞ",106461,229,191,165,26,0,189,2,300,109,97,92
26,"MARAMUREŞ","#N/A",106461,,184,"ULMOASA / Cămin Cultural",1,10078,"ORAŞ TĂUŢII-MĂGHERĂUŞ",106461,158,119,108,11,0,117,2,200,81,61,56
26,"MARAMUREŞ","#N/A",106461,,185,"NISTRU / Grădiniţa 9 Mai",1,10078,"ORAŞ TĂUŢII-MĂGHERĂUŞ",106461,313,243,220,23,0,241,2,400,157,134,107
26,"MARAMUREŞ","#N/A",106817,,186,"TÎRGU LĂPUŞ / Casa orăşenească de cultură",1,10086,"ORAŞ TÎRGU LĂPUŞ",106817,1790,925,851,74,0,918,7,1900,975,367,551
26,"MARAMUREŞ","#N/A",106817,,187,"TÎRGU LĂPUŞ / Şcoala generală pentru copii cu deficienţe",1,10086,"ORAŞ TÎRGU LĂPUŞ",106817,1867,1117,1015,65,37,1115,2,2000,883,439,676
26,"MARAMUREŞ","#N/A",106817,,188,"TÎRGU LĂPUŞ / Primăria oraşului Târgu Lăpuş",1,10086,"ORAŞ TÎRGU LĂPUŞ",106817,1421,783,715,67,1,777,6,1600,817,303,474
26,"MARAMUREŞ","#N/A",106817,,189,"BOIERENI / Şcoala generală",1,10086,"ORAŞ TÎRGU LĂPUŞ",106817,314,161,146,15,0,159,2,400,239,67,92
26,"MARAMUREŞ","#N/A",106817,,190,"BORCUT / Şcoala generală",1,10086,"ORAŞ TÎRGU LĂPUŞ",106817,411,248,233,15,0,247,1,500,252,102,145
26,"MARAMUREŞ","#N/A",106817,,191,"CUFOAIA / Şcoala generală",1,10086,"ORAŞ TÎRGU LĂPUŞ",106817,178,124,113,11,0,124,0,200,76,30,94
26,"MARAMUREŞ","#N/A",106817,,192,"DĂMĂCUŞENI / Şcoala generală",1,10086,"ORAŞ TÎRGU LĂPUŞ",106817,767,354,338,16,0,353,1,800,446,60,293
26,"MARAMUREŞ","#N/A",106817,,193,"DOBRICU LĂPUŞULUI / Şcoala generală",1,10086,"ORAŞ TÎRGU LĂPUŞ",106817,323,179,157,22,0,177,2,400,221,35,142
26,"MARAMUREŞ","#N/A",106817,,194,"DUMBRAVA / Şcoala generală",1,10086,"ORAŞ TÎRGU LĂPUŞ",106817,181,99,87,12,0,98,1,200,101,38,60
26,"MARAMUREŞ","#N/A",106817,,195,"FÎNTÎNELE / Şcoala generală",1,10086,"ORAŞ TÎRGU LĂPUŞ",106817,222,124,105,19,0,123,1,300,176,77,46
26,"MARAMUREŞ","#N/A",106817,,196,"GROAPE / Şcoala generală",1,10086,"ORAŞ TÎRGU LĂPUŞ",106817,61,36,29,7,0,36,0,100,64,15,21
26,"MARAMUREŞ","#N/A",106817,,197,"INĂU / Şcoala generală",1,10086,"ORAŞ TÎRGU LĂPUŞ",106817,225,130,116,14,0,130,0,300,170,24,106
26,"MARAMUREŞ","#N/A",106817,,198,"RĂZOARE / Cămin cultural",1,10086,"ORAŞ TÎRGU LĂPUŞ",106817,641,291,274,17,0,286,5,700,409,123,163
26,"MARAMUREŞ","#N/A",106817,,199,"RĂZOARE / Şcoala generală",1,10086,"ORAŞ TÎRGU LĂPUŞ",106817,479,257,245,12,0,256,1,500,243,118,138
26,"MARAMUREŞ","#N/A",106817,,200,"ROGOZ / Cămin cultural",1,10086,"ORAŞ TÎRGU LĂPUŞ",106817,1299,582,562,20,0,580,2,1400,818,247,333
26,"MARAMUREŞ","#N/A",106817,,201,"ROHIA / Grădiniţă",1,10086,"ORAŞ TÎRGU LĂPUŞ",106817,607,307,288,19,0,306,1,700,393,131,175
26,"MARAMUREŞ","#N/A",106817,,202,"STOICENI / Şcoala generală",1,10086,"ORAŞ TÎRGU LĂPUŞ",106817,209,124,113,11,0,122,2,300,176,35,87
26,"MARAMUREŞ","#N/A",109265,,203,"CHELINŢA / Şcoala Gimnazială",1,10101,"ORAŞ ULMENI",109265,1096,918,801,94,23,913,5,1100,182,762,151
26,"MARAMUREŞ","#N/A",109265,,204,"ULMENI / Cămin Cultural",1,10101,"ORAŞ ULMENI",109265,1242,853,754,85,14,847,6,1300,447,412,435
26,"MARAMUREŞ","#N/A",109265,,205,"ARDUZEL / Şcoala generală Kos Karoly",1,10101,"ORAŞ ULMENI",109265,720,488,458,8,22,488,0,800,312,240,248
26,"MARAMUREŞ","#N/A",109265,,206,"MÂNĂU / CAMIN CULTURAL",1,10101,"ORAŞ ULMENI",109265,908,618,568,33,17,610,8,1000,382,302,308
26,"MARAMUREŞ","#N/A",109265,,207,"SOMEŞ-UILEAC / CAMIN CULTURAL",1,10101,"ORAŞ ULMENI",109265,633,418,330,65,23,415,3,700,282,259,156
26,"MARAMUREŞ","#N/A",109265,,208,"TOHAT / CAMIN CULTURAL",1,10101,"ORAŞ ULMENI",109265,197,156,125,25,6,156,0,200,44,89,67
26,"MARAMUREŞ","#N/A",109265,,209,"ŢICĂU / Şcoala primară",1,10101,"ORAŞ ULMENI",109265,620,450,410,26,14,447,3,700,250,385,62
26,"MARAMUREŞ","#N/A",109265,,210,"VICEA / Şcoala primară",1,10101,"ORAŞ ULMENI",109265,292,157,149,7,1,157,0,300,143,100,57
26,"MARAMUREŞ","#N/A",106979,,211,"VIŞEU DE SUS / Şcoala generală nr. 2",1,10110,"ORAŞ VIŞEU DE SUS",106979,1124,531,508,22,1,531,0,1300,769,231,300
26,"MARAMUREŞ","#N/A",106979,,212,"VIŞEU DE SUS / Liceul Tehnologic",1,10110,"ORAŞ VIŞEU DE SUS",106979,1604,712,668,44,0,703,9,1800,1088,254,449
26,"MARAMUREŞ","#N/A",106979,,213,"VIŞEU DE SUS / Liceul Teoretic Bogdan Voda",1,10110,"ORAŞ VIŞEU DE SUS",106979,929,524,446,78,0,515,9,1000,476,175,340
26,"MARAMUREŞ","#N/A",106979,,214,"VIŞEU DE SUS / Şcoala Gimnazială nr. 7",1,10110,"ORAŞ VIŞEU DE SUS",106979,1651,847,830,17,0,839,8,1800,953,331,508
26,"MARAMUREŞ","#N/A",106979,,215,"VIŞEU DE SUS / Şcoala generală nr. 2",1,10110,"ORAŞ VIŞEU DE SUS",106979,1107,493,476,16,1,487,6,1200,707,170,317
26,"MARAMUREŞ","#N/A",106979,,216,"VIŞEU DE SUS / Liceul tehnologic  nr. 4",1,10110,"ORAŞ VIŞEU DE SUS",106979,1082,524,512,12,0,516,8,1200,676,227,289
26,"MARAMUREŞ","#N/A",106979,,217,"VIŞEU DE SUS / Liceul tehnologic  nr. 4",1,10110,"ORAŞ VIŞEU DE SUS",106979,962,544,519,25,0,533,11,1000,456,283,250
26,"MARAMUREŞ","#N/A",106979,,218,"VIŞEU DE SUS / Liceul Tehnologic",1,10110,"ORAŞ VIŞEU DE SUS",106979,1619,659,622,37,0,650,9,1800,1141,201,449
26,"MARAMUREŞ","#N/A",106979,,219,"VIŞEU DE SUS / Liceul Bogdan Vodă",1,10110,"ORAŞ VIŞEU DE SUS",106979,958,591,479,112,0,585,6,1000,409,204,381
26,"MARAMUREŞ","#N/A",106979,,220,"VIŞEU DE SUS / Scoala Gimnaziala, nr. 7",1,10110,"ORAŞ VIŞEU DE SUS",106979,1596,764,715,48,1,754,10,1800,1036,230,524
26,"MARAMUREŞ","#N/A",106979,,221,"VIŞEU DE SUS / Şcoala gimnazială nr. 3",1,10110,"ORAŞ VIŞEU DE SUS",106979,770,363,347,16,0,354,9,900,537,94,260
26,"MARAMUREŞ","#N/A",106979,,222,"VIŞEU DE SUS / Cantina de ajutor social",1,10110,"ORAŞ VIŞEU DE SUS",106979,1559,910,869,40,1,901,9,1700,790,416,485
26,"MARAMUREŞ","#N/A",107001,,223,"ARDUSAT / Şcoala cu cls. I-VIII",3,10113,"ARDUSAT",107001,1533,777,697,77,3,773,4,1600,823,305,468
26,"MARAMUREŞ","#N/A",107001,,224,"ARIEŞU DE CÎMP / Şcoala cu cls. I-IV",3,10113,"ARDUSAT",107001,222,130,117,13,0,130,0,300,170,44,86
26,"MARAMUREŞ","#N/A",107001,,225,"COLŢIREA / Şcoala cu cls. I-IV",3,10113,"ARDUSAT",107001,347,207,178,29,0,207,0,400,193,95,112
26,"MARAMUREŞ","#N/A",107047,,226,"ARINIŞ / Căminul cultural",3,10117,"ARINIŞ",107047,669,499,423,69,7,496,3,699,200,226,270
26,"MARAMUREŞ","#N/A",107047,,227,"TĂMĂŞEŞTI / Camin cultural Tamasesti",3,10117,"ARINIŞ",107047,181,185,124,52,9,184,1,200,15,113,71
26,"MARAMUREŞ","#N/A",107083,,228,"ASUAJU DE SUS / Primăria Asuaju de Sus",3,10121,"ASUAJU DE SUS",107083,788,594,483,69,42,590,4,900,306,426,164
26,"MARAMUREŞ","#N/A",107083,,229,"ASUAJU DE JOS / Căminul Cultural",3,10121,"ASUAJU DE SUS",107083,294,209,161,43,5,209,0,400,191,105,104
26,"MARAMUREŞ","#N/A",107118,,230,"BĂIŢA DE SUB CODRU / Şcoala Gimnazială",3,10124,"BĂIŢA DE SUB CODRU",107118,1201,733,665,68,0,731,2,1300,567,337,394
26,"MARAMUREŞ","#N/A",107118,,231,"URMENIŞ / Şcoala cu cls. I-IV",3,10124,"BĂIŢA DE SUB CODRU",107118,248,188,160,28,0,186,2,298,110,74,112
26,"MARAMUREŞ","#N/A",107154,,232,"STRÎMBU-BĂIUŢ / Căminul Cultural",3,10127,"BĂIUŢ",107154,501,299,262,37,0,298,1,600,301,116,182
26,"MARAMUREŞ","#N/A",107154,,233,"BĂIUŢ / Şcoala de arte si meserii",3,10127,"BĂIUŢ",107154,1388,633,588,39,6,626,7,1499,866,257,369
26,"MARAMUREŞ","#N/A",107154,,234,"POIANA BOTIZII / Şcoala gen.",3,10127,"BĂIUŢ",107154,199,116,101,15,0,116,0,300,184,77,39
26,"MARAMUREŞ","#N/A",107190,,235,"BĂSEŞTI / Primărie",3,10134,"BĂSEŞTI",107190,465,257,219,38,0,256,1,500,243,131,125
26,"MARAMUREŞ","#N/A",107190,,236,"ODEŞTI / Şcoala cu clasele I-IV",3,10134,"BĂSEŞTI",107190,314,189,156,33,0,189,0,400,211,96,93
26,"MARAMUREŞ","#N/A",107190,,237,"SĂLIŞTE / Şcoala cu clasele I-IV",3,10134,"BĂSEŞTI",107190,94,87,64,23,0,85,2,102,15,32,53
26,"MARAMUREŞ","#N/A",107190,,238,"STREMŢ / Şcoala cu clasele I-IV",3,10134,"BĂSEŞTI",107190,245,146,112,34,0,145,1,300,154,72,73
26,"MARAMUREŞ","#N/A",107314,,239,"BÂRSANA / Şcoala gimnazială Mircea Vulcănescu",3,10131,"BÂRSANA",107314,1503,791,755,36,0,789,2,1600,809,225,564
26,"MARAMUREŞ","#N/A",107314,,240,"BÂRSANA / Şcoala gimnazială Mircea Vulcănescu",3,10131,"BÂRSANA",107314,1173,574,552,22,0,572,2,1300,726,229,343
26,"MARAMUREŞ","#N/A",107314,,241,"BÂRSANA / Şcoala Valea Muntelui",3,10131,"BÂRSANA",107314,624,253,245,8,0,249,4,700,447,67,182
26,"MARAMUREŞ","#N/A",107314,,242,"NĂNEŞTI / SCOALA NANESTI",3,10131,"BÂRSANA",107314,548,335,295,40,0,331,4,600,265,175,156
26,"MARAMUREŞ","#N/A",107234,,243,"BICAZ / Cămin Cultural",3,10139,"BICAZ",107234,443,302,241,37,24,301,1,501,199,181,120
26,"MARAMUREŞ","#N/A",107234,,244,"CIUTA / Şcoala cu cls. I-IV",3,10139,"BICAZ",107234,147,124,80,29,15,123,1,200,76,86,37
26,"MARAMUREŞ","#N/A",107234,,245,"CORNI / Căminul Cultural",3,10139,"BICAZ",107234,253,200,152,33,15,199,1,300,100,123,76
26,"MARAMUREŞ","#N/A",107270,,246,"BISTRA / Primăria Bistra",3,10143,"BISTRA",107270,819,442,422,20,0,440,2,900,458,159,281
26,"MARAMUREŞ","#N/A",107270,,247,"CRASNA VIŞEULUI / Cămin Cultural",3,10143,"BISTRA",107270,1282,686,661,25,0,675,11,1400,714,238,437
26,"MARAMUREŞ","#N/A",107270,,248,"VALEA VIŞEULUI / Şcoala Gimnazială",3,10143,"BISTRA",107270,1202,527,508,19,0,518,9,1300,773,223,295
26,"MARAMUREŞ","#N/A",107350,,249,"LUNCA LA TISA / Şcoala cu cls. I-VIII",3,10147,"BOCICOIU MARE",107350,712,336,306,29,1,332,4,800,464,198,134
26,"MARAMUREŞ","#N/A",107350,,250,"TISA / Şcoala cu cls. I-VIII",3,10147,"BOCICOIU MARE",107350,1174,595,570,23,2,586,9,1200,605,243,343
26,"MARAMUREŞ","#N/A",107350,,251,"BOCICOIU MARE / Grădiniţa de copii",3,10147,"BOCICOIU MARE",107350,504,246,225,19,2,246,0,600,354,111,135
26,"MARAMUREŞ","#N/A",107350,,252,"CRĂCIUNEŞTI / Grădiniţa de copii",3,10147,"BOCICOIU MARE",107350,1288,721,669,40,12,714,7,1400,679,427,287
26,"MARAMUREŞ","#N/A",107403,,253,"BOCICOEL / Şcoala generală",3,10152,"BOGDAN VODĂ",107403,612,302,282,20,0,299,3,700,398,210,89
26,"MARAMUREŞ","#N/A",107403,,254,"BOGDAN VODĂ / Clubul din incinta primăriei",3,10152,"BOGDAN VODĂ",107403,1999,1072,1004,68,0,1063,9,2200,1128,525,538
26,"MARAMUREŞ","#N/A",107430,,255,"BOIU MARE / Primăria",3,10155,"BOIU MARE",107430,463,358,284,51,23,352,6,500,142,240,112
26,"MARAMUREŞ","#N/A",107430,,256,"PRISLOP / Şcoala generală",3,10155,"BOIU MARE",107430,395,270,238,32,0,270,0,400,130,135,135
26,"MARAMUREŞ","#N/A",107430,,257,"FRÎNCENII BOIULUI / Şcoala generală",3,10155,"BOIU MARE",107430,50,60,39,21,0,60,0,99,39,39,21
26,"MARAMUREŞ","#N/A",107430,,258,"ROMĂNEŞTI / Şcoala generală",3,10155,"BOIU MARE",107430,62,64,48,16,0,64,0,100,36,48,16
26,"MARAMUREŞ","#N/A",107485,,259,"BOTIZA / Sediul Primăriei Botiza",3,10160,"BOTIZA",107485,2129,1290,1232,37,21,1283,7,2300,1010,840,443
26,"MARAMUREŞ","#N/A",107519,,260,"SÎRBI / Şcoala cu cls. I-VIII",3,10162,"BUDEŞTI",107519,708,391,373,17,1,390,1,800,409,141,249
26,"MARAMUREŞ","#N/A",107519,,261,"BUDEŞTI / Sediul Primăriei",3,10162,"BUDEŞTI",107519,1192,731,672,35,24,726,5,1300,569,348,378
26,"MARAMUREŞ","#N/A",107519,,262,"BUDEŞTI / Sediul Gradiniţei",3,10162,"BUDEŞTI",107519,706,435,397,20,18,433,2,800,365,250,183
26,"MARAMUREŞ","#N/A",107546,,263,"CORNEŞTI / Şcoala generală",3,10165,"CĂLINEŞTI",107546,361,196,184,12,0,193,3,400,204,37,156
26,"MARAMUREŞ","#N/A",107546,,264,"CĂLINEŞTI / Cămin cultural",3,10165,"CĂLINEŞTI",107546,1206,672,648,24,0,663,9,1300,628,164,499
26,"MARAMUREŞ","#N/A",107546,,265,"VĂLENI / Cămin cultural",3,10165,"CĂLINEŞTI",107546,1103,582,542,40,0,580,2,1200,618,225,355
26,"MARAMUREŞ","#N/A",107582,,266,"CERNEŞTI / Şcoala generală",3,10169,"CERNEŞTI",107582,687,429,405,24,0,429,0,700,271,199,230
26,"MARAMUREŞ","#N/A",107582,,267,"BREBENI / Şcoala generală",3,10169,"CERNEŞTI",107582,184,125,99,26,0,125,0,200,75,57,68
26,"MARAMUREŞ","#N/A",107582,,268,"MĂGURENI / Şcoala Generală",3,10169,"CERNEŞTI",107582,163,127,102,25,0,127,0,200,73,53,74
26,"MARAMUREŞ","#N/A",107582,,269,"TRESTIA / Şcoala Generală",3,10169,"CERNEŞTI",107582,556,378,359,19,0,374,4,600,222,253,121
26,"MARAMUREŞ","#N/A",107582,,270,"FÎNAŢE / Cămin Cultural",3,10169,"CERNEŞTI",107582,553,284,260,24,0,283,1,600,316,166,117
26,"MARAMUREŞ","#N/A",107582,,271,"CIOCOTIŞ / Grădiniţa",3,10169,"CERNEŞTI",107582,831,446,418,28,0,444,2,900,454,225,219
26,"MARAMUREŞ","#N/A",107662,,272,"CICÎRLĂU / Sediul Primariei",3,10177,"CICÎRLĂU",107662,1843,1062,933,124,5,1057,5,2000,938,348,709
26,"MARAMUREŞ","#N/A",107662,,273,"ILBA / Cămin Cultural",3,10177,"CICÎRLĂU",107662,1094,542,497,45,0,535,7,1200,658,238,297
26,"MARAMUREŞ","#N/A",107662,,274,"HANDALU ILBEI / Şcoala Gimnazială",3,10177,"CICÎRLĂU",107662,381,178,163,15,0,176,2,400,222,97,79
26,"MARAMUREŞ","#N/A",107715,,275,"CÎMPULUNG LA TISA / Primăria",3,10182,"CÎMPULUNG LA TISA",107715,2055,792,766,26,0,786,6,2300,1508,204,582
26,"MARAMUREŞ","#N/A",179837,,276,"COAŞ / Şcoala Gimnaziala""Ion Popescu de Coaş""",3,10184,"COAŞ",179837,1083,650,560,52,38,647,3,1200,550,253,394
26,"MARAMUREŞ","#N/A",179837,,277,"ÎNTRERÂURI / Şcoala generală cu clasele I-IV",3,10184,"COAŞ",179837,69,49,37,12,0,49,0,100,51,31,18
26,"MARAMUREŞ","#N/A",179846,,278,"COLTĂU / Caminul cultural Coltau",3,10187,"COLTĂU",179846,1900,989,935,53,1,981,8,2000,1011,285,696
26,"MARAMUREŞ","#N/A",107733,,279,"BERINŢA / Căminul Cultural",3,10190,"COPALNIC-MĂNĂŞTUR",107733,615,408,366,42,0,405,3,700,292,183,222
26,"MARAMUREŞ","#N/A",107733,,280,"COPALNIC-DEAL / Căminul Cultural",3,10190,"COPALNIC-MĂNĂŞTUR",107733,76,38,28,10,0,38,0,100,62,6,32
26,"MARAMUREŞ","#N/A",107733,,281,"FĂUREŞTI / Căminul Cultural",3,10190,"COPALNIC-MĂNĂŞTUR",107733,686,386,360,26,0,381,5,700,314,157,224
26,"MARAMUREŞ","#N/A",107733,,282,"LĂSCHIA / Căminul Cultural",3,10190,"COPALNIC-MĂNĂŞTUR",107733,409,236,213,23,0,235,1,500,264,115,120
26,"MARAMUREŞ","#N/A",107733,,283,"PRELUCA NOUĂ / Căminul Cultural",3,10190,"COPALNIC-MĂNĂŞTUR",107733,250,152,144,8,0,152,0,300,148,63,89
26,"MARAMUREŞ","#N/A",107733,,284,"VAD / Căminul Cultural",3,10190,"COPALNIC-MĂNĂŞTUR",107733,301,197,172,23,2,196,1,300,103,114,82
26,"MARAMUREŞ","#N/A",107733,,285,"CĂRPINIŞ / Şcoala",3,10190,"COPALNIC-MĂNĂŞTUR",107733,280,189,171,18,0,189,0,300,111,75,114
26,"MARAMUREŞ","#N/A",107733,,286,"CURTUIUŞU MIC / Şcoala",3,10190,"COPALNIC-MĂNĂŞTUR",107733,208,113,90,23,0,113,0,300,187,45,68
26,"MARAMUREŞ","#N/A",107733,,287,"PRELUCA VECHE / Şcoala",3,10190,"COPALNIC-MĂNĂŞTUR",107733,306,174,156,18,0,174,0,400,226,34,140
26,"MARAMUREŞ","#N/A",107733,,288,"COPALNIC / Camin cultural",3,10190,"COPALNIC-MĂNĂŞTUR",107733,555,239,212,27,0,235,4,600,361,84,151
26,"MARAMUREŞ","#N/A",107733,,289,"RUŞOR / Camin cultural",3,10190,"COPALNIC-MĂNĂŞTUR",107733,215,171,137,34,0,171,0,300,129,42,129
26,"MARAMUREŞ","#N/A",107733,,290,"COPALNIC-MĂNĂŞTUR / Caminul  cultural",3,10190,"COPALNIC-MĂNĂŞTUR",107733,712,429,388,41,0,424,5,800,371,133,291
26,"MARAMUREŞ","#N/A",107868,,291,"COROIENI / Primărie",3,10203,"COROIENI",107868,344,203,171,32,0,202,1,400,197,65,137
26,"MARAMUREŞ","#N/A",107868,,292,"BABA / Şcoală cls. I-IV",3,10203,"COROIENI",107868,390,276,237,39,0,275,1,400,124,71,204
26,"MARAMUREŞ","#N/A",107868,,293,"DRĂGHIA / Şcoală cls. I-IV",3,10203,"COROIENI",107868,178,134,112,20,2,134,0,194,60,64,70
26,"MARAMUREŞ","#N/A",107868,,294,"DEALU MARE / Şcoala  cls. I-IV",3,10203,"COROIENI",107868,184,152,119,30,3,149,3,202,50,95,54
26,"MARAMUREŞ","#N/A",107868,,295,"VĂLENII LĂPUŞULUI / Şcoală generala",3,10203,"COROIENI",107868,673,453,419,33,1,451,2,700,247,227,224
26,"MARAMUREŞ","#N/A",107920,,296,"CUPŞENI / Şcoala cu cls. I-VIII",3,10209,"CUPŞENI",107920,663,354,342,11,1,351,3,700,346,98,253
26,"MARAMUREŞ","#N/A",107920,,297,"COSTENI / Şcoala cu cls. I-VIII",3,10209,"CUPŞENI",107920,371,215,200,15,0,215,0,400,185,34,181
26,"MARAMUREŞ","#N/A",107920,,298,"LIBOTIN / Şcoala cu cls. V-VIII",3,10209,"CUPŞENI",107920,906,613,603,10,0,610,3,1000,387,212,398
26,"MARAMUREŞ","#N/A",107920,,299,"UNGURENI / Şcoala cu cls. V-VIII",3,10209,"CUPŞENI",107920,1038,429,413,16,0,426,3,1100,671,312,114
26,"MARAMUREŞ","#N/A",107975,,300,"HĂRNICEŞTI / Şcoala",3,10214,"DESEŞTI",107975,468,270,251,19,0,270,0,500,230,38,232
26,"MARAMUREŞ","#N/A",107975,,301,"MARA / Şcoala",3,10214,"DESEŞTI",107975,781,505,476,29,0,500,5,900,395,101,399
26,"MARAMUREŞ","#N/A",107975,,302,"DESEŞTI / Cămin cultural",3,10214,"DESEŞTI",107975,780,477,457,18,2,473,4,900,423,163,310
26,"MARAMUREŞ","#N/A",108035,,303,"CĂRBUNARI / Şcoala generală",3,10218,"DUMBRĂVIŢA",108035,495,339,278,61,0,338,1,500,161,135,203
26,"MARAMUREŞ","#N/A",108035,,304,"CHECHIŞ / Şcoala generală",3,10218,"DUMBRĂVIŢA",108035,771,449,408,41,0,448,1,800,351,216,232
26,"MARAMUREŞ","#N/A",108035,,305,"RUS / Şcoala generală",3,10218,"DUMBRĂVIŢA",108035,533,309,281,27,1,309,0,600,291,74,235
26,"MARAMUREŞ","#N/A",108035,,306,"ŞINDREŞTI / Şcoala generală",3,10218,"DUMBRĂVIŢA",108035,468,329,283,46,0,329,0,500,171,121,208
26,"MARAMUREŞ","#N/A",108035,,307,"UNGURAŞ / Şcoala generală",3,10218,"DUMBRĂVIŢA",108035,402,305,275,30,0,304,1,500,195,134,170
26,"MARAMUREŞ","#N/A",108035,,308,"DUMBRĂVIŢA / Şcoala noua",3,10218,"DUMBRĂVIŢA",108035,949,572,532,39,1,569,3,1000,428,136,433
26,"MARAMUREŞ","#N/A",108106,,309,"FĂRCAŞA / Cămin cultural",3,10225,"FĂRCAŞA",108106,1440,864,783,55,26,859,5,1500,636,388,471
26,"MARAMUREŞ","#N/A",108106,,310,"BUZEŞTI / Cămin cultural",3,10225,"FĂRCAŞA",108106,523,225,194,29,2,224,1,600,375,96,128
26,"MARAMUREŞ","#N/A",108106,,311,"SÎRBI / Cămin cultural",3,10225,"FĂRCAŞA",108106,407,288,241,34,13,286,2,500,212,89,197
26,"MARAMUREŞ","#N/A",108106,,312,"TĂMAIA / Gradinita Tamaia",3,10225,"FĂRCAŞA",108106,800,440,369,54,17,433,7,900,460,174,259
26,"MARAMUREŞ","#N/A",179855,,313,"GÂRDANI / CAMIN CULTURAL",3,10230,"GÂRDANI",179855,1115,688,623,64,1,686,2,1200,512,271,415
26,"MARAMUREŞ","#N/A",108151,,314,"GIULEŞTI / Căminul cultural",3,10232,"GIULEŞTI",108151,1072,558,523,35,0,552,6,1200,642,206,346
26,"MARAMUREŞ","#N/A",108151,,315,"BERBEŞTI / Căminul cultural",3,10232,"GIULEŞTI",108151,1222,557,531,26,0,552,5,1300,743,233,319
26,"MARAMUREŞ","#N/A",108151,,316,"FEREŞTI / Şcoala Generală",3,10232,"GIULEŞTI",108151,391,250,232,18,0,247,3,400,150,134,113
26,"MARAMUREŞ","#N/A",106363,,317,"GROŞI / Sediul Primăriei Groşi",3,10237,"GROŞI",106363,1091,732,672,59,1,731,1,1100,368,179,552
26,"MARAMUREŞ","#N/A",106363,,318,"GROŞI / Şcoală gen.",3,10237,"GROŞI",106363,369,182,128,54,0,182,0,400,218,54,128
26,"MARAMUREŞ","#N/A",106363,,319,"GROŞI / Şcoală gen.",3,10237,"GROŞI",106363,819,486,442,44,0,484,2,900,414,141,343
26,"MARAMUREŞ","#N/A",179622,,320,"GROŞII ŢIBLEŞULUI / Gădiniţa cu program normal Groşii Ţibleşului",3,10241,"GROŞII ŢIBLEŞULUI",179622,966,628,567,50,11,626,2,1100,472,270,356
26,"MARAMUREŞ","#N/A",179622,,321,"GROŞII ŢIBLEŞULUI / Şcoala cu cls. I- IV Greble",3,10241,"GROŞII ŢIBLEŞULUI",179622,759,504,469,29,6,504,0,800,296,220,284
26,"MARAMUREŞ","#N/A",108204,,322,"IEUD / SCOALA GIMNAZIALA",3,10243,"IEUD",108204,1543,676,632,44,0,672,4,1700,1024,306,366
26,"MARAMUREŞ","#N/A",108204,,323,"IEUD / SCOALA GIMNAZIALA",3,10243,"IEUD",108204,1551,728,686,37,5,725,3,1700,972,309,416
26,"MARAMUREŞ","#N/A",108204,,324,"IEUD / SCOALA PLOPSOR",3,10243,"IEUD",108204,332,128,115,11,2,128,0,400,272,70,58
26,"MARAMUREŞ","#N/A",108222,,325,"LĂPUŞ / Primăria Lăpuş",3,10245,"LĂPUŞ",108222,1452,780,746,34,0,778,2,1600,820,388,390
26,"MARAMUREŞ","#N/A",108222,,326,"LĂPUŞ / CAMIN CULTURAL",3,10245,"LĂPUŞ",108222,1561,904,865,36,3,901,3,1600,696,352,549
26,"MARAMUREŞ","#N/A",108240,,327,"LEORDINA / Primărie",3,10247,"LEORDINA",108240,1473,757,707,50,0,750,7,1600,843,303,447
26,"MARAMUREŞ","#N/A",108268,,328,"IADĂRA / Şcoala generală",3,10249,"MIREŞU MARE",108268,796,488,437,40,11,484,4,900,412,151,333
26,"MARAMUREŞ","#N/A",108268,,329,"LUCĂCEŞTI / CENTRUL MULTIFUNCTIONAL LUCACESTI",3,10249,"MIREŞU MARE",108268,513,271,242,28,1,269,2,600,329,127,142
26,"MARAMUREŞ","#N/A",108268,,330,"LUCĂCEŞTI / SCOALA GENERALA LUCACESTI",3,10249,"MIREŞU MARE",108268,398,224,201,22,1,224,0,500,276,135,89
26,"MARAMUREŞ","#N/A",108268,,331,"MIREŞU MARE / Primărie",3,10249,"MIREŞU MARE",108268,1168,727,631,95,1,725,2,1200,473,248,477
26,"MARAMUREŞ","#N/A",108268,,332,"REMEŢI PE SOMEŞ / Şcoala clasele I-IV",3,10249,"MIREŞU MARE",108268,477,286,241,45,0,284,2,500,214,142,142
26,"MARAMUREŞ","#N/A",108268,,333,"TULGHIEŞ / Şcoala clasele I-IV",3,10249,"MIREŞU MARE",108268,527,361,326,35,0,361,0,600,239,156,205
26,"MARAMUREŞ","#N/A",108348,,334,"MOISEI / Primăria",3,10257,"MOISEI",108348,1729,997,953,44,0,988,9,1900,903,433,555
26,"MARAMUREŞ","#N/A",108348,,335,"MOISEI / Şcoala nr. 4 Moisei",3,10257,"MOISEI",108348,1034,525,507,18,0,522,3,1100,575,235,287
26,"MARAMUREŞ","#N/A",108348,,336,"MOISEI / Şcoala nr. 3 Moisei",3,10257,"MOISEI",108348,1589,896,858,38,0,893,3,1700,804,339,554
26,"MARAMUREŞ","#N/A",108348,,337,"MOISEI / Gospodărie individuală",3,10257,"MOISEI",108348,1250,677,661,15,1,672,5,1300,623,290,382
26,"MARAMUREŞ","#N/A",108348,,338,"MOISEI / Şcoala nr. 2 Moisei",3,10257,"MOISEI",108348,1865,988,925,63,0,980,8,2000,1012,369,611
26,"MARAMUREŞ","#N/A",108366,,339,"OARŢA DE JOS / Primăria Oarţa de Jos",3,10259,"OARŢA DE JOS",108366,401,260,212,34,14,260,0,500,240,138,122
26,"MARAMUREŞ","#N/A",108366,,340,"OARŢA DE SUS / Şcoala generală Oarţa de Sus",3,10259,"OARŢA DE JOS",108366,606,396,344,43,9,393,3,700,304,165,228
26,"MARAMUREŞ","#N/A",108400,,341,"BREB / Căminul cultural",3,10263,"OCNA ŞUGATAG",108400,910,488,467,21,0,485,3,1000,512,99,386
26,"MARAMUREŞ","#N/A",108400,,342,"HOTENI / Căminul cultural",3,10263,"OCNA ŞUGATAG",108400,277,211,177,33,1,211,0,300,89,38,173
26,"MARAMUREŞ","#N/A",108400,,343,"SAT-ŞUGATAG / SCOALA GENERALA SAT SUGATAG",3,10263,"OCNA ŞUGATAG",108400,992,552,536,16,0,549,3,1100,548,175,374
26,"MARAMUREŞ","#N/A",108400,,344,"OCNA ŞUGATAG / Sala de festivităţi",3,10263,"OCNA ŞUGATAG",108400,1331,747,655,92,0,742,5,1500,753,193,549
26,"MARAMUREŞ","#N/A",179864,,345,"ONCEŞTI / Cămin cultural Onceşti",3,10268,"ONCEŞTI",179864,1258,758,715,43,0,747,11,1400,642,298,449
26,"MARAMUREŞ","#N/A",108455,,346,"PETROVA / Şcoala Generală ""Mocearschi""",3,10270,"PETROVA",108455,1035,598,565,33,0,591,7,1100,502,350,241
26,"MARAMUREŞ","#N/A",108455,,347,"PETROVA / Şcoala Generală ""Susani""",3,10270,"PETROVA",108455,1001,588,553,34,1,585,3,1100,512,299,286
26,"MARAMUREŞ","#N/A",108473,,348,"POIENILE DE SUB MUNTE / Liceul Tehnologic Poienile de Sub Munte",3,10272,"POIENILE DE SUB MUNTE",108473,1048,577,566,11,0,565,12,1100,523,372,193
26,"MARAMUREŞ","#N/A",108473,,349,"POIENILE DE SUB MUNTE / Liceul Tehnologic Poienile de Sub Munte",3,10272,"POIENILE DE SUB MUNTE",108473,1099,584,571,13,0,577,7,1200,616,349,228
26,"MARAMUREŞ","#N/A",108473,,350,"POIENILE DE SUB MUNTE / Internatul Scolar Poienile de sub Munte",3,10272,"POIENILE DE SUB MUNTE",108473,1621,878,861,17,0,863,15,1800,922,625,238
26,"MARAMUREŞ","#N/A",108473,,351,"POIENILE DE SUB MUNTE / Liceul Tehnologic  Poienile de Sub Munte Scoala Nejnei Crai",3,10272,"POIENILE DE SUB MUNTE",108473,1318,656,642,14,0,645,11,1500,844,416,229
26,"MARAMUREŞ","#N/A",108473,,352,"POIENILE DE SUB MUNTE / Şcoala Gimnaziala nr. 4 Horb Poienile de sub Munte",3,10272,"POIENILE DE SUB MUNTE",108473,1325,707,687,19,1,699,8,1500,793,491,208
26,"MARAMUREŞ","#N/A",108473,,353,"POIENILE DE SUB MUNTE / Şcoala Gimnaziala nr.4 Structura Luhei Poienile de sub Munte",3,10272,"POIENILE DE SUB MUNTE",108473,849,510,491,19,0,505,5,900,390,424,81
26,"MARAMUREŞ","#N/A",179604,,354,"POIENILE IZEI / Primăria Poienile Izei",3,10274,"POIENILE IZEI",179604,804,513,489,24,0,510,3,900,387,272,238
26,"MARAMUREŞ","#N/A",106407,,355,"LĂPUŞEL / Şcoala Gimnazială",3,10276,"RECEA",106407,1166,854,745,90,19,852,2,1300,446,330,522
26,"MARAMUREŞ","#N/A",106407,,356,"SĂSAR / Şcoala Gimnazială",3,10276,"RECEA",106407,1220,813,764,47,2,803,10,1300,487,277,526
26,"MARAMUREŞ","#N/A",106407,,357,"BOZÎNTA MICĂ / Şcoala cu clasele I-IV",3,10276,"RECEA",106407,338,244,192,51,1,239,5,400,156,125,114
26,"MARAMUREŞ","#N/A",106407,,358,"MOCIRA / Şcoala cu clasele I-IV",3,10276,"RECEA",106407,833,708,594,95,19,698,10,900,192,353,345
26,"MARAMUREŞ","#N/A",106407,,359,"RECEA / Şcoala Gimnazială Recea,",3,10276,"RECEA",106407,1008,717,658,57,2,717,0,1099,382,321,396
26,"MARAMUREŞ","#N/A",106407,,360,"SĂSAR / Clădirea administrativă Biserica Duminica Mironosiţelor",3,10276,"RECEA",106407,467,396,329,67,0,392,4,500,104,175,217
26,"MARAMUREŞ","#N/A",108491,,361,"BERCHEZ / Căminul cultural",3,10282,"REMETEA CHIOARULUI",108491,534,297,274,23,0,297,0,600,303,56,241
26,"MARAMUREŞ","#N/A",108491,,362,"BERCHEZOAIA / Căminul cultural",3,10282,"REMETEA CHIOARULUI",108491,370,149,133,16,0,147,2,400,251,53,94
26,"MARAMUREŞ","#N/A",108491,,363,"POSTA / Căminul cultural",3,10282,"REMETEA CHIOARULUI",108491,281,184,156,28,0,184,0,300,116,69,115
26,"MARAMUREŞ","#N/A",108491,,364,"REMETEA CHIOARULUI / Camin Cultural",3,10282,"REMETEA CHIOARULUI",108491,846,506,429,74,3,499,7,900,394,242,257
26,"MARAMUREŞ","#N/A",108491,,365,"REMECIOARA / Şcoala cu clasele I-IV",3,10282,"REMETEA CHIOARULUI",108491,211,118,101,17,0,118,0,300,182,38,80
26,"MARAMUREŞ","#N/A",108552,,366,"PIATRA / Şcoala cu clasele I-IV",3,10288,"REMEŢI",108552,314,147,132,15,0,145,2,400,253,48,97
26,"MARAMUREŞ","#N/A",108552,,367,"TECEU MIC / Şcoala cu clasele I-IV",3,10288,"REMEŢI",108552,141,65,50,15,0,65,0,200,135,17,48
26,"MARAMUREŞ","#N/A",108552,,368,"REMEŢI / Şcoala cu clasele I-VIII",3,10288,"REMEŢI",108552,1313,610,584,26,0,606,4,1400,790,299,307
26,"MARAMUREŞ","#N/A",108552,,369,"REMEŢI / Grădiniţa Remeţi",3,10288,"REMEŢI",108552,808,360,342,18,0,359,1,900,540,210,149
26,"MARAMUREŞ","#N/A",108598,,370,"REPEDEA / Cămin cultural",3,10292,"REPEDEA",108598,1729,931,891,40,0,920,11,1900,969,419,501
26,"MARAMUREŞ","#N/A",108598,,371,"REPEDEA / Şcoala generală clasele I-IV Lujana",3,10292,"REPEDEA",108598,692,361,348,13,0,359,2,800,439,205,154
26,"MARAMUREŞ","#N/A",108598,,372,"REPEDEA / Şcoala generală clasele I-IV Lespedea de Jos",3,10292,"REPEDEA",108598,1129,607,592,15,0,603,4,1200,593,233,370
26,"MARAMUREŞ","#N/A",108614,,373,"RONA DE JOS / Şcoala Gimnazială ""Laurenţiu Ulici""",3,10294,"RONA DE JOS",108614,1736,872,830,42,0,866,6,1900,1028,468,398
26,"MARAMUREŞ","#N/A",108632,,374,"RONA DE SUS / Cămin cultural",3,10296,"RONA DE SUS",108632,1678,675,651,24,0,657,18,1800,1125,303,354
26,"MARAMUREŞ","#N/A",108632,,375,"RONA DE SUS / Cămin cultural",3,10296,"RONA DE SUS",108632,1534,549,535,14,0,544,5,1700,1151,282,262
26,"MARAMUREŞ","#N/A",108632,,376,"COŞTIUI / Clubul Tineretului",3,10296,"RONA DE SUS",108632,600,323,304,19,0,318,5,700,377,100,218
26,"MARAMUREŞ","#N/A",108669,,377,"ROZAVLEA / primaria comunei Rozavlea",3,10299,"ROZAVLEA",108669,1934,901,851,46,4,897,4,1900,999,430,467
26,"MARAMUREŞ","#N/A",108669,,378,"ROZAVLEA / Grădiniţa  sesul manastirii",3,10299,"ROZAVLEA",108669,755,350,324,23,3,349,1,1099,749,163,186
26,"MARAMUREŞ","#N/A",108696,,379,"RUSCOVA / CLUBUL TINERETULUI",3,10302,"RUSCOVA",108696,1488,692,634,57,1,684,8,1600,908,193,491
26,"MARAMUREŞ","#N/A",108696,,380,"RUSCOVA / GRADINITA     NR.1",3,10302,"RUSCOVA",108696,1686,733,717,14,2,719,14,1800,1067,216,503
26,"MARAMUREŞ","#N/A",108696,,381,"RUSCOVA / SCOALA GENERALA NR.2",3,10302,"RUSCOVA",108696,1096,466,415,51,0,459,7,1200,734,137,322
26,"MARAMUREŞ","#N/A",106620,,382,"SARASĂU / Căminul Cultural",3,10314,"SARASĂU",106620,1151,632,601,31,0,628,4,1300,668,260,368
26,"MARAMUREŞ","#N/A",106620,,383,"SARASĂU / CAMINUL CULTURAL",3,10314,"SARASĂU",106620,1009,486,468,18,0,482,4,1100,614,195,287
26,"MARAMUREŞ","#N/A",108712,,384,"SATULUNG / Scoala Gimnazială Satulung",3,10316,"SATULUNG",108712,1215,776,673,83,20,769,7,1300,524,364,405
26,"MARAMUREŞ","#N/A",108712,,385,"ARIEŞU DE PĂDURE / Căminul Cultural",3,10316,"SATULUNG",108712,168,182,118,64,0,182,0,200,18,137,45
26,"MARAMUREŞ","#N/A",108712,,386,"FERSIG / Şcoala Primară",3,10316,"SATULUNG",108712,588,416,364,50,2,415,1,600,184,175,240
26,"MARAMUREŞ","#N/A",108712,,387,"FINTEUŞU MIC / Şcoala Gimnazială",3,10316,"SATULUNG",108712,724,510,460,50,0,505,5,800,290,374,131
26,"MARAMUREŞ","#N/A",108712,,388,"HIDEAGA / Şcoala Gimnazială",3,10316,"SATULUNG",108712,499,341,287,53,1,341,0,501,160,217,124
26,"MARAMUREŞ","#N/A",108712,,389,"MOGOŞEŞTI / Şcoala Primară",3,10316,"SATULUNG",108712,647,390,365,25,0,385,5,700,310,221,164
26,"MARAMUREŞ","#N/A",108712,,390,"PRIBILEŞTI / Şcoala Gimnazială",3,10316,"SATULUNG",108712,584,406,365,38,3,403,3,600,194,161,242
26,"MARAMUREŞ","#N/A",108794,,391,"SĂCĂLĂŞENI / Sala de sport",3,10304,"SĂCĂLĂŞENI",108794,706,414,349,65,0,412,2,800,386,210,202
26,"MARAMUREŞ","#N/A",108794,,392,"CORUIA / Cămin cultural",3,10304,"SĂCĂLĂŞENI",108794,645,451,396,55,0,450,1,700,249,202,248
26,"MARAMUREŞ","#N/A",108794,,393,"CULCEA / Cămin cultural",3,10304,"SĂCĂLĂŞENI",108794,507,304,276,28,0,303,1,600,296,123,180
26,"MARAMUREŞ","#N/A",108874,,394,"SĂCEL / Primăria Săcel",3,10308,"SĂCEL",108874,1462,788,701,71,16,778,10,1600,812,419,359
26,"MARAMUREŞ","#N/A",108874,,395,"SĂCEL / Şcoala Valea Carelor",3,10308,"SĂCEL",108874,1431,742,695,35,12,735,7,1600,858,370,365
26,"MARAMUREŞ","#N/A",108918,,396,"SĂLSIG / Căminul Cultural",3,10310,"SĂLSIG",108918,1216,898,767,111,20,897,1,1300,402,347,550
26,"MARAMUREŞ","#N/A",108945,,397,"SĂPÎNŢA / Şcoala gimnazială",3,10312,"SĂPÎNŢA",108945,1349,786,722,62,2,773,13,1400,614,324,449
26,"MARAMUREŞ","#N/A",108945,,398,"SĂPÎNŢA / Şcoala Gimnazială",3,10312,"SĂPÎNŢA",108945,1295,774,739,34,1,767,7,1400,626,331,436
26,"MARAMUREŞ","#N/A",109005,,399,"STRÎMTURA / scoala generala stramtura",3,10334,"STRÎMTURA",109005,1756,962,923,39,0,953,9,1900,938,360,593
26,"MARAMUREŞ","#N/A",109005,,400,"STRÎMTURA / scoala generala susani",3,10334,"STRÎMTURA",109005,432,223,207,16,0,221,2,500,277,92,129
26,"MARAMUREŞ","#N/A",109005,,401,"GLOD / Şcoala generală Glod",3,10334,"STRÎMTURA",109005,537,303,275,28,0,301,2,600,297,131,170
26,"MARAMUREŞ","#N/A",109005,,402,"SLĂTIOARA / Şcoala generală Sătioara",3,10334,"STRÎMTURA",109005,448,215,199,16,0,211,4,500,285,81,130
26,"MARAMUREŞ","#N/A",109041,,403,"SUCIU DE JOS / Căminul cultural",3,10338,"SUCIU DE SUS",109041,874,597,544,44,9,595,2,1000,403,373,222
26,"MARAMUREŞ","#N/A",109041,,404,"SUCIU DE SUS / Primăria Suciu de Sus",3,10338,"SUCIU DE SUS",109041,1343,890,824,51,15,885,5,1500,610,574,311
26,"MARAMUREŞ","#N/A",109041,,405,"SUCIU DE SUS / Şcoala Generală Candela",3,10338,"SUCIU DE SUS",109041,732,452,414,25,13,450,2,800,348,319,131
26,"MARAMUREŞ","#N/A",109041,,406,"LARGA / Şcoala Primară Larga",3,10338,"SUCIU DE SUS",109041,295,212,188,24,0,210,2,400,188,160,50
26,"MARAMUREŞ","#N/A",179613,,407,"ŞIEU / Caminul cultural Sieu nr.109",3,10324,"ŞIEU",179613,1929,1015,949,66,0,1013,2,2100,1085,613,400
26,"MARAMUREŞ","#N/A",109096,,408,"ŞISEŞTI / PRIMARIA COMUNEI SISESTI",3,10326,"ŞISEŞTI",109096,1286,816,776,36,4,810,6,1300,484,314,496
26,"MARAMUREŞ","#N/A",109096,,409,"BONTĂIENI / Şcoala cu cls. I-IV",3,10326,"ŞISEŞTI",109096,196,112,96,16,0,111,1,200,88,66,45
26,"MARAMUREŞ","#N/A",109096,,410,"CETĂŢELE / Şcoala generală",3,10326,"ŞISEŞTI",109096,535,331,311,20,0,329,2,600,269,98,231
26,"MARAMUREŞ","#N/A",109096,,411,"DĂNEŞTI / Şcoala generală",3,10326,"ŞISEŞTI",109096,537,353,329,24,0,350,3,600,247,120,230
26,"MARAMUREŞ","#N/A",109096,,412,"NEGREIA / Şcoala cu cls. I-IV",3,10326,"ŞISEŞTI",109096,391,229,210,19,0,228,1,406,177,69,159
26,"MARAMUREŞ","#N/A",109096,,413,"PLOPIŞ / Şcoala cu cls. I-IV",3,10326,"ŞISEŞTI",109096,439,268,252,16,0,268,0,500,232,97,171
26,"MARAMUREŞ","#N/A",109096,,414,"ŞURDEŞTI / Şcoala generală",3,10326,"ŞISEŞTI",109096,1166,683,649,33,1,677,6,1200,517,230,447
26,"MARAMUREŞ","#N/A",106648,,415,"VADU IZEI / Sala de festivităţi",3,10342,"VADU IZEI",106648,2004,1225,1139,86,0,1209,16,2200,975,610,599
26,"MARAMUREŞ","#N/A",106648,,416,"VALEA STEJARULUI / Sala de festivităţi",3,10342,"VADU IZEI",106648,393,250,233,17,0,247,3,500,250,153,94
26,"MARAMUREŞ","#N/A",109354,,417,"CURTUIUŞU MARE / Şcoala generală",3,10345,"VALEA CHIOARULUI",109354,244,193,151,42,0,192,1,299,106,109,83
26,"MARAMUREŞ","#N/A",109354,,418,"FERICEA / Şcoala generală",3,10345,"VALEA CHIOARULUI",109354,348,238,215,23,0,235,3,400,162,193,42
26,"MARAMUREŞ","#N/A",109354,,419,"MESTEACĂN / Şcoala generală",3,10345,"VALEA CHIOARULUI",109354,284,190,160,30,0,189,1,300,110,113,76
26,"MARAMUREŞ","#N/A",109354,,420,"VĂRAI / Şcoala generală",3,10345,"VALEA CHIOARULUI",109354,230,167,125,42,0,167,0,300,133,51,116
26,"MARAMUREŞ","#N/A",109354,,421,"VALEA CHIOARULUI / Cămin cultural",3,10345,"VALEA CHIOARULUI",109354,539,359,327,32,0,357,2,600,241,206,151
26,"MARAMUREŞ","#N/A",109354,,422,"DURUŞA / Cămin cultural",3,10345,"VALEA CHIOARULUI",109354,52,51,33,18,0,51,0,100,49,31,20
26,"MARAMUREŞ","#N/A",109425,,423,"VIMA MICĂ / Cămin cultural",3,10352,"VIMA MICĂ",109425,313,171,149,22,0,170,1,400,229,74,96
26,"MARAMUREŞ","#N/A",109425,,424,"ASPRA / Şcoala generală Aspra",3,10352,"VIMA MICĂ",109425,39,33,18,15,0,33,0,100,67,19,14
26,"MARAMUREŞ","#N/A",109425,,425,"DEALU CORBULUI / Cămin cultural",3,10352,"VIMA MICĂ",109425,82,61,44,17,0,61,0,100,39,16,45
26,"MARAMUREŞ","#N/A",109425,,426,"JUGĂSTRENI / Şcoala generală",3,10352,"VIMA MICĂ",109425,46,47,24,23,0,47,0,100,53,21,26
26,"MARAMUREŞ","#N/A",109425,,427,"PETERITEA / Cămin cultural",3,10352,"VIMA MICĂ",109425,205,116,99,17,0,113,3,300,184,68,45
26,"MARAMUREŞ","#N/A",109425,,428,"SĂLNIŢA / Cămin cultural",3,10352,"VIMA MICĂ",109425,206,129,114,15,0,128,1,300,171,62,66
26,"MARAMUREŞ","#N/A",109425,,429,"VIMA MARE / Cămin cultural",3,10352,"VIMA MICĂ",109425,336,194,172,22,0,193,1,400,206,60,133
26,"MARAMUREŞ","#N/A",109504,,430,"VIŞEU DE JOS / Primărie",3,10360,"VIŞEU DE JOS",109504,1458,790,742,48,0,784,6,1700,910,319,465
26,"MARAMUREŞ","#N/A",109504,,431,"VIŞEU DE JOS / Camin Cultural",3,10360,"VIŞEU DE JOS",109504,1532,887,852,35,0,883,4,1600,713,328,555
26,"MARAMUREŞ","#N/A",109504,,432,"VIŞEU DE JOS / Şcoala nr. 2",3,10360,"VIŞEU DE JOS",109504,1341,708,684,24,0,694,14,1500,792,271,423
26,"MARAMUREŞ","#N/A",108240,,433,"LEORDINA / SCOALA",3,10247,"LEORDINA",108240,539,260,244,16,0,253,7,601,341,84,169
27,"MEHEDINŢI","#N/A",109773,,1,"DROBETA-TURNU SEVERIN / Hidroelectrica SA",1,10363,"MUNICIPIUL DROBETA-TURNU SEVERIN",109773,1449,961,826,135,0,938,23,1600,639,514,424
27,"MEHEDINŢI","#N/A",109773,,2,"DROBETA-TURNU SEVERIN / Colegiul Naţional ""Traian""",1,10363,"MUNICIPIUL DROBETA-TURNU SEVERIN",109773,1466,896,787,94,15,875,21,1600,704,464,411
27,"MEHEDINŢI","#N/A",109773,,3,"DROBETA-TURNU SEVERIN / Şcoala Gimnazială ""D.I.Totir"" (Şc.Gen.nr.10)",1,10363,"MUNICIPIUL DROBETA-TURNU SEVERIN",109773,1474,898,845,52,1,877,21,1600,702,408,469
27,"MEHEDINŢI","#N/A",109773,,4,"DROBETA-TURNU SEVERIN / Şcoala Gimnazială ""D.I.Totir""(Şc.Gen.nr.10)",1,10363,"MUNICIPIUL DROBETA-TURNU SEVERIN",109773,1381,774,729,43,2,752,22,1500,726,411,341
27,"MEHEDINŢI","#N/A",109773,,5,"DROBETA-TURNU SEVERIN / ASOCIAŢIA DE PROPRIETARI NR.90",1,10363,"MUNICIPIUL DROBETA-TURNU SEVERIN",109773,1020,643,602,41,0,627,16,1100,457,299,328
27,"MEHEDINŢI","#N/A",109773,,6,"DROBETA-TURNU SEVERIN / Liceul Tehnologic Special ""Drobeta"" (Şc.Energetică)",1,10363,"MUNICIPIUL DROBETA-TURNU SEVERIN",109773,1489,843,805,37,1,830,13,1600,757,422,408
27,"MEHEDINŢI","#N/A",109773,,7,"DROBETA-TURNU SEVERIN / Liceul Tehnologic Special ""Drobeta"" (Şc.Energetică)",1,10363,"MUNICIPIUL DROBETA-TURNU SEVERIN",109773,1087,609,581,28,0,599,10,1200,591,316,283
27,"MEHEDINŢI","#N/A",109773,,8,"DROBETA-TURNU SEVERIN / S.C. TRANSBACO S.R.L. (Autogară)",1,10363,"MUNICIPIUL DROBETA-TURNU SEVERIN",109773,1548,887,794,93,0,872,15,1600,713,473,399
27,"MEHEDINŢI","#N/A",109773,,9,"DROBETA-TURNU SEVERIN / Şcoala Gimnazială ""Constantin Negreanu"" (Şc.Gen.Nr.9)",1,10363,"MUNICIPIUL DROBETA-TURNU SEVERIN",109773,1515,835,760,75,0,813,22,1600,765,421,392
27,"MEHEDINŢI","#N/A",109773,,10,"DROBETA-TURNU SEVERIN / Şcoala Gimnazială ""Constantin Negreanu"" (Şc.Gen.Nr.9)",1,10363,"MUNICIPIUL DROBETA-TURNU SEVERIN",109773,1431,780,715,64,1,770,10,1500,720,450,320
27,"MEHEDINŢI","#N/A",109773,,11,"DROBETA-TURNU SEVERIN / Şcoala Gimnazială ""Constantin Negreanu"" (Şc.Gen.Nr.9)",1,10363,"MUNICIPIUL DROBETA-TURNU SEVERIN",109773,1825,782,750,32,0,764,18,1900,1118,434,330
27,"MEHEDINŢI","#N/A",109773,,12,"DROBETA-TURNU SEVERIN / Casa Agronomului",1,10363,"MUNICIPIUL DROBETA-TURNU SEVERIN",109773,1747,890,831,59,0,868,22,1800,910,452,416
27,"MEHEDINŢI","#N/A",109773,,13,"DROBETA-TURNU SEVERIN / Casa Agronomului",1,10363,"MUNICIPIUL DROBETA-TURNU SEVERIN",109773,1614,829,770,59,0,816,13,1700,871,390,426
27,"MEHEDINŢI","#N/A",109773,,14,"DROBETA-TURNU SEVERIN / Colegiul Naţional ""Gheorghe Ţiţeica""",1,10363,"MUNICIPIUL DROBETA-TURNU SEVERIN",109773,1314,679,621,57,1,669,10,1400,721,368,301
27,"MEHEDINŢI","#N/A",109773,,15,"DROBETA-TURNU SEVERIN / Colegiul Naţional ""Gheorghe Ţiţeica""",1,10363,"MUNICIPIUL DROBETA-TURNU SEVERIN",109773,1287,761,699,59,3,746,15,1400,639,395,351
27,"MEHEDINŢI","#N/A",109773,,16,"DROBETA-TURNU SEVERIN / Colegiul Naţional Economic ""Theodor Costescu""",1,10363,"MUNICIPIUL DROBETA-TURNU SEVERIN",109773,1160,675,638,36,1,658,17,1200,525,403,255
27,"MEHEDINŢI","#N/A",109773,,17,"DROBETA-TURNU SEVERIN / Grădiniţa cu program prelungit nr. 22",1,10363,"MUNICIPIUL DROBETA-TURNU SEVERIN",109773,1177,572,519,53,0,562,10,1300,728,312,250
27,"MEHEDINŢI","#N/A",109773,,18,"DROBETA-TURNU SEVERIN / Şcoala Gimnazială nr. 14",1,10363,"MUNICIPIUL DROBETA-TURNU SEVERIN",109773,1138,637,562,75,0,625,12,1200,563,370,255
27,"MEHEDINŢI","#N/A",109773,,19,"DROBETA-TURNU SEVERIN / Şcoala Gimnazială nr. 14",1,10363,"MUNICIPIUL DROBETA-TURNU SEVERIN",109773,1489,713,675,38,0,691,22,1600,887,395,296
27,"MEHEDINŢI","#N/A",109773,,20,"DROBETA-TURNU SEVERIN / Sindicatul Judeţean Mehedinţi al Pensionarilor",1,10363,"MUNICIPIUL DROBETA-TURNU SEVERIN",109773,1264,696,663,32,1,681,15,1400,704,363,318
27,"MEHEDINŢI","#N/A",109773,,21,"DROBETA-TURNU SEVERIN / Şcoala Gimnazială nr. 11",1,10363,"MUNICIPIUL DROBETA-TURNU SEVERIN",109773,1660,901,821,80,0,884,17,1800,899,504,380
27,"MEHEDINŢI","#N/A",109773,,22,"DROBETA-TURNU SEVERIN / Şcoala Gimnazială nr. 11",1,10363,"MUNICIPIUL DROBETA-TURNU SEVERIN",109773,1397,774,748,25,1,768,6,1500,726,483,285
27,"MEHEDINŢI","#N/A",109773,,23,"DROBETA-TURNU SEVERIN / Ministerul Sănătăţii - Serviciul Judeţean de Ambulanţă - Spaţiu administrativ",1,10363,"MUNICIPIUL DROBETA-TURNU SEVERIN",109773,1621,839,803,35,1,820,19,1800,961,454,366
27,"MEHEDINŢI","#N/A",109773,,24,"DROBETA-TURNU SEVERIN / Direcţia de Sănătate Publică Mehedinţi - Spitalul Judeţean de Urgenţă - Spaţiu administrativ",1,10363,"MUNICIPIUL DROBETA-TURNU SEVERIN",109773,1810,966,922,44,0,950,16,2100,1134,543,407
27,"MEHEDINŢI","#N/A",109773,,25,"DROBETA-TURNU SEVERIN / Direcţia de Sănătate Publică Mehedinţi - Spitalul Judeţean de Urgenţă - Spaţiu administrativ",1,10363,"MUNICIPIUL DROBETA-TURNU SEVERIN",109773,1532,924,681,179,64,914,10,1799,875,553,361
27,"MEHEDINŢI","#N/A",109773,,26,"DROBETA-TURNU SEVERIN / Grădiniţa cu program prelungit nr.20",1,10363,"MUNICIPIUL DROBETA-TURNU SEVERIN",109773,1676,906,852,54,0,895,11,1800,894,478,417
27,"MEHEDINŢI","#N/A",109773,,27,"DROBETA-TURNU SEVERIN / Colegiul Tehnic ""Domnul Tudor""",1,10363,"MUNICIPIUL DROBETA-TURNU SEVERIN",109773,926,543,480,61,2,533,10,1000,457,282,251
27,"MEHEDINŢI","#N/A",109773,,28,"DROBETA-TURNU SEVERIN / Colegiul Tehnic ""Domnul Tudor""",1,10363,"MUNICIPIUL DROBETA-TURNU SEVERIN",109773,1258,782,690,92,0,769,13,1300,518,453,316
27,"MEHEDINŢI","#N/A",109773,,29,"DROBETA-TURNU SEVERIN / Colegiul Tehnic ""Domnul Tudor""",1,10363,"MUNICIPIUL DROBETA-TURNU SEVERIN",109773,1345,802,766,36,0,786,16,1400,598,406,380
27,"MEHEDINŢI","#N/A",109773,,30,"DROBETA-TURNU SEVERIN / Colegiul Tehnic ""Domnul Tudor""",1,10363,"MUNICIPIUL DROBETA-TURNU SEVERIN",109773,1380,727,688,39,0,713,14,1500,773,364,349
27,"MEHEDINŢI","#N/A",109773,,31,"DROBETA-TURNU SEVERIN / Primăria Municipiului Drobeta-Turnu Severin (Stadionul Municipal)",1,10363,"MUNICIPIUL DROBETA-TURNU SEVERIN",109773,1511,822,782,40,0,801,21,1600,778,485,316
27,"MEHEDINŢI","#N/A",109773,,32,"DROBETA-TURNU SEVERIN / Colegiul Tehnic ""Lorin Sălăgean"" (Lic.Ind.Nr.4)",1,10363,"MUNICIPIUL DROBETA-TURNU SEVERIN",109773,1124,612,585,27,0,601,11,1199,587,360,241
27,"MEHEDINŢI","#N/A",109773,,33,"DROBETA-TURNU SEVERIN / Grădiniţa cu program prelungit nr. 3",1,10363,"MUNICIPIUL DROBETA-TURNU SEVERIN",109773,1373,764,720,43,1,750,14,1500,736,411,339
27,"MEHEDINŢI","#N/A",109773,,34,"DROBETA-TURNU SEVERIN / Şcoala Gimnazială nr. 6",1,10363,"MUNICIPIUL DROBETA-TURNU SEVERIN",109773,1344,823,727,95,1,810,13,1400,577,434,376
27,"MEHEDINŢI","#N/A",109773,,35,"DROBETA-TURNU SEVERIN / Şcoala Gimnazială nr. 6",1,10363,"MUNICIPIUL DROBETA-TURNU SEVERIN",109773,1606,866,823,41,2,849,17,1700,834,437,412
27,"MEHEDINŢI","#N/A",109773,,36,"DROBETA-TURNU SEVERIN / Şcoala Gimnazială nr. 6",1,10363,"MUNICIPIUL DROBETA-TURNU SEVERIN",109773,1314,725,689,36,0,711,14,1400,675,372,339
27,"MEHEDINŢI","#N/A",109773,,37,"DROBETA-TURNU SEVERIN / Şcoala Gimnazială nr. 6",1,10363,"MUNICIPIUL DROBETA-TURNU SEVERIN",109773,1317,690,658,32,0,669,21,1400,710,336,333
27,"MEHEDINŢI","#N/A",109773,,38,"DROBETA-TURNU SEVERIN / Direcţia Regională de Drumuri şi Poduri Craiova",1,10363,"MUNICIPIUL DROBETA-TURNU SEVERIN",109773,1458,723,682,41,0,705,18,1600,877,368,337
27,"MEHEDINŢI","#N/A",109773,,39,"DROBETA-TURNU SEVERIN / Şcoala Gimnazială ""Petre Sergescu""",1,10363,"MUNICIPIUL DROBETA-TURNU SEVERIN",109773,1240,660,615,45,0,655,5,1295,635,345,310
27,"MEHEDINŢI","#N/A",109773,,40,"DROBETA-TURNU SEVERIN / Primaria Municipiului Drobeta-Turnu Severin - Spatiu Administrativ",1,10363,"MUNICIPIUL DROBETA-TURNU SEVERIN",109773,1054,568,534,34,0,563,5,1100,532,296,267
27,"MEHEDINŢI","#N/A",109773,,41,"DROBETA-TURNU SEVERIN / Grădiniţa cu program prelungit nr. 21",1,10363,"MUNICIPIUL DROBETA-TURNU SEVERIN",109773,1432,753,720,33,0,730,23,1500,747,422,308
27,"MEHEDINŢI","#N/A",109773,,42,"DROBETA-TURNU SEVERIN / Şcoala Gimnazială ""Petre Sergescu"" (Şc.Gen.Nr.4)",1,10363,"MUNICIPIUL DROBETA-TURNU SEVERIN",109773,1314,632,595,35,2,621,11,1400,768,373,248
27,"MEHEDINŢI","#N/A",109773,,43,"DROBETA-TURNU SEVERIN / Şcoala Gimnazială ""Petre Sergescu"" (Şc.Gen.Nr.4)",1,10363,"MUNICIPIUL DROBETA-TURNU SEVERIN",109773,1308,677,643,34,0,669,8,1398,721,363,306
27,"MEHEDINŢI","#N/A",109773,,44,"DROBETA-TURNU SEVERIN / Şcoala Gimnazială ""Petre Sergescu"" (Şc.Gen.Nr.4)",1,10363,"MUNICIPIUL DROBETA-TURNU SEVERIN",109773,1334,724,700,24,0,710,14,1399,675,417,293
27,"MEHEDINŢI","#N/A",109773,,45,"DROBETA-TURNU SEVERIN / Primăria Municipiului Drobeta-Turnu Severin (Sala Polivalentă)",1,10363,"MUNICIPIUL DROBETA-TURNU SEVERIN",109773,1937,1108,1058,49,1,1085,23,2000,892,605,480
27,"MEHEDINŢI","#N/A",109773,,46,"DROBETA-TURNU SEVERIN / Primăria Municipiului Drobeta-Turnu Severin (Sala Polivalentă)",1,10363,"MUNICIPIUL DROBETA-TURNU SEVERIN",109773,1572,826,785,39,2,817,9,1700,874,447,370
27,"MEHEDINŢI","#N/A",109773,,47,"DROBETA-TURNU SEVERIN / Şcoala Gimnazială ""Dimitrie Grecescu"" (Şc.Gen.Nr.1)",1,10363,"MUNICIPIUL DROBETA-TURNU SEVERIN",109773,1576,1361,916,60,385,1335,26,2099,738,884,451
27,"MEHEDINŢI","#N/A",109773,,48,"DROBETA-TURNU SEVERIN / Colegiul Tehnic ""Decebal""",1,10363,"MUNICIPIUL DROBETA-TURNU SEVERIN",109773,1453,861,806,55,0,842,19,1600,739,459,383
27,"MEHEDINŢI","#N/A",109773,,49,"DROBETA-TURNU SEVERIN / Şcoala Gimnazială nr.3",1,10363,"MUNICIPIUL DROBETA-TURNU SEVERIN",109773,1476,898,823,74,1,879,19,1600,702,423,456
27,"MEHEDINŢI","#N/A",109773,,50,"DROBETA-TURNU SEVERIN / Şcoala Gimnazială ""Alice Voinescu"" (Şc.Gen.Nr.2)",1,10363,"MUNICIPIUL DROBETA-TURNU SEVERIN",109773,1345,933,797,134,2,921,12,1400,467,490,431
27,"MEHEDINŢI","#N/A",109773,,51,"DROBETA-TURNU SEVERIN / Şcoala Gimnazială nr.15 (fosta Şc.Gen.Nr.8)",1,10363,"MUNICIPIUL DROBETA-TURNU SEVERIN",109773,1092,692,604,87,1,683,9,1200,508,399,284
27,"MEHEDINŢI","#N/A",109773,,52,"DROBETA-TURNU SEVERIN / Şcoala Gimnazială nr.15 (fosta Şc.Gen.Nr.8)",1,10363,"MUNICIPIUL DROBETA-TURNU SEVERIN",109773,1782,1048,1016,30,2,1028,20,1899,851,616,412
27,"MEHEDINŢI","#N/A",109773,,53,"DROBETA-TURNU SEVERIN / Şcoala Gimnazială ""Teodor Costescu"" ( Şc.Gen.Nr.7)",1,10363,"MUNICIPIUL DROBETA-TURNU SEVERIN",109773,1969,1001,937,64,0,977,24,2100,1099,512,465
27,"MEHEDINŢI","#N/A",109773,,54,"DROBETA-TURNU SEVERIN / Şcoala Gimnazială ""Teodor Costescu"" ( Şc.Gen.Nr.7)",1,10363,"MUNICIPIUL DROBETA-TURNU SEVERIN",109773,1524,817,736,80,1,804,13,1599,782,422,382
27,"MEHEDINŢI","#N/A",109773,,55,"DROBETA-TURNU SEVERIN / Şcoala Gimnazială ""Teodor Costescu"" ( Şc.Gen.Nr.7)",1,10363,"MUNICIPIUL DROBETA-TURNU SEVERIN",109773,1961,950,925,24,1,923,27,2102,1152,479,444
27,"MEHEDINŢI","#N/A",109773,,56,"DROBETA-TURNU SEVERIN / Şcoala Gimnazială ""Teodor Costescu"" (Şc.Gen.Nr.7)",1,10363,"MUNICIPIUL DROBETA-TURNU SEVERIN",109773,1767,924,898,26,0,903,21,1900,976,461,442
27,"MEHEDINŢI","#N/A",109773,,57,"DROBETA-TURNU SEVERIN / Şcoala Gimnazială nr.15",1,10363,"MUNICIPIUL DROBETA-TURNU SEVERIN",109773,1435,703,649,54,0,689,14,1500,797,344,345
27,"MEHEDINŢI","#N/A",109773,,58,"DROBETA-TURNU SEVERIN / Şcoala Gimnazială nr.15",1,10363,"MUNICIPIUL DROBETA-TURNU SEVERIN",109773,1112,613,576,36,1,599,14,1200,587,333,266
27,"MEHEDINŢI","#N/A",109773,,59,"DROBETA-TURNU SEVERIN / Şcoala Gimnazială nr.15",1,10363,"MUNICIPIUL DROBETA-TURNU SEVERIN",109773,1430,720,690,29,1,704,16,1500,780,384,320
27,"MEHEDINŢI","#N/A",109773,,60,"DROBETA-TURNU SEVERIN / Şcoala Gimnazială nr.15",1,10363,"MUNICIPIUL DROBETA-TURNU SEVERIN",109773,1847,951,913,38,0,930,21,2000,1049,490,440
27,"MEHEDINŢI","#N/A",109773,,61,"DROBETA-TURNU SEVERIN / Grădiniţa cu Program Prelungit nr.15",1,10363,"MUNICIPIUL DROBETA-TURNU SEVERIN",109773,1196,698,655,42,1,681,17,1300,602,437,244
27,"MEHEDINŢI","#N/A",109773,,62,"DROBETA-TURNU SEVERIN / Grădiniţa cu Program Prelungit nr.15",1,10363,"MUNICIPIUL DROBETA-TURNU SEVERIN",109773,1484,753,714,38,1,742,11,1599,846,391,351
27,"MEHEDINŢI","#N/A",109773,,63,"DROBETA-TURNU SEVERIN / Şcoala Gimnazială nr.5",1,10363,"MUNICIPIUL DROBETA-TURNU SEVERIN",109773,1528,842,804,36,2,823,19,1600,758,546,277
27,"MEHEDINŢI","#N/A",109773,,64,"DROBETA-TURNU SEVERIN / Şcoala Gimnazială ""Dimitrie Grecescu"" (Şc.Gen.Nr.15 Gura Văii)",1,10363,"MUNICIPIUL DROBETA-TURNU SEVERIN",109773,1597,970,854,116,0,958,12,1696,726,524,434
27,"MEHEDINŢI","#N/A",109773,,65,"DROBETA-TURNU SEVERIN / Grădiniţa cu program prelungit nr.15",1,10363,"MUNICIPIUL DROBETA-TURNU SEVERIN",109773,1791,662,634,28,0,652,10,2000,1338,272,380
27,"MEHEDINŢI","#N/A",110063,,66,"ORŞOVA / Scoala cu cls.I-VIII Petru Dumitriu Sud",1,10368,"MUNICIPIUL ORŞOVA",110063,1583,899,836,56,7,878,21,1700,801,456,422
27,"MEHEDINŢI","#N/A",110063,,67,"ORŞOVA / Liceul Traian Lalescu",1,10368,"MUNICIPIUL ORŞOVA",110063,1091,590,495,62,33,583,7,1200,610,306,277
27,"MEHEDINŢI","#N/A",110063,,68,"ORŞOVA / Liceul Traian Lalescu",1,10368,"MUNICIPIUL ORŞOVA",110063,1393,661,610,49,2,652,9,1499,838,380,272
27,"MEHEDINŢI","#N/A",110063,,69,"ORŞOVA / Clubul Copiilor",1,10368,"MUNICIPIUL ORŞOVA",110063,1014,542,522,19,1,531,11,1100,558,308,223
27,"MEHEDINŢI","#N/A",110063,,70,"ORŞOVA / Clubul Copiilor",1,10368,"MUNICIPIUL ORŞOVA",110063,1242,636,595,41,0,623,13,1308,672,302,321
27,"MEHEDINŢI","#N/A",110063,,71,"ORŞOVA / Colegiul Tehnic Dierna",1,10368,"MUNICIPIUL ORŞOVA",110063,1536,811,738,69,4,800,11,1600,789,425,375
27,"MEHEDINŢI","#N/A",110063,,72,"ORŞOVA / Scoala Generala I-VIII nr.1 Nord",1,10368,"MUNICIPIUL ORŞOVA",110063,1421,743,685,57,1,731,12,1500,757,413,318
27,"MEHEDINŢI","#N/A",110063,,73,"ORŞOVA / Grădiniţa nr.3",1,10368,"MUNICIPIUL ORŞOVA",110063,1559,854,806,45,3,843,11,1700,846,409,434
27,"MEHEDINŢI","#N/A",110063,,74,"ORŞOVA / Gradiniţa Coramnic",1,10368,"MUNICIPIUL ORŞOVA",110063,328,193,181,11,1,192,1,400,207,117,75
27,"MEHEDINŢI","#N/A",109924,,75,"BAIA DE ARAMĂ / Şcoala generală Baia de aramă",1,10370,"ORAŞ BAIA DE ARAMĂ",109924,1195,921,673,248,0,905,16,1300,379,529,376
27,"MEHEDINŢI","#N/A",109924,,76,"BAIA DE ARAMĂ / Grupul Scolar Constantin Brancoveanu",1,10370,"ORAŞ BAIA DE ARAMĂ",109924,1129,979,619,360,0,963,16,1200,221,637,326
27,"MEHEDINŢI","#N/A",109924,,77,"MĂRĂŞEŞTI / Scoala Generala Mărăşeşti",1,10370,"ORAŞ BAIA DE ARAMĂ",109924,1089,711,651,60,0,706,5,1200,489,380,326
27,"MEHEDINŢI","#N/A",109924,,78,"TITERLEŞTI / Scoala Generala Titerlesti",1,10370,"ORAŞ BAIA DE ARAMĂ",109924,403,285,239,45,1,283,2,500,215,164,119
27,"MEHEDINŢI","#N/A",109924,,79,"NEGOEŞTI / Scoala Generala Negoesti",1,10370,"ORAŞ BAIA DE ARAMĂ",109924,683,601,379,222,0,594,7,800,199,376,218
27,"MEHEDINŢI","#N/A",110116,,80,"STREHAIA / Liceul Tehnologic M.Basarab",1,10380,"ORAŞ STREHAIA",110116,1659,950,872,78,0,932,18,1800,850,663,269
27,"MEHEDINŢI","#N/A",110116,,81,"STREHAIA / Grădiniţa 2",1,10380,"ORAŞ STREHAIA",110116,1592,824,779,45,0,809,15,1700,876,497,312
27,"MEHEDINŢI","#N/A",110116,,82,"STREHAIA / Şcoala Generală Strehaia",1,10380,"ORAŞ STREHAIA",110116,1379,801,690,96,15,789,12,1500,699,492,297
27,"MEHEDINŢI","#N/A",110116,,83,"STREHAIA / Grădiniţa Vest Strehaia",1,10380,"ORAŞ STREHAIA",110116,1460,891,811,32,48,870,21,1600,709,541,329
27,"MEHEDINŢI","#N/A",110116,,84,"CIOCHIUŢA / Şcoala Generală Ciochiuţa",1,10380,"ORAŞ STREHAIA",110116,836,556,482,74,0,549,7,900,344,342,207
27,"MEHEDINŢI","#N/A",110116,,85,"SLĂTINICU MARE / Şcoala Generală Slătinicul Mare",1,10380,"ORAŞ STREHAIA",110116,315,191,164,27,0,190,1,400,209,112,78
27,"MEHEDINŢI","#N/A",110116,,86,"LUNCA BANULUI / Şcoala Generala Lunca Banului",1,10380,"ORAŞ STREHAIA",110116,378,245,220,22,3,240,5,399,154,161,79
27,"MEHEDINŢI","#N/A",110116,,87,"COMANDA / Şcoala Generală Comanda",1,10380,"ORAŞ STREHAIA",110116,1300,698,657,37,4,684,14,1400,702,340,344
27,"MEHEDINŢI","#N/A",110116,,88,"HURDUCEŞTI / Şcoala Generală Hurducesti",1,10380,"ORAŞ STREHAIA",110116,221,135,116,19,0,135,0,299,164,84,51
27,"MEHEDINŢI","#N/A",110116,,89,"STĂNCEŞTI / Şcoala Generală Stănceşti",1,10380,"ORAŞ STREHAIA",110116,159,114,99,14,1,113,1,200,86,57,56
27,"MEHEDINŢI","#N/A",110232,,90,"VÎNJU MARE / Liceul Teoretic  Vînju Mare",1,10391,"ORAŞ VÎNJU MARE",110232,1315,814,700,94,20,798,16,1400,586,541,257
27,"MEHEDINŢI","#N/A",110232,,91,"VÎNJU MARE / Şcoala Generală I-VIII Vînju Mare",1,10391,"ORAŞ VÎNJU MARE",110232,1634,996,880,89,27,987,9,1800,804,623,364
27,"MEHEDINŢI","#N/A",110232,,92,"BUCURA / Gradinita Bucura",1,10391,"ORAŞ VÎNJU MARE",110232,268,232,192,27,13,232,0,300,68,147,85
27,"MEHEDINŢI","#N/A",110232,,93,"NICOLAE BĂLCESCU / Şcoala Generală I-IV Nicolae Bălcescu",1,10391,"ORAŞ VÎNJU MARE",110232,663,454,387,45,22,449,5,700,246,285,164
27,"MEHEDINŢI","#N/A",110232,,94,"OREVIŢA MARE / Scoala Generala I-IV Oreviţa Mare",1,10391,"ORAŞ VÎNJU MARE",110232,682,516,421,64,31,507,9,800,284,340,167
27,"MEHEDINŢI","#N/A",110232,,95,"TRAIAN / Şcoala Generală I-IV Traian",1,10391,"ORAŞ VÎNJU MARE",110232,502,359,287,56,16,358,1,600,241,192,166
27,"MEHEDINŢI","#N/A",110296,,96,"COMĂNEŞTI / Şcoala Generală I-IV Comăneşti",3,10397,"BALA",110296,335,220,177,43,0,216,4,400,180,146,70
27,"MEHEDINŢI","#N/A",110296,,97,"CRAINICI / Scoala Generală I-VIII Crainici",3,10397,"BALA",110296,284,228,167,61,0,228,0,300,72,153,75
27,"MEHEDINŢI","#N/A",110296,,98,"SĂRDĂNEŞTI / scoala Generală I-iV Sărdăneşti",3,10397,"BALA",110296,207,151,118,33,0,149,2,200,49,98,51
27,"MEHEDINŢI","#N/A",110296,,99,"IUPCA / Scoala Generală I-IV Iupca",3,10397,"BALA",110296,226,167,134,33,0,167,0,300,133,98,69
27,"MEHEDINŢI","#N/A",110296,,100,"BALA / Cămin Cultural Bala",3,10397,"BALA",110296,663,473,350,123,0,472,1,700,227,275,197
27,"MEHEDINŢI","#N/A",110296,,101,"BRATEŞUL / Scoala Generală I-IV Brateşul",3,10397,"BALA",110296,102,66,53,13,0,66,0,199,133,28,38
27,"MEHEDINŢI","#N/A",110296,,102,"BALA DE SUS / Scoala Generală I-IV Bala de Sus",3,10397,"BALA",110296,509,358,315,43,0,357,1,600,242,199,158
27,"MEHEDINŢI","#N/A",110296,,103,"RUDINA / Scoala Generală I-IV Rudina",3,10397,"BALA",110296,438,285,235,50,0,276,9,500,215,197,79
27,"MEHEDINŢI","#N/A",110296,,104,"VIDIMIREŞTI / Scoala Generală I-IV Vidimireşti",3,10397,"BALA",110296,142,87,58,29,0,86,1,200,113,57,29
27,"MEHEDINŢI","#N/A",110296,,105,"DÎLMA / Scoala Generală I-VIII Dîlma",3,10397,"BALA",110296,340,238,194,44,0,237,1,400,162,151,86
27,"MEHEDINŢI","#N/A",110456,,106,"BALTA / Cămin Cultural Balta",3,10417,"BALTA",110456,358,284,218,65,1,281,3,410,126,163,118
27,"MEHEDINŢI","#N/A",110456,,107,"PREJNA / Scoala Generala Prejna",3,10417,"BALTA",110456,233,245,158,83,4,245,0,300,55,191,54
27,"MEHEDINŢI","#N/A",110456,,108,"COSTEŞTI / Cămin Cultural Costeşti",3,10417,"BALTA",110456,152,149,105,42,2,148,1,200,51,104,44
27,"MEHEDINŢI","#N/A",110456,,109,"GORNOVIŢA / Cămin Cultural Gornoviţa",3,10417,"BALTA",110456,162,144,111,31,2,143,1,200,56,111,32
27,"MEHEDINŢI","#N/A",110535,,110,"BĂLĂCIŢA / Scoala Generală I-VIII Bălăciţa",3,10413,"BĂLĂCIŢA",110535,1035,596,474,98,24,592,4,1100,504,407,185
27,"MEHEDINŢI","#N/A",110535,,111,"GVARDINIŢA / Scoala Generală I-VIII Gvardeniţa",3,10413,"BĂLĂCIŢA",110535,902,686,549,100,37,677,9,1000,314,545,132
27,"MEHEDINŢI","#N/A",110535,,112,"DOBRA / Scoala Generală I-IV Dobra",3,10413,"BĂLĂCIŢA",110535,387,338,201,121,16,336,2,499,161,284,52
27,"MEHEDINŢI","#N/A",110571,,113,"BÎCLEŞ / Scoala Generală I-VIII BÎCLEŞ",3,10425,"BÎCLEŞ",110571,521,503,319,125,59,500,3,600,97,377,123
27,"MEHEDINŢI","#N/A",110571,,114,"PODU GROSULUI / Scoala Generală I-IV Podu Grosului",3,10425,"BÎCLEŞ",110571,175,146,110,26,10,146,0,200,54,120,26
27,"MEHEDINŢI","#N/A",110571,,115,"PETRA / Scoala Generală I-IV Petra",3,10425,"BÎCLEŞ",110571,158,154,101,45,8,153,1,199,45,130,23
27,"MEHEDINŢI","#N/A",110571,,116,"CORZU / Scoala Generală I-IV Corzu",3,10425,"BÎCLEŞ",110571,364,324,267,57,0,321,3,400,76,283,38
27,"MEHEDINŢI","#N/A",110571,,117,"SMADOVIŢA / Scoala Generală I-IV Smadoviţa",3,10425,"BÎCLEŞ",110571,417,346,277,69,0,344,2,496,150,294,50
27,"MEHEDINŢI","#N/A",110688,,118,"BÎLVĂNEŞTI / Primăria Bîlvăneşti",3,10433,"BÎLVĂNEŞTI",110688,769,636,504,132,0,635,1,800,164,472,163
27,"MEHEDINŢI","#N/A",114060,,119,"BRANIŞTEA / Scoala Gimnaziala Branistea",3,10439,"BRANIŞTEA",114060,1187,1066,810,163,93,1062,4,1300,234,856,206
27,"MEHEDINŢI","#N/A",114060,,120,"GOANŢA / Scoala Generală I-IV Goanţa",3,10439,"BRANIŞTEA",114060,401,339,245,69,25,338,1,500,161,279,59
27,"MEHEDINŢI","#N/A",110740,,121,"BREZNIŢA-MOTRU / Scoala Generală I-VIII Brezniţa Motru",3,10442,"BREZNIŢA-MOTRU",110740,923,722,565,88,69,718,4,1001,279,479,239
27,"MEHEDINŢI","#N/A",110740,,122,"FĂUROAIA / Scoala Generală I-IVIII Făuroaia",3,10442,"BREZNIŢA-MOTRU",110740,309,250,177,49,24,247,3,399,149,175,72
27,"MEHEDINŢI","#N/A",110820,,123,"BREZNIŢA-OCOL / Scoala Generală I-VIII Brezniţa Ocol",3,10450,"BREZNIŢA-OCOL",110820,1516,803,752,51,0,799,4,1600,797,432,367
27,"MEHEDINŢI","#N/A",110820,,124,"MAGHERU / Scoala Generală I-IV Magheru",3,10450,"BREZNIŢA-OCOL",110820,875,623,455,168,0,610,13,1000,377,392,218
27,"MEHEDINŢI","#N/A",110820,,125,"JIDOŞTIŢA / Scoala Generală I-IV Jidoştiţa",3,10450,"BREZNIŢA-OCOL",110820,921,635,506,128,1,633,2,1000,365,331,302
27,"MEHEDINŢI","#N/A",110875,,126,"BROŞTENI / Cămin Cultural Broşteni",3,10455,"BROŞTENI",110875,1193,940,714,212,14,928,12,1299,359,624,304
27,"MEHEDINŢI","#N/A",110875,,127,"LUPŞA DE JOS / Cămin Cultural Lupşa de Jos",3,10455,"BROŞTENI",110875,1101,803,726,75,2,793,10,1199,396,604,189
27,"MEHEDINŢI","#N/A",110946,,128,"BURILA MARE / Scoala Generală Burila Mare",3,10462,"BURILA MARE",110946,628,490,381,92,17,479,11,700,210,292,187
27,"MEHEDINŢI","#N/A",110946,,129,"CRIVINA / Scoala Generală Crivina",3,10462,"BURILA MARE",110946,545,394,274,103,17,390,4,589,195,237,153
27,"MEHEDINŢI","#N/A",110946,,130,"ŢIGĂNAŞI / Scoala Generală Ţigănaşi",3,10462,"BURILA MARE",110946,288,230,154,60,16,228,2,299,69,116,112
27,"MEHEDINŢI","#N/A",110946,,131,"VRANCEA / Scoala Generală Vrancea",3,10462,"BURILA MARE",110946,163,178,95,83,0,176,2,209,31,101,75
27,"MEHEDINŢI","#N/A",110946,,132,"IZVORU FRUMOS / Scoala Generală Izvoru Frumos",3,10462,"BURILA MARE",110946,194,141,96,34,11,139,2,191,50,90,49
27,"MEHEDINŢI","#N/A",111006,,133,"BUTOIEŞTI / Primăria Butoieşti",3,10468,"BUTOIEŞTI",111006,850,550,434,108,8,549,1,899,349,341,208
27,"MEHEDINŢI","#N/A",111006,,134,"ARGINEŞTI / Scoala Generală I-IV Argineşti",3,10468,"BUTOIEŞTI",111006,468,314,268,42,4,311,3,500,186,198,113
27,"MEHEDINŢI","#N/A",111006,,135,"GURA MOTRULUI / Scoala Generală I-IV Gura Motrului",3,10468,"BUTOIEŞTI",111006,248,198,152,46,0,198,0,300,102,101,97
27,"MEHEDINŢI","#N/A",111006,,136,"BUICEŞTI / Scoala Generală I-IV  Buiceşti",3,10468,"BUTOIEŞTI",111006,371,270,212,50,8,266,4,400,130,135,131
27,"MEHEDINŢI","#N/A",111006,,137,"PLUTA / Scoala Generală I-IV Pluta",3,10468,"BUTOIEŞTI",111006,348,275,214,48,13,268,7,401,126,192,76
27,"MEHEDINŢI","#N/A",111006,,138,"TÎNŢARU / Scoala Generală I-IV Ţînţaru",3,10468,"BUTOIEŞTI",111006,281,204,167,33,4,204,0,300,96,155,49
27,"MEHEDINŢI","#N/A",111097,,139,"CĂZĂNEŞTI / Scoala Generală I-IV Căzăneşti",3,10477,"CĂZĂNEŞTI",111097,764,597,457,140,0,595,2,800,203,377,218
27,"MEHEDINŢI","#N/A",111097,,140,"SEVERINEŞTI / Scoala Generală I-IV Severineşti",3,10477,"CĂZĂNEŞTI",111097,983,774,613,161,0,762,12,1000,226,435,327
27,"MEHEDINŢI","#N/A",111220,,141,"CIREŞU / Căminul Cultural Cireşu",3,10490,"CIREŞU",111220,428,357,255,90,12,352,5,500,143,250,102
27,"MEHEDINŢI","#N/A",111275,,142,"CORCOVA / Căminul Cultural Corcova",3,10495,"CORCOVA",111275,1298,848,746,79,23,843,5,1400,552,561,282
27,"MEHEDINŢI","#N/A",111275,,143,"IMOASA / Scoala Generală Imoasa",3,10495,"CORCOVA",111275,306,237,215,22,0,236,1,400,163,176,60
27,"MEHEDINŢI","#N/A",111275,,144,"CORDUN / Scoala Generală Cordun",3,10495,"CORCOVA",111275,568,311,283,22,6,310,1,600,289,204,106
27,"MEHEDINŢI","#N/A",111275,,145,"STEJARU / Scoala Generală I-IV Stejaru",3,10495,"CORCOVA",111275,400,223,204,16,3,220,3,500,277,169,51
27,"MEHEDINŢI","#N/A",111275,,146,"JIROV / Caminul Cultural Jirov",3,10495,"CORCOVA",111275,1198,626,577,49,0,619,7,1300,674,338,281
27,"MEHEDINŢI","#N/A",111275,,147,"MĂRU ROŞU / Scoala Generală Măru Roşu",3,10495,"CORCOVA",111275,489,305,275,29,1,304,1,600,295,222,82
27,"MEHEDINŢI","#N/A",111275,,148,"CERNAIA / Scoala Generală Cernaia",3,10495,"CORCOVA",111275,443,276,236,40,0,274,2,500,224,176,98
27,"MEHEDINŢI","#N/A",111417,,149,"CORLĂŢEL / Scoala Generală I-VIII Corlăţel",3,10509,"CORLĂŢEL",111417,628,575,441,110,24,568,7,697,122,454,114
27,"MEHEDINŢI","#N/A",111417,,150,"VALEA ANILOR / Scoala Generală I-IV Valea Anilor",3,10509,"CORLĂŢEL",111417,466,314,259,47,8,312,2,500,186,254,58
27,"MEHEDINŢI","#N/A",111444,,151,"CUJMIR / Căminul cultural",3,10512,"CUJMIR",111444,962,663,545,82,36,659,4,1000,337,443,216
27,"MEHEDINŢI","#N/A",111444,,152,"CUJMIR / Căminul cultural",3,10512,"CUJMIR",111444,925,621,526,91,4,615,6,1000,379,446,169
27,"MEHEDINŢI","#N/A",111444,,153,"AURORA / Şcoala generală Aurora",3,10512,"CUJMIR",111444,575,331,293,38,0,327,4,699,368,213,114
27,"MEHEDINŢI","#N/A",111444,,154,"CUJMIRU MIC / Grădiniţa Cujmiru Mic",3,10512,"CUJMIR",111444,400,303,257,46,0,297,6,495,192,167,130
27,"MEHEDINŢI","#N/A",111480,,155,"DEVESEL / Căminul Cultural Devesel",3,10516,"DEVESEL",111480,994,858,615,243,0,849,9,1100,242,396,453
27,"MEHEDINŢI","#N/A",111480,,156,"BATOŢI / Şcoala Generală Batoţi",3,10516,"DEVESEL",111480,361,373,199,174,0,370,3,400,27,205,165
27,"MEHEDINŢI","#N/A",111480,,157,"BISTREŢU / Şcoala Generală Bistreţu",3,10516,"DEVESEL",111480,413,349,241,106,2,345,4,500,151,173,172
27,"MEHEDINŢI","#N/A",111480,,158,"SCĂPĂU / Şcoala Generală Scăpău",3,10516,"DEVESEL",111480,632,455,308,146,1,449,6,699,244,263,186
27,"MEHEDINŢI","#N/A",111550,,159,"DÎRVARI / Căminul Cultural Nou-Dîrvari",3,10523,"DÎRVARI",111550,1230,736,652,84,0,728,8,1300,564,524,204
27,"MEHEDINŢI","#N/A",111550,,160,"GEMENI / Căminul Cultural Vechi-Gemeni",3,10523,"DÎRVARI",111550,933,585,528,57,0,573,12,1000,415,466,107
27,"MEHEDINŢI","#N/A",112904,,161,"DUBOVA / Primăria Dubova",3,10526,"DUBOVA",112904,410,351,243,99,9,346,5,499,148,147,199
27,"MEHEDINŢI","#N/A",112904,,162,"EIBENTHAL / Fosta Primărie Eibenthal",3,10526,"DUBOVA",112904,257,171,133,24,14,167,4,300,129,116,51
27,"MEHEDINŢI","#N/A",112904,,163,"BAIA NOUĂ / Fosta Şcoală Baia Nouă",3,10526,"DUBOVA",112904,147,82,65,13,4,82,0,201,119,62,20
27,"MEHEDINŢI","#N/A",111587,,164,"DUMBRAVA DE JOS / CĂMINUL CULTURAL DUMBRAVA DE JOS",3,10530,"DUMBRAVA",111587,416,293,216,77,0,287,6,500,207,157,130
27,"MEHEDINŢI","#N/A",111587,,165,"ALBULEŞTI / ŞCOALA GENERALĂ ALBULEŞTI",3,10530,"DUMBRAVA",111587,489,318,262,48,8,316,2,600,282,158,158
27,"MEHEDINŢI","#N/A",111587,,166,"VALEA MARCULUI / CLĂDIRE FOSTA ŞCOALĂ VALEA MARCULUI",3,10530,"DUMBRAVA",111587,102,102,62,37,3,102,0,199,97,76,26
27,"MEHEDINŢI","#N/A",111587,,167,"ROCŞORENI / CĂMINUL CULTURAL ROCŞORENI",3,10530,"DUMBRAVA",111587,103,84,55,28,1,83,1,202,118,57,26
27,"MEHEDINŢI","#N/A",111587,,168,"VLĂDICA / CLĂDIRE FOSTĂ ŞCOALĂ VLĂDICA",3,10530,"DUMBRAVA",111587,60,86,48,38,0,86,0,100,14,69,17
27,"MEHEDINŢI","#N/A",112245,,169,"EŞELNIŢA / Gradinita Eselnita",3,10542,"EŞELNIŢA",112245,1145,766,652,114,0,757,9,1200,434,445,312
27,"MEHEDINŢI","#N/A",112245,,170,"EŞELNIŢA / Gradinita Eselnita",3,10542,"EŞELNIŢA",112245,1243,816,713,102,1,805,11,1300,484,469,336
27,"MEHEDINŢI","#N/A",111685,,171,"FLOREŞTI / Şcoala generală I-VIII Floreşti",3,10544,"FLOREŞTI",111685,1404,932,826,91,15,925,7,1500,568,635,290
27,"MEHEDINŢI","#N/A",111685,,172,"ZEGUJANI / Şcoala generală I-VIII Zegujani",3,10544,"FLOREŞTI",111685,796,653,512,121,20,649,4,900,247,532,117
27,"MEHEDINŢI","#N/A",111783,,173,"GÂRLA MARE / Căminul Cultural Gîrla Mare",3,10554,"GÂRLA MARE",111783,1504,745,558,120,67,738,7,1599,854,526,212
27,"MEHEDINŢI","#N/A",111783,,174,"GÂRLA MARE / Căminul Cultural Gîrla Mare",3,10554,"GÂRLA MARE",111783,1093,648,461,152,35,635,13,1199,551,415,220
27,"MEHEDINŢI","#N/A",111818,,175,"GODEANU / Primăria Godeanu",3,10556,"GODEANU",111818,515,495,312,183,0,490,5,600,105,354,136
27,"MEHEDINŢI","#N/A",111863,,176,"GOGOŞU / scoala generala clasele I-VIII GOGOŞU",3,10561,"GOGOŞU",111863,918,778,544,204,30,769,9,1000,222,613,156
27,"MEHEDINŢI","#N/A",111863,,177,"BALTA VERDE / Şcoala generală I-VIII Balta Verde",3,10561,"GOGOŞU",111863,984,642,537,84,21,626,16,1099,457,536,90
27,"MEHEDINŢI","#N/A",111863,,178,"BURILA MICĂ / Şcoala generală Burila Mică",3,10561,"GOGOŞU",111863,713,450,345,87,18,444,6,800,350,405,39
27,"MEHEDINŢI","#N/A",111863,,179,"OSTROVU MARE / Şcoala generală I-IV Ostrovu Mare",3,10561,"GOGOŞU",111863,449,373,218,146,9,370,3,500,127,225,145
27,"MEHEDINŢI","#N/A",111863,,180,"OSTROVU MARE / Grădiniţa P.T. II",3,10561,"GOGOŞU",111863,92,455,52,403,0,452,3,550,95,213,239
27,"MEHEDINŢI","#N/A",111916,,181,"GRECI / Căminul Cultural Greci",3,10566,"GRECI",111916,532,423,317,77,29,417,6,599,176,296,121
27,"MEHEDINŢI","#N/A",111916,,182,"BÎLTANELE / Şcoala generală Bîltanele",3,10566,"GRECI",111916,322,233,171,54,8,233,0,387,154,151,82
27,"MEHEDINŢI","#N/A",111916,,183,"SĂLĂTRUC / Şcoala Generală Sălătruc",3,10566,"GRECI",111916,178,177,113,59,5,174,3,200,23,129,45
27,"MEHEDINŢI","#N/A",111989,,184,"GROZEŞTI / Şcoala Generală I-VIII Grozeşti",3,10573,"GROZEŞTI",111989,388,247,223,24,0,242,5,500,253,159,83
27,"MEHEDINŢI","#N/A",111989,,185,"CÎRCENI / Şcoala Generală I-IV Cîrceni",3,10573,"GROZEŞTI",111989,774,364,332,32,0,363,1,800,436,241,122
27,"MEHEDINŢI","#N/A",111989,,186,"ŞUŞIŢA / Şcoala Generală I-IV Şuşiţa",3,10573,"GROZEŞTI",111989,434,272,210,61,1,270,2,500,228,183,87
27,"MEHEDINŢI","#N/A",112030,,187,"GRUIA / Cămin Cultural Gruia",3,10578,"GRUIA",112030,767,423,376,47,0,420,3,900,477,303,117
27,"MEHEDINŢI","#N/A",112030,,188,"GRUIA / Stadion Comunal Gruia",3,10578,"GRUIA",112030,679,368,349,19,0,361,7,800,432,329,32
27,"MEHEDINŢI","#N/A",112030,,189,"IZVOARELE / Şcoala generală Izvoarele",3,10578,"GRUIA",112030,750,480,383,97,0,474,6,800,320,290,184
27,"MEHEDINŢI","#N/A",112030,,190,"POIANA GRUII / Şcoala Poiana Gruii",3,10578,"GRUIA",112030,148,130,103,27,0,130,0,210,80,109,21
27,"MEHEDINŢI","#N/A",112076,,191,"HINOVA / Şcoala generală I-VIII Hinova",3,10582,"HINOVA",112076,850,506,420,86,0,498,8,900,394,377,121
27,"MEHEDINŢI","#N/A",112076,,192,"BISTRIŢA / Şcoala Generală I-VIII Bistriţa",3,10582,"HINOVA",112076,1102,694,615,79,0,683,11,1194,500,435,248
27,"MEHEDINŢI","#N/A",112076,,193,"OSTROVU CORBULUI / Şcoala generală I-IV Ostrovu Corbului",3,10582,"HINOVA",112076,327,241,164,77,0,236,5,400,159,133,103
27,"MEHEDINŢI","#N/A",112129,,194,"HUSNICIOARA / Scoala Gimnaziala Husnicioara",3,10587,"HUSNICIOARA",112129,603,397,282,115,0,395,2,700,303,300,95
27,"MEHEDINŢI","#N/A",112129,,195,"PERI / Căminul Cultural Peri",3,10587,"HUSNICIOARA",112129,334,259,171,88,0,257,2,400,141,170,87
27,"MEHEDINŢI","#N/A",112129,,196,"BĂDIŢEŞTI / Şcoala Generală Bădiţeşti",3,10587,"HUSNICIOARA",112129,163,132,99,33,0,131,1,200,68,93,38
27,"MEHEDINŢI","#N/A",112263,,197,"ILOVĂŢ / Dispensar uman Ilovăţ",3,10599,"ILOVĂŢ",112263,1033,645,511,130,4,639,6,1100,455,452,187
27,"MEHEDINŢI","#N/A",112334,,198,"ILOVIŢA / Scoala Generală Iloviţa",3,10606,"ILOVIŢA",112334,694,559,469,78,12,551,8,799,240,378,173
27,"MEHEDINŢI","#N/A",112334,,199,"BAHNA / Căminul Cultural Bahna",3,10606,"ILOVIŢA",112334,422,293,242,33,18,289,4,499,206,185,104
27,"MEHEDINŢI","#N/A",112370,,200,"ISVERNA / Cămin Cultural Isverna",3,10610,"ISVERNA",112370,1309,750,670,79,1,742,8,1397,647,458,284
27,"MEHEDINŢI","#N/A",112370,,201,"NADANOVA / Scoala Generală Nadanova",3,10610,"ISVERNA",112370,314,172,147,24,1,172,0,400,228,133,39
27,"MEHEDINŢI","#N/A",112370,,202,"BUSEŞTI / Cămin Cultural Buseşti",3,10610,"ISVERNA",112370,154,134,94,40,0,132,2,200,66,104,28
27,"MEHEDINŢI","#N/A",112469,,203,"IZVORU BÎRZII / Căminul Cultural Izvorul Birzii",3,10619,"IZVORU BÎRZII",112469,1111,778,674,104,0,767,11,1203,425,425,342
27,"MEHEDINŢI","#N/A",112469,,204,"BALOTEŞTI / Scoala Generală I-IV Baloteşti",3,10619,"IZVORU BÎRZII",112469,497,316,227,88,1,312,4,597,281,162,150
27,"MEHEDINŢI","#N/A",112469,,205,"HALÎNGA / Scoala Generală I-VIII Halânga",3,10619,"IZVORU BÎRZII",112469,731,582,406,176,0,570,12,799,217,284,286
27,"MEHEDINŢI","#N/A",112548,,206,"JIANA / Scoala Generală I-VIII Jiana",3,10627,"JIANA",112548,586,634,536,70,28,626,8,700,66,595,31
27,"MEHEDINŢI","#N/A",112548,,207,"JIANA MARE / Scoala Generală I-IV Jiana Mare",3,10627,"JIANA",112548,618,544,426,87,31,543,1,700,156,439,104
27,"MEHEDINŢI","#N/A",112548,,208,"JIANA VECHE / Scoala Generală I-VIII Jiana Veche",3,10627,"JIANA",112548,834,506,428,59,19,506,0,900,394,403,103
27,"MEHEDINŢI","#N/A",112548,,209,"DĂNCEU / Căminul Cultural Dănceu",3,10627,"JIANA",112548,977,731,548,143,40,723,8,1100,369,618,105
27,"MEHEDINŢI","#N/A",112548,,210,"CIOROBORENI / Căminul Cultural Cioroboreni",3,10627,"JIANA",112548,559,531,379,124,28,530,1,600,69,432,98
27,"MEHEDINŢI","#N/A",112600,,211,"LIVEZILE / Căminul Cultural Livezile",3,10633,"LIVEZILE",112600,709,643,449,177,17,635,8,799,156,449,186
27,"MEHEDINŢI","#N/A",112600,,212,"IZVORU ANEŞTILOR / Scoala primara Izvorul Aneştilor",3,10633,"LIVEZILE",112600,395,330,224,103,3,328,2,500,170,257,71
27,"MEHEDINŢI","#N/A",112600,,213,"IZVORĂLU DE JOS / Scoala Primară Izvorălul de Jos",3,10633,"LIVEZILE",112600,162,149,103,44,2,149,0,200,51,128,21
27,"MEHEDINŢI","#N/A",112664,,214,"MALOVĂŢ / Căminul Cultural Malovăţ",3,10639,"MALOVĂŢ",112664,1019,879,644,235,0,866,13,1100,221,591,275
27,"MEHEDINŢI","#N/A",112664,,215,"23 August / Scoala Generală I-IV 23 August",3,10639,"MALOVĂŢ",112664,699,479,382,97,0,476,3,800,321,276,200
27,"MEHEDINŢI","#N/A",112664,,216,"BOBAIŢA / Căminul Cultural Bobaiţa",3,10639,"MALOVĂŢ",112664,488,422,299,123,0,418,4,599,177,290,128
27,"MEHEDINŢI","#N/A",112744,,217,"OBÎRŞIA DE CÎMP / Căminul Cultural Obârşia de Câmp",3,10647,"OBÎRŞIA DE CÎMP",112744,681,561,415,114,32,558,3,800,239,406,152
27,"MEHEDINŢI","#N/A",112744,,218,"IZIMŞA / Căminul Cultural Izimşa",3,10647,"OBÎRŞIA DE CÎMP",112744,893,714,524,148,42,709,5,1000,286,531,178
27,"MEHEDINŢI","#N/A",110027,,219,"OBÎRŞIA-CLOŞANI / Scoala Generală I-VIII Obârşia Closani",3,10650,"OBÎRŞIA-CLOŞANI",110027,852,557,441,116,0,557,0,900,343,303,254
27,"MEHEDINŢI","#N/A",112771,,220,"OPRIŞOR / Caminul Cultural Oprisor",3,10653,"OPRIŞOR",112771,838,655,508,109,38,644,11,900,245,375,269
27,"MEHEDINŢI","#N/A",112771,,221,"OPRIŞOR / Scoala Generală I-VIII Oprisor",3,10653,"OPRIŞOR",112771,822,576,477,77,22,568,8,900,324,335,233
27,"MEHEDINŢI","#N/A",112771,,222,"PRISĂCEAUA / Scoala Generală Prisăceaua",3,10653,"OPRIŞOR",112771,355,249,203,46,0,248,1,400,151,192,56
27,"MEHEDINŢI","#N/A",112806,,223,"PĂDINA MARE / Căminul Cultural Pădina Mare",3,10656,"PĂDINA",112806,212,215,127,80,8,214,1,300,85,172,42
27,"MEHEDINŢI","#N/A",112806,,224,"PĂDINA MICĂ / Scoala Generală Pădina Mică",3,10656,"PĂDINA",112806,232,179,133,44,2,175,4,300,121,115,60
27,"MEHEDINŢI","#N/A",112806,,225,"IABLANIŢA / Scoala Generală Iablaniţa",3,10656,"PĂDINA",112806,213,205,140,54,11,204,1,299,94,163,41
27,"MEHEDINŢI","#N/A",112806,,226,"SLAŞOMA / Căminul Cultural Slasoma",3,10656,"PĂDINA",112806,453,377,269,90,18,375,2,500,123,306,69
27,"MEHEDINŢI","#N/A",112879,,227,"PĂTULELE / Căminul Cultural Pătulele",3,10663,"PĂTULELE",112879,1279,1028,857,131,40,1020,8,1398,370,679,341
27,"MEHEDINŢI","#N/A",112879,,228,"PĂTULELE / Scoala Generală I-IV Pătulele",3,10663,"PĂTULELE",112879,1102,861,732,96,33,856,5,1199,338,567,289
27,"MEHEDINŢI","#N/A",112879,,229,"PĂTULELE / Grădiniţa nr. 3 Rudărie",3,10663,"PĂTULELE",112879,354,156,145,10,1,155,1,400,244,129,26
27,"MEHEDINŢI","#N/A",112879,,230,"VIAŞU / Căminul Cultural Viaşu",3,10663,"PĂTULELE",112879,438,362,286,72,4,359,3,498,136,300,59
27,"MEHEDINŢI","#N/A",112959,,231,"PODENI / Căminul Cultural Podeni",3,10666,"PODENI",112959,604,459,378,81,0,456,3,700,241,311,145
27,"MEHEDINŢI","#N/A",112959,,232,"GORNENŢI / Căminul Cultural Gornenţi",3,10666,"PODENI",112959,144,136,92,44,0,132,4,199,63,101,31
27,"MEHEDINŢI","#N/A",112995,,233,"PONOARELE / Căminul Cultural Ponoarele",3,10670,"PONOARELE",112995,871,614,528,86,0,606,8,1000,386,403,203
27,"MEHEDINŢI","#N/A",112995,,234,"GHEORGHEŞTI / Căminul Cultural Ghiorgheşti",3,10670,"PONOARELE",112995,527,372,322,49,1,367,5,600,228,256,111
27,"MEHEDINŢI","#N/A",112995,,235,"GĂRDĂNEASA / Scoala Generală I-IV Gărdăneasa",3,10670,"PONOARELE",112995,401,290,241,49,0,287,3,500,210,204,83
27,"MEHEDINŢI","#N/A",112995,,236,"BÎRÎIACU / Căminul Cultural Bîrîiacu",3,10670,"PONOARELE",112995,241,185,120,63,2,183,2,303,118,111,72
27,"MEHEDINŢI","#N/A",113153,,237,"POROINA MARE / Scoala Generală Poroina Mare",3,10686,"POROINA MARE",113153,355,308,206,75,27,308,0,400,92,231,77
27,"MEHEDINŢI","#N/A",113153,,238,"STIGNIŢA / Scoala Generală I-IV Stigniţa",3,10686,"POROINA MARE",113153,352,308,216,64,28,303,5,400,92,260,43
27,"MEHEDINŢI","#N/A",113153,,239,"FÎNTÎNILE NEGRE / Scoala Generală Fîntânile Negre",3,10686,"POROINA MARE",113153,150,132,86,41,5,131,1,200,68,86,45
27,"MEHEDINŢI","#N/A",113206,,240,"PRISTOL / Căminul Cultural Pristol",3,10691,"PRISTOL",113206,870,605,419,161,25,600,5,1000,395,376,224
27,"MEHEDINŢI","#N/A",113206,,241,"COZIA / Şcoala Generală Cozia",3,10691,"PRISTOL",113206,458,323,242,72,9,317,6,499,176,196,121
27,"MEHEDINŢI","#N/A",113233,,242,"PRUNIŞOR / Şcoala Generală Prunişor",3,10694,"PRUNIŞOR",113233,422,335,263,64,8,334,1,500,165,243,91
27,"MEHEDINŢI","#N/A",113233,,243,"FÎNTÎNA DOMNEASCĂ / Căminul Cultural Fîntîna Domnească",3,10694,"PRUNIŞOR",113233,319,232,163,50,19,229,3,400,168,148,81
27,"MEHEDINŢI","#N/A",113233,,244,"CERVENIŢA / Căminul Cultural Cerveniţa",3,10694,"PRUNIŞOR",113233,326,266,175,82,9,264,2,400,134,199,65
27,"MEHEDINŢI","#N/A",113233,,245,"GHELMEGIOAIA / Şcoala Generală Ghelmegioaia",3,10694,"PRUNIŞOR",113233,315,264,176,75,13,264,0,400,136,196,68
27,"MEHEDINŢI","#N/A",113233,,246,"ZEGAIA / Şcoala Generală Zegaia",3,10694,"PRUNIŞOR",113233,230,188,117,71,0,187,1,300,112,122,65
27,"MEHEDINŢI","#N/A",113395,,247,"PUNGHINA / Căminul Cultural Punghina",3,10710,"PUNGHINA",113395,1035,502,451,51,0,496,6,1100,598,397,99
27,"MEHEDINŢI","#N/A",113395,,248,"RECEA / Şcoala I-IV Recea",3,10710,"PUNGHINA",113395,797,360,337,23,0,357,3,900,540,300,57
27,"MEHEDINŢI","#N/A",113395,,249,"CEARÎNGU / Căminul Cultural Cearîng",3,10710,"PUNGHINA",113395,137,137,97,40,0,136,1,200,63,100,36
27,"MEHEDINŢI","#N/A",113395,,250,"DRINCEA / Căminul Cultural Drincea",3,10710,"PUNGHINA",113395,303,259,204,55,0,258,1,400,141,170,88
27,"MEHEDINŢI","#N/A",113466,,251,"ROGOVA / Şcoala Generală I-VIII Rogova",3,10717,"ROGOVA",113466,1124,1039,722,277,40,1024,15,1200,161,694,330
27,"MEHEDINŢI","#N/A",113493,,252,"SALCIA / Şcoala generală V-VIII Salcia",3,10720,"SALCIA",113493,1192,808,677,98,33,791,17,1300,492,502,289
27,"MEHEDINŢI","#N/A",113493,,253,"SALCIA / Şcoala generală V-VIII Salcia",3,10720,"SALCIA",113493,1308,850,725,89,36,844,6,1399,549,557,287
27,"MEHEDINŢI","#N/A",113518,,254,"STÎNGĂCEAUA / Şcoala Generală Stîngăceaua",3,10742,"STÎNGĂCEAUA",113518,755,550,472,72,6,548,2,800,250,387,161
27,"MEHEDINŢI","#N/A",113518,,255,"SATU MARE / Şcoala Generală Satu Mare",3,10742,"STÎNGĂCEAUA",113518,364,271,230,38,3,268,3,400,129,195,73
27,"MEHEDINŢI","#N/A",113607,,256,"SVINIŢA / Primăria Sviniţa",3,10751,"SVINIŢA",113607,862,653,534,77,42,650,3,1000,347,437,213
27,"MEHEDINŢI","#N/A",109826,,257,"ŞIMIAN / Şcoala Generală I-VIII Şimian",3,10722,"ŞIMIAN",109826,1671,1104,907,197,0,1088,16,1800,696,709,379
27,"MEHEDINŢI","#N/A",109826,,258,"ŞIMIAN / Şcoala Generală I-VIII Şimian",3,10722,"ŞIMIAN",109826,1724,1200,915,280,5,1181,19,1800,600,760,421
27,"MEHEDINŢI","#N/A",109826,,259,"CERNEŢI / Şcoala Generală I-VIII Cerneţi",3,10722,"ŞIMIAN",109826,1431,842,796,44,2,835,7,1500,658,584,251
27,"MEHEDINŢI","#N/A",109826,,260,"CERNEŢI / Şcoala Generală I-VIII Cerneţi",3,10722,"ŞIMIAN",109826,1405,943,848,93,2,911,32,1500,557,649,262
27,"MEHEDINŢI","#N/A",109826,,261,"DUDAŞU / Şcoala Generală I-IV Dudaşu",3,10722,"ŞIMIAN",109826,1020,592,504,88,0,548,44,1099,507,412,136
27,"MEHEDINŢI","#N/A",109826,,262,"DEDOVIŢA NOUĂ / Şcoala Generală I-IV Dedoviţa Nouă",3,10722,"ŞIMIAN",109826,313,250,211,39,0,248,2,400,150,170,78
27,"MEHEDINŢI","#N/A",109826,,263,"POROINA / Şcoala Generală I-IV Poroina",3,10722,"ŞIMIAN",109826,256,203,161,42,0,200,3,300,97,135,65
27,"MEHEDINŢI","#N/A",109826,,264,"ERGHEVIŢA / Clădire Consumcoop Ergheviţa",3,10722,"ŞIMIAN",109826,256,174,131,43,0,172,2,303,129,120,52
27,"MEHEDINŢI","#N/A",109826,,265,"VALEA COPCII / Şcoala Generală Valea Copcii",3,10722,"ŞIMIAN",109826,104,96,60,36,0,95,1,200,104,69,26
27,"MEHEDINŢI","#N/A",113625,,266,"ŞIŞEŞTI / Căminul Cultural Şişeşti",3,10731,"ŞIŞEŞTI",113625,975,772,601,171,0,763,9,1000,228,532,231
27,"MEHEDINŢI","#N/A",113625,,267,"COCOROVA / Şcoala Generală I-IV Cocorova",3,10731,"ŞIŞEŞTI",113625,599,496,368,128,0,488,8,700,204,355,133
27,"MEHEDINŢI","#N/A",113625,,268,"NOAPTEŞA / Căminul Cultural Noapteşa",3,10731,"ŞIŞEŞTI",113625,602,437,399,35,3,433,4,700,263,359,74
27,"MEHEDINŢI","#N/A",113698,,269,"ŞOVARNA / Primăria Şovarna",3,10738,"ŞOVARNA",113698,982,783,622,161,0,778,5,1100,317,608,170
27,"MEHEDINŢI","#N/A",113732,,270,"TÎMNA / Primăria Tîmna",3,10753,"TÎMNA",113732,937,440,339,101,0,433,7,1000,560,303,130
27,"MEHEDINŢI","#N/A",113732,,271,"TÎMNA / Şcoala Generală Tîmna",3,10753,"TÎMNA",113732,579,353,294,59,0,349,4,700,347,229,120
27,"MEHEDINŢI","#N/A",113732,,272,"IZVORĂLU / Cămin Cultural Izvorălu",3,10753,"TÎMNA",113732,298,218,173,45,0,216,2,399,181,139,77
27,"MEHEDINŢI","#N/A",113732,,273,"PLOPI / Şcoala Generală Plopi",3,10753,"TÎMNA",113732,466,311,242,69,0,305,6,500,189,187,118
27,"MEHEDINŢI","#N/A",113732,,274,"CREMENEA / Şcoala Cremenea",3,10753,"TÎMNA",113732,175,117,78,39,0,117,0,200,83,65,52
27,"MEHEDINŢI","#N/A",113849,,275,"VÂNĂTORI / Şcoala Generală I-VIII Vînători",3,10765,"VÂNĂTORI",113849,908,603,477,110,16,600,3,1000,397,406,194
27,"MEHEDINŢI","#N/A",113849,,276,"ROŞIORI / Şcoala Generală I-IV Roşiori",3,10765,"VÂNĂTORI",113849,746,571,460,105,6,566,5,800,229,384,182
27,"MEHEDINŢI","#N/A",113894,,277,"VÎNJULEŢ / Cămin Cultural Vînjuleţ",3,10768,"VÎNJULEŢ",113894,1397,1350,720,224,406,1342,8,1900,550,1245,97
27,"MEHEDINŢI","#N/A",113929,,278,"VLĂDAIA / Şcoala I-VIII Preda Buzescu, Vlădaia",3,10771,"VLĂDAIA",113929,443,423,275,132,16,419,4,496,73,302,117
27,"MEHEDINŢI","#N/A",113929,,279,"ALMĂJEL / Şcoala Generală I-IV Almăjel",3,10771,"VLĂDAIA",113929,561,575,314,261,0,569,6,600,25,461,108
27,"MEHEDINŢI","#N/A",113929,,280,"SCORILA / Şcoala Generală I-IV Scorila",3,10771,"VLĂDAIA",113929,178,125,97,28,0,123,2,200,75,57,66
27,"MEHEDINŢI","#N/A",113929,,281,"ŞTIRCOVIŢA / Şcoala Generală I-IV Ştircoviţa",3,10771,"VLĂDAIA",113929,180,179,120,59,0,178,1,200,21,133,45
27,"MEHEDINŢI","#N/A",113974,,282,"VOLOIAC / Şcoala Generală I-VIII Voloiac",3,10776,"VOLOIAC",113974,510,421,333,60,28,421,0,599,178,308,113
27,"MEHEDINŢI","#N/A",113974,,283,"COTOROAIA / Şcoala Generală I-IV Cotoroaia",3,10776,"VOLOIAC",113974,455,301,242,51,8,297,4,499,198,239,58
27,"MEHEDINŢI","#N/A",113974,,284,"LAC / Fosta Şcoală Generală I-IV Lac",3,10776,"VOLOIAC",113974,103,105,70,30,5,103,2,200,95,80,23
27,"MEHEDINŢI","#N/A",113974,,285,"VALEA BUNĂ / Şcoala Generală I-IV Valea Bună",3,10776,"VOLOIAC",113974,307,227,172,41,14,225,2,401,174,156,69
27,"MEHEDINŢI","#N/A",114079,,286,"VRATA / Căminul Cultural Vrata",3,10785,"VRATA",114079,1472,916,757,94,65,908,8,1600,684,709,199
28,"MUREŞ","#N/A",114319,,1,"TÎRGU MUREŞ / Casa ""Apollo"" (Şcoala de Arte)",1,10788,"MUNICIPIUL TÎRGU MUREŞ",114319,1350,904,721,181,2,895,9,1500,596,230,665
28,"MUREŞ","#N/A",114319,,2,"TÎRGU MUREŞ / Universitatea ""Petru Maior""",1,10788,"MUNICIPIUL TÎRGU MUREŞ",114319,1665,1041,889,86,66,1015,26,1800,759,256,759
28,"MUREŞ","#N/A",114319,,3,"TÎRGU MUREŞ / Liceul teoretic ""Bolyai Farkas"",",1,10788,"MUNICIPIUL TÎRGU MUREŞ",114319,1451,1093,794,228,71,1073,20,1550,457,278,795
28,"MUREŞ","#N/A",114319,,4,"TÎRGU MUREŞ / Internat Liceul Tehnologic ""Avram Iancu""",1,10788,"MUNICIPIUL TÎRGU MUREŞ",114319,1332,787,727,59,1,773,14,1450,663,244,529
28,"MUREŞ","#N/A",114319,,5,"TÎRGU MUREŞ / Şcoala Gimnazială ""Nicolae Bălcescu""",1,10788,"MUNICIPIUL TÎRGU MUREŞ",114319,1681,927,896,29,2,905,22,1800,873,246,659
28,"MUREŞ","#N/A",114319,,6,"TÎRGU MUREŞ / Şcoala Gimnazială ""Nicolae Bălcescu""",1,10788,"MUNICIPIUL TÎRGU MUREŞ",114319,1290,687,633,54,0,682,5,1394,707,212,470
28,"MUREŞ","#N/A",114319,,7,"TÎRGU MUREŞ / Şcoala Gimnazială ""Nicolae Bălcescu""",1,10788,"MUNICIPIUL TÎRGU MUREŞ",114319,1386,784,741,43,0,765,19,1500,716,234,531
28,"MUREŞ","#N/A",114319,,8,"TÎRGU MUREŞ / Şcoala Gimnazială ""Nicolae Bălcescu""",1,10788,"MUNICIPIUL TÎRGU MUREŞ",114319,1312,795,741,54,0,783,12,1400,605,178,605
28,"MUREŞ","#N/A",114319,,9,"TÎRGU MUREŞ / Şcoala Gimnazială ""Nicolae Bălcescu""",1,10788,"MUNICIPIUL TÎRGU MUREŞ",114319,1679,979,921,57,1,966,13,1800,821,218,748
28,"MUREŞ","#N/A",114319,,10,"TÎRGU MUREŞ / Liceul Tehnologic ""Aurel Perşu""",1,10788,"MUNICIPIUL TÎRGU MUREŞ",114319,1307,673,630,43,0,662,11,1400,727,185,477
28,"MUREŞ","#N/A",114319,,11,"TÎRGU MUREŞ / Liceul Tehnologic ""Aurel Perşu""",1,10788,"MUNICIPIUL TÎRGU MUREŞ",114319,1249,776,749,27,0,760,16,1350,574,203,557
28,"MUREŞ","#N/A",114319,,12,"TÎRGU MUREŞ / Primăria municipiului Tg.Mureş",1,10788,"MUNICIPIUL TÎRGU MUREŞ",114319,1481,1077,732,345,0,1053,24,1600,523,254,799
28,"MUREŞ","#N/A",114319,,13,"TÎRGU MUREŞ / Colegiul agricol ""Traian Savulescu""",1,10788,"MUNICIPIUL TÎRGU MUREŞ",114319,1609,1036,904,130,2,1022,14,1750,714,276,746
28,"MUREŞ","#N/A",114319,,14,"TÎRGU MUREŞ / Şcoala Gimnazială ""Al.I.Cuza""",1,10788,"MUNICIPIUL TÎRGU MUREŞ",114319,1607,1006,972,34,0,993,13,1700,694,289,704
28,"MUREŞ","#N/A",114319,,15,"TÎRGU MUREŞ / Şcoala Gimnazială ""Al.I.Cuza""",1,10788,"MUNICIPIUL TÎRGU MUREŞ",114319,1621,1024,967,56,1,1006,18,1750,726,265,741
28,"MUREŞ","#N/A",114319,,16,"TÎRGU MUREŞ / Şcoala Gimnazială ""Al.I.Cuza""",1,10788,"MUNICIPIUL TÎRGU MUREŞ",114319,1684,1048,1000,47,1,1030,18,1800,752,325,705
28,"MUREŞ","#N/A",114319,,17,"TÎRGU MUREŞ / Şcoala Gimnazială""Al.I.Cuza""",1,10788,"MUNICIPIUL TÎRGU MUREŞ",114319,1679,1027,976,51,0,1019,8,1800,773,268,751
28,"MUREŞ","#N/A",114319,,18,"TÎRGU MUREŞ / Şcoala Gimnazială""Al.I.Cuza""",1,10788,"MUNICIPIUL TÎRGU MUREŞ",114319,1623,943,880,63,0,934,9,1750,807,238,696
28,"MUREŞ","#N/A",114319,,19,"TÎRGU MUREŞ / Şcoala Gimnazială""Al.I.Cuza""",1,10788,"MUNICIPIUL TÎRGU MUREŞ",114319,1708,1094,1030,63,1,1084,10,1850,756,285,799
28,"MUREŞ","#N/A",114319,,20,"TÎRGU MUREŞ / Şcoala Gen. Nr. 19 Beşa",1,10788,"MUNICIPIUL TÎRGU MUREŞ",114319,736,433,415,18,0,423,10,800,367,109,314
28,"MUREŞ","#N/A",114319,,21,"TÎRGU MUREŞ / Şcoala Gimnazială ""Friederich Schiller""",1,10788,"MUNICIPIUL TÎRGU MUREŞ",114319,1331,756,687,66,3,740,16,1450,694,198,542
28,"MUREŞ","#N/A",114319,,22,"TÎRGU MUREŞ / Şcoala Gimnazială ""Friederich Schiller""",1,10788,"MUNICIPIUL TÎRGU MUREŞ",114319,1314,807,761,45,1,802,5,1400,593,222,580
28,"MUREŞ","#N/A",114319,,23,"TÎRGU MUREŞ / Liceul cu program sportiv ""Szasz Adalbert""",1,10788,"MUNICIPIUL TÎRGU MUREŞ",114319,1566,864,757,106,1,854,10,1700,836,218,636
28,"MUREŞ","#N/A",114319,,24,"TÎRGU MUREŞ / Liceul cu program sportiv ""Szasz Adalbert""",1,10788,"MUNICIPIUL TÎRGU MUREŞ",114319,1548,1396,918,406,72,1377,19,1850,454,358,1019
28,"MUREŞ","#N/A",114319,,25,"TÎRGU MUREŞ / Grădiniţa progr.prel.nr.6",1,10788,"MUNICIPIUL TÎRGU MUREŞ",114319,1358,828,766,62,0,818,10,1450,622,204,614
28,"MUREŞ","#N/A",114319,,26,"TÎRGU MUREŞ / Liceul Tehnologic ""C-tin Brâncuşi""",1,10788,"MUNICIPIUL TÎRGU MUREŞ",114319,1513,1075,870,150,55,1060,15,1850,775,334,726
28,"MUREŞ","#N/A",114319,,27,"TÎRGU MUREŞ / Şcoala generală nr. 7A",1,10788,"MUNICIPIUL TÎRGU MUREŞ",114319,1562,1005,889,116,0,984,21,1706,701,301,683
28,"MUREŞ","#N/A",114319,,28,"TÎRGU MUREŞ / Şcoala generală nr. 7B",1,10788,"MUNICIPIUL TÎRGU MUREŞ",114319,1262,907,655,155,97,897,10,1350,443,251,646
28,"MUREŞ","#N/A",114319,,29,"TÎRGU MUREŞ / Şcoala generală nr. 7B",1,10788,"MUNICIPIUL TÎRGU MUREŞ",114319,1372,915,722,84,109,901,14,1500,585,219,682
28,"MUREŞ","#N/A",114319,,30,"TÎRGU MUREŞ / Liceul Tehnologic ""Ion Vlasiu""",1,10788,"MUNICIPIUL TÎRGU MUREŞ",114319,1661,1316,931,233,152,1299,17,1824,508,343,956
28,"MUREŞ","#N/A",114319,,31,"TÎRGU MUREŞ / Centrul Cultural ""Mihai Eminescu""",1,10788,"MUNICIPIUL TÎRGU MUREŞ",114319,921,1227,506,618,103,1205,22,1450,223,261,944
28,"MUREŞ","#N/A",114319,,32,"TÎRGU MUREŞ / Colegiul naţional ""Unirea""",1,10788,"MUNICIPIUL TÎRGU MUREŞ",114319,1698,1092,995,78,19,1072,20,1850,758,253,819
28,"MUREŞ","#N/A",114319,,33,"TÎRGU MUREŞ / Liceul Vocaţional ""M. Eminescu""",1,10788,"MUNICIPIUL TÎRGU MUREŞ",114319,1693,979,922,57,0,966,13,1800,821,259,707
28,"MUREŞ","#N/A",114319,,34,"TÎRGU MUREŞ / Şcoala Gimnazială ""T.Vladimirescu""",1,10788,"MUNICIPIUL TÎRGU MUREŞ",114319,1580,952,872,80,0,931,21,1700,748,255,676
28,"MUREŞ","#N/A",114319,,35,"TÎRGU MUREŞ / Şcoala Gimnazială ""T.Vladimirescu""",1,10788,"MUNICIPIUL TÎRGU MUREŞ",114319,1607,1031,961,70,0,1018,13,1750,719,334,684
28,"MUREŞ","#N/A",114319,,36,"TÎRGU MUREŞ / Şcoala Gimnazială ""T.Vladimirescu""",1,10788,"MUNICIPIUL TÎRGU MUREŞ",114319,1594,974,933,41,0,957,17,1700,726,284,673
28,"MUREŞ","#N/A",114319,,37,"TÎRGU MUREŞ / Şcoala Gimnazială ""T.Vladimirescu""",1,10788,"MUNICIPIUL TÎRGU MUREŞ",114319,1670,1006,936,70,0,993,13,1801,795,317,676
28,"MUREŞ","#N/A",114319,,38,"TÎRGU MUREŞ / Şcoala Gimnazială ""T.Vladimirescu""",1,10788,"MUNICIPIUL TÎRGU MUREŞ",114319,1465,928,844,84,0,914,14,1600,672,285,629
28,"MUREŞ","#N/A",114319,,39,"TÎRGU MUREŞ / Liceul Tehnologic Electromureş",1,10788,"MUNICIPIUL TÎRGU MUREŞ",114319,1612,1036,963,73,0,1015,21,1750,714,286,729
28,"MUREŞ","#N/A",114319,,40,"TÎRGU MUREŞ / Liceul Tehnologic Electromureş",1,10788,"MUNICIPIUL TÎRGU MUREŞ",114319,1704,1065,994,70,1,1049,16,1850,785,286,763
28,"MUREŞ","#N/A",114319,,41,"TÎRGU MUREŞ / Liceul Tehnologic Electromureş",1,10788,"MUNICIPIUL TÎRGU MUREŞ",114319,1569,1011,886,82,43,987,24,1700,689,287,700
28,"MUREŞ","#N/A",114319,,42,"TÎRGU MUREŞ / Liceul Tehnologic Electromureş",1,10788,"MUNICIPIUL TÎRGU MUREŞ",114319,1573,939,868,71,0,921,18,1700,761,328,593
28,"MUREŞ","#N/A",114319,,43,"TÎRGU MUREŞ / Punct colectare taxe şi impozite",1,10788,"MUNICIPIUL TÎRGU MUREŞ",114319,1122,798,695,103,0,786,12,1200,402,224,562
28,"MUREŞ","#N/A",114319,,44,"TÎRGU MUREŞ / Şcoala Gimnazială ""Mihai Viteazul""",1,10788,"MUNICIPIUL TÎRGU MUREŞ",114319,1696,1049,979,70,0,1031,18,1799,750,327,704
28,"MUREŞ","#N/A",114319,,45,"TÎRGU MUREŞ / Şcoala Gimnazială ""Mihai Viteazul""",1,10788,"MUNICIPIUL TÎRGU MUREŞ",114319,1673,1036,965,71,0,1011,25,1800,764,332,679
28,"MUREŞ","#N/A",114319,,46,"TÎRGU MUREŞ / Şcoala Gimnazială ""Mihai Viteazul""",1,10788,"MUNICIPIUL TÎRGU MUREŞ",114319,1652,1054,963,91,0,1030,24,1800,746,295,735
28,"MUREŞ","#N/A",114319,,47,"TÎRGU MUREŞ / Şcoala Gimnazială ""Mihai Viteazul""",1,10788,"MUNICIPIUL TÎRGU MUREŞ",114319,1630,1018,906,111,1,990,28,1750,732,326,664
28,"MUREŞ","#N/A",114319,,48,"TÎRGU MUREŞ / Şcoala Gimnazială ""Romulus Guga""",1,10788,"MUNICIPIUL TÎRGU MUREŞ",114319,1586,1029,920,108,1,1017,12,1700,671,348,669
28,"MUREŞ","#N/A",114319,,49,"TÎRGU MUREŞ / Şcoala Gimnazială ""Romulus Guga""",1,10788,"MUNICIPIUL TÎRGU MUREŞ",114319,1603,1134,1026,107,1,1122,12,1700,566,299,823
28,"MUREŞ","#N/A",114319,,50,"TÎRGU MUREŞ / Şcoala Gimnazială ""Romulus Guga""",1,10788,"MUNICIPIUL TÎRGU MUREŞ",114319,1616,1050,985,65,0,1022,28,1750,700,256,766
28,"MUREŞ","#N/A",114319,,51,"TÎRGU MUREŞ / Şcoala Gimnazială ""Romulus Guga""",1,10788,"MUNICIPIUL TÎRGU MUREŞ",114319,1507,923,871,52,0,913,10,1600,677,302,611
28,"MUREŞ","#N/A",114319,,52,"TÎRGU MUREŞ / Grădiniţa cu progr.prel.""Codrişor""",1,10788,"MUNICIPIUL TÎRGU MUREŞ",114319,1721,1089,1019,70,0,1075,14,1850,761,307,768
28,"MUREŞ","#N/A",114319,,53,"TÎRGU MUREŞ / Şcoala Gimnazială ""G.Coşbuc""",1,10788,"MUNICIPIUL TÎRGU MUREŞ",114319,1496,827,766,61,0,815,12,1600,773,210,605
28,"MUREŞ","#N/A",114319,,54,"TÎRGU MUREŞ / Şcoala Gimnazială ""G.Coşbuc""",1,10788,"MUNICIPIUL TÎRGU MUREŞ",114319,1628,968,884,84,0,952,16,1750,782,238,714
28,"MUREŞ","#N/A",114319,,55,"TÎRGU MUREŞ / Şcoala Gimnazială ""Dacia""/B",1,10788,"MUNICIPIUL TÎRGU MUREŞ",114319,1584,956,897,59,0,944,12,1700,744,271,673
28,"MUREŞ","#N/A",114319,,56,"TÎRGU MUREŞ / Şcoala Gimnazială ""Dacia""/B",1,10788,"MUNICIPIUL TÎRGU MUREŞ",114319,1625,958,901,57,0,943,15,1750,792,273,670
28,"MUREŞ","#N/A",114319,,57,"TÎRGU MUREŞ / Centrul şcolar pentru educaţie incluzivă nr.1",1,10788,"MUNICIPIUL TÎRGU MUREŞ",114319,1648,969,896,61,12,953,16,1750,781,288,665
28,"MUREŞ","#N/A",114319,,58,"TÎRGU MUREŞ / Centrul şcolar pentru educaţie incluzivă nr.1",1,10788,"MUNICIPIUL TÎRGU MUREŞ",114319,1291,695,645,50,0,676,19,1400,705,284,392
28,"MUREŞ","#N/A",114319,,59,"TÎRGU MUREŞ / Şcoala Gimnazială ""Dacia""/A",1,10788,"MUNICIPIUL TÎRGU MUREŞ",114319,1586,1005,932,73,0,979,26,1702,697,291,688
28,"MUREŞ","#N/A",114319,,60,"TÎRGU MUREŞ / Şcoala Gimnazială ""Dacia""/A",1,10788,"MUNICIPIUL TÎRGU MUREŞ",114319,1476,931,866,47,18,917,14,1600,669,288,629
28,"MUREŞ","#N/A",114319,,61,"TÎRGU MUREŞ / Şcoala Gimnazială ""Dacia""/A",1,10788,"MUNICIPIUL TÎRGU MUREŞ",114319,945,563,514,49,0,552,11,1000,437,145,407
28,"MUREŞ","#N/A",114319,,62,"TÎRGU MUREŞ / Liceul Tehnologic ""Avram Iancu""",1,10788,"MUNICIPIUL TÎRGU MUREŞ",114319,1394,819,761,58,0,804,15,1498,679,194,610
28,"MUREŞ","#N/A",114319,,63,"TÎRGU MUREŞ / Liceul Tehnologic ""Avram Iancu""",1,10788,"MUNICIPIUL TÎRGU MUREŞ",114319,1587,936,843,91,2,927,9,1700,764,229,698
28,"MUREŞ","#N/A",114319,,64,"TÎRGU MUREŞ / Liceul Tehnologic ""Avram Iancu""",1,10788,"MUNICIPIUL TÎRGU MUREŞ",114319,1485,878,772,59,47,862,16,1600,722,277,585
28,"MUREŞ","#N/A",114319,,65,"TÎRGU MUREŞ / Grădiniţa prog.prel.""Albinuţa""",1,10788,"MUNICIPIUL TÎRGU MUREŞ",114319,1403,866,769,97,0,853,13,1500,634,257,596
28,"MUREŞ","#N/A",114319,,66,"TÎRGU MUREŞ / Şcoala Gimnazială ""Liviu Rebreanu""",1,10788,"MUNICIPIUL TÎRGU MUREŞ",114319,1453,788,741,47,0,771,17,1549,761,193,578
28,"MUREŞ","#N/A",114319,,67,"TÎRGU MUREŞ / Şcoala Gimnazială ""Liviu Rebreanu""",1,10788,"MUNICIPIUL TÎRGU MUREŞ",114319,1344,861,801,59,1,847,14,1444,583,289,558
28,"MUREŞ","#N/A",114319,,68,"TÎRGU MUREŞ / Şcoala Gimnazială ""Liviu Rebreanu""",1,10788,"MUNICIPIUL TÎRGU MUREŞ",114319,1526,873,840,33,0,864,9,1650,777,618,246
28,"MUREŞ","#N/A",114319,,69,"TÎRGU MUREŞ / Şcoala Gimnazială ""Liviu Rebreanu""",1,10788,"MUNICIPIUL TÎRGU MUREŞ",114319,1492,909,858,50,1,890,19,1600,691,244,646
28,"MUREŞ","#N/A",114319,,70,"TÎRGU MUREŞ / Grădiniţa prog.prel.""Licurici""",1,10788,"MUNICIPIUL TÎRGU MUREŞ",114319,1500,849,803,46,0,834,15,1600,751,258,576
28,"MUREŞ","#N/A",114319,,71,"TÎRGU MUREŞ / Grădiniţa prog.prel.""Licurici""",1,10788,"MUNICIPIUL TÎRGU MUREŞ",114319,1296,804,754,50,0,788,16,1400,596,243,545
28,"MUREŞ","#N/A",114319,,72,"TÎRGU MUREŞ / Liceul Tehnologic ""Gh. Şincai""",1,10788,"MUNICIPIUL TÎRGU MUREŞ",114319,1555,943,859,83,1,934,9,1700,757,276,658
28,"MUREŞ","#N/A",114319,,73,"TÎRGU MUREŞ / Liceul Tehnologic ""Gh. Şincai""",1,10788,"MUNICIPIUL TÎRGU MUREŞ",114319,1505,905,859,46,0,890,15,1600,695,296,594
28,"MUREŞ","#N/A",114319,,74,"TÎRGU MUREŞ / Şcoala Gimnazială Liviu Rebreanu",1,10788,"MUNICIPIUL TÎRGU MUREŞ",114319,1414,839,788,51,0,824,15,1500,661,243,581
28,"MUREŞ","#N/A",114319,,75,"TÎRGU MUREŞ / Şcoala Gimnazială Liviu Rebreanu",1,10788,"MUNICIPIUL TÎRGU MUREŞ",114319,1510,881,833,47,1,871,10,1649,768,299,572
28,"MUREŞ","#N/A",114319,,76,"TÎRGU MUREŞ / Grădiniţa cu prog.prel.""Rândunica""",1,10788,"MUNICIPIUL TÎRGU MUREŞ",114319,1674,915,851,64,0,902,13,1800,885,276,626
28,"MUREŞ","#N/A",114319,,77,"TÎRGU MUREŞ / Liceul Tehnologic ""Gh.Şincai""",1,10788,"MUNICIPIUL TÎRGU MUREŞ",114319,1607,905,861,41,3,892,13,1750,845,253,639
28,"MUREŞ","#N/A",114319,,78,"TÎRGU MUREŞ / Şcoala Gimnazială ""Serafim Duicu""",1,10788,"MUNICIPIUL TÎRGU MUREŞ",114319,1656,928,869,59,0,914,14,1800,872,263,651
28,"MUREŞ","#N/A",114319,,79,"TÎRGU MUREŞ / Şcoala Gimnazială ""Serafim Duicu""",1,10788,"MUNICIPIUL TÎRGU MUREŞ",114319,1436,765,710,55,0,751,14,1550,785,194,557
28,"MUREŞ","#N/A",114319,,80,"TÎRGU MUREŞ / Şcoala Gimnazială ""Serafim Duicu""",1,10788,"MUNICIPIUL TÎRGU MUREŞ",114319,1673,958,906,49,3,947,11,1800,842,284,663
28,"MUREŞ","#N/A",114319,,81,"TÎRGU MUREŞ / Liceul Tehnologic ""Traian Vuia""",1,10788,"MUNICIPIUL TÎRGU MUREŞ",114319,1654,983,918,63,2,968,15,1800,817,284,684
28,"MUREŞ","#N/A",114319,,82,"TÎRGU MUREŞ / Liceul Tehnologic ""Traian Vuia""",1,10788,"MUNICIPIUL TÎRGU MUREŞ",114319,1631,799,726,38,35,788,11,1750,951,248,540
28,"MUREŞ","#N/A",114319,,83,"TÎRGU MUREŞ / Liceul Tehnologic ""Traian Vuia""",1,10788,"MUNICIPIUL TÎRGU MUREŞ",114319,1555,927,857,69,1,908,19,1698,771,259,649
28,"MUREŞ","#N/A",114319,,84,"TÎRGU MUREŞ / Liceul Tehnologic ""Emil Dandea""",1,10788,"MUNICIPIUL TÎRGU MUREŞ",114319,1130,653,582,71,0,636,17,1250,597,198,438
28,"MUREŞ","#N/A",114319,,85,"TÎRGU MUREŞ / Căminul cultural",1,10788,"MUNICIPIUL TÎRGU MUREŞ",114319,1008,577,541,36,0,571,6,1100,523,193,378
28,"MUREŞ","#N/A",114809,,86,"REGHIN / GIMNAZIUL DE STAT ALEXANDRU CEUSIANU",1,10792,"MUNICIPIUL REGHIN",114809,1576,979,900,78,1,972,7,1700,721,306,666
28,"MUREŞ","#N/A",114809,,87,"REGHIN / CLUBUL COPIILOR",1,10792,"MUNICIPIUL REGHIN",114809,1392,909,859,50,0,903,6,1500,591,244,659
28,"MUREŞ","#N/A",114809,,88,"REGHIN / GRUP SCOLAR LUCIAN BLAGA",1,10792,"MUNICIPIUL REGHIN",114809,1489,997,925,71,1,984,13,1600,603,268,716
28,"MUREŞ","#N/A",114809,,89,"REGHIN / GRUP SCOLAR LUCIAN BLAGA",1,10792,"MUNICIPIUL REGHIN",114809,1262,770,736,34,0,761,9,1350,580,188,573
28,"MUREŞ","#N/A",114809,,90,"REGHIN / GRUP SCOLAR PETRU MAIOR",1,10792,"MUNICIPIUL REGHIN",114809,1693,1072,1012,57,3,1062,10,1850,778,282,780
28,"MUREŞ","#N/A",114809,,91,"REGHIN / GRUP SCOLAR PETRU MAIOR",1,10792,"MUNICIPIUL REGHIN",114809,1646,991,953,38,0,983,8,1750,759,254,729
28,"MUREŞ","#N/A",114809,,92,"REGHIN / GRUP SCOLAR PETRU MAIOR",1,10792,"MUNICIPIUL REGHIN",114809,1587,976,900,76,0,970,6,1700,724,297,673
28,"MUREŞ","#N/A",114809,,93,"REGHIN / GRUP SCOLAR IOAN BOJOR",1,10792,"MUNICIPIUL REGHIN",114809,1652,991,946,45,0,983,8,2250,1259,274,709
28,"MUREŞ","#N/A",114809,,94,"REGHIN / GRUP SCOLAR IOAN BOJOR",1,10792,"MUNICIPIUL REGHIN",114809,1689,1010,984,26,0,1006,4,1800,790,323,683
28,"MUREŞ","#N/A",114809,,95,"REGHIN / GRADINITA CU PROGRAM PRELUNGIT NR.4",1,10792,"MUNICIPIUL REGHIN",114809,1007,581,550,31,0,575,6,1100,519,172,403
28,"MUREŞ","#N/A",114809,,96,"REGHIN / GRADINITA CU PROGRAM PRELUNGIT NR.4",1,10792,"MUNICIPIUL REGHIN",114809,1008,588,553,35,0,584,4,1100,512,218,366
28,"MUREŞ","#N/A",114809,,97,"REGHIN / CAMINUL CULTURAL IERNUTENI",1,10792,"MUNICIPIUL REGHIN",114809,1511,1120,984,136,0,1105,15,1650,530,349,756
28,"MUREŞ","#N/A",114809,,98,"REGHIN / SCOALA GENERALA NR.4",1,10792,"MUNICIPIUL REGHIN",114809,1020,772,742,30,0,742,30,1099,327,545,197
28,"MUREŞ","#N/A",114809,,99,"REGHIN / SCOALA GENERALA NR.4",1,10792,"MUNICIPIUL REGHIN",114809,1187,652,636,15,1,651,1,1300,648,171,480
28,"MUREŞ","#N/A",114809,,100,"REGHIN / GRADINITA CU PROGRAM PRELUNGIT NR.3",1,10792,"MUNICIPIUL REGHIN",114809,1485,958,893,64,1,948,10,1600,642,372,576
28,"MUREŞ","#N/A",114809,,101,"REGHIN / GIMNAZIUL DE STAT FLOREA BOGDAN",1,10792,"MUNICIPIUL REGHIN",114809,1469,831,784,46,1,821,10,1600,769,239,582
28,"MUREŞ","#N/A",114809,,102,"REGHIN / GIMNAZIUL DE STAT FLOREA BOGDAN",1,10792,"MUNICIPIUL REGHIN",114809,1462,893,856,35,2,883,10,1600,707,304,579
28,"MUREŞ","#N/A",114809,,103,"REGHIN / GIMNAZIUL DE STAT FLOREA BOGDAN",1,10792,"MUNICIPIUL REGHIN",114809,1410,806,782,24,0,799,7,1550,744,213,586
28,"MUREŞ","#N/A",114809,,104,"REGHIN / GRADINITA CU PROGRAM NORMAL NR.3",1,10792,"MUNICIPIUL REGHIN",114809,1228,811,760,51,0,804,7,1350,539,238,566
28,"MUREŞ","#N/A",114809,,105,"REGHIN / GRADINITA CU PROGRAM NORMAL NR.3",1,10792,"MUNICIPIUL REGHIN",114809,1022,645,610,35,0,637,8,1100,455,175,462
28,"MUREŞ","#N/A",114809,,106,"REGHIN / CASA DE CULTURA GEORGE ENESCU",1,10792,"MUNICIPIUL REGHIN",114809,1222,725,674,47,4,713,12,1300,575,234,479
28,"MUREŞ","#N/A",114809,,107,"REGHIN / GIMNAZIUL DE STAT AUGUSTIN MAIOR",1,10792,"MUNICIPIUL REGHIN",114809,1246,731,673,58,0,723,8,1350,619,235,488
28,"MUREŞ","#N/A",114809,,108,"REGHIN / CASA DE CULTURA EUGEN NICOARA",1,10792,"MUNICIPIUL REGHIN",114809,1323,869,759,44,66,863,6,1450,581,278,585
28,"MUREŞ","#N/A",114514,,109,"SIGHIŞOARA / Şcoala Gimnazială "" OCTAVIAN GOGA """,1,10796,"MUNICIPIUL SIGHIŞOARA",114514,1380,862,814,47,1,856,6,1500,638,248,608
28,"MUREŞ","#N/A",114514,,110,"SIGHIŞOARA / Liceul Tehnologic Nr. 2",1,10796,"MUNICIPIUL SIGHIŞOARA",114514,1159,661,605,56,0,651,10,1250,589,159,492
28,"MUREŞ","#N/A",114514,,111,"SIGHIŞOARA / Liceul Tehnologic Nr. 2",1,10796,"MUNICIPIUL SIGHIŞOARA",114514,997,538,459,69,10,533,5,1100,562,134,399
28,"MUREŞ","#N/A",114514,,112,"SIGHIŞOARA / Şcoala Gimnazială  ""Miron Neagu""",1,10796,"MUNICIPIUL SIGHIŞOARA",114514,1371,752,672,80,0,750,2,1500,748,207,543
28,"MUREŞ","#N/A",114514,,113,"SIGHIŞOARA / Şcoala Gimnazială  ""Miron Neagu""",1,10796,"MUNICIPIUL SIGHIŞOARA",114514,1336,744,678,65,1,729,15,1450,706,231,498
28,"MUREŞ","#N/A",114514,,114,"SIGHIŞOARA / Liceul Teoretic  ""Joseph Haltrich""",1,10796,"MUNICIPIUL SIGHIŞOARA",114514,1224,689,507,179,3,677,12,1350,661,165,512
28,"MUREŞ","#N/A",114514,,115,"SIGHIŞOARA / Grădiniţa cu Program Prelungit nr.2",1,10796,"MUNICIPIUL SIGHIŞOARA",114514,1304,740,693,47,0,734,6,1400,660,215,519
28,"MUREŞ","#N/A",114514,,116,"SIGHIŞOARA / Şcoala Gimnazială "" Nicolae Iorga """,1,10796,"MUNICIPIUL SIGHIŞOARA",114514,1026,555,530,25,0,552,3,1100,545,176,376
28,"MUREŞ","#N/A",114514,,117,"SIGHIŞOARA / Şcoala Gimnazială "" Nicolae Iorga """,1,10796,"MUNICIPIUL SIGHIŞOARA",114514,1043,598,570,27,1,593,5,1150,552,188,405
28,"MUREŞ","#N/A",114514,,118,"SIGHIŞOARA / Şcoala Gimnazială "" Nicolae Iorga """,1,10796,"MUNICIPIUL SIGHIŞOARA",114514,1465,758,724,34,0,752,6,1600,842,226,526
28,"MUREŞ","#N/A",114514,,119,"SIGHIŞOARA / Şcoala Gimnazială "" Nicolae Iorga """,1,10796,"MUNICIPIUL SIGHIŞOARA",114514,1219,607,573,33,1,602,5,1300,693,142,460
28,"MUREŞ","#N/A",114514,,120,"SIGHIŞOARA / Şcoala Gimnazială "" Zaharia Boiu """,1,10796,"MUNICIPIUL SIGHIŞOARA",114514,1280,648,608,40,0,641,7,1400,752,162,479
28,"MUREŞ","#N/A",114514,,121,"SIGHIŞOARA / Şcoala Gimnazială "" Zaharia Boiu """,1,10796,"MUNICIPIUL SIGHIŞOARA",114514,1347,769,745,24,0,767,2,1450,681,182,585
28,"MUREŞ","#N/A",114514,,122,"SIGHIŞOARA / Şcoala Gimnazială "" Zaharia Boiu """,1,10796,"MUNICIPIUL SIGHIŞOARA",114514,1221,678,617,58,3,673,5,1300,622,171,502
28,"MUREŞ","#N/A",114514,,123,"SIGHIŞOARA / Şcoala Gimnazială "" Zaharia Boiu """,1,10796,"MUNICIPIUL SIGHIŞOARA",114514,1568,889,861,27,1,881,8,1700,811,202,679
28,"MUREŞ","#N/A",114514,,124,"SIGHIŞOARA / Şcoala Gimnazială "" Zaharia Boiu """,1,10796,"MUNICIPIUL SIGHIŞOARA",114514,1405,775,729,46,0,767,8,1500,725,165,602
28,"MUREŞ","#N/A",114514,,125,"SIGHIŞOARA / Şcoala Primară ""Dealul Viilor""",1,10796,"MUNICIPIUL SIGHIŞOARA",114514,1589,867,836,31,0,854,13,2150,1283,243,611
28,"MUREŞ","#N/A",114514,,126,"SIGHIŞOARA / Şcoala Gimnazială ""Aurel Mosora""",1,10796,"MUNICIPIUL SIGHIŞOARA",114514,1435,846,762,84,0,839,7,1550,704,246,593
28,"MUREŞ","#N/A",114514,,127,"SIGHIŞOARA / Şcoala Gimnazială ""Aurel Mosora""",1,10796,"MUNICIPIUL SIGHIŞOARA",114514,1417,819,739,79,1,813,6,1550,731,244,569
28,"MUREŞ","#N/A",114514,,128,"SIGHIŞOARA / Şcoala Gimnazială ""Radu Popa""",1,10796,"MUNICIPIUL SIGHIŞOARA",114514,1221,740,657,76,7,729,11,1300,560,251,478
28,"MUREŞ","#N/A",114514,,129,"SIGHIŞOARA / Şcoala Gimnazială "" Victor Jinga""",1,10796,"MUNICIPIUL SIGHIŞOARA",114514,1270,801,740,61,0,795,6,1350,549,256,539
28,"MUREŞ","#N/A",114514,,130,"SIGHIŞOARA / Şcoala Gimnazială "" Victor Jinga""",1,10796,"MUNICIPIUL SIGHIŞOARA",114514,993,550,524,26,0,546,4,1100,550,147,399
28,"MUREŞ","#N/A",114514,,131,"HETIUR / Grădiniţa cu Program Normal  Hetiur",1,10796,"MUNICIPIUL SIGHIŞOARA",114514,833,428,380,48,0,423,5,900,472,111,312
28,"MUREŞ","#N/A",114925,,132,"TÂRNĂVENI / Gradinita cu program prelungit nr.4",1,10805,"MUNICIPIUL TÂRNĂVENI",114925,1019,549,515,34,0,543,6,1100,551,212,331
28,"MUREŞ","#N/A",114925,,133,"TÂRNĂVENI / Şcoala gimnazială nr.3",1,10805,"MUNICIPIUL TÂRNĂVENI",114925,1065,615,586,29,0,610,5,1150,535,235,375
28,"MUREŞ","#N/A",114925,,134,"TÂRNĂVENI / Şcoala Gimnazială nr.3",1,10805,"MUNICIPIUL TÂRNĂVENI",114925,1000,508,487,21,0,503,5,1100,592,178,325
28,"MUREŞ","#N/A",114925,,135,"TÂRNĂVENI / Gradinita cu program prelungit nr.1",1,10805,"MUNICIPIUL TÂRNĂVENI",114925,952,569,538,29,2,566,3,1050,481,245,321
28,"MUREŞ","#N/A",114925,,136,"TÂRNĂVENI / Şcoala gimnazială Traian",1,10805,"MUNICIPIUL TÂRNĂVENI",114925,1131,623,576,47,0,617,6,1200,577,211,406
28,"MUREŞ","#N/A",114925,,137,"TÂRNĂVENI / Liceul Constantin Brâncuşi",1,10805,"MUNICIPIUL TÂRNĂVENI",114925,1247,672,642,29,1,667,5,1800,1128,307,360
28,"MUREŞ","#N/A",114925,,138,"TÂRNĂVENI / Casa de cultura Mihai Eminescu",1,10805,"MUNICIPIUL TÂRNĂVENI",114925,1277,720,694,26,0,715,5,1400,680,280,435
28,"MUREŞ","#N/A",114925,,139,"TÂRNĂVENI / Colegiul Tehnic",1,10805,"MUNICIPIUL TÂRNĂVENI",114925,976,536,510,24,2,530,6,1050,514,213,317
28,"MUREŞ","#N/A",114925,,140,"TÂRNĂVENI / Şcoala gimnazială Avram Iancu",1,10805,"MUNICIPIUL TÂRNĂVENI",114925,967,444,422,21,1,441,3,1050,606,172,269
28,"MUREŞ","#N/A",114925,,141,"TÂRNĂVENI / Scoala Gimnaziala Avram Iancu",1,10805,"MUNICIPIUL TÂRNĂVENI",114925,928,476,461,15,0,472,4,1000,524,184,288
28,"MUREŞ","#N/A",114925,,142,"TÂRNĂVENI / Liceul Teoretic Andrei Barseanu",1,10805,"MUNICIPIUL TÂRNĂVENI",114925,1331,806,681,17,108,802,4,1450,644,338,464
28,"MUREŞ","#N/A",114925,,143,"TÂRNĂVENI / Liceul Teoretic Andrei Barseanu",1,10805,"MUNICIPIUL TÂRNĂVENI",114925,1397,761,739,22,0,757,4,1500,739,266,491
28,"MUREŞ","#N/A",114925,,144,"TÂRNĂVENI / Gradinita cu Program Normal nr.6",1,10805,"MUNICIPIUL TÂRNĂVENI",114925,1221,661,628,33,0,658,3,1350,689,212,446
28,"MUREŞ","#N/A",114925,,145,"TÂRNĂVENI / Clubul Pensionarilor nr. 2",1,10805,"MUNICIPIUL TÂRNĂVENI",114925,1205,644,613,31,0,639,5,1300,656,206,433
28,"MUREŞ","#N/A",114925,,146,"TÂRNĂVENI / Gara Târnăveni",1,10805,"MUNICIPIUL TÂRNĂVENI",114925,1105,639,598,41,0,632,7,1200,561,273,359
28,"MUREŞ","#N/A",114925,,147,"TÂRNĂVENI / Şcoala Gimnazială Vasile Moldovan",1,10805,"MUNICIPIUL TÂRNĂVENI",114925,1124,595,559,36,0,589,6,1200,605,159,430
28,"MUREŞ","#N/A",114925,,148,"TÂRNĂVENI / Şcoala Gimnazială Vasile Moldovan",1,10805,"MUNICIPIUL TÂRNĂVENI",114925,1133,578,556,22,0,561,17,1200,622,289,272
28,"MUREŞ","#N/A",114925,,149,"TÂRNĂVENI / Şcoala gimnazială Vasile Moldovan",1,10805,"MUNICIPIUL TÂRNĂVENI",114925,1239,636,619,17,0,626,10,1350,714,186,440
28,"MUREŞ","#N/A",114925,,150,"TÂRNĂVENI / Şcoala Botorca",1,10805,"MUNICIPIUL TÂRNĂVENI",114925,305,195,172,23,0,193,2,350,155,34,159
28,"MUREŞ","#N/A",114925,,151,"BOBOHALMA / Căminul Cultural Bobohalma",1,10805,"MUNICIPIUL TÂRNĂVENI",114925,898,453,430,23,0,451,2,1000,547,130,321
28,"MUREŞ","#N/A",114925,,152,"CUŞTELNIC / Grădiniţa cu program normal nr. 6",1,10805,"MUNICIPIUL TÂRNĂVENI",114925,464,256,241,15,0,255,1,499,243,102,153
28,"MUREŞ","#N/A",117827,,153,"IERNUT / CASA DE CULTURĂ IERNUT",1,10810,"ORAŞ IERNUT",117827,1370,898,822,72,4,888,10,1500,602,291,597
28,"MUREŞ","#N/A",117827,,154,"IERNUT / GRĂDINIŢA CU PR. NORMAL",1,10810,"ORAŞ IERNUT",117827,1144,705,647,53,5,695,10,1251,546,220,475
28,"MUREŞ","#N/A",117827,,155,"IERNUT / ŞCOALA GENERALĂ IERNUT",1,10810,"ORAŞ IERNUT",117827,1216,748,675,68,5,743,5,1300,552,203,540
28,"MUREŞ","#N/A",117827,,156,"IERNUT / ŞCOALA GENERALĂ IERNUT",1,10810,"ORAŞ IERNUT",117827,1363,841,772,64,5,826,15,1450,609,263,563
28,"MUREŞ","#N/A",117827,,157,"CIPĂU / ŞCOALA GENERALĂ CIPĂU",1,10810,"ORAŞ IERNUT",117827,853,542,486,53,3,529,13,950,408,200,329
28,"MUREŞ","#N/A",117827,,158,"DEAG / ŞCOALA GENERALĂ DEAG",1,10810,"ORAŞ IERNUT",117827,303,180,152,28,0,176,4,356,176,69,107
28,"MUREŞ","#N/A",117827,,159,"LECHINŢA / ŞCOALA GENERALĂ LECHINŢA",1,10810,"ORAŞ IERNUT",117827,675,424,379,39,6,417,7,750,326,152,265
28,"MUREŞ","#N/A",117827,,160,"OARBA DE MUREŞ / CĂMIN CULTURAL OARBA",1,10810,"ORAŞ IERNUT",117827,114,69,51,18,0,68,1,149,80,22,46
28,"MUREŞ","#N/A",117827,,161,"SĂLCUD / ŞCOALA GENERALĂ SALCUD",1,10810,"ORAŞ IERNUT",117827,583,351,303,41,7,348,3,650,299,132,216
28,"MUREŞ","#N/A",117827,,162,"SFÎNTU GHEORGHE / ŞCOALA GENERALĂ SF. GHEORGHE",1,10810,"ORAŞ IERNUT",117827,306,233,197,33,3,233,0,351,118,45,188
28,"MUREŞ","#N/A",114710,,163,"LUDUŞ / CĂMINUL CULTURAL GHEJA-LUDUŞ",1,10820,"ORAŞ LUDUŞ",114710,1290,897,852,45,0,887,10,1400,503,476,411
28,"MUREŞ","#N/A",114710,,164,"LUDUŞ / CĂMINUL CULTURAL ROŞIORI-LUDUŞ",1,10820,"ORAŞ LUDUŞ",114710,1057,626,605,21,0,621,5,1150,524,107,514
28,"MUREŞ","#N/A",114710,,165,"LUDUŞ / CASA DE CULTURĂ ""POMPEIU HĂRĂŞTEANU"" - LUDUŞ",1,10820,"ORAŞ LUDUŞ",114710,1637,997,917,80,0,991,6,2200,1203,318,673
28,"MUREŞ","#N/A",114710,,166,"LUDUŞ / ŞCOALA GENERALĂ ""IOAN VLĂDUŢIU"" - LUDUŞ",1,10820,"ORAŞ LUDUŞ",114710,1463,923,887,35,1,917,6,1600,677,326,591
28,"MUREŞ","#N/A",114710,,167,"LUDUŞ / ŞCOALA GENERALĂ ""IOAN VLĂDUŢIU"" - LUDUŞ",1,10820,"ORAŞ LUDUŞ",114710,1545,952,916,36,0,938,14,1650,698,377,561
28,"MUREŞ","#N/A",114710,,168,"LUDUŞ / GRUP ŞCOLAR INDUSTRIAL - LUDUŞ",1,10820,"ORAŞ LUDUŞ",114710,1431,890,863,27,0,878,12,1550,660,407,471
28,"MUREŞ","#N/A",114710,,169,"LUDUŞ / GRĂDINIŢA ""CĂSUŢA FERMECATĂ"" - LUDUŞ",1,10820,"ORAŞ LUDUŞ",114710,1429,914,863,51,0,906,8,1545,631,383,523
28,"MUREŞ","#N/A",114710,,170,"LUDUŞ / GRĂDINIŢA  CU PROGRAM NORMAL - LUDUŞ",1,10820,"ORAŞ LUDUŞ",114710,1550,973,918,55,0,963,10,1700,727,419,544
28,"MUREŞ","#N/A",114710,,171,"LUDUŞ / GRĂDINIŢA CU PROGRAM PRELUNGIT - LUDUŞ",1,10820,"ORAŞ LUDUŞ",114710,1097,669,624,44,1,661,8,1200,531,317,344
28,"MUREŞ","#N/A",114710,,172,"LUDUŞ / ŞCOALA GENERALĂ  NR.1 - LUDUŞ",1,10820,"ORAŞ LUDUŞ",114710,1075,645,577,39,29,630,15,1150,505,233,397
28,"MUREŞ","#N/A",114710,,173,"LUDUŞ / ŞCOALA GENERALĂ  NR.1 - LUDUŞ",1,10820,"ORAŞ LUDUŞ",114710,1117,706,671,34,1,700,6,1203,497,299,401
28,"MUREŞ","#N/A",118281,,174,"MIERCUREA NIRAJULUI / CĂMINUL CULTURAL",1,10828,"ORAŞ MIERCUREA NIRAJULUI",118281,980,392,372,20,0,384,8,1050,658,51,333
28,"MUREŞ","#N/A",118281,,175,"MIERCUREA NIRAJULUI / ŞCOALA GIMNAZIALĂ DEÁK FARKAS",1,10828,"ORAŞ MIERCUREA NIRAJULUI",118281,1094,415,399,16,0,409,6,1650,1235,57,352
28,"MUREŞ","#N/A",118281,,176,"MIERCUREA NIRAJULUI / INTERNATUL  ŞCOLAR",1,10828,"ORAŞ MIERCUREA NIRAJULUI",118281,1059,407,387,20,0,403,4,1150,743,75,328
28,"MUREŞ","#N/A",118281,,177,"DUMITREŞTII / CAMINUL CULTURAL",1,10828,"ORAŞ MIERCUREA NIRAJULUI",118281,260,99,88,11,0,98,1,300,201,19,79
28,"MUREŞ","#N/A",118281,,178,"TÂMPA / CAMINUL CULTURAL",1,10828,"ORAŞ MIERCUREA NIRAJULUI",118281,409,124,111,13,0,123,1,450,326,50,73
28,"MUREŞ","#N/A",118281,,179,"ŞARDU NIRAJULUI / ŞCOALA GIMNAZIALĂ",1,10828,"ORAŞ MIERCUREA NIRAJULUI",118281,552,214,178,36,0,211,3,600,386,73,138
28,"MUREŞ","#N/A",118281,,180,"MOŞUNI / ŞCOALA PRIMARĂ",1,10828,"ORAŞ MIERCUREA NIRAJULUI",118281,336,196,128,68,0,194,2,398,202,59,135
28,"MUREŞ","#N/A",119242,,181,"BALDA / Căminul cultural Balda",1,10842,"ORAŞ SARMAŞU",119242,928,543,505,37,1,538,5,1000,457,218,320
28,"MUREŞ","#N/A",119242,,182,"SĂRMĂŞEL-GARĂ / Căminul cultural Sărmăşel Gară",1,10842,"ORAŞ SARMAŞU",119242,577,377,328,49,0,369,8,650,273,144,225
28,"MUREŞ","#N/A",119242,,183,"VIŞINELU / Căminul cultural Vişinelu",1,10842,"ORAŞ SARMAŞU",119242,389,335,268,57,10,335,0,440,105,143,192
28,"MUREŞ","#N/A",119242,,184,"SARMAŞU / Sală sport Sărmaşu",1,10842,"ORAŞ SARMAŞU",119242,1177,704,656,48,0,692,12,1700,996,240,452
28,"MUREŞ","#N/A",119242,,185,"SARMAŞU / Casă cultură Sărmaşu",1,10842,"ORAŞ SARMAŞU",119242,845,480,435,45,0,474,6,1350,870,107,367
28,"MUREŞ","#N/A",119242,,186,"SARMAŞU / Şcoală generală Sărmaşu",1,10842,"ORAŞ SARMAŞU",119242,1003,631,599,32,0,628,3,1100,469,296,332
28,"MUREŞ","#N/A",119242,,187,"LARGA / Şcoala generală Larga",1,10842,"ORAŞ SARMAŞU",119242,157,76,65,11,0,76,0,201,125,9,67
28,"MUREŞ","#N/A",119242,,188,"SĂRMĂŞEL / Căminul cultural Sărmăşel",1,10842,"ORAŞ SARMAŞU",119242,621,370,341,29,0,369,1,700,330,124,245
28,"MUREŞ","#N/A",119331,,189,"SÂNGEORGIU DE PĂDURE / CAMINUL CULTURAL",1,10837,"ORAŞ SÂNGEORGIU DE PĂDURE",119331,1238,504,480,24,0,503,1,1350,846,106,397
28,"MUREŞ","#N/A",119331,,190,"SÂNGEORGIU DE PĂDURE / CAMINUL CULTURAL",1,10837,"ORAŞ SÂNGEORGIU DE PĂDURE",119331,1276,440,414,26,0,431,9,1400,960,131,300
28,"MUREŞ","#N/A",119331,,191,"SÂNGEORGIU DE PĂDURE / GRUP SCOLAR",1,10837,"ORAŞ SÂNGEORGIU DE PĂDURE",119331,1307,591,538,45,8,587,4,1398,807,143,444
28,"MUREŞ","#N/A",119331,,192,"BEZID / SCOALA",1,10837,"ORAŞ SÂNGEORGIU DE PĂDURE",119331,538,125,112,13,0,125,0,600,475,40,85
28,"MUREŞ","#N/A",114854,,193,"ILIEŞI / CĂMINUL CULTURAL",1,10851,"ORAŞ SOVATA",114854,373,180,172,8,0,180,0,400,220,38,142
28,"MUREŞ","#N/A",114854,,194,"SĂCĂDAT / ŞCOALA GENERALĂ SĂCĂDAT DE JOS",1,10851,"ORAŞ SOVATA",114854,1136,461,419,42,0,459,2,1250,789,73,386
28,"MUREŞ","#N/A",114854,,195,"SOVATA / ŞCOALA GENERALĂ ""S, ILYÉS JALOS""",1,10851,"ORAŞ SOVATA",114854,1058,560,502,58,0,555,5,1150,590,74,481
28,"MUREŞ","#N/A",114854,,196,"SOVATA / Şcoala Generală ""S.Illyés Lajos""",1,10851,"ORAŞ SOVATA",114854,1306,617,588,29,0,613,4,1800,1183,68,545
28,"MUREŞ","#N/A",114854,,197,"SOVATA / Primăria Oraş Sovata",1,10851,"ORAŞ SOVATA",114854,1553,784,675,98,11,773,11,2100,1316,85,688
28,"MUREŞ","#N/A",114854,,198,"SOVATA / Biblioteca Orăşenească Sovata Băi",1,10851,"ORAŞ SOVATA",114854,482,615,210,405,0,612,3,950,335,151,461
28,"MUREŞ","#N/A",114854,,199,"SOVATA / Centrul cultural ""Domokos Kázmér""",1,10851,"ORAŞ SOVATA",114854,1552,747,710,37,0,741,6,1650,903,166,575
28,"MUREŞ","#N/A",114854,,200,"SOVATA / Şcoala Generală Nr.3",1,10851,"ORAŞ SOVATA",114854,1073,439,422,17,0,436,3,1150,711,67,369
28,"MUREŞ","#N/A",119894,,201,"UNGHENI / Scoala gimnaziala ""Emil Dragan""",1,10856,"ORAŞ UNGHENI",119894,874,579,525,54,0,576,3,950,371,208,368
28,"MUREŞ","#N/A",119894,,202,"UNGHENI / Scoala gimnaziala ""Emil Dragan""",1,10856,"ORAŞ UNGHENI",119894,897,530,490,40,0,521,9,1000,470,152,369
28,"MUREŞ","#N/A",119894,,203,"UNGHENI / Camin Cultural",1,10856,"ORAŞ UNGHENI",119894,749,521,426,79,16,513,8,800,279,248,265
28,"MUREŞ","#N/A",119894,,204,"UNGHENI / Camin Cultural",1,10856,"ORAŞ UNGHENI",119894,756,493,433,55,5,489,4,850,357,179,310
28,"MUREŞ","#N/A",119894,,205,"CERGHID / CĂMIN CULTURAL",1,10856,"ORAŞ UNGHENI",119894,409,315,250,65,0,307,8,450,135,113,194
28,"MUREŞ","#N/A",119894,,206,"MOREŞTI / CĂMIN CULTURAL",1,10856,"ORAŞ UNGHENI",119894,606,465,428,37,0,461,4,650,185,183,278
28,"MUREŞ","#N/A",119894,,207,"CERGHIZEL / ŞCOALA GENERALĂ",1,10856,"ORAŞ UNGHENI",119894,369,295,261,27,7,293,2,398,103,136,157
28,"MUREŞ","#N/A",119894,,208,"ŞĂUŞA / ŞCOALA GENERALĂ",1,10856,"ORAŞ UNGHENI",119894,205,157,135,18,4,157,0,250,93,66,91
28,"MUREŞ","#N/A",119894,,209,"VIDRASĂU / ŞCOALA GENERALĂ",1,10856,"ORAŞ UNGHENI",119894,860,658,584,70,4,643,15,950,292,241,402
28,"MUREŞ","#N/A",114970,,210,"ACĂŢARI / Şcoala Generală Acăţari",3,10864,"ACĂŢARI",114970,994,451,413,32,6,443,8,1104,653,96,347
28,"MUREŞ","#N/A",114970,,211,"GRUIŞOR / Şcoala Generală Gruişor",3,10864,"ACĂŢARI",114970,349,185,149,30,6,182,3,392,207,98,84
28,"MUREŞ","#N/A",114970,,212,"GĂIEŞTI / Cămin Cultural Găieşti",3,10864,"ACĂŢARI",114970,309,143,121,16,6,143,0,350,207,33,110
28,"MUREŞ","#N/A",114970,,213,"MURGEŞTI / Cămin Cultural Murgeşti",3,10864,"ACĂŢARI",114970,416,236,204,24,8,232,4,450,214,38,194
28,"MUREŞ","#N/A",114970,,214,"ROTENI / Căminul Cultural Roteni",3,10864,"ACĂŢARI",114970,654,366,338,18,10,364,2,700,334,134,230
28,"MUREŞ","#N/A",114970,,215,"STEJERIŞ / Cămin Cultural Stejeriş",3,10864,"ACĂŢARI",114970,282,134,109,19,6,134,0,300,166,49,85
28,"MUREŞ","#N/A",114970,,216,"SUVEICA / Cămin Cultural Suveica",3,10864,"ACĂŢARI",114970,193,93,79,12,2,91,2,250,157,30,61
28,"MUREŞ","#N/A",114970,,217,"VĂLENII / Şcoala generală Vălenii",3,10864,"ACĂŢARI",114970,647,318,279,28,11,316,2,700,382,101,215
28,"MUREŞ","#N/A",115076,,218,"ADĂMUŞ / SCOALA GEN.ADAMUS",3,10874,"ADĂMUŞ",115076,679,332,307,25,0,325,7,750,418,134,191
28,"MUREŞ","#N/A",115076,,219,"ADĂMUŞ / CAMINUL CULTURAL ADAMUS",3,10874,"ADĂMUŞ",115076,1086,567,525,41,1,563,4,1200,633,261,302
28,"MUREŞ","#N/A",115076,,220,"CORNEŞTI / SCOALA GEN.CORNESTI",3,10874,"ADĂMUŞ",115076,989,526,478,48,0,524,2,1100,574,193,331
28,"MUREŞ","#N/A",115076,,221,"CRĂIEŞTI / GRADINITA DE COPII",3,10874,"ADĂMUŞ",115076,925,401,371,30,0,400,1,1000,599,51,349
28,"MUREŞ","#N/A",115076,,222,"DÎMBĂU / GRADINITA DE COPII",3,10874,"ADĂMUŞ",115076,920,488,466,22,0,484,4,1000,512,114,370
28,"MUREŞ","#N/A",114603,,223,"ŢOPA / Scoala Gimnaziala Ţopa",3,10881,"ALBEŞTI",114603,297,211,187,23,1,210,1,350,139,108,102
28,"MUREŞ","#N/A",114603,,224,"ALBEŞTI / Scoala Gimnaziala Albeşti",3,10881,"ALBEŞTI",114603,1605,973,916,55,2,963,10,1750,777,363,600
28,"MUREŞ","#N/A",114603,,225,"ALBEŞTI / Scoala Gimnaziala Albesti",3,10881,"ALBEŞTI",114603,1696,994,933,61,0,986,8,1800,806,314,672
28,"MUREŞ","#N/A",114603,,226,"BOIU / Scoala Gimnaziala Boiu",3,10881,"ALBEŞTI",114603,1202,730,692,38,0,718,12,1300,570,221,497
28,"MUREŞ","#N/A",115147,,227,"ALUNIŞ / CĂMINUL CULTURAL ALUNIŞ-SALA MARE",3,10891,"ALUNIŞ",115147,803,485,443,37,5,479,6,900,415,114,365
28,"MUREŞ","#N/A",115147,,228,"ALUNIŞ / CĂMINUL CULTURAL ALUNIŞ-SALA MICĂ",3,10891,"ALUNIŞ",115147,872,488,451,26,11,484,4,950,462,101,383
28,"MUREŞ","#N/A",115147,,229,"FIŢCĂU / ŞCOALA GEN. CU CLS.I-IV FIŢCĂU",3,10891,"ALUNIŞ",115147,394,241,224,17,0,240,1,450,209,40,200
28,"MUREŞ","#N/A",115147,,230,"LUNCA MUREŞULUI / CĂMINUL CULTURAL LUNCA- MUREŞ - SALA MICĂ",3,10891,"ALUNIŞ",115147,565,331,286,39,6,328,3,600,269,52,276
28,"MUREŞ","#N/A",115183,,231,"APOLD / Gradinita Apold",3,10895,"APOLD",115183,779,331,299,32,0,328,3,851,520,114,214
28,"MUREŞ","#N/A",115183,,232,"DAIA / Scoala Daia",3,10895,"APOLD",115183,558,282,264,18,0,281,1,598,316,53,228
28,"MUREŞ","#N/A",115183,,233,"ŞAEŞ / Scoala Saes",3,10895,"APOLD",115183,1046,550,518,29,3,547,3,1150,600,241,306
28,"MUREŞ","#N/A",115236,,234,"AŢINTIŞ / Sediul primariei  Atintis",3,10900,"AŢINTIŞ",115236,609,386,343,39,4,384,2,646,260,126,258
28,"MUREŞ","#N/A",115236,,235,"BOTEZ / Scoala Generala Botez",3,10900,"AŢINTIŞ",115236,146,92,77,15,0,92,0,204,112,27,65
28,"MUREŞ","#N/A",115236,,236,"CECĂLACA / Scoala Generala Cecalaca",3,10900,"AŢINTIŞ",115236,336,201,180,21,0,199,2,400,199,58,141
28,"MUREŞ","#N/A",115236,,237,"IŞTIHAZA / Scoala Generala Istihaza",3,10900,"AŢINTIŞ",115236,159,94,77,17,0,94,0,200,106,4,90
28,"MUREŞ","#N/A",115236,,238,"SÎNIACOB / Casa de locuit Siniacob",3,10900,"AŢINTIŞ",115236,22,25,7,18,0,25,0,50,25,10,15
28,"MUREŞ","#N/A",115307,,239,"BAHNEA / Căminul cultural Bahnea",3,10910,"BAHNEA",115307,963,522,492,30,0,512,10,1050,528,216,296
28,"MUREŞ","#N/A",115307,,240,"BAHNEA / Şcoala generală clasele I-IV",3,10910,"BAHNEA",115307,592,285,265,20,0,282,3,650,365,46,236
28,"MUREŞ","#N/A",115307,,241,"BERNADEA / Şcoala generală Bernadea",3,10910,"BAHNEA",115307,147,103,76,27,0,100,3,200,97,40,60
28,"MUREŞ","#N/A",115307,,242,"LEPINDEA / Şcoala generală Lepindea",3,10910,"BAHNEA",115307,155,99,78,21,0,96,3,200,101,44,52
28,"MUREŞ","#N/A",115307,,243,"DAIA / Şcoala generală Daia",3,10910,"BAHNEA",115307,148,90,66,24,0,90,0,200,110,25,65
28,"MUREŞ","#N/A",115307,,244,"IDICIU / Şcoala generală Idiciu",3,10910,"BAHNEA",115307,248,145,130,15,0,139,6,296,151,45,94
28,"MUREŞ","#N/A",115307,,245,"GOGAN / Şcoala generală Gogan",3,10910,"BAHNEA",115307,420,211,184,27,0,211,0,450,239,31,180
28,"MUREŞ","#N/A",115307,,246,"CUND / Şcoala generală Cund",3,10910,"BAHNEA",115307,171,79,64,15,0,79,0,203,124,13,66
28,"MUREŞ","#N/A",115389,,247,"BAND / Şcoala Generală Band",3,10928,"BAND",115389,664,365,335,30,0,362,3,751,386,77,285
28,"MUREŞ","#N/A",115389,,248,"BAND / Şcoala Generală Band",3,10928,"BAND",115389,801,334,309,25,0,330,4,900,566,56,274
28,"MUREŞ","#N/A",115389,,249,"BAND / ŞCOALA GENERALĂ BAND",3,10928,"BAND",115389,742,464,437,27,0,449,15,800,336,124,325
28,"MUREŞ","#N/A",115389,,250,"BAND / Grădiniţa cu Program Normal Band",3,10928,"BAND",115389,758,388,367,21,0,379,9,850,462,93,286
28,"MUREŞ","#N/A",115389,,251,"ŢIPTELNIC / Şcoala generală Ţiptelnic",3,10928,"BAND",115389,96,69,56,13,0,68,1,150,81,36,32
28,"MUREŞ","#N/A",115389,,252,"VALEA RECE / Şcoala generală Valea Rece",3,10928,"BAND",115389,218,93,78,15,0,92,1,254,161,24,68
28,"MUREŞ","#N/A",115389,,253,"MĂRĂŞEŞTI / Şcoala generală Mărăşeşti",3,10928,"BAND",115389,262,165,146,19,0,160,5,293,128,60,100
28,"MUREŞ","#N/A",115389,,254,"FÂNAŢE / Şcoala generală Fînaţe",3,10928,"BAND",115389,377,187,170,17,0,187,0,395,208,93,94
28,"MUREŞ","#N/A",115389,,255,"OROIU / Şcoala generală Oroiu",3,10928,"BAND",115389,250,135,117,18,0,135,0,300,165,52,83
28,"MUREŞ","#N/A",115389,,256,"PETEA / Şcoala generală Petea",3,10928,"BAND",115389,156,103,81,22,0,103,0,200,97,48,55
28,"MUREŞ","#N/A",115389,,257,"DRĂCULEA BANDULUI / Şcoala generală Drăculea Bandului",3,10928,"BAND",115389,109,78,62,16,0,76,2,150,72,14,62
28,"MUREŞ","#N/A",115389,,258,"NEGRENII DE CÂMPIE / Şcoala generală Negrenii de Cîmpiei",3,10928,"BAND",115389,100,63,39,24,0,63,0,150,87,11,52
28,"MUREŞ","#N/A",115389,,259,"VALEA MARE / Şcoala generalăValea Mare",3,10928,"BAND",115389,150,102,73,29,0,102,0,200,98,35,67
28,"MUREŞ","#N/A",115520,,260,"BATOŞ / SCOALA GENERALA BATOS",3,10940,"BATOŞ",115520,1109,650,612,37,1,645,5,1200,550,140,505
28,"MUREŞ","#N/A",115520,,261,"DEDRAD / SCOALA GENERALA DEDRAD",3,10940,"BATOŞ",115520,1290,732,695,37,0,728,4,1400,668,279,449
28,"MUREŞ","#N/A",115520,,262,"GORENI / SCOALA GENERALA GORENI",3,10940,"BATOŞ",115520,504,297,272,25,0,293,4,550,253,118,175
28,"MUREŞ","#N/A",115520,,263,"UILA / SCOALA GENERALA UILA",3,10940,"BATOŞ",115520,483,264,245,19,0,260,4,550,286,88,172
28,"MUREŞ","#N/A",115575,,264,"BĂGACIU / Scoala generală Băgaciu",3,10907,"BĂGACIU",115575,1047,582,549,33,0,576,6,1150,568,242,334
28,"MUREŞ","#N/A",115575,,265,"DELENII / Căminul cultural Delenii",3,10907,"BĂGACIU",115575,887,631,592,39,0,627,4,947,316,82,545
28,"MUREŞ","#N/A",115600,,266,"BĂLA / CĂMIN CULTURAL",3,10918,"BĂLA",115600,481,358,317,38,3,355,3,550,192,166,189
28,"MUREŞ","#N/A",115600,,267,"ERCEA / ŞCOLALA GENERALĂ",3,10918,"BĂLA",115600,148,99,90,9,0,96,3,200,101,56,40
28,"MUREŞ","#N/A",115637,,268,"BĂLĂUŞERI / Camin cultural",3,10921,"BĂLĂUŞERI",115637,1015,363,328,35,0,361,2,1100,737,49,312
28,"MUREŞ","#N/A",115637,,269,"AGRIŞTEU / Camin cultural",3,10921,"BĂLĂUŞERI",115637,615,335,312,23,0,334,1,700,365,85,249
28,"MUREŞ","#N/A",115637,,270,"DUMITRENI / Camin cultural",3,10921,"BĂLĂUŞERI",115637,428,161,139,22,0,158,3,500,339,26,132
28,"MUREŞ","#N/A",115637,,271,"FILITELNIC / Camin cultural",3,10921,"BĂLĂUŞERI",115637,186,135,116,19,0,134,1,200,65,31,103
28,"MUREŞ","#N/A",115637,,272,"CHENDU / Scoala generala",3,10921,"BĂLĂUŞERI",115637,1187,578,531,47,0,572,6,1300,722,44,528
28,"MUREŞ","#N/A",115637,,273,"SENEREUŞ / Scoala generala",3,10921,"BĂLĂUŞERI",115637,544,337,316,21,0,332,5,600,263,69,263
28,"MUREŞ","#N/A",115708,,274,"BEICA DE JOS / CAMINUL CULTURAL BEICA DE JOS",3,10945,"BEICA DE JOS",115708,699,362,332,27,3,349,13,750,388,150,199
28,"MUREŞ","#N/A",115708,,275,"BEICA DE SUS / CAMINUL CULTURAL BEICA DE SUS",3,10945,"BEICA DE JOS",115708,206,116,97,19,0,115,1,250,134,67,48
28,"MUREŞ","#N/A",115708,,276,"NADĂŞA / SCOALA GENERALA NADASA",3,10945,"BEICA DE JOS",115708,194,152,106,43,3,151,1,250,98,96,55
28,"MUREŞ","#N/A",115708,,277,"CĂCUCIU / SCOALA GENERALA CACUCIU",3,10945,"BEICA DE JOS",115708,109,103,69,30,4,102,1,150,47,58,44
28,"MUREŞ","#N/A",115708,,278,"ŞERBENI / CAMINUL CULTURAL SERBENI",3,10945,"BEICA DE JOS",115708,292,213,180,29,4,212,1,348,135,116,96
28,"MUREŞ","#N/A",115708,,279,"SÎNMIHAI DE PĂDURE / SCOALA GENERALA SINMIHAI DE PADURE",3,10945,"BEICA DE JOS",115708,205,142,112,27,3,142,0,250,108,46,96
28,"MUREŞ","#N/A",120511,,280,"BERENI / Căminul Cultural Bereni",3,10952,"BERENI",120511,415,167,128,25,14,164,3,450,283,54,110
28,"MUREŞ","#N/A",120511,,281,"EREMIENI / Căminul Cultural Eremieni",3,10952,"BERENI",120511,184,95,74,14,7,94,1,200,105,39,55
28,"MUREŞ","#N/A",120511,,282,"MĂRCULENI / Căminul Cultural Mărculeni",3,10952,"BERENI",120511,400,180,141,18,21,177,3,450,270,42,135
28,"MUREŞ","#N/A",115771,,283,"BICHIŞ / Cămin Cultural Bichiş",3,10960,"BICHIŞ",115771,181,86,60,26,0,85,1,200,114,17,68
28,"MUREŞ","#N/A",115771,,284,"GÎMBUŢ / Şcoala Generală Gâmbuţ",3,10960,"BICHIŞ",115771,135,101,80,19,2,100,1,150,49,31,69
28,"MUREŞ","#N/A",115771,,285,"NANDRA / Şcoala Generală Nandra",3,10960,"BICHIŞ",115771,119,69,49,20,0,66,3,150,81,22,44
28,"MUREŞ","#N/A",115771,,286,"OZD / Căminul Cultural Ozd",3,10960,"BICHIŞ",115771,266,176,140,33,3,174,2,300,124,29,145
28,"MUREŞ","#N/A",115824,,287,"RANTA / Şcoala primară",3,10965,"BOGATA",115824,245,148,126,20,2,147,1,303,155,25,122
28,"MUREŞ","#N/A",115824,,288,"BOGATA / Primaria Bogata",3,10965,"BOGATA",115824,1319,727,674,48,5,721,6,1400,673,235,486
28,"MUREŞ","#N/A",115851,,289,"FILPIŞU MARE / SCOALA GENERALA",3,10968,"BREAZA",115851,647,323,282,41,0,316,7,700,377,91,225
28,"MUREŞ","#N/A",115851,,290,"FILPIŞU MIC / SCOALA GENERALA",3,10968,"BREAZA",115851,351,237,214,14,9,235,2,400,163,51,184
28,"MUREŞ","#N/A",115851,,291,"BREAZA / CAMIN CULTURAL BREAZA",3,10968,"BREAZA",115851,1043,680,629,51,0,673,7,1150,470,92,581
28,"MUREŞ","#N/A",115897,,292,"IDICEL-PĂDURE / Cămin Cultural",3,10972,"BRÎNCOVENEŞTI",115897,425,253,223,30,0,249,4,498,245,65,184
28,"MUREŞ","#N/A",115897,,293,"BRÎNCOVENEŞTI / Şcoala Primară",3,10972,"BRÎNCOVENEŞTI",115897,1343,615,569,46,0,608,7,1450,835,128,480
28,"MUREŞ","#N/A",115897,,294,"IDICEL / Şcoala Primară",3,10972,"BRÎNCOVENEŞTI",115897,346,200,165,35,0,198,2,399,199,78,120
28,"MUREŞ","#N/A",115897,,295,"SĂCALU DE PĂDURE / Şcoala Primară",3,10972,"BRÎNCOVENEŞTI",115897,292,186,161,25,0,183,3,350,164,89,94
28,"MUREŞ","#N/A",115897,,296,"VĂLENII DE MUREŞ / Club-Cămin Cultural",3,10972,"BRÎNCOVENEŞTI",115897,1034,547,505,42,0,545,2,1100,553,54,491
28,"MUREŞ","#N/A",115959,,297,"CEUAŞU DE CÎMPIE / Camin Cultural Ceuasu de Cimpie",3,10978,"CEUAŞU DE CÎMPIE",115959,1307,698,645,53,0,683,15,1400,702,229,454
28,"MUREŞ","#N/A",115959,,298,"BOZED / Camin Cultural Bozed",3,10978,"CEUAŞU DE CÎMPIE",115959,138,94,68,26,0,94,0,150,56,50,44
28,"MUREŞ","#N/A",115959,,299,"CÎMPENIŢA / Caminul Cultural Cimpenita",3,10978,"CEUAŞU DE CÎMPIE",115959,694,354,337,17,0,352,2,750,396,57,295
28,"MUREŞ","#N/A",115959,,300,"CULPIU / Camin Cultural Culpiu",3,10978,"CEUAŞU DE CÎMPIE",115959,316,164,146,18,0,162,2,350,186,60,102
28,"MUREŞ","#N/A",115959,,301,"HERGHELIA / Camin Cultural Herghelia",3,10978,"CEUAŞU DE CÎMPIE",115959,306,196,167,29,0,193,3,350,154,64,129
28,"MUREŞ","#N/A",115959,,302,"PORUMBENI / Scoala Generala Porumbeni",3,10978,"CEUAŞU DE CÎMPIE",115959,467,258,240,18,0,252,6,500,242,77,175
28,"MUREŞ","#N/A",115959,,303,"SĂBED / Camin Cultural Sabed",3,10978,"CEUAŞU DE CÎMPIE",115959,610,319,291,28,0,315,4,646,327,82,233
28,"MUREŞ","#N/A",115959,,304,"VOINICENI / Camin Cultural Voiniceni",3,10978,"CEUAŞU DE CÎMPIE",115959,901,615,548,67,0,606,9,1000,385,196,410
28,"MUREŞ","#N/A",116046,,305,"GRINDENI / Camin cultural",3,10987,"CHEŢANI",116046,488,302,264,38,0,301,1,548,246,77,224
28,"MUREŞ","#N/A",116046,,306,"CHEŢANI / Sediul primariei Chetani",3,10987,"CHEŢANI",116046,972,631,577,54,0,624,7,1050,419,265,359
28,"MUREŞ","#N/A",116046,,307,"HĂDĂRENI / Camin cultural Hadareni",3,10987,"CHEŢANI",116046,669,399,321,78,0,397,2,750,351,96,301
28,"MUREŞ","#N/A",120478,,308,"CHIBED / PRIMĂRIA COMUNEI CHIBED",3,10995,"CHIBED",120478,1372,431,400,31,0,425,6,1500,1069,89,336
28,"MUREŞ","#N/A",116126,,309,"URISIU DE SUS / Caminul cultural",3,10997,"CHIHERU DE JOS",116126,366,265,235,30,0,261,4,400,135,135,126
28,"MUREŞ","#N/A",116126,,310,"CHIHERU DE SUS / Scoala generala",3,10997,"CHIHERU DE JOS",116126,304,174,139,35,0,170,4,348,174,71,99
28,"MUREŞ","#N/A",116126,,311,"URISIU DE JOS / Scoala generala",3,10997,"CHIHERU DE JOS",116126,267,191,171,19,1,190,1,299,108,70,120
28,"MUREŞ","#N/A",116126,,312,"CHIHERU DE JOS / Sediul Primariei comunei",3,10997,"CHIHERU DE JOS",116126,339,254,216,38,0,253,1,400,146,130,123
28,"MUREŞ","#N/A",116171,,313,"COROISÎNMĂRTIN / Scoala generala Coroisinmartin",3,11002,"COROISÎNMĂRTIN",116171,336,190,153,37,0,188,2,399,209,47,141
28,"MUREŞ","#N/A",116171,,314,"ŞOIMUŞ / Scoala generala Soimus",3,11002,"COROISÎNMĂRTIN",116171,336,212,184,28,0,209,3,401,189,85,124
28,"MUREŞ","#N/A",116171,,315,"ODRIHEI / Caminul Cultural Odrihei",3,11002,"COROISÎNMĂRTIN",116171,388,227,201,26,0,224,3,450,223,117,107
28,"MUREŞ","#N/A",116171,,316,"COROI / Scoala generala Coroi",3,11002,"COROISÎNMĂRTIN",116171,97,77,44,33,0,77,0,150,73,27,50
28,"MUREŞ","#N/A",120487,,317,"CORUNCA / CAMINUL CULTURAL",3,11007,"CORUNCA",120487,1174,815,742,73,0,803,12,1250,435,173,630
28,"MUREŞ","#N/A",120487,,318,"BOZENI / SCOALA GENERALA",3,11007,"CORUNCA",120487,99,71,52,19,0,69,2,150,79,16,53
28,"MUREŞ","#N/A",120487,,319,"CORUNCA / SEDIUL PRIMARIEI",3,11007,"CORUNCA",120487,985,460,406,54,0,455,5,1049,589,94,361
28,"MUREŞ","#N/A",116224,,320,"SOCOLU DE CÎMPIE / CAMIN CULTURAL",3,11010,"COZMA",116224,120,78,60,15,3,78,0,150,72,22,56
28,"MUREŞ","#N/A",116224,,321,"COZMA / PRIMARIA COZMA",3,11010,"COZMA",116224,338,239,195,32,12,239,0,400,161,43,196
28,"MUREŞ","#N/A",116288,,322,"CRĂCIUNEŞTI / CĂMIN CULTURAL CRĂCIUNEŞTI sala mică",3,11016,"CRĂCIUNEŞTI",116288,1046,232,208,24,0,227,5,1151,919,74,153
28,"MUREŞ","#N/A",116288,,323,"CRĂCIUNEŞTI / CĂMINUL CULTURAL CRĂCIUNEŞTI sala mare",3,11016,"CRĂCIUNEŞTI",116288,752,347,308,39,0,345,2,800,453,57,288
28,"MUREŞ","#N/A",116288,,324,"CORNEŞTI / CĂMINUL CULTURAL CORNEŞTI",3,11016,"CRĂCIUNEŞTI",116288,711,404,373,31,0,390,14,800,396,167,223
28,"MUREŞ","#N/A",116288,,325,"CINTA / ŞCOALA GENERALĂ CINTA",3,11016,"CRĂCIUNEŞTI",116288,419,234,211,23,0,231,3,449,215,41,190
28,"MUREŞ","#N/A",116288,,326,"BUDIU MIC / ŞCOALA GENERALĂ BUDIU MIC",3,11016,"CRĂCIUNEŞTI",116288,294,134,102,32,0,133,1,350,216,45,88
28,"MUREŞ","#N/A",116340,,327,"CRĂIEŞTI / PRIMARIA  COMUNEI CRAIESTI",3,11025,"CRĂIEŞTI",116340,533,333,294,23,16,331,2,600,267,81,250
28,"MUREŞ","#N/A",116340,,328,"MILĂŞEL / ŞCOALA GENERALĂ MILĂŞEL",3,11025,"CRĂIEŞTI",116340,154,105,82,15,8,105,0,200,95,40,65
28,"MUREŞ","#N/A",116340,,329,"LEFAIA / ŞCOALA GENERALĂ LEFAIA",3,11025,"CRĂIEŞTI",116340,56,45,32,13,0,45,0,100,55,15,30
28,"MUREŞ","#N/A",114355,,330,"VĂLURENI / CĂMINUL CULTURAL",3,11030,"CRISTEŞTI",114355,815,343,322,21,0,340,3,900,557,67,273
28,"MUREŞ","#N/A",114355,,331,"CRISTEŞTI / PRIMARIA",3,11030,"CRISTEŞTI",114355,1424,809,737,69,3,804,5,1549,740,261,543
28,"MUREŞ","#N/A",114355,,332,"CRISTEŞTI / PRIMĂRIE",3,11030,"CRISTEŞTI",114355,1328,821,767,54,0,819,2,1450,629,217,602
28,"MUREŞ","#N/A",114355,,333,"CRISTEŞTI / ŞCOALA GIMNAZIALA CRISTEŞTI",3,11030,"CRISTEŞTI",114355,1464,787,736,51,0,785,2,1550,763,213,572
28,"MUREŞ","#N/A",116395,,334,"CUCERDEA / PRIMARIA Cucerdea",3,11033,"CUCERDEA",116395,635,369,319,50,0,366,3,700,331,158,208
28,"MUREŞ","#N/A",116395,,335,"ŞEULIA DE MUREŞ / ŞCOALA GENERALĂ ŞEULIA DE MUREŞ",3,11033,"CUCERDEA",116395,479,312,267,45,0,308,4,550,238,136,172
28,"MUREŞ","#N/A",116395,,336,"BORD / CĂMIN CULTURAL BORD",3,11033,"CUCERDEA",116395,116,76,62,14,0,75,1,150,74,27,48
28,"MUREŞ","#N/A",116439,,337,"OROSIA / Camin Cultural",3,11037,"CUCI",116439,144,122,99,18,5,117,5,199,77,70,47
28,"MUREŞ","#N/A",116439,,338,"PETRILACA / Cămin cultural",3,11037,"CUCI",116439,450,286,234,38,14,278,8,494,208,128,150
28,"MUREŞ","#N/A",116439,,339,"DĂTĂŞENI / Scoala Generala",3,11037,"CUCI",116439,290,200,159,40,1,198,2,356,156,80,118
28,"MUREŞ","#N/A",116439,,340,"CUCI / Primăria Cuci",3,11037,"CUCI",116439,690,469,432,34,3,465,4,750,281,205,260
28,"MUREŞ","#N/A",116493,,341,"DANEŞ / CĂMINUL CULTURAL DANES",3,11043,"DANEŞ",116493,991,596,533,63,0,591,5,1100,504,128,463
28,"MUREŞ","#N/A",116493,,342,"DANEŞ / CLUBUL TINERETULUI",3,11043,"DANEŞ",116493,942,607,542,65,0,590,17,1050,443,151,439
28,"MUREŞ","#N/A",116493,,343,"SELEUŞ / SCOALA GENERALA SELEUS",3,11043,"DANEŞ",116493,822,446,410,36,0,442,4,900,454,83,359
28,"MUREŞ","#N/A",116493,,344,"SELEUŞ / SCOALA GENERALA SELEUS",3,11043,"DANEŞ",116493,833,489,469,20,0,483,6,900,411,121,362
28,"MUREŞ","#N/A",116493,,345,"CRIŞ / ŞCOALA GENERALĂ CRIŞ",3,11043,"DANEŞ",116493,564,272,246,26,0,271,1,600,328,70,201
28,"MUREŞ","#N/A",116493,,346,"STEJĂRENII / PUNCT SANITAR  STEJARENII",3,11043,"DANEŞ",116493,264,120,94,26,0,115,5,300,180,40,75
28,"MUREŞ","#N/A",116545,,347,"BISTRA MUREŞULUI / şcoala generală",3,11048,"DEDA",116545,872,632,559,73,0,627,5,950,318,331,296
28,"MUREŞ","#N/A",116545,,348,"FILEA / ŞCOALA GENERALĂ",3,11048,"DEDA",116545,596,421,379,28,14,416,5,650,229,259,157
28,"MUREŞ","#N/A",116545,,349,"PIETRIŞ / ŞCOALA GENERALĂ",3,11048,"DEDA",116545,393,310,264,44,2,308,2,451,141,127,181
28,"MUREŞ","#N/A",116545,,350,"DEDA / cămin cultural",3,11048,"DEDA",116545,1530,1094,1004,85,5,1079,15,1650,556,577,502
28,"MUREŞ","#N/A",116590,,351,"EREMITU / Şcoala generală",3,11053,"EREMITU",116590,1447,587,524,63,0,574,13,1550,963,106,468
28,"MUREŞ","#N/A",116590,,352,"CĂLUGĂRENI / Şcoala generală",3,11053,"EREMITU",116590,468,151,121,30,0,148,3,550,399,43,105
28,"MUREŞ","#N/A",116590,,353,"CÎMPU CETĂŢII / Şcoala generală",3,11053,"EREMITU",116590,312,161,122,39,0,159,2,350,189,40,119
28,"MUREŞ","#N/A",116590,,354,"DĂMIENI / Şcoala generală",3,11053,"EREMITU",116590,189,89,68,21,0,86,3,248,159,20,66
28,"MUREŞ","#N/A",116590,,355,"MĂTRICI / Şcoala generală",3,11053,"EREMITU",116590,683,241,208,33,0,237,4,750,509,36,201
28,"MUREŞ","#N/A",116652,,356,"ERNEI / Căminul cultural Ernei",3,11059,"ERNEI",116652,849,369,344,25,0,366,3,950,581,67,299
28,"MUREŞ","#N/A",116652,,357,"ERNEI / Sala de şedinţe - Primăria comunei Ernei",3,11059,"ERNEI",116652,964,430,398,32,0,420,10,1050,620,126,294
28,"MUREŞ","#N/A",116652,,358,"CĂLUŞERI / Căminul Cultural Căluşeri",3,11059,"ERNEI",116652,494,215,189,26,0,212,3,550,335,30,182
28,"MUREŞ","#N/A",116652,,359,"DUMBRĂVIOARA / Căminul Cultural Dumbrăvioara",3,11059,"ERNEI",116652,1439,568,518,50,0,563,5,1550,982,143,420
28,"MUREŞ","#N/A",116652,,360,"ICLAND / Căminul cultural Icland",3,11059,"ERNEI",116652,291,138,107,31,0,135,3,350,212,32,103
28,"MUREŞ","#N/A",116652,,361,"SĂCĂRENI / Scoala primară SĂCĂRENI",3,11059,"ERNEI",116652,197,98,65,33,0,95,3,251,153,21,74
28,"MUREŞ","#N/A",116652,,362,"SÎNGERU DE PĂDURE / Căminul cultural Sîngeru de Pădure",3,11059,"ERNEI",116652,323,114,102,12,0,111,3,350,236,49,62
28,"MUREŞ","#N/A",116723,,363,"FĂRĂGĂU / SEDIU PRIMARIE",3,11066,"FĂRĂGĂU",116723,409,323,254,65,4,316,7,450,127,176,140
28,"MUREŞ","#N/A",116723,,364,"POARTA / CLADIRE FOSTUL CAP",3,11066,"FĂRĂGĂU",116723,187,151,110,40,1,150,1,200,49,81,69
28,"MUREŞ","#N/A",116723,,365,"TONCIU / SCOALA GENERALA TONCIU",3,11066,"FĂRĂGĂU",116723,686,452,428,24,0,442,10,750,298,343,99
28,"MUREŞ","#N/A",116796,,366,"FÎNTÎNELE / Şcoala Gimnazială Fîntînele",3,11073,"FÎNTÎNELE",116796,992,442,421,21,0,442,0,1100,658,43,399
28,"MUREŞ","#N/A",116796,,367,"FÎNTÎNELE / Şcoala Gimnazială Fîntînele",3,11073,"FÎNTÎNELE",116796,1003,413,388,25,0,413,0,1100,687,60,353
28,"MUREŞ","#N/A",116796,,368,"CĂLIMĂNEŞTI / Şcoala Gimnazială Călimăneşti",3,11073,"FÎNTÎNELE",116796,698,298,251,47,0,297,1,746,448,39,258
28,"MUREŞ","#N/A",116796,,369,"VIFOROASA / Şcoala Primară Viforoasa",3,11073,"FÎNTÎNELE",116796,696,343,316,27,0,342,1,749,406,32,310
28,"MUREŞ","#N/A",116796,,370,"BORDOŞIU / Şcoala Primară Bordoşiu",3,11073,"FÎNTÎNELE",116796,242,128,105,23,0,127,1,305,177,31,96
28,"MUREŞ","#N/A",116796,,371,"CIBU / Grădiniţa cu program Normal Cibu",3,11073,"FÎNTÎNELE",116796,94,56,27,29,0,53,3,100,44,12,41
28,"MUREŞ","#N/A",116796,,372,"ROUA / Şcoala Primară Roua",3,11073,"FÎNTÎNELE",116796,275,79,66,13,0,76,3,301,222,24,52
28,"MUREŞ","#N/A",116867,,373,"GĂLEŞTI / Şcoala Gimnazială ""Szentiváni Mihály""  Găleşti",3,11080,"GĂLEŞTI",116867,830,215,195,20,0,211,4,900,685,43,168
28,"MUREŞ","#N/A",116867,,374,"TROIŢA / Şcoala Gimnazială Troiţa",3,11080,"GĂLEŞTI",116867,604,219,203,16,0,213,6,650,431,72,141
28,"MUREŞ","#N/A",116867,,375,"MAIAD / Şcoala Primară Maiad",3,11080,"GĂLEŞTI",116867,253,106,83,23,0,105,1,300,194,22,83
28,"MUREŞ","#N/A",116867,,376,"SÂNVĂSII / Şcoala Primară Sânvăsii",3,11080,"GĂLEŞTI",116867,233,113,94,19,0,111,2,250,137,23,88
28,"MUREŞ","#N/A",116867,,377,"ADRIANU MARE / Şcoala Primară Adrianu Mare",3,11080,"GĂLEŞTI",116867,127,59,48,11,0,58,1,150,91,15,43
28,"MUREŞ","#N/A",116867,,378,"BEDENI / Căminul Cultural Bedeni",3,11080,"GĂLEŞTI",116867,131,59,43,16,0,59,0,150,91,17,42
28,"MUREŞ","#N/A",116938,,379,"GĂNEŞTI / Grădiniţa Găneşti",3,11088,"GĂNEŞTI",116938,953,538,510,27,1,534,4,1050,512,86,448
28,"MUREŞ","#N/A",116938,,380,"GĂNEŞTI / Şcoala generală Fogarasi Samuel",3,11088,"GĂNEŞTI",116938,819,479,454,23,2,478,1,900,421,64,414
28,"MUREŞ","#N/A",116938,,381,"PĂUCIŞOARA / Cămin Cultural Păucişoara",3,11088,"GĂNEŞTI",116938,215,109,95,14,0,109,0,241,132,21,88
28,"MUREŞ","#N/A",116938,,382,"SEUCA / Şcoala primară Seuca",3,11088,"GĂNEŞTI",116938,995,543,513,28,2,540,3,1100,557,86,454
28,"MUREŞ","#N/A",116983,,383,"GHEORGHE DOJA / CĂMIN CULTURAL GHEORGHE DOJA",3,11093,"GHEORGHE DOJA",116983,390,197,164,24,9,191,6,450,253,17,174
28,"MUREŞ","#N/A",116983,,384,"GHEORGHE DOJA / GRĂDINIŢA CU PROGRAM NORMAL GHEORGHE DOJA",3,11093,"GHEORGHE DOJA",116983,333,163,137,21,5,163,0,398,235,19,144
28,"MUREŞ","#N/A",116983,,385,"LEORDENI / CAMINUL CULTURAL LEORDENI",3,11093,"GHEORGHE DOJA",116983,306,201,159,36,6,198,3,347,146,33,165
28,"MUREŞ","#N/A",116983,,386,"SATU NOU / SCOALA GENERALA SATU NOU",3,11093,"GHEORGHE DOJA",116983,600,283,252,13,18,282,1,650,367,27,255
28,"MUREŞ","#N/A",116983,,387,"TIRIMIA / SCOALA GENERALA TIRIMIA",3,11093,"GHEORGHE DOJA",116983,661,330,287,43,0,329,1,750,420,92,237
28,"MUREŞ","#N/A",117042,,388,"GHINDARI / CAMIN CULTURAL",3,11099,"GHINDARI",117042,1203,395,367,28,0,383,12,1300,905,114,269
28,"MUREŞ","#N/A",117042,,389,"TREI SATE / CAMIN CULTURAL",3,11099,"GHINDARI",117042,965,340,312,28,0,333,7,1050,710,88,245
28,"MUREŞ","#N/A",117042,,390,"SOLOCMA / SCOALA GENERALA",3,11099,"GHINDARI",117042,270,110,93,17,0,110,0,300,190,30,80
28,"MUREŞ","#N/A",117042,,391,"ABUD / SCOALA GENERALA",3,11099,"GHINDARI",117042,121,55,39,16,0,55,0,143,88,4,51
28,"MUREŞ","#N/A",117113,,392,"GLODENI / SCOALA GIMNAZIALA",3,11105,"GLODENI",117113,864,330,308,22,0,326,4,950,620,178,148
28,"MUREŞ","#N/A",117113,,393,"GLODENI / Şcoala Gimnazială Glodeni",3,11105,"GLODENI",117113,1088,445,412,33,0,438,7,1200,755,93,345
28,"MUREŞ","#N/A",117113,,394,"MERIŞOR / Şcoala primară Merişor",3,11105,"GLODENI",117113,141,96,79,17,0,95,1,200,104,58,37
28,"MUREŞ","#N/A",117113,,395,"MOIŞA / Şcola primară Moişa",3,11105,"GLODENI",117113,215,143,126,17,0,141,2,248,105,64,77
28,"MUREŞ","#N/A",117113,,396,"PĂCURENI / Şcoala primară Păcureni",3,11105,"GLODENI",117113,190,106,89,17,0,104,2,250,144,19,85
28,"MUREŞ","#N/A",117113,,397,"PĂINGENI / Şcoala primară Păingeni",3,11105,"GLODENI",117113,317,156,136,20,0,153,3,350,194,39,114
28,"MUREŞ","#N/A",117177,,398,"ILIOARA / CAMIN CULTURAL",3,11111,"GORNEŞTI",117177,99,52,36,16,0,51,1,150,98,11,40
28,"MUREŞ","#N/A",117177,,399,"PĂDURENI / CAMIN CULTURAL",3,11111,"GORNEŞTI",117177,351,192,169,23,0,186,6,397,205,42,144
28,"MUREŞ","#N/A",117177,,400,"PETRILACA DE MUREŞ / CAMIN CULTURAL",3,11111,"GORNEŞTI",117177,356,171,146,25,0,167,4,399,228,55,112
28,"MUREŞ","#N/A",117177,,401,"TELEAC / SCOALA GENERALA",3,11111,"GORNEŞTI",117177,350,238,181,35,22,236,2,400,162,135,101
28,"MUREŞ","#N/A",117177,,402,"GORNEŞTI / SCOALA GIMNAZIALA TELEKI DOMOKOS",3,11111,"GORNEŞTI",117177,821,470,431,35,4,466,4,900,430,110,356
28,"MUREŞ","#N/A",117177,,403,"GORNEŞTI / GRADINITA CU PROGRAM NORMAL",3,11111,"GORNEŞTI",117177,821,424,380,37,7,424,0,898,474,102,322
28,"MUREŞ","#N/A",117177,,404,"PERIŞ / CAMIN CULTURAL PERIS",3,11111,"GORNEŞTI",117177,1516,716,679,35,2,710,6,1650,934,133,577
28,"MUREŞ","#N/A",117177,,405,"IARA DE MUREŞ / SCOALA GENERALA",3,11111,"GORNEŞTI",117177,259,126,98,28,0,123,3,303,177,38,85
28,"MUREŞ","#N/A",117275,,406,"GREBENIŞU DE CÎMPIE / CĂMIN CULTURAL GREBENISU DE CIMPIE",3,11121,"GREBENIŞU DE CÎMPIE",117275,1287,829,789,39,1,828,1,1400,571,369,459
28,"MUREŞ","#N/A",117319,,407,"GURGHIU / CĂMINUL CULTURAL GURGHIU",3,11125,"GURGHIU",117319,841,521,483,38,0,513,8,900,379,137,376
28,"MUREŞ","#N/A",117319,,408,"GURGHIU / CAMINUL CULTURAL GURGHIU",3,11125,"GURGHIU",117319,790,460,438,21,1,456,4,850,390,132,324
28,"MUREŞ","#N/A",117319,,409,"ADRIAN / CĂMINUL CULTURAL ADRIAN",3,11125,"GURGHIU",117319,240,174,141,33,0,172,2,296,122,36,136
28,"MUREŞ","#N/A",117319,,410,"CAŞVA / SCOALA GENERALA CASVA",3,11125,"GURGHIU",117319,667,428,380,47,1,423,5,750,322,123,300
28,"MUREŞ","#N/A",117319,,411,"COMORI / SCOALA GENERALA COMORI",3,11125,"GURGHIU",117319,165,118,89,29,0,117,1,204,86,48,69
28,"MUREŞ","#N/A",117319,,412,"GLĂJĂRIE / CAMINUL CULTURAL GLAJARIE",3,11125,"GURGHIU",117319,1426,760,719,41,0,750,10,1550,790,147,603
28,"MUREŞ","#N/A",117319,,413,"LARGA / SCOALA GENERALA LARGA",3,11125,"GURGHIU",117319,191,131,110,21,0,130,1,250,119,21,109
28,"MUREŞ","#N/A",117319,,414,"ORŞOVA / CAMINUL CULTURAL ORSOVA",3,11125,"GURGHIU",117319,693,456,417,39,0,449,7,750,294,121,328
28,"MUREŞ","#N/A",117426,,415,"HODAC / Caminul Cultural Hodac",3,11136,"HODAC",117426,986,587,559,27,1,583,4,1050,463,203,380
28,"MUREŞ","#N/A",117426,,416,"HODAC / Scoala Generala Hodac",3,11136,"HODAC",117426,1086,702,658,43,1,697,5,1200,498,237,460
28,"MUREŞ","#N/A",117426,,417,"TOACA / GRĂDINIŢA TOACA",3,11136,"HODAC",117426,660,449,430,19,0,445,4,700,251,126,319
28,"MUREŞ","#N/A",117426,,418,"DUBIŞTEA DE PĂDURE / Scoala generală  DUBIŞTEA DE PĂDURE",3,11136,"HODAC",117426,352,251,234,17,0,249,2,402,151,105,144
28,"MUREŞ","#N/A",117426,,419,"TOACA / CĂMINUL CULTURAL TOACA",3,11136,"HODAC",117426,883,599,571,26,2,597,2,950,351,198,399
28,"MUREŞ","#N/A",117505,,420,"HODOŞA / Şcoala elementară Hodoşa",3,11144,"HODOŞA",117505,162,103,91,12,0,102,1,202,99,33,69
28,"MUREŞ","#N/A",117505,,421,"IHOD / Şcoala elementară Ihod",3,11144,"HODOŞA",117505,91,58,45,13,0,55,3,102,44,11,44
28,"MUREŞ","#N/A",117505,,422,"ISLA / Şcoala elementară",3,11144,"HODOŞA",117505,231,111,89,22,0,109,2,250,139,31,78
28,"MUREŞ","#N/A",117505,,423,"SÎMBRIAŞ / Şcoala elementară",3,11144,"HODOŞA",117505,518,242,218,24,0,240,2,538,296,42,198
28,"MUREŞ","#N/A",117550,,424,"IBĂNEŞTI / GRADINITA IBANESTI",3,11149,"IBĂNEŞTI",117550,1321,914,857,55,2,904,10,1450,536,463,441
28,"MUREŞ","#N/A",117550,,425,"IBĂNEŞTI / SALĂ MANIFESTĂRI ISTICEU",3,11149,"IBĂNEŞTI",117550,488,349,321,27,1,346,3,547,198,157,189
28,"MUREŞ","#N/A",117550,,426,"IBĂNEŞTI-PĂDURE / GRADINITA CU PROGRAM PRELUNGIT IBANESTI PADURE",3,11149,"IBĂNEŞTI",117550,809,560,524,36,0,551,9,900,340,227,324
28,"MUREŞ","#N/A",117550,,427,"DULCEA / CĂMIN  CULTURAL DULCEA",3,11149,"IBĂNEŞTI",117550,906,666,620,46,0,660,6,998,332,299,361
28,"MUREŞ","#N/A",117667,,428,"ICLĂNZEL / CAMINUL CULTURAL",3,11160,"ICLĂNZEL",117667,1064,612,560,52,0,611,1,1150,538,254,357
28,"MUREŞ","#N/A",117667,,429,"CĂPUŞU DE CÎMPIE / CAMINUL CULTURAL",3,11160,"ICLĂNZEL",117667,637,409,330,53,26,401,8,700,291,168,233
28,"MUREŞ","#N/A",117783,,430,"IDECIU DE JOS /  Ideciu de Jos",3,11172,"IDECIU DE JOS",117783,819,529,443,75,11,527,2,900,371,201,326
28,"MUREŞ","#N/A",117783,,431,"IDECIU DE JOS / Ideciu de Sus",3,11172,"IDECIU DE JOS",117783,677,382,348,31,3,382,0,750,368,172,210
28,"MUREŞ","#N/A",117783,,432,"IDECIU DE JOS /  Deleni",3,11172,"IDECIU DE JOS",117783,254,165,144,21,0,164,1,301,136,96,68
28,"MUREŞ","#N/A",117925,,433,"IVĂNEŞTI / camin cultural",3,11176,"LIVEZENI",117925,332,178,153,25,0,174,4,398,220,49,125
28,"MUREŞ","#N/A",117925,,434,"POIENIŢA / camin cultural",3,11176,"LIVEZENI",117925,250,171,139,32,0,166,5,300,129,40,126
28,"MUREŞ","#N/A",117925,,435,"LIVEZENI / cămin cultural",3,11176,"LIVEZENI",117925,1595,952,877,75,0,934,18,1700,748,226,708
28,"MUREŞ","#N/A",117925,,436,"SÎNIŞOR / cămin cultural",3,11176,"LIVEZENI",117925,165,117,98,19,0,117,0,200,83,11,106
28,"MUREŞ","#N/A",117998,,437,"LUNCA / SEDIUL ADMINISTRATIV AL PRIMARIEI",3,11181,"LUNCA",117998,451,356,310,46,0,350,6,500,144,155,195
28,"MUREŞ","#N/A",117998,,438,"BĂIŢA / SCOALA PRIMARA BAITA",3,11181,"LUNCA",117998,646,423,399,24,0,420,3,700,277,171,249
28,"MUREŞ","#N/A",117998,,439,"FRUNZENI / ŞCOALA PRIMARA FRUNZENI",3,11181,"LUNCA",117998,344,236,199,37,0,233,3,400,164,105,128
28,"MUREŞ","#N/A",117998,,440,"LOGIG / ŞCOALA PRIMARA LOGIG",3,11181,"LUNCA",117998,339,216,189,27,0,213,3,400,184,111,102
28,"MUREŞ","#N/A",117998,,441,"SÎNTU / SCOALA PRIMARA SINTU",3,11181,"LUNCA",117998,275,220,196,24,0,217,3,300,80,61,156
28,"MUREŞ","#N/A",118058,,442,"LUNCA BRADULUI / CASA DE CULTURA LUNCA BRADULUI",3,11187,"LUNCA BRADULUI",118058,1286,667,617,47,3,662,5,1401,734,213,449
28,"MUREŞ","#N/A",118058,,443,"NEAGRA / SCOALA GENERALA SAT NEAGRA",3,11187,"LUNCA BRADULUI",118058,377,228,204,22,2,226,2,404,176,103,123
28,"MUREŞ","#N/A",120502,,444,"MĂDĂRAŞ / SEDIUL PRIMĂRIEI COMUNEI MĂDĂRAŞ",3,11191,"MĂDĂRAŞ",120502,1060,366,344,22,0,356,10,1150,784,103,253
28,"MUREŞ","#N/A",120502,,445,"MĂDĂRAŞ / ŞCOALA PRIMARĂ CU CLASELE I-IV FÂNAŢTELE MĂDĂRAŞULUI",3,11191,"MĂDĂRAŞ",120502,227,120,106,14,0,120,0,250,130,35,85
28,"MUREŞ","#N/A",118094,,446,"MĂGHERANI / Şcoala Gimnazială Măgherani",3,11194,"MĂGHERANI",118094,577,203,177,26,0,197,6,650,447,35,162
28,"MUREŞ","#N/A",118094,,447,"ŞILEA NIRAJULUI / Şcoala Primară Şilea Nirajului",3,11194,"MĂGHERANI",118094,346,130,118,12,0,130,0,397,267,43,87
28,"MUREŞ","#N/A",118094,,448,"TORBA / Grădiniţa cu program normal Torba",3,11194,"MĂGHERANI",118094,130,75,59,16,0,71,4,150,75,24,47
28,"MUREŞ","#N/A",118209,,449,"MICA / CAMIN CULTURAL",3,11198,"MICA",118209,588,308,275,32,1,305,3,647,339,89,216
28,"MUREŞ","#N/A",118209,,450,"CEUAŞ / CAMIN CULTURAL",3,11198,"MICA",118209,668,362,338,24,0,352,10,750,388,88,264
28,"MUREŞ","#N/A",118209,,451,"DEAJ / CAMIN CULTURAL",3,11198,"MICA",118209,1178,588,561,27,0,582,6,1304,716,278,304
28,"MUREŞ","#N/A",118209,,452,"HĂRĂNGLAB / CAMIN CULTURAL",3,11198,"MICA",118209,614,314,291,23,0,310,4,700,386,49,261
28,"MUREŞ","#N/A",118209,,453,"ŞOMOŞTELNIC / CAMIN CULTURAL",3,11198,"MICA",118209,208,105,79,26,0,105,0,250,145,52,53
28,"MUREŞ","#N/A",118209,,454,"ABUŞ / SCOALA GENERALA",3,11198,"MICA",118209,251,140,128,12,0,139,1,300,160,31,108
28,"MUREŞ","#N/A",118370,,455,"MIHEŞU DE CÎMPIE / CĂMINUL CULTURAL MIHEŞU DE CÎMPIE",3,11206,"MIHEŞU DE CÎMPIE",118370,1248,741,696,45,0,738,3,1350,609,327,411
28,"MUREŞ","#N/A",118370,,456,"RĂZOARE / CĂMINUL CULTURAL RĂZOARE",3,11206,"MIHEŞU DE CÎMPIE",118370,679,397,344,53,0,397,0,750,353,245,152
28,"MUREŞ","#N/A",118469,,457,"NADEŞ / SCOALA  GENERALA NADES CORPUL A",3,11215,"NADEŞ",118469,1198,573,538,34,1,566,7,1300,727,86,480
28,"MUREŞ","#N/A",118469,,458,"MĂGHERUŞ / SCOALA  GENERALA MAGHERUS",3,11215,"NADEŞ",118469,124,65,53,12,0,64,1,150,85,17,47
28,"MUREŞ","#N/A",118469,,459,"PIPEA / SCOALA GENERALA PIPEA",3,11215,"NADEŞ",118469,63,37,29,8,0,37,0,100,63,8,29
28,"MUREŞ","#N/A",118469,,460,"ŢIGMANDRU / SCOALA GENERALA TIGMANDRU",3,11215,"NADEŞ",118469,848,411,389,22,0,406,5,900,489,69,337
28,"MUREŞ","#N/A",118511,,461,"NEAUA / Şcoala Generală Neaua",3,11220,"NEAUA",118511,314,137,119,18,0,134,3,346,209,46,88
28,"MUREŞ","#N/A",118511,,462,"VĂDAŞ / Şcoala Generală Vădaş",3,11220,"NEAUA",118511,308,121,112,9,0,120,1,347,226,17,103
28,"MUREŞ","#N/A",118511,,463,"GHINEŞTI / Şcoala Generală Ghineşti",3,11220,"NEAUA",118511,226,100,77,23,0,97,3,250,150,25,72
28,"MUREŞ","#N/A",118511,,464,"SÎNSIMION / Căminul Cultural Sînsimion",3,11220,"NEAUA",118511,59,50,33,17,0,49,1,100,50,9,40
28,"MUREŞ","#N/A",118511,,465,"RIGMANI / Şcoala Generală Rigmani",3,11220,"NEAUA",118511,210,92,80,12,0,92,0,250,158,21,71
28,"MUREŞ","#N/A",118575,,466,"OGRA / CLUB CAMIN CULTURAL OGRA",3,11226,"OGRA",118575,1283,763,692,70,1,752,11,1400,637,232,520
28,"MUREŞ","#N/A",118575,,467,"DILEU VECHI / SCOALA GENERALA DILEU VECHI",3,11226,"OGRA",118575,148,89,73,16,0,89,0,200,111,29,60
28,"MUREŞ","#N/A",118575,,468,"GIULUŞ / ŞCOALA GENERALĂ GIULUŞ",3,11226,"OGRA",118575,123,82,71,11,0,82,0,150,68,40,42
28,"MUREŞ","#N/A",118575,,469,"LĂSCUD / ŞCOALA GENERALA LASCUD",3,11226,"OGRA",118575,193,125,100,25,0,124,1,250,125,29,95
28,"MUREŞ","#N/A",118575,,470,"VAIDEIU / SCOALA GENERALA VAIDEIU",3,11226,"OGRA",118575,113,76,57,19,0,76,0,150,74,29,47
28,"MUREŞ","#N/A",118637,,471,"PAPIU ILARIAN / CAMIN CULTURAL",3,11238,"PAPIU ILARIAN",118637,722,383,358,24,1,383,0,800,417,81,302
28,"MUREŞ","#N/A",118691,,472,"PĂNET / GRĂDINIŢA PĂNET",3,11232,"PĂNET",118691,1061,450,431,19,0,446,4,1150,700,51,395
28,"MUREŞ","#N/A",118691,,473,"PĂNET / SEDIUL PRIMĂRIEI COMUNEI PĂNET",3,11232,"PĂNET",118691,875,373,354,19,0,361,12,950,577,36,325
28,"MUREŞ","#N/A",118691,,474,"BERGHIA / CĂMINUL CULTURAL BERGHIA",3,11232,"PĂNET",118691,987,535,499,36,0,531,4,1050,515,78,453
28,"MUREŞ","#N/A",118691,,475,"CUIEŞD / ŞCOALA GENERALĂ CUIEŞD",3,11232,"PĂNET",118691,625,222,209,13,0,217,5,700,478,119,98
28,"MUREŞ","#N/A",118691,,476,"HĂRŢĂU / CĂMINUL CULTURAL HĂRŢĂU",3,11232,"PĂNET",118691,261,125,108,17,0,124,1,300,175,48,76
28,"MUREŞ","#N/A",118691,,477,"SÎNTIOANA DE MUREŞ / SINTIOANA DE MUREŞ",3,11232,"PĂNET",118691,1143,630,579,50,1,624,6,1250,620,101,523
28,"MUREŞ","#N/A",118753,,478,"PĂSĂRENI / Şcoala Gimnanzială ""Kiss Gergely"" Păsăreni",3,11244,"PĂSĂRENI",118753,721,387,362,23,2,382,5,800,413,51,331
28,"MUREŞ","#N/A",118753,,479,"GĂLĂŢENI / Cămin Cultural Gălăţeni, sat Gălăţeni",3,11244,"PĂSĂRENI",118753,574,245,216,29,0,244,1,646,401,57,187
28,"MUREŞ","#N/A",118753,,480,"BOLINTINENI / Cămin Cultural Bolintineni, Sat Bolintineni",3,11244,"PĂSĂRENI",118753,179,94,72,22,0,91,3,200,106,39,52
28,"MUREŞ","#N/A",118799,,481,"PETELEA / Fostul sediu al Postei Romane",3,11248,"PETELEA",118799,1027,479,463,16,0,466,13,1100,621,246,220
28,"MUREŞ","#N/A",118799,,482,"PETELEA / Sediul Primariei",3,11248,"PETELEA",118799,888,502,452,49,1,502,0,950,448,204,298
28,"MUREŞ","#N/A",118799,,483,"HABIC / Scoala Generala Habic",3,11248,"PETELEA",118799,222,121,101,20,0,119,2,250,129,45,74
28,"MUREŞ","#N/A",118824,,484,"POGĂCEAUA / Primăria comunei Pogăceaua",3,11251,"POGĂCEAUA",118824,1046,686,649,37,0,682,4,1150,464,196,486
28,"MUREŞ","#N/A",118824,,485,"VĂLENI / Căminul cultural  Văleni",3,11251,"POGĂCEAUA",118824,421,271,226,45,0,268,3,450,179,107,161
28,"MUREŞ","#N/A",118931,,486,"RĂSTOLIŢA / Căminul Cultural Răstoliţa",3,11262,"RĂSTOLIŢA",118931,1496,1060,897,161,2,1050,10,1600,540,376,674
28,"MUREŞ","#N/A",118995,,487,"SÎNMĂRTINU DE CÎMPIE / CĂMINUL CULTURAL",3,11268,"RÎCIU",118995,743,509,440,69,0,503,6,800,291,138,365
28,"MUREŞ","#N/A",118995,,488,"NIMA RÎCIULUI / CĂMINUL CULTURAL",3,11268,"RÎCIU",118995,141,113,83,30,0,111,2,150,37,42,69
28,"MUREŞ","#N/A",118995,,489,"ULIEŞ / ŞCOALA GENERALĂ",3,11268,"RÎCIU",118995,622,361,326,35,0,358,3,700,339,143,215
28,"MUREŞ","#N/A",118995,,490,"RÎCIU / Casa de Cultura Vasile Contiu",3,11268,"RÎCIU",118995,1348,882,813,69,0,869,13,1450,568,274,595
28,"MUREŞ","#N/A",119153,,491,"RUŞII-MUNŢI / CĂMINUL CULTURAL",3,11284,"RUŞII-MUNŢI",119153,1280,813,752,55,6,805,8,1395,582,433,372
28,"MUREŞ","#N/A",119153,,492,"MAIOREŞTI / CĂMINUL CULTURAL",3,11284,"RUŞII-MUNŢI",119153,190,143,123,20,0,142,1,255,112,61,81
28,"MUREŞ","#N/A",119153,,493,"MORĂRENI / SCOALA GENERALĂ",3,11284,"RUŞII-MUNŢI",119153,315,233,211,22,0,230,3,350,117,141,89
28,"MUREŞ","#N/A",119206,,494,"SASCHIZ / Gimnaziul de Stat Ion Dacian",3,11299,"SASCHIZ",119206,1348,713,648,65,0,706,7,1450,737,290,416
28,"MUREŞ","#N/A",119206,,495,"MIHAI VITEAZU / Camin Cultural Mihai Viteazu",3,11299,"SASCHIZ",119206,258,176,140,36,0,175,1,299,123,94,81
28,"MUREŞ","#N/A",119206,,496,"CLOAŞTERF / Caminul Cultural Cloasterf",3,11299,"SASCHIZ",119206,152,92,72,20,0,91,1,200,108,36,55
28,"MUREŞ","#N/A",120496,,497,"SĂRĂŢENI / Caminul Cultural Sarateni",3,11297,"SĂRĂŢENI",120496,1089,454,384,70,0,446,8,1200,746,157,289
28,"MUREŞ","#N/A",119386,,498,"SÂNGER / GRADINITA CU PROGRAM NORMAL SANGER",3,11289,"SÂNGER",119386,1273,725,666,59,0,720,5,1350,625,197,523
28,"MUREŞ","#N/A",119386,,499,"CIPĂIENI / CAMINUL CULTURAL CIPAIENI",3,11289,"SÂNGER",119386,638,371,346,25,0,370,1,700,329,144,226
28,"MUREŞ","#N/A",114382,,500,"SÎNCRAIU DE MUREŞ / CAMIN CULTURAL SINCRAIU DE MURES",3,11313,"SÎNCRAIU DE MUREŞ",114382,1247,802,724,78,0,789,13,1350,548,194,595
28,"MUREŞ","#N/A",114382,,501,"SÎNCRAIU DE MUREŞ / PRIMĂRIA SINCRAIU DE MURES",3,11313,"SÎNCRAIU DE MUREŞ",114382,1547,1010,884,126,0,1002,8,1650,640,288,714
28,"MUREŞ","#N/A",114382,,502,"SÎNCRAIU DE MUREŞ / FOSTUL CĂMIN CULTURAL SINCRAIU DE MURES",3,11313,"SÎNCRAIU DE MUREŞ",114382,1857,1015,948,67,0,1004,11,2000,985,322,682
28,"MUREŞ","#N/A",114382,,503,"NAZNA / Căminul Cultural Nazna",3,11313,"SÎNCRAIU DE MUREŞ",114382,1079,686,638,48,0,675,11,1150,464,225,450
28,"MUREŞ","#N/A",114382,,504,"NAZNA / Scoala Generala Nazna",3,11313,"SÎNCRAIU DE MUREŞ",114382,851,629,559,70,0,625,4,900,271,224,401
28,"MUREŞ","#N/A",114417,,505,"SÎNGEORGIU DE MUREŞ / Căminul cultural",3,11316,"SÎNGEORGIU DE MUREŞ",114417,1067,617,564,53,0,604,13,1150,533,167,437
28,"MUREŞ","#N/A",114417,,506,"SÎNGEORGIU DE MUREŞ / Căminul cultural",3,11316,"SÎNGEORGIU DE MUREŞ",114417,1390,864,792,72,0,851,13,1500,636,217,634
28,"MUREŞ","#N/A",114417,,507,"COTUŞ / Şcoala generală",3,11316,"SÎNGEORGIU DE MUREŞ",114417,383,206,184,18,4,201,5,450,244,85,116
28,"MUREŞ","#N/A",114417,,508,"SÎNGEORGIU DE MUREŞ / GRADINITA CU PROGRAM PRELUNGIT ""BAMBI""",3,11316,"SÎNGEORGIU DE MUREŞ",114417,1455,848,791,55,2,834,14,1550,702,191,643
28,"MUREŞ","#N/A",114417,,509,"SÎNGEORGIU DE MUREŞ / Gimnaziul ""Sf. Gheorghe""",3,11316,"SÎNGEORGIU DE MUREŞ",114417,1168,624,578,46,0,619,5,1250,626,184,435
28,"MUREŞ","#N/A",114417,,510,"SÎNGEORGIU DE MUREŞ / Gimnaziul ""Sf. Gheorghe""",3,11316,"SÎNGEORGIU DE MUREŞ",114417,1270,671,619,52,0,664,7,1350,679,169,495
28,"MUREŞ","#N/A",114417,,511,"SÎNGEORGIU DE MUREŞ / Gimnaziul ""Sf. Gheorghe""",3,11316,"SÎNGEORGIU DE MUREŞ",114417,1215,728,670,58,0,725,3,1300,572,139,586
28,"MUREŞ","#N/A",119466,,512,"SÎNPAUL / CĂMINUL CULTURAL",3,11320,"SÎNPAUL",119466,1369,795,719,60,16,783,12,1500,705,398,385
28,"MUREŞ","#N/A",119466,,513,"CHIRILEU / CĂMINUL CULTURAL",3,11320,"SÎNPAUL",119466,621,434,373,59,2,429,5,700,266,239,190
28,"MUREŞ","#N/A",119466,,514,"DILEU NOU / CĂMINUL CULTURAL",3,11320,"SÎNPAUL",119466,134,95,70,15,10,94,1,150,55,54,40
28,"MUREŞ","#N/A",119466,,515,"SÎNMĂRGHITA / CĂMINUL CULTURAL",3,11320,"SÎNPAUL",119466,199,134,112,22,0,132,2,250,116,58,74
28,"MUREŞ","#N/A",119466,,516,"VALEA IZVOARELOR / CĂMINUL CULTURAL",3,11320,"SÎNPAUL",119466,937,628,542,37,49,617,11,998,370,309,308
28,"MUREŞ","#N/A",119527,,517,"SÎNPETRU DE CÎMPIE / Căminul Cultural Sînpetru de Cîmpie",3,11326,"SÎNPETRU DE CÎMPIE",119527,847,490,435,55,0,488,2,950,460,212,276
28,"MUREŞ","#N/A",119527,,518,"BÎRLIBAŞ / Căminul Cultural Bîrlibaş",3,11326,"SÎNPETRU DE CÎMPIE",119527,88,68,42,25,1,67,1,100,32,29,38
28,"MUREŞ","#N/A",119527,,519,"DÎMBU / Căminul Cultural Dîmbu",3,11326,"SÎNPETRU DE CÎMPIE",119527,468,291,260,31,0,287,4,500,209,176,111
28,"MUREŞ","#N/A",119527,,520,"SATU NOU / Şcoala Gen.  Satu -Nou",3,11326,"SÎNPETRU DE CÎMPIE",119527,150,97,73,24,0,97,0,200,103,38,59
28,"MUREŞ","#N/A",119527,,521,"SÎNGEORGIU DE CÎMPIE / Căminul Cultural Sîngeorgiu de Cîmpie",3,11326,"SÎNPETRU DE CÎMPIE",119527,285,191,163,24,4,187,4,349,158,114,73
28,"MUREŞ","#N/A",119527,,522,"TUŞINU / Căminul Cultural Tuşinu",3,11326,"SÎNPETRU DE CÎMPIE",119527,448,251,203,48,0,246,5,498,247,104,142
28,"MUREŞ","#N/A",114453,,523,"SÎNTANA DE MUREŞ / ŞCOALA GENERALĂ ION CHINEZU",3,11333,"SÎNTANA DE MUREŞ",114453,1302,884,814,68,2,871,13,1400,516,262,609
28,"MUREŞ","#N/A",114453,,524,"SÎNTANA DE MUREŞ / ŞCOALA GENERALĂ ION CHINEZU",3,11333,"SÎNTANA DE MUREŞ",114453,1345,886,829,57,0,873,13,1450,564,266,607
28,"MUREŞ","#N/A",114453,,525,"CURTENI / Şcoala Generală din Curteni",3,11333,"SÎNTANA DE MUREŞ",114453,798,484,446,38,0,480,4,850,366,52,428
28,"MUREŞ","#N/A",114453,,526,"CHINARI / GRĂDINIŢA DIN CHINARI",3,11333,"SÎNTANA DE MUREŞ",114453,574,395,366,28,1,389,6,650,255,81,308
28,"MUREŞ","#N/A",114453,,527,"BĂRDEŞTI / ŞCOALA GENERALĂ DIN BĂRDEŞTI",3,11333,"SÎNTANA DE MUREŞ",114453,386,296,242,48,6,293,3,450,154,122,171
28,"MUREŞ","#N/A",119590,,528,"SOLOVĂSTRU / SOLOVASTRU",3,11338,"SOLOVĂSTRU",119590,1408,885,824,61,0,876,9,1500,615,357,519
28,"MUREŞ","#N/A",119590,,529,"JABENIŢA / JABENITA",3,11338,"SOLOVĂSTRU",119590,950,592,548,44,0,585,7,1050,458,237,348
28,"MUREŞ","#N/A",119625,,530,"STÎNCENI / Camin cultural Stanceni",3,11341,"STÎNCENI",119625,1219,779,721,58,0,771,8,1300,521,301,470
28,"MUREŞ","#N/A",119661,,531,"SUPLAC / Scoala generala Suplac",3,11345,"SUPLAC",119661,648,329,305,23,1,323,6,699,370,97,226
28,"MUREŞ","#N/A",119661,,532,"IDRIFAIA / Scoala generala Bordi Andras Idrifaia",3,11345,"SUPLAC",119661,512,342,308,34,0,340,2,550,208,86,254
28,"MUREŞ","#N/A",119661,,533,"LASLĂU MARE / Scoala generala Sf.Nicolae Laslau Mare",3,11345,"SUPLAC",119661,322,231,195,36,0,229,2,350,119,125,104
28,"MUREŞ","#N/A",119661,,534,"LASLĂU MIC / Şcoala Generală Laslău Mic",3,11345,"SUPLAC",119661,403,175,152,23,0,174,1,450,275,47,127
28,"MUREŞ","#N/A",119723,,535,"SUSENI / Scoala generala",3,11351,"SUSENI",119723,1336,775,726,48,1,770,5,1450,675,149,621
28,"MUREŞ","#N/A",119723,,536,"LUIERIU / Scoala generala",3,11351,"SUSENI",119723,561,405,360,45,0,404,1,600,195,198,206
28,"MUREŞ","#N/A",119750,,537,"ŞĂULIA / Caminul Cultural Saulia",3,11303,"ŞĂULIA",119750,1328,807,711,87,9,800,7,1449,642,441,359
28,"MUREŞ","#N/A",119750,,538,"ŞĂULIA / Clubul Tineretului Saulia",3,11303,"ŞĂULIA",119750,249,187,134,53,0,185,2,300,113,90,95
28,"MUREŞ","#N/A",119803,,539,"ŞINCAI / CONSILIUL LOCALSINCAI",3,11308,"ŞINCAI",119803,874,465,407,58,0,461,4,950,485,140,321
28,"MUREŞ","#N/A",119803,,540,"LECHINCIOARA / SCOALA GENERALA SINCAI - LECHINCIOARA",3,11308,"ŞINCAI",119803,79,66,42,24,0,66,0,100,34,36,30
28,"MUREŞ","#N/A",119803,,541,"PUSTA / SCOALA GENERALA SINCAI - PUSTA",3,11308,"ŞINCAI",119803,100,82,65,17,0,82,0,150,68,50,32
28,"MUREŞ","#N/A",119803,,542,"ŞINCAI-FÎNAŢE / SCOALA GENERALA SINCAI FINATE",3,11308,"ŞINCAI",119803,180,102,89,13,0,98,4,200,98,40,58
28,"MUREŞ","#N/A",119858,,543,"TĂURENI / PRIMĂRIA TĂURENI",3,11354,"TĂURENI",119858,751,578,488,70,20,573,5,800,222,382,191
28,"MUREŞ","#N/A",119974,,544,"VALEA LARGĂ / PRIMARIA COMUNEI VALEA LARGA",3,11358,"VALEA LARGĂ",119974,1133,492,461,31,0,492,0,1254,762,159,333
28,"MUREŞ","#N/A",119974,,545,"VALEA LARGĂ / CĂMINUL CULTURAL VALEA LARGA",3,11358,"VALEA LARGĂ",119974,922,400,361,39,0,398,2,1000,600,154,244
28,"MUREŞ","#N/A",119974,,546,"VALEA FRĂŢIEI / ŞCOALA GENERALĂ CLASELE I-IV VALEA FRĂŢIEI",3,11358,"VALEA LARGĂ",119974,513,241,217,24,0,241,0,550,309,59,182
28,"MUREŞ","#N/A",120076,,547,"VĂRGATA / Şcoala Gimnazială Vargata",3,11368,"VĂRGATA",120076,648,253,225,23,5,247,6,700,447,44,203
28,"MUREŞ","#N/A",120076,,548,"GRÎUŞORUL / Camin cultural Griusorul",3,11368,"VĂRGATA",120076,140,55,32,18,5,54,1,150,95,14,40
28,"MUREŞ","#N/A",120076,,549,"VADU / Camin cultural Vadu",3,11368,"VĂRGATA",120076,213,114,97,15,2,109,5,245,131,33,76
28,"MUREŞ","#N/A",120076,,550,"VALEA / Şcola primară Valea",3,11368,"VĂRGATA",120076,527,262,228,22,12,259,3,600,338,45,214
28,"MUREŞ","#N/A",120138,,551,"VĂTAVA / CAMINUL CULTURAL VATAVA",3,11374,"VĂTAVA",120138,649,456,425,31,0,454,2,700,244,128,326
28,"MUREŞ","#N/A",120138,,552,"DUMBRAVA / SCOALA GENERALA DUMBRAVA",3,11374,"VĂTAVA",120138,565,378,341,36,1,375,3,650,272,203,172
28,"MUREŞ","#N/A",120138,,553,"RÎPA DE JOS / SCOALA GENERALA RÎPA DE JOS",3,11374,"VĂTAVA",120138,391,307,269,34,4,304,3,450,143,113,191
28,"MUREŞ","#N/A",120174,,554,"VEŢCA / Căminul Cultural Veţca",3,11378,"VEŢCA",120174,411,195,162,33,0,193,2,450,255,24,169
28,"MUREŞ","#N/A",120174,,555,"JACODU / Căminul Cultural Jacodu",3,11378,"VEŢCA",120174,213,107,75,32,0,105,2,250,143,38,67
28,"MUREŞ","#N/A",120218,,556,"VIIŞOARA / Primaria Viisoara",3,11382,"VIIŞOARA",120218,578,298,279,18,1,296,2,649,351,100,196
28,"MUREŞ","#N/A",120218,,557,"SÎNTIOANA / Scoala Generala Cls I-VIII Santioana",3,11382,"VIIŞOARA",120218,417,238,224,14,0,238,0,449,211,46,192
28,"MUREŞ","#N/A",120218,,558,"ORMENIŞ / Camin Cultural Ormenis",3,11382,"VIIŞOARA",120218,317,190,177,13,0,190,0,350,160,38,152
28,"MUREŞ","#N/A",120254,,559,"VÎNĂTORI / S.C. GEN. P. N. POPESCU",3,11386,"VÎNĂTORI",120254,1401,792,745,47,0,788,4,1500,708,404,384
28,"MUREŞ","#N/A",120254,,560,"ARCHITA / GRĂDINIŢA DE  COPII ARCHITA",3,11386,"VÎNĂTORI",120254,705,329,294,35,0,326,3,750,421,157,169
28,"MUREŞ","#N/A",120254,,561,"FELEAG / ŞCOALA GENERALĂ CLASELE  I-IV FELEAG",3,11386,"VÎNĂTORI",120254,173,139,100,39,0,138,1,200,61,64,74
28,"MUREŞ","#N/A",120254,,562,"MURENI / ŞCOALA GENERALĂ CLASELE I-IV MURENI",3,11386,"VÎNĂTORI",120254,283,202,157,45,0,202,0,300,98,34,168
28,"MUREŞ","#N/A",120254,,563,"ŞOARD / ŞCOALA GENERALĂ CLASELE I-IV ŞOARD",3,11386,"VÎNĂTORI",120254,563,339,305,34,0,331,8,650,311,165,166
28,"MUREŞ","#N/A",120316,,564,"VOIVODENI / Şcoala Gimnazială Voivodeni",3,11392,"VOIVODENI",120316,1328,704,631,64,9,694,10,1450,746,270,424
28,"MUREŞ","#N/A",120316,,565,"TOLDAL / Căminul Cultural Toldal",3,11392,"VOIVODENI",120316,179,125,90,29,6,125,0,200,75,72,53
28,"MUREŞ","#N/A",120343,,566,"ZAGĂR / PRIMARIA ZAGAR",3,11395,"ZAGĂR",120343,1007,463,434,29,0,461,2,1100,637,110,351
28,"MUREŞ","#N/A",120370,,567,"ZAU DE CÎMPIE / CAMIN CULTURAL aflat in administrarea Primariei",3,11398,"ZAU DE CÎMPIE",120370,998,544,501,34,9,541,3,1100,556,189,352
28,"MUREŞ","#N/A",120370,,568,"ZAU DE CÎMPIE / SCOALA GENERALA V-VIII",3,11398,"ZAU DE CÎMPIE",120370,1262,663,626,27,10,655,8,1350,687,203,452
28,"MUREŞ","#N/A",120370,,569,"BĂRBOŞI / SCOALA GEN I-VIII BARBOSI",3,11398,"ZAU DE CÎMPIE",120370,405,228,210,18,0,226,2,447,219,101,125
29,"NEAMŢ","#N/A",120726,,1,"PIATRA-NEAMŢ / Scoala nr. 3",1,11409,"MUNICIPIUL PIATRA-NEAMŢ",120726,1015,650,584,64,2,640,10,1100,450,295,345
29,"NEAMŢ","#N/A",120726,,2,"PIATRA-NEAMŢ / Scoala nr. 3",1,11409,"MUNICIPIUL PIATRA-NEAMŢ",120726,966,633,575,57,1,612,21,1100,467,297,315
29,"NEAMŢ","#N/A",120726,,3,"PIATRA-NEAMŢ / Grădiniţa cu orar prelungit nr. 6",1,11409,"MUNICIPIUL PIATRA-NEAMŢ",120726,1026,627,587,38,2,609,18,1100,473,326,283
29,"NEAMŢ","#N/A",120726,,4,"PIATRA-NEAMŢ / Colegiul Naţional ""Petru Rareş""",1,11409,"MUNICIPIUL PIATRA-NEAMŢ",120726,1373,739,698,39,2,724,15,1500,761,313,411
29,"NEAMŢ","#N/A",120726,,5,"PIATRA-NEAMŢ / Şcoala nr. 3",1,11409,"MUNICIPIUL PIATRA-NEAMŢ",120726,1181,653,606,46,1,642,11,1300,647,278,364
29,"NEAMŢ","#N/A",120726,,6,"PIATRA-NEAMŢ / Liceul de Arte Victor Brauner",1,11409,"MUNICIPIUL PIATRA-NEAMŢ",120726,1348,774,702,72,0,752,22,1500,726,294,458
29,"NEAMŢ","#N/A",120726,,7,"PIATRA-NEAMŢ / Colegiul Naţional ""Calistrat Hogaş""",1,11409,"MUNICIPIUL PIATRA-NEAMŢ",120726,960,624,594,29,1,610,14,1100,476,191,419
29,"NEAMŢ","#N/A",120726,,8,"PIATRA-NEAMŢ / Liceul Tehnologic ""Spiru Haret""",1,11409,"MUNICIPIUL PIATRA-NEAMŢ",120726,1355,776,747,29,0,752,24,1500,724,349,403
29,"NEAMŢ","#N/A",120726,,9,"PIATRA-NEAMŢ / Liceul Comercial ""Spiru Haret""",1,11409,"MUNICIPIUL PIATRA-NEAMŢ",120726,1174,735,649,86,0,721,14,1300,565,310,411
29,"NEAMŢ","#N/A",120726,,10,"PIATRA-NEAMŢ / Grădiniţa cu program prelungit nr. 3",1,11409,"MUNICIPIUL PIATRA-NEAMŢ",120726,1129,610,587,22,1,599,11,1300,690,293,306
29,"NEAMŢ","#N/A",120726,,11,"PIATRA-NEAMŢ / Liceul cu Program Sportiv",1,11409,"MUNICIPIUL PIATRA-NEAMŢ",120726,1385,778,720,58,0,756,22,1500,722,338,418
29,"NEAMŢ","#N/A",120726,,12,"PIATRA-NEAMŢ / Liceul cu Program Sportiv",1,11409,"MUNICIPIUL PIATRA-NEAMŢ",120726,1248,700,666,34,0,684,16,1400,700,313,371
29,"NEAMŢ","#N/A",120726,,13,"PIATRA-NEAMŢ / Scoala nr. 8",1,11409,"MUNICIPIUL PIATRA-NEAMŢ",120726,1367,754,698,56,0,730,24,1499,745,330,400
29,"NEAMŢ","#N/A",120726,,14,"PIATRA-NEAMŢ / Grădiniţa cuplată cu cresă nr. 5",1,11409,"MUNICIPIUL PIATRA-NEAMŢ",120726,1507,762,733,29,0,748,14,1700,938,307,441
29,"NEAMŢ","#N/A",120726,,15,"PIATRA-NEAMŢ / Grădiniţa cuplată cu cresă nr. 5",1,11409,"MUNICIPIUL PIATRA-NEAMŢ",120726,1083,539,514,25,0,524,15,1200,661,241,283
29,"NEAMŢ","#N/A",120726,,16,"PIATRA-NEAMŢ / Grădiniţa cu program normal nr. 8",1,11409,"MUNICIPIUL PIATRA-NEAMŢ",120726,945,482,458,24,0,473,9,1000,518,228,245
29,"NEAMŢ","#N/A",120726,,17,"PIATRA-NEAMŢ / Grădiniţa de pe lângă Şcoala nr. 11",1,11409,"MUNICIPIUL PIATRA-NEAMŢ",120726,1794,1158,1056,102,0,1144,14,1999,841,502,642
29,"NEAMŢ","#N/A",120726,,18,"PIATRA-NEAMŢ / ASE Bucureşti",1,11409,"MUNICIPIUL PIATRA-NEAMŢ",120726,1602,773,719,53,1,761,12,1800,1027,354,407
29,"NEAMŢ","#N/A",120726,,19,"PIATRA-NEAMŢ / Şcoala nr. 28",1,11409,"MUNICIPIUL PIATRA-NEAMŢ",120726,1489,767,728,38,1,753,14,1600,833,343,410
29,"NEAMŢ","#N/A",120726,,20,"PIATRA-NEAMŢ / Colegiul Naţional ""Gh. Asachi""",1,11409,"MUNICIPIUL PIATRA-NEAMŢ",120726,1038,464,433,31,0,455,9,1100,636,191,264
29,"NEAMŢ","#N/A",120726,,21,"PIATRA-NEAMŢ / Colegiul Naţional ""Gh. Asachi""",1,11409,"MUNICIPIUL PIATRA-NEAMŢ",120726,1054,477,455,16,6,470,7,1200,723,204,266
29,"NEAMŢ","#N/A",120726,,22,"PIATRA-NEAMŢ / Scoala nr. 5",1,11409,"MUNICIPIUL PIATRA-NEAMŢ",120726,1568,794,742,51,1,779,15,1700,906,382,397
29,"NEAMŢ","#N/A",120726,,23,"PIATRA-NEAMŢ / Scoala nr. 5",1,11409,"MUNICIPIUL PIATRA-NEAMŢ",120726,1483,878,825,51,2,863,15,1600,722,397,466
29,"NEAMŢ","#N/A",120726,,24,"PIATRA-NEAMŢ / Grădiniţa cuplată cu cresă nr. 12",1,11409,"MUNICIPIUL PIATRA-NEAMŢ",120726,1393,739,702,35,2,720,19,1500,761,360,360
29,"NEAMŢ","#N/A",120726,,25,"PIATRA-NEAMŢ / Grădiniţa cuplată cu cresă nr. 12",1,11409,"MUNICIPIUL PIATRA-NEAMŢ",120726,1347,712,682,29,1,707,5,1500,788,336,371
29,"NEAMŢ","#N/A",120726,,26,"PIATRA-NEAMŢ / Grădiniţa cuplată cu cresă nr. 12",1,11409,"MUNICIPIUL PIATRA-NEAMŢ",120726,1385,763,712,51,0,746,17,1500,737,333,413
29,"NEAMŢ","#N/A",120726,,27,"PIATRA-NEAMŢ / Şcoala nr. 8",1,11409,"MUNICIPIUL PIATRA-NEAMŢ",120726,1580,891,869,22,0,877,14,1700,809,466,411
29,"NEAMŢ","#N/A",120726,,28,"PIATRA-NEAMŢ / Centrul Social Pietricica",1,11409,"MUNICIPIUL PIATRA-NEAMŢ",120726,1609,892,845,47,0,864,28,1800,908,382,482
29,"NEAMŢ","#N/A",120726,,29,"PIATRA-NEAMŢ / Colegiul Naţional de Informatică",1,11409,"MUNICIPIUL PIATRA-NEAMŢ",120726,863,448,410,36,2,443,5,1000,552,196,247
29,"NEAMŢ","#N/A",120726,,30,"PIATRA-NEAMŢ / Colegiul Naţional de Informatică",1,11409,"MUNICIPIUL PIATRA-NEAMŢ",120726,1851,1005,969,35,1,977,28,2004,999,330,647
29,"NEAMŢ","#N/A",120726,,31,"PIATRA-NEAMŢ / Colegiul Naţional de Informatică",1,11409,"MUNICIPIUL PIATRA-NEAMŢ",120726,1705,896,849,46,1,870,26,1800,904,380,490
29,"NEAMŢ","#N/A",120726,,32,"PIATRA-NEAMŢ / Colegiul Naţional de Informatică",1,11409,"MUNICIPIUL PIATRA-NEAMŢ",120726,1457,841,793,48,0,815,26,1600,759,343,472
29,"NEAMŢ","#N/A",120726,,33,"PIATRA-NEAMŢ / Colegiul Naţional de Informatică",1,11409,"MUNICIPIUL PIATRA-NEAMŢ",120726,1078,454,428,26,0,448,6,1200,746,172,276
29,"NEAMŢ","#N/A",120726,,34,"PIATRA-NEAMŢ / Colegiul Naţional de Informatică",1,11409,"MUNICIPIUL PIATRA-NEAMŢ",120726,986,544,521,23,0,524,20,1100,556,225,299
29,"NEAMŢ","#N/A",120726,,35,"PIATRA-NEAMŢ / Scoala nr. 7",1,11409,"MUNICIPIUL PIATRA-NEAMŢ",120726,1514,863,800,57,6,852,11,1600,737,466,386
29,"NEAMŢ","#N/A",120726,,36,"VĂLENI / Centrul Social",1,11409,"MUNICIPIUL PIATRA-NEAMŢ",120726,1086,599,560,39,0,579,20,1200,601,239,340
29,"NEAMŢ","#N/A",120726,,37,"DOAMNA / Clădire Administrativă S.C. CMI URBAN S.A.",1,11409,"MUNICIPIUL PIATRA-NEAMŢ",120726,724,386,356,28,2,370,16,800,414,178,192
29,"NEAMŢ","#N/A",120726,,38,"DOAMNA / Şcoala nr. 2",1,11409,"MUNICIPIUL PIATRA-NEAMŢ",120726,1144,680,625,55,0,672,8,1200,520,311,361
29,"NEAMŢ","#N/A",120726,,39,"DOAMNA / Şcoala nr. 2",1,11409,"MUNICIPIUL PIATRA-NEAMŢ",120726,950,564,541,23,0,550,14,1000,436,237,313
29,"NEAMŢ","#N/A",120726,,40,"DOAMNA / Şcoala nr. 2",1,11409,"MUNICIPIUL PIATRA-NEAMŢ",120726,917,650,510,14,126,636,14,1600,950,366,270
29,"NEAMŢ","#N/A",120726,,41,"DOAMNA / Direcţia Agricolă",1,11409,"MUNICIPIUL PIATRA-NEAMŢ",120726,1450,868,819,45,4,844,24,1600,732,361,483
29,"NEAMŢ","#N/A",120726,,42,"DOAMNA / S.C. APA SERV S.A.",1,11409,"MUNICIPIUL PIATRA-NEAMŢ",120726,1179,758,688,69,1,739,19,1300,542,320,419
29,"NEAMŢ","#N/A",120726,,43,"DOAMNA / Complexul Expoziţional Municipal",1,11409,"MUNICIPIUL PIATRA-NEAMŢ",120726,1408,888,786,102,0,874,14,1500,612,362,512
29,"NEAMŢ","#N/A",120726,,44,"DOAMNA / Şcoala Elena Cuza",1,11409,"MUNICIPIUL PIATRA-NEAMŢ",120726,1512,907,806,101,0,876,31,1600,693,344,532
29,"NEAMŢ","#N/A",120726,,45,"DOAMNA / Şcoala Elena Cuza",1,11409,"MUNICIPIUL PIATRA-NEAMŢ",120726,1462,901,852,46,3,885,16,1600,699,406,479
29,"NEAMŢ","#N/A",120726,,46,"DOAMNA / SCOALA CU CLASELE I-VIII NICU ALBU",1,11409,"MUNICIPIUL PIATRA-NEAMŢ",120726,1281,664,636,28,0,657,7,1400,736,259,398
29,"NEAMŢ","#N/A",120726,,47,"DOAMNA / SCOALA CU CLASELE I-VIII NICU ALBU",1,11409,"MUNICIPIUL PIATRA-NEAMŢ",120726,1424,740,714,26,0,727,13,1500,760,295,432
29,"NEAMŢ","#N/A",120726,,48,"DOAMNA / SCOALA CU CLASELE I-VIII NICU ALBU",1,11409,"MUNICIPIUL PIATRA-NEAMŢ",120726,1289,650,630,20,0,630,20,1400,750,235,395
29,"NEAMŢ","#N/A",120726,,49,"DOAMNA / SCOALA CU CLASELE I-VIII NICU ALBU",1,11409,"MUNICIPIUL PIATRA-NEAMŢ",120726,1456,823,747,76,0,805,18,1600,777,308,497
29,"NEAMŢ","#N/A",120726,,50,"DOAMNA / Şcoala cu clasele I-VIII Nicu Albu",1,11409,"MUNICIPIUL PIATRA-NEAMŢ",120726,1481,750,701,48,1,726,24,1600,850,261,465
29,"NEAMŢ","#N/A",120726,,51,"DOAMNA / Şcoala cu clasele I-VIII Nicu Albu",1,11409,"MUNICIPIUL PIATRA-NEAMŢ",120726,1454,778,750,28,0,757,21,1600,822,293,464
29,"NEAMŢ","#N/A",120726,,52,"DOAMNA / Casa Corpului Didactic",1,11409,"MUNICIPIUL PIATRA-NEAMŢ",120726,1282,788,740,36,12,772,16,1400,612,362,410
29,"NEAMŢ","#N/A",120726,,53,"DOAMNA / Colegiul Tehnic de Transporturi",1,11409,"MUNICIPIUL PIATRA-NEAMŢ",120726,1238,635,597,27,11,624,11,1400,765,251,373
29,"NEAMŢ","#N/A",120726,,54,"DOAMNA / Colegiul Tehnic Forestier",1,11409,"MUNICIPIUL PIATRA-NEAMŢ",120726,1341,750,700,49,1,740,10,1500,750,297,443
29,"NEAMŢ","#N/A",120726,,55,"DOAMNA / Colegiul Tehnic Forestier",1,11409,"MUNICIPIUL PIATRA-NEAMŢ",120726,1395,874,811,63,0,862,12,1500,626,356,506
29,"NEAMŢ","#N/A",120726,,56,"DOAMNA / Liceul Tehnologic  Economic Administrativ",1,11409,"MUNICIPIUL PIATRA-NEAMŢ",120726,1456,866,829,35,2,852,14,1600,734,296,556
29,"NEAMŢ","#N/A",120726,,57,"DOAMNA / Scoala nr. 2",1,11409,"MUNICIPIUL PIATRA-NEAMŢ",120726,1233,716,668,47,1,698,18,1400,684,307,391
29,"NEAMŢ","#N/A",120726,,58,"DOAMNA / Scoala nr. 2",1,11409,"MUNICIPIUL PIATRA-NEAMŢ",120726,1401,786,733,53,0,774,12,1500,714,354,420
29,"NEAMŢ","#N/A",120726,,59,"DOAMNA / Colegiul Tehnic Gheorghe Cartianu",1,11409,"MUNICIPIUL PIATRA-NEAMŢ",120726,1444,963,801,57,105,940,23,2200,1237,435,505
29,"NEAMŢ","#N/A",120726,,60,"DOAMNA / Colegiul Tehnic Gheorghe Cartianu",1,11409,"MUNICIPIUL PIATRA-NEAMŢ",120726,954,571,516,54,1,566,5,1000,429,212,354
29,"NEAMŢ","#N/A",120726,,61,"DOAMNA / Colegiul Tehnic Gheorghe Cartianu",1,11409,"MUNICIPIUL PIATRA-NEAMŢ",120726,1343,846,797,49,0,832,14,1500,654,349,483
29,"NEAMŢ","#N/A",120726,,62,"DOAMNA / Colegiul Tehnic Gheorghe Cartianu",1,11409,"MUNICIPIUL PIATRA-NEAMŢ",120726,1407,624,571,53,0,613,11,1500,876,271,342
29,"NEAMŢ","#N/A",120726,,63,"DOAMNA / Scoala nr. 1",1,11409,"MUNICIPIUL PIATRA-NEAMŢ",120726,1764,942,856,86,0,922,20,1900,958,343,579
29,"NEAMŢ","#N/A",120726,,64,"CIRITEI / Grădiniţa nr. 19",1,11409,"MUNICIPIUL PIATRA-NEAMŢ",120726,740,412,396,16,0,401,11,800,388,166,235
29,"NEAMŢ","#N/A",120726,,65,"CIRITEI / Liceul Tehnologic Dimitrie Leonida",1,11409,"MUNICIPIUL PIATRA-NEAMŢ",120726,1465,783,741,40,2,765,18,1600,817,352,413
29,"NEAMŢ","#N/A",120726,,66,"CIRITEI / Liceul Tehnologic Dimitrie Leonida",1,11409,"MUNICIPIUL PIATRA-NEAMŢ",120726,1291,717,688,22,7,700,17,1400,683,400,300
29,"NEAMŢ","#N/A",120726,,67,"CIRITEI / Liceul Tehnologic Dimitrie Leonida",1,11409,"MUNICIPIUL PIATRA-NEAMŢ",120726,1123,650,617,33,0,632,18,1200,550,260,372
29,"NEAMŢ","#N/A",120726,,68,"CIRITEI / Şcoala Daniela Cuciuc",1,11409,"MUNICIPIUL PIATRA-NEAMŢ",120726,1863,858,795,62,1,841,17,2000,1142,325,516
29,"NEAMŢ","#N/A",120726,,69,"CIRITEI / Şcoala Daniela Cuciuc",1,11409,"MUNICIPIUL PIATRA-NEAMŢ",120726,1076,550,515,35,0,535,15,1200,650,268,267
29,"NEAMŢ","#N/A",120726,,70,"CIRITEI / Şcoala Daniela Cuciuc",1,11409,"MUNICIPIUL PIATRA-NEAMŢ",120726,1250,673,641,32,0,655,18,1400,727,309,346
29,"NEAMŢ","#N/A",120726,,71,"CIRITEI / Şcoala Daniela Cuciuc",1,11409,"MUNICIPIUL PIATRA-NEAMŢ",120726,968,562,536,26,0,551,11,1100,538,250,301
29,"NEAMŢ","#N/A",120726,,72,"CIRITEI / SCOALA DANIELA CUCIUC",1,11409,"MUNICIPIUL PIATRA-NEAMŢ",120726,1710,830,756,72,2,808,22,1900,1070,322,486
29,"NEAMŢ","#N/A",120726,,73,"CIRITEI / Grădiniţa nr. 7",1,11409,"MUNICIPIUL PIATRA-NEAMŢ",120726,1584,823,795,28,0,806,17,1700,877,349,457
29,"NEAMŢ","#N/A",120726,,74,"CIRITEI / Grădiniţa nr. 7",1,11409,"MUNICIPIUL PIATRA-NEAMŢ",120726,1336,703,646,57,0,689,14,1400,697,347,342
29,"NEAMŢ","#N/A",120726,,75,"CIRITEI / Grădiniţa nr. 1",1,11409,"MUNICIPIUL PIATRA-NEAMŢ",120726,1610,1015,937,77,1,988,27,1800,785,430,558
29,"NEAMŢ","#N/A",120860,,76,"ROMAN / Casa de cultură",1,11414,"MUNICIPIUL ROMAN",120860,1302,685,632,53,0,669,16,1400,715,343,326
29,"NEAMŢ","#N/A",120860,,77,"ROMAN / Grădiniţa de copii nr. 2 cu program prelungit",1,11414,"MUNICIPIUL ROMAN",120860,1262,935,757,46,132,921,14,1900,965,515,406
29,"NEAMŢ","#N/A",120860,,78,"ROMAN / Grădiniţa de copii nr. 6 cu program prelungit",1,11414,"MUNICIPIUL ROMAN",120860,1350,795,751,43,1,774,21,1500,705,400,374
29,"NEAMŢ","#N/A",120860,,79,"ROMAN / Şcoala gimnazială ,,Calistrat Hogaş""",1,11414,"MUNICIPIUL ROMAN",120860,1533,776,713,63,0,767,9,1700,924,368,399
29,"NEAMŢ","#N/A",120860,,80,"ROMAN / Şcoala gimnazială ,,Calistrat Hogaş""",1,11414,"MUNICIPIUL ROMAN",120860,1224,585,536,47,2,575,10,1300,715,251,324
29,"NEAMŢ","#N/A",120860,,81,"ROMAN / Şcoala gimnazială ,,Calistrat Hogaş""",1,11414,"MUNICIPIUL ROMAN",120860,1471,679,655,24,0,666,13,1600,921,278,388
29,"NEAMŢ","#N/A",120860,,82,"ROMAN / Centrul de permanenţă de la Dispensarul medical nr. 6",1,11414,"MUNICIPIUL ROMAN",120860,1348,592,574,18,0,588,4,1500,908,245,343
29,"NEAMŢ","#N/A",120860,,83,"ROMAN / Agenţia pentru Protecţia Mediului",1,11414,"MUNICIPIUL ROMAN",120860,1381,676,642,34,0,671,5,1500,824,329,342
29,"NEAMŢ","#N/A",120860,,84,"ROMAN / Grădiniţa de copii nr. 6 cu program normal",1,11414,"MUNICIPIUL ROMAN",120860,1401,726,697,29,0,710,16,1500,774,322,388
29,"NEAMŢ","#N/A",120860,,85,"ROMAN / Liceul Tehnologic ""Vasile Sav""",1,11414,"MUNICIPIUL ROMAN",120860,1125,600,555,45,0,592,8,1200,600,303,289
29,"NEAMŢ","#N/A",120860,,86,"ROMAN / Liceul Tehnologic ""Vasile Sav""",1,11414,"MUNICIPIUL ROMAN",120860,1128,583,544,37,2,573,10,1200,617,281,292
29,"NEAMŢ","#N/A",120860,,87,"ROMAN / Circumscriptia sanitar veterinara",1,11414,"MUNICIPIUL ROMAN",120860,1254,601,565,36,0,579,22,1400,799,420,159
29,"NEAMŢ","#N/A",120860,,88,"ROMAN / Şcoala gimnazială ,,Carol I""",1,11414,"MUNICIPIUL ROMAN",120860,1440,735,715,20,0,725,10,1600,865,419,306
29,"NEAMŢ","#N/A",120860,,89,"ROMAN / Şcoala gimnazială ,,Carol I""",1,11414,"MUNICIPIUL ROMAN",120860,1370,797,766,31,0,774,23,1500,703,435,339
29,"NEAMŢ","#N/A",120860,,90,"ROMAN / Şcoala de artă ,,Sergiu Celibidache"" - Corp A",1,11414,"MUNICIPIUL ROMAN",120860,1421,721,689,31,1,704,17,1600,879,355,349
29,"NEAMŢ","#N/A",120860,,91,"ROMAN / Şcoala de artă ,,Sergiu Celibidache"" - Corp A",1,11414,"MUNICIPIUL ROMAN",120860,1474,762,733,29,0,750,12,1600,838,395,355
29,"NEAMŢ","#N/A",120860,,92,"ROMAN / Şcoala de artă ,,Sergiu Celibidache"" - Corp B",1,11414,"MUNICIPIUL ROMAN",120860,1483,775,752,23,0,760,15,1600,825,413,347
29,"NEAMŢ","#N/A",120860,,93,"ROMAN / Grădiniţa de copii nr. 4 cu program normal",1,11414,"MUNICIPIUL ROMAN",120860,1436,730,704,26,0,721,9,1600,870,366,355
29,"NEAMŢ","#N/A",120860,,94,"ROMAN / Grădiniţa de copii nr. 5 cu program prelungit",1,11414,"MUNICIPIUL ROMAN",120860,1545,889,851,38,0,874,15,1700,811,459,415
29,"NEAMŢ","#N/A",120860,,95,"ROMAN / Creşa Smirodava",1,11414,"MUNICIPIUL ROMAN",120860,1488,747,703,44,0,731,16,1600,853,391,340
29,"NEAMŢ","#N/A",120860,,96,"ROMAN / Grădiniţa de copii nr. 1 cu program prelungit",1,11414,"MUNICIPIUL ROMAN",120860,1492,741,707,34,0,731,10,1600,859,371,360
29,"NEAMŢ","#N/A",120860,,97,"ROMAN / Grădiniţa de copii nr. 1 cu program prelungit",1,11414,"MUNICIPIUL ROMAN",120860,1498,737,710,25,2,713,24,1600,863,365,348
29,"NEAMŢ","#N/A",120860,,98,"ROMAN / Şcoala gimnazială ,,Mihai Eminescu""",1,11414,"MUNICIPIUL ROMAN",120860,1483,887,835,52,0,855,32,1600,713,418,437
29,"NEAMŢ","#N/A",120860,,99,"ROMAN / Colegiul Tehnic ""Miron Costin""",1,11414,"MUNICIPIUL ROMAN",120860,1364,579,530,49,0,566,13,1500,921,270,296
29,"NEAMŢ","#N/A",120860,,100,"ROMAN / Colegiul  Naţional ""Roman Vodă"" - corp B",1,11414,"MUNICIPIUL ROMAN",120860,1169,568,527,40,1,556,12,1300,732,301,255
29,"NEAMŢ","#N/A",120860,,101,"ROMAN / Şcoala gimnazială ,,Vasile Alecsandri"" - local vechi",1,11414,"MUNICIPIUL ROMAN",120860,1369,712,675,37,0,699,13,1500,788,345,354
29,"NEAMŢ","#N/A",120860,,102,"ROMAN / Şcoala gimnazială ,,Vasile Alecsandri"" - local nou",1,11414,"MUNICIPIUL ROMAN",120860,1520,771,723,32,16,764,7,1700,929,406,358
29,"NEAMŢ","#N/A",120860,,103,"ROMAN / Centrul de îngrijire şi asistenţă bătrâni (Dispensar 7)",1,11414,"MUNICIPIUL ROMAN",120860,1746,1109,1073,36,0,1091,18,1900,791,471,620
29,"NEAMŢ","#N/A",120860,,104,"ROMAN / Direcţia de Asistenţă Socială Roman",1,11414,"MUNICIPIUL ROMAN",120860,1160,607,579,28,0,603,4,1300,693,305,298
29,"NEAMŢ","#N/A",120860,,105,"ROMAN / Liceul Teologic ""Episcop Melchisedec""",1,11414,"MUNICIPIUL ROMAN",120860,1431,780,725,54,1,772,8,1600,820,344,428
29,"NEAMŢ","#N/A",120860,,106,"ROMAN / Şcoala gimnazială ,,Roman Muşat""",1,11414,"MUNICIPIUL ROMAN",120860,1457,643,613,29,1,627,16,1600,957,248,379
29,"NEAMŢ","#N/A",120860,,107,"ROMAN / Şcoala gimnazială ,,Roman Muşat""",1,11414,"MUNICIPIUL ROMAN",120860,1336,563,544,19,0,554,9,1400,837,270,284
29,"NEAMŢ","#N/A",120860,,108,"ROMAN / Complex Servicii Sociale Integrate",1,11414,"MUNICIPIUL ROMAN",120860,1521,740,688,51,1,728,12,1700,960,330,398
29,"NEAMŢ","#N/A",120860,,109,"ROMAN / Grădiniţa de copii nr. 5 cu program normal",1,11414,"MUNICIPIUL ROMAN",120860,1615,838,787,51,0,824,14,1800,962,393,431
29,"NEAMŢ","#N/A",120860,,110,"ROMAN / Şcoala gimnazială ,,Costache Negri"" - local nou",1,11414,"MUNICIPIUL ROMAN",120860,993,466,437,26,3,462,4,1100,634,226,236
29,"NEAMŢ","#N/A",120860,,111,"ROMAN / Şcoala gimnazială ,,Costache Negri"" - local nou",1,11414,"MUNICIPIUL ROMAN",120860,1534,761,731,30,0,745,16,1700,939,403,342
29,"NEAMŢ","#N/A",120860,,112,"ROMAN / Colegiul Tehnic ""Petru Poni"" - Corp A",1,11414,"MUNICIPIUL ROMAN",120860,1309,722,609,113,0,702,20,1400,678,313,389
29,"NEAMŢ","#N/A",120860,,113,"ROMAN / Colegiul Tehnic ""Petru Poni"" - Corp B",1,11414,"MUNICIPIUL ROMAN",120860,1565,880,834,46,0,857,23,1701,821,437,420
29,"NEAMŢ","#N/A",120860,,114,"ROMAN / Şcoala gimnazială ""Alexandru Ioan Cuza""(Şcoala nr. 5)",1,11414,"MUNICIPIUL ROMAN",120860,1589,856,816,40,0,835,21,1700,844,370,465
29,"NEAMŢ","#N/A",120860,,115,"ROMAN / Şcoala gimnazială ""Alexandru Ioan Cuza""(Şcoala nr. 5)",1,11414,"MUNICIPIUL ROMAN",120860,1407,701,670,30,1,682,19,1500,799,310,372
29,"NEAMŢ","#N/A",120860,,116,"ROMAN / Şcoala gimnazială ""Alexandru Ioan Cuza"" Corp C(Grădiniţa de copii nr. 3 cu program prelungit)",1,11414,"MUNICIPIUL ROMAN",120860,1383,800,723,76,1,782,18,1500,700,337,445
29,"NEAMŢ","#N/A",120860,,117,"ROMAN / Şcoala gimnazială ""Alexandru Ioan Cuza"" Corp B(Grădiniţa de copii nr. 12 cu program normal)",1,11414,"MUNICIPIUL ROMAN",120860,1361,711,653,58,0,706,5,1500,789,292,414
29,"NEAMŢ","#N/A",120860,,118,"ROMAN / Colegiul Tehnic ""Danubiana""",1,11414,"MUNICIPIUL ROMAN",120860,1414,696,647,49,0,676,20,1500,804,351,325
29,"NEAMŢ","#N/A",120968,,119,"BICAZ / Primaria orasului Bicaz",1,11416,"ORAŞ BICAZ",120968,1243,746,677,68,1,729,17,1400,654,363,366
29,"NEAMŢ","#N/A",120968,,120,"BICAZ / Scoala Generala nr. 1 Marceni",1,11416,"ORAŞ BICAZ",120968,796,466,440,26,0,456,10,900,434,262,194
29,"NEAMŢ","#N/A",120968,,121,"BICAZ / Scoala Generala nr. 1 Marceni",1,11416,"ORAŞ BICAZ",120968,1258,642,604,35,3,628,14,1400,758,347,281
29,"NEAMŢ","#N/A",120968,,122,"CAPŞA / Grup Scolar Bicaz",1,11416,"ORAŞ BICAZ",120968,1098,640,595,41,4,629,11,1200,560,310,319
29,"NEAMŢ","#N/A",120968,,123,"DODENI / Scoala Generala nr.2 Dodeni",1,11416,"ORAŞ BICAZ",120968,1044,483,455,28,0,474,9,1200,717,238,236
29,"NEAMŢ","#N/A",120968,,124,"DODENI / Scoala Generala nr.2 Dodeni",1,11416,"ORAŞ BICAZ",120968,1031,407,391,16,0,399,8,1100,693,208,191
29,"NEAMŢ","#N/A",120968,,125,"IZVORU MUNTELUI / Centrul Cultural Izvoru Muntelui",1,11416,"ORAŞ BICAZ",120968,406,270,233,37,0,265,5,500,230,145,120
29,"NEAMŢ","#N/A",120968,,126,"IZVORUL ALB / Scoala Generala nr.1 Marceni",1,11416,"ORAŞ BICAZ",120968,145,105,91,14,0,104,1,200,95,66,38
29,"NEAMŢ","#N/A",120968,,127,"POTOCI / Scoala Generala nr.1 Marceni",1,11416,"ORAŞ BICAZ",120968,216,137,115,22,0,136,1,300,163,72,64
29,"NEAMŢ","#N/A",120968,,128,"SECU / Scoala Generala nr.1 Marceni",1,11416,"ORAŞ BICAZ",120968,64,49,40,9,0,48,1,100,51,38,10
29,"NEAMŢ","#N/A",124117,,129,"ROZNOV / SCOALA GENERALA ROZNOV",1,11424,"ORAŞ ROZNOV",124117,1740,971,776,195,0,965,6,1900,929,528,437
29,"NEAMŢ","#N/A",124117,,130,"ROZNOV / GARA ROZNOV",1,11424,"ORAŞ ROZNOV",124117,1461,834,724,108,2,821,13,1600,766,472,349
29,"NEAMŢ","#N/A",124117,,131,"ROZNOV / STADION ROZNOV",1,11424,"ORAŞ ROZNOV",124117,1265,998,850,94,54,979,19,1500,502,703,276
29,"NEAMŢ","#N/A",124117,,132,"CHINTINICI / SCOALA GENERALA CHINTINICI",1,11424,"ORAŞ ROZNOV",124117,960,483,438,45,0,479,4,1100,617,264,215
29,"NEAMŢ","#N/A",124117,,133,"SLOBOZIA / DISPENSAR MEDICAL SLOBOZIA",1,11424,"ORAŞ ROZNOV",124117,1433,831,741,89,1,816,15,1600,769,450,366
29,"NEAMŢ","#N/A",124117,,134,"SLOBOZIA / SCOALA GENERALA SLOBOZIA",1,11424,"ORAŞ ROZNOV",124117,1307,845,731,113,1,822,23,1400,555,542,280
29,"NEAMŢ","#N/A",121055,,135,"TÎRGU NEAMŢ / Sala de Sport Parc Cetate",1,11428,"ORAŞ TÎRGU NEAMŢ",121055,775,551,494,53,4,548,3,901,350,349,199
29,"NEAMŢ","#N/A",121055,,136,"TÎRGU NEAMŢ / Grădiniţa nr.2",1,11428,"ORAŞ TÎRGU NEAMŢ",121055,532,400,295,25,80,393,7,900,500,266,127
29,"NEAMŢ","#N/A",121055,,137,"TÎRGU NEAMŢ / Scoala Generala nr.2 ""Grigore Ghica Vodă""",1,11428,"ORAŞ TÎRGU NEAMŢ",121055,1832,1092,996,85,11,1067,25,1993,901,627,440
29,"NEAMŢ","#N/A",121055,,138,"TÎRGU NEAMŢ / Liceul Economic ""Vasile Conta""",1,11428,"ORAŞ TÎRGU NEAMŢ",121055,1753,962,896,63,3,944,18,1900,938,547,397
29,"NEAMŢ","#N/A",121055,,139,"TÎRGU NEAMŢ / Colegiul Naţional ""Ştefan cel Mare""",1,11428,"ORAŞ TÎRGU NEAMŢ",121055,1746,1005,928,74,3,987,18,1900,895,557,430
29,"NEAMŢ","#N/A",121055,,140,"TÎRGU NEAMŢ / Colegiul Naţional ""Ştefan cel Mare""",1,11428,"ORAŞ TÎRGU NEAMŢ",121055,1757,1036,975,58,3,1020,16,1900,864,629,391
29,"NEAMŢ","#N/A",121055,,141,"TÎRGU NEAMŢ / Colegiul Naţional ""Ştefan cel Mare""",1,11428,"ORAŞ TÎRGU NEAMŢ",121055,1904,1185,1115,66,4,1162,23,2100,915,645,517
29,"NEAMŢ","#N/A",121055,,142,"TÎRGU NEAMŢ / Clubul Copiilor şi Elevilor",1,11428,"ORAŞ TÎRGU NEAMŢ",121055,1835,1054,993,55,6,1029,25,2000,946,631,398
29,"NEAMŢ","#N/A",121055,,143,"TÎRGU NEAMŢ / Colegiul Tehnic ""Ion Creangă""",1,11428,"ORAŞ TÎRGU NEAMŢ",121055,1720,1073,1006,56,11,1049,24,1905,832,664,385
29,"NEAMŢ","#N/A",121055,,144,"BLEBEA / Căminul Cultural",1,11428,"ORAŞ TÎRGU NEAMŢ",121055,672,448,405,24,19,444,4,700,252,301,143
29,"NEAMŢ","#N/A",121055,,145,"HUMULEŞTI / Şcoala Generală nr.3 ""Ion Creangă""",1,11428,"ORAŞ TÎRGU NEAMŢ",121055,1520,918,867,50,1,896,22,1600,682,561,335
29,"NEAMŢ","#N/A",121055,,146,"HUMULEŞTI / Şcoala Generală nr.3 ""Ion Creangă""",1,11428,"ORAŞ TÎRGU NEAMŢ",121055,1696,1028,974,39,15,1018,10,1798,770,626,392
29,"NEAMŢ","#N/A",121055,,147,"HUMULEŞTII NOI / Şcoala Generală nr.3 ""Ion Creangă""",1,11428,"ORAŞ TÎRGU NEAMŢ",121055,477,300,260,40,0,295,5,500,200,189,106
29,"NEAMŢ","#N/A",121108,,148,"AGAPIA / Scoala veche Agapia",3,11433,"AGAPIA",121108,1503,832,759,73,0,790,42,1600,768,499,291
29,"NEAMŢ","#N/A",121108,,149,"FILIOARA / Scoala noua Filioaras",3,11433,"AGAPIA",121108,875,562,524,38,0,553,9,1000,438,398,155
29,"NEAMŢ","#N/A",121108,,150,"SĂCĂLUŞEŞTI / Scoala noua Sacausesti",3,11433,"AGAPIA",121108,531,351,300,51,0,345,6,600,249,218,127
29,"NEAMŢ","#N/A",121108,,151,"VARATEC / Scoala noua Varatec",3,11433,"AGAPIA",121108,735,441,378,62,1,410,31,800,359,201,209
29,"NEAMŢ","#N/A",124938,,152,"VIIŞOARA / SCOALA GIMNAZIALĂ VADURI",3,11438,"ALEXANDRU CEL BUN",124938,898,624,487,49,88,619,5,1300,676,274,345
29,"NEAMŢ","#N/A",124938,,153,"VADURI / SCOALA GIMNAZIALĂ VADURI",3,11438,"ALEXANDRU CEL BUN",124938,850,490,436,54,0,473,17,900,410,211,262
29,"NEAMŢ","#N/A",124938,,154,"BISTRIŢA / SCOALA  GIMNAZIALĂ VADURI",3,11438,"ALEXANDRU CEL BUN",124938,1856,1066,969,97,0,1057,9,2000,934,409,648
29,"NEAMŢ","#N/A",124938,,155,"VĂDURELE / SCOALA  GIMNAZIALĂ VADURI",3,11438,"ALEXANDRU CEL BUN",124938,1354,772,726,46,0,756,16,1500,728,339,417
29,"NEAMŢ","#N/A",121153,,156,"BAHNA / CĂMINUL CULTURAL",3,11446,"BAHNA",121153,560,346,279,37,30,341,5,600,254,234,107
29,"NEAMŢ","#N/A",121153,,157,"BROŞTENI / ŞCOALA CU CLASELE I-IV",3,11446,"BAHNA",121153,420,311,246,48,17,307,4,500,189,165,142
29,"NEAMŢ","#N/A",121153,,158,"ŢUŢCANII DIN VALE / ŞCOALA CU CLASELE I-IV",3,11446,"BAHNA",121153,265,202,162,26,14,202,0,300,98,143,59
29,"NEAMŢ","#N/A",121153,,159,"BĂHNIŞOARA / ŞCOALA CU CLASELE I-IV",3,11446,"BAHNA",121153,357,205,176,24,5,203,2,400,195,124,79
29,"NEAMŢ","#N/A",121153,,160,"IZVOARE / ŞCOALA",3,11446,"BAHNA",121153,1073,587,497,64,26,577,10,1100,513,410,167
29,"NEAMŢ","#N/A",121242,,161,"BĂLŢĂTEŞTI / PRIMĂRIA COMUNEI BĂLŢĂTEŞTI",3,11455,"BĂLŢĂTEŞTI",121242,1752,1173,1011,138,24,1164,9,1900,727,709,455
29,"NEAMŢ","#N/A",121242,,162,"VALEA SEACĂ / ŞCOALA GIMNAZIALĂ",3,11455,"BĂLŢĂTEŞTI",121242,1236,716,658,52,6,709,7,1300,584,457,252
29,"NEAMŢ","#N/A",121242,,163,"VALEA ARINI / CASA DE PRĂZNUIRE A PAROHIEI VALEA ARINI",3,11455,"BĂLŢĂTEŞTI",121242,500,269,249,20,0,266,3,600,331,174,92
29,"NEAMŢ","#N/A",121297,,164,"BICAZ-CHEI / CAMIN CULTURAL",3,11459,"BICAZ-CHEI",121297,1157,664,619,45,0,657,7,1300,636,290,367
29,"NEAMŢ","#N/A",121297,,165,"BICAZ-CHEI / SCOALA GENERALA NR.2",3,11459,"BICAZ-CHEI",121297,791,505,456,49,0,504,1,900,395,210,294
29,"NEAMŢ","#N/A",121297,,166,"BICAZ-CHEI / Scoala Gen. nr. 1",3,11459,"BICAZ-CHEI",121297,1009,652,624,28,0,649,3,1100,448,310,339
29,"NEAMŢ","#N/A",121297,,167,"IVANEŞ / SCOALA IVANES",3,11459,"BICAZ-CHEI",121297,690,436,417,19,0,431,5,800,364,278,153
29,"NEAMŢ","#N/A",121340,,168,"BICAZU ARDELEAN / CĂMIN CULTURAL",3,11464,"BICAZU ARDELEAN",121340,1376,750,702,48,0,743,7,1500,750,198,545
29,"NEAMŢ","#N/A",121340,,169,"TELEC / ŞCOALA GENERALĂ TELEC",3,11464,"BICAZU ARDELEAN",121340,1121,590,553,37,0,585,5,1200,610,184,401
29,"NEAMŢ","#N/A",121340,,170,"TELEC / ŞCOALA PRIMARĂ TOŞOROG",3,11464,"BICAZU ARDELEAN",121340,455,284,272,11,1,283,1,500,216,120,163
29,"NEAMŢ","#N/A",121340,,171,"TICOŞ / ŞCOALA PRIMARĂ TICOŞ",3,11464,"BICAZU ARDELEAN",121340,269,174,144,30,0,170,4,300,126,58,112
29,"NEAMŢ","#N/A",121386,,172,"BIRA / Scoala cls.I-VIII BIRA",3,11468,"BIRA",121386,635,340,309,31,0,338,2,700,360,157,181
29,"NEAMŢ","#N/A",121386,,173,"REDIU / Scoala cls.I-IV REDIU",3,11468,"BIRA",121386,640,313,296,17,0,306,7,700,387,166,140
29,"NEAMŢ","#N/A",121386,,174,"REDIU / Scoala cls.I-IV REDIU",3,11468,"BIRA",121386,110,157,64,93,0,157,0,200,43,103,54
29,"NEAMŢ","#N/A",121386,,175,"NEGREŞTI / Scoala cls.I-IV NEGRESTI",3,11468,"BIRA",121386,159,93,79,14,0,93,0,200,107,61,32
29,"NEAMŢ","#N/A",121466,,176,"BÎRGAUANI / Primăria Bîrgăuani",3,11472,"BÎRGĂUANI",121466,471,267,241,26,0,263,4,496,229,177,86
29,"NEAMŢ","#N/A",121466,,177,"BÎRGAUANI / Primăria Bîrgăuani",3,11472,"BÎRGĂUANI",121466,511,339,290,49,0,337,2,600,261,281,56
29,"NEAMŢ","#N/A",121466,,178,"BREAZA / Primăria Bîrgăuani",3,11472,"BÎRGĂUANI",121466,177,126,103,23,0,126,0,200,74,84,42
29,"NEAMŢ","#N/A",121466,,179,"CERTIENI / Primăria Bîrgăuani",3,11472,"BÎRGĂUANI",121466,185,131,96,35,0,128,3,200,69,72,56
29,"NEAMŢ","#N/A",121466,,180,"HÎRTOP / Primăria Bîrgăuani",3,11472,"BÎRGĂUANI",121466,193,129,97,32,0,129,0,200,71,75,54
29,"NEAMŢ","#N/A",121466,,181,"BĂLĂNEŞTI / Şcoala Bîrgăuani",3,11472,"BÎRGĂUANI",121466,573,334,267,67,0,327,7,598,264,172,155
29,"NEAMŢ","#N/A",121466,,182,"TALPA / Şcoala Bîrgăuani",3,11472,"BÎRGĂUANI",121466,594,368,318,50,0,360,8,700,332,248,112
29,"NEAMŢ","#N/A",121466,,183,"VLĂDICENI / Şcoala Bîrgăuani",3,11472,"BÎRGĂUANI",121466,523,312,258,54,0,308,4,600,288,209,99
29,"NEAMŢ","#N/A",121607,,184,"BODEŞTI / Şcoala cu clasele I-IV",3,11486,"BODEŞTI",121607,957,513,466,47,0,498,15,1000,487,319,179
29,"NEAMŢ","#N/A",121607,,185,"BODEŞTI / Şcoala cu clasele I-IV",3,11486,"BODEŞTI",121607,908,470,438,32,0,458,12,1000,530,296,162
29,"NEAMŢ","#N/A",121607,,186,"CORNI / Şcoala",3,11486,"BODEŞTI",121607,128,107,74,33,0,104,3,200,93,76,28
29,"NEAMŢ","#N/A",121607,,187,"OŞLOBENI / Şcoala",3,11486,"BODEŞTI",121607,780,454,387,67,0,450,4,900,446,242,208
29,"NEAMŢ","#N/A",121607,,188,"BODEŞTII DE JOS / Grădiniţă - (Cătună)",3,11486,"BODEŞTI",121607,526,304,265,39,0,302,2,600,296,159,143
29,"NEAMŢ","#N/A",121607,,189,"BODEŞTII DE JOS / Şcoala cu clasele I-VIII",3,11486,"BODEŞTI",121607,748,428,373,55,0,417,11,800,372,269,148
29,"NEAMŢ","#N/A",125178,,190,"BOGHICEA / SCOALA",3,11491,"BOGHICEA",125178,995,537,483,54,0,528,9,1100,563,334,194
29,"NEAMŢ","#N/A",125178,,191,"SLOBOZIA / SCOALA",3,11491,"BOGHICEA",125178,593,352,317,35,0,350,2,600,248,204,146
29,"NEAMŢ","#N/A",125178,,192,"CĂUŞENI / SCOALA",3,11491,"BOGHICEA",125178,148,108,94,14,0,107,1,200,92,86,21
29,"NEAMŢ","#N/A",125178,,193,"NISTRIA / SCOALA",3,11491,"BOGHICEA",125178,211,136,130,6,0,135,1,300,164,92,43
29,"NEAMŢ","#N/A",121652,,194,"BORCA / ŞCOALA BORCA",3,11496,"BORCA",121652,895,523,489,34,0,510,13,1000,477,306,204
29,"NEAMŢ","#N/A",121652,,195,"MĂDEI / ŞCOALA CU CLASE I-VIII MĂDEI",3,11496,"BORCA",121652,925,567,543,24,0,558,9,1000,433,368,190
29,"NEAMŢ","#N/A",121652,,196,"PÎRÎUL CÎRJEI / ŞCOALA CU CLASELE I-IV PR. CÎRJEI",3,11496,"BORCA",121652,589,354,331,23,0,353,1,700,346,235,118
29,"NEAMŢ","#N/A",121652,,197,"SABASA / GRĂDINIŢA CENTRU",3,11496,"BORCA",121652,783,511,444,67,0,501,10,900,389,286,215
29,"NEAMŢ","#N/A",121652,,198,"SABASA / ŞCOALA CU CLASELE I-VIII SABASA",3,11496,"BORCA",121652,935,538,513,25,0,532,6,1000,462,367,165
29,"NEAMŢ","#N/A",121652,,199,"PÎRÎUL PÎNTEI / ŞCOALA CU CLASELE I-IV PR. PÎNTEI",3,11496,"BORCA",121652,431,285,262,23,0,279,6,500,215,204,75
29,"NEAMŢ","#N/A",121652,,200,"SOCI / ŞCOALA CU CLASELE I-IV SOCI",3,11496,"BORCA",121652,733,420,404,16,0,412,8,800,380,278,134
29,"NEAMŢ","#N/A",121732,,201,"BORLEŞTI / Scoala Gimnazială Borleşti",3,11504,"BORLEŞTI",121732,1595,782,698,84,0,771,11,1700,918,381,390
29,"NEAMŢ","#N/A",121732,,202,"BORLEŞTI / Grădiniţa Borleşti II",3,11504,"BORLEŞTI",121732,757,397,323,73,1,388,9,800,403,163,225
29,"NEAMŢ","#N/A",121732,,203,"MASTACĂN / Şcoala Gimnazială ""Ştefan cel Mare""",3,11504,"BORLEŞTI",121732,1544,714,680,34,0,702,12,1700,986,309,393
29,"NEAMŢ","#N/A",121732,,204,"RUSENI / Şcoala Gimnaziala ""Grigore Teodorescu""",3,11504,"BORLEŞTI",121732,1808,853,746,107,0,838,15,2000,1147,387,451
29,"NEAMŢ","#N/A",121732,,205,"RUSENI / Şcoala nr.2",3,11504,"BORLEŞTI",121732,1230,564,491,73,0,543,21,1300,736,311,232
29,"NEAMŢ","#N/A",121732,,206,"ŞOVOAIA / Grădiniţa",3,11504,"BORLEŞTI",121732,428,212,180,32,0,209,3,500,288,103,106
29,"NEAMŢ","#N/A",121732,,207,"NECHIT / Grădiniţa",3,11504,"BORLEŞTI",121732,239,133,118,15,0,129,4,290,157,80,49
29,"NEAMŢ","#N/A",121796,,208,"BOTEŞTI / ŞCOALA CU CLASELE  I-IV",3,11510,"BOTEŞTI",121796,371,267,232,35,0,265,2,400,133,179,86
29,"NEAMŢ","#N/A",121796,,209,"NISIPOREŞTI / LICEUL TEHNOLOGIC",3,11510,"BOTEŞTI",121796,978,447,416,31,0,441,6,1100,653,185,256
29,"NEAMŢ","#N/A",121796,,210,"NISIPOREŞTI / LICEUL TEHNOLOGIC",3,11510,"BOTEŞTI",121796,1019,454,433,21,0,451,3,1100,646,242,209
29,"NEAMŢ","#N/A",121796,,211,"BARTICEŞTI / SCOALA CU CLASELE I-VII",3,11510,"BOTEŞTI",121796,1716,838,785,53,0,828,10,1800,962,412,416
29,"NEAMŢ","#N/A",121876,,212,"BOZIENI / ŞCOALA GENERALĂ BOZIENI",3,11514,"BOZIENI",121876,908,523,473,50,0,519,4,1000,477,412,107
29,"NEAMŢ","#N/A",121876,,213,"CUCI / ŞCOALA GENERALĂ BOZIENI",3,11514,"BOZIENI",121876,695,409,365,44,0,404,5,800,391,331,73
29,"NEAMŢ","#N/A",121876,,214,"IUCŞA / ŞCOALA GENERALĂ BOZIENI",3,11514,"BOZIENI",121876,640,376,329,47,0,375,1,700,324,306,69
29,"NEAMŢ","#N/A",121938,,215,"BRUSTURI / ŞCOALA GIMNAZIALĂ ""IEREMIA IRIMESCU"" BRUSTURI",3,11520,"BRUSTURI",121938,1552,863,812,51,0,846,17,1700,837,542,304
29,"NEAMŢ","#N/A",121938,,216,"GROŞI / GRADINITA CU PROGRAM NORMAL GROSI",3,11520,"BRUSTURI",121938,394,221,193,28,0,214,7,400,179,186,28
29,"NEAMŢ","#N/A",121938,,217,"POIANA / GRADINITA CU PROGRAM NORMAL POIANA",3,11520,"BRUSTURI",121938,656,379,352,27,0,370,9,700,321,280,90
29,"NEAMŢ","#N/A",121938,,218,"TÎRZIA / ŞCOALA GIMNAZIALĂ ""GRIGORE STURZU"" TIRZIA",3,11520,"BRUSTURI",121938,609,346,317,29,0,345,1,700,354,233,112
29,"NEAMŢ","#N/A",122025,,219,"BISTRICIOARA / Cămin Cultural",3,11525,"CEAHLĂU",122025,618,429,356,73,0,422,7,700,271,219,203
29,"NEAMŢ","#N/A",122025,,220,"CEAHLĂU / Şcoala Grigore Ungureanu",3,11525,"CEAHLĂU",122025,1465,1003,812,162,29,987,16,1600,597,401,586
29,"NEAMŢ","#N/A",122061,,221,"CÎNDESTI / ŞCOALA GIMNAZIALĂ",3,11529,"CÎNDEŞTI",122061,1331,683,632,47,4,674,9,1400,717,394,280
29,"NEAMŢ","#N/A",122061,,222,"VĂDURELE / GRĂDINIŢA CU PROGRAM NORMAL",3,11529,"CÎNDEŞTI",122061,1044,530,470,60,0,525,5,1100,570,272,253
29,"NEAMŢ","#N/A",122061,,223,"BĂRCĂNEŞTI / GRĂDINIŢA CU PROGRAM NORMAL",3,11529,"CÎNDEŞTI",122061,719,392,360,32,0,386,6,800,408,239,147
29,"NEAMŢ","#N/A",122061,,224,"PĂDURENI / ŞCOALA PRIMARĂ",3,11529,"CÎNDEŞTI",122061,318,144,126,18,0,141,3,400,256,98,43
29,"NEAMŢ","#N/A",120888,,225,"CORDUN / Gradinita cu program prelungit Cordun",3,11536,"CORDUN",120888,1228,715,661,38,16,701,14,1300,585,391,310
29,"NEAMŢ","#N/A",120888,,226,"CORDUN / Gradinita cu program prelungit Cordun",3,11536,"CORDUN",120888,1006,623,558,48,17,613,10,1100,477,344,269
29,"NEAMŢ","#N/A",120888,,227,"SIMIONEŞTI / Scoala  Generala  ,  str. Vasile Alecsandri nr.114",3,11536,"CORDUN",120888,712,421,379,32,10,410,11,800,379,261,149
29,"NEAMŢ","#N/A",120888,,228,"PILDEŞTI / Scoala cu clasele I-VIII Pildesti",3,11536,"CORDUN",120888,1684,795,757,28,10,786,9,1800,1005,288,498
29,"NEAMŢ","#N/A",120888,,229,"PILDEŞTI / Scoala cu clasele I-VIII Pildesti",3,11536,"CORDUN",120888,1664,760,725,25,10,746,14,1800,1040,275,471
29,"NEAMŢ","#N/A",122132,,230,"COSTIŞA / ŞCOALA CU CLASELE I-VIII",3,11540,"COSTIŞA",122132,1442,793,718,68,7,789,4,1500,707,501,288
29,"NEAMŢ","#N/A",122132,,231,"MĂNOAIA / ŞCOALA CU CLASELE I-IV",3,11540,"COSTIŞA",122132,762,462,425,34,3,460,2,800,338,293,167
29,"NEAMŢ","#N/A",122132,,232,"FRUNZENI / ŞCOALA CU CLASELE I-IV",3,11540,"COSTIŞA",122132,530,257,227,30,0,255,2,600,343,144,111
29,"NEAMŢ","#N/A",122132,,233,"DORNEŞTI / CLĂDIRE PROPRIETATE PRIVATĂ",3,11540,"COSTIŞA",122132,214,161,128,27,6,157,4,300,139,125,32
29,"NEAMŢ","#N/A",122187,,234,"CRĂCĂOANI / Scoala gimnaziala ""Gh. Savinescu""",3,11545,"CRĂCĂOANI",122187,935,514,470,44,0,503,11,1000,486,299,204
29,"NEAMŢ","#N/A",122187,,235,"CRĂCĂOANI / Scoala gimnaziala Gheorghe Savinescu",3,11545,"CRĂCĂOANI",122187,925,504,468,36,0,492,12,1000,496,337,155
29,"NEAMŢ","#N/A",122187,,236,"MAGAZIA / Scoala generala",3,11545,"CRĂCĂOANI",122187,557,373,343,30,0,371,2,600,227,223,148
29,"NEAMŢ","#N/A",122187,,237,"CRACĂUL NEGRU / Scoala generala",3,11545,"CRĂCĂOANI",122187,883,475,436,39,0,470,5,1000,525,300,170
29,"NEAMŢ","#N/A",122187,,238,"MITOCU BĂLAN / Scoala generala",3,11545,"CRĂCĂOANI",122187,267,235,219,16,0,218,17,300,65,150,68
29,"NEAMŢ","#N/A",122249,,239,"HUISUREZ / SCOALA GENERALA",3,11551,"DĂMUC",122249,622,358,344,14,0,354,4,700,342,166,188
29,"NEAMŢ","#N/A",122249,,240,"DĂMUC / CAMINUL CULTURAL DAMUC",3,11551,"DĂMUC",122249,1316,701,670,31,0,687,14,1400,699,233,454
29,"NEAMŢ","#N/A",122249,,241,"DĂMUC / ŞCOALA GENERALĂ",3,11551,"DĂMUC",122249,503,312,292,20,0,312,0,500,188,90,222
29,"NEAMŢ","#N/A",122285,,242,"DOBRENI / SCOALA GIMNAZIALĂ",3,11555,"DOBRENI",122285,1471,924,762,135,27,912,12,1600,676,516,396
29,"NEAMŢ","#N/A",125098,,243,"BĂLUŞEŞTI / Căminul cultural",3,11559,"DOCHIA",125098,106,112,66,46,0,111,1,200,88,64,47
29,"NEAMŢ","#N/A",125098,,244,"DOCHIA / Şcoala gimnazială nr.1",3,11559,"DOCHIA",125098,796,432,396,36,0,424,8,900,468,253,171
29,"NEAMŢ","#N/A",125098,,245,"DOCHIA / Şcoala gimnazială nr.1",3,11559,"DOCHIA",125098,1101,643,588,55,0,624,19,1200,557,361,263
29,"NEAMŢ","#N/A",122347,,246,"DOLJEŞTI / ŞCOALA GIMNAZIALĂ",3,11562,"DOLJEŞTI",122347,1002,560,520,34,6,553,7,1100,540,362,191
29,"NEAMŢ","#N/A",122347,,247,"ROTUNDA / ŞCOALA GIMNAZIALĂ",3,11562,"DOLJEŞTI",122347,1290,545,495,35,15,538,7,1400,855,231,307
29,"NEAMŢ","#N/A",122347,,248,"BUHONCA / ŞCOALA PRIMARĂ",3,11562,"DOLJEŞTI",122347,550,272,256,13,3,270,2,600,328,163,107
29,"NEAMŢ","#N/A",122347,,249,"BURUIENEŞTI / ŞCOALA BURUIENEŞTI",3,11562,"DOLJEŞTI",122347,1533,674,633,34,7,671,3,1700,1026,361,310
29,"NEAMŢ","#N/A",122347,,250,"BURUIENEŞTI / ŞCOALA BURUIENESTI",3,11562,"DOLJEŞTI",122347,1475,653,626,22,5,641,12,1600,947,302,339
29,"NEAMŢ","#N/A",122392,,251,"DRAGOMIREŞTI / Scoala generala",3,11572,"DRAGOMIREŞTI",122392,707,413,357,56,0,402,11,800,387,229,173
29,"NEAMŢ","#N/A",122392,,252,"BORNIŞ / Scoala generala",3,11572,"DRAGOMIREŞTI",122392,112,86,59,27,0,84,2,200,114,34,50
29,"NEAMŢ","#N/A",122392,,253,"HLĂPEŞTI / Scoala generala",3,11572,"DRAGOMIREŞTI",122392,698,348,318,30,0,341,7,800,452,227,114
29,"NEAMŢ","#N/A",122392,,254,"MASTACĂN / Scoala generala",3,11572,"DRAGOMIREŞTI",122392,167,106,83,23,0,103,3,200,94,65,38
29,"NEAMŢ","#N/A",122392,,255,"UNGHI / Scoala generala",3,11572,"DRAGOMIREŞTI",122392,92,82,52,30,0,82,0,100,18,55,27
29,"NEAMŢ","#N/A",125132,,256,"DRĂGĂNEŞTI / Scoala Gimnaziala",3,11567,"DRĂGĂNEŞTI",125132,581,350,317,33,0,346,4,600,250,215,131
29,"NEAMŢ","#N/A",125132,,257,"ORŢĂŞTI / Scoala Primara",3,11567,"DRĂGĂNEŞTI",125132,283,205,168,37,0,202,3,300,95,148,54
29,"NEAMŢ","#N/A",125132,,258,"ŞOIMĂREŞTI / Scoala Primara",3,11567,"DRĂGĂNEŞTI",125132,392,255,220,35,0,251,4,400,145,188,63
29,"NEAMŢ","#N/A",122463,,259,"CORHANA / ŞCOALA GENERALĂ",3,11579,"DULCEŞTI",122463,528,312,283,22,7,305,7,600,288,197,108
29,"NEAMŢ","#N/A",122463,,260,"CÂRLIG / ŞCOALA GENERALĂ",3,11579,"DULCEŞTI",122463,504,422,352,57,13,421,1,600,178,327,94
29,"NEAMŢ","#N/A",122463,,261,"ROŞIORI / ŞCOALA GENERALĂ",3,11579,"DULCEŞTI",122463,256,200,162,31,7,196,4,302,102,146,50
29,"NEAMŢ","#N/A",122463,,262,"DULCEŞTI / ŞCOALA GIMNAZIALA NR. 1 DULCESTI",3,11579,"DULCEŞTI",122463,929,665,571,83,11,652,13,1000,335,462,190
29,"NEAMŢ","#N/A",120771,,263,"BRĂŞĂUŢI / ŞCOALA CU CLASELE I-IV",3,11586,"DUMBRAVA ROŞIE",120771,569,396,356,40,0,387,9,600,204,242,145
29,"NEAMŢ","#N/A",120771,,264,"DUMBRAVA ROŞIE / ŞCOALA CU CLASELE I-VIII",3,11586,"DUMBRAVA ROŞIE",120771,1285,786,688,98,0,768,18,1400,614,408,360
29,"NEAMŢ","#N/A",120771,,265,"DUMBRAVA ROŞIE / ŞCOALA CU CLASELE I-VIII",3,11586,"DUMBRAVA ROŞIE",120771,1599,900,815,84,1,888,12,1700,800,459,429
29,"NEAMŢ","#N/A",120771,,266,"IZVOARE / ŞCOALA CU CLASELE I-VIII",3,11586,"DUMBRAVA ROŞIE",120771,995,625,541,84,0,614,11,1100,475,185,429
29,"NEAMŢ","#N/A",120771,,267,"CUT / ŞCOALA CU CLASELE V-VIII",3,11586,"DUMBRAVA ROŞIE",120771,1047,530,488,42,0,521,9,1100,570,232,289
29,"NEAMŢ","#N/A",120771,,268,"CUT / ŞCOALA CU CLASELE V-VIII",3,11586,"DUMBRAVA ROŞIE",120771,1146,585,566,19,0,573,12,1200,615,265,308
29,"NEAMŢ","#N/A",122551,,269,"FARCAŞA / ŞCOALA CU CLASELE I-VIII",3,11591,"FARCAŞA",122551,1145,703,657,46,0,699,4,1200,497,432,267
29,"NEAMŢ","#N/A",122551,,270,"FRUMOSU / CĂMINUL CULTURAL",3,11591,"FARCAŞA",122551,800,505,468,37,0,497,8,900,395,307,190
29,"NEAMŢ","#N/A",122551,,271,"STEJARU / CĂMINUL CULTURAL",3,11591,"FARCAŞA",122551,639,387,363,24,0,378,9,700,313,230,148
29,"NEAMŢ","#N/A",122613,,272,"BUDEŞTI / ŞCOALA CU CLASELE I-IV",3,11597,"FĂUREI",122613,877,606,545,61,0,595,11,1000,394,452,143
29,"NEAMŢ","#N/A",122613,,273,"FĂUREI / ŞCOALA CU CLASELE I-VIII",3,11597,"FĂUREI",122613,641,426,372,54,0,422,4,700,274,301,121
29,"NEAMŢ","#N/A",122613,,274,"CLIMEŞTI / BIBLIOTECA",3,11597,"FĂUREI",122613,249,187,157,30,0,180,7,300,113,145,35
29,"NEAMŢ","#N/A",125150,,275,"GÂDINŢI / SCOALA CU CLASELE I - VIII",3,11602,"GÂDINŢI",125150,1001,539,512,27,0,533,6,1100,561,359,174
29,"NEAMŢ","#N/A",125150,,276,"GÂDINŢI / GRADINTA DE COPII",3,11602,"GÂDINŢI",125150,1020,561,521,40,0,554,7,1100,539,401,153
29,"NEAMŢ","#N/A",122668,,277,"GHERĂEŞTI / SCOALA",3,11604,"GHERĂEŞTI",122668,1393,599,588,11,0,594,5,1500,901,294,300
29,"NEAMŢ","#N/A",122668,,278,"GHERĂEŞTI / SCOALA",3,11604,"GHERĂEŞTI",122668,1316,577,557,20,0,574,3,1399,822,269,305
29,"NEAMŢ","#N/A",122668,,279,"GHERĂEŞTI / SCOALA",3,11604,"GHERĂEŞTI",122668,1386,606,575,30,1,600,6,1500,894,279,321
29,"NEAMŢ","#N/A",122668,,280,"GHERĂEŞTII NOI / SCOALA",3,11604,"GHERĂEŞTI",122668,494,249,235,14,0,247,2,500,251,150,97
29,"NEAMŢ","#N/A",122668,,281,"TEŢCANI / SCOALA",3,11604,"GHERĂEŞTI",122668,727,347,312,35,0,341,6,800,453,133,208
29,"NEAMŢ","#N/A",125114,,282,"GHINDĂOANI / CLĂDIREA ""SALA DE NUNŢI""",3,11608,"GHINDĂOANI",125114,1752,976,915,61,0,967,9,1900,924,560,407
29,"NEAMŢ","#N/A",122702,,283,"GIROV / Scoala",3,11614,"GIROV",122702,1420,758,680,76,2,749,9,1500,742,404,345
29,"NEAMŢ","#N/A",122702,,284,"CĂCIULEŞTI / Scoala",3,11614,"GIROV",122702,556,323,268,55,0,321,2,600,277,189,132
29,"NEAMŢ","#N/A",122702,,285,"GURA VĂII / Scoala",3,11614,"GIROV",122702,660,349,315,34,0,338,11,700,351,201,137
29,"NEAMŢ","#N/A",122702,,286,"TURTUREŞTI / Scoala",3,11614,"GIROV",122702,466,279,247,32,0,276,3,500,221,128,148
29,"NEAMŢ","#N/A",122702,,287,"BOŢEŞTI / Scoala",3,11614,"GIROV",122702,428,263,211,52,0,261,2,500,237,125,136
29,"NEAMŢ","#N/A",122702,,288,"DOINA / Scoala",3,11614,"GIROV",122702,225,155,119,36,0,153,2,300,145,84,69
29,"NEAMŢ","#N/A",122702,,289,"DĂNEŞTI / Scoala",3,11614,"GIROV",122702,250,150,126,24,0,146,4,301,151,78,68
29,"NEAMŢ","#N/A",122702,,290,"VERŞEŞTI / Scoala",3,11614,"GIROV",122702,264,189,144,45,0,187,2,300,111,104,83
29,"NEAMŢ","#N/A",122828,,291,"GÎRCINA / ŞCOALA",3,11610,"GÎRCINA",122828,1211,659,617,41,1,646,13,1300,641,337,309
29,"NEAMŢ","#N/A",122828,,292,"ALMAŞ / ŞCOALA",3,11610,"GÎRCINA",122828,552,358,305,53,0,354,4,600,242,166,188
29,"NEAMŢ","#N/A",122828,,293,"CUEJDIU / ŞCOALA",3,11610,"GÎRCINA",122828,1054,515,486,29,0,504,11,1100,585,246,258
29,"NEAMŢ","#N/A",122828,,294,"GÎRCINA / GRĂDINIŢA",3,11610,"GÎRCINA",122828,1094,586,552,34,0,579,7,1200,614,310,269
29,"NEAMŢ","#N/A",122864,,295,"GRINŢIEŞ / CĂMINUL CULTURAL",3,11624,"GRINŢIEŞ",122864,1416,837,763,73,1,825,12,1500,663,473,352
29,"NEAMŢ","#N/A",122864,,296,"BRADU / SALA DE FESTIVITĂŢI",3,11624,"GRINŢIEŞ",122864,688,395,363,31,1,393,2,800,405,232,161
29,"NEAMŢ","#N/A",122908,,297,"TOPOLIŢA / Scoala",3,11628,"GRUMĂZEŞTI",122908,1366,767,712,55,0,756,11,1500,733,505,251
29,"NEAMŢ","#N/A",122908,,298,"CURECHIŞTEA / Scoala primara",3,11628,"GRUMĂZEŞTI",122908,596,298,268,30,0,295,3,700,402,236,59
29,"NEAMŢ","#N/A",122908,,299,"GRUMĂZEŞTI / Gradinita",3,11628,"GRUMĂZEŞTI",122908,1479,847,806,41,0,841,6,1600,753,582,259
29,"NEAMŢ","#N/A",122908,,300,"GRUMĂZEŞTI / Gradinita",3,11628,"GRUMĂZEŞTI",122908,1005,532,505,27,0,523,9,1100,568,390,133
29,"NEAMŢ","#N/A",122953,,301,"BUHALNIŢA / Scoala",3,11633,"HANGU",122953,709,365,330,26,9,359,6,800,435,197,162
29,"NEAMŢ","#N/A",122953,,302,"HANGU / SCOALA CU CL.I-VIII",3,11633,"HANGU",122953,1013,605,542,62,1,602,3,1100,495,370,232
29,"NEAMŢ","#N/A",122953,,303,"HANGU / SCOALA CU CL. I-IV",3,11633,"HANGU",122953,512,283,264,19,0,282,1,600,317,171,111
29,"NEAMŢ","#N/A",122953,,304,"CHIRIŢENI / SCOALA CU CL I -IV",3,11633,"HANGU",122953,416,236,204,15,17,231,5,482,246,162,69
29,"NEAMŢ","#N/A",122953,,305,"GROZĂVEŞTI / SCOALA CU CL I -IV",3,11633,"HANGU",122953,362,235,203,29,3,232,3,398,163,103,129
29,"NEAMŢ","#N/A",122953,,306,"RUGINEŞTI / SCOALA CU CL.I -IV",3,11633,"HANGU",122953,296,185,154,30,1,182,3,300,115,92,90
29,"NEAMŢ","#N/A",120922,,307,"HORIA / SCOALA GIMNAZIALA ''CARMEN SYLVA''",3,11639,"HORIA",120922,1688,894,849,45,0,881,13,1800,906,467,414
29,"NEAMŢ","#N/A",120922,,308,"HORIA / CAMIN    CULTURAL",3,11639,"HORIA",120922,1600,791,744,47,0,786,5,1700,909,418,368
29,"NEAMŢ","#N/A",120922,,309,"COTU VAMEŞ / SCOALA  CU  CL.I-VIII  '' OTILIA  CAZIMIR ''",3,11639,"HORIA",120922,1432,725,675,49,1,721,4,1600,875,400,321
29,"NEAMŢ","#N/A",120922,,310,"COTU VAMEŞ / GRADINITA DE COPII",3,11639,"HORIA",120922,1353,744,712,32,0,731,13,1500,756,407,324
29,"NEAMŢ","#N/A",123013,,311,"ICUŞEŞTI / SCOALA",3,11642,"ICUŞEŞTI",123013,630,314,282,32,0,309,5,700,386,141,168
29,"NEAMŢ","#N/A",123013,,312,"BĂLUŞEŞTI / SCOALA",3,11642,"ICUŞEŞTI",123013,798,355,338,17,0,350,5,900,545,212,138
29,"NEAMŢ","#N/A",123013,,313,"BĂLUŞEŞTI / SCOALA",3,11642,"ICUŞEŞTI",123013,1130,554,527,27,0,547,7,1200,646,248,299
29,"NEAMŢ","#N/A",123013,,314,"ROCNA / SCOALA",3,11642,"ICUŞEŞTI",123013,459,228,193,35,0,223,5,500,272,177,46
29,"NEAMŢ","#N/A",123013,,315,"MESTEACĂN / SCOALA",3,11642,"ICUŞEŞTI",123013,434,254,226,28,0,251,3,500,246,134,117
29,"NEAMŢ","#N/A",123013,,316,"SPIRIDONEŞTI / SCOALA",3,11642,"ICUŞEŞTI",123013,190,122,95,27,0,120,2,200,78,78,42
29,"NEAMŢ","#N/A",123102,,317,"IZVORU / ŞCOALA",3,11650,"ION CREANGĂ",123102,355,226,193,31,2,224,2,400,174,137,87
29,"NEAMŢ","#N/A",123102,,318,"RECEA / ŞCOALA",3,11650,"ION CREANGĂ",123102,657,334,311,23,0,333,1,700,366,187,146
29,"NEAMŢ","#N/A",123102,,319,"STEJARU / CĂMIN CULTURAL",3,11650,"ION CREANGĂ",123102,676,411,373,38,0,410,1,700,289,312,98
29,"NEAMŢ","#N/A",123102,,320,"ION CREANGĂ / CAMIN    CULTURAL",3,11650,"ION CREANGĂ",123102,982,551,510,35,6,547,4,1100,549,378,169
29,"NEAMŢ","#N/A",123102,,321,"ION CREANGĂ / CAMIN    CULTURAL",3,11650,"ION CREANGĂ",123102,1168,676,621,46,9,669,7,1300,624,448,221
29,"NEAMŢ","#N/A",123102,,322,"AVEREŞTI / CAMIN    CULTURAL",3,11650,"ION CREANGĂ",123102,801,515,443,72,0,506,9,900,385,364,142
29,"NEAMŢ","#N/A",123175,,323,"MĂRGINENI / ŞCOALA GENERALĂ",3,11657,"MĂRGINENI",123175,908,396,364,32,0,387,9,1000,604,259,128
29,"NEAMŢ","#N/A",123175,,324,"MĂRGINENI / GRĂDINIŢA",3,11657,"MĂRGINENI",123175,977,440,403,36,1,435,5,1100,660,271,164
29,"NEAMŢ","#N/A",123175,,325,"HÎRŢEŞTI / Scoala Generala",3,11657,"MĂRGINENI",123175,205,140,115,24,1,138,2,300,160,94,44
29,"NEAMŢ","#N/A",123175,,326,"HOISEŞTI / ŞCOALA GENERALĂ",3,11657,"MĂRGINENI",123175,786,389,355,34,0,386,3,900,511,275,111
29,"NEAMŢ","#N/A",123175,,327,"ITRINEŞTI / ŞCOALA GENERALĂ",3,11657,"MĂRGINENI",123175,247,122,94,28,0,119,3,300,178,66,53
29,"NEAMŢ","#N/A",123228,,328,"MOLDOVENI / SCOALA CU CL. I-VIII",3,11662,"MOLDOVENI",123228,1063,641,536,105,0,631,10,1200,559,325,306
29,"NEAMŢ","#N/A",123228,,329,"HOCIUNGI / SCOALA CU CL. I-VIII",3,11662,"MOLDOVENI",123228,755,426,355,71,0,414,12,800,374,221,193
29,"NEAMŢ","#N/A",125169,,330,"NEGREŞTI / Scoala cu clasele I-VIII ""DUMITRU ALMAS""",3,11665,"NEGREŞTI",125169,1267,722,625,97,0,716,6,1400,678,458,258
29,"NEAMŢ","#N/A",125169,,331,"POIANA / ŞCOALA",3,11665,"NEGREŞTI",125169,335,235,192,43,0,228,7,399,164,163,65
29,"NEAMŢ","#N/A",123255,,332,"ONICENI / ŞCOALA GENERALĂ",3,11668,"ONICENI",123255,668,415,377,38,0,411,4,700,285,330,81
29,"NEAMŢ","#N/A",123255,,333,"GORUN / ŞCOALA GENERALĂ",3,11668,"ONICENI",123255,219,166,151,13,2,165,1,300,134,146,19
29,"NEAMŢ","#N/A",123255,,334,"MĂRMURENI / ŞCOALA GENERALĂ",3,11668,"ONICENI",123255,352,232,200,32,0,230,2,400,168,181,49
29,"NEAMŢ","#N/A",123255,,335,"SOLCA / ŞCOALA GENERALĂ",3,11668,"ONICENI",123255,925,673,623,48,2,667,6,1000,327,600,67
29,"NEAMŢ","#N/A",123255,,336,"VALEA ENEI / ŞCOALA GENERALĂ",3,11668,"ONICENI",123255,315,218,202,16,0,217,1,400,182,158,59
29,"NEAMŢ","#N/A",123371,,337,"PĂSTRĂVENI / ŞCOALA CU CLASELE I-VIII",3,11686,"PĂSTRĂVENI",123371,729,413,385,28,0,409,4,800,387,289,120
29,"NEAMŢ","#N/A",123371,,338,"PĂSTRĂVENI / CENTRU DE RECUPERARE SI REABILITARE A PERSOANELOR CU HANDICAP",3,11686,"PĂSTRĂVENI",123371,736,380,344,36,0,373,7,800,420,282,91
29,"NEAMŢ","#N/A",123371,,339,"RĂDENI / SCOALA CU CLASELE I-VIII",3,11686,"PĂSTRĂVENI",123371,787,414,376,38,0,411,3,900,486,292,119
29,"NEAMŢ","#N/A",123371,,340,"RĂDENI / SCOALA CU CLASELE I-IV",3,11686,"PĂSTRĂVENI",123371,575,343,321,22,0,336,7,600,257,232,104
29,"NEAMŢ","#N/A",123371,,341,"LUNCA MOLDOVEI / SCOALA CU CLASELE I-IV",3,11686,"PĂSTRĂVENI",123371,263,186,168,18,0,185,1,300,114,161,24
29,"NEAMŢ","#N/A",125141,,342,"PÂNCEŞTI / ŞCOALA CU CLASELE  I-VIII",3,11680,"PÂNCEŞTI",125141,974,489,448,41,0,488,1,1100,611,340,148
29,"NEAMŢ","#N/A",125141,,343,"CIUREA / ŞCOALA PRIMARA",3,11680,"PÂNCEŞTI",125141,219,139,120,19,0,138,1,300,161,101,37
29,"NEAMŢ","#N/A",123424,,344,"PETRICANI / LICEUL TEHNOLOGIC",3,11691,"PETRICANI",123424,1473,798,756,42,0,793,5,1600,802,454,339
29,"NEAMŢ","#N/A",123424,,345,"BOIŞTEA / SCOALA GENERALA",3,11691,"PETRICANI",123424,734,514,480,34,0,509,5,800,286,361,148
29,"NEAMŢ","#N/A",123424,,346,"TÎRPEŞTI / SCOALA GENERALA",3,11691,"PETRICANI",123424,1102,608,564,44,0,600,8,1200,592,379,221
29,"NEAMŢ","#N/A",123424,,347,"ŢOLICI / SCOALA GENERALA",3,11691,"PETRICANI",123424,1229,616,595,21,0,604,12,1300,684,478,126
29,"NEAMŢ","#N/A",123479,,348,"LUMINIŞ / SCOALA GENERALA",3,11696,"PIATRA ŞOIMULUI",123479,1140,502,481,21,0,494,8,1200,698,323,171
29,"NEAMŢ","#N/A",123479,,349,"POIENI / SCOALA GENERALA",3,11696,"PIATRA ŞOIMULUI",123479,1083,602,579,23,0,599,3,1200,598,433,166
29,"NEAMŢ","#N/A",123479,,350,"LUMINIŞ / ŞCOALA GENERALĂ",3,11696,"PIATRA ŞOIMULUI",123479,1043,502,469,33,0,489,13,1100,598,314,175
29,"NEAMŢ","#N/A",123479,,351,"NEGULEŞTI / SCOALA PRIMARA",3,11696,"PIATRA ŞOIMULUI",123479,561,315,298,17,0,311,4,600,285,197,114
29,"NEAMŢ","#N/A",123479,,352,"PIATRA ŞOIMULUI / ŞCOALA GENERALĂ NR.1",3,11696,"PIATRA ŞOIMULUI",123479,1594,669,623,45,1,654,15,1700,1031,365,289
29,"NEAMŢ","#N/A",123479,,353,"PIATRA ŞOIMULUI / ŞCOALA GENERALĂ NR. 2",3,11696,"PIATRA ŞOIMULUI",123479,1450,703,664,39,0,696,7,1600,897,410,286
29,"NEAMŢ","#N/A",123521,,354,"DOLHEŞTI / Liceul Tehnologic ""Ion Creanga"" Pipirig",3,11708,"PIPIRIG",123521,1421,835,803,31,1,829,6,1500,665,463,366
29,"NEAMŢ","#N/A",123521,,355,"PIPIRIG / Scoala cu clasele I-IV nr. 2 Pipirig",3,11708,"PIPIRIG",123521,872,515,486,28,1,510,5,900,385,303,207
29,"NEAMŢ","#N/A",123521,,356,"BOBOIEŞTI / Scoala cu clasele I-VIII Boboiesti",3,11708,"PIPIRIG",123521,1307,721,704,17,0,713,8,1400,679,478,235
29,"NEAMŢ","#N/A",123521,,357,"LEGHIN / Scoala cu clasele I-IV Leghin",3,11708,"PIPIRIG",123521,506,294,278,16,0,292,2,600,306,189,103
29,"NEAMŢ","#N/A",123521,,358,"STÎNCA / Scoala cu clasele I-VIII Stinca",3,11708,"PIPIRIG",123521,1194,683,656,27,0,677,6,1300,617,441,236
29,"NEAMŢ","#N/A",123521,,359,"DOLHEŞTI / Scoala cu clasele I-IV Dolhesti",3,11708,"PIPIRIG",123521,877,431,411,20,0,429,2,1000,569,280,149
29,"NEAMŢ","#N/A",123521,,360,"PLUTON / Scoala cu clasele I-VIII Pluton",3,11708,"PIPIRIG",123521,852,408,394,13,1,405,3,900,492,200,205
29,"NEAMŢ","#N/A",123601,,361,"PÎNGĂRĂCIOR / ŞCOALA PÎNGĂRAŢI",3,11701,"PÎNGĂRAŢI",123601,1690,957,879,78,0,943,14,1800,843,396,547
29,"NEAMŢ","#N/A",123601,,362,"PÎNGARAŢI / ŞCOALA PÎNGĂRAŢI - CASTEL",3,11701,"PÎNGĂRAŢI",123601,623,390,332,53,5,383,7,700,310,140,243
29,"NEAMŢ","#N/A",123601,,363,"STEJARU / ŞCOALA STEJARU",3,11701,"PÎNGĂRAŢI",123601,878,541,472,68,1,536,5,900,359,180,356
29,"NEAMŢ","#N/A",123601,,364,"OANŢU / ŞCOALA OANŢU",3,11701,"PÎNGĂRAŢI",123601,1265,686,629,57,0,677,9,1300,614,345,332
29,"NEAMŢ","#N/A",123674,,365,"PODOLENI / GRĂDINIŢA AR NR. 2",3,11716,"PODOLENI",123674,1431,719,669,47,3,715,4,1600,881,433,282
29,"NEAMŢ","#N/A",123674,,366,"PODOLENI / ŞCOALA GIMNAZIALĂ ""ALEXANDRU PODOLEANU""",3,11716,"PODOLENI",123674,1015,538,482,46,10,530,8,1100,562,323,207
29,"NEAMŢ","#N/A",123674,,367,"PODOLENI / ŞCOALA GIMNAZIALĂ ""ALEXANDRU PODOLEANU""",3,11716,"PODOLENI",123674,1014,540,494,46,0,532,8,1100,560,346,186
29,"NEAMŢ","#N/A",123674,,368,"PODOLENI / GRĂDINIŢA AR NR. 3",3,11716,"PODOLENI",123674,936,513,478,29,6,505,8,1000,487,332,173
29,"NEAMŢ","#N/A",123674,,369,"NEGRITEŞTI / ŞCOALA PRIMARĂ NEGRITEŞTI",3,11716,"PODOLENI",123674,315,215,189,23,3,214,1,400,185,155,59
29,"NEAMŢ","#N/A",123790,,370,"DREPTU / ŞCOALA",3,11719,"POIANA TEIULUI",123790,964,593,555,38,0,586,7,1100,507,407,179
29,"NEAMŢ","#N/A",123790,,371,"POIANA LARGULUI / ŞCOALA",3,11719,"POIANA TEIULUI",123790,779,464,434,30,0,456,8,900,436,256,200
29,"NEAMŢ","#N/A",123790,,372,"PETRU VODĂ / ŞCOALA",3,11719,"POIANA TEIULUI",123790,1066,499,459,40,0,489,10,1200,701,203,286
29,"NEAMŢ","#N/A",123790,,373,"POIANA TEIULUI / GRĂDINIŢA",3,11719,"POIANA TEIULUI",123790,1323,801,739,62,0,787,14,1400,599,413,374
29,"NEAMŢ","#N/A",123709,,374,"POIENARI / SCOALA GIMNAZIALA NR. 1",3,11731,"POIENARI",123709,1010,550,494,56,0,541,9,1100,550,326,215
29,"NEAMŢ","#N/A",123709,,375,"SĂCĂLENI / SCOALA GIMNAZIALA STRUCTURA SACALENI",3,11731,"POIENARI",123709,285,203,157,46,0,201,2,300,97,150,51
29,"NEAMŢ","#N/A",123914,,376,"OGLINZI / Liceul tehnologic",3,11735,"RĂUCEŞTI",123914,1625,914,831,83,0,910,4,1700,786,594,316
29,"NEAMŢ","#N/A",123914,,377,"OGLINZI / Şcoala primară",3,11735,"RĂUCEŞTI",123914,762,485,403,82,0,479,6,800,315,325,154
29,"NEAMŢ","#N/A",123914,,378,"UNGHENI / Şcoala primară",3,11735,"RĂUCEŞTI",123914,440,294,261,33,0,292,2,500,206,205,87
29,"NEAMŢ","#N/A",123914,,379,"RĂUCEŞTI / Şcoala gimnazială nr. 1",3,11735,"RĂUCEŞTI",123914,1338,709,658,51,0,702,7,1400,691,481,221
29,"NEAMŢ","#N/A",123914,,380,"RĂUCEŞTI / Şcoala gimnazială nr. 2",3,11735,"RĂUCEŞTI",123914,740,410,355,55,0,403,7,800,390,291,112
29,"NEAMŢ","#N/A",123914,,381,"RĂUCEŞTI / Grădiniţa cu program normal nr. 2",3,11735,"RĂUCEŞTI",123914,539,309,268,41,0,305,4,600,291,188,117
29,"NEAMŢ","#N/A",123914,,382,"OGLINZI / Sediul PFA ""Şalaru Jeanina""",3,11735,"RĂUCEŞTI",123914,742,400,380,20,0,394,6,800,400,274,120
29,"NEAMŢ","#N/A",123914,,383,"SĂVEŞTI / Grădiniţa cu program normal",3,11735,"RĂUCEŞTI",123914,387,232,202,30,0,229,3,400,168,175,54
29,"NEAMŢ","#N/A",123969,,384,"BORŞENI / Scoala Generala",3,11740,"RĂZBOIENI",123969,311,208,161,36,11,205,3,399,191,157,48
29,"NEAMŢ","#N/A",123969,,385,"VALEA ALBĂ / Scoala Generala",3,11740,"RĂZBOIENI",123969,341,254,197,47,10,249,5,400,146,185,64
29,"NEAMŢ","#N/A",123969,,386,"RĂZBOIENII DE JOS / Scoala Generala cu clasele I-VIII",3,11740,"RĂZBOIENI",123969,638,505,398,79,28,498,7,700,195,336,162
29,"NEAMŢ","#N/A",123969,,387,"RĂZBOIENI / Scoala Generala cu clasele I-IV nr. 3",3,11740,"RĂZBOIENI",123969,534,309,248,45,16,301,8,700,391,203,98
29,"NEAMŢ","#N/A",124028,,388,"BEŢEŞTI / ŞCOALA",3,11746,"REDIU",124028,638,340,318,22,0,338,2,700,360,189,149
29,"NEAMŢ","#N/A",124028,,389,"POLOBOC / ŞCOALA",3,11746,"REDIU",124028,1183,619,571,48,0,612,7,1300,681,369,243
29,"NEAMŢ","#N/A",124028,,390,"SOCEA / ŞCOALA",3,11746,"REDIU",124028,638,327,297,30,0,327,0,700,373,239,88
29,"NEAMŢ","#N/A",124028,,391,"REDIU / ŞCOALA CU CLASELE I-VIII",3,11746,"REDIU",124028,1912,925,862,63,0,919,6,2100,1175,496,423
29,"NEAMŢ","#N/A",124073,,392,"ROMÂNI / ŞCOALA CU CLASELE I-VIII",3,11751,"ROMÂNI",124073,811,477,400,39,38,471,6,900,423,324,147
29,"NEAMŢ","#N/A",124073,,393,"SILIŞTEA / ŞCOALA CU CLASELE I-VIII",3,11751,"ROMÂNI",124073,1051,716,614,73,29,708,8,1100,384,512,196
29,"NEAMŢ","#N/A",124073,,394,"GOŞMANI / ŞCOALA CU CLASELE I-VIII",3,11751,"ROMÂNI",124073,840,512,474,38,0,507,5,900,388,357,150
29,"NEAMŢ","#N/A",124073,,395,"SILIŞTEA / SCOALA CU CLASELE I-VIII SILISTEAII",3,11751,"ROMÂNI",124073,813,484,382,74,28,478,6,900,416,313,165
29,"NEAMŢ","#N/A",125105,,396,"BOZIENII DE SUS / ŞCOALA",3,11755,"RUGINOASA",125105,318,227,137,38,52,220,7,400,173,113,107
29,"NEAMŢ","#N/A",125105,,397,"RUGINOASA / ŞCOALA CU CLASELE I-VIII",3,11755,"RUGINOASA",125105,662,460,395,45,20,458,2,700,240,281,177
29,"NEAMŢ","#N/A",125105,,398,"RUGINOASA / ŞCOALA CU CLASELE I-VIII",3,11755,"RUGINOASA",125105,676,454,395,44,15,445,9,700,246,281,164
29,"NEAMŢ","#N/A",124153,,399,"SAGNA / Şcoala generala",3,11761,"SAGNA",124153,1640,727,700,24,3,711,16,1800,1073,367,344
29,"NEAMŢ","#N/A",124153,,400,"SAGNA / Şcoala generala",3,11761,"SAGNA",124153,1488,680,631,36,13,667,13,1600,920,371,296
29,"NEAMŢ","#N/A",124153,,401,"LUŢCA / Şcoala generală Sagna",3,11761,"SAGNA",124153,397,222,195,27,0,218,4,400,178,132,86
29,"NEAMŢ","#N/A",124153,,402,"VULPĂŞEŞTI /  Şcoala generală Sagna",3,11761,"SAGNA",124153,691,357,320,37,0,353,4,700,343,207,146
29,"NEAMŢ","#N/A",124206,,403,"TRAIAN / ŞCOALA",3,11758,"SĂBĂOANI",124206,1002,561,500,35,26,554,7,1100,539,289,265
29,"NEAMŢ","#N/A",124206,,404,"SĂBĂOANI / ŞCOALA GENERALĂ",3,11758,"SĂBĂOANI",124206,1068,428,393,30,5,422,6,1200,772,213,209
29,"NEAMŢ","#N/A",124206,,405,"SĂBĂOANI / ŞCOALA GENERALĂ",3,11758,"SĂBĂOANI",124206,1773,823,781,34,8,811,12,1900,1077,422,389
29,"NEAMŢ","#N/A",124206,,406,"SĂBĂOANI / ŞCOALA GENERALĂ",3,11758,"SĂBĂOANI",124206,1130,445,431,13,1,437,8,1200,755,227,210
29,"NEAMŢ","#N/A",124206,,407,"SĂBĂOANI / LICEUL TEORETIC ""VASILE ALECSANDRI""",3,11758,"SĂBĂOANI",124206,1036,447,417,20,10,444,3,1100,653,260,184
29,"NEAMŢ","#N/A",124206,,408,"SĂBĂOANI / LICEUL TEORETIC ""VASILE ALECSANDRI""",3,11758,"SĂBĂOANI",124206,861,386,360,8,18,379,7,900,514,206,173
29,"NEAMŢ","#N/A",124206,,409,"SĂBĂOANI / ŞCOALA GENRALĂ NR.2",3,11758,"SĂBĂOANI",124206,1404,566,539,25,2,559,7,1500,934,267,292
29,"NEAMŢ","#N/A",124206,,410,"SĂBĂOANI / ŞCOALA GENERALĂ NR.2",3,11758,"SĂBĂOANI",124206,1111,465,448,10,7,460,5,1200,735,265,195
29,"NEAMŢ","#N/A",120824,,411,"SĂVINEŞTI / SCOALA CU CLASELE I-VIII",3,11765,"SĂVINEŞTI",120824,1527,626,581,41,4,609,17,1600,974,336,273
29,"NEAMŢ","#N/A",120824,,412,"DUMBRAVA DEAL / SCOALA CU CLASELE I-IV",3,11765,"SĂVINEŞTI",120824,359,211,186,23,2,204,7,400,189,114,90
29,"NEAMŢ","#N/A",120824,,413,"SĂVINEŞTI / GRADINITA CU PROGRAM NORMAL",3,11765,"SĂVINEŞTI",120824,420,207,191,16,0,201,6,500,293,96,105
29,"NEAMŢ","#N/A",120824,,414,"SĂVINEŞTI / GRADINIŢA CU PROGRAM PRELUNGIT SAVINESTI",3,11765,"SĂVINEŞTI",120824,550,309,279,30,0,301,8,600,291,163,138
29,"NEAMŢ","#N/A",120824,,415,"SĂVINEŞTI / ŞCOALA CU CLASELE I-VIII SAVINESTI SAT",3,11765,"SĂVINEŞTI",120824,1462,826,763,47,16,810,16,1600,774,466,344
29,"NEAMŢ","#N/A",120824,,416,"SĂVINEŞTI / SCOALA CU CLASELE I-IV SAVINESTI, D-VA VALE",3,11765,"SĂVINEŞTI",120824,1168,686,618,56,12,670,16,1200,514,384,286
29,"NEAMŢ","#N/A",124233,,417,"SECUIENI / CĂMINUL CULTURAL",3,11768,"SECUIENI",124233,986,477,427,50,0,476,1,1100,623,247,229
29,"NEAMŢ","#N/A",124233,,418,"BAŞTA / CĂMINUL CULTURAL",3,11768,"SECUIENI",124233,545,318,274,44,0,314,4,598,280,170,144
29,"NEAMŢ","#N/A",124233,,419,"BUTNĂREŞTI / CĂMINUL CULTURAL",3,11768,"SECUIENI",124233,965,504,442,62,0,496,8,1000,496,306,190
29,"NEAMŢ","#N/A",124233,,420,"GIULEŞTI / CLĂDIRE",3,11768,"SECUIENI",124233,229,128,109,19,0,127,1,300,172,98,29
29,"NEAMŢ","#N/A",124331,,421,"STĂNIŢA / SCOALA GIMNAZIALA CU CLASELE I-VIII STANITA",3,11778,"STĂNIŢA",124331,424,235,192,43,0,231,4,500,265,146,85
29,"NEAMŢ","#N/A",124331,,422,"TODIRENI / SCOALA PRIMARA NR.1- TODIRENI",3,11778,"STĂNIŢA",124331,267,153,128,25,0,148,5,299,146,112,36
29,"NEAMŢ","#N/A",124331,,423,"CHICEREA / SCOALA PRIMARA,NR.5",3,11778,"STĂNIŢA",124331,211,118,94,24,0,115,3,300,182,56,59
29,"NEAMŢ","#N/A",124331,,424,"POIENILE OANCEI / SCOALA  PRIMARA, NR.4",3,11778,"STĂNIŢA",124331,196,110,88,22,0,108,2,300,190,70,38
29,"NEAMŢ","#N/A",124331,,425,"GHIDION / SCOALA PRIMARA , NR.2",3,11778,"STĂNIŢA",124331,321,175,158,17,0,172,3,400,225,134,38
29,"NEAMŢ","#N/A",124331,,426,"VEJA / SCOALA PRIMARA, NR.3",3,11778,"STĂNIŢA",124331,234,154,130,24,0,151,3,301,147,97,54
29,"NEAMŢ","#N/A",124411,,427,"SOCI / ŞCOALA",3,11786,"ŞTEFAN CEL MARE",124411,274,215,151,49,15,214,1,300,85,147,67
29,"NEAMŢ","#N/A",124411,,428,"GHIGOIEŞTI / SCOALA PRIMARA",3,11786,"ŞTEFAN CEL MARE",124411,496,392,314,67,11,387,5,500,108,225,162
29,"NEAMŢ","#N/A",124411,,429,"CÎRLIGI / GRĂDINIŢA CU PROGRAM NORMAL",3,11786,"ŞTEFAN CEL MARE",124411,430,288,232,49,7,285,3,500,212,172,113
29,"NEAMŢ","#N/A",124411,,430,"ŞTEFAN CEL MARE / SCOALA GIMNAZIALA DR. EMANUIEL RIGLER",3,11786,"ŞTEFAN CEL MARE",124411,712,508,426,75,7,494,14,800,292,333,161
29,"NEAMŢ","#N/A",124411,,431,"ŞTEFAN CEL MARE / SCOALA GIMNAZIALA DR. EMANUIEL RIGLER",3,11786,"ŞTEFAN CEL MARE",124411,727,528,430,87,11,518,10,800,272,373,145
29,"NEAMŢ","#N/A",124493,,432,"TARCĂU / Şcola gimnazială ""Iulia Hălăucescu"", comuna Tarcău, judeţul Neamţ",3,11797,"TARCĂU",124493,806,502,445,55,2,493,9,900,398,235,258
29,"NEAMŢ","#N/A",124493,,433,"TARCĂU / Şcola gimnazială ""Iulia Hălăucescu"", comuna Tarcău, judeţul Neamţ",3,11797,"TARCĂU",124493,829,473,436,36,1,470,3,900,427,227,243
29,"NEAMŢ","#N/A",124493,,434,"STRAJA / GRĂDINIŢA",3,11797,"TARCĂU",124493,547,332,299,33,0,330,2,600,268,145,185
29,"NEAMŢ","#N/A",124493,,435,"CAZACI / GRĂDINIŢA",3,11797,"TARCĂU",124493,434,274,249,24,1,274,0,500,226,152,122
29,"NEAMŢ","#N/A",124493,,436,"BRATEŞ / GRĂDINIŢA",3,11797,"TARCĂU",124493,296,201,163,38,0,200,1,303,102,76,124
29,"NEAMŢ","#N/A",124563,,437,"TAŞCA / CAMIN CULTURAL",3,11804,"TAŞCA",124563,1409,900,849,51,0,886,14,1500,600,401,485
29,"NEAMŢ","#N/A",124563,,438,"NEAGRA / SCOALA NEAGRA",3,11804,"TAŞCA",124563,781,451,427,24,0,440,11,800,349,227,213
29,"NEAMŢ","#N/A",124616,,439,"TAZLĂU / SCOALA GIMNAZIALA ""I.I. MIRONESCU""",3,11809,"TAZLĂU",124616,1104,600,541,55,4,592,8,1200,600,358,234
29,"NEAMŢ","#N/A",124616,,440,"TAZLĂU / CAMINUL CULTURAL",3,11809,"TAZLĂU",124616,1240,717,672,43,2,711,6,1300,583,450,261
29,"NEAMŢ","#N/A",124634,,441,"ADJUDENI / Liceul Tehnologic",3,11794,"TĂMĂŞENI",124634,1643,615,565,50,0,609,6,1800,1185,175,434
29,"NEAMŢ","#N/A",124634,,442,"TĂMĂŞENI / Gradinita",3,11794,"TĂMĂŞENI",124634,1279,594,554,40,0,586,8,1400,806,306,280
29,"NEAMŢ","#N/A",124634,,443,"ADJUDENI / Gradinita",3,11794,"TĂMĂŞENI",124634,1080,433,391,42,0,431,2,1200,767,110,321
29,"NEAMŢ","#N/A",124634,,444,"TĂMĂŞENI / Scoala cu clasele I-VIII",3,11794,"TĂMĂŞENI",124634,1290,517,466,51,0,510,7,1400,883,208,302
29,"NEAMŢ","#N/A",124634,,445,"TĂMĂŞENI / Caminul Cultural",3,11794,"TĂMĂŞENI",124634,1035,471,438,33,0,463,8,1100,629,236,227
29,"NEAMŢ","#N/A",124634,,446,"ADJUDENI / Centrul Medical Adjudeni",3,11794,"TĂMĂŞENI",124634,1321,597,501,96,0,591,6,1400,803,137,454
29,"NEAMŢ","#N/A",124661,,447,"TIMIŞEŞTI / ŞCOALA GIMNAZIALĂ",3,11815,"TIMIŞEŞTI",124661,1031,544,489,55,0,534,10,1100,556,405,129
29,"NEAMŢ","#N/A",124661,,448,"DUMBRAVA / ŞCOALA GIMNAZIALĂ",3,11815,"TIMIŞEŞTI",124661,967,589,548,41,0,584,5,1000,411,470,114
29,"NEAMŢ","#N/A",124661,,449,"PLĂIEŞU / ŞCOALA PRIMARĂ",3,11815,"TIMIŞEŞTI",124661,647,364,327,37,0,355,9,700,336,264,91
29,"NEAMŢ","#N/A",124661,,450,"PREUTEŞTI / ŞCOALA PRIMARĂ",3,11815,"TIMIŞEŞTI",124661,467,282,262,20,0,278,4,498,216,204,74
29,"NEAMŢ","#N/A",124661,,451,"ZVORĂNEŞTI / ŞCOALA PRIMARĂ",3,11815,"TIMIŞEŞTI",124661,140,95,75,20,0,93,2,200,105,68,25
29,"NEAMŢ","#N/A",124723,,452,"TRIFEŞTI / Scoala cu clasele I - VIII",3,11821,"TRIFEŞTI",124723,1847,1049,972,77,0,1031,18,2000,951,696,335
29,"NEAMŢ","#N/A",124723,,453,"TRIFEŞTI / Scoala cu clasele I - IV",3,11821,"TRIFEŞTI",124723,768,485,437,48,0,478,7,800,315,323,155
29,"NEAMŢ","#N/A",124723,,454,"MIRON COSTIN / Scoala cu clasele I - IV",3,11821,"TRIFEŞTI",124723,863,443,407,36,0,436,7,900,457,296,140
29,"NEAMŢ","#N/A",124723,,455,"MIRON COSTIN / scoala cu clasele  I-VIII",3,11821,"TRIFEŞTI",124723,696,401,354,47,0,394,7,700,299,279,115
29,"NEAMŢ","#N/A",124750,,456,"TUPILAŢI / Scoala cu clasele I-VIII",3,11824,"TUPILAŢI",124750,987,635,532,103,0,626,9,1100,465,430,196
29,"NEAMŢ","#N/A",124750,,457,"TOTOIEŞTI / Scoala cu clasele I-VIII",3,11824,"TUPILAŢI",124750,272,175,138,37,0,175,0,300,125,109,66
29,"NEAMŢ","#N/A",124750,,458,"TUPILAŢI / Primaria Tupilaţi",3,11824,"TUPILAŢI",124750,525,392,321,71,0,386,6,600,208,284,102
29,"NEAMŢ","#N/A",124803,,459,"ŢIBUCANII DE JOS / ŞCOALA CU CLASELE I-IV",3,11811,"ŢIBUCANI",124803,349,260,197,38,25,257,3,400,140,179,78
29,"NEAMŢ","#N/A",124803,,460,"DAVIDENI / ŞCOALA CU CLASELE I-VIII",3,11811,"ŢIBUCANI",124803,825,524,452,59,13,518,6,900,376,349,169
29,"NEAMŢ","#N/A",124803,,461,"ŢIBUCANI / ŞCOALA CU CLASELE I-VIII NR.1",3,11811,"ŢIBUCANI",124803,1349,876,769,77,30,861,15,1400,524,630,231
29,"NEAMŢ","#N/A",124803,,462,"ŢIBUCANI / ŞCOALA CU CLASELE I-VIII NR.3",3,11811,"ŢIBUCANI",124803,872,485,433,41,11,472,13,900,415,337,135
29,"NEAMŢ","#N/A",124849,,463,"URECHENI / SCOALA CU CLASELE I-VIII",3,11829,"URECHENI",124849,640,320,292,28,0,315,5,700,380,227,88
29,"NEAMŢ","#N/A",124849,,464,"URECHENI / SCOALA CU CLASELE I-VIII",3,11829,"URECHENI",124849,824,404,386,18,0,401,3,900,496,300,101
29,"NEAMŢ","#N/A",124849,,465,"URECHENI / GRADINITA FUNDATURA",3,11829,"URECHENI",124849,583,320,295,25,0,315,5,600,280,263,52
29,"NEAMŢ","#N/A",124849,,466,"URECHENI / GRADINITA CATUNA",3,11829,"URECHENI",124849,515,245,224,21,0,235,10,600,355,177,58
29,"NEAMŢ","#N/A",124849,,467,"INGĂREŞTI / Scoala cu clasele 1-8 Ingaresti",3,11829,"URECHENI",124849,742,381,365,16,0,378,3,800,419,241,137
29,"NEAMŢ","#N/A",124885,,468,"VALEA URSULUI / CAMIN CULTURAL VALEA URSULUI",3,11833,"VALEA URSULUI",124885,759,403,378,25,0,397,6,800,397,324,73
29,"NEAMŢ","#N/A",124885,,469,"BUCIUM / SCOALA BUCIUM , COMUNA VALEA URSULUI",3,11833,"VALEA URSULUI",124885,540,350,300,50,0,343,7,600,250,290,53
29,"NEAMŢ","#N/A",124885,,470,"CHILII / SCOALA CHILII , COMUNA VALEA URSULUI",3,11833,"VALEA URSULUI",124885,923,502,477,25,0,491,11,1000,498,402,89
29,"NEAMŢ","#N/A",124885,,471,"GIURGENI / SCOALA GIURGENI , COMUNA VALEA URSULUI",3,11833,"VALEA URSULUI",124885,537,287,263,24,0,286,1,600,313,214,72
29,"NEAMŢ","#N/A",124885,,472,"MUNCELU DE JOS / SCOALA MUNCEL , COMUNA VALEA URSULUI",3,11833,"VALEA URSULUI",124885,294,239,213,26,0,238,1,300,61,191,47
29,"NEAMŢ","#N/A",125123,,473,"MORENI / ŞCOALA CU CLASELE I-VIII",3,11839,"VĂLENI",125123,558,365,322,43,0,357,8,600,235,314,43
29,"NEAMŢ","#N/A",125123,,474,"VĂLENI / CONSILIUL LOCAL VĂLENI",3,11839,"VĂLENI",125123,627,368,331,37,0,364,4,700,332,269,95
29,"NEAMŢ","#N/A",125016,,475,"VÎNĂTORI-NEAMŢ / SCOALA GIMNAZIALA  ""ARHIM. CHIRIAC NICOLAU""",3,11844,"VÎNĂTORI-NEAMŢ",125016,1399,782,730,52,0,768,14,1500,718,471,297
29,"NEAMŢ","#N/A",125016,,476,"VÎNĂTORI-NEAMŢ / GRADINITA NR.2 UNGURENI",3,11844,"VÎNĂTORI-NEAMŢ",125016,1446,766,741,25,0,754,12,1600,834,518,236
29,"NEAMŢ","#N/A",125016,,477,"VÎNĂTORI-NEAMŢ / SCOALA GIMNAZIALA  ""ARHIM. CHIRIAC NICOLAU"" NR.2",3,11844,"VÎNĂTORI-NEAMŢ",125016,1389,790,760,30,0,768,22,1500,710,481,287
29,"NEAMŢ","#N/A",125016,,478,"LUNCA / SCOALA GIMNAZIALA ""ARHIM. CHIRIAC NICOLAU""",3,11844,"VÎNĂTORI-NEAMŢ",125016,999,573,557,15,1,567,6,1100,527,374,193
29,"NEAMŢ","#N/A",125016,,479,"NEMŢIŞOR / SCOALA  GIMNAZIALA,,ARHIM.CHIRIAC NECULAU"" NEMTISOR",3,11844,"VÎNĂTORI-NEAMŢ",125016,1353,712,676,36,0,704,8,1500,788,449,255
29,"NEAMŢ","#N/A",125016,,480,"MĂNĂSTIREA NEAMŢ / M-REA NEAMT",3,11844,"VÎNĂTORI-NEAMŢ",125016,227,174,123,51,0,167,7,297,123,89,78
29,"NEAMŢ","#N/A",125016,,481,"VÎNĂTORI-NEAMŢ / MANASTIREA SIHASTRIA",3,11844,"VÎNĂTORI-NEAMŢ",125016,164,121,59,62,0,109,12,200,79,75,34
29,"NEAMŢ","#N/A",125061,,482,"TRAIAN / SCOALA GENERALA",3,11849,"ZĂNEŞTI",125061,883,481,441,40,0,471,10,900,419,316,155
29,"NEAMŢ","#N/A",125061,,483,"ZĂNEŞTI / SCOALA GENERALA NR 2",3,11849,"ZĂNEŞTI",125061,1691,903,847,56,0,883,20,1800,897,481,402
29,"NEAMŢ","#N/A",125061,,484,"ZĂNEŞTI / SCOALA GENERA NR 1",3,11849,"ZĂNEŞTI",125061,1443,872,835,35,2,854,18,1500,628,480,374
29,"NEAMŢ","#N/A",125061,,485,"ZĂNEŞTI / Cantina ""SFANTUL ILIE"" FAURI",3,11849,"ZĂNEŞTI",125061,1084,572,541,31,0,560,12,1100,528,327,233
30,"OLT",289,125347,,1,"SLATINA / Colegiul Naţional Radu Greceanu",1,11853,"MUNICIPIUL SLATINA",125347,1323,780,741,35,4,766,14,1456,676,372,394
30,"OLT",289,125347,,2,"SLATINA / Colegiul Naţional Radu Greceanu",1,11853,"MUNICIPIUL SLATINA",125347,1305,783,694,89,0,767,16,1451,668,406,361
30,"OLT",289,125347,,3,"SLATINA / Colegiul Naţional Radu Greceanu",1,11853,"MUNICIPIUL SLATINA",125347,1985,1052,1018,34,0,1018,34,2191,1139,761,257
30,"OLT",289,125347,,4,"SLATINA / Şcoala Generală nr. 1",1,11853,"MUNICIPIUL SLATINA",125347,1262,810,752,45,13,795,15,1387,577,449,346
30,"OLT",289,125347,,5,"SLATINA / Şcoala Generală nr. 1",1,11853,"MUNICIPIUL SLATINA",125347,936,630,590,34,6,621,9,1034,404,361,260
30,"OLT",289,125347,,6,"SLATINA / Colegiul Naţional Ion Minulescu",1,11853,"MUNICIPIUL SLATINA",125347,1528,863,807,56,0,847,16,1686,823,425,422
30,"OLT",289,125347,,7,"SLATINA / Colegiul Naţional Ion Minulescu",1,11853,"MUNICIPIUL SLATINA",125347,1572,885,817,67,1,865,20,1735,850,464,401
30,"OLT",289,125347,,8,"SLATINA / Colegiul Naţional Ion Minulescu",1,11853,"MUNICIPIUL SLATINA",125347,1446,905,858,47,0,877,28,1598,693,419,458
30,"OLT",289,125347,,9,"SLATINA / Colegiul Naţional Ion Minulescu",1,11853,"MUNICIPIUL SLATINA",125347,1364,820,783,37,0,804,16,1503,683,421,383
30,"OLT",289,125347,,10,"SLATINA / Şcoala generală Ştefan Protopopescu",1,11853,"MUNICIPIUL SLATINA",125347,1917,1124,1026,95,3,1113,11,1994,870,602,511
30,"OLT",289,125347,,11,"SLATINA / Şcoala generală Ştefan Protopopescu",1,11853,"MUNICIPIUL SLATINA",125347,1897,955,900,55,0,937,18,2088,1133,483,454
30,"OLT",289,125347,,12,"SLATINA / Colegiul Naţional Vocaţional Nicolae Titulescu",1,11853,"MUNICIPIUL SLATINA",125347,1689,987,905,82,0,976,11,1863,876,512,464
30,"OLT",289,125347,,13,"SLATINA / Colegiul Naţional Vocaţional Nicolae Titulescu",1,11853,"MUNICIPIUL SLATINA",125347,1650,968,920,48,0,947,21,1812,844,491,456
30,"OLT",289,125347,,14,"SLATINA / Colegiul Naţional Vocaţional Nicolae Titulescu",1,11853,"MUNICIPIUL SLATINA",125347,1294,831,730,100,1,816,15,1422,591,435,381
30,"OLT",289,125347,,15,"SLATINA / Colegiul Naţional Vocaţional Nicolae Titulescu",1,11853,"MUNICIPIUL SLATINA",125347,1131,655,602,52,1,640,15,1249,594,325,315
30,"OLT",289,125347,,16,"SLATINA / Colegiul Naţional Vocaţional Nicolae Titulescu",1,11853,"MUNICIPIUL SLATINA",125347,1329,682,654,28,0,665,17,1458,776,365,300
30,"OLT",289,125347,,17,"SLATINA / Şcoala Generală Nicolae Iorga",1,11853,"MUNICIPIUL SLATINA",125347,1641,966,927,35,4,950,16,1805,839,516,434
30,"OLT",289,125347,,18,"SLATINA / Şcoala Generală Nicolae Iorga",1,11853,"MUNICIPIUL SLATINA",125347,1426,893,818,75,0,866,27,1576,683,476,390
30,"OLT",289,125347,,19,"SLATINA / Şcoala cu clasele I-VIII Eugen Ionescu",1,11853,"MUNICIPIUL SLATINA",125347,1740,886,828,58,0,870,16,1917,1031,483,387
30,"OLT",289,125347,,20,"SLATINA / Şcoala cu clasele I-VIII Eugen Ionescu",1,11853,"MUNICIPIUL SLATINA",125347,1297,773,725,47,1,756,17,1433,660,414,342
30,"OLT",289,125347,,21,"SLATINA / Şcoala cu clasele I-VIII Eugen Ionescu",1,11853,"MUNICIPIUL SLATINA",125347,1321,724,683,41,0,717,7,1458,734,437,280
30,"OLT",289,125347,,22,"SLATINA / Şcoala Generală nr. 7",1,11853,"MUNICIPIUL SLATINA",125347,1571,812,777,35,0,799,13,1739,927,447,352
30,"OLT",289,125347,,23,"SLATINA / Şcoala Generală nr. 7",1,11853,"MUNICIPIUL SLATINA",125347,1301,923,746,24,153,906,17,1436,513,489,417
30,"OLT",289,125347,,24,"SLATINA / Şcoala Generală nr. 7",1,11853,"MUNICIPIUL SLATINA",125347,1436,985,753,48,184,967,18,1586,601,551,416
30,"OLT",289,125347,,25,"SLATINA / Colegiul Economic P.S. Aurelian",1,11853,"MUNICIPIUL SLATINA",125347,1297,831,703,127,1,815,16,1428,597,456,359
30,"OLT",289,125347,,26,"SLATINA / Colegiul Economic P.S. Aurelian",1,11853,"MUNICIPIUL SLATINA",125347,1908,961,894,67,0,945,16,2111,1150,508,437
30,"OLT",289,125347,,27,"SLATINA / Liceul cu Program Sportiv",1,11853,"MUNICIPIUL SLATINA",125347,1941,1085,975,103,7,1058,27,2134,1049,574,484
30,"OLT",289,125347,,28,"SLATINA / Liceul cu Program Sportiv",1,11853,"MUNICIPIUL SLATINA",125347,1754,1045,968,77,0,1013,32,1939,894,546,467
30,"OLT",289,125347,,29,"SLATINA / Liceul cu Program Sportiv",1,11853,"MUNICIPIUL SLATINA",125347,1498,809,759,50,0,789,20,1648,839,415,374
30,"OLT",289,125347,,30,"SLATINA / Şcoala Generală nr. 3",1,11853,"MUNICIPIUL SLATINA",125347,1629,856,802,54,0,839,17,1807,951,440,399
30,"OLT",289,125347,,31,"SLATINA / Şcoala Generală nr. 3",1,11853,"MUNICIPIUL SLATINA",125347,1463,865,797,67,1,849,16,1621,756,430,419
30,"OLT",289,125347,,32,"SLATINA / Şcoala Generală nr. 3",1,11853,"MUNICIPIUL SLATINA",125347,939,578,512,66,0,566,12,1039,461,272,294
30,"OLT",289,125347,,33,"SLATINA / Şcoala Generală nr. 3",1,11853,"MUNICIPIUL SLATINA",125347,1681,886,863,23,0,872,14,1858,972,434,438
30,"OLT",289,125347,,34,"SLATINA / Grupul Şcolar Metalurgic",1,11853,"MUNICIPIUL SLATINA",125347,1693,866,816,50,0,842,24,1858,992,421,421
30,"OLT",289,125347,,35,"SLATINA / Grupul Şcolar Metalurgic",1,11853,"MUNICIPIUL SLATINA",125347,1704,854,788,66,0,841,13,1881,1027,392,449
30,"OLT",289,125347,,36,"SLATINA / Grupul Şcolar Metalurgic",1,11853,"MUNICIPIUL SLATINA",125347,806,450,421,29,0,442,8,893,443,255,187
30,"OLT",289,125347,,37,"SLATINA / Şcoala generală Constantin Brâncoveanu",1,11853,"MUNICIPIUL SLATINA",125347,1248,681,615,65,1,663,18,1379,698,303,360
30,"OLT",289,125347,,38,"SLATINA / Şcoala generală Constantin Brâncoveanu",1,11853,"MUNICIPIUL SLATINA",125347,1575,783,720,41,22,765,18,1737,954,400,365
30,"OLT",289,125347,,39,"SLATINA / Şcoala generală Constantin Brâncoveanu",1,11853,"MUNICIPIUL SLATINA",125347,1801,886,830,56,0,875,11,1988,1102,395,480
30,"OLT",289,125347,,40,"SLATINA / Şcoala generală Constantin Brâncoveanu",1,11853,"MUNICIPIUL SLATINA",125347,1560,861,802,59,0,842,19,1718,857,405,437
30,"OLT",289,125347,,41,"SLATINA / Şcoala generală Constantin Brâncoveanu",1,11853,"MUNICIPIUL SLATINA",125347,1719,900,844,56,0,880,20,1886,986,451,429
30,"OLT",289,125347,,42,"SLATINA / Şcoala Generală nr. 6",1,11853,"MUNICIPIUL SLATINA",125347,1463,961,916,44,1,939,22,1606,645,557,382
30,"OLT",289,125347,,43,"SLATINA / Grupul Şcolar Industrial Construcţii Maşini",1,11853,"MUNICIPIUL SLATINA",125347,1653,950,817,133,0,927,23,1826,876,469,458
30,"OLT",289,125347,,44,"SLATINA / Grupul Şcolar Industrial Construcţii Maşini",1,11853,"MUNICIPIUL SLATINA",125347,1297,752,672,80,0,742,10,1434,682,343,399
30,"OLT",289,125347,,45,"SLATINA / Grupul Şcolar Industrial Construcţii Maşini",1,11853,"MUNICIPIUL SLATINA",125347,1967,1079,1004,75,0,1063,16,2151,1072,506,557
30,"OLT",289,125347,,46,"CIREAŞOV / Şcoala Cireaşov",1,11853,"MUNICIPIUL SLATINA",125347,1159,750,725,25,0,741,9,1267,517,515,226
30,"OLT",289,125347,,47,"SLATINA / Şcoala Generală George Poboran",1,11853,"MUNICIPIUL SLATINA",125347,1231,773,654,119,0,758,15,1352,579,381,377
30,"OLT",289,125347,,48,"SLATINA / Şcoala Generală George Poboran",1,11853,"MUNICIPIUL SLATINA",125347,1300,649,581,68,0,641,8,1426,777,323,318
30,"OLT",289,125472,,49,"CARACAL / Colegiul Naţional Ioniţă Asan",1,11856,"MUNICIPIUL CARACAL",125472,1760,958,879,78,1,936,22,1937,979,616,320
30,"OLT",289,125472,,50,"CARACAL / Grădiniţa cu Program prelungit nr.1",1,11856,"MUNICIPIUL CARACAL",125472,1861,1038,952,86,0,1016,22,2049,1011,643,373
30,"OLT",289,125472,,51,"CARACAL / Grădiniţa cu Program normal nr.4",1,11856,"MUNICIPIUL CARACAL",125472,1692,1005,917,88,0,995,10,1878,873,612,383
30,"OLT",289,125472,,52,"CARACAL / Liceul Tehnologic Constantin Filipescu",1,11856,"MUNICIPIUL CARACAL",125472,1895,1046,973,72,1,1029,17,2096,1050,628,401
30,"OLT",289,125472,,53,"CARACAL / Liceul Mihai Viteazul",1,11856,"MUNICIPIUL CARACAL",125472,1529,1011,759,60,192,997,14,1685,674,612,385
30,"OLT",289,125472,,54,"CARACAL / Colegiul Tehnic Matei Basarab",1,11856,"MUNICIPIUL CARACAL",125472,1924,943,867,75,1,918,25,2118,1175,557,361
30,"OLT",289,125472,,55,"CARACAL / Grădiniţa cu Program Prelungit nr.3",1,11856,"MUNICIPIUL CARACAL",125472,1770,967,880,87,0,948,19,1955,988,564,384
30,"OLT",289,125472,,56,"CARACAL / Şcoala Gimnazială Nicolae Titulescu",1,11856,"MUNICIPIUL CARACAL",125472,1827,998,901,97,0,982,16,2013,1015,591,391
30,"OLT",289,125472,,57,"CARACAL / Şcoala Gimnazială Nicolae Titulescu",1,11856,"MUNICIPIUL CARACAL",125472,1688,931,847,84,0,910,21,1866,935,519,391
30,"OLT",289,125472,,58,"CARACAL / Şcoala Gimnazială nr.2",1,11856,"MUNICIPIUL CARACAL",125472,1788,1193,1049,144,0,1178,15,1980,787,644,534
30,"OLT",289,125472,,59,"CARACAL / Biblioteca municipală Caracal",1,11856,"MUNICIPIUL CARACAL",125472,1751,1016,920,95,1,1002,14,1927,911,637,365
30,"OLT",289,125472,,60,"CARACAL / Biblioteca municipală Caracal",1,11856,"MUNICIPIUL CARACAL",125472,1902,1034,976,53,5,1019,15,2100,1066,620,399
30,"OLT",289,125472,,61,"CARACAL / Centrul Cultural Municipal Caracal",1,11856,"MUNICIPIUL CARACAL",125472,1423,920,843,76,1,910,10,1566,646,535,375
30,"OLT",289,125472,,62,"CARACAL / Şcoala Gimnazială Gheorghe Magheru",1,11856,"MUNICIPIUL CARACAL",125472,1818,1183,1113,69,1,1163,20,2004,821,781,382
30,"OLT",289,125472,,63,"CARACAL / Şcoala Gimnazială Nr. 4",1,11856,"MUNICIPIUL CARACAL",125472,1704,1127,1074,53,0,1111,16,1889,762,697,414
30,"OLT",289,125472,,64,"CARACAL / Şcoala Gimnazială Nr. 3",1,11856,"MUNICIPIUL CARACAL",125472,1896,1282,1198,64,20,1269,13,2081,799,901,368
30,"OLT",289,125472,,65,"CARACAL / Şcoala Gimnazială nr.1",1,11856,"MUNICIPIUL CARACAL",125472,1625,1046,985,61,0,1034,12,1786,740,628,406
30,"OLT",289,125418,,66,"BALŞ / Scoala Gimnazială nr 3 Romana",1,11858,"ORAŞ BALŞ",125418,960,580,560,20,0,570,10,1059,479,366,204
30,"OLT",289,125418,,67,"BALŞ / Scoala Gimnazială nr 2 Virtina",1,11858,"ORAŞ BALŞ",125418,1259,700,667,33,0,689,11,1389,689,471,218
30,"OLT",289,125418,,68,"BALŞ / Scoala Gimnaziala nr. 1 Bals",1,11858,"ORAŞ BALŞ",125418,1038,600,550,50,0,593,7,1147,547,374,219
30,"OLT",289,125418,,69,"BALŞ / Scoala Gimnaziala speciala",1,11858,"ORAŞ BALŞ",125418,1943,960,908,52,0,940,20,2141,1181,589,351
30,"OLT",289,125418,,70,"BALŞ / Liceul Teoretic Petre Pandrea",1,11858,"ORAŞ BALŞ",125418,1504,889,789,100,0,871,18,1662,773,490,381
30,"OLT",289,125418,,71,"BALŞ / Liceul Teoretic Petre Pandrea",1,11858,"ORAŞ BALŞ",125418,1544,851,770,81,0,836,15,1709,858,495,341
30,"OLT",289,125418,,72,"BALŞ / Scoala Gimnazială ""Mihail Drumes""",1,11858,"ORAŞ BALŞ",125418,1545,858,760,58,40,840,18,1697,839,482,358
30,"OLT",289,125418,,73,"BALŞ / Scoala Gimnazială ""Mihail Drumes""",1,11858,"ORAŞ BALŞ",125418,1709,851,767,84,0,835,16,1888,1037,403,432
30,"OLT",289,125418,,74,"BALŞ / Gradinita cu program normal nr 1",1,11858,"ORAŞ BALŞ",125418,1087,498,452,45,1,495,3,1201,703,266,229
30,"OLT",289,125418,,75,"BALŞ / Gradinita cu program normal nr 1",1,11858,"ORAŞ BALŞ",125418,1598,734,692,42,0,723,11,1763,1029,411,312
30,"OLT",289,125418,,76,"BALŞ / Colegiul Tehnic",1,11858,"ORAŞ BALŞ",125418,1725,775,702,73,0,766,9,1899,1124,418,348
30,"OLT",289,125418,,77,"BALŞ / Colegiul Tehnic",1,11858,"ORAŞ BALŞ",125418,1283,606,565,41,0,590,16,1408,802,283,307
30,"OLT",289,125418,,78,"BALŞ / Scoala Gimnaziala Teis",1,11858,"ORAŞ BALŞ",125418,652,385,359,25,1,380,5,719,334,246,134
30,"OLT",289,125542,,79,"CORABIA / Şcoala Gimnazială nr. 1",1,11863,"ORAŞ CORABIA",125542,1545,872,835,36,1,850,22,1705,833,578,272
30,"OLT",289,125542,,80,"CORABIA / Şcoala Gimnazială Dumitru Buzdun",1,11863,"ORAŞ CORABIA",125542,1284,906,799,61,46,895,11,1421,515,570,325
30,"OLT",289,125542,,81,"CORABIA / Scoala GimnazialaVirgil Mazilescu",1,11863,"ORAŞ CORABIA",125542,1104,583,544,37,2,578,5,1229,646,350,228
30,"OLT",289,125542,,82,"CORABIA / Şcoala Gimnazială  Virgil Mazilescu",1,11863,"ORAŞ CORABIA",125542,1191,645,593,46,6,641,4,1313,668,379,262
30,"OLT",289,125542,,83,"CORABIA / Şcoala Gimnazială  Virgil Mazilescu",1,11863,"ORAŞ CORABIA",125542,1001,616,543,71,2,612,4,1105,489,375,237
30,"OLT",289,125542,,84,"CORABIA / Colegiul NaţionalAl I.Cuza",1,11863,"ORAŞ CORABIA",125542,1069,535,495,39,1,529,6,1188,653,337,192
30,"OLT",289,125542,,85,"CORABIA / Colegiul NaţionalAl I.Cuza",1,11863,"ORAŞ CORABIA",125542,1276,746,682,62,2,733,13,1412,666,438,295
30,"OLT",289,125542,,86,"CORABIA / Şcoala Gimnazială Mihail Eminescu",1,11863,"ORAŞ CORABIA",125542,1310,646,610,36,0,633,13,1442,796,437,196
30,"OLT",289,125542,,87,"CORABIA / Şcoala GimnazialăMihail Eminescu",1,11863,"ORAŞ CORABIA",125542,1232,638,608,29,1,629,9,1361,723,425,204
30,"OLT",289,125542,,88,"CORABIA / SCOALA CORABIA VECHE",1,11863,"ORAŞ CORABIA",125542,1614,871,800,43,28,860,11,1771,900,528,332
30,"OLT",289,125542,,89,"CORABIA / Şcoala Gimnazială Celeiu",1,11863,"ORAŞ CORABIA",125542,1515,1001,953,48,0,988,13,1669,668,744,244
30,"OLT",289,125542,,90,"VÎRTOPU / GRADINIŢA SAT VÎRTOPU",1,11863,"ORAŞ CORABIA",125542,382,247,212,35,0,243,4,421,174,156,87
30,"OLT",289,125542,,91,"TUDOR VLADIMIRESCU / Şcoala Gimnazială sat Tudor Vladimirescu",1,11863,"ORAŞ CORABIA",125542,541,330,315,13,2,326,4,596,266,161,165
30,"OLT",289,125542,,92,"CORABIA / Şcoala cartier Siliştioara",1,11863,"ORAŞ CORABIA",125542,457,338,290,45,3,335,3,507,169,205,130
30,"OLT",289,125622,,93,"DRĂGĂNEŞTI-OLT / Liceul T.Vladimirescu Drăgăneşti-Olt",1,11867,"ORAŞ DRĂGĂNEŞTI-OLT",125622,1684,954,884,69,1,934,20,1868,914,550,384
30,"OLT",289,125622,,94,"DRĂGĂNEŞTI-OLT / Liceul T.Vladimirescu Drăgăneşti-Olt",1,11867,"ORAŞ DRĂGĂNEŞTI-OLT",125622,1748,923,840,83,0,912,11,1925,1002,496,416
30,"OLT",289,125622,,95,"DRĂGĂNEŞTI-OLT / Liceul Tehnologic Drăgăneşti-Olt",1,11867,"ORAŞ DRĂGĂNEŞTI-OLT",125622,1166,641,605,35,1,628,13,1290,649,430,198
30,"OLT",289,125622,,96,"DRĂGĂNEŞTI-OLT / Liceul Tehnologic Drăgăneşti-Olt",1,11867,"ORAŞ DRĂGĂNEŞTI-OLT",125622,852,417,381,34,2,409,8,942,525,259,150
30,"OLT",289,125622,,97,"DRĂGĂNEŞTI-OLT / Compania de Apă Olt Slatina",1,11867,"ORAŞ DRĂGĂNEŞTI-OLT",125622,1806,1096,1017,70,9,1072,24,1988,892,717,355
30,"OLT",289,125622,,98,"COMANI / Şcoala Gimnazială Comani",1,11867,"ORAŞ DRĂGĂNEŞTI-OLT",125622,1221,744,682,58,4,732,12,1353,609,461,271
30,"OLT",289,125622,,99,"COMANI / Şcoala Gimnazială Comani",1,11867,"ORAŞ DRĂGĂNEŞTI-OLT",125622,1299,745,698,42,5,740,5,1432,687,456,284
30,"OLT",289,128105,,100,"PIATRA-OLT / Muzeu Piatra Olt",1,11870,"ORAŞ PIATRA-OLT",128105,966,674,550,123,1,668,6,1061,387,371,297
30,"OLT",289,128105,,101,"PIATRA-OLT / Muzeu Piatra Olt",1,11870,"ORAŞ PIATRA-OLT",128105,949,662,578,77,7,652,10,1047,385,398,254
30,"OLT",289,128105,,102,"PIATRA / Grădiniţa Piatra",1,11870,"ORAŞ PIATRA-OLT",128105,1737,1230,1101,126,3,1217,13,1914,684,706,511
30,"OLT",289,128105,,103,"CRIVA DE SUS / Grădiniţa cu Program Normal",1,11870,"ORAŞ PIATRA-OLT",128105,926,851,631,216,4,844,7,1024,173,499,345
30,"OLT",289,128105,,104,"ENOŞEŞTI / Grădinţa cu Program Normal",1,11870,"ORAŞ PIATRA-OLT",128105,275,219,172,46,1,218,1,304,85,149,69
30,"OLT",289,128105,,105,"BISTRIŢA NOUĂ / Şcoala Generală cu clasele I-IV",1,11870,"ORAŞ PIATRA-OLT",128105,460,344,290,53,1,341,3,510,166,233,108
30,"OLT",289,128374,,106,"POTCOAVA FĂLCOENI / Şcoala cu Clasele. I-IV Fălcoieni",1,11877,"ORAŞ POTCOAVA",128374,899,745,580,160,5,733,12,992,247,507,226
30,"OLT",289,128374,,107,"POTCOAVA / Liceul ""Ştefan Diaconescu"" Potcoava",1,11877,"ORAŞ POTCOAVA",128374,1108,886,718,153,15,874,12,1225,339,542,332
30,"OLT",289,128374,,108,"POTCOAVA / Liceul ""Ştefan Diaconescu"" Potcoava",1,11877,"ORAŞ POTCOAVA",128374,1207,879,812,56,11,868,11,1131,252,634,234
30,"OLT",289,128374,,109,"SINEŞTI / Şcoala Generală Sineşti",1,11877,"ORAŞ POTCOAVA",128374,1593,1243,1111,111,21,1182,61,1756,513,792,390
30,"OLT",289,128711,,110,"SCORNICEŞTI / Grupul Scolar Agricol Scorniceşti",1,11883,"ORAŞ SCORNICEŞTI",128711,1951,1125,959,166,0,1106,19,2017,892,563,543
30,"OLT",289,128711,,111,"SCORNICEŞTI / SCOALA GEN.CLASELE I-VIII SCORNICESTI",1,11883,"ORAŞ SCORNICEŞTI",128711,1957,1214,985,191,38,1188,26,2002,788,603,585
30,"OLT",289,128711,,112,"MĂRGINENI SLOBOZIA / SCOALA GENERALA MĂRGINENI",1,11883,"ORAŞ SCORNICEŞTI",128711,1617,1161,1000,161,0,1135,26,1782,621,635,500
30,"OLT",289,128711,,113,"NEGRENI / SCOALA GENERALA NEGRENI",1,11883,"ORAŞ SCORNICEŞTI",128711,1004,955,550,405,0,939,16,1114,159,522,417
30,"OLT",289,128711,,114,"BIRCII / SCOALA GENERLA BIRCII",1,11883,"ORAŞ SCORNICEŞTI",128711,884,724,476,248,0,710,14,974,250,285,425
30,"OLT",289,128711,,115,"MOGOŞEŞTI / SCOALA GENERALA MOGOSESTI",1,11883,"ORAŞ SCORNICEŞTI",128711,465,343,272,71,0,337,6,514,171,187,150
30,"OLT",289,128711,,116,"CONSTANTINEŞTI / SCOALA GENERALA CLASELE I-VIII CONSTANTINESTI",1,11883,"ORAŞ SCORNICEŞTI",128711,455,396,316,80,0,392,4,503,107,188,204
30,"OLT",289,128711,,117,"TEIUŞ / GRADINITA TEIUS",1,11883,"ORAŞ SCORNICEŞTI",128711,481,405,320,85,0,400,5,529,124,233,167
30,"OLT",289,128711,,118,"ŞUICA / GRADINITA ŞUICA",1,11883,"ORAŞ SCORNICEŞTI",128711,197,167,131,36,0,166,1,217,50,95,71
30,"OLT",289,128711,,119,"JITARU / JITARU",1,11883,"ORAŞ SCORNICEŞTI",128711,832,690,528,162,0,675,15,917,227,317,358
30,"OLT",289,128711,,120,"CHIŢEASCA / SCOALA GENERALA CHIŢEASCA",1,11883,"ORAŞ SCORNICEŞTI",128711,384,521,273,248,0,509,12,570,49,236,273
30,"OLT",289,125677,,121,"BALDOVINEŞTI / Şcoala Generală cu clasele I-VIII Baldovineşti",3,11900,"BALDOVINEŞTI",125677,528,442,333,92,17,438,4,561,119,272,166
30,"OLT",289,125677,,122,"PIETRIŞ / Grădiniţă",3,11900,"BALDOVINEŞTI",125677,279,271,169,94,8,270,1,314,43,222,48
30,"OLT",289,125677,,123,"GUBANDRU / Şcoala Generală cu clasele I-IV Gubandru",3,11900,"BALDOVINEŞTI",125677,110,122,72,44,6,118,4,143,21,101,17
30,"OLT",289,125659,,124,"BĂBICIU / Căminul Cultural Băbiciu",3,11898,"BĂBICIU",125659,781,663,555,57,51,661,2,861,198,484,177
30,"OLT",289,125659,,125,"BĂBICIU / Căminul Cultural Băbiciu",3,11898,"BĂBICIU",125659,1021,925,681,178,66,919,6,1124,199,666,253
30,"OLT",289,130286,,126,"BĂLTENI / Şcoala Gimnazială ,, Ion I.Graure ,, Bălteni",3,11904,"BĂLTENI",130286,1392,967,841,126,0,951,16,1535,568,678,273
30,"OLT",289,125757,,127,"BĂRĂŞTII DE VEDE / Şcoala Generală Clasele I-VIII",3,11906,"BĂRĂŞTI",125757,746,899,549,317,33,890,9,1027,128,592,298
30,"OLT",289,125757,,128,"BĂRĂŞTII DE CEPTURI / Şcoala Generală Clasele I-IV.",3,11906,"BĂRĂŞTI",125757,468,508,337,148,23,504,4,519,11,366,138
30,"OLT",289,125757,,129,"MOŢOEŞTI / Sediu Fostă Brigadă Agricolă",3,11906,"BĂRĂŞTI",125757,66,100,45,54,1,99,1,114,14,86,13
30,"OLT",289,125846,,130,"BÎRZA / Şcoala Gimnazială Birza",3,11915,"BÎRZA",125846,901,633,567,66,0,625,8,992,359,443,182
30,"OLT",289,125846,,131,"BRANEŢ / Şcoala Gimnazială Branet",3,11915,"BÎRZA",125846,1289,814,736,78,0,804,10,1419,605,554,250
30,"OLT",289,125873,,132,"LEOTEŞTI / Căminul Cultural Leoteşti",3,11918,"BOBICEŞTI",125873,1294,786,704,80,2,775,11,1430,644,516,259
30,"OLT",289,125873,,133,"BOBICEŞTI / Căminul Cultural Bobiceşti",3,11918,"BOBICEŞTI",125873,858,516,451,65,0,511,5,948,432,352,159
30,"OLT",289,125873,,134,"CHINTEŞTI / Şcoala Generală Chinteşti",3,11918,"BOBICEŞTI",125873,204,151,128,23,0,145,6,226,75,113,32
30,"OLT",289,125873,,135,"BECHET / Şcoala Generală Bechet",3,11918,"BOBICEŞTI",125873,296,203,169,34,0,199,4,330,127,149,50
30,"OLT",289,125962,,136,"BRASTAVĂŢU / Şcoala Generală cu clasele I-VIII Brastavăţu",3,11927,"BRASTAVĂŢU",125962,1381,945,789,106,50,927,18,1520,575,564,363
30,"OLT",289,125962,,137,"BRASTAVĂŢU / Şcoala Generală cu clasele I-VIII Brastavăţu",3,11927,"BRASTAVĂŢU",125962,1484,903,773,85,45,894,9,1641,738,519,375
30,"OLT",289,125962,,138,"CRUŞOVU / Şcoala Generală Cruşovu",3,11927,"BRASTAVĂŢU",125962,940,665,583,65,17,659,6,1041,376,432,227
30,"OLT",289,125999,,139,"BREBENI / Şcoala cu clasele I-IV Brebeni",3,11930,"BREBENI",125999,943,643,487,129,27,635,8,1038,395,411,224
30,"OLT",289,125999,,140,"BREBENI / Şcoala Gimnazială Brebeni",3,11930,"BREBENI",125999,1297,953,709,224,20,943,10,1430,477,602,341
30,"OLT",289,126022,,141,"BRÎNCOVENI / Şcoala gimnazială Voievod Brîncoveanu",3,11933,"BRÎNCOVENI",126022,865,694,589,105,0,684,10,954,260,549,135
30,"OLT",289,126022,,142,"OCIOGI / Şcoala Gimnazială Matei Basarab",3,11933,"BRÎNCOVENI",126022,967,800,659,141,0,797,3,1064,264,570,227
30,"OLT",289,126022,,143,"VĂLENI / Grădiniţa cu Program Normal Domniţa Bălaşa",3,11933,"BRÎNCOVENI",126022,422,349,280,69,0,347,2,467,118,286,61
30,"OLT",289,126077,,144,"BUCINIŞU / Şcoala Generală Bucinişu",3,11938,"BUCINIŞU",126077,1723,1040,911,129,0,1025,15,1903,863,713,312
30,"OLT",289,130295,,145,"CĂLUI / Şcoala Gimnazială Călui",3,11941,"CĂLUI",130295,800,619,498,111,10,613,6,882,263,462,151
30,"OLT",289,130295,,146,"GURA CĂLUIU / Grădiniţa cu Program Normal Gura Călui",3,11941,"CĂLUI",130295,535,345,295,45,5,340,5,542,197,268,72
30,"OLT",289,126102,,147,"CEZIENI / Şcoala Gimnazială Nicolae Marineanu",3,11944,"CEZIENI",126102,1005,766,629,137,0,759,7,1112,346,609,150
30,"OLT",289,126102,,148,"BONDREA / Căminul Cultural",3,11944,"CEZIENI",126102,192,149,124,25,0,149,0,215,66,100,49
30,"OLT",289,126102,,149,"CORLĂTEŞTI / Centrul Social",3,11944,"CEZIENI",126102,285,223,176,47,0,222,1,317,94,179,43
30,"OLT",289,126148,,150,"CILIENI / Liceul Tehnologic Ion Popescu Cilieni",3,11948,"CILIENI",126148,1318,816,761,46,9,805,11,1450,634,512,293
30,"OLT",289,126148,,151,"CILIENI / Liceul Tehnologic Ion Popescu Cilieni",3,11948,"CILIENI",126148,1413,888,819,59,10,882,6,1560,672,569,313
30,"OLT",289,126166,,152,"CÎRLOGANI / SCOALA GIMNAZIALA CARLOGANI",3,11950,"CÎRLOGANI",126166,1235,925,789,136,0,914,11,1369,444,616,298
30,"OLT",289,126166,,153,"CEPARI / SCOALA GIMNAZIALA CEPARI",3,11950,"CÎRLOGANI",126166,763,568,489,79,0,564,4,840,272,380,184
30,"OLT",289,126228,,154,"COLONEŞTI / Căminul Cultural",3,11956,"COLONEŞTI",126228,627,697,396,283,18,594,103,698,1,459,135
30,"OLT",289,126228,,155,"MĂRUNŢEI / Şcoala Generală",3,11956,"COLONEŞTI",126228,377,375,237,132,6,372,3,417,42,252,120
30,"OLT",289,126228,,156,"BĂTĂRENI / Grădiniţa cu Pogram Normal Bătăreni",3,11956,"COLONEŞTI",126228,172,185,117,68,0,185,0,191,6,153,32
30,"OLT",289,126228,,157,"VLAICI / Grădiniţa cu Pogram Normal Vlaici",3,11956,"COLONEŞTI",126228,291,323,193,113,17,319,4,324,1,268,51
30,"OLT",289,126326,,158,"CORBU / Şcoala Gimnazială Corbu",3,11966,"CORBU",126326,872,644,494,112,38,635,9,962,318,466,169
30,"OLT",289,126326,,159,"BUZEŞTI / Şcoala Gimnazială Buzesti",3,11966,"CORBU",126326,523,499,366,108,25,492,7,578,79,382,110
30,"OLT",289,126326,,160,"MILCOVENI / Grădiniţa Milcoveni",3,11966,"CORBU",126326,377,344,277,45,22,336,8,417,73,261,75
30,"OLT",289,126380,,161,"COTEANA / Şcoala Gimnazială Coteana",3,11972,"COTEANA",126380,995,808,678,128,2,799,9,1097,289,620,179
30,"OLT",289,126380,,162,"COTEANA / Şcoala Gimnazială Coteana",3,11972,"COTEANA",126380,1001,907,713,187,7,893,14,1104,197,758,135
30,"OLT",289,126406,,163,"CRÎMPOIA / SAM Crimpoia",3,11974,"CRÎMPOIA",126406,1132,920,781,139,0,911,9,1251,331,321,590
30,"OLT",289,126406,,164,"CRÎMPOIA / SAM Crîmpoia",3,11974,"CRÎMPOIA",126406,1182,865,733,132,0,852,13,1299,434,302,550
30,"OLT",289,126406,,165,"BUTA / Scoala cu clasele I-IV Buta",3,11974,"CRÎMPOIA",126406,645,537,423,114,0,532,5,713,176,202,330
30,"OLT",289,126503,,166,"CUNGREA / Primărie, str. Primăriei, nr.8, sat Cungrea",3,11977,"CUNGREA",126503,763,675,434,241,0,673,2,843,168,420,253
30,"OLT",289,126503,,167,"CEPEŞTI / Şcoala Gimnazială Cepeşti",3,11977,"CUNGREA",126503,726,566,456,110,0,560,6,799,233,373,187
30,"OLT",289,126503,,168,"SPĂTARU / Şcoala Gimnazială Spătaru",3,11977,"CUNGREA",126503,254,218,159,59,0,217,1,280,62,108,109
30,"OLT",289,126433,,169,"CURTIŞOARA / Şcoala cu clasele I-VIII Curtişoara",3,11985,"CURTIŞOARA",126433,1293,964,719,245,0,952,12,1428,464,593,359
30,"OLT",289,126433,,170,"DOBROTINET / Şcoala cu clasele I-VIII Dobrotinet",3,11985,"CURTIŞOARA",126433,1362,1033,852,181,0,1017,16,1501,468,653,364
30,"OLT",289,126433,,171,"PROASPEŢI / Şcoala cu clasele I-IV Proaspeţi",3,11985,"CURTIŞOARA",126433,940,794,549,245,0,786,8,1036,242,455,331
30,"OLT",289,126585,,172,"DĂNEASA / Căminul Cultural Dăneasa",3,11992,"DĂNEASA",126585,1205,825,686,108,31,816,9,1325,500,611,205
30,"OLT",289,126585,,173,"BERINDEI / Şcoala Berindei",3,11992,"DĂNEASA",126585,459,411,285,104,22,410,1,506,95,347,63
30,"OLT",289,126585,,174,"CIOFLANU / Grădiniţa Cioflanu",3,11992,"DĂNEASA",126585,517,332,266,54,12,330,2,570,238,263,67
30,"OLT",289,126585,,175,"PESTRA / Căminul Cultural Pestra",3,11992,"DĂNEASA",126585,460,345,292,41,12,345,0,507,162,267,78
30,"OLT",289,126585,,176,"ZĂNOAGA / Şcoala Zănoaga",3,11992,"DĂNEASA",126585,369,307,255,42,10,305,2,407,100,252,53
30,"OLT",289,126647,,177,"DEVESELU / Căminul Cultural",3,11998,"DEVESELU",126647,1455,1044,863,125,56,1033,11,1611,567,710,323
30,"OLT",289,126647,,178,"COMANCA / Căminul Cultural",3,11998,"DEVESELU",126647,1044,686,594,77,15,682,4,1149,463,426,256
30,"OLT",289,126647,,179,"DEVESELU / Asociaţia locatari Nr.5",3,11998,"DEVESELU",126647,214,190,134,55,1,189,1,235,45,106,83
30,"OLT",289,126674,,180,"CURTIŞOARA / Căminul Cultural Curtişoara",3,12001,"DOBREŢU",126674,631,487,374,106,7,477,10,697,210,298,179
30,"OLT",289,126674,,181,"HOREZU / Căminul Cultural Horezu",3,12001,"DOBREŢU",126674,413,365,300,58,7,359,6,455,90,280,79
30,"OLT",289,126718,,182,"DOBROSLOVENI / Şcoala cu clasele I-VIII Dobrosloveni",3,12005,"DOBROSLOVENI",126718,1100,811,721,90,0,805,6,1211,400,563,242
30,"OLT",289,126718,,183,"REŞCA / Şcoala cu clasele I-VIII Reşca",3,12005,"DOBROSLOVENI",126718,997,708,651,57,0,700,8,1100,392,513,187
30,"OLT",289,126718,,184,"FRĂSINETU / Grădiniţa cu Program Normal Frăsinetu",3,12005,"DOBROSLOVENI",126718,368,314,265,49,0,311,3,405,91,186,125
30,"OLT",289,126718,,185,"POTOPINU / Grădiniţa cu Program Normal Potopinu",3,12005,"DOBROSLOVENI",126718,549,361,320,41,0,351,10,606,245,266,85
30,"OLT",289,126772,,186,"DOBROTEASA / Căminul Cultural",3,12011,"DOBROTEASA",126772,1361,1169,878,268,23,1161,8,1478,309,841,320
30,"OLT",289,126825,,187,"DOBRUN / Şcoala Dobrun",3,12016,"DOBRUN",126825,583,547,383,141,23,538,9,645,98,503,35
30,"OLT",289,126825,,188,"ROŞIENII MARI / Şcoala Roşienii Mari",3,12016,"DOBRUN",126825,647,590,476,83,31,589,1,713,123,574,15
30,"OLT",289,125490,,189,"DRĂGHICENI / Şcoala Generală cu clasele I-VIII Drăghiceni",3,12022,"DRĂGHICENI",125490,1527,1213,1034,167,12,1204,9,1686,473,951,253
30,"OLT",289,126905,,190,"FĂGEŢELU / Şcoala Gimnazială Făgeţelu",3,12026,"FĂGEŢELU",126905,458,485,250,229,6,476,9,512,27,332,144
30,"OLT",289,126905,,191,"CHILIA / Şcoala cu clasele I-VIII Chilia",3,12026,"FĂGEŢELU",126905,323,348,184,161,3,344,4,361,13,234,110
30,"OLT",289,126978,,192,"FĂLCOIU / Şcoala cu clasele I-VIII Fălcoiu",3,12033,"FĂLCOIU",126978,971,734,591,68,75,729,5,1073,339,597,132
30,"OLT",289,126978,,193,"FĂLCOIU / Şcoala cu clasele I-VIII Fălcoiu",3,12033,"FĂLCOIU",126978,1020,668,517,85,66,648,20,1124,456,578,70
30,"OLT",289,126978,,194,"CIOROIU / Şcoala cu clasele I-VIII Cioroiu",3,12033,"FĂLCOIU",126978,1125,779,633,74,72,765,14,1242,463,578,187
30,"OLT",289,127019,,195,"FĂRCAŞELE / Gradinita Fărcaşele",3,12037,"FĂRCAŞELE",127019,973,607,556,47,4,599,8,1075,468,429,170
30,"OLT",289,127019,,196,"FĂRCAŞU DE JOS / Grădiniţa Fărcaşu de Jos",3,12037,"FĂRCAŞELE",127019,1445,1088,961,109,18,1071,17,1588,500,773,298
30,"OLT",289,127019,,197,"GHIMPAŢI / Şcoala Gimnazială Fărcaşele",3,12037,"FĂRCAŞELE",127019,716,495,444,40,11,492,3,793,298,353,139
30,"OLT",289,127019,,198,"HOTĂRANI / Şcoala Gimnazială Hotărani",3,12037,"FĂRCAŞELE",127019,740,513,451,58,4,502,11,817,304,343,159
30,"OLT",289,127064,,199,"GĂNEASA / Şcoala GIimnazială Găneasa",3,12042,"GĂNEASA",127064,1497,1185,962,209,14,1165,20,1653,468,800,365
30,"OLT",289,127064,,200,"DRANOVĂŢU / Şcoala Gimnazială Dranovăţu",3,12042,"GĂNEASA",127064,970,836,621,196,19,827,9,1074,238,574,253
30,"OLT",289,127064,,201,"IZVORU / Şcoala Primară Izvoru",3,12042,"GĂNEASA",127064,575,570,425,132,13,563,7,634,64,437,126
30,"OLT",289,130302,,202,"BĂLEASA / Şcoala cu clasele I-VIII Băleasa",3,12048,"GĂVĂNEŞTI",130302,705,555,463,81,11,552,3,780,225,436,116
30,"OLT",289,130302,,203,"GĂVĂNEŞTI / Cămin Cultural",3,12048,"GĂVĂNEŞTI",130302,614,521,400,103,18,517,4,680,159,399,118
30,"OLT",289,130302,,204,"BROŞTENI / Şcoala cu clasele I-IV Broşteni",3,12048,"GĂVĂNEŞTI",130302,303,270,216,50,4,266,4,333,63,210,56
30,"OLT",289,130311,,205,"GHIMPEŢENII NOI / Grădiniţa cu Program Normal",3,12053,"GHIMPEŢENI",130311,401,302,257,33,12,296,6,445,143,194,102
30,"OLT",289,130311,,206,"GHIMPEŢENI / Şcoala Gimnazială Ghimpeţeni",3,12053,"GHIMPEŢENI",130311,856,624,527,73,24,617,7,948,324,426,191
30,"OLT",289,127126,,207,"GIUVĂRĂŞTI / Şcoala cu clasele I-VIII Giuvărăşti",3,12059,"GIUVĂRĂŞTI",127126,1019,657,608,41,8,653,4,1123,466,430,223
30,"OLT",289,127126,,208,"GIUVĂRĂŞTI / Şcoala cu clasele I-VIII Giuvărăşti",3,12059,"GIUVĂRĂŞTI",127126,939,650,589,48,13,642,8,1041,391,477,165
30,"OLT",289,125588,,209,"GÎRCOV / Grădiniţa cu Program Normal Gîrcov",3,12056,"GÎRCOV",125588,1268,829,759,70,0,827,2,1381,552,617,210
30,"OLT",289,125588,,210,"URSA / Şcoala Generală Ursa",3,12056,"GÎRCOV",125588,765,487,448,39,0,480,7,863,376,338,142
30,"OLT",289,127144,,211,"GOSTAVĂŢU / Şcoala Generală Gostavăţu",3,12061,"GOSTAVĂŢU",127144,1347,983,859,124,0,963,20,1479,496,704,259
30,"OLT",289,127144,,212,"SLĂVENI / Căminul Cultural Slăveni",3,12061,"GOSTAVĂŢU",127144,1167,825,743,82,0,808,17,1287,462,589,219
30,"OLT",289,127171,,213,"GRĂDINARI / Şcoala Gimnazială Grădinari",3,12064,"GRĂDINARI",127171,822,629,548,79,2,618,11,907,278,437,181
30,"OLT",289,127171,,214,"PETCULEŞTI / Şcoala Primară Petculeşti",3,12064,"GRĂDINARI",127171,806,765,708,57,0,746,19,888,123,687,59
30,"OLT",289,127171,,215,"SATU NOU / Şcoala Generală I-IV Satu Nou",3,12064,"GRĂDINARI",127171,218,240,164,76,0,237,3,244,4,166,71
30,"OLT",289,130320,,216,"GRĂDINILE / Centrul Social Grădinile",3,12069,"GRĂDINILE",130320,1234,1065,872,177,16,1052,13,1358,293,816,236
30,"OLT",289,127224,,217,"GROJDIBODU / Şcoala Veche",3,12073,"GROJDIBODU",127224,918,716,638,68,10,713,3,1014,298,512,201
30,"OLT",289,127224,,218,"GROJDIBODU / Şcoala Veche",3,12073,"GROJDIBODU",127224,932,670,622,40,8,669,1,1031,361,501,168
30,"OLT",289,127224,,219,"HOTARU / Grădiniţa Hotaru",3,12073,"GROJDIBODU",127224,637,498,444,47,7,493,5,703,205,386,107
30,"OLT",289,130339,,220,"GURA PADINII / Cămin Cultural",3,12076,"GURA PADINII",130339,1507,1111,987,82,42,1098,13,1662,551,835,263
30,"OLT",289,127251,,221,"IANCA / Şcoala Gimnazială Ada Umbra Ianca",3,12079,"IANCA",127251,1148,919,799,57,63,916,3,1267,348,723,193
30,"OLT",289,127251,,222,"IANCA / Şcoala Gimnazială Ada Umbra Ianca",3,12079,"IANCA",127251,1079,784,681,62,41,778,6,1192,408,575,203
30,"OLT",289,127251,,223,"POTELU / Şcoala Gimnazială George Vişan Potelu",3,12079,"IANCA",127251,1036,780,649,94,37,775,5,1150,370,565,210
30,"OLT",289,127288,,224,"IANCU JIANU / Scoala generala nr 1 Iancu Jianu",3,12082,"IANCU JIANU",127288,1474,919,844,75,0,899,20,1618,699,529,370
30,"OLT",289,127288,,225,"IANCU JIANU / Liceul Iancu Jianu",3,12082,"IANCU JIANU",127288,1301,848,773,75,0,841,7,1439,591,448,393
30,"OLT",289,127288,,226,"DOBRICENI / Şcoala Gimnazială Dobriceni",3,12082,"IANCU JIANU",127288,788,531,462,69,0,520,11,867,336,260,260
30,"OLT",289,127322,,227,"ICOANA / Şcoala Gimnazială Icoana",3,12086,"ICOANA",127322,535,490,333,139,18,482,8,592,102,372,110
30,"OLT",289,127322,,228,"URSOAIA / Şcoala Gimnazială Ursoaia",3,12086,"ICOANA",127322,616,416,316,93,7,412,4,680,264,276,136
30,"OLT",289,127322,,229,"FLORU / Căminul Cultural Floru",3,12086,"ICOANA",127322,421,335,263,68,4,333,2,466,131,252,81
30,"OLT",289,130348,,230,"IPOTEŞTI / Baza sportivă",3,12090,"IPOTESTI",130348,1220,937,763,174,0,931,6,1347,410,728,203
30,"OLT",289,127368,,231,"IZBICENI / Şcoala veche",3,12092,"IZBICENI",127368,930,621,586,35,0,615,6,1020,399,347,268
30,"OLT",289,127368,,232,"IZBICENI / Grădiniţa cu Program Normal Izbiceni",3,12092,"IZBICENI",127368,1535,983,913,69,1,975,8,1703,720,514,461
30,"OLT",289,127368,,233,"IZBICENI / Şcoala noua",3,12092,"IZBICENI",127368,1506,988,921,66,1,981,7,1660,672,462,519
30,"OLT",289,127386,,234,"IZVOARELE / Şcoala Izvoarele",3,12094,"IZVOARELE",127386,1027,687,585,102,0,682,5,1139,452,481,201
30,"OLT",289,127386,,235,"ALIMĂNEŞTI / Şcoala Alimăneşti",3,12094,"IZVOARELE",127386,1834,1138,1033,105,0,1119,19,2012,874,876,243
30,"OLT",289,127411,,236,"LELEASCA / Cămin cultural Leleasca",3,12097,"LELEASCA",127411,477,468,321,137,10,466,2,525,57,368,98
30,"OLT",289,127411,,237,"TONEŞTI / Şcoala generală Toneşti",3,12097,"LELEASCA",127411,340,329,212,109,8,328,1,377,48,228,100
30,"OLT",289,127411,,238,"URŞI / Grădiniţa cu Program Normal Urşi",3,12097,"LELEASCA",127411,272,264,178,78,8,260,4,300,36,193,67
30,"OLT",289,127411,,239,"MIERLICEŞTI / Şcoala generală Mierliceşti",3,12097,"LELEASCA",127411,167,182,122,56,4,180,2,185,3,123,57
30,"OLT",289,127493,,240,"MĂRUNŢEI / Şcoala Primară Viişoara",3,12105,"MĂRUNŢEI",127493,893,482,418,64,0,480,2,985,503,294,186
30,"OLT",289,127493,,241,"MĂRUNŢEI / Şcoala cu clasele I-VIII Mărunţei",3,12105,"MĂRUNŢEI",127493,1202,670,606,64,0,663,7,1332,662,424,239
30,"OLT",289,127493,,242,"BĂLĂNEŞTI / Şcoala cu clasele I-VIII Bălăneşti",3,12105,"MĂRUNŢEI",127493,1186,756,662,94,0,748,8,1311,555,569,179
30,"OLT",289,127493,,243,"MALU ROŞU / Şcoala Primară Malu-Roşu",3,12105,"MĂRUNŢEI",127493,106,76,53,23,0,76,0,115,39,36,40
30,"OLT",289,127536,,244,"MIHĂEŞTI / Şcoala Mihăeşti",3,12109,"MIHĂEŞTI",127536,741,657,431,207,19,652,5,821,164,343,309
30,"OLT",289,127536,,245,"BUŞCA / Şcoala Busca",3,12109,"MIHĂEŞTI",127536,584,526,395,112,19,521,5,650,124,208,313
30,"OLT",289,127563,,246,"MILCOVU DIN VALE / Şcoala Generală",3,12112,"MILCOV",127563,207,224,145,79,0,223,1,229,5,175,48
30,"OLT",289,127563,,247,"ULMI / Căminul Cultural Ulmi",3,12112,"MILCOV",127563,550,430,343,87,0,427,3,609,179,311,116
30,"OLT",289,127563,,248,"MILCOVU DIN DEAL / Şcoala Generală cu clasele I-VIII",3,12112,"MILCOV",127563,467,344,260,84,0,337,7,514,170,217,120
30,"OLT",289,127625,,249,"MORUNGLAV / Căminul Cultural",3,12117,"MORUNGLAV",127625,1261,804,708,96,0,797,7,1392,588,570,227
30,"OLT",289,127625,,250,"MORUNEŞTI / Şcoala Generală Moruneşti",3,12117,"MORUNGLAV",127625,529,389,342,47,0,387,2,585,196,305,82
30,"OLT",289,127625,,251,"BĂRĂŞTI / Şcoala Generală Bărăşti",3,12117,"MORUNGLAV",127625,311,210,177,33,0,209,1,343,133,172,37
30,"OLT",289,127689,,252,"MOVILENI / Şcoala Movileni",3,12123,"MOVILENI",127689,1314,824,735,84,5,814,10,1452,628,675,139
30,"OLT",289,127689,,253,"BACEA / Şcoala Bacea",3,12123,"MOVILENI",127689,1070,737,613,116,8,727,10,1181,444,560,167
30,"OLT",289,127714,,254,"NICOLAE TITULESCU / Şcoala Gimnazială",3,12126,"NICOLAE TITULESCU",127714,1052,896,690,119,87,890,6,1159,263,738,152
30,"OLT",289,127750,,255,"OBÎRŞIA / Şcoala cu clasele I-IV Obîrşia",3,12128,"OBÎRŞIA",127750,598,435,369,52,14,434,1,659,224,315,119
30,"OLT",289,127750,,256,"CÎMPU PĂRULUI / Şcoala cu clasele I-IV Cîmpu Părului",3,12128,"OBÎRŞIA",127750,280,236,189,31,16,236,0,313,77,172,64
30,"OLT",289,127750,,257,"TABONU / Şcoala cu clasele I-IV Tabonu",3,12128,"OBÎRŞIA",127750,115,108,75,28,5,108,0,131,23,91,17
30,"OLT",289,127750,,258,"COTENI / Şcoala cu clasele I-IV Coteni",3,12128,"OBÎRŞIA",127750,191,160,129,29,2,159,1,212,52,138,21
30,"OLT",289,127750,,259,"OBÎRŞIA NOUĂ / Scoala cu clasele I-VIII Obarsia Noua",3,12128,"OBÎRŞIA",127750,1027,656,552,74,30,648,8,1136,480,347,301
30,"OLT",289,127812,,260,"OBOGA / Şcoala Gimnazială Oboga",3,12134,"OBOGA",127812,1019,729,608,105,16,726,3,1125,396,546,180
30,"OLT",289,127812,,261,"OBOGA / Şcoala Oboga de Jos",3,12134,"OBOGA",127812,416,360,246,112,2,359,1,468,108,332,27
30,"OLT",289,127858,,262,"OPORELU / Căminul Cultural Oporelu",3,12136,"OPORELU",127858,933,932,598,242,92,920,12,1024,92,691,229
30,"OLT",289,127901,,263,"OPTAŞI / Şcoala Gimnazială Optaşi Măgura",3,12141,"OPTAŞI-MĂGURA",127901,1079,948,734,175,39,941,7,1193,245,757,184
30,"OLT",289,127938,,264,"ORLEA / Căminul Cultural",3,12143,"ORLEA",127938,1342,887,817,70,0,879,8,1483,596,596,283
30,"OLT",289,127938,,265,"ORLEA / Căminul Cultural",3,12143,"ORLEA",127938,662,505,397,108,0,501,4,729,224,363,138
30,"OLT",289,130357,,266,"OSICA DE JOS / Şcoala Gimnazială Osica de Jos",3,12146,"OSICA DE JOS",130357,1270,989,801,161,27,983,6,1401,412,749,234
30,"OLT",289,127983,,267,"VLĂDULENI / Centru de Promovare a Sănătăţii",3,12149,"OSICA DE SUS",127983,503,344,276,68,0,342,2,557,213,201,141
30,"OLT",289,127983,,268,"OSICA DE SUS / Casa Blănaru",3,12149,"OSICA DE SUS",127983,1007,686,566,120,0,679,7,1108,422,397,282
30,"OLT",289,127983,,269,"OSICA DE SUS / Şcoala Generală nr. 2",3,12149,"OSICA DE SUS",127983,1365,896,803,91,2,888,8,1505,609,514,374
30,"OLT",289,127983,,270,"GRECI / Şcoala Generală Greci",3,12149,"OSICA DE SUS",127983,874,519,446,73,0,513,6,966,447,279,234
30,"OLT",289,127983,,271,"TOMENI / Şcoala Primară Tomeni",3,12149,"OSICA DE SUS",127983,368,147,125,22,0,144,3,405,258,62,82
30,"OLT",289,128178,,272,"PÎRŞCOVENI / Şcoala Gimnazială Pîrşcoveni",3,12156,"PÂRŞCOVENI",128178,1373,948,797,117,34,932,16,1518,570,640,292
30,"OLT",289,128178,,273,"OLARI / Şcoala Gimnazială Olari",3,12156,"PÂRŞCOVENI",128178,1116,630,570,51,9,615,15,1229,599,456,159
30,"OLT",289,128052,,274,"MIERLEŞTII DE SUS / Cămin Cultural",3,12160,"PERIEŢI",128052,1712,1138,947,191,0,1128,10,1892,754,733,395
30,"OLT",289,128221,,275,"PLEŞOIU / Şcoala Gimnazială Pleşoiu",3,12164,"PLEŞOIU",128221,1323,967,785,167,15,958,9,1462,495,628,330
30,"OLT",289,128221,,276,"DOBA / Şcoala Gimnazială Doba",3,12164,"PLEŞOIU",128221,1171,944,740,187,17,929,15,1291,347,672,257
30,"OLT",289,128301,,277,"POBORU / Şcoala Gimnazială",3,12172,"POBORU",128301,642,696,391,305,0,688,8,710,14,518,170
30,"OLT",289,128301,,278,"CORNĂŢELU / Şcoala Gimnazială",3,12172,"POBORU",128301,821,588,488,100,0,581,7,911,323,412,169
30,"OLT",289,128301,,279,"SEACA / Şcoala Primară",3,12172,"POBORU",128301,217,149,139,10,0,148,1,240,91,106,42
30,"OLT",289,128436,,280,"PRISEACA / Şcoala Generală cu Clasele I-IV Priseaca",3,12179,"PRISEACA",128436,1461,1272,873,399,0,1256,16,1615,343,721,535
30,"OLT",289,128472,,281,"RADOMIREŞTI / Cămin Cultural",3,12183,"RADOMIREŞTI",128472,1177,748,616,123,9,741,7,1304,556,482,259
30,"OLT",289,128472,,282,"CRĂCIUNEI / Şcoală Veche",3,12183,"RADOMIREŞTI",128472,619,409,342,61,6,402,7,681,272,263,139
30,"OLT",289,128472,,283,"CĂLINEŞTI / Şcoală Veche",3,12183,"RADOMIREŞTI",128472,764,513,431,75,7,506,7,844,331,380,126
30,"OLT",289,128472,,284,"POIANA / Şcoala Poiana",3,12183,"RADOMIREŞTI",128472,281,217,174,41,2,214,3,311,94,169,45
30,"OLT",289,128524,,285,"REDEA / Grădiniţa cu Program Normal Redea",3,12188,"REDEA",128524,886,569,492,58,19,568,1,977,408,365,203
30,"OLT",289,128524,,286,"REDEA / Grădiniţa cu Program Normal Redea",3,12188,"REDEA",128524,876,579,478,67,34,573,6,963,384,405,168
30,"OLT",289,128524,,287,"REDIŞOARA / Căminul Cultural Redişoara",3,12188,"REDEA",128524,415,349,280,48,21,349,0,455,106,269,80
30,"OLT",289,128524,,288,"VALEA SOARELUI / Căminul Cultural Valea Soarelui",3,12188,"REDEA",128524,228,219,186,24,9,214,5,254,35,174,40
30,"OLT",289,128560,,289,"ROTUNDA / Sediul fostei C.A.P.",3,12192,"ROTUNDA",128560,1066,750,670,74,6,740,10,1174,424,559,181
30,"OLT",289,128560,,290,"ROTUNDA / Sediul fostei C.A.P.",3,12192,"ROTUNDA",128560,1259,911,805,100,6,904,7,1386,475,623,281
30,"OLT",289,128588,,291,"RUSĂNEŞTI / Şcoala generală nr.1",3,12194,"RUSĂNEŞTI",128588,1284,862,747,115,0,854,8,1419,557,477,377
30,"OLT",289,128588,,292,"RUSĂNEŞTI / Şcoala generală nr.2",3,12194,"RUSĂNEŞTI",128588,1383,860,751,109,0,855,5,1526,666,470,385
30,"OLT",289,128588,,293,"JIENI / Şcoala Jieni",3,12194,"RUSĂNEŞTI",128588,979,709,616,93,0,699,10,1084,375,339,360
30,"OLT",289,130366,,294,"VITĂNEŞTI / Şcoala Gimnazială Florian Diţuleasa Vităneşti",3,12197,"SÂRBII - MĂGURA",130366,894,744,562,140,42,726,18,985,241,540,186
30,"OLT",289,130366,,295,"VITĂNEŞTI / Şcoala Primară Branişte",3,12197,"SÂRBII - MĂGURA",130366,731,595,501,70,24,585,10,807,212,443,142
30,"OLT",289,128613,,296,"SCĂRIŞOARA / Şcoala Gimnazială Scărişoara",3,12199,"SCĂRIŞOARA",128613,915,450,405,45,0,442,8,1010,560,246,196
30,"OLT",289,128613,,297,"SCĂRIŞOARA / Şcoala Gimnazială Scărişoara",3,12199,"SCĂRIŞOARA",128613,944,486,445,41,0,477,9,1042,556,267,210
30,"OLT",289,128613,,298,"PLĂVICENI / Grădiniţa cu program normal Plăviceni",3,12199,"SCĂRIŞOARA",128613,587,347,297,50,0,345,2,647,300,249,96
30,"OLT",289,128659,,299,"SCHITU / Şcoala Gimnazială Schitu",3,12203,"SCHITU",128659,1152,720,616,104,0,710,10,1275,555,476,234
30,"OLT",289,128659,,300,"GRECI / Şcoala Gimnazială Greci",3,12203,"SCHITU",128659,743,553,461,92,0,541,12,817,264,371,170
30,"OLT",289,128659,,301,"LISA / Şcoala Primară Lisa",3,12203,"SCHITU",128659,308,236,181,55,0,224,12,338,102,153,71
30,"OLT",289,128864,,302,"SEACA / Grădiniţa cu Program Normal Seaca",3,12209,"SEACA",128864,1600,1002,891,110,1,980,22,1762,760,709,271
30,"OLT",289,128882,,303,"SÎMBUREŞTI / Şcoala Gimnazială Sîmbureşti",3,12215,"SÎMBUREŞTI",128882,896,1078,652,375,51,1058,20,1171,93,749,309
30,"OLT",289,125374,,304,"SLĂTIOARA / Grădiniţa Slătioara",3,12223,"SLĂTIOARA",125374,1411,1081,856,177,48,1070,11,1561,480,645,425
30,"OLT",289,125374,,305,"SLĂTIOARA / Grădiniţa Slătioara",3,12223,"SLĂTIOARA",125374,692,638,420,194,24,626,12,765,127,408,218
30,"OLT",289,128962,,306,"ALUNIŞU / Şcoala Generală Alunişu",3,12228,"SPINENI",128962,414,330,218,112,0,327,3,457,127,228,99
30,"OLT",289,128962,,307,"PROFA / Şcoala Generală Profa",3,12228,"SPINENI",128962,448,453,255,198,0,449,4,496,43,227,222
30,"OLT",289,128962,,308,"SPINENI / Căminul Cultural Spineni",3,12228,"SPINENI",128962,589,523,355,146,22,516,7,653,130,381,135
30,"OLT",289,129040,,309,"SPRÎNCENATA / Căminul Cultural Viespeşti",3,12236,"SPRÎNCENATA",129040,1550,1013,827,186,0,1002,11,1729,716,736,266
30,"OLT",289,129040,,310,"FRUNZARU / Şcoala Veche Frunzaru",3,12236,"SPRÎNCENATA",129040,580,381,325,56,0,376,5,623,242,247,129
30,"OLT",289,129095,,311,"STOENEŞTI / Căminul Cultural Stoeneşti",3,12244,"STOENEŞTI",129095,1102,786,646,125,15,775,11,1215,429,514,261
30,"OLT",289,129095,,312,"STOENEŞTI / Şcoala Gimnazială Didu",3,12244,"STOENEŞTI",129095,820,590,531,49,10,588,2,910,320,386,202
30,"OLT",289,129111,,313,"STOICĂNEŞTI / SCOALA GENERALA",3,12246,"STOICĂNEŞTI",129111,1400,792,731,61,0,784,8,1543,751,641,143
30,"OLT",289,129111,,314,"STOICĂNEŞTI / SCOALA GENERALA",3,12246,"STOICĂNEŞTI",129111,940,511,465,46,0,508,3,1036,525,414,94
30,"OLT",289,129139,,315,"COLIBAŞI / Cămin Cultural",3,12248,"STREJEŞTI",129139,389,322,248,74,0,321,1,429,107,203,118
30,"OLT",289,129139,,316,"STREJEŞTII DE SUS / Şcoala Gimnazială",3,12248,"STREJEŞTI",129139,1368,1008,915,93,0,997,11,1503,495,797,200
30,"OLT",289,129139,,317,"STREJEŞTI / Casa Fraţii Buzeşti",3,12248,"STREJEŞTI",129139,825,618,542,76,0,608,10,908,290,454,154
30,"OLT",289,129184,,318,"STUDINA / Căminul Cultural Studina",3,12253,"STUDINA",129184,1337,793,715,78,0,787,6,1475,682,415,372
30,"OLT",289,129184,,319,"STUDINIŢA / Şcoala generală Studiniţa",3,12253,"STUDINA",129184,991,554,473,81,0,546,8,1094,540,340,206
30,"OLT",289,129246,,320,"ŞERBĂNEŞTI / Şcoala Dumitru Popovici",3,12211,"ŞERBĂNEŞTI",129246,875,643,550,93,0,615,28,967,324,412,203
30,"OLT",289,129246,,321,"ŞERBĂNEŞTI / Şcoala Dumitru Popovici",3,12211,"ŞERBĂNEŞTI",129246,848,634,566,68,0,616,18,943,309,454,162
30,"OLT",289,129246,,322,"ŞERBĂNEŞTII DE SUS / Grădiniţa Şerbăneştii de Sus",3,12211,"ŞERBĂNEŞTI",129246,630,464,406,58,0,452,12,696,232,296,156
30,"OLT",289,130384,,323,"ŞOPÂRLIŢA / Şcoala cu clasele I-VIII",3,12226,"ŞOPÂRLIŢA",130384,1078,910,714,138,58,901,9,1194,284,696,205
30,"OLT",289,129282,,324,"ŞTEFAN CEL MARE / Cămin cultural",3,12241,"ŞTEFAN CEL MARE",129282,1032,785,632,141,12,771,14,1137,352,488,283
30,"OLT",289,129282,,325,"IANCA NOUĂ / Grădiniţa Ianca Nouă",3,12241,"ŞTEFAN CEL MARE",129282,511,362,321,38,3,356,6,562,200,243,113
30,"OLT",289,129317,,326,"TĂTULEŞTI / Şcoala Gimnazială Tătuleşti",3,12256,"TĂTULEŞTI",129317,476,575,329,231,15,565,10,627,52,416,149
30,"OLT",289,129317,,327,"BĂRBĂLĂI / Şcoala Bărbălai",3,12256,"TĂTULEŞTI",129317,185,243,132,106,5,240,3,275,32,187,53
30,"OLT",289,129317,,328,"MIRCEŞTI / Şcoala Mirceşti",3,12256,"TĂTULEŞTI",129317,143,181,92,84,5,181,0,208,27,140,41
30,"OLT",289,129380,,329,"CHERLEŞTII DIN DEAL / Şcoala Generală",3,12263,"TESLUI",129380,1345,933,760,171,2,916,17,1479,546,574,342
30,"OLT",289,129380,,330,"COMĂNIŢA / Şcoala Generală Comăniţa",3,12263,"TESLUI",129380,773,599,431,160,8,594,5,853,254,477,117
30,"OLT",289,129460,,331,"DOANCA / Şcoala Gimnazială",3,12271,"TIA MARE",129460,1038,759,700,59,0,748,11,1147,388,481,267
30,"OLT",289,129460,,332,"POTLOGENI / Grădiniţa",3,12271,"TIA MARE",129460,1317,885,828,57,0,874,11,1454,569,634,240
30,"OLT",289,129460,,333,"TIA MARE / Grădiniţa",3,12271,"TIA MARE",129460,1297,866,816,50,0,855,11,1434,568,569,286
30,"OLT",289,129503,,334,"TOPANA / Şcoala Gimnazială Topana",3,12275,"TOPANA",129503,270,299,158,116,25,298,1,301,2,215,83
30,"OLT",289,129503,,335,"UNGURENI / Şcoala Ungureni",3,12275,"TOPANA",129503,116,123,70,49,4,122,1,129,6,96,26
30,"OLT",289,129503,,336,"CÎNDELEŞTI / Şcoala Candeleşti",3,12275,"TOPANA",129503,85,95,60,30,5,89,6,96,1,80,9
30,"OLT",289,129503,,337,"COJGĂREI / Şcoala Gojgărei",3,12275,"TOPANA",129503,153,168,96,63,9,167,1,169,1,124,43
30,"OLT",289,129567,,338,"TRAIAN / Şcoala Gimnazială Traian",3,12281,"TRAIAN",129567,1198,711,669,42,0,703,8,1321,610,423,280
30,"OLT",289,129567,,339,"TRAIAN / Şcoala Gimnazială Traian",3,12281,"TRAIAN",129567,1351,853,796,55,2,841,12,1492,639,492,349
30,"OLT",289,129585,,340,"TUFENI / Liceul Tehnologic Tufeni",3,12283,"TUFENI",129585,1294,1105,763,278,64,1094,11,1433,328,851,243
30,"OLT",289,129585,,341,"STOBORĂŞTI / Şcoala Stoborăşti",3,12283,"TUFENI",129585,1000,722,604,80,38,716,6,1108,386,542,174
30,"OLT",289,129629,,342,"URZICA / Şcoala Nouă cu clasele I-VIII Urzica",3,12287,"URZICA",129629,1256,860,658,202,0,848,12,1386,526,320,528
30,"OLT",289,129629,,343,"STĂVARU / Şcoala Nouă cu clasele I-IV Stăvaru",3,12287,"URZICA",129629,647,429,337,90,2,421,8,716,287,197,224
30,"OLT",289,129656,,344,"VALEA MARE / Şcoala Gimnazială",3,12294,"VALEA MARE",129656,1284,800,700,84,16,791,9,1421,621,509,282
30,"OLT",289,129656,,345,"BÎRCA / Căminul Cultural",3,12294,"VALEA MARE",129656,667,472,389,70,13,459,13,734,262,346,113
30,"OLT",289,129656,,346,"TURIA / Grădiniţa",3,12294,"VALEA MARE",129656,493,438,308,126,4,428,10,544,106,306,122
30,"OLT",289,129656,,347,"RECEA / Şcoala Gimnazială",3,12294,"VALEA MARE",129656,573,426,334,88,4,424,2,630,204,291,133
30,"OLT",289,129718,,348,"VĂDASTRA /  Căminul Cultural",3,12290,"VĂDASTRA",129718,1219,979,837,95,47,965,14,1343,364,748,217
30,"OLT",289,129745,,349,"VĂDĂSTRIŢA /  Căminul Cultural",3,12292,"VĂDĂSTRIŢA",129745,1137,745,690,55,0,738,7,1254,509,360,378
30,"OLT",289,129745,,350,"VĂDĂSTRIŢA /  Căminul Cultural",3,12292,"VĂDĂSTRIŢA",129745,1619,1065,965,100,0,1050,15,1779,714,520,530
30,"OLT",289,129763,,351,"VĂLENI / Şcoala Generală Văleni",3,12300,"VĂLENI",129763,792,568,471,86,11,568,0,872,304,406,162
30,"OLT",289,129763,,352,"VĂLENI / Şcoala Generală Văleni",3,12300,"VĂLENI",129763,986,657,574,66,17,656,1,1086,429,477,179
30,"OLT",289,129763,,353,"MANDRA / Şcoala Generală Mandra",3,12300,"VĂLENI",129763,567,371,309,59,3,367,4,626,255,257,110
30,"OLT",289,129816,,354,"POGANU / Căminul cultural",3,12305,"VERGULEASA",129816,910,869,613,248,8,859,10,1025,156,608,251
30,"OLT",289,129816,,355,"CĂZĂNEŞTI / SCOALA CU CLASELE I-IV CAZANESTI",3,12305,"VERGULEASA",129816,744,686,507,179,0,686,0,827,141,508,178
30,"OLT",289,129816,,356,"DUMITREŞTI / Şcoala Generală I-IV",3,12305,"VERGULEASA",129816,635,587,399,181,7,586,1,682,95,409,177
30,"OLT",289,129898,,357,"VIŞINA / Grădiniţa de copii",3,12317,"VIŞINA",129898,1160,903,776,80,47,889,14,1280,377,628,261
30,"OLT",289,129898,,358,"VIŞINA / Grădiniţa de copii",3,12317,"VIŞINA",129898,1330,1062,919,78,65,1045,17,1466,404,680,365
30,"OLT",289,130375,,359,"VIŞINA NOUĂ / Biblioteca Comunală",3,12319,"VIŞINA NOUĂ",130375,1499,1038,874,88,76,1030,8,1657,619,713,317
30,"OLT",289,129914,,360,"VITOMIREŞTI / Liceul Vitomireşti",3,12321,"VITOMIREŞTI",129914,457,402,290,105,7,395,7,504,102,267,128
30,"OLT",289,129914,,361,"BULIMANU / Şcoala cu clasele I-IV Bulimanu",3,12321,"VITOMIREŞTI",129914,184,180,125,49,6,175,5,202,22,140,35
30,"OLT",289,129914,,362,"TREPTENI / Şcoala cu clasele I-IV Trepteni",3,12321,"VITOMIREŞTI",129914,299,204,175,28,1,204,0,330,126,157,47
30,"OLT",289,129914,,363,"DEJEŞTI / Şcoala cu clasele I-VIII Dejeşti",3,12321,"VITOMIREŞTI",129914,616,619,386,221,12,613,6,679,60,484,129
30,"OLT",289,129914,,364,"DONEŞTI / Şcoala cu clasele I-IV Doneşti",3,12321,"VITOMIREŞTI",129914,199,179,131,47,1,179,0,220,41,126,53
30,"OLT",289,129987,,365,"BĂRCĂNEŞTI / Şcoala Generală",3,12313,"VÎLCELE",129987,639,481,374,94,13,469,12,691,210,291,178
30,"OLT",289,129987,,366,"VÎLCELE / Şcoala Vîlcele",3,12313,"VÎLCELE",129987,1355,1087,822,229,36,1066,21,1512,425,761,305
30,"OLT",289,130026,,367,"VLĂDILA / Şcoala Gimnazială",3,12328,"VLĂDILA",130026,972,661,563,78,20,659,2,1072,411,435,224
30,"OLT",289,130026,,368,"VLĂDILA NOUĂ / SCOALA VLADILA NOUA",3,12328,"VLĂDILA",130026,740,498,427,61,10,495,3,817,319,322,173
30,"OLT",289,130062,,369,"VOINEASA / Şcoala cu clasele I-VIII Voineasa",3,12332,"VOINEASA",130062,676,473,398,75,0,470,3,748,275,354,116
30,"OLT",289,130062,,370,"MĂRGĂRITEŞTI / Şcoala cu clasele I-VIII Mărgăriteşti",3,12332,"VOINEASA",130062,571,419,363,56,0,417,2,630,211,360,57
30,"OLT",289,130062,,371,"RACOVIŢA / Şcoala cu clasele I-IV Racoviţa",3,12332,"VOINEASA",130062,479,328,288,40,0,325,3,533,205,222,103
30,"OLT",289,130124,,372,"VALEA SATULUI / Şcoala Gimnazială Vulpeni",3,12338,"VULPENI",130124,839,622,502,120,0,616,6,927,305,388,228
30,"OLT",289,130124,,373,"PRISACA / fosta Şcoala cu clasele I-IV Prisaca",3,12338,"VULPENI",130124,322,218,183,35,0,218,0,358,140,154,64
30,"OLT",289,130124,,374,"GROPŞANI / Şcoala Gimnazială Vulpeni structura Gropşani",3,12338,"VULPENI",130124,703,490,424,65,1,485,5,775,285,348,137
30,"OLT",289,130231,,375,"VULTUREŞTI / Şcoala cu clasele I-VIII Vultureşti",3,12349,"VULTUREŞTI",130231,652,434,316,116,2,428,6,572,138,312,116
30,"OLT",289,130231,,376,"VALEA LUI ALB / Şcoala cu clasele I-IV Valea lui Alb",3,12349,"VULTUREŞTI",130231,509,300,234,57,9,299,1,558,258,214,85
30,"OLT",289,130231,,377,"DIENCI / Fost sediu CAP Dienci",3,12349,"VULTUREŞTI",130231,816,647,461,152,34,642,5,900,253,473,169
30,"OLT",289,127689,,378,"MOVILENI / SCOALA GENERALA MOVILENI ( GRADINITA)",3,12123,"MOVILENI",127689,461,457,371,85,1,454,3,508,51,385,69
31,"PRAHOVA",298,130534,,1,"PLOIEŞTI / PALATUL CULTURII",1,12355,"MUNICIPIUL PLOIEŞTI",130534,1271,932,811,118,3,919,13,1398,466,397,522
31,"PRAHOVA",298,130534,,2,"PLOIEŞTI / CASA DE CULTURA A SINDICATELOR",1,12355,"MUNICIPIUL PLOIEŞTI",130534,957,697,628,68,1,688,9,1100,403,317,371
31,"PRAHOVA",298,130534,,3,"PLOIEŞTI / CASA DE CULTURA A SINDICATELOR",1,12355,"MUNICIPIUL PLOIEŞTI",130534,1081,785,713,72,0,769,16,1200,415,292,477
31,"PRAHOVA",298,130534,,4,"PLOIEŞTI / COLEGIUL NAŢIONAL ""ALEXANDRU IOAN CUZA""",1,12355,"MUNICIPIUL PLOIEŞTI",130534,1142,824,757,66,1,808,16,1300,476,296,512
31,"PRAHOVA",298,130534,,5,"PLOIEŞTI / SCOALA GIMNAZIALĂ NR. 4 ""ELENA DOAMNA""",1,12355,"MUNICIPIUL PLOIEŞTI",130534,1432,973,929,41,3,968,5,1600,627,402,566
31,"PRAHOVA",298,130534,,6,"PLOIEŞTI / SCOALA GIMNAZIALĂ  NR. 4 ""ELENA DOAMNA""",1,12355,"MUNICIPIUL PLOIEŞTI",130534,1361,927,861,65,1,914,13,1500,573,354,560
31,"PRAHOVA",298,130534,,7,"PLOIEŞTI / SCOALA  GIMNAZIALĂ NR. 7 ""CANDIANO POPESCU""",1,12355,"MUNICIPIUL PLOIEŞTI",130534,1357,923,871,52,0,897,26,1500,577,361,536
31,"PRAHOVA",298,130534,,8,"PLOIEŞTI / SCOALA  GIMNAZIALĂ NR. 7 ""CANDIANO POPESCU""",1,12355,"MUNICIPIUL PLOIEŞTI",130534,1306,806,693,44,69,790,16,1400,594,358,432
31,"PRAHOVA",298,130534,,9,"PLOIEŞTI / COLEGIUL NAŢIONAL ""ION LUCA CARAGIALE""",1,12355,"MUNICIPIUL PLOIEŞTI",130534,1540,980,881,99,0,963,17,1700,720,393,570
31,"PRAHOVA",298,130534,,10,"PLOIEŞTI / COLEGIUL NAŢIONAL ""ION LUCA CARAGIALE""",1,12355,"MUNICIPIUL PLOIEŞTI",130534,1319,863,755,107,1,844,19,1500,637,333,511
31,"PRAHOVA",298,130534,,11,"PLOIEŞTI / DIRECTIA JUDETEANA A SPORTURILOR",1,12355,"MUNICIPIUL PLOIEŞTI",130534,1313,818,758,60,0,796,22,1400,582,325,471
31,"PRAHOVA",298,130534,,12,"PLOIEŞTI / DIRECTIA JUDETEANA A SPORTURILOR",1,12355,"MUNICIPIUL PLOIEŞTI",130534,1409,986,872,44,70,968,18,1600,614,414,554
31,"PRAHOVA",298,130534,,13,"PLOIEŞTI / GRUPUL SCOLAR DE ARTE SI MESERII ""SPIRU HARET""",1,12355,"MUNICIPIUL PLOIEŞTI",130534,1198,746,715,31,0,727,19,1300,554,310,417
31,"PRAHOVA",298,130534,,14,"PLOIEŞTI / ANEXA SCOLII NR. 21 (""SFANTA VINERI"")",1,12355,"MUNICIPIUL PLOIEŞTI",130534,1065,725,666,59,0,710,15,1200,475,307,403
31,"PRAHOVA",298,130534,,15,"PLOIEŞTI / MUZEUL DE ISTORIE",1,12355,"MUNICIPIUL PLOIEŞTI",130534,838,590,502,88,0,574,16,900,310,243,331
31,"PRAHOVA",298,130534,,16,"PLOIEŞTI / COLEGIUL NAŢIONAL ""MIHAI VITEAZUL""",1,12355,"MUNICIPIUL PLOIEŞTI",130534,739,524,429,92,3,511,13,800,276,192,319
31,"PRAHOVA",298,130534,,17,"PLOIEŞTI / CLUBUL SPORTIV SCOLAR",1,12355,"MUNICIPIUL PLOIEŞTI",130534,973,691,633,58,0,679,12,1100,409,262,417
31,"PRAHOVA",298,130534,,18,"PLOIEŞTI / S.C. ""ELECTRICA"" S.A.",1,12355,"MUNICIPIUL PLOIEŞTI",130534,1219,746,715,31,0,727,19,1300,554,304,423
31,"PRAHOVA",298,130534,,19,"PLOIEŞTI / GRADINITA NR. 28",1,12355,"MUNICIPIUL PLOIEŞTI",130534,1028,665,639,26,0,647,18,1099,434,250,397
31,"PRAHOVA",298,130534,,20,"PLOIEŞTI / OCOLUL SILVIC",1,12355,"MUNICIPIUL PLOIEŞTI",130534,1477,1022,978,44,0,1001,21,1600,578,355,646
31,"PRAHOVA",298,130534,,21,"PLOIEŞTI / OCOLUL SILVIC",1,12355,"MUNICIPIUL PLOIEŞTI",130534,1678,1008,962,45,1,986,22,1800,792,428,558
31,"PRAHOVA",298,130534,,22,"PLOIEŞTI / SCOALA  GIMNAZIALĂ NR. 12 ""NICOLAE TITULESCU""",1,12355,"MUNICIPIUL PLOIEŞTI",130534,1293,921,853,68,0,898,23,1400,479,344,554
31,"PRAHOVA",298,130534,,23,"PLOIEŞTI / SCOALA  GIMNAZIALĂ NR. 12 ""NICOLAE TITULESCU""",1,12355,"MUNICIPIUL PLOIEŞTI",130534,1483,1024,996,27,1,1006,18,1600,576,336,670
31,"PRAHOVA",298,130534,,24,"PLOIEŞTI / ANEXA GRUP SCOLAR INDUSTRIAL TRANSPORTURI (FOST LICEUL AUTO)",1,12355,"MUNICIPIUL PLOIEŞTI",130534,1678,1099,1047,52,0,1072,27,1800,701,450,622
31,"PRAHOVA",298,130534,,25,"PLOIEŞTI / SCOALA  GIMNAZIALĂ NR. 14 ""SFANTUL VASILE""",1,12355,"MUNICIPIUL PLOIEŞTI",130534,1550,1135,1048,82,5,1123,12,1700,565,420,703
31,"PRAHOVA",298,130534,,26,"PLOIEŞTI / SCOALA  GIMNAZIALĂ NR. 14 ""SFANTUL VASILE""",1,12355,"MUNICIPIUL PLOIEŞTI",130534,1432,1018,957,58,3,998,20,1600,582,388,610
31,"PRAHOVA",298,130534,,27,"PLOIEŞTI / SCOALA  GIMNAZIALĂ NR. 14 ""SFANTUL VASILE""",1,12355,"MUNICIPIUL PLOIEŞTI",130534,1348,942,862,77,3,918,24,1500,558,347,571
31,"PRAHOVA",298,130534,,28,"PLOIEŞTI / SCOALA  GIMNAZIALĂ NR. 14 ""SFANTUL VASILE""",1,12355,"MUNICIPIUL PLOIEŞTI",130534,1433,1042,962,80,0,1018,24,1600,558,380,638
31,"PRAHOVA",298,130534,,29,"PLOIEŞTI / SCOALA GIMNAZIALĂ  NR. 13""DIMITRIE BOLINTINEANU""",1,12355,"MUNICIPIUL PLOIEŞTI",130534,1211,801,763,38,0,780,21,1300,499,306,474
31,"PRAHOVA",298,130534,,30,"PLOIEŞTI / SCOALA  GIMNAZIALĂ NR. 13""DIMITRIE BOLINTINEANU""",1,12355,"MUNICIPIUL PLOIEŞTI",130534,1073,720,691,29,0,704,16,1200,480,278,426
31,"PRAHOVA",298,130534,,31,"PLOIEŞTI / S.C. TRANSPORT CALATORI EXPRESS S.A.",1,12355,"MUNICIPIUL PLOIEŞTI",130534,1605,987,946,41,0,970,17,1800,813,506,464
31,"PRAHOVA",298,130534,,32,"PLOIEŞTI / S.C. TRANSPORT CALATORI EXPRESS S.A.",1,12355,"MUNICIPIUL PLOIEŞTI",130534,1254,790,762,28,0,777,13,1400,610,316,461
31,"PRAHOVA",298,130534,,33,"PLOIEŞTI / S.C. TRANSPORT CALATORI EXPRESS S.A.",1,12355,"MUNICIPIUL PLOIEŞTI",130534,1050,685,657,26,2,665,20,1200,515,280,385
31,"PRAHOVA",298,130534,,34,"PLOIEŞTI / S.C. ""COMCEREAL"" S.A. PLOIESTI",1,12355,"MUNICIPIUL PLOIEŞTI",130534,1660,1097,1030,67,0,1077,20,1800,703,446,631
31,"PRAHOVA",298,130534,,35,"PLOIEŞTI / SCOALA GIMNAZIALA NR. 16 ""ANTON PANN""",1,12355,"MUNICIPIUL PLOIEŞTI",130534,1277,729,682,47,0,707,22,1400,671,311,396
31,"PRAHOVA",298,130534,,36,"PLOIEŞTI / SCOALA GIMNAZIALA NR. 16 ""ANTON PANN""",1,12355,"MUNICIPIUL PLOIEŞTI",130534,1438,802,773,29,0,774,28,1600,798,378,396
31,"PRAHOVA",298,130534,,37,"PLOIEŞTI / SCOALA GIMNAZIALA NR. 16 ""ANTON PANN""",1,12355,"MUNICIPIUL PLOIEŞTI",130534,785,423,393,30,0,410,13,900,477,200,210
31,"PRAHOVA",298,130534,,38,"PLOIEŞTI / SPATIUL MUNICIPIULUI PLOIESTI",1,12355,"MUNICIPIUL PLOIEŞTI",130534,1550,923,864,59,0,907,16,1700,777,368,539
31,"PRAHOVA",298,130534,,39,"PLOIEŞTI / BLOCUL 24B PARTER",1,12355,"MUNICIPIUL PLOIEŞTI",130534,1470,949,875,74,0,934,15,1600,651,425,509
31,"PRAHOVA",298,130534,,40,"PLOIEŞTI / CANTINA DE AJUTOR SOCIAL",1,12355,"MUNICIPIUL PLOIEŞTI",130534,1584,942,878,63,1,917,25,1700,758,450,467
31,"PRAHOVA",298,130534,,41,"PLOIEŞTI / CANTINA DE AJUTOR SOCIAL",1,12355,"MUNICIPIUL PLOIEŞTI",130534,1586,1035,955,45,35,1015,20,1700,665,414,601
31,"PRAHOVA",298,130534,,42,"PLOIEŞTI / CANTINA DE AJUTOR SOCIAL",1,12355,"MUNICIPIUL PLOIEŞTI",130534,1427,906,861,44,1,886,20,1600,694,352,534
31,"PRAHOVA",298,130534,,43,"PLOIEŞTI / OFICIUL POSTAL NR. 11",1,12355,"MUNICIPIUL PLOIEŞTI",130534,1550,1019,939,78,2,992,27,1700,681,460,532
31,"PRAHOVA",298,130534,,44,"PLOIEŞTI / GRUP SCOLAR TELEAJEN",1,12355,"MUNICIPIUL PLOIEŞTI",130534,1045,599,546,53,0,591,8,1100,501,213,378
31,"PRAHOVA",298,130534,,45,"PLOIEŞTI / GRADINITA DE COPII NR. 4",1,12355,"MUNICIPIUL PLOIEŞTI",130534,818,679,553,30,96,667,12,900,221,307,360
31,"PRAHOVA",298,130534,,46,"PLOIEŞTI / SCOLALA  GIMNAZIALĂ NR. 17 ""IOAN GRIGORESCU""",1,12355,"MUNICIPIUL PLOIEŞTI",130534,1193,749,719,29,1,734,15,1300,551,328,406
31,"PRAHOVA",298,130534,,47,"PLOIEŞTI / SCOLALA  GIMNAZIALĂ NR. 17 ""IOAN GRIGORESCU""",1,12355,"MUNICIPIUL PLOIEŞTI",130534,1321,857,833,24,0,827,30,1500,643,347,480
31,"PRAHOVA",298,130534,,48,"PLOIEŞTI / SCOLALA  GIMNAZIALĂ NR. 17 ""IOAN GRIGORESCU""",1,12355,"MUNICIPIUL PLOIEŞTI",130534,1159,673,652,21,0,657,16,1300,627,271,386
31,"PRAHOVA",298,130534,,49,"PLOIEŞTI / SCOALA  GIMNAZIALĂ NR. 9 ""RARES VODA""",1,12355,"MUNICIPIUL PLOIEŞTI",130534,1064,795,722,73,0,774,21,1200,405,289,485
31,"PRAHOVA",298,130534,,50,"PLOIEŞTI / CASA CORPULUI DIDACTIC",1,12355,"MUNICIPIUL PLOIEŞTI",130534,1167,772,725,47,0,755,17,1300,528,288,467
31,"PRAHOVA",298,130534,,51,"PLOIEŞTI / CASA CORPULUI DIDACTIC",1,12355,"MUNICIPIUL PLOIEŞTI",130534,912,605,554,48,3,589,16,1000,395,226,363
31,"PRAHOVA",298,130534,,52,"PLOIEŞTI / LICEUL PEDAGOGIC PLOIESTI",1,12355,"MUNICIPIUL PLOIEŞTI",130534,1218,859,764,67,28,833,26,1300,441,343,490
31,"PRAHOVA",298,130534,,53,"PLOIEŞTI / GRUP SCOLAR ADMINISTRATIV SERVICII ""VICTOR SLAVESCU"" ( FOSTA SCOALA NR. 32)",1,12355,"MUNICIPIUL PLOIEŞTI",130534,1199,846,760,84,2,829,17,1300,454,322,507
31,"PRAHOVA",298,130534,,54,"PLOIEŞTI / GRUP SCOLAR ADMINISTRATIV SERVICII ""VICTOR SLAVESCU"" ( FOSTA SCOALA NR. 32)",1,12355,"MUNICIPIUL PLOIEŞTI",130534,1170,761,694,66,1,750,11,1300,539,333,417
31,"PRAHOVA",298,130534,,55,"PLOIEŞTI / SCOALA GIMNAZIALA NR. 10 ""GEORGE COSBUC""",1,12355,"MUNICIPIUL PLOIEŞTI",130534,1347,900,851,48,1,878,22,1501,601,416,462
31,"PRAHOVA",298,130534,,56,"PLOIEŞTI / SCOALA GIMNAZIALA NR. 10 ""GEORGE COSBUC""",1,12355,"MUNICIPIUL PLOIEŞTI",130534,1336,871,818,53,0,846,25,1500,629,380,466
31,"PRAHOVA",298,130534,,57,"PLOIEŞTI / SCOLALA NR. 18 ""UNIREA""",1,12355,"MUNICIPIUL PLOIEŞTI",130534,1163,610,595,15,0,594,16,1300,690,269,325
31,"PRAHOVA",298,130534,,58,"PLOIEŞTI / SCOLALA NR. 18 ""UNIREA""",1,12355,"MUNICIPIUL PLOIEŞTI",130534,873,541,514,27,0,524,17,1000,459,236,288
31,"PRAHOVA",298,130534,,59,"PLOIEŞTI / GRUP SCOLAR 1 MAI",1,12355,"MUNICIPIUL PLOIEŞTI",130534,1638,1019,914,104,1,993,26,1800,781,419,574
31,"PRAHOVA",298,130534,,60,"PLOIEŞTI / GRUP SCOLAR 1 MAI",1,12355,"MUNICIPIUL PLOIEŞTI",130534,1552,1029,890,139,0,1008,21,1700,671,460,548
31,"PRAHOVA",298,130534,,61,"PLOIEŞTI / COLEGIUL ""LAZAR EDELEANU""(FOST LICEUL DE CHIMIE)",1,12355,"MUNICIPIUL PLOIEŞTI",130534,1384,984,893,90,1,969,15,1500,516,378,591
31,"PRAHOVA",298,130534,,62,"PLOIEŞTI / COLEGIUL ""LAZAR EDELEANU""(FOST LICEUL DE CHIMIE)",1,12355,"MUNICIPIUL PLOIEŞTI",130534,1684,1021,942,79,0,994,27,1900,879,419,575
31,"PRAHOVA",298,130534,,63,"PLOIEŞTI / SCOALA GIMNAZIALA NR. 15 ""MIHAI EMINESCU""",1,12355,"MUNICIPIUL PLOIEŞTI",130534,1380,980,902,78,0,963,17,1500,520,402,561
31,"PRAHOVA",298,130534,,64,"PLOIEŞTI / SCOALA GIMNAZIALA NR. 15 ""MIHAI EMINESCU""",1,12355,"MUNICIPIUL PLOIEŞTI",130534,1467,972,931,41,0,956,16,1600,628,404,552
31,"PRAHOVA",298,130534,,65,"PLOIEŞTI / SCOALA NR. 19",1,12355,"MUNICIPIUL PLOIEŞTI",130534,1233,638,600,38,0,619,19,1400,762,364,255
31,"PRAHOVA",298,130534,,66,"PLOIEŞTI / SCOALA GIMNAZIALA NR. 1 ""RADU STANIAN""",1,12355,"MUNICIPIUL PLOIEŞTI",130534,1124,789,734,53,2,771,18,1200,411,354,417
31,"PRAHOVA",298,130534,,67,"PLOIEŞTI / LICEUL DE ARTA",1,12355,"MUNICIPIUL PLOIEŞTI",130534,972,659,616,42,1,650,9,1102,443,268,382
31,"PRAHOVA",298,130534,,68,"PLOIEŞTI / LICEUL DE ARTA",1,12355,"MUNICIPIUL PLOIEŞTI",130534,821,575,550,23,2,562,13,900,325,229,333
31,"PRAHOVA",298,130534,,69,"PLOIEŞTI / S.C.APA NOVA S.R.L.",1,12355,"MUNICIPIUL PLOIEŞTI",130534,1104,894,711,59,124,881,13,1200,306,363,518
31,"PRAHOVA",298,130534,,70,"PLOIEŞTI / COLEGIUL ""SPIRU HARET""(FOST LICEUL DE CONSTRUCTII MASINI)",1,12355,"MUNICIPIUL PLOIEŞTI",130534,985,996,585,49,362,985,11,1099,103,616,369
31,"PRAHOVA",298,130534,,71,"PLOIEŞTI / SEDIUL TMUCB",1,12355,"MUNICIPIUL PLOIEŞTI",130534,865,491,458,33,0,487,4,900,409,241,246
31,"PRAHOVA",298,130534,,72,"PLOIEŞTI / SCOALA  GIMNAZIALĂ NR. 11 ""FLORIN COMISEL""",1,12355,"MUNICIPIUL PLOIEŞTI",130534,1393,913,875,37,1,893,20,1500,587,403,490
31,"PRAHOVA",298,130534,,73,"PLOIEŞTI / PALATUL COPIILOR (FOSTA SCOALA NR. 20)",1,12355,"MUNICIPIUL PLOIEŞTI",130534,1315,893,811,81,1,879,14,1400,507,331,548
31,"PRAHOVA",298,130534,,74,"PLOIEŞTI / PALATUL COPIILOR (FOSTA SCOALA NR. 20)",1,12355,"MUNICIPIUL PLOIEŞTI",130534,1319,878,822,55,1,866,12,1500,622,309,557
31,"PRAHOVA",298,130534,,75,"PLOIEŞTI / PALATUL COPIILOR (FOSTA SCOALA NR. 20)",1,12355,"MUNICIPIUL PLOIEŞTI",130534,1457,912,875,36,1,889,23,1600,688,373,516
31,"PRAHOVA",298,130534,,76,"PLOIEŞTI / PALATUL COPIILOR (FOSTA SCOALA NR. 20)",1,12355,"MUNICIPIUL PLOIEŞTI",130534,882,553,534,19,0,541,12,1000,447,213,328
31,"PRAHOVA",298,130534,,77,"PLOIEŞTI / PALATUL COPIILOR (FOSTA SCOALA NR. 20)",1,12355,"MUNICIPIUL PLOIEŞTI",130534,1052,717,686,31,0,705,12,1200,483,287,418
31,"PRAHOVA",298,130534,,78,"PLOIEŞTI / SCOALA  GIMNAZIALĂ I. A. BASARABESCU",1,12355,"MUNICIPIUL PLOIEŞTI",130534,1630,1095,1032,63,0,1070,25,1801,706,428,642
31,"PRAHOVA",298,130534,,79,"PLOIEŞTI / SCOALA GIMNAZIALĂ  I. A. BASARABESCU",1,12355,"MUNICIPIUL PLOIEŞTI",130534,1436,989,912,76,1,966,23,1600,611,335,631
31,"PRAHOVA",298,130534,,80,"PLOIEŞTI / SCOALA GIMNAZIALĂ  I. A. BASARABESCU",1,12355,"MUNICIPIUL PLOIEŞTI",130534,1816,1232,1182,49,1,1207,25,2000,768,447,760
31,"PRAHOVA",298,130534,,81,"PLOIEŞTI / SCOALA  GIMNAZIALĂ I. A. BASARABESCU",1,12355,"MUNICIPIUL PLOIEŞTI",130534,1566,1109,990,33,86,1085,24,1700,591,489,596
31,"PRAHOVA",298,130534,,82,"PLOIEŞTI / DIRECTIA JUDETEANA DE PROTECTIA COPILULUI PRAHOVA",1,12355,"MUNICIPIUL PLOIEŞTI",130534,1414,882,853,28,1,862,20,1600,718,359,503
31,"PRAHOVA",298,130534,,83,"PLOIEŞTI / DIRECTIA JUDETEANA DE PROTECTIA COPILULUI PRAHOVA",1,12355,"MUNICIPIUL PLOIEŞTI",130534,1420,1009,948,60,1,992,17,1600,591,442,550
31,"PRAHOVA",298,130534,,84,"PLOIEŞTI / SCOALA NR. 29",1,12355,"MUNICIPIUL PLOIEŞTI",130534,1428,942,883,59,0,915,27,1600,658,435,480
31,"PRAHOVA",298,130534,,85,"PLOIEŞTI / SCOALA NR. 29",1,12355,"MUNICIPIUL PLOIEŞTI",130534,1334,845,803,42,0,835,10,1500,655,337,498
31,"PRAHOVA",298,130534,,86,"PLOIEŞTI / SCOALA NR. 29",1,12355,"MUNICIPIUL PLOIEŞTI",130534,1437,895,854,41,0,875,20,1600,705,318,557
31,"PRAHOVA",298,130534,,87,"PLOIEŞTI / SCOALA NR. 29",1,12355,"MUNICIPIUL PLOIEŞTI",130534,1284,775,756,19,0,759,16,1400,625,339,420
31,"PRAHOVA",298,130534,,88,"PLOIEŞTI / GRADINITA NR. 50",1,12355,"MUNICIPIUL PLOIEŞTI",130534,1106,757,722,34,1,737,20,1200,443,335,402
31,"PRAHOVA",298,130534,,89,"PLOIEŞTI / GRADINITA NR. 50",1,12355,"MUNICIPIUL PLOIEŞTI",130534,1276,830,798,31,1,805,25,1400,570,329,476
31,"PRAHOVA",298,130534,,90,"PLOIEŞTI / GRADINITA NR. 40",1,12355,"MUNICIPIUL PLOIEŞTI",130534,1239,744,718,26,0,732,12,1400,656,308,424
31,"PRAHOVA",298,130534,,91,"PLOIEŞTI / GRADINITA NR. 40",1,12355,"MUNICIPIUL PLOIEŞTI",130534,983,667,626,41,0,657,10,1100,433,321,336
31,"PRAHOVA",298,130534,,92,"PLOIEŞTI / GRADINITA NR. 40",1,12355,"MUNICIPIUL PLOIEŞTI",130534,1512,954,907,47,0,939,15,1700,746,394,545
31,"PRAHOVA",298,130534,,93,"PLOIEŞTI / SCOALA NR. 3 ""TOMA CARAGIU""",1,12355,"MUNICIPIUL PLOIEŞTI",130534,1220,755,725,28,2,734,21,1300,545,326,408
31,"PRAHOVA",298,130534,,94,"PLOIEŞTI / SCOALA NR. 3 ""TOMA CARAGIU""",1,12355,"MUNICIPIUL PLOIEŞTI",130534,964,617,583,33,1,603,14,1100,483,282,321
31,"PRAHOVA",298,130534,,95,"PLOIEŞTI / SCOALA NR. 3 ""TOMA CARAGIU""",1,12355,"MUNICIPIUL PLOIEŞTI",130534,1360,861,814,47,0,839,22,1495,634,354,485
31,"PRAHOVA",298,130534,,96,"PLOIEŞTI / SCOALA NR. 31 ""NICOLAE IORGA""",1,12355,"MUNICIPIUL PLOIEŞTI",130534,1520,864,818,46,0,851,13,1700,836,356,495
31,"PRAHOVA",298,130534,,97,"PLOIEŞTI / SCOALA NR. 31 ""NICOLAE IORGA""",1,12355,"MUNICIPIUL PLOIEŞTI",130534,1320,881,826,54,1,858,23,1400,519,380,478
31,"PRAHOVA",298,130534,,98,"PLOIEŞTI / SCOALA NR. 31 ""NICOLAE IORGA""",1,12355,"MUNICIPIUL PLOIEŞTI",130534,1445,913,861,52,0,891,22,1600,687,340,551
31,"PRAHOVA",298,130534,,99,"PLOIEŞTI / GRADINITA NR. 39",1,12355,"MUNICIPIUL PLOIEŞTI",130534,914,635,605,30,0,618,17,1000,365,250,368
31,"PRAHOVA",298,130534,,100,"PLOIEŞTI / GRADINITA NR. 39",1,12355,"MUNICIPIUL PLOIEŞTI",130534,901,561,538,20,3,552,9,1000,439,257,295
31,"PRAHOVA",298,130534,,101,"PLOIEŞTI / GRADINITA NR. 39",1,12355,"MUNICIPIUL PLOIEŞTI",130534,1518,863,838,24,1,850,13,1700,837,360,490
31,"PRAHOVA",298,130534,,102,"PLOIEŞTI / GRADINITA NR. 36 ""SF. MUCENIC MINA""",1,12355,"MUNICIPIUL PLOIEŞTI",130534,1460,948,906,42,0,923,25,1600,652,413,510
31,"PRAHOVA",298,130534,,103,"PLOIEŞTI / GRADINITA NR. 36 ""SF. MUCENIC MINA""",1,12355,"MUNICIPIUL PLOIEŞTI",130534,1598,1007,930,77,0,991,16,1799,792,425,566
31,"PRAHOVA",298,130534,,104,"PLOIEŞTI / GRADINITA NR. 36 ""SF. MUCENIC MINA""",1,12355,"MUNICIPIUL PLOIEŞTI",130534,1267,827,795,32,0,801,26,1400,573,362,439
31,"PRAHOVA",298,130534,,105,"PLOIEŞTI / GRADINITA NR. 36 ""SF. MUCENIC MINA""",1,12355,"MUNICIPIUL PLOIEŞTI",130534,1105,677,620,56,1,658,19,1200,523,294,364
31,"PRAHOVA",298,130534,,106,"PLOIEŞTI / GRADINITA NR. 47",1,12355,"MUNICIPIUL PLOIEŞTI",130534,1020,671,641,29,1,661,10,1200,529,288,373
31,"PRAHOVA",298,130534,,107,"PLOIEŞTI / GRADINITA NR. 47",1,12355,"MUNICIPIUL PLOIEŞTI",130534,863,577,559,17,1,563,14,1000,423,288,275
31,"PRAHOVA",298,130534,,108,"PLOIEŞTI / GRADINITA NR. 47",1,12355,"MUNICIPIUL PLOIEŞTI",130534,962,589,565,24,0,575,14,1100,511,273,302
31,"PRAHOVA",298,130534,,109,"PLOIEŞTI / SISTEMUL DE GOSPODARIRE A APELOR PRAHOVA",1,12355,"MUNICIPIUL PLOIEŞTI",130534,1220,812,773,39,0,805,7,1300,488,318,487
31,"PRAHOVA",298,130534,,110,"PLOIEŞTI / SEDIUL AGENTIEI DE PROTECTIA MEDIULUI PRAHOVA",1,12355,"MUNICIPIUL PLOIEŞTI",130534,1229,874,815,57,2,849,25,1400,526,331,518
31,"PRAHOVA",298,130534,,111,"PLOIEŞTI / SEDIUL A.N. APELE ROMANE - EXPLOATARE SISTEM ZONAL PRAHOVA",1,12355,"MUNICIPIUL PLOIEŞTI",130534,1131,793,723,70,0,775,18,1200,407,293,482
31,"PRAHOVA",298,130534,,112,"PLOIEŞTI / SCOALA GIMNAZIALA NR. 2 ""IENACHITA VACARESCU""",1,12355,"MUNICIPIUL PLOIEŞTI",130534,1490,996,963,33,0,970,26,1600,604,396,574
31,"PRAHOVA",298,130534,,113,"PLOIEŞTI / SCOALA GIMNAZIALA NR. 2 ""IENACHITA VACARESCU""",1,12355,"MUNICIPIUL PLOIEŞTI",130534,1581,1011,991,20,0,992,19,1700,689,448,544
31,"PRAHOVA",298,130534,,114,"PLOIEŞTI / SCOALA GIMNAZIALA NR. 2 ""IENACHITA VACARESCU""",1,12355,"MUNICIPIUL PLOIEŞTI",130534,1361,925,874,51,0,899,26,1500,575,358,541
31,"PRAHOVA",298,130534,,115,"PLOIEŞTI / SCOALA GIMNAZIALA NR. 2 ""IENACHITA VACARESCU""",1,12355,"MUNICIPIUL PLOIEŞTI",130534,1006,667,647,20,0,644,23,1100,433,252,392
31,"PRAHOVA",298,130534,,116,"PLOIEŞTI / GRUP SCOLAR INDUSTRIAL ""TOMA SOCOLESCU""",1,12355,"MUNICIPIUL PLOIEŞTI",130534,1086,767,700,67,0,750,17,1200,433,316,434
31,"PRAHOVA",298,130534,,117,"PLOIEŞTI / GRUP SCOLAR INDUSTRIAL ""TOMA SOCOLESCU""",1,12355,"MUNICIPIUL PLOIEŞTI",130534,759,541,454,87,0,529,12,800,259,202,327
31,"PRAHOVA",298,130534,,118,"PLOIEŞTI / GRUP SCOLAR INDUSTRIAL ENERGETIC ""ELIE RADU""",1,12355,"MUNICIPIUL PLOIEŞTI",130534,1463,913,876,37,0,894,19,1600,687,410,484
31,"PRAHOVA",298,130534,,119,"PLOIEŞTI / GRUP SCOLAR INDUSTRIAL ENERGETIC ""ELIE RADU""",1,12355,"MUNICIPIUL PLOIEŞTI",130534,1540,940,896,44,0,918,22,1700,760,405,513
31,"PRAHOVA",298,130534,,120,"PLOIEŞTI / SEDIUL SCOLII DE SOFERI AMATORI",1,12355,"MUNICIPIUL PLOIEŞTI",130534,960,666,629,37,0,643,23,1100,434,294,349
31,"PRAHOVA",298,130534,,121,"PLOIEŞTI / SCOALA GIMNAZIALA PROFESOR ""NICOLAE SIMACHE""",1,12355,"MUNICIPIUL PLOIEŞTI",130534,1283,901,829,71,1,879,22,1400,499,363,516
31,"PRAHOVA",298,130534,,122,"PLOIEŞTI / SCOALA GIMNAZIALA PROFESOR ""NICOLAE SIMACHE""",1,12355,"MUNICIPIUL PLOIEŞTI",130534,1456,914,874,40,0,890,24,1600,686,388,502
31,"PRAHOVA",298,130534,,123,"PLOIEŞTI / SCOALA GIMNAZIALA PROFESOR ""NICOLAE SIMACHE""",1,12355,"MUNICIPIUL PLOIEŞTI",130534,1317,867,806,58,3,851,16,1500,633,402,449
31,"PRAHOVA",298,130534,,124,"PLOIEŞTI / SCOALA GIMNAZIALA NR. 28 ""NICOLAE BALCESCU""",1,12355,"MUNICIPIUL PLOIEŞTI",130534,1515,951,892,56,3,925,26,1700,749,409,516
31,"PRAHOVA",298,130534,,125,"PLOIEŞTI / SCOALA GIMNAZIALA NR. 28 ""NICOLAE BALCESCU""",1,12355,"MUNICIPIUL PLOIEŞTI",130534,1460,902,845,56,1,883,19,1600,698,388,495
31,"PRAHOVA",298,130534,,126,"PLOIEŞTI / SCOALA GIMNAZIALA NR. 28 ""NICOLAE BALCESCU""",1,12355,"MUNICIPIUL PLOIEŞTI",130534,1602,998,949,48,1,974,24,1800,802,467,507
31,"PRAHOVA",298,130534,,127,"PLOIEŞTI / SCOALA GIMNAZIALA NR. 28 ""NICOLAE BALCESCU""",1,12355,"MUNICIPIUL PLOIEŞTI",130534,1220,785,756,29,0,770,15,1300,515,371,399
31,"PRAHOVA",298,130534,,128,"PLOIEŞTI / GRADINITA DE COPII NR. 10",1,12355,"MUNICIPIUL PLOIEŞTI",130534,1429,908,856,51,1,883,25,1600,692,387,496
31,"PRAHOVA",298,130534,,129,"PLOIEŞTI / GRADINITA DE COPII NR. 10",1,12355,"MUNICIPIUL PLOIEŞTI",130534,1008,596,575,21,0,582,14,1100,504,264,318
31,"PRAHOVA",298,130534,,130,"PLOIEŞTI / GRADINITA DE COPII NR. 10",1,12355,"MUNICIPIUL PLOIEŞTI",130534,1157,712,685,26,1,702,10,1300,588,307,395
31,"PRAHOVA",298,130534,,131,"PLOIEŞTI / S.C. ""ELCO"" S.A.",1,12355,"MUNICIPIUL PLOIEŞTI",130534,1144,780,741,39,0,770,10,1300,520,341,429
31,"PRAHOVA",298,130534,,132,"PLOIEŞTI / SCOALA NR. 5 ""ION CREANGA""",1,12355,"MUNICIPIUL PLOIEŞTI",130534,1474,941,873,68,0,924,17,1599,658,395,529
31,"PRAHOVA",298,130534,,133,"PLOIEŞTI / SCOALA NR. 5 ""ION CREANGA""",1,12355,"MUNICIPIUL PLOIEŞTI",130534,1328,896,864,30,2,879,17,1500,604,329,550
31,"PRAHOVA",298,130534,,134,"PLOIEŞTI / SCOALA NR. 5 ""ION CREANGA""",1,12355,"MUNICIPIUL PLOIEŞTI",130534,1349,964,881,58,25,945,19,1500,536,376,569
31,"PRAHOVA",298,130534,,135,"PLOIEŞTI / SCOALA NR. 5 ""ION CREANGA""",1,12355,"MUNICIPIUL PLOIEŞTI",130534,1267,873,825,48,0,855,18,1400,527,398,457
31,"PRAHOVA",298,130534,,136,"PLOIEŞTI / SCOALA NR. 5 ""ION CREANGA""",1,12355,"MUNICIPIUL PLOIEŞTI",130534,1350,952,901,48,3,932,20,1500,548,383,549
31,"PRAHOVA",298,130534,,137,"PLOIEŞTI / SCOALA GIMNAZIALA NR. 23 ""ANDREI MURESEANU""",1,12355,"MUNICIPIUL PLOIEŞTI",130534,1610,1088,1039,48,1,1067,21,1800,712,448,619
31,"PRAHOVA",298,130534,,138,"PLOIEŞTI / SCOALA GIMNAZIALA NR. 23 ""ANDREI MURESEANU""",1,12355,"MUNICIPIUL PLOIEŞTI",130534,1274,796,743,50,3,779,17,1400,604,319,460
31,"PRAHOVA",298,130534,,139,"PLOIEŞTI / SCOALA GIMNAZIALA NR. 23 ""ANDREI MURESEANU""",1,12355,"MUNICIPIUL PLOIEŞTI",130534,1065,693,644,48,1,686,7,1200,507,264,422
31,"PRAHOVA",298,130534,,140,"PLOIEŞTI / SCOALA GIMNAZIALA NR. 25 ""HENRI MATHIAS BERTHELOT""",1,12355,"MUNICIPIUL PLOIEŞTI",130534,945,661,600,61,0,649,12,1000,339,301,348
31,"PRAHOVA",298,130534,,141,"PLOIEŞTI / SCOALA GIMNAZIALA NR. 25 ""HENRI MATHIAS BERTHELOT""",1,12355,"MUNICIPIUL PLOIEŞTI",130534,1214,830,797,33,0,816,14,1300,470,331,485
31,"PRAHOVA",298,130534,,142,"PLOIEŞTI / SCOALA GIMNAZIALA NR. 25 ""HENRI MATHIAS BERTHELOT""",1,12355,"MUNICIPIUL PLOIEŞTI",130534,1166,786,749,37,0,776,10,1300,514,296,480
31,"PRAHOVA",298,130534,,143,"PLOIEŞTI / SCOALA GIMNAZIALA NR. 8 ""GRIGORE MOISIL""",1,12355,"MUNICIPIUL PLOIEŞTI",130534,1156,772,706,66,0,759,13,1300,528,307,452
31,"PRAHOVA",298,130534,,144,"PLOIEŞTI / SCOALA GIMNAZIALA NR. 8 ""GRIGORE MOISIL""",1,12355,"MUNICIPIUL PLOIEŞTI",130534,1158,745,707,36,2,729,16,1300,555,310,419
31,"PRAHOVA",298,130534,,145,"PLOIEŞTI / LICEUL ""NICHITA STANESCU""",1,12355,"MUNICIPIUL PLOIEŞTI",130534,919,611,582,27,2,601,10,1000,389,266,335
31,"PRAHOVA",298,130534,,146,"PLOIEŞTI / LICEUL ""NICHITA STANESCU""",1,12355,"MUNICIPIUL PLOIEŞTI",130534,1010,685,652,33,0,667,18,1100,415,292,375
31,"PRAHOVA",298,130534,,147,"PLOIEŞTI / LICEUL ""NICHITA STANESCU""",1,12355,"MUNICIPIUL PLOIEŞTI",130534,1001,675,638,37,0,662,13,1100,425,266,396
31,"PRAHOVA",298,130534,,148,"PLOIEŞTI / LICEUL ""NICHITA STANESCU""",1,12355,"MUNICIPIUL PLOIEŞTI",130534,1401,956,862,94,0,935,21,1500,544,425,510
31,"PRAHOVA",298,130534,,149,"PLOIEŞTI / POLICLINICA CINA",1,12355,"MUNICIPIUL PLOIEŞTI",130534,1477,958,907,50,1,935,23,1600,642,362,573
31,"PRAHOVA",298,130534,,150,"PLOIEŞTI / POLICLINICA CINA",1,12355,"MUNICIPIUL PLOIEŞTI",130534,1407,945,892,50,3,929,16,1600,655,388,541
31,"PRAHOVA",298,130534,,151,"PLOIEŞTI / SCOALA GIMNAZIALA NR. 24 ""SFANTUL ANDREI""",1,12355,"MUNICIPIUL PLOIEŞTI",130534,1486,899,844,55,0,880,19,1600,701,363,517
31,"PRAHOVA",298,130534,,152,"PLOIEŞTI / SCOALA GIMNAZIALA NR. 24 ""SFANTUL ANDREI""",1,12355,"MUNICIPIUL PLOIEŞTI",130534,1453,983,908,75,0,953,30,1600,617,429,524
31,"PRAHOVA",298,130534,,153,"PLOIEŞTI / SCOALA GIMNAZIALA NR. 24 ""SFANTUL ANDREI""",1,12355,"MUNICIPIUL PLOIEŞTI",130534,1395,1075,807,62,206,1048,27,1500,425,498,550
31,"PRAHOVA",298,130534,,154,"PLOIEŞTI / SCOALA GIMNAZIALA NR. 24 ""SFANTUL ANDREI""",1,12355,"MUNICIPIUL PLOIEŞTI",130534,1475,900,859,36,5,877,23,1600,700,425,452
31,"PRAHOVA",298,130534,,155,"PLOIEŞTI / SCOALA GIMNAZIALA NR. 24 ""SFANTUL ANDREI""",1,12355,"MUNICIPIUL PLOIEŞTI",130534,1401,897,863,34,0,875,22,1500,603,397,478
31,"PRAHOVA",298,130534,,156,"PLOIEŞTI / SCOALA GIMNAZIALĂ NR. 22 ""MITICA APOSTOL""",1,12355,"MUNICIPIUL PLOIEŞTI",130534,1346,777,723,54,0,763,14,1500,723,323,440
31,"PRAHOVA",298,130534,,157,"PLOIEŞTI / GARA PLOIESTI TRIAJ",1,12355,"MUNICIPIUL PLOIEŞTI",130534,171,113,96,17,0,110,3,200,87,60,50
31,"PRAHOVA",298,131256,,158,"CÂMPINA / CASA DE CULTURĂ ""GEO BOGZA""-  (hol)",1,12357,"MUNICIPIUL CÂMPINA",131256,1405,945,863,79,3,936,9,1500,555,389,547
31,"PRAHOVA",298,131256,,159,"CÂMPINA / COLEGIUL NAŢIONAL""NICOLAE GRIGORESCU"" - (sala de clasa)",1,12357,"MUNICIPIUL CÂMPINA",131256,1228,920,790,129,1,906,14,1400,480,388,518
31,"PRAHOVA",298,131256,,160,"CÂMPINA / COLEGIUL NAŢIONAL""NICOLAE GRIGORESCU"" - (sala de clasa)",1,12357,"MUNICIPIUL CÂMPINA",131256,1347,1051,859,192,0,1028,23,1500,449,421,607
31,"PRAHOVA",298,131256,,161,"CÂMPINA / CASA TINERETULUI (hol mare)",1,12357,"MUNICIPIUL CÂMPINA",131256,1064,702,588,113,1,689,13,1200,498,291,398
31,"PRAHOVA",298,131256,,162,"CÂMPINA / ŞCOALA GIMNAZIALĂ CENTRALĂ - (sala de clasa)",1,12357,"MUNICIPIUL CÂMPINA",131256,1143,877,671,116,90,862,15,1300,423,382,480
31,"PRAHOVA",298,131256,,163,"CÂMPINA / LICEUL TEHNOLOGIC ENERGETIC  -(corp A-sala de clasa nr.5-intrarea secundara)",1,12357,"MUNICIPIUL CÂMPINA",131256,1150,762,717,44,1,757,5,1300,538,283,474
31,"PRAHOVA",298,131256,,164,"CÂMPINA / LICEUL TEHNOLOGIC ENERGETIC - (corp A sala de clasa nr.3-intrarea principala)",1,12357,"MUNICIPIUL CÂMPINA",131256,959,611,566,43,2,600,11,1100,489,274,326
31,"PRAHOVA",298,131256,,165,"CÂMPINA / ŞCOALA GIMNAZIALĂ ""B.P.HASDEU"" - (sala de sport)",1,12357,"MUNICIPIUL CÂMPINA",131256,1449,863,803,59,1,849,14,1600,737,362,487
31,"PRAHOVA",298,131256,,166,"CÂMPINA / CASA TINERETULUI (hol mic)",1,12357,"MUNICIPIUL CÂMPINA",131256,1554,1018,941,75,2,1002,16,1700,682,499,503
31,"PRAHOVA",298,131256,,167,"CÂMPINA / SC STEAUA ROMÂNĂ S.A. - (cantina)",1,12357,"MUNICIPIUL CÂMPINA",131256,1323,884,809,75,0,866,18,1500,616,383,483
31,"PRAHOVA",298,131256,,168,"CÂMPINA / COLEGIUL TEHNIC FORESTIER - (sala de sport)",1,12357,"MUNICIPIUL CÂMPINA",131256,1324,942,857,84,1,926,16,1500,558,381,545
31,"PRAHOVA",298,131256,,169,"CÂMPINA / COLEGIUL TEHNIC FORESTIER - (sala de sport)",1,12357,"MUNICIPIUL CÂMPINA",131256,1378,941,861,80,0,924,17,1500,559,370,554
31,"PRAHOVA",298,131256,,170,"CÂMPINA / COLEGIUL TEHNIC CONSTANTIN ISTRATI (camin)",1,12357,"MUNICIPIUL CÂMPINA",131256,1616,1091,965,126,0,1067,24,1800,709,432,635
31,"PRAHOVA",298,131256,,171,"CÂMPINA / COLEGIUL TEHNIC CONSTANTIN ISTRATI - sala de clasa)",1,12357,"MUNICIPIUL CÂMPINA",131256,1620,1035,952,59,24,1018,17,1800,765,409,609
31,"PRAHOVA",298,131256,,172,"CÂMPINA / ŞCOALA GENERALĂ NR.5 - (sala de clasa)",1,12357,"MUNICIPIUL CÂMPINA",131256,1236,876,812,60,4,857,19,1400,524,333,524
31,"PRAHOVA",298,131256,,173,"CÂMPINA / LICEUL TEHNOLOGIC MECANIC - (sala de sport)",1,12357,"MUNICIPIUL CÂMPINA",131256,1619,987,939,47,1,967,20,1800,813,413,554
31,"PRAHOVA",298,131256,,174,"CÂMPINA / LICEUL TEHNOLOGIC MECANIC - (cantina)",1,12357,"MUNICIPIUL CÂMPINA",131256,1391,914,867,47,0,900,14,1500,586,302,598
31,"PRAHOVA",298,131256,,175,"CÂMPINA / LICEUL TEHNOLOGIC MECANIC - (cantina)",1,12357,"MUNICIPIUL CÂMPINA",131256,1569,900,868,31,1,886,14,1700,800,401,485
31,"PRAHOVA",298,131256,,176,"CÂMPINA / ŞCOALA GENERALĂ NR.6 - (sala de clasa)",1,12357,"MUNICIPIUL CÂMPINA",131256,1618,973,919,54,0,956,17,1800,827,447,509
31,"PRAHOVA",298,131256,,177,"CÂMPINA / ŞCOALA GIMNAZIALĂ ""ALEXANDRU IOAN CUZA"" -  (sala de clasa-etaj 1)",1,12357,"MUNICIPIUL CÂMPINA",131256,1603,1192,1052,139,1,1179,13,1800,608,496,683
31,"PRAHOVA",298,131256,,178,"CÂMPINA / ŞCOALA GIMNAZIALĂ ""ALEXANDRU IOAN CUZA"" - (sala de sport)",1,12357,"MUNICIPIUL CÂMPINA",131256,1667,1185,1080,103,2,1169,16,1800,615,511,658
31,"PRAHOVA",298,131256,,179,"CÂMPINA / SC ELECTROUTILAJ SA - (cantina - sala de protocol)",1,12357,"MUNICIPIUL CÂMPINA",131256,1730,1092,1014,78,0,1081,11,1900,808,447,634
31,"PRAHOVA",298,131256,,180,"CÂMPINA / ŞCOALA GENERALĂ NR.3 - (sala de sport)",1,12357,"MUNICIPIUL CÂMPINA",131256,1718,1257,1084,77,96,1236,21,1900,643,483,753
31,"PRAHOVA",298,130954,,181,"AZUGA / LICEUL TEORETIC AZUGA",1,12359,"ORAŞ AZUGA",130954,1788,1324,1142,134,48,1305,19,1800,476,577,728
31,"PRAHOVA",298,130954,,182,"AZUGA / LICEUL TEORETIC AZUGA",1,12359,"ORAŞ AZUGA",130954,1104,857,698,155,4,840,17,1200,343,365,475
31,"PRAHOVA",298,130954,,183,"AZUGA / GRĂDINIŢA DE COPII",1,12359,"ORAŞ AZUGA",130954,1280,924,830,94,0,913,11,1400,476,390,523
31,"PRAHOVA",298,130981,,184,"BĂICOI / SALA DE SPORT TINERETULUI",1,12361,"ORAŞ BĂICOI",130981,1127,890,745,84,61,871,19,1200,310,399,472
31,"PRAHOVA",298,130981,,185,"BĂICOI / CLADIRE FOST PUNCT SANITAR TUFENI",1,12361,"ORAŞ BĂICOI",130981,1261,800,780,20,0,794,6,1400,600,388,406
31,"PRAHOVA",298,130981,,186,"BĂICOI / CLUBUL ELEVILOR",1,12361,"ORAŞ BĂICOI",130981,1501,1011,954,57,0,997,14,1600,589,488,509
31,"PRAHOVA",298,130981,,187,"BĂICOI / GR. SC. C-TIN CANTACUZINO",1,12361,"ORAŞ BĂICOI",130981,1153,765,702,63,0,749,16,1300,535,336,413
31,"PRAHOVA",298,130981,,188,"BĂICOI / GR. SC. C-TIN CANTACUZINO",1,12361,"ORAŞ BĂICOI",130981,1117,754,693,61,0,741,13,1200,446,328,413
31,"PRAHOVA",298,130981,,189,"BĂICOI / GRADINITA LILIESTI",1,12361,"ORAŞ BĂICOI",130981,1121,722,687,35,0,712,10,1200,478,322,390
31,"PRAHOVA",298,130981,,190,"BĂICOI / SCOALA NUMARUL 3 LILIESTI",1,12361,"ORAŞ BĂICOI",130981,1539,919,879,40,0,911,8,1700,781,406,505
31,"PRAHOVA",298,130981,,191,"BĂICOI / SCOALA NUMARUL 3 LILIESTI sala nr. 2",1,12361,"ORAŞ BĂICOI",130981,1596,1062,1005,55,2,1050,12,1800,738,520,530
31,"PRAHOVA",298,130981,,192,"BĂICOI / GRADINITA LILIESTI",1,12361,"ORAŞ BĂICOI",130981,1037,745,640,105,0,730,15,1100,355,383,347
31,"PRAHOVA",298,130981,,193,"BĂICOI / CASA DE CULTURA LILIESTI",1,12361,"ORAŞ BĂICOI",130981,1357,959,859,99,1,933,26,1500,541,439,494
31,"PRAHOVA",298,130981,,194,"BĂICOI / SCOALA GENERALA DAMBU",1,12361,"ORAŞ BĂICOI",130981,1146,728,711,16,1,722,6,1300,572,452,270
31,"PRAHOVA",298,130981,,195,"BĂICOI / SCOALA GENERALA TINTEA",1,12361,"ORAŞ BĂICOI",130981,1329,817,778,38,1,814,3,1500,683,458,356
31,"PRAHOVA",298,130981,,196,"BĂICOI / CASA DE CULTURA TINTEA",1,12361,"ORAŞ BĂICOI",130981,1059,762,686,76,0,749,13,1200,438,387,362
31,"PRAHOVA",298,131069,,197,"BOLDEŞTI-SCĂENI / Scoala  gimnaziala ""Mihai Viteazul"" Boldesti-Scaeni",1,12368,"ORAŞ BOLDEŞTI-SCĂENI",131069,1033,825,657,150,18,802,23,1100,275,350,452
31,"PRAHOVA",298,131069,,198,"BOLDEŞTI-SCĂENI / Scoala  gimnaziala ""Mihai Viteazul"" Boldesti-Scaeni",1,12368,"ORAŞ BOLDEŞTI-SCĂENI",131069,1248,846,787,59,0,831,15,1400,554,354,477
31,"PRAHOVA",298,131069,,199,"BOLDEŞTI-SCĂENI / Scoala  gimnaziala ""Mihai Viteazul"" Boldesti-Scaeni",1,12368,"ORAŞ BOLDEŞTI-SCĂENI",131069,1176,841,768,73,0,832,9,1300,459,350,482
31,"PRAHOVA",298,131069,,200,"BOLDEŞTI-SCĂENI / Gradinita Nord",1,12368,"ORAŞ BOLDEŞTI-SCĂENI",131069,1323,868,822,45,1,857,11,1500,632,390,467
31,"PRAHOVA",298,131069,,201,"BOLDEŞTI-SCĂENI / Scoala  gimnaziala nr.2 Boldesti-Scaeni",1,12368,"ORAŞ BOLDEŞTI-SCĂENI",131069,881,640,574,66,0,628,12,1000,360,301,327
31,"PRAHOVA",298,131069,,202,"BOLDEŞTI-SCĂENI / Casa de Cultura din           Cartierul Scaeni",1,12368,"ORAŞ BOLDEŞTI-SCĂENI",131069,927,666,599,67,0,650,16,1000,334,265,385
31,"PRAHOVA",298,131069,,203,"BOLDEŞTI-SCĂENI / Liceul Tehnologic ""Teodor Diamant"" Boldesti-Scaeni",1,12368,"ORAŞ BOLDEŞTI-SCĂENI",131069,990,654,607,47,0,639,15,1100,446,269,370
31,"PRAHOVA",298,131069,,204,"BOLDEŞTI-SCĂENI / Scoala generala nr.2 Balaca",1,12368,"ORAŞ BOLDEŞTI-SCĂENI",131069,1033,710,635,75,0,697,13,1100,390,334,363
31,"PRAHOVA",298,131069,,205,"SECIU / Scoala generala Seciu",1,12368,"ORAŞ BOLDEŞTI-SCĂENI",131069,827,589,532,57,0,571,18,900,311,248,323
31,"PRAHOVA",298,131103,,206,"PODU VADULUI / GRADINIŢA CU PROGRAM NORMAL PODU VADULUI",1,12371,"ORAŞ BREAZA",131103,1459,1044,920,123,1,1030,14,1600,556,501,529
31,"PRAHOVA",298,131103,,207,"BREAZA DE JOS / ŞCOALA GIMNAZIALĂ BREAZA DE JOS",1,12371,"ORAŞ BREAZA",131103,997,692,611,81,0,686,6,1100,408,327,359
31,"PRAHOVA",298,131103,,208,"BREAZA DE JOS / ŞCOALA GIMNAZIALĂ BREAZA DE JOS",1,12371,"ORAŞ BREAZA",131103,1070,707,633,73,1,695,12,1200,493,322,373
31,"PRAHOVA",298,131103,,209,"BREAZA DE JOS / CENTRUL CULTURAL ION MANOLESCU",1,12371,"ORAŞ BREAZA",131103,1489,1039,909,130,0,1029,10,1600,561,482,547
31,"PRAHOVA",298,131103,,210,"BREAZA DE JOS / CENTRUL CULTURAL ION MANOLESCU",1,12371,"ORAŞ BREAZA",131103,1158,959,749,171,39,948,11,1300,341,405,543
31,"PRAHOVA",298,131103,,211,"BREAZA DE SUS / LICEUL TEORETIC AUREL VLAICU",1,12371,"ORAŞ BREAZA",131103,1645,1064,958,104,2,1051,13,1800,736,507,544
31,"PRAHOVA",298,131103,,212,"BREAZA DE SUS / LICEUL TEORETIC AUREL VLAICU",1,12371,"ORAŞ BREAZA",131103,934,674,552,119,3,667,7,1000,326,319,348
31,"PRAHOVA",298,131103,,213,"BREAZA DE SUS / GRĂDINIŢA CU PROGRAM PRELUNGIT CASTELUL FERMECAT",1,12371,"ORAŞ BREAZA",131103,971,577,549,27,1,569,8,1100,523,273,296
31,"PRAHOVA",298,131103,,214,"BREAZA DE SUS / SCOALA GIMNAZIALA CONSTANTIN BRANCOVEANU",1,12371,"ORAŞ BREAZA",131103,1330,1002,883,117,2,988,14,1500,498,405,583
31,"PRAHOVA",298,131103,,215,"GURA BELIEI / GRĂDINIŢA CU PROGRAM NORMAL GURA BELIEI ""ALBINUŢA""",1,12371,"ORAŞ BREAZA",131103,1139,812,725,84,3,802,10,1300,488,365,437
31,"PRAHOVA",298,131103,,216,"NISTOREŞTI / ŞCOALA GIMNAZIALĂ NISTOREŞTI",1,12371,"ORAŞ BREAZA",131103,1139,822,730,92,0,818,4,1300,478,376,442
31,"PRAHOVA",298,131103,,217,"VALEA TÎRSEI / ŞCOALA GIMNAZIALĂ VALEA TÂRSEI",1,12371,"ORAŞ BREAZA",131103,1226,793,742,51,0,787,6,1300,507,428,359
31,"PRAHOVA",298,131210,,218,"BUŞTENI / Colegiul Ion Kalinderu",1,12382,"ORAŞ BUŞTENI",131210,985,820,559,259,2,800,20,1100,280,222,578
31,"PRAHOVA",298,131210,,219,"BUŞTENI / Scoala Gimnaziala ,,Nestor Urechia""",1,12382,"ORAŞ BUŞTENI",131210,1080,1020,654,366,0,1009,11,1200,180,345,664
31,"PRAHOVA",298,131210,,220,"BUŞTENI / Scoala Gimnaziala ,,Nestor Urechia""",1,12382,"ORAŞ BUŞTENI",131210,896,761,539,220,2,741,20,1000,239,245,496
31,"PRAHOVA",298,131210,,221,"BUŞTENI / Gradinita cu PP si PN  ,,Fram - ursul polar""",1,12382,"ORAŞ BUŞTENI",131210,678,523,423,99,1,514,9,700,177,211,303
31,"PRAHOVA",298,131210,,222,"BUŞTENI / Sediul firmă pază",1,12382,"ORAŞ BUŞTENI",131210,1366,1167,866,301,0,1137,30,1500,333,434,703
31,"PRAHOVA",298,131210,,223,"BUŞTENI / Scoala Gimnaziala ,,Regina Elisabeta""",1,12382,"ORAŞ BUŞTENI",131210,1369,1166,914,252,0,1147,19,1500,334,397,750
31,"PRAHOVA",298,131210,,224,"BUŞTENI / Scoala Gimnaziala ,,Cezar Petrescu""",1,12382,"ORAŞ BUŞTENI",131210,1325,986,782,204,0,968,18,1500,514,321,647
31,"PRAHOVA",298,131210,,225,"BUŞTENI / Scoala Gimnaziala ,,Cezar Petrescu""",1,12382,"ORAŞ BUŞTENI",131210,993,797,616,181,0,775,22,1100,303,278,497
31,"PRAHOVA",298,131336,,226,"COMARNIC / Liceul Simion Stolnicu",1,12385,"ORAŞ COMARNIC",131336,1598,1054,953,101,0,1046,8,1800,746,454,592
31,"PRAHOVA",298,131336,,227,"COMARNIC / SCOALA GIMNAZIALA COMARNIC NR.2",1,12385,"ORAŞ COMARNIC",131336,873,598,557,41,0,591,7,1000,402,187,404
31,"PRAHOVA",298,131336,,228,"COMARNIC / SCOALA GIMNAZIALA COMARNIC NR.2",1,12385,"ORAŞ COMARNIC",131336,1351,787,763,24,0,775,12,1500,713,288,487
31,"PRAHOVA",298,131336,,229,"POIANA / SCOALA GIMNAZIALA COMARNIC",1,12385,"ORAŞ COMARNIC",131336,1520,899,856,41,2,889,10,1700,801,400,489
31,"PRAHOVA",298,131336,,230,"POIANA / Gradinita cu program normal  POIANA",1,12385,"ORAŞ COMARNIC",131336,916,631,590,41,0,624,7,1000,369,238,386
31,"PRAHOVA",298,131336,,231,"PODU LUNG / Gradinita cu program normal  PODUL LUNG",1,12385,"ORAŞ COMARNIC",131336,507,369,327,42,0,365,4,602,233,206,159
31,"PRAHOVA",298,131336,,232,"GHIOŞEŞTI / GRADINITA CU PROGRAM NORMAL GHIOŞEŞTI",1,12385,"ORAŞ COMARNIC",131336,1610,1075,1012,63,0,1063,12,1800,725,470,593
31,"PRAHOVA",298,131336,,233,"COMARNIC / Scoala primara Ghioşeşti",1,12385,"ORAŞ COMARNIC",131336,1169,687,651,36,0,684,3,1300,613,259,425
31,"PRAHOVA",298,131336,,234,"POSADA / Gradinita cu program normal  Posada",1,12385,"ORAŞ COMARNIC",131336,1194,746,692,54,0,739,7,1300,554,328,411
31,"PRAHOVA",298,131407,,235,"MIZIL / Sala Sporturilor",1,12391,"ORAŞ MIZIL",131407,1513,815,777,38,0,796,19,1700,885,495,301
31,"PRAHOVA",298,131407,,236,"MIZIL / Scoala gimnaziala Sfantul Nicolae Mizil",1,12391,"ORAŞ MIZIL",131407,1318,743,711,29,3,724,19,1500,757,482,242
31,"PRAHOVA",298,131407,,237,"MIZIL / Scoala gimnaziala nr.1",1,12391,"ORAŞ MIZIL",131407,1120,625,595,27,3,616,9,1200,575,370,246
31,"PRAHOVA",298,131407,,238,"MIZIL / Liceul Tehnologic Tase Dumitrescu",1,12391,"ORAŞ MIZIL",131407,1031,653,586,67,0,649,4,1100,447,391,258
31,"PRAHOVA",298,131407,,239,"MIZIL / Primaria oras Mizil",1,12391,"ORAŞ MIZIL",131407,1058,512,487,25,0,496,16,1200,688,355,141
31,"PRAHOVA",298,131407,,240,"MIZIL / Primaria oras Mizil",1,12391,"ORAŞ MIZIL",131407,1120,722,655,67,0,712,10,1200,478,415,297
31,"PRAHOVA",298,131407,,241,"MIZIL / Primaria oras Mizil",1,12391,"ORAŞ MIZIL",131407,1134,645,608,33,4,637,8,1200,555,356,281
31,"PRAHOVA",298,131407,,242,"MIZIL / Centrul Cultural Adrian Paunescu",1,12391,"ORAŞ MIZIL",131407,1358,759,715,43,1,751,8,1500,741,475,276
31,"PRAHOVA",298,131407,,243,"MIZIL / Scoala gimnaziala Sf. Maria Mizil",1,12391,"ORAŞ MIZIL",131407,1064,578,529,49,0,563,15,1200,622,302,261
31,"PRAHOVA",298,131407,,244,"MIZIL / Scoala gimnaziala Sf. Maria Mizil",1,12391,"ORAŞ MIZIL",131407,1185,736,701,34,1,728,8,1310,574,424,304
31,"PRAHOVA",298,131407,,245,"MIZIL / Liceul teoretic Gr. Tocilescu",1,12391,"ORAŞ MIZIL",131407,1028,594,545,36,13,582,12,1100,506,349,233
31,"PRAHOVA",298,131443,,246,"PLOPENI / CASA DE CULTURĂ PLOPENI",1,12394,"ORAŞ PLOPENI",131443,1338,867,814,52,1,857,10,1500,633,426,431
31,"PRAHOVA",298,131443,,247,"PLOPENI / SALA POLIVALENTĂ PLOPENI",1,12394,"ORAŞ PLOPENI",131443,1311,851,788,61,2,832,19,1400,549,461,371
31,"PRAHOVA",298,131443,,248,"PLOPENI / SALA POLIVALENTĂ PLOPENI",1,12394,"ORAŞ PLOPENI",131443,1174,763,724,38,1,751,12,1300,537,401,350
31,"PRAHOVA",298,131443,,249,"PLOPENI / COLEGIUL TEHNIC ""GHEORGHE LAZĂR"" PLOPENI",1,12394,"ORAŞ PLOPENI",131443,1182,706,659,47,0,691,15,1300,594,313,378
31,"PRAHOVA",298,131443,,250,"PLOPENI / COLEGIUL TEHNIC  ""GHEORGHE LAZĂR"" PLOPENI",1,12394,"ORAŞ PLOPENI",131443,1544,893,850,43,0,873,20,1700,807,450,423
31,"PRAHOVA",298,131443,,251,"PLOPENI / ŞCOALA CU CLASELE I-VIII ""CAROL I"" PLOPENI",1,12394,"ORAŞ PLOPENI",131443,1426,933,864,67,2,915,18,1600,667,495,420
31,"PRAHOVA",298,131540,,252,"SINAIA / COLEGIUL ""MIHAIL CANTACUZINO"" SALA AP.1",1,12396,"ORAŞ SINAIA",131540,1250,884,781,103,0,863,21,1400,516,364,499
31,"PRAHOVA",298,131540,,253,"SINAIA / COLEGIUL ""MIHAIL CANTACUZINO"" SALA AP.2",1,12396,"ORAŞ SINAIA",131540,1126,753,684,69,0,732,21,1200,447,300,432
31,"PRAHOVA",298,131540,,254,"SINAIA / SCOALA GIMNAZIALA ""PRINCIPESA MARIA""CORP B",1,12396,"ORAŞ SINAIA",131540,794,600,507,72,21,596,4,900,300,246,350
31,"PRAHOVA",298,131540,,255,"SINAIA / SCOALA GIMNAZIALA ""PRINCIPESA MARIA""CORP A",1,12396,"ORAŞ SINAIA",131540,720,589,467,121,1,576,13,800,211,233,343
31,"PRAHOVA",298,131540,,256,"SINAIA / SCOALA GIMNAZIALA ""PRINCIPESA MARIA""CORP A",1,12396,"ORAŞ SINAIA",131540,1105,742,689,51,2,725,17,1200,458,297,428
31,"PRAHOVA",298,131540,,257,"SINAIA / IMOBIL PROPRIETATE ORAS SINAIA",1,12396,"ORAŞ SINAIA",131540,1016,717,647,68,2,694,23,900,183,325,369
31,"PRAHOVA",298,131540,,258,"SINAIA / CLUBUL SPORTIV CARPAŢI - SALA DE SPORT",1,12396,"ORAŞ SINAIA",131540,875,606,501,104,1,592,14,750,144,255,337
31,"PRAHOVA",298,131540,,259,"SINAIA / ŞCOALA GIMNAZIALA ""GEORGE ENESCU"" SALA 3 B",1,12396,"ORAŞ SINAIA",131540,713,843,423,420,0,818,25,1000,157,301,517
31,"PRAHOVA",298,131540,,260,"SINAIA / ŞCOALA GIMNAZIALA ""GEORGE ENESCU"" SALA I B",1,12396,"ORAŞ SINAIA",131540,946,1014,545,469,0,997,17,1200,186,350,647
31,"PRAHOVA",298,131540,,261,"SINAIA / CENTRUL CULTURAL ""CARMEN SYLVA""",1,12396,"ORAŞ SINAIA",131540,611,433,367,65,1,427,6,699,266,183,244
31,"PRAHOVA",298,131540,,262,"SINAIA / CENTRUL DE ACŢIUNE SI INFORMARE COMUNITARA",1,12396,"ORAŞ SINAIA",131540,646,633,395,238,0,619,14,700,67,210,409
31,"PRAHOVA",298,131540,,263,"SINAIA / CENTRUL INTERNATIONAL DE CONFERINŢE CASINO",1,12396,"ORAŞ SINAIA",131540,594,688,335,353,0,673,15,751,63,242,431
31,"PRAHOVA",298,131577,,264,"PRĂJANI / ŞCOALA PRĂJANI",1,12398,"ORAŞ SLĂNIC",131577,1094,750,693,56,1,731,19,1200,450,418,313
31,"PRAHOVA",298,131577,,265,"SLĂNIC / LICEUL TEORETIC ,,ŞERBAN VODĂ,,",1,12398,"ORAŞ SLĂNIC",131577,1275,970,724,245,1,949,21,1400,430,523,426
31,"PRAHOVA",298,131577,,266,"SLĂNIC / LICEUL TEORETIC ,,ŞERBAN VODĂ,,",1,12398,"ORAŞ SLĂNIC",131577,1362,836,699,136,1,817,19,1500,664,413,404
31,"PRAHOVA",298,131577,,267,"GROŞANI / SCOALA GROSANI",1,12398,"ORAŞ SLĂNIC",131577,1497,953,902,51,0,938,15,1700,747,590,348
31,"PRAHOVA",298,131620,,268,"URLAŢI / GRĂDINIŢA DE COPII CU PROGRAM PRELUNGIT NR.1 URLATI",1,12402,"ORAŞ URLAŢI",131620,1527,931,878,53,0,915,16,1700,769,414,501
31,"PRAHOVA",298,131620,,269,"URLAŢI / LICEUL TEORETIC ""BRÂNCOVEANU VODĂ"" URLATI (CLADIREA VECHE)",1,12402,"ORAŞ URLAŢI",131620,1618,958,864,94,0,945,13,1800,842,442,503
31,"PRAHOVA",298,131620,,270,"URLAŢI / LICEUL TEORETIC ""BRÂNCOVEANU VODĂ""  URLATI",1,12402,"ORAŞ URLAŢI",131620,1483,894,818,47,29,881,13,1600,706,460,421
31,"PRAHOVA",298,131620,,271,"URLAŢI / ŞCOALA CU CLASELE I-VIII ""CĂNUŢĂ IONESCU"" URLATI",1,12402,"ORAŞ URLAŢI",131620,1634,968,925,43,0,956,12,1800,832,459,497
31,"PRAHOVA",298,131620,,272,"URLAŢI / CASA DE CULTURĂ URLAŢI",1,12402,"ORAŞ URLAŢI",131620,1498,954,898,55,1,942,12,1600,646,457,485
31,"PRAHOVA",298,131620,,273,"URLAŢI / LICEUL TEORETIC ""BRÂNCOVEANU VODĂ"" URLAŢI - ŞCOALA JERCĂLĂI",1,12402,"ORAŞ URLAŢI",131620,784,414,388,26,0,404,10,900,486,218,186
31,"PRAHOVA",298,131620,,274,"URLAŢI / LICEUL TEORETIC ""BRÂNCOVEANU VODĂ"" URLAŢI - ŞCOALA CHERBA",1,12402,"ORAŞ URLAŢI",131620,900,524,492,32,0,513,11,1000,476,170,343
31,"PRAHOVA",298,131817,,275,"VĂLENII DE MUNTE / PRIMĂRIA VĂLENII DE MUNTE (Casa căsătoriilor)",1,12420,"ORAŞ VĂLENII DE MUNTE",131817,1083,767,668,99,0,754,13,1200,433,394,360
31,"PRAHOVA",298,131817,,276,"VĂLENII DE MUNTE / CASA DE CULTURĂ (Sala mică)",1,12420,"ORAŞ VĂLENII DE MUNTE",131817,1317,904,828,76,0,890,14,1400,496,459,431
31,"PRAHOVA",298,131817,,277,"VĂLENII DE MUNTE / CASA DE CULTURĂ (Foaier)",1,12420,"ORAŞ VĂLENII DE MUNTE",131817,1116,721,655,66,0,708,13,1200,479,357,351
31,"PRAHOVA",298,131817,,278,"VĂLENII DE MUNTE / CLUBUL COPIILOR",1,12420,"ORAŞ VĂLENII DE MUNTE",131817,922,624,552,72,0,618,6,1000,376,289,329
31,"PRAHOVA",298,131817,,279,"VĂLENII DE MUNTE / ŞCOALA GIMNAZIALĂ ""INGINER GHEORGHE PĂNCULESCU""",1,12420,"ORAŞ VĂLENII DE MUNTE",131817,1323,919,840,79,0,898,21,1500,581,413,485
31,"PRAHOVA",298,131817,,280,"VĂLENII DE MUNTE / GRĂDINIŢA CU PROGRAM NORMAL NR. 1",1,12420,"ORAŞ VĂLENII DE MUNTE",131817,1430,1016,887,67,62,998,18,1600,584,493,505
31,"PRAHOVA",298,131817,,281,"VĂLENII DE MUNTE / GRĂDINIŢA CU PROGRAM NORMAL NR. 4",1,12420,"ORAŞ VĂLENII DE MUNTE",131817,1042,770,718,50,2,757,13,1100,330,420,337
31,"PRAHOVA",298,131817,,282,"VĂLENII DE MUNTE / LICEUL TEHNOLOGIC AGROMONTAN ""ROMEO CONSTANTINESCU""",1,12420,"ORAŞ VĂLENII DE MUNTE",131817,925,673,622,51,0,663,10,1000,327,380,283
31,"PRAHOVA",298,131817,,283,"VĂLENII DE MUNTE / ŞCOALA PRIMARĂ NR.4 (MIULEŞTI)",1,12420,"ORAŞ VĂLENII DE MUNTE",131817,1165,828,732,96,0,817,11,1300,472,406,411
31,"PRAHOVA",298,131817,,284,"VĂLENII DE MUNTE / ŞCOALA PRIMARĂ NR.2 (VALEA GARDULUI)",1,12420,"ORAŞ VĂLENII DE MUNTE",131817,900,631,609,22,0,622,9,1000,369,363,259
31,"PRAHOVA",298,131899,,285,"OCINA DE SUS / CAMIN CULTURAL",3,12422,"ADUNAŢI",131899,945,686,640,46,0,677,9,1005,319,406,271
31,"PRAHOVA",298,131899,,286,"ADUNAŢI / GRADINITA CU  PROGRAM NORMAL",3,12422,"ADUNAŢI",131899,807,538,502,36,0,535,3,900,362,265,270
31,"PRAHOVA",298,131933,,287,"ALBEŞTI-PALEOLOGU / SCOALA GIMNAZIALA CLASELE I-VIII ALBESTI PALEOLOGU",3,12426,"ALBEŞTI-PALEOLOGU",131933,1497,941,827,114,0,922,19,1600,659,410,512
31,"PRAHOVA",298,131933,,288,"VADU PĂRULUI / SCOALA GIMNAZIALA CLASELE I-VIII SAT VADU PĂRULUI",3,12426,"ALBEŞTI-PALEOLOGU",131933,1611,885,809,76,0,876,9,1800,915,424,452
31,"PRAHOVA",298,131933,,289,"ALBEŞTI-MURU / SCOALA GIMNAZIALA CU CLASELE I-IV SAT ALBESTI MURU",3,12426,"ALBEŞTI-PALEOLOGU",131933,944,575,532,41,2,569,6,1000,425,301,268
31,"PRAHOVA",298,131933,,290,"CIOCENI / SCOALA GIMNAZIALA CU CLASELE I-VIII CIOCENI",3,12426,"ALBEŞTI-PALEOLOGU",131933,705,440,404,36,0,433,7,800,360,307,126
31,"PRAHOVA",298,131988,,291,"ALUNIŞ / SCOALA GIMNAZIALA GHEORGHE COSTESCU ALUNIS",3,12431,"ALUNIŞ",131988,1289,961,861,88,12,942,19,1400,439,633,309
31,"PRAHOVA",298,131988,,292,"ALUNIŞ / SCOALA GIMNAZIALA GHEORGHE COSTESCU ALUNIS",3,12431,"ALUNIŞ",131988,769,545,495,45,5,541,4,800,255,339,202
31,"PRAHOVA",298,131988,,293,"OSTROVU / SCOALA GIMNAZIALA GHEORGHE COSTESCU ALUNIS",3,12431,"ALUNIŞ",131988,790,618,552,64,2,612,6,901,283,394,218
31,"PRAHOVA",298,132011,,294,"APOSTOLACHE / Consiliul Local Apostolache",3,12434,"APOSTOLACHE",132011,891,668,562,106,0,660,8,1000,332,274,386
31,"PRAHOVA",298,132011,,295,"APOSTOLACHE / Consiliul Local Apostolache",3,12434,"APOSTOLACHE",132011,824,506,456,50,0,501,5,900,394,142,359
31,"PRAHOVA",298,132075,,296,"ARICEŞTII RAHTIVANI / Scoala Gimnaziala comuna Aricestii Rahtivani",3,12440,"ARICEŞTII RAHTIVANI",132075,1213,797,712,82,3,788,9,1300,503,366,422
31,"PRAHOVA",298,132075,,297,"ARICEŞTII RAHTIVANI / Caminul Cultural Aricestii Rahtivani",3,12440,"ARICEŞTII RAHTIVANI",132075,1082,711,671,38,2,703,8,1200,489,321,382
31,"PRAHOVA",298,132075,,298,"NEDELEA / Gradinita cu program normal Nedelea",3,12440,"ARICEŞTII RAHTIVANI",132075,777,507,474,33,0,502,5,900,393,235,267
31,"PRAHOVA",298,132075,,299,"NEDELEA / Scoala Gimnaziala sat Nedelea comuna Aricestii Rahtivani",3,12440,"ARICEŞTII RAHTIVANI",132075,1168,731,699,32,0,717,14,1300,569,336,381
31,"PRAHOVA",298,132075,,300,"STOENEŞTI / Scoala Gimnazila Stoenesti",3,12440,"ARICEŞTII RAHTIVANI",132075,1132,952,661,60,231,939,13,1300,348,621,318
31,"PRAHOVA",298,132075,,301,"TÎRGŞORU NOU / Gradinta cu program normal Tirgsoru Nou",3,12440,"ARICEŞTII RAHTIVANI",132075,888,855,538,72,245,842,13,1100,245,575,267
31,"PRAHOVA",298,132075,,302,"BUDA / Gradinita cu program normal Buda",3,12440,"ARICEŞTII RAHTIVANI",132075,400,307,242,65,0,302,5,400,93,110,192
31,"PRAHOVA",298,132137,,303,"ARICEŞTII ZELETIN / Şcoala Gimnazială Atanasie Jan Stoicescu",3,12446,"ARICEŞTII ZELETIN",132137,1017,785,646,103,36,775,10,1100,315,356,419
31,"PRAHOVA",298,132164,,304,"BABA ANA / Scoala cu cls. I-VIII Baba Ana",3,12449,"BABA ANA",132164,1584,967,912,55,0,957,10,1700,733,457,500
31,"PRAHOVA",298,132164,,305,"CONDURATU / Scoala cu cls. I-VIII Conduratu",3,12449,"BABA ANA",132164,1000,647,595,52,0,637,10,1100,453,346,291
31,"PRAHOVA",298,132164,,306,"CIREŞANU / Scoala cu  cls. I-VIII Ciresanu",3,12449,"BABA ANA",132164,686,447,419,28,0,443,4,800,353,236,207
31,"PRAHOVA",298,132164,,307,"SATU NOU / Scoala cu cls. I-IV Satu Nou",3,12449,"BABA ANA",132164,93,61,46,15,0,61,0,100,39,29,32
31,"PRAHOVA",298,132226,,308,"BALTA DOAMNEI / SCOALA GENERALA  DIN BALTA DOAMNEI",3,12455,"BALTA DOAMNEI",132226,1193,779,698,81,0,768,11,1300,521,413,355
31,"PRAHOVA",298,132226,,309,"BÎRA / SCOALA GENERALA  DIN BARA",3,12455,"BALTA DOAMNEI",132226,796,584,466,118,0,573,11,900,316,381,192
31,"PRAHOVA",298,132271,,310,"BĂLŢEŞTI / Şcoala cu clasele I-IV",3,12460,"BĂLŢEŞTI",132271,1502,889,817,72,0,872,17,1600,711,383,489
31,"PRAHOVA",298,132271,,311,"PODENII VECHI / Şcoala Podenii Vechi",3,12460,"BĂLŢEŞTI",132271,1437,946,884,62,0,932,14,1600,654,432,500
31,"PRAHOVA",298,132315,,312,"BĂNEŞTI / SCOALA GIMNAZIALA ,IOAN DUHOVNICUL,, BANESTI",3,12464,"BĂNEŞTI",132315,1431,1074,932,121,21,1063,11,1600,526,527,536
31,"PRAHOVA",298,132315,,313,"BĂNEŞTI / DISPENSAR UMAN BANESTI",3,12464,"BĂNEŞTI",132315,1355,957,856,87,14,939,18,1500,543,456,483
31,"PRAHOVA",298,132315,,314,"URLETA / SCOALA GIMNAZIALA IOAN DUHOVNICUL,, BANESTI",3,12464,"BĂNEŞTI",132315,1087,745,670,60,15,738,7,1200,455,358,380
31,"PRAHOVA",298,132315,,315,"URLETA / SCOALA GIMNAZIALA IOAN DUHOVNICUL,, BANEST",3,12464,"BĂNEŞTI",132315,988,687,595,66,26,682,5,1100,413,392,290
31,"PRAHOVA",298,130552,,316,"BĂRCĂNEŞTI / Scoala Gimnazială Gheorghe Lazăr Barcanesti",3,12467,"BĂRCĂNEŞTI",130552,1277,697,627,70,0,682,15,1400,703,370,312
31,"PRAHOVA",298,130552,,317,"BĂRCĂNEŞTI / Scoala Gimnazială Gheorghe Lazăr Bărcxăneşti",3,12467,"BĂRCĂNEŞTI",130552,1405,746,696,50,0,734,12,1500,754,369,365
31,"PRAHOVA",298,130552,,318,"GHIGHIU / Sediul fostei  scoli cu cls.I-IV Ghighiu",3,12467,"BĂRCĂNEŞTI",130552,631,379,348,31,0,374,5,700,321,174,200
31,"PRAHOVA",298,130552,,319,"PUŞCAŞI / Sediul fostei  scoli cu cls.I-IV Puscasi",3,12467,"BĂRCĂNEŞTI",130552,339,229,202,27,0,226,3,400,171,87,139
31,"PRAHOVA",298,130552,,320,"ROMÂNEŞTI / Scoala Gimnazială  Româneşti",3,12467,"BĂRCĂNEŞTI",130552,1615,849,779,70,0,833,16,1800,951,429,404
31,"PRAHOVA",298,130552,,321,"TĂTĂRANI / Scoala Gimnazială  Tătărani",3,12467,"BĂRCĂNEŞTI",130552,1259,783,720,63,0,777,6,1400,617,352,425
31,"PRAHOVA",298,130552,,322,"TĂTĂRANI / Scoala Gimnazială  Tătărani",3,12467,"BĂRCĂNEŞTI",130552,1320,837,769,68,0,829,8,1400,563,340,489
31,"PRAHOVA",298,136278,,323,"BĂTRÂNI / SCOALA GIMNAZIALA, COMUNA BATRANI",3,12473,"BĂTRÂNI",136278,919,649,600,49,0,639,10,1000,351,356,283
31,"PRAHOVA",298,136278,,324,"POIANA MARE / GRADINITA DE COPII",3,12473,"BĂTRÂNI",136278,793,506,478,28,0,497,9,900,394,240,257
31,"PRAHOVA",298,130614,,325,"BERCENI / SCOALA GIMNAZIALA BERCENI,SALA DE SPORT PARTER",3,12476,"BERCENI",130614,1299,785,707,77,1,768,17,1400,615,433,335
31,"PRAHOVA",298,130614,,326,"BERCENI / GRADINITA CU PROGRAM NORMAL-SALA MICA PARTER,COM.BERCENI,SAT BERCENI,STR.GRADINITEI NR. 358 A",3,12476,"BERCENI",130614,760,437,408,27,2,432,5,800,363,254,178
31,"PRAHOVA",298,130614,,327,"CORLĂTEŞTI / SCOALA CU CLASELE I-VIII-SALA DE SPORT PARTER,COM.BERCENI,SAT CORLATESTI,STR.SCOLII,NR.139 A",3,12476,"BERCENI",130614,1182,784,720,64,0,770,14,1300,516,402,368
31,"PRAHOVA",298,130614,,328,"CARTIERUL DÎMBU / CAMINUL CULTURAL -SALA MARE PARTER,COM.BERCENI,SAT DIMBU,STR.PLOPULUI,NR.73 A,",3,12476,"BERCENI",130614,390,301,266,35,0,293,8,500,199,171,122
31,"PRAHOVA",298,130614,,329,"CĂTUNU / GRADINITA CU PROGRAM NORMAL,SALA MICA PARTER,COM.BERCENI,SAT CATUNU.STR.DEMOCRATIEI,NR.148 A",3,12476,"BERCENI",130614,552,378,342,36,0,371,7,600,222,265,106
31,"PRAHOVA",298,130614,,330,"MOARA NOUĂ / GRADINITA CU PROGRAM NORMAL-SALA MARE PARTER,COM.BERCENI,SAT MOARA NOUA,STR.SCOLII,NR.106 C",3,12476,"BERCENI",130614,827,550,450,43,57,537,13,900,350,390,147
31,"PRAHOVA",298,132342,,331,"BERTEA / GRADINITA DE COPII NR.1",3,12482,"BERTEA",132342,1427,853,816,37,0,838,15,1600,747,401,437
31,"PRAHOVA",298,132342,,332,"BERTEA / GRADINITA DE COPII NR.2",3,12482,"BERTEA",132342,1192,717,682,35,0,711,6,1300,583,399,312
31,"PRAHOVA",298,130678,,333,"BLEJOI / Scoala Generala ,,Radu Tudoran'' Blejoi",3,12485,"BLEJOI",130678,1629,1086,998,77,11,1064,22,1800,714,493,571
31,"PRAHOVA",298,130678,,334,"BLEJOI / Gradinita cu Program Normal Blejoi",3,12485,"BLEJOI",130678,1529,1148,999,141,8,1138,10,1700,552,603,535
31,"PRAHOVA",298,130678,,335,"PLOIEŞTIORI / Gradinita cu Program Normal Ploiestiori",3,12485,"BLEJOI",130678,1109,794,739,55,0,786,8,1200,406,392,394
31,"PRAHOVA",298,130678,,336,"PLOIEŞTIORI / Caminul Cultural ,,Geo Bogza'' Ploiestiori",3,12485,"BLEJOI",130678,1550,1064,958,105,1,1054,10,1700,636,415,639
31,"PRAHOVA",298,130678,,337,"ŢÎNŢĂRENI / Gradinita cu Program Normal Tintareni",3,12485,"BLEJOI",130678,1388,954,883,67,4,938,16,1500,546,409,529
31,"PRAHOVA",298,132379,,338,"BOLDEŞTI / camin cultural Boldesti",3,12489,"BOLDEŞTI-GRADIŞTEA",132379,711,484,425,59,0,476,8,800,316,225,251
31,"PRAHOVA",298,132379,,339,"GRADIŞTEA / Scoala generala cu cl. I-IV Gradistea",3,12489,"BOLDEŞTI-GRADIŞTEA",132379,765,503,451,51,1,495,8,800,297,220,275
31,"PRAHOVA",298,130712,,340,"BĂTEŞTI / Sala de sport a Scolii gimnaziale ""Dumitru Hera"" Batesti",3,12492,"BRAZI",130712,1406,854,774,80,0,842,12,1500,646,330,512
31,"PRAHOVA",298,130712,,341,"BRAZII DE JOS / Sala de festivitati a Primariei comunei Brazi",3,12492,"BRAZI",130712,637,410,370,39,1,403,7,700,290,161,242
31,"PRAHOVA",298,130712,,342,"BRAZII DE SUS / Scoala Gimnaziala Brazi",3,12492,"BRAZI",130712,1006,682,632,49,1,676,6,1100,418,281,395
31,"PRAHOVA",298,130712,,343,"POPEŞTI / Punctul de lucru al Primariei Brazi din satul Popesti",3,12492,"BRAZI",130712,1445,976,921,54,1,970,6,1600,624,429,541
31,"PRAHOVA",298,130712,,344,"NEGOIEŞTI / Sala de Sport a Scolii gimnaziale ""Profesor Oprea Mihai"" sat Negoiesti",3,12492,"BRAZI",130712,1569,1005,937,68,0,987,18,1700,695,455,532
31,"PRAHOVA",298,130712,,345,"BRAZII DE SUS / Fostul sediu al Gradinitei de copii din Colonia Brazi",3,12492,"BRAZI",130712,321,236,196,40,0,227,9,393,157,98,129
31,"PRAHOVA",298,130712,,346,"STEJARU / Fostul sediu al Scolii gimnaziale din satul Stejaru",3,12492,"BRAZI",130712,492,255,233,22,0,249,6,600,345,103,146
31,"PRAHOVA",298,132404,,347,"BREBU MÎNĂSTIREI / SCOALA VECHE DIN SATUL  BREBU MINASTIRII - SATUL BREBU MEGIESESC",3,12499,"BREBU",132404,891,729,603,126,0,714,15,1000,271,276,438
31,"PRAHOVA",298,132404,,348,"BREBU MÎNĂSTIREI / SCOALA NOUA DIN SATUL  BREBU MINASTIRII - SATUL BREBU  MINASTIRII",3,12499,"BREBU",132404,1504,974,888,86,0,965,9,1700,726,371,594
31,"PRAHOVA",298,132404,,349,"BREBU MEGIEŞESC / SCOALA NR.2 DIN SATUL  BREBU MEGIESESC (LACUL SEC)  SATUL BREBU MINASTIRII, SATUL BREBU MEGIESESC",3,12499,"BREBU",132404,1496,1049,969,80,0,1037,12,1600,551,462,575
31,"PRAHOVA",298,132404,,350,"BREBU MEGIEŞESC / SCOALA DIN SATUL BREBU MEGIESESC (SILISTE) SATUL BREBU  MEGIESESC",3,12499,"BREBU",132404,1228,854,793,61,0,845,9,1300,446,317,528
31,"PRAHOVA",298,132404,,351,"PIETRICEAUA /  SCOALA DIN SATUL PIETRICEAUA",3,12499,"BREBU",132404,970,636,598,38,0,634,2,1100,464,232,402
31,"PRAHOVA",298,130785,,352,"BUCOV / CAMIN CULTURAL BUCOV",3,12504,"BUCOV",130785,1317,804,734,70,0,797,7,1400,596,344,453
31,"PRAHOVA",298,130785,,353,"BUCOV / CAMIN CULTURAL BUCOV",3,12504,"BUCOV",130785,1527,1014,966,48,0,1003,11,1700,686,378,625
31,"PRAHOVA",298,130785,,354,"BUCOV / CAMIN CULTURAL BUCOV",3,12504,"BUCOV",130785,1231,794,719,75,0,783,11,1400,606,323,460
31,"PRAHOVA",298,130785,,355,"CHIŢORANI / CAMIN CULTURAL CHITORANI",3,12504,"BUCOV",130785,1275,877,785,92,0,865,12,1400,523,344,521
31,"PRAHOVA",298,130785,,356,"PLEAŞA / CAMIN CULTURAL PLEASA",3,12504,"BUCOV",130785,1159,790,742,48,0,778,12,1300,510,315,463
31,"PRAHOVA",298,130785,,357,"PLEAŞA / CAMIN CULTURAL PLEASA",3,12504,"BUCOV",130785,1405,940,877,63,0,920,20,1500,560,365,555
31,"PRAHOVA",298,130785,,358,"PLEAŞA / CLUB PLEASA",3,12504,"BUCOV",130785,1076,640,575,65,0,631,9,1200,560,253,378
31,"PRAHOVA",298,132459,,359,"CĂLUGĂRENI / CAMINUL CULTURAL SALA MICA",3,12510,"CĂLUGĂRENI",132459,979,662,592,70,0,649,13,1105,443,397,252
31,"PRAHOVA",298,132486,,360,"CĂRBUNEŞTI / ŞCOALA CU CLASELE I - VIII CĂRBUNEŞTI",3,12513,"CĂRBUNEŞTI",132486,1444,743,683,60,0,735,8,1600,857,420,315
31,"PRAHOVA",298,132510,,361,"CEPTURA DE JOS / Scoala cu clasele I-VIII ""Nichita Stanescu"" Ceptura",3,12516,"CEPTURA",132510,957,599,540,59,0,589,10,1000,401,319,270
31,"PRAHOVA",298,132510,,362,"CEPTURA DE JOS / Scoala cu clasele  I-VIII ""Nichita Stanescu"" Ceptura",3,12516,"CEPTURA",132510,961,583,521,62,0,570,13,1100,517,281,289
31,"PRAHOVA",298,132510,,363,"CEPTURA DE SUS / Sediul Serviciului Public de Gospodarie Comunala Ceptura",3,12516,"CEPTURA",132510,513,312,270,41,1,308,4,600,288,197,111
31,"PRAHOVA",298,132510,,364,"ŞOIMEŞTI / Gradinita de Copii Soimesti",3,12516,"CEPTURA",132510,658,402,370,32,0,392,10,700,298,181,211
31,"PRAHOVA",298,132510,,365,"ROTARI / Scoala cu clasele I - VIII Rotari",3,12516,"CEPTURA",132510,655,347,317,30,0,346,1,700,353,207,139
31,"PRAHOVA",298,132510,,366,"MALU ROŞU / Scoala cu clasele  I - IV",3,12516,"CEPTURA",132510,150,97,74,23,0,96,1,200,103,59,37
31,"PRAHOVA",298,132574,,367,"CERAŞU / LICEUL TEHNOLOGIC CERASU",3,12522,"CERAŞU",132574,1280,924,820,63,41,909,15,1400,476,533,376
31,"PRAHOVA",298,132574,,368,"VALEA BORULUI / SCOALA GIMNAZIALA VALEA BORULUI",3,12522,"CERAŞU",132574,737,559,436,78,45,551,8,800,241,343,208
31,"PRAHOVA",298,132574,,369,"SLON / SCOALA GIMNAZIALASLON",3,12522,"CERAŞU",132574,812,574,520,32,22,568,6,900,326,342,226
31,"PRAHOVA",298,132574,,370,"SLON / SCOALA GIMNAZIALASLON",3,12522,"CERAŞU",132574,922,679,623,27,29,675,4,1000,321,516,159
31,"PRAHOVA",298,132645,,371,"CHIOJDEANCA / GRADINITA CHIOJDEANCA",3,12529,"CHIOJDEANCA",132645,815,625,525,73,27,615,10,900,275,337,278
31,"PRAHOVA",298,132645,,372,"TRENU / SCOALA TRENU",3,12529,"CHIOJDEANCA",132645,458,401,330,57,14,392,9,500,99,257,135
31,"PRAHOVA",298,132681,,373,"CIORANII DE JOS / LICEUL CIORANI",3,12533,"CIORANI",132681,966,670,608,56,6,659,11,1100,430,455,204
31,"PRAHOVA",298,132681,,374,"CIORANII DE JOS / LICEUL CIORANI",3,12533,"CIORANI",132681,1550,1053,932,115,6,1038,15,1700,647,673,365
31,"PRAHOVA",298,132681,,375,"CIORANII DE JOS / SCOALA CU CLASELE I-IV",3,12533,"CIORANI",132681,1008,774,718,51,5,772,2,1100,326,670,102
31,"PRAHOVA",298,132681,,376,"CIORANII DE SUS / SCOALA GENERALA CIORANII DE SUS",3,12533,"CIORANI",132681,914,725,661,59,5,714,11,1000,275,508,206
31,"PRAHOVA",298,132681,,377,"CIORANII DE SUS / PRIMARIA",3,12533,"CIORANI",132681,1002,784,740,39,5,777,7,1100,316,653,124
31,"PRAHOVA",298,136241,,378,"COCORĂŞTII COLŢ / CASA DE CULTURA RURALA",3,12536,"COCORASTII COLT",136241,1445,913,826,86,1,899,14,1600,687,350,549
31,"PRAHOVA",298,136241,,379,"COCORĂŞTII GRIND / SCOALA PRIMARA COCORASTII GRIND",3,12536,"COCORASTII COLT",136241,962,653,595,58,0,643,10,1000,347,214,429
31,"PRAHOVA",298,132716,,380,"COCORĂŞTII MISLII / CĂMIN CULTURAL",3,12545,"COCORĂŞTII MISLII",132716,1617,1111,1062,48,1,1096,15,1800,689,487,609
31,"PRAHOVA",298,132716,,381,"GORUNA / CĂMIN CULTURAL",3,12545,"COCORĂŞTII MISLII",132716,1326,910,836,71,3,896,14,1400,490,406,490
31,"PRAHOVA",298,132752,,382,"COLCEAG / Scoala gimnaziala, Comuna Colceag PJ",3,12549,"COLCEAG",132752,1156,674,605,69,0,666,8,1300,626,367,299
31,"PRAHOVA",298,132752,,383,"VÎLCELELE / Scoala Primara Vilcelele - Colceag - Structura",3,12549,"COLCEAG",132752,433,240,201,39,0,236,4,500,260,152,84
31,"PRAHOVA",298,132752,,384,"INOTEŞTI / Scoala Gimnaziala Inotesti-Colceag-Structura",3,12549,"COLCEAG",132752,1555,1031,925,106,0,1025,6,1700,669,600,425
31,"PRAHOVA",298,132752,,385,"PAREPA-RUŞANI / Scoala Gimnaziala Parepa-Rusani-Colceag-Structura",3,12549,"COLCEAG",132752,850,516,451,65,0,509,7,900,384,293,216
31,"PRAHOVA",298,132805,,386,"CORNU DE JOS / Grădiniţa cu program normal",3,12554,"CORNU",132805,1415,1084,916,153,15,1040,44,1600,516,690,350
31,"PRAHOVA",298,132805,,387,"CORNU DE JOS / Şcoala Gimnazială ""Profesor Cristea Stănescu""",3,12554,"CORNU",132805,1420,1249,938,282,29,1231,18,1600,351,844,387
31,"PRAHOVA",298,132805,,388,"CORNU DE SUS / Grădiniţa cu Program normal",3,12554,"CORNU",132805,867,723,632,70,21,718,5,900,177,522,196
31,"PRAHOVA",298,132841,,389,"COSMINA DE JOS / Grădiniţa de copii cu program normal",3,12558,"COSMINELE",132841,893,660,577,83,0,647,13,1000,340,287,360
31,"PRAHOVA",298,132896,,390,"DRAJNA DE JOS / SCOALA GIMNAZIALA ""PLATON MOCANU""",3,12571,"DRAJNA",132896,1472,1079,939,96,44,1063,16,1600,521,625,438
31,"PRAHOVA",298,132896,,391,"DRAJNA DE JOS / GRADINITA PLAISANI",3,12571,"DRAJNA",132896,725,510,482,28,0,507,3,800,290,280,227
31,"PRAHOVA",298,132896,,392,"DRAJNA DE SUS / SCOALA GIMNAZIALA DRAJNA DE SUS",3,12571,"DRAJNA",132896,1272,860,748,112,0,856,4,1400,540,369,487
31,"PRAHOVA",298,132896,,393,"OGRETIN / SCOALA GIMNAZIALA OGRETIN",3,12571,"DRAJNA",132896,1082,642,582,60,0,639,3,1200,558,213,426
31,"PRAHOVA",298,133018,,394,"DRĂGĂNEŞTI / Scoala",3,12563,"DRĂGĂNEŞTI",133018,1012,527,457,70,0,520,7,1100,573,262,258
31,"PRAHOVA",298,133018,,395,"BĂRĂITARU / Scoala",3,12563,"DRĂGĂNEŞTI",133018,701,457,402,55,0,452,5,800,343,239,213
31,"PRAHOVA",298,133018,,396,"BELCIUG / Scoala",3,12563,"DRĂGĂNEŞTI",133018,445,292,252,40,0,291,1,500,208,143,148
31,"PRAHOVA",298,133018,,397,"CORNU DE JOS / Scoala",3,12563,"DRĂGĂNEŞTI",133018,512,328,293,35,0,323,5,600,272,133,190
31,"PRAHOVA",298,133018,,398,"MERI / Scoala",3,12563,"DRĂGĂNEŞTI",133018,859,480,432,48,0,476,4,900,420,225,251
31,"PRAHOVA",298,133018,,399,"HĂTCĂRĂU / DUMBRAVA SOCIETATE COOPERATIVA DE CONSUM",3,12563,"DRĂGĂNEŞTI",133018,384,233,199,34,0,227,6,400,167,119,108
31,"PRAHOVA",298,133090,,400,"DUMBRAVA / Cămin Cultural",3,12583,"DUMBRAVA",133090,1347,863,784,79,0,846,17,1500,637,421,425
31,"PRAHOVA",298,133090,,401,"ZĂNOAGA / Cămin Cultural",3,12583,"DUMBRAVA",133090,797,535,488,47,0,523,12,900,365,231,292
31,"PRAHOVA",298,133090,,402,"CIUPELNIŢA / Cămin Cultural",3,12583,"DUMBRAVA",133090,1357,820,734,86,0,804,16,1400,580,457,347
31,"PRAHOVA",298,131461,,403,"DUMBRĂVEŞTI / Cămin Cultural",3,12590,"DUMBRĂVEŞTI",131461,1207,826,756,70,0,806,20,1300,474,429,377
31,"PRAHOVA",298,131461,,404,"PLOPENI / Sala de Utilitate Publică",3,12590,"DUMBRĂVEŞTI",131461,1330,861,798,63,0,826,35,1500,639,457,369
31,"PRAHOVA",298,131461,,405,"SFÎRLEANCA / Fosta Şcoală sat Sfârleanca",3,12590,"DUMBRĂVEŞTI",131461,498,367,335,32,0,361,6,500,133,216,145
31,"PRAHOVA",298,133278,,406,"FÂNTÂNELE / CAMINUL CULTURAL",3,12597,"FÂNTÂNELE",133278,854,569,505,57,7,564,5,900,331,284,280
31,"PRAHOVA",298,133278,,407,"FÂNTÂNELE / CAMINUL CULTURAL",3,12597,"FÂNTÂNELE",133278,850,553,491,54,8,548,5,900,347,316,232
31,"PRAHOVA",298,133161,,408,"FILIPEŞTII DE PĂDURE / Clubul ""Minerul""",3,12600,"FILIPEŞTII DE PĂDURE",133161,1015,618,578,40,0,611,7,1100,482,290,321
31,"PRAHOVA",298,133161,,409,"FILIPEŞTII DE PĂDURE / Scoala Veche",3,12600,"FILIPEŞTII DE PĂDURE",133161,1654,1044,979,64,1,1028,16,1800,756,552,476
31,"PRAHOVA",298,133161,,410,"FILIPEŞTII DE PĂDURE / Liceul Teoretic",3,12600,"FILIPEŞTII DE PĂDURE",133161,1543,991,900,91,0,974,17,1700,709,489,485
31,"PRAHOVA",298,133161,,411,"DIŢEŞTI / Scoala Gimnaziala ""Ioan Moga""",3,12600,"FILIPEŞTII DE PĂDURE",133161,1149,718,665,53,0,709,9,1300,582,356,353
31,"PRAHOVA",298,133161,,412,"DIŢEŞTI / Gradinita nr.1",3,12600,"FILIPEŞTII DE PĂDURE",133161,1029,641,604,37,0,631,10,1100,459,322,309
31,"PRAHOVA",298,133161,,413,"DIŢEŞTI / Gradinita nr. 2",3,12600,"FILIPEŞTII DE PĂDURE",133161,957,565,527,38,0,556,9,1000,435,292,264
31,"PRAHOVA",298,133161,,414,"MINIERI / liceul Tehnologic",3,12600,"FILIPEŞTII DE PĂDURE",133161,1152,640,615,25,0,632,8,1300,660,373,259
31,"PRAHOVA",298,133214,,415,"FILIPEŞTII DE TÎRG / CAMIN FILIPESTII DE TIRG(sala sedinta videoclub)",3,12605,"FILIPEŞTII DE TÎRG",133214,1047,676,623,52,1,668,8,1100,424,341,327
31,"PRAHOVA",298,133214,,416,"FILIPEŞTII DE TÎRG / SCOALA FILIPESTII DE TIRG",3,12605,"FILIPEŞTII DE TÎRG",133214,1150,756,703,53,0,735,21,1300,544,404,331
31,"PRAHOVA",298,133214,,417,"BRĂTĂŞANCA / SCOALA GENERALA BRATASANCA",3,12605,"FILIPEŞTII DE TÎRG",133214,1649,1213,1102,111,0,1195,18,1800,587,611,584
31,"PRAHOVA",298,133214,,418,"MĂRGINENII DE JOS / SCOALA GENERALA MARGINENII DE JOS(Scoala Noua)",3,12605,"FILIPEŞTII DE TÎRG",133214,1513,869,835,34,0,862,7,1700,831,561,301
31,"PRAHOVA",298,133214,,419,"MĂRGINENII DE JOS / SCOALA GENERALA MARGINENII DE JOS(Scoala Veche)",3,12605,"FILIPEŞTII DE TÎRG",133214,1241,563,533,30,0,554,9,1400,837,490,64
31,"PRAHOVA",298,133330,,420,"FLOREŞTI / GRADINITA DE COPII FLORESTI",3,12611,"FLOREŞTI",133330,1259,799,711,88,0,787,12,1420,621,481,306
31,"PRAHOVA",298,133330,,421,"FLOREŞTI / SCOALA CU CLASELE I - VIII FLORESTI (LOCALUL NOU)",3,12611,"FLOREŞTI",133330,1585,928,868,58,2,916,12,1700,772,534,382
31,"PRAHOVA",298,133330,,422,"FLOREŞTI / SCOALA CU CLASELE I-VIII FLORESTI (LOCALUL VECHI)",3,12611,"FLOREŞTI",133330,1481,934,870,64,0,879,55,1600,666,475,404
31,"PRAHOVA",298,133330,,423,"CĂTINA / SCOALA CU CLASELE I-VIII  CATINA",3,12611,"FLOREŞTI",133330,956,551,489,26,36,546,5,1100,549,339,207
31,"PRAHOVA",298,133330,,424,"CĂTINA / CAMINUL CULTURAL CALINESTI",3,12611,"FLOREŞTI",133330,1100,719,665,54,0,708,11,1197,478,445,263
31,"PRAHOVA",298,133394,,425,"FULGA DE JOS / CAMINUL CULTURAL FULGA DE JOS",3,12617,"FULGA",133394,1270,720,646,74,0,711,9,1400,680,546,165
31,"PRAHOVA",298,133394,,426,"FULGA DE SUS / SCOALA GIMNAZIALA ""LAURENTIU FULGA""",3,12617,"FULGA",133394,1502,794,717,77,0,791,3,1600,806,544,247
31,"PRAHOVA",298,133429,,427,"GHERGHIŢA / Scoala cu cls I - VIII Gherghita",3,12620,"GHERGHIŢA",133429,992,731,624,74,33,723,8,1100,369,498,225
31,"PRAHOVA",298,133429,,428,"MALAMUC / Gradinita cu program normal Malamuc",3,12620,"GHERGHIŢA",133429,337,265,226,35,4,262,3,400,135,161,101
31,"PRAHOVA",298,133429,,429,"INDEPENDENŢA / Scoala cu cls I - IV Independenta",3,12620,"GHERGHIŢA",133429,183,136,105,29,2,134,2,200,64,80,54
31,"PRAHOVA",298,133508,,430,"GORGOTA / Scoala cu clasele I-IV - GORGOTA",3,12625,"GORGOTA",133508,1259,812,753,57,2,795,17,1400,588,266,529
31,"PRAHOVA",298,133508,,431,"POTIGRAFU / Scoala gimnaziala, sat Potigrafu, comuna Gorgota",3,12625,"GORGOTA",133508,1077,740,660,80,0,725,15,1200,460,232,493
31,"PRAHOVA",298,133508,,432,"POIENARII APOSTOLI / Scoala cu slasele I-VIII - Poienarii Apostoli",3,12625,"GORGOTA",133508,1170,772,702,63,7,768,4,1300,528,363,405
31,"PRAHOVA",298,133508,,433,"CRIVINA / Scoala cu clasele I-IV - CRIVINA",3,12625,"GORGOTA",133508,836,518,470,48,0,515,3,900,382,247,268
31,"PRAHOVA",298,133562,,434,"GORNET / SCOALA GIMNAZIALA GORNET",3,12631,"GORNET",133562,980,722,666,56,0,717,5,1100,378,367,350
31,"PRAHOVA",298,133562,,435,"GORNET / CAMINUL CULTURAL GORNET",3,12631,"GORNET",133562,1007,749,689,60,0,737,12,1100,351,382,355
31,"PRAHOVA",298,133562,,436,"CUIB / SCOALA PRIMARA CUIB",3,12631,"GORNET",133562,289,184,169,15,0,181,3,300,116,127,54
31,"PRAHOVA",298,133562,,437,"NUCET / SCOALA PRIMARA NUCET",3,12631,"GORNET",133562,159,104,84,20,0,102,2,200,96,67,35
31,"PRAHOVA",298,133615,,438,"GORNET-CRICOV / CAMIN CULTURAL GORNET",3,12636,"GORNET-CRICOV",133615,824,546,447,99,0,538,8,900,354,293,245
31,"PRAHOVA",298,133615,,439,"COŞERELE / GRADINITA COSERELE",3,12636,"GORNET-CRICOV",133615,688,447,393,54,0,441,6,700,253,186,255
31,"PRAHOVA",298,133615,,440,"DOBROTA / GRADINITA DOBROTA",3,12636,"GORNET-CRICOV",133615,406,237,217,20,0,231,6,500,263,106,125
31,"PRAHOVA",298,133688,,441,"GURA VADULUI / CAMINUL CULTURAL, NR. 212",3,12643,"GURA VADULUI",133688,1191,731,670,60,1,721,10,1300,569,395,326
31,"PRAHOVA",298,133688,,442,"PERŞUNARI / GRADINITA DE COPIII PERSUNARI,NR.372",3,12643,"GURA VADULUI",133688,690,439,376,56,7,438,1,800,361,273,165
31,"PRAHOVA",298,131835,,443,"GURA VITIOAREI / SCOALA GIMNAZIALA GURA VITIOAREI",3,12647,"GURA VITIOAREI",131835,1705,1032,957,75,0,1020,12,1900,868,599,421
31,"PRAHOVA",298,131835,,444,"FĂGETU / SCOALA PRIMARA FAGETU",3,12647,"GURA VITIOAREI",131835,985,621,572,43,6,613,8,1100,479,387,226
31,"PRAHOVA",298,131835,,445,"POIANA COPĂCENI / SCOALA GIMNAZIALA POIANA COPACENI",3,12647,"GURA VITIOAREI",131835,843,552,515,37,0,541,11,900,348,280,261
31,"PRAHOVA",298,131835,,446,"BUGHEA DE JOS / SCOALA GIMNAZIALA BUGHEA DE JOS",3,12647,"GURA VITIOAREI",131835,860,508,465,43,0,498,10,900,392,272,226
31,"PRAHOVA",298,131835,,447,"FUNDENI / GRADINITA CU PROGRAM NORMAL FUNDENI",3,12647,"GURA VITIOAREI",131835,548,356,323,33,0,353,3,600,244,169,184
31,"PRAHOVA",298,133722,,448,"IORDĂCHEANU / GRADINITA IORDACHEANU",3,12653,"IORDĂCHEANU",133722,1005,658,601,57,0,651,7,1100,442,280,371
31,"PRAHOVA",298,133722,,449,"MOCEŞTI / SCOALA MOCESTI",3,12653,"IORDĂCHEANU",133722,978,599,547,52,0,583,16,1100,501,296,287
31,"PRAHOVA",298,133722,,450,"VALEA CUCULUI / CLADIRE NOUA - FOST SEDIU C.A.P.",3,12653,"IORDĂCHEANU",133722,1066,677,617,58,2,669,8,1100,423,392,277
31,"PRAHOVA",298,133722,,451,"VĂRBILA / SCOALA VARBILA",3,12653,"IORDĂCHEANU",133722,1162,737,675,62,0,729,8,1300,563,420,309
31,"PRAHOVA",298,133795,,452,"IZVOARELE / Scoala gimnaziala Traiana Savulescu Izvoarele",3,12660,"IZVOARELE",133795,1087,702,665,37,0,696,6,1200,498,334,362
31,"PRAHOVA",298,133795,,453,"IZVOARELE / Scoala gimnaziala Traiana Savulescu Izvoarele",3,12660,"IZVOARELE",133795,935,634,589,45,0,631,3,1000,366,301,330
31,"PRAHOVA",298,133795,,454,"HOMORÎCIU / Scoala gimnaziala Homoriciu",3,12660,"IZVOARELE",133795,965,661,620,41,0,658,3,1100,439,364,294
31,"PRAHOVA",298,133795,,455,"HOMORÎCIU / Scoala gimnaziala Homoriciu",3,12660,"IZVOARELE",133795,818,522,470,52,0,514,8,900,378,270,244
31,"PRAHOVA",298,133795,,456,"SCHIULEŞTI / Scoala primara Schiulesti",3,12660,"IZVOARELE",133795,1023,665,616,49,0,663,2,1100,435,399,264
31,"PRAHOVA",298,133795,,457,"MALU VÎNĂT / Scoala gimnaziala Malu-Vinat",3,12660,"IZVOARELE",133795,709,468,431,37,0,462,6,800,332,236,226
31,"PRAHOVA",298,133866,,458,"JUGURENI / Şcoala gimnazială cu clasele I-VIII",3,12667,"JUGURENI",133866,465,436,292,83,61,435,1,498,62,340,95
31,"PRAHOVA",298,133919,,459,"LAPOŞ / CĂMINUL CULTURAL",3,12672,"LAPOŞ",133919,986,658,568,90,0,657,1,1100,442,498,159
31,"PRAHOVA",298,133964,,460,"LIPĂNEŞTI /  BAZA SPORTIVA",3,12677,"LIPĂNEŞTI",133964,644,431,369,62,0,428,3,699,268,186,242
31,"PRAHOVA",298,133964,,461,"ŞIPOTU / SCOALA GIMNAZIALA ""EROILOR"" LIPANESTI",3,12677,"LIPĂNEŞTI",133964,860,590,531,59,0,584,6,900,310,262,322
31,"PRAHOVA",298,133964,,462,"ŞIPOTU / SCOALA GIMNAZIALA ""EROILOR"" LIPANESTI",3,12677,"LIPĂNEŞTI",133964,998,605,568,37,0,597,8,1100,495,232,365
31,"PRAHOVA",298,133964,,463,"ZAMFIRA / SCOALA GIMNAZIALA ""SPIREA SORESCU""ZAMFIRA",3,12677,"LIPĂNEŞTI",133964,946,619,566,53,0,603,16,1000,381,278,325
31,"PRAHOVA",298,133964,,464,"LIPĂNEŞTI / BAZA SPORTIVA 1",3,12677,"LIPĂNEŞTI",133964,762,505,459,46,0,491,14,800,295,227,264
31,"PRAHOVA",298,134014,,465,"MĂGURELE / GRADINITA VECHE ,SAT MAGURELE",3,12682,"MĂGURELE",134014,1286,796,732,64,0,784,12,1400,604,324,460
31,"PRAHOVA",298,134014,,466,"MĂGURELE / GRADINITA VECHE ,SAT MAGURELE",3,12682,"MĂGURELE",134014,1473,896,813,83,0,888,8,1600,704,409,479
31,"PRAHOVA",298,134014,,467,"COADA MALULUI / GRADINITA DE COPII SAT COADA MALULUI",3,12682,"MĂGURELE",134014,679,452,412,40,0,449,3,700,248,206,243
31,"PRAHOVA",298,134014,,468,"IAZU / GRADINITA DE COPII SAT IAZU",3,12682,"MĂGURELE",134014,516,334,285,49,0,329,5,600,266,115,214
31,"PRAHOVA",298,134050,,469,"MĂGURENI / SCOALA CU CLS.I-IV MAGURENI, CORP B",3,12686,"MĂGURENI",134050,1403,918,857,61,0,909,9,1500,582,501,408
31,"PRAHOVA",298,134050,,470,"MĂGURENI / SCOALA CU CLS.I-IV NR.2 MAGURENI(SATUL BANULUI",3,12686,"MĂGURENI",134050,1003,606,580,26,0,598,8,1100,494,346,252
31,"PRAHOVA",298,134050,,471,"MĂGURENI / Scoala cu cls.I-VIII Magureni(Corp A)",3,12686,"MĂGURENI",134050,1352,765,719,46,0,754,11,1500,735,369,385
31,"PRAHOVA",298,134050,,472,"LUNCA PRAHOVEI / SCOALA CU CLS.I-IV NR.3  LUNCA PRAHOVEI",3,12686,"MĂGURENI",134050,903,502,476,26,0,496,6,1000,498,359,137
31,"PRAHOVA",298,134050,,473,"COCORĂŞTII CAPLII / SCOALA CU CLS.I-IV NR.4 COCORASTIICAPLII",3,12686,"MĂGURENI",134050,680,480,429,51,0,477,3,700,220,187,290
31,"PRAHOVA",298,134096,,474,"MĂNECIU-UNGURENI / NULL",3,12690,"MĂNECIU",134096,1419,980,902,75,3,966,14,1400,420,574,392
31,"PRAHOVA",298,134096,,475,"MĂNECIU-UNGURENI / NULL",3,12690,"MĂNECIU",134096,1358,831,806,24,1,811,20,1500,669,482,329
31,"PRAHOVA",298,134096,,476,"GHEABA / NULL",3,12690,"MĂNECIU",134096,1234,785,713,72,0,774,11,1400,615,382,392
31,"PRAHOVA",298,134096,,477,"GHEABA / NULL",3,12690,"MĂNECIU",134096,1140,726,674,49,3,716,10,1200,474,402,314
31,"PRAHOVA",298,134096,,478,"MĂNECIU-PĂMÎNTENI / NULL",3,12690,"MĂNECIU",134096,874,558,517,40,1,542,16,1000,442,231,311
31,"PRAHOVA",298,134096,,479,"MĂNECIU-PĂMÎNTENI / NULL",3,12690,"MĂNECIU",134096,949,567,539,27,1,556,11,1000,433,275,281
31,"PRAHOVA",298,134096,,480,"MĂNECIU-PĂMÎNTENI / NULL",3,12690,"MĂNECIU",134096,1602,979,921,58,0,964,15,1800,821,512,452
31,"PRAHOVA",298,134096,,481,"CHEIA / NULL",3,12690,"MĂNECIU",134096,332,415,187,228,0,408,7,503,88,142,266
31,"PRAHOVA",298,134194,,482,"MĂNEŞTI / Caminul Cultural",3,12700,"MĂNEŞTI",134194,890,615,542,73,0,606,9,1000,385,269,337
31,"PRAHOVA",298,134194,,483,"ZALHANAUA / SCOALA ZALHANAUA",3,12700,"MĂNEŞTI",134194,795,567,524,42,1,560,7,900,333,257,303
31,"PRAHOVA",298,134194,,484,"COADA IZVORULUI / Scoala Coada Izv",3,12700,"MĂNEŞTI",134194,775,562,499,1,62,555,7,800,238,237,318
31,"PRAHOVA",298,134194,,485,"BĂLTIŢA / Scoala Baltita",3,12700,"MĂNEŞTI",134194,750,495,464,24,7,489,6,800,305,201,288
31,"PRAHOVA",298,136250,,486,"OLARII VECHI / SCOALA OLARII-VECHI",3,12706,"OLARI",136250,647,451,416,35,0,444,7,700,249,308,136
31,"PRAHOVA",298,136250,,487,"OLARI / SCOALA OLARI",3,12706,"OLARI",136250,600,455,409,45,1,452,3,600,145,319,133
31,"PRAHOVA",298,136250,,488,"FÂNARI / SCOALA FINARI",3,12706,"OLARI",136250,338,291,254,37,0,288,3,400,109,252,36
31,"PRAHOVA",298,134336,,489,"PĂCUREŢI / Grădiniţa cu program normal Păcureţi",3,12710,"PĂCUREŢI",134336,1082,660,604,56,0,646,14,1200,540,402,244
31,"PRAHOVA",298,134336,,490,"MATIŢA / Şcoala Gimnazială",3,12710,"PĂCUREŢI",134336,680,390,355,35,0,382,8,700,310,181,201
31,"PRAHOVA",298,130847,,491,"PĂULEŞTI / Scoala Generala cu cl.I-VIII Arh.Toma T.Socolescu Paulesti",3,12716,"PĂULEŞTI",130847,1231,1001,844,142,15,980,21,1300,299,477,503
31,"PRAHOVA",298,130847,,492,"PĂULEŞTI / Centrul Cultural Arh.Toma T.Socolescu Paulesti",3,12716,"PĂULEŞTI",130847,1157,972,840,132,0,956,16,1300,328,433,523
31,"PRAHOVA",298,130847,,493,"COCOŞEŞTI / Gradinita Curcubeul Magic Cocosesti",3,12716,"PĂULEŞTI",130847,740,714,584,112,18,704,10,800,86,402,302
31,"PRAHOVA",298,130847,,494,"GĂGENI / Scoala Generala cu cls.I-VIII Vlad Musatescu Gageni",3,12716,"PĂULEŞTI",130847,782,603,527,75,1,598,5,900,297,269,329
31,"PRAHOVA",298,130847,,495,"GĂGENI / Caminul Cultural Gageni",3,12716,"PĂULEŞTI",130847,981,907,693,97,117,888,19,1100,193,494,394
31,"PRAHOVA",298,134390,,496,"PLOPU / GRADINITA CU PROGRAM NORMAL PLOPU",3,12721,"PLOPU",134390,850,714,577,136,1,705,9,900,186,273,432
31,"PRAHOVA",298,134390,,497,"NISIPOASA / SCOALA CU CLS. I-IV NISIPOASA",3,12721,"PLOPU",134390,650,498,435,63,0,492,6,700,202,289,203
31,"PRAHOVA",298,134390,,498,"GÂLMEIA / FOSTA SCOALA CU CLS. I-IV GALMEIA",3,12721,"PLOPU",134390,203,193,151,42,0,190,3,200,7,58,132
31,"PRAHOVA",298,134390,,499,"HÂRŞA / FOSTA SCOALA CU CLS. I-IV HARSA",3,12721,"PLOPU",134390,205,150,128,22,0,149,1,302,152,68,81
31,"PRAHOVA",298,134443,,500,"SĂLCIOARA / SCOALA CU CLASELE I-VIII PODENII NOI",3,12726,"PODENII NOI",134443,1219,756,692,59,5,751,5,1300,544,298,453
31,"PRAHOVA",298,134443,,501,"VALEA DULCE / CAMIN CULTURAL VALEA-DULCE",3,12726,"PODENII NOI",134443,812,613,548,49,16,605,8,900,287,258,347
31,"PRAHOVA",298,134443,,502,"POPEŞTI / GRADINITA DE COPII POPESTI",3,12726,"PODENII NOI",134443,485,328,283,32,13,320,8,500,172,123,197
31,"PRAHOVA",298,134443,,503,"MEHEDINŢA / SCOALA CU CLASELE I-VIII MEHEDINTA",3,12726,"PODENII NOI",134443,1268,830,746,68,16,821,9,1400,570,466,355
31,"PRAHOVA",298,131274,,504,"POIANA CÂMPINA / SCOALA GIMNAZIALA ""INV. ION MATEESCU"" POIANA-CAMPINA",3,12737,"POIANA CÂMPINA",131274,1070,752,670,81,1,740,12,1200,448,284,456
31,"PRAHOVA",298,131274,,505,"POIANA CÂMPINA / PRIMARIA COMUNEI POIANA-CAMPINA",3,12737,"POIANA CÂMPINA",131274,1259,911,795,116,0,899,12,1400,489,314,585
31,"PRAHOVA",298,131274,,506,"POIANA CÂMPINA / BIBLIOTECA ""DIMITRIE GUSTI"" COMUNA POIANA-CAMPINA",3,12737,"POIANA CÂMPINA",131274,635,491,431,60,0,482,9,700,209,167,315
31,"PRAHOVA",298,131274,,507,"PIETRIŞU / SCOALA GENERALA PIETRISU",3,12737,"POIANA CÂMPINA",131274,488,332,304,26,2,328,4,500,168,135,193
31,"PRAHOVA",298,131274,,508,"BOBOLIA / CAMINUL CULTURAL BOBOLIA",3,12737,"POIANA CÂMPINA",131274,867,647,577,70,0,637,10,1000,353,213,424
31,"PRAHOVA",298,134559,,509,"POIENARII BURCHII / SCOALA GIMANZIALA POIENARII BURCHII",3,12742,"POIENARII BURCHII",134559,988,698,588,110,0,679,19,1100,402,250,429
31,"PRAHOVA",298,134559,,510,"CĂRBUNARI / GRADINITA DE COPII SAT CARBUNARI",3,12742,"POIENARII BURCHII",134559,640,432,379,53,0,426,6,700,268,167,259
31,"PRAHOVA",298,134559,,511,"POIENARII RALI / SCOALA POIENARII RALI",3,12742,"POIENARII BURCHII",134559,900,696,573,109,14,683,13,1000,304,267,416
31,"PRAHOVA",298,134559,,512,"OLOGENI / GRADINITA DE COPII SAT OLOGENI",3,12742,"POIENARII BURCHII",134559,1132,778,659,119,0,768,10,1200,422,430,338
31,"PRAHOVA",298,134559,,513,"TĂTĂRĂI / CAMIN CULTURAL TATARAI",3,12742,"POIENARII BURCHII",134559,426,344,265,78,1,341,3,500,156,205,136
31,"PRAHOVA",298,134648,,514,"BODEŞTI / CĂMINUL CULTURAL DIN SATUL POSEŞTII-PĂMÂNTENI",3,12751,"POSEŞTI",134648,695,434,373,60,1,431,3,800,366,196,235
31,"PRAHOVA",298,134648,,515,"NUCŞOARA DE JOS / CLADIREA FOSTEI PRIMARII RANCEZI DIN SATUL NUCSOARA DE JOS",3,12751,"POSEŞTI",134648,1266,859,772,85,2,851,8,1400,541,468,383
31,"PRAHOVA",298,134648,,516,"VALEA PLOPULUI / ŞCOALA GENERALĂ CU CLASELE I-VIII DIN SATUL VALEA PLOPULUI",3,12751,"POSEŞTI",134648,778,505,432,73,0,490,15,800,295,310,180
31,"PRAHOVA",298,134648,,517,"TÎRLEŞTI / FOSTA ŞCOALĂ GENERALĂ CU CLASELE I-IV DIN SATUL TÂRLEŞTI",3,12751,"POSEŞTI",134648,498,300,281,19,0,298,2,600,300,147,151
31,"PRAHOVA",298,134755,,518,"PREDEAL / SCOALA GIMNAZIALA ,,MANASTIREANU MIHAI "" PREDEAL",3,12762,"PREDEAL-SĂRARI",134755,774,495,453,41,1,489,6,800,305,276,213
31,"PRAHOVA",298,134755,,519,"ZÎMBROAIA / SCOALA ELEMENTARA ZIMBROAIA",3,12762,"PREDEAL-SĂRARI",134755,144,105,79,26,0,105,0,200,95,76,29
31,"PRAHOVA",298,134755,,520,"VITIOARA DE SUS / SCOALA GIMNAZIALA  VITIOARA DE SUS",3,12762,"PREDEAL-SĂRARI",134755,1009,638,587,51,0,628,10,1100,462,333,295
31,"PRAHOVA",298,134853,,521,"PROVIŢA DE JOS / SCOALA GIMNAZIALA PROVITA DE JOS",3,12772,"PROVIŢA DE JOS",134853,939,647,557,89,1,638,9,1000,353,287,351
31,"PRAHOVA",298,134853,,522,"DRĂGĂNEASA / GRADINITA CU PROGRAM NORMAL DRAGANEASA",3,12772,"PROVIŢA DE JOS",134853,920,603,542,61,0,597,6,1000,397,256,341
31,"PRAHOVA",298,134899,,523,"PROVIŢA DE SUS / Scoala  gimnaziala cu Cls. I-VIII,,MITROPOLIT PIMEN GEORGESCU Provita de Sus",3,12776,"PROVIŢA DE SUS",134899,1454,999,906,90,3,990,9,1600,601,485,505
31,"PRAHOVA",298,134899,,524,"IZVORU / Gradinita cu program normal IZVORU",3,12776,"PROVIŢA DE SUS",134899,324,242,209,33,0,238,4,403,161,102,136
31,"PRAHOVA",298,134942,,525,"PUCHENII MARI / SCOALA GIMNAZIALA,COMUNA PUCHENII MARI",3,12781,"PUCHENII MARI",134942,1068,838,687,151,0,823,15,1200,362,291,532
31,"PRAHOVA",298,134942,,526,"PIETROŞANI / SCOALA GIMNAZIALA PIETROSANI",3,12781,"PUCHENII MARI",134942,1022,666,592,74,0,655,11,1100,434,228,427
31,"PRAHOVA",298,134942,,527,"PIETROŞANI / GRADINITA CU PROGRAM NORMALPIETROSANI",3,12781,"PUCHENII MARI",134942,938,584,547,37,0,573,11,1000,416,207,366
31,"PRAHOVA",298,134942,,528,"PUCHENII MOŞNENI / SCOALA GIMNAZIALA PUCHENII MOSNENI",3,12781,"PUCHENII MARI",134942,1194,833,744,89,0,810,23,1300,467,307,503
31,"PRAHOVA",298,134942,,529,"MIROSLĂVEŞTI / SCOALA PRIMARA MIROSLAVESTI",3,12781,"PUCHENII MARI",134942,1543,1092,993,81,18,1085,7,1700,608,431,654
31,"PRAHOVA",298,134942,,530,"ODĂILE / GRADINITA CU PROGRAM NORMAL ODAILE",3,12781,"PUCHENII MARI",134942,1337,981,914,67,0,966,15,1500,519,447,519
31,"PRAHOVA",298,135020,,531,"MĂLĂIEŞTI / scoala primara Malaiesti",3,12789,"RÎFOV",135020,639,485,443,42,0,482,3,700,215,350,132
31,"PRAHOVA",298,135020,,532,"MOARA DOMNEASCĂ / scoala primara Moara Domneasca",3,12789,"RÎFOV",135020,802,569,518,51,0,558,11,900,331,321,237
31,"PRAHOVA",298,135020,,533,"BUDA / scoala gimnazila  Buda",3,12789,"RÎFOV",135020,873,573,518,48,7,559,14,900,327,309,250
31,"PRAHOVA",298,135020,,534,"PALANCA / scoala primara Palanca",3,12789,"RÎFOV",135020,889,563,534,29,0,555,8,1000,437,397,158
31,"PRAHOVA",298,135020,,535,"GOGA / scoala primara Goga",3,12789,"RÎFOV",135020,369,287,247,40,0,283,4,402,115,170,113
31,"PRAHOVA",298,135020,,536,"SICRITA / scoala primara Sicrita",3,12789,"RÎFOV",135020,388,230,187,43,0,225,5,399,169,133,92
31,"PRAHOVA",298,135020,,537,"RÎFOV / fostul sediu al primariei",3,12789,"RÎFOV",135020,285,192,171,21,0,189,3,300,108,113,76
31,"PRAHOVA",298,135020,,538,"BUCHILAŞI / scoala dezafectata Buchilasi",3,12789,"RÎFOV",135020,117,93,68,25,0,93,0,200,107,49,44
31,"PRAHOVA",298,135128,,539,"SALCIA / SCOALA GIMNAZIALA",3,12799,"SALCIA",135128,863,527,485,42,0,522,5,1000,473,326,196
31,"PRAHOVA",298,135146,,540,"SĂLCIILE / SCOALA NOUA",3,12801,"SĂLCIILE",135146,805,596,515,53,28,587,9,900,304,235,352
31,"PRAHOVA",298,135146,,541,"SĂLCIILE / CAMINUL  CULTURAL",3,12801,"SĂLCIILE",135146,781,564,440,98,26,556,8,900,336,245,311
31,"PRAHOVA",298,135164,,542,"SCORŢENI / SCOALA GIMNAZIALA SCORTENI",3,12803,"SCORŢENI",135164,1250,774,709,65,0,767,7,1400,626,393,374
31,"PRAHOVA",298,135164,,543,"MISLEA / SCOALA GIMNAZIALA MISLEA",3,12803,"SCORŢENI",135164,1565,1014,949,65,0,1003,11,1700,686,523,480
31,"PRAHOVA",298,135164,,544,"BORDENII MARI / GRADINITA BORDENII MARI",3,12803,"SCORŢENI",135164,1221,831,755,74,2,818,13,1300,469,417,401
31,"PRAHOVA",298,135164,,545,"SÎRCA / SCOALA GIMNAZIALA BORDENI",3,12803,"SCORŢENI",135164,842,587,528,56,3,583,4,900,313,261,322
31,"PRAHOVA",298,135226,,546,"SECĂRIA / CAMIN CULTURAL SECARIA",3,12809,"SECĂRIA",135226,1043,739,665,67,7,732,7,1200,461,314,418
31,"PRAHOVA",298,135244,,547,"SÎNGERU / Caminul cultural",3,12811,"SÎNGERU",135244,1227,414,381,33,0,403,11,1400,986,214,189
31,"PRAHOVA",298,135244,,548,"SÎNGERU / Căminul cultural",3,12811,"SÎNGERU",135244,688,388,356,31,1,386,2,800,412,222,164
31,"PRAHOVA",298,135244,,549,"MIREŞU MARE / Căminul cultural",3,12811,"SÎNGERU",135244,1210,718,672,46,0,713,5,1300,582,347,366
31,"PRAHOVA",298,135244,,550,"BUTUCI / Şcoala",3,12811,"SÎNGERU",135244,451,316,285,31,0,311,5,500,184,141,170
31,"PRAHOVA",298,135244,,551,"TISA / Şcoala",3,12811,"SÎNGERU",135244,567,358,314,44,0,356,2,600,242,202,154
31,"PRAHOVA",298,135315,,552,"STARCHIOJD / Grădiniţa de copii din satul Starchiojd",3,12836,"STARCHIOJD",135315,1459,917,858,59,0,908,9,1600,683,544,364
31,"PRAHOVA",298,135315,,553,"STARCHIOJD / Grădiniţa de copii din Gîrbeasca",3,12836,"STARCHIOJD",135315,1219,776,738,38,0,764,12,1300,524,476,288
31,"PRAHOVA",298,135315,,554,"VALEA ANEI / Şcoala din satul Valea Anei",3,12836,"STARCHIOJD",135315,478,305,269,36,0,304,1,500,195,232,72
31,"PRAHOVA",298,135404,,555,"SURANI / Şcoala Primară",3,12847,"SURANI",135404,1451,998,861,119,18,984,14,1600,602,277,707
31,"PRAHOVA",298,135431,,556,"TĂRICENI / SCOALA GIMNAZIALA, SAT TARICENI",3,12818,"ŞIRNA",135431,913,548,489,59,0,541,7,1000,452,286,255
31,"PRAHOVA",298,135431,,557,"TĂRICENI / SCOALA GIMNAZIALA, SAT TARICENI",3,12818,"ŞIRNA",135431,679,427,380,47,0,423,4,700,273,254,169
31,"PRAHOVA",298,135431,,558,"ŞIRNA / SCOALA PRIMARA, SAT SIRNA",3,12818,"ŞIRNA",135431,640,438,349,87,2,431,7,700,262,220,211
31,"PRAHOVA",298,135431,,559,"VARNIŢA / SCOALA GIMNAZIALA, SAT VARNITA",3,12818,"ŞIRNA",135431,781,451,421,30,0,445,6,900,449,241,204
31,"PRAHOVA",298,135431,,560,"HĂBUD / SCOALA GIMNAZIALA, SAT HABUD",3,12818,"ŞIRNA",135431,640,439,390,49,0,438,1,700,261,238,200
31,"PRAHOVA",298,135431,,561,"BRĂTEŞTI / SCOALA PRIMARA  SAT BRATESTI",3,12818,"ŞIRNA",135431,424,259,235,24,0,257,2,500,241,132,125
31,"PRAHOVA",298,135501,,562,"MĂGURA / CAMIN CULTURAL",3,12825,"ŞOIMARI",135501,444,299,263,36,0,297,2,500,201,173,124
31,"PRAHOVA",298,135501,,563,"ŞOIMARI / SCOALA GEN.SOIMARI",3,12825,"ŞOIMARI",135501,1426,846,762,84,0,836,10,1600,754,387,449
31,"PRAHOVA",298,135501,,564,"LOPATNIŢA / GRADINITA",3,12825,"ŞOIMARI",135501,576,345,318,27,0,344,1,600,255,139,205
31,"PRAHOVA",298,135547,,565,"PLAIU CÂMPINEI / SCOALA",3,12829,"ŞOTRILE",135547,643,408,391,17,0,399,9,700,292,225,174
31,"PRAHOVA",298,135547,,566,"SECIURI / ŞCOALA",3,12829,"ŞOTRILE",135547,312,197,183,14,0,196,1,396,199,84,112
31,"PRAHOVA",298,135547,,567,"LUNCA MARE / ŞCOALA",3,12829,"ŞOTRILE",135547,396,294,259,35,0,293,1,400,106,120,173
31,"PRAHOVA",298,135547,,568,"VISTIERU / ŞCOALA",3,12829,"ŞOTRILE",135547,491,333,295,37,1,329,4,500,167,195,134
31,"PRAHOVA",298,135547,,569,"ŞOTRILE / ŞCOALA GIMNAZIALĂ,",3,12829,"ŞOTRILE",135547,866,524,492,32,0,523,1,1000,476,257,266
31,"PRAHOVA",298,135618,,570,"SCURTEŞTI / GRĂDINIŢA DE COPII",3,12843,"ŞTEFEŞTI",135618,671,428,403,25,0,427,1,700,272,273,154
31,"PRAHOVA",298,135618,,571,"ŞTEFEŞTI / Scoala generala cu clasele  I-VIII din satul Stefesti",3,12843,"ŞTEFEŞTI",135618,1316,864,807,57,0,853,11,1500,636,461,392
31,"PRAHOVA",298,135654,,572,"TALEA / SCOALA GIMNAZIALA TALEA",3,12850,"TALEA",135654,907,740,659,60,21,729,11,1000,260,441,288
31,"PRAHOVA",298,135681,,573,"TĂTARU / camin cultural",3,12853,"TĂTARU",135681,276,226,165,46,15,223,3,300,74,92,131
31,"PRAHOVA",298,135681,,574,"PODGORIA / Camin cultural",3,12853,"TĂTARU",135681,521,365,284,55,26,359,6,600,235,114,245
31,"PRAHOVA",298,135725,,575,"TEIŞANI / SCOALA GENERALA ""DUMITRU BREZEANU"" TEISANI",3,12857,"TEIŞANI",135725,1479,937,877,60,0,926,11,1600,663,441,485
31,"PRAHOVA",298,135725,,576,"VALEA STÎLPULUI / SC.MALI AUTO EXPRES SRL",3,12857,"TEIŞANI",135725,188,165,136,29,0,161,4,198,33,91,70
31,"PRAHOVA",298,135725,,577,"OLTENI / SCOALA GENERALA ""MOISE VASILESCU""",3,12857,"TEIŞANI",135725,1455,909,836,73,0,894,15,1600,691,479,415
31,"PRAHOVA",298,135789,,578,"TELEGA / ŞCOALA GIMNAZIALA NR.1 TELEGA",3,12863,"TELEGA",135789,1169,780,699,81,0,772,8,1300,520,384,388
31,"PRAHOVA",298,135789,,579,"TELEGA / SCOALA GENERALA NR.2 TELEGA-VALE",3,12863,"TELEGA",135789,1533,1056,980,76,0,1038,18,1700,644,495,543
31,"PRAHOVA",298,135789,,580,"TELEGA / GRĂDINIŢA NR.1 TELEGA",3,12863,"TELEGA",135789,1189,822,755,67,0,809,13,1300,478,414,395
31,"PRAHOVA",298,135789,,581,"BUŞTENARI / ŞCOALA GIMNAZIALĂ SAT BUŞTENARI",3,12863,"TELEGA",135789,545,320,288,32,0,317,3,600,280,173,144
31,"PRAHOVA",298,135789,,582,"MELICEŞTI / SCOALA PRIMARA SAT MELICEŞTI",3,12863,"TELEGA",135789,418,271,253,18,0,271,0,500,229,151,120
31,"PRAHOVA",298,135850,,583,"TINOSU / CAMINUL CULTURAL TINOSU",3,12870,"TINOSU",135850,948,592,538,54,0,584,8,1000,408,268,316
31,"PRAHOVA",298,135850,,584,"PREDEŞTI / SCOALA PRIMARA PREDESTI",3,12870,"TINOSU",135850,541,409,378,31,0,404,5,600,191,147,257
31,"PRAHOVA",298,135850,,585,"PISCULEŞTI / SCOALA PRIMARA PISCULESTI",3,12870,"TINOSU",135850,513,318,290,28,0,313,5,600,282,161,152
31,"PRAHOVA",298,130892,,586,"STREJNICU / BAZA SPORTIVA CONPET",3,12874,"TÎRGŞORU VECHI",130892,1742,1115,1068,47,0,1100,15,1900,785,357,743
31,"PRAHOVA",298,130892,,587,"STREJNICU / GRĂDINIŢA CU PROGRAM NORMAL STREJNICU",3,12874,"TÎRGŞORU VECHI",130892,1422,994,901,92,1,981,13,1500,506,363,618
31,"PRAHOVA",298,130892,,588,"STREJNICU / ŞCOALA GIMNAZIALĂ STREJNICU",3,12874,"TÎRGŞORU VECHI",130892,1359,899,816,83,0,892,7,1500,601,291,601
31,"PRAHOVA",298,130892,,589,"STREJNICU / CĂMINUL CULTURAL STREJNICU",3,12874,"TÎRGŞORU VECHI",130892,600,399,363,36,0,394,5,700,301,144,250
31,"PRAHOVA",298,130892,,590,"TÎRGŞORU VECHI / ŞCOALA GIMNAZIALĂ TIRGŞORU VECHI",3,12874,"TÎRGŞORU VECHI",130892,1079,600,557,43,0,585,15,1200,600,222,363
31,"PRAHOVA",298,130892,,591,"TÎRGŞORU VECHI / GRĂDINIŢA CU PROGRAM NORMAL TÎRGŞORU VECHI",3,12874,"TÎRGŞORU VECHI",130892,847,534,485,49,0,521,13,900,366,182,339
31,"PRAHOVA",298,130892,,592,"STĂNCEŞTI / ŞCOALA GENERALĂ CU CLASELE I-IV STĂNCEŞTI",3,12874,"TÎRGŞORU VECHI",130892,789,488,428,60,0,484,4,900,412,211,273
31,"PRAHOVA",298,135896,,593,"TOMŞANI / CAMIN CULT. TOMSANI",3,12879,"TOMŞANI",135896,1289,809,755,54,0,803,6,1400,591,447,356
31,"PRAHOVA",298,135896,,594,"MAGULA / SCOALA VECHE MAGULA",3,12879,"TOMŞANI",135896,1135,691,654,35,2,686,5,1200,509,435,251
31,"PRAHOVA",298,135896,,595,"LOLOIASCA / CAMIN CULT. LOLOIASCA",3,12879,"TOMŞANI",135896,1205,717,652,62,3,711,6,1300,583,405,306
31,"PRAHOVA",298,136269,,596,"VADU SĂPAT / SCOALA GIMNAZIALA VADU SAPAT, COMUNA VADU SAPAT, SAT VADU SAPAT, NR 255",3,12884,"VADU SĂPAT",136269,1376,800,717,83,0,783,17,1500,700,407,376
31,"PRAHOVA",298,135949,,597,"ARVA / CAMIN CULTURAL",3,12888,"VALEA CĂLUGĂREASCĂ",135949,1106,724,659,59,6,714,10,1200,476,409,305
31,"PRAHOVA",298,135949,,598,"VALEA CĂLUGĂREASCĂ / SCOALA GIMNAZIALA ION IONESCU VALEA CALUGAREASCA",3,12888,"VALEA CĂLUGĂREASCĂ",135949,1528,823,784,38,1,814,9,1700,877,428,386
31,"PRAHOVA",298,135949,,599,"VALEA CĂLUGĂREASCĂ / SCOALA GIMNAZIALA ION IONESCU VALEA CALUGAREASCA",3,12888,"VALEA CĂLUGĂREASCĂ",135949,933,556,511,45,0,542,14,1000,444,260,282
31,"PRAHOVA",298,135949,,600,"VALEA NICOVANI / SCOAL GIMNAZIALA NICOVANI",3,12888,"VALEA CĂLUGĂREASCĂ",135949,1135,667,596,71,0,654,13,1200,533,350,304
31,"PRAHOVA",298,135949,,601,"DÎRVARI / GRADINITA DIRVARI",3,12888,"VALEA CĂLUGĂREASCĂ",135949,484,299,273,26,0,295,4,500,201,194,101
31,"PRAHOVA",298,135949,,602,"COSLEGI / GRADINITA COSLEGI",3,12888,"VALEA CĂLUGĂREASCĂ",135949,544,318,288,30,0,317,1,600,282,151,166
31,"PRAHOVA",298,135949,,603,"RADILA / GRADINITA RADILA",3,12888,"VALEA CĂLUGĂREASCĂ",135949,254,171,152,19,0,169,2,300,129,106,63
31,"PRAHOVA",298,135949,,604,"PANTAZI / SCOAL PRIMARA PANTAZI",3,12888,"VALEA CĂLUGĂREASCĂ",135949,967,526,491,33,2,522,4,1100,574,309,213
31,"PRAHOVA",298,135949,,605,"RACHIERI / SCOAL GIMNAZIALA RACHIERI",3,12888,"VALEA CĂLUGĂREASCĂ",135949,1078,768,715,53,0,760,8,1200,432,609,151
31,"PRAHOVA",298,135949,,606,"VALEA POPII / COLEGIUL AGRICOL GHEORGHE IONESCU SISESTI",3,12888,"VALEA CĂLUGĂREASCĂ",135949,729,440,394,46,0,433,7,800,360,206,227
31,"PRAHOVA",298,135949,,607,"VALEA MANTEI / CABANA DE VANATOARE",3,12888,"VALEA CĂLUGĂREASCĂ",135949,95,63,42,21,0,61,2,100,37,43,18
31,"PRAHOVA",298,136107,,608,"TEŞILA / Grup Scolar Carol I Valea Doftanei",3,12904,"VALEA DOFTANEI",136107,1398,901,845,55,1,895,6,1500,599,397,498
31,"PRAHOVA",298,136107,,609,"TRĂISTENI / Primăria Trăisteni",3,12904,"VALEA DOFTANEI",136107,1005,682,613,65,4,678,4,1100,418,339,339
31,"PRAHOVA",298,136107,,610,"TRĂISTENI / Şcoala cu clasele I-VIII ""Erou Inv.I.Drăgănescu""Trăisteni",3,12904,"VALEA DOFTANEI",136107,1104,757,696,61,0,750,7,1200,443,346,404
31,"PRAHOVA",298,136107,,611,"TEŞILA / Grădiniţa nr.1 Teşila",3,12904,"VALEA DOFTANEI",136107,1200,769,736,27,6,760,9,1300,531,347,413
31,"PRAHOVA",298,136107,,612,"TEŞILA / Grădiniţa nr.2 Teşila",3,12904,"VALEA DOFTANEI",136107,997,688,646,42,0,684,4,1100,412,251,433
31,"PRAHOVA",298,136134,,613,"VĂRBILĂU / Scoala generala cu cls. I-IV Sat Varbilau",3,12907,"VĂRBILĂU",136134,936,581,551,29,1,571,10,1000,419,397,174
31,"PRAHOVA",298,136134,,614,"VĂRBILĂU / Scoala generala cu cls. I-IV Sat Varbilau",3,12907,"VĂRBILĂU",136134,875,495,462,33,0,482,13,1000,505,302,180
31,"PRAHOVA",298,136134,,615,"VĂRBILĂU / Scoala generala cu cls. I-VIII Sat Varbilau",3,12907,"VĂRBILĂU",136134,1188,767,702,65,0,761,6,1300,533,542,219
31,"PRAHOVA",298,136134,,616,"LIVADEA / Scoala generala cu cls. I-VIII Sat Livadea",3,12907,"VĂRBILĂU",136134,891,582,545,37,0,573,9,1000,418,348,225
31,"PRAHOVA",298,136134,,617,"POIANA VĂRBILĂU / Scoala generala cu cls. I-IV Sat Poiana Varbilau",3,12907,"VĂRBILĂU",136134,1061,620,589,31,0,608,12,1200,580,369,239
31,"PRAHOVA",298,136134,,618,"COŢOFENEŞTI / Scoala generala cu cls. I-IV Sat Cotofenesti",3,12907,"VĂRBILĂU",136134,746,535,490,44,1,529,6,800,265,317,212
31,"PRAHOVA",298,136198,,619,"VÎLCĂNEŞTI / CENTRUL CULTURAL",3,12913,"VÎLCĂNEŞTI",136198,1432,950,879,62,9,936,14,1600,650,453,483
31,"PRAHOVA",298,136198,,620,"VÎLCĂNEŞTI / Gradinita  de copii Branzari",3,12913,"VÎLCĂNEŞTI",136198,800,561,511,36,14,553,8,900,339,303,250
31,"PRAHOVA",298,136198,,621,"CÎRJARI / Scoala Cirjari",3,12913,"VÎLCĂNEŞTI",136198,614,406,364,30,12,398,8,700,294,183,215
31,"PRAHOVA",298,136198,,622,"TRESTIOARA / Biblioteca  Sateasca",3,12913,"VÎLCĂNEŞTI",136198,396,239,219,20,0,238,1,396,157,132,106
32,"SATU MARE",305,136483,,1,"SATU MARE / GRADINITA ""DRAGA MEA""",1,12918,"MUNICIPIUL SATU MARE",136483,1922,752,684,68,0,742,10,2100,1348,248,494
32,"SATU MARE",305,136483,,2,"SATU MARE / GRADINITA ""DRAGA MEA""",1,12918,"MUNICIPIUL SATU MARE",136483,1778,958,915,43,0,949,9,2000,1042,301,648
32,"SATU MARE",305,136483,,3,"SATU MARE / ASOCIAŢIA CARITAS SATU MARE CANTRUL SOCIAL DESCHIS LA CASA PRIETENIEI",1,12918,"MUNICIPIUL SATU MARE",136483,1130,684,624,60,0,680,4,1300,616,219,461
32,"SATU MARE",305,136483,,4,"SATU MARE / ŞC. CU CLS.I-VIII"" ION CREANGĂ """,1,12918,"MUNICIPIUL SATU MARE",136483,1446,847,774,71,2,842,5,1600,753,239,603
32,"SATU MARE",305,136483,,5,"SATU MARE / ŞC. CU CLS.I-VIII"" ION CREANGĂ """,1,12918,"MUNICIPIUL SATU MARE",136483,1314,750,714,36,0,744,6,1500,750,255,489
32,"SATU MARE",305,136483,,6,"SATU MARE / ŞC. CU CLS.I-VIII"" ION CREANGĂ """,1,12918,"MUNICIPIUL SATU MARE",136483,1300,764,736,26,2,763,1,1400,636,202,561
32,"SATU MARE",305,136483,,7,"SATU MARE / ŞC. CU CLS.I-VIII"" ION CREANGĂ """,1,12918,"MUNICIPIUL SATU MARE",136483,1565,900,883,17,0,890,10,1700,800,230,660
32,"SATU MARE",305,136483,,8,"SATU MARE / ŞC. CU CLS.I-VIII "" LUCIAN BLAGA """,1,12918,"MUNICIPIUL SATU MARE",136483,1464,829,781,48,0,821,8,1600,771,260,561
32,"SATU MARE",305,136483,,9,"SATU MARE / ŞC. CU CLS.I-VIII "" LUCIAN BLAGA """,1,12918,"MUNICIPIUL SATU MARE",136483,1363,795,742,53,0,791,4,1500,705,230,561
32,"SATU MARE",305,136483,,10,"SATU MARE / ŞC. CU CLS.I-VIII "" LUCIAN BLAGA """,1,12918,"MUNICIPIUL SATU MARE",136483,1216,673,639,34,0,667,6,1300,627,201,466
32,"SATU MARE",305,136483,,11,"SATU MARE / ŞC. CU CLS.I-VIII "" LUCIAN BLAGA """,1,12918,"MUNICIPIUL SATU MARE",136483,1387,754,727,26,1,751,3,1500,746,218,533
32,"SATU MARE",305,136483,,12,"SATU MARE / ŞC. CU CLS.I-VIII"" OCTAVIAN GOGA """,1,12918,"MUNICIPIUL SATU MARE",136483,1338,732,684,48,0,726,6,1500,768,222,504
32,"SATU MARE",305,136483,,13,"SATU MARE / ŞC. CU CLS.I-VIII"" OCTAVIAN GOGA """,1,12918,"MUNICIPIUL SATU MARE",136483,1276,702,665,35,2,699,3,1400,698,218,481
32,"SATU MARE",305,136483,,14,"SATU MARE / ŞC. CU CLS.I-VIII"" OCTAVIAN GOGA """,1,12918,"MUNICIPIUL SATU MARE",136483,1485,813,775,38,0,802,11,1600,787,251,551
32,"SATU MARE",305,136483,,15,"SATU MARE / ŞC. CU CLS.I-VIII"" OCTAVIAN GOGA """,1,12918,"MUNICIPIUL SATU MARE",136483,1629,890,848,42,0,888,2,1800,910,291,597
32,"SATU MARE",305,136483,,16,"SATU MARE / GRĂDINIŢA CU PROGRAM NORMAL NR.21",1,12918,"MUNICIPIUL SATU MARE",136483,1444,852,789,63,0,845,7,1600,748,264,581
32,"SATU MARE",305,136483,,17,"SATU MARE / GRĂDINIŢA CU PROGRAM NORMAL NR.21",1,12918,"MUNICIPIUL SATU MARE",136483,1642,880,844,36,0,875,5,1800,920,291,584
32,"SATU MARE",305,136483,,18,"SATU MARE / GRĂDINIŢA CU PROGRAM NORMAL NR.21",1,12918,"MUNICIPIUL SATU MARE",136483,1681,982,950,31,1,973,9,1900,918,325,648
32,"SATU MARE",305,136483,,19,"SATU MARE / GRĂDINIŢA CU PROGRAM NORMAL NR.21",1,12918,"MUNICIPIUL SATU MARE",136483,1586,869,852,17,0,864,5,1800,931,242,622
32,"SATU MARE",305,136483,,20,"SATU MARE / ŞC. CU CLS.I-VIII NR. 9",1,12918,"MUNICIPIUL SATU MARE",136483,1180,718,676,42,0,711,7,1299,581,258,453
32,"SATU MARE",305,136483,,21,"SATU MARE / LICEUL TEORETIC GERMAN  "" JOHANN ETTINGER """,1,12918,"MUNICIPIUL SATU MARE",136483,1841,1037,945,92,0,1032,5,2000,963,274,758
32,"SATU MARE",305,136483,,22,"SATU MARE / COL.TEHNIC ELISA                  ZAMFIRESCU(GRUP ŞC. DE INDUSTRIE UŞOARĂ )",1,12918,"MUNICIPIUL SATU MARE",136483,1579,984,941,43,0,977,7,1700,716,280,697
32,"SATU MARE",305,136483,,23,"SATU MARE / ŞC. CU CLS.I-VIII"" MIRCEA ELIADE """,1,12918,"MUNICIPIUL SATU MARE",136483,1551,844,785,59,0,836,8,1700,856,251,585
32,"SATU MARE",305,136483,,24,"SATU MARE / ŞC. CU CLS.I-VIII"" MIRCEA ELIADE """,1,12918,"MUNICIPIUL SATU MARE",136483,1699,977,903,70,4,967,10,1900,923,295,672
32,"SATU MARE",305,136483,,25,"SATU MARE / ŞC. CU CLS.I-VIII"" MIRCEA ELIADE """,1,12918,"MUNICIPIUL SATU MARE",136483,1490,649,619,30,0,644,5,1600,951,167,477
32,"SATU MARE",305,136483,,26,"SATU MARE / ŞC. CU CLS.I-VIII"" MIRCEA ELIADE """,1,12918,"MUNICIPIUL SATU MARE",136483,1290,671,655,16,0,659,12,1400,729,220,439
32,"SATU MARE",305,136483,,27,"SATU MARE / GRĂDINIŢA CU PROGRAM PRELUNGIT NR. 9",1,12918,"MUNICIPIUL SATU MARE",136483,1343,716,670,45,1,713,3,1400,684,251,462
32,"SATU MARE",305,136483,,28,"SATU MARE / GRĂDINIŢA CU PROGRAM PRELUNGIT NR. 9",1,12918,"MUNICIPIUL SATU MARE",136483,1484,737,685,51,1,732,5,1600,863,196,536
32,"SATU MARE",305,136483,,29,"SATU MARE / ŞC. CU CLS.I-VIII "" BĂLCESCU-PETOFI """,1,12918,"MUNICIPIUL SATU MARE",136483,1448,838,787,51,0,828,10,1500,662,253,575
32,"SATU MARE",305,136483,,30,"SATU MARE / ŞC. CU CLS.I-VIII "" BĂLCESCU-PETOFI """,1,12918,"MUNICIPIUL SATU MARE",136483,1896,1042,1016,25,1,1034,8,1996,954,280,754
32,"SATU MARE",305,136483,,31,"SATU MARE / ŞC. CU CLS.I-VIII "" BĂLCESCU-PETOFI """,1,12918,"MUNICIPIUL SATU MARE",136483,1419,883,735,21,127,876,7,1600,717,288,588
32,"SATU MARE",305,136483,,32,"SATU MARE / GRĂDINIŢA CU PROGRAM PRELUNGIT NR.13",1,12918,"MUNICIPIUL SATU MARE",136483,1342,717,684,33,0,714,3,1400,683,208,506
32,"SATU MARE",305,136483,,33,"SATU MARE / GRĂDINIŢA CU PROGRAM PRELUNGIT NR. 5",1,12918,"MUNICIPIUL SATU MARE",136483,1200,634,599,35,0,628,6,1300,666,177,451
32,"SATU MARE",305,136483,,34,"SATU MARE / GRĂDINIŢA CU PROGRAM PRELUNGIT NR. 5",1,12918,"MUNICIPIUL SATU MARE",136483,1455,765,747,18,0,755,10,1600,835,224,531
32,"SATU MARE",305,136483,,35,"SATU MARE / GRĂDINIŢA CU PROGRAM PRELUNGIT ""VOINICELUL"" CORP "" B """,1,12918,"MUNICIPIUL SATU MARE",136483,1271,652,623,29,0,646,6,1399,747,213,433
32,"SATU MARE",305,136483,,36,"SATU MARE / ŞC. CU CLS.I-VIII"" AVRAM IANCU """,1,12918,"MUNICIPIUL SATU MARE",136483,1226,784,731,53,0,778,6,1300,516,274,504
32,"SATU MARE",305,136483,,37,"SATU MARE / ŞC. CU CLS.I-VIII"" AVRAM IANCU """,1,12918,"MUNICIPIUL SATU MARE",136483,1400,824,770,54,0,816,8,1500,676,261,555
32,"SATU MARE",305,136483,,38,"SATU MARE / ŞC. CU CLS.I-VIII"" AVRAM IANCU """,1,12918,"MUNICIPIUL SATU MARE",136483,1570,928,894,34,0,920,8,1700,772,284,636
32,"SATU MARE",305,136483,,39,"SATU MARE / ŞC. CU CLS.I-VIII"" AVRAM IANCU """,1,12918,"MUNICIPIUL SATU MARE",136483,1397,762,734,28,0,759,3,1500,738,200,559
32,"SATU MARE",305,136483,,40,"SATU MARE / GRĂDINIŢA CU PROGRAM PRELUNGIT ''VOINICELUL""",1,12918,"MUNICIPIUL SATU MARE",136483,1424,755,720,34,1,745,10,1499,744,238,507
32,"SATU MARE",305,136483,,41,"SATU MARE / GRUPUL ŞCOLAR DE IND. ALIMENTARĂ ""GEORGE EMIL PALADE""",1,12918,"MUNICIPIUL SATU MARE",136483,1472,792,745,45,2,789,3,1600,808,225,564
32,"SATU MARE",305,136483,,42,"SATU MARE / GRUPUL ŞCOLAR DE IND. ALIMENTARĂ ""GEORGE EMIL PALADE""",1,12918,"MUNICIPIUL SATU MARE",136483,1433,812,764,48,0,811,1,1500,688,257,554
32,"SATU MARE",305,136483,,43,"SATU MARE / GRUPUL ŞCOLAR DE IND. ALIMENTARĂ ""GEORGE EMIL PALADE""",1,12918,"MUNICIPIUL SATU MARE",136483,1531,846,833,13,0,841,5,1600,754,273,568
32,"SATU MARE",305,136483,,44,"SATU MARE / GRUPUL ŞCOLAR DE IND. ALIMENTARĂ ""GEORGE EMIL PALADE""",1,12918,"MUNICIPIUL SATU MARE",136483,1404,777,753,24,0,769,8,1500,723,229,540
32,"SATU MARE",305,136483,,45,"SATU MARE / GRUPUL ŞCOLAR DE IND. ALIMENTARĂ ""GEORGE EMIL PALADE""",1,12918,"MUNICIPIUL SATU MARE",136483,1552,837,802,35,0,830,7,1600,763,231,599
32,"SATU MARE",305,136483,,46,"SĂTMĂREL / ŞC. CU CLS.I-VIII - SĂTMĂREL",1,12918,"MUNICIPIUL SATU MARE",136483,1156,616,597,17,2,608,8,1200,584,301,307
32,"SATU MARE",305,136483,,47,"SATU MARE / ASOCIAŢIA JUDEŢEANĂ DE FOTBAL ( ŞC. NR.15 )",1,12918,"MUNICIPIUL SATU MARE",136483,1703,1029,961,67,1,1025,4,1800,771,187,838
32,"SATU MARE",305,136483,,48,"SATU MARE / SECŢIA DE DRUMURI NAŢIONALE",1,12918,"MUNICIPIUL SATU MARE",136483,1657,969,925,44,0,966,3,1701,732,221,745
32,"SATU MARE",305,136483,,49,"SATU MARE / SC. CU CL. I-VIII ""DR. V. LUCACIU""",1,12918,"MUNICIPIUL SATU MARE",136483,1424,842,791,51,0,833,9,1500,658,179,654
32,"SATU MARE",305,136483,,50,"SATU MARE / GRĂDINIŢA NR.15",1,12918,"MUNICIPIUL SATU MARE",136483,1209,738,704,33,1,735,3,1298,560,164,571
32,"SATU MARE",305,136483,,51,"SATU MARE / LICEUL TEOLOGIC""NICOLAE STEINHARDT """,1,12918,"MUNICIPIUL SATU MARE",136483,1667,792,745,47,0,786,6,1800,1008,222,564
32,"SATU MARE",305,136483,,52,"SATU MARE / LICEUL TEOLOGIC""NICOLAE STEINHARDT """,1,12918,"MUNICIPIUL SATU MARE",136483,1558,851,825,26,0,843,8,1700,849,257,586
32,"SATU MARE",305,136483,,53,"SATU MARE / GRĂDINIŢA CU PROGRAM PRELUNGIT NR.12",1,12918,"MUNICIPIUL SATU MARE",136483,1424,796,668,20,108,791,5,1600,804,226,565
32,"SATU MARE",305,136483,,54,"SATU MARE / ŞC. CU CLS.I-VIII "" DR. VASILE LUCACIU """,1,12918,"MUNICIPIUL SATU MARE",136483,1243,739,694,44,1,738,1,1299,560,176,562
32,"SATU MARE",305,136483,,55,"SATU MARE / ŞC. CU CLS.I-VIII "" DR. VASILE LUCACIU """,1,12918,"MUNICIPIUL SATU MARE",136483,1043,662,618,44,0,654,8,1100,438,159,495
32,"SATU MARE",305,136483,,56,"SATU MARE / GRĂDINIŢA CU PROGRAM PRELUNGIT - "" 14 MAI """,1,12918,"MUNICIPIUL SATU MARE",136483,1662,827,794,31,2,821,6,1800,973,292,529
32,"SATU MARE",305,136483,,57,"SATU MARE / GRĂDINIŢA CU PROGRAM PRELUNGIT - "" 14 MAI """,1,12918,"MUNICIPIUL SATU MARE",136483,1169,599,576,23,0,594,5,1200,601,166,428
32,"SATU MARE",305,136483,,58,"SATU MARE / GRUP SCOLAR ""CONSTANTIN BRANCUSI"" SATU MARE",1,12918,"MUNICIPIUL SATU MARE",136483,1508,974,879,87,8,963,11,1701,727,281,682
32,"SATU MARE",305,136483,,59,"SATU MARE / LICEUL CU PROGRAM SPORTIV",1,12918,"MUNICIPIUL SATU MARE",136483,1197,731,687,44,0,725,6,1296,565,144,581
32,"SATU MARE",305,136483,,60,"SATU MARE / ŞC. CU CLS.I-VIII"" GRIGORE MOISIL """,1,12918,"MUNICIPIUL SATU MARE",136483,1176,956,657,80,219,949,7,1556,600,421,528
32,"SATU MARE",305,136483,,61,"SATU MARE / ŞC. CU CLS.I-VIII"" GRIGORE MOISIL """,1,12918,"MUNICIPIUL SATU MARE",136483,1097,856,603,38,215,845,11,1400,544,385,460
32,"SATU MARE",305,136483,,62,"SATU MARE / COLEGIUL TEHNIC  DE TRANSP. ŞI TELECOMUNICAŢII "" I.C. BRĂTIANU """,1,12918,"MUNICIPIUL SATU MARE",136483,1397,876,785,64,27,863,13,1600,724,290,573
32,"SATU MARE",305,136483,,63,"SATU MARE / GRUP ŞC. TEOLOGIC ROM.-CAT. "" HAM JANOS """,1,12918,"MUNICIPIUL SATU MARE",136483,1003,568,498,60,10,560,8,1101,533,180,380
32,"SATU MARE",305,136483,,64,"SATU MARE / LICEUL TEOLOGIC REFORMAT",1,12918,"MUNICIPIUL SATU MARE",136483,1031,719,587,51,81,710,9,1199,480,179,531
32,"SATU MARE",305,136483,,65,"SATU MARE / GRĂDINIŢA ""DUMBRAVA MINUNATĂ""",1,12918,"MUNICIPIUL SATU MARE",136483,1301,780,760,20,0,778,2,1400,620,196,582
32,"SATU MARE",305,136483,,66,"SATU MARE / COLEGIUL NAŢIONAL"" D-NA STANCA """,1,12918,"MUNICIPIUL SATU MARE",136483,996,567,501,65,1,563,4,1101,534,169,394
32,"SATU MARE",305,136483,,67,"SATU MARE / ŞC. CU CLS.I-VIII NR. 10",1,12918,"MUNICIPIUL SATU MARE",136483,1203,726,690,35,1,725,1,1300,574,107,618
32,"SATU MARE",305,136483,,68,"SATU MARE / ŞC. CU CLS.I-VIII NR. 10",1,12918,"MUNICIPIUL SATU MARE",136483,1587,965,914,51,0,955,10,1700,735,198,757
32,"SATU MARE",305,136483,,69,"SATU MARE / ŞC. CU CLS.I-VIII "" C. BRÎNCOVEANU """,1,12918,"MUNICIPIUL SATU MARE",136483,1638,1017,943,74,0,1005,12,1800,783,340,665
32,"SATU MARE",305,136483,,70,"SATU MARE / COLEGIUL NAŢIONAL"" MIHAI  EMINESCU """,1,12918,"MUNICIPIUL SATU MARE",136483,1169,675,592,83,0,666,9,1200,525,235,431
32,"SATU MARE",305,136483,,71,"SATU MARE / GRUP ŞC. ECONOMIC"" GHEORGHE DRAGOŞ """,1,12918,"MUNICIPIUL SATU MARE",136483,1547,1016,924,79,13,1005,11,1700,684,328,677
32,"SATU MARE",305,136483,,72,"SATU MARE / GRĂDINIŢA CU PROGRAM PRELUNGIT",1,12918,"MUNICIPIUL SATU MARE",136483,1156,661,625,36,0,654,7,1300,639,216,438
32,"SATU MARE",305,136483,,73,"SATU MARE / GRĂDINIŢA CU PROGRAM PRELUNGIT",1,12918,"MUNICIPIUL SATU MARE",136483,1135,562,544,16,2,556,6,1200,638,158,398
32,"SATU MARE",305,136483,,74,"SATU MARE / GRĂDINIŢA CU PROGRAM PRELUNGIT",1,12918,"MUNICIPIUL SATU MARE",136483,1217,646,629,17,0,642,4,1300,654,224,418
32,"SATU MARE",305,136526,,75,"CAREI / LICEUL ROMANO-CATOLIC""JOSEPHUS CALASANTIUS""",1,12921,"MUNICIPIUL CAREI",136526,1670,885,829,56,0,870,15,1800,915,294,576
32,"SATU MARE",305,136526,,76,"CAREI / COLEGIUL TEHNIC ""IULIU MANIU""",1,12921,"MUNICIPIUL CAREI",136526,1445,743,722,20,1,735,8,1600,857,249,486
32,"SATU MARE",305,136526,,77,"CAREI / LICEUL TEHNOLOGIC ""SIMION BĂRNUŢIU""",1,12921,"MUNICIPIUL CAREI",136526,1615,837,795,42,0,830,7,1700,863,244,586
32,"SATU MARE",305,136526,,78,"CAREI / ŞCOALA GIMNAZIALĂ NR.1",1,12921,"MUNICIPIUL CAREI",136526,1723,903,834,68,1,895,8,1801,898,292,603
32,"SATU MARE",305,136526,,79,"CAREI / ŞCOALA GIMNAZIALĂ ""VASILE LUCACIU"" NR.2",1,12921,"MUNICIPIUL CAREI",136526,1904,946,912,34,0,941,5,2000,1054,277,664
32,"SATU MARE",305,136526,,80,"CAREI / GRĂDINIŢA CU PROGRAM NORMAL NR.9",1,12921,"MUNICIPIUL CAREI",136526,1257,634,600,34,0,633,1,1400,766,175,458
32,"SATU MARE",305,136526,,81,"CAREI / GRĂDINIŢA CU PROGRAM NORMAL NR.10",1,12921,"MUNICIPIUL CAREI",136526,1978,923,876,46,1,912,11,2100,1177,270,642
32,"SATU MARE",305,136526,,82,"CAREI / ŞCOALA GIMNAZIALĂ NR.3",1,12921,"MUNICIPIUL CAREI",136526,1677,990,935,55,0,981,9,1800,810,322,659
32,"SATU MARE",305,136526,,83,"CAREI / LICEUL TEORETIC CAREI",1,12921,"MUNICIPIUL CAREI",136526,1431,649,597,52,0,644,5,1600,951,200,444
32,"SATU MARE",305,136526,,84,"CAREI / GRĂDINIŢA CU PROGRAM NORMAL NR.5",1,12921,"MUNICIPIUL CAREI",136526,1891,1042,882,78,82,1032,10,2100,1058,365,667
32,"SATU MARE",305,136526,,85,"CAREI / GRĂDINIŢA CU PROGRAM NORMAL NR.8",1,12921,"MUNICIPIUL CAREI",136526,1161,611,579,32,0,608,3,1300,689,174,434
32,"SATU MARE",305,136526,,86,"CAREI / MUZEUL MUNICIPAL CAREI",1,12921,"MUNICIPIUL CAREI",136526,1990,1058,1015,43,0,1050,8,2100,1042,314,736
32,"SATU MARE",305,136526,,87,"CAREI / SCOALA GENERALA NR4",1,12921,"MUNICIPIUL CAREI",136526,1048,463,442,21,0,460,3,1100,637,125,335
32,"SATU MARE",305,136526,,88,"IANCULEŞTI / GRĂDINIŢA CU PROGRAM NORMAL IANCULEŞTI",1,12921,"MUNICIPIUL CAREI",136526,307,206,181,25,0,205,1,400,194,110,95
32,"SATU MARE",305,136848,,89,"ARDUD / liceul tehnologic",1,12924,"ORAŞ ARDUD",136848,1957,1033,980,53,0,1024,9,2000,967,318,706
32,"SATU MARE",305,136848,,90,"ARDUD / biblioteca ardud",1,12924,"ORAŞ ARDUD",136848,1911,1016,970,46,0,1006,10,2000,984,229,777
32,"SATU MARE",305,136848,,91,"BABA NOVAC / scoala generală baba novac",1,12924,"ORAŞ ARDUD",136848,475,295,260,32,3,294,1,500,205,135,159
32,"SATU MARE",305,136848,,92,"GERĂUŞA / scoala generală gerăuşa",1,12924,"ORAŞ ARDUD",136848,442,290,255,35,0,289,1,500,210,125,164
32,"SATU MARE",305,136848,,93,"MĂDĂRAS / scoala generală mădăras",1,12924,"ORAŞ ARDUD",136848,917,561,520,41,0,553,8,1000,439,271,282
32,"SATU MARE",305,138039,,94,"LIVADA / SCOALA GIMNAZIALĂ ""PETOFI SANDOR"" LIVADA",1,12931,"ORAŞ LIVADA",138039,1022,496,473,23,0,495,1,1100,604,87,408
32,"SATU MARE",305,138039,,95,"LIVADA / Gradinita cu program normal Livada",1,12931,"ORAŞ LIVADA",138039,1423,694,660,34,0,687,7,1500,806,172,515
32,"SATU MARE",305,138039,,96,"LIVADA / ŞCOALA GIMNAZIALĂ PETOFI SANDOR LIVADA",1,12931,"ORAŞ LIVADA",138039,1658,810,747,63,0,804,6,1800,990,159,645
32,"SATU MARE",305,138039,,97,"ADRIAN / ŞCOALA PRIMARĂ ADRIAN",1,12931,"ORAŞ LIVADA",138039,431,233,212,21,0,232,1,500,267,42,190
32,"SATU MARE",305,138039,,98,"DUMBRAVA / ŞCOALA GIMNAZIALĂ ""IOSIF ŢIPROC"" DUMBRAVA",1,12931,"ORAŞ LIVADA",138039,921,467,435,32,0,463,4,1000,533,237,226
32,"SATU MARE",305,138039,,99,"LIVADA MICĂ / GRĂDINIŢA LIVADA MICĂ",1,12931,"ORAŞ LIVADA",138039,252,164,139,25,0,163,1,300,136,70,93
32,"SATU MARE",305,136599,,100,"NEGREŞTI-OAŞ / SCOALA GEN.NR,2",1,12936,"ORAŞ NEGREŞTI-OAŞ",136599,1072,441,358,83,0,437,4,1200,759,200,237
32,"SATU MARE",305,136599,,101,"NEGREŞTI-OAŞ / SCOALA GEN.NR,2",1,12936,"ORAŞ NEGREŞTI-OAŞ",136599,1172,465,386,78,1,459,6,1300,835,240,219
32,"SATU MARE",305,136599,,102,"NEGREŞTI-OAŞ / SCOALA GEN.NR,3",1,12936,"ORAŞ NEGREŞTI-OAŞ",136599,1450,664,587,77,0,662,2,1600,936,297,365
32,"SATU MARE",305,136599,,103,"NEGREŞTI-OAŞ / SCOALA GEN.NR.3",1,12936,"ORAŞ NEGREŞTI-OAŞ",136599,1388,526,464,62,0,523,3,1500,974,243,280
32,"SATU MARE",305,136599,,104,"NEGREŞTI-OAŞ / Scoala generala nr.3",1,12936,"ORAŞ NEGREŞTI-OAŞ",136599,1458,674,620,49,5,668,6,1600,926,268,400
32,"SATU MARE",305,136599,,105,"NEGREŞTI-OAŞ / SCOALA GEN.NR.1",1,12936,"ORAŞ NEGREŞTI-OAŞ",136599,1061,542,485,56,1,537,5,1200,658,214,323
32,"SATU MARE",305,136599,,106,"NEGREŞTI-OAŞ / SCOALA GEN,NR.1",1,12936,"ORAŞ NEGREŞTI-OAŞ",136599,1015,626,485,60,81,615,11,1100,474,272,343
32,"SATU MARE",305,136599,,107,"NEGREŞTI-OAŞ / LICEUL TEORETIC",1,12936,"ORAŞ NEGREŞTI-OAŞ",136599,1210,624,539,84,1,612,12,1300,676,248,364
32,"SATU MARE",305,136599,,108,"NEGREŞTI-OAŞ / LICEUL TEORETIC",1,12936,"ORAŞ NEGREŞTI-OAŞ",136599,1243,546,481,64,1,544,2,1400,854,247,297
32,"SATU MARE",305,136599,,109,"NEGREŞTI-OAŞ / LICEUL TEORETIC",1,12936,"ORAŞ NEGREŞTI-OAŞ",136599,1278,663,576,87,0,657,6,1400,737,340,317
32,"SATU MARE",305,136599,,110,"TUR / SCOALA GEN.TUR",1,12936,"ORAŞ NEGREŞTI-OAŞ",136599,1617,570,510,60,0,565,5,1800,1230,334,231
32,"SATU MARE",305,136642,,111,"TĂŞNAD / ŞCOALA GIMNAZIALĂ TĂŞNAD",1,12940,"ORAŞ TĂŞNAD",136642,1264,812,743,50,19,807,5,1400,588,270,537
32,"SATU MARE",305,136642,,112,"TĂŞNAD / ŞCOALA GIMNAZIALĂ TĂŞNAD",1,12940,"ORAŞ TĂŞNAD",136642,1655,871,823,47,1,864,7,1800,929,287,577
32,"SATU MARE",305,136642,,113,"TĂŞNAD / ŞCOALA GIMNAZIALĂ TĂŞNAD",1,12940,"ORAŞ TĂŞNAD",136642,1714,991,948,38,5,983,8,1800,809,311,672
32,"SATU MARE",305,136642,,114,"TĂŞNAD / CASA DE CULTURĂ",1,12940,"ORAŞ TĂŞNAD",136642,1740,1111,1022,83,6,1087,24,1900,789,410,677
32,"SATU MARE",305,136642,,115,"BLAJA / GRĂDINIŢA CU PROGRAM NORMAL BLAJA",1,12940,"ORAŞ TĂŞNAD",136642,187,132,105,20,7,132,0,200,68,55,77
32,"SATU MARE",305,136642,,116,"CIG / GRĂDINIŢA CU PROGRAM NORMAL CIG",1,12940,"ORAŞ TĂŞNAD",136642,374,222,201,15,6,220,2,400,178,107,113
32,"SATU MARE",305,136642,,117,"SĂRĂUAD / ŞCOALA GIMNAZIALĂ SĂRĂUAD",1,12940,"ORAŞ TĂŞNAD",136642,805,534,497,23,14,527,7,900,366,309,218
32,"SATU MARE",305,136642,,118,"VALEA MORII / GRĂDINIŢA CU PROGRAM NORMAL VALEA MORII",1,12940,"ORAŞ TĂŞNAD",136642,156,105,90,15,0,104,1,200,95,40,64
32,"SATU MARE",305,136713,,119,"ACÎŞ / PRIMĂRIA COMUNEI ACÂŞ",3,12947,"ACÎŞ",136713,1485,803,741,62,0,787,16,1600,797,295,492
32,"SATU MARE",305,136713,,120,"MIHĂIENI / ŞCOALA GENERALĂ MIHAIENI",3,12947,"ACÎŞ",136713,382,169,138,31,0,166,3,400,231,55,111
32,"SATU MARE",305,136713,,121,"UNIMĂT / ŞCOALA GENERALĂ UNIMĂT",3,12947,"ACÎŞ",136713,339,267,202,53,12,263,4,400,133,143,120
32,"SATU MARE",305,179873,,122,"AGRIŞ / PRIMARIA AGRIS",3,12952,"AGRIŞ",179873,911,440,413,27,0,436,4,1000,560,58,378
32,"SATU MARE",305,179873,,123,"AGRIŞ / SCOALA CU CLASELE I-IV AGRIS",3,12952,"AGRIŞ",179873,212,112,98,14,0,112,0,300,188,48,64
32,"SATU MARE",305,179873,,124,"CIUPERCENI / SC. GEN. CIUPERCENI",3,12952,"AGRIŞ",179873,466,211,191,20,0,209,2,500,289,35,174
32,"SATU MARE",305,136768,,125,"ANDRID / SC. GIMNAZIALA ANDRID",3,12955,"ANDRID",136768,994,590,551,39,0,583,7,1100,510,247,336
32,"SATU MARE",305,136768,,126,"DINDEŞTI / SC. PRIMARA DINDESTI",3,12955,"ANDRID",136768,604,387,343,43,1,384,3,700,313,122,262
32,"SATU MARE",305,136768,,127,"IRINA / SC. GIMNAZIALA IRINA",3,12955,"ANDRID",136768,405,207,192,15,0,206,1,500,293,76,130
32,"SATU MARE",305,136802,,128,"APA / Centru Cultural ""Emil Matei"" Apa",3,12959,"APA",136802,1070,667,574,79,14,661,6,1199,532,258,403
32,"SATU MARE",305,136802,,129,"APA / Scoala Gimnazială ""Vasile Lucaciu"" Apa",3,12959,"APA",136802,823,541,471,54,16,533,8,900,359,321,212
32,"SATU MARE",305,136802,,130,"SOMEŞENI / GRĂDINIŢA DIN SATUL SOMEŞENI",3,12959,"APA",136802,244,169,143,24,2,169,0,300,131,90,79
32,"SATU MARE",305,136919,,131,"BĂTARCI / Scoala Gimnaziala Bătarci",3,12963,"BĂTARCI",136919,1849,811,776,35,0,802,9,2000,1189,374,428
32,"SATU MARE",305,136919,,132,"COMLĂUŞA / CĂMINUL CULTURAL  COMLĂUŞA",3,12963,"BĂTARCI",136919,896,385,363,22,0,378,7,1000,615,178,200
32,"SATU MARE",305,136919,,133,"TĂMĂŞENI / ŞCOALA PRIMARĂ TĂMĂŞENI",3,12963,"BĂTARCI",136919,329,223,193,30,0,220,3,400,177,51,169
32,"SATU MARE",305,136964,,134,"BELTIUG / SCOALA GIMNAZIALA  BELTIUG",3,12968,"BELTIUG",136964,1127,688,600,76,12,682,6,1200,512,121,561
32,"SATU MARE",305,136964,,135,"BOLDA / CĂMINUL CULTURAL BOLDA",3,12968,"BELTIUG",136964,51,50,26,24,0,49,1,100,50,21,28
32,"SATU MARE",305,136964,,136,"GHIRIŞA / ŞCOALA PRIMARĂ GHIRIŞA",3,12968,"BELTIUG",136964,574,338,291,33,14,334,4,600,262,56,278
32,"SATU MARE",305,136964,,137,"GIUNGI / CĂMINUL CULTURAL GIUNGI",3,12968,"BELTIUG",136964,120,94,61,28,5,92,2,200,106,44,48
32,"SATU MARE",305,136964,,138,"RĂTEŞTI / ŞCOALA GIMNAZIALĂ RĂTEŞTI",3,12968,"BELTIUG",136964,625,336,305,30,1,330,6,700,364,101,229
32,"SATU MARE",305,136964,,139,"ŞANDRA / GRĂDINIŢA DE COPII ŞANDRA",3,12968,"BELTIUG",136964,213,118,98,20,0,118,0,300,182,55,63
32,"SATU MARE",305,137032,,140,"BERVENI / SCOALA GENERALA BERVENI",3,12975,"BERVENI",137032,1744,585,568,17,0,580,5,1900,1315,95,485
32,"SATU MARE",305,137032,,141,"LUCĂCENI / SCOALA GENERALA LUCACENI",3,12975,"BERVENI",137032,1262,628,571,45,12,623,5,1400,772,373,250
32,"SATU MARE",305,137069,,142,"BIXAD / SCOALA GENERALA BIXAD",3,12981,"BIXAD",137069,1248,372,355,17,0,366,6,1400,1028,89,277
32,"SATU MARE",305,137069,,143,"BIXAD / SCOALA GENERALA BIXAD",3,12981,"BIXAD",137069,1162,420,388,31,1,418,2,1300,880,123,295
32,"SATU MARE",305,137069,,144,"BOINEŞTI / BOINESTI SCOALA GENERALA",3,12981,"BIXAD",137069,1403,443,413,30,0,441,2,1500,1057,137,304
32,"SATU MARE",305,137069,,145,"TRIP / TRIP SCOALA GENERALA",3,12981,"BIXAD",137069,1340,480,441,39,0,476,4,1500,1020,167,309
32,"SATU MARE",305,137069,,146,"TRIP / TRIP SCOALA GENERALA",3,12981,"BIXAD",137069,1080,304,283,21,0,304,0,1200,896,85,219
32,"SATU MARE",305,137103,,147,"BÎRSĂU DE SUS / PRIMARIA BÂRSĂU",3,12978,"BÎRSĂU",137103,1380,954,821,72,61,943,11,1500,546,510,433
32,"SATU MARE",305,137103,,148,"BÎRSĂU DE JOS / SEDIU ADMINISTRATIV",3,12978,"BÎRSĂU",137103,539,338,271,51,16,328,10,599,261,148,180
32,"SATU MARE",305,137130,,149,"BOGDAND / PRIMARIA COMUNEI BOGDAND",3,12985,"BOGDAND",137130,803,331,315,16,0,329,2,900,569,25,304
32,"SATU MARE",305,137130,,150,"BABŢA / ŞCOALA CU CLASELE I-VIII",3,12985,"BOGDAND",137130,561,375,307,67,1,371,4,600,225,202,169
32,"SATU MARE",305,137130,,151,"CORUND / ŞCOALA CU CLASELE I-VIII",3,12985,"BOGDAND",137130,370,241,220,20,1,234,7,400,159,152,82
32,"SATU MARE",305,137130,,152,"SER / ŞCOALA CU CLASELE I-IV",3,12985,"BOGDAND",137130,592,190,168,22,0,190,0,700,510,22,168
32,"SATU MARE",305,137185,,153,"BOTIZ / PRIMARIA BOTIZ",3,12990,"BOTIZ",137185,1427,772,713,53,6,769,3,1500,728,161,608
32,"SATU MARE",305,137185,,154,"BOTIZ / SCOALA CU CLASELE I-IV OSVAREU",3,12990,"BOTIZ",137185,1592,872,801,68,3,856,16,1800,928,250,606
32,"SATU MARE",305,137229,,155,"CĂLINEŞTI-OAŞ / PRIMARIA CALINESTI OAS",3,12992,"CĂLINEŞTI-OAŞ",137229,1334,577,551,21,5,573,4,1500,923,220,353
32,"SATU MARE",305,137229,,156,"COCA / SCOALA COCA",3,12992,"CĂLINEŞTI-OAŞ",137229,831,325,301,20,4,321,4,900,575,120,201
32,"SATU MARE",305,137229,,157,"LECHINŢA / SCOALA LECHINTA",3,12992,"CĂLINEŞTI-OAŞ",137229,651,302,283,14,5,300,2,700,398,139,161
32,"SATU MARE",305,137229,,158,"PĂŞUNEA MARE / SCOALA PASUNEA MARE",3,12992,"CĂLINEŞTI-OAŞ",137229,300,106,90,16,0,106,0,300,194,34,72
32,"SATU MARE",305,137229,,159,"CĂLINEŞTI-OAŞ / SPCLEP CALINESTI OAS",3,12992,"CĂLINEŞTI-OAŞ",137229,859,393,363,26,4,392,1,900,507,127,265
32,"SATU MARE",305,137274,,160,"CĂMĂRZANA / PRIMARIA COM. CAMARZANA",3,12997,"CĂMĂRZANA",137274,1085,388,320,29,39,384,4,1200,812,81,303
32,"SATU MARE",305,137274,,161,"CĂMĂRZANA / SCOALA GENERALA CAMARZANA",3,12997,"CĂMĂRZANA",137274,923,363,308,25,30,359,4,1000,637,80,279
32,"SATU MARE",305,179677,,162,"CĂMIN / Scoala Gimnaziala Camin",3,12999,"CĂMIN",179677,1177,647,634,13,0,644,3,1300,653,69,575
32,"SATU MARE",305,136553,,163,"CĂPLENI / PRIMĂRIA COMUNEI CĂPLENI",3,13001,"CĂPLENI",136553,1244,541,523,18,0,538,3,1416,875,27,511
32,"SATU MARE",305,136553,,164,"CĂPLENI / Scoala cu cls. I-VIII Căpleni",3,13001,"CĂPLENI",136553,1459,659,637,22,0,655,4,1600,941,73,582
32,"SATU MARE",305,137292,,165,"CĂUAŞ / SCOALA GENERALA",3,13003,"CĂUAŞ",137292,550,365,325,40,0,358,7,600,235,198,160
32,"SATU MARE",305,137292,,166,"ADY ENDRE / CAMINUL CULTURAL",3,13003,"CĂUAŞ",137292,118,63,45,18,0,63,0,200,137,28,35
32,"SATU MARE",305,137292,,167,"GHENCI / CAMIN CULTURAL",3,13003,"CĂUAŞ",137292,1042,494,458,36,0,489,5,1200,706,68,421
32,"SATU MARE",305,137292,,168,"GHILEŞTI / SCOALA GENERALA",3,13003,"CĂUAŞ",137292,78,62,42,20,0,60,2,100,38,33,27
32,"SATU MARE",305,137292,,169,"HOTOAN / CAMINUL CULTURAL",3,13003,"CĂUAŞ",137292,147,109,83,26,0,109,0,200,91,53,56
32,"SATU MARE",305,137292,,170,"RĂDULEŞTI / SCOALA GENERALA",3,13003,"CĂUAŞ",137292,93,71,47,24,0,71,0,100,29,30,41
32,"SATU MARE",305,137363,,171,"CEHĂLUŢ / CAMIN CULTURAL",3,13010,"CEHAL",137363,527,297,274,11,12,296,1,600,303,80,216
32,"SATU MARE",305,137363,,172,"CEHAL / SCOALA CEHAL",3,13010,"CEHAL",137363,678,494,439,35,20,490,4,700,206,284,206
32,"SATU MARE",305,137363,,173,"ORBĂU / CLADIRE PRIMARIE",3,13010,"CEHAL",137363,200,144,122,16,6,144,0,300,156,99,45
32,"SATU MARE",305,137407,,174,"CERTEZE / SCOALA GIMNAZIALA CERTEZE",3,13014,"CERTEZE",137407,1526,412,380,32,0,408,4,1700,1288,158,250
32,"SATU MARE",305,137407,,175,"CERTEZE / SCOALA GIMNAZIALA CERTEZE",3,13014,"CERTEZE",137407,1267,409,365,44,0,405,4,1400,991,172,233
32,"SATU MARE",305,137407,,176,"HUTA CERTEZE / GRĂDINIŢA CU PROGRAM HUTA CERTEZE",3,13014,"CERTEZE",137407,942,396,354,42,0,391,5,1000,604,151,240
32,"SATU MARE",305,137407,,177,"MOIŞENI / GRĂDINIŢA CU PROGRAM NORMAL MOIŞENI",3,13014,"CERTEZE",137407,1122,318,297,21,0,314,4,1199,881,171,143
32,"SATU MARE",305,179882,,178,"CIUMEŞTI / CĂMINUL CULTURAL",3,13018,"CIUMEŞTI",179882,1110,467,437,30,0,463,4,1200,733,75,388
32,"SATU MARE",305,137443,,179,"CRAIDOROLŢ / PRIMARIA CRAIDOROLT",3,13022,"CRAIDOROLŢ",137443,867,469,427,42,0,466,3,1000,531,272,194
32,"SATU MARE",305,137443,,180,"CRIŞENI / ŞCOALA PRIMARĂ CRIŞENI",3,13022,"CRAIDOROLŢ",137443,150,101,77,24,0,97,4,200,99,64,33
32,"SATU MARE",305,137443,,181,"ERIU SÎNCRAI / ŞCOALA PRIMARĂ ERIU SÂNCRAI",3,13022,"CRAIDOROLŢ",137443,499,262,244,18,0,261,1,500,238,121,140
32,"SATU MARE",305,137443,,182,"SATU MIC / ŞCOALA PRIMARĂ SATU MIC",3,13022,"CRAIDOROLŢ",137443,170,114,97,17,0,114,0,200,86,87,27
32,"SATU MARE",305,137504,,183,"CRUCIŞOR / SCOALA CU CLASELE I-IV CRUCISOR",3,13028,"CRUCIŞOR",137504,469,331,276,35,20,328,3,500,169,166,162
32,"SATU MARE",305,137504,,184,"IEGHERIŞTE / SCOALA CU CLS. I-IV IEGHERISTE",3,13028,"CRUCIŞOR",137504,450,318,273,26,19,318,0,500,182,153,165
32,"SATU MARE",305,137504,,185,"POIANA CODRULUI / SCOALA GIMNAZIALA POIANA CODRULUI",3,13028,"CRUCIŞOR",137504,1231,849,765,54,30,846,3,1400,551,519,327
32,"SATU MARE",305,137540,,186,"CULCIU MARE / SEDIUL CONSILIULUI LOCAL AL COMUNEI CULCIU",3,13032,"CULCIU",137540,652,386,354,32,0,378,8,696,310,170,208
32,"SATU MARE",305,137540,,187,"APATEU / GRADINIŢA  APATEU",3,13032,"CULCIU",137540,259,127,110,17,0,127,0,300,173,40,87
32,"SATU MARE",305,137540,,188,"CĂRĂŞEU / ŞCOALA DE GIMNAZIALĂ BEM JOZSEF CĂRĂŞEU",3,13032,"CULCIU",137540,947,394,374,20,0,387,7,1000,606,97,290
32,"SATU MARE",305,137540,,189,"COROD / GRADINIŢA COROD",3,13032,"CULCIU",137540,422,225,208,17,0,222,3,500,275,65,157
32,"SATU MARE",305,137540,,190,"CULCIU MIC / ŞCOALA PRIMARĂ CULCIU-MIC",3,13032,"CULCIU",137540,582,260,231,29,0,254,6,600,340,68,186
32,"SATU MARE",305,137540,,191,"LIPĂU / ŞCOALA PRIMARĂ LIPĂU",3,13032,"CULCIU",137540,457,335,270,58,7,332,3,500,165,136,196
32,"SATU MARE",305,137611,,192,"DOBA / PRIMARIA COMUNEI DOBA",3,13039,"DOBA",137611,1004,555,517,38,0,549,6,1100,545,205,344
32,"SATU MARE",305,137611,,193,"BOGHIŞ / ŞCOALA  GENERALĂ  BOGHIŞ",3,13039,"DOBA",137611,654,267,242,25,0,267,0,700,433,97,170
32,"SATU MARE",305,137611,,194,"DACIA / CĂMIN CULTURAL  DACIA",3,13039,"DOBA",137611,129,116,83,32,1,115,1,200,84,67,48
32,"SATU MARE",305,137611,,195,"PAULIAN / GRADINITA    PAULIAN",3,13039,"DOBA",137611,401,249,221,28,0,249,0,500,251,114,135
32,"SATU MARE",305,137611,,196,"TRAIAN / CĂMIN CULTURAL TRAIAN",3,13039,"DOBA",137611,161,93,78,15,0,92,1,200,107,52,40
32,"SATU MARE",305,137675,,197,"DOROLŢ / PRIMARIA COMUNEI DOROLT",3,13045,"DOROLŢ",137675,1459,668,623,45,0,663,5,1600,932,100,563
32,"SATU MARE",305,137675,,198,"ATEA / CAMIN CULTURAL ATEA",3,13045,"DOROLŢ",137675,318,168,157,11,0,167,1,400,232,55,112
32,"SATU MARE",305,137675,,199,"DARA / SCOALA DARA",3,13045,"DOROLŢ",137675,1010,428,412,16,0,424,4,1100,672,108,316
32,"SATU MARE",305,137675,,200,"PETEA / CAMIN CULTURAL PETEA",3,13045,"DOROLŢ",137675,321,161,148,13,0,161,0,400,239,34,127
32,"SATU MARE",305,137728,,201,"FOIENI / CONSILIUL LOCAL FOIENI",3,13050,"FOIENI",137728,1638,783,767,16,0,773,10,1800,1017,50,723
32,"SATU MARE",305,137746,,202,"GHERŢA MICĂ / PRIMARIA COMUNEI",3,13052,"GHERŢA MICĂ",137746,1478,538,503,23,12,534,4,1600,1062,256,278
32,"SATU MARE",305,137746,,203,"GHERŢA MICĂ / SCOALA GIMNAZIALA",3,13052,"GHERŢA MICĂ",137746,1163,421,403,13,5,414,7,1300,879,244,170
32,"SATU MARE",305,137764,,204,"HALMEU / Şcoala cu cls.I-VIII Halmeu",3,13054,"HALMEU",137764,1719,750,707,42,1,742,8,1900,1150,243,499
32,"SATU MARE",305,137764,,205,"HALMEU / Şcoala cu cls.I-VIII Halmeu",3,13054,"HALMEU",137764,1298,593,555,38,0,588,5,1400,807,168,420
32,"SATU MARE",305,137764,,206,"BĂBEŞTI / Grădiniţa Băbeşti",3,13054,"HALMEU",137764,325,161,144,17,0,156,5,400,239,46,110
32,"SATU MARE",305,137764,,207,"DOBOLŢ / GRĂDINIŢA DABOLŢ",3,13054,"HALMEU",137764,331,136,121,15,0,136,0,400,264,30,106
32,"SATU MARE",305,137764,,208,"MESTEACĂN / GRĂDINIŢA MESTEACĂN",3,13054,"HALMEU",137764,365,111,100,11,0,110,1,400,289,51,59
32,"SATU MARE",305,137844,,209,"HODOD / SEDIUL PRIMARIEI COMUNEI HODOD",3,13060,"HODOD",137844,704,355,313,42,0,353,2,800,445,46,307
32,"SATU MARE",305,137844,,210,"GIURTELECU HODODULUI / SCOALA GIMNAZIALA GIURTELECU HODODULUI",3,13060,"HODOD",137844,499,259,209,50,0,255,4,600,341,149,106
32,"SATU MARE",305,137844,,211,"LELEI / SCOALA PRIMARA LELEI",3,13060,"HODOD",137844,471,188,170,18,0,184,4,500,312,38,146
32,"SATU MARE",305,137844,,212,"NADIŞU HODODULUI / CENTRU SOCIAL NADISU HODODULUI",3,13060,"HODOD",137844,616,277,257,20,0,274,3,700,423,35,239
32,"SATU MARE",305,137899,,213,"HOMORODU DE MIJLOC / SCOALA CLS. I-VIII HOMORODU DE MIJLOC",3,13065,"HOMOROADE",137899,576,426,362,54,10,423,3,600,174,274,149
32,"SATU MARE",305,137899,,214,"CHILIA / SCOALA CHILIA",3,13065,"HOMOROADE",137899,197,157,108,39,10,157,0,200,43,94,63
32,"SATU MARE",305,137899,,215,"HOMORODU DE JOS / SCOALA CLS I-IV HOMORODU DE JOS",3,13065,"HOMOROADE",137899,303,199,161,35,3,199,0,400,201,91,108
32,"SATU MARE",305,137899,,216,"NECOPOI / SCOALA NECOPOI",3,13065,"HOMOROADE",137899,190,138,105,30,3,138,0,200,62,62,76
32,"SATU MARE",305,137899,,217,"SOLDUBA / SCOALA SOLDUBA",3,13065,"HOMOROADE",137899,224,174,131,30,13,173,1,300,126,103,70
32,"SATU MARE",305,137960,,218,"LAZURI / CAMIN CULTURAL NOU",3,13072,"LAZURI",137960,2310,1184,1128,55,1,1175,9,2500,1316,197,978
32,"SATU MARE",305,137960,,219,"BERCU / SCOALA CU CLASELE I-IV BERCU",3,13072,"LAZURI",137960,536,260,237,23,0,258,2,600,340,21,237
32,"SATU MARE",305,137960,,220,"NISIPENI / SCOALA CU CLASELE I-VIII NISIPENI",3,13072,"LAZURI",137960,727,318,295,23,0,314,4,800,482,52,262
32,"SATU MARE",305,137960,,221,"NOROIENI / SCOALA CU CLASELE I-IV NOROIENI",3,13072,"LAZURI",137960,315,141,124,17,0,141,0,400,259,25,116
32,"SATU MARE",305,137960,,222,"PELEŞ / SCOALA CU CLASELE I-VIII PELES",3,13072,"LAZURI",137960,759,304,279,25,0,297,7,800,496,58,239
32,"SATU MARE",305,137960,,223,"PELIŞOR / SCOALA CU CLASELE I-IV PELISOR",3,13072,"LAZURI",137960,211,94,79,15,0,92,2,300,206,30,62
32,"SATU MARE",305,138084,,224,"IOJIB / SCOALA GENERALA",3,13079,"MEDIEŞU AURIT",138084,904,496,474,22,0,491,5,1000,504,162,329
32,"SATU MARE",305,138084,,225,"MEDIEŞ RÎTURI / SCOALA GENERALA",3,13079,"MEDIEŞU AURIT",138084,236,148,128,17,3,148,0,300,152,72,76
32,"SATU MARE",305,138084,,226,"MEDIEŞ VII / SCOALA GENERALA",3,13079,"MEDIEŞU AURIT",138084,157,95,69,26,0,95,0,200,105,49,46
32,"SATU MARE",305,138084,,227,"POTĂU / SCOALA GENERALA",3,13079,"MEDIEŞU AURIT",138084,844,544,461,50,33,540,4,900,356,243,297
32,"SATU MARE",305,138084,,228,"ROMÂNEŞTI / SCOALA GENERALA",3,13079,"MEDIEŞU AURIT",138084,640,444,387,39,18,440,4,700,256,170,270
32,"SATU MARE",305,138084,,229,"MEDIEŞU AURIT / PRIMARIA MEDIESU AURIT",3,13079,"MEDIEŞU AURIT",138084,939,616,547,58,11,616,0,1000,384,339,277
32,"SATU MARE",305,138084,,230,"MEDIEŞU AURIT / SCOALA MEDIESU AURIT",3,13079,"MEDIEŞU AURIT",138084,1218,756,671,51,34,748,8,1300,544,466,282
32,"SATU MARE",305,138084,,231,"BĂBĂŞEŞTI / GRADINITA",3,13079,"MEDIEŞU AURIT",138084,517,339,287,47,5,337,2,600,261,193,144
32,"SATU MARE",305,138164,,232,"MICULA / CENTRU CULTURAL TURISTIC",3,13087,"MICULA",138164,1182,550,518,32,0,544,6,1300,750,115,429
32,"SATU MARE",305,138164,,233,"MICULA / GRADINITA NR. II MICULA",3,13087,"MICULA",138164,1379,631,598,33,0,623,8,1500,869,223,400
32,"SATU MARE",305,138164,,234,"MICULA NOUĂ / SCOALA GENERALA MICULA NOUA",3,13087,"MICULA",138164,587,290,241,49,0,288,2,600,310,131,157
32,"SATU MARE",305,138208,,235,"MOFTINU MARE / SCOALA GENERALA",3,13091,"MOFTIN",138208,1159,531,471,60,0,527,4,1300,769,107,420
32,"SATU MARE",305,138208,,236,"MOFTINU MIC / CAMINUL CULTURAL",3,13091,"MOFTIN",138208,1049,593,552,41,0,592,1,1200,607,285,307
32,"SATU MARE",305,138208,,237,"DOMĂNEŞTI / SCOALA  GENERALA CL I-VIIII",3,13091,"MOFTIN",138208,904,513,485,28,0,512,1,1000,487,254,258
32,"SATU MARE",305,138208,,238,"SÎNMICLĂUŞ / GRADINITA DE COPII",3,13091,"MOFTIN",138208,438,239,206,33,0,238,1,500,261,141,97
32,"SATU MARE",305,138280,,239,"ODOREU / Gradinita de copii",3,13099,"ODOREU",138280,1976,1167,1087,68,12,1154,13,2200,1033,508,646
32,"SATU MARE",305,138280,,240,"ODOREU / SCOALA GIMNAZIALA  ODOREU",3,13099,"ODOREU",138280,1988,1178,1116,48,14,1171,7,2200,1022,545,626
32,"SATU MARE",305,138280,,241,"BERINDAN / CASA DE TIP FAMILIAL"" IRIS""",3,13099,"ODOREU",138280,109,63,50,13,0,61,2,200,137,31,30
32,"SATU MARE",305,138280,,242,"MĂRTINEŞTI / AFTER SCHOOL, MARTINESTI NR. 51",3,13099,"ODOREU",138280,536,459,355,102,2,457,2,600,141,190,267
32,"SATU MARE",305,138351,,243,"ORAŞU NOU / SCOALA GIMNAZIALA  ORASU NOU SALA  DE CLASĂ 1",3,13106,"ORAŞU NOU",138351,744,424,408,16,0,420,4,800,376,45,375
32,"SATU MARE",305,138351,,244,"ORAŞU NOU / SCOALA GIMNAZIALA  ORASU NOU SALA  DE CLASĂ 2",3,13106,"ORAŞU NOU",138351,876,460,453,7,0,458,2,1000,540,31,427
32,"SATU MARE",305,138351,,245,"ORAŞU NOU-VII / GRĂDINIŢĂ CU PROGRAM NORMAL",3,13106,"ORAŞU NOU",138351,333,151,135,16,0,151,0,400,249,74,77
32,"SATU MARE",305,138351,,246,"PRILOG / GRĂDINIŢĂ CU PROGRAM NORMAL",3,13106,"ORAŞU NOU",138351,550,254,231,23,0,246,8,600,346,57,189
32,"SATU MARE",305,138351,,247,"PRILOG VII / IMOBIL, CASA  DE LOCUIT",3,13106,"ORAŞU NOU",138351,143,74,59,15,0,74,0,200,126,36,38
32,"SATU MARE",305,138351,,248,"PRILOG VII / CLĂDIREA SCOLII",3,13106,"ORAŞU NOU",138351,117,67,43,24,0,66,1,200,133,23,43
32,"SATU MARE",305,138351,,249,"REMETEA OAŞULUI / SCOALĂ PRIMARĂ REMETEA OAŞ",3,13106,"ORAŞU NOU",138351,456,219,201,18,0,217,2,500,281,17,200
32,"SATU MARE",305,138431,,250,"PĂULEŞTI / CAMINUL  CULTURAL  PAULESTI",3,13112,"PĂULEŞTI",138431,1230,785,720,63,2,780,5,1400,615,252,528
32,"SATU MARE",305,138431,,251,"AMAŢI / ŞCOALA GENERALĂ AMAŢI",3,13112,"PĂULEŞTI",138431,856,465,432,33,0,461,4,900,435,177,284
32,"SATU MARE",305,138431,,252,"AMBUD / ŞCOALA SOLTESZ JANOS AMBUD",3,13112,"PĂULEŞTI",138431,931,489,457,30,2,485,4,1000,511,124,361
32,"SATU MARE",305,138431,,253,"HRIP / ŞCOALA GENERALĂ HRIP",3,13112,"PĂULEŞTI",138431,532,309,280,29,0,300,9,600,291,161,139
32,"SATU MARE",305,138431,,254,"PETIN / ŞCOALA GENERALĂ PETIN",3,13112,"PĂULEŞTI",138431,612,359,345,14,0,356,3,700,341,101,255
32,"SATU MARE",305,138431,,255,"RUŞENI / ŞCOALA GENERALĂ RUŞENI",3,13112,"PĂULEŞTI",138431,212,173,137,36,0,170,3,300,127,98,72
32,"SATU MARE",305,138501,,256,"PETREŞTI / Şcoala Gimnazială Dr. Stefan Vonház",3,13119,"PETREŞTI",138501,1310,509,462,33,14,502,7,1400,891,64,438
32,"SATU MARE",305,138501,,257,"DINDEŞTIU MIC / SCOALA GIMNAZIALA DR. STEFAN VONHAZ PETRESTI",3,13119,"PETREŞTI",138501,314,138,116,19,3,135,3,400,262,36,99
32,"SATU MARE",305,138538,,258,"PIR / SCOALA CU CLS. I-VIII PIR",3,13122,"PIR",138538,1154,556,522,34,0,547,9,1199,643,238,309
32,"SATU MARE",305,138538,,259,"SĂRVĂZEL / SCOALA PRIMARA",3,13122,"PIR",138538,113,83,62,21,0,82,1,200,117,54,28
32,"SATU MARE",305,138574,,260,"PIŞCOLT / PRIMARIA COMUNEI  PISCOLT",3,13126,"PIŞCOLT",138574,940,571,538,32,1,567,4,1000,429,205,362
32,"SATU MARE",305,138574,,261,"PIŞCOLT / PRIMARIA COMUNEI  PISCOLT",3,13126,"PIŞCOLT",138574,882,549,524,25,0,538,11,1000,451,250,288
32,"SATU MARE",305,138574,,262,"RESIGHEA / ŞCOALA GIMNAZIALĂ PIşCOLT",3,13126,"PIŞCOLT",138574,342,222,197,25,0,220,2,400,178,96,124
32,"SATU MARE",305,138574,,263,"SCĂRIŞOARA NOUĂ / ŞCOALA GIMNAZIALĂ PIşCOLT",3,13126,"PIŞCOLT",138574,347,267,210,57,0,263,4,400,133,148,115
32,"SATU MARE",305,138618,,264,"ACIUA / CAMIN CULTURAL",3,13130,"POMI",138618,76,110,38,72,0,109,1,200,90,68,41
32,"SATU MARE",305,138618,,265,"BORLEŞTI / SCOALA GENERALA",3,13130,"POMI",138618,608,401,291,104,6,399,2,700,299,208,191
32,"SATU MARE",305,138618,,266,"BICĂU / CAMIN CULTURAL",3,13130,"POMI",138618,111,103,76,27,0,101,2,200,97,81,20
32,"SATU MARE",305,138618,,267,"POMI / PRIMARIA  POMI",3,13130,"POMI",138618,728,547,448,89,10,540,7,800,253,242,298
32,"SATU MARE",305,180028,,268,"PORUMBEŞTI / caminul cultural",3,13135,"PORUMBEŞTI",180028,1200,583,565,18,0,578,5,1400,817,101,477
32,"SATU MARE",305,180028,,269,"CIDREAG / ŞCOALA GIMNAZIALĂ CIDREAG",3,13135,"PORUMBEŞTI",180028,841,431,417,14,0,422,9,800,369,206,216
32,"SATU MARE",305,180091,,270,"RACŞA / Şcoala Generală",3,13138,"RACŞA",180091,1180,619,561,25,33,616,3,1300,681,526,90
32,"SATU MARE",305,180091,,271,"RACŞA / ŞCOALA GIMNAZIALĂ",3,13138,"RACŞA",180091,1025,553,502,26,25,549,4,1100,547,463,86
32,"SATU MARE",305,180091,,272,"RACŞA VII / ŞCOALA PRIMARĂ",3,13138,"RACŞA",180091,220,158,137,18,3,155,3,300,142,98,57
32,"SATU MARE",305,138663,,273,"SANISLĂU / GRĂDINIŢA SANISLĂU",3,13144,"SANISLĂU",138663,1387,661,623,35,3,650,11,1600,939,150,500
32,"SATU MARE",305,138663,,274,"SANISLĂU / ŞCOALA CU CL. I-VIII GH. BULGĂR-SANISLĂU",3,13144,"SANISLĂU",138663,1228,688,634,48,6,680,8,1300,612,347,333
32,"SATU MARE",305,138663,,275,"HOREA / CĂMIN CULTURAL  SAT HOREA",3,13144,"SANISLĂU",138663,126,132,83,49,0,131,1,200,68,64,67
32,"SATU MARE",305,138663,,276,"MARNA NOUĂ / CĂMIN CULTURAL  SAT MARNA NOUĂ",3,13144,"SANISLĂU",138663,286,199,171,27,1,196,3,300,101,112,84
32,"SATU MARE",305,138734,,277,"SANTĂU / SCOALA GIMNAZIALA  SANTAU",3,13148,"SANTĂU",138734,1444,912,829,55,28,905,7,1600,688,205,700
32,"SATU MARE",305,138734,,278,"CHEREUŞA / SC. PRIM. CHEREUŞA",3,13148,"SANTĂU",138734,483,326,289,24,13,325,1,500,174,65,260
32,"SATU MARE",305,138734,,279,"SUDURĂU / GRĂDINIŢA SUDURĂU",3,13148,"SANTĂU",138734,144,111,91,11,9,111,0,200,89,34,77
32,"SATU MARE",305,138770,,280,"SĂCĂŞENI / PRIMARIA SACASENI",3,13141,"SĂCĂŞENI",138770,830,390,359,28,3,385,5,900,510,141,244
32,"SATU MARE",305,138770,,281,"CHEGEA / CAMIN CULTURAL CHEGEA",3,13141,"SĂCĂŞENI",138770,150,101,73,28,0,101,0,200,99,48,53
32,"SATU MARE",305,138805,,282,"SĂUCA / SCOALA CU CLASELE I-VIII SAUCA",3,13152,"SĂUCA",138805,335,204,181,23,0,202,2,400,196,99,103
32,"SATU MARE",305,138805,,283,"BECHENI / SCALA CU CLS.I-VIII BECHENI",3,13152,"SĂUCA",138805,436,213,198,15,0,208,5,500,287,82,126
32,"SATU MARE",305,138805,,284,"CEAN / SCOALA CU CLS.I-IV CEAN",3,13152,"SĂUCA",138805,232,160,137,23,0,159,1,300,140,72,87
32,"SATU MARE",305,138805,,285,"SILVAŞ / SCOALA  SILVAS",3,13152,"SĂUCA",138805,125,87,74,13,0,87,0,200,113,39,48
32,"SATU MARE",305,138869,,286,"SOCOND / SCOALA GIMNAZIALA  SOCOND",3,13158,"SOCOND",138869,473,289,256,32,1,287,2,500,211,104,183
32,"SATU MARE",305,138869,,287,"CUŢA / GRADINITA CU PROGRAM NORMAL",3,13158,"SOCOND",138869,288,188,148,28,12,187,1,300,112,106,81
32,"SATU MARE",305,138869,,288,"HODIŞA / SPATIU PAROHIA ORT. HODISA",3,13158,"SOCOND",138869,202,155,122,25,8,154,1,200,45,70,84
32,"SATU MARE",305,138869,,289,"SOCONZEL / GRADINITA CU PROGRAM NORMAL",3,13158,"SOCOND",138869,257,209,158,32,19,209,0,300,91,90,119
32,"SATU MARE",305,138869,,290,"STÎNA / SCOALA GIMNAZIALA STANA",3,13158,"SOCOND",138869,766,578,559,19,0,576,2,800,222,485,91
32,"SATU MARE",305,138921,,291,"RACOVA / GRĂDINIŢĂ CU PROGRAM NORMAL",3,13164,"SUPUR",138921,174,131,103,28,0,130,1,200,69,60,70
32,"SATU MARE",305,138921,,292,"SUPURU DE JOS / PRIMARIA COMUNEI  SUPUR",3,13164,"SUPUR",138921,1000,613,535,78,0,605,8,1100,487,378,227
32,"SATU MARE",305,138921,,293,"DOBRA / ŞCOALA GIMNAZIALĂ DOBRA",3,13164,"SUPUR",138921,801,315,302,13,0,313,2,900,585,170,143
32,"SATU MARE",305,138921,,294,"GIOROCUTA / ŞCOALA GIMNAZIALĂ GIOROCUTA",3,13164,"SUPUR",138921,584,316,269,47,0,313,3,601,285,214,99
32,"SATU MARE",305,138921,,295,"HUREZU MARE / ŞCOALA GIMNAZIALĂ ""MOISE  SORA NOVAC""  HUREZU MARE",3,13164,"SUPUR",138921,315,211,172,39,0,210,1,400,189,134,76
32,"SATU MARE",305,138921,,296,"SECHEREŞA / CĂMIN CULTURAL SECHEREŞA",3,13164,"SUPUR",138921,56,39,30,9,0,39,0,100,61,9,30
32,"SATU MARE",305,138921,,297,"SUPURU DE SUS / ŞCOALA  PRIMARĂ "" IOAN GALU"" SUPURU DE SUS",3,13164,"SUPUR",138921,413,256,207,48,1,254,2,500,244,173,81
32,"SATU MARE",305,139009,,298,"TARNA MARE / PRIMARIA TARNA MARE",3,13172,"TARNA MARE",139009,1656,844,783,49,12,834,10,1800,956,380,454
32,"SATU MARE",305,139009,,299,"BOCICĂU / SCOALA GENERALA BOCICAU",3,13172,"TARNA MARE",139009,506,261,241,17,3,257,4,600,339,92,165
32,"SATU MARE",305,139009,,300,"VALEA SEACĂ / GRADINITA VALEA SEACA",3,13172,"TARNA MARE",139009,973,438,402,34,2,436,2,1100,662,154,282
32,"SATU MARE",305,139054,,301,"TEREBEŞTI / PRIMARIA TEREBESTI",3,13177,"TEREBEŞTI",139054,567,359,315,35,9,357,2,600,241,170,187
32,"SATU MARE",305,139054,,302,"GELU / GRADINITA CU PROGRAM NORMAL GELU",3,13177,"TEREBEŞTI",139054,414,352,280,65,7,349,3,500,148,184,165
32,"SATU MARE",305,139054,,303,"PIŞCARI / SCOALA PRIMARA PISCARI",3,13177,"TEREBEŞTI",139054,364,284,240,36,8,281,3,400,116,230,51
32,"SATU MARE",305,139107,,304,"PORTIŢA / GRADINITA CU PROGRAM NORMAL",3,13182,"TIREAM",139107,147,119,92,27,0,118,1,200,81,69,49
32,"SATU MARE",305,139107,,305,"TIREAM / PRIMARIA COMUNEI TIREAM",3,13182,"TIREAM",139107,1357,631,584,47,0,629,2,1500,869,213,416
32,"SATU MARE",305,139107,,306,"VEZENDIU / SCOALA PRIMARA VEZENDIU",3,13182,"TIREAM",139107,382,209,173,36,0,209,0,400,191,127,82
32,"SATU MARE",305,139143,,307,"TÎRŞOLŢ / SCOALA GENERALA  TARSOLT",3,13186,"TÎRŞOLŢ",139143,1335,336,320,16,0,335,1,1500,1164,85,250
32,"SATU MARE",305,139143,,308,"TÎRŞOLŢ / SCOALA GENERALA  TARSOLT",3,13186,"TÎRŞOLŢ",139143,803,188,176,12,0,187,1,900,712,53,134
32,"SATU MARE",305,139143,,309,"ALICENI / SCOALA GENERALA  ALICENI",3,13186,"TÎRŞOLŢ",139143,337,109,93,16,0,108,1,400,291,25,83
32,"SATU MARE",305,139170,,310,"TURŢ / Liceul Tehnologic Anghel Saligny Turt, Corpul A",3,13189,"TURŢ",139170,1441,614,595,13,6,613,1,1600,986,304,309
32,"SATU MARE",305,139170,,311,"TURŢ / Liceul Tehnologic Anghel Saligny Turt, Corpul B",3,13189,"TURŢ",139170,1243,548,522,14,12,547,1,1400,852,230,317
32,"SATU MARE",305,139170,,312,"TURŢ / Scoala cu clasele I-VIII Nr. 2",3,13189,"TURŢ",139170,1363,627,598,29,0,619,8,1500,873,293,326
32,"SATU MARE",305,139170,,313,"TURŢ / Gradinita cu program normal Susani",3,13189,"TURŢ",139170,897,356,331,21,4,347,9,1000,644,169,178
32,"SATU MARE",305,139170,,314,"GHERŢA MARE / Scoala cu clasele primare Gherta Mare",3,13189,"TURŢ",139170,1285,512,494,18,0,507,5,1400,888,216,291
32,"SATU MARE",305,139214,,315,"TURULUNG / PRIMĂRIA",3,13193,"TURULUNG",139214,930,353,333,20,0,351,2,1000,647,33,318
32,"SATU MARE",305,139214,,316,"TURULUNG / SCOALA GIMNAZIALA  TURULUNG",3,13193,"TURULUNG",139214,1176,570,543,27,0,556,14,1300,730,167,389
32,"SATU MARE",305,139214,,317,"DRĂGUŞENI / SCOALA GIMNAZIALA  DRAGUSENI",3,13193,"TURULUNG",139214,1062,467,414,34,19,462,5,1199,732,243,219
32,"SATU MARE",305,139214,,318,"TURULUNG VII / GRADINITA",3,13193,"TURULUNG",139214,173,70,56,14,0,70,0,200,130,14,56
32,"SATU MARE",305,139250,,319,"URZICENI / Camin Cultural Urziceni",3,13197,"URZICENI",139250,1085,582,542,40,0,576,6,1200,618,36,540
32,"SATU MARE",305,139250,,320,"URZICENI PĂDURE / ŞCOALA GENERALĂ URZICENI PĂDURE",3,13197,"URZICENI",139250,173,86,70,16,0,86,0,200,114,40,46
32,"SATU MARE",305,139287,,321,"VALEA VINULUI / PRIMARIA COMUNIE VALEA VINULUI",3,13200,"VALEA VINULUI",139287,654,487,399,64,24,483,4,700,213,252,231
32,"SATU MARE",305,139287,,322,"VALEA VINULUI / SCOALA CU CLASELE I-IV MARIUS",3,13200,"VALEA VINULUI",139287,204,169,117,47,5,169,0,301,132,72,97
32,"SATU MARE",305,139287,,323,"VALEA VINULUI / SCOALA CU CLASELE I-IV ROSIORI",3,13200,"VALEA VINULUI",139287,357,249,193,47,9,247,2,400,151,110,137
32,"SATU MARE",305,139287,,324,"VALEA VINULUI / SCOALA CU CLASELE I-IV SII",3,13200,"VALEA VINULUI",139287,445,265,219,41,5,264,1,500,235,166,98
32,"SATU MARE",305,139330,,325,"VAMA / GRADINITA CU PROGRAM NORMAL VAMA",3,13205,"VAMA",139330,1733,700,668,32,0,695,5,1900,1200,193,502
32,"SATU MARE",305,139330,,326,"VAMA / SCOALA GIMNAZIALA VAMA",3,13205,"VAMA",139330,1538,644,624,20,0,642,2,1700,1056,108,534
32,"SATU MARE",305,139358,,327,"VETIŞ / CAMINUL CULTURAL VETIS",3,13207,"VETIŞ",139358,1788,866,818,48,0,861,5,2000,1134,189,672
32,"SATU MARE",305,139358,,328,"DECEBAL / SCOALA GEN.DECEBAL",3,13207,"VETIŞ",139358,1044,537,482,55,0,532,5,1200,663,229,303
32,"SATU MARE",305,139358,,329,"OAR / CĂMINUL CULTURAL OAR",3,13207,"VETIŞ",139358,1328,513,488,25,0,509,4,1500,987,79,430
32,"SATU MARE",305,139394,,330,"VIILE SATU MARE / PRIMĂRIA VIILE SATU MARE",3,13211,"VIILE SATU MARE",139394,1443,735,647,88,0,727,8,1600,865,143,584
32,"SATU MARE",305,139394,,331,"VIILE SATU MARE / ŞCOALA PRIMARĂ DEALU MARE",3,13211,"VIILE SATU MARE",139394,484,291,248,40,3,290,1,500,209,72,218
32,"SATU MARE",305,139394,,332,"CIONCHEŞTI / GRADINITA CIONCHEŞTI",3,13211,"VIILE SATU MARE",139394,212,151,130,21,0,148,3,300,149,45,103
32,"SATU MARE",305,139394,,333,"MEDIŞA / ŞCOALA PRIMARĂ MEDIŞA",3,13211,"VIILE SATU MARE",139394,186,116,90,23,3,115,1,200,84,63,52
32,"SATU MARE",305,139394,,334,"TĂTĂREŞTI / ŞCOALA PRIMARĂ TĂTĂREŞTI",3,13211,"VIILE SATU MARE",139394,580,391,318,56,17,389,2,600,209,211,178
33,"SĂLAJ","#N/A",139704,,1,"ZALĂU / COLEGIUL NATIONAL ""SILVANIA""",1,13218,"MUNICIPIUL ZALĂU",139704,1848,1176,1109,66,1,1166,10,2030,854,352,814
33,"SĂLAJ","#N/A",139704,,2,"ZALĂU / CLUBUL TINERETULUI",1,13218,"MUNICIPIUL ZALĂU",139704,1491,912,847,65,0,906,6,1630,718,204,702
33,"SĂLAJ","#N/A",139704,,3,"ZALĂU / GRADINITA CU PROGRAM PRELUNGIT NR. 1",1,13218,"MUNICIPIUL ZALĂU",139704,1709,993,948,45,0,980,13,1870,877,319,661
33,"SĂLAJ","#N/A",139704,,4,"ZALĂU / PRIMARIA MUNICIPIULUI ZALAU",1,13218,"MUNICIPIUL ZALĂU",139704,1318,690,656,34,0,687,3,1440,750,209,478
33,"SĂLAJ","#N/A",139704,,5,"ZALĂU / STADIONUL MUNICIPALSediu Clubului Sportiv Municipal",1,13218,"MUNICIPIUL ZALĂU",139704,944,606,566,40,0,602,4,1030,424,179,423
33,"SĂLAJ","#N/A",139704,,6,"ZALĂU / LICEUL CU PROGRAM SPORTIV ""AVRAM IANCU""",1,13218,"MUNICIPIUL ZALĂU",139704,1601,1068,967,55,46,1065,3,1730,662,329,736
33,"SĂLAJ","#N/A",139704,,7,"ZALĂU / LICEUL CU PROGRAM SPORTIV ""AVRAM IANCU""",1,13218,"MUNICIPIUL ZALĂU",139704,1626,895,855,40,0,890,5,1780,885,246,644
33,"SĂLAJ","#N/A",139704,,8,"ZALĂU / LICEUL CU PROGRAM SPORTIV ""AVRAM IANCU""",1,13218,"MUNICIPIUL ZALĂU",139704,1796,1018,947,70,1,1015,3,1980,962,321,694
33,"SĂLAJ","#N/A",139704,,9,"ZALĂU / DIRECTIA DE SANATATE PUBLICA SALAJ",1,13218,"MUNICIPIUL ZALĂU",139704,1102,727,669,57,1,720,7,1210,483,258,462
33,"SĂLAJ","#N/A",139704,,10,"ZALĂU / DIRECTIA GENERALA DE ADMINISTRARE DOMENIUL PUBLIC",1,13218,"MUNICIPIUL ZALĂU",139704,1254,802,754,47,1,794,8,1390,588,257,537
33,"SĂLAJ","#N/A",139704,,11,"ZALĂU / CASA DE CULTURA A SINDICATELOR",1,13218,"MUNICIPIUL ZALĂU",139704,1822,1020,950,70,0,1011,9,2000,980,339,672
33,"SĂLAJ","#N/A",139704,,12,"ZALĂU / SCOALA GIMNAZIALA""GHEORGHE LAZAR""",1,13218,"MUNICIPIUL ZALĂU",139704,1844,1100,1035,64,1,1085,15,2010,910,348,737
33,"SĂLAJ","#N/A",139704,,13,"ZALĂU / LICEUL TEHNOLOGIC MIHAI VITEAZU",1,13218,"MUNICIPIUL ZALĂU",139704,1038,611,550,50,11,608,3,1160,549,206,402
33,"SĂLAJ","#N/A",139704,,14,"ZALĂU / LICEUL TEHNOLOGIC ""MIHAI VITEAZUL""",1,13218,"MUNICIPIUL ZALĂU",139704,1332,721,687,34,0,719,2,1460,739,266,453
33,"SĂLAJ","#N/A",139704,,15,"ZALĂU / SCOALA GIMNAZIALA  ""POROLISSUM",1,13218,"MUNICIPIUL ZALĂU",139704,1742,1032,968,63,1,1025,7,1940,908,340,685
33,"SĂLAJ","#N/A",139704,,16,"ZALĂU / SCOALA GIMNAZIALA POROLISSUM",1,13218,"MUNICIPIUL ZALĂU",139704,1637,987,895,44,48,985,2,1790,803,335,650
33,"SĂLAJ","#N/A",139704,,17,"ZALĂU / SCOALA GIMNAZIALA IULIU MANIU",1,13218,"MUNICIPIUL ZALĂU",139704,1835,987,904,82,1,974,13,2040,1053,319,655
33,"SĂLAJ","#N/A",139704,,18,"ZALĂU / GRADINITA CU PROGRAM PRELUNGIT ""VOINICEL""",1,13218,"MUNICIPIUL ZALĂU",139704,1064,575,533,42,0,574,1,1170,595,203,371
33,"SĂLAJ","#N/A",139704,,19,"ZALĂU / GRADINITA CU PROGRAM PRELUNGIT ""VOINICEL""",1,13218,"MUNICIPIUL ZALĂU",139704,1206,680,648,32,0,672,8,1320,640,250,422
33,"SĂLAJ","#N/A",139704,,20,"ZALĂU / SALA SPORTURILOR",1,13218,"MUNICIPIUL ZALĂU",139704,1864,1032,940,91,1,1029,3,2060,1028,368,661
33,"SĂLAJ","#N/A",139704,,21,"ZALĂU / SALA SPORTURILOR",1,13218,"MUNICIPIUL ZALĂU",139704,1745,960,893,67,0,957,3,1920,960,284,673
33,"SĂLAJ","#N/A",139704,,22,"ZALĂU / S.C.SAMTEX S.A.(INTEGRATA)",1,13218,"MUNICIPIUL ZALĂU",139704,1382,782,730,52,0,777,5,1520,738,246,531
33,"SĂLAJ","#N/A",139704,,23,"ZALĂU / SCOALA GIMNAZIALA ""CORNELIU COPOSU""",1,13218,"MUNICIPIUL ZALĂU",139704,1667,937,887,50,0,929,8,1830,893,274,655
33,"SĂLAJ","#N/A",139704,,24,"ZALĂU / SCOALA GIMNAZIALA ""CORNELIU COPOSU""",1,13218,"MUNICIPIUL ZALĂU",139704,1507,850,812,38,0,847,3,1650,800,271,576
33,"SĂLAJ","#N/A",139704,,25,"ZALĂU / SCOALA GIMNAZIALA ""CORNELIU COPOSU""",1,13218,"MUNICIPIUL ZALĂU",139704,1159,678,635,43,0,675,3,1270,592,180,495
33,"SĂLAJ","#N/A",139704,,26,"ZALĂU / LICEUL TEHNOLOGIC "" VOIEVOD GELU""",1,13218,"MUNICIPIUL ZALĂU",139704,1576,900,861,39,0,898,2,1750,850,293,605
33,"SĂLAJ","#N/A",139704,,27,"ZALĂU / LICEUL TEHNOLOGIC "" VOIEVOD GELU""",1,13218,"MUNICIPIUL ZALĂU",139704,1777,972,933,39,0,966,6,1930,958,303,663
33,"SĂLAJ","#N/A",139704,,28,"ZALĂU / LICEUL TEHNOLOGIC "" VOIEVOD GELU""",1,13218,"MUNICIPIUL ZALĂU",139704,1659,889,845,44,0,884,5,1860,971,239,645
33,"SĂLAJ","#N/A",139704,,29,"ZALĂU / GRADINITA CU PROGRAM NORMAL  NR.8",1,13218,"MUNICIPIUL ZALĂU",139704,1957,1250,1041,72,137,1239,11,2150,900,427,812
33,"SĂLAJ","#N/A",139704,,30,"ZALĂU / LICEUL DE ARTA ""IOAN SIMA""",1,13218,"MUNICIPIUL ZALĂU",139704,1647,955,914,41,0,949,6,1820,865,304,645
33,"SĂLAJ","#N/A",139704,,31,"ZALĂU / SCOALA POSTLICEALA SANITARA",1,13218,"MUNICIPIUL ZALĂU",139704,1479,821,788,33,0,812,9,1640,819,290,522
33,"SĂLAJ","#N/A",139704,,32,"ZALĂU / GRADINITA CU PROGRAM PRELUNGIT NR.11",1,13218,"MUNICIPIUL ZALĂU",139704,1658,979,910,69,0,972,7,1820,841,317,655
33,"SĂLAJ","#N/A",139704,,33,"ZALĂU / COLEGIUL TEHNIC ""ALESANDRUPAPIU ILARIAN""",1,13218,"MUNICIPIUL ZALĂU",139704,1197,702,663,39,0,697,5,1330,628,259,438
33,"SĂLAJ","#N/A",139704,,34,"ZALĂU / COLEGIUL TEHNIC ""ALESANDRUPAPIU ILARIAN""",1,13218,"MUNICIPIUL ZALĂU",139704,1040,609,569,40,0,607,2,1160,551,260,347
33,"SĂLAJ","#N/A",139704,,35,"ZALĂU / LICEUL TEORETIC ""GHEORGHE SINCAI""",1,13218,"MUNICIPIUL ZALĂU",139704,1358,871,822,48,1,868,3,1480,609,296,572
33,"SĂLAJ","#N/A",139704,,36,"ZALĂU / SCOALA GIMNAZIALA ""MIHAI EMINESCU""",1,13218,"MUNICIPIUL ZALĂU",139704,1794,1025,988,36,1,1014,11,1980,955,384,630
33,"SĂLAJ","#N/A",139704,,37,"ZALĂU / CLUB SC COMPANIA DE APA SOMES SA SUCURSALA MUNICIPIULUI ZALAU",1,13218,"MUNICIPIUL ZALĂU",139704,1403,789,746,43,0,783,6,1550,761,274,509
33,"SĂLAJ","#N/A",139704,,38,"ZALĂU / SCOALA GENERALA GEORGE COSBUC CARTIER ORTELEC",1,13218,"MUNICIPIUL ZALĂU",139704,1562,905,865,40,0,898,7,1720,815,320,578
33,"SĂLAJ","#N/A",139704,,39,"STÎNA / SCOALA PRIMARASTANA",1,13218,"MUNICIPIUL ZALĂU",139704,267,221,155,64,2,221,0,279,58,64,157
33,"SĂLAJ","#N/A",139740,,40,"CEHU SILVANIEI / Liceul Tehnologic Gheorghe Pop De Basesti",1,13221,"ORAŞ CEHU SILVANIEI",139740,1511,754,726,28,0,750,4,1660,906,186,564
33,"SĂLAJ","#N/A",139740,,41,"CEHU SILVANIEI / Scoala Gimnaziala Andrei Muresanu",1,13221,"ORAŞ CEHU SILVANIEI",139740,1542,764,735,29,0,761,3,1710,946,196,565
33,"SĂLAJ","#N/A",139740,,42,"CEHU SILVANIEI / Piata Trandafirilor nr.29 Clubul Copiilor",1,13221,"ORAŞ CEHU SILVANIEI",139740,1502,844,791,52,1,843,1,1660,816,215,628
33,"SĂLAJ","#N/A",139740,,43,"HOROATU CEHULUI / Horoatu Cehului Nr.23 Scoala Primara",1,13221,"ORAŞ CEHU SILVANIEI",139740,155,123,99,24,0,123,0,170,47,53,70
33,"SĂLAJ","#N/A",139740,,44,"MOTIŞ / Sat Motis Nr.228 Scoala Gimnaziala Gheorghe Sincai",1,13221,"ORAŞ CEHU SILVANIEI",139740,593,378,356,13,9,377,1,660,282,201,176
33,"SĂLAJ","#N/A",139740,,45,"NADIŞ / Nadis Nr.127 Scoala Primara",1,13221,"ORAŞ CEHU SILVANIEI",139740,445,347,324,22,1,347,0,490,143,149,198
33,"SĂLAJ","#N/A",139740,,46,"ULCIUG / Sat Ulciug Nr.6 Gradinita de copii",1,13221,"ORAŞ CEHU SILVANIEI",139740,777,409,392,13,4,404,5,860,451,82,322
33,"SĂLAJ","#N/A",139811,,47,"JIBOU / Casa de Cultura",1,13227,"ORAŞ JIBOU",139811,1925,1096,1032,61,3,1091,5,2110,1014,508,583
33,"SĂLAJ","#N/A",139811,,48,"JIBOU / Liceul tehnologic ""Octavian Goga""",1,13227,"ORAŞ JIBOU",139811,1643,948,860,40,48,946,2,1810,862,458,488
33,"SĂLAJ","#N/A",139811,,49,"JIBOU / Liceul tehnologic ""Octavian Goga""parter,sala de clasa nr.2",1,13227,"ORAŞ JIBOU",139811,1284,789,739,38,12,785,4,1410,621,310,475
33,"SĂLAJ","#N/A",139811,,50,"JIBOU / Scoala Gimnaziala ""Lucian Blaga"" parter,sala de clasa nr.1 str.",1,13227,"ORAŞ JIBOU",139811,1688,1003,956,44,3,996,7,1820,817,518,478
33,"SĂLAJ","#N/A",139811,,51,"JIBOU / Liceul teoretic ""Ion Agârbiceanu""",1,13227,"ORAŞ JIBOU",139811,1739,989,913,73,3,977,12,1900,911,509,468
33,"SĂLAJ","#N/A",139811,,52,"CUCEU / Gradinita",1,13227,"ORAŞ JIBOU",139811,414,314,272,34,8,309,5,448,134,158,151
33,"SĂLAJ","#N/A",139811,,53,"HUSIA / Scoala cu clasele I-IV",1,13227,"ORAŞ JIBOU",139811,208,134,123,10,1,133,1,220,86,79,54
33,"SĂLAJ","#N/A",139811,,54,"RONA / Scoala cu clasele I-IV",1,13227,"ORAŞ JIBOU",139811,313,226,212,14,0,226,0,340,114,149,77
33,"SĂLAJ","#N/A",139811,,55,"VAR / Scoala cu clasele I-IV",1,13227,"ORAŞ JIBOU",139811,425,312,286,21,5,311,1,470,158,177,134
33,"SĂLAJ","#N/A",139884,,56,"ŞIMLEU SILVANIEI / Şcoala Gimnazială  Horea",1,13233,"ORAŞ ŞIMLEU SILVANIEI",139884,1641,1001,954,47,0,996,5,1790,789,341,655
33,"SĂLAJ","#N/A",139884,,57,"ŞIMLEU SILVANIEI / Liceul Tehnologic ""Ioan Ossian""",1,13233,"ORAŞ ŞIMLEU SILVANIEI",139884,1542,874,815,58,1,867,7,1680,806,256,611
33,"SĂLAJ","#N/A",139884,,58,"ŞIMLEU SILVANIEI / CENTRUL CULTURAL",1,13233,"ORAŞ ŞIMLEU SILVANIEI",139884,1478,821,780,39,2,817,4,1630,809,215,602
33,"SĂLAJ","#N/A",139884,,59,"ŞIMLEU SILVANIEI / COLEGIUL TEHNIC ""IULIU MANIU""",1,13233,"ORAŞ ŞIMLEU SILVANIEI",139884,1525,884,827,57,0,880,4,1670,786,259,621
33,"SĂLAJ","#N/A",139884,,60,"ŞIMLEU SILVANIEI / CENTRUL ŞCOLAR PENTRU EDUCAŢIE INCLUZIVĂ",1,13233,"ORAŞ ŞIMLEU SILVANIEI",139884,1960,1012,971,40,1,999,13,2020,1008,309,690
33,"SĂLAJ","#N/A",139884,,61,"ŞIMLEU SILVANIEI / CLUBUL COPIILOR",1,13233,"ORAŞ ŞIMLEU SILVANIEI",139884,1832,1012,962,49,1,999,13,2020,1008,276,723
33,"SĂLAJ","#N/A",139884,,62,"ŞIMLEU SILVANIEI / GRĂDINIŢA CU PROGRAM PRELUNGIT NR.3",1,13233,"ORAŞ ŞIMLEU SILVANIEI",139884,1605,909,877,32,0,901,8,1910,1001,268,633
33,"SĂLAJ","#N/A",139884,,63,"CEHEI / ŞCOALA PRIMARĂ",1,13233,"ORAŞ ŞIMLEU SILVANIEI",139884,797,480,459,20,1,478,2,870,390,184,294
33,"SĂLAJ","#N/A",139884,,64,"PUSTA / ŞCOALA GIMNAZIALĂ NR.1",1,13233,"ORAŞ ŞIMLEU SILVANIEI",139884,1287,532,514,18,0,512,20,1410,878,276,236
33,"SĂLAJ","#N/A",139937,,65,"AGRIJ / CĂMIN  CULTURAL AGRIJ",3,13238,"AGRIJ",139937,811,451,402,49,0,448,3,880,429,234,214
33,"SĂLAJ","#N/A",139937,,66,"RĂSTOLŢU- DEŞERT / ŞCOALA CU CL.I-IV",3,13238,"AGRIJ",139937,284,263,169,80,14,261,2,310,47,150,111
33,"SĂLAJ","#N/A",139982,,67,"ALMAŞU / PRIMARIA COMUNEI ALMASU",3,13241,"ALMAŞU",139982,844,524,458,59,7,522,2,930,406,142,380
33,"SĂLAJ","#N/A",139982,,68,"JEBUCU / CAMINUL CULTURAL JEBUCU",3,13241,"ALMAŞU",139982,310,242,199,43,0,239,3,340,98,37,202
33,"SĂLAJ","#N/A",139982,,69,"MESTEACĂNU / CAMINUL CULTURAL MESTEACANU",3,13241,"ALMAŞU",139982,337,255,216,39,0,255,0,370,115,95,160
33,"SĂLAJ","#N/A",139982,,70,"PETRINZEL / CAMINUL CULTURAL PETRINZEL",3,13241,"ALMAŞU",139982,100,76,57,19,0,76,0,110,34,17,59
33,"SĂLAJ","#N/A",139982,,71,"STANA / CAMINUL CULTURAL STANA",3,13241,"ALMAŞU",139982,117,115,66,49,0,115,0,120,5,13,102
33,"SĂLAJ","#N/A",139982,,72,"ŢĂUDU / SCOALA CU CLASELE I-IV TAUDU",3,13241,"ALMAŞU",139982,126,104,83,19,2,104,0,130,26,26,78
33,"SĂLAJ","#N/A",140084,,73,"BĂBENI / Corp B,Biblioteca comunala",3,13251,"BĂBENI",140084,478,339,280,58,1,334,5,520,181,148,186
33,"SĂLAJ","#N/A",140084,,74,"CIOCMANI / Scoala veche Ciocmani",3,13251,"BĂBENI",140084,495,346,276,69,1,342,4,540,194,140,202
33,"SĂLAJ","#N/A",140084,,75,"CLIŢ / Scoala Clit",3,13251,"BĂBENI",140084,187,150,126,24,0,150,0,200,50,70,80
33,"SĂLAJ","#N/A",140084,,76,"PIROŞA / Cladire multifunctionala",3,13251,"BĂBENI",140084,92,68,57,11,0,68,0,100,32,38,30
33,"SĂLAJ","#N/A",140084,,77,"POIENIŢA / Scoala Poienita",3,13251,"BĂBENI",140084,194,154,122,32,0,151,3,210,56,71,80
33,"SĂLAJ","#N/A",140146,,78,"BĂLAN / Şcoala Gimnazială Bălan",3,13257,"BĂLAN",140146,819,516,434,82,0,511,5,910,394,208,303
33,"SĂLAJ","#N/A",140146,,79,"CHECHIŞ / Şcoala Primară Chechiş",3,13257,"BĂLAN",140146,464,405,285,120,0,400,5,510,105,220,180
33,"SĂLAJ","#N/A",140146,,80,"CHENDREA / Grădiniţa Chendrea",3,13257,"BĂLAN",140146,679,458,412,46,0,456,2,750,292,250,206
33,"SĂLAJ","#N/A",140146,,81,"GĂLPÎIA / Şcoala Primară Gălpîia",3,13257,"BĂLAN",140146,352,237,205,32,0,234,3,390,153,143,91
33,"SĂLAJ","#N/A",140146,,82,"GÎLGĂU ALMAŞULUI / Şcoala Gimnazială Gîlgău Almaşului",3,13257,"BĂLAN",140146,809,544,456,88,0,539,5,880,336,283,256
33,"SĂLAJ","#N/A",140208,,83,"BĂNIŞOR / PRIMARIA",3,13263,"BĂNIŞOR",140208,565,357,312,45,0,353,4,610,253,156,197
33,"SĂLAJ","#N/A",140208,,84,"BAN / Scoala Ban",3,13263,"BĂNIŞOR",140208,381,255,215,40,0,248,7,420,165,104,144
33,"SĂLAJ","#N/A",140208,,85,"PECEIU / Scoala Peceiu",3,13263,"BĂNIŞOR",140208,791,546,486,59,1,539,7,870,324,150,389
33,"SĂLAJ","#N/A",140244,,86,"BENESAT / Scoala primara Benesat",3,13267,"BENESAT",140244,356,245,203,41,1,241,4,390,145,64,177
33,"SĂLAJ","#N/A",140244,,87,"ALUNIŞ / Scoala Gimnaziala A.Iancu",3,13267,"BENESAT",140244,479,359,309,50,0,357,2,520,161,138,219
33,"SĂLAJ","#N/A",140244,,88,"BIUŞA / Scoala primara Biusa",3,13267,"BENESAT",140244,423,274,252,22,0,274,0,463,189,77,197
33,"SĂLAJ","#N/A",140280,,89,"BOBOTA / Gradinita Bobota",3,13271,"BOBOTA",140280,1198,753,681,63,9,746,7,1300,547,322,424
33,"SĂLAJ","#N/A",140280,,90,"DERŞIDA / Scoala Dersida",3,13271,"BOBOTA",140280,1484,905,841,64,0,897,8,1640,735,469,428
33,"SĂLAJ","#N/A",140280,,91,"ZALNOC / Scoala Zalnoc",3,13271,"BOBOTA",140280,395,199,178,21,0,197,2,430,231,85,112
33,"SĂLAJ","#N/A",140324,,92,"BOCŞA / Scoala Gimnaziala Simion Barnutiu Bocsa",3,13275,"BOCŞA",140324,769,510,436,61,13,507,3,840,330,148,359
33,"SĂLAJ","#N/A",140324,,93,"BORLA / Scoala Gimnaziala Borla",3,13275,"BOCŞA",140324,1326,549,538,11,0,546,3,1460,911,70,476
33,"SĂLAJ","#N/A",140324,,94,"SĂLĂJENI / Scoala cu clasele I-IV Salajeni",3,13275,"BOCŞA",140324,464,320,273,45,2,319,1,510,190,116,203
33,"SĂLAJ","#N/A",140324,,95,"CÎMPIA / Scoala cu clasele I-IV Cimpia",3,13275,"BOCŞA",140324,208,191,143,37,11,188,3,230,39,67,121
33,"SĂLAJ","#N/A",180037,,96,"BOGHIŞ / SEDIUL PRIMĂRIEI COMUNEI BOGHIŞ",3,13280,"BOGHIŞ",180037,1221,693,630,50,13,683,10,1340,647,157,526
33,"SĂLAJ","#N/A",180037,,97,"BOZIEŞ / CĂMINUL CULTURAL BOZIEŞ",3,13280,"BOGHIŞ",180037,235,135,113,20,2,132,3,260,125,13,119
33,"SĂLAJ","#N/A",140379,,98,"BODIA / SCOALA CU CLASELE I-IV",3,13283,"BUCIUMI",140379,207,166,131,35,0,166,0,220,54,73,93
33,"SĂLAJ","#N/A",140379,,99,"BOGDANA / SCOALA CU CLASELE I-IV",3,13283,"BUCIUMI",140379,373,315,223,92,0,314,1,410,95,197,117
33,"SĂLAJ","#N/A",140379,,100,"RĂSTOLŢ / SCOALA CU CLASELE I-IV",3,13283,"BUCIUMI",140379,196,137,101,35,1,137,0,210,73,68,69
33,"SĂLAJ","#N/A",140379,,101,"SÎNGEORGIU DE MESEŞ / SCOALA CU CLASELE I-IV",3,13283,"BUCIUMI",140379,260,250,184,66,0,248,2,290,40,114,134
33,"SĂLAJ","#N/A",140379,,102,"BUCIUMI / PRIMARIA BUCIUMI",3,13283,"BUCIUMI",140379,1016,711,594,109,8,705,6,1120,409,286,419
33,"SĂLAJ","#N/A",140440,,103,"CAMĂR / SEDIUL PRIMĂRIEICOMUNEI CAMĂR",3,13290,"CAMĂR",140440,1351,852,821,31,0,847,5,1490,638,340,507
33,"SĂLAJ","#N/A",140477,,104,"DUMUSLĂU / ŞCOALA PRIMARĂ",3,13293,"CARASTELEC",140477,41,41,23,18,0,41,0,60,19,17,24
33,"SĂLAJ","#N/A",140477,,105,"CARASTELEC / CĂMINUL CULTURAL",3,13293,"CARASTELEC",140477,792,504,440,59,5,502,2,870,366,180,322
33,"SĂLAJ","#N/A",140501,,106,"CHIEŞD / SALA DE SPORT CHIEŞD",3,13296,"CHIEŞD",140501,1571,901,851,50,0,895,6,1720,819,472,423
33,"SĂLAJ","#N/A",140501,,107,"SIGHETU SILVANIEI / SC PRIMARA SIGHETU SILVANIEI",3,13296,"CHIEŞD",140501,408,287,244,38,5,286,1,440,153,199,87
33,"SĂLAJ","#N/A",140547,,108,"CIZER / ŞCOALA GIM.CIZER",3,13300,"CIZER",140547,1316,766,695,71,0,760,6,1440,674,202,558
33,"SĂLAJ","#N/A",140547,,109,"PLESCA / ŞCOALA GIM.PLESCA",3,13300,"CIZER",140547,164,117,94,23,0,115,2,180,63,30,85
33,"SĂLAJ","#N/A",140547,,110,"PRIA / CĂMIN CULTURAL",3,13300,"CIZER",140547,344,260,191,69,0,257,3,370,110,123,134
33,"SĂLAJ","#N/A",140583,,111,"COŞEIU / PRIMARIA COMUNEI COSEIU",3,13304,"COŞEIU",140583,361,230,204,25,1,230,0,400,170,82,148
33,"SĂLAJ","#N/A",140583,,112,"COŞEIU / SCOALA GIMNAZIALA ARCHID",3,13304,"COŞEIU",140583,362,176,162,14,0,173,3,400,224,36,137
33,"SĂLAJ","#N/A",140583,,113,"COŞEIU / SCOALA CU CLS. I-IV CHILIOARA",3,13304,"COŞEIU",140583,250,213,159,53,1,211,2,270,57,108,103
33,"SĂLAJ","#N/A",140627,,114,"CRASNA / Caminul Cultural ""Petofi Sandor""",3,13308,"CRASNA",140627,1960,1069,947,42,80,1056,13,2160,1091,279,777
33,"SĂLAJ","#N/A",140627,,115,"CRASNA / Muzeul satului",3,13308,"CRASNA",140627,1762,998,949,30,19,989,9,1930,932,161,828
33,"SĂLAJ","#N/A",140627,,116,"HUSENI / Caminul cultural",3,13308,"CRASNA",140627,397,282,254,28,0,277,5,420,138,112,165
33,"SĂLAJ","#N/A",140627,,117,"MARIN / Caminul cultural",3,13308,"CRASNA",140627,780,440,374,66,0,436,4,850,410,117,319
33,"SĂLAJ","#N/A",140627,,118,"RATIN / Centru de zi pentru copii",3,13308,"CRASNA",140627,381,207,188,19,0,203,4,420,213,53,150
33,"SĂLAJ","#N/A",140672,,119,"CREACA / SCOALA GIMNAZIALA MARCUS AURELIU CREACA",3,13313,"CREACA",140672,371,232,187,45,0,231,1,410,178,130,101
33,"SĂLAJ","#N/A",140672,,120,"BREBI / SCOALA GENERALA BREBI",3,13313,"CREACA",140672,443,274,233,37,4,272,2,480,206,122,150
33,"SĂLAJ","#N/A",140672,,121,"JAC / SCOALA GIMNAZIALA JAC",3,13313,"CREACA",140672,590,450,366,75,9,448,2,640,190,250,198
33,"SĂLAJ","#N/A",140672,,122,"BRUSTURI / SCOALA GENERALA BRUSTURI",3,13313,"CREACA",140672,122,124,77,47,0,123,1,130,6,60,63
33,"SĂLAJ","#N/A",140672,,123,"LUPOAIA / SCOALA GENERALA LUPOAIA",3,13313,"CREACA",140672,229,153,121,32,0,151,2,240,87,75,76
33,"SĂLAJ","#N/A",140672,,124,"BORZA / SCOALA GENERALA BORZA",3,13313,"CREACA",140672,156,123,93,30,0,122,1,170,47,62,60
33,"SĂLAJ","#N/A",140672,,125,"PRODĂNEŞTI / SCOALA GENERALA PRODANESTI",3,13313,"CREACA",140672,207,134,122,12,0,134,0,220,86,67,67
33,"SĂLAJ","#N/A",140672,,126,"CIGLEAN / SCOALA GENERALA CIGLEAN",3,13313,"CREACA",140672,137,88,78,10,0,88,0,140,52,57,31
33,"SĂLAJ","#N/A",140770,,127,"CRISTOLŢ / Căminul Cultural Cristolţ",3,13327,"CRISTOLŢ",140770,540,332,302,30,0,329,3,590,258,147,182
33,"SĂLAJ","#N/A",140770,,128,"MUNCEL / ŞCOALA PRIMARĂ MUNCEL",3,13327,"CRISTOLŢ",140770,144,95,82,13,0,94,1,160,65,49,45
33,"SĂLAJ","#N/A",140770,,129,"POIANA ONŢII / ŞCOALA PRIMARĂ POIANA ONŢII",3,13327,"CRISTOLŢ",140770,64,50,34,16,0,49,1,80,30,20,29
33,"SĂLAJ","#N/A",140770,,130,"VĂLENI / ŞCOALA  PRIMARĂ VĂLENI",3,13327,"CRISTOLŢ",140770,353,217,191,26,0,214,3,390,173,106,108
33,"SĂLAJ","#N/A",140823,,131,"CRIŞENI / SCOALA GIMNAZIALA VASILE BREBAN CRISENI",3,13323,"CRIŞENI",140823,1333,1027,884,100,43,1023,4,1460,433,381,642
33,"SĂLAJ","#N/A",140823,,132,"CRISTUR-CRIŞENI / SCOALA PRIMARA CRISTUR- CRISENI",3,13323,"CRIŞENI",140823,403,237,213,13,11,237,0,433,196,33,204
33,"SĂLAJ","#N/A",140823,,133,"GÎRCEIU / SCOALA PRIMARA GIRCEIU",3,13323,"CRIŞENI",140823,634,391,354,37,0,387,4,680,289,144,243
33,"SĂLAJ","#N/A",140869,,134,"CUZĂPLAC /  Şcoala Gimnazială Cuzăplac. Localitatea Cuzăplac nr. 242",3,13332,"CUZĂPLAC",140869,471,361,301,48,12,359,2,520,159,235,124
33,"SĂLAJ","#N/A",140869,,135,"GĂLĂŞENI / Cămin cultural Gălăşeni. Localitatea Gălăşeni nr. 50",3,13332,"CUZĂPLAC",140869,91,94,53,41,0,92,2,115,21,50,42
33,"SĂLAJ","#N/A",140869,,136,"MIERŢA / Şcoala cu clasele I-IV Mierţa. Localitatea Mierţa nr. 97 . Sala de clasă",3,13332,"CUZĂPLAC",140869,119,96,71,25,0,96,0,130,34,67,29
33,"SĂLAJ","#N/A",140869,,137,"PETRINDU / Centru de zi Petrindu. Localitatea Petrindu nr. 78",3,13332,"CUZĂPLAC",140869,367,323,252,50,21,323,0,400,77,177,146
33,"SĂLAJ","#N/A",140869,,138,"RUGINOASA / Cămin cultural Ruginoasa. Localitatea Ruginoasa nr. 22.",3,13332,"CUZĂPLAC",140869,81,83,45,38,0,82,1,100,17,48,34
33,"SĂLAJ","#N/A",140869,,139,"TĂMASA / Şcoala cu clasele I-IV Tămaşa. Localitatea Tămaşa nr. 229",3,13332,"CUZĂPLAC",140869,273,264,195,61,8,263,1,300,36,204,59
33,"SĂLAJ","#N/A",140958,,140,"DOBRIN / CĂMIN CULTURAL",3,13341,"DOBRIN",140958,367,209,174,21,14,207,2,410,201,78,129
33,"SĂLAJ","#N/A",140958,,141,"DOBA / SCOALA ELEMENTARA",3,13341,"DOBRIN",140958,270,174,143,15,16,171,3,290,116,43,128
33,"SĂLAJ","#N/A",140958,,142,"DOBA / CENTRU DE ZI DOBA",3,13341,"DOBRIN",140958,208,136,116,15,5,136,0,220,84,33,103
33,"SĂLAJ","#N/A",140958,,143,"NAIMON / Camin cultural Naimon",3,13341,"DOBRIN",140958,143,73,58,13,2,71,2,150,77,21,50
33,"SĂLAJ","#N/A",140958,,144,"VERVEGHIU / Scoala elementara verveghiul Verveghiu",3,13341,"DOBRIN",140958,375,213,170,25,18,210,3,410,197,66,144
33,"SĂLAJ","#N/A",141027,,145,"DRAGU / Primăria Dragu,nr.120",3,13348,"DRAGU",141027,502,359,274,84,1,355,4,550,191,198,157
33,"SĂLAJ","#N/A",141027,,146,"ADALIN / Şcoala cu cls.I-IV,nr.100",3,13348,"DRAGU",141027,128,97,55,42,0,95,2,140,43,31,64
33,"SĂLAJ","#N/A",141027,,147,"UGRUŢIU / Cămin cultural, nr.20",3,13348,"DRAGU",141027,24,53,7,46,0,53,0,80,27,20,33
33,"SĂLAJ","#N/A",141027,,148,"VOIVODENI / Şcoala cu cls.I-IV,nr.117",3,13348,"DRAGU",141027,241,182,122,59,1,182,0,250,68,74,108
33,"SĂLAJ","#N/A",141081,,149,"FILDU DE JOS / SCOALA PRIMARA FILDU DE JOS",3,13354,"FILDU DE JOS",141081,177,180,120,54,6,179,1,190,10,72,107
33,"SĂLAJ","#N/A",141081,,150,"FILDU DE MIJLOC / CAMINUL CULTURAL FILDU DE MIJLOC",3,13354,"FILDU DE JOS",141081,328,261,214,33,14,261,0,360,99,148,113
33,"SĂLAJ","#N/A",141081,,151,"FILDU DE SUS / CAMINUL CULTURAL FILDU DE SUS",3,13354,"FILDU DE JOS",141081,316,284,221,52,11,283,1,350,66,204,79
33,"SĂLAJ","#N/A",141081,,152,"TETIŞU / SCOALA PRIMARA TETISU",3,13354,"FILDU DE JOS",141081,255,203,160,38,5,200,3,280,77,34,166
33,"SĂLAJ","#N/A",141134,,153,"BÎRSĂU MARE / Scoala cu clasele I-IV",3,13359,"GÎLGĂU",141134,198,153,108,45,0,153,0,210,57,68,85
33,"SĂLAJ","#N/A",141134,,154,"CĂPÎLNA / Scoala cu clasele I-IV",3,13359,"GÎLGĂU",141134,250,240,173,67,0,240,0,270,30,57,183
33,"SĂLAJ","#N/A",141134,,155,"CHIZENI / Scoala cu clasele I-IV",3,13359,"GÎLGĂU",141134,91,79,64,15,0,79,0,110,31,47,32
33,"SĂLAJ","#N/A",141134,,156,"GLOD / Scoala cu clasele I-IV",3,13359,"GÎLGĂU",141134,410,308,248,60,0,305,3,440,132,88,217
33,"SĂLAJ","#N/A",141134,,157,"GÎLGĂU / Liceul Tehnologic",3,13359,"GÎLGĂU",141134,531,401,330,71,0,394,7,580,179,150,244
33,"SĂLAJ","#N/A",141134,,158,"DOBROCINA / Camin Cultural",3,13359,"GÎLGĂU",141134,136,134,90,44,0,130,4,140,6,55,75
33,"SĂLAJ","#N/A",141134,,159,"FODORA / Scoala gimnaziala",3,13359,"GÎLGĂU",141134,359,264,214,50,0,264,0,390,126,69,195
33,"SĂLAJ","#N/A",141232,,160,"GÎRBOU / Primăria Gîrbou",3,13369,"GÎRBOU",141232,520,290,247,41,2,285,5,570,280,122,163
33,"SĂLAJ","#N/A",141232,,161,"SOLOMON / Căminul cultural",3,13369,"GÎRBOU",141232,308,211,182,27,2,208,3,340,129,129,79
33,"SĂLAJ","#N/A",141232,,162,"CĂLACEA / Şcoala primară",3,13369,"GÎRBOU",141232,222,179,139,40,0,178,1,250,71,86,92
33,"SĂLAJ","#N/A",141232,,163,"POPTELEAC / Şcoala primară",3,13369,"GÎRBOU",141232,275,155,122,33,0,153,2,300,145,67,86
33,"SĂLAJ","#N/A",141232,,164,"CERNUC / CĂMINUL CULTURAL CERNUC",3,13369,"GÎRBOU",141232,154,125,78,47,0,125,0,160,35,58,67
33,"SĂLAJ","#N/A",141232,,165,"BEZDED / Căminul cultural",3,13369,"GÎRBOU",141232,110,91,56,35,0,88,3,120,29,53,35
33,"SĂLAJ","#N/A",141232,,166,"FABRICA / Şcoala primară",3,13369,"GÎRBOU",141232,84,63,49,14,0,63,0,110,47,37,26
33,"SĂLAJ","#N/A",141312,,167,"HALMĂŞD / CAMINUL CULTURAL",3,13377,"HALMĂŞD",141312,902,556,513,40,3,544,12,990,434,237,307
33,"SĂLAJ","#N/A",141312,,168,"ALEUŞ / SCOALA",3,13377,"HALMĂŞD",141312,253,174,152,19,3,172,2,270,96,86,86
33,"SĂLAJ","#N/A",141312,,169,"CERIŞA / SCOALA VECHE",3,13377,"HALMĂŞD",141312,450,321,304,17,0,319,2,490,169,157,162
33,"SĂLAJ","#N/A",141312,,170,"DRIGHIU / SCOALA VECHE",3,13377,"HALMĂŞD",141312,328,217,185,31,1,212,5,360,143,80,132
33,"SĂLAJ","#N/A",141376,,171,"HERECLEAN / Căminul Cultural Hereclean",3,13383,"HERECLEAN",141376,420,314,231,83,0,314,0,460,146,115,199
33,"SĂLAJ","#N/A",141376,,172,"BADON / Şcoala Primară Badon",3,13383,"HERECLEAN",141376,540,395,326,69,0,392,3,570,175,138,254
33,"SĂLAJ","#N/A",141376,,173,"BOCŞIŢA / Căminul Cultural Bocşiţa",3,13383,"HERECLEAN",141376,82,93,45,48,0,93,0,110,17,44,49
33,"SĂLAJ","#N/A",141376,,174,"DIOŞOD / Punct Sanitar Dioşod",3,13383,"HERECLEAN",141376,716,422,336,47,39,418,4,780,358,195,223
33,"SĂLAJ","#N/A",141376,,175,"GURUSLĂU / Şcoala Gimnazială Guruslău",3,13383,"HERECLEAN",141376,498,299,270,29,0,297,2,540,241,53,244
33,"SĂLAJ","#N/A",141376,,176,"PANIC / Şcoala Gimnazială Panic",3,13383,"HERECLEAN",141376,851,483,455,23,5,481,2,910,427,75,406
33,"SĂLAJ","#N/A",141447,,177,"BAICA / CAMIN CULTURAL",3,13390,"HIDA",141447,103,87,60,27,0,87,0,110,23,48,39
33,"SĂLAJ","#N/A",141447,,178,"MILUANI / CAMIN CULTURAL",3,13390,"HIDA",141447,30,76,15,58,3,76,0,90,14,39,37
33,"SĂLAJ","#N/A",141447,,179,"HIDA / PRIMARIA",3,13390,"HIDA",141447,916,532,484,46,2,528,4,1000,468,212,316
33,"SĂLAJ","#N/A",141447,,180,"RACÎŞ / SCOALA GENERALA",3,13390,"HIDA",141447,423,276,214,62,0,274,2,470,194,123,151
33,"SĂLAJ","#N/A",141447,,181,"TRESTIA / SCOALA GENERALA",3,13390,"HIDA",141447,259,140,120,20,0,139,1,280,140,65,74
33,"SĂLAJ","#N/A",141447,,182,"SÎNPETRU ALMAŞULUI / SCOALA GENERALA",3,13390,"HIDA",141447,359,255,180,75,0,253,2,400,145,121,132
33,"SĂLAJ","#N/A",141447,,183,"STUPINI / SCOALA GENERALA",3,13390,"HIDA",141447,117,108,51,57,0,108,0,130,22,54,54
33,"SĂLAJ","#N/A",141447,,184,"PĂDURIŞ / SCOALA GENERALA",3,13390,"HIDA",141447,33,36,18,18,0,36,0,60,24,17,19
33,"SĂLAJ","#N/A",141535,,185,"STÎRCIU / Cămin cultural",3,13399,"HOROATU CRASNEI",141535,771,488,392,95,1,485,3,840,352,105,380
33,"SĂLAJ","#N/A",141535,,186,"ŞEREDEIU / Cămin cultural",3,13399,"HOROATU CRASNEI",141535,216,202,120,82,0,200,2,240,38,124,76
33,"SĂLAJ","#N/A",141535,,187,"HUREZ / NULL",3,13399,"HOROATU CRASNEI",141535,289,199,149,50,0,198,1,320,121,116,82
33,"SĂLAJ","#N/A",141535,,188,"HOROATU CRASNEI / Caminl cultural",3,13399,"HOROATU CRASNEI",141535,792,496,437,48,11,494,2,870,374,188,306
33,"SĂLAJ","#N/A",141580,,189,"DĂBÎCENI / SCOALA GENERALA",3,13404,"ILEANDA",141580,160,123,104,19,0,123,0,170,47,63,60
33,"SĂLAJ","#N/A",141580,,190,"NEGRENI / SCOALA GENERALA",3,13404,"ILEANDA",141580,82,65,48,17,0,65,0,110,45,33,32
33,"SĂLAJ","#N/A",141580,,191,"PERII VADULUI / SCOALA GENERALA",3,13404,"ILEANDA",141580,102,68,48,20,0,68,0,110,42,11,57
33,"SĂLAJ","#N/A",141580,,192,"PODIŞU / SCOALA GENERALA",3,13404,"ILEANDA",141580,117,100,73,27,0,100,0,120,20,36,64
33,"SĂLAJ","#N/A",141580,,193,"RĂSTOCI / SCOALA GENERALA",3,13404,"ILEANDA",141580,118,124,90,33,1,124,0,130,6,52,72
33,"SĂLAJ","#N/A",141580,,194,"ROGNA / SCOALA GENERALA",3,13404,"ILEANDA",141580,70,59,34,25,0,59,0,90,31,31,28
33,"SĂLAJ","#N/A",141580,,195,"ŞASA / SCOALA GENERALA",3,13404,"ILEANDA",141580,59,47,34,13,0,47,0,80,33,29,18
33,"SĂLAJ","#N/A",141580,,196,"ILEANDA / CAMIN CULTURAL ILEANDA",3,13404,"ILEANDA",141580,1014,649,535,111,3,641,8,1120,471,292,349
33,"SĂLAJ","#N/A",141580,,197,"DOLHENI / SCOALA GENERALA DOLHENI",3,13404,"ILEANDA",141580,81,69,51,18,0,69,0,110,41,20,49
33,"SĂLAJ","#N/A",141580,,198,"LUMINIŞU / SCOALA GENERALA LUMINIS",3,13404,"ILEANDA",141580,82,84,47,37,0,84,0,110,26,30,54
33,"SĂLAJ","#N/A",141722,,199,"IP / CAMIN CULTURAL IP",3,13418,"IP",141722,1454,743,692,51,0,737,6,1610,867,214,523
33,"SĂLAJ","#N/A",141722,,200,"COSNICIU DE JOS / SCOALA GIMAZIALA COSNICIU DE JOS",3,13418,"IP",141722,530,382,352,26,4,376,6,580,198,166,210
33,"SĂLAJ","#N/A",141722,,201,"COSNICIU DE SUS / SCOALA GIMAZIALA COSNICIU DE SUS",3,13418,"IP",141722,257,172,157,10,5,171,1,290,118,76,95
33,"SĂLAJ","#N/A",141722,,202,"ZĂUAN / CAMINUL CULTURAL ZAUAN",3,13418,"IP",141722,813,427,405,22,0,424,3,890,463,37,387
33,"SĂLAJ","#N/A",141786,,203,"LETCA / PRIMĂRIA COMUNEI LETCA",3,13424,"LETCA",141786,458,353,292,59,2,352,1,500,147,158,194
33,"SĂLAJ","#N/A",141786,,204,"CIULA / CLĂDIREA FOSTULUI CONSILIU CIULA",3,13424,"LETCA",141786,96,66,42,22,2,66,0,100,34,42,24
33,"SĂLAJ","#N/A",141786,,205,"COZLA / ŞCOALA COZLA",3,13424,"LETCA",141786,214,150,124,26,0,150,0,230,80,74,76
33,"SĂLAJ","#N/A",141786,,206,"CUCIULAT / ŞCOALACUCIULAT",3,13424,"LETCA",141786,161,125,100,24,1,125,0,170,45,77,48
33,"SĂLAJ","#N/A",141786,,207,"LEMNIU / ŞCOALA LEMNIU",3,13424,"LETCA",141786,356,255,212,42,1,255,0,380,125,153,102
33,"SĂLAJ","#N/A",141786,,208,"PURCĂREŢ / ŞCOALA PURCĂREŢ",3,13424,"LETCA",141786,96,83,55,28,0,83,0,100,17,21,62
33,"SĂLAJ","#N/A",141786,,209,"ŞOIMUŞENI / ŞCOALA ŞOIMUŞENI",3,13424,"LETCA",141786,67,68,50,18,0,68,0,90,22,39,29
33,"SĂLAJ","#N/A",141786,,210,"TOPLIŢA / ŞCOALA TOPLIŢA",3,13424,"LETCA",141786,106,94,80,14,0,94,0,110,16,58,36
33,"SĂLAJ","#N/A",141786,,211,"VĂLIŞOARA / ŞCOALA VĂLIŞOARA",3,13424,"LETCA",141786,26,35,14,21,0,35,0,40,5,15,20
33,"SĂLAJ","#N/A",141884,,212,"CORMENIŞ / SCOALA CU CLASELE I-IV",3,13434,"LOZNA",141884,153,133,101,32,0,133,0,160,27,50,83
33,"SĂLAJ","#N/A",141884,,213,"VALEA LOZNEI / SCOALA CU CLASELE I-IV",3,13434,"LOZNA",141884,172,128,82,46,0,128,0,190,62,56,72
33,"SĂLAJ","#N/A",141884,,214,"LOZNA / PRIMĂRIA COMUNEI LOZNA",3,13434,"LOZNA",141884,490,388,292,96,0,386,2,540,152,235,151
33,"SĂLAJ","#N/A",141946,,215,"MARCA / Cămin cultural Marca, nr. 136",3,13447,"MARCA",141946,1153,710,633,77,0,706,4,1270,560,258,448
33,"SĂLAJ","#N/A",141946,,216,"PORŢ / Scoala primara Port, nr. 27",3,13447,"MARCA",141946,246,189,164,25,0,188,1,270,81,59,129
33,"SĂLAJ","#N/A",141946,,217,"LEŞMIR / Scoala primara Lesmir, nr.130",3,13447,"MARCA",141946,346,218,201,17,0,216,2,380,162,20,196
33,"SĂLAJ","#N/A",141946,,218,"ŞUMAL / Camin cultural Sumal, nr. 237",3,13447,"MARCA",141946,438,258,242,16,0,257,1,480,222,63,194
33,"SĂLAJ","#N/A",142006,,219,"MĂERIŞTE / Şcoala Gimnaziala",3,13440,"MĂERIŞTE",142006,631,420,369,48,3,416,4,690,270,187,229
33,"SĂLAJ","#N/A",142006,,220,"GIURTELECU ŞIMLEULUI / Şcoala Gimnaziala",3,13440,"MĂERIŞTE",142006,739,482,435,47,0,475,7,810,328,156,319
33,"SĂLAJ","#N/A",142006,,221,"CRIŞTELEC / Şcoala cu clasele I-IV",3,13440,"MĂERIŞTE",142006,430,278,248,30,0,277,1,480,202,114,163
33,"SĂLAJ","#N/A",142006,,222,"DOH / Şcoala cu clasele I-IV",3,13440,"MĂERIŞTE",142006,180,135,107,28,0,133,2,200,65,58,75
33,"SĂLAJ","#N/A",142006,,223,"MĂLĂDIA / Şcoala cu clasele I-IV",3,13440,"MĂERIŞTE",142006,172,103,88,15,0,102,1,190,87,39,63
33,"SĂLAJ","#N/A",142006,,224,"UILEACU ŞIMLEULUI / Şcoala cu clasele I-IV",3,13440,"MĂERIŞTE",142006,386,177,162,15,0,177,0,420,243,27,150
33,"SĂLAJ","#N/A",142079,,225,"MESEŞENII DE JOS / Primăria comunei Meseşenii de Jos",3,13453,"MESEŞENII DE JOS",142079,523,393,315,59,19,390,3,570,177,198,192
33,"SĂLAJ","#N/A",142079,,226,"AGHIREŞ /  Centrul After School",3,13453,"MESEŞENII DE JOS",142079,1172,727,660,65,2,724,3,1300,573,152,572
33,"SĂLAJ","#N/A",142079,,227,"FETINDIA / Scolala Gimnaziala Fetindia",3,13453,"MESEŞENII DE JOS",142079,150,109,79,30,0,109,0,150,41,52,57
33,"SĂLAJ","#N/A",142079,,228,"MESEŞENII DE SUS / Centrul de zi",3,13453,"MESEŞENII DE JOS",142079,661,476,359,96,21,470,6,720,244,222,248
33,"SĂLAJ","#N/A",142122,,229,"MIRŞID / Sala de şedinţă a primăriei",3,13458,"MIRŞID",142122,539,387,327,48,12,383,4,590,203,245,138
33,"SĂLAJ","#N/A",142122,,230,"FIRMINIŞ / Şcoala  cu clasele I-IV.",3,13458,"MIRŞID",142122,133,123,66,53,4,123,0,140,17,62,61
33,"SĂLAJ","#N/A",142122,,231,"MOIGRAD-POROLISSUM / Şcoala  cu clasele I-IV.",3,13458,"MIRŞID",142122,446,283,248,35,0,283,0,481,198,112,171
33,"SĂLAJ","#N/A",142122,,232,"POPENI / Şcoala  cu clasele I-IV.",3,13458,"MIRŞID",142122,750,519,443,60,16,515,4,820,301,309,206
33,"SĂLAJ","#N/A",142177,,233,"NĂPRADEA / PRIMARIA NAPRADEA",3,13463,"NĂPRADEA",142177,665,408,343,50,15,404,4,740,332,217,187
33,"SĂLAJ","#N/A",142177,,234,"CHEUD / SC GIMNAZ PETRE HOSSU",3,13463,"NĂPRADEA",142177,679,470,407,52,11,468,2,740,270,239,229
33,"SĂLAJ","#N/A",142177,,235,"SOMEŞ-GURUSLĂU / SCOALA SOMES GURUSLAU",3,13463,"NĂPRADEA",142177,370,252,191,61,0,251,1,410,158,117,134
33,"SĂLAJ","#N/A",142177,,236,"TRANIŞ / SCOALA TRANIS",3,13463,"NĂPRADEA",142177,290,178,154,20,4,177,1,320,142,98,79
33,"SĂLAJ","#N/A",142177,,237,"VĂDURELE / SCOALA VADURELE",3,13463,"NĂPRADEA",142177,181,132,119,13,0,131,1,190,58,52,79
33,"SĂLAJ","#N/A",142239,,238,"BILGHEZ / Caminul Cultural",3,13469,"NUŞFALĂU",142239,356,161,147,14,0,159,2,390,229,26,133
33,"SĂLAJ","#N/A",142239,,239,"NUŞFALĂU / CAMIN CULTURAL",3,13469,"NUŞFALĂU",142239,1255,713,698,15,0,708,5,1370,657,288,420
33,"SĂLAJ","#N/A",142239,,240,"NUŞFALĂU / Primaria Nusfalau - Sala de sedinte",3,13469,"NUŞFALĂU",142239,1425,847,807,40,0,842,5,1560,713,111,731
33,"SĂLAJ","#N/A",142284,,241,"PERICEI / GRADINITA CU PROGRAM PRELUNGIT NR. 1 PERICEI",3,13472,"PERICEI",142284,1062,526,500,26,0,522,4,1170,644,111,411
33,"SĂLAJ","#N/A",142284,,242,"PERICEI / Primaria Comunei Pericei",3,13472,"PERICEI",142284,1252,734,707,26,1,730,4,1370,636,104,626
33,"SĂLAJ","#N/A",142284,,243,"BĂDĂCIN / Scoala Generală Bădăcin",3,13472,"PERICEI",142284,604,416,328,53,35,409,7,670,254,55,354
33,"SĂLAJ","#N/A",142284,,244,"SICI / Scoala Generală Sici",3,13472,"PERICEI",142284,168,112,78,29,5,111,1,190,78,48,63
33,"SĂLAJ","#N/A",142337,,245,"PLOPIŞ / Camin Cultural Plopis",3,13477,"PLOPIŞ",142337,810,492,429,57,6,486,6,890,398,112,374
33,"SĂLAJ","#N/A",142337,,246,"IAZ / SCOALA GIMNAZIALA IAZ",3,13477,"PLOPIŞ",142337,616,357,311,35,11,354,3,690,333,65,289
33,"SĂLAJ","#N/A",142337,,247,"FĂGETU / CAMIN CULTURAL FAGETU",3,13477,"PLOPIŞ",142337,534,275,241,33,1,274,1,590,315,46,228
33,"SĂLAJ","#N/A",142373,,248,"POIANA BLENCHII / SCOALA GIMN P.Blenchii",3,13481,"POIANA BLENCHII",142373,642,463,393,64,6,461,2,700,237,253,208
33,"SĂLAJ","#N/A",142373,,249,"GOSTILA / Şcoala cu cls. I-IV Gostila",3,13481,"POIANA BLENCHII",142373,355,258,218,38,2,258,0,390,132,127,131
33,"SĂLAJ","#N/A",142426,,250,"ROMÂNAŞI / Şcoala cu cls. I-VIII Românaşi",3,13486,"ROMÂNAŞI",142426,762,472,405,67,0,468,4,830,358,147,321
33,"SĂLAJ","#N/A",142426,,251,"CHICHIŞA / Şcoala cu cls. I-IV Chichişa",3,13486,"ROMÂNAŞI",142426,189,148,117,31,0,147,1,210,62,78,69
33,"SĂLAJ","#N/A",142426,,252,"CIUMĂRNA / Şcoala cu cls. I-IV Ciumărna",3,13486,"ROMÂNAŞI",142426,347,278,187,91,0,277,1,380,102,93,184
33,"SĂLAJ","#N/A",142426,,253,"PĂUŞA / Şcoala cu cls. I-IV Pausa",3,13486,"ROMÂNAŞI",142426,384,272,208,64,0,268,4,420,148,117,151
33,"SĂLAJ","#N/A",142426,,254,"POARTA SĂLAJULUI / Şcoala cu cls. I-IV Poarta Salajului",3,13486,"ROMÂNAŞI",142426,371,324,236,88,0,321,3,400,76,129,192
33,"SĂLAJ","#N/A",142426,,255,"ROMITA / Şcoala cu cls. I-IV Romita",3,13486,"ROMÂNAŞI",142426,239,128,93,35,0,127,1,260,132,47,80
33,"SĂLAJ","#N/A",142499,,256,"RUS / ŞCOALA GIMNAZIALĂ RUS",3,13493,"RUS",142499,634,432,360,62,10,430,2,690,258,216,214
33,"SĂLAJ","#N/A",142499,,257,"FÎNTÎNELE-RUS / ŞCOALA PRIMARĂ FÎNTÎNELE-RUS",3,13493,"RUS",142499,154,144,112,31,1,143,1,160,16,81,62
33,"SĂLAJ","#N/A",142499,,258,"BUZAŞ / ŞCOALA PRIMARĂ BUZAŞ",3,13493,"RUS",142499,119,92,75,17,0,92,0,130,38,46,46
33,"SĂLAJ","#N/A",142550,,259,"SĂLĂŢIG / Şcoala Gimnazială Petre Dulfu Sălăţig",3,13497,"SĂLĂŢIG",142550,419,240,227,12,1,240,0,460,220,56,184
33,"SĂLAJ","#N/A",142550,,260,"BULGARI / Şcoala Primară Bulgari",3,13497,"SĂLĂŢIG",142550,201,136,107,29,0,136,0,220,84,63,73
33,"SĂLAJ","#N/A",142550,,261,"DEJA / Şcoala Gimnayială Deja",3,13497,"SĂLĂŢIG",142550,992,498,483,15,0,497,1,1080,582,130,367
33,"SĂLAJ","#N/A",142550,,262,"MINEU / Şcoala Primară Mineu",3,13497,"SĂLĂŢIG",142550,276,153,122,31,0,153,0,300,147,43,110
33,"SĂLAJ","#N/A",142550,,263,"NOŢIG / Şcoala Primară Noţig",3,13497,"SĂLĂŢIG",142550,384,346,277,69,0,345,1,420,74,96,249
33,"SĂLAJ","#N/A",142612,,264,"SÎG / PRIMARIA SIG",3,13513,"SÎG",142612,573,297,280,17,0,293,4,620,323,86,207
33,"SĂLAJ","#N/A",142612,,265,"FIZEŞ / CAMIN CULTURAL FIZES",3,13513,"SÎG",142612,303,180,159,21,0,177,3,330,150,62,115
33,"SĂLAJ","#N/A",142612,,266,"MAL / CAMIN CULTURAL MAL",3,13513,"SÎG",142612,844,426,389,37,0,415,11,920,494,125,290
33,"SĂLAJ","#N/A",142612,,267,"SÎRBI / SCOALA PRIMARA SIRBI",3,13513,"SÎG",142612,238,102,90,12,0,100,2,260,158,38,62
33,"SĂLAJ","#N/A",142612,,268,"TUSA / SCOALA GIMNAZIALA TUSA",3,13513,"SÎG",142612,592,337,292,45,0,334,3,660,323,147,187
33,"SĂLAJ","#N/A",142676,,269,"SÎNMIHAIU ALMAŞULUI / Sediul consiliului local Sînmihaiu Almaşului , nr. 93",3,13522,"SÎNMIHAIU ALMAŞULUI",142676,885,560,446,99,15,557,3,980,420,302,255
33,"SĂLAJ","#N/A",142676,,270,"BERCEA / Şcoala cu clasele  I - IV , Bercea nr. 30",3,13522,"SÎNMIHAIU ALMAŞULUI",142676,129,97,81,16,0,96,1,140,43,50,46
33,"SĂLAJ","#N/A",142676,,271,"SÎNTĂ MĂRIA / Şcoala cu clasele  I - IV",3,13522,"SÎNMIHAIU ALMAŞULUI",142676,309,225,190,35,0,225,0,330,105,106,119
33,"SĂLAJ","#N/A",142710,,272,"SOMEŞ-ODORHEI / CAMINUL CULTURAL",3,13526,"SOMEŞ-ODORHEI",142710,1107,716,605,84,27,707,9,1210,494,336,371
33,"SĂLAJ","#N/A",142710,,273,"INĂU / CAMINUL CULTURAL",3,13526,"SOMEŞ-ODORHEI",142710,505,408,332,61,15,407,1,550,142,253,154
33,"SĂLAJ","#N/A",142710,,274,"ŞOIMUŞ / CAMINUL CULTURAL",3,13526,"SOMEŞ-ODORHEI",142710,249,160,112,48,0,160,0,270,110,92,68
33,"SĂLAJ","#N/A",142710,,275,"BÎRSA / SCOALA  PRIMARA",3,13526,"SOMEŞ-ODORHEI",142710,94,70,41,29,0,70,0,100,30,45,25
33,"SĂLAJ","#N/A",142710,,276,"DOMNIN / SCOALA  PRIMARA",3,13526,"SOMEŞ-ODORHEI",142710,267,245,156,78,11,244,1,290,45,123,121
33,"SĂLAJ","#N/A",142774,,277,"SURDUC / CAMINUL CULTURAL",3,13532,"SURDUC",142774,1074,758,660,76,22,748,10,1180,422,420,328
33,"SĂLAJ","#N/A",142774,,278,"BRÎGLEZ / Cămin cult.Brîglez",3,13532,"SURDUC",142774,232,217,159,45,13,217,0,250,33,135,82
33,"SĂLAJ","#N/A",142774,,279,"CRISTOLŢEL / Scoala .primară cls.I-IV",3,13532,"SURDUC",142774,361,271,224,39,8,269,2,400,129,156,113
33,"SĂLAJ","#N/A",142774,,280,"SOLONA / Cămin cult.Solona",3,13532,"SURDUC",142774,214,191,143,42,6,190,1,240,49,120,70
33,"SĂLAJ","#N/A",142774,,281,"TEŞTIOARA / Cămin cult.Teştioara",3,13532,"SURDUC",142774,65,58,38,19,1,57,1,90,32,41,16
33,"SĂLAJ","#N/A",142774,,282,"TIHĂU / Cămin cult.Tihău",3,13532,"SURDUC",142774,890,681,578,77,26,681,0,970,289,367,314
33,"SĂLAJ","#N/A",142774,,283,"TURBUŢA / Scoala primară cls.I-IV",3,13532,"SURDUC",142774,265,129,104,25,0,129,0,290,161,68,61
33,"SĂLAJ","#N/A",142854,,284,"ŞAMŞUD / Primăria Comunei Şamşud",3,13503,"ŞAMŞUD",142854,916,457,437,20,0,447,10,1000,543,114,333
33,"SĂLAJ","#N/A",142854,,285,"VALEA POMILOR / Fosta grădiniţă cu program normal",3,13503,"ŞAMŞUD",142854,442,240,217,23,0,238,2,470,230,72,166
33,"SĂLAJ","#N/A",142881,,286,"ŞĂRMĂŞAG / Centrul cultural comunitar,Şărmăşag, str.Teilor,nr.71/a",3,13506,"ŞĂRMĂŞAG",142881,938,529,482,22,25,528,1,1020,491,87,441
33,"SĂLAJ","#N/A",142881,,287,"ŞĂRMĂŞAG / LICEUL TEHNOLOGIC NR.1",3,13506,"ŞĂRMĂŞAG",142881,820,458,423,26,9,458,0,900,442,100,358
33,"SĂLAJ","#N/A",142881,,288,"ŞĂRMĂŞAG / GRADINITA DE COPII NR.3",3,13506,"ŞĂRMĂŞAG",142881,872,485,447,21,17,484,1,950,465,61,423
33,"SĂLAJ","#N/A",142881,,289,"ŞĂRMĂŞAG / Şcoala generală nr.2 ,str.Minerilor,nr.9/a",3,13506,"ŞĂRMĂŞAG",142881,1280,628,597,28,3,623,5,1400,772,151,472
33,"SĂLAJ","#N/A",142881,,290,"ILIŞUA / Şcoala generală Selymes Peter Ilişua,nr.54/a",3,13506,"ŞĂRMĂŞAG",142881,581,302,266,20,16,299,3,630,328,53,246
33,"SĂLAJ","#N/A",142881,,291,"LOMPIRT / Şcoala generală Ady Endre,Lompirt,nr.51",3,13506,"ŞĂRMĂŞAG",142881,679,323,287,36,0,320,3,750,427,109,211
33,"SĂLAJ","#N/A",142881,,292,"MOIAD / Cămin cultural, Moiad,nr.53/a",3,13506,"ŞĂRMĂŞAG",142881,182,127,108,19,0,127,0,190,63,54,73
33,"SĂLAJ","#N/A",179695,,293,"ŞIMIŞNA / Şcoala gimnazială Şimişna",3,13519,"ŞIMIŞNA",179695,726,476,403,63,10,472,4,800,324,303,169
33,"SĂLAJ","#N/A",179695,,294,"HĂŞMAŞ / Şcoala cu cls. I-IV Hăşmaş",3,13519,"ŞIMIŞNA",179695,268,202,172,30,0,198,4,300,98,133,65
33,"SĂLAJ","#N/A",179631,,295,"TREZNEA / SCOALA GIMNAZIALA TREZNEA",3,13540,"TREZNEA",179631,633,441,374,66,1,438,3,690,249,170,268
33,"SĂLAJ","#N/A",179631,,296,"BOZNA / SCOALA GENERALA BOZNA",3,13540,"TREZNEA",179631,204,157,128,29,0,156,1,220,63,50,106
33,"SĂLAJ","#N/A",142952,,297,"VALCĂU DE JOS / Căminul  cultural",3,13543,"VALCĂU DE JOS",142952,736,466,418,45,3,461,5,810,344,129,332
33,"SĂLAJ","#N/A",142952,,298,"VALCĂU DE SUS / Şcoala Gimnazială",3,13543,"VALCĂU DE JOS",142952,676,474,431,28,15,468,6,750,276,204,264
33,"SĂLAJ","#N/A",142952,,299,"PREOTEASA / Şcoala Gimnazială",3,13543,"VALCĂU DE JOS",142952,531,347,324,11,12,345,2,580,233,137,208
33,"SĂLAJ","#N/A",142952,,300,"LAZURI / Grădiniţă",3,13543,"VALCĂU DE JOS",142952,216,157,141,13,3,156,1,240,83,39,117
33,"SĂLAJ","#N/A",142952,,301,"SUB CETATE / şcoala cu clasele I-IV",3,13543,"VALCĂU DE JOS",142952,305,249,213,24,12,247,2,330,81,109,138
33,"SĂLAJ","#N/A",143021,,302,"VÎRŞOLŢ / PRIMARIA VARSOLT",3,13550,"VÎRŞOLŢ",143021,1406,674,642,32,0,671,3,1550,876,96,575
33,"SĂLAJ","#N/A",143021,,303,"RECEA / Şcoala Recea",3,13550,"VÎRŞOLŢ",143021,515,300,258,42,0,299,1,560,260,118,181
33,"SĂLAJ","#N/A",143067,,304,"ZALHA / Camin cultural Zalha",3,13554,"ZALHA",143067,241,150,119,31,0,150,0,260,110,86,64
33,"SĂLAJ","#N/A",143067,,305,"CEACA / Scoala cu clasele I-IV Ceaca",3,13554,"ZALHA",143067,193,152,122,30,0,152,0,210,58,71,81
33,"SĂLAJ","#N/A",143067,,306,"VALEA HRANEI / Scoala cu clasele I-IV Valea Hranei",3,13554,"ZALHA",143067,79,64,48,16,0,64,0,100,36,19,45
33,"SĂLAJ","#N/A",143067,,307,"CIURENI / Scoala cu clasele I-IV Ciureni",3,13554,"ZALHA",143067,115,107,71,36,0,107,0,120,13,52,55
33,"SĂLAJ","#N/A",143067,,308,"VALEA LUNGĂ / Scoala cu clasele I-IV Valea Lunga",3,13554,"ZALHA",143067,133,86,73,13,0,86,0,140,54,21,65
33,"SĂLAJ","#N/A",143147,,309,"DOLU / Caminul Cultural",3,13562,"ZIMBOR",143147,49,63,31,32,0,63,0,70,7,16,47
33,"SĂLAJ","#N/A",143147,,310,"SUTORU / Camin Cultural",3,13562,"ZIMBOR",143147,111,109,76,33,0,108,1,141,32,28,80
33,"SĂLAJ","#N/A",143147,,311,"ZIMBOR / Sala de Sport Zimbor",3,13562,"ZIMBOR",143147,536,406,322,81,3,400,6,600,194,140,260
33,"SĂLAJ","#N/A",143147,,312,"SÎNCRAIU ALMAŞULUI / Scoala primara",3,13562,"ZIMBOR",143147,158,133,92,41,0,129,4,170,37,57,72
34,"SIBIU",323,143450,,1,"SIBIU / Şcoala cu clasele I-VIII nr. 10 cu structura Gradiniţa cu program normal nr. 20",1,13569,"MUNICIPIUL SIBIU",143450,1526,939,891,48,0,935,4,1650,711,173,762
34,"SIBIU",323,143450,,2,"SIBIU / Şcoala cu clasele I-VIII nr. 10 cu structura Gradiniţa cu program normal nr. 20",1,13569,"MUNICIPIUL SIBIU",143450,1596,953,901,52,0,948,5,1750,797,183,765
34,"SIBIU",323,143450,,3,"SIBIU / Şcoala cu clasele I-VIII nr.10",1,13569,"MUNICIPIUL SIBIU",143450,1681,1156,1028,127,1,1148,8,1800,644,201,947
34,"SIBIU",323,143450,,4,"SIBIU / Şcoala cu clasele I-VIII nr.10",1,13569,"MUNICIPIUL SIBIU",143450,1962,1470,1314,156,0,1465,5,2100,630,178,1287
34,"SIBIU",323,143450,,5,"SIBIU / Şcoala cu clasele I-VIII nr.10",1,13569,"MUNICIPIUL SIBIU",143450,1518,1196,968,228,0,1190,6,1650,454,188,1002
34,"SIBIU",323,143450,,6,"SIBIU / Şcoala cu clasele I-VIII nr. 13 cu structura Şcoala cu clasele I-VIII nr. 12",1,13569,"MUNICIPIUL SIBIU",143450,1559,1035,953,81,1,1024,11,1700,665,175,849
34,"SIBIU",323,143450,,7,"SIBIU / Şcoala cu clasele I-VIII nr. 13 cu structura Şcoala cu clasele I-VIII nr. 12",1,13569,"MUNICIPIUL SIBIU",143450,1368,973,912,60,1,968,5,1450,477,179,789
34,"SIBIU",323,143450,,8,"SIBIU / Şcoala cu clasele I-VIII nr. 13 cu structura Şcoala cu clasele I-VIII nr. 12",1,13569,"MUNICIPIUL SIBIU",143450,1347,972,906,65,1,960,12,1450,478,149,811
34,"SIBIU",323,143450,,9,"SIBIU / Grup Şcolar C-tii şi Arhitectură Carol I Sibiu",1,13569,"MUNICIPIUL SIBIU",143450,1595,1220,1026,151,43,1216,4,1650,430,175,1041
34,"SIBIU",323,143450,,10,"SIBIU / Şcoala cu clasele I-VIII nr.13",1,13569,"MUNICIPIUL SIBIU",143450,1033,815,704,109,2,798,17,1100,285,145,653
34,"SIBIU",323,143450,,11,"SIBIU / Şcoala cu clasele I-VIII nr.13",1,13569,"MUNICIPIUL SIBIU",143450,1179,873,773,99,1,869,4,1300,427,126,743
34,"SIBIU",323,143450,,12,"SIBIU / Şcoala cu clasele I-VIII nr.13",1,13569,"MUNICIPIUL SIBIU",143450,1327,992,890,102,0,983,9,1450,458,151,832
34,"SIBIU",323,143450,,13,"SIBIU / Şcoala cu clasele I-VIII nr. 23",1,13569,"MUNICIPIUL SIBIU",143450,1576,1180,1110,70,0,1175,5,1700,520,142,1033
34,"SIBIU",323,143450,,14,"SIBIU / Şcoala cu clasele I-VIII nr. 23",1,13569,"MUNICIPIUL SIBIU",143450,1282,816,755,61,0,811,5,1400,584,115,696
34,"SIBIU",323,143450,,15,"SIBIU / Şcoala cu clasele I-VIII nr. 23",1,13569,"MUNICIPIUL SIBIU",143450,1249,762,720,42,0,759,3,1350,588,109,650
34,"SIBIU",323,143450,,16,"SIBIU / Colegiul Tehnic ""Independenţa""",1,13569,"MUNICIPIUL SIBIU",143450,1501,1057,914,141,2,1049,8,1650,593,149,900
34,"SIBIU",323,143450,,17,"SIBIU / Colegiul Tehnic de Ind. Alimentară Terezianum Sibiu",1,13569,"MUNICIPIUL SIBIU",143450,1571,1177,1032,96,49,1169,8,1700,523,181,988
34,"SIBIU",323,143450,,18,"SIBIU / Colegiul Tehnic de Ind. Alimentară Terezianum Sibiu",1,13569,"MUNICIPIUL SIBIU",143450,1537,1199,1020,107,72,1192,7,1650,451,187,1005
34,"SIBIU",323,143450,,19,"SIBIU / Şcoala cu clasele I-VIII nr.18",1,13569,"MUNICIPIUL SIBIU",143450,1683,1296,1137,158,1,1290,6,1800,504,213,1077
34,"SIBIU",323,143450,,20,"SIBIU / Şcoala cu clasele I-VIII nr.18",1,13569,"MUNICIPIUL SIBIU",143450,1668,1256,1119,136,1,1251,5,1800,544,160,1091
34,"SIBIU",323,143450,,21,"SIBIU / Şcoala cu clasele I-VIII nr. 20 cu structura Şcoala cu clasele I-VIII nr. 11",1,13569,"MUNICIPIUL SIBIU",143450,1511,902,834,68,0,883,19,1650,748,163,720
34,"SIBIU",323,143450,,22,"SIBIU / Şcoala cu clasele I-VIII nr. 20 cu structura Şcoala cu clasele I-VIII nr. 11",1,13569,"MUNICIPIUL SIBIU",143450,1430,866,823,43,0,858,8,1550,684,166,692
34,"SIBIU",323,143450,,23,"SIBIU / Şcoala cu clasele I-VIII nr. 20",1,13569,"MUNICIPIUL SIBIU",143450,1678,1259,1165,91,3,1252,7,1850,591,227,1025
34,"SIBIU",323,143450,,24,"SIBIU / Şcoala cu clasele I-VIII nr. 20",1,13569,"MUNICIPIUL SIBIU",143450,1482,1089,999,88,2,1074,15,1599,510,208,866
34,"SIBIU",323,143450,,25,"SIBIU / Grup Şcolar Henri Coandă",1,13569,"MUNICIPIUL SIBIU",143450,1129,777,722,53,2,775,2,1200,423,127,648
34,"SIBIU",323,143450,,26,"SIBIU / Grup Şcolar Henri Coandă",1,13569,"MUNICIPIUL SIBIU",143450,1010,795,689,105,1,788,7,1100,305,139,649
34,"SIBIU",323,143450,,27,"SIBIU / Grup Şcolar Henri Coandă",1,13569,"MUNICIPIUL SIBIU",143450,1739,1145,1070,74,1,1141,4,1900,755,162,979
34,"SIBIU",323,143450,,28,"SIBIU / Şcoala cu clasele I-VIII nr. 8",1,13569,"MUNICIPIUL SIBIU",143450,1174,793,768,25,0,789,4,1250,457,123,666
34,"SIBIU",323,143450,,29,"SIBIU / Şcoala cu clasele I-VIII nr. 8",1,13569,"MUNICIPIUL SIBIU",143450,1339,987,951,36,0,977,10,1450,463,156,821
34,"SIBIU",323,143450,,30,"SIBIU / Şcoala cu clasele I-VIII nr. 8",1,13569,"MUNICIPIUL SIBIU",143450,1204,846,798,48,0,840,6,1300,454,191,649
34,"SIBIU",323,143450,,31,"SIBIU / Şcoala cu clasele I-VIII nr. 8",1,13569,"MUNICIPIUL SIBIU",143450,1476,1021,949,72,0,1017,4,1600,579,197,820
34,"SIBIU",323,143450,,32,"SIBIU / Grădiniţa cu program prelungit nr. 17",1,13569,"MUNICIPIUL SIBIU",143450,1107,683,622,61,0,679,4,1200,517,120,559
34,"SIBIU",323,143450,,33,"SIBIU / Grădiniţa cu program prelungit nr. 37",1,13569,"MUNICIPIUL SIBIU",143450,1370,894,795,99,0,890,4,1500,606,163,727
34,"SIBIU",323,143450,,34,"SIBIU / Palatul Copiilor",1,13569,"MUNICIPIUL SIBIU",143450,1368,1121,858,112,151,1113,8,1500,379,220,893
34,"SIBIU",323,143450,,35,"SIBIU / Palatul Copiilor",1,13569,"MUNICIPIUL SIBIU",143450,1155,1079,776,131,172,1066,13,1250,171,212,854
34,"SIBIU",323,143450,,36,"SIBIU / Şcoala cu clasele I-VIII nr.2",1,13569,"MUNICIPIUL SIBIU",143450,1260,1024,695,325,4,1010,14,1350,326,195,815
34,"SIBIU",323,143450,,37,"SIBIU / Colegiul Naţional Ghe.Lazăr Sibiu",1,13569,"MUNICIPIUL SIBIU",143450,1380,1223,786,428,9,1201,22,1500,277,223,978
34,"SIBIU",323,143450,,38,"SIBIU / Liceul de Artă Sibiu",1,13569,"MUNICIPIUL SIBIU",143450,929,714,517,162,35,702,12,1000,286,160,542
34,"SIBIU",323,143450,,39,"SIBIU / Liceul de Artă Sibiu",1,13569,"MUNICIPIUL SIBIU",143450,1075,848,604,239,5,836,12,1150,302,171,665
34,"SIBIU",323,143450,,40,"SIBIU / Colegiul Tehnic Independenţa Sibiu",1,13569,"MUNICIPIUL SIBIU",143450,1272,839,706,133,0,828,11,1400,561,150,678
34,"SIBIU",323,143450,,41,"SIBIU / Colegiul Naţional Oct.Goga Sibiu",1,13569,"MUNICIPIUL SIBIU",143450,1091,910,627,282,1,896,14,1200,290,204,692
34,"SIBIU",323,143450,,42,"SIBIU / Colegiul Naţional  O. Goga cu structură Şcoala cu clasele I-VIII nr. 15",1,13569,"MUNICIPIUL SIBIU",143450,1301,937,791,145,1,923,14,1400,463,212,711
34,"SIBIU",323,143450,,43,"SIBIU / Şcoala cu clasele I-VIII Regina Maria",1,13569,"MUNICIPIUL SIBIU",143450,1267,995,868,125,2,983,12,1350,355,201,782
34,"SIBIU",323,143450,,44,"SIBIU / Şcoala cu clasele I-VIII Regina Maria",1,13569,"MUNICIPIUL SIBIU",143450,1202,999,764,234,1,990,9,1300,301,230,760
34,"SIBIU",323,143450,,45,"SIBIU / Colegiul Agricol D.P.Barcianu Sibiu",1,13569,"MUNICIPIUL SIBIU",143450,1147,929,711,193,25,914,15,1250,321,185,729
34,"SIBIU",323,143450,,46,"SIBIU / Casa Corpului Didactic",1,13569,"MUNICIPIUL SIBIU",143450,1403,1093,944,117,32,1082,11,1500,407,200,882
34,"SIBIU",323,143450,,47,"SIBIU / Liceul Teoretic Onisifor Ghibu",1,13569,"MUNICIPIUL SIBIU",143450,1319,1186,887,297,2,1183,3,1450,264,192,991
34,"SIBIU",323,143450,,48,"SIBIU / Şcoala cu clasele I-VIII nr. 1",1,13569,"MUNICIPIUL SIBIU",143450,1597,1231,1077,154,0,1217,14,1750,519,241,976
34,"SIBIU",323,143450,,49,"SIBIU / Şcoala cu clasele I-VIII nr. 1",1,13569,"MUNICIPIUL SIBIU",143450,1637,1244,1107,135,2,1234,10,1800,556,215,1019
34,"SIBIU",323,143450,,50,"SIBIU / Şcoala cu clasele I-VIII nr. 1",1,13569,"MUNICIPIUL SIBIU",143450,1649,1217,1103,113,1,1208,9,1800,583,234,974
34,"SIBIU",323,143450,,51,"SIBIU / Şcoala cu clasele I-VIII nr. 1",1,13569,"MUNICIPIUL SIBIU",143450,1590,1219,1101,117,1,1208,11,1700,481,222,986
34,"SIBIU",323,143450,,52,"SIBIU / Grădiniţa cu program prelungit nr. 22",1,13569,"MUNICIPIUL SIBIU",143450,1559,1176,1064,110,2,1165,11,1650,474,228,937
34,"SIBIU",323,143450,,53,"SIBIU / Grădiniţa cu program prelungit nr. 22",1,13569,"MUNICIPIUL SIBIU",143450,1442,1155,1014,138,3,1152,3,1550,395,213,939
34,"SIBIU",323,143450,,54,"SIBIU / Grădiniţa cu program prelungit nr. 22",1,13569,"MUNICIPIUL SIBIU",143450,1587,1155,1095,58,2,1145,10,1700,545,172,973
34,"SIBIU",323,143450,,55,"SIBIU / Grădiniţa cu program prelungit nr. 22",1,13569,"MUNICIPIUL SIBIU",143450,1130,797,722,75,0,796,1,1199,402,125,671
34,"SIBIU",323,143450,,56,"SIBIU / Şcoala cu clasele I-VIII nr. 25",1,13569,"MUNICIPIUL SIBIU",143450,1276,965,832,132,1,960,5,1350,385,165,795
34,"SIBIU",323,143450,,57,"SIBIU / Şcoala cu clasele I-VIII nr. 25",1,13569,"MUNICIPIUL SIBIU",143450,1376,1035,913,120,2,1028,7,1500,465,201,827
34,"SIBIU",323,143450,,58,"SIBIU / Şcoala cu clasele I-VIII nr. 25",1,13569,"MUNICIPIUL SIBIU",143450,1399,1063,959,102,2,1056,7,1500,437,182,874
34,"SIBIU",323,143450,,59,"SIBIU / Şcoala cu clasele I-VIII nr. 25",1,13569,"MUNICIPIUL SIBIU",143450,1496,1111,1029,82,0,1104,7,1600,489,170,934
34,"SIBIU",323,143450,,60,"SIBIU / Şcoala cu clasele I-VIII I.L.Caragiale",1,13569,"MUNICIPIUL SIBIU",143450,1396,1161,1024,132,5,1150,11,1500,339,185,965
34,"SIBIU",323,143450,,61,"SIBIU / Şcoala cu clasele I-VIII I.L.Caragiale",1,13569,"MUNICIPIUL SIBIU",143450,1219,884,809,70,5,876,8,1300,416,167,709
34,"SIBIU",323,143450,,62,"SIBIU / Şcoala cu clasele I-VIII I.L.Caragiale",1,13569,"MUNICIPIUL SIBIU",143450,1179,832,795,36,1,822,10,1300,468,152,670
34,"SIBIU",323,143450,,63,"SIBIU / Facultatea de Inginerie",1,13569,"MUNICIPIUL SIBIU",143450,1338,1135,838,296,1,1123,12,1450,315,286,837
34,"SIBIU",323,143450,,64,"SIBIU / Colegiu Economic George Bariţiu",1,13569,"MUNICIPIUL SIBIU",143450,1344,1010,871,139,0,1006,4,1450,440,209,797
34,"SIBIU",323,143450,,65,"SIBIU / Colegiu Economic George Bariţiu",1,13569,"MUNICIPIUL SIBIU",143450,1402,1084,882,202,0,1070,14,1500,416,263,807
34,"SIBIU",323,143450,,66,"SIBIU / Colegiul Economic George Bariţiu, Sibiu",1,13569,"MUNICIPIUL SIBIU",143450,1299,1089,873,214,2,1071,18,1400,311,258,813
34,"SIBIU",323,143450,,67,"SIBIU / Club Sportiv Şcolar Sibiu",1,13569,"MUNICIPIUL SIBIU",143450,1431,1095,956,101,38,1081,14,1550,455,257,824
34,"SIBIU",323,143450,,68,"SIBIU / Şcoala cu clasele I-VIII nr.4",1,13569,"MUNICIPIUL SIBIU",143450,1394,1077,963,99,15,1068,9,1500,423,181,887
34,"SIBIU",323,143450,,69,"SIBIU / Şcoala cu clasele I-VIII nr.4",1,13569,"MUNICIPIUL SIBIU",143450,1199,994,845,132,17,987,7,1300,306,167,820
34,"SIBIU",323,143450,,70,"SIBIU / Şcoala cu clasele I-VIII nr.4",1,13569,"MUNICIPIUL SIBIU",143450,1475,1111,1018,91,2,1105,6,1600,489,196,909
34,"SIBIU",323,143450,,71,"SIBIU / Colegiul Tehnic Energetic",1,13569,"MUNICIPIUL SIBIU",143450,1418,1162,962,200,0,1157,5,1550,388,177,980
34,"SIBIU",323,143450,,72,"SIBIU / Colegiul Tehnic Energetic",1,13569,"MUNICIPIUL SIBIU",143450,1384,949,835,114,0,939,10,1500,551,142,797
34,"SIBIU",323,143450,,73,"SIBIU / Colegiul Tehnic Energetic",1,13569,"MUNICIPIUL SIBIU",143450,1577,1141,1009,131,1,1139,2,1700,559,205,934
34,"SIBIU",323,143450,,74,"SIBIU / Colegiul Tehnic Energetic",1,13569,"MUNICIPIUL SIBIU",143450,1554,1147,991,156,0,1139,8,1650,503,201,938
34,"SIBIU",323,143450,,75,"SIBIU / Şcoala cu clasele I-VIII Regele Ferdinand",1,13569,"MUNICIPIUL SIBIU",143450,1319,1116,828,288,0,1109,7,1450,334,158,951
34,"SIBIU",323,143450,,76,"SIBIU / Şcoala cu clasele I-VIII Regele Ferdinand",1,13569,"MUNICIPIUL SIBIU",143450,1378,954,857,97,0,950,4,1450,496,129,821
34,"SIBIU",323,143450,,77,"SIBIU / Şcoala cu clasele I-VIII Regele Ferdinand",1,13569,"MUNICIPIUL SIBIU",143450,1424,949,912,36,1,944,5,1550,601,169,775
34,"SIBIU",323,143450,,78,"SIBIU / Şcoala cu clasele I-VIII Regele Ferdinand",1,13569,"MUNICIPIUL SIBIU",143450,1391,925,889,35,1,919,6,1500,575,139,780
34,"SIBIU",323,143450,,79,"SIBIU / Şcoala cu clasele I-VIII Regele Ferdinand",1,13569,"MUNICIPIUL SIBIU",143450,1109,761,713,48,0,756,5,1200,439,133,623
34,"SIBIU",323,143450,,80,"SIBIU / Şcoala cu clasele I-VIII Regele Ferdinand",1,13569,"MUNICIPIUL SIBIU",143450,1317,909,860,48,1,898,11,1450,541,170,728
34,"SIBIU",323,143450,,81,"SIBIU / Şcoala cu clasele I-VIII Regele Ferdinand",1,13569,"MUNICIPIUL SIBIU",143450,1338,877,807,70,0,871,6,1450,573,117,754
34,"SIBIU",323,143450,,82,"SIBIU / Grădiniţa cu program prelungit nr.29",1,13569,"MUNICIPIUL SIBIU",143450,1216,1007,832,175,0,1000,7,1300,293,146,854
34,"SIBIU",323,143450,,83,"SIBIU / Şcoala cu clasele I-VIII Radu Selejan",1,13569,"MUNICIPIUL SIBIU",143450,1256,900,803,96,1,897,3,1350,450,139,758
34,"SIBIU",323,143450,,84,"SIBIU / Şcoala cu clasele I-VIII Radu Selejan",1,13569,"MUNICIPIUL SIBIU",143450,1024,806,647,159,0,802,4,1100,294,163,639
34,"SIBIU",323,143450,,85,"SIBIU / Grădiniţa cu program prelungit nr.33",1,13569,"MUNICIPIUL SIBIU",143450,1235,879,771,107,1,872,7,1350,471,201,671
34,"SIBIU",323,143450,,86,"SIBIU / Şcoala cu clasele I-VIII nr. 21",1,13569,"MUNICIPIUL SIBIU",143450,1448,1031,945,84,2,1025,6,1550,519,250,775
34,"SIBIU",323,143450,,87,"SIBIU / Şcoala cu clasele I-VIII nr. 21",1,13569,"MUNICIPIUL SIBIU",143450,942,757,608,145,4,752,5,1000,243,167,585
34,"SIBIU",323,143450,,88,"SIBIU / Şcoala cu clasele I-VIII nr. 21",1,13569,"MUNICIPIUL SIBIU",143450,1055,829,695,132,2,825,4,1150,321,200,625
34,"SIBIU",323,143450,,89,"SIBIU / Şcoala cu clasele I-VIII nr. 21",1,13569,"MUNICIPIUL SIBIU",143450,1315,945,854,88,3,937,8,1450,505,224,713
34,"SIBIU",323,143450,,90,"SIBIU / Şcoala cu clasele I-VIII Nicolae Iorga",1,13569,"MUNICIPIUL SIBIU",143450,1448,1178,939,239,0,1168,10,1550,372,232,936
34,"SIBIU",323,143450,,91,"SIBIU / Şcoala cu clasele I-VIII Nicolae Iorga",1,13569,"MUNICIPIUL SIBIU",143450,1450,1093,917,176,0,1087,6,1550,457,252,835
34,"SIBIU",323,143450,,92,"SIBIU / Şcoala cu clasele I-VIII Nicolae Iorga",1,13569,"MUNICIPIUL SIBIU",143450,1403,978,865,111,2,972,6,1500,522,172,800
34,"SIBIU",323,143450,,93,"SIBIU / Şcoala cu clasele I-VIII Nicolae Iorga",1,13569,"MUNICIPIUL SIBIU",143450,1098,754,653,100,1,747,7,1200,446,144,603
34,"SIBIU",323,143450,,94,"SIBIU / Liceul Teoretic C. Noica",1,13569,"MUNICIPIUL SIBIU",143450,1262,1002,830,171,1,990,12,1350,348,195,795
34,"SIBIU",323,143450,,95,"SIBIU / Liceul Teoretic C. Noica",1,13569,"MUNICIPIUL SIBIU",143450,1439,1099,941,156,2,1091,8,1550,451,211,880
34,"SIBIU",323,143450,,96,"SIBIU / Liceul Teoretic C. Noica",1,13569,"MUNICIPIUL SIBIU",143450,1476,1115,971,144,0,1109,6,1600,485,222,887
34,"SIBIU",323,143450,,97,"SIBIU / Grădiniţa cu program prelungit nr.38",1,13569,"MUNICIPIUL SIBIU",143450,1545,1087,957,129,1,1080,7,1700,613,205,875
34,"SIBIU",323,143450,,98,"SIBIU / Colegiul Naţional Pedagogic ""Andrei Şaguna""",1,13569,"MUNICIPIUL SIBIU",143450,1340,1046,851,191,4,1040,6,1450,404,250,790
34,"SIBIU",323,143450,,99,"SIBIU / Colegiul Naţional Pedagogic ""Andrei Şaguna""",1,13569,"MUNICIPIUL SIBIU",143450,1328,1020,900,118,2,1012,8,1450,430,236,776
34,"SIBIU",323,143450,,100,"SIBIU / Grădiniţa cu program prelungit nr. 42",1,13569,"MUNICIPIUL SIBIU",143450,1408,1068,957,106,5,1058,10,1550,482,254,804
34,"SIBIU",323,143450,,101,"SIBIU / Grădiniţa cu program prelungit nr. 43",1,13569,"MUNICIPIUL SIBIU",143450,1473,1140,967,173,0,1135,5,1600,460,194,941
34,"SIBIU",323,143450,,102,"SIBIU / Grădiniţa cu program prelungit nr. 43",1,13569,"MUNICIPIUL SIBIU",143450,1486,1086,935,150,1,1083,3,1600,514,158,925
34,"SIBIU",323,143450,,103,"SIBIU / Grădiniţa cu program prelungit nr. 5",1,13569,"MUNICIPIUL SIBIU",143450,1665,1155,1053,102,0,1146,9,1750,595,226,920
34,"SIBIU",323,143450,,104,"SIBIU / Grădiniţa cu program prelungit nr. 5",1,13569,"MUNICIPIUL SIBIU",143450,1598,1136,1034,102,0,1128,8,1750,614,209,919
34,"SIBIU",323,143450,,105,"PĂLTINIŞ / Păltiniş",1,13569,"MUNICIPIUL SIBIU",143450,27,113,5,108,0,113,0,339,226,27,86
34,"SIBIU",323,143619,,106,"MEDIAŞ / Sc Gimaziala H.Oberth",1,13572,"MUNICIPIUL MEDIAŞ",143619,1291,733,577,66,90,728,5,1400,667,156,572
34,"SIBIU",323,143619,,107,"MEDIAŞ / Gradinita nr.12",1,13572,"MUNICIPIUL MEDIAŞ",143619,1125,611,580,29,2,608,3,1200,589,127,481
34,"SIBIU",323,143619,,108,"MEDIAŞ / Sc gimnaziala Mihai Eminescu",1,13572,"MUNICIPIUL MEDIAŞ",143619,1333,775,726,47,2,770,5,1450,675,155,615
34,"SIBIU",323,143619,,109,"MEDIAŞ / Gradinita Bucuria Copiilor",1,13572,"MUNICIPIUL MEDIAŞ",143619,1245,739,693,45,1,731,8,1400,661,143,588
34,"SIBIU",323,143619,,110,"MEDIAŞ / Vestiar Sparta",1,13572,"MUNICIPIUL MEDIAŞ",143619,793,452,433,19,0,449,3,900,448,77,372
34,"SIBIU",323,143619,,111,"MEDIAŞ / Stadionul Mun. Gaz Metan",1,13572,"MUNICIPIUL MEDIAŞ",143619,871,534,492,41,1,530,4,1000,466,101,429
34,"SIBIU",323,143619,,112,"MEDIAŞ / SC Hula Veche SRL",1,13572,"MUNICIPIUL MEDIAŞ",143619,1279,780,742,37,1,773,7,1400,620,157,616
34,"SIBIU",323,143619,,113,"MEDIAŞ / Clubul Copiilor si  Elevilor",1,13572,"MUNICIPIUL MEDIAŞ",143619,1099,661,629,32,0,656,5,1200,539,160,496
34,"SIBIU",323,143619,,114,"MEDIAŞ / Şcoala Ajutătoare",1,13572,"MUNICIPIUL MEDIAŞ",143619,1092,651,630,21,0,648,3,1200,549,127,521
34,"SIBIU",323,143619,,115,"MEDIAŞ / Sc gimnaziala nr.7",1,13572,"MUNICIPIUL MEDIAŞ",143619,1334,804,752,52,0,793,11,1500,696,185,608
34,"SIBIU",323,143619,,116,"MEDIAŞ / Sc gimnaziala nr.7",1,13572,"MUNICIPIUL MEDIAŞ",143619,1035,582,532,49,1,579,3,1100,518,117,462
34,"SIBIU",323,143619,,117,"MEDIAŞ / Sc gimnaziala nr.7",1,13572,"MUNICIPIUL MEDIAŞ",143619,1188,682,660,22,0,677,5,1300,618,172,505
34,"SIBIU",323,143619,,118,"MEDIAŞ / Şc. gimnazială nr.7",1,13572,"MUNICIPIUL MEDIAŞ",143619,1018,518,491,27,0,514,4,1100,582,133,381
34,"SIBIU",323,143619,,119,"MEDIAŞ / Grădiniţa Rază de Soare",1,13572,"MUNICIPIUL MEDIAŞ",143619,1322,726,697,29,0,720,6,1500,774,170,550
34,"SIBIU",323,143619,,120,"MEDIAŞ / Sc gimnaziala nr.5 corp A",1,13572,"MUNICIPIUL MEDIAŞ",143619,1017,589,553,35,1,586,3,1100,511,135,451
34,"SIBIU",323,143619,,121,"MEDIAŞ / Sc gimnaziala nr.5 corp A",1,13572,"MUNICIPIUL MEDIAŞ",143619,1298,660,630,29,1,649,11,1400,740,123,526
34,"SIBIU",323,143619,,122,"MEDIAŞ / Gradinita nr.7",1,13572,"MUNICIPIUL MEDIAŞ",143619,1181,642,602,40,0,633,9,1300,658,144,489
34,"SIBIU",323,143619,,123,"MEDIAŞ / Gradinita Piticot",1,13572,"MUNICIPIUL MEDIAŞ",143619,1614,894,824,65,5,871,23,1800,906,228,643
34,"SIBIU",323,143619,,124,"MEDIAŞ / Şc. gimnazială nr.4",1,13572,"MUNICIPIUL MEDIAŞ",143619,1045,624,544,80,0,616,8,1200,576,179,437
34,"SIBIU",323,143619,,125,"MEDIAŞ / Spaţiu cu altă detinaţie",1,13572,"MUNICIPIUL MEDIAŞ",143619,1170,729,663,65,1,722,7,1300,571,137,585
34,"SIBIU",323,143619,,126,"MEDIAŞ / Şc. gimnazială nr.6",1,13572,"MUNICIPIUL MEDIAŞ",143619,1031,639,608,30,1,629,10,1100,461,136,493
34,"SIBIU",323,143619,,127,"MEDIAŞ / SC Automecanica SA",1,13572,"MUNICIPIUL MEDIAŞ",143619,633,422,377,44,1,421,1,700,278,66,355
34,"SIBIU",323,143619,,128,"MEDIAŞ / SC Transgaz SA",1,13572,"MUNICIPIUL MEDIAŞ",143619,1038,641,604,34,3,639,2,1100,459,132,507
34,"SIBIU",323,143619,,129,"MEDIAŞ / Societate Comerciala",1,13572,"MUNICIPIUL MEDIAŞ",143619,1178,705,662,43,0,701,4,1300,595,134,567
34,"SIBIU",323,143619,,130,"MEDIAŞ / Complex Comercial",1,13572,"MUNICIPIUL MEDIAŞ",143619,1287,787,762,25,0,785,2,1400,613,141,644
34,"SIBIU",323,143619,,131,"MEDIAŞ / Şc. gimnazială George Popa",1,13572,"MUNICIPIUL MEDIAŞ",143619,993,631,586,45,0,629,2,1100,469,123,506
34,"SIBIU",323,143619,,132,"MEDIAŞ / Şc. gimnazială George Popa",1,13572,"MUNICIPIUL MEDIAŞ",143619,1471,856,826,30,0,853,3,1600,744,180,673
34,"SIBIU",323,143619,,133,"MEDIAŞ / Şc. gimnazială George Popa",1,13572,"MUNICIPIUL MEDIAŞ",143619,1346,827,784,39,4,816,11,1500,673,155,661
34,"SIBIU",323,143619,,134,"MEDIAŞ / Liceul teoretic Şc. Naţ. De Gaze",1,13572,"MUNICIPIUL MEDIAŞ",143619,1207,710,680,30,0,703,7,1300,590,129,574
34,"SIBIU",323,143619,,135,"MEDIAŞ / Muzeul Herman Oberth",1,13572,"MUNICIPIUL MEDIAŞ",143619,1082,683,645,38,0,679,4,1200,517,156,523
34,"SIBIU",323,143619,,136,"MEDIAŞ / Colegiul tehnic Mediensisi",1,13572,"MUNICIPIUL MEDIAŞ",143619,1301,759,717,42,0,754,5,1400,641,153,601
34,"SIBIU",323,143619,,137,"MEDIAŞ / Şc. gimnazială Cireşarii",1,13572,"MUNICIPIUL MEDIAŞ",143619,1226,716,688,26,2,709,7,1300,584,121,588
34,"SIBIU",323,143619,,138,"MEDIAŞ / Grădiniţa Pinocchio",1,13572,"MUNICIPIUL MEDIAŞ",143619,1224,693,654,37,2,691,2,1300,607,132,559
34,"SIBIU",323,143619,,139,"MEDIAŞ / Sc gimnaziala C-tin Motas",1,13572,"MUNICIPIUL MEDIAŞ",143619,1278,718,682,36,0,711,7,1400,682,128,583
34,"SIBIU",323,143619,,140,"MEDIAŞ / Sc gimnaziala C-tin Motas",1,13572,"MUNICIPIUL MEDIAŞ",143619,1385,716,680,35,1,711,5,1500,784,160,551
34,"SIBIU",323,143619,,141,"MEDIAŞ / Sc gimnaziala C-tin Motas",1,13572,"MUNICIPIUL MEDIAŞ",143619,1389,719,701,17,1,712,7,1500,781,149,563
34,"SIBIU",323,143619,,142,"MEDIAŞ / Sc gimnaziala C-tin Motas",1,13572,"MUNICIPIUL MEDIAŞ",143619,1266,695,647,48,0,689,6,1400,705,98,591
34,"SIBIU",323,143619,,143,"MEDIAŞ / Şc. gimnazială C-tin. I.Motaş",1,13572,"MUNICIPIUL MEDIAŞ",143619,1346,721,698,22,1,715,6,1500,779,128,587
34,"SIBIU",323,143619,,144,"MEDIAŞ / SC BAT SA",1,13572,"MUNICIPIUL MEDIAŞ",143619,1141,633,609,24,0,630,3,1300,667,120,510
34,"SIBIU",323,143619,,145,"MEDIAŞ / Univer. Lucian Blaga",1,13572,"MUNICIPIUL MEDIAŞ",143619,1168,645,610,33,2,642,3,1300,655,121,521
34,"SIBIU",323,143619,,146,"MEDIAŞ / Univer. Lucian Blaga",1,13572,"MUNICIPIUL MEDIAŞ",143619,1402,760,721,38,1,756,4,1500,740,114,642
34,"SIBIU",323,143619,,147,"IGHIŞU NOU / Şcoal generală",1,13572,"MUNICIPIUL MEDIAŞ",143619,1290,651,618,33,0,645,6,1400,749,76,569
34,"SIBIU",323,143682,,148,"AGNITA / Scoala Gimnaziala GD Teutch",1,13575,"ORAŞ AGNITA",143682,1310,607,581,26,0,603,4,1400,793,105,498
34,"SIBIU",323,143682,,149,"AGNITA / Gradinita nr.3",1,13575,"ORAŞ AGNITA",143682,1140,541,516,25,0,538,3,1300,759,99,439
34,"SIBIU",323,143682,,150,"AGNITA / Complexul de servicii",1,13575,"ORAŞ AGNITA",143682,1493,710,664,45,1,692,18,1600,890,137,555
34,"SIBIU",323,143682,,151,"AGNITA / Scoala Gimnaziala GD Teutsch",1,13575,"ORAŞ AGNITA",143682,1170,662,628,34,0,659,3,1300,638,150,509
34,"SIBIU",323,143682,,152,"AGNITA / Colegiul Th. A. T Laurean",1,13575,"ORAŞ AGNITA",143682,1015,538,504,34,0,535,3,1100,562,105,430
34,"SIBIU",323,143682,,153,"AGNITA / SC Apa Tarnavei Mari SA",1,13575,"ORAŞ AGNITA",143682,1300,606,580,25,1,602,4,1400,794,119,483
34,"SIBIU",323,143682,,154,"AGNITA / Gradinita nr.2",1,13575,"ORAŞ AGNITA",143682,1172,637,587,41,9,633,4,1300,663,128,505
34,"SIBIU",323,143682,,155,"COVEŞ / Şcoala Generală Coveş",1,13575,"ORAŞ AGNITA",143682,518,316,303,13,0,309,7,600,284,52,257
34,"SIBIU",323,143682,,156,"RUJA / Scoala Generala Ruja",1,13575,"ORAŞ AGNITA",143682,982,462,444,18,0,460,2,1100,638,78,382
34,"SIBIU",323,144054,,157,"AVRIG / Gradinita Nr.3",1,13579,"ORAŞ AVRIG",144054,1424,834,746,88,0,822,12,1600,766,144,678
34,"SIBIU",323,144054,,158,"AVRIG / SCOALA Gimnaziala Avrig",1,13579,"ORAŞ AVRIG",144054,1347,854,781,72,1,852,2,1500,646,162,690
34,"SIBIU",323,144054,,159,"AVRIG / Şcoala Gimnaziala Avrig",1,13579,"ORAŞ AVRIG",144054,1238,862,789,73,0,854,8,1400,538,150,704
34,"SIBIU",323,144054,,160,"AVRIG / Gradinita Nr,1",1,13579,"ORAŞ AVRIG",144054,1536,968,920,47,1,957,11,1700,732,189,768
34,"SIBIU",323,144054,,161,"AVRIG / Liceul ""GHEORGHE LAZĂR"", Avrig",1,13579,"ORAŞ AVRIG",144054,1321,787,748,39,0,784,3,1500,713,116,668
34,"SIBIU",323,144054,,162,"AVRIG / Liceul ""GHEORGHE LAZĂR"", Avrig",1,13579,"ORAŞ AVRIG",144054,1407,870,833,37,0,859,11,1500,630,163,696
34,"SIBIU",323,144054,,163,"MÎRŞA / Şcoala Gimnaziala MÎRŞA",1,13579,"ORAŞ AVRIG",144054,1313,743,710,33,0,741,2,1500,757,105,636
34,"SIBIU",323,144054,,164,"MÎRŞA / Liceul ""Tehnologic MÎRŞA",1,13579,"ORAŞ AVRIG",144054,1420,790,755,34,1,788,2,1600,810,130,658
34,"SIBIU",323,144054,,165,"BRADU / SCOALA GIMNAZIALĂ BRADU",1,13579,"ORAŞ AVRIG",144054,900,570,503,67,0,567,3,1000,430,86,481
34,"SIBIU",323,144054,,166,"SĂCĂDATE / SCOALA PRIMARĂ SĂCĂDATE",1,13579,"ORAŞ AVRIG",144054,500,328,292,36,0,328,0,600,272,50,278
34,"SIBIU",323,144054,,167,"GLÎMBOACA / SCOALA PRIMARĂ GLÎMBOACA",1,13579,"ORAŞ AVRIG",144054,189,143,109,34,0,143,0,300,157,22,121
34,"SIBIU",323,143735,,168,"CISNĂDIOARA / SCOALA GENERALA CISNADIOARA",1,13585,"ORAŞ CISNĂDIE",143735,617,268,203,65,0,266,2,700,432,43,223
34,"SIBIU",323,143735,,169,"CISNĂDIE / GRADINITA nr 7",1,13585,"ORAŞ CISNĂDIE",143735,1557,858,812,46,0,856,2,1700,842,137,719
34,"SIBIU",323,143735,,170,"CISNĂDIE / Clubul Elevilor",1,13585,"ORAŞ CISNĂDIE",143735,1451,780,743,37,0,780,0,1600,820,127,653
34,"SIBIU",323,143735,,171,"CISNĂDIE / GRADINITA nr 6",1,13585,"ORAŞ CISNĂDIE",143735,1426,848,785,63,0,841,7,1600,752,142,699
34,"SIBIU",323,143735,,172,"CISNĂDIE / Scoala Generala nr.3",1,13585,"ORAŞ CISNĂDIE",143735,1437,833,784,49,0,825,8,1600,767,167,658
34,"SIBIU",323,143735,,173,"CISNĂDIE / Liceul ,,Gustav Gundisch,,",1,13585,"ORAŞ CISNĂDIE",143735,1677,944,853,90,1,936,8,1800,856,216,720
34,"SIBIU",323,143735,,174,"CISNĂDIE / GRADINITA nr 3",1,13585,"ORAŞ CISNĂDIE",143735,1460,842,780,61,1,839,3,1600,758,143,696
34,"SIBIU",323,143735,,175,"CISNĂDIE / Scoala Generala nr.2",1,13585,"ORAŞ CISNĂDIE",143735,1612,910,875,35,0,904,6,1800,890,158,746
34,"SIBIU",323,143735,,176,"CISNĂDIE / LICEUL TEHNOLOGIC (M.I.U)",1,13585,"ORAŞ CISNĂDIE",143735,1103,655,613,42,0,649,6,1200,545,104,545
34,"SIBIU",323,143735,,177,"CISNĂDIE / LICEUL TEHNOLOGIC (M.I.U)",1,13585,"ORAŞ CISNĂDIE",143735,1068,619,573,46,0,611,8,1200,581,103,508
34,"SIBIU",323,143735,,178,"CISNĂDIE / Scoala Generala nr.1",1,13585,"ORAŞ CISNĂDIE",143735,1202,760,687,73,0,755,5,1300,540,124,631
34,"SIBIU",323,143735,,179,"CISNĂDIE / Scoala Generala nr.1",1,13585,"ORAŞ CISNĂDIE",143735,1031,578,555,21,2,576,2,1100,522,101,475
34,"SIBIU",323,143771,,180,"COPŞA MICĂ / SCOALA GIMNAZIALA COPSA MICA, STR. LABORATOR, NR.45",1,13588,"ORAŞ COPŞA MICĂ",143771,1432,719,675,44,0,716,3,1600,881,149,567
34,"SIBIU",323,143771,,181,"COPŞA MICĂ / LICEUL TEHNOLOGIC ""NICOLAE TECLU"" COPSA MICA, SOSEAUA SIBIULUI, NR.61",1,13588,"ORAŞ COPŞA MICĂ",143771,1561,820,741,76,3,816,4,1700,880,182,634
34,"SIBIU",323,143771,,182,"COPŞA MICĂ / SCOALA GIMNAZIALA COPSA MICA, SOS. MEDIASULUI, NR.93",1,13588,"ORAŞ COPŞA MICĂ",143771,1238,621,579,42,0,616,5,1400,779,112,504
34,"SIBIU",323,143771,,183,"COPŞA MICĂ / SCOALA GIMNAZIALA COPSA MICA, STR. TARNAVIOARA, NR.76",1,13588,"ORAŞ COPŞA MICĂ",143771,445,241,220,21,0,237,4,500,259,45,192
34,"SIBIU",323,143806,,184,"DUMBRĂVENI / PRIMĂRIA OR. DUMBRĂVENI",1,13590,"ORAŞ DUMBRĂVENI",143806,1317,826,737,81,8,817,9,1500,674,151,666
34,"SIBIU",323,143806,,185,"DUMBRĂVENI / LICEUL TEORETIC DUMBRĂVENI",1,13590,"ORAŞ DUMBRĂVENI",143806,1090,671,633,33,5,659,12,1200,529,156,503
34,"SIBIU",323,143806,,186,"DUMBRĂVENI / LICEUL TEHNOLOGIC ""TIMOTEI CIPARIU"" DUMBRĂVENI",1,13590,"ORAŞ DUMBRĂVENI",143806,1215,644,603,34,7,639,5,1300,656,228,411
34,"SIBIU",323,143806,,187,"DUMBRĂVENI / CENTRUL ŞCOLAR PENTRU EDUCAŢIE INCLUZIVĂ DUMBRĂVENI",1,13590,"ORAŞ DUMBRĂVENI",143806,1357,737,643,63,31,722,15,1500,763,177,545
34,"SIBIU",323,143806,,188,"ŞAROŞ PE TÎRNAVE / ŞCOALA GIMNAZIALĂ ŞAROŞ PE TÎRNAVE",1,13590,"ORAŞ DUMBRĂVENI",143806,1398,793,761,31,1,785,8,1500,707,313,472
34,"SIBIU",323,143806,,189,"ERNEA / ŞCOALA PRIMARĂ ERNEA",1,13590,"ORAŞ DUMBRĂVENI",143806,384,283,264,19,0,275,8,500,217,90,185
34,"SIBIU",323,144928,,190,"MIERCUREA SIBIULUI / Casa de Cultura",1,13594,"ORAŞ MIERCUREA SIBIULUI",144928,791,571,476,82,13,564,7,900,329,106,458
34,"SIBIU",323,144928,,191,"MIERCUREA SIBIULUI / Casa de Cultura",1,13594,"ORAŞ MIERCUREA SIBIULUI",144928,908,592,514,71,7,588,4,1000,408,62,526
34,"SIBIU",323,144928,,192,"APOLDU DE SUS / Camin cultural",1,13594,"ORAŞ MIERCUREA SIBIULUI",144928,1490,722,630,85,7,720,2,1600,878,178,542
34,"SIBIU",323,144928,,193,"DOBÂRCA / Camin cultural",1,13594,"ORAŞ MIERCUREA SIBIULUI",144928,657,363,322,41,0,362,1,800,437,106,256
34,"SIBIU",323,143851,,194,"OCNA SIBIULUI / Şcoala Gimnaziala Ocna Sibiului ,",1,13598,"ORAŞ OCNA SIBIULUI",143851,1014,695,625,70,0,695,0,1100,405,167,528
34,"SIBIU",323,143851,,195,"OCNA SIBIULUI / Şcoala Gimnazială Ocna Sibiului .",1,13598,"ORAŞ OCNA SIBIULUI",143851,960,636,573,62,1,631,5,1100,464,135,496
34,"SIBIU",323,143851,,196,"OCNA SIBIULUI / Clădirea Parohială Ortodoxă nr.1, Str. Mihai Viteazu nr.82",1,13598,"ORAŞ OCNA SIBIULUI",143851,1368,938,882,53,3,927,11,1500,562,197,730
34,"SIBIU",323,143851,,197,"TOPÎRCEA / Fost sediu  PRIMĂRIE",1,13598,"ORAŞ OCNA SIBIULUI",143851,111,105,61,44,0,105,0,200,95,34,71
34,"SIBIU",323,145499,,198,"SĂLIŞTE / LICEUL TEHNOLOGIC ""IOAN LUPAŞ""",1,13601,"ORAŞ SĂLIŞTE",145499,1250,859,748,111,0,855,4,1400,541,190,665
34,"SIBIU",323,145499,,199,"SĂLIŞTE / LICEUL TEHNOLOGIC ""IOAN LUPAŞ""",1,13601,"ORAŞ SĂLIŞTE",145499,1124,844,702,89,53,838,6,1198,354,157,681
34,"SIBIU",323,145499,,200,"GALEŞ / MUZEUL ETNOGRAFIC ""MARIA COSTACHESCU",1,13601,"ORAŞ SĂLIŞTE",145499,270,230,188,42,0,230,0,400,170,48,182
34,"SIBIU",323,145499,,201,"VALE / CLĂDIREA FOSTEI PRIMĂRII",1,13601,"ORAŞ SĂLIŞTE",145499,304,224,188,35,1,223,1,400,176,47,176
34,"SIBIU",323,145499,,202,"SIBIEL / CENTRU DE DOCUMENTARE ŞI INFORMARE SIBIEL",1,13601,"ORAŞ SĂLIŞTE",145499,316,305,216,89,0,305,0,400,95,58,247
34,"SIBIU",323,145499,,203,"FÂNTÂNELE / CĂMIN CULTURAL FÂNTÂNELE",1,13601,"ORAŞ SĂLIŞTE",145499,169,154,89,65,0,152,2,200,46,24,128
34,"SIBIU",323,145499,,204,"SĂCEL / ŞCOALA GENERALĂ SĂCEL",1,13601,"ORAŞ SĂLIŞTE",145499,422,334,286,48,0,333,1,500,166,27,306
34,"SIBIU",323,145499,,205,"MAG / ŞCOALA PRIMARĂ MAG",1,13601,"ORAŞ SĂLIŞTE",145499,328,274,231,43,0,274,0,400,126,42,232
34,"SIBIU",323,145499,,206,"AMNAŞ / ŞCOALA PRIMARĂ AMNAŞ",1,13601,"ORAŞ SĂLIŞTE",145499,339,216,174,42,0,215,1,400,184,36,179
34,"SIBIU",323,145499,,207,"ACILIU / CĂMIN CULTURAL ACILIU",1,13601,"ORAŞ SĂLIŞTE",145499,184,143,110,33,0,142,1,300,157,27,115
34,"SIBIU",323,145827,,208,"TĂLMACIU / Primaria Orasului Talmaciu",1,13612,"ORAŞ TĂLMACIU",145827,1560,801,744,56,1,796,5,1700,899,146,650
34,"SIBIU",323,145827,,209,"TĂLMACIU / LICEUL TEHNOLOGIC / SCOALA GIMNAZIALA TALMACIU",1,13612,"ORAŞ TĂLMACIU",145827,1091,689,645,44,0,681,8,1200,511,143,538
34,"SIBIU",323,145827,,210,"TĂLMACIU / LICEUL TEHNOLOGIC TALMACIU",1,13612,"ORAŞ TĂLMACIU",145827,1248,848,782,66,0,842,6,1400,552,180,662
34,"SIBIU",323,145827,,211,"TĂLMACIU / LICEUL TEHNOLOGIC TALMACIU",1,13612,"ORAŞ TĂLMACIU",145827,1501,933,894,39,0,927,6,1700,767,182,745
34,"SIBIU",323,145827,,212,"COLONIA TĂLMACIU / LICEUL TEHNOLOGIC/SCOALA COLONIE TALMACIU II",1,13612,"ORAŞ TĂLMACIU",145827,219,135,120,15,0,131,4,300,165,13,118
34,"SIBIU",323,145827,,213,"TĂLMĂCEL / LICEUL TEHNOLOGIC TALMACIU/SCOALA GIMNAZIALA TALMACEL",1,13612,"ORAŞ TĂLMACIU",145827,927,728,679,49,0,724,4,1000,272,188,536
34,"SIBIU",323,146012,,214,"ALMA / Caminul Cultural Alma",3,13616,"ALMA",146012,686,514,473,25,16,514,0,800,286,208,306
34,"SIBIU",323,146012,,215,"GIACĂŞ / Scoala Generala cls.I-IV",3,13616,"ALMA",146012,210,173,132,30,11,170,3,300,127,125,45
34,"SIBIU",323,146012,,216,"ŞMIG / Camin cultural Smig",3,13616,"ALMA",146012,739,542,502,26,14,539,3,800,258,193,346
34,"SIBIU",323,143888,,217,"ALŢINA / Sediu Primaria",3,13620,"ALŢINA",143888,1046,686,566,78,42,682,4,1200,514,388,294
34,"SIBIU",323,143888,,218,"BENEŞTI / Fost sediu CAP",3,13620,"ALŢINA",143888,210,116,83,33,0,114,2,300,184,53,61
34,"SIBIU",323,143888,,219,"GHIJASA DE SUS / Fost sediu CAP",3,13620,"ALŢINA",143888,126,119,82,29,8,119,0,200,81,68,51
34,"SIBIU",323,143922,,220,"APOLDU DE JOS / camin Cltural Apoldu de Jos",3,13624,"APOLDU DE JOS",143922,874,631,542,83,6,626,5,1000,369,174,452
34,"SIBIU",323,143922,,221,"SÎNGĂTIN / Scoala Generala Singatin",3,13624,"APOLDU DE JOS",143922,215,220,161,59,0,217,3,300,80,59,158
34,"SIBIU",323,143959,,222,"ARPAŞU DE JOS / PRIMĂRIA COMUNEI ARPASU DE JOS",3,13627,"ARPAŞU DE JOS",143959,931,586,517,58,11,582,4,1000,414,141,441
34,"SIBIU",323,143959,,223,"ARPAŞU DE SUS / SCOALA GEN. CU CLS V-VIII",3,13627,"ARPAŞU DE JOS",143959,1004,669,591,77,1,666,3,1100,431,109,557
34,"SIBIU",323,143959,,224,"NOUL ROMÂN / GRADINITA, NOU ROMAN",3,13627,"ARPAŞU DE JOS",143959,310,240,188,52,0,240,0,400,160,63,177
34,"SIBIU",323,143995,,225,"AŢEL / Primaria Atel",3,13631,"AŢEL",143995,1160,695,630,64,1,689,6,1300,605,104,585
34,"SIBIU",323,143995,,226,"DUPUŞ / Scoala cu clasele I-IV Dupus",3,13631,"AŢEL",143995,220,147,113,34,0,147,0,300,153,26,121
34,"SIBIU",323,144116,,227,"AGÎRBICIU / CAMIN CULTURAL",3,13634,"AXENTE SEVER",144116,1231,656,613,43,0,655,1,1400,744,113,542
34,"SIBIU",323,144116,,228,"ŞOALA / CAMIN CULTURAL",3,13634,"AXENTE SEVER",144116,275,150,125,25,0,149,1,300,150,38,111
34,"SIBIU",323,144116,,229,"AXENTE SEVER / SCOALA CU CLASELE I-VIII",3,13634,"AXENTE SEVER",144116,1024,563,526,36,1,561,2,1100,537,124,437
34,"SIBIU",323,144116,,230,"AXENTE SEVER / SALA DE FESTIVITATI",3,13634,"AXENTE SEVER",144116,1024,574,541,30,3,568,6,1100,526,94,474
34,"SIBIU",323,144152,,231,"BAZNA / PRIMARIA BAZNA",3,13638,"BAZNA",144152,1460,886,774,112,0,876,10,1600,714,200,676
34,"SIBIU",323,144152,,232,"BOIAN / SCOALA BOIAN",3,13638,"BAZNA",144152,1208,762,703,47,12,758,4,1300,538,96,662
34,"SIBIU",323,144152,,233,"VELŢ / SCOALA VELT",3,13638,"BAZNA",144152,454,252,234,18,0,249,3,500,248,72,177
34,"SIBIU",323,144198,,234,"BIERTAN / Primaria Comunei Biertan",3,13642,"BIERTAN",144198,1344,819,691,90,38,803,16,1500,681,296,507
34,"SIBIU",323,144198,,235,"RICHIŞ / Scoala Primara Richis",3,13642,"BIERTAN",144198,623,357,316,41,0,357,0,700,343,109,248
34,"SIBIU",323,144198,,236,"COPŞA MARE / Scoala Primara Copsa Mare",3,13642,"BIERTAN",144198,410,254,221,28,5,252,2,500,246,150,102
34,"SIBIU",323,144232,,237,"IGHIŞU VECHI / Camin cultural IGHIŞU VECHI",3,13646,"BÎRGHIŞ",144232,217,151,124,27,0,151,0,300,149,60,91
34,"SIBIU",323,144232,,238,"BÎRGHIŞ / Gradinita  Birghis",3,13646,"BÎRGHIŞ",144232,656,407,362,42,3,404,3,700,293,77,327
34,"SIBIU",323,144232,,239,"APOŞ / Şcoala generală cu clasele I-IV APOŞ",3,13646,"BÎRGHIŞ",144232,240,148,133,15,0,146,2,300,152,58,88
34,"SIBIU",323,144232,,240,"PELIŞOR / Şcoala generală cu clasele I-IV PELIŞOR",3,13646,"BÎRGHIŞ",144232,409,218,187,31,0,217,1,500,282,40,177
34,"SIBIU",323,144232,,241,"ZLAGNA / Şcoala generală ZLAGNA",3,13646,"BÎRGHIŞ",144232,138,103,70,32,1,101,2,200,97,31,70
34,"SIBIU",323,144232,,242,"VECERD / Dispensar  uman VECERD",3,13646,"BÎRGHIŞ",144232,104,93,61,32,0,92,1,200,107,55,37
34,"SIBIU",323,144303,,243,"PĂUCEA / Caminul Cultural",3,13653,"BLĂJEL",144303,371,293,271,22,0,291,2,399,106,71,220
34,"SIBIU",323,144303,,244,"ROMANEŞTI / Fosta Scoala Generala",3,13653,"BLĂJEL",144303,49,59,33,26,0,59,0,100,41,30,29
34,"SIBIU",323,144303,,245,"BLĂJEL / CAMINUL CULTURAL BLAJEL",3,13653,"BLĂJEL",144303,1535,1015,912,87,16,1006,9,1700,685,337,669
34,"SIBIU",323,146021,,246,"BOIŢA / PRIMĂRIA COMUNEI BOIŢA",3,13657,"BOIŢA",146021,1357,870,802,58,10,866,4,1500,630,149,717
34,"SIBIU",323,144349,,247,"BRATEIU / Caminul Cultural Brateiu",3,13666,"BRATEIU",144349,1098,630,574,56,0,621,9,1200,570,111,510
34,"SIBIU",323,144349,,248,"BRATEIU / Scoala cu clasele I-VIII Brateiu",3,13666,"BRATEIU",144349,803,466,440,26,0,463,3,900,434,77,386
34,"SIBIU",323,144349,,249,"BUZD / Scoala cu clasele I-VIII Buzd",3,13666,"BRATEIU",144349,908,558,528,30,0,554,4,1000,442,66,488
34,"SIBIU",323,144376,,250,"BRĂDENI / Sala mare -Primarie",3,13662,"BRĂDENI",144376,735,399,377,21,1,399,0,800,401,67,332
34,"SIBIU",323,144376,,251,"RETIŞ / Sala  mare fosta Primarie",3,13662,"BRĂDENI",144376,398,266,229,37,0,266,0,500,234,55,211
34,"SIBIU",323,144376,,252,"ŢELINE / Sala de clasa Scoala",3,13662,"BRĂDENI",144376,93,81,57,24,0,81,0,150,69,40,41
34,"SIBIU",323,144410,,253,"BRUIU / PRIMARIA BRUIU",3,13669,"BRUIU",144410,426,237,197,39,1,232,5,500,263,77,155
34,"SIBIU",323,144410,,254,"ŞOMARTIN / SCOALA CU CLASELE I-IV",3,13669,"BRUIU",144410,332,128,106,22,0,128,0,400,272,28,100
34,"SIBIU",323,144456,,255,"CHIRPĂR / Şcoala Gimnazială Chirpăr",3,13673,"CHIRPĂR",144456,948,381,336,43,2,376,5,1000,619,137,239
34,"SIBIU",323,144456,,256,"VĂRD / Căminul Cultural Vărd",3,13673,"CHIRPĂR",144456,274,175,159,16,0,175,0,300,125,20,155
34,"SIBIU",323,144456,,257,"VESEUD / Şcoala Primară Veseud",3,13673,"CHIRPĂR",144456,149,70,57,13,0,66,4,200,130,39,27
34,"SIBIU",323,144456,,258,"SĂSĂUŞ / Căminul Cultural Săsăuş",3,13673,"CHIRPĂR",144456,113,113,69,44,0,112,1,150,37,35,77
34,"SIBIU",323,144508,,259,"CÎRŢA / Primaria Cirta",3,13678,"CÎRŢA",144508,929,506,434,72,0,502,4,1000,494,208,294
34,"SIBIU",323,144535,,260,"CÎRŢIŞOARA / PRIMARIA COMUNEI",3,13681,"CÎRŢIŞOARA",144535,1069,834,664,148,22,826,8,1200,366,263,563
34,"SIBIU",323,143487,,261,"CRISTIAN / Primaria Comunei Cristian",3,13683,"CRISTIAN",143487,1036,665,597,68,0,658,7,1100,435,57,601
34,"SIBIU",323,143487,,262,"CRISTIAN / Gradinita cu program normal Cristian",3,13683,"CRISTIAN",143487,1158,773,689,84,0,768,5,1300,527,90,678
34,"SIBIU",323,143487,,263,"CRISTIAN / Scoala cu clasele I-VIII, Cristian",3,13683,"CRISTIAN",143487,1044,718,635,83,0,713,5,1200,482,90,623
34,"SIBIU",323,144553,,264,"DÎRLOS / CĂMIN CULTURAL DÎRLOS",3,13685,"DÎRLOS",144553,855,489,447,40,2,489,0,900,411,115,374
34,"SIBIU",323,144553,,265,"DÎRLOS / Scoala Ioan MORARU",3,13685,"DÎRLOS",144553,1036,562,506,51,5,560,2,1100,538,162,398
34,"SIBIU",323,144553,,266,"CURCIU / Scoala Gimnaziala Curciu",3,13685,"DÎRLOS",144553,687,373,349,24,0,371,2,800,427,107,264
34,"SIBIU",323,144553,,267,"VALEA LUNGĂ / CĂMIN CULTURAL VALEA LUNGĂ",3,13685,"DÎRLOS",144553,188,144,116,26,2,144,0,250,106,35,109
34,"SIBIU",323,144599,,268,"GURA RÂULUI / Şcoala generală cu cls. V-VIII",3,13689,"GURA RÂULUI",144599,1374,1143,1032,98,13,1135,8,1500,357,155,980
34,"SIBIU",323,144599,,269,"GURA RÂULUI / Grădiniţa nr.2",3,13689,"GURA RÂULUI",144599,1481,1152,1073,71,8,1142,10,1600,448,124,1018
34,"SIBIU",323,144615,,270,"HOGHILAG / PRIMARIA HOGHILAG",3,13691,"HOGHILAG",144615,952,543,507,36,0,541,2,1000,457,175,366
34,"SIBIU",323,144615,,271,"PROD / SCOALA PRIMARA PROD",3,13691,"HOGHILAG",144615,215,151,125,26,0,148,3,250,99,39,109
34,"SIBIU",323,144615,,272,"VALCHID / CLADIRE CE APARTINE PRIMARIEI HOGHILAG",3,13691,"HOGHILAG",144615,584,407,363,44,0,405,2,650,243,221,184
34,"SIBIU",323,144651,,273,"IACOBENI / PRIMARIA IACOBENI",3,13695,"IACOBENI",144651,769,512,480,32,0,507,5,800,288,249,258
34,"SIBIU",323,144651,,274,"STEJĂRIŞU / SCOALA PRIMARA",3,13695,"IACOBENI",144651,411,221,205,16,0,220,1,500,279,68,152
34,"SIBIU",323,144651,,275,"NETUŞ / SCOALA PRIMARA",3,13695,"IACOBENI",144651,382,201,182,19,0,200,1,400,199,73,127
34,"SIBIU",323,144651,,276,"NOIŞTAT / SCOALA GIMNAZIALA",3,13695,"IACOBENI",144651,431,221,203,18,0,219,2,500,279,85,134
34,"SIBIU",323,144651,,277,"MOVILE / GRADINITA",3,13695,"IACOBENI",144651,286,166,153,13,0,164,2,300,134,48,116
34,"SIBIU",323,144713,,278,"JINA / Primaria comunei Jina",3,13701,"JINA",144713,1617,950,867,83,0,946,4,1800,850,128,818
34,"SIBIU",323,144713,,279,"JINA / Scoala  cu cls I-IV Jina Baiesi , sala de clasa nr. 5",3,13701,"JINA",144713,1246,758,740,18,0,736,22,1400,642,88,648
34,"SIBIU",323,144731,,280,"LASLEA / Camin cultural LASLEA",3,13703,"LASLEA",144731,1247,856,731,99,26,843,13,1400,544,495,348
34,"SIBIU",323,144731,,281,"MĂLÎNCRAV / Camin cultural MĂLÎNCRAV",3,13703,"LASLEA",144731,946,541,474,64,3,538,3,1000,459,194,344
34,"SIBIU",323,144731,,282,"FLOREŞTI / Camin cultural FLOREŞTI",3,13703,"LASLEA",144731,98,88,57,27,4,88,0,150,62,46,42
34,"SIBIU",323,144731,,283,"ROANDOLA / Scoala clasele I-IV ROANDOLA",3,13703,"LASLEA",144731,242,105,71,33,1,102,3,300,195,56,46
34,"SIBIU",323,144731,,284,"NOU SĂSESC / Scoala clasele I-IV NOU SĂSESC",3,13703,"LASLEA",144731,613,207,177,27,3,207,0,700,493,78,129
34,"SIBIU",323,144795,,285,"LOAMNEŞ / CAMIN CULTURAL LOAMNES",3,13709,"LOAMNEŞ",144795,511,429,371,57,1,427,2,600,171,165,262
34,"SIBIU",323,144795,,286,"MÎNDRA / CAMIN CULTURAL MANDRA",3,13709,"LOAMNEŞ",144795,286,273,216,51,6,272,1,300,27,108,164
34,"SIBIU",323,144795,,287,"ALĂMOR / CAMIN CULTURAL ALAMOR",3,13709,"LOAMNEŞ",144795,633,466,407,54,5,461,5,700,234,158,303
34,"SIBIU",323,144795,,288,"ARMENI / SCOALA CU CLS.I-IV ARMENI",3,13709,"LOAMNEŞ",144795,450,281,246,35,0,278,3,500,219,100,178
34,"SIBIU",323,144795,,289,"HAŞAG / SCOALA CU CLS.I-IV HASAG",3,13709,"LOAMNEŞ",144795,511,362,316,41,5,361,1,600,238,96,265
34,"SIBIU",323,144866,,290,"LUDOŞ / PRIMARIA",3,13716,"LUDOŞ",144866,595,391,309,72,10,387,4,700,309,133,254
34,"SIBIU",323,144893,,291,"MARPOD / PRIMARIA MARPOD",3,13719,"MARPOD",144893,537,397,306,81,10,395,2,600,203,92,303
34,"SIBIU",323,144893,,292,"ILIMBAV / ŞCOALA GENERALĂ ILIMBAV",3,13719,"MARPOD",144893,154,118,94,24,0,118,0,200,82,24,94
34,"SIBIU",323,144964,,293,"MERGHINDEAL / Centru de zi (after school)",3,13722,"MERGHINDEAL",144964,672,399,331,41,27,395,4,700,301,143,252
34,"SIBIU",323,144964,,294,"DEALU FRUMOS / SCOALA GENERALA CU CLASELE I-IV DEALU FRUMOS",3,13722,"MERGHINDEAL",144964,539,285,254,27,4,285,0,600,315,137,148
34,"SIBIU",323,144991,,295,"MICĂSASA / Cămin cultural Micăsasa",3,13725,"MICĂSASA",144991,1160,867,763,66,38,865,2,1300,433,327,538
34,"SIBIU",323,144991,,296,"ŢAPU / Scoala Generală Ţapu",3,13725,"MICĂSASA",144991,656,377,339,23,15,374,3,700,323,127,247
34,"SIBIU",323,144991,,297,"CHESLER / Scoala Chesler",3,13725,"MICĂSASA",144991,62,66,38,23,5,65,1,100,34,39,26
34,"SIBIU",323,145042,,298,"MIHĂILENI / Primaria Comunei Mihaileni",3,13730,"MIHĂILENI",145042,265,180,156,23,1,178,2,300,120,64,114
34,"SIBIU",323,145042,,299,"METIŞ / Scoala Generala Metis",3,13730,"MIHĂILENI",145042,234,140,122,17,1,138,2,300,160,63,75
34,"SIBIU",323,145042,,300,"RĂVĂŞEL / Caminul Cultural Ravasel",3,13730,"MIHĂILENI",145042,264,136,119,17,0,135,1,300,164,59,76
34,"SIBIU",323,145104,,301,"MOŞNA / Sc,gimnaziala Mosna",3,13736,"MOŞNA",145104,1052,703,616,87,0,697,6,1200,497,230,467
34,"SIBIU",323,145104,,302,"MOŞNA / Sc.gimnaziala Mosna",3,13736,"MOŞNA",145104,923,570,569,0,1,565,5,1000,430,199,366
34,"SIBIU",323,145104,,303,"ALMA VII / Gradinita Alma Vii",3,13736,"MOŞNA",145104,326,191,164,27,0,190,1,400,209,74,116
34,"SIBIU",323,145104,,304,"NEMŞA / Sc.gimnaziala Nemsa",3,13736,"MOŞNA",145104,467,342,304,38,0,340,2,500,158,208,132
34,"SIBIU",323,145140,,305,"NOCRICH / Caminul Cultural Nocrich",3,13740,"NOCRICH",145140,1118,647,612,35,0,633,14,1200,553,87,546
34,"SIBIU",323,145140,,306,"HOSMAN / Gradinita Hosman",3,13740,"NOCRICH",145140,703,384,344,40,0,380,4,800,416,88,292
34,"SIBIU",323,145140,,307,"FOFELDEA / Scoala cu clasele I-IV, Fofeldea",3,13740,"NOCRICH",145140,280,250,199,48,3,246,4,300,50,31,215
34,"SIBIU",323,145140,,308,"GHIJASA DE JOS / Scoala cu clasele I-IV, Ghijasa de Jos",3,13740,"NOCRICH",145140,89,67,48,19,0,66,1,100,33,15,51
34,"SIBIU",323,145140,,309,"ŢICHINDEAL / Scoala cu clasele I-IV, Ţichindeal",3,13740,"NOCRICH",145140,130,120,91,29,0,120,0,150,30,38,82
34,"SIBIU",323,145202,,310,"ORLAT / GRĂDINIŢA ORLAT",3,13746,"ORLAT",145202,1278,866,803,63,0,863,3,1400,534,95,768
34,"SIBIU",323,145202,,311,"ORLAT / GRĂDINIŢA ORLAT",3,13746,"ORLAT",145202,1348,980,892,86,2,975,5,1500,520,103,872
34,"SIBIU",323,145220,,312,"PĂUCA / Primaria comunei PĂUCA",3,13748,"PĂUCA",145220,692,372,318,28,26,371,1,800,428,77,294
34,"SIBIU",323,145220,,313,"BOGATU ROMÂN / Şcoala Generală BOGATU-ROMÂN",3,13748,"PĂUCA",145220,394,334,280,42,12,331,3,450,116,73,258
34,"SIBIU",323,145220,,314,"BROŞTENI / Şcoala generală BROŞTENI",3,13748,"PĂUCA",145220,292,225,202,15,8,223,2,350,125,50,173
34,"SIBIU",323,145220,,315,"PRESACA / Şcoala generală PRESACA",3,13748,"PĂUCA",145220,352,298,258,28,12,297,1,400,102,77,220
34,"SIBIU",323,145275,,316,"POIANA SIBIULUI / Caminul cultural",3,13753,"POIANA SIBIULUI",145275,977,627,498,129,0,624,3,1100,473,143,481
34,"SIBIU",323,145275,,317,"POIANA SIBIULUI / Scoala Gimnaziala Vadu",3,13753,"POIANA SIBIULUI",145275,768,480,419,61,0,478,2,800,320,60,418
34,"SIBIU",323,143502,,318,"POPLACA / Caminul Cultural Poplaca",3,13755,"POPLACA",143502,1386,978,884,94,0,975,3,1500,522,127,848
34,"SIBIU",323,145293,,319,"PORUMBACU DE JOS / Primaria Porumbacu de Jos",3,13757,"PORUMBACU DE JOS",145293,898,623,556,66,1,616,7,1000,377,186,430
34,"SIBIU",323,145293,,320,"PORUMBACU DE SUS / Caminul Cultural Porumbacu de Sus",3,13757,"PORUMBACU DE JOS",145293,689,543,459,84,0,542,1,800,257,221,321
34,"SIBIU",323,145293,,321,"SCOREIU / Caminul Cultural Scoreiu",3,13757,"PORUMBACU DE JOS",145293,570,385,318,67,0,382,3,600,215,80,302
34,"SIBIU",323,145293,,322,"SĂRATA / Caminul Cultural Sarata",3,13757,"PORUMBACU DE JOS",145293,280,246,67,179,0,245,1,300,54,64,181
34,"SIBIU",323,145293,,323,"COLUN / Caminul Cultural  Colun",3,13757,"PORUMBACU DE JOS",145293,148,106,81,25,0,106,0,200,94,45,61
34,"SIBIU",323,145355,,324,"SEBEŞU DE SUS / ŞCOALA I-IV",3,13763,"RACOVIŢA",145355,611,443,365,76,2,442,1,700,257,79,363
34,"SIBIU",323,145355,,325,"RACOVIŢA / CĂMIN CULTURAL RACOVIŢA",3,13763,"RACOVIŢA",145355,1730,1178,1118,58,2,1169,9,1900,722,182,987
34,"SIBIU",323,143520,,326,"RĂŞINARI / SCOALA GENERALA NR.1",3,13766,"RĂŞINARI",143520,1487,873,819,52,2,860,13,1600,727,115,745
34,"SIBIU",323,143520,,327,"RĂŞINARI / scoala generala nr 2 RASINARI",3,13766,"RĂŞINARI",143520,1456,909,819,90,0,904,5,1600,691,86,818
34,"SIBIU",323,143520,,328,"RĂŞINARI / CAMINUL CULTURAL RASINARI",3,13766,"RĂŞINARI",143520,1492,1024,961,63,0,1014,10,1600,576,113,901
34,"SIBIU",323,145382,,329,"RÎU SADULUI / PRIMARIA",3,13769,"RÎU SADULUI",145382,491,359,307,48,4,356,3,550,191,53,303
34,"SIBIU",323,145408,,330,"ROŞIA / PRIMARIA ROSIA",3,13771,"ROŞIA",145408,1122,738,677,56,5,731,7,1200,462,161,570
34,"SIBIU",323,145408,,331,"NOU / SCOALA GEN. CLASELE I-VIII",3,13771,"ROŞIA",145408,1252,783,741,42,0,775,8,1400,617,177,598
34,"SIBIU",323,145408,,332,"DAIA / SCOALA GEN. CLASELE I-VIII",3,13771,"ROŞIA",145408,706,479,417,62,0,477,2,800,321,51,426
34,"SIBIU",323,145408,,333,"CAŞOLŢ / SCOALA GEN. CLASELE I-VIII",3,13771,"ROŞIA",145408,550,344,297,45,2,340,4,600,256,107,233
34,"SIBIU",323,145408,,334,"CORNĂŢEL / SEDIUL ADMINISTRATIV DISPENSAR",3,13771,"ROŞIA",145408,403,313,255,58,0,312,1,450,137,87,225
34,"SIBIU",323,145471,,335,"SADU / CĂMINUL CULTURAL AL COMUNEI SADU",3,13778,"SADU",145471,975,725,668,57,0,719,6,1100,375,107,612
34,"SIBIU",323,145471,,336,"SADU / CĂMINUL CULTURAL AL COMUNEI SADU",3,13778,"SADU",145471,1042,738,700,38,0,735,3,1100,362,105,630
34,"SIBIU",323,145603,,337,"SLIMNIC / ŞCOALA GIMNAZIALĂ SLIMNIC",3,13795,"SLIMNIC",145603,1314,808,728,80,0,805,3,1400,592,83,722
34,"SIBIU",323,145603,,338,"SLIMNIC / ŞCOALA GIMNAZIALĂ SLIMNIC",3,13795,"SLIMNIC",145603,943,587,525,62,0,585,2,1000,413,86,499
34,"SIBIU",323,145603,,339,"RUŞI / ŞCOALA GIMNAZIALĂ RUŞI",3,13795,"SLIMNIC",145603,741,474,430,44,0,472,2,800,326,96,376
34,"SIBIU",323,145603,,340,"VESEUD / Şcoala Gimnaziala Veseud",3,13795,"SLIMNIC",145603,168,123,91,32,0,123,0,200,77,39,84
34,"SIBIU",323,145667,,341,"ŞEICA MARE / Şcoala Şeica Mare",3,13780,"ŞEICA MARE",145667,942,634,555,77,2,632,2,1000,366,64,568
34,"SIBIU",323,145667,,342,"ŞEICA MARE / Şcoala Şeica Mare",3,13780,"ŞEICA MARE",145667,888,546,508,37,1,540,6,1000,454,70,470
34,"SIBIU",323,145667,,343,"ŞEICA MARE / Şcoala Şeica Mare",3,13780,"ŞEICA MARE",145667,894,632,554,76,2,630,2,1000,368,78,552
34,"SIBIU",323,145667,,344,"BOARTA / Şcoala Boarta",3,13780,"ŞEICA MARE",145667,339,226,186,40,0,226,0,400,174,35,191
34,"SIBIU",323,145667,,345,"BUIA / Şcoala Buia",3,13780,"ŞEICA MARE",145667,482,326,280,44,2,324,2,500,174,40,284
34,"SIBIU",323,145667,,346,"ŞTENEA / Şcoala Ştenea",3,13780,"ŞEICA MARE",145667,133,98,71,27,0,96,2,150,52,24,72
34,"SIBIU",323,145667,,347,"PETIŞ / Imobil Petiş",3,13780,"ŞEICA MARE",145667,48,45,17,28,0,45,0,100,55,8,37
34,"SIBIU",323,145738,,348,"ŞEICA MICĂ / PRIMARIA",3,13787,"ŞEICA MICĂ",145738,1075,541,492,44,5,539,2,1200,659,164,375
34,"SIBIU",323,145738,,349,"SOROŞTIN / Fostul sediu CAP SOROŞTIN",3,13787,"ŞEICA MICĂ",145738,439,323,276,41,6,322,1,500,177,220,102
34,"SIBIU",323,143557,,350,"ŞELIMBĂR / Cămin Cultural Şelimbăr",3,13790,"ŞELIMBĂR",143557,1231,1006,762,244,0,1003,3,1400,394,201,802
34,"SIBIU",323,143557,,351,"ŞELIMBĂR / Şcoala Gimnazială `Mihai Viteazu~   Şelimbăr",3,13790,"ŞELIMBĂR",143557,1235,1016,856,159,1,1010,6,1400,384,189,821
34,"SIBIU",323,143557,,352,"ŞELIMBĂR / Grădiniţa cu program prelungit",3,13790,"ŞELIMBĂR",143557,1579,1322,1040,269,13,1310,12,1700,378,164,1146
34,"SIBIU",323,143557,,353,"VEŞTEM / CAMIN CULTURAL VESTEM",3,13790,"ŞELIMBĂR",143557,1363,976,892,84,0,971,5,1500,524,262,709
34,"SIBIU",323,143557,,354,"MOHU / CAMIN CULTURAL MOHU",3,13790,"ŞELIMBĂR",143557,596,427,371,56,0,426,1,700,273,67,359
34,"SIBIU",323,143557,,355,"BUNGARD / CAMIN CULTURAL BUNGRAD",3,13790,"ŞELIMBĂR",143557,485,328,286,42,0,326,2,500,172,41,285
34,"SIBIU",323,145765,,356,"ŞURA MARE / SALA SPORT",3,13801,"ŞURA MARE",145765,1418,866,811,55,0,859,7,1600,734,168,691
34,"SIBIU",323,145765,,357,"ŞURA MARE / SALA SPORT",3,13801,"ŞURA MARE",145765,1378,885,797,86,2,879,6,1500,615,115,764
34,"SIBIU",323,145765,,358,"HAMBA / CAMINUL CULTURAL",3,13801,"ŞURA MARE",145765,651,431,380,51,0,427,4,700,269,63,364
34,"SIBIU",323,145792,,359,"ŞURA MICĂ / SCOALA GENERALA CU CLASELE V-VIII SURA MICA",3,13804,"ŞURA MICĂ",145792,1770,1122,967,155,0,1112,10,1900,778,174,938
34,"SIBIU",323,145792,,360,"RUSCIORI / SCOALA CU CLS.I-IV RUSCIORI",3,13804,"ŞURA MICĂ",145792,535,382,325,57,0,376,6,600,218,102,274
34,"SIBIU",323,145907,,361,"TILIŞCA / PRIMĂRIA TILIŞCA",3,13807,"TILIŞCA",145907,870,681,603,70,8,676,5,1000,319,183,493
34,"SIBIU",323,145907,,362,"ROD / ŞCOALA GENERALĂ ROD",3,13807,"TILIŞCA",145907,330,241,199,42,0,239,2,400,159,38,201
34,"SIBIU",323,143646,,363,"TÎRNAVA / Gradinita  Tirnava",3,13810,"TÎRNAVA",143646,1257,788,742,42,4,781,7,1400,612,276,505
34,"SIBIU",323,143646,,364,"TÎRNAVA / Grădiniţa Tîrnava",3,13810,"TÎRNAVA",143646,1187,733,685,41,7,728,5,1300,567,216,512
34,"SIBIU",323,145934,,365,"TURNU ROŞU / CLUB",3,13813,"TURNU ROŞU",145934,1427,1061,944,117,0,1056,5,1600,539,252,804
34,"SIBIU",323,145934,,366,"SEBEŞU DE JOS / DISPENSAR",3,13813,"TURNU ROŞU",145934,500,394,335,59,0,391,3,600,206,125,266
34,"SIBIU",323,145961,,367,"VALEA VIILOR / Cămin Valea   Viilor",3,13816,"VALEA VIILOR",145961,1289,756,679,48,29,748,8,1400,644,251,497
34,"SIBIU",323,145961,,368,"MOTIŞ / Cămin  Motiş",3,13816,"VALEA VIILOR",145961,565,271,237,32,2,270,1,600,329,61,209
34,"SIBIU",323,145998,,369,"VURPĂR / SALA SPORT",3,13819,"VURPĂR",145998,1158,734,690,43,1,727,7,1250,516,270,457
34,"SIBIU",323,145998,,370,"VURPĂR / ŞCOALA GIMNAZIALĂ",3,13819,"VURPĂR",145998,820,471,421,50,0,467,4,900,429,84,383
35,"SUCEAVA",332,146263,,1,"SUCEAVA / PRIMĂRIA MUNICIPIULUI SUCEAVA",1,13822,"MUNICIPIUL SUCEAVA",146263,1555,1049,928,121,0,1011,38,1707,658,463,548
35,"SUCEAVA",332,146263,,2,"SUCEAVA / COLEGIUL NAŢIONAL ""PETRU RAREŞ"" SALA A",1,13822,"MUNICIPIUL SUCEAVA",146263,1730,1183,1100,81,2,1161,22,1904,721,525,636
35,"SUCEAVA",332,146263,,3,"SUCEAVA / COLEGIUL NAŢIONAL ""PETRU RAREŞ"" SALA B",1,13822,"MUNICIPIUL SUCEAVA",146263,1692,1134,1029,102,3,1124,10,1862,728,558,566
35,"SUCEAVA",332,146263,,4,"SUCEAVA / COLEGIUL NAŢIONAL "" ŞTEFAN CEL MARE""",1,13822,"MUNICIPIUL SUCEAVA",146263,1450,983,878,105,0,957,26,1590,607,319,638
35,"SUCEAVA",332,146263,,5,"SUCEAVA / Casa de Cultură a Sindicatelor",1,13822,"MUNICIPIUL SUCEAVA",146263,1638,1159,1015,144,0,1138,21,1795,636,514,624
35,"SUCEAVA",332,146263,,6,"SUCEAVA / ŞCOALA  GIMNAZIALĂ NR .1",1,13822,"MUNICIPIUL SUCEAVA",146263,1073,744,668,75,1,729,15,1184,440,328,401
35,"SUCEAVA",332,146263,,7,"SUCEAVA / COLEGIUL TEHNIC ""SAMUIL ISOPESCU""",1,13822,"MUNICIPIUL SUCEAVA",146263,1212,854,789,65,0,835,19,1325,471,368,467
35,"SUCEAVA",332,146263,,8,"SUCEAVA / COLEGIUL DE ARTĂ ""Ciprian Porumbescu"" SALA A",1,13822,"MUNICIPIUL SUCEAVA",146263,751,532,448,84,0,526,6,828,296,231,295
35,"SUCEAVA",332,146263,,9,"SUCEAVA / COLEGIUL DE ARTĂ ""Ciprian Porumbescu"" SALA B",1,13822,"MUNICIPIUL SUCEAVA",146263,1406,824,795,28,1,808,16,1546,722,333,475
35,"SUCEAVA",332,146263,,10,"SUCEAVA / ŞCOALA GIMNAZIALĂ NR.3  Sala A",1,13822,"MUNICIPIUL SUCEAVA",146263,1107,784,687,96,1,774,10,1220,436,346,428
35,"SUCEAVA",332,146263,,11,"SUCEAVA / ŞCOALA GIMNAZIALĂ NR.3  Sala B",1,13822,"MUNICIPIUL SUCEAVA",146263,1172,801,753,46,2,784,17,1292,491,370,414
35,"SUCEAVA",332,146263,,12,"SUCEAVA / COLEGIUL ECONOMIC   "" DIMITRIE CANTEMIR""",1,13822,"MUNICIPIUL SUCEAVA",146263,1149,766,709,51,6,752,14,1265,499,360,392
35,"SUCEAVA",332,146263,,13,"SUCEAVA / GRADINIŢA CU PROGRAM NORMAL NR 4        ,,PITICOT """,1,13822,"MUNICIPIUL SUCEAVA",146263,1644,969,929,40,0,955,14,1802,833,429,526
35,"SUCEAVA",332,146263,,14,"SUCEAVA / UNIVERSITATEA ""ŞTEFAN CEL MARE""",1,13822,"MUNICIPIUL SUCEAVA",146263,929,1006,536,469,1,986,20,1020,14,337,649
35,"SUCEAVA",332,146263,,15,"SUCEAVA / DIRECŢIA  SILVICĂ SUCEAVA",1,13822,"MUNICIPIUL SUCEAVA",146263,1052,773,600,67,106,762,11,1158,385,386,376
35,"SUCEAVA",332,146263,,16,"SUCEAVA / COLEGIUL NAŢIONAL DE INFORMATICĂ ,,SPIRU HARET"", SALA A",1,13822,"MUNICIPIUL SUCEAVA",146263,1196,897,709,76,112,883,14,1318,421,401,482
35,"SUCEAVA",332,146263,,17,"SUCEAVA / COLEGIUL NAŢIONAL DE INFORMATICĂ "" SPIRU HARET"", SALA B",1,13822,"MUNICIPIUL SUCEAVA",146263,1029,850,623,75,152,827,23,1133,283,409,418
35,"SUCEAVA",332,146263,,18,"SUCEAVA / GRĂDINIŢA CU PROGRAM PRELUNGIT NR.7 ""ABC """,1,13822,"MUNICIPIUL SUCEAVA",146263,1388,886,835,51,0,870,16,1529,643,408,462
35,"SUCEAVA",332,146263,,19,"SUCEAVA / ŞCOALA  GIMNAZIALĂ NR. 4 SALA A",1,13822,"MUNICIPIUL SUCEAVA",146263,1595,979,938,41,0,962,17,1750,771,492,470
35,"SUCEAVA",332,146263,,20,"SUCEAVA / ŞCOALA  GIMNAZIALĂ NR. 4, SALA B",1,13822,"MUNICIPIUL SUCEAVA",146263,1400,883,827,56,0,870,13,1537,654,396,474
35,"SUCEAVA",332,146263,,21,"SUCEAVA / ŞCOALA  GIMNAZIALĂ NR. 8",1,13822,"MUNICIPIUL SUCEAVA",146263,1955,1167,1081,86,0,1154,13,2133,966,500,654
35,"SUCEAVA",332,146263,,22,"SUCEAVA / GRADINIŢA CU PROGRAM NORMAL NR. 5",1,13822,"MUNICIPIUL SUCEAVA",146263,1862,1074,1037,37,0,1045,29,2054,980,441,604
35,"SUCEAVA",332,146263,,23,"SUCEAVA / GRADINIŢA CU PROGRAM PRELUNGIT NR.1 ,,GULIVER""",1,13822,"MUNICIPIUL SUCEAVA",146263,1373,828,762,65,1,811,17,1512,684,345,466
35,"SUCEAVA",332,146263,,24,"SUCEAVA / LICEUL CU PROGRAM SPORTIV SALA A",1,13822,"MUNICIPIUL SUCEAVA",146263,1647,962,909,53,0,944,18,1815,853,427,517
35,"SUCEAVA",332,146263,,25,"SUCEAVA / LICEUL CU PROGRAM SPORTIV SALA B",1,13822,"MUNICIPIUL SUCEAVA",146263,1823,1026,973,52,1,1000,26,2007,981,455,545
35,"SUCEAVA",332,146263,,26,"SUCEAVA / COLEGIUL NAŢIONAL   ""MIHAI EMINESCU"" SALA A",1,13822,"MUNICIPIUL SUCEAVA",146263,1487,851,764,87,0,842,9,1636,785,332,510
35,"SUCEAVA",332,146263,,27,"SUCEAVA / COLEGIUL NAŢIONAL   ""MIHAI EMINESCU"" SALA B",1,13822,"MUNICIPIUL SUCEAVA",146263,1667,1067,994,70,3,1053,14,1827,760,451,602
35,"SUCEAVA",332,146263,,28,"SUCEAVA / COLEGIUL NAŢIONAL   ""MIHAI EMINESCU"" SALA C",1,13822,"MUNICIPIUL SUCEAVA",146263,1681,1040,990,49,1,1018,22,1855,815,448,570
35,"SUCEAVA",332,146263,,29,"SUCEAVA / COLEGIUL TEHNIC DE INDUSTRIE ALIMENTARĂ, SALA A",1,13822,"MUNICIPIUL SUCEAVA",146263,1932,1151,1088,60,3,1136,15,2115,964,477,659
35,"SUCEAVA",332,146263,,30,"SUCEAVA / COLEGIUL TEHNIC DE INDUSTRIE ALIMENTARĂ, SALA B",1,13822,"MUNICIPIUL SUCEAVA",146263,1987,1241,1133,108,0,1216,25,2189,948,510,706
35,"SUCEAVA",332,146263,,31,"SUCEAVA / GRĂDINIŢA CU PROGRAM PRELUNGIT  NR.3  ""DUMBRAVA MINUNATĂ""",1,13822,"MUNICIPIUL SUCEAVA",146263,613,409,387,22,0,401,8,670,261,167,234
35,"SUCEAVA",332,146263,,32,"SUCEAVA / S.C.TRUST ORIZONT S.A.",1,13822,"MUNICIPIUL SUCEAVA",146263,456,279,261,18,0,276,3,502,223,105,171
35,"SUCEAVA",332,146263,,33,"SUCEAVA / COLEGIUL TEHNIC  ""PETRU MUŞAT""",1,13822,"MUNICIPIUL SUCEAVA",146263,659,404,358,46,0,401,3,722,318,152,249
35,"SUCEAVA",332,146263,,34,"SUCEAVA / S.C. ROMTELECOM  S.A.",1,13822,"MUNICIPIUL SUCEAVA",146263,1841,1107,1026,81,0,1094,13,2032,925,376,718
35,"SUCEAVA",332,146263,,35,"SUCEAVA / INSPECTORATUL TERITORIAL DE MUNCĂ",1,13822,"MUNICIPIUL SUCEAVA",146263,1841,1006,958,47,1,983,23,2021,1015,375,608
35,"SUCEAVA",332,146263,,36,"SUCEAVA / Agenţia pentru Protecţia Mediului",1,13822,"MUNICIPIUL SUCEAVA",146263,1955,1234,1140,94,0,1206,28,2149,915,450,756
35,"SUCEAVA",332,146263,,37,"SUCEAVA / ŞCOALA GIMNAZIALĂALĂ  NR. 9 ,,ION CREANGĂ"" SALA A",1,13822,"MUNICIPIUL SUCEAVA",146263,1944,1167,1101,66,0,1144,23,2143,976,406,738
35,"SUCEAVA",332,146263,,38,"SUCEAVA / ŞCOALA GIMNAZIALĂALĂ  NR. 9 ,,ION CREANGĂ"" SALA B",1,13822,"MUNICIPIUL SUCEAVA",146263,1972,1231,1124,107,0,1196,35,2161,930,443,753
35,"SUCEAVA",332,146263,,39,"SUCEAVA / ŞCOALA GIMNAZIALĂALĂ  NR. 9 ,,ION CREANGĂ"", SALA C",1,13822,"MUNICIPIUL SUCEAVA",146263,1808,1066,987,77,2,1057,9,1993,927,357,700
35,"SUCEAVA",332,146263,,40,"SUCEAVA / SCOALA GIMNAZIALA NR.9 ""ION CREANGA"", SALA D",1,13822,"MUNICIPIUL SUCEAVA",146263,1832,1117,1051,65,1,1095,22,2014,897,438,657
35,"SUCEAVA",332,146263,,41,"SUCEAVA / GRĂDINIŢA CU PROGRAM NORMAL NR. 9   ,,NOROCEL""",1,13822,"MUNICIPIUL SUCEAVA",146263,1948,1136,1013,123,0,1115,21,2130,994,404,711
35,"SUCEAVA",332,146263,,42,"SUCEAVA / ATELIER ZONĂ CFR",1,13822,"MUNICIPIUL SUCEAVA",146263,1625,931,860,71,0,913,18,1763,832,366,547
35,"SUCEAVA",332,146263,,43,"SUCEAVA / GARA BURDUJENI",1,13822,"MUNICIPIUL SUCEAVA",146263,1814,1005,801,204,0,987,18,1967,962,391,596
35,"SUCEAVA",332,146263,,44,"SUCEAVA / ŞCOALA  GIMNAZIALĂ NR. 10, SALA A",1,13822,"MUNICIPIUL SUCEAVA",146263,1942,1051,994,56,1,1020,31,2140,1089,402,618
35,"SUCEAVA",332,146263,,45,"SUCEAVA / ŞCOALA  GIMNAZIALĂ NR. 10, SALA B",1,13822,"MUNICIPIUL SUCEAVA",146263,1934,1077,1021,56,0,1058,19,2132,1055,409,649
35,"SUCEAVA",332,146263,,46,"SUCEAVA / COLEGIUL TEHNIC ""A.I.CUZA""  Sala A,                               Calea Unirii, nr.49",1,13822,"MUNICIPIUL SUCEAVA",146263,1719,962,903,59,0,945,17,1876,914,331,614
35,"SUCEAVA",332,146263,,47,"SUCEAVA / COLEGIUL TEHNIC ""A.I.CUZA""  Sala B,                               Calea Unirii, nr.49",1,13822,"MUNICIPIUL SUCEAVA",146263,1614,901,863,38,0,887,14,1773,872,332,555
35,"SUCEAVA",332,146263,,48,"SUCEAVA / COLEGIUL TEHNIC ""AL. I. CUZA"" SALA C",1,13822,"MUNICIPIUL SUCEAVA",146263,1334,743,722,20,1,729,14,1465,722,293,436
35,"SUCEAVA",332,146263,,49,"SUCEAVA / ŞCOALA  GIMNAZIALĂ NR. 5   ,,JEAN BART""",1,13822,"MUNICIPIUL SUCEAVA",146263,1645,897,861,36,0,886,11,1805,908,338,548
35,"SUCEAVA",332,146263,,50,"SUCEAVA / CENTRUL  ŞCOLAR PENTRU EDUCAŢIE INCLUZIVĂ SUCEAVA, CORP A",1,13822,"MUNICIPIUL SUCEAVA",146263,1922,1080,1030,50,0,1067,13,2114,1034,378,689
35,"SUCEAVA",332,146263,,51,"SUCEAVA / CENTRUL ŞCOLAR PENTRU EDUCAŢIE INCLUZIVĂ SUCEAVA- CORP B",1,13822,"MUNICIPIUL SUCEAVA",146263,1686,855,819,36,0,836,19,1858,1003,332,504
35,"SUCEAVA",332,146263,,52,"SUCEAVA / GRĂDINIŢA CU PROGRAM NORMAL NR. 12 ""ŢĂNDĂRICĂ""",1,13822,"MUNICIPIUL SUCEAVA",146263,1785,948,895,53,0,935,13,1969,1021,341,594
35,"SUCEAVA",332,146263,,53,"SUCEAVA / ŞCOALA GIMNAZIALĂ NR.11, ,,MIRON COSTIN"", SALA A",1,13822,"MUNICIPIUL SUCEAVA",146263,1938,1064,1001,63,0,1045,19,2132,1068,362,683
35,"SUCEAVA",332,146263,,54,"SUCEAVA / ŞCOALA GIMNAZIALĂ NR.11, ,,MIRON COSTIN"", SALA B",1,13822,"MUNICIPIUL SUCEAVA",146263,1762,945,884,59,2,932,13,1937,992,378,554
35,"SUCEAVA",332,146263,,55,"SUCEAVA / ŞCOALA GIMNAZIALĂ NR.11, ,,MIRON COSTIN"", SALA C",1,13822,"MUNICIPIUL SUCEAVA",146263,1757,953,908,45,0,937,16,1939,986,377,560
35,"SUCEAVA",332,146263,,56,"SUCEAVA / ŞCOALA GIMNAZIALĂ NR.11, ,,MIRON COSTIN"", SALA D",1,13822,"MUNICIPIUL SUCEAVA",146263,1401,758,720,38,0,736,22,1536,778,264,472
35,"SUCEAVA",332,146263,,57,"SUCEAVA / SCOALA GIMNAZIALA NR.11 ""MIRON COSTIN"", SALA E",1,13822,"MUNICIPIUL SUCEAVA",146263,1593,846,820,26,0,826,20,1759,913,301,525
35,"SUCEAVA",332,146263,,58,"SUCEAVA / PRIMĂRIA BURDUJENI",1,13822,"MUNICIPIUL SUCEAVA",146263,1268,720,681,32,7,710,10,1393,673,267,443
35,"SUCEAVA",332,146263,,59,"SUCEAVA / ŞCOALA GIMNAZIALĂ NR. 6, SALA A",1,13822,"MUNICIPIUL SUCEAVA",146263,1088,588,573,15,0,565,23,1188,600,242,323
35,"SUCEAVA",332,146263,,60,"SUCEAVA / SCOALA GIMNAZIALA NR.6 SALA B",1,13822,"MUNICIPIUL SUCEAVA",146263,1042,636,609,26,1,626,10,1146,510,233,393
35,"SUCEAVA",332,146263,,61,"SUCEAVA / GARA SUCEAVA NORD   IŢCANI",1,13822,"MUNICIPIUL SUCEAVA",146263,1247,810,694,116,0,803,7,1375,565,411,392
35,"SUCEAVA",332,146263,,62,"SUCEAVA / GRĂDINIŢA  CU PROGRAM NORMAL NR.8",1,13822,"MUNICIPIUL SUCEAVA",146263,1434,850,809,41,0,837,13,1580,730,352,485
35,"SUCEAVA",332,146263,,63,"SUCEAVA / ŞCOALA GENERALĂ  NR. 7  ,,GRIGORE GHICA VOIEVOD""",1,13822,"MUNICIPIUL SUCEAVA",146263,1598,930,881,49,0,915,14,1761,831,379,536
35,"SUCEAVA",332,146502,,64,"CÂMPULUNG MOLDOVENESC / Şcoala gimnazială ""Theodor Darie""",1,13824,"MUNICIPIUL CÂMPULUNG MOLDOVENESC",146502,1504,926,873,53,0,916,10,1655,729,319,597
35,"SUCEAVA",332,146502,,65,"CÂMPULUNG MOLDOVENESC / Liceul tehnologic nr. 1",1,13824,"MUNICIPIUL CÂMPULUNG MOLDOVENESC",146502,893,615,509,47,59,603,12,987,372,254,349
35,"SUCEAVA",332,146502,,66,"CÂMPULUNG MOLDOVENESC / Circumscripţia sanitar-veterinară",1,13824,"MUNICIPIUL CÂMPULUNG MOLDOVENESC",146502,1392,815,778,37,0,804,11,1531,716,340,464
35,"SUCEAVA",332,146502,,67,"CÂMPULUNG MOLDOVENESC / Şcoala gimnazială ""Teodor Ştefanelli""",1,13824,"MUNICIPIUL CÂMPULUNG MOLDOVENESC",146502,910,532,484,48,0,522,10,1009,477,246,276
35,"SUCEAVA",332,146502,,68,"CÂMPULUNG MOLDOVENESC / Colegiul Naţional  ""Dragoş Vodă""",1,13824,"MUNICIPIUL CÂMPULUNG MOLDOVENESC",146502,1163,673,617,56,0,660,13,1279,606,250,410
35,"SUCEAVA",332,146502,,69,"CÂMPULUNG MOLDOVENESC / Clubul Copiilor şi Elevilor",1,13824,"MUNICIPIUL CÂMPULUNG MOLDOVENESC",146502,1345,918,798,113,7,906,12,1479,561,359,547
35,"SUCEAVA",332,146502,,70,"CÂMPULUNG MOLDOVENESC / Şcoala gimnazială ""Bogdan Vodă""",1,13824,"MUNICIPIUL CÂMPULUNG MOLDOVENESC",146502,1463,1003,874,126,3,985,18,1614,611,399,586
35,"SUCEAVA",332,146502,,71,"CÂMPULUNG MOLDOVENESC / Clubul Copiilor şi Elevilor - Satul de vacanţă",1,13824,"MUNICIPIUL CÂMPULUNG MOLDOVENESC",146502,643,405,379,26,0,395,10,707,302,149,246
35,"SUCEAVA",332,146502,,72,"CÂMPULUNG MOLDOVENESC / Colegiul Silvic ""Bucovina"" (CORP A)",1,13824,"MUNICIPIUL CÂMPULUNG MOLDOVENESC",146502,1478,799,733,66,0,784,15,1625,826,277,507
35,"SUCEAVA",332,146502,,73,"CÂMPULUNG MOLDOVENESC / Colegiul Silvic ""Bucovina"" (CORP B)",1,13824,"MUNICIPIUL CÂMPULUNG MOLDOVENESC",146502,1441,815,789,26,0,797,18,1586,771,311,486
35,"SUCEAVA",332,146502,,74,"CÂMPULUNG MOLDOVENESC / Colegiul Silvic ""Bucovina"" (CORP C)",1,13824,"MUNICIPIUL CÂMPULUNG MOLDOVENESC",146502,1497,868,836,31,1,855,13,1649,781,329,526
35,"SUCEAVA",332,146502,,75,"CÂMPULUNG MOLDOVENESC / Grădiniţa nr. 4 ""Valea Seacă""",1,13824,"MUNICIPIUL CÂMPULUNG MOLDOVENESC",146502,1106,753,717,36,0,745,8,1210,457,305,440
35,"SUCEAVA",332,146502,,76,"CÂMPULUNG MOLDOVENESC / Şcoala gimnazială ""George Voevidca"" - CORP A",1,13824,"MUNICIPIUL CÂMPULUNG MOLDOVENESC",146502,1034,653,604,47,2,647,6,1131,478,269,378
35,"SUCEAVA",332,146502,,77,"CÂMPULUNG MOLDOVENESC / Şcoala gimnazială ""George Voevidca"" - CORP B",1,13824,"MUNICIPIUL CÂMPULUNG MOLDOVENESC",146502,1089,697,645,49,3,692,5,1200,503,236,456
35,"SUCEAVA",332,146539,,78,"FĂLTICENI / Colegiul Tehnic ""Mihai Băcescu""",1,13826,"MUNICIPIUL FĂLTICENI",146539,1448,1001,856,63,82,983,18,1585,584,547,436
35,"SUCEAVA",332,146539,,79,"FĂLTICENI / Şcoala Gimnazială ""Alexandru Ioan Cuza""",1,13826,"MUNICIPIUL FĂLTICENI",146539,1521,864,804,52,8,850,14,1678,814,553,297
35,"SUCEAVA",332,146539,,80,"FĂLTICENI / Colegiul Naţional ""Nicu Gane""",1,13826,"MUNICIPIUL FĂLTICENI",146539,1537,881,800,63,18,868,13,1688,807,558,310
35,"SUCEAVA",332,146539,,81,"FĂLTICENI / Colegiul Naţional ""Nicu Gane""",1,13826,"MUNICIPIUL FĂLTICENI",146539,1670,925,870,54,1,903,22,1840,915,537,366
35,"SUCEAVA",332,146539,,82,"FĂLTICENI / Şcoala Gimnazială ""Ioan Ciurea""",1,13826,"MUNICIPIUL FĂLTICENI",146539,1518,850,743,105,2,831,19,1678,828,487,344
35,"SUCEAVA",332,146539,,83,"FĂLTICENI / Şcoala Gimnazială ""Ioan Ciurea""",1,13826,"MUNICIPIUL FĂLTICENI",146539,835,469,437,32,0,459,10,915,446,309,150
35,"SUCEAVA",332,146539,,84,"FĂLTICENI / Şcoala Gimnazială ""Ioan Ciurea""",1,13826,"MUNICIPIUL FĂLTICENI",146539,1247,666,635,29,2,658,7,1376,710,380,278
35,"SUCEAVA",332,146539,,85,"FĂLTICENI / Şcoala Gimnazială ""Mihail Sadoveanu""",1,13826,"MUNICIPIUL FĂLTICENI",146539,1673,882,838,41,3,864,18,1848,966,517,347
35,"SUCEAVA",332,146539,,86,"FĂLTICENI / Şcoala Gimnazială ""Mihail Sadoveanu""",1,13826,"MUNICIPIUL FĂLTICENI",146539,1375,719,669,50,0,709,10,1521,802,440,269
35,"SUCEAVA",332,146539,,87,"FĂLTICENI / Şcoala Gimnazială ""Mihail Sadoveanu""",1,13826,"MUNICIPIUL FĂLTICENI",146539,1213,732,690,39,3,717,15,1336,604,431,286
35,"SUCEAVA",332,146539,,88,"FĂLTICENI / Şcoala Gimnazială ""Ion Irimiescu""",1,13826,"MUNICIPIUL FĂLTICENI",146539,1322,698,654,44,0,686,12,1453,755,389,297
35,"SUCEAVA",332,146539,,89,"FĂLTICENI / Şcoala Gimnazială ""Ion Irimiescu""",1,13826,"MUNICIPIUL FĂLTICENI",146539,1186,596,577,19,0,588,8,1306,710,341,247
35,"SUCEAVA",332,146539,,90,"FĂLTICENI / Grădiniţa cu program prelungit ""Dumbrava Minunată""",1,13826,"MUNICIPIUL FĂLTICENI",146539,1078,528,514,14,0,514,14,1195,667,320,194
35,"SUCEAVA",332,146539,,91,"FĂLTICENI / Grădiniţa cu program prelungit ""Dumbrava Minunată""",1,13826,"MUNICIPIUL FĂLTICENI",146539,1190,583,554,28,1,571,12,1311,728,350,221
35,"SUCEAVA",332,146539,,92,"FĂLTICENI / Grădiniţa cu program prelungit ""Dumbrava Minunată""",1,13826,"MUNICIPIUL FĂLTICENI",146539,921,560,503,37,20,552,8,1013,453,321,231
35,"SUCEAVA",332,146539,,93,"FĂLTICENI / Colegiul ""Vasile Lovinescu""",1,13826,"MUNICIPIUL FĂLTICENI",146539,1588,896,855,20,21,884,12,1748,852,593,291
35,"SUCEAVA",332,146539,,94,"FĂLTICENI / Colegiul ""Vasile Lovinescu""",1,13826,"MUNICIPIUL FĂLTICENI",146539,1518,865,828,36,1,847,18,1672,807,551,296
35,"SUCEAVA",332,146539,,95,"FĂLTICENI / Colegiul ""Vasile Lovinescu""",1,13826,"MUNICIPIUL FĂLTICENI",146539,1416,896,833,56,7,885,11,1554,658,457,428
35,"SUCEAVA",332,146539,,96,"FĂLTICENI / Şcoala Gimnazială ""Ioan Ciurea""- clădire Gheorghe Gafencu",1,13826,"MUNICIPIUL FĂLTICENI",146539,1522,887,862,24,1,883,4,1677,790,613,270
35,"SUCEAVA",332,146539,,97,"FĂLTICENI / Grădiniţa cu program normal Ţarna Mare",1,13826,"MUNICIPIUL FĂLTICENI",146539,380,241,222,16,3,240,1,421,180,145,95
35,"SUCEAVA",332,146539,,98,"FĂLTICENI / Grădiniţa cu program normal Ţarna Mică",1,13826,"MUNICIPIUL FĂLTICENI",146539,350,196,184,12,0,196,0,385,189,145,51
35,"SUCEAVA",332,146628,,99,"RĂDĂUŢI / PRIMARIA RADAUTI",1,13830,"MUNICIPIUL RĂDĂUŢI",146628,1925,1030,943,86,1,1011,19,2111,1081,410,601
35,"SUCEAVA",332,146628,,100,"RĂDĂUŢI / CASA DE CULTURA",1,13830,"MUNICIPIUL RĂDĂUŢI",146628,1724,1003,929,74,0,988,15,1892,889,493,495
35,"SUCEAVA",332,146628,,101,"RĂDĂUŢI / GALERIILE DE ARTA",1,13830,"MUNICIPIUL RĂDĂUŢI",146628,1813,918,838,79,1,894,24,2000,1082,396,498
35,"SUCEAVA",332,146628,,102,"RĂDĂUŢI / SCOALA GIMNAZIALA REGINA ELISABETA NR.4",1,13830,"MUNICIPIUL RĂDĂUŢI",146628,1923,1043,979,64,0,1023,20,2117,1074,430,593
35,"SUCEAVA",332,146628,,103,"RĂDĂUŢI / COLEGIUL TEHNIC",1,13830,"MUNICIPIUL RĂDĂUŢI",146628,1739,874,819,55,0,857,17,1916,1042,378,479
35,"SUCEAVA",332,146628,,104,"RĂDĂUŢI / COLEGIUL EUDOXIU HURMUZACHI",1,13830,"MUNICIPIUL RĂDĂUŢI",146628,1609,892,830,60,2,875,17,1771,879,426,449
35,"SUCEAVA",332,146628,,105,"RĂDĂUŢI / SCOALA GIMNAZIALA NR.5 BOGDAN VODA",1,13830,"MUNICIPIUL RĂDĂUŢI",146628,1506,843,809,33,1,825,18,1655,812,422,403
35,"SUCEAVA",332,146628,,106,"RĂDĂUŢI / GRADINITA NR.8",1,13830,"MUNICIPIUL RĂDĂUŢI",146628,1981,934,888,46,0,911,23,2183,1249,305,606
35,"SUCEAVA",332,146628,,107,"RĂDĂUŢI / CAMINUL DE PERSOANE VARSTNICE",1,13830,"MUNICIPIUL RĂDĂUŢI",146628,1813,844,804,38,2,825,19,1990,1146,379,446
35,"SUCEAVA",332,146628,,108,"RĂDĂUŢI / POLICLINICA",1,13830,"MUNICIPIUL RĂDĂUŢI",146628,1657,1003,799,38,166,988,15,1822,819,434,554
35,"SUCEAVA",332,146628,,109,"RĂDĂUŢI / SCOALA GIMNAZIALA NR.3 MIHAI EMINESCU",1,13830,"MUNICIPIUL RĂDĂUŢI",146628,1664,893,833,59,1,876,17,1823,930,370,506
35,"SUCEAVA",332,146628,,110,"RĂDĂUŢI / CRESA HIPODROM",1,13830,"MUNICIPIUL RĂDĂUŢI",146628,1919,1006,940,65,1,984,22,2109,1103,422,562
35,"SUCEAVA",332,146628,,111,"RĂDĂUŢI / SCOALA GIMNAZIALA NR.2",1,13830,"MUNICIPIUL RĂDĂUŢI",146628,1941,977,937,40,0,964,13,2131,1154,382,582
35,"SUCEAVA",332,146628,,112,"RĂDĂUŢI / SCOALA GIMNAZIALA GHEORGHE POPADIUC NR.1",1,13830,"MUNICIPIUL RĂDĂUŢI",146628,1523,724,701,23,0,718,6,1680,956,273,445
35,"SUCEAVA",332,146628,,113,"RĂDĂUŢI / GRADINITA CU PROGRAM PRELUNGIT PINOCHIO",1,13830,"MUNICIPIUL RĂDĂUŢI",146628,1649,828,793,35,0,806,22,1812,984,338,468
35,"SUCEAVA",332,146744,,114,"VATRA DORNEI / Casa de cultura "" Platon Pardau""",1,13832,"MUNICIPIUL VATRA DORNEI",146744,1427,1044,782,218,44,1030,14,1574,530,468,562
35,"SUCEAVA",332,146744,,115,"VATRA DORNEI / Hotel Bradul",1,13832,"MUNICIPIUL VATRA DORNEI",146744,955,901,536,365,0,887,14,1050,149,424,463
35,"SUCEAVA",332,146744,,116,"VATRA DORNEI / Hotel Intus",1,13832,"MUNICIPIUL VATRA DORNEI",146744,997,741,581,160,0,729,12,1094,353,366,363
35,"SUCEAVA",332,146744,,117,"VATRA DORNEI / Şcoala Generala nr.1- sectia A",1,13832,"MUNICIPIUL VATRA DORNEI",146744,1060,710,631,79,0,699,11,1162,452,291,408
35,"SUCEAVA",332,146744,,118,"VATRA DORNEI / Şcoala Generala nr.1+ sectia B",1,13832,"MUNICIPIUL VATRA DORNEI",146744,1499,1007,909,97,1,1002,5,1655,648,406,596
35,"SUCEAVA",332,146744,,119,"VATRA DORNEI / Căminul Cultural Roşu",1,13832,"MUNICIPIUL VATRA DORNEI",146744,549,364,323,41,0,360,4,604,240,136,224
35,"SUCEAVA",332,146744,,120,"VATRA DORNEI / Şcoala gimnazială nr.2- secţia A",1,13832,"MUNICIPIUL VATRA DORNEI",146744,938,568,523,45,0,561,7,1032,464,266,295
35,"SUCEAVA",332,146744,,121,"VATRA DORNEI / SCOALA GENERALA NR.2, SECTIA B",1,13832,"MUNICIPIUL VATRA DORNEI",146744,1242,744,712,32,0,739,5,1363,619,379,360
35,"SUCEAVA",332,146744,,122,"VATRA DORNEI / Gardinita cu program prelungit Scufita Rosie",1,13832,"MUNICIPIUL VATRA DORNEI",146744,1131,769,666,100,3,756,13,1247,478,368,388
35,"SUCEAVA",332,146744,,123,"VATRA DORNEI / gradinita cu program normal nr.5",1,13832,"MUNICIPIUL VATRA DORNEI",146744,1083,630,589,41,0,617,13,1189,559,244,373
35,"SUCEAVA",332,146744,,124,"VATRA DORNEI / Scoala generala nr.3,sectia A",1,13832,"MUNICIPIUL VATRA DORNEI",146744,1059,630,603,27,0,616,14,1167,537,232,384
35,"SUCEAVA",332,146744,,125,"VATRA DORNEI / Şcoala primară nr.3- secţia B",1,13832,"MUNICIPIUL VATRA DORNEI",146744,942,552,523,29,0,547,5,1044,492,290,257
35,"SUCEAVA",332,146744,,126,"VATRA DORNEI / Complex CFR Gara Mare",1,13832,"MUNICIPIUL VATRA DORNEI",146744,1136,741,664,77,0,722,19,1246,505,247,475
35,"SUCEAVA",332,146744,,127,"VATRA DORNEI / Scoala generala Argestru",1,13832,"MUNICIPIUL VATRA DORNEI",146744,535,339,307,32,0,329,10,589,250,141,188
35,"SUCEAVA",332,147358,,128,"HOLDA / Cămin Cultural Holda",1,13837,"ORAŞ BROŞTENI",147358,1025,625,602,23,0,620,5,1124,499,238,382
35,"SUCEAVA",332,147358,,129,"BROŞTENI / Primăria Broşteni",1,13837,"ORAŞ BROŞTENI",147358,826,488,453,35,0,480,8,904,416,215,265
35,"SUCEAVA",332,147358,,130,"BROŞTENI / Liceul Tehnologic ""Nicolai Nanu"" Broşteni",1,13837,"ORAŞ BROŞTENI",147358,1511,755,695,57,3,746,9,1664,909,398,348
35,"SUCEAVA",332,147358,,131,"BROŞTENI / SPITAL MEDICO SOCIAL CARMEN SYLVA",1,13837,"ORAŞ BROŞTENI",147358,453,257,238,19,0,255,2,501,244,144,111
35,"SUCEAVA",332,147358,,132,"COTÂRGAŞI / Şcoala Cotîrgaşi nr.1",1,13837,"ORAŞ BROŞTENI",147358,1052,622,602,20,0,616,6,1158,536,292,324
35,"SUCEAVA",332,147358,,133,"FRASIN / Gadinita sat Frasin, Brosteni",1,13837,"ORAŞ BROŞTENI",147358,415,292,264,28,0,289,3,456,164,178,111
35,"SUCEAVA",332,147358,,134,"DÂRMOXA / Şcoala Generală Dîrmoxa",1,13837,"ORAŞ BROŞTENI",147358,131,109,87,22,0,108,1,143,34,55,53
35,"SUCEAVA",332,147633,,135,"CAJVANA / camin cultural  Cajvana",1,13848,"ORAŞ CAJVANA",147633,1669,738,625,113,0,734,4,1833,1095,311,423
35,"SUCEAVA",332,147633,,136,"CAJVANA / liceul tehnologic cajvana",1,13848,"ORAŞ CAJVANA",147633,1821,706,670,35,1,705,1,2003,1297,248,457
35,"SUCEAVA",332,147633,,137,"CAJVANA / liceul tehnologic cajvana",1,13848,"ORAŞ CAJVANA",147633,1601,633,610,23,0,632,1,1758,1125,186,446
35,"SUCEAVA",332,147633,,138,"CAJVANA / GRADINITA CU PROGRAM NORMAL CAJVANA",1,13848,"ORAŞ CAJVANA",147633,1428,580,553,27,0,568,12,1568,988,187,381
35,"SUCEAVA",332,148006,,139,"DOLHASCA / Liceul Tehnologic ,,Oltea Doamna""",1,13851,"ORAŞ DOLHASCA",148006,1164,621,552,65,4,615,6,1282,661,321,294
35,"SUCEAVA",332,148006,,140,"DOLHASCA / Şcoala primară Dolhasca",1,13851,"ORAŞ DOLHASCA",148006,976,561,508,51,2,556,5,1065,504,323,233
35,"SUCEAVA",332,148006,,141,"DOLHASCA / Şcoala primară Sândeni",1,13851,"ORAŞ DOLHASCA",148006,748,411,378,33,0,404,7,828,417,219,185
35,"SUCEAVA",332,148006,,142,"POIANA / Şcoala primară Poiana",1,13851,"ORAŞ DOLHASCA",148006,388,220,199,21,0,219,1,426,206,118,101
35,"SUCEAVA",332,148006,,143,"GULIA / Şcoala gimnazială Gulia",1,13851,"ORAŞ DOLHASCA",148006,1653,1003,961,42,0,994,9,1820,817,824,170
35,"SUCEAVA",332,148006,,144,"PROBOTA / Şcoala gimnazială Probota",1,13851,"ORAŞ DOLHASCA",148006,1419,811,753,58,0,805,6,1565,754,538,267
35,"SUCEAVA",332,148006,,145,"POIENARI / Şcoala primară Poienari",1,13851,"ORAŞ DOLHASCA",148006,237,150,140,10,0,150,0,260,110,119,31
35,"SUCEAVA",332,148006,,146,"SILIŞTEA NOUĂ / Şcoala primară Siliştea",1,13851,"ORAŞ DOLHASCA",148006,590,350,315,35,0,345,5,651,301,229,116
35,"SUCEAVA",332,148006,,147,"BUDENI / Şcoala gimnazială Budeni",1,13851,"ORAŞ DOLHASCA",148006,1135,587,541,46,0,579,8,1250,663,413,166
35,"SUCEAVA",332,148006,,148,"VALEA POIENEI / Şcoala primară Valea Poienii",1,13851,"ORAŞ DOLHASCA",148006,433,257,235,22,0,251,6,480,223,141,110
35,"SUCEAVA",332,148612,,149,"FRASIN / PRIMĂRIA ORAŞULUI FRASIN",1,13860,"ORAŞ FRASIN",148612,1228,727,582,143,2,720,7,1350,623,336,384
35,"SUCEAVA",332,148612,,150,"FRASIN / ŞCOALA GIMNAZIALĂ FRASIN",1,13860,"ORAŞ FRASIN",148612,1201,552,529,23,0,542,10,1329,777,259,283
35,"SUCEAVA",332,148612,,151,"BUCŞOAIA / ŞCOALA GIMNAZIALĂ BUCŞOAIA",1,13860,"ORAŞ FRASIN",148612,1256,762,681,81,0,754,8,1378,616,329,425
35,"SUCEAVA",332,148612,,152,"DOROTEIA / ŞCOALA GIMNAZIALĂ DOROTEIA",1,13860,"ORAŞ FRASIN",148612,803,495,406,89,0,491,4,885,390,202,289
35,"SUCEAVA",332,148612,,153,"PLUTONIŢA / CĂMIN  CULTURAL PLUTONIŢA",1,13860,"ORAŞ FRASIN",148612,899,488,447,41,0,482,6,985,497,182,300
35,"SUCEAVA",332,146584,,154,"GURA HUMORULUI / MUZEUL OBICEIURILOR POPULARE GURA HUMORULUI",1,13865,"ORAŞ GURA HUMORULUI",146584,1668,1065,932,102,31,1046,19,1836,771,411,635
35,"SUCEAVA",332,146584,,155,"GURA HUMORULUI / GRADINITA CU PROGRAM NORMAL ""PINOCHIO""",1,13865,"ORAŞ GURA HUMORULUI",146584,1475,826,783,41,2,817,9,1613,787,368,449
35,"SUCEAVA",332,146584,,156,"GURA HUMORULUI / COLEGIUL ""ALEXANDRU CEL BUN""  CORPUL B",1,13865,"ORAŞ GURA HUMORULUI",146584,1999,1166,1094,58,14,1144,22,2203,1037,509,635
35,"SUCEAVA",332,146584,,157,"GURA HUMORULUI / SCOALA GIMNAZIALA NR.1",1,13865,"ORAŞ GURA HUMORULUI",146584,1990,1141,1055,80,6,1126,15,2179,1038,503,623
35,"SUCEAVA",332,146584,,158,"GURA HUMORULUI / SCOALA GIMNAZIALA ""PETRU COMARNESCU""",1,13865,"ORAŞ GURA HUMORULUI",146584,1703,1027,952,73,2,1014,13,1876,849,456,558
35,"SUCEAVA",332,146584,,159,"GURA HUMORULUI / COLEGIUL"" ALEXANDRU CEL BUN"" CORPUL A",1,13865,"ORAŞ GURA HUMORULUI",146584,1830,1046,969,73,4,1034,12,2004,958,470,564
35,"SUCEAVA",332,146584,,160,"GURA HUMORULUI / SCOALA GIMNAZIALA ""TEODOR BALAN""",1,13865,"ORAŞ GURA HUMORULUI",146584,1711,1009,951,48,10,989,20,1884,875,471,518
35,"SUCEAVA",332,146584,,161,"GURA HUMORULUI / SCOALA PRIMARA BOURENI",1,13865,"ORAŞ GURA HUMORULUI",146584,733,367,352,15,0,364,3,806,439,173,191
35,"SUCEAVA",332,146584,,162,"VORONEŢ / GRADINITA CU PROGRAM NORMAL  VORONET",1,13865,"ORAŞ GURA HUMORULUI",146584,652,511,415,96,0,499,12,717,206,162,337
35,"SUCEAVA",332,149227,,163,"LITENI / Casa de Cultură Liteni",1,13868,"ORAŞ LITENI",149227,1623,911,854,57,0,899,12,1783,872,412,487
35,"SUCEAVA",332,149227,,164,"LITENI / Corpul III Liceul Tehnologic Iorgu Vârnav Liteanu Liteni",1,13868,"ORAŞ LITENI",149227,1261,719,698,20,1,711,8,1387,668,362,349
35,"SUCEAVA",332,149227,,165,"LITENI / Corpul A Liceul Tehnologic Iorgu Vârnav Liteanu Liteni",1,13868,"ORAŞ LITENI",149227,924,495,468,26,1,490,5,1017,522,227,263
35,"SUCEAVA",332,149227,,166,"ROTUNDA / Şcoala Gimnazială nr. 1 Rotunda",1,13868,"ORAŞ LITENI",149227,1150,589,562,27,0,584,5,1268,679,328,256
35,"SUCEAVA",332,149227,,167,"ROTUNDA / Şcoala Primară nr. 2 Rotunda",1,13868,"ORAŞ LITENI",149227,615,332,318,14,0,326,6,677,345,175,151
35,"SUCEAVA",332,149227,,168,"ROŞCANI / Şcoala Gimnazială Roşcani",1,13868,"ORAŞ LITENI",149227,981,535,485,50,0,528,7,1079,544,251,277
35,"SUCEAVA",332,149227,,169,"CORNI / Şcoala Gimnazială Corni",1,13868,"ORAŞ LITENI",149227,669,362,335,25,2,357,5,737,375,201,156
35,"SUCEAVA",332,149227,,170,"SILIŞTEA / Şcoala Gimnazială Siliştea",1,13868,"ORAŞ LITENI",149227,649,356,331,25,0,350,6,716,360,143,207
35,"SUCEAVA",332,146931,,171,"MILIŞĂUŢI / Sediul primăriei Milişăuţi",1,13875,"ORAŞ MILIŞĂUŢI",146931,1522,788,755,32,1,778,10,1666,878,292,486
35,"SUCEAVA",332,146931,,172,"MILIŞĂUŢI / Căminul cultural Milişăuţi",1,13875,"ORAŞ MILIŞĂUŢI",146931,1579,800,775,25,0,788,12,1734,934,310,478
35,"SUCEAVA",332,146931,,173,"BĂDEUŢI / Căminul cultural Bădeuţi",1,13875,"ORAŞ MILIŞĂUŢI",146931,1229,667,625,41,1,655,12,1358,691,344,311
35,"SUCEAVA",332,146370,,174,"SALCEA / CĂMINUL  CULTURAL  SALCEA",1,13880,"ORAŞ SALCEA",146370,1148,577,552,25,0,569,8,1262,685,280,289
35,"SUCEAVA",332,146370,,175,"SALCEA / Căminul  Cultural Salcea",1,13880,"ORAŞ SALCEA",146370,1268,707,675,32,0,698,9,1391,684,311,387
35,"SUCEAVA",332,146370,,176,"PLOPENI / CAMIN CULTURAL PLOPENI",1,13880,"ORAŞ SALCEA",146370,1784,966,924,41,1,957,9,1966,1000,375,582
35,"SUCEAVA",332,146370,,177,"MERENI / ŞCOALA MERENI",1,13880,"ORAŞ SALCEA",146370,1082,537,498,39,0,523,14,1189,652,226,297
35,"SUCEAVA",332,146370,,178,"VĂRATEC / CĂMIN  CULTURAL  VĂRATEC",1,13880,"ORAŞ SALCEA",146370,1205,656,624,32,0,644,12,1325,669,269,375
35,"SUCEAVA",332,146370,,179,"PRELIPCA / CĂMINUL  CULTURAL  PRELIPCA",1,13880,"ORAŞ SALCEA",146370,1000,577,541,35,1,565,12,1099,522,217,348
35,"SUCEAVA",332,146655,,180,"SIRET / casa de cultura Siret",1,13886,"ORAŞ SIRET",146655,1254,703,656,43,4,688,15,1376,673,371,317
35,"SUCEAVA",332,146655,,181,"SIRET / LICEUL LATCU VODA SIRET",1,13886,"ORAŞ SIRET",146655,1462,735,721,14,0,721,14,1607,872,371,350
35,"SUCEAVA",332,146655,,182,"SIRET / grădinita",1,13886,"ORAŞ SIRET",146655,1332,622,594,28,0,608,14,1472,850,329,279
35,"SUCEAVA",332,146655,,183,"SIRET / şcoala profesională",1,13886,"ORAŞ SIRET",146655,762,350,326,24,0,339,11,834,484,185,154
35,"SUCEAVA",332,146655,,184,"SIRET / şcoala generală - corp II",1,13886,"ORAŞ SIRET",146655,1048,579,556,23,0,570,9,1149,570,274,296
35,"SUCEAVA",332,146655,,185,"SIRET / şcoala generală  - corp I",1,13886,"ORAŞ SIRET",146655,1277,706,611,31,64,686,20,1403,697,345,341
35,"SUCEAVA",332,146655,,186,"SIRET / şcoala generală Pădureni",1,13886,"ORAŞ SIRET",146655,467,290,277,13,0,285,5,508,218,185,100
35,"SUCEAVA",332,146655,,187,"SIRET / şcoala generală Mănăstioara",1,13886,"ORAŞ SIRET",146655,460,278,249,28,1,272,6,504,226,160,112
35,"SUCEAVA",332,146708,,188,"SOLCA / PRIMĂRIA ORAŞULUI SOLCA",1,13890,"ORAŞ SOLCA",146708,1050,630,552,58,20,623,7,1153,523,304,319
35,"SUCEAVA",332,146708,,189,"SOLCA / Liceul Tehnologic Tomşa Vodă Solca",1,13890,"ORAŞ SOLCA",146708,1029,610,571,39,0,604,6,1134,524,319,285
35,"SUCEAVA",332,151095,,190,"VICOVU DE SUS / Căminul cultural Vicovu de Sus-Est",1,13892,"ORAŞ VICOVU DE SUS",151095,1178,548,514,34,0,544,4,1303,755,283,261
35,"SUCEAVA",332,151095,,191,"VICOVU DE SUS / Grădiniţa cu program normal nr. 1-Est",1,13892,"ORAŞ VICOVU DE SUS",151095,1564,674,656,18,0,663,11,1746,1072,337,326
35,"SUCEAVA",332,151095,,192,"VICOVU DE SUS / Liceul Tehhnologic ""Ion Nistor"" Vicovu de Sus-Corpul 4",1,13892,"ORAŞ VICOVU DE SUS",151095,1867,966,880,72,14,959,7,2060,1094,472,487
35,"SUCEAVA",332,151095,,193,"VICOVU DE SUS / Şcoala gimnazială nr. 3 Vicovu de Sus",1,13892,"ORAŞ VICOVU DE SUS",151095,1277,581,557,24,0,578,3,1403,822,316,262
35,"SUCEAVA",332,151095,,194,"VICOVU DE SUS / Şcoala gimnazială nr. 2 Vicovu de Sus",1,13892,"ORAŞ VICOVU DE SUS",151095,1337,632,616,16,0,623,9,1471,839,432,191
35,"SUCEAVA",332,151095,,195,"VICOVU DE SUS / Şcoala gimnazială nr. 2 Vicovu de Sus",1,13892,"ORAŞ VICOVU DE SUS",151095,1676,804,787,17,0,796,8,1844,1040,507,289
35,"SUCEAVA",332,151095,,196,"BIVOLĂRIA / Şcoala gimnazială Bivolăria",1,13892,"ORAŞ VICOVU DE SUS",151095,1503,769,734,35,0,765,4,1618,849,281,484
35,"SUCEAVA",332,151095,,197,"BIVOLĂRIA / Grădiniţa Nouă Bivolărie",1,13892,"ORAŞ VICOVU DE SUS",151095,773,383,340,43,0,381,2,846,463,164,217
35,"SUCEAVA",332,146799,,198,"ADÂNCATA / SCOALA CU CLASELE I IV ADANCATA",3,13895,"ADÂNCATA",146799,1402,892,824,68,0,882,10,1545,653,319,563
35,"SUCEAVA",332,146799,,199,"ADÂNCATA / SCOALA CU CLASELE V VIII ADANCATA",3,13895,"ADÂNCATA",146799,985,630,582,48,0,624,6,1080,450,240,384
35,"SUCEAVA",332,146799,,200,"CĂLUGĂRENI / ŞCOALA CU CLASELE I-IV CĂLUGĂRENI",3,13895,"ADÂNCATA",146799,617,351,319,32,0,349,2,680,329,140,209
35,"SUCEAVA",332,146799,,201,"FETEŞTI / ŞCOALA CU CLASELE I-VIII FETEŞTI",3,13895,"ADÂNCATA",146799,431,279,244,35,0,277,2,475,196,122,155
35,"SUCEAVA",332,146860,,202,"ARBORE / Scoala gimnaziala nr. 1 ""Luca Arbure"", corp B",3,13899,"ARBORE",146860,1672,885,826,58,1,880,5,1844,959,332,548
35,"SUCEAVA",332,146860,,203,"ARBORE / Scoala gimnaziala nr.2 Arbore",3,13899,"ARBORE",146860,1649,836,801,35,0,820,16,1817,981,367,453
35,"SUCEAVA",332,146860,,204,"ARBORE / Scoala gimnaziala nr.3 Arbore",3,13899,"ARBORE",146860,1018,485,460,25,0,481,4,1122,637,171,310
35,"SUCEAVA",332,146860,,205,"CLIT / Scoala gimnaziala nr.4 Clit",3,13899,"ARBORE",146860,1029,548,512,36,0,547,1,1139,591,265,282
35,"SUCEAVA",332,146860,,206,"BODNĂRENI / Scoala gimnaziala nr.6 Bodnareni",3,13899,"ARBORE",146860,249,108,102,6,0,106,2,273,165,47,59
35,"SUCEAVA",332,146904,,207,"BAIA / SEDIUL PRIMARIEI BAIA",3,13903,"BAIA",146904,1723,840,808,32,0,831,9,1898,1058,567,264
35,"SUCEAVA",332,146904,,208,"BAIA / ŞCOALA NR. 2 BAIA",3,13903,"BAIA",146904,1132,598,581,17,0,587,11,1248,650,394,193
35,"SUCEAVA",332,146904,,209,"BAIA / ŞCOALA NR. 3 BAIA",3,13903,"BAIA",146904,1633,840,821,19,0,827,13,1799,959,582,245
35,"SUCEAVA",332,146904,,210,"BOGATA / Şcoala Bogata",3,13903,"BAIA",146904,1064,602,571,31,0,595,7,1169,567,460,135
35,"SUCEAVA",332,151530,,211,"BĂLĂCEANA / CĂMIN CULTURAL BALACEANA",3,13906,"BĂLĂCEANA",151530,1261,714,619,95,0,709,5,1382,668,454,255
35,"SUCEAVA",332,146995,,212,"BĂLCĂUŢI / Sediul Primăriei comunei Bălcăuţi",3,13908,"BĂLCĂUŢI",146995,1204,560,503,46,11,550,10,1325,765,332,218
35,"SUCEAVA",332,146995,,213,"NEGOSTINA / Şcoala cu clasele I VIII Negostina",3,13908,"BĂLCĂUŢI",146995,1073,598,547,51,0,594,4,1186,588,303,291
35,"SUCEAVA",332,146995,,214,"GROPENI / Şcoala cu clasele I IV Gropeni",3,13908,"BĂLCĂUŢI",146995,289,162,133,26,3,159,3,316,154,80,79
35,"SUCEAVA",332,151576,,215,"BERCHIŞEŞTI / Caminul Cultural Berchisesti",3,13912,"BERCHIŞEŞTI",151576,1799,1184,1075,101,8,1172,12,1982,798,631,541
35,"SUCEAVA",332,151576,,216,"CORLATA / Scoala primara Corlata",3,13912,"BERCHIŞEŞTI",151576,390,285,253,23,9,277,8,429,144,186,91
35,"SUCEAVA",332,147036,,217,"BILCA / PRIMARIA",3,13915,"BILCA",147036,1134,475,432,38,5,473,2,1250,775,197,276
35,"SUCEAVA",332,147036,,218,"BILCA / SCOALA GIMNAZIALA NR. 2",3,13915,"BILCA",147036,964,531,477,43,11,521,10,1063,532,223,298
35,"SUCEAVA",332,147036,,219,"BILCA / SCOALA PRIMARA NR. 3",3,13915,"BILCA",147036,855,430,398,32,0,424,6,936,506,217,207
35,"SUCEAVA",332,147054,,220,"BOGDĂNEŞTI / SCOALA GIMNAZIALĂ NR. 1",3,13917,"BOGDĂNEŞTI",147054,1958,1154,1050,104,0,1133,21,2151,997,765,368
35,"SUCEAVA",332,147054,,221,"BOGDĂNEŞTI / SCOALA GIMNAZIALĂ NR. 2",3,13917,"BOGDĂNEŞTI",147054,1251,699,638,61,0,688,11,1380,681,433,255
35,"SUCEAVA",332,147072,,222,"BOROAIA / camin cultural BOROAIA",3,13919,"BOROAIA",147072,869,549,436,112,1,542,7,962,413,350,192
35,"SUCEAVA",332,147072,,223,"BOROAIA / SCOALA NR. 2 BOROAIA",3,13919,"BOROAIA",147072,699,448,379,69,0,446,2,764,316,300,146
35,"SUCEAVA",332,147072,,224,"GIULEŞTI / CAMIN CULTURAL GIULESTI",3,13919,"BOROAIA",147072,449,259,236,23,0,254,5,497,238,146,108
35,"SUCEAVA",332,147072,,225,"BĂRĂŞTI / GRADINITA BARASTI",3,13919,"BOROAIA",147072,784,481,435,46,0,471,10,858,377,359,112
35,"SUCEAVA",332,147072,,226,"SĂCUŢA / SCOALA SACUTA",3,13919,"BOROAIA",147072,486,290,264,25,1,286,4,537,247,216,70
35,"SUCEAVA",332,147072,,227,"MOIŞA / SCOALA MOISA",3,13919,"BOROAIA",147072,559,326,283,43,0,322,4,615,289,235,87
35,"SUCEAVA",332,147134,,228,"BOSANCI / Caminul Cultural Bosanci",3,13925,"BOSANCI",147134,1068,472,442,30,0,469,3,1171,699,157,312
35,"SUCEAVA",332,147134,,229,"BOSANCI / Căminul Cultural Bosanci",3,13925,"BOSANCI",147134,1173,549,520,29,0,547,2,1294,745,160,387
35,"SUCEAVA",332,147134,,230,"BOSANCI / Şcoala generală clasele I-VIII Bosanci ,Vale",3,13925,"BOSANCI",147134,1277,538,510,28,0,526,12,1408,870,165,361
35,"SUCEAVA",332,147134,,231,"BOSANCI / Şcoală generală  Bosanci, deal",3,13925,"BOSANCI",147134,1817,802,765,37,0,788,14,1999,1197,233,555
35,"SUCEAVA",332,147134,,232,"CUMPĂRĂTURA / Şcoala primară Cumpărătura",3,13925,"BOSANCI",147134,271,151,114,37,0,150,1,299,148,43,107
35,"SUCEAVA",332,147161,,233,"BOTOŞANA / SCOALA GIMNAZIALA CU CLASELE I-VIII BOTOSANA",3,13928,"BOTOŞANA",147161,1026,581,560,21,0,578,3,1125,544,219,359
35,"SUCEAVA",332,147161,,234,"BOTOŞANA / CĂMIN CULTURAL BOTOŞANA",3,13928,"BOTOŞANA",147161,1070,648,612,33,3,648,0,1179,531,221,427
35,"SUCEAVA",332,147205,,235,"BREAZA / Caminul Cultural sat Breaza",3,13930,"BREAZA",147205,1317,774,705,46,23,766,8,1451,677,460,306
35,"SUCEAVA",332,147241,,236,"BRODINA / SEDIUL NOU AL PRIMARIEI  COMUNEI BRODINA",3,13934,"BRODINA",147241,1214,696,651,45,0,689,7,1328,632,285,404
35,"SUCEAVA",332,147241,,237,"BRODINA DE JOS / CENTRU DE ASISTENTA DUPA PROGRAMUL SCOLAR  TIP  AFTER SCHOOL",3,13934,"BRODINA",147241,659,322,298,24,0,322,0,729,407,140,182
35,"SUCEAVA",332,147241,,238,"FALCĂU / GRADINITA CU PROGRAM NORMAL FALCAU",3,13934,"BRODINA",147241,1052,637,574,63,0,631,6,1156,519,214,417
35,"SUCEAVA",332,147465,,239,"BUNEŞTI / PRIMARIA COMUNEI BUNESTI",3,13945,"BUNEŞTI",147465,542,322,294,28,0,318,4,593,271,164,154
35,"SUCEAVA",332,147465,,240,"PODENI / GRADINITA CU PROGRAM NORMAL  PODENI",3,13945,"BUNEŞTI",147465,433,257,231,26,0,254,3,478,221,140,114
35,"SUCEAVA",332,147465,,241,"PETIA / SCOALA GIMNAZIALA PETIA",3,13945,"BUNEŞTI",147465,641,322,302,20,0,321,1,706,384,188,133
35,"SUCEAVA",332,147465,,242,"UNCEŞTI / SCOALA UNCESTI",3,13945,"BUNEŞTI",147465,541,308,260,48,0,304,4,594,286,163,141
35,"SUCEAVA",332,151521,,243,"BURLA / CAMINUL CULTURAL BURLA - SALA MARE",3,13951,"BURLA",151521,1588,769,732,37,0,761,8,1747,978,392,369
35,"SUCEAVA",332,147526,,244,"PÎRTEŞTII DE SUS / CENTRUL DE AFACERI MULTICULTURAL CACICA",3,13953,"CACICA",147526,1533,1055,973,60,22,1038,17,1689,634,496,542
35,"SUCEAVA",332,147526,,245,"CACICA / ŞCOALA CACICA",3,13953,"CACICA",147526,1119,632,572,49,11,625,7,1234,602,340,285
35,"SUCEAVA",332,147526,,246,"SOLONEŢU NOU / ŞCOALA SOLONEŢU NOU",3,13953,"CACICA",147526,654,394,370,21,3,388,6,722,328,153,235
35,"SUCEAVA",332,147526,,247,"RUNCU / ŞCOALA  RUNCU",3,13953,"CACICA",147526,145,143,81,56,6,143,0,159,16,84,59
35,"SUCEAVA",332,147580,,248,"CALAFINDEŞTI / INSTITUTIE SALA DE SPORT-SALA A",3,13959,"CALAFINDEŞTI",147580,1013,576,548,28,0,560,16,1114,538,296,264
35,"SUCEAVA",332,147580,,249,"CALAFINDEŞTI / SALA DE SPORT  CALAFINDESTI- SALA B",3,13959,"CALAFINDEŞTI",147580,983,547,542,5,0,543,4,1080,533,305,238
35,"SUCEAVA",332,147580,,250,"BOTOŞANIŢA MARE / SCOALA CU CLASELE  I - IV BOTOŞANIŢA MARE",3,13959,"CALAFINDEŞTI",147580,278,184,159,25,0,183,1,304,120,141,42
35,"SUCEAVA",332,151503,,251,"CAPU CÂMPULUI / CAMINUL CULTURAL CAPU CAMPULUI",3,13962,"CAPU CÂMPULUI",151503,1891,1229,1156,73,0,1214,15,2089,860,634,580
35,"SUCEAVA",332,151451,,252,"CIOCĂNEŞTI / CASA DE CULTURA CIOCANESTI",3,13964,"CIOCĂNEŞTI",151451,898,612,582,29,1,609,3,990,378,204,405
35,"SUCEAVA",332,151451,,253,"BOTOŞ / CAMIN CULTURAL BOTOS",3,13964,"CIOCĂNEŞTI",151451,331,240,223,17,0,238,2,363,123,62,176
35,"SUCEAVA",332,151567,,254,"CIPRIAN PORUMBESCU / PRIMARIA COMUNEI CIPRIAN PORUMBESCU",3,13967,"CIPRIAN PORUMBESCU",151567,1508,862,797,65,0,855,7,1659,797,593,262
35,"SUCEAVA",332,147713,,255,"CÎRLIBABA NOUĂ / LOCAL AFTER SCHOOL",3,13969,"CÎRLIBABA",147713,1527,898,846,51,1,891,7,1679,781,308,583
35,"SUCEAVA",332,151433,,256,"COMĂNEŞTI / COMINUL CULTURAL COMANESTI",3,13976,"COMĂNEŞTI",151433,973,643,576,63,4,639,4,1072,429,300,339
35,"SUCEAVA",332,151433,,257,"HUMORENI / SCOALA GIMNAZIALA CU CLASELE I-VIII HUMORENI",3,13976,"COMĂNEŞTI",151433,844,490,456,33,1,483,7,932,442,226,257
35,"SUCEAVA",332,147786,,258,"CORNU LUNCII / SCOALA GIMNAZIALA CORNU LUNCII",3,13979,"CORNU LUNCII",147786,1031,611,532,60,19,605,6,1132,521,407,198
35,"SUCEAVA",332,147786,,259,"BĂIŞEŞTI / SCOALA GIMNAZIALA BAISESTI",3,13979,"CORNU LUNCII",147786,1175,787,722,49,16,773,14,1197,410,345,428
35,"SUCEAVA",332,147786,,260,"BRĂIEŞTI / SCOALA GIMNAZIALA BRAIESTI",3,13979,"CORNU LUNCII",147786,997,636,597,34,5,630,6,1100,464,265,365
35,"SUCEAVA",332,147786,,261,"DUMBRAVA / SCOALA PRIMARA DUMBRAVA",3,13979,"CORNU LUNCII",147786,425,227,211,11,5,225,2,465,238,144,81
35,"SUCEAVA",332,147786,,262,"SASCA NOUĂ / SCOALA SASCA NOUA",3,13979,"CORNU LUNCII",147786,184,115,102,13,0,112,3,199,84,76,36
35,"SUCEAVA",332,147786,,263,"SASCA MICĂ / SCOALA PRIMARA SASCA MICA",3,13979,"CORNU LUNCII",147786,584,622,276,42,304,600,22,746,124,507,93
35,"SUCEAVA",332,147786,,264,"ŞINCA / SCOALA SINCA",3,13979,"CORNU LUNCII",147786,149,105,84,15,6,105,0,166,61,91,14
35,"SUCEAVA",332,147786,,265,"SASCA MARE / SCOALA SASCA MARE",3,13979,"CORNU LUNCII",147786,519,329,281,31,17,323,6,572,243,243,80
35,"SUCEAVA",332,147786,,266,"PĂISENI / SCOALA PAISENI",3,13979,"CORNU LUNCII",147786,599,392,349,20,23,386,6,657,265,285,101
35,"SUCEAVA",332,151497,,267,"COŞNA / CAMINUL CULTURAL COSNA",3,13989,"COŞNA",151497,1240,902,832,59,11,901,1,1363,461,412,489
35,"SUCEAVA",332,147884,,268,"CRUCEA / PRIMĂRIA COMUNEI CRUCEA sală festivităţi",3,13995,"CRUCEA",147884,1277,755,709,45,1,747,8,1405,650,428,319
35,"SUCEAVA",332,147884,,269,"CHIRIL / CĂMIN CULTURAL CHIRIL",3,13995,"CRUCEA",147884,466,314,279,35,0,312,2,514,200,171,141
35,"SUCEAVA",332,147937,,270,"DĂRMĂNEŞTI / Grădiniţa Dărmăneşti",3,14000,"DĂRMĂNEŞTI",147937,946,550,497,53,0,543,7,1040,490,229,314
35,"SUCEAVA",332,147937,,271,"DĂRMĂNEŞTI / Şcoala Dărmăneşti",3,14000,"DĂRMĂNEŞTI",147937,828,512,456,56,0,507,5,910,398,226,281
35,"SUCEAVA",332,147937,,272,"MĂRIŢEI / Şcoala Măriţei",3,14000,"DĂRMĂNEŞTI",147937,1450,870,817,53,0,862,8,1595,725,335,527
35,"SUCEAVA",332,147937,,273,"CĂLINEŞTI / Şcoala Călineşti",3,14000,"DĂRMĂNEŞTI",147937,512,320,266,54,0,316,4,561,241,137,179
35,"SUCEAVA",332,147937,,274,"CĂLINEŞTI-VASILACHE / Şcoala Călineşti-Vasilache",3,14000,"DĂRMĂNEŞTI",147937,165,113,93,20,0,113,0,181,68,46,67
35,"SUCEAVA",332,147937,,275,"DĂNILA / Şcoala Dănila",3,14000,"DĂRMĂNEŞTI",147937,845,479,435,44,0,476,3,932,453,195,281
35,"SUCEAVA",332,148097,,276,"DOLHEŞTII-MARI / PRIMĂRIA DOLHEŞTI",3,14007,"DOLHEŞTI",148097,1442,885,816,69,0,878,7,1591,706,613,265
35,"SUCEAVA",332,148097,,277,"DOLHEŞTII MICI / ŞCOALA GIMNAZIALĂ DOLHEŞTII MICI",3,14007,"DOLHEŞTI",148097,995,597,529,68,0,589,8,1099,502,340,249
35,"SUCEAVA",332,148097,,278,"VALEA BOUREI / ŞCOALA PRIMARĂ VALEA BOUREI",3,14007,"DOLHEŞTI",148097,627,358,323,35,0,354,4,692,334,227,127
35,"SUCEAVA",332,148202,,279,"DORNA CANDRENILOR / CĂMINUL CULTURAL DORNA CANDRENILOR",3,14011,"DORNA CANDRENILOR",148202,1708,1115,1023,69,23,1098,17,1886,771,305,793
35,"SUCEAVA",332,148202,,280,"POIANA NEGRII / CĂMINUL CULTURAL POIANA NEGRII",3,14011,"DORNA CANDRENILOR",148202,766,504,469,34,1,500,4,838,334,112,388
35,"SUCEAVA",332,148131,,281,"DORNA-ARINI / Asociaţia ""Obştea Gura Negrii"" Dorna Arini  (Şcoala I-IV)",3,14015,"DORNA-ARINI",148131,507,335,307,28,0,331,4,559,224,132,199
35,"SUCEAVA",332,148131,,282,"COZĂNEŞTI / Cămin Cultural Cozăneşti",3,14015,"DORNA-ARINI",148131,1301,901,809,90,2,892,9,1430,529,396,496
35,"SUCEAVA",332,148131,,283,"RUSCA / Şcoala cu clasele I-IV sat Rusca, nr. 59A",3,14015,"DORNA-ARINI",148131,674,489,443,46,0,487,2,743,254,231,256
35,"SUCEAVA",332,148293,,284,"DORNEŞTI / Scoala gimnaziala Dornesti",3,14022,"DORNEŞTI",148293,1663,708,664,44,0,701,7,1825,1117,316,385
35,"SUCEAVA",332,148293,,285,"DORNEŞTI / Caminul Cultural Dornesti",3,14022,"DORNEŞTI",148293,1788,880,845,34,1,867,13,1965,1085,445,422
35,"SUCEAVA",332,148293,,286,"IAZ / Scoala primara Iaz",3,14022,"DORNEŞTI",148293,214,97,89,8,0,95,2,234,137,36,59
35,"SUCEAVA",332,148328,,287,"MĂZĂNĂEŞTI / PRIMARIA COMUNEI DRĂGOIEŞTI",3,14025,"DRĂGOIEŞTI",148328,471,283,260,23,0,278,5,517,234,138,140
35,"SUCEAVA",332,148328,,288,"DRĂGOIEŞTI / CĂMIN CULTURAL DRĂGOIEŞTI",3,14025,"DRĂGOIEŞTI",148328,1396,853,775,78,0,841,12,1541,688,535,306
35,"SUCEAVA",332,148328,,289,"LUCĂCEŞTI / CĂMIN CULTURAL LUCĂCEŞTI",3,14025,"DRĂGOIEŞTI",148328,212,160,131,29,0,159,1,231,71,87,72
35,"SUCEAVA",332,148382,,290,"DRĂGUŞENI / Primăria comunei Drăguşeni",3,14029,"DRĂGUŞENI",148382,1816,1049,875,93,81,1039,10,2002,953,787,252
35,"SUCEAVA",332,148382,,291,"BROŞTENI / Grădiniţa cu program normal Broşteni",3,14029,"DRĂGUŞENI",148382,300,215,171,44,0,213,2,330,115,175,38
35,"SUCEAVA",332,148426,,292,"DUMBRĂVENI / ATENEU UMBRAVENI",3,14033,"DUMBRĂVENI",148426,1444,864,786,78,0,852,12,1590,726,436,416
35,"SUCEAVA",332,148426,,293,"DUMBRĂVENI / GRUP SCOLAR",3,14033,"DUMBRĂVENI",148426,1803,966,913,53,0,952,14,1991,1025,482,470
35,"SUCEAVA",332,148426,,294,"DUMBRĂVENI / SCOALA TOLOACA",3,14033,"DUMBRĂVENI",148426,1718,908,862,46,0,898,10,1882,974,460,438
35,"SUCEAVA",332,148426,,295,"DUMBRĂVENI / SCOALA DEAL",3,14033,"DUMBRĂVENI",148426,1361,723,699,24,0,712,11,1492,769,391,321
35,"SUCEAVA",332,148426,,296,"SĂLĂGENI / SCOALA SALAGENI",3,14033,"DUMBRĂVENI",148426,393,199,169,30,0,196,3,432,233,118,78
35,"SUCEAVA",332,151488,,297,"FÂNTÂNA MARE / Scoala cu clasele I-IV Fantana Mare",3,14036,"FÂNTÂNA MARE",151488,837,487,450,37,0,476,11,922,435,334,142
35,"SUCEAVA",332,151488,,298,"COTU BĂII / Scoala cu clasele I-IV Cotu Baii",3,14036,"FÂNTÂNA MARE",151488,778,450,401,49,0,436,14,855,405,299,137
35,"SUCEAVA",332,151488,,299,"PRAXIA / Scoala cu clasele I-IV Praxia",3,14036,"FÂNTÂNA MARE",151488,140,96,73,23,0,94,2,153,57,42,52
35,"SUCEAVA",332,151488,,300,"SPĂTĂREŞTI / Scoala cu clasele I-IV Spătăreşti",3,14036,"FÂNTÂNA MARE",151488,378,230,203,27,0,228,2,413,183,140,88
35,"SUCEAVA",332,148453,,301,"FÎNTÎNELE / Căminul cultural Fîntînele",3,14041,"FÎNTÎNELE",148453,879,429,405,24,0,427,2,967,538,225,202
35,"SUCEAVA",332,148453,,302,"SLOBOZIA / Scoala din satul Slobozia",3,14041,"FÎNTÎNELE",148453,181,97,87,10,0,97,0,198,101,63,34
35,"SUCEAVA",332,148453,,303,"BĂNEŞTI / Căminul cultural Băneşti",3,14041,"FÎNTÎNELE",148453,940,537,496,41,0,525,12,1032,495,256,269
35,"SUCEAVA",332,148453,,304,"STAMATE / Căminul cultural Stamate",3,14041,"FÎNTÎNELE",148453,1541,797,752,45,0,789,8,1695,898,452,337
35,"SUCEAVA",332,148453,,305,"COTU DOBEI / Scoala din satul Cotu Dobei",3,14041,"FÎNTÎNELE",148453,153,109,88,21,0,109,0,167,58,78,31
35,"SUCEAVA",332,148514,,306,"FORĂŞTI / Sediul  Primariei   Forasti",3,14047,"FORĂŞTI",148514,522,323,280,22,21,318,5,576,253,218,100
35,"SUCEAVA",332,148514,,307,"ANTOCENI / Scoala Antoceni",3,14047,"FORĂŞTI",148514,285,194,157,24,13,191,3,315,121,146,45
35,"SUCEAVA",332,148514,,308,"ONICENI / Scoala gimnaziala Oniceni",3,14047,"FORĂŞTI",148514,804,528,443,69,16,524,4,881,353,388,136
35,"SUCEAVA",332,148514,,309,"ROŞIORI / Scoala Rosiori",3,14047,"FORĂŞTI",148514,304,211,180,26,5,210,1,334,123,147,63
35,"SUCEAVA",332,148514,,310,"RUŞI / Scoala primara Rusi",3,14047,"FORĂŞTI",148514,335,217,194,18,5,211,6,371,154,166,45
35,"SUCEAVA",332,148514,,311,"ŢOLEŞTI / Scoala Tolesti",3,14047,"FORĂŞTI",148514,350,202,162,19,21,198,4,387,185,171,27
35,"SUCEAVA",332,148514,,312,"BOURA / Scoala primara Boura",3,14047,"FORĂŞTI",148514,482,308,271,21,16,308,0,534,226,243,65
35,"SUCEAVA",332,148514,,313,"MANOLEA / SEDIUL FOSTEI  PRIMARII MANOLEA",3,14047,"FORĂŞTI",148514,479,323,241,75,7,320,3,527,204,251,69
35,"SUCEAVA",332,148514,,314,"UIDEŞTI / Scoala primara Uidesti",3,14047,"FORĂŞTI",148514,139,117,90,27,0,117,0,154,37,108,9
35,"SUCEAVA",332,148514,,315,"MANOLEA / SCOALA VIISOARA, CATUN VIISOARA",3,14047,"FORĂŞTI",148514,168,137,100,37,0,132,5,185,48,90,42
35,"SUCEAVA",332,148667,,316,"FRĂTĂUŢII NOI / CĂMINUL CULTURAL FRĂTĂUŢII NOI",3,14057,"FRĂTĂUŢII NOI",148667,1210,640,606,33,1,633,7,1333,693,321,312
35,"SUCEAVA",332,148667,,317,"FRĂTĂUŢII NOI / ŞCOALA GIMNAZIALĂ NR 2 FRĂTĂUŢII NOI",3,14057,"FRĂTĂUŢII NOI",148667,1449,503,480,23,0,490,13,1594,1091,251,239
35,"SUCEAVA",332,148667,,318,"FRĂTĂUŢII NOI / GRADINITA CU PROGRAM NORMAL NR 3 FRĂTĂUŢII NOI",3,14057,"FRĂTĂUŢII NOI",148667,381,218,188,29,1,216,2,420,202,95,121
35,"SUCEAVA",332,148667,,319,"COSTIŞA / CĂMIN CULTURAL COSTIŞA",3,14057,"FRĂTĂUŢII NOI",148667,771,343,322,20,1,338,5,848,505,143,195
35,"SUCEAVA",332,148667,,320,"COSTIŞA / GRĂDINIŢA CU PROGRAM NORMAL NR 2 COSTIŞA",3,14057,"FRĂTĂUŢII NOI",148667,507,250,239,11,0,241,9,557,307,156,85
35,"SUCEAVA",332,148694,,321,"FRĂTĂUŢII VECHI / CAMIN CULTURAL FRATAUTII VECHI",3,14060,"FRĂTĂUŢII VECHI",148694,1316,541,508,33,0,533,8,1443,902,213,320
35,"SUCEAVA",332,148694,,322,"FRĂTĂUŢII VECHI / SCOALA CU CLASELE 1-4 FRATAUTII VECHI",3,14060,"FRĂTĂUŢII VECHI",148694,965,416,390,26,0,415,1,1051,635,190,225
35,"SUCEAVA",332,148694,,323,"MĂNEUŢI / CAMIN CULTURAL MĂNEUŢI",3,14060,"FRĂTĂUŢII VECHI",148694,1604,610,588,21,1,606,4,1762,1152,275,331
35,"SUCEAVA",332,148729,,324,"FRUMOSU / PRIMARIA FRUMOSU",3,14063,"FRUMOSU",148729,1844,1168,1134,32,2,1164,4,2032,864,436,728
35,"SUCEAVA",332,148729,,325,"DEIA / SCOALA GENERALA CU CLASELE I-IV DEIA",3,14063,"FRUMOSU",148729,686,468,445,18,5,465,3,755,287,154,311
35,"SUCEAVA",332,148729,,326,"DRAGOŞA / SCOALA DRAGOSA",3,14063,"FRUMOSU",148729,340,209,194,15,0,208,1,373,164,91,117
35,"SUCEAVA",332,148765,,327,"FUNDU MOLDOVEI / ŞCOALA GIMNAZIALĂ""DIMITRIE GUSTI""",3,14067,"FUNDU MOLDOVEI",148765,1587,1045,986,59,0,1036,9,1748,703,320,716
35,"SUCEAVA",332,148765,,328,"COLACU / CĂMINUL CULTURAL COLACU",3,14067,"FUNDU MOLDOVEI",148765,834,594,567,26,1,587,7,920,326,226,361
35,"SUCEAVA",332,148765,,329,"BOTUŞ / ŞCOALA GIMNAZIALĂ BOTUŞ",3,14067,"FUNDU MOLDOVEI",148765,1037,597,561,36,0,593,4,1143,546,184,409
35,"SUCEAVA",332,148872,,330,"GĂLĂNEŞTI / Şcoala primară din satul Gălăneşti",3,14078,"GĂLĂNEŞTI",148872,1352,588,555,33,0,577,11,1495,907,330,247
35,"SUCEAVA",332,148872,,331,"HURJUIENI / Şcoala primară din satul Hurjuieni",3,14078,"GĂLĂNEŞTI",148872,875,359,346,13,0,352,7,961,602,193,159
35,"SUCEAVA",332,148916,,332,"GRĂMEŞTI / CĂMIN CULTURAL GRĂMEŞTI",3,14081,"GRĂMEŞTI",148916,1673,930,855,64,11,921,9,1846,916,492,429
35,"SUCEAVA",332,148916,,333,"BĂLINEŞTI / ŞC.GEN. BĂLINEŞTI",3,14081,"GRĂMEŞTI",148916,569,318,288,28,2,315,3,626,308,239,76
35,"SUCEAVA",332,148916,,334,"BOTOŞANIŢA MICĂ / ŞC.GEN. BOTOŞENIŢA-MICĂ",3,14081,"GRĂMEŞTI",148916,189,131,114,17,0,131,0,208,77,117,14
35,"SUCEAVA",332,148970,,335,"GRĂNICEŞTI / Şcoala Gimnazială ""Mihail Sadoveanu"" Grăniceşti",3,14087,"GRĂNICEŞTI",148970,896,438,416,22,0,436,2,987,549,196,240
35,"SUCEAVA",332,148970,,336,"GRĂNICEŞTI / SCOALA GIMNAZIALA MIHAIL SADOVEANU GRANICESTI",3,14087,"GRĂNICEŞTI",148970,825,377,351,26,0,373,4,906,529,162,211
35,"SUCEAVA",332,148970,,337,"DUMBRAVA / Şcoala Primară Dumbrava",3,14087,"GRĂNICEŞTI",148970,326,165,140,25,0,163,2,358,193,63,100
35,"SUCEAVA",332,148970,,338,"GURA SOLCII / Şcoala Gimnazială Gura Solcii",3,14087,"GRĂNICEŞTI",148970,535,238,218,20,0,235,3,591,353,171,64
35,"SUCEAVA",332,148970,,339,"IACOBEŞTI / Şcoala Primară Iacobeşti",3,14087,"GRĂNICEŞTI",148970,429,243,204,39,0,240,3,473,230,93,147
35,"SUCEAVA",332,148970,,340,"ROMÂNEŞTI / Şcoala Gimnazială Româneşti",3,14087,"GRĂNICEŞTI",148970,505,307,271,36,0,304,3,551,244,181,123
35,"SUCEAVA",332,148970,,341,"SLOBOZIA SUCEVEI / Şcoala Primară Slobozia Sucevei",3,14087,"GRĂNICEŞTI",148970,518,264,230,34,0,264,0,570,306,89,175
35,"SUCEAVA",332,151512,,342,"HĂNŢEŞTI / SCOALA GIMNAZIALA HANTESTI",3,14094,"HĂNŢEŞTI",151512,1399,834,780,45,9,824,10,1538,704,518,306
35,"SUCEAVA",332,151512,,343,"HĂNŢEŞTI / SCOALA PRIMARA NR.2 HANTESTI VALE",3,14094,"HĂNŢEŞTI",151512,1132,647,616,28,3,632,15,1245,598,403,229
35,"SUCEAVA",332,151512,,344,"ARŢARI / Şcoala  primară Bereşti",3,14094,"HĂNŢEŞTI",151512,482,287,250,37,0,285,2,529,242,160,125
35,"SUCEAVA",332,151549,,345,"HÂRTOP / Clădire administrativă",3,14098,"HÂRTOP",151549,1088,580,564,16,0,572,8,1197,617,362,210
35,"SUCEAVA",332,151549,,346,"HÂRTOP / Clădire administrativă",3,14098,"HÂRTOP",151549,853,460,446,14,0,455,5,941,481,326,129
35,"SUCEAVA",332,149101,,347,"HORODNIC DE JOS / Căminul Cultural Horodnic de Jos",3,14100,"HORODNIC DE JOS",149101,1329,691,665,25,1,678,13,1461,770,272,406
35,"SUCEAVA",332,149101,,348,"HORODNIC DE JOS / SCOALA PRIMARĂ VASILE ŢIGĂNESCU",3,14100,"HORODNIC DE JOS",149101,648,336,319,17,0,330,6,714,378,125,205
35,"SUCEAVA",332,151479,,349,"HORODNIC DE SUS / SCOALA GIMNAZIALA NR.2",3,14102,"HORODNIC DE SUS",151479,1076,550,507,43,0,538,12,1181,631,214,324
35,"SUCEAVA",332,151479,,350,"HORODNIC DE SUS / SALA DE SPORT",3,14102,"HORODNIC DE SUS",151479,1691,863,813,50,0,851,12,1858,995,370,481
35,"SUCEAVA",332,151479,,351,"HORODNIC DE SUS / SCOALA GIMNAZIALA NR.3",3,14102,"HORODNIC DE SUS",151479,1017,482,464,18,0,475,7,1119,637,259,216
35,"SUCEAVA",332,149049,,352,"HORODNICENI / PRIMĂRIA COMUNEI HORODNICENI",3,14104,"HORODNICENI",149049,913,649,571,71,7,644,5,1008,359,290,354
35,"SUCEAVA",332,149049,,353,"BOTEŞTI / ŞCOALA CU CL.I-IV BOTEŞTI",3,14104,"HORODNICENI",149049,392,281,231,50,0,276,5,431,150,120,156
35,"SUCEAVA",332,149049,,354,"BRĂDĂŢEL / ŞCOALA CU CL.I-IV BRĂDĂŢEL",3,14104,"HORODNICENI",149049,429,268,244,23,1,266,2,473,205,121,145
35,"SUCEAVA",332,149049,,355,"MIHĂIEŞTI / ŞCOALA CU CL.I-VIII MIHĂIEŞTI",3,14104,"HORODNICENI",149049,623,446,408,38,0,442,4,685,239,227,215
35,"SUCEAVA",332,149049,,356,"ROTOPĂNEŞTI / PUNCT DOCUMENTAR NICOALE ISTRATI",3,14104,"HORODNICENI",149049,582,308,292,15,1,305,3,644,336,179,126
35,"SUCEAVA",332,149138,,357,"IACOBENI / LICEUL TEHNOLOGIC LIVIU SUHAR IACOBENI CORP B str REPUBLICII NR 87 com IACOBENI Judetul SUCEAVA",3,14110,"IACOBENI",149138,971,615,579,25,11,609,6,1074,459,221,388
35,"SUCEAVA",332,149138,,358,"MESTECĂNIŞ / CLUBUL FERMIERILOR MESTECANIS Str Fermierilor nr 14 Sat Mestecanis Comuna Iacobeni Judetul Suceava",3,14110,"IACOBENI",149138,258,179,157,21,1,176,3,279,100,80,96
35,"SUCEAVA",332,149138,,359,"IACOBENI / LICEUL TEHNOLOGIC LIVIU SUHAR IACOBENI   CORP A   STR.   MINELOR nr 17 Comuna Iacobeni Judetul Suceava",3,14110,"IACOBENI",149138,615,375,345,24,6,372,3,680,305,183,189
35,"SUCEAVA",332,151442,,360,"IASLOVĂŢ / Sala Mică a Căminului Cultural Iaslovăţ",3,14113,"IASLOVĂŢ",151442,1493,647,629,18,0,635,12,1642,995,311,324
35,"SUCEAVA",332,151442,,361,"IASLOVĂŢ / Şcoala Nr. 2 Iaslovăţ",3,14113,"IASLOVĂŢ",151442,1400,580,566,14,0,574,6,1540,960,258,316
35,"SUCEAVA",332,147660,,362,"ILIŞEŞTI / PRIMARIA ILISESTI",3,14115,"ILIŞEŞTI",147660,1873,1091,998,81,12,1075,16,2061,970,489,586
35,"SUCEAVA",332,147660,,363,"BRAŞCA / CAMIN CULTURAL BRASCA",3,14115,"ILIŞEŞTI",147660,305,206,172,30,4,202,4,333,127,76,126
35,"SUCEAVA",332,146281,,364,"IPOTEŞTI / Şcoala Generală cu clasele I - VIII Ipoteşti",3,14118,"IPOTEŞTI",146281,1228,692,642,50,0,687,5,1353,661,185,502
35,"SUCEAVA",332,146281,,365,"IPOTEŞTI / Fosta Grădiniţă nr. 2 Ipoteşti",3,14118,"IPOTEŞTI",146281,1205,736,688,48,0,730,6,1326,590,180,550
35,"SUCEAVA",332,146281,,366,"IPOTEŞTI / Şcoala cu clasele I - IV Ipoteşti",3,14118,"IPOTEŞTI",146281,1085,553,531,22,0,547,6,1197,644,162,385
35,"SUCEAVA",332,146281,,367,"TIŞĂUŢI / Şcoala Generală clasele I-IV Tişăuţi",3,14118,"IPOTEŞTI",146281,901,561,513,48,0,558,3,989,428,243,315
35,"SUCEAVA",332,146281,,368,"LISAURA / Şcoala Generală clasele I-IV Lisaura",3,14118,"IPOTEŞTI",146281,786,495,460,35,0,490,5,862,367,204,286
35,"SUCEAVA",332,149183,,369,"IZVOARELE SUCEVEI / Primaria Izvoarele Sucevei",3,14122,"IZVOARELE SUCEVEI",149183,732,390,356,33,1,388,2,802,412,171,217
35,"SUCEAVA",332,149183,,370,"BOBEICA / Scoala I-IV Bobeica",3,14122,"IZVOARELE SUCEVEI",149183,358,169,157,12,0,169,0,394,225,38,131
35,"SUCEAVA",332,149183,,371,"BRODINA / Scoala I-VII Brodina",3,14122,"IZVOARELE SUCEVEI",149183,584,317,273,44,0,313,4,646,329,116,197
35,"SUCEAVA",332,149290,,372,"MARGINEA / Scoala cu clasele I-VIII nr. 2 Marginea",3,14136,"MARGINEA",149290,1605,737,696,41,0,724,13,1761,1024,218,506
35,"SUCEAVA",332,149290,,373,"MARGINEA / Liceul Tehnologic Vasile Gherasim Marginea",3,14136,"MARGINEA",149290,1514,716,651,65,0,709,7,1667,951,283,426
35,"SUCEAVA",332,149290,,374,"MARGINEA / Liceul Tehnologic Vasile Gherasim Marginea",3,14136,"MARGINEA",149290,1458,700,671,27,2,685,15,1599,899,267,418
35,"SUCEAVA",332,149290,,375,"MARGINEA / Caminul Cultural Marginea",3,14136,"MARGINEA",149290,1649,764,726,38,0,754,10,1821,1057,342,412
35,"SUCEAVA",332,149290,,376,"MARGINEA / Scoala cu clasele I-VIII nr. 3 Marginea",3,14136,"MARGINEA",149290,1650,806,736,70,0,794,12,1814,1008,353,441
35,"SUCEAVA",332,149316,,377,"MĂLINI / PRIMARIA MALINI",3,14126,"MĂLINI",149316,1303,794,727,67,0,788,6,1433,639,551,237
35,"SUCEAVA",332,149316,,378,"MĂLINI / SCOALA GENERALA NR.2 MALINI",3,14126,"MĂLINI",149316,1474,883,832,50,1,876,7,1618,735,663,213
35,"SUCEAVA",332,149316,,379,"PÎRAIE / SCOALA GIMNAZIALA  PIRAIE",3,14126,"MĂLINI",149316,1519,869,836,33,0,858,11,1672,803,586,272
35,"SUCEAVA",332,149316,,380,"POIANA MĂRULUI / SCOALA GIMNAZIALA POIANA MARULUI",3,14126,"MĂLINI",149316,1041,619,582,37,0,614,5,1148,529,499,115
35,"SUCEAVA",332,149316,,381,"VĂLENI-STÎNIŞOARA / SCOALA GIMNAZIALA VALENI-STANISOARA",3,14126,"MĂLINI",149316,669,457,428,29,0,456,1,738,281,374,82
35,"SUCEAVA",332,149370,,382,"MĂNĂSTIREA HUMORULUI / ŞCOALA GIMNAZIALĂ MĂNĂSTIREA HUMORULUI",3,14132,"MĂNĂSTIREA HUMORULUI",149370,937,620,557,63,0,617,3,1034,414,164,453
35,"SUCEAVA",332,149370,,383,"MĂNĂSTIREA HUMORULUI / ŞCOALA GIMNAZIALĂ MĂNĂSTIREA HUMORULUI",3,14132,"MĂNĂSTIREA HUMORULUI",149370,1044,579,524,55,0,574,5,1143,564,115,459
35,"SUCEAVA",332,149370,,384,"PLEŞA / CASA POLONĂ ""DOM POLSKI""",3,14132,"MĂNĂSTIREA HUMORULUI",149370,170,78,70,8,0,77,1,187,109,14,63
35,"SUCEAVA",332,149370,,385,"POIANA MICULUI / ŞCOALA GIMNAZIALĂ ""KRYSTINA BOCHENEK"" POIANA MICULUI",3,14132,"MĂNĂSTIREA HUMORULUI",149370,446,300,252,48,0,299,1,490,190,30,269
35,"SUCEAVA",332,149370,,386,"POIANA MICULUI / FOSTA ""ŞCOALĂ PRIMARĂ NR. .1 POIANA MICULUI""",3,14132,"MĂNĂSTIREA HUMORULUI",149370,360,177,153,24,0,176,1,398,221,79,97
35,"SUCEAVA",332,146325,,387,"MITOCU DRAGOMIRNEI / Caminul Cultural al comunei Mitocu Dragomirnei",3,14138,"MITOCU DRAGOMIRNEI",146325,1173,703,624,79,0,690,13,1235,532,285,405
35,"SUCEAVA",332,146325,,388,"MITOCU DRAGOMIRNEI / Grădiniţa cu program normal nr. 1",3,14138,"MITOCU DRAGOMIRNEI",146325,1459,927,851,76,0,908,19,1623,696,389,519
35,"SUCEAVA",332,146325,,389,"MITOCAŞI / ŞCOALA PRIMARĂ ""ION  CREANGĂ"" MITOCAŞI",3,14138,"MITOCU DRAGOMIRNEI",146325,663,398,368,29,1,393,5,733,335,197,196
35,"SUCEAVA",332,146325,,390,"LIPOVENI / ŞCOALA PRIMARĂ LIPOVENI",3,14138,"MITOCU DRAGOMIRNEI",146325,380,232,197,35,0,230,2,419,187,101,129
35,"SUCEAVA",332,149414,,391,"MOARA NICA / PRIMARIE",3,14143,"MOARA",149414,1317,651,602,49,0,643,8,1447,796,225,418
35,"SUCEAVA",332,149414,,392,"MOARA NICA / SCOALA GENERALA MOARA NICA",3,14143,"MOARA",149414,922,495,458,37,0,490,5,1010,515,155,335
35,"SUCEAVA",332,149414,,393,"MOARA CARP / SCOALA GENERALA MOARA CARP",3,14143,"MOARA",149414,706,356,335,21,0,351,5,771,415,134,217
35,"SUCEAVA",332,149414,,394,"FRUMOASA / SCOALA GNERALA FUMOASA",3,14143,"MOARA",149414,177,100,78,22,0,100,0,195,95,36,64
35,"SUCEAVA",332,149414,,395,"LITENI / CAMIN CULTUAL LITENI",3,14143,"MOARA",149414,723,474,415,59,0,471,3,799,325,190,281
35,"SUCEAVA",332,149414,,396,"VORNICENII MARI / SCOALA GENERALA VORNICENII MARI",3,14143,"MOARA",149414,234,143,122,21,0,141,2,257,114,78,63
35,"SUCEAVA",332,149502,,397,"MOLDOVA-SULIŢA / Primăria com Moldova Suliţa",3,14152,"MOLDOVA-SULIŢA",149502,1040,520,493,26,1,513,7,1142,622,212,301
35,"SUCEAVA",332,149502,,398,"BENIA / Şcoala primară Benia",3,14152,"MOLDOVA-SULIŢA",149502,546,320,300,20,0,317,3,605,285,103,214
35,"SUCEAVA",332,149539,,399,"MOLDOVIŢA / SALA DE SPECTACOLE",3,14155,"MOLDOVIŢA",149539,1872,1109,1023,86,0,1094,15,2065,956,338,756
35,"SUCEAVA",332,149539,,400,"ARGEL / ŞCOALA GENERALĂ DE 8 ANI ARGEL",3,14155,"MOLDOVIŢA",149539,802,452,437,15,0,448,4,881,429,123,325
35,"SUCEAVA",332,149539,,401,"DEMACUŞA / ŞCOALAGENERALĂ DE 4 ANI DEMACUŞA",3,14155,"MOLDOVIŢA",149539,815,480,469,11,0,478,2,898,418,180,298
35,"SUCEAVA",332,149539,,402,"RAŞCA / ŞCOALA GENERALĂ DE 4 ANI RAŞCA",3,14155,"MOLDOVIŢA",149539,641,392,377,15,0,391,1,708,316,96,295
35,"SUCEAVA",332,149584,,403,"BAINEŢ / Căminul cultural Baineţ",3,14160,"MUŞENIŢA",149584,255,169,134,27,8,166,3,282,113,110,56
35,"SUCEAVA",332,149584,,404,"CLIMĂUŢI / Căminul cultural Climăuţi",3,14160,"MUŞENIŢA",149584,317,184,151,23,10,181,3,353,169,100,81
35,"SUCEAVA",332,149584,,405,"VICŞANI / Clădirea ""Dom Polski"" Vicşani",3,14160,"MUŞENIŢA",149584,202,135,109,26,0,134,1,224,89,67,67
35,"SUCEAVA",332,149584,,406,"MUŞENIŢA / Şcoala cu cl.I-IV Muşeniţa",3,14160,"MUŞENIŢA",149584,310,174,157,14,3,171,3,342,168,105,66
35,"SUCEAVA",332,149584,,407,"VĂŞCĂUŢI / Căminul Cultural Văşcăuţi",3,14160,"MUŞENIŢA",149584,486,271,240,19,12,266,5,537,266,127,139
35,"SUCEAVA",332,149655,,408,"OSTRA / SCOALA   GIMNAZIALA  OSTRA",3,14167,"OSTRA",149655,1881,993,961,27,5,979,14,2075,1082,688,291
35,"SUCEAVA",332,149655,,409,"OSTRA / CAMIN CULTURAL VECHI NR.471",3,14167,"OSTRA",149655,599,365,339,22,4,365,0,661,296,235,130
35,"SUCEAVA",332,149682,,410,"PANACI / Căminul Cultural Panaci",3,14173,"PANACI",149682,663,480,445,33,2,475,5,736,256,230,245
35,"SUCEAVA",332,149682,,411,"COVERCA / SCOALA CU CLASELE I-IV COVERCA",3,14173,"PANACI",149682,660,458,423,25,10,454,4,729,271,175,279
35,"SUCEAVA",332,149682,,412,"PĂLTINIŞ / Şcoala cu clasele I-IV Păltiniş",3,14173,"PANACI",149682,237,155,140,15,0,153,2,262,107,49,104
35,"SUCEAVA",332,149682,,413,"GLODU / camin cultural glodu",3,14173,"PANACI",149682,316,193,167,26,0,192,1,353,160,100,92
35,"SUCEAVA",332,149753,,414,"PĂLTINOASA / Căminul cultural Păltinoasa",3,14170,"PĂLTINOASA",149753,1233,803,754,49,0,798,5,1354,551,347,451
35,"SUCEAVA",332,149753,,415,"PĂLTINOASA / Şcoala Gimnazială Păltinoasa",3,14170,"PĂLTINOASA",149753,1322,798,764,34,0,789,9,1455,657,449,340
35,"SUCEAVA",332,149753,,416,"CAPU CODRULUI / Căminul cultural Capu Codrului",3,14170,"PĂLTINOASA",149753,917,561,537,24,0,555,6,1013,452,362,193
35,"SUCEAVA",332,149753,,417,"CAPU CODRULUI / Şcoala Gimnazială Bogdan Vodă Capu Codrului",3,14170,"PĂLTINOASA",149753,1176,650,627,23,0,641,9,1291,641,402,239
35,"SUCEAVA",332,149833,,418,"PĂTRĂUŢI / Primaria comunei Patrauti",3,14180,"PĂTRĂUŢI",149833,1923,958,895,63,0,948,10,2112,1154,395,553
35,"SUCEAVA",332,149833,,419,"PĂTRĂUŢI / Caminul cultural vechi Patrauti",3,14180,"PĂTRĂUŢI",149833,1656,856,827,29,0,841,15,1824,968,569,272
35,"SUCEAVA",332,149780,,420,"PÎRTEŞTII DE JOS / CĂMINUL CULTURAL",3,14182,"PÎRTEŞTII DE JOS",149780,1574,930,841,67,22,919,11,1735,805,460,459
35,"SUCEAVA",332,149780,,421,"DELENI / ŞCOALA DELENI",3,14182,"PÎRTEŞTII DE JOS",149780,551,370,301,63,6,364,6,604,234,183,181
35,"SUCEAVA",332,149780,,422,"VÎRFU DEALULUI / ŞCOALA VÂRFU DEALULUI",3,14182,"PÎRTEŞTII DE JOS",149780,123,90,72,18,0,88,2,132,42,49,39
35,"SUCEAVA",332,149851,,423,"POIANA STAMPEI / PRIMARIA POIANA STAMPEI",3,14187,"POIANA STAMPEI",149851,1600,1191,1085,86,20,1179,12,1762,571,589,590
35,"SUCEAVA",332,149851,,424,"DORNIŞOARA / Complex social Dornisoara",3,14187,"POIANA STAMPEI",149851,265,189,168,21,0,187,2,289,100,138,49
35,"SUCEAVA",332,151585,,425,"POIENI-SOLCA / PRIMĂRIA POIENI-SOLCA",3,14195,"POIENI-SOLCA",151585,1681,840,780,60,0,834,6,1852,1012,500,334
35,"SUCEAVA",332,149931,,426,"POJORÎTA / ŞCOALA CU CLASELE I-IV POJORÎTA",3,14197,"POJORÎTA",149931,779,596,498,73,25,589,7,859,263,230,359
35,"SUCEAVA",332,149931,,427,"POJORÎTA / CĂMINUL CULTURAL POJORÎTA",3,14197,"POJORÎTA",149931,1445,995,921,73,1,975,20,1593,598,455,520
35,"SUCEAVA",332,149931,,428,"VALEA PUTNEI / CĂMINUL CULTURAL VALEA PUTNEI",3,14197,"POJORÎTA",149931,269,201,158,43,0,197,4,297,96,59,138
35,"SUCEAVA",332,149968,,429,"ARGHIRA / ŞCOALA GIMNAZIALĂ ARGHIRA",3,14200,"PREUTEŞTI",149968,909,605,541,64,0,598,7,1000,395,430,168
35,"SUCEAVA",332,149968,,430,"BASARABI / ŞCOALA GIMNAZIALĂ BASARABI",3,14200,"PREUTEŞTI",149968,1405,857,817,40,0,847,10,1550,693,654,193
35,"SUCEAVA",332,149968,,431,"BAHNA ARIN / ŞCOALA PRIMARĂ BAHNA ARIN",3,14200,"PREUTEŞTI",149968,159,139,120,19,0,138,1,172,33,120,18
35,"SUCEAVA",332,149968,,432,"PREUTEŞTI / CĂMINUL CULTURAL PREUTEŞTI",3,14200,"PREUTEŞTI",149968,1525,959,870,89,0,952,7,1680,721,729,223
35,"SUCEAVA",332,149968,,433,"HUŞI / ŞCOALA PRIMARĂ HUŞI",3,14200,"PREUTEŞTI",149968,559,387,346,41,0,382,5,617,230,291,91
35,"SUCEAVA",332,149968,,434,"LEUCUŞEŞTI / ŞCOALA GIMNAZIALĂ LEUCUŞEŞTI",3,14200,"PREUTEŞTI",149968,883,528,500,28,0,520,8,974,446,332,188
35,"SUCEAVA",332,150043,,435,"PUTNA / PRIMĂRIA COMUNEI PUTNA- SALA CĂSĂTORIILOR",3,14207,"PUTNA",150043,1159,767,680,78,9,755,12,1274,507,535,220
35,"SUCEAVA",332,150043,,436,"PUTNA / PRIMARIA COMUNEI PUTNA- SALA PARTER",3,14207,"PUTNA",150043,905,619,539,75,5,607,12,999,380,375,232
35,"SUCEAVA",332,150043,,437,"GURA PUTNEI / SCOALA  GURA PUTNEI",3,14207,"PUTNA",150043,1067,645,629,15,1,639,6,1172,527,399,240
35,"SUCEAVA",332,150070,,438,"RĂDĂŞENI / PRIMĂRIA COMUNEI RĂDĂŞENI",3,14210,"RĂDĂŞENI",150070,1139,536,513,23,0,523,13,1266,730,204,319
35,"SUCEAVA",332,150070,,439,"RĂDĂŞENI / PRIMĂRIA COMUNEI RĂDĂŞENI",3,14210,"RĂDĂŞENI",150070,1120,575,542,32,1,564,11,1234,659,234,330
35,"SUCEAVA",332,150070,,440,"LĂMĂŞENI / Şcoala Mihai Niculăiasa, sat Lămăşeni",3,14210,"RĂDĂŞENI",150070,1084,649,605,43,1,643,6,1186,537,307,336
35,"SUCEAVA",332,150070,,441,"POCOLENI / Şcoala Pocoleni",3,14210,"RĂDĂŞENI",150070,174,105,82,23,0,102,3,190,85,65,37
35,"SUCEAVA",332,150114,,442,"RÎŞCA / CĂMIN CULTURAL RÂŞCA",3,14214,"RÎŞCA",150114,1534,829,784,45,0,821,8,1691,862,599,222
35,"SUCEAVA",332,150114,,443,"RÎŞCA / SCOALA GENERALA RISCA 3",3,14214,"RÎŞCA",150114,696,412,389,23,0,410,2,765,353,289,121
35,"SUCEAVA",332,150114,,444,"JAHALIA / Şcoala Jahalia",3,14214,"RÎŞCA",150114,242,142,129,13,0,139,3,265,123,115,24
35,"SUCEAVA",332,150114,,445,"BUDA / Şcoala primară nr. 2 Rîşca",3,14214,"RÎŞCA",150114,594,332,305,27,0,330,2,655,323,226,104
35,"SUCEAVA",332,150114,,446,"DUMBRĂVENI / Şcoala Dumbrăveni",3,14214,"RÎŞCA",150114,316,181,174,7,0,179,2,349,168,135,44
35,"SUCEAVA",332,150114,,447,"SLĂTIOARA / Şcoala Slătioara",3,14214,"RÎŞCA",150114,614,361,319,42,0,351,10,681,320,277,74
35,"SUCEAVA",332,150178,,448,"SADOVA / CĂMINUL CULTURAL SADOVA",3,14220,"SADOVA",150178,1026,664,628,36,0,653,11,1128,464,185,468
35,"SUCEAVA",332,150178,,449,"SADOVA / ŞCOALA GENERALĂ FUNDU SADOVEI",3,14220,"SADOVA",150178,1007,744,724,20,0,741,3,1108,364,204,537
35,"SUCEAVA",332,150196,,450,"SATU MARE / CAMIN CULTURAL",3,14230,"SATU MARE",150196,1169,532,503,28,1,526,6,1288,756,237,289
35,"SUCEAVA",332,150196,,451,"SATU MARE / SCOALA GIMNAZIALA SATU MARE",3,14230,"SATU MARE",150196,1167,570,553,17,0,564,6,1283,713,253,311
35,"SUCEAVA",332,150196,,452,"ŢIBENI / Scoala gimnaziala sat TIBENI",3,14230,"SATU MARE",150196,1074,510,472,38,0,503,7,1183,673,299,204
35,"SUCEAVA",332,150221,,453,"SIMINICEA / caminul cultural siminicea",3,14242,"SIMINICEA",150221,1273,643,617,26,0,630,13,1405,762,415,215
35,"SUCEAVA",332,150221,,454,"SIMINICEA / SCOALA GIMNAZIALA SIMINICEA",3,14242,"SIMINICEA",150221,861,473,437,36,0,468,5,950,477,317,151
35,"SUCEAVA",332,150221,,455,"GRIGOREŞTI / SCOALA PRIMARA GRIGORESTI",3,14242,"SIMINICEA",150221,253,183,155,28,0,179,4,278,95,96,83
35,"SUCEAVA",332,150258,,456,"SLATINA / Primaria Comunei Slatina",3,14245,"SLATINA",150258,1537,854,795,59,0,844,10,1695,841,239,605
35,"SUCEAVA",332,150258,,457,"HERLA / Şcoala Herla",3,14245,"SLATINA",150258,1058,666,612,54,0,657,9,1164,498,187,470
35,"SUCEAVA",332,150258,,458,"GĂINEŞTI / Şcoala Găineşti",3,14245,"SLATINA",150258,1617,1021,954,60,7,1010,11,1784,763,679,331
35,"SUCEAVA",332,150294,,459,"STRAJA / Grădiniţa de copii nr. 1 Straja",3,14249,"STRAJA",150294,1262,649,635,14,0,640,9,1393,744,224,416
35,"SUCEAVA",332,150294,,460,"STRAJA / Grădiniţa de copii nr. 3  Straja",3,14249,"STRAJA",150294,1115,573,557,16,0,569,4,1225,652,171,398
35,"SUCEAVA",332,150294,,461,"STRAJA / Primăria comunei Straja",3,14249,"STRAJA",150294,1173,584,552,32,0,571,13,1290,706,168,403
35,"SUCEAVA",332,150294,,462,"STRAJA / Grădiniţa de copii nr. 2  Straja",3,14249,"STRAJA",150294,953,437,422,15,0,432,5,1049,612,111,321
35,"SUCEAVA",332,150310,,463,"STROIEŞTI / CAMINUL CULTURAL STROIESTI",3,14251,"STROIEŞTI",150310,1123,673,641,32,0,666,7,1241,568,371,295
35,"SUCEAVA",332,150310,,464,"STROIEŞTI / CAMIN CULTURAL STROIESTI",3,14251,"STROIEŞTI",150310,951,523,494,29,0,520,3,1043,520,244,276
35,"SUCEAVA",332,150310,,465,"ZAHAREŞTI / SCOALA ZAHARESTI",3,14251,"STROIEŞTI",150310,628,399,360,39,0,390,9,690,291,211,179
35,"SUCEAVA",332,150356,,466,"STULPICANI / CAMINUL CULTURAL STULPICANI",3,14255,"STULPICANI",150356,1165,662,629,33,0,660,2,1287,625,354,306
35,"SUCEAVA",332,150356,,467,"STULPICANI / Grădiniţa Stulpicani",3,14255,"STULPICANI",150356,1140,623,608,14,1,620,3,1249,626,294,326
35,"SUCEAVA",332,150356,,468,"NEGRILEASA / Cămin cultural Negrilesa",3,14255,"STULPICANI",150356,832,444,420,24,0,440,4,916,472,239,201
35,"SUCEAVA",332,150356,,469,"VADU NEGRILESEI / Şcoala Vadu Negrilesei",3,14255,"STULPICANI",150356,465,333,305,28,0,302,31,512,179,160,142
35,"SUCEAVA",332,150356,,470,"GEMENEA / Şcoala Gemenea",3,14255,"STULPICANI",150356,667,394,369,25,0,391,3,736,342,161,230
35,"SUCEAVA",332,150356,,471,"SLĂTIOARA / Cămin cultural Slătioara",3,14255,"STULPICANI",150356,519,311,291,20,0,306,5,570,259,133,173
35,"SUCEAVA",332,150418,,472,"SUCEVIŢA / scoala gimnazială Dimitrie Vatamaniuc",3,14261,"SUCEVIŢA",150418,1260,797,668,122,7,780,17,1390,593,358,422
35,"SUCEAVA",332,150418,,473,"VOIEVODEASA / scoala gimnaziala Voievodeasa",3,14261,"SUCEVIŢA",150418,986,548,522,23,3,539,9,1084,536,210,329
35,"SUCEAVA",332,150445,,474,"NEAGRA ŞARULUI / SCOALA GIMNAZIALA NEAGRA SARULUI",3,14222,"ŞARU DORNEI",150445,1622,1035,954,74,7,1029,6,1782,747,415,614
35,"SUCEAVA",332,150445,,475,"ŞARU DORNEI / Scoala cu clasele I-VIII Saru Dornei",3,14222,"ŞARU DORNEI",150445,951,594,564,30,0,586,8,1048,454,252,334
35,"SUCEAVA",332,150445,,476,"GURA HAITII / Scoala cu clasele I-IV Gura Haitii",3,14222,"ŞARU DORNEI",150445,487,329,311,18,0,329,0,536,207,130,199
35,"SUCEAVA",332,150445,,477,"SĂRIŞORU MARE / Scoala cu clasele I-IV Sarisoru Mare",3,14222,"ŞARU DORNEI",150445,435,297,277,20,0,297,0,477,180,110,187
35,"SUCEAVA",332,146432,,478,"SFÎNTU ILIE / CAMIN CULTURAL",3,14233,"ŞCHEIA",146432,1975,1203,1157,46,0,1180,23,2168,965,457,723
35,"SUCEAVA",332,146432,,479,"SFÎNTU ILIE / CAMIN CULTURAL",3,14233,"ŞCHEIA",146432,1443,772,733,39,0,761,11,1584,812,357,404
35,"SUCEAVA",332,146432,,480,"ŞCHEIA / Primăria comunei Şcheia",3,14233,"ŞCHEIA",146432,1584,994,939,55,0,982,12,1746,752,346,636
35,"SUCEAVA",332,146432,,481,"ŞCHEIA / Primăria comunei Şcheia",3,14233,"ŞCHEIA",146432,1286,767,695,72,0,760,7,1405,638,355,405
35,"SUCEAVA",332,146432,,482,"MIHOVENI / Şcoala gimnazială",3,14233,"ŞCHEIA",146432,1865,1083,1020,63,0,1071,12,2053,970,466,605
35,"SUCEAVA",332,151460,,483,"ŞERBĂUŢI / CAMIN CULTURAL SERBAUTI",3,14239,"ŞERBĂUŢI",151460,1555,727,661,66,0,713,14,1708,981,337,376
35,"SUCEAVA",332,151460,,484,"CĂLINEŞTI / CAMIN CULTURAL CALINESTI",3,14239,"ŞERBĂUŢI",151460,985,438,408,30,0,430,8,1084,646,199,231
35,"SUCEAVA",332,150524,,485,"TODIREŞTI / Scoala gimnazială Todireşti",3,14264,"TODIREŞTI",150524,1208,746,686,60,0,744,2,1335,589,423,321
35,"SUCEAVA",332,150524,,486,"COSTÎNA / Scoala gimanzială ""Vasile Bumbac"" Costîna",3,14264,"TODIREŞTI",150524,861,529,468,61,0,526,3,947,418,282,244
35,"SUCEAVA",332,150524,,487,"PĂRHĂUŢI / Scoala gimnazială Părhăuţi",3,14264,"TODIREŞTI",150524,1030,615,557,58,0,607,8,1131,516,301,306
35,"SUCEAVA",332,150524,,488,"SOLONEŢ / Scoala gimnazială ""I.V.Rachieru"" Soloneţ",3,14264,"TODIREŞTI",150524,1292,705,664,41,0,695,10,1426,721,290,405
35,"SUCEAVA",332,150588,,489,"UDEŞTI / PRIMĂRIA COMUNEI UDEŞTI",3,14270,"UDEŞTI",150588,1909,1176,1066,110,0,1162,14,2100,924,659,503
35,"SUCEAVA",332,150588,,490,"POIENI-SUCEAVA / CĂMINUL CULTURAL POIENI - SUCEAVA",3,14270,"UDEŞTI",150588,429,304,253,51,0,302,2,470,166,135,167
35,"SUCEAVA",332,150588,,491,"CHILIŞENI / CĂMINUL CULTURAL CHILIŞENI",3,14270,"UDEŞTI",150588,579,450,412,38,0,445,5,639,189,267,178
35,"SUCEAVA",332,150588,,492,"ŞTIRBĂŢ / CĂMINUL CULTURAL ŞTIRBĂŢ",3,14270,"UDEŞTI",150588,460,350,293,57,0,348,2,509,159,249,99
35,"SUCEAVA",332,150588,,493,"RACOVA / CĂMINUL CULTURAL RACOVA",3,14270,"UDEŞTI",150588,230,176,151,25,0,175,1,253,77,109,66
35,"SUCEAVA",332,150588,,494,"RUŞII-MĂNĂSTIOARA / ŞCOALA PRIMARĂ RUŞII - MĂNĂSTIOARA",3,14270,"UDEŞTI",150588,414,270,233,37,0,268,2,454,184,137,131
35,"SUCEAVA",332,150588,,495,"LUNCUŞOARA / ŞCOALA PRIMARĂ LUNCUŞOARA",3,14270,"UDEŞTI",150588,502,278,254,24,0,273,5,554,276,104,169
35,"SUCEAVA",332,150588,,496,"REUSENI / ŞCOALA GIMNAZIALĂ REUSENI",3,14270,"UDEŞTI",150588,518,350,307,42,1,348,2,572,222,183,165
35,"SUCEAVA",332,150588,,497,"PLĂVĂLARI / GRĂDINIŢA CU PROGRAM NORMAL PLĂVĂLARI",3,14270,"UDEŞTI",150588,860,474,437,37,0,465,9,943,469,250,215
35,"SUCEAVA",332,150702,,498,"ULMA / ŞCOALA GIMNAZIALA ULMA",3,14282,"ULMA",150702,565,284,270,14,0,280,4,622,338,117,163
35,"SUCEAVA",332,150702,,499,"LUPCINA / ŞCOALA GIMNAZIALĂ LUPCINA",3,14282,"ULMA",150702,785,481,440,41,0,474,7,867,386,185,289
35,"SUCEAVA",332,150702,,500,"NISIPITU / ŞCOALA PRIMARĂ NISIPITU",3,14282,"ULMA",150702,348,200,181,19,0,199,1,383,183,119,80
35,"SUCEAVA",332,150766,,501,"VADU MOLDOVEI / SCOALA GIMNAZIALA NR 1 VADU MOLDOVEI",3,14288,"VADU MOLDOVEI",150766,884,574,475,56,43,567,7,976,402,324,243
35,"SUCEAVA",332,150766,,502,"DUMBRĂVIŢA / SCOALA PRIMARA DUMBRAVITA",3,14288,"VADU MOLDOVEI",150766,823,492,433,50,9,485,7,901,409,342,143
35,"SUCEAVA",332,150766,,503,"NIGOTEŞTI / SCOALA GIMNAZIALA NIGOTESTI",3,14288,"VADU MOLDOVEI",150766,378,245,216,27,2,243,2,419,174,160,83
35,"SUCEAVA",332,150766,,504,"MOVILENI / SCOALA PRIMARA MOVILENI",3,14288,"VADU MOLDOVEI",150766,215,145,127,18,0,145,0,238,93,121,24
35,"SUCEAVA",332,150766,,505,"MESTECENI / SCOALA PRIMARA MESTECENI",3,14288,"VADU MOLDOVEI",150766,168,113,90,21,2,113,0,186,73,60,53
35,"SUCEAVA",332,150766,,506,"IONEASA / SCOALA PRIMARA IONEASA",3,14288,"VADU MOLDOVEI",150766,310,206,177,23,6,204,2,341,135,129,75
35,"SUCEAVA",332,150766,,507,"CIUMULEŞTI / SCOALA PRIMARA CIUMULESTI",3,14288,"VADU MOLDOVEI",150766,659,425,376,40,9,421,4,724,299,241,180
35,"SUCEAVA",332,150766,,508,"VADU MOLDOVEI / SCOAJA GIMNAZIALA NR 2 VADU MOLDOVEI",3,14288,"VADU MOLDOVEI",150766,285,205,145,57,3,204,1,312,107,137,67
35,"SUCEAVA",332,150891,,509,"VALEA MOLDOVEI / PRIMĂRIA COMUNEI VALEA MOLDOVEI, JUDEŢUL SUCEAVA",3,14297,"VALEA MOLDOVEI",150891,1313,859,836,23,0,850,9,1447,588,538,312
35,"SUCEAVA",332,150891,,510,"MIRONU / Şcoala primară Mironu",3,14297,"VALEA MOLDOVEI",150891,1398,804,781,23,0,774,30,1541,737,540,234
35,"SUCEAVA",332,150935,,511,"VAMA / Cămin cultural Vama",3,14300,"VAMA",150935,984,594,552,39,3,585,9,1085,491,183,402
35,"SUCEAVA",332,150935,,512,"VAMA / Scoala gimnazială ""Iorgu G. Toma"" localul nr.2",3,14300,"VAMA",150935,1698,985,912,63,10,978,7,1869,884,271,707
35,"SUCEAVA",332,150935,,513,"STRÎMTURA / Şcoala gimnazială ""Iorgu G. Toma"" localul din satul Strâmtura",3,14300,"VAMA",150935,1018,589,555,33,1,585,4,1118,529,190,395
35,"SUCEAVA",332,150935,,514,"MOLID / Şcola gimnazială ""Iorgu G. Toma"" localul din satul Molid",3,14300,"VAMA",150935,531,315,289,26,0,311,4,581,266,110,201
35,"SUCEAVA",332,150935,,515,"PRISACA DORNEI / Şcoala gimnazială ""Iorgu G. Toma"" localul din satul Prisaca Dornei",3,14300,"VAMA",150935,689,384,356,28,0,380,4,760,376,163,217
35,"SUCEAVA",332,150980,,516,"VATRA MOLDOVIŢEI / CĂMINUL CULTURAL VATRA MOLDOVIŢEI",3,14305,"VATRA MOLDOVIŢEI",150980,1191,841,767,54,20,835,6,1316,475,236,599
35,"SUCEAVA",332,150980,,517,"VATRA MOLDOVIŢEI / ŞCOALA VALEA STÂNII",3,14305,"VATRA MOLDOVIŢEI",150980,663,432,396,24,12,429,3,733,301,134,295
35,"SUCEAVA",332,150980,,518,"CIUMÎRNA / SALA POLIVALENTĂ CIUMÂRNA",3,14305,"VATRA MOLDOVIŢEI",150980,376,253,206,42,5,252,1,409,156,67,185
35,"SUCEAVA",332,150980,,519,"PALTINU / ŞCOALA GIMNAZIALĂ CU CLASELE I-VIII PALTINU",3,14305,"VATRA MOLDOVIŢEI",150980,700,438,403,30,5,434,4,771,333,114,320
35,"SUCEAVA",332,150980,,520,"PALTINU / ŞCOALA PRIMARĂ SPĂRTURI",3,14305,"VATRA MOLDOVIŢEI",150980,637,486,461,25,0,485,1,700,214,145,340
35,"SUCEAVA",332,151022,,521,"VEREŞTI / CAMINUL CULTURAL VERESTI",3,14309,"VEREŞTI",151022,1250,677,634,43,0,670,7,1377,700,339,331
35,"SUCEAVA",332,151022,,522,"HANCEA / SALA DE SEDINTE A CONSILIULUI LOCAL VERESTI",3,14309,"VEREŞTI",151022,832,485,471,14,0,475,10,913,428,301,174
35,"SUCEAVA",332,151022,,523,"COROCĂIEŞTI / Scoala Gimnaziala Corocaiesti",3,14309,"VEREŞTI",151022,992,448,422,26,0,445,3,1086,638,257,188
35,"SUCEAVA",332,151022,,524,"COROCĂIEŞTI / CAMINUL CULTURAL COROCAIESTI",3,14309,"VEREŞTI",151022,1269,564,537,27,0,562,2,1398,834,314,248
35,"SUCEAVA",332,151022,,525,"BURSUCENI / SCOALA GIMNAZIALA BURSUCENI",3,14309,"VEREŞTI",151022,1152,532,500,32,0,527,5,1269,737,272,255
35,"SUCEAVA",332,151077,,526,"VICOVU DE JOS / Scoala  cu clasele I-VIII Ioan Vicoveanu",3,14314,"VICOVU DE JOS",151077,1328,653,621,32,0,649,4,1458,805,330,319
35,"SUCEAVA",332,151077,,527,"VICOVU DE JOS / Scoala cu clasele I-VIII nr.2 Remezau",3,14314,"VICOVU DE JOS",151077,1865,869,857,12,0,854,15,2060,1191,390,464
35,"SUCEAVA",332,151077,,528,"VICOVU DE JOS / Scoala cu clasele I-IV Margine",3,14314,"VICOVU DE JOS",151077,729,384,370,14,0,379,5,798,414,231,148
35,"SUCEAVA",332,151077,,529,"VICOVU DE JOS / Grădiniţa ""Pod Dabîca""",3,14314,"VICOVU DE JOS",151077,941,468,453,15,0,464,4,1034,566,213,251
35,"SUCEAVA",332,151558,,530,"VOITINEL / Gradinita cu program normal Voitinel",3,14316,"VOITINEL",151558,1657,927,830,61,36,904,23,1826,899,656,248
35,"SUCEAVA",332,151558,,531,"VOITINEL / Scoala cu clasele I-VIII Voitinel",3,14316,"VOITINEL",151558,1321,694,640,42,12,688,6,1451,757,407,281
35,"SUCEAVA",332,151120,,532,"VOLOVĂŢ / Căminul cultural",3,14318,"VOLOVĂŢ",151120,1982,968,950,14,4,951,17,2179,1211,450,501
35,"SUCEAVA",332,151120,,533,"VOLOVĂŢ / Căminul cultural",3,14318,"VOLOVĂŢ",151120,1977,946,926,15,5,928,18,2177,1231,495,433
35,"SUCEAVA",332,151157,,534,"PLEŞEŞTI / Şcoala Gimnazială ""Constantin Tomescu"" Pleşeşti",3,14320,"VULTUREŞTI",151157,497,239,216,23,0,239,0,552,313,149,90
35,"SUCEAVA",332,151157,,535,"VALEA GLODULUI / Şcoala Gimnazială Valea Glodului",3,14320,"VULTUREŞTI",151157,744,428,399,27,2,422,6,820,392,285,137
35,"SUCEAVA",332,151157,,536,"GIURGEŞTI / Scoala Gimnazială Giurgeşti",3,14320,"VULTUREŞTI",151157,585,347,314,33,0,338,9,641,294,237,101
35,"SUCEAVA",332,151157,,537,"HREAŢCA / Scoala Primară Hreaţca",3,14320,"VULTUREŞTI",151157,315,179,149,30,0,179,0,345,166,93,86
35,"SUCEAVA",332,151157,,538,"MEREŞTI / Parohia ortodoxă Mereşti",3,14320,"VULTUREŞTI",151157,200,144,118,26,0,143,1,220,76,112,31
35,"SUCEAVA",332,151157,,539,"JACOTA / Localul fostei şcoli Jacota",3,14320,"VULTUREŞTI",151157,130,78,59,19,0,77,1,145,67,49,28
35,"SUCEAVA",332,151157,,540,"OSOI / Scoala Primară Osoi",3,14320,"VULTUREŞTI",151157,281,169,140,29,0,165,4,311,142,123,42
35,"SUCEAVA",332,151246,,541,"ZAMOSTEA / Şc. generala cl.I-VIII-Zamostea",3,14329,"ZAMOSTEA",151246,1229,735,650,84,1,723,12,1352,617,539,184
35,"SUCEAVA",332,151246,,542,"CIOMÎRTAN / Şc. generala cl.I-IV- Ciomîrtan",3,14329,"ZAMOSTEA",151246,451,271,234,32,5,268,3,495,224,217,51
35,"SUCEAVA",332,151246,,543,"LUNCA / Şc.generala cl.I-IV-Lunca",3,14329,"ZAMOSTEA",151246,214,133,117,15,1,133,0,235,102,96,37
35,"SUCEAVA",332,151246,,544,"NICANI / Şc. Generala cl.I-IV-Nicani",3,14329,"ZAMOSTEA",151246,413,213,201,11,1,212,1,455,242,148,64
35,"SUCEAVA",332,151246,,545,"TĂUTEŞTI / Sc.Generală cl.l-lV - Tăuteşti",3,14329,"ZAMOSTEA",151246,160,127,108,19,0,126,1,176,49,96,30
35,"SUCEAVA",332,151344,,546,"ZVORIŞTEA / ŞCOALA GENERALĂ ZVORIŞTEA",3,14339,"ZVORIŞTEA",151344,775,516,410,46,60,506,10,859,343,365,141
35,"SUCEAVA",332,151344,,547,"DEALU / ŞCOALA GENERALĂ BUDA",3,14339,"ZVORIŞTEA",151344,646,356,320,36,0,352,4,705,349,281,71
35,"SUCEAVA",332,151344,,548,"BUDA / ŞCOALA GENERALĂ BUDA",3,14339,"ZVORIŞTEA",151344,860,455,428,27,0,450,5,946,491,322,128
35,"SUCEAVA",332,151344,,549,"STÎNCA / ŞCOALA GENERALĂ STÎNCA",3,14339,"ZVORIŞTEA",151344,459,302,281,21,0,298,4,503,201,223,75
35,"SUCEAVA",332,151344,,550,"STÎNCUŢA / ŞCOALA GENERALĂ STÎNCUŢA",3,14339,"ZVORIŞTEA",151344,132,93,71,22,0,93,0,145,52,72,21
35,"SUCEAVA",332,151344,,551,"POIANA / ŞCOALA GENERALĂ POIANA",3,14339,"ZVORIŞTEA",151344,441,257,222,35,0,253,4,483,226,167,86
35,"SUCEAVA",332,151344,,552,"ŞERBĂNEŞTI / ŞCOALA GENERALĂ ŞERBĂNEŞTI",3,14339,"ZVORIŞTEA",151344,909,446,418,28,0,442,4,999,553,305,137
35,"SUCEAVA",332,151344,,553,"SLOBOZIA / ŞCOALA GENERALĂ SLOBOZIA",3,14339,"ZVORIŞTEA",151344,505,278,249,29,0,277,1,558,280,155,122
36,"TELEORMAN",341,151790,,1,"ALEXANDRIA / Scoala ajutatoare Alexandria",1,14349,"MUNICIPIUL ALEXANDRIA",151790,1528,1071,905,81,85,1048,23,1679,608,591,457
36,"TELEORMAN",341,151790,,2,"ALEXANDRIA / Scoala gimnaziala  nr.7",1,14349,"MUNICIPIUL ALEXANDRIA",151790,1307,745,704,41,0,725,20,1444,699,425,300
36,"TELEORMAN",341,151790,,3,"ALEXANDRIA / Gradinita cu program prelungit nr.6",1,14349,"MUNICIPIUL ALEXANDRIA",151790,1247,693,645,44,4,682,11,1364,671,383,299
36,"TELEORMAN",341,151790,,4,"ALEXANDRIA / Scoala gimnaziala nr.7",1,14349,"MUNICIPIUL ALEXANDRIA",151790,1390,821,776,45,0,811,10,1533,712,462,349
36,"TELEORMAN",341,151790,,5,"ALEXANDRIA / Scoala gimnaziala nr.7",1,14349,"MUNICIPIUL ALEXANDRIA",151790,1409,865,824,40,1,847,18,1549,684,442,405
36,"TELEORMAN",341,151790,,6,"ALEXANDRIA / Liceul Tehnologic Nicolae Balcescu",1,14349,"MUNICIPIUL ALEXANDRIA",151790,1536,948,921,27,0,931,17,1692,744,580,351
36,"TELEORMAN",341,151790,,7,"ALEXANDRIA / Colegiul national Al D Ghica",1,14349,"MUNICIPIUL ALEXANDRIA",151790,1530,974,932,40,2,957,17,1690,716,531,426
36,"TELEORMAN",341,151790,,8,"ALEXANDRIA / Colegiul national Al D Ghica",1,14349,"MUNICIPIUL ALEXANDRIA",151790,1399,876,832,43,1,862,14,1538,662,488,374
36,"TELEORMAN",341,151790,,9,"ALEXANDRIA / Liceul Tehnologic Nicolae Balcescu",1,14349,"MUNICIPIUL ALEXANDRIA",151790,1273,771,720,51,0,759,12,1408,637,390,369
36,"TELEORMAN",341,151790,,10,"ALEXANDRIA / Gradinita cu program prelungit nr.10",1,14349,"MUNICIPIUL ALEXANDRIA",151790,1425,858,803,54,1,844,14,1571,713,467,377
36,"TELEORMAN",341,151790,,11,"ALEXANDRIA / Liceul teoretic C-tin Noica",1,14349,"MUNICIPIUL ALEXANDRIA",151790,1060,675,630,44,1,665,10,1171,496,383,282
36,"TELEORMAN",341,151790,,12,"ALEXANDRIA / Liceul pedagogic Mircea Scarlat",1,14349,"MUNICIPIUL ALEXANDRIA",151790,1298,801,757,39,5,790,11,1428,627,450,340
36,"TELEORMAN",341,151790,,13,"ALEXANDRIA / Scoala gimnaziala nr.5",1,14349,"MUNICIPIUL ALEXANDRIA",151790,1064,717,622,77,18,703,14,1177,460,392,311
36,"TELEORMAN",341,151790,,14,"ALEXANDRIA / Gradinita cu program prelungit nr.7",1,14349,"MUNICIPIUL ALEXANDRIA",151790,1191,745,695,48,2,727,18,1309,564,410,317
36,"TELEORMAN",341,151790,,15,"ALEXANDRIA / Gradinita cu program prelungit nr.7",1,14349,"MUNICIPIUL ALEXANDRIA",151790,1122,711,673,37,1,698,13,1236,525,385,313
36,"TELEORMAN",341,151790,,16,"ALEXANDRIA / Sala polivalenta",1,14349,"MUNICIPIUL ALEXANDRIA",151790,1519,983,867,107,9,960,23,1668,685,552,408
36,"TELEORMAN",341,151790,,17,"ALEXANDRIA / Oficiul postal nr. 3",1,14349,"MUNICIPIUL ALEXANDRIA",151790,1166,735,674,58,3,726,9,1295,560,444,282
36,"TELEORMAN",341,151790,,18,"ALEXANDRIA / Scoala gimnaziala Stefan cel Mare",1,14349,"MUNICIPIUL ALEXANDRIA",151790,889,587,507,57,23,580,7,984,397,327,253
36,"TELEORMAN",341,151790,,19,"ALEXANDRIA / Scoala gimnaziala Stefan cel Mare",1,14349,"MUNICIPIUL ALEXANDRIA",151790,1076,668,611,56,1,653,15,1193,525,334,319
36,"TELEORMAN",341,151790,,20,"ALEXANDRIA / Scoala gimnaziala Mihai Viteazul",1,14349,"MUNICIPIUL ALEXANDRIA",151790,1480,912,830,82,0,889,23,1628,716,470,419
36,"TELEORMAN",341,151790,,21,"ALEXANDRIA / Scoala gimnaziala Mihai Viteazul",1,14349,"MUNICIPIUL ALEXANDRIA",151790,1159,716,678,37,1,702,14,1281,565,351,351
36,"TELEORMAN",341,151790,,22,"ALEXANDRIA / Scoala gimnaziala nr.6",1,14349,"MUNICIPIUL ALEXANDRIA",151790,988,544,505,39,0,534,10,1086,542,342,192
36,"TELEORMAN",341,151790,,23,"ALEXANDRIA / Scoala gimnaziala nr.6",1,14349,"MUNICIPIUL ALEXANDRIA",151790,1232,675,620,53,2,662,13,1359,684,404,258
36,"TELEORMAN",341,151790,,24,"ALEXANDRIA / Liceul teoretic Al I Cuza",1,14349,"MUNICIPIUL ALEXANDRIA",151790,1144,635,592,43,0,627,8,1258,623,345,282
36,"TELEORMAN",341,151790,,25,"ALEXANDRIA / Liceul teoretic Al I Cuza",1,14349,"MUNICIPIUL ALEXANDRIA",151790,1172,696,647,49,0,688,8,1291,595,383,305
36,"TELEORMAN",341,151790,,26,"ALEXANDRIA / Liceul teoretic Al I Cuza",1,14349,"MUNICIPIUL ALEXANDRIA",151790,1087,653,591,61,1,642,11,1199,546,352,290
36,"TELEORMAN",341,151790,,27,"ALEXANDRIA / Scoala gimnaziala Al Colfescu",1,14349,"MUNICIPIUL ALEXANDRIA",151790,1433,790,735,55,0,770,20,1589,799,424,346
36,"TELEORMAN",341,151790,,28,"ALEXANDRIA / Scoala gimnaziala Al Colfescu",1,14349,"MUNICIPIUL ALEXANDRIA",151790,1487,797,765,32,0,777,20,1644,847,511,266
36,"TELEORMAN",341,151790,,29,"ALEXANDRIA / Gradinita cu program normal nr.1",1,14349,"MUNICIPIUL ALEXANDRIA",151790,1512,872,834,38,0,859,13,1660,788,514,345
36,"TELEORMAN",341,151790,,30,"ALEXANDRIA / Scoala gimnaziala Al Colfescu",1,14349,"MUNICIPIUL ALEXANDRIA",151790,1546,889,842,47,0,873,16,1708,819,466,407
36,"TELEORMAN",341,151790,,31,"ALEXANDRIA / Gradinita cu program prelungit nr.4",1,14349,"MUNICIPIUL ALEXANDRIA",151790,1498,708,679,29,0,703,5,1643,935,421,282
36,"TELEORMAN",341,151790,,32,"ALEXANDRIA / Gradinita cu program prelungit nr.4",1,14349,"MUNICIPIUL ALEXANDRIA",151790,1500,691,659,31,1,674,17,1649,958,395,279
36,"TELEORMAN",341,151790,,33,"ALEXANDRIA / Scoala de soferi amatori",1,14349,"MUNICIPIUL ALEXANDRIA",151790,1539,827,795,32,0,803,24,1697,870,540,263
36,"TELEORMAN",341,151790,,34,"ALEXANDRIA / Gradinita cu program prelungit nr.8",1,14349,"MUNICIPIUL ALEXANDRIA",151790,1249,415,387,25,3,404,11,1381,966,293,111
36,"TELEORMAN",341,151870,,35,"ROSIORI DE VEDE / Şc. Gimn. Zaharia Stancu",1,14351,"MUNICIPIUL ROŞIORI DE VEDE",151870,1300,764,708,56,0,746,18,1433,669,444,302
36,"TELEORMAN",341,151870,,36,"ROSIORI DE VEDE / Şc. Gimn. Zaharia Stancu",1,14351,"MUNICIPIUL ROŞIORI DE VEDE",151870,1091,598,556,38,4,591,7,1201,603,387,204
36,"TELEORMAN",341,151870,,37,"ROSIORI DE VEDE / Sc. Gimn. Dan Berindei",1,14351,"MUNICIPIUL ROŞIORI DE VEDE",151870,1250,704,620,39,45,688,16,1378,674,399,289
36,"TELEORMAN",341,151870,,38,"ROSIORI DE VEDE / Colegiul Tehnic A. Saligny",1,14351,"MUNICIPIUL ROŞIORI DE VEDE",151870,1205,685,641,44,0,675,10,1326,641,365,310
36,"TELEORMAN",341,151870,,39,"ROSIORI DE VEDE / Grădiniţa cu program prelungit nr.1",1,14351,"MUNICIPIUL ROŞIORI DE VEDE",151870,1185,654,624,29,1,641,13,1303,649,373,268
36,"TELEORMAN",341,151870,,40,"ROSIORI DE VEDE / Centrul Cultural",1,14351,"MUNICIPIUL ROŞIORI DE VEDE",151870,1160,676,633,43,0,664,12,1275,599,390,274
36,"TELEORMAN",341,151870,,41,"ROSIORI DE VEDE / Şc. Gimn. Gala Galaction",1,14351,"MUNICIPIUL ROŞIORI DE VEDE",151870,1195,643,620,22,1,629,14,1315,672,391,238
36,"TELEORMAN",341,151870,,42,"ROSIORI DE VEDE / Şc. Gimn. Gala Galaction",1,14351,"MUNICIPIUL ROŞIORI DE VEDE",151870,1265,563,529,27,7,538,25,1395,832,331,207
36,"TELEORMAN",341,151870,,43,"ROSIORI DE VEDE / Muzeul de Istorie",1,14351,"MUNICIPIUL ROŞIORI DE VEDE",151870,1179,624,576,48,0,610,14,1303,679,327,283
36,"TELEORMAN",341,151870,,44,"ROSIORI DE VEDE / Clubul Copiilor",1,14351,"MUNICIPIUL ROŞIORI DE VEDE",151870,1573,930,817,42,71,916,14,1688,758,520,396
36,"TELEORMAN",341,151870,,45,"ROSIORI DE VEDE / Şc. Gimn. Al. Depărăţeanu",1,14351,"MUNICIPIUL ROŞIORI DE VEDE",151870,1498,775,702,39,34,766,9,1655,880,496,270
36,"TELEORMAN",341,151870,,46,"ROSIORI DE VEDE / Şc. Gimn. Al. Depărăţeanu",1,14351,"MUNICIPIUL ROŞIORI DE VEDE",151870,1453,694,653,30,11,685,9,1606,912,468,217
36,"TELEORMAN",341,151870,,47,"ROSIORI DE VEDE / Şc. Gimn. Al. Depărăţeanu",1,14351,"MUNICIPIUL ROŞIORI DE VEDE",151870,1176,706,659,44,3,690,16,1295,589,385,305
36,"TELEORMAN",341,151870,,48,"ROSIORI DE VEDE / Şc. Primară nr. 5",1,14351,"MUNICIPIUL ROŞIORI DE VEDE",151870,1510,807,769,37,1,794,13,1665,858,491,303
36,"TELEORMAN",341,151870,,49,"ROSIORI DE VEDE / Şc. Primară nr. 5",1,14351,"MUNICIPIUL ROŞIORI DE VEDE",151870,1197,722,690,30,2,698,24,1315,593,472,226
36,"TELEORMAN",341,151870,,50,"ROSIORI DE VEDE / Liceul Tehnologic Emil Racoviţă",1,14351,"MUNICIPIUL ROŞIORI DE VEDE",151870,1471,816,777,38,1,797,19,1619,803,483,314
36,"TELEORMAN",341,151870,,51,"ROSIORI DE VEDE / Casa de Cultură",1,14351,"MUNICIPIUL ROŞIORI DE VEDE",151870,1108,646,589,55,2,633,13,1219,573,344,289
36,"TELEORMAN",341,151870,,52,"ROSIORI DE VEDE / Colegiul Naţional Anastasescu",1,14351,"MUNICIPIUL ROŞIORI DE VEDE",151870,1430,794,752,41,1,780,14,1580,786,478,302
36,"TELEORMAN",341,151870,,53,"ROSIORI DE VEDE / Grădiniţa cu program normal nr. 3",1,14351,"MUNICIPIUL ROŞIORI DE VEDE",151870,1466,739,703,34,2,727,12,1615,876,475,252
36,"TELEORMAN",341,151870,,54,"ROSIORI DE VEDE / Liceul Tehnologic V. Madgearu",1,14351,"MUNICIPIUL ROŞIORI DE VEDE",151870,1333,724,668,53,3,709,15,1473,749,410,299
36,"TELEORMAN",341,151870,,55,"ROSIORI DE VEDE / Grădiniţa cu program normal nr. 6",1,14351,"MUNICIPIUL ROŞIORI DE VEDE",151870,1184,638,604,28,6,631,7,1304,666,421,210
36,"TELEORMAN",341,151683,,56,"TURNU MĂGURELE / localul Grădiniţei cu program normal nr.3",1,14353,"MUNICIPIUL TURNU MAGURELE",151683,1497,891,857,34,0,871,20,1648,757,530,341
36,"TELEORMAN",341,151683,,57,"TURNU MĂGURELE / Şcoala nouă din cartierul Odaia",1,14353,"MUNICIPIUL TURNU MAGURELE",151683,1115,624,605,19,0,619,5,1230,606,388,231
36,"TELEORMAN",341,151683,,58,"TURNU MĂGURELE / localul Şcolii Gimnaziale nr. 4",1,14353,"MUNICIPIUL TURNU MAGURELE",151683,1912,919,853,66,0,905,14,2111,1192,495,410
36,"TELEORMAN",341,151683,,59,"TURNU MĂGURELE / localul Grădiniţei cu program prelungit nr. 7",1,14353,"MUNICIPIUL TURNU MAGURELE",151683,1932,991,944,46,1,972,19,2122,1131,538,434
36,"TELEORMAN",341,151683,,60,"TURNU MĂGURELE / Colegiului Tehnic ""G-ral D. Praporgescu""",1,14353,"MUNICIPIUL TURNU MAGURELE",151683,1903,980,949,31,0,966,14,2099,1119,581,385
36,"TELEORMAN",341,151683,,61,"TURNU MĂGURELE / localul Grădiniţei cu program normal nr. 4",1,14353,"MUNICIPIUL TURNU MAGURELE",151683,1528,706,662,44,0,693,13,1685,979,411,282
36,"TELEORMAN",341,151683,,62,"TURNU MĂGURELE / localul Policlinicii municipiului Turnu Măgurele",1,14353,"MUNICIPIUL TURNU MAGURELE",151683,1721,746,690,56,0,730,16,1899,1153,487,243
36,"TELEORMAN",341,151683,,63,"TURNU MĂGURELE / localul Colegiului Naţional ""Unirea""",1,14353,"MUNICIPIUL TURNU MAGURELE",151683,1213,755,641,42,72,750,5,1340,585,442,308
36,"TELEORMAN",341,151683,,64,"TURNU MĂGURELE / localul Colegiului Naţional ""Unirea""",1,14353,"MUNICIPIUL TURNU MAGURELE",151683,1334,722,691,27,4,712,10,1468,746,398,314
36,"TELEORMAN",341,151683,,65,"TURNU MĂGURELE / localul Şcolii gimnaziale ""Mircea Cel Bătrân""",1,14353,"MUNICIPIUL TURNU MAGURELE",151683,1223,623,583,35,5,606,17,1344,721,307,299
36,"TELEORMAN",341,151683,,66,"TURNU MĂGURELE / localul Şcolii gimnaziale ""Mircea Cel Bătrân""",1,14353,"MUNICIPIUL TURNU MAGURELE",151683,1698,978,921,55,2,966,12,1880,902,536,430
36,"TELEORMAN",341,151683,,67,"TURNU MĂGURELE / Liceului Tehnologic ""Sf. Haralambie""",1,14353,"MUNICIPIUL TURNU MAGURELE",151683,998,577,547,30,0,565,12,1098,521,323,242
36,"TELEORMAN",341,151683,,68,"TURNU MĂGURELE / Liceului Tehnologic ""Sf. Haralambie""",1,14353,"MUNICIPIUL TURNU MAGURELE",151683,880,497,462,33,2,491,6,976,479,257,234
36,"TELEORMAN",341,151683,,69,"TURNU MĂGURELE / localul Liceului Teoretic ""Marin Preda""",1,14353,"MUNICIPIUL TURNU MAGURELE",151683,1287,755,713,39,3,744,11,1427,672,429,315
36,"TELEORMAN",341,151683,,70,"TURNU MĂGURELE / localul Grădiniţei cu program prelungit nr. 5",1,14353,"MUNICIPIUL TURNU MAGURELE",151683,1200,664,630,34,0,659,5,1324,660,346,313
36,"TELEORMAN",341,151683,,71,"TURNU MĂGURELE / localul Grădiniţei cu program normal nr. 2",1,14353,"MUNICIPIUL TURNU MAGURELE",151683,1392,669,653,16,0,654,15,1532,863,411,243
36,"TELEORMAN",341,151683,,72,"TURNU MĂGURELE / localul Şcolii gimnaziale nr. 2 - local nou",1,14353,"MUNICIPIUL TURNU MAGURELE",151683,1451,741,706,35,0,722,19,1597,856,482,240
36,"TELEORMAN",341,151683,,73,"TURNU MĂGURELE / localul Dispensarului uman Măgurele",1,14353,"MUNICIPIUL TURNU MAGURELE",151683,1467,845,814,31,0,827,18,1621,776,512,315
36,"TELEORMAN",341,151905,,74,"VIDELE / Scoala gimnaziala cu clasele I-VIII nr.2",1,14355,"ORAŞ VIDELE",151905,1787,1229,1108,119,2,1207,22,1967,738,587,620
36,"TELEORMAN",341,151905,,75,"VIDELE / Liceul Teoretic",1,14355,"ORAŞ VIDELE",151905,1616,1119,996,120,3,1096,23,1784,665,579,517
36,"TELEORMAN",341,151905,,76,"VIDELE / Casa de Cultura",1,14355,"ORAŞ VIDELE",151905,1512,1054,932,120,2,1027,27,1668,614,469,558
36,"TELEORMAN",341,151905,,77,"VIDELE / Gradinita Fotachesti",1,14355,"ORAŞ VIDELE",151905,944,631,516,45,70,623,8,1041,410,383,240
36,"TELEORMAN",341,151905,,78,"VIDELE / Gradinita Furculesti",1,14355,"ORAŞ VIDELE",151905,1403,952,879,70,3,914,38,1546,594,517,397
36,"TELEORMAN",341,151905,,79,"VIDELE / Gradinita Cartojanca",1,14355,"ORAŞ VIDELE",151905,705,506,471,35,0,497,9,784,278,313,184
36,"TELEORMAN",341,151905,,80,"VIDELE / Gradinita Tamasesti",1,14355,"ORAŞ VIDELE",151905,778,567,520,45,2,552,15,856,289,328,224
36,"TELEORMAN",341,151905,,81,"VIDELE / Gradinita Parisesti",1,14355,"ORAŞ VIDELE",151905,507,407,366,34,7,396,11,599,192,192,204
36,"TELEORMAN",341,151905,,82,"COŞOAIA / Gradinita Cosoia",1,14355,"ORAŞ VIDELE",151905,294,237,190,47,0,230,7,323,86,146,84
36,"TELEORMAN",341,151978,,83,"ZIMNICEA / Scoala Primara nr.4",1,14358,"ORAŞ ZIMNICEA",151978,1505,894,871,22,1,881,13,1655,761,642,239
36,"TELEORMAN",341,151978,,84,"ZIMNICEA / Scoala Primara nr.4",1,14358,"ORAŞ ZIMNICEA",151978,1569,926,899,27,0,911,15,1727,801,675,236
36,"TELEORMAN",341,151978,,85,"ZIMNICEA / Gradinita nr.2",1,14358,"ORAŞ ZIMNICEA",151978,1487,956,878,36,42,941,15,1637,681,707,234
36,"TELEORMAN",341,151978,,86,"ZIMNICEA / Scoala Gimnaziala nr.3",1,14358,"ORAŞ ZIMNICEA",151978,1618,852,774,78,0,842,10,1782,930,513,329
36,"TELEORMAN",341,151978,,87,"ZIMNICEA / Scoala Gimnaziala nr.1",1,14358,"ORAŞ ZIMNICEA",151978,1577,840,774,66,0,823,17,1743,903,467,356
36,"TELEORMAN",341,151978,,88,"ZIMNICEA / Gradinita nr.5",1,14358,"ORAŞ ZIMNICEA",151978,1415,718,663,54,1,710,8,1565,847,425,285
36,"TELEORMAN",341,151978,,89,"ZIMNICEA / Gradinita nr.5",1,14358,"ORAŞ ZIMNICEA",151978,1270,797,762,35,0,780,17,1399,602,532,248
36,"TELEORMAN",341,151978,,90,"ZIMNICEA / Scoala Gimnaziala nr.2",1,14358,"ORAŞ ZIMNICEA",151978,1376,872,843,25,4,866,6,1518,646,600,266
36,"TELEORMAN",341,151978,,91,"ZIMNICEA / Scoala Gimnaziala nr.2",1,14358,"ORAŞ ZIMNICEA",151978,1430,925,883,40,2,909,16,1578,653,604,305
36,"TELEORMAN",341,151996,,92,"BALACI / localul Căminului Cultural din comuna Balaci,  satul Balaci",3,14363,"BALACI",151996,908,719,491,132,96,708,11,1000,281,528,180
36,"TELEORMAN",341,151996,,93,"TECUCI / localul Căminului Cultural din comuna Balaci, satul Tecuci",3,14363,"BALACI",151996,631,458,303,124,31,453,5,701,243,331,122
36,"TELEORMAN",341,152038,,94,"BĂBĂIŢA / localul Şcolii Generale Băbăiţa",3,14360,"BĂBĂIŢA",152038,1577,985,920,57,8,974,11,1736,751,758,216
36,"TELEORMAN",341,152038,,95,"BĂBĂIŢA / localul Şcolii Generale Merişani",3,14360,"BĂBĂIŢA",152038,920,645,572,54,19,639,6,1015,370,532,107
36,"TELEORMAN",341,155083,,96,"BECIU / localul Grădiniţei Beciu, amplasată pe DJ 546",3,14367,"BECIU",155083,875,553,492,61,0,549,4,964,411,370,179
36,"TELEORMAN",341,155083,,97,"SMÂRDAN / localul Grădiniţei Smârdan",3,14367,"BECIU",155083,493,317,273,44,0,312,5,542,225,219,93
36,"TELEORMAN",341,155092,,98,"BEUCA / incinta Căminului Cultural Beuca",3,14371,"BEUCA",155092,1011,811,631,99,81,804,7,1117,306,521,283
36,"TELEORMAN",341,155092,,99,"PLOPI / incinta Căminului Cultural Plopi",3,14371,"BEUCA",155092,174,157,95,37,25,152,5,193,36,94,58
36,"TELEORMAN",341,152083,,100,"BLEJEŞTI / clădirea Şcolii Gimnaziale nr. 1 Blejeşti",3,14374,"BLEJEŞTI",152083,996,755,662,93,0,743,12,1086,331,563,180
36,"TELEORMAN",341,152083,,101,"BLEJEŞTI / gradinita cu program normal nr. 1 Blejesti comuna Blejesti",3,14374,"BLEJEŞTI",152083,926,741,652,89,0,731,10,1025,284,571,160
36,"TELEORMAN",341,152083,,102,"BACIU / clădirea Şcolii Gimnaziale nr. 2 Baciu",3,14374,"BLEJEŞTI",152083,884,594,522,70,2,589,5,975,381,402,187
36,"TELEORMAN",341,152083,,103,"SERICU / clădirea Grădiniţei cu program normal nr. 3 Sericu",3,14374,"BLEJEŞTI",152083,331,258,229,29,0,254,4,369,111,186,68
36,"TELEORMAN",341,152127,,104,"BOGDANA / localul Şcolii Generale cu clasele I-VIII Bogdana",3,14378,"BOGDANA",152127,807,665,507,144,14,656,9,894,229,510,146
36,"TELEORMAN",341,152127,,105,"ULMENI / localul fostei Şcoli Generale Ulmeni",3,14378,"BOGDANA",152127,609,475,397,65,13,468,7,669,194,338,130
36,"TELEORMAN",341,152127,,106,"URLUIU / localul fostei Şcoli Generale Urluiu",3,14378,"BOGDANA",152127,562,541,368,142,31,532,9,624,83,402,130
36,"TELEORMAN",341,152172,,107,"BOTOROAGA / localul Şcolii de Arta şi Meserii Botoroaga",3,14383,"BOTOROAGA",152172,1079,836,651,172,13,829,7,1171,335,513,316
36,"TELEORMAN",341,152172,,108,"CĂLUGARU / localul Şcolii cu clasele I-VIII Călugăru",3,14383,"BOTOROAGA",152172,733,511,447,51,13,505,6,809,298,278,227
36,"TELEORMAN",341,152172,,109,"TÎRNAVA / localul Şcolii cu clasele I-VIII Târnava",3,14383,"BOTOROAGA",152172,1121,877,707,165,5,861,16,1234,357,499,362
36,"TELEORMAN",341,152172,,110,"TUNARI / localul Şcolii cu clasele I-IV Tunari",3,14383,"BOTOROAGA",152172,170,156,108,43,5,155,1,189,33,79,76
36,"TELEORMAN",341,152172,,111,"VALEA CIREŞULUI / localul Şcolii cu clasele I-VIII Valea Cireşului",3,14383,"BOTOROAGA",152172,1315,885,737,145,3,871,14,1447,562,508,363
36,"TELEORMAN",341,152234,,112,"BRAGADIRU / localul Primăriei vechi din satul Bragadiru",3,14389,"BRAGADIRU",152234,1136,595,526,64,5,585,10,1257,662,457,128
36,"TELEORMAN",341,152234,,113,"BRAGADIRU / localul Căminului Cultural din satul Bragadiru",3,14389,"BRAGADIRU",152234,1106,595,525,67,3,589,6,1223,628,470,119
36,"TELEORMAN",341,152234,,114,"BRAGADIRU / localul Şcolii Roiba din satul Bragadiru",3,14389,"BRAGADIRU",152234,1183,669,619,46,4,663,6,1351,682,549,114
36,"TELEORMAN",341,152252,,115,"BRÎNCENI / localul Şcolii Gimnaziale Brînceni",3,14391,"BRÎNCENI",152252,1136,867,778,61,28,856,11,1254,387,635,221
36,"TELEORMAN",341,152252,,116,"BRÎNCENI / localul clădirii administrative",3,14391,"BRÎNCENI",152252,1237,903,836,53,14,884,19,1361,458,644,240
36,"TELEORMAN",341,152270,,117,"BUJORENI / localul Căminului Cultural",3,14393,"BUJORENI",152270,491,392,296,95,1,390,2,544,152,264,126
36,"TELEORMAN",341,152270,,118,"PRUNARU / localul Şcolii cu clasele I-IV Prunaru",3,14393,"BUJORENI",152270,359,282,206,73,3,278,4,394,112,196,82
36,"TELEORMAN",341,152314,,119,"BUJORU / incinta Şcolii Gimnaziale Bujoru",3,14397,"BUJORU",152314,714,523,443,71,9,515,8,789,266,272,243
36,"TELEORMAN",341,152314,,120,"BUJORU / incinta Căminului Cultural Bujoru",3,14397,"BUJORU",152314,825,576,506,60,10,570,6,910,334,279,291
36,"TELEORMAN",341,152332,,121,"BUZESCU / CAMIN CULTURAL",3,14399,"BUZESCU",152332,1171,795,691,84,20,780,15,1291,496,304,476
36,"TELEORMAN",341,152332,,122,"BUZESCU / GRADINITA CU PROGRAM NORMAL",3,14399,"BUZESCU",152332,1193,595,529,52,14,590,5,1311,716,218,372
36,"TELEORMAN",341,152332,,123,"BUZESCU / SCOALA GIMNAZIALA BUZESCU",3,14399,"BUZESCU",152332,1220,797,693,70,34,774,23,1350,553,339,435
36,"TELEORMAN",341,152350,,124,"CĂLINEŞTI / localul Şcolii Generale I-VIII Călineşti",3,14401,"CĂLINEŞTI",152350,1250,1048,856,113,79,1041,7,1380,332,849,192
36,"TELEORMAN",341,152350,,125,"LICURICIU / localul Şcolii Generale I-VIII Licuriciu",3,14401,"CĂLINEŞTI",152350,458,366,254,80,32,362,4,506,140,259,103
36,"TELEORMAN",341,152350,,126,"COPĂCEANCA / localul Şcolii Generale I-VIII Copăceanca",3,14401,"CĂLINEŞTI",152350,776,657,490,117,50,649,8,853,196,489,160
36,"TELEORMAN",341,152350,,127,"ANTONEŞTI / localul Şcolii Generale I-IV Antoneşti",3,14401,"CĂLINEŞTI",152350,261,248,174,59,15,246,2,279,31,197,49
36,"TELEORMAN",341,152412,,128,"CĂLMĂŢUIU / localul nou al Şcolii cu clasele I-IV Călmăţuiu",3,14407,"CĂLMĂŢUIU",152412,611,429,358,71,0,421,8,673,244,331,90
36,"TELEORMAN",341,152412,,129,"CARAVANEŢI / localul Şcolii cu clasele I-IV Caravaneti",3,14407,"CĂLMĂŢUIU",152412,241,175,141,34,0,174,1,251,76,136,38
36,"TELEORMAN",341,152412,,130,"BUJORU / localul Şcolii cu clasele I-IV Bujoru",3,14407,"CĂLMĂŢUIU",152412,182,202,114,88,0,200,2,216,14,151,49
36,"TELEORMAN",341,152412,,131,"NICOLAE BĂLCESCU / în localul Şcolii cu clasele I-VIII  Nicolae Bălcescu",3,14407,"CĂLMĂŢUIU",152412,656,429,349,80,0,424,5,725,296,317,107
36,"TELEORMAN",341,152467,,132,"CĂLMĂŢUIU DE SUS / localul Şcolii vechi Călmăţuiu de Sus",3,14412,"CĂLMĂŢUIU DE SUS",152467,702,554,513,41,0,553,1,776,222,303,250
36,"TELEORMAN",341,152467,,133,"IONAŞCU / localul Şcolii Ionaşcu",3,14412,"CĂLMĂŢUIU DE SUS",152467,305,222,193,29,0,220,2,337,115,121,99
36,"TELEORMAN",341,152467,,134,"BĂCĂLEŞTI / localul Sălii de festivităţi a fostului sediu CAP Băcăleşti",3,14412,"CĂLMĂŢUIU DE SUS",152467,863,685,633,52,0,679,6,957,272,360,319
36,"TELEORMAN",341,152500,,135,"CERVENIA / incinta Şcolii cu clasele I-VIII Cervenia",3,14416,"CERVENIA",152500,1367,883,747,104,32,878,5,1505,622,514,364
36,"TELEORMAN",341,152500,,136,"CERVENIA / incinta Şcolii cu clasele I-VIII Cervenia",3,14416,"CERVENIA",152500,1191,768,665,103,0,757,11,1318,550,385,372
36,"TELEORMAN",341,152528,,137,"CIOLĂNEŞTII DIN DEAL / incinta Şcolii Generale nr. 1 Ciolăneştii din Deal",3,14418,"CIOLĂNEŞTI",152528,855,555,481,74,0,546,9,937,382,363,183
36,"TELEORMAN",341,152528,,138,"CIOLĂNEŞTII DIN DEAL / incinta Şcolii Generale nr. 2 Ciolăneştii din Deal",3,14418,"CIOLĂNEŞTI",152528,605,394,337,57,0,392,2,647,253,288,104
36,"TELEORMAN",341,152528,,139,"CIOLĂNEŞTII DIN VALE / incinta Şcolii Generale nr. 3 Ciolăneştii din Vale",3,14418,"CIOLĂNEŞTI",152528,488,351,297,54,0,342,9,557,206,266,76
36,"TELEORMAN",341,152528,,140,"BALDOVINEŞTI / incinta Şcolii Generale Baldovineşti",3,14418,"CIOLĂNEŞTI",152528,390,272,251,21,0,270,2,444,172,172,98
36,"TELEORMAN",341,151709,,141,"CIUPERCENI / Scoala Gimnaziala Ciuperceni",3,14422,"CIUPERCENI",151709,858,610,494,97,19,603,7,945,335,396,207
36,"TELEORMAN",341,151709,,142,"POIANA / localul Şcolii din satul Poiana",3,14422,"CIUPERCENI",151709,558,501,383,99,19,493,8,613,112,275,218
36,"TELEORMAN",341,152564,,143,"CONŢEŞTI / Sala de şedinţă a Consiliului local Conţeşti",3,14425,"CONŢEŞTI",152564,1408,1017,873,100,44,1009,8,1548,531,838,171
36,"TELEORMAN",341,152564,,144,"CONŢEŞTI / localul Grădiniţei Conţeşti",3,14425,"CONŢEŞTI",152564,1404,1080,918,104,58,1073,7,1553,473,867,206
36,"TELEORMAN",341,152582,,145,"COSMEŞTI / localul Şcolii Gimnaziale nr. 2 Cosmeşti",3,14427,"COSMEŞTI",152582,847,680,588,60,32,676,4,931,251,186,490
36,"TELEORMAN",341,152582,,146,"CIUPERCENI / localul Şcolii Gimnazială nr. 1 Ciuperceni",3,14427,"COSMEŞTI",152582,1208,815,714,65,36,810,5,1333,518,268,542
36,"TELEORMAN",341,152662,,147,"CRÂNGU / localul Căminului Cultural din satul Crângu",3,14430,"CRÂNGU",152662,884,567,456,89,22,562,5,979,412,392,170
36,"TELEORMAN",341,152662,,148,"SECARA / localul fostei primării (sediul administrativ) din satul Secara",3,14430,"CRÂNGU",152662,315,285,200,55,30,282,3,349,64,216,66
36,"TELEORMAN",341,151932,,149,"CREVENICU / localul Grădiniţei cu program normal nr. 1 Crevenicu",3,14433,"CREVENICU",151932,792,636,487,84,65,622,14,875,239,410,212
36,"TELEORMAN",341,151932,,150,"RĂDULEŞTI / localul Căminului cultural Răduleşti",3,14433,"CREVENICU",151932,456,346,285,46,15,344,2,526,180,237,107
36,"TELEORMAN",341,152617,,151,"CRÎNGENI / localul Căminului cultural din satul Crîngeni",3,14436,"CRÎNGENI",152617,1326,801,691,82,28,787,14,1359,558,575,212
36,"TELEORMAN",341,152617,,152,"BALTA SĂRATĂ / localul Şcolii cu clasele I-VIII Balta Sărată",3,14436,"CRÎNGENI",152617,710,443,353,67,23,440,3,782,339,324,116
36,"TELEORMAN",341,152617,,153,"DOROBANŢU / localul Şcolii cu clasele I-IV Dorobanţu",3,14436,"CRÎNGENI",152617,242,180,117,63,0,174,6,266,86,130,44
36,"TELEORMAN",341,152617,,154,"STEJARU / localul Şcolii cu clasele I-IV Stejaru",3,14436,"CRÎNGENI",152617,148,179,91,88,0,172,7,214,35,111,61
36,"TELEORMAN",341,152724,,155,"DIDEŞTI / camin cultural Didesti",3,14441,"DIDEŞTI",152724,1022,712,647,56,9,701,11,1122,410,381,320
36,"TELEORMAN",341,152760,,156,"DOBROTEŞTI / localul  Şcolii gimnaziale nr. 1 Dobroteşti",3,14445,"DOBROTEŞTI",152760,1354,812,706,105,1,802,10,1483,671,502,300
36,"TELEORMAN",341,152760,,157,"DOBROTEŞTI / fosta Şcoală  cu clasele I - IV Dobroteşti",3,14445,"DOBROTEŞTI",152760,1389,730,667,63,0,717,13,1545,815,417,300
36,"TELEORMAN",341,152760,,158,"MERIŞANI / localul Şcolii gimnaziale nr. 2 Merişani",3,14445,"DOBROTEŞTI",152760,1037,704,614,90,0,696,8,1155,451,501,195
36,"TELEORMAN",341,155109,,159,"DRACEA / Grădiniţa cu program normal Dracea",3,14448,"DRACEA",155109,1085,629,543,86,0,621,8,1102,473,467,154
36,"TELEORMAN",341,155109,,160,"ZLATA / Şcoala generală Zlata",3,14448,"DRACEA",155109,78,75,49,26,0,74,1,166,91,57,17
36,"TELEORMAN",341,155109,,161,"FLORICA / Căminul Cultural Florica",3,14448,"DRACEA",155109,223,194,158,36,0,193,1,247,53,158,35
36,"TELEORMAN",341,152797,,162,"DRĂCŞENEI / Şcoala cu clasele I-IV Drăcşenei",3,14452,"DRĂCŞENEI",152797,655,432,358,48,26,427,5,726,294,304,123
36,"TELEORMAN",341,152797,,163,"DRĂCŞANI / Şcoala Gimnazială Drăcşani",3,14452,"DRĂCŞENEI",152797,372,270,216,37,17,265,5,411,141,199,66
36,"TELEORMAN",341,152797,,164,"ODOBEASCA / Şcoala cu clasele I-IV Odobeasca",3,14452,"DRĂCŞENEI",152797,457,292,253,25,14,287,5,507,215,195,92
36,"TELEORMAN",341,152868,,165,"DRĂGĂNEŞTI DE VEDE / SCOALA GIMNAZIALA CU CLASELE I-VIII DRAGANESTI DE VEDE",3,14457,"DRĂGĂNEŞTI DE VEDE",152868,1191,787,694,85,8,776,11,1312,525,451,325
36,"TELEORMAN",341,152868,,166,"VĂCĂREŞTI / GRADINITA CU PROGRAM NORMAL NR. 2 VACARESTI",3,14457,"DRĂGĂNEŞTI DE VEDE",152868,534,336,313,23,0,331,5,587,251,150,181
36,"TELEORMAN",341,152902,,167,"DRĂGĂNEŞTI-VLAŞCA / liceul Tehnologic Drăgăneşti Vlaşca",3,14461,"DRĂGĂNEŞTI-VLAŞCA",152902,1768,1122,984,138,0,1108,14,1958,836,727,381
36,"TELEORMAN",341,152902,,168,"DRĂGĂNEŞTI-VLAŞCA / localul Şcolii Gimnaziale Drăgăneşti Vlaşca",3,14461,"DRĂGĂNEŞTI-VLAŞCA",152902,1127,707,593,114,0,703,4,1235,528,466,237
36,"TELEORMAN",341,152902,,169,"VĂCENI / Clădirea Şcolii",3,14461,"DRĂGĂNEŞTI-VLAŞCA",152902,258,159,126,33,0,158,1,275,116,107,51
36,"TELEORMAN",341,152902,,170,"COMOARA / Clădirea Şcolii",3,14461,"DRĂGĂNEŞTI-VLAŞCA",152902,416,287,239,48,0,280,7,459,172,210,70
36,"TELEORMAN",341,155118,,171,"FÂNTÂNELE / GRĂDINIŢA fÂNTÂNELE",3,14465,"FÂNTÂNELE",155118,1456,1154,970,163,21,1137,17,1610,456,685,452
36,"TELEORMAN",341,155127,,172,"FRĂSINET / localul Şcolii gimnaziale Frăsinet",3,14467,"FRĂSINET",155127,1583,1021,900,111,10,1005,16,1868,847,702,303
36,"TELEORMAN",341,155127,,173,"CLĂNIŢA / localul Grădiniţei Clăniţa",3,14467,"FRĂSINET",155127,593,446,379,59,8,439,7,528,82,300,139
36,"TELEORMAN",341,152993,,174,"FRUMOASA / SALA DE SPORT A SCOLII GIMNAZIALE FRUMOASA",3,14470,"FRUMOASA",152993,865,611,536,60,15,601,10,952,341,422,179
36,"TELEORMAN",341,152993,,175,"FRUMOASA / Grădiniţa cu program normal nr. 1 din Cartierul Răreanca",3,14470,"FRUMOASA",152993,501,395,327,58,10,390,5,554,159,291,99
36,"TELEORMAN",341,152993,,176,"PĂULEASCA / Grădiniţa cu program normal nr. 2, Păuleasca",3,14470,"FRUMOASA",152993,441,330,267,63,0,325,5,487,157,195,130
36,"TELEORMAN",341,152948,,177,"FURCULEŞTI / localul Şcolii cu clasele I-VIII Furculeşti",3,14473,"FURCULEŞTI",152948,1400,775,612,142,21,769,6,1545,770,564,205
36,"TELEORMAN",341,152948,,178,"SPĂTĂREI / LOCALUL GRADINITEI SPATAREI",3,14473,"FURCULEŞTI",152948,888,582,490,92,0,578,4,979,397,417,161
36,"TELEORMAN",341,152948,,179,"VOIEVODA / localul Grădiniţei Voievoda",3,14473,"FURCULEŞTI",152948,557,391,328,63,0,386,5,611,220,241,145
36,"TELEORMAN",341,153026,,180,"GĂLĂTENI / localul Şcolii cu clasele I-VIII Gălăteni",3,14478,"GĂLĂTENI",153026,1309,863,711,118,34,858,5,1454,591,653,205
36,"TELEORMAN",341,153026,,181,"BÎSCOVENI / localul Grădiniţei Bâscoveni",3,14478,"GĂLĂTENI",153026,929,693,553,111,29,684,9,1019,326,477,207
36,"TELEORMAN",341,153062,,182,"GRATIA / NULL",3,14482,"GRATIA",153062,983,805,684,111,10,794,11,1086,281,656,138
36,"TELEORMAN",341,153062,,183,"CIURARI-DEAL / NULL",3,14482,"GRATIA",153062,1235,982,840,122,20,973,9,1359,377,776,197
36,"TELEORMAN",341,151736,,184,"ISLAZ / Camin Cultural",3,14486,"ISLAZ",151736,1352,951,844,88,19,942,9,1483,532,628,314
36,"TELEORMAN",341,151736,,185,"ISLAZ / Gradinita de copii nr. 2",3,14486,"ISLAZ",151736,1581,975,876,88,11,956,19,1744,769,624,332
36,"TELEORMAN",341,151736,,186,"ISLAZ / Şcoala Generala nr. 1Islaz",3,14486,"ISLAZ",151736,821,555,485,63,7,544,11,910,355,389,155
36,"TELEORMAN",341,151736,,187,"MOLDOVENI / Şcoala Generala Moldoveni",3,14486,"ISLAZ",151736,817,600,505,61,34,587,13,901,301,398,189
36,"TELEORMAN",341,153106,,188,"IZVOARELE / localul fostei Grădiniţe de copii",3,14489,"IZVOARELE",153106,1194,828,744,76,8,825,3,1314,486,481,344
36,"TELEORMAN",341,153106,,189,"IZVOARELE / localul Şcolii noi fără etaj",3,14489,"IZVOARELE",153106,1001,747,668,78,1,745,2,1104,357,412,333
36,"TELEORMAN",341,153124,,190,"LISA / localul Primăriei Lisa",3,14491,"LISA",153124,1360,887,750,77,60,883,4,1502,615,374,509
36,"TELEORMAN",341,153124,,191,"VÎNĂTORI / Grădinţa Vânători",3,14491,"LISA",153124,575,468,354,65,49,465,3,633,165,250,215
36,"TELEORMAN",341,151763,,192,"LIŢA / localul Şcolii cu clasele I-VIII Liţa, (Şcoala veche)",3,14494,"LIŢA",151763,1167,788,681,102,5,785,3,1236,448,525,260
36,"TELEORMAN",341,151763,,193,"LIŢA / localul Grădiniţei nr. 2 Liţa",3,14494,"LIŢA",151763,1191,771,695,68,8,758,13,1350,579,540,218
36,"TELEORMAN",341,153151,,194,"LUNCA / localul Şcolii Gimnaziale nr. 1 Lunca",3,14496,"LUNCA",153151,1021,619,527,81,11,613,6,1126,507,428,185
36,"TELEORMAN",341,153151,,195,"LUNCA / localul Grădiniţei cu program normal nr. 1 Lunca",3,14496,"LUNCA",153151,602,452,361,85,6,449,3,660,208,314,135
36,"TELEORMAN",341,153151,,196,"PRUNDU / în localul Şcolii Gimnaziale nr. 2 Prundu",3,14496,"LUNCA",153151,1096,495,478,17,0,488,7,1203,708,393,95
36,"TELEORMAN",341,153204,,197,"MAVRODIN / Şcoala Gimnazială Mavrodin",3,14504,"MAVRODIN",153204,1082,657,593,64,0,653,4,1187,530,436,217
36,"TELEORMAN",341,153204,,198,"MAVRODIN / Caminul Cultural Mavrodin",3,14504,"MAVRODIN",153204,1021,660,597,62,1,652,8,1128,468,404,248
36,"TELEORMAN",341,153240,,199,"MĂGURA / localul Căminului cultural Măgura",3,14499,"MĂGURA",153240,1558,1234,1023,155,56,1211,23,1714,480,817,394
36,"TELEORMAN",341,153240,,200,"GURUIENI / localul Şcolii cu clasele I - VIII Guruieni",3,14499,"MĂGURA",153240,832,678,543,98,37,673,5,895,217,478,195
36,"TELEORMAN",341,153277,,201,"MĂLDĂENI / localul Şcolii Generale cu clasele I - VIII  nr. 1 Măldăeni",3,14502,"MĂLDĂENI",153277,1230,853,745,76,32,841,12,1345,492,591,250
36,"TELEORMAN",341,153277,,202,"MĂLDĂENI / localul Grădiniţei nr. 1 (Bidoiu)",3,14502,"MĂLDĂENI",153277,1014,660,604,43,13,650,10,1117,457,442,208
36,"TELEORMAN",341,153277,,203,"MĂLDĂENI / localul Grădiniţei de copii nr. 2",3,14502,"MĂLDĂENI",153277,1367,905,822,49,34,891,14,1502,597,577,314
36,"TELEORMAN",341,153295,,204,"MERENII DE JOS / localul Şcolii gimnaziale Mereni",3,14506,"MERENI",153295,1381,970,809,161,0,959,11,1522,552,364,595
36,"TELEORMAN",341,153295,,205,"MERENII DE SUS / localul fostei Şcoli generale cu cls I-VIII",3,14506,"MERENI",153295,865,625,535,90,0,612,13,954,329,352,260
36,"TELEORMAN",341,153339,,206,"CERNETU / localul Şcolii gimnaziale cu clasele I-IV Cernetu",3,14510,"MÎRZĂNEŞTI",153339,1141,912,725,154,33,899,13,1262,350,457,442
36,"TELEORMAN",341,153339,,207,"VALEA PĂRULUI / Grădiniţa Valea Părului",3,14510,"MÎRZĂNEŞTI",153339,709,636,471,143,22,627,9,787,151,306,321
36,"TELEORMAN",341,153339,,208,"MÎRZĂNEŞTI / localul Şcolii gimnaziale cu cls.I-VIII mîrzăneşti",3,14510,"MÎRZĂNEŞTI",153339,526,444,344,96,4,439,5,579,135,212,227
36,"TELEORMAN",341,153339,,209,"TELEORMANU / localul Şcolii gimnaziale cu clasele I-IV Teleormanu",3,14510,"MÎRZĂNEŞTI",153339,790,685,500,142,43,678,7,873,188,439,239
36,"TELEORMAN",341,153384,,210,"MOŞTENI / Scoala Gimnaziala Mosteni",3,14515,"MOŞTENI",153384,717,647,513,89,45,637,10,791,144,134,503
36,"TELEORMAN",341,153384,,211,"MOŞTENI / Şcoala Gimnazială Moşteni",3,14515,"MOŞTENI",153384,520,447,343,73,31,442,5,591,144,113,329
36,"TELEORMAN",341,151816,,212,"NANOV / localul Şcolii gimnaziale Nanov",3,14517,"NANOV",151816,1706,1072,1001,71,0,1066,6,1873,801,621,445
36,"TELEORMAN",341,151816,,213,"NANOV / localul Grădiniţei cu program normal nr. 2 Nanov",3,14517,"NANOV",151816,1403,899,849,49,1,885,14,1555,656,522,363
36,"TELEORMAN",341,153400,,214,"NĂSTURELU / localul Şcolii Năsturelu",3,14519,"NĂSTURELU",153400,1329,829,784,45,0,817,12,1468,639,430,387
36,"TELEORMAN",341,153400,,215,"ZIMNICELE / localul Şcolii Zimnicele",3,14519,"NĂSTURELU",153400,876,565,522,43,0,558,7,958,393,352,206
36,"TELEORMAN",341,153437,,216,"NECŞEŞTI / localul Şcolii cu clasele I-IV Necşeşti",3,14522,"NECŞEŞTI",153437,483,366,263,103,0,357,9,533,167,205,152
36,"TELEORMAN",341,153437,,217,"GÎRDEŞTI / localul Şcolii cu clasele I-VIII Gârdeşti",3,14522,"NECŞEŞTI",153437,491,338,289,49,0,334,4,544,206,241,93
36,"TELEORMAN",341,154996,,218,"NENCIULEŞTI / Scoala gimnaziala",3,14526,"NENCIULEŞTI",154996,745,481,385,96,0,472,9,820,339,323,149
36,"TELEORMAN",341,154996,,219,"NENCIULEŞTI / Gradinita Nenciulesti",3,14526,"NENCIULEŞTI",154996,830,509,442,67,0,502,7,916,407,375,127
36,"TELEORMAN",341,154996,,220,"PĂRU ROTUND / Gradinita Paru Rotund",3,14526,"NENCIULEŞTI",154996,475,372,331,41,0,370,2,524,152,306,64
36,"TELEORMAN",341,153473,,221,"OLTENI / localul Şcolii gimnaziale Olteni",3,14529,"OLTENI",153473,1539,1046,921,97,28,1041,5,1699,653,835,206
36,"TELEORMAN",341,153473,,222,"PERII BROŞTENI / în localul Şcolii gimnaziale Perii Broşteni",3,14529,"OLTENI",153473,952,798,733,65,0,793,5,1056,258,649,144
36,"TELEORMAN",341,153507,,223,"ORBEASCA DE JOS / Scoala cu cls.I-VIII Orbeasca de Jos",3,14532,"ORBEASCA",153507,834,510,443,64,3,501,9,916,406,383,118
36,"TELEORMAN",341,153507,,224,"ORBEASCA DE JOS / Scoala cu cls.I-VIII Orbeasca de Jos",3,14532,"ORBEASCA",153507,1092,697,573,105,19,693,4,1202,505,541,152
36,"TELEORMAN",341,153507,,225,"ORBEASCA DE SUS / Scoala cu cls.I-VIII Orbeasca de Sus",3,14532,"ORBEASCA",153507,1156,793,677,106,10,784,9,1271,478,564,220
36,"TELEORMAN",341,153507,,226,"ORBEASCA DE SUS / Scoala cu cls.I-VIII Orbeasca de Sus",3,14532,"ORBEASCA",153507,1297,869,737,117,15,861,8,1427,558,660,201
36,"TELEORMAN",341,153507,,227,"LĂCENI / Scoala cu cls.I-VIII Laceni",3,14532,"ORBEASCA",153507,973,617,554,57,6,612,5,1069,452,477,135
36,"TELEORMAN",341,153507,,228,"LĂCENI / Scoala cu cls.I-VIII Laceni",3,14532,"ORBEASCA",153507,1067,692,610,65,17,687,5,1173,481,545,142
36,"TELEORMAN",341,153543,,229,"PERETU / localul Şcolii cu clasele I -VIII Peretu",3,14536,"PERETU",153543,1030,647,593,54,0,636,11,1133,486,346,290
36,"TELEORMAN",341,153543,,230,"PERETU / localul Şcolii cu clasele I -VIII Peretu",3,14536,"PERETU",153543,1206,731,684,47,0,721,10,1331,600,410,311
36,"TELEORMAN",341,153543,,231,"PERETU / localul Căminului Cultural Peretu",3,14536,"PERETU",153543,1340,792,734,58,0,782,10,1470,678,423,359
36,"TELEORMAN",341,153543,,232,"PERETU / localul Grădiniţei Peretu",3,14536,"PERETU",153543,1388,844,783,61,0,831,13,1521,677,392,439
36,"TELEORMAN",341,153543,,233,"PERETU / localul Grădiniţei Peretu",3,14536,"PERETU",153543,1183,659,601,58,0,649,10,1303,644,416,233
36,"TELEORMAN",341,153561,,234,"PIATRA / localul Şcolii gimnaziale Piatra",3,14538,"PIATRA",153561,965,716,637,79,0,702,14,1066,350,535,167
36,"TELEORMAN",341,153561,,235,"PIATRA / localul  Gradiniţei din centrul comunei Piatra",3,14538,"PIATRA",153561,841,645,522,123,0,637,8,927,282,463,174
36,"TELEORMAN",341,153561,,236,"PIATRA / localul CONSUMCOOP Piatra",3,14538,"PIATRA",153561,926,648,567,81,0,635,13,1020,372,505,130
36,"TELEORMAN",341,153589,,237,"PIETROŞANI / localul Şcolii vechi din şosea",3,14540,"PIETROŞANI",153589,1033,618,517,99,2,612,6,1132,514,351,261
36,"TELEORMAN",341,153589,,238,"PIETROŞANI / localul şcolii noi",3,14540,"PIETROŞANI",153589,1243,703,610,93,0,694,9,1373,670,408,286
36,"TELEORMAN",341,153623,,239,"PLOPII-SLĂVITEŞTI / localul Şcolii gimnaziale Plopii Slăviteşti",3,14542,"PLOPII-SLĂVITEŞTI",153623,613,486,399,87,0,484,2,679,193,224,260
36,"TELEORMAN",341,153623,,240,"BRÎNCOVEANCA / localul Grădiniţei de copii Brâncoveanca",3,14542,"PLOPII-SLĂVITEŞTI",153623,853,624,555,64,5,614,10,945,321,359,255
36,"TELEORMAN",341,153623,,241,"DUDU / localul Grădiniţei de copii Dudu",3,14542,"PLOPII-SLĂVITEŞTI",153623,635,465,406,57,2,459,6,699,234,214,245
36,"TELEORMAN",341,153605,,242,"PLOSCA / localul Căminului Cultural",3,14546,"PLOSCA",153605,1432,912,825,87,0,901,11,1578,666,419,482
36,"TELEORMAN",341,153605,,243,"PLOSCA / localul Şcolii Răsfiraţi",3,14546,"PLOSCA",153605,1437,962,878,84,0,947,15,1584,622,441,506
36,"TELEORMAN",341,153605,,244,"PLOSCA / localul Şcolii Mari",3,14546,"PLOSCA",153605,805,494,431,63,0,487,7,888,394,258,229
36,"TELEORMAN",341,153605,,245,"PLOSCA / localul Şcolii Mica Deal",3,14546,"PLOSCA",153605,1275,788,725,63,0,780,8,1401,613,303,477
36,"TELEORMAN",341,153696,,246,"POENI / localul Şcolii Generale Poeni, satul Poeni",3,14548,"POENI",153696,1174,782,656,122,4,775,7,1302,520,454,321
36,"TELEORMAN",341,153696,,247,"PREAJBA / localul Şcolii Primare Preajba",3,14548,"POENI",153696,325,219,195,24,0,216,3,379,160,137,79
36,"TELEORMAN",341,153696,,248,"VĂTAŞI / localul Şcolii generale Vătaşi",3,14548,"POENI",153696,514,321,291,30,0,317,4,564,243,182,135
36,"TELEORMAN",341,153696,,249,"CĂTUNU / localul Şcolii Primare Cătunu",3,14548,"POENI",153696,364,240,191,49,0,240,0,366,126,167,73
36,"TELEORMAN",341,151834,,250,"POROSCHIA / Şcoala gimnazială Poroschia",3,14556,"POROSCHIA",151834,1514,1040,918,116,6,1015,25,1658,618,714,301
36,"TELEORMAN",341,151834,,251,"POROSCHIA / Sc. Gen. Poroschia",3,14556,"POROSCHIA",151834,1414,1343,963,323,57,1326,17,1554,211,926,400
36,"TELEORMAN",341,151834,,252,"CALOMFIREŞTI / Sc. Gen. Calomfiresti",3,14556,"POROSCHIA",151834,936,728,630,98,0,721,7,1028,300,515,206
36,"TELEORMAN",341,155136,,253,"PURANI / localul Şcolii Gimnaziale Puranii de Sus",3,14559,"PURANI",155136,1225,808,735,66,7,795,13,1346,538,534,261
36,"TELEORMAN",341,153829,,254,"PUTINEIU / Şcoala cu cls. I-IV Putineiu",3,14562,"PUTINEIU",153829,1163,950,808,133,9,934,16,1276,326,671,263
36,"TELEORMAN",341,153829,,255,"BĂDULEASA / Grădiniţa de copii Băduleasa",3,14562,"PUTINEIU",153829,648,527,416,109,2,511,16,733,206,362,149
36,"TELEORMAN",341,153865,,256,"RĂDOIEŞTI-VALE / localul Căminului Cultural",3,14566,"RĂDOIEŞTI",153865,546,398,319,73,6,395,3,605,207,311,84
36,"TELEORMAN",341,153865,,257,"RĂDOIEŞTI-DEAL / localul Şcolii Gimnaziale Rădoieşti Deal",3,14566,"RĂDOIEŞTI",153865,896,733,676,53,4,725,8,989,256,601,124
36,"TELEORMAN",341,153865,,258,"CETATEA / localul Grădiniţei cu program normal",3,14566,"RĂDOIEŞTI",153865,328,271,204,63,4,269,2,360,89,225,44
36,"TELEORMAN",341,153909,,259,"RĂSMIREŞTI / localul Căminului Cultural Răsmireşti",3,14570,"RĂSMIREŞTI",153909,703,489,366,123,0,484,5,783,294,343,141
36,"TELEORMAN",341,155145,,260,"SAELELE / localul Şcolii cu claseleI-VIII Saelele",3,14577,"SAELELE",155145,1372,1021,852,121,48,1009,12,1507,486,765,244
36,"TELEORMAN",341,155145,,261,"PLEAŞOV / localul Şcolii cu clasele I-IV Pleaşov",3,14577,"SAELELE",155145,720,581,489,79,13,574,7,794,213,483,91
36,"TELEORMAN",341,153936,,262,"SALCIA / localul Căminului Cultural Salcia",3,14580,"SALCIA",153936,886,609,457,120,32,606,3,975,366,439,167
36,"TELEORMAN",341,153936,,263,"BĂNEASA / localul Căminului Cultural din satul Băneasa",3,14580,"SALCIA",153936,758,594,481,91,22,592,2,833,239,471,121
36,"TELEORMAN",341,153936,,264,"TUDOR VLADIMIRESCU / localul Căminului Cultural din satul Tudor Vladimirescu",3,14580,"SALCIA",153936,685,486,401,72,13,481,5,761,275,383,98
36,"TELEORMAN",341,153972,,265,"SĂCENI / localul Şcolii cu clasele I-VIII Săceni",3,14573,"SĂCENI",153972,636,454,362,62,30,447,7,706,252,359,88
36,"TELEORMAN",341,153972,,266,"CIURARI / Şcolii generale din satul Ciurari",3,14573,"SĂCENI",153972,432,357,284,56,17,351,6,477,120,246,105
36,"TELEORMAN",341,154013,,267,"SCRIOAŞTEA / localul Căminul  Cultural Scrioaştea",3,14584,"SCRIOAŞTEA",154013,1953,1337,1204,119,14,1323,14,2204,867,994,329
36,"TELEORMAN",341,154013,,268,"BREBINA / localul Grădiniţei Brebina",3,14584,"SCRIOAŞTEA",154013,653,456,399,57,0,452,4,719,263,305,147
36,"TELEORMAN",341,154013,,269,"CUCUEŢI / localul Căminului Cultural Cucueţi",3,14584,"SCRIOAŞTEA",154013,709,499,433,63,3,492,7,686,187,311,181
36,"TELEORMAN",341,154068,,270,"SCURTU MARE / localul Şcolii Generale cu clasele I - VIII Scurtu Mare",3,14589,"SCURTU MARE",154068,922,712,577,97,38,694,18,1021,309,505,189
36,"TELEORMAN",341,154068,,271,"DRĂCEŞTI / localul Şcolii cu clasele I-IV Dracesti",3,14589,"SCURTU MARE",154068,294,250,184,44,22,250,0,293,43,196,54
36,"TELEORMAN",341,154068,,272,"ALBENI / localul Şcolii cu clasele I-IV Albeni",3,14589,"SCURTU MARE",154068,191,143,91,35,17,138,5,214,71,98,40
36,"TELEORMAN",341,154139,,273,"SEACA / localul Grădiniţei Seaca",3,14596,"SEACA",154139,1283,625,530,82,13,613,12,1415,790,383,230
36,"TELEORMAN",341,154139,,274,"NĂVODARI / localul Grădiniţei Năvodari",3,14596,"SEACA",154139,755,445,400,44,1,437,8,835,390,252,185
36,"TELEORMAN",341,154184,,275,"SEGARCEA-VALE / localul Şcolii cu clasele I-VIII Segarcea Vale",3,14599,"SEGARCEA-VALE",154184,884,641,526,102,13,634,7,964,323,458,176
36,"TELEORMAN",341,154184,,276,"OLTEANCA / localul Şcolii cu clasele I-VIII Olteanca",3,14599,"SEGARCEA-VALE",154184,756,572,460,97,15,558,14,839,267,423,135
36,"TELEORMAN",341,154184,,277,"SEGARCEA-DEAL / localul Şcolii cu clasele I-VIII Segarcea Deal",3,14599,"SEGARCEA-VALE",154184,1018,702,610,71,21,693,9,1127,425,481,212
36,"TELEORMAN",341,154166,,278,"SFINŢEŞTI / localul Căminului Cultural Sfinţeşti",3,14603,"SFINŢEŞTI",154166,982,769,610,115,44,763,6,1082,313,367,396
36,"TELEORMAN",341,154228,,279,"SILIŞTEA / Căminul Cultural Siliştea",3,14605,"SILIŞTEA",154228,1124,865,756,109,0,850,15,1239,374,345,505
36,"TELEORMAN",341,154228,,280,"BUTEŞTI / localul Şcolii cu clasele I - IV Buteşti",3,14605,"SILIŞTEA",154228,562,408,342,66,0,402,6,622,214,202,200
36,"TELEORMAN",341,154228,,281,"SILIŞTEA MICĂ / localul Şcolii cu clasele I - IV Şiliştea Mică",3,14605,"SILIŞTEA",154228,286,178,150,28,0,175,3,279,101,65,110
36,"TELEORMAN",341,154282,,282,"SILIŞTEA-GUMEŞTI / Centrul Memorial Marin Preda",3,14609,"SILIŞTEA-GUMEŞTI",154282,1248,734,614,115,5,723,11,1367,633,468,255
36,"TELEORMAN",341,154282,,283,"SILIŞTEA-GUMEŞTI / Scoala cu clasele I-IV Magura",3,14609,"SILIŞTEA-GUMEŞTI",154282,879,523,465,56,2,521,2,971,448,350,171
36,"TELEORMAN",341,154308,,284,"UDENI / Grădiniţa cu program normal nr. 3",3,14611,"SÎRBENI",154308,366,322,256,64,2,315,7,404,82,248,67
36,"TELEORMAN",341,154308,,285,"SÎRBENI / Grădiniţa cu program normal nr. 2",3,14611,"SÎRBENI",154308,576,393,333,58,2,385,8,667,274,297,88
36,"TELEORMAN",341,154308,,286,"SÎRBENII DE JOS / localul Şcolii Gimnaziale Sârbenii de Jos",3,14611,"SÎRBENI",154308,220,174,132,42,0,173,1,242,68,100,73
36,"TELEORMAN",341,154344,,287,"SLOBOZIA MÂNDRA / localul Şcolii Gimnaziale Slobozia Mândra",3,14615,"SLOBOZIA MÂNDRA",154344,703,571,465,106,0,565,6,747,176,467,98
36,"TELEORMAN",341,154344,,288,"SLOBOZIA MÂNDRA / localul Şcolii Gimnaziale Slobozia Mândra",3,14615,"SLOBOZIA MÂNDRA",154344,823,622,548,73,1,617,5,935,313,457,160
36,"TELEORMAN",341,154380,,289,"SMÎRDIOASA / localul Şcolii cu clasele I - VIII Smârdioasa",3,14617,"SMÎRDIOASA",154380,1589,1050,941,108,1,1028,22,1754,704,716,312
36,"TELEORMAN",341,154380,,290,"ŞOIMU / localul Şcolii Soimu",3,14617,"SMÎRDIOASA",154380,377,290,233,57,0,287,3,418,128,170,117
36,"TELEORMAN",341,154415,,291,"STEJARU / Cladirea caminului cultural Stejaru",3,14620,"STEJARU",154415,632,628,442,169,17,627,1,699,71,458,169
36,"TELEORMAN",341,154415,,292,"SOCETU / localul fostei Şcoli cu clasele I - IV Socetu",3,14620,"STEJARU",154415,654,649,464,160,25,642,7,723,74,408,234
36,"TELEORMAN",341,154415,,293,"BRATCOVU / localul fostei primării Bratcovu",3,14620,"STEJARU",154415,132,134,82,48,4,133,1,192,58,101,32
36,"TELEORMAN",341,154415,,294,"GRESIA / clădirea fostei Şcoli generale Gresia",3,14620,"STEJARU",154415,102,140,69,68,3,139,1,214,74,88,51
36,"TELEORMAN",341,154460,,295,"SUHAIA / localul Şcolii Gimnaziale Suhaia",3,14628,"SUHAIA",154460,983,722,605,103,14,720,2,1085,363,347,373
36,"TELEORMAN",341,154460,,296,"SUHAIA / localul Şcolii Gimnaziale Suhaia",3,14628,"SUHAIA",154460,1054,809,663,126,20,800,9,1160,351,272,528
36,"TELEORMAN",341,154497,,297,"ŞTOROBĂNEASA / Scoala Gimnaziala ""Vasile Racotta""",3,14625,"ŞTOROBĂNEASA",154497,1466,997,877,104,16,976,21,1615,618,729,247
36,"TELEORMAN",341,154497,,298,"BEIU / Scoala cu clasele I-VIII "" Badea Negreanu """,3,14625,"ŞTOROBĂNEASA",154497,1237,832,712,108,12,822,10,1359,527,633,189
36,"TELEORMAN",341,154521,,299,"TALPA-OGRĂZILE / localul Şcolii Gimnaziale Talpa",3,14630,"TALPA",154521,842,753,543,119,91,740,13,928,175,591,149
36,"TELEORMAN",341,154521,,300,"TALPA-BÎSCOVENI / localul Şcolii primare Talpa",3,14630,"TALPA",154521,760,597,504,64,29,588,9,838,241,445,143
36,"TELEORMAN",341,154585,,301,"TĂTĂRĂŞTII DE JOS / localul Şcolii gimnaziale Tătărăştii de Jos",3,14636,"TĂTĂRĂŞTII DE JOS",154585,1268,791,659,130,2,778,13,1397,606,523,255
36,"TELEORMAN",341,154585,,302,"SLĂVEŞTI / localul Şcolii Generale cu clasele I - VIII Slăveşti",3,14636,"TĂTĂRĂŞTII DE JOS",154585,849,507,431,61,15,502,5,938,431,281,221
36,"TELEORMAN",341,154585,,303,"NEGRENI / localul Şcolii cu clasele I - IV Negreni",3,14636,"TĂTĂRĂŞTII DE JOS",154585,789,429,365,64,0,416,13,875,446,319,97
36,"TELEORMAN",341,154665,,304,"TĂTĂRĂŞTII DE SUS /  In localul Şcolii cu cls.I-IV Tătărăştii de Sus",3,14644,"TĂTĂRĂŞTII DE SUS",154665,1128,831,703,128,0,818,13,1243,412,399,419
36,"TELEORMAN",341,154665,,305,"UDUPU / In localul Şcolii cu cls.I-IV Udupu",3,14644,"TĂTĂRĂŞTII DE SUS",154665,1236,856,736,120,0,840,16,1359,503,415,425
36,"TELEORMAN",341,154736,,306,"TRAIAN / localul fostei Grădiniţe",3,14650,"TRAIAN",154736,707,497,429,44,24,490,7,763,266,366,124
36,"TELEORMAN",341,154736,,307,"TRAIAN / localul Şcolii cu clasele I - VIII Traian",3,14650,"TRAIAN",154736,879,579,501,62,16,567,12,983,404,382,185
36,"TELEORMAN",341,154754,,308,"TRIVALEA-MOŞTENI / localul Şcolii cu clasele I - VIII Trivalea Moşteni",3,14652,"TRIVALEA-MOŞTENI",154754,791,511,426,85,0,505,6,867,356,241,264
36,"TELEORMAN",341,154754,,309,"BRĂTĂŞANI / localul Şcolii Generale Brătăşani",3,14652,"TRIVALEA-MOŞTENI",154754,552,411,315,96,0,406,5,648,237,195,211
36,"TELEORMAN",341,154754,,310,"DEPARAŢI / localul Şcolii  Alexandru Deparateanu - Deparaţi",3,14652,"TRIVALEA-MOŞTENI",154754,944,508,440,68,0,501,7,1037,529,311,190
36,"TELEORMAN",341,154790,,311,"TROIANUL / localul Şcolii Ion Preotu",3,14656,"TROIANUL",154790,1408,960,843,117,0,950,10,1549,589,543,407
36,"TELEORMAN",341,154790,,312,"TROIANUL / local scoala nr.2",3,14656,"TROIANUL",154790,883,600,537,63,0,589,11,972,372,325,264
36,"TELEORMAN",341,154790,,313,"VATRA / localul Şcolii Generale Vatra",3,14656,"TROIANUL",154790,191,131,114,17,0,128,3,209,78,79,49
36,"TELEORMAN",341,154790,,314,"DULCENI / localul Căminului Cultural Dulceni",3,14656,"TROIANUL",154790,81,78,49,29,0,77,1,90,12,45,32
36,"TELEORMAN",341,154834,,315,"ŢIGĂNEŞTI / localul Şcolii cu clasele I-IV din com. Ţigăneşti",3,14648,"ŢIGĂNEŞTI",154834,1510,974,894,72,8,960,14,1664,690,711,249
36,"TELEORMAN",341,154834,,316,"ŢIGĂNEŞTI / localul Grădiniţei de copii de lângă Primăria Ţigăneşti",3,14648,"ŢIGĂNEŞTI",154834,1410,941,861,69,11,936,5,1559,618,638,298
36,"TELEORMAN",341,154834,,317,"ŢIGĂNEŞTI / localul Şcolii Gimnaziale ,,I.GH. DUCA"" din com. Ţigăneşti",3,14648,"ŢIGĂNEŞTI",154834,1500,1018,932,71,15,1007,11,1645,627,757,250
36,"TELEORMAN",341,155154,,318,"UDA-CLOCOCIOV / localul Căminului Cultural Uda Clocociov",3,14660,"UDA-CLOCOCIOV",155154,731,538,461,70,7,532,6,811,273,396,136
36,"TELEORMAN",341,155154,,319,"UDA-PACIUREA / localul Şcolii cu clasele I - VIII Uda Paciurea",3,14660,"UDA-CLOCOCIOV",155154,712,499,415,75,9,490,9,784,285,342,148
36,"TELEORMAN",341,154852,,320,"VEDEA / localul Şcolii cu cls. I-VIII Vedea",3,14663,"VEDEA",154852,516,394,350,43,1,337,57,563,169,289,48
36,"TELEORMAN",341,154852,,321,"ALBEŞTI / localul Şcolii cu cls. I-IV Albeşti",3,14663,"VEDEA",154852,591,423,390,32,1,370,53,677,254,360,10
36,"TELEORMAN",341,154852,,322,"COŞOTENI / localul Şcolii cu clasele I - IV Coşoteni",3,14663,"VEDEA",154852,477,310,286,24,0,273,37,524,214,224,49
36,"TELEORMAN",341,154852,,323,"DULCEANCA / localul Şcolii cu clasele I - VIII Dulceanca",3,14663,"VEDEA",154852,467,356,307,45,4,318,38,518,162,270,48
36,"TELEORMAN",341,154852,,324,"MERI / localul Şcolii cu clasele I - IV Meri",3,14663,"VEDEA",154852,386,284,250,32,2,267,17,408,124,244,23
36,"TELEORMAN",341,154914,,325,"VIIŞOARA / localul Şcolii cu clasele I-VIII",3,14669,"VIIŞOARA",154914,828,654,519,74,61,645,9,916,262,309,336
36,"TELEORMAN",341,154914,,326,"VIIŞOARA / localul Grădiniţei  de copii",3,14669,"VIIŞOARA",154914,689,578,463,83,32,573,5,763,185,258,315
36,"TELEORMAN",341,153776,,327,"PURANI / Sediul fostei Şcoli Generale cu clasele I - IV Purani",3,14675,"VITĂNEŞTI",153776,627,512,397,86,29,505,7,688,176,326,179
36,"TELEORMAN",341,153776,,328,"SILIŞTEA / Sediul fostei Şcoli Generale Şiliştea",3,14675,"VITĂNEŞTI",153776,752,669,439,158,72,664,5,828,159,556,108
36,"TELEORMAN",341,153776,,329,"VITANESTI / Sediul fostei Şcoli cu clasele I - IV Vităneşti",3,14675,"VITĂNEŞTI",153776,962,805,594,137,74,798,7,1061,256,624,174
36,"TELEORMAN",341,154932,,330,"VÎRTOAPELE DE SUS / localul Căminului Cultural Vîrtoape de Sus",3,14671,"VÎRTOAPE",154932,902,736,590,146,0,724,12,988,252,300,424
36,"TELEORMAN",341,154932,,331,"VÎRTOAPELE DE JOS / localul Căminului Şcolii cu clasele I - VIII Vîrtoape de Jos",3,14671,"VÎRTOAPE",154932,788,602,478,124,0,595,7,869,267,284,311
36,"TELEORMAN",341,154932,,332,"GĂRĂGĂU / localul Căminului Cultural Gărăgău",3,14671,"VÎRTOAPE",154932,615,434,395,39,0,431,3,677,243,169,262
36,"TELEORMAN",341,154978,,333,"ZÎMBREASCA / localul Căminului Cultural Zâmbreasca",3,14680,"ZÎMBREASCA",154978,834,581,513,51,17,576,5,921,340,389,187
36,"TELEORMAN",341,154978,,334,"ZÎMBREASCA / localul Şcolii cu clasele I - IV din comuna Zâmbreasca",3,14680,"ZÎMBREASCA",154978,431,346,281,47,18,341,5,475,129,282,59
37,"TIMIŞ","#N/A",155243,,1,"TIMIŞOARA / Universitatea de Medicina",1,14683,"MUNICIPIUL TIMIŞOARA",155243,1335,979,548,397,34,967,12,1477,498,293,674
37,"TIMIŞ","#N/A",155243,,2,"TIMIŞOARA / Universitatea de Medicină",1,14683,"MUNICIPIUL TIMIŞOARA",155243,1161,938,580,349,9,928,10,1285,347,280,648
37,"TIMIŞ","#N/A",155243,,3,"TIMIŞOARA / Liceul Pedagogic "" Carmen Sylva""",1,14683,"MUNICIPIUL TIMIŞOARA",155243,717,652,381,230,41,642,10,984,332,217,425
37,"TIMIŞ","#N/A",155243,,4,"TIMIŞOARA / Grup Şcolar Industrial ""Emanuil Ungureanu""",1,14683,"MUNICIPIUL TIMIŞOARA",155243,710,673,392,280,1,663,10,981,308,195,468
37,"TIMIŞ","#N/A",155243,,5,"TIMIŞOARA / Liceul Teoretic ""Nikolaus Lenau"" - Corp cladire Scoala cu clasele I-IV",1,14683,"MUNICIPIUL TIMIŞOARA",155243,809,708,440,148,120,694,14,888,180,230,464
37,"TIMIŞ","#N/A",155243,,6,"TIMIŞOARA / Liceul Teoretic ""Nikolaus Lenau"" - Corp cladire Scoala cu clasele I-IV",1,14683,"MUNICIPIUL TIMIŞOARA",155243,766,529,378,135,16,526,3,845,316,161,365
37,"TIMIŞ","#N/A",155243,,7,"TIMIŞOARA / Liceul Teoretic ""Nikolaus Lenau"" - Corp cladire Scoala cu clasele I-IV",1,14683,"MUNICIPIUL TIMIŞOARA",155243,964,864,482,210,172,853,11,1072,208,310,543
37,"TIMIŞ","#N/A",155243,,8,"TIMIŞOARA / Colegiul Tehnic ""Henri Coandă""",1,14683,"MUNICIPIUL TIMIŞOARA",155243,898,601,460,141,0,589,12,987,386,179,410
37,"TIMIŞ","#N/A",155243,,9,"TIMIŞOARA / Colegiul Tehnic ""Henry Coanda""",1,14683,"MUNICIPIUL TIMIŞOARA",155243,1327,836,734,102,0,817,19,1459,623,274,543
37,"TIMIŞ","#N/A",155243,,10,"TIMIŞOARA / Liceul Teologic Romano Catolic Gerhardinum""",1,14683,"MUNICIPIUL TIMIŞOARA",155243,879,647,492,151,4,638,9,967,320,232,406
37,"TIMIŞ","#N/A",155243,,11,"TIMIŞOARA / Colegiul Tehnic ""Ion Mincu""",1,14683,"MUNICIPIUL TIMIŞOARA",155243,713,702,380,313,9,689,13,987,285,194,495
37,"TIMIŞ","#N/A",155243,,12,"TIMIŞOARA / Inspectoratul Judetean al Poliţiei de Frontiera",1,14683,"MUNICIPIUL TIMIŞOARA",155243,1352,755,662,93,0,746,9,1480,725,208,538
37,"TIMIŞ","#N/A",155243,,13,"TIMIŞOARA / Inspectoratul Judetean al Poliţiei de Frontiera",1,14683,"MUNICIPIUL TIMIŞOARA",155243,1421,859,742,117,0,847,12,1562,703,249,598
37,"TIMIŞ","#N/A",155243,,14,"TIMIŞOARA / Fundaţia Ioan Slavici",1,14683,"MUNICIPIUL TIMIŞOARA",155243,1340,1028,757,270,1,1009,19,1466,438,254,755
37,"TIMIŞ","#N/A",155243,,15,"TIMIŞOARA / Fundaţia Ioan Slavici",1,14683,"MUNICIPIUL TIMIŞOARA",155243,1496,1011,852,159,0,1001,10,1644,633,292,709
37,"TIMIŞ","#N/A",155243,,16,"TIMIŞOARA / Gradinita nr. 37",1,14683,"MUNICIPIUL TIMIŞOARA",155243,1762,1225,1011,214,0,1206,19,1936,711,350,856
37,"TIMIŞ","#N/A",155243,,17,"TIMIŞOARA / Grădiniţa nr.37",1,14683,"MUNICIPIUL TIMIŞOARA",155243,1579,1020,890,130,0,1010,10,1729,709,313,697
37,"TIMIŞ","#N/A",155243,,18,"TIMIŞOARA / Grup Şcolar Agricol ""Iulian Dracea""",1,14683,"MUNICIPIUL TIMIŞOARA",155243,1808,1344,1087,257,0,1321,23,1983,639,344,977
37,"TIMIŞ","#N/A",155243,,19,"TIMIŞOARA / Grup Şcolar Agricol ""Iulian Dracea""",1,14683,"MUNICIPIUL TIMIŞOARA",155243,1658,1135,916,219,0,1118,17,1811,676,278,840
37,"TIMIŞ","#N/A",155243,,20,"TIMIŞOARA / Grupul Şcolar Agricol ""Iulian Dracea""",1,14683,"MUNICIPIUL TIMIŞOARA",155243,1837,1196,988,208,0,1178,18,2019,823,346,832
37,"TIMIŞ","#N/A",155243,,21,"TIMIŞOARA / Grup Şcolar Agricol ""Iulian Dracea""",1,14683,"MUNICIPIUL TIMIŞOARA",155243,1640,1092,864,227,1,1072,20,1800,708,330,742
37,"TIMIŞ","#N/A",155243,,22,"TIMIŞOARA / Grup Şcolar Agricol ""Iulian Dracea""",1,14683,"MUNICIPIUL TIMIŞOARA",155243,1551,1129,897,232,0,1114,15,1700,571,311,803
37,"TIMIŞ","#N/A",155243,,23,"TIMIŞOARA / Grădiniţa cu program prelungit nr.27",1,14683,"MUNICIPIUL TIMIŞOARA",155243,1425,943,787,156,0,925,18,1569,626,310,615
37,"TIMIŞ","#N/A",155243,,24,"TIMIŞOARA / Grădiniţa cu program prelungit nr.27",1,14683,"MUNICIPIUL TIMIŞOARA",155243,1409,926,826,98,2,914,12,1553,627,301,613
37,"TIMIŞ","#N/A",155243,,25,"TIMIŞOARA / Şcoala Generala  cu clasele    I-IV nr. 19",1,14683,"MUNICIPIUL TIMIŞOARA",155243,1447,970,865,105,0,950,20,1586,616,298,652
37,"TIMIŞ","#N/A",155243,,26,"TIMIŞOARA / Şcoala Generala cu clasele I-IV nr. 19",1,14683,"MUNICIPIUL TIMIŞOARA",155243,1676,1039,950,89,0,1026,13,1845,806,296,730
37,"TIMIŞ","#N/A",155243,,27,"TIMIŞOARA / Şcoala Generală  nr.24",1,14683,"MUNICIPIUL TIMIŞOARA",155243,1354,964,783,180,1,950,14,1492,528,325,625
37,"TIMIŞ","#N/A",155243,,28,"TIMIŞOARA / Şcoala Generală  nr.24",1,14683,"MUNICIPIUL TIMIŞOARA",155243,1493,992,871,121,0,969,23,1648,656,314,655
37,"TIMIŞ","#N/A",155243,,29,"TIMIŞOARA / Şcoala Generală  nr.24",1,14683,"MUNICIPIUL TIMIŞOARA",155243,853,645,491,154,0,629,16,935,290,186,443
37,"TIMIŞ","#N/A",155243,,30,"TIMIŞOARA / Şcoala Generală  nr.24",1,14683,"MUNICIPIUL TIMIŞOARA",155243,1008,684,582,102,0,670,14,1116,432,192,478
37,"TIMIŞ","#N/A",155243,,31,"TIMIŞOARA / Şcoala Generală nr. 26",1,14683,"MUNICIPIUL TIMIŞOARA",155243,1511,891,821,70,0,880,11,1667,776,303,577
37,"TIMIŞ","#N/A",155243,,32,"TIMIŞOARA / Şcoala Generală nr.26",1,14683,"MUNICIPIUL TIMIŞOARA",155243,1209,807,703,104,0,793,14,1336,529,259,534
37,"TIMIŞ","#N/A",155243,,33,"TIMIŞOARA / Şcoala Generală nr.26",1,14683,"MUNICIPIUL TIMIŞOARA",155243,1123,760,642,118,0,748,12,1238,478,217,531
37,"TIMIŞ","#N/A",155243,,34,"TIMIŞOARA / Şcoala Generală nr.26",1,14683,"MUNICIPIUL TIMIŞOARA",155243,1401,919,849,68,2,911,8,1543,624,303,608
37,"TIMIŞ","#N/A",155243,,35,"TIMIŞOARA / Şcoala Generală nr.18",1,14683,"MUNICIPIUL TIMIŞOARA",155243,802,546,462,84,0,541,5,882,336,202,339
37,"TIMIŞ","#N/A",155243,,36,"TIMIŞOARA / Şcoala Generală nr.18",1,14683,"MUNICIPIUL TIMIŞOARA",155243,1619,989,872,117,0,961,28,1785,796,338,623
37,"TIMIŞ","#N/A",155243,,37,"TIMIŞOARA / Şcoala Generală nr.18",1,14683,"MUNICIPIUL TIMIŞOARA",155243,952,612,523,87,2,606,6,1050,438,209,397
37,"TIMIŞ","#N/A",155243,,38,"TIMIŞOARA / Clubul Sportiv Şcolar nr.1",1,14683,"MUNICIPIUL TIMIŞOARA",155243,974,702,597,103,2,697,5,1075,373,221,476
37,"TIMIŞ","#N/A",155243,,39,"TIMIŞOARA / Grădiniţa  nr.36",1,14683,"MUNICIPIUL TIMIŞOARA",155243,1358,972,724,247,1,954,18,1495,523,297,657
37,"TIMIŞ","#N/A",155243,,40,"TIMIŞOARA / Şcoala cu clasele I-VIII nr.19 ""Avram Iancu""",1,14683,"MUNICIPIUL TIMIŞOARA",155243,1161,751,667,84,0,735,16,1285,534,246,489
37,"TIMIŞ","#N/A",155243,,41,"TIMIŞOARA / Şcoala cu clasele I-VIII nr. 19 ""Avram Iancu""",1,14683,"MUNICIPIUL TIMIŞOARA",155243,1301,920,749,169,2,913,7,1432,512,316,597
37,"TIMIŞ","#N/A",155243,,42,"TIMIŞOARA / Şcoala cu clasele I-VIII nr.19 "" Avram Iancu """,1,14683,"MUNICIPIUL TIMIŞOARA",155243,1306,1005,791,214,0,982,23,1431,426,332,650
37,"TIMIŞ","#N/A",155243,,43,"TIMIŞOARA / Şcoala cu clasele I-VIII nr.19 ""Avram Iancu""",1,14683,"MUNICIPIUL TIMIŞOARA",155243,1528,928,852,76,0,915,13,1681,753,294,621
37,"TIMIŞ","#N/A",155243,,44,"TIMIŞOARA / Şcoala Generală nr.18",1,14683,"MUNICIPIUL TIMIŞOARA",155243,1254,786,696,89,1,777,9,1385,599,292,485
37,"TIMIŞ","#N/A",155243,,45,"TIMIŞOARA / Grădiniţa cu program prelungit nr.26",1,14683,"MUNICIPIUL TIMIŞOARA",155243,783,611,498,113,0,604,7,854,243,190,414
37,"TIMIŞ","#N/A",155243,,46,"TIMIŞOARA / Grădiniţa cu program prelungit nr.26",1,14683,"MUNICIPIUL TIMIŞOARA",155243,1162,783,676,105,2,775,8,1276,493,274,501
37,"TIMIŞ","#N/A",155243,,47,"TIMIŞOARA / Grădiniţa cu program prelungit nr.26",1,14683,"MUNICIPIUL TIMIŞOARA",155243,939,613,485,127,1,605,8,1030,417,186,419
37,"TIMIŞ","#N/A",155243,,48,"TIMIŞOARA / Grădiniţa cu program prelungit nr.9 ""Carla Pelz""",1,14683,"MUNICIPIUL TIMIŞOARA",155243,1464,942,867,75,0,929,13,1308,366,274,655
37,"TIMIŞ","#N/A",155243,,49,"TIMIŞOARA / Grădiniţa cu program prelungit nr.9 ""Carla Pelz""",1,14683,"MUNICIPIUL TIMIŞOARA",155243,1520,952,860,92,0,942,10,1672,720,265,677
37,"TIMIŞ","#N/A",155243,,50,"TIMIŞOARA / Biroul Locuinţe Nord-Serviciul Public de Administrare Locuinţe şi Utilităţi",1,14683,"MUNICIPIUL TIMIŞOARA",155243,885,606,493,113,0,596,10,968,362,189,407
37,"TIMIŞ","#N/A",155243,,51,"TIMIŞOARA / Grup Şcolar de Industrie Alimentară",1,14683,"MUNICIPIUL TIMIŞOARA",155243,1141,791,666,125,0,777,14,1260,469,255,522
37,"TIMIŞ","#N/A",155243,,52,"TIMIŞOARA / Gruo Şcolar de Industrie Alimentară",1,14683,"MUNICIPIUL TIMIŞOARA",155243,1260,884,765,119,0,871,13,1379,495,228,643
37,"TIMIŞ","#N/A",155243,,53,"TIMIŞOARA / Grup Şcolar de Arte si Meserii ""Spiru Haret""",1,14683,"MUNICIPIUL TIMIŞOARA",155243,1326,879,757,121,1,869,10,1464,585,276,593
37,"TIMIŞ","#N/A",155243,,54,"TIMIŞOARA / Grup Şcolar de Arte si Meserii ""Spiru Haret""",1,14683,"MUNICIPIUL TIMIŞOARA",155243,1327,873,804,69,0,855,18,1457,584,271,584
37,"TIMIŞ","#N/A",155243,,55,"TIMIŞOARA / Şcoala cu clasele I-IV nr.11",1,14683,"MUNICIPIUL TIMIŞOARA",155243,1670,1105,1012,93,0,1095,10,1840,735,315,780
37,"TIMIŞ","#N/A",155243,,56,"TIMIŞOARA / Şcoala cu clasele I-IV nr. 11",1,14683,"MUNICIPIUL TIMIŞOARA",155243,1731,1072,987,84,1,1060,12,1902,830,321,739
37,"TIMIŞ","#N/A",155243,,57,"TIMIŞOARA / Şcoala cu clasele I-IV nr. 11",1,14683,"MUNICIPIUL TIMIŞOARA",155243,1755,1140,1044,96,0,1131,9,1923,783,305,826
37,"TIMIŞ","#N/A",155243,,58,"TIMIŞOARA / Şcoala cu clasele I-IV  nr.19",1,14683,"MUNICIPIUL TIMIŞOARA",155243,1665,951,847,95,9,936,15,1816,865,269,667
37,"TIMIŞ","#N/A",155243,,59,"TIMIŞOARA / Şcola cu clasele I-IV nr.19",1,14683,"MUNICIPIUL TIMIŞOARA",155243,1794,1127,1050,77,0,1110,17,1971,844,297,813
37,"TIMIŞ","#N/A",155243,,60,"TIMIŞOARA / Şcoala cu clasele I-IV nr.19",1,14683,"MUNICIPIUL TIMIŞOARA",155243,1740,1017,897,120,0,1003,14,1912,895,284,719
37,"TIMIŞ","#N/A",155243,,61,"TIMIŞOARA / Inspectoratul Teritorial de Muncă Timiş",1,14683,"MUNICIPIUL TIMIŞOARA",155243,1337,800,642,158,0,788,12,1270,470,240,548
37,"TIMIŞ","#N/A",155243,,62,"TIMIŞOARA / Administrarea Domeniului Public",1,14683,"MUNICIPIUL TIMIŞOARA",155243,1250,770,672,97,1,759,11,1380,610,279,480
37,"TIMIŞ","#N/A",155243,,63,"TIMIŞOARA / Administrarea Domeniului Public",1,14683,"MUNICIPIUL TIMIŞOARA",155243,1705,931,829,102,0,916,15,1179,248,237,679
37,"TIMIŞ","#N/A",155243,,64,"TIMIŞOARA / Colegiul Tehnic de Vest",1,14683,"MUNICIPIUL TIMIŞOARA",155243,1281,765,641,80,44,758,7,1414,649,252,506
37,"TIMIŞ","#N/A",155243,,65,"TIMIŞOARA / Colegiul Tehnic de Vest",1,14683,"MUNICIPIUL TIMIŞOARA",155243,1103,738,549,189,0,730,8,1212,474,216,514
37,"TIMIŞ","#N/A",155243,,66,"TIMIŞOARA / Colegiul Tehnic de Vest",1,14683,"MUNICIPIUL TIMIŞOARA",155243,1058,665,533,132,0,656,9,1169,504,180,476
37,"TIMIŞ","#N/A",155243,,67,"TIMIŞOARA / Şcoala cu clasele I-VIII nr.12",1,14683,"MUNICIPIUL TIMIŞOARA",155243,1019,762,557,176,29,752,10,1113,351,224,528
37,"TIMIŞ","#N/A",155243,,68,"TIMIŞOARA / Şcoala cu clasele I-VIII nr.12",1,14683,"MUNICIPIUL TIMIŞOARA",155243,1323,780,659,121,0,767,13,1459,679,214,553
37,"TIMIŞ","#N/A",155243,,69,"TIMIŞOARA / Colegiul Economic  ""F.S.Nitti""",1,14683,"MUNICIPIUL TIMIŞOARA",155243,1304,729,624,105,0,719,10,1429,700,236,483
37,"TIMIŞ","#N/A",155243,,70,"TIMIŞOARA / Colegiul Economic ""F.S.Nitti""",1,14683,"MUNICIPIUL TIMIŞOARA",155243,1188,703,585,77,41,692,11,1297,594,164,528
37,"TIMIŞ","#N/A",155243,,71,"TIMIŞOARA / Colegiul Economic ""F.S.Nitti""",1,14683,"MUNICIPIUL TIMIŞOARA",155243,1345,810,749,61,0,794,16,1481,671,239,555
37,"TIMIŞ","#N/A",155243,,72,"TIMIŞOARA / Colegiul Economic ""F.S. Nitti""",1,14683,"MUNICIPIUL TIMIŞOARA",155243,1374,791,725,65,1,776,15,1510,719,213,563
37,"TIMIŞ","#N/A",155243,,73,"TIMIŞOARA / Liceul ""Grigore Moisil""",1,14683,"MUNICIPIUL TIMIŞOARA",155243,995,754,516,230,8,743,11,1092,338,212,531
37,"TIMIŞ","#N/A",155243,,74,"TIMIŞOARA / Liceul ""Grigore Moisil""",1,14683,"MUNICIPIUL TIMIŞOARA",155243,992,642,509,133,0,631,11,1091,449,176,455
37,"TIMIŞ","#N/A",155243,,75,"TIMIŞOARA / Liceul ""Grigore Moisil""",1,14683,"MUNICIPIUL TIMIŞOARA",155243,1047,636,537,99,0,631,5,1154,518,209,422
37,"TIMIŞ","#N/A",155243,,76,"TIMIŞOARA / Liceul ""Grigore Moisil""",1,14683,"MUNICIPIUL TIMIŞOARA",155243,1134,727,598,129,0,721,6,1251,524,176,545
37,"TIMIŞ","#N/A",155243,,77,"TIMIŞOARA / Liceul  ""Grigore Moisil""",1,14683,"MUNICIPIUL TIMIŞOARA",155243,1025,617,543,73,1,608,9,1132,515,153,455
37,"TIMIŞ","#N/A",155243,,78,"TIMIŞOARA / Liceul ""Grigore Moisil""",1,14683,"MUNICIPIUL TIMIŞOARA",155243,1012,695,589,78,28,690,5,1113,418,230,460
37,"TIMIŞ","#N/A",155243,,79,"TIMIŞOARA / Liceul de Arte Plastice",1,14683,"MUNICIPIUL TIMIŞOARA",155243,1524,971,871,99,1,958,13,1670,699,316,642
37,"TIMIŞ","#N/A",155243,,80,"TIMIŞOARA / Liceul de Arte Plastice  (fosta Şcoala generala nr. 9",1,14683,"MUNICIPIUL TIMIŞOARA",155243,1836,1010,914,95,1,990,20,2022,1012,287,703
37,"TIMIŞ","#N/A",155243,,81,"TIMIŞOARA / Liceul de Arte Plastice",1,14683,"MUNICIPIUL TIMIŞOARA",155243,1551,955,890,63,2,947,8,1506,551,284,663
37,"TIMIŞ","#N/A",155243,,82,"TIMIŞOARA / Liceul de Arte Plastice",1,14683,"MUNICIPIUL TIMIŞOARA",155243,1153,630,547,83,0,617,13,1267,637,180,437
37,"TIMIŞ","#N/A",155243,,83,"TIMIŞOARA / Gradiniţa cu program prelungit nr. 3",1,14683,"MUNICIPIUL TIMIŞOARA",155243,1090,847,616,231,0,843,4,1201,354,302,541
37,"TIMIŞ","#N/A",155243,,84,"TIMIŞOARA / Gradiniţa cu program prelungit nr. 3",1,14683,"MUNICIPIUL TIMIŞOARA",155243,1589,987,885,101,1,972,15,1744,757,308,664
37,"TIMIŞ","#N/A",155243,,85,"TIMIŞOARA / Şcoala cu clasele I-VIII nr. 27",1,14683,"MUNICIPIUL TIMIŞOARA",155243,1729,1055,935,120,0,1041,14,1903,848,326,715
37,"TIMIŞ","#N/A",155243,,86,"TIMIŞOARA / Şcoala cu clasele I-VIII nr.27",1,14683,"MUNICIPIUL TIMIŞOARA",155243,1703,1088,950,138,0,1067,21,1872,784,309,758
37,"TIMIŞ","#N/A",155243,,87,"TIMIŞOARA / Şcoala cu clasele I-VIII nr. 27",1,14683,"MUNICIPIUL TIMIŞOARA",155243,1775,1136,989,147,0,1120,16,1948,812,335,785
37,"TIMIŞ","#N/A",155243,,88,"TIMIŞOARA / Şcoala cu clasele I-VIII nr. 27",1,14683,"MUNICIPIUL TIMIŞOARA",155243,1730,1046,925,121,0,1032,14,1904,858,372,660
37,"TIMIŞ","#N/A",155243,,89,"TIMIŞOARA / Şcoala cu clasele I-VIII nr. 6",1,14683,"MUNICIPIUL TIMIŞOARA",155243,1190,706,626,80,0,699,7,1311,605,244,455
37,"TIMIŞ","#N/A",155243,,90,"TIMIŞOARA / Şcoala cu clasele I-VIII nr. 6",1,14683,"MUNICIPIUL TIMIŞOARA",155243,1297,875,762,113,0,861,14,1428,553,243,618
37,"TIMIŞ","#N/A",155243,,91,"TIMIŞOARA / Şcoala cu clasele I-VIII nr. 6",1,14683,"MUNICIPIUL TIMIŞOARA",155243,1361,812,728,84,0,800,12,1495,683,252,548
37,"TIMIŞ","#N/A",155243,,92,"TIMIŞOARA / Şcoala cu clasele I-VIII nr. 6",1,14683,"MUNICIPIUL TIMIŞOARA",155243,1588,919,849,70,0,902,17,1750,831,275,627
37,"TIMIŞ","#N/A",155243,,93,"TIMIŞOARA / Grup Şcolar Industrial Transporturi Auto",1,14683,"MUNICIPIUL TIMIŞOARA",155243,1519,924,835,87,2,913,11,1666,742,250,663
37,"TIMIŞ","#N/A",155243,,94,"TIMIŞOARA / Grup Şcolar Industrial Transporturi Auto",1,14683,"MUNICIPIUL TIMIŞOARA",155243,1577,967,865,102,0,952,15,1732,765,250,702
37,"TIMIŞ","#N/A",155243,,95,"TIMIŞOARA / Grup Scolar Industrial Transporturi Auto",1,14683,"MUNICIPIUL TIMIŞOARA",155243,1808,1099,978,120,1,1089,10,1987,888,287,802
37,"TIMIŞ","#N/A",155243,,96,"TIMIŞOARA / Şcoala cu clasele I-VIII nr. 29",1,14683,"MUNICIPIUL TIMIŞOARA",155243,1434,830,766,64,0,821,9,1575,745,237,584
37,"TIMIŞ","#N/A",155243,,97,"TIMIŞOARA / Şcoala cu clasele I-VIII nr. 29",1,14683,"MUNICIPIUL TIMIŞOARA",155243,1301,659,576,83,0,654,5,1404,745,200,454
37,"TIMIŞ","#N/A",155243,,98,"TIMIŞOARA / Şcoala cu clasele I-VIII nr. 29",1,14683,"MUNICIPIUL TIMIŞOARA",155243,1203,653,621,32,0,641,12,1325,672,166,475
37,"TIMIŞ","#N/A",155243,,99,"TIMIŞOARA / Şcoala cu clasele I-IV nr.15",1,14683,"MUNICIPIUL TIMIŞOARA",155243,1793,1049,958,90,1,1032,17,1970,921,284,748
37,"TIMIŞ","#N/A",155243,,100,"TIMIŞOARA / Şcoala cu clasele I-IV nr.15",1,14683,"MUNICIPIUL TIMIŞOARA",155243,1540,912,849,63,0,896,16,1702,790,298,598
37,"TIMIŞ","#N/A",155243,,101,"TIMIŞOARA / Grădiniţa cu program prelungit nr. 29",1,14683,"MUNICIPIUL TIMIŞOARA",155243,1485,959,819,139,1,947,12,1638,679,279,668
37,"TIMIŞ","#N/A",155243,,102,"TIMIŞOARA / Grădiniţa cu program prelungit nr. 29",1,14683,"MUNICIPIUL TIMIŞOARA",155243,1287,851,726,123,2,843,8,1410,559,253,590
37,"TIMIŞ","#N/A",155243,,103,"TIMIŞOARA / Şcoala cu clasele I-VIII nr.2",1,14683,"MUNICIPIUL TIMIŞOARA",155243,1334,886,706,178,2,881,5,1465,579,276,605
37,"TIMIŞ","#N/A",155243,,104,"TIMIŞOARA / Şcoala cu clasele I-VIII nr. 2",1,14683,"MUNICIPIUL TIMIŞOARA",155243,1700,1114,981,131,2,1090,24,1868,754,363,727
37,"TIMIŞ","#N/A",155243,,105,"TIMIŞOARA / Şcoala cu clasele I-VIII nr.2",1,14683,"MUNICIPIUL TIMIŞOARA",155243,1478,901,827,74,0,883,18,1634,733,310,573
37,"TIMIŞ","#N/A",155243,,106,"TIMIŞOARA / Gradinita cu program prelungit nr. 1",1,14683,"MUNICIPIUL TIMIŞOARA",155243,1777,1206,1125,81,0,1190,16,1952,746,339,851
37,"TIMIŞ","#N/A",155243,,107,"TIMIŞOARA / Grădiniţa cu program prelungit nr.1",1,14683,"MUNICIPIUL TIMIŞOARA",155243,1886,1164,1036,128,0,1140,24,2060,896,359,781
37,"TIMIŞ","#N/A",155243,,108,"TIMIŞOARA / Liceul teoretic ""Vlad Tepes""",1,14683,"MUNICIPIUL TIMIŞOARA",155243,1360,960,739,219,2,952,8,1486,526,316,636
37,"TIMIŞ","#N/A",155243,,109,"TIMIŞOARA / Liceul cu program sportiv Banatul",1,14683,"MUNICIPIUL TIMIŞOARA",155243,510,465,331,134,0,455,10,761,296,131,324
37,"TIMIŞ","#N/A",155243,,110,"TIMIŞOARA / Liceul cu program sportiv ""Banatul""",1,14683,"MUNICIPIUL TIMIŞOARA",155243,1077,883,631,252,0,866,17,1184,301,247,619
37,"TIMIŞ","#N/A",155243,,111,"TIMIŞOARA / Colegiul National de Arta ""Ion Vidu""",1,14683,"MUNICIPIUL TIMIŞOARA",155243,606,1806,341,1465,0,1774,32,2066,260,366,1408
37,"TIMIŞ","#N/A",155243,,112,"TIMIŞOARA / Casa Tineretului",1,14683,"MUNICIPIUL TIMIŞOARA",155243,988,1082,572,439,71,1071,11,1488,406,271,800
37,"TIMIŞ","#N/A",155243,,113,"TIMIŞOARA / Casa Tineretului",1,14683,"MUNICIPIUL TIMIŞOARA",155243,799,843,431,343,69,831,12,1278,435,218,613
37,"TIMIŞ","#N/A",155243,,114,"TIMIŞOARA / Casa Tineretului",1,14683,"MUNICIPIUL TIMIŞOARA",155243,887,1097,504,526,67,1085,12,1464,367,249,836
37,"TIMIŞ","#N/A",155243,,115,"TIMIŞOARA / Casa Tineretului",1,14683,"MUNICIPIUL TIMIŞOARA",155243,1098,1065,583,416,66,1053,12,1211,146,298,755
37,"TIMIŞ","#N/A",155243,,116,"TIMIŞOARA / Liceul teoretic ""Jean Louis Calderon""",1,14683,"MUNICIPIUL TIMIŞOARA",155243,1144,810,572,237,1,794,16,1254,444,194,600
37,"TIMIŞ","#N/A",155243,,117,"TIMIŞOARA / Şcoala cu clasele I-VIII nr.30",1,14683,"MUNICIPIUL TIMIŞOARA",155243,1735,1217,1029,187,1,1197,20,1909,692,324,873
37,"TIMIŞ","#N/A",155243,,118,"TIMIŞOARA / Şcoala cu clasele I-VIII nr.20",1,14683,"MUNICIPIUL TIMIŞOARA",155243,1421,1046,845,201,0,1037,9,1565,519,297,740
37,"TIMIŞ","#N/A",155243,,119,"TIMIŞOARA / Şcoala cu clasele I-VIII nr.30",1,14683,"MUNICIPIUL TIMIŞOARA",155243,1637,1082,917,165,0,1066,16,1801,719,345,721
37,"TIMIŞ","#N/A",155243,,120,"TIMIŞOARA / Şcoala cu clasele I-VIII nr.30",1,14683,"MUNICIPIUL TIMIŞOARA",155243,1576,1073,911,162,0,1062,11,1733,660,313,749
37,"TIMIŞ","#N/A",155243,,121,"TIMIŞOARA / Şcoala cu clasele I-VIII nr.30",1,14683,"MUNICIPIUL TIMIŞOARA",155243,1394,1028,820,208,0,1022,6,1535,507,277,745
37,"TIMIŞ","#N/A",155243,,122,"TIMIŞOARA / Liceul teoretic ""Jean Louis Calderon""",1,14683,"MUNICIPIUL TIMIŞOARA",155243,1227,776,571,205,0,758,18,1348,572,186,572
37,"TIMIŞ","#N/A",155243,,123,"TIMIŞOARA / Liceul teoretic ""Jean Louis Calderon""",1,14683,"MUNICIPIUL TIMIŞOARA",155243,838,732,457,275,0,723,9,924,192,182,541
37,"TIMIŞ","#N/A",155243,,124,"TIMIŞOARA / Liceul Teoretic ""William Shakespeare""",1,14683,"MUNICIPIUL TIMIŞOARA",155243,1568,1024,863,156,5,1002,22,1725,701,281,721
37,"TIMIŞ","#N/A",155243,,125,"TIMIŞOARA / Liceul Teoretic ""William Shakespeare""",1,14683,"MUNICIPIUL TIMIŞOARA",155243,1080,661,594,67,0,653,8,1187,526,207,446
37,"TIMIŞ","#N/A",155243,,126,"TIMIŞOARA / Gradiniţa cu program prelungit nr.11",1,14683,"MUNICIPIUL TIMIŞOARA",155243,1373,876,798,78,0,864,12,1513,637,261,603
37,"TIMIŞ","#N/A",155243,,127,"TIMIŞOARA / Gradiniţa cu program prelungit nr.11",1,14683,"MUNICIPIUL TIMIŞOARA",155243,1131,778,667,111,0,767,11,1240,462,222,545
37,"TIMIŞ","#N/A",155243,,128,"TIMIŞOARA / Colegiul Tehnic ""Azur""",1,14683,"MUNICIPIUL TIMIŞOARA",155243,1061,963,577,385,1,954,9,1164,201,253,701
37,"TIMIŞ","#N/A",155243,,129,"TIMIŞOARA / Colegiul Tehnic ""Azur""",1,14683,"MUNICIPIUL TIMIŞOARA",155243,1188,1009,730,279,0,994,15,1307,298,264,730
37,"TIMIŞ","#N/A",155243,,130,"TIMIŞOARA / Colegiul Tehnic ""Azur""",1,14683,"MUNICIPIUL TIMIŞOARA",155243,1243,860,663,197,0,847,13,1364,504,223,624
37,"TIMIŞ","#N/A",155243,,131,"TIMIŞOARA / Colegiul Tehnic ""Azur""",1,14683,"MUNICIPIUL TIMIŞOARA",155243,1042,656,572,84,0,647,9,1145,489,215,432
37,"TIMIŞ","#N/A",155243,,132,"TIMIŞOARA / Colegiul Tehnic ""Azur""",1,14683,"MUNICIPIUL TIMIŞOARA",155243,1660,931,866,65,0,914,17,1820,889,277,637
37,"TIMIŞ","#N/A",155243,,133,"TIMIŞOARA / Colegiul Tehnic ""Azur""",1,14683,"MUNICIPIUL TIMIŞOARA",155243,1670,1006,935,71,0,989,17,1842,836,276,713
37,"TIMIŞ","#N/A",155243,,134,"TIMIŞOARA / Liceul Teoretic ""Iris""",1,14683,"MUNICIPIUL TIMIŞOARA",155243,1545,1100,855,244,1,1086,14,1701,601,266,820
37,"TIMIŞ","#N/A",155243,,135,"TIMIŞOARA / Şcoala cu clasele I-VIII nr.25",1,14683,"MUNICIPIUL TIMIŞOARA",155243,1643,1211,976,235,0,1187,24,1804,593,356,831
37,"TIMIŞ","#N/A",155243,,136,"TIMIŞOARA / Şcoala cu clasele I-VIII nr.25",1,14683,"MUNICIPIUL TIMIŞOARA",155243,1614,1046,939,106,1,1031,15,1779,733,322,709
37,"TIMIŞ","#N/A",155243,,137,"TIMIŞOARA / Şcoala cu clasele I-VIII nr.25",1,14683,"MUNICIPIUL TIMIŞOARA",155243,1709,1168,1088,80,0,1148,20,1871,703,325,823
37,"TIMIŞ","#N/A",155243,,138,"TIMIŞOARA / Şcoala cu clasele I-VIII nr.25",1,14683,"MUNICIPIUL TIMIŞOARA",155243,1631,1074,992,81,1,1058,16,1793,719,345,713
37,"TIMIŞ","#N/A",155243,,139,"TIMIŞOARA / Şcoala cu clasele I-VIII nr.25",1,14683,"MUNICIPIUL TIMIŞOARA",155243,1638,964,880,84,0,953,11,1809,845,262,691
37,"TIMIŞ","#N/A",155243,,140,"TIMIŞOARA / Gradinita cu program prelungit nr. 12",1,14683,"MUNICIPIUL TIMIŞOARA",155243,1126,688,592,95,1,670,18,1242,554,217,453
37,"TIMIŞ","#N/A",155243,,141,"TIMIŞOARA / Şcoala cu clasele I-VIII nr.15",1,14683,"MUNICIPIUL TIMIŞOARA",155243,1350,893,731,161,1,877,16,1485,592,268,609
37,"TIMIŞ","#N/A",155243,,142,"TIMIŞOARA / Şcoala cu clasele I-VIII nr. 15",1,14683,"MUNICIPIUL TIMIŞOARA",155243,1108,690,606,84,0,675,15,1218,528,231,444
37,"TIMIŞ","#N/A",155243,,143,"TIMIŞOARA / Şcoala cu clasele I-VIII nr. 15",1,14683,"MUNICIPIUL TIMIŞOARA",155243,1396,868,795,72,1,856,12,1535,667,224,632
37,"TIMIŞ","#N/A",155243,,144,"TIMIŞOARA / Şcoala cu clasele I-VIII nr. 15",1,14683,"MUNICIPIUL TIMIŞOARA",155243,1432,797,741,55,1,785,12,1570,773,229,556
37,"TIMIŞ","#N/A",155243,,145,"TIMIŞOARA / Şantierul  Drumuri  Municipale",1,14683,"MUNICIPIUL TIMIŞOARA",155243,1699,836,780,55,1,820,16,1875,1039,228,592
37,"TIMIŞ","#N/A",155243,,146,"TIMIŞOARA / Şantierul Drumuri Municipale",1,14683,"MUNICIPIUL TIMIŞOARA",155243,1647,865,791,74,0,853,12,1817,952,233,620
37,"TIMIŞ","#N/A",155243,,147,"TIMIŞOARA / Gradiniţa cu program prelungit nr.23",1,14683,"MUNICIPIUL TIMIŞOARA",155243,1236,887,731,155,1,874,13,1364,477,318,556
37,"TIMIŞ","#N/A",155243,,148,"TIMIŞOARA / Şcoala cu clasele I-VIII nr. 13",1,14683,"MUNICIPIUL TIMIŞOARA",155243,1222,721,631,90,0,708,13,1348,627,207,501
37,"TIMIŞ","#N/A",155243,,149,"TIMIŞOARA / Şcoala cu clasele I-VIII nr.13",1,14683,"MUNICIPIUL TIMIŞOARA",155243,1421,844,776,67,1,835,9,1561,717,303,532
37,"TIMIŞ","#N/A",155243,,150,"TIMIŞOARA / Şcoala cu clasele I-VIII nr. 13",1,14683,"MUNICIPIUL TIMIŞOARA",155243,1423,835,741,94,0,827,8,1561,726,271,556
37,"TIMIŞ","#N/A",155243,,151,"TIMIŞOARA / Şcoala cu clasele I-VIII nr. 13",1,14683,"MUNICIPIUL TIMIŞOARA",155243,1153,671,598,73,0,660,11,1273,602,210,450
37,"TIMIŞ","#N/A",155243,,152,"TIMIŞOARA / Grup Scolar Industrial Electrotimiş",1,14683,"MUNICIPIUL TIMIŞOARA",155243,1320,896,733,163,0,878,18,1448,552,271,607
37,"TIMIŞ","#N/A",155243,,153,"TIMIŞOARA / Grup Scolar Industrial Electrotimiş",1,14683,"MUNICIPIUL TIMIŞOARA",155243,1725,977,909,68,0,967,10,1905,928,260,707
37,"TIMIŞ","#N/A",155243,,154,"TIMIŞOARA / Grup Scolar Industrial Electrotimiş",1,14683,"MUNICIPIUL TIMIŞOARA",155243,1760,1127,1014,113,0,1105,22,1930,803,351,754
37,"TIMIŞ","#N/A",155243,,155,"TIMIŞOARA / Grup Scolar Industrial Electrotimiş",1,14683,"MUNICIPIUL TIMIŞOARA",155243,1610,912,728,183,1,894,18,1771,859,232,662
37,"TIMIŞ","#N/A",155243,,156,"TIMIŞOARA / Liceul teoretic ""Vlad Tepes""",1,14683,"MUNICIPIUL TIMIŞOARA",155243,1324,927,761,165,1,912,15,1458,531,239,673
37,"TIMIŞ","#N/A",155243,,157,"TIMIŞOARA / Liceul teoretic ""Vlad Tepes""",1,14683,"MUNICIPIUL TIMIŞOARA",155243,1628,967,812,155,0,958,9,1792,825,230,728
37,"TIMIŞ","#N/A",155243,,158,"TIMIŞOARA / Centrul Scolar pentru Educatie Incluziva ""Constantin Pufan""",1,14683,"MUNICIPIUL TIMIŞOARA",155243,1369,1073,806,267,0,1058,15,1504,431,324,734
37,"TIMIŞ","#N/A",155243,,159,"TIMIŞOARA / Gradiniţa cu program normal nr.19",1,14683,"MUNICIPIUL TIMIŞOARA",155243,1698,1073,974,99,0,1053,19,1866,794,282,771
37,"TIMIŞ","#N/A",155243,,160,"TIMIŞOARA / Gradiniţa cu program normal nr.19",1,14683,"MUNICIPIUL TIMIŞOARA",155243,1586,1010,897,113,0,986,24,1739,729,284,702
37,"TIMIŞ","#N/A",155243,,161,"TIMIŞOARA / Şcoala Generala nr.16 ""Take Ionescu""",1,14683,"MUNICIPIUL TIMIŞOARA",155243,1192,1037,725,114,198,1018,19,1358,321,469,549
37,"TIMIŞ","#N/A",155243,,162,"TIMIŞOARA / Şcoala Generală nr.16 ""Take Ionescu""",1,14683,"MUNICIPIUL TIMIŞOARA",155243,1013,937,643,122,172,923,14,1217,280,442,481
37,"TIMIŞ","#N/A",155243,,163,"TIMIŞOARA / Şcoala Generală nr.16 ""Take Ionescu""",1,14683,"MUNICIPIUL TIMIŞOARA",155243,1036,987,611,205,171,970,17,1283,296,468,502
37,"TIMIŞ","#N/A",155243,,164,"TIMIŞOARA / Sediul R.A.T.T.",1,14683,"MUNICIPIUL TIMIŞOARA",155243,661,472,347,115,10,465,7,732,260,174,291
37,"TIMIŞ","#N/A",155243,,165,"TIMIŞOARA / Gradiniţa cu program prelungit nr.48",1,14683,"MUNICIPIUL TIMIŞOARA",155243,992,651,564,87,0,643,8,1097,446,196,447
37,"TIMIŞ","#N/A",155243,,166,"TIMIŞOARA / Grup Şcolar Energetic",1,14683,"MUNICIPIUL TIMIŞOARA",155243,1963,1315,1045,165,105,1307,8,2163,848,385,922
37,"TIMIŞ","#N/A",155243,,167,"TIMIŞOARA / Şcoala Generala  nr.21",1,14683,"MUNICIPIUL TIMIŞOARA",155243,1501,967,814,153,0,954,13,1659,692,280,674
37,"TIMIŞ","#N/A",155243,,168,"TIMIŞOARA / Şcoala Generala  nr.21",1,14683,"MUNICIPIUL TIMIŞOARA",155243,1636,1107,923,184,0,1088,19,1504,397,332,756
37,"TIMIŞ","#N/A",155243,,169,"TIMIŞOARA / Şcoala Generala  nr.21",1,14683,"MUNICIPIUL TIMIŞOARA",155243,1633,1150,998,151,1,1133,17,1800,650,380,753
37,"TIMIŞ","#N/A",155243,,170,"TIMIŞOARA / Şcoala Generală nr.21 ""Vicenţiu Babeş""",1,14683,"MUNICIPIUL TIMIŞOARA",155243,1184,775,643,131,1,760,15,1300,525,234,526
37,"TIMIŞ","#N/A",155243,,171,"TIMIŞOARA / Fundaţia Ioan Slavici",1,14683,"MUNICIPIUL TIMIŞOARA",155243,1392,877,735,142,0,865,12,1535,658,275,590
37,"TIMIŞ","#N/A",155243,,172,"TIMIŞOARA / Fundaţia Ioan Slavici",1,14683,"MUNICIPIUL TIMIŞOARA",155243,1911,1138,1066,72,0,1115,23,2106,968,337,778
37,"TIMIŞ","#N/A",155243,,173,"TIMIŞOARA / Şcoala Generală nr.7 "" Sfânta Maria """,1,14683,"MUNICIPIUL TIMIŞOARA",155243,1392,973,781,192,0,964,9,1526,553,250,714
37,"TIMIŞ","#N/A",155243,,174,"TIMIŞOARA / Scoala Generala nr. 7 ""Sfanta Maria""",1,14683,"MUNICIPIUL TIMIŞOARA",155243,1523,1027,841,185,1,1012,15,1678,651,316,696
37,"TIMIŞ","#N/A",155243,,175,"TIMIŞOARA / Şcoala Generala nr.7 ""Sfanta Maria""",1,14683,"MUNICIPIUL TIMIŞOARA",155243,1522,999,878,120,1,979,20,1677,678,324,655
37,"TIMIŞ","#N/A",155243,,176,"TIMIŞOARA / Şcoala Generală nr.7 "" Sfânta Maria """,1,14683,"MUNICIPIUL TIMIŞOARA",155243,1453,953,768,185,0,939,14,1604,651,244,695
37,"TIMIŞ","#N/A",155243,,177,"TIMIŞOARA / Şcoala Generală nr.7 "" Sfânta Maria """,1,14683,"MUNICIPIUL TIMIŞOARA",155243,1086,589,557,32,0,576,13,1201,612,179,397
37,"TIMIŞ","#N/A",155243,,178,"TIMIŞOARA / Şcoala Generala  nr.7 ""Sfanta Maria""",1,14683,"MUNICIPIUL TIMIŞOARA",155243,1197,818,692,126,0,807,11,1312,494,209,598
37,"TIMIŞ","#N/A",155243,,179,"TIMIŞOARA / Grădiniţa cu program prelungit nr.20",1,14683,"MUNICIPIUL TIMIŞOARA",155243,1686,1056,935,120,1,1042,14,1860,804,321,721
37,"TIMIŞ","#N/A",155243,,180,"TIMIŞOARA / Gradiniţa cu program prelungit nr.20",1,14683,"MUNICIPIUL TIMIŞOARA",155243,1772,1072,948,124,0,1061,11,1943,871,395,666
37,"TIMIŞ","#N/A",155243,,181,"TIMIŞOARA / Gradiniţa cu program prelungit nr.20",1,14683,"MUNICIPIUL TIMIŞOARA",155243,1051,718,643,75,0,702,16,1150,432,200,502
37,"TIMIŞ","#N/A",155243,,182,"TIMIŞOARA / S.C.""RETIM""S.A.",1,14683,"MUNICIPIUL TIMIŞOARA",155243,1926,1224,1106,118,0,1203,20,2118,895,340,863
37,"TIMIŞ","#N/A",155243,,183,"TIMIŞOARA / S.C.""RETIM""S.A.",1,14683,"MUNICIPIUL TIMIŞOARA",155243,1975,1187,1084,103,0,1176,11,2175,988,348,828
37,"TIMIŞ","#N/A",155243,,184,"TIMIŞOARA / Liceul Regele Ferdinand - Camin nr. 1",1,14683,"MUNICIPIUL TIMIŞOARA",155243,1485,968,842,126,0,956,12,1633,665,290,666
37,"TIMIŞ","#N/A",155243,,185,"TIMIŞOARA / Liceul Regele Ferdinand - Camin nr. 1",1,14683,"MUNICIPIUL TIMIŞOARA",155243,1656,916,837,78,1,906,10,1822,906,260,646
37,"TIMIŞ","#N/A",155243,,186,"TIMIŞOARA / Liceul Regele Ferdinand - Camin nr. 1",1,14683,"MUNICIPIUL TIMIŞOARA",155243,1774,964,886,78,0,948,16,1954,990,282,666
37,"TIMIŞ","#N/A",155243,,187,"TIMIŞOARA / Liceul Regele Ferdinand - Camin nr. 1",1,14683,"MUNICIPIUL TIMIŞOARA",155243,1752,923,849,74,0,908,15,1925,1002,286,622
37,"TIMIŞ","#N/A",155243,,188,"TIMIŞOARA / S.C.""RETIM  Ecologic Service ""S.A.",1,14683,"MUNICIPIUL TIMIŞOARA",155243,1668,947,794,153,0,934,13,1831,884,287,647
37,"TIMIŞ","#N/A",155243,,189,"TIMIŞOARA / Liceul Teoretic ""William Shakespeare""",1,14683,"MUNICIPIUL TIMIŞOARA",155243,918,548,483,65,0,535,13,811,263,179,356
37,"TIMIŞ","#N/A",155243,,190,"TIMIŞOARA / Liceul teoretic ""William Shakespeare""",1,14683,"MUNICIPIUL TIMIŞOARA",155243,799,503,439,62,2,496,7,880,377,165,331
37,"TIMIŞ","#N/A",155243,,191,"TIMIŞOARA / Centrul Scolar pentru Educatie Incluziva "" Paul Popescu Neveanu""",1,14683,"MUNICIPIUL TIMIŞOARA",155243,1296,718,656,62,0,703,15,924,206,168,535
37,"TIMIŞ","#N/A",155243,,192,"TIMIŞOARA / Centrul Scolar pentru Educatie Incluziva "" Paul Popescu Neveanu""",1,14683,"MUNICIPIUL TIMIŞOARA",155243,1316,619,546,73,0,605,14,1454,835,165,440
37,"TIMIŞ","#N/A",155243,,193,"TIMIŞOARA / Centrul Şcolar pentru Educaţie Incluzivă ""Paul Popescu Neveanu""",1,14683,"MUNICIPIUL TIMIŞOARA",155243,1048,579,534,45,0,572,7,1155,576,144,428
37,"TIMIŞ","#N/A",155243,,194,"TIMIŞOARA / Centrul Scolar pentru Educatie Incluziva "" Paul Popescu Neveanu""",1,14683,"MUNICIPIUL TIMIŞOARA",155243,1242,615,547,68,0,603,12,1365,750,170,433
37,"TIMIŞ","#N/A",155243,,195,"TIMIŞOARA / Liceul Teoretic Jean Louis Calderon",1,14683,"MUNICIPIUL TIMIŞOARA",155243,958,723,484,239,0,712,11,1045,322,205,507
37,"TIMIŞ","#N/A",155243,,196,"TIMIŞOARA / Liceul Teoretic Jean Louis Calderon",1,14683,"MUNICIPIUL TIMIŞOARA",155243,1568,1092,873,219,0,1070,22,1727,635,233,837
37,"TIMIŞ","#N/A",155243,,197,"TIMIŞOARA / Liceul Teoretic Jean Louis Calderon",1,14683,"MUNICIPIUL TIMIŞOARA",155243,1303,1008,718,289,1,989,19,1433,425,265,724
37,"TIMIŞ","#N/A",155243,,198,"TIMIŞOARA / Liceul Teoretic Jean Louis Calderon",1,14683,"MUNICIPIUL TIMIŞOARA",155243,1087,888,620,267,1,877,11,1193,305,249,628
37,"TIMIŞ","#N/A",155243,,199,"TIMIŞOARA / Liceul Teologic Penticostal Logos",1,14683,"MUNICIPIUL TIMIŞOARA",155243,1488,932,860,72,0,921,11,1641,709,267,654
37,"TIMIŞ","#N/A",155243,,200,"TIMIŞOARA / Liceul Teologic Penticostal Logos",1,14683,"MUNICIPIUL TIMIŞOARA",155243,1134,683,586,97,0,673,10,1255,572,202,471
37,"TIMIŞ","#N/A",155243,,201,"TIMIŞOARA / Liceul Teologic Penticostal Logos",1,14683,"MUNICIPIUL TIMIŞOARA",155243,1185,693,613,80,0,685,8,1300,607,240,445
37,"TIMIŞ","#N/A",155243,,202,"TIMIŞOARA / Liceul Teologic Penticostal Logos",1,14683,"MUNICIPIUL TIMIŞOARA",155243,1318,770,712,58,0,761,9,1449,679,249,512
37,"TIMIŞ","#N/A",155243,,203,"TIMIŞOARA / Gradiniţa cu program prelungit nr. 30",1,14683,"MUNICIPIUL TIMIŞOARA",155243,1571,842,774,65,3,828,14,1738,896,210,618
37,"TIMIŞ","#N/A",155243,,204,"TIMIŞOARA / Grădiniţa cu program prelungit nr.30",1,14683,"MUNICIPIUL TIMIŞOARA",155243,1789,952,872,78,2,936,16,1966,1014,270,666
37,"TIMIŞ","#N/A",155243,,205,"TIMIŞOARA / Şcoala Generala nr.20",1,14683,"MUNICIPIUL TIMIŞOARA",155243,1822,1228,1141,86,1,1217,11,1992,764,323,894
37,"TIMIŞ","#N/A",155243,,206,"TIMIŞOARA / Şcoala cu clasele I-VIII nr 4",1,14683,"MUNICIPIUL TIMIŞOARA",155243,1594,960,899,60,1,949,11,1754,794,247,702
37,"TIMIŞ","#N/A",155243,,207,"TIMIŞOARA / Şcoala cu clasele I-VIII nr.4",1,14683,"MUNICIPIUL TIMIŞOARA",155243,1285,768,722,46,0,753,15,1402,634,197,556
37,"TIMIŞ","#N/A",155243,,208,"TIMIŞOARA / Gradiniţa cu program prelungit nr.6",1,14683,"MUNICIPIUL TIMIŞOARA",155243,1307,878,818,60,0,867,11,1141,263,276,591
37,"TIMIŞ","#N/A",155243,,209,"TIMIŞOARA / Gradiniţa cu program prelungit nr.6",1,14683,"MUNICIPIUL TIMIŞOARA",155243,1286,811,745,66,0,801,10,1014,203,263,538
37,"TIMIŞ","#N/A",155243,,210,"TIMIŞOARA / Centrul Logistic Timis",1,14683,"MUNICIPIUL TIMIŞOARA",155243,1219,656,597,58,1,646,10,1034,378,209,437
37,"TIMIŞ","#N/A",155243,,211,"TIMIŞOARA / Centrul Logistic Timis",1,14683,"MUNICIPIUL TIMIŞOARA",155243,1140,654,613,39,2,644,10,854,200,159,485
37,"TIMIŞ","#N/A",155243,,212,"TIMIŞOARA / Gradinita Aeroport cu program prelungit nr.13",1,14683,"MUNICIPIUL TIMIŞOARA",155243,522,364,323,41,0,360,4,572,208,103,257
37,"TIMIŞ","#N/A",155350,,213,"LUGOJ / Colegiul Naţional ,,Iulia Haşdeu""",1,14685,"MUNICIPIUL LUGOJ",155350,1359,750,679,71,0,746,4,1494,744,269,477
37,"TIMIŞ","#N/A",155350,,214,"LUGOJ / Şcoala Gimnazială nr.3",1,14685,"MUNICIPIUL LUGOJ",155350,1662,916,819,97,0,909,7,1838,922,374,535
37,"TIMIŞ","#N/A",155350,,215,"LUGOJ / Grădiniţa cu Program Prelungit nr.3",1,14685,"MUNICIPIUL LUGOJ",155350,1627,880,820,59,1,870,10,1789,909,249,621
37,"TIMIŞ","#N/A",155350,,216,"LUGOJ / Grădiniţa cu Program Prelungit nr.4",1,14685,"MUNICIPIUL LUGOJ",155350,1406,760,711,48,1,748,12,1545,785,325,423
37,"TIMIŞ","#N/A",155350,,217,"LUGOJ / Grădiniţa cu Program Prelungit nr.4",1,14685,"MUNICIPIUL LUGOJ",155350,1037,572,551,21,0,571,1,1135,563,209,362
37,"TIMIŞ","#N/A",155350,,218,"LUGOJ / Şcoala Gimnazială nr.4",1,14685,"MUNICIPIUL LUGOJ",155350,1056,604,547,54,3,600,4,1157,553,195,405
37,"TIMIŞ","#N/A",155350,,219,"LUGOJ / Grădiniţa cu Program Prelungit nr.5",1,14685,"MUNICIPIUL LUGOJ",155350,1565,838,796,41,1,828,10,1723,885,349,479
37,"TIMIŞ","#N/A",155350,,220,"LUGOJ / Grădiniţa cu Program Prelungit nr.5",1,14685,"MUNICIPIUL LUGOJ",155350,1247,705,670,35,0,697,8,1374,669,281,416
37,"TIMIŞ","#N/A",155350,,221,"LUGOJ / Şcoala Gimnazială nr.2",1,14685,"MUNICIPIUL LUGOJ",155350,1595,873,838,35,0,866,7,1749,876,343,523
37,"TIMIŞ","#N/A",155350,,222,"LUGOJ / Grădiniţa cu Program Prelungit nr.7",1,14685,"MUNICIPIUL LUGOJ",155350,1309,713,669,44,0,710,3,1442,729,240,470
37,"TIMIŞ","#N/A",155350,,223,"LUGOJ / Grădiniţa cu Program Normal nr.11",1,14685,"MUNICIPIUL LUGOJ",155350,1169,764,669,95,0,753,11,1282,518,218,535
37,"TIMIŞ","#N/A",155350,,224,"LUGOJ / Grădiniţa cu Program Normal nr.11",1,14685,"MUNICIPIUL LUGOJ",155350,1057,684,641,43,0,679,5,1163,479,280,399
37,"TIMIŞ","#N/A",155350,,225,"LUGOJ / Sala Sporturilor ,,Ioan Kunst Ghermănescu""",1,14685,"MUNICIPIUL LUGOJ",155350,795,523,463,59,1,521,2,875,352,209,312
37,"TIMIŞ","#N/A",155350,,226,"LUGOJ / Sala Sporturilor ,,Ioan Kunst Ghermănescu""",1,14685,"MUNICIPIUL LUGOJ",155350,1581,925,869,56,0,917,8,1737,812,310,607
37,"TIMIŞ","#N/A",155350,,227,"LUGOJ / Sala Sporturilor ,,Ioan Kunst Ghermănescu""",1,14685,"MUNICIPIUL LUGOJ",155350,1362,862,800,60,2,848,14,1495,633,355,493
37,"TIMIŞ","#N/A",155350,,228,"LUGOJ / S.C.,,MISIAN PREST"" SRL",1,14685,"MUNICIPIUL LUGOJ",155350,1206,673,637,36,0,664,9,1333,660,228,436
37,"TIMIŞ","#N/A",155350,,229,"LUGOJ / Şcoala Gimnazială ""Eftimie Murgu""",1,14685,"MUNICIPIUL LUGOJ",155350,1173,690,648,41,1,682,8,1283,593,236,446
37,"TIMIŞ","#N/A",155350,,230,"LUGOJ / Şcoala Gimnazială ,,Eftimie Murgu""",1,14685,"MUNICIPIUL LUGOJ",155350,1597,876,825,51,0,868,8,1759,883,330,538
37,"TIMIŞ","#N/A",155350,,231,"LUGOJ / Grădiniţa cu  Program Normal nr.13",1,14685,"MUNICIPIUL LUGOJ",155350,1626,949,869,79,1,933,16,1795,846,352,581
37,"TIMIŞ","#N/A",155350,,232,"LUGOJ / Colegiul Tehnic ""Valeriu Branişte""",1,14685,"MUNICIPIUL LUGOJ",155350,1087,751,590,67,94,741,10,1210,459,298,443
37,"TIMIŞ","#N/A",155350,,233,"LUGOJ / Grădiniţa cu Program Prelungit nr.2",1,14685,"MUNICIPIUL LUGOJ",155350,1566,805,752,53,0,800,5,1725,920,301,499
37,"TIMIŞ","#N/A",155350,,234,"LUGOJ / S.C.,,AGROMEC LUGOJ""S.A.",1,14685,"MUNICIPIUL LUGOJ",155350,1436,834,783,49,2,825,9,1581,747,259,566
37,"TIMIŞ","#N/A",155350,,235,"LUGOJ / Cubul Tineretului",1,14685,"MUNICIPIUL LUGOJ",155350,1183,666,556,109,1,658,8,1300,634,230,428
37,"TIMIŞ","#N/A",155350,,236,"LUGOJ / Sala de lupte şi gimnastică ,,Francisc Horvath""",1,14685,"MUNICIPIUL LUGOJ",155350,1161,563,531,31,1,559,4,1277,714,212,347
37,"TIMIŞ","#N/A",155350,,237,"LUGOJ / Baza de agrement Ştrand",1,14685,"MUNICIPIUL LUGOJ",155350,1319,791,747,44,0,783,8,1454,663,314,469
37,"TIMIŞ","#N/A",155350,,238,"LUGOJ / Sala Sporturilor ,,Lavinia Miloşovici""",1,14685,"MUNICIPIUL LUGOJ",155350,1588,888,841,47,0,879,9,1739,851,264,615
37,"TIMIŞ","#N/A",155350,,239,"LUGOJ / Sala Sporturilor ,,Lavinia Miloşovici""",1,14685,"MUNICIPIUL LUGOJ",155350,1559,860,817,43,0,849,11,1716,856,247,602
37,"TIMIŞ","#N/A",155350,,240,"LUGOJ / Sala Sporturilor ,,Lavinia Miloşovici""",1,14685,"MUNICIPIUL LUGOJ",155350,1648,905,845,57,3,900,5,1811,906,318,582
37,"TIMIŞ","#N/A",155350,,241,"LUGOJ / Şcoala Gimnazială Nr.1",1,14685,"MUNICIPIUL LUGOJ",155350,1304,776,720,55,1,766,10,1433,657,253,513
37,"TIMIŞ","#N/A",155350,,242,"LUGOJ / S.C.,,TECHNOCER""S.R.L.",1,14685,"MUNICIPIUL LUGOJ",155350,459,282,251,31,0,282,0,504,222,119,163
37,"TIMIŞ","#N/A",155350,,243,"MĂGURI / Centrul  Comunitar de Sprijin pentru Prevenirea Abandonului Şcolar Măguri",1,14685,"MUNICIPIUL LUGOJ",155350,731,294,278,16,0,289,5,801,507,220,69
37,"TIMIŞ","#N/A",155350,,244,"TAPIA / Grădiniţa cu Program Normal Nr.5 Tăpia",1,14685,"MUNICIPIUL LUGOJ",155350,264,141,133,8,0,140,1,289,148,84,56
37,"TIMIŞ","#N/A",155403,,245,"BUZIAŞ / Şcoala Generală",1,14689,"ORAŞ BUZIAŞ",155403,1545,944,834,109,1,936,8,1704,760,402,534
37,"TIMIŞ","#N/A",155403,,246,"BUZIAŞ / Şcoala Generală",1,14689,"ORAŞ BUZIAŞ",155403,1374,964,712,204,48,955,9,1512,548,485,470
37,"TIMIŞ","#N/A",155403,,247,"BUZIAŞ / LIceul Teoretic",1,14689,"ORAŞ BUZIAŞ",155403,1753,1076,922,151,3,1062,14,1928,852,537,525
37,"TIMIŞ","#N/A",155403,,248,"BACOVA / Căminul Cultural Bacova",1,14689,"ORAŞ BUZIAŞ",155403,1557,731,649,82,0,725,6,1712,981,198,527
37,"TIMIŞ","#N/A",155403,,249,"SILAGIU / Căminul Cultural Silagiu",1,14689,"ORAŞ BUZIAŞ",155403,677,468,425,41,2,465,3,740,272,231,234
37,"TIMIŞ","#N/A",156357,,250,"CIACOVA / Primărie",1,14693,"ORAŞ CIACOVA",156357,1313,778,659,108,11,769,9,1458,680,224,545
37,"TIMIŞ","#N/A",156357,,251,"CIACOVA / Liceul Al.Mocioni Ciacova",1,14693,"ORAŞ CIACOVA",156357,995,569,455,76,38,565,4,1089,520,163,402
37,"TIMIŞ","#N/A",156357,,252,"CEBZA / Scoala   cu cls.I-IV Cebza",1,14693,"ORAŞ CIACOVA",156357,619,327,258,69,0,325,2,677,350,109,216
37,"TIMIŞ","#N/A",156357,,253,"MACEDONIA / Căminul Cultural Macedonia",1,14693,"ORAŞ CIACOVA",156357,352,248,195,53,0,247,1,384,136,77,170
37,"TIMIŞ","#N/A",156357,,254,"OBAD / Şcoala cu clasele I-IV Obad",1,14693,"ORAŞ CIACOVA",156357,489,310,276,34,0,310,0,536,226,49,261
37,"TIMIŞ","#N/A",156357,,255,"PETROMAN / Şcoala cu clasele I-IV Petroman",1,14693,"ORAŞ CIACOVA",156357,541,313,264,49,0,309,4,597,284,87,222
37,"TIMIŞ","#N/A",155458,,256,"DETA / Liceul Sfântul Nicolae Deta",1,14699,"ORAŞ DETA",155458,1488,859,744,96,19,851,8,1637,778,253,598
37,"TIMIŞ","#N/A",155458,,257,"DETA / Şcoala cu cls. V-VIII Deta",1,14699,"ORAŞ DETA",155458,1437,697,623,74,0,691,6,1574,877,233,458
37,"TIMIŞ","#N/A",155458,,258,"DETA / Şcoala cu cls. V-VIII Deta",1,14699,"ORAŞ DETA",155458,1293,625,583,39,3,621,4,1424,799,205,416
37,"TIMIŞ","#N/A",155458,,259,"DETA / A.N.I.F Deta",1,14699,"ORAŞ DETA",155458,1561,717,675,38,4,704,13,1715,998,214,490
37,"TIMIŞ","#N/A",155458,,260,"OPATIŢA / Căminul Cultural Opatiţa",1,14699,"ORAŞ DETA",155458,571,395,357,26,12,390,5,627,232,109,281
37,"TIMIŞ","#N/A",156801,,261,"FĂGET / CASA DE CULTURA FAGET",1,14702,"ORAŞ FĂGET",156801,1640,1023,863,156,4,1011,12,1807,784,417,594
37,"TIMIŞ","#N/A",156801,,262,"FĂGET / SC TRANSPORT MIXT FAGETEANA SA",1,14702,"ORAŞ FĂGET",156801,313,238,190,29,19,235,3,343,105,103,132
37,"TIMIŞ","#N/A",156801,,263,"FĂGET / GRADINITA PN FAGET",1,14702,"ORAŞ FĂGET",156801,1458,979,902,65,12,972,7,1603,624,424,548
37,"TIMIŞ","#N/A",156801,,264,"BĂTEŞTI / Şcoala Generală Băteşti,",1,14702,"ORAŞ FĂGET",156801,392,257,236,21,0,252,5,430,173,93,159
37,"TIMIŞ","#N/A",156801,,265,"BEGHEIU MIC / Şcoala Generală Begheiul  Mic",1,14702,"ORAŞ FĂGET",156801,278,196,168,16,12,194,2,306,110,118,76
37,"TIMIŞ","#N/A",156801,,266,"BICHIGI / Căminul Cultural Bichigi",1,14702,"ORAŞ FĂGET",156801,505,318,289,19,10,315,3,556,238,164,151
37,"TIMIŞ","#N/A",156801,,267,"BRĂNEŞTI / Caminul Cultural Brăneşti",1,14702,"ORAŞ FĂGET",156801,421,237,225,12,0,237,0,467,230,165,72
37,"TIMIŞ","#N/A",156801,,268,"BUNEA MARE / Şcoala Generală Bunea Mare",1,14702,"ORAŞ FĂGET",156801,193,122,111,11,0,121,1,209,87,47,74
37,"TIMIŞ","#N/A",156801,,269,"COLONIA MICĂ / SCOALA GENERALA, COLONIA MICA",1,14702,"ORAŞ FĂGET",156801,198,131,102,29,0,128,3,216,85,25,103
37,"TIMIŞ","#N/A",156801,,270,"JUPÂNEŞTI / Şcoala generală Jupâneşti",1,14702,"ORAŞ FĂGET",156801,150,114,96,16,2,112,2,162,48,78,34
37,"TIMIŞ","#N/A",156801,,271,"POVÂRGINA / Caminul Cultural Povergina",1,14702,"ORAŞ FĂGET",156801,150,107,94,13,0,105,2,165,58,50,55
37,"TIMIŞ","#N/A",156801,,272,"TEMEREŞTI / Caminul Cultural Temereşti",1,14702,"ORAŞ FĂGET",156801,425,325,278,34,13,319,6,467,142,205,114
37,"TIMIŞ","#N/A",157086,,273,"GĂTAIA / Casa de Cultura Gataia",1,14714,"ORAŞ GĂTAIA",157086,1372,774,678,91,5,764,10,1512,738,237,527
37,"TIMIŞ","#N/A",157086,,274,"GĂTAIA / PRIMARIA ORAS GATAIA",1,14714,"ORAŞ GĂTAIA",157086,1318,711,626,79,6,702,9,1448,737,278,424
37,"TIMIŞ","#N/A",157086,,275,"SCULIA / Scoala primara Sculia",1,14714,"ORAŞ GĂTAIA",157086,1584,948,850,88,10,941,7,1743,795,336,605
37,"TIMIŞ","#N/A",157086,,276,"BUTIN / Şcoala primară Butin",1,14714,"ORAŞ GĂTAIA",157086,331,265,195,64,6,264,1,360,95,145,119
37,"TIMIŞ","#N/A",157086,,277,"PERCOSOVA / Şcoala primară Percosova",1,14714,"ORAŞ GĂTAIA",157086,228,191,146,40,5,188,3,252,61,88,100
37,"TIMIŞ","#N/A",157086,,278,"ŞEMLACU MARE / SCOALA PRIMARA SEMLACU MARE",1,14714,"ORAŞ GĂTAIA",157086,282,188,142,46,0,187,1,310,122,49,138
37,"TIMIŞ","#N/A",157086,,279,"ŞEMLACU MIC / Şcoala primară  Şemlacul Mic",1,14714,"ORAŞ GĂTAIA",157086,145,104,74,24,6,104,0,157,53,26,78
37,"TIMIŞ","#N/A",155494,,280,"JIMBOLIA / Liceul Tehnologic Jimbolia",1,14721,"ORAŞ JIMBOLIA",155494,1664,684,639,45,0,674,10,1827,1143,174,500
37,"TIMIŞ","#N/A",155494,,281,"JIMBOLIA / Şcoala Gimnazială Jimbolia",1,14721,"ORAŞ JIMBOLIA",155494,1628,704,670,34,0,693,11,1789,1085,162,531
37,"TIMIŞ","#N/A",155494,,282,"JIMBOLIA / Liceul Tehnologic Jimbolia",1,14721,"ORAŞ JIMBOLIA",155494,1622,731,690,38,3,721,10,1791,1060,217,504
37,"TIMIŞ","#N/A",155494,,283,"JIMBOLIA / Incubatorul de afaceri Jimbolia",1,14721,"ORAŞ JIMBOLIA",155494,1499,707,665,41,1,697,10,1653,946,216,481
37,"TIMIŞ","#N/A",155494,,284,"JIMBOLIA / Casa de cultură",1,14721,"ORAŞ JIMBOLIA",155494,1534,842,703,90,49,837,5,1681,839,254,583
37,"TIMIŞ","#N/A",155494,,285,"JIMBOLIA / Casa de cultură",1,14721,"ORAŞ JIMBOLIA",155494,1347,649,548,78,23,641,8,1475,826,195,446
37,"TIMIŞ","#N/A",155494,,286,"JIMBOLIA / Şcoala Gimnazială Jimbolia",1,14721,"ORAŞ JIMBOLIA",155494,1641,742,708,32,2,727,15,1801,1059,182,545
37,"TIMIŞ","#N/A",155494,,287,"JIMBOLIA / Gradinita",1,14721,"ORAŞ JIMBOLIA",155494,218,109,94,15,0,109,0,239,130,23,86
37,"TIMIŞ","#N/A",158314,,288,"RECAŞ / Primăria Recaş",1,14723,"ORAŞ RECAŞ",158314,1766,1024,801,211,12,1011,13,1943,919,392,619
37,"TIMIŞ","#N/A",158314,,289,"RECAŞ / Grădiniţa cu P.P. Recaş",1,14723,"ORAŞ RECAŞ",158314,1324,772,687,82,3,770,2,1449,677,290,480
37,"TIMIŞ","#N/A",158314,,290,"RECAŞ / Liceul Teoretic Recaş",1,14723,"ORAŞ RECAŞ",158314,1531,964,838,121,5,955,9,1679,715,330,625
37,"TIMIŞ","#N/A",158314,,291,"BAZOŞ / Şcoala Gimnazială Bazoş",1,14723,"ORAŞ RECAŞ",158314,736,469,342,126,1,467,2,808,339,228,239
37,"TIMIŞ","#N/A",158314,,292,"HERNEACOVA / Şcoala Primară Herneacova",1,14723,"ORAŞ RECAŞ",158314,372,273,223,48,2,271,2,408,135,132,139
37,"TIMIŞ","#N/A",158314,,293,"IZVIN / Şcoala Gimnazială Izvin",1,14723,"ORAŞ RECAŞ",158314,1211,813,655,157,1,805,8,1133,320,285,520
37,"TIMIŞ","#N/A",158314,,294,"PETROVASELO / Şcoala Primară Petrovaselo",1,14723,"ORAŞ RECAŞ",158314,203,191,119,71,1,189,2,221,30,83,106
37,"TIMIŞ","#N/A",158314,,295,"STANCIOVA / Şcoala Primară Stanciova",1,14723,"ORAŞ RECAŞ",158314,307,197,149,46,2,197,0,338,141,81,116
37,"TIMIŞ","#N/A",155528,,296,"SÂNNICOLAU MARE / Sala casei de cultură (Castel Nako)etaj 1",1,14731,"ORAŞ SÂNNICOLAU MARE",155528,1402,826,725,100,1,817,9,1541,715,259,558
37,"TIMIŞ","#N/A",155528,,297,"SÂNNICOLAU MARE / Sala casei de cultură (Castel Nako) demisol",1,14731,"ORAŞ SÂNNICOLAU MARE",155528,1798,1007,914,92,1,992,15,1983,976,301,691
37,"TIMIŞ","#N/A",155528,,298,"SÂNNICOLAU MARE / Primăria Oraşului Sânnicolau Mare",1,14731,"ORAŞ SÂNNICOLAU MARE",155528,1783,1115,968,144,3,1108,7,1963,848,390,718
37,"TIMIŞ","#N/A",155528,,299,"SÂNNICOLAU MARE / Grădiniţa PP1 NR.1 parter, Sânnicolau Mare",1,14731,"ORAŞ SÂNNICOLAU MARE",155528,1737,906,854,50,2,893,13,1903,997,279,614
37,"TIMIŞ","#N/A",155528,,300,"SÂNNICOLAU MARE / Grădiniţa PP1 NR.1 etaj, Sânnicolau Mare",1,14731,"ORAŞ SÂNNICOLAU MARE",155528,1541,881,821,56,4,868,13,1692,811,285,583
37,"TIMIŞ","#N/A",155528,,301,"SÂNNICOLAU MARE / Liceul Tehnologic CRISTOFOR NAKO Oraş Sânnicolau Mare",1,14731,"ORAŞ SÂNNICOLAU MARE",155528,1835,922,840,81,1,915,7,2016,1094,286,629
37,"TIMIŞ","#N/A",155528,,302,"SÂNNICOLAU MARE / Şcoala generală nr.1 Sânnicolau Mare, parter",1,14731,"ORAŞ SÂNNICOLAU MARE",155528,1847,1101,957,109,35,1091,10,2027,926,344,747
37,"TIMIŞ","#N/A",155546,,303,"BALINŢ / Căminul Cultural Balinţ",3,14733,"BALINŢ",155546,448,350,237,94,19,348,2,495,145,168,180
37,"TIMIŞ","#N/A",155546,,304,"BODO / Şcoala cu clasele I- IV Bodo",3,14733,"BALINŢ",155546,408,271,225,39,7,270,1,445,174,58,212
37,"TIMIŞ","#N/A",155546,,305,"FĂDIMAC / Şcoala cu clasele I- IV Fădimac",3,14733,"BALINŢ",155546,189,160,105,44,11,158,2,207,47,66,92
37,"TIMIŞ","#N/A",155546,,306,"TÎRGOVIŞTE / Şcoala cu cls.I-IV Tîrgovişte",3,14733,"BALINŢ",155546,271,209,165,27,17,207,2,297,88,91,116
37,"TIMIŞ","#N/A",155591,,307,"BANLOC / Primaria Banloc",3,14738,"BANLOC",155591,1355,666,597,69,0,665,1,1490,824,307,358
37,"TIMIŞ","#N/A",155591,,308,"OFSENIŢA / Şcoala Ofseniţa",3,14738,"BANLOC",155591,327,151,132,19,0,150,1,360,209,68,82
37,"TIMIŞ","#N/A",155591,,309,"PARTOŞ / Şcoala  Partoş",3,14738,"BANLOC",155591,343,233,169,50,14,232,1,380,147,128,104
37,"TIMIŞ","#N/A",155591,,310,"SOCA / Şcoala  Soca",3,14738,"BANLOC",155591,438,247,223,24,0,246,1,483,236,136,110
37,"TIMIŞ","#N/A",155662,,311,"BARA /  Primaria Bara",3,14743,"BARA",155662,143,133,82,46,5,132,1,157,24,87,45
37,"TIMIŞ","#N/A",155662,,312,"DOBREŞTI / Şcoala Dobreşti",3,14743,"BARA",155662,37,78,30,48,0,77,1,140,62,46,31
37,"TIMIŞ","#N/A",155662,,313,"LĂPUŞNIC / Căminul cultural  Lăpuşnic",3,14743,"BARA",155662,33,51,20,31,0,50,1,135,84,30,20
37,"TIMIŞ","#N/A",155662,,314,"RĂDMĂNEŞTI / Căminul cultural  Rădmăneşti",3,14743,"BARA",155662,56,53,31,22,0,53,0,61,8,38,15
37,"TIMIŞ","#N/A",155724,,315,"BEBA VECHE / Căminul Cultural Beba Veche",3,14749,"BEBA VECHE",155724,859,514,444,50,20,508,6,945,431,260,248
37,"TIMIŞ","#N/A",155724,,316,"CHERESTUR / Căminul Cultural Chereştur",3,14749,"BEBA VECHE",155724,423,290,258,32,0,288,2,464,174,67,221
37,"TIMIŞ","#N/A",155760,,317,"BECICHERECU MIC / Grădiniţa PP Dimitrie Ţichindeal",3,14753,"BECICHERECU MIC",155760,1255,843,681,145,17,837,6,1375,532,349,488
37,"TIMIŞ","#N/A",155760,,318,"BECICHERECU MIC / Şcoala cu cls. I - VIII Dimitrie Ţichindeal",3,14753,"BECICHERECU MIC",155760,1276,883,672,195,16,878,5,1403,520,366,512
37,"TIMIŞ","#N/A",155797,,319,"BELINŢ / Primăria Belinţ",3,14755,"BELINŢ",155797,1208,730,614,114,2,726,4,1329,599,220,506
37,"TIMIŞ","#N/A",155797,,320,"BABŞA / Şcoala cu clasele I-IV  Babşa",3,14755,"BELINŢ",155797,196,171,133,38,0,168,3,214,43,71,97
37,"TIMIŞ","#N/A",155797,,321,"CHIZĂTĂU / Şcoala cu clasele I-IV Chizătău",3,14755,"BELINŢ",155797,666,489,391,92,6,487,2,729,240,156,331
37,"TIMIŞ","#N/A",155797,,322,"GRUNI / Şcoala cu clasele I-IV Gruni",3,14755,"BELINŢ",155797,181,159,126,33,0,159,0,200,41,64,95
37,"TIMIŞ","#N/A",155840,,323,"BETHAUSEN / Primăria Bethausen",3,14760,"BETHAUSEN",155840,688,438,394,44,0,434,4,758,320,213,221
37,"TIMIŞ","#N/A",155840,,324,"CLADOVA / Căminul Cultural Cladova",3,14760,"BETHAUSEN",155840,383,306,293,13,0,304,2,420,114,171,133
37,"TIMIŞ","#N/A",155840,,325,"CLICIOVA / Căminul Cultural Cliciova",3,14760,"BETHAUSEN",155840,350,211,186,25,0,206,5,385,174,127,79
37,"TIMIŞ","#N/A",155840,,326,"CUTINA / Şcoala cu cls.I-IV  Cutina",3,14760,"BETHAUSEN",155840,249,190,160,30,0,189,1,271,81,73,116
37,"TIMIŞ","#N/A",155840,,327,"LEUCUŞEŞTI /  Şcoala cu cls.I-IV Leucuseşti",3,14760,"BETHAUSEN",155840,355,285,242,43,0,283,2,388,103,144,139
37,"TIMIŞ","#N/A",155840,,328,"NEVRINCEA / Şcoala  cu cls. I-IV Nevrincea",3,14760,"BETHAUSEN",155840,179,122,98,24,0,121,1,196,74,49,72
37,"TIMIŞ","#N/A",155911,,329,"BILED / Caminul  cultural  Biled",3,14767,"BILED",155911,1829,1061,902,120,39,1051,10,2009,948,346,705
37,"TIMIŞ","#N/A",155911,,330,"BILED / Gradinita  PP  BILED",3,14767,"BILED",155911,1484,911,712,157,42,896,15,1635,724,320,576
37,"TIMIŞ","#N/A",159366,,331,"BIRDA / Şcoala cu clasele V-VIII Birda",3,14769,"BIRDA",159366,889,595,492,90,13,591,4,978,383,318,273
37,"TIMIŞ","#N/A",159366,,332,"BERECUŢA / Căminul Cultural Berecuţa",3,14769,"BIRDA",159366,154,99,78,20,1,99,0,168,69,64,35
37,"TIMIŞ","#N/A",159366,,333,"MÂNĂSTIRE / Şcoala cu clasele I-IV Mînăstire",3,14769,"BIRDA",159366,186,156,115,34,7,156,0,206,50,88,68
37,"TIMIŞ","#N/A",159366,,334,"SÂNGEORGE /  Scoal cu cl. I-IV  Sângeorge",3,14769,"BIRDA",159366,432,267,226,33,8,267,0,478,211,146,121
37,"TIMIŞ","#N/A",155957,,335,"BÎRNA / Căminul Cultural Bîrna",3,14774,"BÎRNA",155957,421,274,217,57,0,270,4,465,191,145,125
37,"TIMIŞ","#N/A",155957,,336,"BOTINEŞTI / Căminul Cultural Botineşti",3,14774,"BÎRNA",155957,167,127,105,22,0,126,1,183,56,99,27
37,"TIMIŞ","#N/A",155957,,337,"DRINOVA / Căminul Cultural Drinova",3,14774,"BÎRNA",155957,170,145,110,32,3,145,0,186,41,84,61
37,"TIMIŞ","#N/A",155957,,338,"JUREŞTI / Căminul Cultural Jureşti",3,14774,"BÎRNA",155957,187,118,97,21,0,115,3,206,88,51,64
37,"TIMIŞ","#N/A",155957,,339,"POGĂNEŞTI / Căminul Cultural Pogăneşti",3,14774,"BÎRNA",155957,273,166,141,25,0,163,3,299,133,76,87
37,"TIMIŞ","#N/A",156035,,340,"BOGDA / Sediul Primăriei Bogda",3,14782,"BOGDA",156035,250,184,130,51,3,184,0,274,90,89,95
37,"TIMIŞ","#N/A",156035,,341,"BUZAD / Casa de Cultură Buzad",3,14782,"BOGDA",156035,150,154,90,48,16,154,0,165,11,80,74
37,"TIMIŞ","#N/A",156106,,342,"BOLDUR / Şcoala Gimnazială  Boldur",3,14789,"BOLDUR",156106,506,386,333,53,0,381,5,556,170,134,247
37,"TIMIŞ","#N/A",156106,,343,"JABĂR / Şcoala Primară Jabăr",3,14789,"BOLDUR",156106,363,269,213,55,1,266,3,399,130,130,136
37,"TIMIŞ","#N/A",156106,,344,"OHABA-FORGACI / Şcoala Primară Ohaba-Forgaci",3,14789,"BOLDUR",156106,630,461,393,67,1,459,2,692,231,205,254
37,"TIMIŞ","#N/A",156106,,345,"SINERSIG / Şcoala Primară Sinersig",3,14789,"BOLDUR",156106,493,332,285,47,0,327,5,540,208,111,216
37,"TIMIŞ","#N/A",156151,,346,"BRESTOVĂŢ /  Primăria Brestovăţ",3,14794,"BRESTOVĂŢ",156151,220,171,121,48,2,168,3,240,69,65,103
37,"TIMIŞ","#N/A",156151,,347,"COŞARII / Şcoala Generală Coşarii",3,14794,"BRESTOVĂŢ",156151,116,90,71,19,0,90,0,127,37,25,65
37,"TIMIŞ","#N/A",156151,,348,"TEŞ / Căminul Cultural Teş",3,14794,"BRESTOVĂŢ",156151,232,154,126,27,1,154,0,254,100,63,91
37,"TIMIŞ","#N/A",159516,,349,"BUCOVĂŢ / Căminul Cultural Bucovăţ",3,14800,"BUCOVĂŢ",159516,1123,820,639,181,0,813,7,1123,303,203,610
37,"TIMIŞ","#N/A",159516,,350,"BAZOŞU NOU / Căminul Cultural Bazoşu Nou",3,14800,"BUCOVĂŢ",159516,259,285,186,99,0,278,7,383,98,150,128
37,"TIMIŞ","#N/A",156213,,351,"CĂRPINIŞ / Primaria Cărpiniş",3,14803,"CĂRPINIŞ",156213,1781,852,788,58,6,846,6,1956,1104,254,592
37,"TIMIŞ","#N/A",156213,,352,"CĂRPINIŞ / Căminul Cultural Cărpiniş",3,14803,"CĂRPINIŞ",156213,1662,724,667,51,6,711,13,1834,1110,257,454
37,"TIMIŞ","#N/A",156213,,353,"IECEA MICĂ / Căminul Cultural Iecea Mică",3,14803,"CĂRPINIŞ",156213,1034,487,436,51,0,485,2,1140,653,140,345
37,"TIMIŞ","#N/A",156259,,354,"CENAD / SCOALA GENERALA CU CLASELE I-VIII CENAD",3,14806,"CENAD",156259,1943,802,680,122,0,792,10,2136,1334,213,579
37,"TIMIŞ","#N/A",156259,,355,"CENAD / SCOALA GENERALA CU CLASELE I-VIII CENAD",3,14806,"CENAD",156259,1951,881,728,152,1,871,10,2142,1261,278,593
37,"TIMIŞ","#N/A",156277,,356,"CENEI / Sediul Primăriei Cenei",3,14808,"CENEI",156277,1855,959,838,113,8,950,9,2033,1074,232,718
37,"TIMIŞ","#N/A",156277,,357,"BOBDA / Şcoala Generală Bobda",3,14808,"CENEI",156277,783,559,441,114,4,556,3,861,302,194,362
37,"TIMIŞ","#N/A",159375,,358,"CHECEA / Căminul Cultural Checea",3,14811,"CHECEA",159375,1578,744,652,89,3,729,15,1727,983,248,481
37,"TIMIŞ","#N/A",156311,,359,"CHEVEREŞU MARE / Consiliul Local Chevereşu Mare",3,14813,"CHEVEREŞU MARE",156311,1005,598,461,124,13,595,3,1106,508,306,289
37,"TIMIŞ","#N/A",156311,,360,"DRAGŞINA / Şcoala cu clasele I-IV Dragşina",3,14813,"CHEVEREŞU MARE",156311,451,391,264,108,19,387,4,494,103,188,199
37,"TIMIŞ","#N/A",156311,,361,"VUCOVA / Şcoala  cu clasel  I - IV Vucova",3,14813,"CHEVEREŞU MARE",156311,305,242,179,60,3,238,4,336,94,98,140
37,"TIMIŞ","#N/A",156437,,362,"COMLOŞU MARE / Şcoala cu clasel I-VIII Comloşu Mare",3,14817,"COMLOŞU MARE",156437,1485,827,696,75,56,818,9,1631,804,420,398
37,"TIMIŞ","#N/A",156437,,363,"COMLOŞU MARE / CAMIN CULTURAL COMLOSU MARE",3,14817,"COMLOŞU MARE",156437,1433,777,668,106,3,773,4,1582,805,477,296
37,"TIMIŞ","#N/A",156437,,364,"COMLOŞU MIC / ŞCOALA cu clasele I -IV",3,14817,"COMLOŞU MARE",156437,897,432,395,37,0,432,0,985,553,229,203
37,"TIMIŞ","#N/A",156437,,365,"LUNGA / Şcoala cu cl. I - IV Lunga",3,14817,"COMLOŞU MARE",156437,435,253,212,39,2,250,3,480,227,128,122
37,"TIMIŞ","#N/A",156473,,366,"COŞTEIU / Căminul Cultural Coşteiu",3,14821,"COŞTEIU",156473,658,445,359,86,0,439,6,724,279,192,247
37,"TIMIŞ","#N/A",156473,,367,"COŞTEIU /  Primăria VecheCoşteiu",3,14821,"COŞTEIU",156473,1285,727,657,70,0,715,12,1413,686,234,481
37,"TIMIŞ","#N/A",156473,,368,"HEZERIŞ / Şcoala cu clasele I-IV Hezeriş",3,14821,"COŞTEIU",156473,208,130,100,30,0,128,2,228,98,67,61
37,"TIMIŞ","#N/A",156473,,369,"PĂRU / Caminul Cultural Paru",3,14821,"COŞTEIU",156473,208,142,117,25,0,142,0,228,86,55,87
37,"TIMIŞ","#N/A",156473,,370,"ŢIPARI / Căminul Cultural Ţipari",3,14821,"COŞTEIU",156473,701,455,384,71,0,451,4,768,313,122,329
37,"TIMIŞ","#N/A",156473,,371,"VALEA LUNGĂ ROMÂNĂ / Căminul Cultural Valea Lungă Română",3,14821,"COŞTEIU",156473,125,102,83,19,0,101,1,137,35,56,45
37,"TIMIŞ","#N/A",156534,,372,"CRICIOVA / Căminul Cultural Criciova",3,14827,"CRICIOVA",156534,592,516,385,118,13,513,3,654,138,283,230
37,"TIMIŞ","#N/A",156534,,373,"CIREŞU / Căminul Cultural Cireşu",3,14827,"CRICIOVA",156534,297,265,189,72,4,264,1,325,60,118,146
37,"TIMIŞ","#N/A",156534,,374,"JDIOARA / Căminul Cultural Jdioara",3,14827,"CRICIOVA",156534,453,338,288,50,0,336,2,498,160,131,205
37,"TIMIŞ","#N/A",156589,,375,"CURTEA / Căminul Cultural Curtea",3,14832,"CURTEA",156589,546,405,355,41,9,401,4,600,195,249,152
37,"TIMIŞ","#N/A",156589,,376,"COŞAVA / Căminul Cultural Coşava",3,14832,"CURTEA",156589,475,320,241,79,0,312,8,523,203,155,157
37,"TIMIŞ","#N/A",156623,,377,"DAROVA / Scoala gimnaziala comuna Darova",3,14836,"DAROVA",156623,1680,658,618,40,0,652,6,1843,1185,186,466
37,"TIMIŞ","#N/A",156623,,378,"HODOŞ / Gradinita PN",3,14836,"DAROVA",156623,295,202,177,25,0,201,1,328,126,66,135
37,"TIMIŞ","#N/A",156623,,379,"SACOŞU MARE / Scoala primara",3,14836,"DAROVA",156623,734,479,415,64,0,475,4,804,325,116,359
37,"TIMIŞ","#N/A",156669,,380,"DENTA / Scoala cu clasele I-VIII Denta",3,14840,"DENTA",156669,922,567,468,93,6,563,4,1011,444,274,289
37,"TIMIŞ","#N/A",156669,,381,"DENTA / Scoala cu clasele I-VIII Denta",3,14840,"DENTA",156669,1009,618,541,70,7,613,5,1110,492,264,349
37,"TIMIŞ","#N/A",156669,,382,"BREŞTEA / Şcoala clasele  I-IV Brestea",3,14840,"DENTA",156669,397,277,234,43,0,270,7,436,159,120,150
37,"TIMIŞ","#N/A",156669,,383,"ROVINIŢA MARE / Căminul cultural Roviniţa Mare",3,14840,"DENTA",156669,319,219,182,28,9,217,2,340,121,91,126
37,"TIMIŞ","#N/A",159384,,384,"DUDEŞTII NOI / Căminul Cultural Dudestii Noi",3,14845,"DUDEŞTII NOI",159384,1369,753,674,77,2,749,4,1499,746,200,549
37,"TIMIŞ","#N/A",159384,,385,"DUDEŞTII NOI / Căminul Cultural Dudestii Noi",3,14845,"DUDEŞTII NOI",159384,1178,654,549,105,0,649,5,1292,638,153,496
37,"TIMIŞ","#N/A",156712,,386,"DUDEŞTII VECHI / Liceul Dudestii Vechi",3,14847,"DUDEŞTII VECHI",156712,1587,877,790,87,0,869,8,1749,872,200,669
37,"TIMIŞ","#N/A",156712,,387,"DUDEŞTII VECHI / Consiliul Local Dudeştii Vechi",3,14847,"DUDEŞTII VECHI",156712,1540,800,709,91,0,793,7,1697,897,174,619
37,"TIMIŞ","#N/A",156712,,388,"CHEGLEVICI / Căminul Cultural Cheglevici",3,14847,"DUDEŞTII VECHI",156712,571,252,219,32,1,247,5,626,374,36,211
37,"TIMIŞ","#N/A",156767,,389,"DUMBRAVA / Sediul Primariei Dumbrava",3,14851,"DUMBRAVA",156767,885,467,420,43,4,463,4,970,503,124,339
37,"TIMIŞ","#N/A",156767,,390,"BUCOVĂŢ / Şcoala primară  Bucovăţ",3,14851,"DUMBRAVA",156767,418,307,253,44,10,304,3,459,152,180,124
37,"TIMIŞ","#N/A",156767,,391,"RĂCHITA / Şcoala Gimnazială Răchita",3,14851,"DUMBRAVA",156767,932,496,469,27,0,493,3,1031,535,220,273
37,"TIMIŞ","#N/A",155261,,392,"DUMBRĂVIŢA / CAMIN CULTURAL",3,14855,"DUMBRĂVIŢA",155261,2054,1897,1312,585,0,1882,15,2240,343,504,1378
37,"TIMIŞ","#N/A",155261,,393,"DUMBRĂVIŢA / SCOALA GIMNAZIALA",3,14855,"DUMBRĂVIŢA",155261,1827,1589,1219,370,0,1569,20,1994,405,432,1137
37,"TIMIŞ","#N/A",155261,,394,"DUMBRĂVIŢA / SCOALA GIMNAZIALA",3,14855,"DUMBRĂVIŢA",155261,2028,1618,1331,286,1,1602,16,2209,591,395,1207
37,"TIMIŞ","#N/A",159393,,395,"FIBIŞ / Căminul Cultural  Fibiş",3,14857,"FIBIŞ",159393,1380,927,725,191,11,923,4,1515,588,298,625
37,"TIMIŞ","#N/A",156927,,396,"FÎRDEA / Căminul Cultural Fîrdea",3,14859,"FÎRDEA",156927,597,416,338,63,15,412,4,657,241,171,241
37,"TIMIŞ","#N/A",156927,,397,"DRĂGSINEŞTI / Căminul Cultural Drăgşineşti",3,14859,"FÎRDEA",156927,402,302,260,25,17,300,2,440,138,110,190
37,"TIMIŞ","#N/A",156927,,398,"GLADNA ROMÂNA / Căminul Cultural Gladna Română",3,14859,"FÎRDEA",156927,481,362,299,49,14,358,4,529,167,164,194
37,"TIMIŞ","#N/A",157004,,399,"FOENI /  Şcoala cu clasele I-VIII Foeni",3,14867,"FOENI",157004,1006,532,458,74,0,532,0,1106,574,161,371
37,"TIMIŞ","#N/A",157004,,400,"CRUCENI / Primăria Veche Cruceni",3,14867,"FOENI",157004,464,260,196,64,0,260,0,509,249,62,198
37,"TIMIŞ","#N/A",157031,,401,"GAVOJDIA / Sediul Primariei Găvojdia",3,14870,"GAVOJDIA",157031,1121,564,505,59,0,562,2,1230,666,201,361
37,"TIMIŞ","#N/A",157031,,402,"JENA / Şcoala primară Jena",3,14870,"GAVOJDIA",157031,437,279,242,37,0,279,0,478,199,118,161
37,"TIMIŞ","#N/A",157031,,403,"LUGOJEL / Grădiniţa  Lugojel",3,14870,"GAVOJDIA",157031,560,411,329,78,4,410,1,617,206,130,280
37,"TIMIŞ","#N/A",157031,,404,"SĂLBĂGEL / Căminul Cultural Sălbăgel",3,14870,"GAVOJDIA",157031,243,179,151,28,0,175,4,265,86,54,121
37,"TIMIŞ","#N/A",159400,,405,"GHILAD / Şcoala cu clasele I-VIII Ghilad",3,14875,"GHILAD",159400,1543,867,717,150,0,860,7,1699,832,248,612
37,"TIMIŞ","#N/A",159400,,406,"GAD / Căminul Cultural Gad",3,14875,"GHILAD",159400,117,93,61,32,0,92,1,128,35,40,52
37,"TIMIŞ","#N/A",155289,,407,"GHIRODA / Gradinita Ghiroda",3,14878,"GHIRODA",155289,1997,1493,1251,241,1,1477,16,2191,698,513,964
37,"TIMIŞ","#N/A",155289,,408,"GHIRODA / SCOALA CU CLS. I  -VIII GHIRODA",3,14878,"GHIRODA",155289,1943,1406,1208,198,0,1390,16,2123,717,443,947
37,"TIMIŞ","#N/A",155289,,409,"GIARMATA-VII / SCOALA PRIMARA GIARMATA VII",3,14878,"GHIRODA",155289,1408,1022,877,144,1,1014,8,1556,534,311,703
37,"TIMIŞ","#N/A",157193,,410,"GHIZELA / Sediul Primariei Ghizela",3,14881,"GHIZELA",157193,366,257,212,45,0,254,3,401,144,112,142
37,"TIMIŞ","#N/A",157193,,411,"PANIOVA / Căminul Cultural Paniova",3,14881,"GHIZELA",157193,223,153,121,32,0,153,0,244,91,87,66
37,"TIMIŞ","#N/A",157193,,412,"ŞANOVIŢA / Casa Natională  ""Nicolae Ursu"" Şanoviţa",3,14881,"GHIZELA",157193,398,266,231,35,0,265,1,437,171,125,140
37,"TIMIŞ","#N/A",157246,,413,"GIARMATA / Camin Cultural",3,14886,"GIARMATA",157246,1961,1221,1051,169,1,1213,8,2152,931,339,874
37,"TIMIŞ","#N/A",157246,,414,"GIARMATA / Scoala Gimnaziala cls.I-VIII",3,14886,"GIARMATA",157246,1197,698,617,80,1,684,14,1311,613,216,468
37,"TIMIŞ","#N/A",157246,,415,"GIARMATA / Gradinita cu program prelungit comuna Giarmata",3,14886,"GIARMATA",157246,1519,781,701,80,0,775,6,1671,890,190,585
37,"TIMIŞ","#N/A",157246,,416,"CERNETEAZ / Şcoala Generală Cerneteaz",3,14886,"GIARMATA",157246,1005,717,540,161,16,711,6,1099,382,295,416
37,"TIMIŞ","#N/A",157273,,417,"GIERA / Sediul Primariei Giera",3,14889,"GIERA",157273,639,349,293,56,0,346,3,703,354,147,199
37,"TIMIŞ","#N/A",157273,,418,"GRĂNICERII / Şcoala  cu clasele  I - IV Grăniceri",3,14889,"GIERA",157273,206,129,105,24,0,128,1,226,97,22,106
37,"TIMIŞ","#N/A",157273,,419,"TOAGER / Şcoala  cu clasel  I - IV Toager",3,14889,"GIERA",157273,305,190,161,28,1,190,0,336,146,60,130
37,"TIMIŞ","#N/A",155314,,420,"GIROC / Şcoala cu clasele I-VIII Giroc",3,14893,"GIROC",155314,2116,1713,1394,307,12,1695,18,2317,604,531,1164
37,"TIMIŞ","#N/A",155314,,421,"GIROC / Căminul Cultural Giroc",3,14893,"GIROC",155314,2113,1580,1269,289,22,1567,13,2478,898,491,1076
37,"TIMIŞ","#N/A",155314,,422,"GIROC / Calea Timişoarei (fostele u.m)",3,14893,"GIROC",155314,1167,1052,785,267,0,1038,14,1252,200,244,794
37,"TIMIŞ","#N/A",155314,,423,"CHIŞODA / Şcoala cu clasele I-VIII ""Iosif Ciorogariu"" ,Chişoda",3,14893,"GIROC",155314,1194,867,763,100,4,861,6,1304,437,265,596
37,"TIMIŞ","#N/A",155314,,424,"CHIŞODA / Şcoala cu clasele I-VIII ""Iosif Ciorogariu"" ,Chişoda",3,14893,"GIROC",155314,1353,998,816,181,1,987,11,1482,484,352,635
37,"TIMIŞ","#N/A",157317,,425,"GIULVĂZ /  Primara Giulvăz",3,14896,"GIULVĂZ",157317,1023,624,504,120,0,615,9,1128,504,271,344
37,"TIMIŞ","#N/A",157317,,426,"CRAI NOU / Cămin Cultural Crai Nou",3,14896,"GIULVĂZ",157317,361,259,199,60,0,258,1,398,139,74,184
37,"TIMIŞ","#N/A",157317,,427,"IVANDA / Camin Cultural Ivanda",3,14896,"GIULVĂZ",157317,482,299,267,32,0,298,1,527,228,95,203
37,"TIMIŞ","#N/A",157317,,428,"RUDNA / Cămin Cultural Rudna",3,14896,"GIULVĂZ",157317,582,303,242,61,0,301,2,637,334,114,187
37,"TIMIŞ","#N/A",159419,,429,"GOTTLOB / Sala de şedinţe Gottlob",3,14901,"GOTTLOB",159419,1803,848,789,58,1,840,8,1982,1134,187,653
37,"TIMIŞ","#N/A",159419,,430,"VIZEJDIA / Şcoala Generală Vizejdia",3,14901,"GOTTLOB",159419,380,149,132,17,0,148,1,416,267,25,123
37,"TIMIŞ","#N/A",159428,,431,"IECEA MARE / PRIMARIA IECEA MARE",3,14904,"IECEA MARE",159428,1164,711,595,106,10,696,15,1271,560,286,410
37,"TIMIŞ","#N/A",159428,,432,"IECEA MARE / SCOALA CU CLASELE I-IV IECEA MARE",3,14904,"IECEA MARE",159428,986,558,455,88,15,555,3,1084,526,284,271
37,"TIMIŞ","#N/A",157362,,433,"JAMU MARE / Primaria Jamu Mare",3,14906,"JAMU MARE",157362,1187,678,590,85,3,659,19,1307,629,339,320
37,"TIMIŞ","#N/A",157362,,434,"CLOPODIA / Şcoala Clopodia",3,14906,"JAMU MARE",157362,579,304,252,50,2,301,3,635,331,85,216
37,"TIMIŞ","#N/A",157362,,435,"FERENDIA / Şcoala  Ferendia",3,14906,"JAMU MARE",157362,363,211,171,40,0,211,0,396,185,90,121
37,"TIMIŞ","#N/A",157362,,436,"GHERMAN / Căminul Cultural Gherman",3,14906,"JAMU MARE",157362,199,163,117,46,0,160,3,217,54,50,110
37,"TIMIŞ","#N/A",157362,,437,"LĂŢUNAŞ / Şcoala Lăţunaş",3,14906,"JAMU MARE",157362,200,156,119,36,1,154,2,220,64,75,79
37,"TIMIŞ","#N/A",157424,,438,"JEBEL / CASA NATIONALA EFTA BOTOCA",3,14912,"JEBEL",157424,1466,1387,843,424,120,1373,14,1614,227,541,832
37,"TIMIŞ","#N/A",157424,,439,"JEBEL / GRADINITA PN JEBEL",3,14912,"JEBEL",157424,1442,954,805,139,10,950,4,1586,632,357,593
37,"TIMIŞ","#N/A",157451,,440,"LENAUHEIM / Căminul Cultural Lenauheim",3,14914,"LENAUHEIM",157451,1550,728,661,67,0,720,8,1710,982,225,495
37,"TIMIŞ","#N/A",157451,,441,"BULGĂRUŞ / Căminul Cultural Bulgăruş",3,14914,"LENAUHEIM",157451,1735,807,715,92,0,795,12,1912,1105,232,563
37,"TIMIŞ","#N/A",157451,,442,"GRABĂŢ / Căminul Cultural Grabaţ",3,14914,"LENAUHEIM",157451,1778,763,698,65,0,750,13,1955,1192,147,603
37,"TIMIŞ","#N/A",157497,,443,"LIEBLING / Căminul cultural Liebling",3,14918,"LIEBLING",157497,1515,820,729,83,8,817,3,1667,847,277,540
37,"TIMIŞ","#N/A",157497,,444,"LIEBLING / Şcoala gimnazială Liebling",3,14918,"LIEBLING",157497,1264,784,686,90,8,779,5,1388,604,262,517
37,"TIMIŞ","#N/A",157497,,445,"CERNA / Cladirea fostei Primarii din Cerna",3,14918,"LIEBLING",157497,191,117,70,47,0,117,0,207,90,34,83
37,"TIMIŞ","#N/A",157497,,446,"IOSIF / Căminul Cultural satul Iosif",3,14918,"LIEBLING",157497,268,163,126,37,0,163,0,295,132,26,137
37,"TIMIŞ","#N/A",159491,,447,"LIVEZILE / Primaria comunei Livezile",3,14922,"LIVEZILE",159491,913,489,430,59,0,482,7,1008,519,199,283
37,"TIMIŞ","#N/A",159491,,448,"DOLAŢ / Şcoala cu clasele I - IV  Dolaţ",3,14922,"LIVEZILE",159491,444,192,174,18,0,191,1,483,291,34,157
37,"TIMIŞ","#N/A",157530,,449,"LOVRIN / Grup Scolar Romulus Paraschivoiu Lovrin, nr. 202-203, judetul Timis",3,14925,"LOVRIN",157530,1951,840,765,74,1,835,5,2144,1304,234,601
37,"TIMIŞ","#N/A",157530,,450,"LOVRIN / Strand termal Lovrin, nr 752/B",3,14925,"LOVRIN",157530,1400,710,632,77,1,705,5,1534,824,176,529
37,"TIMIŞ","#N/A",157585,,451,"MARGINA / Căminul Cultural Margina",3,14932,"MARGINA",157585,1006,606,545,47,14,604,2,1103,497,391,213
37,"TIMIŞ","#N/A",157585,,452,"BREAZOVA / Căminul Cultural Breazova",3,14932,"MARGINA",157585,214,154,131,18,5,154,0,234,80,83,71
37,"TIMIŞ","#N/A",157585,,453,"COŞTEIU DE SUS / Căminul Cultural Coşteiu de Sus",3,14932,"MARGINA",157585,176,120,93,27,0,120,0,193,73,56,64
37,"TIMIŞ","#N/A",157585,,454,"GROŞI / Căminul Cultural Groşi",3,14932,"MARGINA",157585,89,70,49,21,0,70,0,97,27,44,26
37,"TIMIŞ","#N/A",157585,,455,"SINTEŞTI / Căminul Cultural Sinteşti",3,14932,"MARGINA",157585,395,286,235,48,3,283,3,436,150,144,139
37,"TIMIŞ","#N/A",157683,,456,"MAŞLOC /  Primaria Maşloc",3,14942,"MAŞLOC",157683,844,474,364,108,2,468,6,929,455,190,278
37,"TIMIŞ","#N/A",157683,,457,"ALIOŞ / Căminul Cultural Alios",3,14942,"MAŞLOC",157683,686,455,342,106,7,449,6,751,296,200,249
37,"TIMIŞ","#N/A",157683,,458,"REMETEA MICĂ / Căminul Cultural Remetea Mică",3,14942,"MAŞLOC",157683,450,268,221,46,1,263,5,494,226,89,174
37,"TIMIŞ","#N/A",157736,,459,"MĂNĂŞTIUR / Şcoala Generală Mănăştiur",3,14927,"MĂNĂŞTIUR",157736,970,570,529,41,0,563,7,1063,493,254,309
37,"TIMIŞ","#N/A",157736,,460,"PĂDURANI / Şcoala Generală Pădurani",3,14927,"MĂNĂŞTIUR",157736,67,65,41,24,0,65,0,74,9,21,44
37,"TIMIŞ","#N/A",157736,,461,"REMETEA-LUNCĂ / Şcoala Generală Remetea Luncă",3,14927,"MĂNĂŞTIUR",157736,325,218,198,20,0,216,2,354,136,76,140
37,"TIMIŞ","#N/A",157781,,462,"MORAVIŢA / CASA NATIONALA DE CULTURA Moraviţa",3,14946,"MORAVIŢA",157781,977,557,474,82,1,552,5,1078,521,306,246
37,"TIMIŞ","#N/A",157781,,463,"DEJAN / Casa Naţională Dejan",3,14946,"MORAVIŢA",157781,211,131,109,22,0,128,3,230,99,69,59
37,"TIMIŞ","#N/A",157781,,464,"GAIU MIC / Casa Naţională Gaiu Mic",3,14946,"MORAVIŢA",157781,147,103,78,25,0,102,1,163,60,64,38
37,"TIMIŞ","#N/A",157781,,465,"STAMORA GERMANĂ / Şcoala Generală Stamora Germană",3,14946,"MORAVIŢA",157781,836,463,424,39,0,460,3,916,453,274,186
37,"TIMIŞ","#N/A",157834,,466,"MOŞNIŢA NOUĂ / SCOALA CU CLASELE I - VIII MOŞNIŢA NOUĂ",3,14951,"MOŞNIŢA NOUĂ",157834,1978,1646,1212,422,12,1631,15,2168,522,456,1175
37,"TIMIŞ","#N/A",157834,,467,"MOŞNIŢA NOUĂ / SC MOTELEŢUL SRL",3,14951,"MOŞNIŢA NOUĂ",157834,442,502,328,174,0,497,5,686,184,114,383
37,"TIMIŞ","#N/A",157834,,468,"ALBINA / Şcoala cu clasele I-IV Albina",3,14951,"MOŞNIŢA NOUĂ",157834,300,278,186,89,3,278,0,330,52,106,172
37,"TIMIŞ","#N/A",157834,,469,"MOŞNIŢA VECHE / Şcoala cu clasele I-IV Moşniţa Veche",3,14951,"MOŞNIŢA NOUĂ",157834,1613,1181,949,220,12,1170,11,1759,578,303,867
37,"TIMIŞ","#N/A",157834,,470,"URSENI / Şcoalacu clasele I-IV Urseni",3,14951,"MOŞNIŢA NOUĂ",157834,1185,876,689,179,8,868,8,1298,422,212,656
37,"TIMIŞ","#N/A",157898,,471,"NĂDRAG / Grădiniţa Nădrag",3,14957,"NĂDRAG",157898,1064,611,575,35,1,599,12,1171,560,296,303
37,"TIMIŞ","#N/A",157898,,472,"NĂDRAG / Şcoala Generală Nădrag",3,14957,"NĂDRAG",157898,1161,673,625,44,4,664,9,1275,602,279,385
37,"TIMIŞ","#N/A",157898,,473,"CRIVINA / Şcoala Generală Crivina",3,14957,"NĂDRAG",157898,250,204,182,22,0,203,1,274,70,129,74
37,"TIMIŞ","#N/A",157923,,474,"NIŢCHIDORF / Holul primăriei Niţchidorf",3,14960,"NIŢCHIDORF",157923,1071,637,562,64,11,632,5,1182,545,233,399
37,"TIMIŞ","#N/A",157923,,475,"BLAJOVA / Casa Naţională Blajova",3,14960,"NIŢCHIDORF",157923,106,92,59,33,0,91,1,115,23,34,57
37,"TIMIŞ","#N/A",157923,,476,"DUBOZ / Casa Parohială Duboz",3,14960,"NIŢCHIDORF",157923,156,120,96,24,0,119,1,171,51,58,61
37,"TIMIŞ","#N/A",157969,,477,"OHABA LUNGĂ / Căminul cultural  Ohaba Lungă",3,14964,"OHABA LUNGĂ",157969,315,235,204,27,4,232,3,347,112,139,93
37,"TIMIŞ","#N/A",157969,,478,"DUBEŞTI / Căminul cultural Dubeşti",3,14964,"OHABA LUNGĂ",157969,217,157,135,21,1,153,4,239,82,52,101
37,"TIMIŞ","#N/A",157969,,479,"IERŞNIC / Căminul Cultural Ierşnic",3,14964,"OHABA LUNGĂ",157969,134,147,107,40,0,147,0,148,1,94,53
37,"TIMIŞ","#N/A",157969,,480,"OHABA ROMÂNĂ / Căminul Cultural Ohaba Română",3,14964,"OHABA LUNGĂ",157969,180,155,131,22,2,151,4,197,42,94,57
37,"TIMIŞ","#N/A",158010,,481,"ORŢIŞOARA / camin cultural Ortisoara",3,14969,"ORŢIŞOARA",158010,1128,604,517,87,0,600,4,1238,634,150,450
37,"TIMIŞ","#N/A",158010,,482,"ORŢIŞOARA / biblioteca comunala Ortisoara",3,14969,"ORŢIŞOARA",158010,931,573,485,88,0,566,7,1024,451,183,383
37,"TIMIŞ","#N/A",158010,,483,"CĂLACEA / Şcoala Generală Călacea",3,14969,"ORŢIŞOARA",158010,603,374,294,80,0,368,6,667,293,156,212
37,"TIMIŞ","#N/A",158010,,484,"CORNEŞTI / Şcoala Generală Corneşti",3,14969,"ORŢIŞOARA",158010,505,336,268,68,0,333,3,560,224,65,268
37,"TIMIŞ","#N/A",158010,,485,"SECEANI / Căminul Cultural  Seceani",3,14969,"ORŢIŞOARA",158010,451,312,248,64,0,308,4,489,177,120,188
37,"TIMIŞ","#N/A",159525,,486,"OTELEC / Căminul Cultural Otelec",3,14974,"OTELEC",159525,668,381,328,53,0,380,1,733,352,69,311
37,"TIMIŞ","#N/A",159525,,487,"IOHANISFELD / Căminul Cultural  Iohanisfeld",3,14974,"OTELEC",159525,806,367,340,27,0,365,2,886,519,76,289
37,"TIMIŞ","#N/A",159437,,488,"PARŢA / Căminul cultural Parţa",3,14979,"PARŢA",159437,1796,1232,985,237,10,1221,11,1974,742,518,703
37,"TIMIŞ","#N/A",159446,,489,"PĂDURENI / Şcoala Gimnazială Pădureni",3,14977,"PĂDURENI",159446,1432,1015,799,162,54,1012,3,1574,559,288,724
37,"TIMIŞ","#N/A",158065,,490,"PECIU NOU / Liceul Teoretic Peciu Nou",3,14981,"PECIU NOU",158065,1445,785,680,105,0,778,7,1585,800,210,568
37,"TIMIŞ","#N/A",158065,,491,"PECIU NOU / Căminul Cultural  Peciu Nou",3,14981,"PECIU NOU",158065,1471,908,687,220,1,905,3,1615,707,243,662
37,"TIMIŞ","#N/A",158065,,492,"DINIAŞ / Căminul Cultural Diniaş",3,14981,"PECIU NOU",158065,852,566,465,100,1,559,7,935,369,147,412
37,"TIMIŞ","#N/A",158065,,493,"SÎNMARTINU SÎRBESC / Şcoala  Generală cu clasele  I-IV Sînmartinu Sîrbesc",3,14981,"PECIU NOU",158065,823,420,342,78,0,412,8,904,484,115,297
37,"TIMIŞ","#N/A",158109,,494,"PERIAM / Liceul Teoretic Periam",3,14985,"PERIAM",158109,1425,776,712,39,25,772,4,1571,795,308,464
37,"TIMIŞ","#N/A",158109,,495,"PERIAM / Casa de Cultură",3,14985,"PERIAM",158109,1358,728,671,36,21,724,4,1494,766,298,426
37,"TIMIŞ","#N/A",158109,,496,"PERIAM / Liceul Teoretic Periam",3,14985,"PERIAM",158109,1333,767,679,62,26,755,12,1464,697,307,448
37,"TIMIŞ","#N/A",159507,,497,"PESAC / Căminul Cultural Pesac",3,14987,"PESAC",159507,884,500,426,61,13,495,5,973,473,264,231
37,"TIMIŞ","#N/A",159507,,498,"PESAC / Şcoala Gimnazială ""MARIA BRINDEA""",3,14987,"PESAC",159507,907,492,452,32,8,488,4,993,501,232,256
37,"TIMIŞ","#N/A",158136,,499,"PIETROASA / Căminul Cultural Pietroasa",3,14989,"PIETROASA",158136,272,225,204,17,4,223,2,299,74,146,77
37,"TIMIŞ","#N/A",158136,,500,"CRIVINA DE SUS / Căminul Cultural Crivina de Sus",3,14989,"PIETROASA",158136,161,138,111,25,2,130,8,176,38,63,67
37,"TIMIŞ","#N/A",158136,,501,"FĂRĂŞEŞTI / Căminul Cultural Fărăşeşti",3,14989,"PIETROASA",158136,172,139,126,13,0,137,2,188,49,85,52
37,"TIMIŞ","#N/A",158136,,502,"POIENI / Căminul Cultural Poieni",3,14989,"PIETROASA",158136,209,195,170,16,9,193,2,228,33,151,42
37,"TIMIŞ","#N/A",158181,,503,"PIŞCHIA / Şcoala cu cls. I-VIII Pişchia",3,14994,"PIŞCHIA",158181,1072,650,562,87,1,646,4,1177,527,207,439
37,"TIMIŞ","#N/A",158181,,504,"BENCECU DE JOS / Grădiniţa cu P.N. Bencecu de Jos",3,14994,"PIŞCHIA",158181,309,214,181,33,0,213,1,342,128,89,124
37,"TIMIŞ","#N/A",158181,,505,"BENCECU DE SUS / Şcoala cu cls. I-VIII  Bencecu de Sus",3,14994,"PIŞCHIA",158181,754,451,393,58,0,449,2,831,380,104,345
37,"TIMIŞ","#N/A",158181,,506,"MURANI / Grădiniţa cu P.N.Murani  nr.383",3,14994,"PIŞCHIA",158181,454,334,243,91,0,333,1,498,164,135,198
37,"TIMIŞ","#N/A",158243,,507,"RACOVIŢA / Şcoala Generală Racoviţa",3,15000,"RACOVIŢA",158243,696,550,419,115,16,546,4,765,215,261,285
37,"TIMIŞ","#N/A",158243,,508,"CĂPĂT / Scoala Generala Capat",3,15000,"RACOVIŢA",158243,210,159,130,29,0,157,2,231,72,75,82
37,"TIMIŞ","#N/A",158243,,509,"DRĂGOIEŞTI / Scoala Generala Dragoiesti",3,15000,"RACOVIŢA",158243,316,226,161,63,2,221,5,347,121,105,116
37,"TIMIŞ","#N/A",158243,,510,"FICĂTAR / Scoala Generala Ficatar",3,15000,"RACOVIŢA",158243,315,242,195,47,0,237,5,346,104,111,126
37,"TIMIŞ","#N/A",158243,,511,"HITIAŞ / SCOALA GENERALA HITIAS",3,15000,"RACOVIŢA",158243,664,500,412,75,13,496,4,727,227,240,256
37,"TIMIŞ","#N/A",158243,,512,"SÂRBOVA / SCOALA CU CLASELE I -IV SARBOVA",3,15000,"RACOVIŢA",158243,221,174,138,36,0,173,1,242,68,83,90
37,"TIMIŞ","#N/A",158396,,513,"REMETEA MARE / Şcoala  cu clasele I - VIII  Remetea Mare",3,15007,"REMETEA MARE",158396,1300,1173,802,365,6,1160,13,1426,253,523,637
37,"TIMIŞ","#N/A",158396,,514,"IANOVA / Şcoala cu clasele  I - IV  Ianova",3,15007,"REMETEA MARE",158396,765,553,418,132,3,549,4,842,289,149,400
37,"TIMIŞ","#N/A",158449,,515,"SACOŞU TURCESC / Şcoala cu clasele  I-VIII Sacoşu Turcesc",3,15014,"SACOŞU TURCESC",158449,718,548,388,144,16,544,4,790,242,195,349
37,"TIMIŞ","#N/A",158449,,516,"BERINI / Şcoala cu clasele I-IV Berini",3,15014,"SACOŞU TURCESC",158449,402,283,181,91,11,283,0,440,157,134,149
37,"TIMIŞ","#N/A",158449,,517,"ICLODA / Şcoala  cu clasele I-IV Icloda",3,15014,"SACOŞU TURCESC",158449,216,188,135,53,0,187,1,238,50,81,106
37,"TIMIŞ","#N/A",158449,,518,"OTVEŞTI / Şcoala  cu clasele I-IV Otveşti",3,15014,"SACOŞU TURCESC",158449,283,208,148,60,0,208,0,310,102,49,159
37,"TIMIŞ","#N/A",158449,,519,"STAMORA ROMÂNĂ / Scoala cu clasele I-IV Stamora Română",3,15014,"SACOŞU TURCESC",158449,212,215,117,97,1,213,2,229,14,71,142
37,"TIMIŞ","#N/A",158449,,520,"ULIUC / Şcoala cu clasele I-IV  Uliuc",3,15014,"SACOŞU TURCESC",158449,542,381,292,89,0,377,4,595,214,141,236
37,"TIMIŞ","#N/A",158449,,521,"UNIP / Şcoala  cu clasele  I-IV Unip",3,15014,"SACOŞU TURCESC",158449,185,142,105,37,0,138,4,203,61,32,106
37,"TIMIŞ","#N/A",159455,,522,"SARAVALE / SALA PRIMARIEI   NR. 167b, SARAVALE",3,15030,"SARAVALE",159455,1195,645,616,29,0,644,1,1312,667,233,411
37,"TIMIŞ","#N/A",159455,,523,"SARAVALE / CAMINUL CULTURAL NR. 673, SARAVALE",3,15030,"SARAVALE",159455,882,564,528,36,0,560,4,969,405,192,368
37,"TIMIŞ","#N/A",158528,,524,"SATCHINEZ / SCOALA GIMNAZIALA CU CLASELE V-VIII SATCHINEZ",3,15032,"SATCHINEZ",158528,1258,706,631,75,0,701,5,1383,677,207,494
37,"TIMIŞ","#N/A",158528,,525,"SATCHINEZ / SCOALA GIMNAZIALA CU CLASELE V-VIII SATCHINEZ",3,15032,"SATCHINEZ",158528,1208,652,574,78,0,638,14,1330,678,156,482
37,"TIMIŞ","#N/A",158528,,526,"BĂRĂTEAZ / SCOALA GIMNAZIALA CU CLASELE I-IV BARATEAZ",3,15032,"SATCHINEZ",158528,549,325,280,45,0,324,1,603,278,76,248
37,"TIMIŞ","#N/A",158528,,527,"HODONI / SCOALA GIMNAZIALA CU CLASELE V-VIII, localitatea Hodoni",3,15032,"SATCHINEZ",158528,1008,569,506,63,0,566,3,1113,544,134,432
37,"TIMIŞ","#N/A",158564,,528,"SĂCĂLAZ / Şcoala Generală cu clasele I-VIII Săcălaz",3,15010,"SĂCĂLAZ",158564,1799,988,869,118,1,975,13,1979,991,297,678
37,"TIMIŞ","#N/A",158564,,529,"SĂCĂLAZ / Şcoala Generală cu clasele I-VIII Săcălaz",3,15010,"SĂCĂLAZ",158564,1720,970,863,106,1,959,11,1889,919,299,660
37,"TIMIŞ","#N/A",158564,,530,"SĂCĂLAZ / Căminul Cultural Săcălaz",3,15010,"SĂCĂLAZ",158564,895,597,424,172,1,596,1,984,387,186,410
37,"TIMIŞ","#N/A",158564,,531,"BEREGSĂU MARE / Căminul Cultural  Beregsău Mare",3,15010,"SĂCĂLAZ",158564,1660,1048,895,153,0,1042,6,1832,784,297,745
37,"TIMIŞ","#N/A",158564,,532,"BEREGSĂU MIC / Şcoala Generală Beregsău Mic",3,15010,"SĂCĂLAZ",158564,741,467,408,59,0,463,4,812,345,145,318
37,"TIMIŞ","#N/A",158733,,533,"SÂNPETRU MARE / Primăria comunei Sînpetru Mare",3,15027,"SÂNPETRU MARE",158733,991,433,402,31,0,429,4,1086,653,145,284
37,"TIMIŞ","#N/A",158733,,534,"SÂNPETRU MARE / Primăria comunei Sînpetru Mare",3,15027,"SÂNPETRU MARE",158733,843,399,359,40,0,399,0,929,530,126,273
37,"TIMIŞ","#N/A",158733,,535,"IGRIŞ / Şcoala cu clasele I-VIII Igriş",3,15027,"SÂNPETRU MARE",158733,921,509,439,70,0,505,4,1010,501,206,299
37,"TIMIŞ","#N/A",158608,,536,"SECAŞ / Sediul Primăriei Secaş",3,15036,"SECAŞ",158608,264,185,113,63,9,185,0,238,53,80,105
37,"TIMIŞ","#N/A",158608,,537,"CRIVOBARA / Căminul Cultural Crivobara",3,15036,"SECAŞ",158608,73,102,31,69,2,102,0,130,28,58,44
37,"TIMIŞ","#N/A",158653,,538,"SÎNANDREI / CAMINUL CULTURAL SINANDREI",3,15041,"SÎNANDREI",158653,1685,1045,838,207,0,1026,19,1853,808,377,649
37,"TIMIŞ","#N/A",158653,,539,"SÎNANDREI / SCOALA CU CLASELE I-VIII SÂNANDREI",3,15041,"SÎNANDREI",158653,1455,826,707,119,0,820,6,1593,767,292,528
37,"TIMIŞ","#N/A",158653,,540,"CARANI / Căminul Cultural  Carani",3,15041,"SÎNANDREI",158653,1658,981,816,163,2,976,5,1828,847,325,651
37,"TIMIŞ","#N/A",158653,,541,"COVACI / Şcoala  cu cls. I-IV Covaci",3,15041,"SÎNANDREI",158653,745,604,425,176,3,601,3,819,215,216,385
37,"TIMIŞ","#N/A",158699,,542,"SÎNMIHAIU ROMÂN / Primăria Sînmihaiu Român",3,15045,"SÎNMIHAIU ROMÂN",158699,1341,1016,776,236,4,1005,11,1463,447,272,733
37,"TIMIŞ","#N/A",158699,,543,"SÎNMIHAIU ROMÂN / Şcoala cu cls.I-VIII Sînmihaiu Român",3,15045,"SÎNMIHAIU ROMÂN",158699,1214,791,645,142,4,783,8,1328,537,191,592
37,"TIMIŞ","#N/A",158699,,544,"SÎNMIHAIU GERMAN / Şcoala  cu cl.I-IV Sânmihaiu German",3,15045,"SÎNMIHAIU ROMÂN",158699,796,515,425,90,0,513,2,870,355,100,413
37,"TIMIŞ","#N/A",158699,,545,"UTVIN / Gradinita cu P.N  Utvin",3,15045,"SÎNMIHAIU ROMÂN",158699,1059,720,599,121,0,715,5,1156,436,148,567
37,"TIMIŞ","#N/A",158699,,546,"UTVIN / Şcoala cu cls.I-VIII  Utvin",3,15045,"SÎNMIHAIU ROMÂN",158699,1112,740,636,104,0,732,8,1217,477,156,576
37,"TIMIŞ","#N/A",158779,,547,"ŞAG / Casa Nationala MIHAI VITEAZU",3,15022,"ŞAG",158779,1456,1026,826,197,3,1016,10,1589,563,300,716
37,"TIMIŞ","#N/A",158779,,548,"ŞAG / Casa Nationala Mihai Viteazul",3,15022,"ŞAG",158779,1301,872,719,152,1,859,13,1438,566,282,577
37,"TIMIŞ","#N/A",159464,,549,"ŞANDRA / SCOALA GENERALA SANDRA",3,15024,"ŞANDRA",159464,1232,689,595,88,6,684,5,1359,670,264,420
37,"TIMIŞ","#N/A",159464,,550,"ŞANDRA / SCOALA GENERALA SANDRA",3,15024,"ŞANDRA",159464,794,486,402,79,5,481,5,867,381,193,288
37,"TIMIŞ","#N/A",159464,,551,"UIHEI / Şcoala Generală cu clasele I-IV Uihei",3,15024,"ŞANDRA",159464,472,261,237,22,2,255,6,519,258,100,155
37,"TIMIŞ","#N/A",158804,,552,"ŞTIUCA / Căminul Cultural Ştiuca",3,15049,"ŞTIUCA",158804,799,400,379,21,0,397,3,872,472,79,318
37,"TIMIŞ","#N/A",158804,,553,"DRAGOMIREŞTI / Şcoala cu cls. I-IV Dragomireşti",3,15049,"ŞTIUCA",158804,275,143,129,14,0,142,1,303,160,35,107
37,"TIMIŞ","#N/A",158804,,554,"OLOŞAG / Căminul Cultural Oloşag",3,15049,"ŞTIUCA",158804,257,190,133,57,0,188,2,282,92,39,149
37,"TIMIŞ","#N/A",158804,,555,"ZGRIBEŞTI / Căminul Cultural Zgribeşti",3,15049,"ŞTIUCA",158804,201,157,118,39,0,156,1,220,63,70,86
37,"TIMIŞ","#N/A",158859,,556,"TEREMIA MARE / Centru Cultural",3,15054,"TEREMIA MARE",158859,1112,557,505,51,1,552,5,1223,666,202,350
37,"TIMIŞ","#N/A",158859,,557,"TEREMIA MARE / Centru Cultural",3,15054,"TEREMIA MARE",158859,1179,489,468,20,1,487,2,1294,805,192,295
37,"TIMIŞ","#N/A",158859,,558,"NERĂU / Şcoala  cu clasele  I-VIII Nerău",3,15054,"TEREMIA MARE",158859,917,451,410,40,1,446,5,1004,553,131,315
37,"TIMIŞ","#N/A",158859,,559,"TEREMIA MICĂ / Şcoala cu clasele I-IV  Teremia Mică",3,15054,"TEREMIA MARE",158859,552,224,202,22,0,223,1,611,387,63,160
37,"TIMIŞ","#N/A",158895,,560,"COLONIA FABRICII / Şcoala  Generală Sorin Leia, Colonia Fabricii",3,15058,"TOMEŞTI",158895,697,372,347,25,0,369,3,768,396,177,192
37,"TIMIŞ","#N/A",158895,,561,"BALOŞEŞTI / Căminul Cultural  Baloşeşti",3,15058,"TOMEŞTI",158895,107,85,76,9,0,85,0,117,32,26,59
37,"TIMIŞ","#N/A",158895,,562,"LUNCANII DE JOS / Şcoala Luncanii de Jos",3,15058,"TOMEŞTI",158895,314,251,223,28,0,247,4,347,96,129,118
37,"TIMIŞ","#N/A",158895,,563,"ROMÂNEŞTI / Şcoala  Româneşti",3,15058,"TOMEŞTI",158895,437,301,277,23,1,297,4,480,179,172,125
37,"TIMIŞ","#N/A",158895,,564,"TOMEŞTI / Şcoala Tomeşti",3,15058,"TOMEŞTI",158895,279,208,187,21,0,205,3,307,99,79,126
37,"TIMIŞ","#N/A",159473,,565,"TOMNATIC / PRIMARIA COMUNEI TOMNATIC , CORP A",3,15065,"TOMNATIC",159473,1656,794,748,41,5,783,11,1824,1030,318,465
37,"TIMIŞ","#N/A",159473,,566,"TOMNATIC / PRIMARIA COMUNEI TOMNATIC , CORP B",3,15065,"TOMNATIC",159473,1343,661,618,36,7,657,4,1482,821,318,339
37,"TIMIŞ","#N/A",158966,,567,"TOPOLOVĂŢU MARE / Prămăria Topolovăţu Mare",3,15067,"TOPOLOVĂŢU MARE",158966,958,642,516,125,1,638,4,1031,389,182,456
37,"TIMIŞ","#N/A",158966,,568,"CRALOVĂŢ / Căminul Cultural  Cralovăţ",3,15067,"TOPOLOVĂŢU MARE",158966,99,110,45,65,0,109,1,136,26,46,63
37,"TIMIŞ","#N/A",158966,,569,"ICTAR-BUDINŢI / Sediul fostului CAP Ictar - Budinţi",3,15067,"TOPOLOVĂŢU MARE",158966,320,281,173,108,0,281,0,351,70,57,224
37,"TIMIŞ","#N/A",158966,,570,"IOSIFALĂU / Şcoala Generală cu cls.  I-VIII Iosifalău",3,15067,"TOPOLOVĂŢU MARE",158966,427,192,168,24,0,192,0,470,278,53,139
37,"TIMIŞ","#N/A",158966,,571,"SUŞTRA / Căminul Cultural Şuştra",3,15067,"TOPOLOVĂŢU MARE",158966,334,209,149,60,0,207,2,365,156,56,151
37,"TIMIŞ","#N/A",159035,,572,"TORMAC / Căminul Cultural Tormac",3,15074,"TORMAC",159035,1386,703,634,69,0,696,7,1523,820,112,584
37,"TIMIŞ","#N/A",159035,,573,"CADAR / Căminul Cultural Cadăr",3,15074,"TORMAC",159035,232,183,147,29,7,182,1,250,67,99,83
37,"TIMIŞ","#N/A",159035,,574,"ŞIPET / Căminul Cultural Şipet",3,15074,"TORMAC",159035,657,388,340,44,4,388,0,720,332,202,186
37,"TIMIŞ","#N/A",159071,,575,"SUDRIAŞ / Telecentrul ""Traian Vuia"" Sudriaş",3,15078,"TRAIAN VUIA",159071,626,351,293,49,9,349,2,689,338,127,222
37,"TIMIŞ","#N/A",159071,,576,"SĂCENI / Căminul Cultural Săceni",3,15078,"TRAIAN VUIA",159071,162,113,98,15,0,113,0,175,62,47,66
37,"TIMIŞ","#N/A",159071,,577,"SURDUCU MIC / Căminul cultural Surducu Mic",3,15078,"TRAIAN VUIA",159071,264,174,149,25,0,173,1,290,116,91,82
37,"TIMIŞ","#N/A",159071,,578,"SUSANI / Căminul Cultural Susani",3,15078,"TRAIAN VUIA",159071,310,214,183,30,1,211,3,338,124,105,106
37,"TIMIŞ","#N/A",159071,,579,"TRAIAN VUIA / Căminul Cultural Traian Vuia",3,15078,"TRAIAN VUIA",159071,367,274,235,33,6,270,4,404,130,135,135
37,"TIMIŞ","#N/A",159142,,580,"UIVAR / Căminul Cultural Uivar",3,15085,"UIVAR",159142,1165,491,438,53,0,485,6,1281,790,162,323
37,"TIMIŞ","#N/A",159142,,581,"PUSTINIŞ / Căminul Cultural Pustiniş",3,15085,"UIVAR",159142,581,385,312,66,7,380,5,638,253,162,218
37,"TIMIŞ","#N/A",159142,,582,"RĂUŢI / Căminul Cultural Răuţi",3,15085,"UIVAR",159142,488,263,224,39,0,263,0,537,274,73,190
37,"TIMIŞ","#N/A",159142,,583,"SÂNMARTINU MAGHIAR / Şcoala Generală Sânmartinul Maghiar",3,15085,"UIVAR",159142,214,120,100,20,0,119,1,234,114,25,94
37,"TIMIŞ","#N/A",159482,,584,"VĂLCANI / Primaria Vălcani",3,15090,"VALCANI",159482,1135,725,635,55,35,718,7,1253,528,324,394
37,"TIMIŞ","#N/A",159213,,585,"VARIAŞ / Căminul Cultural  Variaş",3,15092,"VARIAŞ",159213,1726,1034,918,91,25,1021,13,1903,869,563,458
37,"TIMIŞ","#N/A",159213,,586,"VARIAŞ / Scoala cu clasele I-VIII Varias",3,15092,"VARIAŞ",159213,1755,1187,1020,142,25,1174,13,1936,749,683,491
37,"TIMIŞ","#N/A",159213,,587,"GELU / Şcoala Gelu",3,15092,"VARIAŞ",159213,1137,698,571,127,0,690,8,1257,559,313,377
37,"TIMIŞ","#N/A",159213,,588,"SÎNPETRU MIC / Şcoala  Sânpetru Mic",3,15092,"VARIAŞ",159213,470,237,213,21,3,235,2,520,283,71,164
37,"TIMIŞ","#N/A",159259,,589,"VICTOR VLAD DELAMARINA / Căminul Cultural V.V Delamarina",3,15096,"VICTOR VLAD DELAMARINA",159259,382,318,251,65,2,315,3,418,100,163,152
37,"TIMIŞ","#N/A",159259,,590,"HERENDEŞTI / Căminul Cultural Herendeşti",3,15096,"VICTOR VLAD DELAMARINA",159259,384,296,238,58,0,292,4,423,127,100,192
37,"TIMIŞ","#N/A",159259,,591,"HONORICI / Şcoala cu clasele I-IV Honorici",3,15096,"VICTOR VLAD DELAMARINA",159259,254,179,146,33,0,178,1,280,101,64,114
37,"TIMIŞ","#N/A",159259,,592,"PĂDURENI /  Şcoala cu clasele I-IV Pădureni",3,15096,"VICTOR VLAD DELAMARINA",159259,159,118,91,21,6,116,2,174,56,59,57
37,"TIMIŞ","#N/A",159259,,593,"PETROASA MARE / Şcoala clasele I-VIII Petroasa Mare",3,15096,"VICTOR VLAD DELAMARINA",159259,865,418,377,38,3,405,13,947,529,202,203
37,"TIMIŞ","#N/A",159259,,594,"VIŞAG / Şcoala cu clasele I-IV Vişag",3,15096,"VICTOR VLAD DELAMARINA",159259,280,214,146,68,0,212,2,307,93,134,78
37,"TIMIŞ","#N/A",159339,,595,"VOITEG / Primăria  Voiteg",3,15104,"VOITEG",159339,1592,951,800,137,14,944,7,1751,800,359,585
37,"TIMIŞ","#N/A",159339,,596,"FOLEA / Şcoala cu clasele I-IV Folea",3,15104,"VOITEG",159339,380,243,195,48,0,240,3,419,176,94,146
38,"TULCEA",369,159614,,1,"TULCEA / Grădiniţa cu orar prelungit nr.18",1,15108,"MUNICIPIUL TULCEA",159614,1060,559,528,31,0,552,7,1172,613,228,324
38,"TULCEA",369,159614,,2,"TULCEA / Grădiniţa cu orar prelungit nr.18",1,15108,"MUNICIPIUL TULCEA",159614,1376,721,684,37,0,710,11,1508,787,296,414
38,"TULCEA",369,159614,,3,"TULCEA / Şcoala gimnazială    "" I.L. Caragiale""",1,15108,"MUNICIPIUL TULCEA",159614,1924,968,924,44,0,956,12,2117,1149,444,512
38,"TULCEA",369,159614,,4,"TULCEA / Şcoala gimnazială    "" I.L. Caragiale""",1,15108,"MUNICIPIUL TULCEA",159614,1844,1056,998,56,2,1038,18,2032,976,504,534
38,"TULCEA",369,159614,,5,"TULCEA / Şcoala gimnazială    "" I.L. Caragiale""",1,15108,"MUNICIPIUL TULCEA",159614,1929,966,905,59,2,947,19,2131,1165,386,561
38,"TULCEA",369,159614,,6,"TULCEA / Grădiniţa cu program prelungit nr.13",1,15108,"MUNICIPIUL TULCEA",159614,1833,878,839,39,0,867,11,2014,1136,413,454
38,"TULCEA",369,159614,,7,"TULCEA / Liceul de Arte ""George  Georgescu""",1,15108,"MUNICIPIUL TULCEA",159614,1301,849,752,96,1,839,10,1427,578,420,419
38,"TULCEA",369,159614,,8,"TULCEA / Liceul de Arte ""George  Georgescu""",1,15108,"MUNICIPIUL TULCEA",159614,1181,678,612,66,0,667,11,1309,631,278,389
38,"TULCEA",369,159614,,9,"TULCEA / Liceul de Arte ""George  Georgescu""",1,15108,"MUNICIPIUL TULCEA",159614,1407,769,729,39,1,753,16,1554,785,302,451
38,"TULCEA",369,159614,,10,"TULCEA / Liceul de Arte ""George  Georgescu""",1,15108,"MUNICIPIUL TULCEA",159614,998,609,545,62,2,605,4,1096,486,232,373
38,"TULCEA",369,159614,,11,"TULCEA / Liceul de Arte ""George  Georgescu""",1,15108,"MUNICIPIUL TULCEA",159614,1005,618,536,82,0,607,11,1111,493,279,328
38,"TULCEA",369,159614,,12,"TULCEA / Grădiniţa cu program prelungit nr.12",1,15108,"MUNICIPIUL TULCEA",159614,1824,1060,1025,35,0,1045,15,2015,955,469,576
38,"TULCEA",369,159614,,13,"TULCEA / Liceul Teoretic ""Ion Creangă""",1,15108,"MUNICIPIUL TULCEA",159614,1300,988,668,84,236,979,9,1584,596,519,460
38,"TULCEA",369,159614,,14,"TULCEA / Liceul Teoretic ""Ion Creangă""",1,15108,"MUNICIPIUL TULCEA",159614,1003,711,494,8,209,700,11,1269,558,383,317
38,"TULCEA",369,159614,,15,"TULCEA / ŞCOALA GIMNAZIALĂ ELENA DOAMNA",1,15108,"MUNICIPIUL TULCEA",159614,1375,839,796,43,0,828,11,1511,672,320,508
38,"TULCEA",369,159614,,16,"TULCEA / ŞCOALA GIMNAZIALĂ ELENA DOAMNA",1,15108,"MUNICIPIUL TULCEA",159614,1037,568,527,41,0,563,5,1146,578,238,325
38,"TULCEA",369,159614,,17,"TULCEA / SEMINARUL TEOLOGIC ORTODOX SF. IOAN CASIAN",1,15108,"MUNICIPIUL TULCEA",159614,1113,716,627,66,23,713,3,1227,511,308,405
38,"TULCEA",369,159614,,18,"TULCEA / SEMINARUL TEOLOGIC ORTODOX SF. IOAN CASIAN",1,15108,"MUNICIPIUL TULCEA",159614,994,580,539,40,1,567,13,1096,516,226,341
38,"TULCEA",369,159614,,19,"TULCEA / TEATRUL JEAN BART",1,15108,"MUNICIPIUL TULCEA",159614,1787,1153,1046,105,2,1138,15,1966,813,503,635
38,"TULCEA",369,159614,,20,"TULCEA / ŞCOALA GIMNAZIALĂ GRIGORE ANTIPA",1,15108,"MUNICIPIUL TULCEA",159614,1266,753,702,51,0,738,15,1394,641,338,400
38,"TULCEA",369,159614,,21,"TULCEA / ŞCOALA GIMNAZIALĂ GRIGORE ANTIPA",1,15108,"MUNICIPIUL TULCEA",159614,1211,724,679,44,1,711,13,1332,608,273,438
38,"TULCEA",369,159614,,22,"TULCEA / GRĂDINIŢA CU ORAR PRELUNGIT DUMBRAVA MINUNATĂ",1,15108,"MUNICIPIUL TULCEA",159614,1883,1094,1028,66,0,1078,16,2074,980,392,686
38,"TULCEA",369,159614,,23,"TULCEA / Şcoala Gimnazială ""Alexandru Ciucurencu""",1,15108,"MUNICIPIUL TULCEA",159614,1374,958,753,199,6,936,22,1512,554,395,541
38,"TULCEA",369,159614,,24,"TULCEA / Şcoala Gimnazială ""Alexandru Ciucurencu""",1,15108,"MUNICIPIUL TULCEA",159614,1802,1014,939,75,0,996,18,1995,981,416,580
38,"TULCEA",369,159614,,25,"TULCEA / Şcoala Gimnazială ""Constantin Găvenea""",1,15108,"MUNICIPIUL TULCEA",159614,1877,1056,989,67,0,1041,15,2068,1012,381,660
38,"TULCEA",369,159614,,26,"TULCEA / Şcoala Gimnazială ""Constantin Găvenea""",1,15108,"MUNICIPIUL TULCEA",159614,1549,857,790,67,0,852,5,1713,856,303,549
38,"TULCEA",369,159614,,27,"TULCEA / Şcoala Gimnazială ""Constantin Găvenea""",1,15108,"MUNICIPIUL TULCEA",159614,1623,916,842,74,0,903,13,1779,863,366,537
38,"TULCEA",369,159614,,28,"TULCEA / Punct de încasare taxe şi impozite locale",1,15108,"MUNICIPIUL TULCEA",159614,1855,1027,959,67,1,1006,21,2046,1019,415,591
38,"TULCEA",369,159614,,29,"TULCEA / Liceul Teoretic ""Grigore Moisil""",1,15108,"MUNICIPIUL TULCEA",159614,1456,991,758,28,205,973,18,1610,619,434,539
38,"TULCEA",369,159614,,30,"TULCEA / Liceul Teoretic ""Grigore Moisil""",1,15108,"MUNICIPIUL TULCEA",159614,1257,729,645,84,0,717,12,1385,656,294,423
38,"TULCEA",369,159614,,31,"TULCEA / Şcoala Gimnazială nr.12",1,15108,"MUNICIPIUL TULCEA",159614,1372,825,775,50,0,809,16,1510,685,335,474
38,"TULCEA",369,159614,,32,"TULCEA / Şcoala Gimnazială nr.12",1,15108,"MUNICIPIUL TULCEA",159614,1495,747,694,53,0,733,14,1649,902,318,415
38,"TULCEA",369,159614,,33,"TULCEA / Sala de Sport multifuncţională",1,15108,"MUNICIPIUL TULCEA",159614,1634,898,794,104,0,883,15,1799,901,346,537
38,"TULCEA",369,159614,,34,"TULCEA / Grădiniţa cu program prelungit nr.17",1,15108,"MUNICIPIUL TULCEA",159614,1681,1023,944,79,0,1012,11,1851,828,406,606
38,"TULCEA",369,159614,,35,"TULCEA / Grădiniţa cu program prelungit nr.17",1,15108,"MUNICIPIUL TULCEA",159614,1846,901,815,86,0,890,11,2030,1129,298,592
38,"TULCEA",369,159614,,36,"TULCEA / Colegiul Tehnic ""Henry Coandă""",1,15108,"MUNICIPIUL TULCEA",159614,1590,1006,859,146,1,984,22,1755,749,405,579
38,"TULCEA",369,159614,,37,"TULCEA / Biblioteca Judeţeană",1,15108,"MUNICIPIUL TULCEA",159614,1476,924,810,114,0,903,21,1634,710,378,525
38,"TULCEA",369,159614,,38,"TULCEA / Colegiul Economic "" Delta Dunării""",1,15108,"MUNICIPIUL TULCEA",159614,1525,778,709,69,0,764,14,1696,918,246,518
38,"TULCEA",369,159614,,39,"TULCEA / Colegiul Economic "" Delta Dunării""",1,15108,"MUNICIPIUL TULCEA",159614,1008,576,507,69,0,571,5,1110,534,190,381
38,"TULCEA",369,159614,,40,"TULCEA / SC Transport Public SA",1,15108,"MUNICIPIUL TULCEA",159614,1238,744,642,102,0,741,3,1350,606,235,506
38,"TULCEA",369,159614,,41,"TULCEA / Grupul Şcolar ""Anghel Saligny""",1,15108,"MUNICIPIUL TULCEA",159614,1411,731,649,82,0,721,10,1539,808,244,477
38,"TULCEA",369,159614,,42,"TULCEA / Casa de Cultură",1,15108,"MUNICIPIUL TULCEA",159614,1550,909,833,76,0,891,18,1704,795,361,530
38,"TULCEA",369,159614,,43,"TULCEA / Casa de Cultură",1,15108,"MUNICIPIUL TULCEA",159614,515,391,283,108,0,384,7,567,176,119,265
38,"TULCEA",369,159614,,44,"TULCEA / Colegiul Dobrogean ""Spiru C. Haret""",1,15108,"MUNICIPIUL TULCEA",159614,1862,1038,957,81,0,1014,24,2054,1016,402,612
38,"TULCEA",369,159614,,45,"TULCEA / ŞCOALA GIMNAZIALĂ NIFON BĂLĂŞESCU",1,15108,"MUNICIPIUL TULCEA",159614,1183,645,600,44,1,639,6,1306,661,303,336
38,"TULCEA",369,159614,,46,"TULCEA / ŞCOALA GIMNAZIALĂ NIFON BĂLĂŞESCU",1,15108,"MUNICIPIUL TULCEA",159614,1731,957,900,57,0,949,8,1910,953,435,514
38,"TULCEA",369,159614,,47,"TULCEA / ŞCOALA GIMNAZIALĂ NIFON BĂLĂŞESCU",1,15108,"MUNICIPIUL TULCEA",159614,1607,843,775,46,22,818,25,1775,932,382,436
38,"TULCEA",369,159614,,48,"TULCEA / ŞCOALA PROFESIONALĂ DANUBIUS",1,15108,"MUNICIPIUL TULCEA",159614,1263,635,585,50,0,627,8,1392,757,313,314
38,"TULCEA",369,159614,,49,"TULCEA / ŞCOALA PROFESIONALĂ DANUBIUS",1,15108,"MUNICIPIUL TULCEA",159614,1245,606,582,24,0,594,12,1373,767,282,312
38,"TULCEA",369,159614,,50,"TULCEA / ŞCOALA PRIMARĂ NR. 9",1,15108,"MUNICIPIUL TULCEA",159614,1264,672,643,29,0,656,16,1393,721,244,412
38,"TULCEA",369,159614,,51,"TULCEA / ŞCOALA PRIMARĂ NR. 9",1,15108,"MUNICIPIUL TULCEA",159614,1345,706,672,34,0,698,8,1473,767,307,391
38,"TULCEA",369,159614,,52,"TULCEA / ŞCOALA GIMNAZIALĂ IOAN NENIŢESCU",1,15108,"MUNICIPIUL TULCEA",159614,1327,746,700,46,0,735,11,1452,706,322,413
38,"TULCEA",369,159614,,53,"TULCEA / ŞCOALA GIMNAZIALĂ IOAN NENIŢESCU",1,15108,"MUNICIPIUL TULCEA",159614,1341,780,736,43,1,767,13,1479,699,335,432
38,"TULCEA",369,159650,,54,"BABADAG / GRUP SCOLAR DIMITRIE CANTEMIR",1,15111,"ORAŞ BABADAG",159650,1548,767,690,75,2,751,16,1713,946,392,359
38,"TULCEA",369,159650,,55,"BABADAG / SCOALA GENERALA NR.1  MIRCEA CEL BATRAN",1,15111,"ORAŞ BABADAG",159650,1701,1131,931,166,34,1084,47,1873,742,559,525
38,"TULCEA",369,159650,,56,"BABADAG / SCOALA GENERALA NR.2",1,15111,"ORAŞ BABADAG",159650,1422,787,761,23,3,778,9,1565,778,409,369
38,"TULCEA",369,159650,,57,"BABADAG / Şcoala generală Nr. 3 ""Constantin Brâncoveanu""",1,15111,"ORAŞ BABADAG",159650,1456,545,495,50,0,525,20,1599,1054,284,241
38,"TULCEA",369,159650,,58,"BABADAG / Grădiniţa de copii nr.2-Veterani",1,15111,"ORAŞ BABADAG",159650,611,319,293,25,1,314,5,669,350,166,148
38,"TULCEA",369,159650,,59,"BABADAG / Salonul de nunţi",1,15111,"ORAŞ BABADAG",159650,1358,817,768,45,4,803,14,1498,681,405,398
38,"TULCEA",369,159687,,60,"ISACCEA / Casa de Cultură",1,15113,"ORAŞ ISACCEA",159687,1388,845,761,80,4,830,15,1523,678,371,459
38,"TULCEA",369,159687,,61,"ISACCEA / Grupul Şcolar ""C-tin Brătescu""",1,15113,"ORAŞ ISACCEA",159687,1186,738,693,44,1,725,13,1308,570,299,426
38,"TULCEA",369,159687,,62,"ISACCEA / Grădiniţa ""Constantin Brătescu""",1,15113,"ORAŞ ISACCEA",159687,1326,776,746,26,4,762,14,1466,690,348,414
38,"TULCEA",369,159687,,63,"ISACCEA / Şcoala generală Revarsarea",1,15113,"ORAŞ ISACCEA",159687,416,250,193,39,18,249,1,454,204,133,116
38,"TULCEA",369,159730,,64,"MĂCIN / Şcoala gimnazială ""Gheorghe Banea""",1,15117,"ORAŞ MĂCIN",159730,1320,660,613,44,3,651,9,1452,792,270,381
38,"TULCEA",369,159730,,65,"MĂCIN / Şcoala gimnazială ""Gheorghe Banea""",1,15117,"ORAŞ MĂCIN",159730,1406,744,713,31,0,741,3,1544,800,304,437
38,"TULCEA",369,159730,,66,"MĂCIN / Grădiniţa nr. 3",1,15117,"ORAŞ MĂCIN",159730,1306,685,634,37,14,673,12,1440,755,264,409
38,"TULCEA",369,159730,,67,"MĂCIN / Şcoala gimnazială nr. 1",1,15117,"ORAŞ MĂCIN",159730,1645,766,736,27,3,754,12,1812,1046,305,449
38,"TULCEA",369,159730,,68,"MĂCIN / Şcoala gimnazială nr. 1",1,15117,"ORAŞ MĂCIN",159730,1294,641,614,27,0,632,9,1428,787,292,340
38,"TULCEA",369,159730,,69,"MĂCIN / Liceul teoretic"" Gheorghe M. Murgoci""",1,15117,"ORAŞ MĂCIN",159730,1440,653,624,26,3,651,2,1585,932,325,326
38,"TULCEA",369,159730,,70,"MĂCIN / Liceul teoretic"" Gheorghe M. Murgoci""",1,15117,"ORAŞ MĂCIN",159730,958,364,346,17,1,361,3,1056,692,183,178
38,"TULCEA",369,159767,,71,"SULINA / clădire proprietatea SC PRODCON ANTREPRENOR GENERAL SRL Piteşti",1,15119,"ORAŞ SULINA",159767,1070,647,576,58,13,638,9,1183,536,282,356
38,"TULCEA",369,159767,,72,"SULINA / Liceul ""Jean Bart""",1,15119,"ORAŞ SULINA",159767,227,145,118,18,9,145,0,248,103,64,81
38,"TULCEA",369,159767,,73,"SULINA / Liceul ""Jean Bart""",1,15119,"ORAŞ SULINA",159767,1145,639,574,60,5,636,3,1257,618,243,393
38,"TULCEA",369,159767,,74,"SULINA / Primăria oraşului Sulina",1,15119,"ORAŞ SULINA",159767,1182,752,648,94,10,741,11,1300,548,296,445
38,"TULCEA",369,159785,,75,"BAIA / SCOALA CU CLASELE I-VIII",3,15121,"BAIA",159785,1526,968,876,89,3,953,15,1679,711,496,457
38,"TULCEA",369,159785,,76,"BAIA / SCOALA CU CLASELE I-IV",3,15121,"BAIA",159785,823,498,471,25,2,492,6,904,406,308,184
38,"TULCEA",369,159785,,77,"CAMENA / SCOALA CU CLASELE I-IV",3,15121,"BAIA",159785,319,236,198,35,3,234,2,353,117,80,154
38,"TULCEA",369,159785,,78,"CAUGAGIA / Şcoala cu clasele I-IV",3,15121,"BAIA",159785,176,121,102,19,0,117,4,194,73,54,63
38,"TULCEA",369,159785,,79,"PANDURU / Şcoala cu clasele I-IV",3,15121,"BAIA",159785,310,180,152,28,0,179,1,342,162,90,89
38,"TULCEA",369,159785,,80,"CEAMURLIA DE SUS / Şcoala cu clasele I-VIII",3,15121,"BAIA",159785,564,284,231,53,0,279,5,620,336,124,155
38,"TULCEA",369,159847,,81,"BEIDAUD / PUBLICA",3,15127,"BEIDAUD",159847,430,299,257,42,0,298,1,473,174,165,133
38,"TULCEA",369,159847,,82,"NEATÎRNAREA / Caminul cultural",3,15127,"BEIDAUD",159847,400,237,207,30,0,235,2,440,203,146,89
38,"TULCEA",369,159847,,83,"SARIGHIOL DE DEAL / Caminul cultural",3,15127,"BEIDAUD",159847,440,233,199,34,0,229,4,485,252,141,88
38,"TULCEA",369,161552,,84,"BEŞTEPE / Şcoala cu clasele I-VIII",3,15131,"BEŞTEPE",161552,1452,745,654,80,11,734,11,1576,831,425,309
38,"TULCEA",369,161552,,85,"BĂLTENII DE JOS / Şcoala",3,15131,"BEŞTEPE",161552,58,69,30,39,0,67,2,84,15,22,45
38,"TULCEA",369,159883,,86,"LETEA / Şcoala cu clasele I-IV",3,15135,"C.A. ROSETTI",159883,253,144,127,17,0,143,1,282,138,24,119
38,"TULCEA",369,159883,,87,"PERIPRAVA / Şcoala cu clasele I-IV",3,15135,"C.A. ROSETTI",159883,192,151,112,39,0,149,2,211,60,35,114
38,"TULCEA",369,159883,,88,"C.A. ROSETTI / Şcoala cu clasele I-VIII",3,15135,"C.A. ROSETTI",159883,281,133,114,19,0,131,2,308,175,59,72
38,"TULCEA",369,159945,,89,"CARCALIU / Şcoala cu clasele I-VIII",3,15141,"CARCALIU",159945,1466,567,513,52,2,564,3,1617,1050,308,256
38,"TULCEA",369,159945,,90,"CARCALIU / Şcoala cu clasele I-VIII",3,15141,"CARCALIU",159945,1219,481,431,49,1,474,7,1340,859,217,257
38,"TULCEA",369,159963,,91,"CIŞMEAUA NOUĂ / Şcoala",3,15143,"CASIMCEA",159963,38,39,27,12,0,39,0,41,2,28,11
38,"TULCEA",369,159963,,92,"CASIMCEA / Şcoala gimnazială",3,15143,"CASIMCEA",159963,1112,634,556,77,1,624,10,1230,596,328,296
38,"TULCEA",369,159963,,93,"CORUGEA / Şcoala primară",3,15143,"CASIMCEA",159963,346,174,155,19,0,172,2,381,207,129,43
38,"TULCEA",369,159963,,94,"RAHMAN / Şcoala primară",3,15143,"CASIMCEA",159963,263,151,131,20,0,151,0,288,137,120,31
38,"TULCEA",369,159963,,95,"RĂZBOIENI / Şcoala primară",3,15143,"CASIMCEA",159963,512,314,282,32,0,313,1,563,249,211,102
38,"TULCEA",369,160092,,96,"CEAMURLIA DE JOS / Şcoala generală cu clasele I-VIII",3,15151,"CEAMURLIA DE JOS",160092,992,593,506,65,22,587,6,1095,502,272,315
38,"TULCEA",369,160092,,97,"LUNCA / Şcoala generală cu clasele I-VIII",3,15151,"CEAMURLIA DE JOS",160092,1057,592,498,83,11,587,5,1160,568,232,355
38,"TULCEA",369,160047,,98,"PĂTLĂGEANCA / Şcoala",3,15154,"CEATALCHIOI",160047,168,116,82,34,0,116,0,186,70,64,52
38,"TULCEA",369,160047,,99,"CEATALCHIOI / Căminul Cultural",3,15154,"CEATALCHIOI",160047,353,226,164,62,0,226,0,387,161,73,153
38,"TULCEA",369,160047,,100,"PLAURU / Vechea şcoală",3,15154,"CEATALCHIOI",160047,40,42,22,20,0,42,0,43,1,24,18
38,"TULCEA",369,160127,,101,"MIRCEA VODĂ / Şcoala cu clasele I-IV",3,15159,"CERNA",160127,419,235,216,19,0,235,0,464,229,138,97
38,"TULCEA",369,160127,,102,"CERNA / Şcoala cu clasele I-VIII",3,15159,"CERNA",160127,1781,994,909,73,12,981,13,1961,967,655,326
38,"TULCEA",369,160127,,103,"TRAIAN / Şcoala cu clasele I-VIII",3,15159,"CERNA",160127,861,492,436,56,0,487,5,948,456,249,238
38,"TULCEA",369,160127,,104,"GENERAL PRAPORGESCU / Grădiniţa cu program normal",3,15159,"CERNA",160127,166,74,60,14,0,73,1,183,109,47,26
38,"TULCEA",369,160172,,105,"CHILIA VECHE / camin cultural",3,15164,"CHILIA VECHE",160172,895,487,367,84,36,481,6,987,500,224,257
38,"TULCEA",369,160172,,106,"CHILIA VECHE / CAMIN CULTURAL",3,15164,"CHILIA VECHE",160172,899,405,372,33,0,403,2,992,587,161,242
38,"TULCEA",369,160225,,107,"CIUCUROVA / Şcoala gimnazială",3,15169,"CIUCUROVA",160225,1104,635,549,86,0,627,8,1221,586,340,287
38,"TULCEA",369,160225,,108,"ATMAGEA / Şcoala primară",3,15169,"CIUCUROVA",160225,152,83,60,23,0,83,0,167,84,40,43
38,"TULCEA",369,160225,,109,"FÎNTÎNA MARE / Şcoala primară",3,15169,"CIUCUROVA",160225,464,278,233,45,0,274,4,512,234,141,133
38,"TULCEA",369,160261,,110,"CRIŞAN / Şcoala generală",3,15173,"CRIŞAN",160261,387,413,251,162,0,405,8,474,61,149,256
38,"TULCEA",369,160261,,111,"CARAORMAN / Şcoala generală",3,15173,"CRIŞAN",160261,270,206,176,30,0,204,2,247,41,74,130
38,"TULCEA",369,160261,,112,"MILA 23 / Şcoala generală",3,15173,"CRIŞAN",160261,386,351,280,70,1,345,6,424,73,121,224
38,"TULCEA",369,160305,,113,"DĂENI / Scoala Gimnaziala Daeni",3,15177,"DĂENI",160305,1738,997,921,76,0,978,19,1918,921,471,507
38,"TULCEA",369,160323,,114,"DOROBANŢU / Şcoala cu clasele I-VIII",3,15179,"DOROBANŢU",160323,689,426,387,36,3,422,4,763,337,274,148
38,"TULCEA",369,160323,,115,"CÎRJELARI / fosta Şcoală cu clasele I-IV",3,15179,"DOROBANŢU",160323,384,191,168,23,0,190,1,421,230,130,60
38,"TULCEA",369,160323,,116,"MEŞTERU / fosta Şcoală",3,15179,"DOROBANŢU",160323,148,94,75,19,0,92,2,162,68,61,31
38,"TULCEA",369,160387,,117,"FRECĂŢEI / Scoala Gimnaziala Frecatei",3,15185,"FRECĂŢEI",160387,1037,668,552,95,21,668,0,1140,472,326,342
38,"TULCEA",369,160387,,118,"CATALOI / Scoala Gimnaziala Cataloi",3,15185,"FRECĂŢEI",160387,1071,666,564,86,16,663,3,1183,517,374,289
38,"TULCEA",369,160387,,119,"POŞTA / Scoala Primara Posta",3,15185,"FRECĂŢEI",160387,535,352,260,70,22,343,9,582,230,205,138
38,"TULCEA",369,160387,,120,"TELIŢA / Scoala Primara Telita",3,15185,"FRECĂŢEI",160387,433,295,208,74,13,294,1,475,180,182,112
38,"TULCEA",369,160430,,121,"GRECI / Şcoala ""Centru""",3,15190,"GRECI",160430,1548,728,691,30,7,720,8,1696,967,355,365
38,"TULCEA",369,160430,,122,"GRECI / Şcoala ""Creşa""",3,15190,"GRECI",160430,1603,779,744,32,3,774,5,1760,981,369,405
38,"TULCEA",369,160430,,123,"GRECI / Şcoala ""Creşa""",3,15190,"GRECI",160430,1270,640,580,60,0,628,12,1399,759,297,331
38,"TULCEA",369,160458,,124,"GRINDU / Şcoala Gimnazială ""Nicolae Iorga""",3,15192,"GRINDU",160458,1161,814,662,93,59,806,8,1277,463,327,479
38,"TULCEA",369,160476,,125,"HAMCEARCA / SCOALA",3,15194,"HAMCEARCA",160476,287,189,142,43,4,184,5,311,122,95,89
38,"TULCEA",369,160476,,126,"BALABANCEA / SCOALA",3,15194,"HAMCEARCA",160476,288,203,155,42,6,201,2,313,110,92,109
38,"TULCEA",369,160476,,127,"NIFON / SCOALA",3,15194,"HAMCEARCA",160476,538,336,275,46,15,329,7,594,258,113,216
38,"TULCEA",369,160528,,128,"CLOŞCA / Şcoala cu clasele I-IV",3,15199,"HORIA",160528,105,76,54,19,3,75,1,115,39,62,13
38,"TULCEA",369,160528,,129,"FLOREŞTI / Şcoala cu clasele I-IV",3,15199,"HORIA",160528,242,170,123,35,12,167,3,263,93,115,52
38,"TULCEA",369,160528,,130,"HORIA / Şcoala Veche",3,15199,"HORIA",160528,852,609,482,95,32,604,5,936,327,366,238
38,"TULCEA",369,161525,,131,"I.C.BRĂTIANU / Căminul Cultural",3,15203,"I.C.BRĂTIANU",161525,977,911,655,236,20,907,4,1074,163,400,507
38,"TULCEA",369,160564,,132,"IZVOARELE / Şcoala generală",3,15205,"IZVOARELE",160564,1314,809,709,64,36,804,5,1450,641,424,380
38,"TULCEA",369,160564,,133,"ALBA / Şcoala generală",3,15205,"IZVOARELE",160564,218,135,102,27,6,133,2,242,107,72,61
38,"TULCEA",369,160564,,134,"IULIA / Şcoala generală",3,15205,"IZVOARELE",160564,279,145,111,22,12,145,0,305,160,91,54
38,"TULCEA",369,160617,,135,"JIJILA / Căminul Cultural",3,15209,"JIJILA",160617,1877,1083,1029,54,0,1074,9,2067,984,473,601
38,"TULCEA",369,160617,,136,"JIJILA / Căminul Cultural",3,15209,"JIJILA",160617,1637,966,925,40,1,956,10,1802,836,449,507
38,"TULCEA",369,160617,,137,"GARVĂN / Căminul Cultural",3,15209,"JIJILA",160617,1105,659,606,52,1,650,9,1211,552,265,385
38,"TULCEA",369,160644,,138,"SĂLCIOARA / Căminul Cultural",3,15212,"JURILOVCA",160644,1102,700,642,58,0,698,2,1210,510,441,257
38,"TULCEA",369,160644,,139,"VIŞINA / Căminul Cultural",3,15212,"JURILOVCA",160644,635,407,340,59,8,405,2,696,289,260,145
38,"TULCEA",369,160644,,140,"JURILOVCA / Şcoala generală",3,15212,"JURILOVCA",160644,1029,618,562,50,6,538,80,1134,516,359,179
38,"TULCEA",369,160644,,141,"JURILOVCA / Gradinita de copii",3,15212,"JURILOVCA",160644,1135,680,612,63,5,673,7,1250,570,418,255
38,"TULCEA",369,160680,,142,"LUNCAVIŢA / Căminul Cultural",3,15216,"LUNCAVIŢA",160680,1628,858,784,74,0,850,8,1790,932,395,455
38,"TULCEA",369,160680,,143,"LUNCAVIŢA / Căminul Cultural",3,15216,"LUNCAVIŢA",160680,1315,622,553,69,0,613,9,1449,827,277,336
38,"TULCEA",369,160680,,144,"RACHELU / Şcoala generală",3,15216,"LUNCAVIŢA",160680,655,339,273,66,0,337,2,723,384,205,132
38,"TULCEA",369,160724,,145,"MAHMUDIA / Grup Şcolar ""Vasile Bacalu""",3,15219,"MAHMUDIA",160724,1141,692,610,69,13,685,7,1257,565,329,356
38,"TULCEA",369,160724,,146,"MAHMUDIA / Grup Şcolar ""Vasile Bacalu""",3,15219,"MAHMUDIA",160724,1179,712,635,61,16,706,6,1301,589,321,385
38,"TULCEA",369,160779,,147,"GORGOVA / Şcoala cu clasele I-IV",3,15221,"MALIUC",160779,110,100,59,41,0,100,0,121,21,33,67
38,"TULCEA",369,160779,,148,"MALIUC / Şcoala cu clasele I-VIII",3,15221,"MALIUC",160779,327,199,154,44,1,197,2,359,160,87,110
38,"TULCEA",369,160779,,149,"PARTIZANI / Şcoala cu clasele I-VIII",3,15221,"MALIUC",160779,377,218,199,18,1,217,1,417,199,91,126
38,"TULCEA",369,160831,,150,"SATU NOU / Şcoala cu clasele I-IV",3,15227,"MIHAI BRAVU",160831,559,336,283,43,10,331,5,612,276,199,132
38,"TULCEA",369,160831,,151,"MIHAI BRAVU / Şcoala cu clasele I-VIII",3,15227,"MIHAI BRAVU",160831,564,264,232,19,13,262,2,620,356,149,113
38,"TULCEA",369,160831,,152,"TURDA / Căminul Cultural",3,15227,"MIHAI BRAVU",160831,958,574,501,52,21,565,9,1057,483,445,120
38,"TULCEA",369,160877,,153,"LĂSTUNI / Şcoala cu clasele I-IV",3,15231,"MIHAIL KOGĂLNICEANU",160877,434,220,186,34,0,216,4,480,260,138,78
38,"TULCEA",369,160877,,154,"RÎNDUNICA / Şcoala generală",3,15231,"MIHAIL KOGĂLNICEANU",160877,534,272,246,26,0,268,4,585,313,137,131
38,"TULCEA",369,160877,,155,"MIHAIL KOGĂLNICEANU / Şcoala de Arte şi Meserii ""Mihail Kogălniceanu""",3,15231,"MIHAIL KOGĂLNICEANU",160877,1709,984,863,95,26,969,15,1883,899,579,390
38,"TULCEA",369,160911,,156,"MURIGHIOL / Şcoala",3,15235,"MURIGHIOL",160911,1212,881,621,260,0,874,7,1339,458,272,602
38,"TULCEA",369,160911,,157,"COLINA / Şcoala",3,15235,"MURIGHIOL",160911,118,78,57,21,0,77,1,130,52,43,34
38,"TULCEA",369,160911,,158,"DUNAVĂŢU DE JOS / Şcoala",3,15235,"MURIGHIOL",160911,559,435,304,131,0,433,2,618,183,108,325
38,"TULCEA",369,160911,,159,"DUNAVĂŢU DE SUS / Şcoala",3,15235,"MURIGHIOL",160911,127,111,69,42,0,111,0,141,30,46,65
38,"TULCEA",369,160911,,160,"PLOPUL / Şcoala",3,15235,"MURIGHIOL",160911,508,266,224,42,0,264,2,561,295,115,149
38,"TULCEA",369,160911,,161,"SARINASUF / Căminul Cultural",3,15235,"MURIGHIOL",160911,376,248,209,39,0,245,3,414,166,142,103
38,"TULCEA",369,160993,,162,"TRESTENIC / Şcoala cu clasele I-IV",3,15243,"NALBANT",160993,285,173,141,32,0,171,2,314,141,93,78
38,"TULCEA",369,160993,,163,"NALBANT / Şcoala cu clasele I-VIII",3,15243,"NALBANT",160993,808,407,356,51,0,402,5,890,483,245,157
38,"TULCEA",369,160993,,164,"NICOLAE BĂLCESCU / Şcoala cu clasele I-VIII",3,15243,"NALBANT",160993,1008,383,353,30,0,379,4,1108,725,236,143
38,"TULCEA",369,161035,,165,"NICULIŢEL / Şcoala Gimnazială ""Nichifor Ludovig""",3,15247,"NICULIŢEL",161035,1362,711,653,58,0,703,8,1495,784,387,316
38,"TULCEA",369,161035,,166,"NICULIŢEL / Şcoala Gimnazială ""Nichifor Ludovig""",3,15247,"NICULIŢEL",161035,1250,701,611,90,0,695,6,1377,676,391,304
38,"TULCEA",369,161035,,167,"NICULIŢEL / Grădiniţa de copii",3,15247,"NICULIŢEL",161035,1303,668,621,47,0,659,9,1438,770,341,318
38,"TULCEA",369,161053,,168,"VICTORIA / Şcoala cu clasele I-IV",3,15249,"NUFĂRU",161053,176,143,87,56,0,141,2,189,46,86,55
38,"TULCEA",369,161053,,169,"NUFĂRU / Şcoala cu clasele I-VIII",3,15249,"NUFĂRU",161053,1050,705,532,169,4,697,8,1153,448,372,325
38,"TULCEA",369,161053,,170,"MALCOCI / Centrul Cultural Administrativ Social",3,15249,"NUFĂRU",161053,947,612,488,107,17,606,6,1035,423,332,274
38,"TULCEA",369,161106,,171,"OSTROV / Grădiniţa de copii Ostrov",3,15254,"OSTROV",161106,1644,875,805,67,3,861,14,1807,932,441,420
38,"TULCEA",369,161133,,172,"PARDINA / Şcoala cu clasele I-VIII",3,15257,"PARDINA",161133,458,239,170,69,0,238,1,504,265,104,134
38,"TULCEA",369,161151,,173,"PECENEAGA / Căminul Cultural",3,15259,"PECENEAGA",161151,1466,952,859,59,34,939,13,1619,667,541,398
38,"TULCEA",369,161179,,174,"SABANGIA / Şcoala cu clasele I-IV",3,15261,"SARICHIOI",161179,485,296,235,58,3,290,6,531,235,162,128
38,"TULCEA",369,161179,,175,"VISTERNA / Şcoala cu clasele I-IV",3,15261,"SARICHIOI",161179,319,181,147,34,0,180,1,350,169,89,91
38,"TULCEA",369,161179,,176,"ENISALA / Şcoala cu clasele I-VIII",3,15261,"SARICHIOI",161179,808,638,422,216,0,624,14,887,249,268,356
38,"TULCEA",369,161179,,177,"ZEBIL / Şcoala cu clasele I-VIII",3,15261,"SARICHIOI",161179,1097,617,552,65,0,606,11,1209,592,354,252
38,"TULCEA",369,161179,,178,"SARICHIOI / Şcoala veche",3,15261,"SARICHIOI",161179,1628,832,763,56,13,820,12,1793,961,318,502
38,"TULCEA",369,161179,,179,"SARICHIOI / Şcoala veche",3,15261,"SARICHIOI",161179,1450,773,728,40,5,761,12,1598,825,267,494
38,"TULCEA",369,161231,,180,"SFÎNTU GHEORGHE / CAMIN CULTURAL",3,15267,"SFÎNTU GHEORGHE",161231,741,458,391,53,14,453,5,815,357,211,242
38,"TULCEA",369,161259,,181,"SLAVA CERCHEZĂ / Consiliul Local",3,15269,"SLAVA CERCHEZĂ",161259,1081,476,406,70,0,469,7,1194,718,240,229
38,"TULCEA",369,161259,,182,"SLAVA RUSĂ / Şcoala generală cu clasele I-IV",3,15269,"SLAVA CERCHEZĂ",161259,977,406,330,76,0,405,1,1075,669,201,204
38,"TULCEA",369,161286,,183,"SMÎRDAN / Şcoala generală cu clasele I-VIII ""Mr. Ioan Murgescu""",3,15272,"SMÎRDAN",161286,938,589,490,98,1,578,11,1036,447,134,444
38,"TULCEA",369,161302,,184,"MINERI / Şcoala cu clasele I-IV",3,15274,"SOMOVA",161302,1357,799,722,76,1,793,6,1491,692,349,444
38,"TULCEA",369,161302,,185,"PARCHEŞ / Şcoala cu clasele I-IV",3,15274,"SOMOVA",161302,637,348,296,52,0,343,5,701,353,196,147
38,"TULCEA",369,161302,,186,"SOMOVA / Şcoala ""Traian Coşovei"" cu clasele I-VIII",3,15274,"SOMOVA",161302,1909,1102,980,122,0,1088,14,2102,1000,468,620
38,"TULCEA",369,161348,,187,"STEJARU / Căminul Cultural",3,15278,"STEJARU",161348,532,328,273,55,0,326,2,586,258,164,162
38,"TULCEA",369,161348,,188,"MINA ALTÎN TEPE / sediul fostei Şcoli",3,15278,"STEJARU",161348,369,187,165,22,0,186,1,408,221,113,73
38,"TULCEA",369,161348,,189,"VASILE ALECSANDRI / sediul fostei Şcoli",3,15278,"STEJARU",161348,381,237,200,37,0,235,2,416,179,141,94
38,"TULCEA",369,161384,,190,"TOPOLOG / Liceul Tehnologic Topolog Topolog",3,15282,"TOPOLOG",161384,899,553,494,59,0,546,7,989,436,317,229
38,"TULCEA",369,161384,,191,"TOPOLOG / Liceul Tehnologic Topolog",3,15282,"TOPOLOG",161384,991,573,542,30,1,565,8,1092,519,350,215
38,"TULCEA",369,161384,,192,"CALFA / Şcoala generală",3,15282,"TOPOLOG",161384,115,86,62,24,0,85,1,127,41,69,16
38,"TULCEA",369,161384,,193,"CERBU / Şcoala generală",3,15282,"TOPOLOG",161384,209,125,101,24,0,123,2,233,108,73,50
38,"TULCEA",369,161384,,194,"FĂGĂRAŞU NOU / Şcoala generală",3,15282,"TOPOLOG",161384,529,294,263,31,0,288,6,584,290,148,140
38,"TULCEA",369,161384,,195,"LUMINIŢA / Şcoala generală",3,15282,"TOPOLOG",161384,224,129,117,12,0,126,3,246,117,88,38
38,"TULCEA",369,161384,,196,"MĂGURELE / Şcoala generală",3,15282,"TOPOLOG",161384,205,175,141,34,0,174,1,225,50,131,43
38,"TULCEA",369,161384,,197,"SÎMBĂTA NOUĂ / Şcoala generală",3,15282,"TOPOLOG",161384,454,285,236,31,18,285,0,498,213,206,79
38,"TULCEA",369,161464,,198,"TURCOAIA / CAMIN CULTURAL",3,15290,"TURCOAIA",161464,1553,971,902,57,12,966,5,1709,738,539,427
38,"TULCEA",369,161464,,199,"TURCOAIA / SCOALA GENERALA",3,15290,"TURCOAIA",161464,1282,804,762,34,8,798,6,1411,607,489,309
38,"TULCEA",369,161482,,200,"VALEA NUCARILOR / Căminul Cultural",3,15294,"VALEA NUCARILOR",161482,847,560,451,106,3,556,4,937,377,366,190
38,"TULCEA",369,161482,,201,"AGIGHIOL / Căminul Cultural",3,15294,"VALEA NUCARILOR",161482,1463,794,689,103,2,780,14,1612,818,342,438
38,"TULCEA",369,161482,,202,"IAZURILE / Căminul Cultural",3,15294,"VALEA NUCARILOR",161482,683,420,364,48,8,417,3,749,329,283,134
38,"TULCEA",369,161561,,203,"VALEA TEILOR / Şcoala generală Mihai Eminescu - Valea Teilor",3,15298,"VALEA TEILOR",161561,1148,657,608,49,0,645,12,1272,615,419,226
38,"TULCEA",369,161543,,204,"VĂCĂRENI / Căminul Cultural",3,15292,"VĂCĂRENI",161543,1821,1105,993,85,27,1095,10,2001,896,538,557
39,"VASLUI",378,161945,,1,"VASLUI / Casa de Cultură a Sindicatelor",1,15301,"MUNICIPIUL VASLUI",161945,1573,985,924,59,2,967,18,1701,716,482,485
39,"VASLUI",378,161945,,2,"VASLUI / Casa de Cultură a Sindicatelor",1,15301,"MUNICIPIUL VASLUI",161945,1689,789,727,62,0,779,10,1801,1012,440,339
39,"VASLUI",378,161945,,3,"VASLUI / Liceul Mihail Kogălniceanu",1,15301,"MUNICIPIUL VASLUI",161945,1868,730,705,25,0,718,12,1901,1171,382,336
39,"VASLUI",378,161945,,4,"VASLUI / Liceul Mihail Kogălniceanu",1,15301,"MUNICIPIUL VASLUI",161945,1565,741,704,36,1,730,11,1601,860,403,327
39,"VASLUI",378,161945,,5,"VASLUI / S.C. COREVAS S.R.L.",1,15301,"MUNICIPIUL VASLUI",161945,789,394,381,13,0,382,12,901,507,164,218
39,"VASLUI",378,161945,,6,"VASLUI / S.C. COREVAS S.R.L.",1,15301,"MUNICIPIUL VASLUI",161945,1084,574,543,31,0,564,10,1201,627,207,357
39,"VASLUI",378,161945,,7,"VASLUI / Căminul de copii nr.15",1,15301,"MUNICIPIUL VASLUI",161945,1912,1000,931,53,16,993,7,2001,1001,528,465
39,"VASLUI",378,161945,,8,"VASLUI / Şcoala nr.3 Constantin Parfene",1,15301,"MUNICIPIUL VASLUI",161945,1734,689,661,28,0,683,6,1801,1112,347,336
39,"VASLUI",378,161945,,9,"VASLUI / Şcoala nr.3 Constantin Parfene",1,15301,"MUNICIPIUL VASLUI",161945,2260,293,265,25,3,288,5,2101,1808,156,132
39,"VASLUI",378,161945,,10,"VASLUI / Grădiniţa nr.5",1,15301,"MUNICIPIUL VASLUI",161945,988,390,362,28,0,383,7,1001,611,227,156
39,"VASLUI",378,161945,,11,"VASLUI / Grădiniţa nr.5",1,15301,"MUNICIPIUL VASLUI",161945,1323,408,388,20,0,399,9,1301,893,205,194
39,"VASLUI",378,161945,,12,"VASLUI / ROMSILVA - RA - filiala Vaslui",1,15301,"MUNICIPIUL VASLUI",161945,1748,913,876,37,0,900,13,1801,888,490,410
39,"VASLUI",378,161945,,13,"VASLUI / Şcoala Ajutătoare",1,15301,"MUNICIPIUL VASLUI",161945,908,547,463,30,54,543,4,1201,654,263,280
39,"VASLUI",378,161945,,14,"VASLUI / Şcoala Ajutătoare",1,15301,"MUNICIPIUL VASLUI",161945,1736,503,483,20,0,494,9,1801,1298,256,238
39,"VASLUI",378,161945,,15,"VASLUI / Şcoala nr.10 ""Mihail Sadoveanu""",1,15301,"MUNICIPIUL VASLUI",161945,1954,776,712,22,42,764,12,2201,1425,410,354
39,"VASLUI",378,161945,,16,"VASLUI / Şcoala nr.10""Mihail Sadoveanu""",1,15301,"MUNICIPIUL VASLUI",161945,1910,790,717,38,35,784,6,2101,1311,395,389
39,"VASLUI",378,161945,,17,"VASLUI / Şcoala nr.2 Dimitrie Cantemir",1,15301,"MUNICIPIUL VASLUI",161945,1607,753,699,54,0,747,6,1700,947,372,375
39,"VASLUI",378,161945,,18,"VASLUI / Liceul Sportiv",1,15301,"MUNICIPIUL VASLUI",161945,1710,732,683,49,0,719,13,1800,1068,348,371
39,"VASLUI",378,161945,,19,"VASLUI / Gradinita nr. 6",1,15301,"MUNICIPIUL VASLUI",161945,1890,719,692,27,0,712,7,1901,1182,375,337
39,"VASLUI",378,161945,,20,"VASLUI / Gradinita de copii nr.17",1,15301,"MUNICIPIUL VASLUI",161945,1857,810,769,41,0,805,5,1901,1091,452,353
39,"VASLUI",378,161945,,21,"VASLUI / Şcoala nr.5 ""Stefan cel Mare"",",1,15301,"MUNICIPIUL VASLUI",161945,1991,808,766,42,0,801,7,2001,1193,423,378
39,"VASLUI",378,161945,,22,"VASLUI / Şcoala nr.5 ""Stefan cel Mare"",",1,15301,"MUNICIPIUL VASLUI",161945,1498,833,778,52,3,821,12,1601,768,438,383
39,"VASLUI",378,161945,,23,"VASLUI / Şcoala nr.7 Constantin Motaş",1,15301,"MUNICIPIUL VASLUI",161945,993,487,449,38,0,483,4,1001,514,263,220
39,"VASLUI",378,161945,,24,"VASLUI / Şcoala nr.7 Constantin Motaş",1,15301,"MUNICIPIUL VASLUI",161945,1256,514,499,15,0,506,8,1301,787,260,246
39,"VASLUI",378,161945,,25,"VASLUI / Liceul ""Emil Racoviţă""",1,15301,"MUNICIPIUL VASLUI",161945,1712,817,771,46,0,807,10,1801,984,436,371
39,"VASLUI",378,161945,,26,"VASLUI / Grădiniţa de copii nr.12",1,15301,"MUNICIPIUL VASLUI",161945,1583,733,704,29,0,725,8,1601,868,393,332
39,"VASLUI",378,161945,,27,"VASLUI / Căminul de copii nr.3",1,15301,"MUNICIPIUL VASLUI",161945,1288,685,658,26,1,676,9,1301,616,356,320
39,"VASLUI",378,161945,,28,"VASLUI / Sala Sporturilor",1,15301,"MUNICIPIUL VASLUI",161945,1617,763,732,31,0,757,6,1701,938,384,373
39,"VASLUI",378,161945,,29,"VASLUI / Sala Sporturilor",1,15301,"MUNICIPIUL VASLUI",161945,2048,771,732,39,0,759,12,2101,1330,335,424
39,"VASLUI",378,161945,,30,"VASLUI / Şcoala nr.6 ""Mihai Eminescu""",1,15301,"MUNICIPIUL VASLUI",161945,1830,886,804,82,0,871,15,1901,1015,381,490
39,"VASLUI",378,161945,,31,"VASLUI / Şcoala nr.9 Vasile Alecsandri",1,15301,"MUNICIPIUL VASLUI",161945,1118,641,453,43,145,634,7,1401,760,373,261
39,"VASLUI",378,161945,,32,"VASLUI / Şcoala nr.9 Vasile Alecsandri",1,15301,"MUNICIPIUL VASLUI",161945,1070,601,430,25,146,594,7,1401,800,335,259
39,"VASLUI",378,161945,,33,"VASLUI / Şcoala nr.9 Vasile Alecsandri",1,15301,"MUNICIPIUL VASLUI",161945,761,407,242,24,141,403,4,1101,694,265,138
39,"VASLUI",378,161945,,34,"VASLUI / Şcoala nr.9 Vasile Alecsandri",1,15301,"MUNICIPIUL VASLUI",161945,1948,818,793,25,0,801,17,2001,1183,385,416
39,"VASLUI",378,161945,,35,"VASLUI / Şcoala nr.8 Alexandra Nechita",1,15301,"MUNICIPIUL VASLUI",161945,1080,544,494,50,0,536,8,1201,657,248,288
39,"VASLUI",378,161945,,36,"VASLUI / Şcoala nr.8 Alexandra Nechita",1,15301,"MUNICIPIUL VASLUI",161945,948,449,418,30,1,437,12,1001,552,224,213
39,"VASLUI",378,161945,,37,"VASLUI / Şcoala nr.8 Alexandra Nichita",1,15301,"MUNICIPIUL VASLUI",161945,1619,500,485,15,0,491,9,1601,1101,274,217
39,"VASLUI",378,161945,,38,"VASLUI / Şcoala nr.8 Alexandra Nichita",1,15301,"MUNICIPIUL VASLUI",161945,930,453,436,17,0,446,7,1001,548,233,213
39,"VASLUI",378,161945,,39,"VASLUI / Liceul Anghel Rugină",1,15301,"MUNICIPIUL VASLUI",161945,1682,720,655,31,34,713,7,1901,1181,347,366
39,"VASLUI",378,161945,,40,"VASLUI / Liceul Anghel Rugină",1,15301,"MUNICIPIUL VASLUI",161945,783,410,385,25,0,405,5,901,491,187,218
39,"VASLUI",378,161945,,41,"VASLUI / Şcoala nr.4 Elena Cuza",1,15301,"MUNICIPIUL VASLUI",161945,1065,577,522,55,0,570,7,1101,524,264,306
39,"VASLUI",378,161945,,42,"VASLUI / Şcoala nr.4 Elena Cuza",1,15301,"MUNICIPIUL VASLUI",161945,1091,544,515,29,0,536,8,1101,557,266,270
39,"VASLUI",378,161945,,43,"VASLUI / Şcoala nr.1 Alexandru Ioan Cuza",1,15301,"MUNICIPIUL VASLUI",161945,2011,681,647,34,0,677,4,2100,1419,398,279
39,"VASLUI",378,161945,,44,"VASLUI / Şcoala nr.1 Alexandru Ioan Cuza",1,15301,"MUNICIPIUL VASLUI",161945,1476,757,734,23,0,747,10,1601,844,330,417
39,"VASLUI",378,161945,,45,"VASLUI / Şcoala cu clasele I-IV, Bahnari",1,15301,"MUNICIPIUL VASLUI",161945,358,170,150,20,0,166,4,401,231,113,53
39,"VASLUI",378,161945,,46,"VASLUI / Şcoala cu clasele I-VIII, Viişoara",1,15301,"MUNICIPIUL VASLUI",161945,1283,615,593,22,0,610,5,1401,786,305,305
39,"VASLUI",378,161945,,47,"VASLUI / Grădiniţa cu program normal, Moara Grecilor",1,15301,"MUNICIPIUL VASLUI",161945,1604,952,913,39,0,935,17,1701,749,489,446
39,"VASLUI",378,161945,,48,"VASLUI / Şcoala cu clasele I-IV, Rediu",1,15301,"MUNICIPIUL VASLUI",161945,2022,546,518,28,0,542,4,2101,1555,399,143
39,"VASLUI",378,161945,,49,"VASLUI / Şcoala cu clasele I-VIII, Brodoc",1,15301,"MUNICIPIUL VASLUI",161945,1082,488,460,28,0,483,5,1201,713,280,203
39,"VASLUI",378,161945,,50,"VASLUI / Liceul Ştefan Procopiu",1,15301,"MUNICIPIUL VASLUI",161945,1827,802,729,73,0,796,6,1901,1099,352,444
39,"VASLUI",378,161945,,51,"VASLUI / Grădiniţa de copii nr.22 - Dispensar",1,15301,"MUNICIPIUL VASLUI",161945,1996,520,497,23,0,508,12,2101,1581,249,259
39,"VASLUI",378,161794,,52,"BÎRLAD / Şcoala Gimnazială nr. 10",1,15308,"MUNICIPIUL BÎRLAD",161794,1629,846,825,20,1,834,12,1701,855,471,363
39,"VASLUI",378,161794,,53,"BÎRLAD / Şcoala Gimnazială nr. 10",1,15308,"MUNICIPIUL BÎRLAD",161794,1803,989,962,27,0,966,23,1901,912,441,525
39,"VASLUI",378,161794,,54,"BÎRLAD / Şcoala Gimnazială nr. 10",1,15308,"MUNICIPIUL BÎRLAD",161794,1731,945,910,35,0,925,20,1801,856,470,455
39,"VASLUI",378,161794,,55,"BÎRLAD / Şcoala Generala nr. 7 ""CĂPITAN GRIGORE IGNAT""",1,15308,"MUNICIPIUL BÎRLAD",161794,880,476,461,15,0,466,10,1001,525,243,223
39,"VASLUI",378,161794,,56,"BÎRLAD / Şcoala Generala nr. 7 ""CĂPITAN GRIGORE IGNAT""",1,15308,"MUNICIPIUL BÎRLAD",161794,952,524,503,20,1,516,8,1001,477,259,257
39,"VASLUI",378,161794,,57,"BÎRLAD / Colegiul Naţional ""Gheorghe Roşca Codreanu""",1,15308,"MUNICIPIUL BÎRLAD",161794,1043,612,568,43,1,599,12,1101,490,255,344
39,"VASLUI",378,161794,,58,"BÎRLAD / Colegiul Naţional ""Gheorghe Roşca Codreanu""",1,15308,"MUNICIPIUL BÎRLAD",161794,1525,780,748,32,0,770,10,1601,821,405,365
39,"VASLUI",378,161794,,59,"BÎRLAD / Colegiul Naţional ""Gheorghe Roşca Codreanu""",1,15308,"MUNICIPIUL BÎRLAD",161794,1055,638,596,42,0,626,12,1201,563,304,322
39,"VASLUI",378,161794,,60,"BÎRLAD / Şcoala gimnazială de Arte ""N. N. Tonitza""",1,15308,"MUNICIPIUL BÎRLAD",161794,1109,682,642,40,0,668,14,1201,519,320,348
39,"VASLUI",378,161794,,61,"BÎRLAD / Şcoala gimnazială de Arte ""N. N. Tonitza""",1,15308,"MUNICIPIUL BÎRLAD",161794,999,650,594,54,2,638,12,1101,451,299,339
39,"VASLUI",378,161794,,62,"BÎRLAD / Şcoala Gimnazială nr. 8",1,15308,"MUNICIPIUL BÎRLAD",161794,675,347,329,17,1,340,7,801,454,192,148
39,"VASLUI",378,161794,,63,"BÎRLAD / Şcoala Gimnazială nr. 8",1,15308,"MUNICIPIUL BÎRLAD",161794,1406,824,779,43,2,811,13,1601,777,440,371
39,"VASLUI",378,161794,,64,"BÎRLAD / Şcoala Gimnazială nr. 8",1,15308,"MUNICIPIUL BÎRLAD",161794,1319,713,672,41,0,704,9,1401,688,382,322
39,"VASLUI",378,161794,,65,"BÎRLAD / Şcoala Gimnazială nr. 8",1,15308,"MUNICIPIUL BÎRLAD",161794,1643,856,818,37,1,849,7,1701,845,481,368
39,"VASLUI",378,161794,,66,"BÎRLAD / Şcoala Gimnazială ""MANOLACHE COSTACHE EPUREANU""",1,15308,"MUNICIPIUL BÎRLAD",161794,1446,797,719,77,1,789,8,1601,804,439,350
39,"VASLUI",378,161794,,67,"BÎRLAD / Colegiul ""ALEXANDRU IOAN CUZA""",1,15308,"MUNICIPIUL BÎRLAD",161794,1670,832,715,33,84,814,18,1801,969,406,408
39,"VASLUI",378,161794,,68,"BÎRLAD / Colegiul ""ALEXANDRU IOAN CUZA""",1,15308,"MUNICIPIUL BÎRLAD",161794,1422,757,702,19,36,748,9,1801,1044,422,326
39,"VASLUI",378,161794,,69,"BÎRLAD / Colegiul ""ALEXANDRU IOAN CUZA""",1,15308,"MUNICIPIUL BÎRLAD",161794,1450,770,752,18,0,744,26,1601,831,416,328
39,"VASLUI",378,161794,,70,"BÎRLAD / Colegiul ""ALEXANDRU IOAN CUZA""",1,15308,"MUNICIPIUL BÎRLAD",161794,1318,654,569,46,39,639,15,1501,847,356,283
39,"VASLUI",378,161794,,71,"BÎRLAD / Colegiul ""ALEXANDRU IOAN CUZA""",1,15308,"MUNICIPIUL BÎRLAD",161794,1413,699,665,34,0,692,7,1601,902,367,325
39,"VASLUI",378,161794,,72,"BÎRLAD / Colegiul ""ALEXANDRU IOAN CUZA""",1,15308,"MUNICIPIUL BÎRLAD",161794,1438,719,701,18,0,709,10,1601,882,374,335
39,"VASLUI",378,161794,,73,"BÎRLAD / Colegiul ""ALEXANDRU IOAN CUZA""",1,15308,"MUNICIPIUL BÎRLAD",161794,1513,733,705,28,0,723,10,1601,868,420,303
39,"VASLUI",378,161794,,74,"BÎRLAD / Liceul Tehnologic ""PETRU RAREŞ""",1,15308,"MUNICIPIUL BÎRLAD",161794,1110,632,604,28,0,619,13,1201,569,343,276
39,"VASLUI",378,161794,,75,"BÎRLAD / Liceul Tehnologic ""PETRU RAREŞ""",1,15308,"MUNICIPIUL BÎRLAD",161794,1415,759,734,25,0,750,9,1501,742,414,336
39,"VASLUI",378,161794,,76,"BÎRLAD / Liceul Tehnologic ""PETRU RAREŞ""",1,15308,"MUNICIPIUL BÎRLAD",161794,1526,784,759,25,0,767,17,1601,817,402,365
39,"VASLUI",378,161794,,77,"BÎRLAD / Şcoala Gimnazială  ""VICTOR IOAN POPA""",1,15308,"MUNICIPIUL BÎRLAD",161794,1200,640,609,31,0,629,11,1301,661,337,292
39,"VASLUI",378,161794,,78,"BÎRLAD / Şcoala Gimnazială  ""VICTOR IOAN POPA""",1,15308,"MUNICIPIUL BÎRLAD",161794,1359,730,710,19,1,715,15,1401,671,408,307
39,"VASLUI",378,161794,,79,"BÎRLAD / Şcoala Gimnazială ""VICTOR IOAN POPA""",1,15308,"MUNICIPIUL BÎRLAD",161794,1338,673,654,19,0,656,17,1401,728,360,296
39,"VASLUI",378,161794,,80,"BÎRLAD / Casa de Cultură a Sindicatelor ""GEORGE TUTOVEANU""",1,15308,"MUNICIPIUL BÎRLAD",161794,1362,794,721,73,0,781,13,1401,607,391,390
39,"VASLUI",378,161794,,81,"BÎRLAD / Casa de Cultură a Sindicatelor ""GEORGE TUTOVEANU""",1,15308,"MUNICIPIUL BÎRLAD",161794,1727,944,904,40,0,922,22,1801,857,407,515
39,"VASLUI",378,161794,,82,"BÎRLAD / Şcoala Gimnazială ""PRINCIPESA ELENA BIBESCU""",1,15308,"MUNICIPIUL BÎRLAD",161794,1539,816,778,38,0,805,11,1601,785,349,456
39,"VASLUI",378,161794,,83,"BÎRLAD / Şcoala Gimnazială ""PRINCIPESA ELENA BIBESCU""",1,15308,"MUNICIPIUL BÎRLAD",161794,1614,821,784,37,0,798,23,1701,880,398,400
39,"VASLUI",378,161794,,84,"BÎRLAD / Şcoala Gimnazială nr. 2",1,15308,"MUNICIPIUL BÎRLAD",161794,1021,525,478,47,0,512,13,1101,576,218,294
39,"VASLUI",378,161794,,85,"BÎRLAD / Şcoala Gimnazială nr. 2",1,15308,"MUNICIPIUL BÎRLAD",161794,729,394,372,22,0,387,7,801,407,190,197
39,"VASLUI",378,161794,,86,"BÎRLAD / Şcoala Gimnazială nr. 2",1,15308,"MUNICIPIUL BÎRLAD",161794,1152,595,573,21,1,587,8,1201,606,266,321
39,"VASLUI",378,161794,,87,"BÎRLAD / Şcoala Gimnazială nr. 2",1,15308,"MUNICIPIUL BÎRLAD",161794,859,460,422,38,0,451,9,1001,541,180,271
39,"VASLUI",378,161794,,88,"BÎRLAD / Şcoala Gimnazială ""GEORGE TUTOVEANU""",1,15308,"MUNICIPIUL BÎRLAD",161794,1513,737,685,52,0,727,10,1601,864,317,410
39,"VASLUI",378,161794,,89,"BÎRLAD / Şcoala Gimnazială ""GEORGE TUTOVEANU""",1,15308,"MUNICIPIUL BÎRLAD",161794,1744,877,832,45,0,861,16,1801,924,411,450
39,"VASLUI",378,161794,,90,"BÎRLAD / Şcoala Gimnazială ""GEORGE TUTOVEANU""",1,15308,"MUNICIPIUL BÎRLAD",161794,1431,765,715,50,0,748,17,1501,736,356,392
39,"VASLUI",378,161794,,91,"BÎRLAD / Liceul Pedagogic ""ALEXANDRU VLAHUŢĂ""",1,15308,"MUNICIPIUL BÎRLAD",161794,1216,608,586,22,0,597,11,1301,693,264,333
39,"VASLUI",378,161794,,92,"BÎRLAD / Liceul Pedagogic ""ALEXANDRU VLAHUŢĂ""",1,15308,"MUNICIPIUL BÎRLAD",161794,1390,710,672,38,0,701,9,1451,741,285,416
39,"VASLUI",378,161794,,93,"BÎRLAD / Liceul Pedagogic ""ALEXANDRU VLAHUŢĂ""",1,15308,"MUNICIPIUL BÎRLAD",161794,1586,748,693,55,0,737,11,1701,953,328,409
39,"VASLUI",378,161794,,94,"BÎRLAD / Liceul Pedagogic ""ALEXANDRU VLAHUŢĂ""",1,15308,"MUNICIPIUL BÎRLAD",161794,1247,621,576,45,0,610,11,1401,780,245,365
39,"VASLUI",378,161794,,95,"BÎRLAD / Grădiniţa cu program prelungit ""Licurici""",1,15308,"MUNICIPIUL BÎRLAD",161794,1335,674,642,30,2,658,16,1501,827,260,398
39,"VASLUI",378,161794,,96,"BÎRLAD / Grădiniţa cu program prelungit ""Licurici""",1,15308,"MUNICIPIUL BÎRLAD",161794,1388,708,675,33,0,698,10,1501,793,282,416
39,"VASLUI",378,161794,,97,"BÎRLAD / Grădiniţa cu program prelungit ""Licurici""",1,15308,"MUNICIPIUL BÎRLAD",161794,925,483,451,32,0,480,3,1001,518,187,293
39,"VASLUI",378,161829,,98,"HUŞI / Asociatia Agricola ""Corni""",1,15310,"MUNICIPIUL HUŞI",161829,1120,548,528,20,0,539,9,1201,653,255,284
39,"VASLUI",378,161829,,99,"HUŞI / Scoala Profesionala Specială ""Sf.Ecaterina""",1,15310,"MUNICIPIUL HUŞI",161829,901,508,456,52,0,502,6,1001,493,227,275
39,"VASLUI",378,161829,,100,"HUŞI / Centrul consultativ Huşi",1,15310,"MUNICIPIUL HUŞI",161829,1763,979,842,82,55,964,15,2001,1022,601,363
39,"VASLUI",378,161829,,101,"HUŞI / Colegiul Naţional ""Cuza Voda""",1,15310,"MUNICIPIUL HUŞI",161829,1092,589,560,29,0,580,9,1201,612,362,218
39,"VASLUI",378,161829,,102,"HUŞI / Liceul Tehnologic ""Ioan Corivan""",1,15310,"MUNICIPIUL HUŞI",161829,1013,594,556,38,0,584,10,1101,507,338,246
39,"VASLUI",378,161829,,103,"HUŞI / Colegiul Agricol ,,Dimitrie Cantemir""",1,15310,"MUNICIPIUL HUŞI",161829,1166,648,603,45,0,639,9,1201,553,362,277
39,"VASLUI",378,161829,,104,"HUŞI / Scoala Gimnazială ""Anastasie Panu""",1,15310,"MUNICIPIUL HUŞI",161829,1029,608,562,46,0,595,13,1101,493,345,250
39,"VASLUI",378,161829,,105,"HUŞI / Scoala Gimnazială ""Anastasie Panu""",1,15310,"MUNICIPIUL HUŞI",161829,1032,496,469,27,0,490,6,1101,605,299,191
39,"VASLUI",378,161829,,106,"HUŞI / Scoala Gimnazială ""Anastasie Panu""",1,15310,"MUNICIPIUL HUŞI",161829,1707,892,844,48,0,874,18,1801,909,446,428
39,"VASLUI",378,161829,,107,"HUŞI / Casa de Cultura  ""Alexandru Giugaru""",1,15310,"MUNICIPIUL HUŞI",161829,1112,621,578,43,0,611,10,1201,580,340,271
39,"VASLUI",378,161829,,108,"HUŞI / Scoala Gimnazială ""Mihail Sadoveanu""",1,15310,"MUNICIPIUL HUŞI",161829,1729,899,844,55,0,887,12,1801,902,489,398
39,"VASLUI",378,161829,,109,"HUŞI / Scoala Gimnazială ""Mihail Sadoveanu""",1,15310,"MUNICIPIUL HUŞI",161829,1248,698,640,58,0,685,13,1301,603,368,317
39,"VASLUI",378,161829,,110,"HUŞI / Şcoala Gimnazială ''Ion Creangă''",1,15310,"MUNICIPIUL HUŞI",161829,1611,922,871,49,2,913,9,1701,779,519,394
39,"VASLUI",378,161829,,111,"HUŞI / Scoala gimnaziala,,Ion Creanga""",1,15310,"MUNICIPIUL HUŞI",161829,1259,726,663,63,0,718,8,1301,575,412,306
39,"VASLUI",378,161829,,112,"HUŞI / Scoala Gimnazială ,,Ion Creanga""",1,15310,"MUNICIPIUL HUŞI",161829,1468,797,746,51,0,786,11,1601,804,463,323
39,"VASLUI",378,161829,,113,"HUŞI / Scoala Gimnazială nr.5",1,15310,"MUNICIPIUL HUŞI",161829,994,493,471,21,1,479,14,1001,508,210,269
39,"VASLUI",378,161829,,114,"HUŞI / Scoala Gimnazială nr.5",1,15310,"MUNICIPIUL HUŞI",161829,816,358,342,16,0,352,6,901,543,116,236
39,"VASLUI",378,161829,,115,"HUŞI / Scoala Gimnazială nr.4",1,15310,"MUNICIPIUL HUŞI",161829,1314,716,684,32,0,713,3,1401,685,454,259
39,"VASLUI",378,161829,,116,"HUŞI / Scoala Gimnazială nr.4",1,15310,"MUNICIPIUL HUŞI",161829,1423,729,706,23,0,718,11,1501,772,421,297
39,"VASLUI",378,161829,,117,"HUŞI / Directia Agricola Judeteana Vaslui - Unitatea Fitosanitara Husi",1,15310,"MUNICIPIUL HUŞI",161829,1695,759,708,51,0,743,16,1701,942,415,328
39,"VASLUI",378,164981,,118,"MURGENI / Casa de Cultura Murgeni",1,15312,"ORAŞ MURGENI",164981,1839,932,808,73,51,918,14,2101,1169,610,308
39,"VASLUI",378,164981,,119,"MURGENI / Scoala din cartierul Satul Nou",1,15312,"ORAŞ MURGENI",164981,975,268,242,26,0,262,6,1001,733,190,72
39,"VASLUI",378,164981,,120,"CÂRJA / Scoala Carja",1,15312,"ORAŞ MURGENI",164981,824,496,401,94,1,490,6,901,405,331,159
39,"VASLUI",378,164981,,121,"FLORENI / Scoala Floreni",1,15312,"ORAŞ MURGENI",164981,542,307,276,31,0,302,5,601,294,183,119
39,"VASLUI",378,164981,,122,"LĂŢEŞTI / Scoala Latesti",1,15312,"ORAŞ MURGENI",164981,272,175,152,23,0,169,6,301,126,109,60
39,"VASLUI",378,164981,,123,"RAIU / Scoala Raiu",1,15312,"ORAŞ MURGENI",164981,566,337,313,24,0,326,11,601,264,251,75
39,"VASLUI",378,164981,,124,"SĂRĂŢENI / Scoala Sarateni",1,15312,"ORAŞ MURGENI",164981,308,196,166,30,0,193,3,401,205,104,89
39,"VASLUI",378,164981,,125,"SCHINENI / Scoala Schineni",1,15312,"ORAŞ MURGENI",164981,399,238,204,34,0,233,5,501,263,165,68
39,"VASLUI",378,161856,,126,"NEGREŞTI / Casa de Cultură",1,15320,"ORAŞ NEGREŞTI",161856,1582,839,770,68,1,824,15,1601,762,448,376
39,"VASLUI",378,161856,,127,"NEGREŞTI / Casa de Cultură",1,15320,"ORAŞ NEGREŞTI",161856,1590,800,756,41,3,789,11,1601,801,414,375
39,"VASLUI",378,161856,,128,"NEGREŞTI / Cantina de Ajutor Social",1,15320,"ORAŞ NEGREŞTI",161856,1812,980,919,53,8,958,22,1901,921,547,411
39,"VASLUI",378,161856,,129,"NEGREŞTI / Şcoala Generală",1,15320,"ORAŞ NEGREŞTI",161856,847,450,430,19,1,438,12,1001,551,285,153
39,"VASLUI",378,161856,,130,"VALEA MARE / Şcoala Generală  Valea Mare",1,15320,"ORAŞ NEGREŞTI",161856,676,393,377,16,0,390,3,801,408,255,135
39,"VASLUI",378,161856,,131,"POIANA / Şcoala Generală  Poiana",1,15320,"ORAŞ NEGREŞTI",161856,225,142,121,21,0,140,2,301,159,90,50
39,"VASLUI",378,161856,,132,"CIOATELE / Şcoala Generală  Cioatele",1,15320,"ORAŞ NEGREŞTI",161856,255,158,150,8,0,158,0,301,143,112,46
39,"VASLUI",378,161856,,133,"PARPANIŢA / Şcoala Generală  Parpaniţa",1,15320,"ORAŞ NEGREŞTI",161856,473,267,246,20,1,265,2,501,234,181,84
39,"VASLUI",378,161856,,134,"GLODENI / Scoala Generala  Glodeni",1,15320,"ORAŞ NEGREŞTI",161856,218,147,127,20,0,145,2,301,154,106,39
39,"VASLUI",378,161856,,135,"CĂZĂNEŞTI / Şcoala Generală Căzăneşti",1,15320,"ORAŞ NEGREŞTI",161856,356,222,189,33,0,217,5,401,179,157,60
39,"VASLUI",378,162014,,136,"ALBEŞTI / Şcoala generală Albeşti",3,15328,"ALBEŞTI",162014,885,464,419,45,0,455,9,901,437,273,182
39,"VASLUI",378,162014,,137,"CORNI-ALBEŞTI / Şcoala generală Corni Albeşti",3,15328,"ALBEŞTI",162014,1052,551,502,49,0,547,4,1101,550,350,197
39,"VASLUI",378,162014,,138,"CRASNA / Şcoala generală Crasna",3,15328,"ALBEŞTI",162014,427,232,208,24,0,226,6,501,269,83,143
39,"VASLUI",378,162014,,139,"GURA ALBEŞTI / Şcoala generală  Cls I-IV Gura Albeşti",3,15328,"ALBEŞTI",162014,131,90,72,18,0,90,0,201,111,62,28
39,"VASLUI",378,162069,,140,"ALEXANDRU VLAHUŢĂ / Şcoala cu clasele I-VIII, Alexandru Vlahuţă",3,15333,"ALEXANDRU VLAHUŢĂ",162069,629,346,314,32,0,337,9,701,355,193,144
39,"VASLUI",378,162069,,141,"GHICANI / Şcoala cu clasele I-IV, Ghicani",3,15333,"ALEXANDRU VLAHUŢĂ",162069,144,93,68,25,0,93,0,201,108,51,42
39,"VASLUI",378,162069,,142,"BUDA / Şcoala cu clasele I-IV, Buda",3,15333,"ALEXANDRU VLAHUŢĂ",162069,232,145,127,18,0,141,4,301,156,67,74
39,"VASLUI",378,162069,,143,"MORĂRENI / Şcoala cu clasele I-IV, Morăreni",3,15333,"ALEXANDRU VLAHUŢĂ",162069,186,114,96,18,0,113,1,201,87,52,61
39,"VASLUI",378,162069,,144,"MORĂRENI / Şcoala cu clasele I-VIII, Floreşti",3,15333,"ALEXANDRU VLAHUŢĂ",162069,482,270,235,35,0,264,6,501,231,147,117
39,"VASLUI",378,162149,,145,"ARSURA / Şcoala generala Arsura",3,15338,"ARSURA",162149,570,329,286,41,2,326,3,601,272,240,86
39,"VASLUI",378,162149,,146,"FUNDĂTURA / Şcoala generală Fundătura",3,15338,"ARSURA",162149,351,186,155,31,0,185,1,401,215,90,95
39,"VASLUI",378,162149,,147,"MIHAIL KOGĂLNICEANU / Şcoala generală Pihneşti",3,15338,"ARSURA",162149,362,223,191,31,1,221,2,401,178,136,85
39,"VASLUI",378,162149,,148,"MIHAIL KOGĂLNICEANU / Şcoala generală Mihail Kogălniceanu",3,15338,"ARSURA",162149,80,67,49,17,1,67,0,101,34,50,17
39,"VASLUI",378,162194,,149,"GARA BANCA / Şcoala gimnazială nr. 1 Gara Banca",3,15360,"BANCA",162194,1012,642,568,74,0,636,6,1101,459,293,343
39,"VASLUI",378,162194,,150,"BANCA / Şcoala gimnazială Banca",3,15360,"BANCA",162194,862,479,441,38,0,475,4,901,422,287,188
39,"VASLUI",378,162194,,151,"GHERMĂNEŞTI / Şcoala primară Ghermăneşti",3,15360,"BANCA",162194,398,268,239,29,0,261,7,501,233,199,62
39,"VASLUI",378,162194,,152,"STOIŞEŞTI / Şcoala primară Stoisesti",3,15360,"BANCA",162194,492,312,275,37,0,311,1,601,289,220,91
39,"VASLUI",378,162194,,153,"ŢIFU / Şcoala gimnazială Tifu",3,15360,"BANCA",162194,333,182,159,23,0,181,1,401,219,128,53
39,"VASLUI",378,162194,,154,"41974 / Şcoala primară 1 Decembrie",3,15360,"BANCA",162194,340,229,201,28,0,226,3,401,172,156,70
39,"VASLUI",378,162194,,155,"MITOC / Şcoala primară Mitoc",3,15360,"BANCA",162194,283,201,184,17,0,199,2,301,100,151,48
39,"VASLUI",378,162194,,156,"SÎRBI / Şcoala gimnazială  Sarbi",3,15360,"BANCA",162194,337,206,173,33,0,205,1,401,195,104,101
39,"VASLUI",378,162194,,157,"STRÎMTURA-MITOC / Grădiniţa Strâmtura -Mitoc",3,15360,"BANCA",162194,151,101,83,18,0,100,1,201,100,66,34
39,"VASLUI",378,162194,,158,"MICLEŞTI / Şcoala primara Miclesti",3,15360,"BANCA",162194,198,120,103,17,0,119,1,301,181,99,20
39,"VASLUI",378,162327,,159,"BĂCANI / Şcoala cu clasele I-VIII, Băcani",3,15343,"BĂCANI",162327,1018,606,565,40,1,597,9,1101,495,361,236
39,"VASLUI",378,162327,,160,"BĂLTĂŢENI / Şcoala cu clasele I-IV, Bălţăteni",3,15343,"BĂCANI",162327,318,192,178,14,0,188,4,401,209,115,73
39,"VASLUI",378,162327,,161,"DRUJEŞTI / Şcoala cu clasele I-IV, Drujeşti",3,15343,"BĂCANI",162327,344,224,194,30,0,221,3,401,177,144,77
39,"VASLUI",378,162327,,162,"SUSENI / Şcoala cu clasele I-IV, Suseni",3,15343,"BĂCANI",162327,338,227,202,25,0,225,2,401,174,124,101
39,"VASLUI",378,162327,,163,"VULPĂŞENI / Şcoala cu clasele I-IV, Vulpăşeni",3,15343,"BĂCANI",162327,155,103,83,20,0,102,1,201,98,48,54
39,"VASLUI",378,162381,,164,"BĂCEŞTI / Şcoala cu clasele I-VIII, Băceşti",3,15349,"BĂCEŞTI",162381,1640,728,665,50,13,697,31,1701,973,491,206
39,"VASLUI",378,162381,,165,"ARMĂŞENI / Şcoala cu clasele I-IV, Armăşeni",3,15349,"BĂCEŞTI",162381,313,180,168,12,0,179,1,401,221,136,43
39,"VASLUI",378,162381,,166,"BĂBUŞA / Şcoala cu clasele I-IV, Băbuşa",3,15349,"BĂCEŞTI",162381,331,186,167,19,0,184,2,401,215,131,53
39,"VASLUI",378,162381,,167,"PĂLTINIŞ / Şcoala cu clasele I-IV, Păltiniş",3,15349,"BĂCEŞTI",162381,231,155,147,8,0,146,9,301,146,112,34
39,"VASLUI",378,162381,,168,"ŢIBĂNEŞTII BUHLII / Şcoala cu clasele I-IV, Ţibăneştii Buhlii",3,15349,"BĂCEŞTI",162381,179,112,82,23,7,112,0,201,89,71,41
39,"VASLUI",378,162381,,169,"VOVRIEŞTI / Şcoala cu clasele I-IV, Vovrieşti",3,15349,"BĂCEŞTI",162381,261,192,150,30,12,188,4,301,109,132,56
39,"VASLUI",378,162452,,170,"BĂLTENI / Şcoala  cu clasele I-VIII Bălteni",3,15356,"BĂLTENI",162452,763,484,432,51,1,477,7,801,317,351,126
39,"VASLUI",378,162452,,171,"BĂLTENI-DEAL / Şcoala  cu clasele I-IV Bălteni Deal",3,15356,"BĂLTENI",162452,377,209,182,27,0,207,2,402,193,155,52
39,"VASLUI",378,162452,,172,"CHETREŞTI / Şcoala  cu clasele I-IV Chetreşti",3,15356,"BĂLTENI",162452,109,91,64,27,0,90,1,201,110,71,19
39,"VASLUI",378,162498,,173,"BEREZENI / Şcoala nr.1, Berezeni",3,15373,"BEREZENI",162498,1172,705,643,62,0,700,5,1301,596,492,208
39,"VASLUI",378,162498,,174,"BEREZENI / Şcoala nr.3, Berezeni",3,15373,"BEREZENI",162498,715,464,445,19,0,464,0,801,337,330,134
39,"VASLUI",378,162498,,175,"SATU NOU / Scoala primara Satu Nou",3,15373,"BEREZENI",162498,1184,679,649,30,0,670,9,1201,522,469,201
39,"VASLUI",378,162498,,176,"MUŞATA / Şcoala primară Muşata",3,15373,"BEREZENI",162498,359,221,202,19,0,219,2,401,180,156,63
39,"VASLUI",378,162498,,177,"RÎNCENI / Şcoala gimnazială Rînceni",3,15373,"BEREZENI",162498,453,273,239,34,0,268,5,501,228,176,92
39,"VASLUI",378,162498,,178,"STUHULEŢ / Şcoala primară Stuhuleţ",3,15373,"BEREZENI",162498,186,124,103,21,0,123,1,201,77,72,51
39,"VASLUI",378,162559,,179,"BLĂGEŞTI / Căminul Cultural Blăgeşti",3,15379,"BLĂGEŞTI",162559,925,518,436,81,1,510,8,1001,483,349,161
39,"VASLUI",378,162559,,180,"IGEŞTI / Şcoala primara Igeşti",3,15379,"BLĂGEŞTI",162559,221,142,110,32,0,141,1,301,159,91,50
39,"VASLUI",378,162559,,181,"SIPENI / Şcoala primara Sipeni",3,15379,"BLĂGEŞTI",162559,88,66,46,20,0,66,0,101,35,53,13
39,"VASLUI",378,162595,,182,"BOGDANA / Şcoala Bogdana",3,15383,"BOGDANA",162595,474,296,241,55,0,291,5,501,205,142,149
39,"VASLUI",378,162595,,183,"SUCEVENI / Şcoala Suceveni",3,15383,"BOGDANA",162595,166,112,91,21,0,112,0,201,89,72,40
39,"VASLUI",378,162595,,184,"GĂVANU / Şcoala Gavanu",3,15383,"BOGDANA",162595,100,74,52,22,0,73,1,201,127,50,23
39,"VASLUI",378,162595,,185,"VERDEŞ / Şcoala Verdeş",3,15383,"BOGDANA",162595,160,95,77,18,0,94,1,201,106,41,53
39,"VASLUI",378,162595,,186,"LACU BABEI / Şcoala  Lacul Babei",3,15383,"BOGDANA",162595,317,201,193,8,0,200,1,401,200,87,113
39,"VASLUI",378,162693,,187,"BOGDĂNEŞTI / Căminul Cultural Bogdăneşti",3,15393,"BOGDĂNEŞTI",162693,800,508,445,57,6,497,11,901,393,330,167
39,"VASLUI",378,162693,,188,"BUDA / Şcoala generală cu clasele I-IV Buda",3,15393,"BOGDĂNEŞTI",162693,273,252,195,53,4,245,7,300,48,216,29
39,"VASLUI",378,162693,,189,"VIŞINARI / Şcoala generală cu clasele I-IV Vişinari",3,15393,"BOGDĂNEŞTI",162693,165,143,101,37,5,141,2,201,58,119,22
39,"VASLUI",378,162693,,190,"ULEA / Şcoala generală cu clasele I-IV Ulea",3,15393,"BOGDĂNEŞTI",162693,300,190,157,33,0,188,2,401,211,145,43
39,"VASLUI",378,162693,,191,"UNŢEŞTI / Şcoala generală cu clasele I-VIII, Unţeşti",3,15393,"BOGDĂNEŞTI",162693,776,488,436,39,13,484,4,801,313,378,106
39,"VASLUI",378,162693,,192,"HOROIATA / Şcoala generală cu clasele I-IV Horoiata",3,15393,"BOGDĂNEŞTI",162693,108,114,71,41,2,113,1,201,87,76,37
39,"VASLUI",378,162791,,193,"BOGDĂNIŢA / Sediul Primariei",3,15403,"BOGDĂNIŢA",162791,146,84,62,22,0,83,1,201,117,57,26
39,"VASLUI",378,162791,,194,"COROIEŞTI / Şcoala cu clasele I-IV, Coroieşti",3,15403,"BOGDĂNIŢA",162791,338,202,179,23,0,202,0,401,199,134,68
39,"VASLUI",378,162791,,195,"TUNSEŞTI / Şcoala cu clasele I-IV, Tunseşti",3,15403,"BOGDĂNIŢA",162791,202,120,111,9,0,120,0,301,181,75,45
39,"VASLUI",378,162791,,196,"CEPEŞTI / Şcoala cu clasele I-IV, Cepeşti",3,15403,"BOGDĂNIŢA",162791,456,257,223,34,0,256,1,501,244,172,84
39,"VASLUI",378,162871,,197,"BOŢEŞTI / Şcoala cu clasele I-VIII Boţeşti",3,15411,"BOŢEŞTI",162871,830,511,467,42,2,506,5,901,390,381,125
39,"VASLUI",378,162871,,198,"GUGEŞTI / Şcoala cu clasele I-VIII ""Al. Obreja"" Gugeşti",3,15411,"BOŢEŞTI",162871,830,559,513,46,0,557,2,901,342,357,200
39,"VASLUI",378,162924,,199,"AVEREŞTI / Şcoala generală Avereşti",3,15416,"BUNEŞTI-AVEREŞTI",162924,249,151,131,20,0,150,1,301,150,122,28
39,"VASLUI",378,162924,,200,"BUNEŞTI / Şcoala generală Buneşti",3,15416,"BUNEŞTI-AVEREŞTI",162924,993,599,562,32,5,595,4,1101,502,413,182
39,"VASLUI",378,162924,,201,"PLOPI / Şcoala generală Plopi",3,15416,"BUNEŞTI-AVEREŞTI",162924,398,227,199,28,0,223,4,501,274,156,67
39,"VASLUI",378,162924,,202,"ROŞIORI / Şcoala generală Armăşeni",3,15416,"BUNEŞTI-AVEREŞTI",162924,313,168,148,20,0,166,2,401,233,97,69
39,"VASLUI",378,162924,,203,"PODU OPRII / Şcoala generală Podu-Oprii",3,15416,"BUNEŞTI-AVEREŞTI",162924,210,147,107,40,0,145,2,301,154,94,51
39,"VASLUI",378,167268,,204,"CIOCANI / Căminul Cultural Ciocani",3,15424,"CIOCANI",167268,855,464,410,54,0,460,4,901,437,219,241
39,"VASLUI",378,167268,,205,"CRÂNG / Şcoala cu clasele I-IV Crâng",3,15424,"CIOCANI",167268,351,206,178,28,0,202,4,401,195,102,100
39,"VASLUI",378,163002,,206,"CODĂEŞTI / SCOALA GENERALA CODAESTI",3,15429,"CODĂEŞTI",163002,918,471,420,46,5,466,5,1001,530,297,169
39,"VASLUI",378,163002,,207,"CODĂEŞTI / SCOALA GENERALA CODAESTI",3,15429,"CODĂEŞTI",163002,788,403,381,22,0,401,2,901,498,252,149
39,"VASLUI",378,163002,,208,"PRIBEŞTI / Şcoala generală Pribeşti",3,15429,"CODĂEŞTI",163002,973,493,451,42,0,490,3,1101,608,293,197
39,"VASLUI",378,163002,,209,"REDIU GALIAN / Căminul Cultural, Rediu-Galian",3,15429,"CODĂEŞTI",163002,468,237,210,27,0,233,4,501,264,130,103
39,"VASLUI",378,163002,,210,"GHERGHELEU / SCOALA GENERALA GHERGHELEU",3,15429,"CODĂEŞTI",163002,338,187,170,17,0,187,0,401,214,120,67
39,"VASLUI",378,163057,,211,"COROIEŞTI / Şcoala Nouă cu clasele I-VIII, Coroieşti",3,15434,"COROIEŞTI",163057,774,514,466,48,0,510,4,801,287,434,76
39,"VASLUI",378,163057,,212,"CHILIENI / Şcoala cu clasele I-IV, Chilieni",3,15434,"COROIEŞTI",163057,216,146,126,20,0,142,4,301,155,112,30
39,"VASLUI",378,163057,,213,"MIRENI / Şcoala cu clasele I-IV, Mireni",3,15434,"COROIEŞTI",163057,364,217,191,26,0,213,4,401,184,150,63
39,"VASLUI",378,163057,,214,"HREASCA / Şcoala cu clasele I-IV, Hreasca",3,15434,"COROIEŞTI",163057,285,175,157,18,0,173,2,301,126,137,36
39,"VASLUI",378,163137,,215,"COSTEŞTI / Şcoala generală Costeşti",3,15442,"COSTEŞTI",163137,1485,811,740,71,0,794,17,1601,790,428,366
39,"VASLUI",378,163137,,216,"RĂDEŞTI / Şcoala generală Puntişeni",3,15442,"COSTEŞTI",163137,239,137,118,19,0,134,3,301,164,101,33
39,"VASLUI",378,163137,,217,"CHIŢCANI / Şcoala generală Chiţcani",3,15442,"COSTEŞTI",163137,255,149,135,14,0,148,1,301,152,85,63
39,"VASLUI",378,163137,,218,"DINGA / Şcoala generală Dinga",3,15442,"COSTEŞTI",163137,108,73,59,14,0,71,2,201,128,40,31
39,"VASLUI",378,163137,,219,"RĂDEŞTI / Şcoala generală Rădeşti",3,15442,"COSTEŞTI",163137,121,97,77,20,0,97,0,201,104,57,40
39,"VASLUI",378,163137,,220,"PÎRVEŞTI / Şcoala generală Pîrveşti",3,15442,"COSTEŞTI",163137,85,55,44,11,0,55,0,101,46,40,15
39,"VASLUI",378,167277,,221,"BĂLEŞTI / Şcoala cu clasele I-VIII, Băleşti",3,15449,"COZMEŞTI",167277,603,333,295,38,0,327,6,701,368,244,83
39,"VASLUI",378,167277,,222,"FÂSTÂCI / Şcoala cu clasele I - VIII Fîstîci",3,15449,"COZMEŞTI",167277,308,150,127,23,0,147,3,401,251,122,25
39,"VASLUI",378,167277,,223,"COZMEŞTI / Şcoala cu clasele I-IV , Cozmeşti",3,15449,"COZMEŞTI",167277,272,155,120,35,0,154,1,301,146,115,39
39,"VASLUI",378,167277,,224,"FÂSTÂCI / ŞCOALA  PRIMARA FÎSTÎCI",3,15449,"COZMEŞTI",167277,588,315,296,19,0,308,7,601,286,238,70
39,"VASLUI",378,163208,,225,"CREŢEŞTI / Căminul Cultural  "" Vasile Folescu"" Creţeşti",3,15454,"CREŢEŞTI",163208,472,328,279,28,21,324,4,601,273,218,106
39,"VASLUI",378,163208,,226,"CREŢEŞTII DE SUS / Şcoala noua Creţeştii de Sus",3,15454,"CREŢEŞTI",163208,545,359,288,50,21,356,3,601,242,243,113
39,"VASLUI",378,163208,,227,"SATU NOU / Şcoala noua Satu Nou",3,15454,"CREŢEŞTI",163208,265,212,162,39,11,211,1,301,89,112,99
39,"VASLUI",378,163208,,228,"BUDEŞTI / Şcoala dezafectata Budeşti",3,15454,"CREŢEŞTI",163208,182,120,101,15,4,120,0,201,81,104,16
39,"VASLUI",378,163253,,229,"DĂNEŞTI / Căminul Cultural Dăneşti",3,15459,"DĂNEŞTI",163253,463,223,190,33,0,222,1,501,278,139,83
39,"VASLUI",378,163253,,230,"EMIL RACOVIŢĂ / Şcoala cu clasele I-VIII, Emil Racoviţă",3,15459,"DĂNEŞTI",163253,706,306,280,26,0,303,3,801,495,221,82
39,"VASLUI",378,163253,,231,"BEREASA / Şcoala cu clasele I-IV Bereasa",3,15459,"DĂNEŞTI",163253,298,150,122,28,0,149,1,400,250,103,46
39,"VASLUI",378,163253,,232,"TĂTĂRĂNI / Şcoala cu clasele I-IV Tătărăni",3,15459,"DĂNEŞTI",163253,185,93,64,29,0,92,1,201,108,74,18
39,"VASLUI",378,163324,,233,"DELENI / Şcoala cu clasele I-VIII, Deleni",3,15466,"DELENI",163324,1416,801,690,110,1,786,15,1501,700,468,318
39,"VASLUI",378,163324,,234,"BULBOACA / Şcoala cu clasele I-IV Bulboaca",3,15466,"DELENI",163324,524,264,233,31,0,259,5,601,337,131,128
39,"VASLUI",378,163379,,235,"DELEŞTI / Şcoala Gimnazială nr. 1, Deleşti",3,15471,"DELEŞTI",163379,598,314,271,43,0,309,5,701,387,216,93
39,"VASLUI",378,163379,,236,"ALBEŞTI / Şcoala primară, Albeşti",3,15471,"DELEŞTI",163379,163,75,64,11,0,73,2,201,126,52,21
39,"VASLUI",378,163379,,237,"FUNDĂTURA / Şcoala primară, Fundătura",3,15471,"DELEŞTI",163379,368,219,189,30,0,217,2,401,182,124,93
39,"VASLUI",378,163379,,238,"HÎRSOVA / Şcoala gimnazială, Hîrşova",3,15471,"DELEŞTI",163379,397,241,207,34,0,233,8,501,260,131,102
39,"VASLUI",378,163379,,239,"MÎNĂSTIREA / Şcoala primară, Mînăstirea",3,15471,"DELEŞTI",163379,149,81,62,19,0,81,0,201,120,36,45
39,"VASLUI",378,163379,,240,"RĂDUIEŞTI / Şcoala primară, Răduieşti",3,15471,"DELEŞTI",163379,175,113,95,18,0,112,1,201,88,70,42
39,"VASLUI",378,164277,,241,"HURDUGI / Şcoala Hurdugi",3,15478,"DIMITRIE CANTEMIR",164277,542,302,280,22,0,300,2,601,299,204,96
39,"VASLUI",378,164277,,242,"GRUMEZOAIA / Şcoala cu clasele I-IV, Grumezoaia",3,15478,"DIMITRIE CANTEMIR",164277,354,223,181,42,0,221,2,401,178,173,48
39,"VASLUI",378,164277,,243,"GUŞIŢEI / Şcoala cu clasele I-VIII, Gusitei",3,15478,"DIMITRIE CANTEMIR",164277,614,340,321,19,0,338,2,701,361,208,130
39,"VASLUI",378,164277,,244,"PLOTONEŞTI / Şcoala Plotoneşti",3,15478,"DIMITRIE CANTEMIR",164277,287,124,113,11,0,122,2,301,177,96,26
39,"VASLUI",378,164277,,245,"URLAŢI / Şcoala Urlaţi",3,15478,"DIMITRIE CANTEMIR",164277,205,139,122,17,0,137,2,301,162,85,52
39,"VASLUI",378,167286,,246,"DODEŞTI / Şcoala gimnazială ""V.I. Popa""",3,15484,"DODEŞTI",167286,1170,705,596,68,41,698,7,1201,496,464,234
39,"VASLUI",378,167286,,247,"URDEŞTI / Şcoala primară Urdeşti",3,15484,"DODEŞTI",167286,198,139,105,30,4,138,1,301,162,81,57
39,"VASLUI",378,163486,,248,"DRAGOMIREŞTI / Căminul Cultural Dragomireşti",3,15487,"DRAGOMIREŞTI",163486,456,255,228,27,0,253,2,501,246,189,64
39,"VASLUI",378,163486,,249,"POIANA PIETREI / Şcoala cu clasele I-IV Poiana Pietrei",3,15487,"DRAGOMIREŞTI",163486,237,126,107,19,0,126,0,301,175,72,54
39,"VASLUI",378,163486,,250,"DOAGELE / Şcoala cu clasele I-VIII Doagele",3,15487,"DRAGOMIREŞTI",163486,802,421,393,28,0,415,6,901,480,209,206
39,"VASLUI",378,163486,,251,"VLADIA / Liceul tehnologic Vladia",3,15487,"DRAGOMIREŞTI",163486,385,191,171,20,0,191,0,401,210,108,83
39,"VASLUI",378,163486,,252,"BELZENI / Şcoala cu clasele I-IV Belzeni",3,15487,"DRAGOMIREŞTI",163486,194,94,71,23,0,92,2,301,207,66,26
39,"VASLUI",378,163486,,253,"BĂBUŢA / Şcoala cu clasele I-IV Băbuţa",3,15487,"DRAGOMIREŞTI",163486,125,86,71,15,0,86,0,201,115,62,24
39,"VASLUI",378,163486,,254,"RĂDENI / Şcoala nr. 1  cu clasele I-VIII Rădeni",3,15487,"DRAGOMIREŞTI",163486,889,439,399,40,0,433,6,1001,562,348,85
39,"VASLUI",378,163486,,255,"TULEŞTI / Şcoala cu clasele I-IV Tuleşti",3,15487,"DRAGOMIREŞTI",163486,151,94,76,18,0,92,2,201,107,73,19
39,"VASLUI",378,163486,,256,"POPEŞTI / Şcoala cu clasele I-IV Popeşti",3,15487,"DRAGOMIREŞTI",163486,305,170,158,12,0,167,3,401,231,120,47
39,"VASLUI",378,163618,,257,"GHERMĂNEŞTI / ŞCOALA DE EDUCAŢIE FIZICĂ ŞCOLARĂ GHERMĂNEŞTI",3,15500,"DRÎNCENI",163618,1660,886,846,40,0,871,15,1701,815,456,415
39,"VASLUI",378,163618,,258,"DRÎNCENI / Şcoala cu clasele I-IV Drînceni",3,15500,"DRÎNCENI",163618,470,270,217,53,0,266,4,501,231,168,98
39,"VASLUI",378,163618,,259,"RÎŞEŞTI / Şcoala cu clasele I-VIII Rîşeşti",3,15500,"DRÎNCENI",163618,1655,857,755,102,0,842,15,1701,844,514,328
39,"VASLUI",378,163681,,260,"EPURENI / Şcoala generală Epureni",3,15507,"DUDA-EPURENI",163681,1257,643,601,42,0,633,10,1301,658,350,283
39,"VASLUI",378,163681,,261,"DUDA / Şcoala generală Duda",3,15507,"DUDA-EPURENI",163681,1054,511,461,49,1,504,7,1101,590,284,220
39,"VASLUI",378,163681,,262,"VALEA GRECULUI / Şcoala generală  Valea Grecului",3,15507,"DUDA-EPURENI",163681,1299,605,582,23,0,594,11,1401,796,383,211
39,"VASLUI",378,163681,,263,"BOBEŞTI / Şcoala Gimnazială Bobeşti",3,15507,"DUDA-EPURENI",163681,122,76,57,19,0,74,2,201,125,53,21
39,"VASLUI",378,163734,,264,"DUMEŞTI / Şcoala gimnazială ""Mareşal C-tin Prezan"" Dumeşti",3,15512,"DUMEŞTI",163734,1103,508,462,46,0,498,10,1201,693,358,140
39,"VASLUI",378,163734,,265,"DUMEŞTI / Grădiniţa nr. 1 Dumeşti",3,15512,"DUMEŞTI",163734,694,392,368,23,1,385,7,801,409,256,129
39,"VASLUI",378,163734,,266,"DUMEŞTII VECHI / Grădiniţa Dumeştii Vechi",3,15512,"DUMEŞTI",163734,374,200,181,19,0,198,2,400,200,151,47
39,"VASLUI",378,163734,,267,"VALEA MARE / Şcoala primară Valea Mare",3,15512,"DUMEŞTI",163734,656,395,378,17,0,389,6,701,306,331,58
39,"VASLUI",378,163789,,268,"EPURENI / Camin Cultural ,, Principesa Elena Bibescu"" Epureni",3,15517,"EPURENI",163789,778,384,342,42,0,382,2,900,516,241,141
39,"VASLUI",378,163789,,269,"BURSUCI / Şcoala nr. 1  Bursuci",3,15517,"EPURENI",163789,727,335,320,15,0,332,3,801,466,237,95
39,"VASLUI",378,163789,,270,"BÎRLĂLEŞTI / Şcoala cu clasele I - IV  Barlalesti",3,15517,"EPURENI",163789,607,325,289,36,0,319,6,701,376,194,125
39,"VASLUI",378,163789,,271,"HORGA / Şcoala cu clasele I-IV Horga",3,15517,"EPURENI",163789,338,169,150,19,0,167,2,401,232,98,69
39,"VASLUI",378,163832,,272,"FĂLCIU / Liceul tehnologic ""D.Cantemir"" Fălciu",3,15522,"FĂLCIU",163832,1056,530,484,44,2,523,7,1101,571,308,215
39,"VASLUI",378,163832,,273,"FĂLCIU / Căminul Cultural, Fălciu",3,15522,"FĂLCIU",163832,1049,548,511,36,1,541,7,1101,553,326,215
39,"VASLUI",378,163832,,274,"BOGDĂNEŞTI / Şcoala generală cu clasele I-IV, Bogdăneşti",3,15522,"FĂLCIU",163832,486,243,216,27,0,238,5,601,358,155,83
39,"VASLUI",378,163832,,275,"RÎNZEŞTI / Şcoala generală cu clasele I-IV, Rînzeşti",3,15522,"FĂLCIU",163832,856,485,419,66,0,479,6,901,416,305,174
39,"VASLUI",378,163832,,276,"BOZIA / Şcoala generală cu clasele I-IV, Bozia",3,15522,"FĂLCIU",163832,368,210,194,16,0,206,4,401,191,137,69
39,"VASLUI",378,163832,,277,"COPĂCEANA / Şcoala generala cu clasele I-IV, Copăceana",3,15522,"FĂLCIU",163832,486,263,243,20,0,257,6,601,338,170,87
39,"VASLUI",378,163832,,278,"ODAIA BOGDANA / Şcoala generală cu clasele I-IV, Odaia Bogdana",3,15522,"FĂLCIU",163832,283,168,141,27,0,166,2,401,233,96,70
39,"VASLUI",378,167295,,279,"FEREŞTI / Centrul Cultural ""SANDU TRIFAN"", Fereşti",3,15529,"FEREŞTI",167295,1624,757,703,54,0,751,6,1700,943,567,184
39,"VASLUI",378,167231,,280,"FRUNTIŞENI / Şcoala cu clasele I-VIII, Fruntişeni",3,15531,"FRUNTIŞENI",167231,787,406,383,23,0,401,5,801,395,294,107
39,"VASLUI",378,167231,,281,"GRĂJDENI / Şcoala cu clasele I-VIII, Grăjdeni",3,15531,"FRUNTIŞENI",167231,636,344,321,23,0,338,6,701,357,179,159
39,"VASLUI",378,163903,,282,"GĂGEŞTI / Şcoala Găgeşti",3,15534,"GĂGEŞTI",163903,385,233,208,25,0,231,2,401,168,136,95
39,"VASLUI",378,163903,,283,"GIURCANI / Grădiniţa Giurcani",3,15534,"GĂGEŞTI",163903,457,297,243,38,16,289,8,501,204,197,92
39,"VASLUI",378,163903,,284,"PEICANI / Şcoala Peicani",3,15534,"GĂGEŞTI",163903,455,272,245,27,0,267,5,501,229,163,104
39,"VASLUI",378,163903,,285,"TUPILAŢI / Şcoala Tupilati",3,15534,"GĂGEŞTI",163903,259,180,148,32,0,174,6,301,121,124,50
39,"VASLUI",378,163967,,286,"GHERGHEŞTI / Căminul Cultural, Ghergheşti",3,15540,"GHERGHEŞTI",163967,964,517,448,69,0,509,8,1101,584,250,259
39,"VASLUI",378,163967,,287,"LUNCA / Şcoala generală cu clasele I-IV, Lunca",3,15540,"GHERGHEŞTI",163967,388,210,189,21,0,208,2,501,291,94,114
39,"VASLUI",378,163967,,288,"CORODEŞTI / Şcoala generală cu clasele I-IV, Corodeşti",3,15540,"GHERGHEŞTI",163967,208,128,106,22,0,123,5,301,173,77,46
39,"VASLUI",378,163967,,289,"CHETROSU / Şcoala generală cu clasele I-VIII, Chetrosu",3,15540,"GHERGHEŞTI",163967,414,277,247,30,0,275,2,500,223,139,136
39,"VASLUI",378,163967,,290,"DRĂXENI / Şcoala generală cu clasele I-IV, Draxeni",3,15540,"GHERGHEŞTI",163967,119,89,65,24,0,88,1,200,111,73,15
39,"VASLUI",378,164062,,291,"GÎRCENI / Căminul Cultural Gîrceni",3,15550,"GÎRCENI",164062,753,480,381,62,37,473,7,801,321,356,117
39,"VASLUI",378,164062,,292,"DUMBRĂVENI / Şcoala cu clasele I-IV, Dumbrăveni",3,15550,"GÎRCENI",164062,179,132,100,32,0,131,1,201,69,96,35
39,"VASLUI",378,164062,,293,"TROHAN / Şcoala cu clasele I-IV, Trohan",3,15550,"GÎRCENI",164062,187,124,95,29,0,124,0,201,77,77,47
39,"VASLUI",378,164062,,294,"RACOVA / Şcoala cu clasele I-VIII, Racova",3,15550,"GÎRCENI",164062,171,108,91,17,0,108,0,201,93,58,50
39,"VASLUI",378,164062,,295,"RACOVIŢA / Şcoala cu clasele I-IV, Racoviţa",3,15550,"GÎRCENI",164062,159,109,99,10,0,109,0,201,92,91,18
39,"VASLUI",378,164062,,296,"SLOBOZIA / Şcoala cu clasele I-IV, Slobozia",3,15550,"GÎRCENI",164062,338,224,213,11,0,223,1,401,177,166,57
39,"VASLUI",378,164133,,297,"GRIVIŢA / Grădiniţa cu program normal  Griviţa",3,15557,"GRIVIŢA",164133,1265,770,691,79,0,762,8,1401,631,370,392
39,"VASLUI",378,164133,,298,"TRESTIANA / Şcoala  gimnazială Trestiana",3,15557,"GRIVIŢA",164133,1123,585,546,39,0,574,11,1201,616,324,250
39,"VASLUI",378,164133,,299,"ODAIA BURSUCANI / Şcoala primară Odaia Bursucani",3,15557,"GRIVIŢA",164133,444,278,227,51,0,277,1,501,223,160,117
39,"VASLUI",378,164197,,300,"HOCENI / Căminul Cultural Hoceni",3,15561,"HOCENI",164197,437,286,259,27,0,280,6,501,215,204,76
39,"VASLUI",378,164197,,301,"BARBOŞI / Grădiniţa de copii Barboşi",3,15561,"HOCENI",164197,578,389,358,30,1,383,6,701,312,361,22
39,"VASLUI",378,164197,,302,"DELENI / Şcoala cu clasele I - IV Deleni",3,15561,"HOCENI",164197,379,256,228,28,0,254,2,401,145,203,51
39,"VASLUI",378,164197,,303,"OŢELENI / Şcoala cu clasele I-IV Oţeleni",3,15561,"HOCENI",164197,427,295,253,42,0,292,3,501,206,220,72
39,"VASLUI",378,164197,,304,"ŞIŞCANI / Şcoala cu clasele I-IV Şişcani",3,15561,"HOCENI",164197,275,237,205,32,0,232,5,301,64,197,35
39,"VASLUI",378,164197,,305,"TOMŞA / Şcoala cu clasele I-IV Tomşa",3,15561,"HOCENI",164197,105,82,66,16,0,81,1,201,119,65,16
39,"VASLUI",378,164339,,306,"IANA / Şcoala Iana",3,15569,"IANA",164339,885,543,479,64,0,540,3,1000,457,363,177
39,"VASLUI",378,164339,,307,"HĂLĂREŞTI / Şcoala Hălăreşti",3,15569,"IANA",164339,805,439,404,35,0,433,6,901,462,249,184
39,"VASLUI",378,164339,,308,"SILIŞTEA / Şcoala Siliştea",3,15569,"IANA",164339,738,489,466,23,0,486,3,801,312,353,133
39,"VASLUI",378,164339,,309,"RECEA / Şcoala Recea",3,15569,"IANA",164339,348,179,166,13,0,178,1,401,222,104,74
39,"VASLUI",378,164339,,310,"VADURILE / Grădiniţa Vadurile",3,15569,"IANA",164339,255,158,134,24,0,156,2,301,143,118,38
39,"VASLUI",378,167222,,311,"IBĂNEŞTI / Căminul Cultural Ibăneşti",3,15575,"IBĂNEŞTI",167222,529,442,374,56,12,437,5,601,159,331,106
39,"VASLUI",378,167222,,312,"MÎNZAŢI / Şcoala cu clasele I-IV, Mânzaţi",3,15575,"IBĂNEŞTI",167222,514,413,375,23,15,409,4,601,188,362,47
39,"VASLUI",378,167222,,313,"PUŢU OLARULUI / Şcoala cu clasele I-IV, Puţu Olaru",3,15575,"IBĂNEŞTI",167222,99,88,67,18,3,86,2,201,113,58,28
39,"VASLUI",378,164393,,314,"IVĂNEŞTI / Şcoala Ivăneşti",3,15579,"IVĂNEŞTI",164393,1037,531,458,72,1,518,13,1101,570,289,229
39,"VASLUI",378,164393,,315,"BROŞTENI / Şcoala Broşteni",3,15579,"IVĂNEŞTI",164393,476,242,221,20,1,240,2,501,259,141,99
39,"VASLUI",378,164393,,316,"VALEA MARE / Şcoala Valea Mare",3,15579,"IVĂNEŞTI",164393,417,226,212,14,0,223,3,501,275,177,46
39,"VASLUI",378,164393,,317,"COŞCA / Şcoala Coşca",3,15579,"IVĂNEŞTI",164393,268,143,120,23,0,139,4,301,158,84,55
39,"VASLUI",378,164393,,318,"COŞEŞTI / Şcoala Coseşti",3,15579,"IVĂNEŞTI",164393,316,178,147,31,0,177,1,401,223,129,48
39,"VASLUI",378,164393,,319,"VALEA OANEI / Şcoala Valea Oanei",3,15579,"IVĂNEŞTI",164393,243,151,127,24,0,147,4,301,150,88,59
39,"VASLUI",378,164393,,320,"URSOAIA / Şcoala Ursoaia",3,15579,"IVĂNEŞTI",164393,353,218,168,50,0,216,2,401,183,171,45
39,"VASLUI",378,164393,,321,"BLEŞCA / Şcoala Bleşca",3,15579,"IVĂNEŞTI",164393,410,226,208,18,0,222,4,501,275,129,93
39,"VASLUI",378,164543,,322,"IVEŞTI / Şcoala cu clasele I-VIII",3,15594,"IVEŞTI",164543,1177,577,552,25,0,565,12,1201,624,328,237
39,"VASLUI",378,164543,,323,"IVEŞTI / Şcoala cu clasele I-VIII",3,15594,"IVEŞTI",164543,1017,574,541,33,0,572,2,1101,527,344,228
39,"VASLUI",378,164598,,324,"LAZA / Şcoala  Gimnazială ""Mihai Eminescu"" Laza",3,15596,"LAZA",164598,1484,794,745,49,0,779,15,1601,807,472,307
39,"VASLUI",378,164598,,325,"SAUCA / Şcoala primara ,Sauca",3,15596,"LAZA",164598,880,457,433,24,0,452,5,1001,544,322,130
39,"VASLUI",378,164598,,326,"RÎŞNIŢA / Şcoala primară, Râşniţa",3,15596,"LAZA",164598,241,147,122,25,0,147,0,301,154,81,66
39,"VASLUI",378,164687,,327,"LIPOVĂŢ / Caminul Cultural Lipovat",3,15601,"LIPOVĂŢ",164687,1273,752,708,43,1,737,15,1401,649,530,207
39,"VASLUI",378,164687,,328,"CORBU / Şcoala generală Corbu",3,15601,"LIPOVĂŢ",164687,449,278,250,27,1,274,4,501,223,184,90
39,"VASLUI",378,164687,,329,"CHIŢOC / Şcoala generală Chiţoc",3,15601,"LIPOVĂŢ",164687,825,460,408,52,0,454,6,901,441,259,195
39,"VASLUI",378,164687,,330,"CĂPUŞNENI / Şcoala generală Căpuşneni",3,15601,"LIPOVĂŢ",164687,213,151,136,15,0,150,1,301,150,131,19
39,"VASLUI",378,164687,,331,"FUNDU VĂII / Şcoala generală Fundu - Văii",3,15601,"LIPOVĂŢ",164687,428,296,278,18,0,296,0,501,205,262,34
39,"VASLUI",378,164749,,332,"LUNCA BANULUI / Şcoala generală Lunca Banului",3,15607,"LUNCA BANULUI",164749,1691,810,774,36,0,802,8,1798,988,516,286
39,"VASLUI",378,164749,,333,"OŢETOAIA / Şcoala generală Oţetoaia",3,15607,"LUNCA BANULUI",164749,672,321,305,16,0,320,1,701,380,201,119
39,"VASLUI",378,164749,,334,"LUNCA VECHE / Şcoala generală Lunca Veche",3,15607,"LUNCA BANULUI",164749,72,46,38,8,0,46,0,101,55,34,12
39,"VASLUI",378,164749,,335,"FOCŞA / Şcoala generală  Focşa",3,15607,"LUNCA BANULUI",164749,151,107,92,15,0,107,0,201,94,55,52
39,"VASLUI",378,164749,,336,"BROSCOŞEŞTI / Şcoala generală Broşcoşeşti",3,15607,"LUNCA BANULUI",164749,422,203,177,26,0,201,2,501,298,103,98
39,"VASLUI",378,164829,,337,"MĂLUŞTENI / Şcoala Nouă Măluşteni",3,15615,"MĂLUŞTENI",164829,522,297,264,32,1,295,2,603,306,160,135
39,"VASLUI",378,164829,,338,"ŢUŢCANI / Şcoala Centru Tutcani",3,15615,"MĂLUŞTENI",164829,475,298,254,44,0,295,3,501,203,208,87
39,"VASLUI",378,164829,,339,"MÎNĂSTIREA / Şcoala Mănastirea",3,15615,"MĂLUŞTENI",164829,86,64,38,26,0,64,0,101,37,49,15
39,"VASLUI",378,164829,,340,"GHIREASCA / Şcoala Ghireasca",3,15615,"MĂLUŞTENI",164829,160,118,89,29,0,117,1,201,83,54,63
39,"VASLUI",378,164829,,341,"LUPEŞTI / SALA FESTIVITATI LUPESTI",3,15615,"MĂLUŞTENI",164829,385,258,216,42,0,257,1,501,243,166,91
39,"VASLUI",378,164829,,342,"MÎNZĂTEŞTI / Şcoala Minzateşti",3,15615,"MĂLUŞTENI",164829,304,208,178,30,0,205,3,401,193,176,29
39,"VASLUI",378,164892,,343,"MICLEŞTI / Căminul Cultural Micleşti",3,15622,"MICLEŞTI",164892,835,429,381,46,2,424,5,903,474,299,125
39,"VASLUI",378,164892,,344,"CHIRCEŞTI / Şcoala generală ""Ion Creangă"", Chirceşti-Deal",3,15622,"MICLEŞTI",164892,612,350,314,35,1,344,6,701,351,248,96
39,"VASLUI",378,164892,,345,"CHIRCEŞTI / Şcoala generală Chirceşti -Vale",3,15622,"MICLEŞTI",164892,368,216,195,21,0,212,4,401,185,147,65
39,"VASLUI",378,164892,,346,"POPEŞTI / Şcoala generală Popeşti",3,15622,"MICLEŞTI",164892,382,221,197,24,0,220,1,401,180,170,50
39,"VASLUI",378,164936,,347,"MUNTENII DE JOS / Sala de educaţie fizică şcolară Muntenii de Jos",3,15626,"MUNTENII DE JOS",164936,1741,1007,859,44,104,1000,7,1901,894,624,376
39,"VASLUI",378,164936,,348,"MÎNJEŞTI / Şcoala cu clasele I-IV Mînjeşti",3,15626,"MUNTENII DE JOS",164936,682,382,326,56,0,377,5,801,419,268,109
39,"VASLUI",378,164936,,349,"BĂCĂOANI / Şcoala cu clasele I-IV Băcăoani",3,15626,"MUNTENII DE JOS",164936,1069,536,497,39,0,529,7,1101,565,273,256
39,"VASLUI",378,167302,,350,"MUNTENII DE SUS / Şcoala gimnazială ""Ion Agarici"", Muntenii de Sus",3,15631,"MUNTENII DE SUS",167302,1243,508,494,14,0,498,10,1297,789,301,197
39,"VASLUI",378,167302,,351,"SATU NOU / Şcoala primară, Satu-Nou",3,15631,"MUNTENII DE SUS",167302,1081,479,466,13,0,474,5,1201,722,239,235
39,"VASLUI",378,167302,,352,"SATU NOU / Scoala primara, Satu Nou",3,15631,"MUNTENII DE SUS",167302,929,396,380,16,0,391,5,1001,605,218,173
39,"VASLUI",378,165069,,353,"OLTENEŞTI / Şcoala cu clasele I-IV, Olteneşti",3,15634,"OLTENEŞTI",165069,399,197,164,33,0,193,4,501,304,101,92
39,"VASLUI",378,165069,,354,"ZGURA / Şcoala cu clasele I-IV, Zgura",3,15634,"OLTENEŞTI",165069,81,59,48,11,0,57,2,101,42,46,11
39,"VASLUI",378,165069,,355,"CURTENI / Şcoala cu clasele I-IV, Curteni",3,15634,"OLTENEŞTI",165069,173,127,96,31,0,124,3,201,74,83,41
39,"VASLUI",378,165069,,356,"VINEŢEŞTI / Şcoala cu clasele I-VIII, Vineţeşti",3,15634,"OLTENEŞTI",165069,537,306,273,33,0,303,3,601,295,239,64
39,"VASLUI",378,165069,,357,"TÎRZII / Şcoala cu clasele I-VIII, Târzii",3,15634,"OLTENEŞTI",165069,847,406,367,39,0,403,3,901,495,257,146
39,"VASLUI",378,165069,,358,"PÎHNA / Şcoala cu clasele I-IV, Pâhna",3,15634,"OLTENEŞTI",165069,128,96,77,19,0,95,1,201,105,77,18
39,"VASLUI",378,165130,,359,"OŞEŞTI / Şcoala cu clasele I-VIII, Oşeşti",3,15641,"OŞEŞTI",165130,1052,615,547,68,0,607,8,1201,586,369,238
39,"VASLUI",378,165130,,360,"BUDA / Şcoala cu clasele I-VIII ""Luiza Zavloschi"" Buda",3,15641,"OŞEŞTI",165130,1061,548,506,42,0,545,3,1201,653,375,170
39,"VASLUI",378,165130,,361,"PĂDURENI / Şcoala generală cu clasele I-IV, Padureni",3,15641,"OŞEŞTI",165130,236,116,99,17,0,114,2,301,185,67,47
39,"VASLUI",378,165185,,362,"PĂDURENI / Şcoala cu clasele I-VIII, Pădureni",3,15646,"PĂDURENI",165185,1009,482,447,35,0,472,10,1101,619,330,142
39,"VASLUI",378,165185,,363,"RUSCA / Şcoala cu clasele I-IV, Rusca",3,15646,"PĂDURENI",165185,535,279,257,22,0,273,6,601,322,209,64
39,"VASLUI",378,165185,,364,"CĂPOTEŞTI / Şcoala cu clasele I-IV, Davideşti",3,15646,"PĂDURENI",165185,425,254,225,23,6,250,4,501,247,180,70
39,"VASLUI",378,165185,,365,"IVĂNEŞTI / Şcoala cu clasele I-IV, Ivăneşti",3,15646,"PĂDURENI",165185,355,203,178,25,0,194,9,401,198,150,44
39,"VASLUI",378,165185,,366,"VĂLENI / Şcoala cu clasele I-IV, Văleni",3,15646,"PĂDURENI",165185,945,521,478,43,0,509,12,1001,480,385,124
39,"VASLUI",378,165274,,367,"PERIENI / Şcoala cu clasele I-VIII, Perieni",3,15655,"PERIENI",165274,1227,711,669,42,0,699,12,1301,590,512,187
39,"VASLUI",378,165274,,368,"PERIENI / Şcoala cu clasele I-IV, Perieni",3,15655,"PERIENI",165274,1107,652,626,26,0,645,7,1201,549,390,255
39,"VASLUI",378,165274,,369,"PERIENI / Şcoala cu clasele I-IV, Perieni",3,15655,"PERIENI",165274,465,278,252,26,0,274,4,601,323,197,77
39,"VASLUI",378,167311,,370,"BORODEŞTI / P.A.P.I. - acces internet, Borodeşti",3,15657,"POCHIDIA",167311,210,185,131,47,7,183,2,301,116,105,78
39,"VASLUI",378,167311,,371,"POCHIDIA / SCOALA GENERALA CU CLASELE i-iv POCHIDIA",3,15657,"POCHIDIA",167311,348,225,181,44,0,221,4,400,175,119,102
39,"VASLUI",378,167311,,372,"SĂLCENI / Şcoala generală - clasele I-VIII, Sălceni",3,15657,"POCHIDIA",167311,762,563,488,59,16,546,17,801,238,295,251
39,"VASLUI",378,165416,,373,"POGANA / Şcoala cu clasele I-VIII Pogana",3,15662,"POGANA",165416,629,312,287,25,0,309,3,701,389,178,131
39,"VASLUI",378,165416,,374,"TOMEŞTI / Şcoala  cu clasele I-VIII Tomeşti",3,15662,"POGANA",165416,703,367,338,29,0,362,5,801,434,176,186
39,"VASLUI",378,165416,,375,"BOGEŞTI / Şcoala  cu clasele I-IV Bogeşti",3,15662,"POGANA",165416,543,294,256,38,0,289,5,601,307,187,102
39,"VASLUI",378,165416,,376,"MĂSCUREI / Şcoala  cu clasele I-VIII Măscurei",3,15662,"POGANA",165416,558,260,244,16,0,251,9,601,341,137,114
39,"VASLUI",378,167259,,377,"POGONEŞTI / Şcoala cu clasele I-VIII, Pogoneşti",3,15668,"POGONEŞTI",167259,1238,760,679,47,34,755,5,1301,541,518,237
39,"VASLUI",378,167259,,378,"POLOCIN / Sala Tineretului",3,15668,"POGONEŞTI",167259,174,144,110,28,6,142,2,201,57,93,49
39,"VASLUI",378,165336,,379,"POIENEŞTI / Cămin Cultural Poieneşti",3,15672,"POIENEŞTI",165336,681,268,241,27,0,265,3,701,433,150,115
39,"VASLUI",378,165336,,380,"OPRIŞIŢA / Şcoala Oprişiţa",3,15672,"POIENEŞTI",165336,691,386,342,44,0,381,5,801,415,178,203
39,"VASLUI",378,165336,,381,"FRASINU / Şcoala Frasinu",3,15672,"POIENEŞTI",165336,303,128,113,15,0,128,0,401,273,93,35
39,"VASLUI",378,165336,,382,"POIENEŞTI-DEAL / Şcoala Poieneşti Deal",3,15672,"POIENEŞTI",165336,90,45,34,11,0,45,0,101,56,20,25
39,"VASLUI",378,165336,,383,"FUNDU VĂII / Şcoala Fundu Văii",3,15672,"POIENEŞTI",165336,71,55,31,24,0,54,1,100,45,35,19
39,"VASLUI",378,165470,,384,"PUIEŞTI / Şcoala Puieşti",3,15680,"PUIEŞTI",165470,1160,604,544,60,0,587,17,1201,597,410,177
39,"VASLUI",378,165470,,385,"IEZER / Şcoala Iezer",3,15680,"PUIEŞTI",165470,234,152,125,27,0,151,1,301,149,111,40
39,"VASLUI",378,165470,,386,"GÎLŢEŞTI / Şcoala Galteşti",3,15680,"PUIEŞTI",165470,112,76,62,14,0,74,2,201,125,57,17
39,"VASLUI",378,165470,,387,"RUŞI / Şcoala Rusi",3,15680,"PUIEŞTI",165470,303,178,155,23,0,173,5,401,223,112,61
39,"VASLUI",378,165470,,388,"FÎNTÎNELE / Şcoala Fantanele",3,15680,"PUIEŞTI",165470,100,70,53,17,0,69,1,201,131,57,12
39,"VASLUI",378,165470,,389,"CĂLIMĂNEŞTI / Şcoala Calimăneşti",3,15680,"PUIEŞTI",165470,279,189,158,31,0,186,3,301,112,130,56
39,"VASLUI",378,165470,,390,"FULGU / Şcoala Fulgu",3,15680,"PUIEŞTI",165470,116,87,79,8,0,86,1,201,114,51,35
39,"VASLUI",378,165470,,391,"LĂLEŞTI / Şcoala Laleşti",3,15680,"PUIEŞTI",165470,356,208,186,22,0,206,2,401,193,157,49
39,"VASLUI",378,165470,,392,"CRISTEŞTI / Şcoala Cristeşti",3,15680,"PUIEŞTI",165470,343,200,162,38,0,195,5,401,201,109,86
39,"VASLUI",378,165470,,393,"CETĂŢUIA / Şcoala Cetăţuia",3,15680,"PUIEŞTI",165470,320,173,154,19,0,172,1,401,228,120,52
39,"VASLUI",378,165470,,394,"ROTARI / Şcoala Rotari",3,15680,"PUIEŞTI",165470,91,62,50,12,0,62,0,101,39,37,25
39,"VASLUI",378,165470,,395,"BĂRTĂLUŞ-MOCANI / Şcoala Mocani",3,15680,"PUIEŞTI",165470,229,161,132,29,0,158,3,301,140,115,43
39,"VASLUI",378,165611,,396,"PUNGEŞTI / Şcoala cu clasele  I- VIII, Pungeşti",3,15694,"PUNGEŞTI",165611,767,387,353,34,0,376,11,801,414,187,189
39,"VASLUI",378,165611,,397,"STEJARU / Şcoala cu clasele I-IV, Stejaru",3,15694,"PUNGEŞTI",165611,186,134,125,9,0,132,2,201,67,78,54
39,"VASLUI",378,165611,,398,"SILIŞTEA / Şcoala cu clasele I-IV, Siliştea",3,15694,"PUNGEŞTI",165611,213,124,102,22,0,121,3,301,177,41,80
39,"VASLUI",378,165611,,399,"ARMĂŞOAIA / Şcoala cu clasele I-IV, Armăsoaia",3,15694,"PUNGEŞTI",165611,454,301,255,46,0,293,8,501,200,88,205
39,"VASLUI",378,165611,,400,"TOPORĂŞTI / Şcoala cu clasele I-IV, Toporăşti",3,15694,"PUNGEŞTI",165611,511,314,267,47,0,309,5,601,287,126,183
39,"VASLUI",378,165611,,401,"CURSEŞTI-DEAL / Şcoala cu clasele I-IV, Curseşti Deal",3,15694,"PUNGEŞTI",165611,173,105,90,15,0,104,1,201,96,82,22
39,"VASLUI",378,165611,,402,"CURSEŞTI-VALE / Şcoala cu clasele I-IV, Curseşti Vale",3,15694,"PUNGEŞTI",165611,212,128,108,20,0,127,1,301,173,75,52
39,"VASLUI",378,167320,,403,"PUŞCAŞI / Şcoala cu clasele I-VIII, Puşcaşi",3,15704,"PUŞCAŞI",167320,1108,546,516,26,4,537,9,1201,655,311,226
39,"VASLUI",378,167320,,404,"POIANA LUI ALEXA / Şcoala cu clasele I-IV, Poiana lui Alexa",3,15704,"PUŞCAŞI",167320,271,185,143,33,9,182,3,301,116,141,41
39,"VASLUI",378,167320,,405,"TEIŞORU / Cămin Cultural, Teişoru",3,15704,"PUŞCAŞI",167320,404,196,182,12,2,189,7,501,305,132,57
39,"VASLUI",378,167320,,406,"VALEA TÂRGULUI / Şcoala  Valea Târgului",3,15704,"PUŞCAŞI",167320,135,145,101,44,0,145,0,201,56,107,38
39,"VASLUI",378,167320,,407,"PUŞCAŞI / Scoala cu clasele I- VIII Puscasi",3,15704,"PUŞCAŞI",167320,940,420,389,25,6,413,7,1001,581,246,167
39,"VASLUI",378,167240,,408,"RAFAILA / Grădiniţa cu program normal, Rafaila",3,15709,"RAFAILA",167240,1442,781,751,30,0,762,19,1501,720,616,146
39,"VASLUI",378,165719,,409,"REBRICEA / Şcoala gimnazială Rebricea",3,15711,"REBRICEA",165719,449,217,191,26,0,210,7,501,284,156,54
39,"VASLUI",378,165719,,410,"DRAXENI / Căminul Cultural, Draxeni",3,15711,"REBRICEA",165719,654,366,341,25,0,365,1,701,335,295,70
39,"VASLUI",378,165719,,411,"SASOVA / Şcoala primară Sasova",3,15711,"REBRICEA",165719,222,153,137,16,0,153,0,301,148,91,62
39,"VASLUI",378,165719,,412,"TUFEŞTII DE JOS / Şcoala primară Tufeştii de Jos",3,15711,"REBRICEA",165719,299,154,142,12,0,153,1,401,247,107,46
39,"VASLUI",378,165719,,413,"BOLAŢI / Şcoala primară Bolaţi",3,15711,"REBRICEA",165719,169,106,84,22,0,105,1,201,95,75,30
39,"VASLUI",378,165719,,414,"CRĂCIUNEŞTI / Şcoala primară Crăciuneşti",3,15711,"REBRICEA",165719,255,168,138,30,0,161,7,301,133,112,49
39,"VASLUI",378,165719,,415,"TATOMIREŞTI / Şcoala primară Tatomireşti",3,15711,"REBRICEA",165719,228,119,100,19,0,117,2,301,182,89,28
39,"VASLUI",378,165719,,416,"RATEŞU CUZEI / Şcoala primară Rateşu-Cuzei",3,15711,"REBRICEA",165719,439,229,201,28,0,229,0,501,272,172,57
39,"VASLUI",378,165817,,417,"ROŞIEŞTI / Şcoala gimnazială ""Veniamin Costachi"" , Roşieşti",3,15721,"ROŞIEŞTI",165817,1000,546,496,50,0,541,5,1101,555,309,232
39,"VASLUI",378,165817,,418,"VALEA LUI DARIE / Şcoala primară Valea lui Darie",3,15721,"ROŞIEŞTI",165817,502,332,286,46,0,330,2,601,269,230,100
39,"VASLUI",378,165817,,419,"IDRICI / Şcoala primară Idrici",3,15721,"ROŞIEŞTI",165817,279,169,136,33,0,166,3,301,132,105,61
39,"VASLUI",378,165817,,420,"GURA IDRICI / Şcoala primară Gura Idrici",3,15721,"ROŞIEŞTI",165817,381,240,206,34,0,236,4,401,161,154,82
39,"VASLUI",378,165817,,421,"GARA ROŞIEŞTI / Grădiniţa cu Program Normal Gara Roşieşti",3,15721,"ROŞIEŞTI",165817,309,181,165,16,0,178,3,401,220,90,88
39,"VASLUI",378,165817,,422,"REDIU / Şcoala primară Rediu",3,15721,"ROŞIEŞTI",165817,153,113,87,26,0,108,5,201,88,70,38
39,"VASLUI",378,165817,,423,"CODRENI / Şcoala generală  Codreni",3,15721,"ROŞIEŞTI",165817,85,55,39,16,0,55,0,100,45,35,20
39,"VASLUI",378,165899,,424,"SOLEŞTI / Scoala  cu clasele I-VIII  Soleşti",3,15729,"SOLEŞTI",165899,922,451,425,24,2,450,1,1001,550,297,153
39,"VASLUI",378,165899,,425,"BOUŞORI / Şcoala Bouşori",3,15729,"SOLEŞTI",165899,228,157,121,35,1,156,1,301,144,106,50
39,"VASLUI",378,165899,,426,"IAZ / Şcoala Iaz",3,15729,"SOLEŞTI",165899,269,183,170,13,0,183,0,301,118,138,45
39,"VASLUI",378,165899,,427,"SATU NOU / Şcoala SAT - Nou",3,15729,"SOLEŞTI",165899,287,175,162,12,1,172,3,301,126,124,48
39,"VASLUI",378,165899,,428,"ŞERBOTEŞTI / Şcoala Serbotesti",3,15729,"SOLEŞTI",165899,642,397,355,42,0,394,3,701,304,267,127
39,"VASLUI",378,165899,,429,"ŞTIOBORĂNI / Şcoala Stioborani",3,15729,"SOLEŞTI",165899,336,186,158,28,0,183,3,401,215,129,54
39,"VASLUI",378,165899,,430,"VALEA SILIŞTEI / Şcoala Valea Silistei",3,15729,"SOLEŞTI",165899,262,160,136,22,2,157,3,301,141,106,51
39,"VASLUI",378,165979,,431,"STĂNILEŞTI / SCOALA CU CL.I-VIII STANILESTI, Corp B",3,15737,"STĂNILEŞTI",165979,1472,726,691,35,0,719,7,1501,775,368,351
39,"VASLUI",378,165979,,432,"STĂNILEŞTI / SCOALA CU CL.I-VIII STANILESTI, Corp B",3,15737,"STĂNILEŞTI",165979,910,463,431,32,0,461,2,1001,538,268,193
39,"VASLUI",378,165979,,433,"BOGDANA-VOLOSENI / Şcoala cu clasele I-IV, Bogdana -  Voloseni",3,15737,"STĂNILEŞTI",165979,134,69,55,14,0,68,1,201,132,53,15
39,"VASLUI",378,165979,,434,"BUDU CANTEMIR / Şcoala  cu clasele I - IV Budu -Cantemir",3,15737,"STĂNILEŞTI",165979,242,124,107,17,0,123,1,301,177,53,70
39,"VASLUI",378,165979,,435,"CHERSĂCOSU / Şcoala cu clasele I-IV Chersăcosu",3,15737,"STĂNILEŞTI",165979,407,205,192,13,0,204,1,501,296,130,74
39,"VASLUI",378,165979,,436,"GURA VĂII / Şcoala generală cu clasele I-IV, Gura Văii",3,15737,"STĂNILEŞTI",165979,367,198,177,21,0,197,1,401,203,101,96
39,"VASLUI",378,165979,,437,"POGĂNEŞTI / Şcoala cu clasele I-VIII, Pogăneşti",3,15737,"STĂNILEŞTI",165979,881,500,449,51,0,497,3,901,401,264,233
39,"VASLUI",378,166057,,438,"ŞTEFAN CEL MARE / Căminul Cultural, Ştefan cel Mare",3,15745,"ŞTEFAN CEL MARE",166057,600,433,362,71,0,396,37,701,268,336,60
39,"VASLUI",378,166057,,439,"BÎRZEŞTI / Căminul Cultural Bîrzeşti",3,15745,"ŞTEFAN CEL MARE",166057,1017,639,594,45,0,587,52,1101,462,476,111
39,"VASLUI",378,166057,,440,"MĂRĂŞENI / Şcoala generală cu clasele I-IV Maraseni",3,15745,"ŞTEFAN CEL MARE",166057,719,512,448,64,0,482,30,801,289,370,112
39,"VASLUI",378,166057,,441,"BRĂHĂŞOAIA / Şcoala generală cu clasele I-IV, Brăhăşoaia",3,15745,"ŞTEFAN CEL MARE",166057,418,284,233,51,0,268,16,501,217,250,18
39,"VASLUI",378,166137,,442,"ŞULETEA / Şcoala cu clasele I -VIII ""Virgil Caraivan"" Şuletea",3,15753,"ŞULETEA",166137,965,535,489,41,5,530,5,1001,466,272,258
39,"VASLUI",378,166137,,443,"FEDEŞTI / Şcoala generală Fedeşti",3,15753,"ŞULETEA",166137,477,272,241,24,7,265,7,501,229,131,134
39,"VASLUI",378,166137,,444,"JIGĂLIA / Şcoala generală Jigălia",3,15753,"ŞULETEA",166137,199,123,97,26,0,123,0,301,178,53,70
39,"VASLUI",378,166137,,445,"RĂŞCANI / Şcoala generală Răşcani",3,15753,"ŞULETEA",166137,199,120,104,16,0,120,0,300,180,41,79
39,"VASLUI",378,166182,,446,"TANACU / Şcoala generală Tanacu",3,15766,"TANACU",166182,1355,749,620,129,0,742,7,1401,652,554,188
39,"VASLUI",378,166182,,447,"BENEŞTI / Şcoala generală Beneşti",3,15766,"TANACU",166182,318,188,150,38,0,185,3,401,213,137,48
39,"VASLUI",378,166235,,448,"TĂCUTA / Căminul Cultural Tăcuta",3,15758,"TĂCUTA",166235,668,395,357,32,6,390,5,701,306,209,181
39,"VASLUI",378,166235,,449,"DUMASCA / Şcoala Primara Dumasca",3,15758,"TĂCUTA",166235,274,172,138,34,0,171,1,301,129,105,66
39,"VASLUI",378,166235,,450,"MIRCEŞTI / Şcoala Primară Mirceşti",3,15758,"TĂCUTA",166235,222,150,118,31,1,149,1,301,151,104,45
39,"VASLUI",378,166235,,451,"FOCŞEAŞCA / Şcoala Gimnazială Focsasca",3,15758,"TĂCUTA",166235,600,385,345,40,0,377,8,701,316,209,168
39,"VASLUI",378,166235,,452,"PROTOPOPEŞTI / Şcoala Gimnazială Protopopesti",3,15758,"TĂCUTA",166235,706,414,371,43,0,409,5,801,387,210,199
39,"VASLUI",378,166315,,453,"LEOŞTI / Scolala cu cls.I - IV",3,15769,"TĂTĂRĂNI",166315,294,172,147,25,0,166,6,401,229,128,38
39,"VASLUI",378,166315,,454,"TĂTĂRĂNI / Căminul Cultural Tătărăni",3,15769,"TĂTĂRĂNI",166315,647,314,272,40,2,311,3,701,387,203,108
39,"VASLUI",378,166315,,455,"BĂLŢAŢI / Şcoala ""Ion Angheluţă"", Bălţaţi",3,15769,"TĂTĂRĂNI",166315,471,233,212,21,0,226,7,501,268,155,71
39,"VASLUI",378,166315,,456,"STROIEŞTI / Şcoala cu clasele I-IV, Stroeşti",3,15769,"TĂTĂRĂNI",166315,305,172,143,29,0,171,1,401,229,89,82
39,"VASLUI",378,166413,,457,"SILIŞTEA / Şcoala cu clasele I-IV, Siliştea",3,15779,"TODIREŞTI",166413,292,182,159,23,0,177,5,401,219,121,56
39,"VASLUI",378,166413,,458,"TODIREŞTI / Şcoala ""Gh.Cioată"" Todireşti",3,15779,"TODIREŞTI",166413,750,390,352,38,0,384,6,801,411,246,138
39,"VASLUI",378,166413,,459,"COTIC / Şcoala cu clasele I-IV, Cotic",3,15779,"TODIREŞTI",166413,246,143,126,17,0,143,0,301,158,103,40
39,"VASLUI",378,166413,,460,"DRĂGEŞTI / Şcoala ""Preot Constantin Ghe.Radu"" Drăgeşti",3,15779,"TODIREŞTI",166413,278,151,135,16,0,149,2,401,250,125,24
39,"VASLUI",378,166413,,461,"HUC / Şcoala cu clasele I-IV, Huc",3,15779,"TODIREŞTI",166413,456,255,243,12,0,253,2,501,246,190,63
39,"VASLUI",378,166413,,462,"PLOPOASA / Şcoala cu clasele I-IV, Plopoasa",3,15779,"TODIREŞTI",166413,183,123,101,22,0,121,2,201,78,97,24
39,"VASLUI",378,166413,,463,"SOFRONEŞTI / Şcoala cu clasele I-IV, Sofroneşti",3,15779,"TODIREŞTI",166413,126,78,69,9,0,75,3,201,123,51,24
39,"VASLUI",378,166413,,464,"VALEA POPII / Şcoala cu clasele I-IV, Valea -Popii",3,15779,"TODIREŞTI",166413,104,71,59,12,0,71,0,201,130,57,14
39,"VASLUI",378,166413,,465,"VIIŞOARA / Şcoala cu clasele I-IV, Viişoara",3,15779,"TODIREŞTI",166413,103,70,59,11,0,70,0,201,131,45,25
39,"VASLUI",378,166529,,466,"TUTOVA / Căminul Cultural Tutova",3,15789,"TUTOVA",166529,1100,649,574,75,0,643,6,1201,552,381,262
39,"VASLUI",378,166529,,467,"BĂDEANA / Şcoala Badeana",3,15789,"TUTOVA",166529,1076,570,523,47,0,566,4,1101,531,347,219
39,"VASLUI",378,166529,,468,"CRIVEŞTI / Căminul Cultural Crivesti",3,15789,"TUTOVA",166529,389,232,203,29,0,230,2,401,169,173,57
39,"VASLUI",378,166529,,469,"CIORTOLOM / Şcoala Ciortolom",3,15789,"TUTOVA",166529,133,109,83,26,0,108,1,201,92,68,40
39,"VASLUI",378,166529,,470,"COROIU / Şcoala Coroi",3,15789,"TUTOVA",166529,158,112,86,26,0,112,0,201,89,54,58
39,"VASLUI",378,166529,,471,"VIZURENI / Şcoala Vizureni",3,15789,"TUTOVA",166529,150,117,95,22,0,116,1,201,84,73,43
39,"VASLUI",378,166636,,472,"VĂLENI / SCOALA CU CLASELE I-VIII VALENI",3,15796,"VĂLENI",166636,1345,593,581,12,0,587,6,1401,808,293,294
39,"VASLUI",378,166636,,473,"VĂLENI / SCOALA CU CLASELE I-VIII VALENI",3,15796,"VĂLENI",166636,1270,551,528,23,0,542,9,1301,750,267,275
39,"VASLUI",378,166636,,474,"MOARA DOMNEASCĂ / SCOALA CU CLASELE I-VIII MOARA DOMNEASCA",3,15796,"VĂLENI",166636,1293,542,509,33,0,536,6,1401,859,279,257
39,"VASLUI",378,166672,,475,"VETRIŞOAIA / CAMIN CULTURAL VETRISOAIA",3,15799,"VETRIŞOAIA",166672,1612,757,700,57,0,747,10,1701,944,511,236
39,"VASLUI",378,166672,,476,"VETRIŞOAIA / SCOALA SATUL NOU VETRISOAIA",3,15799,"VETRIŞOAIA",166672,877,513,451,62,0,504,9,1001,488,349,155
39,"VASLUI",378,166672,,477,"BUMBĂTA / SCOALA BUMBATA",3,15799,"VETRIŞOAIA",166672,128,97,75,22,0,97,0,201,104,75,22
39,"VASLUI",378,166707,,478,"VIIŞOARA / CĂMIN CULTURAL",3,15802,"VIIŞOARA",166707,968,582,457,77,48,573,9,1001,419,437,136
39,"VASLUI",378,166707,,479,"VILTOTEŞTI / ŞCOALA GENERALĂ VILTOTEŞTI",3,15802,"VIIŞOARA",166707,174,110,87,16,7,110,0,201,91,88,22
39,"VASLUI",378,166707,,480,"VĂLENI / ŞCOALA GENERALĂ VĂLENI",3,15802,"VIIŞOARA",166707,114,72,51,18,3,72,0,201,129,50,22
39,"VASLUI",378,166707,,481,"HALTA DODEŞTI / ŞCOALA GENERALĂ HALTA DODEŞTI",3,15802,"VIIŞOARA",166707,163,108,65,41,2,106,2,202,94,85,21
39,"VASLUI",378,166770,,482,"VINDEREI / Şcoala cu clasele I-VIII, Vinderei",3,15807,"VINDEREI",166770,819,391,336,55,0,388,3,901,510,219,169
39,"VASLUI",378,166770,,483,"BRĂDEŞTI / Şcoala cu clasele I-IV, Bradesti",3,15807,"VINDEREI",166770,489,256,234,21,1,252,4,601,345,179,73
39,"VASLUI",378,166770,,484,"DOCANI / Şcoala cu clasele I-VIII, Docani",3,15807,"VINDEREI",166770,505,207,186,21,0,200,7,601,394,136,64
39,"VASLUI",378,166770,,485,"DOCĂNEASA / Şcoala cu clasele I-IV, Docaneasa",3,15807,"VINDEREI",166770,390,187,166,21,0,183,4,501,314,108,75
39,"VASLUI",378,166770,,486,"OBÎRŞENI / Şcoala cu clasele I-VIII, Obarseni",3,15807,"VINDEREI",166770,766,382,332,50,0,372,10,901,519,243,129
39,"VASLUI",378,166770,,487,"VALEA LUNGĂ / Şcoala cu clasele I-VIII, Valea Lungă",3,15807,"VINDEREI",166770,384,196,170,26,0,192,4,401,205,112,80
39,"VASLUI",378,166869,,488,"VOINEŞTI / Şcoala cu clasele I-VIII, Voineşti",3,15816,"VOINEŞTI",166869,312,170,148,22,0,167,3,401,231,122,45
39,"VASLUI",378,166869,,489,"AVRĂMEŞTI / Şcoala cu clasele I-VIII, Avrămeşti",3,15816,"VOINEŞTI",166869,544,290,252,38,0,286,4,601,311,208,78
39,"VASLUI",378,166869,,490,"MĂRĂŞEŞTI / Şcoala cu clasele I-IV, Mărăşeşti",3,15816,"VOINEŞTI",166869,179,113,91,22,0,112,1,201,88,74,38
39,"VASLUI",378,166869,,491,"BĂNCEŞTI / Şcoala cu clasele I-IV, Bănceşti",3,15816,"VOINEŞTI",166869,155,115,101,14,0,114,1,201,86,98,16
39,"VASLUI",378,166869,,492,"STÎNCĂŞENI / Şcoala cu clasele I-IV, Stancaseni",3,15816,"VOINEŞTI",166869,160,125,100,25,0,125,0,201,76,110,15
39,"VASLUI",378,166869,,493,"GÎRDEŞTI / Şcoala cu clasele I-IV, Gardesti",3,15816,"VOINEŞTI",166869,440,259,242,17,0,257,2,501,242,176,81
39,"VASLUI",378,166869,,494,"OBÎRŞENI / Şcoala cu clasele I-IV, Obarseni",3,15816,"VOINEŞTI",166869,262,130,113,17,0,128,2,301,171,91,37
39,"VASLUI",378,166869,,495,"OBÎRŞENII LINGURARI / Şcoala cu clasele I-VIII, Obarseni-Lingurari",3,15816,"VOINEŞTI",166869,622,395,369,26,0,387,8,701,306,319,68
39,"VASLUI",378,166985,,496,"VULTUREŞTI / Căminul Cultural Vultureşti",3,15828,"VULTUREŞTI",166985,820,499,446,53,0,490,9,901,402,329,161
39,"VASLUI",378,166985,,497,"BUHĂIEŞTI / Căminul Cultural Buhăeşti",3,15828,"VULTUREŞTI",166985,660,348,310,38,0,347,1,700,352,222,125
39,"VASLUI",378,166985,,498,"VOINEŞTI / Şcoala Voineşti",3,15828,"VULTUREŞTI",166985,274,168,143,25,0,166,2,301,133,123,43
39,"VASLUI",378,167035,,499,"VUTCANI / Şcoala generală nr.1, Vutcani",3,15833,"VUTCANI",167035,1198,765,651,84,30,751,14,1301,536,556,195
39,"VASLUI",378,167035,,500,"MĂLĂIEŞTI / Şcoala generală Mălăieşti",3,15833,"VUTCANI",167035,262,223,144,20,59,221,2,301,78,173,48
39,"VASLUI",378,167035,,501,"POŞTA ELAN / Şcoala generală Poşta-Elan",3,15833,"VUTCANI",167035,130,101,79,20,2,100,1,201,100,91,9
39,"VASLUI",378,167071,,502,"ZĂPODENI / Căminul Cultural Zăpodeni",3,15837,"ZĂPODENI",167071,1254,818,697,93,28,807,11,1301,483,590,217
39,"VASLUI",378,167071,,503,"CIOFENI / Şcoala cu clasele I-IV, Ciofeni",3,15837,"ZĂPODENI",167071,128,63,51,12,0,63,0,201,138,44,19
39,"VASLUI",378,167071,,504,"PORTARI / Şcoala cu clasele I-IV, Portari",3,15837,"ZĂPODENI",167071,481,366,301,46,19,360,6,501,135,288,72
39,"VASLUI",378,167071,,505,"DELEA / Şcoala cu clasele I-IV, Delea",3,15837,"ZĂPODENI",167071,203,124,96,28,0,123,1,301,177,70,53
39,"VASLUI",378,167071,,506,"TELEJNA / Şcoala cu clasele I-IV, Telejna",3,15837,"ZĂPODENI",167071,293,190,160,24,6,183,7,300,110,137,46
39,"VASLUI",378,167071,,507,"BUTUCĂRIA / Şcoala cu clasele I-VIII, Butucărie",3,15837,"ZĂPODENI",167071,121,99,72,24,3,98,1,201,102,65,33
39,"VASLUI",378,167071,,508,"DOBROSLOVEŞTI / Şcoala cu clasele I-IV, Dobrosloveşti",3,15837,"ZĂPODENI",167071,311,213,175,28,10,207,6,401,188,166,41
39,"VASLUI",378,167071,,509,"UNCEŞTI / Şcoala cu clasele I-IV, Unceşti",3,15837,"ZĂPODENI",167071,310,216,178,28,10,214,2,401,185,180,34
39,"VASLUI",378,167179,,510,"ZORLENI / Şcoala nr.1 Zorleni",3,15847,"ZORLENI",167179,1367,720,694,26,0,711,9,1401,681,379,332
39,"VASLUI",378,167179,,511,"ZORLENI / Şcoala nr.1 Zorleni",3,15847,"ZORLENI",167179,1374,721,680,41,0,714,7,1401,680,396,318
39,"VASLUI",378,167179,,512,"ZORLENI / Şcoala nr. 2 Zorleni",3,15847,"ZORLENI",167179,1433,705,674,31,0,693,12,1501,796,454,239
39,"VASLUI",378,167179,,513,"POPENI / Şcoala Popeni",3,15847,"ZORLENI",167179,1256,629,599,30,0,618,11,1301,672,449,169
39,"VASLUI",378,167179,,514,"POPENI / Şcoala Popeni",3,15847,"ZORLENI",167179,961,492,451,41,0,482,10,1001,509,336,146
39,"VASLUI",378,167179,,515,"DEALU MARE / Şcoala Dealu Mare",3,15847,"ZORLENI",167179,203,125,99,26,0,124,1,301,176,73,51
39,"VASLUI",378,167179,,516,"SIMILA / Şcoala Simila",3,15847,"ZORLENI",167179,978,589,551,38,0,580,9,1001,412,279,301
40,"VÂLCEA","#N/A",167473,,1,"RÂMNICU VÂLCEA / Colegiul Energetic",1,15853,"MUNICIPIUL RÂMNICU VÂLCEA",167473,1751,1003,945,58,0,986,17,1930,927,358,628
40,"VÂLCEA","#N/A",167473,,2,"RÂMNICU VÂLCEA / Colegiul Energetic",1,15853,"MUNICIPIUL RÂMNICU VÂLCEA",167473,1047,593,559,34,0,579,14,1150,557,224,355
40,"VÂLCEA","#N/A",167473,,3,"RÂMNICU VÂLCEA / Liceul Antim Ivireanu",1,15853,"MUNICIPIUL RÂMNICU VÂLCEA",167473,1411,824,735,87,2,814,10,1550,726,372,442
40,"VÂLCEA","#N/A",167473,,4,"RÂMNICU VÂLCEA / Liceul Antim Ivireanul",1,15853,"MUNICIPIUL RÂMNICU VÂLCEA",167473,1299,798,729,69,0,785,13,1430,632,340,445
40,"VÂLCEA","#N/A",167473,,5,"RÂMNICU VÂLCEA / Liceul Antim Ivireanu",1,15853,"MUNICIPIUL RÂMNICU VÂLCEA",167473,1266,659,623,36,0,648,11,1390,731,267,381
40,"VÂLCEA","#N/A",167473,,6,"RÂMNICU VÂLCEA / Grădiniţa cu program prelungit Nord II",1,15853,"MUNICIPIUL RÂMNICU VÂLCEA",167473,1055,604,557,47,0,596,8,1160,556,221,375
40,"VÂLCEA","#N/A",167473,,7,"RÂMNICU VÂLCEA / Grădiniţa cu program prelungit Nord II",1,15853,"MUNICIPIUL RÂMNICU VÂLCEA",167473,1086,611,563,48,0,602,9,1190,579,288,314
40,"VÂLCEA","#N/A",167473,,8,"RÂMNICU VÂLCEA / Grădiniţa cu program prelungit Nord II",1,15853,"MUNICIPIUL RÂMNICU VÂLCEA",167473,971,586,568,18,0,579,7,1070,484,256,323
40,"VÂLCEA","#N/A",167473,,9,"RÂMNICU VÂLCEA / Liceul Tehnologic Henri Coanda",1,15853,"MUNICIPIUL RÂMNICU VÂLCEA",167473,1143,648,601,46,1,634,14,1270,622,265,369
40,"VÂLCEA","#N/A",167473,,10,"RÂMNICU VÂLCEA / Liceul Tehnologic Henri Coanda",1,15853,"MUNICIPIUL RÂMNICU VÂLCEA",167473,1099,639,602,37,0,622,17,1210,571,264,358
40,"VÂLCEA","#N/A",167473,,11,"RÂMNICU VÂLCEA / Liceul Tehnologic Henri Coandă",1,15853,"MUNICIPIUL RÂMNICU VÂLCEA",167473,1068,611,578,33,0,609,2,1180,569,252,357
40,"VÂLCEA","#N/A",167473,,12,"RÂMNICU VÂLCEA / Liceul Tehnologic Henri Coandă",1,15853,"MUNICIPIUL RÂMNICU VÂLCEA",167473,1249,748,719,29,0,735,13,1370,622,298,437
40,"VÂLCEA","#N/A",167473,,13,"RÂMNICU VÂLCEA / Liceul Tehnologic Henri Coandă",1,15853,"MUNICIPIUL RÂMNICU VÂLCEA",167473,871,512,454,58,0,503,9,960,448,198,305
40,"VÂLCEA","#N/A",167473,,14,"RÂMNICU VÂLCEA / Colegiul Naţional de Informatică Matei Basarab",1,15853,"MUNICIPIUL RÂMNICU VÂLCEA",167473,1075,635,579,56,0,625,10,1180,545,259,366
40,"VÂLCEA","#N/A",167473,,15,"RÂMNICU VÂLCEA / Colegiul Naţional de Informatică Matei Basarab",1,15853,"MUNICIPIUL RÂMNICU VÂLCEA",167473,866,488,459,28,1,483,5,950,462,219,264
40,"VÂLCEA","#N/A",167473,,16,"RÂMNICU VÂLCEA / Colegiul Naţional de Informatică Matei Basarab",1,15853,"MUNICIPIUL RÂMNICU VÂLCEA",167473,1091,632,603,29,0,617,15,1190,558,240,377
40,"VÂLCEA","#N/A",167473,,17,"RÂMNICU VÂLCEA / Colegiul Naţional de Informatică Matei Basarab",1,15853,"MUNICIPIUL RÂMNICU VÂLCEA",167473,1285,735,703,32,0,726,9,1410,675,343,383
40,"VÂLCEA","#N/A",167473,,18,"RÂMNICU VÂLCEA / Colegiul de Silvicultura si Protectia Mediului",1,15853,"MUNICIPIUL RÂMNICU VÂLCEA",167473,1001,699,629,70,0,688,11,1100,401,279,409
40,"VÂLCEA","#N/A",167473,,19,"RÂMNICU VÂLCEA / Colegiul de Sivicultura si Protectia Mediului",1,15853,"MUNICIPIUL RÂMNICU VÂLCEA",167473,964,730,502,31,197,719,11,1060,330,354,365
40,"VÂLCEA","#N/A",167473,,20,"RÂMNICU VÂLCEA / Colegiul de Silvicultura si Protectia Mediului",1,15853,"MUNICIPIUL RÂMNICU VÂLCEA",167473,924,598,554,44,0,594,4,1020,422,276,318
40,"VÂLCEA","#N/A",167473,,21,"RÂMNICU VÂLCEA / Scoala gimnazială ""Ioan  Gh. Duca""",1,15853,"MUNICIPIUL RÂMNICU VÂLCEA",167473,1024,680,578,102,0,665,15,1120,440,257,408
40,"VÂLCEA","#N/A",167473,,22,"RÂMNICU VÂLCEA / Scoala gimnazială ""Ioan  Gh. Duca""",1,15853,"MUNICIPIUL RÂMNICU VÂLCEA",167473,1067,662,631,31,0,647,15,1180,518,234,413
40,"VÂLCEA","#N/A",167473,,23,"RÂMNICU VÂLCEA / Scoala Gimnaziala ""Ioan Gh. Duca""",1,15853,"MUNICIPIUL RÂMNICU VÂLCEA",167473,1082,699,621,77,1,684,15,1200,501,288,396
40,"VÂLCEA","#N/A",167473,,24,"RÂMNICU VÂLCEA / Scoala Gimnaziala ""Ioan Gh. Duca""",1,15853,"MUNICIPIUL RÂMNICU VÂLCEA",167473,878,551,517,33,1,545,6,971,420,260,285
40,"VÂLCEA","#N/A",167473,,25,"RÂMNICU VÂLCEA / Scoala Gimnaziala ""Ioan Gh. Duca""",1,15853,"MUNICIPIUL RÂMNICU VÂLCEA",167473,1141,738,683,55,0,722,16,1260,522,289,433
40,"VÂLCEA","#N/A",167473,,26,"RÂMNICU VÂLCEA / Scoala Gimnaziala ""Ioan Gh. Duca""",1,15853,"MUNICIPIUL RÂMNICU VÂLCEA",167473,1163,683,631,51,1,675,8,1280,597,284,391
40,"VÂLCEA","#N/A",167473,,27,"RÂMNICU VÂLCEA / Scoala Gimnaziala ""Ioan Gh. Duca""",1,15853,"MUNICIPIUL RÂMNICU VÂLCEA",167473,907,574,552,22,0,563,11,1000,426,253,310
40,"VÂLCEA","#N/A",167473,,28,"RÂMNICU VÂLCEA / Scoala Gimnaziala Take Ionescu",1,15853,"MUNICIPIUL RÂMNICU VÂLCEA",167473,1069,791,664,127,0,780,11,1170,379,323,457
40,"VÂLCEA","#N/A",167473,,29,"RÂMNICU VÂLCEA / Colegiul National Alexandru Lahovari",1,15853,"MUNICIPIUL RÂMNICU VÂLCEA",167473,1137,842,680,162,0,827,15,1250,408,352,475
40,"VÂLCEA","#N/A",167473,,30,"RÂMNICU VÂLCEA / Colegiul Naţional Alexandru Lahovari",1,15853,"MUNICIPIUL RÂMNICU VÂLCEA",167473,1486,1029,895,42,92,1017,12,1640,611,476,541
40,"VÂLCEA","#N/A",167473,,31,"RÂMNICU VÂLCEA / Liceul Tehnologic Oltchim",1,15853,"MUNICIPIUL RÂMNICU VÂLCEA",167473,1459,916,813,103,0,889,27,1610,694,339,550
40,"VÂLCEA","#N/A",167473,,32,"RÂMNICU VÂLCEA / Liceul Tehnologic Oltchim",1,15853,"MUNICIPIUL RÂMNICU VÂLCEA",167473,1414,883,780,34,69,869,14,1560,677,382,487
40,"VÂLCEA","#N/A",167473,,33,"RÂMNICU VÂLCEA / Şcoala gimnazială nr.5",1,15853,"MUNICIPIUL RÂMNICU VÂLCEA",167473,1080,779,656,121,2,766,13,1190,411,324,442
40,"VÂLCEA","#N/A",167473,,34,"RÂMNICU VÂLCEA / DADP - sediu, bl A17",1,15853,"MUNICIPIUL RÂMNICU VÂLCEA",167473,1432,875,813,62,0,858,17,1568,693,313,545
40,"VÂLCEA","#N/A",167473,,35,"RÂMNICU VÂLCEA / SC Piete Prest SA - Sediu Piata Centrala",1,15853,"MUNICIPIUL RÂMNICU VÂLCEA",167473,846,555,509,45,1,547,8,940,385,240,307
40,"VÂLCEA","#N/A",167473,,36,"RÂMNICU VÂLCEA / S.C. Pieţe Prest SA- Sediu Piaţa Centrală",1,15853,"MUNICIPIUL RÂMNICU VÂLCEA",167473,735,463,418,45,0,458,5,810,347,202,256
40,"VÂLCEA","#N/A",167473,,37,"RÂMNICU VÂLCEA / S.C. Piete Prest SA - Sediul Piata Centrala",1,15853,"MUNICIPIUL RÂMNICU VÂLCEA",167473,979,612,575,36,1,602,10,1080,468,315,287
40,"VÂLCEA","#N/A",167473,,38,"RÂMNICU VÂLCEA / Gradinita cu program prelungit Cozia",1,15853,"MUNICIPIUL RÂMNICU VÂLCEA",167473,1171,751,674,76,1,739,12,1290,539,299,440
40,"VÂLCEA","#N/A",167473,,39,"RÂMNICU VÂLCEA / Grădiniţa cu program prelungit Cozia",1,15853,"MUNICIPIUL RÂMNICU VÂLCEA",167473,1202,717,676,41,0,700,17,1338,621,293,407
40,"VÂLCEA","#N/A",167473,,40,"RÂMNICU VÂLCEA / Liceul Tehnologic Căpitan Nicolae Pleşoianu",1,15853,"MUNICIPIUL RÂMNICU VÂLCEA",167473,1129,718,682,35,1,701,17,1250,532,316,385
40,"VÂLCEA","#N/A",167473,,41,"RÂMNICU VÂLCEA / Liceul Tehnologic Căpitan Nicolae Pleşoianu",1,15853,"MUNICIPIUL RÂMNICU VÂLCEA",167473,1051,706,634,72,0,698,8,1160,454,265,433
40,"VÂLCEA","#N/A",167473,,42,"RÂMNICU VÂLCEA / Şcoala Gimnazială Spiru Haret (fostă nr. 3)",1,15853,"MUNICIPIUL RÂMNICU VÂLCEA",167473,1518,975,936,38,1,966,9,1670,695,390,576
40,"VÂLCEA","#N/A",167473,,43,"RÂMNICU VÂLCEA / Scoala gimnazială Goranu",1,15853,"MUNICIPIUL RÂMNICU VÂLCEA",167473,1408,737,701,35,1,729,8,1550,813,305,424
40,"VÂLCEA","#N/A",167473,,44,"RÂMNICU VÂLCEA / Şcoala Gimnaziala Goranu",1,15853,"MUNICIPIUL RÂMNICU VÂLCEA",167473,1039,624,596,27,1,612,12,1140,516,269,343
40,"VÂLCEA","#N/A",167473,,45,"RÂMNICU VÂLCEA / Şcoala Lespezi - arhivă",1,15853,"MUNICIPIUL RÂMNICU VÂLCEA",167473,1084,688,659,29,0,679,9,1190,502,245,434
40,"VÂLCEA","#N/A",167473,,46,"RÂMNICU VÂLCEA / Şcoala Feţeni",1,15853,"MUNICIPIUL RÂMNICU VÂLCEA",167473,159,103,84,19,0,103,0,170,67,42,61
40,"VÂLCEA","#N/A",167473,,47,"RÂMNICU VÂLCEA / Liceul Tehnologic Căpitan Nicolae Pleşoianu",1,15853,"MUNICIPIUL RÂMNICU VÂLCEA",167473,1829,1155,1104,51,0,1131,24,2010,855,523,608
40,"VÂLCEA","#N/A",167473,,48,"RÂMNICU VÂLCEA / Cartier Petrişor - PT8",1,15853,"MUNICIPIUL RÂMNICU VÂLCEA",167473,1602,835,787,47,1,822,13,1770,935,347,475
40,"VÂLCEA","#N/A",167473,,49,"RÂMNICU VÂLCEA / Şcoala Gimnazială nr.4",1,15853,"MUNICIPIUL RÂMNICU VÂLCEA",167473,1046,699,618,80,1,687,12,1150,451,315,372
40,"VÂLCEA","#N/A",167473,,50,"RÂMNICU VÂLCEA / Şcoala Gimnazială nr.4",1,15853,"MUNICIPIUL RÂMNICU VÂLCEA",167473,1456,853,815,38,0,836,17,1610,757,402,434
40,"VÂLCEA","#N/A",167473,,51,"RÂMNICU VÂLCEA / Şcoala Gimnazială nr.4",1,15853,"MUNICIPIUL RÂMNICU VÂLCEA",167473,1012,670,643,22,5,653,17,1120,450,283,370
40,"VÂLCEA","#N/A",167473,,52,"RÂMNICU VÂLCEA / Colegiul Economic",1,15853,"MUNICIPIUL RÂMNICU VÂLCEA",167473,1279,864,780,84,0,851,13,1410,546,348,503
40,"VÂLCEA","#N/A",167473,,53,"RÂMNICU VÂLCEA / Colegiul Economic",1,15853,"MUNICIPIUL RÂMNICU VÂLCEA",167473,1157,729,665,62,2,719,10,1270,541,319,400
40,"VÂLCEA","#N/A",167473,,54,"RÂMNICU VÂLCEA / Colegiul Economic",1,15853,"MUNICIPIUL RÂMNICU VÂLCEA",167473,1210,668,627,41,0,650,18,1330,662,277,373
40,"VÂLCEA","#N/A",167473,,55,"RÂMNICU VÂLCEA / Scoala gimnaziala nr. 10",1,15853,"MUNICIPIUL RÂMNICU VÂLCEA",167473,1336,877,746,130,1,859,18,1460,583,358,501
40,"VÂLCEA","#N/A",167473,,56,"RÂMNICU VÂLCEA / Scoala gimnaziala nr. 10",1,15853,"MUNICIPIUL RÂMNICU VÂLCEA",167473,1612,981,913,68,0,968,13,1788,807,415,553
40,"VÂLCEA","#N/A",167473,,57,"RÂMNICU VÂLCEA / Scoala gimnaziala nr. 10",1,15853,"MUNICIPIUL RÂMNICU VÂLCEA",167473,1228,687,653,34,0,673,14,1350,663,317,356
40,"VÂLCEA","#N/A",167473,,58,"RÂMNICU VÂLCEA / Gradinita cu program prelungit Ostroveni I",1,15853,"MUNICIPIUL RÂMNICU VÂLCEA",167473,1362,767,723,44,0,760,7,1490,723,347,413
40,"VÂLCEA","#N/A",167473,,59,"RÂMNICU VÂLCEA / Liceul Tehnologic Ferdinand I",1,15853,"MUNICIPIUL RÂMNICU VÂLCEA",167473,878,541,479,62,0,536,5,969,428,223,313
40,"VÂLCEA","#N/A",167473,,60,"RÂMNICU VÂLCEA / Liceul Tehnologic Ferdinand I",1,15853,"MUNICIPIUL RÂMNICU VÂLCEA",167473,809,503,440,63,0,491,12,890,387,230,261
40,"VÂLCEA","#N/A",167473,,61,"RÂMNICU VÂLCEA / Liceul Tehnologic Ferdinand I",1,15853,"MUNICIPIUL RÂMNICU VÂLCEA",167473,900,502,448,53,1,493,9,990,488,215,278
40,"VÂLCEA","#N/A",167473,,62,"RÂMNICU VÂLCEA / Liceul Tehnologic Ferdinand I",1,15853,"MUNICIPIUL RÂMNICU VÂLCEA",167473,1151,680,630,50,0,666,14,1270,590,280,386
40,"VÂLCEA","#N/A",167473,,63,"RÂMNICU VÂLCEA / Liceul Tehnologic Ferdinand I",1,15853,"MUNICIPIUL RÂMNICU VÂLCEA",167473,864,475,455,20,0,467,8,950,475,207,260
40,"VÂLCEA","#N/A",167473,,64,"RÂMNICU VÂLCEA / Liceul Tehnologic Ferdinand I",1,15853,"MUNICIPIUL RÂMNICU VÂLCEA",167473,924,487,464,23,0,478,9,1018,531,204,274
40,"VÂLCEA","#N/A",167473,,65,"RÂMNICU VÂLCEA / Gradinita cu program prelungit Ostroveni II",1,15853,"MUNICIPIUL RÂMNICU VÂLCEA",167473,1488,878,811,67,0,864,14,1630,752,366,498
40,"VÂLCEA","#N/A",167473,,66,"RÂMNICU VÂLCEA / Gradinita cu program prelungit Ostroveni II",1,15853,"MUNICIPIUL RÂMNICU VÂLCEA",167473,1088,600,554,46,0,587,13,1200,600,253,334
40,"VÂLCEA","#N/A",167473,,67,"RÂMNICU VÂLCEA / Gradinita cu program prelungit Ostroveni II",1,15853,"MUNICIPIUL RÂMNICU VÂLCEA",167473,1143,603,567,36,0,592,11,1260,657,239,353
40,"VÂLCEA","#N/A",167473,,68,"RÂMNICU VÂLCEA / Gradinita cu program prelungit Ostroveni II",1,15853,"MUNICIPIUL RÂMNICU VÂLCEA",167473,1313,675,644,29,2,654,21,1460,785,315,339
40,"VÂLCEA","#N/A",167473,,69,"RÂMNICU VÂLCEA / Scoala gimnaziala Anton Pann",1,15853,"MUNICIPIUL RÂMNICU VÂLCEA",167473,1080,783,648,135,0,770,13,1180,397,279,491
40,"VÂLCEA","#N/A",167473,,70,"RÂMNICU VÂLCEA / Scoala gimnaziala Anton Pann",1,15853,"MUNICIPIUL RÂMNICU VÂLCEA",167473,1106,680,596,84,0,673,7,1220,540,317,356
40,"VÂLCEA","#N/A",167473,,71,"RÂMNICU VÂLCEA / Scoala gimnaziala Anton Pann",1,15853,"MUNICIPIUL RÂMNICU VÂLCEA",167473,1054,572,545,27,0,563,9,1160,588,227,336
40,"VÂLCEA","#N/A",167473,,72,"RÂMNICU VÂLCEA / Scoala gimnaziala Anton Pann",1,15853,"MUNICIPIUL RÂMNICU VÂLCEA",167473,1596,992,951,41,0,970,22,1750,758,395,575
40,"VÂLCEA","#N/A",167473,,73,"RÂMNICU VÂLCEA / Scoala gimnaziala Anton Pann",1,15853,"MUNICIPIUL RÂMNICU VÂLCEA",167473,1033,606,580,26,0,589,17,1140,534,264,325
40,"VÂLCEA","#N/A",167473,,74,"RÂMNICU VÂLCEA / Scoala gimnaziala Anton Pann",1,15853,"MUNICIPIUL RÂMNICU VÂLCEA",167473,863,468,456,12,0,455,13,950,482,195,260
40,"VÂLCEA","#N/A",167473,,75,"RÂMNICU VÂLCEA / Scoala gimnaziala Anton Pann",1,15853,"MUNICIPIUL RÂMNICU VÂLCEA",167473,1152,628,607,21,0,617,11,1260,632,247,370
40,"VÂLCEA","#N/A",167473,,76,"RÂMNICU VÂLCEA / Scoala gimnaziala Anton Pann",1,15853,"MUNICIPIUL RÂMNICU VÂLCEA",167473,1383,766,738,27,1,751,15,1520,754,313,438
40,"VÂLCEA","#N/A",167473,,77,"RÂMNICU VÂLCEA / Scoala gimnaziala nr. 13",1,15853,"MUNICIPIUL RÂMNICU VÂLCEA",167473,944,502,486,16,0,487,15,1040,538,211,276
40,"VÂLCEA","#N/A",167473,,78,"RÂMNICU VÂLCEA / Scoala Gimnaziala nr. 13",1,15853,"MUNICIPIUL RÂMNICU VÂLCEA",167473,998,585,558,27,0,572,13,1093,508,231,341
40,"VÂLCEA","#N/A",167473,,79,"RÂMNICU VÂLCEA / Scoala gimnaziala nr. 13",1,15853,"MUNICIPIUL RÂMNICU VÂLCEA",167473,970,601,551,50,0,588,13,1060,459,256,332
40,"VÂLCEA","#N/A",167473,,80,"RÂMNICU VÂLCEA / Scoala gimnaziala nr. 13",1,15853,"MUNICIPIUL RÂMNICU VÂLCEA",167473,1042,597,559,38,0,586,11,1149,552,263,323
40,"VÂLCEA","#N/A",167473,,81,"RÂMNICU VÂLCEA / Scoala gimnaziala nr. 13",1,15853,"MUNICIPIUL RÂMNICU VÂLCEA",167473,1070,588,556,32,0,574,14,1180,592,237,337
40,"VÂLCEA","#N/A",167473,,82,"RÂMNICU VÂLCEA / Scoala gimnaziala nr. 13",1,15853,"MUNICIPIUL RÂMNICU VÂLCEA",167473,1326,816,783,33,0,801,15,1470,654,334,467
40,"VÂLCEA","#N/A",167473,,83,"RÂMNICU VÂLCEA / Scoala gimnaziala nr. 13",1,15853,"MUNICIPIUL RÂMNICU VÂLCEA",167473,1246,763,725,38,0,748,15,1370,607,282,466
40,"VÂLCEA","#N/A",167473,,84,"RÂMNICU VÂLCEA / Sectia 1 de Politie Rurala Ramnicu Valcea",1,15853,"MUNICIPIUL RÂMNICU VÂLCEA",167473,878,566,519,47,0,562,4,970,404,284,278
40,"VÂLCEA","#N/A",167473,,85,"RÂMNICU VÂLCEA / Şcoala Stolniceni",1,15853,"MUNICIPIUL RÂMNICU VÂLCEA",167473,545,336,290,46,0,330,6,600,264,219,111
40,"VÂLCEA","#N/A",167473,,86,"RÂMNICU VÂLCEA / Scoala gimnaziala Colonie",1,15853,"MUNICIPIUL RÂMNICU VÂLCEA",167473,1061,639,548,91,0,629,10,1160,521,398,231
40,"VÂLCEA","#N/A",167473,,87,"RÂMNICU VÂLCEA / Scoala Copacelu",1,15853,"MUNICIPIUL RÂMNICU VÂLCEA",167473,1896,1153,1094,59,0,1145,8,2080,927,638,507
40,"VÂLCEA","#N/A",167473,,88,"RÂMNICU VÂLCEA / Şcoala Căzăneşti",1,15853,"MUNICIPIUL RÂMNICU VÂLCEA",167473,926,587,542,45,0,578,9,1020,433,333,245
40,"VÂLCEA","#N/A",167981,,89,"DRĂGĂŞANI / ŞCOALA TUDOR VLADIMIRESCU",1,15868,"MUNICIPIUL DRĂGĂŞANI",167981,1468,823,745,78,0,807,16,1630,807,373,434
40,"VÂLCEA","#N/A",167981,,90,"DRĂGĂŞANI / ŞCOALA TUDOR VLADIMIRESCU",1,15868,"MUNICIPIUL DRĂGĂŞANI",167981,1540,863,744,119,0,856,7,1700,837,383,473
40,"VÂLCEA","#N/A",167981,,91,"DRĂGĂŞANI / Grupul Şcolar Brătianu",1,15868,"MUNICIPIUL DRĂGĂŞANI",167981,1491,731,651,80,0,723,8,1640,909,373,350
40,"VÂLCEA","#N/A",167981,,92,"DRĂGĂŞANI / Grupul şcolar Brătianu",1,15868,"MUNICIPIUL DRĂGĂŞANI",167981,1409,756,698,58,0,751,5,1560,804,386,365
40,"VÂLCEA","#N/A",167981,,93,"DRĂGĂŞANI / caminul de copii",1,15868,"MUNICIPIUL DRĂGĂŞANI",167981,1432,784,742,42,0,782,2,1580,796,400,382
40,"VÂLCEA","#N/A",167981,,94,"DRĂGĂŞANI / Grădiniţa de copii Brătianu",1,15868,"MUNICIPIUL DRĂGĂŞANI",167981,915,495,460,35,0,485,10,1010,515,306,179
40,"VÂLCEA","#N/A",167981,,95,"DRĂGĂŞANI / scoala Nicolae Balcescu",1,15868,"MUNICIPIUL DRĂGĂŞANI",167981,1166,700,615,84,1,692,8,1290,590,331,361
40,"VÂLCEA","#N/A",167981,,96,"DRĂGĂŞANI / COLEGIUL NATIONAL GIB MIHĂESCU",1,15868,"MUNICIPIUL DRĂGĂŞANI",167981,1578,884,792,92,0,872,12,1720,836,445,427
40,"VÂLCEA","#N/A",167981,,97,"DRĂGĂŞANI / Grupul Şcolar Brătianu- Şcoala Profesională",1,15868,"MUNICIPIUL DRĂGĂŞANI",167981,1182,655,616,39,0,644,11,1310,655,429,215
40,"VÂLCEA","#N/A",167981,,98,"DRĂGĂŞANI / Şcoala Bârsanu",1,15868,"MUNICIPIUL DRĂGĂŞANI",167981,965,595,553,42,0,585,10,1060,465,380,205
40,"VÂLCEA","#N/A",167981,,99,"DRĂGĂŞANI / Grădiniţa  Colonia Rudari",1,15868,"MUNICIPIUL DRĂGĂŞANI",167981,495,331,313,18,0,328,3,540,209,260,68
40,"VÂLCEA","#N/A",167981,,100,"DRĂGĂŞANI / ŞCOALA NICOLAE BĂLCESCU",1,15868,"MUNICIPIUL DRĂGĂŞANI",167981,1326,765,717,48,0,759,6,1460,695,394,365
40,"VÂLCEA","#N/A",167981,,101,"DRĂGĂŞANI / Şcoala  Momoteşti",1,15868,"MUNICIPIUL DRĂGĂŞANI",167981,812,452,439,13,0,446,6,890,438,254,192
40,"VÂLCEA","#N/A",167981,,102,"DRĂGĂŞANI / Gradinita Capul Dealului",1,15868,"MUNICIPIUL DRĂGĂŞANI",167981,823,481,464,15,2,477,4,910,429,278,199
40,"VÂLCEA","#N/A",167981,,103,"DRĂGĂŞANI / Şcoala Zlătărei",1,15868,"MUNICIPIUL DRĂGĂŞANI",167981,1226,743,709,34,0,733,10,1350,607,379,354
40,"VÂLCEA","#N/A",168372,,104,"BĂBENI / Primăria oraşului Băbeni",1,15873,"ORAŞ BĂBENI",168372,1799,1120,1005,115,0,1097,23,1970,850,541,556
40,"VÂLCEA","#N/A",168372,,105,"BĂBENI / Liceul,,George Ţărnea,, Băbeni",1,15873,"ORAŞ BĂBENI",168372,1322,750,684,66,0,739,11,1460,710,320,419
40,"VÂLCEA","#N/A",168372,,106,"BĂBENI / S.C. ALFA FARM S.R.L.",1,15873,"ORAŞ BĂBENI",168372,588,481,357,124,0,477,4,650,169,247,230
40,"VÂLCEA","#N/A",168372,,107,"BĂBENI / Şcoala gen. cu cls.I-IV Valea Mare",1,15873,"ORAŞ BĂBENI",168372,828,515,451,64,0,508,7,910,395,328,180
40,"VÂLCEA","#N/A",168372,,108,"BĂBENI / Şcoala Gimnaziala, sat Valea Mare, oras Băbeni",1,15873,"ORAŞ BĂBENI",168372,1292,726,645,80,1,718,8,1430,704,434,284
40,"VÂLCEA","#N/A",168372,,109,"BĂBENI / Şcoala gen.Tătărani",1,15873,"ORAŞ BĂBENI",168372,561,329,269,60,0,325,4,620,291,148,177
40,"VÂLCEA","#N/A",168372,,110,"BĂBENI / Şcoala generală Romani",1,15873,"ORAŞ BĂBENI",168372,1095,785,723,62,0,777,8,1210,425,421,356
40,"VÂLCEA","#N/A",168372,,111,"BĂBENI / Şcoala Pădureţu",1,15873,"ORAŞ BĂBENI",168372,183,159,137,22,0,158,1,199,40,89,69
40,"VÂLCEA","#N/A",167641,,112,"CURĂTURILE / Sala de căsătorii a primăriei",1,15881,"ORAŞ BĂILE GOVORA",167641,1107,1078,677,401,0,1070,8,1220,142,498,572
40,"VÂLCEA","#N/A",167641,,113,"PRAJILA / Liceul Teoretic Băile Govora",1,15881,"ORAŞ BĂILE GOVORA",167641,1091,808,704,75,29,789,19,1200,392,381,408
40,"VÂLCEA","#N/A",167641,,114,"GĂTEJEŞTI / Şcoala generală cu cls. I-IV Gătejeşti",1,15881,"ORAŞ BĂILE GOVORA",167641,336,253,209,44,0,253,0,369,116,108,145
40,"VÂLCEA","#N/A",167696,,115,"LIVADIA / Grupul Şcolar Tehnic Economic Justinian Marina",1,15885,"ORAŞ BĂILE OLĂNEŞTI",167696,1589,1789,1031,756,2,1761,28,1950,161,1030,731
40,"VÂLCEA","#N/A",167696,,116,"OLĂNEŞTI / Scoala gimnaziala Prof. Dr. Ghe. Olanescu",1,15885,"ORAŞ BĂILE OLĂNEŞTI",167696,1340,915,838,71,6,899,16,1470,555,526,373
40,"VÂLCEA","#N/A",167696,,117,"CHEIA / Scoala gimnaziala cu clasele I-VIII Ionescu Cheianu",1,15885,"ORAŞ BĂILE OLĂNEŞTI",167696,935,634,601,33,0,626,8,830,196,374,252
40,"VÂLCEA","#N/A",168452,,118,"BĂLCEŞTI / Liceul Tehnologic Petrache Poenaru",1,15894,"ORAŞ BĂLCEŞTI",168452,993,665,555,75,35,656,9,1090,425,386,270
40,"VÂLCEA","#N/A",168452,,119,"BĂLCEŞTI / Liceul Tehnologic Petrache Poenaru",1,15894,"ORAŞ BĂLCEŞTI",168452,943,609,534,71,4,603,6,1040,431,373,230
40,"VÂLCEA","#N/A",168452,,120,"BENEŞTI / Şcoala primară Beneşti",1,15894,"ORAŞ BĂLCEŞTI",168452,352,237,207,29,1,235,2,390,153,150,85
40,"VÂLCEA","#N/A",168452,,121,"GORUNEŞTI / Şcoala primară  Goruneşti",1,15894,"ORAŞ BĂLCEŞTI",168452,691,437,384,51,2,434,3,761,324,311,123
40,"VÂLCEA","#N/A",168452,,122,"IRIMEŞTI / Scoala primară Cârlogani",1,15894,"ORAŞ BĂLCEŞTI",168452,500,361,308,52,1,354,7,550,189,244,110
40,"VÂLCEA","#N/A",168452,,123,"OTETELIŞU / Şcoala primară Otetelişu",1,15894,"ORAŞ BĂLCEŞTI",168452,871,621,553,66,2,615,6,960,339,373,242
40,"VÂLCEA","#N/A",168602,,124,"DEALU ALUNIŞ / Grădiniţa nr.1 (PECO)",1,15904,"ORAŞ BERBEŞTI",168602,950,456,417,39,0,455,1,1050,594,175,280
40,"VÂLCEA","#N/A",168602,,125,"DEALU ALUNIŞ / Grădiniţa nr. 2 blocuri",1,15904,"ORAŞ BERBEŞTI",168602,1187,668,638,30,0,662,6,1290,622,281,381
40,"VÂLCEA","#N/A",168602,,126,"ROŞIOARA / Şcoala Generală cu cls. I- VIII Berbeşti",1,15904,"ORAŞ BERBEŞTI",168602,1513,936,900,36,0,917,19,1679,743,473,444
40,"VÂLCEA","#N/A",168602,,127,"TÂRGU GÂNGULEŞTI / Grup Şcolar Preda Buzescu",1,15904,"ORAŞ BERBEŞTI",168602,957,573,544,29,0,567,6,1050,477,244,323
40,"VÂLCEA","#N/A",167794,,128,"PĂSCOAIA / Şcoala cu cls. I-IV Păscoaia",1,15911,"ORAŞ BREZOI",167794,161,125,99,26,0,124,1,180,55,80,44
40,"VÂLCEA","#N/A",167794,,129,"VALEA LUI STAN / Şcoala cu cls. I-VIII Valea lui Stan",1,15911,"ORAŞ BREZOI",167794,389,241,231,10,0,234,7,430,189,88,146
40,"VÂLCEA","#N/A",167794,,130,"BREZOI / Şcoala cu clasele I-IV nr.2 Brezoi",1,15911,"ORAŞ BREZOI",167794,1091,679,606,71,2,671,8,1200,521,301,370
40,"VÂLCEA","#N/A",167794,,131,"BREZOI / Grădiniţa cu Program Normalnr.1- parter",1,15911,"ORAŞ BREZOI",167794,971,483,445,38,0,472,11,1060,577,190,282
40,"VÂLCEA","#N/A",167794,,132,"BREZOI / Grădiniţa cu Program Normalnr.1- parter",1,15911,"ORAŞ BREZOI",167794,1247,641,587,54,0,635,6,1381,740,277,358
40,"VÂLCEA","#N/A",167794,,133,"BREZOI / Şcoala cu clasele I-IV nr 1 Brezoi",1,15911,"ORAŞ BREZOI",167794,919,503,467,36,0,494,9,1010,507,214,280
40,"VÂLCEA","#N/A",167794,,134,"BREZOI / Magazia Miniera",1,15911,"ORAŞ BREZOI",167794,529,312,275,37,0,310,2,579,267,125,185
40,"VÂLCEA","#N/A",167794,,135,"CĂLINEŞTI / Căminul cultural Călineşti",1,15911,"ORAŞ BREZOI",167794,537,374,318,56,0,370,4,590,216,183,187
40,"VÂLCEA","#N/A",167909,,136,"CĂLIMĂNEŞTI / Şcoala generală cu cls.I-IV Seaca",1,15921,"ORAŞ CĂLIMĂNEŞTI",167909,490,321,296,25,0,317,4,442,121,120,197
40,"VÂLCEA","#N/A",167909,,137,"CĂLIMĂNEŞTI / Liceul tehnologic de turism Călimăneşti (Sala cantina restaurant)",1,15921,"ORAŞ CĂLIMĂNEŞTI",167909,936,688,572,116,0,681,7,930,242,288,393
40,"VÂLCEA","#N/A",167909,,138,"CĂLIMĂNEŞTI / Şcoala gimnazială ,,Şerban Vodă Cantacuzino,, Călimăneşti",1,15921,"ORAŞ CĂLIMĂNEŞTI",167909,1056,709,633,76,0,693,16,1070,361,302,391
40,"VÂLCEA","#N/A",167909,,139,"CĂLIMĂNEŞTI / Şcoala generală cu clasele I-IV Călimăneşti (Deal)",1,15921,"ORAŞ CĂLIMĂNEŞTI",167909,1117,752,710,42,0,743,9,1030,278,313,430
40,"VÂLCEA","#N/A",167909,,140,"CĂLIMĂNEŞTI / Centrul de Informare turistică Călimăneşti",1,15921,"ORAŞ CĂLIMĂNEŞTI",167909,520,525,283,242,0,516,9,670,145,258,258
40,"VÂLCEA","#N/A",167909,,141,"CĂLIMĂNEŞTI / Hotel Traian (Cofetăria)",1,15921,"ORAŞ CĂLIMĂNEŞTI",167909,541,1259,318,940,1,1241,18,1653,394,585,656
40,"VÂLCEA","#N/A",167909,,142,"CĂLIMĂNEŞTI / Şcoala gimnazială Jiblea Veche",1,15921,"ORAŞ CĂLIMĂNEŞTI",167909,970,483,454,29,0,481,2,870,387,214,267
40,"VÂLCEA","#N/A",167909,,143,"CĂLIMĂNEŞTI / Şcoala gimnazială Jiblea Veche",1,15921,"ORAŞ CĂLIMĂNEŞTI",167909,977,569,520,49,0,564,5,880,311,236,328
40,"VÂLCEA","#N/A",167909,,144,"CĂLIMĂNEŞTI / Şcoala primară Jiblea Nouă",1,15921,"ORAŞ CĂLIMĂNEŞTI",167909,869,529,485,44,0,521,8,760,231,216,305
40,"VÂLCEA","#N/A",168041,,145,"URŞANI / CAMINUL CULTURAL URSANI",1,15928,"ORAŞ HOREZU",168041,393,274,251,22,1,268,6,441,167,103,165
40,"VÂLCEA","#N/A",168041,,146,"HOREZU / LICEUL CONSTANTIN BRANCOVEANU",1,15928,"ORAŞ HOREZU",168041,1332,975,826,143,6,969,6,1480,505,457,512
40,"VÂLCEA","#N/A",168041,,147,"HOREZU / CLUBUL COPIILOR HOREZU",1,15928,"ORAŞ HOREZU",168041,1314,846,779,67,0,834,12,1450,604,382,452
40,"VÂLCEA","#N/A",168041,,148,"HOREZU / CASA DE CULTURA CONSTANTIN BRANCOVEANU",1,15928,"ORAŞ HOREZU",168041,865,652,563,88,1,634,18,950,298,277,357
40,"VÂLCEA","#N/A",168041,,149,"RÎMEŞTI / CAMINUL CULTURAL RAMESTI",1,15928,"ORAŞ HOREZU",168041,394,308,275,33,0,307,1,430,122,158,149
40,"VÂLCEA","#N/A",168041,,150,"ROMANII DE JOS / SCOALA GENERALA CU CLASELE I - VIII ROMANII DE JOS",1,15928,"ORAŞ HOREZU",168041,640,425,393,32,0,417,8,709,284,215,202
40,"VÂLCEA","#N/A",168041,,151,"ROMANII DE SUS / MAGAZINUL SATESC ROMANII DE SUS",1,15928,"ORAŞ HOREZU",168041,806,545,524,21,0,528,17,890,345,264,264
40,"VÂLCEA","#N/A",168041,,152,"TĂNĂSEŞTI / CAMINUL CULTURAL TANASESTI",1,15928,"ORAŞ HOREZU",168041,140,120,102,18,0,117,3,159,39,59,58
40,"VÂLCEA","#N/A",168130,,153,"GURA SUHAŞULUI / Şcoala gimnazială Costea Marinoiu Ocnele Mari",1,15936,"ORAŞ OCNELE MARI",168130,1394,970,865,98,7,956,14,1530,560,487,469
40,"VÂLCEA","#N/A",168130,,154,"OCNIŢA / Fosta Şcoala cu cls. I-VIII Ocniţa",1,15936,"ORAŞ OCNELE MARI",168130,1498,1007,921,81,5,992,15,1650,643,572,420
40,"VÂLCEA","#N/A",168229,,155,"IGOIU / SCOALA GIMNAZIALA, COMUNA ALUNU, SAT IGOIU",3,15945,"ALUNU",168229,1513,870,823,47,0,863,7,1670,800,382,481
40,"VÂLCEA","#N/A",168229,,156,"BODEŞTI / FOSTUL LOCAL AL GRĂDINIŢEI CU PROGRAM NORMAL BODEŞTI, SAT BODEŞTI",3,15945,"ALUNU",168229,297,174,156,18,0,170,4,329,155,74,96
40,"VÂLCEA","#N/A",168229,,157,"COLTEŞTI / GRĂDINIŢA CU PROGRAM NORMAL COLTEŞTI, SAT COLTEŞTI",3,15945,"ALUNU",168229,1286,820,756,64,0,814,6,1411,591,450,364
40,"VÂLCEA","#N/A",168229,,158,"ROŞIA / GRĂDINIŢA CU PROGRAM NORMAL ROŞIA",3,15945,"ALUNU",168229,477,290,267,23,0,289,1,518,228,157,132
40,"VÂLCEA","#N/A",168309,,159,"AMĂRĂŞTI / Şcoala gimnazială Amărăşti",3,15953,"AMĂRĂŞTI",168309,936,573,515,58,0,570,3,1030,457,315,255
40,"VÂLCEA","#N/A",168309,,160,"NEMOIU / Fosta şcoală Nemoiu",3,15953,"AMĂRĂŞTI",168309,663,439,385,54,0,428,11,730,291,211,217
40,"VÂLCEA","#N/A",168559,,161,"BODEŞTI / Fosta Şcoală cu clasele I-IV Bodeşti",3,15960,"BĂRBĂTEŞTI",168559,825,563,501,61,1,555,8,910,347,352,203
40,"VÂLCEA","#N/A",168559,,162,"BĂRBĂTEŞTI / Căminul cultural Bărbăteşti",3,15960,"BĂRBĂTEŞTI",168559,1334,909,831,78,0,899,10,1470,561,597,302
40,"VÂLCEA","#N/A",168559,,163,"BÎRZEŞTI / Fosta Şcoală cu cls.I-IV Bârzeşti,",3,15960,"BĂRBĂTEŞTI",168559,779,501,439,62,0,497,4,860,359,243,254
40,"VÂLCEA","#N/A",168675,,164,"BERISLĂVEŞTI / cAMINUL cULTURAL sTOENESTI",3,15965,"BERISLĂVEŞTI",168675,1188,849,751,89,9,846,3,1288,439,367,479
40,"VÂLCEA","#N/A",168675,,165,"DÎNGEŞTI / Căminul cultural Dângeşti",3,15965,"BERISLĂVEŞTI",168675,302,244,199,34,11,242,2,330,86,155,87
40,"VÂLCEA","#N/A",168675,,166,"RĂDĂCINEŞTI / Căminul cultural Rădăcineşti",3,15965,"BERISLĂVEŞTI",168675,591,404,360,37,7,399,5,653,249,157,242
40,"VÂLCEA","#N/A",168675,,167,"ROBAIA / Căminul cultural Robaia",3,15965,"BERISLĂVEŞTI",168675,213,148,133,14,1,146,2,242,94,109,37
40,"VÂLCEA","#N/A",168755,,168,"BOIŞOARA / Şcoala cu cls.I-VIII Boişoara",3,15973,"BOIŞOARA",168755,1107,706,628,75,3,700,6,1220,514,230,470
40,"VÂLCEA","#N/A",168791,,169,"BUDEŞTI / Căminul cultural Budeşti",3,15977,"BUDEŞTI",168791,1211,753,677,76,0,748,5,1330,577,285,463
40,"VÂLCEA","#N/A",168791,,170,"LINIA / Şcoala Racoviţa",3,15977,"BUDEŞTI",168791,1358,805,734,71,0,798,7,1500,695,334,464
40,"VÂLCEA","#N/A",168791,,171,"BARZA / Şcoala Barza",3,15977,"BUDEŞTI",168791,836,573,530,43,0,568,5,920,347,208,360
40,"VÂLCEA","#N/A",168791,,172,"BÎRSEŞTI / Şcoala Bârseşti",3,15977,"BUDEŞTI",168791,742,523,458,65,0,519,4,820,297,212,307
40,"VÂLCEA","#N/A",168791,,173,"RUDA / Şcoala Ruda",3,15977,"BUDEŞTI",168791,452,280,243,37,0,278,2,500,220,112,166
40,"VÂLCEA","#N/A",168791,,174,"BERCIOIU / Şcoala Bercioiu",3,15977,"BUDEŞTI",168791,296,238,204,34,0,231,7,320,82,91,140
40,"VÂLCEA","#N/A",168880,,175,"OLTENI / Şcoala cu clasele I-VIII Olteni",3,15986,"BUJORENI",168880,1383,928,811,116,1,918,10,1520,592,346,572
40,"VÂLCEA","#N/A",168880,,176,"LUNCA / Şcoala cu clasele I-IV Lunca",3,15986,"BUJORENI",168880,543,390,335,55,0,383,7,590,200,223,160
40,"VÂLCEA","#N/A",168880,,177,"BOGDĂNEŞTI / Şcoala cu cls.I-IV Bogdăneşti",3,15986,"BUJORENI",168880,698,440,395,45,0,434,6,770,330,196,238
40,"VÂLCEA","#N/A",168880,,178,"GURA VĂII / Şcoala cu clasele I-VIII Gura Văii",3,15986,"BUJORENI",168880,1092,702,621,81,0,694,8,1200,498,293,401
40,"VÂLCEA","#N/A",168960,,179,"BUNEŞTI / Şcoala cu clasele I-VIII Buneşti",3,15994,"BUNEŞTI",168960,969,678,632,45,1,668,10,1079,401,428,240
40,"VÂLCEA","#N/A",168960,,180,"TITIRECI / Şcoala cu clasele I-VIII  Buneşti",3,15994,"BUNEŞTI",168960,855,555,499,56,0,547,8,948,393,353,194
40,"VÂLCEA","#N/A",168960,,181,"TEIUŞU / Şcoala Teiuşu, com.Buneşti",3,15994,"BUNEŞTI",168960,465,250,213,37,0,248,2,510,260,191,57
40,"VÂLCEA","#N/A",169039,,182,"ARMĂŞEŞTI / Şcoala cu clasele I-VIII Armăşeşti",3,16001,"CERNIŞOARA",169039,515,343,303,40,0,342,1,570,227,229,113
40,"VÂLCEA","#N/A",169039,,183,"CERNIŞOARA / Şcoala cu clasele I-VIII Cernişoara",3,16001,"CERNIŞOARA",169039,752,521,478,43,0,503,18,830,309,319,184
40,"VÂLCEA","#N/A",169039,,184,"GROŞI / Şcoala  cu clasele I-IV Groşi",3,16001,"CERNIŞOARA",169039,781,534,487,47,0,526,8,860,326,319,207
40,"VÂLCEA","#N/A",169039,,185,"MĂDULARI / Şcoala  cu clasele I-VIII Mădulari,",3,16001,"CERNIŞOARA",169039,574,416,371,45,0,406,10,640,224,314,92
40,"VÂLCEA","#N/A",169039,,186,"OBÎRŞIA / Şcoala cu clasele I-IV Obârşia",3,16001,"CERNIŞOARA",169039,450,301,280,21,0,295,6,490,189,208,87
40,"VÂLCEA","#N/A",169119,,187,"CÎINENII MICI / Şcoala primară Câinenii Mici",3,16009,"CÎINENI",169119,510,325,268,55,2,323,2,560,235,111,212
40,"VÂLCEA","#N/A",169119,,188,"CÎINENII MARI / Şcoala gimnazială Cîinenii Mari",3,16009,"CÎINENI",169119,587,370,304,66,0,368,2,640,270,117,251
40,"VÂLCEA","#N/A",169119,,189,"GREBLEŞTI / Grădiniţa cu program normal Grebleşti",3,16009,"CÎINENI",169119,598,464,345,119,0,456,8,660,196,125,331
40,"VÂLCEA","#N/A",169119,,190,"ROBEŞTI / Caminul cultural Robesti",3,16009,"CÎINENI",169119,168,143,104,39,0,142,1,190,47,56,86
40,"VÂLCEA","#N/A",169182,,191,"ULMETU / Grădiniţa Ulmetu",3,16016,"COPĂCENI",169182,1472,891,802,89,0,876,15,1620,729,507,369
40,"VÂLCEA","#N/A",169182,,192,"VEŢELU / Şcoala cu clasele I-IV Veţelu",3,16016,"COPĂCENI",169182,788,478,426,52,0,472,6,870,392,278,194
40,"VÂLCEA","#N/A",169253,,193,"COSTEŞTI / Şcoala cu cls.I-VIII Costeşti",3,16023,"COSTEŞTI",169253,1597,1131,1043,77,11,1115,16,1760,629,613,502
40,"VÂLCEA","#N/A",169253,,194,"BISTRIŢA / Şcoala cu cls.I-IV Bistriţa",3,16023,"COSTEŞTI",169253,707,509,424,70,15,485,24,766,257,319,166
40,"VÂLCEA","#N/A",169253,,195,"PIETRENI / Şcoala cu cls.I-IV Pietreni",3,16023,"COSTEŞTI",169253,462,343,324,16,3,341,2,510,167,224,117
40,"VÂLCEA","#N/A",169306,,196,"CREŢENI / ŞCOALA GIMNAZIALĂ CREŢENI",3,16028,"CREŢENI",169306,929,617,548,64,5,608,9,1019,402,357,251
40,"VÂLCEA","#N/A",169306,,197,"IZVORU / GRĂDINIŢA CU PROGRAM NORMAL IZVORU",3,16028,"CREŢENI",169306,492,349,303,46,0,349,0,539,190,174,175
40,"VÂLCEA","#N/A",169306,,198,"STREMINOASA / GRĂDINIŢA CU PROGRAM NORMAL STREMINOASA",3,16028,"CREŢENI",169306,510,353,318,34,1,350,3,564,211,230,120
40,"VÂLCEA","#N/A",169351,,199,"DĂEŞTI / Şcoala  Dăeşti",3,16033,"DĂEŞTI",169351,870,652,579,73,0,646,6,960,308,196,450
40,"VÂLCEA","#N/A",169351,,200,"SÎNBOTIN / Căminul cultural Sânbotin",3,16033,"DĂEŞTI",169351,655,464,397,67,0,460,4,720,256,178,282
40,"VÂLCEA","#N/A",169351,,201,"FEDELEŞOIU / Scoala Fedelesoiu",3,16033,"DĂEŞTI",169351,850,661,555,105,1,651,10,930,269,220,431
40,"VÂLCEA","#N/A",169351,,202,"BĂBUEŞTI / Şcoala  Băbueşti",3,16033,"DĂEŞTI",169351,85,63,47,16,0,63,0,90,27,22,41
40,"VÂLCEA","#N/A",169404,,203,"UDREŞTI / Şcoala gimnazială Udreşti",3,16038,"DĂNICEI",169404,809,491,401,90,0,483,8,890,399,313,170
40,"VÂLCEA","#N/A",169404,,204,"DEALU SCHEIULUI / Şcoala primară Dealul Scheiului",3,16038,"DĂNICEI",169404,254,200,157,43,0,199,1,280,80,121,78
40,"VÂLCEA","#N/A",169404,,205,"LĂUNELE DE JOS / Şcoala gimnazială Lăunele de Jos",3,16038,"DĂNICEI",169404,382,263,212,51,0,260,3,420,157,177,83
40,"VÂLCEA","#N/A",169404,,206,"CERETU / Scoala primară Ceretu",3,16038,"DĂNICEI",169404,324,207,175,32,0,206,1,360,153,131,75
40,"VÂLCEA","#N/A",174502,,207,"BĂBENI-OLTEŢU / Şcoala cu cls. I-VIII Băbeni-Olteţu",3,16052,"DICULEŞTI",174502,918,589,534,53,2,585,4,1010,421,354,231
40,"VÂLCEA","#N/A",174502,,208,"BUDEŞTI / Şcoala cu clasele I-IV Budeşti",3,16052,"DICULEŞTI",174502,651,452,414,33,5,445,7,712,260,254,191
40,"VÂLCEA","#N/A",169547,,209,"DRĂGOEŞTI / Şcoala cu clasele I-VIII Drăgoeşti",3,16057,"DRĂGOEŞTI",169547,711,488,411,77,0,484,4,790,302,298,186
40,"VÂLCEA","#N/A",169547,,210,"DRĂGOEŞTI / ŞCOALA CU CLS. I- IV GEAMĂNA- BUCIUMENI",3,16057,"DRĂGOEŞTI",169547,617,418,370,48,0,413,5,680,262,282,131
40,"VÂLCEA","#N/A",169547,,211,"DRĂGOEŞTI / Şcoala cu clasele I-IV Boncani",3,16057,"DRĂGOEŞTI",169547,425,300,258,42,0,292,8,460,160,194,98
40,"VÂLCEA","#N/A",169583,,212,"MĂRCUŞU / Şcoala gimnazială Făureşti",3,16061,"FĂUREŞTI",169583,675,455,398,57,0,449,6,740,285,212,237
40,"VÂLCEA","#N/A",169583,,213,"MILEŞTI / Grădiniţa Mileşti",3,16061,"FĂUREŞTI",169583,528,332,288,44,0,327,5,580,248,190,137
40,"VÂLCEA","#N/A",169681,,214,"FÎRTĂŢEŞTI / Primăria Fârtăţeşti",3,16067,"FÎRTĂŢEŞTI",169681,330,251,203,47,1,250,1,360,109,196,54
40,"VÂLCEA","#N/A",169681,,215,"BECŞANI / Fosta Şcoală Dejoi",3,16067,"FÎRTĂŢEŞTI",169681,408,310,239,71,0,309,1,450,140,218,91
40,"VÂLCEA","#N/A",169681,,216,"CĂŢETU / Fosta Şcoală Căţetu",3,16067,"FÎRTĂŢEŞTI",169681,401,248,225,23,0,248,0,440,192,196,52
40,"VÂLCEA","#N/A",169681,,217,"DOZEŞTI / Şcoala cu cls.I-VIII Dozeşti",3,16067,"FÎRTĂŢEŞTI",169681,1082,626,536,88,2,620,6,1190,564,398,222
40,"VÂLCEA","#N/A",169681,,218,"GIULEŞTI / Şcoala  cu cls.I-VIII Rusăneşti",3,16067,"FÎRTĂŢEŞTI",169681,1010,646,568,68,10,640,6,1110,464,450,190
40,"VÂLCEA","#N/A",169896,,219,"FRÎNCEŞTI / Şcoala  cu clasele I-VIII Frânceşti",3,16088,"FRÎNCEŞTI",169896,631,364,317,47,0,361,3,700,336,232,129
40,"VÂLCEA","#N/A",169896,,220,"MĂNĂILEŞTI / Scoala generală cu cls.I-VIII  Genuneni",3,16088,"FRÎNCEŞTI",169896,652,450,397,53,0,450,0,721,271,273,177
40,"VÂLCEA","#N/A",169896,,221,"GENUNENI / Grădiniţa Negreni",3,16088,"FRÎNCEŞTI",169896,421,275,244,31,0,274,1,458,183,140,134
40,"VÂLCEA","#N/A",169896,,222,"COŞANI / Şcoala generală cu clasele I-IV Coşani",3,16088,"FRÎNCEŞTI",169896,1187,583,545,38,0,574,9,1310,727,339,235
40,"VÂLCEA","#N/A",169896,,223,"DEZROBIŢI / Grădiniţa Dezrobiţi",3,16088,"FRÎNCEŞTI",169896,570,363,330,33,0,355,8,630,267,213,142
40,"VÂLCEA","#N/A",169896,,224,"MOŞTENI / Şcoala Generală cu clasele I-IV Surpate",3,16088,"FRÎNCEŞTI",169896,677,429,382,47,0,427,2,749,320,284,143
40,"VÂLCEA","#N/A",169896,,225,"VIIŞOARA / Grădiniţa Viişoara",3,16088,"FRÎNCEŞTI",169896,231,174,147,27,0,171,3,249,75,121,50
40,"VÂLCEA","#N/A",169994,,226,"GALICEA / CAMINUL CULTURAL GALICEA",3,16098,"GALICEA",169994,973,661,581,80,0,651,10,1070,409,325,326
40,"VÂLCEA","#N/A",169994,,227,"TEIU / Şcoala Teiu",3,16098,"GALICEA",169994,356,279,233,46,0,275,4,390,111,147,128
40,"VÂLCEA","#N/A",169994,,228,"VALEA RÎULUI / Şcoala Valea Râului",3,16098,"GALICEA",169994,376,276,250,26,0,269,7,410,134,140,129
40,"VÂLCEA","#N/A",169994,,229,"COCORU / Şcoala Cocoru",3,16098,"GALICEA",169994,558,399,340,59,0,395,4,610,211,184,211
40,"VÂLCEA","#N/A",169994,,230,"BRATIA DIN VALE / Şcoala Bratia din Vale",3,16098,"GALICEA",169994,403,279,222,57,0,275,4,452,173,146,129
40,"VÂLCEA","#N/A",169994,,231,"BRATIA DIN DEAL / Şcoala Bratia din Deal",3,16098,"GALICEA",169994,296,232,190,42,0,231,1,330,98,115,116
40,"VÂLCEA","#N/A",169994,,232,"CREMENARI / Căminul cultural Cremenari",3,16098,"GALICEA",169994,357,283,222,56,5,281,2,390,107,164,117
40,"VÂLCEA","#N/A",170097,,233,"ŞTIRBEŞTI / Şcoala Ştirbeşti",3,16108,"GHIOROIU",170097,524,344,280,64,0,340,4,580,236,218,122
40,"VÂLCEA","#N/A",170097,,234,"GHIOROIU / Căminul cultural Ghioroiu",3,16108,"GHIOROIU",170097,545,402,325,76,1,395,7,622,220,252,143
40,"VÂLCEA","#N/A",170097,,235,"POIENARI / Şcoala  Poienari",3,16108,"GHIOROIU",170097,266,210,168,41,1,206,4,268,58,145,61
40,"VÂLCEA","#N/A",170168,,236,"GLĂVILE / ŞCOALA GIMNAZIALĂ ,,BARTOLOMEU VALERIU ANANIA""GLĂVILE",3,16115,"GLĂVILE",170168,922,480,428,52,0,469,11,1020,540,264,205
40,"VÂLCEA","#N/A",170168,,237,"ANINOASA / ŞCOALA PRIMARĂ ANINOASA",3,16115,"GLĂVILE",170168,191,136,101,35,0,134,2,210,74,78,56
40,"VÂLCEA","#N/A",170168,,238,"OLTEANCA / ŞCOALA PRIMARĂ OLTEANCA",3,16115,"GLĂVILE",170168,610,422,350,72,0,418,4,670,248,308,110
40,"VÂLCEA","#N/A",170220,,239,"POPEŞTI / Şcoala cu clasele I-VIII Popeşti",3,16121,"GOLEŞTI",170220,752,473,413,60,0,468,5,830,357,222,246
40,"VÂLCEA","#N/A",170220,,240,"BLIDARI / Şcoala Blidari",3,16121,"GOLEŞTI",170220,858,605,565,40,0,597,8,940,335,295,302
40,"VÂLCEA","#N/A",170220,,241,"TULEI-CÎMPENI / Şcoala Poeniţa",3,16121,"GOLEŞTI",170220,364,252,211,41,0,248,4,387,135,100,148
40,"VÂLCEA","#N/A",170220,,242,"VĂTĂŞEŞTI / Şcoala Vătăşeşti",3,16121,"GOLEŞTI",170220,213,173,134,39,0,173,0,218,45,92,81
40,"VÂLCEA","#N/A",170346,,243,"GRĂDIŞTEA / Sala de Sport de la Liceul teoretic Grădiştea",3,16133,"GRĂDIŞTEA",170346,348,231,191,40,0,229,2,380,149,122,107
40,"VÂLCEA","#N/A",170346,,244,"VALEA GRĂDIŞTEI / Şcoala cu clasele I-IV Valea Grădiştea",3,16133,"GRĂDIŞTEA",170346,124,102,86,16,0,102,0,140,38,31,71
40,"VÂLCEA","#N/A",170346,,245,"DOBRICEA / Scoala cu clasele I-VIII Dobricea",3,16133,"GRĂDIŞTEA",170346,634,420,374,46,0,410,10,697,277,202,208
40,"VÂLCEA","#N/A",170346,,246,"ŢUŢURU / Grădiniţa cu program normal Ţuţuru",3,16133,"GRĂDIŞTEA",170346,1116,648,604,41,3,640,8,1230,582,216,424
40,"VÂLCEA","#N/A",170444,,247,"SPÎRLENI / Şcoala gimnazială  Guşoeni",3,16143,"GUŞOENI",170444,793,558,456,84,18,555,3,870,312,333,222
40,"VÂLCEA","#N/A",170444,,248,"GUŞOIANCA / Căminul Cultural Guşoianca",3,16143,"GUŞOENI",170444,517,367,325,27,15,362,5,570,203,258,104
40,"VÂLCEA","#N/A",170514,,249,"IONEŞTI / Şcoala  Ioneştii Govorii",3,16150,"IONEŞTI",170514,1165,715,599,116,0,710,5,1280,565,397,313
40,"VÂLCEA","#N/A",170514,,250,"DELURENI / Şcoala Fişcălia",3,16150,"IONEŞTI",170514,911,520,471,48,1,511,9,1010,490,270,241
40,"VÂLCEA","#N/A",170514,,251,"FOTEŞTI / Şcoala  Foteşti",3,16150,"IONEŞTI",170514,718,432,374,58,0,428,4,790,358,234,194
40,"VÂLCEA","#N/A",170514,,252,"MARCEA / Şcoala Marcea",3,16150,"IONEŞTI",170514,696,442,374,68,0,438,4,770,328,267,171
40,"VÂLCEA","#N/A",170612,,253,"LALOŞU / Şcoala primară Laloşu",3,16177,"LALOŞU",170612,767,343,314,29,0,336,7,850,507,221,115
40,"VÂLCEA","#N/A",170612,,254,"MOLOGEŞTI / Şcoala gimnazială Mologeşti",3,16177,"LALOŞU",170612,548,377,328,49,0,374,3,609,232,210,164
40,"VÂLCEA","#N/A",170612,,255,"BERBEŞTI / Şcoala primară Berbeşti",3,16177,"LALOŞU",170612,381,199,173,26,0,195,4,404,205,108,87
40,"VÂLCEA","#N/A",170612,,256,"OLTEŢANI / Scoala primară Olteţani",3,16177,"LALOŞU",170612,200,170,129,41,0,166,4,220,50,93,73
40,"VÂLCEA","#N/A",174511,,257,"LĂCUSTENI / Scoala cu clasele I-IV Lăcusteni",3,16160,"LĂCUSTENI",174511,428,293,253,39,1,289,4,470,177,172,117
40,"VÂLCEA","#N/A",174511,,258,"CONTEA / Şcoala cu clasele V-VIII Lăcusteni",3,16160,"LĂCUSTENI",174511,266,176,156,20,0,172,4,286,110,89,83
40,"VÂLCEA","#N/A",174511,,259,"GĂNEŞTI / Scoala cu clasele I-IV Găneşti",3,16160,"LĂCUSTENI",174511,470,332,293,38,1,329,3,522,190,215,114
40,"VÂLCEA","#N/A",170685,,260,"LĂDEŞTI / Căminul Cultural Lădeşti",3,16166,"LĂDEŞTI",170685,793,642,473,143,26,633,9,870,228,342,291
40,"VÂLCEA","#N/A",170685,,261,"GĂGENI / Şcoala primară Găgeni",3,16166,"LĂDEŞTI",170685,197,167,117,50,0,167,0,233,66,98,69
40,"VÂLCEA","#N/A",170685,,262,"CHIRICEŞTI / Şcoala primară Chiriceşti",3,16166,"LĂDEŞTI",170685,438,309,261,48,0,305,4,480,171,189,116
40,"VÂLCEA","#N/A",170685,,263,"OLTEANCA / Şcoala primară Olteanca",3,16166,"LĂDEŞTI",170685,90,96,61,35,0,96,0,100,4,61,35
40,"VÂLCEA","#N/A",170792,,264,"SĂRULEŞTI / Şcoala gimnazială Săruleşti",3,16184,"LĂPUŞATA",170792,1190,759,660,99,0,751,8,1306,547,379,372
40,"VÂLCEA","#N/A",170792,,265,"BROŞTENI / Şcoala primară Broşteni",3,16184,"LĂPUŞATA",170792,580,382,329,53,0,380,2,639,257,212,168
40,"VÂLCEA","#N/A",170872,,266,"LIVEZI / Căminul cultural Tina",3,16192,"LIVEZI",170872,580,369,326,43,0,365,4,626,257,220,145
40,"VÂLCEA","#N/A",170872,,267,"PLEŞOIU / Şcoala cu cls.I-IV Pleşoiu",3,16192,"LIVEZI",170872,365,196,166,30,0,194,2,394,198,111,83
40,"VÂLCEA","#N/A",170872,,268,"PÎRÎIENII DE MIJLOC / Căminul cultural Pîrîieni",3,16192,"LIVEZI",170872,977,558,499,59,0,556,2,1070,512,358,198
40,"VÂLCEA","#N/A",170952,,269,"LUNGEŞTI / Şcoala Lungeşti",3,16200,"LUNGEŞTI",170952,875,568,482,67,19,560,8,960,392,329,231
40,"VÂLCEA","#N/A",170952,,270,"STĂNEŞTI-LUNCA / Şcoala cu clasele I-IV Stăneşti-Lunca",3,16200,"LUNGEŞTI",170952,812,535,469,59,7,526,9,900,365,319,207
40,"VÂLCEA","#N/A",170952,,271,"FUMURENI / Căminul Cultural Fumureni",3,16200,"LUNGEŞTI",170952,616,406,332,74,0,400,6,680,274,250,150
40,"VÂLCEA","#N/A",170952,,272,"DUMBRAVA / Şcoala cu clasele I-IV Dumbrava",3,16200,"LUNGEŞTI",170952,317,218,184,29,5,218,0,348,130,129,89
40,"VÂLCEA","#N/A",171021,,273,"MALAIA / Şcoala gimnazială Malaia",3,16224,"MALAIA",171021,895,691,587,104,0,681,10,990,299,302,379
40,"VÂLCEA","#N/A",171021,,274,"CIUNGETU / Şcoala primară Ciunget",3,16224,"MALAIA",171021,400,307,260,47,0,305,2,440,133,104,201
40,"VÂLCEA","#N/A",171021,,275,"SĂLIŞTEA / Grădiniţa cu program normal Sălişte",3,16224,"MALAIA",171021,245,225,168,57,0,223,2,270,45,112,111
40,"VÂLCEA","#N/A",171067,,276,"MATEEŞTI / Şcoala gimnazială Mateeşti",3,16233,"MATEEŞTI",171067,1101,781,692,79,10,772,9,1222,441,404,368
40,"VÂLCEA","#N/A",171067,,277,"GRECI / Grădiniţă Greci",3,16233,"MATEEŞTI",171067,487,328,287,34,7,327,1,541,213,183,144
40,"VÂLCEA","#N/A",171067,,278,"TURCEŞTI / Şcoala gimnazială Turceşti",3,16233,"MATEEŞTI",171067,993,688,624,61,3,679,9,1100,412,422,257
40,"VÂLCEA","#N/A",171101,,279,"OVESELU / sediu vechi primarie centru civic",3,16207,"MĂCIUCA",171101,859,918,545,373,0,912,6,1090,172,316,596
40,"VÂLCEA","#N/A",171101,,280,"POPEŞTI / Şcoala gen.Popeşti, comuna Măciuca, satul Popeşti",3,16207,"MĂCIUCA",171101,415,449,263,186,0,444,5,463,14,157,287
40,"VÂLCEA","#N/A",171101,,281,"ŞTEFĂNEŞTI / Scoala cu clasele I-IV Zăvoieni",3,16207,"MĂCIUCA",171101,270,310,169,141,0,302,8,328,18,86,216
40,"VÂLCEA","#N/A",171209,,282,"MĂDULARI / Şcoala cu cls. I-VIII Mădulari",3,16217,"MĂDULARI",171209,670,486,413,72,1,484,2,735,249,291,193
40,"VÂLCEA","#N/A",171209,,283,"BĂLŞOARA / Şcoala cu clasele I-IV Bălşoara",3,16217,"MĂDULARI",171209,297,203,186,17,0,201,2,320,117,135,66
40,"VÂLCEA","#N/A",171209,,284,"BĂNŢEŞTI / Şcoala cu cls. I-IV Bănţeşti",3,16217,"MĂDULARI",171209,272,185,161,24,0,185,0,300,115,92,93
40,"VÂLCEA","#N/A",171272,,285,"MĂLDĂREŞTI / Şcoala veche  Măldăreşti",3,16228,"MĂLDĂREŞTI",171272,1562,1052,988,63,1,1037,15,1720,668,607,430
40,"VÂLCEA","#N/A",171272,,286,"TELECHEŞTI / Şcoala Telecheşti",3,16228,"MĂLDĂREŞTI",171272,136,115,87,28,0,114,1,150,35,78,36
40,"VÂLCEA","#N/A",171325,,287,"BULETA / Gradinita Buleta",3,16237,"MIHĂEŞTI",171325,1163,766,680,86,0,761,5,1280,514,403,358
40,"VÂLCEA","#N/A",171325,,288,"MĂGURA / Căminul Cultural Măgura",3,16237,"MIHĂEŞTI",171325,729,545,472,73,0,544,1,800,255,321,223
40,"VÂLCEA","#N/A",171325,,289,"VULPUEŞTI / Căminul cultural Vulpuieşti",3,16237,"MIHĂEŞTI",171325,661,429,390,39,0,424,5,730,301,249,175
40,"VÂLCEA","#N/A",171325,,290,"BÎRSEŞTI / Şcoala cu clasele I-IV Bîrseşti",3,16237,"MIHĂEŞTI",171325,619,367,317,50,0,366,1,690,323,167,199
40,"VÂLCEA","#N/A",171325,,291,"STUPĂREI / Grădiniţa Stupărei",3,16237,"MIHĂEŞTI",171325,724,494,415,79,0,490,4,800,306,260,230
40,"VÂLCEA","#N/A",171325,,292,"MIHĂEŞTI / GRADINITA MIHAESTI",3,16237,"MIHĂEŞTI",171325,903,637,536,34,67,632,5,1000,363,391,241
40,"VÂLCEA","#N/A",171325,,293,"GURIŞOARA / SCOALA GENERALA",3,16237,"MIHĂEŞTI",171325,765,515,461,54,0,502,13,840,325,256,246
40,"VÂLCEA","#N/A",171469,,294,"MILCOIU / Primăria Milcoiu",3,16251,"MILCOIU",171469,595,500,394,105,1,497,3,660,160,232,265
40,"VÂLCEA","#N/A",171469,,295,"IZBĂSEŞTI / Grădiniţa Izbăşeşti",3,16251,"MILCOIU",171469,223,154,117,37,0,152,2,250,96,68,84
40,"VÂLCEA","#N/A",171469,,296,"CIUTEŞTI / Grădiniţa Ciuteşti",3,16251,"MILCOIU",171469,234,168,123,39,6,164,4,262,94,66,98
40,"VÂLCEA","#N/A",174520,,297,"MITROFANI / CAMINUL CULTURAL MITROFANI",3,16258,"MITROFANI",174520,595,396,335,46,15,394,2,650,254,204,190
40,"VÂLCEA","#N/A",174520,,298,"RACU / FOSTA SCOALA RACU",3,16258,"MITROFANI",174520,231,172,153,19,0,172,0,249,77,55,117
40,"VÂLCEA","#N/A",171539,,299,"MUEREASCA / Şcoala Muereasca de jos",3,16263,"MUEREASCA",171539,936,547,485,62,0,542,5,1040,493,227,315
40,"VÂLCEA","#N/A",171539,,300,"MUEREASCA DE SUS / Şcoala Muereasca de sus",3,16263,"MUEREASCA",171539,1198,671,603,66,2,665,6,1320,649,203,462
40,"VÂLCEA","#N/A",171628,,301,"ROTĂRĂŞTI / Şcoala cu clasele I-VIII Rotărăşti",3,16272,"NICOLAE BĂLCESCU",171628,891,641,518,119,4,633,8,980,339,402,231
40,"VÂLCEA","#N/A",171628,,302,"CORBII DIN VALE / Şcoala cu clasele I-IV Corbi",3,16272,"NICOLAE BĂLCESCU",171628,343,250,194,56,0,248,2,370,120,136,112
40,"VÂLCEA","#N/A",171628,,303,"ŞERBĂNEASA / Şcoala cu clasele I-IV  Şerbăneasa",3,16272,"NICOLAE BĂLCESCU",171628,740,516,453,62,1,512,4,810,294,348,164
40,"VÂLCEA","#N/A",171628,,304,"VALEA VIEI / Grădiniţa de copii Predeşti",3,16272,"NICOLAE BĂLCESCU",171628,740,522,441,71,10,519,3,820,298,330,189
40,"VÂLCEA","#N/A",171628,,305,"GÎLTOFANI / Şcoala cu clasele I-IV Gâltofani",3,16272,"NICOLAE BĂLCESCU",171628,166,128,98,30,0,128,0,180,52,78,50
40,"VÂLCEA","#N/A",171806,,306,"OLANU / Şcoala  cu cls I-IV Peretu",3,16290,"OLANU",171806,466,325,276,49,0,317,8,510,185,184,133
40,"VÂLCEA","#N/A",171806,,307,"CASA VECHE / Şcoala cu cls.I-IV Casa veche",3,16290,"OLANU",171806,625,448,388,60,0,446,2,700,252,237,209
40,"VÂLCEA","#N/A",171806,,308,"CIOBOŢI / Scoala  cu cls I-IV Cioboţi",3,16290,"OLANU",171806,596,378,322,56,0,377,1,650,272,186,191
40,"VÂLCEA","#N/A",171806,,309,"DRĂGIOIU / Scoala cu cls.I-IV Drăgioiu",3,16290,"OLANU",171806,492,354,305,49,0,352,2,540,186,159,193
40,"VÂLCEA","#N/A",171806,,310,"STOICĂNEŞTI / Şcoala cu cls.I-IV Stoicăneşti",3,16290,"OLANU",171806,371,285,245,40,0,284,1,410,125,129,155
40,"VÂLCEA","#N/A",171879,,311,"ORLEŞTI / Cămin cultural(fostul cămin cultural din curtea primăriei)",3,16297,"ORLEŞTI",171879,1409,972,837,83,52,960,12,1551,579,409,551
40,"VÂLCEA","#N/A",171879,,312,"SILEA / Grădiniţa Silea",3,16297,"ORLEŞTI",171879,1067,790,688,61,41,779,11,1170,380,395,384
40,"VÂLCEA","#N/A",171931,,313,"OTEŞANI / Căminul cultural Oteşani",3,16303,"OTEŞANI",171931,1181,804,742,61,1,795,9,1300,496,413,382
40,"VÂLCEA","#N/A",171931,,314,"CÎRSTĂNEŞTI / Şcoala Cîrstăneşti",3,16303,"OTEŞANI",171931,1156,790,715,71,4,775,15,1270,480,344,431
40,"VÂLCEA","#N/A",172082,,315,"PIETRARI / Şcoala gimnazială Achim Popescu",3,16318,"PĂUSEŞTI-MĂGLAŞI",172082,1087,817,712,105,0,806,11,1190,373,348,458
40,"VÂLCEA","#N/A",172082,,316,"PĂUŞEŞTI-MĂGLAŞI / Şcoala gimnazială Achim Popescu",3,16318,"PĂUSEŞTI-MĂGLAŞI",172082,1227,902,787,115,0,888,14,1350,448,355,533
40,"VÂLCEA","#N/A",172082,,317,"VALEA CHEII / Şcoala primară Valea Cheii",3,16318,"PĂUSEŞTI-MĂGLAŞI",172082,932,501,441,60,0,494,7,1030,529,252,242
40,"VÂLCEA","#N/A",171995,,318,"BARCANELE / Şcoala primară Barcanele",3,16309,"PĂUŞEŞTI",171995,521,363,324,39,0,360,3,580,217,222,138
40,"VÂLCEA","#N/A",171995,,319,"PĂUŞEŞTI / Căminul cultural Păuşeşti",3,16309,"PĂUŞEŞTI",171995,785,563,499,64,0,555,8,860,297,350,205
40,"VÂLCEA","#N/A",171995,,320,"CERNELELE / Căminul cultural Şerbăneşti",3,16309,"PĂUŞEŞTI",171995,570,345,307,38,0,340,5,630,285,187,153
40,"VÂLCEA","#N/A",171995,,321,"BUZDUGAN / Şcoala gimnazială Şerbăneşti",3,16309,"PĂUŞEŞTI",171995,412,269,247,22,0,262,7,447,178,119,143
40,"VÂLCEA","#N/A",172153,,322,"PERIŞANI / Şcoala cu clasele I-VIII Perişani",3,16325,"PERIŞANI",172153,471,351,291,49,11,349,2,520,169,108,241
40,"VÂLCEA","#N/A",172153,,323,"MLĂCENI / Căminul Cultural Mlăceni",3,16325,"PERIŞANI",172153,466,337,293,44,0,337,0,510,173,104,233
40,"VÂLCEA","#N/A",172153,,324,"POIANA / Şcoala cu clasele I-VIII Poiana",3,16325,"PERIŞANI",172153,496,313,287,25,1,312,1,540,227,138,174
40,"VÂLCEA","#N/A",172153,,325,"SPINU / Căminul cultural Spinu",3,16325,"PERIŞANI",172153,316,229,182,35,12,227,2,350,121,60,167
40,"VÂLCEA","#N/A",172153,,326,"PODENI / Şcoala Podeni",3,16325,"PERIŞANI",172153,62,59,41,18,0,59,0,70,11,8,51
40,"VÂLCEA","#N/A",172279,,327,"PESCEANA / Şcoala cu cls.I-IV Pesceana (Şcoala Veche nr. 2 Pesceana)",3,16334,"PESCEANA",172279,1444,1007,866,133,8,1002,5,1590,583,646,356
40,"VÂLCEA","#N/A",172340,,328,"PIETRARI / Şcoală gimnazială Pietrari",3,16341,"PIETRARI",172340,1409,997,885,112,0,983,14,1561,564,440,543
40,"VÂLCEA","#N/A",172340,,329,"PIETRARII DE SUS / Şcoala primară Pietrarii de sus",3,16341,"PIETRARI",172340,1161,817,762,54,1,803,14,1270,453,450,353
40,"VÂLCEA","#N/A",172377,,330,"DĂEŞTI / Şcoala cu clasele I-VIII Dăeşti",3,16344,"POPEŞTI",172377,798,513,464,49,0,502,11,880,367,310,192
40,"VÂLCEA","#N/A",172377,,331,"MEIENI / Căminul cultural Popeşti",3,16344,"POPEŞTI",172377,392,301,246,48,7,297,4,430,129,186,111
40,"VÂLCEA","#N/A",172377,,332,"POPEŞTI / Şcoala cu cls.I-IV Popeşti",3,16344,"POPEŞTI",172377,487,368,314,52,2,363,5,541,173,205,158
40,"VÂLCEA","#N/A",172377,,333,"URŞI / Şcoala cu clasele I-VIII Urşi",3,16344,"POPEŞTI",172377,856,618,539,77,2,609,9,940,322,343,266
40,"VÂLCEA","#N/A",172457,,334,"PRUNDENI / Şcoala Prundeni",3,16352,"PRUNDENI",172457,1373,869,778,73,18,860,9,1510,641,569,291
40,"VÂLCEA","#N/A",172457,,335,"CĂLINA / Şcoala Călina",3,16352,"PRUNDENI",172457,1219,773,692,70,11,768,5,1340,567,550,218
40,"VÂLCEA","#N/A",172457,,336,"BĂRBUCENI / Şcoala Bărbuceni",3,16352,"PRUNDENI",172457,1053,663,602,47,14,660,3,1160,497,414,246
40,"VÂLCEA","#N/A",172509,,337,"RACOVIŢA / Căminul cultural Racoviţa",3,16357,"RACOVIŢA",172509,802,527,442,83,2,522,5,891,364,201,321
40,"VÂLCEA","#N/A",172509,,338,"GRUIU LUPULUI / Şcoala Gruiul Lupului",3,16357,"RACOVIŢA",172509,152,105,82,23,0,99,6,170,65,26,73
40,"VÂLCEA","#N/A",172509,,339,"TUŢULEŞTI / Ocolul silvic Loviştea",3,16357,"RACOVIŢA",172509,94,99,72,27,0,99,0,99,0,15,84
40,"VÂLCEA","#N/A",172509,,340,"BALOTA / Căminul cultural Balota",3,16357,"RACOVIŢA",172509,319,216,158,58,0,212,4,350,134,67,145
40,"VÂLCEA","#N/A",172581,,341,"BĂIAŞA / Şcoala cu cls.I-IV Roeşti",3,16365,"ROEŞTI",172581,618,395,331,45,19,391,4,680,285,247,144
40,"VÂLCEA","#N/A",172581,,342,"CIOCÎLTEI / Şcoala cu cls.I-VIII Ciocîltei",3,16365,"ROEŞTI",172581,505,372,322,38,12,364,8,560,188,233,131
40,"VÂLCEA","#N/A",172581,,343,"CUENI / Şcoala cu cls.I-VIII Cueni",3,16365,"ROEŞTI",172581,479,303,266,37,0,298,5,530,227,206,92
40,"VÂLCEA","#N/A",172581,,344,"BĂRBĂRIGENI / Şcoala cu cls.I-IV Bărbărigeni",3,16365,"ROEŞTI",172581,160,121,100,19,2,119,2,172,51,73,46
40,"VÂLCEA","#N/A",172698,,345,"ROŞIILE / Şcoala gimnazială Roşiile",3,16376,"ROŞIILE",172698,941,601,484,117,0,591,10,1040,439,333,258
40,"VÂLCEA","#N/A",172698,,346,"ROMÂNEŞTI / Şcoala primară Romaneşti",3,16376,"ROŞIILE",172698,850,450,400,50,0,444,6,940,490,275,169
40,"VÂLCEA","#N/A",172698,,347,"ZGUBEA / Grădiniţa cu program normal Zgubea",3,16376,"ROŞIILE",172698,292,207,170,37,0,205,2,320,113,125,80
40,"VÂLCEA","#N/A",172698,,348,"PERTEŞTI / Fosta Şcoala Perteşti",3,16376,"ROŞIILE",172698,61,68,35,33,0,68,0,70,2,29,39
40,"VÂLCEA","#N/A",172812,,349,"RUNCU / Şcoala  Gimnaziala cu clasele I-VIII Runcu",3,16388,"RUNCU",172812,481,339,269,70,0,337,2,530,191,164,173
40,"VÂLCEA","#N/A",172812,,350,"VALEA BABEI / Şcoala generală cu cls.I-IV Valea Babei",3,16388,"RUNCU",172812,229,132,112,20,0,131,1,260,128,70,61
40,"VÂLCEA","#N/A",172812,,351,"SURPAŢI / Şcoala generală cu cls.I-IV Surpaţi",3,16388,"RUNCU",172812,123,96,77,19,0,96,0,140,44,33,63
40,"VÂLCEA","#N/A",172894,,352,"SĂLĂTRUCEL / Căminul cultural Sălătrucel",3,16396,"SĂLĂTRUCEL",172894,1142,682,620,62,0,674,8,1260,578,222,452
40,"VÂLCEA","#N/A",172894,,353,"ŞERBĂNEŞTI / Şcoala  Şerbăneşti",3,16396,"SĂLĂTRUCEL",172894,430,246,221,25,0,245,1,470,224,79,166
40,"VÂLCEA","#N/A",172894,,354,"PĂTEŞTI / Şcoala  Pateşti",3,16396,"SĂLĂTRUCEL",172894,102,76,60,16,0,74,2,110,34,22,52
40,"VÂLCEA","#N/A",172894,,355,"SEACA / Şcoala  Seaca",3,16396,"SĂLĂTRUCEL",172894,100,69,58,11,0,68,1,110,41,11,57
40,"VÂLCEA","#N/A",172947,,356,"SCUNDU / Şcoala cu cls. I-VIII Scundu",3,16401,"SCUNDU",172947,1031,751,631,101,19,746,5,1140,389,522,224
40,"VÂLCEA","#N/A",172947,,357,"CRÎNGU / Şcoala cu cls. I-VIII Avrămeşti",3,16401,"SCUNDU",172947,675,493,401,79,13,490,3,740,247,373,117
40,"VÂLCEA","#N/A",172992,,358,"SINEŞTI / SCOALA GIMNAZIALA COMUNA  SINESTI",3,16406,"SINEŞTI",172992,704,464,422,42,0,461,3,770,306,224,237
40,"VÂLCEA","#N/A",172992,,359,"MIJLOCU / SCOALA URZICA, SAT URZICA",3,16406,"SINEŞTI",172992,823,525,472,53,0,523,2,910,385,255,268
40,"VÂLCEA","#N/A",172992,,360,"POPEŞTI / SCOALA PRIMARA, SAT POPESTI",3,16406,"SINEŞTI",172992,524,328,311,17,0,326,2,580,252,151,175
40,"VÂLCEA","#N/A",173061,,361,"MOGEŞTI / Casa de Cultură Slătioara",3,16419,"SLĂTIOARA",173061,846,580,518,61,1,568,12,930,350,367,201
40,"VÂLCEA","#N/A",173061,,362,"MILOSTEA / Şcoala cu clasele I-VIII Milostea",3,16419,"SLĂTIOARA",173061,664,445,378,67,0,440,5,730,285,269,171
40,"VÂLCEA","#N/A",173061,,363,"RUGETU / Şcoala cu clasele I-VIII Rugetu",3,16419,"SLĂTIOARA",173061,540,361,317,44,0,358,3,600,239,280,78
40,"VÂLCEA","#N/A",173061,,364,"GORUNEŞTI / Scoala Generala Goruneşti",3,16419,"SLĂTIOARA",173061,371,247,218,27,2,246,1,410,163,183,63
40,"VÂLCEA","#N/A",173061,,365,"SLĂTIOARA / GRĂDINIŢA Cumpene",3,16419,"SLĂTIOARA",173061,427,261,241,20,0,259,2,470,209,162,97
40,"VÂLCEA","#N/A",173132,,366,"STĂNEŞTI / Şcoala cu clasele I-VIII Stăneşti",3,16426,"STĂNEŞTI",173132,450,342,277,65,0,334,8,500,158,137,197
40,"VÂLCEA","#N/A",173132,,367,"VÎRLENI / Şcoala cu cls.I-IV Vârleni",3,16426,"STĂNEŞTI",173132,410,279,242,37,0,274,5,450,171,118,156
40,"VÂLCEA","#N/A",173132,,368,"LINIA DEALULUI / Şcoala cu clasele I-IV Linia Dealului",3,16426,"STĂNEŞTI",173132,142,122,97,25,0,120,2,160,38,69,51
40,"VÂLCEA","#N/A",173230,,369,"STOENEŞTI / Şcoala gimnazială Stoeneşti",3,16441,"STOENEŞTI",173230,933,640,561,79,0,636,4,1020,380,407,229
40,"VÂLCEA","#N/A",173230,,370,"BÎRLOGU / Şcoala Bârlogu",3,16441,"STOENEŞTI",173230,312,248,206,42,0,246,2,350,102,151,95
40,"VÂLCEA","#N/A",173230,,371,"DOBRICENI / Şcoala gimnazială Dobriceni",3,16441,"STOENEŞTI",173230,1069,725,657,68,0,719,6,1175,450,451,268
40,"VÂLCEA","#N/A",173230,,372,"PISCU MARE / Şcoala Piscu Mare",3,16441,"STOENEŞTI",173230,515,326,281,45,0,325,1,570,244,207,118
40,"VÂLCEA","#N/A",173230,,373,"ZMEURĂTU / Şcoala Zmeurăt",3,16441,"STOENEŞTI",173230,155,137,102,35,0,136,1,170,33,88,48
40,"VÂLCEA","#N/A",173374,,374,"URŞI / Şcoala cu clasele I-VIII Urşi",3,16455,"STOILEŞTI",173374,1217,765,704,57,4,758,7,1340,575,414,344
40,"VÂLCEA","#N/A",173374,,375,"STOILEŞTI / Şcoala cu clasele I-VIII Stoileşti",3,16455,"STOILEŞTI",173374,630,439,380,51,8,436,3,700,261,259,177
40,"VÂLCEA","#N/A",173374,,376,"GEAMĂNA / Şcoala cu clasele I-IV Geamăna",3,16455,"STOILEŞTI",173374,800,525,450,63,12,523,2,880,355,274,249
40,"VÂLCEA","#N/A",173374,,377,"BÎRSOIU / Şcoala cu clasele I-IV Bîrsoiu",3,16455,"STOILEŞTI",173374,564,381,321,60,0,379,2,620,239,206,173
40,"VÂLCEA","#N/A",173533,,378,"STROEŞTI / Şcoala cu clasele I-VIII Căpitan Mărăşanu Stroeşti",3,16471,"STROEŞTI",173533,755,467,428,38,1,462,5,830,363,281,181
40,"VÂLCEA","#N/A",173533,,379,"CIREŞU / Şcoala cu clasele I-VIII Cireşu",3,16471,"STROEŞTI",173533,668,428,381,47,0,422,6,730,302,238,184
40,"VÂLCEA","#N/A",173533,,380,"DIANU / Şcoala cu clasele I-VIII Dianu",3,16471,"STROEŞTI",173533,450,269,241,27,1,266,3,490,221,176,90
40,"VÂLCEA","#N/A",173533,,381,"OBROCEŞTI / Centrul Social Obroceşti",3,16471,"STROEŞTI",173533,298,172,155,17,0,170,2,330,158,109,61
40,"VÂLCEA","#N/A",173533,,382,"POJOGI-CERNA / Căminul Cultural Pojogi - Cerna",3,16471,"STROEŞTI",173533,212,166,131,35,0,165,1,240,74,81,84
40,"VÂLCEA","#N/A",173597,,383,"MĂZILI / Căminul cultural Suteşti",3,16483,"SUTEŞTI",173597,1426,804,718,85,1,790,14,1570,766,340,450
40,"VÂLCEA","#N/A",173597,,384,"VERDEA / Fosta Şcoala Verdea",3,16483,"SUTEŞTI",173597,454,301,252,49,0,298,3,500,199,187,111
40,"VÂLCEA","#N/A",173686,,385,"ŞIRINEASA / Şcoala gimnazială Şirineasa",3,16413,"ŞIRINEASA",173686,1220,766,684,82,0,757,9,1350,584,441,316
40,"VÂLCEA","#N/A",173686,,386,"CIORĂŞTI / Şcoala primară Ciorăşti",3,16413,"ŞIRINEASA",173686,483,326,294,31,1,321,5,530,204,209,112
40,"VÂLCEA","#N/A",173686,,387,"SLĂVITEŞTI / Şcoala primară Slăviteşti",3,16413,"ŞIRINEASA",173686,254,179,155,24,0,177,2,280,101,71,106
40,"VÂLCEA","#N/A",173748,,388,"ŞTEFĂNEŞTI / SC CLASELD I-VIII STEFANESTI",3,16436,"ŞTEFĂNEŞTI",173748,1021,661,580,73,8,657,4,1130,469,392,265
40,"VÂLCEA","#N/A",173748,,389,"ŞERBĂNEŞTI / GRADFINITA SERBANESTI",3,16436,"ŞTEFĂNEŞTI",173748,703,480,426,50,4,479,1,772,292,348,131
40,"VÂLCEA","#N/A",173748,,390,"DOBRUŞA / Şcoala generală cu cls.I-IV Dobruşa de jos",3,16436,"ŞTEFĂNEŞTI",173748,544,384,309,75,0,382,2,600,216,238,144
40,"VÂLCEA","#N/A",173748,,391,"DOBRUŞA / Grădiniţa Dobruşa de sus",3,16436,"ŞTEFĂNEŞTI",173748,539,378,343,31,4,374,4,594,216,284,90
40,"VÂLCEA","#N/A",173793,,392,"UŞUREI / Căminul Cultural Uşurei",3,16477,"ŞUŞANI",173793,479,340,280,60,0,338,2,523,183,234,104
40,"VÂLCEA","#N/A",173793,,393,"ŞUŞANI / SCOALA SUSANII DE SUS",3,16477,"ŞUŞANI",173793,539,371,302,69,0,368,3,590,219,218,150
40,"VÂLCEA","#N/A",173793,,394,"ŞUŞANI / Şcoala  Şuşani de jos",3,16477,"ŞUŞANI",173793,482,326,251,72,3,321,5,530,204,236,85
40,"VÂLCEA","#N/A",173793,,395,"STOICULEŞTI / Şcoala  Stoiculeşti",3,16477,"ŞUŞANI",173793,320,210,180,30,0,206,4,350,140,136,70
40,"VÂLCEA","#N/A",173793,,396,"RÎMEŞTI / Şcoala Râmeşti",3,16477,"ŞUŞANI",173793,898,580,469,111,0,572,8,1000,420,393,179
40,"VÂLCEA","#N/A",173855,,397,"BĂROIU / Şcoala cu clasele I-IV Băroiu",3,16488,"TETOIU",173855,320,239,209,30,0,237,2,350,111,174,63
40,"VÂLCEA","#N/A",173855,,398,"TETOIU / Căminul cultural Tetoiu",3,16488,"TETOIU",173855,571,375,300,75,0,368,7,630,255,227,141
40,"VÂLCEA","#N/A",173855,,399,"ŢEPEŞTI / Şcoala generală cu cls.I-VIII Ţepeşti",3,16488,"TETOIU",173855,738,502,412,87,3,498,4,820,318,244,254
40,"VÂLCEA","#N/A",173855,,400,"NENCIULEŞTI / Şcoala generală cu cls.I-IV Nenciuleşti",3,16488,"TETOIU",173855,306,212,160,45,7,210,2,340,128,91,119
40,"VÂLCEA","#N/A",173855,,401,"BUDELE / Scoala generală cu cls.I-IV Budele",3,16488,"TETOIU",173855,162,125,97,28,0,123,2,180,55,57,66
40,"VÂLCEA","#N/A",174496,,402,"TITEŞTI / Şcoala cu cls.I-VIII Titeşti (Sala de festivitati)",3,16496,"TITEŞTI",174496,514,400,312,56,32,396,4,558,158,116,280
40,"VÂLCEA","#N/A",174496,,403,"BRATOVEŞTI / Şcoala cu cls.I-IV Bratoveşti",3,16496,"TITEŞTI",174496,178,176,114,59,3,174,2,200,24,55,119
40,"VÂLCEA","#N/A",173935,,404,"TOMŞANI / Căminul Cultural Tomşani",3,16500,"TOMŞANI",173935,965,722,676,44,2,705,17,1060,338,432,273
40,"VÂLCEA","#N/A",173935,,405,"FOLEŞTII DE SUS / Şcoala generală Foleşti de sus",3,16500,"TOMŞANI",173935,967,637,571,65,1,632,5,1070,433,350,282
40,"VÂLCEA","#N/A",173935,,406,"DUMBRĂVEŞTI / Şcoala generală Foleşti de jos",3,16500,"TOMŞANI",173935,698,533,450,80,3,530,3,770,237,369,161
40,"VÂLCEA","#N/A",173935,,407,"BOGDĂNEŞTI / CĂMIN CULTURAL",3,16500,"TOMŞANI",173935,608,485,444,40,1,485,0,661,176,302,183
40,"VÂLCEA","#N/A",174021,,408,"VAIDEENI / Căminul cultural Vaideeni",3,16509,"VAIDEENI",174021,950,604,543,58,3,598,6,1050,446,294,304
40,"VÂLCEA","#N/A",174021,,409,"VAIDEENI / Căminul cultural Vaideeni",3,16509,"VAIDEENI",174021,1222,821,753,57,11,805,16,1350,529,456,349
40,"VÂLCEA","#N/A",174021,,410,"IZVORU RECE / Căminul cultural Izvoru Rece",3,16509,"VAIDEENI",174021,680,466,415,42,9,464,2,750,284,278,186
40,"VÂLCEA","#N/A",174021,,411,"MARIŢA / Căminul cultural Mariţa",3,16509,"VAIDEENI",174021,505,328,278,46,4,327,1,560,232,199,128
40,"VÂLCEA","#N/A",174085,,412,"DELURENI / Şcoala cu clasele I-IV Delureni",3,16515,"VALEA MARE",174085,439,288,235,53,0,285,3,480,192,149,136
40,"VÂLCEA","#N/A",174085,,413,"VALEA MARE / Grădiniţa Valea Mare",3,16515,"VALEA MARE",174085,558,333,304,29,0,328,5,610,277,195,133
40,"VÂLCEA","#N/A",174085,,414,"BĂTĂŞANI / Şcoala cu cls.I-VIII Bătăşani",3,16515,"VALEA MARE",174085,434,284,251,33,0,281,3,480,196,153,128
40,"VÂLCEA","#N/A",174085,,415,"MĂRGINENI / Şcoala Mărgineni",3,16515,"VALEA MARE",174085,350,215,182,33,0,214,1,380,165,119,95
40,"VÂLCEA","#N/A",174085,,416,"DRĂGANU / Căminul cultural Drăgani",3,16515,"VALEA MARE",174085,467,331,270,61,0,328,3,510,179,221,107
40,"VÂLCEA","#N/A",174156,,417,"VLĂDEŞTI / Şcoala cu clasele I-VIII Vlădeşti",3,16522,"VLĂDEŞTI",174156,1453,1061,965,81,15,1048,13,1600,539,523,525
40,"VÂLCEA","#N/A",174156,,418,"PRIPORU / Şcoala cu clasele I-VIII Vlădeşti",3,16522,"VLĂDEŞTI",174156,1053,787,691,94,2,782,5,1163,376,372,410
40,"VÂLCEA","#N/A",174218,,419,"VOICEŞTI / Căminul cultural Voiceşti",3,16528,"VOICEŞTI",174218,1301,990,865,98,27,976,14,1427,437,640,336
40,"VÂLCEA","#N/A",174254,,420,"VOINEASA / Localul primăriei Voineasa",3,16532,"VOINEASA",174254,719,509,438,71,0,505,4,790,281,187,318
40,"VÂLCEA","#N/A",174254,,421,"VOINEŞIŢA / Şcoala cu clasele I-VIII Voineasa",3,16532,"VOINEASA",174254,694,462,415,47,0,458,4,762,300,182,276
40,"VÂLCEA","#N/A",174290,,422,"ZĂTRENI / Şcoala gimnazială Zătreni",3,16536,"ZĂTRENI",174290,579,363,318,45,0,355,8,640,277,183,172
40,"VÂLCEA","#N/A",174290,,423,"STANOMIRU / Şcoala primară Stanomiru",3,16536,"ZĂTRENI",174290,397,258,225,33,0,254,4,440,182,151,103
40,"VÂLCEA","#N/A",174290,,424,"VĂLENI / Şcoala primară Văleni",3,16536,"ZĂTRENI",174290,392,253,205,48,0,248,5,430,177,152,96
40,"VÂLCEA","#N/A",174290,,425,"DEALU VĂLENI / Şcoala Dealul Văleni",3,16536,"ZĂTRENI",174290,266,195,133,62,0,194,1,290,95,126,68
40,"VÂLCEA","#N/A",174290,,426,"SĂŞCIOARA / Şcoala primară Săscioara",3,16536,"ZĂTRENI",174290,352,257,196,61,0,250,7,390,133,128,122
41,"VRANCEA",396,174744,,1,"FOCŞANI / Directia Silvică Vrancea",1,16552,"MUNICIPIUL FOCŞANI",174744,1492,842,766,76,0,826,16,1650,808,372,454
41,"VRANCEA",396,174744,,2,"FOCŞANI / Teatrul Municipal Focşani",1,16552,"MUNICIPIUL FOCŞANI",174744,1647,1087,978,108,1,1073,14,1800,713,404,669
41,"VRANCEA",396,174744,,3,"FOCŞANI / Biblioteca Judeţeană ""Duiliu Zamfirescu""",1,16552,"MUNICIPIUL FOCŞANI",174744,1594,1032,957,74,1,1016,16,1760,728,453,563
41,"VRANCEA",396,174744,,4,"FOCŞANI / Biblioteca Judeţeană ""Duiliu Zamfirescu""",1,16552,"MUNICIPIUL FOCŞANI",174744,1267,734,681,53,0,723,11,1400,666,328,395
41,"VRANCEA",396,174744,,5,"FOCŞANI / Şcoala ""Ştefan cel Mare"" - intrarea principală",1,16552,"MUNICIPIUL FOCŞANI",174744,1188,732,621,111,0,726,6,1300,568,330,396
41,"VRANCEA",396,174744,,6,"FOCŞANI / Şcoala ""Ştefan cel Mare"" - intrarea elevilor",1,16552,"MUNICIPIUL FOCŞANI",174744,1306,771,720,50,1,761,10,1450,679,341,420
41,"VRANCEA",396,174744,,7,"FOCŞANI / Şcoala ""Ştefan cel Mare"" - intrarea secundara",1,16552,"MUNICIPIUL FOCŞANI",174744,901,605,529,76,0,596,9,1000,395,256,340
41,"VRANCEA",396,174744,,8,"FOCŞANI / Colegiul ""Tehnic Traian Vuia""",1,16552,"MUNICIPIUL FOCŞANI",174744,605,410,374,36,0,400,10,700,290,164,236
41,"VRANCEA",396,174744,,9,"FOCŞANI / Colegiul ""Tehnic Traian Vuia""",1,16552,"MUNICIPIUL FOCŞANI",174744,1028,590,551,39,0,587,3,1130,540,270,317
41,"VRANCEA",396,174744,,10,"FOCŞANI / Colegiul Economic Mihail Kogalniceanu Focsani",1,16552,"MUNICIPIUL FOCŞANI",174744,1779,1085,976,109,0,1075,10,1960,875,408,667
41,"VRANCEA",396,174744,,11,"FOCŞANI / Colegiul Economic Mihail Kogalniceanu Focsani",1,16552,"MUNICIPIUL FOCŞANI",174744,1687,1004,888,116,0,990,14,1850,846,388,602
41,"VRANCEA",396,174744,,12,"FOCŞANI / Colegiul Economic ""Mihail Kogălniceanu""",1,16552,"MUNICIPIUL FOCŞANI",174744,1674,969,919,50,0,944,25,1850,881,474,470
41,"VRANCEA",396,174744,,13,"FOCŞANI / Colegiul Economic ""Mihail Kogălniceanu""",1,16552,"MUNICIPIUL FOCŞANI",174744,1732,936,893,43,0,923,13,1900,964,421,502
41,"VRANCEA",396,174744,,14,"FOCŞANI / Şcoala Gimnazială nr. 7",1,16552,"MUNICIPIUL FOCŞANI",174744,1352,792,706,86,0,783,9,1500,708,405,378
41,"VRANCEA",396,174744,,15,"FOCŞANI / Grădiniţa nr. 15",1,16552,"MUNICIPIUL FOCŞANI",174744,1019,573,525,44,4,561,12,1120,547,262,299
41,"VRANCEA",396,174744,,16,"FOCŞANI / Grădiniţa nr. 15",1,16552,"MUNICIPIUL FOCŞANI",174744,1775,1049,990,57,2,1029,20,1960,911,465,564
41,"VRANCEA",396,174744,,17,"FOCŞANI / Liceul Tehnologic ""G.G.Longinescu""",1,16552,"MUNICIPIUL FOCŞANI",174744,1971,1191,1065,126,0,1173,18,2170,979,498,675
41,"VRANCEA",396,174744,,18,"FOCŞANI / Şcoala Gimnazială ""Ion Basgan""",1,16552,"MUNICIPIUL FOCŞANI",174744,1857,1117,968,149,0,1108,9,2040,923,421,687
41,"VRANCEA",396,174744,,19,"FOCŞANI / Ocolul Silvic",1,16552,"MUNICIPIUL FOCŞANI",174744,1498,831,767,64,0,818,13,1660,829,315,503
41,"VRANCEA",396,174744,,20,"FOCŞANI / Colegiul Tehnic ""Valeriu D. Cotea""",1,16552,"MUNICIPIUL FOCŞANI",174744,1226,917,631,108,178,907,10,1350,433,428,479
41,"VRANCEA",396,174744,,21,"FOCŞANI / Colegiul Naţional ""Al. I. Cuza""",1,16552,"MUNICIPIUL FOCŞANI",174744,870,568,454,68,46,557,11,1000,432,191,366
41,"VRANCEA",396,174744,,22,"FOCŞANI / Şcoala Gimnazială ""Anghel Saligny""",1,16552,"MUNICIPIUL FOCŞANI",174744,1304,745,715,29,1,726,19,1440,695,304,422
41,"VRANCEA",396,174744,,23,"FOCŞANI / Scoala Anghel Saligny (Scoala nr, 5) intrarea secundara",1,16552,"MUNICIPIUL FOCŞANI",174744,1859,965,874,91,0,954,11,2050,1085,466,488
41,"VRANCEA",396,174744,,24,"MÎNDREŞTI-MUNTENI / Consiliul local al municipiului Focşani",1,16552,"MUNICIPIUL FOCŞANI",174744,1358,1066,705,29,332,1048,18,1499,433,659,389
41,"VRANCEA",396,174744,,25,"FOCŞANI / Agenţia Naţională de Îmbunăăţiri Funciare",1,16552,"MUNICIPIUL FOCŞANI",174744,1099,571,539,32,0,566,5,1200,629,233,333
41,"VRANCEA",396,174744,,26,"FOCŞANI / Grădiniţa nr. 16",1,16552,"MUNICIPIUL FOCŞANI",174744,1421,760,673,87,0,747,13,1570,810,335,412
41,"VRANCEA",396,174744,,27,"FOCŞANI / Grădiniţa nr. 16",1,16552,"MUNICIPIUL FOCŞANI",174744,1771,899,834,64,1,886,13,1950,1051,450,436
41,"VRANCEA",396,174744,,28,"FOCŞANI / Colegiul Naţional ""Unirea""",1,16552,"MUNICIPIUL FOCŞANI",174744,1248,691,568,79,44,687,4,1380,689,311,376
41,"VRANCEA",396,174744,,29,"FOCŞANI / Şcoala  Gimnazială nr. 3",1,16552,"MUNICIPIUL FOCŞANI",174744,1270,731,651,80,0,720,11,1400,669,320,400
41,"VRANCEA",396,174744,,30,"FOCŞANI / Agenţia Judeţeană pentru Plăţi şi Inspecţie Socială",1,16552,"MUNICIPIUL FOCŞANI",174744,1563,857,760,97,0,840,17,1700,843,398,442
41,"VRANCEA",396,174744,,31,"FOCŞANI / Colegiul Tehnic ""Edmond Nicolau""",1,16552,"MUNICIPIUL FOCŞANI",174744,1214,741,656,85,0,729,12,1340,599,296,433
41,"VRANCEA",396,174744,,32,"FOCŞANI / Sala Sporturilor",1,16552,"MUNICIPIUL FOCŞANI",174744,1313,760,702,58,0,742,18,1450,690,342,400
41,"VRANCEA",396,174744,,33,"FOCŞANI / Inspectoratul teritorial de Muncă Vrancea",1,16552,"MUNICIPIUL FOCŞANI",174744,1406,845,765,78,2,830,15,1550,705,324,506
41,"VRANCEA",396,174744,,34,"FOCŞANI / Direcţia Judeţeană a Sporturilor Vrancea",1,16552,"MUNICIPIUL FOCŞANI",174744,1610,848,786,62,0,830,18,1780,932,427,403
41,"VRANCEA",396,174744,,35,"FOCŞANI / Centrul Medical Focşani",1,16552,"MUNICIPIUL FOCŞANI",174744,1030,623,554,67,2,616,7,1130,507,264,352
41,"VRANCEA",396,174744,,36,"FOCŞANI / Şcoala Gimnazială ""Duiliu Zamfirescu""",1,16552,"MUNICIPIUL FOCŞANI",174744,973,533,454,79,0,528,5,1070,537,218,310
41,"VRANCEA",396,174744,,37,"FOCŞANI / Şcoala Gimnazială ""Duiliu Zamfirescu""",1,16552,"MUNICIPIUL FOCŞANI",174744,1509,867,777,90,0,850,17,1660,793,368,482
41,"VRANCEA",396,174744,,38,"FOCŞANI / Şcoala Gimnazială ""Duiliu Zamfirescu""",1,16552,"MUNICIPIUL FOCŞANI",174744,1711,972,902,70,0,954,18,1900,928,406,548
41,"VRANCEA",396,174744,,39,"FOCŞANI / Liceul Pedagogic ""Spiru Haret""",1,16552,"MUNICIPIUL FOCŞANI",174744,1673,968,918,50,0,953,15,1840,872,407,546
41,"VRANCEA",396,174744,,40,"FOCŞANI / SC FEDERAL COOP SA",1,16552,"MUNICIPIUL FOCŞANI",174744,1633,970,882,87,1,950,20,1800,830,414,536
41,"VRANCEA",396,174744,,41,"FOCŞANI / Grădiniţa nr. 18",1,16552,"MUNICIPIUL FOCŞANI",174744,1090,681,616,65,0,667,14,1200,519,265,402
41,"VRANCEA",396,174744,,42,"FOCŞANI / Colegiul Tehnic ""Ion Mincu""",1,16552,"MUNICIPIUL FOCŞANI",174744,946,505,457,48,0,494,11,1040,535,202,292
41,"VRANCEA",396,174744,,43,"FOCŞANI / Şcoala Gimnazială ""Alexandru Vlahuţă""",1,16552,"MUNICIPIUL FOCŞANI",174744,1530,821,696,125,0,805,16,1700,879,377,428
41,"VRANCEA",396,174744,,44,"FOCŞANI / Şcoala Gimnazială ""Alexandru Vlahuţă""",1,16552,"MUNICIPIUL FOCŞANI",174744,1568,907,794,112,1,894,13,1730,823,461,433
41,"VRANCEA",396,174744,,45,"FOCŞANI / Şcoala Gimnazială ""Alexandru Vlahuţă""",1,16552,"MUNICIPIUL FOCŞANI",174744,1525,756,712,44,0,749,7,1670,914,391,358
41,"VRANCEA",396,174744,,46,"FOCŞANI / Şcoala Gimnazială ""Alexandru Vlahuţă""",1,16552,"MUNICIPIUL FOCŞANI",174744,946,464,443,21,0,459,5,1040,576,210,249
41,"VRANCEA",396,174744,,47,"FOCŞANI / Şcoala Gimnazială ""Alexandru Vlahuţă""",1,16552,"MUNICIPIUL FOCŞANI",174744,1542,809,770,39,0,798,11,1700,891,421,377
41,"VRANCEA",396,174744,,48,"FOCŞANI / Şcoala Gimnazială ""Alexandru Vlahuţă""",1,16552,"MUNICIPIUL FOCŞANI",174744,953,519,495,24,0,512,7,1050,531,237,275
41,"VRANCEA",396,174744,,49,"FOCŞANI / Grădiniţa nr. 13",1,16552,"MUNICIPIUL FOCŞANI",174744,1721,944,864,80,0,925,19,1897,953,422,503
41,"VRANCEA",396,174744,,50,"FOCŞANI / Grădiniţa nr. 13",1,16552,"MUNICIPIUL FOCŞANI",174744,1888,1101,1040,61,0,1076,25,2073,972,502,574
41,"VRANCEA",396,174744,,51,"FOCŞANI / Grădiniţa nr. 1",1,16552,"MUNICIPIUL FOCŞANI",174744,926,568,505,61,2,557,11,1000,432,260,297
41,"VRANCEA",396,174744,,52,"FOCŞANI / Universitatea ""George Bariţiu"" - Centrul de studii Focşani",1,16552,"MUNICIPIUL FOCŞANI",174744,996,794,712,82,0,784,10,1100,306,334,450
41,"VRANCEA",396,174744,,53,"FOCŞANI / Direcţia Sanitar-Veterinară",1,16552,"MUNICIPIUL FOCŞANI",174744,1731,1330,968,57,305,1305,25,1900,570,720,585
41,"VRANCEA",396,174744,,54,"FOCŞANI / Grădiniţa nr. 8",1,16552,"MUNICIPIUL FOCŞANI",174744,980,548,507,41,0,538,10,1077,529,237,301
41,"VRANCEA",396,174744,,55,"FOCŞANI / Grădiniţa nr. 4",1,16552,"MUNICIPIUL FOCŞANI",174744,1823,961,903,58,0,945,16,2000,1039,417,528
41,"VRANCEA",396,174744,,56,"FOCŞANI / Scoala Gimnaziala Alexandru Vlahuta",1,16552,"MUNICIPIUL FOCŞANI",174744,1709,859,823,34,2,846,13,1880,1021,461,385
41,"VRANCEA",396,174744,,57,"FOCŞANI / Grădiniţa nr. 17",1,16552,"MUNICIPIUL FOCŞANI",174744,1173,659,601,56,2,650,9,1292,633,327,323
41,"VRANCEA",396,174744,,58,"FOCŞANI / Şcoala Gimnazială nr. 3",1,16552,"MUNICIPIUL FOCŞANI",174744,776,388,367,20,1,378,10,850,462,196,182
41,"VRANCEA",396,174860,,59,"ADJUD / CASA DE CULTURĂ ""TUDOR VORNICU""",1,16556,"MUNICIPIUL ADJUD",174860,1044,612,490,48,74,605,7,1150,538,314,291
41,"VRANCEA",396,174860,,60,"ADJUD / SCOALĂ GIMNAZIALĂ ""MIHAIL ARMENCEA""",1,16556,"MUNICIPIUL ADJUD",174860,1135,617,583,34,0,611,6,1250,633,275,336
41,"VRANCEA",396,174860,,61,"ADJUD / SCOALĂ GIMNAZIALĂ ""MAREŞAL ALEXANDRU AVERESCU""",1,16556,"MUNICIPIUL ADJUD",174860,1291,548,511,37,0,534,14,1430,882,350,184
41,"VRANCEA",396,174860,,62,"ADJUD / SCOALĂ GIMNAZIALĂ ""PRINCIPELE RADU""  A",1,16556,"MUNICIPIUL ADJUD",174860,1345,635,609,26,0,625,10,1480,845,287,338
41,"VRANCEA",396,174860,,63,"ADJUD / SCOALĂ GIMNAZIALĂ ""PRINCIPELE RADU"" B",1,16556,"MUNICIPIUL ADJUD",174860,1367,662,641,21,0,640,22,1500,838,308,332
41,"VRANCEA",396,174860,,64,"ADJUD / SCOALĂ GIMNAZIALĂ ""PRINCIPELE RADU"" C",1,16556,"MUNICIPIUL ADJUD",174860,1368,623,593,30,0,609,14,1500,877,286,323
41,"VRANCEA",396,174860,,65,"ADJUD / STAŢIA CFR ADJUD",1,16556,"MUNICIPIUL ADJUD",174860,1583,780,703,77,0,770,10,1740,960,370,400
41,"VRANCEA",396,174860,,66,"ADJUD / CRSA",1,16556,"MUNICIPIUL ADJUD",174860,1236,642,603,39,0,636,6,1350,708,329,307
41,"VRANCEA",396,174860,,67,"ADJUD / SCOALĂ GIMNAZIALĂ ""ANGELA GHEORGHIU""",1,16556,"MUNICIPIUL ADJUD",174860,1625,926,798,127,1,911,15,1790,864,425,486
41,"VRANCEA",396,174860,,68,"ADJUD / COLEGIUL TEHNIC ""GHEORGHE BALŞ"" A",1,16556,"MUNICIPIUL ADJUD",174860,1283,691,634,57,0,680,11,1400,709,377,303
41,"VRANCEA",396,174860,,69,"ADJUD / COLEGIUL TEHNIC ""GHEORGHE BALŞ"" B",1,16556,"MUNICIPIUL ADJUD",174860,975,481,449,32,0,473,8,1070,589,230,243
41,"VRANCEA",396,174860,,70,"BURCIOAIA / SCOALĂ PRIMARA BURCIOAIA",1,16556,"MUNICIPIUL ADJUD",174860,453,246,223,23,0,241,5,500,254,146,95
41,"VRANCEA",396,174860,,71,"ŞIŞCANI / SCOALĂ PRIMARA SISCANI",1,16556,"MUNICIPIUL ADJUD",174860,675,327,312,15,0,322,5,740,413,206,116
41,"VRANCEA",396,174860,,72,"ADJUDU VECHI / SCOALĂ GENERALA ADJUDU VECHI",1,16556,"MUNICIPIUL ADJUD",174860,1393,742,712,30,0,730,12,1540,798,440,290
41,"VRANCEA",396,174922,,73,"MĂRĂŞEŞTI / SCOALA GENERALA NR.1",1,16561,"ORAŞ MĂRĂŞEŞTI",174922,1419,887,832,40,15,875,12,1560,673,561,314
41,"VRANCEA",396,174922,,74,"MĂRĂŞEŞTI / SCOALA GENERALA NR.3",1,16561,"ORAŞ MĂRĂŞEŞTI",174922,1464,773,755,16,2,754,19,1600,827,631,123
41,"VRANCEA",396,174922,,75,"MĂRĂŞEŞTI / CLUBUL ELEVILOR",1,16561,"ORAŞ MĂRĂŞEŞTI",174922,795,443,410,28,5,433,10,880,437,263,170
41,"VRANCEA",396,174922,,76,"MĂRĂŞEŞTI / CASA DE CULTURĂ",1,16561,"ORAŞ MĂRĂŞEŞTI",174922,1728,869,815,47,7,852,17,1900,1031,486,366
41,"VRANCEA",396,174922,,77,"MĂRĂŞEŞTI / GRUP ŞCOLAR INDUSTRIAL",1,16561,"ORAŞ MĂRĂŞEŞTI",174922,1451,831,760,66,5,807,24,1600,769,455,352
41,"VRANCEA",396,174922,,78,"MĂRĂŞEŞTI / SCOALA GENERALA NR.2",1,16561,"ORAŞ MĂRĂŞEŞTI",174922,1181,610,582,27,1,603,7,1300,690,309,294
41,"VRANCEA",396,174922,,79,"MĂRĂŞEŞTI / STATIE CFR MARASESTI",1,16561,"ORAŞ MĂRĂŞEŞTI",174922,308,193,130,62,1,191,2,340,147,101,90
41,"VRANCEA",396,174922,,80,"HARET / SCOALA GENERALA HARET",1,16561,"ORAŞ MĂRĂŞEŞTI",174922,485,294,255,33,6,293,1,540,246,193,100
41,"VRANCEA",396,174922,,81,"PĂDURENI / SCOALA GENERALA PADURENI",1,16561,"ORAŞ MĂRĂŞEŞTI",174922,442,381,344,37,0,343,38,490,109,265,78
41,"VRANCEA",396,174922,,82,"CĂLIMĂNEŞTI / SCOALA GENERALA CĂLIMĂNEŞTI",1,16561,"ORAŞ MĂRĂŞEŞTI",174922,429,294,247,44,3,293,1,470,176,210,83
41,"VRANCEA",396,174922,,83,"TIŞIŢA / SCOALA GENERALA DOAGA",1,16561,"ORAŞ MĂRĂŞEŞTI",174922,220,119,103,16,0,119,0,240,121,60,59
41,"VRANCEA",396,175019,,84,"ODOBEŞTI / BIBLIOTECA ORASENEASCA     ""ANA GEORGESCU""",1,16569,"ORAŞ ODOBEŞTI",175019,1643,1030,924,89,17,1018,12,1800,770,598,420
41,"VRANCEA",396,175019,,85,"ODOBEŞTI / LICEUL TEORETIC      ""DUILIU ZAMFIRESCU""     ODOBESTI",1,16569,"ORAŞ ODOBEŞTI",175019,1672,1126,892,225,9,1079,47,1840,714,626,453
41,"VRANCEA",396,175019,,86,"ODOBEŞTI / GRUPUL SCOLAR AGRICOL ODOBESTI",1,16569,"ORAŞ ODOBEŞTI",175019,1617,1007,935,70,2,995,12,1780,773,579,416
41,"VRANCEA",396,175019,,87,"ODOBEŞTI / GRADINITA NR.2        CARAGEA",1,16569,"ORAŞ ODOBEŞTI",175019,963,551,516,33,2,540,11,1060,509,278,262
41,"VRANCEA",396,175019,,88,"UNIREA / GRADINITA NR.5",1,16569,"ORAŞ ODOBEŞTI",175019,704,385,337,48,0,382,3,770,385,255,127
41,"VRANCEA",396,175019,,89,"UNIREA / SCOALA GENERALA UNIREA",1,16569,"ORAŞ ODOBEŞTI",175019,1240,731,672,59,0,722,9,1370,639,389,333
41,"VRANCEA",396,175055,,90,"PANCIU / CASA DE CULTURA A ORASULUI PANCIU",1,16572,"ORAŞ PANCIU",175055,1412,740,660,78,2,734,6,1560,820,368,366
41,"VRANCEA",396,175055,,91,"PANCIU / SCOALA GENERALA NR. 1",1,16572,"ORAŞ PANCIU",175055,1288,824,674,141,9,807,17,1420,596,430,377
41,"VRANCEA",396,175055,,92,"PANCIU / FOSTUL SEDIU BANCPOST",1,16572,"ORAŞ PANCIU",175055,1059,543,502,39,2,536,7,1180,637,234,302
41,"VRANCEA",396,175055,,93,"PANCIU / SPITALUL ORASENESC",1,16572,"ORAŞ PANCIU",175055,1212,665,584,81,0,661,4,1330,665,299,362
41,"VRANCEA",396,175055,,94,"SATU NOU / SCOALA GENERALA SATU-NOU",1,16572,"ORAŞ PANCIU",175055,852,537,473,49,15,529,8,940,403,264,265
41,"VRANCEA",396,175055,,95,"CRUCEA DE JOS / CLUBUL DE SOCIALIZARE CRUCEA DE JOS",1,16572,"ORAŞ PANCIU",175055,400,279,242,35,2,273,6,440,161,161,112
41,"VRANCEA",396,175055,,96,"DUMBRAVA / SCOALA GENERALA DUMBRAVA",1,16572,"ORAŞ PANCIU",175055,418,246,215,16,15,240,6,460,214,140,100
41,"VRANCEA",396,175055,,97,"CRUCEA DE SUS / SCOALA GENERALA CUCEA DE SUS",1,16572,"ORAŞ PANCIU",175055,724,468,403,62,3,463,5,800,332,256,207
41,"VRANCEA",396,175055,,98,"NEICU / CAMINUL CULTURAL NEICU",1,16572,"ORAŞ PANCIU",175055,547,366,327,26,13,364,2,600,234,217,147
41,"VRANCEA",396,175126,,99,"ANDREIAŞU DE JOS / SCOALA ANDREIASU DE JOS",3,16579,"ANDREIAŞU DE JOS",175126,525,342,288,44,10,339,3,580,238,184,155
41,"VRANCEA",396,175126,,100,"RĂCHITAŞU / SCOALA RACHITASU",3,16579,"ANDREIAŞU DE JOS",175126,579,373,330,32,11,370,3,640,267,232,138
41,"VRANCEA",396,175126,,101,"ANDREIAŞU DE SUS / SCOALA ANDREIASU DE SUS",3,16579,"ANDREIAŞU DE JOS",175126,405,247,219,20,8,238,9,448,201,103,135
41,"VRANCEA",396,175206,,102,"BĂLEŞTI / Scoala generala cu clasele I-VIII BALESTI",3,16587,"BĂLEŞTI",175206,917,556,478,67,11,550,6,1000,444,361,189
41,"VRANCEA",396,175206,,103,"BĂLEŞTI / Scoala generala cu clasele I-VIII BALESTI",3,16587,"BĂLEŞTI",175206,749,475,420,40,15,465,10,820,345,307,158
41,"VRANCEA",396,175224,,104,"BÂRSEŞTI / Camin cultural(sala festivitati)",3,16589,"BÂRSEŞTI",175224,1209,802,717,51,34,789,13,1330,528,439,350
41,"VRANCEA",396,178929,,105,"BILIEŞTI / Scoala Gimnaziala Biliesti",3,16592,"BILIEŞTI",178929,1037,618,533,85,0,606,12,1140,522,253,353
41,"VRANCEA",396,178929,,106,"BILIEŞTI / Scoala Generala nr. 2 Biliesti",3,16592,"BILIEŞTI",178929,1043,551,497,54,0,543,8,1150,599,222,321
41,"VRANCEA",396,175260,,107,"BOGHEŞTI / PRIMARIE",3,16594,"BOGHEŞTI",175260,687,450,362,69,19,445,5,760,310,297,148
41,"VRANCEA",396,175260,,108,"PRISECANI / SCOALA",3,16594,"BOGHEŞTI",175260,465,358,264,76,18,357,1,496,138,280,77
41,"VRANCEA",396,175260,,109,"IUGANI / Scoala Iugani",3,16594,"BOGHEŞTI",175260,144,123,85,35,3,121,2,160,37,103,18
41,"VRANCEA",396,175368,,110,"BOLOTEŞTI / CAMINUL CULTURAL BOLOTESTI",3,16604,"BOLOTEŞTI",175368,628,421,344,66,11,418,3,700,279,226,192
41,"VRANCEA",396,175368,,111,"PUTNA / SCOALA GIMNAZIALA PUTNA",3,16604,"BOLOTEŞTI",175368,524,367,315,40,12,363,4,580,213,204,159
41,"VRANCEA",396,175368,,112,"IVĂNCEŞTI / SCOALA CU CL. I - IV IVANCESTI",3,16604,"BOLOTEŞTI",175368,363,200,157,41,2,197,3,400,200,111,86
41,"VRANCEA",396,175368,,113,"GĂGEŞTI / SCOALA GIMNAZIALA GAGESTI",3,16604,"BOLOTEŞTI",175368,1274,758,660,54,44,738,20,1400,642,441,297
41,"VRANCEA",396,175368,,114,"GĂGEŞTI / SCOALA GIMNAZIALA GAGESTI",3,16604,"BOLOTEŞTI",175368,484,316,271,43,2,307,9,540,224,162,145
41,"VRANCEA",396,175368,,115,"VITĂNEŞTII DE SUB MĂGURĂ / SCOALA CU CLASELE I - IV VITANESTII DE SUB MAGURA",3,16604,"BOLOTEŞTI",175368,604,354,309,45,0,346,8,671,317,196,150
41,"VRANCEA",396,175439,,116,"BORDEŞTI / CAMINUL CULTURAL",3,16611,"BORDEŞTI",175439,1037,673,584,43,46,664,9,1140,467,377,287
41,"VRANCEA",396,175439,,117,"BORDEŞTII DE JOS / SCOALA CU CLASELE I-IV",3,16611,"BORDEŞTI",175439,425,318,260,48,10,314,4,470,152,190,124
41,"VRANCEA",396,175466,,118,"BROŞTENI / CAMIN CULTURAL",3,16614,"BROŞTENI",175466,1311,775,710,64,1,768,7,1460,685,451,317
41,"VRANCEA",396,175466,,119,"ARVA / GRADINITA",3,16614,"BROŞTENI",175466,494,317,292,25,0,310,7,530,213,162,148
41,"VRANCEA",396,175509,,120,"CHIOJDENI / GRĂDINIŢA CU PROGRAM NORMAL CHIOJDENI",3,16618,"CHIOJDENI",175509,791,505,458,47,0,502,3,870,365,262,240
41,"VRANCEA",396,175509,,121,"CĂTĂUŢI / ŞCOALA PRIMARĂ CĂTĂUŢI",3,16618,"CHIOJDENI",175509,328,193,167,26,0,186,7,360,167,113,73
41,"VRANCEA",396,175509,,122,"LUNCILE / ŞCOALA PRIMARĂ LUNCILE",3,16618,"CHIOJDENI",175509,690,504,478,26,0,491,13,760,256,217,274
41,"VRANCEA",396,175590,,123,"CIORĂŞTI / CAMIN CULTURAL CIORASTI",3,16637,"CIORĂŞTI",175590,785,514,430,77,7,506,8,860,346,232,274
41,"VRANCEA",396,175590,,124,"CODREŞTI / MAGAZIN SC SAND VAD SRL",3,16637,"CIORĂŞTI",175590,206,149,111,32,6,149,0,230,81,62,87
41,"VRANCEA",396,175590,,125,"MIHĂLCENI / SCOALA CU CLASELE I-IV",3,16637,"CIORĂŞTI",175590,634,441,352,79,10,434,7,700,259,194,240
41,"VRANCEA",396,175590,,126,"SALCIA NOUĂ / CAMIN CULTURAL SAT SALCIA NOUA",3,16637,"CIORĂŞTI",175590,364,293,220,62,11,291,2,400,107,103,188
41,"VRANCEA",396,175590,,127,"SALCIA VECHE / SCOALA SALCIA VECHE",3,16637,"CIORĂŞTI",175590,252,236,173,52,11,235,1,281,45,103,132
41,"VRANCEA",396,175590,,128,"SATU NOU / SCOALA SATU NOU",3,16637,"CIORĂŞTI",175590,221,158,144,14,0,154,4,250,92,66,88
41,"VRANCEA",396,175590,,129,"SPĂTĂREASA / SC OVION COM SERV SRL",3,16637,"CIORĂŞTI",175590,189,159,118,36,5,158,1,200,41,80,78
41,"VRANCEA",396,174780,,130,"CÎMPINEANCA / SCOALA PRIMARA CAMPINEANCA",3,16627,"CÎMPINEANCA",174780,1718,1067,963,102,2,1054,13,1880,813,498,556
41,"VRANCEA",396,174780,,131,"CÎMPINEANCA / SCOALA PRIMARA CAMPINEANCA",3,16627,"CÎMPINEANCA",174780,1554,944,883,60,1,933,11,1700,756,433,500
41,"VRANCEA",396,175670,,132,"CÎMPURI / SCOALA PRIMARA CÎMPURI",3,16631,"CÎMPURI",175670,825,506,442,36,28,501,5,900,394,303,198
41,"VRANCEA",396,175670,,133,"CÎMPURI / ŞCOALA GIMNAZIALA CÎMPURI",3,16631,"CÎMPURI",175670,974,587,488,50,49,580,7,1080,493,340,240
41,"VRANCEA",396,175670,,134,"ROTILEŞTII MICI / SCOALA GIMNAZIALA ROTILESTII MICI",3,16631,"CÎMPURI",175670,533,320,274,29,17,317,3,590,270,225,92
41,"VRANCEA",396,175670,,135,"FETEŞTI / SCOALA PRIMARA FETESTI",3,16631,"CÎMPURI",175670,764,416,347,40,29,412,4,850,434,275,137
41,"VRANCEA",396,175732,,136,"CÎRLIGELE / CĂMIN CULTURAL",3,16645,"CÎRLIGELE",175732,1036,636,512,82,42,630,6,1150,514,469,161
41,"VRANCEA",396,175732,,137,"BLIDARI / SCOALA BLIDARI",3,16645,"CÎRLIGELE",175732,472,303,242,47,14,301,2,520,217,190,111
41,"VRANCEA",396,175732,,138,"BONŢEŞTI / GRADINITA",3,16645,"CÎRLIGELE",175732,371,264,196,41,27,260,4,400,136,199,61
41,"VRANCEA",396,175732,,139,"DĂLHĂUŢI / GRĂDINIŢĂ",3,16645,"CÎRLIGELE",175732,562,381,295,61,25,377,4,620,239,286,91
41,"VRANCEA",396,175787,,140,"ŞERBĂNEŞTI / PRIMARIE",3,16650,"CORBIŢA",175787,364,244,198,40,6,243,1,400,156,203,40
41,"VRANCEA",396,175787,,141,"BUDA / Şcoala Primară Buda",3,16650,"CORBIŢA",175787,442,285,243,35,7,282,3,490,205,195,87
41,"VRANCEA",396,175787,,142,"RĂDĂCINEŞTI / SCOALA RADACINESTI",3,16650,"CORBIŢA",175787,366,256,196,57,3,256,0,400,144,214,42
41,"VRANCEA",396,175787,,143,"OCHEŞEŞTI / SCOALA OCHEŞEŞTI",3,16650,"CORBIŢA",175787,298,209,180,21,8,206,3,330,121,131,75
41,"VRANCEA",396,175885,,144,"COTEŞTI / SCOALA  GENERALA COTESTI",3,16660,"COTEŞTI",175885,1107,659,583,69,7,652,7,1220,561,380,272
41,"VRANCEA",396,175885,,145,"COTEŞTI / SCOALA PRIMARA COTESTI",3,16660,"COTEŞTI",175885,473,284,251,33,0,280,4,519,235,152,128
41,"VRANCEA",396,175885,,146,"BUDEŞTI / GRADINITA BUDESTI",3,16660,"COTEŞTI",175885,1477,914,794,105,15,901,13,1620,706,489,412
41,"VRANCEA",396,175885,,147,"VALEA COTEŞTI / SCOALA VALEA COTESTI",3,16660,"COTEŞTI",175885,551,335,300,30,5,332,3,596,261,148,184
41,"VRANCEA",396,175885,,148,"GOLEŞTII DE SUS / GRADINITA GOLESTII DE SUS",3,16660,"COTEŞTI",175885,346,265,228,31,6,265,0,380,115,149,116
41,"VRANCEA",396,175938,,149,"DUMBRĂVENI / CAMIN CULTURAL DUMBRAVENI",3,16665,"DUMBRĂVENI",175938,1617,1067,921,123,23,1059,8,1780,713,626,433
41,"VRANCEA",396,175938,,150,"CÎNDEŞTI / SCOALA GIMNAZIALA CINDESTI",3,16665,"DUMBRĂVENI",175938,1153,688,605,76,7,677,11,1270,582,373,304
41,"VRANCEA",396,175938,,151,"DUMBRĂVENI / SCOALA PRIMARA AL.VLAHUTA DRAG.",3,16665,"DUMBRĂVENI",175938,917,556,513,39,4,549,7,1000,444,296,253
41,"VRANCEA",396,175983,,152,"DUMITREŞTI / Caminul Cultural Dumitresti",3,16670,"DUMITREŞTI",175983,666,454,389,60,5,450,4,740,286,225,225
41,"VRANCEA",396,175983,,153,"DUMITREŞTII DE SUS / Scoala primara Dumitresti de Sus",3,16670,"DUMITREŞTI",175983,235,184,146,33,5,183,1,260,76,120,63
41,"VRANCEA",396,175983,,154,"MOTNĂU / Scoala primara Motnau",3,16670,"DUMITREŞTI",175983,305,220,199,14,7,218,2,330,110,143,75
41,"VRANCEA",396,175983,,155,"TRESTIA / Scoala primara Trestia",3,16670,"DUMITREŞTI",175983,141,104,93,8,3,100,4,160,56,52,48
41,"VRANCEA",396,175983,,156,"TINOASA / Scoala primara Tinoasa",3,16670,"DUMITREŞTI",175983,164,137,125,8,4,136,1,180,43,60,76
41,"VRANCEA",396,175983,,157,"LĂSTUNI / Scoala primara Lastuni",3,16670,"DUMITREŞTI",175983,287,209,183,18,8,209,0,320,111,145,64
41,"VRANCEA",396,175983,,158,"POIENIŢA / Scoala primara Poienita",3,16670,"DUMITREŞTI",175983,209,162,138,21,3,160,2,230,68,99,61
41,"VRANCEA",396,175983,,159,"DUMITREŞTII-FAŢĂ / Scoala primara Dumitresti Fata",3,16670,"DUMITREŞTI",175983,194,151,116,28,7,151,0,220,69,120,31
41,"VRANCEA",396,175983,,160,"BICEŞTII DE SUS / Scoala primara Bicesti de Sus",3,16670,"DUMITREŞTI",175983,620,475,410,52,13,469,6,690,215,288,181
41,"VRANCEA",396,175983,,161,"GĂLOIEŞTI / Scoala rimara Galoiesti",3,16670,"DUMITREŞTI",175983,453,313,278,30,5,305,8,500,187,202,103
41,"VRANCEA",396,175983,,162,"BICEŞTII DE JOS / Scoala primara Bicesti de Jos",3,16670,"DUMITREŞTI",175983,545,332,304,27,1,324,8,600,268,167,157
41,"VRANCEA",396,176150,,163,"FITIONEŞTI / CAMINUL CULTURAL FITIONESTI",3,16687,"FITIONEŞTI",176150,715,430,389,41,0,419,11,790,360,211,208
41,"VRANCEA",396,176150,,164,"FITIONEŞTI / SCOALA CU CLASELE I-IV PISC",3,16687,"FITIONEŞTI",176150,572,328,314,14,0,325,3,630,302,129,196
41,"VRANCEA",396,176150,,165,"GHIMICEŞTI / GRADINITA GHIMICESTI",3,16687,"FITIONEŞTI",176150,344,215,186,29,0,212,3,380,165,89,123
41,"VRANCEA",396,176150,,166,"MĂNĂSTIOARA / SCOALA I-IV MANASTIOARA",3,16687,"FITIONEŞTI",176150,505,305,266,39,0,302,3,560,255,157,145
41,"VRANCEA",396,176150,,167,"CIOLĂNEŞTI / SCOALA I-IV CIOLANESTI",3,16687,"FITIONEŞTI",176150,138,92,81,11,0,92,0,150,58,28,64
41,"VRANCEA",396,176212,,168,"GAROAFA / CAMINUL CULTURAL",3,16693,"GAROAFA",176212,1539,943,803,133,7,940,3,1700,757,435,505
41,"VRANCEA",396,176212,,169,"BIZIGHEŞTI / ŞCOALA PRIMARĂ",3,16693,"GAROAFA",176212,576,350,305,39,6,348,2,630,280,185,163
41,"VRANCEA",396,176212,,170,"DOAGA / ŞCOALA",3,16693,"GAROAFA",176212,394,252,209,37,6,251,1,440,188,119,132
41,"VRANCEA",396,176212,,171,"CIUŞLEA / ŞCOALA GIMNAZIALĂ ""PETRACHE BLÎNDU""",3,16693,"GAROAFA",176212,1296,797,700,96,1,790,7,1420,623,390,400
41,"VRANCEA",396,174824,,172,"GOLEŞTI / ŞCOALA GIMNAZIALĂ GOLEŞTI",3,16702,"GOLEŞTI",174824,1384,864,774,89,1,857,7,1530,666,456,401
41,"VRANCEA",396,174824,,173,"GOLEŞTI / CĂMIN CULTURAL GOLEŞTI",3,16702,"GOLEŞTI",174824,1723,1046,963,82,1,1036,10,1880,834,512,524
41,"VRANCEA",396,174824,,174,"CEARDAC / GRĂDINIŢA GOLEŞTI",3,16702,"GOLEŞTI",174824,514,351,328,23,0,346,5,560,209,182,164
41,"VRANCEA",396,178938,,175,"GOLOGANU / GRADINITA",3,16705,"GOLOGANU",178938,1203,706,667,28,11,690,16,1330,624,440,250
41,"VRANCEA",396,178938,,176,"GOLOGANU / SCOALA GENERALA PROFESOR GENERAL GHEORGHE GHEORGHIU",3,16705,"GOLOGANU",178938,1462,916,861,51,4,905,11,1599,683,599,306
41,"VRANCEA",396,176301,,177,"GUGEŞTI / CAMINUL CULTURAL",3,16707,"GUGEŞTI",176301,1649,960,866,82,12,950,10,1820,860,534,416
41,"VRANCEA",396,176301,,178,"GUGEŞTI / SCOALA GENERALA NR. 2 GUGESTI",3,16707,"GUGEŞTI",176301,1556,934,870,42,22,925,9,1700,766,569,356
41,"VRANCEA",396,176301,,179,"GUGEŞTI / GRADINITA NR.3",3,16707,"GUGEŞTI",176301,895,506,463,33,10,503,3,990,484,329,174
41,"VRANCEA",396,176301,,180,"GUGEŞTI / SCOALA DE ARTE SI MESERII AL. VLAHUTA",3,16707,"GUGEŞTI",176301,993,558,500,49,9,545,13,1100,542,323,222
41,"VRANCEA",396,176301,,181,"OREAVU / SCOALA OREAVU",3,16707,"GUGEŞTI",176301,471,306,258,43,5,303,3,520,214,192,111
41,"VRANCEA",396,176338,,182,"GURA CALIŢEI / SCOALA GENERALA GURA CALITEI",3,16710,"GURA CALIŢEI",176338,854,472,415,57,0,466,6,940,468,239,227
41,"VRANCEA",396,176338,,183,"GURA CALIŢEI / SCOALA GENERALA LACU LUI BABAN",3,16710,"GURA CALIŢEI",176338,401,233,196,37,0,232,1,440,207,153,79
41,"VRANCEA",396,176338,,184,"GURA CALIŢEI / SCOALA GENERALA POIENILE",3,16710,"GURA CALIŢEI",176338,341,191,174,17,0,190,1,380,189,122,68
41,"VRANCEA",396,176338,,185,"GURA CALIŢEI / SCOALA GENERALA PLOPU",3,16710,"GURA CALIŢEI",176338,300,181,166,15,0,180,1,330,149,131,49
41,"VRANCEA",396,176338,,186,"GURA CALIŢEI / SCOALA GENERALA DEALUL LUNG",3,16710,"GURA CALIŢEI",176338,366,222,211,11,0,219,3,400,178,145,74
41,"VRANCEA",396,176445,,187,"HOMOCEA / CAMINUL CULTURAL",3,16721,"HOMOCEA",176445,1488,617,581,31,5,602,15,1640,1023,341,261
41,"VRANCEA",396,176445,,188,"LESPEZI / CAMINUL CULTURAL",3,16721,"HOMOCEA",176445,1048,530,477,48,5,522,8,1160,630,307,215
41,"VRANCEA",396,176445,,189,"COSTIŞA / SCOALA CU CLASELE I-IV",3,16721,"HOMOCEA",176445,286,190,161,28,1,190,0,320,130,85,105
41,"VRANCEA",396,176445,,190,"HOMOCEA / GRADINITA NR. 1 CENTRU HOMOCEA",3,16721,"HOMOCEA",176445,1562,674,645,25,4,665,9,1720,1046,353,312
41,"VRANCEA",396,176445,,191,"HOMOCEA / SCOALA CU CLASELE I-VIII",3,16721,"HOMOCEA",176445,1246,628,580,45,3,618,10,1370,742,373,245
41,"VRANCEA",396,176506,,192,"PĂDURENI / SCOALA GENERALA PADURENI",3,16725,"JARIŞTEA",176506,407,270,214,55,1,265,5,450,180,106,159
41,"VRANCEA",396,176506,,193,"JARIŞTEA / Scoala Gimnaziala Jaristea",3,16725,"JARIŞTEA",176506,1684,1081,871,208,2,1064,17,1860,779,382,682
41,"VRANCEA",396,176506,,194,"JARIŞTEA / SCOALA GENERALA NR 2 MARGINEA",3,16725,"JARIŞTEA",176506,660,480,392,88,0,475,5,720,240,198,277
41,"VRANCEA",396,176506,,195,"SCÎNTEIA / SCOALA GENERALA SCINTEIA",3,16725,"JARIŞTEA",176506,180,148,106,42,0,147,1,200,52,54,93
41,"VRANCEA",396,176506,,196,"VĂRSĂTURA / SCOALA GENERALA VARSATURA",3,16725,"JARIŞTEA",176506,453,291,227,57,7,290,1,500,209,105,185
41,"VRANCEA",396,176551,,197,"JITIA / Scoala cu clasele I-IV JITIA",3,16730,"JITIA",176551,818,453,416,36,1,452,1,900,447,161,291
41,"VRANCEA",396,176551,,198,"JITIA DE JOS / Scoala cu clasele I-IV JITIA DE JOS nr.1",3,16730,"JITIA",176551,333,219,195,21,3,218,1,370,151,121,97
41,"VRANCEA",396,176551,,199,"DEALU SĂRII / Scoala cu clasele I-IV DEALU SARII",3,16730,"JITIA",176551,173,129,115,14,0,129,0,200,71,83,46
41,"VRANCEA",396,176613,,200,"MĂICĂNEŞTI / SCOALA GENERALA MAICANESTI",3,16736,"MĂICĂNEŞTI",176613,1196,782,646,83,53,775,7,1320,538,569,206
41,"VRANCEA",396,176613,,201,"MĂICĂNEŞTI / SCOALA  GENERALA TATARU",3,16736,"MĂICĂNEŞTI",176613,694,479,394,68,17,476,3,770,291,335,141
41,"VRANCEA",396,176613,,202,"RÎMNICENI / SCOALA GENERALA RIMNICENI",3,16736,"MĂICĂNEŞTI",176613,1352,861,769,91,1,859,2,1500,639,649,210
41,"VRANCEA",396,176613,,203,"MĂICĂNEŞTI / SCOALA GENERALA SLOBOZIA-BOTESTI",3,16736,"MĂICĂNEŞTI",176613,249,180,140,40,0,178,2,280,100,136,42
41,"VRANCEA",396,176613,,204,"MĂICĂNEŞTI / SCOALA  GENERALA  SATU-NOU",3,16736,"MĂICĂNEŞTI",176613,231,147,115,32,0,147,0,260,113,110,37
41,"VRANCEA",396,176613,,205,"MĂICĂNEŞTI / SCOALA  GENERALA  STUPINA",3,16736,"MĂICĂNEŞTI",176613,301,247,215,32,0,245,2,330,83,176,69
41,"VRANCEA",396,176686,,206,"MERA / SCOALA MERA nr. 2",3,16743,"MERA",176686,1686,898,827,42,29,888,10,1850,952,490,398
41,"VRANCEA",396,176686,,207,"VULCĂNEASA / SCOALA VULCANEASA",3,16743,"MERA",176686,1587,856,799,38,19,843,13,1750,894,483,360
41,"VRANCEA",396,176748,,208,"MILCOVUL / GRADINITA DE COPII MILCOVUL",3,16749,"MILCOVUL",176748,1095,753,661,60,32,750,3,1200,447,406,344
41,"VRANCEA",396,176748,,209,"MILCOVUL / SCOALA MILCOVUL",3,16749,"MILCOVUL",176748,1115,746,651,71,24,736,10,1230,484,401,335
41,"VRANCEA",396,176748,,210,"LĂMOTEŞTI / SCOALA LAMOTESTI",3,16749,"MILCOVUL",176748,831,611,489,110,12,602,9,900,289,251,351
41,"VRANCEA",396,176793,,211,"DIOCHEŢIREDIU / SCOALA PRIMARA DIOCHETI-REDIU",3,16752,"MOVILIŢA",176793,624,345,307,38,0,338,7,690,345,185,153
41,"VRANCEA",396,176793,,212,"MOVILIŢA / GRADINITA SPERIETI",3,16752,"MOVILIŢA",176793,391,216,190,26,0,214,2,430,214,106,108
41,"VRANCEA",396,176793,,213,"MOVILIŢA / SCOALA NR.2",3,16752,"MOVILIŢA",176793,688,372,344,28,0,365,7,740,368,164,201
41,"VRANCEA",396,176793,,214,"MOVILIŢA / SCOALA NR.1",3,16752,"MOVILIŢA",176793,734,388,339,49,0,385,3,830,442,136,249
41,"VRANCEA",396,176793,,215,"TROTUŞANU / SCOALA PRIMARA TROTUSANU",3,16752,"MOVILIŢA",176793,375,222,189,33,0,215,7,400,178,98,117
41,"VRANCEA",396,176793,,216,"FRECĂŢEI / SCOALA PRIMARA FRECATEI",3,16752,"MOVILIŢA",176793,403,215,187,28,0,213,2,440,225,81,132
41,"VRANCEA",396,176855,,217,"NĂNEŞTI / CAMIN CULTURAL NANESTI",3,16758,"NĂNEŞTI",176855,1126,722,607,87,28,715,7,1239,517,378,337
41,"VRANCEA",396,176855,,218,"CĂLIENII VECHI / CAMIN CULTURAL CALIENII-VECHI",3,16758,"NĂNEŞTI",176855,640,369,304,56,9,365,4,700,331,239,126
41,"VRANCEA",396,176855,,219,"CĂLIENII NOI / SCOALA CALIENII-NOI",3,16758,"NĂNEŞTI",176855,301,192,149,36,7,188,4,330,138,104,84
41,"VRANCEA",396,176891,,220,"NĂRUJA / CĂMINUL CULTURAL",3,16762,"NĂRUJA",176891,1003,638,582,56,0,632,6,1100,462,373,259
41,"VRANCEA",396,176891,,221,"PODU NĂRUJEI / ŞCOALA CU CLASELE I-IV",3,16762,"NĂRUJA",176891,521,307,273,34,0,305,2,580,273,164,141
41,"VRANCEA",396,178885,,222,"NEGRILEŞTI / CAMIN CULTURAL",3,16767,"NEGRILEŞTI",178885,1468,800,713,39,48,787,13,1620,820,495,292
41,"VRANCEA",396,176944,,223,"NEREJU / SCOALA "" DIMITRIE GUSTI""  NEREJU",3,16769,"NEREJU",176944,1435,851,821,30,0,846,5,1580,729,620,226
41,"VRANCEA",396,176944,,224,"NEREJU MIC / SCOALA GIMNAZIALA NEREJU-MIC",3,16769,"NEREJU",176944,1433,855,824,31,0,842,13,1570,715,502,340
41,"VRANCEA",396,176944,,225,"NEREJU MIC / Internat scolar",3,16769,"NEREJU",176944,578,301,285,16,0,294,7,640,339,179,115
41,"VRANCEA",396,177003,,226,"NISTOREŞTI / CĂMINUL CULTURAL",3,16775,"NISTOREŞTI",177003,968,579,483,43,53,571,8,1070,491,401,170
41,"VRANCEA",396,177003,,227,"VETREŞTI-HERĂSTRĂU / CĂMINUL CULTURAL",3,16775,"NISTOREŞTI",177003,864,562,480,36,46,556,6,950,388,379,177
41,"VRANCEA",396,178947,,228,"OBREJIŢA / SCOALA GIMNAZIALĂ OBREJIŢA",3,16785,"OBREJIŢA",178947,1282,841,727,81,33,824,17,1400,559,502,322
41,"VRANCEA",396,177101,,229,"PALTIN / Camin cultural Paltin",3,16787,"PALTIN",177101,1135,632,588,44,0,625,7,1251,619,379,246
41,"VRANCEA",396,177101,,230,"PALTIN / Camin cultural Prahuda",3,16787,"PALTIN",177101,492,284,262,22,0,282,2,551,267,182,100
41,"VRANCEA",396,178910,,231,"PĂULEŞTI / CAMIN CULTURAL PĂULEŞTI",3,16793,"PAULEŞTI",178910,649,399,358,35,6,396,3,720,321,286,110
41,"VRANCEA",396,178910,,232,"PĂULEŞTI / Şcoala cu clasele I-IV Fundatura",3,16793,"PAULEŞTI",178910,449,269,224,38,7,268,1,500,231,165,103
41,"VRANCEA",396,178910,,233,"HĂULIŞCA / SCOALA PRIMARA HAULISCA",3,16793,"PAULEŞTI",178910,606,473,427,41,5,472,1,670,197,432,40
41,"VRANCEA",396,177236,,234,"PĂUNEŞTI / Scoala nr.4 Surlea",3,16796,"PĂUNEŞTI",177236,1182,529,446,83,0,521,8,1300,771,221,300
41,"VRANCEA",396,177236,,235,"PĂUNEŞTI / Scoala nr.3 Novacesti",3,16796,"PĂUNEŞTI",177236,1454,717,649,68,0,700,17,1600,883,246,454
41,"VRANCEA",396,177236,,236,"PĂUNEŞTI / Scoala Bostanesti",3,16796,"PĂUNEŞTI",177236,971,482,410,72,0,473,9,1060,578,197,276
41,"VRANCEA",396,177236,,237,"VIIŞOARA / scoala generala viisoara",3,16796,"PĂUNEŞTI",177236,805,398,369,29,0,393,5,890,492,215,178
41,"VRANCEA",396,177236,,238,"PĂUNEŞTI / Camin Cultural Paunesti",3,16796,"PĂUNEŞTI",177236,1071,538,417,121,0,533,5,1180,642,230,303
41,"VRANCEA",396,178894,,239,"PLOSCUŢENI / Scoala Generala nr.1, CORP A",3,16799,"PLOSCUŢENI",178894,1006,527,464,37,26,520,7,1100,573,357,163
41,"VRANCEA",396,178894,,240,"PLOSCUŢENI / Scoala Generala nr.1, CORP B",3,16799,"PLOSCUŢENI",178894,1133,600,520,39,41,596,4,1240,640,408,188
41,"VRANCEA",396,178894,,241,"ARGEA / Scoala Primara sat Argea",3,16799,"PLOSCUŢENI",178894,309,191,169,18,4,190,1,340,149,159,31
41,"VRANCEA",396,177263,,242,"POIANA CRISTEI / Camin Cultural Poiana Cristei, Primaria Comunei Poiana Cristei",3,16802,"POIANA CRISTEI",177263,973,581,553,28,0,578,3,1070,489,374,204
41,"VRANCEA",396,177263,,243,"PODU LACULUI / Scoala cu clasele I-IV sat Podu Lacului, Scoala Coordonatoare Poiana Cristei",3,16802,"POIANA CRISTEI",177263,559,350,324,26,0,345,5,620,270,195,150
41,"VRANCEA",396,177263,,244,"MAHRIU / Scoala cu clasele I-IV sat Mahriu, Scoala Coordonatorare Poiana Cristei",3,16802,"POIANA CRISTEI",177263,322,203,195,8,0,201,2,350,147,131,70
41,"VRANCEA",396,177263,,245,"PETREANU / Scoala Cu clasele I-IV sat Petreanu. Scoala Coordonatoare Poiana Cristei",3,16802,"POIANA CRISTEI",177263,133,74,63,11,0,74,0,150,76,61,13
41,"VRANCEA",396,177263,,246,"TÎRÎTU / Scoala cu clasele I-VIII sat Tiritu, Scoala Coordonatoare Poiana Cristei",3,16802,"POIANA CRISTEI",177263,224,136,129,7,0,136,0,250,114,113,23
41,"VRANCEA",396,178901,,247,"POPEŞTI / SCOALA GIMNAZIALA PROFESOR DOCTOR GENERAL GHEORGHE V. ZAHARIA",3,16811,"POPEŞTI",178901,1856,1035,945,88,2,1024,11,2050,1015,474,550
41,"VRANCEA",396,178901,,248,"POPEŞTI / FOSTA GRADINIŢĂ POPESTI",3,16811,"POPEŞTI",178901,287,171,143,28,0,164,7,310,139,70,94
41,"VRANCEA",396,178901,,249,"TERCHEŞTI / Scoala primara Terchesti",3,16811,"POPEŞTI",178901,411,231,194,37,0,225,6,450,219,149,76
41,"VRANCEA",396,177352,,250,"PUFEŞTI / Scoala gimnaziala  Pufesti",3,16814,"PUFEŞTI",177352,1325,752,685,67,0,748,4,1450,698,333,415
41,"VRANCEA",396,177352,,251,"CIORANI / GRADINITA CIORANI",3,16814,"PUFEŞTI",177352,815,496,446,50,0,487,9,900,404,237,250
41,"VRANCEA",396,177352,,252,"DOMNEŞTI-TÎRG / Scoala cu cls.I-VIII",3,16814,"PUFEŞTI",177352,1211,719,665,54,0,712,7,1320,601,409,303
41,"VRANCEA",396,177405,,253,"RĂCOASA / SCOALA GENERALA RACOASA",3,16819,"RĂCOASA",177405,899,561,479,65,17,552,9,1000,439,263,289
41,"VRANCEA",396,177405,,254,"GOGOIU / SCOALA PRIMARA GOGOIU",3,16819,"RĂCOASA",177405,184,107,82,20,5,103,4,200,93,45,58
41,"VRANCEA",396,177405,,255,"MĂRĂŞTI / SCOALA PRIMARA MARASTI",3,16819,"RĂCOASA",177405,459,306,250,43,13,301,5,500,194,147,154
41,"VRANCEA",396,177405,,256,"VARNIŢA / SCOALA PRIMARA VARNITA",3,16819,"RĂCOASA",177405,450,309,256,46,7,305,4,500,191,209,96
41,"VRANCEA",396,177405,,257,"VERDEA / SCOALA PRIMARA VERDEA",3,16819,"RĂCOASA",177405,630,409,353,43,13,402,7,700,291,159,243
41,"VRANCEA",396,178956,,258,"RĂSTOACA / CĂMINUL CULTURAL",3,16825,"RĂSTOACA",178956,1284,763,708,37,18,756,7,1400,637,402,354
41,"VRANCEA",396,178956,,259,"RĂSTOACA / CAMINUL CULTURAL RASTOACA",3,16825,"RĂSTOACA",178956,859,524,462,48,14,511,13,950,426,245,266
41,"VRANCEA",396,177469,,260,"ŞINDRILARI / Scoala Gimnaziala Sindrilari nr. 1",3,16827,"REGHIU",177469,990,637,591,46,0,627,10,1100,463,419,208
41,"VRANCEA",396,177469,,261,"REGHIU / Scoala Primara Reghiu",3,16827,"REGHIU",177469,581,344,328,16,0,337,7,640,296,195,142
41,"VRANCEA",396,177469,,262,"RĂIUŢI / Scoala Primara Raiuti",3,16827,"REGHIU",177469,324,211,201,10,0,207,4,360,149,98,109
41,"VRANCEA",396,177557,,263,"RUGINEŞTI / CAMIN CULTURAL",3,16836,"RUGINEŞTI",177557,785,441,386,51,4,439,2,871,430,252,187
41,"VRANCEA",396,177557,,264,"RUGINEŞTI / SCOALA GENERALA",3,16836,"RUGINEŞTI",177557,797,450,399,46,5,446,4,871,421,265,181
41,"VRANCEA",396,177557,,265,"ANGHELEŞTI / SCOALA GENERALA",3,16836,"RUGINEŞTI",177557,1008,541,482,59,0,531,10,1100,559,275,256
41,"VRANCEA",396,177557,,266,"COPĂCEŞTI / SCOALA GENERALA",3,16836,"RUGINEŞTI",177557,593,326,303,23,0,319,7,651,325,222,97
41,"VRANCEA",396,177557,,267,"VĂLENI / SCOALA GENERALA",3,16836,"RUGINEŞTI",177557,245,143,123,18,2,143,0,271,128,79,64
41,"VRANCEA",396,177600,,268,"SIHLEA / PRIMARIA COMUNEI SIHLEA",3,16841,"SIHLEA",177600,1904,1013,923,85,5,1001,12,2100,1087,646,355
41,"VRANCEA",396,177600,,269,"CĂIATA / SCOALA CĂIATA",3,16841,"SIHLEA",177600,577,358,305,53,0,350,8,640,282,231,119
41,"VRANCEA",396,177600,,270,"BOGZA / GRADINIŢA BOGZA",3,16841,"SIHLEA",177600,774,411,345,66,0,406,5,850,439,272,134
41,"VRANCEA",396,177600,,271,"VOETIN / SCOALA VOETIN",3,16841,"SIHLEA",177600,936,482,416,66,0,476,6,1030,548,379,97
41,"VRANCEA",396,177655,,272,"SLOBOZIA BRADULUI / SCOALA SLOBOZIA BRADULUI SALA A",3,16846,"SLOBOZIA BRADULUI",177655,541,319,284,27,8,312,7,600,281,156,156
41,"VRANCEA",396,177655,,273,"SLOBOZIA BRADULUI / SCOALA SLOBOZIA BRADULUI SALA B",3,16846,"SLOBOZIA BRADULUI",177655,668,398,361,29,8,388,10,740,342,195,193
41,"VRANCEA",396,177655,,274,"SLOBOZIA BRADULUI / SCOALA SLOBOZIA BRADULUI SALA C",3,16846,"SLOBOZIA BRADULUI",177655,831,505,476,29,0,490,15,900,395,187,303
41,"VRANCEA",396,177655,,275,"COROTENI / SCOALA COROTENI",3,16846,"SLOBOZIA BRADULUI",177655,750,588,465,97,26,581,7,830,242,204,377
41,"VRANCEA",396,177655,,276,"CORNETU / SCOALA CORNETU SALA A",3,16846,"SLOBOZIA BRADULUI",177655,524,320,299,21,0,309,11,581,261,108,201
41,"VRANCEA",396,177655,,277,"CORNETU / SCOALA CORNETU SALA B",3,16846,"SLOBOZIA BRADULUI",177655,594,407,382,25,0,398,9,660,253,177,221
41,"VRANCEA",396,177726,,278,"SLOBOZIA CIORĂŞTI / Gradinita Slobozia Ciorasti",3,16853,"SLOBOZIA CIORĂŞTI",177726,1150,804,641,133,30,793,11,1270,466,570,223
41,"VRANCEA",396,177726,,279,"JILIŞTE / Scoala cu clasele I-IV Jiliste",3,16853,"SLOBOZIA CIORĂŞTI",177726,580,364,319,38,7,355,9,640,276,237,118
41,"VRANCEA",396,177762,,280,"DRAGOSLOVENI / SCOALA GENERAL[ SIMION MEHEDINTI",3,16857,"SOVEJA",177762,1146,763,675,74,14,757,6,1260,497,494,263
41,"VRANCEA",396,177762,,281,"RUCĂRENI / FOSTA SCOALA GENERALA",3,16857,"SOVEJA",177762,853,559,510,31,18,552,7,940,381,370,182
41,"VRANCEA",396,178965,,282,"SPULBER / CAMINUL  CULTURAL",3,16860,"SPULBER",178965,1009,672,634,38,0,670,2,1121,449,464,206
41,"VRANCEA",396,177799,,283,"STRĂOANE / CAMINUL CULTURAL STRAOANE DE JOS",3,16868,"STRĂOANE",177799,1172,719,611,97,11,713,6,1230,511,449,264
41,"VRANCEA",396,177799,,284,"STRĂOANE / CAMINUL CULTURAL STRAOANE DE SUS",3,16868,"STRĂOANE",177799,795,432,386,36,10,425,7,900,468,256,169
41,"VRANCEA",396,177799,,285,"REPEDEA / SCOALA GENERALA REPEDEA",3,16868,"STRĂOANE",177799,291,180,157,23,0,179,1,320,140,152,27
41,"VRANCEA",396,177799,,286,"MUNCELU / CAMIN CULTURAL",3,16868,"STRĂOANE",177799,809,471,433,28,10,464,7,900,429,317,147
41,"VRANCEA",396,177842,,287,"SURAIA / SCOALA GIMNAZIALA SURAIA",3,16873,"SURAIA",177842,1800,945,849,90,6,937,8,2000,1055,409,528
41,"VRANCEA",396,177842,,288,"SURAIA / GRADINITA NR. 2 SURAIA",3,16873,"SURAIA",177842,1578,786,723,62,1,778,8,1700,914,337,441
41,"VRANCEA",396,177842,,289,"SURAIA / SCOALA VECHE SURAIA",3,16873,"SURAIA",177842,1625,835,769,63,3,825,10,1800,965,390,435
41,"VRANCEA",396,177879,,290,"TĂNĂSOAIA / camin cultural",3,16881,"TĂNĂSOAIA",177879,744,543,456,64,23,538,5,820,277,377,161
41,"VRANCEA",396,177879,,291,"TĂNĂSOAIA / Scoala generala",3,16881,"TĂNĂSOAIA",177879,555,342,296,37,9,336,6,600,258,239,97
41,"VRANCEA",396,177879,,292,"TĂNĂSOAIA / Scoala generala",3,16881,"TĂNĂSOAIA",177879,208,201,141,47,13,196,5,230,29,137,59
41,"VRANCEA",396,177879,,293,"TĂNĂSOAIA / Scoala generala",3,16881,"TĂNĂSOAIA",177879,230,179,133,30,16,177,2,250,71,157,20
41,"VRANCEA",396,177986,,294,"TĂTĂRANU / Scoala Generala Tataranu",3,16892,"TĂTĂRANU",177986,1247,662,598,59,5,655,7,1380,718,397,258
41,"VRANCEA",396,177986,,295,"MĂRTINEŞTI / Scoala Generala Martinesti",3,16892,"TĂTĂRANU",177986,588,367,301,62,4,366,1,650,283,201,165
41,"VRANCEA",396,177986,,296,"VÎJÎITOAREA / Scoala Generala Vajaitoarea",3,16892,"TĂTĂRANU",177986,215,158,117,38,3,157,1,230,72,100,57
41,"VRANCEA",396,177986,,297,"BORDEASCA VECHE / Scoala generala Bordeasca Veche 2",3,16892,"TĂTĂRANU",177986,699,460,375,76,9,448,12,780,320,296,152
41,"VRANCEA",396,177986,,298,"BORDEASCA NOUĂ / Scoala Generala Bordeasca Noua",3,16892,"TĂTĂRANU",177986,373,238,188,48,2,233,5,400,162,146,87
41,"VRANCEA",396,177986,,299,"BORDEASCA VECHE / Scoala generala Bordeasca Veche 1",3,16892,"TĂTĂRANU",177986,873,475,406,66,3,470,5,950,475,271,199
41,"VRANCEA",396,178046,,300,"TÂMBOEŞTI / Primarie",3,16875,"TÂMBOEŞTI",178046,1062,586,518,57,11,578,8,1170,584,385,193
41,"VRANCEA",396,178046,,301,"SLIMNIC / Scoala Slimnic",3,16875,"TÂMBOEŞTI",178046,1178,711,620,59,32,697,14,1290,579,431,266
41,"VRANCEA",396,178046,,302,"TRESTIENI / SCOALA TRESTIENI",3,16875,"TÂMBOEŞTI",178046,139,102,82,16,4,101,1,200,98,65,36
41,"VRANCEA",396,178117,,303,"TULNICI / SCOALA ION DIACONU TULNICI",3,16907,"TULNICI",178117,1147,668,596,64,8,659,9,1260,592,405,254
41,"VRANCEA",396,178117,,304,"TULNICI / SCOALA ION DIACONU TULNICI",3,16907,"TULNICI",178117,1171,631,573,45,13,628,3,1280,649,370,258
41,"VRANCEA",396,178117,,305,"COZA / Şcoala Coza",3,16907,"TULNICI",178117,688,397,362,24,11,395,2,760,363,293,102
41,"VRANCEA",396,178117,,306,"LEPŞA / Şcoala Lepşa",3,16907,"TULNICI",178117,360,472,193,275,4,467,5,480,8,185,282
41,"VRANCEA",396,178180,,307,"ŢIFEŞTI / Scoala cu cls.I-VIII",3,16898,"ŢIFEŞTI",178180,867,488,432,56,0,482,6,950,462,167,315
41,"VRANCEA",396,178180,,308,"BĂTINEŞTI / Scoala cu cls.I-VIII",3,16898,"ŢIFEŞTI",178180,1305,729,681,48,0,715,14,1440,711,262,453
41,"VRANCEA",396,178180,,309,"CLIPICEŞTI / Scoala cu cls.I-VIII",3,16898,"ŢIFEŞTI",178180,678,339,297,42,0,338,1,740,401,185,153
41,"VRANCEA",396,178180,,310,"OLEŞEŞTI / Scoala cu Ccls.I-IV",3,16898,"ŢIFEŞTI",178180,744,447,395,52,0,444,3,820,373,194,250
41,"VRANCEA",396,178180,,311,"SÎRBI / Scoala cu Ccls.I-IV",3,16898,"ŢIFEŞTI",178180,663,380,330,48,2,374,6,730,350,165,209
41,"VRANCEA",396,178279,,312,"URECHEŞTI / Consiliul Local Urecheşti",3,16912,"URECHEŞTI",178279,1840,1142,1010,132,0,1130,12,2020,878,398,732
41,"VRANCEA",396,178279,,313,"URECHEŞTI / Şcoala primară Urecheşti",3,16912,"URECHEŞTI",178279,451,353,263,90,0,349,4,500,147,145,204
41,"VRANCEA",396,178313,,314,"VALEA SĂRII / SCOALA GENERALA VALEA SARII",3,16914,"VALEA SĂRII",178313,678,392,355,37,0,392,0,750,358,193,199
41,"VRANCEA",396,178313,,315,"VALEA SĂRII / CAMINUL CULTURAL COLACU",3,16914,"VALEA SĂRII",178313,627,380,356,24,0,378,2,681,301,233,145
41,"VRANCEA",396,178313,,316,"VALEA SĂRII / SCOALA GENERALA PODURI",3,16914,"VALEA SĂRII",178313,268,184,163,21,0,182,2,300,116,97,85
41,"VRANCEA",396,178313,,317,"VALEA SĂRII / SCOALA  PRISACA",3,16914,"VALEA SĂRII",178313,162,113,94,19,0,111,2,200,87,71,40
41,"VRANCEA",396,178377,,318,"VIDRA / SALA DE SPORT VIDRA",3,16920,"VIDRA",178377,1483,879,765,95,19,873,6,1640,761,460,413
41,"VRANCEA",396,178377,,319,"VOLOŞCANI / SCOALA GENERALA",3,16920,"VIDRA",178377,285,170,149,21,0,166,4,300,130,90,76
41,"VRANCEA",396,178377,,320,"IREŞTI / SCOALA GENERALA",3,16920,"VIDRA",178377,772,405,361,44,0,398,7,850,445,213,185
41,"VRANCEA",396,178377,,321,"ŞERBEŞTI / SCOALA GENERALA",3,16920,"VIDRA",178377,497,263,226,37,0,260,3,550,287,116,144
41,"VRANCEA",396,178377,,322,"BURCA / SCOALA GENERALA",3,16920,"VIDRA",178377,660,419,369,39,11,404,15,700,281,286,118
41,"VRANCEA",396,178377,,323,"BURCA / SCOALA GENERALA",3,16920,"VIDRA",178377,673,370,345,20,5,365,5,751,381,257,108
41,"VRANCEA",396,178377,,324,"SCAFARI / SCOALA GENERALA",3,16920,"VIDRA",178377,368,205,192,13,0,204,1,401,196,115,89
41,"VRANCEA",396,178377,,325,"TICHIRIŞ / SCOALA GENERALA",3,16920,"VIDRA",178377,644,380,352,28,0,376,4,700,320,214,162
41,"VRANCEA",396,178377,,326,"VIIŞOARA / SCOALA GENERALA",3,16920,"VIDRA",178377,594,333,319,14,0,328,5,650,317,213,115
41,"VRANCEA",396,178475,,327,"VINTILEASCA / Scoala Regina Maria Vintileasca",3,16938,"VINTILEASCA",178475,638,428,380,37,11,422,6,700,272,301,121
41,"VRANCEA",396,178475,,328,"NECULELE / Gradinita Voinicelul Neculele",3,16938,"VINTILEASCA",178475,393,237,200,26,11,235,2,430,193,185,50
41,"VRANCEA",396,178475,,329,"BAHNELE / Scoala Pictor Mihail Balasescu Bahnele",3,16938,"VINTILEASCA",178475,485,298,259,27,12,293,5,540,242,223,70
41,"VRANCEA",396,178475,,330,"DUPĂ MĂGURA / Scoala Ion Creanga Dupa Magura",3,16938,"VINTILEASCA",178475,74,51,44,7,0,50,1,100,49,26,24
41,"VRANCEA",396,178475,,331,"POIANA STOICHII / Scoaola Poiana Stoichii",3,16938,"VINTILEASCA",178475,77,55,32,14,9,54,1,100,45,33,21
41,"VRANCEA",396,178545,,332,"VIZANTEA RĂZĂŞEASCĂ / Scoala din Vizantea Razaseasca",3,16952,"VIZANTEA-LIVEZI",178545,663,338,287,30,21,333,5,730,392,171,162
41,"VRANCEA",396,178545,,333,"VIZANTEA MĂNĂSTIREASCĂ / Scoala din Vizantea Manastireasca",3,16952,"VIZANTEA-LIVEZI",178545,1476,700,622,41,37,695,5,1630,930,247,448
41,"VRANCEA",396,178545,,334,"PISCU RADULUI / Soala din PIiscu-Radului",3,16952,"VIZANTEA-LIVEZI",178545,360,171,152,16,3,169,2,400,229,66,103
41,"VRANCEA",396,178545,,335,"MESTEACĂNU / Scoala din Mesteacanu",3,16952,"VIZANTEA-LIVEZI",178545,303,190,171,18,1,188,2,330,140,84,104
41,"VRANCEA",396,178545,,336,"LIVEZILE / Scoala din Livezile",3,16952,"VIZANTEA-LIVEZI",178545,589,373,325,30,18,367,6,640,267,149,218
41,"VRANCEA",396,178607,,337,"VÎNĂTORI / SCOALA VANATORI",3,16930,"VÎNĂTORI",178607,996,608,549,59,0,605,3,1090,482,266,339
41,"VRANCEA",396,178607,,338,"JORĂŞTI / GRADINITA JORASTI",3,16930,"VÎNĂTORI",178607,1303,684,630,54,0,672,12,1430,746,292,380
41,"VRANCEA",396,178607,,339,"PETREŞTI / GRADINITA PETRESTI",3,16930,"VÎNĂTORI",178607,1145,711,647,64,0,705,6,1250,539,279,426
41,"VRANCEA",396,178607,,340,"MIRCEŞTII NOI / SCOALA GIMNAZIALA MIRCESTII NOI",3,16930,"VÎNĂTORI",178607,718,441,394,47,0,437,4,800,359,203,234
41,"VRANCEA",396,178607,,341,"MIRCEŞTII VECHI / DISPENSARUL UMAN MIRCESTII VECHI",3,16930,"VÎNĂTORI",178607,238,165,139,26,0,161,4,260,95,97,64
41,"VRANCEA",396,178607,,342,"BALTA RAŢEI / SCOALA PRIMARA BALTA RATEI",3,16930,"VÎNĂTORI",178607,215,130,102,28,0,129,1,240,110,74,55
41,"VRANCEA",396,178607,,343,"RĂDULEŞTI / SCOALA PRIMARA RADULESTI",3,16930,"VÎNĂTORI",178607,742,398,352,46,0,393,5,800,402,202,191
41,"VRANCEA",396,178689,,344,"VÎRTEŞCOIU / CAMIN CULTURAL  VIRTESCOIU",3,16945,"VÎRTEŞCOIU",178689,1237,691,612,79,0,683,8,1370,679,410,273
41,"VRANCEA",396,178689,,345,"FARAOANELE / CAMIN CULTURAL  FARAOANELE",3,16945,"VÎRTEŞCOIU",178689,1002,657,571,74,12,650,7,1100,443,516,134
41,"VRANCEA",396,178689,,346,"BECIU / SCOALA  BECIU",3,16945,"VÎRTEŞCOIU",178689,348,235,194,39,2,230,5,380,145,133,97
41,"VRANCEA",396,178689,,347,"RÎMNICEANCA / SCOALA PRIMARA RIMNICEANCA",3,16945,"VÎRTEŞCOIU",178689,217,143,119,24,0,139,4,240,97,92,47
41,"VRANCEA",396,178750,,348,"VRÎNCIOAIA / Camin cultural Vrincioaia",3,16958,"VRÎNCIOAIA",178750,526,282,260,15,7,279,3,580,298,192,87
41,"VRANCEA",396,178750,,349,"POIANA / Corp C primarie",3,16958,"VRÎNCIOAIA",178750,610,321,270,37,14,319,2,670,349,201,118
41,"VRANCEA",396,178750,,350,"SPINEŞTI / SEDIU OBSTEI CHILIILE ZBOINEI",3,16958,"VRÎNCIOAIA",178750,626,357,294,33,30,352,5,700,343,278,74
41,"VRANCEA",396,178750,,351,"MUNCEI / Scoala Primara Muncei",3,16958,"VRÎNCIOAIA",178750,578,318,296,15,7,317,1,640,322,238,79
41,"VRANCEA",396,178821,,352,"VULTURU / SCOALA GENERALA VULTURU",3,16965,"VULTURU",178821,1182,545,491,51,3,540,5,1300,755,335,205
41,"VRANCEA",396,178821,,353,"VULTURU / SCOALA GENERALA VULTURU",3,16965,"VULTURU",178821,1256,604,520,73,11,595,9,1380,776,394,201
41,"VRANCEA",396,178821,,354,"VULTURU / GRADINITA NR 1",3,16965,"VULTURU",178821,1247,578,513,58,7,572,6,1370,792,372,200
41,"VRANCEA",396,178821,,355,"BOŢÎRLĂU / SCOALA BOTARLAU",3,16965,"VULTURU",178821,1188,521,454,65,2,503,18,1300,779,320,183
41,"VRANCEA",396,178821,,356,"HÎNGULEŞTI / SCOALA HANGULESTI",3,16965,"VULTURU",178821,1005,580,506,69,5,576,4,1100,520,404,172
41,"VRANCEA",396,178821,,357,"MALURI / SCOALA MALURI",3,16965,"VULTURU",178821,472,331,255,76,0,328,3,514,183,253,75
41,"VRANCEA",396,178821,,358,"VADU ROŞCA / SCOALA VADU ROSCA",3,16965,"VULTURU",178821,723,286,248,38,0,280,6,800,514,189,91
42,"SECTOR 1","#N/A",179141,,1,"BUCUREŞTI SECTORUL 1 / LICEUL TEORETIC ""NICOLAE IORGA""",1,16973,"MUNICIPIUL BUCUREŞTI",179141,1353,1194,883,310,1,1159,35,1500,306,390,769
42,"SECTOR 1","#N/A",179141,,2,"BUCUREŞTI SECTORUL 1 / LICEUL TEORETIC ""NICOLAE IORGA""",1,16973,"MUNICIPIUL BUCUREŞTI",179141,1648,1293,1119,174,0,1260,33,1806,513,488,772
42,"SECTOR 1","#N/A",179141,,3,"BUCUREŞTI SECTORUL 1 / LICEUL TEORETIC ""NICOLAE IORGA""",1,16973,"MUNICIPIUL BUCUREŞTI",179141,909,751,583,168,0,737,14,1000,249,280,457
42,"SECTOR 1","#N/A",179141,,4,"BUCUREŞTI SECTORUL 1 / LICEUL TEORETIC ""NICOLAE IORGA""",1,16973,"MUNICIPIUL BUCUREŞTI",179141,1152,891,710,181,0,872,19,1296,405,334,538
42,"SECTOR 1","#N/A",179141,,5,"BUCUREŞTI SECTORUL 1 / LICEUL GRECO-CATOLIC ""TIMOTEI CIPARIU""",1,16973,"MUNICIPIUL BUCUREŞTI",179141,1650,1101,1028,71,2,1091,10,1800,699,429,662
42,"SECTOR 1","#N/A",179141,,6,"BUCUREŞTI SECTORUL 1 / LICEUL GRECO-CATOLIC ""TIMOTEI CIPARIU""",1,16973,"MUNICIPIUL BUCUREŞTI",179141,1026,746,663,83,0,735,11,1100,354,252,483
42,"SECTOR 1","#N/A",179141,,7,"BUCUREŞTI SECTORUL 1 / LICEUL GRECO-CATOLIC ""TIMOTEI CIPARIU""",1,16973,"MUNICIPIUL BUCUREŞTI",179141,1322,938,823,115,0,913,25,1502,564,356,557
42,"SECTOR 1","#N/A",179141,,8,"BUCUREŞTI SECTORUL 1 / ŞCOALA GIMNAZIALĂ NR.13",1,16973,"MUNICIPIUL BUCUREŞTI",179141,946,661,568,93,0,645,16,1000,339,278,367
42,"SECTOR 1","#N/A",179141,,9,"BUCUREŞTI SECTORUL 1 / ŞCOALA GIMNAZIALĂ NR.13",1,16973,"MUNICIPIUL BUCUREŞTI",179141,915,580,511,69,0,569,11,990,410,254,315
42,"SECTOR 1","#N/A",179141,,10,"BUCUREŞTI SECTORUL 1 / ŞCOALA GIMNAZIALĂ NR.13",1,16973,"MUNICIPIUL BUCUREŞTI",179141,1435,986,882,88,16,971,15,1600,614,405,566
42,"SECTOR 1","#N/A",179141,,11,"BUCUREŞTI SECTORUL 1 / ŞCOALA GIMNAZIALĂ NR.13",1,16973,"MUNICIPIUL BUCUREŞTI",179141,965,522,485,37,0,510,12,1100,578,261,249
42,"SECTOR 1","#N/A",179141,,12,"BUCUREŞTI SECTORUL 1 / ŞCOALA GIMNAZIALĂ NR.179",1,16973,"MUNICIPIUL BUCUREŞTI",179141,1425,1001,838,163,0,977,24,1600,599,412,565
42,"SECTOR 1","#N/A",179141,,13,"BUCUREŞTI SECTORUL 1 / ŞCOALA GIMNAZIALĂ NR.179",1,16973,"MUNICIPIUL BUCUREŞTI",179141,1715,1191,1083,73,35,1157,34,1956,765,463,694
42,"SECTOR 1","#N/A",179141,,14,"BUCUREŞTI SECTORUL 1 / ŞCOALA GIMNAZIALĂ NR.179",1,16973,"MUNICIPIUL BUCUREŞTI",179141,1046,791,659,131,1,771,20,1200,409,313,458
42,"SECTOR 1","#N/A",179141,,15,"BUCUREŞTI SECTORUL 1 / ŞCOALA GIMNAZIALĂ NR.179",1,16973,"MUNICIPIUL BUCUREŞTI",179141,1620,1181,1097,84,0,1151,30,1800,619,465,686
42,"SECTOR 1","#N/A",179141,,16,"BUCUREŞTI SECTORUL 1 / LICEUL TEORETIC ""C-TIN BRÂNCOVEANU""",1,16973,"MUNICIPIUL BUCUREŞTI",179141,1662,1144,978,166,0,1120,24,1800,656,457,663
42,"SECTOR 1","#N/A",179141,,17,"BUCUREŞTI SECTORUL 1 / LICEUL TEORETIC ""C-TIN BRÂNCOVEANU""",1,16973,"MUNICIPIUL BUCUREŞTI",179141,976,750,595,155,0,730,20,1100,350,303,427
42,"SECTOR 1","#N/A",179141,,18,"BUCUREŞTI SECTORUL 1 / LICEUL TEORETIC ""C-TIN BRÂNCOVEANU""",1,16973,"MUNICIPIUL BUCUREŞTI",179141,1047,815,643,172,0,790,25,1100,285,297,493
42,"SECTOR 1","#N/A",179141,,19,"BUCUREŞTI SECTORUL 1 / LICEUL TEORETIC ""C-TIN BRÂNCOVEANU""",1,16973,"MUNICIPIUL BUCUREŞTI",179141,1538,1133,1021,112,0,1098,35,1700,567,502,596
42,"SECTOR 1","#N/A",179141,,20,"BUCUREŞTI SECTORUL 1 / ŞCOALA GIMNAZIALĂ NR.178",1,16973,"MUNICIPIUL BUCUREŞTI",179141,1522,1139,894,245,0,1106,33,1699,560,424,682
42,"SECTOR 1","#N/A",179141,,21,"BUCUREŞTI SECTORUL 1 / ŞCOALA GIMNAZIALĂ NR.178",1,16973,"MUNICIPIUL BUCUREŞTI",179141,1365,1020,880,140,0,990,30,1500,480,368,622
42,"SECTOR 1","#N/A",179141,,22,"BUCUREŞTI SECTORUL 1 / ŞCOALA GIMNAZIALĂ NR.178",1,16973,"MUNICIPIUL BUCUREŞTI",179141,1069,856,717,138,1,840,16,1200,344,322,518
42,"SECTOR 1","#N/A",179141,,23,"BUCUREŞTI SECTORUL 1 / ŞCOALA GIMNAZIALĂ SPECIALĂ NR.8",1,16973,"MUNICIPIUL BUCUREŞTI",179141,1329,884,735,149,0,863,21,1500,616,318,545
42,"SECTOR 1","#N/A",179141,,24,"BUCUREŞTI SECTORUL 1 / ŞCOALA GIMNAZIALĂ SPECIALĂ NR.8",1,16973,"MUNICIPIUL BUCUREŞTI",179141,1440,967,854,113,0,950,17,1600,633,345,605
42,"SECTOR 1","#N/A",179141,,25,"BUCUREŞTI SECTORUL 1 / ŞCOALA GIMNAZIALĂ SPECIALĂ NR.8",1,16973,"MUNICIPIUL BUCUREŞTI",179141,1246,936,839,97,0,915,21,1399,463,343,572
42,"SECTOR 1","#N/A",179141,,26,"BUCUREŞTI SECTORUL 1 / ŞCOALA GIMNAZIALĂ ""NICOLAE GRIGORESCU""",1,16973,"MUNICIPIUL BUCUREŞTI",179141,1774,1239,1073,165,1,1216,23,2000,761,484,732
42,"SECTOR 1","#N/A",179141,,27,"BUCUREŞTI SECTORUL 1 / ŞCOALA GIMNAZIALĂ ""NICOLAE GRIGORESCU""",1,16973,"MUNICIPIUL BUCUREŞTI",179141,1800,1212,1116,96,0,1179,33,2000,788,439,740
42,"SECTOR 1","#N/A",179141,,28,"BUCUREŞTI SECTORUL 1 / CENTRUL SOCIAL SF. LAZĂR",1,16973,"MUNICIPIUL BUCUREŞTI",179141,1493,1089,961,128,0,1064,25,1599,510,425,639
42,"SECTOR 1","#N/A",179141,,29,"BUCUREŞTI SECTORUL 1 / CENTRUL SOCIAL SF. LAZĂR",1,16973,"MUNICIPIUL BUCUREŞTI",179141,1863,1421,1247,174,0,1403,18,2000,579,431,972
42,"SECTOR 1","#N/A",179141,,30,"BUCUREŞTI SECTORUL 1 / CENTRUL SOCIAL SF. LAZĂR",1,16973,"MUNICIPIUL BUCUREŞTI",179141,1369,1009,799,177,33,981,28,1500,491,440,541
42,"SECTOR 1","#N/A",179141,,31,"BUCUREŞTI SECTORUL 1 / ŞCOALA GIMNAZIALĂ NR.6",1,16973,"MUNICIPIUL BUCUREŞTI",179141,950,785,613,153,19,763,22,1000,215,297,466
42,"SECTOR 1","#N/A",179141,,32,"BUCUREŞTI SECTORUL 1 / ŞCOALA GIMNAZIALĂ NR.6",1,16973,"MUNICIPIUL BUCUREŞTI",179141,1019,829,641,187,1,809,20,1100,271,313,496
42,"SECTOR 1","#N/A",179141,,33,"BUCUREŞTI SECTORUL 1 / UNIVERSITATEA DE ŞTIINŢE AGRONOMICE ŞI MEDICINĂ VETERINARĂ BUCUREŞTI",1,16973,"MUNICIPIUL BUCUREŞTI",179141,1399,1696,828,687,181,1658,38,1750,54,557,1101
42,"SECTOR 1","#N/A",179141,,34,"BUCUREŞTI SECTORUL 1 / UNIVERSITATEA DE ŞTIINŢE AGRONOMICE ŞI MEDICINĂ VETERINARĂ",1,16973,"MUNICIPIUL BUCUREŞTI",179141,1457,1748,906,775,67,1721,27,1850,102,532,1189
42,"SECTOR 1","#N/A",179141,,35,"BUCUREŞTI SECTORUL 1 / DIRECŢIA PUBLICĂ DE EVIDENŢĂ A PERSOANEI ŞI STARE CIVILĂ SECT.1",1,16973,"MUNICIPIUL BUCUREŞTI",179141,1169,889,759,130,0,869,20,1307,418,331,538
42,"SECTOR 1","#N/A",179141,,36,"BUCUREŞTI SECTORUL 1 / ŞCOALA GIMNAZIALĂ NR.7",1,16973,"MUNICIPIUL BUCUREŞTI",179141,1464,1170,916,252,2,1140,30,1600,430,444,696
42,"SECTOR 1","#N/A",179141,,37,"BUCUREŞTI SECTORUL 1 / ŞCOALA GIMNAZIALĂ NR.7",1,16973,"MUNICIPIUL BUCUREŞTI",179141,1572,1227,988,239,0,1199,28,1700,473,446,753
42,"SECTOR 1","#N/A",179141,,38,"BUCUREŞTI SECTORUL 1 / ŞCOALA GIMNAZIALĂ NR.7",1,16973,"MUNICIPIUL BUCUREŞTI",179141,1512,1153,971,182,0,1127,26,1700,547,413,714
42,"SECTOR 1","#N/A",179141,,39,"BUCUREŞTI SECTORUL 1 / COLEGIUL AGRICOL ""VIACESLAV HARNAJ""",1,16973,"MUNICIPIUL BUCUREŞTI",179141,1774,1430,1119,308,3,1392,38,2000,570,488,904
42,"SECTOR 1","#N/A",179141,,40,"BUCUREŞTI SECTORUL 1 / COLEGIUL AGRICOL ""VIACESLAV HARNAJ""",1,16973,"MUNICIPIUL BUCUREŞTI",179141,1948,1427,1216,209,2,1405,22,2001,574,456,949
42,"SECTOR 1","#N/A",179141,,41,"BUCUREŞTI SECTORUL 1 / ŞCOALA GIMNAZIALĂ ""HERĂSTRĂU""",1,16973,"MUNICIPIUL BUCUREŞTI",179141,1538,1117,998,118,1,1090,27,1700,583,378,712
42,"SECTOR 1","#N/A",179141,,42,"BUCUREŞTI SECTORUL 1 / ŞCOALA GIMNAZIALĂ ""HERĂSTRĂU""",1,16973,"MUNICIPIUL BUCUREŞTI",179141,958,721,620,101,0,705,16,1000,279,256,449
42,"SECTOR 1","#N/A",179141,,43,"BUCUREŞTI SECTORUL 1 / ŞCOALA GIMNAZIALĂ ""HERĂSTRĂU""",1,16973,"MUNICIPIUL BUCUREŞTI",179141,1380,1066,922,144,0,1049,17,1499,433,381,668
42,"SECTOR 1","#N/A",179141,,44,"BUCUREŞTI SECTORUL 1 / ŞCOALA GIMNAZIALĂ ""HERĂSTRĂU""",1,16973,"MUNICIPIUL BUCUREŞTI",179141,1427,1049,909,140,0,1024,25,1600,551,317,707
42,"SECTOR 1","#N/A",179141,,45,"BUCUREŞTI SECTORUL 1 / ŞCOALA GIMNAZIALĂ ""HERĂSTRĂU""",1,16973,"MUNICIPIUL BUCUREŞTI",179141,1602,1267,1015,251,1,1239,28,1800,533,471,768
42,"SECTOR 1","#N/A",179141,,46,"BUCUREŞTI SECTORUL 1 / ŞCOALA GIMNAZIALĂ ""HERĂSTRĂU""",1,16973,"MUNICIPIUL BUCUREŞTI",179141,839,701,537,164,0,682,19,900,199,230,452
42,"SECTOR 1","#N/A",179141,,47,"BUCUREŞTI SECTORUL 1 / ŞCOALA GIMNAZIALĂ ""HERĂSTRĂU""",1,16973,"MUNICIPIUL BUCUREŞTI",179141,1067,846,673,172,1,821,25,1200,354,284,537
42,"SECTOR 1","#N/A",179141,,48,"BUCUREŞTI SECTORUL 1 / ŞCOALA GIMNAZIALĂ ""HERĂSTRĂU""",1,16973,"MUNICIPIUL BUCUREŞTI",179141,1465,1092,903,189,0,1071,21,1600,508,393,678
42,"SECTOR 1","#N/A",179141,,49,"BUCUREŞTI SECTORUL 1 / ŞCOALA GIMNAZIALĂ ""HERĂSTRĂU""",1,16973,"MUNICIPIUL BUCUREŞTI",179141,1407,1060,979,81,0,1030,30,1500,440,377,653
42,"SECTOR 1","#N/A",179141,,50,"BUCUREŞTI SECTORUL 1 / ŞCOALA GIMNAZIALĂ ""HERĂSTRĂU""",1,16973,"MUNICIPIUL BUCUREŞTI",179141,1175,846,791,55,0,833,13,1300,454,282,551
42,"SECTOR 1","#N/A",179141,,51,"BUCUREŞTI SECTORUL 1 / ŞCOALA GIMNAZIALĂ ""HERĂSTRĂU""",1,16973,"MUNICIPIUL BUCUREŞTI",179141,1310,925,856,68,1,912,13,1400,475,379,533
42,"SECTOR 1","#N/A",179141,,52,"BUCUREŞTI SECTORUL 1 / ŞCOALA GIMNAZIALĂ ""HERĂSTRĂU""",1,16973,"MUNICIPIUL BUCUREŞTI",179141,1168,801,741,60,0,783,18,1300,499,274,509
42,"SECTOR 1","#N/A",179141,,53,"BUCUREŞTI SECTORUL 1 / ŞCOALA GIMNAZIALĂ ""PIA BRĂTIANU""",1,16973,"MUNICIPIUL BUCUREŞTI",179141,1324,1071,846,223,2,1051,20,1500,429,384,667
42,"SECTOR 1","#N/A",179141,,54,"BUCUREŞTI SECTORUL 1 / ŞCOALA GIMNAZIALĂ ""PIA BRĂTIANU""",1,16973,"MUNICIPIUL BUCUREŞTI",179141,1260,868,750,117,1,851,17,1399,531,320,531
42,"SECTOR 1","#N/A",179141,,55,"BUCUREŞTI SECTORUL 1 / COLEGIUL NAŢIONAL DE INFORMATICĂ ""TUDOR VIANU""",1,16973,"MUNICIPIUL BUCUREŞTI",179141,1230,965,791,143,31,948,17,1600,635,347,601
42,"SECTOR 1","#N/A",179141,,56,"BUCUREŞTI SECTORUL 1 / COLEGIUL NAŢIONAL DE INFORMATICĂ ""TUDOR VIANU""",1,16973,"MUNICIPIUL BUCUREŞTI",179141,1437,1271,1003,157,111,1247,24,1600,329,462,785
42,"SECTOR 1","#N/A",179141,,57,"BUCUREŞTI SECTORUL 1 / COLEGIUL NAŢIONAL DE INFORMATICĂ ""TUDOR VIANU""",1,16973,"MUNICIPIUL BUCUREŞTI",179141,1103,902,710,185,7,881,21,1200,298,310,571
42,"SECTOR 1","#N/A",179141,,58,"BUCUREŞTI SECTORUL 1 / COLEGIUL NAŢIONAL ""I.L. CARAGIALE""",1,16973,"MUNICIPIUL BUCUREŞTI",179141,1004,978,610,295,73,965,13,1200,222,352,613
42,"SECTOR 1","#N/A",179141,,59,"BUCUREŞTI SECTORUL 1 / COLEGIUL NAŢIONAL ""I.L. CARAGIALE""",1,16973,"MUNICIPIUL BUCUREŞTI",179141,1139,1050,741,308,1,1018,32,1300,250,403,615
42,"SECTOR 1","#N/A",179141,,60,"BUCUREŞTI SECTORUL 1 / ŞCOALA GIMNAZIALĂ ""TITU MAIORESCU""",1,16973,"MUNICIPIUL BUCUREŞTI",179141,1517,1178,962,215,1,1159,19,1700,522,485,674
42,"SECTOR 1","#N/A",179141,,61,"BUCUREŞTI SECTORUL 1 / ŞCOALA GIMNAZIALĂ ""TITU MAIORESCU""",1,16973,"MUNICIPIUL BUCUREŞTI",179141,1425,1110,925,180,5,1090,20,1600,490,401,689
42,"SECTOR 1","#N/A",179141,,62,"BUCUREŞTI SECTORUL 1 / LICEUL TEORETIC ""JEAN MONNET""",1,16973,"MUNICIPIUL BUCUREŞTI",179141,1431,1225,907,318,0,1200,25,1600,375,446,754
42,"SECTOR 1","#N/A",179141,,63,"BUCUREŞTI SECTORUL 1 / LICEUL TEORETIC ""JEAN MONNET""",1,16973,"MUNICIPIUL BUCUREŞTI",179141,1319,1072,808,263,1,1051,21,1500,428,420,631
42,"SECTOR 1","#N/A",179141,,64,"BUCUREŞTI SECTORUL 1 / COLEGIUL ECONOMIC ""V. MADGEARU""",1,16973,"MUNICIPIUL BUCUREŞTI",179141,1098,948,652,291,5,926,22,1200,252,298,628
42,"SECTOR 1","#N/A",179141,,65,"BUCUREŞTI SECTORUL 1 / COLEGIUL ECONOMIC ""V. MADGEARU""",1,16973,"MUNICIPIUL BUCUREŞTI",179141,1137,921,643,253,25,903,18,1315,394,320,583
42,"SECTOR 1","#N/A",179141,,66,"BUCUREŞTI SECTORUL 1 / ACADEMIA DE STUDII ECONOMICE DIN BUCUREŞTI",1,16973,"MUNICIPIUL BUCUREŞTI",179141,1069,868,557,311,0,848,20,1200,332,314,534
42,"SECTOR 1","#N/A",179141,,67,"BUCUREŞTI SECTORUL 1 / ACADEMIA DE STUDII ECONOMICE DIN BUCUREŞTI",1,16973,"MUNICIPIUL BUCUREŞTI",179141,730,800,394,406,0,787,13,1050,250,241,546
42,"SECTOR 1","#N/A",179141,,68,"BUCUREŞTI SECTORUL 1 / UNIVERSITATEA DE ARHITECTURĂ ŞI URBANISM ION MINCU",1,16973,"MUNICIPIUL BUCUREŞTI",179141,998,919,540,379,0,898,21,1100,181,304,594
42,"SECTOR 1","#N/A",179141,,69,"BUCUREŞTI SECTORUL 1 / UNIVERSITATEA DE ARHITECTURĂ ŞI URBANISM ION MINCU",1,16973,"MUNICIPIUL BUCUREŞTI",179141,1191,1043,588,455,0,1026,17,1300,257,275,751
42,"SECTOR 1","#N/A",179141,,70,"BUCUREŞTI SECTORUL 1 / ŞCOALA GIMNAZIALĂ NR.5",1,16973,"MUNICIPIUL BUCUREŞTI",179141,1216,906,664,241,1,886,20,1300,394,292,594
42,"SECTOR 1","#N/A",179141,,71,"BUCUREŞTI SECTORUL 1 / ŞCOALA GIMNAZIALĂ NR.5",1,16973,"MUNICIPIUL BUCUREŞTI",179141,758,668,426,239,3,659,9,800,132,225,434
42,"SECTOR 1","#N/A",179141,,72,"BUCUREŞTI SECTORUL 1 / COLEGIUL NAŢIONAL DE MUZICĂ ""GEORGE ENESCU""",1,16973,"MUNICIPIUL BUCUREŞTI",179141,1112,907,642,264,1,891,16,1200,293,316,575
42,"SECTOR 1","#N/A",179141,,73,"BUCUREŞTI SECTORUL 1 / COLEGIUL NAŢIONAL DE MUZICĂ ""GEORGE ENESCU""",1,16973,"MUNICIPIUL BUCUREŞTI",179141,1381,878,689,137,52,868,10,1500,622,300,568
42,"SECTOR 1","#N/A",179141,,74,"BUCUREŞTI SECTORUL 1 / COLEGIUL TEHNIC DE ARHITECTURĂ ŞI LUCRĂRI PUBLICE ""IOAN N. SOCOLESCU""",1,16973,"MUNICIPIUL BUCUREŞTI",179141,1068,781,571,210,0,768,13,1199,418,285,483
42,"SECTOR 1","#N/A",179141,,75,"BUCUREŞTI SECTORUL 1 / COLEGIUL NAŢIONAL ""SFÂNTUL SAVA""",1,16973,"MUNICIPIUL BUCUREŞTI",179141,854,600,431,165,4,591,9,909,309,210,381
42,"SECTOR 1","#N/A",179141,,76,"BUCUREŞTI SECTORUL 1 / COLEGIUL NAŢIONAL ""SFÂNTUL SAVA""",1,16973,"MUNICIPIUL BUCUREŞTI",179141,985,697,533,164,0,685,12,1100,403,224,461
42,"SECTOR 1","#N/A",179141,,77,"BUCUREŞTI SECTORUL 1 / COLEGIUL NAŢIONAL ""SFÂNTUL SAVA""",1,16973,"MUNICIPIUL BUCUREŞTI",179141,1153,696,615,81,0,685,11,1300,604,339,346
42,"SECTOR 1","#N/A",179141,,78,"BUCUREŞTI SECTORUL 1 / COLEGIUL NAŢIONAL ""SFÂNTUL SAVA""",1,16973,"MUNICIPIUL BUCUREŞTI",179141,1272,744,677,66,1,733,10,1398,654,260,473
42,"SECTOR 1","#N/A",179141,,79,"BUCUREŞTI SECTORUL 1 / UNIVERSITATEA NAŢIONALĂ DE MUZICĂ DIN BUCUREŞTI",1,16973,"MUNICIPIUL BUCUREŞTI",179141,1042,779,513,266,0,760,19,1100,321,269,491
42,"SECTOR 1","#N/A",179141,,80,"BUCUREŞTI SECTORUL 1 / UNIVERSITATEA NAŢIONALĂ DE MUZICĂ DIN BUCUREŞTI",1,16973,"MUNICIPIUL BUCUREŞTI",179141,1022,799,547,251,1,784,15,1100,301,268,516
42,"SECTOR 1","#N/A",179141,,81,"BUCUREŞTI SECTORUL 1 / LICEUL DE ARTE PLASTICE ""NICOLAE TONITZA""",1,16973,"MUNICIPIUL BUCUREŞTI",179141,725,416,361,55,0,407,9,800,384,191,216
42,"SECTOR 1","#N/A",179141,,82,"BUCUREŞTI SECTORUL 1 / LICEUL DE ARTE PLASTICE ""NICOLAE TONITZA""",1,16973,"MUNICIPIUL BUCUREŞTI",179141,826,545,451,94,0,536,9,901,356,215,321
42,"SECTOR 1","#N/A",179141,,83,"BUCUREŞTI SECTORUL 1 / LICEUL DE ARTE PLASTICE ""NICOLAE TONITZA""",1,16973,"MUNICIPIUL BUCUREŞTI",179141,1204,855,732,121,2,840,15,1300,445,313,527
42,"SECTOR 1","#N/A",179141,,84,"BUCUREŞTI SECTORUL 1 / LICEUL DE ARTE PLASTICE ""NICOLAE TONITZA""",1,16973,"MUNICIPIUL BUCUREŞTI",179141,1280,861,735,126,0,845,16,1400,539,340,505
42,"SECTOR 1","#N/A",179141,,85,"BUCUREŞTI SECTORUL 1 / LICEUL DE ARTE PLASTICE ""NICOLAE TONITZA""",1,16973,"MUNICIPIUL BUCUREŞTI",179141,1450,950,865,81,4,938,12,1600,650,381,557
42,"SECTOR 1","#N/A",179141,,86,"BUCUREŞTI SECTORUL 1 / CENTRUL NAŢIONAL DE CALIFICARE ŞI INSTRUIRE FEROVIARĂ CENAFER",1,16973,"MUNICIPIUL BUCUREŞTI",179141,1547,1666,848,817,1,1630,36,1952,286,510,1120
42,"SECTOR 1","#N/A",179141,,87,"BUCUREŞTI SECTORUL 1 / CENTRUL NAŢIONAL DE CALIFICARE ŞI INSTRUIRE FEROVIARĂ CENAFER",1,16973,"MUNICIPIUL BUCUREŞTI",179141,1291,878,760,118,0,858,20,1400,522,391,467
42,"SECTOR 1","#N/A",179141,,88,"BUCUREŞTI SECTORUL 1 / CENTRUL NAŢIONAL DE CALIFICARE ŞI INSTRUIRE FEROVIARĂ CENAFER",1,16973,"MUNICIPIUL BUCUREŞTI",179141,1485,1027,941,83,3,1004,23,1600,573,447,557
42,"SECTOR 1","#N/A",179141,,89,"BUCUREŞTI SECTORUL 1 / ŞCOALA GIMNAZIALĂ ""NICOLAE TITULESCU""",1,16973,"MUNICIPIUL BUCUREŞTI",179141,1331,958,758,179,21,944,14,1500,542,319,625
42,"SECTOR 1","#N/A",179141,,90,"BUCUREŞTI SECTORUL 1 / ŞCOALA GIMNAZIALĂ ""NICOLAE TITULESCU""",1,16973,"MUNICIPIUL BUCUREŞTI",179141,957,771,568,201,2,752,19,1000,229,259,493
42,"SECTOR 1","#N/A",179141,,91,"BUCUREŞTI SECTORUL 1 / ŞCOALA GIMNAZIALĂ ""NICOLAE TITULESCU""",1,16973,"MUNICIPIUL BUCUREŞTI",179141,1486,1186,986,200,0,1171,15,1600,414,445,726
42,"SECTOR 1","#N/A",179141,,92,"BUCUREŞTI SECTORUL 1 / ŞCOALA GIMNAZIALĂ ""NICOLAE TITULESCU""",1,16973,"MUNICIPIUL BUCUREŞTI",179141,1349,1077,870,206,1,1061,16,1500,423,458,603
42,"SECTOR 1","#N/A",179141,,93,"BUCUREŞTI SECTORUL 1 / ŞCOALA GIMNAZIALĂ ""NICOLAE TITULESCU""",1,16973,"MUNICIPIUL BUCUREŞTI",179141,1509,1199,1029,168,2,1182,17,1699,500,399,783
42,"SECTOR 1","#N/A",179141,,94,"BUCUREŞTI SECTORUL 1 / LICEUL TEORETIC ""ALEXANDRU VLAHUŢĂ""",1,16973,"MUNICIPIUL BUCUREŞTI",179141,1247,887,776,53,58,876,11,1400,513,360,516
42,"SECTOR 1","#N/A",179141,,95,"BUCUREŞTI SECTORUL 1 / LICEUL TEORETIC ""ALEXANDRU VLAHUŢĂ""",1,16973,"MUNICIPIUL BUCUREŞTI",179141,1507,1091,933,75,83,1067,24,1700,609,380,687
42,"SECTOR 1","#N/A",179141,,96,"BUCUREŞTI SECTORUL 1 / LICEUL TEORETIC ""ALEXANDRU VLAHUŢĂ""",1,16973,"MUNICIPIUL BUCUREŞTI",179141,1305,1003,785,128,90,982,21,1400,397,400,582
42,"SECTOR 1","#N/A",179141,,97,"BUCUREŞTI SECTORUL 1 / ŞCOALA GIMNAZIALĂ ""ELENA VĂCĂRESCU""",1,16973,"MUNICIPIUL BUCUREŞTI",179141,1346,848,670,176,2,827,21,1500,652,329,498
42,"SECTOR 1","#N/A",179141,,98,"BUCUREŞTI SECTORUL 1 / COLEGIUL GERMAN ""GOETHE""",1,16973,"MUNICIPIUL BUCUREŞTI",179141,1029,685,596,89,0,670,15,1100,415,252,418
42,"SECTOR 1","#N/A",179141,,99,"BUCUREŞTI SECTORUL 1 / COLEGIUL GERMAN ""GOETHE""",1,16973,"MUNICIPIUL BUCUREŞTI",179141,852,552,476,76,0,538,14,900,348,197,341
42,"SECTOR 1","#N/A",179141,,100,"BUCUREŞTI SECTORUL 1 / COLEGIUL GERMAN ""GOETHE""",1,16973,"MUNICIPIUL BUCUREŞTI",179141,928,580,529,51,0,565,15,1005,425,210,355
42,"SECTOR 1","#N/A",179141,,101,"BUCUREŞTI SECTORUL 1 / LICEUL TEORETIC BILINGV ""MIGUEL DE CERVANTES""",1,16973,"MUNICIPIUL BUCUREŞTI",179141,1093,761,592,169,0,746,15,1200,439,284,462
42,"SECTOR 1","#N/A",179141,,102,"BUCUREŞTI SECTORUL 1 / LICEUL TEORETIC BILINGV ""MIGUEL DE CERVANTES""",1,16973,"MUNICIPIUL BUCUREŞTI",179141,1069,667,530,137,0,647,20,1200,533,235,412
42,"SECTOR 1","#N/A",179141,,103,"BUCUREŞTI SECTORUL 1 / ŞCOALA GIMNAZIALĂ ""URUGUAY""",1,16973,"MUNICIPIUL BUCUREŞTI",179141,1128,749,579,101,69,735,14,1200,451,302,433
42,"SECTOR 1","#N/A",179141,,104,"BUCUREŞTI SECTORUL 1 / ŞCOALA GIMNAZIALĂ ""URUGUAY""",1,16973,"MUNICIPIUL BUCUREŞTI",179141,1336,773,600,150,23,756,17,1500,727,351,405
42,"SECTOR 1","#N/A",179141,,105,"BUCUREŞTI SECTORUL 1 / ŞCOALA GIMNAZIALĂ ""URUGUAY""",1,16973,"MUNICIPIUL BUCUREŞTI",179141,1010,705,570,64,71,696,9,1096,391,291,405
42,"SECTOR 1","#N/A",179141,,106,"BUCUREŞTI SECTORUL 1 / ŞCOALA GIMNAZIALĂ ""URUGUAY""",1,16973,"MUNICIPIUL BUCUREŞTI",179141,1516,1073,944,55,74,1052,21,1700,627,433,619
42,"SECTOR 1","#N/A",179141,,107,"BUCUREŞTI SECTORUL 1 / CLUBUL SPORTIV ŞCOLAR NR.5",1,16973,"MUNICIPIUL BUCUREŞTI",179141,994,739,526,213,0,716,23,1100,361,257,459
42,"SECTOR 1","#N/A",179141,,108,"BUCUREŞTI SECTORUL 1 / CLUBUL SPORTIV ŞCOLAR NR.5",1,16973,"MUNICIPIUL BUCUREŞTI",179141,1048,665,522,143,0,649,16,1100,435,239,410
42,"SECTOR 1","#N/A",179141,,109,"BUCUREŞTI SECTORUL 1 / ŞCOALA GIMNAZIALĂ ""SFINŢII VOIEVOZI""",1,16973,"MUNICIPIUL BUCUREŞTI",179141,1057,875,606,265,4,851,24,1200,325,349,502
42,"SECTOR 1","#N/A",179141,,110,"BUCUREŞTI SECTORUL 1 / ŞCOALA GIMNAZIALĂ ""SFINŢII VOIEVOZI""",1,16973,"MUNICIPIUL BUCUREŞTI",179141,954,733,537,196,0,719,14,1000,267,249,470
42,"SECTOR 1","#N/A",179141,,111,"BUCUREŞTI SECTORUL 1 / ŞCOALA GIMNAZIALĂ ""SFINŢII VOIEVOZI""",1,16973,"MUNICIPIUL BUCUREŞTI",179141,1092,782,624,156,2,769,13,1200,418,312,457
42,"SECTOR 1","#N/A",179141,,112,"BUCUREŞTI SECTORUL 1 / ŞCOALA GIMNAZIALĂ ""SFINŢII VOIEVOZI""",1,16973,"MUNICIPIUL BUCUREŞTI",179141,1524,973,865,106,2,950,23,1700,727,386,564
42,"SECTOR 1","#N/A",179141,,113,"BUCUREŞTI SECTORUL 1 / ŞCOALA GIMNAZIALĂ ""SFINŢII VOIEVOZI""",1,16973,"MUNICIPIUL BUCUREŞTI",179141,1109,751,603,70,78,732,19,1200,449,300,432
42,"SECTOR 1","#N/A",179141,,114,"BUCUREŞTI SECTORUL 1 / COLEGIUL NAŢIONAL ""ION NECULCE""",1,16973,"MUNICIPIUL BUCUREŞTI",179141,1591,1215,1051,163,1,1190,25,1700,485,441,749
42,"SECTOR 1","#N/A",179141,,115,"BUCUREŞTI SECTORUL 1 / COLEGIUL NAŢIONAL ""ION NECULCE""",1,16973,"MUNICIPIUL BUCUREŞTI",179141,1434,978,848,130,0,957,21,1600,622,334,623
42,"SECTOR 1","#N/A",179141,,116,"BUCUREŞTI SECTORUL 1 / COLEGIUL NAŢIONAL ""ION NECULCE""",1,16973,"MUNICIPIUL BUCUREŞTI",179141,1633,1154,933,101,120,1128,26,1800,646,441,687
42,"SECTOR 1","#N/A",179141,,117,"BUCUREŞTI SECTORUL 1 / COLEGIUL NAŢIONAL ""ION NECULCE""",1,16973,"MUNICIPIUL BUCUREŞTI",179141,1586,1091,996,74,21,1067,24,1698,607,380,687
42,"SECTOR 1","#N/A",179141,,118,"BUCUREŞTI SECTORUL 1 / COLEGIUL NAŢIONAL ""ION NECULCE""",1,16973,"MUNICIPIUL BUCUREŞTI",179141,1508,908,842,66,0,892,16,1449,541,358,534
42,"SECTOR 1","#N/A",179141,,119,"BUCUREŞTI SECTORUL 1 / ŞCOALA GIMNAZIALĂ ""GEO BOGZA""",1,16973,"MUNICIPIUL BUCUREŞTI",179141,1133,740,646,94,0,728,12,1200,460,262,466
42,"SECTOR 1","#N/A",179141,,120,"BUCUREŞTI SECTORUL 1 / ŞCOALA GIMNAZIALĂ ""GEO BOGZA""",1,16973,"MUNICIPIUL BUCUREŞTI",179141,1241,873,770,103,0,850,23,1400,527,345,505
42,"SECTOR 1","#N/A",179141,,121,"BUCUREŞTI SECTORUL 1 / ŞCOALA GIMNAZIALĂ ""GEO BOGZA""",1,16973,"MUNICIPIUL BUCUREŞTI",179141,905,709,624,85,0,700,9,1000,291,262,438
42,"SECTOR 1","#N/A",179141,,122,"BUCUREŞTI SECTORUL 1 / ŞCOALA GIMNAZIALĂ ""PETRE ISPIRESCU""",1,16973,"MUNICIPIUL BUCUREŞTI",179141,1468,1063,957,106,0,1043,20,1600,537,406,637
42,"SECTOR 1","#N/A",179141,,123,"BUCUREŞTI SECTORUL 1 / ŞCOALA GIMNAZIALĂ ""PETRE ISPIRESCU""",1,16973,"MUNICIPIUL BUCUREŞTI",179141,1496,1096,980,116,0,1070,26,1600,504,378,692
42,"SECTOR 1","#N/A",179141,,124,"BUCUREŞTI SECTORUL 1 / ŞCOALA GIMNAZIALĂ ""PETRE ISPIRESCU""",1,16973,"MUNICIPIUL BUCUREŞTI",179141,1395,912,862,50,0,896,16,1492,580,342,554
42,"SECTOR 1","#N/A",179141,,125,"BUCUREŞTI SECTORUL 1 / ŞCOALA GIMNAZIALĂ ""PETRE ISPIRESCU""",1,16973,"MUNICIPIUL BUCUREŞTI",179141,1091,763,711,51,1,745,18,1199,436,286,459
42,"SECTOR 1","#N/A",179141,,126,"BUCUREŞTI SECTORUL 1 / ŞCOALA GIMNAZIALĂ ""PETRE ISPIRESCU""",1,16973,"MUNICIPIUL BUCUREŞTI",179141,1069,726,647,79,0,711,15,1200,474,267,444
42,"SECTOR 1","#N/A",179141,,127,"BUCUREŞTI SECTORUL 1 / ŞCOALA GIMNAZIALĂ ""SF.NICOLAE""",1,16973,"MUNICIPIUL BUCUREŞTI",179141,1505,1083,957,125,1,1066,17,1600,517,438,628
42,"SECTOR 1","#N/A",179141,,128,"BUCUREŞTI SECTORUL 1 / ŞCOALA GIMNAZIALĂ ""SF.NICOLAE""",1,16973,"MUNICIPIUL BUCUREŞTI",179141,1316,882,770,111,1,869,13,1305,423,365,504
42,"SECTOR 1","#N/A",179141,,129,"BUCUREŞTI SECTORUL 1 / COLEGIUL NAŢIONAL ""AUREL VLAICU""",1,16973,"MUNICIPIUL BUCUREŞTI",179141,1202,827,771,56,0,812,15,1289,462,282,530
42,"SECTOR 1","#N/A",179141,,130,"BUCUREŞTI SECTORUL 1 / COLEGIUL NAŢIONAL ""AUREL VLAICU""",1,16973,"MUNICIPIUL BUCUREŞTI",179141,1201,868,816,50,2,850,18,1305,437,334,516
42,"SECTOR 1","#N/A",179141,,131,"BUCUREŞTI SECTORUL 1 / COLEGIUL NAŢIONAL ""AUREL VLAICU""",1,16973,"MUNICIPIUL BUCUREŞTI",179141,916,682,582,99,1,664,18,1001,319,260,404
42,"SECTOR 1","#N/A",179141,,132,"BUCUREŞTI SECTORUL 1 / COLEGIUL TEHNIC ""ION MIHALACHE""",1,16973,"MUNICIPIUL BUCUREŞTI",179141,1194,811,690,120,1,793,18,1300,489,353,440
42,"SECTOR 1","#N/A",179141,,133,"BUCUREŞTI SECTORUL 1 / COLEGIUL TEHNIC ""ION MIHALACHE""",1,16973,"MUNICIPIUL BUCUREŞTI",179141,1532,1047,920,126,1,1025,22,1700,653,435,590
42,"SECTOR 1","#N/A",179141,,134,"BUCUREŞTI SECTORUL 1 / COLEGIUL TEHNIC ""ION MIHALACHE""",1,16973,"MUNICIPIUL BUCUREŞTI",179141,1375,933,824,91,18,900,33,1500,567,411,489
42,"SECTOR 1","#N/A",179141,,135,"BUCUREŞTI SECTORUL 1 / COLEGIUL TEHNIC FEROVIAR ""MIHAI I""",1,16973,"MUNICIPIUL BUCUREŞTI",179141,1271,793,679,114,0,775,18,1400,607,378,397
42,"SECTOR 1","#N/A",179141,,136,"BUCUREŞTI SECTORUL 1 / COLEGIUL TEHNIC FEROVIAR ""MIHAI I""",1,16973,"MUNICIPIUL BUCUREŞTI",179141,1247,808,715,91,2,793,15,1420,612,397,396
42,"SECTOR 1","#N/A",179141,,137,"BUCUREŞTI SECTORUL 1 / ŞCOALA GIMNAZIALĂ NR.162",1,16973,"MUNICIPIUL BUCUREŞTI",179141,1238,856,752,104,0,842,14,1410,554,388,454
42,"SECTOR 1","#N/A",179141,,138,"BUCUREŞTI SECTORUL 1 / ŞCOALA GIMNAZIALĂ NR.162",1,16973,"MUNICIPIUL BUCUREŞTI",179141,1507,986,898,88,0,972,14,1700,714,480,492
42,"SECTOR 1","#N/A",179141,,139,"BUCUREŞTI SECTORUL 1 / ŞCOALA GIMNAZIALĂ ""ALEXANDRU COSTESCU"" NR.182",1,16973,"MUNICIPIUL BUCUREŞTI",179141,1327,896,831,65,0,884,12,1500,604,364,520
42,"SECTOR 1","#N/A",179141,,140,"BUCUREŞTI SECTORUL 1 / ŞCOALA GIMNAZIALĂ ""ALEXANDRU COSTESCU"" NR.182",1,16973,"MUNICIPIUL BUCUREŞTI",179141,1672,1095,1024,70,1,1068,27,1800,705,404,664
42,"SECTOR 1","#N/A",179141,,141,"BUCUREŞTI SECTORUL 1 / ŞCOALA GIMNAZIALĂ ""ALEXANDRU COSTESCU"" NR.182",1,16973,"MUNICIPIUL BUCUREŞTI",179141,1332,919,854,65,0,898,21,1500,581,369,529
42,"SECTOR 1","#N/A",179141,,142,"BUCUREŞTI SECTORUL 1 / ŞCOALA GIMNAZIALĂ ""ALEXANDRU COSTESCU"" NR.182",1,16973,"MUNICIPIUL BUCUREŞTI",179141,1414,883,816,67,0,866,17,1495,612,398,468
42,"SECTOR 1","#N/A",179141,,143,"BUCUREŞTI SECTORUL 1 / ŞCOALA GIMNAZIALĂ NR.183",1,16973,"MUNICIPIUL BUCUREŞTI",179141,1268,766,670,95,1,756,10,1400,634,313,443
42,"SECTOR 1","#N/A",179141,,144,"BUCUREŞTI SECTORUL 1 / ŞCOALA GIMNAZIALĂ NR.183",1,16973,"MUNICIPIUL BUCUREŞTI",179141,1308,764,713,51,0,755,9,1400,636,371,384
42,"SECTOR 1","#N/A",179141,,145,"BUCUREŞTI SECTORUL 1 / ŞCOALA GIMNAZIALĂ NR.183",1,16973,"MUNICIPIUL BUCUREŞTI",179141,1222,777,725,52,0,764,13,1300,523,346,418
42,"SECTOR 1","#N/A",179141,,146,"BUCUREŞTI SECTORUL 1 / ŞCOALA GIMNAZIALĂ NR.183",1,16973,"MUNICIPIUL BUCUREŞTI",179141,1463,933,852,81,0,909,24,1600,667,454,455
42,"SECTOR 1","#N/A",179141,,147,"BUCUREŞTI SECTORUL 1 / ŞCOALA GIMNAZIALĂ NR.183",1,16973,"MUNICIPIUL BUCUREŞTI",179141,1103,716,660,56,0,699,17,1199,483,289,410
42,"SECTOR 1","#N/A",179141,,148,"BUCUREŞTI SECTORUL 1 / ŞCOALA GIMNAZIALĂ NR.183",1,16973,"MUNICIPIUL BUCUREŞTI",179141,1480,930,895,35,0,912,18,1600,670,408,504
42,"SECTOR 1","#N/A",179141,,149,"BUCUREŞTI SECTORUL 1 / ŞCOALA GIMNAZIALĂ NR.183",1,16973,"MUNICIPIUL BUCUREŞTI",179141,1507,930,892,35,3,906,24,1700,770,406,500
42,"SECTOR 1","#N/A",179141,,150,"BUCUREŞTI SECTORUL 1 / ŞCOALA GIMNAZIALĂ NR.153",1,16973,"MUNICIPIUL BUCUREŞTI",179141,1485,745,688,57,0,719,26,1100,355,370,349
42,"SECTOR 1","#N/A",179141,,151,"BUCUREŞTI SECTORUL 1 / ŞCOALA GIMNAZIALĂ NR.184",1,16973,"MUNICIPIUL BUCUREŞTI",179141,1326,808,757,51,0,791,17,1500,692,370,421
42,"SECTOR 1","#N/A",179141,,152,"BUCUREŞTI SECTORUL 1 / ŞCOALA GIMNAZIALĂ NR.184",1,16973,"MUNICIPIUL BUCUREŞTI",179141,1587,929,841,88,0,903,26,1450,521,396,507
42,"SECTOR 1","#N/A",179141,,153,"BUCUREŞTI SECTORUL 1 / ŞCOALA GIMNAZIALĂ NR.184",1,16973,"MUNICIPIUL BUCUREŞTI",179141,1319,805,749,56,0,782,23,1400,595,362,420
42,"SECTOR 1","#N/A",179141,,154,"BUCUREŞTI SECTORUL 1 / ŞCOALA GIMNAZIALĂ NR.184",1,16973,"MUNICIPIUL BUCUREŞTI",179141,1297,796,725,71,0,783,13,1400,604,376,407
42,"SECTOR 1","#N/A",179141,,155,"BUCUREŞTI SECTORUL 1 / ŞCOALA GIMNAZIALĂ NR.184",1,16973,"MUNICIPIUL BUCUREŞTI",179141,1506,976,933,43,0,961,15,1600,624,423,538
42,"SECTOR 1","#N/A",179141,,156,"BUCUREŞTI SECTORUL 1 / ŞCOALA GIMNAZIALĂ NR.181",1,16973,"MUNICIPIUL BUCUREŞTI",179141,1212,865,769,96,0,843,22,1300,435,407,436
42,"SECTOR 1","#N/A",179141,,157,"BUCUREŞTI SECTORUL 1 / ŞCOALA GIMNAZIALĂ NR.181",1,16973,"MUNICIPIUL BUCUREŞTI",179141,1433,841,783,56,2,813,28,1600,759,396,417
42,"SECTOR 1","#N/A",179141,,158,"BUCUREŞTI SECTORUL 1 / ŞCOALA GIMNAZIALĂ NR.181",1,16973,"MUNICIPIUL BUCUREŞTI",179141,1346,834,758,76,0,810,24,1500,666,365,445
42,"SECTOR 1","#N/A",179141,,159,"BUCUREŞTI SECTORUL 1 / ŞCOALA GIMNAZIALĂ NR.181",1,16973,"MUNICIPIUL BUCUREŞTI",179141,1063,642,617,25,0,633,9,1200,558,294,339
42,"SECTOR 1","#N/A",179141,,160,"BUCUREŞTI SECTORUL 1 / SCOALA GIMNAZIALĂ NR. 192",1,16973,"MUNICIPIUL BUCUREŞTI",179141,1558,1176,960,216,0,1152,24,1700,524,477,675
42,"SECTOR 1","#N/A",179141,,161,"BUCUREŞTI SECTORUL 1 / ŞCOALA GIMNAZIALĂ NR.192",1,16973,"MUNICIPIUL BUCUREŞTI",179141,1345,1013,816,177,20,989,24,1509,496,387,602
42,"SECTOR 1","#N/A",179141,,162,"BUCUREŞTI SECTORUL 1 / ŞCOALA GIMNAZIALĂ NR.192",1,16973,"MUNICIPIUL BUCUREŞTI",179141,1430,1064,861,202,1,1050,14,1737,673,459,591
43,"SECTOR 2","#N/A",179150,,163,"BUCUREŞTI SECTORUL 2 / ŞCOALA GIMNAZIALĂ Nr. 28",1,16974,"MUNICIPIUL BUCUREŞTI",179150,1820,1265,1053,209,3,1246,19,1997,732,461,785
43,"SECTOR 2","#N/A",179150,,164,"BUCUREŞTI SECTORUL 2 / ŞCOALA GIMNAZIALĂ Nr. 28",1,16974,"MUNICIPIUL BUCUREŞTI",179150,1244,1029,809,171,49,1012,17,1597,568,362,650
43,"SECTOR 2","#N/A",179150,,165,"BUCUREŞTI SECTORUL 2 / ŞCOALA GIMNAZIALĂ Nr. 28",1,16974,"MUNICIPIUL BUCUREŞTI",179150,1485,1162,888,132,142,1133,29,1600,438,541,592
43,"SECTOR 2","#N/A",179150,,166,"BUCUREŞTI SECTORUL 2 / ŞCOALA GIMNAZIALĂ  ""MARIA ROSETTI""",1,16974,"MUNICIPIUL BUCUREŞTI",179150,1784,1307,1185,120,2,1281,26,2000,693,477,804
43,"SECTOR 2","#N/A",179150,,167,"BUCUREŞTI SECTORUL 2 / ŞCOALA GIMNAZIALĂ ""MARIA ROSETTI""",1,16974,"MUNICIPIUL BUCUREŞTI",179150,1021,783,641,139,3,767,16,1217,434,312,455
43,"SECTOR 2","#N/A",179150,,168,"BUCUREŞTI SECTORUL 2 / ŞCOALA GIMNAZIALĂ ""MARIA ROSETTI""",1,16974,"MUNICIPIUL BUCUREŞTI",179150,1002,743,586,156,1,725,18,1200,457,262,463
43,"SECTOR 2","#N/A",179150,,169,"BUCUREŞTI SECTORUL 2 / LICEUL TEORETIC    ""C.A. ROSETTI """,1,16974,"MUNICIPIUL BUCUREŞTI",179150,1182,816,714,100,2,790,26,1200,384,333,457
43,"SECTOR 2","#N/A",179150,,170,"BUCUREŞTI SECTORUL 2 / LICEUL TEORETIC    ""C.A. ROSETTI """,1,16974,"MUNICIPIUL BUCUREŞTI",179150,1543,1037,935,100,2,1016,21,1599,562,395,621
43,"SECTOR 2","#N/A",179150,,171,"BUCUREŞTI SECTORUL 2 / LICEUL TEORETIC    ""C.A. ROSETTI """,1,16974,"MUNICIPIUL BUCUREŞTI",179150,1525,992,896,96,0,968,24,1600,608,366,602
43,"SECTOR 2","#N/A",179150,,172,"BUCUREŞTI SECTORUL 2 / COLEGIUL  TEHNIC ""TRAIAN""",1,16974,"MUNICIPIUL BUCUREŞTI",179150,1987,1446,1221,225,0,1416,30,2200,754,529,887
43,"SECTOR 2","#N/A",179150,,173,"BUCUREŞTI SECTORUL 2 / COLEGIUL  TEHNIC ""TRAIAN""",1,16974,"MUNICIPIUL BUCUREŞTI",179150,1970,1288,1227,60,1,1257,31,2000,712,506,751
43,"SECTOR 2","#N/A",179150,,174,"BUCUREŞTI SECTORUL 2 / COLEGIUL  TEHNIC ""TRAIAN""",1,16974,"MUNICIPIUL BUCUREŞTI",179150,1995,1233,1167,66,0,1213,20,2200,967,497,716
43,"SECTOR 2","#N/A",179150,,175,"BUCUREŞTI SECTORUL 2 / COLEGIUL  TEHNIC ""TRAIAN""",1,16974,"MUNICIPIUL BUCUREŞTI",179150,1969,1308,1226,82,0,1292,16,2000,692,500,792
43,"SECTOR 2","#N/A",179150,,176,"BUCUREŞTI SECTORUL 2 / ŞCOALA GIMNAZIALĂ Nr. 31",1,16974,"MUNICIPIUL BUCUREŞTI",179150,1610,1371,1026,320,25,1351,20,2400,1029,587,764
43,"SECTOR 2","#N/A",179150,,177,"BUCUREŞTI SECTORUL 2 / ŞCOALA GIMNAZIALĂ Nr. 31",1,16974,"MUNICIPIUL BUCUREŞTI",179150,1904,1369,1115,232,22,1332,37,2400,1031,566,766
43,"SECTOR 2","#N/A",179150,,178,"BUCUREŞTI SECTORUL 2 / ŞCOALA GIMNAZIALĂ Nr. 31",1,16974,"MUNICIPIUL BUCUREŞTI",179150,1849,1323,1064,259,0,1295,28,2000,677,492,803
43,"SECTOR 2","#N/A",179150,,179,"BUCUREŞTI SECTORUL 2 / ŞCOALA GIMNAZIALĂ Nr. 31",1,16974,"MUNICIPIUL BUCUREŞTI",179150,1814,1320,1054,262,4,1287,33,2400,1080,454,833
43,"SECTOR 2","#N/A",179150,,180,"BUCUREŞTI SECTORUL 2 / ŞCOALA GIMNAZIALĂ Nr. 31",1,16974,"MUNICIPIUL BUCUREŞTI",179150,1877,1264,1043,221,0,1245,19,1999,735,459,786
43,"SECTOR 2","#N/A",179150,,181,"BUCUREŞTI SECTORUL 2 / UNIVERSITATEA TEHNICĂ DE CONSTRUCŢII BUCUREŞTI",1,16974,"MUNICIPIUL BUCUREŞTI",179150,1830,1342,1199,143,0,1320,22,2000,658,506,814
43,"SECTOR 2","#N/A",179150,,182,"BUCUREŞTI SECTORUL 2 / UNIVERSITATEA TEHNICĂ DE CONSTRUCŢII BUCUREŞTI",1,16974,"MUNICIPIUL BUCUREŞTI",179150,1892,1142,1017,124,1,1121,21,2000,858,517,604
43,"SECTOR 2","#N/A",179150,,183,"BUCUREŞTI SECTORUL 2 / UNIVERSITATEA TEHNICĂ DE CONSTRUCŢII BUCUREŞTI",1,16974,"MUNICIPIUL BUCUREŞTI",179150,1622,1160,894,266,0,1131,29,2400,1240,463,668
43,"SECTOR 2","#N/A",179150,,184,"BUCUREŞTI SECTORUL 2 / UNIVERSITATEA TEHNICĂ DE CONSTRUCŢII BUCUREŞTI",1,16974,"MUNICIPIUL BUCUREŞTI",179150,1798,1136,999,137,0,1112,24,2000,864,424,688
43,"SECTOR 2","#N/A",179150,,185,"BUCUREŞTI SECTORUL 2 / UNIVERSITATEA TEHNICĂ DE CONSTRUCŢII BUCUREŞTI",1,16974,"MUNICIPIUL BUCUREŞTI",179150,1865,1221,1123,97,1,1193,28,2000,779,492,701
43,"SECTOR 2","#N/A",179150,,186,"BUCUREŞTI SECTORUL 2 / UNIVERSITATEA TEHNICĂ DE CONSTRUCŢII BUCUREŞTI",1,16974,"MUNICIPIUL BUCUREŞTI",179150,1958,1414,1120,294,0,1386,28,2400,986,533,853
43,"SECTOR 2","#N/A",179150,,187,"BUCUREŞTI SECTORUL 2 / UNIVERSITATEA TEHNICĂ DE CONSTRUCŢII BUCUREŞTI",1,16974,"MUNICIPIUL BUCUREŞTI",179150,1663,1043,957,84,2,1007,36,1999,956,414,593
43,"SECTOR 2","#N/A",179150,,188,"BUCUREŞTI SECTORUL 2 / UNIVERSITATEA TEHNICĂ DE CONSTRUCŢII BUCUREŞTI",1,16974,"MUNICIPIUL BUCUREŞTI",179150,1261,668,601,67,0,647,21,2000,1332,284,363
43,"SECTOR 2","#N/A",179150,,189,"BUCUREŞTI SECTORUL 2 / UNIVERSITATEA TEHNICĂ DE CONSTRUCŢII BUCUREŞTI",1,16974,"MUNICIPIUL BUCUREŞTI",179150,1769,1445,1109,333,3,1422,23,2399,954,535,887
43,"SECTOR 2","#N/A",179150,,190,"BUCUREŞTI SECTORUL 2 / UNIVERSITATEA TEHNICĂ DE CONSTRUCŢII BUCUREŞTI",1,16974,"MUNICIPIUL BUCUREŞTI",179150,1724,1142,894,247,1,1117,25,2400,1258,478,639
43,"SECTOR 2","#N/A",179150,,191,"BUCUREŞTI SECTORUL 2 / LICEUL TEHNOLOGIC CONSTANTIN BRÂNCUŞI",1,16974,"MUNICIPIUL BUCUREŞTI",179150,828,629,369,260,0,625,4,1000,371,186,439
43,"SECTOR 2","#N/A",179150,,192,"BUCUREŞTI SECTORUL 2 / ŞCOALA GIMNAZIALĂ Nr. 27",1,16974,"MUNICIPIUL BUCUREŞTI",179150,1734,1091,830,261,0,1069,22,2400,1309,428,641
43,"SECTOR 2","#N/A",179150,,193,"BUCUREŞTI SECTORUL 2 / ŞCOALA GIMNAZIALĂ Nr. 27",1,16974,"MUNICIPIUL BUCUREŞTI",179150,1629,1235,1005,230,0,1219,16,1800,565,505,714
43,"SECTOR 2","#N/A",179150,,194,"BUCUREŞTI SECTORUL 2 / ŞCOALA GIMNAZIALĂ Nr. 27",1,16974,"MUNICIPIUL BUCUREŞTI",179150,1341,984,779,203,2,965,19,1400,416,399,566
43,"SECTOR 2","#N/A",179150,,195,"BUCUREŞTI SECTORUL 2 / ŞCOALA GIMNAZIALĂ Nr. 27",1,16974,"MUNICIPIUL BUCUREŞTI",179150,1402,1050,855,195,0,1025,25,1600,550,415,610
43,"SECTOR 2","#N/A",179150,,196,"BUCUREŞTI SECTORUL 2 / ŞCOALA GIMNAZIALĂ Nr. 27",1,16974,"MUNICIPIUL BUCUREŞTI",179150,1150,896,724,168,4,878,18,1200,304,315,563
43,"SECTOR 2","#N/A",179150,,197,"BUCUREŞTI SECTORUL 2 / ŞCOALA GIMNAZIALĂ ""GRIGORE GHICA VOIEVOD""",1,16974,"MUNICIPIUL BUCUREŞTI",179150,1832,1323,1138,185,0,1293,30,1999,676,483,810
43,"SECTOR 2","#N/A",179150,,198,"BUCUREŞTI SECTORUL 2 / ŞCOALA GIMNAZIALĂ ""GRIGORE GHICA VOIEVOD""",1,16974,"MUNICIPIUL BUCUREŞTI",179150,1607,1089,982,107,0,1066,23,1800,711,440,626
43,"SECTOR 2","#N/A",179150,,199,"BUCUREŞTI SECTORUL 2 / ŞCOALA GIMNAZIALĂ ""GRIGORE GHICA VOIEVOD""",1,16974,"MUNICIPIUL BUCUREŞTI",179150,1973,1328,1193,135,0,1303,25,2000,672,597,706
43,"SECTOR 2","#N/A",179150,,200,"BUCUREŞTI SECTORUL 2 / ŞCOALA GIMNAZIALĂ ""GRIGORE GHICA VOIEVOD""",1,16974,"MUNICIPIUL BUCUREŞTI",179150,1941,1247,1124,121,2,1215,32,2000,753,569,646
43,"SECTOR 2","#N/A",179150,,201,"BUCUREŞTI SECTORUL 2 / ŞCOALA GIMNAZIALĂ ""GRIGORE GHICA VOIEVOD""",1,16974,"MUNICIPIUL BUCUREŞTI",179150,1743,1247,1104,142,1,1229,18,1800,553,514,715
43,"SECTOR 2","#N/A",179150,,202,"BUCUREŞTI SECTORUL 2 / ŞCOALA GIMNAZIALĂ ""GRIGORE GHICA VOIEVOD""",1,16974,"MUNICIPIUL BUCUREŞTI",179150,1528,1034,902,131,1,999,35,1600,566,442,557
43,"SECTOR 2","#N/A",179150,,203,"BUCUREŞTI SECTORUL 2 / ŞCOALA GIMNAZIALĂ ""GRIGORE GHICA VOIEVOD""",1,16974,"MUNICIPIUL BUCUREŞTI",179150,1857,991,916,74,1,966,25,2000,1009,441,525
43,"SECTOR 2","#N/A",179150,,204,"BUCUREŞTI SECTORUL 2 / GRĂDINIŢA Nr. 233",1,16974,"MUNICIPIUL BUCUREŞTI",179150,1468,1034,901,133,0,1015,19,1600,566,424,591
43,"SECTOR 2","#N/A",179150,,205,"BUCUREŞTI SECTORUL 2 / GRĂDINIŢA Nr. 233",1,16974,"MUNICIPIUL BUCUREŞTI",179150,1335,937,858,77,2,919,18,1400,463,399,520
43,"SECTOR 2","#N/A",179150,,206,"BUCUREŞTI SECTORUL 2 / ŞCOALA GIMNAZIALĂ Nr. 39",1,16974,"MUNICIPIUL BUCUREŞTI",179150,1632,1214,1057,157,0,1186,28,1800,586,489,697
43,"SECTOR 2","#N/A",179150,,207,"BUCUREŞTI SECTORUL 2 / ŞCOALA GIMNAZIALĂ Nr. 39",1,16974,"MUNICIPIUL BUCUREŞTI",179150,1482,996,904,91,1,975,21,1600,604,415,560
43,"SECTOR 2","#N/A",179150,,208,"BUCUREŞTI SECTORUL 2 / ŞCOALA GIMNAZIALĂ Nr. 39",1,16974,"MUNICIPIUL BUCUREŞTI",179150,1654,1013,867,144,2,998,15,1800,787,425,573
43,"SECTOR 2","#N/A",179150,,209,"BUCUREŞTI SECTORUL 2 / ŞCOALA GIMNAZIALĂ Nr. 39",1,16974,"MUNICIPIUL BUCUREŞTI",179150,1612,1047,963,84,0,1024,23,1800,753,431,593
43,"SECTOR 2","#N/A",179150,,210,"BUCUREŞTI SECTORUL 2 / ŞCOALA GIMNAZIALĂ Nr. 39",1,16974,"MUNICIPIUL BUCUREŞTI",179150,1668,1143,1041,102,0,1111,29,1800,657,455,656
43,"SECTOR 2","#N/A",179150,,211,"BUCUREŞTI SECTORUL 2 / ŞCOALA GIMNAZIALĂ Nr. 39",1,16974,"MUNICIPIUL BUCUREŞTI",179150,1638,995,945,50,0,970,25,1800,805,468,502
43,"SECTOR 2","#N/A",179150,,212,"BUCUREŞTI SECTORUL 2 / ŞCOALA GIMNAZIALĂ Nr. 39",1,16974,"MUNICIPIUL BUCUREŞTI",179150,1654,994,926,67,1,982,12,1800,806,458,524
43,"SECTOR 2","#N/A",179150,,213,"BUCUREŞTI SECTORUL 2 / ŞCOALA GIMNAZIALĂ Nr. 40",1,16974,"MUNICIPIUL BUCUREŞTI",179150,1673,1021,970,51,0,999,22,1800,779,479,520
43,"SECTOR 2","#N/A",179150,,214,"BUCUREŞTI SECTORUL 2 / ŞCOALA GIMNAZIALĂ  Nr. 40",1,16974,"MUNICIPIUL BUCUREŞTI",179150,1928,1086,1037,49,0,1064,22,2000,914,527,537
43,"SECTOR 2","#N/A",179150,,215,"BUCUREŞTI SECTORUL 2 / ŞCOALA GIMNAZIALĂ Nr. 40",1,16974,"MUNICIPIUL BUCUREŞTI",179150,1794,1097,1046,51,0,1070,27,2000,903,543,527
43,"SECTOR 2","#N/A",179150,,216,"BUCUREŞTI SECTORUL 2 / ŞCOALA GIMNAZIALĂ Nr. 40",1,16974,"MUNICIPIUL BUCUREŞTI",179150,1721,1091,1048,43,0,1075,16,1800,709,514,561
43,"SECTOR 2","#N/A",179150,,217,"BUCUREŞTI SECTORUL 2 / ŞCOALA GIMNAZIALĂ Nr. 40",1,16974,"MUNICIPIUL BUCUREŞTI",179150,1618,941,866,75,0,919,22,1800,859,458,461
43,"SECTOR 2","#N/A",179150,,218,"BUCUREŞTI SECTORUL 2 / ŞCOALA GIMNAZIALĂ Nr. 40",1,16974,"MUNICIPIUL BUCUREŞTI",179150,1958,1178,1135,43,0,1146,32,2000,822,565,581
43,"SECTOR 2","#N/A",179150,,219,"BUCUREŞTI SECTORUL 2 / ŞCOALA GIMNAZIALĂ Nr. 41",1,16974,"MUNICIPIUL BUCUREŞTI",179150,1624,995,911,84,0,969,26,1800,805,552,417
43,"SECTOR 2","#N/A",179150,,220,"BUCUREŞTI SECTORUL 2 / ŞCOALA GIMNAZIALĂ Nr. 41",1,16974,"MUNICIPIUL BUCUREŞTI",179150,1966,1144,1083,60,1,1119,25,2000,856,592,527
43,"SECTOR 2","#N/A",179150,,221,"BUCUREŞTI SECTORUL 2 / ŞCOALA GIMNAZIALĂ Nr. 41",1,16974,"MUNICIPIUL BUCUREŞTI",179150,1959,1201,1151,50,0,1165,36,2000,799,596,569
43,"SECTOR 2","#N/A",179150,,222,"BUCUREŞTI SECTORUL 2 / ŞCOALA GIMNAZIALĂ Nr. 32",1,16974,"MUNICIPIUL BUCUREŞTI",179150,1715,1080,959,74,47,1061,19,1800,720,505,556
43,"SECTOR 2","#N/A",179150,,223,"BUCUREŞTI SECTORUL 2 / ŞCOALA GIMNAZIALĂ Nr. 32",1,16974,"MUNICIPIUL BUCUREŞTI",179150,1693,1186,1053,84,49,1154,32,1800,614,518,636
43,"SECTOR 2","#N/A",179150,,224,"BUCUREŞTI SECTORUL 2 / ŞCOALA GIMNAZIALĂ Nr. 32",1,16974,"MUNICIPIUL BUCUREŞTI",179150,1690,1080,938,78,64,1062,18,1800,720,502,560
43,"SECTOR 2","#N/A",179150,,225,"BUCUREŞTI SECTORUL 2 / ŞCOALA GIMNAZIALĂ Nr. 32",1,16974,"MUNICIPIUL BUCUREŞTI",179150,1734,1092,976,60,56,1071,21,2000,908,510,561
43,"SECTOR 2","#N/A",179150,,226,"BUCUREŞTI SECTORUL 2 / ŞCOALA GIMNAZIALĂ Nr. 32",1,16974,"MUNICIPIUL BUCUREŞTI",179150,1258,847,732,76,39,833,14,1400,553,394,439
43,"SECTOR 2","#N/A",179150,,227,"BUCUREŞTI SECTORUL 2 / COLEGIUL NAŢIONAL   ""VICTOR BABEŞ""",1,16974,"MUNICIPIUL BUCUREŞTI",179150,1916,1241,981,92,168,1230,11,2000,759,580,650
43,"SECTOR 2","#N/A",179150,,228,"BUCUREŞTI SECTORUL 2 / COLEGIUL NAŢIONAL   ""VICTOR BABEŞ""",1,16974,"MUNICIPIUL BUCUREŞTI",179150,1826,1143,982,99,62,1120,23,2000,857,481,639
43,"SECTOR 2","#N/A",179150,,229,"BUCUREŞTI SECTORUL 2 / COLEGIUL NAŢIONAL   ""VICTOR BABEŞ""",1,16974,"MUNICIPIUL BUCUREŞTI",179150,1946,1308,1141,107,60,1271,37,2000,692,540,731
43,"SECTOR 2","#N/A",179150,,230,"BUCUREŞTI SECTORUL 2 / COLEGIUL NAŢIONAL   ""VICTOR BABEŞ""",1,16974,"MUNICIPIUL BUCUREŞTI",179150,1938,1133,1007,67,59,1121,12,2000,867,547,574
43,"SECTOR 2","#N/A",179150,,231,"BUCUREŞTI SECTORUL 2 / ŞCOALA GIMNAZIALĂ Nr.  25 ( fosta GRĂDINITĂ  Nr. 11)",1,16974,"MUNICIPIUL BUCUREŞTI",179150,1828,1128,1024,102,2,1104,24,2008,880,548,556
43,"SECTOR 2","#N/A",179150,,232,"BUCUREŞTI SECTORUL 2 / ŞCOALA GIMNAZIALĂ Nr.  25 ( fosta GRĂDINITĂ  Nr. 11)",1,16974,"MUNICIPIUL BUCUREŞTI",179150,1666,1002,930,72,0,979,23,1822,820,492,487
43,"SECTOR 2","#N/A",179150,,233,"BUCUREŞTI SECTORUL 2 / ŞCOALA GIMNAZIALĂ Nr. 145",1,16974,"MUNICIPIUL BUCUREŞTI",179150,1856,976,912,63,1,943,33,1999,1023,428,515
43,"SECTOR 2","#N/A",179150,,234,"BUCUREŞTI SECTORUL 2 / ŞCOALA GIMNAZIALĂ Nr. 145",1,16974,"MUNICIPIUL BUCUREŞTI",179150,1620,994,944,50,0,976,18,1800,806,377,599
43,"SECTOR 2","#N/A",179150,,235,"BUCUREŞTI SECTORUL 2 / ŞCOALA GIMNAZIALĂ Nr. 145",1,16974,"MUNICIPIUL BUCUREŞTI",179150,1762,1012,957,53,2,992,20,1800,788,476,516
43,"SECTOR 2","#N/A",179150,,236,"BUCUREŞTI SECTORUL 2 / ŞCOALA GIMNAZIALĂ Nr. 145",1,16974,"MUNICIPIUL BUCUREŞTI",179150,1920,967,891,76,0,948,19,2000,1033,461,487
43,"SECTOR 2","#N/A",179150,,237,"BUCUREŞTI SECTORUL 2 / ŞCOALA GIMNAZIALĂ Nr. 145",1,16974,"MUNICIPIUL BUCUREŞTI",179150,1704,1061,977,83,1,1037,24,1800,739,408,629
43,"SECTOR 2","#N/A",179150,,238,"BUCUREŞTI SECTORUL 2 / ŞCOALA GIMNAZIALĂ Nr. 145",1,16974,"MUNICIPIUL BUCUREŞTI",179150,1631,1090,942,148,0,1068,22,1801,711,443,625
43,"SECTOR 2","#N/A",179150,,239,"BUCUREŞTI SECTORUL 2 / ŞCOALA GIMNAZIALĂ Nr. 145",1,16974,"MUNICIPIUL BUCUREŞTI",179150,1783,991,941,49,1,972,19,2000,1009,451,521
43,"SECTOR 2","#N/A",179150,,240,"BUCUREŞTI SECTORUL 2 / ŞCOALA GIMNAZIALĂ Nr. 145",1,16974,"MUNICIPIUL BUCUREŞTI",179150,1663,810,774,36,0,785,25,1800,990,440,345
43,"SECTOR 2","#N/A",179150,,241,"BUCUREŞTI SECTORUL 2 / ŞCOALA GIMNAZIALĂ  Nr. 62",1,16974,"MUNICIPIUL BUCUREŞTI",179150,1706,1051,977,74,0,1022,29,1800,749,522,500
43,"SECTOR 2","#N/A",179150,,242,"BUCUREŞTI SECTORUL 2 / ŞCOALA GIMNAZIALĂ  Nr. 62",1,16974,"MUNICIPIUL BUCUREŞTI",179150,1362,753,705,48,0,730,23,1399,646,375,355
43,"SECTOR 2","#N/A",179150,,243,"BUCUREŞTI SECTORUL 2 / ŞCOALA GIMNAZIALĂ  Nr. 62",1,16974,"MUNICIPIUL BUCUREŞTI",179150,1420,929,864,65,0,916,13,1600,671,426,490
43,"SECTOR 2","#N/A",179150,,244,"BUCUREŞTI SECTORUL 2 / ŞCOALA GIMNAZIALĂ  Nr. 62",1,16974,"MUNICIPIUL BUCUREŞTI",179150,1588,994,945,49,0,970,24,1800,806,455,515
43,"SECTOR 2","#N/A",179150,,245,"BUCUREŞTI SECTORUL 2 / ŞCOALA GIMNAZIALĂ  Nr. 62",1,16974,"MUNICIPIUL BUCUREŞTI",179150,1521,879,822,57,0,852,27,1600,721,358,494
43,"SECTOR 2","#N/A",179150,,246,"BUCUREŞTI SECTORUL 2 / ŞCOALA GIMNAZIALĂ  Nr. 62",1,16974,"MUNICIPIUL BUCUREŞTI",179150,1402,948,865,83,0,919,29,1600,652,445,474
43,"SECTOR 2","#N/A",179150,,247,"BUCUREŞTI SECTORUL 2 / ŞCOALA GIMNAZIALĂ  Nr. 62",1,16974,"MUNICIPIUL BUCUREŞTI",179150,1200,736,680,56,0,720,16,1400,664,365,355
43,"SECTOR 2","#N/A",179150,,248,"BUCUREŞTI SECTORUL 2 / LICEUL TEHNOLOGIC  ""SF. PANTELIMON""",1,16974,"MUNICIPIUL BUCUREŞTI",179150,1934,1309,1239,69,1,1280,29,1984,675,517,763
43,"SECTOR 2","#N/A",179150,,249,"BUCUREŞTI SECTORUL 2 / LICEUL TEHNOLOGIC  ""SF. PANTELIMON""",1,16974,"MUNICIPIUL BUCUREŞTI",179150,1405,1006,903,102,1,994,12,1600,594,384,610
43,"SECTOR 2","#N/A",179150,,250,"BUCUREŞTI SECTORUL 2 / LICEUL TEHNOLOGIC  ""SF. PANTELIMON""",1,16974,"MUNICIPIUL BUCUREŞTI",179150,1412,947,869,78,0,933,14,1584,637,405,528
43,"SECTOR 2","#N/A",179150,,251,"BUCUREŞTI SECTORUL 2 / LICEUL TEHNOLOGIC  ""SF. PANTELIMON""",1,16974,"MUNICIPIUL BUCUREŞTI",179150,1695,1083,1048,33,2,1060,23,1783,700,418,642
43,"SECTOR 2","#N/A",179150,,252,"BUCUREŞTI SECTORUL 2 / ŞCOALA GIMNAZIALĂ NR. 51",1,16974,"MUNICIPIUL BUCUREŞTI",179150,1566,1115,986,127,2,1095,20,1600,485,475,620
43,"SECTOR 2","#N/A",179150,,253,"BUCUREŞTI SECTORUL 2 / ŞCOALA GIMNAZIALĂ NR. 51",1,16974,"MUNICIPIUL BUCUREŞTI",179150,1592,929,763,164,2,906,23,1800,871,398,508
43,"SECTOR 2","#N/A",179150,,254,"BUCUREŞTI SECTORUL 2 / ŞCOALA GIMNAZIALĂ NR. 51",1,16974,"MUNICIPIUL BUCUREŞTI",179150,1463,1024,931,93,0,995,29,1584,560,491,504
43,"SECTOR 2","#N/A",179150,,255,"BUCUREŞTI SECTORUL 2 / GRADINIŢA Nr. 280",1,16974,"MUNICIPIUL BUCUREŞTI",179150,1379,895,807,86,2,874,21,1600,705,359,515
43,"SECTOR 2","#N/A",179150,,256,"BUCUREŞTI SECTORUL 2 / GRADINIŢA Nr. 280",1,16974,"MUNICIPIUL BUCUREŞTI",179150,1727,1044,983,60,1,1027,17,1798,754,467,560
43,"SECTOR 2","#N/A",179150,,257,"BUCUREŞTI SECTORUL 2 / ŞCOALA GIMNAZIALĂ Nr. 77",1,16974,"MUNICIPIUL BUCUREŞTI",179150,1535,1011,861,112,38,985,26,1600,589,465,520
43,"SECTOR 2","#N/A",179150,,258,"BUCUREŞTI SECTORUL 2 / ŞCOALA GIMNAZIALĂ Nr. 77",1,16974,"MUNICIPIUL BUCUREŞTI",179150,1545,1044,947,58,39,1019,25,1584,540,482,537
43,"SECTOR 2","#N/A",179150,,259,"BUCUREŞTI SECTORUL 2 / ŞCOALA GIMNAZIALĂ Nr. 77",1,16974,"MUNICIPIUL BUCUREŞTI",179150,1624,1106,1039,32,35,1074,32,1800,694,531,543
43,"SECTOR 2","#N/A",179150,,260,"BUCUREŞTI SECTORUL 2 / ŞCOALA GIMNAZIALĂ Nr. 77",1,16974,"MUNICIPIUL BUCUREŞTI",179150,1572,1056,994,62,0,1026,30,1600,544,473,553
43,"SECTOR 2","#N/A",179150,,261,"BUCUREŞTI SECTORUL 2 / ŞCOALA GIMNAZIALĂ Nr. 77",1,16974,"MUNICIPIUL BUCUREŞTI",179150,1893,1160,1090,70,0,1127,33,1972,812,620,507
43,"SECTOR 2","#N/A",179150,,262,"BUCUREŞTI SECTORUL 2 / ŞCOALA GIMNAZIALĂ Nr. 77",1,16974,"MUNICIPIUL BUCUREŞTI",179150,1618,1015,964,51,0,988,27,1800,785,492,496
43,"SECTOR 2","#N/A",179150,,263,"BUCUREŞTI SECTORUL 2 / LICEUL TEORETIC  ""LUCIAN BLAGA""",1,16974,"MUNICIPIUL BUCUREŞTI",179150,1702,1083,953,130,0,1064,19,1800,717,473,591
43,"SECTOR 2","#N/A",179150,,264,"BUCUREŞTI SECTORUL 2 / LICEUL TEORETIC  ""LUCIAN BLAGA""",1,16974,"MUNICIPIUL BUCUREŞTI",179150,1928,854,795,59,0,837,17,2000,1146,409,428
43,"SECTOR 2","#N/A",179150,,265,"BUCUREŞTI SECTORUL 2 / LICEUL TEORETIC  ""LUCIAN BLAGA""",1,16974,"MUNICIPIUL BUCUREŞTI",179150,1885,1208,1132,76,0,1178,30,2000,792,570,608
43,"SECTOR 2","#N/A",179150,,266,"BUCUREŞTI SECTORUL 2 / LICEUL TEORETIC  ""LUCIAN BLAGA""",1,16974,"MUNICIPIUL BUCUREŞTI",179150,1914,1013,977,36,0,987,26,2000,987,505,482
43,"SECTOR 2","#N/A",179150,,267,"BUCUREŞTI SECTORUL 2 / LICEUL TEORETIC  ""LUCIAN BLAGA""",1,16974,"MUNICIPIUL BUCUREŞTI",179150,1963,1156,1101,53,2,1130,26,2000,844,574,556
43,"SECTOR 2","#N/A",179150,,268,"BUCUREŞTI SECTORUL 2 / ŞCOALA GIMNAZIALĂ Nr. 66",1,16974,"MUNICIPIUL BUCUREŞTI",179150,1891,1121,1041,52,28,1093,28,2000,879,569,524
43,"SECTOR 2","#N/A",179150,,269,"BUCUREŞTI SECTORUL 2 / ŞCOALA GIMNAZIALĂ Nr. 66",1,16974,"MUNICIPIUL BUCUREŞTI",179150,1297,872,789,57,26,853,19,1400,528,426,427
43,"SECTOR 2","#N/A",179150,,270,"BUCUREŞTI SECTORUL 2 / ŞCOALA GIMNAZIALĂ Nr. 66",1,16974,"MUNICIPIUL BUCUREŞTI",179150,1666,922,867,55,0,903,19,1800,878,419,484
43,"SECTOR 2","#N/A",179150,,271,"BUCUREŞTI SECTORUL 2 / ŞCOALA GIMNAZIALĂ Nr. 66",1,16974,"MUNICIPIUL BUCUREŞTI",179150,1375,972,905,67,0,948,24,1400,428,425,523
43,"SECTOR 2","#N/A",179150,,272,"BUCUREŞTI SECTORUL 2 / ŞCOALA GIMNAZIALĂ Nr. 66",1,16974,"MUNICIPIUL BUCUREŞTI",179150,1908,1202,1099,103,0,1185,17,2000,798,582,603
43,"SECTOR 2","#N/A",179150,,273,"BUCUREŞTI SECTORUL 2 / GRADINIŢA Nr. 189",1,16974,"MUNICIPIUL BUCUREŞTI",179150,1071,711,648,63,0,696,15,1200,489,325,371
43,"SECTOR 2","#N/A",179150,,274,"BUCUREŞTI SECTORUL 2 / GRADINIŢA Nr. 189",1,16974,"MUNICIPIUL BUCUREŞTI",179150,1093,722,671,51,0,709,13,1200,478,358,351
43,"SECTOR 2","#N/A",179150,,275,"BUCUREŞTI SECTORUL 2 / COLEGUL TEHNIC ""DIMITRIE LEONIDA""",1,16974,"MUNICIPIUL BUCUREŞTI",179150,1167,984,734,247,3,966,18,1201,217,358,608
43,"SECTOR 2","#N/A",179150,,276,"BUCUREŞTI SECTORUL 2 / COLEGUL TEHNIC ""DIMITRIE LEONIDA""",1,16974,"MUNICIPIUL BUCUREŞTI",179150,1506,1010,872,137,1,995,15,1600,590,476,519
43,"SECTOR 2","#N/A",179150,,277,"BUCUREŞTI SECTORUL 2 / ŞCOALA GIMNAZIALĂ ""PETRE GHELMEZ""",1,16974,"MUNICIPIUL BUCUREŞTI",179150,1796,1192,1073,119,0,1165,27,2000,808,501,664
43,"SECTOR 2","#N/A",179150,,278,"BUCUREŞTI SECTORUL 2 / ŞCOALA GIMNAZIALĂ ""PETRE GHELMEZ""",1,16974,"MUNICIPIUL BUCUREŞTI",179150,1829,1182,1096,86,0,1151,31,2000,818,560,591
43,"SECTOR 2","#N/A",179150,,279,"BUCUREŞTI SECTORUL 2 / ŞCOALA GIMNAZIALĂ ""PETRE GHELMEZ""",1,16974,"MUNICIPIUL BUCUREŞTI",179150,1465,1065,976,87,2,1031,33,1600,536,360,671
43,"SECTOR 2","#N/A",179150,,280,"BUCUREŞTI SECTORUL 2 / ŞCOALA GIMNAZIALĂ ""PETRE GHELMEZ""",1,16974,"MUNICIPIUL BUCUREŞTI",179150,1401,881,804,77,0,860,21,1600,719,422,438
43,"SECTOR 2","#N/A",179150,,281,"BUCUREŞTI SECTORUL 2 / ŞCOALA GIMNAZIALĂ ""PETRE GHELMEZ""",1,16974,"MUNICIPIUL BUCUREŞTI",179150,1816,1186,1102,84,0,1162,24,2000,814,551,611
43,"SECTOR 2","#N/A",179150,,282,"BUCUREŞTI SECTORUL 2 / ŞCOALA GIMNAZIALĂ ""PETRE GHELMEZ""",1,16974,"MUNICIPIUL BUCUREŞTI",179150,1638,1129,1044,85,0,1106,23,1800,671,472,634
43,"SECTOR 2","#N/A",179150,,283,"BUCUREŞTI SECTORUL 2 / ŞCOALA GIMNAZIALĂ Nr. 4",1,16974,"MUNICIPIUL BUCUREŞTI",179150,1729,1176,1070,105,1,1143,33,1800,624,501,642
43,"SECTOR 2","#N/A",179150,,284,"BUCUREŞTI SECTORUL 2 / ŞCOALA GIMNAZIALĂ Nr. 4",1,16974,"MUNICIPIUL BUCUREŞTI",179150,1835,1224,1134,90,0,1201,23,2000,776,572,629
43,"SECTOR 2","#N/A",179150,,285,"BUCUREŞTI SECTORUL 2 / ŞCOALA GIMNAZIALĂ Nr. 4",1,16974,"MUNICIPIUL BUCUREŞTI",179150,1899,1228,1165,62,1,1201,27,2000,772,526,675
43,"SECTOR 2","#N/A",179150,,286,"BUCUREŞTI SECTORUL 2 / ŞCOALA GIMNAZIALĂ Nr. 4",1,16974,"MUNICIPIUL BUCUREŞTI",179150,1987,1327,1242,84,1,1300,27,2199,872,528,772
43,"SECTOR 2","#N/A",179150,,287,"BUCUREŞTI SECTORUL 2 / ŞCOALA GIMNAZIALĂ Nr. 4",1,16974,"MUNICIPIUL BUCUREŞTI",179150,1542,956,902,53,1,934,22,1600,644,422,512
43,"SECTOR 2","#N/A",179150,,288,"BUCUREŞTI SECTORUL 2 / ŞCOALA GIMNAZIALĂ Nr. 25",1,16974,"MUNICIPIUL BUCUREŞTI",179150,1925,1277,1166,111,0,1254,23,2000,723,548,706
43,"SECTOR 2","#N/A",179150,,289,"BUCUREŞTI SECTORUL 2 / ŞCOALA GIMNAZIALĂ Nr. 25",1,16974,"MUNICIPIUL BUCUREŞTI",179150,1961,1212,1110,101,1,1195,17,2000,788,556,639
43,"SECTOR 2","#N/A",179150,,290,"BUCUREŞTI SECTORUL 2 / ŞCOALA GIMNAZIALĂ Nr. 25",1,16974,"MUNICIPIUL BUCUREŞTI",179150,1863,1130,1073,55,2,1111,19,2000,870,537,574
43,"SECTOR 2","#N/A",179150,,291,"BUCUREŞTI SECTORUL 2 / ŞCOALA GIMNAZIALĂ Nr. 25",1,16974,"MUNICIPIUL BUCUREŞTI",179150,1886,1292,1191,98,3,1275,17,2000,708,453,822
43,"SECTOR 2","#N/A",179150,,292,"BUCUREŞTI SECTORUL 2 / ŞCOALA GIMNAZIALĂ ""FERDINAND I"" (FOSTA ŞCOALĂ  Nr. 64)",1,16974,"MUNICIPIUL BUCUREŞTI",179150,1528,1088,938,148,2,1062,26,1600,512,483,579
43,"SECTOR 2","#N/A",179150,,293,"BUCUREŞTI SECTORUL 2 / ŞCOALA GIMNAZIALĂ ""FERDINAND I"" (FOSTA ŞCOALĂ  Nr. 64)",1,16974,"MUNICIPIUL BUCUREŞTI",179150,1564,1056,930,125,1,1041,15,1600,544,440,601
43,"SECTOR 2","#N/A",179150,,294,"BUCUREŞTI SECTORUL 2 / ŞCOALA GIMNAZIALĂ ""FERDINAND I"" (FOSTA ŞCOALĂ  Nr. 64)",1,16974,"MUNICIPIUL BUCUREŞTI",179150,1266,788,705,83,0,769,19,1400,612,306,463
43,"SECTOR 2","#N/A",179150,,295,"BUCUREŞTI SECTORUL 2 / ŞCOALA GIMNAZIALĂ ""FERDINAND I"" (FOSTA ŞCOALĂ  Nr. 64)",1,16974,"MUNICIPIUL BUCUREŞTI",179150,1930,1201,1116,85,0,1174,27,2000,799,516,658
43,"SECTOR 2","#N/A",179150,,296,"BUCUREŞTI SECTORUL 2 / ŞCOALA GIMNAZIALĂ ""FERDINAND I"" (FOSTA ŞCOALĂ  Nr. 64)",1,16974,"MUNICIPIUL BUCUREŞTI",179150,1503,879,779,100,0,868,11,1600,721,459,409
43,"SECTOR 2","#N/A",179150,,297,"BUCUREŞTI SECTORUL 2 / LICEUL TEHNOLOGIC ELECTRONICA INDUSTRIALĂ",1,16974,"MUNICIPIUL BUCUREŞTI",179150,1689,1119,1055,60,4,1083,36,1800,681,465,618
43,"SECTOR 2","#N/A",179150,,298,"BUCUREŞTI SECTORUL 2 / LICEUL TEHNOLOGIC ELECTRONICA INDUSTRIALĂ",1,16974,"MUNICIPIUL BUCUREŞTI",179150,1631,1086,1003,81,2,1064,22,1800,714,452,612
43,"SECTOR 2","#N/A",179150,,299,"BUCUREŞTI SECTORUL 2 / LICEUL TEHNOLOGIC ELECTRONICA INDUSTRIALĂ",1,16974,"MUNICIPIUL BUCUREŞTI",179150,1336,896,846,49,1,879,17,1400,504,380,499
43,"SECTOR 2","#N/A",179150,,300,"BUCUREŞTI SECTORUL 2 / COLEGIUL NAŢIONAL ""IULIA HAŞDEU""",1,16974,"MUNICIPIUL BUCUREŞTI",179150,1478,1280,913,365,2,1250,30,2400,1120,473,777
43,"SECTOR 2","#N/A",179150,,301,"BUCUREŞTI SECTORUL 2 / COLEGIUL NAŢIONAL ""IULIA HAŞDEU""",1,16974,"MUNICIPIUL BUCUREŞTI",179150,1580,1060,869,191,0,1033,27,2000,940,415,618
43,"SECTOR 2","#N/A",179150,,302,"BUCUREŞTI SECTORUL 2 / COLEGIUL NAŢIONAL ""IULIA HAŞDEU""",1,16974,"MUNICIPIUL BUCUREŞTI",179150,1568,1280,911,369,0,1255,25,2400,1120,448,807
43,"SECTOR 2","#N/A",179150,,303,"BUCUREŞTI SECTORUL 2 / LICEUL TEHNOLOGIC MECANICĂ FINĂ",1,16974,"MUNICIPIUL BUCUREŞTI",179150,1328,952,838,114,0,938,14,1400,448,369,569
43,"SECTOR 2","#N/A",179150,,304,"BUCUREŞTI SECTORUL 2 / LICEUL TEHNOLOGIC MECANICĂ FINĂ",1,16974,"MUNICIPIUL BUCUREŞTI",179150,1268,887,795,90,2,863,24,1400,513,388,475
43,"SECTOR 2","#N/A",179150,,305,"BUCUREŞTI SECTORUL 2 / LICEUL TEHNOLOGIC MECANICĂ FINĂ",1,16974,"MUNICIPIUL BUCUREŞTI",179150,1139,756,638,116,2,744,12,1200,444,280,464
43,"SECTOR 2","#N/A",179150,,306,"BUCUREŞTI SECTORUL 2 / LICEUL TEHNOLOGIC MECANICĂ FINĂ",1,16974,"MUNICIPIUL BUCUREŞTI",179150,1708,1183,1099,84,0,1168,15,1799,616,402,766
43,"SECTOR 2","#N/A",179150,,307,"BUCUREŞTI SECTORUL 2 / CLUB SPORTIV ŞCOLAR Nr. 2",1,16974,"MUNICIPIUL BUCUREŞTI",179150,1653,1398,1031,366,1,1353,45,2400,1002,456,897
43,"SECTOR 2","#N/A",179150,,308,"BUCUREŞTI SECTORUL 2 / CLUB SPORTIV ŞCOLAR Nr. 2",1,16974,"MUNICIPIUL BUCUREŞTI",179150,1529,1215,963,251,1,1181,34,1600,385,414,767
43,"SECTOR 2","#N/A",179150,,309,"BUCUREŞTI SECTORUL 2 / GRĂDINIŢA CLOPOŢEL (fosta GRADINIŢA Nr. 201)",1,16974,"MUNICIPIUL BUCUREŞTI",179150,1484,980,874,105,1,950,30,1600,620,367,583
43,"SECTOR 2","#N/A",179150,,310,"BUCUREŞTI SECTORUL 2 / GRĂDINIŢA CLOPOŢEL (fosta GRADINIŢA Nr. 201)",1,16974,"MUNICIPIUL BUCUREŞTI",179150,1675,1252,1103,149,0,1210,42,1800,548,495,715
43,"SECTOR 2","#N/A",179150,,311,"BUCUREŞTI SECTORUL 2 / GRĂDINIŢA CLOPOŢEL (fosta GRADINIŢA Nr. 201)",1,16974,"MUNICIPIUL BUCUREŞTI",179150,1407,1003,893,110,0,984,19,1600,597,407,577
43,"SECTOR 2","#N/A",179150,,312,"BUCUREŞTI SECTORUL 2 / GRĂDINIŢA CLOPOŢEL (fosta GRADINIŢA Nr. 201)",1,16974,"MUNICIPIUL BUCUREŞTI",179150,1331,926,828,98,0,905,21,1400,474,344,561
43,"SECTOR 2","#N/A",179150,,313,"BUCUREŞTI SECTORUL 2 / COLEGIUL NAŢIONAL ""EMIL RACOVIŢĂ""",1,16974,"MUNICIPIUL BUCUREŞTI",179150,1566,1184,1020,164,0,1158,26,1600,416,547,611
43,"SECTOR 2","#N/A",179150,,314,"BUCUREŞTI SECTORUL 2 / COLEGIUL NAŢIONAL ""EMIL RACOVIŢĂ""",1,16974,"MUNICIPIUL BUCUREŞTI",179150,1166,990,764,225,1,975,15,1199,209,345,630
43,"SECTOR 2","#N/A",179150,,315,"BUCUREŞTI SECTORUL 2 / COLEGIUL NAŢIONAL ""EMIL RACOVIŢĂ""",1,16974,"MUNICIPIUL BUCUREŞTI",179150,1877,1261,1133,128,0,1231,30,2000,739,461,770
43,"SECTOR 2","#N/A",179150,,316,"BUCUREŞTI SECTORUL 2 / GRĂDINIŢA LUMINIŢA (fosta GRADINITA Nr. 16)",1,16974,"MUNICIPIUL BUCUREŞTI",179150,1367,1004,884,118,2,994,10,1400,396,371,623
43,"SECTOR 2","#N/A",179150,,317,"BUCUREŞTI SECTORUL 2 / GRĂDINIŢA LUMINIŢA (fosta GRADINITA Nr. 16)",1,16974,"MUNICIPIUL BUCUREŞTI",179150,1255,894,830,64,0,876,18,1399,505,342,534
43,"SECTOR 2","#N/A",179150,,318,"BUCUREŞTI SECTORUL 2 / GRĂDINIŢA Nr. 256",1,16974,"MUNICIPIUL BUCUREŞTI",179150,1659,1199,1106,92,1,1173,26,1800,601,428,745
43,"SECTOR 2","#N/A",179150,,319,"BUCUREŞTI SECTORUL 2 / ŞCOALA GIMNAZIALĂ Nr. 49",1,16974,"MUNICIPIUL BUCUREŞTI",179150,1228,1002,842,146,14,986,16,1400,398,355,631
43,"SECTOR 2","#N/A",179150,,320,"BUCUREŞTI SECTORUL 2 / ŞCOALA GIMNAZIALĂ Nr. 49",1,16974,"MUNICIPIUL BUCUREŞTI",179150,1186,915,792,123,0,903,12,1400,485,288,615
43,"SECTOR 2","#N/A",179150,,321,"BUCUREŞTI SECTORUL 2 / ŞCOALA GIMNAZIALĂ Nr. 46",1,16974,"MUNICIPIUL BUCUREŞTI",179150,1448,1009,872,136,1,990,19,1600,591,383,607
43,"SECTOR 2","#N/A",179150,,322,"BUCUREŞTI SECTORUL 2 / ŞCOALA GIMNAZIALĂ Nr. 46",1,16974,"MUNICIPIUL BUCUREŞTI",179150,1676,1188,1003,184,1,1165,23,1800,612,539,626
43,"SECTOR 2","#N/A",179150,,323,"BUCUREŞTI SECTORUL 2 / ŞCOALA GIMNAZIALĂ Nr. 46",1,16974,"MUNICIPIUL BUCUREŞTI",179150,1660,1140,1052,88,0,1107,33,1800,660,487,620
43,"SECTOR 2","#N/A",179150,,324,"BUCUREŞTI SECTORUL 2 / ŞCOALA GIMNAZIALĂ Nr. 46",1,16974,"MUNICIPIUL BUCUREŞTI",179150,1965,1364,1230,132,2,1343,21,2000,636,564,779
43,"SECTOR 2","#N/A",179150,,325,"BUCUREŞTI SECTORUL 2 / ŞCOALA GIMNAZIALĂ TUDOR ARGHEZI (fosta ŞCOALĂ Nr. 19)",1,16974,"MUNICIPIUL BUCUREŞTI",179150,1226,855,675,180,0,838,17,1400,545,289,549
43,"SECTOR 2","#N/A",179150,,326,"BUCUREŞTI SECTORUL 2 / ŞCOALA GIMNAZIALĂ TUDOR ARGHEZI (fosta ŞCOALĂ Nr. 19)",1,16974,"MUNICIPIUL BUCUREŞTI",179150,1036,721,558,163,0,705,16,1200,479,232,473
43,"SECTOR 2","#N/A",179150,,327,"BUCUREŞTI SECTORUL 2 / COLEGIUL NAŢIONAL ""SPIRU HARET""",1,16974,"MUNICIPIUL BUCUREŞTI",179150,1282,980,695,234,51,958,22,1600,620,323,635
43,"SECTOR 2","#N/A",179150,,328,"BUCUREŞTI SECTORUL 2 / COLEGIUL NAŢIONAL ""SPIRU HARET""",1,16974,"MUNICIPIUL BUCUREŞTI",179150,1230,837,680,156,1,821,16,1400,563,287,534
43,"SECTOR 2","#N/A",179150,,329,"BUCUREŞTI SECTORUL 2 / COLEGIUL NAŢIONAL ""CANTEMIR VODĂ""",1,16974,"MUNICIPIUL BUCUREŞTI",179150,1029,839,576,210,53,826,13,1600,761,299,527
43,"SECTOR 2","#N/A",179150,,330,"BUCUREŞTI SECTORUL 2 / COLEGIUL NAŢIONAL ""CANTEMIR VODĂ""",1,16974,"MUNICIPIUL BUCUREŞTI",179150,1304,972,779,139,54,955,17,1400,428,338,617
43,"SECTOR 2","#N/A",179150,,331,"BUCUREŞTI SECTORUL 2 / COLEGIUL NAŢIONAL ""CANTEMIR VODĂ""",1,16974,"MUNICIPIUL BUCUREŞTI",179150,1347,895,752,109,34,879,16,1400,505,336,543
43,"SECTOR 2","#N/A",179150,,332,"BUCUREŞTI SECTORUL 2 / COLEGIUL NAŢIONAL ""CANTEMIR VODĂ""",1,16974,"MUNICIPIUL BUCUREŞTI",179150,1701,1082,973,109,0,1066,16,1800,718,401,665
43,"SECTOR 2","#N/A",179150,,333,"BUCUREŞTI SECTORUL 2 / ŞCOALA GIMNAZIALĂ Nr. 24",1,16974,"MUNICIPIUL BUCUREŞTI",179150,1878,1319,1045,190,84,1297,22,2000,681,521,776
43,"SECTOR 2","#N/A",179150,,334,"BUCUREŞTI SECTORUL 2 / ŞCOALA GIMNAZIALĂ Nr. 24",1,16974,"MUNICIPIUL BUCUREŞTI",179150,1701,1215,984,151,80,1195,20,1800,585,494,701
43,"SECTOR 2","#N/A",179150,,335,"BUCUREŞTI SECTORUL 2 / LICEUL TEHNOLOGIC SPECIAL Nr. 3 (fosta ŞCOALĂ PENTRU HIPOACUZICI)",1,16974,"MUNICIPIUL BUCUREŞTI",179150,1446,834,763,68,3,812,22,1600,766,331,481
43,"SECTOR 2","#N/A",179150,,336,"BUCUREŞTI SECTORUL 2 / LICEUL TEHNOLOGIC SPECIAL Nr. 3 (fosta ŞCOALĂ PENTRU HIPOACUZICI)",1,16974,"MUNICIPIUL BUCUREŞTI",179150,1409,839,787,52,0,821,18,1600,761,330,491
43,"SECTOR 2","#N/A",179150,,337,"BUCUREŞTI SECTORUL 2 / ŞCOALA GIMNAZIALĂ ""MAICA DOMNULUI"" (fosta ŞCOALA Nr. 26)",1,16974,"MUNICIPIUL BUCUREŞTI",179150,1275,783,708,74,1,774,9,1400,617,329,445
43,"SECTOR 2","#N/A",179150,,338,"BUCUREŞTI SECTORUL 2 / ŞCOALA GIMNAZIALĂ ""MAICA DOMNULUI"" (fosta ŞCOALA Nr. 26)",1,16974,"MUNICIPIUL BUCUREŞTI",179150,1409,952,879,73,0,933,19,1600,648,409,524
43,"SECTOR 2","#N/A",179150,,339,"BUCUREŞTI SECTORUL 2 / ŞCOALA PROFESIONALĂ SPECIALĂ Nr. 3",1,16974,"MUNICIPIUL BUCUREŞTI",179150,1583,962,873,88,1,935,27,2000,1038,417,518
43,"SECTOR 2","#N/A",179150,,340,"BUCUREŞTI SECTORUL 2 / ŞCOALA PROFESIONALĂ SPECIALĂ Nr. 3",1,16974,"MUNICIPIUL BUCUREŞTI",179150,1384,837,769,68,0,823,14,1400,563,313,510
43,"SECTOR 2","#N/A",179150,,341,"BUCUREŞTI SECTORUL 2 / ŞCOALA GIMNAZIALĂ Nr. 307",1,16974,"MUNICIPIUL BUCUREŞTI",179150,1387,1161,903,258,0,1135,26,1384,223,403,732
43,"SECTOR 2","#N/A",179150,,342,"BUCUREŞTI SECTORUL 2 / ŞCOALA GIMNAZIALĂ Nr. 307",1,16974,"MUNICIPIUL BUCUREŞTI",179150,1105,786,594,192,0,763,23,1200,414,317,446
43,"SECTOR 2","#N/A",179150,,343,"BUCUREŞTI SECTORUL 2 / ŞCOALA GIMNAZIALĂ Nr. 307",1,16974,"MUNICIPIUL BUCUREŞTI",179150,1531,1162,954,204,4,1144,18,1600,438,446,698
43,"SECTOR 2","#N/A",179150,,344,"BUCUREŞTI SECTORUL 2 / ŞCOALA GIMNAZIALĂ Nr. 71",1,16974,"MUNICIPIUL BUCUREŞTI",179150,1503,936,802,134,0,923,13,1600,664,325,598
43,"SECTOR 2","#N/A",179150,,345,"BUCUREŞTI SECTORUL 2 / ŞCOALA GIMNAZIALĂ Nr. 71",1,16974,"MUNICIPIUL BUCUREŞTI",179150,1424,924,810,114,0,893,31,1600,676,351,542
43,"SECTOR 2","#N/A",179150,,346,"BUCUREŞTI SECTORUL 2 / COLEGIUL ECONOMIC ""A.D. XENOPOL""",1,16974,"MUNICIPIUL BUCUREŞTI",179150,1311,821,747,73,1,806,15,1400,579,267,539
43,"SECTOR 2","#N/A",179150,,347,"BUCUREŞTI SECTORUL 2 / COLEGIUL ECONOMIC ""A.D. XENOPOL""",1,16974,"MUNICIPIUL BUCUREŞTI",179150,1079,727,581,144,2,712,15,1200,473,244,468
43,"SECTOR 2","#N/A",179150,,348,"BUCUREŞTI SECTORUL 2 / COLEGIUL ECONOMIC ""A.D. XENOPOL""",1,16974,"MUNICIPIUL BUCUREŞTI",179150,1343,855,756,98,1,845,10,1400,545,333,512
43,"SECTOR 2","#N/A",179150,,349,"BUCUREŞTI SECTORUL 2 / COLEGIUL ECONOMIC ""A.D. XENOPOL"" ; Str. TRAIAN Nr. 165; CP 024076",1,16974,"MUNICIPIUL BUCUREŞTI",179150,1510,912,834,78,0,891,21,1600,688,390,501
43,"SECTOR 2","#N/A",179150,,350,"BUCUREŞTI SECTORUL 2 / COLEGIUL NAŢIONAL BILINGV  ""GEORGE COŞBUC""",1,16974,"MUNICIPIUL BUCUREŞTI",179150,1541,1069,937,130,2,1052,17,1600,531,358,694
43,"SECTOR 2","#N/A",179150,,351,"BUCUREŞTI SECTORUL 2 / COLEGIUL NAŢIONAL  BILINGV ""GEORGE COŞBUC""",1,16974,"MUNICIPIUL BUCUREŞTI",179150,1765,1103,967,133,3,1081,22,1800,697,401,680
43,"SECTOR 2","#N/A",179150,,352,"BUCUREŞTI SECTORUL 2 / ŞCOALA GIMNAZIALĂ ""MAICA DOMNULUI"" (fosta ŞCOALĂ NR. 50)",1,16974,"MUNICIPIUL BUCUREŞTI",179150,1559,1198,1034,163,1,1171,27,1600,402,432,739
43,"SECTOR 2","#N/A",179150,,353,"BUCUREŞTI SECTORUL 2 / ŞCOALA GIMNAZIALĂ ""MAICA DOMNULUI"" (fosta ŞCOALĂ NR. 50)",1,16974,"MUNICIPIUL BUCUREŞTI",179150,1578,1124,973,150,1,1107,17,1600,476,435,672
43,"SECTOR 2","#N/A",179150,,354,"BUCUREŞTI SECTORUL 2 / ŞCOALA GIMNAZIALĂ ""MAICA DOMNULUI"" (fosta ŞCOALĂ NR. 50)",1,16974,"MUNICIPIUL BUCUREŞTI",179150,1857,1186,1055,128,3,1167,19,2000,814,476,691
43,"SECTOR 2","#N/A",179150,,355,"BUCUREŞTI SECTORUL 2 / COLEGIUL NAŢIONAL   ""MIHAI VITEAZUL""",1,16974,"MUNICIPIUL BUCUREŞTI",179150,1754,1137,952,159,26,1114,23,1800,663,433,681
43,"SECTOR 2","#N/A",179150,,356,"BUCUREŞTI SECTORUL 2 / COLEGIUL NAŢIONAL   ""MIHAI VITEAZUL""",1,16974,"MUNICIPIUL BUCUREŞTI",179150,1556,1100,858,184,58,1076,24,1984,884,444,632
43,"SECTOR 2","#N/A",179150,,357,"BUCUREŞTI SECTORUL 2 / ŞCOALA GIMNAZIALĂ Nr. 56",1,16974,"MUNICIPIUL BUCUREŞTI",179150,1524,1078,962,116,0,1052,26,1600,522,396,656
43,"SECTOR 2","#N/A",179150,,358,"BUCUREŞTI SECTORUL 2 / ŞCOALA GIMNAZIALĂ Nr. 56",1,16974,"MUNICIPIUL BUCUREŞTI",179150,1303,945,813,131,1,919,26,1400,455,391,528
43,"SECTOR 2","#N/A",179150,,359,"BUCUREŞTI SECTORUL 2 / ŞCOALA GIMNAZIALĂ Nr. 85",1,16974,"MUNICIPIUL BUCUREŞTI",179150,1057,715,631,84,0,696,19,1200,485,260,436
43,"SECTOR 2","#N/A",179150,,360,"BUCUREŞTI SECTORUL 2 / ŞCOALA GIMNAZIALĂ Nr. 85",1,16974,"MUNICIPIUL BUCUREŞTI",179150,1346,810,723,87,0,791,19,1366,556,345,446
43,"SECTOR 2","#N/A",179150,,361,"BUCUREŞTI SECTORUL 2 / ŞCOALA GIMNAZIALĂ Nr. 85",1,16974,"MUNICIPIUL BUCUREŞTI",179150,1287,855,799,56,0,839,16,1400,545,379,460
43,"SECTOR 2","#N/A",179150,,362,"BUCUREŞTI SECTORUL 2 / ŞCOALA GIMNAZIALĂ Nr. 85",1,16974,"MUNICIPIUL BUCUREŞTI",179150,1234,845,792,53,0,823,22,1400,555,351,472
43,"SECTOR 2","#N/A",179150,,363,"BUCUREŞTI SECTORUL 2 / ŞCOALA GIMNAZIALĂ Nr. 85",1,16974,"MUNICIPIUL BUCUREŞTI",179150,1358,847,744,103,0,832,15,1386,539,337,495
43,"SECTOR 2","#N/A",179150,,364,"BUCUREŞTI SECTORUL 2 / ŞCOALA GIMNAZIALĂ Nr. 85",1,16974,"MUNICIPIUL BUCUREŞTI",179150,1634,983,884,99,0,967,16,1800,817,419,548
44,"SECTOR 3","#N/A",179169,,365,"BUCUREŞTI SECTORUL 3 / ŞCOALA SUPERIOARĂ COMERCIALĂ ""NICOLAE KRETZULESCU"";",1,16975,"MUNICIPIUL BUCUREŞTI",179169,1189,634,521,112,1,621,13,1300,666,270,351
44,"SECTOR 3","#N/A",179169,,366,"BUCUREŞTI SECTORUL 3 / ŞCOALA SUPERIOARĂ COMERCIALĂ ""NICOLAE KRETZULESCU"";",1,16975,"MUNICIPIUL BUCUREŞTI",179169,1037,491,407,65,19,483,8,1100,609,214,269
44,"SECTOR 3","#N/A",179169,,367,"BUCUREŞTI SECTORUL 3 / ŞCOALA SUPERIOARĂ COMERCIALĂ ""NICOLAE KRETZULESCU"";",1,16975,"MUNICIPIUL BUCUREŞTI",179169,987,775,498,136,141,757,18,1100,325,340,417
44,"SECTOR 3","#N/A",179169,,368,"BUCUREŞTI SECTORUL 3 / ŞCOALA SUPERIOARĂ COMERCIALĂ ""NICOLAE KRETZULESCU"";",1,16975,"MUNICIPIUL BUCUREŞTI",179169,1350,790,610,179,1,769,21,1503,713,327,442
44,"SECTOR 3","#N/A",179169,,369,"BUCUREŞTI SECTORUL 3 / ŞCOALA SUPERIOARĂ COMERCIALĂ ""NICOLAE KRETZULESCU"";",1,16975,"MUNICIPIUL BUCUREŞTI",179169,1258,696,588,108,0,685,11,1399,703,247,438
44,"SECTOR 3","#N/A",179169,,370,"BUCUREŞTI SECTORUL 3 / ŞCOALA SUPERIOARĂ COMERCIALĂ ""NICOLAE KRETZULESCU"";",1,16975,"MUNICIPIUL BUCUREŞTI",179169,1544,992,842,150,0,968,24,1700,708,356,612
44,"SECTOR 3","#N/A",179169,,371,"BUCUREŞTI SECTORUL 3 / ŞCOALA GIMNAZIALĂ ""BARBU DELAVRANCEA"";",1,16975,"MUNICIPIUL BUCUREŞTI",179169,1509,1177,959,216,2,1150,27,1700,523,468,682
44,"SECTOR 3","#N/A",179169,,372,"BUCUREŞTI SECTORUL 3 / ŞCOALA GIMNAZIALĂ ""BARBU DELAVRANCEA"";",1,16975,"MUNICIPIUL BUCUREŞTI",179169,1662,974,750,221,3,956,18,1800,826,385,571
44,"SECTOR 3","#N/A",179169,,373,"BUCUREŞTI SECTORUL 3 / COLEGIUL NATIONAL ""MATEI BASARAB"";",1,16975,"MUNICIPIUL BUCUREŞTI",179169,1997,665,457,173,35,647,18,2100,1435,282,365
44,"SECTOR 3","#N/A",179169,,374,"BUCUREŞTI SECTORUL 3 / COLEGIUL NAŢIONAL ""MATEI BASARAB"";",1,16975,"MUNICIPIUL BUCUREŞTI",179169,1872,1123,1036,86,1,1094,29,2100,977,480,614
44,"SECTOR 3","#N/A",179169,,375,"BUCUREŞTI SECTORUL 3 / COLEGIUL NAŢIONAL  ""MATEI BASARAB"";",1,16975,"MUNICIPIUL BUCUREŞTI",179169,1846,1036,955,80,1,1020,16,2001,965,453,567
44,"SECTOR 3","#N/A",179169,,376,"BUCUREŞTI SECTORUL 3 / ŞCOALA GIMNAZIALĂ SPECIALĂ Nr.5;",1,16975,"MUNICIPIUL BUCUREŞTI",179169,1332,985,804,179,2,966,19,1500,515,372,594
44,"SECTOR 3","#N/A",179169,,377,"BUCUREŞTI SECTORUL 3 / ŞCOALA GIMNAZIALĂ SPECIALĂ Nr.5;",1,16975,"MUNICIPIUL BUCUREŞTI",179169,1552,999,786,209,4,976,23,1700,701,416,560
44,"SECTOR 3","#N/A",179169,,378,"BUCUREŞTI SECTORUL 3 / ŞCOALA GIMNAZIALĂ SPECIALĂ Nr.5;",1,16975,"MUNICIPIUL BUCUREŞTI",179169,1044,785,665,120,0,772,13,1100,315,279,493
44,"SECTOR 3","#N/A",179169,,379,"BUCUREŞTI SECTORUL 3 / ŞCOALA GIMNAZIALĂ SPECIALĂ Nr.5;",1,16975,"MUNICIPIUL BUCUREŞTI",179169,1391,914,803,109,2,893,21,1500,586,366,527
44,"SECTOR 3","#N/A",179169,,380,"BUCUREŞTI SECTORUL 3 / ŞCOALA GIMNAZIALĂ SPECIALĂ Nr.5;",1,16975,"MUNICIPIUL BUCUREŞTI",179169,1331,873,792,80,1,861,12,1500,627,347,514
44,"SECTOR 3","#N/A",179169,,381,"BUCUREŞTI SECTORUL 3 / ŞCOALA GIMNAZIALĂ SPECIALĂ Nr.5;",1,16975,"MUNICIPIUL BUCUREŞTI",179169,1581,935,830,105,0,924,11,1700,765,339,585
44,"SECTOR 3","#N/A",179169,,382,"BUCUREŞTI SECTORUL 3 / ŞCOALA GIMNAZIALĂ SPECIALĂ Nr.5;",1,16975,"MUNICIPIUL BUCUREŞTI",179169,1233,642,559,82,1,626,16,1400,758,238,388
44,"SECTOR 3","#N/A",179169,,383,"BUCUREŞTI SECTORUL 3 / ŞCOALA GIMNAZIALĂ ""CEZAR BOLLIAC"";",1,16975,"MUNICIPIUL BUCUREŞTI",179169,1486,1303,966,337,0,1275,28,1600,297,411,864
44,"SECTOR 3","#N/A",179169,,384,"BUCUREŞTI SECTORUL 3 / ŞCOALA GIMNAZIALĂ ""CEZAR BOLLIAC"";",1,16975,"MUNICIPIUL BUCUREŞTI",179169,1480,1159,932,225,2,1141,18,1600,441,420,721
44,"SECTOR 3","#N/A",179169,,385,"BUCUREŞTI SECTORUL 3 / ŞCOALA GIMNAZIALĂ ""CEZAR BOLLIAC"";",1,16975,"MUNICIPIUL BUCUREŞTI",179169,1401,1070,915,155,0,1057,13,1500,430,408,649
44,"SECTOR 3","#N/A",179169,,386,"BUCUREŞTI SECTORUL 3 / ŞCOALA GIMNAZIALĂ ""CEZAR BOLLIAC"";",1,16975,"MUNICIPIUL BUCUREŞTI",179169,1496,982,933,47,2,961,21,1600,618,350,611
44,"SECTOR 3","#N/A",179169,,387,"BUCUREŞTI SECTORUL 3 / ŞCOALA GIMNAZIALĂ ""CEZAR BOLLIAC"";",1,16975,"MUNICIPIUL BUCUREŞTI",179169,1356,921,876,44,1,894,27,1500,579,404,490
44,"SECTOR 3","#N/A",179169,,388,"BUCUREŞTI SECTORUL 3 / ŞCOALA GIMNAZIALĂ ""CEZAR BOLLIAC"";",1,16975,"MUNICIPIUL BUCUREŞTI",179169,1619,1108,1024,83,1,1089,19,1801,693,354,735
44,"SECTOR 3","#N/A",179169,,389,"BUCUREŞTI SECTORUL 3 / ŞCOALA GIMNAZIALĂ ""CEZAR BOLLIAC"";",1,16975,"MUNICIPIUL BUCUREŞTI",179169,1568,1106,1001,90,15,1089,17,1700,594,442,647
44,"SECTOR 3","#N/A",179169,,390,"BUCUREŞTI SECTORUL 3 / ŞCOALA GIMNAZIALĂ ""CEZAR BOLLIAC"";",1,16975,"MUNICIPIUL BUCUREŞTI",179169,1521,1097,984,113,0,1075,22,1700,603,403,672
44,"SECTOR 3","#N/A",179169,,391,"BUCUREŞTI SECTORUL 3 / ŞCOALA GIMNAZIALĂ Nr.80;",1,16975,"MUNICIPIUL BUCUREŞTI",179169,1435,1190,892,298,0,1157,33,1600,410,411,746
44,"SECTOR 3","#N/A",179169,,392,"BUCUREŞTI SECTORUL 3 / ŞCOALA GIMNAZIALĂ Nr.80;",1,16975,"MUNICIPIUL BUCUREŞTI",179169,1390,996,756,238,2,977,19,1500,504,346,631
44,"SECTOR 3","#N/A",179169,,393,"BUCUREŞTI SECTORUL 3 / ŞCOALA GIMNAZIALĂ Nr.80;",1,16975,"MUNICIPIUL BUCUREŞTI",179169,1647,1188,997,190,1,1165,23,1800,612,444,721
44,"SECTOR 3","#N/A",179169,,394,"BUCUREŞTI SECTORUL 3 / ŞCOALA GIMNAZIALĂ Nr.80;",1,16975,"MUNICIPIUL BUCUREŞTI",179169,1634,1155,1030,125,0,1123,32,1798,643,459,664
44,"SECTOR 3","#N/A",179169,,395,"BUCUREŞTI SECTORUL 3 / ŞCOALA GIMNAZIALĂ Nr.80;",1,16975,"MUNICIPIUL BUCUREŞTI",179169,1085,840,685,155,0,828,12,1200,360,322,506
44,"SECTOR 3","#N/A",179169,,396,"BUCUREŞTI SECTORUL 3 / ŞCOALA GIMNAZIALĂ Nr.80;",1,16975,"MUNICIPIUL BUCUREŞTI",179169,1136,819,699,120,0,806,13,1200,381,306,500
44,"SECTOR 3","#N/A",179169,,397,"BUCUREŞTI SECTORUL 3 / ŞCOALA GIMNAZIALĂ Nr.80;",1,16975,"MUNICIPIUL BUCUREŞTI",179169,904,605,536,69,0,589,16,1000,395,202,387
44,"SECTOR 3","#N/A",179169,,398,"BUCUREŞTI SECTORUL 3 / ŞCOALA GIMNAZIALĂ Nr.80;",1,16975,"MUNICIPIUL BUCUREŞTI",179169,1112,728,674,54,0,712,16,1203,475,274,438
44,"SECTOR 3","#N/A",179169,,399,"BUCUREŞTI SECTORUL 3 / ŞCOALA GIMNAZIALĂ Nr.81;",1,16975,"MUNICIPIUL BUCUREŞTI",179169,1755,1388,1137,251,0,1356,32,1900,512,588,768
44,"SECTOR 3","#N/A",179169,,400,"BUCUREŞTI SECTORUL 3 / ŞCOALA GIMNAZIALĂ Nr.81;",1,16975,"MUNICIPIUL BUCUREŞTI",179169,1318,1186,755,431,0,1160,26,1400,214,377,783
44,"SECTOR 3","#N/A",179169,,401,"BUCUREŞTI SECTORUL 3 / ŞCOALA GIMNAZIALĂ Nr.81;",1,16975,"MUNICIPIUL BUCUREŞTI",179169,1370,1054,859,195,0,1030,24,1500,446,337,693
44,"SECTOR 3","#N/A",179169,,402,"BUCUREŞTI SECTORUL 3 / ŞCOALA GIMNAZIALĂ Nr.81;",1,16975,"MUNICIPIUL BUCUREŞTI",179169,1305,1030,755,275,0,1005,25,1400,370,370,635
44,"SECTOR 3","#N/A",179169,,403,"BUCUREŞTI SECTORUL 3 / ŞCOALA GIMNAZIALĂ Nr.81;",1,16975,"MUNICIPIUL BUCUREŞTI",179169,1592,1265,1109,155,1,1230,35,1700,435,470,760
44,"SECTOR 3","#N/A",179169,,404,"BUCUREŞTI SECTORUL 3 / ŞCOALA GIMNAZIALĂ Nr.81;",1,16975,"MUNICIPIUL BUCUREŞTI",179169,1306,885,737,148,0,855,30,1400,515,337,518
44,"SECTOR 3","#N/A",179169,,405,"BUCUREŞTI SECTORUL 3 / ŞCOALA GIMNAZIALĂ Nr.81;",1,16975,"MUNICIPIUL BUCUREŞTI",179169,1502,1097,924,173,0,1074,23,1700,603,432,642
44,"SECTOR 3","#N/A",179169,,406,"BUCUREŞTI SECTORUL 3 / ŞCOALA GIMNAZIALĂ Nr.81;",1,16975,"MUNICIPIUL BUCUREŞTI",179169,1380,966,835,131,0,945,21,1500,534,333,612
44,"SECTOR 3","#N/A",179169,,407,"BUCUREŞTI SECTORUL 3 / ŞCOALA GIMNAZIALĂ Nr.81;",1,16975,"MUNICIPIUL BUCUREŞTI",179169,1243,886,787,98,1,872,14,1399,513,302,570
44,"SECTOR 3","#N/A",179169,,408,"BUCUREŞTI SECTORUL 3 / COLEGIUL TEHNIC ""MIHAI BRAVU"";",1,16975,"MUNICIPIUL BUCUREŞTI",179169,1354,831,616,215,0,813,18,1500,669,297,516
44,"SECTOR 3","#N/A",179169,,409,"BUCUREŞTI SECTORUL 3 / COLEGIUL TEHNIC ""MIHAI BRAVU"";",1,16975,"MUNICIPIUL BUCUREŞTI",179169,1489,1238,855,383,0,1206,32,1600,362,393,813
44,"SECTOR 3","#N/A",179169,,410,"BUCUREŞTI SECTORUL 3 / COLEGIUL TEHNIC ""MIHAI BRAVU"";",1,16975,"MUNICIPIUL BUCUREŞTI",179169,1327,999,781,218,0,979,20,1500,501,322,657
44,"SECTOR 3","#N/A",179169,,411,"BUCUREŞTI SECTORUL 3 / COLEGIUL TEHNIC ""MIHAI BRAVU"";",1,16975,"MUNICIPIUL BUCUREŞTI",179169,1615,1050,967,83,0,1028,22,1800,750,463,565
44,"SECTOR 3","#N/A",179169,,412,"BUCUREŞTI SECTORUL 3 / COLEGIUL TEHNIC ""MIHAI BRAVU"";",1,16975,"MUNICIPIUL BUCUREŞTI",179169,1114,720,638,82,0,702,18,1200,480,313,389
44,"SECTOR 3","#N/A",179169,,413,"BUCUREŞTI SECTORUL 3 / COLEGIUL TEHNIC ""MIHAI BRAVU"";",1,16975,"MUNICIPIUL BUCUREŞTI",179169,1576,1087,930,157,0,1068,19,1700,613,371,697
44,"SECTOR 3","#N/A",179169,,414,"BUCUREŞTI SECTORUL 3 / COLEGIUL TEHNIC ""MIHAI BRAVU"";",1,16975,"MUNICIPIUL BUCUREŞTI",179169,1355,1098,856,240,2,1082,16,1500,402,421,661
44,"SECTOR 3","#N/A",179169,,415,"BUCUREŞTI SECTORUL 3 / COLEGIUL TEHNIC ""MIHAI BRAVU"";",1,16975,"MUNICIPIUL BUCUREŞTI",179169,1231,939,776,163,0,920,19,1400,461,357,563
44,"SECTOR 3","#N/A",179169,,416,"BUCUREŞTI SECTORUL 3 / COLEGIUL TEHNIC ""MIHAI BRAVU"";",1,16975,"MUNICIPIUL BUCUREŞTI",179169,1301,893,783,107,3,865,28,1399,506,379,486
44,"SECTOR 3","#N/A",179169,,417,"BUCUREŞTI SECTORUL 3 / COLEGIUL TEHNIC ""MIHAI BRAVU"";",1,16975,"MUNICIPIUL BUCUREŞTI",179169,1386,961,876,84,1,930,31,1500,539,420,510
44,"SECTOR 3","#N/A",179169,,418,"BUCUREŞTI SECTORUL 3 / COLEGIUL TEHNIC ""MIHAI BRAVU"";",1,16975,"MUNICIPIUL BUCUREŞTI",179169,1196,752,687,65,0,731,21,1300,548,302,429
44,"SECTOR 3","#N/A",179169,,419,"BUCUREŞTI SECTORUL 3 / COLEGIUL TEHNIC ""MIHAI BRAVU"";",1,16975,"MUNICIPIUL BUCUREŞTI",179169,1438,882,825,57,0,865,17,1600,718,381,484
44,"SECTOR 3","#N/A",179169,,420,"BUCUREŞTI SECTORUL 3 / COLEGIUL TEHNIC ""MIHAI BRAVU"";",1,16975,"MUNICIPIUL BUCUREŞTI",179169,1178,792,687,101,4,769,23,1300,508,352,417
44,"SECTOR 3","#N/A",179169,,421,"BUCUREŞTI SECTORUL 3 / ŞCOALA GIMNAZIALĂ Nr.95;",1,16975,"MUNICIPIUL BUCUREŞTI",179169,1447,1004,822,181,1,982,22,1600,596,344,638
44,"SECTOR 3","#N/A",179169,,422,"BUCUREŞTI SECTORUL 3 / ŞCOALA GIMNAZIALĂ Nr.95;",1,16975,"MUNICIPIUL BUCUREŞTI",179169,1410,882,779,101,2,861,21,1500,618,292,569
44,"SECTOR 3","#N/A",179169,,423,"BUCUREŞTI SECTORUL 3 / ŞCOALA GIMNAZIALĂ Nr.95;",1,16975,"MUNICIPIUL BUCUREŞTI",179169,1365,765,679,84,2,752,12,1500,735,319,433
44,"SECTOR 3","#N/A",179169,,424,"BUCUREŞTI SECTORUL 3 / ŞCOALA GIMNAZIALĂ Nr.95;",1,16975,"MUNICIPIUL BUCUREŞTI",179169,1060,676,619,56,1,667,9,1187,511,259,408
44,"SECTOR 3","#N/A",179169,,425,"BUCUREŞTI SECTORUL 3 / ŞCOALA GIMNAZIALĂ Nr.95;",1,16975,"MUNICIPIUL BUCUREŞTI",179169,1537,954,883,70,1,934,20,1700,746,358,576
44,"SECTOR 3","#N/A",179169,,426,"BUCUREŞTI SECTORUL 3 / ŞCOALA GIMNAZIALĂ Nr.95;",1,16975,"MUNICIPIUL BUCUREŞTI",179169,1379,702,639,63,0,690,12,1500,798,266,424
44,"SECTOR 3","#N/A",179169,,427,"BUCUREŞTI SECTORUL 3 / ŞCOALA GIMNAZIALĂ Nr.95;",1,16975,"MUNICIPIUL BUCUREŞTI",179169,1339,1074,832,242,0,1060,14,1500,426,359,701
44,"SECTOR 3","#N/A",179169,,428,"BUCUREŞTI SECTORUL 3 / ŞCOALA GIMNAZIALĂ Nr.95;",1,16975,"MUNICIPIUL BUCUREŞTI",179169,1442,1076,928,148,0,1047,29,1600,524,409,638
44,"SECTOR 3","#N/A",179169,,429,"BUCUREŞTI SECTORUL 3 / ŞCOALA GIMNAZIALĂ Nr.95;",1,16975,"MUNICIPIUL BUCUREŞTI",179169,1667,1117,1004,111,2,1089,28,1800,683,406,683
44,"SECTOR 3","#N/A",179169,,430,"BUCUREŞTI SECTORUL 3 / ŞCOALA GIMNAZIALĂ Nr.95;",1,16975,"MUNICIPIUL BUCUREŞTI",179169,1563,1027,928,98,1,1012,15,1698,671,388,624
44,"SECTOR 3","#N/A",179169,,431,"BUCUREŞTI SECTORUL 3 / ŞCOALA GIMNAZIALĂ Nr.84",1,16975,"MUNICIPIUL BUCUREŞTI",179169,988,930,589,341,0,904,26,1100,170,312,592
44,"SECTOR 3","#N/A",179169,,432,"BUCUREŞTI SECTORUL 3 / ŞCOALA GIMNAZIALĂ Nr.84",1,16975,"MUNICIPIUL BUCUREŞTI",179169,1998,1228,1003,225,0,1203,25,2200,972,476,727
44,"SECTOR 3","#N/A",179169,,433,"BUCUREŞTI SECTORUL 3 / ŞCOALA GIMNAZIALĂ Nr.84",1,16975,"MUNICIPIUL BUCUREŞTI",179169,1374,945,794,151,0,926,19,1500,555,365,561
44,"SECTOR 3","#N/A",179169,,434,"BUCUREŞTI SECTORUL 3 / ŞCOALA GIMNAZIALĂ Nr.84",1,16975,"MUNICIPIUL BUCUREŞTI",179169,1567,1021,909,109,3,1000,21,1700,679,440,560
44,"SECTOR 3","#N/A",179169,,435,"BUCUREŞTI SECTORUL 3 / ŞCOALA GIMNAZIALĂ Nr.84",1,16975,"MUNICIPIUL BUCUREŞTI",179169,1447,990,878,112,0,966,24,1600,610,416,550
44,"SECTOR 3","#N/A",179169,,436,"BUCUREŞTI SECTORUL 3 / ŞCOALA GIMNAZIALĂ Nr.84;",1,16975,"MUNICIPIUL BUCUREŞTI",179169,1301,767,688,79,0,747,20,1400,633,325,422
44,"SECTOR 3","#N/A",179169,,437,"BUCUREŞTI SECTORUL 3 / ŞCOALA GIMNAZIALĂ Nr.86;",1,16975,"MUNICIPIUL BUCUREŞTI",179169,1392,998,846,150,2,969,27,1500,502,357,612
44,"SECTOR 3","#N/A",179169,,438,"BUCUREŞTI SECTORUL 3 / ŞCOALA GIMNAZIALĂ Nr 86;",1,16975,"MUNICIPIUL BUCUREŞTI",179169,1615,1235,1029,206,0,1212,23,1800,565,461,751
44,"SECTOR 3","#N/A",179169,,439,"BUCUREŞTI SECTORUL 3 / ŞCOALA GIMNAZIALĂ Nr 86;",1,16975,"MUNICIPIUL BUCUREŞTI",179169,1685,1104,1036,64,4,1076,28,1900,796,455,621
44,"SECTOR 3","#N/A",179169,,440,"BUCUREŞTI SECTORUL 3 / ŞCOALA GIMNAZIALĂ Nr 86;",1,16975,"MUNICIPIUL BUCUREŞTI",179169,1761,1116,1032,83,1,1096,20,1900,784,454,642
44,"SECTOR 3","#N/A",179169,,441,"BUCUREŞTI SECTORUL 3 / ŞCOALA GIMNAZIALĂ Nr 86;",1,16975,"MUNICIPIUL BUCUREŞTI",179169,1670,976,924,50,2,955,21,1801,825,397,558
44,"SECTOR 3","#N/A",179169,,442,"BUCUREŞTI SECTORUL 3 / ŞCOALA GIMNAZIALĂ Nr 86;",1,16975,"MUNICIPIUL BUCUREŞTI",179169,1389,848,793,52,3,828,20,1500,652,342,486
44,"SECTOR 3","#N/A",179169,,443,"BUCUREŞTI SECTORUL 3 / ŞCOALA GIMNAZIALĂ Nr 86;",1,16975,"MUNICIPIUL BUCUREŞTI",179169,1680,1129,1064,62,3,1100,29,1800,671,417,683
44,"SECTOR 3","#N/A",179169,,444,"BUCUREŞTI SECTORUL 3 / ŞCOALA GIMNAZIALĂ ""LEONARDO DA VINCI"";",1,16975,"MUNICIPIUL BUCUREŞTI",179169,1521,1231,921,179,131,1206,25,1700,469,439,767
44,"SECTOR 3","#N/A",179169,,445,"BUCUREŞTI SECTORUL 3 / ŞCOALA GIMNAZIALĂ ""LEONARDO DA VINCI"";",1,16975,"MUNICIPIUL BUCUREŞTI",179169,1386,1054,832,221,1,1037,16,1501,447,402,635
44,"SECTOR 3","#N/A",179169,,446,"BUCUREŞTI SECTORUL 3 / ŞCOALA GIMNAZIALĂ ""LEONARDO DA VINCI"";",1,16975,"MUNICIPIUL BUCUREŞTI",179169,1498,982,887,91,4,961,21,1600,618,346,615
44,"SECTOR 3","#N/A",179169,,447,"BUCUREŞTI SECTORUL 3 / ŞCOALA GIMNAZIALĂ ""LEONARDO DA VINCI"";",1,16975,"MUNICIPIUL BUCUREŞTI",179169,1315,931,853,78,0,916,15,1400,469,346,570
44,"SECTOR 3","#N/A",179169,,448,"BUCUREŞTI SECTORUL 3 / ŞCOALA GIMNAZIALĂ ""LEONARDO DA VINCI"";",1,16975,"MUNICIPIUL BUCUREŞTI",179169,1229,863,814,48,1,843,20,1300,437,298,545
44,"SECTOR 3","#N/A",179169,,449,"BUCUREŞTI SECTORUL 3 / ŞCOALA GIMNAZIALĂ ""LEONARDO DA VINCI"";",1,16975,"MUNICIPIUL BUCUREŞTI",179169,1149,896,733,157,6,874,22,1299,403,338,536
44,"SECTOR 3","#N/A",179169,,450,"BUCUREŞTI SECTORUL 3 / ŞCOALA GIMNAZIALĂ ""LEONARDO DA VINCI"";",1,16975,"MUNICIPIUL BUCUREŞTI",179169,1132,885,769,116,0,868,17,1200,315,388,480
44,"SECTOR 3","#N/A",179169,,451,"BUCUREŞTI SECTORUL 3 / ŞCOALA GIMNAZIALĂ ""LEONARDO DA VINCI"";",1,16975,"MUNICIPIUL BUCUREŞTI",179169,1111,828,710,117,1,814,14,1200,372,316,498
44,"SECTOR 3","#N/A",179169,,452,"BUCUREŞTI SECTORUL 3 / ŞCOALA GIMNAZIALĂ ""LEONARDO DA VINCI"";",1,16975,"MUNICIPIUL BUCUREŞTI",179169,1191,826,733,92,1,804,22,1300,474,311,493
44,"SECTOR 3","#N/A",179169,,453,"BUCUREŞTI SECTORUL 3 / LICEUL TEORETIC ""BENJAMIN FRANKLIN"";",1,16975,"MUNICIPIUL BUCUREŞTI",179169,1317,884,791,93,0,867,17,1500,616,316,551
44,"SECTOR 3","#N/A",179169,,454,"BUCUREŞTI SECTORUL 3 / LICEUL TEORETIC ""BENJAMIN FRANKLIN"";",1,16975,"MUNICIPIUL BUCUREŞTI",179169,1128,755,682,73,0,743,12,1200,445,271,472
44,"SECTOR 3","#N/A",179169,,455,"BUCUREŞTI SECTORUL 3 / LICEUL TEORETIC ""BENJAMIN FRANKLIN"";",1,16975,"MUNICIPIUL BUCUREŞTI",179169,1017,687,616,70,1,674,13,1100,413,265,409
44,"SECTOR 3","#N/A",179169,,456,"BUCUREŞTI SECTORUL 3 / LICEUL TEORETIC ""BENJAMIN FRANKLIN"";",1,16975,"MUNICIPIUL BUCUREŞTI",179169,1147,758,718,37,3,737,21,1300,542,311,426
44,"SECTOR 3","#N/A",179169,,457,"BUCUREŞTI SECTORUL 3 / ŞCOALA GIMNAZIALĂ  ""ALEXANDRU IOAN CUZA"";",1,16975,"MUNICIPIUL BUCUREŞTI",179169,1239,825,776,47,2,805,20,1384,559,349,456
44,"SECTOR 3","#N/A",179169,,458,"BUCUREŞTI SECTORUL 3 / ŞCOALA GIMNAZIALĂ  ""ALEXANDRU IOAN CUZA"";",1,16975,"MUNICIPIUL BUCUREŞTI",179169,1427,1039,923,116,0,1020,19,1584,545,404,616
44,"SECTOR 3","#N/A",179169,,459,"BUCUREŞTI SECTORUL 3 / ŞCOALA GIMNAZIALĂ  ""ALEXANDRU IOAN CUZA"";",1,16975,"MUNICIPIUL BUCUREŞTI",179169,1664,1093,992,100,1,1079,14,1784,691,533,546
44,"SECTOR 3","#N/A",179169,,460,"BUCUREŞTI SECTORUL 3 / ŞCOALA GIMNAZIALĂ  ""ALEXANDRU IOAN CUZA"";",1,16975,"MUNICIPIUL BUCUREŞTI",179169,1310,874,838,35,1,847,27,1400,526,364,483
44,"SECTOR 3","#N/A",179169,,461,"BUCUREŞTI SECTORUL 3 / ŞCOALA GIMNAZIALĂ  ""ALEXANDRU IOAN CUZA"";",1,16975,"MUNICIPIUL BUCUREŞTI",179169,1062,668,614,53,1,657,11,1155,487,267,390
44,"SECTOR 3","#N/A",179169,,462,"BUCUREŞTI SECTORUL 3 / COLEGIUL TEHNIC ""ANGHEL SALIGNY"";",1,16975,"MUNICIPIUL BUCUREŞTI",179169,1270,1063,803,260,0,1032,31,1450,387,411,621
44,"SECTOR 3","#N/A",179169,,463,"BUCUREŞTI SECTORUL 3 / COLEGIUL TEHNIC ""ANGHEL SALIGNY"";",1,16975,"MUNICIPIUL BUCUREŞTI",179169,1100,886,697,188,1,874,12,1200,314,335,539
44,"SECTOR 3","#N/A",179169,,464,"BUCUREŞTI SECTORUL 3 / ŞCOALA GIMNAZIALĂ Nr.88",1,16975,"MUNICIPIUL BUCUREŞTI",179169,1435,994,888,104,2,976,18,1584,590,392,584
44,"SECTOR 3","#N/A",179169,,465,"BUCUREŞTI SECTORUL 3 / ŞCOALA GIMNAZIALĂ Nr.88",1,16975,"MUNICIPIUL BUCUREŞTI",179169,1480,1066,907,153,6,1041,25,1600,534,401,640
44,"SECTOR 3","#N/A",179169,,466,"BUCUREŞTI SECTORUL 3 / ŞCOALA GIMNAZIALĂ Nr.88",1,16975,"MUNICIPIUL BUCUREŞTI",179169,1397,1008,886,120,2,982,26,1499,491,401,581
44,"SECTOR 3","#N/A",179169,,467,"BUCUREŞTI SECTORUL 3 / ŞCOALA GIMNAZIALĂ Nr.88",1,16975,"MUNICIPIUL BUCUREŞTI",179169,1520,1063,955,108,0,1043,20,1700,637,454,589
44,"SECTOR 3","#N/A",179169,,468,"BUCUREŞTI SECTORUL 3 / ŞCOALA GIMNAZIALĂ Nr.88",1,16975,"MUNICIPIUL BUCUREŞTI",179169,1568,1063,1011,51,1,1042,21,1700,637,427,615
44,"SECTOR 3","#N/A",179169,,469,"BUCUREŞTI SECTORUL 3 / ŞCOALA GIMNAZIALĂ Nr.88",1,16975,"MUNICIPIUL BUCUREŞTI",179169,1365,885,835,50,0,862,23,1501,616,359,503
44,"SECTOR 3","#N/A",179169,,470,"BUCUREŞTI SECTORUL 3 / ŞCOALA GIMNAZIALĂ ""MIHAI BOTEZ"";",1,16975,"MUNICIPIUL BUCUREŞTI",179169,1269,1000,733,267,0,986,14,1400,400,400,586
44,"SECTOR 3","#N/A",179169,,471,"BUCUREŞTI SECTORUL 3 / ŞCOALA GIMNAZIALĂ ""MIHAI BOTEZ"";",1,16975,"MUNICIPIUL BUCUREŞTI",179169,1198,899,671,228,0,884,15,1300,401,331,553
44,"SECTOR 3","#N/A",179169,,472,"BUCUREŞTI SECTORUL 3 / ŞCOALA GIMNAZIALĂ ""MIHAI BOTEZ"";",1,16975,"MUNICIPIUL BUCUREŞTI",179169,1447,960,809,150,1,933,27,1600,640,415,518
44,"SECTOR 3","#N/A",179169,,473,"BUCUREŞTI SECTORUL 3 / ŞCOALA GIMNAZIALĂ ""MIHAI BOTEZ"";",1,16975,"MUNICIPIUL BUCUREŞTI",179169,1809,1159,1055,104,0,1133,26,2001,842,474,659
44,"SECTOR 3","#N/A",179169,,474,"BUCUREŞTI SECTORUL 3 / ŞCOALA GIMNAZIALĂ ""MIHAI BOTEZ"";",1,16975,"MUNICIPIUL BUCUREŞTI",179169,1509,970,826,144,0,942,28,1700,730,393,549
44,"SECTOR 3","#N/A",179169,,475,"BUCUREŞTI SECTORUL 3 / ŞCOALA GIMNAZIALĂ ""MIHAI BOTEZ"";",1,16975,"MUNICIPIUL BUCUREŞTI",179169,1420,886,822,63,1,861,25,1600,714,355,506
44,"SECTOR 3","#N/A",179169,,476,"BUCUREŞTI SECTORUL 3 / ŞCOALA GIMNAZIALĂ ""MIHAI BOTEZ"";",1,16975,"MUNICIPIUL BUCUREŞTI",179169,1404,859,811,48,0,844,15,1600,741,390,454
44,"SECTOR 3","#N/A",179169,,477,"BUCUREŞTI SECTORUL 3 / ŞCOALA GIMNAZIALĂ ""MIHAI BOTEZ"";",1,16975,"MUNICIPIUL BUCUREŞTI",179169,1447,925,835,89,1,899,26,1596,671,400,499
44,"SECTOR 3","#N/A",179169,,478,"BUCUREŞTI SECTORUL 3 / ŞCOALA GIMNAZIALĂ ""MIHAI BOTEZ"";",1,16975,"MUNICIPIUL BUCUREŞTI",179169,1570,1016,893,123,0,998,18,1700,684,442,556
44,"SECTOR 3","#N/A",179169,,479,"BUCUREŞTI SECTORUL 3 / ŞCOALA GIMNAZIALĂ ""MIHAI BOTEZ"";",1,16975,"MUNICIPIUL BUCUREŞTI",179169,1516,990,897,92,1,946,44,1687,697,441,505
44,"SECTOR 3","#N/A",179169,,480,"BUCUREŞTI SECTORUL 3 / ŞCOALA GIMNAZIALĂ ""MIHAI BOTEZ"";",1,16975,"MUNICIPIUL BUCUREŞTI",179169,1203,740,661,78,1,728,12,1300,560,299,429
44,"SECTOR 3","#N/A",179169,,481,"BUCUREŞTI SECTORUL 3 / LICEUL TEORETIC ""DANTE ALIGHIERI"";",1,16975,"MUNICIPIUL BUCUREŞTI",179169,1496,1080,979,100,1,1062,18,1600,520,436,626
44,"SECTOR 3","#N/A",179169,,482,"BUCUREŞTI SECTORUL 3 / LICEUL TEORETIC ""DANTE ALIGHIERI"";",1,16975,"MUNICIPIUL BUCUREŞTI",179169,1431,1077,907,170,0,1050,27,1600,523,444,606
44,"SECTOR 3","#N/A",179169,,483,"BUCUREŞTI SECTORUL 3 / LICEUL TEORETIC ""DANTE ALIGHIERI"";",1,16975,"MUNICIPIUL BUCUREŞTI",179169,1143,846,708,137,1,828,18,1300,454,323,505
44,"SECTOR 3","#N/A",179169,,484,"BUCUREŞTI SECTORUL 3 / LICEUL TEORETIC ""DANTE ALIGHIERI"";",1,16975,"MUNICIPIUL BUCUREŞTI",179169,1159,842,736,106,0,816,26,1300,458,360,456
44,"SECTOR 3","#N/A",179169,,485,"BUCUREŞTI SECTORUL 3 / LICEUL TEORETIC ""DANTE ALIGHIERI"";",1,16975,"MUNICIPIUL BUCUREŞTI",179169,1325,924,836,87,1,899,25,1500,576,393,506
44,"SECTOR 3","#N/A",179169,,486,"BUCUREŞTI SECTORUL 3 / ŞCOALA GIMNAZIALĂ Nr.195;",1,16975,"MUNICIPIUL BUCUREŞTI",179169,1252,1070,845,225,0,1046,24,1399,329,329,717
44,"SECTOR 3","#N/A",179169,,487,"BUCUREŞTI SECTORUL 3 / ŞCOALA GIMNAZIALĂ Nr.195;",1,16975,"MUNICIPIUL BUCUREŞTI",179169,1218,934,815,118,1,908,26,1300,366,361,547
44,"SECTOR 3","#N/A",179169,,488,"BUCUREŞTI SECTORUL 3 / ŞCOALA GIMNAZIALĂ Nr.195;",1,16975,"MUNICIPIUL BUCUREŞTI",179169,1239,897,811,86,0,876,21,1400,503,362,514
44,"SECTOR 3","#N/A",179169,,489,"BUCUREŞTI SECTORUL 3 / ŞCOALA GIMNAZIALĂ Nr.195;",1,16975,"MUNICIPIUL BUCUREŞTI",179169,1077,764,719,45,0,747,17,1200,436,326,421
44,"SECTOR 3","#N/A",179169,,490,"BUCUREŞTI SECTORUL 3 / ŞCOALA GIMNAZIALĂ Nr.195;",1,16975,"MUNICIPIUL BUCUREŞTI",179169,1098,752,681,71,0,732,20,1200,448,288,444
44,"SECTOR 3","#N/A",179169,,491,"BUCUREŞTI SECTORUL 3 / LICEUL TEHNOLOGIC ""ELIE RADU"";",1,16975,"MUNICIPIUL BUCUREŞTI",179169,1488,844,779,54,11,818,25,1600,756,375,443
44,"SECTOR 3","#N/A",179169,,492,"BUCUREŞTI SECTORUL 3 / LICEUL TEHNOLOGIC ""ELIE RADU"";",1,16975,"MUNICIPIUL BUCUREŞTI",179169,1529,955,837,111,7,933,22,1701,746,446,487
44,"SECTOR 3","#N/A",179169,,493,"BUCUREŞTI SECTORUL 3 / LICEUL TEHNOLOGIC ""ELIE RADU"";",1,16975,"MUNICIPIUL BUCUREŞTI",179169,1070,765,601,164,0,747,18,1200,435,284,463
44,"SECTOR 3","#N/A",179169,,494,"BUCUREŞTI SECTORUL 3 / LICEUL TEHNOLOGIC ""ELIE RADU"";",1,16975,"MUNICIPIUL BUCUREŞTI",179169,1654,933,833,99,1,910,23,1800,867,412,498
44,"SECTOR 3","#N/A",179169,,495,"BUCUREŞTI SECTORUL 3 / LICEUL TEHNOLOGIC ""ELIE RADU"";",1,16975,"MUNICIPIUL BUCUREŞTI",179169,1464,795,736,59,0,782,13,1600,805,399,383
44,"SECTOR 3","#N/A",179169,,496,"BUCUREŞTI SECTORUL 3 / LICEUL TEORETIC BILINGV ""DECEBAL"";",1,16975,"MUNICIPIUL BUCUREŞTI",179169,1205,836,680,155,1,823,13,1300,464,379,444
44,"SECTOR 3","#N/A",179169,,497,"BUCUREŞTI SECTORUL 3 / LICEUL TEORETIC BILINGV ""DECEBAL"";",1,16975,"MUNICIPIUL BUCUREŞTI",179169,1476,844,782,62,0,826,18,1600,756,396,430
44,"SECTOR 3","#N/A",179169,,498,"BUCUREŞTI SECTORUL 3 / LICEUL TEORETIC BILINGV ""DECEBAL"";",1,16975,"MUNICIPIUL BUCUREŞTI",179169,1555,779,716,63,0,766,13,1700,921,387,379
44,"SECTOR 3","#N/A",179169,,499,"BUCUREŞTI SECTORUL 3 / LICEUL TEORETIC BILINGV ""DECEBAL"";",1,16975,"MUNICIPIUL BUCUREŞTI",179169,1618,671,638,32,1,655,16,1800,1129,282,373
44,"SECTOR 3","#N/A",179169,,500,"BUCUREŞTI SECTORUL 3 / ŞCOALA GIMNAZIALĂ Nr.54;",1,16975,"MUNICIPIUL BUCUREŞTI",179169,1087,791,633,158,0,772,19,1200,409,278,494
44,"SECTOR 3","#N/A",179169,,501,"BUCUREŞTI SECTORUL 3 / ŞCOALA GIMNAZIALĂ Nr.54;",1,16975,"MUNICIPIUL BUCUREŞTI",179169,1360,969,798,171,0,938,31,1500,531,422,516
44,"SECTOR 3","#N/A",179169,,502,"BUCUREŞTI SECTORUL 3 / ŞCOALA GIMNAZIALĂ Nr.54;",1,16975,"MUNICIPIUL BUCUREŞTI",179169,1606,909,850,58,1,894,15,1800,891,402,492
44,"SECTOR 3","#N/A",179169,,503,"BUCUREŞTI SECTORUL 3 / ŞCOALA GIMNAZIALĂ Nr.54;",1,16975,"MUNICIPIUL BUCUREŞTI",179169,1416,978,885,93,0,951,27,1600,622,424,527
44,"SECTOR 3","#N/A",179169,,504,"BUCUREŞTI SECTORUL 3 / ŞCOALA GIMNAZIALĂ Nr.54;",1,16975,"MUNICIPIUL BUCUREŞTI",179169,1393,865,812,53,0,842,23,1500,635,355,487
44,"SECTOR 3","#N/A",179169,,505,"BUCUREŞTI SECTORUL 3 / ŞCOALA GIMNAZIALĂ Nr.54;",1,16975,"MUNICIPIUL BUCUREŞTI",179169,1234,791,717,74,0,771,20,1391,600,328,443
44,"SECTOR 3","#N/A",179169,,506,"BUCUREŞTI SECTORUL 3 / ŞCOALA GIMNAZIALĂ Nr.54;",1,16975,"MUNICIPIUL BUCUREŞTI",179169,1407,821,782,39,0,803,18,1600,779,366,437
44,"SECTOR 3","#N/A",179169,,507,"BUCUREŞTI SECTORUL 3 / ŞCOALA GIMNAZIALĂ Nr.54;",1,16975,"MUNICIPIUL BUCUREŞTI",179169,1231,686,666,20,0,671,15,1384,698,298,373
44,"SECTOR 3","#N/A",179169,,508,"BUCUREŞTI SECTORUL 3 / ŞCOALA GIMNAZIALĂ Nr.54;",1,16975,"MUNICIPIUL BUCUREŞTI",179169,1346,808,770,37,1,787,21,1499,691,416,371
44,"SECTOR 3","#N/A",179169,,509,"BUCUREŞTI SECTORUL 3 / ŞCOALA GIMNAZIALĂ Nr.54;",1,16975,"MUNICIPIUL BUCUREŞTI",179169,1534,898,848,48,2,873,25,1699,801,392,481
44,"SECTOR 3","#N/A",179169,,510,"BUCUREŞTI SECTORUL 3 / ŞCOALA GIMNAZIALĂ ""NICOLAE LABIŞ"";",1,16975,"MUNICIPIUL BUCUREŞTI",179169,1626,1095,986,108,1,1064,31,1797,702,454,610
44,"SECTOR 3","#N/A",179169,,511,"BUCUREŞTI SECTORUL 3 / ŞCOALA GIMNAZIALĂ ""NICOLAE LABIŞ"";",1,16975,"MUNICIPIUL BUCUREŞTI",179169,1255,833,708,124,1,817,16,1400,567,354,463
44,"SECTOR 3","#N/A",179169,,512,"BUCUREŞTI SECTORUL 3 / ŞCOALA GIMNAZIALĂ ""NICOLAE LABIŞ"";",1,16975,"MUNICIPIUL BUCUREŞTI",179169,1693,1018,932,86,0,1002,16,1900,882,343,659
44,"SECTOR 3","#N/A",179169,,513,"BUCUREŞTI SECTORUL 3 / ŞCOALA GIMNAZIALĂ ""NICOLAE LABIŞ"";",1,16975,"MUNICIPIUL BUCUREŞTI",179169,1458,969,912,56,1,944,25,1600,631,413,531
44,"SECTOR 3","#N/A",179169,,514,"BUCUREŞTI SECTORUL 3 / ŞCOALA GIMNAZIALĂ ""NICOLAE LABIŞ"";",1,16975,"MUNICIPIUL BUCUREŞTI",179169,1556,1015,926,87,2,986,29,1700,685,373,613
44,"SECTOR 3","#N/A",179169,,515,"BUCUREŞTI SECTORUL 3 / ŞCOALA GIMNAZIALĂ ""NICOLAE LABIŞ"";",1,16975,"MUNICIPIUL BUCUREŞTI",179169,1683,1001,923,78,0,981,20,1900,899,391,590
44,"SECTOR 3","#N/A",179169,,516,"BUCUREŞTI SECTORUL 3 / ŞCOALA GIMNAZIALĂ ""NICOLAE LABIŞ"";",1,16975,"MUNICIPIUL BUCUREŞTI",179169,1224,853,795,57,1,838,15,1300,447,321,517
44,"SECTOR 3","#N/A",179169,,517,"BUCUREŞTI SECTORUL 3 / ŞCOALA GIMNAZIALĂ ""NICOLAE LABIŞ"";",1,16975,"MUNICIPIUL BUCUREŞTI",179169,1274,897,842,53,2,880,17,1386,489,397,483
44,"SECTOR 3","#N/A",179169,,518,"BUCUREŞTI SECTORUL 3 / ŞCOALA GIMNAZIALĂ Nr.92;",1,16975,"MUNICIPIUL BUCUREŞTI",179169,1693,983,905,77,1,963,20,1901,918,372,591
44,"SECTOR 3","#N/A",179169,,519,"BUCUREŞTI SECTORUL 3 / ŞCOALA GIMNAZIALĂ Nr.92;",1,16975,"MUNICIPIUL BUCUREŞTI",179169,1425,1079,912,166,1,1054,25,1599,520,450,604
44,"SECTOR 3","#N/A",179169,,520,"BUCUREŞTI SECTORUL 3 / ŞCOALA GIMNAZIALĂ Nr.92;",1,16975,"MUNICIPIUL BUCUREŞTI",179169,1609,1023,942,81,0,991,32,1800,777,393,598
44,"SECTOR 3","#N/A",179169,,521,"BUCUREŞTI SECTORUL 3 / ŞCOALA GIMNAZIALĂ Nr.92;",1,16975,"MUNICIPIUL BUCUREŞTI",179169,1436,997,904,91,2,965,32,1600,603,360,605
44,"SECTOR 3","#N/A",179169,,522,"BUCUREŞTI SECTORUL 3 / ŞCOALA GIMNAZIALĂ Nr.92;",1,16975,"MUNICIPIUL BUCUREŞTI",179169,1200,764,706,56,2,748,16,1268,504,378,370
44,"SECTOR 3","#N/A",179169,,523,"BUCUREŞTI SECTORUL 3 / ŞCOALA GIMNAZIALĂ Nr.92;",1,16975,"MUNICIPIUL BUCUREŞTI",179169,1598,1006,952,54,0,990,16,1800,794,451,539
44,"SECTOR 3","#N/A",179169,,524,"BUCUREŞTI SECTORUL 3 / ŞCOALA GIMNAZIALĂ Nr.92;",1,16975,"MUNICIPIUL BUCUREŞTI",179169,1591,1011,955,56,0,983,28,1800,789,438,545
44,"SECTOR 3","#N/A",179169,,525,"BUCUREŞTI SECTORUL 3 / ŞCOALA GIMNAZIALĂ Nr.92;",1,16975,"MUNICIPIUL BUCUREŞTI",179169,1429,941,888,53,0,918,23,1600,659,469,449
44,"SECTOR 3","#N/A",179169,,526,"BUCUREŞTI SECTORUL 3 / ŞCOALA GIMNAZIALĂ Nr.92;",1,16975,"MUNICIPIUL BUCUREŞTI",179169,1526,908,866,42,0,892,16,1700,792,436,456
44,"SECTOR 3","#N/A",179169,,527,"BUCUREŞTI SECTORUL 3 / ŞCOALA GIMNAZIALĂ Nr.20;",1,16975,"MUNICIPIUL BUCUREŞTI",179169,1467,1017,917,99,1,995,22,1599,582,446,549
44,"SECTOR 3","#N/A",179169,,528,"BUCUREŞTI SECTORUL 3 / ŞCOALA GIMNAZIALĂ Nr.20;",1,16975,"MUNICIPIUL BUCUREŞTI",179169,1910,1209,1109,100,0,1180,29,2100,891,474,706
44,"SECTOR 3","#N/A",179169,,529,"BUCUREŞTI SECTORUL 3 / ŞCOALA GIMNAZIALĂ Nr.20;",1,16975,"MUNICIPIUL BUCUREŞTI",179169,1372,1008,865,143,0,984,24,1500,492,412,572
44,"SECTOR 3","#N/A",179169,,530,"BUCUREŞTI SECTORUL 3 / ŞCOALA GIMNAZIALĂ Nr.20;",1,16975,"MUNICIPIUL BUCUREŞTI",179169,1447,944,872,71,1,921,23,1600,656,402,519
44,"SECTOR 3","#N/A",179169,,531,"BUCUREŞTI SECTORUL 3 / ŞCOALA GIMNAZIALĂ Nr.20;",1,16975,"MUNICIPIUL BUCUREŞTI",179169,1521,980,919,60,1,951,29,1700,720,466,485
44,"SECTOR 3","#N/A",179169,,532,"BUCUREŞTI SECTORUL 3 / ŞCOALA GIMNAZIALĂ Nr.20;",1,16975,"MUNICIPIUL BUCUREŞTI",179169,1362,878,816,60,2,859,19,1484,606,360,499
44,"SECTOR 3","#N/A",179169,,533,"BUCUREŞTI SECTORUL 3 / COLEGIUL TEHNIC ""COSTIN D. NENIŢESCU"";",1,16975,"MUNICIPIUL BUCUREŞTI",179169,1793,1240,1037,203,0,1218,22,2000,760,434,784
44,"SECTOR 3","#N/A",179169,,534,"BUCUREŞTI SECTORUL 3 / COLEGIUL TEHNIC ""COSTIN D. NENIŢESCU"";",1,16975,"MUNICIPIUL BUCUREŞTI",179169,1420,958,764,194,0,939,19,1600,642,437,502
44,"SECTOR 3","#N/A",179169,,535,"BUCUREŞTI SECTORUL 3 / COLEGIUL TEHNIC ""COSTIN D. NENIŢESCU"";",1,16975,"MUNICIPIUL BUCUREŞTI",179169,1248,995,765,230,0,965,30,1409,414,394,571
44,"SECTOR 3","#N/A",179169,,536,"BUCUREŞTI SECTORUL 3 / COLEGIUL TEHNIC ""COSTIN D. NENIŢESCU"";",1,16975,"MUNICIPIUL BUCUREŞTI",179169,1564,1137,968,165,4,1106,31,1700,563,429,677
44,"SECTOR 3","#N/A",179169,,537,"BUCUREŞTI SECTORUL 3 / COLEGIUL TEHNIC ""COSTIN D. NENIŢESCU"";",1,16975,"MUNICIPIUL BUCUREŞTI",179169,1819,1285,1106,179,0,1251,34,2000,715,527,724
44,"SECTOR 3","#N/A",179169,,538,"BUCUREŞTI SECTORUL 3 / ŞCOALA GIMNAZIALĂ Nr.112;",1,16975,"MUNICIPIUL BUCUREŞTI",179169,1311,953,772,179,2,921,32,1400,447,414,507
44,"SECTOR 3","#N/A",179169,,539,"BUCUREŞTI SECTORUL 3 / ŞCOALA GIMNAZIALĂ Nr.112;",1,16975,"MUNICIPIUL BUCUREŞTI",179169,1296,1055,747,308,0,1020,35,1400,345,406,614
44,"SECTOR 3","#N/A",179169,,540,"BUCUREŞTI SECTORUL 3 / ŞCOALA GIMNAZIALĂ Nr.112;",1,16975,"MUNICIPIUL BUCUREŞTI",179169,1333,899,771,128,0,879,20,1500,601,404,475
44,"SECTOR 3","#N/A",179169,,541,"BUCUREŞTI SECTORUL 3 / ŞCOALA GIMNAZIALĂ Nr.112;",1,16975,"MUNICIPIUL BUCUREŞTI",179169,1615,1055,1002,53,0,1041,14,1800,745,489,552
44,"SECTOR 3","#N/A",179169,,542,"BUCUREŞTI SECTORUL 3 / ŞCOALA GIMNAZIALĂ Nr.112;",1,16975,"MUNICIPIUL BUCUREŞTI",179169,1312,892,825,65,2,873,19,1400,508,400,473
44,"SECTOR 3","#N/A",179169,,543,"BUCUREŞTI SECTORUL 3 / ŞCOALA GIMNAZIALĂ Nr.112;",1,16975,"MUNICIPIUL BUCUREŞTI",179169,1309,857,810,46,1,835,22,1386,529,375,460
44,"SECTOR 3","#N/A",179169,,544,"BUCUREŞTI SECTORUL 3 / ŞCOALA GIMNAZIALĂ Nr.112;",1,16975,"MUNICIPIUL BUCUREŞTI",179169,1264,748,711,37,0,734,14,1400,652,338,396
44,"SECTOR 3","#N/A",179169,,545,"BUCUREŞTI SECTORUL 3 / ŞCOALA GIMNAZIALĂ Nr.112;",1,16975,"MUNICIPIUL BUCUREŞTI",179169,1182,742,700,42,0,724,18,1300,558,354,370
44,"SECTOR 3","#N/A",179169,,546,"BUCUREŞTI SECTORUL 3 / ŞCOALA GIMNAZIALĂ Nr.112;",1,16975,"MUNICIPIUL BUCUREŞTI",179169,1311,825,784,40,1,808,17,1397,572,370,438
44,"SECTOR 3","#N/A",179169,,547,"BUCUREŞTI SECTORUL 3 / ŞCOALA GIMNAZIALĂ Nr.112;",1,16975,"MUNICIPIUL BUCUREŞTI",179169,1237,642,609,32,1,622,20,1400,758,299,323
44,"SECTOR 3","#N/A",179169,,548,"BUCUREŞTI SECTORUL 3 / ŞCOALA GIMNAZIALĂ Nr.200;",1,16975,"MUNICIPIUL BUCUREŞTI",179169,1645,1291,1063,225,3,1265,26,1800,509,560,705
44,"SECTOR 3","#N/A",179169,,549,"BUCUREŞTI SECTORUL 3 / ŞCOALA GIMNAZIALĂ Nr.200;",1,16975,"MUNICIPIUL BUCUREŞTI",179169,1328,1022,837,185,0,999,23,1500,478,395,604
44,"SECTOR 3","#N/A",179169,,550,"BUCUREŞTI SECTORUL 3 / ŞCOALA GIMNAZIALĂ Nr.200;",1,16975,"MUNICIPIUL BUCUREŞTI",179169,1507,930,843,61,26,911,19,1700,770,442,469
44,"SECTOR 3","#N/A",179169,,551,"BUCUREŞTI SECTORUL 3 / ŞCOALA GIMNAZIALĂ Nr.200;",1,16975,"MUNICIPIUL BUCUREŞTI",179169,1606,941,881,59,1,921,20,1800,859,456,465
44,"SECTOR 3","#N/A",179169,,552,"BUCUREŞTI SECTORUL 3 / ŞCOALA GIMNAZIALĂ Nr.200;",1,16975,"MUNICIPIUL BUCUREŞTI",179169,1535,895,850,44,1,876,19,1700,805,422,454
44,"SECTOR 3","#N/A",179169,,553,"BUCUREŞTI SECTORUL 3 / ŞCOALA GIMNAZIALĂ Nr.200;",1,16975,"MUNICIPIUL BUCUREŞTI",179169,1420,806,778,27,1,790,16,1599,793,335,455
44,"SECTOR 3","#N/A",179169,,554,"BUCUREŞTI SECTORUL 3 / ŞCOALA GIMNAZIALĂ Nr.200;",1,16975,"MUNICIPIUL BUCUREŞTI",179169,1739,1187,1139,47,1,1155,32,1900,713,514,641
44,"SECTOR 3","#N/A",179169,,555,"BUCUREŞTI SECTORUL 3 / ŞCOALA GIMNAZIALĂ  ""FEDERICO GARCIA LORCA"";",1,16975,"MUNICIPIUL BUCUREŞTI",179169,1322,923,724,198,1,904,19,1500,577,355,549
44,"SECTOR 3","#N/A",179169,,556,"BUCUREŞTI SECTORUL 3 / ŞCOALA GIMNAZIALĂ  ""FEDERICO GARCIA LORCA"";",1,16975,"MUNICIPIUL BUCUREŞTI",179169,1089,802,708,92,2,789,13,1238,436,301,488
44,"SECTOR 3","#N/A",179169,,557,"BUCUREŞTI SECTORUL 3 / ŞCOALA GIMNAZIALĂ  ""FEDERICO GARCIA LORCA"";",1,16975,"MUNICIPIUL BUCUREŞTI",179169,1236,875,797,77,1,853,22,1399,524,407,446
44,"SECTOR 3","#N/A",179169,,558,"BUCUREŞTI SECTORUL 3 / ŞCOALA GIMNAZIALĂ  ""FEDERICO GARCIA LORCA"";",1,16975,"MUNICIPIUL BUCUREŞTI",179169,1467,1055,998,53,4,1037,18,1600,545,384,653
44,"SECTOR 3","#N/A",179169,,559,"BUCUREŞTI SECTORUL 3 / ŞCOALA GIMNAZIALĂ  ""FEDERICO GARCIA LORCA"";",1,16975,"MUNICIPIUL BUCUREŞTI",179169,1429,928,881,46,1,911,17,1600,672,402,509
44,"SECTOR 3","#N/A",179169,,560,"BUCUREŞTI SECTORUL 3 / ŞCOALA GIMNAZIALĂ  ""FEDERICO GARCIA LORCA"";",1,16975,"MUNICIPIUL BUCUREŞTI",179169,1316,844,809,34,1,820,24,1500,656,381,439
44,"SECTOR 3","#N/A",179169,,561,"BUCUREŞTI SECTORUL 3 / ŞCOALA GIMNAZIALĂ  ""FEDERICO GARCIA LORCA"";",1,16975,"MUNICIPIUL BUCUREŞTI",179169,1454,896,852,44,0,876,20,1584,688,356,520
44,"SECTOR 3","#N/A",179169,,562,"BUCUREŞTI SECTORUL 3 / ŞCOALA GIMNAZIALĂ ""MEXIC"";",1,16975,"MUNICIPIUL BUCUREŞTI",179169,1751,1157,1061,95,1,1130,27,1885,728,474,656
44,"SECTOR 3","#N/A",179169,,563,"BUCUREŞTI SECTORUL 3 / ŞCOALA GIMNAZIALĂ ""MEXIC"";",1,16975,"MUNICIPIUL BUCUREŞTI",179169,1540,1083,915,168,0,1053,30,1700,617,485,568
44,"SECTOR 3","#N/A",179169,,564,"BUCUREŞTI SECTORUL 3 / ŞCOALA GIMNAZIALĂ ""MEXIC"";",1,16975,"MUNICIPIUL BUCUREŞTI",179169,1935,1306,1141,165,0,1282,24,2101,795,451,831
44,"SECTOR 3","#N/A",179169,,565,"BUCUREŞTI SECTORUL 3 / ŞCOALA GIMNAZIALĂ ""MEXIC"";",1,16975,"MUNICIPIUL BUCUREŞTI",179169,1725,882,750,132,0,870,12,1900,1018,389,481
44,"SECTOR 3","#N/A",179169,,566,"BUCUREŞTI SECTORUL 3 / ŞCOALA GIMNAZIALĂ ""MEXIC"";",1,16975,"MUNICIPIUL BUCUREŞTI",179169,1887,981,910,71,0,963,18,2100,1119,500,463
44,"SECTOR 3","#N/A",179169,,567,"BUCUREŞTI SECTORUL 3 / ŞCOALA GIMNAZIALĂ ""MEXIC"";",1,16975,"MUNICIPIUL BUCUREŞTI",179169,1569,954,921,33,0,929,25,1700,746,361,568
44,"SECTOR 3","#N/A",179169,,568,"BUCUREŞTI SECTORUL 3 / ŞCOALA GIMNAZIALĂ ""MEXIC"";",1,16975,"MUNICIPIUL BUCUREŞTI",179169,1690,977,938,38,1,952,25,1884,907,405,547
44,"SECTOR 3","#N/A",179169,,569,"BUCUREŞTI SECTORUL 3 / ŞCOALA GIMNAZIALĂ ""MEXIC"";",1,16975,"MUNICIPIUL BUCUREŞTI",179169,1986,1161,1111,49,1,1129,32,2200,1039,537,592
44,"SECTOR 3","#N/A",179169,,570,"BUCUREŞTI SECTORUL 3 / ŞCOALA GIMNAZIALĂ ""LIVIU REBREANU"";",1,16975,"MUNICIPIUL BUCUREŞTI",179169,1456,935,873,62,0,917,18,1600,665,426,491
44,"SECTOR 3","#N/A",179169,,571,"BUCUREŞTI SECTORUL 3 / ŞCOALA GIMNAZIALĂ ""LIVIU REBREANU"";",1,16975,"MUNICIPIUL BUCUREŞTI",179169,1070,694,641,52,1,680,14,1199,505,290,390
44,"SECTOR 3","#N/A",179169,,572,"BUCUREŞTI SECTORUL 3 / LICEUL TEORETIC ""AL. I. CUZA"";",1,16975,"MUNICIPIUL BUCUREŞTI",179169,1503,971,854,110,7,947,24,1600,629,377,570
44,"SECTOR 3","#N/A",179169,,573,"BUCUREŞTI SECTORUL 3 / LICEUL TEORETIC ""AL. I. CUZA"";",1,16975,"MUNICIPIUL BUCUREŞTI",179169,1410,1063,929,129,5,1037,26,1600,537,411,626
44,"SECTOR 3","#N/A",179169,,574,"BUCUREŞTI SECTORUL 3 / LICEUL TEORETIC ""AL. I. CUZA"";",1,16975,"MUNICIPIUL BUCUREŞTI",179169,1316,1015,892,123,0,999,16,1400,385,382,617
44,"SECTOR 3","#N/A",179169,,575,"BUCUREŞTI SECTORUL 3 / LICEUL TEORETIC ""AL. I. CUZA"";",1,16975,"MUNICIPIUL BUCUREŞTI",179169,1381,978,835,129,14,952,26,1500,522,409,543
44,"SECTOR 3","#N/A",179169,,576,"BUCUREŞTI SECTORUL 3 / LICEUL TEORETIC ""AL. I. CUZA"";",1,16975,"MUNICIPIUL BUCUREŞTI",179169,1415,971,865,93,13,943,28,1600,629,388,555
44,"SECTOR 3","#N/A",179169,,577,"BUCUREŞTI SECTORUL 3 / LICEUL TEORETIC ""AL. I. CUZA"";",1,16975,"MUNICIPIUL BUCUREŞTI",179169,1531,1062,981,80,1,1038,24,1700,638,434,604
44,"SECTOR 3","#N/A",179169,,578,"BUCUREŞTI SECTORUL 3 / LICEUL TEORETIC ""NICHITA STĂNESCU"";",1,16975,"MUNICIPIUL BUCUREŞTI",179169,1277,899,753,146,0,879,20,1400,501,398,481
44,"SECTOR 3","#N/A",179169,,579,"BUCUREŞTI SECTORUL 3 / LICEUL TEORETIC ""NICHITA STĂNESCU"";",1,16975,"MUNICIPIUL BUCUREŞTI",179169,1127,770,585,185,0,755,15,1287,517,300,455
44,"SECTOR 3","#N/A",179169,,580,"BUCUREŞTI SECTORUL 3 / LICEUL TEORETIC ""NICHITA STĂNESCU"";",1,16975,"MUNICIPIUL BUCUREŞTI",179169,1542,928,789,137,2,908,20,1700,772,401,507
44,"SECTOR 3","#N/A",179169,,581,"BUCUREŞTI SECTORUL 3 / LICEUL TEORETIC ""NICHITA STĂNESCU"";",1,16975,"MUNICIPIUL BUCUREŞTI",179169,1167,856,727,129,0,842,14,1300,444,293,549
44,"SECTOR 3","#N/A",179169,,582,"BUCUREŞTI SECTORUL 3 / LICEUL TEORETIC ""NICHITA STĂNESCU"";",1,16975,"MUNICIPIUL BUCUREŞTI",179169,1452,991,829,162,0,967,24,1600,609,428,539
44,"SECTOR 3","#N/A",179169,,583,"BUCUREŞTI SECTORUL 3 / LICEUL TEORETIC ""NICHITA STĂNESCU"";",1,16975,"MUNICIPIUL BUCUREŞTI",179169,1528,961,822,139,0,935,26,1700,739,379,556
44,"SECTOR 3","#N/A",179169,,584,"BUCUREŞTI SECTORUL 3 / ŞCOALA GIMNAZIALĂ Nr.16;",1,16975,"MUNICIPIUL BUCUREŞTI",179169,1497,1043,969,70,4,1016,27,1550,507,444,572
44,"SECTOR 3","#N/A",179169,,585,"BUCUREŞTI SECTORUL 3 / ŞCOALA GIMNAZIALĂ Nr.16;",1,16975,"MUNICIPIUL BUCUREŞTI",179169,1288,845,729,114,2,821,24,1400,555,374,447
44,"SECTOR 3","#N/A",179169,,586,"BUCUREŞTI SECTORUL 3 / ŞCOALA GIMNAZIALĂ Nr.16;",1,16975,"MUNICIPIUL BUCUREŞTI",179169,1498,1040,934,104,2,1017,23,1684,644,409,608
44,"SECTOR 3","#N/A",179169,,587,"BUCUREŞTI SECTORUL 3 / ŞCOALA GIMNAZIALĂ Nr.16;",1,16975,"MUNICIPIUL BUCUREŞTI",179169,1487,995,930,65,0,973,22,1584,589,404,569
44,"SECTOR 3","#N/A",179169,,588,"BUCUREŞTI SECTORUL 3 / ŞCOALA GIMNAZIALĂ Nr.149;",1,16975,"MUNICIPIUL BUCUREŞTI",179169,1562,1046,975,68,3,1021,25,1700,654,467,554
44,"SECTOR 3","#N/A",179169,,589,"BUCUREŞTI SECTORUL 3 / ŞCOALA GIMNAZIALĂ Nr.149;",1,16975,"MUNICIPIUL BUCUREŞTI",179169,1541,943,887,56,0,919,24,1700,757,438,481
44,"SECTOR 3","#N/A",179169,,590,"BUCUREŞTI SECTORUL 3 / ŞCOALA GIMNAZIALĂ Nr.149;",1,16975,"MUNICIPIUL BUCUREŞTI",179169,1465,942,902,38,2,924,18,1584,642,447,477
44,"SECTOR 3","#N/A",179169,,591,"BUCUREŞTI SECTORUL 3 / ŞCOALA GIMNAZIALĂ Nr. 82;",1,16975,"MUNICIPIUL BUCUREŞTI",179169,1334,949,814,132,3,928,21,1500,551,394,534
44,"SECTOR 3","#N/A",179169,,592,"BUCUREŞTI SECTORUL 3 / ŞCOALA GIMNAZIALĂ Nr. 82;",1,16975,"MUNICIPIUL BUCUREŞTI",179169,1450,1005,905,84,16,983,22,1568,563,439,544
44,"SECTOR 3","#N/A",179169,,593,"BUCUREŞTI SECTORUL 3 / ŞCOALA GIMNAZIALĂ Nr. 82;",1,16975,"MUNICIPIUL BUCUREŞTI",179169,1477,969,894,74,1,948,21,1600,631,443,505
44,"SECTOR 3","#N/A",179169,,594,"BUCUREŞTI SECTORUL 3 / ŞCOALA GIMNAZIALĂ Nr. 82;",1,16975,"MUNICIPIUL BUCUREŞTI",179169,1373,948,782,166,0,932,16,1500,552,391,541
44,"SECTOR 3","#N/A",179169,,595,"BUCUREŞTI SECTORUL 3 / ŞCOALA GIMNAZIALĂ Nr. 82;",1,16975,"MUNICIPIUL BUCUREŞTI",179169,1300,876,809,66,1,858,18,1400,524,392,466
44,"SECTOR 3","#N/A",179169,,596,"BUCUREŞTI SECTORUL 3 / ŞCOALA GIMNAZIALĂ Nr. 82;",1,16975,"MUNICIPIUL BUCUREŞTI",179169,1724,1286,1156,129,1,1255,31,1900,614,486,769
44,"SECTOR 3","#N/A",179169,,597,"BUCUREŞTI SECTORUL 3 / ŞCOALA GIMNAZIALĂ Nr. 82;",1,16975,"MUNICIPIUL BUCUREŞTI",179169,1415,986,879,104,3,963,23,1568,582,408,555
44,"SECTOR 3","#N/A",179169,,598,"BUCUREŞTI SECTORUL 3 / ŞCOALA GIMNAZIALĂ Nr. 82;",1,16975,"MUNICIPIUL BUCUREŞTI",179169,1212,779,723,56,0,765,14,1300,521,352,413
44,"SECTOR 3","#N/A",179169,,599,"BUCUREŞTI SECTORUL 3 / ŞCOALA GIMNAZIALĂ Nr.116;",1,16975,"MUNICIPIUL BUCUREŞTI",179169,1504,958,921,37,0,937,21,1668,710,433,504
44,"SECTOR 3","#N/A",179169,,600,"BUCUREŞTI SECTORUL 3 / ŞCOALA GIMNAZIALĂ Nr.116;",1,16975,"MUNICIPIUL BUCUREŞTI",179169,1403,889,831,58,0,864,25,1484,595,396,468
44,"SECTOR 3","#N/A",179169,,601,"BUCUREŞTI SECTORUL 3 / ŞCOALA GIMNAZIALĂ Nr.116;",1,16975,"MUNICIPIUL BUCUREŞTI",179169,1666,1094,971,123,0,1072,22,1798,704,508,564
44,"SECTOR 3","#N/A",179169,,602,"BUCUREŞTI SECTORUL 3 / ŞCOALA GIMNAZIALĂ Nr.116;",1,16975,"MUNICIPIUL BUCUREŞTI",179169,1618,1017,969,48,0,994,23,1784,767,464,530
44,"SECTOR 3","#N/A",179169,,603,"BUCUREŞTI SECTORUL 3 / ŞCOALA GIMNAZIALĂ Nr.116;",1,16975,"MUNICIPIUL BUCUREŞTI",179169,1449,907,866,41,0,882,25,1600,693,393,489
44,"SECTOR 3","#N/A",179169,,604,"BUCUREŞTI SECTORUL 3 / ŞCOALA GIMNAZIALĂ Nr.116;",1,16975,"MUNICIPIUL BUCUREŞTI",179169,1374,790,764,26,0,770,20,1500,710,366,404
44,"SECTOR 3","#N/A",179169,,605,"BUCUREŞTI SECTORUL 3 / ŞCOALA GIMNAZIALĂ Nr. 116;",1,16975,"MUNICIPIUL BUCUREŞTI",179169,1558,865,830,35,0,836,29,1700,835,371,465
44,"SECTOR 3","#N/A",179169,,606,"BUCUREŞTI SECTORUL 3 / ŞCOALA GIMNAZIALĂ Nr.55;",1,16975,"MUNICIPIUL BUCUREŞTI",179169,1891,637,595,42,0,619,18,2100,1463,310,309
44,"SECTOR 3","#N/A",179169,,607,"BUCUREŞTI SECTORUL 3 / ŞCOALA GIMNAZIALĂ Nr.55;",1,16975,"MUNICIPIUL BUCUREŞTI",179169,1931,688,598,90,0,676,12,2100,1412,365,311
44,"SECTOR 3","#N/A",179169,,608,"BUCUREŞTI SECTORUL 3 / ŞCOALA GIMNAZIALĂ Nr.55;",1,16975,"MUNICIPIUL BUCUREŞTI",179169,1870,248,208,40,0,243,5,1999,1751,120,123
44,"SECTOR 3","#N/A",179169,,609,"BUCUREŞTI SECTORUL 3 / ŞCOALA GIMNAZIALĂ Nr.55;",1,16975,"MUNICIPIUL BUCUREŞTI",179169,1897,421,387,34,0,409,12,2103,1682,228,181
44,"SECTOR 3","#N/A",179169,,610,"BUCUREŞTI SECTORUL 3 / ŞCOALA GIMNAZIALĂ Nr.55;",1,16975,"MUNICIPIUL BUCUREŞTI",179169,1881,72,44,28,0,71,1,2101,2029,37,34
44,"SECTOR 3","#N/A",179169,,611,"BUCUREŞTI SECTORUL 3 / ŞCOALA GIMNAZIALĂ Nr.55;",1,16975,"MUNICIPIUL BUCUREŞTI",179169,1962,47,17,30,0,47,0,2184,2137,18,29
44,"SECTOR 3","#N/A",179169,,612,"BUCUREŞTI SECTORUL 3 / ŞCOALA GIMNAZIALĂ Nr.55;",1,16975,"MUNICIPIUL BUCUREŞTI",179169,1902,349,335,14,0,339,10,2100,1751,187,152
44,"SECTOR 3","#N/A",179169,,613,"BUCUREŞTI SECTORUL 3 / ŞCOALA GIMNAZIALĂ Nr.55;",1,16975,"MUNICIPIUL BUCUREŞTI",179169,1821,588,549,39,0,576,12,2001,1413,262,314
44,"SECTOR 3","#N/A",179169,,614,"BUCUREŞTI SECTORUL 3 / ŞCOALA GIMNAZIALĂ Nr.55;",1,16975,"MUNICIPIUL BUCUREŞTI",179169,1879,646,630,16,0,633,12,2100,1454,334,299
44,"SECTOR 3","#N/A",179169,,615,"BUCUREŞTI SECTORUL 3 / ŞCOALA GIMNAZIALĂ Nr.55;",1,16975,"MUNICIPIUL BUCUREŞTI",179169,1720,258,244,14,0,250,8,1909,1651,145,105
44,"SECTOR 3","#N/A",179169,,616,"BUCUREŞTI SECTORUL 3 / ŞCOALA GIMNAZIALĂ Nr.55;",1,16975,"MUNICIPIUL BUCUREŞTI",179169,1791,514,495,18,1,498,16,2000,1486,272,226
44,"SECTOR 3","#N/A",179169,,617,"BUCUREŞTI SECTORUL 3 / ŞCOALA GIMNAZIALĂ Nr.55;",1,16975,"MUNICIPIUL BUCUREŞTI",179169,1874,462,449,13,0,452,10,2068,1606,292,160
44,"SECTOR 3","#N/A",179169,,618,"BUCUREŞTI SECTORUL 3 / ŞCOALA GIMNAZIALĂ Nr.55;",1,16975,"MUNICIPIUL BUCUREŞTI",179169,1898,387,369,18,0,381,6,2100,1713,248,133
44,"SECTOR 3","#N/A",179169,,619,"BUCUREŞTI SECTORUL 3 / ŞCOALA GIMNAZIALĂ Nr.55;",1,16975,"MUNICIPIUL BUCUREŞTI",179169,1980,325,312,13,0,319,6,2200,1875,136,183
44,"SECTOR 3","#N/A",179169,,620,"BUCUREŞTI SECTORUL 3 / ŞCOALA GIMNAZIALĂ Nr.55;",1,16975,"MUNICIPIUL BUCUREŞTI",179169,1943,152,143,9,0,150,2,2091,1939,89,61
44,"SECTOR 3","#N/A",179169,,621,"BUCUREŞTI SECTORUL 3 / ŞCOALA GIMNAZIALĂ Nr.55;",1,16975,"MUNICIPIUL BUCUREŞTI",179169,1791,306,291,15,0,301,5,2000,1694,147,154
44,"SECTOR 3","#N/A",179169,,622,"BUCUREŞTI SECTORUL 3 / ŞCOALA GIMNAZIALĂ Nr.47;",1,16975,"MUNICIPIUL BUCUREŞTI",179169,1681,171,154,17,0,166,5,1798,1627,97,69
44,"SECTOR 3","#N/A",179169,,623,"BUCUREŞTI SECTORUL 3 / ŞCOALA GIMNAZIALĂ Nr.47;",1,16975,"MUNICIPIUL BUCUREŞTI",179169,1863,505,471,34,0,501,4,2067,1562,288,213
44,"SECTOR 3","#N/A",179169,,624,"BUCUREŞTI SECTORUL 3 / ŞCOALA GIMNAZIALĂ Nr.47;",1,16975,"MUNICIPIUL BUCUREŞTI",179169,1865,936,903,33,0,924,12,2000,1064,493,431
44,"SECTOR 3","#N/A",179169,,625,"BUCUREŞTI SECTORUL 3 / ŞCOALA GIMNAZIALĂ Nr.47;",1,16975,"MUNICIPIUL BUCUREŞTI",179169,1902,233,220,13,0,227,6,2100,1867,129,98
44,"SECTOR 3","#N/A",179169,,626,"BUCUREŞTI SECTORUL 3 / ŞCOALA GIMNAZIALĂ Nr.47;",1,16975,"MUNICIPIUL BUCUREŞTI",179169,1866,125,110,15,0,118,7,2084,1959,62,56
44,"SECTOR 3","#N/A",179169,,627,"BUCUREŞTI SECTORUL 3 / ŞCOALA GIMNAZIALĂ Nr.47;",1,16975,"MUNICIPIUL BUCUREŞTI",179169,1821,114,98,16,0,113,1,2001,1887,64,49
44,"SECTOR 3","#N/A",179169,,628,"BUCUREŞTI SECTORUL 3 / ŞCOALA GIMNAZIALĂ Nr.47;",1,16975,"MUNICIPIUL BUCUREŞTI",179169,1888,101,86,15,0,96,5,2000,1899,33,63
44,"SECTOR 3","#N/A",179169,,629,"BUCUREŞTI SECTORUL 3 / ŞCOALA GIMNAZIALĂ Nr.78;",1,16975,"MUNICIPIUL BUCUREŞTI",179169,1783,543,470,72,1,533,10,1968,1425,284,249
44,"SECTOR 3","#N/A",179169,,630,"BUCUREŞTI SECTORUL 3 / ŞCOALA GIMNAZIALĂ Nr.78;",1,16975,"MUNICIPIUL BUCUREŞTI",179169,1921,821,809,12,0,805,16,2100,1279,428,377
44,"SECTOR 3","#N/A",179169,,631,"BUCUREŞTI SECTORUL 3 / ŞCOALA GIMNAZIALĂ Nr.78;",1,16975,"MUNICIPIUL BUCUREŞTI",179169,1638,210,200,10,0,205,5,1800,1590,108,97
44,"SECTOR 3","#N/A",179169,,632,"BUCUREŞTI SECTORUL 3 / ŞCOALA GIMNAZIALĂ Nr.78;",1,16975,"MUNICIPIUL BUCUREŞTI",179169,1651,42,9,33,0,42,0,1800,1758,18,24
44,"SECTOR 3","#N/A",179169,,633,"BUCUREŞTI SECTORUL 3 / ŞCOALA GIMNAZIALĂ Nr.78;",1,16975,"MUNICIPIUL BUCUREŞTI",179169,1734,308,289,19,0,304,4,1900,1592,165,139
44,"SECTOR 3","#N/A",179169,,634,"BUCUREŞTI SECTORUL 3 / ŞCOALA GIMNAZIALĂ Nr.78;",1,16975,"MUNICIPIUL BUCUREŞTI",179169,1761,257,245,12,0,253,4,1900,1643,124,129
44,"SECTOR 3","#N/A",179169,,635,"BUCUREŞTI SECTORUL 3 / ŞCOALA GIMNAZIALĂ Nr.78;",1,16975,"MUNICIPIUL BUCUREŞTI",179169,1951,296,281,15,0,290,6,2100,1804,135,155
44,"SECTOR 3","#N/A",179169,,636,"BUCUREŞTI SECTORUL 3 / ŞCOALA GIMNAZIALĂ Nr. 78",1,16975,"MUNICIPIUL BUCUREŞTI",179169,1690,180,169,11,0,177,3,1800,1620,93,84
44,"SECTOR 3","#N/A",179169,,637,"BUCUREŞTI SECTORUL 3 / ŞCOALA GIMNAZIALĂ Nr.67;",1,16975,"MUNICIPIUL BUCUREŞTI",179169,1749,889,842,47,0,869,20,1900,1011,437,432
44,"SECTOR 3","#N/A",179169,,638,"BUCUREŞTI SECTORUL 3 / ŞCOALA GIMNAZIALĂ Nr.67;",1,16975,"MUNICIPIUL BUCUREŞTI",179169,1803,943,899,44,0,917,26,2000,1057,427,490
45,"SECTOR 4","#N/A",179178,,639,"BUCUREŞTI SECTORUL 4 / COLEGIUL NAŢIONAL ""MIHAI EMINESCU""",1,16976,"MUNICIPIUL BUCUREŞTI",179178,1548,1046,895,151,0,1026,20,1700,654,398,628
45,"SECTOR 4","#N/A",179178,,640,"BUCUREŞTI SECTORUL 4 / COLEGIUL NAŢIONAL ""MIHAI EMINESCU""",1,16976,"MUNICIPIUL BUCUREŞTI",179178,1396,1060,740,205,115,1041,19,1500,440,415,626
45,"SECTOR 4","#N/A",179178,,641,"BUCUREŞTI SECTORUL 4 / COLEGIUL NAŢIONAL ""MIHAI EMINESCU""",1,16976,"MUNICIPIUL BUCUREŞTI",179178,1199,784,597,187,0,768,16,1298,514,286,482
45,"SECTOR 4","#N/A",179178,,642,"BUCUREŞTI SECTORUL 4 / GRĂDINIŢA Nr. 224",1,16976,"MUNICIPIUL BUCUREŞTI",179178,1267,784,685,99,0,768,16,1400,616,310,458
45,"SECTOR 4","#N/A",179178,,643,"BUCUREŞTI SECTORUL 4 / GRĂDINIŢA Nr. 224",1,16976,"MUNICIPIUL BUCUREŞTI",179178,1245,795,711,83,1,774,21,1400,605,315,459
45,"SECTOR 4","#N/A",179178,,644,"BUCUREŞTI SECTORUL 4 / ŞCOALA GIMNAZIALĂ ""IENĂCHIŢĂ VĂCĂRESCU""",1,16976,"MUNICIPIUL BUCUREŞTI",179178,1211,886,711,174,1,866,20,1300,414,340,526
45,"SECTOR 4","#N/A",179178,,645,"BUCUREŞTI SECTORUL 4 / ŞCOALA GIMNAZIALĂ ""IENĂCHIŢĂ VĂCĂRESCU""",1,16976,"MUNICIPIUL BUCUREŞTI",179178,1223,845,711,134,0,819,26,1300,455,334,485
45,"SECTOR 4","#N/A",179178,,646,"BUCUREŞTI SECTORUL 4 / ŞCOALA GIMNAZIALĂ ""IENĂCHIŢĂ VĂCĂRESCU""",1,16976,"MUNICIPIUL BUCUREŞTI",179178,1157,903,687,160,56,875,28,1300,397,407,468
45,"SECTOR 4","#N/A",179178,,647,"BUCUREŞTI SECTORUL 4 / ŞCOALA GIMNAZIALĂ ""IENĂCHIŢĂ VĂCĂRESCU""",1,16976,"MUNICIPIUL BUCUREŞTI",179178,1400,881,757,123,1,856,25,1600,719,362,494
45,"SECTOR 4","#N/A",179178,,648,"BUCUREŞTI SECTORUL 4 / Şcoala Gimnazială nr. 79",1,16976,"MUNICIPIUL BUCUREŞTI",179178,1042,766,606,135,25,740,26,1100,334,322,418
45,"SECTOR 4","#N/A",179178,,649,"BUCUREŞTI SECTORUL 4 / Şcoala Gimnazială nr. 79",1,16976,"MUNICIPIUL BUCUREŞTI",179178,1127,841,707,133,1,812,29,1200,359,348,464
45,"SECTOR 4","#N/A",179178,,650,"BUCUREŞTI SECTORUL 4 / Şcoala Gimnazială nr. 79",1,16976,"MUNICIPIUL BUCUREŞTI",179178,1362,865,758,105,2,852,13,1500,635,311,541
45,"SECTOR 4","#N/A",179178,,651,"BUCUREŞTI SECTORUL 4 / Colegiul Naţional  Ion Creangă",1,16976,"MUNICIPIUL BUCUREŞTI",179178,1341,793,729,63,1,780,13,1500,707,298,482
45,"SECTOR 4","#N/A",179178,,652,"BUCUREŞTI SECTORUL 4 / Colegiul Naţional  Ion Creangă",1,16976,"MUNICIPIUL BUCUREŞTI",179178,1103,788,640,148,0,772,16,1200,412,335,437
45,"SECTOR 4","#N/A",179178,,653,"BUCUREŞTI SECTORUL 4 / Colegiul Tehnic Grigore Cerchez",1,16976,"MUNICIPIUL BUCUREŞTI",179178,1131,870,694,176,0,853,17,1200,330,303,550
45,"SECTOR 4","#N/A",179178,,654,"BUCUREŞTI SECTORUL 4 / Colegiul Tehnic Grigore Cerchez",1,16976,"MUNICIPIUL BUCUREŞTI",179178,1393,943,762,181,0,922,21,1500,557,306,616
45,"SECTOR 4","#N/A",179178,,655,"BUCUREŞTI SECTORUL 4 / Colegiul Naţional Gh.Şincai",1,16976,"MUNICIPIUL BUCUREŞTI",179178,1227,1013,746,265,2,997,16,1300,287,319,678
45,"SECTOR 4","#N/A",179178,,656,"BUCUREŞTI SECTORUL 4 / Colegiul Naţional Gh.Şincai",1,16976,"MUNICIPIUL BUCUREŞTI",179178,1155,1066,740,326,0,1046,20,1300,234,299,747
45,"SECTOR 4","#N/A",179178,,657,"BUCUREŞTI SECTORUL 4 / Colegiul Naţional Gh.Şincai",1,16976,"MUNICIPIUL BUCUREŞTI",179178,1366,1220,904,316,0,1200,20,1500,280,424,776
45,"SECTOR 4","#N/A",179178,,658,"BUCUREŞTI SECTORUL 4 / Colegiul Naţional Gh.Şincai",1,16976,"MUNICIPIUL BUCUREŞTI",179178,1170,1011,741,270,0,992,19,1300,289,365,627
45,"SECTOR 4","#N/A",179178,,659,"BUCUREŞTI SECTORUL 4 / Colegiul Naţional Gh.Şincai",1,16976,"MUNICIPIUL BUCUREŞTI",179178,1552,1253,1003,250,0,1227,26,1699,446,453,774
45,"SECTOR 4","#N/A",179178,,660,"BUCUREŞTI SECTORUL 4 / Şcoala Gimnazială  nr. 97",1,16976,"MUNICIPIUL BUCUREŞTI",179178,1372,1157,896,259,2,1129,28,1500,343,382,747
45,"SECTOR 4","#N/A",179178,,661,"BUCUREŞTI SECTORUL 4 / Şcoala Gimnazială  nr. 97",1,16976,"MUNICIPIUL BUCUREŞTI",179178,1452,1096,940,156,0,1065,31,1600,504,412,653
45,"SECTOR 4","#N/A",179178,,662,"BUCUREŞTI SECTORUL 4 / Şcoala Gimnazială  nr. 97",1,16976,"MUNICIPIUL BUCUREŞTI",179178,1346,1115,896,219,0,1098,17,1500,385,371,727
45,"SECTOR 4","#N/A",179178,,663,"BUCUREŞTI SECTORUL 4 / Şcoala Gimnazială  nr. 97",1,16976,"MUNICIPIUL BUCUREŞTI",179178,1306,1003,860,143,0,988,15,1399,396,345,643
45,"SECTOR 4","#N/A",179178,,664,"BUCUREŞTI SECTORUL 4 / Şcoala Gimnazială  nr. 97",1,16976,"MUNICIPIUL BUCUREŞTI",179178,1061,949,669,280,0,933,16,1200,251,310,623
45,"SECTOR 4","#N/A",179178,,665,"BUCUREŞTI SECTORUL 4 / Colegiul Tehnic Petru Rareş",1,16976,"MUNICIPIUL BUCUREŞTI",179178,1181,943,784,159,0,926,17,1300,357,380,546
45,"SECTOR 4","#N/A",179178,,666,"BUCUREŞTI SECTORUL 4 / Colegiul Tehnic Petru Rareş",1,16976,"MUNICIPIUL BUCUREŞTI",179178,1316,990,876,114,0,964,26,1400,410,335,629
45,"SECTOR 4","#N/A",179178,,667,"BUCUREŞTI SECTORUL 4 / Colegiul Tehnic Petru Rareş",1,16976,"MUNICIPIUL BUCUREŞTI",179178,1111,791,719,72,0,776,15,1200,409,341,435
45,"SECTOR 4","#N/A",179178,,668,"BUCUREŞTI SECTORUL 4 / Colegiul Tehnic Petru Rareş",1,16976,"MUNICIPIUL BUCUREŞTI",179178,997,759,655,103,1,742,17,1100,341,315,427
45,"SECTOR 4","#N/A",179178,,669,"BUCUREŞTI SECTORUL 4 / Colegiul Tehnic Petru Rareş",1,16976,"MUNICIPIUL BUCUREŞTI",179178,1540,1107,976,130,1,1089,18,1700,593,409,680
45,"SECTOR 4","#N/A",179178,,670,"BUCUREŞTI SECTORUL 4 / Colegiul Tehnic Petru Rareş",1,16976,"MUNICIPIUL BUCUREŞTI",179178,1415,1063,880,183,0,1040,23,1600,537,429,611
45,"SECTOR 4","#N/A",179178,,671,"BUCUREŞTI SECTORUL 4 / Colegiul Tehnic Petru Rareş",1,16976,"MUNICIPIUL BUCUREŞTI",179178,1218,882,770,111,1,867,15,1300,418,360,507
45,"SECTOR 4","#N/A",179178,,672,"BUCUREŞTI SECTORUL 4 / Colegiul Tehnic Petru Rareş",1,16976,"MUNICIPIUL BUCUREŞTI",179178,1464,1106,1021,85,0,1085,21,1600,494,425,660
45,"SECTOR 4","#N/A",179178,,673,"BUCUREŞTI SECTORUL 4 / Colegiul Tehnic Petru Rareş",1,16976,"MUNICIPIUL BUCUREŞTI",179178,1585,1101,1020,81,0,1081,20,1700,599,451,630
45,"SECTOR 4","#N/A",179178,,674,"BUCUREŞTI SECTORUL 4 / Liceul Tehnologic Dacia",1,16976,"MUNICIPIUL BUCUREŞTI",179178,1621,1050,950,100,0,1022,28,1816,766,498,524
45,"SECTOR 4","#N/A",179178,,675,"BUCUREŞTI SECTORUL 4 / Liceul Tehnologic Dacia",1,16976,"MUNICIPIUL BUCUREŞTI",179178,1541,922,836,86,0,899,23,1700,778,380,519
45,"SECTOR 4","#N/A",179178,,676,"BUCUREŞTI SECTORUL 4 / Liceul Tehnologic DACIA",1,16976,"MUNICIPIUL BUCUREŞTI",179178,1483,736,696,39,1,720,16,1600,864,308,412
45,"SECTOR 4","#N/A",179178,,677,"BUCUREŞTI SECTORUL 4 / Colegiul Tehnic Miron Nicolescu",1,16976,"MUNICIPIUL BUCUREŞTI",179178,1871,1141,974,167,0,1122,19,2098,957,512,610
45,"SECTOR 4","#N/A",179178,,678,"BUCUREŞTI SECTORUL 4 / Colegiul Tehnic Miron Nicolescu",1,16976,"MUNICIPIUL BUCUREŞTI",179178,1717,966,777,189,0,950,16,1900,934,409,541
45,"SECTOR 4","#N/A",179178,,679,"BUCUREŞTI SECTORUL 4 / Colegiul Tehnic MIRON NICOLESCU",1,16976,"MUNICIPIUL BUCUREŞTI",179178,1958,963,858,105,0,944,19,2100,1137,550,394
45,"SECTOR 4","#N/A",179178,,680,"BUCUREŞTI SECTORUL 4 / Grădiniţa ""Panseluţa""",1,16976,"MUNICIPIUL BUCUREŞTI",179178,2068,1383,1217,166,0,1348,35,2304,921,596,752
45,"SECTOR 4","#N/A",179178,,681,"BUCUREŞTI SECTORUL 4 / Grădiniţa ""Panseluţa""",1,16976,"MUNICIPIUL BUCUREŞTI",179178,2041,1388,1232,156,0,1363,25,2300,912,620,743
45,"SECTOR 4","#N/A",179178,,682,"BUCUREŞTI SECTORUL 4 / Grădiniţa ""Panseluţa""",1,16976,"MUNICIPIUL BUCUREŞTI",179178,1997,1184,1120,64,0,1156,28,2200,1016,549,607
45,"SECTOR 4","#N/A",179178,,683,"BUCUREŞTI SECTORUL 4 / Grădiniţa ""Panseluţa""",1,16976,"MUNICIPIUL BUCUREŞTI",179178,2058,1191,1137,53,1,1158,33,2300,1109,520,638
45,"SECTOR 4","#N/A",179178,,684,"BUCUREŞTI SECTORUL 4 / Grădiniţa ""Panseluţa""",1,16976,"MUNICIPIUL BUCUREŞTI",179178,1806,1029,984,44,1,1004,25,2000,971,529,475
45,"SECTOR 4","#N/A",179178,,685,"BUCUREŞTI SECTORUL 4 / Şcoala Gimnazială  G-ral Eremia  Grigorescu",1,16976,"MUNICIPIUL BUCUREŞTI",179178,1965,1197,1064,133,0,1180,17,2200,1003,575,605
45,"SECTOR 4","#N/A",179178,,686,"BUCUREŞTI SECTORUL 4 / Şcoala Gimnazială  G-ral Eremia  Grigorescu",1,16976,"MUNICIPIUL BUCUREŞTI",179178,1836,1197,1084,113,0,1156,41,2000,803,518,638
45,"SECTOR 4","#N/A",179178,,687,"BUCUREŞTI SECTORUL 4 / Şcoala Gimnazială  G-ral Eremia  Grigorescu",1,16976,"MUNICIPIUL BUCUREŞTI",179178,1818,1279,1076,203,0,1237,42,2000,721,520,717
45,"SECTOR 4","#N/A",179178,,688,"BUCUREŞTI SECTORUL 4 / Şcoala Gimnazială  G-ral Eremia  Grigorescu",1,16976,"MUNICIPIUL BUCUREŞTI",179178,2010,1371,1191,180,0,1344,27,2200,829,516,828
45,"SECTOR 4","#N/A",179178,,689,"BUCUREŞTI SECTORUL 4 / Şcoala Gimnazială  G-ral Eremia  Grigorescu",1,16976,"MUNICIPIUL BUCUREŞTI",179178,1889,1292,1108,184,0,1260,32,2086,794,526,734
45,"SECTOR 4","#N/A",179178,,690,"BUCUREŞTI SECTORUL 4 / Şcoala Gimnazială  G-ral Eremia  Grigorescu",1,16976,"MUNICIPIUL BUCUREŞTI",179178,1798,1229,1037,101,91,1203,26,2001,772,569,634
45,"SECTOR 4","#N/A",179178,,691,"BUCUREŞTI SECTORUL 4 / Şcoala Gimnazială  G-ral Eremia  Grigorescu",1,16976,"MUNICIPIUL BUCUREŞTI",179178,1787,1269,1039,107,123,1226,43,2000,731,586,640
45,"SECTOR 4","#N/A",179178,,692,"BUCUREŞTI SECTORUL 4 / Şcoala Gimnazială nr. 133",1,16976,"MUNICIPIUL BUCUREŞTI",179178,1690,1191,1016,102,73,1172,19,1900,709,580,592
45,"SECTOR 4","#N/A",179178,,693,"BUCUREŞTI SECTORUL 4 / Şcoala Gimnazială nr. 133",1,16976,"MUNICIPIUL BUCUREŞTI",179178,1670,1103,1044,59,0,1075,28,1800,697,490,585
45,"SECTOR 4","#N/A",179178,,694,"BUCUREŞTI SECTORUL 4 / Şcoala Gimnazială nr. 133",1,16976,"MUNICIPIUL BUCUREŞTI",179178,1628,1224,1032,168,24,1200,24,1800,576,613,587
45,"SECTOR 4","#N/A",179178,,695,"BUCUREŞTI SECTORUL 4 / Şcoala Gimnazială nr. 133",1,16976,"MUNICIPIUL BUCUREŞTI",179178,1701,1228,1040,123,65,1189,39,1900,672,537,652
45,"SECTOR 4","#N/A",179178,,696,"BUCUREŞTI SECTORUL 4 / Şcoala Gimnazială nr. 133",1,16976,"MUNICIPIUL BUCUREŞTI",179178,1722,1266,1022,129,115,1233,33,1900,634,553,680
45,"SECTOR 4","#N/A",179178,,697,"BUCUREŞTI SECTORUL 4 / Şcoala Gimnazială nr. 133",1,16976,"MUNICIPIUL BUCUREŞTI",179178,1592,1127,996,131,0,1105,22,1800,673,522,583
45,"SECTOR 4","#N/A",179178,,698,"BUCUREŞTI SECTORUL 4 / Şcoala Gimnazială  nr. 113",1,16976,"MUNICIPIUL BUCUREŞTI",179178,1893,1319,1167,152,0,1285,34,2100,781,566,719
45,"SECTOR 4","#N/A",179178,,699,"BUCUREŞTI SECTORUL 4 / Şcoala Gimnazială  nr. 113",1,16976,"MUNICIPIUL BUCUREŞTI",179178,1981,1260,1143,117,0,1229,31,2210,950,518,711
45,"SECTOR 4","#N/A",179178,,700,"BUCUREŞTI SECTORUL 4 / Şcoala Gimnazială  nr. 113",1,16976,"MUNICIPIUL BUCUREŞTI",179178,1832,1155,1098,57,0,1123,32,2000,845,516,607
45,"SECTOR 4","#N/A",179178,,701,"BUCUREŞTI SECTORUL 4 / Şcoala Gimnazială  nr. 113",1,16976,"MUNICIPIUL BUCUREŞTI",179178,2030,1376,1301,75,0,1353,23,2200,824,596,757
45,"SECTOR 4","#N/A",179178,,702,"BUCUREŞTI SECTORUL 4 / Şcoala Gimnazială  nr. 113",1,16976,"MUNICIPIUL BUCUREŞTI",179178,1849,1356,1085,85,186,1329,27,2000,644,623,706
45,"SECTOR 4","#N/A",179178,,703,"BUCUREŞTI SECTORUL 4 / Şcoala Gimnazială  nr. 113",1,16976,"MUNICIPIUL BUCUREŞTI",179178,1796,1183,1093,90,0,1158,25,2000,817,493,665
45,"SECTOR 4","#N/A",179178,,704,"BUCUREŞTI SECTORUL 4 / Şcoala Gimnazială  ""Mărţişor""",1,16976,"MUNICIPIUL BUCUREŞTI",179178,1872,1184,1084,100,0,1144,40,2100,916,491,653
45,"SECTOR 4","#N/A",179178,,705,"BUCUREŞTI SECTORUL 4 / Şcoala Gimnazială  ""Mărţişor""",1,16976,"MUNICIPIUL BUCUREŞTI",179178,1330,892,769,122,1,878,14,1500,608,388,490
45,"SECTOR 4","#N/A",179178,,706,"BUCUREŞTI SECTORUL 4 / Şcoala Gimnazială  ""Mărţişor""",1,16976,"MUNICIPIUL BUCUREŞTI",179178,1772,1221,1110,111,0,1189,32,2000,779,431,758
45,"SECTOR 4","#N/A",179178,,707,"BUCUREŞTI SECTORUL 4 / Şcoala Gimnazială  ""Mărţişor""",1,16976,"MUNICIPIUL BUCUREŞTI",179178,1431,970,862,108,0,939,31,1600,630,372,567
45,"SECTOR 4","#N/A",179178,,708,"BUCUREŞTI SECTORUL 4 / Şcoala Gimnazială  ""Mărţişor""",1,16976,"MUNICIPIUL BUCUREŞTI",179178,1465,982,887,95,0,954,28,1600,618,442,512
45,"SECTOR 4","#N/A",179178,,709,"BUCUREŞTI SECTORUL 4 / Şcoala Gimnazială nr. 190",1,16976,"MUNICIPIUL BUCUREŞTI",179178,1807,1399,1159,240,0,1371,28,2000,601,627,744
45,"SECTOR 4","#N/A",179178,,710,"BUCUREŞTI SECTORUL 4 / Şcoala Gimnazială nr. 190",1,16976,"MUNICIPIUL BUCUREŞTI",179178,1426,1212,904,307,1,1176,36,1600,388,443,733
45,"SECTOR 4","#N/A",179178,,711,"BUCUREŞTI SECTORUL 4 / Şcoala Gimnazială nr. 190",1,16976,"MUNICIPIUL BUCUREŞTI",179178,1380,1111,872,239,0,1087,24,1500,389,419,668
45,"SECTOR 4","#N/A",179178,,712,"BUCUREŞTI SECTORUL 4 / Şcoala Gimnazială nr. 190",1,16976,"MUNICIPIUL BUCUREŞTI",179178,1540,1126,909,217,0,1096,30,1700,574,484,612
45,"SECTOR 4","#N/A",179178,,713,"BUCUREŞTI SECTORUL 4 / Şcoala Gimnazială nr. 190",1,16976,"MUNICIPIUL BUCUREŞTI",179178,1405,964,809,155,0,951,13,1600,636,418,533
45,"SECTOR 4","#N/A",179178,,714,"BUCUREŞTI SECTORUL 4 / Şcoala Gimnazială nr. 190",1,16976,"MUNICIPIUL BUCUREŞTI",179178,1278,856,722,134,0,833,23,1399,543,314,519
45,"SECTOR 4","#N/A",179178,,715,"BUCUREŞTI SECTORUL 4 / Şcoala Gimnazială nr. 190",1,16976,"MUNICIPIUL BUCUREŞTI",179178,1407,1014,889,124,1,990,24,1500,486,412,578
45,"SECTOR 4","#N/A",179178,,716,"BUCUREŞTI SECTORUL 4 / Şcoala Gimnazială nr. 96",1,16976,"MUNICIPIUL BUCUREŞTI",179178,993,714,632,82,0,705,9,1100,386,310,395
45,"SECTOR 4","#N/A",179178,,717,"BUCUREŞTI SECTORUL 4 / Şcoala Gimnazială nr. 96",1,16976,"MUNICIPIUL BUCUREŞTI",179178,1243,841,769,72,0,818,23,1400,559,393,425
45,"SECTOR 4","#N/A",179178,,718,"BUCUREŞTI SECTORUL 4 / Şcoala Gimnazială nr. 96",1,16976,"MUNICIPIUL BUCUREŞTI",179178,1126,748,657,91,0,728,20,1200,452,345,383
45,"SECTOR 4","#N/A",179178,,719,"BUCUREŞTI SECTORUL 4 / Şcoala Gimnazială nr. 96",1,16976,"MUNICIPIUL BUCUREŞTI",179178,1733,1091,1010,80,1,1063,28,1900,809,516,547
45,"SECTOR 4","#N/A",179178,,720,"BUCUREŞTI SECTORUL 4 / Şcoala Gimnazială nr. 96",1,16976,"MUNICIPIUL BUCUREŞTI",179178,1290,823,771,52,0,806,17,1400,577,365,441
45,"SECTOR 4","#N/A",179178,,721,"BUCUREŞTI SECTORUL 4 / Colegiul Naţional Octav Onicescu",1,16976,"MUNICIPIUL BUCUREŞTI",179178,1825,1168,1077,91,0,1138,30,2000,832,537,601
45,"SECTOR 4","#N/A",179178,,722,"BUCUREŞTI SECTORUL 4 / Colegiul Naţional Octav Onicescu",1,16976,"MUNICIPIUL BUCUREŞTI",179178,1258,812,746,66,0,786,26,1400,588,350,436
45,"SECTOR 4","#N/A",179178,,723,"BUCUREŞTI SECTORUL 4 / Colegiul Naţional Octav Onicescu",1,16976,"MUNICIPIUL BUCUREŞTI",179178,1531,857,822,35,0,836,21,1700,843,424,412
45,"SECTOR 4","#N/A",179178,,724,"BUCUREŞTI SECTORUL 4 / Colegiul Naţional Octav Onicescu",1,16976,"MUNICIPIUL BUCUREŞTI",179178,1433,961,929,32,0,935,26,1600,639,435,500
45,"SECTOR 4","#N/A",179178,,725,"BUCUREŞTI SECTORUL 4 / Şcoala Gimnazială nr. 108",1,16976,"MUNICIPIUL BUCUREŞTI",179178,1448,1012,934,77,1,993,19,1600,588,430,563
45,"SECTOR 4","#N/A",179178,,726,"BUCUREŞTI SECTORUL 4 / Şcoala Gimnazială nr. 108",1,16976,"MUNICIPIUL BUCUREŞTI",179178,1379,968,883,85,0,942,26,1500,532,483,459
45,"SECTOR 4","#N/A",179178,,727,"BUCUREŞTI SECTORUL 4 / Şcoala Gimnazială nr. 108",1,16976,"MUNICIPIUL BUCUREŞTI",179178,1534,1031,946,85,0,1015,16,1700,669,475,540
45,"SECTOR 4","#N/A",179178,,728,"BUCUREŞTI SECTORUL 4 / Şcoala Gimnazială nr. 108",1,16976,"MUNICIPIUL BUCUREŞTI",179178,1562,993,953,40,0,968,25,1700,707,433,535
45,"SECTOR 4","#N/A",179178,,729,"BUCUREŞTI SECTORUL 4 / Şcoala Gimnazială nr. 108",1,16976,"MUNICIPIUL BUCUREŞTI",179178,1409,858,831,27,0,844,14,1600,742,394,450
45,"SECTOR 4","#N/A",179178,,730,"BUCUREŞTI SECTORUL 4 / Şcoala Gimnazială Avram Iancu",1,16976,"MUNICIPIUL BUCUREŞTI",179178,1765,1222,1145,76,1,1198,24,1900,678,535,663
45,"SECTOR 4","#N/A",179178,,731,"BUCUREŞTI SECTORUL 4 / Şcoala Gimnazială Avram Iancu",1,16976,"MUNICIPIUL BUCUREŞTI",179178,1385,974,881,93,0,943,31,1500,526,447,496
45,"SECTOR 4","#N/A",179178,,732,"BUCUREŞTI SECTORUL 4 / Şcoala Gimnazială Avram Iancu",1,16976,"MUNICIPIUL BUCUREŞTI",179178,1216,805,729,76,0,787,18,1300,495,327,460
45,"SECTOR 4","#N/A",179178,,733,"BUCUREŞTI SECTORUL 4 / Şcoala Gimnazială Avram Iancu",1,16976,"MUNICIPIUL BUCUREŞTI",179178,1570,910,870,40,0,899,11,1700,790,406,493
45,"SECTOR 4","#N/A",179178,,734,"BUCUREŞTI SECTORUL 4 / Şcoala Gimnazială Avram Iancu",1,16976,"MUNICIPIUL BUCUREŞTI",179178,1572,1066,1011,55,0,1046,20,1700,634,492,554
45,"SECTOR 4","#N/A",179178,,735,"BUCUREŞTI SECTORUL 4 / Şcoala Gimnazială nr. 189",1,16976,"MUNICIPIUL BUCUREŞTI",179178,1398,866,781,84,1,850,16,1600,734,419,431
45,"SECTOR 4","#N/A",179178,,736,"BUCUREŞTI SECTORUL 4 / Şcoala Gimnazială nr. 189",1,16976,"MUNICIPIUL BUCUREŞTI",179178,1081,672,587,85,0,650,22,1200,528,302,348
45,"SECTOR 4","#N/A",179178,,737,"BUCUREŞTI SECTORUL 4 / Şcoala Gimnazială nr. 189",1,16976,"MUNICIPIUL BUCUREŞTI",179178,1345,851,808,43,0,817,34,1500,649,377,440
45,"SECTOR 4","#N/A",179178,,738,"BUCUREŞTI SECTORUL 4 / Şcoala Gimnazială nr. 189",1,16976,"MUNICIPIUL BUCUREŞTI",179178,1171,778,749,29,0,760,18,1300,522,323,437
45,"SECTOR 4","#N/A",179178,,739,"BUCUREŞTI SECTORUL 4 / Şcoala Gimnazială nr. 189",1,16976,"MUNICIPIUL BUCUREŞTI",179178,1296,786,746,39,1,767,19,1400,614,347,420
45,"SECTOR 4","#N/A",179178,,740,"BUCUREŞTI SECTORUL 4 / Şcoala Gimnazială Emil Racoviţă",1,16976,"MUNICIPIUL BUCUREŞTI",179178,1667,1031,918,113,0,1015,16,1800,769,418,597
45,"SECTOR 4","#N/A",179178,,741,"BUCUREŞTI SECTORUL 4 / Şcoala Gimnazială Emil Racoviţă",1,16976,"MUNICIPIUL BUCUREŞTI",179178,1661,1087,986,101,0,1070,17,1800,713,494,576
45,"SECTOR 4","#N/A",179178,,742,"BUCUREŞTI SECTORUL 4 / Şcoala Gimnazială Emil Racoviţă",1,16976,"MUNICIPIUL BUCUREŞTI",179178,1651,1040,936,104,0,1021,19,1800,760,443,578
45,"SECTOR 4","#N/A",179178,,743,"BUCUREŞTI SECTORUL 4 / Şcoala Gimnazială Emil Racoviţă",1,16976,"MUNICIPIUL BUCUREŞTI",179178,1699,1096,1015,81,0,1076,20,1906,810,497,579
45,"SECTOR 4","#N/A",179178,,744,"BUCUREŞTI SECTORUL 4 / Grădiniţa  ""101 Dalmaţieni""",1,16976,"MUNICIPIUL BUCUREŞTI",179178,1346,837,774,63,0,824,13,1500,663,366,458
45,"SECTOR 4","#N/A",179178,,745,"BUCUREŞTI SECTORUL 4 / Grădiniţa  ""101 Dalmaţieni""",1,16976,"MUNICIPIUL BUCUREŞTI",179178,1029,644,581,62,1,633,11,1100,456,276,357
45,"SECTOR 4","#N/A",179178,,746,"BUCUREŞTI SECTORUL 4 / Grădiniţa  ""101 Dalmaţieni""",1,16976,"MUNICIPIUL BUCUREŞTI",179178,1488,1017,959,58,0,994,23,1600,583,444,550
45,"SECTOR 4","#N/A",179178,,747,"BUCUREŞTI SECTORUL 4 / Şcoala Gimnazială nr. 194",1,16976,"MUNICIPIUL BUCUREŞTI",179178,1038,748,653,95,0,732,16,1200,452,305,427
45,"SECTOR 4","#N/A",179178,,748,"BUCUREŞTI SECTORUL 4 / Şcoala Gimnazială nr. 194",1,16976,"MUNICIPIUL BUCUREŞTI",179178,942,678,592,86,0,668,10,1000,322,321,347
45,"SECTOR 4","#N/A",179178,,749,"BUCUREŞTI SECTORUL 4 / Şcoala Gimnazială nr. 194",1,16976,"MUNICIPIUL BUCUREŞTI",179178,1244,779,718,61,0,762,17,1400,621,360,402
45,"SECTOR 4","#N/A",179178,,750,"BUCUREŞTI SECTORUL 4 / Şcoala Gimnazială nr. 194",1,16976,"MUNICIPIUL BUCUREŞTI",179178,1651,1050,989,60,1,1037,13,1800,750,498,539
45,"SECTOR 4","#N/A",179178,,751,"BUCUREŞTI SECTORUL 4 / Şcoala Gimnazială nr. 194",1,16976,"MUNICIPIUL BUCUREŞTI",179178,1185,735,693,42,0,720,15,1300,565,361,359
45,"SECTOR 4","#N/A",179178,,752,"BUCUREŞTI SECTORUL 4 / Şcoala Gimnazială nr. 194",1,16976,"MUNICIPIUL BUCUREŞTI",179178,1223,829,769,42,18,816,13,1299,470,414,402
45,"SECTOR 4","#N/A",179178,,753,"BUCUREŞTI SECTORUL 4 / Grădiniţa ""Dumbrava Minunata""",1,16976,"MUNICIPIUL BUCUREŞTI",179178,1063,702,611,91,0,688,14,1200,498,284,404
45,"SECTOR 4","#N/A",179178,,754,"BUCUREŞTI SECTORUL 4 / Grădiniţa ""Dumbrava Minunata""",1,16976,"MUNICIPIUL BUCUREŞTI",179178,1148,742,711,31,0,728,14,1300,558,338,390
45,"SECTOR 4","#N/A",179178,,755,"BUCUREŞTI SECTORUL 4 / Şcoala Gimnazială nr. 190",1,16976,"MUNICIPIUL BUCUREŞTI",179178,1992,1382,1219,163,0,1343,39,2199,817,544,799
45,"SECTOR 4","#N/A",179178,,756,"BUCUREŞTI SECTORUL 4 / Şcoala Gimnazială nr. 190",1,16976,"MUNICIPIUL BUCUREŞTI",179178,1985,1404,1291,113,0,1369,35,2200,796,561,808
45,"SECTOR 4","#N/A",179178,,757,"BUCUREŞTI SECTORUL 4 / Şcoala Gimnazială nr. 190",1,16976,"MUNICIPIUL BUCUREŞTI",179178,2166,1180,1060,120,0,1155,25,2399,1219,507,648
45,"SECTOR 4","#N/A",179178,,758,"BUCUREŞTI SECTORUL 4 / Şcoala Gimnazială  ""George Bacovia""",1,16976,"MUNICIPIUL BUCUREŞTI",179178,1541,994,910,84,0,979,15,1700,706,414,565
45,"SECTOR 4","#N/A",179178,,759,"BUCUREŞTI SECTORUL 4 / Şcoala Gimnazială  ""George Bacovia""",1,16976,"MUNICIPIUL BUCUREŞTI",179178,1420,966,923,43,0,948,18,1600,634,403,545
45,"SECTOR 4","#N/A",179178,,760,"BUCUREŞTI SECTORUL 4 / Şcoala Gimnazială  ""George Bacovia""",1,16976,"MUNICIPIUL BUCUREŞTI",179178,1958,1263,1152,111,0,1228,35,2200,937,460,768
45,"SECTOR 4","#N/A",179178,,761,"BUCUREŞTI SECTORUL 4 / Şcoala Gimnazială  ""George Bacovia""",1,16976,"MUNICIPIUL BUCUREŞTI",179178,1680,1069,946,122,1,1042,27,1798,729,488,554
45,"SECTOR 4","#N/A",179178,,762,"BUCUREŞTI SECTORUL 4 / Şcoala Gimnazială  ""George Bacovia""",1,16976,"MUNICIPIUL BUCUREŞTI",179178,1990,1328,1152,176,0,1297,31,2200,872,535,762
45,"SECTOR 4","#N/A",179178,,763,"BUCUREŞTI SECTORUL 4 / Şcoala Gimnazială  ""George Bacovia""",1,16976,"MUNICIPIUL BUCUREŞTI",179178,1677,1159,1050,109,0,1127,32,1800,641,421,706
45,"SECTOR 4","#N/A",179178,,764,"BUCUREŞTI SECTORUL 4 / Şcoala Gimnazială  ""George Bacovia""",1,16976,"MUNICIPIUL BUCUREŞTI",179178,1843,1238,1139,98,1,1208,30,2000,762,479,729
45,"SECTOR 4","#N/A",179178,,765,"BUCUREŞTI SECTORUL 4 / Grădiniţa ""Ciupercuta""",1,16976,"MUNICIPIUL BUCUREŞTI",179178,1195,885,785,99,1,869,16,1299,414,368,501
45,"SECTOR 4","#N/A",179178,,766,"BUCUREŞTI SECTORUL 4 / Grădiniţa ""Ciupercuta""",1,16976,"MUNICIPIUL BUCUREŞTI",179178,1441,842,754,87,1,826,16,1600,758,419,407
45,"SECTOR 4","#N/A",179178,,767,"BUCUREŞTI SECTORUL 4 / Şcoala Gimnazială ""Şerban Vodă""",1,16976,"MUNICIPIUL BUCUREŞTI",179178,1753,906,826,80,0,884,22,1900,994,364,520
45,"SECTOR 4","#N/A",179178,,768,"BUCUREŞTI SECTORUL 4 / Şcoala Gimnazială ""Şerban Vodă""",1,16976,"MUNICIPIUL BUCUREŞTI",179178,1748,1073,1024,48,1,1044,29,1901,828,505,539
45,"SECTOR 4","#N/A",179178,,769,"BUCUREŞTI SECTORUL 4 / Şcoala Gimnazială ""Şerban Vodă""",1,16976,"MUNICIPIUL BUCUREŞTI",179178,1562,970,888,82,0,947,23,1700,730,440,507
45,"SECTOR 4","#N/A",179178,,770,"BUCUREŞTI SECTORUL 4 / Şcoala Gimnazială ""Şerban Vodă""",1,16976,"MUNICIPIUL BUCUREŞTI",179178,1444,940,860,80,0,916,24,1600,660,407,509
45,"SECTOR 4","#N/A",179178,,771,"BUCUREŞTI SECTORUL 4 / Şcoala Gimnazială ""Şerban Vodă""",1,16976,"MUNICIPIUL BUCUREŞTI",179178,1488,968,920,47,1,940,28,1600,632,414,526
45,"SECTOR 4","#N/A",179178,,772,"BUCUREŞTI SECTORUL 4 / Grădiniţa ""Albă ca Zapada şi Piticii""",1,16976,"MUNICIPIUL BUCUREŞTI",179178,1435,868,800,67,1,850,18,1600,732,372,478
45,"SECTOR 4","#N/A",179178,,773,"BUCUREŞTI SECTORUL 4 / Grădiniţa ""Albă ca Zapada şi Piticii""",1,16976,"MUNICIPIUL BUCUREŞTI",179178,1251,725,698,27,0,707,18,1400,675,371,336
45,"SECTOR 4","#N/A",179178,,774,"BUCUREŞTI SECTORUL 4 / Grădiniţa    ""Piticot""",1,16976,"MUNICIPIUL BUCUREŞTI",179178,1552,941,883,58,0,913,28,1699,758,427,486
45,"SECTOR 4","#N/A",179178,,775,"BUCUREŞTI SECTORUL 4 / Grădiniţa    ""Piticot""",1,16976,"MUNICIPIUL BUCUREŞTI",179178,1454,963,889,74,0,946,17,1600,637,450,496
45,"SECTOR 4","#N/A",179178,,776,"BUCUREŞTI SECTORUL 4 / Şcoala Gimnazială nr. 308",1,16976,"MUNICIPIUL BUCUREŞTI",179178,1398,882,840,42,0,857,25,1600,718,399,458
45,"SECTOR 4","#N/A",179178,,777,"BUCUREŞTI SECTORUL 4 / Şcoala Gimnazială nr. 308",1,16976,"MUNICIPIUL BUCUREŞTI",179178,1270,778,741,36,1,769,9,1400,622,394,375
45,"SECTOR 4","#N/A",179178,,778,"BUCUREŞTI SECTORUL 4 / Şcoala Gimnazială nr. 308",1,16976,"MUNICIPIUL BUCUREŞTI",179178,1520,868,825,43,0,847,21,1700,832,427,420
45,"SECTOR 4","#N/A",179178,,779,"BUCUREŞTI SECTORUL 4 / Şcoala Gimnazială nr. 308",1,16976,"MUNICIPIUL BUCUREŞTI",179178,1606,874,827,46,1,858,16,1800,926,414,444
45,"SECTOR 4","#N/A",179178,,780,"BUCUREŞTI SECTORUL 4 / Şcoala Gimnazială nr. 308",1,16976,"MUNICIPIUL BUCUREŞTI",179178,1927,1205,1102,103,0,1180,25,2100,895,596,584
45,"SECTOR 4","#N/A",179178,,781,"BUCUREŞTI SECTORUL 4 / Şcoala Gimnazială nr. 308",1,16976,"MUNICIPIUL BUCUREŞTI",179178,1997,1253,1181,72,0,1214,39,2200,947,574,640
45,"SECTOR 4","#N/A",179178,,782,"BUCUREŞTI SECTORUL 4 / Şcoala Gimnazială nr. 308",1,16976,"MUNICIPIUL BUCUREŞTI",179178,2012,1186,1117,69,0,1158,28,2200,1014,563,595
45,"SECTOR 4","#N/A",179178,,783,"BUCUREŞTI SECTORUL 4 / Şcoala Gimnazială nr. 308",1,16976,"MUNICIPIUL BUCUREŞTI",179178,1717,951,893,58,0,929,22,1903,952,502,427
45,"SECTOR 4","#N/A",179178,,784,"BUCUREŞTI SECTORUL 4 / Şcoala Gimnazială nr. 308",1,16976,"MUNICIPIUL BUCUREŞTI",179178,1970,1097,984,113,0,1080,17,2200,1103,572,508
45,"SECTOR 4","#N/A",179178,,785,"BUCUREŞTI SECTORUL 4 / Şcoala Gimnazială nr. 308",1,16976,"MUNICIPIUL BUCUREŞTI",179178,1811,1123,991,132,0,1102,21,2000,877,541,561
45,"SECTOR 4","#N/A",179178,,786,"BUCUREŞTI SECTORUL 4 / Şcoala Gimnazială George Topârceanu",1,16976,"MUNICIPIUL BUCUREŞTI",179178,1581,901,853,48,0,878,23,1700,799,441,437
45,"SECTOR 4","#N/A",179178,,787,"BUCUREŞTI SECTORUL 4 / Şcoala Gimnazială George Topârceanu",1,16976,"MUNICIPIUL BUCUREŞTI",179178,1551,976,923,53,0,956,20,1700,724,506,450
45,"SECTOR 4","#N/A",179178,,788,"BUCUREŞTI SECTORUL 4 / Şcoala Gimnazială George Topârceanu",1,16976,"MUNICIPIUL BUCUREŞTI",179178,1462,874,776,97,1,855,19,1600,726,413,442
45,"SECTOR 4","#N/A",179178,,789,"BUCUREŞTI SECTORUL 4 / Şcoala Gimnazială George Topârceanu",1,16976,"MUNICIPIUL BUCUREŞTI",179178,1696,1048,1000,48,0,1027,21,1902,854,518,509
45,"SECTOR 4","#N/A",179178,,790,"BUCUREŞTI SECTORUL 4 / Şcoala Gimnazială nr. 129",1,16976,"MUNICIPIUL BUCUREŞTI",179178,1477,1010,920,89,1,981,29,1600,590,397,584
45,"SECTOR 4","#N/A",179178,,791,"BUCUREŞTI SECTORUL 4 / Şcoala Gimnazială nr. 129",1,16976,"MUNICIPIUL BUCUREŞTI",179178,1593,1097,1034,63,0,1078,19,1800,703,516,562
45,"SECTOR 4","#N/A",179178,,792,"BUCUREŞTI SECTORUL 4 / Şcoala Gimnazială nr. 129",1,16976,"MUNICIPIUL BUCUREŞTI",179178,1790,1118,1072,46,0,1081,37,2000,882,536,545
45,"SECTOR 4","#N/A",179178,,793,"BUCUREŞTI SECTORUL 4 / Şcoala Gimnazială nr. 129",1,16976,"MUNICIPIUL BUCUREŞTI",179178,1763,1148,1114,32,2,1117,31,1900,752,542,575
45,"SECTOR 4","#N/A",179178,,794,"BUCUREŞTI SECTORUL 4 / Liceul Tehnologic ""Mircea Vulcănescu""",1,16976,"MUNICIPIUL BUCUREŞTI",179178,1479,941,834,107,0,926,15,1600,659,397,529
45,"SECTOR 4","#N/A",179178,,795,"BUCUREŞTI SECTORUL 4 / Liceul Tehnologic ""Mircea Vulcănescu""",1,16976,"MUNICIPIUL BUCUREŞTI",179178,1417,993,874,118,1,979,14,1600,607,422,557
45,"SECTOR 4","#N/A",179178,,796,"BUCUREŞTI SECTORUL 4 / Şcoala Gimnazială nr. 119",1,16976,"MUNICIPIUL BUCUREŞTI",179178,1936,1234,1163,71,0,1211,23,2098,864,582,629
45,"SECTOR 4","#N/A",179178,,797,"BUCUREŞTI SECTORUL 4 / Şcoala Gimnazială nr. 119",1,16976,"MUNICIPIUL BUCUREŞTI",179178,1881,1188,1096,92,0,1162,26,2000,812,550,612
45,"SECTOR 4","#N/A",179178,,798,"BUCUREŞTI SECTORUL 4 / Şcoala Gimnazială nr. 119",1,16976,"MUNICIPIUL BUCUREŞTI",179178,1819,1127,1089,38,0,1099,28,2001,874,563,536
45,"SECTOR 4","#N/A",179178,,799,"BUCUREŞTI SECTORUL 4 / Şcoala Gimnazială nr. 119",1,16976,"MUNICIPIUL BUCUREŞTI",179178,1755,954,909,45,0,932,22,1900,946,478,454
45,"SECTOR 4","#N/A",179178,,800,"BUCUREŞTI SECTORUL 4 / Şcoala   Gimnazială ""Ionel Teodoreanu""",1,16976,"MUNICIPIUL BUCUREŞTI",179178,1309,878,799,59,20,856,22,1400,522,423,433
45,"SECTOR 4","#N/A",179178,,801,"BUCUREŞTI SECTORUL 4 / Şcoala   Gimnazială ""Ionel Teodoreanu""",1,16976,"MUNICIPIUL BUCUREŞTI",179178,1445,913,834,79,0,890,23,1600,687,465,425
45,"SECTOR 4","#N/A",179178,,802,"BUCUREŞTI SECTORUL 4 / Şcoala   Gimnazială ""Ionel Teodoreanu""",1,16976,"MUNICIPIUL BUCUREŞTI",179178,1571,993,889,104,0,963,30,1700,707,460,503
45,"SECTOR 4","#N/A",179178,,803,"BUCUREŞTI SECTORUL 4 / Şcoala   Gimnazială ""Ionel Teodoreanu""",1,16976,"MUNICIPIUL BUCUREŞTI",179178,1896,972,900,72,0,950,22,2100,1128,472,478
45,"SECTOR 4","#N/A",179178,,804,"BUCUREŞTI SECTORUL 4 / Şcoala   Gimnazială ""Ionel Teodoreanu""",1,16976,"MUNICIPIUL BUCUREŞTI",179178,1753,943,891,52,0,918,25,1900,957,456,462
45,"SECTOR 4","#N/A",179178,,805,"BUCUREŞTI SECTORUL 4 / Şcoala   Gimnazială ""Ionel Teodoreanu""",1,16976,"MUNICIPIUL BUCUREŞTI",179178,1585,956,910,45,1,931,25,1700,744,474,457
45,"SECTOR 4","#N/A",179178,,806,"BUCUREŞTI SECTORUL 4 / Şcoala Gimnazială nr. 99",1,16976,"MUNICIPIUL BUCUREŞTI",179178,1661,1055,967,88,0,1034,21,1790,735,533,501
45,"SECTOR 4","#N/A",179178,,807,"BUCUREŞTI SECTORUL 4 / Şcoala Gimnazială nr. 99",1,16976,"MUNICIPIUL BUCUREŞTI",179178,1936,1172,1103,68,1,1127,45,2100,928,525,602
45,"SECTOR 4","#N/A",179178,,808,"BUCUREŞTI SECTORUL 4 / Şcoala Gimnazială nr. 99",1,16976,"MUNICIPIUL BUCUREŞTI",179178,1615,1028,931,97,0,1000,28,1800,772,454,546
45,"SECTOR 4","#N/A",179178,,809,"BUCUREŞTI SECTORUL 4 / Şcoala Gimnazială nr. 99",1,16976,"MUNICIPIUL BUCUREŞTI",179178,1836,1060,979,81,0,1042,18,2000,940,516,526
45,"SECTOR 4","#N/A",179178,,810,"BUCUREŞTI SECTORUL 4 / Şcoala Gimnazială nr. 165",1,16976,"MUNICIPIUL BUCUREŞTI",179178,1419,936,783,152,1,914,22,1600,664,403,511
45,"SECTOR 4","#N/A",179178,,811,"BUCUREŞTI SECTORUL 4 / Şcoala Gimnazială nr. 165",1,16976,"MUNICIPIUL BUCUREŞTI",179178,1958,1194,1129,64,1,1168,26,2200,1006,581,587
45,"SECTOR 4","#N/A",179178,,812,"BUCUREŞTI SECTORUL 4 / Şcoala Gimnazială nr. 165",1,16976,"MUNICIPIUL BUCUREŞTI",179178,1597,899,817,82,0,884,15,1700,801,423,461
45,"SECTOR 4","#N/A",179178,,813,"BUCUREŞTI SECTORUL 4 / Şcoala Gimnazială nr. 165",1,16976,"MUNICIPIUL BUCUREŞTI",179178,1868,1066,1008,58,0,1039,27,2099,1033,493,546
45,"SECTOR 4","#N/A",179178,,814,"BUCUREŞTI SECTORUL 4 / Şcoala Gimnazială nr.165",1,16976,"MUNICIPIUL BUCUREŞTI",179178,1617,851,796,55,0,834,17,1800,949,421,413
45,"SECTOR 4","#N/A",179178,,815,"BUCUREŞTI SECTORUL 4 / Grădiniţa  ""Înşir'te Mărgărite""",1,16976,"MUNICIPIUL BUCUREŞTI",179178,1401,839,786,53,0,805,34,1500,661,388,417
45,"SECTOR 4","#N/A",179178,,816,"BUCUREŞTI SECTORUL 4 / Grădiniţa  ""Înşir'te Mărgărite""",1,16976,"MUNICIPIUL BUCUREŞTI",179178,1283,746,701,45,0,726,20,1400,654,321,405
46,"SECTOR 5","#N/A",179187,,817,"BUCUREŞTI SECTORUL 5 / ŞCOALA GIMNAZIALĂ NR.134",1,16977,"MUNICIPIUL BUCUREŞTI",179187,1751,845,757,88,0,834,11,1900,1055,375,459
46,"SECTOR 5","#N/A",179187,,818,"BUCUREŞTI SECTORUL 5 / ŞCOALA GIMNAZIALĂ NR.134",1,16977,"MUNICIPIUL BUCUREŞTI",179187,1882,1043,997,45,1,1019,24,2000,957,485,534
46,"SECTOR 5","#N/A",179187,,819,"BUCUREŞTI SECTORUL 5 / ŞCOALA GIMNAZIALĂ NR.134",1,16977,"MUNICIPIUL BUCUREŞTI",179187,1473,805,778,25,2,786,19,1599,794,442,344
46,"SECTOR 5","#N/A",179187,,820,"BUCUREŞTI SECTORUL 5 / ŞCOALA GIMNAZIALĂ NR.134",1,16977,"MUNICIPIUL BUCUREŞTI",179187,1152,489,462,27,0,484,5,1300,811,243,241
46,"SECTOR 5","#N/A",179187,,821,"BUCUREŞTI SECTORUL 5 / ŞCOALA GIMNAZIALĂ NR.134",1,16977,"MUNICIPIUL BUCUREŞTI",179187,1574,819,796,23,0,810,9,1700,881,392,418
46,"SECTOR 5","#N/A",179187,,822,"BUCUREŞTI SECTORUL 5 / ŞCOALA GIMNAZIALĂ NR.134",1,16977,"MUNICIPIUL BUCUREŞTI",179187,1668,850,824,25,1,827,23,1800,950,428,399
46,"SECTOR 5","#N/A",179187,,823,"BUCUREŞTI SECTORUL 5 / ŞCOALA GIMNAZIALĂ NR.134",1,16977,"MUNICIPIUL BUCUREŞTI",179187,1872,913,874,39,0,898,15,2100,1187,523,375
46,"SECTOR 5","#N/A",179187,,824,"BUCUREŞTI SECTORUL 5 / ŞCOALA GIMNAZIALĂ NR.134",1,16977,"MUNICIPIUL BUCUREŞTI",179187,1749,796,771,25,0,786,10,1900,1104,410,376
46,"SECTOR 5","#N/A",179187,,825,"BUCUREŞTI SECTORUL 5 / ŞCOALA GIMNAZIALĂ NR.134",1,16977,"MUNICIPIUL BUCUREŞTI",179187,1183,507,483,24,0,501,6,1300,793,300,201
46,"SECTOR 5","#N/A",179187,,826,"BUCUREŞTI SECTORUL 5 / ŞCOALA GIMNAZIALĂ NR.134",1,16977,"MUNICIPIUL BUCUREŞTI",179187,1877,821,797,24,0,804,17,2000,1179,414,390
46,"SECTOR 5","#N/A",179187,,827,"BUCUREŞTI SECTORUL 5 / ŞCOALA GIMNAZIALĂ NR.134",1,16977,"MUNICIPIUL BUCUREŞTI",179187,1549,740,724,16,0,730,10,1700,960,408,322
46,"SECTOR 5","#N/A",179187,,828,"BUCUREŞTI SECTORUL 5 / COLEGIUL TEHNIC ENERGETIC",1,16977,"MUNICIPIUL BUCUREŞTI",179187,1254,854,740,113,1,834,20,1400,546,408,426
46,"SECTOR 5","#N/A",179187,,829,"BUCUREŞTI SECTORUL 5 / COLEGIUL TEHNIC ENERGETIC",1,16977,"MUNICIPIUL BUCUREŞTI",179187,1418,991,876,113,2,971,20,1600,609,524,447
46,"SECTOR 5","#N/A",179187,,830,"BUCUREŞTI SECTORUL 5 / COLEGIUL TEHNIC ENERGETIC",1,16977,"MUNICIPIUL BUCUREŞTI",179187,1063,715,616,99,0,684,31,1200,485,326,358
46,"SECTOR 5","#N/A",179187,,831,"BUCUREŞTI SECTORUL 5 / COLEGIUL TEHNIC ENERGETIC",1,16977,"MUNICIPIUL BUCUREŞTI",179187,1039,686,601,85,0,678,8,1200,514,299,379
46,"SECTOR 5","#N/A",179187,,832,"BUCUREŞTI SECTORUL 5 / ŞCOALA GIMNAZIALĂ NR.136",1,16977,"MUNICIPIUL BUCUREŞTI",179187,1973,926,859,67,0,907,19,2200,1274,470,437
46,"SECTOR 5","#N/A",179187,,833,"BUCUREŞTI SECTORUL 5 / ŞCOALA GIMNAZIALĂ NR.136",1,16977,"MUNICIPIUL BUCUREŞTI",179187,1321,630,566,64,0,617,13,1400,770,347,270
46,"SECTOR 5","#N/A",179187,,834,"BUCUREŞTI SECTORUL 5 / ŞCOALA GIMNAZIALĂ NR.136",1,16977,"MUNICIPIUL BUCUREŞTI",179187,1919,721,670,51,0,706,15,2100,1379,432,274
46,"SECTOR 5","#N/A",179187,,835,"BUCUREŞTI SECTORUL 5 / ŞCOALA GIMNAZIALĂ NR.136",1,16977,"MUNICIPIUL BUCUREŞTI",179187,1389,619,596,23,0,602,17,1500,881,352,250
46,"SECTOR 5","#N/A",179187,,836,"BUCUREŞTI SECTORUL 5 / ŞCOALA GIMNAZIALĂ NR.136",1,16977,"MUNICIPIUL BUCUREŞTI",179187,1636,747,722,25,0,726,21,1800,1053,402,324
46,"SECTOR 5","#N/A",179187,,837,"BUCUREŞTI SECTORUL 5 / ŞCOALA GIMNAZIALĂ NR.136",1,16977,"MUNICIPIUL BUCUREŞTI",179187,1540,744,715,29,0,722,22,1700,956,399,323
46,"SECTOR 5","#N/A",179187,,838,"BUCUREŞTI SECTORUL 5 / ŞCOALA GIMNAZIALĂ NR.136",1,16977,"MUNICIPIUL BUCUREŞTI",179187,1442,727,689,37,1,703,24,1600,873,397,306
46,"SECTOR 5","#N/A",179187,,839,"BUCUREŞTI SECTORUL 5 / ŞCOALA GIMNAZIALĂ NR.2",1,16977,"MUNICIPIUL BUCUREŞTI",179187,1277,694,648,46,0,675,19,1400,706,355,320
46,"SECTOR 5","#N/A",179187,,840,"BUCUREŞTI SECTORUL 5 / ŞCOALA GIMNAZIALĂ NR.2",1,16977,"MUNICIPIUL BUCUREŞTI",179187,1437,743,708,34,1,732,11,1600,857,401,331
46,"SECTOR 5","#N/A",179187,,841,"BUCUREŞTI SECTORUL 5 / ŞCOALA GIMNAZIALĂ NR.2",1,16977,"MUNICIPIUL BUCUREŞTI",179187,1241,668,637,31,0,649,18,1400,732,349,300
46,"SECTOR 5","#N/A",179187,,842,"BUCUREŞTI SECTORUL 5 / ŞCOALA GIMNAZIALĂ NR.2",1,16977,"MUNICIPIUL BUCUREŞTI",179187,1017,521,497,24,0,509,12,1100,579,255,254
46,"SECTOR 5","#N/A",179187,,843,"BUCUREŞTI SECTORUL 5 / ŞCOALA GIMNAZIALĂ NR.2",1,16977,"MUNICIPIUL BUCUREŞTI",179187,1418,707,683,24,0,688,19,1500,793,378,310
46,"SECTOR 5","#N/A",179187,,844,"BUCUREŞTI SECTORUL 5 / ŞCOALA GIMNAZIALĂ NR.188",1,16977,"MUNICIPIUL BUCUREŞTI",179187,999,689,582,107,0,672,17,1100,411,338,334
46,"SECTOR 5","#N/A",179187,,845,"BUCUREŞTI SECTORUL 5 / ŞCOALA GIMNAZIALĂ NR.188",1,16977,"MUNICIPIUL BUCUREŞTI",179187,1236,874,732,142,0,851,23,1300,426,370,481
46,"SECTOR 5","#N/A",179187,,846,"BUCUREŞTI SECTORUL 5 / ŞCOALA GIMNAZIALĂ NR.188",1,16977,"MUNICIPIUL BUCUREŞTI",179187,923,623,568,55,0,610,13,999,376,301,309
46,"SECTOR 5","#N/A",179187,,847,"BUCUREŞTI SECTORUL 5 / ŞCOALA GIMNAZIALĂ NR.188",1,16977,"MUNICIPIUL BUCUREŞTI",179187,1046,599,571,27,1,590,9,1200,601,303,287
46,"SECTOR 5","#N/A",179187,,848,"BUCUREŞTI SECTORUL 5 / ŞCOALA GIMNAZIALĂ NR.188",1,16977,"MUNICIPIUL BUCUREŞTI",179187,824,464,448,16,0,454,10,900,436,191,263
46,"SECTOR 5","#N/A",179187,,849,"BUCUREŞTI SECTORUL 5 / ŞCOALA GIMNAZIALĂ NR.130",1,16977,"MUNICIPIUL BUCUREŞTI",179187,1233,804,712,92,0,792,12,1400,596,328,464
46,"SECTOR 5","#N/A",179187,,850,"BUCUREŞTI SECTORUL 5 / ŞCOALA GIMNAZIALĂ NR.130",1,16977,"MUNICIPIUL BUCUREŞTI",179187,1193,845,713,132,0,831,14,1300,455,365,466
46,"SECTOR 5","#N/A",179187,,851,"BUCUREŞTI SECTORUL 5 / ŞCOALA GIMNAZIALĂ NR.130",1,16977,"MUNICIPIUL BUCUREŞTI",179187,1080,714,652,62,0,701,13,1200,486,328,373
46,"SECTOR 5","#N/A",179187,,852,"BUCUREŞTI SECTORUL 5 / ŞCOALA GIMNAZIALĂ NR.130",1,16977,"MUNICIPIUL BUCUREŞTI",179187,1307,826,780,45,1,806,20,1400,574,355,451
46,"SECTOR 5","#N/A",179187,,853,"BUCUREŞTI SECTORUL 5 / ŞCOALA GIMNAZIALĂ NR.135 ""ŞTEFAN CEL MARE""",1,16977,"MUNICIPIUL BUCUREŞTI",179187,1028,718,597,121,0,704,14,1100,382,344,360
46,"SECTOR 5","#N/A",179187,,854,"BUCUREŞTI SECTORUL 5 / ŞCOALA GIMNAZIALĂ NR.135 ""ŞTEFAN CEL MARE""",1,16977,"MUNICIPIUL BUCUREŞTI",179187,1337,838,788,50,0,822,16,1500,662,384,438
46,"SECTOR 5","#N/A",179187,,855,"BUCUREŞTI SECTORUL 5 / ŞCOALA GIMNAZIALĂ NR.135 ""ŞTEFAN CEL MARE""",1,16977,"MUNICIPIUL BUCUREŞTI",179187,1416,814,767,47,0,791,23,1601,787,386,405
46,"SECTOR 5","#N/A",179187,,856,"BUCUREŞTI SECTORUL 5 / ŞCOALA GIMNAZIALĂ NR.135 ""ŞTEFAN CEL MARE""",1,16977,"MUNICIPIUL BUCUREŞTI",179187,1589,944,885,55,4,911,33,1700,756,428,483
46,"SECTOR 5","#N/A",179187,,857,"BUCUREŞTI SECTORUL 5 / ŞCOALA GIMNAZIALĂ NR.141 ""I.C.BRĂTIANU""",1,16977,"MUNICIPIUL BUCUREŞTI",179187,1168,727,696,31,0,706,21,1300,573,338,368
46,"SECTOR 5","#N/A",179187,,858,"BUCUREŞTI SECTORUL 5 / ŞCOALA GIMNAZIALĂ NR.141 ""I.C.BRĂTIANU""",1,16977,"MUNICIPIUL BUCUREŞTI",179187,1115,663,631,32,0,653,10,1201,538,308,345
46,"SECTOR 5","#N/A",179187,,859,"BUCUREŞTI SECTORUL 5 / ŞCOALA GIMNAZIALĂ NR.141 ""I.C.BRĂTIANU""",1,16977,"MUNICIPIUL BUCUREŞTI",179187,1508,857,826,31,0,840,17,1700,843,385,455
46,"SECTOR 5","#N/A",179187,,860,"BUCUREŞTI SECTORUL 5 / ŞCOALA GIMNAZIALĂ NR.141 ""I.C.BRĂTIANU""",1,16977,"MUNICIPIUL BUCUREŞTI",179187,1167,667,637,30,0,656,11,1300,633,342,314
46,"SECTOR 5","#N/A",179187,,861,"BUCUREŞTI SECTORUL 5 / ŞCOALA GIMNAZIALĂ NR.141 ""I.C.BRĂTIANU""",1,16977,"MUNICIPIUL BUCUREŞTI",179187,1223,736,679,57,0,708,28,1300,564,325,383
46,"SECTOR 5","#N/A",179187,,862,"BUCUREŞTI SECTORUL 5 / ŞCOALA GIMNAZIALĂ NR.141 ""I.C.BRĂTIANU""",1,16977,"MUNICIPIUL BUCUREŞTI",179187,1482,913,861,51,1,889,24,1600,687,420,469
46,"SECTOR 5","#N/A",179187,,863,"BUCUREŞTI SECTORUL 5 / ŞCOALA GIMNAZIALĂ NR.141 ""I.C.BRĂTIANU""",1,16977,"MUNICIPIUL BUCUREŞTI",179187,1377,667,569,95,3,658,9,1500,833,344,314
46,"SECTOR 5","#N/A",179187,,864,"BUCUREŞTI SECTORUL 5 / ŞCOALA GIMNAZIALĂ NR.141 ""I.C.BRĂTIANU""",1,16977,"MUNICIPIUL BUCUREŞTI",179187,1715,800,697,81,22,786,14,1900,1100,440,346
46,"SECTOR 5","#N/A",179187,,865,"BUCUREŞTI SECTORUL 5 / ŞCOALA GIMNAZIALĂ NR.141 ""I.C.BRĂTIANU""",1,16977,"MUNICIPIUL BUCUREŞTI",179187,1483,685,642,42,1,665,20,1600,915,326,339
46,"SECTOR 5","#N/A",179187,,866,"BUCUREŞTI SECTORUL 5 / ŞCOALA GIMNAZIALĂ NR.141 ""I.C.BRĂTIANU""",1,16977,"MUNICIPIUL BUCUREŞTI",179187,1337,844,765,79,0,835,9,1500,656,423,412
46,"SECTOR 5","#N/A",179187,,867,"BUCUREŞTI SECTORUL 5 / ŞCOALA GIMNAZIALĂ NR.141 ""I.C.BRĂTIANU""",1,16977,"MUNICIPIUL BUCUREŞTI",179187,1634,879,815,62,2,854,25,1800,921,384,470
46,"SECTOR 5","#N/A",179187,,868,"BUCUREŞTI SECTORUL 5 / ŞCOALA GIMNAZIALĂ NR.148 ""G.CĂLINESCU""",1,16977,"MUNICIPIUL BUCUREŞTI",179187,1374,752,675,77,0,739,13,1500,748,358,381
46,"SECTOR 5","#N/A",179187,,869,"BUCUREŞTI SECTORUL 5 / ŞCOALA GIMNAZIALĂ NR.148 ""G.CĂLINESCU""",1,16977,"MUNICIPIUL BUCUREŞTI",179187,1239,761,681,80,0,744,17,1400,639,361,383
46,"SECTOR 5","#N/A",179187,,870,"BUCUREŞTI SECTORUL 5 / ŞCOALA GIMNAZIALĂ NR.148 ""G.CĂLINESCU""",1,16977,"MUNICIPIUL BUCUREŞTI",179187,1458,844,808,36,0,821,23,1600,756,443,378
46,"SECTOR 5","#N/A",179187,,871,"BUCUREŞTI SECTORUL 5 / ŞCOALA GIMNAZIALĂ NR.148 ""G.CĂLINESCU""",1,16977,"MUNICIPIUL BUCUREŞTI",179187,1567,818,787,30,1,809,9,1699,881,422,387
46,"SECTOR 5","#N/A",179187,,872,"BUCUREŞTI SECTORUL 5 / ŞCOALA GIMNAZIALĂ NR.148 ""G.CĂLINESCU""",1,16977,"MUNICIPIUL BUCUREŞTI",179187,1652,887,871,16,0,875,12,1800,913,490,385
46,"SECTOR 5","#N/A",179187,,873,"BUCUREŞTI SECTORUL 5 / GRĂDINIŢA NR.244",1,16977,"MUNICIPIUL BUCUREŞTI",179187,1561,789,759,30,0,775,14,1700,911,432,343
46,"SECTOR 5","#N/A",179187,,874,"BUCUREŞTI SECTORUL 5 / GRĂDINIŢA NR.244",1,16977,"MUNICIPIUL BUCUREŞTI",179187,1700,863,823,40,0,847,16,1900,1037,486,361
46,"SECTOR 5","#N/A",179187,,875,"BUCUREŞTI SECTORUL 5 / ŞCOALA GIMNAZIALĂ NR.147 ""P.POENARU""",1,16977,"MUNICIPIUL BUCUREŞTI",179187,1240,615,567,48,0,602,13,1200,585,297,305
46,"SECTOR 5","#N/A",179187,,876,"BUCUREŞTI SECTORUL 5 / ŞCOALA GIMNAZIALĂ NR.147 ""P.POENARU""",1,16977,"MUNICIPIUL BUCUREŞTI",179187,1256,713,628,84,1,699,14,1200,487,387,312
46,"SECTOR 5","#N/A",179187,,877,"BUCUREŞTI SECTORUL 5 / ŞCOALA GIMNAZIALĂ NR.147 ""P.POENARU""",1,16977,"MUNICIPIUL BUCUREŞTI",179187,1246,665,641,24,0,654,11,1200,535,343,311
46,"SECTOR 5","#N/A",179187,,878,"BUCUREŞTI SECTORUL 5 / ŞCOALA GIMNAZIALĂ NR.147 ""P.POENARU""",1,16977,"MUNICIPIUL BUCUREŞTI",179187,1304,628,605,21,2,617,11,1200,572,342,275
46,"SECTOR 5","#N/A",179187,,879,"BUCUREŞTI SECTORUL 5 / ŞCOALA GIMNAZIALĂ NR.147 ""P.POENARU""",1,16977,"MUNICIPIUL BUCUREŞTI",179187,1579,749,734,15,0,735,14,1600,851,406,329
46,"SECTOR 5","#N/A",179187,,880,"BUCUREŞTI SECTORUL 5 / ŞCOALA GIMNAZIALĂ NR.147 ""P.POENARU""",1,16977,"MUNICIPIUL BUCUREŞTI",179187,1483,765,734,30,1,750,15,1600,835,380,370
46,"SECTOR 5","#N/A",179187,,881,"BUCUREŞTI SECTORUL 5 / ŞCOALA GIMNAZIALĂ NR.147 ""P.POENARU""",1,16977,"MUNICIPIUL BUCUREŞTI",179187,1253,693,672,21,0,668,25,1200,507,351,317
46,"SECTOR 5","#N/A",179187,,882,"BUCUREŞTI SECTORUL 5 / ŞCOALA GIMNAZIALĂ NR.114 ""PRINCIPESA MARGARETA""",1,16977,"MUNICIPIUL BUCUREŞTI",179187,1044,732,674,58,0,720,12,1100,368,271,449
46,"SECTOR 5","#N/A",179187,,883,"BUCUREŞTI SECTORUL 5 / ŞCOALA GIMNAZIALĂ NR.114 ""PRINCIPESA MARGARETA""",1,16977,"MUNICIPIUL BUCUREŞTI",179187,1313,671,583,88,0,655,16,1400,729,336,319
46,"SECTOR 5","#N/A",179187,,884,"BUCUREŞTI SECTORUL 5 / ŞCOALA GIMNAZIALĂ NR.114 ""PRINCIPESA MARGARETA""",1,16977,"MUNICIPIUL BUCUREŞTI",179187,1726,762,650,112,0,744,18,1900,1138,374,370
46,"SECTOR 5","#N/A",179187,,885,"BUCUREŞTI SECTORUL 5 / ŞCOALA GIMNAZIALĂ NR.114 ""PRINCIPESA MARGARETA""",1,16977,"MUNICIPIUL BUCUREŞTI",179187,1266,836,704,43,89,826,10,1400,564,374,452
46,"SECTOR 5","#N/A",179187,,886,"BUCUREŞTI SECTORUL 5 / GRĂDINIŢA NR.168",1,16977,"MUNICIPIUL BUCUREŞTI",179187,1027,656,558,98,0,642,14,1100,444,289,353
46,"SECTOR 5","#N/A",179187,,887,"BUCUREŞTI SECTORUL 5 / GRĂDINIŢA NR.168",1,16977,"MUNICIPIUL BUCUREŞTI",179187,921,639,531,107,1,622,17,1000,361,290,332
46,"SECTOR 5","#N/A",179187,,888,"BUCUREŞTI SECTORUL 5 / CLUBUL COPIILOR ŞI ELEVILOR",1,16977,"MUNICIPIUL BUCUREŞTI",179187,1417,1043,836,207,0,1024,19,1600,557,397,627
46,"SECTOR 5","#N/A",179187,,889,"BUCUREŞTI SECTORUL 5 / CLUBUL COPIILOR ŞI ELEVILOR",1,16977,"MUNICIPIUL BUCUREŞTI",179187,1387,1032,812,220,0,1010,22,1500,468,450,560
46,"SECTOR 5","#N/A",179187,,890,"BUCUREŞTI SECTORUL 5 / ŞCOALA GIMNAZIALĂ NR.280 ""M.SEBASTIAN""",1,16977,"MUNICIPIUL BUCUREŞTI",179187,1477,1067,879,188,0,1050,17,1600,533,431,619
46,"SECTOR 5","#N/A",179187,,891,"BUCUREŞTI SECTORUL 5 / ŞCOALA GIMNAZIALĂ NR.280 ""M.SEBASTIAN""",1,16977,"MUNICIPIUL BUCUREŞTI",179187,1185,767,676,91,0,757,10,1300,533,337,420
46,"SECTOR 5","#N/A",179187,,892,"BUCUREŞTI SECTORUL 5 / ŞCOALA GIMNAZIALĂ NR.280 ""M.SEBASTIAN""",1,16977,"MUNICIPIUL BUCUREŞTI",179187,1115,744,671,73,0,730,14,1200,456,305,425
46,"SECTOR 5","#N/A",179187,,893,"BUCUREŞTI SECTORUL 5 / ŞCOALA GIMNAZIALĂ NR.280 ""M.SEBASTIAN""",1,16977,"MUNICIPIUL BUCUREŞTI",179187,1162,765,702,63,0,749,16,1300,535,320,429
46,"SECTOR 5","#N/A",179187,,894,"BUCUREŞTI SECTORUL 5 / ŞCOALA GIMNAZIALĂ NR.280 ""M.SEBASTIAN""",1,16977,"MUNICIPIUL BUCUREŞTI",179187,924,598,560,37,1,582,16,1000,402,274,308
46,"SECTOR 5","#N/A",179187,,895,"BUCUREŞTI SECTORUL 5 / ŞCOALA GIMNAZIALĂ NR.280 ""M.SEBASTIAN""",1,16977,"MUNICIPIUL BUCUREŞTI",179187,1362,861,816,45,0,834,27,1500,639,375,459
46,"SECTOR 5","#N/A",179187,,896,"BUCUREŞTI SECTORUL 5 / ŞCOALA GIMNAZIALĂ NR.280 ""M.SEBASTIAN""",1,16977,"MUNICIPIUL BUCUREŞTI",179187,1305,798,762,36,0,771,27,1400,602,392,379
46,"SECTOR 5","#N/A",179187,,897,"BUCUREŞTI SECTORUL 5 / ŞCOALA GIMNAZIALĂ NR.280 ""M.SEBASTIAN""",1,16977,"MUNICIPIUL BUCUREŞTI",179187,1170,701,679,22,0,680,21,1300,599,318,362
46,"SECTOR 5","#N/A",179187,,898,"BUCUREŞTI SECTORUL 5 / ŞCOALA GIMNAZIALĂ NR.132 ""GR.TOCILESCU""",1,16977,"MUNICIPIUL BUCUREŞTI",179187,1295,946,836,110,0,926,20,1400,454,375,551
46,"SECTOR 5","#N/A",179187,,899,"BUCUREŞTI SECTORUL 5 / ŞCOALA GIMNAZIALĂ NR.132 ""GR.TOCILESCU""",1,16977,"MUNICIPIUL BUCUREŞTI",179187,1352,944,813,130,1,921,23,1500,556,377,544
46,"SECTOR 5","#N/A",179187,,900,"BUCUREŞTI SECTORUL 5 / ŞCOALA GIMNAZIALĂ NR.132 ""GR.TOCILESCU""",1,16977,"MUNICIPIUL BUCUREŞTI",179187,1302,872,812,60,0,850,22,1400,528,357,493
46,"SECTOR 5","#N/A",179187,,901,"BUCUREŞTI SECTORUL 5 / GRĂDINIŢA NR.205",1,16977,"MUNICIPIUL BUCUREŞTI",179187,1455,969,897,72,0,944,25,1600,631,431,513
46,"SECTOR 5","#N/A",179187,,902,"BUCUREŞTI SECTORUL 5 / GRĂDINIŢA NR.205",1,16977,"MUNICIPIUL BUCUREŞTI",179187,1191,885,735,150,0,863,22,1300,415,406,457
46,"SECTOR 5","#N/A",179187,,903,"BUCUREŞTI SECTORUL 5 / GRĂDINIŢA NR.205",1,16977,"MUNICIPIUL BUCUREŞTI",179187,1378,876,785,91,0,848,28,1500,624,346,502
46,"SECTOR 5","#N/A",179187,,904,"BUCUREŞTI SECTORUL 5 / GRĂDINIŢA NR.205",1,16977,"MUNICIPIUL BUCUREŞTI",179187,1129,750,695,55,0,724,26,1200,450,321,403
46,"SECTOR 5","#N/A",179187,,905,"BUCUREŞTI SECTORUL 5 / GRĂDINIŢA NR.205",1,16977,"MUNICIPIUL BUCUREŞTI",179187,1223,763,727,36,0,750,13,1299,536,335,415
46,"SECTOR 5","#N/A",179187,,906,"BUCUREŞTI SECTORUL 5 / LICEUL TEORETIC ""DIMITRIE BOLINTINEANU""",1,16977,"MUNICIPIUL BUCUREŞTI",179187,1150,866,707,158,1,837,29,1300,434,387,450
46,"SECTOR 5","#N/A",179187,,907,"BUCUREŞTI SECTORUL 5 / LICEUL TEORETIC ""DIMITRIE BOLINTINEANU""",1,16977,"MUNICIPIUL BUCUREŞTI",179187,1019,752,585,166,1,738,14,1100,348,341,397
46,"SECTOR 5","#N/A",179187,,908,"BUCUREŞTI SECTORUL 5 / LICEUL TEORETIC ""DIMITRIE BOLINTINEANU""",1,16977,"MUNICIPIUL BUCUREŞTI",179187,1222,867,735,132,0,851,16,1400,533,331,520
46,"SECTOR 5","#N/A",179187,,909,"BUCUREŞTI SECTORUL 5 / LICEUL TEORETIC ""DIMITRIE BOLINTINEANU""",1,16977,"MUNICIPIUL BUCUREŞTI",179187,1368,879,805,74,0,862,17,1500,621,451,411
46,"SECTOR 5","#N/A",179187,,910,"BUCUREŞTI SECTORUL 5 / LICEUL TEORETIC ""DIMITRIE BOLINTINEANU""",1,16977,"MUNICIPIUL BUCUREŞTI",179187,1348,928,810,118,0,909,19,1499,571,394,515
46,"SECTOR 5","#N/A",179187,,911,"BUCUREŞTI SECTORUL 5 / LICEUL TEORETIC ""DIMITRIE BOLINTINEANU""",1,16977,"MUNICIPIUL BUCUREŞTI",179187,1485,858,733,125,0,830,28,1600,742,406,424
46,"SECTOR 5","#N/A",179187,,912,"BUCUREŞTI SECTORUL 5 / LICEUL TEORETIC ""DIMITRIE BOLINTINEANU""",1,16977,"MUNICIPIUL BUCUREŞTI",179187,1263,789,744,45,0,764,25,1400,611,343,421
46,"SECTOR 5","#N/A",179187,,913,"BUCUREŞTI SECTORUL 5 / LICEUL TEORETIC ""DIMITRIE BOLINTINEANU""",1,16977,"MUNICIPIUL BUCUREŞTI",179187,1342,872,750,122,0,855,17,1500,628,415,440
46,"SECTOR 5","#N/A",179187,,914,"BUCUREŞTI SECTORUL 5 / LICEUL TEORETIC ""DIMITRIE BOLINTINEANU""",1,16977,"MUNICIPIUL BUCUREŞTI",179187,967,671,603,68,0,660,9,1100,429,333,327
46,"SECTOR 5","#N/A",179187,,915,"BUCUREŞTI SECTORUL 5 / ŞCOALA GIMNAZIALĂ NR.130",1,16977,"MUNICIPIUL BUCUREŞTI",179187,1251,843,701,142,0,820,23,1400,557,308,512
46,"SECTOR 5","#N/A",179187,,916,"BUCUREŞTI SECTORUL 5 / ŞCOALA GIMNAZIALĂ NR.130",1,16977,"MUNICIPIUL BUCUREŞTI",179187,1270,732,669,63,0,715,17,1400,668,291,424
46,"SECTOR 5","#N/A",179187,,917,"BUCUREŞTI SECTORUL 5 / ŞCOALA GIMNAZIALĂ NR.130",1,16977,"MUNICIPIUL BUCUREŞTI",179187,1158,706,655,50,1,694,12,1300,594,322,372
46,"SECTOR 5","#N/A",179187,,918,"BUCUREŞTI SECTORUL 5 / FACULTATEA DE DREPT",1,16977,"MUNICIPIUL BUCUREŞTI",179187,692,912,412,497,3,884,28,1100,188,221,663
46,"SECTOR 5","#N/A",179187,,919,"BUCUREŞTI SECTORUL 5 / FACULTATEA DE DREPT",1,16977,"MUNICIPIUL BUCUREŞTI",179187,678,636,348,288,0,627,9,900,264,169,458
46,"SECTOR 5","#N/A",179187,,920,"BUCUREŞTI SECTORUL 5 / FACULTATEA DE DREPT",1,16977,"MUNICIPIUL BUCUREŞTI",179187,662,635,326,309,0,624,11,900,265,194,430
46,"SECTOR 5","#N/A",179187,,921,"BUCUREŞTI SECTORUL 5 / COLEGIUL NAŢIONAL ""GHEORGHE LAZĂR""",1,16977,"MUNICIPIUL BUCUREŞTI",179187,729,790,454,231,105,771,19,900,110,284,487
46,"SECTOR 5","#N/A",179187,,922,"BUCUREŞTI SECTORUL 5 / COLEGIUL NAŢIONAL ""GHEORGHE LAZĂR""",1,16977,"MUNICIPIUL BUCUREŞTI",179187,952,953,460,401,92,934,19,1200,247,294,640
46,"SECTOR 5","#N/A",179187,,923,"BUCUREŞTI SECTORUL 5 / COLEGIUL NAŢIONAL ""GHEORGHE LAZĂR""",1,16977,"MUNICIPIUL BUCUREŞTI",179187,699,747,351,319,77,732,15,1000,253,243,489
46,"SECTOR 5","#N/A",179187,,924,"BUCUREŞTI SECTORUL 5 / COLEGIUL NAŢIONAL ""GHEORGHE LAZĂR""",1,16977,"MUNICIPIUL BUCUREŞTI",179187,824,827,465,253,109,811,16,1200,373,291,520
46,"SECTOR 5","#N/A",179187,,925,"BUCUREŞTI SECTORUL 5 / COLEGIUL NAŢIONAL ""GHEORGHE LAZĂR""",1,16977,"MUNICIPIUL BUCUREŞTI",179187,723,482,372,109,1,475,7,800,318,186,289
46,"SECTOR 5","#N/A",179187,,926,"BUCUREŞTI SECTORUL 5 / GRĂDINŢA NR.178 ""FLORI DE TEI""",1,16977,"MUNICIPIUL BUCUREŞTI",179187,1701,1024,919,104,1,986,38,1899,875,439,547
46,"SECTOR 5","#N/A",179187,,927,"BUCUREŞTI SECTORUL 5 / GRĂDINŢA NR.178 ""FLORI DE TEI""",1,16977,"MUNICIPIUL BUCUREŞTI",179187,1147,661,602,59,0,646,15,1300,639,317,329
46,"SECTOR 5","#N/A",179187,,928,"BUCUREŞTI SECTORUL 5 / GRĂDINŢA NR.178 ""FLORI DE TEI""",1,16977,"MUNICIPIUL BUCUREŞTI",179187,1943,1144,1075,69,0,1127,17,2100,956,555,572
46,"SECTOR 5","#N/A",179187,,929,"BUCUREŞTI SECTORUL 5 / LICEUL TEORETIC  ION BARBU",1,16977,"MUNICIPIUL BUCUREŞTI",179187,1283,868,720,148,0,843,25,1400,532,334,509
46,"SECTOR 5","#N/A",179187,,930,"BUCUREŞTI SECTORUL 5 / LICEUL TEORETIC  ION BARBU",1,16977,"MUNICIPIUL BUCUREŞTI",179187,1405,969,814,154,1,949,20,1600,631,367,582
46,"SECTOR 5","#N/A",179187,,931,"BUCUREŞTI SECTORUL 5 / LICEUL TEORETIC  ION BARBU",1,16977,"MUNICIPIUL BUCUREŞTI",179187,984,734,630,103,1,723,11,1100,366,251,472
46,"SECTOR 5","#N/A",179187,,932,"BUCUREŞTI SECTORUL 5 / LICEUL TEORETIC  ION BARBU",1,16977,"MUNICIPIUL BUCUREŞTI",179187,1121,786,749,37,0,771,15,1200,414,366,405
46,"SECTOR 5","#N/A",179187,,933,"BUCUREŞTI SECTORUL 5 / LICEUL TEORETIC  ION BARBU",1,16977,"MUNICIPIUL BUCUREŞTI",179187,1280,822,770,52,0,809,13,1400,578,376,433
46,"SECTOR 5","#N/A",179187,,934,"BUCUREŞTI SECTORUL 5 / LICEUL TEORETIC  ION BARBU",1,16977,"MUNICIPIUL BUCUREŞTI",179187,1842,1217,1167,50,0,1185,32,2000,783,487,698
46,"SECTOR 5","#N/A",179187,,935,"BUCUREŞTI SECTORUL 5 / LICEUL TEORETIC  ION BARBU",1,16977,"MUNICIPIUL BUCUREŞTI",179187,1059,754,717,37,0,735,19,1200,446,309,426
46,"SECTOR 5","#N/A",179187,,936,"BUCUREŞTI SECTORUL 5 / LICEUL TEORETIC  ION BARBU",1,16977,"MUNICIPIUL BUCUREŞTI",179187,834,531,496,35,0,520,11,900,369,189,331
46,"SECTOR 5","#N/A",179187,,937,"BUCUREŞTI SECTORUL 5 / LICEUL TEORETIC  ION BARBU",1,16977,"MUNICIPIUL BUCUREŞTI",179187,1291,853,806,44,3,835,18,1400,547,368,467
46,"SECTOR 5","#N/A",179187,,938,"BUCUREŞTI SECTORUL 5 / ŞCOALA GIMNAZIALĂ NR.115",1,16977,"MUNICIPIUL BUCUREŞTI",179187,1439,1029,887,142,0,1017,12,1600,571,417,600
46,"SECTOR 5","#N/A",179187,,939,"BUCUREŞTI SECTORUL 5 / ŞCOALA GIMNAZIALĂ NR.115",1,16977,"MUNICIPIUL BUCUREŞTI",179187,1252,965,775,188,2,945,20,1400,435,373,572
46,"SECTOR 5","#N/A",179187,,940,"BUCUREŞTI SECTORUL 5 / ŞCOALA GIMNAZIALĂ NR.115",1,16977,"MUNICIPIUL BUCUREŞTI",179187,1390,942,848,93,1,916,26,1500,558,379,537
46,"SECTOR 5","#N/A",179187,,941,"BUCUREŞTI SECTORUL 5 / ŞCOALA GIMNAZIALĂ NR.115",1,16977,"MUNICIPIUL BUCUREŞTI",179187,1205,833,735,98,0,821,12,1300,467,348,473
46,"SECTOR 5","#N/A",179187,,942,"BUCUREŞTI SECTORUL 5 / ŞCOALA GIMNAZIALĂ NR.115",1,16977,"MUNICIPIUL BUCUREŞTI",179187,1089,810,662,148,0,795,15,1200,390,327,468
46,"SECTOR 5","#N/A",179187,,943,"BUCUREŞTI SECTORUL 5 / ŞCOALA GIMNAZIALĂ NR.115",1,16977,"MUNICIPIUL BUCUREŞTI",179187,1240,846,773,72,1,832,14,1400,554,355,477
46,"SECTOR 5","#N/A",179187,,944,"BUCUREŞTI SECTORUL 5 / ŞCOALA GIMNAZIALĂ NR.146",1,16977,"MUNICIPIUL BUCUREŞTI",179187,1102,916,700,215,1,899,17,1200,284,300,599
46,"SECTOR 5","#N/A",179187,,945,"BUCUREŞTI SECTORUL 5 / ŞCOALA GIMNAZIALĂ NR.146",1,16977,"MUNICIPIUL BUCUREŞTI",179187,986,842,637,205,0,829,13,1100,258,303,526
46,"SECTOR 5","#N/A",179187,,946,"BUCUREŞTI SECTORUL 5 / ŞCOALA GIMNAZIALĂ NR.146",1,16977,"MUNICIPIUL BUCUREŞTI",179187,1088,990,686,145,159,972,18,1200,210,426,546
46,"SECTOR 5","#N/A",179187,,947,"BUCUREŞTI SECTORUL 5 / ŞCOALA GIMNAZIALĂ NR.146",1,16977,"MUNICIPIUL BUCUREŞTI",179187,892,689,569,120,0,677,12,1000,311,248,429
46,"SECTOR 5","#N/A",179187,,948,"BUCUREŞTI SECTORUL 5 / ŞCOALA GIMNAZIALĂ NR.146",1,16977,"MUNICIPIUL BUCUREŞTI",179187,906,766,633,132,1,751,15,1000,234,288,463
46,"SECTOR 5","#N/A",179187,,949,"BUCUREŞTI SECTORUL 5 / ŞCOALA GIMNAZIALĂ NR.150",1,16977,"MUNICIPIUL BUCUREŞTI",179187,754,530,448,80,2,518,12,800,270,176,342
46,"SECTOR 5","#N/A",179187,,950,"BUCUREŞTI SECTORUL 5 / ŞCOALA GIMNAZIALĂ NR.150",1,16977,"MUNICIPIUL BUCUREŞTI",179187,745,580,458,122,0,568,12,800,220,230,338
46,"SECTOR 5","#N/A",179187,,951,"BUCUREŞTI SECTORUL 5 / ŞCOALA GIMNAZIALĂ NR.150",1,16977,"MUNICIPIUL BUCUREŞTI",179187,791,555,450,105,0,546,9,900,345,196,350
46,"SECTOR 5","#N/A",179187,,952,"BUCUREŞTI SECTORUL 5 / ŞCOALA GIMNAZIALĂ NR.150",1,16977,"MUNICIPIUL BUCUREŞTI",179187,703,579,439,137,3,569,10,800,221,198,371
46,"SECTOR 5","#N/A",179187,,953,"BUCUREŞTI SECTORUL 5 / ŞCOALA GIMNAZIALĂ NR.150",1,16977,"MUNICIPIUL BUCUREŞTI",179187,739,479,438,41,0,472,7,800,321,166,306
46,"SECTOR 5","#N/A",179187,,954,"BUCUREŞTI SECTORUL 5 / ŞCOALA GIMNAZIALĂ NR.150",1,16977,"MUNICIPIUL BUCUREŞTI",179187,817,542,504,37,1,531,11,900,358,164,367
46,"SECTOR 5","#N/A",179187,,955,"BUCUREŞTI SECTORUL 5 / ŞCOALA GIMNAZIALĂ NR.128",1,16977,"MUNICIPIUL BUCUREŞTI",179187,786,484,424,60,0,476,8,900,416,192,284
46,"SECTOR 5","#N/A",179187,,956,"BUCUREŞTI SECTORUL 5 / ŞCOALA GIMNAZIALĂ NR.128",1,16977,"MUNICIPIUL BUCUREŞTI",179187,791,386,342,43,1,367,19,900,514,185,182
46,"SECTOR 5","#N/A",179187,,957,"BUCUREŞTI SECTORUL 5 / ŞCOALA GIMNAZIALĂ NR.128",1,16977,"MUNICIPIUL BUCUREŞTI",179187,799,469,438,31,0,461,8,900,431,181,280
46,"SECTOR 5","#N/A",179187,,958,"BUCUREŞTI SECTORUL 5 / ŞCOALA GIMNAZIALĂ NR.128",1,16977,"MUNICIPIUL BUCUREŞTI",179187,772,571,539,31,1,567,4,900,329,278,289
46,"SECTOR 5","#N/A",179187,,959,"BUCUREŞTI SECTORUL 5 / GRĂDINIŢA NR.268",1,16977,"MUNICIPIUL BUCUREŞTI",179187,741,576,512,63,1,562,14,800,224,250,312
46,"SECTOR 5","#N/A",179187,,960,"BUCUREŞTI SECTORUL 5 / GRĂDINIŢA NR.268",1,16977,"MUNICIPIUL BUCUREŞTI",179187,1262,1081,892,91,98,1056,25,1400,319,559,497
46,"SECTOR 5","#N/A",179187,,961,"BUCUREŞTI SECTORUL 5 / GRĂDINIŢA NR.268",1,16977,"MUNICIPIUL BUCUREŞTI",179187,871,655,604,47,4,632,23,1000,345,295,337
46,"SECTOR 5","#N/A",179187,,962,"BUCUREŞTI SECTORUL 5 / ŞCOALA GIMNAZIALĂ NR.127",1,16977,"MUNICIPIUL BUCUREŞTI",179187,1552,803,767,36,0,783,20,1600,797,419,364
46,"SECTOR 5","#N/A",179187,,963,"BUCUREŞTI SECTORUL 5 / ŞCOALA GIMNAZIALĂ NR.127",1,16977,"MUNICIPIUL BUCUREŞTI",179187,1774,985,941,44,0,963,22,1700,715,493,470
46,"SECTOR 5","#N/A",179187,,964,"BUCUREŞTI SECTORUL 5 / ŞCOALA GIMNAZIALĂ NR.127",1,16977,"MUNICIPIUL BUCUREŞTI",179187,1880,1157,1064,93,0,1133,24,2100,943,524,609
46,"SECTOR 5","#N/A",179187,,965,"BUCUREŞTI SECTORUL 5 / ŞCOALA GIMNAZIALĂ NR.127",1,16977,"MUNICIPIUL BUCUREŞTI",179187,1539,905,860,44,1,885,20,1700,795,468,417
46,"SECTOR 5","#N/A",179187,,966,"BUCUREŞTI SECTORUL 5 / ŞCOALA GIMNAZIALĂ NR.127",1,16977,"MUNICIPIUL BUCUREŞTI",179187,1612,919,864,55,0,887,32,1800,881,460,427
46,"SECTOR 5","#N/A",179187,,967,"BUCUREŞTI SECTORUL 5 / ŞCOALA GIMNAZIALĂ NR.125",1,16977,"MUNICIPIUL BUCUREŞTI",179187,1579,1006,930,75,1,986,20,1700,694,499,487
46,"SECTOR 5","#N/A",179187,,968,"BUCUREŞTI SECTORUL 5 / ŞCOALA GIMNAZIALĂ NR.125",1,16977,"MUNICIPIUL BUCUREŞTI",179187,1668,976,908,68,0,961,15,1800,824,552,409
46,"SECTOR 5","#N/A",179187,,969,"BUCUREŞTI SECTORUL 5 / ŞCOALA GIMNAZIALĂ NR.125",1,16977,"MUNICIPIUL BUCUREŞTI",179187,1440,808,749,59,0,794,14,1600,792,437,357
46,"SECTOR 5","#N/A",179187,,970,"BUCUREŞTI SECTORUL 5 / ŞCOALA GIMNAZIALĂ NR.131",1,16977,"MUNICIPIUL BUCUREŞTI",179187,1420,1086,730,106,250,1073,13,1600,514,674,399
46,"SECTOR 5","#N/A",179187,,971,"BUCUREŞTI SECTORUL 5 / ŞCOALA GIMNAZIALĂ NR.131",1,16977,"MUNICIPIUL BUCUREŞTI",179187,1583,1140,830,42,268,1121,19,1800,660,733,388
46,"SECTOR 5","#N/A",179187,,972,"BUCUREŞTI SECTORUL 5 / ŞCOALA GIMNAZIALĂ NR.131",1,16977,"MUNICIPIUL BUCUREŞTI",179187,1392,956,727,34,195,938,18,1500,544,595,343
46,"SECTOR 5","#N/A",179187,,973,"BUCUREŞTI SECTORUL 5 / ŞCOALA GIMNAZIALĂ NR.131",1,16977,"MUNICIPIUL BUCUREŞTI",179187,1647,961,884,44,33,946,15,1800,839,501,445
46,"SECTOR 5","#N/A",179187,,974,"BUCUREŞTI SECTORUL 5 / ŞCOALA GIMNAZIALĂ NR.131",1,16977,"MUNICIPIUL BUCUREŞTI",179187,1419,1012,779,24,209,998,14,1600,588,641,357
46,"SECTOR 5","#N/A",179187,,975,"BUCUREŞTI SECTORUL 5 / ŞCOALA GIMNAZIALĂ NR.131",1,16977,"MUNICIPIUL BUCUREŞTI",179187,1715,1160,901,36,223,1126,34,1900,740,688,438
46,"SECTOR 5","#N/A",179187,,976,"BUCUREŞTI SECTORUL 5 / ŞCOALA GIMNAZIALĂ NR.126",1,16977,"MUNICIPIUL BUCUREŞTI",179187,1522,972,924,48,0,953,19,1700,728,454,499
46,"SECTOR 5","#N/A",179187,,977,"BUCUREŞTI SECTORUL 5 / ŞCOALA GIMNAZIALĂ NR.126",1,16977,"MUNICIPIUL BUCUREŞTI",179187,1404,831,773,58,0,811,20,1500,669,456,355
46,"SECTOR 5","#N/A",179187,,978,"BUCUREŞTI SECTORUL 5 / ŞCOALA GIMNAZIALĂ NR.126",1,16977,"MUNICIPIUL BUCUREŞTI",179187,1376,843,797,46,0,820,23,1500,657,435,385
46,"SECTOR 5","#N/A",179187,,979,"BUCUREŞTI SECTORUL 5 / ŞCOALA GIMNAZIALĂ NR.126",1,16977,"MUNICIPIUL BUCUREŞTI",179187,1738,841,770,70,1,828,13,1900,1059,455,373
46,"SECTOR 5","#N/A",179187,,980,"BUCUREŞTI SECTORUL 5 / ŞCOALA GIMNAZIALĂ NR.139",1,16977,"MUNICIPIUL BUCUREŞTI",179187,1052,736,662,73,1,720,16,1198,462,344,376
46,"SECTOR 5","#N/A",179187,,981,"BUCUREŞTI SECTORUL 5 / ŞCOALA GIMNAZIALĂ NR.139",1,16977,"MUNICIPIUL BUCUREŞTI",179187,1048,679,621,57,1,669,10,1200,521,311,358
46,"SECTOR 5","#N/A",179187,,982,"BUCUREŞTI SECTORUL 5 / ŞCOALA GIMNAZIALĂ NR.139",1,16977,"MUNICIPIUL BUCUREŞTI",179187,947,705,664,41,0,689,16,1100,395,303,386
46,"SECTOR 5","#N/A",179187,,983,"BUCUREŞTI SECTORUL 5 / ŞCOALA GIMNAZIALĂ NR.139",1,16977,"MUNICIPIUL BUCUREŞTI",179187,1053,678,657,18,3,659,19,1200,522,375,284
46,"SECTOR 5","#N/A",179187,,984,"BUCUREŞTI SECTORUL 5 / ŞCOALA GIMNAZIALĂ NR.139",1,16977,"MUNICIPIUL BUCUREŞTI",179187,1057,684,660,21,3,669,15,1200,516,340,329
46,"SECTOR 5","#N/A",179187,,985,"BUCUREŞTI SECTORUL 5 / ŞCOALA GIMNAZIALĂ NR.124",1,16977,"MUNICIPIUL BUCUREŞTI",179187,1240,899,759,140,0,881,18,1400,501,421,460
46,"SECTOR 5","#N/A",179187,,986,"BUCUREŞTI SECTORUL 5 / ŞCOALA GIMNAZIALĂ NR.124",1,16977,"MUNICIPIUL BUCUREŞTI",179187,1174,798,705,93,0,781,17,1300,502,391,390
46,"SECTOR 5","#N/A",179187,,987,"BUCUREŞTI SECTORUL 5 / ŞCOALA GIMNAZIALĂ NR.124",1,16977,"MUNICIPIUL BUCUREŞTI",179187,1363,868,805,63,0,846,22,1500,632,400,446
46,"SECTOR 5","#N/A",179187,,988,"BUCUREŞTI SECTORUL 5 / ŞCOALA GIMNAZIALĂ NR.124",1,16977,"MUNICIPIUL BUCUREŞTI",179187,1239,737,692,45,0,718,19,1400,663,319,399
46,"SECTOR 5","#N/A",179187,,989,"BUCUREŞTI SECTORUL 5 / ŞCOALA GIMNAZIALĂ NR.124",1,16977,"MUNICIPIUL BUCUREŞTI",179187,1239,776,746,30,0,756,20,1400,624,372,384
46,"SECTOR 5","#N/A",179187,,990,"BUCUREŞTI SECTORUL 5 / ŞCOALA GIMNAZIALĂ NR.124",1,16977,"MUNICIPIUL BUCUREŞTI",179187,1037,673,644,29,0,657,16,1098,425,349,308
46,"SECTOR 5","#N/A",179187,,991,"BUCUREŞTI SECTORUL 5 / ŞCOALA GIMNAZIALĂ NR.124",1,16977,"MUNICIPIUL BUCUREŞTI",179187,1101,686,661,25,0,674,12,1200,514,366,308
46,"SECTOR 5","#N/A",179187,,992,"BUCUREŞTI SECTORUL 5 / ŞCOALA GIMNAZIALĂ NR.124",1,16977,"MUNICIPIUL BUCUREŞTI",179187,1191,757,722,35,0,741,16,1300,543,397,344
46,"SECTOR 5","#N/A",179187,,993,"BUCUREŞTI SECTORUL 5 / ŞCOALA GIMNAZIALĂ NR.124",1,16977,"MUNICIPIUL BUCUREŞTI",179187,1122,702,649,53,0,688,14,1200,498,348,340
46,"SECTOR 5","#N/A",179187,,994,"BUCUREŞTI SECTORUL 5 / ŞCOALA GIMNAZIALĂ NR.124",1,16977,"MUNICIPIUL BUCUREŞTI",179187,1239,732,688,43,1,717,15,1400,668,383,334
46,"SECTOR 5","#N/A",179187,,995,"BUCUREŞTI SECTORUL 5 / GRĂDINIŢA NR.55",1,16977,"MUNICIPIUL BUCUREŞTI",179187,983,688,539,148,1,675,13,1100,412,309,366
46,"SECTOR 5","#N/A",179187,,996,"BUCUREŞTI SECTORUL 5 / GRĂDINIŢA NR.55",1,16977,"MUNICIPIUL BUCUREŞTI",179187,1095,634,544,89,1,619,15,1200,566,314,305
46,"SECTOR 5","#N/A",179187,,997,"BUCUREŞTI SECTORUL 5 / ŞCOALA GIMNAZIALĂ NR.144",1,16977,"MUNICIPIUL BUCUREŞTI",179187,2082,1361,1211,150,0,1337,24,2300,939,627,710
46,"SECTOR 5","#N/A",179187,,998,"BUCUREŞTI SECTORUL 5 / ŞCOALA GIMNAZIALĂ NR.144",1,16977,"MUNICIPIUL BUCUREŞTI",179187,2100,1414,1250,162,2,1383,31,2300,886,646,737
46,"SECTOR 5","#N/A",179187,,999,"BUCUREŞTI SECTORUL 5 / ŞCOALA GIMNAZIALĂ NR.143",1,16977,"MUNICIPIUL BUCUREŞTI",179187,1169,768,692,76,0,751,17,1300,532,403,348
46,"SECTOR 5","#N/A",179187,,1000,"BUCUREŞTI SECTORUL 5 / ŞCOALA GIMNAZIALĂ NR.143",1,16977,"MUNICIPIUL BUCUREŞTI",179187,1302,864,732,132,0,847,17,1400,536,427,420
46,"SECTOR 5","#N/A",179187,,1001,"BUCUREŞTI SECTORUL 5 / ŞCOALA GIMNAZIALĂ NR.143",1,16977,"MUNICIPIUL BUCUREŞTI",179187,1192,762,681,81,0,750,12,1300,538,351,399
46,"SECTOR 5","#N/A",179187,,1002,"BUCUREŞTI SECTORUL 5 / ŞCOALA GIMNAZIALĂ NR.143",1,16977,"MUNICIPIUL BUCUREŞTI",179187,1223,780,715,65,0,764,16,1300,520,365,399
46,"SECTOR 5","#N/A",179187,,1003,"BUCUREŞTI SECTORUL 5 / ŞCOALA GIMNAZIALĂ NR.143",1,16977,"MUNICIPIUL BUCUREŞTI",179187,1066,680,642,38,0,667,13,1200,520,315,352
46,"SECTOR 5","#N/A",179187,,1004,"BUCUREŞTI SECTORUL 5 / ŞCOALA GIMNAZIALĂ NR.143",1,16977,"MUNICIPIUL BUCUREŞTI",179187,1393,833,789,44,0,803,30,1500,667,418,385
46,"SECTOR 5","#N/A",179187,,1005,"BUCUREŞTI SECTORUL 5 / ŞCOALA GIMNAZIALĂ NR.143",1,16977,"MUNICIPIUL BUCUREŞTI",179187,1176,768,729,39,0,754,14,1300,532,371,383
46,"SECTOR 5","#N/A",179187,,1006,"BUCUREŞTI SECTORUL 5 / ŞCOALA GIMNAZIALĂ NR.143",1,16977,"MUNICIPIUL BUCUREŞTI",179187,1182,687,650,36,1,676,11,1300,613,293,383
46,"SECTOR 5","#N/A",179187,,1007,"BUCUREŞTI SECTORUL 5 / ŞCOALA GIMNAZIALĂ NR.143",1,16977,"MUNICIPIUL BUCUREŞTI",179187,1301,784,752,32,0,762,22,1398,614,359,403
46,"SECTOR 5","#N/A",179187,,1008,"BUCUREŞTI SECTORUL 5 / ŞCOALA GIMNAZIALĂ NR.143",1,16977,"MUNICIPIUL BUCUREŞTI",179187,1198,672,642,30,0,651,21,1300,628,317,334
46,"SECTOR 5","#N/A",179187,,1009,"BUCUREŞTI SECTORUL 5 / ŞCOALA GIMNAZIALĂ NR.143",1,16977,"MUNICIPIUL BUCUREŞTI",179187,1227,725,698,27,0,705,20,1400,675,326,379
46,"SECTOR 5","#N/A",179187,,1010,"BUCUREŞTI SECTORUL 5 / ŞCOALA GIMNAZIALĂ NR.143",1,16977,"MUNICIPIUL BUCUREŞTI",179187,1194,660,629,30,1,648,12,1300,640,307,341
46,"SECTOR 5","#N/A",179187,,1011,"BUCUREŞTI SECTORUL 5 / ŞCOALA GIMNAZIALĂ NR.143",1,16977,"MUNICIPIUL BUCUREŞTI",179187,1223,658,629,27,2,641,17,1400,742,318,323
46,"SECTOR 5","#N/A",179187,,1012,"BUCUREŞTI SECTORUL 5 / ŞCOALA GIMNAZIALĂ NR.143",1,16977,"MUNICIPIUL BUCUREŞTI",179187,1129,710,693,17,0,695,15,1200,490,406,289
47,"SECTOR 6","#N/A",179196,,1013,"BUCUREŞTI SECTORUL 6 / SERVICIUL STARE CIVILĂ SECTOR 6",1,16878,"MUNICIPIUL BUCUREŞTI",179196,1156,732,627,105,0,719,13,1200,468,286,433
47,"SECTOR 6","#N/A",179196,,1014,"BUCUREŞTI SECTORUL 6 / SERVICIUL STARE CIVILĂ SECTOR 6",1,16878,"MUNICIPIUL BUCUREŞTI",179196,1245,910,802,106,2,893,17,1300,390,361,532
47,"SECTOR 6","#N/A",179196,,1015,"BUCUREŞTI SECTORUL 6 / ŞCOALA GIMNAZIALĂ NR.311",1,16878,"MUNICIPIUL BUCUREŞTI",179196,1605,1169,1021,148,0,1143,26,1700,531,471,672
47,"SECTOR 6","#N/A",179196,,1016,"BUCUREŞTI SECTORUL 6 / ŞCOALA GIMNAZIALĂ NR.311",1,16878,"MUNICIPIUL BUCUREŞTI",179196,1457,976,850,126,0,947,29,1499,523,442,505
47,"SECTOR 6","#N/A",179196,,1017,"BUCUREŞTI SECTORUL 6 / ŞCOALA GIMNAZIALĂ NR.311",1,16878,"MUNICIPIUL BUCUREŞTI",179196,1594,1102,1016,86,0,1069,32,1700,598,438,631
47,"SECTOR 6","#N/A",179196,,1018,"BUCUREŞTI SECTORUL 6 / ŞCOALA GIMNAZIALĂ NR.311",1,16878,"MUNICIPIUL BUCUREŞTI",179196,1609,1095,1025,70,0,1067,28,1700,605,482,585
47,"SECTOR 6","#N/A",179196,,1019,"BUCUREŞTI SECTORUL 6 / ŞCOALA GIMNAZIALĂ NR.311",1,16878,"MUNICIPIUL BUCUREŞTI",179196,1306,886,836,50,0,863,23,1380,494,364,499
47,"SECTOR 6","#N/A",179196,,1020,"BUCUREŞTI SECTORUL 6 / ŞCOALA GIMNAZIALĂ NR.311",1,16878,"MUNICIPIUL BUCUREŞTI",179196,1216,867,816,50,1,848,19,1300,433,388,460
47,"SECTOR 6","#N/A",179196,,1021,"BUCUREŞTI SECTORUL 6 / ŞCOALA GIMNAZIALĂ NR.59",1,16878,"MUNICIPIUL BUCUREŞTI",179196,1030,761,653,108,0,741,20,1100,339,326,415
47,"SECTOR 6","#N/A",179196,,1022,"BUCUREŞTI SECTORUL 6 / ŞCOALA GIMNAZIALĂ NR.59",1,16878,"MUNICIPIUL BUCUREŞTI",179196,1300,968,872,96,0,952,16,1400,432,383,569
47,"SECTOR 6","#N/A",179196,,1023,"BUCUREŞTI SECTORUL 6 / ŞCOALA GIMNAZIALĂ NR.59",1,16878,"MUNICIPIUL BUCUREŞTI",179196,1285,927,771,156,0,902,25,1400,473,354,548
47,"SECTOR 6","#N/A",179196,,1024,"BUCUREŞTI SECTORUL 6 / ŞCOALA GIMNAZIALĂ NR.59",1,16878,"MUNICIPIUL BUCUREŞTI",179196,1536,1038,912,125,1,1012,26,1700,662,412,600
47,"SECTOR 6","#N/A",179196,,1025,"BUCUREŞTI SECTORUL 6 / ŞCOALA GIMNAZIALĂ NR.59",1,16878,"MUNICIPIUL BUCUREŞTI",179196,1233,936,798,138,0,907,29,1300,364,299,608
47,"SECTOR 6","#N/A",179196,,1026,"BUCUREŞTI SECTORUL 6 / ŞCOALA GIMNAZIALĂ NR.59",1,16878,"MUNICIPIUL BUCUREŞTI",179196,1348,941,863,77,1,912,29,1400,459,399,513
47,"SECTOR 6","#N/A",179196,,1027,"BUCUREŞTI SECTORUL 6 / ŞCOALA GIMNAZIALĂ ""ADRIAN PĂUNESCU""",1,16878,"MUNICIPIUL BUCUREŞTI",179196,1309,971,835,135,1,938,33,1399,428,435,503
47,"SECTOR 6","#N/A",179196,,1028,"BUCUREŞTI SECTORUL 6 / ŞCOALA GIMNAZIALĂ ""ADRIAN PĂUNESCU""",1,16878,"MUNICIPIUL BUCUREŞTI",179196,1465,1061,880,181,0,1032,29,1600,539,405,627
47,"SECTOR 6","#N/A",179196,,1029,"BUCUREŞTI SECTORUL 6 / ŞCOALA GIMNAZIALĂ ""ADRIAN PĂUNESCU""",1,16878,"MUNICIPIUL BUCUREŞTI",179196,880,557,423,132,2,544,13,1000,443,221,323
47,"SECTOR 6","#N/A",179196,,1030,"BUCUREŞTI SECTORUL 6 / ŞCOALA GIMNAZIALĂ ""ADRIAN PĂUNESCU""",1,16878,"MUNICIPIUL BUCUREŞTI",179196,1456,967,899,66,2,936,31,1600,633,389,547
47,"SECTOR 6","#N/A",179196,,1031,"BUCUREŞTI SECTORUL 6 / ŞCOALA GIMNAZIALĂ ""ADRIAN PĂUNESCU""",1,16878,"MUNICIPIUL BUCUREŞTI",179196,1396,931,871,58,2,910,21,1500,569,366,544
47,"SECTOR 6","#N/A",179196,,1032,"BUCUREŞTI SECTORUL 6 / ŞCOALA GIMNAZIALĂ ""ADRIAN PĂUNESCU""",1,16878,"MUNICIPIUL BUCUREŞTI",179196,1332,789,756,33,0,770,19,1400,611,315,455
47,"SECTOR 6","#N/A",179196,,1033,"BUCUREŞTI SECTORUL 6 / ŞCOALA GIMNAZIALĂ NR.197",1,16878,"MUNICIPIUL BUCUREŞTI",179196,1649,1149,1040,109,0,1135,14,1800,651,455,680
47,"SECTOR 6","#N/A",179196,,1034,"BUCUREŞTI SECTORUL 6 / ŞCOALA GIMNAZIALĂ NR.197",1,16878,"MUNICIPIUL BUCUREŞTI",179196,1123,880,732,148,0,859,21,1200,320,322,537
47,"SECTOR 6","#N/A",179196,,1035,"BUCUREŞTI SECTORUL 6 / ŞCOALA GIMNAZIALĂ NR.197",1,16878,"MUNICIPIUL BUCUREŞTI",179196,1052,771,678,91,2,749,22,1100,329,295,454
47,"SECTOR 6","#N/A",179196,,1036,"BUCUREŞTI SECTORUL 6 / ŞCOALA GIMNAZIALĂ NR.197",1,16878,"MUNICIPIUL BUCUREŞTI",179196,1423,1047,950,96,1,1025,22,1500,453,456,569
47,"SECTOR 6","#N/A",179196,,1037,"BUCUREŞTI SECTORUL 6 / ŞCOALA GIMNAZIALĂ NR.197",1,16878,"MUNICIPIUL BUCUREŞTI",179196,1212,823,746,77,0,802,21,1300,477,289,513
47,"SECTOR 6","#N/A",179196,,1038,"BUCUREŞTI SECTORUL 6 / ŞCOALA GIMNAZIALĂ NR.197",1,16878,"MUNICIPIUL BUCUREŞTI",179196,1087,841,746,94,1,833,8,1200,359,406,427
47,"SECTOR 6","#N/A",179196,,1039,"BUCUREŞTI SECTORUL 6 / ŞCOALA GIMNAZIALĂ NR.197",1,16878,"MUNICIPIUL BUCUREŞTI",179196,1006,655,586,68,1,641,14,1100,445,256,385
47,"SECTOR 6","#N/A",179196,,1040,"BUCUREŞTI SECTORUL 6 / A.D.P.D.U. SECTOR 6",1,16878,"MUNICIPIUL BUCUREŞTI",179196,1284,895,812,82,1,880,15,1399,504,417,463
47,"SECTOR 6","#N/A",179196,,1041,"BUCUREŞTI SECTORUL 6 / ŞCOALA GIMNAZIALĂ NR.193",1,16878,"MUNICIPIUL BUCUREŞTI",179196,1130,867,741,125,1,849,18,1200,333,337,512
47,"SECTOR 6","#N/A",179196,,1042,"BUCUREŞTI SECTORUL 6 / ŞCOALA GIMNAZIALĂ NR.193",1,16878,"MUNICIPIUL BUCUREŞTI",179196,1166,998,758,237,3,967,31,1200,202,392,575
47,"SECTOR 6","#N/A",179196,,1043,"BUCUREŞTI SECTORUL 6 / ŞCOALA GIMNAZIALĂ NR.193",1,16878,"MUNICIPIUL BUCUREŞTI",179196,1028,975,652,321,2,956,19,1100,125,356,600
47,"SECTOR 6","#N/A",179196,,1044,"BUCUREŞTI SECTORUL 6 / ŞCOALA GIMNAZIALĂ NR.193",1,16878,"MUNICIPIUL BUCUREŞTI",179196,1307,984,796,188,0,967,17,1400,416,369,598
47,"SECTOR 6","#N/A",179196,,1045,"BUCUREŞTI SECTORUL 6 / COLEGIUL NAŢIONAL ""GRIGORE MOISIL""",1,16878,"MUNICIPIUL BUCUREŞTI",179196,1292,1132,832,299,1,1108,24,1400,268,396,712
47,"SECTOR 6","#N/A",179196,,1046,"BUCUREŞTI SECTORUL 6 / COLEGIUL NAŢIONAL ""GRIGORE MOISIL""",1,16878,"MUNICIPIUL BUCUREŞTI",179196,1449,1049,888,158,3,1022,27,1600,551,412,610
47,"SECTOR 6","#N/A",179196,,1047,"BUCUREŞTI SECTORUL 6 / COLEGIUL NAŢIONAL ""GRIGORE MOISIL""",1,16878,"MUNICIPIUL BUCUREŞTI",179196,1330,896,779,117,0,878,18,1400,504,365,513
47,"SECTOR 6","#N/A",179196,,1048,"BUCUREŞTI SECTORUL 6 / COLEGIUL NAŢIONAL ""GRIGORE MOISIL""",1,16878,"MUNICIPIUL BUCUREŞTI",179196,1168,793,705,88,0,774,19,1300,507,301,473
47,"SECTOR 6","#N/A",179196,,1049,"BUCUREŞTI SECTORUL 6 / ŞCOALA GIMNAZIALĂ NR.164",1,16878,"MUNICIPIUL BUCUREŞTI",179196,1142,848,658,190,0,829,19,1300,452,384,445
47,"SECTOR 6","#N/A",179196,,1050,"BUCUREŞTI SECTORUL 6 / ŞCOALA GIMNAZIALĂ NR.164",1,16878,"MUNICIPIUL BUCUREŞTI",179196,1211,863,698,163,2,843,20,1300,437,392,451
47,"SECTOR 6","#N/A",179196,,1051,"BUCUREŞTI SECTORUL 6 / ŞCOALA GIMNAZIALĂ NR.164",1,16878,"MUNICIPIUL BUCUREŞTI",179196,1049,786,641,145,0,770,16,1100,314,306,464
47,"SECTOR 6","#N/A",179196,,1052,"BUCUREŞTI SECTORUL 6 / COLEGIUL TEHNIC ""GHEORGHE ASACHI""",1,16878,"MUNICIPIUL BUCUREŞTI",179196,1484,1015,913,101,1,990,25,1600,585,422,568
47,"SECTOR 6","#N/A",179196,,1053,"BUCUREŞTI SECTORUL 6 / COLEGIUL TEHNIC ""GHEORGHE ASACHI""",1,16878,"MUNICIPIUL BUCUREŞTI",179196,1221,868,738,130,0,847,21,1298,430,327,520
47,"SECTOR 6","#N/A",179196,,1054,"BUCUREŞTI SECTORUL 6 / COLEGIUL TEHNIC ""GHEORGHE ASACHI""",1,16878,"MUNICIPIUL BUCUREŞTI",179196,1165,832,715,104,13,819,13,1301,469,402,417
47,"SECTOR 6","#N/A",179196,,1055,"BUCUREŞTI SECTORUL 6 / COLEGIUL TEHNIC ""GHEORGHE ASACHI""",1,16878,"MUNICIPIUL BUCUREŞTI",179196,1198,852,763,88,1,842,10,1300,448,375,467
47,"SECTOR 6","#N/A",179196,,1056,"BUCUREŞTI SECTORUL 6 / LICEUL TEHNOLOGIC ""ANTIM IVIREANU""",1,16878,"MUNICIPIUL BUCUREŞTI",179196,1332,883,797,86,0,867,16,1400,517,380,487
47,"SECTOR 6","#N/A",179196,,1057,"BUCUREŞTI SECTORUL 6 / LICEUL TEHNOLOGIC ""ANTIM IVIREANU""",1,16878,"MUNICIPIUL BUCUREŞTI",179196,1173,809,714,95,0,795,14,1300,491,334,461
47,"SECTOR 6","#N/A",179196,,1058,"BUCUREŞTI SECTORUL 6 / LICEUL TEHNOLOGIC ""ANTIM IVIREANU""",1,16878,"MUNICIPIUL BUCUREŞTI",179196,1229,865,805,58,2,850,15,1300,435,382,468
47,"SECTOR 6","#N/A",179196,,1059,"BUCUREŞTI SECTORUL 6 / LICEUL TEHNOLOGIC ""ANTIM IVIREANU""",1,16878,"MUNICIPIUL BUCUREŞTI",179196,1303,729,635,94,0,710,19,1400,671,312,398
47,"SECTOR 6","#N/A",179196,,1060,"BUCUREŞTI SECTORUL 6 / LICEUL TEHNOLOGIC ""ANTIM IVIREANU""",1,16878,"MUNICIPIUL BUCUREŞTI",179196,1087,698,635,63,0,678,20,1200,502,274,404
47,"SECTOR 6","#N/A",179196,,1061,"BUCUREŞTI SECTORUL 6 / LICEUL TEHNOLOGIC ""ANTIM IVIREANU""",1,16878,"MUNICIPIUL BUCUREŞTI",179196,1306,828,764,64,0,805,23,1400,572,352,453
47,"SECTOR 6","#N/A",179196,,1062,"BUCUREŞTI SECTORUL 6 / LICEUL TEHNOLOGIC ""ANTIM IVIREANU""",1,16878,"MUNICIPIUL BUCUREŞTI",179196,1353,916,840,76,0,902,14,1500,584,378,524
47,"SECTOR 6","#N/A",179196,,1063,"BUCUREŞTI SECTORUL 6 / ŞCOALA GIMNAZIALĂ NR.169 CORPI",1,16878,"MUNICIPIUL BUCUREŞTI",179196,1210,881,794,85,2,870,11,1300,419,363,507
47,"SECTOR 6","#N/A",179196,,1064,"BUCUREŞTI SECTORUL 6 / ŞCOALA GIMNAZIALĂ NR.169 CORPI",1,16878,"MUNICIPIUL BUCUREŞTI",179196,1179,844,734,110,0,828,16,1300,456,366,462
47,"SECTOR 6","#N/A",179196,,1065,"BUCUREŞTI SECTORUL 6 / ŞCOALA GIMNAZIALĂ NR.169 CORPI",1,16878,"MUNICIPIUL BUCUREŞTI",179196,1373,934,873,60,1,912,22,1500,566,358,554
47,"SECTOR 6","#N/A",179196,,1066,"BUCUREŞTI SECTORUL 6 / ŞCOALA GIMNAZIALĂ NR.169 CORPI",1,16878,"MUNICIPIUL BUCUREŞTI",179196,1363,900,854,45,1,878,22,1500,600,398,480
47,"SECTOR 6","#N/A",179196,,1067,"BUCUREŞTI SECTORUL 6 / ŞCOALA GIMNAZIALĂ NR.169 CORPI",1,16878,"MUNICIPIUL BUCUREŞTI",179196,1306,934,883,51,0,906,28,1395,461,396,510
47,"SECTOR 6","#N/A",179196,,1068,"BUCUREŞTI SECTORUL 6 / ŞCOALA GIMNAZIALĂ NR.169 CORPII",1,16878,"MUNICIPIUL BUCUREŞTI",179196,1469,1052,951,101,0,1032,20,1600,548,446,586
47,"SECTOR 6","#N/A",179196,,1069,"BUCUREŞTI SECTORUL 6 / ŞCOALA GIMNAZIALĂ NR.169 CORPII",1,16878,"MUNICIPIUL BUCUREŞTI",179196,1337,991,859,132,0,967,24,1400,409,380,587
47,"SECTOR 6","#N/A",179196,,1070,"BUCUREŞTI SECTORUL 6 / ŞCOALA GIMNAZIALĂ NR.169 CORPII",1,16878,"MUNICIPIUL BUCUREŞTI",179196,1252,823,780,43,0,815,8,1300,477,326,489
47,"SECTOR 6","#N/A",179196,,1071,"BUCUREŞTI SECTORUL 6 / ŞCOALA GIMNAZIALĂ NR.169 CORPII",1,16878,"MUNICIPIUL BUCUREŞTI",179196,1213,800,766,34,0,785,15,1300,500,395,390
47,"SECTOR 6","#N/A",179196,,1072,"BUCUREŞTI SECTORUL 6 / COLEGIUL NAŢIONAL ""ELENA CUZA""",1,16878,"MUNICIPIUL BUCUREŞTI",179196,1265,947,801,145,1,918,29,1400,453,378,540
47,"SECTOR 6","#N/A",179196,,1073,"BUCUREŞTI SECTORUL 6 / COLEGIUL NAŢIONAL ""ELENA CUZA""",1,16878,"MUNICIPIUL BUCUREŞTI",179196,1081,788,698,88,2,776,12,1200,412,319,457
47,"SECTOR 6","#N/A",179196,,1074,"BUCUREŞTI SECTORUL 6 / COLEGIUL NAŢIONAL ""ELENA CUZA""",1,16878,"MUNICIPIUL BUCUREŞTI",179196,1195,827,756,71,0,809,18,1300,473,341,468
47,"SECTOR 6","#N/A",179196,,1075,"BUCUREŞTI SECTORUL 6 / COLEGIUL NAŢIONAL ""ELENA CUZA""",1,16878,"MUNICIPIUL BUCUREŞTI",179196,1006,663,603,60,0,649,14,1100,437,295,354
47,"SECTOR 6","#N/A",179196,,1076,"BUCUREŞTI SECTORUL 6 / LICEUL TEORETIC ""EUGEN LOVINESCU""",1,16878,"MUNICIPIUL BUCUREŞTI",179196,1532,1126,995,130,1,1090,36,1700,574,467,623
47,"SECTOR 6","#N/A",179196,,1077,"BUCUREŞTI SECTORUL 6 / LICEUL TEORETIC ""EUGEN LOVINESCU""",1,16878,"MUNICIPIUL BUCUREŞTI",179196,1313,1020,853,166,1,990,30,1400,380,396,594
47,"SECTOR 6","#N/A",179196,,1078,"BUCUREŞTI SECTORUL 6 / LICEUL TEORETIC ""EUGEN LOVINESCU""",1,16878,"MUNICIPIUL BUCUREŞTI",179196,1568,1117,992,125,0,1101,16,1700,583,456,645
47,"SECTOR 6","#N/A",179196,,1079,"BUCUREŞTI SECTORUL 6 / LICEUL TEORETIC ""EUGEN LOVINESCU""",1,16878,"MUNICIPIUL BUCUREŞTI",179196,1517,1010,946,62,2,989,21,1600,590,436,553
47,"SECTOR 6","#N/A",179196,,1080,"BUCUREŞTI SECTORUL 6 / LICEUL TEORETIC ""EUGEN LOVINESCU""",1,16878,"MUNICIPIUL BUCUREŞTI",179196,1479,1038,969,68,1,1007,31,1600,562,407,600
47,"SECTOR 6","#N/A",179196,,1081,"BUCUREŞTI SECTORUL 6 / LICEUL TEORETIC ""EUGEN LOVINESCU""",1,16878,"MUNICIPIUL BUCUREŞTI",179196,1293,868,814,53,1,852,16,1400,532,391,461
47,"SECTOR 6","#N/A",179196,,1082,"BUCUREŞTI SECTORUL 6 / LICEUL TEORETIC ""EUGEN LOVINESCU""",1,16878,"MUNICIPIUL BUCUREŞTI",179196,1223,832,734,98,0,811,21,1300,468,318,493
47,"SECTOR 6","#N/A",179196,,1083,"BUCUREŞTI SECTORUL 6 / LICEUL TEORETIC ""EUGEN LOVINESCU""",1,16878,"MUNICIPIUL BUCUREŞTI",179196,1302,864,797,66,1,847,17,1400,536,387,460
47,"SECTOR 6","#N/A",179196,,1084,"BUCUREŞTI SECTORUL 6 / LICEUL TEORETIC ""EUGEN LOVINESCU""",1,16878,"MUNICIPIUL BUCUREŞTI",179196,886,591,554,37,0,572,19,1000,409,255,317
47,"SECTOR 6","#N/A",179196,,1085,"BUCUREŞTI SECTORUL 6 / ŞCOALA GIMNAZIALĂ NR.279",1,16878,"MUNICIPIUL BUCUREŞTI",179196,1539,1014,918,96,0,997,17,1601,587,386,611
47,"SECTOR 6","#N/A",179196,,1086,"BUCUREŞTI SECTORUL 6 / ŞCOALA GIMNAZIALĂ NR.279",1,16878,"MUNICIPIUL BUCUREŞTI",179196,1595,1136,991,145,0,1113,23,1700,564,465,648
47,"SECTOR 6","#N/A",179196,,1087,"BUCUREŞTI SECTORUL 6 / ŞCOALA GIMNAZIALĂ NR.279",1,16878,"MUNICIPIUL BUCUREŞTI",179196,1426,1053,904,149,0,1041,12,1500,447,345,696
47,"SECTOR 6","#N/A",179196,,1088,"BUCUREŞTI SECTORUL 6 / ŞCOALA GIMNAZIALĂ NR.279",1,16878,"MUNICIPIUL BUCUREŞTI",179196,1602,1046,951,95,0,1027,19,1700,654,471,556
47,"SECTOR 6","#N/A",179196,,1089,"BUCUREŞTI SECTORUL 6 / ŞCOALA GIMNAZIALĂ NR.279",1,16878,"MUNICIPIUL BUCUREŞTI",179196,1471,959,900,59,0,936,23,1600,641,424,512
47,"SECTOR 6","#N/A",179196,,1090,"BUCUREŞTI SECTORUL 6 / ŞCOALA GIMNAZIALĂ SPECIALĂ ""CONSTANTIN PĂUNESCU""",1,16878,"MUNICIPIUL BUCUREŞTI",179196,1788,1187,1078,108,1,1158,29,1900,713,490,668
47,"SECTOR 6","#N/A",179196,,1091,"BUCUREŞTI SECTORUL 6 / ŞCOALA GIMNAZIALĂ SPECIALĂ ""CONSTANTIN PĂUNESCU""",1,16878,"MUNICIPIUL BUCUREŞTI",179196,1601,1059,970,89,0,1031,28,1684,625,451,580
47,"SECTOR 6","#N/A",179196,,1092,"BUCUREŞTI SECTORUL 6 / ŞCOALA GIMNAZIALĂ SPECIALĂ PENTRU DEFICIENŢI DE AUZ ""SF. MARIA""",1,16878,"MUNICIPIUL BUCUREŞTI",179196,1910,1255,1172,82,1,1238,17,2000,745,422,816
47,"SECTOR 6","#N/A",179196,,1093,"BUCUREŞTI SECTORUL 6 / ŞCOALA GIMNAZIALĂ SPECIALĂ PENTRU DEFICIENŢI DE AUZ ""SF. MARIA""",1,16878,"MUNICIPIUL BUCUREŞTI",179196,1756,1266,1139,127,0,1249,17,1899,633,410,839
47,"SECTOR 6","#N/A",179196,,1094,"BUCUREŞTI SECTORUL 6 / ŞCOALA GIMNAZIALĂ SPECIALĂ PENTRU DEFICIENŢI DE AUZ ""SF. MARIA""",1,16878,"MUNICIPIUL BUCUREŞTI",179196,1089,713,639,74,0,691,22,1200,487,291,400
47,"SECTOR 6","#N/A",179196,,1095,"BUCUREŞTI SECTORUL 6 / ŞCOALA GIMNAZIALĂ ""SF. ANDREI""",1,16878,"MUNICIPIUL BUCUREŞTI",179196,1372,1007,834,173,0,985,22,1500,493,391,594
47,"SECTOR 6","#N/A",179196,,1096,"BUCUREŞTI SECTORUL 6 / ŞCOALA GIMNAZIALĂ ""SF. ANDREI""",1,16878,"MUNICIPIUL BUCUREŞTI",179196,1692,1224,1000,223,1,1191,33,1800,576,462,729
47,"SECTOR 6","#N/A",179196,,1097,"BUCUREŞTI SECTORUL 6 / ŞCOALA GIMNAZIALĂ ""SF. ANDREI""",1,16878,"MUNICIPIUL BUCUREŞTI",179196,1483,1084,944,139,1,1054,30,1600,516,456,598
47,"SECTOR 6","#N/A",179196,,1098,"BUCUREŞTI SECTORUL 6 / ŞCOALA GIMNAZIALĂ ""SF. ANDREI""",1,16878,"MUNICIPIUL BUCUREŞTI",179196,1611,1041,970,71,0,1008,33,1700,659,445,563
47,"SECTOR 6","#N/A",179196,,1099,"BUCUREŞTI SECTORUL 6 / ŞCOALA GIMNAZIALĂ ""SF. ANDREI""",1,16878,"MUNICIPIUL BUCUREŞTI",179196,1129,787,745,42,0,768,19,1200,413,279,489
47,"SECTOR 6","#N/A",179196,,1100,"BUCUREŞTI SECTORUL 6 / ŞCOALA GIMNAZIALĂ ""SF. ANDREI""",1,16878,"MUNICIPIUL BUCUREŞTI",179196,1469,929,893,35,1,913,16,1600,671,426,487
47,"SECTOR 6","#N/A",179196,,1101,"BUCUREŞTI SECTORUL 6 / ŞCOALA GIMNAZIALĂ ""SF. ANDREI""",1,16878,"MUNICIPIUL BUCUREŞTI",179196,1511,1052,1009,43,0,1031,21,1600,548,386,645
47,"SECTOR 6","#N/A",179196,,1102,"BUCUREŞTI SECTORUL 6 / ŞCOALA GIMNAZIALĂ ""SF. ANDREI""",1,16878,"MUNICIPIUL BUCUREŞTI",179196,1315,880,830,48,2,865,15,1400,520,364,501
47,"SECTOR 6","#N/A",179196,,1103,"BUCUREŞTI SECTORUL 6 / ŞCOALA GIMNAZIALĂ ""SF. ANDREI""",1,16878,"MUNICIPIUL BUCUREŞTI",179196,1942,1394,1338,56,0,1342,52,2100,706,478,864
47,"SECTOR 6","#N/A",179196,,1104,"BUCUREŞTI SECTORUL 6 / ŞCOALA GIMNAZIALĂ ""SF. ANDREI""",1,16878,"MUNICIPIUL BUCUREŞTI",179196,1420,993,933,59,1,966,27,1500,507,279,687
47,"SECTOR 6","#N/A",179196,,1105,"BUCUREŞTI SECTORUL 6 / ŞCOALA GIMNAZIALĂ NR.206",1,16878,"MUNICIPIUL BUCUREŞTI",179196,1443,1035,921,114,0,1014,21,1600,565,439,575
47,"SECTOR 6","#N/A",179196,,1106,"BUCUREŞTI SECTORUL 6 / ŞCOALA GIMNAZIALĂ NR.206",1,16878,"MUNICIPIUL BUCUREŞTI",179196,1509,946,861,84,1,930,16,1600,654,434,496
47,"SECTOR 6","#N/A",179196,,1107,"BUCUREŞTI SECTORUL 6 / ŞCOALA GIMNAZIALĂ NR.206",1,16878,"MUNICIPIUL BUCUREŞTI",179196,1542,954,859,95,0,927,27,1600,646,391,536
47,"SECTOR 6","#N/A",179196,,1108,"BUCUREŞTI SECTORUL 6 / ŞCOALA GIMNAZIALĂ NR.206",1,16878,"MUNICIPIUL BUCUREŞTI",179196,1356,908,859,49,0,881,27,1500,592,389,492
47,"SECTOR 6","#N/A",179196,,1109,"BUCUREŞTI SECTORUL 6 / ŞCOALA GIMNAZIALĂ NR.206",1,16878,"MUNICIPIUL BUCUREŞTI",179196,1501,982,943,36,3,965,17,1600,618,394,571
47,"SECTOR 6","#N/A",179196,,1110,"BUCUREŞTI SECTORUL 6 / ŞCOALA GIMNAZIALĂ NR.206",1,16878,"MUNICIPIUL BUCUREŞTI",179196,1577,982,953,27,2,958,24,1698,716,408,550
47,"SECTOR 6","#N/A",179196,,1111,"BUCUREŞTI SECTORUL 6 / ŞCOALA GIMNAZIALĂ ""SF. CONSTANTIN ŞI ELENA""",1,16878,"MUNICIPIUL BUCUREŞTI",179196,1311,926,768,157,1,908,18,1400,474,389,519
47,"SECTOR 6","#N/A",179196,,1112,"BUCUREŞTI SECTORUL 6 / ŞCOALA GIMNAZIALĂ ""SF. CONSTANTIN ŞI ELENA""",1,16878,"MUNICIPIUL BUCUREŞTI",179196,1628,1084,959,124,1,1071,13,1700,616,488,583
47,"SECTOR 6","#N/A",179196,,1113,"BUCUREŞTI SECTORUL 6 / ŞCOALA GIMNAZIALĂ ""SF. CONSTANTIN ŞI ELENA""",1,16878,"MUNICIPIUL BUCUREŞTI",179196,1212,864,771,93,0,847,17,1300,436,358,489
47,"SECTOR 6","#N/A",179196,,1114,"BUCUREŞTI SECTORUL 6 / ŞCOALA GIMNAZIALĂ ""SF. CONSTANTIN ŞI ELENA""",1,16878,"MUNICIPIUL BUCUREŞTI",179196,1391,975,916,58,1,958,17,1501,526,399,559
47,"SECTOR 6","#N/A",179196,,1115,"BUCUREŞTI SECTORUL 6 / ŞCOALA GIMNAZIALĂ ""SF. CONSTANTIN ŞI ELENA""",1,16878,"MUNICIPIUL BUCUREŞTI",179196,1566,996,954,42,0,974,22,1700,704,428,546
47,"SECTOR 6","#N/A",179196,,1116,"BUCUREŞTI SECTORUL 6 / ŞCOALA GIMNAZIALĂ ""SF. CONSTANTIN ŞI ELENA""",1,16878,"MUNICIPIUL BUCUREŞTI",179196,959,519,484,35,0,506,13,1100,581,199,307
47,"SECTOR 6","#N/A",179196,,1117,"BUCUREŞTI SECTORUL 6 / COLEGIUL TEHNIC  DE POŞTĂ ŞI TELECOMUNICAŢII ""GH. AIRINEI""",1,16878,"MUNICIPIUL BUCUREŞTI",179196,1840,1271,1059,212,0,1243,28,2000,729,485,758
47,"SECTOR 6","#N/A",179196,,1118,"BUCUREŞTI SECTORUL 6 / COLEGIUL TEHNIC  DE POŞTĂ ŞI TELECOMUNICAŢII ""GH. AIRINEI""",1,16878,"MUNICIPIUL BUCUREŞTI",179196,1571,1055,754,301,0,1033,22,1700,645,433,600
47,"SECTOR 6","#N/A",179196,,1119,"BUCUREŞTI SECTORUL 6 / ŞCOALA GIMNAZIALĂ NR.309",1,16878,"MUNICIPIUL BUCUREŞTI",179196,1615,1352,1020,330,2,1316,36,1700,348,538,778
47,"SECTOR 6","#N/A",179196,,1120,"BUCUREŞTI SECTORUL 6 / ŞCOALA GIMNAZIALĂ NR.309",1,16878,"MUNICIPIUL BUCUREŞTI",179196,1614,1281,1015,266,0,1246,35,1700,419,478,768
47,"SECTOR 6","#N/A",179196,,1121,"BUCUREŞTI SECTORUL 6 / ŞCOALA GIMNAZIALĂ NR.309",1,16878,"MUNICIPIUL BUCUREŞTI",179196,1531,1141,897,244,0,1120,21,1600,459,452,668
47,"SECTOR 6","#N/A",179196,,1122,"BUCUREŞTI SECTORUL 6 / ŞCOALA GIMNAZIALĂ NR.309",1,16878,"MUNICIPIUL BUCUREŞTI",179196,1338,991,719,272,0,961,30,1400,409,416,545
47,"SECTOR 6","#N/A",179196,,1123,"BUCUREŞTI SECTORUL 6 / ŞCOALA GIMNAZIALĂ NR.309",1,16878,"MUNICIPIUL BUCUREŞTI",179196,1322,860,740,120,0,832,28,1400,540,321,511
47,"SECTOR 6","#N/A",179196,,1124,"BUCUREŞTI SECTORUL 6 / ŞCOALA GIMNAZIALĂ NR.309",1,16878,"MUNICIPIUL BUCUREŞTI",179196,1938,1206,1126,77,3,1175,31,2100,894,529,646
47,"SECTOR 6","#N/A",179196,,1125,"BUCUREŞTI SECTORUL 6 / ŞCOALA GIMNAZIALĂ ""ION DUMITRIU""",1,16878,"MUNICIPIUL BUCUREŞTI",179196,1320,797,713,82,2,783,14,1400,603,343,440
47,"SECTOR 6","#N/A",179196,,1126,"BUCUREŞTI SECTORUL 6 / ŞCOALA GIMNAZIALĂ ""ION DUMITRIU""",1,16878,"MUNICIPIUL BUCUREŞTI",179196,1635,1046,932,114,0,1023,23,1800,754,461,562
47,"SECTOR 6","#N/A",179196,,1127,"BUCUREŞTI SECTORUL 6 / ŞCOALA GIMNAZIALĂ ""ION DUMITRIU""",1,16878,"MUNICIPIUL BUCUREŞTI",179196,1272,877,743,134,0,862,15,1400,523,386,476
47,"SECTOR 6","#N/A",179196,,1128,"BUCUREŞTI SECTORUL 6 / ŞCOALA GIMNAZIALĂ ""ION DUMITRIU""",1,16878,"MUNICIPIUL BUCUREŞTI",179196,1706,1086,956,130,0,1065,21,1799,713,460,605
47,"SECTOR 6","#N/A",179196,,1129,"BUCUREŞTI SECTORUL 6 / ŞCOALA GIMNAZIALĂ ""ION DUMITRIU""",1,16878,"MUNICIPIUL BUCUREŞTI",179196,1449,933,860,73,0,915,18,1600,667,442,473
47,"SECTOR 6","#N/A",179196,,1130,"BUCUREŞTI SECTORUL 6 / ŞCOALA GIMNAZIALĂ ""ION DUMITRIU""",1,16878,"MUNICIPIUL BUCUREŞTI",179196,1689,1047,967,80,0,1026,21,1800,753,459,567
47,"SECTOR 6","#N/A",179196,,1131,"BUCUREŞTI SECTORUL 6 / ŞCOALA GIMNAZIALĂ ""ION DUMITRIU""",1,16878,"MUNICIPIUL BUCUREŞTI",179196,1426,815,773,42,0,792,23,1600,785,399,393
47,"SECTOR 6","#N/A",179196,,1132,"BUCUREŞTI SECTORUL 6 / ŞCOALA GIMNAZIALĂ ""ION DUMITRIU""",1,16878,"MUNICIPIUL BUCUREŞTI",179196,1504,995,922,73,0,963,32,1600,605,441,522
47,"SECTOR 6","#N/A",179196,,1133,"BUCUREŞTI SECTORUL 6 / ŞCOALA GIMNAZIALĂ ""ION DUMITRIU""",1,16878,"MUNICIPIUL BUCUREŞTI",179196,1706,1040,992,48,0,1018,22,1800,760,485,533
47,"SECTOR 6","#N/A",179196,,1134,"BUCUREŞTI SECTORUL 6 / ŞCOALA GIMNAZIALĂ ""ION DUMITRIU""",1,16878,"MUNICIPIUL BUCUREŞTI",179196,1641,853,808,45,0,841,12,1800,947,348,493
47,"SECTOR 6","#N/A",179196,,1135,"BUCUREŞTI SECTORUL 6 / CENTRUL EUROPEAN SECTOR 6",1,16878,"MUNICIPIUL BUCUREŞTI",179196,1753,1302,1077,224,1,1272,30,1900,598,517,755
47,"SECTOR 6","#N/A",179196,,1136,"BUCUREŞTI SECTORUL 6 / LICEUL TEHNOLOGIC ""PETRU PONI""",1,16878,"MUNICIPIUL BUCUREŞTI",179196,1537,1108,801,307,0,1092,16,1600,492,380,712
47,"SECTOR 6","#N/A",179196,,1137,"BUCUREŞTI SECTORUL 6 / LICEUL TEHNOLOGIC ""PETRU PONI""",1,16878,"MUNICIPIUL BUCUREŞTI",179196,1425,1166,720,446,0,1140,26,1700,534,352,788
47,"SECTOR 6","#N/A",179196,,1138,"BUCUREŞTI SECTORUL 6 / ŞCOALA GIMNAZIALĂ ""SFÂNTA TREIME""",1,16878,"MUNICIPIUL BUCUREŞTI",179196,1709,1077,946,131,0,1057,20,1800,723,431,626
47,"SECTOR 6","#N/A",179196,,1139,"BUCUREŞTI SECTORUL 6 / ŞCOALA GIMNAZIALĂ ""SFÂNTA TREIME""",1,16878,"MUNICIPIUL BUCUREŞTI",179196,1788,1255,1143,103,9,1227,28,1900,645,512,715
47,"SECTOR 6","#N/A",179196,,1140,"BUCUREŞTI SECTORUL 6 / ŞCOALA GIMNAZIALĂ ""SFÂNTA TREIME""",1,16878,"MUNICIPIUL BUCUREŞTI",179196,1758,1117,1045,72,0,1094,23,1900,783,485,609
47,"SECTOR 6","#N/A",179196,,1141,"BUCUREŞTI SECTORUL 6 / ŞCOALA GIMNAZIALĂ ""SFÂNTA TREIME""",1,16878,"MUNICIPIUL BUCUREŞTI",179196,1833,1171,1109,61,1,1140,31,2001,830,506,634
47,"SECTOR 6","#N/A",179196,,1142,"BUCUREŞTI SECTORUL 6 / ŞCOALA GIMNAZIALĂ ""SFÂNTA TREIME""",1,16878,"MUNICIPIUL BUCUREŞTI",179196,1659,1103,1023,79,1,1078,25,1800,697,460,618
47,"SECTOR 6","#N/A",179196,,1143,"BUCUREŞTI SECTORUL 6 / ŞCOALA GIMNAZIALĂ ""SFÂNTA TREIME""",1,16878,"MUNICIPIUL BUCUREŞTI",179196,1601,993,919,74,0,960,33,1700,707,410,550
47,"SECTOR 6","#N/A",179196,,1144,"BUCUREŞTI SECTORUL 6 / ŞCOALA GIMNAZIALĂ ""SFÂNTA TREIME""",1,16878,"MUNICIPIUL BUCUREŞTI",179196,1702,1121,1036,83,2,1092,29,1800,679,458,634
47,"SECTOR 6","#N/A",179196,,1145,"BUCUREŞTI SECTORUL 6 / ŞCOALA GIMNAZIALĂ NR.198",1,16878,"MUNICIPIUL BUCUREŞTI",179196,1871,1244,1049,195,0,1209,35,2000,756,439,770
47,"SECTOR 6","#N/A",179196,,1146,"BUCUREŞTI SECTORUL 6 / ŞCOALA GIMNAZIALĂ NR.198",1,16878,"MUNICIPIUL BUCUREŞTI",179196,1774,1229,993,236,0,1206,23,1900,671,515,691
47,"SECTOR 6","#N/A",179196,,1147,"BUCUREŞTI SECTORUL 6 / ŞCOALA GIMNAZIALĂ NR.198",1,16878,"MUNICIPIUL BUCUREŞTI",179196,1559,1007,893,113,1,991,16,1700,693,455,536
47,"SECTOR 6","#N/A",179196,,1148,"BUCUREŞTI SECTORUL 6 / ŞCOALA GIMNAZIALĂ NR.198",1,16878,"MUNICIPIUL BUCUREŞTI",179196,1505,999,893,104,2,974,25,1600,601,387,587
47,"SECTOR 6","#N/A",179196,,1149,"BUCUREŞTI SECTORUL 6 / ŞCOALA GIMNAZIALĂ NR.198",1,16878,"MUNICIPIUL BUCUREŞTI",179196,1852,1193,1061,132,0,1178,15,2000,807,488,690
47,"SECTOR 6","#N/A",179196,,1150,"BUCUREŞTI SECTORUL 6 / ŞCOALA GIMNAZIALĂ NR.198",1,16878,"MUNICIPIUL BUCUREŞTI",179196,1557,1025,934,90,1,1001,24,1700,675,423,578
47,"SECTOR 6","#N/A",179196,,1151,"BUCUREŞTI SECTORUL 6 / ŞCOALA GIMNAZIALĂ ""CONSTANTIN BRÂNCUŞI""",1,16878,"MUNICIPIUL BUCUREŞTI",179196,1439,1036,863,173,0,1016,20,1600,564,424,592
47,"SECTOR 6","#N/A",179196,,1152,"BUCUREŞTI SECTORUL 6 / ŞCOALA GIMNAZIALĂ ""CONSTANTIN BRÂNCUŞI""",1,16878,"MUNICIPIUL BUCUREŞTI",179196,1371,991,821,169,1,977,14,1500,509,404,573
47,"SECTOR 6","#N/A",179196,,1153,"BUCUREŞTI SECTORUL 6 / ŞCOALA GIMNAZIALĂ ""CONSTANTIN BRÂNCUŞI""",1,16878,"MUNICIPIUL BUCUREŞTI",179196,1442,1142,899,205,38,1116,26,1600,458,485,631
47,"SECTOR 6","#N/A",179196,,1154,"BUCUREŞTI SECTORUL 6 / ŞCOALA GIMNAZIALĂ ""CONSTANTIN BRÂNCUŞI""",1,16878,"MUNICIPIUL BUCUREŞTI",179196,1217,887,756,130,1,873,14,1300,413,397,476
47,"SECTOR 6","#N/A",179196,,1155,"BUCUREŞTI SECTORUL 6 / ŞCOALA GIMNAZIALĂ ""CONSTANTIN BRÂNCUŞI""",1,16878,"MUNICIPIUL BUCUREŞTI",179196,1578,1112,987,124,1,1076,36,1700,588,510,566
47,"SECTOR 6","#N/A",179196,,1156,"BUCUREŞTI SECTORUL 6 / ŞCOALA GIMNAZIALĂ ""CONSTANTIN BRÂNCUŞI""",1,16878,"MUNICIPIUL BUCUREŞTI",179196,973,697,613,79,5,679,18,1100,403,299,380
47,"SECTOR 6","#N/A",179196,,1157,"BUCUREŞTI SECTORUL 6 / ŞCOALA GIMNAZIALĂ ""CONSTANTIN BRÂNCUŞI""",1,16878,"MUNICIPIUL BUCUREŞTI",179196,1036,729,666,61,2,713,16,1100,371,314,399
47,"SECTOR 6","#N/A",179196,,1158,"BUCUREŞTI SECTORUL 6 / ŞCOALA GIMNAZIALĂ ""REGELE MIHAI I""",1,16878,"MUNICIPIUL BUCUREŞTI",179196,1518,1144,941,202,1,1113,31,1600,456,455,658
47,"SECTOR 6","#N/A",179196,,1159,"BUCUREŞTI SECTORUL 6 / ŞCOALA GIMNAZIALĂ ""REGELE MIHAI I""",1,16878,"MUNICIPIUL BUCUREŞTI",179196,1329,878,786,92,0,865,13,1400,522,362,503
47,"SECTOR 6","#N/A",179196,,1160,"BUCUREŞTI SECTORUL 6 / ŞCOALA GIMNAZIALĂ ""REGELE MIHAI I""",1,16878,"MUNICIPIUL BUCUREŞTI",179196,856,603,503,100,0,585,18,1000,397,235,350
47,"SECTOR 6","#N/A",179196,,1161,"BUCUREŞTI SECTORUL 6 / ŞCOALA GIMNAZIALĂ ""REGELE MIHAI I""",1,16878,"MUNICIPIUL BUCUREŞTI",179196,1085,740,674,66,0,733,7,1200,460,329,404
47,"SECTOR 6","#N/A",179196,,1162,"BUCUREŞTI SECTORUL 6 / ŞCOALA GIMNAZIALĂ NR.156",1,16878,"MUNICIPIUL BUCUREŞTI",179196,1800,1436,1100,336,0,1405,31,1900,464,559,846
47,"SECTOR 6","#N/A",179196,,1163,"BUCUREŞTI SECTORUL 6 / ŞCOALA GIMNAZIALĂ NR.156",1,16878,"MUNICIPIUL BUCUREŞTI",179196,1545,1281,970,311,0,1253,28,1700,419,426,827
47,"SECTOR 6","#N/A",179196,,1164,"BUCUREŞTI SECTORUL 6 / ŞCOALA GIMNAZIALĂ NR.156",1,16878,"MUNICIPIUL BUCUREŞTI",179196,1641,1267,1039,228,0,1228,39,1800,533,515,713
47,"SECTOR 6","#N/A",179196,,1165,"BUCUREŞTI SECTORUL 6 / ŞCOALA GIMNAZIALĂ NR.156",1,16878,"MUNICIPIUL BUCUREŞTI",179196,1495,987,890,96,1,959,28,1600,613,373,586
47,"SECTOR 6","#N/A",179196,,1166,"BUCUREŞTI SECTORUL 6 / ŞCOALA GIMNAZIALĂ NR.156",1,16878,"MUNICIPIUL BUCUREŞTI",179196,1411,955,874,81,0,929,26,1500,545,405,524
47,"SECTOR 6","#N/A",179196,,1167,"BUCUREŞTI SECTORUL 6 / ŞCOALA GIMNAZIALĂ NR.156",1,16878,"MUNICIPIUL BUCUREŞTI",179196,1437,953,913,40,0,922,31,1601,648,420,502
47,"SECTOR 6","#N/A",179196,,1168,"BUCUREŞTI SECTORUL 6 / ŞCOALA GIMNAZIALĂ NR.156",1,16878,"MUNICIPIUL BUCUREŞTI",179196,1717,1131,1008,122,1,1113,18,1800,669,461,652
47,"SECTOR 6","#N/A",179196,,1169,"BUCUREŞTI SECTORUL 6 / ŞCOALA GIMNAZIALĂ NR.156",1,16878,"MUNICIPIUL BUCUREŞTI",179196,1597,1047,919,121,7,1030,17,1700,653,422,608
47,"SECTOR 6","#N/A",179196,,1170,"BUCUREŞTI SECTORUL 6 / ŞCOALA GIMNAZIALĂ NR.156",1,16878,"MUNICIPIUL BUCUREŞTI",179196,1492,967,866,101,0,949,18,1600,633,390,559
47,"SECTOR 6","#N/A",179196,,1171,"BUCUREŞTI SECTORUL 6 / ŞCOALA GIMNAZIALĂ NR.156",1,16878,"MUNICIPIUL BUCUREŞTI",179196,1873,1243,1142,100,1,1223,20,2800,1557,479,744
47,"SECTOR 6","#N/A",179196,,1172,"BUCUREŞTI SECTORUL 6 / LICEUL TEHNOLOGIC ""COSTIN C. KIRIŢESCU""",1,16878,"MUNICIPIUL BUCUREŞTI",179196,1280,896,732,163,1,879,17,1400,504,352,527
47,"SECTOR 6","#N/A",179196,,1173,"BUCUREŞTI SECTORUL 6 / LICEUL TEHNOLOGIC ""COSTIN C. KIRIŢESCU""",1,16878,"MUNICIPIUL BUCUREŞTI",179196,1351,927,819,108,0,902,25,1500,573,329,573
47,"SECTOR 6","#N/A",179196,,1174,"BUCUREŞTI SECTORUL 6 / LICEUL TEHNOLOGIC ""COSTIN C. KIRIŢESCU""",1,16878,"MUNICIPIUL BUCUREŞTI",179196,1364,938,808,129,1,902,36,1500,562,416,486
47,"SECTOR 6","#N/A",179196,,1175,"BUCUREŞTI SECTORUL 6 / LICEUL TEHNOLOGIC ""COSTIN C. KIRIŢESCU""",1,16878,"MUNICIPIUL BUCUREŞTI",179196,1417,882,812,69,1,861,21,1500,618,405,456
47,"SECTOR 6","#N/A",179196,,1176,"BUCUREŞTI SECTORUL 6 / LICEUL TEHNOLOGIC ""COSTIN C. KIRIŢESCU""",1,16878,"MUNICIPIUL BUCUREŞTI",179196,1534,1090,886,204,0,1066,24,1700,610,454,612
47,"SECTOR 6","#N/A",179196,,1177,"BUCUREŞTI SECTORUL 6 / LICEUL TEHNOLOGIC ""COSTIN C. KIRIŢESCU""",1,16878,"MUNICIPIUL BUCUREŞTI",179196,1182,838,719,118,1,823,15,1300,462,364,459
47,"SECTOR 6","#N/A",179196,,1178,"BUCUREŞTI SECTORUL 6 / LICEUL TEHNOLOGIC ""COSTIN C. KIRIŢESCU""",1,16878,"MUNICIPIUL BUCUREŞTI",179196,1233,898,807,90,1,883,15,1300,402,386,497
47,"SECTOR 6","#N/A",179196,,1179,"BUCUREŞTI SECTORUL 6 / LICEUL TEHNOLOGIC ""COSTIN C. KIRIŢESCU""",1,16878,"MUNICIPIUL BUCUREŞTI",179196,1102,790,700,89,1,779,11,1199,409,343,436
47,"SECTOR 6","#N/A",179196,,1180,"BUCUREŞTI SECTORUL 6 / LICEUL TEHNOLOGIC ""COSTIN C. KIRIŢESCU""",1,16878,"MUNICIPIUL BUCUREŞTI",179196,1645,1053,983,69,1,1033,20,1800,747,473,560
47,"SECTOR 6","#N/A",179196,,1181,"BUCUREŞTI SECTORUL 6 / LICEUL TEHNOLOGIC ""COSTIN C. KIRIŢESCU""",1,16878,"MUNICIPIUL BUCUREŞTI",179196,1866,1268,1197,70,1,1242,26,2000,732,526,716
47,"SECTOR 6","#N/A",179196,,1182,"BUCUREŞTI SECTORUL 6 / LICEUL TEHNOLOGIC ""COSTIN C. KIRIŢESCU""",1,16878,"MUNICIPIUL BUCUREŞTI",179196,1881,1200,1133,66,1,1175,25,1990,790,501,674
47,"SECTOR 6","#N/A",179196,,1183,"BUCUREŞTI SECTORUL 6 / ŞCOALA GIMNAZIALĂ NR.142",1,16878,"MUNICIPIUL BUCUREŞTI",179196,1316,820,708,112,0,801,19,1400,580,356,445
47,"SECTOR 6","#N/A",179196,,1184,"BUCUREŞTI SECTORUL 6 / ŞCOALA GIMNAZIALĂ NR.142",1,16878,"MUNICIPIUL BUCUREŞTI",179196,1478,1136,918,215,3,1112,24,1600,464,470,642
47,"SECTOR 6","#N/A",179196,,1185,"BUCUREŞTI SECTORUL 6 / ŞCOALA GIMNAZIALĂ NR.142",1,16878,"MUNICIPIUL BUCUREŞTI",179196,1547,1120,956,164,0,1096,24,1700,580,451,645
47,"SECTOR 6","#N/A",179196,,1186,"BUCUREŞTI SECTORUL 6 / ŞCOALA GIMNAZIALĂ NR.142",1,16878,"MUNICIPIUL BUCUREŞTI",179196,1656,1038,960,77,1,1010,28,1800,762,450,560
47,"SECTOR 6","#N/A",179196,,1187,"BUCUREŞTI SECTORUL 6 / ŞCOALA GIMNAZIALĂ NR.142",1,16878,"MUNICIPIUL BUCUREŞTI",179196,1438,935,790,144,1,912,23,1600,665,388,524
47,"SECTOR 6","#N/A",179196,,1188,"BUCUREŞTI SECTORUL 6 / ŞCOALA GIMNAZIALĂ NR.142",1,16878,"MUNICIPIUL BUCUREŞTI",179196,1860,1210,1035,173,2,1173,37,2000,790,491,682
47,"SECTOR 6","#N/A",179196,,1189,"BUCUREŞTI SECTORUL 6 / ŞCOALA GIMNAZIALĂ NR.142",1,16878,"MUNICIPIUL BUCUREŞTI",179196,1603,999,900,99,0,978,21,1700,701,368,610
47,"SECTOR 6","#N/A",179196,,1190,"BUCUREŞTI SECTORUL 6 / ŞCOALA GIMNAZIALĂ NR.142",1,16878,"MUNICIPIUL BUCUREŞTI",179196,1440,887,820,65,2,871,16,1600,713,424,447
47,"SECTOR 6","#N/A",179196,,1191,"BUCUREŞTI SECTORUL 6 / ŞCOALA GIMNAZIALĂ NR.142",1,16878,"MUNICIPIUL BUCUREŞTI",179196,1509,918,869,49,0,894,24,1600,682,359,535
47,"SECTOR 6","#N/A",179196,,1192,"BUCUREŞTI SECTORUL 6 / ŞCOALA GIMNAZIALĂ NR.117",1,16878,"MUNICIPIUL BUCUREŞTI",179196,1899,1240,1139,101,0,1219,21,2000,760,490,729
47,"SECTOR 6","#N/A",179196,,1193,"BUCUREŞTI SECTORUL 6 / ŞCOALA GIMNAZIALĂ NR.117",1,16878,"MUNICIPIUL BUCUREŞTI",179196,1547,1110,947,160,3,1079,31,1700,590,421,658
47,"SECTOR 6","#N/A",179196,,1194,"BUCUREŞTI SECTORUL 6 / ŞCOALA GIMNAZIALĂ NR.117",1,16878,"MUNICIPIUL BUCUREŞTI",179196,1396,1165,906,259,0,1138,27,1500,335,387,751
47,"SECTOR 6","#N/A",179196,,1195,"BUCUREŞTI SECTORUL 6 / ŞCOALA GIMNAZIALĂ NR.117",1,16878,"MUNICIPIUL BUCUREŞTI",179196,1837,1407,1081,326,0,1380,27,2000,593,519,861
47,"SECTOR 6","#N/A",179196,,1196,"BUCUREŞTI SECTORUL 6 / ŞCOALA GIMNAZIALĂ NR.117",1,16878,"MUNICIPIUL BUCUREŞTI",179196,1732,1160,925,235,0,1130,30,1900,740,488,642
47,"SECTOR 6","#N/A",179196,,1197,"BUCUREŞTI SECTORUL 6 / ŞCOALA GIMNAZIALĂ NR.117",1,16878,"MUNICIPIUL BUCUREŞTI",179196,1392,930,705,225,0,913,17,1500,570,402,511
47,"SECTOR 6","#N/A",179196,,1198,"BUCUREŞTI SECTORUL 6 / ŞCOALA GIMNAZIALĂ NR.117",1,16878,"MUNICIPIUL BUCUREŞTI",179196,1266,950,798,152,0,923,27,1400,450,366,557
47,"SECTOR 6","#N/A",179196,,1199,"BUCUREŞTI SECTORUL 6 / LICEUL TEORETIC ""TUDOR VLADIMIRESCU""",1,16878,"MUNICIPIUL BUCUREŞTI",179196,1351,1507,832,675,0,1463,44,1700,193,467,996
47,"SECTOR 6","#N/A",179196,,1200,"BUCUREŞTI SECTORUL 6 / LICEUL TEORETIC ""TUDOR VLADIMIRESCU""",1,16878,"MUNICIPIUL BUCUREŞTI",179196,1141,1151,686,465,0,1122,29,1600,449,352,770
47,"SECTOR 6","#N/A",179196,,1201,"BUCUREŞTI SECTORUL 6 / LICEUL TEORETIC ""TUDOR VLADIMIRESCU""",1,16878,"MUNICIPIUL BUCUREŞTI",179196,1458,1145,893,251,1,1119,26,1800,655,425,694
47,"SECTOR 6","#N/A",179196,,1202,"BUCUREŞTI SECTORUL 6 / LICEUL TEORETIC ""TUDOR VLADIMIRESCU""",1,16878,"MUNICIPIUL BUCUREŞTI",179196,991,1014,646,365,3,997,17,1400,386,348,649
47,"SECTOR 6","#N/A",179196,,1203,"BUCUREŞTI SECTORUL 6 / LICEUL TEORETIC ""TUDOR VLADIMIRESCU""",1,16878,"MUNICIPIUL BUCUREŞTI",179196,1351,1228,814,413,1,1199,29,1800,572,413,786
47,"SECTOR 6","#N/A",179196,,1204,"BUCUREŞTI SECTORUL 6 / CLUB SPORTIV ŞCOLAR NR.5",1,16878,"MUNICIPIUL BUCUREŞTI",179196,1668,1358,1019,289,50,1333,25,2000,642,446,887
47,"SECTOR 6","#N/A",179196,,1205,"BUCUREŞTI SECTORUL 6 / COLEGIUL UCECOM ""SPIRU HARET""",1,16878,"MUNICIPIUL BUCUREŞTI",179196,875,1652,333,1317,2,1621,31,2002,350,371,1250
47,"SECTOR 6","#N/A",179196,,1206,"BUCUREŞTI SECTORUL 6 / ŞCOALA GIMNAZIALĂ NR.168",1,16878,"MUNICIPIUL BUCUREŞTI",179196,1823,1568,1028,523,17,1542,26,2200,632,533,1009
47,"SECTOR 6","#N/A",179196,,1207,"BUCUREŞTI SECTORUL 6 / ŞCOALA GIMNAZIALĂ NR.168",1,16878,"MUNICIPIUL BUCUREŞTI",179196,1591,1249,851,353,45,1223,26,2000,751,440,783
47,"SECTOR 6","#N/A",179196,,1208,"BUCUREŞTI SECTORUL 6 / ŞCOALA GIMNAZIALĂ NR.168",1,16878,"MUNICIPIUL BUCUREŞTI",179196,1331,1155,762,393,0,1132,23,1800,645,357,775
47,"SECTOR 6","#N/A",179196,,1209,"BUCUREŞTI SECTORUL 6 / ŞCOALA GIMNAZIALĂ NR.168",1,16878,"MUNICIPIUL BUCUREŞTI",179196,1472,1334,831,503,0,1300,34,1900,566,436,864
47,"SECTOR 6","#N/A",179196,,1210,"BUCUREŞTI SECTORUL 6 / ŞCOALA GIMNAZIALĂ NR.168",1,16878,"MUNICIPIUL BUCUREŞTI",179196,1425,1123,728,395,0,1103,20,1900,777,354,749
47,"SECTOR 6","#N/A",179196,,1211,"BUCUREŞTI SECTORUL 6 / COLEGIUL TEHNIC ""CAROL I""",1,16878,"MUNICIPIUL BUCUREŞTI",179196,1808,1072,880,191,1,1041,31,1999,927,441,600
47,"SECTOR 6","#N/A",179196,,1212,"BUCUREŞTI SECTORUL 6 / COLEGIUL TEHNIC ""CAROL I""",1,16878,"MUNICIPIUL BUCUREŞTI",179196,1755,1216,992,223,1,1191,25,1900,684,479,712
47,"SECTOR 6","#N/A",179196,,1213,"BUCUREŞTI SECTORUL 6 / COLEGIUL TEHNIC ""CAROL I""",1,16878,"MUNICIPIUL BUCUREŞTI",179196,1957,1103,987,115,1,1073,29,2100,997,455,618
47,"SECTOR 6","#N/A",179196,,1214,"BUCUREŞTI SECTORUL 6 / COLEGIUL TEHNIC ""CAROL I""",1,16878,"MUNICIPIUL BUCUREŞTI",179196,1505,917,855,62,0,905,12,1600,683,394,511
47,"SECTOR 6","#N/A",179196,,1215,"BUCUREŞTI SECTORUL 6 / COLEGIUL TEHNIC ""CAROL I""",1,16878,"MUNICIPIUL BUCUREŞTI",179196,1278,898,770,128,0,878,20,1400,502,330,548
47,"SECTOR 6","#N/A",179196,,1216,"BUCUREŞTI SECTORUL 6 / COLEGIUL TEHNIC ""CAROL I""",1,16878,"MUNICIPIUL BUCUREŞTI",179196,1246,871,751,120,0,847,24,1401,530,333,514
47,"SECTOR 6","#N/A",179196,,1217,"BUCUREŞTI SECTORUL 6 / COLEGIUL TEHNIC ""CAROL I""",1,16878,"MUNICIPIUL BUCUREŞTI",179196,1444,952,862,89,1,930,22,1500,548,341,589
47,"SECTOR 6","#N/A",179196,,1218,"BUCUREŞTI SECTORUL 6 / COLEGIUL TEHNIC ""CAROL I""",1,16878,"MUNICIPIUL BUCUREŞTI",179196,1459,962,874,88,0,946,16,1600,638,385,561
47,"SECTOR 6","#N/A",179196,,1219,"BUCUREŞTI SECTORUL 6 / ŞCOALA GIMNAZIALĂ NR.163",1,16878,"MUNICIPIUL BUCUREŞTI",179196,1791,1128,1004,124,0,1108,20,1900,772,461,647
47,"SECTOR 6","#N/A",179196,,1220,"BUCUREŞTI SECTORUL 6 / ŞCOALA GIMNAZIALĂ NR.163",1,16878,"MUNICIPIUL BUCUREŞTI",179196,1743,1130,965,165,0,1107,23,1900,770,434,673
47,"SECTOR 6","#N/A",179196,,1221,"BUCUREŞTI SECTORUL 6 / ŞCOALA GIMNAZIALĂ NR.163",1,16878,"MUNICIPIUL BUCUREŞTI",179196,1313,810,709,101,0,782,28,1400,590,299,483
47,"SECTOR 6","#N/A",179196,,1222,"BUCUREŞTI SECTORUL 6 / ŞCOALA GIMNAZIALĂ NR.163",1,16878,"MUNICIPIUL BUCUREŞTI",179196,1175,753,694,59,0,738,15,1300,547,297,441
47,"SECTOR 6","#N/A",179196,,1223,"BUCUREŞTI SECTORUL 6 / ŞCOALA GIMNAZIALĂ NR.163",1,16878,"MUNICIPIUL BUCUREŞTI",179196,1322,790,754,36,0,765,25,1400,610,353,412
47,"SECTOR 6","#N/A",179196,,1224,"BUCUREŞTI SECTORUL 6 / ŞCOALA GIMNAZIALĂ NR.163",1,16878,"MUNICIPIUL BUCUREŞTI",179196,1334,845,784,61,0,824,21,1400,555,355,469
47,"SECTOR 6","#N/A",179196,,1225,"BUCUREŞTI SECTORUL 6 / ŞCOALA GIMNAZIALĂ NR.163",1,16878,"MUNICIPIUL BUCUREŞTI",179196,1467,910,868,41,1,893,17,1600,690,404,489
47,"SECTOR 6","#N/A",179196,,1226,"BUCUREŞTI SECTORUL 6 / ŞCOALA GIMNAZIALĂ NR.163",1,16878,"MUNICIPIUL BUCUREŞTI",179196,1211,731,701,29,1,712,19,1300,569,339,373
47,"SECTOR 6","#N/A",179196,,1227,"BUCUREŞTI SECTORUL 6 / ŞCOALA GIMNAZIALĂ NR.163",1,16878,"MUNICIPIUL BUCUREŞTI",179196,1281,795,763,31,1,778,17,1400,605,348,430
47,"SECTOR 6","#N/A",179196,,1228,"BUCUREŞTI SECTORUL 6 / LICEUL TEORETIC ""MARIN PREDA""",1,16878,"MUNICIPIUL BUCUREŞTI",179196,1764,1014,925,89,0,987,27,1900,886,400,587
47,"SECTOR 6","#N/A",179196,,1229,"BUCUREŞTI SECTORUL 6 / LICEUL TEORETIC ""MARIN PREDA""",1,16878,"MUNICIPIUL BUCUREŞTI",179196,1412,963,779,183,1,928,35,1501,538,393,535
47,"SECTOR 6","#N/A",179196,,1230,"BUCUREŞTI SECTORUL 6 / LICEUL TEORETIC ""MARIN PREDA""",1,16878,"MUNICIPIUL BUCUREŞTI",179196,1054,786,664,121,1,765,21,1200,414,287,478
47,"SECTOR 6","#N/A",179196,,1231,"BUCUREŞTI SECTORUL 6 / LICEUL TEORETIC ""MARIN PREDA""",1,16878,"MUNICIPIUL BUCUREŞTI",179196,1564,941,865,76,0,915,26,1700,759,392,523
47,"SECTOR 6","#N/A",179196,,1232,"BUCUREŞTI SECTORUL 6 / ŞCOALA GIMNAZIALĂ NR.167",1,16878,"MUNICIPIUL BUCUREŞTI",179196,1430,806,673,133,0,794,12,1500,694,322,472
47,"SECTOR 6","#N/A",179196,,1233,"BUCUREŞTI SECTORUL 6 / ŞCOALA GIMNAZIALĂ NR.167",1,16878,"MUNICIPIUL BUCUREŞTI",179196,1662,979,836,143,0,952,27,1800,821,410,542
47,"SECTOR 6","#N/A",179196,,1234,"BUCUREŞTI SECTORUL 6 / ŞCOALA GIMNAZIALĂ NR.167",1,16878,"MUNICIPIUL BUCUREŞTI",179196,1307,909,755,151,3,888,21,1400,491,362,526
47,"SECTOR 6","#N/A",179196,,1235,"BUCUREŞTI SECTORUL 6 / ŞCOALA GIMNAZIALĂ NR.167",1,16878,"MUNICIPIUL BUCUREŞTI",179196,1160,743,601,142,0,727,16,1300,557,333,394
47,"SECTOR 6","#N/A",179196,,1236,"BUCUREŞTI SECTORUL 6 / ŞCOALA GIMNAZIALĂ NR.167",1,16878,"MUNICIPIUL BUCUREŞTI",179196,1742,1142,1022,120,0,1126,16,1784,642,408,718
47,"SECTOR 6","#N/A",179196,,1237,"BUCUREŞTI SECTORUL 6 / ŞCOALA GIMNAZIALĂ NR.167",1,16878,"MUNICIPIUL BUCUREŞTI",179196,1714,1115,958,157,0,1091,24,1800,685,418,673
47,"SECTOR 6","#N/A",179196,,1238,"BUCUREŞTI SECTORUL 6 / ŞCOALA GIMNAZIALĂ NR.167",1,16878,"MUNICIPIUL BUCUREŞTI",179196,1154,826,650,176,0,805,21,1300,474,262,543
47,"SECTOR 6","#N/A",179196,,1239,"BUCUREŞTI SECTORUL 6 / ŞCOALA GIMNAZIALĂ NR.167",1,16878,"MUNICIPIUL BUCUREŞTI",179196,1264,821,709,112,0,802,19,1400,579,321,481
47,"SECTOR 6","#N/A",179196,,1240,"BUCUREŞTI SECTORUL 6 / ŞCOALA GIMNAZIALĂ NR.167",1,16878,"MUNICIPIUL BUCUREŞTI",179196,1474,888,842,46,0,864,24,1600,712,345,519
47,"SECTOR 6","#N/A",179196,,1241,"BUCUREŞTI SECTORUL 6 / ŞCOALA GIMNAZIALĂ NR.162",1,16878,"MUNICIPIUL BUCUREŞTI",179196,1058,665,630,35,0,649,16,1200,535,286,363
47,"SECTOR 6","#N/A",179196,,1242,"BUCUREŞTI SECTORUL 6 / ŞCOALA GIMNAZIALĂ NR.162",1,16878,"MUNICIPIUL BUCUREŞTI",179196,1239,785,713,71,1,765,20,1300,515,369,396
47,"SECTOR 6","#N/A",179196,,1243,"BUCUREŞTI SECTORUL 6 / ŞCOALA GIMNAZIALĂ NR.153",1,16878,"MUNICIPIUL BUCUREŞTI",179196,1776,894,832,62,0,881,13,1900,1006,465,416
47,"SECTOR 6","#N/A",179196,,1244,"BUCUREŞTI SECTORUL 6 / ŞCOALA GIMNAZIALĂ NR.153",1,16878,"MUNICIPIUL BUCUREŞTI",179196,1417,734,672,62,0,720,14,1500,766,344,376
47,"SECTOR 6","#N/A",179196,,1245,"BUCUREŞTI SECTORUL 6 / ŞCOALA GIMNAZIALĂ NR.161",1,16878,"MUNICIPIUL BUCUREŞTI",179196,2009,1017,946,71,0,1004,13,2100,1083,511,493
48,"STRĂINĂTATE",,,"AF",1,"Kabul 1",0,1,"Afganistan",1,0,47,0,47,0,47,0,300,253,9,38
48,"STRĂINĂTATE",,,"AF",2,"Kabul 2",0,1,"Afganistan",1,0,162,0,162,0,158,4,300,138,37,121
48,"STRĂINĂTATE",,,"AF",3,"Kandahar",0,1,"Afganistan",1,0,164,0,164,0,162,2,300,136,38,124
48,"STRĂINĂTATE",,,"ZA",4,"Pretoria",0,4,"Africa de Sud",2,0,105,0,105,0,105,0,401,296,17,88
48,"STRĂINĂTATE",,,"ZA",5,"Cape Town",0,4,"Africa de Sud",2,0,51,0,51,0,51,0,400,349,8,43
48,"STRĂINĂTATE",,,"AL",6,"Tirana",0,6,"Albania",3,0,68,0,68,0,66,2,400,332,17,49
48,"STRĂINĂTATE",,,"DZ",7,"Alger",0,7,"Algeria",4,0,64,0,64,0,64,0,400,336,19,45
48,"STRĂINĂTATE",,,"AO",8,"Luanda",0,8,"Republica Angola",5,0,35,0,35,0,35,0,200,165,8,27
48,"STRĂINĂTATE",,,"SA",9,"Riad",0,9,"Arabia Saudita",6,0,171,0,171,0,169,2,400,229,23,146
48,"STRĂINĂTATE",,,"AR",10,"Buenos Aires",0,10,"Argentina",7,0,42,0,42,0,41,1,399,357,7,34
48,"STRĂINĂTATE",,,"AM",11,"Erevan",0,11,"Armenia",8,0,24,0,24,0,24,0,200,176,8,16
48,"STRĂINĂTATE",,,"AU",12,"Canberra",0,12,"Australia",9,0,53,0,53,0,53,0,801,748,5,48
48,"STRĂINĂTATE",,,"AU",13,"Sydney",0,12,"Australia",9,0,353,0,353,0,351,2,1200,847,39,312
48,"STRĂINĂTATE",,,"AU",14,"Brisbane",0,12,"Australia",9,0,233,0,233,0,233,0,800,567,13,220
48,"STRĂINĂTATE",,,"AU",15,"Melbourne",0,12,"Australia",9,0,587,0,587,0,584,3,2000,1413,35,549
48,"STRĂINĂTATE",,,"AU",16,"Perth",0,12,"Australia",9,0,280,0,280,0,278,2,1200,920,22,256
48,"STRĂINĂTATE",,,"AT",17,"Viena 1",0,17,"Austria",10,0,3281,0,3281,0,3271,10,4799,1518,198,3073
48,"STRĂINĂTATE",,,"AT",18,"Viena 2",0,17,"Austria",10,0,3594,0,3594,0,3578,16,4800,1206,233,3345
48,"STRĂINĂTATE",,,"AT",19,"Graz",0,17,"Austria",10,0,2690,0,2690,0,2684,3,4000,1310,129,2555
48,"STRĂINĂTATE",,,"AZ",20,"Baku",0,20,"Azerbaidjan",11,0,122,0,122,0,121,1,198,76,13,108
48,"STRĂINĂTATE",,,"BY",21,"Minsk",0,21,"Republica Belarus",12,0,22,0,22,0,22,0,200,178,5,17
48,"STRĂINĂTATE",,,"BE",22,"Bruxelles 1",0,24,"Belgia",13,0,3390,0,3390,0,3386,4,5200,1810,181,3205
48,"STRĂINĂTATE",,,"BE",23,"Bruxelles 2",0,24,"Belgia",13,0,3421,0,3421,0,3407,14,5200,1779,230,3177
48,"STRĂINĂTATE",,,"BE",24,"Bruxelles 3",0,24,"Belgia",13,0,3446,0,3446,0,3429,17,5199,1753,248,3181
48,"STRĂINĂTATE",,,"BE",25,"Bruxelles 4",0,24,"Belgia",13,0,2825,0,2825,0,2818,7,4800,1975,159,2659
48,"STRĂINĂTATE",,,"BA",26,"Sarajevo",0,26,"Bosnia Herţegovina",14,0,74,0,74,0,71,3,801,727,11,60
48,"STRĂINĂTATE",,,"BR",27,"Brasilia",0,27,"Brazilia",15,0,10,0,10,0,10,0,200,190,6,4
48,"STRĂINĂTATE",,,"BR",28,"Rio de Janeiro",0,27,"Brazilia",15,0,43,0,43,0,43,0,200,157,4,39
48,"STRĂINĂTATE",,,"BG",29,"Sofia",0,29,"Republica Bulgaria",16,0,273,0,273,0,269,4,2800,2527,51,218
48,"STRĂINĂTATE",,,"CA",30,"Ottawa",0,30,"Canada",17,0,597,0,597,0,597,0,2401,1804,54,543
48,"STRĂINĂTATE",,,"CA",31,"Montreal",0,30,"Canada",17,0,2070,0,2070,0,2066,4,3600,1530,122,1944
48,"STRĂINĂTATE",,,"CA",32,"Toronto",0,30,"Canada",17,0,2753,0,2753,0,2751,2,3600,847,183,2568
48,"STRĂINĂTATE",,,"CA",33,"Vancouver",0,30,"Canada",17,0,1079,0,1079,0,1076,3,2000,921,64,1012
48,"STRĂINĂTATE",,,"CZ",34,"Praga",0,34,"Republica Cehă",18,0,1431,0,1431,0,1420,11,3200,1769,148,1272
48,"STRĂINĂTATE",,,"CZ",35,"Brno",0,34,"Republica Cehă",18,0,519,0,519,0,513,6,2000,1481,49,464
48,"STRĂINĂTATE",,,"CL",36,"Santiago de Chile",0,36,"Chile",19,0,60,0,60,0,60,0,400,340,5,55
48,"STRĂINĂTATE",,,"CL",37,"Copiapo",0,36,"Chile",19,0,47,0,47,0,46,1,405,358,10,36
48,"STRĂINĂTATE",,,"CN",38,"Beijing",0,38,"Republica Chineză",20,0,160,0,160,0,153,7,800,640,61,92
48,"STRĂINĂTATE",,,"CN",39,"Shanghai",0,38,"Republica Chineză",20,0,210,0,210,0,206,4,801,591,22,184
48,"STRĂINĂTATE",,,"CN",40,"Hong Kong",0,38,"Republica Chineză",20,0,108,0,108,0,107,1,401,293,12,95
48,"STRĂINĂTATE",,,"CY",41,"Nicosia",0,41,"Cipru",21,0,1946,0,1946,0,1938,8,3200,1254,366,1572
48,"STRĂINĂTATE",,,"CY",42,"Limassol",0,41,"Cipru",21,0,1674,0,1674,0,1661,13,3200,1526,290,1371
48,"STRĂINĂTATE",,,"CY",43,"Larnaca",0,41,"Cipru",21,0,871,0,871,0,865,6,2800,1929,183,682
48,"STRĂINĂTATE",,,"CO",44,"Bogota",0,44,"Columbia",22,0,38,0,38,0,38,0,400,362,7,31
48,"STRĂINĂTATE",,,"KP",45,"Phenian",0,45,"R.P.D. Coreeană (Coreea de Nord)",23,0,9,0,9,0,9,0,100,91,3,6
48,"STRĂINĂTATE",,,"KR",46,"Seul",0,46,"Republica Coreea (Coreea de Sud)",24,0,89,0,89,0,88,1,400,311,7,81
48,"STRĂINĂTATE",,,"HR",47,"Zagreb",0,47,"Croaţia",25,0,105,0,105,0,103,2,2000,1895,15,88
48,"STRĂINĂTATE",,,"CU",48,"Havana",0,48,"Cuba",26,0,36,0,36,0,36,0,400,364,14,22
48,"STRĂINĂTATE",,,"DK",49,"Copenhaga",0,49,"Danemarca",27,0,2369,0,2369,0,2367,2,4000,1631,138,2229
48,"STRĂINĂTATE",,,"DK",50,"Ikast",0,49,"Danemarca",27,0,2454,0,2454,0,2446,8,2800,346,96,2350
48,"STRĂINĂTATE",,,"EG",51,"Cairo",0,51,"Egipt",28,0,119,0,119,0,118,1,800,681,19,99
48,"STRĂINĂTATE",,,"CH",52,"Berna",0,52,"Elveţia",29,0,2069,0,2069,0,2065,4,3200,1131,108,1957
48,"STRĂINĂTATE",,,"CH",53,"Geneva",0,52,"Elveţia",29,0,1705,0,1705,0,1693,12,3200,1495,146,1547
48,"STRĂINĂTATE",,,"AE",54,"Abu Dhabi",0,54,"Emiratele Arabe Unite",30,0,766,0,766,0,753,13,1200,434,83,670
48,"STRĂINĂTATE",,,"AE",55,"Dubai",0,54,"Emiratele Arabe Unite",30,0,1570,0,1570,0,1567,3,2000,430,146,1421
48,"STRĂINĂTATE",,,"ET",56,"Addis Abeba",0,56,"Etiopia",31,0,18,0,18,0,15,3,200,182,3,12
48,"STRĂINĂTATE",,,"PH",57,"Manila",0,57,"Filipine",32,0,71,0,71,0,71,0,199,128,5,66
48,"STRĂINĂTATE",,,"FI",58,"Helsinki",0,58,"Finlanda",33,0,603,0,603,0,599,4,1600,997,56,543
48,"STRĂINĂTATE",,,"FI",59,"Tampere",0,58,"Finlanda",33,0,157,0,157,0,157,0,1200,1043,8,149
48,"STRĂINĂTATE",,,"FR",60,"Paris 1",0,60,"Franţa",34,0,4150,0,4150,0,4142,8,7999,3849,153,3989
48,"STRĂINĂTATE",,,"FR",61,"Paris 2",0,60,"Franţa",34,0,3528,0,3528,0,3503,25,8000,4472,142,3361
48,"STRĂINĂTATE",,,"FR",62,"Brest",0,60,"Franţa",34,0,512,0,512,0,512,0,2000,1488,69,443
48,"STRĂINĂTATE",,,"FR",63,"Bordeaux",0,60,"Franţa",34,0,950,0,950,0,947,3,2800,1850,88,859
48,"STRĂINĂTATE",,,"FR",64,"Lyon",0,60,"Franţa",34,0,1695,0,1695,0,1683,12,3200,1505,180,1503
48,"STRĂINĂTATE",,,"FR",65,"Marsilia",0,60,"Franţa",34,0,1486,0,1486,0,1471,15,2800,1314,147,1324
48,"STRĂINĂTATE",,,"FR",66,"Toulouse",0,60,"Franţa",34,0,886,0,886,0,886,0,2800,1914,82,804
48,"STRĂINĂTATE",,,"FR",67,"Strasbourg",0,60,"Franţa",34,0,2426,0,2426,0,2422,4,3600,1174,112,2310
48,"STRĂINĂTATE",,,"FR",68,"Nancy",0,60,"Franţa",34,0,491,0,491,0,487,4,2400,1909,76,411
48,"STRĂINĂTATE",,,"GE",69,"Tbilisi",0,69,"Georgia",35,0,82,0,82,0,82,0,398,316,13,69
48,"STRĂINĂTATE",,,"DE",70,"Berlin",0,72,"Republica Federală Germania",36,0,2974,0,2974,0,2963,11,4997,2023,240,2723
48,"STRĂINĂTATE",,,"DE",71,"Hamburg",0,72,"Republica Federală Germania",36,0,2563,0,2563,0,2553,10,4000,1437,126,2427
48,"STRĂINĂTATE",,,"DE",72,"Bonn",0,72,"Republica Federală Germania",36,0,4349,0,4349,0,4334,15,6000,1651,125,4209
48,"STRĂINĂTATE",,,"DE",73,"Munchen",0,72,"Republica Federală Germania",36,0,4045,0,4045,0,4037,8,5988,1943,86,3951
48,"STRĂINĂTATE",,,"DE",74,"Stuttgart",0,72,"Republica Federală Germania",36,0,3624,0,3624,0,3619,5,6000,2376,113,3506
48,"STRĂINĂTATE",,,"GR",75,"Atena",0,75,"Grecia",37,0,2909,0,2909,0,2895,14,4399,1490,371,2524
48,"STRĂINĂTATE",,,"GR",76,"Salonic",0,75,"Grecia",37,0,348,0,348,0,347,1,2401,2053,62,285
48,"STRĂINĂTATE",,,"GR",77,"Patra",0,75,"Grecia",37,0,184,0,184,0,183,1,2401,2217,54,129
48,"STRĂINĂTATE",,,"IN",78,"New Delhi",0,78,"India",38,0,65,0,65,0,65,0,400,335,8,57
48,"STRĂINĂTATE",,,"ID",79,"Jakarta",0,79,"Republica Indonezia",39,0,38,0,38,0,37,1,399,361,10,27
48,"STRĂINĂTATE",,,"JO",80,"Amman",0,80,"Iordania",40,0,222,0,222,0,221,1,800,578,66,155
48,"STRĂINĂTATE",,,"IQ",81,"Bagdad",0,81,"Irak",41,0,25,0,25,0,25,0,400,375,14,11
48,"STRĂINĂTATE",,,"IQ",82,"Erbil",0,81,"Irak",41,0,168,0,168,0,165,3,600,432,36,129
48,"STRĂINĂTATE",,,"IR",83,"Teheran",0,83,"Republica Islamică Iran",42,0,51,0,51,0,51,0,400,349,17,34
48,"STRĂINĂTATE",,,"IE",84,"Dublin",0,84,"Irlanda",43,0,3722,0,3722,0,3718,4,7201,3479,158,3560
48,"STRĂINĂTATE",,,"IL",85,"Tel Aviv",0,85,"Israel",44,0,663,0,663,0,663,0,2400,1737,155,508
48,"STRĂINĂTATE",,,"IL",86,"Ierusalim",0,85,"Israel",44,0,419,0,419,0,414,5,2000,1581,161,253
48,"STRĂINĂTATE",,,"IL",87,"Haifa",0,85,"Israel",44,0,359,0,359,0,359,0,2000,1641,53,306
48,"STRĂINĂTATE",,,"IT",88,"Roma 1",0,96,"Italia",45,0,2992,0,2992,0,2985,7,6001,3009,363,2622
48,"STRĂINĂTATE",,,"IT",89,"Roma 2",0,96,"Italia",45,0,2699,0,2699,0,2689,10,6001,3302,267,2422
48,"STRĂINĂTATE",,,"IT",90,"Roma 3",0,96,"Italia",45,0,2996,0,2996,0,2983,13,5200,2204,398,2585
48,"STRĂINĂTATE",,,"IT",91,"Frosinone",0,96,"Italia",45,0,1623,0,1623,0,1618,5,2401,778,236,1382
48,"STRĂINĂTATE",,,"IT",92,"Ladispoli",0,96,"Italia",45,0,3163,0,3163,0,3158,5,3601,438,298,2860
48,"STRĂINĂTATE",,,"IT",93,"Palestrina",0,96,"Italia",45,0,2647,0,2647,0,2641,6,3601,954,265,2376
48,"STRĂINĂTATE",,,"IT",94,"Tivoli",0,96,"Italia",45,0,2348,0,2348,0,2343,5,3601,1253,244,2099
48,"STRĂINĂTATE",,,"IT",95,"Napoli",0,96,"Italia",45,0,929,0,929,0,924,5,2400,1471,136,788
48,"STRĂINĂTATE",,,"IT",96,"Perugia",0,96,"Italia",45,0,1979,0,1979,0,1977,2,2801,822,193,1784
48,"STRĂINĂTATE",,,"IT",97,"Pescara",0,96,"Italia",45,0,1746,0,1746,0,1736,10,2801,1055,348,1388
48,"STRĂINĂTATE",,,"IT",98,"Cagliari",0,96,"Italia",45,0,555,0,555,0,553,1,2401,1846,131,422
48,"STRĂINĂTATE",,,"IT",99,"Ostia",0,96,"Italia",45,0,2464,0,2464,0,2455,9,3601,1137,277,2178
48,"STRĂINĂTATE",,,"IT",100,"Bologna",0,96,"Italia",45,0,3500,0,3500,0,3491,9,4100,600,251,3240
48,"STRĂINĂTATE",,,"IT",101,"Florenta",0,96,"Italia",45,0,2976,0,2976,0,2970,6,3600,624,382,2588
48,"STRĂINĂTATE",,,"IT",102,"Arezzo",0,96,"Italia",45,0,2176,0,2176,0,2164,12,2800,624,344,1820
48,"STRĂINĂTATE",,,"IT",103,"Grosseto",0,96,"Italia",45,0,1128,0,1128,0,1125,3,2400,1272,224,901
48,"STRĂINĂTATE",,,"IT",104,"Livorno",0,96,"Italia",45,0,1477,0,1477,0,1465,12,2800,1323,185,1280
48,"STRĂINĂTATE",,,"IT",105,"Ancona",0,96,"Italia",45,0,1620,0,1620,0,1614,6,2300,680,191,1423
48,"STRĂINĂTATE",,,"IT",106,"Milano 1",0,96,"Italia",45,0,2436,0,2436,0,2431,5,4000,1564,320,2111
48,"STRĂINĂTATE",,,"IT",107,"Milano 2",0,96,"Italia",45,0,2898,0,2898,0,2888,10,4400,1502,273,2615
48,"STRĂINĂTATE",,,"IT",108,"Brescia",0,96,"Italia",45,0,2902,0,2902,0,2895,7,3600,698,261,2634
48,"STRĂINĂTATE",,,"IT",109,"Bergamo",0,96,"Italia",45,0,2558,0,2558,0,2553,5,3600,1042,262,2291
48,"STRĂINĂTATE",,,"IT",110,"Mantova",0,96,"Italia",45,0,2172,0,2172,0,2169,3,2801,629,141,2028
48,"STRĂINĂTATE",,,"IT",111,"Trento",0,96,"Italia",45,0,2460,0,2460,0,2449,11,3600,1140,274,2175
48,"STRĂINĂTATE",,,"IT",112,"Trieste 1",0,96,"Italia",45,0,699,0,699,0,697,2,1601,902,123,574
48,"STRĂINĂTATE",,,"IT",113,"Trieste 2",0,96,"Italia",45,0,513,0,513,0,510,3,2400,1887,77,433
48,"STRĂINĂTATE",,,"IT",114,"Venetia",0,96,"Italia",45,0,1680,0,1680,0,1676,4,2000,320,187,1489
48,"STRĂINĂTATE",,,"IT",115,"Treviso",0,96,"Italia",45,0,2682,0,2682,0,2679,3,3600,918,129,2550
48,"STRĂINĂTATE",,,"IT",116,"Verona",0,96,"Italia",45,0,3842,0,3842,0,3830,12,4800,958,283,3547
48,"STRĂINĂTATE",,,"IT",117,"Padova",0,96,"Italia",45,0,4246,0,4246,0,4244,2,4801,555,388,3856
48,"STRĂINĂTATE",,,"IT",118,"Udine",0,96,"Italia",45,0,2944,0,2944,0,2936,8,3599,655,268,2668
48,"STRĂINĂTATE",,,"IT",119,"Torino",0,96,"Italia",45,0,3647,0,3647,0,3642,5,7200,3553,371,3271
48,"STRĂINĂTATE",,,"IT",120,"Alessandria",0,96,"Italia",45,0,2444,0,2444,0,2439,5,2800,356,239,2200
48,"STRĂINĂTATE",,,"IT",121,"Cuneo",0,96,"Italia",45,0,2330,0,2330,0,2326,4,2800,470,295,2031
48,"STRĂINĂTATE",,,"IT",122,"Novara",0,96,"Italia",45,0,892,0,892,0,883,9,2650,1758,115,768
48,"STRĂINĂTATE",,,"IT",123,"Vercelli",0,96,"Italia",45,0,1877,0,1877,0,1871,6,2400,523,150,1721
48,"STRĂINĂTATE",,,"IT",124,"Aosta",0,96,"Italia",45,0,1205,0,1205,0,1198,7,2400,1195,113,1085
48,"STRĂINĂTATE",,,"IT",125,"Genova",0,96,"Italia",45,0,1298,0,1298,0,1292,6,2800,1502,171,1121
48,"STRĂINĂTATE",,,"IT",126,"La Spezia",0,96,"Italia",45,0,1620,0,1620,0,1620,0,2800,1180,128,1492
48,"STRĂINĂTATE",,,"IT",127,"Sanremo",0,96,"Italia",45,0,1538,0,1538,0,1522,16,2801,1263,143,1379
48,"STRĂINĂTATE",,,"IT",128,"Catania",0,96,"Italia",45,0,1172,0,1172,0,1160,12,2800,1628,296,864
48,"STRĂINĂTATE",,,"IT",129,"Canicatti",0,96,"Italia",45,0,492,0,492,0,489,3,2400,1908,168,321
48,"STRĂINĂTATE",,,"IT",130,"Reggio di Calabria",0,96,"Italia",45,0,544,0,544,0,541,3,2401,1857,99,442
48,"STRĂINĂTATE",,,"IT",131,"Bari",0,96,"Italia",45,0,634,0,634,0,630,4,2799,2165,124,506
48,"STRĂINĂTATE",,,"IT",132,"Foggia",0,96,"Italia",45,0,427,0,427,0,426,1,2801,2374,107,319
48,"STRĂINĂTATE",,,"IT",133,"Varese",0,96,"Italia",45,0,1217,0,1217,0,1208,9,2800,1583,195,1013
48,"STRĂINĂTATE",,,"IT",134,"Sondrio",0,96,"Italia",45,0,136,0,136,0,136,0,2000,1864,13,123
48,"STRĂINĂTATE",,,"IT",135,"Lecco",0,96,"Italia",45,0,1525,0,1525,0,1516,9,2800,1275,183,1333
48,"STRĂINĂTATE",,,"IT",136,"Como",0,96,"Italia",45,0,1529,0,1529,0,1524,5,2800,1271,166,1358
48,"STRĂINĂTATE",,,"IT",137,"Fermo",0,96,"Italia",45,0,814,0,814,0,810,4,2400,1586,134,676
48,"STRĂINĂTATE",,,"IT",138,"Cosenza",0,96,"Italia",45,0,520,0,520,0,519,1,2400,1880,92,427
48,"STRĂINĂTATE",,,"JP",139,"Tokyo",0,139,"Japonia",46,0,277,0,277,0,276,1,800,523,34,242
48,"STRĂINĂTATE",,,"KZ",140,"Astana",0,140,"Kazahstan",47,0,20,0,20,0,19,1,201,181,4,15
48,"STRĂINĂTATE",,,"KE",141,"Nairobi",0,141,"Kenya",48,0,37,0,37,0,36,1,200,163,2,34
48,"STRĂINĂTATE",,,"KW",142,"Kuweit City",0,142,"Kuweit",49,0,297,0,297,0,294,3,800,503,63,231
48,"STRĂINĂTATE",,,"LV",143,"Riga",0,143,"Letonia",50,0,53,0,53,0,52,1,600,547,7,45
48,"STRĂINĂTATE",,,"LB",144,"Beirut",0,144,"Liban",51,0,204,0,204,0,204,0,600,396,74,130
48,"STRĂINĂTATE",,,"LT",145,"Vilnius",0,145,"Lituania",52,0,52,0,52,0,52,0,600,548,7,45
48,"STRĂINĂTATE",,,"LU",146,"Luxemburg",0,146,"Luxemburg",53,0,2433,0,2433,0,2419,14,3600,1167,218,2201
48,"STRĂINĂTATE",,,"MK",147,"Skopje",0,147,"Macedonia",54,0,63,0,63,0,63,0,800,737,16,47
48,"STRĂINĂTATE",,,"MY",148,"Kuala Lumpur",0,148,"Malaezia",55,0,93,0,93,0,92,1,399,306,6,86
48,"STRĂINĂTATE",,,"MT",149,"La Valletta",0,149,"Malta",56,0,531,0,531,0,525,6,2001,1470,67,458
48,"STRĂINĂTATE",,,"GB",150,"Londra 1",0,156,"Marea Britanie",57,0,4626,0,4626,0,4615,11,6000,1374,177,4438
48,"STRĂINĂTATE",,,"GB",151,"Londra 2",0,156,"Marea Britanie",57,0,3914,0,3914,0,3903,11,6000,2086,185,3718
48,"STRĂINĂTATE",,,"GB",152,"Londra 3",0,156,"Marea Britanie",57,0,4269,0,4269,0,4264,5,6000,1731,119,4145
48,"STRĂINĂTATE",,,"GB",153,"Edinburgh",0,156,"Marea Britanie",57,0,1287,0,1287,0,1279,8,2800,1513,79,1200
48,"STRĂINĂTATE",,,"GB",154,"Newcastle",0,156,"Marea Britanie",57,0,704,0,704,0,700,4,2401,1697,68,632
48,"STRĂINĂTATE",,,"GB",155,"Leeds",0,156,"Marea Britanie",57,0,1604,0,1604,0,1588,16,2801,1197,152,1436
48,"STRĂINĂTATE",,,"GB",156,"Liverpool",0,156,"Marea Britanie",57,0,1254,0,1254,0,1242,12,2800,1546,88,1154
48,"STRĂINĂTATE",,,"GB",157,"Birmingham",0,156,"Marea Britanie",57,0,2583,0,2583,0,2569,14,2800,217,147,2422
48,"STRĂINĂTATE",,,"GB",158,"Portsmouth",0,156,"Marea Britanie",57,0,2106,0,2106,0,2100,6,2800,694,74,2026
48,"STRĂINĂTATE",,,"GB",159,"Bristol",0,156,"Marea Britanie",57,0,2073,0,2073,0,2061,12,2801,728,96,1965
48,"STRĂINĂTATE",,,"GB",160,"Belfast",0,156,"Marea Britanie",57,0,1540,0,1540,0,1529,11,2402,862,132,1397
48,"STRĂINĂTATE",,,"MA",161,"Rabat",0,161,"Maroc",58,0,130,0,130,0,129,1,402,272,18,111
48,"STRĂINĂTATE",,,"MX",162,"Mexic",0,162,"Mexic",59,0,92,0,92,0,91,1,400,308,17,74
48,"STRĂINĂTATE",,,"MD",163,"Chisinau 1",0,168,"Republica Moldova",60,0,2804,0,2804,0,2803,1,6750,3946,323,2480
48,"STRĂINĂTATE",,,"MD",164,"Chisinau 2",0,168,"Republica Moldova",60,0,2990,0,2990,0,2982,8,6750,3760,407,2575
48,"STRĂINĂTATE",,,"MD",165,"Chisinau 3",0,168,"Republica Moldova",60,0,2952,0,2952,0,2948,4,6750,3798,390,2558
48,"STRĂINĂTATE",,,"MD",166,"Chisinau 4",0,168,"Republica Moldova",60,0,3005,0,3005,0,2996,9,6750,3745,270,2726
48,"STRĂINĂTATE",,,"MD",167,"Orhei",0,168,"Republica Moldova",60,0,2697,0,2697,0,2689,8,4350,1653,780,1909
48,"STRĂINĂTATE",,,"MD",168,"Nisporeni",0,168,"Republica Moldova",60,0,1460,0,1460,0,1454,5,3950,2490,498,956
48,"STRĂINĂTATE",,,"MD",169,"Hincesti",0,168,"Republica Moldova",60,0,1948,0,1948,0,1946,2,3951,2003,311,1635
48,"STRĂINĂTATE",,,"MD",170,"Calarasi",0,168,"Republica Moldova",60,0,2546,0,2546,0,2536,10,4350,1804,497,2039
48,"STRĂINĂTATE",,,"MD",171,"Cahul",0,168,"Republica Moldova",60,0,1788,0,1788,0,1784,4,4351,2563,516,1268
48,"STRĂINĂTATE",,,"MD",172,"Cimislia",0,168,"Republica Moldova",60,0,1514,0,1514,0,1510,4,3950,2436,374,1136
48,"STRĂINĂTATE",,,"MD",173,"Balti",0,168,"Republica Moldova",60,0,1805,0,1805,0,1801,4,4348,2543,443,1358
48,"STRĂINĂTATE",,,"MD",174,"Soroca",0,168,"Republica Moldova",60,0,755,0,755,0,754,1,3551,2796,283,471
48,"STRĂINĂTATE",,,"MD",175,"Ungheni",0,168,"Republica Moldova",60,0,1528,0,1528,0,1527,1,3940,2412,494,1033
48,"STRĂINĂTATE",,,"MD",176,"Drochia",0,168,"Republica Moldova",60,0,700,0,700,0,696,4,3549,2849,267,429
48,"STRĂINĂTATE",,,"MD",177,"Giurgiulesti",0,168,"Republica Moldova",60,0,611,0,611,0,608,3,3550,2939,231,377
48,"STRĂINĂTATE",,,"MD",178,"Cantemir",0,168,"Republica Moldova",60,0,720,0,720,0,719,1,3550,2830,245,474
48,"STRĂINĂTATE",,,"MD",179,"Ialoveni",0,168,"Republica Moldova",60,0,3339,0,3339,0,3332,7,4748,1409,379,2953
48,"STRĂINĂTATE",,,"MD",180,"Floresti",0,168,"Republica Moldova",60,0,581,0,581,0,581,0,3549,2968,206,375
48,"STRĂINĂTATE",,,"MD",181,"Leova",0,168,"Republica Moldova",60,0,737,0,737,0,735,2,3553,2816,317,418
48,"STRĂINĂTATE",,,"MD",182,"Edinet",0,168,"Republica Moldova",60,0,788,0,788,0,780,8,3547,2759,276,504
48,"STRĂINĂTATE",,,"MD",183,"Falesti",0,168,"Republica Moldova",60,0,362,0,362,0,362,0,3550,3188,103,259
48,"STRĂINĂTATE",,,"ME",184,"Podgorica",0,184,"Muntenegru",61,0,20,0,20,0,20,0,800,780,3,17
48,"STRĂINĂTATE",,,"NG",185,"Abuja",0,185,"Nigeria",62,0,34,0,34,0,34,0,400,366,6,28
48,"STRĂINĂTATE",,,"NO",186,"Oslo",0,186,"Norvegia",63,0,1902,0,1902,0,1892,10,3600,1698,141,1751
48,"STRĂINĂTATE",,,"NZ",187,"Auckland",0,187,"Noua Zeelanda",64,0,331,0,331,0,330,1,1600,1269,21,309
48,"STRĂINĂTATE",,,"NL",188,"Haga 1",0,188,"Olanda",65,0,1935,0,1935,0,1924,11,4400,2465,136,1788
48,"STRĂINĂTATE",,,"NL",189,"Haga 2",0,188,"Olanda",65,0,1907,0,1907,0,1894,13,4000,2093,150,1744
48,"STRĂINĂTATE",,,"PS",190,"Ramallah",0,190,"Palestina",66,0,19,0,19,0,19,0,400,381,10,9
48,"STRĂINĂTATE",,,"PK",191,"Islamabad",0,191,"Pakistan",67,0,15,0,15,0,14,1,200,185,6,8
48,"STRĂINĂTATE",,,"PE",192,"Lima",0,192,"Peru",68,0,45,0,45,0,45,0,400,355,4,41
48,"STRĂINĂTATE",,,"PL",193,"Varsovia",0,193,"Polonia",69,0,360,0,360,0,357,3,2800,2440,55,302
48,"STRĂINĂTATE",,,"PL",194,"Cracovia",0,193,"Polonia",69,0,264,0,264,0,261,3,2400,2136,21,240
48,"STRĂINĂTATE",,,"PL",195,"Poznan",0,193,"Polonia",69,0,51,0,51,0,50,1,2000,1949,5,45
48,"STRĂINĂTATE",,,"PT",196,"Lisabona",0,196,"Portugalia",70,0,1599,0,1599,0,1590,9,3201,1602,189,1401
48,"STRĂINĂTATE",,,"PT",197,"Porto",0,196,"Portugalia",70,0,223,0,223,0,223,0,1200,977,23,200
48,"STRĂINĂTATE",,,"PT",198,"Vilamoura",0,196,"Portugalia",70,0,1028,0,1028,0,1025,3,2000,972,124,901
48,"STRĂINĂTATE",,,"QA",199,"Doha",0,199,"Qatar",71,0,753,0,753,0,748,5,1600,847,80,668
48,"STRĂINĂTATE",,,"RU",200,"Moscova",0,200,"Federaţia Rusă",72,0,295,0,295,0,291,4,800,505,67,224
48,"STRĂINĂTATE",,,"RU",201,"Rostov pe Don",0,200,"Federaţia Rusă",72,0,6,0,6,0,6,0,200,194,4,2
48,"STRĂINĂTATE",,,"RU",202,"Sankt Petersburg",0,200,"Federaţia Rusă",72,0,40,0,40,0,40,0,200,160,8,32
48,"STRĂINĂTATE",,,"SM",203,"San Marino",0,203,"Republica San Marino",73,0,1779,0,1779,0,1771,8,2401,622,156,1615
48,"STRĂINĂTATE",,,"SN",204,"Dakar",0,204,"Senegal",74,0,33,0,33,0,33,0,400,367,5,28
48,"STRĂINĂTATE",,,"RS",205,"Belgrad",0,205,"Serbia",75,0,112,0,112,0,111,1,2400,2288,21,90
48,"STRĂINĂTATE",,,"RS",206,"Varset",0,205,"Serbia",75,0,65,0,65,0,64,1,2000,1935,14,50
48,"STRĂINĂTATE",,,"RS",207,"Zajecar",0,205,"Serbia",75,0,22,0,22,0,22,0,1600,1578,13,9
48,"STRĂINĂTATE",,,"RS",208,"Pristina",0,205,"Serbia",75,0,118,0,118,0,115,3,1999,1881,26,89
48,"STRĂINĂTATE",,,"SG",209,"Singapore",0,209,"Singapore",76,0,220,0,220,0,220,0,800,580,16,204
48,"STRĂINĂTATE",,,"SY",210,"Damasc",0,210,"Republica Arabă Siriană",77,0,13,0,13,0,13,0,1000,987,4,9
48,"STRĂINĂTATE",,,"SK",211,"Bratislava",0,211,"Slovacia",78,0,1321,0,1321,0,1318,3,2400,1079,65,1253
48,"STRĂINĂTATE",,,"SI",212,"Ljubljana",0,211,"Slovenia",78,0,151,0,151,0,150,1,1601,1450,19,131
48,"STRĂINĂTATE",,,"ES",213,"Madrid 1",0,222,"Spania",79,0,2347,0,2347,0,2334,13,4400,2053,378,1956
48,"STRĂINĂTATE",,,"ES",214,"Madrid 2",0,222,"Spania",79,0,1908,0,1908,0,1899,9,4400,2492,305,1594
48,"STRĂINĂTATE",,,"ES",215,"Madrid 3",0,222,"Spania",79,0,3213,0,3213,0,3197,16,6000,2787,304,2893
48,"STRĂINĂTATE",,,"ES",216,"Madrid 4",0,222,"Spania",79,0,2781,0,2781,0,2767,14,6000,3219,274,2493
48,"STRĂINĂTATE",,,"ES",217,"Coslada",0,222,"Spania",79,0,4795,0,4795,0,4775,20,6799,2004,536,4239
48,"STRĂINĂTATE",,,"ES",218,"Alcala de Henares",0,222,"Spania",79,0,3821,0,3821,0,3806,15,6801,2980,260,3546
48,"STRĂINĂTATE",,,"ES",219,"Getafe",0,222,"Spania",79,0,3521,0,3521,0,3503,18,4000,479,231,3272
48,"STRĂINĂTATE",,,"ES",220,"Arganda del Rey",0,222,"Spania",79,0,3962,0,3962,0,3953,9,6400,2438,232,3721
48,"STRĂINĂTATE",,,"ES",221,"Mostoles",0,222,"Spania",79,0,3128,0,3128,0,3122,6,3998,870,268,2854
48,"STRĂINĂTATE",,,"ES",222,"Burgos",0,222,"Spania",79,0,1560,0,1560,0,1554,6,3200,1640,208,1346
48,"STRĂINĂTATE",,,"ES",223,"Toledo",0,222,"Spania",79,0,2620,0,2620,0,2611,9,3200,580,227,2384
48,"STRĂINĂTATE",,,"ES",224,"Guadalajara",0,222,"Spania",79,0,2445,0,2445,0,2435,10,4000,1555,137,2298
48,"STRĂINĂTATE",,,"ES",225,"Sevilla",0,222,"Spania",79,0,862,0,862,0,851,11,3200,2338,153,698
48,"STRĂINĂTATE",,,"ES",226,"Malaga",0,222,"Spania",79,0,1462,0,1462,0,1455,7,3200,1738,182,1273
48,"STRĂINĂTATE",,,"ES",227,"Motril",0,222,"Spania",79,0,1295,0,1295,0,1293,2,3200,1905,98,1195
48,"STRĂINĂTATE",,,"ES",228,"Murcia",0,222,"Spania",79,0,1107,0,1107,0,1102,5,3201,2094,111,991
48,"STRĂINĂTATE",,,"ES",229,"Barcelona 1",0,222,"Spania",79,0,2228,0,2228,0,2218,10,4000,1772,124,2094
48,"STRĂINĂTATE",,,"ES",230,"Barcelona 2",0,222,"Spania",79,0,2362,0,2362,0,2356,6,4000,1638,132,2224
48,"STRĂINĂTATE",,,"ES",231,"Lerida",0,222,"Spania",79,0,2977,0,2977,0,2964,13,4000,1023,215,2749
48,"STRĂINĂTATE",,,"ES",232,"Reus",0,222,"Spania",79,0,2914,0,2914,0,2907,7,4000,1086,254,2653
48,"STRĂINĂTATE",,,"ES",233,"Palma de Mallorca",0,222,"Spania",79,0,1237,0,1237,0,1227,10,2400,1163,106,1121
48,"STRĂINĂTATE",,,"ES",234,"Bilbao",0,222,"Spania",79,0,2078,0,2078,0,2071,7,4001,1923,224,1847
48,"STRĂINĂTATE",,,"ES",235,"Logrono",0,222,"Spania",79,0,2383,0,2383,0,2379,4,4000,1617,204,2175
48,"STRĂINĂTATE",,,"ES",236,"Pamplona",0,222,"Spania",79,0,1414,0,1414,0,1404,10,3200,1786,172,1232
48,"STRĂINĂTATE",,,"ES",237,"Zaragoza 1",0,222,"Spania",79,0,2926,0,2926,0,2904,22,4000,1074,335,2569
48,"STRĂINĂTATE",,,"ES",238,"Zaragoza 2",0,222,"Spania",79,0,2920,0,2920,0,2908,12,4000,1080,327,2581
48,"STRĂINĂTATE",,,"ES",239,"Calatayud",0,222,"Spania",79,0,1790,0,1790,0,1783,7,3200,1410,144,1639
48,"STRĂINĂTATE",,,"ES",240,"Ciudad Real",0,222,"Spania",79,0,1131,0,1131,0,1120,11,3200,2069,117,1003
48,"STRĂINĂTATE",,,"ES",241,"Albacete",0,222,"Spania",79,0,918,0,918,0,917,1,3200,2282,88,829
48,"STRĂINĂTATE",,,"ES",242,"Almeria",0,222,"Spania",79,0,2904,0,2904,0,2901,3,4000,1096,216,2685
48,"STRĂINĂTATE",,,"ES",243,"Castellon de la Plana 1",0,222,"Spania",79,0,2356,0,2356,0,2317,39,4001,1645,233,2084
48,"STRĂINĂTATE",,,"ES",244,"Castellon de la Plana 2",0,222,"Spania",79,0,2592,0,2592,0,2579,13,4000,1408,253,2326
48,"STRĂINĂTATE",,,"ES",245,"Valencia",0,222,"Spania",79,0,2604,0,2604,0,2595,9,4000,1396,192,2403
48,"STRĂINĂTATE",,,"ES",246,"Alicante",0,222,"Spania",79,0,2148,0,2148,0,2138,10,3597,1449,162,1976
48,"STRĂINĂTATE",,,"ES",247,"Lepe",0,222,"Spania",79,0,914,0,914,0,913,1,3200,2286,156,757
48,"STRĂINĂTATE",,,"ES",248,"Santiago de Compostela",0,222,"Spania",79,0,244,0,244,0,243,1,2801,2557,26,217
48,"STRĂINĂTATE",,,"ES",249,"Cordoba",0,222,"Spania",79,0,341,0,341,0,339,2,2800,2459,44,295
48,"STRĂINĂTATE",,,"ES",250,"Gijon",0,222,"Spania",79,0,909,0,909,0,904,5,3200,2291,121,783
48,"STRĂINĂTATE",,,"LK",251,"Colombo",0,251,"Sri Lanka",80,0,18,0,18,0,18,0,200,182,4,14
48,"STRĂINĂTATE",,,"US",252,"Washington D.C.",0,252,"SUA",81,0,1087,0,1087,0,1084,3,4000,2913,96,988
48,"STRĂINĂTATE",,,"US",253,"Atlanta",0,252,"SUA",81,0,1044,0,1044,0,1038,6,3200,2156,75,963
48,"STRĂINĂTATE",,,"US",254,"Charlotte",0,252,"SUA",81,0,358,0,358,0,358,0,2801,2443,21,337
48,"STRĂINĂTATE",,,"US",255,"Cleveland",0,252,"SUA",81,0,483,0,483,0,481,2,2801,2318,36,445
48,"STRĂINĂTATE",,,"US",256,"Dallas",0,252,"SUA",81,0,333,0,333,0,331,2,2801,2468,18,313
48,"STRĂINĂTATE",,,"US",257,"Hollywood",0,252,"SUA",81,0,1294,0,1294,0,1287,7,3601,2307,103,1184
48,"STRĂINĂTATE",,,"US",258,"Houston",0,252,"SUA",81,0,508,0,508,0,508,0,2801,2293,45,463
48,"STRĂINĂTATE",,,"US",259,"New York",0,252,"SUA",81,0,2183,0,2183,0,2177,6,5200,3017,156,2021
48,"STRĂINĂTATE",,,"US",260,"Boston",0,252,"SUA",81,0,867,0,867,0,861,6,3200,2333,79,782
48,"STRĂINĂTATE",,,"US",261,"Philadelphia",0,252,"SUA",81,0,620,0,620,0,620,0,3200,2580,74,546
48,"STRĂINĂTATE",,,"US",262,"Chicago 1",0,252,"SUA",81,0,772,0,772,0,767,5,3600,2828,50,717
48,"STRĂINĂTATE",,,"US",263,"Chicago 2",0,252,"SUA",81,0,2161,0,2161,0,2158,3,4000,1839,169,1989
48,"STRĂINĂTATE",,,"US",264,"Detroit",0,252,"SUA",81,0,1113,0,1113,0,1110,3,3200,2087,71,1039
48,"STRĂINĂTATE",,,"US",265,"Minneapolis",0,252,"SUA",81,0,113,0,113,0,113,0,2800,2687,5,108
48,"STRĂINĂTATE",,,"US",266,"Indianapolis",0,252,"SUA",81,0,164,0,164,0,162,2,2801,2637,14,148
48,"STRĂINĂTATE",,,"US",267,"Los Angeles",0,252,"SUA",81,0,1251,0,1251,0,1250,1,5201,3950,79,1171
48,"STRĂINĂTATE",,,"US",268,"San Francisco",0,252,"SUA",81,0,940,0,940,0,933,7,3201,2261,56,877
48,"STRĂINĂTATE",,,"US",269,"Las Vegas",0,252,"SUA",81,0,319,0,319,0,318,1,2801,2482,30,288
48,"STRĂINĂTATE",,,"US",270,"Sacramento",0,252,"SUA",81,0,472,0,472,0,472,0,2800,2328,24,448
48,"STRĂINĂTATE",,,"US",271,"Phoenix",0,252,"SUA",81,0,812,0,812,0,812,0,2801,1989,53,759
48,"STRĂINĂTATE",,,"US",272,"Portland - Oregon",0,252,"SUA",81,0,777,0,777,0,776,1,2801,2024,37,739
48,"STRĂINĂTATE",,,"US",273,"Salt Lake City",0,252,"SUA",81,0,67,0,67,0,67,0,2401,2334,4,63
48,"STRĂINĂTATE",,,"SD",274,"Khartoum",0,274,"Sudan",82,0,17,0,17,0,17,0,200,183,4,13
48,"STRĂINĂTATE",,,"SE",275,"Stockholm",0,275,"Suedia",83,0,1792,0,1792,0,1774,18,4400,2608,152,1622
48,"STRĂINĂTATE",,,"TH",276,"Bangkok",0,276,"Thailanda",84,0,102,0,102,0,100,2,401,299,16,84
48,"STRĂINĂTATE",,,"TN",277,"Tunis",0,277,"Tunisia",85,0,83,0,83,0,83,0,400,317,28,55
48,"STRĂINĂTATE",,,"TR",278,"Ankara",0,278,"Republica Turcia",86,0,126,0,126,0,123,3,1200,1074,35,88
48,"STRĂINĂTATE",,,"TR",279,"Istanbul 1",0,278,"Republica Turcia",86,0,204,0,204,0,202,2,1600,1396,64,138
48,"STRĂINĂTATE",,,"TR",280,"Istanbul 2",0,278,"Republica Turcia",86,0,442,0,442,0,436,6,1599,1157,85,351
48,"STRĂINĂTATE",,,"TR",281,"Izmir",0,278,"Republica Turcia",86,0,80,0,80,0,79,1,800,720,21,58
48,"STRĂINĂTATE",,,"TM",282,"Ashgabat",0,282,"Turkmenistan",87,0,19,0,19,0,19,0,200,181,4,15
48,"STRĂINĂTATE",,,"UA",283,"Kiev",0,283,"Ucraina",88,0,92,0,92,0,92,0,800,708,24,68
48,"STRĂINĂTATE",,,"UA",284,"Cernauti",0,283,"Ucraina",88,0,130,0,130,0,130,0,800,670,53,77
48,"STRĂINĂTATE",,,"UA",285,"Odesa",0,283,"Ucraina",88,0,41,0,41,0,40,1,801,760,16,24
48,"STRĂINĂTATE",,,"HU",286,"Budapesta 1",0,286,"Ungaria",89,0,1577,0,1577,0,1570,7,4000,2423,57,1513
48,"STRĂINĂTATE",,,"HU",287,"Budapesta 2",0,286,"Ungaria",89,0,1391,0,1391,0,1387,4,4000,2609,80,1307
48,"STRĂINĂTATE",,,"HU",288,"Gyula",0,286,"Ungaria",89,0,99,0,99,0,99,0,2800,2701,36,63
48,"STRĂINĂTATE",,,"HU",289,"Szeged",0,286,"Ungaria",89,0,182,0,182,0,181,1,2800,2618,25,156
48,"STRĂINĂTATE",,,"UY",290,"Montevideo",0,290,"Uruguay",90,0,39,0,39,0,37,2,200,161,14,23
48,"STRĂINĂTATE",,,"UZ",291,"Taskent",0,291,"Uzbekistan",91,0,17,0,17,0,17,0,197,180,4,13
48,"STRĂINĂTATE",,,"VE",292,"Caracas",0,292,"Venezuela",92,0,44,0,44,0,43,1,400,356,10,33
48,"STRĂINĂTATE",,,"VN",293,"Hanoi",0,293,"Vietnam",93,0,40,0,40,0,40,0,199,159,11,29
48,"STRĂINĂTATE",,,"ZW",294,"Harare",0,294,"Zimbabwe",94,0,15,0,15,0,14,1,105,90,5,9
"Total",,,,,,,,,"Total",,18280994,11719344,10042721,1569668,106955,11553152,166111,20911043,9191626,5264383,6288769
