"NCE","NUME_CE","CountyId","LocalityId","CountryId","NSV","SVSPEC","ADRESA","NUME_L","COD_L","SIRUTA","TIP_L","MEDIU_L","A_SV","AP_SV","APP_SV","APS_SV","TVE_SV","VN_SV","BVP_SV","BVRN_SV","ILIESCU","VADIM",
1,"ALBA",10,1017,,1,0,"Str.Marasti nr.55","MUNICIPIUL ALBA IULIA",1,1017,1,1,1428,762,719,43,756,6,1577,815,541,215,
1,"ALBA",10,1017,,2,0,"STR.N.FILIPESCU NR.2","MUNICIPIUL ALBA IULIA",1,1017,1,1,1120,605,550,55,594,11,1240,635,414,180,
1,"ALBA",10,1017,,3,0,"STR.MOLDOVEI NR.2","MUNICIPIUL ALBA IULIA",1,1017,1,1,1359,732,659,73,719,13,2500,1768,511,208,
1,"ALBA",10,1017,,4,0,"STR.N.TITULESCU NR.5","MUNICIPIUL ALBA IULIA",1,1017,1,1,1462,842,769,73,832,10,1600,758,613,219,
1,"ALBA",10,1017,,5,0,"STR.ARDEALULUI NR.1","MUNICIPIUL ALBA IULIA",1,1017,1,1,1177,604,532,72,597,7,1300,696,416,181,
1,"ALBA",10,1017,,6,0,"STR.MOLDOVEI NR.2","MUNICIPIUL ALBA IULIA",1,1017,1,1,1268,618,573,45,606,12,1400,782,381,225,
1,"ALBA",10,1017,,7,0,"STR.OCTAVIAN GOGA NR.11","MUNICIPIUL ALBA IULIA",1,1017,1,1,1311,753,704,49,744,9,1452,699,537,207,
1,"ALBA",10,1017,,8,0,"STR. NICOLAE IORGA NR.13","MUNICIPIUL ALBA IULIA",1,1017,1,1,1365,700,600,100,689,11,1500,800,535,154,
1,"ALBA",10,1017,,9,0,"B-DUL 1 DECEMBRIE 1918 NR.83","MUNICIPIUL ALBA IULIA",1,1017,1,1,1385,738,528,210,729,9,1530,792,430,299,
1,"ALBA",10,1017,,10,0,"STR.NICOLAE IORGA NR.13","MUNICIPIUL ALBA IULIA",1,1017,1,1,1114,506,472,34,497,9,1240,734,325,172,
1,"ALBA",10,1017,,11,0,"B-DUL 1 DECEMBRIE NR.83","MUNICIPIUL ALBA IULIA",1,1017,1,1,1321,591,498,93,581,10,1470,879,271,310,
1,"ALBA",10,1017,,12,0,"B-DUL 1 DECEMBRIE 1918 NR.83","MUNICIPIUL ALBA IULIA",1,1017,1,1,1119,487,430,57,484,3,1243,756,251,233,
1,"ALBA",10,1017,,13,0,"B-DUL 1 DECEMBRIE 1918 NR.83","MUNICIPIUL ALBA IULIA",1,1017,1,1,1173,547,488,59,542,5,1302,755,322,220,
1,"ALBA",10,1017,,14,0,"STR.VASILE GOLDIS NR.3","MUNICIPIUL ALBA IULIA",1,1017,1,1,1450,707,602,105,702,5,1560,853,403,299,
1,"ALBA",10,1017,,15,0,"STR VASILE GOLDIS NR.7","MUNICIPIUL ALBA IULIA",1,1017,1,1,1369,560,508,52,556,4,1520,960,317,239,
1,"ALBA",10,1017,,16,0,"B-DUL TRANSILVANIEI NR.25A","MUNICIPIUL ALBA IULIA",1,1017,1,1,1547,839,727,112,823,16,1710,871,479,344,
1,"ALBA",10,1017,,17,0,"VASILE GOLDIS NR.10B","MUNICIPIUL ALBA IULIA",1,1017,1,1,1106,600,538,62,594,6,1230,630,390,204,
1,"ALBA",10,1017,,18,0,"STR. VASILE GOLDIS NR.10B","MUNICIPIUL ALBA IULIA",1,1017,1,1,1067,596,538,58,581,15,1180,584,401,180,
1,"ALBA",10,1017,,19,0,"STR. VASILE GOLDIS NR.18B","MUNICIPIUL ALBA IULIA",1,1017,1,1,1467,649,555,94,647,2,1600,951,353,294,
1,"ALBA",10,1017,,20,0,"STR. STEFAN CEL MARE NR.11","MUNICIPIUL ALBA IULIA",1,1017,1,1,1340,640,603,37,634,6,1479,839,402,232,
1,"ALBA",10,1017,,21,0,"STR. STEFAN CEL MARE NR.11","MUNICIPIUL ALBA IULIA",1,1017,1,1,1348,686,636,50,675,11,1491,805,463,212,
1,"ALBA",10,1017,,22,0,"STR. PETRU RAVES NR.18","MUNICIPIUL ALBA IULIA",1,1017,1,1,1441,690,643,47,686,4,1600,910,301,385,
1,"ALBA",10,1017,,23,0,"STR PETRU RARES NR.18","MUNICIPIUL ALBA IULIA",1,1017,1,1,1456,722,635,87,718,4,1610,888,417,301,
1,"ALBA",10,1017,,24,0,"STR.MARESAL ION ANTONESCU NR.21","MUNICIPIUL ALBA IULIA",1,1017,1,1,1246,631,586,45,617,14,1380,749,384,233,
1,"ALBA",10,1017,,25,0,"STR MARESAL ION ANTONESCU NR.21","MUNICIPIUL ALBA IULIA",1,1017,1,1,1466,737,687,50,730,7,1620,883,402,328,
1,"ALBA",10,1017,,26,0,"VESTIARE STADION ""UNIREA""","MUNICIPIUL ALBA IULIA",1,1017,1,1,1443,638,615,23,635,3,1600,962,353,282,
1,"ALBA",10,1017,,27,0,"STR.REVOLUTIEI NR.87","MUNICIPIUL ALBA IULIA",1,1017,1,1,1410,687,627,60,677,10,1542,853,398,279,
1,"ALBA",10,1017,,28,0,"STR STEFAN CEL MARE","MUNICIPIUL ALBA IULIA",1,1017,1,1,1337,651,600,51,649,2,1520,869,373,276,
1,"ALBA",10,1017,,29,0,"STR.STEFAN CEL MARE NR.25","MUNICIPIUL ALBA IULIA",1,1017,1,1,1643,860,830,30,846,14,1822,962,478,368,
1,"ALBA",10,1017,,30,0,"CALEA MOTILOR NR.83","MUNICIPIUL ALBA IULIA",1,1017,1,1,1388,748,697,51,735,13,1540,792,505,230,
1,"ALBA",10,1017,,31,0,"STR SEPTIMIUS SEVERUS NR.38A","MUNICIPIUL ALBA IULIA",1,1017,1,1,1649,768,718,50,759,9,1820,1052,528,231,
1,"ALBA",10,1017,,32,0,"STR GHEORGHE SINCAI NR.2A","MUNICIPIUL ALBA IULIA",1,1017,1,1,1746,864,735,129,846,18,1942,1078,542,304,
1,"ALBA",10,1017,,33,0,"B-DUL REVOLUTIEI NR.113","MUNICIPIUL ALBA IULIA",1,1017,1,1,1682,648,603,45,645,3,1860,1212,323,322,
1,"ALBA",10,1017,,34,0,"BDUL REGELE CAROL I NR.39","MUNICIPIUL ALBA IULIA",1,1017,1,1,1411,631,588,43,625,6,1570,939,393,232,
1,"ALBA",10,1017,,35,0,"B-DUL REGELE CAROL I NR.143","MUNICIPIUL ALBA IULIA",1,1017,1,1,1257,614,556,58,608,6,1700,1086,273,335,
1,"ALBA",10,1017,,36,0,"B-DUL REGELE CAROL I nr.143","MUNICIPIUL ALBA IULIA",1,1017,1,1,1734,794,726,68,788,6,1920,1126,340,448,
1,"ALBA",10,1017,,37,0,"B-DUL REGELE CAROL I nr.143","MUNICIPIUL ALBA IULIA",1,1017,1,1,1629,753,658,95,736,17,1820,1066,318,418,
1,"ALBA",10,1017,,38,0,"STR CABANEI NR.7","MUNICIPIUL ALBA IULIA",1,1017,1,1,1605,826,739,87,808,18,1780,954,483,325,
1,"ALBA",10,1017,,39,0,"STR SCARISOAREI NR 17","MUNICIPIUL ALBA IULIA",1,1017,1,1,1309,755,667,88,734,21,1428,673,439,295,
1,"ALBA",10,1017,,40,0,"STR CARPENULUI SCOALA PRIMARA","MUNICIPIUL ALBA IULIA",1,1017,1,1,642,313,259,54,308,5,720,407,133,175,
1,"ALBA",10,1017,,41,0,"CANTINA SC ""AGRA"" SA","MUNICIPIUL ALBA IULIA",1,1017,1,1,931,552,474,78,544,8,1030,478,339,205,
1,"ALBA",10,1017,,42,0,"STR VICTORIEI SCOALA PRIMARA","MUNICIPIUL ALBA IULIA",1,1017,1,1,599,359,304,55,350,9,660,301,153,197,
1,"ALBA",10,1017,,43,1,"STR ALEXANDRU IOAN CUZA NR 18","MUNICIPIUL ALBA IULIA",1,1017,1,1,0,230,0,230,227,3,250,20,139,88,
1,"ALBA",10,1017,,44,1,"STR MILITARI NR.7","MUNICIPIUL ALBA IULIA",1,1017,1,1,0,267,0,267,257,10,450,183,102,155,
1,"ALBA",10,1017,,45,1,"B-DUL REVOLUTIEI NR.23","MUNICIPIUL ALBA IULIA",1,1017,1,1,0,371,0,371,364,7,1000,629,224,140,
1,"ALBA",10,1017,,46,1,"STR MIHAI VITEAZUL NR 31","MUNICIPIUL ALBA IULIA",1,1017,1,1,0,400,0,400,364,36,1000,600,169,195,
1,"ALBA",10,1017,,47,1,"B-DUL TRANSILVANIEI BL.M6","MUNICIPIUL ALBA IULIA",1,1017,1,1,0,186,0,186,176,10,1001,815,130,46,
1,"ALBA",10,1213,,48,0,"STR TRANSILVANIEI NR.31","MUNICIPIUL AIUD",2,1213,1,1,2050,1110,1033,77,1084,25,2260,1151,753,331,
1,"ALBA",10,1213,,49,0,"STR TRIBUN TUDORAN NR 5","MUNICIPIUL AIUD",2,1213,1,1,1641,857,814,43,849,8,1802,945,611,238,
1,"ALBA",10,1213,,50,0,"STR UNIRII NR.26","MUNICIPIUL AIUD",2,1213,1,1,1914,1016,951,65,1005,11,2091,1075,626,379,
1,"ALBA",10,1213,,51,0,"STR UNIRII NR.24","MUNICIPIUL AIUD",2,1213,1,1,1766,960,920,40,948,12,1950,990,624,324,
1,"ALBA",10,1213,,52,0,"STR UNIRII NR.22","MUNICIPIUL AIUD",2,1213,1,1,1602,767,702,65,759,8,1769,1002,461,298,
1,"ALBA",10,1213,,53,0,"STR UNIRII NR.22","MUNICIPIUL AIUD",2,1213,1,1,1117,592,550,42,590,2,1240,648,381,209,
1,"ALBA",10,1213,,54,0,"STR ECATERINA VARGA NR.8","MUNICIPIUL AIUD",2,1213,1,1,1715,1015,780,235,1002,13,1902,887,637,365,
1,"ALBA",10,1213,,55,0,"STR ION CREANGA NR.24","MUNICIPIUL AIUD",2,1213,1,1,2019,1026,970,56,1014,12,2230,1204,806,208,
1,"ALBA",10,1213,,56,0,"STR SIMION BARNUTIU NR 20","MUNICIPIUL AIUD",2,1213,1,1,1829,947,888,59,936,11,2017,1070,580,356,
1,"ALBA",10,1213,,57,0,"STR CUZA VODA NR.35","MUNICIPIUL AIUD",2,1213,1,1,1736,932,830,102,918,14,1920,988,696,222,
1,"ALBA",10,1213,,58,0,"STR GHEORGHE LAZAR NR 17","MUNICIPIUL AIUD",2,1213,1,1,1849,922,868,54,898,24,2040,1118,615,283,
1,"ALBA",10,1213,,59,0,"STR PANDURILOR NR.50","MUNICIPIUL AIUD",2,1213,1,1,485,314,272,42,310,4,540,226,144,166,
1,"ALBA",10,1213,,60,0,"STR BABA NOVAC NR 9","MUNICIPIUL AIUD",2,1213,1,1,446,276,250,26,273,3,590,314,219,54,
1,"ALBA",10,1213,,61,0,"STR DEALULUI NR 12","MUNICIPIUL AIUD",2,1213,1,1,120,96,81,15,93,3,140,44,73,20,
1,"ALBA",10,1213,,62,0,"STR VASILE LUCACIU NR 18","MUNICIPIUL AIUD",2,1213,1,1,1052,627,569,58,621,6,1157,530,415,206,
1,"ALBA",10,1213,,63,0,"STR ANDREI MURESANU NR.60","MUNICIPIUL AIUD",2,1213,1,1,597,407,350,57,394,13,657,250,282,112,
1,"ALBA",10,1213,,64,0,"STR GHEORGHE ASACHI NR 24","MUNICIPIUL AIUD",2,1213,1,1,430,253,206,47,249,4,480,227,113,136,
1,"ALBA",10,1213,,65,0,"SCOALA GENERALA NR.66","MUNICIPIUL AIUD",2,1213,1,1,127,99,85,14,97,2,140,41,43,54,
1,"ALBA",10,1213,,66,0,"STR GRUISOAREI NR.2","MUNICIPIUL AIUD",2,1213,1,1,264,211,179,32,209,2,290,79,88,121,
1,"ALBA",10,1213,,67,1,"UM 01626 STR TRANSILVANIEI","MUNICIPIUL AIUD",2,1213,1,1,0,558,0,558,529,29,697,139,303,226,
1,"ALBA",10,1348,,68,0,"STR GARII BLOC 3","MUNICIPIUL BLAJ",3,1348,1,1,1351,735,656,79,725,10,1742,1007,452,273,
1,"ALBA",10,1348,,69,0,"STR EROILOR GRADINITA CU PROGRAM PRELUNGIT","MUNICIPIUL BLAJ",3,1348,1,1,1579,821,772,49,811,10,1742,921,498,313,
1,"ALBA",10,1348,,70,0,"STR REPUBLICII NR.48","MUNICIPIUL BLAJ",3,1348,1,1,1817,933,850,83,915,18,2000,1067,555,360,
1,"ALBA",10,1348,,71,0,"P-TA 1848 NR.3","MUNICIPIUL BLAJ",3,1348,1,1,1425,768,634,134,733,35,1560,792,504,229,
1,"ALBA",10,1348,,72,0,"STR T VLADIMIRESCU NR.80","MUNICIPIUL BLAJ",3,1348,1,1,1553,743,710,33,738,5,1712,969,418,320,
1,"ALBA",10,1348,,73,0,"STR DR V.SUCIU NR.29","MUNICIPIUL BLAJ",3,1348,1,1,1676,860,803,57,841,19,1835,975,550,291,
1,"ALBA",10,1348,,74,0,"STR SIMION BARNUTIU NR.2","MUNICIPIUL BLAJ",3,1348,1,1,1532,888,706,182,866,22,1688,800,550,316,
1,"ALBA",10,1348,,75,0,"STR PACII NR.1","MUNICIPIUL BLAJ",3,1348,1,1,1793,915,855,60,895,20,1982,1067,509,386,
1,"ALBA",10,1348,,76,0,"SC GENERALA NR.2","MUNICIPIUL BLAJ",3,1348,1,1,1956,1156,1067,89,1133,23,2150,994,741,392,
1,"ALBA",10,1348,,77,0,"SC GENERALA","MUNICIPIUL BLAJ",3,1348,1,1,1490,843,771,72,830,13,1582,739,433,397,
1,"ALBA",10,1348,,78,0,"SC GENERALA","MUNICIPIUL BLAJ",3,1348,1,1,740,453,398,55,450,3,810,357,215,235,
1,"ALBA",10,1348,,79,0,"SC GENERALA","MUNICIPIUL BLAJ",3,1348,1,1,484,301,270,31,296,5,530,229,273,23,
1,"ALBA",10,1151,,80,0,"P-TA EROILOR NR.17","ORAS ABRUD",5,1151,2,1,2290,1399,1276,123,1385,14,2530,1131,677,708,
1,"ALBA",10,1151,,81,0,"STR REPUBLICII NR.16","ORAS ABRUD",5,1151,2,1,2404,1423,1184,239,1407,16,2660,1237,595,812,
1,"ALBA",10,2915,,82,0,"CLUBUL MINIER -SALA MARE","ORAS BAIA DE ARIES",6,2915,2,1,994,480,425,55,475,5,1100,620,218,257,
1,"ALBA",10,2915,,83,0,"CLUBUL MINIER -SALA MICA","ORAS BAIA DE ARIES",6,2915,2,1,919,405,379,26,403,2,1010,605,180,223,
1,"ALBA",10,2915,,84,0,"PRIMARIA","ORAS BAIA DE ARIES",6,2915,2,1,917,493,427,66,492,1,1000,507,196,296,
1,"ALBA",10,2915,,85,0,"SCOALA PRIMARA","ORAS BAIA DE ARIES",6,2915,2,1,240,137,118,19,135,2,267,130,54,81,
1,"ALBA",10,2915,,86,0,"SCOALA PRIMARA","ORAS BAIA DE ARIES",6,2915,2,1,355,194,172,22,191,3,381,187,61,130,
1,"ALBA",10,2915,,87,0,"CAMINUL CULTURAL","ORAS BAIA DE ARIES",6,2915,2,1,352,205,193,12,204,1,390,185,69,135,
1,"ALBA",10,1455,,88,0,"P-TA AVRAM IANCU NR.5","ORAS CAMPENI",7,1455,2,1,1304,708,585,123,692,16,1450,742,290,402,
1,"ALBA",10,1455,,89,0,"STR MOTILOR NR.29","ORAS CAMPENI",7,1455,2,1,1656,1034,879,155,1023,11,1820,786,444,579,
1,"ALBA",10,1455,,90,0,"STR OITUZ NR.6","ORAS CAMPENI",7,1455,2,1,1638,1029,876,153,1023,6,1810,781,408,615,
1,"ALBA",10,1455,,91,0,"SCOALA GENERALA","ORAS CAMPENI",7,1455,2,1,645,340,309,31,332,8,709,369,108,224,
1,"ALBA",10,1455,,92,0,"SCOALA GENERALA","ORAS CAMPENI",7,1455,2,1,560,299,274,25,295,4,620,321,102,193,
1,"ALBA",10,1455,,93,0,"SCOALA GENERALA","ORAS CAMPENI",7,1455,2,1,572,246,214,32,243,3,627,381,69,174,
1,"ALBA",10,1455,,94,0,"SCOALA GENERALA","ORAS CAMPENI",7,1455,2,1,302,270,152,118,270,0,334,64,90,180,
1,"ALBA",10,1696,,95,0,"STR VICTORIEI NR.14","ORAS CUGIR",8,1696,2,1,2089,995,943,52,982,13,2300,1305,545,437,
1,"ALBA",10,1696,,96,0,"STR DOINEI NR.3","ORAS CUGIR",8,1696,2,1,1636,859,802,57,849,10,1802,943,430,419,
1,"ALBA",10,1696,,97,0,"STR ALEEA CONSTRUCTORULUI NR.1","ORAS CUGIR",8,1696,2,1,1733,889,850,39,881,8,1900,1011,465,416,
1,"ALBA",10,1696,,98,0,"STR VICTORIEI NR.15","ORAS CUGIR",8,1696,2,1,1586,770,681,89,761,9,1750,980,383,378,
1,"ALBA",10,1696,,99,0,"STR VICTORIE NR.15","ORAS CUGIR",8,1696,2,1,1401,700,673,27,691,9,1550,850,379,312,
1,"ALBA",10,1696,,100,0,"STR ALEXANDRU SAHIA NR.16","ORAS CUGIR",8,1696,2,1,1688,879,813,66,868,11,1860,981,465,403,
1,"ALBA",10,1696,,101,0,"STR VICTORIEI NR9","ORAS CUGIR",8,1696,2,1,1546,806,766,40,797,9,1700,894,486,311,
1,"ALBA",10,1696,,102,0,"STR TINERETULUI NR.4","ORAS CUGIR",8,1696,2,1,1290,710,640,70,705,5,1420,710,407,298,
1,"ALBA",10,1696,,103,0,"STR NICOLAE BALCESCU NR.6","ORAS CUGIR",8,1696,2,1,1261,792,622,170,778,14,1390,598,457,321,
1,"ALBA",10,1696,,104,0,"STR GHEORGHE ASACHI NR.15A","ORAS CUGIR",8,1696,2,1,1665,904,811,93,887,17,1840,936,473,414,
1,"ALBA",10,1696,,105,0,"STR I.L.CARAGIALE NR.3","ORAS CUGIR",8,1696,2,1,1582,799,749,50,789,10,1740,941,489,300,
1,"ALBA",10,1696,,106,0,"STR 21 DECEMBRIE 1989 NR.56","ORAS CUGIR",8,1696,2,1,1145,613,587,26,605,8,1260,647,341,264,
1,"ALBA",10,1696,,107,0,"STR 21 DECEMBRIE 1989 NR.27","ORAS CUGIR",8,1696,2,1,1242,670,614,56,658,12,1358,688,386,272,
1,"ALBA",10,1696,,108,0,"STR 21 DECEMBRIE 1989 NR.157","ORAS CUGIR",8,1696,2,1,1130,698,566,132,688,10,1248,550,349,339,
1,"ALBA",10,1696,,109,0,"STR RAUL MIC NR.105","ORAS CUGIR",8,1696,2,1,1186,660,600,60,654,6,1310,650,366,288,
1,"ALBA",10,1696,,110,0,"STR CULTURII NR.1","ORAS CUGIR",8,1696,2,1,1098,593,546,47,580,13,1210,617,277,303,
1,"ALBA",10,1696,,111,0,"PRINCIPALA NR 178","ORAS CUGIR",8,1696,2,1,886,549,468,81,542,7,980,431,318,224,
1,"ALBA",10,1696,,112,1,"STR 21 DECEMBRIE 1989 NR.1","ORAS CUGIR",8,1696,2,1,0,165,0,165,163,2,200,35,96,67,
1,"ALBA",10,1696,,113,0,"SCOALA GENERALA","ORAS CUGIR",8,1696,2,1,173,37,23,14,36,1,190,153,6,30,
1,"ALBA",10,1696,,114,0,"SCOALA GENERALA","ORAS CUGIR",8,1696,2,1,141,57,39,18,57,0,160,103,10,47,
1,"ALBA",10,1794,,115,0,"STR ALEEA INDEPENDENTEI NR.1","ORAS OCNA MURES",9,1794,2,1,1902,1065,984,81,1050,15,2100,1035,520,530,
1,"ALBA",10,1794,,116,0,"STR BRAZILOR NR.2","ORAS OCNA MURES",9,1794,2,1,2112,1073,1020,53,1057,16,2330,1257,487,570,
1,"ALBA",10,1794,,117,0,"STR HOREA NR.1","ORAS OCNA MURES",9,1794,2,1,707,375,351,24,367,8,779,404,182,185,
1,"ALBA",10,1794,,118,0,"STR HOREA NR.35","ORAS OCNA MURES",9,1794,2,1,1153,688,629,59,678,10,1280,592,354,324,
1,"ALBA",10,1794,,119,0,"STR VADULUI NR.1","ORAS OCNA MURES",9,1794,2,1,1204,667,615,52,658,9,1330,663,353,305,
1,"ALBA",10,1794,,120,0,"STR MIHAI EMINESCU NR.2","ORAS OCNA MURES",9,1794,2,1,1570,854,792,62,847,7,1740,886,458,389,
1,"ALBA",10,1794,,121,0,"STR LUNGA NR.79","ORAS OCNA MURES",9,1794,2,1,1076,677,607,70,665,12,1188,511,311,354,
1,"ALBA",10,1794,,122,0,"STR PIATA IZVOR NR 1","ORAS OCNA MURES",9,1794,2,1,1067,613,557,56,603,10,1180,567,278,325,
1,"ALBA",10,1794,,123,0,"SCOALA GENERALA NR.81","ORAS OCNA MURES",9,1794,2,1,513,305,279,26,298,7,570,265,158,140,
1,"ALBA",10,1794,,124,0,"GRADINITA NR 122","ORAS OCNA MURES",9,1794,2,1,244,210,143,67,208,2,270,60,87,121,
1,"ALBA",10,1794,,125,0,"NR.142 GRADINITA","ORAS OCNA MURES",9,1794,2,1,1206,710,634,76,705,5,1330,620,319,386,
1,"ALBA",10,1874,,126,0,"STR VIILOR NR.28","MUNICIPIUL SEBES",4,1874,1,1,935,448,427,21,437,11,1030,582,301,136,
1,"ALBA",10,1874,,127,0,"STR VIILOR NR.2","MUNICIPIUL SEBES",4,1874,1,1,1435,738,648,90,718,20,1580,842,565,153,
1,"ALBA",10,1874,,128,0,"B-DUL LUCIAN BLAGA NR.76","MUNICIPIUL SEBES",4,1874,1,1,1874,831,794,37,784,10,2101,1270,497,287,
1,"ALBA",10,1874,,129,0,"B-DUL LUCIAN BLAGA  CASA DE CULTURA","MUNICIPIUL SEBES",4,1874,1,1,929,531,467,64,524,7,1030,499,305,219,
1,"ALBA",10,1874,,130,0,"B-DUL LUCIAN BLAGA NR.31","MUNICIPIUL SEBES",4,1874,1,1,1930,958,844,114,941,17,2130,1172,619,322,
1,"ALBA",10,1874,,131,0,"STR PIATA LIBERTATII NR.1","MUNICIPIUL SEBES",4,1874,1,1,1512,752,693,59,734,18,1700,948,490,244,
1,"ALBA",10,1874,,132,0,"STR DORIN PAVEL -GR SCOLAR INDUSTRIAL","MUNICIPIUL SEBES",4,1874,1,1,1880,899,836,63,885,14,2070,1171,543,342,
1,"ALBA",10,1874,,133,0,"STRDORIN PAVEL NR.75","MUNICIPIUL SEBES",4,1874,1,1,1317,755,633,122,741,14,1449,694,443,298,
1,"ALBA",10,1874,,134,0,"STR STEFAN CEL MARE NR.1","MUNICIPIUL SEBES",4,1874,1,1,1537,761,720,41,746,15,1690,929,410,336,
1,"ALBA",10,1874,,135,0,"CARTIER M KOGALNICEANU -GRADINITA NR.8","MUNICIPIUL SEBES",4,1874,1,1,1708,718,668,50,713,5,1880,1162,342,371,
1,"ALBA",10,1874,,136,0,"CARTIER M KOGALNICEANU SC. GEN NR.4","MUNICIPIUL SEBES",4,1874,1,1,1440,686,616,70,675,11,1580,894,317,358,
1,"ALBA",10,1874,,137,0,"CARTIER M KOGALNICEANU -SC GEN NR.4","MUNICIPIUL SEBES",4,1874,1,1,1637,719,641,78,708,11,1792,1073,313,395,
1,"ALBA",10,1874,,138,0,"SCOALA GENERALA","MUNICIPIUL SEBES",4,1874,1,1,1160,624,564,60,609,15,1280,656,303,306,
1,"ALBA",10,1874,,139,0,"SCOALA GENERALA","MUNICIPIUL SEBES",4,1874,1,1,1410,706,619,87,691,15,1540,834,342,349,
1,"ALBA",10,1874,,140,0,"SCOALA GENERALA","MUNICIPIUL SEBES",4,1874,1,1,1608,951,760,191,929,22,1770,819,434,495,
1,"ALBA",10,1874,,141,0,"STR SCOLII NR.65-SCOALA GENERALA","MUNICIPIUL SEBES",4,1874,1,1,694,344,285,59,336,8,759,415,154,182,
1,"ALBA",10,1874,,142,1,"UNITATE MILITARA","MUNICIPIUL SEBES",4,1874,1,1,0,163,0,163,156,7,200,37,60,96,
1,"ALBA",10,8096,,143,0,"CAMIN CULTURAL","ORAS TEIUS",10,8096,2,1,1526,839,784,55,825,14,1680,841,477,348,
1,"ALBA",10,8096,,144,0,"SCOALA GENERALA","ORAS TEIUS",10,8096,2,1,1258,628,577,51,622,6,1379,751,337,285,
1,"ALBA",10,8096,,145,0,"LICEUL TEORETIC","ORAS TEIUS",10,8096,2,1,1512,775,723,52,759,16,1660,885,437,322,
1,"ALBA",10,8096,,146,0,"GARA CFR","ORAS TEIUS",10,8096,2,1,796,636,418,218,625,11,1880,1244,340,285,
1,"ALBA",10,8096,,147,0,"GARA CFR","ORAS TEIUS",10,8096,2,1,199,143,129,14,141,2,220,77,64,77,
1,"ALBA",10,8096,,148,0,"SCOALA GENERALA","ORAS TEIUS",10,8096,2,1,252,180,159,21,174,6,280,100,70,104,
1,"ALBA",10,8096,,149,0,"SCOLA GENERALA","ORAS TEIUS",10,8096,2,1,197,127,113,14,125,2,221,94,64,61,
1,"ALBA",10,1936,,150,0,"STR PIATA UNIRII NR.4","ORAS ZLATNA",11,1936,2,1,1240,772,709,63,766,6,1362,590,435,331,
1,"ALBA",10,1936,,151,0,"STR T VLADIMIRESCU NR.14","ORAS ZLATNA",11,1936,2,1,1351,839,717,122,831,8,1500,661,430,401,
1,"ALBA",10,1936,,152,0,"STR VALEA MORILOR NR.5","ORAS ZLATNA",11,1936,2,1,945,578,540,38,574,4,1052,474,304,270,
1,"ALBA",10,1936,,153,0,"CAMINUL CULTURAL","ORAS ZLATNA",11,1936,2,1,1200,742,680,62,732,10,1322,580,229,503,
1,"ALBA",10,1936,,154,0,"CAMINUL CULTURAL","ORAS ZLATNA",11,1936,2,1,678,373,328,45,370,3,762,389,138,232,
1,"ALBA",10,1936,,155,0,"CAMIN CULTURAL","ORAS ZLATNA",11,1936,2,1,508,333,306,27,330,3,562,229,161,169,
1,"ALBA",10,1936,,156,0,"SCOLA GENERALA","ORAS ZLATNA",11,1936,2,1,483,262,242,20,261,1,542,280,70,191,
1,"ALBA",10,1936,,157,0,"CAMIN CULTURAL","ORAS ZLATNA",11,1936,2,1,373,290,257,33,287,3,422,132,102,185,
1,"ALBA",10,1936,,158,0,"SCOLA GENERALA","ORAS ZLATNA",11,1936,2,1,245,179,142,37,177,2,272,93,48,129,
1,"ALBA",10,2130,,159,0,"SCOALA GENERALA","ALBAC",12,2130,0,3,1690,935,840,95,926,9,1860,925,282,644,
1,"ALBA",10,2130,,160,0,"SCOALA PRIMARA","ALBAC",12,2130,0,3,152,95,85,10,93,2,170,75,34,59,
1,"ALBA",10,2309,,161,0,"CONSILIUL LOCAL","ALMASU MARE",13,2309,0,3,476,229,203,26,229,0,530,301,75,154,
1,"ALBA",10,2309,,162,0,"SCOALA PRIMARA NR.2","ALMASU MARE",13,2309,0,3,294,226,123,103,222,4,320,94,90,132,
1,"ALBA",10,2309,,163,0,"SCOALA PRIMARA","ALMASU MARE",13,2309,0,3,182,123,112,11,118,5,200,77,33,85,
1,"ALBA",10,2309,,164,0,"CAMIN CULTURAL","ALMASU MARE",13,2309,0,3,328,195,179,16,192,3,352,157,105,87,
1,"ALBA",10,2309,,165,0,"SCOALA PRIMARA","ALMASU MARE",13,2309,0,3,188,147,135,12,147,0,210,63,59,88,
1,"ALBA",10,2381,,166,0,"STR CENTRU NR.19 PRIMARIA","ARIESENI",14,2381,0,3,1238,778,697,81,768,10,1370,592,307,461,
1,"ALBA",10,2381,,167,0,"NR.100 SCOALA PRIMARA","ARIESENI",14,2381,0,3,92,70,64,6,70,0,100,30,17,53,
1,"ALBA",10,2381,,168,0,"NR.576A SCOALA PRIMARA","ARIESENI",14,2381,0,3,218,124,108,16,123,1,240,116,34,89,
1,"ALBA",10,2577,,169,0,"SCOALA GENERALA","AVRAM IANCU",15,2577,0,3,931,531,477,54,522,9,1030,499,143,379,
1,"ALBA",10,2577,,170,0,"SCOALA GENERALA","AVRAM IANCU",15,2577,0,3,760,426,377,49,418,8,840,414,96,322,
1,"ALBA",10,2988,,171,0,"CAMIN CULTURAL","BERGHIN",16,2988,0,3,535,303,251,52,296,7,592,289,162,134,
1,"ALBA",10,2988,,172,0,"SCOALA GENERALA","BERGHIN",16,2988,0,3,557,328,303,25,322,6,608,280,155,167,
1,"ALBA",10,2988,,173,0,"SCOALA GENERALA","BERGHIN",16,2988,0,3,341,204,178,26,203,1,380,176,119,84,
1,"ALBA",10,2988,,174,0,"SCOALA GENERALA","BERGHIN",16,2988,0,3,294,204,174,30,201,3,332,128,103,98,
1,"ALBA",10,3039,,175,0,"SCOALA GENERALA NR.1","BISTRA",17,3039,0,3,991,614,525,89,611,3,1090,476,173,438,
1,"ALBA",10,3039,,176,0,"SCOAL GENERALA NR.2","BISTRA",17,3039,0,3,1758,875,843,32,868,7,1932,1057,344,524,
1,"ALBA",10,3039,,177,0,"SCOALA GENERALA","BISTRA",17,3039,0,3,686,411,390,21,409,2,760,349,142,267,
1,"ALBA",10,3039,,178,0,"SCOALA GENERALA","BISTRA",17,3039,0,3,602,342,324,18,338,4,660,318,121,217,
1,"ALBA",10,3397,,179,0,"NR.15 CAMIN CULTURAL","BLANDIANA",18,3397,0,3,527,304,250,54,300,4,580,276,101,199,
1,"ALBA",10,3397,,180,0,"NR.173 SCOALA GENERALA","BLANDIANA",18,3397,0,3,397,220,187,33,216,4,440,220,113,103,
1,"ALBA",10,3397,,181,0,"NR.15 SCOALA GENERALA","BLANDIANA",18,3397,0,3,56,37,24,13,37,0,60,23,10,27,
1,"ALBA",10,3459,,182,0,"PRIMARIA","BUCIUM",19,3459,0,3,496,276,235,41,274,2,550,274,129,145,
1,"ALBA",10,3459,,183,0,"SCOALA GENERALA","BUCIUM",19,3459,0,3,476,276,235,41,276,0,522,246,129,147,
1,"ALBA",10,3459,,184,0,"CAMIN CULTURAL","BUCIUM",19,3459,0,3,298,202,171,31,200,2,330,128,74,126,
1,"ALBA",10,3459,,185,0,"SCOALA GENERALA","BUCIUM",19,3459,0,3,354,202,181,21,201,1,390,188,92,109,
1,"ALBA",10,3761,,186,0,"CONSILIUL LOCAL","CENADE",21,3761,0,3,785,372,321,51,368,4,860,488,148,220,
1,"ALBA",10,3805,,187,0,"SCOALA GENERALA","CERGAU",22,3805,0,3,804,441,407,34,439,2,882,441,215,224,
1,"ALBA",10,3805,,188,0,"SCOALA GENERALA","CERGAU",22,3805,0,3,304,200,182,18,198,2,342,142,79,119,
1,"ALBA",10,3805,,189,0,"SCOALA GENERALA","CERGAU",22,3805,0,3,288,209,184,25,207,2,320,111,128,79,
1,"ALBA",10,3841,,190,0,"CAMIN CULTURAL","CERU-BACAINTI",23,3841,0,3,336,131,105,26,128,3,370,239,53,75,
1,"ALBA",10,3958,,191,0,"CAMIN CULTURAL","CETATEA DE BALTA",24,3958,0,3,1570,882,822,60,854,28,1726,844,521,333,
1,"ALBA",10,3958,,192,0,"SCOALA GENERALA","CETATEA DE BALTA",24,3958,0,3,194,163,121,42,156,7,210,47,56,100,
1,"ALBA",10,3958,,193,0,"SCOALA GENERALA","CETATEA DE BALTA",24,3958,0,3,584,395,347,48,390,5,640,245,268,122,
1,"ALBA",10,3958,,194,0,"SCOALA GENERALA","CETATEA DE BALTA",24,3958,0,3,243,187,154,33,184,3,270,83,125,59,
1,"ALBA",10,4106,,195,0,"CONSILIUL LOCAL","CALNIC",20,4106,0,3,885,452,376,76,442,10,982,530,280,162,
1,"ALBA",10,4106,,196,0,"SCOALA GENERALA","CALNIC",20,4106,0,3,1011,477,420,57,468,9,1120,643,184,284,
1,"ALBA",10,4106,,197,0,"FOST SEDIU CAP","CALNIC",20,4106,0,3,384,218,188,30,215,3,422,204,62,153,
1,"ALBA",10,1071,,198,0,"NR.157 CONSILIUL LOCAL","CIUGUD",25,1071,0,3,596,344,315,29,335,9,660,316,191,144,
1,"ALBA",10,1071,,199,0,"SCOALA GENERALA","CIUGUD",25,1071,0,3,478,272,246,26,266,6,505,233,129,137,
1,"ALBA",10,1071,,200,0,"SCOALA GENERALA","CIUGUD",25,1071,0,3,606,321,303,18,316,5,670,349,154,162,
1,"ALBA",10,1071,,201,0,"SCOALA GENERALA","CIUGUD",25,1071,0,3,374,242,213,29,232,10,410,168,135,97,
1,"ALBA",10,4008,,202,0,"CONSILIUL LOCAL","CIURULEASA",26,4008,0,3,1138,623,589,34,614,9,1260,637,200,414,
1,"ALBA",10,4188,,203,0,"STR 6 MARTIE NR.133","CRACIUNELU DE JOS",27,4188,0,3,1599,852,792,60,847,5,1760,908,502,345,
1,"ALBA",10,4188,,204,0,"NR.6 FOSTUL LOCAL AL PRIMARIEI","CRACIUNELU DE JOS",27,4188,0,3,1785,947,889,58,873,16,1970,1081,548,325,
1,"ALBA",10,4142,,205,0,"NR.318 CAMIN CULTURAL","CRICAU",28,4142,0,3,966,543,465,78,532,11,1070,527,233,299,
1,"ALBA",10,4142,,206,0,"NR.76 SCOALA PRIMARA","CRICAU",28,4142,0,3,274,157,137,20,152,5,300,143,74,78,
1,"ALBA",10,4142,,207,0,"NR.98 SCOALA PRIMARA","CRICAU",28,4142,0,3,317,209,163,46,207,2,350,141,83,124,
1,"ALBA",10,4240,,208,0,"CAMIN CULTURAL","DAIA ROMANA",29,4240,0,3,2435,1050,1003,47,1029,21,2680,1630,524,505,
1,"ALBA",10,4268,,209,0,"CAMINUL MIC","DOSTAT",30,4268,0,3,541,323,290,33,317,6,600,277,130,187,
1,"ALBA",10,4268,,210,0,"SCOALA PRIMARA","DOSTAT",30,4268,0,3,301,197,169,28,193,4,330,133,119,74,
1,"ALBA",10,4302,,211,0,"SCOALA GENERALA","FARAU",31,4302,0,3,590,321,298,23,316,5,650,329,88,228,
1,"ALBA",10,4302,,212,0,"SCOALA GENERALA","FARAU",31,4302,0,3,288,172,152,20,171,1,320,148,92,79,
1,"ALBA",10,4302,,213,0,"SCOALA GENERALA","FARAU",31,4302,0,3,308,188,164,24,182,6,340,152,69,113,
1,"ALBA",10,4302,,214,0,"SCOALA GENERALA","FARAU",31,4302,0,3,201,100,85,15,97,3,220,120,89,8,
1,"ALBA",10,4302,,215,0,"SCOALA GENERALA","FARAU",31,4302,0,3,371,197,175,22,194,3,410,213,97,97,
1,"ALBA",10,4366,,216,0,"CAMIN CULTURAL","GALDA DE JOS",32,4366,0,3,1519,826,717,109,818,8,1670,844,357,461,
1,"ALBA",10,4366,,217,0,"SCOALA GENERALA","GALDA DE JOS",32,4366,0,3,670,362,300,62,357,5,742,380,232,125,
1,"ALBA",10,4366,,218,0,"SCOALA GENERALA","GALDA DE JOS",32,4366,0,3,394,237,191,46,235,2,432,195,105,130,
1,"ALBA",10,4366,,219,0,"SCOALA GENERALA","GALDA DE JOS",32,4366,0,3,476,237,205,32,235,2,520,283,86,149,
1,"ALBA",10,4366,,220,0,"SCOALA GENERALA","GALDA DE JOS",32,4366,0,3,548,312,259,53,306,6,600,288,77,229,
1,"ALBA",10,4482,,221,0,"SCOALA GENERALA","GARBOVA",33,4482,0,3,1055,591,499,92,583,8,1160,569,331,252,
1,"ALBA",10,4482,,222,0,"FOST SEDIU CAP","GARBOVA",33,4482,0,3,267,196,146,50,194,2,300,104,69,125,
1,"ALBA",10,4482,,223,0,"FOST SEDIU CAP","GARBOVA",33,4482,0,3,180,168,122,46,164,4,200,32,55,109,
1,"ALBA",10,4525,,224,0,"NR.50A SCOALA GENERALA NR.1","GARDA DE SUS",34,4525,0,3,981,596,460,136,584,12,1080,484,247,337,
1,"ALBA",10,4525,,225,0,"NR.778 SCOALA GENERALA NR.2","GARDA DE SUS",34,4525,0,3,464,278,213,65,272,6,510,232,111,161,
1,"ALBA",10,4525,,226,0,"NR.777 SCOALA GENERALA","GARDA DE SUS",34,4525,0,3,160,77,63,14,77,0,182,105,23,54,
1,"ALBA",10,4703,,227,0,"CAMIN CULTURAL","HOPARTA",35,4703,0,3,338,226,208,18,221,5,370,144,98,123,
1,"ALBA",10,4703,,228,0,"CAMIN CULTURAL","HOPARTA",35,4703,0,3,160,137,113,24,135,2,180,43,77,58,
1,"ALBA",10,4703,,229,0,"SCOALA GENERALA","HOPARTA",35,4703,0,3,241,164,142,22,160,4,270,106,70,90,
1,"ALBA",10,4703,,230,0,"CAMIN CULTURAL","HOPARTA",35,4703,0,3,264,191,154,37,189,2,290,99,88,101,
1,"ALBA",10,4703,,231,0,"SCOALA GENERALA","HOPARTA",35,4703,0,3,173,126,107,19,124,2,192,66,50,74,
1,"ALBA",10,4767,,232,0,"SCOALA GENERALA","HOREA",36,4767,0,3,804,673,590,83,584,89,1070,397,308,276,
1,"ALBA",10,4767,,233,0,"CAMIN CULTURAL","HOREA",36,4767,0,3,381,298,284,14,296,2,450,152,127,169,
1,"ALBA",10,4767,,234,0,"SCOALA PRIMARA","HOREA",36,4767,0,3,376,287,274,13,243,44,450,163,131,112,
1,"ALBA",10,4767,,235,0,"MAGAZIN MIXT","HOREA",36,4767,0,3,195,190,174,16,190,0,230,40,102,88,
1,"ALBA",10,4927,,236,0,"SCOALA GENERALA","IGHIU",37,4927,0,3,805,453,382,71,447,6,890,437,283,164,
1,"ALBA",10,4927,,237,0,"SCOALA GENERALA","IGHIU",37,4927,0,3,966,550,449,101,542,8,1070,520,261,281,
1,"ALBA",10,4927,,238,0,"SCOALA GENERALA","IGHIU",37,4927,0,3,829,401,361,40,397,4,912,511,110,287,
1,"ALBA",10,4927,,239,0,"SCOALA GENERALA","IGHIU",37,4927,0,3,1468,725,633,92,712,13,1630,905,331,381,
1,"ALBA",10,4927,,240,0,"SCOALA GENERALA","IGHIU",37,4927,0,3,947,436,393,43,432,4,1042,606,207,225,
1,"ALBA",10,4981,,241,0,"SCOALA GENERALA","INTREGALDE",38,4981,0,3,371,170,144,26,165,5,410,240,51,114,
1,"ALBA",10,4981,,242,0,"NR.37 SCOALA PRIMARA","INTREGALDE",38,4981,0,3,191,142,111,31,142,0,220,78,15,127,
1,"ALBA",10,4981,,243,0,"NR.52 SCOALA PRIMARA","INTREGALDE",38,4981,0,3,151,81,55,26,80,1,170,89,10,70,
1,"ALBA",10,4981,,244,0,"NR.28 SCOALA PRIMARA","INTREGALDE",38,4981,0,3,102,93,60,33,91,2,110,17,28,63,
1,"ALBA",10,5103,,245,0,"CAMIN CULTURAL","JIDVEI",39,5103,0,3,922,585,497,88,567,18,1010,425,305,262,
1,"ALBA",10,5103,,246,0,"SCOALA GENERALA","JIDVEI",39,5103,0,3,891,501,456,45,497,4,980,479,302,195,
1,"ALBA",10,5103,,247,0,"SCOALA GENERALA","JIDVEI",39,5103,0,3,682,420,382,38,416,4,750,330,194,222,
1,"ALBA",10,5103,,248,0,"CAMIN CULTURAL","JIDVEI",39,5103,0,3,775,528,493,35,519,9,860,332,279,240,
1,"ALBA",10,5103,,249,0,"FOST SEDIU CAP","JIDVEI",39,5103,0,3,782,524,484,40,517,7,860,336,366,151,
1,"ALBA",10,5167,,250,0,"CAMIN CULTURAL","LIVEZILE",40,5167,0,3,640,383,362,21,382,1,700,317,167,215,
1,"ALBA",10,5167,,251,0,"NR.26 SCOALA GENERALA","LIVEZILE",40,5167,0,3,228,151,133,18,148,3,250,99,42,106,
1,"ALBA",10,5167,,252,0,"CAMIN CULTURAL","LIVEZILE",40,5167,0,3,377,260,237,23,252,8,416,156,148,104,
1,"ALBA",10,5167,,253,0,"NR.41 SCOALA GENERALA","LIVEZILE",40,5167,0,3,200,140,124,16,138,2,220,80,66,72,
1,"ALBA",10,5210,,254,0,"PRIMARIA -SALA DE CUNUNII","LOPADEA NOUA",41,5210,0,3,881,517,495,22,507,10,970,453,481,26,
1,"ALBA",10,5210,,255,0,"FOST SEDIU CAP","LOPADEA NOUA",41,5210,0,3,168,130,114,16,129,1,190,60,82,47,
1,"ALBA",10,5210,,256,0,"SCOALA PRIMARA","LOPADEA NOUA",41,5210,0,3,461,289,247,42,285,4,510,221,161,124,
1,"ALBA",10,5210,,257,0,"SCOALA GENERALA","LOPADEA NOUA",41,5210,0,3,489,218,203,15,215,3,540,322,187,28,
1,"ALBA",10,5210,,258,0,"DISPENSAR","LOPADEA NOUA",41,5210,0,3,604,426,396,30,422,4,672,246,188,234,
1,"ALBA",10,5309,,259,0,"SCOALA GENERALA","LUNCA MURESULUI",42,5309,0,3,1620,863,798,65,853,10,1780,917,575,278,
1,"ALBA",10,5309,,260,0,"SCOALA GENERALA","LUNCA MURESULUI",42,5309,0,3,480,304,253,51,300,4,480,176,119,181,
1,"ALBA",10,5336,,261,0,"CAMIN CULTURAL","LUPSA",43,5336,0,3,1035,673,584,89,663,10,1130,457,193,470,
1,"ALBA",10,5336,,262,0,"FOST SEDIU PRIMARIE","LUPSA",43,5336,0,3,1097,533,490,43,530,3,1210,677,160,370,
1,"ALBA",10,5336,,263,0,"SCOALA PRIMARA","LUPSA",43,5336,0,3,742,478,432,46,472,6,820,342,121,351,
1,"ALBA",10,5336,,264,0,"LOCUINTA -NICOARA TRAIAN","LUPSA",43,5336,0,3,156,98,74,24,98,0,180,82,21,77,
1,"ALBA",10,5577,,265,0,"SCOALA GENERALA","METES",44,5577,0,3,360,219,193,26,217,2,390,171,83,134,
1,"ALBA",10,5577,,266,0,"SCOALA GENERALA","METES",44,5577,0,3,273,171,146,25,170,1,302,131,78,92,
1,"ALBA",10,5577,,267,0,"SCOALA GENERALA","METES",44,5577,0,3,596,268,246,22,262,6,662,394,116,146,
1,"ALBA",10,5577,,268,0,"SCOALA GENERALA","METES",44,5577,0,3,574,342,306,36,342,0,630,288,146,196,
1,"ALBA",10,5577,,269,0,"SCOALA GENERALA","METES",44,5577,0,3,578,397,348,49,394,3,642,245,137,257,
1,"ALBA",10,5577,,270,0,"SCOALA GENERALA","METES",44,5577,0,3,218,136,104,32,129,7,240,104,26,103,
1,"ALBA",10,5700,,271,0,"SCOALA GENERALA","MIHALT",45,5700,0,3,1874,1377,1296,81,1342,35,2060,683,739,603,
1,"ALBA",10,5700,,272,0,"SCOALA GENERALA","MIHALT",45,5700,0,3,484,367,333,34,358,9,530,163,226,132,
1,"ALBA",10,5700,,273,0,"GRADINITA","MIHALT",45,5700,0,3,493,341,285,56,335,6,542,201,193,142,
1,"ALBA",10,5755,,274,0,"NR.109 SCOALA GENERALA","MIRASLAU",46,5755,0,3,195,117,96,21,114,3,220,103,41,73,
1,"ALBA",10,5755,,275,0,"NR.65 SCOALA GENERALA","MIRASLAU",46,5755,0,3,566,369,304,65,367,2,620,251,276,91,
1,"ALBA",10,5755,,276,0,"NR.207 SCOALA GENERALA","MIRASLAU",46,5755,0,3,330,249,201,48,240,9,370,121,128,112,
1,"ALBA",10,5755,,277,0,"NR.84 GRADINITA","MIRASLAU",46,5755,0,3,729,439,401,38,424,15,800,361,304,120,
1,"ALBA",10,5755,,278,0,"NR.54 ORMENIS","MIRASLAU",46,5755,0,3,104,82,62,20,80,2,120,38,38,42,
1,"ALBA",10,5826,,279,0,"CONSILIUL LOCAL","MOGOS",47,5826,0,3,708,342,301,41,332,10,780,438,117,215,
1,"ALBA",10,5826,,280,0,"SCOALA GENERALA","MOGOS",47,5826,0,3,376,178,151,27,175,3,420,242,36,139,
1,"ALBA",10,6048,,281,0,"CONSILIUL LOCAL","NOSLAC",48,6048,0,3,1059,587,484,103,581,6,1162,575,343,238,
1,"ALBA",10,6048,,282,0,"SCOALA GENERALA","NOSLAC",48,6048,0,3,430,248,210,38,248,0,470,222,158,90,
1,"ALBA",10,6048,,283,0,"SCOALA GENERALA","NOSLAC",48,6048,0,3,250,125,99,26,123,2,280,155,63,60,
1,"ALBA",10,6119,,284,0,"INTERNAT SCOLAR","OCOLIS",49,6119,0,3,404,184,157,27,182,2,442,258,68,114,
1,"ALBA",10,6119,,285,0,"SCOALA PRIMARA","OCOLIS",49,6119,0,3,146,85,68,17,84,1,160,75,17,67,
1,"ALBA",10,6119,,286,0,"SCOALA PRIMARA","OCOLIS",49,6119,0,3,109,97,64,33,97,0,122,25,26,71,
1,"ALBA",10,6119,,287,0,"SCOALA PRIMARA","OCOLIS",49,6119,0,3,87,74,55,19,74,0,100,26,20,54,
1,"ALBA",10,6164,,288,0,"CONSILIUL LOCAL","OHABA",50,6164,0,3,573,309,276,33,301,8,630,321,156,145,
1,"ALBA",10,6164,,289,0,"CAMERA AGRICOLA","OHABA",50,6164,0,3,254,190,164,26,186,4,280,90,52,134,
1,"ALBA",10,6164,,290,0,"SCOALA GENERALA","OHABA",50,6164,0,3,67,66,39,27,64,2,80,14,12,52,
1,"ALBA",10,6217,,291,0,"CAMIN CULTURAL","PIANU",51,6217,0,3,1353,662,607,55,646,16,1500,838,267,379,
1,"ALBA",10,6217,,292,0,"SC PRIMARA","PIANU",51,6217,0,3,965,519,458,61,514,5,1058,539,241,273,
1,"ALBA",10,6217,,293,0,"SCOALA GENERALA","PIANU",51,6217,0,3,147,100,74,26,96,4,159,59,54,42,
1,"ALBA",10,6217,,294,0,"SCOALA PRIMARA","PIANU",51,6217,0,3,275,97,84,13,97,0,299,202,47,50,
1,"ALBA",10,6217,,295,0,"SCOALA PRIMARA","PIANU",51,6217,0,3,62,47,27,20,47,0,70,23,17,30,
1,"ALBA",10,6271,,296,0,"CAMIN CULTURAL","POIANA VADULUI",52,6271,0,3,1097,422,399,23,419,3,1184,762,76,343,
1,"ALBA",10,6397,,297,0,"CONSILIUL LOCAL","PONOR",53,6397,0,3,417,201,168,33,196,5,462,261,41,155,
1,"ALBA",10,6397,,298,0,"CAMIN CULTURAL","PONOR",53,6397,0,3,302,183,136,47,178,5,330,147,28,150,
1,"ALBA",10,6468,,299,0,"NR.257 CAMIN CULTURAL","POSAGA",54,6468,0,3,444,267,226,41,260,7,492,225,81,179,
1,"ALBA",10,6468,,300,0,"NR.50 SCOALA PRIMARA","POSAGA",54,6468,0,3,193,142,104,38,140,2,210,68,56,84,
1,"ALBA",10,6468,,301,0,"NR.355 SCOALA GENERALA","POSAGA",54,6468,0,3,191,105,90,15,104,1,212,107,35,69,
1,"ALBA",10,6468,,302,0,"NR.547 SCOALA PRIMARA","POSAGA",54,6468,0,3,276,166,155,11,163,3,309,143,28,135,
1,"ALBA",10,6468,,303,0,"NR.421 SCOALA PRIMARA","POSAGA",54,6468,0,3,129,79,63,16,78,1,142,63,13,65,
1,"ALBA",10,6547,,304,0,"STR PRINCIPALA NR.22","RADESTI",55,6547,0,3,867,523,475,48,507,16,941,418,366,141,
1,"ALBA",10,6547,,305,0,"NR.125 SCOALA GENERALA","RADESTI",55,6547,0,3,325,171,143,28,165,6,364,193,107,58,
1,"ALBA",10,6627,,306,0,"SCOALA GENERALA","RAMET",56,6627,0,3,316,113,101,12,110,3,350,237,28,82,
1,"ALBA",10,6627,,307,0,"SCOALA PRIMARA","RAMET",56,6627,0,3,174,162,108,54,156,6,190,28,113,43,
1,"ALBA",10,6627,,308,0,"SCOALA PRIMARA","RAMET",56,6627,0,3,160,105,89,16,103,2,180,75,30,73,
1,"ALBA",10,6627,,309,0,"SCOALA PRIMARA","RAMET",56,6627,0,3,130,46,39,7,46,0,140,94,18,28,
1,"ALBA",10,6592,,310,0,"CAMIN CULTURAL","RAMETEA",57,6592,0,3,489,333,276,57,329,4,540,207,311,18,
1,"ALBA",10,6592,,311,0,"CAMIN CULTURAL","RAMETEA",57,6592,0,3,542,290,274,16,282,8,600,310,270,12,
1,"ALBA",10,6930,,312,0,"STR PRINCIPALA NR.458","ROSIA DE SECAS",58,6930,0,3,642,396,337,59,384,12,710,314,206,178,
1,"ALBA",10,6930,,313,0,"NR.357 FOST SEDIU CAP","ROSIA DE SECAS",58,6930,0,3,439,233,197,36,232,1,490,257,108,124,
1,"ALBA",10,6930,,314,0,"NR.217 CAMIN CULTURAL","ROSIA DE SECAS",58,6930,0,3,252,149,125,24,147,2,280,131,89,58,
1,"ALBA",10,6761,,315,0,"CONSILIUL LOCAL","ROSIA MONTANA",59,6761,0,3,1411,856,790,66,848,8,1558,702,446,402,
1,"ALBA",10,6761,,316,0,"SCOALA GENERALA","ROSIA MONTANA",59,6761,0,3,1171,679,596,83,672,7,1289,610,289,383,
1,"ALBA",10,6761,,317,0,"SCOALA PRIMARA","ROSIA MONTANA",59,6761,0,3,304,209,179,30,207,2,330,121,63,144,
1,"ALBA",10,6761,,318,0,"SCOALA PRIMARA","ROSIA MONTANA",59,6761,0,3,224,131,99,32,130,1,250,119,40,90,
1,"ALBA",10,6976,,319,0,"SCOALA PRIMARA","SALCIUA",60,6976,0,3,770,472,423,49,468,4,850,378,216,252,
1,"ALBA",10,6976,,320,0,"SCOALA PRIMARA","SALCIUA",60,6976,0,3,696,403,348,55,400,3,770,367,160,240,
1,"ALBA",10,7044,,321,0,"STR JOSENI NR.477","SALISTEA",61,7044,0,3,1184,743,666,77,736,7,1310,567,353,383,
1,"ALBA",10,7044,,322,0,"STR PRINCIPALA NR.34","SALISTEA",61,7044,0,3,607,396,328,68,392,4,670,274,207,185,
1,"ALBA",10,7044,,323,0,"NR.11 FOSTA SCOALA PRIMARA","SALISTEA",61,7044,0,3,61,34,15,19,34,0,72,38,19,15,
1,"ALBA",10,7099,,324,0,"STR PRINCIPALA NR.380","SASCIORI",64,7099,0,3,1570,870,777,93,856,14,1740,870,357,499,
1,"ALBA",10,7099,,325,0,"STR PRINCIPALA SCOALA GENERALA","SASCIORI",64,7099,0,3,671,336,303,33,326,10,740,404,114,212,
1,"ALBA",10,7099,,326,0,"NR.26 FOST SEDIU SFAT POPULAR","SASCIORI",64,7099,0,3,763,269,248,21,263,6,840,571,123,140,
1,"ALBA",10,7099,,327,0,"CAMIN CULTURAL","SASCIORI",64,7099,0,3,521,320,285,35,315,5,580,260,175,140,
1,"ALBA",10,7099,,328,0,"SCOALA GENERALA","SASCIORI",64,7099,0,3,798,492,433,59,483,9,880,388,252,231,
1,"ALBA",10,7197,,329,0,"CAMIN CULTURAL","SCARISOARA",65,7197,0,3,1443,721,655,66,715,6,1610,889,284,431,
1,"ALBA",10,7197,,330,0,"SCOALA GENERALA","SCARISOARA",65,7197,0,3,218,181,86,95,180,1,240,59,53,127,
1,"ALBA",10,7810,,331,0,"SCOALA GENERALA","SIBOT",66,7810,0,3,1032,535,458,77,527,8,1140,605,313,214,
1,"ALBA",10,7810,,332,0,"SCOALA GENERALA","SIBOT",66,7810,0,3,492,297,249,48,293,4,540,243,150,143,
1,"ALBA",10,7810,,333,0,"COMIN CULTURAL","SIBOT",66,7810,0,3,232,149,97,52,147,2,260,111,44,103,
1,"ALBA",10,7810,,334,0,"SCOALA GENERALA","SIBOT",66,7810,0,3,188,96,71,25,96,0,212,116,56,40,
1,"ALBA",10,7348,,335,0,"CAMIN CULTURAL","SANCEL",62,7348,0,3,1353,703,655,48,692,11,1489,786,390,302,
1,"ALBA",10,7348,,336,0,"SCOALA GENERALA","SANCEL",62,7348,0,3,374,183,162,21,181,2,407,224,87,94,
1,"ALBA",10,7348,,337,0,"SCOALA GENERALA","SANCEL",62,7348,0,3,578,357,319,38,351,6,640,283,192,159,
1,"ALBA",10,7384,,338,0,"CAMIN CULTURAL","SANTIMBRU",63,7384,0,3,1264,685,578,107,681,4,1390,705,298,383,
1,"ALBA",10,7384,,339,0,"SCOALA PRIMARA","SANTIMBRU",63,7384,0,3,319,190,168,22,190,0,350,160,97,93,
1,"ALBA",10,7384,,340,0,"SCOALA PRIMARA","SANTIMBRU",63,7384,0,3,550,335,283,52,333,2,610,275,133,200,
1,"ALBA",10,7446,,341,0,"CAMIN CULTURAL","SOHODOL",67,7446,0,3,1780,764,742,22,758,6,1960,1196,239,519,
1,"ALBA",10,7865,,342,0,"CONSILIUL LOCAL","SONA",68,7865,0,3,735,416,341,75,413,3,810,394,268,145,
1,"ALBA",10,7865,,343,0,"SCOALA PRIMARA","SONA",68,7865,0,3,243,106,93,13,103,3,270,164,76,27,
1,"ALBA",10,7865,,344,0,"NR.471 GRADINITA","SONA",68,7865,0,3,1139,583,548,35,579,4,1250,667,337,242,
1,"ALBA",10,7865,,345,0,"GRADINITA","SONA",68,7865,0,3,1105,678,629,49,645,33,1206,528,523,122,
1,"ALBA",10,7865,,346,0,"SCOALA PRIMARA","SONA",68,7865,0,3,385,225,207,18,219,6,420,195,112,107,
1,"ALBA",10,7945,,347,0,"CONSILIUL LOCAL","SPRING",69,7945,0,3,609,391,336,55,387,4,670,279,187,200,
1,"ALBA",10,7945,,348,0,"SCOALA GENERALA","SPRING",69,7945,0,3,454,339,302,37,336,3,500,161,136,200,
1,"ALBA",10,7945,,349,0,"SCOALA GENERALA","SPRING",69,7945,0,3,436,318,273,45,314,4,480,162,160,154,
1,"ALBA",10,7945,,350,0,"SEDIUL FOSTEI PRIMARII","SPRING",69,7945,0,3,547,317,261,56,314,3,597,280,179,135,
1,"ALBA",10,7767,,351,0,"NR.97 SCOALA GENERALA","STREMT",70,7767,0,3,1159,578,537,41,567,11,1300,722,269,298,
1,"ALBA",10,7767,,352,0,"NR.270 SCOALA GENERALA","STREMT",70,7767,0,3,752,386,346,40,381,5,830,444,104,277,
1,"ALBA",10,7767,,353,0,"NR.185 SCOALA PRIMARA","STREMT",70,7767,0,3,350,210,187,23,208,2,390,180,89,119,
1,"ALBA",10,8014,,354,0,"CAMIN CULTURAL","SUGAG",71,8014,0,3,1729,843,659,184,829,14,2000,1157,272,557,
1,"ALBA",10,8014,,355,0,"SCOALA GENERALA","SUGAG",71,8014,0,3,390,224,199,25,219,5,440,216,65,154,
1,"ALBA",10,8014,,356,0,"SCOALA PRIMARA","SUGAG",71,8014,0,3,67,112,30,82,112,0,302,190,34,78,
1,"ALBA",10,8158,,357,0,"STR AVRAM IANCU NR.76","UNIREA",72,8158,0,3,1903,926,812,114,918,8,2090,1164,559,359,
1,"ALBA",10,8158,,358,0,"STR SCOLII NR.1142","UNIREA",72,8158,0,3,1154,610,543,67,602,8,1270,660,282,320,
1,"ALBA",10,8158,,359,0,"SCOALA GENERALA","UNIREA",72,8158,0,3,218,137,111,26,136,1,240,103,65,71,
1,"ALBA",10,8158,,360,0,"SCOALA GENERALA","UNIREA",72,8158,0,3,364,188,162,26,186,2,400,212,104,82,
1,"ALBA",10,8158,,361,0,"SCOALA GENERALA","UNIREA",72,8158,0,3,168,146,98,48,140,6,190,44,45,95,
1,"ALBA",10,8158,,362,0,"SCOALA GENERALA","UNIREA",72,8158,0,3,322,202,167,35,198,4,350,148,82,116,
1,"ALBA",10,8158,,363,0,"SCOALA GENERALA","UNIREA",72,8158,0,3,322,224,172,52,220,4,350,126,101,119,
1,"ALBA",10,8229,,364,0,"CAMIN CULTURAL","VADU MOTILOR",73,8229,0,3,1274,655,591,64,651,4,1400,745,220,431,
1,"ALBA",10,8354,,365,0,"CONSILIUL LOCAL","VALEA LUNGA",74,8354,0,3,1404,612,517,95,604,8,1539,927,315,289,
1,"ALBA",10,8354,,366,0,"CAMIN CULTURAL","VALEA LUNGA",74,8354,0,3,342,269,217,52,264,5,380,111,153,111,
1,"ALBA",10,8354,,367,0,"SCOALA GENERALA","VALEA LUNGA",74,8354,0,3,237,143,114,29,142,1,262,117,76,66,
1,"ALBA",10,8354,,368,0,"SCOALA GENERALA","VALEA LUNGA",74,8354,0,3,206,114,94,20,114,0,230,116,51,63,
1,"ALBA",10,8354,,369,0,"SCOALA GENERALA","VALEA LUNGA",74,8354,0,3,475,334,297,37,328,6,520,186,94,234,
1,"ALBA",10,8425,,370,0,"SCOALA GENERALA","VIDRA",75,8425,0,3,853,440,404,36,427,13,940,500,84,343,
1,"ALBA",10,8425,,371,0,"SCOALA PRIMAR","VIDRA",75,8425,0,3,932,557,535,22,554,3,1020,463,190,364,
1,"ALBA",10,8826,,372,0,"CAMIN CULTURAL","VINTU DE JOS",76,8826,0,3,2508,1182,1031,151,1167,15,2770,1588,632,535,
1,"ALBA",10,8826,,373,0,"CAMIN CULTURAL","VINTU DE JOS",76,8826,0,3,1211,431,377,54,428,3,1341,910,181,247,
1,"ALBA",10,8826,,374,0,"SCOALA PRIMARA","VINTU DE JOS",76,8826,0,3,365,108,91,17,106,2,410,302,28,78,
2,"ARAD",29,9262,,1,0,"GRUP SCOLAR ECONOMICO-ADMINISTRATIV,P-TA G.ENESCU NR.2","MUNICIPIUL ARAD",1,9262,1,1,1391,818,662,156,804,14,1600,782,595,209,
2,"ARAD",29,9262,,2,0,"POLICLINICA MUNICIPALA,B-DUL REVOLUTIEI NR.45","MUNICIPIUL ARAD",1,9262,1,1,1941,1068,962,106,1042,26,2200,1132,858,184,
2,"ARAD",29,9262,,3,0,"SPITALUL MUNICIPAL SECT.OFTALMOLOGIE,STR.T.VLADIMIRESCU NR.1-SALA DE SPORT","MUNICIPIUL ARAD",1,9262,1,1,1714,1183,878,305,1157,26,1894,711,887,270,
2,"ARAD",29,9262,,4,0,"SCOALA CU CLASELE I-VIII NR.4,B-DUL MRS.ANTONESCU NR.31-35","MUNICIPIUL ARAD",1,9262,1,1,1755,885,824,61,873,12,1906,1021,681,192,
2,"ARAD",29,9262,,5,0,"SCOALA CU CLASELE I-VIII NR.4,B-DUL MRS.ANTONESCU NR.31-35","MUNICIPIUL ARAD",1,9262,1,1,875,487,432,55,474,13,1107,620,384,90,
2,"ARAD",29,9262,,6,0,"SCOALA CU CLASELE I-VIII NR.4,B-DUL MRS.ANTONESCU NR.31-35","MUNICIPIUL ARAD",1,9262,1,1,1900,972,891,81,945,27,2200,1228,744,201,
2,"ARAD",29,9262,,7,0,"SCOALA CU CLASELE I-VIII NR.4,B-DUL MRS.ANTONESCU NR.31-35","MUNICIPIUL ARAD",1,9262,1,1,1318,730,682,48,722,8,1312,582,584,138,
2,"ARAD",29,9262,,8,0,"LICEUL TEORETIC ""V.GOLDIS"",CALEA VICTORIEI NR.3-5","MUNICIPIUL ARAD",1,9262,1,1,1800,1135,829,306,1112,23,1992,857,792,320,
2,"ARAD",29,9262,,9,0,"LICEUL DE ARTA ""SABIN DRAGOI"",B-DUL REVOLUTIEI NR.20-22","MUNICIPIUL ARAD",1,9262,1,1,1343,757,596,161,749,8,1300,543,535,214,
2,"ARAD",29,9262,,10,0,"LICEUL DE ARTA ""SABIN DRAGOI"",B-DUL REVOLUTIEI NR.20-22","MUNICIPIUL ARAD",1,9262,1,1,1604,888,778,110,878,10,2000,1112,639,239,
2,"ARAD",29,9262,,11,0,"GR.SCOLAR IND.TRANSP.CAI FERATE,P-TA ACAD.CAIUS IACOB NR.1","MUNICIPIUL ARAD",1,9262,1,1,1775,1008,850,158,994,14,2000,992,722,272,
2,"ARAD",29,9262,,12,0,"LICEUL BAPTIST,STR.DR.I.SUCIU NR.7-9","MUNICIPIUL ARAD",1,9262,1,1,1098,636,598,38,630,6,1200,564,498,132,
2,"ARAD",29,9262,,13,0,"LICEUL BAPTIST,STR.DR.I.SUCIU NR.7-9","MUNICIPIUL ARAD",1,9262,1,1,1446,806,742,64,793,13,1600,786,617,176,
2,"ARAD",29,9262,,14,0,"GR.SCOLAR IND.""I.MANIU"",B-DUL I.MANIU NR.39-41","MUNICIPIUL ARAD",1,9262,1,1,1723,1016,839,177,1002,14,1900,884,742,260,
2,"ARAD",29,9262,,15,0,"SALA POLIVALENTA,P-TA SPORTURILOR","MUNICIPIUL ARAD",1,9262,1,1,1076,642,582,60,630,12,1197,555,517,113,
2,"ARAD",29,9262,,16,0,"SALA POLIVALENTA,P-TA SPORTURILOR","MUNICIPIUL ARAD",1,9262,1,1,1174,676,612,64,658,18,1400,724,529,129,
2,"ARAD",29,9262,,17,0,"DISPENSARUL MICALACA-ZONA III,DISP.AFLAT IN CONSTRUCTIE,B-DUL N.TITULESCU","MUNICIPIUL ARAD",1,9262,1,1,3276,1613,1526,87,1588,25,3500,1887,1157,431,
2,"ARAD",29,9262,,18,0,"DISPENSARUL MICALACA-ZONAIII,DISP AFLAT IN CONSTRUCTIE B-DUL N.TITULESCU","MUNICIPIUL ARAD",1,9262,1,1,2306,1088,1002,86,1075,13,2600,1512,703,372,
2,"ARAD",29,9262,,19,0,"SCOALA CU CLASELE I-VIII NR.12,STR.MIORITEI","MUNICIPIUL ARAD",1,9262,1,1,1923,948,894,54,923,25,1989,1041,628,295,
2,"ARAD",29,9262,,20,0,"SCOALA CU CLASELE I-VIII NR.12,STR.MIORITEI","MUNICIPIUL ARAD",1,9262,1,1,2726,1403,1334,69,1378,25,2993,1590,1001,377,
2,"ARAD",29,9262,,21,0,"SCOALA CU CLASELE I-VIII NR.12,STR.MIORITEI","MUNICIPIUL ARAD",1,9262,1,1,2264,1106,1047,59,1093,13,2498,1392,708,385,
2,"ARAD",29,9262,,22,0,"SCOALA CU CLASELE I-VIII NR.12,STR.MIORITEI","MUNICIPIUL ARAD",1,9262,1,1,2183,936,848,88,913,23,2300,1364,612,301,
2,"ARAD",29,9262,,23,0,"SCOALA CU CLASELE I-VIII NR.22,STR.NUCET NR.3","MUNICIPIUL ARAD",1,9262,1,1,1610,723,678,45,713,10,1800,1077,460,253,
2,"ARAD",29,9262,,24,0,"SCOALA CU CLASELE I-VIII NR.22,STR.NUCET NR.3","MUNICIPIUL ARAD",1,9262,1,1,1907,900,830,70,890,10,2105,1205,595,295,
2,"ARAD",29,9262,,25,0,"SCOALA CU CLASELE I-VIII NR.22,STR.NUCET NR.3","MUNICIPIUL ARAD",1,9262,1,1,2395,1026,957,69,1012,14,2500,1474,637,375,
2,"ARAD",29,9262,,26,0,"SCOALA CU CLASELE I-VIII NR.22,STR.NUCET NR.3","MUNICIPIUL ARAD",1,9262,1,1,2385,1091,972,119,1059,32,2500,1409,677,382,
2,"ARAD",29,9262,,27,0,"SCOALA CU CLASELE I-VIII NR.12,CALEA RADNEI NR.250","MUNICIPIUL ARAD",1,9262,1,1,2267,1098,1023,75,1084,14,2392,1294,681,403,
2,"ARAD",29,9262,,28,0,"GRADINITA DE COPII P.N. NR.18 ,STR.FABIUS NR.8","MUNICIPIUL ARAD",1,9262,1,1,2670,1262,1200,62,1246,16,2800,1538,862,384,
2,"ARAD",29,9262,,29,0,"SCOALA CU CLASELE I-VIII NR.13,STR.ARDEALULUI NR.8","MUNICIPIUL ARAD",1,9262,1,1,1591,769,725,44,757,12,1700,931,505,252,
2,"ARAD",29,9262,,30,0,"GRADINITA DE COPII P.P.NR.11,STR.CRASNA NR.44","MUNICIPIUL ARAD",1,9262,1,1,1656,798,757,41,788,10,1800,1002,528,260,
2,"ARAD",29,9262,,31,0,"SCOALA CU CLASELE I-VIII NR.13,STR.P.RARES NR.20","MUNICIPIUL ARAD",1,9262,1,1,1421,748,676,72,741,7,1700,952,501,240,
2,"ARAD",29,9262,,32,0,"SCOALA CU CLASELE I-VIII NR.13,STR.P.RARES NR.20","MUNICIPIUL ARAD",1,9262,1,1,1484,771,655,116,760,11,1600,829,515,245,
2,"ARAD",29,9262,,33,0,"SCOALA CU CLASELE I-VIII NR.13,STR.P.RARES NR.21","MUNICIPIUL ARAD",1,9262,1,1,2260,1114,1056,58,1092,22,2500,1386,722,370,
2,"ARAD",29,9262,,34,0,"SCOALA CU CLASELE I-VIII NR.13,STR.P.RARES NR.21","MUNICIPIUL ARAD",1,9262,1,1,1192,601,541,60,592,9,1300,699,358,234,
2,"ARAD",29,9262,,35,0,"SCOALA CU CLASELE I-IV NR.15,CALEA 6 VINATORI NR.55","MUNICIPIUL ARAD",1,9262,1,1,1991,896,770,126,883,13,2200,1304,456,427,
2,"ARAD",29,9262,,36,0,"SCOALA CU CLASELE I-VIII NR.21,STR.FULGERULUI NR.2-4","MUNICIPIUL ARAD",1,9262,1,1,1771,993,853,140,976,17,1912,919,689,287,
2,"ARAD",29,9262,,37,0,"SCOALA CU CLASELE I-VIII NR.21,STR.FULGERULUI NR.2-4","MUNICIPIUL ARAD",1,9262,1,1,2258,1197,1108,89,1180,17,2403,1206,807,373,
2,"ARAD",29,9262,,38,0,"SCOALA CU CLASELE I-VIII NR.11,STR.POETULUI NR.89A","MUNICIPIUL ARAD",1,9262,1,1,1739,785,730,55,775,10,1900,1115,575,200,
2,"ARAD",29,9262,,39,0,"SCOALA CU CLASELE I-VIII NR.11,STR.POETULUI NR.89A","MUNICIPIUL ARAD",1,9262,1,1,1713,859,725,134,848,11,1800,941,500,348,
2,"ARAD",29,9262,,40,0,"GRADINITA DE COPII CU P.P. NR.17,STR.LUCHIAN","MUNICIPIUL ARAD",1,9262,1,1,1728,900,811,89,884,16,1900,1000,605,279,
2,"ARAD",29,9262,,41,0,"GRADINITA DE COPII CU P.P.NR.17 ,STR.LUCHIAN","MUNICIPIUL ARAD",1,9262,1,1,1889,854,802,52,842,12,2000,1146,548,294,
2,"ARAD",29,9262,,42,0,"CENTRUL DE VARSTNICI,C.A.VLAICU NR.227","MUNICIPIUL ARAD",1,9262,1,1,1711,803,744,59,792,11,1900,1097,514,278,
2,"ARAD",29,9262,,43,0,"SCOALA CU CLASELE I-VIII,NR.11,STR.POETULUI NR.89","MUNICIPIUL ARAD",1,9262,1,1,1642,717,684,33,708,9,1800,1083,450,258,
2,"ARAD",29,9262,,44,0,"GRADINITA DE COPII P.N.NR.8,STR.POETULUI NR.72","MUNICIPIUL ARAD",1,9262,1,1,1693,850,778,72,830,20,1800,950,515,315,
2,"ARAD",29,9262,,45,0,"SCOALA CU CLASELE I-VIII NR.10,STR.FAURILOR NR.94","MUNICIPIUL ARAD",1,9262,1,1,1567,756,694,62,741,15,1700,944,451,290,
2,"ARAD",29,9262,,46,0,"SCOALA CU CLASELE I-VIII NR.10,STR.GRADINARILOR NR.1-15","MUNICIPIUL ARAD",1,9262,1,1,2018,843,750,93,829,14,2195,1352,547,282,
2,"ARAD",29,9262,,47,0,"SCOALA CU CLASELE I-VIII NR.9,STR.INDEPENDENTEI NR.3","MUNICIPIUL ARAD",1,9262,1,1,1926,946,889,57,924,22,2091,1145,543,381,
2,"ARAD",29,9262,,48,0,"SCOALA CU CLASELE I-VIII NR.9,STR.INDEPENDENTEI NR.3","MUNICIPIUL ARAD",1,9262,1,1,1814,839,763,76,824,15,2000,1161,467,357,
2,"ARAD",29,9262,,49,0,"GRADINITA DE COPII P.P.NR.16,STR.PREDEAL","MUNICIPIUL ARAD",1,9262,1,1,1614,759,607,152,738,21,1800,1041,477,261,
2,"ARAD",29,9262,,50,0,"GRADINITA DE COPII P.P. NR.16,STR.PREDEAL","MUNICIPIUL ARAD",1,9262,1,1,1857,969,811,158,953,16,2100,1131,621,332,
2,"ARAD",29,9262,,51,0,"SCOALA CU CLASELE I-VIII NR.6,STR.HATEG NR.1","MUNICIPIUL ARAD",1,9262,1,1,1698,748,694,54,730,18,1700,952,497,233,
2,"ARAD",29,9262,,52,0,"SCOALA CU CLASELE I-VIII NR.6,STR.HATEG NR.1","MUNICIPIUL ARAD",1,9262,1,1,1969,894,792,102,884,10,2100,1206,584,300,
2,"ARAD",29,9262,,53,0,"SCOALA CU CLASELE I-VIII NR.6,STR.HATEG NR.1","MUNICIPIUL ARAD",1,9262,1,1,2821,1291,1191,100,1273,18,3000,1709,939,334,
2,"ARAD",29,9262,,54,0,"SCOALA CU CLASELE I-VIII NR.18,STR.V.CONTA NR.2B","MUNICIPIUL ARAD",1,9262,1,1,1448,735,643,92,724,11,1600,865,509,215,
2,"ARAD",29,9262,,55,0,"SCOALA CU CLASELE I-VIII NR.18,STR.V.CONTA NR.2B","MUNICIPIUL ARAD",1,9262,1,1,1644,799,726,73,789,10,1800,1001,578,211,
2,"ARAD",29,9262,,56,0,"GRADINITA DE COPII P.N.NR.16,STR.TIBERIU NR.4","MUNICIPIUL ARAD",1,9262,1,1,1973,852,793,59,837,15,2100,1248,552,285,
2,"ARAD",29,9262,,57,0,"GR.SC.IND.CONSTRUCTII APE SI PROT.MEDIULUI,STR.I.FLUIERAS,NR.10C","MUNICIPIUL ARAD",1,9262,1,1,2304,993,892,101,967,26,2500,1507,618,349,
2,"ARAD",29,9262,,58,0,"LICEUL TEORETIC""V.GOLDIS"",C.VICTORIEI NR.3-5","MUNICIPIUL ARAD",1,9262,1,1,1306,990,523,467,973,17,1400,410,614,359,
2,"ARAD",29,9262,,59,0,"GR.SC.IND.CONSTRUCTII,APE SI PROT.MEDIULUI,STR.I.FLUIERAS NR.10C","MUNICIPIUL ARAD",1,9262,1,1,1324,565,495,70,538,27,1500,935,416,122,
2,"ARAD",29,9262,,60,0,"GRADINITA DE COPII P.N.NR.12,STR.L.REBREANU BL.5","MUNICIPIUL ARAD",1,9262,1,1,1729,801,590,211,790,11,1900,1099,485,305,
2,"ARAD",29,9262,,61,0,"GRADINITA DE COPII P.N. NR.12,STR.L.REBREANU BL.5","MUNICIPIUL ARAD",1,9262,1,1,2961,1230,1062,168,1206,24,3096,1866,709,497,
2,"ARAD",29,9262,,62,0,"SCOALA CU CLASELE I-VIII NR.3,STR.EP.ROMAN CIOROGARIU NR.18","MUNICIPIUL ARAD",1,9262,1,1,1911,942,882,60,934,8,2100,1158,677,257,
2,"ARAD",29,9262,,63,0,"GRADINITA DE COPII NR.24,STR.DOROBANTILOR NR.41","MUNICIPIUL ARAD",1,9262,1,1,2310,990,901,89,966,24,2500,1510,693,273,
2,"ARAD",29,9262,,64,0,"SCOALA CU CLASELE I-VIII NR.3,STR.CONDURASILOR NR.48-50","MUNICIPIUL ARAD",1,9262,1,1,2463,1251,894,357,1236,15,2592,1341,774,462,
2,"ARAD",29,9262,,65,0,"SCOALA CU CLASELE I-VIII NR.3,STR.CONDURASILOR NR.48-50","MUNICIPIUL ARAD",1,9262,1,1,2313,987,893,94,970,15,2500,1515,519,451,
2,"ARAD",29,9262,,66,0,"SCOALA CU CLASELE I-VIII NR.3,STR.CONDURASILOR NR.48-50","MUNICIPIUL ARAD",1,9262,1,1,2906,1429,1247,182,1412,17,3100,1671,862,550,
2,"ARAD",29,9262,,67,0,"SCOALA CU CLASELE I-VIII NR.1,STR.MARASESTI NR.34","MUNICIPIUL ARAD",1,9262,1,1,1197,608,551,57,599,9,1300,692,491,108,
2,"ARAD",29,9262,,68,0,"SCOALA CU CLASELE I-VIII NR.1,STR.EPISCOPIEI NR.40-42","MUNICIPIUL ARAD",1,9262,1,1,1476,744,690,54,728,16,1700,956,547,181,
2,"ARAD",29,9262,,69,0,"GR.SC.IND.ALIMENTARA,STR.L.BLAGA NR.15","MUNICIPIUL ARAD",1,9262,1,1,2325,1193,974,219,1160,33,2500,1307,839,321,
2,"ARAD",29,9262,,70,0,"GR.SC.IND.""HENRI COANDA"",STR.I.CALVIN NR.22","MUNICIPIUL ARAD",1,9262,1,1,1856,965,843,122,946,19,2100,1135,701,245,
2,"ARAD",29,9262,,71,0,"GR.SC.DE ARTE SI MESERII""SPIRU HARET"",STR.E.GARLEANU NR.1","MUNICIPIUL ARAD",1,9262,1,1,1876,792,681,111,768,24,2100,1308,599,169,
2,"ARAD",29,9262,,72,0,"LOCALUL R.A.L.L.,STR.MUCIUS SCAEVOLA NR.9-11","MUNICIPIUL ARAD",1,9262,1,1,1519,817,709,108,798,19,1700,883,529,269,
2,"ARAD",29,9262,,73,0,"GR.SC.INDUSTRIE USOARA,STR.SAVA TEKELIJA NR.1","MUNICIPIUL ARAD",1,9262,1,1,1426,749,601,148,730,19,1595,846,526,204,
2,"ARAD",29,9262,,74,0,"CLUBUL C.A.R.AL PENSIONARILOR,P-TA A.IANCU NR.21","MUNICIPIUL ARAD",1,9262,1,1,1395,725,632,93,707,18,1500,775,489,218,
2,"ARAD",29,9262,,75,0,"GR.SC.IND.""A.VLAICU"",B-DUL DECEBALNR.31A","MUNICIPIUL ARAD",1,9262,1,1,1462,832,763,69,818,14,1600,768,652,166,
2,"ARAD",29,9262,,76,0,"INTERNATUL GR.SC.DE IND.USOARA,STR.LABIRINT NR.6","MUNICIPIUL ARAD",1,9262,1,1,1228,748,640,108,724,24,1400,652,579,145,
2,"ARAD",29,9262,,77,0,"GRADINITA DE COPII CU P.P.NR.14,STR.PATRIA NR.2-6","MUNICIPIUL ARAD",1,9262,1,1,1384,809,726,83,796,13,1500,691,568,228,
2,"ARAD",29,9262,,78,0,"SCOALA CU CLASELE I-IV NR.20,STR.SPARTACUS NR.1","MUNICIPIUL ARAD",1,9262,1,1,843,392,359,33,384,8,1000,608,228,156,
2,"ARAD",29,9262,,79,0,"SCOALA CU CLASELE I-VIII NR.20,STR.POSADA NR.1","MUNICIPIUL ARAD",1,9262,1,1,1530,734,694,40,718,16,1700,966,501,217,
2,"ARAD",29,9262,,80,0,"SCOALA CU CLASELE I-VIII NR.20,STR.CONSTITUTIEI NR.132","MUNICIPIUL ARAD",1,9262,1,1,1593,726,686,40,711,15,1700,974,484,227,
2,"ARAD",29,9262,,81,0,"LICEUL TEORETIC""ADAM MULLER GUTTENBRUNN"",C.TIMISORII 93","MUNICIPIUL ARAD",1,9262,1,1,1581,821,737,84,807,14,1700,879,382,425,
2,"ARAD",29,9262,,82,0,"GR.SC.IND.FORESTIER,C.TIMISORII,NR.29-31","MUNICIPIUL ARAD",1,9262,1,1,1570,695,631,64,682,13,1700,1005,455,227,
2,"ARAD",29,9262,,83,0,"GRADINITA DE COPII P.N.NR.26,STR.A.M.GUTTENBRUNN,NR.114","MUNICIPIUL ARAD",1,9262,1,1,2957,1350,1224,126,1332,18,3200,1850,755,577,
2,"ARAD",29,9262,,84,0,"SCOALA CU CLASELE I-VIII NR.7,STR.STEAGULUI,NR.25-27","MUNICIPIUL ARAD",1,9262,1,1,1515,830,710,120,818,12,1700,870,396,422,
2,"ARAD",29,9262,,85,0,"SCOALA CU CLASELE I-VIII NR.7,STR.STEAGULUI NR.25-27","MUNICIPIUL ARAD",1,9262,1,1,1579,782,668,114,769,13,1697,915,398,371,
2,"ARAD",29,9262,,86,1,"CENTRUL MILITAR,B-DUL DECEBAL NR.19","MUNICIPIUL ARAD",1,9262,1,1,0,335,0,335,323,12,1300,965,155,168,
2,"ARAD",29,9459,,87,0,"LICEUL TEORETIC,STR.PRIMAVERII NR.3","ORAS CHISINEU-CRIS",2,9459,2,1,2303,1080,1020,60,1073,7,3100,2020,681,392,
2,"ARAD",29,9459,,88,0,"SCOALA GENERALA,STR.OITUZ NR.4","ORAS CHISINEU-CRIS",2,9459,2,1,2258,910,819,91,897,13,1900,990,586,311,
2,"ARAD",29,9459,,89,0,"GRADINITA PADURENI,STR.INFRATIRII NR.10","ORAS CHISINEU-CRIS",2,9459,2,1,1611,793,729,64,783,10,1700,907,618,165,
2,"ARAD",29,9459,,90,0,"SCOALA GENERALA NADAB,NR.313","ORAS CHISINEU-CRIS",2,9459,2,1,1446,902,830,72,894,8,1500,598,301,593,
2,"ARAD",29,9495,,91,0,"LICEUL TEORETIC,STR.HOREA NR.2","ORAS CURTICI",3,9495,2,1,1825,992,861,131,984,8,1900,908,546,438,
2,"ARAD",29,9495,,92,0,"LICEUL TEORETIC,STR.REVOLUTIEI NR.37","ORAS CURTICI",3,9495,2,1,2504,1253,1154,99,1239,14,2600,1347,667,572,
2,"ARAD",29,9495,,93,0,"CLUBUL ELEVILOR,STR.PRIMARIEI NR.89","ORAS CURTICI",3,9495,2,1,2124,977,921,56,962,15,2200,1223,571,391,
2,"ARAD",29,9495,,94,0,"CAMINUL CULTURAL SAT DOROBANTI,NR.90","ORAS CURTICI",3,9495,2,1,1453,725,672,53,710,15,1600,875,668,42,
2,"ARAD",29,9538,,95,0,"SCOALA GENERALA NR.1,STR.REPUBLICII NR.3","ORAS INEU",4,9538,2,1,2620,1386,1243,143,1374,12,2700,1314,734,640,
2,"ARAD",29,9538,,96,0,"GRADINITA DE COPII,STR.HORIA","ORAS INEU",4,9538,2,1,1928,968,883,85,953,15,2100,1132,486,467,
2,"ARAD",29,9538,,97,0,"LICEUL M.VITEAZUL,STR.TRAIAN NR.7","ORAS INEU",4,9538,2,1,1713,860,782,78,849,11,1800,940,474,375,
2,"ARAD",29,9538,,98,0,"SCOALA CL.I-IV,STR.MARASESTI","ORAS INEU",4,9538,2,1,1347,700,662,38,696,4,1400,700,307,389,
2,"ARAD",29,9538,,99,0,"SEDIUL FOSTULUI CAP MOCREA","ORAS INEU",4,9538,2,1,621,343,286,57,332,11,700,357,170,162,
2,"ARAD",29,9538,,100,1,"CLUBUL DE GARNIZOANA","ORAS INEU",4,9538,2,1,0,96,0,96,93,3,200,104,52,41,
2,"ARAD",29,9574,,101,0,"SEDIUL RENEL,STR.HASDEU NR.51","ORAS LIPOVA",5,9574,2,1,1938,916,795,121,901,15,2000,1084,504,397,
2,"ARAD",29,9574,,102,0,"SCOALA GENERALA,STR.N.BALCESCU NR.52","ORAS LIPOVA",5,9574,2,1,1543,833,712,121,820,13,1600,767,508,312,
2,"ARAD",29,9574,,103,0,"SCOALA GENERALA ,STR.9 MAI NR.1","ORAS LIPOVA",5,9574,2,1,1618,717,649,68,708,9,1700,983,370,338,
2,"ARAD",29,9574,,104,0,"CASA DE CULTURA,STR.N.TITULESCU NR.10","ORAS LIPOVA",5,9574,2,1,1205,480,435,45,475,5,1300,820,300,175,
2,"ARAD",29,9574,,105,0,"PALATUL COPIILOR,STR.BUGARIU NR.12","ORAS LIPOVA",5,9574,2,1,831,339,297,42,334,5,900,561,217,117,
2,"ARAD",29,9574,,106,0,"SCOALA GENERALA CARTIER RADNA,STR.POMPIERILOR NR.23","ORAS LIPOVA",5,9574,2,1,1737,915,688,227,899,16,1800,885,520,379,
2,"ARAD",29,9574,,107,0,"SCOALA GENERALA CARTIER SOIMOS,STR.PRINCIPALA NR.132","ORAS LIPOVA",5,9574,2,1,768,352,305,47,350,2,800,448,169,181,
2,"ARAD",29,9627,,108,0,"GR.SCOLAR ""J.G.TAJOVSKI"",P-TA UNIRII NR.2","ORAS NADLAC",6,9627,2,1,1974,805,733,72,786,19,2000,1195,465,321,
2,"ARAD",29,9627,,109,0,"CASA CULTURII,STR.1 DECEMBRIE NR.24","ORAS NADLAC",6,9627,2,1,2240,949,784,165,932,17,2400,1451,529,403,
2,"ARAD",29,9627,,110,0,"SCOALA GENERALA NR.3,STR.1 DECEMBRIE NR.9","ORAS NADLAC",6,9627,2,1,2211,1027,942,85,1020,7,2400,1373,501,519,
2,"ARAD",29,9654,,111,0,"CASA DE CULTURA,STR.T.VLADIMIRESCU NR.22","ORAS PANCOTA",7,9654,2,1,2049,1019,888,131,996,23,2200,1181,566,430,
2,"ARAD",29,9654,,112,0,"LICEUL TEORETIC,STR.V.GOLDIS NR.67","ORAS PANCOTA",7,9654,2,1,2561,1097,995,102,1071,26,2700,1603,603,468,
2,"ARAD",29,9654,,113,0,"CAMINUL CULTURAL SAT MADERAT","ORAS PANCOTA",7,9654,2,1,1154,588,522,66,580,8,1200,612,302,278,
2,"ARAD",29,9690,,114,0,"PALATUL ADMINISTRATIV CULTURAL","ORAS SEBIS",8,9690,2,1,1516,704,633,71,692,12,1600,896,360,332,
2,"ARAD",29,9690,,115,0,"GRUP SCOLAR SEBIS","ORAS SEBIS",8,9690,2,1,1486,692,643,49,686,6,1600,908,412,274,
2,"ARAD",29,9690,,116,0,"CASA ELEVILOR SI COPIILOR","ORAS SEBIS",8,9690,2,1,1552,811,740,71,797,14,1600,789,485,312,
2,"ARAD",29,9690,,117,0,"SCOALA GENERALA,CARTIER PRAJESTI","ORAS SEBIS",8,9690,2,1,228,172,128,44,170,2,300,128,78,92,
2,"ARAD",29,9690,,118,0,"SCOALA GENERALA ,SAT PRUNISOR","ORAS SEBIS",8,9690,2,1,491,318,285,33,313,5,600,282,131,182,
2,"ARAD",29,9690,,119,0,"SCOALA GENERALA,SAT DONCENI","ORAS SEBIS",8,9690,2,1,149,103,86,17,99,4,200,97,39,60,
2,"ARAD",29,9690,,120,0,"SCOALA GENERALA,SAT SALAJENI","ORAS SEBIS",8,9690,2,1,164,123,104,19,122,1,200,77,54,68,
2,"ARAD",29,9743,,121,0,"CAMINUL CULTURAL ALMAS","ALMAS",9,9743,0,3,1696,869,784,85,859,10,1800,931,311,548,
2,"ARAD",29,9743,,122,0,"CAMINUL CULTURAL SAT CIL","ALMAS",9,9743,0,3,505,285,257,28,283,2,600,315,92,191,
2,"ARAD",29,9743,,123,0,"CAMINUL CULTURAL SAT JOIA MARE","ALMAS",9,9743,0,3,162,119,91,28,119,0,197,78,45,74,
2,"ARAD",29,9798,,124,0,"CAMINUL CULTURAL APATEU NR.364","APATEU",10,9798,0,3,1912,1202,1137,65,1186,8,2000,806,650,536,
2,"ARAD",29,9798,,125,0,"CAMINUL CULTURAL SAT BERECHIU NR.128","APATEU",10,9798,0,3,774,523,461,62,518,5,800,277,354,164,
2,"ARAD",29,9798,,126,0,"SCOALA SAT MOTIORI NR.75","APATEU",10,9798,0,3,317,249,226,23,248,1,400,151,132,116,
2,"ARAD",29,9832,,127,0,"PRIMARIA ARCHIS","ARCHIS",11,9832,0,3,543,352,301,51,342,10,600,248,224,118,
2,"ARAD",29,9832,,128,0,"SCOALA GENERALA CL.I-VIII,SAT GROSENI","ARCHIS",11,9832,0,3,856,453,410,43,447,6,900,447,202,245,
2,"ARAD",29,9887,,129,0,"PRIMARIA BATA","BATA",14,9887,0,3,369,262,195,67,256,6,400,138,139,117,
2,"ARAD",29,9887,,130,0,"CAMINUL CULTURAL SAT TELA","BATA",14,9887,0,3,440,212,163,49,208,4,500,288,82,126,
2,"ARAD",29,9887,,131,0,"CAMINUL CULTURAL SAT BULCI","BATA",14,9887,0,3,125,142,76,66,141,1,200,58,56,85,
2,"ARAD",29,9930,,132,0,"CONSILIUL LOCAL BELIU","BELIU",15,9930,0,3,1550,947,852,95,919,28,1600,653,398,521,
2,"ARAD",29,9930,,133,0,"CAMINUL CULTURAL SAT TAGADAU","BELIU",15,9930,0,3,436,260,224,36,254,6,500,240,107,147,
2,"ARAD",29,9930,,134,0,"SCOALA GENERALA SAT BENESTI","BELIU",15,9930,0,3,177,113,98,15,113,0,200,87,48,65,
2,"ARAD",29,9930,,135,0,"CAMINUL CULTURAL SAT SECACI","BELIU",15,9930,0,3,174,144,125,19,142,2,200,56,30,112,
2,"ARAD",29,9930,,136,0,"CAMINUL CULTURAL SAT LUNCA TEUZULUI","BELIU",15,9930,0,3,403,369,315,54,364,5,500,131,239,125,
2,"ARAD",29,10006,,137,0,"CAMINUL CULTURAL BIRCHIS","BIRCHIS",16,10006,0,3,788,389,306,83,384,5,800,411,246,138,
2,"ARAD",29,10006,,138,0,"SCOALA GENERALA SAT CAPILNAS","BIRCHIS",16,10006,0,3,783,508,413,95,504,4,800,292,277,227,
2,"ARAD",29,10051,,139,0,"CAMINUL CULTURAL BARSA NR.385","BARSA",12,10051,0,3,997,601,527,74,592,9,1000,399,267,325,
2,"ARAD",29,10051,,140,0,"CAMINUL CULTURA SAT ALDESTI NR.206","BARSA",12,10051,0,3,610,371,318,53,370,1,704,333,189,181,
2,"ARAD",29,10104,,141,0,"CONSILIUL LOCAL BARZAVA","BARZAVA",13,10104,0,3,1003,561,413,148,554,7,1100,539,184,370,
2,"ARAD",29,10104,,142,0,"CAMINUL CULTURAL SAT CAPRUTA","BARZAVA",13,10104,0,3,257,145,111,34,145,0,300,155,77,68,
2,"ARAD",29,10104,,143,0,"SCOALA GENERALA SAT DUMBRAVITA","BARZAVA",13,10104,0,3,297,197,169,28,196,1,300,103,85,111,
2,"ARAD",29,10104,,144,0,"SCOALA GENERALA SAT GROSII NOI","BARZAVA",13,10104,0,3,252,172,145,27,170,2,300,128,68,102,
2,"ARAD",29,10104,,145,0,"SCOALA GENERALA SAT SLATINA DE MURES","BARZAVA",13,10104,0,3,175,94,78,16,94,0,200,106,35,59,
2,"ARAD",29,10104,,146,0,"SCOALA GENERALA SAT LALASINT","BARZAVA",13,10104,0,3,377,244,200,44,230,14,400,156,84,146,
2,"ARAD",29,10104,,147,0,"SCOALA GENERALA SAT BATUTA","BARZAVA",13,10104,0,3,62,77,39,38,76,1,100,23,24,52,
2,"ARAD",29,10195,,148,0,"CAMINUL CULTURAL BOCSIG","BOCSIG",17,10195,0,3,1494,946,847,99,940,6,1700,754,458,482,
2,"ARAD",29,10195,,149,0,"SCOALA CU CLASELE 1-4 BOCSIG-CARTIER","BOCSIG",17,10195,0,3,361,275,224,51,273,2,300,25,132,141,
2,"ARAD",29,10195,,150,0,"CAMINUL CULTURAL SAT MINERAU","BOCSIG",17,10195,0,3,322,242,192,50,239,3,400,158,121,118,
2,"ARAD",29,10195,,151,0,"SCOALA VECHE SAT RAPSIG","BOCSIG",17,10195,0,3,642,420,377,43,417,3,700,280,200,217,
2,"ARAD",29,10239,,152,0,"PRIMARIA BRAZII","BRAZII",18,10239,0,3,290,185,163,22,185,0,300,115,103,82,
2,"ARAD",29,10239,,153,0,"CAMINUL CULTURAL SAT SECAS","BRAZII",18,10239,0,3,374,241,223,18,233,8,400,159,102,131,
2,"ARAD",29,10239,,154,0,"CAMINUL CULTURAL SAT BUCEAVA","BRAZII",18,10239,0,3,416,215,185,30,212,3,500,285,68,144,
2,"ARAD",29,10293,,155,0,"PRIMARIA BUTENI","BUTENI",19,10293,0,3,1736,943,851,92,927,16,1800,857,486,441,
2,"ARAD",29,10293,,156,0,"SEDIUL FOSTEI PRIMARII CUIED","BUTENI",19,10293,0,3,644,330,292,38,329,1,700,370,151,178,
2,"ARAD",29,10293,,157,0,"CAMINUL CULTURAL SAT PAULEANI","BUTENI",19,10293,0,3,471,262,224,38,257,5,500,238,120,137,
2,"ARAD",29,10346,,158,0,"CAMIN CULTURAL CARAND","CARAND",20,10346,0,3,645,478,444,34,465,13,700,222,211,254,
2,"ARAD",29,10346,,159,0,"CAMIN CULTURAL SAT SELISTEA","CARAND",20,10346,0,3,465,278,241,37,273,5,500,222,138,135,
2,"ARAD",29,10373,,160,0,"SEDIUL PRIMARIEI CERMEI","CERMEI",21,10373,0,3,1543,1030,893,137,1019,11,1600,570,558,461,
2,"ARAD",29,10373,,161,0,"SCOALA GENERALA SAT SOMOSCHES","CERMEI",21,10373,0,3,728,423,368,55,419,4,800,377,275,144,
2,"ARAD",29,10417,,162,0,"CONSILIUL LOCAL CHISINDIA","CHISINDIA",22,10417,0,3,876,479,432,47,471,8,900,421,178,293,
2,"ARAD",29,10417,,163,0,"CAMIN CULTURAL SAT PAIUSENI","CHISINDIA",22,10417,0,3,440,225,197,28,221,4,500,275,94,127,
2,"ARAD",29,10417,,164,0,"CAMIN CULTURAL SAT VASOAIA","CHISINDIA",22,10417,0,3,102,53,38,15,53,0,200,147,21,32,
2,"ARAD",29,10453,,165,0,"CAMIN CULTURAL CONOP","CONOP",23,10453,0,3,360,233,183,50,229,4,400,167,129,100,
2,"ARAD",29,10453,,166,0,"CAMIN CULTURAL SAT BELOTINT","CONOP",23,10453,0,3,242,193,149,44,191,2,300,107,117,74,
2,"ARAD",29,10453,,167,0,"CAMIN CULTURAL SAT CHELMAC","CONOP",23,10453,0,3,322,203,159,44,201,2,400,197,130,71,
2,"ARAD",29,10453,,168,0,"SCOALA GENERALA SAT ODVOS","CONOP",23,10453,0,3,326,255,212,43,252,3,400,145,130,122,
2,"ARAD",29,10453,,169,0,"CAMINUL CULTURAL SAT MILOVA","CONOP",23,10453,0,3,345,224,167,57,223,1,400,176,77,146,
2,"ARAD",29,10514,,170,0,"CONSILIUL LOCAL COVASINT","COVASINT",24,10514,0,3,2010,1035,917,118,1025,10,2100,1065,556,469,
2,"ARAD",29,10532,,171,0,"CONSILIUL LOCAL CRAIVA","CRAIVA",25,10532,0,3,913,513,449,64,510,3,1000,487,327,183,
2,"ARAD",29,10532,,172,0,"SCOALA GENERALA SAT CHISLACA","CRAIVA",25,10532,0,3,590,318,273,45,315,3,600,282,167,148,
2,"ARAD",29,10532,,173,0,"SCOALA GENERALA SAT MARAUS","CRAIVA",25,10532,0,3,444,240,215,25,238,2,500,260,113,125,
2,"ARAD",29,10532,,174,0,"SCOALA GENERALA SAT STOIENESTI","CRAIVA",25,10532,0,3,325,158,145,13,157,1,400,242,63,94,
2,"ARAD",29,10532,,175,0,"SCOALA GENERALA SAT SUSAG","CRAIVA",25,10532,0,3,434,267,241,26,263,4,500,233,112,151,
2,"ARAD",29,10649,,176,0,"CAMINUL CULTURAL DEZNA","DEZNA",26,10649,0,3,989,559,485,74,550,9,1000,441,295,255,
2,"ARAD",29,10649,,177,0,"CAMINUL CULTURAL SAT BUHANI","DEZNA",26,10649,0,3,320,200,139,61,200,0,400,200,137,63,
2,"ARAD",29,10701,,178,0,"CAMINUL CULTURAL DIECI","DIECI",27,10701,0,3,689,414,389,25,411,3,700,286,140,271,
2,"ARAD",29,10701,,179,0,"CAMINUL CULTURAL SAT CROCNA","DIECI",27,10701,0,3,407,269,236,33,267,2,500,231,111,156,
2,"ARAD",29,10701,,180,0,"CAMINUL CULTURAL SAT REVETIS","DIECI",27,10701,0,3,354,203,167,36,202,1,400,197,85,117,
2,"ARAD",29,10827,,181,0,"SCOALA GENERALA CU CLASELE I-VIII FELNAC","FELNAC",30,10827,0,3,1925,939,833,106,916,23,2000,1061,381,535,
2,"ARAD",29,10827,,182,0,"GRADINITA DE COPII SAT ZADARENI NR.245","FELNAC",30,10827,0,3,1525,817,667,150,811,6,1600,783,379,432,
2,"ARAD",29,10827,,183,0,"SCOALA GENERALA CU CL.I-IV,SAT BODROGU NOU","FELNAC",30,10827,0,3,355,250,191,59,246,4,400,150,107,139,
2,"ARAD",29,9280,,184,0,"CONSILIUL LOCAL FINTINELE","FANTINELE",29,9280,0,3,1816,867,764,103,851,16,1900,1033,424,427,
2,"ARAD",29,9280,,185,0,"CAMINUL CULTURAL SAT ALUNIS NR.298","FANTINELE",29,9280,0,3,693,458,402,56,454,4,700,242,143,311,
2,"ARAD",29,9280,,186,0,"CAMINUL CULTURAL SAT FRUMUSENI NR.379","FANTINELE",29,9280,0,3,1189,667,600,67,664,3,1200,533,326,338,
2,"ARAD",29,9280,,187,0,"CAMINUL CULTURAL SAT TISA NOUA","FANTINELE",29,9280,0,3,656,387,336,51,381,6,700,313,184,197,
2,"ARAD",29,10872,,188,0,"CAMINUL CULTURAL GHIOROC NR.3","GHIOROC",31,10872,0,3,1437,734,588,146,727,7,1500,766,452,275,
2,"ARAD",29,10872,,189,0,"CAMINUL CULTURAL SAT CUVIN NR.97","GHIOROC",31,10872,0,3,1188,634,535,99,627,7,1200,566,311,316,
2,"ARAD",29,10872,,190,0,"CAMINUL CULTURAL SAT MINIS NR.163","GHIOROC",31,10872,0,3,525,342,247,95,333,9,600,258,166,167,
2,"ARAD",29,10916,,191,0,"CAMINUL CULTURAL GRANICERI","GRANICERI",32,10916,0,3,1056,676,568,108,666,10,1100,424,402,264,
2,"ARAD",29,10916,,192,0,"CAMINUL CULTURAL SAT SICLAU","GRANICERI",32,10916,0,3,893,478,395,83,466,12,900,422,255,211,
2,"ARAD",29,10943,,193,0,"CAMINUL CULTURAL GURAHONT STRADA A.IANCU NR.12","GURAHONT",33,10943,0,3,1451,909,713,196,892,17,1502,593,453,439,
2,"ARAD",29,10943,,194,0,"SEDIUL FORMATIEI DRUMURI JUDETENE GURAHONT,STR.IOSASULUI NR.9","GURAHONT",33,10943,0,3,656,346,290,56,342,4,700,354,149,193,
2,"ARAD",29,10943,,195,0,"CAMINUL CULTURAL SAT BONTESTI NR.242","GURAHONT",33,10943,0,3,619,324,295,29,312,12,704,380,127,185,
2,"ARAD",29,10943,,196,0,"CAMINUL CULTURAL SAT PESCARI NR.151","GURAHONT",33,10943,0,3,413,237,211,26,236,1,500,263,116,120,
2,"ARAD",29,10943,,197,0,"CAMINUL CULTURAL SAT ZIMBRU NR.125","GURAHONT",33,10943,0,3,558,260,234,26,260,0,594,334,119,141,
2,"ARAD",29,11058,,198,0,"CONSILIUL LOCAL HALMAGIU","HALMAGIU",35,11058,0,3,1575,716,656,60,709,7,1600,884,306,403,
2,"ARAD",29,11058,,199,0,"CAMINUL CULTURAL SAT BRUSTURI","HALMAGIU",35,11058,0,3,459,208,184,24,200,8,500,292,55,145,
2,"ARAD",29,11058,,200,0,"SCOALA GENERALA I-IV SAT POENARI","HALMAGIU",35,11058,0,3,201,124,111,13,121,3,300,176,42,79,
2,"ARAD",29,11058,,201,0,"CAMINUL CULTURAL SAT TARMURE","HALMAGIU",35,11058,0,3,621,383,326,57,378,5,700,317,149,229,
2,"ARAD",29,11058,,202,0,"SCOALA GEN.CL.I-IV SAT LEASA","HALMAGIU",35,11058,0,3,261,132,115,17,130,2,300,168,46,84,
2,"ARAD",29,11174,,203,0,"CONS.LOCAL HALMAGEL","HALMAGEL",34,11174,0,3,1021,560,498,62,556,4,1100,540,257,299,
2,"ARAD",29,11174,,204,0,"SC.GEN.SAT LUNCSOARA","HALMAGEL",34,11174,0,3,485,249,223,26,246,3,500,251,70,176,
2,"ARAD",29,11236,,205,0,"CONS.LOCAL HASMAS","HASMAS",36,11236,0,3,713,448,394,54,444,4,800,352,191,253,
2,"ARAD",29,11236,,206,0,"SC.GEN.SAT AGRISU-MIC","HASMAS",36,11236,0,3,464,286,253,33,285,1,500,214,115,170,
2,"ARAD",29,11307,,207,0,"CAMIN CULTURAL IGNESTI","IGNESTI",37,11307,0,3,328,203,186,17,199,4,400,197,76,123,
2,"ARAD",29,11307,,208,0,"CAMIN CULTURAL SAT SUSANI","IGNESTI",37,11307,0,3,323,179,159,20,174,5,400,221,77,97,
2,"ARAD",29,11352,,209,0,"CONS.LOCAL IRATOSU","IRATOSU",38,11352,0,3,1508,628,538,90,623,5,1600,972,436,187,
2,"ARAD",29,11352,,210,0,"SC.GEN.SAT VARIASU MARE","IRATOSU",38,11352,0,3,294,161,112,49,159,2,300,139,130,29,
2,"ARAD",29,9333,,211,0,"SC.GEN.LIVADA NR.62","LIVADA",39,9333,0,3,1202,559,530,29,551,8,1296,737,268,283,
2,"ARAD",29,9333,,212,0,"SC.GEN.CL.I-IV SAT SINLEANI","LIVADA",39,9333,0,3,1268,569,509,60,557,12,1300,731,298,259,
2,"ARAD",29,11398,,213,0,"SC.GEN.MACEA(SCOALA DE JOS) NR.1","MACEA",40,11398,0,3,1700,751,631,120,743,8,1700,949,326,417,
2,"ARAD",29,11398,,214,0,"SC.GEN.MACEA(SATU NOU) NR.2","MACEA",40,11398,0,3,1575,761,665,96,752,9,1600,839,372,380,
2,"ARAD",29,11398,,215,0,"SC.GEN.SAT SINMARTIN","MACEA",40,11398,0,3,1446,799,634,165,785,14,1500,701,402,383,
2,"ARAD",29,11423,,216,0,"CONS.LOCAL MISCA","MISCA",41,11423,0,3,842,600,504,96,588,12,900,300,307,281,
2,"ARAD",29,11423,,217,0,"SEDIUL FOSTEI PRIMARII SAT SATU NOU","MISCA",41,11423,0,3,660,426,364,62,424,2,700,274,409,15,
2,"ARAD",29,11423,,218,0,"SC.GEN.SAT VINATORI","MISCA",41,11423,0,3,892,631,550,81,619,12,900,269,379,240,
2,"ARAD",29,11423,,219,0,"SC.GEN.SAT ZERINDU MIC","MISCA",41,11423,0,3,177,140,117,23,140,0,200,60,134,6,
2,"ARAD",29,11478,,220,0,"CAMIN CULTURAL MONEASA","MONEASA",42,11478,0,3,685,488,363,125,478,10,700,212,238,240,
2,"ARAD",29,11478,,221,0,"SC.GEN SAT RANUSA","MONEASA",42,11478,0,3,238,164,146,18,159,5,299,135,64,95,
2,"ARAD",29,11502,,222,0,"CONS.LOCAL OLARI","OLARI",43,11502,0,3,1147,780,689,91,763,17,1200,420,543,220,
2,"ARAD",29,11502,,223,0,"SC.GEN CL.I-IV.SAT SINTEA MICA","OLARI",43,11502,0,3,276,231,174,57,229,2,300,69,89,140,
2,"ARAD",29,11539,,224,0,"CONS.LOCAL PAULIS","PAULIS",44,11539,0,3,1608,797,681,116,788,9,1700,903,366,422,
2,"ARAD",29,11539,,225,0,"CAMIN CULTURAL SAT CLADOVA","PAULIS",44,11539,0,3,287,208,154,54,205,3,300,92,103,102,
2,"ARAD",29,11539,,226,0,"SC.GENERALA SAT SIMBATENI","PAULIS",44,11539,0,3,1208,712,574,138,697,15,1300,588,292,405,
2,"ARAD",29,11584,,227,0,"CAMIN CULTURAL PECICA","PECICA",45,11584,0,3,1984,897,735,162,880,17,2000,1103,503,377,
2,"ARAD",29,11584,,228,0,"LICEUL TEORETIC PECICA","PECICA",45,11584,0,3,2024,913,753,160,901,12,2100,1187,398,503,
2,"ARAD",29,11584,,229,0,"S.C.A.I.PECICA NR.1432/R","PECICA",45,11584,0,3,2602,909,773,136,877,32,2700,1791,622,255,
2,"ARAD",29,11584,,230,0,"CLUBUL ""FORUM""PECICA NR.18/R","PECICA",45,11584,0,3,1264,720,435,285,704,16,1300,580,595,109,
2,"ARAD",29,11584,,231,0,"SC.PRIMARA NR.2""ZAGONY "" PECICA","PECICA",45,11584,0,3,985,645,356,289,626,19,1000,355,545,81,
2,"ARAD",29,11584,,232,0,"SEDIUL FOSTEI PRIMARII SAT TURNU NR.244","PECICA",45,11584,0,3,890,520,385,135,503,17,900,380,275,228,
2,"ARAD",29,11584,,233,0,"SC.GEN SAT SEDERHAT NR.116","PECICA",45,11584,0,3,203,131,103,28,131,0,300,169,64,67,
2,"ARAD",29,11637,,234,0,"CONS.LOCAL PEREGU-MARE","PEREGU MARE",46,11637,0,3,844,354,322,32,344,10,900,546,187,157,
2,"ARAD",29,11637,,235,0,"SEDIUL FOSTULUI CAP SAT PEREGU MIC NR.323","PEREGU MARE",46,11637,0,3,714,438,358,80,433,5,800,362,416,17,
2,"ARAD",29,11664,,236,0,"CONSILIUL LOCAL PETRIS","PETRIS",47,11664,0,3,507,325,261,64,321,4,600,275,150,171,
2,"ARAD",29,11664,,237,0,"CAMIN CULTURAL SAT ILTEU","PETRIS",47,11664,0,3,239,150,122,28,148,2,300,150,58,90,
2,"ARAD",29,11664,,238,0,"CAMIN CULTURAL SAT CORBESTI","PETRIS",47,11664,0,3,192,133,109,24,127,6,200,67,82,45,
2,"ARAD",29,11664,,239,0,"CAMIN CULTURAL SAT ROSIA NOUA","PETRIS",47,11664,0,3,407,235,208,27,229,6,500,265,125,104,
2,"ARAD",29,11735,,240,0,"CONS.LOCAL PILU","PILU",48,11735,0,3,742,520,438,82,518,2,800,280,373,145,
2,"ARAD",29,11735,,241,0,"SC.GEN.SAT VARSAND NR.31","PILU",48,11735,0,3,656,355,274,81,350,5,700,345,249,101,
2,"ARAD",29,11762,,242,0,"CAMIN CULTURAL PLESCUTA NR.34","PLESCUTA",49,11762,0,3,889,443,391,52,438,5,900,457,215,223,
2,"ARAD",29,11762,,243,0,"CAMIN CULTURAL SAT TALAGIU NR.62","PLESCUTA",49,11762,0,3,478,298,260,38,296,2,500,202,156,140,
2,"ARAD",29,11842,,244,0,"CAMIN CULTURAL SAVIRSIN","SAVARSIN",52,11842,0,3,1422,745,578,167,736,9,1500,755,401,335,
2,"ARAD",29,11842,,245,0,"CAMIN CULTURAL SAT PARNESTI","SAVARSIN",52,11842,0,3,208,161,129,32,159,2,300,139,95,64,
2,"ARAD",29,11842,,246,0,"SC.PRIMARA SAT TROAS","SAVARSIN",52,11842,0,3,209,124,94,30,124,0,300,176,49,75,
2,"ARAD",29,11842,,247,0,"CAMIN CULTURAL SAT TOC","SAVARSIN",52,11842,0,3,412,223,184,39,219,4,500,277,122,97,
2,"ARAD",29,11842,,248,0,"PCT.SANITAR CAPRIOARA","SAVARSIN",52,11842,0,3,266,172,130,42,169,3,300,128,108,61,
2,"ARAD",29,11940,,249,0,"PRIMARIA SECUSIGIU","SECUSIGIU",53,11940,0,3,1632,816,707,109,811,5,1700,884,408,403,
2,"ARAD",29,11940,,250,0,"SC.CL.I-IV SAT SATU MARE","SECUSIGIU",53,11940,0,3,757,443,369,74,433,10,800,357,122,311,
2,"ARAD",29,11940,,251,0,"CAMIN CULTURAL SAT MUNAR","SECUSIGIU",53,11940,0,3,400,295,225,70,289,6,500,205,157,132,
2,"ARAD",29,11940,,252,0,"SC.GEN.SAT SINPETRU GERMAN","SECUSIGIU",53,11940,0,3,1450,742,587,155,732,10,1500,758,292,440,
2,"ARAD",29,11995,,253,0,"CONS.LOCAL SELEUS NR.2","SELEUS",55,11995,0,3,1611,791,728,63,783,8,1700,909,372,411,
2,"ARAD",29,11995,,254,0,"SEDIUL FOSTEI PRIMARII SAT MORODA NR.331","SELEUS",55,11995,0,3,884,427,358,69,420,7,900,473,189,231,
2,"ARAD",29,12037,,255,0,"SC.GEN.NR.1,CL.I-VIII SEMLAC NR.648","SEMLAC",56,12037,0,3,1562,701,600,101,694,7,1600,899,252,442,
2,"ARAD",29,12037,,256,0,"SC.GEN NR.2,CL.I-IV NR.767","SEMLAC",56,12037,0,3,1561,840,708,132,834,6,1600,760,319,515,
2,"ARAD",29,12055,,257,0,"GRADINITA DE COPII SAT SINTEA MARE","SINTEA MARE",61,12055,0,3,898,535,459,76,520,15,1000,465,253,267,
2,"ARAD",29,12055,,258,0,"CAMIN CULTURAL SAT ADEA","SINTEA MARE",61,12055,0,3,775,395,351,44,385,10,800,405,353,32,
2,"ARAD",29,12055,,259,0,"CAMIN CULTURAL SAT TIPARI","SINTEA MARE",61,12055,0,3,1082,485,425,60,479,6,1100,615,351,128,
2,"ARAD",29,12091,,260,0,"CAMIN CULTURAL SANTANA,STR.BUCEGI NR.32","SANTANA",51,12091,0,3,1953,764,687,77,758,6,2000,1236,312,446,
2,"ARAD",29,12091,,261,0,"SC.CL.I-IV SANTANA,STR.MUNCII NR.68","SANTANA",51,12091,0,3,1549,613,467,146,602,11,1600,987,330,272,
2,"ARAD",29,12091,,262,0,"CAMINUL CULTURAL SAT COMLAUS STR.1 DECEMBRIE NR.36","SANTANA",51,12091,0,3,2177,1155,1008,147,1138,17,2200,1045,569,569,
2,"ARAD",29,12091,,263,0,"GRADINITA ROMILOR SAT COMLAUS, STR. MUNCII NR.119","SANTANA",51,12091,0,3,2096,867,781,86,842,25,2200,1333,538,304,
2,"ARAD",29,12091,,264,0,"CAMINUL CULTURAL CRISANA STR.UNIRII NR.3","SANTANA",51,12091,0,3,1956,1002,928,74,992,10,2000,998,499,493,
2,"ARAD",29,12091,,265,0,"CAMINUL CULTURAL SAT CAPORAL ALEXA NR.173","SANTANA",51,12091,0,3,959,554,481,73,549,5,1000,446,282,267,
2,"ARAD",29,12126,,266,0,"PRIMARIA SOCODOR","SOCODOR",64,12126,0,3,1773,908,825,83,898,10,1800,892,491,407,
2,"ARAD",29,12144,,267,0,"PRIMARIA SAGU","SAGU",50,12144,0,3,1606,827,725,102,821,6,1700,873,270,551,
2,"ARAD",29,12144,,268,0,"SCOALA GENERALA SAT CRUCENI","SAGU",50,12144,0,3,482,312,247,65,307,5,500,188,113,194,
2,"ARAD",29,12144,,269,0,"SCOALA GENERALA SAT FIRITEAZ","SAGU",50,12144,0,3,342,211,176,35,207,4,400,189,116,91,
2,"ARAD",29,12144,,270,0,"SCOALA GEN. SAT FISCUT","SAGU",50,12144,0,3,373,224,178,46,224,0,400,176,160,64,
2,"ARAD",29,12144,,271,0,"ASOCIATIA AGRICOLA SAT HUNEDOARA TIMISANA","SAGU",50,12144,0,3,209,124,100,24,123,1,300,176,47,76,
2,"ARAD",29,12206,,272,0,"CONSILIUL LOCAL SEITIN, STR. REVOLUTIEI NR.49","SEITIN",54,12206,0,3,1150,635,528,107,619,16,1200,565,272,347,
2,"ARAD",29,12206,,273,0,"SC. GEN. NR.2 SEITIN.STR. REVOLUTIEI NR.40","SEITIN",54,12206,0,3,947,537,454,83,524,13,1000,463,218,306,
2,"ARAD",29,12224,,274,0,"CONSILIUL LOCAL SEPREUS NR. 298","SEPREUS",57,12224,0,3,871,518,472,46,509,9,900,382,251,258,
2,"ARAD",29,12224,,275,0,"CAMINUL CULTURAL SEPREUS NR. 301","SEPREUS",57,12224,0,3,1141,590,538,52,582,8,1200,610,300,282,
2,"ARAD",29,12242,,276,0,"CAMIN CULTURAL SICULA","SICULA",58,12242,0,3,1930,1044,962,82,1034,10,2000,956,453,581,
2,"ARAD",29,12242,,277,0,"SC. GEN. CL I-VIII SAT CHERELUS","SICULA",58,12242,0,3,810,464,426,38,462,2,900,436,186,276,
2,"ARAD",29,12242,,278,0,"CAMIN CULTURAL SAT GURBA","SICULA",58,12242,0,3,986,655,584,71,645,10,1000,345,385,260,
2,"ARAD",29,12288,,279,0,"CONSILIUL LOCAL SILINDIA","SILINDIA",59,12288,0,3,708,338,268,70,331,7,900,562,202,129,
2,"ARAD",29,12340,,280,0,"SCOALA GEN. CL. I-IV SIMAND NR.1202","SIMAND",60,12340,0,3,1724,900,805,95,891,9,1800,900,478,413,
2,"ARAD",29,12340,,281,0,"SC. GEN. CLS. I-IV SIMAND NR.692","SIMAND",60,12340,0,3,1251,686,605,81,679,7,1300,614,361,318,
2,"ARAD",29,12368,,282,0,"CAMINUL CULTURAL SIRIA","SIRIA",62,12368,0,3,2058,827,691,136,809,18,2100,1273,413,396,
2,"ARAD",29,12368,,283,0,"SCOALA CU CLASELE I-IV SIRIA","SIRIA",62,12368,0,3,1900,820,691,129,797,23,1900,1080,518,279,
2,"ARAD",29,12368,,284,0,"CAMINUL CULTURAL SAT GALSA","SIRIA",62,12368,0,3,1593,869,737,132,858,11,1600,731,507,351,
2,"ARAD",29,12368,,285,0,"CAMINUL CULTURAL SAT MISCA","SIRIA",62,12368,0,3,760,511,454,57,507,4,800,289,256,251,
2,"ARAD",29,12402,,286,0,"PRIMARIA COMUNEI SISTAROVAT","SISTAROVAT",63,12402,0,3,274,217,155,62,214,3,300,83,114,100,
2,"ARAD",29,9360,,287,0,"SC.GENERALA CL.I-VIII  SOFRONEA","SOFRONEA",65,9360,0,3,1511,679,592,87,673,6,1600,921,392,281,
2,"ARAD",29,9360,,288,0,"SCOALA GEN . CL. I-IV SAT SINPAUL NR.252","SOFRONEA",65,9360,0,3,443,271,200,71,269,2,500,229,234,35,
2,"ARAD",29,12457,,289,0,"CONSILIUL LOCAL TAUT","TAUT",67,12457,0,3,697,392,322,70,390,2,800,408,217,173,
2,"ARAD",29,12457,,290,0,"SCOALA GEN SAT MINISEL","TAUT",67,12457,0,3,182,122,102,20,119,3,200,78,42,77,
2,"ARAD",29,12457,,291,0,"CAMINUL CULTURAL SAT MINISUL DE SUS","TAUT",67,12457,0,3,125,107,75,32,104,3,200,93,39,65,
2,"ARAD",29,12457,,292,0,"SEDIUL FOSTEI PRIMARII SAT NADAS","TAUT",67,12457,0,3,773,468,387,81,462,6,800,332,139,323,
2,"ARAD",29,12509,,293,0,"CAMINUL CULTURAL TARNOVA","TARNOVA",66,12509,0,3,1474,817,734,83,783,34,1500,683,340,443,
2,"ARAD",29,12509,,294,0,"CAMINUL CULTURAL SAT AGRISUL MARE","TARNOVA",66,12509,0,3,762,453,390,63,442,11,800,347,183,259,
2,"ARAD",29,12509,,295,0,"CAMINUL CULTURAL SAT ARANEAG","TARNOVA",66,12509,0,3,326,215,179,36,207,8,400,185,113,94,
2,"ARAD",29,12509,,296,0,"CAMINUL CULTURAL SAT DRAUT","TARNOVA",66,12509,0,3,794,581,536,45,566,15,800,219,396,170,
2,"ARAD",29,12509,,297,0,"CAMINUL CULTURAL SAT DUD","TARNOVA",66,12509,0,3,473,327,273,54,320,7,500,173,163,157,
2,"ARAD",29,12509,,298,0,"CAMIN CULTURAL SAT CHIER","TARNOVA",66,12509,0,3,875,506,438,68,492,14,900,394,224,268,
2,"ARAD",29,10765,,299,0,"SCOALA GEN. USUSAU","DORGOS (USUSAU)",28,10765,0,3,410,271,212,59,268,3,500,229,113,155,
2,"ARAD",29,10765,,300,0,"CAMIN CULTURAL SAT DORGOS","DORGOS (USUSAU)",28,10765,0,3,159,110,73,37,109,1,200,90,53,56,
2,"ARAD",29,10765,,301,0,"SCOALA GEN. SAT PATARS","DORGOS (USUSAU)",28,10765,0,3,77,58,35,23,56,2,100,42,22,34,
2,"ARAD",29,10765,,302,0,"SCOALA GEN. SAT ZABALT","DORGOS (USUSAU)",28,10765,0,3,231,169,130,39,169,0,300,131,107,62,
2,"ARAD",29,10765,,303,0,"SCOALA GEN. SAT BRUZNIC","DORGOS (USUSAU)",28,10765,0,3,119,95,64,31,94,1,200,105,67,27,
2,"ARAD",29,12572,,304,0,"PRIMARIA COMUNEI VARADIA DE MURES","VARADIA DE MURES",68,12572,0,3,472,246,193,53,243,3,500,254,97,146,
2,"ARAD",29,12572,,305,0,"SCOALA GEN. SAT JULITA","VARADIA DE MURES",68,12572,0,3,343,239,169,70,236,3,400,161,105,131,
2,"ARAD",29,12572,,306,0,"CAMIN CULTURAL SAT LUPESTI","VARADIA DE MURES",68,12572,0,3,274,190,166,24,189,1,300,110,94,95,
2,"ARAD",29,12572,,307,0,"SCOALA GEN. SAT BALCESCU","VARADIA DE MURES",68,12572,0,3,197,133,108,25,129,4,300,167,86,43,
2,"ARAD",29,12572,,308,0,"CAMINUL CULTURAL SAT BAIA","VARADIA DE MURES",68,12572,0,3,131,97,79,18,97,0,200,103,35,62,
2,"ARAD",29,12572,,309,0,"SCOALA GEN SAT STEJAR","VARADIA DE MURES",68,12572,0,3,116,117,81,36,117,0,200,83,54,63,
2,"ARAD",29,12643,,310,0,"CONSILIUL LOCAL VINGA","VINGA",70,12643,0,3,1599,748,629,119,738,10,1700,952,358,380,
2,"ARAD",29,12643,,311,0,"SCOALA GEN. NR. 2 VINGA","VINGA",70,12643,0,3,1556,783,668,115,763,20,1600,817,280,483,
2,"ARAD",29,12643,,312,0,"CAMINUL CULTURAL SAT MAILAT","VINGA",70,12643,0,3,858,544,430,114,538,6,900,356,518,20,
2,"ARAD",29,12643,,313,0,"SCOALA GEN. I-VIII SAT MANASTUR","VINGA",70,12643,0,3,804,509,418,91,504,5,900,391,162,342,
2,"ARAD",29,12689,,314,0,"PRIMARIA COMUNEI VARFURILE","VARFURILE",69,12689,0,3,1199,876,779,97,871,5,1300,424,519,352,
2,"ARAD",29,12689,,315,0,"SCOALA GEN.I-IV SAT AVRAM IANCU","VARFURILE",69,12689,0,3,830,687,631,56,672,15,900,213,299,373,
2,"ARAD",29,12689,,316,0,"CAMINUL CULTURAL SAT LAZURI","VARFURILE",69,12689,0,3,751,622,561,61,617,5,800,178,292,325,
2,"ARAD",29,9397,,317,0,"PRIMARIA VLADIMIRESCU , STR. REVOLUTIEI NR.4","VLADIMIRESCU",71,9397,0,3,1613,754,642,112,742,12,1700,946,395,347,
2,"ARAD",29,9397,,318,0,"SCOALA GEN I-IV, STR. PROGRESUL NR.69","VLADIMIRESCU",71,9397,0,3,1978,865,722,143,851,14,1900,1035,433,418,
2,"ARAD",29,9397,,319,0,"LICEUL SPORTIV VLADIMIRESCU , STR. GARII NR. 59-61","VLADIMIRESCU",71,9397,0,3,1293,682,576,106,671,11,1400,718,278,393,
2,"ARAD",29,9397,,320,0,"SCOALA GEN. SAT HORIA","VLADIMIRESCU",71,9397,0,3,1706,952,838,114,948,4,1800,848,357,591,
2,"ARAD",29,9397,,321,0,"SCOALA GEN. SAT MANDRULOC","VLADIMIRESCU",71,9397,0,3,874,449,363,86,444,5,900,451,212,232,
2,"ARAD",29,9397,,322,0,"GRADINITA DE COPII SAT CICIR","VLADIMIRESCU",71,9397,0,3,659,446,368,78,442,4,700,254,186,256,
2,"ARAD",29,9397,,323,1,"U.M. VLADIMIRESCU","VLADIMIRESCU",71,9397,0,3,0,345,0,345,331,14,400,55,185,146,
2,"ARAD",29,12778,,324,0,"CAMINUL CULTURAL ZABRANI NR.648","ZABRANI",72,12778,0,3,1665,844,743,101,834,10,1700,856,329,505,
2,"ARAD",29,12778,,325,0,"FOSTUL SEDIU CAP SAT CHESINT NR.480","ZABRANI",72,12778,0,3,926,527,436,91,518,9,1000,473,293,225,
2,"ARAD",29,12778,,326,0,"FOST DISPENSAR UMANI SAT NEUDORF NR.152","ZABRANI",72,12778,0,3,728,437,371,66,433,4,800,363,219,214,
2,"ARAD",29,12812,,327,0,"PRIMARIA COMUNEI ZARAND","ZARAND",73,12812,0,3,1103,952,839,113,936,16,1200,248,541,395,
2,"ARAD",29,12812,,328,0,"SCOALA GEN. SAT CINTEI NR.88","ZARAND",73,12812,0,3,958,887,831,56,875,12,1000,113,565,310,
2,"ARAD",29,12849,,329,0,"CONSILIUL LOCAL ZERIND","ZERIND",74,12849,0,3,727,375,342,33,370,5,796,421,353,17,
2,"ARAD",29,12849,,330,0,"SCOALA GENERAL SAT IERMATA NEAGRA","ZERIND",74,12849,0,3,473,320,286,34,317,3,496,176,305,12,
2,"ARAD",29,12876,,331,0,"CAMINUL CULTURAL ZIMANDU NOU","ZIMANDU NOU",75,12876,0,3,2698,1144,1021,123,1119,25,2895,1751,699,420,
2,"ARAD",29,12876,,332,0,"CAMINUL CULTURAL SAT ZIMANDUL CUZ","ZIMANDU NOU",75,12876,0,3,923,522,403,119,509,13,1000,478,387,122,
3,"ARGES",38,13169,,1,0,"TEHNIC CLUB STR. JUSTITIEI NR.2","MUNICIPIUL PITESTI",1,13169,1,1,1609,1028,881,147,1014,14,1761,733,775,239,
3,"ARGES",38,13169,,2,0,"GRUP SCOLAR ECONOMIC TEHNOLOGIC ADMINISTRATIV ""MARIA TEIULEANI"" BD. REPUBLICII NR.63","MUNICIPIUL PITESTI",1,13169,1,1,1343,815,683,132,789,26,1472,657,637,152,
3,"ARGES",38,13169,,3,0,"SCOALA NR.3 INTRAREA RAHOVEI NR.6","MUNICIPIUL PITESTI",1,13169,1,1,1123,587,513,74,578,9,1225,638,423,155,
3,"ARGES",38,13169,,4,0,"GRUP SCOLAR INDUSTRIAL CONSTRUCTII NR.2 BD.EROILOR NR.6","MUNICIPIUL PITESTI",1,13169,1,1,1483,831,773,58,814,17,1634,803,533,281,
3,"ARGES",38,13169,,5,0,"SCOALA NR.12 STR.BRADULUI NR.13 CARTIER TRIVALE","MUNICIPIUL PITESTI",1,13169,1,1,1671,906,821,85,896,10,1839,933,582,314,
3,"ARGES",38,13169,,6,0,"SCOALA NR.12(INTRAREA B) STR.BRADULUI NR.13 CARTIER TRIVALE","MUNICIPIUL PITESTI",1,13169,1,1,2047,1065,990,75,1057,8,2260,1195,707,350,
3,"ARGES",38,13169,,7,0,"SCOALA NR.12(INTRAREA C) STR.BRADULUI NR.13 CARTIER TRIVALE","MUNICIPIUL PITESTI",1,13169,1,1,1750,777,723,54,775,2,1942,1165,466,309,
3,"ARGES",38,13169,,8,0,"CASA DE COPII SCOLARI CALEA DRAGASANI NR.10 CARTIER TRIVALE","MUNICIPIUL PITESTI",1,13169,1,1,1712,907,816,91,902,5,1886,979,570,332,
3,"ARGES",38,13169,,9,0,"GRADINITA NR.13 STR.CAMPULUI NR.10 CARTIER TRIVALE","MUNICIPIUL PITESTI",1,13169,1,1,1818,831,765,66,822,9,1999,1168,502,320,
3,"ARGES",38,13169,,10,0,"SCOALA NR.13 (INTRAREA A) STR.ZIMBRULUI NR.13 CARTIER TRIVALE","MUNICIPIUL PITESTI",1,13169,1,1,1416,747,679,68,740,7,1549,802,507,233,
3,"ARGES",38,13169,,11,0,"SCOALA NR.13 (INTRAREA B) STR.ZIMBRULUI NR.13 CARTIER TRIVALE","MUNICIPIUL PITESTI",1,13169,1,1,2179,1154,1067,87,1122,32,2407,1253,722,400,
3,"ARGES",38,13169,,12,0,"SCOALA NR.13 (INTRAREA C) STR.ZIMBRULUI NR.13 CARTIER TRIVALE","MUNICIPIUL PITESTI",1,13169,1,1,2379,1310,1200,110,1299,11,2621,1311,821,478,
3,"ARGES",38,13169,,13,0,"SCOALA NR.13 (INTRAREA D) STR.ZIMBRULUI NR.13 CARTIER TRIVALE","MUNICIPIUL PITESTI",1,13169,1,1,1744,1046,959,87,1020,26,1911,865,673,347,
3,"ARGES",38,13169,,14,0,"GRADINITA CU PROGRAM PRELUNGIT SI CRESA NR.6(INTRAREA A) STR.FRASINULUI NR.10 CARTIER TRIVALE","MUNICIPIUL PITESTI",1,13169,1,1,1628,952,899,53,936,16,1790,838,686,250,
3,"ARGES",38,13169,,15,0,"GRADINITA CU PROGRAM PRELUNGIT SI CRESA NR.6(INTRAREA B) STR.FRASINULUI NR.10 CARTIER TRIVALE","MUNICIPIUL PITESTI",1,13169,1,1,1430,1001,941,60,997,4,2096,1095,689,308,
3,"ARGES",38,13169,,16,0,"LICEUL INDUSTRIAL NR.1 INTRAREA TEILOR NR.1","MUNICIPIUL PITESTI",1,13169,1,1,1474,978,782,196,961,17,1621,643,704,257,
3,"ARGES",38,13169,,17,0,"COLEGIUL NATIONAL I.C.BRATIANU STR.ARMAND CALINESCU NR.14","MUNICIPIUL PITESTI",1,13169,1,1,1082,836,523,313,825,11,1295,459,598,227,
3,"ARGES",38,13169,,18,0,"SCOALA NR.9 (INTRAREA A) STR.NEGRU VODA NR.31","MUNICIPIUL PITESTI",1,13169,1,1,1873,1186,1029,157,1170,16,2059,873,865,305,
3,"ARGES",38,13169,,19,0,"SCOALA NR.9 (INTRAREA B) STR.NEGRU VODA NR.31","MUNICIPIUL PITESTI",1,13169,1,1,1829,1154,1001,153,1134,20,2008,854,836,298,
3,"ARGES",38,13169,,20,0,"SEDIUL DISPENSARE UMANE ZONA NORD (FOSTA CLADIRE A CRESEI NR.4) STR.CONSTANTIN STATESCU NR.14","MUNICIPIUL PITESTI",1,13169,1,1,2518,1035,917,118,1030,5,2185,1150,645,385,
3,"ARGES",38,13169,,21,0,"SOCIETATEA COMERCIALA GROSMETCHIM BD. NICOLAE BALCESCU NR.48","MUNICIPIUL PITESTI",1,13169,1,1,2225,1153,1096,57,1145,8,2444,1291,689,456,
3,"ARGES",38,13169,,22,0,"SCOALA NR.6 (INTRAREA A) BD.1 DECEMBRIE 1918 CARTIER TRIVALE","MUNICIPIUL PITESTI",1,13169,1,1,2060,1100,993,107,1096,4,2273,1173,688,408,
3,"ARGES",38,13169,,23,0,"SCOALA NR.6 (INTRAREA B) BD.1 DECEMBRIE 1918 CARTIER TRIVALE","MUNICIPIUL PITESTI",1,13169,1,1,2371,1046,958,88,1040,6,2524,1478,625,415,
3,"ARGES",38,13169,,24,0,"GRADINITA CU PROGRAM PRELUNGIT SI CRESA NR.10 STR. STEJARULUI NR.11 CARTIER GAVANA","MUNICIPIUL PITESTI",1,13169,1,1,2304,1125,1047,78,1122,3,2549,1424,674,448,
3,"ARGES",38,13169,,25,0,"SCOALA NR.15 (INTRAREA A) STR.PALTINULUI NR.17 CARTIER GAVANA","MUNICIPIUL PITESTI",1,13169,1,1,2106,1150,1058,92,1142,8,2327,1177,689,453,
3,"ARGES",38,13169,,26,0,"SCOALA NR.15 (INTRAREA B) STR.PALTINULUI NR.17 CARTIER GAVANA","MUNICIPIUL PITESTI",1,13169,1,1,2213,1188,1098,90,1179,9,2444,1256,721,458,
3,"ARGES",38,13169,,27,0,"CINEMATOGRAFUL LUMINA BD.NICOLAE BALCESCU NR.141","MUNICIPIUL PITESTI",1,13169,1,1,2510,1345,1254,91,1343,2,2765,1420,837,506,
3,"ARGES",38,13169,,28,0,"SC SUBANSAMBLE AUTO SA BD. NICOLAE BALCESCU NR.165","MUNICIPIUL PITESTI",1,13169,1,1,1760,1019,938,81,1013,6,1939,920,657,356,
3,"ARGES",38,13169,,29,0,"SC URSUS SA BD.NICOLAE BALCESCU NR.158","MUNICIPIUL PITESTI",1,13169,1,1,1345,938,780,158,932,6,1471,533,599,333,
3,"ARGES",38,13169,,30,0,"SC LIXA DRAXLMAIER SA (INTRAREA A) BD. NICOLAE BALCESCU NR.164","MUNICIPIUL PITESTI",1,13169,1,1,2251,1254,1099,155,1245,9,2473,1219,780,465,
3,"ARGES",38,13169,,31,0,"SC LIXA DRAXLMAIER SA (INTRAREA B) BD. NICOLAE BALCESCU NR.164","MUNICIPIUL PITESTI",1,13169,1,1,908,697,525,172,693,4,998,301,410,283,
3,"ARGES",38,13169,,32,0,"POLICLINICA SPITALULUI JUDETEAN(INTRAREA A) ALEEA SPITALULUI GAVANA NR.1","MUNICIPIUL PITESTI",1,13169,1,1,1777,1035,819,216,1032,3,1956,921,646,386,
3,"ARGES",38,13169,,33,0,"POLICLINICA SPITALULUI JUDETEAN(INTRAREA B) ALEEA SPITALULUI GAVANA NR.1","MUNICIPIUL PITESTI",1,13169,1,1,2069,1605,1081,524,1582,23,2274,669,1005,577,
3,"ARGES",38,13169,,34,0,"GRUP SCOLAR ""ION CANTACUZINO"" BD. 1 DECEMBRIE 1918 NR.1","MUNICIPIUL PITESTI",1,13169,1,1,1798,1003,911,92,995,8,1976,973,628,367,
3,"ARGES",38,13169,,35,0,"SCOALA NR.19 (INTRAREA A) CARTIER GAVANA III","MUNICIPIUL PITESTI",1,13169,1,1,2195,1231,1123,108,1230,1,2421,1190,759,471,
3,"ARGES",38,13169,,36,0,"SCOALA NR.19 (INTRAREA B) CARTIER GAVANA III","MUNICIPIUL PITESTI",1,13169,1,1,1816,859,814,45,848,11,2006,1147,533,315,
3,"ARGES",38,13169,,37,0,"CAMINUL LICEULUI ECONOMIC(GRADINITA CU PROGRAM NORMAL NR.21) CALEA BASCOV NR.6","MUNICIPIUL PITESTI",1,13169,1,1,2198,1283,1074,209,1273,10,2422,1139,828,445,
3,"ARGES",38,13169,,38,0,"SCOALA NR.14 STR.FAGARAS NR.10","MUNICIPIUL PITESTI",1,13169,1,1,2013,1129,1038,91,1109,20,2217,1088,734,375,
3,"ARGES",38,13169,,39,0,"SCOALA NR.10 ""MARIN PREDA"" (INTRAREA B) STR.PICTOR NICOLAE GRIGORESCU NR.37","MUNICIPIUL PITESTI",1,13169,1,1,1714,959,898,61,948,11,1888,929,669,279,
3,"ARGES",38,13169,,40,0,"SCOALA NR.10 ""MARIN PREDA"" (INTRAREA A) STR.PICTOR NICOLAE GRIGORESCU NR.37","MUNICIPIUL PITESTI",1,13169,1,1,1751,1071,914,157,1063,8,1926,855,773,290,
3,"ARGES",38,13169,,41,0,"SCOALA NR.10 ""MARIN PREDA"" (INTRAREA B) STR.PICTOR NICOLAE GRIGORESCU NR.37","MUNICIPIUL PITESTI",1,13169,1,1,1821,1195,1090,105,1170,25,2000,805,883,287,
3,"ARGES",38,13169,,42,0,"GRADINITA CU PROGRAM PRELUNGIT NR.3 BD.I.C.BRATIANU NR.50","MUNICIPIUL PITESTI",1,13169,1,1,898,552,418,134,547,5,977,425,422,125,
3,"ARGES",38,13169,,43,0,"SCOALA NR.1 ""NICOLAE SIMONIDE"" (INTRAREA A) STR. 9 MAI NR.50","MUNICIPIUL PITESTI",1,13169,1,1,1434,908,831,77,893,15,1570,662,698,195,
3,"ARGES",38,13169,,44,0,"SCOALA NR.1 ""NICOLAE SIMONIDE"" (INTRAREA B) STR. 9 MAI NR.50","MUNICIPIUL PITESTI",1,13169,1,1,1584,938,815,123,932,6,1743,805,641,291,
3,"ARGES",38,13169,,45,0,"SC ""SECONA""SA STR.MIHAI EMINESCU NR.11","MUNICIPIUL PITESTI",1,13169,1,1,1052,667,573,94,659,8,1150,483,479,180,
3,"ARGES",38,13169,,46,0,"DIRECTIA APELOR ARGES CALEA CAMPULUNG NR.6","MUNICIPIUL PITESTI",1,13169,1,1,584,349,281,68,343,6,633,284,227,116,
3,"ARGES",38,13169,,47,0,"DISPENSARUL NR.16(IN CLADIREA CRESEI NR.9) STR.MIHAI EMINESCU NR.1","MUNICIPIUL PITESTI",1,13169,1,1,2169,1071,1016,55,1062,9,2406,1335,743,319,
3,"ARGES",38,13169,,48,0,"GRUP SCOLAR DE INDUSTRIE USOARA ""ARMAND CALINESCU"" BD.I.C.BRATIANU NR.44","MUNICIPIUL PITESTI",1,13169,1,1,1893,1061,955,106,1026,35,2068,1007,814,212,
3,"ARGES",38,13169,,49,0,"SCOALA NR.5 (INTRAREA A) STR.RAURILOR NR.11","MUNICIPIUL PITESTI",1,13169,1,1,1798,856,779,77,846,10,1888,1032,591,255,
3,"ARGES",38,13169,,50,0,"SCOALA NR.5 (INTRAREA B) STR.RAURILOR NR.11","MUNICIPIUL PITESTI",1,13169,1,1,1116,602,522,80,590,12,1228,626,442,148,
3,"ARGES",38,13169,,51,0,"SANTIER C.F.NR.11 STR.GARII NR.7","MUNICIPIUL PITESTI",1,13169,1,1,2147,1185,1063,122,1166,19,2362,1177,729,437,
3,"ARGES",38,13169,,52,0,"CRESA CALUGARENI CARTIER TUDOR VLADIMIRESCU","MUNICIPIUL PITESTI",1,13169,1,1,2736,1417,1323,94,1403,14,3017,1600,843,560,
3,"ARGES",38,13169,,53,0,"SCOALA NR.18 (INTRAREA A) CARTIER PRUNDU","MUNICIPIUL PITESTI",1,13169,1,1,2380,1156,1106,50,1146,10,2634,1478,734,412,
3,"ARGES",38,13169,,54,0,"SCOALA NR.18 (INTRAREA B) CARTIER PRUNDU","MUNICIPIUL PITESTI",1,13169,1,1,1704,803,764,39,800,3,1883,1080,512,288,
3,"ARGES",38,13169,,55,0,"SCOALA NR.7 (INTRAREA A) CARTIER PRUNDU","MUNICIPIUL PITESTI",1,13169,1,1,2877,1376,1237,139,1351,25,3170,1794,782,569,
3,"ARGES",38,13169,,56,0,"SCOALA NR.7 (INTRAREA B) CARTIER PRUNDU","MUNICIPIUL PITESTI",1,13169,1,1,2894,1560,1465,95,1545,15,3190,1630,1011,534,
3,"ARGES",38,13169,,57,0,"DEPOUL C.F.R.PITESTI CARTIER PRUNDU","MUNICIPIUL PITESTI",1,13169,1,1,1856,1097,1008,89,1080,17,2042,945,719,361,
3,"ARGES",38,13169,,58,0,"GRUP SCOLAR DE CHIMIE INDUSTRIALA (INTRAREA A) CARTIER PRUNDU","MUNICIPIUL PITESTI",1,13169,1,1,2290,1322,1091,231,1308,14,2661,1339,866,442,
3,"ARGES",38,13169,,59,0,"GRUP SCOLAR DE CHIMIE INDUSTRIALA (INTRAREA B) CARTIER PRUNDU","MUNICIPIUL PITESTI",1,13169,1,1,1950,1273,1057,216,1241,32,2217,944,728,513,
3,"ARGES",38,13169,,60,0,"SCOALA NR.8 BD.REPUBLICII NR.204","MUNICIPIUL PITESTI",1,13169,1,1,2411,1372,1202,170,1355,17,2384,1012,916,439,
3,"ARGES",38,13169,,61,0,"SC ELECTRICA SA SUCURSALA DE DISTRIBUTIE A ENERGIEI ELECTRICE - PITESTI BD.REPUBLICII NR.148","MUNICIPIUL PITESTI",1,13169,1,1,1750,955,823,132,936,19,1925,970,666,270,
3,"ARGES",38,13169,,62,0,"SCOALA NR.11 (INTRAREA A) STR.TINERETULUI NR.4","MUNICIPIUL PITESTI",1,13169,1,1,1767,1002,938,64,984,18,1952,765,686,298,
3,"ARGES",38,13169,,63,0,"SCOALA NR.11 (INTRAREA B) STR.TINERETULUI NR.4","MUNICIPIUL PITESTI",1,13169,1,1,1495,814,735,79,810,4,1644,830,575,235,
3,"ARGES",38,13169,,64,0,"GRADINITA CU PROGRAM PRELUNGIT SI CRESA NR.5 STR.CRAIOVEI NR.123","MUNICIPIUL PITESTI",1,13169,1,1,1315,793,749,44,785,8,1430,637,553,232,
3,"ARGES",38,13169,,65,0,"UNIVERSITATEA PITESTI STR. GHEORGHE DOJA NR.41","MUNICIPIUL PITESTI",1,13169,1,1,1702,936,850,86,922,14,1878,942,694,228,
3,"ARGES",38,13169,,66,0,"COLEGIUL NATIONAL ""ALEXANDRU ODOBESCU"" STR.BUREBISTA NR.20","MUNICIPIUL PITESTI",1,13169,1,1,2249,1204,1107,97,1195,9,2475,1271,783,412,
3,"ARGES",38,13169,,67,0,"GRADINITA CU PROGRAM PRELUNGIT SI CRESA NR.8 CARTIER RAZBOIENI","MUNICIPIUL PITESTI",1,13169,1,1,2686,1198,1055,143,1172,26,2938,1740,759,413,
3,"ARGES",38,13169,,68,0,"SCOALA NR.2 (INTRAREA A) STR.EXERCITIU NR.206","MUNICIPIUL PITESTI",1,13169,1,1,2173,1084,989,95,1075,9,2392,1308,695,380,
3,"ARGES",38,13169,,69,0,"SCOALA NR.2 (INTRAREA B) STR.EXERCITIU NR.206","MUNICIPIUL PITESTI",1,13169,1,1,2002,1146,1054,92,1129,17,2198,1052,761,368,
3,"ARGES",38,13169,,70,0,"GRUP SCOLAR INDUSTRIAL DE CONSTRUCTII MONTAJ NR.1 (INTRAREA A) CARTIER RAZBOIENI","MUNICIPIUL PITESTI",1,13169,1,1,2103,1152,1026,126,1139,13,2323,1171,748,391,
3,"ARGES",38,13169,,71,0,"GRUP SCOLAR INDUSTRIAL DE CONSTRUCTII MONTAJ NR.1 (INTRAREA B) CARTIER RAZBOIENI","MUNICIPIUL PITESTI",1,13169,1,1,1338,792,541,251,772,20,1475,683,439,333,
3,"ARGES",38,13169,,72,0,"SCOALA NR.17 STR.VASILE PIRVAN NR.1","MUNICIPIUL PITESTI",1,13169,1,1,1941,947,875,72,943,4,2137,1190,582,361,
3,"ARGES",38,13169,,73,0,"GRUP SCOLAR DE INDUSTRIALIZARE A LEMNULUI STR.PATRASCU VODA NR.2","MUNICIPIUL PITESTI",1,13169,1,1,1942,1107,1020,87,1101,6,2139,1032,711,390,
3,"ARGES",38,13169,,74,0,"SC AUTO DACIA SA STR.MIRCEA VODA NR.42","MUNICIPIUL PITESTI",1,13169,1,1,2134,1157,1080,77,1135,22,2349,1192,814,321,
3,"ARGES",38,13169,,75,0,"CRESA DOBRESCU ARGES ALEEA CIRESULUI NR.4 CARTIER BANAT","MUNICIPIUL PITESTI",1,13169,1,1,2160,1240,1104,136,1232,8,2366,1126,803,429,
3,"ARGES",38,13169,,76,0,"GRADINITA CU PROGRAM PRELUNGIT SI CRESA NR.14 ALEEA FRATII TRIFONESCU NR.21 CARTIER BANAT","MUNICIPIUL PITESTI",1,13169,1,1,2165,1211,1089,122,1195,16,2381,1170,816,379,
3,"ARGES",38,13169,,77,0,"SCOALA NR.16 (INTRAREA A) STR.DOBRESCU ARGES NR.4 CARTIER BANAT","MUNICIPIUL PITESTI",1,13169,1,1,2163,1160,1064,96,1151,9,2382,1222,784,367,
3,"ARGES",38,13169,,78,0,"SCOALA NR.16 (INTRAREA B) STR.DOBRESCU ARGES NR.4 CARTIER BANAT","MUNICIPIUL PITESTI",1,13169,1,1,2264,1131,1015,116,1121,10,2493,1362,720,401,
3,"ARGES",38,13169,,79,0,"SCOALA NR.4 (INTRAREA A) STR.TRAIAN NR.35","MUNICIPIUL PITESTI",1,13169,1,1,2208,1278,1191,87,1267,11,2422,1144,855,412,
3,"ARGES",38,13169,,80,0,"SCOALA NR.4 (INTRAREA B) STR.TRAIAN NR.35","MUNICIPIUL PITESTI",1,13169,1,1,2002,1187,1070,117,1172,15,2270,1083,807,365,
3,"ARGES",38,13169,,81,1,"SECTIE SPECIALA PENTRU MILITARI U.M 01225 PITESTI","MUNICIPIUL PITESTI",1,13169,1,1,711,666,627,39,652,14,1029,363,322,330,
3,"ARGES",38,13169,,82,1,"SECTIE SPECIALA PENTRU MILITARI U.M 01261 PITESTI","MUNICIPIUL PITESTI",1,13169,1,1,305,319,282,37,314,5,497,178,233,81,
3,"ARGES",38,13169,,83,1,"SECTIE SPECIALA PENTRU STUDENTI STR.GHEORGHE DOJA NR.41-CAMIN STUDENTESC","MUNICIPIUL PITESTI",1,13169,1,1,0,316,0,316,309,7,766,450,182,127,
3,"ARGES",38,13490,,84,0,"SCOALA DE MUZICA STR.REPUBLICII NR.51","MUNICIPIUL CAMPULUNG",2,13490,1,1,1260,717,640,77,706,11,1400,683,505,201,
3,"ARGES",38,13490,,85,0,"SCOALA GENERALA NR.1 STR. GENERAL POSOIU NR.1","MUNICIPIUL CAMPULUNG",2,13490,1,1,1231,748,671,77,736,12,1400,652,524,212,
3,"ARGES",38,13490,,86,0,"LICEUL INDUSTRIAL NR.1 STR. NEGRU VODA NR.145","MUNICIPIUL CAMPULUNG",2,13490,1,1,1525,880,781,99,869,11,1800,920,625,244,
3,"ARGES",38,13490,,87,0,"PIATA AGROALIMENTARA GRUI","MUNICIPIUL CAMPULUNG",2,13490,1,1,2022,1092,1019,73,1074,18,2200,1108,634,440,
3,"ARGES",38,13490,,88,0,"OFICIUL PTTR NR.4 GRUI BL.D18 STR. CARPATI NR.78","MUNICIPIUL CAMPULUNG",2,13490,1,1,2417,1372,1285,87,1364,8,2400,1028,770,594,
3,"ARGES",38,13490,,89,0,"BL.SC CIMPULUNG SA STR.I.TICALOIU NR.52","MUNICIPIUL CAMPULUNG",2,13490,1,1,1721,938,855,83,928,10,1800,862,518,410,
3,"ARGES",38,13490,,90,0,"SCOALA GENERALA NR.5 STR.NEGRU VODA NR.282","MUNICIPIUL CAMPULUNG",2,13490,1,1,900,576,481,95,570,6,1000,424,371,199,
3,"ARGES",38,13490,,91,0,"SCOALA GENERALA NR.6 VISOI STR.C.VODA NR.30","MUNICIPIUL CAMPULUNG",2,13490,1,1,982,596,553,43,590,6,1100,504,398,192,
3,"ARGES",38,13490,,92,0,"SCOALA GENERALA NR.7 VISOI SECTIA I,STR.G.TOPARCEANU NR.6","MUNICIPIUL CAMPULUNG",2,13490,1,1,1500,862,793,69,852,10,1600,738,444,408,
3,"ARGES",38,13490,,93,0,"SCOALA GENERALA NR.7 VISOI SECTIA II,STR.G.TOPARCEANU NR.6","MUNICIPIUL CAMPULUNG",2,13490,1,1,2197,1195,1102,93,1186,9,2400,1205,662,524,
3,"ARGES",38,13490,,94,0,"SEDIUL SC CONMUS SA STR.EMIL GARLEANU NR.14","MUNICIPIUL CAMPULUNG",2,13490,1,1,2200,1200,1101,99,1153,47,2400,1200,622,531,
3,"ARGES",38,13490,,95,0,"OFICIUL PTTR NR.3 VISOI STR.D.LAZEA BL.C4","MUNICIPIUL CAMPULUNG",2,13490,1,1,2397,1144,1085,59,1136,8,2400,1256,653,483,
3,"ARGES",38,13490,,96,0,"CINEMATOGRAF BALADA STR.D.LAZEA BL.C4","MUNICIPIUL CAMPULUNG",2,13490,1,1,2518,1340,1149,191,1331,9,2600,1260,761,570,
3,"ARGES",38,13490,,97,0,"BLOCUL TINERETULUI NR.1 ARO STR.DR.FALCOIANU","MUNICIPIUL CAMPULUNG",2,13490,1,1,1837,1030,935,95,1020,10,2000,970,678,342,
3,"ARGES",38,13490,,98,0,"SCOALA GENERALA VALEA ROMANESTILOR STR.VALEA ROMARESTILOR","MUNICIPIUL CAMPULUNG",2,13490,1,1,433,260,239,21,255,5,600,340,140,115,
3,"ARGES",38,13490,,99,0,"LICEUL DAN BARBILIAN STR.MR.GIRLAU NR.12C","MUNICIPIUL CAMPULUNG",2,13490,1,1,1232,675,613,62,669,6,1400,725,439,230,
3,"ARGES",38,13490,,100,0,"SCOALA NORMALA CAROL I STR.MARASESTI","MUNICIPIUL CAMPULUNG",2,13490,1,1,746,461,397,64,454,7,800,339,333,121,
3,"ARGES",38,13490,,101,0,"SEDIUL CONCIFOR STR.MARASTI NR.1","MUNICIPIUL CAMPULUNG",2,13490,1,1,951,536,494,42,531,5,1000,464,278,253,
3,"ARGES",38,13490,,102,0,"LICEUL MINIER NR.2 STR. MARESAL ANTONESCU NR.108","MUNICIPIUL CAMPULUNG",2,13490,1,1,1135,641,582,59,638,3,1400,759,423,215,
3,"ARGES",38,13490,,103,0,"SCOALA GENERALA NR.4 APA SARATA SOSEAUA MARESAL ANTONESCU","MUNICIPIUL CAMPULUNG",2,13490,1,1,926,511,466,45,505,6,1200,689,354,151,
3,"ARGES",38,13490,,104,0,"SCOALA GENERALA MARCUS STR. DRACESTI","MUNICIPIUL CAMPULUNG",2,13490,1,1,562,346,322,24,345,1,800,454,217,128,
3,"ARGES",38,13490,,105,0,"LICEUL DINICU GOLESCU STR.N.VODA NR.66","MUNICIPIUL CAMPULUNG",2,13490,1,1,1575,890,810,80,874,16,1600,710,598,276,
3,"ARGES",38,13490,,106,0,"SCOALA GENERALA NR.2 STR. REPUBLICII NR.3","MUNICIPIUL CAMPULUNG",2,13490,1,1,1131,822,570,252,811,11,1400,578,589,222,
3,"ARGES",38,13490,,107,1,"CASA DE CULTURA STR. REPUBLICII","MUNICIPIUL CAMPULUNG",2,13490,1,1,0,821,0,821,795,26,1000,179,459,336,
3,"ARGES",38,13622,,108,0,"CLUB UFET STR.VLAD TEPES NR.2","MUNICIPIUL CURTEA DE ARGES",3,13622,1,1,2017,1150,975,175,1143,7,2100,950,694,449,
3,"ARGES",38,13622,,109,0,"SCOALA GENERALA NR.2 STR.PROGRESULUI NR.1","MUNICIPIUL CURTEA DE ARGES",3,13622,1,1,1781,1053,904,149,1039,14,2000,947,676,363,
3,"ARGES",38,13622,,110,0,"LICEL ELECTROARGES STR.ALBESTI NR.5","MUNICIPIUL CURTEA DE ARGES",3,13622,1,1,1271,640,544,96,637,3,1400,760,384,253,
3,"ARGES",38,13622,,111,0,"LICEUL AGROINDUSTRIAL B-DUL BASARABILOR NR.15","MUNICIPIUL CURTEA DE ARGES",3,13622,1,1,2756,1494,1300,194,1486,8,3020,1526,865,621,
3,"ARGES",38,13622,,112,0,"SCOALA GENERALA NR.6 STR.POSADA NR.1","MUNICIPIUL CURTEA DE ARGES",3,13622,1,1,2527,1180,1054,126,1163,17,2700,1520,678,485,
3,"ARGES",38,13622,,113,0,"LICEUL INDUSTRIAL 1 SECTIA I B-DUL BASARABILOR NR.21","MUNICIPIUL CURTEA DE ARGES",3,13622,1,1,2195,987,914,73,975,12,2300,1313,593,382,
3,"ARGES",38,13622,,114,0,"LICEUL INDUSTRIAL 1 SECTIA II B-DUL BASARABILOR NR.21","MUNICIPIUL CURTEA DE ARGES",3,13622,1,1,1467,803,687,116,796,7,1750,947,513,283,
3,"ARGES",38,13622,,115,0,"CASA DE CULTURA  B-DUL BASARABILOR NR.58","MUNICIPIUL CURTEA DE ARGES",3,13622,1,1,2056,1079,954,125,1072,7,2150,1071,743,329,
3,"ARGES",38,13622,,116,0,"SCOALA GENERALA NR.4 STR.BANU MARACINE","MUNICIPIUL CURTEA DE ARGES",3,13622,1,1,2326,1327,1098,229,1314,13,2700,1373,866,448,
3,"ARGES",38,13622,,117,0,"SCOALA GENERALA NR.1 STR.TRAIAN NR.2","MUNICIPIUL CURTEA DE ARGES",3,13622,1,1,2732,1431,1295,136,1415,16,3000,1569,916,499,
3,"ARGES",38,13622,,118,0,"SCOALA GENERALA NR.5 STR.NEGRU VODA NR.76","MUNICIPIUL CURTEA DE ARGES",3,13622,1,1,2422,1323,1202,121,1313,10,2650,1327,822,491,
3,"ARGES",38,13622,,119,0,"SCOALA GENERALA VALEA IASULUI","MUNICIPIUL CURTEA DE ARGES",3,13622,1,1,858,535,503,32,532,3,900,365,371,161,
3,"ARGES",38,13622,,120,0,"GRUP SCOLAR AUTO STR.RM.VALCEA NR.41","MUNICIPIUL CURTEA DE ARGES",3,13622,1,1,1479,853,760,93,843,10,1600,747,551,292,
3,"ARGES",38,13622,,121,0,"GRADINITA NR.4 B-DUL BASARABILOR NR.60","MUNICIPIUL CURTEA DE ARGES",3,13622,1,1,649,377,317,60,376,1,600,223,247,129,
3,"ARGES",38,13622,,122,0,"SCOALA GENERALA NR.3 STR.RM.VALCEA","MUNICIPIUL CURTEA DE ARGES",3,13622,1,1,1174,746,643,103,732,14,1300,554,471,261,
3,"ARGES",38,13622,,123,0,"SCOALA GENERALA NOAPTES STR.LINIEI NR.13","MUNICIPIUL CURTEA DE ARGES",3,13622,1,1,617,376,340,36,370,6,1257,881,218,152,
3,"ARGES",38,13622,,124,1,"STRADA MILITARI","MUNICIPIUL CURTEA DE ARGES",3,13622,1,1,753,768,680,88,731,37,830,62,406,325,
3,"ARGES",38,13668,,125,0,"CASA DE CULTURA","ORAS COSTESTI",4,13668,2,1,2669,1420,1242,178,1407,13,3000,1580,913,494,
3,"ARGES",38,13668,,126,0,"LICEUL TEORETIC","ORAS COSTESTI",4,13668,2,1,2367,1325,1172,153,1311,14,2600,1275,810,501,
3,"ARGES",38,13668,,127,0,"SCOALA GENERALA TELESTI","ORAS COSTESTI",4,13668,2,1,833,414,377,37,413,1,900,486,228,185,
3,"ARGES",38,13668,,128,0,"SCOALA GENERALA ZORILE","ORAS COSTESTI",4,13668,2,1,1191,613,531,82,606,7,1300,687,342,264,
3,"ARGES",38,13668,,129,0,"SCOALA GENERALA BROSTENI","ORAS COSTESTI",4,13668,2,1,736,362,299,63,358,4,800,438,255,103,
3,"ARGES",38,13668,,130,0,"SCOALA GENERALA PODU BROSTENI","ORAS COSTESTI",4,13668,2,1,490,317,237,80,311,6,550,233,197,114,
3,"ARGES",38,13668,,131,0,"SCOALA GENERALA PIRVU","ORAS COSTESTI",4,13668,2,1,591,355,297,58,347,8,650,295,233,114,
3,"ARGES",38,13301,,132,0,"GRADINITA DIN BL.A1,SC.A STR.LOGOFATU STANCIU MIHOVEANU","ORAS MIOVENI",5,13301,2,1,2684,1567,1370,197,1561,6,3000,1433,853,708,
3,"ARGES",38,13301,,133,0,"GRADINITA DIN BL.M6,SC.D STR.CARANESTI","ORAS MIOVENI",5,13301,2,1,3026,1611,1449,162,1593,18,3100,1489,889,704,
3,"ARGES",38,13301,,134,0,"CAMINUL SCOALA MIOVENI STR.LIVIU REBREANU","ORAS MIOVENI",5,13301,2,1,2847,1585,1374,211,1575,10,3100,1515,876,699,
3,"ARGES",38,13301,,135,0,"SCOALA MIOVENI STR.EROILOR","ORAS MIOVENI",5,13301,2,1,2661,1489,1308,181,1478,11,2900,1411,838,640,
3,"ARGES",38,13301,,136,0,"CRESA MIOVENI STR.ALEEA CAMINULUI","ORAS MIOVENI",5,13301,2,1,2519,1298,1183,115,1290,8,2800,1502,761,529,
3,"ARGES",38,13301,,137,0,"SC REGOM SERV SA MIOVENI STR.B-DUL DACIA","ORAS MIOVENI",5,13301,2,1,1526,1009,815,194,1003,6,1699,690,564,439,
3,"ARGES",38,13301,,138,0,"CASA DE CULTURA A SINDICATELOR MIOVENI","ORAS MIOVENI",5,13301,2,1,1529,929,798,131,917,12,1700,771,516,401,
3,"ARGES",38,13301,,139,0,"GRADINITA DIN BL.T6 STR.FRATII GOLESTI","ORAS MIOVENI",5,13301,2,1,1939,1109,1014,95,1104,5,2100,991,638,466,
3,"ARGES",38,13301,,140,0,"GRADINITA DIN BL.P19 SC.D STR.7 SEPTEMBRIE 1485","ORAS MIOVENI",5,13301,2,1,2326,1325,1208,117,1314,11,2609,1284,786,528,
3,"ARGES",38,13301,,141,0,"SCOALA RACOVITA","ORAS MIOVENI",5,13301,2,1,1262,942,638,304,936,6,1398,456,662,274,
3,"ARGES",38,13301,,142,0,"SCOALA COLIBASI","ORAS MIOVENI",5,13301,2,1,1463,1028,866,162,1020,8,1600,572,667,353,
3,"ARGES",38,13301,,143,0,"SCOALA CLUCEREASA","ORAS MIOVENI",5,13301,2,1,416,424,330,94,416,8,500,76,278,138,
3,"ARGES",38,13301,,144,0,"SCOALA FAGET","ORAS MIOVENI",5,13301,2,1,824,504,423,81,495,9,900,396,360,135,
3,"ARGES",38,13757,,145,0,"SCOALA PRIMARA GOLESTII - BADII","ORAS TOPOLOVENI",6,13757,2,1,825,473,421,52,465,8,910,437,331,134,
3,"ARGES",38,13757,,146,0,"LICEUL TEORETIC ""ION MIHALACHE"" TOPOLOVENI","ORAS TOPOLOVENI",6,13757,2,1,2320,1256,1131,125,1233,23,2560,1304,766,467,
3,"ARGES",38,13757,,147,0,"SCOALA GENERALA TOPOLOVENI (INTRAREA DIN FATA)","ORAS TOPOLOVENI",6,13757,2,1,687,394,342,52,384,10,740,346,254,130,
3,"ARGES",38,13757,,148,0,"SCOALA GENERALA TOPOLOVENI (INTRAREA DIN SPATE)","ORAS TOPOLOVENI",6,13757,2,1,2304,1198,1082,116,1174,24,2540,1342,671,503,
3,"ARGES",38,13757,,149,0,"SCOALA GENERALA TIGANESTI","ORAS TOPOLOVENI",6,13757,2,1,1393,840,746,94,829,11,1545,705,614,215,
3,"ARGES",38,13819,,150,0,"CASA DE CULTURA","ALBESTII DE ARGES",7,13819,0,3,2977,1189,1004,185,1181,8,2400,1211,786,395,
3,"ARGES",38,13819,,151,0,"SCOALA GENERALA ALBESTI UNGURENI","ALBESTII DE ARGES",7,13819,0,3,1177,1031,521,510,1011,20,2000,969,609,402,
3,"ARGES",38,13819,,152,0,"SCOALA GENERALA ALBESTI BRATESTI","ALBESTII DE ARGES",7,13819,0,3,579,369,243,126,369,0,800,431,232,137,
3,"ARGES",38,13891,,153,0,"SCOALA GENERALA BUGHEA DE SUS","ALBESTII DE MUSCEL",8,13891,0,3,2198,1134,1021,113,1125,9,2300,1166,801,324,
3,"ARGES",38,13891,,154,0,"SCOALA GENERALA ALBESTI","ALBESTII DE MUSCEL",8,13891,0,3,957,557,491,66,554,3,1100,543,271,283,
3,"ARGES",38,13891,,155,0,"SCOALA GENERALA CANDESTI","ALBESTII DE MUSCEL",8,13891,0,3,424,302,260,42,299,3,500,198,197,102,
3,"ARGES",38,13935,,156,0,"SCOALA ALBOTA","ALBOTA",9,13935,0,3,1515,849,673,176,826,23,1700,851,478,348,
3,"ARGES",38,13935,,157,0,"SCOALA MARES","ALBOTA",9,13935,0,3,812,651,478,173,643,8,1200,549,535,108,
3,"ARGES",38,13935,,158,0,"SCOALA CERBU","ALBOTA",9,13935,0,3,484,344,249,95,337,7,600,256,222,115,
3,"ARGES",38,13999,,159,0,"CAMINUL CULTURAL","ANINOASA",10,13999,0,3,1730,911,800,111,903,8,2000,1089,588,315,
3,"ARGES",38,13999,,160,0,"CAMINUL CULTURAL SLANIC","ANINOASA",10,13999,0,3,866,599,530,69,596,3,900,301,396,200,
3,"ARGES",38,14049,,161,0,"GRADINITA AREFU","AREFU",11,14049,0,3,1306,647,617,30,645,2,1300,653,342,303,
3,"ARGES",38,14049,,162,0,"SCOALA GENERALA CAPATINENI","AREFU",11,14049,0,3,963,626,488,138,622,4,1200,574,396,226,
3,"ARGES",38,13187,,163,0,"CAMINUL CULTURAL BASCOV","BASCOV",16,13187,0,3,1459,919,774,145,915,4,1600,681,548,367,
3,"ARGES",38,13187,,164,0,"SCOALA GENERALA BASCOV","BASCOV",16,13187,0,3,2866,1038,874,164,1033,5,2700,1662,618,415,
3,"ARGES",38,13187,,165,0,"SCOALA GENERALA SCHIAU","BASCOV",16,13187,0,3,390,504,224,280,500,4,700,196,304,196,
3,"ARGES",38,13187,,166,0,"SCOALA GENERALA GLIMBOC","BASCOV",16,13187,0,3,342,300,187,113,300,0,500,200,177,123,
3,"ARGES",38,13187,,167,0,"SCOALA GENERALA VALEA URSULUI","BASCOV",16,13187,0,3,994,722,377,345,712,10,1100,378,422,290,
3,"ARGES",38,13187,,168,0,"SCOALA MICA","BASCOV",16,13187,0,3,395,314,253,61,308,6,500,186,179,129,
3,"ARGES",38,14085,,169,0,"SCOALA GENERALA BABANA","BABANA",12,14085,0,3,1476,1359,1161,198,1353,6,1450,91,1067,286,
3,"ARGES",38,14085,,170,0,"SCOALA GENERALA SLATIOARELE","BABANA",12,14085,0,3,361,424,203,221,422,2,450,26,319,103,
3,"ARGES",38,14085,,171,0,"SCOALA GENERALA GROSI","BABANA",12,14085,0,3,118,290,110,180,288,2,300,10,195,93,
3,"ARGES",38,14165,,172,0,"SEDIUL CONSILIUL LOCAL","BAICULESTI",13,14165,0,3,1941,719,452,267,714,5,2200,1481,452,262,
3,"ARGES",38,14165,,173,0,"SCOALA GENERALA TUTANA","BAICULESTI",13,14165,0,3,1604,790,540,250,786,4,1800,1010,450,336,
3,"ARGES",38,14165,,174,0,"CAMINUL CULTURAL ZIGONENI","BAICULESTI",13,14165,0,3,1306,711,482,229,701,10,1400,689,463,238,
3,"ARGES",38,14272,,175,0,"CAMIN CULTURAL BALILESTI","BALILESTI",14,14272,0,3,925,558,466,92,549,9,1000,442,426,123,
3,"ARGES",38,14272,,176,0,"CAMIN CULTURAL BAJESTI","BALILESTI",14,14272,0,3,987,657,591,66,652,5,1100,443,485,167,
3,"ARGES",38,14272,,177,0,"CAMIN CULTURAL POIENITA","BALILESTI",14,14272,0,3,1636,1005,931,74,989,16,1800,795,755,234,
3,"ARGES",38,14352,,178,0,"SCOALA GENERALA BELETI","BELETI-NEGRESTI",17,14352,0,3,503,325,264,61,323,2,600,275,214,109,
3,"ARGES",38,14352,,179,0,"CAMIN CULTURAL NEGRESTI","BELETI-NEGRESTI",17,14352,0,3,1032,545,484,61,545,0,1200,655,298,247,
3,"ARGES",38,14405,,180,0,"CAMIN CULTURAL BEREVOIESTI PAMANTENI","BEREVOESTI",18,14405,0,3,2510,1436,1323,113,1422,14,2800,1364,1025,397,
3,"ARGES",38,14450,,181,0,"SCOALA GENERALA URLUIENI","BARLA",15,14450,0,3,1333,595,435,160,591,4,1500,905,449,142,
3,"ARGES",38,14450,,182,0,"SCOALA GENERALA MINDRA","BARLA",15,14450,0,3,875,428,320,108,421,7,950,522,271,150,
3,"ARGES",38,14450,,183,0,"SCOALA GENERALA BIRLA","BARLA",15,14450,0,3,1013,582,388,194,571,11,1150,568,403,168,
3,"ARGES",38,14450,,184,0,"SCOALA GENERALA MAZACENI","BARLA",15,14450,0,3,1468,645,521,124,637,8,1600,955,429,208,
3,"ARGES",38,14584,,185,0,"SCOALA GENERALA GLIMBOCELU","BOGATI",19,14584,0,3,594,363,268,95,359,4,600,237,255,104,
3,"ARGES",38,14584,,186,0,"SCOALA GENERALA BOGATI","BOGATI",19,14584,0,3,2048,840,702,138,831,9,2400,1560,549,282,
3,"ARGES",38,14584,,187,0,"CAMIN CULTURAL SUSENI","BOGATI",19,14584,0,3,1462,638,576,62,634,4,1500,862,374,260,
3,"ARGES",38,14673,,188,0,"CAMIN CULTURAL BOTENI","BOTENI",20,14673,0,3,2326,1333,1255,78,1320,13,2600,1267,865,455,
3,"ARGES",38,14726,,189,0,"SCOALA GENERALA BOTESTI","BOTESTI",21,14726,0,3,728,557,467,90,552,5,820,263,367,185,
3,"ARGES",38,14726,,190,0,"SCOALA GENERALA MOSTENI-GRECI","BOTESTI",21,14726,0,3,339,251,231,20,250,1,380,129,192,58,
3,"ARGES",38,13276,,191,0,"CAMIN CULTURAL GEAMANA","BRADU",22,13276,0,3,623,584,278,306,577,7,904,320,355,222,
3,"ARGES",38,13276,,192,0,"CAMIN CULTURAL BRADU DE SUS","BRADU",22,13276,0,3,1700,678,541,137,670,8,1800,1122,427,243,
3,"ARGES",38,13276,,193,0,"SCOALA GENERALA NR.2 BRADU DE JOS","BRADU",22,13276,0,3,1365,690,537,153,678,12,1400,710,476,202,
3,"ARGES",38,14753,,194,0,"CAMIN CULTURAL BRADULET","BRADULET",23,14753,0,3,563,323,260,63,319,4,610,287,200,119,
3,"ARGES",38,14753,,195,0,"CAMINUL CULTURAL GALETU","BRADULET",23,14753,0,3,849,433,383,50,429,4,920,487,289,140,
3,"ARGES",38,14753,,196,0,"SCOALA PRIMARA BRADETU","BRADULET",23,14753,0,3,386,360,223,137,357,3,470,110,220,137,
3,"ARGES",38,14851,,197,0,"SCOALA GENERALA BUDEASA","BUDEASA",24,14851,0,3,1455,402,354,48,398,4,1413,1011,230,168,
3,"ARGES",38,14851,,198,0,"SCOALA GENERALA GALASESTI","BUDEASA",24,14851,0,3,499,458,285,173,455,3,632,174,252,203,
3,"ARGES",38,14851,,199,0,"SCOALA GENERALA CALOTESTI","BUDEASA",24,14851,0,3,580,392,227,165,387,5,655,263,266,121,
3,"ARGES",38,14851,,200,0,"SCOALA GENERALA BUDEASA MICA","BUDEASA",24,14851,0,3,405,314,198,116,311,3,500,186,188,123,
3,"ARGES",38,14922,,201,0,"SCOALA GENERALA BUGHEA DE JOS","BUGHEA DE JOS",25,14922,0,3,2317,1295,1217,78,1290,5,2600,1305,785,505,
3,"ARGES",38,14940,,202,0,"CAMIN CULTURAL BUZOIESTI","BUZOESTI",26,14940,0,3,1043,934,558,376,925,9,1234,300,549,376,
3,"ARGES",38,14940,,203,0,"GRADINITA IONESTI","BUZOESTI",26,14940,0,3,1142,616,536,80,610,6,1246,630,435,175,
3,"ARGES",38,14940,,204,0,"SCOALA GENERALA VULPESTI","BUZOESTI",26,14940,0,3,1731,1081,859,222,1074,7,1833,752,677,397,
3,"ARGES",38,14940,,205,0,"CAMIN CULTURAL BUZOIESTI","BUZOESTI",26,14940,0,3,1087,790,671,119,785,5,1187,397,448,337,
3,"ARGES",38,15064,,206,0,"SCOALA GENERALA CALDARARU","CALDARARU",27,15064,0,3,843,528,436,92,521,7,900,372,366,155,
3,"ARGES",38,15064,,207,0,"SCOALA GENERALA STRAMBENI","CALDARARU",27,15064,0,3,974,600,489,111,594,6,1100,500,424,170,
3,"ARGES",38,15064,,208,0,"SCOALA GENERALA BURDEA","CALDARARU",27,15064,0,3,610,409,327,82,397,12,700,291,309,88,
3,"ARGES",38,15108,,209,0,"SCOALA GENERALA VALENI","CALINESTI",28,15108,0,3,1575,730,641,89,730,0,1712,982,414,316,
3,"ARGES",38,15108,,210,0,"SCOALA GENERALA VRANESTI","CALINESTI",28,15108,0,3,1694,862,690,172,858,4,1841,979,499,359,
3,"ARGES",38,15108,,211,0,"SCOALA GENERALA GORGANU","CALINESTI",28,15108,0,3,761,404,291,113,402,2,901,497,231,171,
3,"ARGES",38,15108,,212,0,"SCOALA GENERALA CALINESTI-VALE","CALINESTI",28,15108,0,3,1576,725,554,171,715,10,1716,991,465,250,
3,"ARGES",38,15108,,213,0,"SCOALA GENERALA GLODU","CALINESTI",28,15108,0,3,1192,651,548,103,645,6,1332,681,379,266,
3,"ARGES",38,15108,,214,0,"SCOALA GENERALA CIRSTIENI","CALINESTI",28,15108,0,3,1055,589,459,130,578,11,1198,609,441,137,
3,"ARGES",38,15233,,215,0,"GRADINITA CATEASCA","CATEASCA",29,15233,0,3,759,446,383,63,440,6,900,454,313,127,
3,"ARGES",38,15233,,216,0,"CAMIN CULTURAL CATANELE","CATEASCA",29,15233,0,3,1515,762,676,86,751,11,1600,838,479,272,
3,"ARGES",38,15233,,217,0,"CAMIN CULTURAL SILISTEA","CATEASCA",29,15233,0,3,484,338,277,61,336,2,600,262,218,118,
3,"ARGES",38,15313,,218,0,"CAMIN CULTURAL CEPARI","CEPARI",30,15313,0,3,1134,605,538,67,593,12,1244,639,395,198,
3,"ARGES",38,15313,,219,0,"SCOALA GENERALA CARPENIS","CEPARI",30,15313,0,3,683,438,416,22,432,6,746,308,216,216,
3,"ARGES",38,15313,,220,0,"SCOALA GENERALA URLUIESTI","CEPARI",30,15313,0,3,289,202,186,16,200,2,311,109,137,63,
3,"ARGES",38,15402,,221,0,"CAMIN CULTURAL CETATENI","CETATENI",31,15402,0,3,1631,1049,970,79,1035,14,1700,651,797,238,
3,"ARGES",38,15402,,222,0,"GRADINITA LAICAI","CETATENI",31,15402,0,3,690,432,395,37,423,9,900,468,251,172,
3,"ARGES",38,15448,,223,0,"CONSILIUL LOCAL CICANESTI","CICANESTI",32,15448,0,3,1851,914,857,57,906,8,2000,1086,482,424,
3,"ARGES",38,15493,,224,0,"CAMIN CULTURAL","CIOFRANGENI",33,15493,0,3,1994,1077,908,169,1059,18,2200,1123,680,379,
3,"ARGES",38,15554,,225,0,"SCOALA GENERALA BRATIA","CIOMAGESTI",34,15554,0,3,444,336,274,62,331,5,500,164,202,129,
3,"ARGES",38,15554,,226,0,"SCOALA GENERALA CIOMAGESTI SAT","CIOMAGESTI",34,15554,0,3,411,250,203,47,248,2,460,210,164,84,
3,"ARGES",38,15554,,227,0,"SCOALA PRIMARA DOGARI","CIOMAGESTI",34,15554,0,3,217,164,121,43,160,4,240,76,95,65,
3,"ARGES",38,15652,,228,0,"SCOALA GENERALA COCU","COCU",35,15652,0,3,915,589,423,166,587,2,1015,426,414,173,
3,"ARGES",38,15652,,229,0,"SCOALA GENERALA RACHITELE DE SUS","COCU",35,15652,0,3,841,305,255,50,302,3,940,635,173,129,
3,"ARGES",38,15652,,230,0,"SCOALA GENERALA BARBATESTI","COCU",35,15652,0,3,544,242,180,62,235,7,645,403,163,72,
3,"ARGES",38,15741,,231,0,"SCOALA GENERALA OIESTI","CORBENI",36,15741,0,3,1708,1058,883,175,1050,8,1850,792,713,337,
3,"ARGES",38,15741,,232,0,"SCOALA GENERALA CORBENI","CORBENI",36,15741,0,3,2205,1084,918,166,1062,22,2400,1316,704,358,
3,"ARGES",38,15741,,233,0,"SCOALA GENERALA BERINDESTI","CORBENI",36,15741,0,3,605,385,312,73,383,2,750,365,257,126,
3,"ARGES",38,15830,,234,0,"CAMIN CULTURAL CORBI","CORBI",37,15830,0,3,1806,698,653,45,682,16,2000,1302,348,334,
3,"ARGES",38,15830,,235,0,"SCOALA GENERALA CORBSORI","CORBI",37,15830,0,3,811,543,491,52,540,3,900,357,287,253,
3,"ARGES",38,15830,,236,0,"CAMIN CULTURAL STANESTI","CORBI",37,15830,0,3,988,555,494,61,553,2,1200,645,362,191,
3,"ARGES",38,15901,,237,0,"SCOALA GENERALA PETRESTI","COSESTI",38,15901,0,3,775,501,388,113,496,5,900,399,303,193,
3,"ARGES",38,15901,,238,0,"CAMIN CULTURAL COSESTI","COSESTI",38,15901,0,3,1808,822,653,169,805,17,1900,1078,484,321,
3,"ARGES",38,15901,,239,0,"CAMINUL CULTURAL LEICESTI","COSESTI",38,15901,0,3,1644,936,661,275,932,4,1900,964,594,338,
3,"ARGES",38,15983,,240,0,"CAMIN CULTURAL COTMEANA","COTMEANA",39,15983,0,3,1002,411,349,62,402,9,1152,741,255,147,
3,"ARGES",38,15983,,241,0,"SCOALA GENERALA LINTESTI","COTMEANA",39,15983,0,3,413,204,158,46,204,0,448,244,125,79,
3,"ARGES",38,15983,,242,0,"SCOALA GENERALA BASCOVELE","COTMEANA",39,15983,0,3,401,266,142,124,263,3,400,134,137,126,
3,"ARGES",38,16132,,243,0,"SCOALA GENERALA CUCA","CUCA",40,16132,0,3,1280,649,539,110,645,4,1400,751,404,241,
3,"ARGES",38,16132,,244,0,"SCOALA GENERALA TEODORESTI","CUCA",40,16132,0,3,560,318,241,77,307,11,600,282,179,128,
3,"ARGES",38,16285,,245,0,"SCOALA GENERALA DAVIDESTI","DAVIDESTI",43,16285,0,3,987,510,413,97,507,3,1100,590,315,192,
3,"ARGES",38,16285,,246,0,"SCOALA GENERALA CONTESTI","DAVIDESTI",43,16285,0,3,1091,629,532,97,625,4,1200,571,492,133,
3,"ARGES",38,16329,,247,0,"CAMIN CULTURAL DAMBOVICIOARA","DAMBOVICIOARA",41,16329,0,3,465,212,187,25,212,0,470,258,132,80,
3,"ARGES",38,16329,,248,0,"CAMIN CULTURAL PODU DAMBOVITEI","DAMBOVICIOARA",41,16329,0,3,432,375,297,78,372,3,510,135,221,151,
3,"ARGES",38,16329,,249,0,"CAMIN CULTURAL CIOCANU","DAMBOVICIOARA",41,16329,0,3,96,78,49,29,77,1,120,42,35,42,
3,"ARGES",38,16365,,250,0,"SCOALA GENERALA DIRMANESTI","DARMANESTI",42,16365,0,3,1685,717,619,98,712,5,1700,983,445,267,
3,"ARGES",38,16365,,251,0,"SCOALA GENERALA PISCANI","DARMANESTI",42,16365,0,3,1152,694,541,153,691,3,1400,706,456,235,
3,"ARGES",38,16427,,252,0,"CAMIN CULTURAL DOBRESTI","DOBRESTI",44,16427,0,3,814,526,444,82,525,1,900,374,342,183,
3,"ARGES",38,16427,,253,0,"SCOALA GENERALA FURESTI","DOBRESTI",44,16427,0,3,605,360,312,48,357,3,700,340,258,99,
3,"ARGES",38,16454,,254,0,"CAMIN CULTURAL DOMNESTI","DOMNESTI",45,16454,0,3,2637,1534,1384,150,1519,15,3000,1466,968,551,
3,"ARGES",38,16472,,255,0,"SCOALA GENERALA DRAVOSLAVELE","DRAGOSLAVELE",47,16472,0,3,1069,722,639,83,718,4,1200,478,454,264,
3,"ARGES",38,16472,,256,0,"COLONIA DE COPII DRAGOSLAVELE","DRAGOSLAVELE",47,16472,0,3,735,511,405,106,504,7,800,289,247,257,
3,"ARGES",38,16506,,257,0,"CAMIN CULTURAL","DRAGANU",46,16506,0,3,1461,862,690,172,852,10,1600,738,521,331,
3,"ARGES",38,16551,,258,0,"SCOALA GENERALA GODENI","GODENI",48,16551,0,3,1240,771,705,66,764,7,1360,589,602,162,
3,"ARGES",38,16551,,259,0,"SCOALA GENERALA COTESTI","GODENI",48,16551,0,3,1522,871,792,79,860,11,1640,769,568,292,
3,"ARGES",38,16613,,260,0,"CAMIN CULTURAL HIRSESTI","HARSESTI",49,16613,0,3,1836,985,704,281,971,14,1900,915,707,264,
3,"ARGES",38,16613,,261,0,"SCOALA GENERALA MARTALOGI","HARSESTI",49,16613,0,3,424,542,197,345,533,8,600,59,393,140,
3,"ARGES",38,16659,,262,0,"CONSILIUL LOCAL HIRTIESTI","HARTIESTI",50,16659,0,3,1583,956,800,156,946,10,1500,544,766,180,
3,"ARGES",38,16659,,263,0,"FOSTA PRIMARIE VULTURESTI","HARTIESTI",50,16659,0,3,1529,898,715,183,888,10,1500,602,555,333,
3,"ARGES",38,16659,,264,0,"CAMIN CULTURAL BIRZESTI","HARTIESTI",50,16659,0,3,353,318,181,137,308,10,600,281,204,104,
3,"ARGES",38,16659,,265,0,"SCOALA GENERALA HULUBA","HARTIESTI",50,16659,0,3,143,151,92,59,151,0,400,249,69,82,
3,"ARGES",38,16739,,266,0,"CAMIN CULTURAL IZVORU","IZVORU",51,16739,0,3,2210,986,891,95,981,5,2500,1514,709,272,
3,"ARGES",38,16757,,267,0,"CAMIN CULTURAL LEORDENI","LEORDENI",52,16757,0,3,2263,1169,901,268,1146,23,2500,1331,790,356,
3,"ARGES",38,16757,,268,0,"GRADINITA BUDISTENI","LEORDENI",52,16757,0,3,1071,738,589,149,735,3,1200,462,504,231,
3,"ARGES",38,16757,,269,0,"SCOALA GENERALA GLIMBOCATA","LEORDENI",52,16757,0,3,1305,739,637,102,730,9,1400,661,500,230,
3,"ARGES",38,16908,,270,0,"CAMIN CULTURAL LERESTI","LERESTI",53,16908,0,3,2727,1566,1420,146,1562,4,3000,1434,1130,432,
3,"ARGES",38,16908,,271,0,"CAMIN CULTURAL VOINESTI","LERESTI",53,16908,0,3,1431,932,715,217,924,8,1600,668,617,307,
3,"ARGES",38,16944,,272,0,"CONSILIUL LOCAL LUNCA CORBULUI","LUNCA CORBULUI",54,16944,0,3,1440,449,327,122,447,2,1200,751,283,164,
3,"ARGES",38,16944,,273,0,"SCOALA GENERALA SILISTENI","LUNCA CORBULUI",54,16944,0,3,173,133,46,87,128,5,300,167,72,56,
3,"ARGES",38,16944,,274,0,"SCOALA GENERALA PADURETI","LUNCA CORBULUI",54,16944,0,3,683,513,275,238,508,5,800,287,363,145,
3,"ARGES",38,16944,,275,0,"SCOALA GENERALA MIRGHIA DE SUS","LUNCA CORBULUI",54,16944,0,3,315,350,157,193,346,4,600,250,268,78,
3,"ARGES",38,17049,,276,0,"SCOALA GENERALA MALURENI SAT","MALURENI",55,17049,0,3,837,341,272,69,339,2,900,559,208,131,
3,"ARGES",38,17049,,277,0,"CAMIN CULTURAL BADICENI","MALURENI",55,17049,0,3,340,253,120,133,250,3,400,147,161,89,
3,"ARGES",38,17049,,278,0,"SCOALA GENERALA BOHARI","MALURENI",55,17049,0,3,254,180,97,83,179,1,300,120,90,89,
3,"ARGES",38,17049,,279,0,"SCOALA GENERALA TOPLITA","MALURENI",55,17049,0,3,572,276,219,57,273,3,600,324,171,102,
3,"ARGES",38,17049,,280,0,"SCOALA GENERALA ZARNESTI","MALURENI",55,17049,0,3,694,501,346,155,499,2,700,199,342,157,
3,"ARGES",38,17049,,281,0,"SCOALA GENERALA BUNESTI","MALURENI",55,17049,0,3,530,281,215,66,276,5,600,319,170,106,
3,"ARGES",38,17049,,282,0,"TABARA PAULEASCA","MALURENI",55,17049,0,3,425,322,164,158,315,7,500,178,247,68,
3,"ARGES",38,13365,,283,0,"SCOALA GENERALA MARACINENI","MARACINENI",56,13365,0,3,2205,1197,1007,190,1191,6,2300,1103,715,476,
3,"ARGES",38,13365,,284,0,"SCOALA GENERALA ARGESELU","MARACINENI",56,13365,0,3,972,760,486,274,751,9,1200,440,428,323,
3,"ARGES",38,17101,,285,0,"SCOALA GENERALA DOBROGOSTEA","MERISANI",57,17101,0,3,560,493,263,230,488,5,800,307,314,174,
3,"ARGES",38,17101,,286,0,"SCOALA GENERALA MERISANI","MERISANI",57,17101,0,3,1671,574,466,108,566,8,1600,1026,329,237,
3,"ARGES",38,17101,,287,0,"SCOALA GENERALA VILCELELE","MERISANI",57,17101,0,3,728,418,292,126,409,9,800,382,252,157,
3,"ARGES",38,17209,,288,0,"SCOALA GENERALA MICESTI","MICESTI",58,17209,0,3,1837,768,642,126,754,14,2000,1232,442,312,
3,"ARGES",38,17209,,289,0,"SCOALA GENERALA PURCARENI","MICESTI",58,17209,0,3,983,599,441,158,595,4,1100,501,413,182,
3,"ARGES",38,17254,,290,0,"CAMIN CULTURAL MIHAIESTI","MIHAESTI",59,17254,0,3,2030,733,575,158,720,13,1700,967,524,196,
3,"ARGES",38,17254,,291,0,"CAMIN CULTURAL VALEA POPII","MIHAESTI",59,17254,0,3,627,604,421,183,601,3,900,296,379,222,
3,"ARGES",38,17254,,292,0,"SCOALA GENERALA DRAGHICI","MIHAESTI",59,17254,0,3,812,584,458,126,578,6,900,316,427,151,
3,"ARGES",38,17254,,293,0,"SCOALA GENERALA VACAREA","MIHAESTI",59,17254,0,3,417,410,279,131,409,1,600,190,296,113,
3,"ARGES",38,17254,,294,0,"CAMIN CULTURAL FURNICOSI","MIHAESTI",59,17254,0,3,549,566,281,285,557,9,800,234,381,176,
3,"ARGES",38,17334,,295,0,"CAMIN CULTURAL MATAU","MIOARELE",60,17334,0,3,1083,548,501,47,545,3,1200,652,306,239,
3,"ARGES",38,17334,,296,0,"CAMIN CULTURAL SUSLANESTI","MIOARELE",60,17334,0,3,376,249,221,28,246,3,500,251,147,99,
3,"ARGES",38,17398,,297,0,"SCOALA GENERALA MIROSI","MIROSI",61,17398,0,3,1542,716,644,72,710,6,1698,982,499,211,
3,"ARGES",38,17398,,298,0,"SCOALA GENERALA SURDULESTI","MIROSI",61,17398,0,3,889,467,388,79,459,8,1000,533,340,119,
3,"ARGES",38,17423,,299,0,"SCOALA GENERALA MORARESTI","MORARESTI",62,17423,0,3,942,475,383,92,461,14,1100,625,247,214,
3,"ARGES",38,17423,,300,0,"SCOALA GENERALA DEDULESTI","MORARESTI",62,17423,0,3,731,377,284,93,376,1,800,423,240,136,
3,"ARGES",38,17496,,301,0,"SCOALA GENERALA MOSOAIA","MOSOAIA",63,17496,0,3,1738,696,581,115,691,5,1900,1204,379,312,
3,"ARGES",38,17496,,302,0,"SCOALA GENERALA HINTESTI","MOSOAIA",63,17496,0,3,404,356,253,103,351,5,600,244,241,110,
3,"ARGES",38,17496,,303,0,"CAMIN CULTURAL SMEURA","MOSOAIA",63,17496,0,3,594,349,231,118,340,9,700,351,197,143,
3,"ARGES",38,17575,,304,0,"SCOALA GENERALA BABAROAGA","MOZACENI",64,17575,0,3,1497,761,671,90,753,8,1700,939,552,201,
3,"ARGES",38,17575,,305,0,"SCOALA GENERALA MISEI","MOZACENI",64,17575,0,3,721,465,368,97,461,4,800,335,325,136,
3,"ARGES",38,17619,,306,0,"SCOALA GENERALA STROIESTI","MUSATESTI",65,17619,0,3,871,535,434,101,531,4,992,457,316,215,
3,"ARGES",38,17619,,307,0,"SCOALA GENERALA VILSANESTI","MUSATESTI",65,17619,0,3,440,253,164,89,250,3,500,247,166,84,
3,"ARGES",38,17619,,308,0,"CAMIN CULTURAL COSTESTI VILSAN","MUSATESTI",65,17619,0,3,673,434,338,96,428,6,800,366,329,99,
3,"ARGES",38,17619,,309,0,"SCOALA GENERALA MUSATESTI","MUSATESTI",65,17619,0,3,1360,703,585,118,694,9,1408,705,463,231,
3,"ARGES",38,17726,,310,0,"SCOALA GENERALA NEGRASI","NEGRASI",66,17726,0,3,798,674,591,83,663,11,900,226,521,142,
3,"ARGES",38,17726,,311,0,"SCOALA GENERALA MOZACU","NEGRASI",66,17726,0,3,344,380,336,44,378,2,400,20,325,53,
3,"ARGES",38,17726,,312,0,"SCOALA GENERALA BUTA","NEGRASI",66,17726,0,3,219,232,206,26,230,2,250,18,185,45,
3,"ARGES",38,17726,,313,0,"SCOALA GENERALA BIRLOGU","NEGRASI",66,17726,0,3,863,532,422,110,529,3,950,418,337,192,
3,"ARGES",38,17771,,314,0,"CAMIN CULTURAL NUCSOARA","NUCSOARA",67,17771,0,3,1441,714,661,53,709,5,1600,886,420,289,
3,"ARGES",38,17824,,315,0,"SCOALA GENERALA OARJA CENTRU","OARJA",68,17824,0,3,1355,826,652,174,817,9,1600,774,470,347,
3,"ARGES",38,17824,,316,0,"SCOALA GENERALA OARJA SAT","OARJA",68,17824,0,3,770,511,357,154,507,4,800,289,334,173,
3,"ARGES",38,17851,,317,0,"SCOALA GENERALA PIETROSANI","PIETROSANI",69,17851,0,3,1480,791,696,95,788,3,1653,862,525,263,
3,"ARGES",38,17851,,318,0,"CAMIN CULTURAL BADESTI","PIETROSANI",69,17851,0,3,1137,782,658,124,766,16,1275,493,476,290,
3,"ARGES",38,17851,,319,0,"SCOALA GENERALA RETEVOIESTI","PIETROSANI",69,17851,0,3,1484,953,889,64,952,1,1660,707,551,401,
3,"ARGES",38,17851,,320,0,"SCOALA GENERALA GANESTI","PIETROSANI",69,17851,0,3,533,334,267,67,332,2,612,278,228,104,
3,"ARGES",38,17913,,321,0,"SCOALA GENERALA POIENARI","POIENARII DE ARGES",71,17913,0,3,987,532,472,60,529,3,1100,565,379,150,
3,"ARGES",38,17968,,322,0,"SCOALA GENERALA POIENARI","POIENARII DE MUSCEL",72,17968,0,3,2035,1090,1002,88,1072,18,2200,1110,743,329,
3,"ARGES",38,17968,,323,0,"SCOALA GENERALA JUGUR","POIENARII DE MUSCEL",72,17968,0,3,1018,564,493,71,558,6,1200,636,408,150,
3,"ARGES",38,18028,,324,0,"SCOALA GENERALA POIANA LACULUI","POIANA LACULUI",70,18028,0,3,1972,1112,842,270,1088,24,2000,888,649,439,
3,"ARGES",38,18028,,325,0,"SCOALA GENERALA PADUROIU DIN VALE","POIANA LACULUI",70,18028,0,3,1612,883,607,276,873,10,1800,917,507,366,
3,"ARGES",38,18028,,326,0,"SCOALA GENERALA SAMARA","POIANA LACULUI",70,18028,0,3,1350,658,505,153,649,9,1600,942,381,268,
3,"ARGES",38,18162,,327,0,"SCOALA GENERALA POPESTI","POPESTI",73,18162,0,3,744,752,640,112,748,4,800,48,634,114,
3,"ARGES",38,18162,,328,0,"SCOALA GENERALA SLOBOZIA","POPESTI",73,18162,0,3,1522,975,838,137,969,6,1650,675,774,195,
3,"ARGES",38,18162,,329,0,"SCOALA GENERALA RICA","POPESTI",73,18162,0,3,1112,974,726,248,967,7,1250,276,840,127,
3,"ARGES",38,18242,,330,0,"CAMIN CULTURAL PRIBOIENI","PRIBOIENI",74,18242,0,3,2835,1496,1376,120,1485,11,3100,1604,970,515,
3,"ARGES",38,18331,,331,0,"SCOALA GENERALA NEJLOVELE","RATESTI",75,18331,0,3,663,471,409,62,468,3,750,279,319,149,
3,"ARGES",38,18331,,332,0,"SCOALA GENERALA FURDUIESTI","RATESTI",75,18331,0,3,492,420,407,13,417,3,550,130,328,89,
3,"ARGES",38,18331,,333,0,"CAMIN CULTURAL RATESTI","RATESTI",75,18331,0,3,1571,1400,1300,100,1385,15,1700,300,969,416,
3,"ARGES",38,18411,,334,0,"SCOALA GENERALA RECEA","RECEA",76,18411,0,3,1704,959,780,179,950,9,1800,841,686,264,
3,"ARGES",38,18411,,335,0,"SCOALA GENERALA DEAGURILE","RECEA",76,18411,0,3,933,650,574,76,640,10,1100,450,517,123,
3,"ARGES",38,18475,,336,0,"SCOALA GENERALA ROCIU","ROCIU",77,18475,0,3,459,399,283,116,368,31,500,101,284,84,
3,"ARGES",38,18475,,337,0,"SCOALA GENERALA GLIGANU DE JOS","ROCIU",77,18475,0,3,453,360,267,93,357,3,500,140,262,95,
3,"ARGES",38,18475,,338,0,"SCOALA GENERALA GLIGANU DE SUS","ROCIU",77,18475,0,3,712,519,392,127,512,7,800,281,359,153,
3,"ARGES",38,18475,,339,0,"SCOALA GENERALA SERBANESTI","ROCIU",77,18475,0,3,879,522,443,79,510,12,1000,478,295,215,
3,"ARGES",38,18527,,340,0,"CAMIN CULTURAL RUCAR","RUCAR",78,18527,0,3,2383,1721,1473,248,1716,5,2500,779,986,730,
3,"ARGES",38,18527,,341,0,"SCOALA GENERALA NR.1 RUCAR","RUCAR",78,18527,0,3,2319,1549,1332,217,1545,4,2500,951,825,720,
3,"ARGES",38,18527,,342,0,"SCOALA DE 4 ANI SATUL SATIC","RUCAR",78,18527,0,3,117,121,69,52,121,0,300,179,71,50,
3,"ARGES",38,18554,,343,0,"CAMINUL CULTURAL","SALATRUCU",79,18554,0,3,1280,501,440,61,492,9,1400,899,337,155,
3,"ARGES",38,18554,,344,0,"SCOALA GENERALA VALENI","SALATRUCU",79,18554,0,3,450,269,198,71,265,4,600,331,104,161,
3,"ARGES",38,18581,,345,0,"GRADINITA MIRTESTI","SAPATA",80,18581,0,3,242,230,169,61,227,3,260,30,160,67,
3,"ARGES",38,18581,,346,0,"SCOALA GENERALA SAPATA DE JOS","SAPATA",80,18581,0,3,397,279,213,66,276,3,430,151,194,82,
3,"ARGES",38,18581,,347,0,"SCOALA GENERALA DEALUL BRADULUI","SAPATA",80,18581,0,3,183,149,104,45,149,0,210,61,97,52,
3,"ARGES",38,18581,,348,0,"PRIMARIE","SAPATA",80,18581,0,3,745,546,423,123,539,7,800,254,369,170,
3,"ARGES",38,18670,,349,0,"SCOALA GENERALA SCHITU GOLESTI","SCHITU GOLESTI",81,18670,0,3,2327,1225,1133,92,1221,4,2600,1375,933,288,
3,"ARGES",38,18670,,350,0,"CAMIN CULTURAL","SCHITU GOLESTI",81,18670,0,3,1510,903,746,157,892,11,1700,797,565,327,
3,"ARGES",38,18741,,351,0,"SCOALA GENERALA NR.1","SLOBOZIA",82,18741,0,3,2009,884,754,130,864,20,2200,1316,549,315,
3,"ARGES",38,18741,,352,0,"SCOALA GENERALA NR.2","SLOBOZIA",82,18741,0,3,2101,893,772,121,890,3,2300,1407,567,323,
3,"ARGES",38,18778,,353,0,"CLUBUL MUNCITORILOR FORESTIERI","STALPENI",83,18778,0,3,1579,884,766,118,869,15,1800,916,663,206,
3,"ARGES",38,18778,,354,0,"CAMIN CULTURAL  LIVEZENI","STALPENI",83,18778,0,3,1079,746,627,119,739,7,1200,454,535,204,
3,"ARGES",38,18778,,355,0,"CAMIN CULTURAL RADESTI","STALPENI",83,18778,0,3,1363,854,705,149,847,7,1500,646,626,221,
3,"ARGES",38,18858,,356,0,"SCOALA GENERALA STOENESTI","STOENESTI",86,18858,0,3,1192,612,532,80,609,3,1300,588,348,261,
3,"ARGES",38,18858,,357,0,"SCOALA GENERALA BADENI","STOENESTI",86,18858,0,3,2074,1056,990,66,1036,20,2300,1244,673,363,
3,"ARGES",38,18858,,358,0,"SCOALA GENERALA PIATRA","STOENESTI",86,18858,0,3,469,243,222,21,242,1,500,257,174,68,
3,"ARGES",38,18938,,359,0,"SCOALA GENERALA STOLNICI","STOLNICI",87,18938,0,3,1652,775,613,162,762,13,1852,1077,543,219,
3,"ARGES",38,18938,,360,0,"CAMIN CULTURAL FILFANI","STOLNICI",87,18938,0,3,1362,682,492,190,671,11,1548,866,455,216,
3,"ARGES",38,19007,,361,0,"SCOALA GENERALA SUSENI","SUSENI",89,19007,0,3,1598,779,667,112,777,2,1760,981,535,242,
3,"ARGES",38,19007,,362,0,"SCOALA GENERALA TUTULESTI","SUSENI",89,19007,0,3,1124,719,533,186,712,7,1240,521,511,201,
3,"ARGES",38,19114,,363,0,"SCOALA GENERALA STEFAN CEL MARE","STEFAN CEL MARE",84,19114,0,3,1733,944,814,130,933,11,1900,956,618,315,
3,"ARGES",38,19114,,364,0,"SCOALA GENERALA GLAVACIOC","STEFAN CEL MARE",84,19114,0,3,321,242,152,90,238,4,400,158,195,43,
3,"ARGES",38,13392,,365,0,"CAMIN CULTURAL STEFANESTI","STEFANESTI",85,13392,0,3,1206,1043,536,507,1025,18,1500,457,646,379,
3,"ARGES",38,13392,,366,0,"SCOALA GENERALA NR.2 BLOCURI","STEFANESTI",85,13392,0,3,1918,1583,849,734,1568,15,2200,617,1039,529,
3,"ARGES",38,13392,,367,0,"SCOALA GENERALA VALEA MARE","STEFANESTI",85,13392,0,3,2354,2016,1645,371,2006,10,2600,584,1562,444,
3,"ARGES",38,13392,,368,0,"SCOALA GENERALA GOLESTI","STEFANESTI",85,13392,0,3,749,644,449,195,637,7,800,156,466,171,
3,"ARGES",38,13392,,369,0,"SCOALA I-IV STEFANESTI VALE","STEFANESTI",85,13392,0,3,2654,1231,1073,158,1222,9,2600,1369,949,273,
3,"ARGES",38,13392,,370,0,"SCOALA I-IV ENCULESTI","STEFANESTI",85,13392,0,3,215,384,170,214,380,4,400,16,259,121,
3,"ARGES",38,19141,,371,0,"CONSILIUL LOCAL SUICI","SUICI",88,19141,0,3,1337,556,481,75,553,3,1500,944,357,196,
3,"ARGES",38,19141,,372,0,"SCOALA GENERALA RUDENI","SUICI",88,19141,0,3,636,432,333,99,424,8,696,264,254,170,
3,"ARGES",38,19141,,373,0,"SCOALA GENERALA IANCULESTI","SUICI",88,19141,0,3,275,197,182,15,193,4,300,103,106,87,
3,"ARGES",38,19141,,374,0,"SCOALA PRIMARA VALEA CALULUI","SUICI",88,19141,0,3,86,63,38,25,61,2,100,37,34,27,
3,"ARGES",38,19212,,375,0,"CAMIN CULTURAL TEIU","TEIU",90,19212,0,3,1530,758,653,105,744,14,1700,942,551,193,
3,"ARGES",38,19249,,376,0,"CONSILIUL LOCAL TIGVENI","TIGVENI",91,19249,0,3,1202,660,550,110,644,16,1343,683,449,195,
3,"ARGES",38,19249,,377,0,"SCOALA GENERALA BIRSESTI","TIGVENI",91,19249,0,3,1013,615,519,96,609,6,1114,499,391,218,
3,"ARGES",38,19249,,378,0,"SCOALA GENERALA VLADESTI","TIGVENI",91,19249,0,3,278,191,161,30,190,1,343,152,132,58,
3,"ARGES",38,19338,,379,0,"CONSILIUL TITESTI","TITESTI",92,19338,0,3,2498,1305,1139,166,1294,11,2800,1495,936,358,
3,"ARGES",38,19338,,380,0,"SCOALA GENERALA VALEA MINASTIRII","TITESTI",92,19338,0,3,610,321,262,59,314,7,700,379,288,26,
3,"ARGES",38,19392,,381,0,"UDA DE SUS","UDA",93,19392,0,3,323,272,185,87,267,5,350,78,223,44,
3,"ARGES",38,19392,,382,0,"UDA DE JOS","UDA",93,19392,0,3,763,280,213,67,275,5,800,520,223,52,
3,"ARGES",38,19392,,383,0,"SALISTEA","UDA",93,19392,0,3,615,392,244,148,388,4,700,308,252,136,
3,"ARGES",38,19392,,384,0,"GOVORA","UDA",93,19392,0,3,473,398,199,199,395,3,550,152,268,127,
3,"ARGES",38,19560,,385,0,"SCOALA GENERALA UNGHENI","UNGHENI",94,19560,0,3,880,467,386,81,457,10,1000,533,304,153,
3,"ARGES",38,19560,,386,0,"SCOALA GENERALA COLTU","UNGHENI",94,19560,0,3,803,455,368,87,447,8,900,445,307,140,
3,"ARGES",38,19560,,387,0,"SEDIUL SOCIETATII AGRICOLE ALBINA","UNGHENI",94,19560,0,3,1504,799,685,114,788,11,1600,801,527,261,
3,"ARGES",38,19631,,388,0,"CAMINUL CULTURAL VALEA DANULUI","VALEA DANULUI",95,19631,0,3,1715,807,727,80,794,13,1800,993,487,307,
3,"ARGES",38,19631,,389,0,"CAMIN CULTURAL VERNESTI","VALEA DANULUI",95,19631,0,3,992,532,399,133,524,8,992,460,337,187,
3,"ARGES",38,19695,,390,0,"SCOALA GENERALA VALEA IASULUI","VALEA IASULUI",96,19695,0,3,1084,525,450,75,521,4,1250,725,325,196,
3,"ARGES",38,19695,,391,0,"SCOALA GENERALA MUSATESTI","VALEA IASULUI",96,19695,0,3,1140,596,529,67,587,9,1250,654,403,184,
3,"ARGES",38,13524,,392,0,"CAMIN CULTURAL VALEA MARE PRAVAT","VALEA MARE PRAVAT",97,13524,0,3,1291,831,702,129,821,10,1400,569,537,284,
3,"ARGES",38,13524,,393,0,"CAMIN CULTURAL NAMAIESTI","VALEA MARE PRAVAT",97,13524,0,3,1028,755,687,68,744,11,1200,445,576,168,
3,"ARGES",38,13524,,394,0,"SCOALA GENERALA BILCESTI","VALEA MARE PRAVAT",97,13524,0,3,736,436,354,82,433,3,800,364,259,174,
3,"ARGES",38,19793,,395,0,"GRUP SCOLAR VEDEA","VEDEA",98,19793,0,3,2147,728,550,178,715,13,2000,1272,471,244,
3,"ARGES",38,19793,,396,0,"SCOALA GENERALA VATA","VEDEA",98,19793,0,3,794,645,377,268,639,6,1200,555,431,208,
3,"ARGES",38,19793,,397,0,"SCOALA GENERALA FATA","VEDEA",98,19793,0,3,432,383,170,213,377,6,500,113,236,141,
3,"ARGES",38,19999,,398,0,"SCOALA GENERALA VLADESTII DE SUS","VLADESTI",99,19999,0,3,753,446,394,52,440,6,900,454,289,151,
3,"ARGES",38,19999,,399,0,"GRADINITA VLADESTI CENTRU","VLADESTI",99,19999,0,3,1712,973,877,96,968,5,1800,827,668,300,
4,"BACAU",47,20297,,1,0,"Mun.Bacau str.Vasile Alecsandri nr.37","MUNICIPIUL BACAU",1,20297,1,1,2000,1236,1106,130,1206,30,2300,1064,886,320,
4,"BACAU",47,20297,,2,0,"Mun.Bacau str.Razboieni nr.24","MUNICIPIUL BACAU",1,20297,1,1,2187,1351,1258,93,1324,27,2500,1149,988,336,
4,"BACAU",47,20297,,3,0,"Mun.Bacau str.Oituz nr.14","MUNICIPIUL BACAU",1,20297,1,1,1852,1132,1026,106,1095,37,2100,968,795,300,
4,"BACAU",47,20297,,4,0,"Mun.Bacau str.I.S.Sturza nr.80","MUNICIPIUL BACAU",1,20297,1,1,2241,1346,1277,69,1320,26,2600,1254,1015,305,
4,"BACAU",47,20297,,5,0,"Mun.Bacau str.George Bacovia nr.45","MUNICIPIUL BACAU",1,20297,1,1,2211,1193,1098,95,1169,24,2500,1307,836,333,
4,"BACAU",47,20297,,6,0,"Mun.Bacau str.Mioritei nr.76","MUNICIPIUL BACAU",1,20297,1,1,2052,1215,1101,114,1194,21,2196,981,796,398,
4,"BACAU",47,20297,,7,0,"Mun.Bacau str.Mihai Eminescu nr.35","MUNICIPIUL BACAU",1,20297,1,1,2372,1431,1271,160,1410,21,2600,1169,959,451,
4,"BACAU",47,20297,,8,0,"Mun.Bacau str.Vasile Parvan nr.22","MUNICIPIUL BACAU",1,20297,1,1,2171,1443,1248,195,1422,21,2392,949,955,467,
4,"BACAU",47,20297,,9,0,"Mun.Bacau str.Mioritei nr.76","MUNICIPIUL BACAU",1,20297,1,1,2220,1295,1190,105,1276,19,2399,1104,782,494,
4,"BACAU",47,20297,,10,0,"Mun.Bacau str.Tipografilor nr.11","MUNICIPIUL BACAU",1,20297,1,1,2473,1351,1265,86,1317,34,2691,1340,838,479,
4,"BACAU",47,20297,,11,0,"Mun.Bacau str.Cuza Voda nr.10","MUNICIPIUL BACAU",1,20297,1,1,2081,1102,1049,53,1078,24,2300,1198,751,327,
4,"BACAU",47,20297,,12,0,"Mun.Bacau str.Tipografilor nr.11","MUNICIPIUL BACAU",1,20297,1,1,2573,1323,1243,80,1298,25,2901,1578,846,452,
4,"BACAU",47,20297,,13,0,"Mun.Bacau str.Prieteniei nr.73","MUNICIPIUL BACAU",1,20297,1,1,2345,1185,1100,85,1156,29,2600,1415,648,508,
4,"BACAU",47,20297,,14,0,"Mun.Bacau str.Radu Negru nr.3","MUNICIPIUL BACAU",1,20297,1,1,3108,1716,1639,77,1682,34,3400,1684,1054,628,
4,"BACAU",47,20297,,15,0,"Mun.Bacau str.Radu Negru nr.3","MUNICIPIUL BACAU",1,20297,1,1,2778,1378,1326,52,1359,19,3100,1722,889,470,
4,"BACAU",47,20297,,16,0,"Mun.Bacau str.Lucretiu Patrascanu nr.30","MUNICIPIUL BACAU",1,20297,1,1,2778,1511,1447,64,1495,16,3097,1586,992,503,
4,"BACAU",47,20297,,17,0,"Mun.Bacau str.Mioritei nr.10","MUNICIPIUL BACAU",1,20297,1,1,2559,1527,1399,128,1498,29,2800,1273,1009,489,
4,"BACAU",47,20297,,18,0,"Mun.Bacau str.Prieteniei nr.73","MUNICIPIUL BACAU",1,20297,1,1,2783,1495,1386,109,1469,26,3103,1608,970,499,
4,"BACAU",47,20297,,19,0,"Mun.Bacau str.Prieteniei nr.73","MUNICIPIUL BACAU",1,20297,1,1,2326,1236,1153,83,1217,19,2600,1364,740,477,
4,"BACAU",47,20297,,20,0,"Mun.Bacau str.Logofat Tautu nr.7","MUNICIPIUL BACAU",1,20297,1,1,2417,1291,1212,79,1273,18,2712,1421,840,433,
4,"BACAU",47,20297,,21,0,"Mun.Bacau str.Logofat Tautu nr.7","MUNICIPIUL BACAU",1,20297,1,1,2421,1310,1235,75,1294,16,2700,1390,850,444,
4,"BACAU",47,20297,,22,0,"Mun.Bacau str.Stefan cel Mare nr.26","MUNICIPIUL BACAU",1,20297,1,1,2945,1683,1522,161,1646,37,3301,1618,1091,555,
4,"BACAU",47,20297,,23,0,"Mun.Bacau str.Venus nr.1","MUNICIPIUL BACAU",1,20297,1,1,2499,1243,1181,62,1223,20,2801,1558,739,484,
4,"BACAU",47,20297,,24,0,"Mun.Bacau str.Logofat Tautu nr.7","MUNICIPIUL BACAU",1,20297,1,1,2032,966,934,32,954,12,2200,1234,591,363,
4,"BACAU",47,20297,,25,0,"Mun.Bacau str.Venus nr.1","MUNICIPIUL BACAU",1,20297,1,1,2052,1090,1018,72,1072,18,2290,1200,630,442,
4,"BACAU",47,20297,,26,0,"Mun.Bacau cal.Moldovei nr.136","MUNICIPIUL BACAU",1,20297,1,1,1290,755,706,49,747,8,1399,644,464,283,
4,"BACAU",47,20297,,27,0,"Mun.Bacau cal.Romanului nr.144","MUNICIPIUL BACAU",1,20297,1,1,2471,1412,1322,90,1398,14,2700,1288,937,461,
4,"BACAU",47,20297,,28,0,"Mun.Bacau str.Tecuciului nr.17","MUNICIPIUL BACAU",1,20297,1,1,2870,1891,1686,205,1820,38,3200,1309,1228,592,
4,"BACAU",47,20297,,29,0,"Mun.Bacau str.9 Mai nr.104","MUNICIPIUL BACAU",1,20297,1,1,3141,1790,1505,285,1758,32,3500,1710,1206,552,
4,"BACAU",47,20297,,30,0,"Mun.Bacau str.9 Mai nr.64","MUNICIPIUL BACAU",1,20297,1,1,2439,1370,1231,139,1345,24,2700,1330,939,406,
4,"BACAU",47,20297,,31,0,"Mun.Bacau str.Alexandru cel Bun nr.43","MUNICIPIUL BACAU",1,20297,1,1,1995,1240,1122,118,1216,23,2308,1068,881,335,
4,"BACAU",47,20297,,32,0,"Mun.Bacau str.9 Mai nr.64","MUNICIPIUL BACAU",1,20297,1,1,2041,1168,1114,54,1148,20,2300,1132,791,357,
4,"BACAU",47,20297,,33,0,"Mun.Bacau str.Alexandru cel Bun nr.10","MUNICIPIUL BACAU",1,20297,1,1,2138,1168,1116,52,1149,19,2395,1227,771,378,
4,"BACAU",47,20297,,34,0,"Mun.Bacau str.9 Mai nr.11","MUNICIPIUL BACAU",1,20297,1,1,2536,1366,1296,70,1349,17,2900,1534,849,500,
4,"BACAU",47,20297,,35,0,"Mun.Bacau str.Miron Costin nr.64","MUNICIPIUL BACAU",1,20297,1,1,2643,1430,1314,116,1414,16,2900,1470,947,467,
4,"BACAU",47,20297,,36,0,"Mun.Bacau str.Mircea Eliade nr.6","MUNICIPIUL BACAU",1,20297,1,1,2149,1318,1144,174,1301,17,2400,1082,868,433,
4,"BACAU",47,20297,,37,0,"Mun.Bacau str.Miron Costin nr.64","MUNICIPIUL BACAU",1,20297,1,1,2615,1438,1386,52,1420,18,2900,1462,937,483,
4,"BACAU",47,20297,,38,0,"Mun.Bacau al.Ghioceilor","MUNICIPIUL BACAU",1,20297,1,1,2097,1289,1051,238,1258,31,2297,1008,874,384,
4,"BACAU",47,20297,,39,0,"Mun.Bacau str.Spiru Haret nr.6","MUNICIPIUL BACAU",1,20297,1,1,2325,1563,1229,334,1542,19,2600,1037,1043,499,
4,"BACAU",47,20297,,40,0,"Mun.Bacau str.Carpati nr.28","MUNICIPIUL BACAU",1,20297,1,1,3113,1695,1553,142,1670,24,3400,1705,1083,587,
4,"BACAU",47,20297,,41,0,"Mun.Bacau str.Carpati nr.12A","MUNICIPIUL BACAU",1,20297,1,1,2445,1293,1208,85,1272,21,2800,1507,816,456,
4,"BACAU",47,20297,,42,0,"Mun.Bacau str.Carpati nr.12A","MUNICIPIUL BACAU",1,20297,1,1,2630,1450,1374,76,1422,28,3000,1550,1005,417,
4,"BACAU",47,20297,,43,0,"Mun.Bacau str.Spiru Haret nr.6","MUNICIPIUL BACAU",1,20297,1,1,2493,1386,1275,111,1360,26,2701,1315,1007,353,
4,"BACAU",47,20297,,44,0,"Mun.Bacau str.Pictor Andreescu nr.1","MUNICIPIUL BACAU",1,20297,1,1,2456,1499,1415,84,1478,21,2747,1248,1076,402,
4,"BACAU",47,20297,,45,0,"Mun.Bacau str.Pictor Andreescu nr.1","MUNICIPIUL BACAU",1,20297,1,1,2373,1381,1309,72,1357,24,2600,1219,986,371,
4,"BACAU",47,20297,,46,0,"Mun.Bacau str.Alecu Russo nr.5","MUNICIPIUL BACAU",1,20297,1,1,2448,1355,1303,52,1332,23,2700,1345,918,414,
4,"BACAU",47,20297,,47,0,"Mun.Bacau str.Alecu Russo nr.5","MUNICIPIUL BACAU",1,20297,1,1,2436,1228,1145,83,1198,30,2700,1472,774,424,
4,"BACAU",47,20297,,48,0,"Mun.Bacau str.Alecu Russo nr.5","MUNICIPIUL BACAU",1,20297,1,1,2565,1381,1314,67,1366,15,2800,1419,906,460,
4,"BACAU",47,20297,,49,0,"Mun.Bacau str.Alecu Russo nr.29","MUNICIPIUL BACAU",1,20297,1,1,2439,1247,1188,59,1227,20,2680,1433,827,400,
4,"BACAU",47,20297,,50,0,"Mun.Bacau str.Alecu Russo nr.37","MUNICIPIUL BACAU",1,20297,1,1,2313,1231,1164,67,1210,21,2499,1268,784,426,
4,"BACAU",47,20297,,51,0,"Mun.Bacau str.Alecu Russo nr.59","MUNICIPIUL BACAU",1,20297,1,1,2151,1214,1137,77,1163,51,2400,1186,782,381,
4,"BACAU",47,20297,,52,0,"Mun.Bacau str.Alecu Russo nr.37","MUNICIPIUL BACAU",1,20297,1,1,2075,1117,939,178,1091,26,2300,1183,699,392,
4,"BACAU",47,20297,,53,0,"Mun.Bacau str.Letea nr.26","MUNICIPIUL BACAU",1,20297,1,1,3539,1759,1692,67,1731,28,3906,2147,1183,548,
4,"BACAU",47,20297,,54,0,"Mun.Bacau str.Letea nr.26","MUNICIPIUL BACAU",1,20297,1,1,2326,1262,1138,124,1234,28,2614,1352,795,439,
4,"BACAU",47,20297,,55,0,"Mun.Bacau str.Bicaz nr.3","MUNICIPIUL BACAU",1,20297,1,1,3267,1666,1590,76,1633,33,3600,1934,1049,584,
4,"BACAU",47,20297,,56,0,"Mun.Bacau str.Bicaz nr.3","MUNICIPIUL BACAU",1,20297,1,1,2605,1411,1339,72,1387,24,2900,1489,884,503,
4,"BACAU",47,20297,,57,0,"Mun.Bacau str.Bicaz nr.17","MUNICIPIUL BACAU",1,20297,1,1,2908,1472,1419,53,1451,21,3200,1728,921,530,
4,"BACAU",47,20297,,58,0,"Mun.Bacau str.Henri Coanda nr.7","MUNICIPIUL BACAU",1,20297,1,1,3026,1601,1489,112,1582,19,3300,1699,917,665,
4,"BACAU",47,20297,,59,0,"Mun.Bacau str.Bicaz nr.17","MUNICIPIUL BACAU",1,20297,1,1,2582,1407,1290,117,1390,17,2903,1496,865,525,
4,"BACAU",47,20297,,60,0,"Mun.Bacau str.Aeroportului nr.5","MUNICIPIUL BACAU",1,20297,1,1,2609,1686,1358,328,1669,17,2900,1214,1050,619,
4,"BACAU",47,20297,,61,0,"Mun.Bacau str.Aviatori nr.6","MUNICIPIUL BACAU",1,20297,1,1,2750,1539,1429,110,1509,17,3000,1461,958,551,
4,"BACAU",47,20297,,62,0,"Mun.Bacau str.Henri Coanda nr.1","MUNICIPIUL BACAU",1,20297,1,1,2461,1498,1389,109,1479,19,2704,1206,921,558,
4,"BACAU",47,20297,,63,0,"Mun.Bacau str.Narciselor nr.16","MUNICIPIUL BACAU",1,20297,1,1,2527,1467,1268,199,1438,29,2777,1310,869,569,
4,"BACAU",47,20297,,64,0,"Mun.Bacau str.Bicaz nr.126","MUNICIPIUL BACAU",1,20297,1,1,2333,1267,1107,160,1249,18,2600,1333,703,546,
4,"BACAU",47,20297,,65,0,"Mun.Bacau str.Bicaz nr.126","MUNICIPIUL BACAU",1,20297,1,1,2477,1453,1342,111,1427,26,2703,1250,929,498,
4,"BACAU",47,20297,,66,1,"Mun.Bacau str.Marasesti nr.80","MUNICIPIUL BACAU",1,20297,1,1,0,730,0,730,709,21,1835,1105,496,213,
4,"BACAU",47,20297,,67,1,"Mun.Bacau str.Republicii nr.222bis","MUNICIPIUL BACAU",1,20297,1,1,0,159,0,159,156,3,200,41,74,82,
4,"BACAU",47,20297,,68,1,"Mun.Bacau str.Stefan Guse nr.2","MUNICIPIUL BACAU",1,20297,1,1,0,119,0,119,118,1,200,81,63,55,
4,"BACAU",47,20297,,69,1,"Mun.Bacau str.Stefan Guse nr.9","MUNICIPIUL BACAU",1,20297,1,1,0,82,0,82,79,3,200,118,50,29,
4,"BACAU",47,20297,,70,1,"Mun.Bacau str.Constantei nr.1","MUNICIPIUL BACAU",1,20297,1,1,0,115,0,115,111,4,200,85,62,49,
4,"BACAU",47,20297,,71,1,"Mun.Bacau str.Constantin Musat nr.4","MUNICIPIUL BACAU",1,20297,1,1,0,579,0,579,558,21,700,121,366,192,
4,"BACAU",47,20297,,72,1,"Mun.Bacau str.Stefan Guse nr.3","MUNICIPIUL BACAU",1,20297,1,1,0,465,0,465,446,19,701,236,206,240,
4,"BACAU",47,20563,,73,0,"Mun.Onesti str.Tineretului nr.14","MUNICIPIUL ONESTI",2,20563,1,1,2390,1464,1361,103,1446,18,2636,1172,1126,320,
4,"BACAU",47,20563,,74,0,"Mun.Onesti str.Tineretului nr.14","MUNICIPIUL ONESTI",2,20563,1,1,2415,1445,1384,61,1434,11,2661,1216,1079,355,
4,"BACAU",47,20563,,75,0,"Mun.Onesti b-dul Oituz nr.7bis","MUNICIPIUL ONESTI",2,20563,1,1,2451,1342,1287,55,1327,15,2700,1358,978,349,
4,"BACAU",47,20563,,76,0,"Mun.Onesti str.Venus nr.2","MUNICIPIUL ONESTI",2,20563,1,1,2584,1432,1305,127,1409,23,2850,1418,964,445,
4,"BACAU",47,20563,,77,0,"Mun.Onesti str.Aurora nr.2","MUNICIPIUL ONESTI",2,20563,1,1,2969,1491,1444,47,1464,27,3275,1784,1008,456,
4,"BACAU",47,20563,,78,0,"Mun.Onesti str.Aurora nr.2","MUNICIPIUL ONESTI",2,20563,1,1,2642,1434,1348,86,1416,18,2900,1466,983,433,
4,"BACAU",47,20563,,79,0,"Mun.Onesti str.Culturii nr.2","MUNICIPIUL ONESTI",2,20563,1,1,2286,1343,1283,60,1325,18,2500,1157,895,430,
4,"BACAU",47,20563,,80,0,"Mun.Onesti str.Culturii nr.2","MUNICIPIUL ONESTI",2,20563,1,1,2256,1360,1285,75,1341,19,2500,1140,984,357,
4,"BACAU",47,20563,,81,0,"Mun.Onesti str.1 Mai nr.7","MUNICIPIUL ONESTI",2,20563,1,1,2100,1315,1236,79,1307,8,2300,985,973,334,
4,"BACAU",47,20563,,82,0,"Mun.Onesti str.Casinului nr.15","MUNICIPIUL ONESTI",2,20563,1,1,1759,993,926,67,980,12,1960,967,732,248,
4,"BACAU",47,20563,,83,0,"Mun.Onesti str.Casinului nr.15","MUNICIPIUL ONESTI",2,20563,1,1,1950,1150,1074,76,1135,15,2148,998,837,298,
4,"BACAU",47,20563,,84,0,"Mun.Onesti str.Perchiului nr.4","MUNICIPIUL ONESTI",2,20563,1,1,2481,1789,1376,413,1741,14,2742,953,1295,446,
4,"BACAU",47,20563,,85,0,"Mun.Onesti str.Perchiului nr.4","MUNICIPIUL ONESTI",2,20563,1,1,2275,1341,1271,70,1333,8,2500,1159,1017,316,
4,"BACAU",47,20563,,86,0,"Mun.Onesti str.Dr.Victor Babes nr.12","MUNICIPIUL ONESTI",2,20563,1,1,3320,1836,1667,169,1799,37,3562,1726,1212,587,
4,"BACAU",47,20563,,87,0,"Mun.Onesti b-dul Republicii nr.60","MUNICIPIUL ONESTI",2,20563,1,1,2542,1396,1278,118,1381,15,2701,1305,951,430,
4,"BACAU",47,20563,,88,0,"Mun.Onesti str.Armoniei nr.4","MUNICIPIUL ONESTI",2,20563,1,1,2369,1303,1240,63,1287,16,2639,1336,1000,287,
4,"BACAU",47,20563,,89,0,"Mun.Onesti str.Armoniei nr.4","MUNICIPIUL ONESTI",2,20563,1,1,2142,1290,1239,51,1257,11,2409,1119,867,390,
4,"BACAU",47,20563,,90,0,"Mun.Onesti b-dul Republicii nr.45","MUNICIPIUL ONESTI",2,20563,1,1,1710,1032,905,127,1024,8,1886,854,668,356,
4,"BACAU",47,20563,,91,0,"Mun.Onesti str.Avantului nr.5","MUNICIPIUL ONESTI",2,20563,1,1,955,583,534,49,578,5,961,378,426,152,
4,"BACAU",47,20563,,92,0,"Mun.Onesti","MUNICIPIUL ONESTI",2,20563,1,1,238,465,137,328,461,4,579,114,349,112,
4,"BACAU",47,20563,,93,0,"Mun.Onesti str.Victoriei nr.44","MUNICIPIUL ONESTI",2,20563,1,1,821,605,549,56,594,11,900,295,439,155,
4,"BACAU",47,20563,,94,0,"Mun.Onesti str.Flacara nr.2","MUNICIPIUL ONESTI",2,20563,1,1,2137,1435,1336,99,1389,14,2360,925,1091,298,
4,"BACAU",47,20778,,95,0,"Ors.Buhusi str.Republicii nr.5","ORAS BUHUSI",3,20778,2,1,2469,1331,1281,50,1309,22,2600,1269,977,332,
4,"BACAU",47,20778,,96,0,"Ors.Buhusi str.Tineretului nr.3","ORAS BUHUSI",3,20778,2,1,2846,1832,1642,190,1812,20,3011,1179,1337,475,
4,"BACAU",47,20778,,97,0,"Ors.Buhusi str.Tineretului nr.1","ORAS BUHUSI",3,20778,2,1,2386,1468,1309,159,1446,22,2515,1047,1101,345,
4,"BACAU",47,20778,,98,0,"Ors.Buhusi str.Florilor nr.7","ORAS BUHUSI",3,20778,2,1,3028,1706,1614,92,1683,23,3200,1494,1239,444,
4,"BACAU",47,20778,,99,0,"Ors.Buhusi str.Libertatii nr.225","ORAS BUHUSI",3,20778,2,1,2728,1508,1337,171,1486,22,2900,1392,1050,436,
4,"BACAU",47,20778,,100,0,"Ors.Buhusi str.Libertatii nr.143","ORAS BUHUSI",3,20778,2,1,2737,1606,1355,251,1590,16,3000,1394,1205,385,
4,"BACAU",47,20778,,101,0,"Ors.Buhusi str.Orbic nr.246","ORAS BUHUSI",3,20778,2,1,1132,936,686,250,923,13,1199,263,768,155,
4,"BACAU",47,20821,,102,0,"Ors.Comanesti str.Republicii nr.100","ORAS COMANESTI",4,20821,2,1,1938,1154,1063,91,1144,10,2200,1046,783,361,
4,"BACAU",47,20821,,103,0,"Ors.Comanesti str.Republicii nr.17","ORAS COMANESTI",4,20821,2,1,1570,988,886,102,970,18,1788,800,628,342,
4,"BACAU",47,20821,,104,0,"Ors.Comanesti str.Garlei nr.1","ORAS COMANESTI",4,20821,2,1,1664,986,924,62,979,7,1795,809,613,366,
4,"BACAU",47,20821,,105,0,"Ors.Comanesti str.Sperantei nr.11","ORAS COMANESTI",4,20821,2,1,1494,898,830,68,887,11,1820,922,566,321,
4,"BACAU",47,20821,,106,0,"Ors.Comanesti str.Ciobanus nr.2","ORAS COMANESTI",4,20821,2,1,1159,668,592,76,658,10,1344,676,399,259,
4,"BACAU",47,20821,,107,0,"Ors.Comanesti str.Soimului nr.35","ORAS COMANESTI",4,20821,2,1,1777,1151,1099,52,1131,20,1867,716,920,211,
4,"BACAU",47,20821,,108,0,"Ors.Comanesti str.Cuza Voda nr.7","ORAS COMANESTI",4,20821,2,1,1591,1066,1011,55,1048,18,1748,682,721,327,
4,"BACAU",47,20821,,109,0,"Ors.Comanesti str.Libertatii nr.98","ORAS COMANESTI",4,20821,2,1,1380,965,872,93,958,7,1400,435,650,308,
4,"BACAU",47,20821,,110,0,"Ors.Comanesti str.Progresului nr.43","ORAS COMANESTI",4,20821,2,1,1164,816,762,54,804,12,1245,429,544,260,
4,"BACAU",47,20821,,111,0,"Ors.Comanesti str.Garii nr.1","ORAS COMANESTI",4,20821,2,1,1135,690,642,48,682,8,1300,610,431,251,
4,"BACAU",47,20821,,112,0,"Ors.Comanesti str.Liceului nr.8","ORAS COMANESTI",4,20821,2,1,1369,829,760,69,823,6,1505,676,538,285,
4,"BACAU",47,20821,,113,0,"Ors.Comanesti str.Ciresoaia nr.68","ORAS COMANESTI",4,20821,2,1,991,684,647,37,677,7,1100,416,485,192,
4,"BACAU",47,20821,,114,0,"Ors.Comanesti str.Moldovei nr.55","ORAS COMANESTI",4,20821,2,1,636,400,376,24,395,5,680,280,227,168,
4,"BACAU",47,20821,,115,0,"Ors.Comanesti str.Vasile Alecsandri nr.18","ORAS COMANESTI",4,20821,2,1,859,676,541,135,665,11,1102,426,488,177,
4,"BACAU",47,20821,,116,0,"Ors.Comanesti str.Podeiului nr.20","ORAS COMANESTI",4,20821,2,1,399,310,277,33,309,1,516,206,219,90,
4,"BACAU",47,22166,,117,0,"Ors.Darmanesti str.Muncii nr.11","ORAS DARMANESTI",5,22166,2,1,1665,1076,919,157,1061,15,1800,724,742,319,
4,"BACAU",47,22166,,118,0,"Ors.Darmanesti str. Chimiei, nr.62","ORAS DARMANESTI",5,22166,2,1,1340,1006,843,163,994,12,1550,544,783,211,
4,"BACAU",47,22166,,119,0,"Ors.Darmanesti str. Chimiei, nr.148","ORAS DARMANESTI",5,22166,2,1,1825,1319,1161,158,1302,17,1877,558,972,330,
4,"BACAU",47,22166,,120,0,"Ors.Darmanesti str. Tineretului, nr.1","ORAS DARMANESTI",5,22166,2,1,2279,1481,1351,130,1446,35,2400,919,1058,388,
4,"BACAU",47,22166,,121,0,"Ors.Darmanesti sat Lapos","ORAS DARMANESTI",5,22166,2,1,1070,783,752,31,776,7,1150,367,590,186,
4,"BACAU",47,22166,,122,0,"Ors.Darmanesti sat Plopu","ORAS DARMANESTI",5,22166,2,1,1227,884,800,84,878,6,1337,453,699,179,
4,"BACAU",47,22166,,123,0,"Ors.Darmanesti str. Uzinei","ORAS DARMANESTI",5,22166,2,1,546,452,381,71,447,5,600,148,325,122,
4,"BACAU",47,22166,,124,0,"Ors.Darmanesti str. Plopului, nr.12","ORAS DARMANESTI",5,22166,2,1,962,615,551,64,597,18,1150,535,374,223,
4,"BACAU",47,20876,,125,0,"Ors.Moinesti str.Vasile Alecsandri nr.12","ORAS MOINESTI",6,20876,2,1,2017,1105,1031,74,1087,18,2109,1004,763,324,
4,"BACAU",47,20876,,126,0,"Ors.Moinesti str.Libertatii nr.1","ORAS MOINESTI",6,20876,2,1,2605,1475,1436,39,1450,25,2700,1225,955,495,
4,"BACAU",47,20876,,127,0,"Ors.Moinesti str.Schelei nr.1","ORAS MOINESTI",6,20876,2,1,1930,1120,1064,56,1104,16,2003,883,707,397,
4,"BACAU",47,20876,,128,0,"Ors.Moinesti str.Schelei nr.1","ORAS MOINESTI",6,20876,2,1,2705,1530,1504,26,1519,11,2800,1270,1058,461,
4,"BACAU",47,20876,,129,0,"Ors.Moinesti str.Zorilor nr.20","ORAS MOINESTI",6,20876,2,1,2265,1260,1186,74,1235,25,2500,1240,831,404,
4,"BACAU",47,20876,,130,0,"Ors.Moinesti str.Lucacesti","ORAS MOINESTI",6,20876,2,1,1368,879,853,26,866,13,1486,607,617,249,
4,"BACAU",47,20876,,131,0,"Ors.Moinesti str.Luminii nr.2","ORAS MOINESTI",6,20876,2,1,1007,750,671,79,744,6,1100,350,476,268,
4,"BACAU",47,20876,,132,0,"Ors.Moinesti str.Luminii nr.2","ORAS MOINESTI",6,20876,2,1,1545,914,875,39,904,10,1601,687,598,306,
4,"BACAU",47,20876,,133,0,"Ors.Moinesti str.Mihai Eminescu nr.237","ORAS MOINESTI",6,20876,2,1,1016,610,585,25,605,5,1096,486,405,200,
4,"BACAU",47,20876,,134,0,"Ors.Moinesti str.Lunca nr.51","ORAS MOINESTI",6,20876,2,1,866,535,502,33,523,12,899,364,297,226,
4,"BACAU",47,20876,,135,0,"Ors.Moinesti str.1 Mai nr.2","ORAS MOINESTI",6,20876,2,1,1660,1134,1057,77,1118,16,1600,466,785,333,
4,"BACAU",47,20876,,136,0,"Ors.Moinesti str.Avram Iancu nr.1","ORAS MOINESTI",6,20876,2,1,1112,779,738,41,770,9,1188,409,484,286,
4,"BACAU",47,20876,,137,1,"Ors.Moinesti str.Zorilor nr.1","ORAS MOINESTI",6,20876,2,1,0,205,0,205,203,2,300,95,125,78,
4,"BACAU",47,20910,,138,0,"Ors.Slanic Moldova","ORAS SLANIC MOLDOVA",7,20910,2,1,1652,1321,1012,309,1304,17,1994,673,739,565,
4,"BACAU",47,20910,,139,0,"Ors.Slanic Moldova (Cerdac)","ORAS SLANIC MOLDOVA",7,20910,2,1,973,685,640,45,675,10,1168,483,308,367,
4,"BACAU",47,20910,,140,0,"Ors.Slanic Moldova (Ciresoaia)","ORAS SLANIC MOLDOVA",7,20910,2,1,1437,980,935,45,968,12,1791,811,488,480,
4,"BACAU",47,20965,,141,0,"Ors.Targu Ocna str.Trandafirilor nr.2","ORAS TARGU OCNA",8,20965,2,1,1892,1321,1086,235,1300,21,2100,779,807,493,
4,"BACAU",47,20965,,142,0,"Ors.Targu Ocna str.Costache Negri nr.43","ORAS TARGU OCNA",8,20965,2,1,1987,1251,1180,71,1231,20,2152,901,770,461,
4,"BACAU",47,20965,,143,0,"Ors.Targu Ocna str.Oituz nr.13","ORAS TARGU OCNA",8,20965,2,1,2174,1336,1273,63,1328,8,2418,1082,817,511,
4,"BACAU",47,20965,,144,0,"Ors.Targu Ocna str.Costache Negri nr.123","ORAS TARGU OCNA",8,20965,2,1,1727,1153,1044,109,1143,10,1900,747,667,476,
4,"BACAU",47,20965,,145,0,"Ors.Targu Ocna str.Tisesti nr.67","ORAS TARGU OCNA",8,20965,2,1,1236,942,761,181,929,13,1350,408,511,418,
4,"BACAU",47,20965,,146,0,"Ors.Targu Ocna str.Poieni nr.33","ORAS TARGU OCNA",8,20965,2,1,756,513,474,39,509,4,851,338,282,227,
4,"BACAU",47,20965,,147,0,"Ors.Targu Ocna str.Valcele nr.27","ORAS TARGU OCNA",8,20965,2,1,1024,745,706,39,740,5,1152,407,481,259,
4,"BACAU",47,21007,,148,0,"Sat.Agas/Com.Agas","AGAS",9,21007,0,3,1882,1366,1143,223,1356,10,2025,659,810,546,
4,"BACAU",47,21007,,149,0,"Sat.Cotumba/Com.Agas","AGAS",9,21007,0,3,1020,682,530,152,668,14,1100,418,402,266,
4,"BACAU",47,21007,,150,0,"Sat.Goioasa/Com.Agas","AGAS",9,21007,0,3,1532,917,796,121,913,4,1677,760,632,281,
4,"BACAU",47,21007,,151,0,"Sat.Cosnea/Com.Agas","AGAS",9,21007,0,3,458,256,213,43,249,7,468,212,213,36,
4,"BACAU",47,21098,,152,0,"Sat.Ardeoani/Com.Ardeoani","ARDEOANI",10,21098,0,3,1331,774,701,73,768,6,1389,615,482,286,
4,"BACAU",47,21098,,153,0,"Sat.Leontinesti/Com.Ardeoani","ARDEOANI",10,21098,0,3,714,425,379,46,418,7,800,375,254,164,
4,"BACAU",47,21123,,154,0,"Sat.Asau/Com.Asau","ASAU",11,21123,0,3,1835,1496,1356,140,1471,25,1979,483,958,513,
4,"BACAU",47,21123,,155,0,"Sat.Lunca Asau/Com.Asau","ASAU",11,21123,0,3,675,534,493,41,529,5,700,166,397,132,
4,"BACAU",47,21123,,156,0,"Sat.Straja/Com.Asau","ASAU",11,21123,0,3,1488,1078,993,85,1073,5,1550,472,715,358,
4,"BACAU",47,21123,,157,0,"Sat.Apa Asau/Com.Asau","ASAU",11,21123,0,3,1272,1049,952,97,1040,9,1365,316,617,423,
4,"BACAU",47,21123,,158,0,"Sat.Paltinis/Com.Asau","ASAU",11,21123,0,3,466,469,413,56,440,29,550,81,249,191,
4,"BACAU",47,21196,,159,0,"Sat.Balcani/Com.Balcani","BALCANI",12,21196,0,3,1190,652,606,46,642,10,1266,614,382,260,
4,"BACAU",47,21196,,160,0,"Sat.Frumoasa/Com.Balcani","BALCANI",12,21196,0,3,2691,1434,1365,69,1406,28,2899,1465,960,446,
4,"BACAU",47,21196,,161,0,"Sat.Schitu Frumoasa/Com.Balcani","BALCANI",12,21196,0,3,1613,1009,956,53,983,26,1721,712,516,467,
4,"BACAU",47,21196,,162,0,"Sat.Ludasi/Com.Balcani","BALCANI",12,21196,0,3,824,392,358,34,386,6,951,559,227,159,
4,"BACAU",47,21249,,163,0,"Sat.Beresti-Bistrita/Com.Beresti-Bistrita","BERESTI-BISTRITA",14,21249,0,3,1489,985,800,185,968,17,1470,485,664,304,
4,"BACAU",47,21249,,164,0,"Sat.Itesti/Com.Beresti-Bistrita","BERESTI-BISTRITA",14,21249,0,3,699,500,361,139,496,4,699,199,382,114,
4,"BACAU",47,21249,,165,0,"Sat.Dumbrava/Com.Beresti-Bistrita","BERESTI-BISTRITA",14,21249,0,3,150,204,91,113,202,2,230,26,120,82,
4,"BACAU",47,21249,,166,1,"Sat.Itesti/Com.Beresti-Bistrita","BERESTI-BISTRITA",14,21249,0,3,53,68,52,16,68,0,70,2,35,33,
4,"BACAU",47,21338,,167,0,"Sat.Beresti-Tazlau/Com.Beresti-Tazlau","BERESTI-TAZLAU",15,21338,0,3,1050,650,587,63,642,8,1100,450,472,170,
4,"BACAU",47,21338,,168,0,"Sat.Enachesti/Com.Beresti-Tazlau","BERESTI-TAZLAU",15,21338,0,3,1005,633,562,71,619,14,1100,467,463,156,
4,"BACAU",47,21338,,169,0,"Sat.Tescani/Com.Beresti-Tazlau","BERESTI-TAZLAU",15,21338,0,3,1303,810,710,100,799,9,1400,590,510,289,
4,"BACAU",47,21338,,170,0,"Sat.Turluianu/Com.Beresti-Tazlau","BERESTI-TAZLAU",15,21338,0,3,887,517,482,35,504,13,1000,483,324,180,
4,"BACAU",47,21418,,171,0,"Sat.Berzunti/Com.Berzunti","BERZUNTI",16,21418,0,3,2056,1266,1217,49,1243,23,2250,984,813,430,
4,"BACAU",47,21418,,172,0,"Sat.Dragomir/Com.Berzunti","BERZUNTI",16,21418,0,3,1480,890,854,36,878,12,1620,730,669,209,
4,"BACAU",47,21418,,173,0,"Sat.Buda/Com.Berzunti","BERZUNTI",16,21418,0,3,396,285,239,46,284,1,430,145,197,87,
4,"BACAU",47,21454,,174,0,"Sat.Barsanesti/Com.Barsanesti","BARSANESTI",13,21454,0,3,1423,862,784,78,856,6,1570,708,616,240,
4,"BACAU",47,21454,,175,0,"Sat.Albele/Com.Barsanesti","BARSANESTI",13,21454,0,3,529,400,328,72,399,1,580,180,252,147,
4,"BACAU",47,21454,,176,0,"Sat.Bratesti/Com.Barsanesti","BARSANESTI",13,21454,0,3,1004,756,663,93,746,10,1112,356,377,369,
4,"BACAU",47,21454,,177,0,"Sat.Caraclau/Com.Barsanesti","BARSANESTI",13,21454,0,3,993,805,694,111,800,5,1020,215,540,260,
4,"BACAU",47,21506,,178,0,"Sat.Blagesti/Com.Blagesti","BLAGESTI",17,21506,0,3,1775,1079,918,161,1067,12,1900,821,792,275,
4,"BACAU",47,21506,,179,0,"Sat.Buda/Com.Blagesti","BLAGESTI",17,21506,0,3,1605,986,858,128,970,16,1900,914,727,243,
4,"BACAU",47,21506,,180,0,"Sat.Valea lui Ion/Com.Blagesti","BLAGESTI",17,21506,0,3,1059,683,565,118,679,4,1100,417,472,207,
4,"BACAU",47,21506,,181,0,"Sat.Tardenii Mari/Com.Blagesti","BLAGESTI",17,21506,0,3,1030,573,495,78,556,17,1100,527,435,121,
4,"BACAU",47,21560,,182,0,"Sat.Bogdanesti/Com.Bogdanesti","BOGDANESTI",18,21560,0,3,1667,1059,974,85,1046,13,1700,641,816,230,
4,"BACAU",47,21560,,183,0,"Sat.Filipesti/Com.Bogdanesti","BOGDANESTI",18,21560,0,3,429,350,284,66,343,7,499,149,247,96,
4,"BACAU",47,21597,,184,0,"Sat.Brusturoasa/Com.Brusturoasa","BRUSTUROASA",19,21597,0,3,1058,583,518,65,572,11,1196,613,403,169,
4,"BACAU",47,21597,,185,0,"Sat.Camenca/Com.Brusturoasa","BRUSTUROASA",19,21597,0,3,1085,601,564,37,589,12,1100,499,362,227,
4,"BACAU",47,21597,,186,0,"Sat.Cuchinis/Com.Brusturoasa","BRUSTUROASA",19,21597,0,3,625,472,392,80,456,16,700,228,306,150,
4,"BACAU",47,21668,,187,0,"Sat.Buhoci/Com.Buhoci","BUHOCI",20,21668,0,3,1179,700,571,129,685,13,1192,492,460,225,
4,"BACAU",47,21668,,188,0,"Sat.Bijghir/Com.Buhoci","BUHOCI",20,21668,0,3,1887,852,775,77,836,16,2100,1248,514,322,
4,"BACAU",47,21668,,189,0,"Sat.Coteni/Com.Buhoci","BUHOCI",20,21668,0,3,561,355,288,67,339,16,700,345,222,117,
4,"BACAU",47,21720,,190,0,"Sat.Casin/Com.Casin","CASIN",22,21720,0,3,2069,1163,1063,100,1146,17,2260,1097,796,350,
4,"BACAU",47,21720,,191,0,"Sat.Curita/Com.Casin","CASIN",22,21720,0,3,703,518,478,40,503,15,740,222,342,161,
4,"BACAU",47,21757,,192,0,"Sat.Caiuti/Com.Caiuti","CAIUTI",21,21757,0,3,1370,896,749,147,885,11,1500,604,625,260,
4,"BACAU",47,21757,,193,0,"Sat.Blidari/Com.Caiuti","CAIUTI",21,21757,0,3,1190,848,726,122,841,7,1300,452,585,256,
4,"BACAU",47,21757,,194,0,"Sat.Heltiu/Com.Caiuti","CAIUTI",21,21757,0,3,820,507,434,73,495,12,900,393,320,175,
4,"BACAU",47,21757,,195,0,"Sat.Pralea/Com.Caiuti","CAIUTI",21,21757,0,3,621,523,486,37,522,1,700,177,401,121,
4,"BACAU",47,21855,,196,0,"Sat.Cleja/Com.Cleja","CLEJA",23,21855,0,3,2237,1179,994,185,1137,42,2700,1521,746,391,
4,"BACAU",47,21855,,197,0,"Sat.Cleja/Com.Cleja","CLEJA",23,21855,0,3,1574,895,725,170,869,26,1600,705,542,327,
4,"BACAU",47,21855,,198,0,"Sat.Somusca/Com.Cleja","CLEJA",23,21855,0,3,1347,633,581,52,596,35,1402,769,430,166,
4,"BACAU",47,21891,,199,0,"Sat.Colonesti/Com.Colonesti","COLONESTI",24,21891,0,3,1057,660,606,54,649,11,1100,440,465,184,
4,"BACAU",47,21891,,200,0,"Sat.Spria/Com.Colonesti","COLONESTI",24,21891,0,3,518,334,277,57,329,5,600,266,246,83,
4,"BACAU",47,21971,,201,0,"Sat.Corbasca/Com.Corbasca","CORBASCA",25,21971,0,3,984,570,486,84,560,10,1060,490,424,136,
4,"BACAU",47,21971,,202,0,"Sat.Scarisoara/Com.Corbasca","CORBASCA",25,21971,0,3,1127,573,503,70,567,6,1230,657,430,137,
4,"BACAU",47,21971,,203,0,"Sat.Marvila/Com.Corbasca","CORBASCA",25,21971,0,3,476,282,226,56,276,6,512,230,181,95,
4,"BACAU",47,21971,,204,0,"Sat.Bacioiu/Com.Corbasca","CORBASCA",25,21971,0,3,1280,776,712,64,753,23,1400,624,734,19,
4,"BACAU",47,22059,,205,0,"Sat.Cotofanesti/Com.Cotofanesti","COTOFANESTI",26,22059,0,3,1088,724,599,125,702,22,1298,574,562,140,
4,"BACAU",47,22059,,206,0,"Sat.Borsani/Com.Cotofanesti","COTOFANESTI",26,22059,0,3,1189,724,656,68,711,13,1297,573,474,237,
4,"BACAU",47,22111,,207,0,"Sat.Damienesti/Com.Damienesti","DAMIENESTI",27,22111,0,3,805,544,465,79,534,10,900,356,422,112,
4,"BACAU",47,22111,,208,0,"Sat.Calugareni/Com.Damienesti","DAMIENESTI",27,22111,0,3,875,545,504,41,541,4,893,348,417,124,
4,"BACAU",47,22237,,209,0,"Sat.Negulesti/Com.Dealu Morii","DEALU MORII",28,22237,0,3,580,400,348,52,391,9,640,240,267,124,
4,"BACAU",47,22237,,210,0,"Sat.Cauia/Com.Dealu Morii","DEALU MORII",28,22237,0,3,606,387,337,50,384,3,670,283,261,123,
4,"BACAU",47,22237,,211,0,"Sat.Dealu Morii/Com.Dealu Morii","DEALU MORII",28,22237,0,3,1090,606,546,60,589,17,1090,484,403,186,
4,"BACAU",47,22237,,212,0,"Sat.Tavadaresti/Com.Dealu Morii","DEALU MORII",28,22237,0,3,375,261,205,56,252,9,410,149,167,85,
4,"BACAU",47,22380,,213,0,"Sat.Dofteana/Com.Dofteana","DOFTEANA",29,22380,0,3,2692,2001,1801,200,1832,169,2900,899,1272,560,
4,"BACAU",47,22380,,214,0,"Sat.Haghiac/Com.Dofteana","DOFTEANA",29,22380,0,3,1817,1367,1175,192,1351,16,2000,633,851,500,
4,"BACAU",47,22380,,215,0,"Sat.Bogata/Com.Dofteana","DOFTEANA",29,22380,0,3,613,550,466,84,546,4,700,150,375,171,
4,"BACAU",47,22380,,216,0,"Sat.Cucuieti/Com.Dofteana","DOFTEANA",29,22380,0,3,1664,1241,1119,122,1235,6,1800,559,802,433,
4,"BACAU",47,22380,,217,0,"Sat.Larga/Com.Dofteana","DOFTEANA",29,22380,0,3,923,661,589,72,650,11,1000,339,367,283,
4,"BACAU",47,22460,,218,0,"Sat.Faraoani/Com.Faraoani","FARAOANI",30,22460,0,3,2308,1259,1135,124,1212,47,2499,1240,859,353,
4,"BACAU",47,22460,,219,0,"Sat.Faraoani/Com.Faraoani","FARAOANI",30,22460,0,3,2085,1082,1003,79,1047,35,2284,1202,557,490,
4,"BACAU",47,22488,,220,0,"Sat.Filipeni/Com.Filipeni","FILIPENI",31,22488,0,3,687,556,470,86,547,9,760,204,434,113,
4,"BACAU",47,22488,,221,0,"Sat.Marasti/Com.Filipeni","FILIPENI",31,22488,0,3,667,480,363,117,475,5,740,260,297,178,
4,"BACAU",47,22488,,222,0,"Sat.Fruntesti/Com.Filipeni","FILIPENI",31,22488,0,3,635,425,346,79,424,1,700,275,320,104,
4,"BACAU",47,22576,,223,0,"Sat.Filipesti/Com.Filipesti","FILIPESTI",32,22576,0,3,783,517,384,133,503,11,850,333,320,183,
4,"BACAU",47,22576,,224,0,"Sat.Galbeni/Com.Filipesti","FILIPESTI",32,22576,0,3,637,456,318,138,453,3,700,244,333,120,
4,"BACAU",47,22576,,225,0,"Sat.Carligi/Com.Filipesti","FILIPESTI",32,22576,0,3,948,569,503,66,553,14,1050,481,367,186,
4,"BACAU",47,22576,,226,0,"Sat.Oniscani/Com.Filipesti","FILIPESTI",32,22576,0,3,680,372,305,67,364,8,750,378,215,149,
4,"BACAU",47,22576,,227,0,"Sat.Harlesti/Com.Filipesti","FILIPESTI",32,22576,0,3,445,375,289,86,371,4,550,175,284,87,
4,"BACAU",47,22665,,228,0,"Sat.Gaiceana/Com.Gaiceana","GAICEANA",33,22665,0,3,843,497,417,80,493,4,930,433,366,127,
4,"BACAU",47,22665,,229,0,"Sat.Arini/Com.Gaiceana","GAICEANA",33,22665,0,3,1060,623,595,28,613,10,1170,547,490,123,
4,"BACAU",47,22665,,230,0,"Sat.Hutu/Com.Gaiceana","GAICEANA",33,22665,0,3,545,375,303,72,368,7,600,225,289,79,
4,"BACAU",47,22718,,231,0,"Sat.Faget/Com.Ghimes-Faget","GHIMES-FAGET",35,22718,0,3,1371,630,541,89,612,18,1500,870,446,166,
4,"BACAU",47,22718,,232,0,"Sat.Tarhausi/Com.Ghimes-Faget","GHIMES-FAGET",35,22718,0,3,599,233,197,36,233,0,650,417,167,66,
4,"BACAU",47,22718,,233,0,"Sat.Ghimes/Com.Ghimes-Faget","GHIMES-FAGET",35,22718,0,3,863,464,391,73,447,17,1000,536,382,65,
4,"BACAU",47,22718,,234,0,"Sat.Bolovanis/Com.Ghimes-Faget","GHIMES-FAGET",35,22718,0,3,772,449,407,42,436,13,900,451,182,254,
4,"BACAU",47,22718,,235,0,"Sat.Rachitis/Com.Ghimes-Faget","GHIMES-FAGET",35,22718,0,3,228,179,144,35,176,3,250,71,104,72,
4,"BACAU",47,22781,,236,0,"Sat.Garlenii de Sus/Com.Garleni","GARLENI",34,22781,0,3,1162,641,493,148,631,10,1400,759,445,186,
4,"BACAU",47,22781,,237,0,"Sat.Lespezi/Com.Garleni","GARLENI",34,22781,0,3,1993,1047,881,166,1027,19,2098,1051,751,276,
4,"BACAU",47,22781,,238,0,"Sat.Garleni/Com.Garleni","GARLENI",34,22781,0,3,1456,806,684,122,798,8,1600,794,405,393,
4,"BACAU",47,22834,,239,0,"Sat.Glavanesti/Com.Glavanesti","GLAVANESTI",36,22834,0,3,1800,1014,907,107,998,16,2000,986,741,257,
4,"BACAU",47,22834,,240,0,"Sat.Frumuselu/Com.Glavanesti","GLAVANESTI",36,22834,0,3,1519,864,765,99,844,20,1600,736,629,215,
4,"BACAU",47,20607,,241,0,"Sat.Gura Vaii/Com.Gura Vaii","GURA VAII",37,20607,0,3,1879,1369,1174,195,1350,19,2000,631,1058,292,
4,"BACAU",47,20607,,242,0,"Sat.Motocesti/Com.Gura Vaii","GURA VAII",37,20607,0,3,145,121,84,37,119,2,200,79,103,16,
4,"BACAU",47,20607,,243,0,"Sat.Temelia/Com.Gura Vaii","GURA VAII",37,20607,0,3,512,403,310,93,400,3,600,197,269,131,
4,"BACAU",47,20607,,244,0,"Sat.Paltinata/Com.Gura Vaii","GURA VAII",37,20607,0,3,458,296,261,35,292,4,550,254,214,78,
4,"BACAU",47,20607,,245,0,"Sat.Dumbrava/Com.Gura Vaii","GURA VAII",37,20607,0,3,1355,768,710,58,748,20,1450,682,540,208,
4,"BACAU",47,22898,,246,0,"Sat.Helegiu/Com.Helegiu","HELEGIU",38,22898,0,3,755,602,405,197,599,3,800,198,416,183,
4,"BACAU",47,22898,,247,0,"Sat.Deleni/Com.Helegiu","HELEGIU",38,22898,0,3,1607,887,733,154,819,68,1807,920,689,130,
4,"BACAU",47,22898,,248,0,"Sat.Dragugesti/Com.Helegiu","HELEGIU",38,22898,0,3,1809,1260,1127,133,1237,23,2000,740,951,286,
4,"BACAU",47,22898,,249,1,"Sat.Bratila/Com.Helegiu","HELEGIU",38,22898,0,3,0,576,0,576,565,11,800,224,414,151,
4,"BACAU",47,22898,,250,0,"Sat.Bratila/Com.Helegiu","HELEGIU",38,22898,0,3,1602,610,502,108,600,10,900,290,461,139,
4,"BACAU",47,20313,,251,0,"Sat.Hemeius/Com.Hemeius","HEMEIUS",39,20313,0,3,1185,782,645,137,778,4,1250,468,506,272,
4,"BACAU",47,20313,,252,0,"Sat.Lilieci/Com.Hemeius","HEMEIUS",39,20313,0,3,1446,813,703,110,794,19,1497,684,447,347,
4,"BACAU",47,20313,,253,1,"Sat.Lilieci/Com.Hemeius","HEMEIUS",39,20313,0,3,0,118,0,118,117,1,150,32,83,34,
4,"BACAU",47,22941,,254,0,"Sat.Horgesti/Com.Horgesti","HORGESTI",40,22941,0,3,1566,748,692,56,739,8,1700,952,509,230,
4,"BACAU",47,22941,,255,0,"Sat.Recea/Com.Horgesti","HORGESTI",40,22941,0,3,1080,812,703,109,804,8,1200,388,638,166,
4,"BACAU",47,22941,,256,0,"Sat.Racatau-Razesi/Com.Horgesti","HORGESTI",40,22941,0,3,812,480,394,86,471,9,900,420,343,128,
4,"BACAU",47,23047,,257,0,"Sat.Huruiesti/Com.Huruiesti","HURUIESTI",41,23047,0,3,646,534,509,25,532,2,700,166,511,21,
4,"BACAU",47,23047,,258,0,"Sat.Perchiu/Com.Huruiesti","HURUIESTI",41,23047,0,3,140,173,129,44,141,32,180,7,135,6,
4,"BACAU",47,23047,,259,0,"Sat.Pradais/Com.Huruiesti","HURUIESTI",41,23047,0,3,277,296,241,55,281,15,300,4,277,4,
4,"BACAU",47,23047,,260,0,"Sat.Capotesti/Com.Huruiesti","HURUIESTI",41,23047,0,3,242,278,239,39,277,1,280,2,262,15,
4,"BACAU",47,23047,,261,0,"Sat.Ocheni/Com.Huruiesti","HURUIESTI",41,23047,0,3,360,381,350,31,378,3,400,19,364,14,
4,"BACAU",47,23047,,262,0,"Sat.Floresti/Com.Huruiesti","HURUIESTI",41,23047,0,3,180,178,171,7,177,1,200,22,166,11,
4,"BACAU",47,23047,,263,0,"Sat.Fundoaia/Com.Huruiesti","HURUIESTI",41,23047,0,3,426,348,331,17,346,2,500,152,315,31,
4,"BACAU",47,23127,,264,0,"Sat.Izvoru Berheciului/Com.Izvoru Berheciului","IZVORU BERHECIULUI",42,23127,0,3,1234,672,563,109,653,18,1402,730,482,171,
4,"BACAU",47,20359,,265,0,"Sat.Letea Veche/Com.Letea Veche","LETEA VECHE",43,20359,0,3,1194,695,585,110,688,7,1298,603,448,240,
4,"BACAU",47,20359,,266,0,"Sat.Holt/Com.Letea Veche","LETEA VECHE",43,20359,0,3,1181,864,684,180,844,20,1300,436,572,272,
4,"BACAU",47,20359,,267,0,"Sat.Rusi-Ciutea/Com.Letea Veche","LETEA VECHE",43,20359,0,3,633,456,340,116,445,11,696,240,262,183,
4,"BACAU",47,23207,,268,0,"Sat.Lipova/Com.Lipova","LIPOVA",44,23207,0,3,542,361,300,61,350,11,600,239,210,140,
4,"BACAU",47,23207,,269,0,"Sat.Valea Hogei/Com.Lipova","LIPOVA",44,23207,0,3,628,426,346,80,413,13,700,274,298,115,
4,"BACAU",47,23207,,270,0,"Sat.Malosu/Com.Lipova","LIPOVA",44,23207,0,3,940,616,516,100,602,14,982,366,411,191,
4,"BACAU",47,23289,,271,0,"Sat.Livezi/Com.Livezi","LIVEZI",45,23289,0,3,737,440,370,70,435,5,813,373,326,109,
4,"BACAU",47,23289,,272,0,"Sat.Orasa/Com.Livezi","LIVEZI",45,23289,0,3,788,574,515,59,570,4,867,293,441,129,
4,"BACAU",47,23289,,273,0,"Sat.Prajoaia/Com.Livezi","LIVEZI",45,23289,0,3,711,503,432,71,494,9,781,278,382,112,
4,"BACAU",47,23289,,274,0,"Sat.Scariga/Com.Livezi","LIVEZI",45,23289,0,3,402,342,284,58,336,6,441,99,244,92,
4,"BACAU",47,23289,,275,0,"Sat.Balaneasa/Com.Livezi","LIVEZI",45,23289,0,3,718,502,402,100,497,5,741,239,415,82,
4,"BACAU",47,23289,,276,0,"Sat.Poiana/Com.Livezi","LIVEZI",45,23289,0,3,726,475,426,49,469,6,812,337,313,156,
4,"BACAU",47,23350,,277,0,"Sat.Luizi-Calugara/Com.Luizi-Calugara","LUIZI-CALUGARA",46,23350,0,3,2857,1257,1113,144,1214,43,3000,1743,826,388,
4,"BACAU",47,23350,,278,0,"Sat.Osebiti/Com.Luizi-Calugara","LUIZI-CALUGARA",46,23350,0,3,1370,737,624,113,693,44,1600,863,460,233,
4,"BACAU",47,23387,,279,0,"Sat.Magiresti/Com.Magiresti","MAGIRESTI",47,23387,0,3,2014,1254,1099,155,1227,27,2200,946,874,353,
4,"BACAU",47,23387,,280,0,"Sat.Valea Arinilor/Com.Magiresti","MAGIRESTI",47,23387,0,3,1384,921,731,190,907,12,1500,579,563,344,
4,"BACAU",47,20411,,281,0,"Sat.Magura/Com.Magura","MAGURA",48,20411,0,3,2131,1197,1050,147,1188,9,2297,1100,673,515,
4,"BACAU",47,20411,,282,0,"Sat.Sohodol/Com.Magura","MAGURA",48,20411,0,3,705,440,343,97,436,4,800,360,231,205,
4,"BACAU",47,20466,,283,0,"Sat.Margineni/Com.Margineni","MARGINENI",50,20466,0,3,2632,1223,986,237,1190,33,2800,1577,622,568,
4,"BACAU",47,20466,,284,0,"Sat.Barati/Com.Margineni","MARGINENI",50,20466,0,3,1055,785,518,267,774,11,1200,415,509,265,
4,"BACAU",47,20466,,285,0,"Sat.Trebes/Com.Margineni","MARGINENI",50,20466,0,3,999,722,502,220,706,16,1100,378,315,391,
4,"BACAU",47,20466,,286,0,"Sat.Luncani/Com.Margineni","MARGINENI",50,20466,0,3,907,626,453,173,606,20,995,369,340,266,
4,"BACAU",47,23449,,287,0,"Sat.Manastirea Casin/Com.Manastirea Casin","MANASTIREA CASIN",49,23449,0,3,2073,1281,1104,177,1262,19,2299,1018,928,334,
4,"BACAU",47,23449,,288,0,"Sat.Manastirea Casin/Com.Manastirea Casin","MANASTIREA CASIN",49,23449,0,3,1568,1043,887,156,1025,11,1656,613,732,293,
4,"BACAU",47,23449,,289,0,"Sat.Lupesti/Com.Manastirea Casin","MANASTIREA CASIN",49,23449,0,3,589,382,313,69,369,13,650,268,273,96,
4,"BACAU",47,23494,,290,0,"Sat.Motoseni/Com.Motoseni","MOTOSENI",51,23494,0,3,1097,523,379,144,514,9,1298,775,367,147,
4,"BACAU",47,23494,,291,0,"Sat.Tepoaia/Com.Motoseni","MOTOSENI",51,23494,0,3,553,365,275,90,361,4,610,245,272,89,
4,"BACAU",47,23494,,292,0,"Sat.Cociu/Com.Motoseni","MOTOSENI",51,23494,0,3,689,407,287,120,400,7,760,353,322,78,
4,"BACAU",47,23494,,293,0,"Sat.Fantanele/Com.Motoseni","MOTOSENI",51,23494,0,3,555,457,282,175,453,4,610,153,338,115,
4,"BACAU",47,23494,,294,0,"Sat.Sendresti/Com.Motoseni","MOTOSENI",51,23494,0,3,362,291,189,102,288,3,391,100,229,59,
4,"BACAU",47,23644,,295,0,"Sat.Negri/Com.Negri","NEGRI",52,23644,0,3,1172,728,611,117,714,14,1384,656,592,122,
4,"BACAU",47,23644,,296,0,"Sat.Poiana/Com.Negri","NEGRI",52,23644,0,3,1387,764,709,55,747,17,1400,636,610,137,
4,"BACAU",47,23715,,297,0,"Sat.Nicolae Balcescu/Com.Nicolae Balcescu","NICOLAE BALCESCU",53,23715,0,3,3106,1406,1035,371,1370,36,3100,1694,837,533,
4,"BACAU",47,23715,,298,0,"Sat.Galbeni/Com.Nicolae Balcescu","NICOLAE BALCESCU",53,23715,0,3,1043,546,410,136,489,57,1000,454,260,229,
4,"BACAU",47,23715,,299,0,"Sat.Valea Seaca/Com.Nicolae Balcescu","NICOLAE BALCESCU",53,23715,0,3,1371,801,373,428,766,35,1998,1197,541,225,
4,"BACAU",47,23715,,300,0,"Sat.Valea Seaca/Com.Nicolae Balcescu","NICOLAE BALCESCU",53,23715,0,3,891,364,154,210,349,15,1000,636,257,92,
4,"BACAU",47,23715,,301,0,"Sat.Sarata/Com.Nicolae Balcescu","NICOLAE BALCESCU",53,23715,0,3,661,409,240,169,394,15,500,91,302,92,
4,"BACAU",47,23715,,302,0,"Sat.Sarata/Com.Nicolae Balcescu","NICOLAE BALCESCU",53,23715,0,3,690,490,284,206,471,19,1000,510,312,159,
4,"BACAU",47,23797,,303,0,"Sat.Oituz/Com.Oituz","OITUZ",54,23797,0,3,2009,1157,1006,151,1137,20,2100,943,821,316,
4,"BACAU",47,23797,,304,0,"Sat.Oituz/Com.Oituz","OITUZ",54,23797,0,3,1718,1017,809,208,999,18,1900,883,708,291,
4,"BACAU",47,23797,,305,0,"Sat.Oituz/Com.Oituz","OITUZ",54,23797,0,3,1360,760,609,151,744,16,1500,740,555,189,
4,"BACAU",47,23797,,306,0,"Sat.Oituz/Com.Oituz","OITUZ",54,23797,0,3,946,559,469,90,553,6,1100,541,425,128,
4,"BACAU",47,23797,,307,0,"Sat.Ferestrau-Oituz/Com.Oituz","OITUZ",54,23797,0,3,769,521,449,72,515,6,900,379,352,163,
4,"BACAU",47,23797,,308,0,"Sat.Harja/Com.Oituz","OITUZ",54,23797,0,3,322,277,196,81,272,5,400,123,149,123,
4,"BACAU",47,23797,,309,0,"Sat.Poiana Sarata/Com.Oituz","OITUZ",54,23797,0,3,212,233,129,104,228,5,300,67,139,89,
4,"BACAU",47,23868,,310,0,"Sat.Oncesti/Com.Oncesti","ONCESTI",55,23868,0,3,806,558,469,89,543,15,800,242,392,151,
4,"BACAU",47,23868,,311,0,"Sat.Tarnita/Com.Oncesti","ONCESTI",55,23868,0,3,536,375,327,48,369,6,705,330,305,64,
4,"BACAU",47,23948,,312,0,"Sat.Orbeni/Com.Orbeni","ORBENI",56,23948,0,3,1713,1114,952,162,1096,18,1880,766,746,350,
4,"BACAU",47,23948,,313,0,"Sat.Scurta/Com.Orbeni","ORBENI",56,23948,0,3,1375,991,841,150,969,22,1520,529,736,233,
4,"BACAU",47,23975,,314,0,"Sat.Palanca/Com.Palanca","PALANCA",57,23975,0,3,1233,881,756,125,869,12,1421,540,585,284,
4,"BACAU",47,23975,,315,0,"Sat.Ciughes/Com.Palanca","PALANCA",57,23975,0,3,1585,1160,1087,73,1150,10,1750,590,894,256,
4,"BACAU",47,23975,,316,0,"Sat.Cadaresti/Com.Palanca","PALANCA",57,23975,0,3,116,101,58,43,98,3,150,49,68,30,
4,"BACAU",47,24034,,317,0,"Sat.Parava/Com.Parava","PARAVA",59,24034,0,3,894,701,593,108,688,13,980,279,453,235,
4,"BACAU",47,24034,,318,0,"Sat.Dragusani/Com.Parava","PARAVA",59,24034,0,3,787,441,384,57,428,13,860,419,289,139,
4,"BACAU",47,24034,,319,0,"Sat.Radoaia/Com.Parava","PARAVA",59,24034,0,3,698,603,545,58,591,12,760,157,535,56,
4,"BACAU",47,24089,,320,0,"Sat.Parincea/Com.Parincea","PARINCEA",61,24089,0,3,662,473,364,109,465,8,720,247,260,205,
4,"BACAU",47,24089,,321,0,"Sat.Valeni/Com.Parincea","PARINCEA",61,24089,0,3,738,413,346,67,398,15,800,387,277,121,
4,"BACAU",47,24089,,322,0,"Sat.Vladnic/Com.Parincea","PARINCEA",61,24089,0,3,776,443,408,35,438,5,850,407,343,95,
4,"BACAU",47,24089,,323,0,"Sat.Nanesti/Com.Parincea","PARINCEA",61,24089,0,3,641,420,331,89,411,9,700,280,334,77,
4,"BACAU",47,24089,,324,0,"Sat.Poieni/Com.Parincea","PARINCEA",61,24089,0,3,220,159,115,44,153,6,230,71,112,41,
4,"BACAU",47,24187,,325,0,"Sat.Pancesti/Com.Pancesti","PANCESTI",58,24187,0,3,1748,888,778,110,868,20,1910,1022,661,207,
4,"BACAU",47,24187,,326,0,"Sat.Petresti/Com.Pancesti","PANCESTI",58,24187,0,3,1312,790,674,116,775,15,1435,645,595,180,
4,"BACAU",47,24187,,327,0,"Sat.Fulgeris/Com.Pancesti","PANCESTI",58,24187,0,3,321,198,161,37,189,9,347,149,122,67,
4,"BACAU",47,24276,,328,0,"Sat.Pargaresti/Com.Pargaresti","PARGARESTI",60,24276,0,3,1195,745,626,119,727,18,1295,550,518,209,
4,"BACAU",47,24276,,329,0,"Sat.Satu Nou/Com.Pargaresti","PARGARESTI",60,24276,0,3,1390,715,572,143,699,16,1530,815,490,209,
4,"BACAU",47,24276,,330,0,"Sat.Nicoresti/Com.Pargaresti","PARGARESTI",60,24276,0,3,1067,664,478,186,648,16,1175,511,445,203,
4,"BACAU",47,24338,,331,0,"Sat.Parjol/Com.Parjol","PARJOL",62,24338,0,3,662,439,311,128,431,8,740,301,259,172,
4,"BACAU",47,24338,,332,0,"Sat.Basasti/Com.Parjol","PARJOL",62,24338,0,3,540,347,264,83,344,3,595,248,186,158,
4,"BACAU",47,24338,,333,0,"Sat.Haineala/Com.Parjol","PARJOL",62,24338,0,3,224,192,121,71,190,2,250,58,109,81,
4,"BACAU",47,24338,,334,0,"Sat.Campeni/Com.Parjol","PARJOL",62,24338,0,3,659,401,337,64,398,3,720,319,254,144,
4,"BACAU",47,24338,,335,0,"Sat.Tarita/Com.Parjol","PARJOL",62,24338,0,3,834,544,463,81,538,6,920,376,338,200,
4,"BACAU",47,24338,,336,0,"Sat.Pustiana/Com.Parjol","PARJOL",62,24338,0,3,1619,1000,875,125,989,11,1800,800,650,339,
4,"BACAU",47,24338,,337,0,"Sat.Bahnaseni/Com.Parjol","PARJOL",62,24338,0,3,712,418,350,68,413,5,780,362,304,109,
4,"BACAU",47,24338,,338,0,"Sat.Barnesti/Com.Parjol","PARJOL",62,24338,0,3,169,176,94,82,175,1,195,19,132,43,
4,"BACAU",47,24427,,339,0,"Sat.Plopana/Com.Plopana","PLOPANA",63,24427,0,3,1281,735,627,108,721,14,1392,657,550,171,
4,"BACAU",47,24427,,340,0,"Sat.Rusenii Razesi/Com.Plopana","PLOPANA",63,24427,0,3,1362,845,756,89,833,12,1497,652,601,232,
4,"BACAU",47,24631,,341,0,"Sat.Poduri/Com.Poduri","PODURI",65,24631,0,3,2168,1281,1020,261,1271,10,2203,922,808,463,
4,"BACAU",47,24631,,342,0,"Sat.Valea Sosii/Com.Poduri","PODURI",65,24631,0,3,794,620,417,203,614,6,900,280,456,158,
4,"BACAU",47,24631,,343,0,"Sat.Prohozesti/Com.Poduri","PODURI",65,24631,0,3,739,767,459,308,762,5,1000,233,480,282,
4,"BACAU",47,24631,,344,0,"Sat.Bucsesti/Com.Poduri","PODURI",65,24631,0,3,1191,892,685,207,882,7,1100,208,523,359,
4,"BACAU",47,24631,,345,0,"Sat.Cernu/Com.Poduri","PODURI",65,24631,0,3,937,825,586,239,817,8,1100,275,610,207,
4,"BACAU",47,24524,,346,0,"Sat.Podu Turcului/Com.Podu Turcului","PODU TURCULUI",64,24524,0,3,2208,1401,1230,171,1388,13,2394,993,962,426,
4,"BACAU",47,24524,,347,0,"Sat.Cabesti/Com.Podu Turcului","PODU TURCULUI",64,24524,0,3,848,578,441,137,574,4,909,331,418,156,
4,"BACAU",47,24524,,348,0,"Sat.Lehancea/Com.Podu Turcului","PODU TURCULUI",64,24524,0,3,580,385,306,79,380,5,657,272,220,160,
4,"BACAU",47,24524,,349,0,"Sat.Sarbi/Com.Podu Turcului","PODU TURCULUI",64,24524,0,3,437,297,251,46,292,5,525,228,195,97,
4,"BACAU",47,24711,,350,0,"Sat.Racova/Com.Racova","RACOVA",68,24711,0,3,1669,1080,908,172,1067,13,1800,720,755,312,
4,"BACAU",47,24711,,351,0,"Sat.Gura Vaii/Com.Racova","RACOVA",68,24711,0,3,929,641,496,145,636,5,1000,359,454,182,
4,"BACAU",47,24766,,352,0,"Sat.Racaciuni/Com.Racaciuni","RACACIUNI",66,24766,0,3,2177,1567,1297,270,1547,20,2420,853,1152,395,
4,"BACAU",47,24766,,353,0,"Sat.Gheorghe Doja/Com.Racaciuni","RACACIUNI",66,24766,0,3,810,634,539,95,621,13,889,255,481,140,
4,"BACAU",47,24766,,354,0,"Sat.Gasteni/Com.Racaciuni","RACACIUNI",66,24766,0,3,573,454,356,98,453,1,630,176,317,136,
4,"BACAU",47,24766,,355,0,"Sat.Fundu Racaciuni/Com.Racaciuni","RACACIUNI",66,24766,0,3,1785,1218,1097,121,1103,115,1960,742,886,217,
4,"BACAU",47,24837,,356,0,"Sat.Rachitoasa/Com.Rachitoasa","RACHITOASA",67,24837,0,3,1516,911,760,151,894,17,1600,689,688,206,
4,"BACAU",47,24837,,357,0,"Sat.Dumbrava/Com.Rachitoasa","RACHITOASA",67,24837,0,3,534,301,263,38,297,4,550,249,247,50,
4,"BACAU",47,24837,,358,0,"Sat.Burdusaci/Com.Rachitoasa","RACHITOASA",67,24837,0,3,774,521,394,127,516,5,800,279,359,157,
4,"BACAU",47,24837,,359,0,"Sat.Buda/Com.Rachitoasa","RACHITOASA",67,24837,0,3,990,592,475,117,585,7,1100,508,479,106,
4,"BACAU",47,24999,,360,0,"Sat.Rosiori/Com.Rosiori","ROSIORI",69,24999,0,3,882,552,465,87,545,7,1000,448,430,115,
4,"BACAU",47,24999,,361,0,"Sat.Poieni/Com.Rosiori","ROSIORI",69,24999,0,3,271,205,154,51,203,2,300,95,165,38,
4,"BACAU",47,24999,,362,0,"Sat.Valea Mare/Com.Rosiori","ROSIORI",69,24999,0,3,375,274,210,64,271,3,400,126,200,71,
4,"BACAU",47,25068,,363,0,"Sat.Sascut/Com.Sascut","SASCUT",71,25068,0,3,2108,2065,1535,530,2029,36,2300,235,1404,625,
4,"BACAU",47,25068,,364,0,"Sat.Sascut-Sat/Com.Sascut","SASCUT",71,25068,0,3,2027,1791,1535,256,1767,19,2200,409,1256,511,
4,"BACAU",47,25068,,365,0,"Sat.Pancesti/Com.Sascut","SASCUT",71,25068,0,3,1120,1046,839,207,1026,20,1300,254,712,314,
4,"BACAU",47,25068,,366,0,"Sat.Pancesti/Com.Sascut","SASCUT",71,25068,0,3,1381,936,655,281,914,22,1500,564,676,238,
4,"BACAU",47,25068,,367,0,"Sat.Contesti/Com.Sascut","SASCUT",71,25068,0,3,419,464,307,157,458,6,484,20,375,83,
4,"BACAU",47,25068,,368,0,"Sat.Beresti/Com.Sascut","SASCUT",71,25068,0,3,1144,1071,994,77,1056,15,1300,229,698,358,
4,"BACAU",47,25148,,369,0,"Sat.Sanduleni/Com.Sanduleni","SANDULENI",70,25148,0,3,1306,820,738,82,811,9,1478,658,655,156,
4,"BACAU",47,25148,,370,0,"Sat.Versesti/Com.Sanduleni","SANDULENI",70,25148,0,3,728,507,452,55,505,2,801,294,417,88,
4,"BACAU",47,25148,,371,0,"Sat.Coman/Com.Sanduleni","SANDULENI",70,25148,0,3,929,568,519,49,563,5,906,338,481,82,
4,"BACAU",47,25148,,372,0,"Sat.Stufu/Com.Sanduleni","SANDULENI",70,25148,0,3,305,195,163,32,195,0,393,198,140,55,
4,"BACAU",47,25228,,373,0,"Sat.Saucesti/Com.Saucesti","SAUCESTI",72,25228,0,3,1998,1098,892,206,1079,19,2001,903,742,337,
4,"BACAU",47,25228,,374,0,"Sat.Siretu/Com.Saucesti","SAUCESTI",72,25228,0,3,793,544,392,152,533,11,1000,456,381,152,
4,"BACAU",47,25291,,375,0,"Sat.Scorteni/Com.Scorteni","SCORTENI",73,25291,0,3,1782,980,862,118,963,17,1900,920,590,373,
4,"BACAU",47,25291,,376,0,"Sat.Grigoreni/Com.Scorteni","SCORTENI",73,25291,0,3,682,556,402,154,548,8,793,237,382,166,
4,"BACAU",47,25362,,377,0,"Sat.Secuieni/Com.Secuieni","SECUIENI",74,25362,0,3,1009,644,535,109,636,8,1009,365,480,156,
4,"BACAU",47,25362,,378,0,"Sat.Berbinceni/Com.Secuieni","SECUIENI",74,25362,0,3,451,336,244,92,327,9,471,135,264,63,
4,"BACAU",47,25362,,379,0,"Sat.Odobesti/Com.Secuieni","SECUIENI",74,25362,0,3,1129,742,570,172,723,19,1175,433,599,124,
4,"BACAU",47,25362,,380,0,"Sat.Ciuturesti/Com.Secuieni","SECUIENI",74,25362,0,3,599,404,345,59,394,10,645,241,305,89,
4,"BACAU",47,25488,,381,0,"Sat.Solont/Com.Solont","SOLONT",75,25488,0,3,1306,899,747,152,893,5,1400,501,632,261,
4,"BACAU",47,25488,,382,0,"Sat.Sarata/Com.Solont","SOLONT",75,25488,0,3,679,428,367,61,425,3,708,280,293,132,
4,"BACAU",47,25488,,383,0,"Sat.Cucuieti/Com.Solont","SOLONT",75,25488,0,3,1116,676,623,53,668,8,1200,524,393,275,
4,"BACAU",47,25521,,384,0,"Sat.Stanisesti/Com.Stanisesti","STANISESTI",76,25521,0,3,957,553,435,118,540,13,1050,497,355,185,
4,"BACAU",47,25521,,385,0,"Sat.Benesti/Com.Stanisesti","STANISESTI",76,25521,0,3,408,251,207,44,246,5,450,199,144,102,
4,"BACAU",47,25521,,386,0,"Sat.Craiesti/Com.Stanisesti","STANISESTI",76,25521,0,3,434,409,321,88,404,5,500,91,311,93,
4,"BACAU",47,25521,,387,0,"Sat.Slobozia/Com.Stanisesti","STANISESTI",76,25521,0,3,1328,837,721,116,825,12,1400,563,660,165,
4,"BACAU",47,25521,,388,0,"Sat.Slobozia Noua/Com.Stanisesti","STANISESTI",76,25521,0,3,431,297,245,52,290,7,500,203,247,43,
4,"BACAU",47,25629,,389,0,"Sat.Strugari/Com.Strugari","STRUGARI",78,25629,0,3,1175,807,714,93,800,7,1200,393,585,215,
4,"BACAU",47,25629,,390,0,"Sat.Rachitisu/Com.Strugari","STRUGARI",78,25629,0,3,383,252,224,28,246,6,400,148,169,77,
4,"BACAU",47,25629,,391,0,"Sat.Petricica/Com.Strugari","STRUGARI",78,25629,0,3,541,524,414,110,522,2,600,76,432,90,
4,"BACAU",47,20670,,392,0,"Sat.Stefan cel Mare/Com.Stefan cel Mare","STEFAN CEL MARE",77,20670,0,3,645,429,338,91,418,11,693,264,282,136,
4,"BACAU",47,20670,,393,0,"Sat.Bogdana/Com.Stefan cel Mare","STEFAN CEL MARE",77,20670,0,3,517,390,310,80,381,9,579,189,236,145,
4,"BACAU",47,20670,,394,0,"Sat.Viisoara/Com.Stefan cel Mare","STEFAN CEL MARE",77,20670,0,3,483,376,283,93,374,2,582,206,244,130,
4,"BACAU",47,20670,,395,0,"Sat.Negoiesti/Com.Stefan cel Mare","STEFAN CEL MARE",77,20670,0,3,679,450,352,98,447,3,750,300,298,149,
4,"BACAU",47,20670,,396,0,"Sat.Radeana/Com.Stefan cel Mare","STEFAN CEL MARE",77,20670,0,3,498,411,295,116,406,5,580,169,290,116,
4,"BACAU",47,20670,,397,0,"Sat.Gutinas/Com.Stefan cel Mare","STEFAN CEL MARE",77,20670,0,3,457,316,239,77,313,3,500,184,227,86,
4,"BACAU",47,20670,,398,0,"Sat.Racauti/Com.Stefan cel Mare","STEFAN CEL MARE",77,20670,0,3,810,600,460,140,596,4,893,293,509,87,
4,"BACAU",47,20670,,399,0,"Sat.Buciumi/Com.Stefan cel Mare","STEFAN CEL MARE",77,20670,0,3,607,735,607,128,724,11,1308,573,470,254,
4,"BACAU",47,25692,,400,0,"Sat.Tamasi/Com.Tamasi","TAMASI",79,25692,0,3,1949,1241,1075,166,1220,21,2100,859,889,331,
4,"BACAU",47,25692,,401,0,"Sat.Gioseni/Com.Tamasi","TAMASI",79,25692,0,3,2516,1518,1355,163,1480,36,2801,1283,1097,383,
4,"BACAU",47,25745,,402,0,"Sat.Tatarasti/Com.Tatarasti","TATARASTI",81,25745,0,3,639,445,398,47,424,21,750,305,343,81,
4,"BACAU",47,25745,,403,0,"Sat.Cornii de Sus/Com.Tatarasti","TATARASTI",81,25745,0,3,839,660,586,74,654,6,900,240,430,224,
4,"BACAU",47,25745,,404,0,"Sat.Gherdana/Com.Tatarasti","TATARASTI",81,25745,0,3,684,565,508,57,543,22,750,185,350,193,
4,"BACAU",47,25825,,405,0,"Sat.Targu Trotus/Com.Targu Trotus","TARGU TROTUS",80,25825,0,3,1582,1018,916,102,993,25,1734,716,753,240,
4,"BACAU",47,25825,,406,0,"Sat.Tuta/Com.Targu Trotus","TARGU TROTUS",80,25825,0,3,1501,1011,969,42,997,14,1627,616,844,153,
4,"BACAU",47,25825,,407,0,"Sat.Viisoara/Com.Targu Trotus","TARGU TROTUS",80,25825,0,3,927,667,591,76,663,4,1032,365,356,307,
4,"BACAU",47,25861,,408,0,"Sat.Traian/Com.Traian","TRAIAN",82,25861,0,3,1679,818,622,196,797,21,1776,958,519,278,
4,"BACAU",47,25861,,409,0,"Sat.Prajesti/Com.Traian","TRAIAN",82,25861,0,3,2040,960,792,168,932,28,2240,1280,564,368,
4,"BACAU",47,25861,,410,0,"Sat.Bogdanesti/Com.Traian","TRAIAN",82,25861,0,3,455,238,181,57,230,8,580,342,131,99,
4,"BACAU",47,25932,,411,0,"Sat.Ungureni/Com.Ungureni","UNGURENI",83,25932,0,3,765,532,456,76,522,10,815,283,396,126,
4,"BACAU",47,25932,,412,0,"Sat.Viforeni/Com.Ungureni","UNGURENI",83,25932,0,3,576,392,323,69,388,4,626,234,273,115,
4,"BACAU",47,25932,,413,0,"Sat.Botesti/Com.Ungureni","UNGURENI",83,25932,0,3,592,376,315,61,368,8,640,264,235,133,
4,"BACAU",47,25932,,414,0,"Sat.Bibiresti/Com.Ungureni","UNGURENI",83,25932,0,3,665,533,443,90,521,12,717,184,345,176,
4,"BACAU",47,26029,,415,0,"Sat.Urechesti/Com.Urechesti","URECHESTI",84,26029,0,3,1835,1082,941,141,1062,17,1978,896,651,411,
4,"BACAU",47,26029,,416,0,"Sat.Cornatel/Com.Urechesti","URECHESTI",84,26029,0,3,1244,882,717,165,872,10,1301,419,678,194,
4,"BACAU",47,26083,,417,0,"Sat.Valea Seaca/Com.Valea Seaca","VALEA SEACA",85,26083,0,3,752,529,340,189,521,8,800,271,390,131,
4,"BACAU",47,26083,,418,0,"Sat.Valea Seaca/Com.Valea Seaca","VALEA SEACA",85,26083,0,3,583,450,349,101,446,4,685,235,321,125,
4,"BACAU",47,26083,,419,0,"Sat.Valea Seaca/Com.Valea Seaca","VALEA SEACA",85,26083,0,3,859,583,471,112,560,23,900,317,449,111,
4,"BACAU",47,26083,,420,0,"Sat.Cucova/Com.Valea Seaca","VALEA SEACA",85,26083,0,3,529,462,325,137,455,5,500,38,325,130,
4,"BACAU",47,26118,,421,0,"Sat.Vultureni/Com.Vultureni","VULTURENI",86,26118,0,3,404,267,222,45,265,2,457,190,185,80,
4,"BACAU",47,26118,,422,0,"Sat.Lichitiseni/Com.Vultureni","VULTURENI",86,26118,0,3,548,289,262,27,286,3,599,310,232,54,
4,"BACAU",47,26118,,423,0,"Sat.Godinestii de Jos/Com.Vultureni","VULTURENI",86,26118,0,3,593,370,314,56,351,19,647,277,243,108,
4,"BACAU",47,26118,,424,0,"Sat.Ghilavesti/Com.Vultureni","VULTURENI",86,26118,0,3,264,159,121,38,157,2,295,136,136,21,
4,"BACAU",47,26289,,425,0,"Sat.Zemes/Com.Zemes","ZEMES",87,26289,0,3,925,650,538,112,648,2,1000,350,451,197,
4,"BACAU",47,26289,,426,0,"Sat.Zemes/Com.Zemes","ZEMES",87,26289,0,3,1876,1419,1228,191,1387,20,2000,581,1028,359,
4,"BACAU",47,26289,,427,0,"Sat.Bolatau/Com.Zemes","ZEMES",87,26289,0,3,740,539,462,77,535,4,900,361,368,167,
5,"BIHOR",56,26564,,1,0,"CALUGARENI 4/A - A","MUNICIPIUL ORADEA",1,26564,1,1,945,480,382,98,472,8,1044,564,326,146,
5,"BIHOR",56,26564,,2,0,"CALUGARENI 4/A - B","MUNICIPIUL ORADEA",1,26564,1,1,981,463,432,31,454,9,1080,617,337,117,
5,"BIHOR",56,26564,,3,0,"CALUGARENI 8/A - A","MUNICIPIUL ORADEA",1,26564,1,1,1622,636,590,46,627,9,1780,1144,433,194,
5,"BIHOR",56,26564,,4,0,"CALUGARENI 8/A - B","MUNICIPIUL ORADEA",1,26564,1,1,1660,716,673,43,716,0,1810,1094,504,212,
5,"BIHOR",56,26564,,5,0,"CALUGARENI 4 - A","MUNICIPIUL ORADEA",1,26564,1,1,1218,642,562,80,635,7,1364,722,476,159,
5,"BIHOR",56,26564,,6,0,"CALUGARENI 4 - B","MUNICIPIUL ORADEA",1,26564,1,1,1084,566,528,38,564,2,1190,624,446,118,
5,"BIHOR",56,26564,,7,0,"MIHAIL SADOVEANU 10 - A","MUNICIPIUL ORADEA",1,26564,1,1,794,406,354,52,400,6,871,465,268,132,
5,"BIHOR",56,26564,,8,0,"MIHAIL SADOVEANU 10 - B","MUNICIPIUL ORADEA",1,26564,1,1,1485,645,588,57,639,6,1690,1045,418,221,
5,"BIHOR",56,26564,,9,0,"ALEEA POSADA 1 - A","MUNICIPIUL ORADEA",1,26564,1,1,1961,954,890,64,936,18,2150,1196,700,236,
5,"BIHOR",56,26564,,10,0,"TRANSILVANIEI 21","MUNICIPIUL ORADEA",1,26564,1,1,1935,1033,955,78,1020,13,2130,1097,770,250,
5,"BIHOR",56,26564,,11,0,"ALEEA POSADA 20 - A","MUNICIPIUL ORADEA",1,26564,1,1,795,338,288,50,334,4,923,585,177,157,
5,"BIHOR",56,26564,,12,0,"ALEEA POSADA 20 - B","MUNICIPIUL ORADEA",1,26564,1,1,704,361,332,29,358,3,681,320,263,95,
5,"BIHOR",56,26564,,13,0,"ALEEA POSADA 1 - B","MUNICIPIUL ORADEA",1,26564,1,1,920,531,391,140,527,4,10101,479,290,237,
5,"BIHOR",56,26564,,14,0,"ALEEA POSADA 1 - C","MUNICIPIUL ORADEA",1,26564,1,1,1443,716,684,32,711,5,1590,874,529,182,
5,"BIHOR",56,26564,,15,0,"ALUMINEI 88 - A/A","MUNICIPIUL ORADEA",1,26564,1,1,980,472,413,59,467,5,1080,608,376,91,
5,"BIHOR",56,26564,,16,0,"ALUMINEI 88 - A/B","MUNICIPIUL ORADEA",1,26564,1,1,901,446,415,31,441,5,1009,563,328,113,
5,"BIHOR",56,26564,,17,0,"BUL. DACIA 110 - A","MUNICIPIUL ORADEA",1,26564,1,1,1149,633,593,40,623,10,1260,627,448,175,
5,"BIHOR",56,26564,,18,0,"BUL. DACIA 110 - B","MUNICIPIUL ORADEA",1,26564,1,1,1172,589,547,42,585,4,1290,701,428,157,
5,"BIHOR",56,26564,,19,0,"ALUMINEI 88 - B/A","MUNICIPIUL ORADEA",1,26564,1,1,1570,747,714,33,738,9,1720,973,509,229,
5,"BIHOR",56,26564,,20,0,"ALUMINEI 88 - B/B","MUNICIPIUL ORADEA",1,26564,1,1,1452,760,730,30,743,17,1600,840,591,152,
5,"BIHOR",56,26564,,21,0,"NICOLAE GANE 1 - A","MUNICIPIUL ORADEA",1,26564,1,1,1484,841,779,62,833,8,1879,1038,569,264,
5,"BIHOR",56,26564,,22,0,"NICOLAE GANE 1 - B","MUNICIPIUL ORADEA",1,26564,1,1,1178,562,512,50,554,8,1315,753,377,177,
5,"BIHOR",56,26564,,23,0,"NICOLAE GANE 1 - C","MUNICIPIUL ORADEA",1,26564,1,1,1636,884,846,38,873,11,1800,916,695,178,
5,"BIHOR",56,26564,,24,0,"SOVATA 23 SALA CLUB","MUNICIPIUL ORADEA",1,26564,1,1,2131,1058,926,132,1054,4,2160,1102,707,347,
5,"BIHOR",56,26564,,25,0,"ALUMINEI 37/A","MUNICIPIUL ORADEA",1,26564,1,1,1975,1078,989,89,1061,17,2180,1102,702,359,
5,"BIHOR",56,26564,,26,0,"ALUMINEI 100/A - A","MUNICIPIUL ORADEA",1,26564,1,1,1663,851,804,47,840,11,1834,983,625,215,
5,"BIHOR",56,26564,,27,0,"ALUMINEI 100/A - B","MUNICIPIUL ORADEA",1,26564,1,1,1851,920,885,35,907,13,2040,1120,651,256,
5,"BIHOR",56,26564,,28,0,"MENUMORUT 33 - A","MUNICIPIUL ORADEA",1,26564,1,1,1458,784,724,60,778,6,1610,826,550,228,
5,"BIHOR",56,26564,,29,0,"MENUMORUT 33 - B","MUNICIPIUL ORADEA",1,26564,1,1,1622,879,808,71,870,9,1790,911,637,233,
5,"BIHOR",56,26564,,30,0,"ORSOVEI 5","MUNICIPIUL ORADEA",1,26564,1,1,1763,916,865,51,901,15,1940,1024,683,218,
5,"BIHOR",56,26564,,31,0,"BUL. DACIA 25 - A","MUNICIPIUL ORADEA",1,26564,1,1,2141,1011,934,77,1008,3,2350,1339,713,295,
5,"BIHOR",56,26564,,32,0,"BUL. DACIA 25 - B","MUNICIPIUL ORADEA",1,26564,1,1,2047,990,950,40,977,13,2250,1260,694,283,
5,"BIHOR",56,26564,,33,0,"BUL. STEFAN CEL MARE 28","MUNICIPIUL ORADEA",1,26564,1,1,1921,878,838,40,874,4,2078,1200,606,268,
5,"BIHOR",56,26564,,34,0,"BUL. STEFAN CEL MARE 28","MUNICIPIUL ORADEA",1,26564,1,1,1508,623,572,51,616,7,1660,1037,438,178,
5,"BIHOR",56,26564,,35,0,"TRAIAN LALESCU 1","MUNICIPIUL ORADEA",1,26564,1,1,1478,631,593,38,620,11,1630,999,443,177,
5,"BIHOR",56,26564,,36,0,"CORNELIU COPOSU 14 - ARSMED","MUNICIPIUL ORADEA",1,26564,1,1,1438,692,635,57,682,10,1590,898,493,189,
5,"BIHOR",56,26564,,37,0,"CORNELIU COPOSU 14 - CABINETE MEDICALE INDIVIDUALE","MUNICIPIUL ORADEA",1,26564,1,1,1817,826,778,48,823,3,1990,1164,591,232,
5,"BIHOR",56,26564,,38,0,"CORNELIU COPOSU 12 - POLICLINICA COPII 2","MUNICIPIUL ORADEA",1,26564,1,1,1124,511,463,48,508,3,1240,729,381,127,
5,"BIHOR",56,26564,,39,0,"CORNELIU COPOSU 12 - SPITAL CLINIC COPII","MUNICIPIUL ORADEA",1,26564,1,1,1790,929,788,141,918,11,1970,1041,675,243,
5,"BIHOR",56,26564,,40,0,"MOLDOVEI 55 - A VECHE","MUNICIPIUL ORADEA",1,26564,1,1,1441,667,613,54,666,1,1582,915,434,232,
5,"BIHOR",56,26564,,41,0,"MOLDOVEI 55 - B VECHE","MUNICIPIUL ORADEA",1,26564,1,1,1102,539,468,71,531,8,1412,873,389,142,
5,"BIHOR",56,26564,,42,0,"CANTACUZINO 68","MUNICIPIUL ORADEA",1,26564,1,1,2060,835,779,56,833,2,2060,1225,531,302,
5,"BIHOR",56,26564,,43,0,"MOLDOVEI 55 - A NOUA","MUNICIPIUL ORADEA",1,26564,1,1,1948,1011,914,97,991,20,2140,1129,654,337,
5,"BIHOR",56,26564,,44,0,"MOLDOVEI 55 - B NOUA","MUNICIPIUL ORADEA",1,26564,1,1,1769,877,801,76,873,4,1940,1063,582,291,
5,"BIHOR",56,26564,,45,0,"COSMINULUI 1 - A","MUNICIPIUL ORADEA",1,26564,1,1,1263,636,568,68,630,6,1380,744,400,230,
5,"BIHOR",56,26564,,46,0,"COSMINULUI 1 - A","MUNICIPIUL ORADEA",1,26564,1,1,1928,882,828,54,878,4,2130,1248,543,335,
5,"BIHOR",56,26564,,47,0,"COSMINULUI 1 - B","MUNICIPIUL ORADEA",1,26564,1,1,1169,608,578,30,605,3,1196,588,373,232,
5,"BIHOR",56,26564,,48,0,"MATEI CORVIN 231","MUNICIPIUL ORADEA",1,26564,1,1,1417,607,547,60,594,13,1550,943,520,74,
5,"BIHOR",56,26564,,49,0,"MATEI CORVIN 106","MUNICIPIUL ORADEA",1,26564,1,1,1628,694,633,61,689,5,1790,1096,612,77,
5,"BIHOR",56,26564,,50,0,"ION BOGDAN 20 - A","MUNICIPIUL ORADEA",1,26564,1,1,1028,466,434,32,462,4,1120,654,284,178,
5,"BIHOR",56,26564,,51,0,"ION BOGDAN 20 - B","MUNICIPIUL ORADEA",1,26564,1,1,1188,508,486,22,502,6,1300,792,308,194,
5,"BIHOR",56,26564,,52,0,"CALIMANESTILOR 10 - A","MUNICIPIUL ORADEA",1,26564,1,1,1025,548,475,73,539,9,1132,584,368,171,
5,"BIHOR",56,26564,,53,0,"CALIMANESTILOR 10 - B","MUNICIPIUL ORADEA",1,26564,1,1,1041,550,512,38,537,13,1148,598,387,150,
5,"BIHOR",56,26564,,54,0,"LOUIS PASTEUR 30","MUNICIPIUL ORADEA",1,26564,1,1,1088,736,504,232,732,4,1200,464,557,175,
5,"BIHOR",56,26564,,55,0,"LOUIS PASTEUR 44","MUNICIPIUL ORADEA",1,26564,1,1,1132,579,515,64,576,3,1247,668,445,131,
5,"BIHOR",56,26564,,56,0,"ALEEA STRANDULUI 18","MUNICIPIUL ORADEA",1,26564,1,1,1513,687,563,124,676,11,1650,963,447,229,
5,"BIHOR",56,26564,,57,0,"BARBU STEFANESCU DELAVRANCEA 4 - A","MUNICIPIUL ORADEA",1,26564,1,1,916,525,467,58,520,5,1010,485,433,87,
5,"BIHOR",56,26564,,58,0,"BARBU STEFANESCU DELAVRANCEA 4 - B","MUNICIPIUL ORADEA",1,26564,1,1,1121,659,612,47,650,9,1214,555,508,142,
5,"BIHOR",56,26564,,59,0,"PARCUL PETOFI 26","MUNICIPIUL ORADEA",1,26564,1,1,1365,909,655,254,900,9,2100,1191,695,205,
5,"BIHOR",56,26564,,60,0,"MUZEULUI 2","MUNICIPIUL ORADEA",1,26564,1,1,1602,879,794,85,873,6,1760,881,678,195,
5,"BIHOR",56,26564,,61,0,"ADY ENDRE 63","MUNICIPIUL ORADEA",1,26564,1,1,1653,773,701,72,765,8,1820,1047,587,178,
5,"BIHOR",56,26564,,62,0,"MIHAI EMINESCU 28 - A","MUNICIPIUL ORADEA",1,26564,1,1,844,542,414,128,536,6,928,386,432,104,
5,"BIHOR",56,26564,,63,0,"MIHAI EMINESCU 28 - B","MUNICIPIUL ORADEA",1,26564,1,1,756,416,374,42,412,4,833,417,364,48,
5,"BIHOR",56,26564,,64,0,"MOSCOVEI 1 - A","MUNICIPIUL ORADEA",1,26564,1,1,805,443,385,58,433,10,892,449,362,71,
5,"BIHOR",56,26564,,65,0,"MOSCOVEI 1 - B","MUNICIPIUL ORADEA",1,26564,1,1,876,513,427,86,502,11,940,427,377,125,
5,"BIHOR",56,26564,,66,0,"ANDREI SAGUNA 1 - A","MUNICIPIUL ORADEA",1,26564,1,1,934,818,441,377,803,15,1470,652,620,183,
5,"BIHOR",56,26564,,67,0,"ANDREI SAGUNA 1 - B","MUNICIPIUL ORADEA",1,26564,1,1,1111,733,592,141,719,14,1210,477,557,162,
5,"BIHOR",56,26564,,68,0,"PARCUL 1 DECEMBRIE - A","MUNICIPIUL ORADEA",1,26564,1,1,1520,803,759,44,794,0,1680,877,616,178,
5,"BIHOR",56,26564,,69,0,"PARCUL 1 DECEMBRIE - B","MUNICIPIUL ORADEA",1,26564,1,1,1145,711,600,111,699,12,1260,549,546,153,
5,"BIHOR",56,26564,,70,0,"AVRAM IANCU 10","MUNICIPIUL ORADEA",1,26564,1,1,1054,570,454,116,561,9,1156,586,418,143,
5,"BIHOR",56,26564,,71,0,"MIHAI VITEAZUL 3","MUNICIPIUL ORADEA",1,26564,1,1,1147,583,546,37,577,6,1452,869,454,123,
5,"BIHOR",56,26564,,72,0,"GRIVITEI 2","MUNICIPIUL ORADEA",1,26564,1,1,1328,606,543,63,592,14,1470,864,476,116,
5,"BIHOR",56,26564,,73,0,"CALEA CLUJULUI 66 - A","MUNICIPIUL ORADEA",1,26564,1,1,1212,571,440,131,567,4,1329,758,394,173,
5,"BIHOR",56,26564,,74,0,"CALEA CLUJULUI 66 - B","MUNICIPIUL ORADEA",1,26564,1,1,1129,521,449,72,513,8,1250,729,373,140,
5,"BIHOR",56,26564,,75,0,"CALEA CLUJULUI 106 - A","MUNICIPIUL ORADEA",1,26564,1,1,1459,576,502,74,575,1,1610,1034,320,255,
5,"BIHOR",56,26564,,76,0,"CALEA CLUJULUI 106 - B","MUNICIPIUL ORADEA",1,26564,1,1,861,436,381,55,433,3,950,514,270,163,
5,"BIHOR",56,26564,,77,0,"CALEA CLUJULUI 188 - A","MUNICIPIUL ORADEA",1,26564,1,1,1780,888,814,74,875,13,1950,1062,498,377,
5,"BIHOR",56,26564,,78,0,"CALEA CLUJULUI 188 - B","MUNICIPIUL ORADEA",1,26564,1,1,1565,810,730,80,797,13,1710,900,584,213,
5,"BIHOR",56,26564,,79,0,"CALEA CLUJULUI 229","MUNICIPIUL ORADEA",1,26564,1,1,1353,791,704,87,784,7,1580,789,434,350,
5,"BIHOR",56,26564,,80,0,"RAMPEI 2 - A","MUNICIPIUL ORADEA",1,26564,1,1,1758,859,778,81,850,9,1930,1071,545,305,
5,"BIHOR",56,26564,,81,0,"RAMPEI 1","MUNICIPIUL ORADEA",1,26564,1,1,1826,831,756,75,827,4,2010,1179,511,316,
5,"BIHOR",56,26564,,82,0,"ZALAULUI 11","MUNICIPIUL ORADEA",1,26564,1,1,1751,722,678,44,716,6,1930,1208,523,193,
5,"BIHOR",56,26564,,83,0,"DIMITRIE CANTEMIR 32","MUNICIPIUL ORADEA",1,26564,1,1,1818,947,872,75,935,12,2000,1053,680,255,
5,"BIHOR",56,26564,,84,0,"DIMITRIE CANTEMIR 84","MUNICIPIUL ORADEA",1,26564,1,1,1449,830,758,72,822,8,1589,759,624,198,
5,"BIHOR",56,26564,,85,0,"NUCETULUI 3","MUNICIPIUL ORADEA",1,26564,1,1,1755,810,773,37,796,14,1930,1120,503,293,
5,"BIHOR",56,26564,,86,0,"IALOMITEI 3 BL.AN7,SC.C - A","MUNICIPIUL ORADEA",1,26564,1,1,1631,931,794,137,920,11,1790,859,547,373,
5,"BIHOR",56,26564,,87,0,"ONISIFOR GHIBU 3 - A NOUA","MUNICIPIUL ORADEA",1,26564,1,1,1750,818,752,66,808,10,1930,1112,484,324,
5,"BIHOR",56,26564,,88,0,"ONISIFOR GHIBU 3 - B NOUA","MUNICIPIUL ORADEA",1,26564,1,1,1748,692,639,53,689,3,1890,1198,440,249,
5,"BIHOR",56,26564,,89,0,"ONISIFOR GHIBU 16 - A","MUNICIPIUL ORADEA",1,26564,1,1,1712,823,761,62,811,12,1880,1057,526,285,
5,"BIHOR",56,26564,,90,0,"ONISIFOR GHIBU 16 - B","MUNICIPIUL ORADEA",1,26564,1,1,1597,728,665,63,719,9,1770,1042,460,259,
5,"BIHOR",56,26564,,91,0,"ONISIFOR GHIBU 3 - A VECHE","MUNICIPIUL ORADEA",1,26564,1,1,1229,552,515,37,543,9,1350,798,376,167,
5,"BIHOR",56,26564,,92,0,"ONISIFOR GHIBU 3 - A VECHE","MUNICIPIUL ORADEA",1,26564,1,1,1202,559,534,25,556,3,1334,775,395,161,
5,"BIHOR",56,26564,,93,0,"ONISIFOR GHIBU 3 - A VECHE","MUNICIPIUL ORADEA",1,26564,1,1,1970,933,900,33,923,10,2170,1237,587,336,
5,"BIHOR",56,26564,,94,0,"IALOMITEI 3 BL.AN7,SC.C - B","MUNICIPIUL ORADEA",1,26564,1,1,1187,604,563,41,602,2,1300,696,364,238,
5,"BIHOR",56,26564,,95,0,"BUMBACULUI 22 - A","MUNICIPIUL ORADEA",1,26564,1,1,1087,568,490,78,565,3,1190,622,360,205,
5,"BIHOR",56,26564,,96,0,"BUMBACULUI 22 - B","MUNICIPIUL ORADEA",1,26564,1,1,1413,696,659,37,688,8,1540,844,503,185,
5,"BIHOR",56,26564,,97,0,"ONISIFOR GHIBU 3 - A VECHE","MUNICIPIUL ORADEA",1,26564,1,1,1717,848,780,68,842,6,1890,1042,532,310,
5,"BIHOR",56,26564,,98,0,"ONISIFOR GHIBU 3 - B VECHE","MUNICIPIUL ORADEA",1,26564,1,1,1907,878,828,50,874,4,2100,1222,534,340,
5,"BIHOR",56,26564,,99,0,"SEXTIL PUSCARIU 2 - A","MUNICIPIUL ORADEA",1,26564,1,1,1200,672,547,125,664,8,1299,627,445,219,
5,"BIHOR",56,26564,,100,0,"SEXTIL PUSCARIU 2 - B","MUNICIPIUL ORADEA",1,26564,1,1,1455,681,651,30,679,2,1600,919,452,227,
5,"BIHOR",56,26564,,101,0,"FELDIOAREI 17 - A","MUNICIPIUL ORADEA",1,26564,1,1,1424,663,632,31,660,3,1503,840,469,191,
5,"BIHOR",56,26564,,102,0,"FELDIOAREI 17 - B","MUNICIPIUL ORADEA",1,26564,1,1,1280,540,517,23,533,7,1400,860,355,178,
5,"BIHOR",56,26564,,103,0,"DIMITRIE CANTEMIR 9-11 PARTER","MUNICIPIUL ORADEA",1,26564,1,1,1574,831,775,56,820,11,1740,909,647,173,
5,"BIHOR",56,26564,,104,0,"EROU MARIUS COSMA 8 - A","MUNICIPIUL ORADEA",1,26564,1,1,868,637,438,199,628,9,949,312,443,185,
5,"BIHOR",56,26564,,105,0,"EROU MARIUS COSMA 8 - B","MUNICIPIUL ORADEA",1,26564,1,1,985,510,439,71,498,12,1071,561,375,123,
5,"BIHOR",56,26564,,106,0,"IULIU MANIU 5 - A","MUNICIPIUL ORADEA",1,26564,1,1,1072,485,418,67,479,6,1180,695,373,106,
5,"BIHOR",56,26564,,107,0,"IULIU MANIU 5 - B","MUNICIPIUL ORADEA",1,26564,1,1,987,417,386,31,410,7,1080,663,303,107,
5,"BIHOR",56,26564,,108,0,"JEAN CALVIN 3 - A","MUNICIPIUL ORADEA",1,26564,1,1,992,484,443,41,474,10,997,513,395,79,
5,"BIHOR",56,26564,,109,0,"JEAN CALVIN 3 - B","MUNICIPIUL ORADEA",1,26564,1,1,1130,525,467,58,518,7,1240,715,421,97,
5,"BIHOR",56,26564,,110,0,"PIATA CAZARMII 17 - A","MUNICIPIUL ORADEA",1,26564,1,1,1382,644,607,37,641,3,1520,876,504,137,
5,"BIHOR",56,26564,,111,0,"PIATA CAZARMII 7 - B","MUNICIPIUL ORADEA",1,26564,1,1,1529,733,644,89,725,8,1680,947,553,172,
5,"BIHOR",56,26564,,112,0,"BUL. DECEBAL 60 - A","MUNICIPIUL ORADEA",1,26564,1,1,1716,860,758,102,851,9,1880,1020,591,260,
5,"BIHOR",56,26564,,113,0,"BUL. DECEBAL 60 - B","MUNICIPIUL ORADEA",1,26564,1,1,1830,903,823,80,892,11,1990,1087,511,381,
5,"BIHOR",56,26564,,114,0,"WILLIAM SHAKESPEARE 22","MUNICIPIUL ORADEA",1,26564,1,1,1789,1177,958,219,1165,12,1960,783,851,314,
5,"BIHOR",56,26564,,115,0,"CAZABAN 3 - A","MUNICIPIUL ORADEA",1,26564,1,1,1622,976,869,107,975,1,1862,886,624,351,
5,"BIHOR",56,26564,,116,0,"CAZABAN 3 - B","MUNICIPIUL ORADEA",1,26564,1,1,2234,1115,1050,65,1106,9,2460,1345,717,389,
5,"BIHOR",56,26564,,117,0,"CAZABAN - A STRAND TERMAL IOSIA NORD","MUNICIPIUL ORADEA",1,26564,1,1,1526,758,718,40,751,7,1680,922,470,281,
5,"BIHOR",56,26564,,118,0,"CAZABAN - B STRAND TERMAL IOSIA NORD","MUNICIPIUL ORADEA",1,26564,1,1,1580,742,712,30,737,5,1740,998,465,272,
5,"BIHOR",56,26564,,119,0,"IOSIA NORD - A SINTEZA","MUNICIPIUL ORADEA",1,26564,1,1,1743,833,713,120,827,6,1920,1087,456,371,
5,"BIHOR",56,26564,,120,0,"IOSIA NORD - B SINTEZA","MUNICIPIUL ORADEA",1,26564,1,1,1661,835,760,75,831,4,1820,985,486,345,
5,"BIHOR",56,26564,,121,0,"MEZIADULUI 2 - SALA SEDINTE","MUNICIPIUL ORADEA",1,26564,1,1,855,433,391,42,423,10,950,517,259,164,
5,"BIHOR",56,26564,,122,0,"HATEGULUI 32","MUNICIPIUL ORADEA",1,26564,1,1,1257,661,613,48,656,5,1390,729,394,262,
5,"BIHOR",56,26564,,123,0,"GHEORGHE POP DE BASESTI 3-5 - A","MUNICIPIUL ORADEA",1,26564,1,1,1088,605,579,26,599,6,1200,595,402,197,
5,"BIHOR",56,26564,,124,0,"GHEORGHE POP DE BASESTI 3-5 - B","MUNICIPIUL ORADEA",1,26564,1,1,1038,537,509,28,531,6,1167,630,365,166,
5,"BIHOR",56,26564,,125,0,"AVIATORILOR 2 - A","MUNICIPIUL ORADEA",1,26564,1,1,1002,610,532,78,602,8,1100,490,337,265,
5,"BIHOR",56,26564,,126,0,"AVIATORILOR 2 - B","MUNICIPIUL ORADEA",1,26564,1,1,1026,573,526,47,568,5,1130,557,333,235,
5,"BIHOR",56,26564,,127,0,"BUZAULUI 2/A","MUNICIPIUL ORADEA",1,26564,1,1,1438,659,613,46,651,8,1570,911,402,249,
5,"BIHOR",56,26564,,128,0,"PIATA DEVEI - POLICLINICA 6 IOSIA","MUNICIPIUL ORADEA",1,26564,1,1,1200,446,415,31,443,3,1310,864,284,159,
5,"BIHOR",56,26564,,129,0,"ALEXANDRU ROMAN 2","MUNICIPIUL ORADEA",1,26564,1,1,1144,565,524,41,558,7,1296,731,354,204,
5,"BIHOR",56,26564,,130,0,"MARESAL ION ANTONESCU 105","MUNICIPIUL ORADEA",1,26564,1,1,1782,948,868,80,943,5,1947,999,621,322,
5,"BIHOR",56,26564,,131,0,"CARTIER PODGORIA - SCOALA OLTEA DOAMNA","MUNICIPIUL ORADEA",1,26564,1,1,291,160,127,33,158,2,320,160,144,14,
5,"BIHOR",56,26564,,132,1,"ARMATEI ROMANE 5","MUNICIPIUL ORADEA",1,26564,1,1,0,1231,0,1231,1180,51,1500,269,624,556,
5,"BIHOR",56,26699,,133,0,"PRIMARIA ALESD","ORAS ALESD",2,26699,2,1,3036,1754,1569,185,1715,39,3340,1586,1055,660,
5,"BIHOR",56,26699,,134,0,"SCOALA GENERALA ALESD","ORAS ALESD",2,26699,2,1,3027,1357,1210,147,1345,12,3330,1973,657,688,
5,"BIHOR",56,26699,,135,0,"CLUBUL CRISTAPAN ALESD","ORAS ALESD",2,26699,2,1,765,322,293,29,315,7,840,518,223,92,
5,"BIHOR",56,26699,,136,0,"SC. GEN. PESTIS","ORAS ALESD",2,26699,2,1,1124,601,574,27,592,9,1230,629,133,459,
5,"BIHOR",56,26699,,137,0,"CAMIN CULTURAL TINAUD","ORAS ALESD",2,26699,2,1,628,332,308,24,319,13,690,358,132,187,
5,"BIHOR",56,26804,,138,0,"PTA SAMUIL VULCAN 15 BEIUS","ORAS BEIUS",3,26804,2,1,1963,1040,977,63,1032,8,2160,1120,639,393,
5,"BIHOR",56,26804,,139,0,"ROMANA 6 BEIUS","ORAS BEIUS",3,26804,2,1,1777,1034,913,121,1026,8,1950,916,569,457,
5,"BIHOR",56,26804,,140,0,"IOAN CIORDAS 5","ORAS BEIUS",3,26804,2,1,1215,667,597,70,659,8,1330,663,442,217,
5,"BIHOR",56,26804,,141,0,"CALEA BIHORULUI 14-16 BEIUS","ORAS BEIUS",3,26804,2,1,2003,1112,1039,73,1098,14,2220,1108,647,451,
5,"BIHOR",56,26804,,142,0,"ALEEA INDEPENDENTEI BEIUS - GRADINITA COPII","ORAS BEIUS",3,26804,2,1,2216,1309,1240,69,1295,14,2440,1131,766,529,
5,"BIHOR",56,26804,,143,0,"CAMIN CULTURAL DELANI","ORAS BEIUS",3,26804,2,1,317,178,165,13,175,3,350,172,110,65,
5,"BIHOR",56,26804,,144,1,"ROMANA 8 - CERC MILITAR","ORAS BEIUS",3,26804,2,1,0,301,0,301,294,7,330,29,138,156,
5,"BIHOR",56,26877,,145,0,"PTA INDEPENDENTEI 1 - SCOALA I-VIII","ORAS MARGHITA",4,26877,2,1,1948,879,815,64,867,12,2140,1261,585,282,
5,"BIHOR",56,26877,,146,0,"PTA INDEPENDENTEI 20 - CASA CULTURA","ORAS MARGHITA",4,26877,2,1,1718,900,733,167,886,14,1900,1000,661,225,
5,"BIHOR",56,26877,,147,0,"CALEA REPUBLICII 9 - CLUB COPII","ORAS MARGHITA",4,26877,2,1,1589,728,671,57,723,5,1760,1032,514,209,
5,"BIHOR",56,26877,,148,0,"T. VLADIMIRESCU 2 - SC. I-VIII","ORAS MARGHITA",4,26877,2,1,2172,991,934,57,980,11,2390,1399,769,211,
5,"BIHOR",56,26877,,149,0,"ALEEA TINERETULUI 4 - DEPOZIT ICS","ORAS MARGHITA",4,26877,2,1,1695,923,792,131,916,7,1850,927,648,268,
5,"BIHOR",56,26877,,150,0,"N. BALCESCU 80","ORAS MARGHITA",4,26877,2,1,2253,1000,942,58,990,10,2470,1470,704,286,
5,"BIHOR",56,26877,,151,0,"N. BALCESCU 80","ORAS MARGHITA",4,26877,2,1,2064,844,811,33,829,15,2260,1416,560,269,
5,"BIHOR",56,26877,,152,0,"SC. CL. I-VIII CHET","ORAS MARGHITA",4,26877,2,1,829,336,295,41,318,18,910,574,265,53,
5,"BIHOR",56,26877,,153,0,"SC. GEN. GHENETEA","ORAS MARGHITA",4,26877,2,1,646,381,349,32,377,4,700,319,160,217,
5,"BIHOR",56,26920,,154,0,"CASA DE CULTURA","ORAS NUCET",5,26920,2,1,1114,837,773,64,831,6,1210,373,271,560,
5,"BIHOR",56,26920,,155,0,"CAMIN CULTURAL BAITA","ORAS NUCET",5,26920,2,1,569,425,387,38,417,8,630,205,165,252,
5,"BIHOR",56,26975,,156,0,"KULIN GYORGY 62","ORAS SALONTA",6,26975,2,1,2655,1416,1328,88,1399,17,2920,1504,1224,175,
5,"BIHOR",56,26975,,157,0,"BOCSKAI ISTVAN 21/A","ORAS SALONTA",6,26975,2,1,1673,823,779,44,816,7,1830,1007,757,59,
5,"BIHOR",56,26975,,158,0,"IULIU MANIU 10","ORAS SALONTA",6,26975,2,1,2099,919,882,37,914,5,1620,701,744,170,
5,"BIHOR",56,26975,,159,0,"REPUBLICII 2","ORAS SALONTA",6,26975,2,1,1959,985,907,78,976,9,2170,1185,844,132,
5,"BIHOR",56,26975,,160,0,"REPUBLICII 90","ORAS SALONTA",6,26975,2,1,1268,682,604,78,678,0,1187,509,551,127,
5,"BIHOR",56,26975,,161,0,"REPUBLICII 113","ORAS SALONTA",6,26975,2,1,2280,1067,980,87,1055,12,3500,2433,732,323,
5,"BIHOR",56,26975,,162,0,"ION CREANGA 1","ORAS SALONTA",6,26975,2,1,2007,1002,917,85,977,25,2220,1218,782,195,
5,"BIHOR",56,26975,,163,0,"SARCADULUI 1","ORAS SALONTA",6,26975,2,1,1614,834,790,44,824,10,1640,806,641,183,
5,"BIHOR",56,26975,,164,0,"A. MURESAN 1","ORAS SALONTA",6,26975,2,1,709,521,491,30,513,8,780,259,341,172,
5,"BIHOR",56,26840,,165,0,"CUZA VODA 11","ORAS STEI",7,26840,2,1,1365,746,611,135,741,5,1470,724,370,371,
5,"BIHOR",56,26840,,166,0,"TINERETULUI - SC.GEN. I-IV","ORAS STEI",7,26840,2,1,1245,656,602,54,652,4,1380,724,381,271,
5,"BIHOR",56,26840,,167,0,"INDEPENDENTEI 19/A","ORAS STEI",7,26840,2,1,1593,810,754,56,799,11,1720,910,438,361,
5,"BIHOR",56,32027,,168,0,"MURESULUI - SC.GEN.","ORAS VALEA LUI MIHAI",8,32027,2,1,2787,1310,1152,158,1296,14,3070,1760,1214,82,
5,"BIHOR",56,32027,,169,0,"BRESLELOR - CASA CULTURA","ORAS VALEA LUI MIHAI",8,32027,2,1,2621,1169,1124,45,1156,13,2890,1721,1104,52,
5,"BIHOR",56,32027,,170,0,"CODRULUI - SC.GEN.","ORAS VALEA LUI MIHAI",8,32027,2,1,1453,713,633,80,694,19,1590,877,643,51,
5,"BIHOR",56,32027,,171,0,"VULTURULUI - SC.GEN.","ORAS VALEA LUI MIHAI",8,32027,2,1,1777,838,705,133,817,21,1950,1112,762,55,
5,"BIHOR",56,27007,,172,0,"UNIRII 1","ORAS VASCAU",9,27007,2,1,1899,1053,984,69,1036,17,2094,1041,495,541,
5,"BIHOR",56,27007,,173,0,"CAMIN CULTURAL CIMP","ORAS VASCAU",9,27007,2,1,592,382,336,46,376,6,650,268,201,175,
5,"BIHOR",56,27070,,174,0,"PRIMARIAABRAM","ABRAM",10,27070,0,3,709,438,371,67,431,7,780,342,227,204,
5,"BIHOR",56,27070,,175,0,"SC. CL. I-VIII DIJIR","ABRAM",10,27070,0,3,298,212,187,25,207,5,330,118,102,105,
5,"BIHOR",56,27070,,176,0,"SC. CL. I-IV ITEU","ABRAM",10,27070,0,3,423,300,269,31,296,4,470,170,186,110,
5,"BIHOR",56,27070,,177,0,"SC. CL. I-VIII MARGINE","ABRAM",10,27070,0,3,708,397,362,35,392,5,780,383,144,248,
5,"BIHOR",56,27070,,178,0,"SC. CL. I-VIII SUIUG","ABRAM",10,27070,0,3,503,330,292,38,327,3,550,220,120,207,
5,"BIHOR",56,27169,,179,0,"SC.GEN. ABRAMUT","ABRAMUT",11,27169,0,3,688,342,318,24,341,1,760,418,225,116,
5,"BIHOR",56,27169,,180,0,"SC.GEN.CRESTUR","ABRAMUT",11,27169,0,3,357,261,211,50,258,3,400,139,245,13,
5,"BIHOR",56,27169,,181,0,"SC.GEN.PETREU 2","ABRAMUT",11,27169,0,3,1143,676,646,30,663,13,1250,574,595,68,
5,"BIHOR",56,26742,,182,0,"SC.GEN. AUSEU","ASTILEU",12,26742,0,3,1757,846,768,78,838,8,1930,1084,262,576,
5,"BIHOR",56,26742,,183,0,"CAMIN CULTURAL CALATEA","ASTILEU",12,26742,0,3,722,380,354,26,380,0,800,420,97,283,
5,"BIHOR",56,26742,,184,0,"CAMIN CULTURAL CHISTAG","ASTILEU",12,26742,0,3,470,300,257,43,296,4,510,210,127,169,
5,"BIHOR",56,27212,,185,0,"CAMIN CULTURAL AUSEU","AUSEU",13,27212,0,3,1520,728,620,108,721,7,1670,942,200,521,
5,"BIHOR",56,27212,,186,0,"CAMIN CULTURAL LUNCSOARA","AUSEU",13,27212,0,3,847,395,365,30,386,9,930,535,204,182,
5,"BIHOR",56,27285,,187,0,"SC.GEN. AVRAM IANCU","AVRAM IANCU",14,27285,0,3,1584,1123,1001,122,1114,9,1750,627,649,465,
5,"BIHOR",56,27285,,188,0,"FOST DISPENSAR ANT","AVRAM IANCU",14,27285,0,3,163,128,85,43,128,0,180,52,116,12,
5,"BIHOR",56,27285,,189,0,"SC.GEN. TAMASDA","AVRAM IANCU",14,27285,0,3,760,531,436,95,515,16,860,329,394,121,
5,"BIHOR",56,27329,,190,0,"SC.I-VIII BALC","BALC",15,27329,0,3,986,427,383,44,414,13,1080,653,296,118,
5,"BIHOR",56,27329,,191,0,"CAMIN CULTURAL ALMASU MARE","BALC",15,27329,0,3,745,432,402,30,421,11,820,388,114,307,
5,"BIHOR",56,27329,,192,0,"SC. ALMASU MIC","BALC",15,27329,0,3,406,250,223,27,247,3,450,200,65,182,
5,"BIHOR",56,27329,,193,0,"SC. SALDABAGIU DE BARCAU","BALC",15,27329,0,3,592,440,382,58,438,2,660,220,142,296,
5,"BIHOR",56,27383,,194,0,"SC.GEN. BATAR","BATAR",16,27383,0,3,1217,823,711,112,807,16,1330,507,589,218,
5,"BIHOR",56,27383,,195,0,"SC.GEN. ARPASEL","BATAR",16,27383,0,3,684,326,282,44,323,3,750,424,286,37,
5,"BIHOR",56,27383,,196,0,"GRADINITA TALPOS","BATAR",16,27383,0,3,1266,815,722,93,809,6,1390,575,677,132,
5,"BIHOR",56,27383,,197,0,"GRADINITA TAUT","BATAR",16,27383,0,3,788,513,435,78,503,10,870,357,300,203,
5,"BIHOR",56,27436,,198,0,"CAMIN CULTURAL BIHARIA","BIHARIA",17,27436,0,3,2380,1061,902,159,1050,11,2620,1559,981,69,
5,"BIHOR",56,27436,,199,0,"CASA COMUNALA CAUACEU","BIHARIA",17,27436,0,3,491,348,290,58,341,7,565,217,327,14,
5,"BIHOR",56,27436,,200,0,"CAMIN CULTURAL NIUVED","BIHARIA",17,27436,0,3,165,133,104,29,133,0,180,47,128,5,
5,"BIHOR",56,27436,,201,0,"CAMIN CULTURAL PARHIDA","BIHARIA",17,27436,0,3,362,211,165,46,209,2,400,189,143,66,
5,"BIHOR",56,27436,,202,0,"SC.GEN. SATU NOU","BIHARIA",17,27436,0,3,196,131,103,28,131,0,220,89,129,2,
5,"BIHOR",56,27436,,203,0,"CAMIN CULTURAL TAMASEU","BIHARIA",17,27436,0,3,725,470,407,63,464,6,800,330,449,15,
5,"BIHOR",56,27506,,204,0,"SC.GEN. BOIANU MARE","BOIANU MARE",18,27506,0,3,615,557,535,22,553,4,670,113,340,213,
5,"BIHOR",56,27506,,205,0,"SC.GEN. PAGAIA","BOIANU MARE",18,27506,0,3,538,346,312,34,339,7,590,244,172,167,
5,"BIHOR",56,27560,,206,0,"CAMIN CULTURAL BOROD","BOROD",19,27560,0,3,1306,679,600,79,672,7,1440,761,191,481,
5,"BIHOR",56,27560,,207,0,"SC.I-VIII BOROZEL","BOROD",19,27560,0,3,805,344,310,34,340,4,880,536,131,209,
5,"BIHOR",56,27560,,208,0,"SC.I-VIII BOROD","BOROD",19,27560,0,3,886,376,350,26,373,3,980,604,123,250,
5,"BIHOR",56,27560,,209,0,"SC.I-VIII SERANI 1","BOROD",19,27560,0,3,99,70,18,52,69,1,110,40,34,35,
5,"BIHOR",56,27560,,210,0,"SC.I-VIII SERANI 2","BOROD",19,27560,0,3,332,129,87,42,127,2,361,232,42,85,
5,"BIHOR",56,27631,,211,0,"CAMIN CULTURAL BORS","BORS",20,27631,0,3,922,521,362,159,512,9,1010,489,423,89,
5,"BIHOR",56,27631,,212,0,"GRADINITA SINTION","BORS",20,27631,0,3,1133,737,671,66,732,5,1250,513,722,10,
5,"BIHOR",56,27631,,213,0,"SC.GEN. SANTAUL MARE","BORS",20,27631,0,3,258,190,138,52,189,1,280,90,184,5,
5,"BIHOR",56,27631,,214,0,"SC.GEN. SANTAUL MIC","BORS",20,27631,0,3,314,214,157,57,214,0,253,39,203,11,
5,"BIHOR",56,27686,,215,0,"CONS. LOCAL BRATCA","BRATCA",21,27686,0,3,1292,791,688,103,783,8,1420,629,309,474,
5,"BIHOR",56,27686,,216,0,"CAMIN CULTURAL BEZNEA","BRATCA",21,27686,0,3,1162,631,571,60,619,12,1280,649,170,449,
5,"BIHOR",56,27686,,217,0,"SC.GEN. DAMIS","BRATCA",21,27686,0,3,628,405,363,42,401,4,700,295,129,272,
5,"BIHOR",56,27686,,218,0,"CAMIN CULTURAL PONOARA","BRATCA",21,27686,0,3,633,403,383,20,398,5,700,297,52,346,
5,"BIHOR",56,27686,,219,0,"CAMIN CULTURAL LORAU","BRATCA",21,27686,0,3,403,236,207,29,235,1,440,204,54,181,
5,"BIHOR",56,27686,,220,0,"CAMIN CULTURAL VALEA CRISULUI","BRATCA",21,27686,0,3,429,268,240,28,264,4,468,200,84,180,
5,"BIHOR",56,27757,,221,0,"CAMIN CULTURAL VALEA BRUSTURI","BRUSTURI",22,27757,0,3,1425,649,561,88,649,0,1570,921,202,447,
5,"BIHOR",56,27757,,222,0,"SC.GEN. CUIESD","BRUSTURI",22,27757,0,3,841,313,281,32,311,2,930,617,114,197,
5,"BIHOR",56,27757,,223,0,"SC.GEN. ORVISELE","BRUSTURI",22,27757,0,3,508,407,385,22,405,2,550,143,33,372,
5,"BIHOR",56,27757,,224,0,"CAMIN CULTURAL PICLEU","BRUSTURI",22,27757,0,3,761,489,416,73,485,4,840,351,142,343,
5,"BIHOR",56,27846,,225,0,"SC.GEN.I-VIII","BUDUREASA",23,27846,0,3,1479,874,772,102,863,11,1630,756,321,542,
5,"BIHOR",56,27846,,226,0,"CAMIN CULTURAL SACA","BUDUREASA",23,27846,0,3,536,258,231,27,258,0,591,333,83,175,
5,"BIHOR",56,27908,,227,0,"CONSILIUL LOCAL BUDUSLAU","BUDUSLAU",24,27908,0,3,835,414,379,35,401,13,920,506,388,13,
5,"BIHOR",56,27908,,228,0,"SC.GEN. ALBIS","BUDUSLAU",24,27908,0,3,805,382,346,36,379,3,890,508,367,12,
5,"BIHOR",56,27935,,229,0,"CAMIN CULTURAL BULZ","BULZ",25,27935,0,3,848,375,341,34,372,3,930,555,74,298,
5,"BIHOR",56,27935,,230,0,"SC.I-IV MUNTENI","BULZ",25,27935,0,3,429,352,214,138,352,0,480,128,34,318,
5,"BIHOR",56,27935,,231,0,"CAMIN CULTURAL REMETI","BULZ",25,27935,0,3,692,484,396,88,481,3,760,276,132,349,
5,"BIHOR",56,27971,,232,0,"PRIMARIA BUNTESTI","BUNTESTI",26,27971,0,3,1229,654,615,39,648,6,1350,696,271,377,
5,"BIHOR",56,27971,,233,0,"SC.I-VIII POIENII DE JOS","BUNTESTI",26,27971,0,3,1085,546,516,30,545,1,1190,644,127,418,
5,"BIHOR",56,27971,,234,0,"SC. I-VIII STINCESTI","BUNTESTI",26,27971,0,3,1035,589,555,34,585,4,1140,551,226,359,
5,"BIHOR",56,27971,,235,0,"SC. I-VIII FERICE","BUNTESTI",26,27971,0,3,468,254,242,12,253,1,520,266,118,135,
5,"BIHOR",56,28077,,236,0,"CONSILIUL LOCAL CABESTI","CABESTI",27,28077,0,3,1257,716,668,48,707,9,1380,664,313,394,
5,"BIHOR",56,28077,,237,0,"CAMIN CULTURAL SOHODOL","CABESTI",27,28077,0,3,277,211,192,19,207,4,300,89,140,67,
5,"BIHOR",56,28077,,238,0,"SC.I-IV GOILA","CABESTI",27,28077,0,3,166,146,123,23,146,0,190,44,71,75,
5,"BIHOR",56,28139,,239,0,"PRIMARIA CAPILNA","CAPALNA",29,28139,0,3,371,332,268,64,330,2,410,78,203,127,
5,"BIHOR",56,28139,,240,0,"SC.GEN. GINTA","CAPALNA",29,28139,0,3,418,272,201,71,270,2,460,188,244,26,
5,"BIHOR",56,28139,,241,0,"SC.GEN. SALDABAGIU MIC","CAPALNA",29,28139,0,3,482,349,295,54,349,0,530,176,163,186,
5,"BIHOR",56,28139,,242,0,"SC.GEN. SUPLACU DE TINCA","CAPALNA",29,28139,0,3,368,328,265,63,326,2,400,72,180,146,
5,"BIHOR",56,28193,,243,0,"CAMIN CULTURAL CARPINET","CARPINET",30,28193,0,3,816,457,422,35,455,2,890,433,221,234,
5,"BIHOR",56,28193,,244,0,"CAMIN CULTURAL IZBUC","CARPINET",30,28193,0,3,1116,630,573,57,627,3,1230,600,279,348,
5,"BIHOR",56,28246,,245,0,"CAMIN CULTURAL CEFA","CEFA",31,28246,0,3,905,570,456,114,562,8,990,420,362,200,
5,"BIHOR",56,28246,,246,0,"SCOALA ATEAS","CEFA",31,28246,0,3,175,133,99,34,131,2,190,57,63,68,
5,"BIHOR",56,28246,,247,0,"SC.GEN. BICACIU","CEFA",31,28246,0,3,419,297,246,51,292,5,460,163,194,98,
5,"BIHOR",56,28246,,248,0,"SC.GEN. GEPIU","CEFA",31,28246,0,3,765,493,380,113,484,9,840,347,279,205,
5,"BIHOR",56,28246,,249,0,"CAMIN CULTURAL INAND","CEFA",31,28246,0,3,641,410,361,49,409,1,700,290,207,202,
5,"BIHOR",56,28246,,250,0,"GRADINITA SINICOLAU ROMAN","CEFA",31,28246,0,3,1141,783,623,160,763,20,1260,477,472,291,
5,"BIHOR",56,28246,,251,0,"SC.GEN. ROIT","CEFA",31,28246,0,3,429,310,264,46,301,9,470,160,137,164,
5,"BIHOR",56,28335,,252,0,"PRIMARIA CEICA","CEICA",32,28335,0,3,912,493,416,77,487,6,999,506,250,237,
5,"BIHOR",56,28335,,253,0,"SCOALA CEISOARA","CEICA",32,28335,0,3,597,308,292,16,304,4,660,352,123,181,
5,"BIHOR",56,28335,,254,0,"CAMIN CULTURAL CORBESTI","CEICA",32,28335,0,3,476,353,334,19,353,0,520,167,121,232,
5,"BIHOR",56,28335,,255,0,"SC.GEN. COTIGLET","CEICA",32,28335,0,3,453,307,277,30,304,3,500,193,151,153,
5,"BIHOR",56,28335,,256,0,"CAMIN CULTURAL DUSESTI","CEICA",32,28335,0,3,437,298,242,56,296,2,483,185,98,198,
5,"BIHOR",56,28335,,257,0,"CAMIN CULTURAL INCESTI","CEICA",32,28335,0,3,340,211,179,32,211,0,380,169,114,97,
5,"BIHOR",56,28415,,258,0,"CULBUL CAMIN CULTURAL CETARIU","CETARIU",33,28415,0,3,816,479,429,50,473,6,890,411,457,16,
5,"BIHOR",56,28415,,259,0,"SC.GEN. PALEU","CETARIU",33,28415,0,3,387,250,220,30,242,8,430,180,235,7,
5,"BIHOR",56,28415,,260,0,"SC.GEN. SALDABAGIU DE MUNTE","CETARIU",33,28415,0,3,413,378,307,71,372,6,450,72,356,16,
5,"BIHOR",56,28415,,261,0,"SC.GEN. UILEACU DE MUNTE","CETARIU",33,28415,0,3,419,320,267,53,320,0,460,140,316,4,
5,"BIHOR",56,28415,,262,0,"GRADINITA TAUTELEC","CETARIU",33,28415,0,3,161,144,112,32,144,0,170,26,142,2,
5,"BIHOR",56,28415,,263,0,"GRADINITA SISTEREA","CETARIU",33,28415,0,3,481,359,299,60,354,5,530,171,335,19,
5,"BIHOR",56,28415,,264,0,"SC.GEN. SUSTUROGIU","CETARIU",33,28415,0,3,262,188,146,42,187,1,290,102,81,106,
5,"BIHOR",56,28497,,265,0,"PRIMARIA CHERECHIU","CHERECHIU",34,28497,0,3,607,393,360,33,377,16,670,277,370,7,
5,"BIHOR",56,28497,,266,0,"CAMIN CULTURAL CHESEREU","CHERECHIU",34,28497,0,3,845,613,565,48,609,4,930,317,593,16,
5,"BIHOR",56,28497,,267,0,"CASA SATULUI TIRGUSOR","CHERECHIU",34,28497,0,3,435,357,298,59,350,7,480,123,337,13,
5,"BIHOR",56,28530,,268,0,"SC.GEN. CHISLAZ","CHISLAZ",35,28530,0,3,472,300,256,44,289,11,520,220,129,160,
5,"BIHOR",56,28530,,269,0,"SC.GEN. CHIRALEU","CHISLAZ",35,28530,0,3,506,345,301,44,339,6,560,215,162,177,
5,"BIHOR",56,28530,,270,0,"SC.GEN. MISCA","CHISLAZ",35,28530,0,3,755,473,426,47,471,2,830,357,445,26,
5,"BIHOR",56,28530,,271,0,"SC.GEN. POCLUSA DE BARCAU","CHISLAZ",35,28530,0,3,289,148,117,31,144,4,320,172,117,27,
5,"BIHOR",56,28530,,272,0,"SC.GEN. SARSIG","CHISLAZ",35,28530,0,3,296,211,162,49,211,0,321,110,79,132,
5,"BIHOR",56,28530,,273,0,"SC.GEN. SINLAZAR","CHISLAZ",35,28530,0,3,364,250,213,37,247,3,400,150,105,142,
5,"BIHOR",56,28610,,274,0,"SC.GEN. CIUHOI","CIUHOI",36,28610,0,3,820,510,433,77,499,11,910,400,256,243,
5,"BIHOR",56,28610,,275,0,"SC.GEN. SINIOB","CIUHOI",36,28610,0,3,931,664,593,71,656,8,1020,356,631,25,
5,"BIHOR",56,28665,,276,0,"PRIMARIA CIUMEGHIU","CIUMEGHIU",37,28665,0,3,1379,750,682,68,741,9,1520,770,407,334,
5,"BIHOR",56,28665,,277,0,"AS.AGR.SPICUL BOIU","CIUMEGHIU",37,28665,0,3,659,356,299,57,350,6,720,364,273,77,
5,"BIHOR",56,28665,,278,0,"SC.GEN. GHIORAC","CIUMEGHIU",37,28665,0,3,1335,714,649,65,699,15,1470,756,513,186,
5,"BIHOR",56,28709,,279,0,"CAMIN CULTURAL CIMPANI","CAMPANI",28,28709,0,3,1280,757,703,54,743,14,1410,653,363,380,
5,"BIHOR",56,28709,,280,0,"SC.GEN. HIRSESTI","CAMPANI",28,28709,0,3,300,208,191,17,205,3,330,122,91,114,
5,"BIHOR",56,28709,,281,0,"SC.GEN. SIGHISTEL","CAMPANI",28,28709,0,3,306,265,244,21,263,2,340,75,108,155,
5,"BIHOR",56,28709,,282,0,"SC.GEN. VALEA DE SUS","CAMPANI",28,28709,0,3,300,216,207,9,216,0,330,114,80,136,
5,"BIHOR",56,28763,,283,0,"CAMIN CULTURAL COCIUBA MARE","COCIUBA MARE",38,28763,0,3,832,580,506,74,568,12,920,340,324,244,
5,"BIHOR",56,28763,,284,0,"SC.GEN. CHESA","COCIUBA MARE",38,28763,0,3,620,438,390,48,433,5,687,249,196,237,
5,"BIHOR",56,28763,,285,0,"SC.GEN. CARASAU","COCIUBA MARE",38,28763,0,3,621,386,351,35,384,2,683,297,137,247,
5,"BIHOR",56,28763,,286,0,"CAMIN CULTURAL PETID","COCIUBA MARE",38,28763,0,3,577,404,363,41,395,9,630,226,183,212,
5,"BIHOR",56,28816,,287,0,"CAMIN CULTURAL COPACEL","COPACEL",39,28816,0,3,563,396,304,92,391,5,630,234,133,258,
5,"BIHOR",56,28816,,288,0,"SC.GEN. BUCUROAIA","COPACEL",39,28816,0,3,577,339,283,56,335,4,640,301,109,226,
5,"BIHOR",56,28816,,289,0,"SC.GEN. SARAND","COPACEL",39,28816,0,3,355,264,209,55,258,6,390,126,122,136,
5,"BIHOR",56,28816,,290,0,"CAMIN CULTURAL SURDUC","COPACEL",39,28816,0,3,408,270,222,48,265,5,440,170,111,154,
5,"BIHOR",56,28889,,291,0,"CAMIN CULTURAL CRISTIORU DE JOS","CRISTIORU DE JOS",40,28889,0,3,361,229,186,43,226,3,400,171,105,121,
5,"BIHOR",56,28889,,292,0,"CAMIN CULTURAL CRISTIORU DE SUS","CRISTIORU DE JOS",40,28889,0,3,175,123,88,35,123,0,200,77,47,76,
5,"BIHOR",56,28889,,293,0,"SC.I-VIII POIANA","CRISTIORU DE JOS",40,28889,0,3,476,343,310,33,340,3,520,177,199,141,
5,"BIHOR",56,28889,,294,0,"CAMIN CULTURAL SALISTE DE V.","CRISTIORU DE JOS",40,28889,0,3,415,317,278,39,312,5,450,133,131,181,
5,"BIHOR",56,28941,,295,0,"SC.GEN. CURATELE","CURATELE",41,28941,0,3,2238,1156,1124,32,1150,6,2480,1324,478,672,
5,"BIHOR",56,29001,,296,0,"PRIMARIA CURTUISENI","CURTUISENI",42,29001,0,3,2126,972,947,25,953,19,2340,1368,881,72,
5,"BIHOR",56,29001,,297,0,"SC.GEN. VASAD","CURTUISENI",42,29001,0,3,809,629,554,75,618,11,900,271,418,200,
5,"BIHOR",56,29038,,298,0,"PRIMARIA DERNA","DERNA",43,29038,0,3,803,474,443,31,470,4,890,416,286,184,
5,"BIHOR",56,29038,,299,0,"SC.GEN. DERNISOARA","DERNA",43,29038,0,3,551,307,284,23,304,3,610,303,110,194,
5,"BIHOR",56,29038,,300,0,"SC.GEN. SACALASAU","DERNA",43,29038,0,3,554,276,253,23,273,3,610,334,95,178,
5,"BIHOR",56,29038,,301,0,"SC.GEN. SACALASAU NOU","DERNA",43,29038,0,3,276,131,118,13,131,0,300,169,70,61,
5,"BIHOR",56,29038,,302,0,"SC.GEN. TRIA","DERNA",43,29038,0,3,358,219,202,17,217,2,400,181,86,131,
5,"BIHOR",56,29092,,303,0,"SC.GEN. DIOSIG","DIOSIG",44,29092,0,3,1387,798,675,123,791,7,1550,752,378,413,
5,"BIHOR",56,29092,,304,0,"CAMIN CULTURAL CENTRU","DIOSIG",44,29092,0,3,2089,1019,921,98,968,51,2290,1271,878,90,
5,"BIHOR",56,29092,,305,0,"PRIMARIA DIOSIG","DIOSIG",44,29092,0,3,1505,562,519,43,554,8,1650,1088,485,69,
5,"BIHOR",56,29092,,306,0,"CAMIN CULTURAL MIHAI BRAVU","DIOSIG",44,29092,0,3,869,549,475,74,544,5,950,401,231,313,
5,"BIHOR",56,29092,,307,0,"CAMIN CULTURAL ROSIORI","DIOSIG",44,29092,0,3,975,426,362,64,415,11,1070,644,391,24,
5,"BIHOR",56,29092,,308,0,"SALA CLUB VAIDA","DIOSIG",44,29092,0,3,482,328,304,24,325,3,530,202,305,20,
5,"BIHOR",56,29154,,309,0,"CAMIN CULTURAL DOBRESTI","DOBRESTI",45,29154,0,3,1376,826,748,78,811,15,1510,684,451,360,
5,"BIHOR",56,29154,,310,0,"CAMIN CULTURAL LUNCASPRIE","DOBRESTI",45,29154,0,3,860,476,450,26,472,4,950,474,221,251,
5,"BIHOR",56,29154,,311,0,"CAMIN CULTURAL HIDISEL","DOBRESTI",45,29154,0,3,1400,786,715,71,774,12,1540,754,367,407,
5,"BIHOR",56,29154,,312,0,"SC.GEN. TOPA DE SUS","DOBRESTI",45,29154,0,3,610,364,336,28,363,1,670,306,220,143,
5,"BIHOR",56,29243,,313,0,"PRIMARIA DRAGANESTI","DRAGANESTI",46,29243,0,3,1111,614,558,56,607,7,1220,606,334,273,
5,"BIHOR",56,29243,,314,0,"CAMIN CULTURAL SEBIS","DRAGANESTI",46,29243,0,3,280,236,208,28,235,1,310,74,107,128,
5,"BIHOR",56,29243,,315,0,"SC.GEN. BELEJENI","DRAGANESTI",46,29243,0,3,265,195,178,17,193,2,290,95,76,117,
5,"BIHOR",56,29243,,316,0,"SFAT POPULAR MIZIES","DRAGANESTI",46,29243,0,3,470,400,361,39,398,2,510,110,203,195,
5,"BIHOR",56,29243,,317,0,"SC.GEN. TALPE","DRAGANESTI",46,29243,0,3,234,133,122,11,132,1,260,127,69,63,
5,"BIHOR",56,29341,,318,0,"PRIMARIA DRAGANESTI","DRAGESTI",47,29341,0,3,328,217,172,45,215,0,360,143,99,116,
5,"BIHOR",56,29341,,319,0,"CAMIN CULTURAL DICANESTI","DRAGESTI",47,29341,0,3,233,163,139,24,160,3,260,97,45,115,
5,"BIHOR",56,29341,,320,0,"SC.I-IV STRACOS","DRAGESTI",47,29341,0,3,254,167,139,28,165,2,280,113,72,93,
5,"BIHOR",56,29341,,321,0,"SC.I-VIII TASAD","DRAGESTI",47,29341,0,3,864,541,444,97,528,13,960,419,278,250,
5,"BIHOR",56,29341,,322,0,"CAMIN CULTURAL TOPESTI","DRAGESTI",47,29341,0,3,201,151,129,22,148,3,220,69,69,79,
5,"BIHOR",56,29403,,323,0,"PRIMARIA FINIS","FINIS",48,29403,0,3,1612,912,859,53,905,7,1770,858,653,252,
5,"BIHOR",56,29403,,324,0,"CLUB FABRICA IOANIS","FINIS",48,29403,0,3,1121,665,596,69,657,8,1230,565,444,213,
5,"BIHOR",56,29467,,325,0,"PRIMARIA GIRISU DE CRIS","GIRISU DE CRIS",49,29467,0,3,870,508,360,148,503,5,960,452,276,227,
5,"BIHOR",56,29467,,326,0,"SC.GEN. TARIAN","GIRISU DE CRIS",49,29467,0,3,1334,679,566,113,675,4,1470,791,452,223,
5,"BIHOR",56,29467,,327,0,"SC.GEN. TOBOLIU","GIRISU DE CRIS",49,29467,0,3,716,397,328,69,394,3,786,389,151,243,
5,"BIHOR",56,29467,,328,0,"CAMIN CULTURAL CHERESIG","GIRISU DE CRIS",49,29467,0,3,780,512,422,90,510,2,860,348,292,218,
5,"BIHOR",56,29519,,329,0,"CAMIN CULTURAL HIDISELUL DE SUS","HIDISELU DE SUS",50,29519,0,3,1484,801,698,103,793,8,1630,829,446,347,
5,"BIHOR",56,29519,,330,0,"SC.GEN. MIERLAU","HIDISELU DE SUS",50,29519,0,3,639,433,373,60,433,0,700,267,211,222,
5,"BIHOR",56,29519,,331,0,"SC.GEN. SUMUGIU","HIDISELU DE SUS",50,29519,0,3,340,275,212,63,271,4,380,105,146,125,
5,"BIHOR",56,29573,,332,0,"CAMIN CULTURAL HOLOD","HOLOD",51,29573,0,3,723,478,376,102,471,7,799,321,229,242,
5,"BIHOR",56,29573,,333,0,"CAMIN CULTURAL DUMBRAVA","HOLOD",51,29573,0,3,456,320,250,70,309,11,500,180,156,153,
5,"BIHOR",56,29573,,334,0,"SC.I-IV HODIS","HOLOD",51,29573,0,3,734,343,286,57,338,5,810,467,193,145,
5,"BIHOR",56,29573,,335,0,"CAMIN CULTURAL VINTERE","HOLOD",51,29573,0,3,718,499,424,75,493,6,790,291,203,290,
5,"BIHOR",56,29662,,336,0,"PRIMARIA HUSASAU DE TINCA","HUSASAU DE TINCA",52,29662,0,3,570,414,341,73,408,6,621,207,227,181,
5,"BIHOR",56,29662,,337,0,"SC.GEN. FONAU","HUSASAU DE TINCA",52,29662,0,3,149,116,86,30,111,5,161,45,73,38,
5,"BIHOR",56,29662,,338,0,"SC.GEN. MIERSIG","HUSASAU DE TINCA",52,29662,0,3,263,223,152,71,221,2,290,67,142,79,
5,"BIHOR",56,29662,,339,0,"SC.GEN. OSAND","HUSASAU DE TINCA",52,29662,0,3,353,262,215,47,254,8,390,128,207,47,
5,"BIHOR",56,29662,,340,0,"SC.GEN. SITITELEC","HUSASAU DE TINCA",52,29662,0,3,340,312,236,76,300,12,380,68,158,142,
5,"BIHOR",56,29724,,341,0,"CAMIN CULTURAL INEU","INEU",53,29724,0,3,1479,738,640,98,723,15,1619,881,362,361,
5,"BIHOR",56,29724,,342,0,"CAMIN CULTURAL BOTEAN","INEU",53,29724,0,3,508,258,215,43,254,4,560,302,100,154,
5,"BIHOR",56,29724,,343,0,"SC.GEN. HUSASAU","INEU",53,29724,0,3,654,382,296,86,381,1,720,338,175,206,
5,"BIHOR",56,29760,,344,0,"PRIMARIA LAZURI DE BEIUS","LAZURI DE BEIUS",55,29760,0,3,499,292,265,27,288,4,550,258,114,174,
5,"BIHOR",56,29760,,345,0,"SC.GEN. CUSUIS","LAZURI DE BEIUS",55,29760,0,3,419,260,237,23,258,2,460,200,151,107,
5,"BIHOR",56,29760,,346,0,"SC.GEN. HINCHIRIS","LAZURI DE BEIUS",55,29760,0,3,614,344,310,34,333,11,680,336,127,206,
5,"BIHOR",56,29813,,347,0,"CONSILIUL LOCAL LAZARENI","LAZARENI",54,29813,0,3,519,346,270,76,341,5,570,224,161,180,
5,"BIHOR",56,29813,,348,0,"CAMIN CULTURAL GRUILUNG","LAZARENI",54,29813,0,3,102,105,59,46,103,2,110,5,19,84,
5,"BIHOR",56,29813,,349,0,"SC.GEN. CALEA MARE","LAZARENI",54,29813,0,3,508,327,289,38,317,10,560,233,157,160,
5,"BIHOR",56,29813,,350,0,"CAMIN CULTURAL CARANDENI","LAZARENI",54,29813,0,3,339,235,187,48,235,0,380,145,94,141,
5,"BIHOR",56,29813,,351,0,"CAMIN CULTURAL CARANZEL","LAZARENI",54,29813,0,3,102,88,71,17,88,0,110,22,23,65,
5,"BIHOR",56,29813,,352,0,"CAMIN CULTURAL GEPIS","LAZARENI",54,29813,0,3,455,382,283,99,363,19,500,118,219,144,
5,"BIHOR",56,29813,,353,0,"SC.GEN. MIHELEU","LAZARENI",54,29813,0,3,173,132,98,34,127,5,190,58,54,73,
5,"BIHOR",56,29902,,354,0,"CAMIN CULTURAL LUGASU DE JOS","LUGASU DE JOS",56,29902,0,3,1749,888,790,98,873,15,1920,1032,315,558,
5,"BIHOR",56,29902,,355,0,"CAMIN CULTURAL URVIND","LUGASU DE JOS",56,29902,0,3,698,380,327,53,376,4,802,422,340,36,
5,"BIHOR",56,29948,,356,0,"CAMIN CULTURAL LUNCA","LUNCA",57,29948,0,3,806,480,434,46,477,3,880,400,199,278,
5,"BIHOR",56,29948,,357,0,"CAMIN CULTURAL BRIHENI","LUNCA",57,29948,0,3,361,257,231,26,253,4,400,143,126,127,
5,"BIHOR",56,29948,,358,0,"SC.GEN. HOTAREL","LUNCA",57,29948,0,3,253,164,135,29,161,3,280,116,81,80,
5,"BIHOR",56,29948,,359,0,"SC.GEN. SUSTIU","LUNCA",57,29948,0,3,396,311,264,47,311,0,440,129,183,128,
5,"BIHOR",56,29948,,360,0,"SC.GEN. SIRBESTI","LUNCA",57,29948,0,3,311,217,194,23,217,0,340,123,127,90,
5,"BIHOR",56,29948,,361,0,"CAMIN CULTURAL SEGHISTE","LUNCA",57,29948,0,3,493,324,290,34,323,1,540,216,146,177,
5,"BIHOR",56,30014,,362,0,"CAMIN CULTURAL MADARAS","MADARAS",58,30014,0,3,762,475,436,39,468,7,840,365,243,225,
5,"BIHOR",56,30014,,363,0,"CAMIN CULTURAL HOMOROG","MADARAS",58,30014,0,3,564,457,397,60,454,3,620,163,261,193,
5,"BIHOR",56,30014,,364,0,"FOST SEDIU PRIMARIE IANOSDA","MADARAS",58,30014,0,3,832,609,540,69,605,4,920,311,320,285,
5,"BIHOR",56,30014,,365,0,"CAMIN CULTURAL MARTIHAZ","MADARAS",58,30014,0,3,177,111,95,16,109,2,190,79,53,56,
5,"BIHOR",56,30069,,366,0,"PRIMARIA MAGESTI","MAGESTI",59,30069,0,3,834,472,419,53,468,4,910,438,192,276,
5,"BIHOR",56,30069,,367,0,"SC.GEN. ORTITEAG","MAGESTI",59,30069,0,3,670,375,333,42,373,2,740,365,132,241,
5,"BIHOR",56,30069,,368,0,"CAMIN CULTURAL DOBRICIONESTI","MAGESTI",59,30069,0,3,476,304,273,31,300,4,520,216,81,219,
5,"BIHOR",56,30069,,369,0,"SC.GEN. GALASENI","MAGESTI",59,30069,0,3,273,148,132,16,148,0,300,152,45,103,
5,"BIHOR",56,30149,,370,0,"CAMIN CULTURAL NOJORID","NOJORID",60,30149,0,3,1232,715,645,70,706,9,1360,645,218,488,
5,"BIHOR",56,30149,,371,0,"SC.GEN. APATEU","NOJORID",60,30149,0,3,181,146,85,61,144,2,150,4,56,88,
5,"BIHOR",56,30149,,372,0,"SC.GEN. CHISIRID","NOJORID",60,30149,0,3,100,69,34,35,69,0,110,41,35,34,
5,"BIHOR",56,30149,,373,0,"SC.GEN. LES","NOJORID",60,30149,0,3,433,274,194,80,274,0,523,249,143,131,
5,"BIHOR",56,30149,,374,0,"GRADINITA LIVADA DE BIHOR","NOJORID",60,30149,0,3,776,527,427,100,522,5,850,223,179,343,
5,"BIHOR",56,30149,,375,0,"SC.GEN. PAUSA","NOJORID",60,30149,0,3,218,147,108,39,145,2,241,94,78,67,
5,"BIHOR",56,30149,,376,0,"SC.GEN. SAUAIEU","NOJORID",60,30149,0,3,261,163,122,41,159,4,290,127,84,75,
5,"BIHOR",56,30229,,377,0,"SC.GEN. OLCEA","OLCEA",61,30229,0,3,477,421,370,51,414,7,530,109,179,235,
5,"BIHOR",56,30229,,378,0,"SC.GEN. CALACEA","OLCEA",61,30229,0,3,910,565,524,41,556,9,1000,435,228,328,
5,"BIHOR",56,30229,,379,0,"SC.GEN. HODISEL","OLCEA",61,30229,0,3,342,274,262,12,273,1,370,96,106,167,
5,"BIHOR",56,30229,,380,0,"SC.GEN. UCURIS","OLCEA",61,30229,0,3,391,358,265,93,353,5,430,72,216,137,
5,"BIHOR",56,30274,,381,0,"CAMIN CULTURAL OSORHEI","OSORHEI",62,30274,0,3,1948,929,828,101,911,18,2160,1231,638,273,
5,"BIHOR",56,30274,,382,0,"CAMIN CULTURAL ALPAREA","OSORHEI",62,30274,0,3,716,508,394,114,504,4,790,282,242,262,
5,"BIHOR",56,30274,,383,0,"CAMIN CULTURAL CHERIU","OSORHEI",62,30274,0,3,356,277,203,74,272,5,390,113,147,125,
5,"BIHOR",56,30274,,384,0,"SC.GEN. FELCHERIU","OSORHEI",62,30274,0,3,265,217,154,63,217,0,290,73,118,99,
5,"BIHOR",56,30274,,385,0,"CAMIN CULTURAL FUGHIU","OSORHEI",62,30274,0,3,666,349,302,47,346,3,730,381,239,107,
5,"BIHOR",56,30336,,386,0,"SC.GEN. PIETROASA","PIETROASA",63,30336,0,3,1686,1121,1063,58,1107,14,1860,739,455,652,
5,"BIHOR",56,30336,,387,0,"SC.GEN. CHISCAU","PIETROASA",63,30336,0,3,1088,815,769,46,815,0,1200,385,203,612,
5,"BIHOR",56,30416,,388,0,"CAMIN CULTURAL POCOLA","POCOLA",64,30416,0,3,1413,695,649,46,680,15,1550,855,327,353,
5,"BIHOR",56,30470,,389,0,"CAMIN CULTURAL POMEZEU","POMEZEU",65,30470,0,3,865,641,595,46,632,9,950,309,351,281,
5,"BIHOR",56,30470,,390,0,"CAMIN CULTURAL CIMPANI DE P.","POMEZEU",65,30470,0,3,1003,935,875,60,929,6,1110,175,608,321,
5,"BIHOR",56,30470,,391,0,"SC.GEN. COSDENI","POMEZEU",65,30470,0,3,971,793,741,52,785,8,1070,277,465,320,
5,"BIHOR",56,30568,,392,0,"LIC.IND.POPESTI","POPESTI",66,30568,0,3,1887,1070,938,132,1044,26,2070,1000,652,392,
5,"BIHOR",56,30568,,393,0,"SC.GEN. BISTRA","POPESTI",66,30568,0,3,792,487,455,32,480,7,870,383,293,187,
5,"BIHOR",56,30568,,394,0,"LICEUL BUDOI","POPESTI",66,30568,0,3,834,326,289,37,323,3,920,594,214,109,
5,"BIHOR",56,30568,,395,0,"SC.GEN. CUZAP","POPESTI",66,30568,0,3,973,498,464,34,493,5,1070,572,273,220,
5,"BIHOR",56,30568,,396,0,"SC.GEN. VARVIZ","POPESTI",66,30568,0,3,480,263,238,25,260,3,530,267,103,157,
5,"BIHOR",56,30568,,397,0,"SC.GEN. VARZARI","POPESTI",66,30568,0,3,269,162,148,14,154,8,300,138,74,80,
5,"BIHOR",56,30568,,398,0,"SC.GEN. VOIVOZI","POPESTI",66,30568,0,3,1469,769,719,50,765,4,1620,851,398,367,
5,"BIHOR",56,30648,,399,0,"CAMIN CULTURAL RABAGANI","RABAGANI",67,30648,0,3,661,439,397,42,434,5,730,291,265,169,
5,"BIHOR",56,30648,,400,0,"CAMIN CULTURAL SAUCANI","RABAGANI",67,30648,0,3,597,367,344,23,363,4,650,283,228,135,
5,"BIHOR",56,30648,,401,0,"CAMIN CULTURAL VARASENI","RABAGANI",67,30648,0,3,390,318,277,41,315,3,430,112,193,122,
5,"BIHOR",56,30648,,402,0,"CAMIN CULTURAL ALBESTI","RABAGANI",67,30648,0,3,290,227,198,29,226,1,320,93,153,73,
5,"BIHOR",56,30719,,403,0,"SC.GEN. REMETEA","REMETEA",68,30719,0,3,1087,660,606,54,652,8,1200,540,456,196,
5,"BIHOR",56,30719,,404,0,"SC.GEN. MEZIAD","REMETEA",68,30719,0,3,1010,519,481,38,517,2,1110,591,222,295,
5,"BIHOR",56,30719,,405,0,"SC.GEN. DRAGOTENI","REMETEA",68,30719,0,3,420,342,254,88,339,3,460,118,137,202,
5,"BIHOR",56,30773,,406,0,"SC.GEN. RIENI","RIENI",69,30773,0,3,799,436,393,43,433,3,870,434,183,250,
5,"BIHOR",56,30773,,407,0,"SC.GEN. GHIGHISENI","RIENI",69,30773,0,3,1252,664,607,57,656,8,1370,706,371,285,
5,"BIHOR",56,30773,,408,0,"SC.GEN.VALEA DE JOS","RIENI",69,30773,0,3,470,383,339,44,378,5,520,137,155,223,
5,"BIHOR",56,30844,,409,0,"CAMIN CULTURAL ROSIA","ROSIA",70,30844,0,3,2110,1409,1360,49,1389,20,2330,921,676,713,
5,"BIHOR",56,30871,,410,0,"CAMIN CULTURAL SACADAT","SACADAT",71,30871,0,3,884,559,444,115,553,6,970,411,260,293,
5,"BIHOR",56,30915,,411,0,"PTA LIBERTATII - SC.GEN.","SACUENI",72,30915,0,3,2103,887,837,50,874,13,2330,1443,819,55,
5,"BIHOR",56,30915,,412,0,"IRINYI JANOS 1","SACUENI",72,30915,0,3,1617,805,721,84,787,18,1780,975,759,28,
5,"BIHOR",56,30915,,413,0,"MORII 34","SACUENI",72,30915,0,3,1137,505,465,40,504,1,1252,747,486,18,
5,"BIHOR",56,30915,,414,0,"INFRATIRII 4","SACUENI",72,30915,0,3,961,503,418,85,495,8,1050,547,400,95,
5,"BIHOR",56,30915,,415,0,"SC.GEN. CADEA","SACUENI",72,30915,0,3,851,408,355,53,395,13,930,522,375,20,
5,"BIHOR",56,30915,,416,0,"SC.GEN. CIOCAIA","SACUENI",72,30915,0,3,758,420,395,25,403,17,830,410,387,16,
5,"BIHOR",56,30915,,417,0,"FOST SEDIU PRIMARIE","SACUENI",72,30915,0,3,764,294,264,30,289,5,840,546,261,28,
5,"BIHOR",56,30915,,418,0,"CAMIN CULTURAL OLOSIG","SACUENI",72,30915,0,3,435,225,204,21,215,10,480,255,204,11,
5,"BIHOR",56,30915,,419,0,"SC.GEN. SINICOLAU DE MUNTE","SACUENI",72,30915,0,3,673,352,321,31,348,4,740,388,324,24,
5,"BIHOR",56,30988,,420,0,"CAMIN CULTURAL SALACEA","SALACEA",73,30988,0,3,1954,986,934,52,977,9,2150,1164,966,11,
5,"BIHOR",56,30988,,421,0,"SC.GEN. OTOMANI","SALACEA",73,30988,0,3,619,348,326,22,345,3,670,322,336,9,
5,"BIHOR",56,31011,,422,0,"SC.GEN. SALARD","SALARD",74,31011,0,3,2089,1078,968,110,1066,12,2290,1212,891,175,
5,"BIHOR",56,31011,,423,0,"SC.GEN. HODOS","SALARD",74,31011,0,3,611,312,291,21,308,4,680,368,299,9,
5,"BIHOR",56,31011,,424,0,"FOST SEDIU CAP SINTIMREU","SALARD",74,31011,0,3,450,271,222,49,265,5,490,219,261,4,
5,"BIHOR",56,31057,,425,0,"CAMIN CULTURAL SIMBATA","SAMBATA",75,31057,0,3,1388,756,659,97,750,6,1540,784,377,373,
5,"BIHOR",56,26582,,426,0,"SC.GEN. SINMARTIN - CARTIER BLOCURI","SANMARTIN",76,26582,0,3,2209,1078,960,118,1063,15,2430,1352,542,521,
5,"BIHOR",56,26582,,427,0,"SC I-IV BETFIA","SANMARTIN",76,26582,0,3,318,245,212,33,245,0,350,105,111,134,
5,"BIHOR",56,26582,,428,0,"SC. I-VIII CIHEI","SANMARTIN",76,26582,0,3,702,471,426,45,465,6,770,299,246,219,
5,"BIHOR",56,26582,,429,0,"SC. I-VIII CORDAU","SANMARTIN",76,26582,0,3,871,622,534,88,622,0,962,340,351,271,
5,"BIHOR",56,26582,,430,0,"CASA CULTURA BAILE FELIX","SANMARTIN",76,26582,0,3,333,922,198,724,914,8,2092,1170,544,370,
5,"BIHOR",56,26582,,431,0,"SC. I-VIII BAILE 1 MAI","SANMARTIN",76,26582,0,3,618,598,288,310,596,2,1070,472,317,279,
5,"BIHOR",56,26582,,432,0,"SC. I-IV RONTAU","SANMARTIN",76,26582,0,3,674,390,353,37,387,3,740,350,246,141,
5,"BIHOR",56,26653,,433,0,"CAMIN CULTURAL SINTANDREI","SANTANDREI",77,26653,0,3,2345,1191,1059,132,1186,5,2570,1379,650,536,
5,"BIHOR",56,26653,,434,0,"CAMIN CULTURAL PALOTA","SANTANDREI",77,26653,0,3,514,215,175,40,213,2,560,345,175,38,
5,"BIHOR",56,31128,,435,0,"CAMIN CULTURAL SIRBI","SARBI",78,31128,0,3,1401,721,591,130,711,10,1550,829,278,433,
5,"BIHOR",56,31128,,436,0,"CAMIN CULTURAL BURZUC","SARBI",78,31128,0,3,991,569,493,76,562,7,1100,531,159,403,
5,"BIHOR",56,31208,,437,0,"SC. I-VIII SPINUS","SPINUS",82,31208,0,3,734,364,312,52,361,3,810,446,165,196,
5,"BIHOR",56,31208,,438,0,"SC. I-IV SALISTE","SPINUS",82,31208,0,3,361,224,190,34,220,4,400,176,121,99,
5,"BIHOR",56,31262,,439,0,"GRUP SCOLAR SUPLACU DE BARCAU","SUPLACU DE BARCAU",84,31262,0,3,2035,911,794,117,900,11,2250,1339,643,257,
5,"BIHOR",56,31262,,440,0,"SC.GEN. BORUMLACA","SUPLACU DE BARCAU",84,31262,0,3,782,487,459,28,472,15,860,373,227,245,
5,"BIHOR",56,31262,,441,0,"SC.GEN. DOLEA","SUPLACU DE BARCAU",84,31262,0,3,161,109,92,17,105,4,180,71,98,7,
5,"BIHOR",56,31262,,442,0,"SC.GEN. FOGLAS","SUPLACU DE BARCAU",84,31262,0,3,157,88,70,18,88,0,170,82,19,69,
5,"BIHOR",56,31262,,443,0,"SC.GEN. VALEA CERULUI","SUPLACU DE BARCAU",84,31262,0,3,533,295,278,17,294,1,580,285,108,186,
5,"BIHOR",56,31333,,444,0,"CASA MEMORIALA KAZINCZY F.","SIMIAN",79,31333,0,3,1963,1109,1042,67,1095,14,2160,1051,1000,95,
5,"BIHOR",56,31333,,445,0,"SC. I-IV BARANTAU","SIMIAN",79,31333,0,3,145,111,84,27,109,2,160,49,104,5,
5,"BIHOR",56,31333,,446,0,"SC. I-IV SILINDRU","SIMIAN",79,31333,0,3,712,384,305,79,382,2,780,396,344,38,
5,"BIHOR",56,31333,,447,0,"SC. I-IV VOIVOZI","SIMIAN",79,31333,0,3,383,212,144,68,210,2,430,218,96,114,
5,"BIHOR",56,31379,,448,0,"PRIMARIA SINTEU","SINTEU",80,31379,0,3,1090,311,284,27,303,8,1200,889,93,210,
5,"BIHOR",56,31422,,449,0,"PRIMARIA SOIMI","SOIMI",81,31422,0,3,574,371,331,40,329,2,630,299,205,124,
5,"BIHOR",56,31422,,450,0,"GRADINITA URSAD","SOIMI",81,31422,0,3,292,159,127,32,156,3,320,161,75,81,
5,"BIHOR",56,31422,,451,0,"SC.GEN. CODRU","SOIMI",81,31422,0,3,139,108,60,48,107,1,150,42,61,46,
5,"BIHOR",56,31422,,452,0,"TABARA TINERET URVIS","SOIMI",81,31422,0,3,987,515,476,39,513,2,1090,575,203,310,
5,"BIHOR",56,31422,,453,0,"SC.GEN. DUMBRAVITA DE CODRU","SOIMI",81,31422,0,3,446,249,212,37,246,3,490,241,126,120,
5,"BIHOR",56,31510,,454,0,"CAMIN CULTURAL SUNCUIUS","SUNCUIUS",83,31510,0,3,1452,922,788,134,911,11,1600,678,464,447,
5,"BIHOR",56,31510,,455,0,"SC.GEN. BALNACA","SUNCUIUS",83,31510,0,3,807,520,449,71,514,6,890,370,160,354,
5,"BIHOR",56,31510,,456,0,"CAMIN CULTURAL BALNACA GROSI","SUNCUIUS",83,31510,0,3,136,61,44,17,61,0,150,89,10,51,
5,"BIHOR",56,31510,,457,0,"CAMIN CULTURAL CARMAZAN","SUNCUIUS",83,31510,0,3,254,158,141,17,154,4,280,122,79,75,
5,"BIHOR",56,31510,,458,0,"SC.GEN. GUGU","SUNCUIUS",83,31510,0,3,210,157,112,45,153,4,231,74,39,114,
5,"BIHOR",56,31565,,459,0,"CAMIN CULTURAL TARCEA","TARCEA",86,31565,0,3,738,313,295,18,300,13,817,504,270,30,
5,"BIHOR",56,31565,,460,0,"SC.GEN. ADONI","TARCEA",86,31565,0,3,633,322,299,23,320,2,702,380,306,14,
5,"BIHOR",56,31565,,461,0,"SC.GEN. GALOSPETREU","TARCEA",86,31565,0,3,814,422,397,25,416,6,900,478,385,31,
5,"BIHOR",56,31609,,462,0,"PRIMARIA TARCAIA","TARCAIA",85,31609,0,3,1199,703,677,26,687,16,1120,417,595,92,
5,"BIHOR",56,31609,,463,0,"CAMIN CULTURAL TARCAITA","TARCAIA",85,31609,0,3,550,276,261,15,269,7,610,334,84,185,
5,"BIHOR",56,31654,,464,0,"SC.GEN. TAUTEU","TAUTEU",87,31654,0,3,909,648,628,20,636,12,1000,352,614,22,
5,"BIHOR",56,31654,,465,0,"SC.GEN. CIUTELEC","TAUTEU",87,31654,0,3,657,407,282,125,402,5,720,313,226,176,
5,"BIHOR",56,31654,,466,0,"SC.GEN. BOGEI","TAUTEU",87,31654,0,3,972,631,588,43,619,12,1072,441,438,181,
5,"BIHOR",56,31654,,467,0,"SC.GEN. CHIRIBIS","TAUTEU",87,31654,0,3,559,399,354,45,398,1,610,211,76,322,
5,"BIHOR",56,31654,,468,0,"SC.GEN. POIANA","TAUTEU",87,31654,0,3,173,121,98,23,120,1,190,69,74,46,
5,"BIHOR",56,31716,,469,0,"CAMIN CULTURAL TILEAGD","TILEAGD",89,31716,0,3,1705,881,710,171,866,15,1880,999,511,355,
5,"BIHOR",56,31716,,470,0,"SC.GEN. GARA TILEAGD","TILEAGD",89,31716,0,3,1291,694,547,147,685,9,1410,716,282,403,
5,"BIHOR",56,31716,,471,0,"CAMIN CULTURAL TILECUS","TILEAGD",89,31716,0,3,770,484,427,57,479,5,780,296,160,319,
5,"BIHOR",56,31716,,472,0,"CAMIN CULTURAL POSOLOACA","TILEAGD",89,31716,0,3,303,179,154,25,179,0,330,151,145,34,
5,"BIHOR",56,31716,,473,0,"CAMIN CULTURAL UILEACU DE CRIS","TILEAGD",89,31716,0,3,668,332,284,48,329,3,752,420,195,134,
5,"BIHOR",56,31716,,474,0,"SC.GEN. BALAIA","TILEAGD",89,31716,0,3,630,359,327,32,354,5,690,331,113,241,
5,"BIHOR",56,31789,,475,0,"HOREA 2 - CAMIN CULTURAL","TINCA",90,31789,0,3,1423,874,764,110,862,12,1570,696,606,256,
5,"BIHOR",56,31789,,476,0,"REPUBLICII 36","TINCA",90,31789,0,3,1923,1073,969,104,1060,13,2110,1037,731,329,
5,"BIHOR",56,31789,,477,0,"SC.GEN. GURBEDIU 394","TINCA",90,31789,0,3,966,591,522,69,580,11,1060,469,324,256,
5,"BIHOR",56,31789,,478,0,"SC.GEN. RIPA 344","TINCA",90,31789,0,3,512,307,275,32,297,10,560,253,191,106,
5,"BIHOR",56,31789,,479,0,"SC.GEN. BELFIR 410","TINCA",90,31789,0,3,388,224,196,28,215,9,430,206,190,25,
5,"BIHOR",56,31789,,480,0,"SC.GEN. GIRISU NEGRU 84","TINCA",90,31789,0,3,595,452,364,88,449,3,650,198,241,208,
5,"BIHOR",56,31841,,481,0,"CAMIN CULTURAL TULCA","TULCA",91,31841,0,3,1860,1166,1066,100,1152,14,2052,886,573,579,
5,"BIHOR",56,31841,,482,0,"CAMIN CULTURAL CAUASD","TULCA",91,31841,0,3,357,320,253,67,316,4,390,70,184,132,
5,"BIHOR",56,31878,,483,0,"CAMIN CULTURAL TETCHEA","TETCHEA",88,31878,0,3,1140,507,449,58,504,3,1230,723,318,186,
5,"BIHOR",56,31878,,484,0,"SC.GEN. HOTAR","TETCHEA",88,31878,0,3,1235,627,569,58,618,9,1360,733,183,435,
5,"BIHOR",56,31921,,485,0,"CAMIN CULTURAL UILEACU DE B.","UILEACU DE BEIUS",92,31921,0,3,553,392,344,48,390,2,610,218,289,101,
5,"BIHOR",56,31921,,486,0,"CAMIN CULTURAL FORAU","UILEACU DE BEIUS",92,31921,0,3,842,561,533,28,561,0,940,379,173,388,
5,"BIHOR",56,31921,,487,0,"CAMIN CULTURAL PRISACA","UILEACU DE BEIUS",92,31921,0,3,439,361,343,18,361,0,490,129,235,126,
5,"BIHOR",56,31921,,488,0,"CAMIN CULTURAL VALANI","UILEACU DE BEIUS",92,31921,0,3,249,240,215,25,239,1,280,40,137,102,
5,"BIHOR",56,31976,,489,0,"CAMIN CULTURAL VADU CRISULUI","VADU CRISULUI",93,31976,0,3,1765,724,672,52,710,14,1940,1216,407,303,
5,"BIHOR",56,31976,,490,0,"SC. I-IV VADU CRISULUI","VADU CRISULUI",93,31976,0,3,1373,653,553,100,646,7,1510,857,287,359,
5,"BIHOR",56,31976,,491,0,"SC.GEN. TOMNATIC","VADU CRISULUI",93,31976,0,3,328,163,150,13,163,0,360,197,53,110,
5,"BIHOR",56,32045,,492,0,"PRIMARIA VIISOARA","VIISOARA",95,32045,0,3,868,500,461,39,496,4,960,460,446,50,
5,"BIHOR",56,32045,,493,0,"SC.GEN. IZVOARALE","VIISOARA",95,32045,0,3,215,132,118,14,132,0,230,98,102,30,
5,"BIHOR",56,32090,,494,0,"CAMIN CULTURAL VIRCIOROG","VARCIOROG",94,32090,0,3,951,485,456,29,480,5,1050,565,212,268,
5,"BIHOR",56,32090,,495,0,"GRADINITA SERGHIS","VARCIOROG",94,32090,0,3,534,346,316,30,346,0,590,244,163,183,
5,"BIHOR",56,32090,,496,0,"SC.GEN. FISCA","VARCIOROG",94,32090,0,3,455,348,331,17,348,0,510,162,72,276,
5,"BIHOR",56,26564,,497,1,"GHEORGHE DOJA 65 - SPITAL JUDETEAN","MUNICIPIUL ORADEA",1,26564,1,1,0,436,0,436,434,2,805,369,278,156,
5,"BIHOR",56,26564,,498,1,"GARA CENTRALA SNCFR","MUNICIPIUL ORADEA",1,26564,1,1,0,963,0,963,952,11,1750,787,526,426,
5,"BIHOR",56,26975,,499,1,"SPITALULUI 2-4 - SPITAL UNIFICAT","ORAS SALONTA",6,26975,2,1,0,118,0,118,115,3,150,32,78,37,
5,"BIHOR",56,26975,,500,1,"SARCADULUI 1/A - UNITATE MILITARA","ORAS SALONTA",6,26975,2,1,0,148,0,148,141,7,200,52,56,85,
5,"BIHOR",56,26840,,501,0,"INDEPENDENTEI 31 - GRUP SCOLAR UNIREA","ORAS STEI",7,26840,2,1,1388,732,660,72,724,8,1510,778,383,341,
5,"BIHOR",56,26840,,502,0,"NICOLAE IORGA 28 - SC.GEN.I-VIII","ORAS STEI",7,26840,2,1,1509,842,797,45,829,13,1660,818,468,361,
5,"BIHOR",56,30871,,503,0,"CAMIN CULTURAL SABOLCIU","SACADAT",71,30871,0,3,582,413,361,52,404,9,640,227,170,234,
6,"BISTRITA-NASAUD",65,32394,,1,0,"CASA MUNICIPALA DE CULTUAR ""GEORGE COSBUC""","MUNICIPIUL BISTRITA",1,32394,1,1,1941,1156,1035,121,1094,17,2200,1044,770,324,
6,"BISTRITA-NASAUD",65,32394,,2,0,"SALA DE EXPOZITII ""PIATA MICA""","MUNICIPIUL BISTRITA",1,32394,1,1,1967,953,870,83,934,19,2200,1247,543,391,
6,"BISTRITA-NASAUD",65,32394,,3,0,"SCOALA DE MUZICA, STR. AL. ODOBESCU, NR. 2","MUNICIPIUL BISTRITA",1,32394,1,1,1926,831,761,70,823,8,2200,1369,432,391,
6,"BISTRITA-NASAUD",65,32394,,4,0,"SCOALA GENERALA NR.5 ""LUCIAN BLAGA"", STR. GAROAFEI, NR.8","MUNICIPIUL BISTRITA",1,32394,1,1,1929,896,851,45,889,7,2200,1304,455,434,
6,"BISTRITA-NASAUD",65,32394,,5,0,"GRADINITA NR. 10, B-DUL INDEPENDENTEI, NR. 57","MUNICIPIUL BISTRITA",1,32394,1,1,1997,825,762,63,817,8,2200,1375,404,413,
6,"BISTRITA-NASAUD",65,32394,,6,0,"GRADINITA NR.6, ALEEA SIEULUI, NR. 11B","MUNICIPIUL BISTRITA",1,32394,1,1,1574,664,614,50,658,6,1800,1136,347,311,
6,"BISTRITA-NASAUD",65,32394,,7,0,"SCOALA GENERALA NR.1, SEDIUL VECHI, B-DUL INDEPENDENTEI, NR. 46","MUNICIPIUL BISTRITA",1,32394,1,1,1439,607,542,65,596,11,1602,995,341,255,
6,"BISTRITA-NASAUD",65,32394,,8,0,"SCOALA GENERALA NR.1, STR. IMPARATUL TRAIAN (SEDIUL NOU)","MUNICIPIUL BISTRITA",1,32394,1,1,2111,1062,997,65,1052,10,2400,1338,737,315,
6,"BISTRITA-NASAUD",65,32394,,9,0,"SCOALA PROFESIONALA NR.17, SF. MARIA, B-DUL INDEPENDENTEI, NR.23","MUNICIPIUL BISTRITA",1,32394,1,1,2045,1081,859,222,1076,5,2300,1219,615,461,
6,"BISTRITA-NASAUD",65,32394,,10,0,"SCOALA GENERALA NR.2, STR. TOAMNEI (SEDIUL NOU)","MUNICIPIUL BISTRITA",1,32394,1,1,1513,712,668,44,706,6,1700,988,445,261,
6,"BISTRITA-NASAUD",65,32394,,11,0,"SCOALA GENERALA NR.2 (SEDIUL VECHI), STR. AL. ODOBESCU, NR.9","MUNICIPIUL BISTRITA",1,32394,1,1,1623,728,674,54,721,7,1800,1072,381,340,
6,"BISTRITA-NASAUD",65,32394,,12,0,"LICEUL IND. NR.1 - INTERNAT, STR. RODNEI, NR.23","MUNICIPIUL BISTRITA",1,32394,1,1,1932,907,698,209,903,4,2200,1293,392,511,
6,"BISTRITA-NASAUD",65,32394,,13,0,"LICEUL IND. NR.1, STR. RODNEI, NR. 23","MUNICIPIUL BISTRITA",1,32394,1,1,1961,931,867,64,923,8,2200,1269,465,458,
6,"BISTRITA-NASAUD",65,32394,,14,0,"GRADINITA NR.14, STR. RODNEI, NR.3","MUNICIPIUL BISTRITA",1,32394,1,1,1587,818,722,96,808,10,1800,982,417,391,
6,"BISTRITA-NASAUD",65,32394,,15,0,"GRADINITA NR.15, STR. ZIMBRULUI, NR. 19","MUNICIPIUL BISTRITA",1,32394,1,1,1313,727,600,127,716,11,1500,773,429,287,
6,"BISTRITA-NASAUD",65,32394,,16,0,"GRUP SC. FORESTIER, STR. ZEFIRULUI, NR.1","MUNICIPIUL BISTRITA",1,32394,1,1,1747,882,725,157,871,11,2000,1118,443,428,
6,"BISTRITA-NASAUD",65,32394,,17,0,"GRADINITA NR.11, STR. ZIMBRULUI, NR.9","MUNICIPIUL BISTRITA",1,32394,1,1,1636,702,624,78,694,8,1800,1098,365,329,
6,"BISTRITA-NASAUD",65,32394,,18,0,"COLEGIUL NATIONAL ""A. MURESANU"", B-DUL REPUBLICII, NR.26","MUNICIPIUL BISTRITA",1,32394,1,1,1729,812,735,77,802,10,1900,1088,465,337,
6,"BISTRITA-NASAUD",65,32394,,19,0,"SCOALA GENERALA ""A. MURESANU"", B-DUL REPUBLICII, NR. 10","MUNICIPIUL BISTRITA",1,32394,1,1,1679,808,754,54,795,13,1900,1092,547,248,
6,"BISTRITA-NASAUD",65,32394,,20,0,"COLEGIUL NATIONAL ""L. REBREANU"", B-DUL REPUBLICII, NR.8","MUNICIPIUL BISTRITA",1,32394,1,1,1554,697,652,45,690,7,1800,1103,444,246,
6,"BISTRITA-NASAUD",65,32394,,21,0,"SCOALA GENERALA ""L. REBREANU"", STR. URSULUI, NR.3","MUNICIPIUL BISTRITA",1,32394,1,1,2022,836,761,75,825,11,2300,1464,384,441,
6,"BISTRITA-NASAUD",65,32394,,22,0,"GRADINITA NR.9, STR. CRINIOR, NR.4","MUNICIPIUL BISTRITA",1,32394,1,1,1992,1090,1009,81,1080,10,2200,1110,692,388,
6,"BISTRITA-NASAUD",65,32394,,23,0,"SCOALA GENERALA NR.4, SEDIUL 1, STR. FLORILOR 3-5","MUNICIPIUL BISTRITA",1,32394,1,1,2038,958,908,50,944,14,2302,1344,447,497,
6,"BISTRITA-NASAUD",65,32394,,24,0,"SCOALA GENERALA NR.4, SEDIUL 2, STR. FLORILOR 3-5","MUNICIPIUL BISTRITA",1,32394,1,1,2180,1077,988,89,1071,6,2401,1324,577,494,
6,"BISTRITA-NASAUD",65,32394,,25,0,"COLEGIUL EUROPEAN APL ""APOLLO"", STR. A. MURESANU, NR. 3-5","MUNICIPIUL BISTRITA",1,32394,1,1,1872,908,815,93,906,2,2100,1192,508,398,
6,"BISTRITA-NASAUD",65,32394,,26,0,"GRADINITA NR. 13, STR. P. ISPIRESCU, NR.1","MUNICIPIUL BISTRITA",1,32394,1,1,1950,1003,960,43,989,14,2200,1197,647,342,
6,"BISTRITA-NASAUD",65,32394,,27,0,"SCOALA GENERALA NR.3, AVRAM IANCU, STR. 1 DECEMBRIE, NR.27","MUNICIPIUL BISTRITA",1,32394,1,1,2012,956,856,100,948,8,2300,1344,515,433,
6,"BISTRITA-NASAUD",65,32394,,28,0,"GRADINITA NR.4, STR. BARGAULUI, NR.12","MUNICIPIUL BISTRITA",1,32394,1,1,2101,894,834,60,886,8,2400,1506,438,448,
6,"BISTRITA-NASAUD",65,32394,,29,0,"GRUP SCOLAR DE INFORMATICA, ELECTRONICA SI ELECTROTEHNICA - SEDIUL 1 - STR. CALEA MOLDOVEI, NR. 20","MUNICIPIUL BISTRITA",1,32394,1,1,2032,806,742,64,797,9,2300,1494,440,357,
6,"BISTRITA-NASAUD",65,32394,,30,0,"GRUP SCOLAR SPORTIV, STR. CALEA MOLDOVEI, NR.18","MUNICIPIUL BISTRITA",1,32394,1,1,1773,888,779,109,886,2,2000,1112,420,466,
6,"BISTRITA-NASAUD",65,32394,,31,0,"GRUP SCOLAR SPORTIV - INTERNAT - STR. GRANICERILOR, NR.9","MUNICIPIUL BISTRITA",1,32394,1,1,1933,1306,816,490,1293,13,2200,894,771,522,
6,"BISTRITA-NASAUD",65,32394,,32,0,"GRADINITA NR.3, AL. PLAIESULUI, NR.2","MUNICIPIUL BISTRITA",1,32394,1,1,1882,732,646,86,729,3,2200,1468,399,330,
6,"BISTRITA-NASAUD",65,32394,,33,0,"GRADINITA NR.7, STR. C.R. VIVU, NR. 29","MUNICIPIUL BISTRITA",1,32394,1,1,2000,985,868,117,968,17,2200,1215,542,426,
6,"BISTRITA-NASAUD",65,32394,,34,0,"FLORARIE, STR. CALEA MOLDOVEI, BL.2","MUNICIPIUL BISTRITA",1,32394,1,1,1316,918,641,277,908,10,1500,582,447,461,
6,"BISTRITA-NASAUD",65,32394,,35,0,"SCOALA GENERALA UNIREA","MUNICIPIUL BISTRITA",1,32394,1,1,1212,643,547,96,635,8,1400,757,289,346,
6,"BISTRITA-NASAUD",65,32394,,36,0,"SCOALA GENERALA GHINDA","MUNICIPIUL BISTRITA",1,32394,1,1,479,297,234,63,294,3,600,303,112,182,
6,"BISTRITA-NASAUD",65,32394,,37,0,"SCOALA GENERALA ""DIMITRIE COJOCARU"" SLATINITA","MUNICIPIUL BISTRITA",1,32394,1,1,455,287,224,63,282,5,500,213,117,165,
6,"BISTRITA-NASAUD",65,32394,,38,0,"SCOALA GENERALA SIGMIR","MUNICIPIUL BISTRITA",1,32394,1,1,443,379,240,139,373,6,500,121,174,199,
6,"BISTRITA-NASAUD",65,32394,,39,0,"SCOALA GENERALA SARATA","MUNICIPIUL BISTRITA",1,32394,1,1,647,389,310,79,383,6,800,411,240,143,
6,"BISTRITA-NASAUD",65,32394,,40,0,"SCOALA GENERALA VIISOARA","MUNICIPIUL BISTRITA",1,32394,1,1,917,513,432,81,509,4,1000,487,226,283,
6,"BISTRITA-NASAUD",65,32394,,41,1,"CERCUL MILITAR, STR. PARCULUI, NR.2","MUNICIPIUL BISTRITA",1,32394,1,1,0,403,0,403,393,10,500,97,192,201,
6,"BISTRITA-NASAUD",65,32483,,42,0,"PRIMARIA BECLEAN, STR. 1 DECEMBRIE 1918, NR.5","ORAS BECLEAN",2,32483,2,1,1307,577,530,47,573,4,1500,923,331,242,
6,"BISTRITA-NASAUD",65,32483,,43,0,"CAMIN SPITAL BECLEAN, STR. 1 DECEMBRIE 1918, NR. 43","ORAS BECLEAN",2,32483,2,1,1133,628,493,135,622,6,1300,672,340,282,
6,"BISTRITA-NASAUD",65,32483,,44,0,"CLUBUL ELEVILOR, STR. ALEEA GARII, NR.10","ORAS BECLEAN",2,32483,2,1,1702,814,735,79,808,6,1900,1086,427,381,
6,"BISTRITA-NASAUD",65,32483,,45,0,"SCOALA GENERALA GRIGORE SILASI, STR. PIATA LIBERTATII, NR.19","ORAS BECLEAN",2,32483,2,1,1573,717,656,61,705,12,1800,1083,438,267,
6,"BISTRITA-NASAUD",65,32483,,46,0,"CASA DE CULTURA, STR. ALEEA GHIOCELULUI, NR.2","ORAS BECLEAN",2,32483,2,1,1325,589,551,38,581,8,1500,911,343,238,
6,"BISTRITA-NASAUD",65,32483,,47,0,"SCOALA GENERALA BECLENUT","ORAS BECLEAN",2,32483,2,1,279,155,139,16,152,3,400,245,60,92,
6,"BISTRITA-NASAUD",65,32483,,48,0,"SCOALA GENERALA COLDAU","ORAS BECLEAN",2,32483,2,1,534,275,235,40,274,1,600,325,190,84,
6,"BISTRITA-NASAUD",65,32483,,49,0,"SCOALA GENERALA FIGA","ORAS BECLEAN",2,32483,2,1,377,226,200,26,223,3,500,274,99,124,
6,"BISTRITA-NASAUD",65,32483,,50,0,"SCOALA GENERALA RUSU DE JOS","ORAS BECLEAN",2,32483,2,1,285,177,157,20,176,1,400,223,96,80,
6,"BISTRITA-NASAUD",65,32544,,51,0,"CASA ORASENEASCA DE CULTURA, PIATA UNIRII, NR.7","ORAS NASAUD",3,32544,2,1,2174,1044,928,116,1022,22,2500,1456,521,501,
6,"BISTRITA-NASAUD",65,32544,,52,0,"GRUP SCOLAR SILVIC, STR. GARII, NR.1","ORAS NASAUD",3,32544,2,1,2519,986,912,74,978,8,2800,1814,474,504,
6,"BISTRITA-NASAUD",65,32544,,53,0,"POLICLINICA VECHE","ORAS NASAUD",3,32544,2,1,2298,1420,1204,216,1401,19,2600,1180,835,566,
6,"BISTRITA-NASAUD",65,32544,,54,0,"CAMIN CULTURAL LUSCA","ORAS NASAUD",3,32544,2,1,531,275,255,20,274,1,603,328,121,153,
6,"BISTRITA-NASAUD",65,32544,,55,0,"SCOALA GENERALA, STR. GEORGE COSBUC, NR. 184","ORAS NASAUD",3,32544,2,1,902,483,451,32,477,6,1000,517,219,258,
6,"BISTRITA-NASAUD",65,32544,,56,0,"CAMIN CULTURAL LIVIU REBREANU","ORAS NASAUD",3,32544,2,1,639,503,456,47,496,7,800,297,180,316,
6,"BISTRITA-NASAUD",65,32599,,57,0,"SCOALA GENERALA NR.1, STR. REPUBLICII, NR.38","ORAS SANGEORZ-BAI",4,32599,2,1,1842,832,771,61,828,4,2100,1268,381,447,
6,"BISTRITA-NASAUD",65,32599,,58,0,"CLUBUL TINERETULUI, STR. CARPATI, NR.8","ORAS SANGEORZ-BAI",4,32599,2,1,1741,879,842,37,872,7,2000,1121,263,609,
6,"BISTRITA-NASAUD",65,32599,,59,0,"VILA NR.13, STR. IZVOARELOR, NR. 96","ORAS SANGEORZ-BAI",4,32599,2,1,1772,792,671,121,783,9,2000,1208,338,445,
6,"BISTRITA-NASAUD",65,32599,,60,0,"SCOALA GENERALA, STR. TEILOR, NR.4","ORAS SANGEORZ-BAI",4,32599,2,1,1732,682,643,39,677,5,2000,1313,253,424,
6,"BISTRITA-NASAUD",65,32599,,61,0,"SCOALA GENERALA CORMAIA, CORMAIA, NR.138","ORAS SANGEORZ-BAI",4,32599,2,1,507,242,228,14,240,2,600,358,120,120,
6,"BISTRITA-NASAUD",65,32633,,62,0,"PRIMARIA BISTRITA-BARGAULUI","BISTRITA BARGAULUI",5,32633,0,3,1415,834,620,214,822,12,1600,766,267,555,
6,"BISTRITA-NASAUD",65,32633,,63,0,"SCOALA GENERALA NR.2, BISTRITA-BARGAULUI","BISTRITA BARGAULUI",5,32633,0,3,1611,856,575,281,844,12,1800,944,220,624,
6,"BISTRITA-NASAUD",65,32633,,64,0,"SCOALA GENERALA COLIBITA","BISTRITA BARGAULUI",5,32633,0,3,266,158,90,68,156,2,400,242,52,104,
6,"BISTRITA-NASAUD",65,32660,,65,0,"CAMIN CULTURAL BRANISTEA","BRANISTEA",6,32660,0,3,1038,473,455,18,466,7,1200,727,324,142,
6,"BISTRITA-NASAUD",65,32660,,66,0,"CAMIN CULTURAL CIRESOAIA","BRANISTEA",6,32660,0,3,1340,551,526,25,547,4,1500,949,532,15,
6,"BISTRITA-NASAUD",65,32660,,67,0,"CAMIN CULTURAL MALUT","BRANISTEA",6,32660,0,3,533,268,245,23,258,10,600,332,143,115,
6,"BISTRITA-NASAUD",65,32704,,68,0,"PRIMARIA BUDACU DE JOS","BUDACU DE JOS",7,32704,0,3,1123,554,484,70,547,7,1300,746,295,252,
6,"BISTRITA-NASAUD",65,32704,,69,0,"GRADINITA JELNA","BUDACU DE JOS",7,32704,0,3,569,343,276,67,338,5,700,357,132,206,
6,"BISTRITA-NASAUD",65,32704,,70,0,"CAMIN CULTURAL MONARIU","BUDACU DE JOS",7,32704,0,3,299,211,183,28,209,2,400,189,53,156,
6,"BISTRITA-NASAUD",65,32704,,71,0,"SCOALA GENERALA SIMIONESTI","BUDACU DE JOS",7,32704,0,3,170,148,117,31,147,1,200,52,66,81,
6,"BISTRITA-NASAUD",65,32768,,72,0,"CAMIN CULTURAL BUDESTI","BUDESTI",8,32768,0,3,698,352,288,64,348,4,800,448,174,174,
6,"BISTRITA-NASAUD",65,32768,,73,0,"SCOALA GENERALA BUDESTI-FANATE","BUDESTI",8,32768,0,3,202,214,124,90,209,5,300,86,70,139,
6,"BISTRITA-NASAUD",65,32768,,74,0,"CAMIN CULTURAL TAGU","BUDESTI",8,32768,0,3,597,311,268,43,308,3,700,389,140,168,
6,"BISTRITA-NASAUD",65,32768,,75,0,"SCOALA GENERALA TAGSOR","BUDESTI",8,32768,0,3,270,188,132,56,187,1,300,112,84,103,
6,"BISTRITA-NASAUD",65,32811,,76,0,"PRIMARIA CAIANU MIC","CAIANU MIC",9,32811,0,3,1186,547,516,31,540,7,1400,853,277,263,
6,"BISTRITA-NASAUD",65,32811,,77,0,"SCOALA GENERALA CAIANU MARE","CAIANU MIC",9,32811,0,3,525,252,218,34,251,1,600,348,150,101,
6,"BISTRITA-NASAUD",65,32811,,78,0,"GRADINITA DOBRIC","CAIANU MIC",9,32811,0,3,781,356,330,26,353,3,900,544,229,124,
6,"BISTRITA-NASAUD",65,32811,,79,0,"SCOALA GENERALA CICEU-POIENI","CAIANU MIC",9,32811,0,3,666,386,348,38,377,9,800,414,113,264,
6,"BISTRITA-NASAUD",65,32811,,80,0,"SCOALA GENERALA DOBRICEL","CAIANU MIC",9,32811,0,3,506,292,270,22,291,1,599,307,108,183,
6,"BISTRITA-NASAUD",65,32811,,81,0,"SCOALA DUMBRAVITA","CAIANU MIC",9,32811,0,3,593,329,289,40,325,4,700,371,129,196,
6,"BISTRITA-NASAUD",65,32884,,82,0,"SCOALA GENERALA PIETRIS","CETATE",10,32884,0,3,1369,685,608,77,683,2,1600,915,204,479,
6,"BISTRITA-NASAUD",65,32884,,83,0,"CAMIN CULTURAL ORHEIUL BISTRITEI","CETATE",10,32884,0,3,384,236,193,43,235,1,500,264,118,117,
6,"BISTRITA-NASAUD",65,32884,,84,0,"SEDIUL COOP. DUMITRITA","CETATE",10,32884,0,3,776,401,346,55,392,9,900,499,132,260,
6,"BISTRITA-NASAUD",65,32884,,85,0,"SCOALA GENERALA BUDACU DE SUS","CETATE",10,32884,0,3,1188,632,540,92,628,4,1400,768,84,544,
6,"BISTRITA-NASAUD",65,32955,,86,0,"SCOALA GENERALA CICEU GIURGESTI","CICEU-GIURGESTI",13,32955,0,3,891,426,385,41,419,7,1000,574,176,243,
6,"BISTRITA-NASAUD",65,32955,,87,0,"SCOALA GENERALA DUMBRAVENI","CICEU-GIURGESTI",13,32955,0,3,655,317,275,42,314,3,800,483,131,183,
6,"BISTRITA-NASAUD",65,32955,,88,0,"SCOALA GENERALA NEGRILESTI","CICEU-GIURGESTI",13,32955,0,3,1200,689,615,74,683,6,1400,711,251,432,
6,"BISTRITA-NASAUD",65,32955,,89,0,"SCOALA GENERALA BREAZA","CICEU-GIURGESTI",13,32955,0,3,838,443,421,22,443,0,1000,557,114,329,
6,"BISTRITA-NASAUD",65,33015,,90,0,"CAMIN CULTURAL BOZIES","CHIOCHIS",11,33015,0,3,1000,422,389,33,419,3,1000,578,255,164,
6,"BISTRITA-NASAUD",65,33015,,91,0,"PRIMARIE CHIOCHIS","CHIOCHIS",11,33015,0,3,890,406,360,46,402,4,1000,594,278,124,
6,"BISTRITA-NASAUD",65,33015,,92,0,"CAMIN CULTURAL SANICOARA","CHIOCHIS",11,33015,0,3,334,113,91,22,112,1,400,287,42,70,
6,"BISTRITA-NASAUD",65,33015,,93,0,"FOST SEDIU CAP JIMBOR","CHIOCHIS",11,33015,0,3,471,330,269,61,313,17,600,270,168,145,
6,"BISTRITA-NASAUD",65,33015,,94,0,"SCOALA GENERALA MANIC","CHIOCHIS",11,33015,0,3,406,195,175,20,194,1,500,305,88,106,
6,"BISTRITA-NASAUD",65,33122,,95,0,"CAMIN CULTURAL CHIUZA","CHIUZA",12,33122,0,3,695,421,391,30,420,1,800,379,165,255,
6,"BISTRITA-NASAUD",65,33122,,96,0,"CAMIN CULTURAL SASARM","CHIUZA",12,33122,0,3,562,363,326,37,356,7,701,338,111,245,
6,"BISTRITA-NASAUD",65,33122,,97,0,"CAMIN CULTURAL PIATRA","CHIUZA",12,33122,0,3,405,272,247,25,262,10,500,228,128,134,
6,"BISTRITA-NASAUD",65,33122,,98,0,"SCOALA GENERALA MIRES","CHIUZA",12,33122,0,3,128,115,93,22,114,1,200,85,59,55,
6,"BISTRITA-NASAUD",65,33177,,99,0,"SCOALA GENERALA COSBUC","COSBUC",14,33177,0,3,1592,917,872,45,912,5,1800,883,342,570,
6,"BISTRITA-NASAUD",65,33177,,100,0,"SCOALA GENERALA BICHIGIU","COSBUC",14,33177,0,3,867,361,319,42,349,12,1000,639,61,288,
6,"BISTRITA-NASAUD",65,33202,,101,0,"SCOALA GENERALA DUMITRA","DUMITRA",15,33202,0,3,1990,930,891,39,917,13,2200,1270,284,633,
6,"BISTRITA-NASAUD",65,33202,,102,0,"SCOALA GENERALA CEPARI","DUMITRA",15,33202,0,3,615,338,295,43,333,5,700,362,74,259,
6,"BISTRITA-NASAUD",65,33202,,103,0,"SCOALA GENERALA TARPIU","DUMITRA",15,33202,0,3,707,324,278,46,319,5,800,476,120,199,
6,"BISTRITA-NASAUD",65,33248,,104,0,"CAMIN CULTURAL FELDRU","FELDRU",16,33248,0,3,1073,523,344,179,514,9,1200,677,101,413,
6,"BISTRITA-NASAUD",65,33248,,105,0,"PRIMARIA FELDRU","FELDRU",16,33248,0,3,1506,610,491,119,605,5,1700,1090,115,490,
6,"BISTRITA-NASAUD",65,33248,,106,0,"SCOALA GENERALA 1 FELDRU","FELDRU",16,33248,0,3,1902,760,580,180,751,9,2100,1340,223,528,
6,"BISTRITA-NASAUD",65,33248,,107,0,"SCOALA GENERALA NEPOS","FELDRU",16,33248,0,3,1273,594,521,73,585,9,1400,806,193,392,
6,"BISTRITA-NASAUD",65,33275,,108,0,"CAMIN CULTURAL GALATII BISTRITEI","GALATII BISTRITEI",17,33275,0,3,502,361,297,64,357,4,600,239,178,179,
6,"BISTRITA-NASAUD",65,33275,,109,0,"SCOALA GENERALA DIPSA","GALATII BISTRITEI",17,33275,0,3,664,447,386,61,444,3,800,353,192,252,
6,"BISTRITA-NASAUD",65,33275,,110,0,"CAMIN CULTURAL HERINA","GALATII BISTRITEI",17,33275,0,3,383,271,210,61,267,4,500,229,187,80,
6,"BISTRITA-NASAUD",65,33275,,111,0,"SCOALA GENERALA ALBESTII BISTRITEI","GALATII BISTRITEI",17,33275,0,3,149,133,101,32,129,4,200,67,64,65,
6,"BISTRITA-NASAUD",65,33275,,112,0,"SCOALA GENERALA TONCIU","GALATII BISTRITEI",17,33275,0,3,204,180,148,32,178,2,300,120,164,14,
6,"BISTRITA-NASAUD",65,33337,,113,0,"PRIMARIA ILVA MARE","ILVA MARE",18,33337,0,3,2008,886,798,88,881,5,2296,1410,283,598,
6,"BISTRITA-NASAUD",65,33364,,114,0,"PRIMARIA ILVA MICA","ILVA MICA",19,33364,0,3,1409,611,521,90,605,6,1600,989,191,414,
6,"BISTRITA-NASAUD",65,33364,,115,0,"SCOALA GENERALA NR.1, ILVA MICA","ILVA MICA",19,33364,0,3,1364,713,581,132,707,6,1500,787,102,605,
6,"BISTRITA-NASAUD",65,33382,,116,0,"CAMIN CULTURAL JOSENII BARGAULUI","JOSENII BARGAULUI",20,33382,0,3,2837,1351,1234,117,1338,13,3200,1849,508,830,
6,"BISTRITA-NASAUD",65,33382,,117,0,"SCOALA GENERALA RUSU BARGAULUI","JOSENII BARGAULUI",20,33382,0,3,899,514,438,76,512,2,1000,486,242,270,
6,"BISTRITA-NASAUD",65,33435,,118,0,"PRIMARIA LECHINTA","LECHINTA",21,33435,0,3,2099,1156,1037,119,1147,9,2400,1244,588,559,
6,"BISTRITA-NASAUD",65,33435,,119,0,"SCOALA GENERALA CHIRALES","LECHINTA",21,33435,0,3,392,213,176,37,213,0,500,287,92,121,
6,"BISTRITA-NASAUD",65,33435,,120,0,"CAMIN CULTURAL SANIACOB","LECHINTA",21,33435,0,3,181,176,131,45,174,2,200,24,71,103,
6,"BISTRITA-NASAUD",65,33435,,121,0,"SCOALA GENERALA TIGAU","LECHINTA",21,33435,0,3,341,206,177,29,206,0,400,194,176,30,
6,"BISTRITA-NASAUD",65,33435,,122,0,"CAMIN CULTURAL VERMES","LECHINTA",21,33435,0,3,680,376,310,66,368,8,799,423,241,127,
6,"BISTRITA-NASAUD",65,33435,,123,0,"CAMIN CULTURAL SANGEORZU-NOU","LECHINTA",21,33435,0,3,805,432,360,72,420,12,900,468,169,251,
6,"BISTRITA-NASAUD",65,33514,,124,0,"PRIMARIA LESU","LESU",22,33514,0,3,2283,962,920,42,957,5,2600,1638,185,772,
6,"BISTRITA-NASAUD",65,33541,,125,0,"PRIMARIA LIVEZILE","LIVEZILE",23,33541,0,3,1996,894,789,105,885,9,2200,1306,381,504,
6,"BISTRITA-NASAUD",65,33541,,126,0,"CAMIN CULTURAL DOROLEA","LIVEZILE",23,33541,0,3,638,357,295,62,355,2,700,343,143,212,
6,"BISTRITA-NASAUD",65,33541,,127,0,"CAMIN CULTURAL CUSMA","LIVEZILE",23,33541,0,3,463,308,255,53,308,0,600,292,45,263,
6,"BISTRITA-NASAUD",65,33603,,128,0,"PRIMARIA LUNCA ILVEI","LUNCA ILVEI",24,33603,0,3,2601,1124,971,153,1111,13,2900,1776,373,738,
6,"BISTRITA-NASAUD",65,33603,,129,1,"UM LARION","LUNCA ILVEI",24,33603,0,3,0,147,0,147,147,0,200,53,79,68,
6,"BISTRITA-NASAUD",65,33621,,130,0,"SCOALA GENERALA MAIERU","MAIERU",26,33621,0,3,2144,907,874,33,904,3,2400,1493,336,568,
6,"BISTRITA-NASAUD",65,33621,,131,0,"CAMIN CULTURAL MAIERU","MAIERU",26,33621,0,3,2360,1000,954,46,994,6,2600,1600,382,612,
6,"BISTRITA-NASAUD",65,33621,,132,0,"SCOALA GENERALA ANIES","MAIERU",26,33621,0,3,996,599,440,159,595,4,1100,501,224,371,
6,"BISTRITA-NASAUD",65,33658,,133,0,"SCOALA GENERALA MATEI","MATEI",28,33658,0,3,825,474,417,57,462,12,1000,526,369,93,
6,"BISTRITA-NASAUD",65,33658,,134,0,"SCOALA GENERALA FANTANELE","MATEI",28,33658,0,3,567,303,275,28,301,2,1200,897,231,70,
6,"BISTRITA-NASAUD",65,33658,,135,0,"SCOALA GENERALA CORVINESTI","MATEI",28,33658,0,3,704,440,416,24,436,4,800,360,164,272,
6,"BISTRITA-NASAUD",65,33658,,136,0,"SCOALA GENERALA BIDIU","MATEI",28,33658,0,3,484,350,302,48,348,2,600,250,114,234,
6,"BISTRITA-NASAUD",65,33729,,137,0,"PRIMARIA MAGURA ILVEI","MAGURA ILVEI",25,33729,0,3,1530,714,687,27,710,4,1700,986,278,432,
6,"BISTRITA-NASAUD",65,33729,,138,0,"DISPENSAR POIANA ILVEI","MAGURA ILVEI",25,33729,0,3,1265,728,678,50,722,6,1400,672,338,384,
6,"BISTRITA-NASAUD",65,33729,,139,0,"SCOALA 4 CLASE ARSITA","MAGURA ILVEI",25,33729,0,3,330,194,174,20,192,2,400,206,71,121,
6,"BISTRITA-NASAUD",65,33765,,140,0,"SCOALA GENERALA DOMNESTI","MARISELU",27,33765,0,3,550,403,302,101,393,10,700,297,217,176,
6,"BISTRITA-NASAUD",65,33765,,141,0,"PRIMARIA MARISELU","MARISELU",27,33765,0,3,589,360,301,59,355,5,698,338,95,260,
6,"BISTRITA-NASAUD",65,33765,,142,0,"FOST SEDIU CAP JEICA","MARISELU",27,33765,0,3,99,107,65,42,107,0,200,93,103,4,
6,"BISTRITA-NASAUD",65,33765,,143,0,"GRADINITA SANTIOANA","MARISELU",27,33765,0,3,759,456,427,29,451,5,900,444,181,270,
6,"BISTRITA-NASAUD",65,33845,,144,0,"CAMIN CULTURAL MICESTI","MICESTII DE CAMPIE",29,33845,0,3,353,232,206,26,229,3,400,168,140,89,
6,"BISTRITA-NASAUD",65,33845,,145,0,"SCOALA GENERALA FANTANITA","MICESTII DE CAMPIE",29,33845,0,3,431,207,190,17,202,5,500,293,120,82,
6,"BISTRITA-NASAUD",65,33845,,146,0,"CAMIN CULTURAL VISUIA","MICESTII DE CAMPIE",29,33845,0,3,464,245,225,20,239,6,600,355,114,125,
6,"BISTRITA-NASAUD",65,33881,,147,0,"PRIMARIA MILAS","MILAS",30,33881,0,3,757,429,364,65,424,5,900,471,219,205,
6,"BISTRITA-NASAUD",65,33881,,148,0,"SCOALA GENERALA OROSFAIA","MILAS",30,33881,0,3,572,323,272,51,319,4,700,377,163,156,
6,"BISTRITA-NASAUD",65,33952,,149,0,"CAMIN CULTURAL MONOR","MONOR",31,33952,0,3,1429,732,684,48,719,13,1600,868,326,393,
6,"BISTRITA-NASAUD",65,33989,,150,0,"CAMIN CULTURAL NIMIGEA DE JOS","NIMIGEA",32,33989,0,3,1258,582,531,51,574,8,1400,818,404,170,
6,"BISTRITA-NASAUD",65,33989,,151,0,"SCOALA GENERALA MOCOD","NIMIGEA",32,33989,0,3,573,298,275,23,295,3,700,402,127,168,
6,"BISTRITA-NASAUD",65,33989,,152,0,"SCOALA GENERALA MITITEI","NIMIGEA",32,33989,0,3,605,348,318,30,344,4,700,352,148,196,
6,"BISTRITA-NASAUD",65,33989,,153,0,"SCOALA GENERALA NIMIGEA DE SUS","NIMIGEA",32,33989,0,3,503,357,330,27,323,34,600,243,107,216,
6,"BISTRITA-NASAUD",65,33989,,154,0,"SCOALA GENERALA MINTIU","NIMIGEA",32,33989,0,3,406,236,210,26,229,7,500,264,67,162,
6,"BISTRITA-NASAUD",65,33989,,155,0,"SCOALA GENERALA TAURE","NIMIGEA",32,33989,0,3,421,279,257,22,275,4,500,221,155,120,
6,"BISTRITA-NASAUD",65,33989,,156,0,"SCOALA GENERALA MOGOSENI","NIMIGEA",32,33989,0,3,250,165,141,24,164,1,300,135,51,113,
6,"BISTRITA-NASAUD",65,33989,,157,0,"SCOALA GENERALA FLORESTI","NIMIGEA",32,33989,0,3,357,231,200,31,226,5,400,169,96,130,
6,"BISTRITA-NASAUD",65,34075,,158,0,"PRIMARIA NUSENI","NUSENI",33,34075,0,3,1000,467,415,52,461,6,1100,633,245,216,
6,"BISTRITA-NASAUD",65,34075,,159,0,"SCOALA GENERALA MALIN","NUSENI",33,34075,0,3,444,263,236,27,254,9,500,237,163,91,
6,"BISTRITA-NASAUD",65,34075,,160,0,"SCOALA GENERALA FELEAC","NUSENI",33,34075,0,3,334,233,211,22,231,2,400,167,100,131,
6,"BISTRITA-NASAUD",65,34075,,161,0,"CAMIN CULTURAL BEUDIU","NUSENI",33,34075,0,3,551,342,302,40,341,1,700,358,165,176,
6,"BISTRITA-NASAUD",65,34075,,162,0,"SCOALA GENERALA VITA","NUSENI",33,34075,0,3,364,171,153,18,164,7,400,229,146,18,
6,"BISTRITA-NASAUD",65,34155,,163,0,"CAMIN CULTURAL PARVA","PARVA",34,34155,0,3,1792,628,615,13,618,10,2001,1373,161,457,
6,"BISTRITA-NASAUD",65,34173,,164,0,"PRIMARIA PETRU RARES","PETRU RARES",35,34173,0,3,2060,996,935,61,985,11,2300,1304,522,463,
6,"BISTRITA-NASAUD",65,34173,,165,0,"SCOALA GENERALA BATA","PETRU RARES",35,34173,0,3,660,411,371,40,410,1,800,389,271,139,
6,"BISTRITA-NASAUD",65,34173,,166,0,"SCOALA GENERALA CICEU MIHAIESTI","PETRU RARES",35,34173,0,3,687,394,315,79,391,3,800,406,205,186,
6,"BISTRITA-NASAUD",65,34173,,167,0,"SCOALA GENERALA LELESTI","PETRU RARES",35,34173,0,3,175,152,116,36,149,3,200,48,68,81,
6,"BISTRITA-NASAUD",65,34173,,168,0,"SCOALA GENERALA CICEU CORABIA","PETRU RARES",35,34173,0,3,172,146,104,42,143,3,200,54,59,84,
6,"BISTRITA-NASAUD",65,34235,,169,0,"CAMIN CULTURAL PRUNDU BARGAULUI","PRUNDU BARGAULUI",36,34235,0,3,2906,1507,1287,220,1489,18,3300,1783,498,991,
6,"BISTRITA-NASAUD",65,34235,,170,0,"CANTINA HICART","PRUNDU BARGAULUI",36,34235,0,3,1157,686,448,238,680,6,1304,618,297,383,
6,"BISTRITA-NASAUD",65,34235,,171,0,"CAMIN SUSENI","PRUNDU BARGAULUI",36,34235,0,3,1017,635,497,138,631,4,1200,565,190,441,
6,"BISTRITA-NASAUD",65,34262,,172,0,"SCOALA GENERALA REBRA","REBRA",37,34262,0,3,1956,789,763,26,782,7,2200,1411,169,613,
6,"BISTRITA-NASAUD",65,34280,,173,0,"CAMIN CULTURAL REBRISOARA","REBRISOARA",38,34280,0,3,2016,963,776,187,959,4,1900,937,381,578,
6,"BISTRITA-NASAUD",65,34280,,174,0,"SCOALA GENERALA NR.2","REBRISOARA",38,34280,0,3,1269,1153,860,293,1145,8,1400,247,686,459,
6,"BISTRITA-NASAUD",65,34280,,175,0,"SCOALA GENERALA GERSA 1","REBRISOARA",38,34280,0,3,320,470,164,306,468,2,800,330,59,409,
6,"BISTRITA-NASAUD",65,34280,,176,0,"SCOALA GENERALA VALEA BABII","REBRISOARA",38,34280,0,3,131,150,59,91,150,0,200,50,56,94,
6,"BISTRITA-NASAUD",65,34333,,177,0,"SCOALA GENERALA NR.2 RODNA","RODNA",39,34333,0,3,1994,995,819,176,987,8,2200,1205,472,515,
6,"BISTRITA-NASAUD",65,34333,,178,0,"PRIMARIA RODNA","RODNA",39,34333,0,3,1585,919,691,228,910,9,1800,881,431,479,
6,"BISTRITA-NASAUD",65,34333,,179,0,"CAMIN CULTURAL RODNA","RODNA",39,34333,0,3,961,446,301,145,438,8,1100,654,216,222,
6,"BISTRITA-NASAUD",65,34333,,180,0,"SCOALA VALEA VINULUI","RODNA",39,34333,0,3,194,116,106,10,116,0,300,184,98,18,
6,"BISTRITA-NASAUD",65,34360,,181,0,"SCOALA GENERALA ROMULI","ROMULI",40,34360,0,3,1182,546,495,51,536,10,1400,854,223,313,
6,"BISTRITA-NASAUD",65,34360,,182,0,"SCOALA GENERALA DEALUL STEFANITEI","ROMULI",40,34360,0,3,163,159,55,104,158,1,200,41,39,119,
6,"BISTRITA-NASAUD",65,34397,,183,0,"PRIMARIA SALVA","SALVA",41,34397,0,3,1212,504,449,55,499,5,1400,896,198,301,
6,"BISTRITA-NASAUD",65,34397,,184,0,"CAMIN CULTURAL SALVA","SALVA",41,34397,0,3,1184,572,491,81,567,5,1400,828,238,329,
6,"BISTRITA-NASAUD",65,34397,,185,0,"SCOALA GENERALA RUNC","SALVA",41,34397,0,3,1155,563,520,43,550,13,1300,737,257,293,
6,"BISTRITA-NASAUD",65,34422,,186,0,"CAMIN CULTURAL","SILIVASU DE CIMPIE",48,34422,0,3,1016,561,503,58,549,12,1200,639,293,256,
6,"BISTRITA-NASAUD",65,34477,,187,0,"PRIMARIA SANMIHAIU DE CAMPIE","SANMIHAIU DE CIMPIE",42,34477,0,3,656,317,278,39,313,4,799,482,203,110,
6,"BISTRITA-NASAUD",65,34477,,188,0,"CAMIN CULTURAL BRATENI","SANMIHAIU DE CIMPIE",42,34477,0,3,114,93,62,31,91,2,200,107,34,57,
6,"BISTRITA-NASAUD",65,34477,,189,0,"CAMIN CULTURAL SALCUTA","SANMIHAIU DE CIMPIE",42,34477,0,3,138,82,58,24,80,2,200,118,26,54,
6,"BISTRITA-NASAUD",65,34477,,190,0,"CAMIN CULTURAL STUPINI","SANMIHAIU DE CIMPIE",42,34477,0,3,240,138,89,49,136,2,300,162,52,84,
6,"BISTRITA-NASAUD",65,34477,,191,0,"CAMIN CULTURAL ZORENI","SANMIHAIU DE CIMPIE",42,34477,0,3,316,175,139,36,168,7,400,225,93,75,
6,"BISTRITA-NASAUD",65,34547,,192,0,"PRIMARIA SPERMEZEU","SPERMEZEU",50,34547,0,3,1664,758,714,44,753,5,1900,1142,192,561,
6,"BISTRITA-NASAUD",65,34547,,193,0,"SCOALA GENERALA SITA","SPERMEZEU",50,34547,0,3,304,178,158,20,178,0,400,222,15,163,
6,"BISTRITA-NASAUD",65,34547,,194,0,"SCOALA GENERALA HALMASAU","SPERMEZEU",50,34547,0,3,254,150,118,32,147,3,300,150,58,89,
6,"BISTRITA-NASAUD",65,34618,,195,0,"GRADINITA SANT","SANT",43,34618,0,3,2164,1439,1358,81,1429,10,2400,961,445,984,
6,"BISTRITA-NASAUD",65,34618,,196,0,"SCOALA VALEA MARE","SANT",43,34618,0,3,178,167,114,53,167,0,200,33,47,120,
6,"BISTRITA-NASAUD",65,34645,,197,0,"CAMIN CULTURAL SIEU","SIEU",44,34645,0,3,1176,641,587,54,636,5,1300,659,391,245,
6,"BISTRITA-NASAUD",65,34645,,198,0,"SCOALA GENERALA NR.2 ARDAN","SIEU",44,34645,0,3,662,322,297,25,320,2,800,478,86,234,
6,"BISTRITA-NASAUD",65,34645,,199,0,"SCOALA GENERALA POSMUS","SIEU",44,34645,0,3,578,336,306,30,330,6,700,364,101,229,
6,"BISTRITA-NASAUD",65,34645,,200,0,"SCOALA GENERALA SOIMUS","SIEU",44,34645,0,3,132,115,84,31,114,1,200,85,29,85,
6,"BISTRITA-NASAUD",65,34850,,201,0,"PRIMARIA SIEU","SIEUT",47,34850,0,3,1155,650,610,40,644,6,1300,650,203,441,
6,"BISTRITA-NASAUD",65,34850,,202,0,"CAMIN CULTURAL SEBIS","SIEUT",47,34850,0,3,701,455,420,35,442,9,800,349,149,293,
6,"BISTRITA-NASAUD",65,34850,,203,0,"SCOALA GENERALA LUNCA","SIEUT",47,34850,0,3,306,202,179,23,202,0,400,198,71,131,
6,"BISTRITA-NASAUD",65,34690,,204,0,"SCOALA GENERALA MAGHERUS","SIEU-MAGHERUS",45,34690,0,3,737,364,309,55,359,5,900,536,165,194,
6,"BISTRITA-NASAUD",65,34690,,205,0,"SCOALA GENERALA CHINTELNIC","SIEU-MAGHERUS",45,34690,0,3,514,273,225,48,271,2,600,327,84,187,
6,"BISTRITA-NASAUD",65,34690,,206,0,"CAMIN CULTURAL CRAINIMAT","SIEU-MAGHERUS",45,34690,0,3,575,423,366,57,416,7,700,277,100,316,
6,"BISTRITA-NASAUD",65,34690,,207,0,"SCOALA GENERALA SARATEL","SIEU-MAGHERUS",45,34690,0,3,351,199,145,54,196,3,401,202,83,113,
6,"BISTRITA-NASAUD",65,34690,,208,0,"GRADINITA ARCALIA","SIEU-MAGHERUS",45,34690,0,3,501,335,282,53,328,7,600,265,95,233,
6,"BISTRITA-NASAUD",65,34770,,209,0,"PRIMARIA SIEU ODORHEI","SIEU-ODORHEI",46,34770,0,3,621,305,272,33,303,2,700,395,147,156,
6,"BISTRITA-NASAUD",65,34770,,210,0,"CAMIN CULTURAL AGRISU DE JOS","SIEU-ODORHEI",46,34770,0,3,493,267,245,22,255,12,600,333,122,133,
6,"BISTRITA-NASAUD",65,34770,,211,0,"CAMIN CULTURAL BRETEA","SIEU-ODORHEI",46,34770,0,3,213,123,89,34,119,4,300,177,95,24,
6,"BISTRITA-NASAUD",65,34770,,212,0,"CAMIN CULTURAL COASTA","SIEU-ODORHEI",46,34770,0,3,175,140,115,25,139,1,200,60,46,93,
6,"BISTRITA-NASAUD",65,34770,,213,0,"SCOALA GENERALA CRISTUR SIEU","SIEU-ODORHEI",46,34770,0,3,356,249,201,48,249,0,400,151,66,183,
6,"BISTRITA-NASAUD",65,34770,,214,0,"SCOALA GENERALA SIRIOARA","SIEU-ODORHEI",46,34770,0,3,267,182,159,23,182,0,300,118,47,135,
6,"BISTRITA-NASAUD",65,34903,,215,0,"PRIMARIA SINTEREAG","SINTEREAG",49,34903,0,3,845,437,355,82,435,2,1000,563,214,221,
6,"BISTRITA-NASAUD",65,34903,,216,0,"CAMIN CULTURAL BLAJENII DE JOS","SINTEREAG",49,34903,0,3,344,219,196,23,217,2,398,179,82,135,
6,"BISTRITA-NASAUD",65,34903,,217,0,"SCOALA GENERALA BLAJENII DE SUS","SINTEREAG",49,34903,0,3,373,238,218,20,235,3,500,262,129,106,
6,"BISTRITA-NASAUD",65,34903,,218,0,"GRADINITA CAILA","SINTEREAG",49,34903,0,3,279,232,206,26,228,4,400,168,97,131,
6,"BISTRITA-NASAUD",65,34903,,219,0,"GRADINITA COCIU","SINTEREAG",49,34903,0,3,918,497,456,41,494,3,1100,603,233,261,
6,"BISTRITA-NASAUD",65,34903,,220,0,"GRADINITA SIEU SFANTU","SINTEREAG",49,34903,0,3,363,286,254,32,286,0,400,114,135,151,
6,"BISTRITA-NASAUD",65,34985,,221,0,"CAMIN CULTURAL ARCHIUD","TEACA",52,34985,0,3,644,383,338,45,368,15,800,417,177,191,
6,"BISTRITA-NASAUD",65,34985,,222,0,"CAMIN CULTURAL OCNITA","TEACA",52,34985,0,3,1135,587,542,45,576,11,1300,713,236,340,
6,"BISTRITA-NASAUD",65,34985,,223,0,"FOST SEDIU CAP PINTICU","TEACA",52,34985,0,3,695,365,330,35,360,5,800,435,189,171,
6,"BISTRITA-NASAUD",65,34985,,224,0,"PRIMARIA TEACA","TEACA",52,34985,0,3,1633,849,731,118,836,13,1800,951,487,349,
6,"BISTRITA-NASAUD",65,34985,,225,0,"SCOALA GENERALA VIILE TECII","TEACA",52,34985,0,3,785,541,429,112,518,23,900,359,303,215,
6,"BISTRITA-NASAUD",65,35054,,226,0,"SCOALA GENERALA TELCIU","TELCIU",53,35054,0,3,1829,1030,781,249,1024,6,2100,1070,324,700,
6,"BISTRITA-NASAUD",65,35054,,227,0,"GRADINITA TELCIU","TELCIU",53,35054,0,3,1434,711,522,189,700,11,1600,889,244,456,
6,"BISTRITA-NASAUD",65,35054,,228,0,"SCOALA GENERALA TELCISOR","TELCIU",53,35054,0,3,804,267,217,50,264,3,900,633,54,210,
6,"BISTRITA-NASAUD",65,35054,,229,0,"SCOALA GENERALA FIAD","TELCIU",53,35054,0,3,264,145,115,30,145,0,300,155,33,112,
6,"BISTRITA-NASAUD",65,35090,,230,0,"PRIMARIA TIHA BARGAULUI","TIHA BARGAULUI",54,35090,0,3,1313,504,446,58,503,1,1497,993,173,330,
6,"BISTRITA-NASAUD",65,35090,,231,0,"SCOALA GENERALA TUREAC","TIHA BARGAULUI",54,35090,0,3,1820,1021,903,118,1006,15,2002,981,175,831,
6,"BISTRITA-NASAUD",65,35090,,232,0,"SCOALA GENERALA MURESENI","TIHA BARGAULUI",54,35090,0,3,1255,703,628,75,696,7,1400,697,163,533,
6,"BISTRITA-NASAUD",65,35090,,233,0,"CANTON DRUMURI","TIHA BARGAULUI",54,35090,0,3,342,241,152,89,237,4,400,159,59,178,
6,"BISTRITA-NASAUD",65,35152,,234,0,"SCOALA GENERALA TARLISUA","TARLISUA",51,35152,0,3,1753,668,642,26,659,9,2000,1332,195,464,
6,"BISTRITA-NASAUD",65,35152,,235,0,"SCOALA GENERALA BORLEASA","TARLISUA",51,35152,0,3,447,192,177,15,188,4,500,308,68,120,
6,"BISTRITA-NASAUD",65,35152,,236,0,"SCOALA GENERALA AGRIES","TARLISUA",51,35152,0,3,1190,501,459,42,497,4,1400,899,163,334,
6,"BISTRITA-NASAUD",65,35269,,237,0,"SCOALA GENERALA URIU","URIU",55,35269,0,3,1106,506,466,40,500,6,1300,794,356,144,
6,"BISTRITA-NASAUD",65,35269,,238,0,"SCOALA GENERALA CRISTESTI","URIU",55,35269,0,3,858,545,503,42,538,7,1000,455,282,256,
6,"BISTRITA-NASAUD",65,35269,,239,0,"SCOALA GENERALA ILISUA","URIU",55,35269,0,3,561,323,289,34,322,1,700,377,140,182,
6,"BISTRITA-NASAUD",65,35269,,240,0,"SCOALA GENERALA HASMAS","URIU",55,35269,0,3,252,150,130,20,145,5,300,150,44,101,
6,"BISTRITA-NASAUD",65,35312,,241,0,"PRIMARIA URMENIS","URMENIS",56,35312,0,3,920,434,376,58,426,8,1100,666,203,223,
6,"BISTRITA-NASAUD",65,35312,,242,0,"SCOALA GENERALA SOPTERIU","URMENIS",56,35312,0,3,501,245,191,54,243,2,600,355,89,154,
6,"BISTRITA-NASAUD",65,35312,,243,0,"SCOALA GENERALA DELURENI","URMENIS",56,35312,0,3,352,187,143,44,186,1,400,213,54,132,
6,"BISTRITA-NASAUD",65,35312,,244,0,"CAMIN CULTURAL FANATE","URMENIS",56,35312,0,3,146,157,63,94,156,1,200,43,36,120,
6,"BISTRITA-NASAUD",65,35429,,245,0,"CAMIN CULTURAL ZAGRA","ZAGRA",57,35429,0,3,1014,548,493,55,540,8,1200,652,241,299,
6,"BISTRITA-NASAUD",65,35429,,246,0,"CAMIN CULTURAL PERISOR","ZAGRA",57,35429,0,3,543,247,221,26,243,4,600,349,91,152,
6,"BISTRITA-NASAUD",65,35429,,247,0,"CAMIN CULTURAL POIENILE","ZAGRA",57,35429,0,3,624,368,313,55,362,6,700,332,96,266,
6,"BISTRITA-NASAUD",65,35429,,248,0,"CAMIN CULTURAL SUPLAI","ZAGRA",57,35429,0,3,583,351,321,30,348,3,700,349,157,191,
6,"BISTRITA-NASAUD",65,35429,,249,0,"CAMIN CULTURAL ALUNIS","ZAGRA",57,35429,0,3,281,201,185,16,198,3,400,199,75,123,
7,"BOTOSANI",74,35731,,1,0,"B-DUL MIHAI EMINESCU NR.75","MUNICIPIUL BOTOSANI",1,35731,1,1,2125,1360,1277,83,1339,21,2286,926,1017,322,
7,"BOTOSANI",74,35731,,2,0,"STR. STEFAN LUCHIAN NR.18 (A)","MUNICIPIUL BOTOSANI",1,35731,1,1,2260,1363,1300,63,1347,16,2450,1087,926,421,
7,"BOTOSANI",74,35731,,3,0,"B-DUL MIHAI EMINESCU NR.75","MUNICIPIUL BOTOSANI",1,35731,1,1,2262,1289,1147,142,1276,13,2450,1161,883,393,
7,"BOTOSANI",74,35731,,4,0,"B-DUL MIHAI EMINESCU NR.50","MUNICIPIUL BOTOSANI",1,35731,1,1,1623,952,891,61,946,6,1750,798,642,304,
7,"BOTOSANI",74,35731,,5,0,"STR. STEFAN LUCHIAN NR.18 (B)","MUNICIPIUL BOTOSANI",1,35731,1,1,898,556,480,76,552,4,950,394,354,198,
7,"BOTOSANI",74,35731,,6,0,"STR. VARNAV NR.32","MUNICIPIUL BOTOSANI",1,35731,1,1,1971,1103,1043,60,1100,2,2150,1047,708,392,
7,"BOTOSANI",74,35731,,7,0,"STR. VARNAV NR. 32","MUNICIPIUL BOTOSANI",1,35731,1,1,2079,1160,1038,122,1150,10,2250,1090,781,369,
7,"BOTOSANI",74,35731,,8,0,"B-DUL MIHAI EMINESCU NR. 50","MUNICIPIUL BOTOSANI",1,35731,1,1,3004,1702,1614,88,1687,15,3300,1598,1197,490,
7,"BOTOSANI",74,35731,,9,0,"STR. VARNAV NR.65","MUNICIPIUL BOTOSANI",1,35731,1,1,1456,875,729,146,867,8,1599,724,517,350,
7,"BOTOSANI",74,35731,,10,0,"STR. NICOLAE IORGA NR. 9","MUNICIPIUL BOTOSANI",1,35731,1,1,2325,1393,1257,136,1377,16,2550,1157,890,487,
7,"BOTOSANI",74,35731,,11,0,"STR. PIATA 1 DECEMBRIE NR.4","MUNICIPIUL BOTOSANI",1,35731,1,1,2522,1530,1397,133,1517,13,2750,1220,1013,504,
7,"BOTOSANI",74,35731,,12,0,"STR. A.S. PUSKIN NR. 20","MUNICIPIUL BOTOSANI",1,35731,1,1,1350,730,685,45,723,7,1450,720,459,264,
7,"BOTOSANI",74,35731,,13,0,"STR. A.S. PUSCHIN NR. 20","MUNICIPIUL BOTOSANI",1,35731,1,1,1554,947,906,41,931,16,1700,753,643,288,
7,"BOTOSANI",74,35731,,14,0,"STR. CALUGARENI NR.17","MUNICIPIUL BOTOSANI",1,35731,1,1,1942,1108,1046,62,1097,11,2100,992,670,427,
7,"BOTOSANI",74,35731,,15,0,"STR. CALUGARENI NR.17","MUNICIPIUL BOTOSANI",1,35731,1,1,2294,1287,1229,58,1272,15,2500,1213,833,439,
7,"BOTOSANI",74,35731,,16,0,"STR. ION ELEFTERESCU NR. 2","MUNICIPIUL BOTOSANI",1,35731,1,1,3199,2021,1899,122,2005,16,3500,1479,1185,820,
7,"BOTOSANI",74,35731,,17,0,"STR. GEN. GH. AVRAMESCU NR.20","MUNICIPIUL BOTOSANI",1,35731,1,1,2535,1495,1370,125,1476,19,2750,1255,887,589,
7,"BOTOSANI",74,35731,,18,0,"STR. SFEFAN LUCHIAN NR.19","MUNICIPIUL BOTOSANI",1,35731,1,1,1670,901,823,78,899,2,1800,899,598,301,
7,"BOTOSANI",74,35731,,19,0,"CALEA NATIONALA NR.143","MUNICIPIUL BOTOSANI",1,35731,1,1,1480,929,800,129,914,15,1600,671,544,370,
7,"BOTOSANI",74,35731,,20,0,"CALEA NATIONALA NR.143","MUNICIPIUL BOTOSANI",1,35731,1,1,3120,1385,1234,151,1374,11,3400,2015,809,565,
7,"BOTOSANI",74,35731,,21,0,"STR. PRIETENIEI NR.7","MUNICIPIUL BOTOSANI",1,35731,1,1,2298,1426,1281,145,1414,12,2500,1074,843,571,
7,"BOTOSANI",74,35731,,22,0,"STR. PRIETENIEI NR. 1 BIS","MUNICIPIUL BOTOSANI",1,35731,1,1,1907,1097,1013,84,1080,17,2050,953,630,450,
7,"BOTOSANI",74,35731,,23,0,"STR. PRIETENIEI NR.1 BIS","MUNICIPIUL BOTOSANI",1,35731,1,1,1533,934,881,53,921,13,1650,716,565,356,
7,"BOTOSANI",74,35731,,24,0,"ALEEA PRIETENIEI NR.6","MUNICIPIUL BOTOSANI",1,35731,1,1,1742,1004,939,65,1001,3,1900,893,623,378,
7,"BOTOSANI",74,35731,,25,0,"STR. OCTAV ONICESCU NR. 52","MUNICIPIUL BOTOSANI",1,35731,1,1,2293,1286,1241,45,1274,12,2500,1214,860,414,
7,"BOTOSANI",74,35731,,26,0,"ALEEA NUCULUI NR.6","MUNICIPIUL BOTOSANI",1,35731,1,1,2224,1355,1238,117,1347,8,2450,1095,850,497,
7,"BOTOSANI",74,35731,,27,0,"ALEEA CURCUBEULUI NR.5","MUNICIPIUL BOTOSANI",1,35731,1,1,1998,1102,1025,77,1093,9,2200,1098,657,436,
7,"BOTOSANI",74,35731,,28,0,"STR. OCTAV ONICESCU NR.52","MUNICIPIUL BOTOSANI",1,35731,1,1,2026,1135,1063,72,1122,13,2450,1315,646,476,
7,"BOTOSANI",74,35731,,29,0,"ALEEA CURCUBEULUI NR.5","MUNICIPIUL BOTOSANI",1,35731,1,1,1442,820,777,43,815,5,1550,730,495,320,
7,"BOTOSANI",74,35731,,30,0,"ALEEA CURCUBEULUI NR.10","MUNICIPIUL BOTOSANI",1,35731,1,1,2674,1520,1448,72,1500,20,2900,1380,864,636,
7,"BOTOSANI",74,35731,,31,0,"STR. ALEEA CURCUBEULUI NR.10","MUNICIPIUL BOTOSANI",1,35731,1,1,1538,832,798,34,814,18,1700,868,497,317,
7,"BOTOSANI",74,35731,,32,0,"STR. MAXIM GORKI NR.11","MUNICIPIUL BOTOSANI",1,35731,1,1,1878,1044,994,50,1033,11,2050,1006,631,402,
7,"BOTOSANI",74,35731,,33,0,"STR. BUCOVINEI NR.29","MUNICIPIUL BOTOSANI",1,35731,1,1,2812,1671,1560,111,1657,14,3050,1379,972,685,
7,"BOTOSANI",74,35731,,34,0,"STR. BUCOVINEI NR.29","MUNICIPIUL BOTOSANI",1,35731,1,1,2444,1423,1346,77,1413,10,2650,1227,857,556,
7,"BOTOSANI",74,35731,,35,0,"STR. DUMITRIE RALET NR.3","MUNICIPIUL BOTOSANI",1,35731,1,1,2038,1194,1145,49,1183,11,2200,1006,705,478,
7,"BOTOSANI",74,35731,,36,0,"STR. DUMITRIE RALET NR.3","MUNICIPIUL BOTOSANI",1,35731,1,1,1490,847,812,35,840,7,1600,753,469,371,
7,"BOTOSANI",74,35731,,37,0,"B-DUL MIHAI EMINESCU NR.91","MUNICIPIUL BOTOSANI",1,35731,1,1,1722,1102,981,121,1098,4,1850,748,677,421,
7,"BOTOSANI",74,35731,,38,0,"SAT TULBURENI","MUNICIPIUL BOTOSANI",1,35731,1,1,652,474,416,58,469,5,700,226,308,161,
7,"BOTOSANI",74,35731,,39,0,"STR. I.C. BRATIANU NR.49","MUNICIPIUL BOTOSANI",1,35731,1,1,1227,811,738,73,802,9,1350,539,523,279,
7,"BOTOSANI",74,35731,,40,0,"STR. I.C.BRATIANU NR.49","MUNICIPIUL BOTOSANI",1,35731,1,1,1098,630,590,40,620,10,1200,570,395,225,
7,"BOTOSANI",74,35731,,41,0,"STR. I.ELEFTERESCU NR.55","MUNICIPIUL BOTOSANI",1,35731,1,1,2561,1504,1451,53,1484,20,2800,1296,905,579,
7,"BOTOSANI",74,35731,,42,0,"STR. ION ELEFTERESCU NR.55","MUNICIPIUL BOTOSANI",1,35731,1,1,3071,1561,1432,129,1540,21,3352,1791,954,586,
7,"BOTOSANI",74,35731,,43,0,"STR. ION ELEFTERESCU NR.54","MUNICIPIUL BOTOSANI",1,35731,1,1,3149,1778,1694,84,1751,27,3460,1682,1012,739,
7,"BOTOSANI",74,35731,,44,0,"STR. ION ELEFTERESCU NR.2","MUNICIPIUL BOTOSANI",1,35731,1,1,3075,1843,1755,88,1821,22,3350,1507,1065,756,
7,"BOTOSANI",74,35731,,45,0,"STR. GEN GH. AVRAMESCU NR.20","MUNICIPIUL BOTOSANI",1,35731,1,1,2602,1563,1481,82,1554,9,2850,1287,896,658,
7,"BOTOSANI",74,35731,,46,0,"STR. UZINEI NR.5","MUNICIPIUL BOTOSANI",1,35731,1,1,1547,1002,870,132,994,8,1650,648,569,425,
7,"BOTOSANI",74,35731,,47,0,"CALEA NATIONALA NR.4","MUNICIPIUL BOTOSANI",1,35731,1,1,1072,1163,520,643,1153,10,1252,89,645,508,
7,"BOTOSANI",74,35731,,48,1,"SPITALUL JUDETEAN ""MAVROMATI"" B-DUL MIHAI EMINESCU","MUNICIPIUL BOTOSANI",1,35731,1,1,0,627,0,627,622,5,650,23,439,183,
7,"BOTOSANI",74,35731,,49,1,"SPITALUL DE SPECIALITATE ""SF. GHEORGHE"" CALEA NATIONALA","MUNICIPIUL BOTOSANI",1,35731,1,1,0,138,0,138,137,1,200,62,86,51,
7,"BOTOSANI",74,35731,,50,1,"MATERNITATEA JUDETEANA BOTOSANI B-DUL GEORGE ENESCU","MUNICIPIUL BOTOSANI",1,35731,1,1,0,164,0,164,163,1,200,36,107,56,
7,"BOTOSANI",74,35731,,51,1,"SPITALUL DE PSIHIATRIE STR. I.C. BRATIANU","MUNICIPIUL BOTOSANI",1,35731,1,1,0,111,0,111,111,0,150,39,72,39,
7,"BOTOSANI",74,35731,,52,1,"SPITALUL BOLI CONTAGIOASE STR. STEFAN CEL MARE","MUNICIPIUL BOTOSANI",1,35731,1,1,0,61,0,61,60,1,100,39,41,19,
7,"BOTOSANI",74,35731,,53,1,"SPITALUL TBC STR. TRANDAFIRILOR","MUNICIPIUL BOTOSANI",1,35731,1,1,0,90,0,90,88,2,100,10,58,30,
7,"BOTOSANI",74,35731,,54,1,"SPITALUL DE COPII ""CUVIOASA  PARASCHIVA ""  B-DUL MIHAI EMINESCU","MUNICIPIUL BOTOSANI",1,35731,1,1,0,115,0,115,112,3,200,85,80,32,
7,"BOTOSANI",74,35731,,55,1,"UNITATEA MILITARA 01189 BOTOSANI","MUNICIPIUL BOTOSANI",1,35731,1,1,0,162,0,162,156,6,200,38,70,86,
7,"BOTOSANI",74,35731,,56,1,"UNITATEA 01130 BOTOSANI","MUNICIPIUL BOTOSANI",1,35731,1,1,0,103,0,103,103,0,150,47,51,52,
7,"BOTOSANI",74,35731,,57,1,"UNITATEA MILITARA 0901 BOTOSANI","MUNICIPIUL BOTOSANI",1,35731,1,1,0,530,0,530,518,10,598,70,389,129,
7,"BOTOSANI",74,36006,,58,0,"STR.GR. GHICA NR.41","MUNICIPIUL DOROHOI",2,36006,1,1,2326,1398,1340,58,1381,17,2555,1157,952,429,
7,"BOTOSANI",74,36006,,59,0,"STR. OLINESCU NR.2","MUNICIPIUL DOROHOI",2,36006,1,1,2324,1471,1364,107,1460,11,2550,1079,952,508,
7,"BOTOSANI",74,36006,,60,0,"STR. A.I. CUZA NR.43","MUNICIPIUL DOROHOI",2,36006,1,1,2284,1451,1348,103,1440,11,2500,1049,912,528,
7,"BOTOSANI",74,36006,,61,0,"STR. LOCOTENENT STROE BUICAN NR.2","MUNICIPIUL DOROHOI",2,36006,1,1,1247,843,764,79,835,8,1350,507,485,350,
7,"BOTOSANI",74,36006,,62,0,"STR. GEORGE ENESCU NR.57","MUNICIPIUL DOROHOI",2,36006,1,1,1299,783,732,51,769,14,1398,615,489,280,
7,"BOTOSANI",74,36006,,63,0,"STR. STEFAN CEL MARE NR. 28","MUNICIPIUL DOROHOI",2,36006,1,1,2075,1344,1253,91,1325,19,2250,906,813,512,
7,"BOTOSANI",74,36006,,64,0,"B-DUL VICTORIEI NR.95","MUNICIPIUL DOROHOI",2,36006,1,1,2080,1313,1172,141,1306,7,2252,939,846,460,
7,"BOTOSANI",74,36006,,65,0,"B-DUL VICTORIEI NR.112","MUNICIPIUL DOROHOI",2,36006,1,1,2171,1304,1184,120,1296,8,2350,1046,780,516,
7,"BOTOSANI",74,36006,,66,0,"ALEEA DUMBRAVA NR.2","MUNICIPIUL DOROHOI",2,36006,1,1,2509,1497,1431,66,1483,14,2750,1253,911,572,
7,"BOTOSANI",74,36006,,67,0,"B-DUL VICTORIEI NR.75","MUNICIPIUL DOROHOI",2,36006,1,1,2097,1428,1186,242,1418,10,2303,875,882,536,
7,"BOTOSANI",74,36006,,68,0,"ALEEA MARULUI NR. 25","MUNICIPIUL DOROHOI",2,36006,1,1,2218,1311,1252,59,1300,11,2400,1089,843,457,
7,"BOTOSANI",74,36006,,69,0,"STR HORIA NR. 21","MUNICIPIUL DOROHOI",2,36006,1,1,1844,1265,1193,72,1244,21,2000,735,774,470,
7,"BOTOSANI",74,36006,,70,0,"STR. PRUNULUI NR.1","MUNICIPIUL DOROHOI",2,36006,1,1,704,480,451,29,474,6,800,320,336,138,
7,"BOTOSANI",74,36006,,71,0,"SAT LOTURI ENESCU","MUNICIPIUL DOROHOI",2,36006,1,1,293,202,191,11,200,2,300,98,141,59,
7,"BOTOSANI",74,35946,,72,0,"STR.1 DECEMBRIE NR.76","ORAS DARABANI",3,35946,2,1,2844,1793,1719,74,1767,26,3100,1307,1364,403,
7,"BOTOSANI",74,35946,,73,0,"STR. 1 DECEMBRIE NR.45","ORAS DARABANI",3,35946,2,1,2917,1941,1833,108,1910,31,3200,1259,1438,472,
7,"BOTOSANI",74,35946,,74,0,"SAT BAJURA","ORAS DARABANI",3,35946,2,1,1481,1013,982,31,995,18,1600,587,721,274,
7,"BOTOSANI",74,35946,,75,0,"SAT TEIOASA","ORAS DARABANI",3,35946,2,1,1188,783,750,33,771,12,1300,517,541,230,
7,"BOTOSANI",74,35946,,76,0,"SAT LISMANITA","ORAS DARABANI",3,35946,2,1,506,382,363,19,377,5,600,218,314,63,
7,"BOTOSANI",74,35946,,77,0,"SAT ESANCA","ORAS DARABANI",3,35946,2,1,285,216,200,16,213,3,300,84,191,22,
7,"BOTOSANI",74,36060,,78,0,"STR. NICOLAE IORGA NR. 3","ORAS SAVENI",4,36060,2,1,1892,1136,1094,42,1130,6,2050,914,775,355,
7,"BOTOSANI",74,36060,,79,0,"STR. NICOLAE IORGA NR.3","ORAS SAVENI",4,36060,2,1,1899,1171,1119,52,1167,4,2050,879,767,400,
7,"BOTOSANI",74,36060,,80,0,"STR. STEFAN CEL MARE NR.2","ORAS SAVENI",4,36060,2,1,1346,870,849,21,864,6,1450,580,583,281,
7,"BOTOSANI",74,36060,,81,0,"SAT PETRICANI","ORAS SAVENI",4,36060,2,1,1173,757,715,42,749,8,1250,493,544,205,
7,"BOTOSANI",74,36060,,82,0,"SAT BODEASA","ORAS SAVENI",4,36060,2,1,327,268,243,25,265,3,400,132,228,37,
7,"BOTOSANI",74,36060,,83,1,"SPITALUL SAVENI","ORAS SAVENI",4,36060,2,1,0,98,0,98,97,1,100,2,72,25,
7,"BOTOSANI",74,36131,,84,0,"SAT ALBESTI","ALBESTI",5,36131,0,3,1773,949,872,77,931,18,1948,999,672,259,
7,"BOTOSANI",74,36131,,85,0,"SAT BUIMACENI","ALBESTI",5,36131,0,3,671,435,372,63,426,9,700,265,323,103,
7,"BOTOSANI",74,36131,,86,0,"SAT JIJIA","ALBESTI",5,36131,0,3,538,328,278,50,327,1,600,272,264,63,
7,"BOTOSANI",74,36131,,87,0,"SAT COSTIUGENI","ALBESTI",5,36131,0,3,557,339,298,41,335,4,600,261,268,67,
7,"BOTOSANI",74,36131,,88,0,"SAT MASCATENI","ALBESTI",5,36131,0,3,299,240,192,48,236,4,350,110,202,34,
7,"BOTOSANI",74,36131,,89,0,"SAT TUDOR VLADIMIRESCU","ALBESTI",5,36131,0,3,1005,691,617,74,671,20,1100,409,566,105,
7,"BOTOSANI",74,36202,,90,0,"SAT AVRAMENI","AVRAMENI",6,36202,0,3,1222,806,718,88,801,5,1350,544,621,180,
7,"BOTOSANI",74,36202,,91,0,"SAT ADASENI","AVRAMENI",6,36202,0,3,896,515,454,61,501,14,950,435,323,178,
7,"BOTOSANI",74,36202,,92,0,"SAT PANAITOAIA","AVRAMENI",6,36202,0,3,916,705,566,139,690,15,1000,295,493,197,
7,"BOTOSANI",74,36202,,93,0,"SAT TUDOR VLADIMIRESCU","AVRAMENI",6,36202,0,3,610,459,386,73,451,8,650,191,343,108,
7,"BOTOSANI",74,36202,,94,0,"SAT AUREL VLAICU","AVRAMENI",6,36202,0,3,464,342,306,36,339,3,500,158,255,84,
7,"BOTOSANI",74,36202,,95,0,"SAT ICHIMENI","AVRAMENI",6,36202,0,3,168,130,97,33,130,0,200,70,95,35,
7,"BOTOSANI",74,36300,,96,0,"SAT BALUSENI","BALUSENI",7,36300,0,3,1593,908,821,87,889,19,1700,792,621,268,
7,"BOTOSANI",74,36300,,97,0,"SAT DRAXINI","BALUSENI",7,36300,0,3,1667,1183,1041,142,1162,21,1800,617,765,397,
7,"BOTOSANI",74,36300,,98,0,"SAT BUZENI","BALUSENI",7,36300,0,3,1059,602,510,92,589,13,1150,548,393,196,
7,"BOTOSANI",74,36373,,99,0,"SAT BRAESTI","BRAESTI",8,36373,0,3,1395,916,826,90,912,4,1500,584,632,280,
7,"BOTOSANI",74,36373,,100,0,"SAT POIANA","BRAESTI",8,36373,0,3,326,280,227,53,276,4,400,120,211,65,
7,"BOTOSANI",74,36426,,101,0,"SAT BROSCAUTI","BROSCAUTI",9,36426,0,3,1413,894,838,56,890,4,1550,656,600,290,
7,"BOTOSANI",74,36426,,102,0,"SAT BROSCAUTI","BROSCAUTI",9,36426,0,3,1325,881,818,63,873,8,1450,569,571,302,
7,"BOTOSANI",74,36453,,103,0,"SAT BUCECEA","BUCECEA",10,36453,0,3,2590,1474,1415,59,1457,17,2800,1326,972,485,
7,"BOTOSANI",74,36453,,104,0,"SAT BUCECEA","BUCECEA",10,36453,0,3,1320,931,820,111,910,21,1600,669,584,326,
7,"BOTOSANI",74,36499,,105,0,"SAT CALARASI","CALARASI",11,36499,0,3,2361,1425,1344,81,1403,20,2600,1175,1039,364,
7,"BOTOSANI",74,36499,,106,0,"SAT PLESANI","CALARASI",11,36499,0,3,485,343,290,53,337,6,550,207,270,67,
7,"BOTOSANI",74,36499,,107,0,"SAT LIBERTATAEA","CALARASI",11,36499,0,3,431,348,286,62,341,7,500,152,272,69,
7,"BOTOSANI",74,36532,,108,0,"SAT CONCESTI","CONCESTI",12,36532,0,3,1709,1101,1070,31,1087,14,1850,749,908,179,
7,"BOTOSANI",74,36569,,109,0,"SAT COPALAU","COPALAU",13,36569,0,3,2189,1474,1331,143,1462,12,2400,926,1118,344,
7,"BOTOSANI",74,36569,,110,0,"SAT COTU","COPALAU",13,36569,0,3,538,419,373,46,411,8,600,181,300,111,
7,"BOTOSANI",74,36569,,111,0,"SAT CERBU","COPALAU",13,36569,0,3,555,464,373,91,458,6,600,136,409,49,
7,"BOTOSANI",74,36569,,112,0,"SAT COSULA","COPALAU",13,36569,0,3,1452,785,689,96,771,14,1600,815,518,253,
7,"BOTOSANI",74,36569,,113,0,"SAT SUPITCA","COPALAU",13,36569,0,3,1023,739,586,153,727,12,1100,361,486,241,
7,"BOTOSANI",74,36649,,114,0,"SAT CORDARENI","CORDARENI",14,36649,0,3,1416,1078,1035,43,1066,12,1550,472,871,195,
7,"BOTOSANI",74,36649,,115,0,"SAT GRIVITA","CORDARENI",14,36649,0,3,444,421,342,79,415,6,500,79,256,159,
7,"BOTOSANI",74,36676,,116,0,"SAT CORLATENI","CORLATENI",15,36676,0,3,1229,779,687,92,766,13,1300,519,622,144,
7,"BOTOSANI",74,36676,,117,0,"SAT CORLATENI","CORLATENI",15,36676,0,3,1071,714,604,110,700,14,1150,436,528,172,
7,"BOTOSANI",74,36676,,118,0,"SAT CORLATENI","CORLATENI",15,36676,0,3,966,801,711,90,789,12,1050,249,657,132,
7,"BOTOSANI",74,36756,,119,0,"SAT CORNI","CORNI",16,36756,0,3,1673,895,819,76,885,10,1803,908,574,311,
7,"BOTOSANI",74,36756,,120,0,"SAT CORNI","CORNI",16,36756,0,3,1545,860,784,76,836,24,1694,834,579,257,
7,"BOTOSANI",74,36756,,121,0,"SAT SARAFINESTI","CORNI",16,36756,0,3,1403,872,729,143,853,19,1550,678,547,306,
7,"BOTOSANI",74,36756,,122,0,"SAT BALTA ARSA","CORNI",16,36756,0,3,248,178,134,44,173,5,300,122,153,20,
7,"BOTOSANI",74,36809,,123,0,"SAT COTUSCA","COTUSCA",17,36809,0,3,1595,968,895,73,957,11,1650,682,697,260,
7,"BOTOSANI",74,36809,,124,0,"SAT PUTURENI","COTUSCA",17,36809,0,3,595,425,363,62,419,6,800,375,318,101,
7,"BOTOSANI",74,36809,,125,0,"SAT NICHITENI","COTUSCA",17,36809,0,3,755,532,440,92,521,11,650,118,326,195,
7,"BOTOSANI",74,36809,,126,0,"SAT GHIRENI","COTUSCA",17,36809,0,3,615,460,407,53,454,6,650,190,376,78,
7,"BOTOSANI",74,36809,,127,0,"SAT COTU MICULINTI","COTUSCA",17,36809,0,3,337,360,237,123,359,1,450,90,272,87,
7,"BOTOSANI",74,36809,,128,0,"SAT CRASNALEUCA","COTUSCA",17,36809,0,3,725,482,434,48,480,2,800,318,360,120,
7,"BOTOSANI",74,36907,,129,0,"SAT CRISTESTI","CRISTESTI",18,36907,0,3,1932,1021,877,144,1009,12,2100,1079,651,358,
7,"BOTOSANI",74,36907,,130,0,"SAT ORASENI","CRISTESTI",18,36907,0,3,426,311,227,84,306,5,500,189,197,109,
7,"BOTOSANI",74,36907,,131,0,"SAT ONEAGA","CRISTESTI",18,36907,0,3,1283,755,637,118,747,8,1400,645,538,209,
7,"BOTOSANI",74,36952,,132,0,"SAT CRISTINESTI","CRISTINESTI",19,36952,0,3,1328,913,764,149,901,12,1450,537,632,269,
7,"BOTOSANI",74,36952,,133,0,"SAT DRAGALINA","CRISTINESTI",19,36952,0,3,488,426,312,114,422,4,600,174,299,123,
7,"BOTOSANI",74,36952,,134,0,"SAT CRISTINESTI","CRISTINESTI",19,36952,0,3,1099,704,617,87,688,16,1200,496,532,156,
7,"BOTOSANI",74,35759,,135,0,"SAT CURTESTI","CURTESTI",20,35759,0,3,1182,686,589,97,678,8,1300,614,442,236,
7,"BOTOSANI",74,35759,,136,0,"SAT ORASENI DEAL","CURTESTI",20,35759,0,3,1343,835,724,111,827,8,1450,615,452,375,
7,"BOTOSANI",74,35759,,137,0,"SAT MANASTIREA DOAMNEI","CURTESTI",20,35759,0,3,780,521,441,80,517,4,800,279,324,193,
7,"BOTOSANI",74,37011,,138,0,"SAT DERSCA","DERSCA",22,37011,0,3,1534,869,823,46,856,13,1650,781,636,220,
7,"BOTOSANI",74,37011,,139,0,"SAT DERSCA","DERSCA",22,37011,0,3,1200,659,610,49,656,3,1300,641,476,180,
7,"BOTOSANI",74,37011,,140,0,"SAT LOZNA","DERSCA",22,37011,0,3,1567,888,785,103,867,21,1700,812,599,268,
7,"BOTOSANI",74,37057,,141,0,"SAT DINGENI","DANGENI",21,37057,0,3,1041,638,551,87,632,6,1100,462,414,218,
7,"BOTOSANI",74,37057,,142,0,"SAT HULUB","DANGENI",21,37057,0,3,542,343,299,44,338,5,600,257,220,118,
7,"BOTOSANI",74,37057,,143,0,"SAT IACOBENI","DANGENI",21,37057,0,3,861,530,476,54,524,6,900,370,395,129,
7,"BOTOSANI",74,37100,,144,0,"SAT DOBARCENI","DOBARCENI",23,37100,0,3,962,571,521,50,562,9,1005,434,413,149,
7,"BOTOSANI",74,37100,,145,0,"SAT BRATENI","DOBARCENI",23,37100,0,3,643,460,399,61,449,11,700,240,297,152,
7,"BOTOSANI",74,37100,,146,0,"SAT CISMANESTI","DOBARCENI",23,37100,0,3,356,260,229,31,258,2,400,140,197,61,
7,"BOTOSANI",74,37100,,147,0,"SAT MURGUTA","DOBARCENI",23,37100,0,3,356,258,223,35,256,2,400,142,218,38,
7,"BOTOSANI",74,37173,,148,0,"SAT DRAGUSENI","DRAGUSENI",24,37173,0,3,1415,920,858,62,913,7,1550,630,686,227,
7,"BOTOSANI",74,37173,,149,0,"SAT PODRIGA","DRAGUSENI",24,37173,0,3,730,534,486,48,532,2,801,267,402,130,
7,"BOTOSANI",74,37217,,150,0,"SAT DURNESTI","DURNESTI",25,37217,0,3,1025,645,568,77,637,8,1100,455,495,142,
7,"BOTOSANI",74,37217,,151,0,"SAT CUCUTENI TUFESCU","DURNESTI",25,37217,0,3,710,518,445,73,518,0,800,282,423,95,
7,"BOTOSANI",74,37217,,152,0,"SAT GURANDA","DURNESTI",25,37217,0,3,871,548,479,69,542,6,900,352,375,167,
7,"BOTOSANI",74,37217,,153,1,"SANATORIUL TBC GURANDA","DURNESTI",25,37217,0,3,0,73,0,73,72,1,100,27,49,23,
7,"BOTOSANI",74,37217,,154,0,"SAT BABICENI","DURNESTI",25,37217,0,3,593,445,390,55,441,4,700,255,352,89,
7,"BOTOSANI",74,37280,,155,0,"SAT FLAMINZI","FLAMANZI",26,37280,0,3,1793,897,811,86,890,7,1950,1053,575,315,
7,"BOTOSANI",74,37280,,156,0,"SAT FLAMINZI","FLAMANZI",26,37280,0,3,1631,1169,852,317,1150,19,1750,581,788,362,
7,"BOTOSANI",74,37280,,157,0,"SAT POIANA","FLAMANZI",26,37280,0,3,1509,984,910,74,933,51,1650,666,740,193,
7,"BOTOSANI",74,37280,,158,0,"SAT NICOLAE BALCESCU","FLAMANZI",26,37280,0,3,1902,1094,949,145,1073,21,2100,1006,755,318,
7,"BOTOSANI",74,37280,,159,0,"SAT NICOLAE BALCESCU","FLAMANZI",26,37280,0,3,1377,858,766,92,848,10,1500,642,600,248,
7,"BOTOSANI",74,37280,,160,0,"SAT PRISACANI","FLAMANZI",26,37280,0,3,991,628,559,69,618,10,1000,372,431,187,
7,"BOTOSANI",74,37324,,161,0,"SAT FRUMISICA","FRUMUSICA",27,37324,0,3,2015,1201,1088,113,1186,15,2200,999,940,246,
7,"BOTOSANI",74,37324,,162,0,"SAT VLADENI DEAL","FRUMUSICA",27,37324,0,3,1321,830,739,91,824,6,1462,632,693,131,
7,"BOTOSANI",74,37324,,163,0,"SAT RADENI","FRUMUSICA",27,37324,0,3,1386,846,779,67,820,15,1500,654,624,196,
7,"BOTOSANI",74,37397,,164,0,"SAT DUMENI","GEORGE ENESCU",28,37397,0,3,1076,663,500,163,655,8,1150,487,449,206,
7,"BOTOSANI",74,37397,,165,0,"SAT DUMENI","GEORGE ENESCU",28,37397,0,3,1065,752,625,127,737,15,1150,398,529,208,
7,"BOTOSANI",74,37397,,166,0,"SAT ARBOREA","GEORGE ENESCU",28,37397,0,3,770,511,401,110,503,8,800,289,328,175,
7,"BOTOSANI",74,37459,,167,0,"SAT GORBANESTI","GORBANESTI",29,37459,0,3,1043,695,656,39,685,10,1150,455,538,147,
7,"BOTOSANI",74,37459,,168,0,"SAT BATRINESTI","GORBANESTI",29,37459,0,3,495,304,275,29,301,3,600,296,252,49,
7,"BOTOSANI",74,37459,,169,0,"SAT SOCRUJENI","GORBANESTI",29,37459,0,3,693,563,512,51,555,8,800,237,462,93,
7,"BOTOSANI",74,37459,,170,0,"SAT VINATORI","GORBANESTI",29,37459,0,3,753,540,482,58,534,6,803,263,357,177,
7,"BOTOSANI",74,37547,,171,0,"SAT HAVIRNA","HAVARNA",31,37547,0,3,3033,1842,1701,141,1823,19,3350,1508,1236,587,
7,"BOTOSANI",74,37547,,172,0,"SAT TATARASENI","HAVARNA",31,37547,0,3,1379,849,762,87,839,10,1500,651,578,261,
7,"BOTOSANI",74,37618,,173,0,"SAT HANESTI","HANESTI",30,37618,0,3,1314,792,734,58,790,2,1445,653,617,173,
7,"BOTOSANI",74,37618,,174,0,"SAT SARATA BASARAB","HANESTI",30,37618,0,3,646,428,373,55,422,6,700,272,335,87,
7,"BOTOSANI",74,37672,,175,0,"SAT HILISEU HORIA","HILISEU-HORIA",32,37672,0,3,1776,1202,1083,119,1191,11,1951,749,909,282,
7,"BOTOSANI",74,37672,,176,0,"SAT HILISEU CRISAN","HILISEU-HORIA",32,37672,0,3,1146,773,685,88,764,9,1250,477,564,200,
7,"BOTOSANI",74,37734,,177,0,"SAT HLIPICENI","HLIPICENI",33,37734,0,3,1610,1005,889,116,986,19,1749,744,748,238,
7,"BOTOSANI",74,37734,,178,0,"SAT VICTORIA","HLIPICENI",33,37734,0,3,1023,1076,947,129,1067,9,1750,673,843,224,
7,"BOTOSANI",74,37770,,179,0,"SAT HUDESTI","HUDESTI",34,37770,0,3,920,660,487,173,653,7,1000,340,449,204,
7,"BOTOSANI",74,37770,,180,0,"SAT HUDESTI","HUDESTI",34,37770,0,3,1144,810,711,99,795,15,1251,441,632,163,
7,"BOTOSANI",74,37770,,181,0,"SAT ALBA","HUDESTI",34,37770,0,3,1307,945,863,82,932,13,1400,455,652,280,
7,"BOTOSANI",74,37770,,182,0,"SAT MLENAUTI","HUDESTI",34,37770,0,3,1089,732,664,68,722,10,1200,468,550,172,
7,"BOTOSANI",74,37770,,183,0,"SAT BARANCA","HUDESTI",34,37770,0,3,626,516,482,34,512,4,700,184,443,69,
7,"BOTOSANI",74,37823,,184,0,"SAT IBANESTI","IBANESTI",35,37823,0,3,1996,1421,1283,138,1407,14,2200,779,1062,345,
7,"BOTOSANI",74,37823,,185,0,"SAT DUMBRAVITA","IBANESTI",35,37823,0,3,1279,980,827,153,968,12,1400,420,634,334,
7,"BOTOSANI",74,37850,,186,0,"SAT LEORDA","LEORDA",36,37850,0,3,1966,1288,1177,111,1277,11,2100,812,860,417,
7,"BOTOSANI",74,37912,,187,0,"SAT LUNCA","LUNCA",37,37912,0,3,1590,1016,893,123,1006,10,1700,684,767,239,
7,"BOTOSANI",74,37912,,188,0,"SAT STROIESTI","LUNCA",37,37912,0,3,879,575,512,63,565,10,950,375,402,163,
7,"BOTOSANI",74,37912,,189,0,"SAT ZLATUNOAIA","LUNCA",37,37912,0,3,1928,1186,1065,121,1158,28,2100,914,821,337,
7,"BOTOSANI",74,37958,,190,0,"SAT MANOLEASA","MANOLEASA",38,37958,0,3,653,450,387,63,440,10,700,250,330,110,
7,"BOTOSANI",74,37958,,191,0,"SAT FLONDORA","MANOLEASA",38,37958,0,3,448,358,321,37,352,6,500,142,251,101,
7,"BOTOSANI",74,37958,,192,0,"SAT LIVENI","MANOLEASA",38,37958,0,3,956,647,566,81,638,6,1050,403,474,164,
7,"BOTOSANI",74,37958,,193,0,"SAT SADOVENI","MANOLEASA",38,37958,0,3,421,316,274,42,314,2,500,184,216,98,
7,"BOTOSANI",74,37958,,194,0,"SAT ZAHORENI","MANOLEASA",38,37958,0,3,466,380,341,39,376,4,500,120,268,108,
7,"BOTOSANI",74,38063,,195,0,"SAT IPOTESTI","MIHAI EMINESCU",39,38063,0,3,998,648,555,93,643,5,1100,452,418,225,
7,"BOTOSANI",74,38063,,196,0,"SAT CUCORANI","MIHAI EMINESCU",39,38063,0,3,719,479,420,59,474,5,804,325,339,135,
7,"BOTOSANI",74,38063,,197,0,"SAT CERVICESTI","MIHAI EMINESCU",39,38063,0,3,644,503,429,74,496,7,700,197,313,183,
7,"BOTOSANI",74,38063,,198,0,"SAT CATAMARASTI DEAL","MIHAI EMINESCU",39,38063,0,3,1301,846,673,173,834,12,1400,554,503,331,
7,"BOTOSANI",74,38063,,199,0,"SAT STINCESTI","MIHAI EMINESCU",39,38063,0,3,1045,663,601,62,657,6,1150,481,464,193,
7,"BOTOSANI",74,38161,,200,0,"SAT MIHAILENI","MIHAILENI",40,38161,0,3,1535,1018,835,183,1004,14,1700,682,673,331,
7,"BOTOSANI",74,38161,,201,0,"SAT ROGOJESTI","MIHAILENI",40,38161,0,3,532,370,311,59,367,3,600,230,194,173,
7,"BOTOSANI",74,38161,,202,0,"SAT CANDESTI","MIHAILENI",40,38161,0,3,1278,747,659,88,736,11,1400,653,458,278,
7,"BOTOSANI",74,38161,,203,0,"SAT TALPA","MIHAILENI",40,38161,0,3,517,389,322,67,386,3,600,211,333,53,
7,"BOTOSANI",74,38241,,204,0,"SAT MIHALASENI","MIHALASENI",41,38241,0,3,940,593,545,48,538,7,1000,455,388,150,
7,"BOTOSANI",74,38241,,205,0,"SAT NASTASE","MIHALASENI",41,38241,0,3,668,419,365,54,414,5,700,281,303,111,
7,"BOTOSANI",74,38241,,206,0,"SAT SARATA","MIHALASENI",41,38241,0,3,412,258,219,39,252,6,450,192,198,54,
7,"BOTOSANI",74,38321,,207,0,"SAT MILEANCA","MILEANCA",42,38321,0,3,1557,977,872,105,964,13,1700,723,680,284,
7,"BOTOSANI",74,38321,,208,0,"SAT CODRENI","MILEANCA",42,38321,0,3,614,370,319,51,366,4,700,330,277,89,
7,"BOTOSANI",74,38321,,209,0,"SAT SILISTEA","MILEANCA",42,38321,0,3,317,254,212,42,252,2,350,96,194,58,
7,"BOTOSANI",74,38376,,210,0,"SAT MITOC","MITOC",43,38376,0,3,1149,719,653,66,712,7,1248,529,557,155,
7,"BOTOSANI",74,38376,,211,0,"SAT HORIA","MITOC",43,38376,0,3,533,382,355,27,381,1,600,218,325,56,
7,"BOTOSANI",74,38456,,212,0,"SAT NICSENI","NICSENI",44,38456,0,3,1032,730,658,72,721,9,1080,350,538,183,
7,"BOTOSANI",74,38456,,213,0,"SAT DOROBANTI","NICSENI",44,38456,0,3,1226,1026,873,153,1018,8,1350,324,858,160,
7,"BOTOSANI",74,38492,,214,0,"SAT PALTINIS","PALTINIS",45,38492,0,3,1150,781,650,131,768,13,1250,469,572,196,
7,"BOTOSANI",74,38492,,215,0,"SAT PALTINIS","PALTINIS",45,38492,0,3,670,512,383,129,508,4,700,188,422,86,
7,"BOTOSANI",74,38492,,216,0,"SAT HORODISTEA","PALTINIS",45,38492,0,3,961,646,533,113,637,9,1050,404,471,166,
7,"BOTOSANI",74,38544,,217,0,"SAT POMIRLA","POMARLA",46,38544,0,3,1955,1245,1188,57,1234,11,2100,855,962,272,
7,"BOTOSANI",74,38544,,218,0,"SAT RACOVAT","POMARLA",46,38544,0,3,290,234,185,49,226,8,350,116,168,58,
7,"BOTOSANI",74,38580,,219,0,"SAT PRAJENI","PRAJENI",47,38580,0,3,2098,1230,1171,59,1210,20,2250,1020,868,342,
7,"BOTOSANI",74,38580,,220,0,"SAT MILETIN","PRAJENI",47,38580,0,3,478,309,282,27,307,2,550,241,246,61,
7,"BOTOSANI",74,38633,,221,0,"SAT RADAUTI PRUT","RADAUTI-PRUT",49,38633,0,3,721,572,463,109,569,3,800,228,397,172,
7,"BOTOSANI",74,38633,,222,0,"SAT REDIU","RADAUTI-PRUT",49,38633,0,3,942,663,561,102,651,12,1050,387,520,131,
7,"BOTOSANI",74,38633,,223,0,"SAT MIORCANI","RADAUTI-PRUT",49,38633,0,3,1815,1344,1248,96,1335,9,1950,606,1032,303,
7,"BOTOSANI",74,35839,,224,0,"SAT RACHITI","RACHITI",48,35839,0,3,1153,603,551,52,593,10,1240,637,388,205,
7,"BOTOSANI",74,35839,,225,0,"SAT COSTESTI","RACHITI",48,35839,0,3,1121,909,782,127,899,10,1200,291,623,276,
7,"BOTOSANI",74,35839,,226,0,"SAT ROSIORI","RACHITI",48,35839,0,3,978,692,567,125,685,7,1050,358,512,173,
7,"BOTOSANI",74,38679,,227,0,"SAT RAUSENI","RAUSENI",50,38679,0,3,1380,868,737,131,863,5,1500,632,704,159,
7,"BOTOSANI",74,38679,,228,0,"SAT DOINA","RAUSENI",50,38679,0,3,465,308,266,42,308,0,500,192,249,59,
7,"BOTOSANI",74,38679,,229,0,"SAT REDIU","RAUSENI",50,38679,0,3,463,310,266,44,303,7,500,190,253,50,
7,"BOTOSANI",74,38731,,230,0,"SAT RIPICENI","RIPICENI",51,38731,0,3,1815,1319,1233,86,1303,16,1950,631,911,392,
7,"BOTOSANI",74,38811,,231,0,"SAT ROMA","ROMA",52,38811,0,3,1223,949,848,101,942,7,1350,401,666,276,
7,"BOTOSANI",74,38811,,232,0,"SAT ROMA","ROMA",52,38811,0,3,871,624,561,63,615,9,950,326,417,198,
7,"BOTOSANI",74,38811,,233,0,"SAT COTARGACI","ROMA",52,38811,0,3,418,275,239,36,274,1,500,225,216,58,
7,"BOTOSANI",74,38848,,234,0,"SAT ROMANESTI","ROMANESTI",53,38848,0,3,1309,860,783,77,843,17,1450,590,666,177,
7,"BOTOSANI",74,38848,,235,0,"SAT DAMIDENI","ROMANESTI",53,38848,0,3,528,344,291,53,336,8,600,256,272,64,
7,"BOTOSANI",74,38893,,236,0,"SAT SANTA MARE","SANTA MARE",54,38893,0,3,1146,733,628,105,724,9,1250,517,529,195,
7,"BOTOSANI",74,38893,,237,0,"SAT BERZA","SANTA MARE",54,38893,0,3,179,154,114,40,150,4,200,46,115,35,
7,"BOTOSANI",74,38893,,238,0,"SAT BOGDANESTI","SANTA MARE",54,38893,0,3,810,467,411,56,457,10,900,433,349,108,
7,"BOTOSANI",74,38893,,239,0,"SAT ILISENI","SANTA MARE",54,38893,0,3,262,300,176,124,297,3,300,0,255,42,
7,"BOTOSANI",74,38982,,240,0,"SAT SUHARAU","SUHARAU",59,38982,0,3,1195,741,657,84,733,8,1300,559,569,164,
7,"BOTOSANI",74,38982,,241,0,"SAT  SUHARAU","SUHARAU",59,38982,0,3,690,519,441,78,512,7,750,231,432,80,
7,"BOTOSANI",74,38982,,242,0,"SAT LISMNA","SUHARAU",59,38982,0,3,787,612,529,83,610,2,850,238,397,213,
7,"BOTOSANI",74,38982,,243,0,"SAT OROFTIANA","SUHARAU",59,38982,0,3,956,593,539,54,577,16,1050,457,380,197,
7,"BOTOSANI",74,38982,,244,0,"SAT SMIRDAN","SUHARAU",59,38982,0,3,755,565,472,93,561,4,800,235,390,171,
7,"BOTOSANI",74,39051,,245,0,"SAT SULITA","SULITA",60,39051,0,3,1113,704,601,103,699,5,1206,502,504,195,
7,"BOTOSANI",74,39051,,246,0,"SAT DRACSANI","SULITA",60,39051,0,3,1532,1069,941,128,1054,15,1700,631,780,274,
7,"BOTOSANI",74,39051,,247,0,"SAT BLINDESTI","SULITA",60,39051,0,3,1534,1012,882,130,991,21,1640,628,695,296,
7,"BOTOSANI",74,39051,,248,0,"SAT SOLDANESTI","SULITA",60,39051,0,3,358,318,271,47,315,3,400,82,205,110,
7,"BOTOSANI",74,39122,,249,0,"SAT SENDRICENI","SENDRICENI",55,39122,0,3,904,599,508,91,593,6,1000,401,447,146,
7,"BOTOSANI",74,39122,,250,0,"SAT SENDRICENI","SENDRICENI",55,39122,0,3,589,423,360,63,419,4,650,227,288,131,
7,"BOTOSANI",74,39122,,251,0,"SAT HORLACENI","SENDRICENI",55,39122,0,3,487,281,240,41,277,4,500,219,216,61,
7,"BOTOSANI",74,39122,,252,0,"SAT PADURENI","SENDRICENI",55,39122,0,3,982,601,538,63,599,2,1050,449,427,172,
7,"BOTOSANI",74,35884,,253,0,"SAT STAUCENI","STAUCENI",56,35884,0,3,1247,895,775,120,888,7,1348,453,551,337,
7,"BOTOSANI",74,35884,,254,0,"SAT TOCILENI","STAUCENI",56,35884,0,3,1173,783,676,107,776,7,1240,457,434,342,
7,"BOTOSANI",74,39168,,255,0,"SAT BOBULESTI","STEFANESTI",57,39168,0,3,1115,771,665,106,758,13,1200,429,643,115,
7,"BOTOSANI",74,39168,,256,0,"SAT STEFANESTI","STEFANESTI",57,39168,0,3,2667,1463,1292,171,1440,23,2900,1437,1081,359,
7,"BOTOSANI",74,39168,,257,0,"SAT STINCA","STEFANESTI",57,39168,0,3,760,525,421,104,519,6,850,325,368,151,
7,"BOTOSANI",74,39220,,258,0,"SAT STIUBIENI","STIUBIENI",58,39220,0,3,1616,1019,942,77,1006,13,1750,731,812,194,
7,"BOTOSANI",74,39220,,259,0,"SAT NEGRENI","STIUBIENI",58,39220,0,3,672,515,419,96,507,8,800,285,347,160,
7,"BOTOSANI",74,39266,,260,0,"SAT TODIRENI","TODIRENI",61,39266,0,3,1847,1106,991,115,1089,17,2000,894,878,211,
7,"BOTOSANI",74,39266,,261,0,"SAT CERNESTI","TODIRENI",61,39266,0,3,1144,752,628,124,744,8,1250,498,643,101,
7,"BOTOSANI",74,39328,,262,0,"SAT TRUSESTI","TRUSESTI",62,39328,0,3,1939,1269,1122,147,1257,12,2100,831,817,440,
7,"BOTOSANI",74,39328,,263,0,"SAT BUHACENI","TRUSESTI",62,39328,0,3,685,491,429,62,485,6,750,259,356,129,
7,"BOTOSANI",74,39328,,264,0,"SAT DRISLEA","TRUSESTI",62,39328,0,3,870,567,523,44,559,8,950,383,427,132,
7,"BOTOSANI",74,39328,,265,0,"SAT IONASENI","TRUSESTI",62,39328,0,3,996,764,663,101,753,11,1048,284,599,154,
7,"BOTOSANI",74,39391,,266,0,"SAT TUDORA","TUDORA",63,39391,0,3,1803,963,855,108,933,30,1950,987,697,236,
7,"BOTOSANI",74,39391,,267,0,"SAT TUDORA","TUDORA",63,39391,0,3,1035,608,470,138,602,6,1100,492,443,159,
7,"BOTOSANI",74,39391,,268,0,"SAT TUDORA","TUDORA",63,39391,0,3,1374,745,600,145,732,13,1500,755,557,175,
7,"BOTOSANI",74,39417,,269,0,"SAT UNGURENI","UNGURENI",64,39417,0,3,1245,870,705,165,864,6,1350,480,623,241,
7,"BOTOSANI",74,39417,,270,0,"SAT EPURENI","UNGURENI",64,39417,0,3,1168,763,654,109,752,11,1253,490,517,235,
7,"BOTOSANI",74,39417,,271,0,"SAT  MIHAI VITEAZU","UNGURENI",64,39417,0,3,354,296,243,53,296,0,400,104,207,89,
7,"BOTOSANI",74,39417,,272,0,"SAT PLOPENII MARI","UNGURENI",64,39417,0,3,885,613,525,88,605,5,966,353,460,145,
7,"BOTOSANI",74,39417,,273,0,"SAT BORZESTI","UNGURENI",64,39417,0,3,1247,772,680,92,758,14,1350,578,617,141,
7,"BOTOSANI",74,39417,,274,0,"SAT CALUGARENII VECHI","UNGURENI",64,39417,0,3,528,474,340,134,465,9,600,126,333,132,
7,"BOTOSANI",74,39532,,275,0,"SAT UNTENI","UNTENI",65,39532,0,3,1196,732,683,49,719,13,1300,568,568,151,
7,"BOTOSANI",74,39532,,276,0,"SAT MANASTIRENI","UNTENI",65,39532,0,3,668,451,397,54,443,8,750,299,364,79,
7,"BOTOSANI",74,39532,,277,0,"SAT BURLESTI","UNTENI",65,39532,0,3,665,568,537,31,559,9,750,182,443,116,
7,"BOTOSANI",74,39612,,278,0,"SAT VACULESTI","VACULESTI",66,39612,0,3,937,643,547,96,634,7,1058,417,373,261,
7,"BOTOSANI",74,39612,,279,0,"SAT SAUCENITA","VACULESTI",66,39612,0,3,778,561,471,90,548,5,850,297,365,183,
7,"BOTOSANI",74,39658,,280,0,"SAT VIISOARA","VIISOARA",68,39658,0,3,905,654,609,45,645,9,1000,346,490,155,
7,"BOTOSANI",74,39658,,281,0,"SAT CUZA VODA","VIISOARA",68,39658,0,3,558,433,403,30,432,1,600,167,341,91,
7,"BOTOSANI",74,39658,,282,0,"SAT VIISOARA MICA","VIISOARA",68,39658,0,3,536,393,349,44,387,6,600,207,298,89,
7,"BOTOSANI",74,39694,,283,0,"SAT VIRFU CIMPULUI","VARFU CAMPULUI",67,39694,0,3,1698,1154,1013,141,1138,16,1850,696,818,320,
7,"BOTOSANI",74,39694,,284,0,"SAT IONASENI","VARFU CAMPULUI",67,39694,0,3,700,483,429,54,478,5,800,317,335,143,
7,"BOTOSANI",74,39694,,285,0,"SAT LUNCA","VARFU CAMPULUI",67,39694,0,3,625,462,365,97,454,8,700,238,366,88,
7,"BOTOSANI",74,39738,,286,0,"SAT VLADENI DEAL","VLADENI",69,39738,0,3,1490,959,850,109,952,7,1600,641,630,322,
7,"BOTOSANI",74,39738,,287,0,"SAT BREHUIESTI","VLADENI",69,39738,0,3,1221,821,729,92,809,12,1350,529,565,244,
7,"BOTOSANI",74,39738,,288,0,"SAT MINDRESTI","VLADENI",69,39738,0,3,1140,794,727,67,783,11,1250,456,562,221,
7,"BOTOSANI",74,39792,,289,0,"SAT VLASINESTI","VLASINESTI",70,39792,0,3,1462,1034,928,106,1023,11,1631,597,752,271,
7,"BOTOSANI",74,39792,,290,0,"SAT SIRBI","VLASINESTI",70,39792,0,3,1215,851,717,134,839,12,1300,449,618,221,
7,"BOTOSANI",74,39836,,291,0,"SAT VORNICENI","VORNICENI",71,39836,0,3,1616,996,788,208,985,11,1750,754,766,219,
7,"BOTOSANI",74,39836,,292,0,"SAT VORNICENI","VORNICENI",71,39836,0,3,1729,936,764,172,922,14,1900,964,736,186,
7,"BOTOSANI",74,39836,,293,0,"SAT DEALU CRUCII","VORNICENI",71,39836,0,3,332,187,157,30,185,2,400,213,146,39,
7,"BOTOSANI",74,39872,,294,0,"SAT VORONA NOUA","VORONA",72,39872,0,3,661,536,333,203,533,3,700,164,308,225,
7,"BOTOSANI",74,39872,,295,0,"SAT VORONA CENTRU","VORONA",72,39872,0,3,563,555,269,286,541,14,600,45,349,192,
7,"BOTOSANI",74,39872,,296,0,"SAT VORONA MARE","VORONA",72,39872,0,3,1009,608,461,147,602,6,1100,492,400,202,
7,"BOTOSANI",74,39872,,297,0,"SAT JOLDESTI","VORONA",72,39872,0,3,1065,606,538,68,593,13,1150,544,482,111,
7,"BOTOSANI",74,39872,,298,0,"SAT ICUSENI","VORONA",72,39872,0,3,1111,638,488,150,632,6,1202,564,433,199,
7,"BOTOSANI",74,39872,,299,0,"SAT POIANA","VORONA",72,39872,0,3,1517,567,502,65,565,2,1650,1083,402,163,
7,"BOTOSANI",74,39872,,300,0,"SAT CHISCOVATA","VORONA",72,39872,0,3,462,321,200,121,315,3,600,282,174,141,
8,"BRASOV",83,40198,,1,0,"Str. EgalitÇîii nr.27","MUNICIPIUL BRASOV",1,40198,1,1,1350,710,667,43,688,22,1400,690,468,220,
8,"BRASOV",83,40198,,2,0,"Str. EgalitÇîii nr.27","MUNICIPIUL BRASOV",1,40198,1,1,1271,617,567,50,601,16,1319,702,425,176,
8,"BRASOV",83,40198,,3,0,"Str. Constantin BrOncoveanu nr.33","MUNICIPIUL BRASOV",1,40198,1,1,1053,546,510,36,536,10,1204,658,422,114,
8,"BRASOV",83,40198,,4,0,"Str. Constantin BrOncoveanu nr.33","MUNICIPIUL BRASOV",1,40198,1,1,1430,789,727,62,751,38,1500,711,605,146,
8,"BRASOV",83,40198,,5,0,"Str. Prundului nr.45 (30 Decembrie)","MUNICIPIUL BRASOV",1,40198,1,1,841,542,393,149,526,16,909,367,395,131,
8,"BRASOV",83,40198,,6,0,"Str. Prundului nr.45 - intrarea Str. Bisericii Sf.Nicolae","MUNICIPIUL BRASOV",1,40198,1,1,1016,614,541,73,598,16,1125,511,476,122,
8,"BRASOV",83,40198,,7,0,"Str. Prundului nr.45 - intrarea Str. Bisericii Sf.Nicolae","MUNICIPIUL BRASOV",1,40198,1,1,1530,783,718,65,763,20,1600,817,598,165,
8,"BRASOV",83,40198,,8,0,"Str. Castelului nr.4","MUNICIPIUL BRASOV",1,40198,1,1,1338,739,673,66,716,23,1400,661,565,151,
8,"BRASOV",83,40198,,9,0,"Str. Castelului nr.4","MUNICIPIUL BRASOV",1,40198,1,1,1182,593,551,42,586,7,1200,607,471,115,
8,"BRASOV",83,40198,,10,0,"Str. Castelului nr.4","MUNICIPIUL BRASOV",1,40198,1,1,1376,660,616,44,638,20,1400,740,527,111,
8,"BRASOV",83,40198,,11,0,"Str. DupÇ Ziduri nr.1","MUNICIPIUL BRASOV",1,40198,1,1,1546,815,739,76,785,30,1600,785,629,156,
8,"BRASOV",83,40198,,12,0,"Str. DupÇ Ziduri nr.1","MUNICIPIUL BRASOV",1,40198,1,1,1481,819,756,63,797,22,1500,681,634,163,
8,"BRASOV",83,40198,,13,0,"B-dul Eroilor nr.7","MUNICIPIUL BRASOV",1,40198,1,1,1162,738,602,136,716,22,1200,462,549,167,
8,"BRASOV",83,40198,,14,0,"B-dul Eroilor nr.7","MUNICIPIUL BRASOV",1,40198,1,1,1411,793,719,74,775,18,1500,707,618,157,
8,"BRASOV",83,40198,,15,0,"Str. PÇltini­ nr.6","MUNICIPIUL BRASOV",1,40198,1,1,1526,993,845,148,972,21,1600,607,725,247,
8,"BRASOV",83,40198,,16,0,"Str. PÇltini­ nr.6","MUNICIPIUL BRASOV",1,40198,1,1,912,542,504,38,523,19,1000,458,408,115,
8,"BRASOV",83,40198,,17,0,"Str. Verii nr.1","MUNICIPIUL BRASOV",1,40198,1,1,1346,826,764,62,808,18,1412,586,634,174,
8,"BRASOV",83,40198,,18,0,"Str. N.Titulescu nr.2","MUNICIPIUL BRASOV",1,40198,1,1,971,591,507,84,579,12,1000,409,465,114,
8,"BRASOV",83,40198,,19,0,"Str. Dr.Cantacuzino nr.3 - acces Str. Toma Ionescu","MUNICIPIUL BRASOV",1,40198,1,1,1146,623,582,41,603,20,1200,577,503,100,
8,"BRASOV",83,40198,,20,0,"Str. Plevnei nr.2 corp 2","MUNICIPIUL BRASOV",1,40198,1,1,1088,636,594,42,615,21,1104,468,499,116,
8,"BRASOV",83,40198,,21,0,"Str. Mihai Viteazul nr.100 corp A","MUNICIPIUL BRASOV",1,40198,1,1,1366,834,688,146,811,23,1409,575,626,185,
8,"BRASOV",83,40198,,22,0,"Str. Dr.Cantacuzino nr.3","MUNICIPIUL BRASOV",1,40198,1,1,1175,677,632,45,655,22,1200,523,484,171,
8,"BRASOV",83,40198,,23,0,"Str. Dr.Cantacuzino nr.3","MUNICIPIUL BRASOV",1,40198,1,1,1159,630,593,37,598,32,1200,570,500,98,
8,"BRASOV",83,40198,,24,0,"Intrarea din str. Nicolae Iorga nr.1","MUNICIPIUL BRASOV",1,40198,1,1,1369,925,714,211,902,23,1500,575,734,168,
8,"BRASOV",83,40198,,25,0,"Str. De Mijloc nr.47","MUNICIPIUL BRASOV",1,40198,1,1,744,389,348,41,382,7,804,415,314,68,
8,"BRASOV",83,40198,,26,0,"Str. De Mijloc nr.47","MUNICIPIUL BRASOV",1,40198,1,1,1228,606,557,49,597,9,1300,694,472,125,
8,"BRASOV",83,40198,,27,0,"Str. ¸colii nr.2A","MUNICIPIUL BRASOV",1,40198,1,1,1514,810,734,76,795,15,1608,798,593,202,
8,"BRASOV",83,40198,,28,0,"Str. Memorandumului nr.10","MUNICIPIUL BRASOV",1,40198,1,1,1408,854,740,114,835,19,1498,644,684,151,
8,"BRASOV",83,40198,,29,0,"Str. LungÇ nr.192-194","MUNICIPIUL BRASOV",1,40198,1,1,1297,736,633,103,718,18,1300,564,577,141,
8,"BRASOV",83,40198,,30,0,"Str. LungÇ nr.192-194","MUNICIPIUL BRASOV",1,40198,1,1,1214,630,549,81,608,22,1300,670,471,137,
8,"BRASOV",83,40198,,31,0,"Str. MicÇ nr.10","MUNICIPIUL BRASOV",1,40198,1,1,1093,565,516,49,549,14,1200,635,336,213,
8,"BRASOV",83,40198,,32,0,"Str. Carierii nr.15","MUNICIPIUL BRASOV",1,40198,1,1,1331,723,622,101,715,8,1400,677,489,226,
8,"BRASOV",83,40198,,33,0,"Str. LungÇ nr.261","MUNICIPIUL BRASOV",1,40198,1,1,1400,694,616,78,684,10,1500,806,447,237,
8,"BRASOV",83,40198,,34,0,"Str. Inului nr.14","MUNICIPIUL BRASOV",1,40198,1,1,1139,655,564,91,635,20,1252,597,402,233,
8,"BRASOV",83,40198,,35,0,"Str. Agricultorilor nr.3","MUNICIPIUL BRASOV",1,40198,1,1,2470,1182,1118,64,1160,22,2608,1426,687,473,
8,"BRASOV",83,40198,,36,0,"Str. Agricultorilor nr.3","MUNICIPIUL BRASOV",1,40198,1,1,1488,700,662,38,690,10,1600,900,410,280,
8,"BRASOV",83,40198,,37,0,"Str. Lnii nr.6","MUNICIPIUL BRASOV",1,40198,1,1,1693,881,779,102,860,21,1700,819,463,397,
8,"BRASOV",83,40198,,38,0,"Str. Lanurilor nr.9","MUNICIPIUL BRASOV",1,40198,1,1,765,326,303,23,322,4,850,524,157,165,
8,"BRASOV",83,40198,,39,0,"Str. Agricultorilor","MUNICIPIUL BRASOV",1,40198,1,1,1828,863,814,49,843,20,1893,1030,465,378,
8,"BRASOV",83,40198,,40,0,"Str. Gospodarilor nr.1","MUNICIPIUL BRASOV",1,40198,1,1,937,465,408,57,460,5,1000,535,261,199,
8,"BRASOV",83,40198,,41,0,"Str. ¸colii nr.6A","MUNICIPIUL BRASOV",1,40198,1,1,1600,829,791,38,806,23,1706,877,577,229,
8,"BRASOV",83,40198,,42,0,"Str. ¸colii nr.11","MUNICIPIUL BRASOV",1,40198,1,1,1292,742,629,113,722,20,1406,664,542,180,
8,"BRASOV",83,40198,,43,0,"Str. Fagurului nr.1","MUNICIPIUL BRASOV",1,40198,1,1,1854,913,816,97,905,8,1885,972,452,453,
8,"BRASOV",83,40198,,44,0,"Str. T. Vladimirescu nr.33","MUNICIPIUL BRASOV",1,40198,1,1,1023,535,512,23,520,15,1100,565,388,132,
8,"BRASOV",83,40198,,45,0,"B-dul. Griviîei nr.55","MUNICIPIUL BRASOV",1,40198,1,1,1582,937,861,76,918,19,1695,758,688,230,
8,"BRASOV",83,40198,,46,0,"Str. Mihai Viteazu nr.100","MUNICIPIUL BRASOV",1,40198,1,1,1246,732,678,54,723,9,1300,568,515,208,
8,"BRASOV",83,40198,,47,0,"Str. Mihai Viteazu","MUNICIPIUL BRASOV",1,40198,1,1,2245,1198,1102,96,1176,22,2300,1102,924,252,
8,"BRASOV",83,40198,,48,0,"Str. Armoniei nr.6","MUNICIPIUL BRASOV",1,40198,1,1,1730,991,933,58,967,24,1878,887,673,294,
8,"BRASOV",83,40198,,49,0,"Str. Armoniei nr.6","MUNICIPIUL BRASOV",1,40198,1,1,1673,964,918,46,951,13,1703,726,762,189,
8,"BRASOV",83,40198,,50,0,"Str. Armoniei nr.6","MUNICIPIUL BRASOV",1,40198,1,1,1143,650,619,31,636,14,1200,550,489,147,
8,"BRASOV",83,40198,,51,0,"Str. Aurel Vlaicu nr.26 bis","MUNICIPIUL BRASOV",1,40198,1,1,1659,833,787,46,818,15,1804,971,631,187,
8,"BRASOV",83,40198,,52,0,"Str. Aurel Vlaicu nr.26 bis","MUNICIPIUL BRASOV",1,40198,1,1,2738,1362,1293,69,1332,30,2800,1438,897,435,
8,"BRASOV",83,40198,,53,0,"Str. T.Vladimirescu nr.33","MUNICIPIUL BRASOV",1,40198,1,1,2032,1151,1077,74,1127,24,2100,949,836,291,
8,"BRASOV",83,40198,,54,0,"Str. 1 Decembrie 1918 nr.4","MUNICIPIUL BRASOV",1,40198,1,1,2523,1371,1294,77,1348,23,2616,1245,868,480,
8,"BRASOV",83,40198,,55,0,"Str. 1 Decembrie 1918 nr.4","MUNICIPIUL BRASOV",1,40198,1,1,1809,983,947,36,960,23,1912,929,623,337,
8,"BRASOV",83,40198,,56,0,"Str. 1 Decembrie 1918 nr.4","MUNICIPIUL BRASOV",1,40198,1,1,1045,615,578,37,607,8,1107,492,456,151,
8,"BRASOV",83,40198,,57,0,"Str. Olteî nr.11","MUNICIPIUL BRASOV",1,40198,1,1,1620,839,801,38,815,24,1698,859,597,218,
8,"BRASOV",83,40198,,58,0,"Str. Olteî nr.12","MUNICIPIUL BRASOV",1,40198,1,1,1031,662,576,86,653,9,1100,438,469,184,
8,"BRASOV",83,40198,,59,0,"Str. Olteî nr.12","MUNICIPIUL BRASOV",1,40198,1,1,1040,582,554,28,568,14,1115,533,419,149,
8,"BRASOV",83,40198,,60,0,"Str. Olteî nr.12","MUNICIPIUL BRASOV",1,40198,1,1,1745,997,924,73,974,23,1800,803,651,323,
8,"BRASOV",83,40198,,61,0,"Ale. Constructorilor nr.1-3","MUNICIPIUL BRASOV",1,40198,1,1,2980,1795,1578,217,1761,28,2100,311,1001,760,
8,"BRASOV",83,40198,,62,0,"Str. 13 Decembrie nr.125","MUNICIPIUL BRASOV",1,40198,1,1,2468,1359,1291,68,1338,21,2500,1131,823,515,
8,"BRASOV",83,40198,,63,0,"Str. 13 Decembrie nr.125","MUNICIPIUL BRASOV",1,40198,1,1,1616,774,736,38,763,11,1700,926,425,338,
8,"BRASOV",83,40198,,64,0,"Str. 13 Decembrie nr.125","MUNICIPIUL BRASOV",1,40198,1,1,1872,1008,942,66,992,16,2126,1118,586,406,
8,"BRASOV",83,40198,,65,0,"Str. 13 Decembrie nr.125","MUNICIPIUL BRASOV",1,40198,1,1,1320,709,641,68,699,10,1400,691,350,349,
8,"BRASOV",83,40198,,66,0,"Str. 13 Decembrie nr.131","MUNICIPIUL BRASOV",1,40198,1,1,1141,1092,548,544,1066,26,1500,396,721,345,
8,"BRASOV",83,40198,,67,0,"Str. 13 Decembrie nr.131","MUNICIPIUL BRASOV",1,40198,1,1,2178,1228,965,263,1205,23,2195,967,842,363,
8,"BRASOV",83,40198,,68,0,"Str. Bihorului nr.3","MUNICIPIUL BRASOV",1,40198,1,1,982,564,520,44,553,11,1100,536,445,108,
8,"BRASOV",83,40198,,69,0,"Str. Bihorului nr.3","MUNICIPIUL BRASOV",1,40198,1,1,811,501,441,60,483,18,900,399,381,102,
8,"BRASOV",83,40198,,70,0,"Str. Bihorului nr.3","MUNICIPIUL BRASOV",1,40198,1,1,1201,648,605,43,632,16,1301,653,507,125,
8,"BRASOV",83,40198,,71,0,"B-dul. Victoriei nr.10","MUNICIPIUL BRASOV",1,40198,1,1,1058,673,590,83,663,10,1100,427,536,127,
8,"BRASOV",83,40198,,72,0,"Aleea LÇcrÇmioarelor nr.2","MUNICIPIUL BRASOV",1,40198,1,1,1393,859,815,44,830,29,1519,660,665,165,
8,"BRASOV",83,40198,,73,0,"Aleea LÇcrÇmioarelor nr.2","MUNICIPIUL BRASOV",1,40198,1,1,1549,917,868,49,897,20,1600,683,672,225,
8,"BRASOV",83,40198,,74,0,"Aleea LÇcrÇmioarelor nr.2","MUNICIPIUL BRASOV",1,40198,1,1,1842,1051,1018,33,1027,24,1900,849,782,245,
8,"BRASOV",83,40198,,75,0,"B-dul GÇrii","MUNICIPIUL BRASOV",1,40198,1,1,594,322,302,20,319,3,700,378,237,82,
8,"BRASOV",83,40198,,76,0,"B-dul GÇrii","MUNICIPIUL BRASOV",1,40198,1,1,741,1639,391,1248,1604,35,2000,361,973,631,
8,"BRASOV",83,40198,,77,0,"Str. HÇrmanului nr.54","MUNICIPIUL BRASOV",1,40198,1,1,1264,715,669,46,701,14,1300,585,481,220,
8,"BRASOV",83,40198,,78,0,"Str. AlbÇstrelelor nr.29A","MUNICIPIUL BRASOV",1,40198,1,1,3024,1669,1526,143,1637,31,3164,1495,1197,440,
8,"BRASOV",83,40198,,79,0,"FundÇtura HÇrmanului nr.12","MUNICIPIUL BRASOV",1,40198,1,1,3141,1886,1483,403,1865,21,3203,1317,948,917,
8,"BRASOV",83,40198,,80,0,"Str. Simeria nr.5","MUNICIPIUL BRASOV",1,40198,1,1,1989,1139,1077,62,1129,10,2100,961,662,467,
8,"BRASOV",83,40198,,81,0,"Str. Simeria nr.5","MUNICIPIUL BRASOV",1,40198,1,1,2148,1255,1168,87,1238,17,2295,1040,706,532,
8,"BRASOV",83,40198,,82,0,"Str. Prof. Bogdan Alexandru nr.4 (Dobroliubov)","MUNICIPIUL BRASOV",1,40198,1,1,1804,958,899,59,933,25,1900,942,606,327,
8,"BRASOV",83,40198,,83,0,"Str. Prof. Bogdan Alexandru nr.4 (Dobroliubov)","MUNICIPIUL BRASOV",1,40198,1,1,1572,879,835,44,862,17,1700,821,539,323,
8,"BRASOV",83,40198,,84,0,"Str. Drezinei nr.2","MUNICIPIUL BRASOV",1,40198,1,1,2055,1112,1054,58,1098,14,2103,991,708,390,
8,"BRASOV",83,40198,,85,0,"Str. Busuiocului nr.1","MUNICIPIUL BRASOV",1,40198,1,1,1554,832,789,43,818,14,1600,768,597,221,
8,"BRASOV",83,40198,,86,0,"Str. Busuiocului nr.1","MUNICIPIUL BRASOV",1,40198,1,1,2032,1069,1022,47,1046,23,2100,1031,757,289,
8,"BRASOV",83,40198,,87,0,"Str. Busuiocului nr.1","MUNICIPIUL BRASOV",1,40198,1,1,1542,783,745,38,776,7,1600,817,518,258,
8,"BRASOV",83,40198,,88,0,"Str. AlbÇstrelelor nr.10","MUNICIPIUL BRASOV",1,40198,1,1,1497,826,775,51,806,20,1603,777,569,237,
8,"BRASOV",83,40198,,89,0,"Str. MÇrgÇritarelor nr.2","MUNICIPIUL BRASOV",1,40198,1,1,1950,1111,1069,42,1091,20,2097,986,807,284,
8,"BRASOV",83,40198,,90,0,"Str. MÇrgÇritarelor nr.2","MUNICIPIUL BRASOV",1,40198,1,1,506,318,278,40,313,5,917,599,242,71,
8,"BRASOV",83,40198,,91,0,"Str. MÇrgÇritarelor nr.2","MUNICIPIUL BRASOV",1,40198,1,1,1707,906,836,70,882,24,1800,894,638,244,
8,"BRASOV",83,40198,,92,0,"Str. MÇrgÇritarelor nr.2","MUNICIPIUL BRASOV",1,40198,1,1,1057,597,556,41,585,12,1100,503,427,158,
8,"BRASOV",83,40198,,93,0,"Str. MÇrgÇritarelor nr.2","MUNICIPIUL BRASOV",1,40198,1,1,1746,955,912,43,934,21,1800,845,679,255,
8,"BRASOV",83,40198,,94,0,"Aleea Mimozei nr.11","MUNICIPIUL BRASOV",1,40198,1,1,1894,971,901,70,955,16,2003,1032,630,325,
8,"BRASOV",83,40198,,95,0,"Aleea Mimozei nr.11","MUNICIPIUL BRASOV",1,40198,1,1,2973,1535,1466,69,1498,37,3144,1609,1034,464,
8,"BRASOV",83,40198,,96,0,"Str. ¸tefan cel Mare nr.11","MUNICIPIUL BRASOV",1,40198,1,1,1347,734,660,74,721,13,1549,815,521,200,
8,"BRASOV",83,40198,,97,0,"Str. ¸tefan cel Mare nr.11","MUNICIPIUL BRASOV",1,40198,1,1,1751,973,936,37,963,10,1800,827,700,263,
8,"BRASOV",83,40198,,98,0,"Str. Lunii nr.6","MUNICIPIUL BRASOV",1,40198,1,1,1668,838,794,44,821,17,1800,962,613,208,
8,"BRASOV",83,40198,,99,0,"Str. Zizinului nr.46","MUNICIPIUL BRASOV",1,40198,1,1,1793,939,820,119,917,22,1999,1060,669,248,
8,"BRASOV",83,40198,,100,0,"Str. Baba Novac nr.15a","MUNICIPIUL BRASOV",1,40198,1,1,2036,1071,967,104,1051,20,2203,1132,733,318,
8,"BRASOV",83,40198,,101,0,"Str. Busuiocului nr.1","MUNICIPIUL BRASOV",1,40198,1,1,1537,763,700,63,742,21,1700,774,551,191,
8,"BRASOV",83,40198,,102,0,"Str. Zizinului nr.128","MUNICIPIUL BRASOV",1,40198,1,1,730,376,315,61,364,12,901,525,263,101,
8,"BRASOV",83,40198,,103,0,"Str. Zizinului nr.144","MUNICIPIUL BRASOV",1,40198,1,1,1858,1017,899,118,1006,11,2025,1008,572,434,
8,"BRASOV",83,40198,,104,0,"Str. Zizinului nr.144","MUNICIPIUL BRASOV",1,40198,1,1,1948,1130,1093,37,1118,12,1991,861,682,436,
8,"BRASOV",83,40198,,105,0,"Str. Neptun nr.1","MUNICIPIUL BRASOV",1,40198,1,1,1467,730,687,43,705,25,1500,770,473,232,
8,"BRASOV",83,40198,,106,0,"Str. Neptun nr.1","MUNICIPIUL BRASOV",1,40198,1,1,1593,895,840,55,867,28,1700,805,664,203,
8,"BRASOV",83,40198,,107,0,"Str. Venus nr.1","MUNICIPIUL BRASOV",1,40198,1,1,1436,820,785,35,803,17,1500,680,568,235,
8,"BRASOV",83,40198,,108,0,"Str. Venus nr.1","MUNICIPIUL BRASOV",1,40198,1,1,511,311,290,21,303,8,600,289,240,63,
8,"BRASOV",83,40198,,109,0,"Str. Venus nr.1","MUNICIPIUL BRASOV",1,40198,1,1,939,534,497,37,527,7,1000,466,361,166,
8,"BRASOV",83,40198,,110,0,"Str. Jupiter nr.4","MUNICIPIUL BRASOV",1,40198,1,1,1850,1051,998,53,1041,10,1900,849,798,243,
8,"BRASOV",83,40198,,111,0,"Str. Minerva nr.11","MUNICIPIUL BRASOV",1,40198,1,1,1236,731,699,32,701,30,1303,572,497,204,
8,"BRASOV",83,40198,,112,0,"Str. Minerva nr.11","MUNICIPIUL BRASOV",1,40198,1,1,893,505,477,28,501,4,1000,495,391,110,
8,"BRASOV",83,40198,,113,0,"Str. Mercur nr.7","MUNICIPIUL BRASOV",1,40198,1,1,1772,1040,984,56,1024,16,1900,860,744,280,
8,"BRASOV",83,40198,,114,0,"Str. Aurora nr.24","MUNICIPIUL BRASOV",1,40198,1,1,1147,661,581,80,648,13,1299,638,505,143,
8,"BRASOV",83,40198,,115,0,"B-dul. ¸tefan cel Mare nr.15","MUNICIPIUL BRASOV",1,40198,1,1,911,499,460,39,481,18,997,498,384,97,
8,"BRASOV",83,40198,,116,0,"B-dul. ¸tefan cel Mare nr.15","MUNICIPIUL BRASOV",1,40198,1,1,988,635,586,49,625,10,1094,459,485,140,
8,"BRASOV",83,40198,,117,0,"Str. Jupiter","MUNICIPIUL BRASOV",1,40198,1,1,1210,710,622,88,702,8,1300,590,563,139,
8,"BRASOV",83,40198,,118,0,"B-dul. ¸tefan cel Mare nr.16A","MUNICIPIUL BRASOV",1,40198,1,1,659,416,350,66,405,11,803,387,284,121,
8,"BRASOV",83,40198,,119,0,"Str. Mercur nr.7","MUNICIPIUL BRASOV",1,40198,1,1,1766,930,900,30,915,15,1900,970,703,212,
8,"BRASOV",83,40198,,120,0,"Str. Lunii nr.6","MUNICIPIUL BRASOV",1,40198,1,1,1294,795,660,135,776,19,1401,606,532,244,
8,"BRASOV",83,40198,,121,0,"Str. Szemler Ferencz nr.3 (Str. Muncii)","MUNICIPIUL BRASOV",1,40198,1,1,1205,776,539,237,772,4,1400,624,409,363,
8,"BRASOV",83,40198,,122,0,"Str. Jupiter nr.4","MUNICIPIUL BRASOV",1,40198,1,1,716,453,426,27,443,10,800,337,352,91,
8,"BRASOV",83,40198,,123,0,"Calea Bucure­ti nr.68","MUNICIPIUL BRASOV",1,40198,1,1,1503,879,798,81,864,15,1592,713,673,191,
8,"BRASOV",83,40198,,124,0,"B-dul. ¸tefan cel Mare nr.15","MUNICIPIUL BRASOV",1,40198,1,1,1785,1204,975,229,1183,19,2000,796,912,271,
8,"BRASOV",83,40198,,125,0,"B-dul. ¸tefan cel Mare nr.15","MUNICIPIUL BRASOV",1,40198,1,1,1806,914,871,43,899,15,1900,986,699,200,
8,"BRASOV",83,40198,,126,0,"B-dul. ¸tefan cel Mare nr.15","MUNICIPIUL BRASOV",1,40198,1,1,829,474,441,33,463,11,900,426,346,117,
8,"BRASOV",83,40198,,127,0,"Str. Barbu LÇutaru nr.10","MUNICIPIUL BRASOV",1,40198,1,1,1525,762,711,51,738,24,1600,838,528,210,
8,"BRASOV",83,40198,,128,0,"Str. Traian nr.4","MUNICIPIUL BRASOV",1,40198,1,1,2243,1129,1091,38,1103,2,2400,1271,784,319,
8,"BRASOV",83,40198,,129,1,"Str. Traian nr.4","MUNICIPIUL BRASOV",1,40198,1,1,0,54,0,54,53,1,200,146,37,16,
8,"BRASOV",83,40198,,130,0,"Str. Traian nr.4","MUNICIPIUL BRASOV",1,40198,1,1,2026,1119,1062,57,1105,14,1691,572,835,270,
8,"BRASOV",83,40198,,131,0,"Calea Bucure­ti nr.75","MUNICIPIUL BRASOV",1,40198,1,1,2017,1025,994,31,1014,11,2100,1075,716,298,
8,"BRASOV",83,40198,,132,0,"Calea Bucure­ti nr.75","MUNICIPIUL BRASOV",1,40198,1,1,1113,707,642,65,691,16,1200,493,490,201,
8,"BRASOV",83,40198,,133,0,"Calea Bucure­ti nr.75","MUNICIPIUL BRASOV",1,40198,1,1,786,429,415,14,422,7,900,471,327,95,
8,"BRASOV",83,40198,,134,0,"Calea Bucure­ti nr.75","MUNICIPIUL BRASOV",1,40198,1,1,1963,1081,994,87,1048,33,2200,1119,741,307,
8,"BRASOV",83,40198,,135,0,"Str. Cocorului nr.28","MUNICIPIUL BRASOV",1,40198,1,1,2526,1431,1388,43,1409,22,2600,1169,1058,351,
8,"BRASOV",83,40198,,136,0,"Str. Cocorului nr.28","MUNICIPIUL BRASOV",1,40198,1,1,772,439,406,33,435,4,1600,1161,341,94,
8,"BRASOV",83,40198,,137,0,"Str. Cocorului nr.28","MUNICIPIUL BRASOV",1,40198,1,1,2034,1117,1063,54,1095,22,2098,981,774,321,
8,"BRASOV",83,40198,,138,0,"Str. Cocorului nr.28","MUNICIPIUL BRASOV",1,40198,1,1,1968,1073,1021,52,1032,21,2100,1027,686,346,
8,"BRASOV",83,40198,,139,0,"Str. Barbu LÇutaru nr.10","MUNICIPIUL BRASOV",1,40198,1,1,1392,783,741,42,767,16,1500,717,546,221,
8,"BRASOV",83,40198,,140,0,"Str. Barbu LÇutaru nr.10","MUNICIPIUL BRASOV",1,40198,1,1,2672,1438,1398,40,1393,43,2792,1354,969,424,
8,"BRASOV",83,40198,,141,0,"Str. Barbu LÇutaru nr.10","MUNICIPIUL BRASOV",1,40198,1,1,1065,516,493,23,506,10,1200,684,348,158,
8,"BRASOV",83,40198,,142,0,"Str. Barbu LÇutaru nr.8","MUNICIPIUL BRASOV",1,40198,1,1,1870,924,871,53,912,12,2000,1076,613,299,
8,"BRASOV",83,40198,,143,0,"Str. Barbu LÇutaru nr.10","MUNICIPIUL BRASOV",1,40198,1,1,1542,795,765,30,782,13,1600,805,563,219,
8,"BRASOV",83,40198,,144,0,"Str. Barbu LÇutaru nr.8","MUNICIPIUL BRASOV",1,40198,1,1,1852,988,954,34,964,24,1900,912,697,267,
8,"BRASOV",83,40198,,145,0,"Str. Barbu LÇutaru nr.8","MUNICIPIUL BRASOV",1,40198,1,1,904,546,480,66,537,9,1000,454,364,173,
8,"BRASOV",83,40198,,146,0,"Str. Carpaîilor nr.60","MUNICIPIUL BRASOV",1,40198,1,1,1181,607,577,30,599,8,1300,693,419,180,
8,"BRASOV",83,40198,,147,0,"Str. Carpaîilor nr.60","MUNICIPIUL BRASOV",1,40198,1,1,1495,992,760,232,966,26,1700,708,604,362,
8,"BRASOV",83,40198,,148,0,"Str. Carpaîilor nr.60","MUNICIPIUL BRASOV",1,40198,1,1,1508,775,733,42,770,5,1600,825,534,236,
8,"BRASOV",83,40198,,149,0,"Str. Carpaîilor nr.44","MUNICIPIUL BRASOV",1,40198,1,1,1363,831,742,89,825,6,1500,667,576,249,
8,"BRASOV",83,40198,,150,0,"Str. Poienelor nr.5","MUNICIPIUL BRASOV",1,40198,1,1,1550,822,751,71,795,27,1700,878,561,234,
8,"BRASOV",83,40198,,151,0,"B-dul. Valea CetÇîii nr.8","MUNICIPIUL BRASOV",1,40198,1,1,1941,1056,964,92,1041,15,2106,1050,746,295,
8,"BRASOV",83,40198,,152,0,"B-dul. Valea CetÇîii nr.8","MUNICIPIUL BRASOV",1,40198,1,1,1528,816,774,42,798,18,1604,778,503,295,
8,"BRASOV",83,40198,,153,0,"B-dul. Valea CetÇîii nr.8","MUNICIPIUL BRASOV",1,40198,1,1,1610,783,733,50,767,16,1700,917,512,255,
8,"BRASOV",83,40198,,154,0,"B-dul. Valea CetÇîii nr.8","MUNICIPIUL BRASOV",1,40198,1,1,2047,1043,1001,42,1029,14,2000,957,700,329,
8,"BRASOV",83,40198,,155,0,"Str. Jepilor nr.1","MUNICIPIUL BRASOV",1,40198,1,1,2539,1265,1159,106,1240,19,2700,1435,826,414,
8,"BRASOV",83,40198,,156,0,"Str. Jepilor nr.1","MUNICIPIUL BRASOV",1,40198,1,1,1780,941,886,55,869,17,1800,914,596,273,
8,"BRASOV",83,40198,,157,0,"Str. Jepilor nr.1","MUNICIPIUL BRASOV",1,40198,1,1,2523,1229,1175,54,1207,22,2607,1378,865,342,
8,"BRASOV",83,40198,,158,0,"Str. Jepilor nr.1","MUNICIPIUL BRASOV",1,40198,1,1,2384,1280,1208,72,1243,37,2500,1220,857,386,
8,"BRASOV",83,40198,,159,0,"Str. Brazilor nr.18","MUNICIPIUL BRASOV",1,40198,1,1,2269,1192,1117,75,1173,19,2400,1208,726,447,
8,"BRASOV",83,40198,,160,0,"Str. Brazilor nr.18","MUNICIPIUL BRASOV",1,40198,1,1,1689,896,845,51,876,20,1800,904,607,269,
8,"BRASOV",83,40198,,161,0,"Str. Prunului nr.1","MUNICIPIUL BRASOV",1,40198,1,1,2373,1357,1258,99,1339,18,2500,1143,889,450,
8,"BRASOV",83,40198,,162,0,"Str. Prunului nr.1","MUNICIPIUL BRASOV",1,40198,1,1,1689,952,886,66,934,15,1838,889,575,359,
8,"BRASOV",83,40198,,163,0,"Str. Prunului nr.1","MUNICIPIUL BRASOV",1,40198,1,1,1869,1050,971,79,1034,16,2000,950,658,376,
8,"BRASOV",83,40198,,164,0,"Str. Prunului nr.1","MUNICIPIUL BRASOV",1,40198,1,1,2243,1262,1194,68,1247,15,2300,1023,812,435,
8,"BRASOV",83,40198,,165,0,"Calea Bucure­ti nr.257","MUNICIPIUL BRASOV",1,40198,1,1,1155,634,572,62,619,15,1300,664,409,210,
8,"BRASOV",83,40198,,166,0,"Calea Bucure­ti nr.257","MUNICIPIUL BRASOV",1,40198,1,1,1636,882,834,48,864,18,1700,818,587,277,
8,"BRASOV",83,40198,,167,1,"Str. Mihai Viteazul nr.160","MUNICIPIUL BRASOV",1,40198,1,1,196,166,144,22,161,5,400,234,52,109,
8,"BRASOV",83,40198,,168,1,"¸os. Feldioarei nr.26","MUNICIPIUL BRASOV",1,40198,1,1,0,130,0,130,127,3,321,191,83,44,
8,"BRASOV",83,40198,,169,1,"Str. Gh.Bariîiu nr.36","MUNICIPIUL BRASOV",1,40198,1,1,0,331,0,331,321,10,500,169,227,94,
8,"BRASOV",83,40198,,170,1,"B-dul. 15 Noiembrie nr.60","MUNICIPIUL BRASOV",1,40198,1,1,0,120,0,120,118,2,300,180,77,41,
8,"BRASOV",83,40198,,171,1,"Str. Mihai Viteazul nr.9","MUNICIPIUL BRASOV",1,40198,1,1,0,58,0,58,54,4,200,142,43,11,
8,"BRASOV",83,40198,,172,1,"Calea Bucure­ti nr.25-27","MUNICIPIUL BRASOV",1,40198,1,1,0,605,0,605,594,11,800,195,413,181,
8,"BRASOV",83,40198,,173,1,"Str. Olteî nr.2","MUNICIPIUL BRASOV",1,40198,1,1,0,152,0,152,149,3,300,148,94,55,
8,"BRASOV",83,40198,,174,1,"Str. Pieîii nr.9","MUNICIPIUL BRASOV",1,40198,1,1,0,171,0,171,168,3,300,129,107,61,
8,"BRASOV",83,40198,,175,1,"Str. UniversitÇîii","MUNICIPIUL BRASOV",1,40198,1,1,0,607,0,607,595,12,2800,2193,369,226,
8,"BRASOV",83,40198,,176,1,"Str. Memorandumului","MUNICIPIUL BRASOV",1,40198,1,1,0,1005,0,1005,978,27,1700,695,578,400,
8,"BRASOV",83,40198,,177,0,"Poiana Bra­ov - Vila Aluni­","MUNICIPIUL BRASOV",1,40198,1,1,412,488,132,356,474,14,1000,512,285,189,
8,"BRASOV",83,40278,,178,0,"Str. Tudor Vladimirescu","MUNICIPIUL FAGARAS",3,40278,1,1,1906,694,634,60,687,7,2000,1306,324,363,
8,"BRASOV",83,40278,,179,0,"Str. Tudor Vladimirescu","MUNICIPIUL FAGARAS",3,40278,1,1,1771,654,604,50,641,13,1900,1246,303,338,
8,"BRASOV",83,40278,,180,0,"Str. Mihai Viteazu nr.1","MUNICIPIUL FAGARAS",3,40278,1,1,1474,581,539,42,565,16,1600,1019,371,194,
8,"BRASOV",83,40278,,181,0,"Str. Mihai Viteazu nr.1","MUNICIPIUL FAGARAS",3,40278,1,1,1531,563,510,53,557,6,1600,1037,329,228,
8,"BRASOV",83,40278,,182,0,"Str. Gheorghe Doja nr.48","MUNICIPIUL FAGARAS",3,40278,1,1,1064,539,460,79,524,15,1200,661,276,248,
8,"BRASOV",83,40278,,183,0,"Str. Republicii nr.3","MUNICIPIUL FAGARAS",3,40278,1,1,1125,481,415,66,464,17,1200,719,312,152,
8,"BRASOV",83,40278,,184,0,"Str. D-na Stanca","MUNICIPIUL FAGARAS",3,40278,1,1,1588,714,653,61,694,20,1700,986,443,251,
8,"BRASOV",83,40278,,185,0,"Str. Crinului nr.5","MUNICIPIUL FAGARAS",3,40278,1,1,917,514,380,134,501,13,1100,586,333,168,
8,"BRASOV",83,40278,,186,0,"Str. D-na Stanca nr.33","MUNICIPIUL FAGARAS",3,40278,1,1,1575,644,580,64,631,13,1700,1056,400,231,
8,"BRASOV",83,40278,,187,0,"Str. ¸colii","MUNICIPIUL FAGARAS",3,40278,1,1,1011,407,345,62,401,6,1107,700,244,157,
8,"BRASOV",83,40278,,188,0,"Str. ¸colii","MUNICIPIUL FAGARAS",3,40278,1,1,1095,463,425,38,459,4,1200,737,298,161,
8,"BRASOV",83,40278,,189,0,"Str. ¸colii","MUNICIPIUL FAGARAS",3,40278,1,1,1409,528,466,62,521,7,1500,972,262,259,
8,"BRASOV",83,40278,,190,0,"Str. ¸colii","MUNICIPIUL FAGARAS",3,40278,1,1,1652,594,561,33,578,16,1700,1106,353,225,
8,"BRASOV",83,40278,,191,0,"Str. 13 Decembrie","MUNICIPIUL FAGARAS",3,40278,1,1,1553,566,521,45,556,10,1600,1034,318,238,
8,"BRASOV",83,40278,,192,0,"Str. 13 Decembrie","MUNICIPIUL FAGARAS",3,40278,1,1,1096,425,390,35,415,10,1200,775,271,144,
8,"BRASOV",83,40278,,193,0,"Car. 1 Decembrie 1918","MUNICIPIUL FAGARAS",3,40278,1,1,1665,658,619,39,639,19,1800,1142,385,254,
8,"BRASOV",83,40278,,194,0,"Car. 1 Decembrie 1918","MUNICIPIUL FAGARAS",3,40278,1,1,1382,521,499,22,511,10,1400,879,279,232,
8,"BRASOV",83,40278,,195,0,"Str. Combinatului","MUNICIPIUL FAGARAS",3,40278,1,1,1121,650,426,224,628,22,1400,750,298,330,
8,"BRASOV",83,40278,,196,0,"Str. Combinatului","MUNICIPIUL FAGARAS",3,40278,1,1,1085,433,369,64,421,12,1200,767,216,205,
8,"BRASOV",83,40278,,197,0,"Statia C.F.R.","MUNICIPIUL FAGARAS",3,40278,1,1,1425,615,465,150,602,13,1600,985,339,263,
8,"BRASOV",83,40278,,198,0,"Str. Negoiu","MUNICIPIUL FAGARAS",3,40278,1,1,1625,676,562,114,659,17,1800,1124,411,248,
8,"BRASOV",83,40278,,199,0,"Str. Negoiu","MUNICIPIUL FAGARAS",3,40278,1,1,1173,509,385,124,502,7,1300,791,247,255,
8,"BRASOV",83,40278,,200,0,"Str. Negoiu","MUNICIPIUL FAGARAS",3,40278,1,1,1131,553,391,162,535,18,1300,747,345,190,
8,"BRASOV",83,40278,,201,0,"Str. Negoiu","MUNICIPIUL FAGARAS",3,40278,1,1,1643,617,566,51,602,15,1700,1083,363,239,
8,"BRASOV",83,40278,,202,0,"Str. Vasile Alecsandri","MUNICIPIUL FAGARAS",3,40278,1,1,1325,574,546,28,555,19,1400,826,358,197,
8,"BRASOV",83,40278,,203,1,"Str. TÇbÇcari nr.13","MUNICIPIUL FAGARAS",3,40278,1,1,0,183,0,183,166,17,300,117,77,89,
8,"BRASOV",83,40438,,204,0,"B-dul Bra­ovului nr.227 (langÇ grÇdiniîÇ)","ORAS SACELE",7,40438,2,1,1587,906,851,55,869,37,1700,794,762,107,
8,"BRASOV",83,40438,,205,0,"B-dul Bra­ovului nr.250","ORAS SACELE",7,40438,2,1,1450,829,748,81,806,23,1500,671,555,251,
8,"BRASOV",83,40438,,206,0,"Str. ¸colii nr.2","ORAS SACELE",7,40438,2,1,1242,754,672,82,743,11,1400,646,535,208,
8,"BRASOV",83,40438,,207,0,"B-dul. Bra­ovului nr.107","ORAS SACELE",7,40438,2,1,1248,653,617,36,628,25,1300,647,535,93,
8,"BRASOV",83,40438,,208,0,"Str. Mihai Eminescu nr.6","ORAS SACELE",7,40438,2,1,1301,755,692,63,720,35,1400,645,612,108,
8,"BRASOV",83,40438,,209,0,"Piaîa LibertÇîii nr.24","ORAS SACELE",7,40438,2,1,1662,1023,964,59,995,28,1800,777,678,317,
8,"BRASOV",83,40438,,210,0,"B-dul. G.Moroianu nr.17","ORAS SACELE",7,40438,2,1,1544,947,899,48,883,16,1600,653,656,227,
8,"BRASOV",83,40438,,211,0,"B-dul. G.Moroianu nr.17","ORAS SACELE",7,40438,2,1,1241,721,681,40,712,9,1300,579,477,235,
8,"BRASOV",83,40438,,212,0,"Str. Poienii nr.1","ORAS SACELE",7,40438,2,1,1573,938,873,65,911,27,1700,762,713,198,
8,"BRASOV",83,40438,,213,0,"B-dul. G.Moroianu nr.291","ORAS SACELE",7,40438,2,1,1477,1087,938,149,1063,24,1599,512,742,321,
8,"BRASOV",83,40438,,214,0,"Str. Parcului nr.16","ORAS SACELE",7,40438,2,1,1162,771,688,83,751,20,1300,529,513,238,
8,"BRASOV",83,40438,,215,0,"Str. Parcului nr.22","ORAS SACELE",7,40438,2,1,918,591,528,63,575,16,983,392,380,195,
8,"BRASOV",83,40438,,216,0,"Str. Viitorului nr.1","ORAS SACELE",7,40438,2,1,1534,936,885,51,918,18,1600,664,597,321,
8,"BRASOV",83,40438,,217,0,"Str. Viitorului bl.22","ORAS SACELE",7,40438,2,1,1494,985,908,77,976,9,1600,615,729,247,
8,"BRASOV",83,40438,,218,0,"Str. Viitorului bl.22","ORAS SACELE",7,40438,2,1,1140,770,735,35,751,19,1200,430,469,282,
8,"BRASOV",83,40438,,219,0,"B-dul. G.Moroianu nr.399","ORAS SACELE",7,40438,2,1,1375,868,803,65,826,42,1500,632,645,181,
8,"BRASOV",83,40438,,220,0,"Str. Barajului nr.49","ORAS SACELE",7,40438,2,1,1523,1343,1217,126,1299,44,1700,357,1107,192,
8,"BRASOV",83,40241,,221,0,"Str. Chimi­tilor nr.3","MUNICIPIUL CODLEA",2,40241,1,1,2068,1169,1004,165,1148,21,2300,1131,662,486,
8,"BRASOV",83,40241,,222,0,"Str. Chimi­tilor nr.1","MUNICIPIUL CODLEA",2,40241,1,1,1418,829,766,63,809,20,1500,671,534,275,
8,"BRASOV",83,40241,,223,0,"Str. GÇrii nr.11","MUNICIPIUL CODLEA",2,40241,1,1,1513,1159,835,324,1136,23,1800,641,745,391,
8,"BRASOV",83,40241,,224,0,"Str. LateralÇ nr.4","MUNICIPIUL CODLEA",2,40241,1,1,1136,610,566,44,602,8,1200,590,380,222,
8,"BRASOV",83,40241,,225,0,"Str. MÇgurii nr.3","MUNICIPIUL CODLEA",2,40241,1,1,1304,802,744,58,785,17,1400,598,479,306,
8,"BRASOV",83,40241,,226,0,"Str. MÇgurii nr.6","MUNICIPIUL CODLEA",2,40241,1,1,1511,867,782,85,855,12,1600,733,507,348,
8,"BRASOV",83,40241,,227,0,"Str. LungÇ nr.147","MUNICIPIUL CODLEA",2,40241,1,1,1500,769,714,55,751,18,1600,831,426,325,
8,"BRASOV",83,40241,,228,0,"Str. 15 Noiembrie nr.28","MUNICIPIUL CODLEA",2,40241,1,1,1430,818,782,36,808,10,1507,689,507,301,
8,"BRASOV",83,40241,,229,0,"Str. Freziei nr.41","MUNICIPIUL CODLEA",2,40241,1,1,1718,966,923,43,949,17,1800,834,555,394,
8,"BRASOV",83,40241,,230,0,"Str. Freziei nr.41","MUNICIPIUL CODLEA",2,40241,1,1,1931,1038,1011,27,1018,18,2001,963,610,408,
8,"BRASOV",83,40241,,231,0,"Str. Clo­ca nr.26","MUNICIPIUL CODLEA",2,40241,1,1,1581,862,811,51,852,10,1700,838,448,404,
8,"BRASOV",83,40241,,232,0,"Str. Carpaîilor nr.3","MUNICIPIUL CODLEA",2,40241,1,1,1485,920,833,87,890,25,1600,680,599,291,
8,"BRASOV",83,40303,,233,0,"Str. M.SÇulescu nr.117","ORAS PREDEAL",4,40303,2,1,1779,1532,915,617,1505,27,1900,368,1069,436,
8,"BRASOV",83,40303,,234,0,"Str. M.SÇulescu nr.91","ORAS PREDEAL",4,40303,2,1,2177,1217,998,219,1202,15,2300,1083,840,362,
8,"BRASOV",83,40303,,235,1,"SEDIUL UNITÆÝII MILITARE 01053","ORAS PREDEAL",4,40303,2,1,0,200,0,200,185,15,400,200,97,88,
8,"BRASOV",83,40303,,236,0,"Str. Piatra Mare nr.1","ORAS PREDEAL",4,40303,2,1,561,314,245,69,306,8,700,386,192,114,
8,"BRASOV",83,40303,,237,0,"¸os. NaîionalÇ nr.25","ORAS PREDEAL",4,40303,2,1,225,208,88,120,207,1,500,292,127,80,
8,"BRASOV",83,40367,,238,0,"Str. I.L.Caragiale","ORAS RASNOV",5,40367,2,1,2000,1062,990,72,1053,9,2000,938,577,476,
8,"BRASOV",83,40367,,239,0,"Str. Predeal","ORAS RASNOV",5,40367,2,1,438,235,210,25,233,2,700,465,160,73,
8,"BRASOV",83,40367,,240,0,"Piaîa ¸colii","ORAS RASNOV",5,40367,2,1,1205,661,624,37,651,10,1300,639,413,238,
8,"BRASOV",83,40367,,241,0,"Piaîa ¸colii","ORAS RASNOV",5,40367,2,1,1349,772,742,30,763,9,1400,628,419,344,
8,"BRASOV",83,40367,,242,0,"Str. Cimpului nr.2","ORAS RASNOV",5,40367,2,1,684,462,361,101,459,3,800,338,211,248,
8,"BRASOV",83,40367,,243,0,"CLUBUL FABRICII DE SCULE RI¸NOV","ORAS RASNOV",5,40367,2,1,1488,954,867,87,945,9,1700,746,571,374,
8,"BRASOV",83,40367,,244,0,"Str. Izvorului","ORAS RASNOV",5,40367,2,1,2383,1131,1084,47,1112,19,2500,1369,579,533,
8,"BRASOV",83,40367,,245,0,"Str. Izvorului","ORAS RASNOV",5,40367,2,1,2111,1244,1123,121,1231,13,2400,1156,695,536,
8,"BRASOV",83,40367,,246,0,"Str. Republicii nr.29","ORAS RASNOV",5,40367,2,1,789,520,439,81,514,6,900,380,334,180,
8,"BRASOV",83,40367,,247,1,"U.M.01751","ORAS RASNOV",5,40367,2,1,0,238,0,238,219,19,400,162,118,101,
8,"BRASOV",83,40394,,248,0,"Str. Republicii nr.181","ORAS RUPEA",6,40394,2,1,1242,657,593,64,647,10,1400,743,385,262,
8,"BRASOV",83,40394,,249,0,"Str. Republicii nr.124","ORAS RUPEA",6,40394,2,1,1232,621,562,59,607,14,1300,679,380,227,
8,"BRASOV",83,40394,,250,0,"Str. Republicii nr.112-114","ORAS RUPEA",6,40394,2,1,1410,761,689,72,739,22,1500,739,499,240,
8,"BRASOV",83,40394,,251,0,"CLUB MUNCITORESC BRAFOR GARÆ RUPEA","ORAS RUPEA",6,40394,2,1,633,358,335,23,355,3,800,442,251,104,
8,"BRASOV",83,40394,,252,0,"Str. Fi­er nr.227","ORAS RUPEA",6,40394,2,1,291,222,155,67,220,2,400,178,121,99,
8,"BRASOV",83,40465,,253,0,"Str. Stadionului nr.14","ORAS VICTORIA",8,40465,2,1,1517,641,568,73,626,15,1600,959,373,253,
8,"BRASOV",83,40465,,254,0,"Str. Stadionului nr.18","ORAS VICTORIA",8,40465,2,1,1249,519,474,45,510,9,1300,781,320,190,
8,"BRASOV",83,40465,,255,0,"Str. 1 Decembrie 1918 nr.8","ORAS VICTORIA",8,40465,2,1,1426,578,535,43,571,7,1500,922,280,291,
8,"BRASOV",83,40465,,256,0,"Str. Victoriei nr.1","ORAS VICTORIA",8,40465,2,1,1181,586,540,46,579,7,1300,714,393,186,
8,"BRASOV",83,40465,,257,0,"Str. Salcmilor nr.2","ORAS VICTORIA",8,40465,2,1,950,510,415,95,502,8,1100,590,336,166,
8,"BRASOV",83,40465,,258,0,"Str. Parcului nr.8","ORAS VICTORIA",8,40465,2,1,1573,589,529,60,577,12,1700,1111,296,281,
8,"BRASOV",83,40492,,259,0,"GrÇdiniîa nr.6 Cartier Grui","ORAS ZARNESTI",9,40492,2,1,1553,898,813,85,878,20,1700,802,515,363,
8,"BRASOV",83,40492,,260,0,"Str. Dr. Ioan Senchea","ORAS ZARNESTI",9,40492,2,1,1456,762,730,32,753,9,1600,838,415,338,
8,"BRASOV",83,40492,,261,0,"Str. Dr. Tiberiu SpOrchez nr.2","ORAS ZARNESTI",9,40492,2,1,1553,968,889,79,953,15,1700,732,585,368,
8,"BRASOV",83,40492,,262,0,"Str. Mitropolit Ion Metianu nr. 11","ORAS ZARNESTI",9,40492,2,1,2200,1142,1054,88,1122,20,2200,1058,751,371,
8,"BRASOV",83,40492,,263,0,"Str. Mitropolit Ion Metianu","ORAS ZARNESTI",9,40492,2,1,1621,984,887,97,960,24,1700,716,602,358,
8,"BRASOV",83,40492,,264,0,"Str. Mitropolit Ion Metianu nr.77","ORAS ZARNESTI",9,40492,2,1,1072,967,860,107,960,7,1300,333,559,401,
8,"BRASOV",83,40492,,265,0,"Str. Carpaîi nr.1","ORAS ZARNESTI",9,40492,2,1,1509,892,798,94,874,18,1600,708,620,254,
8,"BRASOV",83,40492,,266,0,"Str. Carpaîi nr.1","ORAS ZARNESTI",9,40492,2,1,1459,869,816,53,858,11,1600,731,632,226,
8,"BRASOV",83,40492,,267,0,"Str. Carpaîi nr.1","ORAS ZARNESTI",9,40492,2,1,1640,927,870,57,911,16,1800,873,637,274,
8,"BRASOV",83,40492,,268,0,"Str. Carpaîi nr.1","ORAS ZARNESTI",9,40492,2,1,1472,851,745,106,825,26,1600,749,558,267,
8,"BRASOV",83,40492,,269,0,"CLUBUL UZINEI MECANICE TOHAN S.A.","ORAS ZARNESTI",9,40492,2,1,953,616,454,162,606,10,1100,484,366,240,
8,"BRASOV",83,40492,,270,0,"Str. ¸colii nr.80","ORAS ZARNESTI",9,40492,2,1,1708,922,843,79,895,27,1800,878,596,299,
8,"BRASOV",83,40492,,271,0,"Str. ¸colii","ORAS ZARNESTI",9,40492,2,1,849,503,435,68,496,7,1000,497,290,206,
8,"BRASOV",83,40492,,272,0,"Str. Unirii nr.3","ORAS ZARNESTI",9,40492,2,1,945,707,553,154,695,12,1200,493,399,296,
8,"BRASOV",83,40526,,273,0,"CÆMINUL CULTURAL APAÝA","APATA",10,40526,0,3,989,558,454,104,531,27,1200,642,419,112,
8,"BRASOV",83,40526,,274,0,"CÆMINUL CULTURAL APAÝA","APATA",10,40526,0,3,940,547,476,71,528,19,1100,553,357,171,
8,"BRASOV",83,40544,,275,0,"CONSILIUL LOCAL BECLEAN","BECLEAN",11,40544,0,3,546,357,284,73,350,7,700,343,194,156,
8,"BRASOV",83,40544,,276,0,"ClÇdirea fostei primÇrii BOHOLÝ","BECLEAN",11,40544,0,3,164,129,92,37,126,3,300,171,63,63,
8,"BRASOV",83,40544,,277,0,"¸coala generalÇ CALBOR","BECLEAN",11,40544,0,3,179,136,86,50,132,4,300,164,68,64,
8,"BRASOV",83,40544,,278,0,"¸coala generalÇ HUREZ","BECLEAN",11,40544,0,3,360,247,201,46,247,0,450,203,92,155,
8,"BRASOV",83,40606,,279,0,"Str. ¸colii nr.139","BOD",12,40606,0,3,1575,954,833,121,935,19,1700,746,563,372,
8,"BRASOV",83,40606,,280,0,"CAZINOUL S.C.""FABBRICA DE ZAHÆR"" S.A. BOD","BOD",12,40606,0,3,1573,925,806,119,899,26,1700,775,565,334,
8,"BRASOV",83,40633,,281,0,"CONSILIUL LOCAL BRAN","BRAN",13,40633,0,3,2136,1312,906,406,1285,27,2300,988,804,481,
8,"BRASOV",83,40633,,282,0,"CÆMINUL CULTURAL SOHODOL","BRAN",13,40633,0,3,1333,566,481,85,559,7,1500,934,318,241,
8,"BRASOV",83,40633,,283,0,"CÆMINUL CULTURAL ¸IMON","BRAN",13,40633,0,3,912,458,356,102,452,6,1000,542,195,257,
8,"BRASOV",83,40688,,284,0,"CÆMINUL CULTURAL BUDILA","BUDILA",14,40688,0,3,1240,694,630,64,669,25,1400,706,492,177,
8,"BRASOV",83,40688,,285,0,"¸coala generalÇ BUDILA","BUDILA",14,40688,0,3,968,577,506,71,561,16,1100,523,424,137,
8,"BRASOV",83,40704,,286,0,"nr.119","BUNESTI",15,40704,0,3,483,352,278,74,342,10,600,248,205,137,
8,"BRASOV",83,40704,,287,0,"nr.121","BUNESTI",15,40704,0,3,379,270,199,71,263,7,500,230,192,71,
8,"BRASOV",83,40704,,288,0,"nr.51","BUNESTI",15,40704,0,3,226,130,90,40,127,3,343,213,91,36,
8,"BRASOV",83,40704,,289,0,"nr.163","BUNESTI",15,40704,0,3,128,106,61,45,102,4,250,144,65,37,
8,"BRASOV",83,40704,,290,0,"nr.60","BUNESTI",15,40704,0,3,305,200,136,64,197,3,400,200,137,60,
8,"BRASOV",83,40768,,291,0,"CÆMINUL CULTURAL CAÝA","CATA",16,40768,0,3,799,536,459,77,514,22,897,361,292,222,
8,"BRASOV",83,40768,,292,0,"nr.244","CATA",16,40768,0,3,235,213,150,63,210,3,350,137,133,77,
8,"BRASOV",83,40768,,293,0,"GrÇdiniîa de copii DRÆU¸ENI","CATA",16,40768,0,3,393,270,226,44,266,4,450,180,202,64,
8,"BRASOV",83,40768,,294,0,"CÆMINUL CULTURAL IONE¸TI","CATA",16,40768,0,3,118,126,88,38,125,1,200,74,118,7,
8,"BRASOV",83,40768,,295,0,"¸coala generalÇ PALO¸","CATA",16,40768,0,3,231,206,143,63,202,4,300,94,132,70,
8,"BRASOV",83,40820,,296,0,"Str. Pieîii nr.254","CINCU",17,40820,0,3,1101,675,531,144,659,16,1200,525,404,255,
8,"BRASOV",83,40820,,297,0,"¸coala generalÇ TOARCLA","CINCU",17,40820,0,3,243,167,127,40,165,2,300,133,50,115,
8,"BRASOV",83,40857,,298,0,"nr.178","COMANA",18,40857,0,3,743,424,328,96,413,11,850,426,255,158,
8,"BRASOV",83,40857,,299,0,"nr.125","COMANA",18,40857,0,3,237,233,157,76,232,1,350,117,95,137,
8,"BRASOV",83,40857,,300,0,"nr.27","COMANA",18,40857,0,3,517,356,312,44,344,12,600,244,233,111,
8,"BRASOV",83,40857,,301,0,"nr.93","COMANA",18,40857,0,3,398,318,255,63,317,1,450,132,177,140,
8,"BRASOV",83,40900,,302,0,"Piaîa LibertÇîii nr.8","CRISTIAN",19,40900,0,3,1549,925,710,215,910,15,1790,865,557,353,
8,"BRASOV",83,40900,,303,0,"Str. LungÇ nr.36","CRISTIAN",19,40900,0,3,1300,777,658,119,754,23,1500,723,482,272,
8,"BRASOV",83,40928,,304,0,"CONSILIUL LOCAL DUMBRÆVIÝA","DUMBRAVITA",20,40928,0,3,1336,838,696,142,826,12,1500,662,423,403,
8,"BRASOV",83,40928,,305,0,"GrÇdiniîa de copii DUMBRÆVIÝA","DUMBRAVITA",20,40928,0,3,1438,867,788,79,848,19,1500,633,353,495,
8,"BRASOV",83,40928,,306,0,"¸coala generalÇ VLÆDENI","DUMBRAVITA",20,40928,0,3,576,487,256,231,477,10,750,263,248,229,
8,"BRASOV",83,40955,,307,0,"CÆMINUL CULTURAL FELDIOARA - Sala nouÇ","FELDIOARA",21,40955,0,3,1995,1098,852,246,1084,14,2200,1102,592,492,
8,"BRASOV",83,40955,,308,0,"CONSILIUL LOCAL FELDIOARA","FELDIOARA",21,40955,0,3,1480,818,635,183,806,12,1800,982,481,325,
8,"BRASOV",83,40955,,309,0,"CÆMINUL CULTURAL ROTBAV","FELDIOARA",21,40955,0,3,1195,671,502,169,652,19,1300,629,367,285,
8,"BRASOV",83,40991,,310,0,"CONSILIUL LOCAL FUNDATA","FUNDATA",22,40991,0,3,609,358,302,56,356,2,700,342,219,137,
8,"BRASOV",83,40991,,311,0,"¸coala generalÇ ¸IRNEA","FUNDATA",22,40991,0,3,306,199,145,54,199,0,400,201,78,121,
8,"BRASOV",83,40214,,312,0,"CONSILIUL LOCAL GHIMBAV","GHIMBAV",23,40214,0,3,1527,826,743,83,816,10,1700,874,474,342,
8,"BRASOV",83,40214,,313,0,"Str. Pieîii","GHIMBAV",23,40214,0,3,1282,735,621,114,723,12,1400,665,413,310,
8,"BRASOV",83,40214,,314,0,"Str. ¸colii","GHIMBAV",23,40214,0,3,1167,706,564,142,699,7,1400,694,386,313,
8,"BRASOV",83,41033,,315,0,"Str. InvÇîÇtorilor nr.2","HALCHIU",24,41033,0,3,1023,636,524,112,623,13,1100,464,335,288,
8,"BRASOV",83,41033,,316,0,"Str. InvÇîÇtorilor nr.2","HALCHIU",24,41033,0,3,1179,676,573,103,669,7,1300,624,323,346,
8,"BRASOV",83,41033,,317,0,"Str. PrincipalÇ nr.149","HALCHIU",24,41033,0,3,1277,852,696,156,810,42,1400,548,600,210,
8,"BRASOV",83,41033,,318,0,"SATU NOU","HALCHIU",24,41033,0,3,803,503,383,120,487,16,1100,597,401,86,
8,"BRASOV",83,41088,,319,0,"CONSILIUL LOCAL HÆRMAN","HARMAN",25,41088,0,3,1413,759,604,155,749,10,1600,841,486,263,
8,"BRASOV",83,41088,,320,0,"¸coala generalÇ HÆRMAN","HARMAN",25,41088,0,3,1380,772,621,151,760,12,1600,828,469,291,
8,"BRASOV",83,41088,,321,0,"S.C.""AGROINDUSTRIALA"" PREJMER - SEDIUL FERMEI","HARMAN",25,41088,0,3,362,263,195,68,258,5,500,237,125,133,
8,"BRASOV",83,41113,,322,0,"Str. PrincipalÇ nr.154","HARSENI",26,41113,0,3,954,446,368,78,444,2,1100,654,162,282,
8,"BRASOV",83,41113,,323,0,"Str. PrincipalÇ nr.47","HARSENI",26,41113,0,3,810,443,336,107,439,3,900,458,125,314,
8,"BRASOV",83,41177,,324,0,"CÆMINUL CULTURAL HOGHIZ","HOGHIZ",27,41177,0,3,1591,853,731,122,839,14,1800,947,571,268,
8,"BRASOV",83,41177,,325,0,"CÆMINUL CULTURAL BOGATA","HOGHIZ",27,41177,0,3,278,199,160,39,198,1,350,151,154,44,
8,"BRASOV",83,41177,,326,0,"CÆMINUL CULTURAL CUCIULATA","HOGHIZ",27,41177,0,3,1100,628,536,92,621,7,1100,472,288,333,
8,"BRASOV",83,41177,,327,0,"CÆMINUL CULTURAL DOPCA","HOGHIZ",27,41177,0,3,398,313,267,46,303,10,500,187,277,26,
8,"BRASOV",83,41177,,328,0,"CÆMINUL CULTURAL F×NT×NA","HOGHIZ",27,41177,0,3,259,220,172,48,218,2,350,130,76,142,
8,"BRASOV",83,41248,,329,0,"CÆMINUL CULTURAL HOMOROD","HOMOROD",28,41248,0,3,1042,530,472,58,512,18,1100,570,276,236,
8,"BRASOV",83,41248,,330,0,"CÆMINUL CULTURAL JIMBOR","HOMOROD",28,41248,0,3,372,207,184,23,195,12,500,293,176,19,
8,"BRASOV",83,41248,,331,0,"¸coala generalÇ MERCHEA¸A","HOMOROD",28,41248,0,3,386,241,209,32,241,0,498,257,92,149,
8,"BRASOV",83,41284,,332,0,"¸coala generalÇ JIBERT","JIBERT",29,41284,0,3,571,271,231,40,264,7,600,329,151,113,
8,"BRASOV",83,41284,,333,0,"¸coala generalÇ DACIA","JIBERT",29,41284,0,3,243,305,243,62,301,4,600,295,153,148,
8,"BRASOV",83,41284,,334,0,"SEDIUL FOSTUL C.A.P. GRINARI","JIBERT",29,41284,0,3,379,214,197,17,203,11,500,286,155,48,
8,"BRASOV",83,41284,,335,0,"¸coala generalÇ LOVNIC","JIBERT",29,41284,0,3,524,277,228,49,269,8,600,323,141,128,
8,"BRASOV",83,41346,,336,0,"CÆMINUL CULTURAL LISA","LISA",30,41346,0,3,777,400,335,65,392,8,900,500,146,246,
8,"BRASOV",83,41346,,337,0,"CÆMINUL CULTURAL BREAZA","LISA",30,41346,0,3,591,263,184,79,259,4,700,437,68,191,
8,"BRASOV",83,41382,,338,0,"Str. Nicolae BÇlcescu nr.2","MAIERUS",31,41382,0,3,1080,549,443,106,543,6,1200,651,325,218,
8,"BRASOV",83,41382,,339,0,"Str. PrincipalÇ","MAIERUS",31,41382,0,3,466,320,236,84,311,9,600,280,223,88,
8,"BRASOV",83,41417,,340,0,"CÆMINUL CULTURAL M×NDRA","MANDRA",32,41417,0,3,779,462,324,138,456,6,950,488,200,256,
8,"BRASOV",83,41417,,341,0,"¸coala generalÇ ILENI","MANDRA",32,41417,0,3,525,302,227,75,296,6,600,298,129,167,
8,"BRASOV",83,41417,,342,0,"¸coala generalÇ RIU¸OR","MANDRA",32,41417,0,3,299,178,132,46,175,3,400,222,79,96,
8,"BRASOV",83,41417,,343,0,"CÆMINUL CULTURAL ¸ONA","MANDRA",32,41417,0,3,188,155,98,57,153,2,290,135,78,75,
8,"BRASOV",83,41417,,344,0,"¸coala generalÇ TODERIÝA","MANDRA",32,41417,0,3,242,176,132,44,171,5,300,124,60,111,
8,"BRASOV",83,41471,,345,0,"nr. 330 A","MOIECIU",33,41471,0,3,2529,1254,1022,232,1244,10,2700,1446,713,531,
8,"BRASOV",83,41471,,346,0,"nr. 121 A","MOIECIU",33,41471,0,3,342,369,166,203,364,5,700,331,188,176,
8,"BRASOV",83,41471,,347,0,"nr. 1 A","MOIECIU",33,41471,0,3,592,298,250,48,297,1,700,402,166,131,
8,"BRASOV",83,41471,,348,0,"CÆMINUL CULTURAL PE¸TERA","MOIECIU",33,41471,0,3,434,284,196,88,282,2,500,216,151,131,
8,"BRASOV",83,41541,,349,0,"Str. PrincipalÇ nr.291","ORMENIS",34,41541,0,3,1406,898,782,116,871,27,1600,702,757,114,
8,"BRASOV",83,41541,,350,0,"Str. GÇrii nr.116","ORMENIS",34,41541,0,3,786,474,357,117,468,6,1000,526,258,210,
8,"BRASOV",83,41578,,351,0,"CÆMINUL CULTURAL PÆRÆU","PARAU",35,41578,0,3,425,324,252,72,319,5,550,226,212,107,
8,"BRASOV",83,41578,,352,0,"¸coala generalÇ GRID","PARAU",35,41578,0,3,243,190,132,58,187,3,350,160,77,110,
8,"BRASOV",83,41578,,353,0,"GRÆDINIÝA DE COPII VENEÝIA DE JOS","PARAU",35,41578,0,3,486,313,220,93,302,11,500,187,166,136,
8,"BRASOV",83,41578,,354,0,"CLÆDIREA FOSTEI PRIMÆRII VENEÝIA DE SUS","PARAU",35,41578,0,3,311,189,131,58,185,4,400,211,86,99,
8,"BRASOV",83,41621,,355,0,"CÆMINUL CULTURAL POIANA MÆRULUI","POIANA MARULUI",36,41621,0,3,1431,653,541,112,643,10,1500,847,245,398,
8,"BRASOV",83,41621,,356,0,"¸coala generalÇ POIANA MÆRULUI - Corp II","POIANA MARULUI",36,41621,0,3,778,592,289,303,588,4,1000,408,141,447,
8,"BRASOV",83,41621,,357,0,"¸coala generalÇ ×NTRE VÆI","POIANA MARULUI",36,41621,0,3,236,225,86,139,219,6,350,125,80,139,
8,"BRASOV",83,41621,,358,0,"¸coala generalÇ PALTIN","POIANA MARULUI",36,41621,0,3,269,214,49,165,210,4,500,286,52,158,
8,"BRASOV",83,41621,,359,0,"CÆMINUL CULTURAL ¸INCA NOUÆ","POIANA MARULUI",36,41621,0,3,1145,618,533,85,614,4,1300,682,208,406,
8,"BRASOV",83,41667,,360,0,"BIBLIOTECA COMUNALÆ PREJMER","PREJMER",37,41667,0,3,2434,988,732,256,969,19,2700,1712,608,361,
8,"BRASOV",83,41667,,361,0,"CÆMINUL CULTURAL LUNCA CALNICULUI","PREJMER",37,41667,0,3,1093,579,445,134,572,7,1300,721,275,297,
8,"BRASOV",83,41667,,362,0,"¸coala generalÇ LUNCA CALNICULUI","PREJMER",37,41667,0,3,836,694,427,267,690,4,1200,506,375,315,
8,"BRASOV",83,41667,,363,0,"GrÇdiniîa de copii nr.10 - STUPINII PREJMERULUI","PREJMER",37,41667,0,3,1836,890,631,259,880,10,2000,1110,521,359,
8,"BRASOV",83,41701,,364,0,"CONSILIUL LOCAL RACO¸","RACOS",38,41701,0,3,1889,1134,1067,67,1106,28,2104,970,980,126,
8,"BRASOV",83,41701,,365,0,"¸coala generalÇ MATEIA¸","RACOS",38,41701,0,3,318,233,187,46,227,6,400,167,135,92,
8,"BRASOV",83,41738,,366,0,"CÆMINUL CULTURAL RECEA","RECEA",39,41738,0,3,1315,835,644,191,821,14,1600,765,401,420,
8,"BRASOV",83,41738,,367,0,"CÆMINUL CULTURAL BERIVOI","RECEA",39,41738,0,3,467,354,261,93,349,5,600,246,138,211,
8,"BRASOV",83,41738,,368,0,"¸coala generalÇ SÆVÆSTRENI","RECEA",39,41738,0,3,556,386,317,69,382,4,700,314,220,162,
8,"BRASOV",83,41925,,369,0,"Str. Republicii nr.646","SANPETRU",40,41925,0,3,1291,758,593,165,747,11,1400,642,456,291,
8,"BRASOV",83,41925,,370,0,"Str. Biserici Romne nr.481","SANPETRU",40,41925,0,3,1239,724,558,166,711,13,1400,676,444,267,
8,"BRASOV",83,41818,,371,0,"CONSILIUL LOCAL ¸ERCAIA","SERCAIA",41,41818,0,3,1178,570,490,80,555,15,1300,730,328,227,
8,"BRASOV",83,41818,,372,0,"¸coala generalÇ VAD","SERCAIA",41,41818,0,3,432,242,189,53,238,4,550,308,114,124,
8,"BRASOV",83,41818,,373,0,"CÆMINUL CULTURAL HÆLMEAG","SERCAIA",41,41818,0,3,375,264,194,70,254,10,450,186,185,69,
8,"BRASOV",83,41854,,374,0,"¸coala generalÇ ¸INCA VECHE","SINCA",42,41854,0,3,1116,598,478,120,586,12,1200,602,295,291,
8,"BRASOV",83,41854,,375,0,"¸coala generalÇ PER¸ANI","SINCA",42,41854,0,3,704,450,342,108,447,3,800,350,180,267,
8,"BRASOV",83,41854,,376,0,"¸coala generalÇ ¸ERCÆIÝA","SINCA",42,41854,0,3,702,470,345,125,455,15,800,330,187,268,
8,"BRASOV",83,41943,,377,0,"CONSILIUL LOCAL ¸OAR¸","SOARS",43,41943,0,3,420,199,170,29,198,1,500,301,78,120,
8,"BRASOV",83,41943,,378,0,"SEDIUL FOSTULUI C.A.P. BÆRCUÝ","SOARS",43,41943,0,3,301,205,164,41,201,4,350,145,75,126,
8,"BRASOV",83,41943,,379,0,"¸coala generalÇ FELMER","SOARS",43,41943,0,3,353,200,167,33,198,2,400,200,91,107,
8,"BRASOV",83,41943,,380,0,"¸coala generalÇ RODBAV","SOARS",43,41943,0,3,205,139,110,29,132,7,250,111,61,71,
8,"BRASOV",83,41943,,381,0,"CLÆDIREA ¸COLII GENERALE SELI¸TAT","SOARS",43,41943,0,3,150,116,87,29,112,4,200,84,84,28,
8,"BRASOV",83,42003,,382,0,"Str. PrincipalÇ nr.754","TARLUNGENI",44,42003,0,3,2335,1275,1090,185,1242,33,2500,1200,1018,224,
8,"BRASOV",83,42003,,383,0,"Str. PrincipalÇ nr.943","TARLUNGENI",44,42003,0,3,243,196,129,67,191,5,350,154,114,77,
8,"BRASOV",83,42003,,384,0,"Str. PrincipalÇ nr.465","TARLUNGENI",44,42003,0,3,1143,653,552,101,635,18,1300,647,407,228,
8,"BRASOV",83,42003,,385,0,"Str. ¸colii nr.155","TARLUNGENI",44,42003,0,3,1302,818,702,116,781,37,1500,682,613,168,
8,"BRASOV",83,42058,,386,0,"CÆMINUL CULTURAL TELIU","TELIU",45,42058,0,3,1913,897,784,113,852,45,2100,1203,676,176,
8,"BRASOV",83,42058,,387,0,"¸coala generalÇ TELIU - VALE","TELIU",45,42058,0,3,681,391,310,81,385,6,800,409,226,159,
8,"BRASOV",83,42076,,388,0,"CÆMINUL CULTURAL TICU¸","TICUSU",46,42076,0,3,372,192,138,54,190,2,499,307,114,76,
8,"BRASOV",83,42076,,389,0,"¸coala generalÇ COBOR","TICUSU",46,42076,0,3,118,123,54,69,121,2,200,77,96,25,
8,"BRASOV",83,42101,,390,0,"Str. PrincipalÇ nr.19 (nr.78)","UCEA",47,42101,0,3,673,447,361,86,428,19,900,453,218,210,
8,"BRASOV",83,42101,,391,0,"¸coala generalÇ FELDIOARA","UCEA",47,42101,0,3,168,115,91,24,110,5,250,135,45,65,
8,"BRASOV",83,42101,,392,0,"¸coala generalÇ UCEA DE SUS","UCEA",47,42101,0,3,668,363,296,67,358,5,800,437,169,189,
8,"BRASOV",83,42156,,393,0,"Str. PrincipalÇ nr.189","UNGRA",48,42156,0,3,893,393,362,31,386,7,900,507,231,155,
8,"BRASOV",83,42156,,394,0,"SEDIUL FOSTEI PRIMÆRII DÆI¸OARA","UNGRA",48,42156,0,3,487,399,332,67,393,6,600,201,282,111,
8,"BRASOV",83,42183,,395,0,"CÆMINUL CULTURAL VAMA BUZÆULUI","VAMA BUZAULUI",49,42183,0,3,1739,632,550,82,622,10,1800,1168,458,164,
8,"BRASOV",83,42183,,396,0,"CÆMINUL CULTURAL ACRI¸","VAMA BUZAULUI",49,42183,0,3,599,428,276,152,421,7,800,372,265,156,
8,"BRASOV",83,42183,,397,0,"¸coala generalÇ BUZÆIEL","VAMA BUZAULUI",49,42183,0,3,237,201,77,124,198,3,400,199,143,55,
8,"BRASOV",83,42236,,398,0,"CONSILIUL LOCAL VI¸TEA","VISTEA",50,42236,0,3,577,282,247,35,279,3,700,418,142,137,
8,"BRASOV",83,42236,,399,0,"CÆMINUL CULTURAL DRÆGU¸","VISTEA",50,42236,0,3,863,446,394,52,444,2,900,454,140,304,
8,"BRASOV",83,42236,,400,0,"¸coala generalÇ OLTEÝ","VISTEA",50,42236,0,3,277,215,127,88,208,7,350,135,86,122,
8,"BRASOV",83,42236,,401,0,"¸coala generalÇ RUCÆR","VISTEA",50,42236,0,3,359,173,122,51,170,3,450,277,96,74,
8,"BRASOV",83,42236,,402,0,"CÆMINUL CULTURAL VI¸TEA DE SUS","VISTEA",50,42236,0,3,519,254,203,51,250,4,550,296,125,125,
8,"BRASOV",83,42307,,403,0,"CONSILIUL LOCAL VOILA","VOILA",51,42307,0,3,546,264,212,52,258,6,700,436,121,137,
8,"BRASOV",83,42307,,404,0,"GrÇdiniîa de copii CINC¸OR","VOILA",51,42307,0,3,449,267,220,47,266,1,500,233,110,156,
8,"BRASOV",83,42307,,405,0,"CÆMINUL CULTURAL DRIDIF","VOILA",51,42307,0,3,288,195,137,58,190,5,400,205,82,108,
8,"BRASOV",83,42307,,406,0,"CÆMINUL CULTURAL LUDI¸OR","VOILA",51,42307,0,3,163,119,92,27,115,4,250,131,41,74,
8,"BRASOV",83,42307,,407,0,"CÆMINUL CULTURAL SIMBATA DE JOS","VOILA",51,42307,0,3,363,221,168,53,219,2,450,229,102,117,
8,"BRASOV",83,42307,,408,0,"¸coala generalÇ SIMBATA DE SUS","VOILA",51,42307,0,3,1050,584,445,139,567,17,1200,616,147,420,
8,"BRASOV",83,42307,,409,0,"CÆMINUL CULTURAL VOIVODENI","VOILA",51,42307,0,3,368,388,309,79,388,0,500,112,218,170,
8,"BRASOV",83,42398,,410,0,"CÆMINUL CULTURAL VULCAN","VULCAN",52,42398,0,3,2350,1521,1386,135,1503,18,2500,979,700,803,
8,"BRASOV",83,42398,,411,0,"SEDIUL FOSTEI PRIMÆRII HOLBAV","VULCAN",52,42398,0,3,1070,619,560,59,598,21,1200,581,195,403,
8,"BRASOV",83,42398,,412,0,"CÆMINUL CULTURAL COLONIA 1 MAI","VULCAN",52,42398,0,3,383,283,208,75,278,5,500,217,100,178,
9,"BRAILA",92,42682,,1,0,"STR SEBESULUI NR. 6(SC GEN. NR. 31 CARTIER RADU NEGRU)","MUNICIPIUL BRAILA",1,42682,1,1,2429,1385,1330,55,1365,20,2600,1215,892,473,
9,"BRAILA",92,42682,,2,0,"STR. SEBESULUI NR. 6 (SC GEN. NR. 31 CARTIER RADU NEGRU)","MUNICIPIUL BRAILA",1,42682,1,1,2263,1363,1233,130,1347,16,2500,1137,914,433,
9,"BRAILA",92,42682,,3,0,"STR. BARAGANULUI NR. 3 (GRAD. NR. 61 CARTIER RADU NEGRU)","MUNICIPIUL BRAILA",1,42682,1,1,2048,1234,1163,71,1222,12,2200,966,828,394,
9,"BRAILA",92,42682,,4,0,"STR. CHISINAU NR.44 (SC GEN. NR. 1)","MUNICIPIUL BRAILA",1,42682,1,1,1698,1098,1039,59,1090,8,1900,802,790,300,
9,"BRAILA",92,42682,,5,0,"STR. GRIGORE ALEXANSDRESCU NR. 33 ( GRAD. NR. 12)","MUNICIPIUL BRAILA",1,42682,1,1,2379,1488,1413,75,1472,16,2596,1108,1049,423,
9,"BRAILA",92,42682,,6,0,"STR. GRIGORE ALEXANDRESCU NR. 33(GRAD. NR. 33)","MUNICIPIUL BRAILA",1,42682,1,1,1952,1258,1175,83,1247,11,2100,842,853,394,
9,"BRAILA",92,42682,,7,0,"SOS. BUZAULUI NR. 10(SC GEN. NR. 2)","MUNICIPIUL BRAILA",1,42682,1,1,2910,1694,1550,144,1679,15,3200,1506,1126,553,
9,"BRAILA",92,42682,,8,0,"SOS. BUZAULUI NR. 10( SC GEN. NR. 2 CARTIER RADU NEGRU)","MUNICIPIUL BRAILA",1,42682,1,1,3160,1970,1843,127,1949,21,3500,1530,1354,595,
9,"BRAILA",92,42682,,9,0,"SOS. BUZAULUI NR. 86(SC GEN. NR. 27 CARTIER RADU NEGRU)","MUNICIPIUL BRAILA",1,42682,1,1,2373,1404,1341,63,1380,24,2600,1196,1027,353,
9,"BRAILA",92,42682,,10,0,"SOS BUZAULUI NR. 86(SC GEN. NR. 27 CARTIER RADU NEGRU)","MUNICIPIUL BRAILA",1,42682,1,1,2672,1620,1509,111,1588,32,3000,1380,1118,470,
9,"BRAILA",92,42682,,11,0,"ALEEA CRESEI NR. 2 CARTIER VIZIRU I ( CRESA NR. 39)","MUNICIPIUL BRAILA",1,42682,1,1,1837,1011,985,26,1003,8,2000,989,703,300,
9,"BRAILA",92,42682,,12,0,"ALEEA CRESEI NR. 2 CARTIER VIZIRU I (CRESA GRAD. NR 39)","MUNICIPIUL BRAILA",1,42682,1,1,1451,886,850,36,874,12,1596,710,602,272,
9,"BRAILA",92,42682,,13,0,"ALEEA STIINTEI CARTIER VIZIRU I ( SC GEN. NR. 28)","MUNICIPIUL BRAILA",1,42682,1,1,2332,1395,1336,59,1380,15,2600,1205,928,452,
9,"BRAILA",92,42682,,14,0,"ALEEA STIINTEI NR. 2 CARTIER VIZIRU I ( SC GEN. NR. 28)","MUNICIPIUL BRAILA",1,42682,1,1,1885,1045,997,48,1029,16,2100,1055,737,292,
9,"BRAILA",92,42682,,15,0,"ALEEA STIINTEI NR. 2 CARTIER VIZIRU I ( SC GEN. NR. 28)","MUNICIPIUL BRAILA",1,42682,1,1,1874,1089,1043,46,1077,12,2120,1031,777,300,
9,"BRAILA",92,42682,,16,0,"CALEA CALARASI NR. 252 ( OF POSTAL NR. 10)","MUNICIPIUL BRAILA",1,42682,1,1,1795,1036,985,51,1020,16,2000,964,719,301,
9,"BRAILA",92,42682,,17,0,"ALEEA MECANIZATORILOR NR. 1 CARTIER VIZIRU III ( GRAD. BL. U)","MUNICIPIUL BRAILA",1,42682,1,1,1881,1129,989,140,1122,7,2000,871,780,342,
9,"BRAILA",92,42682,,18,0,"FABRICILOR NR. 50( LOCAL CANTINA SANAB)","MUNICIPIUL BRAILA",1,42682,1,1,2200,1252,1143,109,1235,17,2400,1148,822,413,
9,"BRAILA",92,42682,,19,0,"ALEEA COCORILOR NR. 2 CARTIER VIZIRU III( SC GEN. NR. 29)","MUNICIPIUL BRAILA",1,42682,1,1,2870,1554,1485,69,1535,19,3100,1546,1047,488,
9,"BRAILA",92,42682,,20,0,"ALEEA LEBEDELOR NR. 9 CARTIER VIZIRU III ( LOCALUL GRAD. NR. 53 )","MUNICIPIUL BRAILA",1,42682,1,1,2060,1185,1136,49,1170,15,2300,1115,828,342,
9,"BRAILA",92,42682,,21,0,"ALEEA LEBEDELOR NR. 9, CARTIER VIZIRU III( GRAD. NR. 53)","MUNICIPIUL BRAILA",1,42682,1,1,1901,1087,1038,49,1069,18,2100,1013,704,365,
9,"BRAILA",92,42682,,22,0,"ALEEA COCORILOR NR. 3, VIZIRU III( SC GEN. NR. 29)","MUNICIPIUL BRAILA",1,42682,1,1,2036,1097,1040,57,1088,9,2200,1103,752,336,
9,"BRAILA",92,42682,,23,0,"SOS. BUZAULUI ( LOCALUL GR. SCOLAR DE CONSTRUCTII EDMOND NICOLAU)","MUNICIPIUL BRAILA",1,42682,1,1,703,421,370,51,418,3,800,379,295,123,
9,"BRAILA",92,42682,,24,0,"PIATA UZINEI NR. 1( INCINTA R.A APTERCOL)","MUNICIPIUL BRAILA",1,42682,1,1,1426,783,720,63,770,13,1600,817,506,264,
9,"BRAILA",92,42682,,25,0,"STR. FABRICILOR NR. 50( LOCALUL CANTINEI SANAB)","MUNICIPIUL BRAILA",1,42682,1,1,1349,856,669,187,851,5,1500,644,509,342,
9,"BRAILA",92,42682,,26,0,"STR. DORULUI NR. 38 CARTIER NEDELCU CHERCEA ( SC GEN. NR. 9)","MUNICIPIUL BRAILA",1,42682,1,1,1914,1158,1052,106,1134,24,2100,942,799,335,
9,"BRAILA",92,42682,,27,0,"STR. DORULUI NR. 38 CARTIER NEDELCU CHERCEA ( SC GEN. NR. 9)","MUNICIPIUL BRAILA",1,42682,1,1,1275,828,755,73,818,10,1400,572,586,232,
9,"BRAILA",92,42682,,28,0,"STR. DEVA NR. 11 CARTIER NEDELCU CHERCEA ( SC GEN. NR. 13)","MUNICIPIUL BRAILA",1,42682,1,1,1212,754,712,42,744,10,1300,546,513,231,
9,"BRAILA",92,42682,,29,0,"STR. DEVA NR. 11 CARTIER NEDELCU CHERCEA ( SC GEN. NR. 13)","MUNICIPIUL BRAILA",1,42682,1,1,1320,877,813,64,860,17,1400,523,606,254,
9,"BRAILA",92,42682,,30,0,"STR. COMUNA DIN PARIS NR. 95 (LOCALUL CAMINULUI CULTURAL)","MUNICIPIUL BRAILA",1,42682,1,1,2380,1426,1339,87,1397,29,2600,1174,979,418,
9,"BRAILA",92,42682,,31,0,"COMUNA DIN PARIS NR. 95 ( LOCALUL CAMINULUI CULTURAL)","MUNICIPIUL BRAILA",1,42682,1,1,1850,1197,1135,62,1184,13,2000,803,819,365,
9,"BRAILA",92,42682,,32,0,"SOS. RM. SARAT NR. 80 ( LOCALUL SCOLII UCECOM)","MUNICIPIUL BRAILA",1,42682,1,1,1144,727,677,50,721,6,1200,473,539,182,
9,"BRAILA",92,42682,,33,0,"SOS BALDOVINESTI NR. 10 ( SEDIUL PLAFAR BRAILA)","MUNICIPIUL BRAILA",1,42682,1,1,1359,890,842,48,881,9,1500,610,636,245,
9,"BRAILA",92,42682,,34,0,"STR. CARABUSULUI NR. 22 CARTIER NEDELCU CHERCEA ( SC GEN. NR. 24)","MUNICIPIUL BRAILA",1,42682,1,1,2783,1720,1646,74,1697,23,3000,1280,1231,466,
9,"BRAILA",92,42682,,35,0,"SOS BALDOVINESTI NR. 20 ( LOCALUL SC PAPAER PRINT)","MUNICIPIUL BRAILA",1,42682,1,1,2094,1422,1296,126,1414,8,2300,878,1010,404,
9,"BRAILA",92,42682,,36,0,"LOCALUL SECTIEI UTILAJE A DIRECTIEI JUDETENE DE DRUMURI SI PODURI BRAILA","MUNICIPIUL BRAILA",1,42682,1,1,1264,785,738,47,775,10,1400,615,508,267,
9,"BRAILA",92,42682,,37,0,"STR. DUDULUI NR. 2  CARTIER BRAILITA ( SC GEN. NR. 33 )","MUNICIPIUL BRAILA",1,42682,1,1,1638,973,943,30,964,9,1800,827,650,314,
9,"BRAILA",92,42682,,38,0,"STR. DUDULUI NR. 2 CARTIER BRAILITA ( SC GEN. NR. 33)","MUNICIPIUL BRAILA",1,42682,1,1,1491,867,829,38,861,6,1600,733,565,296,
9,"BRAILA",92,42682,,39,0,"CALEA GALATI NR. 346 BIS (LIC. IND. PROMEX)","MUNICIPIUL BRAILA",1,42682,1,1,1635,1037,961,76,1019,18,1800,763,673,346,
9,"BRAILA",92,42682,,40,0,"CALEA GALATI NR. 346 BIS ( LIC. IND. PROMEX)","MUNICIPIUL BRAILA",1,42682,1,1,2036,1245,1146,99,1237,8,2300,1055,822,415,
9,"BRAILA",92,42682,,41,0,"CALEA GALATI NR. 346 BIS ( LIC. IND. PROMEX)","MUNICIPIUL BRAILA",1,42682,1,1,1808,1154,989,165,1150,4,2000,846,812,338,
9,"BRAILA",92,42682,,42,0,"CALEA GALATI NR. 346 BIS ( LIC. IND. PROMEX)","MUNICIPIUL BRAILA",1,42682,1,1,1788,1041,1018,23,1036,5,2000,959,740,296,
9,"BRAILA",92,42682,,43,0,"STR. ULMULUI NR. 20 ( SC GEN. NR. 20)","MUNICIPIUL BRAILA",1,42682,1,1,1519,846,811,35,841,5,1700,854,589,252,
9,"BRAILA",92,42682,,44,0,"STR. ULMULUI NR. 20 ( SC. GEN. NR. 20)","MUNICIPIUL BRAILA",1,42682,1,1,1660,1059,987,72,1052,7,1800,741,717,335,
9,"BRAILA",92,42682,,45,0,"STR. TARGOVISTE NR. 28, CARTIER BRAILITA ( SC. GEN. NR.21)","MUNICIPIUL BRAILA",1,42682,1,1,1260,883,819,64,868,15,1400,517,577,291,
9,"BRAILA",92,42682,,46,0,"STR. MATEI BASARAB NR. 26 CARTIER BRAILITA ( LOCALUL GRAD. NR. 31)","MUNICIPIUL BRAILA",1,42682,1,1,1517,934,900,34,919,15,1700,766,606,313,
9,"BRAILA",92,42682,,47,0,"STR. PROGRESULUI NR. 9 CARTIER BRAILITA ( GRAD. NR. 28)","MUNICIPIUL BRAILA",1,42682,1,1,1768,1008,974,34,993,15,1900,892,697,296,
9,"BRAILA",92,42682,,48,0,"STR. PROGRESULUI NR. 9 CARTIER BRAILITA ( GRAD. NR. 28)","MUNICIPIUL BRAILA",1,42682,1,1,1882,1116,1050,66,1107,9,2100,984,730,377,
9,"BRAILA",92,42682,,49,0,"STR. PROGRESULUI NR. 7 CARTIER BRAILITA ( SC. GEN. NR. 11)","MUNICIPIUL BRAILA",1,42682,1,1,1883,1081,1028,53,1078,3,2100,1019,728,350,
9,"BRAILA",92,42682,,50,0,"STR. PROGRESULUI NR. 7 CARTIER BRAILITA ( SC. GEN. NR. 11)","MUNICIPIUL BRAILA",1,42682,1,1,1473,865,820,45,853,12,1600,735,604,249,
9,"BRAILA",92,42682,,51,0,"STR. C. NEGRUZZI NR. 76, CARTIER BRAILITA ( SC GEN. NR. 19)","MUNICIPIUL BRAILA",1,42682,1,1,1587,1031,987,44,1021,10,1698,667,687,334,
9,"BRAILA",92,42682,,52,0,"STR. MIRCEA CEL MARE NR. 58 . CARTIE BRAILITA  ( GRAD. NR. 29)","MUNICIPIUL BRAILA",1,42682,1,1,1359,849,813,36,841,8,1500,651,572,269,
9,"BRAILA",92,42682,,53,0,"STR. C. NEGRUZZI NR. 76,CARTIER BRAILITA ( SC. GEN. NR. 19)","MUNICIPIUL BRAILA",1,42682,1,1,1444,909,875,34,902,7,1600,691,633,269,
9,"BRAILA",92,42682,,54,0,"ALEEA TRANDAFIRILOR NR. 3 CARTIER HIPODROM ( GRAD. NR. 37)","MUNICIPIUL BRAILA",1,42682,1,1,1501,933,825,108,924,9,1702,769,710,214,
9,"BRAILA",92,42682,,55,0,"ALEEA TRANDAFIRILOR NR. 3 CARTIE HIPODROM ( GRAD. NR. 37)","MUNICIPIUL BRAILA",1,42682,1,1,1067,565,529,36,562,3,1200,635,393,169,
9,"BRAILA",92,42682,,56,0,"SALA POLIVALENTA PARC MONUMENT","MUNICIPIUL BRAILA",1,42682,1,1,1174,783,701,82,772,11,1300,517,581,191,
9,"BRAILA",92,42682,,57,0,"SALA POLIVALENTA PARC MONUMENT","MUNICIPIUL BRAILA",1,42682,1,1,1186,744,672,72,729,15,1300,556,560,169,
9,"BRAILA",92,42682,,58,0,"STR. PIETATII NR. 3 CARTIER HIPODROM ( POLICLINICA NR. 2)","MUNICIPIUL BRAILA",1,42682,1,1,1743,1301,953,348,1282,19,2300,999,877,405,
9,"BRAILA",92,42682,,59,0,"ALEEA PARCULUI NR. 2, CARTIER HIPODROM ( SC. GEN. NR. 3)","MUNICIPIUL BRAILA",1,42682,1,1,1770,1055,991,64,1037,18,1900,845,811,226,
9,"BRAILA",92,42682,,60,0,"ALEEA PARCULUI NR. 2 CARTIER HIPODROM ( SC GEN. NR. 3)","MUNICIPIUL BRAILA",1,42682,1,1,1491,925,874,51,912,13,1600,675,709,203,
9,"BRAILA",92,42682,,61,0,"ALEEA CUTEZATORILOR NR. 3, CARTIER HIPODROM ( SC. GEN. 23)","MUNICIPIUL BRAILA",1,42682,1,1,2075,1244,1187,57,1226,18,2300,1056,876,350,
9,"BRAILA",92,42682,,62,0,"ALEEA INVATATORILOR CARTIER HIPODROM ( LIC. D.P. PERPESSICIUS)","MUNICIPIUL BRAILA",1,42682,1,1,1863,1141,1081,60,1130,11,2100,959,806,324,
9,"BRAILA",92,42682,,63,0,"ALEEA INVATATORILOR CARTIER HIPODROM ( LIC. D.P.PERPESSICIUS)","MUNICIPIUL BRAILA",1,42682,1,1,2298,1292,1224,68,1271,21,2492,1200,908,363,
9,"BRAILA",92,42682,,64,0,"STR. SCOLILOR NR. 83 ( GRAD. NR.49)","MUNICIPIUL BRAILA",1,42682,1,1,2056,1194,1122,72,1182,12,2200,1006,830,352,
9,"BRAILA",92,42682,,65,0,"STR. OBORULUI NR. 9 CARTIER OBOR ( SC GEN. NR. 32)","MUNICIPIUL BRAILA",1,42682,1,1,2173,1202,1141,61,1189,13,2400,1198,867,322,
9,"BRAILA",92,42682,,66,0,"STR. OBORULUI NR. 9 CARTIER OBOR ( SC. GEN. NR. 32)","MUNICIPIUL BRAILA",1,42682,1,1,2122,1228,1156,72,1216,12,2300,1072,866,350,
9,"BRAILA",92,42682,,67,0,"STR. OBORULUI NR. 9 CARTIER OBOR ( SC. GEN. NR. 32)","MUNICIPIUL BRAILA",1,42682,1,1,2600,1503,1447,56,1479,24,2900,1397,1006,473,
9,"BRAILA",92,42682,,68,0,"ALEEA NARCISELOR NR. 6 CARTIER BOBR ( GRAD. NR. 36)","MUNICIPIUL BRAILA",1,42682,1,1,2325,1335,1264,71,1312,23,2600,1265,915,397,
9,"BRAILA",92,42682,,69,0,"B-DUL DOROBANTILOR NR. 311 ( LIC. PANAIT CERNA)","MUNICIPIUL BRAILA",1,42682,1,1,2293,1306,1227,79,1293,13,2500,1194,863,430,
9,"BRAILA",92,42682,,70,0,"STR. TRANSILVANIEI NR. 5 ( LOCALUL SC LAMINORUL SA)","MUNICIPIUL BRAILA",1,42682,1,1,1709,1079,930,149,1068,11,1900,821,708,360,
9,"BRAILA",92,42682,,71,0,"STR. G-RAL EREMIA GRIGORESCU NR. 23 ( SC GEN. NR. 6)","MUNICIPIUL BRAILA",1,42682,1,1,2457,1570,1459,111,1547,23,2700,1130,1114,433,
9,"BRAILA",92,42682,,72,0,"STR. SIRETULUI NR. 7 ( SECTIA L2 STATIA CFR)","MUNICIPIUL BRAILA",1,42682,1,1,2284,1421,1339,82,1412,9,2500,1079,1045,367,
9,"BRAILA",92,42682,,73,0,"STR. M. KOGALNICEANU NR. 3 ( GRAD. NR. 21)","MUNICIPIUL BRAILA",1,42682,1,1,2212,1307,1245,62,1293,14,2400,1093,907,386,
9,"BRAILA",92,42682,,74,0,"CALEA GALATI NR. 61 ( SC. GEN. NR. 18)","MUNICIPIUL BRAILA",1,42682,1,1,1667,941,901,40,931,10,1800,859,684,247,
9,"BRAILA",92,42682,,75,0,"STR. PLANTELOR NR. 7 ( LIC. PANAIT ISTRATI)","MUNICIPIUL BRAILA",1,42682,1,1,1599,1061,965,96,1050,11,1800,739,756,294,
9,"BRAILA",92,42682,,76,0,"STR. PLANTELOR NR. 7 (LIC. PANAIT ISTRATI)","MUNICIPIUL BRAILA",1,42682,1,1,2399,1455,1359,96,1432,23,2600,1145,1000,432,
9,"BRAILA",92,42682,,77,0,"STR. GHIOCEILOR NR. 1 ( SC. GEN. NR. 4)","MUNICIPIUL BRAILA",1,42682,1,1,1326,743,712,31,735,8,1400,657,540,195,
9,"BRAILA",92,42682,,78,0,"CALEA CALARASI NR. 125 ( SPITALUL NR. 1)","MUNICIPIUL BRAILA",1,42682,1,1,1593,1059,900,159,1052,7,1800,741,753,299,
9,"BRAILA",92,42682,,79,0,"CALEA CALARASI NR. 64 ( OF. POSTAL NR. 6)","MUNICIPIUL BRAILA",1,42682,1,1,1521,955,901,54,949,6,1700,745,673,276,
9,"BRAILA",92,42682,,80,0,"STR. CHIOCEILOR NR. 1 ( SC. GEN. NR. 4)","MUNICIPIUL BRAILA",1,42682,1,1,2124,1285,1224,61,1273,12,2300,1015,940,333,
9,"BRAILA",92,42682,,81,0,"STR. SCOLILOR NR. 60 ( SC. GEN. NR. 8)","MUNICIPIUL BRAILA",1,42682,1,1,1907,1184,1099,85,1175,9,2100,916,847,328,
9,"BRAILA",92,42682,,82,0,"B-DUL DOROBANTILOR NR. 411 ( LIC. PANAIT CERNA)","MUNICIPIUL BRAILA",1,42682,1,1,2377,1431,1347,84,1413,18,2500,1069,953,460,
9,"BRAILA",92,42682,,83,0,"STR. GRIVITA NR. 250 ( SC. GEN. NR. 10)","MUNICIPIUL BRAILA",1,42682,1,1,1819,1035,958,77,1022,13,2004,969,736,286,
9,"BRAILA",92,42682,,84,0,"STR. ROSIORI NR. 395 ( INTERNATUL LIC. NR. 2)","MUNICIPIUL BRAILA",1,42682,1,1,1502,957,895,62,945,12,1700,743,664,281,
9,"BRAILA",92,42682,,85,0,"STR. G-RAL EREMIA GRIGORESCU NR. 52( SC. GEN. NR. 12)","MUNICIPIUL BRAILA",1,42682,1,1,1840,1174,1049,125,1160,14,2000,826,824,336,
9,"BRAILA",92,42682,,86,0,"STR. STEFAN CEL MARE NR. 475 ( SC. GEN. NR. 17)","MUNICIPIUL BRAILA",1,42682,1,1,1273,791,711,80,780,11,1400,609,568,212,
9,"BRAILA",92,42682,,87,0,"STR. GALATI NR. 61( SC. GEN. NR. 18)","MUNICIPIUL BRAILA",1,42682,1,1,1459,900,842,58,889,11,1600,700,638,251,
9,"BRAILA",92,42682,,88,0,"STR. CARANTINA NR. 8 ( SC. GEN. NR. 25)","MUNICIPIUL BRAILA",1,42682,1,1,1619,1014,951,63,1008,6,1800,786,718,290,
9,"BRAILA",92,42682,,89,0,"CALEA CALARASI NR. 53 ( LIC. GHE.MUNTEANU MURGOCI)","MUNICIPIUL BRAILA",1,42682,1,1,1748,1064,960,104,1043,21,1900,836,727,316,
9,"BRAILA",92,42682,,90,0,"CALEA CALARASI NR. 104 ( SC. GEN. WALDORF)","MUNICIPIUL BRAILA",1,42682,1,1,1949,1267,1107,160,1254,13,2100,833,902,352,
9,"BRAILA",92,42682,,91,0,"CALEA CALARASI NR. 104 ( SC. GEN. WALDORF)","MUNICIPIUL BRAILA",1,42682,1,1,1363,852,782,70,839,13,1600,748,604,235,
9,"BRAILA",92,42682,,92,0,"STR. GRIVITA NR. 250 ( SC. GEN. NR. 10)","MUNICIPIUL BRAILA",1,42682,1,1,1750,1206,1011,195,1192,14,1900,694,876,316,
9,"BRAILA",92,42682,,93,0,"STR. GRIVITEI NR. 312 ( ADMINSTRATIA TABERELOR)","MUNICIPIUL BRAILA",1,42682,1,1,2016,1177,1106,71,1168,9,2200,1023,834,334,
9,"BRAILA",92,42682,,94,0,"STR. G-RAL EREMIA GRIGORESCU NR. 52 ( SC. GEN. NR. 12)","MUNICIPIUL BRAILA",1,42682,1,1,2077,1173,1098,75,1159,14,2300,1127,825,334,
9,"BRAILA",92,42682,,95,0,"STR. STEFAN CEL MARE NR. 475 ( SC. GEN. NR. 17)","MUNICIPIUL BRAILA",1,42682,1,1,1936,1086,976,110,1062,24,2100,1014,763,299,
9,"BRAILA",92,42682,,96,0,"B-DUL AL. I. CUZA NR. 71 ( LICEUL SANITAR)","MUNICIPIUL BRAILA",1,42682,1,1,1302,893,750,143,884,9,1400,507,688,196,
9,"BRAILA",92,42682,,97,0,"STR. SCOLILOR NR. 15 ( SC. GEN. NR. 7)","MUNICIPIUL BRAILA",1,42682,1,1,2303,1231,1134,97,1212,19,2500,1269,916,296,
9,"BRAILA",92,42682,,98,0,"STR. SCOLILOR NR. 15 ( SC. GEN. NR. 7)","MUNICIPIUL BRAILA",1,42682,1,1,1615,972,842,130,958,14,1800,828,703,255,
9,"BRAILA",92,42682,,99,0,"B-DUL AL. I. CUZA NR. 284 ( LIC. DE ARTA HARICLEEA DARCLE)","MUNICIPIUL BRAILA",1,42682,1,1,1915,1084,972,112,1074,10,2100,1016,744,330,
9,"BRAILA",92,42682,,100,0,"B-DUL PANAIT ISTRATI NR. 34 ( SC. GEN. NR. 16)","MUNICIPIUL BRAILA",1,42682,1,1,1718,1072,971,101,1057,15,1900,828,728,329,
9,"BRAILA",92,42682,,101,0,"STR. CAMPINIU NR. 32 ( LICEUL NICOLAE IORGA)","MUNICIPIUL BRAILA",1,42682,1,1,1801,1035,932,103,1021,14,1900,865,706,315,
9,"BRAILA",92,42682,,102,0,"B-DUL AL. I. CUZA NR. 182 ( LICEUL NICOLAE BALCESCU)","MUNICIPIUL BRAILA",1,42682,1,1,1749,1133,961,172,1108,22,1900,770,824,284,
9,"BRAILA",92,42682,,103,0,"STR. DIMITRIE BOLINTINEANU NR. 6 ( LICEUL ION GHICA)","MUNICIPIUL BRAILA",1,42682,1,1,1460,762,729,33,749,13,1600,838,508,241,
9,"BRAILA",92,42682,,104,1,"SOS. BUZAULUI NR. 2 ( SPITALUL JUDETEAN BRAILA)","MUNICIPIUL BRAILA",1,42682,1,1,0,347,0,347,342,5,599,252,254,88,
9,"BRAILA",92,42682,,105,1,"STR. CAMPINIU NR. 21 ( SPITALUL DE PNEUMOLOGIE)","MUNICIPIUL BRAILA",1,42682,1,1,0,80,0,80,80,0,200,120,52,28,
9,"BRAILA",92,42682,,106,1,"B-DUL INDEPENDENTEI NR. 237 ( SPITALUL DE OBSTRETICA SI GINECOLOGIE)","MUNICIPIUL BRAILA",1,42682,1,1,0,163,0,163,156,7,600,437,114,42,
9,"BRAILA",92,42682,,107,1,"CALEA CALARASI NR. 220 UM 01478","MUNICIPIUL BRAILA",1,42682,1,1,669,657,627,30,634,23,800,143,405,229,
9,"BRAILA",92,42682,,108,1,"STR. INDUSTRIA SARMEI NR. 2 UM 01481","MUNICIPIUL BRAILA",1,42682,1,1,0,610,0,610,598,12,800,190,414,184,
9,"BRAILA",92,42682,,109,1,"STR. CARANTINA NR. 2 PENITENCIARUL BRAILA","MUNICIPIUL BRAILA",1,42682,1,1,0,206,0,206,202,4,300,94,136,66,
9,"BRAILA",92,42682,,110,0,"STATIUNEA LACUL SARAT","MUNICIPIUL BRAILA",1,42682,1,1,186,468,37,431,458,10,700,232,321,137,
9,"BRAILA",92,42682,,111,1,"STR. G-RAL EREMIA GRIGORESCU  GARA CFR","MUNICIPIUL BRAILA",1,42682,1,1,0,241,0,241,236,5,500,259,140,96,
9,"BRAILA",92,42682,,112,1,"STR. SIRETULUI NR. 12 AUTOGARA BRAILA","MUNICIPIUL BRAILA",1,42682,1,1,0,62,0,62,62,0,200,138,40,22,
9,"BRAILA",92,42682,,113,1,"STR. VADUL GHECETULUI TRECERE BAC","MUNICIPIUL BRAILA",1,42682,1,1,0,68,0,68,67,1,200,132,32,35,
9,"BRAILA",92,42682,,114,1,"CAMIN SPITAL BALDOVINWSTI","MUNICIPIUL BRAILA",1,42682,1,1,0,84,0,84,80,4,400,316,60,20,
9,"BRAILA",92,42753,,115,0,"STR. REPUBLICII CASA DE CULTURA","ORAS FAUREI",2,42753,2,1,3038,1561,1496,65,1536,25,3400,1839,1135,401,
9,"BRAILA",92,42753,,116,0,"STR. BARAGANUL ( SC. GEN.)","ORAS FAUREI",2,42753,2,1,550,337,288,49,334,3,600,263,262,72,
9,"BRAILA",92,42753,,117,1,"GARA FAUREI","ORAS FAUREI",2,42753,2,1,0,170,0,170,168,2,500,330,115,53,
9,"BRAILA",92,43331,,118,0,"STR. SARATENI ( SC. GEN.)","ORAS IANCA",3,43331,2,1,1787,1008,908,100,1004,4,2000,992,632,372,
9,"BRAILA",92,43331,,119,0,"CASA DE CULTURA","ORAS IANCA",3,43331,2,1,1647,907,777,130,904,3,1800,893,615,289,
9,"BRAILA",92,43331,,120,0,"CALEA BRAILEI NR. 167 ( GR. SCOLAR INDUSTRIAL)","ORAS IANCA",3,43331,2,1,1673,1063,878,185,1054,9,1896,833,704,350,
9,"BRAILA",92,43331,,121,1,"UNITATE MILITARA","ORAS IANCA",3,43331,2,1,0,342,0,342,333,9,500,158,206,127,
9,"BRAILA",92,43331,,122,0,"SAT PLOPU ( SC. GEN.)","ORAS IANCA",3,43331,2,1,1256,787,688,99,777,10,1392,605,551,226,
9,"BRAILA",92,43331,,123,0,"SAT OPRISENESTI ( SC. GEN.)","ORAS IANCA",3,43331,2,1,570,448,322,126,441,7,700,252,283,158,
9,"BRAILA",92,43331,,124,0,"SAT PERISORU ( SC. GEN.)","ORAS IANCA",3,43331,2,1,908,601,530,71,594,7,1000,399,452,142,
9,"BRAILA",92,43331,,125,0,"SAT TIRLELE FILIULUI ( SC. GEN)","ORAS IANCA",3,43331,2,1,592,433,352,81,426,7,700,267,333,93,
9,"BRAILA",92,43331,,126,0,"SAT BERLESTI ( SC. GEN.)","ORAS IANCA",3,43331,2,1,320,260,214,46,257,3,400,140,172,85,
9,"BRAILA",92,43411,,127,0,"SC. GENERALA NR. 1 INSURATEI","ORAS INSURATEI",4,43411,2,1,1118,568,523,45,557,11,1200,632,385,172,
9,"BRAILA",92,43411,,128,0,"SC. GENERALA NR. 1 INSURATEI","ORAS INSURATEI",4,43411,2,1,1172,698,615,83,692,6,1284,586,469,223,
9,"BRAILA",92,43411,,129,0,"SC. ANEXA A GR. SCOLAR IND. INSURATEI","ORAS INSURATEI",4,43411,2,1,1867,1010,903,107,996,14,2100,1090,616,380,
9,"BRAILA",92,43411,,130,0,"SC. GEN. NR. 2 INSURATEI","ORAS INSURATEI",4,43411,2,1,1379,813,749,64,806,7,1496,683,455,351,
9,"BRAILA",92,43411,,131,0,"SC. GENERALA LACU REZII","ORAS INSURATEI",4,43411,2,1,399,228,192,36,222,6,496,268,143,79,
9,"BRAILA",92,42824,,132,0,"CAMIN CULTURAL BARAGANUL","BARAGANUL",5,42824,0,3,1816,1150,989,161,1133,17,2000,850,896,237,
9,"BRAILA",92,42824,,133,0,"SC. GEN. NR. 3 BARAGANUL","BARAGANUL",5,42824,0,3,898,612,544,68,605,7,1100,488,487,118,
9,"BRAILA",92,42842,,134,0,"SCOALA GEN. BERTESTII DE JOS","BERTESTII DE JOS",6,42842,0,3,1323,806,713,93,794,12,1500,694,545,249,
9,"BRAILA",92,42842,,135,0,"GRADINITA SAT SPIRU HARET","BERTESTII DE JOS",6,42842,0,3,1234,690,640,50,682,8,1400,710,523,159,
9,"BRAILA",92,42913,,136,0,"SC. GEN. BORDEI VERDE","BORDEI VERDE",7,42913,0,3,1318,814,735,79,806,8,1500,686,591,215,
9,"BRAILA",92,42913,,137,0,"SC. GEN. SAT GABRIELESCU","BORDEI VERDE",7,42913,0,3,656,563,482,81,560,3,700,137,418,142,
9,"BRAILA",92,42913,,138,0,"SC. GEN. SAT LISCOTEANCA","BORDEI VERDE",7,42913,0,3,435,303,243,60,295,8,500,197,223,72,
9,"BRAILA",92,42708,,139,0,"CAMIN CULTURAL","CHISCANI",8,42708,0,3,1443,791,665,126,778,13,1600,809,502,276,
9,"BRAILA",92,42708,,140,0,"SC. GENERALA CHISCANI","CHISCANI",8,42708,0,3,1436,798,652,146,792,6,1600,802,472,320,
9,"BRAILA",92,42708,,141,0,"SC. GEN. LACU SARAT","CHISCANI",8,42708,0,3,777,506,357,149,499,7,900,394,339,160,
9,"BRAILA",92,42968,,142,0,"SC. GEN. CIOCILE","CIOCILE",9,42968,0,3,1972,1155,1077,78,1138,17,2199,1044,912,226,
9,"BRAILA",92,42968,,143,0,"SC. GEN. SAT CHICHINETU","CIOCILE",9,42968,0,3,624,368,320,48,358,10,700,332,279,79,
9,"BRAILA",92,43019,,144,0,"SC. GEN. CIRESU","CIRESU",10,43019,0,3,922,579,505,74,568,11,1000,421,381,187,
9,"BRAILA",92,43019,,145,0,"SC. GEN. BATOGU","CIRESU",10,43019,0,3,638,415,346,69,411,4,700,285,322,89,
9,"BRAILA",92,43019,,146,0,"SC. GEN. SCARLATESI","CIRESU",10,43019,0,3,800,567,517,50,561,6,900,333,447,114,
9,"BRAILA",92,43019,,147,0,"CAMIN CULTURAL VULTURENI","CIRESU",10,43019,0,3,556,490,427,63,485,5,596,106,402,83,
9,"BRAILA",92,43073,,148,0,"SC GEN. TATARU","DUDESTI",11,43073,0,3,1722,1093,931,162,1070,23,1896,803,798,272,
9,"BRAILA",92,43073,,149,0,"SC. GEN. DUDESTI","DUDESTI",11,43073,0,3,1517,885,734,151,873,12,1699,814,647,226,
9,"BRAILA",92,43117,,150,0,"SC. GEN. FRECATEI","FRECATEI",12,43117,0,3,455,227,173,54,225,2,500,273,161,64,
9,"BRAILA",92,43117,,151,0,"SC. GEN. AGAUA","FRECATEI",12,43117,0,3,370,313,201,112,311,2,400,87,219,92,
9,"BRAILA",92,43117,,152,0,"SC. GEN. TITCOV","FRECATEI",12,43117,0,3,321,269,181,88,265,4,400,131,194,71,
9,"BRAILA",92,43180,,153,0,"SC. GEN. GALBENU","GALBENU",13,43180,0,3,935,683,592,91,677,6,1000,317,552,125,
9,"BRAILA",92,43180,,154,0,"SC. GEN. SATUC","GALBENU",13,43180,0,3,764,610,529,81,603,7,800,190,513,90,
9,"BRAILA",92,43180,,155,0,"SC. GEN. DROGU","GALBENU",13,43180,0,3,1102,891,764,127,879,12,1200,309,740,139,
9,"BRAILA",92,43242,,156,0,"SC. GEN. GEMENELE","GEMENELE",14,43242,0,3,1626,1044,972,72,1013,31,1800,756,832,181,
9,"BRAILA",92,43279,,157,0,"CAMIN CULTURAL GRADISTEA","GRADISTEA",15,43279,0,3,1175,642,539,103,627,15,1300,658,449,178,
9,"BRAILA",92,43279,,158,0,"CAMIN CULTURAL IBRIANU","GRADISTEA",15,43279,0,3,959,622,533,89,612,10,1100,478,443,169,
9,"BRAILA",92,43313,,159,0,"CAMIN CULTURAL GROPENI","GROPENI",16,43313,0,3,1789,1119,963,156,1100,19,2000,881,759,341,
9,"BRAILA",92,43313,,160,0,"SC. GEN. GROPENI","GROPENI",16,43313,0,3,1220,775,648,127,759,16,1300,525,527,232,
9,"BRAILA",92,43466,,161,0,"SC. GEN. NR. 1 JIRLAU","JIRLAU",17,43466,0,3,1438,835,746,89,818,17,1400,565,679,139,
9,"BRAILA",92,43466,,162,0,"SC. GEN. NR. 2 JIRLAU","JIRLAU",17,43466,0,3,1270,718,648,70,711,7,1600,882,581,130,
9,"BRAILA",92,43493,,163,0,"SC. GEN. MARASU","MARASU",18,43493,0,3,899,469,399,70,465,4,1000,531,317,148,
9,"BRAILA",92,43493,,164,0,"SC. GEN. BANDOIU","MARASU",18,43493,0,3,411,300,258,42,295,5,500,200,255,40,
9,"BRAILA",92,43493,,165,0,"SC. GEN. TACAU","MARASU",18,43493,0,3,669,330,288,42,325,5,700,370,269,56,
9,"BRAILA",92,43493,,166,0,"SC. GEN. MAGURENI","MARASU",18,43493,0,3,475,357,293,64,349,8,500,143,247,102,
9,"BRAILA",92,43493,,167,0,"SC. GEN. PLOPI","MARASU",18,43493,0,3,233,169,145,24,164,5,300,131,121,43,
9,"BRAILA",92,43563,,168,0,"LICEUL M. BASARAB MAXINENI","MAXINENI",19,43563,0,3,1409,824,738,86,813,11,1500,676,603,210,
9,"BRAILA",92,43563,,169,0,"CAMIN CULTURAL CORBU NOU","MAXINENI",19,43563,0,3,728,502,411,91,495,7,800,298,368,127,
9,"BRAILA",92,43563,,170,0,"SC. GEN. CORBU VECHI","MAXINENI",19,43563,0,3,207,160,126,34,158,2,296,136,100,58,
9,"BRAILA",92,43563,,171,0,"CAMIN CULTURAL LATINU","MAXINENI",19,43563,0,3,615,472,377,95,459,13,700,228,356,103,
9,"BRAILA",92,43625,,172,0,"CAMIN CULTURAL MIRCEA VODA","MIRCEA VODA",20,43625,0,3,2010,1433,1304,129,1405,28,2200,767,1057,348,
9,"BRAILA",92,43625,,173,0,"CAMIN CULTURAL DEDULESTI","MIRCEA VODA",20,43625,0,3,835,513,456,57,507,6,900,387,380,127,
9,"BRAILA",92,43652,,174,0,"SC. GEN. MOVILA MIRESII","MOVILA MIRESII",21,43652,0,3,1177,657,575,82,649,8,1300,643,479,170,
9,"BRAILA",92,43652,,175,0,"CAMIN CULTURAL MOVILA MIRESII","MOVILA MIRESII",21,43652,0,3,1201,657,566,91,645,12,1300,643,497,148,
9,"BRAILA",92,43652,,176,0,"SC. GEN. SAT TEPES VODA","MOVILA MIRESII",21,43652,0,3,670,470,373,97,463,7,700,230,333,130,
9,"BRAILA",92,43652,,177,0,"SC. GEN. SAT ESNA","MOVILA MIRESII",21,43652,0,3,296,200,164,36,194,6,300,100,138,56,
9,"BRAILA",92,43698,,178,0,"CAMIN CULTURAL RACOVITA","RACOVITA",22,43698,0,3,1215,1010,953,57,1000,10,1305,295,829,171,
9,"BRAILA",92,43732,,179,0,"SC. GEN. NR. 1 RAMNICELU","RAMNICELU",23,43732,0,3,1338,709,90,619,694,15,1500,791,512,182,
9,"BRAILA",92,43732,,180,0,"CAMIN CULTURAL CONSTANTINESTI","RAMNICELU",23,43732,0,3,267,259,176,83,253,6,300,41,196,57,
9,"BRAILA",92,43732,,181,0,"CAMIN CULTURAL M. KOGALNICEANU","RAMNICELU",23,43732,0,3,162,252,132,120,244,8,300,48,186,58,
9,"BRAILA",92,43787,,182,0,"SC. GEN. ROMANU","ROMANU",24,43787,0,3,1189,805,666,139,785,20,1301,496,607,178,
9,"BRAILA",92,43787,,183,0,"SC. GEN. SAT OANCEA","ROMANU",24,43787,0,3,323,291,232,59,280,11,400,109,183,97,
9,"BRAILA",92,43812,,184,0,"SC. GEN. ROSIORI","ROSIORI",25,43812,0,3,1494,1209,1126,83,1200,9,1700,491,821,379,
9,"BRAILA",92,43812,,185,0,"SOC. AGRICOLA SAT COLTEA","ROSIORI",25,43812,0,3,890,646,526,120,637,9,1000,354,512,125,
9,"BRAILA",92,43867,,186,0,"SC. GEN. SALCIA TUDOR","SALCIA TUDOR",26,43867,0,3,866,664,565,99,560,5,1000,435,414,146,
9,"BRAILA",92,43867,,187,0,"SC. GEN. CUZA VODA","SALCIA TUDOR",26,43867,0,3,860,583,513,70,571,12,996,413,434,137,
9,"BRAILA",92,43867,,188,0,"SC. GEN. GULIANCA","SALCIA TUDOR",26,43867,0,3,739,518,437,81,491,27,796,278,368,123,
9,"BRAILA",92,43929,,189,0,"SC. GEN. SCORTARU NOU","SCORTARU NOU",27,43929,0,3,728,492,415,77,485,7,800,308,394,91,
9,"BRAILA",92,43929,,190,0,"SC. GEN. SIHLEANU","SCORTARU NOU",27,43929,0,3,467,317,247,70,312,5,500,183,206,106,
9,"BRAILA",92,43992,,191,0,"CAMIN CULTURAL SILISTEA","SILISTEA",28,43992,0,3,1117,696,608,88,685,11,1200,504,446,239,
9,"BRAILA",92,43992,,192,0,"SC. GEN. COTU LUNG","SILISTEA",28,43992,0,3,250,237,160,77,231,6,300,63,129,102,
9,"BRAILA",92,44060,,193,0,"SC. GEN. STANCUTA","STANCUTA",29,44060,0,3,1363,927,835,92,919,8,1600,673,719,200,
9,"BRAILA",92,44060,,194,0,"AS. AGRICOLA VIITORUL CUZA VODA","STANCUTA",29,44060,0,3,1216,748,684,64,744,4,1300,552,397,347,
9,"BRAILA",92,44060,,195,0,"SC. GEN. SAT STANCA","STANCUTA",29,44060,0,3,417,340,297,43,338,2,500,160,271,67,
9,"BRAILA",92,44113,,196,0,"SC. GEN. SURDILA GAISEANCA","SURDILA-GAISEANCA",30,44113,0,3,1528,1000,929,71,989,11,1700,700,740,249,
9,"BRAILA",92,44113,,197,0,"SC. GEN. FILIPESTI","SURDILA-GAISEANCA",30,44113,0,3,697,527,444,83,521,6,800,273,369,152,
9,"BRAILA",92,42771,,198,0,"SC. GEN. SURDILA GRECI","SURDILA-GRECI",31,42771,0,3,778,368,332,36,358,10,900,532,259,99,
9,"BRAILA",92,42771,,199,0,"SC. GEN. FAUREI SAT","SURDILA-GRECI",31,42771,0,3,241,205,144,61,200,5,300,95,143,57,
9,"BRAILA",92,42771,,200,0,"SC. GEN. HORIA","SURDILA-GRECI",31,42771,0,3,341,249,216,33,249,0,400,151,176,73,
9,"BRAILA",92,44140,,201,0,"CAMIN CULTURAL SUTESTI","SUTESTI",32,44140,0,3,1823,1175,1023,152,1160,15,1992,817,869,291,
9,"BRAILA",92,44140,,202,0,"SC. GEN. SUTESTI","SUTESTI",32,44140,0,3,1577,905,785,120,892,13,1700,795,696,196,
9,"BRAILA",92,44140,,203,0,"SC. GEN. SAT M. KOGALNICEANU","SUTESTI",32,44140,0,3,224,246,147,99,238,8,300,54,192,46,
9,"BRAILA",92,44177,,204,0,"SC. GEN. TICHILESTI","TICHILESTI",33,44177,0,3,1408,836,735,101,818,18,1604,768,529,289,
9,"BRAILA",92,44177,,205,0,"SC. GEN. TICHILESTI","TICHILESTI",33,44177,0,3,1433,881,791,90,866,15,1600,719,584,282,
9,"BRAILA",92,44177,,206,0,"SOC. AGRICOLA ALBINA","TICHILESTI",33,44177,0,3,196,166,117,49,164,2,288,122,109,55,
9,"BRAILA",92,44202,,207,0,"SC. GEN. TRAIAN","TRAIAN",34,44202,0,3,855,575,458,117,573,2,1000,425,379,194,
9,"BRAILA",92,44202,,208,0,"SC. GEN. SILISTRARU","TRAIAN",34,44202,0,3,584,451,329,122,445,6,700,249,348,97,
9,"BRAILA",92,44202,,209,0,"SC. GEN. URLEASCA","TRAIAN",34,44202,0,3,1007,696,541,155,682,14,1100,404,550,132,
9,"BRAILA",92,44202,,210,0,"SC. GEN. CALDARUSA","TRAIAN",34,44202,0,3,150,137,100,37,135,2,200,63,83,52,
9,"BRAILA",92,44257,,211,0,"SC. GEN. CAZASU NOU","TUDOR VLADIMIRESCU",35,44257,0,3,664,486,392,94,482,4,700,214,290,192,
9,"BRAILA",92,44257,,212,0,"SC. GEN. CAZASU VECHI","TUDOR VLADIMIRESCU",35,44257,0,3,1362,875,737,138,856,19,1500,625,576,280,
9,"BRAILA",92,44257,,213,0,"SC. GEN. TUDOR VLADIMIRESCU","TUDOR VLADIMIRESCU",35,44257,0,3,890,614,488,126,598,16,996,382,406,192,
9,"BRAILA",92,44257,,214,0,"SEDIUL FOSTULUI CAP SCORTARU VECHI","TUDOR VLADIMIRESCU",35,44257,0,3,844,604,492,112,590,14,899,295,445,145,
9,"BRAILA",92,44257,,215,0,"SC. GEN. COMANEASCA","TUDOR VLADIMIRESCU",35,44257,0,3,189,148,111,37,147,1,200,52,97,50,
9,"BRAILA",92,44300,,216,0,"SC. GEN. NR. 1 TUFESTI","TUFESTI",36,44300,0,3,1446,1023,867,156,1016,7,1700,677,796,220,
9,"BRAILA",92,44300,,217,0,"CAMIN CULTURAL TUFESTI","TUFESTI",36,44300,0,3,1335,737,649,88,727,10,1500,763,496,231,
9,"BRAILA",92,44300,,218,0,"GRADINITA TUFESTI","TUFESTI",36,44300,0,3,919,710,579,131,705,5,1000,290,563,142,
9,"BRAILA",92,44300,,219,0,"SC. GEN. NR. 2 TUFESTI","TUFESTI",36,44300,0,3,994,690,555,135,679,11,1100,410,503,176,
9,"BRAILA",92,44328,,220,0,"CAMIN CULTURAL ULMU","ULMU",37,44328,0,3,1623,876,771,105,862,14,1795,919,579,283,
9,"BRAILA",92,44328,,221,0,"SC. GEN. NR. 2 ULMU","ULMU",37,44328,0,3,1044,732,611,121,726,6,1200,468,542,184,
9,"BRAILA",92,44328,,222,0,"CAMIN CULTURAL JUGUREANU","ULMU",37,44328,0,3,1023,645,584,61,627,18,1100,455,456,171,
9,"BRAILA",92,44355,,223,0,"SC. GEN. UNIREA","UNIREA",38,44355,0,3,967,680,596,84,664,16,1100,420,536,128,
9,"BRAILA",92,44355,,224,0,"SC. GEN. VALEA CINEPII","UNIREA",38,44355,0,3,1018,726,603,123,710,16,1104,378,538,172,
9,"BRAILA",92,44391,,225,0,"SC. GEN. VADENI","VADENI",39,44391,0,3,1704,1034,865,169,1022,12,1900,866,612,410,
9,"BRAILA",92,44391,,226,0,"CAMIN CULTURAL BALDOVINESTI","VADENI",39,44391,0,3,686,431,330,101,425,6,797,366,221,204,
9,"BRAILA",92,44391,,227,0,"SC. GEN. PIETROIU","VADENI",39,44391,0,3,307,268,174,94,265,3,400,132,146,119,
9,"BRAILA",92,44435,,228,0,"SC. GEN. VICTORIA","VICTORIA",40,44435,0,3,1828,1072,997,75,1055,17,2000,928,799,256,
9,"BRAILA",92,44435,,229,0,"SC. GEN. MIHAI BRAVU","VICTORIA",40,44435,0,3,1185,903,815,88,898,5,1300,397,671,227,
9,"BRAILA",92,44462,,230,0,"SC. GEN. VISANI","VISANI",41,44462,0,3,1665,1250,1147,103,1240,10,1800,550,1073,167,
9,"BRAILA",92,44462,,231,0,"SC. GEN. CIINENI BAI","VISANI",41,44462,0,3,584,459,404,55,449,10,700,241,359,90,
9,"BRAILA",92,44505,,232,0,"SC. GEN. NR. 1 VIZIRU","VIZIRU",42,44505,0,3,1683,985,767,218,971,14,1800,815,589,382,
9,"BRAILA",92,44505,,233,0,"SC. ANEXA NR. 2 VIZIRU","VIZIRU",42,44505,0,3,1914,1081,875,206,1065,16,1900,819,685,380,
9,"BRAILA",92,44505,,234,0,"SC. GEN. LANURILE","VIZIRU",42,44505,0,3,1578,1214,982,232,1196,18,1704,490,872,324,
9,"BRAILA",92,44532,,235,0,"CAMIN CULTURAL ZAVOAIA","ZAVOAIA",43,44532,0,3,2100,1205,1121,84,1182,23,2296,1091,800,382,
9,"BRAILA",92,44532,,236,0,"CAMIN CULTURAL DUDESCU","ZAVOAIA",43,44532,0,3,698,562,476,86,555,7,800,238,411,144,
10,"BUZAU",109,44818,,1,0,"SCOALA GEN. NR.5, STR. BISTRITEI, NR. 31","MUNICIPIUL BUZAU",1,44818,1,1,1767,1048,973,75,1036,12,1950,902,728,308,
10,"BUZAU",109,44818,,2,0,"SCOALA GEN. NR. 11, STR. CHIRISTIGII, NR. 7","MUNICIPIUL BUZAU",1,44818,1,1,1721,1011,958,53,1002,9,1900,889,740,262,
10,"BUZAU",109,44818,,3,0,"SCOALA AJUTATOARE, STR. AL. MARGHILOMAN, NR. 30","MUNICIPIUL BUZAU",1,44818,1,1,2360,1398,1264,134,1390,8,2600,1202,952,438,
10,"BUZAU",109,44818,,4,0,"GRUPUL SCOLAR CONTACTOARE, CART. BROSTENI","MUNICIPIUL BUZAU",1,44818,1,1,2274,1276,1196,80,1261,15,2550,1274,800,461,
10,"BUZAU",109,44818,,5,0,"GRUPUL SCOLAR CONTACTOARE, CART. BROSTENI","MUNICIPIUL BUZAU",1,44818,1,1,2107,1122,1072,50,1110,12,2350,1228,708,402,
10,"BUZAU",109,44818,,6,0,"GRUPUL SCOLAR CONTACTOARE, CART. BROSTENI","MUNICIPIUL BUZAU",1,44818,1,1,1907,946,896,50,939,7,1950,1004,607,332,
10,"BUZAU",109,44818,,7,0,"COLEGIUL UNIVERSITAR ECONOMIC, CART. BROSTENI","MUNICIPIUL BUZAU",1,44818,1,1,2019,1076,998,78,1068,8,2250,1174,684,384,
10,"BUZAU",109,44818,,8,0,"SCOALA GENERALA NR. 7, CART. DOROBANTI I","MUNICIPIUL BUZAU",1,44818,1,1,1874,936,862,74,922,14,2001,1065,597,325,
10,"BUZAU",109,44818,,9,0,"SCOALA GENERALA NR. 6, STR. VICTORIEI, NR. 73","MUNICIPIUL BUZAU",1,44818,1,1,2035,1084,1028,56,1080,4,2250,1166,668,412,
10,"BUZAU",109,44818,,10,0,"SCOALA GENERALA NR. 7, CART. DOROBANTI I","MUNICIPIUL BUZAU",1,44818,1,1,1924,1043,999,44,1040,3,2000,957,686,354,
10,"BUZAU",109,44818,,11,0,"SCOALA GENERALA NR. 7, CART. DOROBANTI I","MUNICIPIUL BUZAU",1,44818,1,1,1859,1088,1040,48,1083,5,2095,1007,687,396,
10,"BUZAU",109,44818,,12,0,"LICEUL PENTRU DEFICIENTI DE VEDERE, STR. HORTICOLEI, NR.50","MUNICIPIUL BUZAU",1,44818,1,1,1944,1058,969,89,1038,20,2150,1092,739,299,
10,"BUZAU",109,44818,,13,0,"CASA DE COPII SCOLARI, STR. HORTICOLEI NR. 50","MUNICIPIUL BUZAU",1,44818,1,1,1977,993,931,62,988,5,2200,1207,636,352,
10,"BUZAU",109,44818,,14,0,"SCOALA GENERALA NR. 6, STR. VICTORIEI NR. 73","MUNICIPIUL BUZAU",1,44818,1,1,1969,1061,1023,38,1055,6,2200,1139,686,369,
10,"BUZAU",109,44818,,15,0,"GRUP SCOLAR INDUSTRIAL CAI FERATE, STR HORTICOLEI, NR. 50","MUNICIPIUL BUZAU",1,44818,1,1,2379,1314,1224,90,1298,16,2450,1136,846,452,
10,"BUZAU",109,44818,,16,0,"SCOALA GENERALA NR. 16, CARTIER MICRO V","MUNICIPIUL BUZAU",1,44818,1,1,1886,958,915,43,947,11,2100,1142,602,345,
10,"BUZAU",109,44818,,17,0,"SCOALA GENERALA NR. 16, CARTIER MICRO V","MUNICIPIUL BUZAU",1,44818,1,1,1669,915,824,91,904,11,1900,985,610,294,
10,"BUZAU",109,44818,,18,0,"SCOALA GENERALA NR. 6, STR. VICTORIEI, NR. 73","MUNICIPIUL BUZAU",1,44818,1,1,1385,769,723,46,758,11,1550,781,527,231,
10,"BUZAU",109,44818,,19,0,"SCOALA GENERALA NR. 3, B-DUL REPUBLICII, NR. 18","MUNICIPIUL BUZAU",1,44818,1,1,2183,1174,1090,84,1167,7,2400,1226,770,397,
10,"BUZAU",109,44818,,20,0,"SCOALA GENERALA NR. 16, CARTIER MICRO V","MUNICIPIUL BUZAU",1,44818,1,1,1882,999,961,38,995,4,2100,1101,667,328,
10,"BUZAU",109,44818,,21,0,"LICEUL DE ARTA, STR. BUCEGI, NR.6","MUNICIPIUL BUZAU",1,44818,1,1,1640,930,882,48,919,11,1800,870,704,215,
10,"BUZAU",109,44818,,22,0,"SCOALA GENERALA NR. 16, CARTIER MICRO V","MUNICIPIUL BUZAU",1,44818,1,1,1651,1047,984,63,980,67,1800,753,699,281,
10,"BUZAU",109,44818,,23,0,"COLEGIUL B. P. HASDEU, STR. LIBERTATII, NR. 3","MUNICIPIUL BUZAU",1,44818,1,1,1594,876,800,76,870,6,1750,874,624,246,
10,"BUZAU",109,44818,,24,0,"SCOALA GENERALA NR. 10, STR. STUPARIEI, NR. 1","MUNICIPIUL BUZAU",1,44818,1,1,1572,1043,897,146,1037,6,1700,657,721,316,
10,"BUZAU",109,44818,,25,0,"SCOALA GENERALA NR. 10, STR. STUPARIEI, NR. 1","MUNICIPIUL BUZAU",1,44818,1,1,1594,1002,909,93,992,10,1800,798,707,285,
10,"BUZAU",109,44818,,26,0,"GRUPUL SCOLAR METALURGIC, STR. DTRU. FILIPESCU, NR. 6","MUNICIPIUL BUZAU",1,44818,1,1,2437,1689,1332,357,1670,19,2600,911,1018,652,
10,"BUZAU",109,44818,,27,0,"GRUPUL SCOLAR AGRICOL, STR. CRIZANTEMELOR, NR. 17","MUNICIPIUL BUZAU",1,44818,1,1,1523,836,784,52,829,7,1700,864,612,217,
10,"BUZAU",109,44818,,28,0,"SCOALA GENERALA NR. 8, STR. COL. ION BUZOIANU, NR. 109","MUNICIPIUL BUZAU",1,44818,1,1,1936,1109,1041,68,1101,4,2150,1045,754,347,
10,"BUZAU",109,44818,,29,0,"SCOALA GENERALA NR. 8, STR. COL. ION BUZOIANU, NR. 109","MUNICIPIUL BUZAU",1,44818,1,1,1702,989,940,49,974,15,1900,911,717,257,
10,"BUZAU",109,44818,,30,0,"DISTRICTUL 4 CFR, B-DUL 1 DECEMBRIE 1918, NR. 5","MUNICIPIUL BUZAU",1,44818,1,1,2266,1216,1124,92,1205,11,2500,1284,832,373,
10,"BUZAU",109,44818,,31,0,"GRADINITA DE COPII CU PROGRAM NORMAL NR. 8, STR. INDEPENDENTEI, NR. 81","MUNICIPIUL BUZAU",1,44818,1,1,1966,1009,958,51,995,14,2200,1191,676,319,
10,"BUZAU",109,44818,,32,0,"LICEUL M. EMINESCU, STR. INDEPENDENTEI, NR. 22","MUNICIPIUL BUZAU",1,44818,1,1,2117,1045,991,54,1036,9,2350,1305,758,278,
10,"BUZAU",109,44818,,33,0,"SCOALA NORMALA SPIRU HARET, STR. SPIRU HARET, NR. 6","MUNICIPIUL BUZAU",1,44818,1,1,2150,1088,994,94,1073,15,2400,1312,785,288,
10,"BUZAU",109,44818,,34,0,"SCOALA GENERALA NR. 15, STR. SPIRU HARET, NR. 8","MUNICIPIUL BUZAU",1,44818,1,1,1926,1016,956,60,1006,10,2150,1134,740,266,
10,"BUZAU",109,44818,,35,0,"SCOALA GENERALA NR. 15, STR. SPIRU HARET, NR. 8","MUNICIPIUL BUZAU",1,44818,1,1,1909,1008,956,52,996,12,2100,1092,695,301,
10,"BUZAU",109,44818,,36,0,"SCOALA GENERALA NR. 15, STR. SPIRU HARET, NR. 8","MUNICIPIUL BUZAU",1,44818,1,1,2175,1199,1140,59,1184,15,2397,1198,901,283,
10,"BUZAU",109,44818,,37,0,"S.C. ELECTRICA S.A. BUZAU, B-DUL MARESAL AL. AVERESCU, NR. 3","MUNICIPIUL BUZAU",1,44818,1,1,2142,1262,1105,157,1255,7,2350,1088,911,344,
10,"BUZAU",109,44818,,38,0,"SCOALA NORMALA SPIRU HARET, STR. SPIRU HARET, NR. 6","MUNICIPIUL BUZAU",1,44818,1,1,1787,940,877,63,932,8,2000,1060,707,225,
10,"BUZAU",109,44818,,39,0,"SCOALA NORMALA SPIRU HARET, STR. SPIRU HARET, NR. 6","MUNICIPIUL BUZAU",1,44818,1,1,1579,880,828,52,875,5,1750,870,700,175,
10,"BUZAU",109,44818,,40,0,"SCOALA GENERALA NR. 1, B-DUL N. BALCESCU, NR.28","MUNICIPIUL BUZAU",1,44818,1,1,1571,901,839,62,890,11,1750,849,691,199,
10,"BUZAU",109,44818,,41,0,"LICEUL M. EMINESCU, STR. INDEPENDENTEI, NR. 22","MUNICIPIUL BUZAU",1,44818,1,1,1807,1016,908,108,1003,13,2000,984,718,285,
10,"BUZAU",109,44818,,42,0,"GRUPUL SCOLAR ECONOMIC ADMINISTRATIV SI DE DESERVIRE, STR. T VLADIMIRESCU, NR. 15","MUNICIPIUL BUZAU",1,44818,1,1,1551,956,867,89,946,10,1700,744,762,184,
10,"BUZAU",109,44818,,43,0,"SCOALA GENERALA NR. 1, B-DUL N. BALCESCU, NR.28","MUNICIPIUL BUZAU",1,44818,1,1,1655,964,918,46,941,23,1800,836,704,237,
10,"BUZAU",109,44818,,44,0,"S.C. PROIECT S.A., STR. UNIRII, BL.13 A+B","MUNICIPIUL BUZAU",1,44818,1,1,1569,933,861,72,916,17,1750,817,613,303,
10,"BUZAU",109,44818,,45,0,"SCOALA GENERALA NR. 1, B-DUL N. BALCESCU, NR.28","MUNICIPIUL BUZAU",1,44818,1,1,1460,752,699,53,739,13,1600,848,523,216,
10,"BUZAU",109,44818,,46,0,"MUZEUL JUDETEAN DE ISTORIE, B-DUL N. BALCESCU, NR. 50","MUNICIPIUL BUZAU",1,44818,1,1,1687,1004,918,86,984,20,1850,846,704,280,
10,"BUZAU",109,44818,,47,0,"SCOALA GENERALA NR. 2, STR. GEORGE COSBUC, NR. 5","MUNICIPIUL BUZAU",1,44818,1,1,1564,872,835,37,861,11,1750,878,653,208,
10,"BUZAU",109,44818,,48,0,"SCOALA GENERALA NR. 2, STR. GEORGE COSBUC, NR. 5","MUNICIPIUL BUZAU",1,44818,1,1,1593,940,872,68,933,7,1750,810,678,255,
10,"BUZAU",109,44818,,49,0,"SCOALA GENERALA NR. 12, CARTIER MICRO XIV","MUNICIPIUL BUZAU",1,44818,1,1,2144,1155,1016,139,1139,16,2400,1245,772,367,
10,"BUZAU",109,44818,,50,0,"CENTRUL DE RECOLTARE SI CONSERVARE A SANGELUI, STR. G-RAL GRIGORE BASTAN, NR. 2","MUNICIPIUL BUZAU",1,44818,1,1,1929,1346,1001,345,1332,14,2200,854,864,468,
10,"BUZAU",109,44818,,51,0,"SCOALA GENERALA NR. 12, CARTIER MICRO XIV","MUNICIPIUL BUZAU",1,44818,1,1,2134,1179,1103,76,1162,17,2350,1171,815,347,
10,"BUZAU",109,44818,,52,0,"LICEUL CU PROGRAM SPORTIV, CARTIER MICRO XIV","MUNICIPIUL BUZAU",1,44818,1,1,1330,689,638,51,680,9,1500,811,460,220,
10,"BUZAU",109,44818,,53,0,"LICEUL CU PROGRAM SPORTIV, CARTIER MICRO XIV","MUNICIPIUL BUZAU",1,44818,1,1,1592,812,742,70,806,6,1800,988,512,294,
10,"BUZAU",109,44818,,54,0,"LICEUL CU PROGRAM SPORTIV, CARTIER MICRO XIV","MUNICIPIUL BUZAU",1,44818,1,1,1677,805,783,22,798,7,1850,1045,536,262,
10,"BUZAU",109,44818,,55,0,"SCOALA GENERALA NR. 11, STR. CHIRISTIGII, NR. 7","MUNICIPIUL BUZAU",1,44818,1,1,1875,1097,1006,91,1082,15,2100,1003,743,339,
10,"BUZAU",109,44818,,56,0,"SCOALA GENERALA NR. 11, STR. CHIRISTIGII, NR. 7","MUNICIPIUL BUZAU",1,44818,1,1,2015,1127,1041,86,1115,12,2250,1123,758,357,
10,"BUZAU",109,44818,,57,0,"SCOALA GENERALA NR. 11, STR. CHIRISTIGII, NR. 7","MUNICIPIUL BUZAU",1,44818,1,1,1950,1219,1013,206,1216,3,2150,931,819,397,
10,"BUZAU",109,44818,,58,0,"CAMINUL NR. 5, CARTIER MICRO III","MUNICIPIUL BUZAU",1,44818,1,1,1797,945,875,70,929,16,2000,1055,653,276,
10,"BUZAU",109,44818,,59,0,"SEMINARUL TEOLOGIC (GRUPUL SCOLAR DE COOPERATIE), ALEEA EPISCOPIEI NR. 1","MUNICIPIUL BUZAU",1,44818,1,1,1876,1105,987,118,1092,13,2100,995,755,337,
10,"BUZAU",109,44818,,60,0,"SEMINARUL TEOLOGIC (GRUPUL SCOLAR DE COOPERATIE), ALEEA EPISCOPIEI NR. 1","MUNICIPIUL BUZAU",1,44818,1,1,1966,1074,1021,53,1056,18,2200,1126,782,274,
10,"BUZAU",109,44818,,61,0,"GRUPUL SCOLAR DE INDUSTRIE USOARA, STR. BAZALT NR. 1","MUNICIPIUL BUZAU",1,44818,1,1,2564,1445,1243,202,1427,18,2850,1405,976,451,
10,"BUZAU",109,44818,,62,0,"SCOALA GENERALA NR. 14, STR. TRANSILVANIEI, NR. 313","MUNICIPIUL BUZAU",1,44818,1,1,1784,935,886,49,925,10,2000,1065,670,255,
10,"BUZAU",109,44818,,63,0,"SCOALA GENERALA NR. 14, STR. TRANSILVANIEI, NR. 313","MUNICIPIUL BUZAU",1,44818,1,1,1253,670,592,78,662,8,1400,730,521,141,
10,"BUZAU",109,44818,,64,0,"SCOALA GENERALA NR. 14, STR. TRANSILVANIEI, NR. 313","MUNICIPIUL BUZAU",1,44818,1,1,1317,640,601,39,625,15,1450,810,550,75,
10,"BUZAU",109,44818,,65,1,"STATIA CFR BUZAU","MUNICIPIUL BUZAU",1,44818,1,1,0,775,0,775,772,3,1000,225,451,321,
10,"BUZAU",109,44818,,66,1,"SPITALUL JUDETEAN BUZAU, B-DUL STADIONULUI, NR. 2","MUNICIPIUL BUZAU",1,44818,1,1,0,457,0,457,453,4,1200,743,339,114,
10,"BUZAU",109,44818,,67,1,"SPITALUL JUDETEAN BUZAU, B-DUL N. BALCESCU, NR. 40","MUNICIPIUL BUZAU",1,44818,1,1,0,27,0,27,27,0,150,123,13,14,
10,"BUZAU",109,44818,,68,1,"SPITALUL JUDETEAN BUZAU, B-DUL GARII, NR. 8","MUNICIPIUL BUZAU",1,44818,1,1,0,127,0,127,124,3,300,173,89,35,
10,"BUZAU",109,44818,,69,1,"SPITALUL JUDETEAN BUZAU, STR. PLEVNEI, NR. 26","MUNICIPIUL BUZAU",1,44818,1,1,0,67,0,67,67,0,400,333,49,18,
10,"BUZAU",109,44818,,70,1,"DISPENSARUL POLICLINIC CFR, B-DUL REPUBLICII, NR. 8-12","MUNICIPIUL BUZAU",1,44818,1,1,0,73,0,73,72,1,200,127,45,27,
10,"BUZAU",109,44818,,71,1,"U.M. 01671","MUNICIPIUL BUZAU",1,44818,1,1,342,370,304,66,365,5,500,130,207,158,
10,"BUZAU",109,44818,,72,1,"U.M. 0838","MUNICIPIUL BUZAU",1,44818,1,1,0,239,0,239,234,5,398,159,150,84,
10,"BUZAU",109,44845,,73,0,"SCOALA GENERALA NR.7, STR. MERISORULUI, NR.3","MUNICIPIUL RAMNICU SARAT",2,44845,1,1,1566,899,831,68,889,10,1700,801,625,264,
10,"BUZAU",109,44845,,74,0,"SCOALA GENERALA NR. 3 STR. PERISORI, NR.2","MUNICIPIUL RAMNICU SARAT",2,44845,1,1,1648,848,763,85,841,7,1850,1002,726,115,
10,"BUZAU",109,44845,,75,0,"SCOALA GENERALA NR. 5 LOCALUL I, STR. AL. IOAN CUZA, NR.7","MUNICIPIUL RAMNICU SARAT",2,44845,1,1,1377,871,740,131,859,12,1553,682,657,202,
10,"BUZAU",109,44845,,76,0,"GRADINITA CU PROGRAM NORMAL NR. 8, STR. LT. PANTAZESCU, NR.2","MUNICIPIUL RAMNICU SARAT",2,44845,1,1,1220,1000,815,185,994,6,1850,850,670,324,
10,"BUZAU",109,44845,,77,0,"SCOALA PROFESIONALA NR. 1, STR. MIHAIL KOGALNICEANU, NR.22","MUNICIPIUL RAMNICU SARAT",2,44845,1,1,1674,999,787,212,987,12,1800,801,709,278,
10,"BUZAU",109,44845,,78,0,"SCOALA GENERALA NR. 5 LOCALUL II, STR. AL. IOAN CUZA, NR. 4","MUNICIPIUL RAMNICU SARAT",2,44845,1,1,1726,840,765,75,830,10,1900,1060,574,256,
10,"BUZAU",109,44845,,79,0,"SCOALA GENERALA NR.4, STR. PRINCIPELE FERDINAND, NR.13","MUNICIPIUL RAMNICU SARAT",2,44845,1,1,1411,822,678,144,816,6,1552,730,582,234,
10,"BUZAU",109,44845,,80,0,"LICEUL TEORETIC AL. VLAHUTA, LOCALUL II, STR. TUDOR VLADIMIRESCU, NR.17","MUNICIPIUL RAMNICU SARAT",2,44845,1,1,1544,812,706,106,802,10,1700,888,571,231,
10,"BUZAU",109,44845,,81,0,"CAMINUL CU PROGRAM PELUNGIT NR. 1, STR. CONSTANTIN BRANCOVEANU, NR. 13","MUNICIPIUL RAMNICU SARAT",2,44845,1,1,1610,830,747,83,824,6,1800,970,590,234,
10,"BUZAU",109,44845,,82,0,"SCOALA GENERALA NR. 6, STR. MATEI BASARAB, NR. 86","MUNICIPIUL RAMNICU SARAT",2,44845,1,1,1696,1072,953,119,1068,4,1900,828,755,313,
10,"BUZAU",109,44845,,83,0,"LICEUL TEORETIC STEFAN CEL MARE, STR. LILIACULUI, NR.15","MUNICIPIUL RAMNICU SARAT",2,44845,1,1,1479,825,768,57,819,6,1650,825,631,188,
10,"BUZAU",109,44845,,84,0,"LICEUL AGROINDUSTRIAL, STR. N. BALCESCU, NR. 2, LOCALUL I","MUNICIPIUL RAMNICU SARAT",2,44845,1,1,1476,905,831,74,831,12,1600,757,593,238,
10,"BUZAU",109,44845,,85,0,"CANTINA DE AJUTOR SOCIAL, STR. PLT. TORCARU, NR. 12","MUNICIPIUL RAMNICU SARAT",2,44845,1,1,1536,853,816,37,843,10,1536,683,558,285,
10,"BUZAU",109,44845,,86,0,"LICEUL TEORETIC AL. VLAHUTA, LOCALUL I, STR. TUDOR VLADIMIRESCU, NR. 13","MUNICIPIUL RAMNICU SARAT",2,44845,1,1,1508,822,756,66,815,7,1650,828,630,185,
10,"BUZAU",109,44845,,87,0,"SCOALA GENERALA NR. 1, STR. STEFAN CEL MARE, NR.17","MUNICIPIUL RAMNICU SARAT",2,44845,1,1,1403,821,781,40,814,7,1550,729,594,220,
10,"BUZAU",109,44845,,88,0,"SCOALA GENERALA NR. 2, STR. PAUN PINCIO, NR. 8","MUNICIPIUL RAMNICU SARAT",2,44845,1,1,1617,917,778,139,904,13,1800,883,642,262,
10,"BUZAU",109,44845,,89,0,"OILREG S.A. , STR. COSTIENI, NR. 106","MUNICIPIUL RAMNICU SARAT",2,44845,1,1,1754,1073,945,128,1061,12,2006,933,748,313,
10,"BUZAU",109,44845,,90,0,"CAMINUL DE COPII CU PROGRAM PRELUNGIT NR. 3, COSTIENI, LOCAL I, STR. BALTA ALBA, NR. 2","MUNICIPIUL RAMNICU SARAT",2,44845,1,1,1770,983,918,65,973,10,1950,967,625,348,
10,"BUZAU",109,44845,,91,0,"CAMINUL DE COPII CU PROGRAM PRELUNGIT NR. 3, COSTIENI, LOCAL II, STR. BALTA ALBA, NR. 2","MUNICIPIUL RAMNICU SARAT",2,44845,1,1,1548,915,747,168,908,7,1700,785,594,314,
10,"BUZAU",109,44845,,92,0,"SCOALA GENERALA NR. 8, STR. LALELELOR, NR. 1","MUNICIPIUL RAMNICU SARAT",2,44845,1,1,1881,847,773,74,839,8,2100,1253,536,303,
10,"BUZAU",109,44845,,93,0,"LICEUL AGROINDUSTRIAL, LOCALUL II, STR. LALELELOR, NR.1","MUNICIPIUL RAMNICU SARAT",2,44845,1,1,1381,873,695,178,871,2,1552,679,526,345,
10,"BUZAU",109,44845,,94,1,"SPITALUL MUNICIPAL, B-DUL NICOLAE BALCESCU, NR. 4","MUNICIPIUL RAMNICU SARAT",2,44845,1,1,0,314,0,314,310,4,350,36,239,71,
10,"BUZAU",109,44845,,95,1,"U.M. 01422","MUNICIPIUL RAMNICU SARAT",2,44845,1,1,157,193,154,39,187,6,200,7,106,81,
10,"BUZAU",109,47916,,96,0,"CASA DE CULTURA NEHOIU","ORAS NEHOIU",3,47916,2,1,2832,1219,985,234,1205,14,3100,1881,875,330,
10,"BUZAU",109,47916,,97,0,"CLADIRE PROPRIET. PRIMARIEI-LINGA BISERICA, FOSTA SECTIE DE INCALTAMINTE ""DIMBOVITA""","ORAS NEHOIU",3,47916,2,1,405,358,283,75,358,0,450,92,236,122,
10,"BUZAU",109,47916,,98,0,"CAMIN CULTURAL VALEA NEHOIULUI","ORAS NEHOIU",3,47916,2,1,798,706,514,192,703,3,900,194,422,281,
10,"BUZAU",109,47916,,99,0,"SCOALA CU CLASELE I-IV VALEA NEHOIASULUI","ORAS NEHOIU",3,47916,2,1,600,303,207,96,300,3,650,347,209,91,
10,"BUZAU",109,47916,,100,0,"CAMIN CULTURAL LUNCA PRIPOR","ORAS NEHOIU",3,47916,2,1,693,619,407,212,612,7,750,131,383,229,
10,"BUZAU",109,47916,,101,0,"CAMIN CULTURAL BASCA ROZILEI","ORAS NEHOIU",3,47916,2,1,1011,784,643,141,769,15,1100,316,427,342,
10,"BUZAU",109,47916,,102,0,"SCOALA CU CLASELE I-IV VINETIS","ORAS NEHOIU",3,47916,2,1,169,154,115,39,152,2,200,46,92,60,
10,"BUZAU",109,47916,,103,0,"CAMIN NEFAMILISTI FORESTA NEHOIU, LUNCA MARE","ORAS NEHOIU",3,47916,2,1,664,473,401,72,464,9,700,227,356,108,
10,"BUZAU",109,47916,,104,0,"CAMIN CULTURAL BADARLEGI","ORAS NEHOIU",3,47916,2,1,371,214,186,28,210,4,400,186,119,91,
10,"BUZAU",109,47916,,105,0,"CAMIN CULTURAL PALTINENI","ORAS NEHOIU",3,47916,2,1,785,559,476,83,553,6,800,241,347,206,
10,"BUZAU",109,47916,,106,0,"SCOALA GENERALA MLAJET","ORAS NEHOIU",3,47916,2,1,750,568,477,91,564,4,850,282,388,176,
10,"BUZAU",109,47916,,107,0,"SCOALA CU CLASELE I-IV CHIRLESTI","ORAS NEHOIU",3,47916,2,1,502,411,317,94,404,7,550,139,277,127,
10,"BUZAU",109,47916,,108,0,"CAMIN CULTURAL CURMATURA","ORAS NEHOIU",3,47916,2,1,196,212,167,45,208,4,250,38,155,53,
10,"BUZAU",109,48744,,109,0,"CLUBUL COPIILOR POGOANELE","ORAS POGOANELE",4,48744,2,1,1512,742,684,58,732,10,1600,858,514,218,
10,"BUZAU",109,48744,,110,0,"SCOALA NR. 2 POGOANELE","ORAS POGOANELE",4,48744,2,1,1593,930,861,69,915,15,1750,820,647,268,
10,"BUZAU",109,48744,,111,0,"SCOALA NR. 3 POGOANELE","ORAS POGOANELE",4,48744,2,1,1484,862,774,88,852,10,1750,888,609,243,
10,"BUZAU",109,48744,,112,0,"SCOALA CALDARASTI","ORAS POGOANELE",4,48744,2,1,1838,1034,937,97,1014,20,1950,916,794,220,
10,"BUZAU",109,44863,,113,0,"SCOALA GENERALA AMARU","AMARU",5,44863,0,3,1181,708,613,95,692,16,1301,593,528,164,
10,"BUZAU",109,44863,,114,0,"SCOALA GENERALA DULBANU","AMARU",5,44863,0,3,398,307,235,72,304,3,450,143,242,62,
10,"BUZAU",109,44863,,115,0,"SCOALA GENERALA LUNCA","AMARU",5,44863,0,3,373,260,187,73,257,3,400,140,196,61,
10,"BUZAU",109,44863,,116,0,"SCOALA GENERALA SINAIA","AMARU",5,44863,0,3,228,199,143,56,196,3,250,51,129,67,
10,"BUZAU",109,44934,,117,0,"SCOALA GENERALA BALTA-ALBA","BALTA ALBA",7,44934,0,3,642,410,346,64,402,8,700,290,286,116,
10,"BUZAU",109,44934,,118,0,"SCOALA GENERALA BAILE","BALTA ALBA",7,44934,0,3,496,344,272,72,335,9,550,206,242,93,
10,"BUZAU",109,44934,,119,0,"SCOALA GENERALA AMARA","BALTA ALBA",7,44934,0,3,1579,936,850,86,919,17,1700,764,656,263,
10,"BUZAU",109,44989,,120,0,"PRIMARIA BALACEANU","BALACEANU",6,44989,0,3,1448,913,816,97,902,11,1600,687,795,107,
10,"BUZAU",109,45003,,121,0,"SCOALA CU CLASELE I-IV BECENI","BECENI",8,45003,0,3,794,522,399,123,519,3,850,328,416,103,
10,"BUZAU",109,45003,,122,0,"SCOALA CU CLASELE I-VIII GURA DIMIENII","BECENI",8,45003,0,3,919,581,489,92,573,8,1050,469,467,106,
10,"BUZAU",109,45003,,123,0,"SCOALA CU CLASELE I-VIII VALEA PARULUI","BECENI",8,45003,0,3,1236,722,601,121,713,9,1350,628,541,172,
10,"BUZAU",109,45003,,124,0,"SCOALA CU CLASELE I-VIII IZVORU DULCE","BECENI",8,45003,0,3,835,544,441,103,536,8,900,356,411,125,
10,"BUZAU",109,45003,,125,0,"SCOALA CU CLASELE I-IV FLORESTI","BECENI",8,45003,0,3,314,175,152,23,173,2,350,175,146,27,
10,"BUZAU",109,45101,,126,0,"CASA DE CULTURA BERCA","BERCA",9,45101,0,3,1546,1238,706,532,1227,11,1550,312,835,392,
10,"BUZAU",109,45101,,127,0,"SCOALA GENERALA BERCA","BERCA",9,45101,0,3,3046,757,585,172,752,5,2800,2043,491,261,
10,"BUZAU",109,45101,,128,0,"SCOALA GENERALA RATESTI","BERCA",9,45101,0,3,849,618,359,259,610,8,950,332,475,135,
10,"BUZAU",109,45101,,129,0,"SCOALA CU CLASELE I-IV PICLELE","BERCA",9,45101,0,3,182,143,116,27,141,2,300,157,100,41,
10,"BUZAU",109,45101,,130,0,"SCOALA GENERALA PLESCOI","BERCA",9,45101,0,3,1545,864,621,243,858,6,1550,686,657,201,
10,"BUZAU",109,45101,,131,0,"SCOALA CU CLASELE I-IV VALEA NUCULUI","BERCA",9,45101,0,3,508,431,431,0,427,4,500,69,295,132,
10,"BUZAU",109,45101,,132,0,"SCOALA GENERALA JOSENI","BERCA",9,45101,0,3,645,524,429,95,518,6,650,126,386,132,
10,"BUZAU",109,45245,,133,0,"SALA DE FESTIVITATI A PRIMARIEI BISOCA","BISOCA",10,45245,0,3,1012,447,401,46,437,10,1150,703,355,82,
10,"BUZAU",109,45245,,134,0,"CAMPUSUL ""SF. SAVA"" -RECEA","BISOCA",10,45245,0,3,1277,840,763,77,838,2,1500,660,726,112,
10,"BUZAU",109,45334,,135,0,"SCOALA GENERALA BLAJANI","BLAJANI",11,45334,0,3,853,518,451,67,512,6,950,432,382,130,
10,"BUZAU",109,45334,,136,0,"CAMINUL CULTURAL SORESTI","BLAJANI",11,45334,0,3,273,188,164,24,181,7,300,112,120,61,
10,"BUZAU",109,45361,,137,0,"PRIMARIA COM.BOLDU","BOLDU",12,45361,0,3,1098,859,725,134,845,14,1200,341,703,142,
10,"BUZAU",109,45361,,138,0,"GRADINITA DE COPII BOLDU","BOLDU",12,45361,0,3,932,843,729,114,831,12,1050,207,670,161,
10,"BUZAU",109,45389,,139,0,"""SOCIETATEA AGRICOLA BOZIORU""","BOZIORU",13,45389,0,3,651,403,375,28,401,2,700,297,298,103,
10,"BUZAU",109,45389,,140,0,"SCOALA CU CLASELE I-IV VAVALUCILE","BOZIORU",13,45389,0,3,435,248,218,30,242,6,500,252,164,78,
10,"BUZAU",109,45496,,141,0,"SCOALA BRADEANU","BRADEANU",14,45496,0,3,984,599,508,91,574,25,1150,551,424,150,
10,"BUZAU",109,45496,,142,0,"SCOALA SMIRDAN","BRADEANU",14,45496,0,3,939,647,517,130,640,7,1100,453,485,155,
10,"BUZAU",109,45496,,143,0,"SCOALA MITROPOLIA","BRADEANU",14,45496,0,3,410,332,235,97,326,6,400,68,254,72,
10,"BUZAU",109,45539,,144,0,"CAMINUL CULTURAL BRAESTI","BRAESTI",15,45539,0,3,938,522,447,75,520,2,1050,528,412,108,
10,"BUZAU",109,45539,,145,0,"GRADINITA BRATILESTI","BRAESTI",15,45539,0,3,1162,670,595,75,660,10,1300,630,496,164,
10,"BUZAU",109,45619,,146,0,"FOSTA PRIMARIE BREAZA","BREAZA",16,45619,0,3,1109,561,477,84,545,16,1200,639,444,101,
10,"BUZAU",109,45619,,147,0,"FOSTUL SEDIU AL CAP GRECEANCA","BREAZA",16,45619,0,3,716,509,311,198,496,13,1100,591,359,137,
10,"BUZAU",109,45619,,148,0,"SCOALA VISPESTI","BREAZA",16,45619,0,3,289,390,139,251,383,7,800,410,313,70,
10,"BUZAU",109,45673,,149,0,"SCOALA GENERALA BUDA","BUDA",17,45673,0,3,1583,948,851,97,933,15,1750,802,692,241,
10,"BUZAU",109,45673,,150,0,"SCOALA GENERALA AL. ODOBESCU","BUDA",17,45673,0,3,1066,541,462,79,532,9,1200,659,405,127,
10,"BUZAU",109,45753,,151,0,"CAMINUL CULTURAL CALVINI","CALVINI",19,45753,0,3,1536,766,683,83,757,9,1700,934,486,271,
10,"BUZAU",109,45753,,152,0,"SCOALA GENERALA CALVINI","CALVINI",19,45753,0,3,1758,903,814,89,885,18,1800,897,745,140,
10,"BUZAU",109,45815,,153,0,"SCOALA C.A. ROSETTI","C.A. ROSETTI",18,45815,0,3,798,681,557,124,675,6,900,219,523,152,
10,"BUZAU",109,45815,,154,0,"SCOALA BALTENI","C.A. ROSETTI",18,45815,0,3,460,494,428,66,488,6,500,6,455,33,
10,"BUZAU",109,45815,,155,0,"SCOALA LUNCA","C.A. ROSETTI",18,45815,0,3,1116,971,879,92,940,31,1250,279,684,256,
10,"BUZAU",109,45815,,156,0,"SCOALA BILHACU","C.A. ROSETTI",18,45815,0,3,189,178,139,39,178,0,200,22,156,22,
10,"BUZAU",109,45815,,157,0,"SCOALA COTU CIORII","C.A. ROSETTI",18,45815,0,3,536,457,385,72,451,6,600,143,363,88,
10,"BUZAU",109,45815,,158,0,"SCOALA VIZIRENI","C.A. ROSETTI",18,45815,0,3,376,277,224,53,272,5,400,123,211,61,
10,"BUZAU",109,45888,,159,0,"SCOALA GENERALA CANESTI","CANESTI",20,45888,0,3,922,577,469,108,570,7,1000,423,330,240,
10,"BUZAU",109,45959,,160,0,"SCOALA GENERALA CATINA","CATINA",21,45959,0,3,1465,809,732,77,807,2,1600,791,695,112,
10,"BUZAU",109,45959,,161,0,"SCOALA GENERALA CORBU","CATINA",21,45959,0,3,798,524,450,74,522,2,900,376,363,159,
10,"BUZAU",109,46019,,162,0,"CAMINUL CULTURAL ZARNESTI - SLANIC","CERNATESTI",22,46019,0,3,2094,1269,1108,161,1248,21,2300,1031,898,350,
10,"BUZAU",109,46019,,163,0,"SCOALA GENERALA ALDENI","CERNATESTI",22,46019,0,3,1146,702,612,90,695,7,1250,548,533,162,
10,"BUZAU",109,46108,,164,0,"CAMINUL CULTURAL CHILIILE","CHILIILE",23,46108,0,3,764,449,400,49,448,1,950,501,360,88,
10,"BUZAU",109,46180,,165,0,"SCOALA GENERALA CHIOJDU","CHIOJDU",24,46180,0,3,887,477,388,89,468,9,1000,523,367,101,
10,"BUZAU",109,46180,,166,0,"SCOALA GENERALA BISCA CHIOJDULUI","CHIOJDU",24,46180,0,3,1176,838,781,57,833,5,1300,462,662,171,
10,"BUZAU",109,46180,,167,0,"CAMINUL CULTURAL CATIASU","CHIOJDU",24,46180,0,3,409,318,285,33,315,3,450,132,277,38,
10,"BUZAU",109,46180,,168,0,"SCOALA GENERALA LERA","CHIOJDU",24,46180,0,3,413,325,263,62,319,6,450,125,227,92,
10,"BUZAU",109,46180,,169,0,"SCOALA GENERALA POENITELE","CHIOJDU",24,46180,0,3,330,224,199,25,218,6,350,126,166,52,
10,"BUZAU",109,46251,,170,0,"SCOALA GENERALA CILIBIA","CILIBIA",25,46251,0,3,1065,1063,994,69,1055,8,1200,137,976,79,
10,"BUZAU",109,46251,,171,0,"SCOALA GENERALA MOVILA OII","CILIBIA",25,46251,0,3,370,377,320,57,371,6,400,23,316,55,
10,"BUZAU",109,46313,,172,0,"SCOALA GENERALA CISLAU","CISLAU",26,46313,0,3,1950,1330,1086,244,1319,11,1950,620,1036,283,
10,"BUZAU",109,46313,,173,0,"SCOALA GENERALA SCARISOARA","CISLAU",26,46313,0,3,1057,942,797,145,905,37,1150,208,719,186,
10,"BUZAU",109,46313,,174,0,"SCOALA GENERALA BUDA-CRACIUNESTI","CISLAU",26,46313,0,3,680,545,465,80,537,8,750,205,400,137,
10,"BUZAU",109,46377,,175,0,"SCOALA GENERALA NR. 1 COCHIRLEANCA","COCHIRLEANCA",27,46377,0,3,1356,858,802,56,846,12,1600,742,605,241,
10,"BUZAU",109,46377,,176,0,"SCOALA GENERALA NR. 2 COCHIRLEANCA","COCHIRLEANCA",27,46377,0,3,775,522,433,89,518,4,1000,478,386,132,
10,"BUZAU",109,46377,,177,0,"SCOALA GENERALA BOBOC","COCHIRLEANCA",27,46377,0,3,1522,867,764,103,854,13,1700,833,621,233,
10,"BUZAU",109,46377,,178,0,"SCOALA GENERALA ROSIORU","COCHIRLEANCA",27,46377,0,3,603,440,375,65,432,8,650,210,311,121,
10,"BUZAU",109,46377,,179,1,"U.M. BOBOC","COCHIRLEANCA",27,46377,0,3,173,187,102,85,184,3,199,12,116,68,
10,"BUZAU",109,46439,,180,0,"SALA DE SEDINTE A PRIMARIEI COLTI","COLTI",28,46439,0,3,1145,710,668,42,706,4,1250,540,479,227,
10,"BUZAU",109,46484,,181,0,"SCOALA VECHE COSTESTI","COSTESTI",29,46484,0,3,1288,718,606,112,709,9,1450,732,537,172,
10,"BUZAU",109,46484,,182,0,"SCOALA CU CLASELE I-IV PIETROSU","COSTESTI",29,46484,0,3,994,664,511,153,654,10,1100,436,526,128,
10,"BUZAU",109,46484,,183,0,"SCOALA GENERALA SPATARU","COSTESTI",29,46484,0,3,933,532,399,133,530,2,1000,468,326,204,
10,"BUZAU",109,46484,,184,0,"SCOALA CU CLASELE I-IV BUDISTENI","COSTESTI",29,46484,0,3,483,307,263,44,301,6,550,243,235,66,
10,"BUZAU",109,46554,,185,0,"SCOALA GENERALA COZIENI","COZIENI",30,46554,0,3,622,353,300,53,349,4,700,347,238,111,
10,"BUZAU",109,46554,,186,0,"SCOALA GENERALA BALANESTI","COZIENI",30,46554,0,3,786,485,437,48,478,7,850,365,358,120,
10,"BUZAU",109,46554,,187,0,"SCOALA GENERALA PIETRARU","COZIENI",30,46554,0,3,339,208,172,36,205,3,400,152,153,52,
10,"BUZAU",109,46554,,188,0,"CAMINUL CULTURAL TRESTIA","COZIENI",30,46554,0,3,480,287,262,25,283,4,550,263,217,66,
10,"BUZAU",109,46769,,189,0,"CAMINUL CULTURAL TABARASTI","GALBINASI",31,46769,0,3,1406,751,625,126,742,9,1550,799,562,180,
10,"BUZAU",109,46769,,190,0,"SCOALA GENERALA GALBINASI","GALBINASI",31,46769,0,3,950,554,459,95,545,9,1000,446,392,153,
10,"BUZAU",109,46769,,191,0,"CAMINUL CULTURAL BENTU","GALBINASI",31,46769,0,3,771,485,409,76,483,2,750,265,332,151,
10,"BUZAU",109,46803,,192,0,"CAMINUL CULTURAL GHERASENI","GHERASENI",32,46803,0,3,2541,1350,1249,101,1328,22,2850,1500,807,521,
10,"BUZAU",109,46803,,193,0,"SCOALA CU CLASELE I-IV SUDITI","GHERASENI",32,46803,0,3,503,330,328,2,322,8,548,218,235,87,
10,"BUZAU",109,46830,,194,0,"SCOALA GENERALA GHERGHEASA","GHERGHEASA",33,46830,0,3,1267,867,785,82,848,19,1350,483,677,171,
10,"BUZAU",109,46830,,195,0,"SCOALA GENERALA SALCIOARA","GHERGHEASA",33,46830,0,3,1091,883,818,65,870,13,1200,317,639,231,
10,"BUZAU",109,46867,,196,0,"CAMINUL CULTURAL GLODEANU SARAT","GLODEANU SARAT",34,46867,0,3,2399,1249,1099,150,1222,27,2650,1401,928,294,
10,"BUZAU",109,46867,,197,0,"SCOALA GENERALA ILEANA","GLODEANU SARAT",34,46867,0,3,380,352,256,96,338,14,400,48,217,121,
10,"BUZAU",109,46867,,198,0,"SCOALA GENERALA PITULICEA","GLODEANU SARAT",34,46867,0,3,635,534,389,145,520,14,700,166,399,121,
10,"BUZAU",109,46867,,199,0,"SCOALA GENERALA CALDARUSANCA","GLODEANU SARAT",34,46867,0,3,461,423,316,107,413,10,500,77,329,84,
10,"BUZAU",109,46910,,200,0,"CAMINUL CULTURAL GLODEANU SILISTEA","GLODEANU-SILISTEA",35,46910,0,3,1575,830,770,60,805,25,1700,870,546,259,
10,"BUZAU",109,46910,,201,0,"CAMINUL CULTURAL COTORCA","GLODEANU-SILISTEA",35,46910,0,3,982,596,541,55,588,8,1100,504,470,118,
10,"BUZAU",109,46910,,202,0,"SCOALA CIRLIGU MARE","GLODEANU-SILISTEA",35,46910,0,3,478,320,221,99,310,10,550,230,247,63,
10,"BUZAU",109,46910,,203,0,"SCOALA VACAREASCA","GLODEANU-SILISTEA",35,46910,0,3,668,360,299,61,351,9,750,390,220,131,
10,"BUZAU",109,46910,,204,0,"SCOALA CASOTA","GLODEANU-SILISTEA",35,46910,0,3,393,235,190,45,228,7,450,215,154,74,
10,"BUZAU",109,47006,,205,0,"SCOALA PLEVNA","GREBANU",36,47006,0,3,1034,727,635,92,721,6,1150,423,546,175,
10,"BUZAU",109,47006,,206,0,"SCOALA GREBANU","GREBANU",36,47006,0,3,1713,862,734,128,844,18,1900,1038,647,197,
10,"BUZAU",109,47006,,207,0,"SCOALA HOMESTI","GREBANU",36,47006,0,3,742,471,351,120,457,14,800,329,361,96,
10,"BUZAU",109,47006,,208,0,"SCOALA LIVADA","GREBANU",36,47006,0,3,632,447,328,119,443,4,700,253,331,112,
10,"BUZAU",109,47079,,209,0,"SCOALA GENERALA PALTINIS","GURA TEGHII",37,47079,0,3,575,413,366,47,405,8,650,237,270,135,
10,"BUZAU",109,47079,,210,0,"GRADINITA DE COPII FURTUNESTI","GURA TEGHII",37,47079,0,3,801,608,577,31,603,5,850,242,439,164,
10,"BUZAU",109,47079,,211,0,"CAMINUL CULTURAL GURA TEGHII","GURA TEGHII",37,47079,0,3,1098,828,770,58,814,14,1200,372,555,259,
10,"BUZAU",109,47079,,212,0,"SCOALA GENERALA VARLAAM","GURA TEGHII",37,47079,0,3,518,431,380,51,430,1,600,169,283,147,
10,"BUZAU",109,47159,,213,0,"SALA DE SEDINTE A PRIMARIEI LARGU","LARGU",38,47159,0,3,1459,1086,963,123,1064,22,1600,514,805,259,
10,"BUZAU",109,47186,,214,0,"CAMINUL CULTURAL LOPATARI","LOPATARI",39,47186,0,3,1158,773,622,151,763,10,1250,477,574,189,
10,"BUZAU",109,47186,,215,0,"SCOALA LUNCILE","LOPATARI",39,47186,0,3,790,420,341,79,414,6,900,480,292,122,
10,"BUZAU",109,47186,,216,0,"SCOALA MALU-ROSU","LOPATARI",39,47186,0,3,1006,661,513,148,658,3,1100,439,540,118,
10,"BUZAU",109,47186,,217,0,"SCOALA PLAIU NUCULUI","LOPATARI",39,47186,0,3,699,407,331,76,403,4,750,343,325,78,
10,"BUZAU",109,47300,,218,0,"CAMINUL CULTURAL LUCIU","LUCIU",40,47300,0,3,1619,977,869,108,965,12,1750,773,793,172,
10,"BUZAU",109,47300,,219,0,"SCOALA CARAGELE","LUCIU",40,47300,0,3,756,490,417,73,482,8,850,360,350,132,
10,"BUZAU",109,47337,,220,0,"CAMINUL CULTURAL MAGURA","MAGURA",41,47337,0,3,1245,718,566,152,709,9,1350,632,509,200,
10,"BUZAU",109,47337,,221,0,"SCOALA GENERALA CIUTA","MAGURA",41,47337,0,3,531,400,333,67,393,7,600,200,309,84,
10,"BUZAU",109,47337,,222,0,"SCOALA GENERALA UNGURIU","MAGURA",41,47337,0,3,862,584,488,96,579,5,950,366,396,183,
10,"BUZAU",109,47337,,223,0,"SCOALA GENERALA UNGURIU","MAGURA",41,47337,0,3,932,623,560,63,616,7,1000,377,453,163,
10,"BUZAU",109,47373,,224,0,"SCOALA POTOCENI","MARACINENI",43,47373,0,3,1350,807,735,72,801,6,1500,693,619,182,
10,"BUZAU",109,47373,,225,0,"SCOALA CAPATINESTI","MARACINENI",43,47373,0,3,2100,1164,1022,142,1144,20,2250,1086,820,324,
10,"BUZAU",109,47373,,226,0,"SCOALA MARACINENI","MARACINENI",43,47373,0,3,1714,948,835,113,934,14,1900,952,664,270,
10,"BUZAU",109,47373,,227,1,"U.M. 01654","MARACINENI",43,47373,0,3,0,373,0,373,358,15,400,27,195,163,
10,"BUZAU",109,47417,,228,0,"PRIMARIA MARGARITESTI","MARGARITESTI",44,47417,0,3,813,469,425,44,462,7,900,431,334,128,
10,"BUZAU",109,47453,,229,0,"SCOALA GENERALA MEREI","MEREI",45,47453,0,3,1633,686,532,154,678,8,1800,1114,499,179,
10,"BUZAU",109,47453,,230,0,"SCOALA GENERALA LIPIA","MEREI",45,47453,0,3,1431,938,744,194,929,9,1550,612,766,163,
10,"BUZAU",109,47453,,231,0,"SCOALA GENERALA SARATA-MONTEORU","MEREI",45,47453,0,3,631,502,309,193,495,7,700,198,372,123,
10,"BUZAU",109,47453,,232,0,"SCOALA GENERALA IZVORU DULCE","MEREI",45,47453,0,3,997,566,389,177,562,4,1150,584,456,106,
10,"BUZAU",109,47453,,233,0,"SCOALA GENERALA DEALU VIEI","MEREI",45,47453,0,3,721,469,322,147,463,6,800,331,328,135,
10,"BUZAU",109,47578,,234,0,"SCOALA MIHAILESTI","MIHAILESTI",46,47578,0,3,1107,589,486,103,576,13,1200,611,412,164,
10,"BUZAU",109,47578,,235,0,"SCOALA MARGINEANU","MIHAILESTI",46,47578,0,3,568,371,300,71,361,10,600,229,282,79,
10,"BUZAU",109,47578,,236,0,"SCOALA FLORICA","MIHAILESTI",46,47578,0,3,1397,1221,1088,133,1191,30,1550,329,840,351,
10,"BUZAU",109,47630,,237,0,"SCOALA MINZALESTI","MANZALESTI",42,47630,0,3,756,446,395,51,443,3,843,397,293,150,
10,"BUZAU",109,47630,,238,0,"SCOALA BESLII","MANZALESTI",42,47630,0,3,800,499,435,64,493,6,900,401,341,152,
10,"BUZAU",109,47630,,239,0,"SCOALA  GURA BADICULUI","MANZALESTI",42,47630,0,3,776,440,360,80,432,8,850,410,282,150,
10,"BUZAU",109,47774,,240,0,"SCOALA MOVILA BANULUI","MOVILA BANULUI",47,47774,0,3,1210,684,585,99,672,12,1300,616,551,121,
10,"BUZAU",109,47774,,241,0,"SCOALA CIORANCA","MOVILA BANULUI",47,47774,0,3,200,159,88,71,154,5,250,91,112,42,
10,"BUZAU",109,47774,,242,0,"SCOALA LIMPEZIS","MOVILA BANULUI",47,47774,0,3,849,494,412,82,486,8,950,456,369,117,
10,"BUZAU",109,47818,,243,0,"SCOALA GENERALA MURGESTI","MURGESTI",48,47818,0,3,997,578,517,61,567,11,1100,522,353,214,
10,"BUZAU",109,47854,,244,0,"FOST SEDIU CAP NAENI","NAENI",49,47854,0,3,1053,1103,968,135,1094,9,1150,47,897,197,
10,"BUZAU",109,47854,,245,0,"SCOALA GENERALA FINTESTI","NAENI",49,47854,0,3,566,522,438,84,514,8,650,128,372,142,
10,"BUZAU",109,48021,,246,0,"SALA DE FESTIVITATI A PRIMARIEI ODAILE","ODAILE",50,48021,0,3,1007,676,609,67,671,5,1100,424,528,143,
10,"BUZAU",109,48138,,247,0,"SCOALA NR. 2 PADINA","PADINA",51,48138,0,3,1553,690,617,73,667,23,1700,1010,532,135,
10,"BUZAU",109,48138,,248,0,"CAMINUL CULTURAL PADINA","PADINA",51,48138,0,3,1212,560,511,49,546,14,1350,790,407,139,
10,"BUZAU",109,48138,,249,0,"SCOALA NR.1 PADINA","PADINA",51,48138,0,3,1353,637,572,65,627,10,1450,813,461,166,
10,"BUZAU",109,48165,,250,0,"SCOALA GENERALA PARDOSI","PARDOSI",53,48165,0,3,521,360,292,68,355,5,600,240,257,98,
10,"BUZAU",109,48227,,251,0,"SCOALA GENERALA PANATAU","PANATAU",52,48227,0,3,1690,997,931,66,979,18,1850,853,746,233,
10,"BUZAU",109,48227,,252,0,"SCOALA CU CLASELE I-IV TEGA","PANATAU",52,48227,0,3,723,385,343,42,384,1,800,415,306,78,
10,"BUZAU",109,48325,,253,0,"SCOALA PROFESIONALA PATIRLAGELE","PATARLAGELE",55,48325,0,3,1010,597,494,103,591,6,1100,503,422,169,
10,"BUZAU",109,48325,,254,0,"SCOALA PROFESIONALA PATIRLAGELE","PATARLAGELE",55,48325,0,3,1196,664,601,63,654,10,1300,636,510,144,
10,"BUZAU",109,48325,,255,0,"SCOALA CU CLASELE I-IV POIENILE","PATARLAGELE",55,48325,0,3,275,240,170,70,238,2,300,60,168,70,
10,"BUZAU",109,48325,,256,0,"SCOALA GENERALA MARUNTISU","PATARLAGELE",55,48325,0,3,1305,879,781,98,866,13,1450,571,651,215,
10,"BUZAU",109,48325,,257,0,"SCOALA CU CLASELE I-IV VALEA LUPULUI","PATARLAGELE",55,48325,0,3,406,311,277,34,309,2,450,139,214,95,
10,"BUZAU",109,48325,,258,0,"SCOALA CU CLASELE I-IV VALEA VIEI","PATARLAGELE",55,48325,0,3,438,310,264,46,307,3,500,190,209,98,
10,"BUZAU",109,48325,,259,0,"SCOALA CU CLASELE I-IV MANASTIREA","PATARLAGELE",55,48325,0,3,82,81,64,17,81,0,100,19,59,22,
10,"BUZAU",109,48325,,260,0,"SCOALA CU CLASELE I-IV CRING","PATARLAGELE",55,48325,0,3,458,319,278,41,315,4,500,181,221,94,
10,"BUZAU",109,48325,,261,0,"SCOALA GENERALA MUSCEL","PATARLAGELE",55,48325,0,3,691,416,385,31,413,3,750,334,306,107,
10,"BUZAU",109,48325,,262,0,"SCOALA GENERALA SIBICIU DE SUS","PATARLAGELE",55,48325,0,3,815,538,476,62,530,8,900,362,365,165,
10,"BUZAU",109,48325,,263,0,"SCOALA CU CLASELE I-IV VALEA SIBICIULUI","PATARLAGELE",55,48325,0,3,232,194,153,41,193,1,250,56,134,59,
10,"BUZAU",109,48487,,264,0,"CAMINUL CULTURAL PIETROASELE","PIETROASELE",56,48487,0,3,1523,926,766,160,918,8,1698,772,745,173,
10,"BUZAU",109,48487,,265,0,"GRADINITA DE COPII SARINGA","PIETROASELE",56,48487,0,3,1401,766,608,158,759,7,1600,834,543,216,
10,"BUZAU",109,48557,,266,0,"CAMINUL CULTURAL PIRSCOV","PARSCOV",54,48557,0,3,2539,1390,1124,266,1378,12,2750,1360,1043,335,
10,"BUZAU",109,48557,,267,0,"SCOALA GENERALA BADILA","PARSCOV",54,48557,0,3,566,410,310,100,405,5,650,240,305,100,
10,"BUZAU",109,48557,,268,0,"SCOALA GENERALA LUNCA FRUMOASA","PARSCOV",54,48557,0,3,1008,619,501,118,614,5,1100,481,491,123,
10,"BUZAU",109,48557,,269,0,"SCOALA GENERALA  ROBESTI","PARSCOV",54,48557,0,3,563,353,259,94,352,1,650,297,270,82,
10,"BUZAU",109,48557,,270,0,"MAGAZINUL TRESTIENI CONSUMCOOP PIRSCOV","PARSCOV",54,48557,0,3,91,76,33,43,76,0,100,24,52,24,
10,"BUZAU",109,48682,,271,0,"SCOALA PODGORIA","PODGORIA",57,48682,0,3,1193,677,560,117,668,9,1300,623,482,186,
10,"BUZAU",109,48682,,272,0,"SCOALA COTATCU","PODGORIA",57,48682,0,3,1098,714,617,97,696,18,1200,486,516,180,
10,"BUZAU",109,48682,,273,0,"SCOALA PLESESTI","PODGORIA",57,48682,0,3,393,256,176,80,252,4,450,194,153,99,
10,"BUZAU",109,48771,,274,0,"GRADINITA DE COPII POSTA CILNAU","POSTA CALNAU",58,48771,0,3,2159,1514,1392,122,1491,23,2350,836,1066,425,
10,"BUZAU",109,48771,,275,0,"SCOALA GENERALA ZILISTEANCA","POSTA CALNAU",58,48771,0,3,991,595,552,43,590,5,1100,505,456,134,
10,"BUZAU",109,48771,,276,0,"SCOALA GENERALA SUDITI","POSTA CALNAU",58,48771,0,3,1504,865,789,76,851,14,1650,785,610,241,
10,"BUZAU",109,48842,,277,0,"SCOALA PUIESTII DE JOS","PUIESTI",59,48842,0,3,1683,931,838,93,916,15,1850,919,689,227,
10,"BUZAU",109,48842,,278,0,"SCOALA NICOLESTI","PUIESTI",59,48842,0,3,1632,983,868,115,964,19,1800,817,721,243,
10,"BUZAU",109,48842,,279,0,"SCOALA MACRINA","PUIESTI",59,48842,0,3,647,441,392,49,432,9,700,259,357,75,
10,"BUZAU",109,48922,,280,0,"PRIMARIA RACOVITENI","RACOVITENI",60,48922,0,3,1281,691,611,80,682,9,1400,709,397,285,
10,"BUZAU",109,48968,,281,0,"SCOALA GENERALA NR. 1 RIMNICELU","RAMNICELU",61,48968,0,3,2065,969,865,104,948,21,2250,1281,698,250,
10,"BUZAU",109,48968,,282,0,"SCOALA GENERALA STIUBEI","RAMNICELU",61,48968,0,3,481,400,325,75,395,5,550,150,302,93,
10,"BUZAU",109,48968,,283,0,"SCOALA GENERALA COLIBASI","RAMNICELU",61,48968,0,3,407,328,253,75,322,6,450,122,258,64,
10,"BUZAU",109,49019,,284,0,"GRADINITA DE COPII ROBEASCA","ROBEASCA",62,49019,0,3,665,476,436,40,472,4,747,271,374,98,
10,"BUZAU",109,49019,,285,0,"SCOALA MOSESTI","ROBEASCA",62,49019,0,3,398,289,234,55,288,1,450,161,234,54,
10,"BUZAU",109,49046,,286,0,"SCOALA GENERALA RUSETU","RUSETU",63,49046,0,3,1454,848,777,71,838,10,1600,752,617,221,
10,"BUZAU",109,49046,,287,0,"DISPENSARUL MEDICAL RUSETU","RUSETU",63,49046,0,3,1106,820,758,62,809,11,1200,380,682,127,
10,"BUZAU",109,49046,,288,0,"CAMINUL CULTURAL RUSETU","RUSETU",63,49046,0,3,959,622,569,53,612,10,1050,428,476,136,
10,"BUZAU",109,49046,,289,0,"SCOALA GENERALA SG. IONEL STEFAN","RUSETU",63,49046,0,3,231,214,178,36,212,2,250,36,200,12,
10,"BUZAU",109,49073,,290,0,"SCOALA GENERALA SAGEATA","SAGEATA",64,49073,0,3,1659,1018,926,92,1009,9,1800,782,840,169,
10,"BUZAU",109,49073,,291,0,"SCOALA GENERALA DIMBROCA","SAGEATA",64,49073,0,3,967,728,646,82,720,8,1050,322,629,91,
10,"BUZAU",109,49073,,292,0,"SCOALA CU CLASELE I-IV BEILIC","SAGEATA",64,49073,0,3,368,277,242,35,270,7,450,173,195,75,
10,"BUZAU",109,49073,,293,0,"SEDIUL ADMINISTRATIV GAVANESTI","SAGEATA",64,49073,0,3,1028,645,573,72,635,10,1150,505,518,117,
10,"BUZAU",109,49073,,294,0,"SCOALA CU CLASELE I-IV BANITA","SAGEATA",64,49073,0,3,386,251,201,50,245,6,450,199,174,71,
10,"BUZAU",109,49153,,295,0,"CAMINUL CULTURAL SAHATENI","SAHATENI",65,49153,0,3,1561,861,799,62,846,15,1600,739,651,195,
10,"BUZAU",109,49153,,296,0,"SCOALA CLASELE I-IV GAGENI","SAHATENI",65,49153,0,3,350,267,191,76,264,3,400,133,201,63,
10,"BUZAU",109,49153,,297,0,"SCOALA GENERALA VINTILEANCA","SAHATENI",65,49153,0,3,796,522,453,69,512,10,900,378,381,131,
10,"BUZAU",109,49206,,298,0,"SCOALA GENERALA SAPOCA","SAPOCA",66,49206,0,3,1398,730,605,125,725,5,1500,770,535,190,
10,"BUZAU",109,49206,,299,0,"CAMINUL CULTURAL MATESTI","SAPOCA",66,49206,0,3,1088,671,538,133,660,11,1200,529,504,156,
10,"BUZAU",109,49206,,300,1,"SPITALUL INTERJUDETEAN DE NEUROPSIHIATRIE SAPOCA","SAPOCA",66,49206,0,3,0,113,0,113,113,0,150,37,94,19,
10,"BUZAU",109,49233,,301,0,"CAMINUL CULTURAL SARULESTI","SARULESTI",67,49233,0,3,1365,803,698,105,796,7,1500,697,571,225,
10,"BUZAU",109,49313,,302,0,"SALA DE FESTIVITATI A COM. SCORTOASA","SCORTOASA",68,49313,0,3,1328,827,684,143,817,10,1300,473,582,235,
10,"BUZAU",109,49313,,303,0,"SCOALA GENERALA PLOPEASA","SCORTOASA",68,49313,0,3,256,190,126,64,187,3,300,110,132,55,
10,"BUZAU",109,49313,,304,0,"SCOALA GENERALA BALTA TOCILA","SCORTOASA",68,49313,0,3,330,275,226,49,273,2,450,175,214,59,
10,"BUZAU",109,49313,,305,0,"SCOALA GENERALA GOLU GRABICINA","SCORTOASA",68,49313,0,3,365,267,186,81,256,11,350,83,201,55,
10,"BUZAU",109,49313,,306,0,"SCOALA GENERALA GRABICINA DE JOS","SCORTOASA",68,49313,0,3,294,284,242,42,281,3,350,66,240,41,
10,"BUZAU",109,49313,,307,0,"SCOALA GENERALA BECIU","SCORTOASA",68,49313,0,3,182,187,140,47,187,0,250,63,152,35,
10,"BUZAU",109,49439,,308,0,"CAMINUL CULTURAL SCUTELNICI","SCUTELNICI",69,49439,0,3,1125,726,581,145,709,17,1250,524,560,149,
10,"BUZAU",109,49439,,309,0,"SCOALA GENERALA ARCANU","SCUTELNICI",69,49439,0,3,382,313,248,65,309,4,450,137,249,60,
10,"BUZAU",109,49439,,310,0,"GRADINITA BRAGAREASA","SCUTELNICI",69,49439,0,3,617,461,368,93,454,7,650,189,341,113,
10,"BUZAU",109,49484,,311,0,"CAMINUL CULTURAL LUNCA JARISTEI","SIRIU",70,49484,0,3,1324,860,711,149,848,12,1400,540,494,354,
10,"BUZAU",109,49484,,312,0,"SCOALA GENERALA NR. 1 COLTU PIETRII","SIRIU",70,49484,0,3,962,704,653,51,694,10,1100,396,382,312,
10,"BUZAU",109,49545,,313,0,"SCOALA VECHE SMEENI","SMEENI",71,49545,0,3,2401,1143,954,189,1132,11,2650,1507,841,291,
10,"BUZAU",109,49545,,314,0,"SCOALA GENERALA SALCIOARA","SMEENI",71,49545,0,3,802,530,425,105,527,3,850,320,413,114,
10,"BUZAU",109,49545,,315,0,"SCOALA GENERALA ALBESTI","SMEENI",71,49545,0,3,719,577,411,166,566,11,750,173,459,107,
10,"BUZAU",109,49545,,316,0,"SCOALA GENERALA UDATI","SMEENI",71,49545,0,3,794,539,404,135,528,11,900,361,427,101,
10,"BUZAU",109,49545,,317,0,"SCOALA GENERALA CALTUNA","SMEENI",71,49545,0,3,682,412,297,115,402,10,800,388,311,91,
10,"BUZAU",109,49545,,318,0,"SCOALA GENERALA BALAIA","SMEENI",71,49545,0,3,140,140,99,41,139,1,150,10,106,33,
10,"BUZAU",109,49625,,319,0,"SCOALA  GENERALA STIPLU","STALPU",72,49625,0,3,1346,669,614,55,661,8,1450,781,473,188,
10,"BUZAU",109,49625,,320,0,"PRIMARIA COMUNEI STILPU","STALPU",72,49625,0,3,1107,583,535,48,579,4,1200,617,413,166,
10,"BUZAU",109,49643,,321,0,"CAMINUL CULTURAL GRAJDANA","TISAU",74,49643,0,3,1527,758,640,118,747,11,1700,942,481,266,
10,"BUZAU",109,49643,,322,0,"GRADINITA DE COPII HALES","TISAU",74,49643,0,3,1263,638,440,198,624,14,1400,762,431,193,
10,"BUZAU",109,49643,,323,0,"SCOALA GENERALA TISAU","TISAU",74,49643,0,3,1258,624,528,96,613,11,1400,776,403,210,
10,"BUZAU",109,49769,,324,0,"SCOALA GENERALA TOPLICENI","TOPLICENI",75,49769,0,3,1654,835,712,123,826,9,1800,965,580,246,
10,"BUZAU",109,49769,,325,0,"SCOALA GENERALA BABENI","TOPLICENI",75,49769,0,3,940,568,437,131,560,8,900,332,411,149,
10,"BUZAU",109,49769,,326,0,"SCOALA GENERALA DEDULESTI","TOPLICENI",75,49769,0,3,915,657,515,142,647,10,1000,343,434,213,
10,"BUZAU",109,49849,,327,0,"SALA DE FESTIVITATI A PRIMARIEI TINTESTI","TINTESTI",73,49849,0,3,1431,980,828,152,966,14,1850,870,782,184,
10,"BUZAU",109,49849,,328,0,"SALA DE FESTIVITATI DIN CLADIREA SPATIULUI DE UTILITATE PUBLICA MAXENU","TINTESTI",73,49849,0,3,1330,1000,711,289,984,16,1950,950,785,199,
10,"BUZAU",109,49894,,329,0,"SCOALA GENERALA ULMENI","ULMENI",76,49894,0,3,1236,685,590,95,676,9,1350,665,494,182,
10,"BUZAU",109,49894,,330,0,"FOSTUL SFAT POPULAR CLONDIRU","ULMENI",76,49894,0,3,1417,797,666,131,780,17,1399,602,575,205,
10,"BUZAU",109,49956,,331,0,"SCOALA GENERALA VADU PASII","VADU PASII",77,49956,0,3,2500,1292,1103,189,1275,17,2500,1208,939,336,
10,"BUZAU",109,49956,,332,0,"SCOALA GENERALA FOCSANEI","VADU PASII",77,49956,0,3,1199,696,546,150,687,9,1300,604,492,195,
10,"BUZAU",109,49956,,333,0,"SCOALA GENERALA SCURTESTI","VADU PASII",77,49956,0,3,2087,1038,887,151,1027,11,2300,1262,851,176,
10,"BUZAU",109,49956,,334,0,"CAMINUL CULTURAL STANCESTIW","VADU PASII",77,49956,0,3,1109,688,568,120,675,13,1250,562,521,154,
10,"BUZAU",109,50022,,335,0,"SCOALA GENERALA VALEA RIMNICULUI","VALEA RAMNICULUI",79,50022,0,3,1623,932,818,114,925,7,1800,868,656,269,
10,"BUZAU",109,50022,,336,0,"SCOALA GENERALA OREAVU","VALEA RAMNICULUI",79,50022,0,3,1877,1134,997,137,1125,9,2000,866,841,284,
10,"BUZAU",109,50022,,337,0,"SCOALA GENERALA RUBLA","VALEA RAMNICULUI",79,50022,0,3,1007,696,617,79,685,11,1100,404,426,259,
10,"BUZAU",109,50068,,338,0,"CAMINUL CULTURAL MODRENI","VALEA SALCIEI",80,50068,0,3,792,552,519,33,543,9,947,395,373,170,
10,"BUZAU",109,50102,,339,0,"SCOALA VERNESTI","VERNESTI",81,50102,0,3,1800,839,674,165,821,18,1800,961,573,248,
10,"BUZAU",109,50102,,340,0,"SCOALA CINDESTI","VERNESTI",81,50102,0,3,1903,1248,945,303,1229,19,2200,952,1028,201,
10,"BUZAU",109,50102,,341,0,"SCOALA NISCOV","VERNESTI",81,50102,0,3,1487,678,486,192,671,7,1750,1072,465,206,
10,"BUZAU",109,50102,,342,0,"SCOALA ZORESTI","VERNESTI",81,50102,0,3,1002,579,432,147,566,13,1150,571,433,133,
10,"BUZAU",109,50102,,343,1,"U.M. 01910 MIEREA","VERNESTI",81,50102,0,3,0,93,0,93,91,2,100,7,55,36,
10,"BUZAU",109,50228,,344,0,"SCOALA GENERALA VINTILA VODA","VINTILA VODA",82,50228,0,3,1382,797,683,114,791,6,1500,703,585,206,
10,"BUZAU",109,50228,,345,0,"SCOALA GENERALA NICULESTI","VINTILA VODA",82,50228,0,3,994,589,468,121,585,4,1150,561,418,167,
10,"BUZAU",109,50228,,346,0,"SCOALA GENERALA COCA-ANTIMIRESTI","VINTILA VODA",82,50228,0,3,277,179,135,44,175,4,350,171,78,97,
10,"BUZAU",109,50326,,347,0,"COMPLEX COMERCIAL SAT VIPERESTI","VIPERESTI",83,50326,0,3,1492,913,776,137,904,9,1600,687,722,182,
10,"BUZAU",109,50326,,348,0,"SCOALA GIMNAZIALA URSOAIA","VIPERESTI",83,50326,0,3,994,614,504,110,608,6,1100,486,483,125,
10,"BUZAU",109,50326,,349,0,"SCOALA PRIMARA MUSCEL","VIPERESTI",83,50326,0,3,208,163,116,47,162,1,250,87,128,34,
10,"BUZAU",109,50399,,350,0,"CAMINUL CULTURAL VILCELELE","VALCELELE",78,50399,0,3,1580,1029,929,100,1014,15,1594,565,721,293,
10,"BUZAU",109,50415,,351,0,"SCOALA GENERALA FUNDENI","ZARNESTI",84,50415,0,3,1799,932,815,117,915,17,1950,1018,618,297,
10,"BUZAU",109,50415,,352,0,"GRADINITA PRUNENI","ZARNESTI",84,50415,0,3,398,266,219,47,259,7,400,134,187,72,
10,"BUZAU",109,50415,,353,0,"SCOALA GENERALA VADU-SORESTI","ZARNESTI",84,50415,0,3,1132,666,580,86,653,13,1300,634,487,166,
10,"BUZAU",109,50415,,354,0,"SCOALA GENERALA ZARNESTI","ZARNESTI",84,50415,0,3,1100,574,502,72,561,13,1250,676,394,167,
10,"BUZAU",109,50479,,355,0,"SALA DE SEDINTE A PRIMARIEI ZIDURI","ZIDURI",85,50479,0,3,747,641,558,83,636,5,850,209,441,195,
10,"BUZAU",109,50479,,356,0,"CAMINUL CULTURAL LANURILE","ZIDURI",85,50479,0,3,700,586,507,79,581,5,750,164,471,110,
10,"BUZAU",109,50479,,357,0,"SCOALA HELIADE RADULESCU","ZIDURI",85,50479,0,3,886,655,578,77,638,17,950,295,481,157,
10,"BUZAU",109,50479,,358,0,"SCOALA COSTIENI","ZIDURI",85,50479,0,3,473,509,473,36,502,7,800,291,353,149,
10,"BUZAU",109,50479,,359,0,"CAMINUL CULTURAL ZOITA","ZIDURI",85,50479,0,3,843,600,512,88,589,11,950,350,410,179,
11,"CARAS-SEVERIN",118,50790,,1,0,"SCOALA CUPTOARE","MUNICIPIUL RESITA",1,50790,1,1,270,196,147,49,187,9,300,104,111,76,
11,"CARAS-SEVERIN",118,50790,,2,0,"SCOALA SECU","MUNICIPIUL RESITA",1,50790,1,1,418,254,203,51,250,4,500,246,108,142,
11,"CARAS-SEVERIN",118,50790,,3,0,"STR. SODOL NR 10/A","MUNICIPIUL RESITA",1,50790,1,1,1104,493,459,34,485,8,1200,707,271,214,
11,"CARAS-SEVERIN",118,50790,,4,0,"STR. CIRESULUI NR 75","MUNICIPIUL RESITA",1,50790,1,1,579,286,243,43,284,1,700,414,169,115,
11,"CARAS-SEVERIN",118,50790,,5,0,"STR. ZIMBRULUI NR 46","MUNICIPIUL RESITA",1,50790,1,1,967,480,422,58,467,13,1100,620,286,181,
11,"CARAS-SEVERIN",118,50790,,6,0,"STR. CASTANILOR NR 68","MUNICIPIUL RESITA",1,50790,1,1,658,316,271,45,313,3,800,484,202,111,
11,"CARAS-SEVERIN",118,50790,,7,0,"STR. CASTANILOR NR 68","MUNICIPIUL RESITA",1,50790,1,1,1060,496,445,51,489,7,1200,704,305,184,
11,"CARAS-SEVERIN",118,50790,,8,0,"P-TA REPUBLICII NR 44","MUNICIPIUL RESITA",1,50790,1,1,1368,610,553,57,601,9,1500,890,398,203,
11,"CARAS-SEVERIN",118,50790,,9,0,"STR. S. MANGIUCA NR 1","MUNICIPIUL RESITA",1,50790,1,1,1365,612,550,62,596,16,1500,888,344,252,
11,"CARAS-SEVERIN",118,50790,,10,0,"P-TA REPUBLICII NR 17","MUNICIPIUL RESITA",1,50790,1,1,1014,453,399,54,444,9,1100,647,267,177,
11,"CARAS-SEVERIN",118,50790,,11,0,"STR. ROMANILOR NR 2","MUNICIPIUL RESITA",1,50790,1,1,995,491,439,52,482,9,1100,609,338,144,
11,"CARAS-SEVERIN",118,50790,,12,0,"STR. ROMANILOR NR 2","MUNICIPIUL RESITA",1,50790,1,1,1284,654,601,53,647,7,1400,746,431,216,
11,"CARAS-SEVERIN",118,50790,,13,0,"STR. ROMANILOR NR 2","MUNICIPIUL RESITA",1,50790,1,1,1168,568,532,36,558,10,1300,732,376,182,
11,"CARAS-SEVERIN",118,50790,,14,0,"STR. MOCIUR NR 4","MUNICIPIUL RESITA",1,50790,1,1,535,341,231,110,338,3,600,259,175,163,
11,"CARAS-SEVERIN",118,50790,,15,0,"P-TA 1 DECEMBRIE 1918 NR 6","MUNICIPIUL RESITA",1,50790,1,1,1010,564,495,69,556,8,1100,536,369,187,
11,"CARAS-SEVERIN",118,50790,,16,0,"P-TA 1 DECEMBRIE 1918 NR 6","MUNICIPIUL RESITA",1,50790,1,1,1463,776,714,62,756,20,1600,824,520,236,
11,"CARAS-SEVERIN",118,50790,,17,0,"P-TA 1 DECEMBRIE 1918 NR 6","MUNICIPIUL RESITA",1,50790,1,1,1222,560,484,76,549,11,1300,740,311,238,
11,"CARAS-SEVERIN",118,50790,,18,0,"SCOALA DOMAN","MUNICIPIUL RESITA",1,50790,1,1,590,392,301,91,387,5,700,308,190,197,
11,"CARAS-SEVERIN",118,50790,,19,0,"STR. 24 IANUARIE NR 1","MUNICIPIUL RESITA",1,50790,1,1,1050,551,458,93,543,8,1200,649,375,168,
11,"CARAS-SEVERIN",118,50790,,20,0,"P-TA ""TRAIAN VUIA"" NR 1-4","MUNICIPIUL RESITA",1,50790,1,1,654,434,342,92,429,5,700,266,318,111,
11,"CARAS-SEVERIN",118,50790,,21,0,"P-TA TRAIAN VUIA NR 1-4","MUNICIPIUL RESITA",1,50790,1,1,1311,686,642,44,670,16,1502,816,481,189,
11,"CARAS-SEVERIN",118,50790,,22,0,"STR. AL I CUZA NR 17/A","MUNICIPIUL RESITA",1,50790,1,1,1322,673,625,48,660,13,1500,827,427,233,
11,"CARAS-SEVERIN",118,50790,,23,0,"B-DUL AL I CUZA NR 17/A","MUNICIPIUL RESITA",1,50790,1,1,1007,524,472,52,514,10,1100,576,260,254,
11,"CARAS-SEVERIN",118,50790,,24,0,"B-DUL AL I CUZA NR 19","MUNICIPIUL RESITA",1,50790,1,1,1500,690,649,41,684,6,1700,1010,421,263,
11,"CARAS-SEVERIN",118,50790,,25,0,"B-DUL AL I CUZA NR 19","MUNICIPIUL RESITA",1,50790,1,1,869,501,458,43,490,11,1000,499,341,149,
11,"CARAS-SEVERIN",118,50790,,26,0,"STR. GRATZ NR 10","MUNICIPIUL RESITA",1,50790,1,1,1076,621,584,37,611,10,1200,579,456,155,
11,"CARAS-SEVERIN",118,50790,,27,0,"STR. GRATZ NR 10","MUNICIPIUL RESITA",1,50790,1,1,936,465,430,35,459,6,1000,535,303,156,
11,"CARAS-SEVERIN",118,50790,,28,0,"STR. GRATZ NR 10","MUNICIPIUL RESITA",1,50790,1,1,1120,603,524,79,598,5,1207,604,419,179,
11,"CARAS-SEVERIN",118,50790,,29,0,"B-DUL AL I CUZA NR 39","MUNICIPIUL RESITA",1,50790,1,1,1357,658,607,51,647,11,1500,842,388,259,
11,"CARAS-SEVERIN",118,50790,,30,0,"B-DUL AL I CUZA NR 39","MUNICIPIUL RESITA",1,50790,1,1,756,395,364,31,391,4,803,408,257,134,
11,"CARAS-SEVERIN",118,50790,,31,0,"B-DUL AL I CUZA NR 39","MUNICIPIUL RESITA",1,50790,1,1,1189,552,519,33,542,10,1300,748,338,204,
11,"CARAS-SEVERIN",118,50790,,32,0,"STR. C PORUMBESCU NR 17","MUNICIPIUL RESITA",1,50790,1,1,721,361,282,79,350,11,801,440,215,135,
11,"CARAS-SEVERIN",118,50790,,33,0,"CALEA TIMISORII NR 12","MUNICIPIUL RESITA",1,50790,1,1,1141,588,419,169,586,2,1196,608,253,333,
11,"CARAS-SEVERIN",118,50790,,34,0,"SCOALA TEROVA","MUNICIPIUL RESITA",1,50790,1,1,387,219,162,57,217,2,400,181,118,99,
11,"CARAS-SEVERIN",118,50790,,35,0,"CALEA CARANSEBESULUI NR 16","MUNICIPIUL RESITA",1,50790,1,1,1581,1157,541,616,1145,12,1700,543,463,682,
11,"CARAS-SEVERIN",118,50790,,36,0,"CALEA CARANSEBESULUI NR 16","MUNICIPIUL RESITA",1,50790,1,1,1399,659,570,89,651,8,1500,841,325,326,
11,"CARAS-SEVERIN",118,50790,,37,0,"CALEA CARANSEBESULUI NR 4","MUNICIPIUL RESITA",1,50790,1,1,1739,886,752,134,874,12,1900,1014,483,391,
11,"CARAS-SEVERIN",118,50790,,38,0,"AL. BAZNA NR 2","MUNICIPIUL RESITA",1,50790,1,1,1355,691,636,55,680,11,1500,809,400,280,
11,"CARAS-SEVERIN",118,50790,,39,0,"AL. BAZNA NR 2","MUNICIPIUL RESITA",1,50790,1,1,1288,629,594,35,622,7,1402,773,362,260,
11,"CARAS-SEVERIN",118,50790,,40,0,"STR. FAGARASULUI NR 8","MUNICIPIUL RESITA",1,50790,1,1,1242,614,556,58,606,8,1400,786,334,272,
11,"CARAS-SEVERIN",118,50790,,41,0,"STR. FAGARASULUI NR 8","MUNICIPIUL RESITA",1,50790,1,1,1147,549,526,23,536,13,1300,751,306,230,
11,"CARAS-SEVERIN",118,50790,,42,0,"STR. FAGARASULUI NR 12","MUNICIPIUL RESITA",1,50790,1,1,1326,629,587,42,620,9,1500,871,404,216,
11,"CARAS-SEVERIN",118,50790,,43,0,"STR. FAGARASULUI NR 12","MUNICIPIUL RESITA",1,50790,1,1,1112,515,474,41,512,3,1200,685,310,202,
11,"CARAS-SEVERIN",118,50790,,44,0,"CALEA CARANSEBESULUI NR 2","MUNICIPIUL RESITA",1,50790,1,1,1358,692,650,42,687,5,1500,808,449,238,
11,"CARAS-SEVERIN",118,50790,,45,0,"CALEA CARANSEBESULUI NR 2","MUNICIPIUL RESITA",1,50790,1,1,1288,634,581,53,626,8,1400,766,396,230,
11,"CARAS-SEVERIN",118,50790,,46,0,"AL. GALATI NR 6","MUNICIPIUL RESITA",1,50790,1,1,1596,791,750,41,772,19,1802,1011,465,307,
11,"CARAS-SEVERIN",118,50790,,47,0,"AL. GALATI NR 6","MUNICIPIUL RESITA",1,50790,1,1,1263,705,636,69,694,11,1400,695,388,306,
11,"CARAS-SEVERIN",118,50790,,48,0,"STR. PROGRESULUI NR 2","MUNICIPIUL RESITA",1,50790,1,1,1283,674,625,49,664,10,1400,726,424,240,
11,"CARAS-SEVERIN",118,50790,,49,0,"STR. PROGREULUI NR 2","MUNICIPIUL RESITA",1,50790,1,1,1009,514,467,47,508,6,1100,586,300,208,
11,"CARAS-SEVERIN",118,50790,,50,0,"AL. DACIA 2","MUNICIPIUL RESITA",1,50790,1,1,1498,755,707,48,745,10,1600,845,420,325,
11,"CARAS-SEVERIN",118,50790,,51,0,"AL. DACIA 2","MUNICIPIUL RESITA",1,50790,1,1,1311,668,619,49,662,6,1400,732,384,278,
11,"CARAS-SEVERIN",118,50790,,52,0,"AL. DACIA 2","MUNICIPIUL RESITA",1,50790,1,1,1669,796,726,70,782,14,1802,1006,465,317,
11,"CARAS-SEVERIN",118,50790,,53,0,"AL. MARGHITAS 5A","MUNICIPIUL RESITA",1,50790,1,1,1201,594,549,45,586,8,1300,706,310,276,
11,"CARAS-SEVERIN",118,50790,,54,0,"AL. MARGHITAS NR 5","MUNICIPIUL RESITA",1,50790,1,1,1287,635,574,61,630,5,1400,765,334,296,
11,"CARAS-SEVERIN",118,50790,,55,0,"AL. MARGHITAS NR 5","MUNICIPIUL RESITA",1,50790,1,1,1642,717,676,41,706,11,1800,1083,378,328,
11,"CARAS-SEVERIN",118,50790,,56,0,"AL. MARGHITAS NR 5","MUNICIPIUL RESITA",1,50790,1,1,1410,689,647,42,676,13,1501,812,383,293,
11,"CARAS-SEVERIN",118,50790,,57,0,"AL. MARGHITAS NR 5","MUNICIPIUL RESITA",1,50790,1,1,1656,750,707,43,733,17,1801,1051,388,345,
11,"CARAS-SEVERIN",118,50790,,58,0,"AL. HERCULANE NR 3","MUNICIPIUL RESITA",1,50790,1,1,1115,448,418,30,440,8,1200,752,239,201,
11,"CARAS-SEVERIN",118,50790,,59,0,"AL. HERCULANE NR 3","MUNICIPIUL RESITA",1,50790,1,1,1433,666,628,38,659,7,1600,934,347,312,
11,"CARAS-SEVERIN",118,50790,,60,0,"AL. HERCULANE NR 3","MUNICIPIUL RESITA",1,50790,1,1,1608,767,718,49,756,11,1800,1033,442,314,
11,"CARAS-SEVERIN",118,50790,,61,0,"AL. HERCULANE NR 3","MUNICIPIUL RESITA",1,50790,1,1,1314,572,548,24,563,9,1500,928,338,225,
11,"CARAS-SEVERIN",118,50790,,62,0,"AL. MACINULUI NR 3","MUNICIPIUL RESITA",1,50790,1,1,1384,658,614,44,645,13,1500,842,384,261,
11,"CARAS-SEVERIN",118,50790,,63,0,"AL. MACINULUI NR 3","MUNICIPIUL RESITA",1,50790,1,1,1550,766,704,62,761,5,1700,934,426,335,
11,"CARAS-SEVERIN",118,50790,,64,0,"AL. MACINULUI NR 3","MUNICIPIUL RESITA",1,50790,1,1,1374,604,557,47,598,6,1500,896,302,296,
11,"CARAS-SEVERIN",118,50790,,65,0,"AL. MACINULUI NR 3","MUNICIPIUL RESITA",1,50790,1,1,1127,523,490,33,517,6,1200,677,283,234,
11,"CARAS-SEVERIN",118,50790,,66,0,"SCOALA CILNIC","MUNICIPIUL RESITA",1,50790,1,1,1302,602,533,69,589,13,1400,798,315,274,
11,"CARAS-SEVERIN",118,50790,,67,0,"SCOALA MONIOM","MUNICIPIUL RESITA",1,50790,1,1,257,203,153,50,201,2,300,97,87,114,
11,"CARAS-SEVERIN",118,50790,,68,1,"AL. HERCULANE NR 8","MUNICIPIUL RESITA",1,50790,1,1,0,220,0,220,215,5,500,280,133,82,
11,"CARAS-SEVERIN",118,50790,,69,1,"STR. SPITALULUI NR 16","MUNICIPIUL RESITA",1,50790,1,1,0,144,0,144,144,0,250,106,94,50,
11,"CARAS-SEVERIN",118,50790,,70,1,"STR. CRISAN NR 5","MUNICIPIUL RESITA",1,50790,1,1,0,103,0,103,102,1,250,147,46,56,
11,"CARAS-SEVERIN",118,50790,,71,1,"STR. SODOL NR 14","MUNICIPIUL RESITA",1,50790,1,1,0,139,0,139,138,1,250,111,88,50,
11,"CARAS-SEVERIN",118,50790,,72,1,"BD. AL I CUZA NR 39","MUNICIPIUL RESITA",1,50790,1,1,0,370,0,370,354,16,450,80,188,166,
11,"CARAS-SEVERIN",118,51010,,73,0,"STR. N. BALCESCU NR 113","MUNICIPIUL CARANSEBES",2,51010,1,1,1053,618,436,182,609,9,1150,532,279,330,
11,"CARAS-SEVERIN",118,51010,,74,0,"STR. GODENULUI NR 3","MUNICIPIUL CARANSEBES",2,51010,1,1,453,210,188,22,206,4,500,290,105,101,
11,"CARAS-SEVERIN",118,51010,,75,0,"P-TA G.I.DRAGALINA NR 2","MUNICIPIUL CARANSEBES",2,51010,1,1,1636,790,723,67,780,10,1800,1010,531,249,
11,"CARAS-SEVERIN",118,51010,,76,0,"STR. RACOVITA NR 1","MUNICIPIUL CARANSEBES",2,51010,1,1,1853,932,868,64,922,10,2000,1068,553,369,
11,"CARAS-SEVERIN",118,51010,,77,0,"STR. LIBERTATII NR 21","MUNICIPIUL CARANSEBES",2,51010,1,1,1152,582,510,72,575,7,1250,668,400,175,
11,"CARAS-SEVERIN",118,51010,,78,0,"STR. MIHAI VITEAZUL NR 6","MUNICIPIUL CARANSEBES",2,51010,1,1,960,537,457,80,521,16,1050,513,339,182,
11,"CARAS-SEVERIN",118,51010,,79,0,"STR. MUNTELE MIC NR 1","MUNICIPIUL CARANSEBES",2,51010,1,1,1824,921,750,171,906,15,2000,1079,590,316,
11,"CARAS-SEVERIN",118,51010,,80,0,"AL. ALUNISULUI NR 1 (CARTIER TIGLARIE NORD)","MUNICIPIUL CARANSEBES",2,51010,1,1,1241,598,538,60,583,15,1350,752,336,247,
11,"CARAS-SEVERIN",118,51010,,81,0,"AL. ALUNISULUI NR 1 (CARTIER TIGLARIE NORD)","MUNICIPIUL CARANSEBES",2,51010,1,1,1956,983,781,202,977,6,2200,1217,483,494,
11,"CARAS-SEVERIN",118,51010,,82,0,"AL. GRADINITEI NR 1 (CARTIER TIGLARIE NORD)","MUNICIPIUL CARANSEBES",2,51010,1,1,1604,754,714,40,743,11,1750,996,380,363,
11,"CARAS-SEVERIN",118,51010,,83,0,"STR. ARDEALULUI NR 138 (CARTIER INTRARE NORD)","MUNICIPIUL CARANSEBES",2,51010,1,1,2791,1241,1165,76,1217,24,3000,1759,627,590,
11,"CARAS-SEVERIN",118,51010,,84,0,"STR. ARDEALULUI NR 166, CORP A","MUNICIPIUL CARANSEBES",2,51010,1,1,2002,871,792,79,866,5,2200,1329,415,451,
11,"CARAS-SEVERIN",118,51010,,85,0,"STR. ARDEALULUI NR 166, CORP B","MUNICIPIUL CARANSEBES",2,51010,1,1,1532,943,658,285,933,10,1700,757,470,463,
11,"CARAS-SEVERIN",118,51010,,86,0,"STR. C. D. LOGA NR 12","MUNICIPIUL CARANSEBES",2,51010,1,1,1878,800,708,92,777,23,2000,1200,457,320,
11,"CARAS-SEVERIN",118,51010,,87,0,"C. CARANSEBESULUI NR 48","MUNICIPIUL CARANSEBES",2,51010,1,1,1204,546,487,59,534,12,1300,754,317,217,
11,"CARAS-SEVERIN",118,51010,,88,0,"C. SEVERINULUI 143 CARTIER BALTA SARATA","MUNICIPIUL CARANSEBES",2,51010,1,1,1625,925,803,122,913,12,1800,875,467,446,
11,"CARAS-SEVERIN",118,51010,,89,0,"CAMIN CULTURAL SAT JUPA","MUNICIPIUL CARANSEBES",2,51010,1,1,423,270,208,62,267,3,450,180,150,117,
11,"CARAS-SEVERIN",118,51010,,90,1,"GARNIZOANE CARANSEBES","MUNICIPIUL CARANSEBES",2,51010,1,1,0,280,0,280,269,11,350,70,107,162,
11,"CARAS-SEVERIN",118,50889,,91,0,"CLUBUL ANINA","ORAS ANINA",3,50889,2,1,1295,798,739,59,793,5,1400,602,585,208,
11,"CARAS-SEVERIN",118,50889,,92,0,"SCOALA PROFESIONALA","ORAS ANINA",3,50889,2,1,1052,558,475,83,550,8,1100,542,348,202,
11,"CARAS-SEVERIN",118,50889,,93,0,"GRADINITA CELNIC","ORAS ANINA",3,50889,2,1,665,368,305,63,358,10,700,332,182,176,
11,"CARAS-SEVERIN",118,50889,,94,0,"SEDIUL SC ""GOSTRANS"" SA","ORAS ANINA",3,50889,2,1,604,355,296,59,354,1,700,345,194,160,
11,"CARAS-SEVERIN",118,50889,,95,0,"GRADINITA ORASUL NOU","ORAS ANINA",3,50889,2,1,529,277,194,83,275,2,600,323,144,131,
11,"CARAS-SEVERIN",118,50889,,96,0,"CASA COPIILOR SI ELEVILOR","ORAS ANINA",3,50889,2,1,1049,548,465,83,535,13,1200,652,296,239,
11,"CARAS-SEVERIN",118,50889,,97,0,"GRADINITA CARTIER SIGISMUND","ORAS ANINA",3,50889,2,1,584,310,262,48,307,3,700,390,182,125,
11,"CARAS-SEVERIN",118,50889,,98,0,"CLUBUL STEIERDORT","ORAS ANINA",3,50889,2,1,1104,623,519,104,614,9,1200,577,383,231,
11,"CARAS-SEVERIN",118,50889,,99,0,"SEDIUL CARITAS","ORAS ANINA",3,50889,2,1,550,344,246,98,340,4,600,256,191,149,
11,"CARAS-SEVERIN",118,50889,,100,0,"SCOALA GENERALA BRADET","ORAS ANINA",3,50889,2,1,364,200,152,48,197,3,400,200,146,51,
11,"CARAS-SEVERIN",118,50889,,101,1,"UNITATEA MILITARA CERESNAIA","ORAS ANINA",3,50889,2,1,0,19,0,19,19,0,50,31,8,11,
11,"CARAS-SEVERIN",118,50923,,102,0,"STR. CERNEI NR 6","ORAS BAILE HERCULANE",4,50923,2,1,474,566,222,344,560,6,700,134,341,219,
11,"CARAS-SEVERIN",118,50923,,103,0,"STR. CASTANILOR NR 17","ORAS BAILE HERCULANE",4,50923,2,1,1274,1011,524,487,995,16,1400,389,613,382,
11,"CARAS-SEVERIN",118,50923,,104,0,"STR. TRANDAFIRILOR NR 36","ORAS BAILE HERCULANE",4,50923,2,1,2476,1295,1099,196,1273,22,2600,1305,748,525,
11,"CARAS-SEVERIN",118,50923,,105,0,"CAMIN CULTURAL STR. PECINISCA","ORAS BAILE HERCULANE",4,50923,2,1,548,330,282,48,325,5,600,270,196,129,
11,"CARAS-SEVERIN",118,50969,,106,0,"STR. 1 DEC 1918 NR 12","ORAS BOCSA",5,50969,2,1,1312,614,587,27,596,18,1400,786,381,215,
11,"CARAS-SEVERIN",118,50969,,107,0,"STR. SEREI NR 2","ORAS BOCSA",5,50969,2,1,1276,638,592,46,629,9,1400,762,328,301,
11,"CARAS-SEVERIN",118,50969,,108,0,"STR. MAGURA NR 45","ORAS BOCSA",5,50969,2,1,1159,615,591,24,610,5,1300,685,409,201,
11,"CARAS-SEVERIN",118,50969,,109,0,"STR. TATA OANCEA NR 4","ORAS BOCSA",5,50969,2,1,1200,616,582,34,604,12,1300,684,418,186,
11,"CARAS-SEVERIN",118,50969,,110,0,"LICEUL TEORETIC STR. T. VLADIMIRESCU","ORAS BOCSA",5,50969,2,1,868,468,403,65,462,6,950,482,288,174,
11,"CARAS-SEVERIN",118,50969,,111,0,"STR. TINERETULUI NR 1","ORAS BOCSA",5,50969,2,1,1293,647,581,66,637,10,1400,753,314,323,
11,"CARAS-SEVERIN",118,50969,,112,0,"STR. CARPATI NR 6","ORAS BOCSA",5,50969,2,1,1311,530,507,23,525,5,1400,870,270,255,
11,"CARAS-SEVERIN",118,50969,,113,0,"STR. CARPATI NR 5","ORAS BOCSA",5,50969,2,1,1168,571,521,50,569,2,1300,729,291,278,
11,"CARAS-SEVERIN",118,50969,,114,0,"STR. REPUBLICII NR 97","ORAS BOCSA",5,50969,2,1,1413,622,587,35,603,19,1550,928,365,238,
11,"CARAS-SEVERIN",118,50969,,115,0,"STR. VICTORIEI NR 6","ORAS BOCSA",5,50969,2,1,1480,697,641,56,687,10,1600,903,433,254,
11,"CARAS-SEVERIN",118,50969,,116,0,"STR. SADOVEI NR 2E","ORAS BOCSA",5,50969,2,1,1362,657,625,32,651,6,1500,843,337,314,
11,"CARAS-SEVERIN",118,50969,,117,0,"STR. REPUBLICII 100","ORAS BOCSA",5,50969,2,1,1312,655,627,28,649,6,1400,745,335,314,
11,"CARAS-SEVERIN",118,51056,,118,0,"SCOALA GENERALA NR 1","ORAS MOLDOVA NOUA",6,51056,2,1,1336,782,637,145,771,11,1500,718,548,223,
11,"CARAS-SEVERIN",118,51056,,119,0,"STR. 1 DECEMBRIE 1918 NR 2","ORAS MOLDOVA NOUA",6,51056,2,1,1142,598,523,75,595,3,1300,702,411,184,
11,"CARAS-SEVERIN",118,51056,,120,0,"SCOALA GEN NR 2 STR 1 DECEMBRIE 1918","ORAS MOLDOVA NOUA",6,51056,2,1,491,365,260,105,359,6,501,136,242,117,
11,"CARAS-SEVERIN",118,51056,,121,0,"CAMIN CULTURAL MOLDOVITA","ORAS MOLDOVA NOUA",6,51056,2,1,251,252,201,51,252,0,300,48,211,41,
11,"CARAS-SEVERIN",118,51056,,122,0,"SCOALA GENERALA MACESTI","ORAS MOLDOVA NOUA",6,51056,2,1,517,400,366,34,397,3,600,200,329,68,
11,"CARAS-SEVERIN",118,51056,,123,0,"CAMIN CULTURAL MOLDOVA VECHE","ORAS MOLDOVA NOUA",6,51056,2,1,1375,743,652,91,731,12,1500,757,500,231,
11,"CARAS-SEVERIN",118,51056,,124,0,"SCOALA GEN NR 3 ORAS NOU","ORAS MOLDOVA NOUA",6,51056,2,1,2686,1275,1130,145,1264,11,2900,1625,857,407,
11,"CARAS-SEVERIN",118,51056,,125,0,"SEDIUL INTR. MINIERE MOLDOVA NOUA, SERV TAXE IMPOZITWE","ORAS MOLDOVA NOUA",6,51056,2,1,2690,1182,1023,159,1173,9,3000,1818,794,379,
11,"CARAS-SEVERIN",118,51056,,126,0,"CLUBUL COPIILOR SI ELEVILOR","ORAS MOLDOVA NOUA",6,51056,2,1,1936,902,743,159,892,10,2100,1198,555,337,
11,"CARAS-SEVERIN",118,51056,,127,1,"SPITAL ORASENESC","ORAS MOLDOVA NOUA",6,51056,2,1,0,163,0,163,163,0,200,37,121,42,
11,"CARAS-SEVERIN",118,51118,,128,0,"SPITAL MARILA","ORAS ORAVITA",7,51118,2,1,61,143,25,118,139,4,200,57,68,71,
11,"CARAS-SEVERIN",118,51118,,129,0,"SCOALA GEN NR 3 STR. GOJDU","ORAS ORAVITA",7,51118,2,1,1217,564,479,85,555,9,1350,786,308,247,
11,"CARAS-SEVERIN",118,51118,,130,0,"STR. 1 DECEMBRIE 1918 NR 62","ORAS ORAVITA",7,51118,2,1,1175,608,526,82,594,14,1300,692,387,207,
11,"CARAS-SEVERIN",118,51118,,131,0,"STR. EF. MURGU NR 31","ORAS ORAVITA",7,51118,2,1,943,456,404,52,443,13,1100,644,269,174,
11,"CARAS-SEVERIN",118,51118,,132,0,"GRUP SCOLAR AGRICOL STR. CLOSCA","ORAS ORAVITA",7,51118,2,1,1084,555,468,87,547,8,1200,645,266,281,
11,"CARAS-SEVERIN",118,51118,,133,0,"SCOALA GEN NR 1 STR. ZONA GARII 1","ORAS ORAVITA",7,51118,2,1,1887,808,708,100,799,9,2100,1292,397,402,
11,"CARAS-SEVERIN",118,51118,,134,0,"GRADINITA NR 1 STR. ZONA GARII (CLADIRE SITUATA IN CURTEA SCOLII NR 1)","ORAS ORAVITA",7,51118,2,1,2059,878,763,115,869,9,2100,1222,427,442,
11,"CARAS-SEVERIN",118,51118,,135,0,"CRESA CAMIN STR ZONA GARII","ORAS ORAVITA",7,51118,2,1,1586,704,587,117,690,14,1700,996,331,359,
11,"CARAS-SEVERIN",118,51118,,136,0,"CAMIN CULTURAL CICLOVA MONTANA","ORAS ORAVITA",7,51118,2,1,448,290,226,64,285,5,500,210,130,155,
11,"CARAS-SEVERIN",118,51118,,137,0,"SCOALA GENERALA BROSTENI","ORAS ORAVITA",7,51118,2,1,484,275,206,69,272,3,500,225,96,176,
11,"CARAS-SEVERIN",118,51118,,138,0,"SCOALA GENERALA RACHITOVA","ORAS ORAVITA",7,51118,2,1,279,174,124,50,172,2,300,126,68,104,
11,"CARAS-SEVERIN",118,51118,,139,0,"SCOALA GENERALA BRADISORUL DE JOS","ORAS ORAVITA",7,51118,2,1,441,304,245,59,302,2,502,198,129,173,
11,"CARAS-SEVERIN",118,51118,,140,0,"SCOALA GENERALA AGADICI","ORAS ORAVITA",7,51118,2,1,179,165,109,56,160,5,200,35,52,108,
11,"CARAS-SEVERIN",118,51118,,141,1,"SPITALUL ORASENESC ORAVITA","ORAS ORAVITA",7,51118,2,1,0,94,0,94,92,2,100,6,52,40,
11,"CARAS-SEVERIN",118,51118,,142,1,"U.M. 0422 (POLITIA DE FRONTIERA)","ORAS ORAVITA",7,51118,2,1,0,100,0,100,96,4,100,0,59,37,
11,"CARAS-SEVERIN",118,51207,,143,0,"GRADINITA OHABA","ORAS OTELU ROSU",8,51207,2,1,1112,558,514,44,548,10,1200,642,270,278,
11,"CARAS-SEVERIN",118,51207,,144,0,"GRADINITA-PROGRAM PRELUNGIT","ORAS OTELU ROSU",8,51207,2,1,1294,704,648,56,694,10,1400,696,407,287,
11,"CARAS-SEVERIN",118,51207,,145,0,"SC ""MAURICOM"" SRL","ORAS OTELU ROSU",8,51207,2,1,538,297,255,42,292,5,600,303,154,138,
11,"CARAS-SEVERIN",118,51207,,146,0,"SCOALA GENERALA NR 3 STR. LIBERTATII","ORAS OTELU ROSU",8,51207,2,1,1493,661,630,31,654,7,1600,939,343,311,
11,"CARAS-SEVERIN",118,51207,,147,0,"CLUBUL SINDICATULUI ""METASID""","ORAS OTELU ROSU",8,51207,2,1,1647,812,737,75,797,15,1800,973,441,356,
11,"CARAS-SEVERIN",118,51207,,148,0,"CANTINA DE AJUTOR SOCIAL","ORAS OTELU ROSU",8,51207,2,1,1041,543,453,90,533,10,1200,657,363,170,
11,"CARAS-SEVERIN",118,51207,,149,0,"SEDIUL SC ""ROMFLEX"" SA","ORAS OTELU ROSU",8,51207,2,1,1125,659,500,159,650,9,1250,591,320,330,
11,"CARAS-SEVERIN",118,51207,,150,0,"GRADINITA- CARTIER GAI","ORAS OTELU ROSU",8,51207,2,1,1030,605,564,41,595,10,1140,535,339,256,
11,"CARAS-SEVERIN",118,51207,,151,0,"CAMIN CULTURAL-CIRESA","ORAS OTELU ROSU",8,51207,2,1,632,378,336,42,370,8,700,322,205,165,
11,"CARAS-SEVERIN",118,51207,,152,0,"SCOALA GENERALA-MAL","ORAS OTELU ROSU",8,51207,2,1,300,270,234,36,267,3,350,80,142,125,
11,"CARAS-SEVERIN",118,51243,,153,0,"SCOALA GENERALA ARMENIS","ARMENIS",9,51243,0,3,1104,692,608,84,688,4,1200,508,312,376,
11,"CARAS-SEVERIN",118,51243,,154,0,"SCOALA GENERALA SAT FENES","ARMENIS",9,51243,0,3,468,355,289,66,350,5,500,145,200,150,
11,"CARAS-SEVERIN",118,51243,,155,0,"SCOALA PRIMARA SAT BATRAN","ARMENIS",9,51243,0,3,396,214,188,26,213,1,450,236,51,162,
11,"CARAS-SEVERIN",118,51243,,156,0,"SCOALA PRIMARA SAT SUBMARGINEA","ARMENIS",9,51243,0,3,224,123,101,22,121,2,250,127,33,88,
11,"CARAS-SEVERIN",118,51305,,157,0,"CAMINUL CULTURAL BANIA","BANIA",10,51305,0,3,1021,775,718,57,770,5,1102,327,183,587,
11,"CARAS-SEVERIN",118,51305,,158,0,"CAMIN CULTURAL SAT GARBOVAT","BANIA",10,51305,0,3,482,345,287,58,339,6,500,155,164,175,
11,"CARAS-SEVERIN",118,51332,,159,0,"CAMIN CULTURAL BAUTAR DE JOS, BAUTAR NR 253A","BAUTAR",11,51332,0,3,723,506,475,31,500,6,900,394,230,270,
11,"CARAS-SEVERIN",118,51332,,160,0,"CAMIN CULTURAL BAUTAR DE SUS, BAUTAR NR 45A","BAUTAR",11,51332,0,3,728,478,453,25,474,4,700,222,258,216,
11,"CARAS-SEVERIN",118,51332,,161,0,"CAMIN CULTURAL BUCOVA, BUCOVA NR 65A","BAUTAR",11,51332,0,3,771,521,472,49,514,7,850,329,204,310,
11,"CARAS-SEVERIN",118,51387,,162,0,"SCOALA CU CLS I-IV BERLISTE","BERLISTE",12,51387,0,3,317,259,176,83,248,11,350,91,171,77,
11,"CARAS-SEVERIN",118,51387,,163,0,"SCOALA CU CLS I-IV SAT MILCOVENI","BERLISTE",12,51387,0,3,255,243,146,97,236,7,300,57,131,105,
11,"CARAS-SEVERIN",118,51387,,164,0,"SCOALA CU CLS I-IV SAT IAM","BERLISTE",12,51387,0,3,302,231,143,88,224,7,350,119,148,76,
11,"CARAS-SEVERIN",118,51387,,165,0,"SCOALA CU CLS I-IV SAT RUSOVA NOUA","BERLISTE",12,51387,0,3,151,119,74,45,117,2,200,81,72,45,
11,"CARAS-SEVERIN",118,51449,,166,0,"INTERNATUL SCOLII BERZASCA","BERZASCA",13,51449,0,3,1103,849,595,254,831,18,1100,251,638,193,
11,"CARAS-SEVERIN",118,51449,,167,0,"GRADINITA DE COPII NR 2 SAT LIUBCOVA","BERZASCA",13,51449,0,3,947,580,487,93,573,7,1050,470,416,157,
11,"CARAS-SEVERIN",118,51449,,168,0,"SCOALA GENERALA SAT BIGAR","BERZASCA",13,51449,0,3,278,149,131,18,145,4,300,151,92,53,
11,"CARAS-SEVERIN",118,51449,,169,0,"SCOALA PRIMARA SAT COZLA","BERZASCA",13,51449,0,3,132,78,32,46,78,0,150,72,58,20,
11,"CARAS-SEVERIN",118,51500,,170,0,"SCOALA GENERALA BERZOVIA","BERZOVIA",14,51500,0,3,1626,1016,897,119,878,19,1800,903,556,322,
11,"CARAS-SEVERIN",118,51500,,171,0,"GRADINITA DE COPII SAT GHERTENIS","BERZOVIA",14,51500,0,3,745,417,341,76,415,2,800,383,201,214,
11,"CARAS-SEVERIN",118,51500,,172,0,"CAMINUL CULTURAL SAT FIZES","BERZOVIA",14,51500,0,3,740,492,429,63,486,6,800,308,217,269,
11,"CARAS-SEVERIN",118,51546,,173,0,"SCOALA GENERALA BOLVASNITA","BOLVASNITA",15,51546,0,3,424,214,189,25,209,5,500,286,71,138,
11,"CARAS-SEVERIN",118,51546,,174,0,"SCOALA GENERALA SAT VARCIOROVA","BOLVASNITA",15,51546,0,3,796,389,358,31,378,11,900,511,109,269,
11,"CARAS-SEVERIN",118,51573,,175,0,"SCOALA GENERALA CLS I-IV BOZOVICI, BOZOVICI NR 206","BOZOVICI",16,51573,0,3,1351,772,649,123,763,9,1500,728,459,304,
11,"CARAS-SEVERIN",118,51573,,176,0,"LIC. TEORETIC BOZOVICI","BOZOVICI",16,51573,0,3,662,426,287,139,420,6,700,274,263,157,
11,"CARAS-SEVERIN",118,51573,,177,0,"CAMIN CULTURAL PRILIPET, PRILIPET NR 33","BOZOVICI",16,51573,0,3,586,406,321,85,402,4,650,244,157,245,
11,"CARAS-SEVERIN",118,51573,,178,1,"GRUPUL DE POMPIERI MILITARI","BOZOVICI",16,51573,0,3,0,20,0,20,20,0,52,32,13,7,
11,"CARAS-SEVERIN",118,51573,,179,1,"SPITALUL COMUNAL BOZOVICI","BOZOVICI",16,51573,0,3,0,66,0,66,66,0,100,34,33,33,
11,"CARAS-SEVERIN",118,51626,,180,0,"CAMIN CULTURAL BREBU","BREBU",17,51626,0,3,557,354,258,96,347,7,600,246,101,246,
11,"CARAS-SEVERIN",118,51626,,181,0,"SCOALA GENERALA SAT APADIA","BREBU",17,51626,0,3,193,144,88,56,141,3,200,56,39,102,
11,"CARAS-SEVERIN",118,51626,,182,0,"SCOALA GENERALA SAT VALEADENI","BREBU",17,51626,0,3,174,155,78,77,154,1,200,45,60,94,
11,"CARAS-SEVERIN",118,51662,,183,0,"SCOALA GENERALA GARINA","BREBU NOU",18,51662,0,3,76,83,26,57,82,1,250,167,60,22,
11,"CARAS-SEVERIN",118,51699,,184,0,"SCOALA PRIMARA BUCHIN","BUCHIN",19,51699,0,3,619,472,382,90,467,5,702,230,197,270,
11,"CARAS-SEVERIN",118,51699,,185,0,"SCOALA PRIMARA SAT POIANA","BUCHIN",19,51699,0,3,521,448,384,64,447,1,600,152,273,174,
11,"CARAS-SEVERIN",118,51699,,186,0,"SCOALA GENERALA VALEA TIMUSULUI","BUCHIN",19,51699,0,3,433,408,338,70,406,2,500,92,188,218,
11,"CARAS-SEVERIN",118,51751,,187,0,"SCOALA GENERALA SAT BUCOSNITA","BUCOSNITA",20,51751,0,3,649,395,344,51,394,1,700,305,118,276,
11,"CARAS-SEVERIN",118,51751,,188,0,"SCOALA GENERALS SAT GOLET","BUCOSNITA",20,51751,0,3,491,455,423,32,448,7,550,95,96,352,
11,"CARAS-SEVERIN",118,51751,,189,0,"CAMIN CULTURAL SAT PETROSNITA","BUCOSNITA",20,51751,0,3,717,455,380,75,449,6,800,345,295,154,
11,"CARAS-SEVERIN",118,51751,,190,0,"SCOALA GENERALA SAT VALISOARA","BUCOSNITA",20,51751,0,3,572,420,370,50,418,2,650,230,173,245,
11,"CARAS-SEVERIN",118,51804,,191,0,"CAMINUL CULTURAL CARASOVA NR 96","CARASOVA",21,51804,0,3,2010,660,603,57,648,12,2200,1540,345,303,
11,"CARAS-SEVERIN",118,51804,,192,0,"SCOALA CLS I-IV SAT NERMED","CARASOVA",21,51804,0,3,453,227,199,28,218,9,500,273,102,116,
11,"CARAS-SEVERIN",118,51804,,193,0,"SCOALA CLS I-IV SAT IABALCEA","CARASOVA",21,51804,0,3,174,122,95,27,118,4,200,78,37,81,
11,"CARAS-SEVERIN",118,51840,,194,0,"SCOALA GENERALA CARBUNARI","CARBUNARI",22,51840,0,3,1058,765,657,108,763,2,1202,437,451,312,
11,"CARAS-SEVERIN",118,51948,,195,0,"SCOALA CU CL.I-VIII CICLOVA ROMANA","CICLOVA ROMANA",23,51948,0,3,858,502,400,102,499,3,770,268,195,304,
11,"CARAS-SEVERIN",118,51948,,196,0,"CAMIN CULTURAL SAT ILIDIA","CICLOVA ROMANA",23,51948,0,3,281,233,141,92,225,8,300,67,120,105,
11,"CARAS-SEVERIN",118,51948,,197,0,"FOSTUL SEDIU AL PRIMARIEI VECHI,SAT SOCOLARI","CICLOVA ROMANA",23,51948,0,3,120,142,73,69,136,6,180,38,105,31,
11,"CARAS-SEVERIN",118,51984,,198,0,"CAMIN CULTURAL CIUCHICI","CIUCHICI",24,51984,0,3,411,317,218,99,314,3,400,83,133,181,
11,"CARAS-SEVERIN",118,51984,,199,0,"SCOALA GENERALA SAT MACOVISTE","CIUCHICI",24,51984,0,3,98,133,63,70,131,2,150,17,71,60,
11,"CARAS-SEVERIN",118,51984,,200,0,"SCOALA GENERALA SAT NICOLINT","CIUCHICI",24,51984,0,3,191,190,117,73,183,7,200,10,114,69,
11,"CARAS-SEVERIN",118,51984,,201,0,"SCOALA GENERALA SAT PETRILOVA","CIUCHICI",24,51984,0,3,113,131,68,63,129,2,150,19,59,70,
11,"CARAS-SEVERIN",118,52035,,202,0,"SCOALA GENERALA CIUDANOVITA-COLONIE","CIUDANOVITA",25,52035,0,3,571,280,232,48,279,1,650,370,111,168,
11,"CARAS-SEVERIN",118,52035,,203,0,"SCOALA GENERALA SAT JITIN","CIUDANOVITA",25,52035,0,3,150,153,118,35,149,4,200,47,97,52,
11,"CARAS-SEVERIN",118,51877,,204,0,"SCOALA GENERALA SAT JAGUJENI","CONSTANTIN DAICOVICIU",26,51877,0,3,620,371,293,78,368,3,700,329,164,204,
11,"CARAS-SEVERIN",118,51877,,205,0,"SCOALA CONSTANTIN DAICOVICIU","CONSTANTIN DAICOVICIU",26,51877,0,3,511,388,298,90,380,8,550,162,230,150,
11,"CARAS-SEVERIN",118,51877,,206,0,"SCOALA SAT MACIOVA","CONSTANTIN DAICOVICIU",26,51877,0,3,541,328,279,49,320,8,600,272,149,171,
11,"CARAS-SEVERIN",118,51877,,207,0,"SCOALA SAT MATNICU MARE","CONSTANTIN DAICOVICIU",26,51877,0,3,329,205,166,39,203,2,350,145,83,120,
11,"CARAS-SEVERIN",118,52062,,208,0,"CAMIN CULTURAL COPACELE","COPACELE",27,52062,0,3,354,227,187,40,220,7,400,173,138,82,
11,"CARAS-SEVERIN",118,52062,,209,0,"SCOALA GENERALA SAT OHABA MATNIC","COPACELE",27,52062,0,3,317,165,113,52,162,3,350,185,72,90,
11,"CARAS-SEVERIN",118,52062,,210,0,"SCOALA GENERALA SAT ZORILE","COPACELE",27,52062,0,3,486,239,208,31,237,2,545,306,99,138,
11,"CARAS-SEVERIN",118,52115,,211,0,"CAMIN CULTURAL VECHI CORNEA","CORNEA",28,52115,0,3,740,422,388,34,417,5,800,378,206,211,
11,"CARAS-SEVERIN",118,52115,,212,0,"CAMIN CULTURAL SAT CUPTOARE","CORNEA",28,52115,0,3,586,407,354,53,401,6,650,243,241,160,
11,"CARAS-SEVERIN",118,52115,,213,0,"CAMIN CULTURAL SAT CRUSOVAT","CORNEA",28,52115,0,3,485,352,305,47,349,3,550,198,115,234,
11,"CARAS-SEVERIN",118,52160,,214,0,"PRIMARIA COMUNEI CORNEREVA","CORNEREVA",29,52160,0,3,417,233,212,21,225,8,500,267,114,111,
11,"CARAS-SEVERIN",118,52160,,215,0,"SCOALA SAT GRUNI","CORNEREVA",29,52160,0,3,940,396,372,24,384,12,1100,704,80,304,
11,"CARAS-SEVERIN",118,52160,,216,0,"SCOALA SAT DOLINA","CORNEREVA",29,52160,0,3,786,415,404,11,413,2,800,385,265,148,
11,"CARAS-SEVERIN",118,52160,,217,0,"SCOALA SAT BOGALTIN","CORNEREVA",29,52160,0,3,456,213,191,22,212,1,500,287,130,82,
11,"CARAS-SEVERIN",118,52160,,218,0,"SCOLA SAT DOBRAIA","CORNEREVA",29,52160,0,3,143,90,62,28,90,0,150,60,40,50,
11,"CARAS-SEVERIN",118,52160,,219,0,"SCOALA SAT INELET","CORNEREVA",29,52160,0,3,147,84,66,18,83,1,150,66,56,27,
11,"CARAS-SEVERIN",118,53489,,220,0,"CAMIN CULTURAL CORONINI","CORONINI",30,53489,0,3,1033,740,703,37,737,3,1200,460,542,195,
11,"CARAS-SEVERIN",118,53489,,221,0,"CAMIN CULTURAL SAT SFANTA ELENA","CORONINI",30,53489,0,3,479,306,287,19,302,4,550,244,252,50,
11,"CARAS-SEVERIN",118,52570,,222,0,"CAMIN CULTURAL DALBOSET","DALBOSET",31,52570,0,3,953,608,503,105,604,4,1000,392,240,364,
11,"CARAS-SEVERIN",118,52570,,223,0,"SCOALA GENERALA SOPOTU VECHI","DALBOSET",31,52570,0,3,610,496,407,89,494,2,700,204,191,303,
11,"CARAS-SEVERIN",118,52650,,224,0,"CAMIN CULTURAL DOCLIN","DOCLIN",32,52650,0,3,416,292,239,53,287,5,450,158,136,151,
11,"CARAS-SEVERIN",118,52650,,225,0,"GRADINITA DE COPII SAT BINIS","DOCLIN",32,52650,0,3,585,349,290,59,342,7,650,301,144,198,
11,"CARAS-SEVERIN",118,52650,,226,0,"GRADINITA DE COPII SAT TIROL","DOCLIN",32,52650,0,3,451,270,197,73,266,4,500,230,168,98,
11,"CARAS-SEVERIN",118,52696,,227,0,"GRADINITA DE COPII DOGNECEA","DOGNECEA",33,52696,0,3,954,546,408,138,534,12,1050,504,246,288,
11,"CARAS-SEVERIN",118,52696,,228,0,"SCOALA GENERALA NR.2","DOGNECEA",33,52696,0,3,497,281,200,81,278,3,550,269,107,171,
11,"CARAS-SEVERIN",118,52696,,229,0,"SCOALA ELEMENTARA DE IV CLASE SAT CALINA","DOGNECEA",33,52696,0,3,96,96,64,32,95,1,150,54,37,58,
11,"CARAS-SEVERIN",118,52721,,230,0,"CAMIN CULTURAL SALA MICA","DOMASNEA",34,52721,0,3,920,566,483,83,558,8,1000,434,292,266,
11,"CARAS-SEVERIN",118,52721,,231,0,"SCOALA GENERALA CLS.I-IV SAT CANICEA","DOMASNEA",34,52721,0,3,306,279,250,29,276,3,350,71,104,172,
11,"CARAS-SEVERIN",118,53700,,232,0,"CLUBUL CASEI CULTURALE ""ION SARBU""","EFTIMIE MURGU",35,53700,0,3,1503,1036,913,123,1028,8,1650,614,268,760,
11,"CARAS-SEVERIN",118,52758,,233,0,"CAMIN CULTURAL EZERIS","EZERIS",36,52758,0,3,451,333,221,112,331,2,500,167,165,166,
11,"CARAS-SEVERIN",118,52758,,234,0,"CAMIN CULTURAL SAT SOCENI","EZERIS",36,52758,0,3,493,325,259,66,322,3,550,225,111,211,
11,"CARAS-SEVERIN",118,52785,,235,0,"SCOALA GENERALA SAT FARLIUG","FARLIUG",37,52785,0,3,721,421,316,105,407,14,800,379,124,283,
11,"CARAS-SEVERIN",118,52785,,236,0,"CAMIN CULTURAL SAT SCAIUS","FARLIUG",37,52785,0,3,305,163,120,43,162,1,350,187,66,96,
11,"CARAS-SEVERIN",118,52785,,237,0,"SCOALA GENERALA DEZESTI","FARLIUG",37,52785,0,3,137,212,105,107,210,2,250,38,62,148,
11,"CARAS-SEVERIN",118,52785,,238,0,"SCOALA GENERALA REMETEA POGONICI","FARLIUG",37,52785,0,3,151,121,80,41,120,1,200,79,53,67,
11,"CARAS-SEVERIN",118,52785,,239,0,"CAMIN CULTURAL SAT DULEU","FARLIUG",37,52785,0,3,158,142,87,55,141,1,170,28,83,58,
11,"CARAS-SEVERIN",118,52785,,240,0,"CAMIN CULTURAL SAT VALEA MARE","FARLIUG",37,52785,0,3,83,110,58,52,106,4,130,20,21,85,
11,"CARAS-SEVERIN",118,52856,,241,0,"CAMIN CULTURAL FOROTIC","FOROTIC",38,52856,0,3,491,423,346,77,346,9,550,195,164,182,
11,"CARAS-SEVERIN",118,52856,,242,0,"CAMIN CULTURAL SAT COMORASTE","FOROTIC",38,52856,0,3,527,358,301,57,347,11,600,242,199,148,
11,"CARAS-SEVERIN",118,52856,,243,0,"CAMIN CULTURAL SAT SURDUC","FOROTIC",38,52856,0,3,362,332,249,83,329,3,400,68,130,199,
11,"CARAS-SEVERIN",118,52909,,244,0,"CAMIN CULTURAL DARNIC","GARNIC",39,52909,0,3,640,299,285,14,288,11,700,401,178,110,
11,"CARAS-SEVERIN",118,52909,,245,0,"CAMIN CULTURAL PADINA MATEI","GARNIC",39,52909,0,3,757,537,480,57,536,1,850,313,301,235,
11,"CARAS-SEVERIN",118,52936,,246,0,"CAMIN CULTURAL GLIMBOCA","GLIMBOCA",40,52936,0,3,1400,853,734,119,848,5,1500,647,467,381,
11,"CARAS-SEVERIN",118,52954,,247,0,"CAMIN CULTURAL SAT GORUIA","GORUIA",41,52954,0,3,327,227,191,36,225,2,350,123,95,130,
11,"CARAS-SEVERIN",118,52954,,248,0,"SCOALA GENERALA SAT GARLISTE","GORUIA",41,52954,0,3,306,259,168,91,259,0,350,91,155,104,
11,"CARAS-SEVERIN",118,52954,,249,0,"SCOALA GENERALA SAT GIURGIOVA","GORUIA",41,52954,0,3,130,115,89,26,115,0,150,35,80,35,
11,"CARAS-SEVERIN",118,52990,,250,0,"SCOALA CU CLS.I-VIII GRADINARI","GRADINARI",42,52990,0,3,916,656,515,141,641,15,1000,344,379,262,
11,"CARAS-SEVERIN",118,52990,,251,0,"FOSTUL SEDIU CAP GREONI","GRADINARI",42,52990,0,3,727,448,366,82,439,9,801,353,261,178,
11,"CARAS-SEVERIN",118,53023,,252,0,"SCOALA CU CLS.I-VIII IABLANITA","IABLANITA",43,53023,0,3,732,477,375,102,471,6,800,323,228,243,
11,"CARAS-SEVERIN",118,53023,,253,0,"SCOALA CU CLS.I-IV SAT PETNIC","IABLANITA",43,53023,0,3,736,443,373,70,439,4,800,357,154,285,
11,"CARAS-SEVERIN",118,53023,,254,0,"SCOALA CU CLS.I-VIII SAT GLOBUL CRAIOVEI","IABLANITA",43,53023,0,3,631,473,396,77,467,6,700,227,249,218,
11,"CARAS-SEVERIN",118,53069,,255,0,"CAMINUL CULTURAL LAPUSNICEL","LAPUSNICEL",44,53069,0,3,576,408,341,67,404,4,650,242,257,147,
11,"CARAS-SEVERIN",118,53069,,256,0,"SCOALA GENERALA PARVOVA","LAPUSNICEL",44,53069,0,3,497,391,324,67,388,3,600,209,183,205,
11,"CARAS-SEVERIN",118,53069,,257,0,"SCOALA GENERALA SUMITA","LAPUSNICEL",44,53069,0,3,145,93,69,24,91,2,150,57,49,42,
11,"CARAS-SEVERIN",118,53103,,258,0,"CAMINUL CULTURAL LAPUSNICU MARE","LAPUSNICU MARE",45,53103,0,3,1058,591,505,86,575,16,1100,509,297,278,
11,"CARAS-SEVERIN",118,53103,,259,0,"CAMINUL CULTURAL MOCERIS","LAPUSNICU MARE",45,53103,0,3,564,385,315,70,382,3,599,214,121,261,
11,"CARAS-SEVERIN",118,53130,,260,0,"CAMINUL CULTURAL,SALA MICA LUNCAVITA","LUNCAVITA",46,53130,0,3,838,528,473,55,522,6,900,372,153,369,
11,"CARAS-SEVERIN",118,53130,,261,0,"CAMINUL CULTURAL,SALA MICA VERENDIN","LUNCAVITA",46,53130,0,3,1479,562,488,74,554,8,1600,1038,147,407,
11,"CARAS-SEVERIN",118,53167,,262,0,"SCOALA GENERALA LUPAC","LUPAC",47,53167,0,3,747,351,302,49,342,9,800,449,137,205,
11,"CARAS-SEVERIN",118,53167,,263,0,"SCOALA GENERALA CLOCOTICI","LUPAC",47,53167,0,3,775,373,334,39,362,11,850,477,168,194,
11,"CARAS-SEVERIN",118,53167,,264,0,"SCOALA GENERALA RAFNIC","LUPAC",47,53167,0,3,437,243,211,32,239,4,500,257,62,177,
11,"CARAS-SEVERIN",118,53167,,265,0,"SCOALA GENERALA VODNIC","LUPAC",47,53167,0,3,335,244,218,26,240,4,350,106,139,101,
11,"CARAS-SEVERIN",118,53210,,266,0,"CASA DE CULTURA MARGA","MARGA",48,53210,0,3,1045,697,635,62,696,1,1200,503,413,283,
11,"CARAS-SEVERIN",118,53247,,267,0,"SCOALA GENERALA MAURENI","MAURENI",49,53247,0,3,1201,599,526,73,587,12,1300,701,250,337,
11,"CARAS-SEVERIN",118,53247,,268,0,"SCOALA GENERALA SOSDEA","MAURENI",49,53247,0,3,617,397,317,80,395,2,650,253,187,208,
11,"CARAS-SEVERIN",118,53274,,269,0,"LICEUL MEHADIA","MEHADIA",50,53274,0,3,1481,1125,814,311,1106,19,1600,475,528,578,
11,"CARAS-SEVERIN",118,53274,,270,0,"SCOALA GENERALA I-VIII SAT PLUGOVA","MEHADIA",50,53274,0,3,771,578,472,106,571,7,850,272,269,302,
11,"CARAS-SEVERIN",118,53274,,271,0,"SCOALA GENERALA I-VIII SAT VALEA BOLVASNITA","MEHADIA",50,53274,0,3,704,508,424,84,508,0,800,292,235,273,
11,"CARAS-SEVERIN",118,53274,,272,0,"SCOALA GENERALA I-IV SAT GLOBU RAU","MEHADIA",50,53274,0,3,192,149,101,48,147,2,200,51,59,88,
11,"CARAS-SEVERIN",118,53327,,273,0,"CAMIN CULTURAL MEHADICA","MEHADICA",51,53327,0,3,737,554,440,114,548,6,801,247,182,366,
11,"CARAS-SEVERIN",118,53345,,274,0,"PRIMARIA VECHE NAIDAS","NAIDAS",52,53345,0,3,702,613,453,160,605,8,800,187,248,357,
11,"CARAS-SEVERIN",118,53345,,275,0,"CAMIN CULTURAL LESCOVITA","NAIDAS",52,53345,0,3,272,293,212,81,291,2,300,7,173,118,
11,"CARAS-SEVERIN",118,53372,,276,0,"COM.OBREJA NR.157","OBREJA",53,53372,0,3,1949,1331,1115,216,1326,5,2150,819,645,681,
11,"CARAS-SEVERIN",118,53372,,277,0,"SCOALA GENERALA VAR,NR.47","OBREJA",53,53372,0,3,313,275,187,88,272,3,350,75,150,122,
11,"CARAS-SEVERIN",118,50987,,278,0,"SCOALA GENERALA OCNA DE FIER STRADA MORAVITA","OCNA DE FIER",54,50987,0,3,662,376,341,35,372,4,700,324,234,138,
11,"CARAS-SEVERIN",118,53425,,279,0,"CAMINUL CULTURAL PALTINIS","PALTINIS",55,53425,0,3,495,341,287,54,336,5,550,209,119,217,
11,"CARAS-SEVERIN",118,53425,,280,0,"SCOALA GENERALA CORNUTEL","PALTINIS",55,53425,0,3,775,474,426,48,470,4,850,376,179,291,
11,"CARAS-SEVERIN",118,53425,,281,0,"SCOALA GENERALA DELINESTI","PALTINIS",55,53425,0,3,486,298,243,55,298,0,550,252,92,206,
11,"CARAS-SEVERIN",118,53425,,282,0,"SCOALA PRIMARA RUGI","PALTINIS",55,53425,0,3,228,180,129,51,179,1,250,70,86,93,
11,"CARAS-SEVERIN",118,53513,,283,0,"CAMINUL CULTURAL POJEJENA","POJEJENA",56,53513,0,3,1485,806,687,119,800,6,1600,794,554,246,
11,"CARAS-SEVERIN",118,53513,,284,0,"SCOALA GENERALA CL.I-VIII BELOBRESCA","POJEJENA",56,53513,0,3,1199,649,513,136,638,11,1300,651,438,200,
11,"CARAS-SEVERIN",118,53577,,285,0,"GRADINITA DE COPII PRIGOR","PRIGOR",57,53577,0,3,891,560,531,29,559,1,1000,440,131,428,
11,"CARAS-SEVERIN",118,53577,,286,0,"SCOALA GENERALA SAT PATAS","PRIGOR",57,53577,0,3,1005,620,554,66,616,4,1100,480,242,374,
11,"CARAS-SEVERIN",118,53577,,287,0,"SCOALA GENERALA SAT BORLOVENII NOI","PRIGOR",57,53577,0,3,418,283,235,48,282,1,450,167,66,216,
11,"CARAS-SEVERIN",118,53577,,288,0,"SCOALA GENERALA SAT PUTNA","PRIGOR",57,53577,0,3,162,109,94,15,107,2,200,91,44,63,
11,"CARAS-SEVERIN",118,53639,,289,0,"SCOALA GENERALA CLS.I-VIII RAMNA","RAMNA",59,53639,0,3,994,543,476,67,532,11,1100,557,276,256,
11,"CARAS-SEVERIN",118,53639,,290,0,"SCOALA GENERALA CLS.I-VIII SAT VALEA PAI","RAMNA",59,53639,0,3,371,249,191,58,246,3,380,131,115,131,
11,"CARAS-SEVERIN",118,53639,,291,0,"SCOALA GENERALA CLS.I-IV SAT BARBOSU","RAMNA",59,53639,0,3,39,52,18,34,51,1,70,18,29,22,
11,"CARAS-SEVERIN",118,53675,,292,0,"CAMIN CULTURAL RACASDIA","RACASDIA",58,53675,0,3,1259,738,623,115,716,22,1400,662,376,340,
11,"CARAS-SEVERIN",118,53675,,293,0,"SEDIUL FOSTEI PRIMARII VRANIUT","RACASDIA",58,53675,0,3,286,182,119,63,177,5,300,118,92,85,
11,"CARAS-SEVERIN",118,53728,,294,0,"SCOALA GENERALA CLS.I-VIII RUSCA MONTANA","RUSCA MONTANA",60,53728,0,3,1281,813,732,81,803,10,1400,587,307,496,
11,"CARAS-SEVERIN",118,53728,,295,0,"SCOALA GENERALA CLS.I-IV RUSCHITA","RUSCA MONTANA",60,53728,0,3,341,280,188,92,275,5,400,120,109,166,
11,"CARAS-SEVERIN",118,53755,,296,0,"CLUB CAMIN CULTURALSACU","SACU",61,53755,0,3,672,459,343,116,456,3,750,291,221,235,
11,"CARAS-SEVERIN",118,53755,,297,0,"CLUB CAMIN CULTURAL SAT TINCOVA","SACU",61,53755,0,3,365,284,234,50,283,1,400,116,153,130,
11,"CARAS-SEVERIN",118,53755,,298,0,"SCOALA GENERALA SAT SALBAGELU NOU","SACU",61,53755,0,3,157,87,74,13,86,1,200,113,29,57,
11,"CARAS-SEVERIN",118,53791,,299,0,"SCOALA GENERALA SASCA MONTANA","SASCA MONTANA",62,53791,0,3,511,271,211,60,267,4,500,229,152,115,
11,"CARAS-SEVERIN",118,53791,,300,0,"SCOALA GENERALA SAT SASCA MONTANA","SASCA MONTANA",62,53791,0,3,389,267,238,29,267,0,400,133,140,127,
11,"CARAS-SEVERIN",118,53791,,301,0,"CAMINUL CULTURAL SAT SLATINA NERA","SASCA MONTANA",62,53791,0,3,227,226,122,104,220,6,250,24,131,89,
11,"CARAS-SEVERIN",118,53791,,302,0,"CAMINUL CULTURAL SAT POTOC","SASCA MONTANA",62,53791,0,3,196,191,116,75,190,1,250,59,72,118,
11,"CARAS-SEVERIN",118,53791,,303,0,"CAMINUL CULTURAL SAT BOGODINT","SASCA MONTANA",62,53791,0,3,112,133,76,57,129,4,150,17,83,46,
11,"CARAS-SEVERIN",118,53853,,304,0,"CAMINUL CULTURAL SAT SICHIEVITA","SICHEVITA",63,53853,0,3,1515,885,740,145,870,15,1701,816,574,296,
11,"CARAS-SEVERIN",118,53853,,305,0,"SCOALA PRIMARA SAT GORNEA","SICHEVITA",63,53853,0,3,430,393,254,139,386,7,500,107,250,136,
11,"CARAS-SEVERIN",118,53853,,306,0,"CLADIREA SANTIERULUI DE DRUMURI SI PODURI SAT LIBORAJDEA","SICHEVITA",63,53853,0,3,230,72,41,31,70,2,250,178,41,29,
11,"CARAS-SEVERIN",118,54056,,307,0,"CAMINUL CULTURAL SLATINA TIMIS","SLATINA-TIMIS",64,54056,0,3,1478,766,711,55,761,5,1600,834,365,396,
11,"CARAS-SEVERIN",118,54056,,308,0,"SCOALA GENERALA SAT ILOVA","SLATINA-TIMIS",64,54056,0,3,684,527,487,40,526,1,750,223,147,379,
11,"CARAS-SEVERIN",118,54056,,309,0,"SCOALA GENERALA SADOVA VECHE","SLATINA-TIMIS",64,54056,0,3,456,246,200,46,246,0,500,254,109,137,
11,"CARAS-SEVERIN",118,54109,,310,0,"SCOALA GENERALA SOCOL","SOCOL",65,54109,0,3,666,447,289,158,444,3,740,293,335,109,
11,"CARAS-SEVERIN",118,54109,,311,0,"CAMIN CULTURAL BAZIAS","SOCOL",65,54109,0,3,40,44,21,23,43,1,62,18,22,21,
11,"CARAS-SEVERIN",118,54109,,312,0,"SCOALA PRIMARA CAMPIA","SOCOL",65,54109,0,3,466,354,269,85,352,2,502,148,259,93,
11,"CARAS-SEVERIN",118,54109,,313,0,"SCOALA PRIMARA ZLATITA","SOCOL",65,54109,0,3,559,445,341,104,443,2,600,155,320,123,
11,"CARAS-SEVERIN",118,54163,,314,0,"CAMINUL CULTURAL SOPOTU NOU","SOPOTU NOU",66,54163,0,3,279,202,167,35,202,0,350,148,83,119,
11,"CARAS-SEVERIN",118,54163,,315,0,"CAMINUL CULTURAL SAT STANCILOVA","SOPOTU NOU",66,54163,0,3,326,195,173,22,189,6,350,155,105,84,
11,"CARAS-SEVERIN",118,54163,,316,0,"SCOALA PRIMARA SAT VALEA ROSIE","SOPOTU NOU",66,54163,0,3,244,109,93,16,107,2,250,141,30,77,
11,"CARAS-SEVERIN",118,54163,,317,0,"SCOALA PRIMARA SAT RACHITA","SOPOTU NOU",66,54163,0,3,130,57,47,10,57,0,150,93,31,26,
11,"CARAS-SEVERIN",118,54163,,318,0,"CAMIN CULTURAL RAVENSCA","SOPOTU NOU",66,54163,0,3,154,91,79,12,91,0,200,109,53,38,
11,"CARAS-SEVERIN",118,54270,,319,0,"SCOALA GENERALA TEREGOVA","TEREGOVA",68,54270,0,3,1242,720,644,76,715,5,1392,672,363,352,
11,"CARAS-SEVERIN",118,54270,,320,0,"CAMINUL CULTURAL TEREGOVA","TEREGOVA",68,54270,0,3,1220,737,638,99,731,6,1350,613,300,431,
11,"CARAS-SEVERIN",118,54270,,321,0,"SCOALA GENERALA SAT RUSCA","TEREGOVA",68,54270,0,3,1001,653,551,102,650,3,1100,447,353,297,
11,"CARAS-SEVERIN",118,54350,,322,0,"SCOALA GENERALA TARNOVA","TARNOVA",67,54350,0,3,1528,816,701,115,809,7,1649,833,260,549,
11,"CARAS-SEVERIN",118,54305,,323,0,"CAMINUL CULTURAL TICVANIUL MARE","TICVANIU MARE",69,54305,0,3,539,396,296,100,386,10,600,204,193,193,
11,"CARAS-SEVERIN",118,54305,,324,0,"SCOALA GENERALA SAT TICVANIU MIC","TICVANIU MARE",69,54305,0,3,244,210,133,77,206,4,250,40,76,130,
11,"CARAS-SEVERIN",118,54305,,325,0,"SCOALA GENERALA SAT CARNECEA","TICVANIU MARE",69,54305,0,3,299,227,151,76,223,4,350,123,116,107,
11,"CARAS-SEVERIN",118,54305,,326,0,"SCOALA GENERALA SAT SECASENI","TICVANIU MARE",69,54305,0,3,226,168,102,66,164,4,250,82,83,81,
11,"CARAS-SEVERIN",118,54387,,327,0,"CAMINUL CULTURAL TOPLET","TOPLET",70,54387,0,3,1482,788,664,124,783,5,1600,812,330,453,
11,"CARAS-SEVERIN",118,54387,,328,0,"SCOALA GENERALA SAT BARZA","TOPLET",70,54387,0,3,709,649,356,293,643,6,800,151,256,387,
11,"CARAS-SEVERIN",118,54412,,329,0,"SCOALA CU CLS.I-VIII TURNU RUIENI","TURNU RUIENI",71,54412,0,3,699,430,342,88,430,0,800,370,133,297,
11,"CARAS-SEVERIN",118,54412,,330,0,"SCOALA CU CLS.I-VIII SAT BORLOVA","TURNU RUIENI",71,54412,0,3,1050,600,528,72,588,12,1150,550,173,415,
11,"CARAS-SEVERIN",118,54412,,331,0,"SCOALA GENERALA CLS.I-VIII SAT ZERVESTI","TURNU RUIENI",71,54412,0,3,626,363,306,57,355,8,700,337,180,175,
11,"CARAS-SEVERIN",118,54412,,332,0,"SCOALA CU CLS.I-IV SAT ZLAGNA","TURNU RUIENI",71,54412,0,3,282,263,238,25,261,2,302,39,148,113,
11,"CARAS-SEVERIN",118,54485,,333,0,"SCOALA GENERALA VALIUG NR.41","VALIUG",72,54485,0,3,718,425,343,82,420,5,800,375,175,245,
11,"CARAS-SEVERIN",118,54500,,334,0,"GRADINITA DE COPII SAT VARADIA","VARADIA",73,54500,0,3,667,353,281,72,345,8,750,397,175,170,
11,"CARAS-SEVERIN",118,54500,,335,0,"FOSTUL SEDIU CAP SAT MERCINA","VARADIA",73,54500,0,3,398,272,223,49,263,9,450,178,137,126,
11,"CARAS-SEVERIN",118,54537,,336,0,"CAMINUL CULTURAL VERMES","VERMES",74,54537,0,3,946,585,535,50,585,0,1050,465,295,290,
11,"CARAS-SEVERIN",118,54537,,337,0,"SCOALA PRIMARA SAT IZGAR","VERMES",74,54537,0,3,298,189,160,29,186,3,350,161,71,115,
11,"CARAS-SEVERIN",118,54537,,338,0,"SCOALA PRIMARA SAT IERSIG","VERMES",74,54537,0,3,217,155,117,38,153,2,250,95,53,100,
11,"CARAS-SEVERIN",118,54573,,339,0,"SCOALA GENERALA CLS.I-IV VRANI","VRANI",75,54573,0,3,796,554,447,107,545,9,900,346,304,241,
11,"CARAS-SEVERIN",118,54617,,340,0,"CAMINUL CULTURAL ZAVOI","ZAVOI",76,54617,0,3,1394,903,767,136,903,0,1450,547,495,408,
11,"CARAS-SEVERIN",118,54617,,341,0,"CAMINUL CULTURAL SAT VOISLOVA","ZAVOI",76,54617,0,3,447,344,279,65,340,4,500,156,159,181,
11,"CARAS-SEVERIN",118,54617,,342,0,"CAMINUL CULTURAL SAT MAGURA","ZAVOI",76,54617,0,3,395,334,287,47,332,2,450,116,184,148,
11,"CARAS-SEVERIN",118,54617,,343,0,"CAMIN CULTURAL MARU","ZAVOI",76,54617,0,3,777,694,472,222,684,10,850,156,304,380,
11,"CARAS-SEVERIN",118,54617,,344,0,"CASA PRIMARIEI SAT POIANA MARULUI","ZAVOI",76,54617,0,3,34,42,11,31,42,0,50,8,35,7,
11,"CARAS-SEVERIN",118,54699,,345,0,"SCOALA GENERALA ZORLENTU MARE","ZORLENTU MARE",77,54699,0,3,683,398,228,170,395,3,750,352,155,240,
11,"CARAS-SEVERIN",118,54699,,346,0,"CAMIN CULTURAL SAT ZORLENCIOR","ZORLENTU MARE",77,54699,0,3,83,100,47,53,98,2,100,0,38,60,
12,"CALARASI",519,92569,,1,0,"SCOALA GEN. NR. 1 , STR. BUCURESTI NR.159","MUNICIPIUL CALARASI",1,92569,1,1,1439,842,714,128,822,20,2300,1458,598,224,
12,"CALARASI",519,92569,,2,0,"LICEUL ECONOMIC , STR. 1 DECEMBRIE 1918 NR.98","MUNICIPIUL CALARASI",1,92569,1,1,1955,1156,1015,141,1128,28,3104,1948,814,314,
12,"CALARASI",519,92569,,3,0,"LICEUL STIRBEI VODA , STR. EROILOR REVOLUTIEI DIN DEC 1989 NR.36","MUNICIPIUL CALARASI",1,92569,1,1,1409,882,726,156,863,19,1500,618,587,276,
12,"CALARASI",519,92569,,4,0,"SCOALA GEN. NR. 4 ANEXE , STR. ALEXANDRU SAHIA NR.9","MUNICIPIUL CALARASI",1,92569,1,1,1720,1073,798,275,1058,15,2200,1127,741,317,
12,"CALARASI",519,92569,,5,0,"LICEUL STIRBEI VODA , STR. EROILOR REVOLUTIEI DIN 22 DECEMBRIE 1989 NR. 36","MUNICIPIUL CALARASI",1,92569,1,1,1233,668,573,95,661,7,1300,632,496,165,
12,"CALARASI",519,92569,,6,0,"GRADINITA NR. 5 , STR. GRIVITA NR.98","MUNICIPIUL CALARASI",1,92569,1,1,1532,792,657,135,782,10,1700,908,551,231,
12,"CALARASI",519,92569,,7,0,"SCOALA GENERALA NR. 5 ANEXE , STR. STADIONULUI NR. 27","MUNICIPIUL CALARASI",1,92569,1,1,2448,1372,1209,163,1359,13,3200,1828,992,367,
12,"CALARASI",519,92569,,8,0,"GRADINITA CATEX MICRO 6 , ALLEA CENTRALA","MUNICIPIUL CALARASI",1,92569,1,1,1794,989,880,109,981,8,1500,511,714,267,
12,"CALARASI",519,92569,,9,0,"GRUP SCOLAR AGRICOL , STR. PREL BUCURESTI NR.4","MUNICIPIUL CALARASI",1,92569,1,1,2043,989,868,121,974,15,2200,1211,649,325,
12,"CALARASI",519,92569,,10,0,"SCOALA GEN.NR.5,B-DUL N.TITULESCU NR. 2","MUNICIPIUL CALARASI",1,92569,1,1,2009,1042,788,254,1023,19,1900,858,714,309,
12,"CALARASI",519,92569,,11,0,"LICEUL MIHAI EMINESCU , STR.PREL. BUCURESTI NR.14","MUNICIPIUL CALARASI",1,92569,1,1,1234,756,550,206,747,9,1300,544,497,250,
12,"CALARASI",519,92569,,12,0,"GRADINITA NR.11","MUNICIPIUL CALARASI",1,92569,1,1,1917,1017,773,244,1007,10,2000,983,686,321,
12,"CALARASI",519,92569,,13,0,"GRADINITA NR. 12 , STR. BARAGANULUI","MUNICIPIUL CALARASI",1,92569,1,1,1523,788,720,68,779,9,1603,815,554,225,
12,"CALARASI",519,92569,,14,0,"GRUPUL SCOLAR DANUBIUS , STR. STIRBEI VODA NR. 1","MUNICIPIUL CALARASI",1,92569,1,1,2079,1059,864,195,1044,15,2200,1141,654,390,
12,"CALARASI",519,92569,,15,0,"SCOALA GEN. NR. 2 , STR. GRIVITA NR.188","MUNICIPIUL CALARASI",1,92569,1,1,1124,692,585,107,685,7,1200,508,491,194,
12,"CALARASI",519,92569,,16,0,"CRESEA CU 100 LOCURI , STR. ALEEA MUSETELULUI","MUNICIPIUL CALARASI",1,92569,1,1,2685,1411,1063,348,1392,19,2900,1489,888,504,
12,"CALARASI",519,92569,,17,0,"SCOALA GEN. NR. 11 , STR. MACULUI","MUNICIPIUL CALARASI",1,92569,1,1,2681,1301,1085,216,1286,14,2908,1607,866,420,
12,"CALARASI",519,92569,,18,0,"SCOALA GEN. NR. 10 , STR. PREL. BUCURESTI NR. 6","MUNICIPIUL CALARASI",1,92569,1,1,1891,972,712,260,961,11,2000,1028,647,314,
12,"CALARASI",519,92569,,19,0,"LICEUL MIHAI EMINESCU , STR. PREL. BUCURESTI NR. 14","MUNICIPIUL CALARASI",1,92569,1,1,1132,661,534,127,653,8,1000,339,423,230,
12,"CALARASI",519,92569,,20,0,"SCOALA GEN. NR. 8 , STR. PREL. BUCURESTI NR. 161","MUNICIPIUL CALARASI",1,92569,1,1,2008,1130,922,208,1116,14,1800,670,741,375,
12,"CALARASI",519,92569,,21,0,"SCOALA GEN. NR. 8 ,STR. PREL BUCURESTI NR. 161","MUNICIPIUL CALARASI",1,92569,1,1,2013,1054,787,267,1050,4,2200,1146,691,359,
12,"CALARASI",519,92569,,22,0,"SCOALA GEN. NR. 8 ANEXA DIN STR. CRANGULUI NR. 20","MUNICIPIUL CALARASI",1,92569,1,1,2120,1265,1161,104,1243,22,2300,1035,900,343,
12,"CALARASI",519,92569,,23,0,"SCOALA GENERALA NR. 8 ANEXA , STR. CRANGULUI NR. 20","MUNICIPIUL CALARASI",1,92569,1,1,2065,1148,981,167,1129,19,2200,1052,827,302,
12,"CALARASI",519,92569,,24,0,"GRUPUL SCOLAR AUTO , STR. SLOBOZIEI NR. 2","MUNICIPIUL CALARASI",1,92569,1,1,1555,1019,842,177,1000,19,1700,681,695,305,
12,"CALARASI",519,92569,,25,0,"SCOALA GENERALA NR. 9, STR. GRIVITA NR. 343","MUNICIPIUL CALARASI",1,92569,1,1,1152,766,670,96,752,14,1189,423,481,271,
12,"CALARASI",519,92569,,26,0,"SCOALA GENERALA NR. 1 , STR. BUCURESTI NR. 159","MUNICIPIUL CALARASI",1,92569,1,1,996,603,509,94,591,12,1300,697,424,167,
12,"CALARASI",519,92569,,27,0,"SCOALA GENERALA NR. 9 , STR. GRIVITA NR.343","MUNICIPIUL CALARASI",1,92569,1,1,1920,1085,942,143,1075,10,2100,1015,704,371,
12,"CALARASI",519,92569,,28,0,"ALIMENTARA ABATOR , STR. PACII","MUNICIPIUL CALARASI",1,92569,1,1,1938,1190,1073,117,1164,26,2100,910,753,411,
12,"CALARASI",519,92569,,29,0,"GRADINITA CU PROGRAM NORMAL , STR. BUCURESTI NR. 227","MUNICIPIUL CALARASI",1,92569,1,1,1804,894,817,77,884,10,1900,1006,619,265,
12,"CALARASI",519,92569,,30,0,"GRUPUL SCOLAR AGRICOL  STR. PREL. BUCURESTI NR. 4","MUNICIPIUL CALARASI",1,92569,1,1,2132,892,701,191,873,19,1800,908,598,275,
12,"CALARASI",519,92569,,31,0,"SCOALA GEN. NR. 11 , STR.BORDAREA BELSUGULUI","MUNICIPIUL CALARASI",1,92569,1,1,1930,1036,868,168,1031,5,1400,364,671,360,
12,"CALARASI",519,92569,,32,0,"CRESA CU ORAR PRELUNGIT , STR. DUNARII NR. 1","MUNICIPIUL CALARASI",1,92569,1,1,1947,1055,828,227,1044,11,2100,1045,674,370,
12,"CALARASI",519,92569,,33,0,"SCOALA GEN. NR. 10 , STR. PRELUNGIREA BUCURESTI NR. 6","MUNICIPIUL CALARASI",1,92569,1,1,2028,942,736,206,931,11,2000,1058,618,313,
12,"CALARASI",519,92569,,34,0,"GRUPUL SCOLAR DANUBIUS , STR. STIRBEI VODA NR.1","MUNICIPIUL CALARASI",1,92569,1,1,2260,1298,1025,273,1283,15,2400,1102,855,428,
12,"CALARASI",519,92569,,35,1,"SPITALUL JUDETEAN CALARASI","MUNICIPIUL CALARASI",1,92569,1,1,0,607,0,607,604,3,801,194,475,129,
12,"CALARASI",519,92569,,36,1,"SEDIUL U.M. 01438 CALARASI","MUNICIPIUL CALARASI",1,92569,1,1,0,531,0,531,514,17,600,69,297,217,
12,"CALARASI",519,100610,,37,0,"SCOALA GEN. NR. 5 , STR. MIHAI EMINESCU NR. 17","MUNICIPIUL OLTENITA",2,100610,1,1,1990,1218,1138,80,1203,15,2200,982,986,217,
12,"CALARASI",519,100610,,38,0,"CANTINA DE AJUTOR SOCIAL , STR. TRAIAN NR. 16","MUNICIPIUL OLTENITA",2,100610,1,1,2115,1146,1093,53,1139,7,2300,1154,900,239,
12,"CALARASI",519,100610,,39,0,"SCOALA GENERALA NR. 2 , STR. ARGESULUI NR. 10","MUNICIPIUL OLTENITA",2,100610,1,1,2151,1064,989,75,1052,12,2400,1336,769,283,
12,"CALARASI",519,100610,,40,0,"CLUBUL NAVOL , STR. ARGESULUI NR. 76","MUNICIPIUL OLTENITA",2,100610,1,1,1954,1037,955,82,1028,9,2100,1063,767,261,
12,"CALARASI",519,100610,,41,0,"CLUBUL TINERETULUI , ALLEA FLACARA NR. 2","MUNICIPIUL OLTENITA",2,100610,1,1,2008,1099,1008,91,1090,9,2208,1109,789,301,
12,"CALARASI",519,100610,,42,0,"SCOALA GEN. NR. 1 , STR. MIHAI EMINESCU NR. 23","MUNICIPIUL OLTENITA",2,100610,1,1,1847,1245,879,366,1235,10,2000,755,904,331,
12,"CALARASI",519,100610,,43,0,"LICEUL NEAGOE BASARAB , B-DUL TINERETULUI NR. 157","MUNICIPIUL OLTENITA",2,100610,1,1,1848,1243,989,254,1225,18,2006,763,925,300,
12,"CALARASI",519,100610,,44,0,"SCOALA GENERALA NR. 6 , B-DUL MARASESTI NR. 23","MUNICIPIUL OLTENITA",2,100610,1,1,1742,947,751,196,941,6,1900,953,718,223,
12,"CALARASI",519,100610,,45,0,"GRADINITA NR. 3 OLTENITA , B-DUL MARASESTI NR. 28","MUNICIPIUL OLTENITA",2,100610,1,1,1592,828,712,116,821,7,1700,872,600,221,
12,"CALARASI",519,100610,,46,0,"GRUPUL SCOLAR ARTE-MESERII , STR. CUZA-VODA NR. 36","MUNICIPIUL OLTENITA",2,100610,1,1,2140,1043,982,61,1036,7,2300,1257,767,269,
12,"CALARASI",519,100610,,47,0,"SCOALA GEN. NR. 4 , STR. RAZBOIENI NR. 7","MUNICIPIUL OLTENITA",2,100610,1,1,1726,899,764,135,894,5,1900,1001,739,155,
12,"CALARASI",519,100610,,48,0,"SCOALA GEN. NR. 3 (LOCAL NOU) , B-DUL 22 DECEMBRIE NR. 76","MUNICIPIUL OLTENITA",2,100610,1,1,1317,732,686,46,718,14,1400,668,578,140,
12,"CALARASI",519,100610,,49,0,"SCOALA GEN. NR. 3 (LOCAL VECHI) , STR. SPIRU HARET NR. 3","MUNICIPIUL OLTENITA",2,100610,1,1,1592,1072,1030,42,1030,12,1700,658,826,204,
12,"CALARASI",519,101458,,50,0,"SCOALA GEN. BUDESTI","ORAS BUDESTI",3,101458,2,1,1989,903,744,159,882,21,2100,1197,676,206,
12,"CALARASI",519,101458,,51,0,"SCOALA GEN. BUDESTI","ORAS BUDESTI",3,101458,2,1,1453,602,497,105,583,19,1502,900,462,121,
12,"CALARASI",519,101458,,52,0,"SCOALA GEN. APROZI","ORAS BUDESTI",3,101458,2,1,853,569,407,162,557,12,900,331,418,139,
12,"CALARASI",519,101458,,53,0,"SCOALA GEN. BUCIUMENI","ORAS BUDESTI",3,101458,2,1,219,380,143,237,372,8,400,20,306,66,
12,"CALARASI",519,101458,,54,0,"SCOALA GEN. GRUIU","ORAS BUDESTI",3,101458,2,1,881,460,333,127,448,12,801,341,261,187,
12,"CALARASI",519,101458,,55,0,"SCOALA GEN. CRIVAT","ORAS BUDESTI",3,101458,2,1,922,537,458,79,525,10,993,456,279,246,
12,"CALARASI",519,101458,,56,0,"SCOALA GEN. CRIVAT","ORAS BUDESTI",3,101458,2,1,1015,538,468,70,526,12,1100,562,282,244,
12,"CALARASI",519,103032,,57,0,"I.C.C.P.T. FUNDULEA","ORAS FUNDULEA",4,103032,2,1,735,497,321,176,485,12,800,303,377,108,
12,"CALARASI",519,103032,,58,0,"GRADINITA NR. 1 FUNDULEA","ORAS FUNDULEA",4,103032,2,1,898,622,335,287,610,11,1000,378,470,140,
12,"CALARASI",519,103032,,59,0,"SCOALA GEN. NR. 1 FUNDULEA","ORAS FUNDULEA",4,103032,2,1,1816,555,449,106,539,16,2000,1445,387,152,
12,"CALARASI",519,103032,,60,0,"SCOALA GEN. CRANG","ORAS FUNDULEA",4,103032,2,1,844,565,373,192,548,17,903,337,383,165,
12,"CALARASI",519,103032,,61,0,"SCOALA GEN. GOSTILELE","ORAS FUNDULEA",4,103032,2,1,544,419,277,142,406,13,603,184,278,128,
12,"CALARASI",519,93888,,62,0,"SEDIUL PRIMARIEI ORASULUI LEHLIU-GARA","ORAS LEHLIU GARA",5,93888,2,1,3153,1684,1445,239,1656,28,3400,1716,1206,450,
12,"CALARASI",519,93888,,63,0,"SCOALA GEN. BUZOIENI","ORAS LEHLIU GARA",5,93888,2,1,415,308,230,78,300,8,500,192,212,88,
12,"CALARASI",519,93888,,64,0,"SCOALA GEN. RAZVANI","ORAS LEHLIU GARA",5,93888,2,1,1711,962,838,124,935,27,1800,838,654,281,
12,"CALARASI",519,94125,,65,0,"SCOALA GEN. - SATUL NICOLAE BALCESCU","ALEXANDRU ODOBESCU",6,94125,0,3,1128,773,660,113,758,15,1200,427,557,201,
12,"CALARASI",519,94125,,66,0,"SCOALA GEN. - SATUL ALEXANDRU ODOBESCU","ALEXANDRU ODOBESCU",6,94125,0,3,1250,837,712,125,825,12,1300,463,549,276,
12,"CALARASI",519,101083,,67,0,"SCOALA GEN. BELCIUGATELE","BELCIUGATELE",7,101083,0,3,1139,780,659,121,768,12,1200,420,546,222,
12,"CALARASI",519,101083,,68,0,"SCOALA GEN. MARIUTA","BELCIUGATELE",7,101083,0,3,498,390,297,93,377,13,490,100,257,120,
12,"CALARASI",519,92961,,69,0,"SCOALA GEN. NR. 3 PIETROIU","BORCEA",8,92961,0,3,2211,1702,1620,82,1689,13,2402,700,1396,293,
12,"CALARASI",519,92961,,70,0,"CLUBUL ELEVILOR BORCEA","BORCEA",8,92961,0,3,1474,1429,1269,160,1414,15,1600,171,1030,384,
12,"CALARASI",519,92961,,71,0,"SCOALA GEN. NR. 1 BORCEA","BORCEA",8,92961,0,3,1608,1054,721,333,1044,10,1700,646,788,256,
12,"CALARASI",519,92961,,72,0,"SCOALA GEN. NR. 2 BORCEA","BORCEA",8,92961,0,3,1892,1410,1370,40,1393,17,2000,590,959,434,
12,"CALARASI",519,92961,,73,1,"UNITATEA MILITARA BARAGANU","BORCEA",8,92961,0,3,56,249,16,233,247,2,300,51,126,121,
12,"CALARASI",519,101724,,74,0,"CAMINUL CULTURAL CASCIOARELE","CASCIOARELE",9,101724,0,3,1877,868,807,61,849,19,2000,1132,543,306,
12,"CALARASI",519,101804,,75,0,"SCOALA GEN. NR. 1 CHIRNOGI","CHARNOGI",10,101804,0,3,2328,1096,964,132,1078,18,2500,1404,813,265,
12,"CALARASI",519,101804,,76,0,"SCOALA GEN. NR. 2 CHIRNOGI","CHARNOGI",10,101804,0,3,1916,1064,910,154,1054,10,2100,1036,774,280,
12,"CALARASI",519,101804,,77,0,"SCOALA GEN. NR. 3 CHIRNOGI","CHARNOGI",10,101804,0,3,2075,1126,956,170,1109,17,2300,1174,820,289,
12,"CALARASI",519,101822,,78,0,"SCOALA GEN. NR. 1 CHISELET","CHISELET",11,101822,0,3,2379,1161,965,196,1131,30,2400,1239,857,274,
12,"CALARASI",519,101822,,79,0,"SCOALA GEN. NR. 2 CHISELET","CHISELET",11,101822,0,3,472,502,254,248,495,7,700,198,370,125,
12,"CALARASI",519,93085,,80,0,"SCOALA GEN. SMARDAN","CIOCANESTI",12,93085,0,3,882,646,503,143,637,9,900,254,493,144,
12,"CALARASI",519,93085,,81,0,"SCOALA GEN. MARGINENI","CIOCANESTI",12,93085,0,3,1480,940,784,156,926,14,1600,660,722,204,
12,"CALARASI",519,93085,,82,0,"SCOALA GEN. ANDOLINA","CIOCANESTI",12,93085,0,3,1520,910,725,185,887,23,1600,690,664,223,
12,"CALARASI",519,102419,,83,0,"SCOALA GEN. NR. 1 CURCANI (CORP A)","CURCANI",13,102419,0,3,1956,971,856,115,957,14,2100,1129,690,267,
12,"CALARASI",519,102419,,84,0,"SCOALA GEN. NR. 1 CURCANI (CORP C)","CURCANI",13,102419,0,3,1932,906,738,168,869,21,2100,1194,643,226,
12,"CALARASI",519,93281,,85,0,"SCOALA GEN. CEACU","CUZA VODA",14,93281,0,3,1058,709,554,155,696,13,1100,391,486,210,
12,"CALARASI",519,93281,,86,0,"SCOALA GEN. CUZA-VODA","CUZA VODA",14,93281,0,3,1485,962,766,196,938,24,1600,638,673,265,
12,"CALARASI",519,93281,,87,0,"SCOALA GEN. CALARASII VECHI","CUZA VODA",14,93281,0,3,552,467,364,103,458,9,600,133,347,111,
12,"CALARASI",519,93325,,88,0,"SCOALA GEN. DICHISENI","DICHISENI",15,93325,0,3,1429,862,755,107,852,10,1500,638,473,379,
12,"CALARASI",519,93370,,89,0,"SCOALA GEN. DOR-MARUNT GARA","DOR MARUNT",16,93370,0,3,1967,850,584,266,823,27,2200,1350,528,295,
12,"CALARASI",519,93370,,90,0,"SCOALA GEN. DOR-MARUNT SAT","DOR MARUNT",16,93370,0,3,1404,969,647,322,957,12,1500,531,766,191,
12,"CALARASI",519,93370,,91,0,"SCOALA GEN. INFRATIREA","DOR MARUNT",16,93370,0,3,204,292,104,188,288,4,299,7,200,88,
12,"CALARASI",519,93370,,92,0,"SCOALA GEN. PELINU","DOR MARUNT",16,93370,0,3,88,87,32,55,87,0,100,13,56,31,
12,"CALARASI",519,93370,,93,0,"SCOALA GEN. DALGA GARA","DOR MARUNT",16,93370,0,3,1362,766,504,262,752,14,1400,634,474,278,
12,"CALARASI",519,93441,,94,0,"SCOALA GEN. DOROBANTU","DOROBANTU",17,93441,0,3,1426,775,629,146,755,20,1500,725,501,254,
12,"CALARASI",519,93441,,95,0,"SCOALA GEN. VARASTI","DOROBANTU",17,93441,0,3,947,660,517,143,639,21,1000,340,436,203,
12,"CALARASI",519,93441,,96,0,"SCOALA GEN. BOSNEAGU","DOROBANTU",17,93441,0,3,404,306,204,102,296,10,500,194,244,52,
12,"CALARASI",519,93487,,97,0,"SCOALA GEN. NR. 1 DRAGALINA","DRAGALINA",18,93487,0,3,2296,1110,818,292,1092,18,2500,1390,721,371,
12,"CALARASI",519,93487,,98,0,"SCOALA GEN. NR. 2 DRAGALINA (SCOALA INTERNAT)","DRAGALINA",18,93487,0,3,2439,1329,920,409,1296,33,2600,1271,922,374,
12,"CALARASI",519,93487,,99,0,"SCOALA GEN. DRAJNA","DRAGALINA",18,93487,0,3,1008,649,466,183,639,10,1100,451,380,259,
12,"CALARASI",519,93487,,100,0,"SCOALA GEN. C.BRINCOVEANU","DRAGALINA",18,93487,0,3,738,501,359,142,496,5,801,300,324,172,
12,"CALARASI",519,93539,,101,0,"SCOALA GEN. DRAGOS-VODA","DRAGOS VODA",19,93539,0,3,1861,1079,844,235,1060,19,2000,921,681,379,
12,"CALARASI",519,93539,,102,0,"SCOALA GEN. SOCOALELE","DRAGOS VODA",19,93539,0,3,240,173,118,55,170,3,300,127,106,64,
12,"CALARASI",519,102838,,103,0,"SCOALA GEN. FRASINET","FRASINET",20,102838,0,3,1101,532,438,94,522,10,1200,668,391,131,
12,"CALARASI",519,102838,,104,0,"SCOALA GEN. LUPTATORI","FRASINET",20,102838,0,3,495,402,264,138,393,9,500,98,325,68,
12,"CALARASI",519,102945,,105,0,"SCOALA GEN. FRUMUSANI","FRUMUSANI",21,102945,0,3,2224,969,737,232,930,39,2400,1431,666,264,
12,"CALARASI",519,102945,,106,0,"SCOALA GEN. ORASTI","FRUMUSANI",21,102945,0,3,1297,509,330,179,495,14,1400,891,325,170,
12,"CALARASI",519,103014,,107,0,"AGROINDUSTRIALA FRUNZANESTI","FUNDENI",22,103014,0,3,1834,842,693,149,819,23,2000,1158,601,218,
12,"CALARASI",519,103014,,108,0,"SCOALA GEN. FUNDENI","FUNDENI",22,103014,0,3,2028,908,739,169,886,22,2200,1292,611,275,
12,"CALARASI",519,93664,,109,0,"SCOALA VECHE GRADISTEA","GRADISTEA",23,93664,0,3,1723,1259,1073,186,1243,16,1900,641,944,299,
12,"CALARASI",519,93664,,110,0,"SCOALA GEN. CUNESTI","GRADISTEA",23,93664,0,3,729,541,439,102,534,7,800,259,396,138,
12,"CALARASI",519,93664,,111,0,"SCOALA VECHE RASA","GRADISTEA",23,93664,0,3,1148,730,578,152,723,7,1200,470,491,232,
12,"CALARASI",519,93664,,112,0,"SCOALA GEN. BOGATA","GRADISTEA",23,93664,0,3,446,400,277,123,395,5,500,100,264,131,
12,"CALARASI",519,103568,,113,0,"SCOALA GEN. GURBANESTI","GURBANESTI",24,103568,0,3,1119,541,438,103,534,7,1200,659,396,138,
12,"CALARASI",519,103568,,114,0,"SCOALA GEN. VALEA PRESNEI","GURBANESTI",24,103568,0,3,220,187,131,56,183,4,300,113,155,28,
12,"CALARASI",519,103764,,115,0,"CAMINUL CULTURAL ILEANA","ILEANA",25,103764,0,3,876,536,387,149,529,7,900,364,345,184,
12,"CALARASI",519,103764,,116,0,"CAMINUL CULTURAL STEFANESTI","ILEANA",25,103764,0,3,767,450,325,125,445,5,800,350,326,119,
12,"CALARASI",519,103764,,117,0,"SCOALA GEN. FLORICA","ILEANA",25,103764,0,3,606,413,285,128,401,12,702,289,287,114,
12,"CALARASI",519,103764,,118,0,"SCOALA GEN.ARTARI","ILEANA",25,103764,0,3,698,455,321,134,444,11,700,244,375,69,
12,"CALARASI",519,93771,,119,0,"GRADINITA DE COPII INDEPENDENTA","INDEPENDENTA",26,93771,0,3,1914,1133,1059,74,1108,25,2100,967,825,283,
12,"CALARASI",519,93771,,120,0,"SCOALA GEN. POTCOAVA","INDEPENDENTA",26,93771,0,3,743,693,578,115,677,16,800,107,495,182,
12,"CALARASI",519,93771,,121,0,"GRADINITA DE COPII VISINI","INDEPENDENTA",26,93771,0,3,455,371,291,80,365,6,500,129,274,91,
12,"CALARASI",519,93815,,122,0,"SCOALA GEN. JEGALIA","JEGALIA",27,93815,0,3,1869,1094,987,107,1076,18,2002,908,752,324,
12,"CALARASI",519,93815,,123,0,"SCOALA GEN. GALDAU","JEGALIA",27,93815,0,3,1214,847,715,132,831,16,1300,453,602,229,
12,"CALARASI",519,93815,,124,0,"SCOALA GEN. IEZERU","JEGALIA",27,93815,0,3,774,602,498,104,594,8,800,198,445,149,
12,"CALARASI",519,93851,,125,0,"CAMINUL CULTURAL LEHLIU","LEHLIU",28,93851,0,3,1482,894,783,111,874,20,1600,706,583,291,
12,"CALARASI",519,93851,,126,0,"SCOALA GEN. SAPUNARI","LEHLIU",28,93851,0,3,789,423,377,46,415,8,802,379,315,100,
12,"CALARASI",519,104083,,127,0,"SCOALA GEN. LUICA","LUICA",29,104083,0,3,1334,832,705,127,816,16,1400,568,589,227,
12,"CALARASI",519,104083,,128,0,"SCOALA GEN. VALEA STINII","LUICA",29,104083,0,3,247,365,247,118,354,11,500,135,271,83,
12,"CALARASI",519,93931,,129,0,"SCOALA GEN. NUCETU","LUPSANU",30,93931,0,3,512,426,304,122,417,9,600,174,309,108,
12,"CALARASI",519,93931,,130,0,"SCOALA GEN. LUPSANU","LUPSANU",30,93931,0,3,684,334,286,48,325,9,700,366,270,55,
12,"CALARASI",519,93931,,131,0,"SCOALA GEN. RADU VODA","LUPSANU",30,93931,0,3,1059,728,611,117,726,2,1100,372,569,157,
12,"CALARASI",519,93931,,132,0,"SCOALA GEN. PLEVNA","LUPSANU",30,93931,0,3,684,374,313,61,361,13,700,326,296,65,
12,"CALARASI",519,100638,,133,0,"SCOALA GEN. MITRENI","MITRENI",32,100638,0,3,1440,740,623,117,732,8,1500,760,471,261,
12,"CALARASI",519,100638,,134,0,"SCOALA GEN. VALEA ROSIE","MITRENI",32,100638,0,3,1865,920,808,112,901,19,2000,1080,701,200,
12,"CALARASI",519,100638,,135,0,"SCOALA GEN. CLATESTI","MITRENI",32,100638,0,3,570,380,311,69,377,3,600,220,277,100,
12,"CALARASI",519,104181,,136,0,"SCOALA GEN. MINASTIREA","MANASTIREA",31,104181,0,3,1381,865,721,144,848,17,1800,935,646,202,
12,"CALARASI",519,104181,,137,0,"SEDIUL FOSTULUI CAP MINASTIREA","MANASTIREA",31,104181,0,3,1663,857,712,145,841,14,1600,742,602,239,
12,"CALARASI",519,104181,,138,0,"SCOALA GEN. COCONI","MANASTIREA",31,104181,0,3,969,523,453,70,500,23,1000,477,341,159,
12,"CALARASI",519,104181,,139,0,"SCOALA GEN. SULTANA","MANASTIREA",31,104181,0,3,860,581,473,108,571,10,800,219,415,156,
12,"CALARASI",519,92587,,140,0,"SCOALA GEN. NR. 1 MODELU","MODELU",33,92587,0,3,2437,1424,1250,174,1402,22,2600,1176,887,515,
12,"CALARASI",519,92587,,141,0,"CAMINUL CULTURAL MODELU","MODELU",33,92587,0,3,1588,987,786,201,976,11,1700,713,653,323,
12,"CALARASI",519,92587,,142,0,"SCOALA GEN. NR. 2 MODELU","MODELU",33,92587,0,3,1784,1012,870,142,978,34,1900,854,676,302,
12,"CALARASI",519,92587,,143,0,"SCOALA GEN. TONEA","MODELU",33,92587,0,3,1293,604,437,167,580,24,1400,796,426,154,
12,"CALARASI",519,104323,,144,0,"SCOALA GEN. NR. 1 NANA","NANA",34,104323,0,3,2101,1139,1026,113,1110,29,2300,1161,768,342,
12,"CALARASI",519,104341,,145,0,"CAMINUL CULTURAL SAT N.BALCESCU","NICOLAE BALCESCU",35,104341,0,3,1246,742,592,150,720,22,1300,558,542,178,
12,"CALARASI",519,94223,,146,0,"SCOALA GEN. PERISORU","PERISORU",36,94223,0,3,1528,999,879,120,994,5,1500,501,611,383,
12,"CALARASI",519,94223,,147,0,"SCOALA GEN. PERISORU","PERISORU",36,94223,0,3,1650,990,822,168,984,6,1800,810,597,387,
12,"CALARASI",519,94223,,148,0,"SCOALA GEN. TUDOR VLADIMIRESCU","PERISORU",36,94223,0,3,664,545,409,136,541,4,700,155,283,258,
12,"CALARASI",519,94223,,149,1,"U.M. 02445 JEGALIA","PERISORU",36,94223,0,3,0,138,0,138,137,1,200,62,94,43,
12,"CALARASI",519,104635,,150,0,"CAMINUL CULTURAL PLATARESTI","PLATARESTI",37,104635,0,3,1228,614,435,179,607,7,1302,688,430,177,
12,"CALARASI",519,104635,,151,0,"SCOALA GEN. PODUL PITARULUI","PLATARESTI",37,104635,0,3,801,382,253,129,375,7,900,518,267,108,
12,"CALARASI",519,104635,,152,0,"SCOALA GEN. DOROBANTU","PLATARESTI",37,104635,0,3,950,529,365,164,521,8,1000,471,410,111,
12,"CALARASI",519,104751,,153,0,"SCOALA GEN. NR. 1 RADOVANU (LOCAL NOU)","RADOVANU",38,104751,0,3,1690,576,499,77,568,8,1800,1224,404,164,
12,"CALARASI",519,104751,,154,0,"SCOALA GEN. NR. 1 RADOVANU (LOCAL VECHI)","RADOVANU",38,104751,0,3,1005,557,445,112,546,11,1100,543,350,196,
12,"CALARASI",519,104751,,155,0,"SCOALA GEN. COADELE","RADOVANU",38,104751,0,3,1124,681,516,165,676,5,1200,519,439,237,
12,"CALARASI",519,104751,,156,0,"SCOALA GEN. VALEA POPII","RADOVANU",38,104751,0,3,555,377,306,71,371,6,600,223,282,89,
12,"CALARASI",519,94312,,157,0,"SCOALA GEN. NR. 1 (CENTRU ROSETI)","ROSETI",39,94312,0,3,2468,1420,1298,122,1380,40,2700,1280,1031,349,
12,"CALARASI",519,94312,,158,0,"SCOALA GEN. NR. 2 (DEAL) ROSETI","ROSETI",39,94312,0,3,1916,1225,1082,143,1209,16,2100,875,735,474,
12,"CALARASI",519,104886,,159,0,"SCOALA GEN. SARULESTI GARA","SARULESTI",40,104886,0,3,1027,567,442,125,557,10,1102,535,390,167,
12,"CALARASI",519,104886,,160,0,"SCOALA GEN. SARULESTI GARA","SARULESTI",40,104886,0,3,835,401,312,89,394,7,900,499,252,142,
12,"CALARASI",519,104886,,161,0,"SCOALA GEN. SOLACOLU","SARULESTI",40,104886,0,3,223,141,105,36,136,5,300,159,85,51,
12,"CALARASI",519,105222,,162,0,"SCOALA GEN. SOHATU","SOHATU",41,105222,0,3,1868,792,686,106,751,41,2010,1218,454,297,
12,"CALARASI",519,105222,,163,0,"SCOALA GEN. PROGRESU","SOHATU",41,105222,0,3,1123,605,482,123,588,17,1198,593,461,127,
12,"CALARASI",519,105259,,164,0,"SCOALA GEN. SPANTOV","SPANTOV",43,105259,0,3,1568,943,722,221,925,18,1700,757,724,201,
12,"CALARASI",519,105259,,165,0,"SCOALA GEN. STANCEA","SPANTOV",43,105259,0,3,1874,1305,1046,259,1277,28,2000,695,1057,220,
12,"CALARASI",519,105384,,166,0,"SCOALA GEN. SOLDANU","SOLDANU",42,105384,0,3,1939,1009,843,166,996,13,2009,1000,725,271,
12,"CALARASI",519,105384,,167,0,"SCOALA GEN. NEGOIESTI","SOLDANU",42,105384,0,3,803,494,386,108,482,12,800,306,334,148,
12,"CALARASI",519,94562,,168,0,"SCOALA GEN. NR. 1 STEFAN CEL MARE","STEFAN CEL MARE",44,94562,0,3,1412,876,876,0,866,10,1500,624,649,217,
12,"CALARASI",519,94562,,169,0,"SCOALA GEN. NR. 2 STEFAN CEL MARE","STEFAN CEL MARE",44,94562,0,3,1108,809,651,158,797,12,1200,391,579,218,
12,"CALARASI",519,94580,,170,0,"SCOALA GEN. NR. 1 STEFAN-VODA","STEFAN VODA",45,94580,0,3,1832,1289,1146,143,1268,21,2005,716,891,377,
12,"CALARASI",519,105455,,171,0,"SCOALA GEN. TAMADAU MARE","TAMADAU MARE",46,105455,0,3,1133,537,411,126,529,6,1203,668,390,139,
12,"CALARASI",519,105455,,172,0,"SCOALA GEN. PLUMBUITA","TAMADAU MARE",46,105455,0,3,745,402,291,111,394,8,813,411,267,127,
12,"CALARASI",519,105605,,173,0,"SCOALA GEN. NR. 1 ULMENI","ULMENI",47,105605,0,3,1567,780,687,93,761,19,1700,920,616,145,
12,"CALARASI",519,105605,,174,0,"SCOALA GEN. NR. 2 ULMENI","ULMENI",47,105605,0,3,1286,874,772,102,852,22,1400,526,755,97,
12,"CALARASI",519,105605,,175,0,"SCOALA GEN. NR. 3 ULMEMI","ULMENI",47,105605,0,3,1347,913,778,135,900,13,1400,487,659,241,
12,"CALARASI",519,94606,,176,0,"CAMINUL CULTURAL ULMU","ULMU",48,94606,0,3,920,832,706,126,815,17,1000,168,669,146,
12,"CALARASI",519,94606,,177,0,"ASOCIATIA AGRICOLA GLORIA SAT FAUREI","ULMU",48,94606,0,3,536,353,287,66,344,9,550,197,235,109,
12,"CALARASI",519,94606,,178,0,"SCOALA PRIMARA ZIMBRU","ULMU",48,94606,0,3,65,138,35,103,136,2,150,12,109,27,
12,"CALARASI",519,94651,,179,0,"SCOALA GEN. (LOCAL VECHI) UNIREA","UNIREA",49,94651,0,3,1126,560,495,65,546,14,1200,640,375,171,
12,"CALARASI",519,94651,,180,0,"CAMINUL CULTURAL UNIREA","UNIREA",49,94651,0,3,1332,727,670,57,720,7,1402,675,456,264,
12,"CALARASI",519,105712,,181,0,"SCOALA GEN. VALEA ARGOVEI","VALEA ARGOVEI",51,105712,0,3,1636,874,763,111,859,15,1800,926,765,94,
12,"CALARASI",519,105712,,182,0,"SCOALA GEN. SILISTEA","VALEA ARGOVEI",51,105712,0,3,673,485,398,87,476,9,700,215,360,116,
12,"CALARASI",519,105829,,183,0,"SCOALA GEN. NR. 1 VASILATI","VASILATI",52,105829,0,3,1234,573,400,173,564,9,1300,727,367,197,
12,"CALARASI",519,105829,,184,0,"SCOALA GEN. NR. 1 VASILATI","VASILATI",52,105829,0,3,1555,968,751,217,954,14,1700,732,676,278,
12,"CALARASI",519,105829,,185,0,"SCOALA GEN. GALBINASI","VASILATI",52,105829,0,3,2262,1038,800,238,1024,14,2400,1362,839,185,
12,"CALARASI",519,105829,,186,0,"SCOALA GEN. NUCI","VASILATI",52,105829,0,3,263,233,181,52,226,7,302,69,157,69,
12,"CALARASI",519,105829,,187,0,"SCOALA GEN. POPESTI","VASILATI",52,105829,0,3,270,242,161,81,239,3,300,58,181,58,
12,"CALARASI",519,94731,,188,0,"SCOALA GEN. VILCELELE","VALCELELE",50,94731,0,3,1120,720,623,97,703,17,1200,480,509,194,
12,"CALARASI",519,94731,,189,0,"SCOALA GEN. FLOROAICA","VALCELELE",50,94731,0,3,497,413,311,102,408,5,500,87,279,129,
12,"CALARASI",519,94768,,190,0,"SCOALA GEN. VLAD TEPES","VLAD TEPES",53,94768,0,3,1366,815,676,139,796,19,1500,685,546,250,
12,"CALARASI",519,94768,,191,0,"SCOALA GEN. MIHAI VITEAZU","VLAD TEPES",53,94768,0,3,786,572,444,128,554,18,800,228,397,157,
13,"CLUJ",127,54975,,1,0,"SCOALA NR.10, STR. ZORILOR NR. 27","MUNICIPIUL CLUJ-NAPOCA",1,54975,1,1,2802,1447,1316,131,1431,16,3051,1603,937,494,
13,"CLUJ",127,54975,,2,0,"SCOALA NR.10, STR. ZORILOR NR. 27","MUNICIPIUL CLUJ-NAPOCA",1,54975,1,1,2605,1343,1209,134,1330,13,2850,1507,921,409,
13,"CLUJ",127,54975,,3,0,"SCOALA NR.10, STR. ZORILOR NR. 27","MUNICIPIUL CLUJ-NAPOCA",1,54975,1,1,2424,1293,1203,90,1269,24,2675,1382,900,369,
13,"CLUJ",127,54975,,4,0,"GRADINITA NR.18, STR. PASTEUR NR. 12","MUNICIPIUL CLUJ-NAPOCA",1,54975,1,1,2201,1086,812,274,1067,19,2404,1318,732,335,
13,"CLUJ",127,54975,,5,0,"FACULTATEA DE CONSTRUCTII, SECTIA DRUMURI SI PODURI, STR. OBSERVATORULUI NR. 72","MUNICIPIUL CLUJ-NAPOCA",1,54975,1,1,2057,1016,889,127,1000,16,2200,1184,684,316,
13,"CLUJ",127,54975,,6,0,"FACULTATEA DE CONSTRUCTII, SECTIA DRUMURI SI PODURI, STR. OBSERVATORULUI NR. 72","MUNICIPIUL CLUJ-NAPOCA",1,54975,1,1,2420,1138,1020,118,1126,12,2656,1518,736,390,
13,"CLUJ",127,54975,,7,0,"LICEUL DE INFORMATICA ""TIBERIU POPOVICI"", CALEA TURZII NR. 140-142","MUNICIPIUL CLUJ-NAPOCA",1,54975,1,1,2227,1153,1042,111,1134,19,2399,1246,775,359,
13,"CLUJ",127,54975,,8,0,"PALATUL COPIILOR, STR. DR. GH. BILASCU NR. 23","MUNICIPIUL CLUJ-NAPOCA",1,54975,1,1,2241,1537,1121,416,1518,19,2442,905,1243,275,
13,"CLUJ",127,54975,,9,0,"GRUP SCOLAR ECONOMIC, STR. EMIL ISAC NR. 19","MUNICIPIUL CLUJ-NAPOCA",1,54975,1,1,1778,979,822,157,966,13,1950,971,803,163,
13,"CLUJ",127,54975,,10,0,"SCOALA NR.14 ""HOREA"", STR. HOREA NR. 19/A","MUNICIPIUL CLUJ-NAPOCA",1,54975,1,1,1865,1338,1083,255,1309,29,2045,707,1083,226,
13,"CLUJ",127,54975,,11,0,"SCOALA NR.2 ""IOAN BOB"", STR. PRAHOVEI NR. 10","MUNICIPIUL CLUJ-NAPOCA",1,54975,1,1,2188,1248,1108,140,1212,36,2403,1155,993,219,
13,"CLUJ",127,54975,,12,0,"LICEUL ""NICOLAE BALCESCU"", STR. CONSTANTA NR. 6","MUNICIPIUL CLUJ-NAPOCA",1,54975,1,1,2048,1501,1090,411,1459,42,2252,750,1166,293,
13,"CLUJ",127,54975,,13,0,"LICEUL ""BRASSAI SAMUEL"", B-DUL 21 DECEMBRIE 1989 NR. 9","MUNICIPIUL CLUJ-NAPOCA",1,54975,1,1,2061,1373,1032,341,1347,26,2250,877,1156,191,
13,"CLUJ",127,54975,,14,0,"SALA SPORTIVA A ARMATEI, STR. G-RAL TRAIAN MOSOIU NR. 9","MUNICIPIUL CLUJ-NAPOCA",1,54975,1,1,1585,897,779,118,884,13,1699,802,677,207,
13,"CLUJ",127,54975,,15,0,"COLEGIUL NATIONAL ""GEORGE COSBUC"", STR. AVRAM IANCU NR. 44","MUNICIPIUL CLUJ-NAPOCA",1,54975,1,1,2144,1222,1095,127,1196,26,2350,1115,949,247,
13,"CLUJ",127,54975,,16,0,"LICEUL TEORETIC ""GHEORGHE SINCAI"", STR. AVRAM IANCU NR. 33","MUNICIPIUL CLUJ-NAPOCA",1,54975,1,1,2457,1428,1239,189,1400,28,2700,1272,1138,262,
13,"CLUJ",127,54975,,17,0,"GRADINITA NR.22, STR. BRASOV NR. 27","MUNICIPIUL CLUJ-NAPOCA",1,54975,1,1,2010,1320,1146,174,1297,23,2300,980,1102,195,
13,"CLUJ",127,54975,,18,0,"GRADINITA NR.67, STR. ALVERNA NR. 63","MUNICIPIUL CLUJ-NAPOCA",1,54975,1,1,2357,1226,1099,127,1201,25,2551,1325,881,320,
13,"CLUJ",127,54975,,19,0,"SCOALA NR.16, STR. HORTICULTORILOR NR. 1","MUNICIPIUL CLUJ-NAPOCA",1,54975,1,1,1980,1135,972,163,1122,13,2143,1008,866,256,
13,"CLUJ",127,54975,,20,0,"SCOALA NR.16, STR. HORTICULTORILOR NR. 1","MUNICIPIUL CLUJ-NAPOCA",1,54975,1,1,2488,1463,1332,131,1435,28,2709,1246,1112,323,
13,"CLUJ",127,54975,,21,0,"SCOALA NR.16, STR. HORTICULTORILOR NR. 1","MUNICIPIUL CLUJ-NAPOCA",1,54975,1,1,2268,1254,1150,104,1132,18,2450,1300,878,254,
13,"CLUJ",127,54975,,22,0,"GRADINITA NR.10, STR. SEPTIMIU ALBINI NR. 53","MUNICIPIUL CLUJ-NAPOCA",1,54975,1,1,1857,1045,916,129,1033,12,2003,958,851,182,
13,"CLUJ",127,54975,,23,0,"SCOALA NR.22, STR. SEPTIMIU ALBINI NR. 91","MUNICIPIUL CLUJ-NAPOCA",1,54975,1,1,1898,1000,906,94,985,15,2049,1049,770,215,
13,"CLUJ",127,54975,,24,0,"SCOALA NR.22, STR. SEPTIMIU ALBINI NR. 91","MUNICIPIUL CLUJ-NAPOCA",1,54975,1,1,1962,962,859,103,948,14,2161,1199,723,225,
13,"CLUJ",127,54975,,25,0,"LICEUL TEORETIC ""LUCIAN BLAGA"", ALEEA BAISOARA NR. 2-4","MUNICIPIUL CLUJ-NAPOCA",1,54975,1,1,2119,1214,1120,94,1197,17,2350,1136,933,264,
13,"CLUJ",127,54975,,26,0,"LICEUL TEORETIC ""LUCIAN BLAGA"", ALEEA BAISOARA NR. 2-4","MUNICIPIUL CLUJ-NAPOCA",1,54975,1,1,1585,900,847,53,898,2,1750,844,746,152,
13,"CLUJ",127,54975,,27,0,"LICEUL TEORETIC ""LUCIAN BLAGA"", ALEEA BAISOARA NR. 2-4","MUNICIPIUL CLUJ-NAPOCA",1,54975,1,1,1452,840,718,122,825,15,1600,760,675,150,
13,"CLUJ",127,54975,,28,0,"LICEUL TEORETIC ""LUCIAN BLAGA"", ALEEA BAISOARA NR. 2-4","MUNICIPIUL CLUJ-NAPOCA",1,54975,1,1,1828,1006,873,133,986,20,2005,999,791,195,
13,"CLUJ",127,54975,,29,0,"SCOALA NR.1, ALEEA HERCULANE NR. 7","MUNICIPIUL CLUJ-NAPOCA",1,54975,1,1,1815,1076,937,139,1063,13,1950,872,869,194,
13,"CLUJ",127,54975,,30,0,"COLEGIUL PEDAGOGIC ""GHEORGHE LAZAR"", STR. ALEXANDRU VAIDA VOEVOD NR. 55","MUNICIPIUL CLUJ-NAPOCA",1,54975,1,1,1606,1096,923,173,1076,15,1750,645,888,188,
13,"CLUJ",127,54975,,31,0,"SCOALA NR.1, ALEEA HERCULANE NR. 7","MUNICIPIUL CLUJ-NAPOCA",1,54975,1,1,1728,1007,942,65,988,19,1903,896,788,200,
13,"CLUJ",127,54975,,32,0,"GRUP SCOLAR TRANSPORT CF NR.9, STR. BISTRITEI NR. 21","MUNICIPIUL CLUJ-NAPOCA",1,54975,1,1,1633,909,779,130,895,14,1750,841,726,169,
13,"CLUJ",127,54975,,33,0,"GRUP SCOLAR INDUSTRIE ALIMENTARA, STR. BISTRITEI NR. 21","MUNICIPIUL CLUJ-NAPOCA",1,54975,1,1,2150,1376,1062,314,1353,23,2375,999,979,374,
13,"CLUJ",127,54975,,34,0,"GRUP SCOLAR INDUSTRIAL ENERGETIC, STR. NICOLAE PASCALY NR. 2","MUNICIPIUL CLUJ-NAPOCA",1,54975,1,1,1893,1141,1004,137,1124,16,2055,915,852,272,
13,"CLUJ",127,54975,,35,0,"STR. DAMBOVITEI, PAVILION EXPO","MUNICIPIUL CLUJ-NAPOCA",1,54975,1,1,2271,1138,950,188,1132,6,2450,1312,723,409,
13,"CLUJ",127,54975,,36,0,"STR. DAMBOVITEI, PAVILION EXPO","MUNICIPIUL CLUJ-NAPOCA",1,54975,1,1,2263,1114,981,133,1096,18,2462,1348,661,435,
13,"CLUJ",127,54975,,37,0,"ANTRPRIZA CONSTRUCTII SI INSTALATII, STR. AUREL VLAICU NR. 180","MUNICIPIUL CLUJ-NAPOCA",1,54975,1,1,2535,1154,1078,76,1144,10,2748,1594,718,426,
13,"CLUJ",127,54975,,38,0,"SCOALA DE APLICATIE, STR. TARNAVELOR NR. 22","MUNICIPIUL CLUJ-NAPOCA",1,54975,1,1,2293,1011,948,63,998,13,2498,1487,611,387,
13,"CLUJ",127,54975,,39,0,"SCOALA DE APLICATIE, STR. TARNAVELOR NR. 22","MUNICIPIUL CLUJ-NAPOCA",1,54975,1,1,3214,1306,1240,66,1296,10,3513,2207,729,567,
13,"CLUJ",127,54975,,40,0,"GRADINITA NR.53, STR. TARNAVELOR NR. 4","MUNICIPIUL CLUJ-NAPOCA",1,54975,1,1,2102,965,908,57,948,17,2303,1338,607,341,
13,"CLUJ",127,54975,,41,0,"SC ATLAS INDUSTRIE TRANSPORT, STR. AUREL VLAICU NR. 182","MUNICIPIUL CLUJ-NAPOCA",1,54975,1,1,1949,905,833,72,893,12,2103,1198,548,345,
13,"CLUJ",127,54975,,42,0,"STR. DAMBOVITEI, PAVILION EXPO","MUNICIPIUL CLUJ-NAPOCA",1,54975,1,1,2898,1587,1475,112,1568,19,3150,1563,941,627,
13,"CLUJ",127,54975,,43,0,"SCOALA PROFESIONALA SPECIALA NR.18, STR. FABRICII DE ZAHAR NR. 51","MUNICIPIUL CLUJ-NAPOCA",1,54975,1,1,2064,1034,959,75,1024,10,2250,1216,636,388,
13,"CLUJ",127,54975,,44,0,"SCOALA NR.5 ""ION AGARBICEANU"", STR. GRADINARILOR NR. 1","MUNICIPIUL CLUJ-NAPOCA",1,54975,1,1,2411,1181,1106,75,1173,8,2598,1417,691,482,
13,"CLUJ",127,54975,,45,0,"SCOALA NR.5 ""ION AGARBICEANU"", STR. GRADINARILOR NR. 1","MUNICIPIUL CLUJ-NAPOCA",1,54975,1,1,2007,1048,964,84,1023,14,2207,1170,645,378,
13,"CLUJ",127,54975,,46,0,"SCOALA PROFESIONALA SPECIALA NR.18, STR. FABRICII DE ZAHAR NR. 51","MUNICIPIUL CLUJ-NAPOCA",1,54975,1,1,2070,1061,981,80,1046,15,2253,1192,640,406,
13,"CLUJ",127,54975,,47,0,"STR. DAMBOVITEI, PAVILION EXPO","MUNICIPIUL CLUJ-NAPOCA",1,54975,1,1,1873,858,726,132,850,8,2054,1196,437,413,
13,"CLUJ",127,54975,,48,0,"STR. DAMBOVITEI, PAVILION EXPO","MUNICIPIUL CLUJ-NAPOCA",1,54975,1,1,2086,1214,929,285,1200,14,2250,1036,606,594,
13,"CLUJ",127,54975,,49,0,"SCOALA PROFESIONALA SPECIALA NR.18, STR. FABRICII DE ZAHAR NR. 51","MUNICIPIUL CLUJ-NAPOCA",1,54975,1,1,2179,1028,965,63,1020,8,2332,1304,585,435,
13,"CLUJ",127,54975,,50,0,"GRADINITA NR.42, B-DUL 21 DECEMBRIE 1989 NR. 124","MUNICIPIUL CLUJ-NAPOCA",1,54975,1,1,2632,1345,1219,126,1320,21,2850,1509,908,412,
13,"CLUJ",127,54975,,51,0,"GRUP SCOLAR ""TRAIAN VUIA"", B-DUL 21 DECEMBRIE 1989 NR. 128","MUNICIPIUL CLUJ-NAPOCA",1,54975,1,1,2515,1376,1155,221,1360,16,2758,1382,889,471,
13,"CLUJ",127,54975,,52,0,"GRUP SCOLAR ""TRAIAN VUIA"", B-DUL 21 DECEMBRIE 1989 NR. 128","MUNICIPIUL CLUJ-NAPOCA",1,54975,1,1,2014,1303,1010,293,1287,14,2202,899,896,391,
13,"CLUJ",127,54975,,53,0,"SCOALA NR.5 ""ION AGARBICEANU"", STR. GRADINARILOR NR. 1","MUNICIPIUL CLUJ-NAPOCA",1,54975,1,1,2169,1116,1013,103,1096,20,2350,1234,726,370,
13,"CLUJ",127,54975,,54,0,"LICEUL TEORETIC ""MIHAI EMINESCU"", B-DUL 21 DECEMBRIE 1989 NR. 98","MUNICIPIUL CLUJ-NAPOCA",1,54975,1,1,2400,1326,1156,170,1305,21,2626,1300,1013,292,
13,"CLUJ",127,54975,,55,0,"SCOALA ""SIMION BARNUTIU"" NR.8, CALEA DOROBANTILOR NR. 72","MUNICIPIUL CLUJ-NAPOCA",1,54975,1,1,1905,1079,909,170,1066,13,2050,971,755,311,
13,"CLUJ",127,54975,,56,0,"SCOALA ""SIMION BARNUTIU"" NR.8, CALEA DOROBANTILOR NR. 72","MUNICIPIUL CLUJ-NAPOCA",1,54975,1,1,2821,1565,1368,197,1541,24,3108,1543,1015,526,
13,"CLUJ",127,54975,,57,0,"GRUP SCOLAR INDUSTRIAL UNIREA, STR. PARIS NR. 60","MUNICIPIUL CLUJ-NAPOCA",1,54975,1,1,2081,1122,1010,112,1114,8,2250,1128,806,308,
13,"CLUJ",127,54975,,58,0,"LICEUL TEORETIC ""AVRAM IANCU"", STR. ONISIFOR GHIBU NR. 25","MUNICIPIUL CLUJ-NAPOCA",1,54975,1,1,1860,1029,906,123,1006,23,2017,988,779,227,
13,"CLUJ",127,54975,,59,0,"SCOALA NR.28 ""DAVID PRODAN"", STR. MESERIILOR NR. 20","MUNICIPIUL CLUJ-NAPOCA",1,54975,1,1,1534,829,765,64,816,13,1650,821,624,192,
13,"CLUJ",127,54975,,60,0,"SCOALA NR.28 ""DAVID PRODAN"", STR. MESERIILOR NR. 20","MUNICIPIUL CLUJ-NAPOCA",1,54975,1,1,1230,593,535,58,582,11,1300,707,438,144,
13,"CLUJ",127,54975,,61,0,"GRUP SCOLAR INDUSTRIAL TERAPIA,STR. DECEBAL NR. 41","MUNICIPIUL CLUJ-NAPOCA",1,54975,1,1,1681,928,781,147,913,15,1804,876,671,242,
13,"CLUJ",127,54975,,62,0,"LICEUL TEORETIC NR. 5, STR. HOREA NR. 42-44","MUNICIPIUL CLUJ-NAPOCA",1,54975,1,1,1884,1130,902,228,1113,17,2043,913,899,214,
13,"CLUJ",127,54975,,63,0,"GRUP SCOLAR INDUSTRIAL FORESTIER, STR. HOREA NR. 51","MUNICIPIUL CLUJ-NAPOCA",1,54975,1,1,1096,806,674,132,796,10,1399,593,609,187,
13,"CLUJ",127,54975,,64,0,"SCOALA NR.27, STR. 11 OCTOMBRIE NR. 3","MUNICIPIUL CLUJ-NAPOCA",1,54975,1,1,2085,1159,1069,90,1147,11,2244,1086,892,255,
13,"CLUJ",127,54975,,65,0,"SCOALA NR.27, STR. 11 OCTOMBRIE NR. 3","MUNICIPIUL CLUJ-NAPOCA",1,54975,1,1,2240,1152,1039,113,1134,9,2456,1304,850,284,
13,"CLUJ",127,54975,,66,0,"SCOALA NR.9, CALEA BACIULUI NR. 18","MUNICIPIUL CLUJ-NAPOCA",1,54975,1,1,2507,1350,1142,208,1341,9,2701,1351,678,663,
13,"CLUJ",127,54975,,67,0,"GRUP SCOLAR TRANSPORTURI MATERIAL RULANT, STR. CORNELIU COPOSU NR. 89","MUNICIPIUL CLUJ-NAPOCA",1,54975,1,1,2367,1205,1071,134,1194,10,2552,1347,855,339,
13,"CLUJ",127,54975,,68,0,"SCOALA NR.7, STR. GIORDANO BRUNO NR. 46","MUNICIPIUL CLUJ-NAPOCA",1,54975,1,1,1858,1076,992,84,1063,13,2000,924,750,313,
13,"CLUJ",127,54975,,69,0,"SCOALA NR.13 ""NICOLAE IORGA"", STR. RAZBOIENI NR. 67","MUNICIPIUL CLUJ-NAPOCA",1,54975,1,1,2101,1133,941,192,1110,23,2300,1167,820,290,
13,"CLUJ",127,54975,,70,0,"SCOALA NR.13 ""NICOLAE IORGA"", STR. RAZBOIENI NR. 67","MUNICIPIUL CLUJ-NAPOCA",1,54975,1,1,2084,1051,950,101,1042,9,2250,1199,614,428,
13,"CLUJ",127,54975,,71,0,"GRUP SCOLAR TEHNOFRIG, STR. MARAMURESULUI NR. 165/A","MUNICIPIUL CLUJ-NAPOCA",1,54975,1,1,2002,840,754,86,828,12,2163,1323,507,321,
13,"CLUJ",127,54975,,72,0,"GRUP SCOLAR CONSTRUCTII MASINI CUG, B-DUL MUNCII NR. 189","MUNICIPIUL CLUJ-NAPOCA",1,54975,1,1,1526,789,559,230,784,5,1653,864,307,477,
13,"CLUJ",127,54975,,73,0,"CLUB SC TRANSCOM, STR. CAMPINA NR. 53-55","MUNICIPIUL CLUJ-NAPOCA",1,54975,1,1,2051,977,916,61,966,11,2208,1231,736,230,
13,"CLUJ",127,54975,,74,0,"SCOALA NR.12, STR. TRAIAN VUIA NR. 76","MUNICIPIUL CLUJ-NAPOCA",1,54975,1,1,2006,1115,948,167,1094,21,2150,1035,632,462,
13,"CLUJ",127,54975,,75,0,"SCOALA NR.12, STR. TRAIAN VUIA NR. 76","MUNICIPIUL CLUJ-NAPOCA",1,54975,1,1,1734,898,784,114,890,8,1900,1002,541,349,
13,"CLUJ",127,54975,,76,0,"GRUP SCOLAR ELECTROTEHNICA, STR. CAMPULUI MICRO II/2","MUNICIPIUL CLUJ-NAPOCA",1,54975,1,1,2355,1208,1150,58,1193,15,2608,1400,789,404,
13,"CLUJ",127,54975,,77,0,"GRUP SCOLAR ELECTROTEHNICA, STR. CAMPULUI MICRO II/2","MUNICIPIUL CLUJ-NAPOCA",1,54975,1,1,2619,1311,1244,67,1287,24,2850,1539,841,446,
13,"CLUJ",127,54975,,78,0,"SCOALA NR.23 LIVIU REBREANU, STR. MOLDOVEANU NR. 1","MUNICIPIUL CLUJ-NAPOCA",1,54975,1,1,2586,1370,1285,85,1358,12,2800,1430,930,428,
13,"CLUJ",127,54975,,79,0,"GRADINITA NR.71, STR. MOLDOVEANU NR. 7","MUNICIPIUL CLUJ-NAPOCA",1,54975,1,1,2662,1330,1246,84,1311,19,2900,1570,856,455,
13,"CLUJ",127,54975,,80,0,"SCOALA NR.3, ALEEA RETEZAT NR. 44","MUNICIPIUL CLUJ-NAPOCA",1,54975,1,1,2306,1061,974,87,1044,15,2500,1439,623,421,
13,"CLUJ",127,54975,,81,0,"SCOALA NR.3, ALEEA RETEZAT NR. 44","MUNICIPIUL CLUJ-NAPOCA",1,54975,1,1,2431,1234,1135,99,1213,12,2653,1419,716,497,
13,"CLUJ",127,54975,,82,0,"ALEEA MOLDOVEANU (SCOALA NR. 23 ""LIVIU REBREANU"")","MUNICIPIUL CLUJ-NAPOCA",1,54975,1,1,2306,1098,998,100,1090,8,2503,1405,644,446,
13,"CLUJ",127,54975,,83,0,"GRADINITA NR.70, STR. MEHEDINTI NR. 19","MUNICIPIUL CLUJ-NAPOCA",1,54975,1,1,2401,1021,919,102,1013,8,2600,1579,639,374,
13,"CLUJ",127,54975,,84,0,"GRADINITA NR.70, STR. MEHEDINTI NR. 19","MUNICIPIUL CLUJ-NAPOCA",1,54975,1,1,2006,876,821,55,866,10,2147,1271,572,294,
13,"CLUJ",127,54975,,85,0,"GRADINITA NR.72, STR. TAZLAU NR. 11","MUNICIPIUL CLUJ-NAPOCA",1,54975,1,1,2583,1321,1183,138,1310,11,2802,1481,890,420,
13,"CLUJ",127,54975,,86,0,"GRADINITA NR.72, STR. TAZLAU NR. 11","MUNICIPIUL CLUJ-NAPOCA",1,54975,1,1,1757,877,802,75,867,10,1900,1023,601,266,
13,"CLUJ",127,54975,,87,0,"SCOALA NR.6, STR. MEZIAD NR. 4","MUNICIPIUL CLUJ-NAPOCA",1,54975,1,1,1812,1057,983,74,965,18,1951,968,666,299,
13,"CLUJ",127,54975,,88,0,"SCOALA NR.6, STR. MEZIAD NR. 4","MUNICIPIUL CLUJ-NAPOCA",1,54975,1,1,1885,1104,1048,56,1088,16,2048,944,766,322,
13,"CLUJ",127,54975,,89,0,"SCOALA NR.6, STR. MEZIAD NR. 4","MUNICIPIUL CLUJ-NAPOCA",1,54975,1,1,2006,987,901,86,982,5,2197,1210,617,365,
13,"CLUJ",127,54975,,90,0,"SCOALA NR.29, ALEEA PEANA NR. 16","MUNICIPIUL CLUJ-NAPOCA",1,54975,1,1,2450,1099,988,111,1079,20,2450,1351,742,337,
13,"CLUJ",127,54975,,91,0,"SCOALA NR.29, ALEEA PEANA NR. 16","MUNICIPIUL CLUJ-NAPOCA",1,54975,1,1,2521,1150,1012,138,1141,9,2741,1591,702,439,
13,"CLUJ",127,54975,,92,0,"SCOALA NR.17 ""ION CREANGA"", ALEEA PEANA NR. 4","MUNICIPIUL CLUJ-NAPOCA",1,54975,1,1,2183,1149,1048,101,1140,9,2350,1201,816,324,
13,"CLUJ",127,54975,,93,0,"SCOALA NR.17 ""ION CREANGA"", ALEEA PEANA NR. 4","MUNICIPIUL CLUJ-NAPOCA",1,54975,1,1,2348,1294,1172,122,1288,6,2582,1288,778,510,
13,"CLUJ",127,54975,,94,0,"GRADINITA NR.66, STR. GR. ALEXANDRESCU NR. 47","MUNICIPIUL CLUJ-NAPOCA",1,54975,1,1,2158,1060,982,78,1048,12,2358,1298,776,272,
13,"CLUJ",127,54975,,95,0,"GRADINITA NR.66, STR. GR. ALEXANDRESCU NR. 47","MUNICIPIUL CLUJ-NAPOCA",1,54975,1,1,2812,1465,1370,95,1441,24,3107,1640,1050,391,
13,"CLUJ",127,54975,,96,0,"SCOALA NR.21, STR. GR. ALEXANDRESCU NR. 16","MUNICIPIUL CLUJ-NAPOCA",1,54975,1,1,2625,1449,1327,122,1442,7,2850,1401,895,547,
13,"CLUJ",127,54975,,97,0,"GRADINITA NR.55, STR. GR. ALEXANDRESCU NR. 21","MUNICIPIUL CLUJ-NAPOCA",1,54975,1,1,2165,1105,1047,58,1088,17,2353,1248,845,243,
13,"CLUJ",127,54975,,98,0,"SCOALA NR.21, STR. GR. ALEXANDRESCU NR. 16","MUNICIPIUL CLUJ-NAPOCA",1,54975,1,1,2062,1031,964,67,1017,14,2257,1226,683,334,
13,"CLUJ",127,54975,,99,0,"SCOALA NR.21, STR. GR. ALEXANDRESCU NR. 16","MUNICIPIUL CLUJ-NAPOCA",1,54975,1,1,1955,985,848,137,962,23,2100,1105,651,311,
13,"CLUJ",127,54975,,100,0,"GRUP SCOLAR DE INDUSTRIE USOARA ""CLUJANA"", STR. TABEREI NR. 1-3","MUNICIPIUL CLUJ-NAPOCA",1,54975,1,1,2058,1153,878,275,1138,15,2178,1025,701,437,
13,"CLUJ",127,54975,,101,0,"STR. ARINILOR FN (SCOALA NR. 20)","MUNICIPIUL CLUJ-NAPOCA",1,54975,1,1,1760,877,836,41,866,11,1900,1023,546,320,
13,"CLUJ",127,54975,,102,0,"STR. ARINILOR FN (SCOALA NR. 20)","MUNICIPIUL CLUJ-NAPOCA",1,54975,1,1,2165,1088,1036,52,1083,5,2350,1262,649,434,
13,"CLUJ",127,54975,,103,0,"SCOALA NR.11, STR. MOGOSOAIA NR. 6","MUNICIPIUL CLUJ-NAPOCA",1,54975,1,1,2216,1238,1095,143,1217,21,2400,1162,769,448,
13,"CLUJ",127,54975,,104,0,"SCOALA NR.11, STR. MOGOSOAIA NR. 6","MUNICIPIUL CLUJ-NAPOCA",1,54975,1,1,2305,1214,1125,89,1199,15,2500,1286,729,470,
13,"CLUJ",127,54975,,105,0,"SCOALA NR.4, CALEA MANASTUR NR. 22-24","MUNICIPIUL CLUJ-NAPOCA",1,54975,1,1,2518,1368,1257,111,1344,24,2757,1389,970,374,
13,"CLUJ",127,54975,,106,0,"BIBLIOTECA JUDETEANA FILIALA MANASTUR, STR. IZLAZULUI NR. 18","MUNICIPIUL CLUJ-NAPOCA",1,54975,1,1,2821,1539,1346,193,1511,28,3050,1511,890,621,
13,"CLUJ",127,54975,,107,0,"SCOALA NR.4, CALEA MANASTUR NR. 22-24","MUNICIPIUL CLUJ-NAPOCA",1,54975,1,1,2900,1331,1212,119,1312,19,3149,1818,852,460,
13,"CLUJ",127,54975,,108,0,"SPLAIUL INDEPENDENTEI (SALA SPORTURILOR)","MUNICIPIUL CLUJ-NAPOCA",1,54975,1,1,2400,1297,1202,95,1269,28,2617,1320,885,384,
13,"CLUJ",127,54975,,109,0,"SPLAIUL INDEPENDENTEI (SALA SPORTURILOR)","MUNICIPIUL CLUJ-NAPOCA",1,54975,1,1,1301,733,615,118,724,9,1403,670,557,167,
13,"CLUJ",127,54975,,110,0,"CATEDRA DE FARMACOLOGIE, STR. G-RAL EREMIA GRIGORESCU NR. 2","MUNICIPIUL CLUJ-NAPOCA",1,54975,1,1,1995,1182,1063,119,1150,32,2210,1028,1008,142,
13,"CLUJ",127,54975,,111,0,"GRUP SCOLAR POSTA SI TELECOMUNICATII, STR. MOTILOR NR. 78-80","MUNICIPIUL CLUJ-NAPOCA",1,54975,1,1,2030,1216,939,277,1199,17,2190,974,937,262,
13,"CLUJ",127,54975,,112,0,"GRUP SCOLAR POSTA SI TELECOMUNICATII, STR. MOTILOR NR. 78-80","MUNICIPIUL CLUJ-NAPOCA",1,54975,1,1,1414,870,758,112,845,25,1550,680,737,108,
13,"CLUJ",127,54975,,113,0,"LICEUL TEORETIC ""ONISIFOR GHIBU"", STR. ALEXANDRU VLAHUTA NR. 12-14","MUNICIPIUL CLUJ-NAPOCA",1,54975,1,1,2337,1398,1260,138,1373,25,2548,1150,1139,234,
13,"CLUJ",127,54975,,114,0,"GRADINITA NR.64, STR. ALEXANDRU VLAHUTA NR. 59","MUNICIPIUL CLUJ-NAPOCA",1,54975,1,1,2082,1243,1146,97,1217,26,2256,1013,950,267,
13,"CLUJ",127,54975,,115,0,"LICEUL TEORETIC ""ONISIFOR GHIBU"", STR. ALEXANDRU VLAHUTA NR. 12-14","MUNICIPIUL CLUJ-NAPOCA",1,54975,1,1,2369,1271,1187,84,1247,24,2600,1329,937,310,
13,"CLUJ",127,54975,,116,0,"SCOALA ALEXANDRU VLAHUTA, STR. ALEXANDRU VLAHUTA NR. 44-48","MUNICIPIUL CLUJ-NAPOCA",1,54975,1,1,2091,1178,1093,85,1162,16,1450,272,935,227,
13,"CLUJ",127,54975,,117,0,"SCOALA ALEXANDRU VLAHUTA, STR. ALEXANDRU VLAHUTA NR. 44-48","MUNICIPIUL CLUJ-NAPOCA",1,54975,1,1,1325,859,697,162,848,11,2250,1391,665,183,
13,"CLUJ",127,54975,,118,0,"GRADINITA NR.68, STR. FANTANELE NR. 46","MUNICIPIUL CLUJ-NAPOCA",1,54975,1,1,2746,1472,1362,110,1457,15,3000,1528,1094,363,
13,"CLUJ",127,54975,,119,0,"INSTITUTUL DE CHIMIE, STR. DONATH NR. 63","MUNICIPIUL CLUJ-NAPOCA",1,54975,1,1,2560,1560,1400,160,1546,14,2800,1240,1094,452,
13,"CLUJ",127,54975,,120,0,"GRADINITA NR. 12, STR. DONATH NR. 150","MUNICIPIUL CLUJ-NAPOCA",1,54975,1,1,1557,880,799,81,874,6,1653,773,642,232,
13,"CLUJ",127,54975,,121,0,"GRADINITA NR. 64, STR. ALEXANDRU VLAHUTA NR. 59","MUNICIPIUL CLUJ-NAPOCA",1,54975,1,1,2562,1336,1232,104,1326,10,2775,1439,977,349,
13,"CLUJ",127,54975,,122,1,"SALA SPORTIVA A ARMATEI, STR. G-RAL TRAIAN MOSOIU NR. 9","MUNICIPIUL CLUJ-NAPOCA",1,54975,1,1,0,810,0,810,792,18,999,189,367,425,
13,"CLUJ",127,54975,,123,1,"U.M. 01607 SOMESENI","MUNICIPIUL CLUJ-NAPOCA",1,54975,1,1,0,553,0,553,516,37,651,98,234,282,
13,"CLUJ",127,54975,,124,1,"SPITALUL CLINIC DE RECUPERARE, STR. VIILOR NR. 46-50","MUNICIPIUL CLUJ-NAPOCA",1,54975,1,1,0,290,0,290,283,7,400,110,174,109,
13,"CLUJ",127,54975,,125,1,"CLINICA MEDICALA V, STR. TABACARILOR NR. 11","MUNICIPIUL CLUJ-NAPOCA",1,54975,1,1,0,145,0,145,141,4,250,105,96,45,
13,"CLUJ",127,54975,,126,1,"SPITALUL CLINIC JUDETEAN, STR. CLINICILOR NR. 3-5","MUNICIPIUL CLUJ-NAPOCA",1,54975,1,1,0,396,0,396,393,3,500,104,263,130,
13,"CLUJ",127,54975,,127,1,"STATIA CFR CLUJ, PIATA GARII NR. 2","MUNICIPIUL CLUJ-NAPOCA",1,54975,1,1,0,1315,0,1315,1301,14,1402,87,859,442,
13,"CLUJ",127,54975,,128,1,"AUTOGARA, STR. GIORDANO BRUNO NR. 3-5","MUNICIPIUL CLUJ-NAPOCA",1,54975,1,1,0,109,0,109,109,0,200,91,55,54,
13,"CLUJ",127,54975,,129,1,"CANTINA COMPLEX HASDEU, STR. HASDEU NR. 45","MUNICIPIUL CLUJ-NAPOCA",1,54975,1,1,0,1146,0,1146,1122,24,1502,356,936,186,
13,"CLUJ",127,54975,,130,1,"CANTINA COMPLEX HASDEU, STR. HASDEU NR. 46","MUNICIPIUL CLUJ-NAPOCA",1,54975,1,1,0,883,0,883,870,13,1507,624,711,159,
13,"CLUJ",127,54975,,131,1,"CANTINA AGRONOMIA, STR. MOTILOR NR. 76","MUNICIPIUL CLUJ-NAPOCA",1,54975,1,1,0,342,0,342,336,6,600,258,218,118,
13,"CLUJ",127,54975,,132,1,"CANTINA COMPLEX OBSERVATOR, STR. OBSERVATORULUI NR. 34","MUNICIPIUL CLUJ-NAPOCA",1,54975,1,1,0,1270,0,1270,1240,30,1994,724,904,336,
13,"CLUJ",127,54975,,133,1,"COMPLEX STUDENTESC MARASTI, STR. FABRICII DE ZAHAR NR. 58","MUNICIPIUL CLUJ-NAPOCA",1,54975,1,1,0,735,0,735,700,35,1513,778,365,335,
13,"CLUJ",127,54975,,134,1,"CAMINUL STUDENTESC NR. 7 HASDEU, STR. CLINICILOR NR. 5-7","MUNICIPIUL CLUJ-NAPOCA",1,54975,1,1,0,1083,0,1083,1062,21,1800,716,791,271,
13,"CLUJ",127,55008,,135,0,"AUTOGARA DEJ, STR. BISTRITEI NR. 2","MUNICIPIUL DEJ",3,55008,1,1,1001,435,347,88,430,5,1100,665,189,241,
13,"CLUJ",127,55008,,136,0,"SCOALA GEN. NR.1, STR. MARASESTI NR. 2","MUNICIPIUL DEJ",3,55008,1,1,1352,648,579,69,642,6,1500,852,426,216,
13,"CLUJ",127,55008,,137,0,"GRADINITA DE COPII, STR. 1 MAI NR. 12","MUNICIPIUL DEJ",3,55008,1,1,1846,765,653,112,760,5,2000,1235,454,306,
13,"CLUJ",127,55008,,138,0,"SCOALA GEN. NR. 3, STR. AVRAM IANCU NR. 2-4","MUNICIPIUL DEJ",3,55008,1,1,1621,821,745,76,813,8,1796,975,491,322,
13,"CLUJ",127,55008,,139,0,"LICEUL TEORETIC, PIATA LUPENI NR. 2","MUNICIPIUL DEJ",3,55008,1,1,1727,788,720,68,783,5,1850,1062,528,255,
13,"CLUJ",127,55008,,140,0,"CAMINUL DE COPII, STR. INFRATIRII NR. 30","MUNICIPIUL DEJ",3,55008,1,1,1322,686,623,63,670,16,1450,764,384,286,
13,"CLUJ",127,55008,,141,0,"OCOLUL SILVIC, STR. NICOLAE IORGA NR. 5","MUNICIPIUL DEJ",3,55008,1,1,1799,957,847,110,943,14,1950,993,561,382,
13,"CLUJ",127,55008,,142,0,"CENTRUL REPRODUCTIE SELECTIE ANIMALE, STR. ION POP RETEGANU NR. 21","MUNICIPIUL DEJ",3,55008,1,1,1518,743,681,62,739,4,1650,907,491,248,
13,"CLUJ",127,55008,,143,0,"SCOALA GEN., STR. VALEA CODORULUI NR. 72","MUNICIPIUL DEJ",3,55008,1,1,748,378,358,20,374,4,800,422,168,206,
13,"CLUJ",127,55008,,144,0,"SCOALA GEN. NR. 2, STR. MARASTI NR. 5A","MUNICIPIUL DEJ",3,55008,1,1,1491,686,635,51,678,8,1650,964,368,310,
13,"CLUJ",127,55008,,145,0,"SC AGROCOM SA, STR. ECATERINA TEODOROIU NR. 50","MUNICIPIUL DEJ",3,55008,1,1,1679,769,702,67,764,5,1850,1081,407,357,
13,"CLUJ",127,55008,,146,0,"RADP DEJ, STR. CRANGULUI FN (RADP DEJ)","MUNICIPIUL DEJ",3,55008,1,1,1519,628,573,55,626,2,1650,1022,307,319,
13,"CLUJ",127,55008,,147,0,"SCOALA GEN. NR. 5, STR. PEPINIEREI NR. 6 (INTRAREA PRINCIPALA)","MUNICIPIUL DEJ",3,55008,1,1,1655,730,669,61,725,5,1750,925,363,362,
13,"CLUJ",127,55008,,148,0,"SCOALA GEN. NR. 5, STR. PEPINIEREI NR. 6 (INTRAREA SECUNDARA)","MUNICIPIUL DEJ",3,55008,1,1,1672,803,721,82,802,1,1800,997,374,428,
13,"CLUJ",127,55008,,149,0,"CAMINUL DE COPII NR.7, ALEEA TOMIS NR. 2, BLOC D15","MUNICIPIUL DEJ",3,55008,1,1,1143,602,529,73,596,6,1250,648,353,243,
13,"CLUJ",127,55008,,150,0,"GRADINITA DE COPII, STR. UNIRII NR. 27, BLOC D","MUNICIPIUL DEJ",3,55008,1,1,1146,492,442,50,490,2,1246,754,261,229,
13,"CLUJ",127,55008,,151,0,"CRESA DE COPII, ALEEA TOMIS NR. 4","MUNICIPIUL DEJ",3,55008,1,1,1721,816,716,100,806,10,1900,1084,380,426,
13,"CLUJ",127,55008,,152,0,"CAMINUL DE COPII SOMES, STR. UNIRII NR. 1","MUNICIPIUL DEJ",3,55008,1,1,1449,717,652,65,708,9,1600,883,463,245,
13,"CLUJ",127,55008,,153,0,"CAMINUL DE COPII NR. 10, STR. AURORA NR. 3","MUNICIPIUL DEJ",3,55008,1,1,1638,720,617,103,714,6,1794,1074,325,389,
13,"CLUJ",127,55008,,154,0,"SCOALA GEN. NR. 4, STR. AURORA NR. 5","MUNICIPIUL DEJ",3,55008,1,1,1622,724,653,71,718,6,1750,1026,340,378,
13,"CLUJ",127,55008,,155,0,"SCOALA GEN. OCNA DEJ, STR. MIXANDRELOR NR. 2A","MUNICIPIUL DEJ",3,55008,1,1,2038,906,811,95,895,11,2200,1294,431,464,
13,"CLUJ",127,55008,,156,0,"VIILE DEJULUI (SCOALA GENERALA)","MUNICIPIUL DEJ",3,55008,1,1,1342,634,571,63,625,9,1450,816,441,184,
13,"CLUJ",127,55008,,157,0,"SOMCUTU MIC (SCOALA GENERALA)","MUNICIPIUL DEJ",3,55008,1,1,474,343,251,92,339,4,500,157,111,228,
13,"CLUJ",127,55008,,158,0,"PINTIC (SCOALA GENERALA)","MUNICIPIUL DEJ",3,55008,1,1,319,147,89,58,147,0,350,203,55,92,
13,"CLUJ",127,55008,,159,1,"GARNIZOANA DEJ, PIATA BOBALNA NR. 19","MUNICIPIUL DEJ",3,55008,1,1,0,189,0,189,178,11,300,111,63,115,
13,"CLUJ",127,55008,,160,1,"SPITALUL MUNICIPAL DEJ","MUNICIPIUL DEJ",3,55008,1,1,0,252,0,252,249,3,300,48,154,95,
13,"CLUJ",127,55259,,161,0,"SCOALA GEN. NR. 1, STR. BOGDAN PETRICEICU HASDEU NR. 4","MUNICIPIUL TURDA",5,55259,1,1,1433,799,710,89,775,24,1446,647,554,221,
13,"CLUJ",127,55259,,162,0,"SCOALA GEN. NR. 1, STR. DR. ION RATIU NR. 55","MUNICIPIUL TURDA",5,55259,1,1,1918,982,901,81,969,13,2107,1125,622,347,
13,"CLUJ",127,55259,,163,0,"SCOALA GEN. NR. 1, STR. BOGDAN PETRICEICU HASDEU NR. 4","MUNICIPIUL TURDA",5,55259,1,1,1406,678,634,44,664,14,1554,876,454,210,
13,"CLUJ",127,55259,,164,0,"SCOALA GEN. NR. 3, PIATA ROMANA NR. 12","MUNICIPIUL TURDA",5,55259,1,1,1210,644,583,61,637,7,1287,643,411,226,
13,"CLUJ",127,55259,,165,0,"SCOALA GEN. NR. 3, PIATA ROMANA NR. 12","MUNICIPIUL TURDA",5,55259,1,1,1122,551,514,37,542,9,1192,641,334,208,
13,"CLUJ",127,55259,,166,0,"SCOALA GEN. NR. 2, STR. C-TIN BRANCOVEANU NR. 4","MUNICIPIUL TURDA",5,55259,1,1,1156,612,547,65,602,10,1242,630,387,215,
13,"CLUJ",127,55259,,167,0,"AUTOBAZA ITA, STR. CLUJULUI NR. 71","MUNICIPIUL TURDA",5,55259,1,1,1074,517,472,45,515,2,1150,633,302,213,
13,"CLUJ",127,55259,,168,0,"LICEUL INDUSTRIAL NR. 3, PIATA BASARABIEI NR.48","MUNICIPIUL TURDA",5,55259,1,1,904,515,464,51,506,9,999,484,317,189,
13,"CLUJ",127,55259,,169,0,"LICEUL INDUSTRIAL NR. 3, PIATA BASARABIEI NR.48","MUNICIPIUL TURDA",5,55259,1,1,1027,530,491,39,523,7,1088,558,338,185,
13,"CLUJ",127,55259,,170,0,"LICEUL INDUSTRIAL NR. 3, PIATA BASARABIEI NR.48","MUNICIPIUL TURDA",5,55259,1,1,862,463,434,29,455,8,905,442,322,133,
13,"CLUJ",127,55259,,171,0,"LICEUL ""MIHAI VITEAZU"", STR. DR. ION RATIU NR. 111","MUNICIPIUL TURDA",5,55259,1,1,787,417,378,39,412,5,851,434,298,114,
13,"CLUJ",127,55259,,172,0,"STATIUNEA DE CERCETARI AGRICOLE, STR. AGRICULTURII NR. 27","MUNICIPIUL TURDA",5,55259,1,1,1784,681,607,74,675,6,1954,1273,384,291,
13,"CLUJ",127,55259,,173,0,"SCOALA GEN. NR.4, STR. AXENTE SEVER NR. 4","MUNICIPIUL TURDA",5,55259,1,1,1143,641,473,168,634,7,1240,599,333,301,
13,"CLUJ",127,55259,,174,0,"SCOALA GEN. NR.4, STR. AXENTE SEVER NR. 4","MUNICIPIUL TURDA",5,55259,1,1,1337,766,633,133,747,19,1446,680,459,288,
13,"CLUJ",127,55259,,175,0,"STR. 22 DECEMBRIE 1989 (CLUBUL CIMENT)","MUNICIPIUL TURDA",5,55259,1,1,1374,726,623,103,713,13,1511,785,492,221,
13,"CLUJ",127,55259,,176,0,"CLUBUL STICLA, STR. FABRICILOR NR. 51","MUNICIPIUL TURDA",5,55259,1,1,970,576,480,96,569,7,1054,478,375,194,
13,"CLUJ",127,55259,,177,0,"LICEUL INDUSTRIAL NR.1, STR. TINERETULUI NR. 6","MUNICIPIUL TURDA",5,55259,1,1,1254,633,568,65,627,6,1352,719,327,300,
13,"CLUJ",127,55259,,178,0,"LICEUL INDUSTRIAL NR.1, STR. TINERETULUI NR. 6","MUNICIPIUL TURDA",5,55259,1,1,1613,823,709,114,816,7,1736,913,415,401,
13,"CLUJ",127,55259,,179,0,"SCOALA GEN. NR. 6, STR. RAPSODIEI NR. 1","MUNICIPIUL TURDA",5,55259,1,1,1005,669,526,143,661,8,1042,373,417,244,
13,"CLUJ",127,55259,,180,0,"SCOALA GEN. NR. 6, STR. RAPSODIEI NR. 1","MUNICIPIUL TURDA",5,55259,1,1,1562,802,747,55,791,11,1700,898,497,294,
13,"CLUJ",127,55259,,181,0,"SCOALA GEN. NR. 6, STR. RAPSODIEI NR. 1","MUNICIPIUL TURDA",5,55259,1,1,1261,687,623,64,679,8,1346,659,397,282,
13,"CLUJ",127,55259,,182,0,"SCOALA GEN. NR. 8, STR. AVIATORILOR NR. 14","MUNICIPIUL TURDA",5,55259,1,1,985,523,476,47,517,6,1054,531,339,178,
13,"CLUJ",127,55259,,183,0,"SCOALA GEN. NR. 8, STR. AVIATORILOR NR. 14","MUNICIPIUL TURDA",5,55259,1,1,1191,640,604,36,640,0,1320,680,392,248,
13,"CLUJ",127,55259,,184,0,"SCOALA GEN. NR. 8, STR. AVIATORILOR NR. 14","MUNICIPIUL TURDA",5,55259,1,1,2078,1014,960,54,999,15,2253,1239,557,442,
13,"CLUJ",127,55259,,185,0,"LICEUL INDUSTRIAL NR.1, STR. TINERETULUI NR. 6","MUNICIPIUL TURDA",5,55259,1,1,2210,1012,922,90,996,16,2402,1390,513,483,
13,"CLUJ",127,55259,,186,0,"LICEUL INDUSTRIAL NR.1, STR. TINERETULUI NR. 6","MUNICIPIUL TURDA",5,55259,1,1,1763,822,754,68,817,5,1893,1071,438,379,
13,"CLUJ",127,55259,,187,0,"LICEUL INDUSTRIAL NR.1, STR. TINERETULUI NR. 6","MUNICIPIUL TURDA",5,55259,1,1,1698,893,767,126,878,15,1855,962,469,409,
13,"CLUJ",127,55259,,188,0,"SCOALA GEN. NR.7, STR. LOTUS NR. 7","MUNICIPIUL TURDA",5,55259,1,1,1740,777,711,66,768,9,1916,1139,375,393,
13,"CLUJ",127,55259,,189,0,"SCOALA GEN. NR.7, STR. LOTUS NR. 7","MUNICIPIUL TURDA",5,55259,1,1,1948,1039,931,108,1031,8,2090,1051,588,443,
13,"CLUJ",127,55259,,190,0,"SCOALA GEN. NR.7, STR. LOTUS NR. 7","MUNICIPIUL TURDA",5,55259,1,1,945,483,442,41,476,7,1000,517,281,195,
13,"CLUJ",127,55259,,191,0,"SCOALA GEN. NR.7, STR. LOTUS NR. 7","MUNICIPIUL TURDA",5,55259,1,1,2506,1171,1089,82,1158,13,2757,1586,585,573,
13,"CLUJ",127,55259,,192,0,"SCOALA GEN. NR.7, STR. LOTUS NR. 7","MUNICIPIUL TURDA",5,55259,1,1,1505,755,657,98,742,13,1650,895,409,333,
13,"CLUJ",127,55259,,193,0,"SCOALA GEN. NR.7, STR. LOTUS NR. 7","MUNICIPIUL TURDA",5,55259,1,1,1321,655,628,27,649,6,1400,745,355,294,
13,"CLUJ",127,55259,,194,0,"SCOALA GEN. NR.5, STR. CAMPIEI NR. 51","MUNICIPIUL TURDA",5,55259,1,1,902,520,466,54,512,8,999,479,291,221,
13,"CLUJ",127,55259,,195,0,"SCOALA GEN. NR.5, STR. CAMPIEI NR. 51","MUNICIPIUL TURDA",5,55259,1,1,1086,636,573,63,626,5,1200,564,429,197,
13,"CLUJ",127,55259,,196,1,"SC CASIROM SA, STR. 22 DECEMBRIE 1989 NR. 35","MUNICIPIUL TURDA",5,55259,1,1,0,220,0,220,203,17,286,64,94,109,
13,"CLUJ",127,55259,,197,1,"SPITALUL MUNICIPAL, STR. ANDREI MURESANU NR. 18-22","MUNICIPIUL TURDA",5,55259,1,1,0,179,0,179,176,3,312,133,101,75,
13,"CLUJ",127,55357,,198,0,"GRUPUL SCOLAR METALURGIC, STR. LAMINORISTILOR NR. 115","MUNICIPIUL CAMPIA TURZII",2,55357,1,1,1585,733,667,66,729,4,1700,967,442,287,
13,"CLUJ",127,55357,,199,0,"GRUPUL SCOLAR METALURGIC, STR. LAMINORISTILOR NR. 115","MUNICIPIUL CAMPIA TURZII",2,55357,1,1,1760,850,750,100,838,12,1900,1050,497,341,
13,"CLUJ",127,55357,,200,0,"SCOALA GEN. NR. 3, STR. GHEORGHE LAZAR NR. 14","MUNICIPIUL CAMPIA TURZII",2,55357,1,1,1822,983,900,83,976,7,2000,1017,531,445,
13,"CLUJ",127,55357,,201,0,"SCOALA GEN. ""AVRAM IANCU"", STR. NOUA NR. 8","MUNICIPIUL CAMPIA TURZII",2,55357,1,1,1947,1077,1019,58,1057,20,2100,1023,701,356,
13,"CLUJ",127,55357,,202,0,"SCOALA GEN. ""AVRAM IANCU"", STR. NOUA NR. 8","MUNICIPIUL CAMPIA TURZII",2,55357,1,1,1989,1127,938,189,1108,19,2100,973,754,354,
13,"CLUJ",127,55357,,203,0,"GRADINITA NR.8, STR. RETEZATULUI NR. 6A","MUNICIPIUL CAMPIA TURZII",2,55357,1,1,2450,1232,1159,73,1220,12,2700,1468,737,483,
13,"CLUJ",127,55357,,204,0,"GRADINITA NR.8, STR. RETEZATULUI NR. 6A","MUNICIPIUL CAMPIA TURZII",2,55357,1,1,1968,931,868,63,922,9,2150,1219,480,442,
13,"CLUJ",127,55357,,205,0,"SCOALA GEN. ""MIHAI VITEAZU"", STR. GHEORGHE BARITIU NR. 57","MUNICIPIUL CAMPIA TURZII",2,55357,1,1,2090,1086,984,102,1073,13,2300,1214,510,563,
13,"CLUJ",127,55357,,206,0,"SCOALA GEN. ""MIHAI VITEAZU"", STR. GHEORGHE BARITIU NR. 57","MUNICIPIUL CAMPIA TURZII",2,55357,1,1,2056,1000,904,96,987,13,2250,1250,574,413,
13,"CLUJ",127,55357,,207,0,"LICEUL TEORETIC ""PAVEL DAN"", STR. TUDOR VLADIMIRESCU NR. 33","MUNICIPIUL CAMPIA TURZII",2,55357,1,1,2013,1006,913,93,988,14,2200,1198,523,465,
13,"CLUJ",127,55357,,208,0,"LICEUL TEORETIC ""PAVEL DAN"", STR. 1 DECEMBRIE 1918 NR. 17","MUNICIPIUL CAMPIA TURZII",2,55357,1,1,2129,937,865,72,933,4,2300,1359,550,383,
13,"CLUJ",127,55357,,209,0,"LICEUL TEORETIC ""PAVEL DAN"", STR. 1 DECEMBRIE 1918 NR. 17","MUNICIPIUL CAMPIA TURZII",2,55357,1,1,1990,1127,1014,113,1116,11,2150,1023,719,397,
13,"CLUJ",127,55357,,210,1,"UM 01845, 01848, 01896, 01969, 01980, 02087","MUNICIPIUL CAMPIA TURZII",2,55357,1,1,95,105,70,35,101,4,350,245,56,45,
13,"CLUJ",127,55384,,211,0,"RAGCL, STR. MIHAI EMINESCU NR.10","MUNICIPIUL GHERLA",4,55384,1,1,1629,1091,800,291,1071,20,1900,809,672,399,
13,"CLUJ",127,55384,,212,0,"LICEUL ""PETRU MAIOR"", STR. BOBALNA NR. 36","MUNICIPIUL GHERLA",4,55384,1,1,1502,846,792,54,836,10,1600,754,543,293,
13,"CLUJ",127,55384,,213,0,"SCOALA GEN. NR.2, STR. BOBALNA NR. 14","MUNICIPIUL GHERLA",4,55384,1,1,1692,847,795,52,837,10,1800,953,570,267,
13,"CLUJ",127,55384,,214,0,"SCOALA GEN. NR.1, STR. LIVIU REBREANU NR. 27","MUNICIPIUL GHERLA",4,55384,1,1,1862,834,793,41,827,7,2000,1166,494,333,
13,"CLUJ",127,55384,,215,0,"SCOALA GEN. NR.1, STR. LIVIU REBREANU NR. 27","MUNICIPIUL GHERLA",4,55384,1,1,1775,892,779,113,883,9,2000,1108,541,342,
13,"CLUJ",127,55384,,216,0,"SCOALA GEN. NR.2, STR. DRAGOS VODA NR. 3","MUNICIPIUL GHERLA",4,55384,1,1,1730,804,740,64,790,14,1800,995,491,299,
13,"CLUJ",127,55384,,217,0,"SCOALA GEN. ""ANA IPATESCU"", STR. 1 DECEMBRIE 1918 NR. 13","MUNICIPIUL GHERLA",4,55384,1,1,1932,981,827,154,975,6,2000,1019,606,369,
13,"CLUJ",127,55384,,218,0,"LICEUL ""ANA IPATESCU"", STR. 1 DECEMBRIE 1918 NR. 20","MUNICIPIUL GHERLA",4,55384,1,1,2179,971,922,49,959,12,2200,1229,528,431,
13,"CLUJ",127,55384,,219,0,"LICEUL ""ANA IPATESCU"", STR. 1 DECEMBRIE 1918 NR. 20","MUNICIPIUL GHERLA",4,55384,1,1,2139,1010,961,49,1004,6,2400,1390,556,448,
13,"CLUJ",127,55384,,220,0,"CLUBUL COPIILOR, STR. 1 DECEMBRIE 1918 NR. 12","MUNICIPIUL GHERLA",4,55384,1,1,1902,873,815,58,868,5,2000,1127,433,435,
13,"CLUJ",127,55384,,221,0,"SMA GHERLA, STR. CLUJULUI NR. 17","MUNICIPIUL GHERLA",4,55384,1,1,324,154,113,41,151,3,600,446,85,66,
13,"CLUJ",127,55384,,222,0,"HASDATE (SCOALA GENERALA)","MUNICIPIUL GHERLA",4,55384,1,1,370,156,128,28,155,1,400,244,72,83,
13,"CLUJ",127,55446,,223,0,"LICEUL TEORETIC ""OCTAVIAN GOGA"", PIATA VICTORIEI NR. 11","ORAS HUEDIN",6,55446,2,1,2238,1111,987,124,1106,5,2400,1289,564,542,
13,"CLUJ",127,55446,,224,0,"SCOALA GENERALA, STR. HOREA NR. 78","ORAS HUEDIN",6,55446,2,1,1493,851,596,255,846,5,1550,699,528,318,
13,"CLUJ",127,55446,,225,0,"CASA TINERETULUI, STR. AVRAM IANCU NR. 35","ORAS HUEDIN",6,55446,2,1,1381,1009,902,107,1005,4,1850,841,546,459,
13,"CLUJ",127,55446,,226,0,"PRIMARIA, STR. HOREA NR. 1","ORAS HUEDIN",6,55446,2,1,1336,750,616,134,733,17,1550,800,479,254,
13,"CLUJ",127,55446,,227,0,"SCOALA GEN. ""CETATE"", STR. CETATEA VECHE NR. 2","ORAS HUEDIN",6,55446,2,1,495,214,190,24,206,8,550,336,89,117,
13,"CLUJ",127,55446,,228,0,"BICALAT (SCOALA GENERALA)","ORAS HUEDIN",6,55446,2,1,376,271,234,37,269,2,397,126,240,29,
13,"CLUJ",127,55446,,229,1,"LICEUL TEORETIC ""OCTAVIAN GOGA"", PIATA VICTORIEI NR. 11","ORAS HUEDIN",6,55446,2,1,0,96,0,96,93,3,200,104,45,48,
13,"CLUJ",127,55473,,230,0,"AGHIRESU (SEDIUL PRIMARIEI)","AGHIRESU",7,55473,0,3,1060,552,447,105,549,3,1166,614,252,297,
13,"CLUJ",127,55473,,231,0,"AGHIRESU-FABRICI (CASA DE CULTURA)","AGHIRESU",7,55473,0,3,1218,621,528,93,619,2,1340,719,347,272,
13,"CLUJ",127,55473,,232,0,"AGHIRESU-FABRICI (SCOALA GENERALA)","AGHIRESU",7,55473,0,3,1313,610,515,95,604,6,1445,835,321,283,
13,"CLUJ",127,55473,,233,0,"BAGARA (SCOALA GENERALA)","AGHIRESU",7,55473,0,3,387,251,203,48,243,8,428,175,221,22,
13,"CLUJ",127,55473,,234,0,"INUCU (CAMINUL CULTURAL)","AGHIRESU",7,55473,0,3,357,242,224,18,241,1,395,153,222,19,
13,"CLUJ",127,55473,,235,0,"LEGHIA (SCOALA GENERALA)","AGHIRESU",7,55473,0,3,467,308,285,23,307,1,515,207,289,18,
13,"CLUJ",127,55473,,236,0,"MACAU (SEDIUL CONSILIULUI LOCAL)","AGHIRESU",7,55473,0,3,586,358,336,22,356,2,646,288,342,14,
13,"CLUJ",127,55473,,237,0,"TICU-COLONIE (SCOALA GENERALA)","AGHIRESU",7,55473,0,3,615,261,198,63,256,5,615,354,147,109,
13,"CLUJ",127,55598,,238,0,"AITON (CAMINUL CULTURAL)","AITON",8,55598,0,3,642,374,324,50,367,7,700,326,240,127,
13,"CLUJ",127,55598,,239,0,"FOSTUL CAP REDIU","AITON",8,55598,0,3,609,267,235,32,266,1,700,433,85,181,
13,"CLUJ",127,55623,,240,0,"CAMIN CULTURAL ALUNIS","ALUNIS",9,55623,0,3,585,276,251,25,272,4,656,380,112,160,
13,"CLUJ",127,55623,,241,0,"SCOALA GENERALA CL. I-IV CORNENI","ALUNIS",9,55623,0,3,278,95,73,22,92,3,303,208,54,38,
13,"CLUJ",127,55623,,242,0,"FOSTUL SEDIU CAP","ALUNIS",9,55623,0,3,420,174,156,18,166,8,476,302,55,111,
13,"CLUJ",127,55687,,243,0,"CAMIN CULTURAL APAHIDA","APAHIDA",10,55687,0,3,1620,680,571,109,671,9,1750,1070,355,316,
13,"CLUJ",127,55687,,244,0,"CAMIN CULTURAL APAHIDA","APAHIDA",10,55687,0,3,1752,704,577,127,700,4,1900,1196,359,341,
13,"CLUJ",127,55687,,245,0,"SCOALA GENERALA SANNICOARA","APAHIDA",10,55687,0,3,1055,690,552,138,681,9,1150,460,300,381,
13,"CLUJ",127,55687,,246,0,"FOSTA PRIMARIE DEZMIR","APAHIDA",10,55687,0,3,887,477,393,84,474,3,950,473,213,261,
13,"CLUJ",127,55687,,247,0,"FOSTA PRIMARIE PATA","APAHIDA",10,55687,0,3,545,323,235,88,320,3,550,227,193,127,
13,"CLUJ",127,55687,,248,0,"SCOALA GENERALA CORPADEA","APAHIDA",10,55687,0,3,385,202,161,41,201,1,450,248,87,114,
13,"CLUJ",127,55776,,249,0,"GRADINITA ASCHILEUL MARE","ASCHILEU",11,55776,0,3,929,382,337,45,380,2,1031,649,219,161,
13,"CLUJ",127,55776,,250,0,"SCOALA PRIMARA ASCHILEUL MIC","ASCHILEU",11,55776,0,3,297,195,160,35,189,6,332,137,117,72,
13,"CLUJ",127,55776,,251,0,"SCOALA PRIMARA CRISTOREL","ASCHILEU",11,55776,0,3,345,181,160,21,178,3,388,207,102,76,
13,"CLUJ",127,55838,,252,0,"CAMINUL CULTURAL BACIU","BACIU",12,55838,0,3,1829,892,778,114,882,10,2004,1112,687,195,
13,"CLUJ",127,55838,,253,0,"CAMINUL CULTURAL BACIU","BACIU",12,55838,0,3,1180,632,521,111,625,7,1292,660,344,281,
13,"CLUJ",127,55838,,254,0,"SCOALA GENERALA CORUSU","BACIU",12,55838,0,3,607,377,308,69,377,0,664,287,171,206,
13,"CLUJ",127,55838,,255,0,"SCOALA GENERALA MERA","BACIU",12,55838,0,3,1108,853,790,63,849,4,1221,368,718,131,
13,"CLUJ",127,55838,,256,0,"SCOALA GENERALA POPESTI","BACIU",12,55838,0,3,456,301,263,38,298,3,506,205,104,194,
13,"CLUJ",127,55838,,257,0,"SCOALA GENERALA SUCEAGU","BACIU",12,55838,0,3,922,493,434,59,482,11,1013,520,352,130,
13,"CLUJ",127,55918,,258,0,"SCOALA GENERALA BAISOARA","BAISOARA",13,55918,0,3,908,465,436,29,462,3,1000,535,200,262,
13,"CLUJ",127,55918,,259,0,"SCOALA GENERALA SACEL","BAISOARA",13,55918,0,3,374,242,219,23,239,3,400,158,94,145,
13,"CLUJ",127,55918,,260,0,"SCOALA GENERALA MUNTELE BAISORII","BAISOARA",13,55918,0,3,510,239,221,18,236,3,560,321,52,184,
13,"CLUJ",127,55918,,261,0,"SCOALA GENERALA MUNTELE SACEL","BAISOARA",13,55918,0,3,208,99,65,34,97,2,243,144,30,67,
13,"CLUJ",127,55918,,262,1,"CABANA MILITARA MUNTELE BAISORII","BAISOARA",13,55918,0,3,0,67,0,67,66,1,200,133,24,42,
13,"CLUJ",127,56014,,263,0,"PRIMARIA BELIS","BELIS",14,56014,0,3,684,523,412,111,516,7,744,221,177,339,
13,"CLUJ",127,56014,,264,0,"SCOALA GENERALA DEALU BOTII","BELIS",14,56014,0,3,59,50,39,11,50,0,65,15,16,34,
13,"CLUJ",127,56014,,265,0,"SCOALA GENERALA GIURCUTA DE SUS","BELIS",14,56014,0,3,214,173,150,23,173,0,237,64,108,65,
13,"CLUJ",127,56014,,266,0,"CAMIN CULTURAL POIANA HOREA","BELIS",14,56014,0,3,368,315,275,40,311,4,404,89,161,150,
13,"CLUJ",127,56096,,267,0,"SCOALA GENERALA BOBALNA","BOBALNA",15,56096,0,3,517,311,253,58,306,5,566,255,183,123,
13,"CLUJ",127,56096,,268,0,"SCOALA GENERALA MAIA","BOBALNA",15,56096,0,3,452,271,214,57,271,0,496,225,139,132,
13,"CLUJ",127,56096,,269,0,"SCOALA GENERALA BABDIU","BOBALNA",15,56096,0,3,345,195,152,43,194,1,375,180,81,113,
13,"CLUJ",127,56096,,270,0,"SCOALA GENERALA OSORHEL","BOBALNA",15,56096,0,3,244,164,90,74,164,0,264,100,81,83,
13,"CLUJ",127,56210,,271,0,"PRIMARIA BONTIDA","BONTIDA",16,56210,0,3,2000,1009,906,103,1003,6,2198,1187,574,429,
13,"CLUJ",127,56210,,272,0,"SCOALA GENERALA RASCRUCI","BONTIDA",16,56210,0,3,1100,701,577,124,689,12,1213,512,382,307,
13,"CLUJ",127,56210,,273,0,"SCOALA GENERALA COASTA","BONTIDA",16,56210,0,3,261,117,73,44,115,2,291,174,52,63,
13,"CLUJ",127,56265,,274,0,"CONSILIUL LOCAL BORSA","BORSA",17,56265,0,3,1100,655,574,81,646,9,1219,564,341,305,
13,"CLUJ",127,56265,,275,0,"CAMINUL CULTURAL GIULA","BORSA",17,56265,0,3,200,143,108,35,137,6,224,81,56,81,
13,"CLUJ",127,56265,,276,0,"SCOALA GENERALA CIUMAFAIA","BORSA",17,56265,0,3,142,104,74,30,104,0,157,53,62,42,
13,"CLUJ",127,56327,,277,0,"CAMINUL CULTURAL ROTUNDA","BUZA",18,56327,0,3,1215,732,673,59,714,18,1350,618,485,229,
13,"CLUJ",127,56354,,278,0,"CAMINUL CULTURAL CAIANU","CAIANU",19,56354,0,3,649,253,218,35,251,2,726,473,140,111,
13,"CLUJ",127,56354,,279,0,"SCOALA GENERALA BARAI","CAIANU",19,56354,0,3,302,183,152,31,180,3,332,149,64,116,
13,"CLUJ",127,56354,,280,0,"SCOALA GENERALA CAIANU VAMA","CAIANU",19,56354,0,3,412,234,188,46,234,0,452,218,118,116,
13,"CLUJ",127,56354,,281,0,"CAMINUL CULTURAL VAIDA CAMARAS","CAIANU",19,56354,0,3,809,413,371,42,406,7,891,478,380,26,
13,"CLUJ",127,56425,,282,0,"CAMINUL CULTURAL CALARASI","CALARASI",20,56425,0,3,1155,585,538,47,576,9,1200,615,433,143,
13,"CLUJ",127,56425,,283,0,"SCOALA GENERALA BOGATA","CALARASI",20,56425,0,3,883,496,442,54,489,7,1049,553,259,230,
13,"CLUJ",127,56461,,284,0,"PRIMARIA CALATELE","CALATELE",21,56461,0,3,953,563,507,56,554,9,1087,524,259,295,
13,"CLUJ",127,56461,,285,0,"SCOALA GENERALA CALATA","CALATELE",21,56461,0,3,648,353,306,47,350,3,724,371,181,169,
13,"CLUJ",127,56461,,286,0,"SCOALA GENERALA DEALU NEGRU","CALATELE",21,56461,0,3,610,365,268,97,365,0,650,285,122,243,
13,"CLUJ",127,56522,,287,0,"CAMINUL CULTURAL CLUB CAMARASU","CAMARASU",22,56522,0,3,1188,561,522,39,549,12,1302,741,276,273,
13,"CLUJ",127,56522,,288,0,"SCOALA GENERALA NAOIU","CAMARASU",22,56522,0,3,487,305,278,27,298,7,535,230,167,131,
13,"CLUJ",127,56522,,289,0,"SCOALA GENERALA SAMBOLENI","CAMARASU",22,56522,0,3,608,217,200,17,215,2,665,448,137,78,
13,"CLUJ",127,56568,,290,0,"CAMINUL CULTURAL CAPUSU MARE","CAPUSU MARE",23,56568,0,3,785,512,448,64,506,6,865,353,452,54,
13,"CLUJ",127,56568,,291,0,"CAMINUL CULTURAL CAPUSU MIC","CAPUSU MARE",23,56568,0,3,663,401,347,54,396,5,733,332,268,128,
13,"CLUJ",127,56568,,292,0,"FOSTUL SEDIU CAP DUMBRAVA","CAPUSU MARE",23,56568,0,3,319,206,171,35,206,0,354,148,151,55,
13,"CLUJ",127,56568,,293,0,"SCOALA GENERALA PANICENI","CAPUSU MARE",23,56568,0,3,300,170,140,30,170,0,336,166,54,116,
13,"CLUJ",127,56568,,294,0,"SCOALA GENERALA DANGAU MARE","CAPUSU MARE",23,56568,0,3,633,389,356,33,386,3,664,275,177,209,
13,"CLUJ",127,56568,,295,0,"SCOALA GENERALA AGARBICIU","CAPUSU MARE",23,56568,0,3,495,355,335,20,349,6,548,193,122,227,
13,"CLUJ",127,56666,,296,0,"CAMINUL CULTURAL CASEIU","CASEIU",24,56666,0,3,1395,659,575,84,647,12,1542,883,354,293,
13,"CLUJ",127,56666,,297,0,"SCOALA GENERALA RUGASESTI","CASEIU",24,56666,0,3,877,406,353,53,402,4,968,562,154,248,
13,"CLUJ",127,56666,,298,0,"SCOALA GENERALA GUGA","CASEIU",24,56666,0,3,294,149,131,18,149,0,327,178,68,81,
13,"CLUJ",127,56666,,299,0,"SCOALA GENERALA SALATRUC","CASEIU",24,56666,0,3,177,90,51,39,88,2,197,107,23,65,
13,"CLUJ",127,56666,,300,0,"SCOALA GENERALA GARBAUL-DEJULUI","CASEIU",24,56666,0,3,208,128,90,38,125,3,234,106,41,84,
13,"CLUJ",127,56666,,301,0,"SCOALA GENERALA URISOR","CASEIU",24,56666,0,3,709,361,307,54,354,7,782,421,180,174,
13,"CLUJ",127,56773,,302,0,"PRIMARIA CATINA","CATINA",26,56773,0,3,1232,635,610,25,604,9,1365,752,335,269,
13,"CLUJ",127,56773,,303,0,"SCOALA GENERALA FELDIOARA","CATINA",26,56773,0,3,520,279,241,38,276,3,574,295,172,104,
13,"CLUJ",127,56773,,304,0,"SCOALA GENERALA COPRU","CATINA",26,56773,0,3,141,102,87,15,102,0,161,59,45,57,
13,"CLUJ",127,56844,,305,0,"CAMINUL CULTURAL CEANU MARE","CEANU MARE",27,56844,0,3,1417,602,547,55,592,10,1572,970,237,355,
13,"CLUJ",127,56844,,306,0,"GRADINITA BOIAN","CEANU MARE",27,56844,0,3,832,459,413,46,457,2,917,458,237,220,
13,"CLUJ",127,56844,,307,0,"FOSTUL SEDIU CAP BOLDUT","CEANU MARE",27,56844,0,3,700,453,398,55,449,4,774,321,206,243,
13,"CLUJ",127,56844,,308,0,"CAMINUL CULTURAL IACOBENI","CEANU MARE",27,56844,0,3,600,299,252,47,296,3,666,367,99,197,
13,"CLUJ",127,56844,,309,0,"SCOALA GENERALA DOSU NAPULUI","CEANU MARE",27,56844,0,3,155,117,83,34,114,3,171,54,38,76,
13,"CLUJ",127,56988,,310,0,"PRIMARIE","CHINTENI",28,56988,0,3,802,386,332,54,377,9,900,514,252,125,
13,"CLUJ",127,56988,,311,0,"SCOALA GENERALA DEUSU","CHINTENI",28,56988,0,3,702,410,356,54,405,5,800,390,198,207,
13,"CLUJ",127,56988,,312,0,"SCOALA GENERALA MACICASU","CHINTENI",28,56988,0,3,450,281,250,31,250,3,500,247,134,116,
13,"CLUJ",127,56988,,313,0,"SCOALA GENERALA FEIURDENI","CHINTENI",28,56988,0,3,527,306,237,69,299,7,550,244,172,127,
13,"CLUJ",127,57083,,314,0,"SCOALA GENERALA CHIUIESTI","CHIUIESTI",29,57083,0,3,1364,797,743,54,792,5,1507,710,620,172,
13,"CLUJ",127,57083,,315,0,"SCOALA GENERALA MAGOAJA","CHIUIESTI",29,57083,0,3,343,242,194,48,237,5,381,139,108,129,
13,"CLUJ",127,57083,,316,0,"SCOALA GENERALA STRAMBU","CHIUIESTI",29,57083,0,3,515,241,205,36,231,10,566,325,102,129,
13,"CLUJ",127,57163,,317,0,"SCOALA GENERALA CIUCEA","CIUCEA",30,57163,0,3,1081,571,501,70,562,9,1280,709,224,338,
13,"CLUJ",127,57163,,318,0,"SCOALA GENERALA NEGRENI","CIUCEA",30,57163,0,3,1552,845,778,67,834,11,1658,813,229,605,
13,"CLUJ",127,57163,,319,0,"SCOALA GENERALA BUCEA","CIUCEA",30,57163,0,3,606,440,370,70,435,5,660,220,114,321,
13,"CLUJ",127,57163,,320,0,"SCOALA GENERALA VANATORI","CIUCEA",30,57163,0,3,418,247,222,25,244,3,500,253,32,212,
13,"CLUJ",127,57225,,321,0,"SCOALA GENERALA CIURILA","CIURILA",31,57225,0,3,168,112,90,22,110,2,200,88,50,60,
13,"CLUJ",127,57225,,322,0,"SCOALA GENERALA SALICEA","CIURILA",31,57225,0,3,222,131,98,33,129,2,240,109,52,77,
13,"CLUJ",127,57225,,323,0,"SCOALA GENERALA SUTU","CIURILA",31,57225,0,3,339,148,112,36,147,1,380,232,71,76,
13,"CLUJ",127,57225,,324,0,"SCOALA GENERALA FILEA DE JOS","CIURILA",31,57225,0,3,420,220,188,32,210,10,450,230,103,107,
13,"CLUJ",127,57225,,325,0,"SCOALA GENERALA SALISTE","CIURILA",31,57225,0,3,116,81,56,25,79,2,130,49,28,51,
13,"CLUJ",127,57314,,326,0,"CAMINUL CULTURAL CATCAU","CATCAU",25,57314,0,3,1154,757,608,149,754,3,1294,537,388,366,
13,"CLUJ",127,57314,,327,0,"SCOALA GENERALA SALISCA","CATCAU",25,57314,0,3,480,245,216,29,244,1,545,300,140,104,
13,"CLUJ",127,57314,,328,0,"SCOALA GENERALA MUNCEL","CATCAU",25,57314,0,3,223,128,112,16,127,1,258,130,60,67,
13,"CLUJ",127,57350,,329,0,"CAMINUL CULTURAL COJOCNA","COJOCNA",32,57350,0,3,1824,800,689,111,778,22,2014,1214,602,176,
13,"CLUJ",127,57350,,330,0,"SCOALA GENERALA BOJU","COJOCNA",32,57350,0,3,574,297,254,43,292,5,643,346,133,159,
13,"CLUJ",127,57350,,331,0,"SCOALA GENERALA CARA","COJOCNA",32,57350,0,3,582,319,257,62,310,9,646,327,182,128,
13,"CLUJ",127,57350,,332,0,"CAMINUL CULTURAL IURIU DE CAMPIE","COJOCNA",32,57350,0,3,489,314,249,65,308,6,547,233,178,130,
13,"CLUJ",127,57449,,333,0,"SCOALA GENERALA CORNESTI","CORNESTI",33,57449,0,3,401,226,176,50,222,4,451,225,142,80,
13,"CLUJ",127,57449,,334,0,"SCOALA GENERALA LUJERDIU","CORNESTI",33,57449,0,3,447,211,175,36,209,2,500,289,157,52,
13,"CLUJ",127,57449,,335,0,"SCOALA GENERALA TIOCU DE SUS","CORNESTI",33,57449,0,3,352,162,113,49,160,2,394,232,105,55,
13,"CLUJ",127,57449,,336,0,"CAMINUL CULTURAL TIOLTIUR","CORNESTI",33,57449,0,3,455,152,129,23,151,1,504,352,61,90,
13,"CLUJ",127,55062,,337,0,"CAMINUL CULTURAL","CUZDRIOARA",34,55062,0,3,1776,795,728,67,789,6,1972,1177,332,457,
13,"CLUJ",127,55062,,338,0,"SCOALA GENERALA MANASTUREL","CUZDRIOARA",34,55062,0,3,526,251,221,30,251,0,578,327,142,109,
13,"CLUJ",127,57546,,339,0,"SCOALA GENERALA DABACA","DABACA",35,57546,0,3,714,354,305,49,352,2,781,427,206,146,
13,"CLUJ",127,57546,,340,0,"SCOALA GENERALA LUNA","DABACA",35,57546,0,3,517,305,256,49,304,1,566,261,120,184,
13,"CLUJ",127,57546,,341,0,"CAMINUL CULTURAL PAGLISA","DABACA",35,57546,0,3,140,121,83,38,119,2,153,32,49,70,
13,"CLUJ",127,57582,,342,0,"PRIMARIA FELEACU","FELEACU",36,57582,0,3,1449,552,494,58,549,3,1700,1148,236,313,
13,"CLUJ",127,57582,,343,0,"SCOALA GENERALA GHEORGHENI","FELEACU",36,57582,0,3,916,447,409,38,440,7,996,549,404,36,
13,"CLUJ",127,57582,,344,0,"SCOALA GENERALA VILCELE","FELEACU",36,57582,0,3,763,331,274,57,328,3,800,469,97,231,
13,"CLUJ",127,57644,,345,0,"PRIMARIA FIZESU GHERLII","FIZESU GHERLII",37,57644,0,3,1117,528,476,52,520,8,1240,712,401,119,
13,"CLUJ",127,57644,,346,0,"SCOALA GENERALA NICULA","FIZESU GHERLII",37,57644,0,3,496,330,267,63,323,7,553,223,117,206,
13,"CLUJ",127,57644,,347,0,"SCOALA GENERALA BONT","FIZESU GHERLII",37,57644,0,3,303,173,140,33,170,3,335,162,93,77,
13,"CLUJ",127,57644,,348,0,"SCOALA GENERALA SACALAIA","FIZESU GHERLII",37,57644,0,3,199,150,99,51,148,2,222,72,82,66,
13,"CLUJ",127,57706,,349,0,"CAMIN CULTURAL NR. 2 FLORESTI","FLORESTI",38,57706,0,3,2695,1328,1142,186,1307,21,3006,1678,809,498,
13,"CLUJ",127,57706,,350,0,"GRADINITA NR.1 FLORESTI","FLORESTI",38,57706,0,3,791,500,396,104,490,10,826,326,275,215,
13,"CLUJ",127,57706,,351,1,"SEDIUL SC AVICOLA","FLORESTI",38,57706,0,3,0,147,0,147,141,6,400,253,70,71,
13,"CLUJ",127,57706,,352,0,"CAMINUL CULTURAL LUNA","FLORESTI",38,57706,0,3,1628,786,715,71,781,5,1787,1001,644,137,
13,"CLUJ",127,57706,,353,0,"CAMINUL CULTURAL TAUTI","FLORESTI",38,57706,0,3,165,115,66,49,108,7,183,68,38,70,
13,"CLUJ",127,57742,,354,0,"CAMINUL CULTURAL FRATA","FRATA",39,57742,0,3,1600,846,799,47,832,14,2084,1238,473,359,
13,"CLUJ",127,57742,,355,0,"SCOALA GENERALA BERCHES","FRATA",39,57742,0,3,627,320,275,45,312,8,689,369,183,129,
13,"CLUJ",127,57742,,356,0,"SCOALA POIANA FRATII","FRATA",39,57742,0,3,208,116,95,21,115,1,271,155,44,71,
13,"CLUJ",127,57742,,357,0,"SCOALA GENERALA SOPORUL DE CAMPIE","FRATA",39,57742,0,3,954,468,430,38,462,6,1206,738,284,178,
13,"CLUJ",127,57831,,358,0,"PRIMARIA GEACA","GEACA",41,57831,0,3,564,281,240,41,279,2,628,347,155,124,
13,"CLUJ",127,57831,,359,0,"SCOALA GENERALA LACU","GEACA",41,57831,0,3,259,163,128,35,163,0,294,131,143,20,
13,"CLUJ",127,57831,,360,0,"SCOALA GENERALA SUCUTARD","GEACA",41,57831,0,3,504,218,183,35,218,0,562,344,111,107,
13,"CLUJ",127,57831,,361,0,"CAMINUL CULTURAL LEGII","GEACA",41,57831,0,3,192,124,97,27,121,3,216,92,87,34,
13,"CLUJ",127,57902,,362,0,"CAMINUL CULTURAL GILAU","GILAU",42,57902,0,3,2434,1206,1069,137,1195,11,2600,1394,576,619,
13,"CLUJ",127,57902,,363,0,"CASA DE CULTURA GILAU","GILAU",42,57902,0,3,1851,1021,836,185,1011,10,2000,979,521,490,
13,"CLUJ",127,57902,,364,0,"SCOALA GENERALA SOMESU RECE","GILAU",42,57902,0,3,840,571,436,135,561,10,1000,429,266,295,
13,"CLUJ",127,57902,,365,0,"SCOALA GENERALA SOMESU RECE - UZINA ELECTRICA","GILAU",42,57902,0,3,437,232,163,69,232,0,650,418,76,156,
13,"CLUJ",127,57948,,366,0,"CAMINUL CULTURAL GARBAU","GARBAU",40,57948,0,3,1109,603,521,82,596,7,1220,617,364,232,
13,"CLUJ",127,57948,,367,0,"SCOALA GENERALA VISTEA","GARBAU",40,57948,0,3,631,486,439,47,477,9,696,210,455,22,
13,"CLUJ",127,57948,,368,0,"CAMINUL CULTURAL NADASEL","GARBAU",40,57948,0,3,257,211,168,43,210,1,284,73,89,121,
13,"CLUJ",127,58008,,369,0,"SCOALA GENERALA IARA","IARA",43,58008,0,3,1872,726,650,76,723,3,2048,1322,397,326,
13,"CLUJ",127,58008,,370,0,"SCOALA GENERALA AGRIS","IARA",43,58008,0,3,458,220,202,18,220,0,500,280,62,158,
13,"CLUJ",127,58008,,371,0,"COOPERATIVA DE CONSUM BORZESTI","IARA",43,58008,0,3,59,71,27,44,71,0,100,29,48,23,
13,"CLUJ",127,58008,,372,0,"SCOALA GENERALA BURU","IARA",43,58008,0,3,261,183,119,64,181,2,290,107,50,131,
13,"CLUJ",127,58008,,373,0,"SCOALA GENERALA CACOVA-DEAL","IARA",43,58008,0,3,686,310,275,35,309,1,750,440,149,160,
13,"CLUJ",127,58008,,374,0,"SCOALA GENERALA OCOLISEL","IARA",43,58008,0,3,151,94,68,26,92,2,170,76,19,73,
13,"CLUJ",127,58008,,375,0,"SCOALA GENERALA SURDUC","IARA",43,58008,0,3,366,171,148,23,168,3,400,229,45,123,
13,"CLUJ",127,58142,,376,0,"CONSILIUL LOCAL ICLOD","ICLOD",44,58142,0,3,1554,775,686,89,768,7,1718,943,281,487,
13,"CLUJ",127,58142,,377,0,"SCOALA GENERALA FUNDATURA","ICLOD",44,58142,0,3,575,326,281,45,322,4,633,307,128,194,
13,"CLUJ",127,58142,,378,0,"SCOALA GENERALA LIVADA","ICLOD",44,58142,0,3,683,435,387,48,425,7,754,318,165,260,
13,"CLUJ",127,58142,,379,0,"SCOALA GENERALA ORMAN","ICLOD",44,58142,0,3,619,290,261,29,289,1,695,405,84,205,
13,"CLUJ",127,58204,,380,0,"SEDIUL PRIMARIEI","IZVORU CRISULUI",45,58204,0,3,1117,641,556,85,633,8,1236,595,614,19,
13,"CLUJ",127,58204,,381,0,"SCOALA GENERALA NADASU","IZVORU CRISULUI",45,58204,0,3,277,214,182,32,214,0,314,100,85,129,
13,"CLUJ",127,55106,,382,0,"SCOALA GENERALA JICHISU DE JOS","JICHISU DE JOS",46,55106,0,3,376,257,220,37,256,1,410,153,111,145,
13,"CLUJ",127,55106,,383,0,"SCOALA GENERALA JICHISU DE SUS","JICHISU DE JOS",46,55106,0,3,285,137,119,18,137,0,325,188,65,72,
13,"CLUJ",127,55106,,384,0,"SCOALA GENERALA CODOR","JICHISU DE JOS",46,55106,0,3,332,249,229,20,245,4,373,124,116,129,
13,"CLUJ",127,55106,,385,0,"SCOALA GENERALA TARPIU","JICHISU DE JOS",46,55106,0,3,124,102,91,11,100,2,142,40,40,60,
13,"CLUJ",127,58259,,386,0,"PRIMARIA JUCU","JUCU",47,58259,0,3,1364,735,543,192,731,4,1496,761,350,381,
13,"CLUJ",127,58259,,387,0,"SCOALA PRIMARA JUCU DE MIJLOC","JUCU",47,58259,0,3,652,262,218,44,261,1,714,452,117,144,
13,"CLUJ",127,58259,,388,0,"SCOALA GENERALA GADALIN","JUCU",47,58259,0,3,594,376,313,63,374,2,655,279,136,238,
13,"CLUJ",127,58259,,389,0,"SCOALA GENERALA VISEA","JUCU",47,58259,0,3,526,264,236,28,260,4,577,313,208,52,
13,"CLUJ",127,58311,,390,0,"CAMINUL CULTURAL LUNA","LUNA",48,58311,0,3,1942,1036,936,100,1029,7,2126,1090,529,500,
13,"CLUJ",127,58311,,391,0,"GRADINITA DE COPII","LUNA",48,58311,0,3,1081,603,517,86,595,8,1190,587,370,225,
13,"CLUJ",127,58311,,392,0,"SCOALA GENERALA GLIGORESTI","LUNA",48,58311,0,3,442,268,224,44,261,7,484,216,126,135,
13,"CLUJ",127,58357,,393,0,"SALA DE SEDINTE A PRIMARIEI","MAGURI-RACATAU",49,58357,0,3,713,335,271,64,331,4,780,445,105,226,
13,"CLUJ",127,58357,,394,0,"CLADIREA SCOLII DIN MAGURI-BOGDANESTI","MAGURI-RACATAU",49,58357,0,3,759,236,205,31,233,3,840,604,98,135,
13,"CLUJ",127,58357,,395,0,"CLADIREA SCOLII DIN MUNTELE RECE","MAGURI-RACATAU",49,58357,0,3,520,231,170,61,230,1,570,339,65,165,
13,"CLUJ",127,58393,,396,0,"PRIMARIA MANASTIRENI","MANASTIRENI",50,58393,0,3,1037,593,531,62,590,3,1155,562,292,298,
13,"CLUJ",127,58393,,397,0,"SCOALA GENERALA BEDECIU","MANASTIRENI",50,58393,0,3,554,336,300,36,332,4,608,272,141,191,
13,"CLUJ",127,58464,,398,0,"CONSILIUL LOCAL MARGAU","MARGAU",51,58464,0,3,470,235,207,28,231,4,525,290,56,175,
13,"CLUJ",127,58464,,399,0,"CONSILIUL LOCAL MARGAU-RACHITELE","MARGAU",51,58464,0,3,776,453,402,51,449,4,860,407,164,285,
13,"CLUJ",127,58464,,400,0,"SCOALA GENERALA SCRIND FRASINET","MARGAU",51,58464,0,3,154,124,98,26,124,0,175,51,37,87,
13,"CLUJ",127,58464,,401,0,"SCOALA GENERALA BUTENI","MARGAU",51,58464,0,3,258,128,81,47,123,5,291,163,49,74,
13,"CLUJ",127,58534,,402,0,"PRIMARIA MARISEL","MARISEL",52,58534,0,3,1223,523,477,46,521,2,1300,777,167,354,
13,"CLUJ",127,58534,,403,0,"BLOCUL CHE MARISEL AP.2","MARISEL",52,58534,0,3,156,143,65,78,142,1,250,107,34,108,
13,"CLUJ",127,55160,,404,0,"SCOALA GENERALA MICA","MICA",53,55160,0,3,659,401,325,76,398,3,725,324,177,221,
13,"CLUJ",127,55160,,405,0,"CAMINUL CULTURAL MANASTIREA","MICA",53,55160,0,3,507,323,256,67,317,6,567,244,175,142,
13,"CLUJ",127,55160,,406,0,"CLADIREA FOSTULUI CAP NIRES","MICA",53,55160,0,3,962,432,376,56,421,11,1062,630,305,116,
13,"CLUJ",127,55160,,407,0,"SCOALA GENERALA SANMARGHITA","MICA",53,55160,0,3,899,421,364,57,407,14,996,575,241,166,
13,"CLUJ",127,55277,,408,0,"CAMINUL CULTURAL MIHAI VITEAZU","MIHAI VITEAZU",54,55277,0,3,2370,1168,1062,106,1150,18,2500,1332,619,531,
13,"CLUJ",127,55277,,409,0,"SCOALA VECHE MIHAI VITEAZU","MIHAI VITEAZU",54,55277,0,3,1201,566,494,72,557,9,1300,734,314,243,
13,"CLUJ",127,55277,,410,0,"SCOALA GENERALA CHEIA","MIHAI VITEAZU",54,55277,0,3,474,254,204,50,252,2,600,346,116,136,
13,"CLUJ",127,55277,,411,0,"SCOALA GENERALA CORNESTI","MIHAI VITEAZU",54,55277,0,3,566,357,310,47,346,11,692,335,289,57,
13,"CLUJ",127,58552,,412,0,"CLUBUL TINERETULUI","MINTIU GHERLII",55,58552,0,3,1504,678,612,66,666,12,1650,972,325,341,
13,"CLUJ",127,58552,,413,0,"SCOALA GENERALA BUNESTI","MINTIU GHERLII",55,58552,0,3,661,285,250,35,284,1,720,435,98,186,
13,"CLUJ",127,58552,,414,0,"SCOALA GENERALA NIMA","MINTIU GHERLII",55,58552,0,3,582,260,221,39,255,5,639,379,72,183,
13,"CLUJ",127,58552,,415,0,"SCOALA GENERALA PADURENI","MINTIU GHERLII",55,58552,0,3,126,116,85,31,115,1,140,24,34,81,
13,"CLUJ",127,58623,,416,0,"SCOALA GENERALA MOCIU","MOCIU",56,58623,0,3,1387,733,633,100,724,9,1300,567,452,272,
13,"CLUJ",127,58623,,417,0,"SCOALA GENERALA BOTENI","MOCIU",56,58623,0,3,250,119,75,44,119,0,275,156,43,76,
13,"CLUJ",127,58623,,418,0,"SCOALA GENERALA CHESAU","MOCIU",56,58623,0,3,328,174,157,17,171,3,350,176,164,7,
13,"CLUJ",127,58623,,419,0,"SCOALA GENERALA CRISENI","MOCIU",56,58623,0,3,266,168,154,14,166,2,300,132,127,39,
13,"CLUJ",127,58623,,420,0,"SCOALA GENERALA GHIRISU ROMAN","MOCIU",56,58623,0,3,335,175,151,24,173,2,350,175,94,79,
13,"CLUJ",127,58623,,421,0,"SCOALA GENERALA ROSIENI","MOCIU",56,58623,0,3,171,110,83,27,109,1,200,90,45,64,
13,"CLUJ",127,58623,,422,0,"SC.GEN. ZORENII DE VALE","MOCIU",56,58623,0,3,254,124,98,26,122,2,300,176,65,57,
13,"CLUJ",127,58721,,423,0,"CONSILIUL LOCAL MOLDOVENESTI","MOLDOVENESTI",57,58721,0,3,1143,498,466,32,480,18,1260,762,421,59,
13,"CLUJ",127,58721,,424,0,"SC.GEN. PODENI","MOLDOVENESTI",57,58721,0,3,597,339,294,45,334,5,665,326,141,193,
13,"CLUJ",127,58721,,425,0,"SC.GEN. PLAIESTI","MOLDOVENESTI",57,58721,0,3,428,437,372,65,431,6,475,38,409,22,
13,"CLUJ",127,58721,,426,0,"SC.GEN. BADENI","MOLDOVENESTI",57,58721,0,3,732,323,284,39,317,6,800,477,276,41,
13,"CLUJ",127,58856,,427,0,"PRIMARIA PANTICEU","PANTICEU",59,58856,0,3,516,264,186,78,262,2,573,309,171,91,
13,"CLUJ",127,58856,,428,0,"SEDIUL FOSTULUI CAP DIRJA","PANTICEU",59,58856,0,3,225,154,108,46,154,0,259,105,84,70,
13,"CLUJ",127,58856,,429,0,"SC.GEN. CUBLES","PANTICEU",59,58856,0,3,451,290,239,51,282,8,500,210,161,121,
13,"CLUJ",127,58856,,430,0,"SC.GEN. SARATA","PANTICEU",59,58856,0,3,326,116,66,50,115,1,367,251,58,57,
13,"CLUJ",127,58794,,431,0,"SC.GEN. PALATCA","PALATCA",58,58794,0,3,907,360,326,34,357,3,1020,660,232,125,
13,"CLUJ",127,58794,,432,0,"SC.GEN. SAVA","PALATCA",58,58794,0,3,427,156,121,35,153,3,480,324,89,64,
13,"CLUJ",127,58918,,433,0,"SEDIUL PRIMARIEI","PETRESTII DE JOS",60,58918,0,3,1113,439,395,44,437,2,1200,761,161,276,
13,"CLUJ",127,58918,,434,0,"CAMINUL CULTURAL","PETRESTII DE JOS",60,58918,0,3,207,134,101,33,132,2,250,116,78,54,
13,"CLUJ",127,58918,,435,0,"SC.GEN. CRAIESTI","PETRESTII DE JOS",60,58918,0,3,360,177,148,29,167,10,400,223,66,101,
13,"CLUJ",127,58990,,436,0,"SC.GEN. PLOSCOS","PLOSCOS",61,58990,0,3,658,330,272,58,327,3,750,420,128,199,
13,"CLUJ",127,59041,,437,0,"CAMINUL CULTURAL POIENI","POIENI",62,59041,0,3,1003,654,570,84,645,9,1100,446,247,398,
13,"CLUJ",127,59041,,438,0,"SC.CLASELE I-VIII BOLOGA","POIENI",62,59041,0,3,601,417,384,33,415,2,650,233,164,251,
13,"CLUJ",127,59041,,439,0,"SC.CLASELE 1-VIII MORLACA","POIENI",62,59041,0,3,749,437,387,50,433,4,800,363,160,273,
13,"CLUJ",127,59041,,440,0,"SC.CLASELE I-IV HODISU","POIENI",62,59041,0,3,430,267,239,28,258,9,470,203,83,175,
13,"CLUJ",127,59041,,441,0,"SC.CLASELE I-VIII VALEA DRAGANULUI","POIENI",62,59041,0,3,1514,844,775,69,836,8,1650,806,381,455,
13,"CLUJ",127,59041,,442,0,"SC.CLASELE I-VIII TRANISU","POIENI",62,59041,0,3,461,249,226,23,247,2,500,251,79,168,
13,"CLUJ",127,59041,,443,0,"SC.CLASELE I-IV LUNCA VISAGULUI","POIENI",62,59041,0,3,258,146,126,20,145,1,280,134,62,83,
13,"CLUJ",127,59130,,444,0,"PRIMARIA RECEA CRISTUR","RECEA-CRISTUR",63,59130,0,3,777,334,276,58,330,4,870,536,158,172,
13,"CLUJ",127,59130,,445,0,"SC.GEN. CIUBANCUTA","RECEA-CRISTUR",63,59130,0,3,658,356,308,48,353,3,730,374,180,173,
13,"CLUJ",127,59238,,446,0,"SC.GEN. RISCA","RISCA",64,59238,0,3,1300,480,457,23,475,5,1390,910,116,359,
13,"CLUJ",127,59238,,447,0,"SC.GEN. DEALU MARE","RISCA",64,59238,0,3,416,235,227,8,232,3,500,265,62,170,
13,"CLUJ",127,59283,,448,0,"CAMINUL CULTURAL SACUIEU","SACUIEU",65,59283,0,3,434,274,254,20,268,6,475,201,107,161,
13,"CLUJ",127,59283,,449,0,"CAMINUL CULTURAL ROGOJEL","SACUIEU",65,59283,0,3,631,330,319,11,328,2,695,365,63,265,
13,"CLUJ",127,59283,,450,0,"SC.GEN. VISAG","SACUIEU",65,59283,0,3,345,257,237,20,255,2,373,116,53,202,
13,"CLUJ",127,55311,,451,0,"SC.GEN. SANDULESTI","SANDULESTI",67,55311,0,3,512,263,230,33,262,1,604,341,154,108,
13,"CLUJ",127,55311,,452,0,"SC.GEN. COPACENI","SANDULESTI",67,55311,0,3,946,523,456,67,521,2,1000,477,238,283,
13,"CLUJ",127,59327,,453,0,"CAMINUL CULTURAL SAVADISLA","SAVADISLA",70,59327,0,3,886,586,467,119,571,15,1000,414,516,55,
13,"CLUJ",127,59327,,454,0,"SC.GEN. FINISEL","SAVADISLA",70,59327,0,3,629,385,328,57,383,2,672,287,146,237,
13,"CLUJ",127,59327,,455,0,"SC.GEN. HASDATE","SAVADISLA",70,59327,0,3,453,317,261,56,313,4,500,183,90,223,
13,"CLUJ",127,59327,,456,0,"CAMINUL CULTURAL LITA","SAVADISLA",70,59327,0,3,271,214,173,41,212,2,300,86,80,132,
13,"CLUJ",127,59327,,457,0,"SC.GEN. LITENI","SAVADISLA",70,59327,0,3,375,150,137,13,147,3,400,250,130,17,
13,"CLUJ",127,59327,,458,0,"SC.GEN. STOLNA","SAVADISLA",70,59327,0,3,191,133,102,31,132,1,220,87,74,58,
13,"CLUJ",127,59327,,459,0,"CAMINUL CULTURAL VALISOARA","SAVADISLA",70,59327,0,3,83,95,66,29,95,0,110,15,38,57,
13,"CLUJ",127,59327,,460,0,"CAMINUL CULTURAL VLAHA","SAVADISLA",70,59327,0,3,671,500,429,71,489,11,750,250,477,12,
13,"CLUJ",127,59416,,461,0,"CAMINUL CULTURAL SIC","SIC",71,59416,0,3,2398,1402,1367,35,1363,39,2650,1248,1311,52,
13,"CLUJ",127,59434,,462,0,"CAMINUL CULTURAL SINCRAIU","SANCRAIU",66,59434,0,3,1562,1110,1047,63,1097,13,1750,640,913,184,
13,"CLUJ",127,59498,,463,0,"PRIMARIA SANMARTIN","SANMARTIN",68,59498,0,3,544,251,213,38,249,2,605,354,127,122,
13,"CLUJ",127,59498,,464,0,"SC.GEN. CEABA","SANMARTIN",68,59498,0,3,263,195,162,33,188,7,298,103,44,144,
13,"CLUJ",127,59498,,465,0,"SC.GEN. CUTCA","SANMARTIN",68,59498,0,3,517,384,361,23,382,2,517,133,70,312,
13,"CLUJ",127,59498,,466,0,"SC.GEN. DIVICIORII-MARI","SANMARTIN",68,59498,0,3,382,248,205,43,243,5,428,180,111,132,
13,"CLUJ",127,59586,,467,0,"PRIMARIA SINPAUL","SANPAUL",69,59586,0,3,1174,526,460,66,517,9,1297,771,222,295,
13,"CLUJ",127,59586,,468,0,"CAMINUL CULTURAL MIHAIESTI","SANPAUL",69,59586,0,3,877,319,252,67,315,4,960,641,151,164,
13,"CLUJ",127,59657,,469,0,"PRIMARIA SUATU","SUATU",72,59657,0,3,1392,762,698,64,746,16,1546,784,577,169,
13,"CLUJ",127,59657,,470,0,"FOSTUL CAP SEDIUL ARUNCUTA","SUATU",72,59657,0,3,417,232,207,25,231,1,464,232,135,96,
13,"CLUJ",127,59693,,471,0,"CAMINUL CULTURAL","TRITENII DE JOS",74,59693,0,3,1354,680,631,49,667,13,1500,820,237,430,
13,"CLUJ",127,59693,,472,0,"SC.GEN. TRITENII DE SUS","TRITENII DE JOS",74,59693,0,3,980,558,517,41,556,2,1082,524,199,357,
13,"CLUJ",127,59693,,473,0,"SC.GEN. TRITENI COLONIE","TRITENII DE JOS",74,59693,0,3,390,254,225,29,253,1,433,179,206,47,
13,"CLUJ",127,59693,,474,0,"SC.GEN. PADURENI","TRITENII DE JOS",74,59693,0,3,1159,513,483,30,508,5,1276,763,169,339,
13,"CLUJ",127,59693,,475,0,"SC.GEN. TRITENI HOTAR","TRITENII DE JOS",74,59693,0,3,374,223,201,22,220,3,413,190,28,192,
13,"CLUJ",127,59764,,476,0,"CONSILIUL LOCAL TURENI","TURENI",75,59764,0,3,824,472,427,45,467,5,900,428,334,133,
13,"CLUJ",127,59764,,477,0,"CAMINUL CULTURAL MICESTI","TURENI",75,59764,0,3,380,188,153,35,184,4,420,232,55,129,
13,"CLUJ",127,59764,,478,0,"SC.GEN. CEANU MIC","TURENI",75,59764,0,3,454,211,190,21,208,3,530,319,105,103,
13,"CLUJ",127,59764,,479,0,"SC.GEN. MARTINESTI","TURENI",75,59764,0,3,455,258,218,40,251,7,500,242,134,117,
13,"CLUJ",127,59826,,480,0,"PRIMARIA TAGA","TAGA",73,59826,0,3,727,437,375,62,432,5,803,366,191,241,
13,"CLUJ",127,59826,,481,0,"CAMINUL CULTURAL NASAL","TAGA",73,59826,0,3,423,248,224,24,239,9,469,221,121,118,
13,"CLUJ",127,59826,,482,0,"SC.GEN. SINTIOANA","TAGA",73,59826,0,3,454,283,235,48,281,2,503,220,131,150,
13,"CLUJ",127,59826,,483,0,"CAMINUL CULTURAL SINTEJUDE","TAGA",73,59826,0,3,290,154,121,33,146,8,325,171,72,74,
13,"CLUJ",127,59880,,484,0,"CAMINUL CULTURAL UNGURAS","UNGURAS",76,59880,0,3,1651,849,814,35,838,11,1832,983,790,48,
13,"CLUJ",127,59880,,485,0,"CAMINUL CULTURAL BATIN","UNGURAS",76,59880,0,3,790,441,403,38,432,9,873,432,131,301,
13,"CLUJ",127,59880,,486,0,"SC.GEN. VALEA-UNGURASULUI","UNGURAS",76,59880,0,3,253,151,122,29,145,6,288,137,37,108,
13,"CLUJ",127,59942,,487,0,"CAMINUL CULTURAL VAD","VAD",77,59942,0,3,598,303,253,50,299,4,623,320,149,150,
13,"CLUJ",127,59942,,488,0,"SC.GEN. CETAN","VAD",77,59942,0,3,465,287,229,58,284,3,517,230,157,127,
13,"CLUJ",127,59942,,489,0,"SC.GEN. BOGATA DE JOS","VAD",77,59942,0,3,296,200,180,20,198,2,360,160,102,96,
13,"CLUJ",127,59942,,490,0,"SC.GEN. CURTUIUS","VAD",77,59942,0,3,169,165,112,53,163,2,195,30,83,80,
13,"CLUJ",127,59942,,491,0,"SC.GEN. BOGATA DE SUS","VAD",77,59942,0,3,433,202,160,42,195,7,455,253,83,112,
13,"CLUJ",127,60026,,492,0,"CAMINUL CULTURAL VALEA IERII","VALEA IERII",78,60026,0,3,872,484,455,29,479,5,1017,533,212,267,
13,"CLUJ",127,60062,,493,0,"SC.GEN. VIISOARA CL. I-VIII","VIISOARA",79,60062,0,3,1755,831,764,67,812,19,1981,1150,631,181,
13,"CLUJ",127,60062,,494,0,"SC.GEN. VIISOARA CL. I-IV","VIISOARA",79,60062,0,3,943,1103,943,160,1083,20,2100,997,649,434,
13,"CLUJ",127,60062,,495,0,"SC.GEN. URCA CL. I-VIII","VIISOARA",79,60062,0,3,900,477,433,44,472,5,1003,526,252,220,
13,"CLUJ",127,60099,,496,0,"CONSILIUL LOCAL VULTURENI","VULTURENI",80,60099,0,3,357,187,161,26,187,0,407,220,105,82,
13,"CLUJ",127,60099,,497,0,"SC.GEN. BABUTIU","VULTURENI",80,60099,0,3,148,118,99,19,116,2,157,39,50,66,
13,"CLUJ",127,60099,,498,0,"CAMINUL CULTURAL BADESTI","VULTURENI",80,60099,0,3,144,109,85,24,109,0,144,35,84,25,
13,"CLUJ",127,60099,,499,0,"SC.GEN. CHIDEA","VULTURENI",80,60099,0,3,132,127,82,45,127,0,147,20,118,9,
13,"CLUJ",127,60099,,500,0,"SC.GEN. FAURENI","VULTURENI",80,60099,0,3,210,136,103,33,136,0,230,94,37,99,
13,"CLUJ",127,60099,,501,0,"SC.GEN. SOIMENI","VULTURENI",80,60099,0,3,326,229,187,42,229,0,365,136,154,75,
14,"CONSTANTA",136,60419,,1,0,"LICEUL MIHAI EMINESCU - STR TRAIAN NR.19","MUNICIPIUL CONSTANTA",1,60419,1,1,1077,692,611,81,681,11,1196,504,485,196,
14,"CONSTANTA",136,60419,,2,0,"LICEUL MIHAI EMINESCU - STR. TRAIAN NR.19","MUNICIPIUL CONSTANTA",1,60419,1,1,910,593,510,83,586,7,1000,407,376,210,
14,"CONSTANTA",136,60419,,3,0,"SCOALA NR.2 - STR. ARISTIDE KARATZALI NR.13","MUNICIPIUL CONSTANTA",1,60419,1,1,1311,692,619,73,671,21,1400,708,458,213,
14,"CONSTANTA",136,60419,,4,0,"LICEUL MIRCEA CEL BATRIN - STR.STEFAN CEL MARE NR.6","MUNICIPIUL CONSTANTA",1,60419,1,1,1023,692,562,130,678,14,1100,408,511,167,
14,"CONSTANTA",136,60419,,5,0,"LICEUL MIRCEA CEL BATRIN - STR. STEFAN CEL MARE NR.6","MUNICIPIUL CONSTANTA",1,60419,1,1,725,443,417,26,430,13,800,357,325,105,
14,"CONSTANTA",136,60419,,6,0,"SCOALA NR.28 - STR. DECEBAL NR.15","MUNICIPIUL CONSTANTA",1,60419,1,1,622,335,320,15,327,8,700,365,239,88,
14,"CONSTANTA",136,60419,,7,0,"LICEUL ECONOMIC - STR.DECEBAL NR.15","MUNICIPIUL CONSTANTA",1,60419,1,1,1667,979,914,65,955,24,1800,821,712,243,
14,"CONSTANTA",136,60419,,8,0,"LICEUL ECONOMIC - STR. DECEBAL NR.15","MUNICIPIUL CONSTANTA",1,60419,1,1,1189,628,603,25,621,7,1298,670,474,147,
14,"CONSTANTA",136,60419,,9,0,"SCOALA NORMALA 'CONSTANTIN BRATESCU' - STR. 1907","MUNICIPIUL CONSTANTA",1,60419,1,1,1872,935,892,43,913,22,2000,1065,671,242,
14,"CONSTANTA",136,60419,,10,0,"SCOALA NORMALA 'CONSTANTIN BRATESCU' - STR. 1907","MUNICIPIUL CONSTANTA",1,60419,1,1,1684,969,880,89,950,19,1800,831,697,253,
14,"CONSTANTA",136,60419,,11,0,"GRADINITA NR.1 - STR. SARMIZEGETUSA NR.40","MUNICIPIUL CONSTANTA",1,60419,1,1,1804,1092,980,112,1069,23,2000,908,830,239,
14,"CONSTANTA",136,60419,,12,0,"SCOALA NR.13 - STR. MIHAI VITEAZU","MUNICIPIUL CONSTANTA",1,60419,1,1,1566,834,763,71,820,14,1700,866,613,207,
14,"CONSTANTA",136,60419,,13,0,"TEATRUL 'FANTASIO' - BD. FERDINAND","MUNICIPIUL CONSTANTA",1,60419,1,1,865,688,609,79,675,13,900,212,531,144,
14,"CONSTANTA",136,60419,,14,0,"TEATRUL 'FANTASIO' - BD. FERDINAND","MUNICIPIUL CONSTANTA",1,60419,1,1,1010,625,588,37,623,2,1100,475,497,126,
14,"CONSTANTA",136,60419,,15,0,"LICEUL 'TRAIAN' - STR. TRAIAN NR.55","MUNICIPIUL CONSTANTA",1,60419,1,1,980,789,616,173,777,12,1100,311,623,154,
14,"CONSTANTA",136,60419,,16,0,"LICEUL 'TRAIAN' - STR.TRAIAN NR.55","MUNICIPIUL CONSTANTA",1,60419,1,1,862,523,487,36,517,6,900,377,408,109,
14,"CONSTANTA",136,60419,,17,0,"LICEUL 'TRAIAN' - STR. TRAIAN NR.55","MUNICIPIUL CONSTANTA",1,60419,1,1,1118,596,568,28,578,18,1200,604,408,170,
14,"CONSTANTA",136,60419,,18,0,"SCOALA NR.25 ARIPA STANGA - STR. CUZA VODA NR.80","MUNICIPIUL CONSTANTA",1,60419,1,1,1211,715,588,127,700,15,1295,580,538,162,
14,"CONSTANTA",136,60419,,19,0,"SCOALA NR.25 ARIPA DREAPTA - STR. CUZA VODA NR.80","MUNICIPIUL CONSTANTA",1,60419,1,1,1471,807,751,56,801,6,1596,789,575,226,
14,"CONSTANTA",136,60419,,20,0,"SCOALA NR.24 - STR. GRIVITEI NR.70","MUNICIPIUL CONSTANTA",1,60419,1,1,1462,928,897,31,899,29,1700,772,642,257,
14,"CONSTANTA",136,60419,,21,0,"SCOALA NR.24 - STR. GRIVITEI NR.70","MUNICIPIUL CONSTANTA",1,60419,1,1,1536,879,847,32,858,21,1700,821,630,228,
14,"CONSTANTA",136,60419,,22,0,"SCOALA NR.34 - STR. OBORULUI NR.55","MUNICIPIUL CONSTANTA",1,60419,1,1,1740,944,890,54,932,12,1900,956,622,310,
14,"CONSTANTA",136,60419,,23,0,"SCOALA NR.34 - STR. OBORULUI NR.55","MUNICIPIUL CONSTANTA",1,60419,1,1,1332,737,686,51,722,15,1500,763,468,254,
14,"CONSTANTA",136,60419,,24,0,"SCOALA NR.34 - STR. OBORULUI NR.55","MUNICIPIUL CONSTANTA",1,60419,1,1,1586,879,842,37,862,17,1700,821,534,328,
14,"CONSTANTA",136,60419,,25,0,"CASA DE CULTURA - STR. I.L.CARAGIALE","MUNICIPIUL CONSTANTA",1,60419,1,1,1200,685,638,47,677,8,1296,611,472,205,
14,"CONSTANTA",136,60419,,26,0,"GRUP SCOLAR SPORTIV NR.2 - STR. ION CORVIN","MUNICIPIUL CONSTANTA",1,60419,1,1,1839,1027,977,50,1011,16,2000,973,736,275,
14,"CONSTANTA",136,60419,,27,0,"SC EDIL URBAN - DECORATIVA - STR.CIBINULUI","MUNICIPIUL CONSTANTA",1,60419,1,1,1855,989,937,52,977,12,2000,1011,669,308,
14,"CONSTANTA",136,60419,,28,0,"SCOALA NR.21 - 'I.L.CARAGIALE' - STR. CORBULUI NR.2","MUNICIPIUL CONSTANTA",1,60419,1,1,2093,1040,983,57,1033,7,2300,1260,659,374,
14,"CONSTANTA",136,60419,,29,0,"LICEUL 'OVIDIUS' - STRADELA BASARABI","MUNICIPIUL CONSTANTA",1,60419,1,1,1561,824,750,74,807,17,1700,876,583,224,
14,"CONSTANTA",136,60419,,30,0,"LICEUL 'OVIDIUS' - STRADELA BASARABI","MUNICIPIUL CONSTANTA",1,60419,1,1,961,588,470,118,577,11,1100,512,425,152,
14,"CONSTANTA",136,60419,,31,0,"LICEUL 'OVIDIUS' - STRADELA BASARABI","MUNICIPIUL CONSTANTA",1,60419,1,1,1337,675,639,36,667,8,1500,825,484,183,
14,"CONSTANTA",136,60419,,32,0,"GRUP SCOLAR CONSTRUCTII DE MASINI (SNC) - BD. 1 MAI","MUNICIPIUL CONSTANTA",1,60419,1,1,1058,658,577,81,650,8,1100,442,450,200,
14,"CONSTANTA",136,60419,,33,0,"GRUP SCOLAR DE CONSTRUCTII DE MASINI (SNC) - BD. 1 MAI","MUNICIPIUL CONSTANTA",1,60419,1,1,1673,884,816,68,856,28,1792,908,579,277,
14,"CONSTANTA",136,60419,,34,0,"SCOALA NR.16 - SOS. MANGALIEI NR.89","MUNICIPIUL CONSTANTA",1,60419,1,1,1558,954,848,106,946,8,1697,743,666,280,
14,"CONSTANTA",136,60419,,35,0,"SCOALA NR.16 - SOS. MANGALIEI NR.89","MUNICIPIUL CONSTANTA",1,60419,1,1,1533,870,770,100,856,14,1703,833,555,301,
14,"CONSTANTA",136,60419,,36,0,"SCOALA NR.16 - SOS. MANGALIEI NR.89","MUNICIPIUL CONSTANTA",1,60419,1,1,1826,1031,941,90,1014,17,2000,969,649,365,
14,"CONSTANTA",136,60419,,37,0,"SCOALA NR.16 - SOS. MANGALIEI NR.89","MUNICIPIUL CONSTANTA",1,60419,1,1,2052,1246,1072,174,1227,19,2300,1054,653,574,
14,"CONSTANTA",136,60419,,38,0,"SCOALA NR.41 - STR. PAJUREI NR.1-5","MUNICIPIUL CONSTANTA",1,60419,1,1,1132,506,422,84,500,6,1204,698,311,189,
14,"CONSTANTA",136,60419,,39,0,"SCOALA NR.41 - STR. PAJUREI NR.1-5","MUNICIPIUL CONSTANTA",1,60419,1,1,1979,1022,983,39,1004,18,2199,1177,571,433,
14,"CONSTANTA",136,60419,,40,0,"LICEUL DE MARINA - STR. PAJUREI NR.1-5","MUNICIPIUL CONSTANTA",1,60419,1,1,2196,1106,1017,89,1093,13,2409,1303,645,448,
14,"CONSTANTA",136,60419,,41,0,"LICEUL DE MARINA - STR. PAJUREI NR.1-5","MUNICIPIUL CONSTANTA",1,60419,1,1,2002,1003,970,33,993,10,2200,1197,576,417,
14,"CONSTANTA",136,60419,,42,0,"LICEUL DE MARINA - STR. PAJUREI NR.1-5","MUNICIPIUL CONSTANTA",1,60419,1,1,1635,882,843,39,863,19,1800,918,417,446,
14,"CONSTANTA",136,60419,,43,0,"LICEUL DE MARINA - STR. PAJUREI NR.1-5","MUNICIPIUL CONSTANTA",1,60419,1,1,2113,1087,1046,41,1075,12,2300,1213,582,493,
14,"CONSTANTA",136,60419,,44,0,"LICEUL DE MARINA - STR. PAJUREI NR.1-5","MUNICIPIUL CONSTANTA",1,60419,1,1,1581,840,750,90,833,7,1700,860,471,362,
14,"CONSTANTA",136,60419,,45,0,"SCOALA NR.15 'GRIGORE ANTIPA' - SOS. MANGALIEI NR.128","MUNICIPIUL CONSTANTA",1,60419,1,1,1915,1146,1054,92,1127,19,2100,954,656,471,
14,"CONSTANTA",136,60419,,46,0,"SCOALA NR.15 'GRIGORE ANTIPA' - SOS. MANGALIEI NR.128","MUNICIPIUL CONSTANTA",1,60419,1,1,1732,1036,928,108,1022,14,1900,864,557,465,
14,"CONSTANTA",136,60419,,47,0,"SCOALA NR.17 - STR. MESTERUL MANOLE NR.42","MUNICIPIUL CONSTANTA",1,60419,1,1,2329,1237,1177,60,1221,16,2600,1363,709,512,
14,"CONSTANTA",136,60419,,48,0,"SCOALA NR.17 - STR.MESTERUL MANOLE NR.42","MUNICIPIUL CONSTANTA",1,60419,1,1,2192,1194,1131,63,1183,11,2400,1206,654,529,
14,"CONSTANTA",136,60419,,49,0,"SCOALA NR.17 - STR. MESTERUL MANOLE NR.42","MUNICIPIUL CONSTANTA",1,60419,1,1,2099,1117,1022,95,1110,7,2300,1183,633,477,
14,"CONSTANTA",136,60419,,50,0,"SCOALA NR.33 - KM 4-5","MUNICIPIUL CONSTANTA",1,60419,1,1,1405,763,703,60,753,10,1500,737,497,256,
14,"CONSTANTA",136,60419,,51,0,"SCOALA NR.33 - KM 4-5","MUNICIPIUL CONSTANTA",1,60419,1,1,1572,914,856,58,904,10,1700,786,572,332,
14,"CONSTANTA",136,60419,,52,0,"SCOALA NR.33 - KM 4-5","MUNICIPIUL CONSTANTA",1,60419,1,1,1490,892,859,33,875,17,1600,708,564,311,
14,"CONSTANTA",136,60419,,53,0,"SCOALA NR.33 - KM 4-5","MUNICIPIUL CONSTANTA",1,60419,1,1,1229,770,751,19,760,10,1400,630,485,275,
14,"CONSTANTA",136,60419,,54,0,"SCOALA NR.37 - STR. ARCULUI NR.4","MUNICIPIUL CONSTANTA",1,60419,1,1,1335,789,694,95,786,3,1500,711,447,339,
14,"CONSTANTA",136,60419,,55,0,"SCOALA NR.37 - STR. ARCULUI NR.4","MUNICIPIUL CONSTANTA",1,60419,1,1,1526,847,800,47,834,13,1700,853,494,340,
14,"CONSTANTA",136,60419,,56,0,"SCOALA NR.37 - STR.ARCULUI NR.4","MUNICIPIUL CONSTANTA",1,60419,1,1,1419,809,734,75,793,16,1600,791,499,294,
14,"CONSTANTA",136,60419,,57,0,"SCOALA NR.37 - STR.ARCULUI NR.4","MUNICIPIUL CONSTANTA",1,60419,1,1,1361,715,690,25,712,3,1500,785,460,252,
14,"CONSTANTA",136,60419,,58,0,"SCOALA NR.18 'JEAN BARTH' - STR.ION URSU NR.51A","MUNICIPIUL CONSTANTA",1,60419,1,1,1191,655,619,36,651,4,1300,645,373,278,
14,"CONSTANTA",136,60419,,59,0,"GRUP SCOLAR DE INDUSTRIE ALIMENTARA - B-DUL AUREL VLAICU NR 86","MUNICIPIUL CONSTANTA",1,60419,1,1,1314,730,659,71,723,7,1400,670,398,325,
14,"CONSTANTA",136,60419,,60,0,"GRUP SCOLAR DE INDUSTRIE ALIMENTARA - B-DUL AUREL VLAICU NR 86","MUNICIPIUL CONSTANTA",1,60419,1,1,1771,1044,941,103,1030,14,1900,856,572,458,
14,"CONSTANTA",136,60419,,61,0,"GRUP SCOLAR 'DIMITRIE LEONIDA'-ALEEA PELICANULUI NR.8","MUNICIPIUL CONSTANTA",1,60419,1,1,1660,1033,888,145,1016,17,1794,761,568,448,
14,"CONSTANTA",136,60419,,62,0,"GRUP SCOLAR 'DIMITRIE LEONIDA'-ALEEA PELICANULUI NR.8","MUNICIPIUL CONSTANTA",1,60419,1,1,1840,1013,960,53,1003,10,2000,987,590,413,
14,"CONSTANTA",136,60419,,63,0,"SCOALA NR 18 'JEAN BARTH'-STR. ION URSU NR.51A","MUNICIPIUL CONSTANTA",1,60419,1,1,2211,1212,1175,37,1202,10,2400,1188,670,532,
14,"CONSTANTA",136,60419,,64,0,"SCOALA NR 40 'AUREL VLAICU'-ALEEA PELICANULUI NR.2","MUNICIPIUL CONSTANTA",1,60419,1,1,2299,1393,1077,316,1388,5,2501,1108,725,663,
14,"CONSTANTA",136,60419,,65,0,"SCOALA NR 40 'AUREL VLAICU'-ALEEA PELICANULUI NR.2","MUNICIPIUL CONSTANTA",1,60419,1,1,2535,1325,1140,185,1307,18,2800,1475,696,611,
14,"CONSTANTA",136,60419,,66,0,"SCOALA NR 40 'AUREL VLAICU'-ALEEA PELICANULUI NR.2","MUNICIPIUL CONSTANTA",1,60419,1,1,1720,929,865,64,913,16,1900,971,518,395,
14,"CONSTANTA",136,60419,,67,0,"SCOALA NR 19-STR. MEDEEA NR.6","MUNICIPIUL CONSTANTA",1,60419,1,1,1541,643,599,44,631,12,1700,1057,386,245,
14,"CONSTANTA",136,60419,,68,0,"SCOALA NR 19-STR. MEDEEA NR.6","MUNICIPIUL CONSTANTA",1,60419,1,1,1318,818,721,97,810,8,1400,582,464,346,
14,"CONSTANTA",136,60419,,69,0,"SCOALA NR 19-STR. MEDEEA NR.6","MUNICIPIUL CONSTANTA",1,60419,1,1,1076,726,623,103,717,9,1200,474,438,279,
14,"CONSTANTA",136,60419,,70,0,"SCOALA NR 31-BD. I.C.BRATIANU NR.143","MUNICIPIUL CONSTANTA",1,60419,1,1,1425,862,784,78,852,10,1600,738,470,382,
14,"CONSTANTA",136,60419,,71,0,"GRUP SCOLAR C.F.R-STR. VIFOR HAIDUCUL NR.34","MUNICIPIUL CONSTANTA",1,60419,1,1,1480,977,812,165,968,9,1600,623,504,464,
14,"CONSTANTA",136,60419,,72,0,"SCOALA NR 20-STR.MIHU COPILU NR.1","MUNICIPIUL CONSTANTA",1,60419,1,1,1262,738,659,79,732,6,1400,662,421,311,
14,"CONSTANTA",136,60419,,73,0,"SCOALA NR 31-BD. I.C.BRATIANU NR.143","MUNICIPIUL CONSTANTA",1,60419,1,1,1500,972,866,106,957,15,1598,626,563,394,
14,"CONSTANTA",136,60419,,74,0,"SCOALA NR 22-STR. RAZVAN VODA NR.6","MUNICIPIUL CONSTANTA",1,60419,1,1,1646,1059,954,105,1047,12,1800,741,628,419,
14,"CONSTANTA",136,60419,,75,0,"SCOALA AJUTATOARE NR 2-STR. RAZVAN VODA","MUNICIPIUL CONSTANTA",1,60419,1,1,1687,974,924,50,965,9,1900,926,581,384,
14,"CONSTANTA",136,60419,,76,0,"SCOALA NR 22-STR. RAZVAN VODA NR.6","MUNICIPIUL CONSTANTA",1,60419,1,1,1099,686,585,101,680,6,1200,514,385,295,
14,"CONSTANTA",136,60419,,77,0,"SCOALA AJUTATOARE NR 2-STR. RAZVAN VODA","MUNICIPIUL CONSTANTA",1,60419,1,1,780,406,371,35,393,13,900,494,272,121,
14,"CONSTANTA",136,60419,,78,0,"SCOALA AJUTATOARE NR 2-STR. RAZVAN VODA","MUNICIPIUL CONSTANTA",1,60419,1,1,1980,902,863,39,881,21,2200,1298,549,332,
14,"CONSTANTA",136,60419,,79,0,"SALA DE CULTURA-BD.I.C.BRATIANU","MUNICIPIUL CONSTANTA",1,60419,1,1,1399,768,701,67,760,8,1500,732,494,266,
14,"CONSTANTA",136,60419,,80,0,"SCOALA NR 8-BD.I.C.BRATIANU NR.42","MUNICIPIUL CONSTANTA",1,60419,1,1,1577,793,744,49,784,9,1700,907,491,293,
14,"CONSTANTA",136,60419,,81,0,"SCOALA NR 8-BD.I.C.BRATIANU NR.42","MUNICIPIUL CONSTANTA",1,60419,1,1,1576,802,771,31,791,11,1700,898,482,309,
14,"CONSTANTA",136,60419,,82,0,"SCOALA NR 8-BD.I.C.BRATIANU NR.42","MUNICIPIUL CONSTANTA",1,60419,1,1,1556,892,846,46,878,14,1700,808,581,297,
14,"CONSTANTA",136,60419,,83,0,"GRADINITA NR 36-STR. CORBULUI","MUNICIPIUL CONSTANTA",1,60419,1,1,2129,1098,1015,83,1090,8,2300,1202,634,456,
14,"CONSTANTA",136,60419,,84,0,"SCOALA NR 21 'I L CARAGIALE'-STR. CORBULUI NR.2A","MUNICIPIUL CONSTANTA",1,60419,1,1,1973,1001,933,68,986,15,2200,1199,612,374,
14,"CONSTANTA",136,60419,,85,0,"SCOALA NR 21 'I L CARAGIALE'-STR. CORBULUI NR.2A","MUNICIPIUL CONSTANTA",1,60419,1,1,1685,840,807,33,831,9,1900,1060,573,258,
14,"CONSTANTA",136,60419,,86,0,"SCOALA NR 21 'I L CARAGIALE'-STR.CORBULUI NR.2A","MUNICIPIUL CONSTANTA",1,60419,1,1,1606,900,845,55,886,14,1800,900,597,289,
14,"CONSTANTA",136,60419,,87,0,"SCOALA NR 23-STR. DEZROBIRII NR.80","MUNICIPIUL CONSTANTA",1,60419,1,1,2201,1095,1038,57,1080,15,2400,1305,687,393,
14,"CONSTANTA",136,60419,,88,0,"SCOALA NR 23-STR. DEZROBIRII NR.80","MUNICIPIUL CONSTANTA",1,60419,1,1,2307,1244,1136,108,1225,19,2500,1256,773,452,
14,"CONSTANTA",136,60419,,89,0,"SCOALA NR 39 'NICOLAE TONITZA'-STR. SOLIDARITATII NR.8","MUNICIPIUL CONSTANTA",1,60419,1,1,2339,1300,1248,52,1278,22,2600,1300,784,494,
14,"CONSTANTA",136,60419,,90,0,"SCOALA NR 39 'NICOLAE TONITZA'-STR. SOLIDARITATII NR.8","MUNICIPIUL CONSTANTA",1,60419,1,1,2442,1297,1245,52,1282,15,2700,1403,840,442,
14,"CONSTANTA",136,60419,,91,0,"SCOALA NR 39 'NICOLAE TONITZA'-STR. SOLIDARITATII NR.8","MUNICIPIUL CONSTANTA",1,60419,1,1,2340,1303,1248,55,1293,10,2600,1297,808,485,
14,"CONSTANTA",136,60419,,92,0,"SCOALA NR 23-STR.DEZROBIRII NR.80","MUNICIPIUL CONSTANTA",1,60419,1,1,1559,858,784,74,848,10,1700,842,545,303,
14,"CONSTANTA",136,60419,,93,0,"SCOALA NR 23-STR. DEZROBIRII NR.80","MUNICIPIUL CONSTANTA",1,60419,1,1,1619,771,722,49,765,6,1800,1029,481,284,
14,"CONSTANTA",136,60419,,94,0,"SCOALA NR 10-STR.IZVOR NR.26","MUNICIPIUL CONSTANTA",1,60419,1,1,1455,788,726,62,776,12,1600,812,486,290,
14,"CONSTANTA",136,60419,,95,0,"SCOALA NR 10-STR.IZVOR NR.26","MUNICIPIUL CONSTANTA",1,60419,1,1,1312,783,736,47,776,7,1400,617,508,268,
14,"CONSTANTA",136,60419,,96,0,"CENTRUL DE PERFECTIONARE AL MARINEI CIVILE-STR. BABA NOVAC","MUNICIPIUL CONSTANTA",1,60419,1,1,1533,896,770,126,882,14,1696,800,592,290,
14,"CONSTANTA",136,60419,,97,0,"CASA DE CULTURA-STR. IZVOR","MUNICIPIUL CONSTANTA",1,60419,1,1,1848,1044,972,72,1029,15,2000,956,710,319,
14,"CONSTANTA",136,60419,,98,0,"SCOALA NR 10-STR. IZVOR NR.26","MUNICIPIUL CONSTANTA",1,60419,1,1,1594,825,759,66,804,21,1800,975,523,281,
14,"CONSTANTA",136,60419,,99,0,"SCOALA NR 9 'ION CREANGA'-STR. STRAJERULUI NR.50","MUNICIPIUL CONSTANTA",1,60419,1,1,1969,862,844,18,848,14,2200,1338,501,347,
14,"CONSTANTA",136,60419,,100,0,"SCOALA NR 9 'ION CREANGA'-STR. STRAJERULUI NR.50","MUNICIPIUL CONSTANTA",1,60419,1,1,2034,1040,992,48,1015,25,2200,1160,642,373,
14,"CONSTANTA",136,60419,,101,0,"SCOALA AJUTATOARE NR 1-STR. SEMANATORULUI NR.8","MUNICIPIUL CONSTANTA",1,60419,1,1,2272,1033,988,45,1020,13,2500,1467,625,395,
14,"CONSTANTA",136,60419,,102,0,"SCOALA AJUTATOARE NR 1-STR. SEMANATORULUI NR.8","MUNICIPIUL CONSTANTA",1,60419,1,1,2099,967,943,24,961,6,2300,1333,648,313,
14,"CONSTANTA",136,60419,,103,0,"SCOALA NR 12-STR. B.P.HASDEU NR.98","MUNICIPIUL CONSTANTA",1,60419,1,1,2116,1166,1134,32,1141,25,2300,1134,835,306,
14,"CONSTANTA",136,60419,,104,0,"SCOALA NR 12-STR. B.P.HASDEU NR.98","MUNICIPIUL CONSTANTA",1,60419,1,1,1475,805,762,43,789,16,1600,795,563,226,
14,"CONSTANTA",136,60419,,105,0,"GRADINITA NR 9-STR. DELFINULUI NR.2","MUNICIPIUL CONSTANTA",1,60419,1,1,1437,857,756,101,848,9,1600,743,617,231,
14,"CONSTANTA",136,60419,,106,0,"SCOALA NR 36-ALEEA FRAGILOR NR.3","MUNICIPIUL CONSTANTA",1,60419,1,1,1308,689,592,97,676,13,1400,711,491,185,
14,"CONSTANTA",136,60419,,107,0,"SCOALA NR 36-ALEEA FRAGILOR NR.3","MUNICIPIUL CONSTANTA",1,60419,1,1,1598,819,788,31,813,6,1800,981,541,272,
14,"CONSTANTA",136,60419,,108,0,"SCOALA NR 36-ALEEA FRAGILOR NR.3","MUNICIPIUL CONSTANTA",1,60419,1,1,1673,898,861,37,878,20,1800,902,596,282,
14,"CONSTANTA",136,60419,,109,0,"GRADINITA NR 43-ALEEA FRAGILOR NR.2","MUNICIPIUL CONSTANTA",1,60419,1,1,1739,935,887,48,925,10,1900,965,617,308,
14,"CONSTANTA",136,60419,,110,0,"GRADINITA NR 43-ALEEA FRAGILOR NR.2","MUNICIPIUL CONSTANTA",1,60419,1,1,1924,1029,983,46,1011,18,2100,1071,629,382,
14,"CONSTANTA",136,60419,,111,0,"SCOALA NR 36-ALEEA FRAGILOR NR.3","MUNICIPIUL CONSTANTA",1,60419,1,1,1859,1024,984,40,1009,15,2000,976,692,317,
14,"CONSTANTA",136,60419,,112,0,"GRADINITA NR 51-STR. BADEA CIRTAN","MUNICIPIUL CONSTANTA",1,60419,1,1,1775,949,892,57,939,10,1900,951,597,342,
14,"CONSTANTA",136,60419,,113,0,"GRADINITA NR 51-STR. BADEA CIRTAN","MUNICIPIUL CONSTANTA",1,60419,1,1,1872,1061,1025,36,1047,14,2100,1039,736,311,
14,"CONSTANTA",136,60419,,114,0,"SCOALA NR 36-ALEEA FRAGILOR NR.3","MUNICIPIUL CONSTANTA",1,60419,1,1,2065,1066,1004,62,1047,19,2300,1234,653,394,
14,"CONSTANTA",136,60419,,115,0,"AGENTIA FISCALA NR 1-4-STR. BADEA CIRTAN NR.3","MUNICIPIUL CONSTANTA",1,60419,1,1,1800,1041,963,78,1020,21,2000,959,719,301,
14,"CONSTANTA",136,60419,,116,0,"AGENTIA FISCALA NR 1-4-STR. BADEA CIRTAN NR.3","MUNICIPIUL CONSTANTA",1,60419,1,1,1823,1021,970,51,1012,9,2004,983,690,322,
14,"CONSTANTA",136,60419,,117,0,"LICEUL 'GEORGE CALINESCU'-STR. CPT.DOBRILA EUGENIU NR.6","MUNICIPIUL CONSTANTA",1,60419,1,1,1444,873,837,36,869,4,1600,727,646,223,
14,"CONSTANTA",136,60419,,118,0,"SCOALA NR 14-ARIPA STINGA-PALAZU MARE","MUNICIPIUL CONSTANTA",1,60419,1,1,1482,955,778,177,940,15,1600,645,600,340,
14,"CONSTANTA",136,60419,,119,0,"SCOALA NR 14-ARIPA DREAPTA-PALAZU MARE","MUNICIPIUL CONSTANTA",1,60419,1,1,1314,841,672,169,835,6,1400,559,510,325,
14,"CONSTANTA",136,60419,,120,0,"LICEUL 'GEORGE CALINESCU'-STR. CPT.DOBRILA EUGENIU NR.6","MUNICIPIUL CONSTANTA",1,60419,1,1,1393,853,799,54,840,13,1500,647,586,254,
14,"CONSTANTA",136,60419,,121,0,"LICEUL 'GEORGE CALINESCU'-STR. CPT.DOBRILA EUGENIU NR.6","MUNICIPIUL CONSTANTA",1,60419,1,1,1326,787,758,29,773,14,1500,713,539,234,
14,"CONSTANTA",136,60419,,122,0,"SCOALA NR 38-STR CPT.DOBRILA EUGENIU NR.20","MUNICIPIUL CONSTANTA",1,60419,1,1,1232,757,718,39,743,14,1400,643,560,183,
14,"CONSTANTA",136,60419,,123,0,"SCOALA NR 38-STR. CPT.DOBRILA EUGENIU NR.20","MUNICIPIUL CONSTANTA",1,60419,1,1,1330,785,746,39,774,11,1500,715,529,245,
14,"CONSTANTA",136,60419,,124,0,"LICEUL DECEBAL-ALEEA GRADINITEI NR.4","MUNICIPIUL CONSTANTA",1,60419,1,1,1213,727,687,40,713,14,1400,673,567,146,
14,"CONSTANTA",136,60419,,125,0,"SCOALA NR 35-ALEEA MELODIEI NR.1","MUNICIPIUL CONSTANTA",1,60419,1,1,1130,698,631,67,686,12,1200,502,481,205,
14,"CONSTANTA",136,60419,,126,0,"SCOALA NR 35-ALEEA MELODIEI NR.1","MUNICIPIUL CONSTANTA",1,60419,1,1,1395,761,728,33,750,11,1500,739,578,172,
14,"CONSTANTA",136,60419,,127,0,"SCOALA NR 35-ALEEA MELODIEI NR.1","MUNICIPIUL CONSTANTA",1,60419,1,1,1144,727,682,45,713,14,1300,573,496,217,
14,"CONSTANTA",136,60419,,128,0,"GRADINITA NR 12-STR. CPT.DOBRILA EUGENIU NR.14","MUNICIPIUL CONSTANTA",1,60419,1,1,1577,923,863,60,910,13,1700,777,625,285,
14,"CONSTANTA",136,60419,,129,0,"LICEUL DECEBAL-ALEEA GRADINITEI NR.4","MUNICIPIUL CONSTANTA",1,60419,1,1,771,440,390,50,434,6,800,360,317,117,
14,"CONSTANTA",136,60419,,130,0,"LICEUL DECEBAL-ALEEA GRADINITEI NR.4","MUNICIPIUL CONSTANTA",1,60419,1,1,715,402,385,17,397,5,800,398,276,121,
14,"CONSTANTA",136,60419,,131,0,"LICEUL DECEBAL-ALEEA GRADINITEI NR.4","MUNICIPIUL CONSTANTA",1,60419,1,1,1070,575,538,37,568,7,1200,625,385,183,
14,"CONSTANTA",136,60419,,132,0,"SCOALA NR 29-STR.CISMELEI NR.13","MUNICIPIUL CONSTANTA",1,60419,1,1,840,472,440,32,463,9,900,428,340,123,
14,"CONSTANTA",136,60419,,133,0,"SCOALA NR 29-STR. CISMELEI NR,13","MUNICIPIUL CONSTANTA",1,60419,1,1,904,583,545,38,572,11,1000,417,428,144,
14,"CONSTANTA",136,60419,,134,0,"SCOALA NR 29-STR. CISMELEI NR.13","MUNICIPIUL CONSTANTA",1,60419,1,1,967,588,560,28,574,14,1100,512,444,130,
14,"CONSTANTA",136,60419,,135,0,"SCOALA NR 7-STR. ADAMCLISI NR.2","MUNICIPIUL CONSTANTA",1,60419,1,1,1547,918,871,47,890,28,1600,682,691,199,
14,"CONSTANTA",136,60419,,136,0,"SCOALA NR 7-STR.ADAMCLISI NR.2","MUNICIPIUL CONSTANTA",1,60419,1,1,1333,697,648,49,690,7,1500,803,495,195,
14,"CONSTANTA",136,60419,,137,0,"SCOALA NR 7-STR.ADAMCLISI NR.2","MUNICIPIUL CONSTANTA",1,60419,1,1,1206,682,587,95,670,12,1300,618,513,157,
14,"CONSTANTA",136,60419,,138,0,"SCOALA NR 7-STR.ADAMCLISI NR.2","MUNICIPIUL CONSTANTA",1,60419,1,1,1632,1000,950,50,985,15,1819,819,730,255,
14,"CONSTANTA",136,60419,,139,0,"SCOALA NR 7-STR. ADAMCLISI NR.2","MUNICIPIUL CONSTANTA",1,60419,1,1,1635,977,927,50,957,20,1800,823,711,246,
14,"CONSTANTA",136,60419,,140,0,"SCOALA NR 7-STR.ADAMCLISI NR.2","MUNICIPIUL CONSTANTA",1,60419,1,1,1503,953,905,48,929,24,1600,647,678,251,
14,"CONSTANTA",136,60419,,141,0,"SCOALA NR 6-ALEEA CAMELIEI","MUNICIPIUL CONSTANTA",1,60419,1,1,1157,647,604,43,633,14,1300,653,474,159,
14,"CONSTANTA",136,60419,,142,0,"SCOALA NR 6-ALEEA CAMELIEI","MUNICIPIUL CONSTANTA",1,60419,1,1,1231,668,615,53,665,3,1400,732,433,232,
14,"CONSTANTA",136,60419,,143,0,"SCOALA NR 6-ALEEA CAMELIEI","MUNICIPIUL CONSTANTA",1,60419,1,1,1177,641,613,28,632,9,1300,659,479,153,
14,"CONSTANTA",136,60419,,144,0,"GRADINITA 13-ALEEA IASOMIEI","MUNICIPIUL CONSTANTA",1,60419,1,1,1028,790,744,46,775,15,1400,610,606,169,
14,"CONSTANTA",136,60419,,145,0,"PARCUL COPIILOR-STR. SOVEJA","MUNICIPIUL CONSTANTA",1,60419,1,1,1348,743,714,29,728,15,1500,757,536,192,
14,"CONSTANTA",136,60419,,146,0,"PARCUL COPIILOR-STR. SOVEJA","MUNICIPIUL CONSTANTA",1,60419,1,1,1182,608,570,38,591,17,1300,692,424,167,
14,"CONSTANTA",136,60419,,147,0,"SCOALA NR 27-BD. AL.LAPUSNEANU NR.69","MUNICIPIUL CONSTANTA",1,60419,1,1,1603,902,857,45,888,14,1800,898,670,218,
14,"CONSTANTA",136,60419,,148,0,"SCOALA NR 27-BD. AL.LAPUSNEANU NR,69","MUNICIPIUL CONSTANTA",1,60419,1,1,1339,727,666,61,719,8,1500,773,527,192,
14,"CONSTANTA",136,60419,,149,0,"SCOALA SPORTIVA NR 1-STR.PICTOR NICOLAE GRIGORESCU NR.2","MUNICIPIUL CONSTANTA",1,60419,1,1,806,461,432,29,455,6,900,439,347,108,
14,"CONSTANTA",136,60419,,150,0,"SCOALA SPORTIVA NR 1-STR.PICTOR NICOLAE GRIGORESCU NR.2","MUNICIPIUL CONSTANTA",1,60419,1,1,1642,807,782,25,795,12,1800,993,583,212,
14,"CONSTANTA",136,60419,,151,0,"STADIONUL DE RUGBY-STR. PRIMAVERII","MUNICIPIUL CONSTANTA",1,60419,1,1,1611,839,774,65,829,10,1800,961,609,220,
14,"CONSTANTA",136,60419,,152,0,"R.A.T.C-CONSTANTA-STR. CHILIEI NR.103","MUNICIPIUL CONSTANTA",1,60419,1,1,1417,820,757,63,801,19,1600,780,533,268,
14,"CONSTANTA",136,60419,,153,0,"CAMINUL DE PENSIONARI-STR. UNIRII NR.104","MUNICIPIUL CONSTANTA",1,60419,1,1,2135,1464,1039,425,1445,19,2304,840,961,484,
14,"CONSTANTA",136,60419,,154,0,"LICEUL ENERGETIC-BD. MAMAIA NR.284","MUNICIPIUL CONSTANTA",1,60419,1,1,2346,1155,1048,107,1137,18,2600,1445,758,379,
14,"CONSTANTA",136,60419,,155,0,"LICEUL ENERGETIC-BD. MAMAIA NR.284","MUNICIPIUL CONSTANTA",1,60419,1,1,1197,719,646,73,705,14,1300,581,515,190,
14,"CONSTANTA",136,60419,,156,0,"LICEUL ENERGETIC-BD.MAMAIA NR.284","MUNICIPIUL CONSTANTA",1,60419,1,1,2001,1085,1013,72,1064,21,2200,1115,740,324,
14,"CONSTANTA",136,60419,,157,0,"SCOALA NR 3-STR. CIPRIAN PORUMBESCU NR.3","MUNICIPIUL CONSTANTA",1,60419,1,1,1769,999,920,79,979,20,1900,901,684,295,
14,"CONSTANTA",136,60419,,158,0,"SCOALA NR 3-STR. CIPRIAN PORUMBESCU NR.3","MUNICIPIUL CONSTANTA",1,60419,1,1,1212,656,609,47,646,10,1300,644,457,189,
14,"CONSTANTA",136,60419,,159,0,"GRADINITA NR 45-STR. UNIRII NR.68","MUNICIPIUL CONSTANTA",1,60419,1,1,969,565,515,50,557,8,1100,535,401,156,
14,"CONSTANTA",136,60419,,160,0,"SCOALA NR 1-BD. MAMAIA NR.179","MUNICIPIUL CONSTANTA",1,60419,1,1,1080,566,534,32,556,10,1200,634,395,161,
14,"CONSTANTA",136,60419,,161,0,"SCOALA NR 1-BD. MAMAIA NR.179","MUNICIPIUL CONSTANTA",1,60419,1,1,1059,616,558,58,603,13,1200,584,424,179,
14,"CONSTANTA",136,60419,,162,0,"SCOALA NR 3-STR. CIPRIAN PORUMBESCU NR.3","MUNICIPIUL CONSTANTA",1,60419,1,1,1002,547,513,34,539,8,1100,553,404,135,
14,"CONSTANTA",136,60419,,163,0,"UNIVERSITATEA 'OVIDIUS'-MEDICINA-STR. ION VODA NR.58","MUNICIPIUL CONSTANTA",1,60419,1,1,766,496,379,117,493,3,800,304,354,139,
14,"CONSTANTA",136,60419,,164,0,"UNIVERSITATEA 'OVIDIUS'-BD. MAMAIA NR.124","MUNICIPIUL CONSTANTA",1,60419,1,1,1075,698,479,219,677,21,1200,502,463,214,
14,"CONSTANTA",136,60419,,165,0,"UNIVERSITATEA 'OVIDIUS'-BD. MAMAIA NR.124","MUNICIPIUL CONSTANTA",1,60419,1,1,1143,719,519,200,703,16,1300,581,445,258,
14,"CONSTANTA",136,60419,,166,0,"SCOALA NR.43 - STR. UNIRII NR.12","MUNICIPIUL CONSTANTA",1,60419,1,1,997,548,502,46,532,16,1100,552,387,145,
14,"CONSTANTA",136,60419,,167,0,"SCOALA NR.43 - STR. UNIRII NR.12","MUNICIPIUL CONSTANTA",1,60419,1,1,1073,486,437,49,478,8,1200,714,366,112,
14,"CONSTANTA",136,60419,,168,0,"SCOALA NR.4 - STR. NICOLAE IORGA NR.14","MUNICIPIUL CONSTANTA",1,60419,1,1,907,502,469,33,499,3,1000,498,374,125,
14,"CONSTANTA",136,60419,,169,0,"SCOALA NR.4 - STR. NICOLAE IORGA NR.14","MUNICIPIUL CONSTANTA",1,60419,1,1,785,494,439,55,484,10,900,406,376,108,
14,"CONSTANTA",136,60419,,170,0,"SCOALA NR.5 - STR. NICOLAE IORGA NR.16","MUNICIPIUL CONSTANTA",1,60419,1,1,768,606,481,125,596,10,800,194,458,138,
14,"CONSTANTA",136,60419,,171,0,"SCOALA NR.5 - STR. NICOLAE IORGA NR.16","MUNICIPIUL CONSTANTA",1,60419,1,1,767,423,404,19,413,10,800,377,306,107,
14,"CONSTANTA",136,60419,,172,0,"GRADINITA NR.8 - TOMIS II","MUNICIPIUL CONSTANTA",1,60419,1,1,947,560,536,24,552,8,1000,440,410,142,
14,"CONSTANTA",136,60419,,173,0,"ATELIER SCOALA - STR. PETRU VULCAN NR.100","MUNICIPIUL CONSTANTA",1,60419,1,1,716,460,415,45,449,11,800,340,320,129,
14,"CONSTANTA",136,60419,,174,0,"GRUP SCOLAR 'TOMIS' - BD. TOMIS NR.153","MUNICIPIUL CONSTANTA",1,60419,1,1,1017,570,505,65,561,9,1100,530,414,147,
14,"CONSTANTA",136,60419,,175,0,"GRUP SCOLAR 'TOMIS' - BD. TOMIS NR.153","MUNICIPIUL CONSTANTA",1,60419,1,1,1120,740,666,74,729,11,1199,459,530,199,
14,"CONSTANTA",136,60419,,176,0,"GRADINITA NR.6 - ALEEA MALINULUI NR.5","MUNICIPIUL CONSTANTA",1,60419,1,1,934,594,557,37,583,11,1000,406,477,106,
14,"CONSTANTA",136,60419,,177,0,"SCOALA NR.30 'GHEORGHE TITEICA' - STR. FLAMANDA NR.13","MUNICIPIUL CONSTANTA",1,60419,1,1,972,581,529,52,569,12,1100,519,415,154,
14,"CONSTANTA",136,60419,,178,0,"SCOALA NR.30 'GHEORGHE TITEICA' - STR. FLAMANDA NR.13","MUNICIPIUL CONSTANTA",1,60419,1,1,1062,585,544,41,573,12,1200,615,449,124,
14,"CONSTANTA",136,60419,,179,0,"SCOALA NR.11 - STR. CALARASI NR.48","MUNICIPIUL CONSTANTA",1,60419,1,1,1406,815,746,69,790,25,1500,685,553,237,
14,"CONSTANTA",136,60419,,180,0,"SCOALA NR.11 - STR. CALARASI NR.48","MUNICIPIUL CONSTANTA",1,60419,1,1,1544,909,863,46,902,7,1700,791,639,263,
14,"CONSTANTA",136,60419,,181,0,"LICEUL DE EDUCATIE FIZICA - BD. AL.LAPUSNEANU NR.15","MUNICIPIUL CONSTANTA",1,60419,1,1,1489,831,797,34,826,5,1599,768,616,210,
14,"CONSTANTA",136,60419,,182,0,"LICEUL DE EDUCATIE FIZICA - BD. AL.LAPUSNEANU NR.15","MUNICIPIUL CONSTANTA",1,60419,1,1,1643,753,722,31,744,9,1800,1047,504,240,
14,"CONSTANTA",136,60419,,183,0,"SCOALA NR.12 - STR. B.P.HASDEU NR.98","MUNICIPIUL CONSTANTA",1,60419,1,1,1500,685,630,55,675,10,1600,915,511,164,
14,"CONSTANTA",136,60419,,184,0,"LICEUL DE ARTA (SCOALA NR.42) - BD. AL.LAPUSNEANU NR.11","MUNICIPIUL CONSTANTA",1,60419,1,1,1097,658,621,37,647,11,1195,537,438,209,
14,"CONSTANTA",136,60419,,185,0,"LICEUL DE ARTA (SCOALA NR.42) - BD. AL.LAPUSNEANU NR.11","MUNICIPIUL CONSTANTA",1,60419,1,1,1372,757,723,34,749,8,1500,743,486,263,
14,"CONSTANTA",136,60419,,186,0,"CASA DE CULTURA - BD. AL.LAPUSNEANU","MUNICIPIUL CONSTANTA",1,60419,1,1,874,627,446,181,620,7,1000,373,401,219,
14,"CONSTANTA",136,60419,,188,1,"U.M.0608 - COMANDAMENTUL DE JANDARMI TERITORIAL C-TA - BD. I.C.BRATIANU NR.246","MUNICIPIUL CONSTANTA",1,60419,1,1,0,512,0,512,488,24,698,186,259,229,
14,"CONSTANTA",136,60419,,189,1,"U.M.0406 - COMANDAMENTUL DE JANDARMI TERITORIAL C-TA - STR. MIRCEA CEL BATRIN NR","MUNICIPIUL CONSTANTA",1,60419,1,1,0,328,0,328,315,13,400,72,159,156,
14,"CONSTANTA",136,60419,,190,1,"SPITALUL MUNICIPAL CONSTANTA - STR. STEFAN CEL MARE NR.133","MUNICIPIUL CONSTANTA",1,60419,1,1,0,165,0,165,164,1,200,35,107,57,
14,"CONSTANTA",136,60419,,191,1,"SPITALUL MUNICIPAL CONSTANTA - BD. TOMIS NR.145","MUNICIPIUL CONSTANTA",1,60419,1,1,0,749,0,749,746,3,1000,251,507,239,
14,"CONSTANTA",136,60419,,192,1,"SPITALUL PORT - INCINTA PORT","MUNICIPIUL CONSTANTA",1,60419,1,1,0,95,0,95,94,1,100,5,55,39,
14,"CONSTANTA",136,60419,,193,1,"U.M.01352 - STR. TULCEI NR.22","MUNICIPIUL CONSTANTA",1,60419,1,1,0,124,0,124,119,5,200,76,62,57,
14,"CONSTANTA",136,60419,,194,1,"U.M.02159 - INCINTA PORT","MUNICIPIUL CONSTANTA",1,60419,1,1,0,181,0,181,177,4,200,19,80,97,
14,"CONSTANTA",136,60419,,195,1,"U.M.01323 MUZEUL DE MARE - UNITATEA KM.4-5","MUNICIPIUL CONSTANTA",1,60419,1,1,0,189,0,189,185,4,200,11,107,78,
14,"CONSTANTA",136,60419,,196,1,"U.M.02192 - ACADEMIA NAVALA - STR. FULGER NR.1","MUNICIPIUL CONSTANTA",1,60419,1,1,0,559,0,559,447,112,600,41,270,177,
14,"CONSTANTA",136,60419,,197,1,"U.M.2003 - STR. TULCEI NR.12","MUNICIPIUL CONSTANTA",1,60419,1,1,0,171,0,171,162,9,202,31,83,79,
14,"CONSTANTA",136,60419,,198,1,"PETROMAR - INCINTA PORT","MUNICIPIUL CONSTANTA",1,60419,1,1,0,429,0,429,414,15,600,171,215,199,
14,"CONSTANTA",136,60419,,199,1,"STATIA RADIO COASTA CONSTANTA","MUNICIPIUL CONSTANTA",1,60419,1,1,0,794,0,794,696,98,998,204,285,411,
14,"CONSTANTA",136,60419,,200,1,"GARA CONSTANTA","MUNICIPIUL CONSTANTA",1,60419,1,1,0,712,0,712,701,11,800,88,391,310,
14,"CONSTANTA",136,60419,,201,1,"AUTOGARA SUD CONSTANTA","MUNICIPIUL CONSTANTA",1,60419,1,1,0,194,0,194,193,1,200,6,84,109,
14,"CONSTANTA",136,60419,,202,1,"AUTOGARA NORD CONSTANTA","MUNICIPIUL CONSTANTA",1,60419,1,1,0,139,0,139,139,0,200,61,79,60,
14,"CONSTANTA",136,60482,,203,0,"CASA MUN. DE CULTURA - SOS. CONSTANTEI","MUNICIPIUL MANGALIA",2,60482,1,1,959,711,537,174,699,12,1100,389,484,215,
14,"CONSTANTA",136,60482,,204,0,"CLUBUL ELEVILOR - STR. MIRCEA CEL BATRIN","MUNICIPIUL MANGALIA",2,60482,1,1,1296,816,738,78,807,9,1400,584,527,280,
14,"CONSTANTA",136,60482,,205,0,"GRADINITA NR.1 - STR. DELFINULUI","MUNICIPIUL MANGALIA",2,60482,1,1,1070,640,580,60,634,6,1204,564,407,227,
14,"CONSTANTA",136,60482,,206,0,"LOCAL DMHI - STR. NEGRU VODA","MUNICIPIUL MANGALIA",2,60482,1,1,1752,1357,1005,352,1338,19,1893,536,592,746,
14,"CONSTANTA",136,60482,,207,0,"GRUP SCOLAR 'ION BANESCU' - STR. NEGRU VODA","MUNICIPIUL MANGALIA",2,60482,1,1,2340,1313,1204,109,1298,15,2600,1287,683,615,
14,"CONSTANTA",136,60482,,208,0,"CAMIN SMN,CMZ - BD. 1 DECEMBRIE 1918","MUNICIPIUL MANGALIA",2,60482,1,1,1515,992,789,203,986,6,1722,730,661,325,
14,"CONSTANTA",136,60482,,209,0,"SCOALA GENERALA NR.3 - STR. ALBATROS","MUNICIPIUL MANGALIA",2,60482,1,1,2409,1301,1167,134,1292,9,2600,1299,755,537,
14,"CONSTANTA",136,60482,,210,0,"GRADINITA NR.3 - STR. ALBATROS","MUNICIPIUL MANGALIA",2,60482,1,1,1662,890,826,64,884,6,1800,910,503,381,
14,"CONSTANTA",136,60482,,211,0,"SCOALA GENERALA NR.2 - STR. T. S. SAVEANU","MUNICIPIUL MANGALIA",2,60482,1,1,2047,1151,1022,129,1135,16,2200,1049,677,458,
14,"CONSTANTA",136,60482,,212,0,"GRUP SCOLAR ECONOMIC - STR. OITUZ","MUNICIPIUL MANGALIA",2,60482,1,1,1091,629,545,84,621,8,1200,571,382,239,
14,"CONSTANTA",136,60482,,213,0,"SC FRANC STELICA - STR. OITUZ","MUNICIPIUL MANGALIA",2,60482,1,1,935,558,518,40,549,9,1000,442,294,255,
14,"CONSTANTA",136,60482,,214,0,"SCOALA GENERALA NR.1 (LOCAL VECHI ) - STR. MATEI BASARAB","MUNICIPIUL MANGALIA",2,60482,1,1,1968,1183,1097,86,1173,10,2199,1016,712,461,
14,"CONSTANTA",136,60482,,215,0,"SCOALA GENERALA NR.1 (LOCAL NOU) - STR. MATEI BASARAB","MUNICIPIUL MANGALIA",2,60482,1,1,1380,831,751,80,816,15,1500,669,475,341,
14,"CONSTANTA",136,60482,,216,0,"ASIROM - BD. CALLATIS","MUNICIPIUL MANGALIA",2,60482,1,1,1323,838,777,61,833,5,1200,362,539,294,
14,"CONSTANTA",136,60482,,217,0,"FUNDATIA PENTRU TINERET - SOS. CONSTANTEI","MUNICIPIUL MANGALIA",2,60482,1,1,1178,739,649,90,729,10,1200,461,455,274,
14,"CONSTANTA",136,60482,,218,0,"SCOALA GENERALA NR.5 - SOS. CONSTANTEI","MUNICIPIUL MANGALIA",2,60482,1,1,1391,886,773,113,876,10,1500,614,548,328,
14,"CONSTANTA",136,60482,,219,0,"CINEMA PESCAUS - STR. ROZELOR","MUNICIPIUL MANGALIA",2,60482,1,1,1860,1093,966,127,1073,20,2000,907,657,416,
14,"CONSTANTA",136,60482,,220,0,"HOTEL MANGALIA - STR. MATEI BASARAB","MUNICIPIUL MANGALIA",2,60482,1,1,1586,976,851,125,970,6,1700,724,619,351,
14,"CONSTANTA",136,60482,,221,0,"CLUB SPITAL - STR. ROZELOR","MUNICIPIUL MANGALIA",2,60482,1,1,1121,810,609,201,802,8,1199,389,475,327,
14,"CONSTANTA",136,60482,,222,0,"LICEUL CALLATIS SECTOR 1 - STR. ROZELOR","MUNICIPIUL MANGALIA",2,60482,1,1,1543,926,793,133,914,12,1700,774,588,326,
14,"CONSTANTA",136,60482,,223,0,"LICEUL CALLATIS SECTOR 2 - STR. ROZELOR","MUNICIPIUL MANGALIA",2,60482,1,1,2103,1137,1066,71,1122,15,2300,1163,689,433,
14,"CONSTANTA",136,60482,,224,0,"CANTINA DORNA NEPTUN - STR. PLOPILOR","MUNICIPIUL MANGALIA",2,60482,1,1,1171,727,629,98,722,5,1300,573,418,304,
14,"CONSTANTA",136,60482,,225,0,"CROITORIE OLIMP - STR. TRANDAFIRILOR","MUNICIPIUL MANGALIA",2,60482,1,1,383,414,219,195,408,6,450,36,258,150,
14,"CONSTANTA",136,60482,,226,0,"INCINTA FRUVILEG - SOS. CONSTANTEI NR. 53","MUNICIPIUL MANGALIA",2,60482,1,1,387,372,187,185,362,10,400,28,234,128,
14,"CONSTANTA",136,60482,,227,1,"UM 02091 - BD. 1 DECEMBRIE 1918","MUNICIPIUL MANGALIA",2,60482,1,1,0,722,0,722,681,41,754,32,369,312,
14,"CONSTANTA",136,60482,,228,1,"GARA MANGALIA","MUNICIPIUL MANGALIA",2,60482,1,1,0,160,0,160,160,0,200,40,72,88,
14,"CONSTANTA",136,60847,,229,0,"CASA DE CULTURA 'I.N.ROMAN' - STR. REPUBLICII","MUNICIPIUL MEDGIDIA",3,60847,1,1,1035,620,563,57,617,3,1100,480,463,154,
14,"CONSTANTA",136,60847,,230,0,"CASA DE CULTURA A SINDICATELOR - STR. DECEBAL","MUNICIPIUL MEDGIDIA",3,60847,1,1,691,405,371,34,398,7,800,395,294,104,
14,"CONSTANTA",136,60847,,231,0,"GRADINITA NR.6 - STR. MARGARITARELOR","MUNICIPIUL MEDGIDIA",3,60847,1,1,1057,626,565,61,620,6,1200,574,384,236,
14,"CONSTANTA",136,60847,,232,0,"SCOALA NR.4 - INTRARE STR. SIRETULUI","MUNICIPIUL MEDGIDIA",3,60847,1,1,1028,611,568,43,604,7,1100,489,471,133,
14,"CONSTANTA",136,60847,,233,0,"SCOALA NR.4 - INTRARE STR. JIULUI","MUNICIPIUL MEDGIDIA",3,60847,1,1,1333,789,702,87,764,25,1500,711,690,74,
14,"CONSTANTA",136,60847,,234,0,"SCOALA NR.4 SALA DE SPORT - STR. JIULUI","MUNICIPIUL MEDGIDIA",3,60847,1,1,895,531,465,66,515,16,997,466,407,108,
14,"CONSTANTA",136,60847,,235,0,"GRADINITA NR 8 - STR. POPORULUI","MUNICIPIUL MEDGIDIA",3,60847,1,1,1133,655,585,70,647,8,1200,545,397,250,
14,"CONSTANTA",136,60847,,236,0,"LICEUL NR.2 - STR. POPORULUI","MUNICIPIUL MEDGIDIA",3,60847,1,1,905,562,499,63,554,8,1000,438,350,204,
14,"CONSTANTA",136,60847,,237,0,"SCOALA NR.1 - STR. KEMAL AGI AMET","MUNICIPIUL MEDGIDIA",3,60847,1,1,1134,654,600,54,648,6,1200,546,484,164,
14,"CONSTANTA",136,60847,,238,0,"LICEUL NICOLAE BALCESCU - INTRARE STR. SCARLAT VARNAV","MUNICIPIUL MEDGIDIA",3,60847,1,1,834,464,431,33,459,5,900,436,337,122,
14,"CONSTANTA",136,60847,,239,0,"SCOALA NR.7 - INTRARE STR. ION CREANGA","MUNICIPIUL MEDGIDIA",3,60847,1,1,984,587,535,52,581,6,1100,513,384,197,
14,"CONSTANTA",136,60847,,240,0,"SCOALA NR.7 - INTRARE STR. WALTER MARACINEANU","MUNICIPIUL MEDGIDIA",3,60847,1,1,875,500,457,43,494,6,1000,500,336,158,
14,"CONSTANTA",136,60847,,241,0,"LICEUL NICOLAE BALCESCU - INTRARE STR. ION CREANGA","MUNICIPIUL MEDGIDIA",3,60847,1,1,998,524,497,27,521,3,1100,576,382,139,
14,"CONSTANTA",136,60847,,242,0,"GRADINITA 'TUNA'(FOST SEDIU CAP) - STR. REPUBLICII","MUNICIPIUL MEDGIDIA",3,60847,1,1,1148,651,616,35,643,8,1300,649,419,224,
14,"CONSTANTA",136,60847,,243,0,"GRADINITA NR.2 IN FATA BLOCULUI SC4","MUNICIPIUL MEDGIDIA",3,60847,1,1,1102,709,663,46,705,4,1200,491,505,200,
14,"CONSTANTA",136,60847,,244,0,"GRADINITA NR.11 - IN FATA LA BLOC SC3","MUNICIPIUL MEDGIDIA",3,60847,1,1,941,621,584,37,619,2,1000,379,458,161,
14,"CONSTANTA",136,60847,,245,0,"LICEUL 'KEMAL ALATURK' - STR. ROMANA","MUNICIPIUL MEDGIDIA",3,60847,1,1,1090,635,581,54,630,5,1200,565,432,198,
14,"CONSTANTA",136,60847,,246,0,"SEDIUL C.E.M.-FOSTUL IREC","MUNICIPIUL MEDGIDIA",3,60847,1,1,1036,675,584,91,668,7,1102,427,432,236,
14,"CONSTANTA",136,60847,,247,0,"HOTEL 'STADION' RECEPTIE - STADIONUL CENTRAL","MUNICIPIUL MEDGIDIA",3,60847,1,1,1017,580,547,33,578,2,1102,522,355,223,
14,"CONSTANTA",136,60847,,248,0,"HOTEL 'STADION' SALON OFICIAL -  STADIONUL CENTRAL","MUNICIPIUL MEDGIDIA",3,60847,1,1,1225,744,688,56,736,8,1300,556,481,255,
14,"CONSTANTA",136,60847,,249,0,"SCOALA NR.5 - STR. LUPENI","MUNICIPIUL MEDGIDIA",3,60847,1,1,1077,640,574,66,633,7,1200,560,418,215,
14,"CONSTANTA",136,60847,,250,0,"SCOALA NR.5 - STR. LUPENI","MUNICIPIUL MEDGIDIA",3,60847,1,1,979,519,497,22,513,6,1100,581,305,208,
14,"CONSTANTA",136,60847,,251,0,"SCOALA 'LUCIAN GRIGORESCU'- FOSTA NR. 6 - CLADIRE NOUA","MUNICIPIUL MEDGIDIA",3,60847,1,1,1255,646,601,45,642,4,1402,756,424,218,
14,"CONSTANTA",136,60847,,252,0,"SCOALA 'LUCIAN GRIGORESCU' - FOSTA NR. 6 - CLADIRE VECHE","MUNICIPIUL MEDGIDIA",3,60847,1,1,798,467,442,25,463,4,902,435,348,115,
14,"CONSTANTA",136,60847,,253,0,"CASA DE CULTURA A SINDICATELOR - STR. DECEBAL","MUNICIPIUL MEDGIDIA",3,60847,1,1,1110,625,571,54,621,4,1200,575,424,197,
14,"CONSTANTA",136,60847,,254,0,"GARA C.F.R. - STR. VASILE LUPU","MUNICIPIUL MEDGIDIA",3,60847,1,1,656,580,366,214,579,1,702,122,331,248,
14,"CONSTANTA",136,60847,,255,0,"SCOALA NR.2 - STR. DEZROBIRII","MUNICIPIUL MEDGIDIA",3,60847,1,1,1083,636,589,47,625,11,1200,564,349,276,
14,"CONSTANTA",136,60847,,256,0,"SCOALA NR.2 - STR. DEZROBIRII","MUNICIPIUL MEDGIDIA",3,60847,1,1,1122,566,541,25,559,7,1200,634,300,259,
14,"CONSTANTA",136,60847,,257,0,"CANINA I.M.U.M - STR. INDEPENDENTEI","MUNICIPIUL MEDGIDIA",3,60847,1,1,917,696,485,211,691,5,1004,308,395,296,
14,"CONSTANTA",136,60847,,258,0,"LICEUL NR.1 - STR. DEZROBIRII","MUNICIPIUL MEDGIDIA",3,60847,1,1,0,0,0,0,0,0,0,0,0,0,
14,"CONSTANTA",136,60847,,259,0,"LICEUL NR.1 - STR. DEZROBIRII","MUNICIPIUL MEDGIDIA",3,60847,1,1,1224,737,702,35,732,5,1300,563,426,306,
14,"CONSTANTA",136,60847,,260,0,"SCOALA NR.3 - STR. THEODOR AMAN","MUNICIPIUL MEDGIDIA",3,60847,1,1,842,551,506,45,546,5,900,349,343,203,
14,"CONSTANTA",136,60847,,261,0,"SCOALA NR.3 - STR. THEODOR AMAN","MUNICIPIUL MEDGIDIA",3,60847,1,1,1284,795,728,67,783,12,1400,605,483,300,
14,"CONSTANTA",136,60847,,262,0,"PLATFORMA BICAZ - RESTAURANT ""PIKI""","MUNICIPIUL MEDGIDIA",3,60847,1,1,1334,858,813,45,850,8,1400,542,521,329,
14,"CONSTANTA",136,60847,,263,0,"GRADINITA NR.7 - STR. ALEXANDRU CEL BUN","MUNICIPIUL MEDGIDIA",3,60847,1,1,1488,886,819,67,876,10,1600,714,501,375,
14,"CONSTANTA",136,60847,,264,1,"SPITALUL MEDGIDIA - STR. ION CREANGA","MUNICIPIUL MEDGIDIA",3,60847,1,1,0,289,0,289,286,3,300,11,221,65,
14,"CONSTANTA",136,60847,,265,0,"SCOALA - LOCALITATEA VALEA DACILOR","MUNICIPIUL MEDGIDIA",3,60847,1,1,912,595,493,102,588,7,1000,405,319,269,
14,"CONSTANTA",136,60847,,266,0,"SEDIUL AGROMEC - LOCALITATEA REMUS OPREANU","MUNICIPIUL MEDGIDIA",3,60847,1,1,241,199,151,48,195,4,304,105,110,85,
14,"CONSTANTA",136,60847,,267,1,"U.M.01392-STR. LUPENI","MUNICIPIUL MEDGIDIA",3,60847,1,1,0,134,0,134,129,5,200,66,76,53,
14,"CONSTANTA",136,60847,,268,1,"U.M.01254 - STR. REPUBLICII","MUNICIPIUL MEDGIDIA",3,60847,1,1,0,78,0,78,76,2,104,26,35,41,
14,"CONSTANTA",136,60847,,269,1,"U.M.01459 - STR. REPUBLICII","MUNICIPIUL MEDGIDIA",3,60847,1,1,0,71,0,71,71,0,100,29,32,39,
14,"CONSTANTA",136,62360,,270,0,"LICEUL TEORETIC BASARABI - STR. MIHAI EMINESCU NR.50","ORAS BASARABI",4,62360,2,1,962,535,428,107,532,3,1000,465,249,283,
14,"CONSTANTA",136,62360,,271,0,"LICEUL TEORETIC BASARABI - STR. MIHAI EMINESCU NR. 50","ORAS BASARABI",4,62360,2,1,1989,1172,939,233,1164,8,2200,1028,619,545,
14,"CONSTANTA",136,62360,,272,0,"SCOALA GENERALA NR.BASARABI - STR. ION CREANGA NR. 25","ORAS BASARABI",4,62360,2,1,1478,928,728,200,918,10,1600,672,478,440,
14,"CONSTANTA",136,62360,,273,1,"CERCUL MILITAR BASARABI - STR. G-RAL VASILE MILEA NR. 6","ORAS BASARABI",4,62360,2,1,0,344,0,344,336,8,400,56,139,197,
14,"CONSTANTA",136,62360,,274,0,"CLUB I.A.S. - ALE. MARGARITARELOR NR. 11","ORAS BASARABI",4,62360,2,1,2448,1370,1069,301,1359,11,2700,1330,738,621,
14,"CONSTANTA",136,62360,,275,0,"CANTINA SCUG SA BASARABI - STR. CIOCIRLIEI NR. 1","ORAS BASARABI",4,62360,2,1,629,496,324,172,493,3,700,204,238,255,
14,"CONSTANTA",136,62360,,276,0,"SCOALA SIMINOC","ORAS BASARABI",4,62360,2,1,674,521,390,131,510,11,700,179,264,246,
14,"CONSTANTA",136,60776,,277,0,"SCOALA GEN. NR.1 - STR. SALCIEI NR. 6","ORAS CERNAVODA",5,60776,2,1,1439,843,737,106,830,13,1600,757,424,406,
14,"CONSTANTA",136,60776,,278,0,"SCOALA GEN. NR.1 - STR. SALCIEI NR. 6","ORAS CERNAVODA",5,60776,2,1,1423,791,683,108,783,8,1600,809,365,418,
14,"CONSTANTA",136,60776,,279,0,"GRADINITA NR.1 - STR. SALCIEI NR. 8","ORAS CERNAVODA",5,60776,2,1,1261,736,681,55,730,6,1404,668,407,323,
14,"CONSTANTA",136,60776,,280,0,"SCOALA GEN. NR.2 -  STR. M.SADOVEANU NR. 9","ORAS CERNAVODA",5,60776,2,1,1464,842,800,42,828,14,1600,758,548,280,
14,"CONSTANTA",136,60776,,281,0,"SCOALA GEN. NR.3 - STR. A.SALIGNY NR. 24","ORAS CERNAVODA",5,60776,2,1,1270,752,590,162,746,6,1400,648,482,264,
14,"CONSTANTA",136,60776,,282,0,"SCOALA GEN. NR.3 - STR. A.SALIGNY NR. 24","ORAS CERNAVODA",5,60776,2,1,1883,1080,910,170,1068,12,2099,1019,682,386,
14,"CONSTANTA",136,60776,,283,0,"GRADINITA NR.4 - STR. TUDOR VLADIMIRESCU NR. 12","ORAS CERNAVODA",5,60776,2,1,1097,603,559,44,597,6,1200,597,342,255,
14,"CONSTANTA",136,60776,,284,0,"CRESA - STR. TUDOR VLADIMIRESCU NR. 10","ORAS CERNAVODA",5,60776,2,1,1029,555,521,34,548,7,1100,545,349,199,
14,"CONSTANTA",136,60776,,285,0,"GRUP SCOLAR IND.ENERGETIC - STR. CAZARMII NR. 6","ORAS CERNAVODA",5,60776,2,1,1324,672,519,153,670,2,1496,824,351,319,
14,"CONSTANTA",136,60776,,286,0,"GRUP SCOLAR IND.ENERGETIC - STR. CAZARMII NR. 6","ORAS CERNAVODA",5,60776,2,1,1046,695,508,187,686,9,1100,405,404,282,
14,"CONSTANTA",136,60776,,287,0,"GRUP SCOLAR IND.ENERGETIC - STR. CAZARMII NR. 6","ORAS CERNAVODA",5,60776,2,1,1036,562,450,112,550,12,1100,538,319,231,
14,"CONSTANTA",136,60776,,288,1,"U.M. 02034","ORAS CERNAVODA",5,60776,2,1,0,228,0,228,226,2,296,68,118,108,
14,"CONSTANTA",136,60455,,289,0,"LICEUL ""CARMEN SILVA""","ORAS EFORIE",6,60455,2,1,1472,863,778,85,856,7,1600,737,548,308,
14,"CONSTANTA",136,60455,,290,0,"ANEXA BIBLIOTECII ORASENESTI","ORAS EFORIE",6,60455,2,1,1627,993,860,133,985,8,1796,803,711,274,
14,"CONSTANTA",136,60455,,291,0,"GRADINITA DE COPII - STR. V.ALECSANDRI NR.2","ORAS EFORIE",6,60455,2,1,825,592,439,153,587,5,900,308,388,199,
14,"CONSTANTA",136,60455,,292,0,"HOTEL ""TRAIAN""","ORAS EFORIE",6,60455,2,1,1365,1023,735,288,1002,21,1500,477,639,363,
14,"CONSTANTA",136,60455,,293,0,"COMPLEXUL ""CRISTAL""","ORAS EFORIE",6,60455,2,1,1098,816,528,288,806,10,1194,378,538,268,
14,"CONSTANTA",136,60455,,294,0,"SCOALA GENERALA - STR. M.KOGALNICEANU NR.25","ORAS EFORIE",6,60455,2,1,1356,852,718,134,842,10,1506,654,559,283,
14,"CONSTANTA",136,60801,,295,0,"CASA DE CULTURA - STR. PIATA 1 DECEMBRIE NR. 2","ORAS HARSOVA",7,60801,2,1,929,515,485,30,513,2,1000,485,340,173,
14,"CONSTANTA",136,60801,,296,0,"LICEUL TEORETIC - SOS. CONSTANTEI NR. 24","ORAS HARSOVA",7,60801,2,1,1412,798,697,101,794,4,1500,702,474,320,
14,"CONSTANTA",136,60801,,297,0,"GRADINITA - STR. SOARELUI NR. 2","ORAS HARSOVA",7,60801,2,1,1215,641,614,27,631,10,1296,655,411,220,
14,"CONSTANTA",136,60801,,298,0,"CANTINA LICEUL TEORETIC - STR. SCOLII NR. 12","ORAS HARSOVA",7,60801,2,1,1535,738,707,31,734,4,1700,962,486,248,
14,"CONSTANTA",136,60801,,299,0,"SCOALA GENERALA NR.1 - STR. REVOLUTIEI NR. 5","ORAS HARSOVA",7,60801,2,1,1566,759,711,48,755,4,1700,941,441,314,
14,"CONSTANTA",136,60801,,300,0,"OCOLUL SILVIC - STR. VADULUI NR. 87","ORAS HARSOVA",7,60801,2,1,1313,741,692,49,737,4,1400,659,501,236,
14,"CONSTANTA",136,60801,,301,0,"SCOALA PRIMARA VADU OII","ORAS HARSOVA",7,60801,2,1,336,207,178,29,205,2,400,193,100,105,
14,"CONSTANTA",136,60507,,302,0,"SCOALA NR 3 -STR. CABANEI NR. 2","ORAS NAVODARI",8,60507,2,1,1959,1005,906,99,999,6,2200,1195,522,477,
14,"CONSTANTA",136,60507,,303,0,"LICEUL DE CHIMIE-STR. SANATATII NR. 4","ORAS NAVODARI",8,60507,2,1,2107,1087,1020,67,1077,10,2300,1213,637,440,
14,"CONSTANTA",136,60507,,304,0,"LICEUL DE CHIMIE-STR. SANATATII NR. 4","ORAS NAVODARI",8,60507,2,1,1647,842,707,135,831,11,1800,958,411,420,
14,"CONSTANTA",136,60507,,305,0,"LICEUL DE CHIMIE-STR. SANATATII NR. 4","ORAS NAVODARI",8,60507,2,1,1563,788,735,53,781,7,1700,912,459,322,
14,"CONSTANTA",136,60507,,306,0,"SCOALA GENERALA NR 1-STR. CULTURII NR. 33","ORAS NAVODARI",8,60507,2,1,1628,946,878,68,933,13,1800,854,509,424,
14,"CONSTANTA",136,60507,,307,0,"SCOALA GENERALA NR 1-STR. CULTURII NR. 33","ORAS NAVODARI",8,60507,2,1,1401,733,638,95,723,10,1500,767,396,327,
14,"CONSTANTA",136,60507,,308,0,"SCOALA GENERALA NR 1-STR. CULTURII NR. 33","ORAS NAVODARI",8,60507,2,1,1987,939,840,99,929,10,2200,1261,506,423,
14,"CONSTANTA",136,60507,,309,0,"SCOALA GENERALA NR 2-STR. PLOPILOR NR. 38","ORAS NAVODARI",8,60507,2,1,1839,997,910,87,983,14,2000,1003,535,448,
14,"CONSTANTA",136,60507,,310,0,"SCOALA GENERALA NR 2-STR. PLOPILOR NR. 38","ORAS NAVODARI",8,60507,2,1,1538,810,738,72,798,12,1700,890,458,340,
14,"CONSTANTA",136,60507,,311,0,"GRADINITA NR 2-STR. PLOPILOR NR. 38","ORAS NAVODARI",8,60507,2,1,1913,966,865,101,948,18,2100,1134,463,485,
14,"CONSTANTA",136,60507,,312,0,"CASA CASATORIILOR-STR. CONSTANTEI BL. P2","ORAS NAVODARI",8,60507,2,1,1985,1044,945,99,1023,21,2200,1156,555,468,
14,"CONSTANTA",136,60507,,313,0,"CLUBUL PETROMIDIA-STR. TINERETULUI NR. 3","ORAS NAVODARI",8,60507,2,1,2036,1026,933,93,1015,11,2200,1174,570,445,
14,"CONSTANTA",136,60507,,314,0,"DISCOTECA GALAXY-STR. CULTURII NR. 1","ORAS NAVODARI",8,60507,2,1,1590,940,834,106,924,16,1700,760,569,355,
14,"CONSTANTA",136,60507,,315,0,"CLUBUL ELEVILOR-STR. CABANEI NR. 5","ORAS NAVODARI",8,60507,2,1,2218,1369,1043,326,1356,13,2400,1031,703,653,
14,"CONSTANTA",136,60507,,316,0,"CASA CASATORIILOR-STR. CONSTANTEI BL. P2","ORAS NAVODARI",8,60507,2,1,1597,890,754,136,882,8,1700,810,475,407,
14,"CONSTANTA",136,60507,,317,1,"U.M. 2024","ORAS NAVODARI",8,60507,2,1,0,183,0,183,179,4,500,317,98,81,
14,"CONSTANTA",136,60507,,318,1,"U.M. 01703","ORAS NAVODARI",8,60507,2,1,0,397,0,397,394,3,500,103,240,154,
14,"CONSTANTA",136,62397,,319,0,"SCOALA GENERALA-STR.RECOLTEI","ORAS NEGRU VODA",9,62397,2,1,2080,1326,1141,185,1311,15,2300,974,930,381,
14,"CONSTANTA",136,62397,,320,0,"SCOALA GENERALA-STR.SILOZULUI","ORAS NEGRU VODA",9,62397,2,1,1222,800,676,124,790,10,1300,500,516,274,
14,"CONSTANTA",136,62397,,321,0,"CAMINUL CULTURAL -SAT DARABANI","ORAS NEGRU VODA",9,62397,2,1,565,367,313,54,357,10,600,233,204,153,
14,"CONSTANTA",136,62397,,322,0,"SCOALA GENERALA-SAT VILCELELE","ORAS NEGRU VODA",9,62397,2,1,196,143,93,50,142,1,200,57,88,54,
14,"CONSTANTA",136,62397,,323,0,"FOSTA CANTINA SC NOVOCECA-ORASUL NEGRU VODA","ORAS NEGRU VODA",9,62397,2,1,119,111,81,30,111,0,200,89,55,56,
14,"CONSTANTA",136,60687,,324,0,"SCOALA GENERALA NR.1","ORAS OVIDIU",10,60687,2,1,1797,1010,920,90,998,12,2000,990,552,446,
14,"CONSTANTA",136,60687,,325,0,"GRADINITA ZIG ZAG","ORAS OVIDIU",10,60687,2,1,1782,941,802,139,927,14,1994,1053,510,417,
14,"CONSTANTA",136,60687,,326,0,"SCOALA GENERALA NR.2-LOCAL NOU","ORAS OVIDIU",10,60687,2,1,2237,1240,1145,95,1226,14,2400,1160,720,506,
14,"CONSTANTA",136,60687,,327,0,"SCOALA GENERALA NR.2-LOCAL VECHI","ORAS OVIDIU",10,60687,2,1,2989,1642,1512,130,1629,13,3185,1543,842,787,
14,"CONSTANTA",136,60687,,328,0,"SCOALA GENERALA -SAT POIANA","ORAS OVIDIU",10,60687,2,1,973,389,256,133,386,3,1100,711,183,203,
14,"CONSTANTA",136,60687,,329,0,"SC NAZARCEA-GRUP SOCIAL NAZARCEA","ORAS OVIDIU",10,60687,2,1,440,501,240,261,491,10,600,99,268,223,
14,"CONSTANTA",136,60687,,330,1,"U.M.-RADIOLOCATIE NAZARCEA","ORAS OVIDIU",10,60687,2,1,0,73,0,73,66,7,100,27,41,25,
14,"CONSTANTA",136,60534,,331,0,"CASA DE CULTURA-STR.NARCISELOR NR.2","ORAS TECHIRGHIOL",11,60534,2,1,1717,988,919,69,970,18,1900,912,620,350,
14,"CONSTANTA",136,60534,,332,0,"GRADINITA NR 1-STR.N.BALCESCU NR.29","ORAS TECHIRGHIOL",11,60534,2,1,1500,920,860,60,914,6,1600,680,566,348,
14,"CONSTANTA",136,60534,,333,0,"GRADINITA NR 2-STR.N.BALCESCU NR.61","ORAS TECHIRGHIOL",11,60534,2,1,1190,773,700,73,764,9,1400,627,413,351,
14,"CONSTANTA",136,60534,,334,0,"SALON RODNA-STR.DR.I.TATARU NR.1","ORAS TECHIRGHIOL",11,60534,2,1,1066,665,591,74,647,18,1200,535,397,250,
14,"CONSTANTA",136,60534,,335,1,"SANATORIUL BALNEAR TECHIRGHIOL","ORAS TECHIRGHIOL",11,60534,2,1,0,218,0,218,213,5,700,482,114,99,
14,"CONSTANTA",136,60883,,336,0,"SCOALA GENERALA-SAT ADAMCLISI","ADAMCLISI",13,60883,0,3,977,505,417,88,500,5,1100,595,301,199,
14,"CONSTANTA",136,60883,,337,0,"SCOALA PRIMARA-SAT ZORILE","ADAMCLISI",13,60883,0,3,459,315,261,54,310,5,500,185,199,111,
14,"CONSTANTA",136,60883,,338,0,"SCOALA PRIMARA-SAT URLUIA","ADAMCLISI",13,60883,0,3,223,180,131,49,176,4,300,120,62,114,
14,"CONSTANTA",136,60883,,339,0,"SCOALA PRIMARA-SAT ABRUD","ADAMCLISI",13,60883,0,3,140,91,44,47,90,1,200,109,43,47,
14,"CONSTANTA",136,60570,,340,0,"SCOALA ION BURCEA-SAT AGIGEA","AGIGEA",14,60570,0,3,1442,944,666,278,936,8,1596,652,488,448,
14,"CONSTANTA",136,60570,,341,0,"GRADINITA-SAT AGIGEA","AGIGEA",14,60570,0,3,1492,817,714,103,807,10,1600,783,484,323,
14,"CONSTANTA",136,60570,,342,0,"SANATORIUL T.B.C.OA-SAT AGIGEA","AGIGEA",14,60570,0,3,247,373,133,240,365,8,500,127,161,204,
14,"CONSTANTA",136,60570,,343,0,"SCOALA GENERALA-SAT LAZU","AGIGEA",14,60570,0,3,529,365,264,101,361,4,600,235,185,176,
14,"CONSTANTA",136,60945,,344,0,"SCOALA GENERALA-SAT ALBESTI","ALBESTI",15,60945,0,3,1172,637,523,114,636,1,1300,663,386,250,
14,"CONSTANTA",136,60945,,345,0,"SCOALA GENERALA-SAT COTU VAII","ALBESTI",15,60945,0,3,738,472,374,98,465,7,800,328,233,232,
14,"CONSTANTA",136,60945,,346,0,"SCOALA GENERALA-SAT VIRTOP","ALBESTI",15,60945,0,3,152,140,79,61,139,1,200,60,75,64,
14,"CONSTANTA",136,60945,,347,0,"SCOALA GENERALA-SAT COROANA","ALBESTI",15,60945,0,3,112,100,53,47,97,3,200,100,29,68,
14,"CONSTANTA",136,60945,,348,0,"SCOALA GENERALA-SAT ARSA","ALBESTI",15,60945,0,3,267,275,176,99,271,4,300,25,129,142,
14,"CONSTANTA",136,61005,,349,0,"SCOALA GENERALA-SAT ALIMAN","ALIMAN",16,61005,0,3,1130,685,581,104,672,13,1200,515,328,344,
14,"CONSTANTA",136,61005,,350,0,"SCOALA GENERALA-SAT DUNARENI","ALIMAN",16,61005,0,3,1240,754,708,46,731,23,1400,646,515,216,
14,"CONSTANTA",136,63198,,351,0,"SCOALA GENERALA-SAT AMZACEA","AMZACEA",17,63198,0,3,827,578,473,105,566,12,900,322,293,273,
14,"CONSTANTA",136,63198,,352,0,"SCOALA GENERALA-SAT G-RAL SCARISOREANU","AMZACEA",17,63198,0,3,752,471,453,18,455,16,800,329,302,153,
14,"CONSTANTA",136,63198,,353,0,"SCOALA GENERALA-SAT CASICEA","AMZACEA",17,63198,0,3,348,224,182,42,223,1,400,176,87,136,
14,"CONSTANTA",136,61069,,354,0,"SCOALA GENERALA NR 1-SAT BANEASA","BANEASA",18,61069,0,3,901,663,469,194,650,13,1000,337,317,333,
14,"CONSTANTA",136,61069,,355,0,"LICEUL TEORETIC-SAT BANEASA","BANEASA",18,61069,0,3,1959,1179,995,184,1163,16,2200,1021,560,603,
14,"CONSTANTA",136,61069,,356,0,"SCOALA GENERALA-SAT NEGURENI","BANEASA",18,61069,0,3,588,437,379,58,427,10,600,163,311,116,
14,"CONSTANTA",136,61069,,357,0,"SCOALA GENERALA-SAT FAUREI","BANEASA",18,61069,0,3,722,531,426,105,503,28,800,269,309,194,
14,"CONSTANTA",136,61121,,358,0,"CAMINUL CULTURAL-SAT CASTELU","CASTELU",19,61121,0,3,1281,652,652,0,637,15,1400,748,393,244,
14,"CONSTANTA",136,61121,,359,0,"CAMINUL CULTURAL-SAT CASTELU","CASTELU",19,61121,0,3,781,560,376,184,545,15,900,340,286,259,
14,"CONSTANTA",136,61121,,360,0,"CAMINUL CULTURAL-SAT CUZA VODA","CASTELU",19,61121,0,3,1363,800,765,35,784,16,1500,700,453,331,
14,"CONSTANTA",136,61121,,361,0,"CAMINUL CULTURAL-SAT CUZA VODA","CASTELU",19,61121,0,3,568,562,310,252,551,11,600,38,386,165,
14,"CONSTANTA",136,61121,,362,0,"CAMINUL CULTURAL-SAT NISIPARI","CASTELU",19,61121,0,3,1102,757,581,176,744,13,1200,443,281,463,
14,"CONSTANTA",136,61167,,363,0,"SCOALA GENERALA-SAT CERCHEZU","CERCHEZU",20,61167,0,3,472,327,266,61,317,10,500,173,193,124,
14,"CONSTANTA",136,61167,,364,0,"CAMINUL CULTURAL-SAT VIROAGA","CERCHEZU",20,61167,0,3,592,465,380,85,459,6,700,235,283,176,
14,"CONSTANTA",136,61167,,365,0,"SCOALA PRIMARA-SAT MAGURA","CERCHEZU",20,61167,0,3,99,100,66,34,95,5,100,0,85,10,
14,"CONSTANTA",136,61210,,366,0,"SCOALA GENERALA-SAT CHIRNOGENI","CHIRNOGENI",21,61210,0,3,1484,995,870,125,973,22,1600,605,661,312,
14,"CONSTANTA",136,61210,,367,0,"SCOALA GENERALA-SAT PLOPENI","CHIRNOGENI",21,61210,0,3,966,570,489,81,567,3,1100,530,401,166,
14,"CONSTANTA",136,61210,,368,0,"SCOALA GENERALA-SAT CREDINTA","CHIRNOGENI",21,61210,0,3,206,189,142,47,189,0,300,111,120,69,
14,"CONSTANTA",136,61256,,369,0,"CAMINUL CULTURAL-SAT. CIOBANU","CIOBANU",22,61256,0,3,1147,643,599,44,640,3,1304,661,352,288,
14,"CONSTANTA",136,61256,,370,0,"SCOALA GENERALA-SAT. CIOBANU","CIOBANU",22,61256,0,3,1347,740,710,30,731,9,1500,760,402,329,
14,"CONSTANTA",136,61256,,371,0,"FOSTUL CAMIN CULTURAL-SAT. MIORITA","CIOBANU",22,61256,0,3,275,211,171,40,210,1,300,89,171,39,
14,"CONSTANTA",136,61283,,372,0,"SCOALA GENERALA-SAT CIOCIRLIA DE JOS","CIOCARLIA",23,61283,0,3,1516,764,679,85,755,9,1700,936,461,294,
14,"CONSTANTA",136,61283,,373,0,"SCOALA GENERALA-SAT CIOCIRLIA DE SUS","CIOCARLIA",23,61283,0,3,643,469,334,135,467,2,700,231,212,255,
14,"CONSTANTA",136,61318,,374,0,"CAMINUL CULTURAL-SAT COBADIN","COBADIN",24,61318,0,3,1721,1001,868,133,984,17,1900,899,705,279,
14,"CONSTANTA",136,61318,,375,0,"SCOALA GENERALA(SEDIU VECHI)-SAT COBADIN","COBADIN",24,61318,0,3,1582,930,841,89,917,13,1700,770,622,295,
14,"CONSTANTA",136,61318,,376,0,"SEDIU FOST CAP-SAT COBADIN","COBADIN",24,61318,0,3,1532,900,787,113,890,10,1700,800,600,290,
14,"CONSTANTA",136,61318,,377,0,"SCOALA GENERALA-SAT CONACU","COBADIN",24,61318,0,3,287,206,153,53,205,1,300,94,117,88,
14,"CONSTANTA",136,61318,,378,0,"CAMINUL CULTURAL-SAT NEGRESTI","COBADIN",24,61318,0,3,430,263,214,49,263,0,500,237,183,80,
14,"CONSTANTA",136,61318,,379,0,"SEDIUL FOST CAP-SAT VIISOARA","COBADIN",24,61318,0,3,1132,759,581,178,746,13,1200,441,422,324,
14,"CONSTANTA",136,61372,,380,0,"CAMINUL CULTURAL-SAT COGEALAC","COGEALAC",25,61372,0,3,1433,750,666,84,742,8,1600,850,448,294,
14,"CONSTANTA",136,61372,,381,0,"SCOALA GENERALA-SAT COGEALAC","COGEALAC",25,61372,0,3,1410,736,654,82,729,7,1500,764,440,289,
14,"CONSTANTA",136,61372,,382,0,"SCOALA GENERALA-SAT TARIVERDE","COGEALAC",25,61372,0,3,817,507,400,107,499,8,900,393,276,223,
14,"CONSTANTA",136,61372,,383,0,"SCOALA GENERALA-SAT FANTANELE","COGEALAC",25,61372,0,3,1244,774,670,104,762,12,1400,626,466,296,
14,"CONSTANTA",136,61372,,384,0,"SCOALA GENERALA-SAT RAMNICUL DE JOS","COGEALAC",25,61372,0,3,623,411,331,80,402,9,700,289,248,154,
14,"CONSTANTA",136,61452,,385,0,"SCOALA GENERALA-SAT COMANA","COMANA",26,61452,0,3,731,485,398,87,477,8,800,315,316,161,
14,"CONSTANTA",136,61452,,386,0,"SCOALA GENERALA-SAT TATARU","COMANA",26,61452,0,3,489,312,279,33,307,5,600,288,198,109,
14,"CONSTANTA",136,61452,,387,0,"SCOALA PRIMARA-SAT PELINU","COMANA",26,61452,0,3,231,166,128,38,163,3,300,134,87,76,
14,"CONSTANTA",136,61513,,388,0,"SCOALA GENERALA NR 1-SAT. CORBU","CORBU",27,61513,0,3,1704,1145,856,289,1130,15,1900,755,468,662,
14,"CONSTANTA",136,61513,,389,0,"ASOCIATIA AGRICOLA-SAT. CORBU","CORBU",27,61513,0,3,1271,834,603,231,829,5,1400,566,440,389,
14,"CONSTANTA",136,61513,,390,0,"SCOALA PRIMARA-SAT. VADU","CORBU",27,61513,0,3,500,335,255,80,333,2,600,265,199,134,
14,"CONSTANTA",136,61513,,391,1,"U.M. 01853 CAP MIDIA","CORBU",27,61513,0,3,0,86,0,86,83,3,100,14,31,52,
14,"CONSTANTA",136,63286,,392,0,"SCOALA GENERALA-SAT. COSTINESTI","COSTINESTI",28,63286,0,3,1638,1199,1000,199,1190,9,1800,601,712,478,
14,"CONSTANTA",136,63286,,393,1,"U.M. 02052 COSTINESTI","COSTINESTI",28,63286,0,3,0,82,0,82,78,4,102,20,33,45,
14,"CONSTANTA",136,61559,,394,0,"CAMINUL CULTURAL-SAT. CRUCEA","CRUCEA",29,61559,0,3,965,554,475,79,541,13,1100,546,378,163,
14,"CONSTANTA",136,61559,,395,0,"SEDIUL FOST CAP-SAT. GALBIORI","CRUCEA",29,61559,0,3,222,200,149,51,199,1,300,100,116,83,
14,"CONSTANTA",136,61559,,396,0,"GRADINITA-SAT. BALTAGESTI","CRUCEA",29,61559,0,3,349,253,218,35,249,4,400,147,199,50,
14,"CONSTANTA",136,61559,,397,0,"SCOALA GENERALA-SAT. STUPINA","CRUCEA",29,61559,0,3,540,390,329,61,388,2,600,210,289,99,
14,"CONSTANTA",136,61559,,398,0,"SEDIUL FOST CAP-SAT. CRISAN","CRUCEA",29,61559,0,3,327,225,212,13,223,2,400,175,170,53,
14,"CONSTANTA",136,61559,,399,0,"SCOALA GENERALA-SAT. SIRIU","CRUCEA",29,61559,0,3,193,137,115,22,133,4,200,63,91,42,
14,"CONSTANTA",136,61620,,400,0,"SCOALA VECHE-SAT. CUMPANA","CUMPANA",30,61620,0,3,2299,1475,1303,172,1450,25,2500,1025,751,699,
14,"CONSTANTA",136,61620,,401,0,"SCOALA NOUA-SAT. CUMPANA","CUMPANA",30,61620,0,3,2188,1270,1168,102,1248,22,2395,1125,587,661,
14,"CONSTANTA",136,61620,,402,0,"ANEXA SCOALA GENERALA-SAT. CUMPANA","CUMPANA",30,61620,0,3,2043,1365,1240,125,1348,17,2200,835,763,585,
14,"CONSTANTA",136,61675,,403,0,"SCOALA GENERALA-SAT DELENI","DELENI",31,61675,0,3,296,236,146,90,232,4,300,64,100,132,
14,"CONSTANTA",136,61675,,404,0,"SCOALA GENERALA-SAT SIPOTELE","DELENI",31,61675,0,3,388,328,238,90,321,7,400,72,195,126,
14,"CONSTANTA",136,61675,,405,0,"SCOALA GENERALA-SAT PETROSANI","DELENI",31,61675,0,3,454,308,262,46,303,5,500,192,199,104,
14,"CONSTANTA",136,61675,,406,0,"SCOALA GENERALA-SAT PIETRENI","DELENI",31,61675,0,3,584,408,310,98,404,4,600,192,181,223,
14,"CONSTANTA",136,61737,,407,0,"SCOALA GENERALA-SAT DOBROMIR VALE","DOBROMIR",32,61737,0,3,793,379,313,66,367,12,800,421,192,175,
14,"CONSTANTA",136,61737,,408,0,"SCOALA GENERALA-SAT DOBROMIR DEAL","DOBROMIR",32,61737,0,3,122,240,89,151,235,5,300,60,113,122,
14,"CONSTANTA",136,61737,,409,0,"SCOALA GENERALA-SAT LESPEZI","DOBROMIR",32,61737,0,3,238,241,153,88,236,5,300,59,130,106,
14,"CONSTANTA",136,61737,,410,0,"SCOALA GENERALA-SAT VALENI","DOBROMIR",32,61737,0,3,517,404,282,122,400,4,599,195,312,88,
14,"CONSTANTA",136,61737,,411,0,"SCOALA GENERALA-SAT PADURENI","DOBROMIR",32,61737,0,3,97,88,52,36,88,0,102,14,54,34,
14,"CONSTANTA",136,63161,,412,0,"SCOALA GENERALA-SAT DUMBRAVENI","DUMBRAVENI",33,63161,0,3,437,299,230,69,295,4,500,201,180,115,
14,"CONSTANTA",136,61808,,413,0,"GRADINITA-SAT. GIRLICIU","GARLICIU",34,61808,0,3,1472,889,815,74,882,7,1606,717,541,341,
14,"CONSTANTA",136,61826,,414,0,"SCOALA GENERALA-SAT. GHINDARESTI","GHINDARESTI",35,61826,0,3,1105,559,526,33,552,7,1200,641,184,368,
14,"CONSTANTA",136,61826,,415,0,"SCOALA GENERALA-SAT. GHINDARESTI","GHINDARESTI",35,61826,0,3,1096,535,487,48,529,6,1207,672,177,352,
14,"CONSTANTA",136,63278,,416,0,"CAMINUL CULTURAL-SAT. HOREA","HORIA",36,63278,0,3,660,464,382,82,460,4,700,236,319,141,
14,"CONSTANTA",136,63278,,417,0,"CAMINUL CULTURAL-SAT. TICHILESTI","HORIA",36,63278,0,3,315,228,184,44,223,5,400,172,153,70,
14,"CONSTANTA",136,61871,,418,0,"SCOALA GENERALA-SAT INDEPENDENTA","INDEPENDENTA",37,61871,0,3,1049,613,547,66,601,12,1100,487,426,175,
14,"CONSTANTA",136,61871,,419,0,"SCOALA GENERALA-SAT MOVILA VERDE","INDEPENDENTA",37,61871,0,3,460,326,249,77,321,5,500,174,126,195,
14,"CONSTANTA",136,61871,,420,0,"SCOALA GENERALA-SAT OLTENI","INDEPENDENTA",37,61871,0,3,359,281,235,46,271,10,400,119,134,137,
14,"CONSTANTA",136,61871,,421,0,"SCOALA GENERALA-SAT TUFANI","INDEPENDENTA",37,61871,0,3,291,196,168,28,192,4,300,104,128,64,
14,"CONSTANTA",136,61871,,422,0,"SCOALA GENERALA-SAT FINTINA MARE","INDEPENDENTA",37,61871,0,3,261,229,192,37,225,4,300,71,184,41,
14,"CONSTANTA",136,61951,,423,0,"SCOALA GENERALA-SAT ION CORVIN","ION CORVIN",38,61951,0,3,509,332,267,65,327,5,600,268,224,103,
14,"CONSTANTA",136,61951,,424,0,"SCOALA GENERALA-SAT VIILE","ION CORVIN",38,61951,0,3,874,520,465,55,512,8,1000,480,261,251,
14,"CONSTANTA",136,61951,,425,0,"SCOALA PRIMARA-SAT RARISTEA","ION CORVIN",38,61951,0,3,226,168,121,47,161,7,300,132,115,46,
14,"CONSTANTA",136,61951,,426,0,"SCOALA PRIMARA-SAT CRANGU","ION CORVIN",38,61951,0,3,116,109,60,49,108,1,200,91,76,32,
14,"CONSTANTA",136,62020,,427,0,"SCOALA GENERALA-SAT ISTRIA","ISTRIA",39,62020,0,3,1088,607,515,92,596,11,1200,593,357,239,
14,"CONSTANTA",136,62020,,428,0,"SCOALA GENERALA-SAT NUNTASI","ISTRIA",39,62020,0,3,760,509,403,106,506,3,800,291,294,212,
14,"CONSTANTA",136,60632,,429,0,"SCOALA GENERALA-SAT LIMANU","LIMANU",40,60632,0,3,1572,946,792,154,938,8,1700,754,554,384,
14,"CONSTANTA",136,60632,,430,0,"SCOALA GENERALA-SAT 2 MAI","LIMANU",40,60632,0,3,1719,1099,905,194,1088,11,1900,801,624,464,
14,"CONSTANTA",136,62057,,431,0,"CAMINUL CULTURAL-SAT LIPNITA","LIPNITA",41,62057,0,3,833,539,421,118,531,8,900,361,377,154,
14,"CONSTANTA",136,62057,,432,0,"CAMINUL CULTURAL-SAT COSLUGEA","LIPNITA",41,62057,0,3,649,436,366,70,426,10,700,264,329,97,
14,"CONSTANTA",136,62057,,433,0,"CAMINUL CULTURAL-SAT CANLIA","LIPNITA",41,62057,0,3,486,400,322,78,389,11,500,100,210,179,
14,"CONSTANTA",136,62057,,434,0,"SCOALA GENERALA-SAT CARVAN","LIPNITA",41,62057,0,3,439,270,221,49,265,5,500,230,195,70,
14,"CONSTANTA",136,62057,,435,0,"SCOALA PRIMARA-SAT IZVOARELE","LIPNITA",41,62057,0,3,133,93,73,20,92,1,200,107,48,44,
14,"CONSTANTA",136,62057,,436,0,"SCOALA PRIMARA-SAT GORUNI","LIPNITA",41,62057,0,3,132,105,78,27,104,1,200,95,51,53,
14,"CONSTANTA",136,62057,,437,0,"SCOALA PRIMARA-SAT CUIUGIUC","LIPNITA",41,62057,0,3,191,127,94,33,121,6,200,73,89,32,
14,"CONSTANTA",136,63152,,438,0,"SCOALA GENERALA(NOUA)-SAT LUMINA","LUMINA",42,63152,0,3,2295,1299,1033,266,1291,8,2500,1201,579,712,
14,"CONSTANTA",136,63152,,439,0,"SCOALA GENERALA(VECHE)-SAT LUMINA","LUMINA",42,63152,0,3,1829,1118,897,221,1111,7,2000,882,549,562,
14,"CONSTANTA",136,63152,,440,0,"SCOALA GENERALA-SAT SIBIOARA","LUMINA",42,63152,0,3,337,231,183,48,229,2,400,169,148,81,
14,"CONSTANTA",136,63152,,441,0,"GRADINITA VECHE-SAT OITUZ","LUMINA",42,63152,0,3,419,318,269,49,313,5,500,182,143,170,
14,"CONSTANTA",136,62137,,442,0,"SCOALA GENERALA-SAT MERENI","MERENI",43,62137,0,3,970,614,534,80,607,7,1100,486,349,258,
14,"CONSTANTA",136,62137,,443,0,"SCOALA GENERALA-SAT LANURILE","MERENI",43,62137,0,3,687,480,414,66,478,2,800,320,312,166,
14,"CONSTANTA",136,62137,,444,0,"SCOALA GENERALA-SAT BARAGANU","MERENI",43,62137,0,3,752,528,441,87,523,5,798,270,316,207,
14,"CONSTANTA",136,62137,,445,0,"SCOALA GENERALA-SAT OSMANCEA","MERENI",43,62137,0,3,448,263,216,47,253,10,500,237,158,95,
14,"CONSTANTA",136,62137,,446,0,"CAMINUL CULTURAL-SAT CIOBANITA","MERENI",43,62137,0,3,258,222,172,50,222,0,300,78,126,96,
14,"CONSTANTA",136,62253,,447,0,"SCOALA GENERALA-SAT M.VITEAZU","MIHAI VITEAZU",44,62253,0,3,1402,656,581,75,648,8,1500,844,387,261,
14,"CONSTANTA",136,62253,,448,0,"SCOALA GENERALA-SAT SINOIE","MIHAI VITEAZU",44,62253,0,3,879,493,388,105,479,14,1003,510,289,190,
14,"CONSTANTA",136,62191,,449,0,"SCOALA GENERALA NR 3-SAT M.KOGALNICEANU","MIHAIL KOGALNICEANU",45,62191,0,3,1101,573,339,234,567,6,1200,627,357,210,
14,"CONSTANTA",136,62191,,450,0,"GRADINITA NR 3-SAT M.KOGALNICEANU","MIHAIL KOGALNICEANU",45,62191,0,3,832,491,231,260,488,3,900,409,293,195,
14,"CONSTANTA",136,62191,,451,0,"SCOALA GENERALA NR 2-SAT M.KOGALNICEANU","MIHAIL KOGALNICEANU",45,62191,0,3,1214,568,331,237,563,5,1300,732,338,225,
14,"CONSTANTA",136,62191,,452,0,"LICEUL TEORETIC(SALA 1)-SAT M.KOGALNICEANU","MIHAIL KOGALNICEANU",45,62191,0,3,932,556,285,271,550,6,1000,444,331,219,
14,"CONSTANTA",136,62191,,453,0,"SEDIUL S.P.G.C.L-SAT M.KOGALNICEANU","MIHAIL KOGALNICEANU",45,62191,0,3,592,368,186,182,362,6,600,232,179,183,
14,"CONSTANTA",136,62191,,454,0,"CASA ARMATEI I-SAT M.KOGALNICEANU","MIHAIL KOGALNICEANU",45,62191,0,3,860,559,343,216,553,6,900,341,307,246,
14,"CONSTANTA",136,62191,,455,0,"INTERNAT SCOLAR(FOST)-SAT M.KOGALNICEANU","MIHAIL KOGALNICEANU",45,62191,0,3,246,299,86,213,296,3,306,7,157,139,
14,"CONSTANTA",136,62191,,456,0,"I.A.S 'CERES'-SAT M.KOGALNICEANU","MIHAIL KOGALNICEANU",45,62191,0,3,568,253,146,107,248,5,600,347,163,85,
14,"CONSTANTA",136,62191,,457,0,"U.A.SIBIOARA","MIHAIL KOGALNICEANU",45,62191,0,3,229,226,122,104,225,1,302,76,150,75,
14,"CONSTANTA",136,62191,,458,0,"CASA AGRONOMULUI-SAT PIATRA","MIHAIL KOGALNICEANU",45,62191,0,3,562,437,326,111,431,6,700,263,241,190,
14,"CONSTANTA",136,62191,,459,0,"SCOALA GENERALA-SAT PALAZU MIC","MIHAIL KOGALNICEANU",45,62191,0,3,260,150,108,42,146,4,302,152,55,91,
14,"CONSTANTA",136,62191,,460,1,"CASA ARMATEI II-UM01295","MIHAIL KOGALNICEANU",45,62191,0,3,0,85,0,85,82,3,200,115,33,49,
14,"CONSTANTA",136,62191,,461,1,"CASA ARMATEI III-UM01909J","MIHAIL KOGALNICEANU",45,62191,0,3,0,94,0,94,91,3,100,6,45,46,
14,"CONSTANTA",136,62191,,462,1,"CASA ARMATEI IV-UM JANDARMI","MIHAIL KOGALNICEANU",45,62191,0,3,0,28,0,28,27,1,102,74,15,12,
14,"CONSTANTA",136,62280,,463,0,"SCOALA GENERALA-SAT MIRCEA VODA","MIRCEA VODA",46,62280,0,3,1359,705,584,121,698,7,1500,795,490,208,
14,"CONSTANTA",136,62280,,464,0,"SCOALA GENERALA-SAT SATU NOU","MIRCEA VODA",46,62280,0,3,1581,1200,945,255,1185,15,1700,500,719,466,
14,"CONSTANTA",136,62280,,465,0,"SCOALA GENERALA-SAT FACLIA","MIRCEA VODA",46,62280,0,3,515,466,287,179,464,2,600,134,277,187,
14,"CONSTANTA",136,62280,,466,0,"SCOALA GENERALA-SAT SALIGNY","MIRCEA VODA",46,62280,0,3,748,341,247,94,338,3,796,455,179,159,
14,"CONSTANTA",136,62280,,467,0,"SCOALA GENERALA-SAT STEFAN CEL MARE","MIRCEA VODA",46,62280,0,3,225,279,134,145,279,0,300,21,157,122,
14,"CONSTANTA",136,62280,,468,0,"SCOALA GENERALA-SAT TIBRINU","MIRCEA VODA",46,62280,0,3,76,95,51,44,94,1,100,5,52,42,
14,"CONSTANTA",136,62440,,469,0,"SCOALA GENERALA-SAT NICOLAE BALCESCU","NICOLAE BALCESCU",47,62440,0,3,1285,680,568,112,674,6,1400,720,374,300,
14,"CONSTANTA",136,62440,,470,0,"SCOALA GENERALA-SAT NICOLAE BALCESCU","NICOLAE BALCESCU",47,62440,0,3,1398,736,618,118,730,6,1500,764,407,323,
14,"CONSTANTA",136,62440,,471,0,"SCOALA GENERALA-SAT DOROBANTU","NICOLAE BALCESCU",47,62440,0,3,1143,767,515,252,760,7,1300,533,440,320,
14,"CONSTANTA",136,62486,,472,0,"SCOALA GENERALA-SAT OLTINA","OLTINA",48,62486,0,3,1705,991,897,94,975,16,1902,911,632,343,
14,"CONSTANTA",136,62486,,473,0,"SCOALA GENERALA-SAT RAZOARELE","OLTINA",48,62486,0,3,483,416,323,93,414,2,502,86,239,175,
14,"CONSTANTA",136,62486,,474,0,"ASOCIATIA AGRICOLA MIORITA-SAT SATU NOU","OLTINA",48,62486,0,3,233,214,141,73,211,3,302,88,162,49,
14,"CONSTANTA",136,62538,,475,0,"LICEUL-SAT OSTROV","OSTROV",49,62538,0,3,2288,1309,1073,236,1289,20,2500,1191,900,389,
14,"CONSTANTA",136,62538,,476,0,"SCOALA GENERALA-SAT ALMALAU","OSTROV",49,62538,0,3,725,575,438,137,573,2,800,225,443,130,
14,"CONSTANTA",136,62538,,477,0,"SCOALA GENERALA-SAT BUGEAC","OSTROV",49,62538,0,3,163,167,110,57,167,0,202,35,121,46,
14,"CONSTANTA",136,62538,,478,0,"SCOALA GENERALA-SAT GALITA","OSTROV",49,62538,0,3,407,369,289,80,363,6,500,131,282,81,
14,"CONSTANTA",136,62538,,479,0,"SCOALA GENERALA-SAT GARLITA","OSTROV",49,62538,0,3,288,174,132,42,174,0,300,126,118,56,
14,"CONSTANTA",136,62538,,480,0,"SCOALA GENERALA-SAT ESECHIOI","OSTROV",49,62538,0,3,265,197,160,37,196,1,301,104,161,35,
14,"CONSTANTA",136,62609,,481,0,"SCOALA GENERALA-SAT. PANTELIMON DE SUS","PANTELIMON",50,62609,0,3,653,425,365,60,419,6,700,275,291,128,
14,"CONSTANTA",136,62609,,482,0,"SCOALA PRIMARA-SAT. PANTELIMON DE JOS","PANTELIMON",50,62609,0,3,125,137,65,72,137,0,200,63,103,34,
14,"CONSTANTA",136,62609,,483,0,"SCOALA PRIMARA-SAT. RUNCU","PANTELIMON",50,62609,0,3,298,230,181,49,225,5,300,70,177,48,
14,"CONSTANTA",136,62609,,484,0,"SCOALA PRIMARA-SAT. NISTORESTI","PANTELIMON",50,62609,0,3,270,153,122,31,151,2,300,147,105,46,
14,"CONSTANTA",136,62672,,485,0,"SCOALA GENERALA-SAT PECINEAGA","PECINEAGA",51,62672,0,3,2138,1290,1099,191,1276,14,2300,1010,658,618,
14,"CONSTANTA",136,62707,,486,0,"CAMINUL CULTURAL-SAT PESTERA","PESTERA",52,62707,0,3,1354,821,729,92,815,6,1500,679,547,268,
14,"CONSTANTA",136,62707,,487,0,"CAMINUL CULTURAL-SAT IVRINEZU MARE","PESTERA",52,62707,0,3,710,534,434,100,526,8,800,266,392,134,
14,"CONSTANTA",136,62707,,488,0,"SCOALA GENERALA-SAT IZVORU MARE","PESTERA",52,62707,0,3,496,344,285,59,337,7,500,156,192,145,
14,"CONSTANTA",136,62761,,489,0,"SCOALA GENERALA NR 1-SAT. POARTA ALBA","POARTA ALBA",53,62761,0,3,2013,1214,1027,187,1197,17,2000,786,508,689,
14,"CONSTANTA",136,62761,,490,0,"GRUP SCOLAR AGRICOL-SAT. POARTA ALBA NORD","POARTA ALBA",53,62761,0,3,970,1007,316,691,995,12,1303,296,646,349,
14,"CONSTANTA",136,62761,,491,0,"SCOALA PRIMARA-SAT.NAZARCEA","POARTA ALBA",53,62761,0,3,318,173,133,40,171,2,400,227,92,79,
14,"CONSTANTA",136,62798,,492,0,"SCOALA GENERALA NR 2-SAT RASOVA","RASOVA",54,62798,0,3,2025,1086,972,114,1060,26,2200,1114,691,369,
14,"CONSTANTA",136,62798,,493,0,"SCOALA GENERALA-SAT COCHIRLENI","RASOVA",54,62798,0,3,922,624,522,102,618,6,1002,378,384,234,
14,"CONSTANTA",136,62823,,494,0,"SCOALA GENERALA-SAT. SARAIU","SARAIU",56,62823,0,3,721,436,392,44,427,9,800,364,271,156,
14,"CONSTANTA",136,62823,,495,0,"SCOALA GENERALA-SAT. DULGHERU","SARAIU",56,62823,0,3,446,291,260,31,283,8,500,209,174,109,
14,"CONSTANTA",136,62878,,496,0,"SCOALA GENERALA-SAT SACELE","SACELE",55,62878,0,3,1568,1043,903,140,1033,10,1700,657,521,512,
14,"CONSTANTA",136,62903,,497,0,"SCOALA GENERALA-SAT SEIMENI","SEIMENI",57,62903,0,3,474,260,197,63,256,4,500,240,128,128,
14,"CONSTANTA",136,62903,,498,0,"SCOALA GENERALA-SAT SEIMENII MICI","SEIMENI",57,62903,0,3,582,390,319,71,387,3,596,206,187,200,
14,"CONSTANTA",136,62903,,499,0,"SCOALA GENERALA-SAT DUNAREA","SEIMENI",57,62903,0,3,569,407,330,77,405,2,600,193,218,187,
14,"CONSTANTA",136,62949,,500,0,"SCOALA GENERALA-SAT SILISTEA","SILISTEA",58,62949,0,3,551,400,328,72,396,4,600,200,284,112,
14,"CONSTANTA",136,62949,,501,0,"SCOALA GENERALA-SAT TEPES VODA","SILISTEA",58,62949,0,3,588,400,345,55,396,4,600,200,310,86,
14,"CONSTANTA",136,62985,,502,0,"SEDIU FOST CAP-SAT TIRGUSOR","TARGUSOR",59,62985,0,3,1111,758,626,132,749,9,1200,442,424,325,
14,"CONSTANTA",136,62985,,503,0,"SCOALA PRIMARA-SAT MIREASA","TARGUSOR",59,62985,0,3,258,211,179,32,209,2,300,89,145,64,
14,"CONSTANTA",136,62985,,504,0,"CAMINUL CULTURAL-SAT CHEIA","TARGUSOR",59,62985,0,3,260,199,144,55,196,3,295,96,99,97,
14,"CONSTANTA",136,62985,,505,0,"SCOALA GENERALA-SAT GRADINA","TARGUSOR",59,62985,0,3,672,443,372,71,439,4,700,257,256,183,
14,"CONSTANTA",136,63045,,506,0,"GRADINITA-SAT. TOPALU","TOPALU",60,63045,0,3,1538,925,830,95,913,12,1700,775,708,205,
14,"CONSTANTA",136,63072,,507,0,"SCOALA NOUA-SAT TOPRAISAR","TOPRAISAR",61,63072,0,3,1194,753,673,80,742,11,1300,547,453,289,
14,"CONSTANTA",136,63072,,508,0,"SCOALA VECHE-SAT TOPRAISAR","TOPRAISAR",61,63072,0,3,1269,793,672,121,785,8,1400,607,474,311,
14,"CONSTANTA",136,63072,,509,1,"CASA ARMATEI(UM 01239)-SAT TOPRAISAR","TOPRAISAR",61,63072,0,3,0,244,0,244,235,9,300,56,117,118,
14,"CONSTANTA",136,63072,,510,0,"SCOALA GENERALA-SAT BIRUINTA","TOPRAISAR",61,63072,0,3,500,409,342,67,407,2,600,191,276,131,
14,"CONSTANTA",136,63072,,511,0,"SCOALA GENERALA-SAT MOVILITA","TOPRAISAR",61,63072,0,3,570,438,303,135,412,26,600,162,241,171,
14,"CONSTANTA",136,63072,,512,0,"SCOALA PRIMARA-SAT POTIRNICHEA","TOPRAISAR",61,63072,0,3,271,230,149,81,228,2,300,70,143,85,
14,"CONSTANTA",136,63189,,513,0,"SEDIU FOST CAP-SAT TORTOMANU","TORTOMANU",62,63189,0,3,1282,906,795,111,895,11,1400,494,483,412,
14,"CONSTANTA",136,60721,,514,0,"CAMINUL CULTURAL-SAT TUZLA","TUZLA",63,60721,0,3,1459,803,618,185,793,10,1600,797,418,375,
14,"CONSTANTA",136,60721,,515,0,"SCOALA VECHE-SAT TUZLA","TUZLA",63,60721,0,3,1611,1098,824,274,1086,12,1800,702,562,524,
14,"CONSTANTA",136,60721,,516,0,"SCOALA CU CLASELE I-IV-SAT TUZLA","TUZLA",63,60721,0,3,1498,882,716,166,874,8,1600,718,456,418,
14,"CONSTANTA",136,63125,,517,0,"SCOALA GENERALA NR 1-SAT. VALU LUI TRAIAN","VALU LUI TRAIAN",64,63125,0,3,2570,1527,1321,206,1512,15,2800,1273,885,627,
14,"CONSTANTA",136,63125,,518,0,"LOCAL COMPLEX COOPERATIE-SAT. VALU LUI TRAIAN","VALU LUI TRAIAN",64,63125,0,3,1967,1153,1010,143,1147,6,2202,1049,650,497,
14,"CONSTANTA",136,63125,,519,0,"SCOALA GENERALA NR 2-SAT. VALU LUI TRAIAN","VALU LUI TRAIAN",64,63125,0,3,1484,1107,960,147,1099,8,1600,493,583,516,
14,"CONSTANTA",136,63170,,520,0,"CAMINUL CULTURAL-SAT. VULTURU","VULTURU",65,63170,0,3,554,340,305,35,335,5,600,260,185,150,
14,"CONSTANTA",136,60598,,521,0,"SCOALA GENERALA-SAT 23 AUGUST","23 AUGUST",12,60598,0,3,2432,1256,1093,163,1245,11,2700,1444,700,545,
14,"CONSTANTA",136,60598,,522,0,"SCOALA GENERALA-SAT DULCESTI","23 AUGUST",12,60598,0,3,739,705,423,282,698,7,800,95,376,322,
14,"CONSTANTA",136,60598,,523,0,"GRADINITA-SAT MOSNENI","23 AUGUST",12,60598,0,3,786,578,399,179,570,8,900,322,335,235,
15,"COVASNA",145,63394,,1,0,"CASA DE CULTURA A SINDICATELOR, Pta. Mihai Viteazul nr.1","MUNICIPIUL SFANTU GHEORGHE",1,63394,1,1,2100,945,900,45,914,31,2400,1455,859,55,
15,"COVASNA",145,63394,,2,0,"GRUP SCOLAR INDUSTRIAL TEXTIL, Str. Gabor Aron nr. 18","MUNICIPIUL SFANTU GHEORGHE",1,63394,1,1,887,472,402,70,462,10,1000,528,440,22,
15,"COVASNA",145,63394,,3,0,"LICEUL TEORETIC SZEKELY MIKO, Str. Miko Imre nr. 1","MUNICIPIUL SFANTU GHEORGHE",1,63394,1,1,1798,884,730,154,864,20,1950,1066,788,76,
15,"COVASNA",145,63394,,4,0,"GRUP SCOLAR ECONOMIC ADMINISTRATIV, Str. Crangului nr. 30","MUNICIPIUL SFANTU GHEORGHE",1,63394,1,1,2295,966,932,34,955,11,2550,1584,848,107,
15,"COVASNA",145,63394,,5,0,"LICEUL TEORETIC MIKES KELEMEN, Str. Koos Karoly nr. 5/A","MUNICIPIUL SFANTU GHEORGHE",1,63394,1,1,786,349,322,27,340,9,900,551,300,40,
15,"COVASNA",145,63394,,6,0,"GRUP SCOLAR ECONOMIC ADMINISTRATIV, Str. Crangului nr. 30","MUNICIPIUL SFANTU GHEORGHE",1,63394,1,1,764,397,368,29,391,6,900,503,353,38,
15,"COVASNA",145,63394,,7,0,"SCOALA GENERALA NR. 4 SIMERIA, Str. Kos Karoly nr. 78","MUNICIPIUL SFANTU GHEORGHE",1,63394,1,1,1208,587,545,42,577,10,1340,753,566,11,
15,"COVASNA",145,63394,,8,0,"LICEUL TEORETIC MIHAI VITEAZUL, Str. Kos Karoly nr. 22","MUNICIPIUL SFANTU GHEORGHE",1,63394,1,1,1275,567,542,25,561,6,1450,883,533,28,
15,"COVASNA",145,63394,,9,0,"LICEUL TEORETIC MIHAI VITEAZUL, Str. Kos Karoly nr. 22","MUNICIPIUL SFANTU GHEORGHE",1,63394,1,1,1906,874,821,53,857,17,2150,1276,786,71,
15,"COVASNA",145,63394,,10,0,"GRADINITA DE COPII GULUIVER, Str. Dealului nr. 24","MUNICIPIUL SFANTU GHEORGHE",1,63394,1,1,2280,1030,979,51,1009,21,2540,1510,955,54,
15,"COVASNA",145,63394,,11,0,"GRADINITA DE COPII GULUIVER, Str. Dealului nr. 24","MUNICIPIUL SFANTU GHEORGHE",1,63394,1,1,1506,739,695,44,731,8,1700,961,688,43,
15,"COVASNA",145,63394,,12,0,"COMPLEX SPORTIV, Str Stadionului nr. 12","MUNICIPIUL SFANTU GHEORGHE",1,63394,1,1,1239,591,564,27,574,17,1400,809,534,40,
15,"COVASNA",145,63394,,13,0,"GRADINITA DE COPII ALBA CA ZAPADA, Aleea Tineretului nr. 2","MUNICIPIUL SFANTU GHEORGHE",1,63394,1,1,796,380,361,19,376,4,900,520,356,20,
15,"COVASNA",145,63394,,14,0,"SCOALA GENERALA NR. 2 VARADI JOZSEF, Str. Benedek Elek nr. 20","MUNICIPIUL SFANTU GHEORGHE",1,63394,1,1,1888,797,756,41,786,11,2100,1303,731,55,
15,"COVASNA",145,63394,,15,0,"SCOALA GENERALA NR. 1, Str. Kossuth Lajos nr. 15","MUNICIPIUL SFANTU GHEORGHE",1,63394,1,1,770,336,296,40,327,9,900,564,301,26,
15,"COVASNA",145,63394,,16,0,"LICEUL DE ARTA, Str. Kossuth Lajos nr. 15","MUNICIPIUL SFANTU GHEORGHE",1,63394,1,1,811,488,414,74,474,14,950,462,457,17,
15,"COVASNA",145,63394,,17,0,"SCOALA AJUTATOARE, Piata Kalvin nr. 3","MUNICIPIUL SFANTU GHEORGHE",1,63394,1,1,654,315,298,17,304,11,750,435,294,10,
15,"COVASNA",145,63394,,18,0,"GRADINITA DE COPII CVARTAL CIUCULUI, Str. Romulus Cioflec nr. 14","MUNICIPIUL SFANTU GHEORGHE",1,63394,1,1,2097,943,882,61,917,26,2362,1419,790,127,
15,"COVASNA",145,63394,,19,0,"SCOALA GENERALA GODRI FERENC, Str. Elevilor nr.1","MUNICIPIUL SFANTU GHEORGHE",1,63394,1,1,2196,983,901,82,952,31,2450,1467,841,111,
15,"COVASNA",145,63394,,20,0,"GRUP SCOLAR AGRICOL, Str. Ciucului nr. 50","MUNICIPIUL SFANTU GHEORGHE",1,63394,1,1,1174,567,543,24,563,4,1350,783,549,14,
15,"COVASNA",145,63394,,21,0,"SEDIUL SINDICATELOR, B-dul Grigore Balan nr. 1","MUNICIPIUL SFANTU GHEORGHE",1,63394,1,1,1731,766,722,44,754,12,1950,1184,667,87,
15,"COVASNA",145,63394,,22,0,"S.C. SUGAS SA, Str. N. Iorga nr. 20, bl. 34/C/b","MUNICIPIUL SFANTU GHEORGHE",1,63394,1,1,1968,861,832,29,850,11,2200,1339,731,119,
15,"COVASNA",145,63394,,23,0,"GRADINITA DE COPII BENEDEK ELEK, Str. Oltului nr. 36-38","MUNICIPIUL SFANTU GHEORGHE",1,63394,1,1,1760,830,783,47,809,21,1950,1120,739,70,
15,"COVASNA",145,63394,,24,0,"SC TRANSILCOM SRL, Str. 1 Decembrie 1918","MUNICIPIUL SFANTU GHEORGHE",1,63394,1,1,1320,601,540,61,593,8,1550,949,516,77,
15,"COVASNA",145,63394,,25,0,"GRP SCOLAR PUSKAS TIVADAR, Str. Pescarilor nr. 35","MUNICIPIUL SFANTU GHEORGHE",1,63394,1,1,1982,953,916,37,940,13,2300,1347,786,154,
15,"COVASNA",145,63394,,26,0,"GRP SCOLAR PUSKAS TIVADAR, Str. Pescarilor nr. 35","MUNICIPIUL SFANTU GHEORGHE",1,63394,1,1,626,376,289,87,368,8,762,386,279,89,
15,"COVASNA",145,63394,,27,0,"GRADINITA DE COPII, Str. Daliei nr. 12","MUNICIPIUL SFANTU GHEORGHE",1,63394,1,1,1784,787,760,27,775,12,1995,1208,670,105,
15,"COVASNA",145,63394,,28,0,"SCOALA GENERALA NICOLAE COLAN, Str. Lalelei nr. 1","MUNICIPIUL SFANTU GHEORGHE",1,63394,1,1,2462,1080,1034,46,1068,12,2750,1670,890,178,
15,"COVASNA",145,63394,,29,0,"SCOALA GENERALA NICOLAE COLAN, Str. Lalelei nr. 1","MUNICIPIUL SFANTU GHEORGHE",1,63394,1,1,2535,942,901,41,931,11,2850,1908,812,119,
15,"COVASNA",145,63394,,30,0,"STRAND MUNICIPAL, Str. Sporturilor","MUNICIPIUL SFANTU GHEORGHE",1,63394,1,1,2633,1048,968,80,1031,17,2950,1902,893,138,
15,"COVASNA",145,63394,,31,0,"SCOALA GENERALA NR 6, Str. Armata Romana nr. 25","MUNICIPIUL SFANTU GHEORGHE",1,63394,1,1,1841,783,739,44,768,15,2050,1267,609,159,
15,"COVASNA",145,63394,,32,0,"SCOALA GENERALA NR 6, Str. Armata Romana nr. 25","MUNICIPIUL SFANTU GHEORGHE",1,63394,1,1,1611,762,615,147,744,18,1800,1038,633,111,
15,"COVASNA",145,63394,,33,0,"GRADINITA DE COPII NR 25, Str. Armata Romana nr. 25","MUNICIPIUL SFANTU GHEORGHE",1,63394,1,1,2458,1005,958,47,987,18,2750,1745,807,180,
15,"COVASNA",145,63394,,34,0,"CAMINUL CULTURAL, Sat Chilieni","MUNICIPIUL SFANTU GHEORGHE",1,63394,1,1,484,282,271,11,270,12,600,318,260,10,
15,"COVASNA",145,63394,,35,0,"CAMINUL CULTURAL, Sat Coseni","MUNICIPIUL SFANTU GHEORGHE",1,63394,1,1,379,178,157,21,175,3,450,272,160,15,
15,"COVASNA",145,63394,,36,1,"UNITATEA MILITARA, Str. Armata Romana nr. 33","MUNICIPIUL SFANTU GHEORGHE",1,63394,1,1,0,284,0,284,271,13,300,16,179,92,
15,"COVASNA",145,63394,,37,1,"SITALUL JUDETEAN, Str. Stadionului nr. 1-3","MUNICIPIUL SFANTU GHEORGHE",1,63394,1,1,0,322,0,322,315,7,600,278,283,32,
15,"COVASNA",145,63447,,38,0,"CONSILIUL LOCAL","ORAS BARAOLT",3,63447,2,1,1541,815,697,118,807,8,1750,935,762,45,
15,"COVASNA",145,63447,,39,0,"CASA DE CULTURA","ORAS BARAOLT",3,63447,2,1,1783,880,788,92,869,11,2000,1120,847,22,
15,"COVASNA",145,63447,,40,0,"GRADINITA DE COPII","ORAS BARAOLT",3,63447,2,1,1454,716,662,54,713,3,1650,934,701,12,
15,"COVASNA",145,63447,,41,0,"CAMINUL CULTURAL Sat Biborteni","ORAS BARAOLT",3,63447,2,1,637,434,410,24,432,2,750,316,417,15,
15,"COVASNA",145,63447,,42,0,"CAMINUL CULTURAL Sat Bodos","ORAS BARAOLT",3,63447,2,1,336,220,209,11,217,3,400,180,213,4,
15,"COVASNA",145,63447,,43,0,"CAMINUL CULTURAL Sat Capeni","ORAS BARAOLT",3,63447,2,1,916,635,562,73,613,22,1050,415,594,19,
15,"COVASNA",145,63447,,44,0,"CAMINUL CULTURAL Sat Miclosoara","ORAS BARAOLT",3,63447,2,1,403,325,295,30,316,9,500,175,301,15,
15,"COVASNA",145,63447,,45,0,"CAMINUL CULTURAL Sat Racosul de Sus","ORAS BARAOLT",3,63447,2,1,729,470,435,35,457,13,850,380,450,7,
15,"COVASNA",145,63526,,46,0,"SCOALA GENERALA NR 3, Str Gabor Aron nr. 1/A","ORAS COVASNA",4,63526,2,1,1615,765,701,64,746,19,1785,1020,690,56,
15,"COVASNA",145,63526,,47,0,"CLUBUL ORASENESC, Str. 1 Decembrie 1918 nr. 1","ORAS COVASNA",4,63526,2,1,1464,689,620,69,670,19,1650,961,615,55,
15,"COVASNA",145,63526,,48,0,"GRUPUL SCOLAR KOROSI CSOMA SANDOR, Str. Stefan cel Mare nr 40","ORAS COVASNA",4,63526,2,1,1644,619,593,26,606,13,1850,1231,555,51,
15,"COVASNA",145,63526,,49,0,"INTERNATUL GRUPULUI SCOLAR KOROSI CSOMA SANDOR, Str. Stefan cel Mare nr 40","ORAS COVASNA",4,63526,2,1,1588,816,703,113,806,10,1800,984,718,88,
15,"COVASNA",145,63526,,50,0,"SCOALA GENERALA AVRAM IANCU, Piata Eroilor nr. 11","ORAS COVASNA",4,63526,2,1,1589,700,663,37,685,15,1800,1100,584,101,
15,"COVASNA",145,63526,,51,0,"SCOALA GENERALA AVRAM IANCU, Str. Mihai Eminescu nr. 15","ORAS COVASNA",4,63526,2,1,1592,841,802,39,833,8,1800,959,430,403,
15,"COVASNA",145,63526,,52,1,"HOTEL MONTANA","ORAS COVASNA",4,63526,2,1,0,236,0,236,232,4,400,164,168,64,
15,"COVASNA",145,63526,,53,1,"HOTEL CERBUL","ORAS COVASNA",4,63526,2,1,0,192,0,192,187,5,398,206,111,76,
15,"COVASNA",145,63526,,54,1,"HOTEL DACIA","ORAS COVASNA",4,63526,2,1,0,314,0,314,304,10,786,472,197,107,
15,"COVASNA",145,63526,,55,1,"SPITALUL DE CARDIOLOGIE","ORAS COVASNA",4,63526,2,1,0,403,0,403,400,3,700,297,252,148,
15,"COVASNA",145,63580,,56,0,"SCOALA GENERALA NR 1, Str.Mihai Viteazul nr.188","ORAS INTORSURA BUZAULUI",5,63580,2,1,1759,927,843,84,916,11,2009,1082,561,355,
15,"COVASNA",145,63580,,57,0,"CASA DE CULTURA ,Str. Mihai Viteazul nr.169","ORAS INTORSURA BUZAULUI",5,63580,2,1,1536,782,696,86,774,8,1784,1002,518,256,
15,"COVASNA",145,63580,,58,0,"DISTRICTUL DRUMURI NATIONALE Str.Mihai Viteazul nr.223","ORAS INTORSURA BUZAULUI",5,63580,2,1,1581,928,873,55,918,10,1900,972,622,296,
15,"COVASNA",145,63580,,59,0,"CAMINUL CULTURAL , Sat Bradet","ORAS INTORSURA BUZAULUI",5,63580,2,1,876,512,459,53,505,7,984,472,305,200,
15,"COVASNA",145,63580,,60,0,"CAMINUL CULTURAL , Sat Floroaia","ORAS INTORSURA BUZAULUI",5,63580,2,1,1041,560,541,19,556,4,1199,639,352,204,
15,"COVASNA",145,63740,,61,0,"CASA ORASENEASCA DE CULTURA ""VIGADO"", Piata Gabor Aron nr. 21","MUNICIPIUL TIRGU SECUIESC",2,63740,1,1,1329,748,683,65,732,16,1500,752,711,21,
15,"COVASNA",145,63740,,62,0,"LICEUL ""NAGY MOZES"", Str. Kanta  nr.23","MUNICIPIUL TIRGU SECUIESC",2,63740,1,1,1016,495,459,36,482,13,1150,655,463,19,
15,"COVASNA",145,63740,,63,0,"LICEUL ""BOD PETER"", Str. Ady Endre nr.20","MUNICIPIUL TIRGU SECUIESC",2,63740,1,1,1643,837,720,117,821,16,1850,1013,791,30,
15,"COVASNA",145,63740,,64,0,"SCOALA GENERALA ""PETOFI SANDOR"", Str. Ady Endre nr. 9","MUNICIPIUL TIRGU SECUIESC",2,63740,1,1,1717,731,704,27,724,7,1950,1219,703,21,
15,"COVASNA",145,63740,,65,0,"GRADINITA CU PROGRAM NORMAL ""BENEDEK ELEK"", str. Dozsa Gyorgy nr. 8","MUNICIPIUL TIRGU SECUIESC",2,63740,1,1,1589,760,680,80,746,14,1800,1040,680,66,
15,"COVASNA",145,63740,,66,0,"GRADINITA DE COPII ""CSIPKEROZSIKA"", Str. Rozelor nr. 4","MUNICIPIUL TIRGU SECUIESC",2,63740,1,1,1644,770,738,32,764,6,1850,1080,735,29,
15,"COVASNA",145,63740,,67,0,"SCOALA GENERALA ""TUROCZI MOZES"", Str. Noua nr. 1","MUNICIPIUL TIRGU SECUIESC",2,63740,1,1,1317,628,587,41,620,8,1500,872,594,26,
15,"COVASNA",145,63740,,68,0,"GRADINITA DE COPII ""MANOCSKA"", Str. Gradinitei nr. 1","MUNICIPIUL TIRGU SECUIESC",2,63740,1,1,1910,833,790,43,819,14,2150,1317,792,27,
15,"COVASNA",145,63740,,69,0,"GRUPUL SCOLAR ""GABOR ARON"", Str. Fabricii nr. 8","MUNICIPIUL TIRGU SECUIESC",2,63740,1,1,1459,822,695,127,804,18,1850,1028,750,54,
15,"COVASNA",145,63740,,70,0,"AUTOGARA STR. Garii nr.52","MUNICIPIUL TIRGU SECUIESC",2,63740,1,1,1428,730,693,37,722,8,1600,870,710,12,
15,"COVASNA",145,63740,,71,0,"SCOALA PRIMARA ( RUSENI ) Str. Bem nr. 83","MUNICIPIUL TIRGU SECUIESC",2,63740,1,1,429,229,216,13,225,4,500,271,222,3,
15,"COVASNA",145,63740,,72,0,"SCOALA GENERALA LUNGA Sat Lunga nr. 360","MUNICIPIUL TIRGU SECUIESC",2,63740,1,1,1065,541,502,39,532,9,1200,659,526,6,
15,"COVASNA",145,63740,,73,0,"CAMINUL CULTURAL ( Tinoasa ) Sat Lunga nr. 657","MUNICIPIUL TIRGU SECUIESC",2,63740,1,1,189,210,121,89,209,1,300,90,204,5,
15,"COVASNA",145,63740,,74,1,"SPITALUL TIRGU SECUIESC STR. Garii nr. 23","MUNICIPIUL TIRGU SECUIESC",2,63740,1,1,0,145,0,145,143,2,500,355,138,5,
15,"COVASNA",145,63777,,75,0,"PRIMARIA Sat Aita Mare","AITA MARE",6,63777,0,3,710,486,423,63,473,13,843,357,447,26,
15,"COVASNA",145,63777,,76,0,"CAMINUL CULTURAL  Sat Aita Medie","AITA MARE",6,63777,0,3,617,442,376,66,427,15,700,258,391,36,
15,"COVASNA",145,63633,,77,0,"CAMINUL CULTURAL  Sat Barcani","BARCANI",7,63633,0,3,1850,976,901,75,969,7,2100,1124,656,313,
15,"COVASNA",145,63633,,78,0,"SCOALA GENERALA Sat Ladauti","BARCANI",7,63633,0,3,473,368,295,73,366,2,554,186,286,80,
15,"COVASNA",145,63633,,79,0,"SCOALA GENERALA Sat SARAMAS","BARCANI",7,63633,0,3,501,396,286,110,395,1,593,197,266,129,
15,"COVASNA",145,63802,,80,0,"PRIMARIA Sat Batanii Mari","BATANI",8,63802,0,3,1471,856,773,83,823,33,1650,794,781,42,
15,"COVASNA",145,63802,,81,0,"CLADIREA DE DEPLASARE A PRIMARIEI Sat Aita Seaca","BATANI",8,63802,0,3,681,446,416,30,438,8,800,354,434,4,
15,"COVASNA",145,63802,,82,0,"CAMINUL CULTURAL Sat Batanii Mici","BATANI",8,63802,0,3,398,289,243,46,271,18,500,211,271,0,
15,"COVASNA",145,63802,,83,0,"CLADIREA DE DEPLASARE A PRIMARIEI Sat Herculian","BATANI",8,63802,0,3,780,559,517,42,541,18,900,341,516,25,
15,"COVASNA",145,63866,,84,0,"PRIMARIA Sat Belin","BELIN",9,63866,0,3,1150,719,658,61,703,16,1300,581,631,72,
15,"COVASNA",145,63866,,85,0,"SCOALA GENERALA Sat Belin Vale","BELIN",9,63866,0,3,633,416,350,66,402,14,730,314,339,63,
15,"COVASNA",145,63893,,86,0,"CAMINUL CULTURAL Sat Bodoc","BODOC",10,63893,0,3,1365,914,839,75,892,22,1550,636,844,48,
15,"COVASNA",145,63893,,87,0,"CAMINUL CULTURAL Sat Zalan","BODOC",10,63893,0,3,473,356,233,123,351,5,570,214,306,45,
15,"COVASNA",145,63937,,88,0,"PRIMARIA Sat Borosneu Mare","BOROSNEU MARE",11,63937,0,3,1232,541,455,86,525,16,1400,859,480,45,
15,"COVASNA",145,63937,,89,0,"SCOALA GENERALA Sat Borosneu Mic","BOROSNEU MARE",11,63937,0,3,283,209,157,52,207,2,350,141,191,16,
15,"COVASNA",145,63937,,90,0,"CAMINUL CULTURAL Sat Dobolii de Sus","BOROSNEU MARE",11,63937,0,3,129,158,93,65,151,7,200,42,140,11,
15,"COVASNA",145,63937,,91,0,"SCOALA GENERALA Sat Let","BOROSNEU MARE",11,63937,0,3,407,250,184,66,243,7,500,250,234,9,
15,"COVASNA",145,64005,,92,0,"PRIMARIA Sat Brates","BRATES",13,64005,0,3,1259,686,632,54,668,18,1400,714,632,36,
15,"COVASNA",145,64041,,93,0,"CAMINUL CULTURAL Sat Bradut","BRADUT",12,64041,0,3,749,529,451,78,523,6,850,321,514,9,
15,"COVASNA",145,64041,,94,0,"CAMINUL CULTURAL Sat Talisoara","BRADUT",12,64041,0,3,605,473,437,36,464,9,700,227,455,9,
15,"COVASNA",145,64041,,95,0,"CAMINUL CULTURAL Sat  Doboseni","BRADUT",12,64041,0,3,1025,649,592,57,618,31,1150,501,580,38,
15,"COVASNA",145,64041,,96,0,"CAMINUL CULTURAL Sat Filia","BRADUT",12,64041,0,3,1004,695,650,45,685,10,1150,455,666,19,
15,"COVASNA",145,64096,,97,0,"CENTRUL  CULTURAL Sat Bretcu","BRETCU",14,64096,0,3,2225,1448,1361,87,1417,31,2500,1052,1247,170,
15,"COVASNA",145,64096,,98,0,"SCOALA GENERALA Sat Martanus","BRETCU",14,64096,0,3,619,472,412,60,464,8,700,228,349,115,
15,"COVASNA",145,64096,,99,0,"SCOALA GENERALA Sat Oituz","BRETCU",14,64096,0,3,280,174,140,34,169,5,349,175,145,24,
15,"COVASNA",145,64096,,100,1,"UNITATEA MILITARA Sat Bretcu","BRETCU",14,64096,0,3,0,112,0,112,112,0,129,17,77,35,
15,"COVASNA",145,64130,,101,0,"PRIMARIA Sat Catalina","CATALINA",15,64130,0,3,1365,754,718,36,729,25,1550,796,716,13,
15,"COVASNA",145,64130,,102,0,"SCOALA GENERALA Sat Martineni","CATALINA",15,64130,0,3,1303,751,699,52,734,17,1470,719,710,24,
15,"COVASNA",145,64194,,103,0,"CAMINUL CULTURAL Sat Cernat nr. 455","CERNAT",16,64194,0,3,1713,1255,1208,47,1236,19,1950,695,1210,26,
15,"COVASNA",145,64194,,104,0,"CAMINUL CULTURAL Sat Cernat nr. 816","CERNAT",16,64194,0,3,872,627,569,58,618,9,1000,373,596,22,
15,"COVASNA",145,64194,,105,0,"CAMINUL CULTURAL Sat Albis nr. 43","CERNAT",16,64194,0,3,335,261,245,16,258,3,400,139,250,8,
15,"COVASNA",145,64194,,106,0,"CAMINUL CULTURAL Sat Icafalau nr. 148","CERNAT",16,64194,0,3,223,201,188,13,198,3,300,99,198,0,
15,"COVASNA",145,64238,,107,0,"PRIMARIA Sat  Chichis","CHICHIS",17,64238,0,3,826,539,490,49,527,12,950,411,497,30,
15,"COVASNA",145,64238,,108,0,"GRADINITA DE COPII Sat Bacel","CHICHIS",17,64238,0,3,495,257,227,30,254,3,600,343,116,138,
15,"COVASNA",145,63553,,109,0,"PRIMARIA Sat Comandau","COMANDAU",18,63553,0,3,840,635,536,99,616,19,1000,365,551,65,
15,"COVASNA",145,64265,,110,0,"CAMINUL CULTURAL Sat Dobarlau","DOBARLAU",19,64265,0,3,1105,526,487,39,521,5,1245,719,239,282,
15,"COVASNA",145,64265,,111,0,"SCOALA GENERALA Sat Lunca Marcusului","DOBARLAU",19,64265,0,3,667,313,254,59,312,1,750,437,102,210,
15,"COVASNA",145,64318,,112,0,"SALA DE SPORT Sat Ghelinta","GHELINTA",20,64318,0,3,2094,1097,1045,52,1084,13,2350,1253,1040,44,
15,"COVASNA",145,64318,,113,0,"SCOALA GENERALA NR 1 Sat Ghelinta","GHELINTA",20,64318,0,3,1476,723,624,99,699,24,1650,927,642,57,
15,"COVASNA",145,64345,,114,0,"PRIMARIA Sat Ghidfalau","GHIDFALAU",21,64345,0,3,1401,553,529,24,537,16,1600,1047,506,31,
15,"COVASNA",145,64345,,115,0,"SCOALA GENERALA Sat Anghelus","GHIDFALAU",21,64345,0,3,508,275,244,31,260,15,600,325,252,8,
15,"COVASNA",145,64390,,116,0,"CAMINUL CULTURAL Sat Haghig","HAGHIG",22,64390,0,3,1148,702,549,153,679,23,1300,598,536,143,
15,"COVASNA",145,64390,,117,0,"SCOALA GENERALA Sat Iaras","HAGHIG",22,64390,0,3,366,219,187,32,219,0,500,281,132,87,
15,"COVASNA",145,64425,,118,0,"PRIMARIA Sat Ilieni","ILIENI",23,64425,0,3,1420,837,573,264,818,19,1600,763,781,37,
15,"COVASNA",145,64461,,119,0,"PRIMARIA Sat Lemnia","LEMNIA",24,64461,0,3,751,473,387,86,465,8,900,427,455,10,
15,"COVASNA",145,64461,,120,0,"CAMINUL NR 2 Sat Lemnia","LEMNIA",24,64461,0,3,880,647,590,57,637,10,1000,353,608,29,
15,"COVASNA",145,64461,,121,0,"CAMINUL CULTURAL Sat Mereni","LEMNIA",24,64461,0,3,1127,735,694,41,721,14,1300,565,713,8,
15,"COVASNA",145,64504,,122,0,"CAMINUL CULTURAL Sat Micfalau","MALNAS",25,64504,0,3,1489,756,709,47,750,6,1700,944,722,28,
15,"COVASNA",145,64504,,123,0,"CAMINUL CULTURAL Sat Bixad","MALNAS",25,64504,0,3,1377,788,676,112,765,23,1600,812,715,50,
15,"COVASNA",145,64504,,124,0,"DISPENSARUL MEDICAL Sat Malnas","MALNAS",25,64504,0,3,752,508,422,86,503,5,900,392,488,15,
15,"COVASNA",145,64504,,125,0,"CAMINUL CULTURAL Sat Valea Zalanului","MALNAS",25,64504,0,3,138,64,54,10,60,4,200,136,57,3,
15,"COVASNA",145,64568,,126,0,"PRIMARIA Sat Moacsa","MOACSA",26,64568,0,3,650,387,342,45,383,4,750,363,365,18,
15,"COVASNA",145,64568,,127,0,"CLADIREA DE DEPLASARE A PRIMARIEI Sat Dalnic","MOACSA",26,64568,0,3,734,427,356,71,415,12,850,423,389,26,
15,"COVASNA",145,64568,,128,0,"CAMINUL CULTURAL Sat Padureni","MOACSA",26,64568,0,3,224,184,144,40,184,0,300,116,180,4,
15,"COVASNA",145,64602,,129,0,"CAMINUL CULTURAL ZSOGON ZOLTAN Sat Ojdula","OJDULA",27,64602,0,3,1431,674,653,21,645,29,1600,926,624,21,
15,"COVASNA",145,64602,,130,0,"SCOALA GENERALA KUN KOCSARD Sat Ojdula","OJDULA",27,64602,0,3,1254,723,652,71,697,26,1450,727,673,24,
15,"COVASNA",145,64639,,131,0,"CAMINUL CULTURAL Sat Ozun","OZUN",28,64639,0,3,2177,1159,1081,78,1135,24,2450,1291,1052,83,
15,"COVASNA",145,64639,,132,0,"SCOALA GENERALA Sat Santionlunca","OZUN",28,64639,0,3,614,369,320,49,357,12,700,331,333,24,
15,"COVASNA",145,64639,,133,0,"CAMINUL CULTURAL Sat Lisnau","OZUN",28,64639,0,3,510,309,159,150,299,10,600,291,272,27,
15,"COVASNA",145,64639,,134,0,"CAMINUL CULTURAL Sat Bicfalau","OZUN",28,64639,0,3,305,271,224,47,266,5,360,89,256,10,
15,"COVASNA",145,64719,,135,0,"PRIMARIA Sat Poian","POIAN",29,64719,0,3,1400,1002,941,61,987,15,1600,598,962,25,
15,"COVASNA",145,64719,,136,0,"CASA DE CULTURA Sat Estelnic nr.167","POIAN",29,64719,0,3,856,659,611,48,652,7,1000,341,640,12,
15,"COVASNA",145,64773,,137,0,"CAMINUL CULTURAL Sat Reci","RECI",30,64773,0,3,1048,525,473,52,501,24,1200,675,473,28,
15,"COVASNA",145,64773,,138,0,"SCOALA GENERALA Sat Aninoasa","RECI",30,64773,0,3,662,382,345,37,374,8,750,368,353,21,
15,"COVASNA",145,64826,,139,0,"PRIMARIA Sat Sinzieni","SANZIENI",31,64826,0,3,1261,534,502,32,525,9,1450,916,505,20,
15,"COVASNA",145,64826,,140,0,"SALA DE SEDINTA A FORMATIEI POMPIERILOR CIVIL Sat Sinzieni","SANZIENI",31,64826,0,3,1179,460,437,23,444,16,1300,840,423,21,
15,"COVASNA",145,64826,,141,0,"CAMINUL CULTURAL Sat Petriceni","SANZIENI",31,64826,0,3,720,435,396,39,416,19,800,365,403,13,
15,"COVASNA",145,64826,,142,0,"CAMINUL CULTURAL Sat Valea Seaca","SANZIENI",31,64826,0,3,512,306,283,23,305,1,600,294,304,1,
15,"COVASNA",145,63688,,143,0,"PRIMARIA Sat Sita Buzaului","SITA BUZAULUI",32,63688,0,3,1151,660,612,48,650,10,1800,1140,436,214,
15,"COVASNA",145,63688,,144,0,"SCOALA GENERALA Sat Sita Buzaului (Ciumernic)","SITA BUZAULUI",32,63688,0,3,858,383,332,51,383,0,500,117,265,118,
15,"COVASNA",145,63688,,145,0,"SCOALA GENERALA Sat Sita Buzaului (Bobocea)","SITA BUZAULUI",32,63688,0,3,684,523,418,105,521,2,800,277,381,140,
15,"COVASNA",145,63688,,146,0,"SCOALA GENERALA Sat Zabratau","SITA BUZAULUI",32,63688,0,3,867,533,481,52,529,4,1000,467,305,224,
15,"COVASNA",145,64871,,147,0,"CAMINUL CULTURAL Sat Turia nr. 835","TURIA",33,64871,0,3,1658,1075,1019,56,1033,42,1750,675,1026,7,
15,"COVASNA",145,64871,,148,0,"SCOALA GENERALA Sat Turia nr. 694","TURIA",33,64871,0,3,1131,590,540,50,559,31,1400,810,528,31,
15,"COVASNA",145,64871,,149,0,"SCOALA GENERALA Sat Alungeni nr. 85","TURIA",33,64871,0,3,284,250,222,28,248,2,350,100,245,3,
15,"COVASNA",145,64906,,150,0,"PRIMARIA Sat Valea Crisului","VALEA CRISULUI",35,64906,0,3,1541,812,744,68,779,33,1750,938,744,35,
15,"COVASNA",145,64906,,151,0,"SCOALA GENERALA Sat Arcus","VALEA CRISULUI",35,64906,0,3,996,618,550,68,606,12,1110,492,591,15,
15,"COVASNA",145,64906,,152,1,"UNITATEA MILITARA Sat Arcus","VALEA CRISULUI",35,64906,0,3,0,220,0,220,215,5,570,350,165,50,
15,"COVASNA",145,65099,,153,0,"CAMINUL CULTURAL Sat Valea Mare","VALEA MARE",36,65099,0,3,857,609,561,48,603,6,1000,391,308,295,
15,"COVASNA",145,64942,,154,0,"PRIMARIA Sat Araci","VALCELE",34,64942,0,3,1144,557,500,57,548,9,1300,743,446,102,
15,"COVASNA",145,64942,,155,0,"SCOALA GENERALA Sat Ariujd","VALCELE",34,64942,0,3,351,266,195,71,257,9,450,184,193,64,
15,"COVASNA",145,64942,,156,0,"SCOALA GENERALA Sat Valcele","VALCELE",34,64942,0,3,713,570,425,145,556,14,930,360,369,187,
15,"COVASNA",145,64997,,157,0,"CAMINUL CULTURAL Sat Varghis","VIRGHIS",37,64997,0,3,1566,947,912,35,924,23,1800,853,903,21,
15,"COVASNA",145,65011,,158,0,"CAMINUL CULTURAL NR 1 Sat Zagon","ZAGON",39,65011,0,3,1696,1071,947,124,1052,19,1900,829,1023,29,
15,"COVASNA",145,65011,,159,0,"CAMINUL CULTURAL NR 2 Sat Zagon","ZAGON",39,65011,0,3,1519,1022,931,91,1000,22,1700,678,669,331,
15,"COVASNA",145,65011,,160,0,"CAMINUL CULTURAL Sat Papaut","ZAGON",39,65011,0,3,948,602,523,79,591,11,1050,448,490,101,
15,"COVASNA",145,65048,,161,0,"CAMINUL CULTURAL Sat Zabala","ZABALA",38,65048,0,3,2057,896,784,112,878,18,2300,1404,762,116,
15,"COVASNA",145,65048,,162,0,"CAMINUL CULTURAL Sat Zabala (Pava)","ZABALA",38,65048,0,3,613,294,249,45,280,14,700,406,252,28,
15,"COVASNA",145,65048,,163,0,"CAMINUL CULTURAL Sat Tamasfalau","ZABALA",38,65048,0,3,510,403,341,62,400,3,600,197,379,21,
15,"COVASNA",145,65048,,164,0,"CAMINUL CULTURAL Sat Surcea","ZABALA",38,65048,0,3,490,327,285,42,316,11,600,273,297,19,
16,"DAMBOVITA",154,65342,,1,0,"SCOALA NR. 4 STR. CALEA DOMNEASCA 127","MUNICIPIUL TARGOVISTE",1,65342,1,1,1600,818,716,102,806,12,1702,884,578,228,
16,"DAMBOVITA",154,65342,,2,0,"SCOALA NR. 4 STR. CALEA DOMNEASCA 127","MUNICIPIUL TARGOVISTE",1,65342,1,1,2100,1103,962,141,1089,14,2200,1097,735,354,
16,"DAMBOVITA",154,65342,,3,0,"SCOALA NR.10 STR. RADU CEL MARE NR 12","MUNICIPIUL TARGOVISTE",1,65342,1,1,2167,1085,1008,77,1078,7,2300,1215,664,414,
16,"DAMBOVITA",154,65342,,4,0,"SCOALA NR.10 STR. RADU CEL MARE NR 12","MUNICIPIUL TARGOVISTE",1,65342,1,1,1619,798,721,77,789,9,1750,952,518,271,
16,"DAMBOVITA",154,65342,,5,0,"SCOALA NR.10 STR. RADU CEL MARE NR 12","MUNICIPIUL TARGOVISTE",1,65342,1,1,2125,1125,1030,95,1111,14,2250,1125,691,420,
16,"DAMBOVITA",154,65342,,6,0,"GRUPUL SCOLAR (LIC. 6) STR. M. EMINESCU NR.24","MUNICIPIUL TARGOVISTE",1,65342,1,1,2017,918,851,67,904,14,2154,1236,592,312,
16,"DAMBOVITA",154,65342,,7,0,"GRUPUL SCOLAR (LIC. 6) STR. M. EMINESCU NR.24","MUNICIPIUL TARGOVISTE",1,65342,1,1,2085,1074,966,108,1058,16,2100,1026,729,329,
16,"DAMBOVITA",154,65342,,8,0,"SCOALA DE MUZICA STR. PARVAN POPESCU NR.60","MUNICIPIUL TARGOVISTE",1,65342,1,1,1644,914,827,87,905,9,1750,836,575,330,
16,"DAMBOVITA",154,65342,,9,0,"LIC. CARABELA (GR. ALEXANDRESCU) STR. LT. PARVAN POPESCU 58","MUNICIPIUL TARGOVISTE",1,65342,1,1,988,596,518,78,585,11,1102,506,379,206,
16,"DAMBOVITA",154,65342,,10,0,"LIC. PETRU CERCEL (SANITAR) STR. LT. PARVAN POPESCU NR.94","MUNICIPIUL TARGOVISTE",1,65342,1,1,1251,740,607,133,725,15,1354,609,550,175,
16,"DAMBOVITA",154,65342,,11,0,"SCOALA NR. 13 STR. MR. SPIRESCU NR.5 (SOLD. PUIU SORIN NR.3)","MUNICIPIUL TARGOVISTE",1,65342,1,1,1539,872,757,115,856,16,1650,778,542,314,
16,"DAMBOVITA",154,65342,,12,0,"SCOALA NR. 13 STR. MR. SPIRESCU NR.5 (SOLD. PUIU SORIN NR.3)","MUNICIPIUL TARGOVISTE",1,65342,1,1,957,598,446,152,590,8,1100,502,405,185,
16,"DAMBOVITA",154,65342,,13,0,"SCOALA NR. 6 STR. MOLDOVEI NR.2 (ZEFIRULUI NR. 6)","MUNICIPIUL TARGOVISTE",1,65342,1,1,1549,794,751,43,783,11,1700,906,499,284,
16,"DAMBOVITA",154,65342,,14,0,"SCOALA NR. 6 STR. MOLDOVEI NR.2 (ZEFIRULUI NR. 6)","MUNICIPIUL TARGOVISTE",1,65342,1,1,1380,738,697,41,730,8,1500,762,499,231,
16,"DAMBOVITA",154,65342,,15,0,"GRUPUL SCOLAR C. BRANCOVEANU (LIC. NR. 4 - BD. UNIRII 20) BD. UNIRII 24-26","MUNICIPIUL TARGOVISTE",1,65342,1,1,1508,800,653,147,793,7,1600,793,513,280,
16,"DAMBOVITA",154,65342,,16,0,"GRUPUL SCOLAR C. BRANCOVEANU (LIC. NR. 4 - BD. UNIRII 20) BD. UNIRII 24-26","MUNICIPIUL TARGOVISTE",1,65342,1,1,1733,956,859,97,945,11,1850,894,552,393,
16,"DAMBOVITA",154,65342,,17,0,"DIRECTIA GENERALA PT. MUNCA SI PROTECTIE SOCIALA STR. T. VLADIMIRESCU NR.3","MUNICIPIUL TARGOVISTE",1,65342,1,1,1760,1105,989,116,1093,12,2100,995,691,402,
16,"DAMBOVITA",154,65342,,18,0,"CANTINA DE AJUTOR SOCIAL  STR. T. VLADIMIRESCU NR.1","MUNICIPIUL TARGOVISTE",1,65342,1,1,1978,988,849,139,979,9,2100,1112,672,307,
16,"DAMBOVITA",154,65342,,19,0,"SCOALA NR. 11 STR. MOLDOVEI NR. 3","MUNICIPIUL TARGOVISTE",1,65342,1,1,1585,867,748,119,853,14,1700,833,509,344,
16,"DAMBOVITA",154,65342,,20,0,"LIC. I.H.RADULESCU NR.3 BD. UNIRII NR. 28","MUNICIPIUL TARGOVISTE",1,65342,1,1,2015,1142,988,154,1129,13,2150,1008,747,382,
16,"DAMBOVITA",154,65342,,21,0,"BIROURI PRIMARIE STR. POET GR. ALEXANDRESCU BL. E4","MUNICIPIUL TARGOVISTE",1,65342,1,1,1627,901,794,107,882,19,1750,849,686,196,
16,"DAMBOVITA",154,65342,,22,0,"BIROURI PRIMARIE CORP B STR. REVOLUTIEI NR 3 (SALONUL ARTELOR)","MUNICIPIUL TARGOVISTE",1,65342,1,1,1428,760,664,96,746,14,1600,840,565,181,
16,"DAMBOVITA",154,65342,,23,0,"LIC. ECONOMIC STR. CALEA DOMNEASCA NR.223 (N. BALCECU NR. 261)","MUNICIPIUL TARGOVISTE",1,65342,1,1,1976,1145,1020,125,1126,19,2101,956,801,325,
16,"DAMBOVITA",154,65342,,24,0,"CASA DE CULTURA A MUNICIPIULUI TARGOVISTE B-DUL REGELE CAROL NR 43 (CLUB PETROL)","MUNICIPIUL TARGOVISTE",1,65342,1,1,1247,893,624,269,874,19,1350,457,578,296,
16,"DAMBOVITA",154,65342,,25,0,"SCOALA DIACONU CORESI(SCOALA NR.5) AL. TRANDAFIRILOR NR.2","MUNICIPIUL TARGOVISTE",1,65342,1,1,1597,1010,890,120,1001,9,1700,690,754,247,
16,"DAMBOVITA",154,65342,,26,0,"SCOALA NR.12 STR. GEN. I.E.FLORESCU (MIRCEA CEL BATRAN)","MUNICIPIUL TARGOVISTE",1,65342,1,1,1272,723,596,127,718,5,1400,677,473,245,
16,"DAMBOVITA",154,65342,,27,0,"SCOALA BRATESCU VOINESTI CALEA DOMNEASCA NR.252 (SC. NR.2 CALEA DOMNEASCA 278)","MUNICIPIUL TARGOVISTE",1,65342,1,1,1704,951,895,56,935,16,1800,849,628,307,
16,"DAMBOVITA",154,65342,,28,0,"SCOALA BRATESCU VOINESTI CALEA DOMNEASCA NR.252 (SC. NR.2 CALEA DOMNEASCA 278)","MUNICIPIUL TARGOVISTE",1,65342,1,1,1815,821,725,96,813,8,1900,1079,544,269,
16,"DAMBOVITA",154,65342,,29,0,"LIC. IEN. VACARESCU CALEA DOMNEASCA 237 (CALEA DOMNEASCA 275)","MUNICIPIUL TARGOVISTE",1,65342,1,1,1593,872,771,101,855,17,1700,828,623,232,
16,"DAMBOVITA",154,65342,,30,0,"LIC. NICOLAE CIORANESCU STR. 1 MAI NR 1A ( LICEUL NR. 1)","MUNICIPIUL TARGOVISTE",1,65342,1,1,1430,819,639,180,805,14,1550,731,559,246,
16,"DAMBOVITA",154,65342,,31,0,"LIC. NICOLAE CIORANESCU STR. 1 MAI NR 1A ( LICEUL NR. 1)","MUNICIPIUL TARGOVISTE",1,65342,1,1,1592,772,672,100,760,12,1700,928,514,246,
16,"DAMBOVITA",154,65342,,32,0,"LIC. NICOLAE CIORANESCU STR. 1 MAI NR 1A ( LICEUL NR. 1)","MUNICIPIUL TARGOVISTE",1,65342,1,1,1766,1010,854,156,996,14,1900,890,719,277,
16,"DAMBOVITA",154,65342,,33,0,"SCOALA NR. 8 STR. PROF. ALEX. VASILESCU NR. 1","MUNICIPIUL TARGOVISTE",1,65342,1,1,1702,930,753,177,914,16,1811,881,629,285,
16,"DAMBOVITA",154,65342,,34,0,"SCOALA NR. 8 STR. PROF. ALEX. VASILESCU NR. 1","MUNICIPIUL TARGOVISTE",1,65342,1,1,1474,857,750,107,845,12,1615,758,590,255,
16,"DAMBOVITA",154,65342,,35,0,"SCOALA NORMALA STR. PROF. GEORGE CAIR NR. 3 (G-RAL VASILE MILEA)","MUNICIPIUL TARGOVISTE",1,65342,1,1,1743,898,795,103,889,9,1850,952,576,313,
16,"DAMBOVITA",154,65342,,36,0,"SCOALA NR.12 G-RAL I.E. FLORESCU NR. 8 (MIRCEA CEL BATRAN, NR.6)","MUNICIPIUL TARGOVISTE",1,65342,1,1,2019,1056,884,172,1043,13,2150,1094,667,376,
16,"DAMBOVITA",154,65342,,37,0,"GRUP SCOLAR C-TII MONTAJ STR. G-RAL I.E. FLORESCU NR.18 (LIC. 5 STR. MIRCEA CEL BATRAN NR.20)","MUNICIPIUL TARGOVISTE",1,65342,1,1,1316,709,615,94,689,20,1402,693,431,258,
16,"DAMBOVITA",154,65342,,38,0,"GRUP SCOLAR C-TII MONTAJ STR. G-RAL I.E. FLORESCU NR.18 (LIC. 5 STR. MIRCEA CEL BATRAN NR.20)","MUNICIPIUL TARGOVISTE",1,65342,1,1,2191,1042,956,86,1032,10,2302,1260,616,416,
16,"DAMBOVITA",154,65342,,39,0,"SCOALA NORMALA STR. PROF. GEORGE CAIR NR. 3 (G-RAL VASILE MILEA)","MUNICIPIUL TARGOVISTE",1,65342,1,1,2094,1100,999,101,1086,14,2200,1100,632,454,
16,"DAMBOVITA",154,65342,,40,0,"SCOALA NR.9 STR. VASILE BLENDEA NR. 7 (AVANTULUI)","MUNICIPIUL TARGOVISTE",1,65342,1,1,1898,999,849,150,990,9,2000,1001,558,432,
16,"DAMBOVITA",154,65342,,41,0,"SCOALA NR.9 STR. VASILE BLENDEA NR. 7 (AVANTULUI)","MUNICIPIUL TARGOVISTE",1,65342,1,1,1794,863,806,57,857,6,1900,1037,475,382,
16,"DAMBOVITA",154,65342,,42,0,"SCOALA NR.9 STR. VASILE BLENDEA NR. 7 (AVANTULUI)","MUNICIPIUL TARGOVISTE",1,65342,1,1,1769,858,796,62,850,8,1900,1042,462,388,
16,"DAMBOVITA",154,65342,,43,0,"SCOALA NR. 3 CALEA BUCURESTI NR. 28 (N. BALCESCU 452)","MUNICIPIUL TARGOVISTE",1,65342,1,1,1986,1154,1014,140,1140,14,2100,946,671,469,
16,"DAMBOVITA",154,65342,,44,0,"SCOALA NR. 3 CALEA BUCURESTI NR. 28 (N. BALCESCU 452)","MUNICIPIUL TARGOVISTE",1,65342,1,1,1780,986,895,91,979,7,1900,914,632,347,
16,"DAMBOVITA",154,65342,,45,0,"SCOALA NR. 3 CALEA BUCURESTI NR. 28 (N. BALCESCU 452)","MUNICIPIUL TARGOVISTE",1,65342,1,1,1587,918,832,86,900,18,1700,782,637,263,
16,"DAMBOVITA",154,65342,,46,0,"CAMIN CULTURAL MATEI VOIEVOD STR. CALEA PLOIESTI","MUNICIPIUL TARGOVISTE",1,65342,1,1,1533,1012,957,55,986,26,1650,638,691,295,
16,"DAMBOVITA",154,65342,,47,0,"SCOALA PRISEACA STR. CRANGULUI","MUNICIPIUL TARGOVISTE",1,65342,1,1,645,501,414,87,490,11,700,199,342,148,
16,"DAMBOVITA",154,65342,,48,1,"SCOALA MATEI BASARAB (SCOALA NR 13) MR. SPIRESCU NR.5","MUNICIPIUL TARGOVISTE",1,65342,1,1,440,442,425,17,427,15,550,108,263,164,
16,"DAMBOVITA",154,65342,,49,1,"LIC. VOIEVOD MIRCEA (PETROL) BD. CAROL I CASTANILOR","MUNICIPIUL TARGOVISTE",1,65342,1,1,0,284,0,284,282,2,300,16,192,90,
16,"DAMBOVITA",154,65342,,50,1,"SPITALUL JUDETEAN TGV. STR. T. VLADIMIRESCU NR. 48","MUNICIPIUL TARGOVISTE",1,65342,1,1,0,517,0,517,515,2,600,83,358,157,
16,"DAMBOVITA",154,65342,,51,1,"LIC. VOIEVOD MIRCEA (PETROL) BD. CAROL I CASTANILOR","MUNICIPIUL TARGOVISTE",1,65342,1,1,0,222,0,222,217,5,450,228,119,98,
16,"DAMBOVITA",154,65609,,52,0,"SCOALA GENERALA COSTESTI","ORAS FIENI",2,65609,2,1,725,472,435,37,468,4,800,328,369,99,
16,"DAMBOVITA",154,65609,,53,0,"CANTINA S.C. ROMCIF SA FIENI","ORAS FIENI",2,65609,2,1,829,494,453,41,489,5,909,415,345,144,
16,"DAMBOVITA",154,65609,,54,0,"CLUBUL S.C. ROMCIF SA FIENI","ORAS FIENI",2,65609,2,1,1209,813,692,121,798,15,1300,487,530,268,
16,"DAMBOVITA",154,65609,,55,0,"GRUPUL SCOLAR INDUSTRIAL FIENI","ORAS FIENI",2,65609,2,1,2260,1200,1147,53,1184,16,2400,1200,825,359,
16,"DAMBOVITA",154,65609,,56,0,"CANTINA LIC. INDUSTRIAL FIENI","ORAS FIENI",2,65609,2,1,1395,890,787,103,877,13,1500,610,588,289,
16,"DAMBOVITA",154,65681,,57,0,"SCOALA GENERALA NR.1","ORAS GAESTI",3,65681,2,1,1769,1071,938,133,1058,13,1850,779,698,360,
16,"DAMBOVITA",154,65681,,58,0,"SCOALA GENERALA NR.2","ORAS GAESTI",3,65681,2,1,1364,807,760,47,802,5,1500,693,552,250,
16,"DAMBOVITA",154,65681,,59,0,"LICEUL TEORETIC ""VLADIMIR STREINU""","ORAS GAESTI",3,65681,2,1,1435,848,796,52,842,6,1500,652,513,329,
16,"DAMBOVITA",154,65681,,60,0,"SCOALA GENERALA NR. 6","ORAS GAESTI",3,65681,2,1,2125,1090,990,100,1084,6,2150,1060,638,446,
16,"DAMBOVITA",154,65681,,61,0,"SCOALA GENERALA NR. 6","ORAS GAESTI",3,65681,2,1,1944,1035,950,85,1035,0,2050,1015,642,393,
16,"DAMBOVITA",154,65681,,62,0,"SCOALA GENERALA NR. 6","ORAS GAESTI",3,65681,2,1,1597,873,816,57,859,14,1700,827,562,297,
16,"DAMBOVITA",154,65681,,63,0,"SCOALA GENERALA NR. 3","ORAS GAESTI",3,65681,2,1,1838,985,899,86,973,12,1950,965,662,311,
16,"DAMBOVITA",154,65681,,64,0,"SCOALA GENERALA NR. 3","ORAS GAESTI",3,65681,2,1,1460,829,745,84,818,11,1550,721,552,266,
16,"DAMBOVITA",154,65681,,65,1,"CENTRUL REEDUCARE GAESTI","ORAS GAESTI",3,65681,2,1,0,112,0,112,111,1,150,38,85,26,
16,"DAMBOVITA",154,65841,,66,0,"SCOALA GENERALA NR.2 (SCHELA MARE)","ORAS MORENI",4,65841,2,1,1493,1068,915,153,1060,8,1603,535,771,289,
16,"DAMBOVITA",154,65841,,67,0,"FERMA TIUCANI","ORAS MORENI",4,65841,2,1,321,245,208,37,237,8,400,155,158,79,
16,"DAMBOVITA",154,65841,,68,0,"CLUBUL ""FLACARA"" 2","ORAS MORENI",4,65841,2,1,2277,1426,1226,200,1413,13,2400,974,1022,391,
16,"DAMBOVITA",154,65841,,69,0,"SCOALA GENERALA NR. 3","ORAS MORENI",4,65841,2,1,1889,1268,1119,149,1257,11,2000,732,918,339,
16,"DAMBOVITA",154,65841,,70,0,"SCOALA GENERALA NR. 3","ORAS MORENI",4,65841,2,1,2611,1467,1391,76,1457,10,2700,1233,1000,457,
16,"DAMBOVITA",154,65841,,71,0,"SCOALA GENERALA NR. 4","ORAS MORENI",4,65841,2,1,2482,1423,1348,75,1406,17,2600,1177,993,413,
16,"DAMBOVITA",154,65841,,72,0,"SCOALA GENERALA NR. 4","ORAS MORENI",4,65841,2,1,2184,1286,1164,122,1274,12,2300,1014,927,347,
16,"DAMBOVITA",154,65841,,73,0,"SCOALA GENERALA NR. 4","ORAS MORENI",4,65841,2,1,1957,1390,1156,234,1378,12,2050,660,942,436,
16,"DAMBOVITA",154,65841,,74,0,"LICEUL NR. 2","ORAS MORENI",4,65841,2,1,2050,1387,1153,234,1379,8,2152,765,957,422,
16,"DAMBOVITA",154,65921,,75,0,"SCOALA GENERALA NR. 2 PUCIOASA","ORAS PUCIOASA",5,65921,2,1,1237,682,622,60,678,4,1350,668,453,225,
16,"DAMBOVITA",154,65921,,76,0,"SCOALA GENERALA NR. 7 DIACONESTI","ORAS PUCIOASA",5,65921,2,1,823,463,429,34,458,5,900,437,328,130,
16,"DAMBOVITA",154,65921,,77,0,"SCOALA GENERALA NR. 1 PUCIOASA","ORAS PUCIOASA",5,65921,2,1,1606,1101,826,275,1081,20,1700,599,792,289,
16,"DAMBOVITA",154,65921,,78,0,"GRADINITA NR. 1 PUCIOASA","ORAS PUCIOASA",5,65921,2,1,1636,950,830,120,929,21,1750,800,700,229,
16,"DAMBOVITA",154,65921,,79,0,"SCOALA GENERALA NR. 4 PUCIOASA","ORAS PUCIOASA",5,65921,2,1,1638,920,826,94,909,11,1750,830,659,250,
16,"DAMBOVITA",154,65921,,80,0,"LICEUL N. TITULESCU PUCIOASA","ORAS PUCIOASA",5,65921,2,1,815,410,375,35,403,7,900,490,306,97,
16,"DAMBOVITA",154,65921,,81,0,"GRADINITA NR. 2 PUCIOASA","ORAS PUCIOASA",5,65921,2,1,1564,913,810,103,899,14,1650,737,595,304,
16,"DAMBOVITA",154,65921,,82,0,"CLUBUL TEXTILISTILOR PUCIOASA","ORAS PUCIOASA",5,65921,2,1,1191,778,656,122,771,7,1300,522,536,235,
16,"DAMBOVITA",154,65921,,83,0,"SCOALA GENERALA NR.3 PUCIOASA","ORAS PUCIOASA",5,65921,2,1,1159,744,592,152,733,11,1250,506,532,201,
16,"DAMBOVITA",154,65921,,84,0,"SCOALA GENERALA NR. 5 GLODENI","ORAS PUCIOASA",5,65921,2,1,962,647,590,57,641,6,1052,405,463,178,
16,"DAMBOVITA",154,65921,,85,0,"SCOALA GENERALA MALURI","ORAS PUCIOASA",5,65921,2,1,154,103,84,19,103,0,200,97,84,19,
16,"DAMBOVITA",154,65921,,86,1,"SPITALUL ORASENESC PUCIOASA","ORAS PUCIOASA",5,65921,2,1,0,199,0,199,194,5,252,53,141,53,
16,"DAMBOVITA",154,65921,,87,1,"CAMINUL DE BATRANI PUCIOASA","ORAS PUCIOASA",5,65921,2,1,0,97,0,97,92,4,107,11,40,52,
16,"DAMBOVITA",154,66081,,88,0,"SCOALA GENERALA TITU-TARG","ORAS TITU",6,66081,2,1,1374,792,714,78,782,10,1500,708,547,235,
16,"DAMBOVITA",154,66081,,89,0,"SCOALA GENERALA TITU-TARG","ORAS TITU",6,66081,2,1,868,556,516,40,547,9,900,344,380,167,
16,"DAMBOVITA",154,66081,,90,0,"SCOALA GENERALA SALCUTA","ORAS TITU",6,66081,2,1,1168,704,626,78,696,8,1250,546,498,198,
16,"DAMBOVITA",154,66081,,91,0,"SCOALA GENERALA TITU GARA","ORAS TITU",6,66081,2,1,1116,794,594,200,786,8,1250,456,497,289,
16,"DAMBOVITA",154,66081,,92,0,"LICEUL TEORETIC I.C. VISARION","ORAS TITU",6,66081,2,1,2163,965,886,79,958,7,2300,1335,577,381,
16,"DAMBOVITA",154,66081,,93,0,"GRUP SCOLAR GOGA IONESCU","ORAS TITU",6,66081,2,1,1794,793,714,79,783,10,1900,1107,485,298,
16,"DAMBOVITA",154,66081,,94,1,"SCOALA GENERALA SALCUTA","ORAS TITU",6,66081,2,1,111,121,108,13,121,0,200,79,75,46,
16,"DAMBOVITA",154,65379,,95,0,"SCOALA GENERALA ANINOASA","ANINOASA",7,65379,0,3,864,512,444,68,511,1,1000,488,355,156,
16,"DAMBOVITA",154,65379,,96,0,"SCOALA GENERALA ANINOASA","ANINOASA",7,65379,0,3,1050,612,509,103,602,10,1100,488,422,180,
16,"DAMBOVITA",154,65379,,97,0,"SCOALA GENERALA VIFORATA","ANINOASA",7,65379,0,3,1445,973,673,300,963,10,1500,527,653,310,
16,"DAMBOVITA",154,65379,,98,0,"SCOALA GENERALA SATENI","ANINOASA",7,65379,0,3,1093,759,653,106,753,6,1100,341,551,202,
16,"DAMBOVITA",154,65379,,99,0,"SPITALUL MANASTIREA DEALU","ANINOASA",7,65379,0,3,97,267,40,227,258,9,400,133,168,90,
16,"DAMBOVITA",154,66198,,100,0,"CONSUMCOOP BALENI","BALENI",8,66198,0,3,2065,1310,1153,157,1305,5,2300,990,994,311,
16,"DAMBOVITA",154,66198,,101,0,"SCOALA GENERALA BALENI","BALENI",8,66198,0,3,1224,659,564,95,651,8,1300,641,413,238,
16,"DAMBOVITA",154,66198,,102,0,"CAMINUL CULTURAL BALENI SARBI","BALENI",8,66198,0,3,2740,1393,1239,154,1373,20,3000,1607,912,461,
16,"DAMBOVITA",154,66223,,103,0,"SCOALA GENERALA GURA BARBULETU","BARBULETU",9,66223,0,3,500,452,239,213,446,6,608,156,283,163,
16,"DAMBOVITA",154,66223,,104,0,"CAMIN CULTURAL BARBULETU","BARBULETU",9,66223,0,3,1728,824,703,121,818,6,1900,1076,485,333,
16,"DAMBOVITA",154,66223,,105,0,"CAMIN CULTURAL RAUL ALB","BARBULETU",9,66223,0,3,1373,908,721,187,896,12,1500,592,675,221,
16,"DAMBOVITA",154,66223,,106,0,"CAMIN CULTURAL PIETRARI","BARBULETU",9,66223,0,3,1559,733,562,171,719,14,2000,1267,450,269,
16,"DAMBOVITA",154,66330,,107,0,"CAMIN CULTURAL BEZDEAD","BEZDEAD",10,66330,0,3,1696,898,760,138,878,20,1900,1002,610,268,
16,"DAMBOVITA",154,66330,,108,0,"SCOALA GENERALA NR. 2 BEZDEAD","BEZDEAD",10,66330,0,3,1487,809,717,92,801,8,1600,791,546,255,
16,"DAMBOVITA",154,66330,,109,0,"SCOALA GENERALA MAGURA","BEZDEAD",10,66330,0,3,938,596,509,87,590,6,1000,404,417,173,
16,"DAMBOVITA",154,66401,,110,0,"CAMIN CULTURAL BILCIURESTI","BILCIURESTI",11,66401,0,3,1294,1006,837,169,993,13,1400,394,687,306,
16,"DAMBOVITA",154,66152,,111,0,"SCOALA DE 4 ANI SAVESTI-BRANISTE","BRANISTEA",13,66152,0,3,147,134,84,50,131,3,200,66,109,22,
16,"DAMBOVITA",154,66152,,112,0,"SCOALA DE 8 ANI DAMBOVICIOARA","BRANISTEA",13,66152,0,3,844,573,414,159,557,16,900,327,432,125,
16,"DAMBOVITA",154,66152,,113,0,"SCOALA DE 4 ANI BRANISTEA","BRANISTEA",13,66152,0,3,1258,723,611,112,707,16,1400,677,443,264,
16,"DAMBOVITA",154,66152,,114,0,"SCOALA DE 4 ANI BRANISTEA","BRANISTEA",13,66152,0,3,1230,701,618,83,687,14,1400,699,474,213,
16,"DAMBOVITA",154,66009,,115,0,"CAMINUL CULTURAL BRANESTI","BRANESTI",12,66009,0,3,1440,905,718,187,893,12,1600,695,621,272,
16,"DAMBOVITA",154,66009,,116,0,"SCOALA VECHE BRANESTI","BRANESTI",12,66009,0,3,1141,720,521,199,709,11,1300,580,543,166,
16,"DAMBOVITA",154,66009,,117,0,"CAMINUL CULTURAL VULCANA PANDELE","BRANESTI",12,66009,0,3,2100,1218,986,232,1211,7,2300,1082,919,292,
16,"DAMBOVITA",154,66009,,118,0,"SCOALA GENERALA GURA VULCANII","BRANESTI",12,66009,0,3,1733,1116,897,219,1103,13,1900,784,787,316,
16,"DAMBOVITA",154,66009,,119,0,"SCOALA PRIBOIU","BRANESTI",12,66009,0,3,728,601,403,198,595,6,800,199,401,194,
16,"DAMBOVITA",154,101341,,120,0,"SCOALA GENERALA NR. 1 BREZOAIELE","BREZOAELE",14,101341,0,3,1302,547,439,108,532,15,1400,853,380,152,
16,"DAMBOVITA",154,101341,,121,0,"SCOALA GENERALA NR. 2 BREZOAIELE","BREZOAELE",14,101341,0,3,1846,718,644,74,702,16,2000,1282,503,199,
16,"DAMBOVITA",154,66438,,122,0,"GRADINITA DE COPII BUCIUMENI","BUCIUMENI",15,66438,0,3,1420,804,725,79,799,5,1600,796,548,251,
16,"DAMBOVITA",154,66438,,123,0,"SCOALA DE 4 ANI DEALU MARE","BUCIUMENI",15,66438,0,3,1163,775,715,60,769,6,1300,525,526,243,
16,"DAMBOVITA",154,66438,,124,0,"CAMINUL CULTURAL VALEA LEURZII","BUCIUMENI",15,66438,0,3,1222,637,582,55,633,4,1300,663,463,170,
16,"DAMBOVITA",154,66474,,125,0,"SCOALA GENERALA BUCSANI","BUCSANI",16,66474,0,3,3130,1797,1659,138,1776,21,3300,1503,1118,658,
16,"DAMBOVITA",154,66474,,126,0,"SCOALA GENERALA HABENI","BUCSANI",16,66474,0,3,1131,681,541,140,672,9,1200,519,430,242,
16,"DAMBOVITA",154,66474,,127,0,"SCOALA GENERALA RACOVITA","BUCSANI",16,66474,0,3,758,613,408,205,602,11,900,287,441,161,
16,"DAMBOVITA",154,66474,,128,0,"SCOALA DE 4 ANI RATOAIA","BUCSANI",16,66474,0,3,293,326,192,134,321,5,403,77,254,67,
16,"DAMBOVITA",154,101564,,129,0,"SCOALA GENERALA BUTIMANU","BUTIMANU",17,101564,0,3,1322,557,460,97,546,11,1500,943,326,220,
16,"DAMBOVITA",154,101564,,130,0,"SCOALA GENERALA LUCIANCA","BUTIMANU",17,101564,0,3,392,244,168,76,235,9,503,259,123,112,
16,"DAMBOVITA",154,101840,,131,0,"SCOALA GENERALA CIOCANESTI","CIOCANESTI",19,101840,0,3,2061,1056,889,167,1019,37,2300,1244,661,358,
16,"DAMBOVITA",154,101840,,132,0,"SCOALA GENERALA URZICEANCA","CIOCANESTI",19,101840,0,3,1262,792,633,159,746,46,1300,508,540,206,
16,"DAMBOVITA",154,101840,,133,0,"SCOALA GENERALA VIZURESTI","CIOCANESTI",19,101840,0,3,640,411,299,112,403,8,700,289,337,66,
16,"DAMBOVITA",154,66526,,134,0,"CAMINUL CULTURAL DRAGODANESTI","CANDESTI",18,66526,0,3,1016,643,524,119,636,7,1100,457,408,228,
16,"DAMBOVITA",154,66526,,135,0,"CAMINUL CULTURAL CANDESTI-VALE","CANDESTI",18,66526,0,3,1155,552,480,72,547,5,1300,748,352,195,
16,"DAMBOVITA",154,66526,,136,0,"CAMINUL CULTURAL CANDESTI-DEAL","CANDESTI",18,66526,0,3,235,159,120,39,155,4,300,141,68,87,
16,"DAMBOVITA",154,66526,,137,0,"SCOALA GENERALA VALEA MARE","CANDESTI",18,66526,0,3,148,150,102,48,150,0,200,50,86,64,
16,"DAMBOVITA",154,66580,,138,0,"GRADINITA DE COPII GHERGHITESTI","COBIA",20,66580,0,3,1257,696,615,81,686,10,1400,704,395,291,
16,"DAMBOVITA",154,66580,,139,0,"GRADINITA DE COPII MISLEA","COBIA",20,66580,0,3,673,440,369,71,434,6,700,260,254,180,
16,"DAMBOVITA",154,66580,,140,0,"GRADINITA DE COPII FRASIN DEAL","COBIA",20,66580,0,3,631,374,321,53,369,5,700,326,255,114,
16,"DAMBOVITA",154,66697,,141,0,"SCOALA GENERALA FANTANELE","COJASCA",21,66697,0,3,1199,765,616,149,757,8,1500,735,660,97,
16,"DAMBOVITA",154,66697,,142,0,"SCOALA DE 4 ANI IAZU","COJASCA",21,66697,0,3,1649,575,491,84,565,10,1500,925,446,119,
16,"DAMBOVITA",154,66697,,143,0,"SCOALA GENERALA COJASCA","COJASCA",21,66697,0,3,1255,831,551,280,822,9,1500,669,524,298,
16,"DAMBOVITA",154,66731,,144,0,"CAMINUL CULTURAL COMISANI","COMISANI",22,66731,0,3,2828,1700,1610,90,1687,13,3100,1400,1175,512,
16,"DAMBOVITA",154,66731,,145,0,"CAMINUL CULTURAL LAZURI","COMISANI",22,66731,0,3,1452,976,820,156,964,12,1600,624,629,335,
16,"DAMBOVITA",154,66768,,146,0,"SCOALA GENERALA CONTESTI","CONTESTI",23,66768,0,3,1885,1712,1556,156,1698,14,2100,388,1281,417,
16,"DAMBOVITA",154,66768,,147,0,"SCOALA GENERALA BALTENI","CONTESTI",23,66768,0,3,1240,1128,1000,128,1113,15,1400,272,915,198,
16,"DAMBOVITA",154,66857,,148,0,"SCOALA GENERALA CORBII MARI","CORBII MARI",24,66857,0,3,1591,1024,801,223,1013,11,1700,676,776,237,
16,"DAMBOVITA",154,66857,,149,0,"SCOALA GENERALA GROZAVESTI","CORBII MARI",24,66857,0,3,1191,556,383,173,544,12,1300,744,462,82,
16,"DAMBOVITA",154,66857,,150,0,"SCOALA GENERALA PETRESTI","CORBII MARI",24,66857,0,3,1058,458,346,112,450,8,1202,744,300,150,
16,"DAMBOVITA",154,66857,,151,0,"SCOALA GENERALA UNGURENI","CORBII MARI",24,66857,0,3,1778,1020,811,209,991,29,2000,980,736,255,
16,"DAMBOVITA",154,66955,,152,0,"SCOALA GENERALA CORNATELU","CORNATELU",25,66955,0,3,357,346,237,109,344,2,402,56,249,95,
16,"DAMBOVITA",154,66955,,153,0,"SCOALA GENERALA BOLOVANI DEAL","CORNATELU",25,66955,0,3,668,431,309,122,426,5,800,369,308,118,
16,"DAMBOVITA",154,66955,,154,0,"SCOALA DE 4 ANI ALUNIS","CORNATELU",25,66955,0,3,267,245,183,62,242,3,300,55,187,55,
16,"DAMBOVITA",154,67014,,155,0,"CAMINUL CULTURAL CORNESTI","CORNESTI",26,67014,0,3,2484,1100,925,175,1078,22,2700,1600,580,498,
16,"DAMBOVITA",154,67014,,156,0,"CAMINUL CULTURAL CATUNU","CORNESTI",26,67014,0,3,1410,753,546,207,744,9,1600,847,442,302,
16,"DAMBOVITA",154,67014,,157,0,"CAMINUL CULTURAL FRASINU","CORNESTI",26,67014,0,3,2013,998,852,146,974,24,2200,1202,439,535,
16,"DAMBOVITA",154,67121,,158,0,"GRADINITA DE COPII COSTESTII DIN VALE","COSTESTII DIN VALE",27,67121,0,3,1705,839,716,123,826,13,1900,1061,630,196,
16,"DAMBOVITA",154,67121,,159,0,"SCOALA GENERALA TOMSANI","COSTESTII DIN VALE",27,67121,0,3,834,634,437,197,630,4,900,266,477,153,
16,"DAMBOVITA",154,102286,,160,0,"SCOALA GENERALA CREVEDIA","CREVEDIA",29,102286,0,3,1770,914,627,287,901,13,2000,1086,624,277,
16,"DAMBOVITA",154,102286,,161,0,"SCOALA GENERALA DARZA","CREVEDIA",29,102286,0,3,1388,658,501,157,652,6,1500,842,416,236,
16,"DAMBOVITA",154,102286,,162,0,"SCOALA GENERALA SAMURCASI","CREVEDIA",29,102286,0,3,944,586,330,256,578,8,1100,514,352,226,
16,"DAMBOVITA",154,102286,,163,0,"SCOALA GENERALA COCANI","CREVEDIA",29,102286,0,3,340,209,128,81,201,8,400,191,138,63,
16,"DAMBOVITA",154,67167,,164,0,"SCOALA GENERALA BADULESTI","CRANGURILE",28,67167,0,3,1192,681,574,107,677,4,1300,619,478,199,
16,"DAMBOVITA",154,67167,,165,0,"SCOALA GENERALA PATROAIA VALE","CRANGURILE",28,67167,0,3,1214,679,566,113,672,7,1400,721,498,174,
16,"DAMBOVITA",154,67256,,166,0,"CAMINUL CULTURAL DARMANESTI","DARMANESTI",30,67256,0,3,2913,1775,1556,219,1750,25,3200,1425,1035,715,
16,"DAMBOVITA",154,67256,,167,0,"SCOALA DE 8 ANI MARGINENII DE SUS","DARMANESTI",30,67256,0,3,942,577,457,120,569,8,1100,523,304,265,
16,"DAMBOVITA",154,67256,,168,0,"SCOALA DE 8 ANI VLADENI","DARMANESTI",30,67256,0,3,2216,1181,1056,125,1165,16,2500,1319,747,418,
16,"DAMBOVITA",154,67292,,169,0,"SCOALA GENERALA DOBRA","DOBRA",31,67292,0,3,1601,930,805,125,921,9,1800,870,647,274,
16,"DAMBOVITA",154,67292,,170,0,"SCOALA GENERALA MARCESTI","DOBRA",31,67292,0,3,1377,1123,963,160,1109,14,1500,377,806,303,
16,"DAMBOVITA",154,65413,,171,0,"SCOALA GENERALA NR. 1 DOICESTI","DOICESTI",32,65413,0,3,1772,1220,1090,130,1207,13,2002,782,937,270,
16,"DAMBOVITA",154,65413,,172,0,"SCOALA GENERALA NR.3 DOICESTI COLONIE","DOICESTI",32,65413,0,3,1754,1095,942,153,1088,7,1900,805,799,289,
16,"DAMBOVITA",154,67327,,173,0,"SCOALA GENERALA DRAGODANA","DRAGODANA",33,67327,0,3,1286,707,628,79,702,5,1400,693,430,272,
16,"DAMBOVITA",154,67327,,174,0,"SCOALA GENERALA NR.1 PICIOR DE MUNTE","DRAGODANA",33,67327,0,3,1203,611,532,79,604,7,1300,689,282,322,
16,"DAMBOVITA",154,67327,,175,0,"SCOALA GENERALA NR.2 PICIOR DE MUNTE (BOBOCI)","DRAGODANA",33,67327,0,3,1703,829,769,60,822,7,1800,971,397,425,
16,"DAMBOVITA",154,67327,,176,0,"SCOALA GENERALA BURDUCA","DRAGODANA",33,67327,0,3,1108,575,517,58,572,3,1300,725,357,215,
16,"DAMBOVITA",154,67407,,177,0,"SCOALA DE 8 ANI DRAGOMIRESTI","DRAGOMIRESTI",34,67407,0,3,1463,900,766,134,886,14,1600,700,493,393,
16,"DAMBOVITA",154,67407,,178,0,"SCOALA DE 8 ANI DECINDENI","DRAGOMIRESTI",34,67407,0,3,1704,1121,1010,111,1107,14,1900,779,630,477,
16,"DAMBOVITA",154,67407,,179,0,"SCOALA DE 8 ANI RANCACIOV","DRAGOMIRESTI",34,67407,0,3,1619,896,728,168,888,8,1800,904,552,336,
16,"DAMBOVITA",154,67407,,180,0,"SCOALA DE 8 ANI UNGURENI","DRAGOMIRESTI",34,67407,0,3,1341,662,548,114,650,12,1500,838,423,227,
16,"DAMBOVITA",154,67470,,181,0,"SCOALA FINTA MARE","FINTA",35,67470,0,3,1238,1150,1063,87,1143,7,1300,150,909,234,
16,"DAMBOVITA",154,67470,,182,0,"GRADINITA DE COPII BECHENESTI","FINTA",35,67470,0,3,693,444,327,117,436,8,900,456,338,98,
16,"DAMBOVITA",154,67470,,183,0,"CAMINUL CULTURAL GHEBOAIA","FINTA",35,67470,0,3,1749,1577,1430,147,1563,14,1900,323,1205,358,
16,"DAMBOVITA",154,67522,,184,0,"SCOALA ""BUICA IONESCU"" GLODENI","GLODENI",36,67522,0,3,1486,868,730,138,856,12,1600,732,534,322,
16,"DAMBOVITA",154,67522,,185,0,"SALA DE SEDINTA A PRIMARIEI","GLODENI",36,67522,0,3,1263,783,584,199,770,13,1400,617,502,268,
16,"DAMBOVITA",154,67522,,186,0,"GRADINITA DE COPII LACULETE","GLODENI",36,67522,0,3,792,569,486,83,567,2,900,331,359,208,
16,"DAMBOVITA",154,65707,,187,0,"SALA DE FESTIVITATI A CONSILIULUI LOCAL GURA FOII","GURA FOII",37,65707,0,3,1823,1011,912,99,1000,11,2000,989,738,262,
16,"DAMBOVITA",154,67595,,188,0,"SCOALA GENERALA GURA OCNITEI","GURA OCNITEI",38,67595,0,3,2755,1588,1298,290,1563,25,3030,1442,960,603,
16,"DAMBOVITA",154,67595,,189,0,"SCOALA GENERALA SACUIENI","GURA OCNITEI",38,67595,0,3,1416,928,777,151,916,12,1560,632,567,349,
16,"DAMBOVITA",154,67595,,190,0,"SCOALA GENERALA ADANCA","GURA OCNITEI",38,67595,0,3,1584,1023,898,125,1013,10,1710,687,708,305,
16,"DAMBOVITA",154,67648,,191,0,"SEDIUL PRIMARIEI GURA SUTII","GURA SUTII",39,67648,0,3,2681,1931,1798,133,1924,7,3000,1069,1244,680,
16,"DAMBOVITA",154,67648,,192,0,"SCOALA GENERALA SPERIETENI","GURA SUTII",39,67648,0,3,1487,915,830,85,893,12,1600,695,648,245,
16,"DAMBOVITA",154,67675,,193,0,"SCOALA GENERALA HULUBESTI","HULUBESTI",40,67675,0,3,1250,689,582,107,676,13,1400,711,424,252,
16,"DAMBOVITA",154,67675,,194,0,"SCOALA GENERALA BUTOIU DE JOS","HULUBESTI",40,67675,0,3,1304,806,728,78,790,16,1400,594,584,206,
16,"DAMBOVITA",154,65869,,195,0,"SCOALA GENERALA IEDERA","IEDERA",42,65869,0,3,1497,948,838,110,942,6,1700,752,631,311,
16,"DAMBOVITA",154,65869,,196,0,"CAMINUL CULTURAL IEDERA","IEDERA",42,65869,0,3,1469,974,850,124,966,8,1600,626,696,270,
16,"DAMBOVITA",154,67737,,197,0,"SCOALA GENERALA NR.1 GHIRDOVENI","I. L. CARAGIALE",41,67737,0,3,1403,1051,832,219,1048,3,1500,449,779,269,
16,"DAMBOVITA",154,67737,,198,0,"SCOALA GENERALA NR. 2 GHIRDOVENI","I. L. CARAGIALE",41,67737,0,3,1402,850,645,205,843,7,1500,650,637,206,
16,"DAMBOVITA",154,67737,,199,0,"SCOALA GENERALA I.L. CARAGIALE","I. L. CARAGIALE",41,67737,0,3,1964,1199,1008,191,1181,18,2200,1001,860,321,
16,"DAMBOVITA",154,67737,,200,1,"CLUBUL PENITENCIARULUI","I. L. CARAGIALE",41,67737,0,3,0,353,0,353,348,5,400,47,240,108,
16,"DAMBOVITA",154,67737,,201,0,"SCOALA MIJA","I. L. CARAGIALE",41,67737,0,3,467,418,267,151,416,2,500,82,254,162,
16,"DAMBOVITA",154,67773,,202,0,"SCOALA GENERALA LUCIENI","LUCIENI",43,67773,0,3,1978,1213,1038,175,1202,11,2100,887,790,412,
16,"DAMBOVITA",154,67773,,203,0,"SCOALA GENERALA SUTA SEACA","LUCIENI",43,67773,0,3,993,610,489,121,605,5,1109,499,386,219,
16,"DAMBOVITA",154,67773,,204,0,"SCOALA GENERALA RACIU","LUCIENI",43,67773,0,3,1265,760,677,83,753,7,1400,640,400,353,
16,"DAMBOVITA",154,67773,,205,0,"SCOALA GENERALA SILISTEA","LUCIENI",43,67773,0,3,620,478,382,96,474,4,700,222,262,212,
16,"DAMBOVITA",154,67835,,206,0,"SCOALA GENERALA TELESTI","LUDESTI",44,67835,0,3,1872,935,844,91,921,14,2100,1165,559,362,
16,"DAMBOVITA",154,67835,,207,0,"SCOALA GENERALA SCHEIU DE JOS","LUDESTI",44,67835,0,3,1645,966,873,93,946,20,1800,834,579,367,
16,"DAMBOVITA",154,67906,,208,0,"GRADINITA DE COPII NR.2 LUNGULETU","LUNGULETU",45,67906,0,3,1700,705,559,146,699,6,1900,1195,390,309,
16,"DAMBOVITA",154,67906,,209,0,"SCOALA GENERALA NR. 1 LUNGULETU","LUNGULETU",45,67906,0,3,1493,455,382,73,448,7,1600,1145,293,155,
16,"DAMBOVITA",154,67906,,210,0,"SCOALA GENERALA SERDANU","LUNGULETU",45,67906,0,3,1008,466,403,63,465,1,1100,634,331,134,
16,"DAMBOVITA",154,67942,,211,0,"SCOALA GENERALA MALU CU FLORI","MALU CU FLORI",46,67942,0,3,1302,716,602,114,713,3,1400,684,486,227,
16,"DAMBOVITA",154,67942,,212,0,"SCOALA GENERALA MICLOSANII MICI","MALU CU FLORI",46,67942,0,3,965,613,539,74,611,2,1000,387,400,211,
16,"DAMBOVITA",154,68002,,213,0,"SCOALA GENERALA MANESTI","MANESTI",47,68002,0,3,1048,701,594,107,692,9,1200,499,429,263,
16,"DAMBOVITA",154,68002,,214,0,"SCOALA GENERALA UNGURENI","MANESTI",47,68002,0,3,754,536,401,135,529,7,800,264,369,160,
16,"DAMBOVITA",154,68002,,215,0,"SCOALA GENERALA DRAGAESTI","MANESTI",47,68002,0,3,1328,806,699,107,797,9,1400,594,562,235,
16,"DAMBOVITA",154,68048,,216,0,"GRADINITA DE COPII TETCOIU","MATASARU",48,68048,0,3,908,573,412,161,567,6,1000,427,378,189,
16,"DAMBOVITA",154,68048,,217,0,"SCOALA GENERALA MATASARU","MATASARU",48,68048,0,3,1931,913,821,92,903,10,2100,1187,677,226,
16,"DAMBOVITA",154,68048,,218,0,"SCOALA GENERALA PUTU CU SALCIA","MATASARU",48,68048,0,3,1534,735,654,81,726,9,1700,965,490,236,
16,"DAMBOVITA",154,68128,,219,0,"SCOALA GENERALA MOGOSANI","MOGOSANI",49,68128,0,3,1367,688,608,80,687,1,1500,812,436,251,
16,"DAMBOVITA",154,68128,,220,0,"SCOALA DE 4 ANI MERI","MOGOSANI",49,68128,0,3,1381,709,614,95,696,13,1501,792,491,205,
16,"DAMBOVITA",154,68128,,221,0,"SCOALA DE 4 ANI ZAVOIUL","MOGOSANI",49,68128,0,3,793,519,469,50,516,3,900,381,380,136,
16,"DAMBOVITA",154,68182,,222,0,"SEDIUL PRIMARIEI MOROENI","MOROENI",50,68182,0,3,1007,631,485,146,625,6,1000,369,509,116,
16,"DAMBOVITA",154,68182,,223,0,"SCOALA GENERALA MOROENI","MOROENI",50,68182,0,3,1784,980,870,110,967,13,1800,820,679,288,
16,"DAMBOVITA",154,68182,,224,0,"SCOALA GENERALA GLOD","MOROENI",50,68182,0,3,953,717,600,117,697,20,950,233,579,118,
16,"DAMBOVITA",154,68182,,225,0,"SCOALA MUSCEL","MOROENI",50,68182,0,3,65,89,57,32,88,1,100,11,56,32,
16,"DAMBOVITA",154,68182,,226,0,"CLUBUL SANATORIU TBC MOROENI","MOROENI",50,68182,0,3,47,384,32,352,373,11,400,16,229,144,
16,"DAMBOVITA",154,68253,,227,0,"GRADINITA MORTENI","MORTENI",51,68253,0,3,2403,1414,1351,63,1405,9,2808,1394,916,489,
16,"DAMBOVITA",154,65645,,228,0,"CAMINUL CULTURAL MOTAENI","MOTAIENI",52,65645,0,3,1283,840,777,63,830,10,1400,560,585,245,
16,"DAMBOVITA",154,65645,,229,0,"SCOALA DE 4 ANI CUCUTENI","MOTAIENI",52,65645,0,3,536,287,257,30,282,5,600,313,167,115,
16,"DAMBOVITA",154,104387,,230,0,"SEDIUL PRIMARIEI NICULESTI","NICULESTI",53,104387,0,3,2282,1611,1545,66,1597,14,2500,889,1405,192,
16,"DAMBOVITA",154,104387,,231,0,"SCOALA DE 4 ANI CIOCANARI","NICULESTI",53,104387,0,3,816,418,395,23,406,12,900,482,352,54,
16,"DAMBOVITA",154,68280,,232,0,"SCOALA GENERALA NUCET","NUCET",54,68280,0,3,1704,858,729,129,851,7,1900,1042,562,289,
16,"DAMBOVITA",154,68280,,233,0,"SCOALA DE 4 ANI CAZACI","NUCET",54,68280,0,3,1208,742,632,110,736,6,1300,558,493,243,
16,"DAMBOVITA",154,68280,,234,0,"SCOALA DE 4 ANI ILFOVENI","NUCET",54,68280,0,3,382,262,217,45,259,3,400,138,146,113,
16,"DAMBOVITA",154,68324,,235,0,"SCOALA GENERALA NR. 1 OCNITA","OCNITA",55,68324,0,3,1150,650,590,60,649,1,1100,450,298,351,
16,"DAMBOVITA",154,68324,,236,0,"SCOALA GENERALA NR. 2 OCNITA","OCNITA",55,68324,0,3,1075,647,579,68,644,3,1100,453,275,369,
16,"DAMBOVITA",154,68324,,237,0,"SCOALA GENERALA FUNDUL OCNEI","OCNITA",55,68324,0,3,1091,588,514,74,576,12,1100,512,254,322,
16,"DAMBOVITA",154,68342,,238,0,"SCOALA GENERALA ODOBESTI","ODOBESTI",56,68342,0,3,1519,797,693,104,781,16,1700,903,521,260,
16,"DAMBOVITA",154,68342,,239,0,"SCOALA GENERALA MIULESTI","ODOBESTI",56,68342,0,3,863,608,423,185,598,10,1000,392,513,85,
16,"DAMBOVITA",154,68342,,240,0,"ASOC. AGRICOLA ""DOMNITA BALASA""","ODOBESTI",56,68342,0,3,1610,887,718,169,872,15,1700,813,677,195,
16,"DAMBOVITA",154,65752,,241,0,"SCOALA GENERALA PETRESTI","PETRESTI",57,65752,0,3,2116,1083,985,98,1070,13,2300,1217,716,354,
16,"DAMBOVITA",154,65752,,242,0,"SCOALA GENERALA PUNTEA DE GRECI","PETRESTI",57,65752,0,3,622,420,346,74,417,3,701,281,302,115,
16,"DAMBOVITA",154,65752,,243,0,"CAMINUL CULTURAL IONESTI","PETRESTI",57,65752,0,3,2074,1181,1076,105,1161,20,2300,1119,781,380,
16,"DAMBOVITA",154,68404,,244,0,"SCOALA GENERALA PIETROSITA","PIETROSITA",58,68404,0,3,1828,1098,987,111,1084,14,2000,902,825,259,
16,"DAMBOVITA",154,68404,,245,0,"SCOALA GENERALA DEALU FRUMOS","PIETROSITA",58,68404,0,3,813,527,441,86,518,9,900,373,356,162,
16,"DAMBOVITA",154,68431,,246,0,"SCOALA GENERALA NR.1 POIANA","POIANA",59,68431,0,3,2010,838,764,74,822,16,2200,1362,507,315,
16,"DAMBOVITA",154,68431,,247,0,"SCOALA GENERALA NR.2 POIANA","POIANA",59,68431,0,3,871,444,371,73,433,11,1000,556,320,113,
16,"DAMBOVITA",154,68468,,248,0,"SCOALA GENERALA POTLOGI","POTLOGI",60,68468,0,3,2654,1207,1043,164,1176,31,2900,1693,787,389,
16,"DAMBOVITA",154,68468,,249,0,"SCOALA PITARU","POTLOGI",60,68468,0,3,840,402,284,118,393,9,900,498,307,86,
16,"DAMBOVITA",154,68468,,250,0,"SCOALA VLASCENI","POTLOGI",60,68468,0,3,410,357,153,204,351,6,500,143,259,92,
16,"DAMBOVITA",154,68468,,251,0,"SCOALA ROMANESTI","POTLOGI",60,68468,0,3,1972,938,777,161,904,34,2200,1262,796,108,
16,"DAMBOVITA",154,68529,,252,0,"CAMINUL CULTURAL PRODULESTI","PRODULESTI",61,68529,0,3,2037,934,826,108,916,18,2200,1266,556,360,
16,"DAMBOVITA",154,68529,,253,0,"SCOALA DE 4 ANI COSTESTII DIN DEAL","PRODULESTI",61,68529,0,3,724,456,342,114,451,5,800,344,284,167,
16,"DAMBOVITA",154,68565,,254,0,"CAMINUL CULTURAL PUCHENI","PUCHENI",62,68565,0,3,1824,1155,1098,57,1148,7,2000,845,625,523,
16,"DAMBOVITA",154,68627,,255,0,"SCOALA GENERALA RACARI","RACARI",63,68627,0,3,1895,869,710,159,858,11,2100,1231,530,328,
16,"DAMBOVITA",154,68627,,256,0,"SCOALA GENERALA GHERGANI","RACARI",63,68627,0,3,651,347,224,123,341,6,651,304,228,113,
16,"DAMBOVITA",154,68627,,257,0,"SCOALA GENERALA MAVRODIN","RACARI",63,68627,0,3,640,407,264,143,404,3,700,293,246,158,
16,"DAMBOVITA",154,68627,,258,0,"SCOALA GENERALA GHIMPATI","RACARI",63,68627,0,3,728,474,416,58,469,5,800,326,327,142,
16,"DAMBOVITA",154,68627,,259,0,"SCOALA GENERALA COLACU","RACARI",63,68627,0,3,1151,454,376,78,447,7,1200,746,272,175,
16,"DAMBOVITA",154,68627,,260,0,"SCOALA GENERALA SABIESTI","RACARI",63,68627,0,3,399,386,156,230,383,3,600,214,262,121,
16,"DAMBOVITA",154,65431,,261,0,"SEDIUL BIBLIOTECII RAZVADUL DE JOS","RAZVAD",64,65431,0,3,1392,910,623,287,905,5,1600,690,583,322,
16,"DAMBOVITA",154,65431,,262,0,"SCOALA GENERALA NR. 1 RAZVAD","RAZVAD",64,65431,0,3,1066,645,421,224,639,6,1200,555,411,228,
16,"DAMBOVITA",154,65431,,263,0,"SCOALA GENERALA NR 2 RAZVAD","RAZVAD",64,65431,0,3,906,615,478,137,595,20,1000,385,423,172,
16,"DAMBOVITA",154,65431,,264,0,"SCOALA VALEA VOIEVOZILOR","RAZVAD",64,65431,0,3,1860,1052,895,157,1040,12,2000,948,717,323,
16,"DAMBOVITA",154,65431,,265,0,"SCOALA GORGOTA","RAZVAD",64,65431,0,3,1107,598,500,98,589,9,1200,602,306,283,
16,"DAMBOVITA",154,68716,,266,0,"SEDIUL PRIMARIEI RUNCU","RUNCU",65,68716,0,3,2134,1375,1265,110,1358,17,2300,925,950,408,
16,"DAMBOVITA",154,68716,,267,0,"SCOALA DE 8 ANI BADENI","RUNCU",65,68716,0,3,816,532,492,40,532,0,900,368,395,137,
16,"DAMBOVITA",154,68716,,268,0,"CAMINUL CULTURAL BREBU","RUNCU",65,68716,0,3,542,393,372,21,388,5,600,207,289,99,
16,"DAMBOVITA",154,68789,,269,0,"SCOALA MIRCEA VODA","SALCIOARA",66,68789,0,3,902,558,452,106,553,5,1000,442,382,171,
16,"DAMBOVITA",154,68789,,270,0,"SCOALA BANESTI","SALCIOARA",66,68789,0,3,631,459,284,175,458,1,700,241,285,173,
16,"DAMBOVITA",154,68789,,271,0,"SCOALA GHINESTI","SALCIOARA",66,68789,0,3,959,651,536,115,643,8,1000,349,388,255,
16,"DAMBOVITA",154,68789,,272,0,"SCOALA PODUL RIZII","SALCIOARA",66,68789,0,3,589,350,295,55,344,6,702,352,218,126,
16,"DAMBOVITA",154,105142,,273,0,"SCOALA GENERALA SLOBOZIA MOARA","SLOBOZIA MOARA",68,105142,0,3,1668,598,529,69,589,9,1800,1202,374,215,
16,"DAMBOVITA",154,68887,,274,0,"SCOALA GENERALA SELARU","SELARU",67,68887,0,3,994,575,473,102,562,13,1100,525,394,168,
16,"DAMBOVITA",154,68887,,275,0,"GRADINITA DE COPII FIERBINTI","SELARU",67,68887,0,3,1290,721,639,82,711,10,1400,679,506,205,
16,"DAMBOVITA",154,68887,,276,0,"GRADINITA DE COPII GLOGOVEANU","SELARU",67,68887,0,3,639,432,364,68,427,5,700,268,288,139,
16,"DAMBOVITA",154,65477,,277,0,"SCOALA GENERALA NR.1 SOTANGA","SOTANGA",69,65477,0,3,2491,1292,1139,153,1286,6,2700,1408,929,357,
16,"DAMBOVITA",154,65477,,278,0,"SCOALA GENERALA TEIS","SOTANGA",69,65477,0,3,1707,1085,903,182,1076,9,1900,815,750,326,
16,"DAMBOVITA",154,65477,,279,0,"SCOALA GENERALA NR. 2 SOTANGA","SOTANGA",69,65477,0,3,1120,704,539,165,700,4,1200,496,558,142,
16,"DAMBOVITA",154,105534,,280,0,"SCOALA GENERALA NR. 1 TARTASESTI","TARTASESTI",70,105534,0,3,1682,814,664,150,802,12,1800,986,594,208,
16,"DAMBOVITA",154,105534,,281,0,"SCOALA GENERALA BALDANA","TARTASESTI",70,105534,0,3,1346,687,558,129,666,17,1500,813,444,222,
16,"DAMBOVITA",154,105534,,282,0,"SCOALA GENERALA GULIA","TARTASESTI",70,105534,0,3,652,424,314,110,413,11,700,276,296,117,
16,"DAMBOVITA",154,68921,,283,0,"SALA DE FESTIVITATI TATARANI","TATARANI",71,68921,0,3,1143,636,500,136,630,6,1300,664,411,219,
16,"DAMBOVITA",154,68921,,284,0,"GRADINITA DE COPII GHEBOIENI","TATARANI",71,68921,0,3,1172,774,649,125,771,3,1300,526,485,286,
16,"DAMBOVITA",154,68921,,285,0,"GRADINITA DE COPII CAPRIORU","TATARANI",71,68921,0,3,1201,840,663,177,832,8,1300,460,504,328,
16,"DAMBOVITA",154,68921,,286,0,"CAMINUL CULTURAL PRIBOIU","TATARANI",71,68921,0,3,687,574,392,182,566,8,700,126,383,183,
16,"DAMBOVITA",154,68976,,287,0,"SCOALA GENERALA ULIESTI","ULIESTI",72,68976,0,3,1198,777,666,111,768,9,1300,523,529,239,
16,"DAMBOVITA",154,68976,,288,0,"SCOALA GENERALA CROITORI","ULIESTI",72,68976,0,3,1005,650,548,102,641,9,1100,450,472,169,
16,"DAMBOVITA",154,68976,,289,0,"SCOALA GENERALA JUGARENI","ULIESTI",72,68976,0,3,1339,891,767,124,880,11,1500,609,574,306,
16,"DAMBOVITA",154,65501,,290,0,"SCOALA GENERALA ULMI","ULMI",73,65501,0,3,1287,684,588,96,680,4,1400,716,379,301,
16,"DAMBOVITA",154,65501,,291,0,"SCOALA PRIMARA DUMBRAVA","ULMI",73,65501,0,3,1606,951,783,168,945,6,1800,849,589,356,
16,"DAMBOVITA",154,69063,,292,0,"CAMINUL CULTURAL CRICOV","VALEA LUNGA",75,69063,0,3,980,672,532,140,659,13,1100,428,505,154,
16,"DAMBOVITA",154,69063,,293,0,"GRADINITA DE COPII VALEA MARE","VALEA LUNGA",75,69063,0,3,444,265,215,50,261,4,500,235,167,94,
16,"DAMBOVITA",154,69063,,294,0,"CAMINUL CULTURAL OGREA","VALEA LUNGA",75,69063,0,3,1117,691,579,112,684,7,1200,509,484,200,
16,"DAMBOVITA",154,69063,,295,0,"CAMINUL CULTURAL GORGOTA","VALEA LUNGA",75,69063,0,3,1080,659,544,115,644,15,1200,541,435,209,
16,"DAMBOVITA",154,69063,,296,0,"CAMINUL CULTURAL STUBEIE","VALEA LUNGA",75,69063,0,3,380,286,217,69,281,5,400,114,229,52,
16,"DAMBOVITA",154,69170,,297,0,"SCOALA GENERALA VALEA MARE","VALEA MARE",76,69170,0,3,1268,742,642,100,734,8,1400,658,490,244,
16,"DAMBOVITA",154,69170,,298,0,"SCOALA VALEA CASELOR","VALEA MARE",76,69170,0,3,718,433,386,47,426,7,800,367,256,170,
16,"DAMBOVITA",154,69250,,299,0,"SCOALA GENERALA VACARESTI","VACARESTI",74,69250,0,3,1026,642,561,81,638,4,1100,438,418,220,
16,"DAMBOVITA",154,69250,,300,0,"SCOALA GENERALA VACARESTI","VACARESTI",74,69250,0,3,1452,638,584,54,630,8,1600,962,393,237,
16,"DAMBOVITA",154,69250,,301,0,"SCOALA GENERALA PIERSINARI","VACARESTI",74,69250,0,3,994,489,433,56,486,3,1100,611,380,106,
16,"DAMBOVITA",154,69250,,302,0,"SCOALA GENERALA PIERSINARI","VACARESTI",74,69250,0,3,1229,641,607,34,627,14,1400,759,458,169,
16,"DAMBOVITA",154,69250,,303,0,"SCOALA BUNGETU","VACARESTI",74,69250,0,3,937,667,558,109,659,8,1100,433,433,226,
16,"DAMBOVITA",154,69250,,304,0,"SCOALA GENERALA BRATESTII DE JOS","VACARESTI",74,69250,0,3,478,340,280,60,339,1,600,260,219,120,
16,"DAMBOVITA",154,69303,,305,0,"CAMINUL CULTURAL VALENI DAMBOVITA","VALENI-DIMBOVITA",77,69303,0,3,2253,1274,1181,93,1267,7,2400,1126,742,525,
16,"DAMBOVITA",154,69303,,306,0,"SCOALA MESTEACAN","VALENI-DIMBOVITA",77,69303,0,3,235,191,141,50,191,0,300,109,101,90,
16,"DAMBOVITA",154,69330,,307,0,"SCOALA DE 4 ANI VISINA","VISINA",79,69330,0,3,1225,581,481,100,571,10,1400,819,352,219,
16,"DAMBOVITA",154,69330,,308,0,"CAMINUL CULTURAL VISINA","VISINA",79,69330,0,3,1317,762,578,184,741,21,1500,738,507,234,
16,"DAMBOVITA",154,69330,,309,0,"SCOALA DE 8 ANI BROSTENI","VISINA",79,69330,0,3,912,521,456,65,513,8,900,379,369,144,
16,"DAMBOVITA",154,69330,,310,0,"CAMINUL CULTURAL RASCAIETI","VISINA",79,69330,0,3,1805,1015,919,96,1001,14,2000,985,606,395,
16,"DAMBOVITA",154,69394,,311,0,"SEDIUL PRIMARIEI VISINESTI","VISINESTI",80,69394,0,3,1008,602,546,56,598,4,1100,498,401,197,
16,"DAMBOVITA",154,69394,,312,0,"SCOALA GENERALA URSEIU","VISINESTI",80,69394,0,3,631,445,362,83,435,10,700,255,320,115,
16,"DAMBOVITA",154,69394,,313,0,"SCOALA GENERALA SULTANU","VISINESTI",80,69394,0,3,320,258,218,40,254,4,400,142,191,63,
16,"DAMBOVITA",154,69447,,314,0,"CAMINUL CULTURAL SUVITA","VIRFURI",78,69447,0,3,1707,891,801,90,881,10,1900,1009,599,282,
16,"DAMBOVITA",154,69526,,315,0,"SCOALA GENERALA VOINESTI","VOINESTI",81,69526,0,3,1446,789,614,175,783,6,1600,811,532,251,
16,"DAMBOVITA",154,69526,,316,0,"CAMINUL CULTURAL GEMENEA","VOINESTI",81,69526,0,3,1587,727,601,126,716,11,1700,973,420,296,
16,"DAMBOVITA",154,69526,,317,0,"SCOALA GENERALA IZVOARE","VOINESTI",81,69526,0,3,1364,775,622,153,769,6,1500,725,497,272,
16,"DAMBOVITA",154,69526,,318,0,"SCOALA GENERALA MANGA","VOINESTI",81,69526,0,3,415,315,168,147,311,4,500,185,237,74,
16,"DAMBOVITA",154,69615,,319,0,"GRADINITA DE COPII VULCANA BAI","VULCANA-BAI",82,69615,0,3,1194,1021,952,69,1017,4,1500,479,667,350,
16,"DAMBOVITA",154,69615,,320,0,"GRADINITA DE COPII VULCANA DE SUS","VULCANA-BAI",82,69615,0,3,1030,899,837,62,889,10,1100,201,472,417,
17,"DOLJ",163,69900,,1,0,"Colegiul National ELENA CUZA Str. Ion Maiorescu nr. 4","MUNICIPIUL CRAIOVA",1,69900,1,1,1765,1019,934,85,1002,17,1900,881,802,200,
17,"DOLJ",163,69900,,2,0,"CASA STUDENTILOR Str. Eugeniu Carada nr. 10","MUNICIPIUL CRAIOVA",1,69900,1,1,2026,1043,932,111,1020,23,2200,1157,760,260,
17,"DOLJ",163,69900,,3,0,"Liceul Traian Demetrescu (Lic. auto), Str. Mitropolit Firmilian nr. 114","MUNICIPIUL CRAIOVA",1,69900,1,1,1841,979,894,85,963,16,2000,1021,734,229,
17,"DOLJ",163,69900,,4,0,"Liceul Sportiv Petrache Triscu Str. Tudor Vladimirescu nr. 9","MUNICIPIUL CRAIOVA",1,69900,1,1,1981,1020,966,54,1005,15,2300,1280,763,242,
17,"DOLJ",163,69900,,5,0,"Grupul Scolar Traian Vuia Str. Rovinari nr. 1","MUNICIPIUL CRAIOVA",1,69900,1,1,2227,1185,1120,65,1168,17,2500,1315,823,345,
17,"DOLJ",163,69900,,6,0,"Liceul Teoretic Charles Laugier (Lic. Sanitar) - I Str. Imparatul Traian nr. 65","MUNICIPIUL CRAIOVA",1,69900,1,1,2038,1125,1063,62,1099,26,2300,1175,811,288,
17,"DOLJ",163,69900,,7,0,"Liceul Teoretic Charles Laugier (Lic. Sanitar) - II Str. Imparatul Traian","MUNICIPIUL CRAIOVA",1,69900,1,1,2057,1198,1128,70,1119,79,2300,1102,881,238,
17,"DOLJ",163,69900,,8,0,"Universitate Str. A.I. Cuza nr. 13","MUNICIPIUL CRAIOVA",1,69900,1,1,2264,1493,1295,198,1469,19,2600,1107,1134,335,
17,"DOLJ",163,69900,,9,0,"Scoala Gen. Mircea Eliade (nr. 22) - I, Str. Closca nr. 1","MUNICIPIUL CRAIOVA",1,69900,1,1,1481,846,796,50,830,16,1700,854,632,198,
17,"DOLJ",163,69900,,10,0,"Scoala Gen. Mircea Eliade (nr. 22) - II, Str. Closca nr. 1","MUNICIPIUL CRAIOVA",1,69900,1,1,1736,993,945,48,969,24,1900,907,752,217,
17,"DOLJ",163,69900,,11,0,"Gradinita nr.13 Str. Calea Bucuresti","MUNICIPIUL CRAIOVA",1,69900,1,1,2013,1124,1049,75,1100,24,2300,1176,844,256,
17,"DOLJ",163,69900,,12,0,"Gradinita ""Dumbrava Minunata"" nr. 37 Str. Putnei","MUNICIPIUL CRAIOVA",1,69900,1,1,1523,994,740,254,976,18,1600,606,609,367,
17,"DOLJ",163,69900,,13,0,"Scoala Gen. ""Mihai Eminescu"" nr. 37 - I Str. I. Tuculescu","MUNICIPIUL CRAIOVA",1,69900,1,1,1941,1344,1030,314,1312,32,2100,756,731,581,
17,"DOLJ",163,69900,,14,0,"Gradinita nr. 55 Lapus Str. I. Tuculescu","MUNICIPIUL CRAIOVA",1,69900,1,1,2196,1194,1117,77,1177,17,2500,1306,745,432,
17,"DOLJ",163,69900,,15,0,"Liceul Teoretic Henri Coanda  (nr. 8) - I,Str. Humulesti nr. 62","MUNICIPIUL CRAIOVA",1,69900,1,1,2233,1176,1130,46,1166,10,2500,1324,841,325,
17,"DOLJ",163,69900,,16,0,"Grupul Scolar de Constructii Civile Str. Henri Coanda nr.62","MUNICIPIUL CRAIOVA",1,69900,1,1,2019,1151,1062,89,1133,18,2300,1149,801,332,
17,"DOLJ",163,69900,,17,0,"Grupul Scolar de Arta si Meserii ""Spiru Haret"" (UCECOM) Str. Electroputere nr. 2","MUNICIPIUL CRAIOVA",1,69900,1,1,2117,1166,1103,63,1155,11,2400,1234,743,412,
17,"DOLJ",163,69900,,18,0,"Grupul Scolar Electroputere I Str. Electroputere nr. 13","MUNICIPIUL CRAIOVA",1,69900,1,1,2021,1002,869,133,983,19,2300,1298,619,364,
17,"DOLJ",163,69900,,19,0,"Liceul Teoretic ""Stefan Odobleja"" de Informatica Str. Electroputere nr. 13","MUNICIPIUL CRAIOVA",1,69900,1,1,1020,475,415,60,470,5,1200,725,306,164,
17,"DOLJ",163,69900,,20,0,"Gradinita 41 Cartier Eroilor Str. Revolutiei","MUNICIPIUL CRAIOVA",1,69900,1,1,2146,1211,1103,108,1193,18,2500,1289,784,409,
17,"DOLJ",163,69900,,21,0,"Scoala Gen. ""Theodor Aman"" nr. 31, Str. Vantului nr. 9","MUNICIPIUL CRAIOVA",1,69900,1,1,1757,946,893,53,927,19,2000,1054,635,292,
17,"DOLJ",163,69900,,22,0,"Gradinita nr. 42 - Cartier Eroilor ,Str. Vantului","MUNICIPIUL CRAIOVA",1,69900,1,1,1424,804,738,66,785,19,1600,796,626,159,
17,"DOLJ",163,69900,,23,0,"Scoala nr. 29 Str. Caracal nr. 105","MUNICIPIUL CRAIOVA",1,69900,1,1,2017,1033,927,106,1030,3,2300,1267,664,366,
17,"DOLJ",163,69900,,24,0,"Scoala nr. 29 Str. Caracal nr. 105","MUNICIPIUL CRAIOVA",1,69900,1,1,2290,1101,1031,70,1079,22,2602,1501,693,386,
17,"DOLJ",163,69900,,25,0,"S.C. ORIENTAL CARPET'S (Arta Populara) Str. A. Ipatescu nr. 90","MUNICIPIUL CRAIOVA",1,69900,1,1,2132,1108,1038,70,1083,25,2400,1292,740,343,
17,"DOLJ",163,69900,,26,0,"Grupul Scolar de Transporturi Auto nr. 17 - Sc. nr. 17 Str. N. Romanescu nr. 39","MUNICIPIUL CRAIOVA",1,69900,1,1,2071,1081,897,184,1057,22,2400,1320,714,343,
17,"DOLJ",163,69900,,27,0,"Grupul Scolar de Transporturi Auto - Sc. nr. 17 Str. N. Romanescu nr. 39","MUNICIPIUL CRAIOVA",1,69900,1,1,2445,1051,1002,49,1042,9,2700,1649,658,384,
17,"DOLJ",163,69900,,28,0,"Scoala FACAI","MUNICIPIUL CRAIOVA",1,69900,1,1,768,501,415,86,496,5,900,399,335,161,
17,"DOLJ",163,69900,,29,0,"Scoala POPOVENI nr. 29","MUNICIPIUL CRAIOVA",1,69900,1,1,731,563,397,166,555,8,800,237,370,185,
17,"DOLJ",163,69900,,30,0,"Scoala Generala nr.36 Dr.N. Ionescu Sisesti","MUNICIPIUL CRAIOVA",1,69900,1,1,2428,1218,1154,64,1201,17,2700,1482,789,412,
17,"DOLJ",163,69900,,31,0,"Scoala nr. 36 I Str. Dr. Ionescu Sisesti","MUNICIPIUL CRAIOVA",1,69900,1,1,2434,1199,1140,59,1187,12,2695,1496,727,460,
17,"DOLJ",163,69900,,32,0,"Scoala nr. 36 II Str. Dr. Ionescu Sisesti","MUNICIPIUL CRAIOVA",1,69900,1,1,2199,1071,1016,55,1048,23,2500,1429,609,439,
17,"DOLJ",163,69900,,33,0,"AUTOBAZA 2 R.A.T. Str. Popoveni","MUNICIPIUL CRAIOVA",1,69900,1,1,2292,1211,1133,78,1200,11,2814,1603,747,453,
17,"DOLJ",163,69900,,34,0,"Gradinita CONFECTII B-dul Mar. Ion Antonescu nr. 105","MUNICIPIUL CRAIOVA",1,69900,1,1,2112,1137,1057,80,1125,12,2400,1263,742,383,
17,"DOLJ",163,69900,,35,0,"Facultatea de Medicina B-dul Ion Antonescu","MUNICIPIUL CRAIOVA",1,69900,1,1,1802,1232,843,389,1227,5,2000,768,818,409,
17,"DOLJ",163,69900,,36,0,"Scoala nr. 18 Str. Unirii nr. 180","MUNICIPIUL CRAIOVA",1,69900,1,1,1618,955,869,86,943,12,1800,845,693,250,
17,"DOLJ",163,69900,,37,0,"Liceul de Arta I Str. Tabaci nr. 3","MUNICIPIUL CRAIOVA",1,69900,1,1,1133,679,629,50,660,18,1300,621,518,142,
17,"DOLJ",163,69900,,38,0,"Liceul de Arta II Str. Tabaci nr. 3","MUNICIPIUL CRAIOVA",1,69900,1,1,1756,892,828,64,883,9,1900,1008,604,279,
17,"DOLJ",163,69900,,39,0,"Colegiul National ""FRATII BUZESTI"" I Str. Stirbei Voda nr. 5","MUNICIPIUL CRAIOVA",1,69900,1,1,2000,1222,1055,167,1201,21,2300,1078,867,334,
17,"DOLJ",163,69900,,40,0,"Colegiul National ""FRATII BUZESTI"" II Str. Stirbei Voda nr. 5","MUNICIPIUL CRAIOVA",1,69900,1,1,1763,885,816,69,868,17,2000,1115,628,240,
17,"DOLJ",163,69900,,41,0,"Scoala nr. 19 I Str. Baraganului nr. 41","MUNICIPIUL CRAIOVA",1,69900,1,1,2143,1142,1063,79,1127,15,2400,1258,721,406,
17,"DOLJ",163,69900,,42,0,"Scoala nr. 19 II Str. Baraganului nr. 41","MUNICIPIUL CRAIOVA",1,69900,1,1,2504,1285,1234,51,1277,8,2800,1515,827,450,
17,"DOLJ",163,69900,,43,0,"Scoala MOFLENI nr. 26","MUNICIPIUL CRAIOVA",1,69900,1,1,1022,621,485,136,607,14,1200,579,436,171,
17,"DOLJ",163,69900,,44,0,"D.J.D.P. Str. Drumul Jiului nr. 10","MUNICIPIUL CRAIOVA",1,69900,1,1,1987,859,739,120,848,11,2200,1341,653,195,
17,"DOLJ",163,69900,,45,0,"Scoala nr. 13 BUCOVAT Str. Bucovat nr. 76","MUNICIPIUL CRAIOVA",1,69900,1,1,1626,688,638,50,679,9,1800,1112,398,281,
17,"DOLJ",163,69900,,46,0,"Colegiul National ""NICOLAE BALCESCU"" I Str. Ion Maiorescu nr. 6","MUNICIPIUL CRAIOVA",1,69900,1,1,1221,716,637,79,698,18,1400,684,544,154,
17,"DOLJ",163,69900,,47,0,"Colegiul National ""NICOLAE BALCESCU"" II Str. Ion Maiorescu nr. 6","MUNICIPIUL CRAIOVA",1,69900,1,1,1391,645,594,51,621,24,1600,955,431,190,
17,"DOLJ",163,69900,,48,0,"Facultatea de Agronomie I Str. Libertatii nr. 15","MUNICIPIUL CRAIOVA",1,69900,1,1,2039,1152,947,205,1129,23,2300,1148,842,287,
17,"DOLJ",163,69900,,49,0,"Facultatea de Agronomie II Str. Libertatii nr. 15","MUNICIPIUL CRAIOVA",1,69900,1,1,1788,1090,853,237,1072,18,2000,910,789,283,
17,"DOLJ",163,69900,,50,0,"Gradinita nr. 24 Str. Renasterii nr. 154","MUNICIPIUL CRAIOVA",1,69900,1,1,2155,1102,1043,59,1092,10,2400,1298,796,296,
17,"DOLJ",163,69900,,51,0,"Grupul Scolar de Industrie Alimentara I Str. Brestei nr. 154","MUNICIPIUL CRAIOVA",1,69900,1,1,2263,1166,1041,125,1155,11,2500,1334,718,437,
17,"DOLJ",163,69900,,52,0,"Grupul Scolar de Industrie Alimentara II Str. Brestei nr. 154","MUNICIPIUL CRAIOVA",1,69900,1,1,2249,1057,958,99,1039,17,2497,1423,648,391,
17,"DOLJ",163,69900,,53,0,"Scoala nr. 16 Str. Brestei nr. 240","MUNICIPIUL CRAIOVA",1,69900,1,1,1752,912,812,100,904,8,2000,1088,516,388,
17,"DOLJ",163,69900,,54,0,"Gradinita nr. 15 Str. Brestei nr. 326","MUNICIPIUL CRAIOVA",1,69900,1,1,1970,1128,988,140,1114,14,2200,1072,669,445,
17,"DOLJ",163,69900,,55,0,"Scoala nr. 16 II Str. Brestei nr. 240","MUNICIPIUL CRAIOVA",1,69900,1,1,1083,563,522,41,559,4,1200,637,368,191,
17,"DOLJ",163,69900,,56,0,"Depou TRAMVAI R.A.T. B-dul Dacia","MUNICIPIUL CRAIOVA",1,69900,1,1,2199,1095,1045,50,1090,5,2600,1505,637,453,
17,"DOLJ",163,69900,,57,0,"Scoala Gen. ""Eugeniu Carada"" nr. 34 I. B-dul Oltenia","MUNICIPIUL CRAIOVA",1,69900,1,1,2683,1508,1442,66,1492,16,3090,1582,943,549,
17,"DOLJ",163,69900,,58,0,"Scoala Gen. ""Eugeniu Carada"" nr. 34 II B-dul Oltenia","MUNICIPIUL CRAIOVA",1,69900,1,1,2877,1331,1265,66,1317,14,3200,1869,774,543,
17,"DOLJ",163,69900,,59,0,"Scoala nr. 33 B-dul Oltenia","MUNICIPIUL CRAIOVA",1,69900,1,1,2688,1321,1282,39,1297,19,2997,1676,769,528,
17,"DOLJ",163,69900,,60,0,"Scoala nr. 33 II B-dul Oltenia","MUNICIPIUL CRAIOVA",1,69900,1,1,2646,1388,1336,52,1374,14,2902,1514,870,504,
17,"DOLJ",163,69900,,61,0,"Gradinita nr. 45  I B-dul Oltenia","MUNICIPIUL CRAIOVA",1,69900,1,1,1754,1299,1254,45,1283,16,2800,1501,786,497,
17,"DOLJ",163,69900,,62,0,"Gradinita nr. 45  II B-dul Oltenia","MUNICIPIUL CRAIOVA",1,69900,1,1,2360,1175,1136,39,1164,11,2700,1525,775,389,
17,"DOLJ",163,69900,,63,0,"Gradinita nr. 51 I Str. Craiovita Noua","MUNICIPIUL CRAIOVA",1,69900,1,1,2487,1328,1275,53,1313,15,2800,1472,856,457,
17,"DOLJ",163,69900,,64,0,"Gradinita nr. 51 II Str. Craiovita Noua","MUNICIPIUL CRAIOVA",1,69900,1,1,2006,985,944,41,976,9,2300,1315,599,377,
17,"DOLJ",163,69900,,65,0,"Scoala Gen. ""Alexandru Macedonski"" (Sc. nr. 32) Str. Aleea I Castanilor","MUNICIPIUL CRAIOVA",1,69900,1,1,2569,1231,1158,73,1217,14,2900,1669,783,434,
17,"DOLJ",163,69900,,66,0,"Gradinita nr. 40 I Str. Tineretului","MUNICIPIUL CRAIOVA",1,69900,1,1,2664,1241,1183,58,1219,22,3000,1759,766,453,
17,"DOLJ",163,69900,,67,0,"Gradinita nr. 40 II Str. Tineretului","MUNICIPIUL CRAIOVA",1,69900,1,1,2664,1328,1272,56,1304,24,3000,1669,819,485,
17,"DOLJ",163,69900,,68,0,"Scoala Gen. ""Mihai Viteazul"" (Sc. nr. 30) I Str. Aleea Arh. Duiliu Marcu","MUNICIPIUL CRAIOVA",1,69900,1,1,2064,1004,966,38,1000,4,2300,1296,600,400,
17,"DOLJ",163,69900,,69,0,"Scoala Gen. ""Mihai Viteazul"" (Sc. nr. 30) II Str. Aleea Arh. Duiliu Marcu","MUNICIPIUL CRAIOVA",1,69900,1,1,1991,982,934,48,970,12,2200,209,621,349,
17,"DOLJ",163,69900,,70,0,"Scoala Gen. ""Mihai Viteazul"" (Sc. nr. 30) III Str. Aleea Arh. Duiliu Marcu","MUNICIPIUL CRAIOVA",1,69900,1,1,2065,1112,1026,86,1095,17,2300,1188,767,328,
17,"DOLJ",163,69900,,71,0,"Scoala Gen. ""Alexandru Macedonski"" (nr. 31) I Str. Aleea I Castanilor","MUNICIPIUL CRAIOVA",1,69900,1,1,2339,1202,1146,56,1189,13,2600,1398,787,402,
17,"DOLJ",163,69900,,72,0,"Scoala Gen. ""Alexandru Macedonski"" (nr. 31) II Str. Aleea I Castanilor","MUNICIPIUL CRAIOVA",1,69900,1,1,2522,1289,1226,63,1270,19,2800,1511,926,344,
17,"DOLJ",163,69900,,73,0,"Grupul Scolar Industrial Gh.Bibescu Str.C. Brancoveanu","MUNICIPIUL CRAIOVA",1,69900,1,1,2686,1240,1171,69,1229,11,3000,1760,813,416,
17,"DOLJ",163,69900,,74,0,"Gradinita nr. 52 Str. G. Enescu","MUNICIPIUL CRAIOVA",1,69900,1,1,2800,1424,1349,75,1414,10,2900,1476,878,536,
17,"DOLJ",163,69900,,75,0,"CASA TINERETULUI Str. Calea Severinului","MUNICIPIUL CRAIOVA",1,69900,1,1,2702,1330,1236,94,1318,12,2900,1570,841,477,
17,"DOLJ",163,69900,,76,0,"Grupul Scolar de Chimie I Str. Pascani nr. 28","MUNICIPIUL CRAIOVA",1,69900,1,1,2463,1265,1144,121,1252,13,2800,1535,807,445,
17,"DOLJ",163,69900,,77,0,"Grupul Scolar de Chimie II Str. Pascani nr. 28","MUNICIPIUL CRAIOVA",1,69900,1,1,1942,1030,933,97,1018,12,2200,1170,668,350,
17,"DOLJ",163,69900,,78,0,"Scoala Gen.""Decebal"" nr. 12 I Str. Nicolae Titulescu nr. 64","MUNICIPIUL CRAIOVA",1,69900,1,1,2497,1315,1238,77,1288,27,2900,1585,897,391,
17,"DOLJ",163,69900,,79,0,"Scoala Gen.""Decebal"" nr.12 II Str. Nicolae Titulescu nr. 64","MUNICIPIUL CRAIOVA",1,69900,1,1,2441,1117,1055,62,1109,8,2700,1583,759,350,
17,"DOLJ",163,69900,,80,0,"Grupul Scolar Industrial Energetic I Str. Amaradiei nr. 93","MUNICIPIUL CRAIOVA",1,69900,1,1,2353,1268,1171,97,1249,19,2700,1432,834,415,
17,"DOLJ",163,69900,,81,0,"Grupul Scolar Industrial Energetic II Str. Amaradiei nr. 93","MUNICIPIUL CRAIOVA",1,69900,1,1,2175,1001,956,45,989,12,2500,1499,607,382,
17,"DOLJ",163,69900,,82,0,"Colegiul National ""Stefan Velovan"" (Lic. Pedagogic) I Str. Amaradiei nr. 76","MUNICIPIUL CRAIOVA",1,69900,1,1,2224,1145,1097,48,1134,11,2500,1355,729,405,
17,"DOLJ",163,69900,,83,0,"Colegiul National ""Stefan Velovan"" (Lic. Pedagogic) II Str. Amaradiei nr. 76","MUNICIPIUL CRAIOVA",1,69900,1,1,1342,739,695,44,730,9,1500,761,531,199,
17,"DOLJ",163,69900,,84,0,"I.C.F. TUTUN Str. Brazda lui Novac nr. 217","MUNICIPIUL CRAIOVA",1,69900,1,1,1934,918,874,44,906,12,2100,1182,582,324,
17,"DOLJ",163,69900,,85,0,"Gradinita nr. 32 Str. G-ral Nicolae Magereanu","MUNICIPIUL CRAIOVA",1,69900,1,1,1757,913,870,43,897,16,2000,1087,629,268,
17,"DOLJ",163,69900,,86,0,"Gradinita nr. 43 Str. G-ral Nicolae Magereanu","MUNICIPIUL CRAIOVA",1,69900,1,1,1726,962,911,51,947,15,2000,1038,665,282,
17,"DOLJ",163,69900,,87,0,"Scoala Gen. ""Sfantu Gheorghe"" nr. 24 I Str. G-ral St. Falcoianu","MUNICIPIUL CRAIOVA",1,69900,1,1,2000,1003,974,29,996,7,2300,1297,741,255,
17,"DOLJ",163,69900,,88,0,"Scoala Gen. ""Sfantu Gheorghe"" nr. 24 II Str. G-ral St. Falcoianu","MUNICIPIUL CRAIOVA",1,69900,1,1,1737,909,868,41,899,10,2000,1091,661,238,
17,"DOLJ",163,69900,,89,0,"Scoala nr. 32 Str. Gen. Nicolae Magereanu","MUNICIPIUL CRAIOVA",1,69900,1,1,1472,711,667,44,699,12,1600,889,469,230,
17,"DOLJ",163,69900,,90,0,"Grupul Scolar Industrial C.F.R. Str. Constantin Brancusi nr. 9","MUNICIPIUL CRAIOVA",1,69900,1,1,2255,1342,1194,148,1334,8,2500,1158,1001,333,
17,"DOLJ",163,69900,,91,0,"Liceul ""NICOLAE TITULESCU"" I, Str. Doljului","MUNICIPIUL CRAIOVA",1,69900,1,1,1860,1048,990,58,1030,18,2100,1052,766,264,
17,"DOLJ",163,69900,,92,0,"Scoala Gen. ""Traian"" nr. 2 I Str. Principatele Unite nr. 7","MUNICIPIUL CRAIOVA",1,69900,1,1,1247,733,672,61,698,35,1400,667,559,139,
17,"DOLJ",163,69900,,93,0,"Scoala Gen. ""Traian"" nr. 2 II Str. Principatele Unite nr. 7","MUNICIPIUL CRAIOVA",1,69900,1,1,1420,805,748,57,791,14,1600,795,593,198,
17,"DOLJ",163,69900,,94,0,"Scoala Gen. nr. 10 B-dul Carol I nr. 65","MUNICIPIUL CRAIOVA",1,69900,1,1,1864,1011,947,64,992,19,2100,1089,764,228,
17,"DOLJ",163,69900,,95,0,"Gradinita nr. 29 Str. Paltinis nr. 63 A","MUNICIPIUL CRAIOVA",1,69900,1,1,1564,911,868,43,902,9,1800,889,631,271,
17,"DOLJ",163,69900,,96,0,"Politia Sanitar - str. Lamaitei Str. Lamaitei","MUNICIPIUL CRAIOVA",1,69900,1,1,1436,792,749,43,781,11,1600,808,559,222,
17,"DOLJ",163,69900,,97,0,"Scoala nr. 23 I Str. Lamaitei nr. 23","MUNICIPIUL CRAIOVA",1,69900,1,1,2201,1266,1200,66,1243,23,2500,1234,823,420,
17,"DOLJ",163,69900,,98,0,"Scoala nr. 23 II Str. Lamaitei nr. 23","MUNICIPIUL CRAIOVA",1,69900,1,1,2076,1087,1048,39,1079,8,2300,1213,741,338,
17,"DOLJ",163,69900,,99,0,"Politia Sanitar - str. Lamaitei Str. Lamaitei","MUNICIPIUL CRAIOVA",1,69900,1,1,2033,1115,1072,43,1095,20,2033,918,780,315,
17,"DOLJ",163,69900,,100,0,"Scoala Gen. ""Sfantu Gheorghe"" nr. 24 Str. G-ral St. Falcoianu","MUNICIPIUL CRAIOVA",1,69900,1,1,2014,1055,1011,44,1052,3,1800,745,622,430,
17,"DOLJ",163,69900,,101,0,"Scoala Gen. ""Ion Tuculescu"" nr.14, Str. Bariera Valcii nr.44","MUNICIPIUL CRAIOVA",1,69900,1,1,1270,650,598,52,645,5,1400,750,370,275,
17,"DOLJ",163,69900,,102,0,"TELECONSTRUCTIA Str. Bariera Valcii nr. 80","MUNICIPIUL CRAIOVA",1,69900,1,1,1539,1042,919,123,1030,12,1600,558,686,344,
17,"DOLJ",163,69900,,103,0,"Scoala SIMNICU DE JOS","MUNICIPIUL CRAIOVA",1,69900,1,1,793,522,448,74,504,18,900,378,331,173,
17,"DOLJ",163,69900,,104,0,"Scoala Gen. ""Ion Tuculescu"" nr. 14 I, Str. Teilor nr. 65","MUNICIPIUL CRAIOVA",1,69900,1,1,1289,808,729,79,800,8,1500,692,528,272,
17,"DOLJ",163,69900,,105,0,"Scoala Gen. ""Ion Tuculescu"" nr. 14 II, Str. Teilor nr. 65","MUNICIPIUL CRAIOVA",1,69900,1,1,1135,676,628,48,667,9,1300,624,392,275,
17,"DOLJ",163,69900,,106,0,"REGIONALA C.F.R. I Str. Piata Garii","MUNICIPIUL CRAIOVA",1,69900,1,1,1453,1110,768,342,1101,9,1700,590,723,378,
17,"DOLJ",163,69900,,107,0,"REGIONALA  C.F.R. II Str. Piata Garii","MUNICIPIUL CRAIOVA",1,69900,1,1,1784,1334,990,344,1319,15,2000,666,925,394,
17,"DOLJ",163,69900,,108,0,"Gradinita nr. 50 Str. I.G. Duca nr. 32","MUNICIPIUL CRAIOVA",1,69900,1,1,2077,1131,1065,66,1114,17,2400,1269,797,317,
17,"DOLJ",163,69900,,109,0,"Scoala Gen. ""Petrache Poenaru"" nr. 9 Str. Vasile Alecsandri nr. 73","MUNICIPIUL CRAIOVA",1,69900,1,1,1646,896,848,48,877,19,1800,904,650,227,
17,"DOLJ",163,69900,,110,0,"Scoala Gen. ""Petrache Poenaru""  nr. 9 II Str. Vasile Alecsandri nr. 73","MUNICIPIUL CRAIOVA",1,69900,1,1,1473,817,777,40,797,20,1700,883,617,180,
17,"DOLJ",163,69900,,111,0,"Scoala nr. 21 I Str. Calea Bucuresti nr. 141","MUNICIPIUL CRAIOVA",1,69900,1,1,2123,1193,1117,76,1169,24,2400,1207,897,272,
17,"DOLJ",163,69900,,112,0,"Scoala nr. 21 II Str. Calea Bucuresti nr. 141","MUNICIPIUL CRAIOVA",1,69900,1,1,1335,776,704,72,754,22,1500,724,584,170,
17,"DOLJ",163,69900,,113,0,"Gradinita ELECTROPUTERE Str. Calea Bucuresti nr. 128","MUNICIPIUL CRAIOVA",1,69900,1,1,1525,953,892,61,873,19,1700,747,649,224,
17,"DOLJ",163,69900,,114,0,"Scoala nr. 35, Str. N. Julea","MUNICIPIUL CRAIOVA",1,69900,1,1,1750,948,880,68,935,13,2000,1052,664,271,
17,"DOLJ",163,69900,,115,0,"Grupul Scolar ""Matei Basarab""  (Nr. 7) Str. Vasile Alecsandri nr. 93","MUNICIPIUL CRAIOVA",1,69900,1,1,2600,1090,1043,47,1086,4,2600,1510,753,333,
17,"DOLJ",163,69900,,116,0,"Scoala nr. 35, Str. N. Julea","MUNICIPIUL CRAIOVA",1,69900,1,1,2325,1256,1180,76,1243,13,2600,1344,826,417,
17,"DOLJ",163,69900,,117,0,"Scoala Gen. ""Titu Maiorescu"" nr. 11  I, Str. I. G. Duca nr. 6","MUNICIPIUL CRAIOVA",1,69900,1,1,2355,1314,1261,53,1294,20,2700,1386,848,446,
17,"DOLJ",163,69900,,118,0,"Scoala Gen. ""Titu Maiorescu"" nr. 11  II, Str. I. G. Duca nr. 6","MUNICIPIUL CRAIOVA",1,69900,1,1,2272,1126,1084,42,1104,22,2600,1474,760,344,
17,"DOLJ",163,69900,,119,0,"Scoala Gen. nr. 39  I Str. Traian Lalescu","MUNICIPIUL CRAIOVA",1,69900,1,1,2442,1381,1281,100,1369,12,2700,1319,879,490,
17,"DOLJ",163,69900,,120,0,"Scoala Gen. nr. 39  II Str. Henri Coanda","MUNICIPIUL CRAIOVA",1,69900,1,1,2258,1230,1152,78,1214,16,2500,1270,808,406,
17,"DOLJ",163,69900,,121,0,"Gradinita nr. 14 Str. M. Strajan","MUNICIPIUL CRAIOVA",1,69900,1,1,1878,1015,967,48,999,16,2100,1085,685,314,
17,"DOLJ",163,69900,,122,0,"Facultatea de Mecanica Str. Calea Bucuresti nr. 165","MUNICIPIUL CRAIOVA",1,69900,1,1,1296,1054,710,344,1032,22,1500,446,728,304,
17,"DOLJ",163,69900,,123,0,"S.C. NOVUS S.A. (CLDC) Str. Traian Lalescu nr. 97","MUNICIPIUL CRAIOVA",1,69900,1,1,1700,834,792,42,826,8,1700,866,565,261,
17,"DOLJ",163,69900,,124,0,"Grupul Scolar Industrial Constructii de Masini nr. 1 (Lic. Tudor Arghezi) Str. Tehnicii nr. 2","MUNICIPIUL CRAIOVA",1,69900,1,1,1845,782,751,31,781,1,2000,1218,492,289,
17,"DOLJ",163,69900,,125,0,"Gradinita nr.31 Bulevardul Decebal","MUNICIPIUL CRAIOVA",1,69900,1,1,1846,967,899,68,955,12,2100,1133,585,370,
17,"DOLJ",163,69900,,126,0,"Grupul Scolar Industrial Constructii de Masini nr. 1 (Tudor Arghezi) nr. 1 Str. Tehnicii nr. 2","MUNICIPIUL CRAIOVA",1,69900,1,1,1505,770,710,60,765,5,1700,930,485,280,
17,"DOLJ",163,69900,,127,0,"SERVICIUL AJUTOR SOCIAL Str. Eustatiu Stoenescu bl.T8","MUNICIPIUL CRAIOVA",1,69900,1,1,2088,1224,1100,124,1216,8,2302,1078,732,484,
17,"DOLJ",163,69900,,128,0,"Scoala Gen. ""Mihai Eminescu""  (nr. 37) Str. Ion Tuculescu","MUNICIPIUL CRAIOVA",1,69900,1,1,1689,905,831,74,893,12,1900,995,556,337,
17,"DOLJ",163,69900,,129,0,"Scoala Gen. CERNELE  I","MUNICIPIUL CRAIOVA",1,69900,1,1,1465,683,583,100,677,6,1600,917,376,301,
17,"DOLJ",163,69900,,130,0,"Scoala Gen. CERNELE  II","MUNICIPIUL CRAIOVA",1,69900,1,1,1204,516,437,79,508,8,1500,984,299,209,
17,"DOLJ",163,69900,,131,0,"Scoala Gen. ROVINE Sat  ROVINE","MUNICIPIUL CRAIOVA",1,69900,1,1,411,309,221,88,306,3,500,191,177,129,
17,"DOLJ",163,69900,,132,1,"Spitalul nr. 1 B-dul Maresal Ion Antonescu","MUNICIPIUL CRAIOVA",1,69900,1,1,0,905,0,905,893,12,1100,195,611,282,
17,"DOLJ",163,69900,,133,1,"Spitalul nr. 2 B-dul Nicolae Titulescu","MUNICIPIUL CRAIOVA",1,69900,1,1,0,227,0,227,225,2,300,73,153,72,
17,"DOLJ",163,69900,,134,1,"Spitalul nr. 3 Str. Calea Bucuresti nr. 126","MUNICIPIUL CRAIOVA",1,69900,1,1,0,272,0,272,269,3,301,29,201,68,
17,"DOLJ",163,69900,,135,1,"Camin Spital BOLNAVI CRONICI, Str. Tabaci","MUNICIPIUL CRAIOVA",1,69900,1,1,0,237,0,237,230,7,301,64,143,87,
17,"DOLJ",163,69900,,136,1,"UM 01266, Str. Caracal nr. 128","MUNICIPIUL CRAIOVA",1,69900,1,1,0,441,0,441,422,19,500,59,259,163,
17,"DOLJ",163,69900,,137,1,"UM 01047 Str. Caracal nr. 155","MUNICIPIUL CRAIOVA",1,69900,1,1,0,150,0,150,142,8,200,50,93,49,
17,"DOLJ",163,69900,,138,1,"UM 01456 Str. Bechetului nr. 51","MUNICIPIUL CRAIOVA",1,69900,1,1,134,187,130,57,184,3,300,113,80,104,
17,"DOLJ",163,69900,,139,1,"UM 01820 Str. Calea Bucuresti nr. 433","MUNICIPIUL CRAIOVA",1,69900,1,1,0,239,0,239,229,10,400,161,128,101,
17,"DOLJ",163,69900,,140,1,"UM 0654 Str. Alexandru Macedonski","MUNICIPIUL CRAIOVA",1,69900,1,1,546,577,517,60,559,18,1005,428,362,197,
17,"DOLJ",163,69900,,141,1,"UM 01662, Str. Vasile Alecsandri nr. 77-79","MUNICIPIUL CRAIOVA",1,69900,1,1,868,863,0,863,840,23,1000,137,499,341,
17,"DOLJ",163,69900,,142,0,"Scoala Izvorul Rece","MUNICIPIUL CRAIOVA",1,69900,1,1,406,275,195,80,272,3,500,225,187,85,
17,"DOLJ",163,70352,,143,0,"Camin cult. Golenti","MUNICIPIUL CALAFAT",2,70352,1,1,503,319,252,67,316,3,600,281,201,115,
17,"DOLJ",163,70352,,144,0,"Camin cult. Basarabi","MUNICIPIUL CALAFAT",2,70352,1,1,1020,587,511,76,579,8,1187,600,383,196,
17,"DOLJ",163,70352,,145,0,"Camin cult. Ciupercenii Vechi","MUNICIPIUL CALAFAT",2,70352,1,1,2040,1205,1085,120,1193,12,2300,1095,749,444,
17,"DOLJ",163,70352,,146,0,"Sc. gen. nr.1 Calafat","MUNICIPIUL CALAFAT",2,70352,1,1,2481,1248,991,257,1245,3,2800,1552,781,464,
17,"DOLJ",163,70352,,147,0,"Lic.Teoretic  Independenta Calafat","MUNICIPIUL CALAFAT",2,70352,1,1,2087,1106,1069,37,1101,5,2400,1294,761,340,
17,"DOLJ",163,70352,,148,0,"Clubul copiilor si elevilor Calafat","MUNICIPIUL CALAFAT",2,70352,1,1,1615,848,771,77,836,12,1800,952,569,267,
17,"DOLJ",163,70352,,149,0,"Sc. gen. nr.2. Calafat (localul nou)","MUNICIPIUL CALAFAT",2,70352,1,1,2162,1060,913,147,1042,18,2400,1340,687,355,
17,"DOLJ",163,70352,,150,0,"Sc. gen. nr.2. Calafat (localul vechi)","MUNICIPIUL CALAFAT",2,70352,1,1,2280,1011,932,79,1000,11,2600,1589,610,390,
17,"DOLJ",163,70352,,151,0,"Gradinita de copii nr.4.","MUNICIPIUL CALAFAT",2,70352,1,1,2537,1213,1060,153,1205,8,2900,1687,706,499,
17,"DOLJ",163,70316,,152,0,"Sc. gen. nr.1","ORAS BAILESTI",3,70316,2,1,1453,840,787,53,832,8,1700,860,487,345,
17,"DOLJ",163,70316,,153,0,"Gradinita nr.3.","ORAS BAILESTI",3,70316,2,1,1210,629,566,63,619,10,1400,771,364,255,
17,"DOLJ",163,70316,,154,0,"Sc. gen. nr.3.","ORAS BAILESTI",3,70316,2,1,1286,560,511,49,558,2,1500,940,315,243,
17,"DOLJ",163,70316,,155,0,"Sc. gen. nr.5.","ORAS BAILESTI",3,70316,2,1,1644,843,768,75,836,7,1900,1057,452,384,
17,"DOLJ",163,70316,,156,0,"Sc. gen. nr.3.","ORAS BAILESTI",3,70316,2,1,1183,692,621,71,689,3,1300,608,389,300,
17,"DOLJ",163,70316,,157,0,"Gradinita nr.7.","ORAS BAILESTI",3,70316,2,1,1030,540,508,32,533,7,1200,660,296,237,
17,"DOLJ",163,70316,,158,0,"Sc. gen. nr.4","ORAS BAILESTI",3,70316,2,1,1482,827,759,68,809,18,1700,873,542,267,
17,"DOLJ",163,70316,,159,0,"Gradinita nr.8.","ORAS BAILESTI",3,70316,2,1,1226,702,646,56,689,13,1400,698,341,348,
17,"DOLJ",163,70316,,160,0,"Lic. agroind.","ORAS BAILESTI",3,70316,2,1,1196,680,585,95,669,11,1400,720,386,283,
17,"DOLJ",163,70316,,161,0,"Sc. gen. nr.2.","ORAS BAILESTI",3,70316,2,1,1511,907,855,52,890,17,1700,793,603,287,
17,"DOLJ",163,70316,,162,0,"Gradinita nr.6.","ORAS BAILESTI",3,70316,2,1,1487,755,701,54,751,4,1700,945,389,362,
17,"DOLJ",163,70316,,163,0,"Sc. gen. nr.6","ORAS BAILESTI",3,70316,2,1,1742,884,800,84,872,12,1902,1018,507,365,
17,"DOLJ",163,70316,,164,0,"Sc. gen. sat Balasan","ORAS BAILESTI",3,70316,2,1,507,363,318,45,358,5,600,237,209,149,
17,"DOLJ",163,70414,,165,0,"Sc. gen.","ORAS FILIASI",4,70414,2,1,2754,1465,1381,84,1451,14,3100,1635,828,623,
17,"DOLJ",163,70414,,166,0,"Gr. scolar","ORAS FILIASI",4,70414,2,1,2628,1426,1339,87,1402,24,3000,1574,902,500,
17,"DOLJ",163,70414,,167,0,"Gradinita nr.2.","ORAS FILIASI",4,70414,2,1,1587,957,862,95,952,5,1800,843,528,424,
17,"DOLJ",163,70414,,168,0,"Gradinita nr.3.","ORAS FILIASI",4,70414,2,1,3505,1634,1531,103,1623,11,3900,2266,962,661,
17,"DOLJ",163,70414,,169,0,"Sc. gen. Racari","ORAS FILIASI",4,70414,2,1,924,646,593,53,632,14,1100,454,468,164,
17,"DOLJ",163,70414,,170,0,"Sc.gen. Fratostita","ORAS FILIASI",4,70414,2,1,1985,1184,1086,98,1178,6,2200,1016,568,610,
17,"DOLJ",163,70414,,171,0,"Sc. gen. B@lta","ORAS FILIASI",4,70414,2,1,880,606,545,61,590,16,1000,394,340,250,
17,"DOLJ",163,70414,,172,1,"U.M. 01414 Filiasi","ORAS FILIASI",4,70414,2,1,0,74,0,74,74,0,100,26,41,33,
17,"DOLJ",163,70502,,173,0,"Gr. scolar Horia Vintila","ORAS SEGARCEA",5,70502,2,1,1836,972,922,50,957,15,2100,1128,704,253,
17,"DOLJ",163,70502,,174,0,"Sc.gen. cu clasele I-VIII","ORAS SEGARCEA",5,70502,2,1,1371,768,712,56,760,8,1600,832,572,188,
17,"DOLJ",163,70502,,175,0,"Casa de cultura","ORAS SEGARCEA",5,70502,2,1,1678,970,893,77,966,4,1900,930,644,322,
17,"DOLJ",163,70502,,176,0,"Clubul copiilor","ORAS SEGARCEA",5,70502,2,1,1561,842,783,59,831,11,1800,958,615,216,
17,"DOLJ",163,70520,,177,0,"Consiliul Local Afumati","AFUMATI",6,70520,0,3,1192,1000,855,145,946,54,1400,400,604,342,
17,"DOLJ",163,70520,,178,0,"Sc. Gen. Boureni","AFUMATI",6,70520,0,3,953,640,506,134,632,8,1100,460,391,241,
17,"DOLJ",163,70520,,179,0,"Camin Cultural Covei","AFUMATI",6,70520,0,3,495,340,259,81,337,3,600,260,216,121,
17,"DOLJ",163,70566,,180,0,"Camin Cultural Almaj","ALMAJ",7,70566,0,3,1766,778,692,86,767,11,2000,1222,559,208,
17,"DOLJ",163,70566,,181,0,"Sc. Gen. I-VIII Cotofenii din Fata","ALMAJ",7,70566,0,3,1304,743,612,131,734,9,1500,757,576,158,
17,"DOLJ",163,70637,,182,0,"Caminul cultural Amarastii de Jos","AMARASTII DE JOS",8,70637,0,3,1654,738,582,156,728,10,1900,1162,471,257,
17,"DOLJ",163,70637,,183,0,"Gradinita Tosca sat Amarastii de Jos","AMARASTII DE JOS",8,70637,0,3,938,586,433,153,582,4,1100,514,414,168,
17,"DOLJ",163,70637,,184,0,"Gradinita Prapor, sat Prapor","AMARASTII DE JOS",8,70637,0,3,1359,804,739,65,798,6,1500,696,535,263,
17,"DOLJ",163,70637,,185,0,"Scoala Ocolna, sat Ocolna","AMARASTII DE JOS",8,70637,0,3,589,411,376,35,402,9,700,289,391,11,
17,"DOLJ",163,70673,,186,0,"Sat Amarastii de Sus","AMARASTII DE SUS",9,70673,0,3,1505,1029,901,128,1010,19,1700,671,735,275,
17,"DOLJ",163,70673,,187,0,"Sat Dobrotesti","AMARASTII DE SUS",9,70673,0,3,1608,1521,1375,146,1501,20,1800,279,1091,410,
17,"DOLJ",163,70726,,188,0,"Clubul Camin Cultural Apele Vii","APELE VII",10,70726,0,3,1972,1067,930,137,1055,12,2200,1133,761,294,
17,"DOLJ",163,70744,,189,0,"Sc. Gen. Argetoaia","ARGETOAIA",11,70744,0,3,1336,728,589,139,719,9,1500,772,554,165,
17,"DOLJ",163,70744,,190,0,"Sc. Gen. Argetoaia","ARGETOAIA",11,70744,0,3,540,329,220,109,326,3,600,271,212,114,
17,"DOLJ",163,70744,,191,0,"Sc. Gen. Salcia","ARGETOAIA",11,70744,0,3,1050,779,694,85,770,9,1200,421,441,329,
17,"DOLJ",163,70744,,192,0,"Sc. Gen. Piria","ARGETOAIA",11,70744,0,3,421,213,149,64,209,4,500,287,135,74,
17,"DOLJ",163,70744,,193,0,"Sc. Gen. Leordoasa","ARGETOAIA",11,70744,0,3,333,264,205,59,256,8,400,136,152,104,
17,"DOLJ",163,70879,,194,0,"Scoala primara Bechet","BECHET",12,70879,0,3,952,493,390,103,482,11,1100,607,357,125,
17,"DOLJ",163,70879,,195,0,"Lic. Teoretic Bechet","BECHET",12,70879,0,3,2179,1168,1013,155,1158,10,2500,1332,835,323,
17,"DOLJ",163,70897,,196,0,"Sc. Gen. Bistret - centru","BISTRET",14,70897,0,3,1036,628,412,216,608,17,1200,572,442,166,
17,"DOLJ",163,70897,,197,0,"Sc. Gen. Bistretu - stadion","BISTRET",14,70897,0,3,855,513,362,151,506,7,1000,487,373,133,
17,"DOLJ",163,70897,,198,0,"Sc. Gen. Bistretu Nou","BISTRET",14,70897,0,3,810,417,289,128,413,4,900,483,296,117,
17,"DOLJ",163,70897,,199,0,"Sc. Gen. sat Plosca","BISTRET",14,70897,0,3,803,492,392,100,488,4,1100,608,403,85,
17,"DOLJ",163,70940,,200,0,"Caminul cultural","BIRCA",13,70940,0,3,1910,1054,934,120,1044,10,2200,1146,839,205,
17,"DOLJ",163,70940,,201,0,"Sala mare de sedinta a Primariei Barca","BIRCA",13,70940,0,3,1625,863,746,117,852,11,1800,937,708,144,
17,"DOLJ",163,70968,,202,0,"Sc. Gen. Botosesti Paia","BOTOSESTI-PAIA",15,70968,0,3,836,660,579,81,648,12,1000,340,466,182,
17,"DOLJ",163,70986,,203,0,"Sc.gen.cls.I-VIII Brabova","BRABOVA",16,70986,0,3,584,430,373,57,421,9,700,270,340,81,
17,"DOLJ",163,70986,,204,0,"Camin cult.sat Urdinita","BRABOVA",16,70986,0,3,434,314,270,44,307,6,500,187,219,88,
17,"DOLJ",163,70986,,205,0,"Sc.gen.cls.I-IV Rachita de Jos","BRABOVA",16,70986,0,3,402,265,234,31,263,2,500,235,198,65,
17,"DOLJ",163,70986,,206,0,"Sc.gen.cls.I-VIII Mosna","BRABOVA",16,70986,0,3,209,207,165,42,205,2,300,93,162,43,
17,"DOLJ",163,71055,,207,0,"sediul primariei Bradesti","BRADESTI",17,71055,0,3,1381,742,540,202,733,9,1602,860,473,260,
17,"DOLJ",163,71055,,208,0,"Sc.gen.Bradestii Batr@ni","BRADESTI",17,71055,0,3,379,311,213,98,306,5,500,189,208,98,
17,"DOLJ",163,71055,,209,0,"Sc.gen. Tatomiresti","BRADESTI",17,71055,0,3,746,563,453,110,533,30,700,137,365,168,
17,"DOLJ",163,71055,,210,0,"Sc.gen.Racarii de Jos","BRADESTI",17,71055,0,3,719,488,389,99,482,6,800,312,307,175,
17,"DOLJ",163,71055,,211,0,"Sc.gen. Piscani","BRADESTI",17,71055,0,3,190,137,75,62,135,2,300,163,110,25,
17,"DOLJ",163,71126,,212,0,"Sc. Bralostita","BRALOSTITA",18,71126,0,3,1855,994,910,84,978,16,2100,1106,613,365,
17,"DOLJ",163,71126,,213,0,"Sc. Valea Fantanilor","BRALOSTITA",18,71126,0,3,906,633,530,103,624,9,1100,467,366,258,
17,"DOLJ",163,71199,,214,0,"Scoala sat Badosi","BRATOVOESTI",19,71199,0,3,722,477,336,141,470,7,800,323,287,183,
17,"DOLJ",163,71199,,215,0,"Scoala sat  Prunet","BRATOVOESTI",19,71199,0,3,511,377,310,67,369,8,600,223,228,141,
17,"DOLJ",163,71199,,216,0,"Scoala sat Bratovoesti","BRATOVOESTI",19,71199,0,3,1184,738,578,160,727,11,1400,662,498,229,
17,"DOLJ",163,71199,,217,0,"Scoala sat Georocu Mare","BRATOVOESTI",19,71199,0,3,462,309,233,76,306,3,600,291,240,66,
17,"DOLJ",163,71199,,218,0,"Scoala sat Rojiste","BRATOVOESTI",19,71199,0,3,1289,760,615,145,751,9,1500,740,514,237,
17,"DOLJ",163,71199,,219,0,"Scoala sat Tamburesti","BRATOVOESTI",19,71199,0,3,447,320,215,105,316,4,500,180,246,70,
17,"DOLJ",163,71260,,220,0,"Sc.gen.Breasta","BREASTA",20,71260,0,3,1464,836,750,86,819,17,1700,864,510,309,
17,"DOLJ",163,71260,,221,0,"Sc.gen.Breasta","BREASTA",20,71260,0,3,1336,777,675,102,770,7,1500,720,468,302,
17,"DOLJ",163,69964,,222,0,"Camin Cultural Bucovat","BUCOVAT",21,69964,0,3,1440,687,569,118,682,5,1600,913,402,280,
17,"DOLJ",163,69964,,223,0,"Sanatoriul TBC Leamna","BUCOVAT",21,69964,0,3,418,334,181,153,333,1,500,166,203,130,
17,"DOLJ",163,69964,,224,0,"Sc. Gen. Palilula","BUCOVAT",21,69964,0,3,639,353,272,81,350,3,800,447,152,198,
17,"DOLJ",163,69964,,225,0,"Sc. Gen. Sarbatoarea","BUCOVAT",21,69964,0,3,613,383,298,85,317,66,700,317,212,105,
17,"DOLJ",163,71340,,226,0,"Camin Cultural Bulzesti","BULZESTI",22,71340,0,3,843,625,455,170,610,15,1000,375,442,168,
17,"DOLJ",163,71340,,227,0,"Sala de sedinte a Soc. Agr. Fratila(fost sediu CAP Fratila)","BULZESTI",22,71340,0,3,736,560,435,125,552,8,900,340,430,122,
17,"DOLJ",163,71457,,228,0,"Sc. Gen. Calopar","CALOPAR",24,71457,0,3,1114,551,440,111,538,13,1302,751,324,214,
17,"DOLJ",163,71457,,229,0,"Sc. Gen. sat Belcin","CALOPAR",24,71457,0,3,587,364,306,58,358,6,700,336,241,117,
17,"DOLJ",163,71457,,230,0,"Sc. Gen. sat  Panaghia","CALOPAR",24,71457,0,3,1222,589,498,91,576,13,1400,811,369,207,
17,"DOLJ",163,71518,,231,0,"Camin Cultural","CARAULA",25,71518,0,3,1970,1312,1148,164,1290,22,2200,888,992,298,
17,"DOLJ",163,71536,,232,0,"Sc.gen..cl.I-VIII Carpen","CARPEN",26,71536,0,3,1066,1116,1017,99,1003,14,1200,183,837,166,
17,"DOLJ",163,71536,,233,0,"Sc.gen.cl.I-VIII Cleanov","CARPEN",26,71536,0,3,1356,1089,980,109,1079,10,1500,411,798,281,
17,"DOLJ",163,71572,,234,0,"Camin cult. Castranova","CASTRANOVA",27,71572,0,3,1635,1008,868,140,991,17,1900,892,666,325,
17,"DOLJ",163,71572,,235,0,"Sc.gen.Puturi","CASTRANOVA",27,71572,0,3,1127,1026,869,157,1012,14,1300,274,858,154,
17,"DOLJ",163,71607,,236,0,"Sc. Gen. Calarasi","CALARASI",23,71607,0,3,1732,903,787,116,894,9,2000,1097,508,386,
17,"DOLJ",163,71607,,237,0,"Camin Cultural","CALARASI",23,71607,0,3,1959,1001,884,117,994,7,2200,1199,630,364,
17,"DOLJ",163,71607,,238,0,"Scoala Generala sat Sarata","CALARASI",23,71607,0,3,1743,1066,945,121,1053,11,2000,936,675,378,
17,"DOLJ",163,71634,,239,0,"Sc.gen.nr.1. Celaru","CELARU",28,71634,0,3,1043,570,475,95,563,7,1200,630,397,166,
17,"DOLJ",163,71634,,240,0,"Sc.cl.I-VIII Celaru","CELARU",28,71634,0,3,1224,595,507,88,585,10,1400,805,360,225,
17,"DOLJ",163,71634,,241,0,"Camin cult.Ghizdavesti","CELARU",28,71634,0,3,1431,703,595,108,681,22,1600,897,440,241,
17,"DOLJ",163,71634,,242,0,"Sc.gen.Marotinu de Sus","CELARU",28,71634,0,3,655,355,281,74,345,10,800,445,249,96,
17,"DOLJ",163,71698,,243,0,"Camin cult.  Cerat","CERAT",29,71698,0,3,1890,1105,957,148,1088,17,2100,995,839,249,
17,"DOLJ",163,71698,,244,0,"Sc.gen.cl.I-IV Cerat","CERAT",29,71698,0,3,1085,633,527,106,612,21,1200,567,468,144,
17,"DOLJ",163,71723,,245,0,"Gradinita Tiu","CERNATESTI",30,71723,0,3,453,352,267,85,347,5,502,150,166,181,
17,"DOLJ",163,71723,,246,0,"Camin Cultural Cernatesti","CERNATESTI",30,71723,0,3,614,376,331,45,361,15,702,326,269,92,
17,"DOLJ",163,71723,,247,0,"Sc. Gen. Cornita","CERNATESTI",30,71723,0,3,248,209,167,42,202,7,300,91,132,70,
17,"DOLJ",163,71723,,248,0,"Sc. Gen. Rasnic","CERNATESTI",30,71723,0,3,515,346,308,38,336,10,602,256,176,160,
17,"DOLJ",163,71787,,249,0,"Sc.primara Cetate","CETATE",31,71787,0,3,1907,1095,900,195,1057,38,2100,1005,704,353,
17,"DOLJ",163,71787,,250,0,"Caminul cult.","CETATE",31,71787,0,3,1513,930,647,283,907,23,1700,770,509,398,
17,"DOLJ",163,71787,,251,0,"Sc. Gen. Fantana Banului","CETATE",31,71787,0,3,891,564,442,122,555,9,1000,436,378,177,
17,"DOLJ",163,71787,,252,0,"Sc.primara Moreni","CETATE",31,71787,0,3,552,528,478,50,527,1,700,172,395,132,
17,"DOLJ",163,71812,,253,0,"Camin Cultural Cioroiasi","CIOROIASI",32,71812,0,3,1128,539,462,77,533,6,1300,761,288,245,
17,"DOLJ",163,71812,,254,0,"Sc. Gen. Cioroiu Nou","CIOROIASI",32,71812,0,3,517,366,285,81,360,6,600,234,266,94,
17,"DOLJ",163,71858,,255,0,"Sc. Gen. Ciupercenii Noi","CIUPERCENII NOI",33,71858,0,3,1940,1150,1022,128,1131,19,2200,1050,749,382,
17,"DOLJ",163,71858,,256,0,"Camin Cult. Ciupercenii Noi","CIUPERCENII NOI",33,71858,0,3,1717,1049,962,87,1038,11,1900,851,660,378,
17,"DOLJ",163,71858,,257,0,"Sc. Gen. Smardan","CIUPERCENII NOI",33,71858,0,3,1162,821,697,124,819,2,1300,479,570,249,
17,"DOLJ",163,71885,,258,0,"Camin Cultural Cosoveni","COSOVENI",34,71885,0,3,1734,947,778,169,924,23,2000,1053,604,320,
17,"DOLJ",163,71885,,259,0,"Fost sediu al CAP Cosoveni","COSOVENI",34,71885,0,3,679,368,263,105,362,6,800,428,266,96,
17,"DOLJ",163,71885,,260,0,"Sc. Gen Carcea","COSOVENI",34,71885,0,3,1185,700,575,125,687,13,1400,700,454,233,
17,"DOLJ",163,71910,,261,0,"Sc.gen. I-VIII Cotofenii din Dos","COTOFENII DIN DOS",35,71910,0,3,945,624,576,48,615,9,1100,476,376,239,
17,"DOLJ",163,71910,,262,0,"Sc. cl.I-VIII Mihaita","COTOFENII DIN DOS",35,71910,0,3,1082,622,576,46,613,9,1200,578,442,171,
17,"DOLJ",163,71956,,263,0,"Camin.cult. Daneti","DANETI",37,71956,0,3,1966,766,676,90,753,13,2200,1434,427,326,
17,"DOLJ",163,71956,,264,0,"Sc.gen.nr.1.Daneti","DANETI",37,71956,0,3,1874,591,542,49,580,11,2102,1511,315,265,
17,"DOLJ",163,71956,,265,0,"Sc.gen.nr.1. Locusteni","DANETI",37,71956,0,3,1128,645,509,136,637,8,1300,655,449,188,
17,"DOLJ",163,71956,,266,0,"Sc.gen.Brabeti","DANETI",37,71956,0,3,857,471,348,123,462,9,1000,529,292,170,
17,"DOLJ",163,72007,,267,0,"Lic. teoretic Dabuleni","DABULENI",36,72007,0,3,1718,1003,798,205,997,6,1900,897,755,242,
17,"DOLJ",163,72007,,268,0,"Clubul copiilor Dabuleni","DABULENI",36,72007,0,3,2153,1104,923,181,1090,14,2400,1296,802,288,
17,"DOLJ",163,72007,,269,0,"Sc. Gen. nr. 1 Nord","DABULENI",36,72007,0,3,1364,873,574,299,866,7,1600,727,659,207,
17,"DOLJ",163,72007,,270,0,"Sc. Gen. nr. 1 Sud","DABULENI",36,72007,0,3,1918,1041,848,193,1022,19,2200,1159,783,239,
17,"DOLJ",163,72007,,271,0,"Sc. Gen. nr. 2","DABULENI",36,72007,0,3,1512,878,704,174,871,7,1700,822,668,203,
17,"DOLJ",163,72007,,272,0,"Sc. Gen. nr. 3 - intrare elevi","DABULENI",36,72007,0,3,1533,940,725,215,925,15,1700,760,664,261,
17,"DOLJ",163,72007,,273,0,"Sc. Gen. nr. 3 - intrare prof.","DABULENI",36,72007,0,3,1408,789,635,154,785,4,1600,811,567,218,
17,"DOLJ",163,72034,,274,0,"Sc. Gen. Desa - local vechi - partea de vest","DESA",38,72034,0,3,2029,1198,1163,35,1176,22,2300,1102,784,392,
17,"DOLJ",163,72034,,275,0,"Sc. Gen. Desa - local vechi - partea de est","DESA",38,72034,0,3,1810,1055,1007,48,1037,18,2100,1045,777,260,
17,"DOLJ",163,72052,,276,0,"Camin cultural","DIOSTI",39,72052,0,3,1026,588,500,88,581,7,1200,612,377,204,
17,"DOLJ",163,72052,,277,0,"Scoala veche","DIOSTI",39,72052,0,3,889,559,480,79,555,4,1000,441,403,152,
17,"DOLJ",163,72052,,278,0,"Scoala Ciocanesti","DIOSTI",39,72052,0,3,669,442,369,73,432,10,800,358,260,172,
17,"DOLJ",163,72098,,279,0,"sat Dobresti","DOBRESTI",40,72098,0,3,914,567,518,49,567,0,1100,533,425,142,
17,"DOLJ",163,72098,,280,0,"sat Caciulatesti","DOBRESTI",40,72098,0,3,471,389,288,101,387,2,600,211,285,102,
17,"DOLJ",163,72098,,281,0,"sat Murta","DOBRESTI",40,72098,0,3,843,566,490,76,558,8,1000,434,389,169,
17,"DOLJ",163,72150,,282,0,"Sc.Dragotesti","DRAGOTESTI",41,72150,0,3,1244,799,664,135,788,11,1400,601,582,206,
17,"DOLJ",163,72150,,283,0,"Scoala Popanzalesti","DRAGOTESTI",41,72150,0,3,542,404,289,115,400,4,700,296,290,110,
17,"DOLJ",163,72150,,284,0,"Scoala Buzduc","DRAGOTESTI",41,72150,0,3,149,162,88,74,158,4,200,38,115,43,
17,"DOLJ",163,72221,,285,0,"Camin Cultural Dranic","DRANIC",42,72221,0,3,1331,623,537,86,613,10,1500,877,396,217,
17,"DOLJ",163,72221,,286,0,"Camin Cultural Padea","DRANIC",42,72221,0,3,863,514,459,55,511,3,1002,485,328,183,
17,"DOLJ",163,72221,,287,0,"Scoala Foisor","DRANIC",42,72221,0,3,369,223,195,28,219,4,502,277,192,27,
17,"DOLJ",163,72276,,288,0,"Camin cultural Farcas","FARCAS",43,72276,0,3,1609,1700,1519,181,1660,40,1800,100,1439,221,
17,"DOLJ",163,72276,,289,0,"Sc. Gen. Talpas","FARCAS",43,72276,0,3,872,624,443,181,620,4,1000,376,406,214,
17,"DOLJ",163,72383,,290,0,"Sc. Galicea Mare-localul nr.1","GALICEA MARE",44,72383,0,3,1413,768,686,82,758,10,1600,832,453,305,
17,"DOLJ",163,72383,,291,0,"Sc. Galicea Mare-localul nr.3","GALICEA MARE",44,72383,0,3,1127,598,565,33,592,6,1300,702,382,210,
17,"DOLJ",163,72383,,292,0,"Sc. Galicea Mare-localul nr.4","GALICEA MARE",44,72383,0,3,1404,692,648,44,677,15,1600,908,451,226,
17,"DOLJ",163,72409,,293,0,"Camin Cultural Ghercesti","GHERCESTI",45,72409,0,3,997,730,642,88,727,3,1102,372,502,225,
17,"DOLJ",163,72409,,294,0,"Asoc. agricola CERES UNGURENI","GHERCESTI",45,72409,0,3,417,393,341,52,390,3,500,107,332,58,
17,"DOLJ",163,72463,,295,0,"Camin cultural","GIGHERA",46,72463,0,3,1084,645,521,124,634,11,1200,555,497,137,
17,"DOLJ",163,72463,,296,0,"Camin cultural Nedeia","GIGHERA",46,72463,0,3,1072,625,483,142,612,13,1200,575,480,132,
17,"DOLJ",163,72463,,297,0,"Sc. Gen. Zaval","GIGHERA",46,72463,0,3,814,486,386,100,475,11,900,414,324,151,
17,"DOLJ",163,72506,,298,0,"Sc. Gen. de 4 ani Giubega","GIUBEGA",48,72506,0,3,938,508,444,64,502,6,1100,592,246,256,
17,"DOLJ",163,72506,,299,0,"Camin Cultural","GIUBEGA",48,72506,0,3,1050,598,518,80,595,3,1200,602,341,254,
17,"DOLJ",163,72506,,300,0,"Sc. Gen. sat Galiciuica","GIUBEGA",48,72506,0,3,1331,736,609,127,731,5,1500,764,431,300,
17,"DOLJ",163,72533,,301,0,"Sc. Gen. Giurgita","GIURGITA",49,72533,0,3,1318,676,551,125,667,9,1500,824,462,205,
17,"DOLJ",163,72533,,302,0,"Gradinita Portaresti","GIURGITA",49,72533,0,3,962,511,365,146,505,6,1000,489,367,138,
17,"DOLJ",163,72533,,303,0,"Sc. Gen. Curmatura","GIURGITA",49,72533,0,3,570,376,272,104,371,5,700,324,277,94,
17,"DOLJ",163,72579,,304,0,"sat GANGIOVA","GINGIOVA",47,72579,0,3,1476,968,861,107,956,12,1700,732,655,301,
17,"DOLJ",163,72579,,305,0,"Camin cult. Comosteni","GINGIOVA",47,72579,0,3,993,657,512,145,652,5,1100,443,503,149,
17,"DOLJ",163,72604,,306,0,"Caminul cult.  Gogosu","GOGOSU",50,72604,0,3,598,376,291,85,372,4,700,324,216,156,
17,"DOLJ",163,72604,,307,0,"Camin cult. Gogosita","GOGOSU",50,72604,0,3,310,275,216,59,274,1,400,125,173,101,
17,"DOLJ",163,72640,,308,0,"Sc.sat Goicea Mica","GOICEA",51,72640,0,3,1046,573,428,145,566,7,1200,627,393,173,
17,"DOLJ",163,72640,,309,0,"Camin cult.Goicea Mare","GOICEA",51,72640,0,3,1606,812,590,222,793,19,1800,988,579,214,
17,"DOLJ",163,72640,,310,0,"Sc.sat Carna","GOICEA",51,72640,0,3,1213,857,767,90,838,19,1500,643,695,143,
17,"DOLJ",163,72677,,311,0,"Camin cultural","GOIESTI",52,72677,0,3,1085,532,384,148,517,15,1300,768,338,179,
17,"DOLJ",163,72677,,312,0,"Sc. Gen. I-IV Mogosesti","GOIESTI",52,72677,0,3,339,251,174,77,249,2,400,149,175,74,
17,"DOLJ",163,72677,,313,0,"Sc. Gen. I-IV Malaiesti","GOIESTI",52,72677,0,3,543,350,258,92,341,9,700,350,203,138,
17,"DOLJ",163,72677,,314,0,"Sc. Gen. I-VIII Tandara","GOIESTI",52,72677,0,3,565,302,222,80,295,7,702,400,183,112,
17,"DOLJ",163,72819,,315,0,"Sc. Gen. I-IV Barboi","GRECESTI",53,72819,0,3,395,284,220,64,278,6,500,216,193,85,
17,"DOLJ",163,72819,,316,0,"Sc. Gen. I-VIII Grecesti","GRECESTI",53,72819,0,3,611,311,222,89,303,8,700,389,182,121,
17,"DOLJ",163,72819,,317,0,"Sc. Gen. I-VIII Busu","GRECESTI",53,72819,0,3,617,470,396,74,457,13,700,230,275,182,
17,"DOLJ",163,70094,,318,0,"Sc. Gen.","ISALNITA",54,70094,0,3,1891,941,941,0,932,9,2100,1159,662,270,
17,"DOLJ",163,70094,,319,0,"Camin Cultural","ISALNITA",54,70094,0,3,1117,799,610,189,791,8,1300,501,518,273,
17,"DOLJ",163,72882,,320,0,"Gradinita de copii Izvoare","IZVOARE",55,72882,0,3,1367,702,616,86,689,13,1500,798,414,275,
17,"DOLJ",163,72882,,321,0,"Sc. Gen. Corlate","IZVOARE",55,72882,0,3,320,315,242,73,313,2,400,85,242,71,
17,"DOLJ",163,72926,,322,0,"Scoala de fete Leu","LEU",56,72926,0,3,1742,928,822,106,904,24,2000,1072,658,246,
17,"DOLJ",163,72926,,323,0,"Scoala de baieti Leu","LEU",56,72926,0,3,1779,985,895,90,898,87,2000,1015,700,198,
17,"DOLJ",163,72926,,324,0,"Scoala veche Zanoaga","LEU",56,72926,0,3,1082,682,584,98,664,18,1200,518,391,273,
17,"DOLJ",163,72953,,325,0,"Sc.gen.de 8 ani Lipovu","LIPOVU",57,72953,0,3,1293,641,532,109,621,20,1600,959,477,144,
17,"DOLJ",163,72953,,326,0,"fostul CAP Lipovu","LIPOVU",57,72953,0,3,1059,567,472,95,561,6,1100,533,315,246,
17,"DOLJ",163,72980,,327,0,"Pct. muzeistic Macesu de Jos","MACESU DE JOS",58,72980,0,3,1110,573,520,53,572,1,1300,727,380,192,
17,"DOLJ",163,72980,,328,0,"Sc.gen.cl.I-VIII Sapata","MACESU DE JOS",58,72980,0,3,327,317,245,72,314,3,400,83,193,121,
17,"DOLJ",163,73013,,329,0,"Com. Macesu de Sus","MACESU DE SUS",59,73013,0,3,1468,934,847,87,927,7,1700,766,646,281,
17,"DOLJ",163,73031,,330,0,"Sc. gen. nr.1.","MAGLAVIT",60,73031,0,3,1946,2080,1914,166,1932,148,2200,120,1695,237,
17,"DOLJ",163,73031,,331,0,"Sc. gen. nr.2.","MAGLAVIT",60,73031,0,3,1350,1328,1124,204,1306,22,1500,172,1027,279,
17,"DOLJ",163,73031,,332,0,"Sc. gen. sat Hunia","MAGLAVIT",60,73031,0,3,1301,1408,1197,211,1397,11,1600,192,1047,350,
17,"DOLJ",163,73068,,333,0,"Camin cultural Malu Mare","MALU MARE",61,73068,0,3,1470,900,788,112,889,11,1700,800,610,279,
17,"DOLJ",163,73068,,334,0,"Sc.gen. Preajba","MALU MARE",61,73068,0,3,657,475,336,139,472,3,804,329,262,210,
17,"DOLJ",163,73068,,335,0,"Sc.gen.Ghindeni","MALU MARE",61,73068,0,3,1444,909,746,163,885,24,1600,691,537,348,
17,"DOLJ",163,73102,,336,0,"Camin cultural Melinesti","MELINESTI",63,73102,0,3,863,637,392,245,633,4,1000,363,433,200,
17,"DOLJ",163,73102,,337,0,"Gradinita Negoiesti","MELINESTI",63,73102,0,3,1436,800,623,177,788,12,1600,800,572,216,
17,"DOLJ",163,73102,,338,0,"Sc. Gen. Boddaesti","MELINESTI",63,73102,0,3,942,396,304,92,391,5,1100,704,236,155,
17,"DOLJ",163,73246,,339,0,"Sc. gen.  Mischii","MISCHII",64,73246,0,3,933,641,558,83,585,56,1100,459,370,215,
17,"DOLJ",163,73246,,340,0,"Sc. gen. Urechesti","MISCHII",64,73246,0,3,442,392,267,125,385,7,500,108,222,163,
17,"DOLJ",163,73317,,341,0,"Sc.gen.nr.2.","MARSANI",62,73317,0,3,1460,756,518,238,742,14,1700,944,432,310,
17,"DOLJ",163,73317,,342,0,"Sc.gen.nr.1.","MARSANI",62,73317,0,3,1539,673,508,165,663,10,1700,1027,400,263,
17,"DOLJ",163,73317,,343,0,"Sc.gen.nr.3.","MARSANI",62,73317,0,3,1397,729,578,151,720,9,1600,871,474,246,
17,"DOLJ",163,73335,,344,0,"Sc.gen. sat Motatei Gara","MOTATEI",65,73335,0,3,730,513,422,91,508,5,900,387,321,187,
17,"DOLJ",163,73335,,345,0,"Soc. Agricola FORTUNA","MOTATEI",65,73335,0,3,1973,1011,905,106,1003,8,2200,1189,562,441,
17,"DOLJ",163,73335,,346,0,"Sc.gen.nr.1.  sat Motatei","MOTATEI",65,73335,0,3,1464,709,615,94,698,11,1700,991,426,272,
17,"DOLJ",163,73335,,347,0,"Sc.gen.nr.2. Motatei","MOTATEI",65,73335,0,3,1855,969,864,105,958,11,2100,1131,518,440,
17,"DOLJ",163,73335,,348,0,"Sc.gen.   sat Dobridor","MOTATEI",65,73335,0,3,730,452,370,82,446,6,900,448,329,117,
17,"DOLJ",163,73371,,349,0,"Sc. Gen. Murgasi","MURGASI",66,73371,0,3,940,880,787,93,780,7,1100,313,606,174,
17,"DOLJ",163,73371,,350,0,"Scoala Gen. Balota de Jos","MURGASI",66,73371,0,3,789,591,520,71,586,5,900,309,476,110,
17,"DOLJ",163,73371,,351,0,"Scoala Gen. Velesti","MURGASI",66,73371,0,3,480,308,236,72,305,3,600,292,213,92,
17,"DOLJ",163,73460,,352,0,"Sc.gen.Negoi sat vechi","NEGOI",67,73460,0,3,939,500,413,87,492,8,1100,600,375,117,
17,"DOLJ",163,73460,,353,0,"Sc.gen.Negoi sat nou","NEGOI",67,73460,0,3,827,448,343,105,440,7,1000,552,344,96,
17,"DOLJ",163,73460,,354,0,"Sc.gen.   Catane","NEGOI",67,73460,0,3,1378,680,554,126,675,5,1600,920,484,191,
17,"DOLJ",163,73503,,355,0,"Scoala Gen. Orodel","ORODEL",68,73503,0,3,1056,553,446,107,544,9,1202,649,367,177,
17,"DOLJ",163,73503,,356,0,"Scoala Gen. Cornu","ORODEL",68,73503,0,3,787,472,380,92,465,7,900,428,302,163,
17,"DOLJ",163,73503,,357,0,"Scoala Gen. Calugarei","ORODEL",68,73503,0,3,716,436,368,68,427,9,802,366,333,94,
17,"DOLJ",163,73567,,358,0,"Camin.cult. Ostroveni","OSTROVENI",69,73567,0,3,1467,1328,1305,23,1324,4,1700,372,1233,91,
17,"DOLJ",163,73567,,359,0,"Gradinita de copii Orasani","OSTROVENI",69,73567,0,3,1418,1296,1249,47,1207,89,1600,304,1110,97,
17,"DOLJ",163,73567,,360,0,"Gradinita de copii Grindeni","OSTROVENI",69,73567,0,3,619,562,557,5,510,52,700,138,490,20,
17,"DOLJ",163,73567,,361,0,"Gradinita de copii Listeava","OSTROVENI",69,73567,0,3,1251,1111,1074,37,1099,12,1600,489,890,209,
17,"DOLJ",163,73594,,362,0,"Sc.gen. local vechi","PERISOR",70,73594,0,3,1294,690,560,130,680,10,1500,810,388,292,
17,"DOLJ",163,73594,,363,0,"Sc.primara cl.I-IV Maracine","PERISOR",70,73594,0,3,223,205,139,66,199,6,300,95,145,54,
17,"DOLJ",163,73629,,364,0,"Sc. Gen. nr. 1 Pielesti","PIELESTI",71,73629,0,3,1188,666,555,111,658,8,1400,734,416,242,
17,"DOLJ",163,73629,,365,0,"Sc. gen. nr. 2 Pielesti","PIELESTI",71,73629,0,3,908,493,458,35,481,12,1000,507,275,206,
17,"DOLJ",163,73629,,366,0,"Sc. gen. nr. 3 C@mpeni","PIELESTI",71,73629,0,3,719,594,523,71,589,5,800,206,392,197,
17,"DOLJ",163,73665,,367,0,"Caminul cultural Piscu Vechi","PISCU VECHI",72,73665,0,3,1993,1097,933,164,1086,11,2200,1103,700,386,
17,"DOLJ",163,73665,,368,0,"Camin cultural Ghidici","PISCU VECHI",72,73665,0,3,1932,906,780,126,892,14,2200,1294,551,341,
17,"DOLJ",163,73665,,369,0,"Sc. cl.I-IV Pisculet","PISCU VECHI",72,73665,0,3,275,179,145,34,177,2,400,221,134,43,
17,"DOLJ",163,73709,,370,0,"Sc. Gen. I-VIII Plenita","PLENITA",73,73709,0,3,1960,859,687,172,846,13,2100,1241,455,391,
17,"DOLJ",163,73709,,371,0,"Sc. Gen. I-IV Plenita","PLENITA",73,73709,0,3,1574,675,516,159,667,8,1700,1025,332,335,
17,"DOLJ",163,73709,,372,0,"Sc. Gen. I-VIII sat Castrele Traiane","PLENITA",73,73709,0,3,778,455,337,118,452,3,800,345,224,228,
17,"DOLJ",163,73709,,373,1,"Cercul Militar - Casa Armatei","PLENITA",73,73709,0,3,0,0,0,0,0,0,0,0,0,0,
17,"DOLJ",163,73736,,374,0,"Sc. primara I-IV Sarbi","POIANA MARE",75,73736,0,3,2133,1875,1327,548,1853,22,2400,525,1365,488,
17,"DOLJ",163,73736,,375,0,"Sc. Gen. Dragu","POIANA MARE",75,73736,0,3,1081,998,678,320,977,21,1200,202,730,247,
17,"DOLJ",163,73736,,376,0,"Sc. Gen. nr. 3","POIANA MARE",75,73736,0,3,1438,1182,852,330,1172,10,1600,418,931,241,
17,"DOLJ",163,73736,,377,0,"Culbul elevilor Poiana Mare","POIANA MARE",75,73736,0,3,1643,1544,1293,251,1529,15,1800,256,1253,276,
17,"DOLJ",163,73736,,378,0,"Sc. Gen. Traistaru (sosea)","POIANA MARE",75,73736,0,3,1901,1297,1002,295,1286,11,2100,803,926,360,
17,"DOLJ",163,73736,,379,0,"Sc. Gen. Tunarii Vechi","POIANA MARE",75,73736,0,3,1271,983,753,230,970,13,1400,417,711,259,
17,"DOLJ",163,73736,,380,0,"Sc. Gen. Tunarii Noi","POIANA MARE",75,73736,0,3,409,373,286,87,371,2,500,127,274,97,
17,"DOLJ",163,70110,,381,0,"Sc.gen.  Braniste","PODARI",74,70110,0,3,802,661,524,137,616,45,900,239,542,74,
17,"DOLJ",163,70110,,382,0,"com. Podari","PODARI",74,70110,0,3,1179,915,770,145,903,12,1300,385,662,241,
17,"DOLJ",163,70110,,383,0,"Sc.gen.Podari","PODARI",74,70110,0,3,1793,1122,875,247,1112,10,2000,878,692,420,
17,"DOLJ",163,70110,,384,0,"Sc.gen. Livezi","PODARI",74,70110,0,3,951,668,487,181,660,8,1102,434,437,223,
17,"DOLJ",163,73772,,385,0,"Sc. Gen. Predesti","PREDESTI",76,73772,0,3,1738,994,906,88,985,9,2000,1006,478,507,
17,"DOLJ",163,73772,,386,0,"Camin cultural Plesoi","PREDESTI",76,73772,0,3,1140,650,526,124,636,14,1300,650,309,327,
17,"DOLJ",163,73852,,387,0,"Camin cult. Radovan","RADOVAN",77,73852,0,3,845,487,369,118,476,11,1000,513,299,177,
17,"DOLJ",163,73852,,388,0,"Camin cult. Intorsura","RADOVAN",77,73852,0,3,1352,950,785,165,938,12,1500,550,450,488,
17,"DOLJ",163,73852,,389,0,"Camin cult.  Tarnava","RADOVAN",77,73852,0,3,171,185,75,110,177,8,200,15,102,75,
17,"DOLJ",163,73905,,390,0,"Sc. Gen. nr. 2 - sala de sport","RAST",78,73905,0,3,1507,764,684,80,753,11,1700,936,455,298,
17,"DOLJ",163,73905,,391,0,"Sc. Gen. nr. 3 - sala de mecanizare","RAST",78,73905,0,3,1564,793,701,92,784,9,1800,1007,442,342,
17,"DOLJ",163,73923,,392,0,"Camin cultural Robanesti de Jos","ROBANESTI",79,73923,0,3,993,523,437,86,516,7,1100,577,358,158,
17,"DOLJ",163,73923,,393,0,"Sc. I-IV Lacrita Mare","ROBANESTI",79,73923,0,3,1276,708,606,102,697,11,1502,794,452,245,
17,"DOLJ",163,73996,,394,0,"Sc. Gen. Raieti","SADOVA",80,73996,0,3,1328,891,624,267,880,11,1500,609,712,168,
17,"DOLJ",163,73996,,395,0,"Camin Cultural Sadova","SADOVA",80,73996,0,3,2583,1452,1217,235,1431,21,2900,1448,883,548,
17,"DOLJ",163,73996,,396,0,"Sc. Gen. Sadova","SADOVA",80,73996,0,3,1288,762,547,215,755,7,1500,738,400,355,
17,"DOLJ",163,73996,,397,0,"Sc. Gen. sat Damian","SADOVA",80,73996,0,3,975,816,572,244,807,9,1100,284,608,199,
17,"DOLJ",163,74028,,398,0,"Sc. gen. Salcuta","SALCUTA",81,74028,0,3,1183,685,571,114,675,10,1400,715,400,275,
17,"DOLJ",163,74028,,399,0,"Sc. Gen. Tencanau","SALCUTA",81,74028,0,3,763,603,466,137,585,18,900,297,429,156,
17,"DOLJ",163,74073,,400,0,"Sc. Gen. Scaesti","SCAESTI",82,74073,0,3,1044,630,553,77,619,11,1200,570,392,227,
17,"DOLJ",163,74073,,401,0,"Sc. Gen. sat valea lui Patru","SCAESTI",82,74073,0,3,700,447,391,56,440,7,800,353,287,153,
17,"DOLJ",163,74108,,402,0,"Sc. Gen. Seaca de Camp","SEACA DE CAMP",83,74108,0,3,955,701,644,57,693,8,1100,399,413,280,
17,"DOLJ",163,74108,,403,0,"Sc. Gen. sat Piscu Nou","SEACA DE CAMP",83,74108,0,3,952,763,662,101,759,4,1100,337,530,229,
17,"DOLJ",163,74135,,404,0,"Camin cult.Seaca de Padure","SEACA DE PADURE",84,74135,0,3,724,493,433,60,484,9,900,407,368,116,
17,"DOLJ",163,74135,,405,0,"Sc.cls.I-IV Veleni","SEACA DE PADURE",84,74135,0,3,535,337,288,49,329,8,600,263,226,103,
17,"DOLJ",163,74171,,406,0,"Sc. gen. Secu","SECU",85,74171,0,3,1075,482,427,55,471,11,1200,718,314,157,
17,"DOLJ",163,74224,,407,0,"Sc. Gen. I-VIII","SILISTEA CRUCII",86,74224,0,3,1532,836,724,112,825,11,1700,864,473,352,
17,"DOLJ",163,74242,,408,0,"Camin Cultural Sopot","SOPOT",88,74242,0,3,553,422,394,28,415,7,700,278,312,103,
17,"DOLJ",163,74242,,409,0,"Sc. Gen. Cernat","SOPOT",88,74242,0,3,121,86,70,16,86,0,200,114,52,34,
17,"DOLJ",163,74242,,410,0,"Sc. Gen. Belot","SOPOT",88,74242,0,3,507,274,227,47,266,8,600,326,154,112,
17,"DOLJ",163,74242,,411,0,"Sc. Gen. Pietroaia","SOPOT",88,74242,0,3,326,254,217,37,251,3,400,146,149,102,
17,"DOLJ",163,74242,,412,0,"Sc. Gen. Bascov","SOPOT",88,74242,0,3,333,209,180,29,205,4,400,191,102,103,
17,"DOLJ",163,70174,,413,0,"Camin Cultural sat Dudovicesti","SIMNICU DE SUS",87,70174,0,3,1461,638,551,87,631,7,1700,1062,372,259,
17,"DOLJ",163,70174,,414,0,"Sc. Gen. sat Lesile","SIMNICU DE SUS",87,70174,0,3,1835,985,847,138,965,20,2100,1115,645,320,
17,"DOLJ",163,74322,,415,0,"Sc. Gen. Teasc -sc. veche","TEASC",89,74322,0,3,1512,1118,1006,112,1104,13,1700,583,676,428,
17,"DOLJ",163,74322,,416,0,"Camin Cultural Secui","TEASC",89,74322,0,3,1074,627,547,80,612,15,1200,573,291,321,
17,"DOLJ",163,74359,,417,0,"Sc.gen.cls.I-VIII Terpezita","TERPEZITA",90,74359,0,3,891,610,477,133,593,17,1003,393,357,236,
17,"DOLJ",163,74359,,418,0,"Sc.cls.I-IV- Lazu","TERPEZITA",90,74359,0,3,312,238,181,57,233,5,400,162,128,105,
17,"DOLJ",163,74359,,419,0,"Sc.I-VIII Caciulatu","TERPEZITA",90,74359,0,3,419,305,220,85,303,2,503,198,197,106,
17,"DOLJ",163,74411,,420,0,"Camin cultural Teslui","TESLUI",91,74411,0,3,1112,808,687,121,800,8,1300,492,562,238,
17,"DOLJ",163,74411,,421,0,"Sc.  I-IV Preajba","TESLUI",91,74411,0,3,816,703,618,85,694,9,1000,297,545,149,
17,"DOLJ",163,74411,,422,0,"Sc.  I-IV Tartal","TESLUI",91,74411,0,3,335,269,222,47,266,3,400,131,179,87,
17,"DOLJ",163,74509,,423,0,"Sc.gen.Tuglui","TUGLUI",92,74509,0,3,2143,1300,1185,115,1281,19,2400,1100,765,516,
17,"DOLJ",163,74509,,424,0,"Sc.gen. Jiul","TUGLUI",92,74509,0,3,194,196,138,58,195,1,300,104,150,45,
17,"DOLJ",163,74536,,425,0,"Sc. Gen. nr. 2","UNIREA",93,74536,0,3,1680,945,749,196,937,8,1900,955,519,418,
17,"DOLJ",163,74536,,426,0,"Sc. Gen. nr. 3","UNIREA",93,74536,0,3,1437,792,681,111,779,13,1600,808,401,378,
17,"DOLJ",163,74554,,427,0,"Sc.  Barbu Ionescu- Urzicuta","URZICUTA",94,74554,0,3,1960,1076,926,150,1063,13,2200,1124,721,342,
17,"DOLJ",163,74554,,428,0,"Sc.cl.I-IV - Urzica Mare","URZICUTA",94,74554,0,3,459,460,370,90,449,11,600,140,327,122,
17,"DOLJ",163,74581,,429,0,"Sc. Gen. I-IV sat Tuguresti","VALEA STANCIULUI",95,74581,0,3,689,359,245,114,350,9,800,441,229,121,
17,"DOLJ",163,74581,,430,0,"Soc. Agr. sat Barza","VALEA STANCIULUI",95,74581,0,3,740,388,240,148,384,4,900,512,271,113,
17,"DOLJ",163,74581,,431,0,"Sc. Gen. I-VIII Valea Stanciului","VALEA STANCIULUI",95,74581,0,3,1593,731,593,138,727,4,1800,1069,525,202,
17,"DOLJ",163,74581,,432,0,"Sc. Gen. I-VIII sat Horezu Poenari","VALEA STANCIULUI",95,74581,0,3,1493,738,609,129,727,11,1700,962,564,163,
17,"DOLJ",163,74581,,433,0,"Sc. Gen. I-IV sat Grecesti","VALEA STANCIULUI",95,74581,0,3,705,452,335,117,445,7,800,348,352,93,
17,"DOLJ",163,74616,,434,0,"Sc. gen. cl.I-VIII Vela","VELA",98,74616,0,3,683,300,247,53,296,4,800,500,209,87,
17,"DOLJ",163,74616,,435,0,"Sc. gen. cl.I-IV Bucovicior","VELA",98,74616,0,3,572,338,256,82,332,6,700,362,191,141,
17,"DOLJ",163,74616,,436,0,"Sc. gen. cl.I-VIII Gubaucea","VELA",98,74616,0,3,546,321,233,88,318,3,700,379,215,103,
17,"DOLJ",163,74705,,437,0,"Sc. gen. Verbita","VERBITA",99,74705,0,3,1299,628,555,73,616,12,1500,872,451,165,
17,"DOLJ",163,74732,,438,0,"Caminul cultural","VARTOP",96,74732,0,3,1514,893,808,85,882,11,1700,807,603,279,
17,"DOLJ",163,74750,,439,0,"Sc.gen. cl.I-IV  Varvor","VARVORU DE JOS",97,74750,0,3,712,377,270,107,374,3,802,425,229,145,
17,"DOLJ",163,74750,,440,0,"Sc.gen.cl.I-VIII  Varvoru de Jos","VARVORU DE JOS",97,74750,0,3,1026,787,777,10,783,4,1202,415,505,278,
17,"DOLJ",163,74750,,441,0,"Sc.gen.cl.I-VIII Ciutura","VARVORU DE JOS",97,74750,0,3,856,650,625,25,635,15,1000,350,470,165,
18,"GALATI",172,75098,,1,0,"Str.Vadul Sacalelor nr.2,Scoala Generala ""Ion Creanga""(Scoala Generala Nr.26)","MUNICIPIUL GALATI",1,75098,1,1,1534,959,913,46,939,20,1700,741,740,199,
18,"GALATI",172,75098,,2,0,"Str.Vadul Sacalelor nr.2,Scoala Generala ""Ion Creanga""(Scoala Generala Nr.26)","MUNICIPIUL GALATI",1,75098,1,1,1418,937,899,38,885,17,1600,698,695,190,
18,"GALATI",172,75098,,3,0,"Str.Rosiori nr.31,Scoala Generala ""Mihai Eminescu""(Scoala Generala Nr.28)","MUNICIPIUL GALATI",1,75098,1,1,1432,897,829,68,876,21,1600,703,688,188,
18,"GALATI",172,75098,,4,0,"Str.Rosiori nr.31,Scoala Generala ""Mihai Eminescu""(Scoala Generala Nr.28)","MUNICIPIUL GALATI",1,75098,1,1,1299,797,751,46,787,10,1400,603,606,181,
18,"GALATI",172,75098,,5,0,"Str.Rosiori nr.31,Scoala Generala ""Mihai Eminescu""(Scoala Generala Nr.28)","MUNICIPIUL GALATI",1,75098,1,1,1557,939,908,31,918,21,1700,761,744,174,
18,"GALATI",172,75098,,6,0,"Str.Rosiori nr.31,Scoala Generala ""Mihai Eminescu""(Scoala Generala Nr.28)","MUNICIPIUL GALATI",1,75098,1,1,1441,914,881,33,897,17,1595,681,672,225,
18,"GALATI",172,75098,,7,0,"Str.C-tin Brancoveanu nr.2,S.C. ""APATERM"" SA","MUNICIPIUL GALATI",1,75098,1,1,1994,1198,1163,35,1174,24,2200,1002,871,303,
18,"GALATI",172,75098,,8,0,"Str.C-tin Brancoveanu nr.2,S.C. ""APATERM"" SA","MUNICIPIUL GALATI",1,75098,1,1,1926,1172,1127,45,1151,21,2100,928,795,356,
18,"GALATI",172,75098,,9,0,"Str.C-tin Brancoveanu nr.2,S.C. ""APATERM"" SA","MUNICIPIUL GALATI",1,75098,1,1,1979,1186,1158,28,1164,22,2200,1014,943,221,
18,"GALATI",172,75098,,10,0,"Str.Regiment 11 Siret,Scoala Generala Nr.2","MUNICIPIUL GALATI",1,75098,1,1,1991,1126,1093,33,1115,11,2209,1083,825,290,
18,"GALATI",172,75098,,11,0,"Str.Regiment 11 Siret,Liceul Teoretic ""Emil Racovita""(Scoala Generala Nr.6)","MUNICIPIUL GALATI",1,75098,1,1,1437,846,806,40,834,12,1601,755,613,221,
18,"GALATI",172,75098,,12,0,"Str.Regiment 11 Siret,Scoala Generala Nr.2","MUNICIPIUL GALATI",1,75098,1,1,1286,730,692,38,720,10,1400,670,543,177,
18,"GALATI",172,75098,,13,0,"Tiglina I,Liceul Teoretic ""Mihail Kogalniceanu""","MUNICIPIUL GALATI",1,75098,1,1,1559,722,667,55,714,8,1700,978,529,185,
18,"GALATI",172,75098,,14,0,"Tiglina I,Liceul Teoretic ""Mihail Kogalniceanu""","MUNICIPIUL GALATI",1,75098,1,1,1269,740,695,45,728,12,1400,660,536,192,
18,"GALATI",172,75098,,15,0,"Str.Regiment 11 Siret,Liceul Teoretic ""Emil Racovita""(Scoala Generala Nr.6)","MUNICIPIUL GALATI",1,75098,1,1,1328,777,728,49,765,12,1400,623,585,180,
18,"GALATI",172,75098,,16,0,"Str.Regiment 11 Siret,Liceul Teoretic ""Emil Racovita""(Scoala Generala Nr.6)","MUNICIPIUL GALATI",1,75098,1,1,1300,741,699,42,732,9,1400,659,536,196,
18,"GALATI",172,75098,,17,0,"Str.Saturn - Tiglina I,Scoala Generala ""Spiru Haret""(Scoala Generala Nr.8)","MUNICIPIUL GALATI",1,75098,1,1,1568,951,909,42,947,4,1700,749,652,295,
18,"GALATI",172,75098,,18,0,"Str.Saturn - Tiglina I,Scoala Generala ""Spiru Haret""(Scoala Generala Nr.8)","MUNICIPIUL GALATI",1,75098,1,1,1697,951,906,45,942,9,1806,855,670,272,
18,"GALATI",172,75098,,19,0,"Str.Saturn - Tiglina I,Scoala Generala ""Spiru Haret""(Scoala Generala Nr.8)","MUNICIPIUL GALATI",1,75098,1,1,1690,945,909,36,930,15,1800,855,678,252,
18,"GALATI",172,75098,,20,0,"Str.Saturn - Tiglina I,Scoala Generala ""Spiru Haret""(Scoala Generala Nr.8)","MUNICIPIUL GALATI",1,75098,1,1,1549,894,846,48,881,13,1700,806,621,260,
18,"GALATI",172,75098,,21,0,"Str. Stadionului,Micro 21,Liceul cu Program de Educatie Fizica(Liceul Industrial Nr.12)","MUNICIPIUL GALATI",1,75098,1,1,1917,1264,995,269,1250,14,2100,836,856,394,
18,"GALATI",172,75098,,22,0,"Scoala Generala ""Nichita Stanescu""(Scoala Generala Nr.17)","MUNICIPIUL GALATI",1,75098,1,1,1985,1055,972,83,1046,9,2100,1045,736,310,
18,"GALATI",172,75098,,23,0,"Scoala Generala ""Nichita Stanescu""(Scoala Generala Nr.17)","MUNICIPIUL GALATI",1,75098,1,1,1630,902,839,63,896,6,1800,898,602,294,
18,"GALATI",172,75098,,24,0,"Grup Scolar Economic Administrativ ""Virgil Madgearu""","MUNICIPIUL GALATI",1,75098,1,1,2044,1151,1095,56,1135,16,2200,1049,790,345,
18,"GALATI",172,75098,,25,0,"Scoala Generala <<Sfanta Ana>>(Scoala Generala Nr.29)","MUNICIPIUL GALATI",1,75098,1,1,2132,1279,1209,70,1272,7,2300,1021,924,348,
18,"GALATI",172,75098,,26,0,"Scoala Generala <<Sfanta Ana>>(Scoala Generala Nr.29)","MUNICIPIUL GALATI",1,75098,1,1,1684,941,888,53,926,15,1800,859,639,287,
18,"GALATI",172,75098,,27,0,"Scoala Generala ""Dimitrie Cantemir""(Scoala Generala Nr.22)","MUNICIPIUL GALATI",1,75098,1,1,1554,921,824,97,909,12,1700,779,617,292,
18,"GALATI",172,75098,,28,0,"Scoala Generala ""Dimitrie Cantemir""(Scoala Generala Nr.22)","MUNICIPIUL GALATI",1,75098,1,1,1318,796,738,58,786,10,1500,704,565,221,
18,"GALATI",172,75098,,29,0,"Scoala Generala ""Dimitrie Cantemir""(Scoala Generala Nr.22)","MUNICIPIUL GALATI",1,75098,1,1,2253,1290,1235,55,1278,12,2435,1145,879,399,
18,"GALATI",172,75098,,30,0,"Scoala Generala <<Sfanta Ana>>(Scoala Generala Nr.29)","MUNICIPIUL GALATI",1,75098,1,1,1470,1049,1012,37,1039,10,2100,1051,744,295,
18,"GALATI",172,75098,,31,0,"Str.Brailei Nr.208,Gradinita <<Prichindel>>(Gradinita Nr.62)","MUNICIPIUL GALATI",1,75098,1,1,1738,1117,1025,92,1108,9,1900,783,787,321,
18,"GALATI",172,75098,,32,0,"Str.Brailei Nr.208,Gradinita <<Prichindel>>(Gradinita Nr.62)","MUNICIPIUL GALATI",1,75098,1,1,1735,1045,965,80,1025,20,1900,855,687,338,
18,"GALATI",172,75098,,33,0,"Str.Brailei Nr.208,Gradinita <<Prichindel>>(Gradinita Nr.62)","MUNICIPIUL GALATI",1,75098,1,1,1835,1082,999,83,1059,23,2000,918,720,339,
18,"GALATI",172,75098,,34,0,"Scoala Generala Nr.35 Barbosi","MUNICIPIUL GALATI",1,75098,1,1,335,217,169,48,215,2,400,183,124,91,
18,"GALATI",172,75098,,35,0,"Mocro 20,Scoala Generala <<Dan Barbilian>>(Scoala Generala Nr.43)","MUNICIPIUL GALATI",1,75098,1,1,2476,1491,1361,130,1481,10,2600,1109,947,534,
18,"GALATI",172,75098,,36,0,"Mocro 20,Scoala Generala <<Dan Barbilian>>(Scoala Generala Nr.43)","MUNICIPIUL GALATI",1,75098,1,1,2127,1321,1285,36,1278,7,2290,1005,872,406,
18,"GALATI",172,75098,,37,0,"Mocro 20,Scoala Generala <<Dan Barbilian>>(Scoala Generala Nr.43)","MUNICIPIUL GALATI",1,75098,1,1,1883,1105,1062,43,1091,14,2000,895,711,380,
18,"GALATI",172,75098,,38,0,"Mocro 20,Scoala Generala <<Dan Barbilian>>(Scoala Generala Nr.43)","MUNICIPIUL GALATI",1,75098,1,1,2030,1193,1144,49,1180,13,2200,1007,786,394,
18,"GALATI",172,75098,,39,0,"Mocro 20,Scoala Generala <<Dan Barbilian>>(Scoala Generala Nr.43)","MUNICIPIUL GALATI",1,75098,1,1,1762,1045,1017,28,1039,6,1900,855,664,375,
18,"GALATI",172,75098,,40,0,"Mocro 21,Scoala Generala Nr.3","MUNICIPIUL GALATI",1,75098,1,1,2040,1221,1169,52,1209,12,2201,980,800,409,
18,"GALATI",172,75098,,41,0,"Mocro 21,Scoala Generala Nr.3","MUNICIPIUL GALATI",1,75098,1,1,1911,1183,1140,43,1177,6,2100,917,785,392,
18,"GALATI",172,75098,,42,0,"Mocro 21,Scoala Generala Nr.3","MUNICIPIUL GALATI",1,75098,1,1,2023,1141,1104,37,1127,14,2200,1059,779,348,
18,"GALATI",172,75098,,43,0,"Mocro 21,Scoala Generala Nr.3","MUNICIPIUL GALATI",1,75098,1,1,1798,1068,1008,60,1055,13,1915,847,679,376,
18,"GALATI",172,75098,,44,0,"Str. Stadionului,Micro 21,Liceul cu Program de Educatie Fizica(Liceul Industrial Nr.12)","MUNICIPIUL GALATI",1,75098,1,1,2100,1136,1081,55,1120,16,2300,1164,803,317,
18,"GALATI",172,75098,,45,0,"Str. Stadionului,Micro 21,Liceul cu Program de Educatie Fizica(Liceul Industrial Nr.12)","MUNICIPIUL GALATI",1,75098,1,1,1139,1153,987,166,1148,5,1900,747,790,358,
18,"GALATI",172,75098,,46,0,"Micro 18,Scoala Generala <<Iulia Hasdeu>>(Scoala Generala Nr.40)","MUNICIPIUL GALATI",1,75098,1,1,1761,943,885,58,932,11,1900,957,654,278,
18,"GALATI",172,75098,,47,0,"Micro 18,Scoala Generala <<Iulia Hasdeu>>(Scoala Generala Nr.40)","MUNICIPIUL GALATI",1,75098,1,1,1666,954,916,38,942,12,1800,846,672,270,
18,"GALATI",172,75098,,48,0,"Micro 18,Scoala Generala <<Iulia Hasdeu>>(Scoala Generala Nr.40)","MUNICIPIUL GALATI",1,75098,1,1,2068,1238,1182,56,1224,14,2200,962,818,406,
18,"GALATI",172,75098,,49,0,"Micro 18,Scoala Generala <<Iulia Hasdeu>>(Scoala Generala Nr.40)","MUNICIPIUL GALATI",1,75098,1,1,1859,1028,990,38,1013,15,2000,972,683,330,
18,"GALATI",172,75098,,50,0,"Micro 18,Scoala Generala <<Iulia Hasdeu>>(Scoala Generala Nr.40)","MUNICIPIUL GALATI",1,75098,1,1,1734,1000,946,54,987,13,1900,900,676,311,
18,"GALATI",172,75098,,51,0,"Str.Barbosi Nr.38,Scoala Generala <<Calistrat Hogas>>(Scoala Generala Nr.9)","MUNICIPIUL GALATI",1,75098,1,1,1798,981,943,38,966,15,1900,919,693,273,
18,"GALATI",172,75098,,52,0,"Str.Barbosi Nr.38,Scoala Generala <<Calistrat Hogas>>(Scoala Generala Nr.9)","MUNICIPIUL GALATI",1,75098,1,1,1831,1087,1003,84,1066,21,2001,914,804,262,
18,"GALATI",172,75098,,53,0,"Str.Brailei Nr.188,Scoala Generala Nr.40-Anexa","MUNICIPIUL GALATI",1,75098,1,1,2685,1641,1487,154,1625,16,2800,1159,1096,529,
18,"GALATI",172,75098,,54,0,"Str.Brailei Nr.188,Scoala Generala Nr.40-Anexa","MUNICIPIUL GALATI",1,75098,1,1,1936,1125,1073,52,1118,7,2200,1075,741,377,
18,"GALATI",172,75098,,55,0,"Micro 17,Liceul Teoretic ""Dunarea""","MUNICIPIUL GALATI",1,75098,1,1,2191,1287,1188,99,1274,13,2300,1013,901,373,
18,"GALATI",172,75098,,56,0,"Micro 17,Liceul Teoretic ""Dunarea""","MUNICIPIUL GALATI",1,75098,1,1,2068,1212,1144,68,1199,13,2176,964,853,346,
18,"GALATI",172,75098,,57,0,"Str.Gorunului Nr.6,Scoala Generala <<Cuza Voda>>(Scoala Generala Nr.5)","MUNICIPIUL GALATI",1,75098,1,1,2117,1193,1137,56,1180,13,2300,1107,831,349,
18,"GALATI",172,75098,,58,0,"Str.Gorunului Nr.6,Scoala Generala <<Cuza Voda>>(Scoala Generala Nr.5)","MUNICIPIUL GALATI",1,75098,1,1,1905,1084,1029,55,1072,12,2000,916,720,352,
18,"GALATI",172,75098,,59,0,"Str.Mihail Sadoveanu,Scoala Generala <<Mihail Sadoveanu(Scoala Generala Nr.11)","MUNICIPIUL GALATI",1,75098,1,1,1754,1030,977,53,1020,10,1865,835,690,330,
18,"GALATI",172,75098,,60,0,"Str.Mihail Sadoveanu,Scoala Generala <<Mihail Sadoveanu(Scoala Generala Nr.11)","MUNICIPIUL GALATI",1,75098,1,1,1850,1081,1039,42,1073,8,2000,919,779,294,
18,"GALATI",172,75098,,61,0,"Str.Mihail Sadoveanu,Scoala Generala <<Mihail Sadoveanu(Scoala Generala Nr.11)","MUNICIPIUL GALATI",1,75098,1,1,2003,1149,1116,33,1143,6,2100,951,877,266,
18,"GALATI",172,75098,,62,0,"Str.Mihail Sadoveanu,Scoala Generala <<Mihail Sadoveanu(Scoala Generala Nr.11)","MUNICIPIUL GALATI",1,75098,1,1,2250,1316,1269,47,1300,16,2400,1084,928,372,
18,"GALATI",172,75098,,63,0,"Str.Mihail Sadoveanu,Scoala Generala <<Mihail Sadoveanu(Scoala Generala Nr.11)","MUNICIPIUL GALATI",1,75098,1,1,1811,1040,1001,39,1032,8,2000,960,761,271,
18,"GALATI",172,75098,,64,0,"Str.Lebedei,Scoala Generala ""Petre Tutea""(Scoala Generala Nr.10)","MUNICIPIUL GALATI",1,75098,1,1,1831,1081,995,86,1065,16,2000,919,772,293,
18,"GALATI",172,75098,,65,0,"Str.Lebedei,Scoala Generala ""Petre Tutea""(Scoala Generala Nr.10)","MUNICIPIUL GALATI",1,75098,1,1,1729,974,927,47,960,14,1900,926,664,296,
18,"GALATI",172,75098,,66,0,"Str.Lebedei,Scoala Generala ""Petre Tutea""(Scoala Generala Nr.10)","MUNICIPIUL GALATI",1,75098,1,1,1842,1116,1052,64,1098,18,2000,884,768,330,
18,"GALATI",172,75098,,67,0,"Str.Lebedei,Scoala Generala ""Petre Tutea""(Scoala Generala Nr.10)","MUNICIPIUL GALATI",1,75098,1,1,1690,983,942,41,973,10,1800,817,650,323,
18,"GALATI",172,75098,,68,0,"Str.Lebedei,Grupul Scolar Industrial de Transporturi Auto(Grup Scolar ITA)","MUNICIPIUL GALATI",1,75098,1,1,2083,1147,1097,50,1138,9,2300,1153,798,340,
18,"GALATI",172,75098,,69,0,"Str.Lebedei,Grupul Scolar Industrial de Transporturi Auto(Grup Scolar ITA)","MUNICIPIUL GALATI",1,75098,1,1,2328,1322,1259,63,1312,10,2500,1178,926,386,
18,"GALATI",172,75098,,70,0,"Str.Siderurgistilor,Scoala Generala ""Sfintii Imparati""(Scoala Generala Nr.42)","MUNICIPIUL GALATI",1,75098,1,1,1862,1167,1006,161,1156,11,2000,833,823,333,
18,"GALATI",172,75098,,71,0,"Str.Siderurgistilor,Scoala Generala ""Sfintii Imparati""(Scoala Generala Nr.42)","MUNICIPIUL GALATI",1,75098,1,1,2146,1253,1202,51,1241,12,2200,947,857,384,
18,"GALATI",172,75098,,72,0,"Str.1 Decembrie 1918,Scoala Generala ""Sf.Grigore Teologul""(Scoala Generala Nr.41)","MUNICIPIUL GALATI",1,75098,1,1,2381,1363,1302,61,1343,20,2500,1137,942,401,
18,"GALATI",172,75098,,73,0,"Str.1 Decembrie 1918,Scoala Generala ""Sf.Grigore Teologul""(Scoala Generala Nr.41)","MUNICIPIUL GALATI",1,75098,1,1,2432,1413,1350,63,1398,15,2600,1187,927,471,
18,"GALATI",172,75098,,74,0,"Str.1 Decembrie 1918,Scoala Generala ""Sf.Grigore Teologul""(Scoala Generala Nr.41)","MUNICIPIUL GALATI",1,75098,1,1,2135,1347,1284,63,1328,19,2500,1153,938,390,
18,"GALATI",172,75098,,75,0,"Calea Smardan Nr.13,Grupul Scolar Industrial ""Anghel Saligny""(Liceul Industrial Nr.9)","MUNICIPIUL GALATI",1,75098,1,1,713,1200,370,830,1188,12,1500,300,705,483,
18,"GALATI",172,75098,,76,0,"Str.1 Decembrie 1918,Scoala Generala ""Sf.Grigore Teologul""(Scoala Generala Nr.41)","MUNICIPIUL GALATI",1,75098,1,1,2295,1409,1341,68,1395,14,2500,1091,944,451,
18,"GALATI",172,75098,,77,0,"Micro 13B,Scoala Generala ""Grigore Moisil""(Scoala Generala Nr.38)","MUNICIPIUL GALATI",1,75098,1,1,1877,1143,1052,91,1130,13,2000,857,715,415,
18,"GALATI",172,75098,,78,0,"Micro 13B,Scoala Generala ""Grigore Moisil""(Scoala Generala Nr.38)","MUNICIPIUL GALATI",1,75098,1,1,2448,1476,1420,56,1463,13,2598,1122,988,475,
18,"GALATI",172,75098,,79,0,"Micro 13B,Scoala Generala ""Grigore Moisil""(Scoala Generala Nr.38)","MUNICIPIUL GALATI",1,75098,1,1,1691,970,926,44,955,15,1800,830,676,279,
18,"GALATI",172,75098,,80,0,"Micro 38,Scoala Generala ""Ghe.Munteanu""(Scoala Generala Nr.31)","MUNICIPIUL GALATI",1,75098,1,1,1551,934,882,52,923,11,1700,766,653,270,
18,"GALATI",172,75098,,81,0,"Micro 38,Scoala Generala ""Ghe.Munteanu""(Scoala Generala Nr.31)","MUNICIPIUL GALATI",1,75098,1,1,1830,1009,973,36,994,15,2000,991,710,284,
18,"GALATI",172,75098,,82,0,"Micro 38,Scoala Generala ""Ghe.Munteanu""(Scoala Generala Nr.31)","MUNICIPIUL GALATI",1,75098,1,1,1560,859,809,50,844,15,1700,841,621,223,
18,"GALATI",172,75098,,83,0,"Scoala Primara Filesti(Scoala Generala Nr.36 Filesti)","MUNICIPIUL GALATI",1,75098,1,1,315,232,168,64,228,4,424,192,138,90,
18,"GALATI",172,75098,,84,0,"Str.Milcov,Grupul Scolar Industrial Energetic(Liceul Industrial Nr.4)","MUNICIPIUL GALATI",1,75098,1,1,1874,1106,1030,76,1093,13,1987,881,685,408,
18,"GALATI",172,75098,,85,0,"Str.Milcov Nr.27,Grupul Scolar Industrial Energetic(Liceul Industrial Nr.4)","MUNICIPIUL GALATI",1,75098,1,1,2106,1178,1125,53,1169,9,2300,1122,806,363,
18,"GALATI",172,75098,,86,0,"Str.Milcov Nr.27,Grupul Scolar Industrial Energetic(Liceul Industrial Nr.4)","MUNICIPIUL GALATI",1,75098,1,1,1895,1204,1118,86,1189,15,2000,796,782,407,
18,"GALATI",172,75098,,87,0,"Micro 39A,Scoala Generala ""Sf.Dumitru""(Scoala Generala Nr.33)","MUNICIPIUL GALATI",1,75098,1,1,1932,1081,1027,54,1068,13,2100,1019,745,323,
18,"GALATI",172,75098,,88,0,"Micro 39A,Scoala Generala ""Sf.Dumitru""(Scoala Generala Nr.33)","MUNICIPIUL GALATI",1,75098,1,1,1995,1282,1162,120,1267,15,2100,818,864,403,
18,"GALATI",172,75098,,89,0,"Micro 39A,Scoala Generala ""Sf.Dumitru""(Scoala Generala Nr.33)","MUNICIPIUL GALATI",1,75098,1,1,1822,1141,1025,116,1128,13,1899,758,780,348,
18,"GALATI",172,75098,,90,0,"Micro 39B,Scoala Generala Nr.34","MUNICIPIUL GALATI",1,75098,1,1,2373,1579,1316,263,1566,13,2600,1021,1066,500,
18,"GALATI",172,75098,,91,0,"Micro 40,Scoala Generala Nr.18","MUNICIPIUL GALATI",1,75098,1,1,2118,1225,1137,88,1214,11,2300,1075,871,343,
18,"GALATI",172,75098,,92,0,"Micro 40,Scoala Generala Nr.18","MUNICIPIUL GALATI",1,75098,1,1,1885,1137,1067,70,1129,8,2000,863,755,374,
18,"GALATI",172,75098,,93,0,"Bariera Traian,SC""FIROMEX"" SA(fosta unitate ""B"" a SC""FALFIRTEX"" SA)","MUNICIPIUL GALATI",1,75098,1,1,1658,1089,900,189,1076,13,1800,711,684,392,
18,"GALATI",172,75098,,94,0,"Str.1 Decembrie 1918 Nr.3,Grupul Scolar Metalurgic(Liceul Industrial Nr.3)","MUNICIPIUL GALATI",1,75098,1,1,1920,1046,987,59,1032,14,2100,1054,685,347,
18,"GALATI",172,75098,,95,0,"Str.1 Decembrie 1918 Nr.3,Grupul Scolar Metalurgic(Liceul Industrial Nr.3)","MUNICIPIUL GALATI",1,75098,1,1,2109,1181,1079,102,1170,11,2300,1119,765,405,
18,"GALATI",172,75098,,96,0,"B-dul Milcov Nr.13,Grupul scolar Industrial ""Gh.Asachi""(Licelul Industrial Nr.8)","MUNICIPIUL GALATI",1,75098,1,1,2333,1689,1152,537,1670,19,2400,711,1069,601,
18,"GALATI",172,75098,,97,0,"B-dul Milcov,Scoala Generala Nr.30","MUNICIPIUL GALATI",1,75098,1,1,1328,1474,1071,403,1461,13,2394,920,914,547,
18,"GALATI",172,75098,,98,0,"Str.Aurel Vlaicu,Grupul Scolar Industrial Transporturi CF(Liceul CFR)","MUNICIPIUL GALATI",1,75098,1,1,2314,1304,1221,83,1292,12,2400,1096,838,454,
18,"GALATI",172,75098,,99,0,"Str.Aurel Vlaicu,Grupul Scolar Industrial Transporturi CF(Liceul CFR)","MUNICIPIUL GALATI",1,75098,1,1,2020,1253,1202,51,1239,14,2400,1147,794,445,
18,"GALATI",172,75098,,100,0,"Str.1 Decembrie 1918 Nr.3,Grupul Scolar Metalurgic(Liceul Industrial Nr.3)","MUNICIPIUL GALATI",1,75098,1,1,2408,1588,1344,244,1571,17,2600,1012,1006,565,
18,"GALATI",172,75098,,101,0,"Str.Alba Iulia Nr.2,Scoala Generala ""Miron Costin""(Scoala Generala Nr.12)","MUNICIPIUL GALATI",1,75098,1,1,2088,1272,1199,73,1264,8,2200,928,886,378,
18,"GALATI",172,75098,,102,0,"Str.Alba Iulia Nr.2,Scoala Generala ""Miron Costin""(Scoala Generala Nr.12)","MUNICIPIUL GALATI",1,75098,1,1,2067,1202,1156,46,1194,8,2200,998,781,413,
18,"GALATI",172,75098,,103,0,"Str.Alba Iulia Nr.2,Scoala Generala ""Miron Costin""(Scoala Generala Nr.12)","MUNICIPIUL GALATI",1,75098,1,1,2068,1185,1139,46,1176,9,2300,1115,753,423,
18,"GALATI",172,75098,,104,0,"Str.Alba Iulia Nr.2,Scoala Generala ""Miron Costin""(Scoala Generala Nr.12)","MUNICIPIUL GALATI",1,75098,1,1,2253,1307,1208,99,1294,13,2400,1093,913,381,
18,"GALATI",172,75098,,105,0,"Str.Alba Iulia Nr.2,Scoala Generala ""Miron Costin""(Scoala Generala Nr.12)","MUNICIPIUL GALATI",1,75098,1,1,2479,1404,1299,105,1389,15,2700,1296,949,440,
18,"GALATI",172,75098,,106,0,"Str.Tecuci,SC ""UNICOM"" SA,Sala de intruniri publice","MUNICIPIUL GALATI",1,75098,1,1,2483,1331,1262,69,1316,15,2700,1369,889,427,
18,"GALATI",172,75098,,107,0,"Str.Tecuci,SC ""UNICOM"" SA,Sala de intruniri publice","MUNICIPIUL GALATI",1,75098,1,1,2384,1248,1185,63,1237,11,2600,1352,848,389,
18,"GALATI",172,75098,,108,0,"Str.Tecuci,SC ""UNICOM"" SA,Sala de expozitii","MUNICIPIUL GALATI",1,75098,1,1,2145,1189,1111,78,1177,12,2300,1111,787,390,
18,"GALATI",172,75098,,109,0,"Tiglina II,Grupul Scolar Industrial ""Sf.Maria""(Liceul Industrial Nr.10)","MUNICIPIUL GALATI",1,75098,1,1,1103,787,736,51,782,5,1400,613,602,180,
18,"GALATI",172,75098,,110,0,"Tiglina II,Grupul Scolar Industrial ""Sf.Maria""(Liceul Industrial Nr.10)","MUNICIPIUL GALATI",1,75098,1,1,1853,1132,1044,88,1126,6,2000,868,789,337,
18,"GALATI",172,75098,,111,0,"Tiglina II,Scoala Generala ""Stefan cel Mare""(Scoala Generala Nr.13)","MUNICIPIUL GALATI",1,75098,1,1,2088,1158,1079,79,1148,10,2300,1142,807,341,
18,"GALATI",172,75098,,112,0,"Tiglina II,Scoala Generala ""C.Brancoveanu""(Scoala Generala Nr.7)","MUNICIPIUL GALATI",1,75098,1,1,1653,962,892,70,943,19,1800,838,706,237,
18,"GALATI",172,75098,,113,0,"Str.Brailei Nr.138,Scoala Normala ""C.Negri""(Liceul Pedagogic)","MUNICIPIUL GALATI",1,75098,1,1,1766,1036,983,53,1021,15,1898,862,789,232,
18,"GALATI",172,75098,,114,0,"Str.Brailei Nr.138,Scoala Normala ""C.Negri""(Liceul Pedagogic)","MUNICIPIUL GALATI",1,75098,1,1,1844,1120,1007,113,1095,25,2000,880,824,271,
18,"GALATI",172,75098,,115,0,"Str.Brailei Nr.138,Scoala Normala ""C.Negri""(Liceul Pedagogic)","MUNICIPIUL GALATI",1,75098,1,1,1779,1062,1026,36,1046,16,1900,838,794,252,
18,"GALATI",172,75098,,116,0,"B-dul G.Cosbuc,Casa de Cultura a Sindicatelor","MUNICIPIUL GALATI",1,75098,1,1,1433,825,759,66,818,7,1600,775,615,203,
18,"GALATI",172,75098,,117,0,"B-dul G.Cosbuc,Casa de Cultura a Sindicatelor","MUNICIPIUL GALATI",1,75098,1,1,1565,882,830,52,871,11,1700,818,630,241,
18,"GALATI",172,75098,,118,0,"Str.Morilor Nr.54,SC Cooperativa ""Constructorul""","MUNICIPIUL GALATI",1,75098,1,1,1760,973,891,82,961,12,1900,927,658,303,
18,"GALATI",172,75098,,119,0,"Str.Nenitescu Nr.12,Gradinita Nr.15","MUNICIPIUL GALATI",1,75098,1,1,1703,1024,919,105,989,35,1800,776,681,308,
18,"GALATI",172,75098,,120,0,"Str.Nenitescu Nr.12,Gradinita Nr.15","MUNICIPIUL GALATI",1,75098,1,1,1213,697,629,68,689,8,1295,598,479,210,
18,"GALATI",172,75098,,121,0,"Aleea Scolii Nr.2,Liceul ""Al.I. Cuza""","MUNICIPIUL GALATI",1,75098,1,1,1593,942,865,77,923,19,1708,766,682,241,
18,"GALATI",172,75098,,122,0,"Str.Ariesului,Scoala Generala ""N.Balcescu""(Scoala Generala Nr.16)","MUNICIPIUL GALATI",1,75098,1,1,2019,1224,1155,69,1201,23,2186,962,874,327,
18,"GALATI",172,75098,,123,0,"Str.Ariesului,Scoala Generala ""N.Balcescu""(Scoala Generala Nr.16)","MUNICIPIUL GALATI",1,75098,1,1,2509,1309,1146,163,1295,14,2781,1472,876,419,
18,"GALATI",172,75098,,124,0,"Str.Ariesului,Scoala Generala ""N.Balcescu""(Scoala Generala Nr.16)","MUNICIPIUL GALATI",1,75098,1,1,969,626,562,64,615,11,1100,474,451,164,
18,"GALATI",172,75098,,125,0,"Str.N.Balcescu Nr.82-84,Facultatea de Studii Economice","MUNICIPIUL GALATI",1,75098,1,1,1359,777,718,59,766,11,1500,723,578,188,
18,"GALATI",172,75098,,126,0,"Str.N.Balcescu Nr.82-84,Facultatea de Studii Economice","MUNICIPIUL GALATI",1,75098,1,1,1535,912,779,133,890,22,1583,671,663,227,
18,"GALATI",172,75098,,127,0,"Str.Basarabiei,Scoala Generala ""Petru Rares""(Scoala Generala Nr.25)","MUNICIPIUL GALATI",1,75098,1,1,2444,1396,1252,144,1374,22,2700,1304,970,404,
18,"GALATI",172,75098,,128,0,"Str.Basarabiei,Scoala Generala ""Petru Rares""(Scoala Generala Nr.25)","MUNICIPIUL GALATI",1,75098,1,1,1603,968,815,153,953,15,1707,739,660,293,
18,"GALATI",172,75098,,129,0,"Str.Domneasca Nr.47,Universitatea Galati","MUNICIPIUL GALATI",1,75098,1,1,2392,1396,1288,108,1376,20,2600,1204,1007,369,
18,"GALATI",172,75098,,130,0,"Str.Stelei,Scoala Generala Nr.19","MUNICIPIUL GALATI",1,75098,1,1,1471,956,753,203,946,10,1600,644,646,300,
18,"GALATI",172,75098,,131,0,"Str.Stelei,Scoala Generala Nr.19","MUNICIPIUL GALATI",1,75098,1,1,1471,805,720,85,795,10,1600,795,540,255,
18,"GALATI",172,75098,,132,0,"Str.Traian Nr.203,Grup Scolar Industrial Traian(Liceul Industrial Nr.1)","MUNICIPIUL GALATI",1,75098,1,1,2177,1658,1187,471,1634,24,2900,1242,1106,528,
18,"GALATI",172,75098,,133,0,"Str.Domneasca,Grup Scolar de Industrie Alimentara Nr.1(LIA)","MUNICIPIUL GALATI",1,75098,1,1,1410,822,736,86,812,10,1500,678,589,223,
18,"GALATI",172,75098,,134,0,"Str.Radu Negru,Scoala Generala Nr.27","MUNICIPIUL GALATI",1,75098,1,1,2001,1352,1008,344,1340,12,2500,1148,958,382,
18,"GALATI",172,75098,,135,0,"Str.Domneasca,Grup Scolar de Industrie Alimentara Nr.1(LIA)","MUNICIPIUL GALATI",1,75098,1,1,1603,860,818,42,845,15,1700,840,545,300,
18,"GALATI",172,75098,,136,0,"Str.Navelor,SC ""PROIECT"" SA","MUNICIPIUL GALATI",1,75098,1,1,1985,1131,1091,40,1112,19,2100,969,862,250,
18,"GALATI",172,75098,,137,0,"Str.Portului Nr.59,Grupul Scolar de Marina(Liceul de Marina)","MUNICIPIUL GALATI",1,75098,1,1,1463,897,554,343,882,15,1600,703,518,364,
18,"GALATI",172,75098,,138,0,"Str.Portului Nr.59,Grupul Scolar de Marina(Liceul de Marina)","MUNICIPIUL GALATI",1,75098,1,1,2103,1457,1064,393,1443,14,2300,843,965,478,
18,"GALATI",172,75098,,139,1,"Spitalul Judetean Galati ""Sf.Andrei""","MUNICIPIUL GALATI",1,75098,1,1,0,725,0,725,711,14,892,167,528,183,
18,"GALATI",172,75098,,140,1,"Spitalul Municipal Nr.1 Galati ""Elena Doamna""","MUNICIPIUL GALATI",1,75098,1,1,0,290,0,290,286,4,400,110,209,77,
18,"GALATI",172,75098,,141,1,"Str.Stiintei,Spitalul TBC Galati","MUNICIPIUL GALATI",1,75098,1,1,0,176,0,176,175,1,800,624,103,72,
18,"GALATI",172,75098,,142,1,"Bariera Traian,Spitalul de Boli Infectioase","MUNICIPIUL GALATI",1,75098,1,1,0,82,0,82,80,2,100,18,59,21,
18,"GALATI",172,75098,,143,1,"Str.D.N. Alexandrescu,Maternitatea ""Buna Vestire"" Galati","MUNICIPIUL GALATI",1,75098,1,1,0,75,0,75,75,0,100,25,54,21,
18,"GALATI",172,75098,,144,1,"Str.Domneasca nr.142,Cantina Studenteasca Nr.1 - Complexul Studentesc","MUNICIPIUL GALATI",1,75098,1,1,0,897,0,897,871,26,2700,1803,572,299,
18,"GALATI",172,75098,,145,1,"Gara de Calatori CFR - Galati","MUNICIPIUL GALATI",1,75098,1,1,0,376,0,376,375,1,400,24,230,145,
18,"GALATI",172,75098,,146,1,"Str.Eroilor Nr.20,Cercul Militar Galati","MUNICIPIUL GALATI",1,75098,1,1,0,759,0,759,723,36,900,141,471,252,
18,"GALATI",172,75203,,147,0,"Str.Tecuciul Nou nr.69( Scoala generala nr.1 )","MUNICIPIUL TECUCI",2,75203,1,1,2021,1218,1100,118,1200,18,2300,1082,748,452,
18,"GALATI",172,75203,,148,0,"Str. Tecuciul Nou nr.69 ( Scoala  Generala nr.1 )","MUNICIPIUL TECUCI",2,75203,1,1,1560,870,827,43,855,15,1800,930,513,342,
18,"GALATI",172,75203,,149,0,"Str. 1 Decembrie 1918 nr.26 ( Scoala Generala nr.10)","MUNICIPIUL TECUCI",2,75203,1,1,1915,1063,966,97,1049,14,2200,1137,704,345,
18,"GALATI",172,75203,,150,0,"Str. Alexandru Papadopol Calimah nr.13 ( Scoala Generala nr.2 )","MUNICIPIUL TECUCI",2,75203,1,1,2062,1356,1245,111,1342,14,2300,944,974,368,
18,"GALATI",172,75203,,151,0,"Str. Cuza Voda  ( Gradinita de copii )","MUNICIPIUL TECUCI",2,75203,1,1,1349,777,699,78,758,19,1500,723,507,251,
18,"GALATI",172,75203,,152,0,"Str. Unirii nr.6 ( Scoala Generala nr. 4 )","MUNICIPIUL TECUCI",2,75203,1,1,2019,1218,1075,143,1194,24,2300,1082,845,349,
18,"GALATI",172,75203,,153,0,"B-dul Victoriei nr.12 ( Liceul Spiru Haret)","MUNICIPIUL TECUCI",2,75203,1,1,2132,1131,1044,87,1111,20,2400,1269,802,309,
18,"GALATI",172,75203,,154,0,"Str. 1 Decembrie 1918 nr.103 ( Grupul scolar  agricol Tecuci)","MUNICIPIUL TECUCI",2,75203,1,1,1669,866,774,92,859,7,1900,1034,570,289,
18,"GALATI",172,75203,,155,0,"Str. 1 Decembrie 1918 nr. 103 ( Grupul scolar agricol Tecuci )","MUNICIPIUL TECUCI",2,75203,1,1,1267,715,656,59,707,8,1400,685,445,262,
18,"GALATI",172,75203,,156,0,"Str. 1 Decembrie 1918 nr.125 ( Scoala Generala  nr. 11 )","MUNICIPIUL TECUCI",2,75203,1,1,2267,1190,1027,163,1181,9,2500,1310,784,397,
18,"GALATI",172,75203,,157,0,"Str. 1 Decembrie 1918 nr.125 (Scoala Generala nr.11)","MUNICIPIUL TECUCI",2,75203,1,1,2028,1108,985,123,1097,11,2300,1192,619,478,
18,"GALATI",172,75203,,158,0,"Str. Matei Basarab nr.12 (Scoala Generala nr.8)","MUNICIPIUL TECUCI",2,75203,1,1,1824,1078,971,107,1057,21,2102,1024,703,354,
18,"GALATI",172,75203,,159,0,"Str.Elena Doamna nr.52 (Scoala Generala nr.6)","MUNICIPIUL TECUCI",2,75203,1,1,2130,1267,1173,94,1255,12,2400,1133,822,433,
18,"GALATI",172,75203,,160,0,"Str.Ana Ipatescu nr.35 (Scoala Generala nr.7)","MUNICIPIUL TECUCI",2,75203,1,1,1374,840,785,55,830,10,1600,760,528,302,
18,"GALATI",172,75203,,161,0,"Str.Ana Ipatescu nr.35 ( Scoala Generala nr.7 )","MUNICIPIUL TECUCI",2,75203,1,1,1381,895,809,86,881,14,1600,705,658,223,
18,"GALATI",172,75203,,162,0,"Str.Gh. Petrascu nr.85 ( Gradinita nr.18 )","MUNICIPIUL TECUCI",2,75203,1,1,2321,1441,1129,312,1430,11,2600,1159,899,531,
18,"GALATI",172,75203,,163,0,"Str.Gh. Pertasacu nr.42 ( Gradinita nr.2 )","MUNICIPIUL TECUCI",2,75203,1,1,2198,1193,1049,144,1184,9,2400,1207,754,430,
18,"GALATI",172,75203,,164,0,"Str.Costache Racovita nr.24 ( Liceul Calistrat  Hogas )","MUNICIPIUL TECUCI",2,75203,1,1,2445,1131,1031,100,1112,19,2800,1669,737,375,
18,"GALATI",172,75203,,165,0,"Str. Gh. Petrascu nr.20 ( S.C. VITIMAS SA )","MUNICIPIUL TECUCI",2,75203,1,1,2229,1031,959,72,1019,12,2550,1519,641,378,
18,"GALATI",172,75203,,166,0,"Str. Cocorasti nr.1 ( Scoala Generala nr.9 )","MUNICIPIUL TECUCI",2,75203,1,1,892,643,587,56,632,11,1000,357,295,337,
18,"GALATI",172,75203,,167,1,"Str. Costache Racovita nr.18 (Cercul Militar )","MUNICIPIUL TECUCI",2,75203,1,1,0,571,0,571,549,22,650,79,360,189,
18,"GALATI",172,75203,,168,1,"Str. Costache Conachi nr 35 ( Spitalui ""Anton Cincu"")","MUNICIPIUL TECUCI",2,75203,1,1,0,183,0,183,182,1,450,267,136,46,
18,"GALATI",172,75338,,169,0,"Str. Trandafirilor nr.26 ( Casa de Cultura ""Ion Creanga"" )","ORAS BERESTI",3,75338,2,1,1390,746,687,59,736,10,1500,754,506,230,
18,"GALATI",172,75338,,170,0,"Str. Trandafirilor nr. 210 ( Liceul teoretic Paul Bujor )","ORAS BERESTI",3,75338,2,1,1670,1010,935,75,993,17,1800,790,711,282,
18,"GALATI",172,75472,,171,0,"Scoala Generala nr.1","ORAS TARGU BUJOR",4,75472,2,1,1500,863,777,86,841,22,1650,787,571,270,
18,"GALATI",172,75472,,172,0,"Scoala Generala nr.2","ORAS TARGU BUJOR",4,75472,2,1,2407,1333,1205,128,1317,16,2650,1317,885,432,
18,"GALATI",172,75472,,173,0,"Scoala Generala de 8 ani Moscu","ORAS TARGU BUJOR",4,75472,2,1,1077,774,671,103,766,8,1200,426,590,176,
18,"GALATI",172,75472,,174,0,"Scoala Generala de 8 ani Umbraresti","ORAS TARGU BUJOR",4,75472,2,1,964,612,560,52,605,7,1100,488,417,188,
18,"GALATI",172,75515,,175,0,"Scoala Generala nr.1 Barcea","BARCEA",9,75515,0,3,2267,1116,993,123,1094,22,2500,1384,782,312,
18,"GALATI",172,75515,,176,0,"Scoala Generala nr.2 Barcea","BARCEA",9,75515,0,3,2103,1108,1000,108,1086,22,2300,1192,750,336,
18,"GALATI",172,75542,,177,0,"Caminul Cultural Balabanesti","BALABANESTI",5,75542,0,3,672,413,342,71,407,6,750,337,316,91,
18,"GALATI",172,75542,,178,0,"Scoala Generala Bursucani","BALABANESTI",5,75542,0,3,510,415,319,96,414,1,550,135,342,72,
18,"GALATI",172,75542,,179,0,"Scoala Generala Cruceanu","BALABANESTI",5,75542,0,3,231,120,99,21,120,0,250,130,90,30,
18,"GALATI",172,75542,,180,0,"Scoala Generala Lungesti","BALABANESTI",5,75542,0,3,513,313,272,41,305,8,550,237,240,65,
18,"GALATI",172,75542,,181,0,"Caminul cultural Radesti","BALABANESTI",5,75542,0,3,1117,659,568,91,649,10,1350,691,489,160,
18,"GALATI",172,75613,,182,0,"Caminul cultural Balasesti","BALASESTI",6,75613,0,3,1220,712,617,95,696,16,1350,638,543,153,
18,"GALATI",172,75613,,183,0,"Gradinita Ciurestii Noi","BALASESTI",6,75613,0,3,495,341,284,57,333,8,550,209,273,60,
18,"GALATI",172,75613,,184,0,"Scoala Generala Ciurestii Vechii","BALASESTI",6,75613,0,3,379,271,200,71,261,10,400,129,191,70,
18,"GALATI",172,75668,,185,0,"Caminul cultural Baleni","BALENI",7,75668,0,3,2223,1262,1126,136,1252,10,2500,1238,891,361,
18,"GALATI",172,75686,,186,0,"Gradinita de copii Baneasa","BANEASA",8,75686,0,3,1261,745,675,70,732,13,1400,655,463,269,
18,"GALATI",172,75686,,187,0,"Scoala Generala Roscani","BANEASA",8,75686,0,3,529,336,276,60,332,4,600,264,191,141,
18,"GALATI",172,75356,,188,0,"Gradinita Beresti Meria","BERESTI-MERIA",10,75356,0,3,556,292,250,42,291,1,600,308,198,93,
18,"GALATI",172,75356,,189,0,"Scoala Generala Plesa","BERESTI-MERIA",10,75356,0,3,618,401,351,50,394,7,700,299,298,96,
18,"GALATI",172,75356,,190,0,"Scoala Generala Puricani","BERESTI-MERIA",10,75356,0,3,361,256,167,89,252,4,400,144,181,71,
18,"GALATI",172,75356,,191,0,"Scoala Generala Slivna","BERESTI-MERIA",10,75356,0,3,615,378,301,77,368,10,700,322,276,92,
18,"GALATI",172,75356,,192,0,"Scoala Generala Balintesti","BERESTI-MERIA",10,75356,0,3,862,549,447,102,537,12,950,401,382,155,
18,"GALATI",172,75356,,193,0,"Scoala Generala Aldesti","BERESTI-MERIA",10,75356,0,3,591,252,225,27,250,2,650,398,172,78,
18,"GALATI",172,75711,,194,0,"Gradinita de copii Branistea","BRANISTEA",12,75711,0,3,2272,1364,1205,159,1341,23,2500,1136,921,420,
18,"GALATI",172,75711,,195,0,"Scoala Generala Vasile Alecsandri","BRANISTEA",12,75711,0,3,660,447,376,71,442,5,700,253,253,189,
18,"GALATI",172,75766,,196,0,"Scoala Generala nr.1 Brahasesti","BRAHASESTI",11,75766,0,3,2022,1195,978,217,1174,21,2200,1005,798,376,
18,"GALATI",172,75766,,197,0,"Scoala Generala  Toflea","BRAHASESTI",11,75766,0,3,3347,1200,999,201,1176,24,4000,2800,1087,89,
18,"GALATI",172,75819,,198,0,"Scoala Generala Buciumeni","BUCIUMENI",13,75819,0,3,1213,728,595,133,718,10,1400,672,508,210,
18,"GALATI",172,75819,,199,0,"Scoala Benerala Hintesti","BUCIUMENI",13,75819,0,3,757,459,369,90,444,15,800,341,264,180,
18,"GALATI",172,75864,,200,0,"Scoala Generala Cavadinesti","CAVADINESTI",14,75864,0,3,1314,746,645,101,735,11,1502,756,573,162,
18,"GALATI",172,75864,,201,0,"Scoala Generala Ganesti","CAVADINESTI",14,75864,0,3,994,548,408,140,534,14,1052,504,370,164,
18,"GALATI",172,75864,,202,0,"Scoala Generala Vadeni","CAVADINESTI",14,75864,0,3,519,328,281,47,322,6,600,272,269,53,
18,"GALATI",172,75917,,203,0,"Localul Primariei","CERTESTI",15,75917,0,3,750,419,311,108,414,5,800,381,314,100,
18,"GALATI",172,75917,,204,0,"Scoala Generala Carlomanesti","CERTESTI",15,75917,0,3,564,390,297,93,376,14,600,210,276,100,
18,"GALATI",172,75917,,205,0,"Scoala Generala Cotoroaia","CERTESTI",15,75917,0,3,637,478,353,125,470,8,700,222,333,137,
18,"GALATI",172,76004,,206,0,"Caminul cultural Corni","CORNI",16,76004,0,3,873,535,479,56,529,6,900,365,408,121,
18,"GALATI",172,76004,,207,0,"Caminul cultural Maciseni","CORNI",16,76004,0,3,796,461,409,52,452,9,900,439,342,110,
18,"GALATI",172,76004,,208,0,"Scoala Generala Urlesti","CORNI",16,76004,0,3,463,327,298,29,321,6,500,173,254,67,
18,"GALATI",172,75953,,209,0,"Scoala Generala nr.2 Corod","COROD",17,75953,0,3,2179,1161,1011,150,1147,14,2400,1239,880,267,
18,"GALATI",172,75953,,210,0,"Scoala Generala nr.3 Corod","COROD",17,75953,0,3,2112,888,781,107,875,13,2500,1612,699,176,
18,"GALATI",172,75953,,211,0,"Scoala Generala Blanzi","COROD",17,75953,0,3,1628,874,795,79,859,15,1800,926,770,89,
18,"GALATI",172,75953,,212,0,"Scoala Generala Carpacesti","COROD",17,75953,0,3,384,398,215,183,390,8,500,102,329,61,
18,"GALATI",172,76040,,213,0,"Caminul cultural Cosmesti-Deal","COSMESTI",18,76040,0,3,1635,1578,1297,281,1562,16,2000,422,1217,345,
18,"GALATI",172,76040,,214,0,"Scoala Generala Cosmesti-Vale","COSMESTI",18,76040,0,3,982,675,545,130,668,7,1100,425,486,182,
18,"GALATI",172,76040,,215,0,"Caminul cultural  sat Furcenii Vechi","COSMESTI",18,76040,0,3,1150,850,650,200,835,15,1250,400,541,294,
18,"GALATI",172,76040,,216,0,"Scoala Generala Furcenii Noi","COSMESTI",18,76040,0,3,1186,753,613,140,742,11,1300,547,506,236,
18,"GALATI",172,76111,,217,0,"Scoala Generala Costache Negri","COSTACHE NEGRI",19,76111,0,3,1877,1151,1027,124,1135,16,2050,899,843,292,
18,"GALATI",172,76139,,218,0,"Caminul cultural Cuca","CUCA",20,76139,0,3,1182,630,587,43,620,10,1300,670,436,184,
18,"GALATI",172,76139,,219,0,"Gradinita de copii Cuca","CUCA",20,76139,0,3,1151,649,606,43,633,16,1250,601,430,203,
18,"GALATI",172,76157,,220,0,"Scoala Generala nr.1(Local D)","CUDALBI",21,76157,0,3,1955,996,916,80,973,23,2150,1154,727,246,
18,"GALATI",172,76157,,221,0,"Scoala Generala nr.1 Local B)","CUDALBI",21,76157,0,3,1406,817,724,93,797,20,1550,733,583,214,
18,"GALATI",172,76157,,222,0,"Scoala Generala nr.1 (Local C)","CUDALBI",21,76157,0,3,1418,820,747,73,787,33,1550,730,572,215,
18,"GALATI",172,76157,,223,0,"Scoala Generala nr.2 Cudalbi","CUDALBI",21,76157,0,3,1560,1004,903,101,979,25,1700,696,791,188,
18,"GALATI",172,75221,,224,0,"Scoala Generala Draganesti","DRAGANESTI",22,75221,0,3,2333,1386,1250,136,1367,19,2600,1214,903,464,
18,"GALATI",172,75221,,225,0,"Scoala Generala Malu Alb","DRAGANESTI",22,75221,0,3,1928,1266,1037,229,1243,23,2150,884,752,491,
18,"GALATI",172,76175,,226,0,"Consiliul Local Draguseni","DRAGUSENI",23,76175,0,3,1340,1052,892,160,1038,14,1450,398,736,302,
18,"GALATI",172,76175,,227,0,"Scoala Generala Fundeanu","DRAGUSENI",23,76175,0,3,1026,637,540,97,631,6,1100,463,488,143,
18,"GALATI",172,76175,,228,0,"Scoala Generala Cauesti","DRAGUSENI",23,76175,0,3,667,449,360,89,442,7,700,251,371,71,
18,"GALATI",172,76175,,229,0,"Sala de festivitati- sat Adam","DRAGUSENI",23,76175,0,3,940,551,483,68,544,7,1000,449,419,125,
18,"GALATI",172,76255,,230,0,"Caminul cultural Fartanesti","FARTANESTI",24,76255,0,3,2790,1395,1253,142,1374,21,3050,1655,880,494,
18,"GALATI",172,76255,,231,0,"Caminul cultural Viile","FARTANESTI",24,76255,0,3,1300,808,703,105,794,14,1400,592,647,147,
18,"GALATI",172,76282,,232,0,"Caminul cultutal Foltesti","FOLTESTI",25,76282,0,3,1695,930,799,131,919,11,1850,920,603,316,
18,"GALATI",172,76282,,233,0,"Scoala Generala Stoicani","FOLTESTI",25,76282,0,3,783,493,420,73,484,9,850,357,311,173,
18,"GALATI",172,76317,,234,0,"Primaria Frumusita","FRUMUSITA",26,76317,0,3,2235,1214,1060,154,1190,24,2450,1236,837,353,
18,"GALATI",172,76317,,235,0,"Societatea Agricola ""IZBANDA"" - Ijdileni","FRUMUSITA",26,76317,0,3,1001,560,446,114,552,8,1100,540,386,166,
18,"GALATI",172,76317,,236,0,"Scoala Generala Tamoani","FRUMUSITA",26,76317,0,3,803,471,395,76,462,9,850,379,320,142,
18,"GALATI",172,76353,,237,0,"Scoala Generala Fundeni","FUNDENI",27,76353,0,3,1052,669,557,112,658,11,1250,581,435,223,
18,"GALATI",172,76353,,238,0,"Scoala Generala Hanu Conachi","FUNDENI",27,76353,0,3,1975,1159,1006,153,1147,12,2150,991,786,361,
18,"GALATI",172,76406,,239,0,"Gradinita de copii Ghidigeni","GHIDIGENI",28,76406,0,3,2367,1267,1100,167,1255,12,2600,1333,932,323,
18,"GALATI",172,76406,,240,0,"Scoala Generala Talpigi","GHIDIGENI",28,76406,0,3,1895,1177,993,184,1160,17,2050,873,850,310,
18,"GALATI",172,76497,,241,0,"Scoala Generala Gohor","GOHOR",29,76497,0,3,1426,837,699,138,825,12,1550,713,570,255,
18,"GALATI",172,76497,,242,0,"Scoala Generala de 4 ani Ireasca","GOHOR",29,76497,0,3,300,195,149,46,193,2,340,145,118,75,
18,"GALATI",172,76497,,243,0,"Scoala Generala Nartesti","GOHOR",29,76497,0,3,707,467,384,83,458,4,746,284,277,181,
18,"GALATI",172,76497,,244,0,"Scoala Generala de 8 ani Berheci","GOHOR",29,76497,0,3,555,392,284,108,392,0,600,208,214,178,
18,"GALATI",172,76558,,245,0,"Scoala Generala Grivita (scoala noua)","GRIVITA",30,76558,0,3,1450,859,782,77,848,11,1600,741,542,306,
18,"GALATI",172,76558,,246,0,"Scoala Generala Grivita ( scoala veche)","GRIVITA",30,76558,0,3,1048,604,536,68,587,17,1150,546,364,223,
18,"GALATI",172,76558,,247,0,"Scoala Generala Calmatui","GRIVITA",30,76558,0,3,407,263,194,69,260,3,450,187,172,88,
18,"GALATI",172,76585,,248,0,"Scoala Generala nr.1","INDEPENDENTA",31,76585,0,3,2095,1187,1012,175,1171,16,2300,1113,764,407,
18,"GALATI",172,76585,,249,0,"Scoala Generala nr.2","INDEPENDENTA",31,76585,0,3,1469,895,755,140,882,13,1600,705,540,342,
18,"GALATI",172,76601,,250,0,"Scoala Generala nr.3 Ivesti","IVESTI",32,76601,0,3,2110,988,794,194,952,36,2300,1312,640,312,
18,"GALATI",172,76601,,251,0,"Scoala "" Hortensia Papadat Bengescu""","IVESTI",32,76601,0,3,1579,915,670,245,902,13,1700,785,652,250,
18,"GALATI",172,76601,,252,0,"Scoala ""Catalin Negoita""","IVESTI",32,76601,0,3,1450,985,617,368,951,34,1600,615,563,388,
18,"GALATI",172,76601,,253,0,"Scoala ""Gen.Eremia Grigorescu""","IVESTI",32,76601,0,3,2165,953,770,183,932,21,2350,1397,631,301,
18,"GALATI",172,76638,,254,0,"Caminul Cultural Jorasti","JORASTI",33,76638,0,3,1024,606,531,75,595,11,1100,494,464,131,
18,"GALATI",172,76638,,255,0,"Scoala Generala Lunca","JORASTI",33,76638,0,3,221,151,130,21,150,1,250,99,126,24,
18,"GALATI",172,76638,,256,0,"Scoala Generala Zarnesti","JORASTI",33,76638,0,3,286,210,178,32,207,3,300,90,162,45,
18,"GALATI",172,76674,,257,0,"Scoala Generala Nr.1 Liesti","LIESTI",34,76674,0,3,1886,1030,844,186,1018,12,2050,1020,593,425,
18,"GALATI",172,76674,,258,0,"Clubul Elevilor Liesti","LIESTI",34,76674,0,3,1310,752,586,166,746,6,1442,690,482,264,
18,"GALATI",172,76674,,259,0,"Clubul Elevilor Liesti","LIESTI",34,76674,0,3,1847,1139,943,196,1118,21,2000,861,744,374,
18,"GALATI",172,76674,,260,0,"Scoala Generala Nr.3 Serbanesti","LIESTI",34,76674,0,3,1979,1158,978,180,1139,19,2145,987,658,481,
18,"GALATI",172,76674,,261,0,"Scoala Generala NR.3 Serbanesti","LIESTI",34,76674,0,3,1666,976,822,154,960,16,1800,824,588,372,
18,"GALATI",172,76692,,262,0,"Scoala Generala Nr.2 Matca","MATCA",36,76692,0,3,2670,2397,1991,406,2377,20,2900,503,1880,497,
18,"GALATI",172,76692,,263,0,"Scoala Generala Suseni","MATCA",36,76692,0,3,1618,1466,942,524,1421,45,1750,284,1024,397,
18,"GALATI",172,76692,,264,0,"Scoala Generala Nr.1 Matca","MATCA",36,76692,0,3,2328,1754,1402,352,1732,22,2550,796,1209,523,
18,"GALATI",172,76692,,265,0,"Scoala Generala Nr.1 Matca","MATCA",36,76692,0,3,1917,1592,1260,332,1567,25,2100,508,1142,425,
18,"GALATI",172,76718,,266,0,"Scoala Generala Nr.1 Mastacani","MASTACANI",35,76718,0,3,2197,886,766,120,874,12,2450,1564,494,380,
18,"GALATI",172,76718,,267,0,"Scoala Generala Nr.1 Chiraftei","MASTACANI",35,76718,0,3,1146,654,475,179,650,4,1250,596,395,255,
18,"GALATI",172,76718,,268,0,"Scoala Generala Nr.2 Chiraftei","MASTACANI",35,76718,0,3,849,506,370,136,501,5,900,394,358,143,
18,"GALATI",172,76745,,269,0,"Caminul Cultural Movileni","MOVILENI",37,76745,0,3,1376,849,755,94,835,14,1500,651,580,255,
18,"GALATI",172,76745,,270,0,"Scoala Generala Nr.2 Movileni","MOVILENI",37,76745,0,3,1143,659,556,103,641,18,1250,591,397,244,
18,"GALATI",172,75258,,271,0,"Gradinita de copii Munteni","MUNTENI",38,75258,0,3,1859,935,795,140,922,13,2050,1115,605,317,
18,"GALATI",172,75258,,272,0,"Scoala Generala Munteni","MUNTENI",38,75258,0,3,1714,1129,987,142,1086,43,1850,721,813,273,
18,"GALATI",172,75258,,273,0,"Scoala Generala Ungureni","MUNTENI",38,75258,0,3,1662,1013,791,222,1003,10,1800,787,602,401,
18,"GALATI",172,75258,,274,0,"Gradinita de copii Negrilesti","MUNTENI",38,75258,0,3,2033,1101,898,203,1079,22,2200,1099,580,499,
18,"GALATI",172,76763,,275,0,"Scoala Generala Nr.1 Namoloasa","NAMOLOASA",39,76763,0,3,1027,599,521,78,592,7,1150,551,453,139,
18,"GALATI",172,76763,,276,0,"Scoala Generala Nr.2 Namoloasa","NAMOLOASA",39,76763,0,3,1126,671,592,79,659,12,1200,529,556,103,
18,"GALATI",172,76807,,277,0,"Scoala Generala Nicoresti","NICORESTI",40,76807,0,3,2434,757,599,158,748,9,2250,1493,449,299,
18,"GALATI",172,76807,,278,0,"Scoala Generala Fantani","NICORESTI",40,76807,0,3,266,423,146,277,410,13,500,77,309,101,
18,"GALATI",172,76807,,279,0,"Scoala Generala Coasta Lupei","NICORESTI",40,76807,0,3,300,346,139,207,334,12,441,95,189,145,
18,"GALATI",172,76807,,280,0,"Scoala Generala Ionasesti","NICORESTI",40,76807,0,3,385,379,179,200,374,5,500,121,242,132,
18,"GALATI",172,76807,,281,0,"Scoala Generala Poiana","NICORESTI",40,76807,0,3,1333,1092,826,266,1061,31,1450,358,642,419,
18,"GALATI",172,76932,,282,0,"Scoala Generala I-VIII","OANCEA",41,76932,0,3,1236,729,575,154,706,23,1350,621,473,233,
18,"GALATI",172,76969,,283,0,"Caminul Cultural Pechea","PECHEA",42,76969,0,3,2674,1533,1447,86,1506,27,2900,1367,1018,488,
18,"GALATI",172,76969,,284,0,"Gradinita Nr.1 Pechea","PECHEA",42,76969,0,3,2173,1283,1228,55,1263,20,2400,1117,863,400,
18,"GALATI",172,76969,,285,0,"Scoala Generala Nr.2 Pechea","PECHEA",42,76969,0,3,1856,1131,1071,60,1115,16,2000,869,781,334,
18,"GALATI",172,76969,,286,0,"Scoala Generala Nr.1 Pechea","PECHEA",42,76969,0,3,1996,1184,1112,72,1173,11,2200,1016,804,369,
18,"GALATI",172,76996,,287,0,"Caminul Cultural Piscu","PISCU",43,76996,0,3,2169,1196,1077,119,1180,16,2400,1204,759,421,
18,"GALATI",172,76996,,288,0,"Scoala Generala Nr.2 Piscu","PISCU",43,76996,0,3,1798,1021,910,111,1008,13,1950,929,676,332,
18,"GALATI",172,77028,,289,0,"Scoala Generala Priponesti","PRIPONESTI",44,77028,0,3,1081,628,508,120,618,10,1150,522,412,206,
18,"GALATI",172,77028,,290,0,"Scoala Generala Ciorasti","PRIPONESTI",44,77028,0,3,975,668,577,91,661,7,1050,382,535,126,
18,"GALATI",172,77082,,291,0,"Scoala Generala Rediu","REDIU",45,77082,0,3,2076,1180,1057,123,1168,12,2300,1120,909,259,
18,"GALATI",172,77082,,292,0,"Scoala Generala Suhurlui","REDIU",45,77082,0,3,1348,741,673,68,731,10,1450,709,516,215,
18,"GALATI",172,77153,,293,0,"Gradinita de Copii Schela","SCHELA",47,77153,0,3,2050,1386,1212,174,1376,10,2250,864,763,613,
18,"GALATI",172,77153,,294,0,"Scoala Generala Negrea","SCHELA",47,77153,0,3,465,381,324,57,377,4,500,119,320,57,
18,"GALATI",172,77126,,295,0,"Scoala Generala Scanteiesti","SCANTEIESTI",46,77126,0,3,937,522,458,64,512,10,950,428,390,122,
18,"GALATI",172,77126,,296,0,"Scoala Generala Fantanele","SCANTEIESTI",46,77126,0,3,1467,1132,1076,56,1125,7,1602,470,952,173,
18,"GALATI",172,77180,,297,0,"Scoala Generala Slobozia Conachi","SLOBOZIA CONACHI",49,77180,0,3,979,584,515,69,582,2,1050,466,420,162,
18,"GALATI",172,77180,,298,0,"Sala de sedinte a Consiliului local Slobozia Conachi","SLOBOZIA CONACHI",49,77180,0,3,1680,980,862,118,972,8,1850,870,697,275,
18,"GALATI",172,77180,,299,0,"Scoala Generala Cuza Voda","SLOBOZIA CONACHI",49,77180,0,3,2338,1410,1297,113,1386,24,2550,1140,1075,311,
18,"GALATI",172,77180,,300,0,"Scoala Generala Izvoarele","SLOBOZIA CONACHI",49,77180,0,3,830,467,417,50,458,9,900,433,296,162,
18,"GALATI",172,77224,,301,0,"Scoala Generala Smardan","SMARDAN",50,77224,0,3,1246,772,644,128,761,11,1350,578,537,224,
18,"GALATI",172,77224,,302,0,"Scoala Generala M.Kogalniceanu","SMARDAN",50,77224,0,3,474,384,272,112,380,4,500,116,294,86,
18,"GALATI",172,77224,,303,0,"Scoala Generala Cismele","SMARDAN",50,77224,0,3,815,508,421,87,506,2,850,342,383,123,
18,"GALATI",172,77260,,304,0,"Scoala Generala Smulti","SMULTI",51,77260,0,3,1463,890,810,80,871,19,1600,710,578,293,
18,"GALATI",172,77288,,305,0,"Scoala Generala I-IV Suceveni","SUCEVENI",52,77288,0,3,1294,764,655,109,757,7,1300,536,597,160,
18,"GALATI",172,77288,,306,0,"Scoala Generala I-VIII Rogojeni","SUCEVENI",52,77288,0,3,527,405,298,107,397,8,550,145,315,82,
18,"GALATI",172,75114,,307,0,"Gradinita de copii Sendreni","SENDRENI",48,75114,0,3,1322,861,699,162,857,4,1400,539,611,246,
18,"GALATI",172,75114,,308,0,"Scoala Generala I-IV Serbestii Vechi","SENDRENI",48,75114,0,3,384,397,231,166,392,5,450,53,282,110,
18,"GALATI",172,75114,,309,0,"Scoala Generala I-IV Movileni","SENDRENI",48,75114,0,3,342,258,180,78,250,8,339,81,181,69,
18,"GALATI",172,77313,,310,0,"Scoala Generala T.Vladimirescu","TUDOR VLADIMIRESCU",54,77313,0,3,2110,1209,1073,136,1185,24,2300,1091,755,430,
18,"GALATI",172,77313,,311,0,"Liceul Teoretic T.Vladimirescu","TUDOR VLADIMIRESCU",54,77313,0,3,1901,1314,1159,155,1300,14,2100,786,777,523,
18,"GALATI",172,77331,,312,0,"Gradinita Tulucesti","TULUCESTI",55,77331,0,3,1938,1143,1003,140,1132,11,2100,957,780,352,
18,"GALATI",172,77331,,313,0,"Scoala Generala Tulucesti","TULUCESTI",55,77331,0,3,1340,772,668,104,758,14,1450,678,580,178,
18,"GALATI",172,77331,,314,0,"Scoala Generala Sivita","TULUCESTI",55,77331,0,3,1693,877,727,150,864,13,1850,973,599,265,
18,"GALATI",172,77331,,315,0,"Gradinita Sivita","TULUCESTI",55,77331,0,3,1083,628,511,117,617,11,1200,572,447,170,
18,"GALATI",172,77377,,316,0,"Sala de sedinte Consiliul Local","TEPU",53,77377,0,3,2102,1205,1110,95,1168,37,2300,1095,750,418,
18,"GALATI",172,77402,,317,0,"Scoala Generala Umbraresti","UMBRARESTI",56,77402,0,3,2025,1073,880,193,1060,13,2200,1127,723,337,
18,"GALATI",172,77402,,318,0,"Scoala Generala Umbraresti Deal","UMBRARESTI",56,77402,0,3,1820,1225,961,264,1207,18,2000,775,756,451,
18,"GALATI",172,77402,,319,0,"Scoala Generala Condrea","UMBRARESTI",56,77402,0,3,1385,769,634,135,757,12,1500,731,526,231,
18,"GALATI",172,77475,,320,0,"Scoala Generala Nr.1 Valea Marului","VALEA MARULUI",57,77475,0,3,2149,1330,1247,83,1302,28,2350,1020,869,433,
18,"GALATI",172,77475,,321,0,"Scoala Generala Mandresti","VALEA MARULUI",57,77475,0,3,900,604,502,102,594,10,1000,396,401,193,
18,"GALATI",172,75150,,322,0,"Scoala Generala Vanatori","VANATORI",58,75150,0,3,1259,913,765,148,902,11,1397,484,656,246,
18,"GALATI",172,75150,,323,0,"Scoala Generala Odaia Manolache","VANATORI",58,75150,0,3,1157,691,605,86,690,1,1250,559,530,160,
18,"GALATI",172,75150,,324,0,"Scoala Generala Satu-Costi","VANATORI",58,75150,0,3,397,257,192,65,254,3,450,193,166,88,
18,"GALATI",172,77509,,325,0,"Scoala Generala Varlezi","VARLEZI",59,77509,0,3,1032,587,501,86,579,8,1100,513,428,151,
18,"GALATI",172,77509,,326,0,"Scoala Generala Craiesti","VARLEZI",59,77509,0,3,770,458,406,52,447,11,850,392,300,147,
18,"GALATI",172,77536,,327,0,"Caminul Cultural Vladesti","VLADESTI",60,77536,0,3,1143,599,534,65,587,12,1250,651,468,119,
18,"GALATI",172,77536,,328,0,"Scoala Generala Branesti","VLADESTI",60,77536,0,3,817,505,441,64,494,11,900,395,377,117,
19,"GIURGIU",528,100521,,1,0,"SCOALA GENERALA NR.1 PIATA SF.GHEORGHE","MUNICIPIUL GIURGIU",1,100521,1,1,1806,1000,943,57,993,7,1950,950,750,243,
19,"GIURGIU",528,100521,,2,0,"COMPLEX ATCOM STR.GARII","MUNICIPIUL GIURGIU",1,100521,1,1,945,574,541,33,559,15,1000,426,438,121,
19,"GIURGIU",528,100521,,3,0,"BLOC 32/335 PARTER,B-DUL C.F.R.","MUNICIPIUL GIURGIU",1,100521,1,1,1038,643,587,56,635,8,1050,407,432,203,
19,"GIURGIU",528,100521,,4,0,"LICEUL TUDOR VIANU,STR.23 AUGUST,NR.10","MUNICIPIUL GIURGIU",1,100521,1,1,1399,735,671,64,723,12,1501,766,534,189,
19,"GIURGIU",528,100521,,5,0,"SCOALA GENERALA NR.2,STR.NICOLAE IORGA,NR 34","MUNICIPIUL GIURGIU",1,100521,1,1,1342,743,713,30,737,6,1450,707,540,197,
19,"GIURGIU",528,100521,,6,0,"CANTINA LICEULUI DE CHIMIE,SOS.SLOBOZIEINR.1","MUNICIPIUL GIURGIU",1,100521,1,1,1589,1015,863,152,1009,6,1700,685,675,334,
19,"GIURGIU",528,100521,,7,0,"CANTINA LICEULUI DE CHIMIE ,SOS.SLOBOZIEI NR.1","MUNICIPIUL GIURGIU",1,100521,1,1,1666,907,856,51,899,8,1800,893,602,297,
19,"GIURGIU",528,100521,,8,0,"SEDIUL POLICLINICII,SOS.ALEXANDRIEI,NR.7","MUNICIPIUL GIURGIU",1,100521,1,1,1659,996,919,77,984,12,1800,804,740,244,
19,"GIURGIU",528,100521,,9,0,"LICEUL N. CARTOJAN,STR.23 AUGUST,NR.57","MUNICIPIUL GIURGIU",1,100521,1,1,1005,562,54,508,559,3,1100,538,395,164,
19,"GIURGIU",528,100521,,10,0,"SCOALA GENERALA NR.3,STR.DAN LUCAN,NR.19","MUNICIPIUL GIURGIU",1,100521,1,1,1368,731,697,34,720,11,1500,769,534,186,
19,"GIURGIU",528,100521,,11,0,"CLUBUL ELEVILOR,STR.GARII,NR.115","MUNICIPIUL GIURGIU",1,100521,1,1,782,359,338,21,353,6,850,491,274,79,
19,"GIURGIU",528,100521,,12,0,"GRADINITA NR.8,STR.GORNENI,NR.54","MUNICIPIUL GIURGIU",1,100521,1,1,1483,843,810,33,837,6,1600,757,623,214,
19,"GIURGIU",528,100521,,13,0,"SEDIUL D.G.A.I.A.,SOS.GHIZDARULUI,NR.2","MUNICIPIUL GIURGIU",1,100521,1,1,1887,844,768,76,819,25,2000,1156,629,190,
19,"GIURGIU",528,100521,,14,0,"FOSTA SCOALA NR.9","MUNICIPIUL GIURGIU",1,100521,1,1,1859,886,850,36,877,9,2000,1114,602,275,
19,"GIURGIU",528,100521,,15,0,"SOS.BUCURESTI,BL.10/2S PARTER","MUNICIPIUL GIURGIU",1,100521,1,1,1511,881,831,50,874,7,1650,769,626,248,
19,"GIURGIU",528,100521,,16,0,"SPITALUL JUDETEAN,SOS. BUCURESTI,NR.82","MUNICIPIUL GIURGIU",1,100521,1,1,1417,878,713,165,868,10,1550,672,636,232,
19,"GIURGIU",528,100521,,17,0,"SPITALUL JUDETEAN ,SOS.BUCURESTI,NR.82","MUNICIPIUL GIURGIU",1,100521,1,1,1568,847,733,114,840,7,1700,853,591,249,
19,"GIURGIU",528,100521,,18,0,"SCOALA GENERALA ,NR.8","MUNICIPIUL GIURGIU",1,100521,1,1,1231,648,561,87,641,7,1350,702,396,245,
19,"GIURGIU",528,100521,,19,0,"S.C.COMCARTEX S.A.,BL.202 PARTER","MUNICIPIUL GIURGIU",1,100521,1,1,2655,1350,1274,76,1344,6,2900,1550,971,373,
19,"GIURGIU",528,100521,,20,0,"SCOALA GENERALA NR.8","MUNICIPIUL GIURGIU",1,100521,1,1,2204,1208,1115,93,1190,18,2400,1192,792,398,
19,"GIURGIU",528,100521,,21,0,"SOS.BUCURESTI,BL.47,PARTER","MUNICIPIUL GIURGIU",1,100521,1,1,1193,670,624,46,663,7,1300,630,474,189,
19,"GIURGIU",528,100521,,22,0,"MAGAZINUL DE MOBILA,SOS.BUCURESTI,BL.B3/1S PARTER","MUNICIPIUL GIURGIU",1,100521,1,1,1547,837,773,64,831,6,1700,863,577,254,
19,"GIURGIU",528,100521,,23,0,"SOS.BUCURESTI,BL.61 PARTER","MUNICIPIUL GIURGIU",1,100521,1,1,1707,947,879,68,942,5,1850,903,582,360,
19,"GIURGIU",528,100521,,24,0,"DISPENSARUL URBAN NR.5,SOS.BUCURESTI ANS.1 D","MUNICIPIUL GIURGIU",1,100521,1,1,1429,779,752,27,774,5,1550,771,512,262,
19,"GIURGIU",528,100521,,25,0,"SCOALA GENERALA NR.10","MUNICIPIUL GIURGIU",1,100521,1,1,1319,736,576,160,732,4,1426,690,457,275,
19,"GIURGIU",528,100521,,26,0,"STR.TINERETULUI,BL.64(MAGAZINUL DE MOBILA)","MUNICIPIUL GIURGIU",1,100521,1,1,1897,980,867,113,969,11,2050,1070,651,318,
19,"GIURGIU",528,100521,,27,0,"SCOALA GENERALA NR.10,STR.TINERETULUI NR.22","MUNICIPIUL GIURGIU",1,100521,1,1,1721,876,815,61,869,7,1850,974,580,289,
19,"GIURGIU",528,100521,,28,0,"GRADINITA CU PROGRAM PRELUNGIT,STR.TINERETULUI NR.3","MUNICIPIUL GIURGIU",1,100521,1,1,2012,979,884,95,972,7,2100,1121,654,318,
19,"GIURGIU",528,100521,,29,0,"SCOALA GENERALA NR.5,STR.TINERETULUI","MUNICIPIUL GIURGIU",1,100521,1,1,1883,873,848,25,868,5,2000,1127,598,270,
19,"GIURGIU",528,100521,,30,0,"SCOALA GENERALA NR.5,STR. TINERETULUI","MUNICIPIUL GIURGIU",1,100521,1,1,1448,721,686,35,717,4,1500,779,476,241,
19,"GIURGIU",528,100521,,31,0,"SEDIUL CORPULUI GARDIENILOR PUBLICI,STR.TINERETULUI","MUNICIPIUL GIURGIU",1,100521,1,1,1519,674,576,98,668,6,1650,976,453,215,
19,"GIURGIU",528,100521,,32,0,"SCOALA GENERALA NR.6,STR.1 DECEMBRIE 1918","MUNICIPIUL GIURGIU",1,100521,1,1,1381,706,676,30,701,5,1500,794,512,189,
19,"GIURGIU",528,100521,,33,0,"LICEUL ION MAIORESCU,STR.N.D.BARCIAN","MUNICIPIUL GIURGIU",1,100521,1,1,1879,1159,1064,95,1146,13,2000,841,880,266,
19,"GIURGIU",528,100521,,34,0,"SCOALA GENERALA NR.7,STR.PORTULUI NR.19","MUNICIPIUL GIURGIU",1,100521,1,1,1590,942,840,102,929,13,1700,758,702,227,
19,"GIURGIU",528,100521,,35,0,"SCOALA GENERALA NR.4,STR.VLAD TEPES NR.15","MUNICIPIUL GIURGIU",1,100521,1,1,1350,776,709,67,766,10,1450,674,547,219,
19,"GIURGIU",528,100521,,36,0,"GRADINITA CU PROGRAM NORMAL,STR.SMARDA","MUNICIPIUL GIURGIU",1,100521,1,1,1843,1067,1028,39,1058,9,2000,933,769,289,
19,"GIURGIU",528,100521,,37,0,"SCOALA GENERALA NR.6,STR.1 DECEMBRIE 1918","MUNICIPIUL GIURGIU",1,100521,1,1,1722,873,848,25,860,13,1900,1027,591,269,
19,"GIURGIU",528,100521,,38,0,"LICEUL ECONOMIC ,STR.1 DECEMBRIE 1918 NR.92","MUNICIPIUL GIURGIU",1,100521,1,1,1603,873,814,59,862,11,1700,827,572,290,
19,"GIURGIU",528,100521,,39,1,"U.M.ALEI","MUNICIPIUL GIURGIU",1,100521,1,1,0,785,0,785,755,30,1100,315,507,248,
19,"GIURGIU",528,100521,,40,1,"U.M.JANDARMI","MUNICIPIUL GIURGIU",1,100521,1,1,0,388,0,388,378,10,549,161,271,107,
19,"GIURGIU",528,100521,,41,1,"G.E.F.P. NAVROM","MUNICIPIUL GIURGIU",1,100521,1,1,0,81,0,81,80,1,300,219,44,36,
19,"GIURGIU",528,100521,,42,1,"STATIA C.F.R. GIURGIU ORAS","MUNICIPIUL GIURGIU",1,100521,1,1,0,175,0,175,174,1,300,125,99,75,
19,"GIURGIU",528,100521,,43,1,"P.C.T.F.GIURGIU","MUNICIPIUL GIURGIU",1,100521,1,1,0,80,0,80,80,0,500,420,53,27,
19,"GIURGIU",528,100521,,44,1,"OSTROVUL MOCANASU","MUNICIPIUL GIURGIU",1,100521,1,1,0,16,0,16,15,1,201,185,12,3,
19,"GIURGIU",528,101190,,45,0,"SCOALA GENERALA BOLINTIN VALE","ORAS BOLINTIN-VALE",2,101190,2,1,1145,574,511,63,567,7,1220,646,426,141,
19,"GIURGIU",528,101190,,46,0,"SCOALA GENERALA BOLINTIN VALE","ORAS BOLINTIN-VALE",2,101190,2,1,1936,426,351,75,408,18,2100,1674,325,83,
19,"GIURGIU",528,101190,,47,0,"LICEUL BOLINTIN VALE","ORAS BOLINTIN-VALE",2,101190,2,1,831,340,298,42,338,2,1000,660,243,95,
19,"GIURGIU",528,101190,,48,0,"PRIMARIA BOLINTIN VALE","ORAS BOLINTIN-VALE",2,101190,2,1,1472,552,468,84,542,10,1600,1048,387,155,
19,"GIURGIU",528,101190,,49,0,"SCOALA GENERALA MALU SPART","ORAS BOLINTIN-VALE",2,101190,2,1,1248,604,540,64,589,15,1400,796,420,169,
19,"GIURGIU",528,101190,,50,0,"SCOALA GENERALA MALU SPART","ORAS BOLINTIN-VALE",2,101190,2,1,1476,465,436,29,452,13,1600,1135,315,137,
19,"GIURGIU",528,101190,,51,0,"SCOALA GENERALA CRIVINA","ORAS BOLINTIN-VALE",2,101190,2,1,640,339,283,56,324,15,720,381,221,103,
19,"GIURGIU",528,104136,,52,0,"SCOALA GENERALA NR.1 MIHAILESTI","ORAS MIHAILESTI",3,104136,2,1,2331,961,896,65,949,12,2502,1541,584,365,
19,"GIURGIU",528,104136,,53,0,"SCOALA GENERALA NR.2 TUFA","ORAS MIHAILESTI",3,104136,2,1,887,521,452,69,514,7,1000,479,302,212,
19,"GIURGIU",528,104136,,54,0,"SCOALA GENERALA NR.3 DRAGANESCU","ORAS MIHAILESTI",3,104136,2,1,352,227,180,47,225,2,400,173,151,74,
19,"GIURGIU",528,104136,,55,0,"SCOALA GENERALA NR.4 POPESTI","ORAS MIHAILESTI",3,104136,2,1,877,361,315,46,355,6,1000,639,214,141,
19,"GIURGIU",528,104136,,56,0,"SCOALA GENERALA NR.5NOVACI","ORAS MIHAILESTI",3,104136,2,1,1008,432,376,56,415,17,1100,668,240,175,
19,"GIURGIU",528,100781,,57,0,"SCOALA GENERALA NR.1 AD.COPACENI","ADUNATII-COPACENI",4,100781,0,3,1343,560,416,144,553,7,1400,840,267,286,
19,"GIURGIU",528,100781,,58,0,"SCOALA GENERALA NR.2 AD.COPACENI","ADUNATII-COPACENI",4,100781,0,3,1108,540,402,138,527,13,1200,660,310,217,
19,"GIURGIU",528,100781,,59,0,"SCOALA GENERALA NR.1 DARASTI VLASCA","ADUNATII-COPACENI",4,100781,0,3,1717,699,567,132,684,15,1825,1126,511,173,
19,"GIURGIU",528,100781,,60,0,"SCOALA GENERALA NR.1 VARLAAM","ADUNATII-COPACENI",4,100781,0,3,420,280,227,53,277,3,550,270,176,101,
19,"GIURGIU",528,100781,,61,0,"SCOALA GENERALA NR.1 MOGOSESTI","ADUNATII-COPACENI",4,100781,0,3,354,218,144,74,214,4,450,232,124,90,
19,"GIURGIU",528,101001,,62,0,"SCOALA GENERALA NR.1 BANEASA","BANEASA",5,101001,0,3,2694,1131,972,159,1111,20,2877,1746,599,512,
19,"GIURGIU",528,101001,,63,0,"SCOALA GENERALA SF.GHEORGHE","BANEASA",5,101001,0,3,142,172,70,102,172,0,260,88,130,42,
19,"GIURGIU",528,101001,,64,0,"SCOALA GENERALA NR.4 PIETRELE","BANEASA",5,101001,0,3,1175,635,571,64,618,17,1300,665,406,212,
19,"GIURGIU",528,101001,,65,0,"SCOALA GENERALA NR.3 FRASINU","BANEASA",5,101001,0,3,564,284,204,80,282,2,620,336,163,119,
19,"GIURGIU",528,101163,,66,0,"CAMIN CULTURAL BOLINTIN DEAL","BOLINTIN-DEAL",6,101163,0,3,1618,605,515,90,590,15,1800,1195,437,153,
19,"GIURGIU",528,101163,,67,0,"SCOALA GENERALA NR.1 BOLINTIN DEAL","BOLINTIN-DEAL",6,101163,0,3,1654,567,511,56,561,6,1800,1233,418,143,
19,"GIURGIU",528,101163,,68,0,"SCOALA GENERALA NR.2 MIHAI VODA","BOLINTIN-DEAL",6,101163,0,3,1523,630,542,88,626,4,1673,1043,407,219,
19,"GIURGIU",528,101378,,69,0,"SCOALA GENERALA BUCSANI","BUCSANI",7,101378,0,3,866,340,263,77,336,4,959,619,232,104,
19,"GIURGIU",528,101378,,70,0,"SCOALA GENERALA VADU LAT","BUCSANI",7,101378,0,3,507,412,268,144,404,8,555,143,302,102,
19,"GIURGIU",528,101378,,71,0,"SCOALA GENERALA PODISOR","BUCSANI",7,101378,0,3,388,405,303,102,402,3,425,20,322,80,
19,"GIURGIU",528,101378,,72,0,"SCOALA GENERALA OBEDENI","BUCSANI",7,101378,0,3,318,214,144,70,212,2,350,136,157,55,
19,"GIURGIU",528,101378,,73,0,"SCOALA GENERALA UESTI","BUCSANI",7,101378,0,3,453,244,205,39,240,4,500,256,196,44,
19,"GIURGIU",528,101378,,74,0,"SCOALA GENERALA GOLEASCA","BUCSANI",7,101378,0,3,395,229,183,46,223,6,430,201,176,47,
19,"GIURGIU",528,101519,,75,0,"SCOALA GENERALA BULBUCATA","BULBUCATA",8,101519,0,3,1228,636,504,132,617,19,1354,718,462,155,
19,"GIURGIU",528,101617,,76,0,"SCOALA GENERALA BUTURUGENI","BUTURUGENI",9,101617,0,3,1663,815,756,59,797,18,1821,1006,467,330,
19,"GIURGIU",528,101617,,77,0,"SCOALA GENERALA PADURENI","BUTURUGENI",9,101617,0,3,1187,656,581,75,646,10,1300,644,390,256,
19,"GIURGIU",528,101617,,78,0,"SCOALA POSTA","BUTURUGENI",9,101617,0,3,237,169,124,45,166,3,270,101,92,74,
19,"GIURGIU",528,101662,,79,0,"SCOALA GENERALA CALUGARENI","CALUGARENI",10,101662,0,3,1488,557,443,114,547,10,1630,1073,390,157,
19,"GIURGIU",528,101662,,80,0,"SCOALA GENERALA BRANISTARI","CALUGARENI",10,101662,0,3,832,452,332,120,442,10,900,448,317,125,
19,"GIURGIU",528,101662,,81,0,"SCOALA GENERALA UZUNU","CALUGARENI",10,101662,0,3,1165,581,466,115,573,8,1300,719,352,221,
19,"GIURGIU",528,101662,,82,0,"SCOALA GENERALA HULUBESTI","CALUGARENI",10,101662,0,3,1481,573,476,97,568,5,1628,1055,334,234,
19,"GIURGIU",528,101984,,83,0,"CAMINUL CULTURAL CLEJANI","CLEJANI",11,101984,0,3,1445,710,582,128,700,10,1600,890,497,203,
19,"GIURGIU",528,101984,,84,0,"SCOALA GENERALA NEAJLOV","CLEJANI",11,101984,0,3,970,634,469,165,624,10,1053,419,455,169,
19,"GIURGIU",528,102071,,85,0,"SCOALA GENERALA NR.1 COLIBASI","COLIBASI",12,102071,0,3,987,410,343,67,399,11,1100,690,204,195,
19,"GIURGIU",528,102071,,86,0,"SCOALA GENERALA NR.2 CAMPURELU","COLIBASI",12,102071,0,3,1198,541,458,83,536,5,1300,759,343,193,
19,"GIURGIU",528,102071,,87,0,"SCOALA GENERALA NR.3 COLIBASI","COLIBASI",12,102071,0,3,878,421,353,68,411,10,974,553,204,207,
19,"GIURGIU",528,102106,,88,0,"SCOALA GENERALA NR.1 COMANA","COMANA",13,102106,0,3,1957,816,693,123,803,13,2140,1324,543,260,
19,"GIURGIU",528,102106,,89,0,"SCOALA GENERALA NR.2 VLAD TEPES","COMANA",13,102106,0,3,1392,705,583,122,696,9,1500,795,345,351,
19,"GIURGIU",528,102106,,90,0,"SCOALA GENERALA NR.3 GRADISTEA","COMANA",13,102106,0,3,1538,534,424,110,527,7,1700,1166,302,225,
19,"GIURGIU",528,102106,,91,0,"SCOALA GENERALA NR.4 FALASTOACA","COMANA",13,102106,0,3,498,377,211,166,369,8,531,154,248,121,
19,"GIURGIU",528,102106,,92,0,"SCOALA GENERALA NR.5 BUDENI","COMANA",13,102106,0,3,436,385,220,165,377,8,500,115,227,150,
19,"GIURGIU",528,102106,,93,1,"U.M.COMANA","COMANA",13,102106,0,3,0,506,0,506,487,19,710,204,228,259,
19,"GIURGIU",528,102348,,94,0,"SCOALA GENERALA CREVEDIA MARE","CREVEDIA MARE",14,102348,0,3,1226,603,496,107,600,3,1350,747,495,105,
19,"GIURGIU",528,102348,,95,0,"SCOALA GENERALA DEALU","CREVEDIA MARE",14,102348,0,3,740,523,399,124,523,0,815,292,341,182,
19,"GIURGIU",528,102348,,96,0,"SCOALA GENERALA CREVEDIA MICA","CREVEDIA MARE",14,102348,0,3,1424,591,492,99,579,12,1567,976,427,152,
19,"GIURGIU",528,102446,,97,0,"SCOALA GENERALA NR.1 DAIA","DAIA",15,102446,0,3,1306,571,468,103,556,15,1436,865,359,197,
19,"GIURGIU",528,102446,,98,0,"SCOALA GENERALA NR.2 PLOPSORU","DAIA",15,102446,0,3,1226,797,541,256,777,20,1350,553,475,302,
19,"GIURGIU",528,102794,,99,0,"SCOALA GENERALA STOENESTI","FLORESTI-STOENESTI",16,102794,0,3,1453,413,350,63,408,5,1600,1187,283,125,
19,"GIURGIU",528,102794,,100,0,"SCOALA GENERALA FLORESTI","FLORESTI-STOENESTI",16,102794,0,3,1664,700,641,59,688,12,1830,1130,507,181,
19,"GIURGIU",528,102794,,101,0,"SCOALA GENERALA FLORESTI","FLORESTI-STOENESTI",16,102794,0,3,1463,564,513,51,559,5,1600,1036,406,153,
19,"GIURGIU",528,102794,,102,0,"SCOALA GENERALA PALANCA","FLORESTI-STOENESTI",16,102794,0,3,998,367,323,44,360,7,1100,733,249,111,
19,"GIURGIU",528,102794,,103,0,"SCOALA GENERALA PALANCA","FLORESTI-STOENESTI",16,102794,0,3,838,311,271,40,304,7,930,619,203,101,
19,"GIURGIU",528,102909,,104,0,"CAMIN CULTURAL FRATESTI","FRATESTI",17,102909,0,3,2158,1004,910,94,979,25,2400,1396,679,300,
19,"GIURGIU",528,102909,,105,0,"SCOALA GENERALA REMUS","FRATESTI",17,102909,0,3,1365,833,651,182,814,19,1513,680,555,259,
19,"GIURGIU",528,102909,,106,0,"SCOALA GENERALA CETATEA","FRATESTI",17,102909,0,3,725,373,282,91,354,19,800,427,277,77,
19,"GIURGIU",528,103087,,107,0,"SCOALA GENERALA GAISENI","GAISENI",18,103087,0,3,1615,493,431,62,485,8,1800,1307,344,141,
19,"GIURGIU",528,103087,,108,0,"SCOALA GENERALA CASCIOARELE","GAISENI",18,103087,0,3,1781,469,408,61,464,5,1941,1472,315,149,
19,"GIURGIU",528,103087,,109,0,"SCOALA GENERALA CARPENISU","GAISENI",18,103087,0,3,542,333,251,82,332,1,600,267,250,82,
19,"GIURGIU",528,103194,,110,0,"GRADINITA DE COPII GAUJANI","GAUJANI",19,103194,0,3,1213,773,642,131,758,15,1300,527,528,230,
19,"GIURGIU",528,103194,,111,0,"SCOALA GENERALA PIETRISU","GAUJANI",19,103194,0,3,797,470,385,85,458,12,815,345,364,94,
19,"GIURGIU",528,103194,,112,0,"SCOALA GENERALA CETATUIA","GAUJANI",19,103194,0,3,199,195,144,51,193,2,215,20,130,63,
19,"GIURGIU",528,103238,,113,0,"SCOALA GENERALA DE 8 ANI GHIMPATI","GHIMPATI",20,103238,0,3,1300,996,846,150,985,11,1300,304,622,363,
19,"GIURGIU",528,103238,,114,0,"GRADINITA DE COPII CROVU","GHIMPATI",20,103238,0,3,686,350,287,63,344,6,750,400,243,101,
19,"GIURGIU",528,103238,,115,0,"SCOALA GENERALA DE 4 ANI COPACIU","GHIMPATI",20,103238,0,3,913,600,518,82,574,26,1000,400,447,127,
19,"GIURGIU",528,103238,,116,0,"SCOALA GENERALA DE 8 ANI NAIPU","GHIMPATI",20,103238,0,3,1396,1098,953,145,1077,21,1524,426,845,232,
19,"GIURGIU",528,103238,,117,0,"SCOALA DE 4 ANI VALEA PLOPILOR","GHIMPATI",20,103238,0,3,406,342,281,61,337,5,450,108,232,105,
19,"GIURGIU",528,103309,,118,0,"CAMIN CULTURAL GOGOSARI","GOGOSARI",21,103309,0,3,1083,655,525,130,638,17,1200,545,473,165,
19,"GIURGIU",528,103309,,119,0,"SCOALA GENERALA SAT IZVORU","GOGOSARI",21,103309,0,3,576,518,458,60,503,15,628,110,331,172,
19,"GIURGIU",528,103372,,120,0,"SCOALA GENERALA NR.1 GOSTINARI","GOSTINARI",22,103372,0,3,1501,817,711,106,787,30,1640,823,551,236,
19,"GIURGIU",528,103372,,121,0,"SCOALA GENERALA NR.2 MIRONESTI","GOSTINARI",22,103372,0,3,590,347,234,113,339,8,647,300,263,76,
19,"GIURGIU",528,103354,,122,0,"SCOALA GENERALA NR.1 GOSTINU","GOSTINU",23,103354,0,3,1048,629,529,100,618,11,1150,521,365,253,
19,"GIURGIU",528,103354,,123,0,"GRADINITA NR.1 GOSTINU","GOSTINU",23,103354,0,3,1051,536,491,45,530,6,1162,626,321,209,
19,"GIURGIU",528,103407,,124,0,"CAMINUL CULTURAL GRADINARI","GRADINARI",24,103407,0,3,987,589,517,72,584,5,1068,479,415,169,
19,"GIURGIU",528,103407,,125,0,"SCOALA GENERALA ZORILE","GRADINARI",24,103407,0,3,672,535,439,96,527,8,770,235,359,168,
19,"GIURGIU",528,103407,,126,0,"SCOALA GENERALA TANTAVA","GRADINARI",24,103407,0,3,746,535,395,140,529,6,809,274,334,195,
19,"GIURGIU",528,103470,,127,0,"SCOALA GENERALA GREACA","GREACA",25,103470,0,3,1744,936,826,110,922,14,1915,979,538,384,
19,"GIURGIU",528,103470,,128,0,"SCOALA GENERALA PUTU GRECI","GREACA",25,103470,0,3,346,258,211,47,256,2,380,122,180,76,
19,"GIURGIU",528,103470,,129,0,"SCOALA GENERALA ZBOIU","GREACA",25,103470,0,3,282,189,149,40,186,3,310,121,141,45,
19,"GIURGIU",528,103639,,130,0,"SCOALA GENERALA HOTARELE","HOTARELE",26,103639,0,3,1702,579,465,114,569,10,1850,1271,358,211,
19,"GIURGIU",528,103639,,131,0,"LICEUL HOTARELE","HOTARELE",26,103639,0,3,1519,665,553,112,652,13,1700,1035,466,186,
19,"GIURGIU",528,103639,,132,0,"SCOALA GENERALA SCARISOARA","HOTARELE",26,103639,0,3,725,364,293,71,358,6,800,436,261,97,
19,"GIURGIU",528,103639,,133,0,"SCOALA GENERALA HERESTI","HOTARELE",26,103639,0,3,1462,808,564,244,788,20,1600,792,505,283,
19,"GIURGIU",528,103639,,134,0,"SCOALA GENERALA IZVOARELE","HOTARELE",26,103639,0,3,1386,746,546,200,723,23,1507,761,398,325,
19,"GIURGIU",528,103693,,135,0,"PRIMARIA IEPURESTI","IEPURESTI",27,103693,0,3,1117,749,655,94,734,15,1230,481,555,179,
19,"GIURGIU",528,103693,,136,0,"SCOALA GENERALA GORNENI","IEPURESTI",27,103693,0,3,727,423,348,75,422,1,800,377,324,98,
19,"GIURGIU",528,103899,,137,0,"SCOALA GENERALA IZVOARELE","IZVOARELE",28,103899,0,3,1426,629,525,104,620,9,1550,921,451,169,
19,"GIURGIU",528,103899,,138,0,"SCOALA GENERALA CHIRIACU","IZVOARELE",28,103899,0,3,1333,618,454,164,613,5,1520,902,458,155,
19,"GIURGIU",528,103899,,139,0,"SCOALA GENERALA PETRU RARES","IZVOARELE",28,103899,0,3,159,116,63,53,110,6,200,84,88,22,
19,"GIURGIU",528,103899,,140,0,"SCOALA GENERALA VALEA BUJORULUI","IZVOARELE",28,103899,0,3,491,285,246,39,276,9,500,215,174,102,
19,"GIURGIU",528,103899,,141,0,"SECTIA DE MEC. D. CANTEMIR","IZVOARELE",28,103899,0,3,265,112,101,11,109,3,300,188,79,30,
19,"GIURGIU",528,103899,,142,0,"SCOALA GENERALA RADU VODA","IZVOARELE",28,103899,0,3,250,137,100,37,131,6,267,130,75,56,
19,"GIURGIU",528,103997,,143,0,"PRIMARIA JOITA","JOITA",29,103997,0,3,1750,547,467,80,540,7,2100,1553,302,238,
19,"GIURGIU",528,103997,,144,0,"SCOALA GENERALA BACU","JOITA",29,103997,0,3,799,516,373,143,511,5,900,384,265,246,
19,"GIURGIU",528,103997,,145,0,"SCOALA GENERALA COSOBA","JOITA",29,103997,0,3,1760,709,657,52,702,7,1850,1141,506,196,
19,"GIURGIU",528,103997,,146,0,"SCOALA GENERALA SABARENI","JOITA",29,103997,0,3,1869,930,816,114,901,29,1947,1017,623,278,
19,"GIURGIU",528,104047,,147,0,"CAMIN CULTURAL LETCA NOUA","LETCA NOUA",30,104047,0,3,823,624,521,103,612,12,900,276,495,117,
19,"GIURGIU",528,104047,,148,0,"CAMIN CULTUTAL LETCA VECHE","LETCA NOUA",30,104047,0,3,1016,627,549,78,619,8,1127,500,472,147,
19,"GIURGIU",528,104047,,149,0,"CAMIN CULTURAL MILCOVATU","LETCA NOUA",30,104047,0,3,1030,529,468,61,517,12,1130,601,371,146,
19,"GIURGIU",528,104118,,150,0,"SCOALA GENERALA CLS. I-IV MIHAI BRAVU","MIHAI BRAVU",32,104118,0,3,1028,536,483,53,529,7,1101,565,361,168,
19,"GIURGIU",528,104118,,151,0,"SCOALA GENERALA CLS. I-IV MIHAI BRAVU","MIHAI BRAVU",32,104118,0,3,1074,618,538,80,610,8,1199,581,406,204,
19,"GIURGIU",528,104118,,152,1,"UM GARNIZOANA MIHAI BRAVU","MIHAI BRAVU",32,104118,0,3,0,132,0,132,127,5,150,18,67,60,
19,"GIURGIU",528,104225,,153,0,"SCOALA GENERALA NR.1 MARSA","MIRSA",31,104225,0,3,1034,509,484,25,498,11,1132,623,375,123,
19,"GIURGIU",528,104225,,154,0,"SCOALA GENERALA NR.1 MARSA","MIRSA",31,104225,0,3,1085,491,458,33,483,8,1200,709,370,113,
19,"GIURGIU",528,104485,,155,0,"SCOALA GENERALA NR.1 OGREZENI","OGREZENI",33,104485,0,3,1158,513,431,82,504,9,1300,787,384,120,
19,"GIURGIU",528,104485,,156,0,"SCOALA GENERALA NR.2 OGREZENI","OGREZENI",33,104485,0,3,1040,479,376,103,475,4,1150,671,352,123,
19,"GIURGIU",528,104485,,157,0,"SCOALA GENERALA NR.3 OGREZENI","OGREZENI",33,104485,0,3,752,446,370,76,442,4,800,354,335,107,
19,"GIURGIU",528,104485,,158,0,"SCOALA GENERALA NR.4 OGREZENI","OGREZENI",33,104485,0,3,669,401,348,53,393,8,733,332,303,90,
19,"GIURGIU",528,104519,,159,0,"CAMIN CULTURAL OINACU","OINACU",34,104519,0,3,1692,810,712,98,799,11,1847,1037,453,346,
19,"GIURGIU",528,104519,,160,0,"SCOALA GENERALA BRANISTEA","OINACU",34,104519,0,3,1034,529,433,96,520,9,1150,621,322,198,
19,"GIURGIU",528,104519,,161,0,"SCOALA GENERALA COMASCA","OINACU",34,104519,0,3,496,373,249,124,359,14,550,177,211,148,
19,"GIURGIU",528,104680,,162,0,"CAMIN CULTURAL PRUNDU","PRUNDU",35,104680,0,3,1636,800,706,94,774,26,1800,1000,538,236,
19,"GIURGIU",528,104680,,163,0,"SCOALA GENERALA NR.2 PRUNDU","PRUNDU",35,104680,0,3,1531,755,738,17,748,7,1700,945,477,271,
19,"GIURGIU",528,104680,,164,0,"SCOALA GENERALA PUIENI","PRUNDU",35,104680,0,3,724,627,488,139,619,8,790,163,435,184,
19,"GIURGIU",528,104715,,165,0,"SCOALA GENERALA PUTINEIU","PUTINEIU",36,104715,0,3,1226,858,748,110,848,10,1342,484,612,236,
19,"GIURGIU",528,104715,,166,0,"SCOALA GENERALA HODIVOAIA","PUTINEIU",36,104715,0,3,355,352,289,63,342,10,400,48,278,64,
19,"GIURGIU",528,104715,,167,0,"SCOALA GENERALA VIERU","PUTINEIU",36,104715,0,3,726,504,411,93,501,3,800,296,339,162,
19,"GIURGIU",528,104788,,168,0,"SCOALA GENERALA RASUCENI","RASUCENI",37,104788,0,3,1050,590,496,94,571,19,1125,535,408,163,
19,"GIURGIU",528,104788,,169,0,"SCOALA GENERALA DE 4 CLASE RASUCENI","RASUCENI",37,104788,0,3,539,297,228,69,287,10,600,303,237,50,
19,"GIURGIU",528,104788,,170,0,"SCOALA GENERALA SAT CUCURUZU","RASUCENI",37,104788,0,3,1065,586,488,98,558,28,1200,614,382,176,
19,"GIURGIU",528,104831,,171,0,"SCOALA GENERALA NR.1 ROATA DE JOS","ROATA DE JOS",38,104831,0,3,2362,1015,925,90,996,19,2600,1585,780,216,
19,"GIURGIU",528,104831,,172,0,"SCOALA GENERALA NR.5 SADINA","ROATA DE JOS",38,104831,0,3,956,699,463,236,694,5,1029,330,540,154,
19,"GIURGIU",528,104831,,173,0,"SCOALA GENERALA NR.2 CARTOJANI","ROATA DE JOS",38,104831,0,3,981,398,369,29,395,3,1100,702,299,96,
19,"GIURGIU",528,104831,,174,0,"SCOALA GENERALA NR.2 CARTOJANI","ROATA DE JOS",38,104831,0,3,1080,459,431,28,450,9,1200,741,349,101,
19,"GIURGIU",528,104831,,175,0,"SCOALA GENERALA NR.2 CARTOJANI","ROATA DE JOS",38,104831,0,3,764,332,305,27,325,7,840,508,244,81,
19,"GIURGIU",528,104975,,176,0,"SCOALA GENERALA SCHITU","SCHITU",39,104975,0,3,264,155,127,28,151,4,300,145,116,35,
19,"GIURGIU",528,104975,,177,0,"SCOALA GENERALA BILA","SCHITU",39,104975,0,3,560,262,210,52,252,10,614,352,199,53,
19,"GIURGIU",528,104975,,178,0,"SCOALA GENERALA CAMINEASCA","SCHITU",39,104975,0,3,555,321,267,54,315,6,610,289,235,80,
19,"GIURGIU",528,104975,,179,0,"SCOALA GENERALA VLASINU","SCHITU",39,104975,0,3,482,310,278,32,298,12,530,220,248,50,
19,"GIURGIU",528,105106,,180,0,"PRIMARIA SINGURENI","SINGURENI",40,105106,0,3,1492,516,405,111,510,6,1612,1096,351,159,
19,"GIURGIU",528,105106,,181,0,"SCOALA GENERALA CRANGURI","SINGURENI",40,105106,0,3,618,306,257,49,304,2,700,394,238,66,
19,"GIURGIU",528,105106,,182,0,"SCOALA GENERALA STEJARU","SINGURENI",40,105106,0,3,623,377,311,66,365,12,700,323,260,105,
19,"GIURGIU",528,100549,,183,0,"SCOALA GENERALA SLOBOZIA","SLOBOZIA",41,100549,0,3,910,412,314,98,404,8,1000,588,315,89,
19,"GIURGIU",528,100549,,184,0,"GRADINITA SLOBOZIA","SLOBOZIA",41,100549,0,3,1071,551,448,103,544,7,1179,628,404,140,
19,"GIURGIU",528,105295,,185,0,"SCOALA GENERALA STANESTI","STANESTI",42,105295,0,3,1191,667,525,142,659,8,1300,633,396,263,
19,"GIURGIU",528,105295,,186,0,"SCOALA GENERALA GHIZDARU","STANESTI",42,105295,0,3,525,325,258,67,320,5,570,245,232,88,
19,"GIURGIU",528,105295,,187,0,"SCOALA GENERALA BALANU","STANESTI",42,105295,0,3,299,308,166,142,303,5,353,45,201,102,
19,"GIURGIU",528,105295,,188,0,"SCOALA GENERALA ONCESTI","STANESTI",42,105295,0,3,325,252,187,65,248,4,350,98,189,59,
19,"GIURGIU",528,105348,,189,0,"SCOALA GENERALA NR.1 STOENESTI","STOENESTI",43,105348,0,3,1394,634,554,80,625,9,1528,894,406,219,
19,"GIURGIU",528,105348,,190,0,"SCOALA GENERALA NR.2 STOENESTI","STOENESTI",43,105348,0,3,721,426,367,59,405,21,800,374,288,117,
19,"GIURGIU",528,154709,,191,0,"CAMIN CULTURAL TOPORU","TOPORU",44,154709,0,3,1471,800,708,92,786,14,1623,823,535,251,
19,"GIURGIU",528,154709,,192,0,"SCOALA GENERALA TOMULESTI","TOPORU",44,154709,0,3,642,446,312,134,441,5,710,264,302,139,
19,"GIURGIU",528,105623,,193,0,"SCOALA GENERALA POENARI","ULMI",45,105623,0,3,1842,686,579,107,670,16,2100,1414,504,166,
19,"GIURGIU",528,105623,,194,0,"SCOALA GENERALA CLS. I-IV ULMI","ULMI",45,105623,0,3,1172,499,384,115,494,5,1300,801,388,106,
19,"GIURGIU",528,105623,,195,0,"SCOALA GENERALA TRESTIENI","ULMI",45,105623,0,3,1956,685,598,87,676,9,2100,1415,512,164,
19,"GIURGIU",528,105623,,196,0,"SCOALA GENERALA CLS. I-IV DRAGANEASCA","ULMI",45,105623,0,3,471,313,209,104,310,3,528,215,248,62,
19,"GIURGIU",528,105776,,197,0,"SCOALA GENERALA NR.1 VALEA DRAGULUI","VALEA DRAGULUI",46,105776,0,3,1671,769,633,136,750,19,1824,1055,476,274,
19,"GIURGIU",528,105776,,198,0,"SCOALA GENERALA NR.2 SECTOR CIOCOVENI","VALEA DRAGULUI",46,105776,0,3,898,485,382,103,477,8,1000,515,337,140,
19,"GIURGIU",528,105874,,199,0,"SCOALA VECHE VARASTI","VARASTI",48,105874,0,3,1103,570,507,63,561,9,1220,650,385,176,
19,"GIURGIU",528,105874,,200,0,"GRADINITA VARASTI","VARASTI",48,105874,0,3,1115,536,484,52,523,13,1238,702,355,168,
19,"GIURGIU",528,105874,,201,0,"SCOALA GENERALA NR.3 VARASTI","VARASTI",48,105874,0,3,1020,523,452,71,511,12,1100,577,366,145,
19,"GIURGIU",528,105874,,202,0,"SCOALA GENERALA DOBRENI","VARASTI",48,105874,0,3,1647,821,722,99,797,24,1800,979,644,153,
19,"GIURGIU",528,105909,,203,0,"SCOALA GENERALA DE 8 ANI ""APOSTOL ARSACHE"" VEDEA","VEDEA",49,105909,0,3,1366,1356,1138,218,1321,35,1500,144,1072,249,
19,"GIURGIU",528,105909,,204,0,"SCOALA GENERALA DE 4 ANI VEDEA","VEDEA",49,105909,0,3,1311,803,665,138,783,20,1448,645,539,244,
19,"GIURGIU",528,105909,,205,0,"GRADINITA DE COPII MALU","VEDEA",49,105909,0,3,888,703,588,115,698,5,1000,297,508,190,
19,"GIURGIU",528,105909,,206,0,"CAMIN CULTURAL MALU","VEDEA",49,105909,0,3,1294,1341,1216,125,1321,20,1400,59,1088,233,
19,"GIURGIU",528,105972,,207,0,"SCOALA GENERALA VANATORII MICI","VINATORII MICI",47,105972,0,3,1341,723,603,120,713,10,1500,777,561,152,
19,"GIURGIU",528,105972,,208,0,"SCOALA VECHE IZVORU","VINATORII MICI",47,105972,0,3,926,720,485,235,705,15,1010,290,548,157,
19,"GIURGIU",528,105972,,209,0,"SCOALA VANATORII MARI","VINATORII MICI",47,105972,0,3,1094,625,549,76,615,10,1200,575,486,129,
19,"GIURGIU",528,105972,,210,0,"SCOALA POIANA","VINATORII MICI",47,105972,0,3,458,473,419,54,473,0,500,27,411,62,
20,"GORJ",181,77812,,1,0,"Cu sediul in localul Universitatii ""Constantin Brincusi"" din strada Geneva(denumire veche str. Grivitei)","MUNICIPIUL TARGU JIU",1,77812,1,1,2069,1016,876,140,1000,16,2065,1049,628,372,
20,"GORJ",181,77812,,2,0,"cu sediul in localul Colegiului National ""Tudor Vladimirescu"" din str. Unirii","MUNICIPIUL TARGU JIU",1,77812,1,1,2337,1196,1058,138,1176,20,2700,1504,719,457,
20,"GORJ",181,77812,,3,0,"Cu sediul in localul Scolii Gimnaziale ""C-tin Savoiu"" (Sc Gen nr.8) din str. Unirii","MUNICIPIUL TARGU JIU",1,77812,1,1,1667,894,765,129,883,11,2000,1106,555,328,
20,"GORJ",181,77812,,4,0,"Cu sediul in localul Grupului Scolar Industrial Nr.2 (Lic 2) din str. Victoriei","MUNICIPIUL TARGU JIU",1,77812,1,1,1584,883,775,108,875,8,1800,917,519,356,
20,"GORJ",181,77812,,5,0,"Cu sediul in localul Scolii Primare din loc. Romanesti","MUNICIPIUL TARGU JIU",1,77812,1,1,728,437,384,53,436,1,1000,563,230,206,
20,"GORJ",181,77812,,6,0,"Cu sediul in localul Scolii Gen ""Alexandru Stefulescu"" (Sc Gen 4) din str. Geneva (den veche str. Grivita)","MUNICIPIUL TARGU JIU",1,77812,1,1,1280,678,607,71,674,4,1300,622,460,214,
20,"GORJ",181,77812,,7,0,"Cu sediul in localul Colegiului ""Virgil Madgearu"" (Lic. Ec.)din str. T. Vladimirescu","MUNICIPIUL TARGU JIU",1,77812,1,1,875,503,433,70,495,8,1000,497,303,192,
20,"GORJ",181,77812,,8,0,"Cu sediul in localul Scolii Generale nr.10 din str. Calea Bucuresti","MUNICIPIUL TARGU JIU",1,77812,1,1,1156,649,551,98,641,8,1300,651,336,305,
20,"GORJ",181,77812,,9,0,"Cu sediul in localul Scolii Primare din localitatea Dragoieni","MUNICIPIUL TARGU JIU",1,77812,1,1,1045,650,558,92,644,6,1200,550,349,295,
20,"GORJ",181,77812,,10,0,"Cu sediul in localul Palatului Copiilor(Clubul Elevilor) din B-dul Republicii","MUNICIPIUL TARGU JIU",1,77812,1,1,1659,793,737,56,787,6,2000,1207,485,302,
20,"GORJ",181,77812,,11,0,"Cu sediul in localul Casei Tineretului din b-dul Nicolae Titulescu(denumire veche b-dul Libertatii)","MUNICIPIUL TARGU JIU",1,77812,1,1,1293,733,582,151,724,9,1500,767,443,281,
20,"GORJ",181,77812,,12,0,"Cu sediul in localul Colegiului National ""Spiru Haret""(Liceul""Spiru Haret"")din str. 1 Decembrie 1918","MUNICIPIUL TARGU JIU",1,77812,1,1,1080,575,511,64,573,2,1200,625,325,248,
20,"GORJ",181,77812,,13,0,"Cu sediul in localul Liceului de Muzica si Arte Plastice ""Constantin Brailoiu"" din str. Siretului","MUNICIPIUL TARGU JIU",1,77812,1,1,1972,975,892,83,960,15,2200,1225,529,431,
20,"GORJ",181,77812,,14,0,"Cu sediul in localul Scolii Generale nr. 13 din str. A.I.Cuza","MUNICIPIUL TARGU JIU",1,77812,1,1,2044,981,895,86,976,5,2300,1319,578,398,
20,"GORJ",181,77812,,15,0,"Cu sediul in localul Scolii Generale nr. 13 din str. A.I.Cuza","MUNICIPIUL TARGU JIU",1,77812,1,1,2100,989,902,87,982,7,2300,1311,541,441,
20,"GORJ",181,77812,,16,0,"Cu sediul in localul Colegiului National ""Spiru Haret"" (Liceul ""Spiru Haret"") din str. 1 Decembrie 1918","MUNICIPIUL TARGU JIU",1,77812,1,1,1848,833,697,136,827,6,2000,1167,425,402,
20,"GORJ",181,77812,,17,0,"Cu sediul in localul Scolii Gimnaziale ""Gheorghe Tatarascu"" (Scoala Generala nr. 1) din str. 23 August","MUNICIPIUL TARGU JIU",1,77812,1,1,1376,665,592,73,660,5,1500,835,359,301,
20,"GORJ",181,77812,,18,0,"Cu sediul in localul Scolii Generale ""Pompiliu Marcea"" (Scoala Generala nr. 11) din str. Mioritei","MUNICIPIUL TARGU JIU",1,77812,1,1,1749,799,748,51,789,10,2000,1201,394,395,
20,"GORJ",181,77812,,19,0,"Cu sediul in localul Scolii Generale ""Pompiliu Marcea"" (Scoala Generala nr. 11) din str. Mioritei","MUNICIPIUL TARGU JIU",1,77812,1,1,1825,921,840,81,911,10,2100,1179,493,418,
20,"GORJ",181,77812,,20,0,"Cu sediul in localul Colegiului National ""Spiru Haret"" (Liceul ""Spiru Haret"") din str. 1 Decembrie 1918","MUNICIPIUL TARGU JIU",1,77812,1,1,1524,677,600,77,673,4,1700,1023,354,319,
20,"GORJ",181,77812,,21,0,"Cu sediul in localul Colegiului National ""Spiru Haret"" (Liceul ""Spiru Haret"") din str. 1 Decembrie 1918","MUNICIPIUL TARGU JIU",1,77812,1,1,1514,730,670,60,727,3,1700,970,350,377,
20,"GORJ",181,77812,,22,0,"Cu sediul in localul Scolii Generale nr. 12 din str. Liviu Rebreanu (denumire veche Agriculturii)","MUNICIPIUL TARGU JIU",1,77812,1,1,1385,654,576,78,649,5,1500,846,357,292,
20,"GORJ",181,77812,,23,0,"Cu sediul in localul Scolii Generale nr. 12 din str. Liviu Rebreanu (denumire veche Agriculturii)","MUNICIPIUL TARGU JIU",1,77812,1,1,1729,822,762,60,813,9,1900,1078,437,376,
20,"GORJ",181,77812,,24,0,"Cu sediul in localul Scolii Generale nr. 12 din str. Liviu Rebreanu (denumire veche Agriculturii)","MUNICIPIUL TARGU JIU",1,77812,1,1,2082,959,865,94,958,1,2300,1341,519,439,
20,"GORJ",181,77812,,25,0,"Cu sediul in localul Scolii Generale nr. 12 din str. Liviu Rebreanu (denumire veche Agriculturii)","MUNICIPIUL TARGU JIU",1,77812,1,1,1881,896,797,99,888,8,2200,1304,415,473,
20,"GORJ",181,77812,,26,0,"Cu sediul in localul Scolii Gimnaziale ""Gheorghe Tatarascu""(Scoala Generala nr. 1) din str. 23 August","MUNICIPIUL TARGU JIU",1,77812,1,1,1850,1003,868,135,995,8,2000,997,556,439,
20,"GORJ",181,77812,,27,0,"Cu sediul in localul Liceului ""Ecaterina Teodoroiu"" din str. 1 Decembrie 1918","MUNICIPIUL TARGU JIU",1,77812,1,1,1796,723,667,56,720,3,3200,2477,362,358,
20,"GORJ",181,77812,,28,0,"Cu sediul in localul Liceului ""Ecaterina Teodoroiu"" din str. 1 Decembrie 1918","MUNICIPIUL TARGU JIU",1,77812,1,1,1465,690,624,66,688,2,1600,910,387,301,
20,"GORJ",181,77812,,29,0,"Cu sediul in localul Liceului ""Ecaterina Teodoroiu"" din str. 1 Decembrie 1918","MUNICIPIUL TARGU JIU",1,77812,1,1,1449,715,644,71,713,2,1600,885,358,355,
20,"GORJ",181,77812,,30,0,"Cu sediul in localul Liceului Sportiv (Scoala Generala nr. 14) din str. 23 August","MUNICIPIUL TARGU JIU",1,77812,1,1,773,460,347,113,451,9,800,340,216,235,
20,"GORJ",181,77812,,31,0,"Cu sediul in localul Liceului Sportiv (Scoala Generala nr. 14) din str. 23 August","MUNICIPIUL TARGU JIU",1,77812,1,1,905,470,397,73,464,6,1100,630,258,206,
20,"GORJ",181,77812,,32,0,"Cu sediul in localul Colegiului ""Virgil Madgearu"" (Liceul Economic) din str. Tudor Vladimirescu","MUNICIPIUL TARGU JIU",1,77812,1,1,1631,804,755,49,794,10,1800,996,481,313,
20,"GORJ",181,77812,,33,0,"Cu sediul in localul Scolii Generale nr. 3 din str. Grivitei","MUNICIPIUL TARGU JIU",1,77812,1,1,1330,648,591,57,637,11,1500,852,410,227,
20,"GORJ",181,77812,,34,0,"Cu sediul in localul Scolii Generale nr. 3 din str. Grivitei","MUNICIPIUL TARGU JIU",1,77812,1,1,1238,607,556,51,601,6,1400,793,362,239,
20,"GORJ",181,77812,,35,0,"Cu sediul in localul Casei de Cultura a Sindicatelor din str. Traian","MUNICIPIUL TARGU JIU",1,77812,1,1,1250,684,556,128,675,9,1400,716,407,268,
20,"GORJ",181,77812,,36,0,"Cu sediul in localul Scolii Generale ""Sf. Nicolae"" (Scoala Generala nr. 6) din str. 11 Iunie 1848","MUNICIPIUL TARGU JIU",1,77812,1,1,2028,1148,1062,86,1108,22,2000,870,672,436,
20,"GORJ",181,77812,,37,0,"Cu sediul in localul Scolii Generale ""Sf. Nicolae"" (Scoala Generala nr. 6) din str. 11 Iunie 1848","MUNICIPIUL TARGU JIU",1,77812,1,1,1328,565,511,54,556,9,1504,939,340,216,
20,"GORJ",181,77812,,38,0,"Cu sediul in localul Scolii Generale ""Sf. Nicolae"" (Scoala Generala nr. 6) din str 11 Iunie 1848","MUNICIPIUL TARGU JIU",1,77812,1,1,1205,565,519,46,562,3,1400,835,365,197,
20,"GORJ",181,77812,,39,0,"Cu sediul in localul Scolii Generale nr. 3 din str. Grivitei","MUNICIPIUL TARGU JIU",1,77812,1,1,1653,905,809,96,893,12,1900,995,549,344,
20,"GORJ",181,77812,,40,0,"Cu sediul in localul Scolii Generale nr. 3 din str. Grivitei","MUNICIPIUL TARGU JIU",1,77812,1,1,1289,726,641,85,721,5,1500,774,644,77,
20,"GORJ",181,77812,,41,0,"Cu sediul in localul Scolii Generale nr. 2 din B-dul Ecaterina Teodoroiu (denumire veche b-dul 1 Mai)","MUNICIPIUL TARGU JIU",1,77812,1,1,1509,931,738,193,921,10,1700,769,504,417,
20,"GORJ",181,77812,,42,0,"Cu sediul in localul Grupului Industrial nr.4(Lic. Ind. de Constructii)din str. Lt.Col.Dumitru Petrescu(den.veche car.Debarcader","MUNICIPIUL TARGU JIU",1,77812,1,1,1416,720,652,68,716,4,1600,880,324,392,
20,"GORJ",181,77812,,43,0,"Cu sediul in localul Grupului Scolar Industrial ""Gheorghe Magheru""(Liceul de Chimie nr 1)din str. Lt. Col. Dumitru Petrescu","MUNICIPIUL TARGU JIU",1,77812,1,1,1203,601,527,74,595,6,1400,799,242,353,
20,"GORJ",181,77812,,44,0,"Cu sediul in localul ACH Jiu din str. Hidrocentralei","MUNICIPIUL TARGU JIU",1,77812,1,1,2091,1060,773,287,1051,9,2308,1248,401,650,
20,"GORJ",181,77812,,45,0,"Cu sediul in localul Scolii Generale nr. 7 din b-dul Ecaterina Teodoroiu (denumire veche b-dul 1 Mai)","MUNICIPIUL TARGU JIU",1,77812,1,1,1435,908,702,206,899,9,1600,692,475,424,
20,"GORJ",181,77812,,46,0,"Cu sediul in localul SC COREMI SA (AC Ind Tg-Jiu - Santierul 4) din str. Ciocarlau","MUNICIPIUL TARGU JIU",1,77812,1,1,1255,810,656,154,808,2,1400,590,418,390,
20,"GORJ",181,77812,,47,0,"Cu sediul in localul Scolii Generale nr. 5 din str. Calea Severinului","MUNICIPIUL TARGU JIU",1,77812,1,1,2056,1138,1037,101,1126,12,2400,1262,681,445,
20,"GORJ",181,77812,,48,0,"Cu sediul in localul Scolii Generale nr. 5 din str. Calea Severinului","MUNICIPIUL TARGU JIU",1,77812,1,1,1869,1000,956,44,996,4,2100,1097,658,338,
20,"GORJ",181,77812,,49,0,"Cu sediul in localul Scolii Generale nr. 9 din localitatea Barsesti","MUNICIPIUL TARGU JIU",1,77812,1,1,1515,826,720,106,819,7,1600,774,402,417,
20,"GORJ",181,77812,,50,1,"Cu sediul in UM 01466 Tg-Jiu","MUNICIPIUL TARGU JIU",1,77812,1,1,0,570,0,570,553,17,700,130,314,239,
20,"GORJ",181,77812,,51,1,"Cu sediul in UM 0658 Tg-Jiu","MUNICIPIUL TARGU JIU",1,77812,1,1,0,520,0,520,512,8,598,78,278,234,
20,"GORJ",181,77812,,52,1,"Cu sediul in localul Spitalului Judetean Gorj - 700 paturi, din str. Progresului","MUNICIPIUL TARGU JIU",1,77812,1,1,0,246,0,246,244,2,1100,854,137,107,
20,"GORJ",181,77812,,53,1,"Cu sediul in localul Spitalului Tudor Vladimirescu, din str. T. Vladimirescu","MUNICIPIUL TARGU JIU",1,77812,1,1,0,322,0,322,319,3,1200,878,155,164,
20,"GORJ",181,77812,,54,1,"Cu sediul in localul Spitalului din str. A.I.Cuza","MUNICIPIUL TARGU JIU",1,77812,1,1,0,176,0,176,176,0,1500,1324,108,68,
20,"GORJ",181,77812,,55,1,"Cu sediul in localul Statiei C.F.R. Tg-Jiu","MUNICIPIUL TARGU JIU",1,77812,1,1,0,522,0,522,516,6,2627,2105,234,282,
20,"GORJ",181,79308,,56,0,"Cu sediul la Clubul sindicatelor libere al U.M. Sadu","ORAS BUMBESTI-JIU",3,79308,2,1,1661,1016,813,203,1007,9,1828,812,595,412,
20,"GORJ",181,79308,,57,0,"Cu sediul in localul Scolii Gimnaziale Bumbesti-Jiu (localul vechi)","ORAS BUMBESTI-JIU",3,79308,2,1,1892,981,796,185,977,4,2075,1094,587,390,
20,"GORJ",181,79308,,58,0,"Cu sediul in localul nou al Scolii Gimnaziale Bumbesti-Jiu","ORAS BUMBESTI-JIU",3,79308,2,1,2199,1192,972,220,1182,10,2411,1219,708,474,
20,"GORJ",181,79308,,59,1,"Cu sediul la Scoala de Jandarmi Gr. Alex. Ghica","ORAS BUMBESTI-JIU",3,79308,2,1,232,258,221,37,255,3,279,21,145,110,
20,"GORJ",181,79308,,60,0,"Cu sediul in localul Scolii Gimnaziale Bumbesti-Jiu","ORAS BUMBESTI-JIU",3,79308,2,1,983,521,427,94,518,3,1081,560,289,229,
20,"GORJ",181,79308,,61,0,"Cu sediul la Scoala primara Tetila","ORAS BUMBESTI-JIU",3,79308,2,1,778,591,357,234,583,8,851,260,338,245,
20,"GORJ",181,79308,,62,0,"Cu sediul la Scoala gimnaziala Curtisoara","ORAS BUMBESTI-JIU",3,79308,2,1,765,396,311,85,393,3,847,451,213,180,
20,"GORJ",181,78141,,63,0,"Cu sediul in localul Scolii gimnaziale nr.2","MUNICIPIUL MOTRU",2,78141,1,1,2322,1187,994,193,1179,8,2555,1368,718,461,
20,"GORJ",181,78141,,64,0,"Cu sediul in localul Casei de Cultura","MUNICIPIUL MOTRU",2,78141,1,1,3640,1858,1668,190,1834,24,4011,2153,1105,729,
20,"GORJ",181,78141,,65,0,"Cu sediul in localul Scolii Generale nr. 3","MUNICIPIUL MOTRU",2,78141,1,1,1912,954,822,132,950,4,2093,1139,591,359,
20,"GORJ",181,78141,,66,0,"Cu sediul in localul Scolii Gimnaziale nr. 1","MUNICIPIUL MOTRU",2,78141,1,1,3098,1652,1443,209,1640,12,3670,2018,1000,640,
20,"GORJ",181,78141,,67,0,"Cu sediul in localul Gradinitei - VILA","MUNICIPIUL MOTRU",2,78141,1,1,766,436,390,46,435,1,842,406,280,155,
20,"GORJ",181,78141,,68,0,"Cu sediul in localul Policlinicii","MUNICIPIUL MOTRU",2,78141,1,1,2027,1164,921,243,1158,6,2222,1058,711,447,
20,"GORJ",181,78141,,69,0,"Cu sediul in localul Gradinitei Cresa nr. 1","MUNICIPIUL MOTRU",2,78141,1,1,1987,1032,936,96,1022,10,2120,1088,631,391,
20,"GORJ",181,78141,,70,0,"Cu sediul in localul Scolii Leurda","MUNICIPIUL MOTRU",2,78141,1,1,583,381,320,61,377,4,644,263,247,130,
20,"GORJ",181,78141,,71,0,"Cu sediul in localul Scolii Horasti","MUNICIPIUL MOTRU",2,78141,1,1,401,309,238,71,303,6,442,133,186,117,
20,"GORJ",181,78141,,72,0,"Cu sediul in localul Scolii Plostina","MUNICIPIUL MOTRU",2,78141,1,1,1120,782,661,121,775,7,1232,450,516,259,
20,"GORJ",181,78141,,73,0,"Cu sediul in localul Scolii Rosiuta","MUNICIPIUL MOTRU",2,78141,1,1,621,465,358,107,461,4,684,219,311,150,
20,"GORJ",181,78141,,74,0,"Cu sediul in localul Gradinitei Rapa","MUNICIPIUL MOTRU",2,78141,1,1,311,245,211,34,241,4,341,96,168,73,
20,"GORJ",181,78258,,75,0,"Cu sediul la Sc. Gen. Nr. 1 Novaci","ORAS NOVACI",4,78258,2,1,1702,1052,883,169,1044,8,1900,848,376,668,
20,"GORJ",181,78258,,76,0,"Cu sediul la Sc. Gen. Nr. 2 (Ungureni)","ORAS NOVACI",4,78258,2,1,1737,800,747,53,796,4,1902,1102,292,504,
20,"GORJ",181,78258,,77,0,"Cu sediul in localul Sc. Gen. Nr. 3 Pociovalistea","ORAS NOVACI",4,78258,2,1,1489,820,764,56,814,6,1635,815,344,470,
20,"GORJ",181,82895,,78,0,"Cu sediul la Scoala Generala nr. 1 Rovinari","ORAS ROVINARI",5,82895,2,1,2770,1654,1300,354,1654,0,3043,1389,810,844,
20,"GORJ",181,82895,,79,0,"Cu sediul la Liceul Industrial, Rovinari","ORAS ROVINARI",5,82895,2,1,1781,1126,786,340,1122,4,1937,811,523,599,
20,"GORJ",181,82895,,80,0,"Cu sediul la Clubul elevilor","ORAS ROVINARI",5,82895,2,1,2466,1457,1176,281,1457,0,2682,1225,717,740,
20,"GORJ",181,82895,,81,0,"Cu sediul in localul fostului magazin Poiana","ORAS ROVINARI",5,82895,2,1,232,167,118,49,165,2,255,88,88,77,
20,"GORJ",181,82895,,82,0,"Cu sediul in localul Scolii Generale Vart","ORAS ROVINARI",5,82895,2,1,294,230,172,58,230,0,323,93,111,119,
20,"GORJ",181,78329,,83,0,"Cu sediul in localul Scolii Generale nr. 1, Tg-Carbunesti","ORAS TIRGU CARBUNESTI",6,78329,2,1,2425,1265,1036,229,1255,10,2650,1385,611,644,
20,"GORJ",181,78329,,84,0,"Cu sediul in localul Liceului ""Tudor Arghezi""","ORAS TIRGU CARBUNESTI",6,78329,2,1,1496,803,632,171,795,8,1640,837,454,341,
20,"GORJ",181,78329,,85,0,"Cu sediul in localul Scolii Generale Cretesti","ORAS TIRGU CARBUNESTI",6,78329,2,1,850,310,271,39,309,1,937,627,136,173,
20,"GORJ",181,78329,,86,0,"Cu sediul in localul Scolii Generale Pojogeni","ORAS TIRGU CARBUNESTI",6,78329,2,1,859,442,355,87,438,4,944,502,227,211,
20,"GORJ",181,78329,,87,0,"Cu sediul in localul Scolii Generale Stefanesti","ORAS TIRGU CARBUNESTI",6,78329,2,1,468,317,242,75,313,4,522,205,226,87,
20,"GORJ",181,78329,,88,0,"Cu sediul in localul Caminului Cultural Carbunesti sat","ORAS TIRGU CARBUNESTI",6,78329,2,1,601,373,303,70,372,1,666,293,261,111,
20,"GORJ",181,78329,,89,1,"Cu sediul la UM01013 - Tg-Carbunesti","ORAS TIRGU CARBUNESTI",6,78329,2,1,0,162,0,162,161,1,166,4,93,68,
20,"GORJ",181,78454,,90,0,"Cu sediul in localul Scolii primare Tunsi","ORAS TICLENI",7,78454,2,1,815,467,386,81,463,4,883,416,303,160,
20,"GORJ",181,78454,,91,0,"Cu sediul in localul Scolii generale Centru","ORAS TICLENI",7,78454,2,1,2110,1231,978,253,1222,9,2322,1091,807,415,
20,"GORJ",181,78454,,92,0,"Cu sediul in localul Scolii primare Rasina","ORAS TICLENI",7,78454,2,1,861,457,396,61,457,0,946,489,364,93,
20,"GORJ",181,78472,,93,0,"Cu sediul in localul Caminului Cultural Albeni","ALBENI",8,78472,0,3,1405,721,613,108,717,4,1500,779,402,315,
20,"GORJ",181,78472,,94,0,"Cu sediul in localul Scolii Primare Bolbocesti","ALBENI",8,78472,0,3,654,389,317,72,389,0,766,377,230,159,
20,"GORJ",181,78542,,95,0,"Cu sediul la Caminul Cultural Alimpesti","ALIMPESTI",9,78542,0,3,996,659,571,88,655,4,1124,465,435,220,
20,"GORJ",181,78542,,96,0,"Cu sediul la Caminul Cultural Sirbesti","ALIMPESTI",9,78542,0,3,724,528,473,55,524,4,766,238,320,204,
20,"GORJ",181,78604,,97,0,"Cu sediul in localul Scolii vechi Aninoasa","ANINOASA",10,78604,0,3,1215,644,524,120,638,6,1370,726,432,206,
20,"GORJ",181,78604,,98,0,"Cu sediul in localul Scolii primare Costesti","ANINOASA",10,78604,0,3,786,409,331,78,406,3,842,433,204,202,
20,"GORJ",181,78604,,99,0,"Cu sediul in localul Scolii primare Sterpoaia","ANINOASA",10,78604,0,3,723,483,394,89,474,9,800,317,321,153,
20,"GORJ",181,78604,,100,0,"Cu sediul in localul Scolii Generale Groserea","ANINOASA",10,78604,0,3,518,291,228,63,287,4,557,266,205,82,
20,"GORJ",181,78668,,101,0,"Cu sediul localul Scolii Generale Arcani","ARCANI",11,78668,0,3,1038,682,497,185,674,8,1146,464,380,294,
20,"GORJ",181,78711,,102,0,"Cu sediul in localul Scolii Generale Baia de Fier","BAIA DE FIER",12,78711,0,3,2816,1699,1597,102,1681,18,3104,1405,910,771,
20,"GORJ",181,78711,,103,0,"Cu sediul in localul Scolii Generale Cernadia","BAIA DE FIER",12,78711,0,3,674,403,333,70,394,9,737,334,153,241,
20,"GORJ",181,78748,,104,0,"Cu sediul in localul Scolii primare nr. 2 Balanesti","BALANESTI",13,78748,0,3,596,341,275,66,339,2,728,387,161,178,
20,"GORJ",181,78748,,105,0,"Cu sediul in localul Caminului Cultural, din satul Voitestii din Vale","BALANESTI",13,78748,0,3,550,403,268,135,395,8,571,168,256,139,
20,"GORJ",181,78748,,106,0,"Cu sediul in localul Scolii Generale Glodeni","BALANESTI",13,78748,0,3,739,570,464,106,560,10,774,204,390,170,
20,"GORJ",181,77910,,107,0,"Cu sediul in localul Scolii gimnaziale Balesti","BALESTI",14,77910,0,3,2078,993,835,158,972,21,2291,1298,537,435,
20,"GORJ",181,77910,,108,0,"Cu sediul in localul Scolii gimnaziale Ceauru","BALESTI",14,77910,0,3,2208,1158,960,198,1152,6,2429,1271,687,465,
20,"GORJ",181,77910,,109,0,"Cu sediul in localul Scolii gimnaziale Cornesti","BALESTI",14,77910,0,3,1229,632,462,170,629,3,1350,718,383,246,
20,"GORJ",181,78828,,110,0,"Cu sediul in localul Caminului Cultural Barbatesti","BARBATESTI",16,78828,0,3,1457,760,641,119,750,10,1597,837,482,268,
20,"GORJ",181,78873,,111,0,"Cu sediul in Caminul Cultural Bengesti","BENGESTI-CIOCADIA",17,78873,0,3,1186,674,522,152,669,5,1287,613,405,264,
20,"GORJ",181,78873,,112,0,"Cu sediul in Caminul Cultural Ciocadia","BENGESTI-CIOCADIA",17,78873,0,3,785,442,331,111,437,5,862,420,202,235,
20,"GORJ",181,78873,,113,0,"Cu sediul in Caminul Cultural Balcesti","BENGESTI-CIOCADIA",17,78873,0,3,780,458,354,104,456,2,780,322,282,174,
20,"GORJ",181,78926,,114,0,"Cu sediul in Caminul Cultural din satul Parau-Viu","BERLESTI",18,78926,0,3,1163,538,422,116,536,2,1054,516,331,205,
20,"GORJ",181,78926,,115,0,"Cu sediul in localul Scolii primare din satul Berlesti","BERLESTI",18,78926,0,3,755,500,438,62,491,9,1000,500,295,196,
20,"GORJ",181,79004,,116,0,"Cu sediul in localul Primariei Bilteni","BALTENI",15,79004,0,3,1680,943,797,146,936,7,2026,1083,554,382,
20,"GORJ",181,79004,,117,0,"Cu sediul in localul Scolii generale Pesteana-Jiu","BALTENI",15,79004,0,3,1583,814,728,86,803,11,1669,855,600,203,
20,"GORJ",181,79004,,118,0,"Cu sediul in localul Scolii generale Moi","BALTENI",15,79004,0,3,1479,789,697,92,782,7,1571,782,428,354,
20,"GORJ",181,79004,,119,0,"Cu sediul in localul Scolii generale Cocoreni","BALTENI",15,79004,0,3,964,565,506,59,557,8,1015,450,331,226,
20,"GORJ",181,79077,,120,0,"Cu sediul in localul Scoli generale Bolbosi","BOLBOSI",19,79077,0,3,1465,863,783,80,850,13,1672,809,396,454,
20,"GORJ",181,79077,,121,0,"Cu sediul in localul Scolii generale Valea","BOLBOSI",19,79077,0,3,932,540,458,82,533,7,932,392,325,208,
20,"GORJ",181,79157,,122,0,"Cu sediul in localul Scolii generale Borascu","BORASCU",20,79157,0,3,1795,777,704,73,766,11,1931,1154,483,283,
20,"GORJ",181,79157,,123,0,"Cu sediul in localul Scolii generale Menti din satul Menti","BORASCU",20,79157,0,3,559,372,323,49,366,6,559,187,227,139,
20,"GORJ",181,79157,,124,0,"Cu sediul in localul Scolii generale din satul Miluta","BORASCU",20,79157,0,3,534,304,250,54,303,1,598,294,146,157,
20,"GORJ",181,79237,,125,0,"Cu sediul in localul Scolii generale din satul Capul-Dealului","BRANESTI",21,79237,0,3,668,443,360,83,438,5,718,275,266,172,
20,"GORJ",181,79237,,126,0,"Cu sediul in localul Scolii generale din satul Branesti","BRANESTI",21,79237,0,3,532,298,235,63,297,1,636,338,186,111,
20,"GORJ",181,79237,,127,0,"Cu sediul in localul Scolii generale din satul Parau","BRANESTI",21,79237,0,3,503,264,218,46,261,3,524,260,195,66,
20,"GORJ",181,79237,,128,0,"Cu sediul in localul Scolii primare din satul Badesti","BRANESTI",21,79237,0,3,211,141,84,57,136,5,231,90,97,39,
20,"GORJ",181,79362,,129,0,"Cu sediul in Caminul Cultural din satul Bumbesti-Pitic","BUMBESTI-PITIC",22,79362,0,3,2011,884,806,78,880,4,2218,1334,458,422,
20,"GORJ",181,79406,,130,0,"Cu sediul in localul Grupului Scolar Industrial Bustuchin","BUSTUCHIN",23,79406,0,3,1309,628,476,152,627,1,1475,847,415,212,
20,"GORJ",181,79406,,131,0,"Cu sediul in localul Scolii generale din Poiana-Seciuri","BUSTUCHIN",23,79406,0,3,717,410,318,92,407,3,792,382,214,193,
20,"GORJ",181,79406,,132,0,"Cu sediul in localul Scolii primare Poienita","BUSTUCHIN",23,79406,0,3,249,244,167,77,242,2,365,121,184,58,
20,"GORJ",181,79406,,133,0,"Cu sediul in localul Scolii generale Valea Pojarului","BUSTUCHIN",23,79406,0,3,366,261,216,45,259,2,385,124,177,82,
20,"GORJ",181,79497,,134,0,"Cu sediul in localul Caminului Cultural Capreni","CAPRENI",25,79497,0,3,1553,901,722,179,897,4,1729,828,549,348,
20,"GORJ",181,79497,,135,0,"Cu sediul in localul Scolii generale Bulbuceni","CAPRENI",25,79497,0,3,476,250,194,56,247,3,502,252,136,111,
20,"GORJ",181,79585,,136,0,"Cu sediul in localul Gradinitei de copii din satul Valea Perilor","CATUNELE",26,79585,0,3,521,336,289,47,334,2,551,215,204,130,
20,"GORJ",181,79585,,137,0,"Cu sediul in localul Caminului Cultural din satul Lupoaia","CATUNELE",26,79585,0,3,920,665,582,83,656,9,948,283,446,210,
20,"GORJ",181,79585,,138,0,"Cu sediul in localul Scolii primare din satul Dealul-Viilor","CATUNELE",26,79585,0,3,462,270,216,54,265,5,601,331,162,103,
20,"GORJ",181,79656,,139,0,"Cu sediul in localul vechi al primariei din satul Ciuperceni","CIUPERCENI",27,79656,0,3,431,318,208,110,313,5,481,163,176,137,
20,"GORJ",181,79656,,140,0,"Cu sediul in localul Scolii primare din satul Stramba Vulcan","CIUPERCENI",27,79656,0,3,249,202,144,58,202,0,267,65,110,92,
20,"GORJ",181,79656,,141,0,"Cu sediul in localul Scolii Vartopu","CIUPERCENI",27,79656,0,3,287,217,159,58,216,1,316,99,136,80,
20,"GORJ",181,79656,,142,0,"Cu sediul in localul Scolii generale din satul Pesteana Vulcan","CIUPERCENI",27,79656,0,3,276,233,165,68,231,2,303,70,160,71,
20,"GORJ",181,79736,,143,0,"Cu sediul in Caminul Cultural din satul Cilnic","CALNIC",24,79736,0,3,814,545,391,154,542,3,983,438,329,213,
20,"GORJ",181,79736,,144,0,"Cu sediul in Scoala primara Cilnicul de Sus din satul Calnic","CALNIC",24,79736,0,3,398,320,233,87,316,4,435,115,177,139,
20,"GORJ",181,79736,,145,0,"Cu sediul in Scoala primara din satul Pinoasa","CALNIC",24,79736,0,3,553,275,217,58,275,0,500,225,184,91,
20,"GORJ",181,79834,,146,0,"Cu sediul in Caminul Cultural din satul Carpinis","CRASNA",28,79834,0,3,2417,1334,1160,174,1324,10,2627,1293,561,763,
20,"GORJ",181,79834,,147,0,"Cu sediul in localul Scolii primare din satul Dragoesti","CRASNA",28,79834,0,3,1889,908,797,111,905,3,2115,1207,411,494,
20,"GORJ",181,79932,,148,0,"Cu sediul in localul Scolii generale nr. 1 Cruset","CRUSET",29,79932,0,3,1397,782,554,228,774,8,1594,812,422,352,
20,"GORJ",181,79932,,149,0,"Cu sediul in localul Caminului Cultural din satul Maiag","CRUSET",29,79932,0,3,858,434,333,101,434,0,858,424,258,176,
20,"GORJ",181,79932,,150,0,"Cu sediul in Caminul Cultural din satul Slavuta","CRUSET",29,79932,0,3,646,341,276,65,337,4,689,348,186,151,
20,"GORJ",181,80043,,151,0,"Cu sediul in localul Caminului Cultural din satul Danciulesti","DANCIULESTI",30,80043,0,3,793,616,496,120,596,20,921,305,367,229,
20,"GORJ",181,80043,,152,0,"Cu sediul in localul Caminului Cultural din satul Radinesti","DANCIULESTI",30,80043,0,3,1238,680,613,67,673,7,1323,643,305,368,
20,"GORJ",181,80123,,153,0,"Cu sediul in localul Scolii primare Danesti","DANESTI",31,80123,0,3,971,469,384,85,463,6,1114,645,206,257,
20,"GORJ",181,80123,,154,0,"Cu sediul in localul Scolii primare din satul Vacarea","DANESTI",31,80123,0,3,583,360,277,83,357,3,628,268,185,172,
20,"GORJ",181,80123,,155,0,"Cu sediul in localul Scolii primare din satul Sasa","DANESTI",31,80123,0,3,515,304,222,82,301,3,597,293,123,178,
20,"GORJ",181,80123,,156,0,"Cu sediul in localul Scolii generale din satul Bratuia","DANESTI",31,80123,0,3,759,352,263,89,347,5,818,466,158,189,
20,"GORJ",181,80249,,157,0,"Cu sediul in localul Caminului Cultural Dragotesti","DRAGOTESTI",32,80249,0,3,937,556,476,80,553,3,1104,548,249,304,
20,"GORJ",181,80249,,158,0,"Cu sediul in Caminul Cultural din satul Corobai","DRAGOTESTI",32,80249,0,3,1004,619,553,66,615,4,1032,413,246,369,
20,"GORJ",181,78016,,159,0,"Cu sediul in Caminul Cultural din satul Iasi","DRAGUTESTI",33,78016,0,3,1515,932,800,132,928,4,1731,799,586,342,
20,"GORJ",181,78016,,160,0,"Cu sediul in localul Scolii generale Urechesti","DRAGUTESTI",33,78016,0,3,652,436,347,89,431,5,736,300,268,163,
20,"GORJ",181,78016,,161,0,"Cu sediul in localul Scolii generale din satul Carbesti","DRAGUTESTI",33,78016,0,3,1693,866,756,110,856,10,1693,827,554,302,
20,"GORJ",181,80285,,162,0,"Cu sediul in localul Gradinitei din satul Pesteana de Jos","FARCASESTI",34,80285,0,3,750,455,374,81,452,3,801,346,287,165,
20,"GORJ",181,80285,,163,0,"Cu sediul in localul Scolii generale ""Victor Popescu""","FARCASESTI",34,80285,0,3,564,364,266,98,362,2,612,248,213,149,
20,"GORJ",181,80285,,164,0,"Cu sediul in localul Scolii generale din satul Farcasesti","FARCASESTI",34,80285,0,3,665,375,277,98,370,5,826,451,216,154,
20,"GORJ",181,80285,,165,0,"Cu sediul in localul Scolii generale din satul Rosia Jiu","FARCASESTI",34,80285,0,3,865,582,429,153,571,11,897,315,316,255,
20,"GORJ",181,80285,,166,0,"Cu sediul in localul Scolii generale din satul Timiseni","FARCASESTI",34,80285,0,3,280,161,113,48,155,6,305,144,82,73,
20,"GORJ",181,80365,,167,0,"Cu sediu in cladirea fostului magazin al Cooperatiei de Consum din satul Iormanesti","GLOGOVA",35,80365,0,3,1365,847,719,128,834,13,1491,644,504,330,
20,"GORJ",181,80427,,168,0,"Cu sediul in localul Primariei Godinesti","GODINESTI",36,80427,0,3,979,731,576,155,722,9,1079,348,432,290,
20,"GORJ",181,80427,,169,0,"Cu sediul in localul Scolii generale Calcesti","GODINESTI",36,80427,0,3,740,500,384,116,494,6,814,314,313,181,
20,"GORJ",181,80506,,170,0,"Cu sediul in Caminul Cultural Hurezani","HUREZANI",37,80506,0,3,1221,685,558,127,673,12,1851,1166,461,212,
20,"GORJ",181,80506,,171,0,"Cu sediul in localul Scolii primare Plopu","HUREZANI",37,80506,0,3,233,138,111,27,137,1,755,617,97,40,
20,"GORJ",181,80560,,172,0,"Cu sediul in localul Scolii generale Ionesti","IONESTI",38,80560,0,3,1982,1274,1156,118,1269,5,2178,904,864,405,
20,"GORJ",181,80613,,173,0,"Cu sediul in localul Caminului Cultural Jupinesti","JUPANESTI",39,80613,0,3,1099,549,469,80,543,6,1195,646,298,245,
20,"GORJ",181,80613,,174,0,"Cu sediul in localul Scolii primare Viersani","JUPANESTI",39,80613,0,3,719,383,313,70,372,11,795,412,196,176,
20,"GORJ",181,80677,,175,0,"Cu sediul in localul Primariei Lelesti","LELESTI",40,80677,0,3,1437,855,733,122,853,2,1585,730,483,370,
20,"GORJ",181,80711,,176,0,"Cu sediul in localul Scolii generale Licurici","LICURICI",41,80711,0,3,708,330,254,76,328,2,816,486,198,130,
20,"GORJ",181,80711,,177,0,"Cu sediul in localul Scolii generale Negreni","LICURICI",41,80711,0,3,632,332,245,87,330,2,681,349,203,127,
20,"GORJ",181,80711,,178,0,"Cu sediul in localul Scolii generale Totea","LICURICI",41,80711,0,3,652,331,251,80,331,0,695,364,182,149,
20,"GORJ",181,80766,,179,0,"Cu sediul in localul Caminului Cultural Frunza","LOGRESTI",42,80766,0,3,629,331,207,124,328,3,693,362,201,127,
20,"GORJ",181,80766,,180,0,"Cu sediul in localul Scolii generale Maru","LOGRESTI",42,80766,0,3,1018,418,317,101,412,6,1121,703,246,166,
20,"GORJ",181,80766,,181,0,"Cu sediul in localul Caminului Cultural Seaca","LOGRESTI",42,80766,0,3,276,193,145,48,192,1,305,112,92,100,
20,"GORJ",181,80766,,182,0,"Cu sediul in localul Scolii primare Mosteni","LOGRESTI",42,80766,0,3,484,260,186,74,255,5,535,275,186,69,
20,"GORJ",181,80846,,183,0,"Cu sediul in localul Gradinitei, sat Matasari","MATASARI",43,80846,0,3,1806,1049,718,331,1038,11,1806,757,475,563,
20,"GORJ",181,80846,,184,0,"Cu sediul in localul Scolii gimnaziale nr. 2, sat Matasari","MATASARI",43,80846,0,3,647,396,289,107,396,0,872,476,224,172,
20,"GORJ",181,80846,,185,0,"Cu sediul in localul Scolii primare din satul Bradet","MATASARI",43,80846,0,3,519,322,239,83,318,4,538,216,181,137,
20,"GORJ",181,80846,,186,0,"Cu sediul in localul Scolii primare din satul Runcurel","MATASARI",43,80846,0,3,328,240,186,54,238,2,343,103,136,102,
20,"GORJ",181,80846,,187,0,"Cu sediul in localul Scolii primare din satul Croici","MATASARI",43,80846,0,3,353,213,168,45,210,3,365,152,130,80,
20,"GORJ",181,80908,,188,0,"Cu sediul in localul Scolii generale Musetesti","MUSETESTI",44,80908,0,3,909,502,438,64,502,0,1056,554,262,240,
20,"GORJ",181,80908,,189,0,"Cu sediul in localul Scolii primare Stancesti","MUSETESTI",44,80908,0,3,529,271,229,42,271,0,553,282,102,169,
20,"GORJ",181,80908,,190,0,"Cu sediul in localul Scolii primare Grui","MUSETESTI",44,80908,0,3,431,313,258,55,313,0,444,131,188,125,
20,"GORJ",181,80980,,191,0,"Cu sediul in localul Scolii generale Negomir","NEGOMIR",45,80980,0,3,1243,800,667,133,790,10,1465,665,524,266,
20,"GORJ",181,80980,,192,0,"Cu sediul in localul Scolii primare Artanu","NEGOMIR",45,80980,0,3,877,567,491,76,561,6,922,355,311,250,
20,"GORJ",181,80980,,193,0,"Cu sediul in localul Scolii generale Raci","NEGOMIR",45,80980,0,3,823,588,500,88,578,10,823,235,357,221,
20,"GORJ",181,81095,,194,0,"Cu sediul in localul Caminului Cultural Pades(Scoala Pades)","PADES",46,81095,0,3,1241,707,606,101,704,3,1483,776,368,336,
20,"GORJ",181,81095,,195,0,"Cu sediul in localul Caminului Cultural Calugareni","PADES",46,81095,0,3,2548,1410,1228,182,1395,15,2688,1278,685,710,
20,"GORJ",181,81095,,196,0,"Cu sediul in localul Scolii generale din Cerna-Sat","PADES",46,81095,0,3,160,88,41,47,88,0,176,88,34,54,
20,"GORJ",181,81184,,197,0,"Cu sediul in localul Scolii generale Pestisani","PESTISANI",47,81184,0,3,1514,893,682,211,885,8,1644,751,464,421,
20,"GORJ",181,81184,,198,0,"Cu sediul in localul Grupului Scolar ""Constantin Brancusi""","PESTISANI",47,81184,0,3,1393,800,601,199,792,8,1531,731,418,374,
20,"GORJ",181,81264,,199,0,"Cu sediul in localul Scolii Plopsoru","PLOPSORU",48,81264,0,3,2049,877,784,93,869,8,2328,1451,485,384,
20,"GORJ",181,81264,,200,0,"Cu sediul in localul Scolii Piscuri","PLOPSORU",48,81264,0,3,804,437,381,56,436,1,878,441,232,204,
20,"GORJ",181,81264,,201,0,"Cu sediul in localul Scolii Izvoarele","PLOPSORU",48,81264,0,3,1157,672,628,44,671,1,1271,599,388,283,
20,"GORJ",181,81264,,202,0,"Cu sediul in localul Scolii Brosteni","PLOPSORU",48,81264,0,3,734,443,371,72,438,5,787,344,228,210,
20,"GORJ",181,81380,,203,0,"Cu sediul in localul Scolii generale Polovragi","POLOVRAGI",49,81380,0,3,1916,1137,1054,83,1123,14,2154,1017,768,355,
20,"GORJ",181,81380,,204,0,"Cu sediul in localul Scolii primare Racovita","POLOVRAGI",49,81380,0,3,459,311,281,30,306,5,457,146,209,97,
20,"GORJ",181,81415,,205,0,"Cu sediul in localul Scolii generale Prigoria","PRIGORIA",50,81415,0,3,1723,896,792,104,885,11,1939,1043,507,378,
20,"GORJ",181,81415,,206,0,"Cu sediul in localul Scolii generale Calugareasa","PRIGORIA",50,81415,0,3,498,339,289,50,338,1,531,192,172,166,
20,"GORJ",181,81415,,207,0,"Cu sediul in localul Scolii generale Negoiesti","PRIGORIA",50,81415,0,3,432,217,199,18,217,0,453,236,138,79,
20,"GORJ",181,81497,,208,0,"Cu sediul in localul Caminului Cultural din satul Rosia de Amaradia","ROSIA DE AMARADIA",51,81497,0,3,2537,1328,1176,152,1315,13,2757,1429,718,597,
20,"GORJ",181,81576,,209,0,"Cu sediul in localul Scolii generale Runcu","RUNCU",52,81576,0,3,1130,759,603,156,753,6,1366,607,315,438,
20,"GORJ",181,81576,,210,0,"Cu sediul in localul Scolii generale Balta","RUNCU",52,81576,0,3,1353,829,656,173,816,13,1433,604,296,520,
20,"GORJ",181,81576,,211,0,"Cu sediul in localul Gradinitei din satul Valea Mare","RUNCU",52,81576,0,3,736,463,372,91,440,23,763,300,178,262,
20,"GORJ",181,81576,,212,0,"Cu sediul in Caminul Cultural din satul Dobrita","RUNCU",52,81576,0,3,958,788,660,128,782,6,1109,321,389,393,
20,"GORJ",181,81576,,213,0,"Cu sediul in localul Caminului Cultural Suseni","RUNCU",52,81576,0,3,194,198,87,111,195,3,329,131,82,113,
20,"GORJ",181,81576,,214,1,"Cu sediul in localul sanatoriului TBC Dobrita","RUNCU",52,81576,0,3,0,244,0,244,241,3,385,141,155,86,
20,"GORJ",181,81576,,215,1,"Cu sediul in incinta UM 1083","RUNCU",52,81576,0,3,0,43,0,43,43,0,50,7,23,20,
20,"GORJ",181,81656,,216,0,"Cu sediul in localul Scolii generale Samarinesti","SAMARINESTI",54,81656,0,3,1023,618,537,81,615,3,1123,505,421,194,
20,"GORJ",181,81656,,217,0,"Cu sediul in localul Scolii primare Larga","SAMARINESTI",54,81656,0,3,382,253,189,64,252,1,422,169,187,65,
20,"GORJ",181,81754,,218,0,"Cu sediul in localul Scolii gimnaziale Sacelu","SACELU",53,81754,0,3,1494,710,591,119,704,6,1641,931,380,324,
20,"GORJ",181,81816,,219,0,"Cu sediul in localul Scolii generale Saulesti","SAULESTI",55,81816,0,3,1938,726,628,98,721,5,2129,1403,409,312,
20,"GORJ",181,81861,,220,0,"Cu sediul in localul Scolii generale Budieni","SCOARTA",57,81861,0,3,1179,570,410,160,558,12,1296,726,364,194,
20,"GORJ",181,81861,,221,0,"Cu sediul in localul Scolii generale Copacioasa","SCOARTA",57,81861,0,3,582,324,197,127,320,4,637,313,170,150,
20,"GORJ",181,81861,,222,0,"Cu sediul in localul Caminului Cultural Scoarta","SCOARTA",57,81861,0,3,903,437,288,149,430,7,992,555,250,180,
20,"GORJ",181,81861,,223,0,"Cu sediul in localul fostei primarii Bobu","SCOARTA",57,81861,0,3,971,785,568,217,776,9,1068,283,470,306,
20,"GORJ",181,81987,,224,0,"Cu sediul in localul Scolii primare din Sambotin","SCHELA",56,81987,0,3,534,348,297,51,343,5,570,222,210,133,
20,"GORJ",181,81987,,225,0,"Cu sediul in localul Scolii primare din Gornacel","SCHELA",56,81987,0,3,561,423,375,48,422,1,597,174,265,157,
20,"GORJ",181,81987,,226,0,"Cu sediul in localul Scolii generale Schela","SCHELA",56,81987,0,3,675,318,272,46,317,1,782,464,190,127,
20,"GORJ",181,82047,,227,0,"Cu sediul in localul Scolii primare Slivilesti","SLIVILESTI",58,82047,0,3,1057,510,408,102,501,9,1164,654,302,199,
20,"GORJ",181,82047,,228,0,"Cu sediul in localul Scolii generale Miculesti","SLIVILESTI",58,82047,0,3,856,506,370,136,504,2,939,433,299,205,
20,"GORJ",181,82047,,229,0,"Cu sediul in localul Scolii primare Stramtu","SLIVILESTI",58,82047,0,3,427,229,155,74,226,3,468,239,104,122,
20,"GORJ",181,82047,,230,0,"Cu sediul in localul Scolii primare Siacu","SLIVILESTI",58,82047,0,3,569,366,269,97,364,2,628,262,137,227,
20,"GORJ",181,82136,,231,0,"Cu sediul in localul Primariei Stanesti","STANESTI",59,82136,0,3,1181,559,460,99,551,8,1303,744,277,274,
20,"GORJ",181,82136,,232,0,"Cu sediul in localul Scolii generale Curpen","STANESTI",59,82136,0,3,884,586,461,125,581,5,972,386,185,396,
20,"GORJ",181,82243,,233,0,"Cu sediul in localul Caminului Cultural din satul Stejari","STEJARI",60,82243,0,3,980,496,394,102,489,7,1147,651,297,192,
20,"GORJ",181,82243,,234,0,"Cu sediul in localul Caminului Cultural din satul Balosani","STEJARI",60,82243,0,3,405,263,181,82,259,4,441,178,145,114,
20,"GORJ",181,82243,,235,0,"Cu sediul in localul Caminului Cultural din satul Piscoiu","STEJARI",60,82243,0,3,886,427,351,76,422,5,908,481,164,258,
20,"GORJ",181,82314,,236,0,"Cu sediul in localul Caminului Cultural Stoina","STOINA",61,82314,0,3,1886,1189,913,276,1180,9,2068,879,658,522,
20,"GORJ",181,82396,,237,0,"Cu sediu in localul Scolii generale din satul Telesti","TELESTI",63,82396,0,3,1486,696,570,126,688,8,1634,938,379,309,
20,"GORJ",181,82396,,238,0,"Cu sediul in localul Scolii primare Somanesti","TELESTI",63,82396,0,3,487,422,317,105,421,1,535,113,190,231,
20,"GORJ",181,82430,,239,0,"Cu sediul in localul Caminului Cultural Tismana","TISMANA",64,82430,0,3,1733,881,710,171,871,10,2162,1281,545,326,
20,"GORJ",181,82430,,240,0,"Cu sediul in localul Caminului Cultural Pocruia","TISMANA",64,82430,0,3,1182,707,552,155,704,3,1242,535,314,390,
20,"GORJ",181,82430,,241,0,"Cu sediul in localul Scolii primare Sohodol","TISMANA",64,82430,0,3,983,504,433,71,500,4,1022,518,248,252,
20,"GORJ",181,82430,,242,0,"Cu sediul in localul Scolii generale Celei","TISMANA",64,82430,0,3,1303,643,439,204,635,8,1345,702,321,314,
20,"GORJ",181,82430,,243,0,"Cu sediul in localul Caminului Cultural Topesti","TISMANA",64,82430,0,3,928,466,368,98,461,5,981,515,257,204,
20,"GORJ",181,82555,,244,0,"Cu sediul in localul Scolii generale nr. 1 Turburea","TURBUREA",65,82555,0,3,1159,741,569,172,735,6,1348,607,495,240,
20,"GORJ",181,82555,,245,0,"Cu sediul in localul Scolii primare Spahiu","TURBUREA",65,82555,0,3,684,396,306,90,391,5,734,338,246,145,
20,"GORJ",181,82555,,246,0,"Cu sediul in localul Scolii generale nr. 1 Poiana","TURBUREA",65,82555,0,3,1617,826,695,131,817,9,1723,897,438,379,
20,"GORJ",181,82617,,247,0,"Cu sediul la Casa de Cultura din Turceni","TURCENI",66,82617,0,3,3338,1973,1424,549,1959,14,3670,1697,1043,916,
20,"GORJ",181,82617,,248,0,"Cu sediul in localul Scolii generale Garbovu","TURCENI",66,82617,0,3,1282,764,635,129,756,8,1414,650,482,274,
20,"GORJ",181,82617,,249,0,"Cu sediul in localul Scolii generale Stramba Jiu","TURCENI",66,82617,0,3,1138,704,548,156,703,1,1250,546,420,283,
20,"GORJ",181,78089,,250,0,"Cu sediul in localul Primariei Turcinesti","TURCINESTI",67,78089,0,3,1229,709,612,97,703,6,1359,650,367,336,
20,"GORJ",181,78089,,251,0,"Cu sediul in localul scolii generale Rugi","TURCINESTI",67,78089,0,3,603,356,304,52,355,1,658,302,195,160,
20,"GORJ",181,82680,,252,0,"Cu sediul in localul Primariei Tantareni","TANTARENI",62,82680,0,3,1777,1096,957,139,1079,17,1984,888,616,463,
20,"GORJ",181,82680,,253,0,"Cu sediul in localul Scolii generale Floresti II","TANTARENI",62,82680,0,3,1002,543,457,86,541,2,1087,544,214,327,
20,"GORJ",181,82680,,254,0,"Cu sediul in localul Scolii generale Floresti I","TANTARENI",62,82680,0,3,1212,844,722,122,824,20,1330,486,450,374,
20,"GORJ",181,82680,,255,0,"Cu sediul in localul Scolii generale Chicioara","TANTARENI",62,82680,0,3,242,228,151,77,225,3,264,36,121,104,
20,"GORJ",181,82733,,256,0,"Cu sediul in localul Scolii generale nr. 1 Urdari","URDARI",68,82733,0,3,2519,1360,1285,75,1346,14,2780,1420,890,456,
20,"GORJ",181,82779,,257,0,"Cu sediul in localul Caminului Cultural Vagiulesti","VAGIULESTI",69,82779,0,3,1150,609,507,102,604,5,1322,713,379,225,
20,"GORJ",181,82779,,258,0,"Cu sediul in localul Caminului Cultural covrigi","VAGIULESTI",69,82779,0,3,1189,573,507,66,562,11,1255,682,299,263,
20,"GORJ",181,82831,,259,0,"Cu sediul in localul Caminului Cultural Andreesti","VLADIMIR",70,82831,0,3,930,636,413,223,633,3,1018,382,424,209,
20,"GORJ",181,82831,,260,0,"Cu sediul in localul Scolii generale Vladimir","VLADIMIR",70,82831,0,3,821,602,445,157,598,4,1218,616,425,173,
20,"GORJ",181,82831,,261,0,"Cu sediul in localul Scolii generale Frasinu","VLADIMIR",70,82831,0,3,543,234,161,73,230,4,648,414,161,69,
21,"HARGHITA",190,83320,,1,0,"B-dul Timisoarei nr.6  Casa de Cultura Municipala","MUNICIPIUL MIERCUREA CIUC",1,83320,1,1,1902,867,789,78,840,27,2000,1133,773,67,
21,"HARGHITA",190,83320,,2,0,"P-ta Libertatii nr.16 Casa de Cultura a Sindicatelor","MUNICIPIUL MIERCUREA CIUC",1,83320,1,1,2238,984,874,110,963,21,2500,1516,861,102,
21,"HARGHITA",190,83320,,3,0,"Str. Revolutiei din Decembrie nr.10 Scoala generala ""Nagy Imre""","MUNICIPIUL MIERCUREA CIUC",1,83320,1,1,2617,1056,974,82,1037,19,2900,1844,928,109,
21,"HARGHITA",190,83320,,4,0,"Str. Cosbuc nr.80 Liceul ""Marton Aron""","MUNICIPIUL MIERCUREA CIUC",1,83320,1,1,2700,1037,910,127,1012,25,2700,1663,911,101,
21,"HARGHITA",190,83320,,5,0,"Str. Patinoarului nr.2 Scoala generala nr.9 ""Liviu Rebreanu""","MUNICIPIUL MIERCUREA CIUC",1,83320,1,1,2060,1012,927,85,987,25,2200,1188,900,87,
21,"HARGHITA",190,83320,,6,0,"Str. Florilor nr.21 ASIROM","MUNICIPIUL MIERCUREA CIUC",1,83320,1,1,1776,836,779,57,809,27,1900,1064,740,69,
21,"HARGHITA",190,83320,,7,0,"Str. Harghita Camin de zi nr.1","MUNICIPIUL MIERCUREA CIUC",1,83320,1,1,1654,850,747,103,829,21,1900,1050,767,62,
21,"HARGHITA",190,83320,,8,0,"Str. Salcam nr.1 GOSCOM S.A.","MUNICIPIUL MIERCUREA CIUC",1,83320,1,1,1160,490,392,98,476,14,1200,710,437,39,
21,"HARGHITA",190,83320,,9,0,"Str. Dozsa nr.6 Palatul Justitiei","MUNICIPIUL MIERCUREA CIUC",1,83320,1,1,1626,917,763,154,890,27,1900,983,833,57,
21,"HARGHITA",190,83320,,10,0,"Str. Pictor Nagy Imre nr.140 Casa de Cultura","MUNICIPIUL MIERCUREA CIUC",1,83320,1,1,920,519,459,60,510,9,1100,581,498,12,
21,"HARGHITA",190,83320,,11,0,"Str. Vointa Colegiul Octavian Goga","MUNICIPIUL MIERCUREA CIUC",1,83320,1,1,2600,1053,986,67,1021,32,2600,1547,926,95,
21,"HARGHITA",190,83320,,12,0,"B-dul Fratiei Scoala Generala ""Ady Endre""","MUNICIPIUL MIERCUREA CIUC",1,83320,1,1,2401,1082,1027,55,1056,26,2600,1518,974,82,
21,"HARGHITA",190,83320,,13,0,"Str. Leliceni Gradinita nr.18","MUNICIPIUL MIERCUREA CIUC",1,83320,1,1,1767,937,687,250,922,15,1900,963,743,179,
21,"HARGHITA",190,83320,,14,0,"Aleea Copiilor Camin de zi nr.2","MUNICIPIUL MIERCUREA CIUC",1,83320,1,1,1729,744,630,114,726,18,1900,1156,608,118,
21,"HARGHITA",190,83320,,15,0,"Str. Petofi Sandor Scoala Generala ""Petofi Sandor""","MUNICIPIUL MIERCUREA CIUC",1,83320,1,1,2250,1074,978,96,1037,37,4000,2926,929,108,
21,"HARGHITA",190,83320,,16,0,"Str. Iancu de  Hunedoara nr.29/B Liceul Ind.nr.4","MUNICIPIUL MIERCUREA CIUC",1,83320,1,1,2568,1223,1050,173,1185,38,2700,1477,1083,102,
21,"HARGHITA",190,83320,,17,0,"Str. Szek nr. 123 S.C.A.P.A. Harghiteana S.A.","MUNICIPIUL MIERCUREA CIUC",1,83320,1,1,1595,911,802,109,882,29,1800,889,858,24,
21,"HARGHITA",190,83320,,18,0,"Str. Toplita nr.112 Scoala Generala ""Tamasi Aron""","MUNICIPIUL MIERCUREA CIUC",1,83320,1,1,1289,783,717,66,758,25,1400,617,743,15,
21,"HARGHITA",190,83320,,19,0,"Scoala Generala ""Nyiro Jozsef"" Harghita Bai","MUNICIPIUL MIERCUREA CIUC",1,83320,1,1,163,142,66,76,140,2,200,58,134,6,
21,"HARGHITA",190,83320,,20,1,"Spitalul Judetean Harghita","MUNICIPIUL MIERCUREA CIUC",1,83320,1,1,0,385,0,385,379,6,600,215,352,27,
21,"HARGHITA",190,83320,,21,1,"U.M.01101 Subpadure si Poligonul Militar","MUNICIPIUL MIERCUREA CIUC",1,83320,1,1,0,157,0,157,157,0,200,43,83,74,
21,"HARGHITA",190,83133,,22,0,"Str. Budvar nr.2 Scoala UCECOM","MUNICIPIUL ODORHEIU SECUIESC",2,83133,1,1,1918,892,737,155,878,14,2100,1208,860,18,
21,"HARGHITA",190,83133,,23,0,"Str. Morii nr. 41 Gradinita de copii nr.4","MUNICIPIUL ODORHEIU SECUIESC",2,83133,1,1,1988,936,845,91,916,20,2099,1163,878,38,
21,"HARGHITA",190,83133,,24,0,"P-ta Libertatii nr.11 Liceul Pedagogic","MUNICIPIUL ODORHEIU SECUIESC",2,83133,1,1,1946,906,736,170,881,25,2100,1194,865,16,
21,"HARGHITA",190,83133,,25,0,"Str. Tamasi Aron nr.11 Casa de Cultura","MUNICIPIUL ODORHEIU SECUIESC",2,83133,1,1,1450,780,682,98,763,17,1700,920,745,18,
21,"HARGHITA",190,83133,,26,0,"Str. Orban Balazs nr.100 Fosta Casa de Cultura din Sambatesti","MUNICIPIUL ODORHEIU SECUIESC",2,83133,1,1,1451,822,732,90,818,4,1700,878,802,16,
21,"HARGHITA",190,83133,,27,0,"Str. N. Balcescu nr.35  Liceul ""Kos Karoly""","MUNICIPIUL ODORHEIU SECUIESC",2,83133,1,1,1699,941,798,143,918,23,1900,959,899,19,
21,"HARGHITA",190,83133,,28,0,"Str. Bethlen Gabor nr.50 Parohia Unitariana","MUNICIPIUL ODORHEIU SECUIESC",2,83133,1,1,1388,799,611,188,783,16,1600,801,772,11,
21,"HARGHITA",190,83133,,29,0,"Str. Independentei nr.37 Scoala generala ""Orban Balazs""","MUNICIPIUL ODORHEIU SECUIESC",2,83133,1,1,2149,979,924,55,968,11,2300,1321,945,23,
21,"HARGHITA",190,83133,,30,0,"Str. Independentei nr.37 Scoala generala ""Orban Balazs""","MUNICIPIUL ODORHEIU SECUIESC",2,83133,1,1,2088,1031,949,82,1021,10,2200,1169,1003,18,
21,"HARGHITA",190,83133,,31,0,"Str. Tineretului nr.3 Scoala generala ""Bethlen Gabor""","MUNICIPIUL ODORHEIU SECUIESC",2,83133,1,1,1952,923,849,74,915,8,2099,1176,889,26,
21,"HARGHITA",190,83133,,32,0,"Str. Tineretului nr.3 Scoala generala ""Bethlen Gabor""","MUNICIPIUL ODORHEIU SECUIESC",2,83133,1,1,1811,843,789,54,831,12,2000,1157,816,15,
21,"HARGHITA",190,83133,,33,0,"Str. Intrarea Ghipes nr.4 Cresa din cart. Beclean","MUNICIPIUL ODORHEIU SECUIESC",2,83133,1,1,2700,1247,1166,81,1223,24,2800,1553,1208,15,
21,"HARGHITA",190,83133,,34,0,"Str. Beclean nr.2 Scoala generala nr.6 (fosta maternitate)","MUNICIPIUL ODORHEIU SECUIESC",2,83133,1,1,1576,735,604,131,729,6,1800,1065,707,22,
21,"HARGHITA",190,83133,,35,0,"Str. Victoriei nr.3 Sediul postei din cart. Beclean","MUNICIPIUL ODORHEIU SECUIESC",2,83133,1,1,2494,1207,1072,135,1191,16,2600,1393,1157,34,
21,"HARGHITA",190,83133,,36,0,"Str. Victoriei nr.16 Scoala generala nr. 7 ""Mora Ferenc""","MUNICIPIUL ODORHEIU SECUIESC",2,83133,1,1,1453,576,509,67,567,9,1700,1124,553,14,
21,"HARGHITA",190,83133,,37,0,"Str. Haaz Rezso nr.4 Sediul ""Urbana SA""","MUNICIPIUL ODORHEIU SECUIESC",2,83133,1,1,2265,963,889,74,951,12,2400,1437,928,23,
21,"HARGHITA",190,83133,,38,0,"Str. Beclean nr.170 Casa de cultura Beclean","MUNICIPIUL ODORHEIU SECUIESC",2,83133,1,1,1216,638,526,112,628,10,1600,962,611,17,
21,"HARGHITA",190,83133,,39,1,"Vanatori de munte","MUNICIPIUL ODORHEIU SECUIESC",2,83133,1,1,0,51,0,51,51,0,60,9,29,22,
21,"HARGHITA",190,83133,,40,1,"Pompieri","MUNICIPIUL ODORHEIU SECUIESC",2,83133,1,1,0,80,0,80,79,1,140,60,62,17,
21,"HARGHITA",190,83428,,41,0,"Str. Oltului nr.114 Casa de cultura Oraseneasca Baile Tusnad","ORAS BAILE TUSNAD",3,83428,2,1,1538,879,635,244,845,34,1800,921,745,100,
21,"HARGHITA",190,83464,,42,0,"Scoala generala nr.1 Balan","ORAS BALAN",4,83464,2,1,2308,1139,1038,101,1123,16,2500,1361,844,279,
21,"HARGHITA",190,83464,,43,0,"Str. Florilor nr.82 Scoala generala ""Geo Bogza"" Balan","ORAS BALAN",4,83464,2,1,2284,1173,1104,69,1164,9,2500,1327,815,349,
21,"HARGHITA",190,83464,,44,0,"Str. Florilor F.N. Clubul Elevilor Balan","ORAS BALAN",4,83464,2,1,2805,1280,1225,55,1275,5,3000,1720,857,418,
21,"HARGHITA",190,83491,,45,0,"Str. Mihai Eminescu nr.1 Scoala generala Borsec","ORAS BORSEC",5,83491,2,1,2370,1428,1311,117,1394,34,2600,1172,1284,110,
21,"HARGHITA",190,83525,,46,0,"Str. Timafalvi nr.43 Scoala generala ""Petofi Sandor"" Cristuru-Secuiesc","ORAS CRISTURU SECUIESC",6,83525,2,1,995,562,475,87,550,12,1100,538,538,12,
21,"HARGHITA",190,83525,,47,0,"Str. Harghitei nr.14 Centrul de plasament Cristuru-Secuiesc","ORAS CRISTURU SECUIESC",6,83525,2,1,1127,434,391,43,429,5,1300,866,421,8,
21,"HARGHITA",190,83525,,48,0,"Str. Libertatii nr.27 Primaria Cristuru-Secuiesc","ORAS CRISTURU SECUIESC",6,83525,2,1,1426,635,549,86,630,5,1600,965,607,23,
21,"HARGHITA",190,83525,,49,0,"Str. Kriza Janos nr.8 Casa de Cultura Cristuru-Secuiesc","ORAS CRISTURU SECUIESC",6,83525,2,1,1373,927,790,137,921,6,1500,573,905,16,
21,"HARGHITA",190,83525,,50,0,"Str. Orban Balazs nr.1 Liceul Teoretic ""Orban Balazs""","ORAS CRISTURU SECUIESC",6,83525,2,1,2125,1187,1086,101,1171,16,2400,1213,1139,32,
21,"HARGHITA",190,83525,,51,0,"Str. Filias nr.188 Casa de Cultura","ORAS CRISTURU SECUIESC",6,83525,2,1,831,550,471,79,540,10,900,350,528,12,
21,"HARGHITA",190,83561,,52,0,"Str. Kossuth Lajos nr.124 Scoala generala ""Kos Karoly""","ORAS GHEORGHENI",7,83561,2,1,2457,983,813,170,962,21,2600,1617,882,80,
21,"HARGHITA",190,83561,,53,0,"Str. Kossuth Lajos nr.81 Scoala generala ""Kos Karoly"" sectia I-IV (Orosz Kalman)","ORAS GHEORGHENI",7,83561,2,1,2342,1018,945,73,1002,16,2500,1482,952,50,
21,"HARGHITA",190,83561,,54,0,"Str. Kossuth Lajos nr.81 Scoala generala ""Kos Karoly"" sectia I-IV (Orosz Kalman)","ORAS GHEORGHENI",7,83561,2,1,2343,908,805,103,894,14,2500,1592,813,81,
21,"HARGHITA",190,83561,,55,0,"Str. Kossuth Lajos nr.2 Liceul ""Salamon Erno"" clasele I-VIII (Vaskertes)","ORAS GHEORGHENI",7,83561,2,1,1942,901,775,126,876,25,2200,1299,833,43,
21,"HARGHITA",190,83561,,56,0,"Str. Lacu Rosu nr.5 Liceul ""Salamon Erno""","ORAS GHEORGHENI",7,83561,2,1,2581,1342,1017,325,1295,47,2700,1358,1229,66,
21,"HARGHITA",190,83561,,57,0,"Str. Marton Aron nr.13-15 Grup Scolar Industrial de Constructii de Masini","ORAS GHEORGHENI",7,83561,2,1,2454,1510,1181,329,1478,32,2600,1090,1413,65,
21,"HARGHITA",190,83561,,58,0,"Bd. Lacu Rosu nr. 159 Scoala generala nr. 4","ORAS GHEORGHENI",7,83561,2,1,2244,1201,983,218,1178,23,2400,1199,1143,35,
21,"HARGHITA",190,83561,,59,0,"Str. Lacu Rosu Casa de Cultura -biblioteca-","ORAS GHEORGHENI",7,83561,2,1,75,83,29,54,82,1,300,217,47,35,
21,"HARGHITA",190,83561,,60,1,"Str. Ciobotului U.M. 0721","ORAS GHEORGHENI",7,83561,2,1,0,532,0,532,519,13,600,68,322,197,
21,"HARGHITA",190,83632,,61,0,"Str. Avram Iancu nr.4 Scoala generala nr.8 Toplita I","ORAS TOPLITA",8,83632,2,1,2003,1021,897,124,1014,7,2300,1279,644,370,
21,"HARGHITA",190,83632,,62,0,"Str. Avram Iancu nr.4 Scoala generala nr.6 Toplita II","ORAS TOPLITA",8,83632,2,1,1181,762,580,182,750,12,1500,738,475,275,
21,"HARGHITA",190,83632,,63,0,"Str. Garii nr.8 Clubul C.E.P.L. Toplita III","ORAS TOPLITA",8,83632,2,1,2432,1216,1083,133,1203,13,2500,1284,781,422,
21,"HARGHITA",190,83632,,64,0,"Str. Teiului nr.12 Scoala generala nr.2 Toplita IV","ORAS TOPLITA",8,83632,2,1,1372,695,651,44,686,9,1400,705,404,282,
21,"HARGHITA",190,83632,,65,0,"Str. 1 Decembrie 1918 Vale nr.100 Toplita V","ORAS TOPLITA",8,83632,2,1,1533,972,887,85,968,4,1700,728,459,509,
21,"HARGHITA",190,83632,,66,0,"Str. Stefan Cel Mare nr.6 Liceul ""Mihai Eminescu"" Toplita VI","ORAS TOPLITA",8,83632,2,1,2064,1105,969,136,1085,20,2200,1095,703,382,
21,"HARGHITA",190,83632,,67,0,"Str. Dealului nr.8 Liceul O.C.Taslaoanu Toplita VII","ORAS TOPLITA",8,83632,2,1,1414,627,551,76,616,11,1500,873,331,285,
21,"HARGHITA",190,83632,,68,0,"Str. Calimani nr.5 Scoala generala nr.3 Toplita VIII","ORAS TOPLITA",8,83632,2,1,941,536,490,46,527,9,1000,464,291,236,
21,"HARGHITA",190,83632,,69,0,"Str. Secu nr.15 Cabana Ocolului Silvic Toplita IX","ORAS TOPLITA",8,83632,2,1,54,82,33,49,79,3,200,118,62,17,
21,"HARGHITA",190,83749,,70,0,"Str. Harghitei nr.63 Scoala generala ""Martonffi Janos""","ORAS VLAHITA",9,83749,2,1,1167,754,710,44,728,26,1300,546,700,28,
21,"HARGHITA",190,83749,,71,0,"Str. Republicii nr.24 Scoala generala ""Martonffi Janos""","ORAS VLAHITA",9,83749,2,1,1426,811,768,43,799,12,1500,689,769,30,
21,"HARGHITA",190,83749,,72,0,"Str. Mihai Eminescu nr.2 Grup Scolar ""Gabor Aron""","ORAS VLAHITA",9,83749,2,1,2068,1086,997,89,1056,30,2300,1214,1044,12,
21,"HARGHITA",190,83749,,73,0,"Str. Gabor Aron nr.47 Casa de Cultura ""Bartok Bela""","ORAS VLAHITA",9,83749,2,1,1197,612,509,103,588,24,1300,688,574,14,
21,"HARGHITA",190,83785,,74,0,"Atid nr.469 Primaria","ATID",10,83785,0,3,973,540,484,56,529,11,1100,560,495,34,
21,"HARGHITA",190,83785,,75,0,"Criseni nr.285 Caminul Cultural","ATID",10,83785,0,3,546,332,280,52,320,12,700,368,301,19,
21,"HARGHITA",190,83785,,76,0,"Cusmed nr.29 Scoala generala nr.4","ATID",10,83785,0,3,365,268,225,43,265,3,500,232,254,11,
21,"HARGHITA",190,83785,,77,0,"Inlaceni nr.96 Sediul fostului CAP Inlaceni","ATID",10,83785,0,3,178,167,133,34,167,0,300,133,167,0,
21,"HARGHITA",190,83785,,78,0,"Siclod nr.260 Caminul Cultural","ATID",10,83785,0,3,364,284,238,46,284,0,500,216,282,2,
21,"HARGHITA",190,83847,,79,0,"Avramesti I Scoala generala din satul Cechesti","AVRAMESTI",11,83847,0,3,385,274,216,58,261,13,453,179,254,7,
21,"HARGHITA",190,83847,,80,0,"Avramesti II Sediul Primariei Avramesti","AVRAMESTI",11,83847,0,3,808,545,504,41,542,3,964,419,540,2,
21,"HARGHITA",190,83847,,81,0,"Avramesti III Scoala generala din satul Goagiu","AVRAMESTI",11,83847,0,3,517,364,325,39,349,15,615,251,339,10,
21,"HARGHITA",190,83847,,82,0,"Avramesti IV Scoala generala din satul Firtanus","AVRAMESTI",11,83847,0,3,297,198,163,35,197,1,368,170,197,0,
21,"HARGHITA",190,83936,,83,0,"Bilbor Caminul cultural Bilbor","BILBOR",12,83936,0,3,2174,1388,1297,91,1379,9,2500,1112,608,771,
21,"HARGHITA",190,83151,,84,0,"Bradesti nr.89 Caminul Cultural Bradesti","BRADESTI",13,83151,0,3,702,573,502,71,556,17,800,227,544,12,
21,"HARGHITA",190,83151,,85,0,"Tarnovita nr.51 Gradinita de copii Tarnovita","BRADESTI",13,83151,0,3,523,420,367,53,393,27,600,180,390,3,
21,"HARGHITA",190,83151,,86,0,"Satu Mare nr.480 Scoala generala ""Nyiro Jozsef""","BRADESTI",13,83151,0,3,1449,925,852,73,904,21,1600,675,868,36,
21,"HARGHITA",190,83963,,87,0,"Capilnita Caminul Cultural","CAPALNITA",14,83963,0,3,1605,952,909,43,944,8,1700,748,910,34,
21,"HARGHITA",190,83981,,88,0,"Ciucsangeorgiu Caminul Cultural din Ciucsangeorgiu","CIUCSANGEORGIU",16,83981,0,3,1785,583,540,43,545,38,2060,1477,515,30,
21,"HARGHITA",190,83981,,89,0,"Satul Armaseni Caminul Cultural","CIUCSANGEORGIU",16,83981,0,3,1005,675,588,87,641,34,1160,485,628,13,
21,"HARGHITA",190,83981,,90,0,"Satul Bancu Caminul Cultural","CIUCSANGEORGIU",16,83981,0,3,1112,897,685,212,874,23,1280,383,854,20,
21,"HARGHITA",190,84086,,91,0,"Ciumani Caminul Cultural","CIUMANI",17,84086,0,3,1627,1186,834,352,1162,24,1900,714,1130,32,
21,"HARGHITA",190,84086,,92,0,"Ciumani Scoala generala nr.3","CIUMANI",17,84086,0,3,2133,958,892,66,932,26,2200,1242,896,36,
21,"HARGHITA",190,84102,,93,0,"Cirta Caminul Cultural","CARTA",15,84102,0,3,2303,1705,1620,85,1697,8,2400,695,1656,41,
21,"HARGHITA",190,84102,,94,0,"Tomesti Sediul fostului C.A.P.","CARTA",15,84102,0,3,2087,1584,1492,92,1558,26,2400,816,1542,16,
21,"HARGHITA",190,84148,,95,0,"Corbu I Caminul Cultural","CORBU",18,84148,0,3,860,469,411,58,466,3,1000,531,195,271,
21,"HARGHITA",190,84148,,96,0,"Corbu II Caminul Cultural din satul Capu Corbului","CORBU",18,84148,0,3,353,301,220,81,296,5,500,199,150,146,
21,"HARGHITA",190,84175,,97,0,"Corund I Scoala generala din satul Corund Aripa Stanga","CORUND",19,84175,0,3,1764,1074,1004,70,1068,6,2000,926,1054,14,
21,"HARGHITA",190,84175,,98,0,"Corund II Scoala generala din satul Corund, Aripa Dreapta","CORUND",19,84175,0,3,1762,1063,998,65,1056,7,2000,937,1047,9,
21,"HARGHITA",190,84175,,99,0,"Corund III Fostul sediu al Primariei din Satul Atia","CORUND",19,84175,0,3,238,179,157,22,177,2,300,121,176,1,
21,"HARGHITA",190,84175,,100,0,"Corund IV Scoala generala din satul Fantana Brazilor","CORUND",19,84175,0,3,273,191,164,27,191,0,400,209,189,2,
21,"HARGHITA",190,84175,,101,0,"Corund V Scoala generala din satul Valea lui Pavel","CORUND",19,84175,0,3,314,231,199,32,231,0,400,169,229,2,
21,"HARGHITA",190,84237,,102,0,"Danesti I Caminul Cultural din Danesti","DANESTI",20,84237,0,3,1860,1302,1230,72,1278,24,1950,648,1248,30,
21,"HARGHITA",190,84237,,103,0,"Danesti II Caminul Cultural din Madaras","DANESTI",20,84237,0,3,1793,756,729,27,746,10,1950,1194,728,18,
21,"HARGHITA",190,84264,,104,0,"Dealu I Sala de Sport Dealu nr.95","DEALU",22,84264,0,3,1499,1073,1005,68,1064,9,1600,527,1028,36,
21,"HARGHITA",190,84264,,105,0,"Dealu II Scoala generala cu clasele I-IV din Sancrai","DEALU",22,84264,0,3,967,779,706,73,774,5,1100,321,768,6,
21,"HARGHITA",190,84264,,106,0,"Dealu III Scoala generala cu clasele I-VIII din Ulcani","DEALU",22,84264,0,3,470,397,336,61,386,11,600,203,377,9,
21,"HARGHITA",190,84344,,107,0,"Str. Libertatii nr.3 Scoala generala nr.5","DITRAU",23,84344,0,3,1607,767,703,64,747,20,1700,933,730,17,
21,"HARGHITA",190,84344,,108,0,"Str. Puskas Tivadar nr. 101 Scoala generala nr. 3","DITRAU",23,84344,0,3,873,464,432,32,454,10,1000,536,440,14,
21,"HARGHITA",190,84344,,109,0,"Str. Nicolae Balcescu nr.80 Scoala generala nr.1 clasele I-IV","DITRAU",23,84344,0,3,1004,408,388,20,386,22,1100,692,372,14,
21,"HARGHITA",190,84344,,110,0,"Str. Nicolae Balcescu nr.127 Scoala generala nr.1 clasele V-VIII","DITRAU",23,84344,0,3,903,350,310,40,338,12,1000,650,329,9,
21,"HARGHITA",190,84344,,111,0,"Sat Jolotca scoala generala nr.2 din Jolotca","DITRAU",23,84344,0,3,501,255,216,39,247,8,600,345,236,11,
21,"HARGHITA",190,84380,,112,0,"Darjiu Caminul Cultural","DARJIU",21,84380,0,3,615,445,331,114,443,2,700,255,431,12,
21,"HARGHITA",190,84380,,113,0,"Mujna Caminul Cultural","DARJIU",21,84380,0,3,336,277,237,40,272,5,400,123,264,8,
21,"HARGHITA",190,83197,,114,0,"Feliceni Scoala generala de 8 clase","FELICIENI",24,83197,0,3,664,443,376,67,437,6,700,257,428,9,
21,"HARGHITA",190,83197,,115,0,"Taureni Scoala generala de 4 clase","FELICIENI",24,83197,0,3,511,486,433,53,478,8,600,114,473,5,
21,"HARGHITA",190,83197,,116,0,"Forteni Scoala generala de 8 clase","FELICIENI",24,83197,0,3,616,540,487,53,539,1,800,260,539,0,
21,"HARGHITA",190,83197,,117,0,"Polonita Scoala generala de 4 clase","FELICIENI",24,83197,0,3,228,194,152,42,190,4,300,106,186,4,
21,"HARGHITA",190,83197,,118,0,"Teleac Scoala generala de 4 clase","FELICIENI",24,83197,0,3,195,159,127,32,156,3,300,141,150,6,
21,"HARGHITA",190,84415,,119,0,"Frumoasa Primaria","FRUMOASA",25,84415,0,3,1332,1115,853,262,1078,37,1500,385,1033,45,
21,"HARGHITA",190,84415,,120,0,"Nicolesti Scoala generala nr.2","FRUMOASA",25,84415,0,3,871,604,536,68,580,24,1000,396,576,4,
21,"HARGHITA",190,84415,,121,0,"Barzava Caminul Cultural","FRUMOASA",25,84415,0,3,545,410,380,30,396,14,700,290,386,10,
21,"HARGHITA",190,84460,,122,0,"Galautas Clubul 1 Mai","GALAUTAS",26,84460,0,3,1891,1226,1080,146,1209,17,2000,774,586,623,
21,"HARGHITA",190,84558,,123,0,"Joseni nr.632 Scoala generala","JOSENI",27,84558,0,3,1954,829,752,77,804,25,2100,1271,767,37,
21,"HARGHITA",190,84558,,124,0,"Joseni nr.813 Scoala generala","JOSENI",27,84558,0,3,2273,1115,1034,81,1084,31,2500,1385,1062,22,
21,"HARGHITA",190,84558,,125,0,"Borzont Scoala generala din satul Borzont","JOSENI",27,84558,0,3,641,354,312,42,341,13,700,346,318,23,
21,"HARGHITA",190,84594,,126,0,"Lazarea nr.276 Scoala generala nr.2","LAZAREA",28,84594,0,3,1200,514,472,42,508,6,1200,686,484,24,
21,"HARGHITA",190,84594,,127,0,"Lazarea nr.697 Scoala generala nr.1","LAZAREA",28,84594,0,3,889,435,378,57,424,11,1000,565,404,20,
21,"HARGHITA",190,84594,,128,0,"Lazarea nr.1049 Scoala generala nr.3","LAZAREA",28,84594,0,3,899,377,347,30,365,12,1000,623,344,21,
21,"HARGHITA",190,84594,,129,0,"Lazarea Scoala generala nr.4 GUDUC","LAZAREA",28,84594,0,3,114,100,57,43,99,1,200,100,97,2,
21,"HARGHITA",190,84629,,130,0,"Lueta Sediul Primariei","LUETA",29,84629,0,3,1464,535,524,11,516,19,1600,1065,504,12,
21,"HARGHITA",190,84629,,131,0,"Lueta Gradinita de copii nr.1","LUETA",29,84629,0,3,1531,579,515,64,559,20,1600,1021,543,16,
21,"HARGHITA",190,84656,,132,0,"Lunca de Jos Caminul Cultural ""Tarcau""","LUNCA DE JOS",30,84656,0,3,1405,890,842,48,853,37,1500,610,851,2,
21,"HARGHITA",190,84656,,133,0,"""Lunca de Jos-Centru"" Caminul Cultural","LUNCA DE JOS",30,84656,0,3,1605,839,761,78,787,52,1700,861,760,27,
21,"HARGHITA",190,84656,,134,0,"Valea Rece Caminul Cultural Valea Rece","LUNCA DE JOS",30,84656,0,3,1132,839,693,146,799,40,1300,461,768,31,
21,"HARGHITA",190,84754,,135,0,"Lunca de Sus Sediul Primariei","LUNCA DE SUS",31,84754,0,3,1840,1103,1020,83,1079,24,2000,897,1021,58,
21,"HARGHITA",190,84754,,136,0,"Izvorul Trotusului Scoala generala Izvorul Trotusului","LUNCA DE SUS",31,84754,0,3,749,570,482,88,529,41,800,230,520,9,
21,"HARGHITA",190,84754,,137,1,"Lunca de Sus Clubul U.M. 01159","LUNCA DE SUS",31,84754,0,3,86,120,86,34,118,2,196,76,72,46,
21,"HARGHITA",190,84825,,138,0,"Lupeni Scoala generala ""Tamasi Aron""","LUPENI",32,84825,0,3,1829,1275,1191,84,1263,12,1900,625,1255,8,
21,"HARGHITA",190,84825,,139,0,"Bisericani Scoala generala ""P.Benedek Fidel""","LUPENI",32,84825,0,3,1285,953,894,59,948,5,1400,447,945,3,
21,"HARGHITA",190,84825,,140,0,"Pauleni Scoala generala","LUPENI",32,84825,0,3,333,290,263,27,288,2,400,110,287,1,
21,"HARGHITA",190,84923,,141,0,"Martinis Internatul scolii","MARTINIS",33,84923,0,3,551,407,321,86,402,5,600,193,389,13,
21,"HARGHITA",190,84923,,142,0,"Aldea Scoala generala Aldea","MARTINIS",33,84923,0,3,428,321,251,70,320,1,500,179,314,6,
21,"HARGHITA",190,84923,,143,0,"Badeni Scoala generala Badeni","MARTINIS",33,84923,0,3,195,189,156,33,189,0,220,31,188,1,
21,"HARGHITA",190,84923,,144,0,"Ghipes Scoala generala Ghipes","MARTINIS",33,84923,0,3,175,147,128,19,147,0,200,53,146,1,
21,"HARGHITA",190,84923,,145,0,"Sanpaul Scoala generala Sanpaul","MARTINIS",33,84923,0,3,654,495,425,70,480,15,700,205,465,15,
21,"HARGHITA",190,84923,,146,0,"Oraseni Scoala generala Oraseni","MARTINIS",33,84923,0,3,230,208,182,26,208,0,280,72,208,0,
21,"HARGHITA",190,85056,,147,0,"Meresti Sediul Primariei","MERESTI",34,85056,0,3,1169,749,682,67,737,12,1300,551,723,14,
21,"HARGHITA",190,85074,,148,0,"Mihaileni Sediul Primariei","MIHAILENI",35,85074,0,3,1716,1029,947,82,1005,24,1800,771,995,10,
21,"HARGHITA",190,85074,,149,0,"Livezi Ciuc Scoala generala Livezi Ciuc","MIHAILENI",35,85074,0,3,438,273,250,23,273,0,500,227,88,185,
21,"HARGHITA",190,85127,,150,0,"Mugeni Caminul Cultural","MUGENI",36,85127,0,3,1063,757,679,78,752,5,1200,443,744,8,
21,"HARGHITA",190,85127,,151,0,"Lutita Caminul Cultural","MUGENI",36,85127,0,3,1006,739,681,58,733,6,1100,361,724,9,
21,"HARGHITA",190,85127,,152,0,"Taietura Scoala generala ""Marton Aron""","MUGENI",36,85127,0,3,705,532,494,38,529,3,850,318,518,11,
21,"HARGHITA",190,85127,,153,0,"Porumbenii Mari Caminul Cultural","MUGENI",36,85127,0,3,897,748,668,80,746,2,1050,302,736,10,
21,"HARGHITA",190,85127,,154,0,"Porumbenii Mici Caminul Cultural","MUGENI",36,85127,0,3,357,257,217,40,254,3,450,193,251,3,
21,"HARGHITA",190,85127,,155,0,"Betesti Caminul Cultural","MUGENI",36,85127,0,3,480,274,241,33,268,6,550,276,249,19,
21,"HARGHITA",190,85243,,156,0,"Ocland Caminul Cultural","OCLAND",37,85243,0,3,629,541,479,62,537,4,750,209,523,14,
21,"HARGHITA",190,85243,,157,0,"Craciunel Caminul Cultural","OCLAND",37,85243,0,3,369,321,263,58,304,17,450,129,284,20,
21,"HARGHITA",190,83375,,158,0,"Pauleni Ciuc Caminul Cultural","PAULENI-CIUC",38,83375,0,3,476,319,289,30,314,5,600,281,304,10,
21,"HARGHITA",190,83375,,159,0,"Delnita Scoala generala","PAULENI-CIUC",38,83375,0,3,463,285,264,21,282,3,600,315,279,3,
21,"HARGHITA",190,83375,,160,0,"Soimeni Scoala generala","PAULENI-CIUC",38,83375,0,3,378,251,219,32,241,10,500,249,234,7,
21,"HARGHITA",190,85289,,161,0,"Plaiesii de Jos nr.105 Casa de Cultura","PLAIESII DE JOS",39,85289,0,3,1286,803,704,99,774,29,1500,697,726,48,
21,"HARGHITA",190,85289,,162,0,"Iacobeni nr.331 Scoala generala","PLAIESII DE JOS",39,85289,0,3,327,224,184,40,218,6,400,176,189,29,
21,"HARGHITA",190,85289,,163,0,"Casinu-Nou nr.3333 Scoala generala","PLAIESII DE JOS",39,85289,0,3,660,482,435,47,470,12,800,318,458,12,
21,"HARGHITA",190,85341,,164,0,"Praid Sediul Primariei","PRAID",40,85341,0,3,1430,941,857,84,927,14,1600,659,911,16,
21,"HARGHITA",190,85341,,165,0,"Praid Caminul Cultural","PRAID",40,85341,0,3,1368,885,795,90,864,21,1500,615,832,32,
21,"HARGHITA",190,85341,,166,0,"Ocna de Jos Caminul Cultural","PRAID",40,85341,0,3,1268,967,900,67,958,9,1350,383,947,11,
21,"HARGHITA",190,85341,,167,0,"Satul Ocna de Sus Caminul Cultural","PRAID",40,85341,0,3,1028,732,669,63,707,25,1100,368,704,3,
21,"HARGHITA",190,85341,,168,0,"Becas Scoala generala","PRAID",40,85341,0,3,110,72,58,14,72,0,150,78,72,0,
21,"HARGHITA",190,85412,,169,0,"Remetea Scoala generala - Fabrica de lapte","REMETEA",41,85412,0,3,1334,687,633,54,673,14,1500,813,660,13,
21,"HARGHITA",190,85412,,170,0,"Remetea Scoala generala ""Frater Gyorgy""","REMETEA",41,85412,0,3,1505,911,818,93,890,21,1700,789,885,5,
21,"HARGHITA",190,85412,,171,0,"Remetea Gradinita de copii ""Tulamaros""","REMETEA",41,85412,0,3,1112,617,534,83,593,24,1200,583,589,4,
21,"HARGHITA",190,85412,,172,0,"Remetea Scoala generala ""Balas Jeno""","REMETEA",41,85412,0,3,1078,631,540,91,618,13,1200,569,596,22,
21,"HARGHITA",190,85467,,173,0,"Sacel Caminul Cultural","SACEL",42,85467,0,3,146,115,79,36,112,3,174,59,52,60,
21,"HARGHITA",190,85467,,174,0,"Vidacut Caminul Cultural","SACEL",42,85467,0,3,238,189,140,49,180,9,295,106,114,66,
21,"HARGHITA",190,85467,,175,0,"Soimusu Mic Caminul Cultural","SACEL",42,85467,0,3,436,310,271,39,301,9,553,243,269,32,
21,"HARGHITA",190,85467,,176,0,"Soimusu Mare Caminul Cultural","SACEL",42,85467,0,3,303,237,174,63,233,4,378,141,226,7,
21,"HARGHITA",190,85528,,177,0,"Platonesti Scoala generala","SARMAS",47,85528,0,3,408,320,286,34,318,2,500,180,110,208,
21,"HARGHITA",190,85528,,178,0,"Sarmas Scoala generala nr.1","SARMAS",47,85528,0,3,1651,1149,1056,93,1139,10,1800,651,425,714,
21,"HARGHITA",190,85528,,179,0,"Hodosa Scoala generala nr.2","SARMAS",47,85528,0,3,1168,687,607,80,678,9,1300,613,383,295,
21,"HARGHITA",190,85582,,180,0,"Secuieni Scoala generala ""Bem Jozsef""","SECUIENI",48,85582,0,3,1103,601,524,77,595,6,1200,599,572,23,
21,"HARGHITA",190,85582,,181,0,"Eliseni Caminul Cultural","SECUIENI",48,85582,0,3,833,504,488,16,487,17,1000,496,466,21,
21,"HARGHITA",190,85626,,182,0,"Siculeni Sediul Primariei","SICULENI",49,85626,0,3,817,539,392,147,535,4,880,341,489,46,
21,"HARGHITA",190,85626,,183,0,"Ciceu Caminul Cultural","SICULENI",49,85626,0,3,2034,1167,1054,113,1164,3,2232,1065,1147,17,
21,"HARGHITA",190,85626,,184,0,"Siculeni Scoala generala nr.1","SICULENI",49,85626,0,3,1378,670,581,89,661,9,1472,802,649,12,
21,"HARGHITA",190,85626,,185,0,"Racu Scoala generala","SICULENI",49,85626,0,3,859,566,506,60,548,18,928,362,538,10,
21,"HARGHITA",190,85626,,186,0,"Satul Nou Cooperativa de Consum","SICULENI",49,85626,0,3,346,300,259,41,300,0,388,88,292,8,
21,"HARGHITA",190,85680,,187,0,"Sancraieni Scoala generala ""Vitos Mozes""","SANCRAIENI",43,85680,0,3,1986,1163,1072,91,1105,58,2200,1037,1091,14,
21,"HARGHITA",190,85680,,188,0,"Santimbru Scoala generala Santimbru","SANCRAIENI",43,85680,0,3,1615,1184,1037,147,1173,11,1700,516,1159,14,
21,"HARGHITA",190,85680,,189,0,"Misentea Sediul fostului CAP","SANCRAIENI",43,85680,0,3,752,557,484,73,551,6,800,243,542,9,
21,"HARGHITA",190,85680,,190,0,"Leliceni Sediul fostului CAP","SANCRAIENI",43,85680,0,3,564,295,261,34,288,7,600,305,278,10,
21,"HARGHITA",190,85760,,191,0,"Sandominic Sediul Primariei","SANDOMINIC",44,85760,0,3,3046,1728,1654,74,1698,30,3200,1472,1663,35,
21,"HARGHITA",190,85760,,192,0,"Sandominic Scoala generala ""Marton Aron""","SANDOMINIC",44,85760,0,3,2070,1007,922,85,976,31,2200,1193,942,34,
21,"HARGHITA",190,85788,,193,0,"Sanmartin Sediul Primariei","SANMARTIN",45,85788,0,3,1778,954,878,76,928,26,2000,1046,880,48,
21,"HARGHITA",190,85788,,194,0,"Cozmeni Caminul Cultural","SANMARTIN",45,85788,0,3,1053,748,689,59,721,27,1100,352,714,7,
21,"HARGHITA",190,85788,,195,0,"Lazaresti Caminul Cultural","SANMARTIN",45,85788,0,3,455,385,323,62,381,4,600,215,359,22,
21,"HARGHITA",190,85840,,196,0,"Sansimion Caminul Cultural","SANSIMION",46,85840,0,3,2647,1410,1332,78,1375,35,2800,1390,1318,57,
21,"HARGHITA",190,85877,,197,0,"Subcetate Caminul Cultural","SUBCETATE",51,85877,0,3,1706,1005,927,78,985,20,1800,795,396,589,
21,"HARGHITA",190,85920,,198,0,"Suseni nr.212 Sediul Primariei","SUSENI",52,85920,0,3,1744,1055,974,81,1044,11,2000,945,1034,10,
21,"HARGHITA",190,85920,,199,0,"Suseni nr.332 Scoala generala din Mures sat","SUSENI",52,85920,0,3,757,495,455,40,482,13,800,305,475,7,
21,"HARGHITA",190,85920,,200,0,"Chileni nr.206 Scoala generala","SUSENI",52,85920,0,3,656,417,381,36,406,11,800,383,396,10,
21,"HARGHITA",190,85920,,201,0,"Valea Stramba nr.200 Scoala generala","SUSENI",52,85920,0,3,1115,623,587,36,601,22,1200,577,595,6,
21,"HARGHITA",190,85984,,202,0,"Simonesti Sediul Primariei","SIMONESTI",50,85984,0,3,1086,741,667,74,732,9,1200,459,727,5,
21,"HARGHITA",190,85984,,203,0,"Cobatesti Caminul Cultural","SIMONESTI",50,85984,0,3,438,296,221,75,295,1,496,200,291,4,
21,"HARGHITA",190,85984,,204,0,"Ruganesti Caminul Cultural","SIMONESTI",50,85984,0,3,568,472,393,79,463,9,650,178,459,4,
21,"HARGHITA",190,85984,,205,0,"Tarcesti Caminul Cultural","SIMONESTI",50,85984,0,3,381,303,254,49,303,0,450,147,299,4,
21,"HARGHITA",190,85984,,206,0,"Mihaileni Caminul Cultural","SIMONESTI",50,85984,0,3,444,400,344,56,397,3,500,100,394,3,
21,"HARGHITA",190,86133,,207,0,"Tulghes nr.338 Scoala generala nr.1","TULGHES",53,86133,0,3,1329,675,568,107,671,4,1500,825,415,256,
21,"HARGHITA",190,86133,,208,0,"Rezu Mare nr.42/a Scoala generala nr.4","TULGHES",53,86133,0,3,577,278,243,35,274,4,700,422,180,94,
21,"HARGHITA",190,86133,,209,0,"Hogota nr.57/a Scoala generala","TULGHES",53,86133,0,3,207,88,63,25,84,4,300,212,55,29,
21,"HARGHITA",190,86133,,210,0,"Valea Frumoasa nr.851 Scoala generala nr.6","TULGHES",53,86133,0,3,578,385,333,52,375,10,700,315,260,115,
21,"HARGHITA",190,86188,,211,0,"Tusnad Sat nr.193 Caminul Cultural","TUSNAD",54,86188,0,3,1013,566,492,74,553,13,1000,434,523,30,
21,"HARGHITA",190,86188,,212,0,"Tusnad Nou nr.573 Caminul Cultural","TUSNAD",54,86188,0,3,626,497,339,158,491,6,900,403,479,12,
21,"HARGHITA",190,86222,,213,0,"Ulies nr.44 Clubul Caminului Cultural","ULIES",55,86222,0,3,269,249,218,31,245,4,400,151,244,1,
21,"HARGHITA",190,86222,,214,0,"Daia Sediul fostului CAP","ULIES",55,86222,0,3,258,216,178,38,213,3,400,184,201,12,
21,"HARGHITA",190,86222,,215,0,"Nicolesti nr.23 Sediul fostului CAP","ULIES",55,86222,0,3,174,135,86,49,135,0,300,165,133,2,
21,"HARGHITA",190,86222,,216,0,"Petecu nr.104 Sediul fostului CAP","ULIES",55,86222,0,3,208,231,166,65,231,0,300,69,229,2,
21,"HARGHITA",190,86311,,217,0,"Varsag Caminul Cultural","VARSAG",56,86311,0,3,1234,788,766,22,773,15,1400,612,734,39,
21,"HARGHITA",190,86339,,218,0,"Voslobeni Scoala generala nr.1","VOSLOBENI",57,86339,0,3,983,565,490,75,562,3,1100,535,307,255,
21,"HARGHITA",190,86339,,219,0,"Izvorul Mures Scoala generala nr.2","VOSLOBENI",57,86339,0,3,620,391,322,69,386,5,700,309,313,73,
21,"HARGHITA",190,86366,,220,0,"Zetea nr.271 Caminul Cultural","ZETEA",58,86366,0,3,2068,1265,1095,170,1244,21,2200,935,1212,32,
21,"HARGHITA",190,86366,,221,0,"Zetea str.Tofalau nr.378 Scoala generala nr.7","ZETEA",58,86366,0,3,1468,813,711,102,801,12,1600,787,788,13,
21,"HARGHITA",190,86366,,222,0,"Sub Cetate nr.100 Scoala generala ""Jokai Mor""","ZETEA",58,86366,0,3,432,347,245,102,340,7,600,253,328,12,
21,"HARGHITA",190,86366,,223,0,"Sicasau Sectorul de Exploatare","ZETEA",58,86366,0,3,118,80,52,28,74,6,200,120,74,0,
21,"HARGHITA",190,86366,,224,0,"Izvoare nr.132/A Scoala generala ""Szekely Janos""","ZETEA",58,86366,0,3,260,197,144,53,194,3,400,203,188,6,
22,"HUNEDOARA",207,86687,,1,0,"Casa de cultura (sala mica) Piata Victoriei","MUNICIPIUL DEVA",1,86687,1,1,1946,1006,922,84,990,16,2050,1044,760,230,
22,"HUNEDOARA",207,86687,,2,0,"Casa de cultura (sala de conferinte) Piata Victoriei","MUNICIPIUL DEVA",1,86687,1,1,1507,810,710,100,795,11,1650,840,552,243,
22,"HUNEDOARA",207,86687,,3,0,"CEPROMIN B-dul 22 Decembrie nr.37 A","MUNICIPIUL DEVA",1,86687,1,1,1745,906,852,54,884,22,1875,969,573,311,
22,"HUNEDOARA",207,86687,,4,0,"Gradinita nr.7 Aleea Patriei","MUNICIPIUL DEVA",1,86687,1,1,1307,817,744,73,811,6,1400,583,565,246,
22,"HUNEDOARA",207,86687,,5,0,"Liceul Sabin Dragoi, Str.Gh.Baritiu","MUNICIPIUL DEVA",1,86687,1,1,1226,751,653,98,734,17,1350,599,508,226,
22,"HUNEDOARA",207,86687,,6,0,"Sala expozitiei PTTR, Str.Maresal Averescu","MUNICIPIUL DEVA",1,86687,1,1,1799,902,859,43,889,13,1850,948,611,278,
22,"HUNEDOARA",207,86687,,7,0,"Cantina Restaurant Bloc M parter B-dul Decebal","MUNICIPIUL DEVA",1,86687,1,1,1909,1046,961,85,1032,14,2050,1004,692,340,
22,"HUNEDOARA",207,86687,,8,0,"Galeria Forma, Blocul 8 parter, B-dul Decebal","MUNICIPIUL DEVA",1,86687,1,1,1820,989,875,114,976,13,1800,811,672,304,
22,"HUNEDOARA",207,86687,,9,0,"Colegiul National Decebal, B-dul 1 Decembrie","MUNICIPIUL DEVA",1,86687,1,1,1501,879,770,109,860,19,1600,721,675,185,
22,"HUNEDOARA",207,86687,,10,0,"Grup Scolar de Educatie Fizica si Sport, Str.Axente Sever","MUNICIPIUL DEVA",1,86687,1,1,1466,802,732,70,783,19,1575,773,571,212,
22,"HUNEDOARA",207,86687,,11,0,"Scoala Generala nr.2, Viile Noi, str.16 februarie","MUNICIPIUL DEVA",1,86687,1,1,1739,923,817,106,906,17,1900,977,520,386,
22,"HUNEDOARA",207,86687,,12,0,"Scoala Generala nr.2, Str.Cuza Voda","MUNICIPIUL DEVA",1,86687,1,1,1435,821,761,60,813,8,1600,779,588,225,
22,"HUNEDOARA",207,86687,,13,0,"S.C. ""PLUS COM"", Piata Garii nr.2","MUNICIPIUL DEVA",1,86687,1,1,1768,952,902,50,941,11,1900,948,625,316,
22,"HUNEDOARA",207,86687,,14,0,"Gradinita cu program normal nr.7, Aleea Pescarilor","MUNICIPIUL DEVA",1,86687,1,1,1591,886,832,54,869,14,1725,839,609,260,
22,"HUNEDOARA",207,86687,,15,0,"Policlinica Noua, B-dul 22 Decembrie","MUNICIPIUL DEVA",1,86687,1,1,1667,1198,834,364,1186,12,2500,1302,800,386,
22,"HUNEDOARA",207,86687,,16,0,"Sectia de Termoficare P.T. 6, Aleea Viitorului","MUNICIPIUL DEVA",1,86687,1,1,1646,907,812,95,897,10,1800,893,596,301,
22,"HUNEDOARA",207,86687,,17,0,"Scoala Generala nr.4, Gojdu -Local vechi","MUNICIPIUL DEVA",1,86687,1,1,1650,867,815,52,847,20,1650,783,549,298,
22,"HUNEDOARA",207,86687,,18,0,"Scoala Generala nr.4, Gojdu-Local nou, Aleea Viitorului","MUNICIPIUL DEVA",1,86687,1,1,1565,803,761,42,790,13,1675,872,527,263,
22,"HUNEDOARA",207,86687,,19,0,"S.C.""SALUBRITATEA"" S.A., Str.E.Gojdu nr.83","MUNICIPIUL DEVA",1,86687,1,1,1797,943,884,59,931,12,1800,857,650,281,
22,"HUNEDOARA",207,86687,,20,0,"Cantina S.C.CONDOR S.A., Str.Marasti","MUNICIPIUL DEVA",1,86687,1,1,1139,779,567,212,761,18,1225,446,472,289,
22,"HUNEDOARA",207,86687,,21,0,"FORICON S.A. ,B-dul Nicolae Balcescu, nou","MUNICIPIUL DEVA",1,86687,1,1,1875,922,833,89,906,16,1875,953,552,354,
22,"HUNEDOARA",207,86687,,22,0,"Liceul de Muzica si Arte Plastice ""Sigismund Toduta"",Str.Ciprian Porumbescu","MUNICIPIUL DEVA",1,86687,1,1,1495,846,792,54,828,18,1582,736,545,283,
22,"HUNEDOARA",207,86687,,23,0,"Grupul Scolar de Transport Auto ""Transilvania"",B-dul 22 Decembrie","MUNICIPIUL DEVA",1,86687,1,1,1837,952,886,66,921,31,2000,1048,602,319,
22,"HUNEDOARA",207,86687,,24,0,"Grupul Scolar de Transport Auto ""Transilvania"",B-dul 22 Decembrie","MUNICIPIUL DEVA",1,86687,1,1,1548,831,734,97,818,13,1677,846,537,281,
22,"HUNEDOARA",207,86687,,25,0,"Grupul Scolar de Transport Auto ""Transilvania"",B-dul 22 Decembrie","MUNICIPIUL DEVA",1,86687,1,1,1932,1015,881,134,990,25,2100,1085,561,429,
22,"HUNEDOARA",207,86687,,26,0,"Grupul Scolar Sportiv,Str.Carpati","MUNICIPIUL DEVA",1,86687,1,1,1403,899,681,218,885,14,1561,662,592,293,
22,"HUNEDOARA",207,86687,,27,0,"Scoala Generala nr.3,B-dul Dacia","MUNICIPIUL DEVA",1,86687,1,1,1546,808,740,68,791,17,1675,867,471,320,
22,"HUNEDOARA",207,86687,,28,0,"Scoala Generala nr.3,B-dul Dacia","MUNICIPIUL DEVA",1,86687,1,1,1498,921,666,255,899,22,1625,704,512,387,
22,"HUNEDOARA",207,86687,,29,0,"Casa Armatei,B-dul 22 Decembrie","MUNICIPIUL DEVA",1,86687,1,1,2022,1055,953,102,1025,30,2700,1645,664,361,
22,"HUNEDOARA",207,86687,,30,0,"Scoala Generala nr.6,Str.Bejan","MUNICIPIUL DEVA",1,86687,1,1,1727,836,706,130,815,21,1875,1039,351,464,
22,"HUNEDOARA",207,86687,,31,0,"Scoala Generala nr.6,Str.Bejan","MUNICIPIUL DEVA",1,86687,1,1,1858,927,836,91,904,23,1950,1023,416,488,
22,"HUNEDOARA",207,86687,,32,0,"Cresa, Aleea Teilor","MUNICIPIUL DEVA",1,86687,1,1,1485,719,658,61,705,14,1600,881,360,345,
22,"HUNEDOARA",207,86687,,33,0,"Gradinita, Aleea Teilor","MUNICIPIUL DEVA",1,86687,1,1,2156,977,887,90,957,20,2382,1405,536,421,
22,"HUNEDOARA",207,86687,,34,0,"Grupul Scolar de Constructii, Str.Titu Maiorescu","MUNICIPIUL DEVA",1,86687,1,1,1784,907,789,118,891,16,1911,1004,571,320,
22,"HUNEDOARA",207,86687,,35,0,"Grupul Scolar ""Grigore Moisil"", Str.Titu Maiorescu","MUNICIPIUL DEVA",1,86687,1,1,1641,937,810,127,914,23,1800,863,603,311,
22,"HUNEDOARA",207,86687,,36,0,"Scoala Generala nr.5 ""Andrei Muresanu"", Str.Scarisoara","MUNICIPIUL DEVA",1,86687,1,1,994,668,618,50,660,8,1400,732,371,289,
22,"HUNEDOARA",207,86687,,37,0,"Scoala Generala nr.5 ""Andrei Muresanu"" , Str.Scarisoara","MUNICIPIUL DEVA",1,86687,1,1,2462,1173,1105,68,1141,32,2600,1427,622,519,
22,"HUNEDOARA",207,86687,,38,0,"Cristur,Gradinita Cristur","MUNICIPIUL DEVA",1,86687,1,1,1102,697,626,71,676,21,1357,660,525,151,
22,"HUNEDOARA",207,86687,,39,0,"Santuhalm,Scoala Generala Sintuhalm","MUNICIPIUL DEVA",1,86687,1,1,478,535,250,285,521,14,800,265,279,242,
22,"HUNEDOARA",207,86687,,40,1,"U.M.01719","MUNICIPIUL DEVA",1,86687,1,1,0,378,0,378,361,17,430,52,189,172,
22,"HUNEDOARA",207,86687,,41,1,"Gara CFR,Sala de Protocol","MUNICIPIUL DEVA",1,86687,1,1,0,343,0,343,326,17,430,87,182,144,
22,"HUNEDOARA",207,87291,,42,0,"Casa de Cultura Brad,Str.Independentei","MUNICIPIUL BRAD",2,87291,1,1,1247,661,629,32,652,9,1150,489,417,235,
22,"HUNEDOARA",207,87291,,43,0,"Casa de Cultura Brad, Str.Independentei","MUNICIPIUL BRAD",2,87291,1,1,1443,775,725,50,766,9,1445,670,437,329,
22,"HUNEDOARA",207,87291,,44,0,"Scoala Generala nr.1, Str.Libertatii","MUNICIPIUL BRAD",2,87291,1,1,1463,807,762,45,786,21,1465,658,432,354,
22,"HUNEDOARA",207,87291,,45,0,"Scoala Generala nr.1, Str.Libertatii","MUNICIPIUL BRAD",2,87291,1,1,1627,865,815,50,830,35,1632,767,475,355,
22,"HUNEDOARA",207,87291,,46,0,"Scoala Generala nr.1, Str.Victoriei","MUNICIPIUL BRAD",2,87291,1,1,1640,902,850,52,891,11,1640,738,411,480,
22,"HUNEDOARA",207,87291,,47,0,"Scoala Generala nr.1, Str.Victoriei","MUNICIPIUL BRAD",2,87291,1,1,1395,763,739,24,754,9,1395,632,390,364,
22,"HUNEDOARA",207,87291,,48,0,"Liceul ""Avram Iancu"" Brad","MUNICIPIUL BRAD",2,87291,1,1,942,493,466,27,487,6,945,452,290,197,
22,"HUNEDOARA",207,87291,,49,0,"Liceul ""Avram Iancu"" Brad","MUNICIPIUL BRAD",2,87291,1,1,943,481,451,30,469,12,945,464,289,180,
22,"HUNEDOARA",207,87291,,50,0,"Scoala Generala nr.2, Str.Horia","MUNICIPIUL BRAD",2,87291,1,1,1131,593,561,32,588,5,1140,547,335,253,
22,"HUNEDOARA",207,87291,,51,0,"Scoala Generala nr.2, Str.Horia","MUNICIPIUL BRAD",2,87291,1,1,1196,603,566,37,577,26,1235,632,354,223,
22,"HUNEDOARA",207,87291,,52,0,"Valea Bradului,Scoala Primara Valea Bradului","MUNICIPIUL BRAD",2,87291,1,1,759,460,427,33,451,9,762,302,173,278,
22,"HUNEDOARA",207,87291,,53,0,"Taratel,Scoala Primara Taratel","MUNICIPIUL BRAD",2,87291,1,1,649,384,363,21,368,16,647,263,173,195,
22,"HUNEDOARA",207,87291,,54,0,"Mesteacan,Scoala Primara Mesteacan","MUNICIPIUL BRAD",2,87291,1,1,479,287,245,42,267,20,477,190,143,124,
22,"HUNEDOARA",207,87291,,55,0,"Ruda Brad,Caminul Cultural Ruda Brad","MUNICIPIUL BRAD",2,87291,1,1,190,121,95,26,105,16,197,76,38,67,
22,"HUNEDOARA",207,87291,,56,1,"U.M.01099","MUNICIPIUL BRAD",2,87291,1,1,0,89,0,89,79,10,101,12,39,40,
22,"HUNEDOARA",207,87291,,57,1,"Sanatorul TBC Brad","MUNICIPIUL BRAD",2,87291,1,1,0,114,0,114,108,6,175,61,54,54,
22,"HUNEDOARA",207,87291,,58,1,"Spitalul Municipal","MUNICIPIUL BRAD",2,87291,1,1,0,108,0,108,108,0,160,52,64,44,
22,"HUNEDOARA",207,86810,,59,0,"Scoala Generala nr.12, Str.Prutului nr.9","MUNICIPIUL HUNEDOARA",3,86810,1,1,1594,823,777,46,806,17,1760,937,375,431,
22,"HUNEDOARA",207,86810,,60,0,"Scoala Generala nr.10, Str.Intrarea Spicului nr.6","MUNICIPIUL HUNEDOARA",3,86810,1,1,1215,610,566,44,599,11,1340,730,348,251,
22,"HUNEDOARA",207,86810,,61,0,"Scoala Generala nr.10, Str.Intrarea Spicului nr.6","MUNICIPIUL HUNEDOARA",3,86810,1,1,1529,822,774,48,807,15,1680,858,424,383,
22,"HUNEDOARA",207,86810,,62,0,"Scoala Generala nr.10, Str.Intrarea Spicului nr.6","MUNICIPIUL HUNEDOARA",3,86810,1,1,1334,650,618,32,641,9,1470,820,365,276,
22,"HUNEDOARA",207,86810,,63,0,"Scoala Generala nr.9, Str.Trandafirilor nr.10","MUNICIPIUL HUNEDOARA",3,86810,1,1,1728,883,831,52,867,16,1900,1017,478,389,
22,"HUNEDOARA",207,86810,,64,0,"Scoala Generala nr.9, Str.Trandafirilor nr.10","MUNICIPIUL HUNEDOARA",3,86810,1,1,1545,773,741,32,760,13,1700,927,399,361,
22,"HUNEDOARA",207,86810,,65,0,"Asociatia de Caritate ""Casa Harului"", Str.Trandafirilor nr.18","MUNICIPIUL HUNEDOARA",3,86810,1,1,1376,772,727,45,752,20,1520,748,420,332,
22,"HUNEDOARA",207,86810,,66,0,"Gradinita cu orar normal,Micro VII PN 9,Str.Trandafirilor nr.20","MUNICIPIUL HUNEDOARA",3,86810,1,1,1342,755,714,41,750,5,1480,725,404,346,
22,"HUNEDOARA",207,86810,,67,0,"Cabinet Medical  Micro VII,Str.Viorele nr.1","MUNICIPIUL HUNEDOARA",3,86810,1,1,1624,951,859,92,936,15,1790,839,563,373,
22,"HUNEDOARA",207,86810,,68,0,"Grup Scolar Economic,Str.Al.Vlahuta nr.1 bis","MUNICIPIUL HUNEDOARA",3,86810,1,1,1681,976,867,109,951,25,1850,874,594,357,
22,"HUNEDOARA",207,86810,,69,0,"Grup Scolar Constructii (lic.Industrial nr.3),Aleea Turnatorului nr.1","MUNICIPIUL HUNEDOARA",3,86810,1,1,1551,908,840,68,888,20,1700,792,617,271,
22,"HUNEDOARA",207,86810,,70,0,"Casa Vinatorului,Str.Viorele nr.12","MUNICIPIUL HUNEDOARA",3,86810,1,1,1519,978,898,80,960,18,1670,692,692,268,
22,"HUNEDOARA",207,86810,,71,0,"Colegiul National de Informatica ""Traian Lalescu"",Str.Victoriei","MUNICIPIUL HUNEDOARA",3,86810,1,1,1299,698,670,28,677,21,1330,632,495,182,
22,"HUNEDOARA",207,86810,,72,0,"Colegiul National de Informatica ""Traian Lalescu"",Str.Victoriei","MUNICIPIUL HUNEDOARA",3,86810,1,1,988,633,536,97,626,7,1100,467,384,242,
22,"HUNEDOARA",207,86810,,73,0,"Scoala Generala nr.5,B-dul Decebal 11","MUNICIPIUL HUNEDOARA",3,86810,1,1,1323,949,700,249,927,22,1450,501,594,333,
22,"HUNEDOARA",207,86810,,74,0,"Scoala Generala nr.5,B-dul Decebal 11","MUNICIPIUL HUNEDOARA",3,86810,1,1,1184,579,541,38,565,14,1300,721,384,181,
22,"HUNEDOARA",207,86810,,75,0,"Scoala Generala nr.5,B-dul Decebal 11","MUNICIPIUL HUNEDOARA",3,86810,1,1,1173,669,641,28,654,15,1300,631,440,214,
22,"HUNEDOARA",207,86810,,76,0,"Scoala generala Hasdat","MUNICIPIUL HUNEDOARA",3,86810,1,1,343,183,167,16,179,4,375,192,144,35,
22,"HUNEDOARA",207,86810,,77,0,"Scoala Generala nr.6,Piata Florilor nr.1","MUNICIPIUL HUNEDOARA",3,86810,1,1,1671,933,903,30,917,16,1700,767,579,338,
22,"HUNEDOARA",207,86810,,78,0,"Scoala Generala nr.6,Piata Florilor nr.1","MUNICIPIUL HUNEDOARA",3,86810,1,1,1273,728,663,65,714,11,1400,672,427,287,
22,"HUNEDOARA",207,86810,,79,0,"Grupul Scolar Metarlugic(Lic.Industrial nr.1),Str.Victoriei nr.12","MUNICIPIUL HUNEDOARA",3,86810,1,1,1502,878,806,72,864,14,1660,782,568,296,
22,"HUNEDOARA",207,86810,,80,0,"Scoala Gen.nr.3, Str.Laminatorului 10","MUNICIPIUL HUNEDOARA",3,86810,1,1,1636,856,820,36,844,12,1800,944,557,287,
22,"HUNEDOARA",207,86810,,81,0,"Gradinita cu program normal nr.4 Micro I,Str.Laminatorului nr.8","MUNICIPIUL HUNEDOARA",3,86810,1,1,1731,1038,970,68,1025,13,1900,862,673,352,
22,"HUNEDOARA",207,86810,,82,0,"Scoala Gen.nr.1,B-dul Corvin nr.14","MUNICIPIUL HUNEDOARA",3,86810,1,1,1089,576,533,43,553,23,1300,724,349,204,
22,"HUNEDOARA",207,86810,,83,0,"Scoala Gen.nr.1, B-dul Corvin nr.14","MUNICIPIUL HUNEDOARA",3,86810,1,1,1474,796,747,49,787,9,1700,904,439,348,
22,"HUNEDOARA",207,86810,,84,0,"Scoala Gen.nr.3, Str.Laminatorului nr.10","MUNICIPIUL HUNEDOARA",3,86810,1,1,1735,871,839,32,859,12,1915,1044,567,292,
22,"HUNEDOARA",207,86810,,85,0,"Scoala Gen.nr.7, Str.Moldovei nr.2","MUNICIPIUL HUNEDOARA",3,86810,1,1,1264,731,689,42,720,11,1390,659,457,263,
22,"HUNEDOARA",207,86810,,86,0,"Scoala Gen.nr.7, Str.Moldovei nr.2","MUNICIPIUL HUNEDOARA",3,86810,1,1,1471,845,814,31,826,19,1620,775,523,303,
22,"HUNEDOARA",207,86810,,87,0,"Clubul Constructorul, Str.Moldovei nr.6","MUNICIPIUL HUNEDOARA",3,86810,1,1,1787,851,788,63,836,15,1860,1009,504,332,
22,"HUNEDOARA",207,86810,,88,0,"Scoala Gen.nr.8, Str.Cerbului nr.2","MUNICIPIUL HUNEDOARA",3,86810,1,1,1275,729,702,27,722,7,1410,681,456,266,
22,"HUNEDOARA",207,86810,,89,0,"Scoala Gen.nr.8, Str.Cerbului nr.2","MUNICIPIUL HUNEDOARA",3,86810,1,1,1340,736,694,42,725,11,1480,744,425,300,
22,"HUNEDOARA",207,86810,,90,0,"Gradinita S.C.SIDERURGICA S.A., Str.Cerbuui nr.3","MUNICIPIUL HUNEDOARA",3,86810,1,1,1295,651,615,36,641,10,1420,769,373,268,
22,"HUNEDOARA",207,86810,,91,0,"Gradinita cu orar normal Micro III PN2, Str.Cerbului nr.3 bis","MUNICIPIUL HUNEDOARA",3,86810,1,1,1429,793,742,51,784,9,1570,777,425,359,
22,"HUNEDOARA",207,86810,,92,0,"Scoala Gen.nr.2, Str.Luncii nr.1","MUNICIPIUL HUNEDOARA",3,86810,1,1,1469,839,806,33,830,9,1617,778,497,333,
22,"HUNEDOARA",207,86810,,93,0,"Scoala Gen.nr.2, Str.Luncii nr.1","MUNICIPIUL HUNEDOARA",3,86810,1,1,1448,833,796,37,816,17,1590,757,526,290,
22,"HUNEDOARA",207,86810,,94,0,"Scoala Gen.nr.2, Str.Luncii nr.1","MUNICIPIUL HUNEDOARA",3,86810,1,1,1366,735,694,41,717,18,1510,775,408,309,
22,"HUNEDOARA",207,86810,,95,0,"Gradinita ICSH Micro IV, Str.Cimpului nr.3","MUNICIPIUL HUNEDOARA",3,86810,1,1,640,365,342,23,358,7,710,345,224,134,
22,"HUNEDOARA",207,86810,,96,0,"Cinematograf ""Flacara"", B-dul Dacia nr.14","MUNICIPIUL HUNEDOARA",3,86810,1,1,1680,898,843,55,887,11,1850,952,493,394,
22,"HUNEDOARA",207,86810,,97,0,"Asociatia de Locatari nr.49, Str.Independentei nr.6,Bl.32","MUNICIPIUL HUNEDOARA",3,86810,1,1,2197,1146,1081,65,1115,31,2520,1374,563,552,
22,"HUNEDOARA",207,86810,,98,0,"Scoala Gen.nr.11, Str.Rindunicii nr.3","MUNICIPIUL HUNEDOARA",3,86810,1,1,1565,806,758,48,798,8,1730,924,412,386,
22,"HUNEDOARA",207,86810,,99,0,"Scoala Gen.nr.11, Str.Rindunicii nr.3","MUNICIPIUL HUNEDOARA",3,86810,1,1,1886,987,942,45,964,23,2090,1103,542,422,
22,"HUNEDOARA",207,86810,,100,0,"Scoala Gen.nr.11, Str.Rindunicii nr.3","MUNICIPIUL HUNEDOARA",3,86810,1,1,1549,789,763,26,778,11,1710,921,409,369,
22,"HUNEDOARA",207,86810,,101,0,"S.C.CORVIN SA(fost F-ca incaltaminte),B-dul Traian nr.11","MUNICIPIUL HUNEDOARA",3,86810,1,1,1361,750,705,45,742,8,1420,670,456,286,
22,"HUNEDOARA",207,86810,,102,0,"Caminul Cultural Buituri, Str.Latureni nr.31","MUNICIPIUL HUNEDOARA",3,86810,1,1,487,303,281,22,296,7,541,238,211,85,
22,"HUNEDOARA",207,86810,,103,0,"S.C.ICSH SA Santierul nr.1, Str.Carpati nr.57","MUNICIPIUL HUNEDOARA",3,86810,1,1,581,322,291,31,313,9,640,318,204,109,
22,"HUNEDOARA",207,86810,,104,0,"Sectia ACT a RAIL, Piata Libertatii nr.27","MUNICIPIUL HUNEDOARA",3,86810,1,1,1759,947,851,96,925,22,1950,1003,556,369,
22,"HUNEDOARA",207,86810,,105,0,"Racastie,Scoala Gen.Racastie","MUNICIPIUL HUNEDOARA",3,86810,1,1,476,282,240,42,269,13,530,248,217,52,
22,"HUNEDOARA",207,86810,,106,0,"Zlasti,Scoala Gen.Zlasti","MUNICIPIUL HUNEDOARA",3,86810,1,1,381,260,220,40,255,5,420,160,143,112,
22,"HUNEDOARA",207,86810,,107,0,"Bos,Scoala Gen.Bos","MUNICIPIUL HUNEDOARA",3,86810,1,1,439,361,278,83,358,3,490,129,210,148,
22,"HUNEDOARA",207,86810,,108,0,"Pestisu Mare,Scoala Gen.Pestisul Mare (sat Pestisul Mare)","MUNICIPIUL HUNEDOARA",3,86810,1,1,1020,560,500,60,549,11,1130,570,342,207,
22,"HUNEDOARA",207,86810,,109,1,"U.M.01933","MUNICIPIUL HUNEDOARA",3,86810,1,1,0,149,0,149,140,9,170,21,84,56,
22,"HUNEDOARA",207,86810,,110,1,"SPITALUL MUNICIPAL ""Dr.Al.Simionescu"", Str.Victoriei nr.14","MUNICIPIUL HUNEDOARA",3,86810,1,1,0,426,0,426,420,6,498,72,268,152,
22,"HUNEDOARA",207,87638,,111,0,"Casa de Cultura, Piata Victoriei nr.20","MUNICIPIUL ORASTIE",4,87638,1,1,1831,950,868,82,942,8,2000,1050,596,346,
22,"HUNEDOARA",207,87638,,112,0,"Cresa Spitalului , Str.Pricazului nr.46","MUNICIPIUL ORASTIE",4,87638,1,1,1955,852,805,47,834,18,2150,1298,441,393,
22,"HUNEDOARA",207,87638,,113,0,"Gradinita nr.4, Str.Pricazului nr.48","MUNICIPIUL ORASTIE",4,87638,1,1,1974,907,764,143,884,19,2125,1218,469,415,
22,"HUNEDOARA",207,87638,,114,0,"Scoala Gen.nr.2, Str.Eroilor nr.21 B","MUNICIPIUL ORASTIE",4,87638,1,1,1886,916,846,70,898,18,2100,1184,506,392,
22,"HUNEDOARA",207,87638,,115,0,"Local S.A.M., Str.A.Saguna nr.16","MUNICIPIUL ORASTIE",4,87638,1,1,1793,796,733,63,787,9,1950,1154,386,401,
22,"HUNEDOARA",207,87638,,116,0,"Scoala Gen.""Dr.Aurel Vlad"", Str.Luminii nr.10","MUNICIPIUL ORASTIE",4,87638,1,1,1308,604,552,52,593,11,1400,796,324,269,
22,"HUNEDOARA",207,87638,,117,0,"Scoala Primara 1-4 Gara, Str.Tirgului nr.2","MUNICIPIUL ORASTIE",4,87638,1,1,1552,890,777,113,874,16,1675,785,488,386,
22,"HUNEDOARA",207,87638,,118,0,"Local O.G.A. Str.Progresului nr.66","MUNICIPIUL ORASTIE",4,87638,1,1,1246,636,597,39,626,10,1350,714,401,225,
22,"HUNEDOARA",207,87638,,119,0,"Grupul Scolar Chimie, Str.O.Goga nr.29","MUNICIPIUL ORASTIE",4,87638,1,1,1919,871,805,66,849,22,2050,1179,454,395,
22,"HUNEDOARA",207,87638,,120,0,"Liceul ""Aurel Vlaicu"", Str.Ghe.Lazar nr.8","MUNICIPIUL ORASTIE",4,87638,1,1,1659,830,722,108,796,34,1850,1020,523,273,
22,"HUNEDOARA",207,87638,,121,0,"Gradinita ""Favior"", Str.Gh.Baritiu nr.20","MUNICIPIUL ORASTIE",4,87638,1,1,1730,911,849,62,888,23,1900,989,580,308,
22,"HUNEDOARA",207,87638,,122,1,"U.M.0812, Str.Pricazului nr.5","MUNICIPIUL ORASTIE",4,87638,1,1,0,453,0,453,435,18,600,147,205,230,
22,"HUNEDOARA",207,87638,,123,1,"Spitalul Municipal, Str.Pricazului nr.16","MUNICIPIUL ORASTIE",4,87638,1,1,0,126,0,126,119,7,200,74,77,42,
22,"HUNEDOARA",207,86990,,124,0,"Casa de Cultura,Str.1 Decembrie 1918","MUNICIPIUL PETROSANI",5,86990,1,1,1937,1123,1079,44,1114,9,2600,1477,823,291,
22,"HUNEDOARA",207,86990,,125,0,"Scoala Gen.nr.1 S.N., Str.St.O.Iosif","MUNICIPIUL PETROSANI",5,86990,1,1,1541,961,925,36,944,17,1660,699,651,293,
22,"HUNEDOARA",207,86990,,126,0,"Scoala Gen.nr.1 S.V., Str.1 Decembrie 1918","MUNICIPIUL PETROSANI",5,86990,1,1,1819,1127,1040,87,1108,19,2000,873,816,292,
22,"HUNEDOARA",207,86990,,127,0,"Amfiteatrul Universitatii, Str.Universitatii","MUNICIPIUL PETROSANI",5,86990,1,1,1795,1300,1013,287,1287,13,2400,1100,894,393,
22,"HUNEDOARA",207,86990,,128,0,"Grupul Scolar Sportiv, Str.1 Decembrie 1918","MUNICIPIUL PETROSANI",5,86990,1,1,1295,820,771,49,808,12,1400,580,585,223,
22,"HUNEDOARA",207,86990,,129,0,"Sala Sporturilor, Str.General Vasile Milea","MUNICIPIUL PETROSANI",5,86990,1,1,1251,820,760,60,806,14,1350,530,598,208,
22,"HUNEDOARA",207,86990,,130,0,"Scoala Gen.nr.4, Str.General Vasile Milea","MUNICIPIUL PETROSANI",5,86990,1,1,1788,1048,994,54,1028,20,1900,852,633,395,
22,"HUNEDOARA",207,86990,,131,0,"Liceul Teoretic, Str.1 Decembrie 1918","MUNICIPIUL PETROSANI",5,86990,1,1,1896,1146,1085,61,1125,21,2050,904,744,381,
22,"HUNEDOARA",207,86990,,132,0,"Gradinita nr.3, Str.9 Mai","MUNICIPIUL PETROSANI",5,86990,1,1,1152,730,708,22,708,22,1250,520,562,146,
22,"HUNEDOARA",207,86990,,133,0,"Liceul de Informatica, Str.Slatinioara","MUNICIPIUL PETROSANI",5,86990,1,1,1665,996,948,48,973,23,1800,804,689,284,
22,"HUNEDOARA",207,86990,,134,0,"Liceul Economic, Str.Pacii","MUNICIPIUL PETROSANI",5,86990,1,1,1756,1057,1016,41,1045,12,1900,843,738,307,
22,"HUNEDOARA",207,86990,,135,0,"Scoala Gen.nr.5, Str.Unirii","MUNICIPIUL PETROSANI",5,86990,1,1,1650,1018,956,62,1007,11,1750,732,689,318,
22,"HUNEDOARA",207,86990,,136,0,"Scoala Gen.nr.5, Str.Unirii","MUNICIPIUL PETROSANI",5,86990,1,1,1772,1072,1035,37,1062,10,1900,828,730,332,
22,"HUNEDOARA",207,86990,,137,0,"Scoala Gen.nr.6, Str.Independentei","MUNICIPIUL PETROSANI",5,86990,1,1,2091,1292,1246,46,1277,15,2200,908,911,366,
22,"HUNEDOARA",207,86990,,138,0,"Scoala Gen.nr.6, Str.Independentei","MUNICIPIUL PETROSANI",5,86990,1,1,1746,1022,904,118,1010,12,1930,908,638,372,
22,"HUNEDOARA",207,86990,,139,0,"Gradinita Aeroport(cu program prelungit), Str.Aviatorilor","MUNICIPIUL PETROSANI",5,86990,1,1,946,610,558,52,608,2,1010,400,388,220,
22,"HUNEDOARA",207,86990,,140,0,"Dispensarul Medical Aeroport, Str.Aviatorilor","MUNICIPIUL PETROSANI",5,86990,1,1,1645,1103,1016,87,1089,14,1750,647,686,403,
22,"HUNEDOARA",207,86990,,141,0,"Oficiul Postal Aeroport, Str.Aviatorilor","MUNICIPIUL PETROSANI",5,86990,1,1,1346,861,798,63,854,7,1450,589,534,320,
22,"HUNEDOARA",207,86990,,142,0,"Scoala Gen.nr.7, Str.Venus","MUNICIPIUL PETROSANI",5,86990,1,1,2196,1342,1227,115,1330,12,2300,958,840,490,
22,"HUNEDOARA",207,86990,,143,0,"Scoala Gen.nr.7, Str.Venus","MUNICIPIUL PETROSANI",5,86990,1,1,1934,1137,1032,105,1119,18,2100,963,692,427,
22,"HUNEDOARA",207,86990,,144,0,"Scoala Generala Surduc, Str.1 Decembrie 1918","MUNICIPIUL PETROSANI",5,86990,1,1,620,402,367,35,397,5,700,298,196,201,
22,"HUNEDOARA",207,86990,,145,0,"SC SERVMIN SA, Str.Grivita Rosie","MUNICIPIUL PETROSANI",5,86990,1,1,2307,1450,1377,73,1437,13,2400,950,968,469,
22,"HUNEDOARA",207,86990,,146,0,"Scoala Gen.nr.2, Str.Gh.Baritiu","MUNICIPIUL PETROSANI",5,86990,1,1,1184,731,673,58,719,12,1306,575,454,265,
22,"HUNEDOARA",207,86990,,147,0,"SC GOSPODARIA PREST.COM SA, Str.M.Eminescu","MUNICIPIUL PETROSANI",5,86990,1,1,1191,679,657,22,661,18,1300,621,430,231,
22,"HUNEDOARA",207,86990,,148,0,"Dalja Mare,Scoala Generala, Loc.Dilja Mare","MUNICIPIUL PETROSANI",5,86990,1,1,218,153,133,20,145,8,240,87,84,61,
22,"HUNEDOARA",207,86990,,149,1,"Detasamentul de jandarmi","MUNICIPIUL PETROSANI",5,86990,1,1,0,158,0,158,152,6,300,142,84,68,
22,"HUNEDOARA",207,86990,,150,1,"Spitalul Municipal","MUNICIPIUL PETROSANI",5,86990,1,1,0,342,0,342,337,5,700,358,256,81,
22,"HUNEDOARA",207,86990,,151,1,"Gara CFR","MUNICIPIUL PETROSANI",5,86990,1,1,0,265,0,265,263,2,499,234,129,134,
22,"HUNEDOARA",207,87219,,152,0,"Clubul M.T.I.Aninoasa, Str.Libertatii","ORAS ANINOASA",6,87219,2,1,2518,1630,1502,128,1614,16,2700,1070,986,628,
22,"HUNEDOARA",207,87219,,153,0,"Iscroni,Caminul Cultural","ORAS ANINOASA",6,87219,2,1,1498,946,855,91,936,10,1600,654,500,436,
22,"HUNEDOARA",207,87424,,154,0,"Sediul Primariei(sala de sedinta), Str.Garii nr.1","ORAS CALAN",7,87424,2,1,1124,590,540,50,574,16,1200,610,344,230,
22,"HUNEDOARA",207,87424,,155,0,"Scoala Generala, Str.Florilor","ORAS CALAN",7,87424,2,1,1325,645,612,33,638,7,1325,680,318,320,
22,"HUNEDOARA",207,87424,,156,0,"Scoala Generala, Str.Traian A1","ORAS CALAN",7,87424,2,1,1511,722,662,60,705,17,1425,703,348,357,
22,"HUNEDOARA",207,87424,,157,0,"Liceul Industrial, Str.O.Densusianu","ORAS CALAN",7,87424,2,1,1866,837,747,90,830,7,1950,1113,412,418,
22,"HUNEDOARA",207,87424,,158,0,"Policlinica O.N.","ORAS CALAN",7,87424,2,1,1284,627,592,35,621,6,1375,748,305,316,
22,"HUNEDOARA",207,87424,,159,0,"Sediul Cons.Loc.O.N., Str.Independentei nr.14","ORAS CALAN",7,87424,2,1,1626,816,775,41,792,24,1750,934,436,356,
22,"HUNEDOARA",207,87424,,160,0,"Nadastia de Jos,Caminul Cultural","ORAS CALAN",7,87424,2,1,477,281,221,60,274,7,525,244,149,125,
22,"HUNEDOARA",207,87424,,161,0,"Strei,Caminul Cultural","ORAS CALAN",7,87424,2,1,330,209,170,39,205,4,330,121,118,87,
22,"HUNEDOARA",207,87424,,162,0,"Batiz,Scoala Generala I-IV","ORAS CALAN",7,87424,2,1,438,252,222,30,249,3,475,223,145,104,
22,"HUNEDOARA",207,87424,,163,0,"Calanu Mic,Caminul Cultural","ORAS CALAN",7,87424,2,1,286,161,129,32,161,0,300,139,77,84,
22,"HUNEDOARA",207,87424,,164,0,"Santamaria de Piatra,Scoala Generala I-IV","ORAS CALAN",7,87424,2,1,137,113,96,17,109,4,150,37,57,52,
22,"HUNEDOARA",207,87424,,165,0,"Strei Sacel,Caminul Cultural","ORAS CALAN",7,87424,2,1,160,100,85,15,94,6,175,75,43,51,
22,"HUNEDOARA",207,87424,,166,0,"Strei Sangiorgiu,Caminul Cultural","ORAS CALAN",7,87424,2,1,629,376,350,26,373,3,675,299,261,112,
22,"HUNEDOARA",207,87424,,167,0,"Valea Sangiorgiului,Caminul Cultural","ORAS CALAN",7,87424,2,1,265,195,160,35,195,0,275,80,51,144,
22,"HUNEDOARA",207,87424,,168,0,"Grid,Caminul Cultural","ORAS CALAN",7,87424,2,1,255,197,168,29,196,1,275,78,83,113,
22,"HUNEDOARA",207,87576,,169,0,"Liceul Teoretic I.C.Bratianu, Str.Muntii Retezat nr.3","ORAS HATEG",8,87576,2,1,2185,1290,1197,93,1270,20,2400,1110,819,451,
22,"HUNEDOARA",207,87576,,170,0,"Sediul Primariei, Str.Libertatii 3","ORAS HATEG",8,87576,2,1,2088,1107,1054,53,1088,19,2300,1193,650,438,
22,"HUNEDOARA",207,87576,,171,0,"Scoala Gen.nr.1, Piata Unirii nr.3","ORAS HATEG",8,87576,2,1,2132,1165,1070,95,1144,21,2346,1181,679,465,
22,"HUNEDOARA",207,87576,,172,0,"Scoala Gen.nr.2, Str.Independentei nr.2","ORAS HATEG",8,87576,2,1,2116,1116,1024,92,1094,20,2716,1602,593,501,
22,"HUNEDOARA",207,87576,,173,0,"Silvasu de Jos,Scoala Primara","ORAS HATEG",8,87576,2,1,670,440,361,79,434,6,750,310,217,217,
22,"HUNEDOARA",207,87576,,174,1,"U.M.01420","ORAS HATEG",8,87576,2,1,0,68,0,68,67,1,101,33,36,31,
22,"HUNEDOARA",207,87576,,175,1,"U.M.02332","ORAS HATEG",8,87576,2,1,0,82,0,82,81,1,150,68,19,62,
22,"HUNEDOARA",207,87059,,176,0,"Clubul Sindicatului E.M.Lupeni","ORAS LUPENI",9,87059,2,1,1790,1133,1045,88,1111,22,2000,867,780,331,
22,"HUNEDOARA",207,87059,,177,0,"Casa Pensionarilor Lupeni,Str.T.Vladimirescu nr.1","ORAS LUPENI",9,87059,2,1,1970,1145,1064,81,1137,8,2200,1055,824,313,
22,"HUNEDOARA",207,87059,,178,0,"Scoala Gen.nr.1, Str.T.Vladimirescu nr.1","ORAS LUPENI",9,87059,2,1,2041,1199,1064,135,1191,8,2200,1001,854,337,
22,"HUNEDOARA",207,87059,,179,0,"Bloc nr.2 Lupeni, Aleea Liliacului 2","ORAS LUPENI",9,87059,2,1,1589,1382,973,409,1365,17,1800,418,977,388,
22,"HUNEDOARA",207,87059,,180,0,"Scoala gen.nr.3, Calea Braii nr.8","ORAS LUPENI",9,87059,2,1,1847,1210,1100,110,1203,7,2000,790,932,271,
22,"HUNEDOARA",207,87059,,181,0,"Cinematograful ""Cultural"", Str.T.Vladimirescu nr.82","ORAS LUPENI",9,87059,2,1,1675,1109,1035,74,1087,22,1900,791,816,271,
22,"HUNEDOARA",207,87059,,182,0,"S.C.TESMA SA, B-dul Paci nr.2 bis","ORAS LUPENI",9,87059,2,1,2080,1441,1281,160,1421,20,2194,753,1057,364,
22,"HUNEDOARA",207,87059,,183,0,"Gradinita nr.6, Str.Tineretului","ORAS LUPENI",9,87059,2,1,2100,1361,1193,168,1348,13,2293,932,964,384,
22,"HUNEDOARA",207,87059,,184,0,"Liceul Teoretic, Str.Viitorului nr.2","ORAS LUPENI",9,87059,2,1,1974,1193,1082,111,1171,22,2200,1007,869,302,
22,"HUNEDOARA",207,87059,,185,0,"Scoala Gen.nr.2, Str.Trandafirilor","ORAS LUPENI",9,87059,2,1,2634,1721,1583,138,1709,12,2800,1079,1243,466,
22,"HUNEDOARA",207,87059,,186,0,"Scoala Gen.nr.5, Str.Barbateni","ORAS LUPENI",9,87059,2,1,2049,1269,1157,112,1262,7,2200,931,897,365,
22,"HUNEDOARA",207,87059,,187,0,"Gara Barbateni, Str.Barbateni","ORAS LUPENI",9,87059,2,1,2036,1249,1133,116,1238,11,1600,351,770,468,
22,"HUNEDOARA",207,87077,,188,0,"Scoala gen.nr.1","ORAS PETRILA",10,87077,2,1,1578,1063,993,70,1048,15,1734,671,802,246,
22,"HUNEDOARA",207,87077,,189,0,"Casa Pensionarilor","ORAS PETRILA",10,87077,2,1,1510,952,928,24,949,2,1660,708,636,313,
22,"HUNEDOARA",207,87077,,190,0,"Casa Pensionarilor","ORAS PETRILA",10,87077,2,1,1179,737,696,41,728,9,1295,558,491,237,
22,"HUNEDOARA",207,87077,,191,0,"Scoala Gen.nr.1","ORAS PETRILA",10,87077,2,1,1440,961,891,70,956,5,1580,619,642,314,
22,"HUNEDOARA",207,87077,,192,0,"Clubul Copiilor","ORAS PETRILA",10,87077,2,1,1406,869,813,56,856,13,1545,676,633,223,
22,"HUNEDOARA",207,87077,,193,0,"Scoala Gen.nr.6","ORAS PETRILA",10,87077,2,1,1286,828,793,35,822,6,1410,582,593,229,
22,"HUNEDOARA",207,87077,,194,0,"Scoala Gen.nr.6","ORAS PETRILA",10,87077,2,1,1114,663,638,25,659,4,1220,557,455,204,
22,"HUNEDOARA",207,87077,,195,0,"Scoala Gen.nr.5","ORAS PETRILA",10,87077,2,1,1555,950,920,30,947,3,1705,755,649,298,
22,"HUNEDOARA",207,87077,,196,0,"Scoala Gen.nr.5","ORAS PETRILA",10,87077,2,1,1352,850,794,56,846,4,1845,995,572,274,
22,"HUNEDOARA",207,87077,,197,0,"Gradinita cuplata cu Cresa","ORAS PETRILA",10,87077,2,1,1407,764,719,45,748,16,1550,786,518,230,
22,"HUNEDOARA",207,87077,,198,0,"Liceul Industrial","ORAS PETRILA",10,87077,2,1,950,636,611,25,628,8,1045,409,442,186,
22,"HUNEDOARA",207,87077,,199,0,"Clubul Lonea","ORAS PETRILA",10,87077,2,1,936,645,560,85,633,12,1025,380,428,205,
22,"HUNEDOARA",207,87077,,200,0,"Scoala Gen.nr.2","ORAS PETRILA",10,87077,2,1,1758,1126,1068,58,1111,15,1980,854,800,311,
22,"HUNEDOARA",207,87077,,201,0,"Campa,Scoala Gen.nr.3","ORAS PETRILA",10,87077,2,1,1481,1043,979,64,1021,22,1630,587,754,267,
22,"HUNEDOARA",207,87077,,202,0,"Ocolul Silvic","ORAS PETRILA",10,87077,2,1,1247,957,850,107,949,8,1335,378,673,276,
22,"HUNEDOARA",207,87077,,203,0,"Jiet,Scoala Gen.nr.4","ORAS PETRILA",10,87077,2,1,583,438,386,52,427,11,642,204,270,157,
22,"HUNEDOARA",207,87665,,204,0,"Scoala Gen.nr.2, Str.A.Iancu nr.17","ORAS SIMERIA",11,87665,2,1,2094,1178,1036,142,1159,19,2250,1072,596,563,
22,"HUNEDOARA",207,87665,,205,0,"Gradinita nr.2, Str.1 Decembrie","ORAS SIMERIA",11,87665,2,1,2238,1235,1158,77,1216,19,2427,1192,644,572,
22,"HUNEDOARA",207,87665,,206,0,"Gradinita Waldorf, Str.Cuza Voda nr.2","ORAS SIMERIA",11,87665,2,1,1585,873,791,82,854,19,1725,852,456,398,
22,"HUNEDOARA",207,87665,,207,0,"Ocolul Silvic, Str.Biscaria","ORAS SIMERIA",11,87665,2,1,1183,583,526,57,574,9,1319,736,284,290,
22,"HUNEDOARA",207,87665,,208,0,"Scoala Gen.nr.1, Str.Decebal nr.20","ORAS SIMERIA",11,87665,2,1,1547,857,807,50,836,21,1550,693,506,330,
22,"HUNEDOARA",207,87665,,209,0,"Grupul Scolar Industrial, Soseaua Nationala","ORAS SIMERIA",11,87665,2,1,1468,825,703,122,812,13,1627,802,410,402,
22,"HUNEDOARA",207,87665,,210,0,"Gara CFR Simeria(sala de asteptare cl.I), Str.Victoriei","ORAS SIMERIA",11,87665,2,1,885,792,460,332,777,15,1300,508,368,409,
22,"HUNEDOARA",207,87665,,211,0,"Santandrei,Scoala Generala","ORAS SIMERIA",11,87665,2,1,809,509,420,89,501,8,877,368,279,222,
22,"HUNEDOARA",207,87139,,212,0,"Sediul SC GOSCOMLOC SA, Str.Serminos nr.22 STR.STERMINOS","ORAS URICANI",12,87139,2,1,1895,1067,971,96,1054,13,2100,1033,576,478,
22,"HUNEDOARA",207,87139,,213,0,"Scoala Gen.nr.2","ORAS URICANI",12,87139,2,1,1817,1119,985,134,1111,8,2000,881,630,481,
22,"HUNEDOARA",207,87139,,214,0,"Scoala Gen.nr.1","ORAS URICANI",12,87139,2,1,2197,1192,1094,98,1164,28,2400,1208,667,497,
22,"HUNEDOARA",207,87139,,215,0,"Casa de Cultura","ORAS URICANI",12,87139,2,1,1817,1048,941,107,1021,27,2000,952,638,383,
22,"HUNEDOARA",207,87139,,216,0,"Campu lui Neag.Scoala Generala","ORAS URICANI",12,87139,2,1,418,331,227,104,323,8,484,153,166,157,
22,"HUNEDOARA",207,87175,,217,0,"Casa Casatoriilor, Str.Romanilor","ORAS VULCAN",13,87175,2,1,1257,844,757,87,832,12,1400,556,582,250,
22,"HUNEDOARA",207,87175,,218,0,"Gradinita nr.6, Str.Romanilor","ORAS VULCAN",13,87175,2,1,1629,1018,949,69,1013,5,1775,757,661,352,
22,"HUNEDOARA",207,87175,,219,0,"Scoala Gen.nr.4, Str.N.Titulescu","ORAS VULCAN",13,87175,2,1,1731,1123,1047,76,1119,4,1850,727,833,286,
22,"HUNEDOARA",207,87175,,220,0,"Scoala Gen.nr.4, Str.N.Titulescu","ORAS VULCAN",13,87175,2,1,668,486,390,96,480,6,700,214,356,124,
22,"HUNEDOARA",207,87175,,221,0,"Clubul Muncitoresc, Str.Jiului","ORAS VULCAN",13,87175,2,1,1432,906,861,45,905,1,1550,644,686,219,
22,"HUNEDOARA",207,87175,,222,0,"Grupul Scolar ""Mihai Viteazul"", Str.N.Titulescu","ORAS VULCAN",13,87175,2,1,1171,665,637,28,660,5,1275,610,441,219,
22,"HUNEDOARA",207,87175,,223,0,"Grupul Scolar ""Mihai Viteazul"", Str.N.Titulescu","ORAS VULCAN",13,87175,2,1,999,655,608,47,650,5,1100,445,467,183,
22,"HUNEDOARA",207,87175,,224,0,"Scoala Gen.nr.5, Str.N.Titulescu","ORAS VULCAN",13,87175,2,1,1358,990,854,136,979,11,1550,560,680,299,
22,"HUNEDOARA",207,87175,,225,0,"Scoala Gen.nr.5, Str.N.Titulescu","ORAS VULCAN",13,87175,2,1,1759,1079,1005,74,1063,16,1900,821,740,323,
22,"HUNEDOARA",207,87175,,226,0,"Stadionul EM Vulcan, Str.Coroiesti","ORAS VULCAN",13,87175,2,1,1449,828,776,52,820,8,1550,722,584,236,
22,"HUNEDOARA",207,87175,,227,0,"Gradinita nr.1, Str.Traian","ORAS VULCAN",13,87175,2,1,1870,981,917,64,972,9,2050,1069,665,307,
22,"HUNEDOARA",207,87175,,228,0,"Scoala gen.nr.6, Str.Traian","ORAS VULCAN",13,87175,2,1,2247,1368,1271,97,1357,11,2425,1057,925,432,
22,"HUNEDOARA",207,87175,,229,0,"Scoala Gen.nr.6, Str.Traian","ORAS VULCAN",13,87175,2,1,1687,1005,866,139,997,8,1825,820,643,354,
22,"HUNEDOARA",207,87175,,230,0,"Scoala Gen.nr.1, Str.1 Mai","ORAS VULCAN",13,87175,2,1,1257,737,693,44,732,5,1350,613,489,243,
22,"HUNEDOARA",207,87175,,231,0,"Scoala Gen.nr.1, Str.1 Mai","ORAS VULCAN",13,87175,2,1,919,629,558,71,621,8,1025,396,416,205,
22,"HUNEDOARA",207,87175,,232,0,"Casa Elevului, Str.Decebal","ORAS VULCAN",13,87175,2,1,1037,638,579,59,630,8,1125,487,418,212,
22,"HUNEDOARA",207,87175,,233,0,"Scoala Gen.nr.2, Str.Crividia","ORAS VULCAN",13,87175,2,1,923,530,497,33,523,7,1025,495,301,222,
22,"HUNEDOARA",207,87175,,234,0,"Scoala Gen.nr.3, Cartier Sohodol","ORAS VULCAN",13,87175,2,1,1519,977,904,73,954,23,1650,673,559,395,
22,"HUNEDOARA",207,87745,,235,0,"LOCALUL FOSTEI PRIMARII, STR.PLOPILOR NR.14","BAIA DE CRIS",15,87745,0,3,948,590,509,81,562,28,1050,460,324,238,
22,"HUNEDOARA",207,87745,,236,0,"Lunca,CAMINUL CULTURAL","BAIA DE CRIS",15,87745,0,3,478,243,219,24,230,13,525,282,84,146,
22,"HUNEDOARA",207,87745,,237,0,"Risculita,CAMINUL CULTURAL","BAIA DE CRIS",15,87745,0,3,541,291,264,27,281,10,601,310,162,119,
22,"HUNEDOARA",207,87745,,238,0,"Tebea,CAMINUL CULTURAL","BAIA DE CRIS",15,87745,0,3,642,447,386,61,439,8,697,250,279,160,
22,"HUNEDOARA",207,87843,,239,0,"SEDIUL PRIMARIEI","BALSA",17,87843,0,3,349,331,297,34,327,4,400,69,222,105,
22,"HUNEDOARA",207,87843,,240,0,"Almasu Mic de Munte,SCOALA PRIMARA","BALSA",17,87843,0,3,78,68,50,18,64,4,100,32,23,41,
22,"HUNEDOARA",207,87843,,241,0,"Ardeu,SCOALA PRIMARA","BALSA",17,87843,0,3,61,59,38,21,57,2,75,16,33,24,
22,"HUNEDOARA",207,87843,,242,0,"Mada,SCOALA PRIMARA","BALSA",17,87843,0,3,160,98,75,23,94,4,175,77,50,44,
22,"HUNEDOARA",207,87843,,243,0,"Poiana,SCOALA PRIMARA","BALSA",17,87843,0,3,274,164,131,33,159,5,300,136,77,82,
22,"HUNEDOARA",207,87843,,244,0,"Valisoara,SCOALA PRIMARA","BALSA",17,87843,0,3,82,57,45,12,55,2,100,43,27,28,
22,"HUNEDOARA",207,87843,,245,0,"Voia,SCOALA PRIMARA","BALSA",17,87843,0,3,127,143,114,29,141,2,150,7,93,48,
22,"HUNEDOARA",207,87996,,246,0,"PARTERUL BLOCULUI 12","BARU",19,87996,0,3,1534,1019,858,161,1007,12,1700,681,431,576,
22,"HUNEDOARA",207,87996,,247,0,"Livadia,CAMINUL CULTURAL","BARU",19,87996,0,3,752,482,400,82,476,6,800,318,236,240,
22,"HUNEDOARA",207,88047,,248,0,"CAMINUL CULTURAL","BACIA",14,88047,0,3,1358,698,599,99,685,13,1400,702,371,314,
22,"HUNEDOARA",207,88092,,249,0,"SEDIUL PRIMARIEI(SALA DE SEDINTE)","BAITA",16,88092,0,3,1531,887,770,117,861,26,1675,788,398,463,
22,"HUNEDOARA",207,88092,,250,0,"Hartagani,CAMINUL CULTURAL","BAITA",16,88092,0,3,815,470,421,49,453,17,875,405,193,260,
22,"HUNEDOARA",207,88092,,251,0,"Ormindea,SCOALA PRIMARA","BAITA",16,88092,0,3,571,291,237,54,286,5,625,334,119,167,
22,"HUNEDOARA",207,88092,,252,0,"Fizes,CAMINUL CULTURAL","BAITA",16,88092,0,3,544,345,272,73,340,5,600,255,138,202,
22,"HUNEDOARA",207,87246,,253,0,"SEDIUL PRIMARIEI","BANITA",18,87246,0,3,967,586,500,86,578,8,1075,489,260,318,
22,"HUNEDOARA",207,88216,,254,0,"CAMINUL CULTURAL","BATRANA",20,88216,0,3,149,117,93,24,112,5,175,58,31,81,
22,"HUNEDOARA",207,88261,,255,0,"CAMINUL CULTURAL","BERIU",21,88261,0,3,658,363,296,67,353,10,800,437,195,158,
22,"HUNEDOARA",207,88261,,256,0,"Castau,SCOALA GENERALA DE 8 ANI","BERIU",21,88261,0,3,891,451,414,37,441,10,975,524,252,189,
22,"HUNEDOARA",207,88261,,257,0,"Sibisel,SCOALA GENERALA DE 8 ANI","BERIU",21,88261,0,3,642,334,296,38,324,10,700,366,129,195,
22,"HUNEDOARA",207,88261,,258,0,"Cucuis,SCOALA PRIMARA","BERIU",21,88261,0,3,123,89,69,20,89,0,150,61,46,43,
22,"HUNEDOARA",207,88261,,259,0,"Orastioara de Jos,SCOALA PRIMARA","BERIU",21,88261,0,3,267,161,131,30,159,2,275,114,90,69,
22,"HUNEDOARA",207,88350,,260,0,"CAMINUL CULTURAL","BLAJENI",22,88350,0,3,666,317,263,54,310,7,725,408,114,196,
22,"HUNEDOARA",207,88350,,261,0,"Blajeni-Vulcan,SCOALA PRIMARA","BLAJENI",22,88350,0,3,184,92,64,28,89,3,200,108,28,61,
22,"HUNEDOARA",207,88350,,262,0,"Cris,SCOALA PRIMARA","BLAJENI",22,88350,0,3,397,227,190,37,219,8,425,198,85,134,
22,"HUNEDOARA",207,88350,,263,0,"Cris Grosuri,SCOALA PRIMARA","BLAJENI",22,88350,0,3,160,105,82,23,102,3,175,70,38,64,
22,"HUNEDOARA",207,88449,,264,0,"CAMINUL CULTURAL","BOSOROD",23,88449,0,3,808,544,493,51,529,15,810,266,283,246,
22,"HUNEDOARA",207,88449,,265,0,"Chitid,CAMINUL CULTURAL","BOSOROD",23,88449,0,3,470,295,260,35,291,4,475,180,122,169,
22,"HUNEDOARA",207,88449,,266,0,"Luncani,CABANA OCOLULUI SILVIC","BOSOROD",23,88449,0,3,294,101,80,21,101,0,295,193,55,46,
22,"HUNEDOARA",207,88449,,267,0,"Tirsa,CAMINUL CULTURAL","BOSOROD",23,88449,0,3,225,133,105,28,132,1,225,92,87,45,
22,"HUNEDOARA",207,88546,,268,0,"CAMINUL CULTURAL","BRANISCA",24,88546,0,3,601,400,307,93,391,9,750,350,171,220,
22,"HUNEDOARA",207,88546,,269,0,"Boz,CAMINUL CULTURAL","BRANISCA",24,88546,0,3,512,294,255,39,286,8,580,286,150,136,
22,"HUNEDOARA",207,88546,,270,0,"Tarnava,CAMINUL CULTURAL","BRANISCA",24,88546,0,3,155,80,66,14,79,1,175,95,20,59,
22,"HUNEDOARA",207,88546,,271,0,"Furcsoara,CAMINUL CULTURAL","BRANISCA",24,88546,0,3,111,61,36,25,58,3,125,64,17,41,
22,"HUNEDOARA",207,88644,,272,0,"CAMINUL CULTURAL","BRETEA ROMANA",25,88644,0,3,209,178,144,34,173,5,239,61,99,74,
22,"HUNEDOARA",207,88644,,273,0,"Batalari,CAMINUL CULTURAL","BRETEA ROMANA",25,88644,0,3,170,143,115,28,136,7,200,57,77,59,
22,"HUNEDOARA",207,88644,,274,0,"Bretea Strei,CASA DE COPII","BRETEA ROMANA",25,88644,0,3,154,106,66,40,106,0,200,94,51,55,
22,"HUNEDOARA",207,88644,,275,0,"Covragi,SCOALA PRIMARA","BRETEA ROMANA",25,88644,0,3,151,91,69,22,89,2,170,79,55,34,
22,"HUNEDOARA",207,88644,,276,0,"Gantaga,SCOALA PRIMARA","BRETEA ROMANA",25,88644,0,3,275,161,140,21,157,4,300,139,99,58,
22,"HUNEDOARA",207,88644,,277,0,"Maceu,CAMINUL CULTURAL","BRETEA ROMANA",25,88644,0,3,318,173,142,31,172,1,350,177,97,75,
22,"HUNEDOARA",207,88644,,278,0,"Ocolisu Mare,SCOALA PRIMARA","BRETEA ROMANA",25,88644,0,3,196,135,103,32,135,0,240,105,89,46,
22,"HUNEDOARA",207,88644,,279,0,"Plopi,CAMINUL CULTURAL","BRETEA ROMANA",25,88644,0,3,212,154,132,22,151,3,237,83,76,75,
22,"HUNEDOARA",207,88644,,280,0,"Rusi,SCOALA PRIMARA","BRETEA ROMANA",25,88644,0,3,202,137,116,21,137,0,228,91,77,60,
22,"HUNEDOARA",207,88644,,281,0,"Valcele,CAMINUL CULTURAL","BRETEA ROMANA",25,88644,0,3,204,157,109,48,156,1,260,103,107,49,
22,"HUNEDOARA",207,88644,,282,0,"Valcelele Bune,SCOALA PRIMARA","BRETEA ROMANA",25,88644,0,3,370,208,184,24,205,3,380,172,86,119,
22,"HUNEDOARA",207,88788,,283,0,"CAMINUL CULTURAL","BUCES",26,88788,0,3,873,445,400,45,433,12,900,455,175,258,
22,"HUNEDOARA",207,88788,,284,0,"Stanija,SCOALA PRIMARA","BUCES",26,88788,0,3,394,235,209,26,234,1,400,165,102,132,
22,"HUNEDOARA",207,88788,,285,0,"Dupa Piatra,CAMINUL CULTURAL","BUCES",26,88788,0,3,812,465,435,30,448,17,850,385,162,286,
22,"HUNEDOARA",207,88868,,286,0,"SEDIUL PRIMARIEI","BUCURESCI",27,88868,0,3,579,322,302,20,312,10,650,328,149,163,
22,"HUNEDOARA",207,88868,,287,0,"Curechiu,CAMINUL CULTURAL","BUCURESCI",27,88868,0,3,364,221,198,23,216,5,401,180,105,111,
22,"HUNEDOARA",207,88868,,288,0,"Rovina,SCOALA PRIMARA","BUCURESCI",27,88868,0,3,303,140,129,11,138,2,326,186,82,56,
22,"HUNEDOARA",207,88868,,289,0,"Sesuri,CAMINUL CULTURAL","BUCURESCI",27,88868,0,3,405,227,214,13,219,8,450,223,89,130,
22,"HUNEDOARA",207,88920,,290,0,"TABARA SCOLARA","BULZESTII DE SUS",28,88920,0,3,259,129,105,24,125,4,300,171,73,52,
22,"HUNEDOARA",207,88920,,291,0,"Bulzestii de Jos,SCOALA PRIMARA","BULZESTII DE SUS",28,88920,0,3,149,95,69,26,87,8,175,80,40,47,
22,"HUNEDOARA",207,89026,,292,0,"SEDIUL PRIMARIEI","BUNILA",29,89026,0,3,199,150,111,39,149,1,225,75,103,46,
22,"HUNEDOARA",207,89026,,293,0,"Alun,""LA DISCA""","BUNILA",29,89026,0,3,29,26,12,14,26,0,35,9,14,12,
22,"HUNEDOARA",207,89026,,294,0,"Cernisoara Florese,CAMINUL CULTURAL","BUNILA",29,89026,0,3,172,175,125,50,172,3,180,5,111,61,
22,"HUNEDOARA",207,89026,,295,0,"Vadul Dobrii,CAMINUL CULTURAL","BUNILA",29,89026,0,3,30,52,20,32,51,1,100,48,36,15,
22,"HUNEDOARA",207,89080,,296,0,"CAMINUL CULTURAL","BURJUC",30,89080,0,3,138,111,85,26,109,2,151,40,67,42,
22,"HUNEDOARA",207,89080,,297,0,"Tatarasti,SCOALA PRIMARA","BURJUC",30,89080,0,3,135,109,72,37,103,6,151,42,42,61,
22,"HUNEDOARA",207,89080,,298,0,"Tisa,SCOALA PRIMARA","BURJUC",30,89080,0,3,120,128,86,42,128,0,150,22,83,45,
22,"HUNEDOARA",207,89080,,299,0,"Glodghilesti,SCOALA PRIMARA","BURJUC",30,89080,0,3,184,125,98,27,120,5,200,75,50,70,
22,"HUNEDOARA",207,89080,,300,0,"Bradatel,SCOALA PRIMARA","BURJUC",30,89080,0,3,183,130,111,19,129,1,200,70,65,64,
22,"HUNEDOARA",207,89151,,301,0,"PRIMARIE","CERBAL",32,89151,0,3,250,119,85,34,118,1,275,156,51,67,
22,"HUNEDOARA",207,89151,,302,0,"Poienita Tomii,SCOALA PRIMARA","CERBAL",32,89151,0,3,212,143,125,18,143,0,250,107,76,67,
22,"HUNEDOARA",207,89151,,303,0,"Poiana Rachitelii,SCOALA PRIMARA","CERBAL",32,89151,0,3,153,123,107,16,121,2,175,52,82,39,
22,"HUNEDOARA",207,89240,,304,0,"CAMINUL CULTURAL","CERTEJU DE SUS",33,89240,0,3,1197,753,648,105,745,8,1356,603,431,314,
22,"HUNEDOARA",207,89240,,305,0,"Hondol,CAMINUL CULTURAL","CERTEJU DE SUS",33,89240,0,3,545,359,307,52,359,0,600,241,173,186,
22,"HUNEDOARA",207,89240,,306,0,"Sacaramb,CAMINUL CULTURAL","CERTEJU DE SUS",33,89240,0,3,162,120,78,42,119,1,175,55,66,53,
22,"HUNEDOARA",207,89240,,307,0,"Nojag,SCOALA PRIMARA","CERTEJU DE SUS",33,89240,0,3,239,156,130,26,149,7,265,109,79,70,
22,"HUNEDOARA",207,89240,,308,0,"Varmaga,CAMINUL CULTURAL","CERTEJU DE SUS",33,89240,0,3,321,179,144,35,175,4,350,171,89,86,
22,"HUNEDOARA",207,89240,,309,0,"Magura-Toplita,CAMINUL CULTURAL","CERTEJU DE SUS",33,89240,0,3,182,103,80,23,100,3,203,100,50,50,
22,"HUNEDOARA",207,86749,,310,0,"SEDIUL PRIMARIEI","CARJITI",31,86749,0,3,330,276,220,56,269,7,400,124,155,114,
22,"HUNEDOARA",207,86749,,311,0,"Almasu Sec,CAMINUL CULTURAL","CARJITI",31,86749,0,3,151,110,79,31,107,3,200,90,62,45,
22,"HUNEDOARA",207,86749,,312,0,"Cozia,CAMINUL CULTURAL","CARJITI",31,86749,0,3,141,106,79,27,106,0,200,94,40,66,
22,"HUNEDOARA",207,87362,,313,0,"LOCALUL PRIMARIEI","CRISCIOR",34,87362,0,3,1920,859,757,102,829,30,1800,941,440,389,
22,"HUNEDOARA",207,87362,,314,0,"SEDIUL FOSTEI FARMACII","CRISCIOR",34,87362,0,3,691,868,379,489,844,24,1200,332,394,450,
22,"HUNEDOARA",207,87362,,315,0,"Zdrapti,CAMINUL CULTURAL","CRISCIOR",34,87362,0,3,840,537,492,45,524,13,925,388,280,244,
22,"HUNEDOARA",207,89348,,316,0,"SCOALA GENERALA","DENSUS",35,89348,0,3,568,383,326,57,380,3,600,217,213,167,
22,"HUNEDOARA",207,89348,,317,0,"Pesteana,SCOALA PRIMARA","DENSUS",35,89348,0,3,603,306,257,49,303,3,650,344,165,138,
22,"HUNEDOARA",207,89348,,318,0,"Stei,CAMINUL CULTURAL","DENSUS",35,89348,0,3,366,208,180,28,199,9,400,192,110,89,
22,"HUNEDOARA",207,89428,,319,0,"CAMINUL CULTURAL","DOBRA",36,89428,0,3,1292,769,638,131,761,8,1450,681,394,367,
22,"HUNEDOARA",207,89428,,320,0,"Lapusnic,SCOALA GENERALA","DOBRA",36,89428,0,3,345,229,185,44,225,4,400,171,142,83,
22,"HUNEDOARA",207,89428,,321,0,"Radulesti,CAMINUL CULTURAL","DOBRA",36,89428,0,3,293,220,186,34,214,6,325,105,148,66,
22,"HUNEDOARA",207,89428,,322,0,"Roscani,CAMINUL CULTURAL","DOBRA",36,89428,0,3,620,436,354,82,419,17,700,264,231,188,
22,"HUNEDOARA",207,89428,,323,0,"Panc,SCOALA PRIMARA","DOBRA",36,89428,0,3,208,146,114,32,144,2,230,84,36,108,
22,"HUNEDOARA",207,89561,,324,0,"Suseni,SEDIUL PRIMARIEI","GEOAGIU",37,89561,0,3,1109,601,472,129,583,18,1350,749,336,247,
22,"HUNEDOARA",207,89561,,325,0,"Joseni,GRADINITA NR.1","GEOAGIU",37,89561,0,3,977,557,468,89,528,29,1232,675,280,248,
22,"HUNEDOARA",207,89561,,326,0,"Aurel Vlaicu,CAMINUL CULTURAL","GEOAGIU",37,89561,0,3,610,443,346,97,428,15,700,257,230,198,
22,"HUNEDOARA",207,89561,,327,0,"Bozes,CAMINUL CULTURAL","GEOAGIU",37,89561,0,3,211,156,117,39,149,7,235,79,86,63,
22,"HUNEDOARA",207,89561,,328,0,"Cigmau,SEDIUL FOST C.A.P","GEOAGIU",37,89561,0,3,110,86,62,24,81,5,120,34,57,24,
22,"HUNEDOARA",207,89561,,329,0,"Geoagiu Bai,CASA DE CULTURA","GEOAGIU",37,89561,0,3,419,395,192,203,381,14,950,555,212,169,
22,"HUNEDOARA",207,89561,,330,0,"Gelmar,SCOALA PRIMARA","GEOAGIU",37,89561,0,3,367,227,192,35,224,3,400,173,136,88,
22,"HUNEDOARA",207,89561,,331,0,"Homorod,CAMINUL CULTURAL","GEOAGIU",37,89561,0,3,361,187,162,25,186,1,400,213,86,100,
22,"HUNEDOARA",207,89561,,332,0,"Renghet,CAMINUL CULTURAL","GEOAGIU",37,89561,0,3,247,142,105,37,134,8,260,118,51,83,
22,"HUNEDOARA",207,89561,,333,0,"Valeni,SCOALA PRIMARA","GEOAGIU",37,89561,0,3,65,41,25,16,41,0,75,34,21,20,
22,"HUNEDOARA",207,89561,,334,1,"Sanatorul TBC,CLUBUL SANATORIULUI","GEOAGIU",37,89561,0,3,65,190,28,162,178,12,250,60,95,83,
22,"HUNEDOARA",207,86883,,335,0,"SEDIUL PRIMARIEI","GHELARI",38,86883,0,3,865,497,437,60,488,9,975,478,273,215,
22,"HUNEDOARA",207,86883,,336,0,"CLUBUL MINERUL-CUT","GHELARI",38,86883,0,3,1157,691,598,93,686,5,1100,409,494,192,
22,"HUNEDOARA",207,86883,,337,0,"Govajdie,DISPENSARUL MEDICAL","GHELARI",38,86883,0,3,91,83,39,44,83,0,200,117,49,34,
22,"HUNEDOARA",207,89687,,338,0,"CAMINUL CULTURAL","GURASADA",39,89687,0,3,714,401,314,87,391,10,850,449,195,196,
22,"HUNEDOARA",207,89687,,339,0,"Campuri Surduc,CAMINUL CULTURAL","GURASADA",39,89687,0,3,363,222,181,41,215,7,400,178,84,131,
22,"HUNEDOARA",207,89687,,340,0,"Boiu de Sus,SCOALA PRIMARA","GURASADA",39,89687,0,3,174,108,94,14,99,9,200,92,29,70,
22,"HUNEDOARA",207,89687,,341,0,"Carmazanesti,CAMINUL CULTURAL","GURASADA",39,89687,0,3,178,74,68,6,70,4,200,126,20,50,
22,"HUNEDOARA",207,89801,,342,0,"CAMINUL CULTURAL","HARAU",40,89801,0,3,832,480,375,105,471,9,925,445,288,183,
22,"HUNEDOARA",207,89801,,343,0,"Banpotoc,SEDIUL FOST C.A.P.","HARAU",40,89801,0,3,664,390,315,75,385,5,700,310,156,229,
22,"HUNEDOARA",207,89856,,344,0,"CAMINUL CULTURAL","ILIA",41,89856,0,3,2175,1192,1008,184,1159,33,2500,1308,670,489,
22,"HUNEDOARA",207,89856,,345,0,"Bretea Muresana,CAMINUL CULTURAL","ILIA",41,89856,0,3,505,274,219,55,273,1,550,276,116,157,
22,"HUNEDOARA",207,89856,,346,0,"Sarbi,SEDIUL FOST C.A.P.","ILIA",41,89856,0,3,500,292,232,60,287,5,600,308,125,162,
22,"HUNEDOARA",207,89954,,347,0,"CAMINUL CULTURAL","LAPUGIU DE JOS",42,89954,0,3,395,334,221,113,325,9,548,214,206,119,
22,"HUNEDOARA",207,89954,,348,0,"Lapugiu de Sus,CAMINUL CULTURAL","LAPUGIU DE JOS",42,89954,0,3,349,244,216,28,238,6,350,106,109,129,
22,"HUNEDOARA",207,89954,,349,0,"Ohaba,CAMINUL CULTURAL","LAPUGIU DE JOS",42,89954,0,3,438,224,181,43,211,13,475,251,87,124,
22,"HUNEDOARA",207,90066,,350,0,"SCOALA PRIMARA","LELESE",43,90066,0,3,199,109,84,25,108,1,230,121,61,47,
22,"HUNEDOARA",207,90066,,351,0,"Cerisor,CAMINUL CULTURAL","LELESE",43,90066,0,3,102,82,57,25,78,4,120,38,50,28,
22,"HUNEDOARA",207,90066,,352,0,"Runcu Mare,SCOALA PRIMARA","LELESE",43,90066,0,3,131,110,85,25,110,0,160,50,40,70,
22,"HUNEDOARA",207,90119,,353,0,"SCOALA GENERALA","LUNCA CERNII DE JOS",44,90119,0,3,527,291,239,52,285,6,625,334,192,93,
22,"HUNEDOARA",207,90119,,354,0,"Meria,SCOALA PRIMARA","LUNCA CERNII DE JOS",44,90119,0,3,296,124,97,27,124,0,350,226,53,71,
22,"HUNEDOARA",207,90119,,355,0,"Negoiu,CAMINUL CULTURAL","LUNCA CERNII DE JOS",44,90119,0,3,255,111,92,19,108,3,275,164,73,35,
22,"HUNEDOARA",207,90208,,356,0,"CAMINUL CULTURAL","LUNCOIU DE JOS",45,90208,0,3,1235,642,610,32,624,18,1310,668,288,336,
22,"HUNEDOARA",207,90208,,357,0,"Luncoiu de Sus,CAMINUL CULTURAL","LUNCOIU DE JOS",45,90208,0,3,488,281,256,25,279,2,520,239,117,162,
22,"HUNEDOARA",207,90262,,358,0,"CAMINUL CULTURAL","MARTINESTI",46,90262,0,3,208,168,131,37,160,8,261,93,62,98,
22,"HUNEDOARA",207,90262,,359,0,"Dancu Mare,CAMINUL CULTURAL","MARTINESTI",46,90262,0,3,203,148,102,46,142,6,260,112,55,87,
22,"HUNEDOARA",207,90262,,360,0,"Dancu Mic,SCOALA PRIMARA","MARTINESTI",46,90262,0,3,102,114,75,39,109,5,146,32,76,33,
22,"HUNEDOARA",207,90262,,361,0,"Jeledinti,CAMINUL CULTURAL","MARTINESTI",46,90262,0,3,219,102,88,14,99,3,236,134,62,37,
22,"HUNEDOARA",207,90262,,362,0,"Tamasasa,CAMINUL CULTURAL","MARTINESTI",46,90262,0,3,122,92,73,19,89,3,156,64,29,60,
22,"HUNEDOARA",207,90342,,363,0,"SCOALA GENERALA","ORASTIOARA DE SUS",47,90342,0,3,458,238,196,42,236,2,500,262,143,93,
22,"HUNEDOARA",207,90342,,364,0,"Bucium,SCOALA PRIMARA","ORASTIOARA DE SUS",47,90342,0,3,281,187,160,27,187,0,225,38,106,81,
22,"HUNEDOARA",207,90342,,365,0,"Ludestii de Jos,SCOALA PRIMARA","ORASTIOARA DE SUS",47,90342,0,3,318,142,120,22,141,1,350,208,68,73,
22,"HUNEDOARA",207,90342,,366,0,"Costesti,SCOALA PRIMARA","ORASTIOARA DE SUS",47,90342,0,3,474,285,253,32,283,2,500,215,101,182,
22,"HUNEDOARA",207,90342,,367,0,"Gradistea de Munte,SCOALA PRIMARA","ORASTIOARA DE SUS",47,90342,0,3,176,130,96,34,130,0,225,95,60,70,
22,"HUNEDOARA",207,90342,,368,0,"Ocolisu Mic,SCOALA PRIMARA","ORASTIOARA DE SUS",47,90342,0,3,324,256,224,32,224,7,350,119,71,153,
22,"HUNEDOARA",207,90431,,369,0,"SCOALA GENERALA","PESTISU MIC",48,90431,0,3,307,206,171,35,206,0,350,144,134,72,
22,"HUNEDOARA",207,90431,,370,0,"Manerau,SCOALA PRIMARA","PESTISU MIC",48,90431,0,3,219,193,130,63,193,0,250,57,128,65,
22,"HUNEDOARA",207,90431,,371,0,"Almasu Mic,CAMINUL CULTURAL","PESTISU MIC",48,90431,0,3,56,64,32,32,62,2,75,11,30,32,
22,"HUNEDOARA",207,90431,,372,0,"Nandru,SCOALA PRIMARA","PESTISU MIC",48,90431,0,3,256,199,153,46,199,0,275,76,96,103,
22,"HUNEDOARA",207,90431,,373,0,"Ciulpaz,CAMINUL CULTURAL","PESTISU MIC",48,90431,0,3,104,86,51,35,86,0,115,29,36,50,
22,"HUNEDOARA",207,90538,,374,0,"CAMINUL CULTURAL","PUI",49,90538,0,3,702,486,364,122,480,6,800,314,276,204,
22,"HUNEDOARA",207,90538,,375,0,"Fizesti,CAMINUL CULTURAL","PUI",49,90538,0,3,374,187,166,21,181,6,400,213,86,95,
22,"HUNEDOARA",207,90538,,376,0,"Federi,SCOALA PRIMARA","PUI",49,90538,0,3,289,95,83,12,93,2,300,205,32,61,
22,"HUNEDOARA",207,90538,,377,0,"Galati,SCOALA PRIMARA","PUI",49,90538,0,3,368,247,210,37,245,2,400,153,119,126,
22,"HUNEDOARA",207,90538,,378,0,"Ohaba Ponor,SCOALA PRIMARA","PUI",49,90538,0,3,257,138,108,30,135,3,275,137,40,95,
22,"HUNEDOARA",207,90538,,379,0,"Ponor,SCOALA GENERALA","PUI",49,90538,0,3,348,196,155,41,195,1,375,179,116,79,
22,"HUNEDOARA",207,90538,,380,0,"Rusor,CAMINUL CULTURAL","PUI",49,90538,0,3,424,251,209,42,247,4,450,199,149,98,
22,"HUNEDOARA",207,90538,,381,0,"Rau Barbat,S.C.BALEIA","PUI",49,90538,0,3,307,226,165,61,225,1,325,99,92,133,
22,"HUNEDOARA",207,90538,,382,0,"Serel,CAMINUL CULTURAL","PUI",49,90538,0,3,424,256,220,36,252,4,475,219,93,159,
22,"HUNEDOARA",207,90538,,383,0,"Uric,CAMINUL CULTURAL","PUI",49,90538,0,3,240,204,158,46,202,2,260,56,114,88,
22,"HUNEDOARA",207,90663,,384,0,"SEDIUL PRIMARIEI","RAPOLTU MARE",51,90663,0,3,853,531,440,91,519,12,951,420,276,243,
22,"HUNEDOARA",207,90663,,385,0,"Bobalna,CAMINUL CULTURAL","RAPOLTU MARE",51,90663,0,3,396,272,213,59,272,0,455,183,158,114,
22,"HUNEDOARA",207,90663,,386,0,"Folt,SCOALA PRIMARA","RAPOLTU MARE",51,90663,0,3,285,138,99,39,135,3,326,188,73,62,
22,"HUNEDOARA",207,90725,,387,0,"SEDIUL PRIMARIEI","RACHITOVA",50,90725,0,3,667,294,270,24,286,8,850,556,140,146,
22,"HUNEDOARA",207,90725,,388,0,"Boita,CAMINUL CULTURAL","RACHITOVA",50,90725,0,3,641,300,265,35,295,5,675,375,110,185,
22,"HUNEDOARA",207,90805,,389,0,"CAMINUL CULTURAL","RIBITA",53,90805,0,3,640,351,327,24,330,21,706,355,196,134,
22,"HUNEDOARA",207,90805,,390,0,"Crisan,CAMINUL CULTURAL","RIBITA",53,90805,0,3,441,288,261,27,274,14,501,213,141,133,
22,"HUNEDOARA",207,90805,,391,0,"Dumbrava de Jos,CAMINUL CULTURAL","RIBITA",53,90805,0,3,233,141,117,24,132,9,250,109,56,76,
22,"HUNEDOARA",207,90805,,392,0,"Dumbrava de Sus,SCOALA PRIMARA","RIBITA",53,90805,0,3,85,50,31,19,47,3,100,50,22,25,
22,"HUNEDOARA",207,90878,,393,0,"SCOALA GENERALA","RAU DE MORI",52,90878,0,3,754,399,331,68,382,17,850,451,183,199,
22,"HUNEDOARA",207,90878,,394,0,"Clopotiva,SCOALA GENERALA","RAU DE MORI",52,90878,0,3,728,460,416,44,452,8,800,340,213,239,
22,"HUNEDOARA",207,90878,,395,0,"Ostrov,CAMINUL CULTURAL","RAU DE MORI",52,90878,0,3,399,253,211,42,244,9,450,197,105,139,
22,"HUNEDOARA",207,90878,,396,0,"Unciuc,SCOALA PRIMARA","RAU DE MORI",52,90878,0,3,142,138,101,37,137,1,160,22,44,93,
22,"HUNEDOARA",207,90878,,397,0,"Valea Daljii,SCOALA PRIMARA","RAU DE MORI",52,90878,0,3,231,153,118,35,153,0,275,122,55,98,
22,"HUNEDOARA",207,90878,,398,0,"Ohaba Sibisel,SCOALA PRIMARA","RAU DE MORI",52,90878,0,3,297,185,163,22,184,1,325,140,62,122,
22,"HUNEDOARA",207,90878,,399,0,"Brazi,COMPLEXUL COMERCIAL","RAU DE MORI",52,90878,0,3,99,278,47,231,273,5,350,72,57,216,
22,"HUNEDOARA",207,90994,,400,0,"SCOALA GENERALA","ROMOS",54,90994,0,3,969,544,507,37,525,19,1100,556,255,270,
22,"HUNEDOARA",207,90994,,401,0,"Romosel,SCOALA PRIMARA","ROMOS",54,90994,0,3,657,278,241,37,273,5,770,492,76,197,
22,"HUNEDOARA",207,90994,,402,0,"Vaidei,SCOALA PRIMARA","ROMOS",54,90994,0,3,517,331,270,61,320,11,550,219,152,168,
22,"HUNEDOARA",207,90994,,403,0,"Pischinti,SCOALA PRIMARA","ROMOS",54,90994,0,3,200,164,134,30,159,5,225,61,50,109,
22,"HUNEDOARA",207,91054,,404,0,"CAMINUL CULTURAL","SARMIZEGETUSA",57,91054,0,3,835,491,437,54,488,3,925,434,273,215,
22,"HUNEDOARA",207,91054,,405,0,"Paucinesti,CAMINUL CULTURAL","SARMIZEGETUSA",57,91054,0,3,183,129,105,24,124,5,200,71,52,72,
22,"HUNEDOARA",207,91054,,406,0,"Zeicani,CAMINUL CULTURAL","SARMIZEGETUSA",57,91054,0,3,157,100,75,25,95,5,175,75,34,61,
22,"HUNEDOARA",207,91116,,407,0,"LOCALUL PRIMARIEI CORP 2","SALASU DE SUS",55,91116,0,3,1065,466,391,75,465,1,1250,784,237,228,
22,"HUNEDOARA",207,91116,,408,0,"Ohaba de Subpiatra,CAMINUL CULTURAL","SALASU DE SUS",55,91116,0,3,375,260,187,73,249,11,400,140,130,119,
22,"HUNEDOARA",207,91116,,409,0,"Rau Alb,SEDIUL FOST C.A.P.","SALASU DE SUS",55,91116,0,3,533,222,193,29,216,6,575,353,87,129,
22,"HUNEDOARA",207,91116,,410,0,"Nucsoara,SCOALA PRIMARA","SALASU DE SUS",55,91116,0,3,415,279,223,56,273,6,475,196,66,207,
22,"HUNEDOARA",207,91232,,411,0,"SEDIUL PRIMARIEI","SANTAMARIA-ORLEA",56,91232,0,3,870,545,337,208,537,8,975,430,283,254,
22,"HUNEDOARA",207,91232,,412,0,"Subcetate,SCOALA PRIMARA","SANTAMARIA-ORLEA",56,91232,0,3,811,493,406,87,490,3,900,407,221,269,
22,"HUNEDOARA",207,91232,,413,0,"Sacel,SCOALA AJUTATOARE","SANTAMARIA-ORLEA",56,91232,0,3,822,392,352,40,376,16,900,508,219,157,
22,"HUNEDOARA",207,91330,,414,0,"CAMINUL CULTURAL","SOIMUS",58,91330,0,3,1176,724,621,103,711,13,1325,601,410,301,
22,"HUNEDOARA",207,91330,,415,0,"Boholt,CAMINUL CULTURAL","SOIMUS",58,91330,0,3,263,231,184,47,228,3,275,44,149,79,
22,"HUNEDOARA",207,91330,,416,0,"Paulis,CAMINUL CULTURAL","SOIMUS",58,91330,0,3,752,776,660,116,763,13,825,49,481,282,
22,"HUNEDOARA",207,91330,,417,0,"Fornadie,SCOALA PRIMARA","SOIMUS",58,91330,0,3,219,214,189,25,213,1,250,36,139,74,
22,"HUNEDOARA",207,91330,,418,0,"Sulighete,SCOALA PRIMARA","SOIMUS",58,91330,0,3,263,271,222,49,269,2,299,28,167,102,
22,"HUNEDOARA",207,86936,,419,0,"SEDIUL PRIMARIEI","TELIUCU INFERIOR",59,86936,0,3,1316,738,646,92,718,20,1475,737,424,294,
22,"HUNEDOARA",207,86936,,420,0,"Cincis-Cerna,CAMINUL CULTURAL","TELIUCU INFERIOR",59,86936,0,3,568,467,370,97,463,4,635,168,288,175,
22,"HUNEDOARA",207,86936,,421,0,"Izvoarele,CAMINUL CULTURAL","TELIUCU INFERIOR",59,86936,0,3,123,109,72,37,108,1,150,41,77,31,
22,"HUNEDOARA",207,86936,,422,0,"Teliucu Superior,SCOALA GENERALA","TELIUCU INFERIOR",59,86936,0,3,115,181,88,93,180,1,250,69,99,81,
22,"HUNEDOARA",207,91447,,423,0,"SEDIUL PRIMARIEI","TOMESTI",60,91447,0,3,743,421,398,23,403,18,825,404,160,243,
22,"HUNEDOARA",207,91447,,424,0,"Dobrot,SCOALA PRIMARA","TOMESTI",60,91447,0,3,426,313,289,24,306,7,475,162,140,166,
22,"HUNEDOARA",207,91535,,425,0,"CAMINUL CULTURAL","TOPLITA",61,91535,0,3,306,194,161,33,191,3,350,156,120,71,
22,"HUNEDOARA",207,91535,,426,0,"Dabaca,SCOALA PRIMARA","TOPLITA",61,91535,0,3,169,140,115,25,139,1,350,210,79,60,
22,"HUNEDOARA",207,91535,,427,0,"Hasdau,CAMINUL CULTURAL","TOPLITA",61,91535,0,3,336,242,215,27,242,0,375,133,111,131,
22,"HUNEDOARA",207,91624,,428,0,"CAMINUL CULTURAL","TOTESTI",62,91624,0,3,368,281,244,37,277,4,425,144,178,99,
22,"HUNEDOARA",207,91624,,429,0,"Carnesti,CAMINUL CULTURAL","TOTESTI",62,91624,0,3,429,300,264,36,288,12,450,150,166,122,
22,"HUNEDOARA",207,91624,,430,0,"Reea,SCOALA PRIMARA","TOTESTI",62,91624,0,3,296,238,206,32,234,4,325,87,128,106,
22,"HUNEDOARA",207,91624,,431,0,"Paclisa,CAMINUL CULTURAL","TOTESTI",62,91624,0,3,419,265,226,39,261,4,450,185,149,112,
22,"HUNEDOARA",207,91688,,432,0,"SCOALA GENERALA","TURDAS",63,91688,0,3,405,272,219,53,268,4,453,181,138,130,
22,"HUNEDOARA",207,91688,,433,0,"Pricaz,SCOALA PRIMARA","TURDAS",63,91688,0,3,866,594,513,81,583,11,1016,422,304,279,
22,"HUNEDOARA",207,91688,,434,0,"Spini,SCOALA PRIMARA","TURDAS",63,91688,0,3,235,118,90,28,117,1,250,132,70,47,
22,"HUNEDOARA",207,91731,,435,0,"CAMINUL CULTURAL","UNIREA",64,91731,0,3,794,392,364,28,382,10,900,508,165,217,
22,"HUNEDOARA",207,91795,,436,0,"SCOALA GENERALA","VATA DE JOS",66,91795,0,3,1061,636,573,63,619,17,1275,639,358,261,
22,"HUNEDOARA",207,91795,,437,0,"Tatarastii de Cris,SCOALA PRIMARA","VATA DE JOS",66,91795,0,3,382,248,234,14,237,11,425,177,122,115,
22,"HUNEDOARA",207,91795,,438,0,"Tarnava de Cris,SCOALA PRIMARA","VATA DE JOS",66,91795,0,3,778,457,439,18,448,9,850,393,246,202,
22,"HUNEDOARA",207,91795,,439,0,"Birtin,SCOALA PRIMARA","VATA DE JOS",66,91795,0,3,251,182,152,30,178,4,275,93,97,81,
22,"HUNEDOARA",207,91795,,440,0,"Cazanesti,SCOALA PRIMARA","VATA DE JOS",66,91795,0,3,211,140,129,11,138,2,230,90,61,77,
22,"HUNEDOARA",207,91795,,441,0,"Ciungani,SCOALA PRIMARA","VATA DE JOS",66,91795,0,3,267,153,142,11,150,3,300,147,83,67,
22,"HUNEDOARA",207,91795,,442,0,"Pravaleni,SCOALA PRIMARA","VATA DE JOS",66,91795,0,3,310,196,184,12,191,5,350,154,85,106,
22,"HUNEDOARA",207,91795,,443,0,"Ociu,SCOALA PRIMARA","VATA DE JOS",66,91795,0,3,488,237,221,16,233,4,525,288,102,131,
22,"HUNEDOARA",207,91937,,444,0,"CAMINUL CULTURAL","VALISOARA",65,91937,0,3,713,423,372,51,414,9,800,377,210,204,
22,"HUNEDOARA",207,91937,,445,0,"Dealul Mare,CAMINUL CULTURAL","VALISOARA",65,91937,0,3,207,168,112,56,164,4,230,62,42,122,
22,"HUNEDOARA",207,91937,,446,0,"Salistioara,CAMINUL CULTURAL","VALISOARA",65,91937,0,3,265,155,128,27,150,5,295,140,71,79,
22,"HUNEDOARA",207,91982,,447,0,"CAMINUL CULTURAL","VETEL",67,91982,0,3,634,433,338,95,423,10,725,292,208,215,
22,"HUNEDOARA",207,91982,,448,0,"Herepeia,SCOALA PRIMARA","VETEL",67,91982,0,3,90,83,52,31,81,2,100,17,27,54,
22,"HUNEDOARA",207,91982,,449,0,"Bretelin,SCOALA PRIMARA","VETEL",67,91982,0,3,40,45,22,23,44,1,50,5,18,26,
22,"HUNEDOARA",207,91982,,450,0,"Lesnic,CAMINUL CULTURAL","VETEL",67,91982,0,3,371,277,217,60,274,3,400,123,124,150,
22,"HUNEDOARA",207,91982,,451,0,"Mintia,SCOALA PRIMARA","VETEL",67,91982,0,3,480,356,244,112,349,7,525,169,199,150,
22,"HUNEDOARA",207,91982,,452,0,"Muncelu Mic,SCOALA GENERALA","VETEL",67,91982,0,3,122,102,47,55,100,2,150,48,56,44,
22,"HUNEDOARA",207,91982,,453,0,"Muncelu Mare,CAMINUL CULTURAL","VETEL",67,91982,0,3,109,50,33,17,45,5,115,65,15,30,
22,"HUNEDOARA",207,92097,,454,0,"SCOALA PRIMARA","VORTA",68,92097,0,3,209,126,111,15,121,5,250,124,50,71,
22,"HUNEDOARA",207,92097,,455,0,"Coaja,IMOBILUL NR.7 VALEA HOMORODULUI","VORTA",68,92097,0,3,195,110,98,12,109,1,225,115,53,56,
22,"HUNEDOARA",207,92097,,456,0,"Visca,SCOALA GENERALA","VORTA",68,92097,0,3,565,314,292,22,308,6,625,311,159,149,
22,"HUNEDOARA",207,92177,,457,0,"CAMINUL CULTURAL","ZAM",69,92177,0,3,617,396,323,73,386,10,705,309,199,187,
22,"HUNEDOARA",207,92177,,458,0,"Poganesti,SCOALA PRIMARA","ZAM",69,92177,0,3,336,186,153,33,181,5,325,139,73,108,
22,"HUNEDOARA",207,92177,,459,0,"Almas Saliste,CAMINUL CULTURAL","ZAM",69,92177,0,3,224,119,100,19,111,8,253,134,53,58,
22,"HUNEDOARA",207,92177,,460,0,"Salciva,SCOALA PRIMARA","ZAM",69,92177,0,3,390,270,216,54,266,4,425,155,166,100,
22,"HUNEDOARA",207,92177,,461,0,"Godinesti,CAMINUL CULTURAL","ZAM",69,92177,0,3,177,120,110,10,119,1,195,75,54,65,
22,"HUNEDOARA",207,92177,,462,1,"SPITALUL DE PSIHIATRIE","ZAM",69,92177,0,3,0,153,0,153,149,4,300,147,51,98,
23,"IALOMITA",216,92658,,1,0,"Grup scolar Al. Ioan Cuza , str. Lacului nr.10","MUNICIPIUL SLOBOZIA",1,92658,1,1,1782,949,821,128,933,16,1900,51,624,309,
23,"IALOMITA",216,92658,,2,0,"Liceul Mihai Eminescu, Aleea Chimiei,nr.9","MUNICIPIUL SLOBOZIA",1,92658,1,1,1413,727,642,85,714,13,1400,673,475,239,
23,"IALOMITA",216,92658,,3,0,"Scoala generala nr.4 , Aleea Scolii nr.2","MUNICIPIUL SLOBOZIA",1,92658,1,1,1412,859,797,62,853,6,1800,941,569,284,
23,"IALOMITA",216,92658,,4,0,"Scoala generala nr.4, Aleea Scolii nr.2","MUNICIPIUL SLOBOZIA",1,92658,1,1,1882,913,837,76,901,12,2000,1087,600,301,
23,"IALOMITA",216,92658,,5,0,"Gradinita cu program prelungit, str. Vechea Matca","MUNICIPIUL SLOBOZIA",1,92658,1,1,1528,861,781,80,852,9,1700,839,600,252,
23,"IALOMITA",216,92658,,6,0,"Gradinita cu program normal, str. Independentei","MUNICIPIUL SLOBOZIA",1,92658,1,1,1561,878,802,76,862,16,1700,822,598,264,
23,"IALOMITA",216,92658,,7,0,"Liceul de Arta , str. Mihai Eminescu , nr.3","MUNICIPIUL SLOBOZIA",1,92658,1,1,1244,679,624,55,675,4,1600,921,483,192,
23,"IALOMITA",216,92658,,8,0,"Liceul de Arta, str. Mihai Eminescu , nr.3","MUNICIPIUL SLOBOZIA",1,92658,1,1,1374,752,697,55,746,6,1500,748,508,238,
23,"IALOMITA",216,92658,,9,0,"Scoala generala nr. 1, bd. Matei Basarab, nr.69","MUNICIPIUL SLOBOZIA",1,92658,1,1,1376,748,704,44,737,11,1500,752,503,234,
23,"IALOMITA",216,92658,,10,0,"Scoala generala nr.1 , bd. Matei Basarab , nr 67","MUNICIPIUL SLOBOZIA",1,92658,1,1,1416,759,722,37,749,10,1500,741,545,204,
23,"IALOMITA",216,92658,,11,0,"Clubul elevilor , bd. Matei Basarab, nr.54","MUNICIPIUL SLOBOZIA",1,92658,1,1,1483,808,759,49,806,2,1600,792,563,243,
23,"IALOMITA",216,92658,,12,0,"Cercul Militar , bd. Matei Basarab, nr.52","MUNICIPIUL SLOBOZIA",1,92658,1,1,1488,974,778,196,966,8,1400,426,682,284,
23,"IALOMITA",216,92658,,13,0,"Scoala generala nr.2, bd. Matei Basarab, nr.35","MUNICIPIUL SLOBOZIA",1,92658,1,1,1466,880,808,72,875,5,1600,720,606,269,
23,"IALOMITA",216,92658,,14,0,"Scoala generala nr.2, bd. Matei Basarab, nr.35","MUNICIPIUL SLOBOZIA",1,92658,1,1,1314,823,756,67,813,10,1500,677,591,222,
23,"IALOMITA",216,92658,,15,0,"SCELIF , str. Cuza Voda, nr.2","MUNICIPIUL SLOBOZIA",1,92658,1,1,1932,1051,970,81,1038,13,2100,1049,742,296,
23,"IALOMITA",216,92658,,16,0,"Casa de cultura a Sindicatelor , bd. Chimiei, nr.3","MUNICIPIUL SLOBOZIA",1,92658,1,1,1900,961,870,91,947,14,1900,939,650,297,
23,"IALOMITA",216,92658,,17,0,"Scoala generala nr.3, bd. Unirii, nr.14","MUNICIPIUL SLOBOZIA",1,92658,1,1,1222,710,630,80,703,7,1400,690,486,217,
23,"IALOMITA",216,92658,,18,0,"Scoala generala nr. 3, bd. Unirii, nr.14","MUNICIPIUL SLOBOZIA",1,92658,1,1,1387,795,737,58,783,12,1600,805,510,273,
23,"IALOMITA",216,92658,,19,0,"Seminarul Teologic, str. Al. Odobescu, nr.2","MUNICIPIUL SLOBOZIA",1,92658,1,1,1305,742,689,53,736,6,1500,758,522,214,
23,"IALOMITA",216,92658,,20,0,"Liceul Mihai Viteazu , bd. Unirii , nr.15","MUNICIPIUL SLOBOZIA",1,92658,1,1,1185,714,638,76,712,2,1300,586,500,212,
23,"IALOMITA",216,92658,,21,0,"Liceul Pedagogic, bd. Matei Basarab, nr.3","MUNICIPIUL SLOBOZIA",1,92658,1,1,1664,941,868,73,932,9,1800,859,683,249,
23,"IALOMITA",216,92658,,22,0,"Muzeul Agriculturii, bd. Matei Basarab, nr.2","MUNICIPIUL SLOBOZIA",1,92658,1,1,1796,972,871,101,962,10,2000,1028,684,278,
23,"IALOMITA",216,92658,,23,0,"Scoala generala nr.6, Aleea Parcului , nr.8","MUNICIPIUL SLOBOZIA",1,92658,1,1,1723,961,883,78,954,7,1900,939,616,338,
23,"IALOMITA",216,92658,,24,0,"Scoala generala nr.6, Aleea Parcului , nr.8","MUNICIPIUL SLOBOZIA",1,92658,1,1,1877,964,900,64,953,11,2000,1036,654,299,
23,"IALOMITA",216,92658,,25,0,"Gradinita cu program prelungit, str. C-tin Dobrogeanu Gherea","MUNICIPIUL SLOBOZIA",1,92658,1,1,1331,819,741,78,810,9,1400,581,543,267,
23,"IALOMITA",216,92658,,26,0,"Clubul Tineretului, bd. Chimiei, nr.10","MUNICIPIUL SLOBOZIA",1,92658,1,1,1174,608,542,66,606,2,1300,692,429,177,
23,"IALOMITA",216,92658,,27,0,"Directia Generala a Agriculturii, bd. Chimiei, nr.19","MUNICIPIUL SLOBOZIA",1,92658,1,1,1545,809,765,44,802,7,1700,891,592,210,
23,"IALOMITA",216,92658,,28,0,"Scoala generala Bora, str. G-ral Magheru","MUNICIPIUL SLOBOZIA",1,92658,1,1,1110,687,550,137,668,19,1200,513,501,167,
23,"IALOMITA",216,92658,,29,0,"Scoala generala nr.5, Slobozia Noua, str. Scolii","MUNICIPIUL SLOBOZIA",1,92658,1,1,1539,1023,930,93,1005,18,1700,677,633,372,
23,"IALOMITA",216,92658,,30,1,"Spitalul Judetean Ialomita, str. Decebal , nr.3","MUNICIPIUL SLOBOZIA",1,92658,1,1,0,466,0,466,458,8,600,134,334,124,
23,"IALOMITA",216,92658,,31,1,"Grupul de Pompieri Barbu Catargiu, str. Lacului, nr.23","MUNICIPIUL SLOBOZIA",1,92658,1,1,0,166,0,166,161,5,200,34,109,52,
23,"IALOMITA",216,92658,,32,1,"U.M.01088 , sos. Amara","MUNICIPIUL SLOBOZIA",1,92658,1,1,0,280,0,280,274,6,400,120,169,105,
23,"IALOMITA",216,92658,,33,1,"Penitenciarul Slobozia, str. Garii nr.19","MUNICIPIUL SLOBOZIA",1,92658,1,1,0,208,0,208,203,5,300,92,154,49,
23,"IALOMITA",216,92701,,34,0,"Scoala nr. 3 Buliga","MUNICIPIUL FETESTI",2,92701,1,1,1062,728,687,41,719,9,1200,472,483,236,
23,"IALOMITA",216,92701,,35,0,"Scoala nr.6, Localul Mare, Fetesti Oras","MUNICIPIUL FETESTI",2,92701,1,1,1682,1019,956,63,998,21,1800,781,719,279,
23,"IALOMITA",216,92701,,36,0,"Localul Mic , Fetesti Oras","MUNICIPIUL FETESTI",2,92701,1,1,1855,1030,939,91,1015,15,2000,970,671,344,
23,"IALOMITA",216,92701,,37,0,"Scoala nr.2 , Fetesti Oras","MUNICIPIUL FETESTI",2,92701,1,1,857,558,432,126,550,8,900,342,337,213,
23,"IALOMITA",216,92701,,38,0,"Scoala nr.1, Fetesti Oras","MUNICIPIUL FETESTI",2,92701,1,1,2086,1278,1073,205,1251,27,2200,922,900,351,
23,"IALOMITA",216,92701,,39,0,"Scoala nr.4,str. Vlasca","MUNICIPIUL FETESTI",2,92701,1,1,1563,985,885,100,973,12,1700,715,692,281,
23,"IALOMITA",216,92701,,40,0,"Grup Scolar CCF , str. A. Saligny, Fetesti Gara","MUNICIPIUL FETESTI",2,92701,1,1,1942,1025,953,72,1016,9,2100,1075,656,360,
23,"IALOMITA",216,92701,,41,0,"Scoala nr.3, Fetesti Gara","MUNICIPIUL FETESTI",2,92701,1,1,1992,1216,1092,124,1205,11,2100,884,800,405,
23,"IALOMITA",216,92701,,42,0,"Gradinita + cresa , Fetesti Gara","MUNICIPIUL FETESTI",2,92701,1,1,2411,1305,1182,123,1292,13,2600,1295,772,520,
23,"IALOMITA",216,92701,,43,0,"Scoala nr.8, Fetesti Gara","MUNICIPIUL FETESTI",2,92701,1,1,1837,1100,1033,67,1091,9,2000,900,744,347,
23,"IALOMITA",216,92701,,44,0,"Cantina Depou CFR , Fetesti Gara","MUNICIPIUL FETESTI",2,92701,1,1,1082,762,613,149,754,8,1200,438,511,243,
23,"IALOMITA",216,92701,,45,0,"Gradinita nr.7, Fetesti Gara","MUNICIPIUL FETESTI",2,92701,1,1,1650,1110,915,195,1100,10,1800,690,783,317,
23,"IALOMITA",216,92701,,46,0,"Scoala nr.9, Fetesti Gara","MUNICIPIUL FETESTI",2,92701,1,1,1539,890,819,71,885,5,1700,810,596,289,
23,"IALOMITA",216,92701,,47,0,"Clubul elevilor , Fetesti Gara","MUNICIPIUL FETESTI",2,92701,1,1,1669,1030,930,100,1023,7,1800,770,635,388,
23,"IALOMITA",216,92701,,48,0,"Alimentara bariera, Fetesti Gara","MUNICIPIUL FETESTI",2,92701,1,1,1223,807,716,91,797,10,1400,593,511,286,
23,"IALOMITA",216,92701,,49,0,"Agrosem , Fetesti Gara","MUNICIPIUL FETESTI",2,92701,1,1,1392,914,811,103,906,8,1500,586,625,281,
23,"IALOMITA",216,92701,,50,0,"Scoala nr.5, Colonisti","MUNICIPIUL FETESTI",2,92701,1,1,1955,1083,997,86,1056,27,2100,1017,692,364,
23,"IALOMITA",216,92701,,51,1,"U.M Jandarmi, Fetesti Gara","MUNICIPIUL FETESTI",2,92701,1,1,0,360,0,360,356,4,400,40,238,118,
23,"IALOMITA",216,100683,,52,0,"Scoala gen. nr.3, str. Capitan Urzica, nr.29","MUNICIPIUL URZICENI",3,100683,1,1,1552,846,763,83,837,9,1700,854,557,280,
23,"IALOMITA",216,100683,,53,0,"Gradinita de copii, str. Panduri, nr.21","MUNICIPIUL URZICENI",3,100683,1,1,1644,856,817,39,845,11,1800,944,603,242,
23,"IALOMITA",216,100683,,54,0,"Casa de cultura, str. Regele Ferdinand, nr.73","MUNICIPIUL URZICENI",3,100683,1,1,785,412,383,29,408,4,900,488,278,130,
23,"IALOMITA",216,100683,,55,0,"Gradinita nr. 2 cu program prelungit, str. Revolutiei, nr.14","MUNICIPIUL URZICENI",3,100683,1,1,1041,595,559,36,595,0,1600,1005,418,177,
23,"IALOMITA",216,100683,,56,0,"Grup Scolar Industrial,,Sf. Ecaterina"" , str. Panduri, nr.57","MUNICIPIUL URZICENI",3,100683,1,1,1285,709,676,33,706,3,1500,791,453,253,
23,"IALOMITA",216,100683,,57,0,"Scoala generala nr.1, str. Aurora, nr.17","MUNICIPIUL URZICENI",3,100683,1,1,1515,803,722,81,791,12,1600,797,516,275,
23,"IALOMITA",216,100683,,58,0,"Clubul Sindicatelor, str. Calea Bucuresti, nr.72","MUNICIPIUL URZICENI",3,100683,1,1,1445,835,781,54,830,5,1600,765,583,247,
23,"IALOMITA",216,100683,,59,0,"Scoala generala nr.2, str. Calea Bucuresti, nr.102","MUNICIPIUL URZICENI",3,100683,1,1,1476,782,710,72,776,6,1600,818,513,263,
23,"IALOMITA",216,100683,,60,0,"Scoala generala nr.2, str. Calea Bucuresti, nr.102","MUNICIPIUL URZICENI",3,100683,1,1,1366,756,700,56,752,4,1500,744,549,203,
23,"IALOMITA",216,100683,,61,0,"Internat Liceul Teoretic, str. Al. Ioan Cuza, nr.11","MUNICIPIUL URZICENI",3,100683,1,1,1413,751,700,51,742,9,1600,849,465,277,
23,"IALOMITA",216,100683,,62,0,"Fabrica de Ceramica, str. Vanatori, nr.3","MUNICIPIUL URZICENI",3,100683,1,1,1282,724,634,90,715,9,1400,676,423,292,
23,"IALOMITA",216,92765,,63,0,"Grup Scolar Tandarei, str. Fetesti, nr.3","ORAS TANDAREI",4,92765,2,1,1295,677,646,31,672,5,1400,723,482,190,
23,"IALOMITA",216,92765,,64,0,"Liceul Teoretic ,,Paul Georgescu"", str. Ionel Perlea, nr.8","ORAS TANDAREI",4,92765,2,1,1604,931,850,81,921,10,1800,869,655,266,
23,"IALOMITA",216,92765,,65,0,"Scoala nr.4, str. Barierei, nr.10","ORAS TANDAREI",4,92765,2,1,1882,1050,983,67,1041,9,2200,1150,696,345,
23,"IALOMITA",216,92765,,66,0,"Scoala nr.4, str. Barierei, nr.10","ORAS TANDAREI",4,92765,2,1,1251,805,759,46,791,14,1400,595,566,225,
23,"IALOMITA",216,92765,,67,0,"Scoala nr.5, str. Narciselor, nr.32","ORAS TANDAREI",4,92765,2,1,1517,941,875,66,937,4,1702,761,657,280,
23,"IALOMITA",216,92765,,68,0,"Casa de cultura, str. Garii, nr.2","ORAS TANDAREI",4,92765,2,1,1172,703,659,44,690,4,1300,606,503,187,
23,"IALOMITA",216,92765,,69,0,"Scoala nr.2, str. Bucuresti, nr.20","ORAS TANDAREI",4,92765,2,1,1703,680,631,49,658,22,1900,1220,567,91,
23,"IALOMITA",216,100754,,70,0,"Gradinita de copii nr.1 Adancata","ADANCATA",5,100754,0,3,1756,1040,899,141,1031,9,1900,860,706,325,
23,"IALOMITA",216,100754,,71,0,"Scoala generala de opt clase Patru Frati","ADANCATA",5,100754,0,3,810,558,449,109,538,20,900,342,371,167,
23,"IALOMITA",216,92783,,72,0,"Scoala generala Albesti","ALBESTI",6,92783,0,3,635,357,284,73,351,6,700,343,248,103,
23,"IALOMITA",216,92783,,73,0,"Scoala generala Buiesti","ALBESTI",6,92783,0,3,1033,531,446,85,516,15,1200,669,311,205,
23,"IALOMITA",216,92783,,74,0,"Scoala generala Marsilieni","ALBESTI",6,92783,0,3,518,304,213,91,298,6,602,298,214,84,
23,"IALOMITA",216,100852,,75,0,"Scoala veche","ALEXENI",7,100852,0,3,1937,1040,917,123,1017,23,2100,1060,679,338,
23,"IALOMITA",216,92836,,76,0,"Gradinita de copii, str. Viilor","AMARA",8,92836,0,3,2604,1358,1267,91,1339,19,2800,1442,808,531,
23,"IALOMITA",216,92836,,77,0,"Scoala generala, str. T. Vladimirescu","AMARA",8,92836,0,3,2186,1099,993,106,1087,12,2400,1301,686,401,
23,"IALOMITA",216,92836,,78,0,"Caminul Cultural, str. Al. Ioan Cuza","AMARA",8,92836,0,3,1140,670,511,159,665,5,1300,630,417,248,
23,"IALOMITA",216,92872,,79,0,"Caminul Cultural Andrasesti","ANDRASESTI",9,92872,0,3,1791,970,845,125,956,14,2000,1030,573,383,
23,"IALOMITA",216,100870,,80,0,"Scoala Noua, Malu Rosu","ARMASESTI",10,100870,0,3,1492,735,676,59,705,30,1600,865,441,264,
23,"IALOMITA",216,100870,,81,0,"Scoala generala Armasesti","ARMASESTI",10,100870,0,3,542,365,286,79,359,6,600,235,210,149,
23,"IALOMITA",216,100870,,82,0,"Scoala Fotescu Barbulesti","ARMASESTI",10,100870,0,3,1576,771,719,52,731,40,1700,929,660,71,
23,"IALOMITA",216,100870,,83,0,"Scoala cu etaj , Barbulesti","ARMASESTI",10,100870,0,3,1011,545,510,35,472,73,1100,555,372,100,
23,"IALOMITA",216,100923,,84,0,"Primaria Axintele","AXINTELE",11,100923,0,3,696,370,289,81,356,14,800,430,296,60,
23,"IALOMITA",216,100923,,85,0,"Scoala generala nr. 2 , Frumusica","AXINTELE",11,100923,0,3,960,505,436,69,493,12,1100,595,308,185,
23,"IALOMITA",216,100923,,86,0,"Scoala generala nr.3, Horia","AXINTELE",11,100923,0,3,572,335,265,70,327,8,600,265,269,58,
23,"IALOMITA",216,92907,,87,0,"Caminul Cultural Balaciu","BALACIU",12,92907,0,3,943,475,356,119,467,8,1002,527,332,135,
23,"IALOMITA",216,92907,,88,0,"Scoala generala Sarateni","BALACIU",12,92907,0,3,1108,719,587,132,708,11,1300,581,475,233,
23,"IALOMITA",216,92907,,89,0,"Scoala Copuzu","BALACIU",12,92907,0,3,326,248,174,74,244,4,400,152,129,115,
23,"IALOMITA",216,92907,,90,0,"Caminul Cultural Crasanii de Jos","BALACIU",12,92907,0,3,473,261,167,94,254,7,600,339,180,74,
23,"IALOMITA",216,101056,,91,0,"Scoala generala Barcanesti","BARCANESTI",13,101056,0,3,1914,923,793,130,900,23,2100,1177,709,191,
23,"IALOMITA",216,101056,,92,0,"Scoala generala Condeesti","BARCANESTI",13,101056,0,3,1299,700,530,170,680,20,1400,700,487,193,
23,"IALOMITA",216,92989,,93,0,"Scoala veche Bordusani","BORDUSANI",14,92989,0,3,1704,948,769,179,931,17,1900,952,518,413,
23,"IALOMITA",216,92989,,94,0,"Scoala noua cu cls. I- VIII Bordusani","BORDUSANI",14,92989,0,3,1291,669,627,42,656,13,1400,731,372,284,
23,"IALOMITA",216,92989,,95,0,"Scoala generala Cegani","BORDUSANI",14,92989,0,3,975,659,568,91,648,11,1100,441,406,242,
23,"IALOMITA",216,101243,,96,0,"Scoala generala Brazii","BRAZII",15,101243,0,3,1260,632,535,97,617,15,1400,768,495,122,
23,"IALOMITA",216,101243,,97,0,"Scoala cu cls. I-IV Maia","BRAZII",15,101243,0,3,1615,957,851,106,934,23,1800,843,767,167,
23,"IALOMITA",216,93021,,98,0,"Caminul Cultural Bucu","BUCU",16,93021,0,3,1957,1074,904,170,1061,13,2200,1126,723,338,
23,"IALOMITA",216,93021,,99,0,"Gradinita de copii Ograda","BUCU",16,93021,0,3,1859,1163,929,234,1148,15,2100,937,780,368,
23,"IALOMITA",216,93067,,100,0,"Scoala generala nr.2 Cazanesti","CAZANESTI",17,93067,0,3,1476,838,704,134,829,9,1700,862,624,205,
23,"IALOMITA",216,93067,,101,0,"Grup Scolar Agricol Cazanesti","CAZANESTI",17,93067,0,3,1228,639,538,101,629,10,1200,561,457,172,
23,"IALOMITA",216,93101,,102,0,"Scoala generala Ciochina","CIOCHINA",19,93101,0,3,1461,716,605,111,705,11,1600,884,538,167,
23,"IALOMITA",216,93101,,103,0,"Scoala generala Borduselu","CIOCHINA",19,93101,0,3,725,430,362,68,427,3,800,370,340,87,
23,"IALOMITA",216,93101,,104,0,"Scoala Generala Orezu","CIOCHINA",19,93101,0,3,727,537,475,62,527,10,800,263,387,140,
23,"IALOMITA",216,100709,,105,0,"Scoala cu clasele I-IV Ciocarlia","CIOCARLIA",18,100709,0,3,698,430,384,46,426,4,800,370,291,135,
23,"IALOMITA",216,93156,,106,0,"Scoala cu clasele I-VIII Ciulnita","CIULNITA",20,93156,0,3,1214,755,647,108,725,30,1400,645,543,182,
23,"IALOMITA",216,93156,,107,0,"Scoala cu clasele I-VIII Poiana","CIULNITA",20,93156,0,3,697,514,377,137,508,6,800,286,388,120,
23,"IALOMITA",216,93209,,108,0,"Primaria Cocora","COCORA",21,93209,0,3,2063,1137,1043,94,1122,15,2200,1063,890,232,
23,"IALOMITA",216,93209,,109,0,"Scoala generala Colilia","COCORA",21,93209,0,3,1047,627,515,112,609,18,1200,573,449,160,
23,"IALOMITA",216,93236,,110,0,"Scoala generala Cosambesti","COSAMBESTI",22,93236,0,3,842,457,389,68,452,5,900,443,324,128,
23,"IALOMITA",216,93236,,111,0,"Scoala generala Gimbasani","COSAMBESTI",22,93236,0,3,628,516,420,96,511,5,800,284,339,172,
23,"IALOMITA",216,93236,,112,0,"Scoala generala Marculesti","COSAMBESTI",22,93236,0,3,1258,802,705,97,789,13,1400,598,581,208,
23,"IALOMITA",216,102240,,113,0,"Caminul Cultural Cosereni","COSERENI",23,102240,0,3,1431,903,729,174,871,32,1600,697,596,275,
23,"IALOMITA",216,102240,,114,0,"Scoala generala Cosereni","COSERENI",23,102240,0,3,1237,843,692,151,820,23,1400,557,600,220,
23,"IALOMITA",216,102240,,115,0,"Scoala generala nr.3 Patrime Cosereni","COSERENI",23,102240,0,3,1052,707,570,137,690,17,1200,493,491,199,
23,"IALOMITA",216,102240,,116,0,"Caminul Cultural Boranesti","COSERENI",23,102240,0,3,1740,935,813,122,906,29,1900,965,666,240,
23,"IALOMITA",216,102641,,117,0,"Caminul Cultural Dragoesti","DRAGOESTI",24,102641,0,3,890,540,428,112,521,19,1000,460,393,128,
23,"IALOMITA",216,102703,,118,0,"Scoala generala nr.1 Dridu","DRIDU",25,102703,0,3,2122,1033,883,150,1008,25,2100,1067,728,280,
23,"IALOMITA",216,102703,,119,0,"Gradinita de copii Dridu - Movila","DRIDU",25,102703,0,3,923,363,314,49,353,10,900,537,264,89,
23,"IALOMITA",216,102703,,120,0,"Scoala generala cu cls. I- VIII Moldoveni","DRIDU",25,102703,0,3,1110,655,576,79,649,6,1200,545,446,203,
23,"IALOMITA",216,102703,,121,0,"Scoala generala cu cls. I-IV Dridu - Snagov","DRIDU",25,102703,0,3,394,219,190,29,215,4,400,181,165,50,
23,"IALOMITA",216,93575,,122,0,"Scoala generala nr.1 Facaeni","FACAENI",26,93575,0,3,2163,1173,997,176,1157,16,2400,1227,712,445,
23,"IALOMITA",216,93575,,123,0,"Scoala generala nr.2 Facaeni","FACAENI",26,93575,0,3,1998,1040,892,148,1026,14,2200,1160,641,385,
23,"IALOMITA",216,93575,,124,0,"Scoala generala Progresu","FACAENI",26,93575,0,3,472,365,285,80,360,5,600,235,245,115,
23,"IALOMITA",216,102749,,125,0,"Caminul cultural Fierbinti -Targ","FIERBINTI-TARG",27,102749,0,3,1341,527,446,81,524,3,1500,973,379,145,
23,"IALOMITA",216,102749,,126,0,"Scoala generala cu cls. I-IV Fierbinti de Sus","FIERBINTI-TARG",27,102749,0,3,1566,803,691,112,789,14,1700,897,586,203,
23,"IALOMITA",216,102749,,127,0,"Scoala generala cu cls. I-IV Fierbinti de Jos","FIERBINTI-TARG",27,102749,0,3,1026,636,573,63,621,15,1100,464,450,171,
23,"IALOMITA",216,102749,,128,0,"S.C ,,ADICOM 2A""SRL","FIERBINTI-TARG",27,102749,0,3,273,211,149,62,206,5,300,89,111,95,
23,"IALOMITA",216,93600,,129,0,"Scoala generala nr.1 Gheorghe Doja","GHEORGHE DOJA",29,93600,0,3,1128,632,579,53,619,13,1300,668,443,176,
23,"IALOMITA",216,93600,,130,0,"Scoala generala nr.2 Gheorghe Doja","GHEORGHE DOJA",29,93600,0,3,1224,684,618,66,676,8,1400,716,491,185,
23,"IALOMITA",216,93628,,131,0,"Caminul Cultural Gheorghe Lazar","GHEORGHE LAZAR",30,93628,0,3,2060,1181,1078,103,1161,20,2200,1019,777,384,
23,"IALOMITA",216,93646,,132,0,"Scoala generala Giurgeni","GIURGENI",31,93646,0,3,1245,887,775,112,878,9,1600,713,558,320,
23,"IALOMITA",216,103283,,133,0,"Scoala generala nr.1 Garbovi","GARBOVI",28,103283,0,3,2152,1035,974,61,1013,22,2400,1365,728,285,
23,"IALOMITA",216,103283,,134,0,"Scoala generala nr.2 Garbovi","GARBOVI",28,103283,0,3,1620,802,736,66,780,22,1800,998,549,231,
23,"IALOMITA",216,93717,,135,0,"Caminul cultural Grindu","GRINDU",32,93717,0,3,1996,1183,1060,123,1163,20,2200,1017,978,185,
23,"IALOMITA",216,93735,,136,0,"Scoala cu cls. I-VIII Grivita","GRIVITA",33,93735,0,3,1151,637,579,58,626,11,1300,663,402,224,
23,"IALOMITA",216,93735,,137,0,"Scoala cu cls. I-VIII Grivita","GRIVITA",33,93735,0,3,1116,565,530,35,554,11,1300,735,353,201,
23,"IALOMITA",216,93735,,138,0,"Gradinita de copii Traian","GRIVITA",33,93735,0,3,1022,691,606,85,664,27,1100,409,438,226,
23,"IALOMITA",216,93735,,139,0,"Scoala cu cls. I-VIII Traian","GRIVITA",33,93735,0,3,1396,921,849,72,900,21,1500,579,701,199,
23,"IALOMITA",216,93735,,140,0,"Scoala cu cls. I - VIII Smirna","GRIVITA",33,93735,0,3,912,547,468,79,533,14,903,353,362,171,
23,"IALOMITA",216,103862,,141,0,"Scoala veche Ion Roata","ION ROATA",34,103862,0,3,1001,555,480,75,543,12,1100,545,426,117,
23,"IALOMITA",216,103862,,142,0,"Scoala generala Colinele","ION ROATA",34,103862,0,3,915,541,461,80,530,11,1000,459,375,155,
23,"IALOMITA",216,103862,,143,0,"Scoala generala Brosteni","ION ROATA",34,103862,0,3,1056,625,545,80,614,11,1200,575,497,117,
23,"IALOMITA",216,103960,,144,0,"Scoala generala nr.1 Jilavele","JILAVELE",35,103960,0,3,1502,882,765,117,867,15,1700,818,637,230,
23,"IALOMITA",216,103960,,145,0,"Scoala generala nr.2 Jilavele","JILAVELE",35,103960,0,3,1661,839,780,59,826,13,1800,961,593,233,
23,"IALOMITA",216,100736,,146,0,"Scoala Noua Manasia","MANASIA",36,100736,0,3,1897,977,871,106,959,18,2000,1023,660,299,
23,"IALOMITA",216,100736,,147,0,"Scoala Veche Manasia","MANASIA",36,100736,0,3,1829,1047,888,159,1035,12,2000,953,722,313,
23,"IALOMITA",216,93995,,148,0,"Scoala Mica M. Kogalniceanu","MIHAIL KOGALNICEANU",37,93995,0,3,1144,787,694,93,771,16,1600,813,570,201,
23,"IALOMITA",216,93995,,149,0,"Caminul cultural M. Kogalniceanu","MIHAIL KOGALNICEANU",37,93995,0,3,1264,875,771,104,856,19,1500,625,621,235,
23,"IALOMITA",216,93995,,150,0,"Scoala cu cls. I-VIII Luciu","MIHAIL KOGALNICEANU",37,93995,0,3,1119,827,722,105,805,22,1300,473,590,215,
23,"IALOMITA",216,93995,,151,0,"Caminul cultural Gura Ialomitei","MIHAIL KOGALNICEANU",37,93995,0,3,1039,715,638,77,704,11,1100,385,492,212,
23,"IALOMITA",216,94045,,152,0,"Scoala generala Milosesti","MILOSESTI",38,94045,0,3,1683,955,863,92,944,11,1800,845,726,218,
23,"IALOMITA",216,94045,,153,0,"Scoala generala Nicolesti","MILOSESTI",38,94045,0,3,443,271,208,63,265,6,500,229,176,89,
23,"IALOMITA",216,94045,,154,0,"Scoala generala Tovarasia","MILOSESTI",38,94045,0,3,385,304,203,101,296,8,400,96,205,91,
23,"IALOMITA",216,94081,,155,0,"Scoala generala Movila","MOVILA",39,94081,0,3,1566,931,846,85,918,13,1700,769,607,311,
23,"IALOMITA",216,104270,,156,0,"Scoala generala Movilita","MOVILITA",40,104270,0,3,1190,665,573,92,647,18,1300,635,509,138,
23,"IALOMITA",216,104270,,157,0,"Scoala generala Movilita","MOVILITA",40,104270,0,3,873,363,293,70,353,10,1000,637,244,109,
23,"IALOMITA",216,104270,,158,0,"Primaria Rosiori","MOVILITA",40,104270,0,3,1625,945,798,147,912,33,1800,855,745,167,
23,"IALOMITA",216,94107,,159,0,"Scoala generala nr.1","MUNTENI-BUZAU",41,94107,0,3,1784,920,760,160,905,15,1900,980,718,187,
23,"IALOMITA",216,94107,,160,0,"Scoala generala nr.2","MUNTENI-BUZAU",41,94107,0,3,1370,801,658,143,789,12,1500,699,585,204,
23,"IALOMITA",216,94161,,161,0,"Scoala generala Perieti","PERIETI",42,94161,0,3,1673,800,691,109,789,11,1800,1000,554,235,
23,"IALOMITA",216,94161,,162,0,"Scoala generala Stejaru","PERIETI",42,94161,0,3,712,450,368,82,443,7,800,350,286,157,
23,"IALOMITA",216,94161,,163,0,"Scoala generala Fundata","PERIETI",42,94161,0,3,260,216,137,79,213,3,300,84,117,96,
23,"IALOMITA",216,94269,,164,0,"Scoala generala Reviga","REVIGA",43,94269,0,3,1591,818,670,148,796,22,1700,882,642,154,
23,"IALOMITA",216,94269,,165,0,"Scoala generala Rovine","REVIGA",43,94269,0,3,804,572,427,145,555,17,900,328,424,131,
23,"IALOMITA",216,94269,,166,0,"Scoala generala Crunti","REVIGA",43,94269,0,3,529,493,410,83,485,8,600,107,378,107,
23,"IALOMITA",216,94330,,167,0,"Scoala generala Salcioara","SALCIOARA",44,94330,0,3,979,591,515,76,580,11,1100,509,445,135,
23,"IALOMITA",216,94330,,168,0,"Scoala generala Rasi","SALCIOARA",44,94330,0,3,991,736,658,78,722,14,1100,364,587,135,
23,"IALOMITA",216,94376,,169,0,"Caminul cultural Saveni","SAVENI",45,94376,0,3,1431,822,747,75,813,9,1600,778,549,264,
23,"IALOMITA",216,94376,,170,0,"Scoala generala Saveni","SAVENI",45,94376,0,3,1286,796,721,75,789,7,1400,604,550,239,
23,"IALOMITA",216,94376,,171,0,"Scoala generala Fratilesti","SAVENI",45,94376,0,3,380,269,224,45,265,4,400,131,172,93,
23,"IALOMITA",216,94376,,172,0,"C.A.P Platonesti","SAVENI",45,94376,0,3,1479,921,750,171,906,15,1600,679,672,234,
23,"IALOMITA",216,94429,,173,0,"Scoala generala Scanteia","SCANTEIA",46,94429,0,3,2507,1546,1412,134,1518,28,2700,1154,1233,285,
23,"IALOMITA",216,94429,,174,0,"Gradinita de copii Iazu","SCANTEIA",46,94429,0,3,917,683,525,158,679,4,1000,317,533,146,
23,"IALOMITA",216,94456,,175,0,"Caminul cultural Sfantu Gheorghe","SFANTU GHEORGHE",47,94456,0,3,798,490,376,114,477,13,900,410,361,116,
23,"IALOMITA",216,94456,,176,0,"Caminul cultural Malu","SFANTU GHEORGHE",47,94456,0,3,882,525,415,110,509,16,900,375,410,99,
23,"IALOMITA",216,105026,,177,0,"Scoala generala I-IV Sinesti","SINESTI",48,105026,0,3,1088,583,470,113,574,9,1200,617,328,246,
23,"IALOMITA",216,102240,,178,0,"Scoala generala I-IV Lilieci","COSERENI",23,102240,0,3,892,405,268,137,393,12,1000,595,237,156,
23,"IALOMITA",216,94492,,179,0,"Primaria Stelnica","STELNICA",49,94492,0,3,1380,828,740,88,809,19,1500,672,505,304,
23,"IALOMITA",216,94535,,180,0,"Scoala generala Suditi","SUDITI",50,94535,0,3,1839,1290,1212,78,1203,9,2000,788,761,442,
23,"IALOMITA",216,94688,,181,0,"Primaria Valea Ciorii","VALEA CIORII",51,94688,0,3,1465,994,797,197,980,14,1600,606,781,199,
23,"IALOMITA",216,105794,,182,0,"Caminul cultural Valea Macrisului","VALEA MACRISULUI",52,105794,0,3,1358,793,721,72,778,15,1500,707,639,139,
23,"IALOMITA",216,105794,,183,0,"Caminul cultural Grindasi","VALEA MACRISULUI",52,105794,0,3,488,337,273,64,326,11,600,263,253,73,
23,"IALOMITA",216,94795,,184,0,"Scoala generala Vladeni","VLADENI",53,94795,0,3,1709,1635,1505,130,1379,256,1900,265,1351,28,
24,"IASI",225,95060,,1,0,"ALEEA PACURARI NR.2","MUNICIPIUL IASI",1,95060,1,1,1916,1100,1012,88,1072,14,2300,1214,721,351,
24,"IASI",225,95060,,2,0,"ALEEA CANTA NR.10","MUNICIPIUL IASI",1,95060,1,1,1694,976,928,48,964,12,1900,924,636,328,
24,"IASI",225,95060,,3,0,"ALEEA CANTA NR.10","MUNICIPIUL IASI",1,95060,1,1,1255,766,688,78,753,13,1300,534,525,228,
24,"IASI",225,95060,,4,0,"ALEEA CANTA NR.10","MUNICIPIUL IASI",1,95060,1,1,1695,1137,946,191,1123,14,1800,663,799,324,
24,"IASI",225,95060,,5,0,"ALEEA CANTA NR.10","MUNICIPIUL IASI",1,95060,1,1,1681,1072,917,155,1054,18,1800,728,729,325,
24,"IASI",225,95060,,6,0,"Str.CAZARMILOR NR.3","MUNICIPIUL IASI",1,95060,1,1,1507,821,781,40,815,6,1700,879,594,221,
24,"IASI",225,95060,,7,0,"Str.PACURARI Nr.178","MUNICIPIUL IASI",1,95060,1,1,1477,899,812,87,881,18,1600,701,581,300,
24,"IASI",225,95060,,8,0,"Str.CAZARMILOR Nr.3","MUNICIPIUL IASI",1,95060,1,1,1363,728,680,48,723,5,1500,772,496,227,
24,"IASI",225,95060,,9,0,"ALEEA CANTA Nr.7","MUNICIPIUL IASI",1,95060,1,1,1412,835,738,97,826,9,1500,665,620,206,
24,"IASI",225,95060,,10,0,"ALEEA CANTA NR.10","MUNICIPIUL IASI",1,95060,1,1,1331,814,754,60,807,7,1400,586,572,235,
24,"IASI",225,95060,,11,0,"Str.PACURARI Nr.112","MUNICIPIUL IASI",1,95060,1,1,1806,1029,899,130,1018,11,2000,971,707,311,
24,"IASI",225,95060,,12,0,"Str.PACURARI Nr.112","MUNICIPIUL IASI",1,95060,1,1,1488,859,791,68,843,16,1700,841,634,209,
24,"IASI",225,95060,,13,0,"Str.PACURARI Nr.178","MUNICIPIUL IASI",1,95060,1,1,1156,661,622,39,643,18,1300,639,469,174,
24,"IASI",225,95060,,14,0,"Str.PACURARI Nr.178","MUNICIPIUL IASI",1,95060,1,1,1343,743,685,58,737,6,1500,757,538,199,
24,"IASI",225,95060,,15,0,"Str.PACURARI Nr.112","MUNICIPIUL IASI",1,95060,1,1,1155,700,602,98,688,12,1300,600,541,147,
24,"IASI",225,95060,,16,0,"Str.PACURARI Nr.112","MUNICIPIUL IASI",1,95060,1,1,1162,657,616,41,645,12,1300,643,508,137,
24,"IASI",225,95060,,17,0,"Str.STRAPUNGEREA SILVESTRU Nr.12 A","MUNICIPIUL IASI",1,95060,1,1,1574,996,909,87,982,14,1700,702,764,218,
24,"IASI",225,95060,,18,0,"Str.STRAPUNGEREA SILVESTRU Nr.12 A","MUNICIPIUL IASI",1,95060,1,1,1332,756,720,36,743,13,1500,744,507,236,
24,"IASI",225,95060,,19,0,"Str.STRAPUNGEREA SILVESTRU Nr.12 A","MUNICIPIUL IASI",1,95060,1,1,978,723,610,113,709,14,1100,377,547,162,
24,"IASI",225,95060,,20,0,"Str.STRAPUNGEREA SILVESTRU Nr.12 A","MUNICIPIUL IASI",1,95060,1,1,1243,769,735,34,747,22,1300,531,560,187,
24,"IASI",225,95060,,21,0,"CASA STUDENTILOR PIATA M.EMINESCU","MUNICIPIUL IASI",1,95060,1,1,977,639,521,118,631,8,1100,461,479,152,
24,"IASI",225,95060,,22,0,"Str.ARCU Nr.2","MUNICIPIUL IASI",1,95060,1,1,1341,879,790,89,857,22,1500,621,654,203,
24,"IASI",225,95060,,23,0,"Str.HORIA Nr.10","MUNICIPIUL IASI",1,95060,1,1,1436,885,812,73,870,15,1600,715,650,220,
24,"IASI",225,95060,,24,0,"Str.ARCU Nr.2","MUNICIPIUL IASI",1,95060,1,1,981,738,646,92,714,24,1100,362,567,147,
24,"IASI",225,95060,,25,0,"Str.HORIA Nr.10","MUNICIPIUL IASI",1,95060,1,1,1141,784,680,104,770,14,1300,516,613,157,
24,"IASI",225,95060,,26,0,"Str.SF.ANDREI Nr.73","MUNICIPIUL IASI",1,95060,1,1,1175,626,568,58,610,16,1299,673,457,153,
24,"IASI",225,95060,,27,0,"Sc.G-la 1 'Gh.ASACHI'","MUNICIPIUL IASI",1,95060,1,1,1085,722,613,109,713,9,1204,482,568,145,
24,"IASI",225,95060,,28,0,"Str.TOMA COZMA Nr.4","MUNICIPIUL IASI",1,95060,1,1,967,656,565,91,636,20,1100,444,489,147,
24,"IASI",225,95060,,29,0,"Str.TOMA COZMA Nr.4","MUNICIPIUL IASI",1,95060,1,1,988,680,597,83,650,30,1100,420,515,135,
24,"IASI",225,95060,,30,0,"Str.OASTEI Nr.1","MUNICIPIUL IASI",1,95060,1,1,957,627,580,47,610,17,1100,473,518,92,
24,"IASI",225,95060,,31,0,"Str.OASTEI Nr.1","MUNICIPIUL IASI",1,95060,1,1,817,587,507,80,567,20,1000,413,448,119,
24,"IASI",225,95060,,32,0,"Aleea M.SADOVEANU Nr.3","MUNICIPIUL IASI",1,95060,1,1,1214,776,697,79,763,13,1300,524,596,167,
24,"IASI",225,95060,,33,0,"Str.SARARIEI Nr.189","MUNICIPIUL IASI",1,95060,1,1,1136,771,565,206,759,12,1200,429,548,211,
24,"IASI",225,95060,,34,0,"Str.OASTEI Nr.1","MUNICIPIUL IASI",1,95060,1,1,1145,797,709,88,781,16,1200,403,643,138,
24,"IASI",225,95060,,35,0,"Str.BALCESCU Nr.10","MUNICIPIUL IASI",1,95060,1,1,1080,675,615,60,660,15,1200,525,539,121,
24,"IASI",225,95060,,36,0,"Str.BALCESCU Nr.10","MUNICIPIUL IASI",1,95060,1,1,1151,698,607,91,679,19,1300,602,521,158,
24,"IASI",225,95060,,37,0,"Str.Sf.TEODOR","MUNICIPIUL IASI",1,95060,1,1,1323,874,799,75,857,17,1500,626,669,188,
24,"IASI",225,95060,,38,0,"B-dul C.A.ROSETTI Nr.12","MUNICIPIUL IASI",1,95060,1,1,1488,791,735,56,783,8,1600,809,561,222,
24,"IASI",225,95060,,39,0,"Str.SARARIEI Nr.35","MUNICIPIUL IASI",1,95060,1,1,1011,537,496,41,529,8,1100,563,389,140,
24,"IASI",225,95060,,40,0,"Str.SARARIEI Nr.35","MUNICIPIUL IASI",1,95060,1,1,1015,625,595,30,615,10,1100,475,460,155,
24,"IASI",225,95060,,41,0,"Str.GHICA VODA Nr.24","MUNICIPIUL IASI",1,95060,1,1,1513,878,827,51,867,11,1700,822,644,223,
24,"IASI",225,95060,,42,0,"B-dul C.A.ROSETTI Nr.2","MUNICIPIUL IASI",1,95060,1,1,1320,714,588,126,701,13,1500,786,503,198,
24,"IASI",225,95060,,43,0,"Str.CIRIC Nr.23A","MUNICIPIUL IASI",1,95060,1,1,1113,505,462,43,499,6,1200,695,358,141,
24,"IASI",225,95060,,44,0,"Str.ETERNITATE Nr.37","MUNICIPIUL IASI",1,95060,1,1,1011,623,535,88,611,12,1200,577,427,184,
24,"IASI",225,95060,,45,0,"Str.ETERNITATE Nr.37","MUNICIPIUL IASI",1,95060,1,1,1460,840,735,105,825,15,1600,760,618,207,
24,"IASI",225,95060,,46,0,"Str.I.CREANGA Nr.27","MUNICIPIUL IASI",1,95060,1,1,1291,836,714,122,814,22,1400,564,640,174,
24,"IASI",225,95060,,47,0,"Str.I.CREANGA Nr.27","MUNICIPIUL IASI",1,95060,1,1,1248,739,664,75,725,14,1400,661,556,169,
24,"IASI",225,95060,,48,0,"Str.I.CREANGA Nr.37","MUNICIPIUL IASI",1,95060,1,1,1059,728,648,80,719,9,1200,472,574,145,
24,"IASI",225,95060,,49,0,"Str.I.CREANGA Nr.37","MUNICIPIUL IASI",1,95060,1,1,1003,593,566,27,579,14,1100,507,437,142,
24,"IASI",225,95060,,50,0,"Str.I.CREANGA Nr.37","MUNICIPIUL IASI",1,95060,1,1,1337,813,753,60,788,23,1500,689,603,185,
24,"IASI",225,95060,,51,0,"Str.CIRIC Nr.23A","MUNICIPIUL IASI",1,95060,1,1,1034,585,521,64,575,10,1200,615,433,142,
24,"IASI",225,95060,,52,0,"Str.CIRIC Nr.23A","MUNICIPIUL IASI",1,95060,1,1,1761,893,840,53,879,14,1900,1007,658,221,
24,"IASI",225,95060,,53,0,"Str.I.CREANGA Nr.109","MUNICIPIUL IASI",1,95060,1,1,1097,712,610,102,702,10,1200,488,553,149,
24,"IASI",225,95060,,54,0,"Str.I.CREANGA Nr.37","MUNICIPIUL IASI",1,95060,1,1,1111,699,657,42,685,14,1184,484,541,144,
24,"IASI",225,95060,,55,0,"Str.I.CREANGA Nr.109","MUNICIPIUL IASI",1,95060,1,1,1529,909,772,137,900,9,1600,691,604,296,
24,"IASI",225,95060,,56,0,"B-dul CHIMIEI (SALA SPORTURILOR)","MUNICIPIUL IASI",1,95060,1,1,1307,670,613,57,665,5,1400,730,464,201,
24,"IASI",225,95060,,57,0,"B-dul CHIMIEI (SALA SPORTURILOR)","MUNICIPIUL IASI",1,95060,1,1,1826,1030,951,79,1017,13,2000,970,715,302,
24,"IASI",225,95060,,58,0,"B-dul CHIMIEI (SALA SPORTURILOR)","MUNICIPIUL IASI",1,95060,1,1,1632,954,826,128,945,9,1778,824,657,288,
24,"IASI",225,95060,,59,0,"B-dul CHIMIEI (SALA SPORTURILOR)","MUNICIPIUL IASI",1,95060,1,1,2025,1041,963,78,1022,19,2200,1159,715,307,
24,"IASI",225,95060,,60,0,"Str.I.CREANGA Nr.109","MUNICIPIUL IASI",1,95060,1,1,1357,567,530,37,560,7,1500,933,399,161,
24,"IASI",225,95060,,61,0,"Str.I.CREANGA Nr.109","MUNICIPIUL IASI",1,95060,1,1,799,565,428,137,547,18,900,335,418,129,
24,"IASI",225,95060,,62,0,"Str.VASILE LUPU Nr.110B","MUNICIPIUL IASI",1,95060,1,1,1007,563,512,51,552,11,1100,537,419,133,
24,"IASI",225,95060,,63,0,"Str.VASILE LUPU Nr.110B","MUNICIPIUL IASI",1,95060,1,1,1222,704,608,96,682,22,1400,696,521,161,
24,"IASI",225,95060,,64,0,"Str.VASILE LUPU Nr.110B","MUNICIPIUL IASI",1,95060,1,1,1772,1070,929,141,1053,17,1900,830,789,264,
24,"IASI",225,95060,,65,0,"Str.CIORNEI Nr.10","MUNICIPIUL IASI",1,95060,1,1,1290,708,658,50,699,9,1400,692,531,168,
24,"IASI",225,95060,,66,0,"Str.VASILE LUPU Nr.110B","MUNICIPIUL IASI",1,95060,1,1,1273,781,715,66,763,18,1400,619,594,169,
24,"IASI",225,95060,,67,0,"Str.CIORNEI Nr.10","MUNICIPIUL IASI",1,95060,1,1,1573,914,848,66,910,4,1700,786,682,228,
24,"IASI",225,95060,,68,0,"Str.VASILE LUPU Nr.110B","MUNICIPIUL IASI",1,95060,1,1,1322,789,737,52,771,18,1500,711,598,173,
24,"IASI",225,95060,,69,0,"Str.CIORNEI Nr.10","MUNICIPIUL IASI",1,95060,1,1,1609,941,916,25,929,12,1700,759,692,237,
24,"IASI",225,95060,,70,0,"Str.CIORNEI Nr.10","MUNICIPIUL IASI",1,95060,1,1,1396,578,540,38,567,11,1400,822,413,154,
24,"IASI",225,95060,,71,0,"B-dul D.MANGRRON Nr.71","MUNICIPIUL IASI",1,95060,1,1,1063,942,604,338,923,19,1300,358,712,211,
24,"IASI",225,95060,,72,0,"Str.I.CREANGA Nr.27","MUNICIPIUL IASI",1,95060,1,1,995,596,490,106,591,5,1100,504,453,138,
24,"IASI",225,95060,,73,0,"Str.GHICA VODA Nr.24","MUNICIPIUL IASI",1,95060,1,1,1238,748,631,117,738,10,1300,552,576,162,
24,"IASI",225,95060,,74,0,"B-dul D.MANGRRON Nr.43","MUNICIPIUL IASI",1,95060,1,1,1312,849,783,66,823,26,1400,551,593,230,
24,"IASI",225,95060,,75,0,"B-dul D.MANGRRON Nr.43","MUNICIPIUL IASI",1,95060,1,1,1556,1012,938,74,990,22,1700,688,786,204,
24,"IASI",225,95060,,76,0,"Str.C.NEGRI Nr.50","MUNICIPIUL IASI",1,95060,1,1,846,561,462,99,555,6,900,339,437,118,
24,"IASI",225,95060,,77,0,"Str.C.NEGRI Nr.50","MUNICIPIUL IASI",1,95060,1,1,1226,795,748,47,788,7,1300,505,668,120,
24,"IASI",225,95060,,78,0,"Str.I.C.BRATIANU Nr.26","MUNICIPIUL IASI",1,95060,1,1,1231,750,650,100,735,15,1400,650,557,178,
24,"IASI",225,95060,,79,0,"Str.C.NEGRI Nr.50","MUNICIPIUL IASI",1,95060,1,1,1319,838,769,69,800,38,1400,562,629,171,
24,"IASI",225,95060,,80,0,"Str.I.C.BRATIANU Nr.1","MUNICIPIUL IASI",1,95060,1,1,1230,854,755,99,833,21,1300,446,662,171,
24,"IASI",225,95060,,81,0,"Str.PRIMAVERII Nr.38","MUNICIPIUL IASI",1,95060,1,1,1384,724,627,97,712,12,1500,776,517,195,
24,"IASI",225,95060,,82,0,"Str.PRIMAVERII Nr.38","MUNICIPIUL IASI",1,95060,1,1,1026,603,568,35,588,15,1100,497,462,126,
24,"IASI",225,95060,,83,0,"Str.PRIMAVERII Nr.38","MUNICIPIUL IASI",1,95060,1,1,1246,780,734,46,768,12,1300,520,626,142,
24,"IASI",225,95060,,84,0,"B-dul SOCOLA Nr.13","MUNICIPIUL IASI",1,95060,1,1,1322,729,682,47,699,30,1500,771,531,168,
24,"IASI",225,95060,,85,0,"B-dul SOCOLA Nr.13","MUNICIPIUL IASI",1,95060,1,1,1235,848,798,50,829,19,1300,452,642,187,
24,"IASI",225,95060,,86,0,"B-dul SOCOLA Nr.13","MUNICIPIUL IASI",1,95060,1,1,1219,722,686,36,714,8,1300,578,516,198,
24,"IASI",225,95060,,87,0,"B-dul SOCOLA Nr.13","MUNICIPIUL IASI",1,95060,1,1,1116,642,606,36,639,3,1200,558,477,162,
24,"IASI",225,95060,,88,0,"Aleea NICOLINA Nr.3","MUNICIPIUL IASI",1,95060,1,1,1370,848,776,72,834,14,1500,652,655,179,
24,"IASI",225,95060,,89,0,"Aleea NICOLINA Nr.3","MUNICIPIUL IASI",1,95060,1,1,1324,869,767,102,852,17,1500,631,681,171,
24,"IASI",225,95060,,90,0,"Aleea NICOLINA Nr.3","MUNICIPIUL IASI",1,95060,1,1,1273,781,715,66,763,18,1400,619,594,169,
24,"IASI",225,95060,,91,0,"Aleea NICOLINA Nr.3","MUNICIPIUL IASI",1,95060,1,1,876,575,522,53,561,14,1000,425,419,142,
24,"IASI",225,95060,,92,0,"Str.DECEBAL Nr.13","MUNICIPIUL IASI",1,95060,1,1,1467,815,766,49,798,17,1600,785,609,189,
24,"IASI",225,95060,,93,0,"Str.DECEBAL Nr.13","MUNICIPIUL IASI",1,95060,1,1,853,583,513,70,567,16,900,317,443,124,
24,"IASI",225,95060,,94,0,"Str.DECEBAL Nr.13","MUNICIPIUL IASI",1,95060,1,1,1825,1080,1039,41,1052,28,2004,924,829,223,
24,"IASI",225,95060,,95,0,"Str.DECEBAL Nr.13","MUNICIPIUL IASI",1,95060,1,1,1110,693,596,97,678,15,1200,507,531,147,
24,"IASI",225,95060,,96,0,"Aleea DECEBAL Nr.10","MUNICIPIUL IASI",1,95060,1,1,858,625,480,145,614,11,900,275,468,146,
24,"IASI",225,95060,,97,0,"Aleea DECEBAL Nr.10","MUNICIPIUL IASI",1,95060,1,1,964,573,501,72,560,13,1100,527,430,130,
24,"IASI",225,95060,,98,0,"Aleea DECEBAL Nr.10","MUNICIPIUL IASI",1,95060,1,1,768,466,412,54,458,8,800,334,367,91,
24,"IASI",225,95060,,99,0,"SOS.NATIONALA Nr.45","MUNICIPIUL IASI",1,95060,1,1,853,579,508,71,569,10,900,321,437,132,
24,"IASI",225,95060,,100,0,"Str.ROMANA Nr.30","MUNICIPIUL IASI",1,95060,1,1,1067,707,645,62,696,11,1100,393,546,150,
24,"IASI",225,95060,,101,0,"Str.ROMANA Nr.30","MUNICIPIUL IASI",1,95060,1,1,955,589,542,47,583,6,1000,411,467,116,
24,"IASI",225,95060,,102,0,"Str.ROMANA Nr.30","MUNICIPIUL IASI",1,95060,1,1,1221,650,603,47,631,19,1300,650,469,162,
24,"IASI",225,95060,,103,0,"Str.ROMANA Nr.30","MUNICIPIUL IASI",1,95060,1,1,1230,742,640,102,730,12,1300,558,543,187,
24,"IASI",225,95060,,104,0,"B-dul SOCOLA Nr.113","MUNICIPIUL IASI",1,95060,1,1,1928,1553,996,557,1537,16,2500,947,1027,510,
24,"IASI",225,95060,,105,1,"Str.AEROPORTULUI Nr.2","MUNICIPIUL IASI",1,95060,1,1,196,293,165,128,283,10,500,207,145,138,
24,"IASI",225,95060,,106,0,"B-dul SOCOLA Nr.53","MUNICIPIUL IASI",1,95060,1,1,2070,1409,931,478,1387,22,2200,791,820,567,
24,"IASI",225,95060,,107,1,"B-dul CAROL Nr.5","MUNICIPIUL IASI",1,95060,1,1,128,322,116,206,315,7,600,278,204,111,
24,"IASI",225,95060,,108,0,"Str.BUCIUM Nr.17","MUNICIPIUL IASI",1,95060,1,1,1956,1172,1037,135,1163,9,2100,928,780,383,
24,"IASI",225,95060,,109,0,"Str.BUCIUM Nr.17","MUNICIPIUL IASI",1,95060,1,1,1717,1002,885,117,986,16,1900,898,706,280,
24,"IASI",225,95060,,110,0,"Str.MIHAIL STURZA Nr.43","MUNICIPIUL IASI",1,95060,1,1,1463,1078,766,312,1064,14,1600,522,759,305,
24,"IASI",225,95060,,111,0,"SOS.BUCIUM Nr.72","MUNICIPIUL IASI",1,95060,1,1,1896,1288,1010,278,1265,23,2100,812,897,368,
24,"IASI",225,95060,,112,0,"B-dul POITIERS Nr.41","MUNICIPIUL IASI",1,95060,1,1,1755,1098,828,270,1089,9,1900,802,672,417,
24,"IASI",225,95060,,113,0,"B-dul POITIERS Nr.41","MUNICIPIUL IASI",1,95060,1,1,1817,1064,820,244,1050,14,1900,836,654,396,
24,"IASI",225,95060,,114,0,"Str.CETATUIA Nr.3","MUNICIPIUL IASI",1,95060,1,1,1578,920,849,71,908,12,1700,780,571,337,
24,"IASI",225,95060,,115,0,"Str.CETATUIA Nr.3","MUNICIPIUL IASI",1,95060,1,1,2038,1113,1032,81,1102,11,2100,987,763,339,
24,"IASI",225,95060,,116,1,"Str.ZUGRAVI Nr.37","MUNICIPIUL IASI",1,95060,1,1,0,553,0,553,536,17,600,47,373,163,
24,"IASI",225,95060,,117,0,"PASAJ NICOLINA","MUNICIPIUL IASI",1,95060,1,1,1520,908,831,77,902,6,1600,692,651,251,
24,"IASI",225,95060,,118,0,"PASAJ NICOLINA","MUNICIPIUL IASI",1,95060,1,1,1709,971,910,61,953,18,1800,829,647,306,
24,"IASI",225,95060,,119,0,"Str.LIBERTATII Nr.24","MUNICIPIUL IASI",1,95060,1,1,1876,1050,985,65,1038,12,1996,946,741,297,
24,"IASI",225,95060,,120,0,"Str.LIBERTATII Nr.24","MUNICIPIUL IASI",1,95060,1,1,1337,765,709,56,757,8,1400,635,484,273,
24,"IASI",225,95060,,121,0,"Str.LIBERTATII Nr.24","MUNICIPIUL IASI",1,95060,1,1,1971,1121,1073,48,1106,15,2100,979,677,429,
24,"IASI",225,95060,,122,0,"Str.LIBERTATII Nr.24","MUNICIPIUL IASI",1,95060,1,1,2042,1045,1002,43,1029,16,2200,1155,710,319,
24,"IASI",225,95060,,123,0,"Aleea NICOLINA Nr.167","MUNICIPIUL IASI",1,95060,1,1,1178,682,588,94,671,11,1300,618,474,197,
24,"IASI",225,95060,,124,0,"Aleea NICOLINA Nr.167","MUNICIPIUL IASI",1,95060,1,1,1622,886,827,59,872,14,1800,914,586,286,
24,"IASI",225,95060,,125,0,"SOS. NICOLINA Nr.56","MUNICIPIUL IASI",1,95060,1,1,1786,1003,870,133,994,9,1900,897,714,280,
24,"IASI",225,95060,,126,0,"Str.HLINCEA Nr.7","MUNICIPIUL IASI",1,95060,1,1,1443,783,728,55,776,7,1600,817,497,279,
24,"IASI",225,95060,,127,0,"Str.HLINCEA Nr.7","MUNICIPIUL IASI",1,95060,1,1,1512,804,732,72,795,9,1600,796,556,239,
24,"IASI",225,95060,,128,0,"PAVILIONUL ADMINISTRATIV 'FORTUS'","MUNICIPIUL IASI",1,95060,1,1,1793,998,906,92,985,13,1900,902,639,346,
24,"IASI",225,95060,,129,0,"Str.HLINCEA Nr.7","MUNICIPIUL IASI",1,95060,1,1,2013,1055,999,56,1044,11,2200,1145,714,330,
24,"IASI",225,95060,,130,0,"Str.HLINCEA Nr.7","MUNICIPIUL IASI",1,95060,1,1,1933,992,940,52,970,22,2100,1108,665,305,
24,"IASI",225,95060,,131,0,"Aleea NICOLINA Nr.167","MUNICIPIUL IASI",1,95060,1,1,1359,723,654,69,713,10,1500,777,502,211,
24,"IASI",225,95060,,132,0,"Aleea NICOLINA Nr.167","MUNICIPIUL IASI",1,95060,1,1,2012,1135,1044,91,1122,13,2100,965,796,326,
24,"IASI",225,95060,,133,0,"Str.GH.DOJA Nr.2","MUNICIPIUL IASI",1,95060,1,1,1945,1126,1001,125,1112,14,2100,974,821,291,
24,"IASI",225,95060,,134,0,"Str.PANTELIMON HALIPA (TROTUS) Nr.16","MUNICIPIUL IASI",1,95060,1,1,1565,903,836,67,891,12,1700,797,642,249,
24,"IASI",225,95060,,135,0,"Str.GH.DOJA Nr.2","MUNICIPIUL IASI",1,95060,1,1,1350,818,777,41,807,11,1400,582,535,272,
24,"IASI",225,95060,,136,0,"Str.GH.DOJA Nr.2","MUNICIPIUL IASI",1,95060,1,1,1602,940,885,55,924,16,1700,760,660,264,
24,"IASI",225,95060,,137,0,"Str.PANTELIMON HALIPA (TROTUS) Nr.16","MUNICIPIUL IASI",1,95060,1,1,2130,1118,979,139,1095,23,2300,1182,761,334,
24,"IASI",225,95060,,138,0,"Cal.GALATA Nr42","MUNICIPIUL IASI",1,95060,1,1,1761,1094,1059,35,1079,15,1900,806,760,319,
24,"IASI",225,95060,,139,0,"Cal.GALATA Nr42","MUNICIPIUL IASI",1,95060,1,1,1446,891,847,44,882,9,1600,709,621,261,
24,"IASI",225,95060,,140,0,"Cal.GALATA Nr42","MUNICIPIUL IASI",1,95060,1,1,1552,874,762,112,865,9,1700,826,606,259,
24,"IASI",225,95060,,141,0,"Cal.GALATA Nr42","MUNICIPIUL IASI",1,95060,1,1,1455,872,821,51,862,10,1600,728,617,245,
24,"IASI",225,95060,,142,0,,"MUNICIPIUL IASI",1,95060,1,1,1648,822,736,86,811,11,1800,978,562,249,
24,"IASI",225,95060,,143,0,"Str.CICOAREI Nr.43","MUNICIPIUL IASI",1,95060,1,1,1366,804,662,142,795,9,1500,696,547,248,
24,"IASI",225,95060,,144,0,"Str.MUSATINI Nr.2","MUNICIPIUL IASI",1,95060,1,1,1466,914,829,85,904,10,1600,686,627,277,
24,"IASI",225,95060,,145,0,"SOS.NATIONALA Nr.145","MUNICIPIUL IASI",1,95060,1,1,1285,882,743,139,876,6,1700,818,642,234,
24,"IASI",225,95060,,146,0,"SOS.NATIONALA Nr.145","MUNICIPIUL IASI",1,95060,1,1,1597,981,855,126,969,12,1700,719,690,279,
24,"IASI",225,95060,,147,0,"SOS.NATIONALA Nr.64","MUNICIPIUL IASI",1,95060,1,1,1440,863,779,84,843,20,1800,937,624,219,
24,"IASI",225,95060,,148,0,"SOS.NATIONALA Nr.64","MUNICIPIUL IASI",1,95060,1,1,1814,903,822,81,893,10,2000,1097,637,256,
24,"IASI",225,95060,,149,1,"Str.Dr.VICOL Nr.10","MUNICIPIUL IASI",1,95060,1,1,595,592,559,33,566,24,700,108,468,98,
24,"IASI",225,95060,,150,0,"Str.PLAIESILOR Nr.9","MUNICIPIUL IASI",1,95060,1,1,1582,910,824,86,890,20,1700,790,631,259,
24,"IASI",225,95060,,151,0,"Str.PLAIESILOR Nr.11","MUNICIPIUL IASI",1,95060,1,1,1841,935,853,82,924,11,2000,1065,675,249,
24,"IASI",225,95060,,152,0,"Str.PLAIESILOR Nr.9","MUNICIPIUL IASI",1,95060,1,1,1879,975,900,75,960,15,2000,1025,688,272,
24,"IASI",225,95060,,153,0,"Str.PLAIESILOR Nr.9","MUNICIPIUL IASI",1,95060,1,1,1260,651,626,25,646,5,1400,749,434,212,
24,"IASI",225,95060,,154,0,"Str.PLAIESILOR Nr.9","MUNICIPIUL IASI",1,95060,1,1,2060,1080,1006,74,1054,26,2200,1120,745,309,
24,"IASI",225,95060,,155,0,"Str.MUSATINI Nr.53","MUNICIPIUL IASI",1,95060,1,1,1502,810,740,70,795,15,1700,890,573,222,
24,"IASI",225,95060,,156,0,"Str.MUSATINI Nr.53","MUNICIPIUL IASI",1,95060,1,1,1542,895,835,60,875,20,1700,805,638,237,
24,"IASI",225,95060,,157,0,"Str.PLAIESILOR Nr.9","MUNICIPIUL IASI",1,95060,1,1,1537,846,769,77,834,12,1700,854,568,266,
24,"IASI",225,95060,,158,0,"Str.MUSATINI Nr.53","MUNICIPIUL IASI",1,95060,1,1,1596,977,943,34,957,20,1800,823,695,262,
24,"IASI",225,95060,,159,0,"Str.MUSATINI Nr.12","MUNICIPIUL IASI",1,95060,1,1,1545,926,871,55,917,9,1700,774,680,237,
24,"IASI",225,95060,,160,0,"Str.MUSATINI Nr.53","MUNICIPIUL IASI",1,95060,1,1,1518,877,846,31,857,20,1600,723,624,233,
24,"IASI",225,95060,,161,0,"Str.MUSATINI Nr.12","MUNICIPIUL IASI",1,95060,1,1,1325,787,748,39,775,12,1500,713,561,214,
24,"IASI",225,95060,,162,0,"Str.MUSATINI Nr.12","MUNICIPIUL IASI",1,95060,1,1,1571,936,881,55,931,5,1700,764,704,227,
24,"IASI",225,95060,,163,0,"Str.MILCOV Nr.11","MUNICIPIUL IASI",1,95060,1,1,1871,1056,981,75,1042,14,2000,944,722,320,
24,"IASI",225,95060,,164,0,"Str.MILCOV Nr.11","MUNICIPIUL IASI",1,95060,1,1,1770,944,855,89,932,12,2300,1356,672,260,
24,"IASI",225,95060,,165,0,"Str.MILCOV Nr.11","MUNICIPIUL IASI",1,95060,1,1,1439,883,838,45,869,14,1600,717,603,266,
24,"IASI",225,95060,,166,0,"Str.I.SIMIONESCU Nr.11","MUNICIPIUL IASI",1,95060,1,1,1948,1116,1030,86,1103,13,2100,984,733,370,
24,"IASI",225,95060,,167,0,"Str.I.SIMIONESCU Nr.11","MUNICIPIUL IASI",1,95060,1,1,2271,1290,1230,60,1274,16,2500,1210,853,421,
24,"IASI",225,95060,,168,0,"Str.I.SIMIONESCU Nr.11","MUNICIPIUL IASI",1,95060,1,1,1927,996,971,25,982,14,2100,1104,637,345,
24,"IASI",225,95060,,169,0,"Str.I.SIMIONESCU Nr.11","MUNICIPIUL IASI",1,95060,1,1,2162,1231,1107,124,1217,14,2300,1069,827,390,
24,"IASI",225,95060,,170,0,"Str.I.SIMIONESCU Nr.11","MUNICIPIUL IASI",1,95060,1,1,2140,1224,1124,100,1210,14,2300,1074,842,368,
24,"IASI",225,95060,,171,0,"Str.BURIDAVA Nr.10","MUNICIPIUL IASI",1,95060,1,1,2308,1222,1164,58,1211,11,2500,1278,866,345,
24,"IASI",225,95060,,172,0,"Str.BURIDAVA Nr.10","MUNICIPIUL IASI",1,95060,1,1,2176,1218,1161,57,1200,18,2400,1182,862,338,
24,"IASI",225,95060,,173,0,"Str.AMURGULUI Nr.6","MUNICIPIUL IASI",1,95060,1,1,1596,957,872,85,944,13,1800,840,655,289,
24,"IASI",225,95060,,174,0,"Str.AMURGULUI Nr.6","MUNICIPIUL IASI",1,95060,1,1,1787,1117,1054,63,1108,9,1900,783,802,306,
24,"IASI",225,95060,,175,0,"Str.AMURGULUI Nr.6","MUNICIPIUL IASI",1,95060,1,1,1344,804,757,47,790,14,1400,596,525,265,
24,"IASI",225,95060,,176,0,"Str.AMURGULUI Nr.6","MUNICIPIUL IASI",1,95060,1,1,1555,881,837,44,866,15,1700,819,564,302,
24,"IASI",225,95060,,177,0,"Str.BURIDAVA Nr.10","MUNICIPIUL IASI",1,95060,1,1,2105,1100,1027,73,1083,17,2300,1199,780,303,
24,"IASI",225,95060,,178,0,"Str.MIRCEA CEL BATRIN Nr.12","MUNICIPIUL IASI",1,95060,1,1,2008,1018,961,57,1005,13,2200,1182,720,285,
24,"IASI",225,95060,,179,0,"Str.MIRCEA CEL BATRIN Nr.12","MUNICIPIUL IASI",1,95060,1,1,1907,1191,1034,157,1161,30,2092,901,803,358,
24,"IASI",225,95060,,180,0,"Str.MIRCEA CEL BATRIN Nr.12","MUNICIPIUL IASI",1,95060,1,1,1077,819,747,72,813,6,1600,781,572,241,
24,"IASI",225,95060,,181,0,"Str.MIRCEA CEL BATRIN Nr.12","MUNICIPIUL IASI",1,95060,1,1,1728,1017,962,55,1004,13,1900,883,697,307,
24,"IASI",225,95060,,182,1,"Str.CODRESCU Nr.6","MUNICIPIUL IASI",1,95060,1,1,0,188,0,188,182,6,200,12,131,51,
24,"IASI",225,95060,,183,0,"Cal.GALATA Nr.42","MUNICIPIUL IASI",1,95060,1,1,1890,1097,1044,53,1074,23,2100,1003,750,324,
24,"IASI",225,95060,,184,0,"Str.I.C.BRATIANU Nr.","MUNICIPIUL IASI",1,95060,1,1,1332,818,755,63,790,28,1400,582,617,173,
24,"IASI",225,95060,,185,1,"Str.Sf.CONSTANTIN Nr.1","MUNICIPIUL IASI",1,95060,1,1,0,119,0,119,111,8,200,81,89,22,
24,"IASI",225,95060,,186,1,"B-dul MANGERON Nr.71","MUNICIPIUL IASI",1,95060,1,1,0,1038,0,1038,1007,31,3200,2162,670,337,
24,"IASI",225,95060,,187,1,"Str.TUDOR VLADIMIRESCU","MUNICIPIUL IASI",1,95060,1,1,0,961,0,961,949,12,2100,1118,667,282,
24,"IASI",225,95060,,188,1,"Str.TUDOR VLADIMIRESCU","MUNICIPIUL IASI",1,95060,1,1,0,1751,0,1751,1679,72,3500,1749,1077,602,
24,"IASI",225,95060,,189,1,"Aleea M.SADOVEANU Nr.3","MUNICIPIUL IASI",1,95060,1,1,0,648,0,648,630,18,1400,752,359,271,
24,"IASI",225,95060,,190,1,"Str.SARARIE Nr.189","MUNICIPIUL IASI",1,95060,1,1,0,1039,0,1039,1016,23,2600,1561,704,312,
24,"IASI",225,95060,,191,1,"B-dul COPOU Nr.11","MUNICIPIUL IASI",1,95060,1,1,0,1460,0,1460,1431,29,3300,1840,1115,316,
24,"IASI",225,95060,,192,1,"B-dul COPOU Nr.11","MUNICIPIUL IASI",1,95060,1,1,0,873,0,873,805,68,1500,627,651,154,
24,"IASI",225,95060,,193,1,"Str.TROTUS Nr.16","MUNICIPIUL IASI",1,95060,1,1,0,95,0,95,92,3,100,5,64,28,
24,"IASI",225,95060,,194,1,"Str.N.BALCESCU Nr.11","MUNICIPIUL IASI",1,95060,1,1,0,173,0,173,169,4,500,327,130,39,
24,"IASI",225,95060,,195,1,"Str.MIHAIL STURZA Nr.2","MUNICIPIUL IASI",1,95060,1,1,0,280,0,280,274,6,500,220,176,98,
24,"IASI",225,95060,,196,1,"Str.I.C.BRATIANU Nr.1","MUNICIPIUL IASI",1,95060,1,1,0,110,0,110,107,3,500,390,86,21,
24,"IASI",225,95060,,197,1,"B-dul COPOU Nr.50","MUNICIPIUL IASI",1,95060,1,1,0,269,0,269,263,6,500,231,200,63,
24,"IASI",225,95060,,198,1,"Str.G-ral BERTHELOT Nr.2","MUNICIPIUL IASI",1,95060,1,1,0,178,0,178,176,2,300,122,118,58,
24,"IASI",225,95060,,199,1,"Str.G.IBRAILEANU Nr.1","MUNICIPIUL IASI",1,95060,1,1,0,140,0,140,138,2,400,260,102,36,
24,"IASI",225,95060,,200,1,"Str.OCTAV BOTEZ Nr.2","MUNICIPIUL IASI",1,95060,1,1,0,149,0,149,146,3,400,251,110,36,
24,"IASI",225,95060,,201,1,"Str.Dr.I.CEHAC Nr.30","MUNICIPIUL IASI",1,95060,1,1,0,143,0,143,143,0,200,57,111,32,
24,"IASI",225,95060,,202,1,"B-dul INDEPENDENTEI Nr.1","MUNICIPIUL IASI",1,95060,1,1,0,623,0,623,618,5,1500,877,480,138,
24,"IASI",225,95060,,203,1,"Str.CUZA VODA Nr.34","MUNICIPIUL IASI",1,95060,1,1,0,209,0,209,205,4,500,291,156,49,
24,"IASI",225,95060,,204,1,"Str.ELENA DOAMNA","MUNICIPIUL IASI",1,95060,1,1,0,92,0,92,92,0,200,108,74,18,
24,"IASI",225,95060,,205,1,,"MUNICIPIUL IASI",1,95060,1,1,0,317,0,317,316,1,500,183,255,61,
24,"IASI",225,95060,,206,1,,"MUNICIPIUL IASI",1,95060,1,1,0,179,0,179,175,4,200,21,139,36,
24,"IASI",225,95060,,207,1,"SOS.BUCIUM Nr.36","MUNICIPIUL IASI",1,95060,1,1,0,276,0,276,267,9,1000,724,190,77,
24,"IASI",225,95060,,208,1,"Str.TROTUS Nr.14","MUNICIPIUL IASI",1,95060,1,1,0,415,0,415,406,9,800,385,319,87,
24,"IASI",225,95060,,209,1,"GARA C.F.F.IASI","MUNICIPIUL IASI",1,95060,1,1,0,1109,0,1109,1090,19,3200,2091,720,370,
24,"IASI",225,95060,,210,1,"GARA INTERNATIONALA NICOLINA","MUNICIPIUL IASI",1,95060,1,1,0,77,0,77,77,0,1000,923,60,17,
24,"IASI",225,95391,,211,0,"Str.MOLDOVEI Nr.2","MUNICIPIUL PASCANI",2,95391,1,1,1182,729,683,46,718,11,1300,571,520,198,
24,"IASI",225,95391,,212,0,"Str.MOLDOVEI Nr.2","MUNICIPIUL PASCANI",2,95391,1,1,1715,1084,1013,71,1072,12,1900,816,790,282,
24,"IASI",225,95391,,213,0,"Str.Dr.VODA Nr.59","MUNICIPIUL PASCANI",2,95391,1,1,1187,793,730,63,776,17,1300,507,534,242,
24,"IASI",225,95391,,214,0,"Str.N.IORGA Nr.21","MUNICIPIUL PASCANI",2,95391,1,1,1364,888,849,39,880,8,1500,612,680,200,
24,"IASI",225,95391,,215,0,"Str.ST.CEL MARE Nr.19","MUNICIPIUL PASCANI",2,95391,1,1,1630,1104,913,191,1086,18,1800,696,822,264,
24,"IASI",225,95391,,216,0,"Str.ST.CEL MARE Nr.154","MUNICIPIUL PASCANI",2,95391,1,1,1383,907,767,140,895,12,1500,593,661,234,
24,"IASI",225,95391,,217,0,"Str.SPORTULUI Nr.4","MUNICIPIUL PASCANI",2,95391,1,1,1433,891,840,51,885,6,1600,709,641,244,
24,"IASI",225,95391,,218,0,"Str.SPORTULUI Nr.4","MUNICIPIUL PASCANI",2,95391,1,1,1198,817,697,120,808,9,1300,483,579,229,
24,"IASI",225,95391,,219,0,"Str.E.STAMATE Nr.8","MUNICIPIUL PASCANI",2,95391,1,1,1819,1084,1019,65,1074,10,2000,916,718,356,
24,"IASI",225,95391,,220,0,"Str.E.STAMATE Nr.8","MUNICIPIUL PASCANI",2,95391,1,1,1703,1116,1041,75,1099,17,1800,684,754,345,
24,"IASI",225,95391,,221,0,"Str.GARII Nr.97","MUNICIPIUL PASCANI",2,95391,1,1,1613,972,911,61,965,7,1800,828,635,330,
24,"IASI",225,95391,,222,0,"Str.CEFERISTILOR Nr.3","MUNICIPIUL PASCANI",2,95391,1,1,1511,853,804,49,849,4,1600,747,538,311,
24,"IASI",225,95391,,223,0,"Str.CEFERISTILOR Nr.3","MUNICIPIUL PASCANI",2,95391,1,1,2014,1250,1168,82,1238,12,2200,950,836,402,
24,"IASI",225,95391,,224,0,"Str.IZVOARELOR Nr.11","MUNICIPIUL PASCANI",2,95391,1,1,2032,1171,1101,70,1164,7,2200,1029,763,401,
24,"IASI",225,95391,,225,0,"Str.IZVOARELOR Nr.11","MUNICIPIUL PASCANI",2,95391,1,1,2326,1354,1303,51,1317,37,2500,1146,869,448,
24,"IASI",225,95391,,226,0,"Aleea 22 DECEMBRIE Nr.2","MUNICIPIUL PASCANI",2,95391,1,1,1367,845,802,43,841,4,1500,655,576,265,
24,"IASI",225,95391,,227,0,"Aleea 22 DECEMBRIE Nr.2","MUNICIPIUL PASCANI",2,95391,1,1,1224,801,703,98,792,9,1300,499,503,289,
24,"IASI",225,95391,,228,0,"Str.A.IANCU Nr.36","MUNICIPIUL PASCANI",2,95391,1,1,1117,902,850,52,897,5,1200,298,597,300,
24,"IASI",225,95391,,229,0,"Str.M.VITEAZU Nr.172","MUNICIPIUL PASCANI",2,95391,1,1,1110,852,824,28,812,40,1200,348,521,291,
24,"IASI",225,95391,,230,0,"Str.M.VITEAZU Nr.172","MUNICIPIUL PASCANI",2,95391,1,1,833,691,640,51,680,11,900,209,500,180,
24,"IASI",225,95391,,231,0,"Str.GASTESTI Nr.23","MUNICIPIUL PASCANI",2,95391,1,1,917,785,709,76,745,40,1000,215,514,231,
24,"IASI",225,95391,,232,0,"Str.GASTESTI Nr.23","MUNICIPIUL PASCANI",2,95391,1,1,1282,1064,1009,55,1049,15,1400,336,709,340,
24,"IASI",225,95391,,233,0,"Str.I.CREANGA Nr.45","MUNICIPIUL PASCANI",2,95391,1,1,940,790,740,50,779,11,1000,210,573,206,
24,"IASI",225,95391,,234,0,"Str.13 DECEMBRIE","MUNICIPIUL PASCANI",2,95391,1,1,1034,1012,938,74,1005,7,1100,88,820,185,
24,"IASI",225,95391,,235,1,"GARA C.F.R.","MUNICIPIUL PASCANI",2,95391,1,1,0,367,0,367,364,3,3700,3333,224,140,
24,"IASI",225,95355,,236,0,"Str.M.EMINESCU Nr.3","ORAS HARLAU",3,95355,2,1,1897,1172,1012,160,1157,15,2100,928,811,346,
24,"IASI",225,95355,,237,0,"Str.ST.CEL MARE Nr.17","ORAS HARLAU",3,95355,2,1,2048,1151,1067,84,1132,19,2100,949,756,376,
24,"IASI",225,95355,,238,0,"Str.ST.CEL MARE Nr.34","ORAS HARLAU",3,95355,2,1,2151,1249,1143,106,1241,8,2300,1051,888,353,
24,"IASI",225,95355,,239,0,"CAMINUL CULTURAL PIRCOVACI","ORAS HARLAU",3,95355,2,1,2512,1512,1448,64,1480,32,2700,1188,1083,397,
24,"IASI",225,95471,,240,0,"Sc.GENERALA Nr.3","ORAS TARGU FRUMOS",4,95471,2,1,1532,856,763,93,836,20,1700,844,649,187,
24,"IASI",225,95471,,241,0,"S.C.MECROM","ORAS TARGU FRUMOS",4,95471,2,1,1421,868,725,143,864,4,1600,732,619,245,
24,"IASI",225,95471,,242,0,"CASA DE CULTURA","ORAS TARGU FRUMOS",4,95471,2,1,1421,859,749,110,850,9,1600,741,589,261,
24,"IASI",225,95471,,243,0,"Sc.PROFESIONALA SPECIALA","ORAS TARGU FRUMOS",4,95471,2,1,1575,949,800,149,933,16,1700,751,625,308,
24,"IASI",225,95471,,244,0,"Liceul ION NECULCE","ORAS TARGU FRUMOS",4,95471,2,1,1697,927,773,154,914,13,1892,965,651,263,
24,"IASI",225,95471,,245,0,"Sc.G.IBRAILEANU","ORAS TARGU FRUMOS",4,95471,2,1,1725,1028,927,101,1021,7,1900,872,708,313,
24,"IASI",225,95612,,246,0,"Sc.G-la Al.I.CUZA","ALEXANDRU I. CUZA",5,95612,0,3,575,447,390,57,442,5,600,153,318,124,
24,"IASI",225,95612,,247,0,"Sc.G-la SCHEIA","ALEXANDRU I. CUZA",5,95612,0,3,984,514,462,52,502,12,1100,586,384,118,
24,"IASI",225,95612,,248,0,"Sc.G-la VOLINTIRESTI","ALEXANDRU I. CUZA",5,95612,0,3,553,629,537,92,619,10,700,71,522,97,
24,"IASI",225,95667,,249,0,"Sc.G-la ANDRIESENI","ANDRIESENI",6,95667,0,3,1539,783,658,125,767,16,1700,917,591,176,
24,"IASI",225,95667,,250,0,"Sc.G-la BUHAENI","ANDRIESENI",6,95667,0,3,510,305,237,68,301,4,600,295,238,63,
24,"IASI",225,95667,,251,0,"Sc.G-la SPINENI","ANDRIESENI",6,95667,0,3,817,509,399,110,496,13,900,391,412,84,
24,"IASI",225,95667,,252,0,"Sc.G-la GLAVANESTI","ANDRIESENI",6,95667,0,3,627,388,319,69,380,8,700,312,317,63,
24,"IASI",225,95747,,253,0,"Sc.G-la ARONEANU","ARONEANU",7,95747,0,3,857,503,429,74,494,9,911,408,351,143,
24,"IASI",225,95747,,254,0,"Sc.G-la DOROBANT","ARONEANU",7,95747,0,3,678,495,396,99,480,15,700,205,339,141,
24,"IASI",225,95747,,255,0,"Sc.G-la REDIU","ARONEANU",7,95747,0,3,257,215,172,43,213,2,299,84,190,23,
24,"IASI",225,95747,,256,0,"Sc.G-la SOROGARI","ARONEANU",7,95747,0,3,107,116,74,42,113,3,200,84,77,36,
24,"IASI",225,95792,,257,0,"Sc.G-la BALTATI","BALTATI",8,95792,0,3,1307,769,688,81,763,6,1400,631,553,210,
24,"IASI",225,95792,,258,0,"Sc.G-la MADARJESTI","BALTATI",8,95792,0,3,661,424,357,67,419,5,700,276,296,123,
24,"IASI",225,95792,,259,0,"Sc.G-la SARCA","BALTATI",8,95792,0,3,756,566,494,72,561,5,800,234,413,148,
24,"IASI",225,95792,,260,0,"Sc.G-la VALEA OILOR","BALTATI",8,95792,0,3,545,374,327,47,365,9,600,226,272,93,
24,"IASI",225,95792,,261,0,"Sc.G-la PODISU","BALTATI",8,95792,0,3,410,320,284,36,319,1,500,180,267,52,
24,"IASI",225,95872,,262,0,"Sc.G-la BELCESTI","BELCESTI",10,95872,0,3,882,503,327,176,501,2,1000,497,384,117,
24,"IASI",225,95872,,263,0,"Sc.G-la BELCESTI","BELCESTI",10,95872,0,3,1376,751,514,237,744,7,1400,649,581,163,
24,"IASI",225,95872,,264,0,"Sc.G-la RUSI","BELCESTI",10,95872,0,3,1486,818,598,220,805,13,1600,782,669,136,
24,"IASI",225,95872,,265,0,"Sc. SATU NOU","BELCESTI",10,95872,0,3,1449,978,814,164,971,7,1600,622,775,196,
24,"IASI",225,95872,,266,0,"Sc.SAT MUNTENI","BELCESTI",10,95872,0,3,1003,714,616,98,706,8,1100,386,594,112,
24,"IASI",225,95872,,267,0,"Sc.SAT TANSA","BELCESTI",10,95872,0,3,819,543,453,90,536,7,900,356,426,110,
24,"IASI",225,95872,,268,0,"Sc.SAT LITENI","BELCESTI",10,95872,0,3,960,711,608,103,706,5,1000,289,570,136,
24,"IASI",225,95872,,269,0,"Sc.SAT ULMI","BELCESTI",10,95872,0,3,585,475,402,73,464,11,700,225,408,56,
24,"IASI",225,95088,,270,0,"Camin Cult.BIRNOVA","BARNOVA",9,95088,0,3,1660,847,703,144,835,12,1800,953,635,200,
24,"IASI",225,95088,,271,0,"Camin Cult.PAUN","BARNOVA",9,95088,0,3,588,380,283,97,372,8,600,218,270,102,
24,"IASI",225,95943,,272,0,"Sc.BIVOLARI","BIVOLARI",11,95943,0,3,2488,1432,1244,188,1403,29,2800,1368,1052,351,
24,"IASI",225,95943,,273,0,"Sc.TABARA","BIVOLARI",11,95943,0,3,944,671,517,154,655,16,1000,329,518,137,
24,"IASI",225,96058,,274,0,"Sc.BRAESTI","BRAESTI",12,96058,0,3,1197,778,674,104,756,22,1300,522,526,230,
24,"IASI",225,96058,,275,0,"Sc.CRISTESTI","BRAESTI",12,96058,0,3,1497,690,629,61,675,15,1600,910,496,179,
24,"IASI",225,96110,,276,0,"Gradinita 1 BUTEA","BUTEA",13,96110,0,3,1821,878,831,47,860,18,2000,1122,652,208,
24,"IASI",225,96110,,277,0,"Camin Cult.BUTEA","BUTEA",13,96110,0,3,1161,600,571,29,558,42,1300,700,423,135,
24,"IASI",225,96110,,278,0,"Sc.MICLAUSENI","BUTEA",13,96110,0,3,315,228,186,42,218,10,400,172,142,76,
24,"IASI",225,96147,,279,0,"Sc.CEPLENITA","CEPLENITA",14,96147,0,3,1168,771,696,75,752,19,1300,529,613,139,
24,"IASI",225,96147,,280,0,"Sc.BUHALNITA","CEPLENITA",14,96147,0,3,1279,753,664,89,743,10,1500,747,589,154,
24,"IASI",225,96147,,281,0,"Sc.POIANA MARULUI","CEPLENITA",14,96147,0,3,782,477,405,72,468,9,900,423,375,93,
24,"IASI",225,96147,,282,0,"Sc.ZLODICA","CEPLENITA",14,96147,0,3,236,170,142,28,166,4,300,130,134,32,
24,"IASI",225,96192,,283,0,"Primariea CIORTESTI","CIORTESTI",15,96192,0,3,1614,890,808,82,855,35,1800,910,672,183,
24,"IASI",225,96192,,284,0,"Sc.COROPCENI","CIORTESTI",15,96192,0,3,1200,712,651,61,691,21,1300,588,584,107,
24,"IASI",225,96192,,285,0,"Sc.SERBESTI","CIORTESTI",15,96192,0,3,448,506,448,58,497,9,800,293,418,79,
24,"IASI",225,96254,,286,0,"Sc.CIUREA","CIUREA",16,96254,0,3,1741,734,628,106,725,9,1900,1166,496,229,
24,"IASI",225,96254,,287,0,"Sc.LUNCA CETATUII","CIUREA",16,96254,0,3,1139,911,581,330,908,3,1200,289,499,409,
24,"IASI",225,96254,,288,0,"CIUREA S.C.AGROMEC SA","CIUREA",16,96254,0,3,1531,815,612,203,806,9,1700,885,566,240,
24,"IASI",225,96254,,289,0,"Sc.DUMBRAVA","CIUREA",16,96254,0,3,846,453,387,66,443,10,900,447,245,198,
24,"IASI",225,96254,,290,0,"Sc.PICIORUL LUPULUI","CIUREA",16,96254,0,3,629,357,275,82,347,10,700,343,264,83,
24,"IASI",225,96254,,291,0,"Sc.SLOBOZIA","CIUREA",16,96254,0,3,378,295,234,61,290,5,400,105,183,107,
24,"IASI",225,96334,,292,0,"Sc.COARNELE CAPREI","COARNELE CAPREI",17,96334,0,3,2033,1050,971,79,1043,7,2200,1150,804,239,
24,"IASI",225,96334,,293,0,"Sc.ARAMA","COARNELE CAPREI",17,96334,0,3,548,369,289,80,363,6,600,231,287,76,
24,"IASI",225,96370,,294,0,"Sc.OSOI","COMARNA",18,96370,0,3,1422,998,896,102,973,25,1600,602,653,320,
24,"IASI",225,96370,,295,0,"Sc.STINCA","COMARNA",18,96370,0,3,139,144,111,33,144,0,200,56,125,19,
24,"IASI",225,96370,,296,0,"Sc.COMARNA DE SUS","COMARNA",18,96370,0,3,1162,691,575,116,677,14,1200,509,562,115,
24,"IASI",225,96370,,297,0,"Sc.COMARNA DE JOS","COMARNA",18,96370,0,3,819,580,500,80,568,12,900,320,484,84,
24,"IASI",225,96423,,298,0,"Sc.COSTULENI","COSTULENI",19,96423,0,3,1234,873,748,125,850,23,1300,427,688,162,
24,"IASI",225,96423,,299,0,"COVASNA","COSTULENI",19,96423,0,3,1133,1098,964,134,1082,16,1200,102,952,130,
24,"IASI",225,96423,,300,0,"Sc.COZIA","COSTULENI",19,96423,0,3,932,640,551,89,624,16,1000,360,516,108,
24,"IASI",225,96423,,301,0,"Sc.HILITA","COSTULENI",19,96423,0,3,672,528,443,85,512,16,700,172,374,138,
24,"IASI",225,96478,,302,0,"Sc.COTNARI","COTNARI",20,96478,0,3,1420,740,649,91,736,4,1600,860,591,145,
24,"IASI",225,96478,,303,0,"Sc.BAHLUI","COTNARI",20,96478,0,3,265,182,162,20,179,3,300,118,150,29,
24,"IASI",225,96478,,304,0,"Sc.HODORA","COTNARI",20,96478,0,3,1212,726,661,65,701,25,1300,574,582,119,
24,"IASI",225,96478,,305,0,"Sc.HORODISTEA","COTNARI",20,96478,0,3,793,452,373,79,449,3,900,448,379,70,
24,"IASI",225,96478,,306,0,"Sc.CIRJOAIA","COTNARI",20,96478,0,3,1467,709,621,88,696,13,1600,891,512,184,
24,"IASI",225,96478,,307,0,"Sc.VALEA-RACULUI","COTNARI",20,96478,0,3,274,163,143,20,156,6,300,138,127,29,
24,"IASI",225,96478,,308,0,"Sc.ZBERENI","COTNARI",20,96478,0,3,629,396,332,64,393,3,700,304,322,71,
24,"IASI",225,96593,,309,0,"Sc.COZMESTI","COZMESTI",21,96593,0,3,1332,696,631,65,686,10,1500,804,540,146,
24,"IASI",225,96593,,310,0,"Sc.PODOLENI DE SUS","COZMESTI",21,96593,0,3,743,470,365,105,456,14,800,330,367,89,
24,"IASI",225,96593,,311,0,"Sc.PODOLENI DE JOS","COZMESTI",21,96593,0,3,265,205,150,55,199,6,300,95,142,57,
24,"IASI",225,96637,,312,0,"Sc.CRISTESTI","CRISTESTI",22,96637,0,3,2262,1334,1238,96,1312,22,2500,1166,1004,308,
24,"IASI",225,96637,,313,0,"Sc.HERESTI","CRISTESTI",22,96637,0,3,627,490,392,98,483,7,700,210,352,131,
24,"IASI",225,96637,,314,0,"Sc.HOMITA","CRISTESTI",22,96637,0,3,350,251,211,40,247,4,400,149,195,52,
24,"IASI",225,96664,,315,0,"Camin Cult.CUCUTENI","CUCUTENI",23,96664,0,3,1116,795,727,68,784,11,1200,405,645,139,
24,"IASI",225,96717,,316,0,"Sc.DAGITA","DAGATA",24,96717,0,3,2116,1137,978,159,1118,19,2300,1163,861,257,
24,"IASI",225,96717,,317,0,"Sc.MANASTIREA","DAGATA",24,96717,0,3,1304,674,585,89,667,7,1400,726,530,137,
24,"IASI",225,96815,,318,0,"Camin Cult.DELENI","DELENI",25,96815,0,3,1842,1007,798,209,1000,7,2000,993,703,297,
24,"IASI",225,96815,,319,0,"Gradinita DELENI","DELENI",25,96815,0,3,1261,843,595,248,837,6,1400,557,636,201,
24,"IASI",225,96815,,320,0,"Sc.MAXUT","DELENI",25,96815,0,3,1066,698,543,155,685,13,1100,402,493,192,
24,"IASI",225,96815,,321,0,"Gradinita MAXUT","DELENI",25,96815,0,3,709,422,283,139,418,4,800,378,291,127,
24,"IASI",225,96815,,322,0,"Gradinita SLOBOZIA","DELENI",25,96815,0,3,941,546,460,86,540,6,1000,454,396,144,
24,"IASI",225,96815,,323,0,"Sc.FEREDENI","DELENI",25,96815,0,3,698,442,392,50,432,10,800,358,330,102,
24,"IASI",225,96815,,324,0,"Gradinita POIANA","DELENI",25,96815,0,3,958,643,565,78,631,12,1000,357,511,120,
24,"IASI",225,96888,,325,0,"Sc.DOBROVAT","DOBROVAT",26,96888,0,3,1268,743,634,109,732,11,1400,657,526,206,
24,"IASI",225,96888,,326,0,"RUSI","DOBROVAT",26,96888,0,3,858,562,477,85,547,15,900,338,449,98,
24,"IASI",225,96904,,327,0,"Sc.DOLHESTI","DOLHESTI",27,96904,0,3,582,425,391,34,417,7,600,175,327,90,
24,"IASI",225,96904,,328,0,"Sc.BRADICESTI","DOLHESTI",27,96904,0,3,921,641,594,47,628,13,1000,359,517,111,
24,"IASI",225,96904,,329,0,"Sc.PIETRIS","DOLHESTI",27,96904,0,3,682,483,429,54,480,3,800,317,399,81,
24,"IASI",225,96940,,330,0,"Sc.DUMESTI","DUMESTI",28,96940,0,3,1561,765,657,108,748,17,1700,935,545,203,
24,"IASI",225,96940,,331,0,"Sc.PAUSESTI","DUMESTI",28,96940,0,3,1379,740,642,98,722,18,1500,760,610,112,
24,"IASI",225,96940,,332,0,"Sc.HOISESTI","DUMESTI",28,96940,0,3,679,352,299,53,346,6,800,448,278,68,
24,"IASI",225,97009,,333,0,"Sc.ERBICENI","ERBICENI",29,97009,0,3,1814,939,801,138,920,19,2000,1061,670,250,
24,"IASI",225,97009,,334,0,"Sc.TOTOIESTI","ERBICENI",29,97009,0,3,1242,656,552,104,639,17,1400,744,475,164,
24,"IASI",225,97009,,335,0,"Sc.BIRLESTI","ERBICENI",29,97009,0,3,476,388,262,126,382,6,500,112,310,72,
24,"IASI",225,97009,,336,0,"Sc.SPINOASA","ERBICENI",29,97009,0,3,250,198,162,36,195,3,300,102,142,53,
24,"IASI",225,97009,,337,0,"Sc.SPRINCEANA","ERBICENI",29,97009,0,3,261,175,129,46,174,1,300,125,134,40,
24,"IASI",225,97063,,338,0,"Camin Cult.FOCURI","FOCURI",30,97063,0,3,1617,896,794,102,870,26,1800,904,698,172,
24,"IASI",225,97063,,339,0,"Gradinita 2 PASCANENI","FOCURI",30,97063,0,3,1557,750,669,81,742,8,1700,950,606,136,
24,"IASI",225,97063,,340,0,"Gradinita 1 FINTINELE","FOCURI",30,97063,0,3,1524,861,822,39,847,14,1700,839,659,188,
24,"IASI",225,97090,,341,0,"Sc.GOLAIESTI","GOLAIESTI",31,97090,0,3,1558,791,686,105,778,13,1700,909,612,166,
24,"IASI",225,97090,,342,0,"Sc.GRADINARI","GOLAIESTI",31,97090,0,3,859,498,391,107,490,8,900,402,382,108,
24,"IASI",225,97090,,343,0,"Sc.PETRESTI","GOLAIESTI",31,97090,0,3,312,224,172,52,220,4,400,176,183,37,
24,"IASI",225,97189,,344,0,"Sc.GORBAN","GORBAN",32,97189,0,3,614,386,314,72,375,11,700,314,302,73,
24,"IASI",225,97189,,345,0,"Sc.PODU HAGIULUI","GORBAN",32,97189,0,3,522,369,302,67,363,6,584,215,260,103,
24,"IASI",225,97189,,346,0,"Sc.SCOPOSENI","GORBAN",32,97189,0,3,452,394,297,97,390,4,500,106,276,114,
24,"IASI",225,97189,,347,0,"Sc.GURA BOHOTIN","GORBAN",32,97189,0,3,649,418,350,68,411,7,700,282,334,77,
24,"IASI",225,97241,,348,0,"Camin Cult.GRAJDURI","GRAJDURI",33,97241,0,3,822,439,352,87,434,5,900,461,216,218,
24,"IASI",225,97241,,349,0,"Sc.PADURENI","GRAJDURI",33,97241,0,3,611,395,193,202,385,10,700,305,212,173,
24,"IASI",225,97241,,350,0,"Sc.VALEA SATULUI","GRAJDURI",33,97241,0,3,462,342,271,71,333,9,500,158,270,63,
24,"IASI",225,97321,,351,0,"Sc.GROPNITA","GROPNITA",34,97321,0,3,1108,538,459,79,529,9,1200,662,420,109,
24,"IASI",225,97321,,352,0,"Sc.FORASTI","GROPNITA",34,97321,0,3,783,453,395,58,444,9,900,447,334,110,
24,"IASI",225,97321,,353,0,"Sc.SAVENI","GROPNITA",34,97321,0,3,872,523,461,62,514,9,1000,477,414,100,
24,"IASI",225,97394,,354,0,"Sc.GROZESTI","GROZESTI",35,97394,0,3,967,691,644,47,683,8,1100,409,557,126,
24,"IASI",225,97394,,355,0,"Sc.COLTUL CORNII","GROZESTI",35,97394,0,3,522,353,315,38,347,6,600,247,292,55,
24,"IASI",225,97438,,356,0,"Sc.HALAUCESTI","HALAUCESTI",36,97438,0,3,1797,1271,1188,83,1245,26,1900,629,841,404,
24,"IASI",225,97438,,357,0,"Camin Cult.HALAUCESTI","HALAUCESTI",36,97438,0,3,1907,1427,1346,81,1397,21,2100,673,1004,393,
24,"IASI",225,97438,,358,0,"Sc.LUNCASI","HALAUCESTI",36,97438,0,3,748,602,510,92,570,16,800,214,357,213,
24,"IASI",225,97465,,359,0,"Sc.HELESTENI","HELESTENI",37,97465,0,3,873,573,491,82,556,17,1000,427,441,115,
24,"IASI",225,97465,,360,0,"Sc.HARMANEASA","HELESTENI",37,97465,0,3,586,436,374,62,433,3,600,164,348,85,
24,"IASI",225,97465,,361,0,"Sc.OBOROCENI","HELESTENI",37,97465,0,3,630,462,428,34,456,6,700,238,350,106,
24,"IASI",225,95159,,362,0,"Sc.HOLBOCA","HOLBOCA",38,95159,0,3,2193,1124,930,194,1099,25,2400,1276,733,366,
24,"IASI",225,95159,,363,0,"Sc.RUSENII VECHI","HOLBOCA",38,95159,0,3,997,625,460,165,610,15,1100,475,398,212,
24,"IASI",225,95159,,364,0,"Sc.DANCU","HOLBOCA",38,95159,0,3,1128,583,465,118,576,7,1400,817,380,196,
24,"IASI",225,95159,,365,0,"Sc.DANCU","HOLBOCA",38,95159,0,3,1821,1157,993,164,1145,12,2000,843,774,371,
24,"IASI",225,95159,,366,0,"Sc.DANCU","HOLBOCA",38,95159,0,3,1679,1037,864,173,1024,13,1800,763,681,343,
24,"IASI",225,97517,,367,0,"Camin Cult.HORLESTI","HORLESTI",39,97517,0,3,1662,836,742,94,813,23,1800,964,566,247,
24,"IASI",225,97517,,368,0,"Camin Cult.BOGDANESTI","HORLESTI",39,97517,0,3,472,359,283,76,354,5,500,141,284,70,
24,"IASI",225,97517,,369,0,"Sc.SCOPOSENI","HORLESTI",39,97517,0,3,226,144,119,25,144,0,300,156,125,19,
24,"IASI",225,97553,,370,0,"Sc.IPATELE","IPATELE",40,97553,0,3,643,428,380,48,416,12,700,272,363,53,
24,"IASI",225,97553,,371,0,"Sc.CUZA VODA","IPATELE",40,97553,0,3,422,336,279,57,336,0,500,164,280,56,
24,"IASI",225,97553,,372,0,"Sc.BICU","IPATELE",40,97553,0,3,530,364,316,48,360,4,600,236,297,63,
24,"IASI",225,97606,,373,0,"Sc.BUDA","LESPEZI",41,97606,0,3,830,495,411,84,489,6,900,405,341,148,
24,"IASI",225,97606,,374,0,"Camin Cult.LESPEZI","LESPEZI",41,97606,0,3,1071,498,428,70,490,8,1100,602,357,133,
24,"IASI",225,97606,,375,0,"Sc.DUMBRAVA","LESPEZI",41,97606,0,3,502,345,248,97,338,7,599,254,220,118,
24,"IASI",225,97606,,376,0,"Sc.HECI","LESPEZI",41,97606,0,3,1679,1044,888,156,1030,14,1800,756,710,320,
24,"IASI",225,97606,,377,0,"Sc.BURSUC DEAL","LESPEZI",41,97606,0,3,677,431,332,99,431,0,800,369,291,140,
24,"IASI",225,97679,,378,0,"Sc.LETCANI","LETCANI",42,97679,0,3,2282,1353,1179,174,1313,40,2500,1147,1029,284,
24,"IASI",225,97679,,379,0,"Sc.COGEASCA","LETCANI",42,97679,0,3,1354,730,660,70,720,10,1500,770,583,137,
24,"IASI",225,97679,,380,0,"Sc.CUCUTENI","LETCANI",42,97679,0,3,381,245,37,208,245,0,400,155,201,44,
24,"IASI",225,97679,,381,0,"Sc.BOGONOS","LETCANI",42,97679,0,3,465,319,256,63,308,11,500,181,235,73,
24,"IASI",225,97722,,382,0,"Sc.LUNGANI","LUNGANI",43,97722,0,3,788,514,459,55,512,2,900,386,380,132,
24,"IASI",225,97722,,383,0,"Sc.GOESTI","LUNGANI",43,97722,0,3,818,550,494,56,537,13,900,350,466,71,
24,"IASI",225,97722,,384,0,"Sc.CRUCEA","LUNGANI",43,97722,0,3,992,664,598,66,654,10,1100,436,545,109,
24,"IASI",225,97722,,385,0,"Sc.ZMEU","LUNGANI",43,97722,0,3,918,667,606,61,661,6,1000,333,550,111,
24,"IASI",225,97777,,386,0,"Sc.MADIRJAC","MADARJAC",44,97777,0,3,1264,774,713,61,763,11,1400,626,543,220,
24,"IASI",225,97811,,387,0,"Sc.MIRCESTI","MIRCESTI",45,97811,0,3,1143,627,568,59,618,9,1300,673,452,166,
24,"IASI",225,97811,,388,0,"Sc.IUGANI","MIRCESTI",45,97811,0,3,1508,748,705,43,724,24,1700,952,513,211,
24,"IASI",225,97811,,389,0,"Sc.IZVOARELE","MIRCESTI",45,97811,0,3,1077,543,459,84,532,11,1100,557,382,150,
24,"IASI",225,97811,,390,0,"Sc.RACHITENI","MIRCESTI",45,97811,0,3,1543,702,634,68,683,19,1700,998,497,186,
24,"IASI",225,97875,,391,0,"Sc.MIRONEASA","MIRONEASA",46,97875,0,3,1253,711,647,64,685,26,1400,689,576,109,
24,"IASI",225,97875,,392,0,"Sc.MIRONEASA","MIRONEASA",46,97875,0,3,1159,559,537,22,547,12,1300,741,488,59,
24,"IASI",225,97875,,393,0,"Sc.URSITA","MIRONEASA",46,97875,0,3,396,239,208,31,239,0,500,261,177,62,
24,"IASI",225,97919,,394,0,"Sc.MIROSLAVA","MIROSLAVA",47,97919,0,3,1548,883,680,203,876,7,1700,817,665,211,
24,"IASI",225,97919,,395,0,"Sc.URICANI","MIROSLAVA",47,97919,0,3,719,354,297,57,344,10,800,446,257,87,
24,"IASI",225,97919,,396,0,"Sc.VOROVESTI","MIROSLAVA",47,97919,0,3,677,402,348,54,395,7,800,398,312,83,
24,"IASI",225,97919,,397,0,"Sc.CORNESTI","MIROSLAVA",47,97919,0,3,828,429,320,109,417,12,900,471,314,103,
24,"IASI",225,97919,,398,0,"Sc.HORPAZ","MIROSLAVA",47,97919,0,3,507,345,269,76,329,16,600,255,232,97,
24,"IASI",225,97919,,399,0,"Sc.CIURBESTI","MIROSLAVA",47,97919,0,3,509,357,294,63,354,3,600,243,288,66,
24,"IASI",225,98051,,400,0,"Sc.MIROSLOVESTI","MIROSLOVESTI",48,98051,0,3,1933,960,820,140,946,14,2100,1140,736,210,
24,"IASI",225,98051,,401,0,"Sc.CIOHORANI","MIROSLOVESTI",48,98051,0,3,1388,1092,941,151,1076,16,1500,408,935,141,
24,"IASI",225,98051,,402,0,"Sc.SOCI","MIROSLOVESTI",48,98051,0,3,1157,749,647,102,740,9,1300,551,623,117,
24,"IASI",225,98051,,403,0,"Sc.VERSENI","MIROSLOVESTI",48,98051,0,3,991,810,680,130,792,18,1100,290,548,244,
24,"IASI",225,98113,,404,0,"Sc.MOGOSESTI","MOGOSESTI",49,98113,0,3,1888,1009,878,131,990,19,2100,1091,701,289,
24,"IASI",225,98113,,405,0,"Sc.MINJESTI","MOGOSESTI",49,98113,0,3,781,450,377,73,442,8,900,450,321,121,
24,"IASI",225,98113,,406,0,"Sc.HADIMBU","MOGOSESTI",49,98113,0,3,796,572,474,98,563,9,900,328,409,154,
24,"IASI",225,98168,,407,0,"Sc.MOGOSESTI-SIRET","MOGOSESTI-SIRET",50,98168,0,3,1522,1042,921,121,1035,7,1600,558,794,241,
24,"IASI",225,98168,,408,0,"Sc.MUNCEL DE SUS","MOGOSESTI-SIRET",50,98168,0,3,1622,1200,1037,163,1184,16,1800,600,916,268,
24,"IASI",225,98202,,409,0,"Sc.MOSNA","MOSNA",51,98202,0,3,1573,908,843,65,892,16,1700,792,689,203,
24,"IASI",225,98220,,410,0,"Camin Cult.MOTCA","MOTCA",52,98220,0,3,2728,1883,1805,78,1865,18,3000,1103,1394,471,
24,"IASI",225,98220,,411,0,"Camin Cult.BOURENI","MOTCA",52,98220,0,3,1069,694,630,64,683,11,1200,506,502,181,
24,"IASI",225,98257,,412,0,"Camin Cult.MOVILENI","MOVILENI",53,98257,0,3,1200,599,521,78,593,6,1200,601,460,133,
24,"IASI",225,98257,,413,0,"Sc.POTANGENI","MOVILENI",53,98257,0,3,756,464,413,51,451,13,800,336,313,138,
24,"IASI",225,98257,,414,0,"Sc.IEPURENI","MOVILENI",53,98257,0,3,662,520,450,70,511,9,700,180,406,105,
24,"IASI",225,98300,,415,0,"Sc.OTELENI","OTELENI",54,98300,0,3,2116,1146,1073,73,1136,10,2300,1154,795,341,
24,"IASI",225,98300,,416,0,"Sc.HINDRESTI","OTELENI",54,98300,0,3,991,576,481,95,569,7,1100,524,393,176,
24,"IASI",225,98337,,417,0,"Sc.PLUGARI","PLUGARI",55,98337,0,3,1564,1010,900,110,985,15,1700,690,805,180,
24,"IASI",225,98337,,418,0,"Sc.BOROSOAIA","PLUGARI",55,98337,0,3,1176,903,766,137,895,8,1300,397,706,189,
24,"IASI",225,98373,,419,0,"Gradinita PODU ILOAIEI","PODU ILOAIEI",56,98373,0,3,1101,849,513,336,840,9,1200,351,629,211,
24,"IASI",225,98373,,420,0,"Sc.PODU ILOAIEI","PODU ILOAIEI",56,98373,0,3,1073,804,515,289,799,5,1200,396,599,200,
24,"IASI",225,98373,,421,0,"Gradina de Vara PODU ILOAIEI","PODU ILOAIEI",56,98373,0,3,899,703,351,352,695,8,1000,297,532,163,
24,"IASI",225,98373,,422,0,"Gradinita PODU ILOAIEI","PODU ILOAIEI",56,98373,0,3,2269,764,595,169,750,14,2500,1736,585,165,
24,"IASI",225,98373,,423,0,"Sc.SCOBILTENI","PODU ILOAIEI",56,98373,0,3,998,641,423,218,631,10,1100,449,476,155,
24,"IASI",225,98435,,424,0,"Sc.POPESTI","POPESTI",57,98435,0,3,871,498,426,72,487,11,1000,502,351,136,
24,"IASI",225,98435,,425,0,"Sc.POPESTI","POPESTI",57,98435,0,3,937,577,511,66,561,16,1000,423,455,106,
24,"IASI",225,98435,,426,0,"Sc.DOROSCANI","POPESTI",57,98435,0,3,506,311,253,58,304,7,600,289,225,79,
24,"IASI",225,98435,,427,0,"Sc.HARPASESTI","POPESTI",57,98435,0,3,596,332,252,80,328,4,700,368,282,46,
24,"IASI",225,98505,,428,0,"Sc.POPRICANI","POPRICANI",58,98505,0,3,1657,993,850,143,964,13,1784,807,676,288,
24,"IASI",225,98505,,429,0,"Sc.POPRICANI","POPRICANI",58,98505,0,3,256,232,154,78,232,0,300,68,144,88,
24,"IASI",225,98505,,430,0,"Sc.TIPILESTI","POPRICANI",58,98505,0,3,360,239,194,45,232,7,400,161,180,52,
24,"IASI",225,98505,,431,0,"Sc.COTU MORII","POPRICANI",58,98505,0,3,158,137,103,34,135,2,200,63,104,31,
24,"IASI",225,98505,,432,0,"Sc.VINATORI","POPRICANI",58,98505,0,3,1275,816,622,194,806,10,1400,584,573,233,
24,"IASI",225,98505,,433,0,"Sc.CIRLIG","POPRICANI",58,98505,0,3,338,287,194,93,283,4,400,113,201,82,
24,"IASI",225,98505,,434,0,"Sc.CUZA VODA","POPRICANI",58,98505,0,3,334,277,208,69,275,2,400,123,203,72,
24,"IASI",225,98603,,435,0,"Sc.PRISACANI","PRISACANI",59,98603,0,3,1577,983,894,89,965,18,1800,817,789,176,
24,"IASI",225,98603,,436,0,"Sc.MACARESTI","PRISACANI",59,98603,0,3,553,368,314,54,359,9,600,232,304,55,
24,"IASI",225,98603,,437,0,"Sc.MORENI","PRISACANI",59,98603,0,3,747,515,460,55,498,17,800,285,398,100,
24,"IASI",225,98649,,438,0,"Sc.PROBOTA","PROBOTA",60,98649,0,3,1029,473,433,40,460,13,1100,627,313,147,
24,"IASI",225,98649,,439,0,"Sc.BALTENI","PROBOTA",60,98649,0,3,429,310,233,77,310,0,500,190,225,85,
24,"IASI",225,98649,,440,0,"Sc.PERIENI","PROBOTA",60,98649,0,3,1318,673,586,87,658,15,1400,727,471,187,
24,"IASI",225,98685,,441,0,"Lic.RADUCANENI","RADUCANENI",61,98685,0,3,1631,847,787,60,829,18,1800,953,611,218,
24,"IASI",225,98685,,442,0,"Sc.RADUCANENI","RADUCANENI",61,98685,0,3,1412,792,718,74,775,17,1500,708,578,197,
24,"IASI",225,98685,,443,0,"Sc.RADUCANENI","RADUCANENI",61,98685,0,3,1146,691,607,84,674,17,1300,609,459,215,
24,"IASI",225,98685,,444,0,"Sc.BOHOTIN","RADUCANENI",61,98685,0,3,1176,789,731,58,775,14,1300,511,547,228,
24,"IASI",225,98685,,445,0,"Sc.ROSU","RADUCANENI",61,98685,0,3,489,276,223,53,270,6,600,324,242,28,
24,"IASI",225,98685,,446,0,"Sc.ISAIIA","RADUCANENI",61,98685,0,3,282,192,166,26,184,8,312,120,130,54,
24,"IASI",225,95239,,447,0,"Sc.REDIU","REDIU",62,95239,0,3,1890,859,745,114,852,7,2000,1141,630,222,
24,"IASI",225,95239,,448,0,"Sc.VALEA LUPULUI","REDIU",62,95239,0,3,1783,1136,861,275,1124,12,2000,864,825,299,
24,"IASI",225,95239,,449,0,"Sc.HORLESTI","REDIU",62,95239,0,3,570,420,268,152,411,9,600,180,299,112,
24,"IASI",225,98738,,450,0,"Sc.ROMANESTI","ROMANESTI",63,98738,0,3,954,589,513,76,575,14,1000,411,473,102,
24,"IASI",225,98738,,451,0,"Sc.AVANTU","ROMANESTI",63,98738,0,3,360,307,192,115,300,7,400,93,232,68,
24,"IASI",225,98738,,452,0,"Sc.URSOAIA","ROMANESTI",63,98738,0,3,253,240,161,79,240,0,300,60,167,73,
24,"IASI",225,98774,,453,0,"Sc.RUGINOASA","RUGINOASA",64,98774,0,3,1705,874,689,185,863,11,1900,1026,616,247,
24,"IASI",225,98774,,454,0,"Sc.DUMBRAVITA","RUGINOASA",64,98774,0,3,1654,901,764,137,892,9,1800,899,671,221,
24,"IASI",225,98774,,455,0,"Sc.REDIU","RUGINOASA",64,98774,0,3,803,514,401,113,506,8,900,386,339,167,
24,"IASI",225,98774,,456,0,"Sc.VASCANI","RUGINOASA",64,98774,0,3,373,260,198,62,255,5,400,140,203,52,
24,"IASI",225,98827,,457,0,"Sc.SCHITU DUCA","SCHITU DUCA",67,98827,0,3,1730,691,573,118,675,16,2000,1309,493,182,
24,"IASI",225,98827,,458,0,"Sc.POIANA","SCHITU DUCA",67,98827,0,3,855,520,401,119,510,10,900,380,385,125,
24,"IASI",225,98827,,459,0,"Sc.POCREACA","SCHITU DUCA",67,98827,0,3,732,394,301,93,386,8,800,406,298,88,
24,"IASI",225,98916,,460,0,"Sc.SCINTEIA","SCANTEIA",65,98916,0,3,1311,770,660,110,756,14,1400,630,525,231,
24,"IASI",225,98916,,461,0,"Sc.BODESTI","SCANTEIA",65,98916,0,3,723,445,402,43,436,9,800,355,288,148,
24,"IASI",225,98916,,462,0,"Gradinita BOROSESTI","SCANTEIA",65,98916,0,3,991,581,525,56,575,6,1100,519,359,216,
24,"IASI",225,98998,,463,0,"Mag.Univ.SCOBINTI","SCOBINTI",68,98998,0,3,1491,758,684,74,746,12,1600,842,598,148,
24,"IASI",225,98998,,464,0,"Sc.BADENI","SCOBINTI",68,98998,0,3,973,656,573,83,648,8,1100,444,517,131,
24,"IASI",225,98998,,465,0,"Sc.FETESTI","SCOBINTI",68,98998,0,3,952,589,515,74,577,12,1000,411,408,169,
24,"IASI",225,98998,,466,0,"Sc.STICLARIA","SCOBINTI",68,98998,0,3,1241,779,684,95,763,16,1300,521,555,208,
24,"IASI",225,98998,,467,0,"Sc.ZAGAVIA","SCOBINTI",68,98998,0,3,773,447,369,78,437,10,800,353,312,125,
24,"IASI",225,99058,,468,0,"Sc.SINESTI","SINESTI",69,99058,0,3,1461,874,778,96,858,16,1600,726,718,140,
24,"IASI",225,99058,,469,0,"Sc.STORNESTI","SINESTI",69,99058,0,3,886,536,503,33,525,11,900,364,438,87,
24,"IASI",225,99058,,470,0,"Sc.OSOI","SINESTI",69,99058,0,3,683,396,346,50,394,2,700,304,364,30,
24,"IASI",225,99101,,471,0,"Camin Cult.SIRETEL","SIRETEL",71,99101,0,3,1682,918,862,56,908,10,1800,882,649,259,
24,"IASI",225,99101,,472,0,"Sc.SLOBOZIA","SIRETEL",71,99101,0,3,672,585,539,46,578,7,700,115,439,139,
24,"IASI",225,99101,,473,0,"Sc.HUMOSU","SIRETEL",71,99101,0,3,578,389,354,35,386,3,600,211,327,59,
24,"IASI",225,99165,,474,0,"Camin Cult.STOLNICENI-PRAJESCU","STOLNICENI-PRAJESCU",72,99165,0,3,1313,617,519,98,604,13,1400,783,419,185,
24,"IASI",225,99165,,475,0,"Sc.COZMESTI","STOLNICENI-PRAJESCU",72,99165,0,3,1551,955,782,173,939,16,1700,745,650,289,
24,"IASI",225,99165,,476,0,"Sc.BRATESTI","STOLNICENI-PRAJESCU",72,99165,0,3,1425,945,850,95,932,13,1500,555,702,230,
24,"IASI",225,99209,,477,0,"Sc.STRUNGA","STRUNGA",73,99209,0,3,512,352,297,55,343,9,584,232,237,106,
24,"IASI",225,99209,,478,0,"Sc.BRATULESTI","STRUNGA",73,99209,0,3,725,505,445,60,488,17,800,295,374,114,
24,"IASI",225,99209,,479,0,"Sc.CRIVESTI","STRUNGA",73,99209,0,3,289,209,172,37,207,2,300,91,179,28,
24,"IASI",225,99209,,480,0,"Sc.FARCASENI","STRUNGA",73,99209,0,3,1509,890,841,49,868,22,1600,710,610,258,
24,"IASI",225,99209,,481,0,"Sc.HABASESTI","STRUNGA",73,99209,0,3,382,308,256,52,303,5,400,92,238,65,
24,"IASI",225,99290,,482,0,"Sc.SCHEIA","SCHEIA",66,99290,0,3,1515,895,709,186,875,20,1700,805,698,177,
24,"IASI",225,99290,,483,0,"Caminul Cult.DRAGUSENI","SCHEIA",66,99290,0,3,1094,705,613,92,697,8,1200,495,576,121,
24,"IASI",225,99290,,484,0,"Sc.CIOCA BOCA","SCHEIA",66,99290,0,3,667,466,358,108,461,5,700,234,364,97,
24,"IASI",225,99370,,485,0,"Sc.SIPOTE","SIPOTE",70,99370,0,3,1722,901,796,105,882,19,1900,999,655,227,
24,"IASI",225,99370,,486,0,"Sc.CHISCARENI","SIPOTE",70,99370,0,3,1377,868,752,116,852,16,1500,632,683,169,
24,"IASI",225,99370,,487,0,"Sc.HALCENI","SIPOTE",70,99370,0,3,1140,778,640,138,769,9,1300,522,667,102,
24,"IASI",225,99441,,488,0,"Gradinita TANSA","TANSA",74,99441,0,3,1408,1058,958,100,1046,12,1600,542,844,202,
24,"IASI",225,99441,,489,0,"Sc.SUHULET","TANSA",74,99441,0,3,1112,812,698,114,798,14,1200,388,505,293,
24,"IASI",225,99478,,490,0,"Caminul Cult.TATARUSI","TATARUSI",76,99478,0,3,1867,884,779,105,870,14,2000,1116,653,217,
24,"IASI",225,99478,,491,0,"Sc.UDA","TATARUSI",76,99478,0,3,1087,751,540,211,742,7,1200,451,546,196,
24,"IASI",225,99478,,492,0,"Sc.PIETROSU","TATARUSI",76,99478,0,3,983,685,501,184,674,11,1100,415,518,156,
24,"IASI",225,99478,,493,0,"Sc.IORCANI","TATARUSI",76,99478,0,3,623,463,372,91,459,4,700,237,334,125,
24,"IASI",225,95499,,494,0,"Sc.RAZBOIENI","TARGU FRUMOS",75,95499,0,3,1053,766,680,86,759,7,1200,434,576,183,
24,"IASI",225,95499,,495,0,"Sc.PRIGORENI","TARGU FRUMOS",75,95499,0,3,701,389,359,30,371,18,800,411,297,74,
24,"IASI",225,95499,,496,0,"Sc.BUZNEA","TARGU FRUMOS",75,95499,0,3,895,643,533,110,533,110,1095,335,494,39,
24,"IASI",225,95499,,497,0,"Sc.GANESTI","TARGU FRUMOS",75,95499,0,3,746,413,379,34,407,6,800,387,352,55,
24,"IASI",225,95499,,498,0,"Sc.COSTESTI","TARGU FRUMOS",75,95499,0,3,978,562,476,86,549,13,1100,538,449,100,
24,"IASI",225,95499,,499,0,"Sc.GIURGESTI","TARGU FRUMOS",75,95499,0,3,443,248,170,78,239,9,400,152,201,38,
24,"IASI",225,95499,,500,0,"Sc.BOURENI","TARGU FRUMOS",75,95499,0,3,1093,768,665,103,758,10,1200,432,673,85,
24,"IASI",225,95499,,501,0,"Sc.BALS","TARGU FRUMOS",75,95499,0,3,1025,674,627,47,663,11,1100,426,529,134,
24,"IASI",225,95499,,502,0,"Sc.COASTA MAGURII","TARGU FRUMOS",75,95499,0,3,177,185,159,26,151,34,200,15,139,12,
24,"IASI",225,95499,,503,0,"Sc.DADESTI","TARGU FRUMOS",75,95499,0,3,201,121,101,20,115,6,300,179,93,22,
24,"IASI",225,99539,,504,0,"Caminul Cult.TODIRESTI","TODIRESTI",80,99539,0,3,1966,994,872,122,988,6,2100,1106,787,201,
24,"IASI",225,99539,,505,0,"Sc.TODIRESTI","TODIRESTI",80,99539,0,3,542,475,250,225,470,5,600,125,372,98,
24,"IASI",225,99539,,506,0,"Caminul Cult.STROIESTI","TODIRESTI",80,99539,0,3,670,398,337,61,388,10,700,292,324,64,
24,"IASI",225,99539,,507,0,"Sc.HARMANESTII VECHI","TODIRESTI",80,99539,0,3,861,739,616,123,732,7,1200,461,595,137,
24,"IASI",225,99539,,508,0,"Caminul Cult.HARMANESTII NOI","TODIRESTI",80,99539,0,3,514,365,297,68,357,8,600,235,294,63,
24,"IASI",225,95293,,509,0,"TOMESTI-DEAL","TOMESTI",81,95293,0,3,812,302,206,96,299,3,900,598,231,68,
24,"IASI",225,95293,,510,0,"Sc.GORUNI","TOMESTI",81,95293,0,3,878,567,456,111,555,12,1000,433,413,142,
24,"IASI",225,95293,,511,0,"Sc.CHICEREA","TOMESTI",81,95293,0,3,612,409,324,85,406,3,700,291,307,99,
24,"IASI",225,95293,,512,0,"Sc.TOMESTI-VALE","TOMESTI",81,95293,0,3,802,504,330,174,494,10,900,396,305,189,
24,"IASI",225,95293,,513,0,"Sc.VLADICENI","TOMESTI",81,95293,0,3,244,186,139,47,184,2,300,114,132,52,
24,"IASI",225,95293,,514,0,"Sc.TOMESTI","TOMESTI",81,95293,0,3,685,826,685,141,821,5,1500,674,539,282,
24,"IASI",225,95293,,515,0,"Sc.TOMESTI","TOMESTI",81,95293,0,3,902,549,461,88,544,5,1000,451,324,220,
24,"IASI",225,95293,,516,0,"Sc.TOMESTI","TOMESTI",81,95293,0,3,1144,658,578,80,654,4,1300,642,419,235,
24,"IASI",225,95293,,517,0,"Sc.TOMESTI","TOMESTI",81,95293,0,3,1059,669,577,92,661,8,1200,531,396,265,
24,"IASI",225,99600,,518,0,"Gradinita TRIFESTI","TRIFESTI",82,99600,0,3,1382,733,640,93,723,10,1500,767,608,115,
24,"IASI",225,99600,,519,0,"Sc.HERMEZIU","TRIFESTI",82,99600,0,3,718,416,352,64,407,9,800,384,308,99,
24,"IASI",225,99600,,520,0,"Sc.ROSCANI","TRIFESTI",82,99600,0,3,559,423,361,62,418,5,600,177,327,91,
24,"IASI",225,99600,,521,0,"Sc.RADENI","TRIFESTI",82,99600,0,3,488,351,285,66,347,4,500,149,255,92,
24,"IASI",225,99600,,522,0,"Sc.ZABOLOTENI","TRIFESTI",82,99600,0,3,446,337,285,52,332,5,500,163,277,55,
24,"IASI",225,99600,,523,0,"Sc.VLADOMIRA","TRIFESTI",82,99600,0,3,166,127,102,25,126,1,200,73,104,22,
24,"IASI",225,99673,,524,0,"Caminul Cult.TIBANA","TIBANA",77,99673,0,3,2188,1057,894,163,1036,21,2400,1343,774,262,
24,"IASI",225,99673,,525,0,"Sc.GIRBESTI","TIBANA",77,99673,0,3,1843,901,769,132,896,5,2000,1099,663,233,
24,"IASI",225,99673,,526,0,"Sc.ALEXENI","TIBANA",77,99673,0,3,502,328,267,61,324,4,600,272,218,106,
24,"IASI",225,99780,,527,0,"Sc.TIBANESTI","TIBANESTI",78,99780,0,3,1656,980,880,100,964,16,1800,820,697,267,
24,"IASI",225,99780,,528,0,"Sc.RAZBOIENI","TIBANESTI",78,99780,0,3,603,408,355,53,407,1,700,292,351,56,
24,"IASI",225,99780,,529,0,"Gradinita GLODENII GANDULUI","TIBANESTI",78,99780,0,3,1350,1008,966,42,994,14,1500,492,747,247,
24,"IASI",225,99780,,530,0,"Sc.JIGORENI","TIBANESTI",78,99780,0,3,776,526,448,78,514,12,900,374,365,149,
24,"IASI",225,99780,,531,0,"Sc.TUNGUJEI","TIBANESTI",78,99780,0,3,834,620,524,96,615,5,900,280,520,95,
24,"IASI",225,99879,,532,0,"Sc.TIGANASI","TIGANASI",79,99879,0,3,888,575,483,92,570,5,1000,425,452,118,
24,"IASI",225,99879,,533,0,"Sc.CIRNICENI","TIGANASI",79,99879,0,3,1051,616,542,74,609,7,1100,484,477,132,
24,"IASI",225,99879,,534,0,"Sc.M.KOGALNICEANU","TIGANASI",79,99879,0,3,699,461,413,48,455,6,800,339,355,100,
24,"IASI",225,99879,,535,0,"Sc.STEJARI","TIGANASI",79,99879,0,3,262,233,183,50,228,5,300,67,181,47,
24,"IASI",225,99922,,536,0,"Sc.TUTORA","TUTORA",83,99922,0,3,1721,1036,948,88,1015,21,1900,864,738,277,
24,"IASI",225,96003,,537,0,"Sc.BOSIA","UNGHENI",84,96003,0,3,1410,836,718,118,833,3,1500,664,596,237,
24,"IASI",225,96003,,538,0,"Sc.UNGHENI","UNGHENI",84,96003,0,3,528,370,292,78,366,1,600,233,263,103,
24,"IASI",225,96003,,539,0,"Sc.MINZATESTI","UNGHENI",84,96003,0,3,954,622,476,146,609,13,1000,378,435,174,
24,"IASI",225,99968,,540,0,"Sc.VALEA SEACA","VALEA SEACA",85,99968,0,3,1520,1495,1391,104,1487,8,1700,205,976,511,
24,"IASI",225,99968,,541,0,"Sc.CONTESTI","VALEA SEACA",85,99968,0,3,1208,1085,989,96,1069,16,1300,215,797,272,
24,"IASI",225,99968,,542,0,"Sc.TOPILE","VALEA SEACA",85,99968,0,3,1564,1168,1063,105,1154,14,1700,532,837,317,
24,"IASI",225,100004,,543,0,"Caminul Cult.VICTORIA","VICTORIA",87,100004,0,3,1899,1041,923,118,1019,22,2100,1059,850,169,
24,"IASI",225,100004,,544,0,"Sc.LUCENI","VICTORIA",87,100004,0,3,890,545,422,123,533,12,1000,455,468,65,
24,"IASI",225,100004,,545,0,"Sc.FRASULENI","VICTORIA",87,100004,0,3,390,285,198,87,282,3,400,115,204,78,
24,"IASI",225,100086,,546,0,"Caminul Cult.VINATOTI","VANATORI",86,100086,0,3,998,690,610,80,685,5,1096,406,512,173,
24,"IASI",225,100086,,547,0,"Sc.CRIVESTI","VANATORI",86,100086,0,3,1178,694,640,54,681,13,1300,606,517,164,
24,"IASI",225,100086,,548,0,"Sc.GURA-BADILITEI","VANATORI",86,100086,0,3,472,346,54,292,344,2,500,154,272,72,
24,"IASI",225,100086,,549,0,"Sc.HIRTOAPE","VANATORI",86,100086,0,3,1003,679,599,80,674,5,1100,421,435,239,
24,"IASI",225,100148,,550,0,"Sc.VLADENI","VLADENI",88,100148,0,3,1555,818,727,91,804,14,1700,882,644,160,
24,"IASI",225,100148,,551,0,"Sc.BORSA","VLADENI",88,100148,0,3,996,613,507,106,599,13,1092,479,520,79,
24,"IASI",225,100148,,552,0,"Sc.IACOBENI","VLADENI",88,100148,0,3,957,581,480,101,565,16,1000,419,483,82,
24,"IASI",225,100219,,553,0,"Sc.VOINESTI","VOINESTI",89,100219,0,3,1411,752,679,73,737,15,1500,733,573,164,
24,"IASI",225,100219,,554,0,"Sc.VOINESTI","VOINESTI",89,100219,0,3,1116,538,487,51,531,7,1200,662,422,109,
24,"IASI",225,100219,,555,0,"Casa Fam. Gheorghita Alexandru VOCOTESTI","VOINESTI",89,100219,0,3,130,101,67,34,97,4,196,95,72,25,
24,"IASI",225,100219,,556,0,"Sc.LUNGANI","VOINESTI",89,100219,0,3,361,283,217,66,280,3,400,117,231,49,
24,"IASI",225,100219,,557,0,"Sc.SCHITU STVNIC","VOINESTI",89,100219,0,3,302,266,196,70,263,3,400,134,234,29,
24,"IASI",225,100219,,558,0,"Sc.SLOBOZIA","VOINESTI",89,100219,0,3,877,419,324,95,414,5,1000,581,367,47,
25,"ILFOV",234,100576,,1,0,"Cantina de aj.social - Aleea Scolii nr.6","ORAS BUFTEA",1,100576,2,1,1535,679,645,34,668,11,1500,821,464,204,
25,"ILFOV",234,100576,,2,0,"Sc.gen.nr.1 - Aleea Scolii nr.2","ORAS BUFTEA",1,100576,2,1,1652,845,717,128,835,10,1600,755,598,237,
25,"ILFOV",234,100576,,3,0,"Sc.gen.nr.1 - Aleea Scolii nr.2","ORAS BUFTEA",1,100576,2,1,1993,788,736,52,773,15,1900,1112,524,249,
25,"ILFOV",234,100576,,4,0,"Sos. Bucuresti Targoviste nr.135","ORAS BUFTEA",1,100576,2,1,2165,913,803,110,904,9,2000,1087,617,287,
25,"ILFOV",234,100576,,5,0,"Str.Stirbei Voda nr.22","ORAS BUFTEA",1,100576,2,1,1938,807,714,93,788,19,1900,1093,481,307,
25,"ILFOV",234,100576,,6,0,"Str.Stirbei Voda nr.22","ORAS BUFTEA",1,100576,2,1,1907,857,810,47,844,13,1900,1043,543,301,
25,"ILFOV",234,100576,,7,0,"Str.Stirbei Voda nr.18","ORAS BUFTEA",1,100576,2,1,1476,674,579,95,667,7,1400,726,444,223,
25,"ILFOV",234,100576,,8,0,"Str.Agricultori nr.11, Sat Buciumeni","ORAS BUFTEA",1,100576,2,1,1503,726,666,60,706,20,1400,674,461,245,
25,"ILFOV",234,100576,,9,0,"Sos. Bucuresti Targoviste nr.14","ORAS BUFTEA",1,100576,2,1,1062,496,451,45,481,15,902,406,329,152,
25,"ILFOV",234,100576,,10,0,"Str. Independentei nr.52, sat Bucoveni","ORAS BUFTEA",1,100576,2,1,1524,774,719,55,760,14,1500,726,531,229,
25,"ILFOV",234,100834,,11,0,"Sos. Bucuresti Urziceni (Monument)","AFUMATI",3,100834,0,3,1176,447,333,114,441,6,1200,753,263,178,
25,"ILFOV",234,100834,,12,0,"Sos. Petrachioaia","AFUMATI",3,100834,0,3,1453,532,430,102,525,7,1602,1070,344,181,
25,"ILFOV",234,100834,,13,0,"Sos. Bucuresti Urziceni (Ograda Sindicat)","AFUMATI",3,100834,0,3,1065,461,366,95,441,20,1100,639,294,147,
25,"ILFOV",234,100834,,14,0,"Str. Scolii (Ograda Stefanesti)","AFUMATI",3,100834,0,3,1029,426,293,133,420,6,1083,657,258,162,
25,"ILFOV",234,100969,,15,0,"Sos. Unirii nr.6","BALOTESTI",4,100969,0,3,2248,1133,909,224,1123,10,2400,1267,738,385,
25,"ILFOV",234,100969,,16,0,"Sos. Unirii nr.224","BALOTESTI",4,100969,0,3,1385,658,517,141,650,8,1500,842,420,230,
25,"ILFOV",234,100969,,17,0,"Str. I.C.Bratianu nr.10","BALOTESTI",4,100969,0,3,823,433,282,151,430,3,900,467,310,120,
25,"ILFOV",234,101145,,18,0,"Berceni","BERCENI",5,101145,0,3,1857,858,736,122,830,28,1800,942,594,236,
25,"ILFOV",234,101145,,19,0,"Berceni","BERCENI",5,101145,0,3,1296,663,579,84,652,11,1400,737,473,179,
25,"ILFOV",234,179221,,20,0,"Sos. Alexandriei nr.249","BRAGADIRU",6,179221,0,3,1748,734,587,147,727,7,1800,1066,466,261,
25,"ILFOV",234,179221,,21,0,"Sos. Alexandriei nr.249","BRAGADIRU",6,179221,0,3,1889,942,794,148,933,9,1900,958,502,431,
25,"ILFOV",234,179221,,22,0,"Sos. Alexandriei nr.249","BRAGADIRU",6,179221,0,3,1791,848,713,135,839,9,1800,952,483,356,
25,"ILFOV",234,101298,,23,0,"Cartier Bajenari","BRANESTI",7,101298,0,3,1488,653,540,113,646,7,1500,847,367,279,
25,"ILFOV",234,101298,,24,0,"Str. Slt. Petre Ionel","BRANESTI",7,101298,0,3,1933,942,733,209,925,17,1998,1056,597,328,
25,"ILFOV",234,101298,,25,0,"Branesti","BRANESTI",7,101298,0,3,1495,851,627,224,837,14,1598,747,571,266,
25,"ILFOV",234,101298,,26,0,"Sat Pasarea","BRANESTI",7,101298,0,3,582,350,167,183,345,5,600,250,264,81,
25,"ILFOV",234,101298,,27,0,"Sat Islaz","BRANESTI",7,101298,0,3,943,908,670,238,897,11,1000,92,637,260,
25,"ILFOV",234,101742,,28,0,"Sat Cernica","CERNICA",8,101742,0,3,2432,1010,743,267,998,11,2495,1485,763,235,
25,"ILFOV",234,101742,,29,0,"Sat Tanganu","CERNICA",8,101742,0,3,1743,1040,796,244,1027,13,1800,760,702,325,
25,"ILFOV",234,101742,,30,0,"Sat Caldararu","CERNICA",8,101742,0,3,715,465,292,173,460,5,700,235,354,106,
25,"ILFOV",234,101742,,31,0,"Sat Balaceanca","CERNICA",8,101742,0,3,1397,696,561,135,687,9,1397,701,441,246,
25,"ILFOV",234,101742,,32,0,"Sat Posta","CERNICA",8,101742,0,3,273,258,125,133,252,6,300,42,156,96,
25,"ILFOV",234,179249,,33,0,"Str. Pacii nr.75","CHIAJNA",9,179249,0,3,1745,841,748,93,829,12,1600,759,647,182,
25,"ILFOV",234,179249,,34,0,"Str. Pacii nr.75","CHIAJNA",9,179249,0,3,1805,809,734,75,797,12,1900,1091,640,157,
25,"ILFOV",234,179249,,35,0,"Str. 1 Decembrie 1918, nr. 92","CHIAJNA",9,179249,0,3,1047,620,536,84,610,10,1100,480,448,162,
25,"ILFOV",234,179249,,36,0,"Str. 1 Decembrie 1918, nr. 92, Rosu","CHIAJNA",9,179249,0,3,1180,900,794,106,854,46,1200,300,715,139,
25,"ILFOV",234,179249,,37,1,"Str. 1 Decembrie 1918, nr. 2, Rosu (U.M.)","CHIAJNA",9,179249,0,3,0,550,0,550,520,30,623,73,367,153,
25,"ILFOV",234,179285,,38,0,"SOS BANATULUI,NR.2","CHITILA",10,179285,0,3,1192,584,485,99,566,18,1300,716,350,216,
25,"ILFOV",234,179285,,39,0,"SOS. BANATULUI,NR.85","CHITILA",10,179285,0,3,2331,1300,1054,246,1280,20,2400,1100,821,459,
25,"ILFOV",234,179285,,40,0,"SOS.BANATULUI,NR.46","CHITILA",10,179285,0,3,3085,1556,1328,228,1483,15,3100,1544,1012,471,
25,"ILFOV",234,179285,,41,0,"STR.SCOLII,NR.36,CHITILA","CHITILA",10,179285,0,3,1686,931,784,147,918,13,1800,869,619,299,
25,"ILFOV",234,179285,,42,0,"STR.PANDURI,NR.1,SAT RUDENI","CHITILA",10,179285,0,3,874,391,300,91,382,9,800,409,233,149,
25,"ILFOV",234,179285,,43,1,"U.M. SAT RUDENI","CHITILA",10,179285,0,3,0,223,0,223,203,20,308,85,127,76,
25,"ILFOV",234,101902,,44,0,"CAMIN CULTURAL,CIOLPANI","CIOLPANI",11,101902,0,3,1790,831,685,146,823,8,1790,959,632,191,
25,"ILFOV",234,101902,,45,0,"SAT PISCU","CIOLPANI",11,101902,0,3,668,418,370,48,414,4,602,184,313,101,
25,"ILFOV",234,101902,,46,0,"SAT IZVORANI","CIOLPANI",11,101902,0,3,407,271,137,134,265,6,500,229,190,75,
25,"ILFOV",234,101902,,47,0,"SAT TIGANESTI","CIOLPANI",11,101902,0,3,659,429,301,128,420,9,700,271,248,172,
25,"ILFOV",234,101902,,48,1,"U.M. CIOLPANI","CIOLPANI",11,101902,0,3,0,465,0,465,458,7,500,35,303,155,
25,"ILFOV",234,101957,,49,0,"SOS BUCURESTI,NR.110","CIOROGARLA",12,101957,0,3,953,550,494,56,534,16,1500,947,394,140,
25,"ILFOV",234,101957,,50,0,"SOS BUCURESTI,NR.110","CIOROGARLA",12,101957,0,3,1254,581,530,51,572,9,1100,519,388,184,
25,"ILFOV",234,101957,,51,0,"SAT DIRVARI,STR ADUNATI,NR.29","CIOROGARLA",12,101957,0,3,1106,550,423,127,536,14,1000,450,412,124,
25,"ILFOV",234,102035,,52,0,"STR.MONUMENTUL EROILOR,NR.120","CLINCENI",13,102035,0,3,1354,643,423,220,631,12,1400,757,341,290,
25,"ILFOV",234,102035,,53,0,"STR.PRINCIPALA,NR.107,CLINCENI","CLINCENI",13,102035,0,3,1422,790,594,196,786,4,1500,710,531,255,
25,"ILFOV",234,102035,,54,0,"STR.CIOROGIRLEI,NR.10,SAT OLTENI","CLINCENI",13,102035,0,3,610,361,266,95,355,6,704,343,206,149,
25,"ILFOV",234,102160,,55,0,"CORBEANCA","CORBEANCA",14,102160,0,3,1281,607,467,140,597,10,1400,793,426,171,
25,"ILFOV",234,102160,,56,0,"SAT TEMESI","CORBEANCA",14,102160,0,3,1300,604,514,90,597,7,1300,696,432,165,
25,"ILFOV",234,102213,,57,0,"SOS ALEXANDRIEI,NR.134","CORNETU",15,102213,0,3,1804,823,646,177,815,8,1893,1070,520,295,
25,"ILFOV",234,102213,,58,0,"SOS ALEXANDRIEI,NR.159","CORNETU",15,102213,0,3,1304,632,450,182,623,9,1400,768,420,203,
25,"ILFOV",234,102473,,59,0,"SAT DASCALU","DASCALU",17,102473,0,3,1546,672,578,94,651,21,1594,922,483,168,
25,"ILFOV",234,102473,,60,0,"SAT GAGU","DASCALU",17,102473,0,3,498,255,182,73,253,2,500,245,159,94,
25,"ILFOV",234,102525,,61,0,"STR.MIHAI EMINESCU,NR.5","DARASTI-ILFOV",16,102525,0,3,1040,811,715,96,796,15,1100,289,590,206,
25,"ILFOV",234,102525,,62,0,"STR.MIHAI EMINESCU,NR.5","DARASTI-ILFOV",16,102525,0,3,1173,861,781,80,825,36,1300,439,648,177,
25,"ILFOV",234,179310,,63,0,"STR. NICOLAE BALCESCU,NR.16-18","DOBROIESTI",18,179310,0,3,1505,720,638,82,709,11,1700,980,512,197,
25,"ILFOV",234,179310,,64,0,"STR. NICOLAE BALCESCU,NR.16-18","DOBROIESTI",18,179310,0,3,1304,612,545,67,597,15,1500,888,384,213,
25,"ILFOV",234,179310,,65,0,"SOS.FUNDENI,NR.134","DOBROIESTI",18,179310,0,3,1862,980,817,163,953,27,1900,920,707,246,
25,"ILFOV",234,102570,,66,0,"SAT COJESTI","DOMNESTI",19,102570,0,3,1967,915,707,208,899,16,2000,1085,578,321,
25,"ILFOV",234,102570,,67,0,"SAT DOMNESTI","DOMNESTI",19,102570,0,3,1923,751,603,148,737,14,2100,1349,528,209,
25,"ILFOV",234,102570,,68,0,"SAT TEGHES","DOMNESTI",19,102570,0,3,373,206,155,51,198,8,400,194,158,40,
25,"ILFOV",234,102605,,69,0,"STR.REPUBLICII,NR.142,DRAGOMIRESTI DEAL","DRAGOMIRESTI-VALE",20,102605,0,3,1604,771,680,91,761,10,1578,807,531,230,
25,"ILFOV",234,102605,,70,0,"STR.MICS.,NR.102,DRAGOMIRESTI-VALE","DRAGOMIRESTI-VALE",20,102605,0,3,772,385,286,99,377,8,800,415,244,133,
25,"ILFOV",234,102605,,71,0,"STR.GHIOCEILOR,NR.33,SAT ZURBAUA","DRAGOMIRESTI-VALE",20,102605,0,3,598,401,331,70,400,1,571,170,239,161,
25,"ILFOV",234,103130,,72,0,"SAT GANEASA","GANEASA",21,103130,0,3,555,273,198,75,266,7,600,327,186,80,
25,"ILFOV",234,103130,,73,0,"SAT MOARA- DOMNESCA","GANEASA",21,103130,0,3,382,260,158,102,255,5,400,140,161,94,
25,"ILFOV",234,103130,,74,0,"SAT COZIENI","GANEASA",21,103130,0,3,438,220,201,19,216,4,700,480,196,20,
25,"ILFOV",234,103130,,75,0,"SAT SINDRILITA","GANEASA",21,103130,0,3,695,250,165,85,249,1,800,550,204,45,
25,"ILFOV",234,103130,,76,0,"SAT PITEASCA","GANEASA",21,103130,0,3,943,400,315,85,395,5,1000,600,291,104,
25,"ILFOV",234,179347,,77,0,"SAT GLINA,STR.PARCULUI,NR.1","GLINA",22,179347,0,3,1991,785,627,158,769,16,2096,1311,584,185,
25,"ILFOV",234,179347,,78,0,"SAT BOBESTI,SOS.LIBERTATII,NR.202","GLINA",22,179347,0,3,1305,568,442,126,560,8,1500,932,474,86,
25,"ILFOV",234,179347,,79,0,"SAT CATELU,SOS.LIBERTATII,NR.128","GLINA",22,179347,0,3,1585,956,636,320,940,16,1700,743,616,324,
25,"ILFOV",234,103443,,80,0,"SAT GRADISTEA","GRADISTEA",23,103443,0,3,1458,739,626,113,721,18,1599,860,529,192,
25,"ILFOV",234,103443,,81,0,"SAT SITARU","GRADISTEA",23,103443,0,3,690,469,346,123,457,12,758,289,337,120,
25,"ILFOV",234,103513,,82,0,"SAT GRUIU","GRUIU",24,103513,0,3,1725,865,703,162,859,6,1900,1035,676,183,
25,"ILFOV",234,103513,,83,0,"SAT LIPIA","GRUIU",24,103513,0,3,1551,1063,833,230,1056,7,1700,637,770,286,
25,"ILFOV",234,103513,,84,0,"SAT SILISTEA SNAGOVULUI","GRUIU",24,103513,0,3,1633,1166,972,194,1151,15,1800,634,898,253,
25,"ILFOV",234,103513,,85,0,"SAT SANTUL FLORESTI","GRUIU",24,103513,0,3,381,293,176,117,288,5,400,107,204,84,
25,"ILFOV",234,179383,,86,0,"SOS GIURGIULUI,NR.5","JILAVA",25,179383,0,3,1703,849,656,193,835,14,1800,951,530,305,
25,"ILFOV",234,179383,,87,0,"STR.ODAI,NR.142","JILAVA",25,179383,0,3,1305,596,539,57,585,11,1387,791,375,210,
25,"ILFOV",234,179383,,88,0,"SOS GIURGIULUI,NR.266","JILAVA",25,179383,0,3,1858,869,783,86,767,16,2000,1217,469,298,
25,"ILFOV",234,179383,,89,0,"STR.VERII,NR.33","JILAVA",25,179383,0,3,1901,1029,922,107,1020,9,2000,971,752,268,
25,"ILFOV",234,179383,,90,1,"PENITENCIAR + SPITAL,JILAVA","JILAVA",25,179383,0,3,0,1612,0,1612,1561,51,3012,1400,1217,344,
25,"ILFOV",234,179409,,91,0,"STR CALUGARENI,NR.8","MAGURELE",26,179409,0,3,1754,771,671,100,764,7,1750,979,471,293,
25,"ILFOV",234,179409,,92,0,"STR FIZICIENILOR,NR.30","MAGURELE",26,179409,0,3,1523,842,676,166,827,15,1550,708,564,263,
25,"ILFOV",234,179409,,93,0,"STR CHIRCA,NR.1","MAGURELE",26,179409,0,3,1235,626,473,153,614,12,1350,724,373,241,
25,"ILFOV",234,179409,,94,0,"STR.DUZILOR,NR.131,DUMITRANA","MAGURELE",26,179409,0,3,624,373,291,82,360,13,650,277,222,138,
25,"ILFOV",234,179409,,95,0,"STR.ALUNIS,NR.69,ALUNIS","MAGURELE",26,179409,0,3,835,373,305,68,365,8,850,477,245,120,
25,"ILFOV",234,179409,,96,1,"U.M. MAGURELE","MAGURELE",26,179409,0,3,0,1130,0,1130,1089,41,1150,20,642,447,
25,"ILFOV",234,179409,,97,0,"STR.FIZICIENILOR,NR.130 (CAMIN STUDENTESC)","MAGURELE",26,179409,0,3,0,317,0,317,296,21,1000,683,195,101,
25,"ILFOV",234,104243,,98,0,"SAT MOARA-VLASIEI","MOARA VLASIEI",27,104243,0,3,1347,662,482,180,653,9,1400,738,456,197,
25,"ILFOV",234,104243,,99,0,"SAT MOARA-VLASIEI","MOARA VLASIEI",27,104243,0,3,1664,1104,892,212,1074,30,1900,796,801,273,
25,"ILFOV",234,104243,,100,0,"SAT CACIULATI","MOARA VLASIEI",27,104243,0,3,1180,522,386,136,507,15,1300,778,348,159,
25,"ILFOV",234,179463,,101,0,"STR.BUCURESTI-TARGOVISTE,NR.107","MOGOSOAIA",28,179463,0,3,2117,1032,893,139,991,41,2300,1268,693,298,
25,"ILFOV",234,179463,,102,0,"STR.BUCURESTI-TARGOVISTE.NR.107","MOGOSOAIA",28,179463,0,3,1711,1218,950,268,1210,8,1800,582,875,335,
25,"ILFOV",234,104421,,103,0,"SAT MERII PUTCHII","NUCI",29,104421,0,3,1112,531,442,89,517,14,1200,669,374,143,
25,"ILFOV",234,104421,,104,0,"SAT MICSUNESTI MOARA","NUCI",29,104421,0,3,1293,752,666,86,749,3,1400,648,583,166,
25,"ILFOV",234,179481,,105,0,"STR.SCOLII,NR.6","OTOPENI",30,179481,0,3,830,504,382,122,495,9,900,396,350,145,
25,"ILFOV",234,179481,,106,0,"STR.23 AUGUST,NR.6","OTOPENI",30,179481,0,3,1413,712,583,129,698,14,1500,788,504,194,
25,"ILFOV",234,179481,,107,0,"STR.23 AUGUST,NR.6","OTOPENI",30,179481,0,3,1943,843,710,133,831,12,2193,1350,607,224,
25,"ILFOV",234,179481,,108,0,"STR.23 AUGUST,NR.10","OTOPENI",30,179481,0,3,1473,748,599,149,745,3,1500,752,481,264,
25,"ILFOV",234,179481,,109,0,"STR.23 AUGUST,NR.99","OTOPENI",30,179481,0,3,960,459,407,52,445,14,1000,541,283,162,
25,"ILFOV",234,179481,,110,0,"CALEA BUCURESTILOR,NR.247","OTOPENI",30,179481,0,3,756,339,292,47,334,5,800,461,243,91,
25,"ILFOV",234,179481,,111,0,"CALEA BUCURESTILOR (INGG)","OTOPENI",30,179481,0,3,430,284,179,105,282,2,500,216,207,75,
25,"ILFOV",234,179481,,112,1,"SOS.BUCURESTI-PLOIESTI,KM.16,5 (U.M.)","OTOPENI",30,179481,0,3,0,334,0,334,313,21,400,66,181,132,
25,"ILFOV",234,179481,,113,1,"INCINTA AEROPORT OTOPENI - PASAGERI AFLATI IN TRANZIT","OTOPENI",30,179481,0,3,0,646,0,646,640,6,784,138,456,184,
25,"ILFOV",234,179515,,114,0,"B-DUL BIRUINTEI,NR.36","PANTELIMON",31,179515,0,3,1454,697,697,0,684,13,1514,817,483,201,
25,"ILFOV",234,179515,,115,0,"B-DUL BIRUINTEI,NR.36","PANTELIMON",31,179515,0,3,1582,758,627,131,740,18,1599,841,514,226,
25,"ILFOV",234,179515,,116,0,"B-DUL BIRUINTEI,NR.36","PANTELIMON",31,179515,0,3,1632,664,664,0,659,5,1699,1035,453,206,
25,"ILFOV",234,179515,,117,0,"B-DUL BIRUINTEI,NR.70","PANTELIMON",31,179515,0,3,478,206,206,0,204,2,500,294,128,76,
25,"ILFOV",234,179515,,118,0,"B-DUL BIRUINTEI,NR.70","PANTELIMON",31,179515,0,3,1143,537,537,0,525,12,1200,663,386,139,
25,"ILFOV",234,179515,,119,0,"STR.MIORITEI,NR.24","PANTELIMON",31,179515,0,3,1553,876,876,0,861,15,1692,816,608,253,
25,"ILFOV",234,179515,,120,0,"STR.MIORITEI,NR.24","PANTELIMON",31,179515,0,3,1544,639,519,120,622,17,1700,1061,452,170,
25,"ILFOV",234,179515,,121,0,"STR.MIORITEI,NR.24","PANTELIMON",31,179515,0,3,1815,837,694,143,826,11,1900,1063,591,235,
25,"ILFOV",234,179515,,122,0,"MANASTIREA CERNICA","PANTELIMON",31,179515,0,3,88,104,69,35,94,10,204,100,50,44,
25,"ILFOV",234,179515,,123,1,"SOS DE CENTURA (U.M.)","PANTELIMON",31,179515,0,3,0,300,0,300,292,8,300,0,165,127,
25,"ILFOV",234,179515,,124,1,"STR.RASCOALEI (U.M.)","PANTELIMON",31,179515,0,3,0,75,0,75,73,2,100,25,40,33,
25,"ILFOV",234,104546,,125,0,"SAT PERIS","PERIS",32,104546,0,3,2107,859,814,45,851,8,2200,1341,584,267,
25,"ILFOV",234,104546,,126,0,"SAT BRATULESTI","PERIS",32,104546,0,3,1549,806,603,203,798,8,1595,789,529,269,
25,"ILFOV",234,104546,,127,0,"SAT BURIAS","PERIS",32,104546,0,3,1020,609,465,144,603,6,1099,490,456,147,
25,"ILFOV",234,104546,,128,0,"SAT COCIOC","PERIS",32,104546,0,3,466,300,221,79,299,1,500,200,188,111,
25,"ILFOV",234,104546,,129,0,"SAT BALTENI","PERIS",32,104546,0,3,184,240,117,123,240,0,300,60,176,64,
25,"ILFOV",234,104582,,130,0,"SAT PETRACHIOAIA","PETRACHIOAIA",33,104582,0,3,1926,678,572,106,662,16,2000,1322,399,263,
25,"ILFOV",234,179533,,131,0,"STR.SCOLII,NR.4","POPESTI LEORDENI",34,179533,0,3,1702,996,787,209,973,23,1800,804,736,237,
25,"ILFOV",234,179533,,132,0,"STR.SCOLII,NR.4","POPESTI LEORDENI",34,179533,0,3,1215,545,466,79,535,10,1300,755,369,166,
25,"ILFOV",234,179533,,133,0,"STR.LEORDENI,NR.52","POPESTI LEORDENI",34,179533,0,3,1190,815,690,125,797,18,1298,483,569,228,
25,"ILFOV",234,179533,,134,0,"STR.LEORDENI,NR.52","POPESTI LEORDENI",34,179533,0,3,1183,525,460,65,519,6,1299,774,335,184,
25,"ILFOV",234,179533,,135,0,"STR.UNIRII,NR.19","POPESTI LEORDENI",34,179533,0,3,1180,644,554,90,637,7,1306,662,434,203,
25,"ILFOV",234,179533,,136,0,"STR.UNIRII,NR.19","POPESTI LEORDENI",34,179533,0,3,1351,482,397,85,466,16,1403,921,292,174,
25,"ILFOV",234,179533,,137,0,"STR.DOMNITA BALASA,NR.13","POPESTI LEORDENI",34,179533,0,3,1638,965,783,182,944,21,1800,835,649,295,
25,"ILFOV",234,179533,,138,0,"STR.OLTENITEI,NR.181","POPESTI LEORDENI",34,179533,0,3,1538,1002,636,366,992,10,1700,698,549,443,
25,"ILFOV",234,105160,,139,0,"SAT SNAGOV","SNAGOV",35,105160,0,3,1807,733,443,290,722,11,2000,1267,503,219,
25,"ILFOV",234,105160,,140,0,"SAT GHERMANESTI","SNAGOV",35,105160,0,3,929,844,456,388,815,7,1000,156,514,301,
25,"ILFOV",234,105160,,141,0,"SAT CIOFLICENI","SNAGOV",35,105160,0,3,808,421,254,167,412,9,900,479,251,161,
25,"ILFOV",234,105160,,142,0,"SAT TINCABESTI","SNAGOV",35,105160,0,3,748,529,291,238,527,2,800,271,375,152,
25,"ILFOV",234,105419,,143,0,"SAT STEFANESTII DE JOS","STEFANESTII DE JOS",36,105419,0,3,1506,1382,1382,0,1352,30,1599,217,1070,282,
25,"ILFOV",234,105419,,144,0,"SAT STEFANESTII DE SUS,BOLTASI,CRETUEASCA","STEFANESTII DE JOS",36,105419,0,3,1553,1162,1162,0,1146,16,1500,338,762,384,
25,"ILFOV",234,105570,,145,0,"STR.MIHAI EMINESCU,NR.3","TUNARI",37,105570,0,3,1460,722,595,127,711,11,1600,878,490,221,
25,"ILFOV",234,105570,,146,0,"STR.MIHAI EMINESCU,NR.3","TUNARI",37,105570,0,3,1177,538,332,206,526,12,1300,762,319,207,
25,"ILFOV",234,105936,,147,0,"STR.PRINCIPALA,COM.VIDRA","VIDRA",38,105936,0,3,1646,646,347,299,637,9,1800,1154,408,229,
25,"ILFOV",234,105936,,148,0,"STR.PRINCIPALA,SAT VIDRA","VIDRA",38,105936,0,3,1421,489,279,210,486,3,1500,1011,273,213,
25,"ILFOV",234,105936,,149,0,"SAT CRETESTI","VIDRA",38,105936,0,3,1273,594,308,286,575,19,1400,806,374,201,
25,"ILFOV",234,105936,,150,0,"SAT CRETESTI","VIDRA",38,105936,0,3,732,340,167,173,337,3,800,460,201,136,
25,"ILFOV",234,105936,,151,0,"SAT SINTESTI","VIDRA",38,105936,0,3,1098,743,347,396,728,15,1200,457,449,279,
25,"ILFOV",234,179551,,152,0,"SOS.STEFANESTI,NR.6","VOLUNTARI",39,179551,0,3,1315,672,563,109,663,9,1400,728,435,228,
25,"ILFOV",234,179551,,153,0,"B-DUL TUDOR VLADIMIRESCU,NR.38","VOLUNTARI",39,179551,0,3,1257,587,483,104,581,6,1400,813,402,179,
25,"ILFOV",234,179551,,154,0,"B-DUL TUDOR VLADIMIRESCU,NR.37","VOLUNTARI",39,179551,0,3,1311,644,550,94,635,9,1400,756,452,183,
25,"ILFOV",234,179551,,155,0,"B-DUL TUDOR VLADIMIRESCU,NR.42","VOLUNTARI",39,179551,0,3,1272,686,595,91,676,10,1401,715,467,209,
25,"ILFOV",234,179551,,156,0,"STR.ANTON PANN,NR.7","VOLUNTARI",39,179551,0,3,1205,549,455,94,546,3,1290,741,395,151,
25,"ILFOV",234,179551,,157,0,"STR.ANTON PANN,NR.7","VOLUNTARI",39,179551,0,3,1260,610,525,85,602,8,1381,771,422,180,
25,"ILFOV",234,179551,,158,0,"STR.ANTON PANN,NR.7","VOLUNTARI",39,179551,0,3,1445,723,649,74,718,5,1600,877,496,222,
25,"ILFOV",234,179551,,159,0,"B-DUL DUNARII,NR.43","VOLUNTARI",39,179551,0,3,1655,768,681,87,764,4,1800,1032,523,241,
25,"ILFOV",234,179551,,160,0,"B-DUL DUNARII,NR.43","VOLUNTARI",39,179551,0,3,1327,709,642,67,703,6,1400,691,472,231,
25,"ILFOV",234,179551,,161,0,"B-DUL DUNARII,NR.43","VOLUNTARI",39,179551,0,3,1312,607,556,51,598,9,1400,793,377,221,
25,"ILFOV",234,179551,,162,0,"SOS.AFUMATI,NR.93","VOLUNTARI",39,179551,0,3,1431,762,656,106,749,13,1500,738,579,170,
25,"ILFOV",234,179551,,163,0,"SOS.AFUMATI,NR.72","VOLUNTARI",39,179551,0,3,1645,645,534,111,639,6,1800,1155,442,197,
25,"ILFOV",234,179551,,164,0,"B-DUL NICOLAE BALCESCU,NR.38","VOLUNTARI",39,179551,0,3,1533,673,580,93,670,3,1700,1027,491,179,
25,"ILFOV",234,179551,,165,0,"B-DUL NICOLAE BALCESCU,NR.38","VOLUNTARI",39,179551,0,3,1399,690,613,77,676,14,1500,810,448,228,
25,"ILFOV",234,179551,,166,0,"STR.SERBAN IONEL,NR.1","VOLUNTARI",39,179551,0,3,1404,576,469,107,570,6,1500,924,402,168,
25,"ILFOV",234,179551,,167,0,"STR.SERBAN IONEL,NR.1","VOLUNTARI",39,179551,0,3,1241,612,499,113,609,3,1300,688,339,270,
25,"ILFOV",234,102543,,168,0,"COM. 1 DECEMBRIE","1 DECEMBRIE",2,102543,0,3,2447,1178,937,241,1165,13,2400,1222,654,511,
25,"ILFOV",234,102543,,169,0,"COM. 1 DECEMBRIE","1 DECEMBRIE",2,102543,0,3,1800,785,680,105,779,6,1800,1015,443,336,
25,"ILFOV",234,102543,,170,0,"SAT COPACENI,CAMINUL CULTURAL","1 DECEMBRIE",2,102543,0,3,1300,706,630,76,697,9,1300,594,382,315,
25,"ILFOV",234,102543,,171,0,"SAT COPACENI","1 DECEMBRIE",2,102543,0,3,1140,500,462,38,489,11,1100,600,311,178,
26,"MARAMURES",243,106318,,1,0,"VALEA BORCUTULUI, NR. 76, CAMINUL CULTURAL, BAIA MARE","MUNICIPIUL BAIA MARE",1,106318,1,1,1140,646,540,106,637,9,1300,654,394,243,
26,"MARAMURES",243,106318,,2,0,"STR. VICTORIEI NR. 132/A, SCOALA NR. 12, BAIA MARE","MUNICIPIUL BAIA MARE",1,106318,1,1,2408,1099,1001,98,1090,9,2600,1501,713,377,
26,"MARAMURES",243,106318,,3,0,"STR. V.BABES NR. 64, GRUPUL SCOLAR GHEORGHE LAZAR, BAIA MARE","MUNICIPIUL BAIA MARE",1,106318,1,1,2096,913,860,53,898,15,2300,1387,588,310,
26,"MARAMURES",243,106318,,4,0,"STR. DR. V. BABES NR. 62/A, UNIVERSITATEA I, BAIA MARE","MUNICIPIUL BAIA MARE",1,106318,1,1,1989,1116,914,202,1098,18,2200,1084,750,348,
26,"MARAMURES",243,106318,,5,0,"STR. NARCISELOR NR. 4B, GRADINITA NR. 30, BAIA MARE","MUNICIPIUL BAIA MARE",1,106318,1,1,2283,1121,1078,43,1105,16,2500,1379,849,256,
26,"MARAMURES",243,106318,,6,0,"STR. IZA NR. 2, SCOALA NICHITA STANESCU, BAIA MARE","MUNICIPIUL BAIA MARE",1,106318,1,1,2279,1111,1033,78,1092,19,2500,1389,801,291,
26,"MARAMURES",243,106318,,7,0,"STR. VICTORIEI NR. 84, SCOALA NR. 4, BAIA MARE","MUNICIPIUL BAIA MARE",1,106318,1,1,2250,1111,1045,66,1103,8,2500,1389,854,249,
26,"MARAMURES",243,106318,,8,0,"STR. GH. MARINESCU NR. 1, GRUPUL SCOLAR ELECTROMECANIC, BAIA MARE","MUNICIPIUL BAIA MARE",1,106318,1,1,2389,1142,1081,61,1124,18,2600,1458,899,225,
26,"MARAMURES",243,106318,,9,0,"STR. VICTORIEI NR. 76, UNIVERSITATEA II, BAIA MARE","MUNICIPIUL BAIA MARE",1,106318,1,1,2022,1154,984,170,1142,12,2200,1046,898,244,
26,"MARAMURES",243,106318,,10,0,"STR. VICTORIEI NR. 35, S.C. ENERGOTERM S.A., BAIA MARE","MUNICIPIUL BAIA MARE",1,106318,1,1,2322,1291,1206,85,1272,19,2600,1309,1057,215,
26,"MARAMURES",243,106318,,11,0,"STR. PETOFI NR. 2, SCOALA NR. 20, BAIA MARE","MUNICIPIUL BAIA MARE",1,106318,1,1,2213,1049,1007,42,1024,25,2400,1351,843,181,
26,"MARAMURES",243,106318,,12,0,"STR. MINERILOR NR. 3, GRUPUL SCOLAR SANITAR, BAIA MARE","MUNICIPIUL BAIA MARE",1,106318,1,1,1151,556,510,46,546,10,1300,744,419,127,
26,"MARAMURES",243,106318,,13,0,"STR. INDUSTRIEI NR. 1, GRADINITA NR. 12, BAIA MARE","MUNICIPIUL BAIA MARE",1,106318,1,1,1569,763,726,37,745,18,1700,937,579,166,
26,"MARAMURES",243,106318,,14,0,"STR. ARENEI NR. 15, SCOALA NR. 16, BAIA MARE","MUNICIPIUL BAIA MARE",1,106318,1,1,2156,1119,1045,74,1095,24,2400,1281,744,351,
26,"MARAMURES",243,106318,,15,0,"STR. LUNCI NR. 22, SCOALA NR. 9, BAIA MARE","MUNICIPIUL BAIA MARE",1,106318,1,1,1854,1085,1010,75,1074,11,2000,915,592,482,
26,"MARAMURES",243,106318,,16,0,"SCOALA NR. 13,, FIRIZA","MUNICIPIUL BAIA MARE",1,106318,1,1,1239,870,793,77,858,12,1400,530,406,452,
26,"MARAMURES",243,106318,,17,0,"STR. V. LUCACIU NR. 65, SCOALA OCTAVIAN GOGA, BAIA MARE","MUNICIPIUL BAIA MARE",1,106318,1,1,2365,1308,1130,178,1284,24,2600,1292,1045,239,
26,"MARAMURES",243,106318,,18,0,"STR. GHEORGHE SINCAI NR. 25, COLEGIUL NATIONAL GHEORGHE SINCAI, BAIA MARE","MUNICIPIUL BAIA MARE",1,106318,1,1,1941,1045,909,136,1027,18,2100,1055,844,183,
26,"MARAMURES",243,106318,,19,0,"STR. CULTURII NR. 2, COLEGIUL NATIONAL VASILE LUCACIU, BAIA MARE","MUNICIPIUL BAIA MARE",1,106318,1,1,2015,1032,998,34,1012,20,2200,1168,828,184,
26,"MARAMURES",243,106318,,20,0,"STR. CULTURII NR. 8, GRUPUL SCOLAR DE POSTA SI TELECOMUNICATII, BAIA MARE","MUNICIPIUL BAIA MARE",1,106318,1,1,1770,948,894,54,940,8,1900,952,755,185,
26,"MARAMURES",243,106318,,21,0,"STR. PROGRESULUI NR. 43, GRUPUL SCOLAR TEHNIC ANGHEL SALIGNY, BAIA MARE","MUNICIPIUL BAIA MARE",1,106318,1,1,1800,985,915,70,968,17,1992,1007,754,214,
26,"MARAMURES",243,106318,,22,0,"STR. PROGRESULUI NR. 38, SCOALA LUCIAN BLAGA, BAIA MARE","MUNICIPIUL BAIA MARE",1,106318,1,1,2287,1108,1057,51,1100,8,2500,1392,824,276,
26,"MARAMURES",243,106318,,23,0,"STR. LUMINISULUI NR. 1, GRUPUL SCOLAR INDUSTRIAL METALURGIC C.D. NENITESCU, BAIA MARE","MUNICIPIUL BAIA MARE",1,106318,1,1,1700,753,639,114,745,8,1900,1147,431,314,
26,"MARAMURES",243,106318,,24,0,"STR. LUMINISULUI NR. 1, GRUPUL SCOLAR IND. METALURGIC C.D. NENITESCU, BAIA MARE","MUNICIPIUL BAIA MARE",1,106318,1,1,1433,607,523,84,599,8,1600,993,413,186,
26,"MARAMURES",243,106318,,25,0,"STR. V. ALECSANDRI NR. 56, LICEUL EMIL RACOVITA, BAIA MARE","MUNICIPIUL BAIA MARE",1,106318,1,1,1434,688,655,33,674,14,1600,912,523,151,
26,"MARAMURES",243,106318,,26,0,"STR. V. ALECSANDRI NR. 56, LICEUL EMIL RACOVITA, BAIA MARE","MUNICIPIUL BAIA MARE",1,106318,1,1,1218,488,453,35,480,8,1300,812,292,188,
26,"MARAMURES",243,106318,,27,0,"STR. MARASESTI NR. 28, GRADINITA NR.  17, BAIA MARE","MUNICIPIUL BAIA MARE",1,106318,1,1,1558,585,540,45,581,4,1700,1115,341,240,
26,"MARAMURES",243,106318,,28,0,"STR. M. EMINESCU NR. 80A (STR. MARASEST, SCOALA NR. 10, BAIA MARE","MUNICIPIUL BAIA MARE",1,106318,1,1,1559,586,547,39,582,4,1700,1114,362,220,
26,"MARAMURES",243,106318,,29,0,"STR. PALTINISULUI NR. 65B, GRADINITA NR. 4, BAIA MARE","MUNICIPIUL BAIA MARE",1,106318,1,1,2433,986,918,68,976,10,2699,1713,507,469,
26,"MARAMURES",243,106318,,30,0,"STR. PASUNII NR. 2A, SCOALA NR. 5, BAIA MARE","MUNICIPIUL BAIA MARE",1,106318,1,1,2418,962,901,61,955,7,2700,1738,530,425,
26,"MARAMURES",243,106318,,31,0,"STR. V. ALECSANDRI NR. 58, GRADINITA NR. 27, BAIA MARE","MUNICIPIUL BAIA MARE",1,106318,1,1,1799,636,598,38,621,15,2000,1364,362,259,
26,"MARAMURES",243,106318,,32,0,"STR. V. ALECSANDRI NR. 68, GRADINITA NR. 37, BAIA MARE","MUNICIPIUL BAIA MARE",1,106318,1,1,1426,517,477,40,513,4,1600,1083,272,241,
26,"MARAMURES",243,106318,,33,0,"STR. V. ALECSANDRI NR. 99, DRUMURI SI PODURI S.A. - S.U.T., BAIA MARE","MUNICIPIUL BAIA MARE",1,106318,1,1,2009,743,691,52,726,17,2200,1457,400,326,
26,"MARAMURES",243,106318,,34,0,"STR. PASUNII NR. 2A, SCOALA NR. 5, BAIA MARE","MUNICIPIUL BAIA MARE",1,106318,1,1,2544,1013,929,84,997,16,2800,1787,512,485,
26,"MARAMURES",243,106318,,35,0,"B-DUL. UNIRII NR. 19, S.C. MOBAM S.A. - MAGAZIN, BAIA MARE","MUNICIPIUL BAIA MARE",1,106318,1,1,1547,746,704,42,744,2,1700,954,488,256,
26,"MARAMURES",243,106318,,36,0,"STR. PROGRESULUI NR. 45, GRUP SC. ECONOMIC  ADM. SI DE SERVICII, BAIA MARE","MUNICIPIUL BAIA MARE",1,106318,1,1,2389,1042,971,71,1030,12,2600,1558,717,313,
26,"MARAMURES",243,106318,,37,0,"STR. HORTENSIEI NR. 1A, S.C. AGECOM S.A., BAIA MARE","MUNICIPIUL BAIA MARE",1,106318,1,1,1798,797,760,37,786,11,2000,1203,589,197,
26,"MARAMURES",243,106318,,38,0,"B-DUL. UNIRII NR. 14B, BAZINUL OLIMPIC, BAIA MARE","MUNICIPIUL BAIA MARE",1,106318,1,1,2196,929,889,40,917,12,2400,1471,578,339,
26,"MARAMURES",243,106318,,39,0,"B-DUL. UNIRII NR. 14D, ADMINISTRATIA BAZELOR SPORTIVE, BAIA MARE","MUNICIPIUL BAIA MARE",1,106318,1,1,2559,1110,1059,51,1093,17,2800,1690,799,294,
26,"MARAMURES",243,106318,,40,0,"B-DUL. BUCURESTI NR. 17B, PLANNING FAMILIAL, BAIA MARE","MUNICIPIUL BAIA MARE",1,106318,1,1,2160,1104,1026,78,1089,15,2400,1296,807,282,
26,"MARAMURES",243,106318,,41,0,"B-DUL. BUCURESTI NR. 23, S.C. INFOMARA, BAIA MARE","MUNICIPIUL BAIA MARE",1,106318,1,1,2123,1033,924,109,1020,13,2300,1267,754,266,
26,"MARAMURES",243,106318,,42,0,"B-DUL. BUCURESTI NR. 20, GRADINITA NR. 20, BAIA MARE","MUNICIPIUL BAIA MARE",1,106318,1,1,1554,700,645,55,692,8,1700,1000,536,156,
26,"MARAMURES",243,106318,,43,0,"STR. GH. BILASCU NR. 19A, SCOALA GEORGE COSBUC, BAIA MARE","MUNICIPIUL BAIA MARE",1,106318,1,1,1425,712,670,42,706,6,1600,888,563,143,
26,"MARAMURES",243,106318,,44,0,"STR. G. COSBUC NR. 16, PLANETARIU, BAIA MARE","MUNICIPIUL BAIA MARE",1,106318,1,1,1477,736,688,48,731,5,1600,864,575,156,
26,"MARAMURES",243,106318,,45,0,"STR. GH. BILASCU NR. 1, SCOALA NICOLAE  IORGA, BAIA MARE","MUNICIPIUL BAIA MARE",1,106318,1,1,1312,657,629,28,641,16,1400,743,513,128,
26,"MARAMURES",243,106318,,46,0,"STR. N. IORGA NR. 3A, GRADINITA NR. 9, BAIA MARE","MUNICIPIUL BAIA MARE",1,106318,1,1,1400,731,698,33,720,11,1500,769,542,178,
26,"MARAMURES",243,106318,,47,0,"B-DUL. REPUBLICII NR. 8, GRUPUL SCOLAR DE INDUSTRIE USOARA, BAIA MARE","MUNICIPIUL BAIA MARE",1,106318,1,1,1669,744,683,61,736,8,1800,1056,528,208,
26,"MARAMURES",243,106318,,48,0,"STR. CUZA VODA NR. 7, SCOALA NR. 17, BAIA MARE","MUNICIPIUL BAIA MARE",1,106318,1,1,1439,712,615,97,707,5,1600,888,488,219,
26,"MARAMURES",243,106318,,49,0,"STR. CUZA VODA NR. 8B, GRADINITA NR. 29, BAIA MARE","MUNICIPIUL BAIA MARE",1,106318,1,1,2975,1300,1234,66,1279,21,3300,2000,863,416,
26,"MARAMURES",243,106318,,50,0,"STR. ALEEA FILATURII NR. 2, SCOALA NR. 18, BAIA MARE","MUNICIPIUL BAIA MARE",1,106318,1,1,3070,1349,1287,62,1337,12,3400,2051,830,507,
26,"MARAMURES",243,106318,,51,0,"STR. ALEEA FILATURII NR. 4, GRADINITA NR. 28, BAIA MARE","MUNICIPIUL BAIA MARE",1,106318,1,1,3002,1299,1203,96,1289,10,3299,2000,813,476,
26,"MARAMURES",243,106318,,52,0,"B-DUL. REPUBLICII NR. 33-35, LICEUL CU PROFIL SPORTIV-CLUBUL SPORTIV SCOLAR, BAIA MARE","MUNICIPIUL BAIA MARE",1,106318,1,1,2743,1188,1077,111,1177,11,3000,1812,715,462,
26,"MARAMURES",243,106318,,53,0,"STR. BUCOVINEI NR. 9, SCOALA NR. 21, BAIA MARE","MUNICIPIUL BAIA MARE",1,106318,1,1,2783,1193,1118,75,1179,14,3100,1907,684,495,
26,"MARAMURES",243,106318,,54,0,"STR. BUCOVINEI NR. 7, GRADINITA NR. 36, BAIA MARE","MUNICIPIUL BAIA MARE",1,106318,1,1,2601,1127,1075,52,1120,7,2900,1773,682,438,
26,"MARAMURES",243,106318,,55,0,"STR. ALEEA AMURGULUI NR. 2, GRADINITA NR. 34, BAIA MARE","MUNICIPIUL BAIA MARE",1,106318,1,1,2153,960,916,44,953,7,2400,1440,589,364,
26,"MARAMURES",243,106318,,56,0,"STR, ALEEA JUPITER NR. 4 ,  GRADINITA NR. 25, BAIA MARE","MUNICIPIUL BAIA MARE",1,106318,1,1,1673,790,734,56,781,9,1800,1010,510,271,
26,"MARAMURES",243,106318,,57,0,"STR. ALEEA NEPTUN NR. 5, SCOALA NR. 15, BAIA MARE","MUNICIPIUL BAIA MARE",1,106318,1,1,2205,1001,878,123,989,12,2400,1399,668,321,
26,"MARAMURES",243,106318,,58,0,"STR. BOGDAN VODA NR. 6, SCOALA NR. 3, BAIA MARE","MUNICIPIUL BAIA MARE",1,106318,1,1,2788,1247,1211,36,1238,9,3084,1837,760,478,
26,"MARAMURES",243,106318,,59,0,"STR. GARII NR. 4, GARA C.F.R., BAIA MARE","MUNICIPIUL BAIA MARE",1,106318,1,1,2846,1450,1058,392,1423,27,3100,1650,837,586,
26,"MARAMURES",243,106318,,60,0,"B-DUL. BUCURESTI NR. 44, S.C. MARATEX S.A. - SEDIU, BAIA MARE","MUNICIPIUL BAIA MARE",1,106318,1,1,1881,638,573,65,632,6,2100,1462,356,276,
26,"MARAMURES",243,106318,,61,1,"STR. G. GOSBUC NR. 31, SPITALUL JUDETEAN, BAIA MARE","MUNICIPIUL BAIA MARE",1,106318,1,1,0,541,0,541,534,7,1000,459,348,186,
26,"MARAMURES",243,106318,,62,1,"STR. DR. V. BABES NR. 34, SPITALUL DE BOLI PULMONARE, BAIA MARE","MUNICIPIUL BAIA MARE",1,106318,1,1,0,94,0,94,94,0,200,106,47,47,
26,"MARAMURES",243,106318,,63,1,"STR.V. LUCACIU NR. 72, SPITALUL DE BOLI INFECTIOASE, BAIA MARE","MUNICIPIUL BAIA MARE",1,106318,1,1,0,117,0,117,116,1,200,83,78,38,
26,"MARAMURES",243,106318,,64,1,"STR. PROGRESULUI NR. 17, POLICLINICA NR. 2, BAIA MARE","MUNICIPIUL BAIA MARE",1,106318,1,1,0,75,0,75,73,2,200,125,45,28,
26,"MARAMURES",243,106318,,65,1,"STR. HORTENSIEI NR. 1, CENTRUL MILITAR, BAIA MARE","MUNICIPIUL BAIA MARE",1,106318,1,1,0,324,0,324,313,11,800,476,171,142,
26,"MARAMURES",243,106559,,66,0,"SCOALA GEN. NR. 8,, IAPA","MUNICIPIUL SIGHETU MARMATIEI",2,106559,1,1,1253,659,605,54,647,12,1400,741,342,305,
26,"MARAMURES",243,106559,,67,0,"SCOALA GEN. NR. 1 CIARDA,, SIGHETU MARMATIEI","MUNICIPIUL SIGHETU MARMATIEI",2,106559,1,1,1279,608,569,39,601,7,1400,792,250,351,
26,"MARAMURES",243,106559,,68,0,"SCOALA GEN. NR. 11,, SIGHETU MARMATIEI","MUNICIPIUL SIGHETU MARMATIEI",2,106559,1,1,957,441,423,18,437,4,999,558,240,197,
26,"MARAMURES",243,106559,,69,0,"STR. INDEPENDENTEI NR. 10, GRADINITA NR. 12, SIGHETU MARMATIEI","MUNICIPIUL SIGHETU MARMATIEI",2,106559,1,1,1636,760,718,42,744,12,1800,1040,497,247,
26,"MARAMURES",243,106559,,70,0,"STR. AVRAM IANCU NR. 22, I. PARPLAST, SIGHETU MARMATIEI","MUNICIPIUL SIGHETU MARMATIEI",2,106559,1,1,1948,926,836,90,906,20,2101,1175,574,332,
26,"MARAMURES",243,106559,,71,0,"STR. 22 DECEMBRIE NR. 5, LICEUL PEDAGOGIC, SIGHETU MARMATIEI","MUNICIPIUL SIGHETU MARMATIEI",2,106559,1,1,1987,855,801,54,846,9,2200,1345,562,284,
26,"MARAMURES",243,106559,,72,0,"STR. IULIU MANIU NR. 31, CASA DE CULTURA, SIGHETU MARMATIEI","MUNICIPIUL SIGHETU MARMATIEI",2,106559,1,1,1644,759,725,34,746,13,1800,1041,470,276,
26,"MARAMURES",243,106559,,73,0,"STR.  MIHAI VITEAZU NR. 13, LICEUL DRAGOS VODA, SIGHETU MARMATIEI","MUNICIPIUL SIGHETU MARMATIEI",2,106559,1,1,1346,650,574,76,640,10,1500,850,462,178,
26,"MARAMURES",243,106559,,74,0,"P-TA. LIBERATII NR. 22, LICEUL UCRAINEAN, SIGHETU MARMATIEI","MUNICIPIUL SIGHETU MARMATIEI",2,106559,1,1,723,723,650,73,715,8,1500,777,530,185,
26,"MARAMURES",243,106559,,75,0,"CLUBUL ACATERM,, SIGHETU MARMATIEI","MUNICIPIUL SIGHETU MARMATIEI",2,106559,1,1,1528,756,701,55,743,13,1700,944,512,231,
26,"MARAMURES",243,106559,,76,0,"STR. GHEORGHE SINCAI NR. 1, SCOALA GEN. NR. 2, SIGHETU MARMATIEI","MUNICIPIUL SIGHETU MARMATIEI",2,106559,1,1,1406,704,658,46,690,14,1500,796,513,177,
26,"MARAMURES",243,106559,,77,0,"STR. GH. SINCAI NR. 2, GRADINITA NR. 9, SIGHETU MARMATIEI","MUNICIPIUL SIGHETU MARMATIEI",2,106559,1,1,1582,782,729,53,772,9,1698,917,538,234,
26,"MARAMURES",243,106559,,78,0,"STR. T. VLADIMIRESCU 6-8, SCOALA GEN. NR. 9, SIGHETU MARMATIEI","MUNICIPIUL SIGHETU MARMATIEI",2,106559,1,1,2448,1087,1033,54,1062,25,2700,1613,712,350,
26,"MARAMURES",243,106559,,79,0,"STR. DRAGOS VODA NR. 43, LICEUL IND. NR. 1, SIGHETU MARMATIEI","MUNICIPIUL SIGHETU MARMATIEI",2,106559,1,1,1641,896,734,162,881,15,1800,904,608,273,
26,"MARAMURES",243,106559,,80,0,"STR. DRAGOS VODA NR. 244, SCOALA GENERALA NR. 6, SIGHETU MARMATIEI","MUNICIPIUL SIGHETU MARMATIEI",2,106559,1,1,1426,688,653,35,674,14,1600,912,290,384,
26,"MARAMURES",243,106559,,81,0,"SCOALA GEN.NR. 10,, SIGHETU MARMATIEI","MUNICIPIUL SIGHETU MARMATIEI",2,106559,1,1,1447,683,629,54,670,13,1600,917,455,215,
26,"MARAMURES",243,106559,,82,0,"STR. UNIRII, CANTINA CPL, SIGHETU MARMATIEI","MUNICIPIUL SIGHETU MARMATIEI",2,106559,1,1,1862,865,806,59,850,15,2000,1135,571,279,
26,"MARAMURES",243,106559,,83,0,"UNIVERSITATEA PRO HUMANITAS,, SIGHETU MARMATIEI","MUNICIPIUL SIGHETU MARMATIEI",2,106559,1,1,1689,812,751,61,789,23,1899,1087,493,296,
26,"MARAMURES",243,106559,,84,0,"STR. BOGDAN VODA NR. 118, SCOALA GEN. NR. 4, SIGHETU MARMATIEI","MUNICIPIUL SIGHETU MARMATIEI",2,106559,1,1,2128,1058,982,76,1047,11,2300,1242,680,367,
26,"MARAMURES",243,106559,,85,0,"STR. BOGDAN VODA, SEDIUL SCPCB (SEDIUL VECHI), SIGHETU MARMATIEI","MUNICIPIUL SIGHETU MARMATIEI",2,106559,1,1,1898,904,873,31,884,20,2100,1196,561,323,
26,"MARAMURES",243,106559,,86,0,"STR. BOGDAN VODA NR. 246, SCOALA GEN. NR. 5, SIGHETU MARMATIEI","MUNICIPIUL SIGHETU MARMATIEI",2,106559,1,1,2294,1153,1101,52,1146,7,2500,1347,605,541,
26,"MARAMURES",243,106559,,87,0,"SCOALA GEN. NR. 7,, SUGAU","MUNICIPIUL SIGHETU MARMATIEI",2,106559,1,1,848,347,329,18,340,7,900,553,154,186,
26,"MARAMURES",243,106559,,88,1,"STR. DRAGOS VODA, U.M. GRANICERI, SIGHETU MARMATIEI","MUNICIPIUL SIGHETU MARMATIEI",2,106559,1,1,583,523,517,6,517,6,600,77,347,170,
26,"MARAMURES",243,106684,,89,0,"P-TA. LIBETATII NR. 2,, BAIA SPRIE","ORAS BAIA SPRIE",3,106684,2,1,2830,1329,1199,130,1299,30,3100,1771,972,327,
26,"MARAMURES",243,106684,,90,0,"ALEEA MINERILOR NR. 1,, BAIA SPRIE","ORAS BAIA SPRIE",3,106684,2,1,3275,1343,1206,137,1328,15,3600,2257,907,421,
26,"MARAMURES",243,106684,,91,0,"MICRORAION VEST, CAMIN NEFAMILISTI  - 8, BAIA SPRIE","ORAS BAIA SPRIE",3,106684,2,1,3299,1517,1351,166,1503,14,3600,2083,930,573,
26,"MARAMURES",243,106684,,92,0,"SCOALA GEN CU CLS. I -VIII,, CHIUZBAIA","ORAS BAIA SPRIE",3,106684,2,1,563,490,449,41,488,2,600,110,253,235,
26,"MARAMURES",243,106684,,93,0,"SCOALA GEN., STR. FORESTIER NR. 1, TAUTII DE SUS","ORAS BAIA SPRIE",3,106684,2,1,1926,967,885,82,959,8,2100,1133,604,355,
26,"MARAMURES",243,106684,,94,0,"SCOALA GEN. CU CLS. I-VIII,, SATU NOU DE SUS","ORAS BAIA SPRIE",3,106684,2,1,748,582,359,223,570,12,1000,418,290,280,
26,"MARAMURES",243,106746,,95,0,"STR. DRAGOS VODA NR. 68, CANTINA GARA, BORSA","ORAS BORSA",4,106746,2,1,1171,551,517,34,543,8,1300,749,224,319,
26,"MARAMURES",243,106746,,96,0,"STR. DRAGOS VODA NR. 128, SCOALA NR. 1, BORSA","ORAS BORSA",4,106746,2,1,1049,486,470,16,481,5,1200,714,215,266,
26,"MARAMURES",243,106746,,97,0,"STR. LIBERTATII NR. 154, U.M., BORSA","ORAS BORSA",4,106746,2,1,881,481,383,98,476,5,1000,519,195,281,
26,"MARAMURES",243,106746,,98,0,"STR. LIBERTATII NR. 76, SCOALA NR. 8, BORSA","ORAS BORSA",4,106746,2,1,1767,804,776,28,796,8,1900,1096,372,424,
26,"MARAMURES",243,106746,,99,0,"STR. DECEBAL NR. 8, SCOALA NR. 9, BORSA","ORAS BORSA",4,106746,2,1,1714,669,635,34,667,2,1900,1231,362,305,
26,"MARAMURES",243,106746,,100,0,"STR. VICTORIEI NR. 8, CASA DE CULTURA, BORSA","ORAS BORSA",4,106746,2,1,2225,1202,903,299,1181,21,2400,1198,554,627,
26,"MARAMURES",243,106746,,101,0,"STR. GARLEA NR. 4/A, SCOALA NR. 2GARLEA, BORSA","ORAS BORSA",4,106746,2,1,888,418,403,15,413,5,1000,582,191,222,
26,"MARAMURES",243,106746,,102,0,"STR. VICTORIEI NR. 72, SCOALA STIUBEIE, BORSA","ORAS BORSA",4,106746,2,1,1080,397,367,30,392,5,1200,803,191,201,
26,"MARAMURES",243,106746,,103,0,"STR. REPEZII NR. 98, SCOALA REPEDEA, BORSA","ORAS BORSA",4,106746,2,1,1531,758,733,25,751,7,1700,942,279,472,
26,"MARAMURES",243,106746,,104,0,"STR. AL.I. CUZA NR. 73, SCOALA POIANA, BORSA","ORAS BORSA",4,106746,2,1,1555,751,708,43,741,10,1700,949,375,366,
26,"MARAMURES",243,106746,,105,0,"STR. AL.I. CUZA NR. 249, SCOALA BIRT, BORSA","ORAS BORSA",4,106746,2,1,1084,553,506,47,548,5,1100,547,285,263,
26,"MARAMURES",243,106746,,106,0,"STR. PR. TATARILOR NR. 1, SCOALA FANTANA, BORSA","ORAS BORSA",4,106746,2,1,949,469,442,27,459,10,1000,531,188,271,
26,"MARAMURES",243,106746,,107,0,"STR. UNIRII NR. 11, SCOALA ROTUNDU, BORSA","ORAS BORSA",4,106746,2,1,1691,741,697,44,736,5,1900,1159,341,395,
26,"MARAMURES",243,106746,,108,0,"STR. MINERILOR NR. 77, SCOALA NR. 7, BORSA","ORAS BORSA",4,106746,2,1,1551,680,654,26,677,3,1700,1020,415,262,
26,"MARAMURES",243,106746,,109,0,"STR. INDEPENDENTEI NR. 20, SCOALA NR. 7, BAIA BORSA","ORAS BORSA",4,106746,2,1,1561,685,605,80,675,10,1700,1015,370,305,
26,"MARAMURES",243,106782,,110,0,"GRUPUL SCOLAR, STR. 1 MAI NR. 15, CAVNIC","ORAS CAVNIC",5,106782,2,1,1757,846,801,45,840,6,1900,1054,535,305,
26,"MARAMURES",243,106782,,111,0,"SCOALA GENERALA NR. 2, STR. INDEPENDENTEI NR. 3, CAVNIC","ORAS CAVNIC",5,106782,2,1,1747,996,915,81,985,11,1900,904,645,340,
26,"MARAMURES",243,106782,,112,0,"SCOALA GENERALA NR. 1, STR. ELIBERARII NR. 55, CAVNIC","ORAS CAVNIC",5,106782,2,1,795,380,336,44,360,20,900,520,261,99,
26,"MARAMURES",243,108963,,113,0,"STR. M. EMINESCU NR. 4, CASA DE CULTURA, SEINI","ORAS SEINI",6,108963,2,1,2039,828,776,52,824,4,2200,1372,451,373,
26,"MARAMURES",243,108963,,114,0,"STR. M. EMINESCU NR. 35, GRADINITA DE COPII, SEINI","ORAS SEINI",6,108963,2,1,1953,805,768,37,795,10,2100,1295,536,259,
26,"MARAMURES",243,108963,,115,0,"STR. M. BALCESCU NR. 2, SCOALA GEN. NR.1, SEINI","ORAS SEINI",6,108963,2,1,2031,1028,951,77,1016,12,2200,1172,508,508,
26,"MARAMURES",243,108963,,116,0,"NR. 50, GRADINITA DE COPII,, SABISA","ORAS SEINI",6,108963,2,1,594,350,315,35,345,5,700,350,162,183,
26,"MARAMURES",243,108963,,117,0,"NR. 73, SCOALA GEN.,, VIILE APEI","ORAS SEINI",6,108963,2,1,469,292,233,59,291,1,500,208,152,139,
26,"MARAMURES",243,106817,,118,0,"STR. P-TA. EROILOR NR. 10, CASA ORASENEASCA DE CULTURA, TARGU LAPUS","ORAS TARGU LAPUS",7,106817,2,1,1654,786,727,59,771,15,1800,1014,473,298,
26,"MARAMURES",243,106817,,119,0,"STR. P-TA. EROILOR NR. 31, SCOALA GEN. PT. COPII CU DEFICIENTE., TARGU LAPUS","ORAS TARGU LAPUS",7,106817,2,1,1930,904,823,81,894,10,2100,1196,568,326,
26,"MARAMURES",243,106817,,120,0,"STR. TIBLESULUI NR. 2, HOLUL MARE AL PRIMARIEI ORASULUI, TARGU LAPUS","ORAS TARGU LAPUS",7,106817,2,1,1323,713,652,61,707,6,1500,787,415,292,
26,"MARAMURES",243,106817,,121,0,"SCOALA GEN., NR. 159, BOIERENI","ORAS TARGU LAPUS",7,106817,2,1,403,215,189,26,213,2,500,285,95,118,
26,"MARAMURES",243,106817,,122,0,"SCOALA GEN., NR. 117, BORCUT","ORAS TARGU LAPUS",7,106817,2,1,407,229,200,29,228,1,500,271,123,105,
26,"MARAMURES",243,106817,,123,0,"SCOALA GEN. NR. 15,, CUFOAIA","ORAS TARGU LAPUS",7,106817,2,1,183,138,122,16,135,3,200,62,56,79,
26,"MARAMURES",243,106817,,124,0,"SCOALA GEN., NR. 302, DAMACUSENI","ORAS TARGU LAPUS",7,106817,2,1,784,269,250,19,260,9,900,631,229,31,
26,"MARAMURES",243,106817,,125,0,"SCOALA GEN., NR. 56, DUMBRAVA","ORAS TARGU LAPUS",7,106817,2,1,200,150,135,15,150,0,300,150,49,101,
26,"MARAMURES",243,106817,,126,0,"SCOALA GEN., NR. 53, DOBRICUL","ORAS TARGU LAPUS",7,106817,2,1,361,157,135,22,154,3,400,243,77,77,
26,"MARAMURES",243,106817,,127,0,"SCOALA GEN., NR. 132, FANTANELE","ORAS TARGU LAPUS",7,106817,2,1,272,192,166,26,191,1,300,108,81,110,
26,"MARAMURES",243,106817,,128,0,"SCOALA GEN., NR. 106, INAU","ORAS TARGU LAPUS",7,106817,2,1,242,143,116,27,141,2,300,157,54,87,
26,"MARAMURES",243,106817,,129,0,"SCOALA GEN., NR. 198, RAZOARE","ORAS TARGU LAPUS",7,106817,2,1,1081,541,498,43,529,12,1200,659,326,203,
26,"MARAMURES",243,106817,,130,0,"SCOALA GEN., NR. 411, ROGOZ","ORAS TARGU LAPUS",7,106817,2,1,1263,768,741,27,765,3,1400,632,335,430,
26,"MARAMURES",243,106817,,131,0,"SCOALA GEN., NR. 254, ROHIA","ORAS TARGU LAPUS",7,106817,2,1,656,454,397,57,446,8,700,246,191,255,
26,"MARAMURES",243,106817,,132,0,"SCOALA GEN., NR. 92, STOICENI","ORAS TARGU LAPUS",7,106817,2,1,238,144,130,14,144,0,300,156,42,102,
26,"MARAMURES",243,106979,,133,0,"STR. MALINULUI NR. 4, GRADINITA DE COPII, VISEU DE MIJLOC","ORAS VISEU DE SUS",8,106979,2,1,2346,922,893,29,916,6,2600,1678,434,482,
26,"MARAMURES",243,106979,,134,0,"STR. M. EMINESCU NR. 1, LICEUL BOGDAN VODA, VISEU DE SUS","ORAS VISEU DE SUS",8,106979,2,1,1847,946,722,224,935,11,2000,1054,644,291,
26,"MARAMURES",243,106979,,135,0,"STR. ALEEA EROILOR NR. 8. SCOALA GENERA,, VISEU DE SUS","ORAS VISEU DE SUS",8,106979,2,1,3208,1387,1319,68,1378,9,3500,2113,718,660,
26,"MARAMURES",243,106979,,136,0,"STR. RANDUNELELOR NR. 80, SCOALA GEN. NR. 3, VISEU DE SUS","ORAS VISEU DE SUS",8,106979,2,1,826,411,380,31,399,12,900,489,183,216,
26,"MARAMURES",243,106979,,137,0,"STR. CARPATI NR. 38, CANTINA DE AJUTOR SOCIAL, VISEU DE SUS","ORAS VISEU DE SUS",8,106979,2,1,2007,1162,1117,45,1159,3,2200,1038,728,431,
26,"MARAMURES",243,106979,,138,0,"STR. TUDOR VLADIMIRESCU NR. 1, SCOALA GEN. NR. 1, VISEU DE SUS","ORAS VISEU DE SUS",8,106979,2,1,2579,1062,1006,56,1047,15,2800,1738,676,371,
26,"MARAMURES",243,106979,,139,0,"STR. L MAI NR. 110, SCOALA GEN. NR. 4, VISEU DE SUS","ORAS VISEU DE SUS",8,106979,2,1,2174,951,927,24,922,29,2400,1449,593,329,
26,"MARAMURES",243,107001,,140,0,"NR. 430 - PRIMARIE,, ARDUSAT","ARDUSAT",9,107001,0,3,1449,655,563,92,646,9,1600,945,447,199,
26,"MARAMURES",243,107001,,141,0,"NR. 39, SCOALA, COLTIREA","ARDUSAT",9,107001,0,3,303,232,178,54,229,3,400,168,143,86,
26,"MARAMURES",243,107047,,142,0,"NR. 234, CAMINUL CULTURAL, ARINIS","ARINIS",10,107047,0,3,646,425,378,47,417,8,700,275,239,178,
26,"MARAMURES",243,107047,,143,0,"NR. 168, CAMINUL CULTURAL, TAMASESTI","ARINIS",10,107047,0,3,265,235,176,59,235,0,300,65,129,106,
26,"MARAMURES",243,107083,,144,0,"NR. 160, PRIMARIE, ASUAJU DE SUS","ASUAJU DE SUS",11,107083,0,3,964,587,524,63,573,14,1100,513,394,179,
26,"MARAMURES",243,107083,,145,0,"NR. 54, CAMINUL CULTURAL, ASUAJU DE JOS","ASUAJU DE SUS",11,107083,0,3,306,226,153,73,224,2,400,174,112,112,
26,"MARAMURES",243,107118,,146,0,"NR. 18, SCOALA GEN., BAITA DE SUB CODRU","BAITA DE SUB CODRU",12,107118,0,3,1123,582,524,58,576,6,1300,718,361,215,
26,"MARAMURES",243,107118,,147,0,"NR. 64, SCOALA GEN., URMENIS","BAITA DE SUB CODRU",12,107118,0,3,262,183,149,34,176,7,300,117,108,68,
26,"MARAMURES",243,107154,,148,0,"NR. 434, SCOALA GEN., BAIUT","BAIUT",13,107154,0,3,1681,686,609,77,671,15,1800,1114,514,157,
26,"MARAMURES",243,107154,,149,0,"NR. 212, SCOALA GEN., STRAMBU-BAIUT","BAIUT",13,107154,0,3,478,349,214,135,347,2,500,151,208,139,
26,"MARAMURES",243,107154,,150,0,"NR. 79, SCOALA GEN., POIANA BOTIZII","BAIUT",13,107154,0,3,288,204,187,17,203,1,300,96,90,113,
26,"MARAMURES",243,107190,,151,0,"NR. 133, PRIMARIE, BASESTI","BASESTI",15,107190,0,3,643,333,285,48,330,3,700,367,184,146,
26,"MARAMURES",243,107190,,152,0,"NR. 15, SCOALA GEN., ODESTI","BASESTI",15,107190,0,3,398,259,201,58,257,2,400,141,166,91,
26,"MARAMURES",243,107190,,153,0,"NR. 99, SCOALA, STREMT","BASESTI",15,107190,0,3,281,135,100,35,134,1,300,165,64,70,
26,"MARAMURES",243,107234,,154,0,"NR. 85, PRIMARIE,, BICAZ","BICAZ",16,107234,0,3,536,393,351,42,392,1,600,207,203,189,
26,"MARAMURES",243,107234,,155,0,"NR. 78, SCOALA, CIUTA","BICAZ",16,107234,0,3,215,172,144,28,171,1,300,128,112,59,
26,"MARAMURES",243,107234,,156,0,"NR. 188, SCOALA, CORNI","BICAZ",16,107234,0,3,357,268,244,24,265,3,400,132,170,95,
26,"MARAMURES",243,107270,,157,0,"NR. 315, PRIMARIE, BISTRA","BISTRA",17,107270,0,3,900,418,377,41,411,7,1000,582,187,224,
26,"MARAMURES",243,107270,,158,0,"NR. 480 - CAMINUL CULTURAL,, CRASNA VISEULUI","BISTRA",17,107270,0,3,1440,1019,955,64,993,26,1600,581,596,397,
26,"MARAMURES",243,107270,,159,0,"NR. 105 - CAMINUL CULTURAL,, VALEA VISEULUI","BISTRA",17,107270,0,3,1300,719,645,74,700,19,1300,581,215,485,
26,"MARAMURES",243,107314,,160,0,"NR. 62, CAMINUL CULTURAL, BARSANA","BARSANA",14,107314,0,3,2792,1368,1232,136,1343,22,3000,1632,694,649,
26,"MARAMURES",243,107314,,161,0,"NR. 876, SCOALA VALEA MUNTELUI, BARSANA","BARSANA",14,107314,0,3,584,320,264,56,317,3,600,280,157,160,
26,"MARAMURES",243,107314,,162,0,"NR. 346, SCOALA, ONCESTI","BARSANA",14,107314,0,3,1275,721,676,45,704,17,1400,679,252,452,
26,"MARAMURES",243,107314,,163,0,"NR. 78, SCOALA, NANESTI","BARSANA",14,107314,0,3,582,405,356,49,396,9,600,195,218,178,
26,"MARAMURES",243,107350,,164,0,"NR. 136, PRIMARIE, BOCICOIU MARE","BOCICOIU MARE",18,107350,0,3,461,302,245,57,297,5,500,198,127,170,
26,"MARAMURES",243,107350,,165,0,"NR. 247, SCOALA, CRACIUNESTI","BOCICOIU MARE",18,107350,0,3,1189,628,572,56,618,10,1300,672,219,399,
26,"MARAMURES",243,107350,,166,0,"NR. 350, SCOALA, TISA","BOCICOIU MARE",18,107350,0,3,1042,512,461,51,503,9,1100,588,252,251,
26,"MARAMURES",243,107350,,167,0,"NR. 106, SCOALA, LUNCA LA TISA","BOCICOIU MARE",18,107350,0,3,763,367,303,64,359,8,800,433,179,180,
26,"MARAMURES",243,107403,,168,0,"NR. 232, CLUBUL TINERETULUI, BOGDAN VODA","BOGDAN VODA",19,107403,0,3,2112,999,931,68,984,15,2300,1301,466,518,
26,"MARAMURES",243,107403,,169,0,"NR. 389, SCOALA, BOCICOEL","BOGDAN VODA",19,107403,0,3,772,463,390,73,447,16,900,437,321,126,
26,"MARAMURES",243,107430,,170,0,"NR. 100, PRIMARIE, BOIU MARE","BOIU MARE",20,107430,0,3,657,350,314,36,349,1,700,350,176,173,
26,"MARAMURES",243,107430,,171,0,"SCOALA,, PRISLOP","BOIU MARE",20,107430,0,3,380,222,194,28,220,2,400,178,116,104,
26,"MARAMURES",243,107485,,172,0,"NR. 416, PRIMARIE, BOTIZA","BOTIZA",21,107485,0,3,2367,1687,1639,48,1684,3,2600,913,1245,439,
26,"MARAMURES",243,107519,,173,0,"NR. 781, PRIMARIE, BUDESTI","BUDESTI",22,107519,0,3,1339,859,807,52,854,5,1500,641,351,503,
26,"MARAMURES",243,107519,,174,0,"NR. 492, SCOALA SUSANI, BUDESTI","BUDESTI",22,107519,0,3,821,511,470,41,506,5,900,389,237,269,
26,"MARAMURES",243,107519,,175,0,"NR. 24, SCOALA, SARBI","BUDESTI",22,107519,0,3,726,391,346,45,388,3,800,409,194,194,
26,"MARAMURES",243,107546,,176,0,"NR. 177, CAMINUL CULTURAL, CALINESTI","CALINESTI",23,107546,0,3,1276,599,566,33,588,11,1400,801,233,355,
26,"MARAMURES",243,107546,,177,0,"NR. 22, SCOALA, CORNESTI","CALINESTI",23,107546,0,3,401,226,209,17,224,2,500,274,82,142,
26,"MARAMURES",243,107546,,178,0,"NR. 459, CAMINUL CULTURAL, VALENI","CALINESTI",23,107546,0,3,1110,745,678,67,743,2,1200,455,300,443,
26,"MARAMURES",243,107582,,179,0,"NR. 247, SCOALA, CERNESTI","CERNESTI",25,107582,0,3,998,612,539,73,606,6,1100,488,268,338,
26,"MARAMURES",243,107582,,180,0,"NR. 106, SCOALA, FANATE","CERNESTI",25,107582,0,3,521,433,394,39,432,1,600,167,187,245,
26,"MARAMURES",243,107582,,181,0,"NR. 283, GRADINITA, CIOCOTIS","CERNESTI",25,107582,0,3,934,676,605,71,673,3,1000,324,191,482,
26,"MARAMURES",243,107582,,182,0,"NR. 167, SCOALA, TRESTIA","CERNESTI",25,107582,0,3,537,400,365,35,397,3,600,200,177,220,
26,"MARAMURES",243,107662,,183,0,"NR. 742, DISPENSARUL UMAN, CICARLAU","CICARLAU",26,107662,0,3,1551,908,788,120,891,17,1700,792,377,514,
26,"MARAMURES",243,107662,,184,0,"NR 130, CAMINUL CULTURAL, ILBA","CICARLAU",26,107662,0,3,1425,726,646,80,724,2,1600,874,436,288,
26,"MARAMURES",243,107715,,185,0,"NR. 253, CAMINUL CULTURAL, CAMPULUNG LA TISA","CAMPULUNG LA TISA",24,107715,0,3,1970,738,658,80,728,10,2200,1462,643,85,
26,"MARAMURES",243,107733,,186,0,"NR. 225, CAMINUL CULTURAL,, COPALNIC MANASTUR","COPALNIC-MANASTUR",27,107733,0,3,1266,554,436,118,551,3,1400,846,287,264,
26,"MARAMURES",243,107733,,187,0,"NR. 35, SCOALA,, COPALNIC","COPALNIC-MANASTUR",27,107733,0,3,716,248,191,57,246,2,800,552,91,155,
26,"MARAMURES",243,107733,,188,0,"NR. 171, CAMINUL CULTURAL, BERINTA","COPALNIC-MANASTUR",27,107733,0,3,585,317,261,56,316,1,700,383,169,147,
26,"MARAMURES",243,107733,,189,0,"NR. 36, SCOALA, CARPINIS","COPALNIC-MANASTUR",27,107733,0,3,269,196,168,28,191,5,300,104,80,111,
26,"MARAMURES",243,107733,,190,0,"NR. 20, SCOALA, LASCHIA","COPALNIC-MANASTUR",27,107733,0,3,421,277,253,24,275,2,500,223,129,146,
26,"MARAMURES",243,107733,,191,0,"NR. 185, SCOALA, FAURESTI","COPALNIC-MANASTUR",27,107733,0,3,625,362,317,45,360,2,700,338,169,191,
26,"MARAMURES",243,107733,,192,0,"NR. 78, SCOALA, PRELUCA NOUA","COPALNIC-MANASTUR",27,107733,0,3,261,148,108,40,148,0,300,152,80,68,
26,"MARAMURES",243,107733,,193,0,"NR. 77, SCOALA, PRELUCA VECHE","COPALNIC-MANASTUR",27,107733,0,3,340,199,176,23,199,0,400,201,91,108,
26,"MARAMURES",243,107868,,194,0,"NR. 156, PRIMARIE, COROIENI","COROIENI",28,107868,0,3,548,300,265,35,297,3,600,300,118,179,
26,"MARAMURES",243,107868,,195,0,"NR. 120, SCOALA, BABA","COROIENI",28,107868,0,3,450,260,233,27,260,0,500,240,126,134,
26,"MARAMURES",243,107868,,196,0,"NR. 71, SCOALA, DEALU MARE","COROIENI",28,107868,0,3,307,152,128,24,152,0,400,248,80,72,
26,"MARAMURES",243,107868,,197,0,"NR. 52, SCOALA,, VALENII LAPUSULUI","COROIENI",28,107868,0,3,529,307,264,43,298,9,600,293,139,159,
26,"MARAMURES",243,107920,,198,0,"NR. 168, SCOALA, CUPSENI","CUPSENI",29,107920,0,3,761,509,455,54,502,7,800,291,140,362,
26,"MARAMURES",243,107920,,199,0,"NR. 30, SCOALA, COSTENI","CUPSENI",29,107920,0,3,399,300,270,30,295,5,500,200,131,164,
26,"MARAMURES",243,107920,,200,0,"NR. 269, SCOALA, LIBOTIN","CUPSENI",29,107920,0,3,951,741,715,26,738,3,1000,259,294,444,
26,"MARAMURES",243,107920,,201,0,"NR. 86, SCOALA, UNGURENI","CUPSENI",29,107920,0,3,1119,804,727,77,793,11,1200,396,401,392,
26,"MARAMURES",243,107975,,202,0,"NR. 328, CAMINUL CULTURAL, DESESTI","DESESTI",30,107975,0,3,827,459,433,26,458,1,900,441,169,289,
26,"MARAMURES",243,107975,,203,0,"NR. 306, SCOALA, MARA","DESESTI",30,107975,0,3,826,527,487,40,512,15,900,373,150,362,
26,"MARAMURES",243,107975,,204,0,"NR.72, CAMINUL CULTURAL, HARNICESTI","DESESTI",30,107975,0,3,526,310,276,34,307,3,600,290,83,224,
26,"MARAMURES",243,108017,,205,0,"NR. 934, SCOALA, DRAGOMIRESTI","DRAGOMIRESTI",31,108017,0,3,2578,1383,1317,66,1374,9,2800,1417,848,526,
26,"MARAMURES",243,108035,,206,0,"NR. 331, SCOALA VECHE, DUMBRAVITA","DUMBRAVITA",32,108035,0,3,973,441,398,43,437,4,1000,559,188,249,
26,"MARAMURES",243,108035,,207,0,"NR. 161, SCOALA, CHECHIS","DUMBRAVITA",32,108035,0,3,711,425,385,40,424,1,800,375,225,199,
26,"MARAMURES",243,108035,,208,0,"NR. 23 A, SCOALA, CARBUNARI","DUMBRAVITA",32,108035,0,3,458,285,255,30,284,1,500,215,155,129,
26,"MARAMURES",243,108035,,209,0,"NR. 155 A, SCOALA, RUS","DUMBRAVITA",32,108035,0,3,1355,880,808,72,867,9,1500,624,378,489,
26,"MARAMURES",243,108106,,210,0,"NR. 420, CAMIN CULTURAL - FARCASA,, FARCASA","FARCASA",33,108106,0,3,1598,796,715,81,790,6,1800,1004,509,281,
26,"MARAMURES",243,108106,,211,0,"NR. 29, SCOALA - TAMAIA, TAMAIA","FARCASA",33,108106,0,3,1133,743,655,88,734,9,1200,457,478,256,
26,"MARAMURES",243,108151,,212,0,"NR. 113, CAMINUL CULTURAL, GIULESTI","GIULESTI",34,108151,0,3,1503,783,718,65,777,6,1600,817,356,421,
26,"MARAMURES",243,108151,,213,0,"NR. 269, CAMINUL CULTURAL, BERBESTI","GIULESTI",34,108151,0,3,1263,671,649,22,660,5,1400,729,352,308,
26,"MARAMURES",243,106363,,214,0,"NR. 190, PRIMARIE, GROSI","GROSI",35,106363,0,3,953,454,416,38,450,4,1000,546,238,212,
26,"MARAMURES",243,106363,,215,0,"NR. 165, SCOALA, SATU NOU DE JOS","GROSI",35,106363,0,3,581,303,252,51,302,1,600,297,156,146,
26,"MARAMURES",243,106363,,216,0,"NR. 68 SCOALA,, OCOLIS","GROSI",35,106363,0,3,286,149,82,67,147,2,300,151,78,69,
26,"MARAMURES",243,108204,,217,0,"NR.168, CAMINUL CULTURAL, IEUD","IEUD",36,108204,0,3,3147,1433,1363,70,1415,16,3500,2067,758,657,
26,"MARAMURES",243,108222,,218,0,"NR. 1027, PRIMARIE, LAPUS","LAPUS",37,108222,0,3,1678,1064,1001,63,1060,4,1800,736,457,603,
26,"MARAMURES",243,108222,,219,0,"CAMINUL CULTURAL, LAPUS","LAPUS",37,108222,0,3,1318,787,745,42,782,5,1500,713,263,519,
26,"MARAMURES",243,108240,,220,0,"NR. 136, PRIMARIE, LEORDINA","LEORDINA",38,108240,0,3,2073,1090,1017,73,1066,24,2300,1210,673,393,
26,"MARAMURES",243,108268,,221,0,"NR. 473, PRIMARIE, MIRESU MARE","MIRESU MARE",39,108268,0,3,2075,1056,922,134,1046,10,2296,1240,478,568,
26,"MARAMURES",243,108268,,222,0,"NR. 43, SCOALA, IADARA","MIRESU MARE",39,108268,0,3,856,500,444,56,494,6,900,400,212,282,
26,"MARAMURES",243,108268,,223,0,"NR. 3, SCOALA, LUCACESTI","MIRESU MARE",39,108268,0,3,848,494,433,61,489,5,900,406,247,242,
26,"MARAMURES",243,108348,,224,0,"NR. 64, RASCRUCI, MOISEI","MOISEI",40,108348,0,3,2336,1237,1136,101,1234,3,2600,1363,542,692,
26,"MARAMURES",243,108348,,225,0,"NR. 1300, PRIMARIE, MOISEI","MOISEI",40,108348,0,3,2240,1277,1150,127,1265,10,2500,1223,463,802,
26,"MARAMURES",243,108348,,226,0,"NR. 918/A, SCOALA NR. 2, MOISEI","MOISEI",40,108348,0,3,2226,1150,1050,100,1143,7,2400,1242,496,647,
26,"MARAMURES",243,108366,,227,0,"NR. 216, PRIMARIE, OARTA DE JOS","OARTA DE JOS",41,108366,0,3,466,354,330,24,351,3,500,146,266,85,
26,"MARAMURES",243,108366,,228,0,"NR. 263, SCOALA, OARTA DE SUS","OARTA DE JOS",41,108366,0,3,661,464,383,81,458,6,700,236,227,231,
26,"MARAMURES",243,108400,,229,0,"STR. UNIRII, NR. 66, PRIMARIE, OCNA SUGATAG","OCNA SUGATAG",42,108400,0,3,1076,619,481,138,616,3,1200,581,405,211,
26,"MARAMURES",243,108400,,230,0,"NR. 87, SCOALA, BREBI","OCNA SUGATAG",42,108400,0,3,981,497,472,25,493,4,1100,603,131,362,
26,"MARAMURES",243,108400,,231,0,"NR. 20, SCOALA, HOTENI","OCNA SUGATAG",42,108400,0,3,312,141,131,10,132,9,400,259,40,92,
26,"MARAMURES",243,108400,,232,0,"NR. 327, SCOALA, SAT SUGATAG","OCNA SUGATAG",42,108400,0,3,960,552,507,45,549,3,1100,548,240,309,
26,"MARAMURES",243,108455,,233,0,"NR. 792, PRIMARIE, PETROVA","PETROVA",43,108455,0,3,2228,997,935,62,974,23,2500,1503,501,473,
26,"MARAMURES",243,179604,,234,0,"NR. 45, CAMINUL CULTURAL, POIENILE IZEI","POIENILE IZEI",45,179604,0,3,849,715,675,40,709,6,900,185,426,283,
26,"MARAMURES",243,108473,,235,0,"SCOALA GEN. NR. 1 - CENTRU, POIENILE DE SUB MUNTE","POIENILE DE SUB MUNTE",44,108473,0,3,2043,1191,1118,73,1156,35,2200,1009,796,360,
26,"MARAMURES",243,108473,,236,0,"SCOALA GENERALA NR. 4 HORB, POIENILE DE SUB MUNTE","POIENILE DE SUB MUNTE",44,108473,0,3,2100,1167,1118,49,1134,31,2300,1133,748,386,
26,"MARAMURES",243,108473,,237,0,"SCOALA GENERALA NR. 2 LUHEI., POIENILE DE SUB MUNTE","POIENILE DE SUB MUNTE",44,108473,0,3,797,453,430,23,443,6,900,447,327,116,
26,"MARAMURES",243,108473,,238,0,"NR. SCOALA GENERALA NR. 1 NEJNEI CRAI, POIENILE DE SUB MUNTE","POIENILE DE SUB MUNTE",44,108473,0,3,1663,905,794,111,886,19,1800,895,587,299,
26,"MARAMURES",243,106407,,239,0,"NR. 157, SCOALA, RECEA","RECEA",46,106407,0,3,829,518,433,85,508,10,900,382,293,215,
26,"MARAMURES",243,106407,,240,0,"NR. 122, SCOALA, BOZANTA MICA","RECEA",46,106407,0,3,287,230,176,54,229,1,300,70,96,133,
26,"MARAMURES",243,106407,,241,0,"NR. 43, SCOALA, LAPUSEL","RECEA",46,106407,0,3,975,620,523,97,617,3,1100,480,390,227,
26,"MARAMURES",243,106407,,242,0,"NR. 21, SCOALA, MOCIRA","RECEA",46,106407,0,3,566,465,422,43,461,4,600,135,293,168,
26,"MARAMURES",243,106407,,243,0,"NR. 346 - SCOALA, SASAR","RECEA",46,106407,0,3,1300,956,846,110,950,6,1400,444,459,491,
26,"MARAMURES",243,108491,,244,0,"NR. 129, CAMINUL CULTURAL, REMETEA CHIOARULUI","REMETEA CHIOARULUI",47,108491,0,3,1446,697,596,101,691,6,1600,903,366,325,
26,"MARAMURES",243,108491,,245,0,"NR. 30, SCOALA, BERCHEZOAIA","REMETEA CHIOARULUI",47,108491,0,3,409,161,136,25,161,0,500,339,67,94,
26,"MARAMURES",243,108491,,246,0,"NR. 85, SCOALA, POSTA","REMETEA CHIOARULUI",47,108491,0,3,283,187,163,24,186,1,300,113,59,127,
26,"MARAMURES",243,108552,,247,0,"CAMINUL CULTURAL, REMETI","REMETI",48,108552,0,3,1922,1067,1017,50,1060,7,2100,1033,476,584,
26,"MARAMURES",243,108552,,248,0,"SCOALA GEN., PIATRA","REMETI",48,108552,0,3,421,190,130,60,188,2,500,310,113,75,
26,"MARAMURES",243,108598,,249,0,"CAMINUL CULTURAL, REPEDEA","REPEDEA",49,108598,0,3,2149,1195,1118,77,1177,18,2400,1205,701,476,
26,"MARAMURES",243,108598,,250,0,"SCOALA GEN. NR. 2 MICLUSA, REPEDEA","REPEDEA",49,108598,0,3,950,539,477,62,525,14,1000,461,301,224,
26,"MARAMURES",243,108614,,251,0,"SCOALA,, RONA DE JOS","RONA DE JOS",50,108614,0,3,1732,827,765,62,823,4,1900,1073,336,487,
26,"MARAMURES",243,108632,,252,0,"NR. 1283, CAMINUL CULTURAL, RONA DE SUS","RONA DE SUS",51,108632,0,3,3301,1231,1135,96,1220,11,3600,2369,805,415,
26,"MARAMURES",243,108632,,253,0,"NR. 65, CLUBUL TINERETULUI, COSTIUI","RONA DE SUS",51,108632,0,3,536,310,244,66,304,6,600,290,226,78,
26,"MARAMURES",243,108669,,254,0,"NR. 348, PRIMARIE, ROZAVLEA","ROZAVLEA",52,108669,0,3,2770,1285,1195,90,1278,7,3000,1715,1072,206,
26,"MARAMURES",243,108669,,255,0,"NR. 78, CAMINUL CULTURAL, SIEU","ROZAVLEA",52,108669,0,3,1851,1195,1111,84,1185,10,2000,805,843,342,
26,"MARAMURES",243,108696,,256,0,"NR. 905, CAMINUL CULTURAL, RUSCOVA","RUSCOVA",53,108696,0,3,2720,1296,967,329,1282,14,3000,1704,411,871,
26,"MARAMURES",243,108696,,257,0,"NR. 535, SCOALA OBLAZ, RUSCOVA","RUSCOVA",53,108696,0,3,1110,547,297,250,532,15,1200,653,198,334,
26,"MARAMURES",243,106620,,258,0,"NR. 203, CAMINUL CULTURAL, SARASAU","SARASAU",59,106620,0,3,1815,911,826,85,903,6,2000,1091,352,551,
26,"MARAMURES",243,108712,,259,0,"NR. 129, SCOALA GEN., SATULUNG","SATULUNG",60,108712,0,3,1100,650,560,90,644,6,1200,550,369,275,
26,"MARAMURES",243,108712,,260,0,"NR. 52, CAMINUL CULTURAL, ARIESUL DE PADURE","SATULUNG",60,108712,0,3,161,144,108,36,143,1,200,56,83,60,
26,"MARAMURES",243,108712,,261,0,"NR. 46, SCOALA, FERSIG","SATULUNG",60,108712,0,3,555,289,258,31,289,0,600,311,143,146,
26,"MARAMURES",243,108712,,262,0,"NR. 205, SCOALA, FINTEUSU MIC","SATULUNG",60,108712,0,3,515,320,279,41,317,3,600,280,190,127,
26,"MARAMURES",243,108712,,263,0,"NR. 169, SCOALA, HIDEAGA","SATULUNG",60,108712,0,3,381,309,225,84,307,2,500,191,223,84,
26,"MARAMURES",243,108712,,264,0,"NR. 76, SCOALA, MOGOSESTI","SATULUNG",60,108712,0,3,557,284,240,44,283,1,600,316,159,124,
26,"MARAMURES",243,108712,,265,0,"NR. 211, SCOALA, PRIBILESTI","SATULUNG",60,108712,0,3,521,271,233,38,269,2,600,329,141,128,
26,"MARAMURES",243,108794,,266,0,"NR. 67, CAMINUL CULTURAL, SACALASENI","SACALASENI",54,108794,0,3,1605,660,548,112,656,4,1800,1140,358,298,
26,"MARAMURES",243,108794,,267,0,"NR. 266, SCOALA VECHE, COAS","SACALASENI",54,108794,0,3,1031,936,848,88,930,6,1100,164,540,390,
26,"MARAMURES",243,108794,,268,0,"NR. 68, CAMINUL CULTURAL,, COLTAU","SACALASENI",54,108794,0,3,1426,1105,1054,51,1096,9,1600,495,1047,49,
26,"MARAMURES",243,108794,,269,0,"NR. 26, SCOALA, INTRERAURI","SACALASENI",54,108794,0,3,60,64,47,17,64,0,100,36,42,22,
26,"MARAMURES",243,108874,,270,0,"NR. 1165, PRIMARIE,, SACEL","SACEL",55,108874,0,3,1751,914,874,40,913,1,1900,986,457,456,
26,"MARAMURES",243,108874,,271,0,"NR. 607, SCOALA VALEA CARELOR, SACEL","SACEL",55,108874,0,3,1375,649,609,40,645,4,1500,851,315,330,
26,"MARAMURES",243,108892,,272,0,"NR. 1744, CAMINUL CULTURAL, SALISTEA DE SUS","SALISTEA DE SUS",56,108892,0,3,2409,1407,1285,122,1398,9,2700,1293,734,664,
26,"MARAMURES",243,108892,,273,0,"NR. 1574, SCOALA MIHAI EMINESCU, SALISTEA DE SUS","SALISTEA DE SUS",56,108892,0,3,2000,1107,1043,64,1096,11,2200,1093,580,516,
26,"MARAMURES",243,108918,,274,0,"NR. 399, CAMINUL CULTURAL, SALSIG","SALSIG",57,108918,0,3,1118,734,665,69,725,9,1200,466,445,280,
26,"MARAMURES",243,108918,,275,0,"NR. 452, CAMINUL CULTURAL, GARDANI","SALSIG",57,108918,0,3,1069,574,517,57,573,1,1202,628,377,196,
26,"MARAMURES",243,108945,,276,0,"NR. 513, SCOALA, SAPANTA","SAPANTA",58,108945,0,3,2414,1314,1172,142,1300,11,2700,1386,612,688,
26,"MARAMURES",243,109005,,277,0,"NR. 65, CAMINUL CULTURAL, STRAMTURA","STRAMTURA",63,109005,0,3,1928,1024,946,78,1013,11,2100,1076,357,656,
26,"MARAMURES",243,109005,,278,0,"NR. 481, SCOALA SUSANI, STRAMTURA","STRAMTURA",63,109005,0,3,571,302,262,40,298,4,600,298,87,211,
26,"MARAMURES",243,109005,,279,0,"NR. 174, SCOALA, SLATIOARA","STRAMTURA",63,109005,0,3,484,220,196,24,219,1,500,280,125,94,
26,"MARAMURES",243,109005,,280,0,"NR. 93, SCOALA, GLOD","STRAMTURA",63,109005,0,3,585,336,301,35,336,0,600,264,186,150,
26,"MARAMURES",243,109041,,281,0,"NR. 823, SCOALA, SUCIU DE SUS","SUCIU DE SUS",64,109041,0,3,1269,740,588,152,733,7,1400,660,332,401,
26,"MARAMURES",243,109041,,282,0,"NR. 107, SCOALA CANDELA, SUCIU DE SUS","SUCIU DE SUS",64,109041,0,3,764,392,324,68,391,1,900,508,203,188,
26,"MARAMURES",243,109041,,283,0,"NR. 564, GRADINITA, GROSII TIBLESULUI","SUCIU DE SUS",64,109041,0,3,1299,753,628,125,748,5,1400,647,355,393,
26,"MARAMURES",243,109041,,284,0,"NR. 413, GRADINITA GREBLE, GROSII TIBLESULUI","SUCIU DE SUS",64,109041,0,3,439,315,186,129,314,1,500,185,244,70,
26,"MARAMURES",243,109041,,285,0,"NR. 337, CAMINUL CULTURAL, SUCIU DE JOS","SUCIU DE SUS",64,109041,0,3,973,441,377,64,440,1,1100,659,168,272,
26,"MARAMURES",243,109041,,286,0,"NR. 44, SCOALA, LARGA","SUCIU DE SUS",64,109041,0,3,322,206,161,45,205,1,400,194,80,125,
26,"MARAMURES",243,109096,,287,0,"NR. 229, CAMINUL CULTURAL, SISESTI","SISESTI",61,109096,0,3,1209,466,439,27,459,7,1300,834,199,260,
26,"MARAMURES",243,109096,,288,0,"NR. 102, SCOALA, CETATELE","SISESTI",61,109096,0,3,549,283,251,32,278,5,600,317,124,154,
26,"MARAMURES",243,109096,,289,0,"NR. 120, SCOALA, DANESTI","SISESTI",61,109096,0,3,703,328,282,46,323,5,800,472,117,206,
26,"MARAMURES",243,109096,,290,0,"NR. 93, SCOALA, NEGREIA","SISESTI",61,109096,0,3,417,174,156,18,172,2,500,326,62,110,
26,"MARAMURES",243,109096,,291,0,"NR. 82, SCOALA, PLOPIS","SISESTI",61,109096,0,3,375,268,248,20,266,2,400,132,106,160,
26,"MARAMURES",243,109096,,292,0,"NR. 125, SCOALA, SURDESTI","SISESTI",61,109096,0,3,1071,558,505,53,547,11,1200,642,227,320,
26,"MARAMURES",243,109176,,293,0,"STR. N. BALCESCU NR. 3, CAMINUL CULTURAL, SOMCUTA MARE","SOMCUTA MARE",62,109176,0,3,1508,938,704,234,930,8,1700,762,615,315,
26,"MARAMURES",243,109176,,294,0,"STR. N. BALCESCU NR. 75, DISPENSARUL VET., SOMCUTA MARE","SOMCUTA MARE",62,109176,0,3,1258,617,551,66,607,10,1400,783,452,155,
26,"MARAMURES",243,109176,,295,0,"NR. 197, SCOALA, VALENII SOMCUTEI","SOMCUTA MARE",62,109176,0,3,778,592,549,43,586,6,900,308,348,238,
26,"MARAMURES",243,109176,,296,0,"NR. 56, CAMINUL CULTURAL, BUCIUMI","SOMCUTA MARE",62,109176,0,3,893,637,603,34,623,14,1000,363,374,249,
26,"MARAMURES",243,109176,,297,0,"NR. 49, CAMINUL CULTURAL, FINTEUSU MARE","SOMCUTA MARE",62,109176,0,3,541,391,340,51,387,4,600,209,230,157,
26,"MARAMURES",243,109176,,298,0,"NR. 151, SCOALA, CIOLT","SOMCUTA MARE",62,109176,0,3,495,245,220,25,242,3,600,355,135,107,
26,"MARAMURES",243,109176,,299,0,"NR. 13, CAMINUL CULTURAL, BUTEASA","SOMCUTA MARE",62,109176,0,3,342,188,166,22,185,3,400,212,85,100,
26,"MARAMURES",243,109176,,300,0,"NR. 23, SCOALA, CODRU BUTESII","SOMCUTA MARE",62,109176,0,3,216,209,185,24,209,0,300,91,108,101,
26,"MARAMURES",243,106461,,301,0,"NR. 843, SCOALA, TAUTII MAGHERAUS","TAUTII-MAGHERAUS",65,106461,0,3,1545,889,710,179,880,9,1699,810,527,353,
26,"MARAMURES",243,106461,,302,0,"NR. 387/A, SCOALA, BAITA","TAUTII-MAGHERAUS",65,106461,0,3,1356,716,636,80,707,9,1500,784,465,242,
26,"MARAMURES",243,106461,,303,0,"NR. 29, SCOALA, NISTRU","TAUTII-MAGHERAUS",65,106461,0,3,778,448,381,67,444,4,900,452,236,208,
26,"MARAMURES",243,106461,,304,0,"NR. 35 A, SCOALA, BUSAG","TAUTII-MAGHERAUS",65,106461,0,3,331,300,214,86,290,10,400,100,160,130,
26,"MARAMURES",243,106461,,305,0,"NR. 95, SCOALA, BOZANTA MARE","TAUTII-MAGHERAUS",65,106461,0,3,409,353,308,45,348,5,500,147,225,123,
26,"MARAMURES",243,106461,,306,0,"NR. 62, SCOALA, ULMOASA","TAUTII-MAGHERAUS",65,106461,0,3,158,100,80,20,98,2,200,100,40,58,
26,"MARAMURES",243,106461,,307,0,"NR. 20/B SCOALA, MERISOR","TAUTII-MAGHERAUS",65,106461,0,3,163,172,121,51,169,3,200,28,104,65,
26,"MARAMURES",243,109265,,308,0,"STR. DR. FLORIAN C. ULMEANU NR. 13, CAMINUL CULTURAL, ULMENI","ULMENI",66,109265,0,3,1929,941,857,84,925,16,2100,1159,577,348,
26,"MARAMURES",243,109265,,309,0,"NR. 143, SCOALA, ARDUZEL","ULMENI",66,109265,0,3,1014,506,488,18,500,6,1100,594,417,83,
26,"MARAMURES",243,109265,,310,0,"NR. 196, SCOALA, CHELINTA","ULMENI",66,109265,0,3,867,608,579,29,593,15,1000,392,421,172,
26,"MARAMURES",243,109265,,311,0,"NR. 131, SCOALA, MANAU","ULMENI",66,109265,0,3,905,673,647,26,650,23,1000,327,532,118,
26,"MARAMURES",243,109265,,312,0,"NR. 228, SCOALA, SOMES UILEAC","ULMENI",66,109265,0,3,677,463,410,53,461,2,700,237,180,281,
26,"MARAMURES",243,106648,,313,0,"NR. 162, PRIMARIE, VADU IZEI","VADU IZEI",67,106648,0,3,1798,1011,897,114,995,16,2000,989,571,424,
26,"MARAMURES",243,106648,,314,0,"NR. 43, SCOALA, VALEA STEJARULUI","VADU IZEI",67,106648,0,3,440,300,275,25,294,6,500,200,151,143,
26,"MARAMURES",243,109354,,315,0,"NR, 78  CAMINUL CULTURAL, VALEA CHIOARULUI","VALEA CHIOARULUI",68,109354,0,3,1198,567,520,47,560,7,1300,733,281,279,
26,"MARAMURES",243,109354,,316,0,"NR. 73, SCOALA, CURTUIUSU MARE","VALEA CHIOARULUI",68,109354,0,3,300,302,233,69,301,1,400,98,221,80,
26,"MARAMURES",243,109354,,317,0,"SCOALA, FERICEA","VALEA CHIOARULUI",68,109354,0,3,348,346,332,14,340,6,400,54,304,36,
26,"MARAMURES",243,109425,,318,0,"NR. 12, CAMINUL CULTURAL, VIMA MICA","VIMA MICA",69,109425,0,3,591,262,225,37,256,6,700,438,138,118,
26,"MARAMURES",243,109425,,319,0,"NR. 111, CAMINUL CULTURAL, VIMA MARE","VIMA MICA",69,109425,0,3,364,210,171,39,208,2,400,190,75,133,
26,"MARAMURES",243,109425,,320,0,"NR. 42, CAMINUL CULTURAL, SALNITA","VIMA MICA",69,109425,0,3,473,182,162,20,182,0,500,318,84,98,
26,"MARAMURES",243,109504,,321,0,"NR. 733, PRIMARIE, VISEU DE JOS","VISEU DE JOS",70,109504,0,3,1257,669,618,51,663,6,1400,731,382,281,
26,"MARAMURES",243,109504,,322,0,"NR. 305, GRADINITA CENTRU, VISEU DE JOS","VISEU DE JOS",70,109504,0,3,1976,1074,1011,63,1068,6,2200,1126,574,494,
26,"MARAMURES",243,109504,,323,0,"NR. 226, SCOALA NR. 2, VISEU DE JOS","VISEU DE JOS",70,109504,0,3,1180,542,513,29,534,8,1300,758,307,227,
27,"MEHEDINTI",252,109773,,1,0,"POLICLINICA ALUNIS","MUNICIPIUL DROBETA-TURNU SEVERIN",1,109773,1,1,1712,849,810,39,839,10,1900,1051,554,285,
27,"MEHEDINTI",252,109773,,2,0,"POLICLINICA ALUNIS","MUNICIPIUL DROBETA-TURNU SEVERIN",1,109773,1,1,1451,728,702,26,722,6,1600,872,497,225,
27,"MEHEDINTI",252,109773,,3,0,"SCOALA NR. 1, STRADA TRAIAN,  NR. 18","MUNICIPIUL DROBETA-TURNU SEVERIN",1,109773,1,1,1767,936,878,58,924,12,1900,964,621,303,
27,"MEHEDINTI",252,109773,,4,0,"GRUP SCOLAR DECEBAL, STRADA ANTONINI, NR. 2","MUNICIPIUL DROBETA-TURNU SEVERIN",1,109773,1,1,1750,901,804,97,890,11,1900,999,605,285,
27,"MEHEDINTI",252,109773,,5,0,"SCOALA NR. 3,  STRADA DR. SAIDAC,  NR. 21","MUNICIPIUL DROBETA-TURNU SEVERIN",1,109773,1,1,1483,780,731,49,772,8,1600,820,545,227,
27,"MEHEDINTI",252,109773,,6,0,"PALATUL CULTURAL ""TH. COSTESCU"",  B-DUL CAROL I , NR. 4","MUNICIPIUL DROBETA-TURNU SEVERIN",1,109773,1,1,1856,1013,938,75,993,20,2000,987,752,241,
27,"MEHEDINTI",252,109773,,7,0,"LICEUL TRAIAN, B-DUL CAROL I, NR. 6","MUNICIPIUL DROBETA-TURNU SEVERIN",1,109773,1,1,1828,992,901,91,971,21,2000,1008,703,268,
27,"MEHEDINTI",252,109773,,8,0,"SCOALA NR. 10, STR. MIHAI EMINESCU, NR. 12","MUNICIPIUL DROBETA-TURNU SEVERIN",1,109773,1,1,1799,966,905,61,953,13,2000,1034,669,284,
27,"MEHEDINTI",252,109773,,9,0,"SCOALA NR. 10, STR. MIHAI EMINESCU, NR. 12","MUNICIPIUL DROBETA-TURNU SEVERIN",1,109773,1,1,1904,974,918,56,958,16,2100,1126,577,381,
27,"MEHEDINTI",252,109773,,10,0,"SCOALA PROFESIONALA ENERGETICA","MUNICIPIUL DROBETA-TURNU SEVERIN",1,109773,1,1,1625,856,782,74,848,8,1800,944,493,355,
27,"MEHEDINTI",252,109773,,11,0,"SCOALA PROFESIONALA ENERGETICA","MUNICIPIUL DROBETA-TURNU SEVERIN",1,109773,1,1,1089,571,540,31,568,3,1200,629,340,228,
27,"MEHEDINTI",252,109773,,12,0,"SC SEVERCONF SA, STR. TOPOLNITEI, NR. 16","MUNICIPIUL DROBETA-TURNU SEVERIN",1,109773,1,1,1624,805,777,28,803,2,1800,995,496,307,
27,"MEHEDINTI",252,109773,,13,0,"SCOALA NR. 9, STR. TRAIAN, NR. 287","MUNICIPIUL DROBETA-TURNU SEVERIN",1,109773,1,1,1571,742,707,35,737,5,1700,958,501,236,
27,"MEHEDINTI",252,109773,,14,0,"SCOALA NR. 9, STR. TRAIAN, NR. 287","MUNICIPIUL DROBETA-TURNU SEVERIN",1,109773,1,1,1515,769,723,46,760,9,1600,831,456,304,
27,"MEHEDINTI",252,109773,,15,0,"SC CILDRO SA, STR. TRAIAN, NR. 297","MUNICIPIUL DROBETA-TURNU SEVERIN",1,109773,1,1,1472,744,670,74,737,7,1600,856,318,419,
27,"MEHEDINTI",252,109773,,16,0,"SCOALA NR. 2, B-DUL TUDOR VLADIMIRESCU","MUNICIPIUL DROBETA-TURNU SEVERIN",1,109773,1,1,1530,846,775,71,840,6,1700,854,570,270,
27,"MEHEDINTI",252,109773,,17,0,"SCOALA NR. 8, STR. CICERO, NR. 79","MUNICIPIUL DROBETA-TURNU SEVERIN",1,109773,1,1,1579,841,791,50,830,11,1700,859,533,297,
27,"MEHEDINTI",252,109773,,18,0,"SCOALA NR. 8, STR. CICERO, NR. 79","MUNICIPIUL DROBETA-TURNU SEVERIN",1,109773,1,1,1508,870,850,20,862,8,1700,830,572,290,
27,"MEHEDINTI",252,109773,,19,0,"SCOALA NR. 7, STR. PACII, NR. 2","MUNICIPIUL DROBETA-TURNU SEVERIN",1,109773,1,1,1835,906,798,108,898,8,2000,1094,554,344,
27,"MEHEDINTI",252,109773,,20,0,"SCOALA NR. 7, STR. PACII, NR. 2","MUNICIPIUL DROBETA-TURNU SEVERIN",1,109773,1,1,1832,910,838,72,904,6,2000,1090,500,404,
27,"MEHEDINTI",252,109773,,21,0,"SCOALA NR. 7, STR. PACII, NR. 2","MUNICIPIUL DROBETA-TURNU SEVERIN",1,109773,1,1,1591,855,799,56,853,2,1800,945,498,355,
27,"MEHEDINTI",252,109773,,22,0,"DIRECTIA AGRICOLA, STR. CRISAN, NR. 87","MUNICIPIUL DROBETA-TURNU SEVERIN",1,109773,1,1,1925,918,833,85,914,4,2100,1182,496,418,
27,"MEHEDINTI",252,109773,,23,0,"DIRECTIA AGRICOLA, STR. CRISAN, NR. 87","MUNICIPIUL DROBETA-TURNU SEVERIN",1,109773,1,1,1831,917,829,88,916,1,2000,1083,528,388,
27,"MEHEDINTI",252,109773,,24,0,"SCOALA NR. 15, STR. CRISAN, NR. 49","MUNICIPIUL DROBETA-TURNU SEVERIN",1,109773,1,1,1973,912,850,62,907,5,2200,1288,548,359,
27,"MEHEDINTI",252,109773,,25,0,"SCOALA NR. 15, STR. CRISAN, NR. 49","MUNICIPIUL DROBETA-TURNU SEVERIN",1,109773,1,1,1924,951,866,85,943,8,2100,1149,528,415,
27,"MEHEDINTI",252,109773,,26,0,"SCOALA NR. 15, STR. CRISAN, NR. 49","MUNICIPIUL DROBETA-TURNU SEVERIN",1,109773,1,1,1930,930,891,39,922,8,2100,1170,592,330,
27,"MEHEDINTI",252,109773,,27,0,"LICEUL NR. 5, STR. CRISAN, NR. 50","MUNICIPIUL DROBETA-TURNU SEVERIN",1,109773,1,1,1657,853,781,72,846,7,1800,947,619,227,
27,"MEHEDINTI",252,109773,,28,0,"LICEUL NR. 5, STR. CRISAN, NR. 50","MUNICIPIUL DROBETA-TURNU SEVERIN",1,109773,1,1,1497,800,753,47,783,17,1600,800,568,215,
27,"MEHEDINTI",252,109773,,29,0,"COLEGIUL TH. COSTESCU, STR. PRAHOVA, NR. 37","MUNICIPIUL DROBETA-TURNU SEVERIN",1,109773,1,1,1332,761,713,48,757,4,1500,739,576,181,
27,"MEHEDINTI",252,109773,,30,0,"COLEGIUL TH. COSTESCU, STR. PRAHOVA, NR. 37","MUNICIPIUL DROBETA-TURNU SEVERIN",1,109773,1,1,1586,745,691,54,733,12,1800,1055,427,306,
27,"MEHEDINTI",252,109773,,31,0,"GRADINITA NR. 22, ALEEA TRANDAFIRILOR, NR. 1","MUNICIPIUL DROBETA-TURNU SEVERIN",1,109773,1,1,1844,886,827,59,877,9,2000,1114,533,344,
27,"MEHEDINTI",252,109773,,32,0,"SCOALA NR. 14, B-DUL REVOLUTIEI, NR. 24","MUNICIPIUL DROBETA-TURNU SEVERIN",1,109773,1,1,1588,819,768,51,806,13,1700,881,498,308,
27,"MEHEDINTI",252,109773,,33,0,"SCOALA NR. 11, STR. SLT. E. MARESI, NR. 1","MUNICIPIUL DROBETA-TURNU SEVERIN",1,109773,1,1,1783,954,885,69,943,11,2000,1046,608,335,
27,"MEHEDINTI",252,109773,,34,0,"SCOALA NR. 11, STR. SLT. E. MARESI, NR. 1","MUNICIPIUL DROBETA-TURNU SEVERIN",1,109773,1,1,1694,885,830,55,882,3,1900,1015,536,346,
27,"MEHEDINTI",252,109773,,35,0,"STATIA DE SALVARE, B-DUL MIHAI VITEAZUL, NR. 6","MUNICIPIUL DROBETA-TURNU SEVERIN",1,109773,1,1,1376,861,711,150,850,11,1800,939,499,351,
27,"MEHEDINTI",252,109773,,36,0,"SPITALUL JUDETEAN, B-DUL MIHAI VITEAZUL, NR. 8","MUNICIPIUL DROBETA-TURNU SEVERIN",1,109773,1,1,1821,1015,831,184,1012,3,2000,985,647,365,
27,"MEHEDINTI",252,109773,,37,0,"SPITALUL JUDETEAN, B-DUL MIHAI VITEAZUL, NR. 8","MUNICIPIUL DROBETA-TURNU SEVERIN",1,109773,1,1,1380,894,620,274,885,9,1500,606,532,353,
27,"MEHEDINTI",252,109773,,38,0,"GRADINITA NR. 20, STR. WALTER MARACINEANU, NR. 2","MUNICIPIUL DROBETA-TURNU SEVERIN",1,109773,1,1,1573,861,795,66,856,5,1700,839,476,380,
27,"MEHEDINTI",252,109773,,39,0,"LICEUL DOMNUL TUDOR, STR. I.C. BRATIANU, NR. 7","MUNICIPIUL DROBETA-TURNU SEVERIN",1,109773,1,1,1787,897,828,69,893,4,2000,1103,616,277,
27,"MEHEDINTI",252,109773,,40,0,"LICEUL DOMNUL TUDOR, STR. I.C. BRATIANU, NR. 7","MUNICIPIUL DROBETA-TURNU SEVERIN",1,109773,1,1,1893,923,853,70,914,9,2100,1177,602,312,
27,"MEHEDINTI",252,109773,,41,0,"LICEUL DOMNUL TUDOR, STR. I.C. BRATIANU, NR. 7","MUNICIPIUL DROBETA-TURNU SEVERIN",1,109773,1,1,1858,821,773,48,815,6,2000,1179,454,361,
27,"MEHEDINTI",252,109773,,42,0,"STADION MUNICIPAL,  STR. INDEPENDENTEI, NR. 40","MUNICIPIUL DROBETA-TURNU SEVERIN",1,109773,1,1,1859,987,950,37,982,5,2000,1013,556,426,
27,"MEHEDINTI",252,109773,,43,0,"LICEUL NR. 4, CALEA TG.JIULUI, NR. 13","MUNICIPIUL DROBETA-TURNU SEVERIN",1,109773,1,1,1675,835,774,61,830,5,1800,965,484,346,
27,"MEHEDINTI",252,109773,,44,0,"GRADINITA NR. 3, STR. I.C. BRATIANU, NR. 2","MUNICIPIUL DROBETA-TURNU SEVERIN",1,109773,1,1,1609,781,733,48,777,4,1800,1019,546,231,
27,"MEHEDINTI",252,109773,,45,0,"SCOALA NR. 6, STR. KISELEFF, NR. 55","MUNICIPIUL DROBETA-TURNU SEVERIN",1,109773,1,1,1885,987,892,95,975,12,2100,1113,665,310,
27,"MEHEDINTI",252,109773,,46,0,"SCOALA NR. 6, STR. KISELEFF, NR. 55","MUNICIPIUL DROBETA-TURNU SEVERIN",1,109773,1,1,1911,991,889,102,977,14,2100,1109,598,379,
27,"MEHEDINTI",252,109773,,47,0,"SCOALA NR. 6, STR. KISELEFF, NR. 55","MUNICIPIUL DROBETA-TURNU SEVERIN",1,109773,1,1,1983,1048,991,57,1041,7,2200,1152,650,391,
27,"MEHEDINTI",252,109773,,48,0,"COOPERATIVA MOBILA, STR. TOPOLNITEI, NR. 22","MUNICIPIUL DROBETA-TURNU SEVERIN",1,109773,1,1,1921,1063,911,152,1051,12,2100,1037,615,436,
27,"MEHEDINTI",252,109773,,49,0,"SCOALA NR. 4, ALEEA CLOSANI, NR. 6","MUNICIPIUL DROBETA-TURNU SEVERIN",1,109773,1,1,1236,814,786,28,809,5,2000,1186,514,295,
27,"MEHEDINTI",252,109773,,50,0,"SCOALA NR. 4, ALEEA CLOSANI, NR. 6","MUNICIPIUL DROBETA-TURNU SEVERIN",1,109773,1,1,1379,927,866,61,917,10,2100,1173,495,422,
27,"MEHEDINTI",252,109773,,51,0,"SCOALA NR. 4, ALEEA CLOSANI, NR. 6","MUNICIPIUL DROBETA-TURNU SEVERIN",1,109773,1,1,1796,903,845,58,896,7,2000,1097,497,399,
27,"MEHEDINTI",252,109773,,52,0,"GRADINITA SCHELA CLADOVEI, CALEA TIMISOAREI","MUNICIPIUL DROBETA-TURNU SEVERIN",1,109773,1,1,1524,985,658,327,977,8,1600,615,413,564,
27,"MEHEDINTI",252,109773,,53,0,"GRADINITA SCHELA CLADOVEI","MUNICIPIUL DROBETA-TURNU SEVERIN",1,109773,1,1,1380,926,808,118,918,8,1500,574,573,345,
27,"MEHEDINTI",252,109773,,54,0,"SCAOAL NR. 5 SCHELA NOUA","MUNICIPIUL DROBETA-TURNU SEVERIN",1,109773,1,1,1287,744,696,48,740,4,1400,656,464,276,
27,"MEHEDINTI",252,109773,,55,0,"SCOALA NR. 13, GURA VAII","MUNICIPIUL DROBETA-TURNU SEVERIN",1,109773,1,1,851,709,419,290,706,3,900,191,288,418,
27,"MEHEDINTI",252,109773,,56,1,"SECTIE SPECIALA","MUNICIPIUL DROBETA-TURNU SEVERIN",1,109773,1,1,60,80,60,20,79,1,100,20,57,22,
27,"MEHEDINTI",252,109773,,57,1,"SECTIE SPECIALA","MUNICIPIUL DROBETA-TURNU SEVERIN",1,109773,1,1,0,732,0,732,707,25,900,168,406,301,
27,"MEHEDINTI",252,109773,,58,1,"SECTIE SPECIALA","MUNICIPIUL DROBETA-TURNU SEVERIN",1,109773,1,1,391,407,380,27,400,7,800,393,246,154,
27,"MEHEDINTI",252,109773,,59,1,"SECTIE SPECIALA","MUNICIPIUL DROBETA-TURNU SEVERIN",1,109773,1,1,0,141,0,141,137,4,500,359,102,35,
27,"MEHEDINTI",252,109773,,60,1,"AUTOGARA, STR. TOPOLNITEI","MUNICIPIUL DROBETA-TURNU SEVERIN",1,109773,1,1,0,197,0,197,197,0,400,203,89,108,
27,"MEHEDINTI",252,109773,,61,1,"GARA, STR. GARII","MUNICIPIUL DROBETA-TURNU SEVERIN",1,109773,1,1,0,373,0,373,370,3,1000,627,158,212,
27,"MEHEDINTI",252,109924,,62,0,"SCOALA GENERALA BAIA DE ARAMA, STR. CONSTANTIN BRINCOVEANU","ORAS BAIA DE ARAMA",3,109924,2,1,1429,841,704,137,836,5,1400,559,492,344,
27,"MEHEDINTI",252,109924,,63,0,"LICEUL INDUSTRIAL BAIA DE ARAMA, STR, TUDOR VLADIMIRESCU, NR. 11","ORAS BAIA DE ARAMA",3,109924,2,1,1025,538,486,52,536,2,1309,771,344,192,
27,"MEHEDINTI",252,109924,,64,0,"SCOALA GENERALA NEGOESTI","ORAS BAIA DE ARAMA",3,109924,2,1,669,444,399,45,440,4,700,256,242,198,
27,"MEHEDINTI",252,109924,,65,0,"SCOALA GENERALA MARASESTI","ORAS BAIA DE ARAMA",3,109924,2,1,1178,594,563,31,589,5,1300,706,317,272,
27,"MEHEDINTI",252,110063,,66,0,"GRADINITA NR. 2 SUD, B-DUL 1 DECEMBRIE 1918, NR. 24","MUNICIPIUL ORSOVA",2,110063,1,1,1687,792,765,27,786,6,1900,1108,456,330,
27,"MEHEDINTI",252,110063,,67,0,"LICEUL TRAIAN LALESCU, B-DUL PORTILE DE FIER, NR. 32","MUNICIPIUL ORSOVA",2,110063,1,1,1942,996,871,125,985,11,2100,1104,497,488,
27,"MEHEDINTI",252,110063,,68,0,"CLUB COPII, STR. DECEBAL, NR. 3","MUNICIPIUL ORSOVA",2,110063,1,1,1167,641,600,41,633,8,1300,659,347,286,
27,"MEHEDINTI",252,110063,,69,0,"CLUB COPII, STR. DECEBAL, NR. 3","MUNICIPIUL ORSOVA",2,110063,1,1,1923,923,858,65,916,7,2100,1177,500,416,
27,"MEHEDINTI",252,110063,,70,0,"LICEUL DE MARINA ORSOVA, B-DUL 1 SECEMBRIE 1918, NR. 11A","MUNICIPIUL ORSOVA",2,110063,1,1,2000,982,924,58,977,5,2200,1218,550,427,
27,"MEHEDINTI",252,110063,,71,0,"SCOALLA GENERALA I-VIII, B-DUL 1 DECEMBRIE 1918, NR. 2","MUNICIPIUL ORSOVA",2,110063,1,1,1602,751,710,41,748,3,1800,1049,458,290,
27,"MEHEDINTI",252,110063,,72,0,"GRADINITA NR. 3,  STR. STEFAN CEL MARE, NR. 16","MUNICIPIUL ORSOVA",2,110063,1,1,1609,858,812,46,836,22,1800,942,434,402,
27,"MEHEDINTI",252,110063,,73,0,"SCOALA GENERALA I-IV, STR. COMARNIC, NR. 1","MUNICIPIUL ORSOVA",2,110063,1,1,284,178,154,24,178,0,300,122,97,81,
27,"MEHEDINTI",252,110063,,74,1,"SECTIE SPECIALA","MUNICIPIUL ORSOVA",2,110063,1,1,61,85,61,24,84,1,300,215,48,36,
27,"MEHEDINTI",252,110116,,75,0,"LICEUL INDUSTRIAL STREHAIA, STR. REPUBLICII, NR. 235","ORAS STREHAIA",4,110116,2,1,1493,922,842,80,911,11,1700,778,511,400,
27,"MEHEDINTI",252,110116,,76,0,"GRADINITA NR. 2, STR. EROILOR, NR. 3","ORAS STREHAIA",4,110116,2,1,1622,871,791,80,868,3,1800,929,396,472,
27,"MEHEDINTI",252,110116,,77,0,"SCOALA GENERALA STREHAIA, STR. REPUBLICII, NR. 126","ORAS STREHAIA",4,110116,2,1,1412,839,657,182,832,7,1600,761,434,398,
27,"MEHEDINTI",252,110116,,78,0,"GRADINITA VEST STREHAIA, STR. REPUBLICII, NR. 88","ORAS STREHAIA",4,110116,2,1,1423,878,743,135,868,10,1600,722,404,464,
27,"MEHEDINTI",252,110116,,79,0,"SCOALA GENERALA, CALEA SEVERINULUI, NR. 127","ORAS STREHAIA",4,110116,2,1,1101,712,601,111,702,10,1200,488,361,341,
27,"MEHEDINTI",252,110116,,80,0,"SCOALA GENERALA, STR. TRAIAN, NR. 70","ORAS STREHAIA",4,110116,2,1,380,232,201,31,221,11,400,168,97,124,
27,"MEHEDINTI",252,110116,,81,0,"SCOALA GENERALA, CALEA CRAIOVEI, NR. 12","ORAS STREHAIA",4,110116,2,1,588,348,314,34,347,1,600,252,132,215,
27,"MEHEDINTI",252,110116,,82,0,"SCOALA GENERALA COMANDA, STR. GRADINILOR","ORAS STREHAIA",4,110116,2,1,989,631,573,58,623,8,1100,469,261,362,
27,"MEHEDINTI",252,110116,,83,0,"SCOALA GENERALA MENTII DIN FATA","ORAS STREHAIA",4,110116,2,1,290,146,123,23,145,1,300,154,60,85,
27,"MEHEDINTI",252,110232,,84,0,"LICEUL TEORETIC VANJU MARE, STR. RAHOVEI, NR.2","ORAS VANJU MARE",5,110232,2,1,1352,704,628,76,703,1,1500,796,444,259,
27,"MEHEDINTI",252,110232,,85,0,"SCOALA GENERALA, STR. LIBERTATII, NR. 2","ORAS VANJU MARE",5,110232,2,1,1759,1061,1018,43,1059,2,2000,939,695,364,
27,"MEHEDINTI",252,110232,,86,0,"SCOALA GENERALA BUCURA","ORAS VANJU MARE",5,110232,2,1,284,184,145,39,176,8,300,116,107,69,
27,"MEHEDINTI",252,110232,,87,0,"SCOALA GENERALA NICOLAE BALCESCU","ORAS VANJU MARE",5,110232,2,1,790,538,478,60,521,17,900,362,358,163,
27,"MEHEDINTI",252,110232,,88,0,"SCOALA GENERALA OREVITA MARE","ORAS VANJU MARE",5,110232,2,1,903,614,539,75,606,8,1000,386,465,141,
27,"MEHEDINTI",252,110232,,89,0,"SCOALA GENERALA TRAIAN","ORAS VANJU MARE",5,110232,2,1,505,404,318,86,375,29,600,196,320,55,
27,"MEHEDINTI",252,110232,,90,1,"SECTIE SPECIALA","ORAS VANJU MARE",5,110232,2,1,0,99,0,99,99,0,100,1,55,44,
27,"MEHEDINTI",252,110296,,91,0,"CAMINUL CULTURAL BALA","BALA",7,110296,0,3,943,622,450,172,619,3,1000,378,406,213,
27,"MEHEDINTI",252,110296,,92,0,"CAMINUL CULTURAL BALA DE SUS","BALA",7,110296,0,3,594,387,305,82,385,2,700,313,194,191,
27,"MEHEDINTI",252,110296,,93,0,"SCOALA GENERALA RUDINA","BALA",7,110296,0,3,646,380,311,69,375,5,700,320,189,186,
27,"MEHEDINTI",252,110296,,94,0,"SCOALA GENERALA DILMA","BALA",7,110296,0,3,389,274,199,75,271,3,400,126,186,85,
27,"MEHEDINTI",252,110296,,95,0,"SCOALA GENERALA CRAINICI","BALA",7,110296,0,3,800,520,385,135,519,1,900,380,391,128,
27,"MEHEDINTI",252,110456,,96,0,"CAMINUL CULTURAL BALTA","BALTA",9,110456,0,3,400,266,225,41,261,5,400,134,122,139,
27,"MEHEDINTI",252,110456,,97,0,"SCOALA GENERALA PREJNA","BALTA",9,110456,0,3,746,507,425,82,500,7,800,293,292,208,
27,"MEHEDINTI",252,110456,,98,0,"SCOALA GENERALA SFODEA","BALTA",9,110456,0,3,109,70,50,20,70,0,100,30,24,46,
27,"MEHEDINTI",252,110535,,99,0,"SCOALA GENERALA BALACITA","BALACITA",8,110535,0,3,1296,687,587,100,682,5,1400,713,409,273,
27,"MEHEDINTI",252,110535,,100,0,"SCOALA GENERALA GVARDINITA","BALACITA",8,110535,0,3,1208,647,533,114,635,12,1300,653,368,267,
27,"MEHEDINTI",252,110535,,101,0,"SCOALA GENERALA DOBRA","BALACITA",8,110535,0,3,499,417,330,87,396,21,500,83,352,44,
27,"MEHEDINTI",252,110571,,102,0,"SCOALA GENERALA BACLES","BACLES",6,110571,0,3,706,542,441,101,535,7,798,256,342,193,
27,"MEHEDINTI",252,110571,,103,0,"SCOALA GENERALA CORZU","BACLES",6,110571,0,3,470,479,404,75,430,49,500,21,322,108,
27,"MEHEDINTI",252,110571,,104,0,"FOSTUL SEDIU CAP PETRA","BACLES",6,110571,0,3,429,497,399,98,490,7,500,3,377,113,
27,"MEHEDINTI",252,110571,,105,0,"SCOALA GENERALA SMADOVITA","BACLES",6,110571,0,3,595,307,248,59,305,2,700,393,172,133,
27,"MEHEDINTI",252,110688,,106,0,"PRIMARIA BALVANESTI","BALVANESTI",10,110688,0,3,948,408,324,84,403,5,1900,1492,183,220,
27,"MEHEDINTI",252,110740,,107,0,"SCOALA GENERALA BREZNITA-MOTRU","BREZNITA-MOTRU",11,110740,0,3,1063,485,417,68,484,1,1200,715,214,270,
27,"MEHEDINTI",252,110740,,108,0,"SCOALA GENERALA FAUROAIA","BREZNITA-MOTRU",11,110740,0,3,381,245,182,63,242,3,400,155,160,82,
27,"MEHEDINTI",252,110820,,109,0,"SCOALA GENERALA BREZNITA-OCOL","BREZNITA-OCOL",12,110820,0,3,1443,743,706,37,736,7,1600,857,227,509,
27,"MEHEDINTI",252,110820,,110,0,"SCOALA GENERALA MAGHERU","BREZNITA-OCOL",12,110820,0,3,648,402,344,58,393,9,700,298,180,213,
27,"MEHEDINTI",252,110820,,111,0,"SCOALA GENERALA JIDOSTITA","BREZNITA-OCOL",12,110820,0,3,951,558,449,109,550,8,1100,542,150,400,
27,"MEHEDINTI",252,110875,,112,0,"PRIMARIA BROSTENI","BROSTENI",13,110875,0,3,1079,699,508,191,694,5,1200,501,450,244,
27,"MEHEDINTI",252,110875,,113,0,"CAMINUL CULTURAL LUPSA DE JOS","BROSTENI",13,110875,0,3,1027,586,460,126,580,6,1100,514,373,207,
27,"MEHEDINTI",252,110946,,114,0,"SCOALA GENERALA BURILA MARE","BURILA MARE",14,110946,0,3,604,352,281,71,346,6,700,348,230,116,
27,"MEHEDINTI",252,110946,,115,0,"SCOALA GENERALA CRIVINA","BURILA MARE",14,110946,0,3,576,383,235,148,378,5,600,217,208,170,
27,"MEHEDINTI",252,110946,,116,0,"SCOALA GENERALA VRANCEA","BURILA MARE",14,110946,0,3,168,220,80,140,215,5,300,80,119,96,
27,"MEHEDINTI",252,110946,,117,0,"SCOALA GENERALA TIGANASI","BURILA MARE",14,110946,0,3,300,216,148,68,214,2,300,84,122,92,
27,"MEHEDINTI",252,110946,,118,0,"SCOALA GENERALA IZVORU-FRUMOS","BURILA MARE",14,110946,0,3,208,167,107,60,167,0,200,33,63,104,
27,"MEHEDINTI",252,111006,,119,0,"SCOALA GENERALA BUTOIESTI","BUTOIESTI",15,111006,0,3,1230,627,509,118,623,4,1400,773,383,240,
27,"MEHEDINTI",252,111006,,120,0,"SCOALA GENERALA BUICESTI","BUTOIESTI",15,111006,0,3,752,392,294,98,388,4,800,408,235,153,
27,"MEHEDINTI",252,111006,,121,0,"SCOALA GENERALA TINTARU","BUTOIESTI",15,111006,0,3,231,250,205,45,250,0,300,50,224,26,
27,"MEHEDINTI",252,111006,,122,0,"SCOALA GENERALA GURA MOTRULUI","BUTOIESTI",15,111006,0,3,306,211,166,45,208,3,301,90,109,99,
27,"MEHEDINTI",252,111097,,123,0,"SCOALA GENERALA CAZANESTI","CAZANESTI",16,111097,0,3,875,546,410,136,539,7,1000,454,340,199,
27,"MEHEDINTI",252,111097,,124,0,"SCOALA GENERALA SEVERINESTI","CAZANESTI",16,111097,0,3,1092,608,478,130,600,8,1200,592,410,190,
27,"MEHEDINTI",252,111220,,125,0,"CAMINUL CULTURAL CIRESU","CIRESU",17,111220,0,3,612,305,244,61,297,8,700,395,189,108,
27,"MEHEDINTI",252,111275,,126,0,"CAMINUL CULTURAL CORCOVA","CORCOVA",18,111275,0,3,1568,789,687,102,786,3,1700,911,546,240,
27,"MEHEDINTI",252,111275,,127,0,"SCOALA GENERALA CORDUN","CORCOVA",18,111275,0,3,869,517,410,107,514,3,1000,483,310,204,
27,"MEHEDINTI",252,111275,,128,0,"CAMINUL CULTURAL JIROV","CORCOVA",18,111275,0,3,1430,775,658,117,765,10,1600,825,482,283,
27,"MEHEDINTI",252,111275,,129,0,"CAMINUL CULTURAL CERNAIA","CORCOVA",18,111275,0,3,471,317,236,81,313,4,500,183,150,163,
27,"MEHEDINTI",252,111417,,130,0,"CAMINUL CULTURAL CORLATEL","CORLATEL",19,111417,0,3,636,485,380,105,473,12,700,215,333,140,
27,"MEHEDINTI",252,111417,,131,0,"SCOALA GENERALA VALEA ANILOR","CORLATEL",19,111417,0,3,558,399,343,56,394,5,600,201,278,116,
27,"MEHEDINTI",252,111444,,132,0,"CAMINUL CIULTURAL CUJMIR","CUJMIR",20,111444,0,3,1048,525,444,81,520,5,1200,675,314,206,
27,"MEHEDINTI",252,111444,,133,0,"BIBLIOTECA COMUNALA CUJMIR","CUJMIR",20,111444,0,3,1034,549,457,92,544,5,1100,551,336,208,
27,"MEHEDINTI",252,111444,,134,0,"SCOALA GENERALA AURORA","CUJMIR",20,111444,0,3,1081,579,474,105,574,5,1200,621,368,206,
27,"MEHEDINTI",252,111480,,135,0,"CAMINUL CULTURAL DEVESEL","DEVESEL",22,111480,0,3,979,658,451,207,654,4,1100,442,419,235,
27,"MEHEDINTI",252,111480,,136,0,"SCOALA GENERALA BATOTI","DEVESEL",22,111480,0,3,407,347,219,128,345,2,497,150,219,126,
27,"MEHEDINTI",252,111480,,137,0,"SCOALA GENERALA BISTRETU","DEVESEL",22,111480,0,3,486,471,341,130,463,8,500,29,345,118,
27,"MEHEDINTI",252,111480,,138,0,"SCOALA GENERALA SCAPAU","DEVESEL",22,111480,0,3,603,420,263,157,412,8,700,280,308,104,
27,"MEHEDINTI",252,111550,,139,0,"CAMINUL CULTURAL DARVARI","DARVARI",21,111550,0,3,1441,826,728,98,814,12,1600,774,402,412,
27,"MEHEDINTI",252,111550,,140,0,"CAMINUL CULTURAL GEMENI","DARVARI",21,111550,0,3,1116,612,530,82,605,7,1200,588,374,231,
27,"MEHEDINTI",252,112904,,141,0,"BIBLIOTECA COMUNALA DUBOVA","DUBOVA",23,112904,0,3,447,304,215,89,296,8,500,196,142,154,
27,"MEHEDINTI",252,112904,,142,0,"CAMINUL CULTURAL EIBENTHAL","DUBOVA",23,112904,0,3,433,292,252,40,289,3,500,208,185,104,
27,"MEHEDINTI",252,111587,,143,0,"CAMINUL CULTURAL DUMBRAVA DE JOS","DUMBRAVA",24,111587,0,3,507,523,391,132,504,19,600,77,381,123,
27,"MEHEDINTI",252,111587,,144,0,"SCOALA GENERALA ALBULESTI","DUMBRAVA",24,111587,0,3,747,717,573,144,653,64,800,83,523,130,
27,"MEHEDINTI",252,111587,,145,0,"SCOALA GENERALA ROCSORENI","DUMBRAVA",24,111587,0,3,217,168,98,70,165,3,200,32,133,32,
27,"MEHEDINTI",252,112245,,146,0,"GRADINITA ESELNITA","ESELNITA",25,112245,0,3,1037,707,646,61,702,5,1100,393,327,375,
27,"MEHEDINTI",252,112245,,147,0,"GRADINITA ESELNITA","ESELNITA",25,112245,0,3,1206,777,720,57,771,6,1300,523,392,379,
27,"MEHEDINTI",252,111685,,148,0,"SCOALA GENERALA FLORESTI","FLORESTI",26,111685,0,3,1244,633,550,83,630,3,1400,767,419,211,
27,"MEHEDINTI",252,111685,,149,0,"SCOALA GENERALA ZEGUJANI","FLORESTI",26,111685,0,3,802,469,394,75,465,4,900,431,320,145,
27,"MEHEDINTI",252,111783,,150,0,"CAMINUL CULTURAL GARLA MARE","GARLA MARE",27,111783,0,3,1563,607,543,64,601,6,1700,1093,417,184,
27,"MEHEDINTI",252,111783,,151,0,"CAMINUL CULTURAL GARLA MARE","GARLA MARE",27,111783,0,3,1209,474,442,32,469,5,1300,826,315,154,
27,"MEHEDINTI",252,111783,,152,0,"CAMINUL CULTURAL VRATA","GARLA MARE",27,111783,0,3,1360,840,655,185,831,9,1500,660,467,364,
27,"MEHEDINTI",252,111818,,153,0,"PRIMARIA GODEANU","GODEANU",28,111818,0,3,582,294,207,87,291,3,600,306,171,120,
27,"MEHEDINTI",252,111863,,154,0,"SCOALA GENERALA GOGOSU","GOGOSU",29,111863,0,3,985,607,510,97,598,9,1100,493,374,224,
27,"MEHEDINTI",252,111863,,155,0,"SCOALA GENERALA BALTA VERDE","GOGOSU",29,111863,0,3,1012,503,431,72,499,4,1100,597,216,283,
27,"MEHEDINTI",252,111863,,156,0,"SCOALA GENERALA BURILA MICA","GOGOSU",29,111863,0,3,641,552,453,99,526,26,702,150,387,139,
27,"MEHEDINTI",252,111863,,157,0,"SCOALA GENERALA OSTROVU MARE","GOGOSU",29,111863,0,3,417,335,201,134,330,5,500,165,184,146,
27,"MEHEDINTI",252,111863,,158,1,"SCOALA GENERALA PF II","GOGOSU",29,111863,0,3,0,568,0,568,558,10,700,132,210,348,
27,"MEHEDINTI",252,111916,,159,0,"CAMINUL CULTURAL GRECI","GRECI",30,111916,0,3,660,421,301,120,418,3,650,229,294,124,
27,"MEHEDINTI",252,111916,,160,0,"SCOALA GENERALA BILTANELE","GRECI",30,111916,0,3,344,338,244,94,333,5,403,65,207,126,
27,"MEHEDINTI",252,111916,,161,0,"SCOALA GENERALA SALATRUC","GRECI",30,111916,0,3,217,223,170,53,217,6,250,27,157,60,
27,"MEHEDINTI",252,111989,,162,0,"SCOALA GENERALA GROZESTI","GROZESTI",31,111989,0,3,451,329,276,53,326,3,500,171,250,76,
27,"MEHEDINTI",252,111989,,163,0,"SCOALA GENERALA CIRCENI","GROZESTI",31,111989,0,3,657,457,390,67,451,6,700,243,330,121,
27,"MEHEDINTI",252,111989,,164,0,"SCOALA GENERALA SUSITA","GROZESTI",31,111989,0,3,513,464,368,96,462,2,600,136,318,144,
27,"MEHEDINTI",252,112030,,165,0,"CAMINUL CULTURAL GRUIA","GRUIA",32,112030,0,3,1370,1003,914,89,989,14,1400,397,821,168,
27,"MEHEDINTI",252,112030,,166,0,"CAMINUL CULTURAL IZVOARELE","GRUIA",32,112030,0,3,947,580,494,86,573,7,1000,420,368,205,
27,"MEHEDINTI",252,112030,,167,0,"CAMINUL CULTURAL POIANA GRUII","GRUIA",32,112030,0,3,225,229,197,32,229,0,300,71,187,42,
27,"MEHEDINTI",252,112076,,168,0,"SCOALA GENERALA HINOVA","HINOVA",33,112076,0,3,799,510,400,110,506,4,900,390,359,147,
27,"MEHEDINTI",252,112076,,169,0,"SCOALA GENERALA BISTRITA","HINOVA",33,112076,0,3,995,537,473,64,528,9,1101,564,236,292,
27,"MEHEDINTI",252,112076,,170,0,"SCOALA GENERALA OSTROVU CORBULUI","HINOVA",33,112076,0,3,368,305,229,76,302,3,400,95,162,140,
27,"MEHEDINTI",252,112129,,171,0,"CAMINUL CULTURAL HUSNICIOARA","HUSNICIOARA",34,112129,0,3,717,352,259,93,349,3,800,448,240,109,
27,"MEHEDINTI",252,112129,,172,0,"CAMINUL CULTURAL PERI","HUSNICIOARA",34,112129,0,3,563,313,209,104,308,5,600,287,201,107,
27,"MEHEDINTI",252,112263,,173,0,"DISPENSAR MEDICAL ILOVAT","ILOVAT",35,112263,0,3,1233,632,513,119,624,8,1398,766,478,146,
27,"MEHEDINTI",252,112334,,174,0,"CAMINUL CULTURAL ILOVITA","ILOVITA",36,112334,0,3,692,414,364,50,407,7,800,386,168,239,
27,"MEHEDINTI",252,112334,,175,0,"SCOALA GENERALA BAHNA","ILOVITA",36,112334,0,3,454,268,215,53,262,6,500,232,89,173,
27,"MEHEDINTI",252,112370,,176,0,"SCOALA GENERALA ISVERNA","ISVERNA",37,112370,0,3,1470,640,592,48,632,8,1600,960,326,306,
27,"MEHEDINTI",252,112370,,177,0,"SCOALA GENERALA NADANOVA","ISVERNA",37,112370,0,3,616,229,190,39,222,7,700,471,128,94,
27,"MEHEDINTI",252,112469,,178,0,"CAMINUL CULTURAL IZVORU BARZII","IZVORU BARZII",38,112469,0,3,1002,612,533,79,604,8,1100,488,262,342,
27,"MEHEDINTI",252,112469,,179,0,"SCOALA GENERALA BALOTESTI","IZVORU BARZII",38,112469,0,3,321,226,157,69,221,5,400,174,119,102,
27,"MEHEDINTI",252,112469,,180,0,"SCOALA GENERALA HALINGA","IZVORU BARZII",38,112469,0,3,659,419,269,150,413,6,700,281,188,225,
27,"MEHEDINTI",252,112469,,181,0,"SCOALA GENERALA SCHITU TOPOLNITEI","IZVORU BARZII",38,112469,0,3,164,65,42,23,63,2,200,135,49,14,
27,"MEHEDINTI",252,112548,,182,0,"SCOALA GENERALA JIANA","JIANA",39,112548,0,3,629,369,311,58,359,10,700,331,225,134,
27,"MEHEDINTI",252,112548,,183,0,"SCOALA GENERALA JIANA MARE","JIANA",39,112548,0,3,741,478,413,65,470,8,800,322,326,144,
27,"MEHEDINTI",252,112548,,184,0,"SCOALA GENERALA JIANA VECHE","JIANA",39,112548,0,3,751,424,368,56,422,2,800,376,253,169,
27,"MEHEDINTI",252,112548,,185,0,"CAMINUL CULTURAL DANCEU","JIANA",39,112548,0,3,1005,784,680,104,777,7,1100,316,505,272,
27,"MEHEDINTI",252,112548,,186,0,"SCOALA GENERALA CIOROBORENI","JIANA",39,112548,0,3,676,423,327,96,421,2,800,377,244,177,
27,"MEHEDINTI",252,112600,,187,0,"CAMINUL CULTURAL LIVEZILE","LIVEZILE",40,112600,0,3,894,498,415,83,489,9,1000,502,292,197,
27,"MEHEDINTI",252,112600,,188,0,"CAMINUL CULTURAL IZVORU ANESTILOR","LIVEZILE",40,112600,0,3,483,369,271,98,364,5,500,131,247,117,
27,"MEHEDINTI",252,112600,,189,0,"SCOALA GENERALA IZVORALU DE JOS","LIVEZILE",40,112600,0,3,206,168,130,38,164,4,200,32,98,66,
27,"MEHEDINTI",252,112664,,190,0,"SCOALA GENERALA MALOVAT","MALOVAT",41,112664,0,3,932,540,424,116,524,16,1000,460,281,243,
27,"MEHEDINTI",252,112664,,191,0,"SCOALA GENERALA 23 AUGUST","MALOVAT",41,112664,0,3,637,388,300,88,384,4,700,312,244,140,
27,"MEHEDINTI",252,112664,,192,0,"SCOALA GENERALA BOBAITA","MALOVAT",41,112664,0,3,619,329,226,103,324,5,700,371,199,125,
27,"MEHEDINTI",252,112744,,193,0,"CAMINUL CULTURAL OBARSIA DE CAMP","OBARSIA DE CAMP",42,112744,0,3,899,475,427,48,470,5,1000,525,238,232,
27,"MEHEDINTI",252,112744,,194,0,"CAMINUL CULTURAL IZIMSA","OBARSIA DE CAMP",42,112744,0,3,1063,689,612,77,678,11,1200,511,459,219,
27,"MEHEDINTI",252,110027,,195,0,"SCOALA GENERALA OBARSIA-CLOSANI","OBARSIA-CLOSANI",43,110027,0,3,839,491,444,47,484,7,900,409,165,319,
27,"MEHEDINTI",252,112771,,196,0,"CAMINUL CULTURAL OPRISOR","OPRISOR",44,112771,0,3,1072,652,558,94,643,9,1200,548,419,224,
27,"MEHEDINTI",252,112771,,197,0,"SCOALA GENERALA OPRISOR","OPRISOR",44,112771,0,3,1062,655,566,89,644,11,1200,545,415,229,
27,"MEHEDINTI",252,112771,,198,0,"CAMINUL CULTURAL PRISACEAUA","OPRISOR",44,112771,0,3,503,488,439,49,483,5,600,112,367,116,
27,"MEHEDINTI",252,112806,,199,0,"SCOALA GENERALA PADINA MARE","PADINA",45,112806,0,3,288,256,196,60,212,44,300,44,193,19,
27,"MEHEDINTI",252,112806,,200,0,"SCOALA GENERALA PADINA MICA","PADINA",45,112806,0,3,273,209,168,41,203,6,300,91,115,88,
27,"MEHEDINTI",252,112806,,201,0,"SCOALA GENERALA  OLTEANCA","PADINA",45,112806,0,3,119,138,93,45,135,3,150,12,100,35,
27,"MEHEDINTI",252,112806,,202,0,"CAMINUL CULTURAL IABLANITA","PADINA",45,112806,0,3,343,302,244,58,298,4,400,98,247,51,
27,"MEHEDINTI",252,112806,,203,0,"CAMINUL CULTURAL SLASOMA","PADINA",45,112806,0,3,536,487,412,75,476,11,550,63,375,101,
27,"MEHEDINTI",252,112806,,204,0,"CAMINUL CULTURAL BIBAN","PADINA",45,112806,0,3,109,86,62,24,84,2,100,14,57,27,
27,"MEHEDINTI",252,112879,,205,0,"CAMINUL CULTURAL PATULELE","PATULELE",46,112879,0,3,1537,869,692,177,860,9,1700,831,409,451,
27,"MEHEDINTI",252,112879,,206,0,"SCOALA GENERALA PATULELE","PATULELE",46,112879,0,3,1557,943,839,104,926,17,1700,757,486,440,
27,"MEHEDINTI",252,112879,,207,0,"CAMINUL CULTURAL VIASU","PATULELE",46,112879,0,3,491,384,329,55,381,3,500,116,226,155,
27,"MEHEDINTI",252,112959,,208,0,"CAMINUL CULTURAL PODENI","PODENI",47,112959,0,3,946,680,608,72,672,8,1000,320,350,322,
27,"MEHEDINTI",252,112995,,209,0,"SCOALA GENERALA PONOARELE","PONOARELE",48,112995,0,3,1000,432,361,71,427,5,1100,668,255,172,
27,"MEHEDINTI",252,112995,,210,0,"CAMINUL CULTURAL GHEORGHESTI","PONOARELE",48,112995,0,3,614,385,309,76,383,2,700,315,236,147,
27,"MEHEDINTI",252,112995,,211,0,"CAMINUL CULTURAL GARDANEASA","PONOARELE",48,112995,0,3,480,365,304,61,363,2,500,135,206,157,
27,"MEHEDINTI",252,113153,,212,0,"CAMINUL CULTURAL POROINA MARE","POROINA MARE",49,113153,0,3,530,534,476,58,494,40,600,66,460,34,
27,"MEHEDINTI",252,113153,,213,0,"SCOALA GENERALA STIGNITA","POROINA MARE",49,113153,0,3,475,436,354,82,432,4,450,14,342,90,
27,"MEHEDINTI",252,113153,,214,0,"SCOALA GENERALA FINTINILE NEGRE","POROINA MARE",49,113153,0,3,164,214,138,76,189,25,250,36,162,27,
27,"MEHEDINTI",252,113206,,215,0,"CAMINUL CULTURAL PRISTOL","PRISTOL",50,113206,0,3,1086,533,465,68,526,7,1200,667,321,205,
27,"MEHEDINTI",252,113206,,216,0,"SCOALA GENERALA COZIA","PRISTOL",50,113206,0,3,589,347,300,47,343,4,700,353,211,132,
27,"MEHEDINTI",252,113233,,217,0,"CAMINUL CULTURAL PRUNISOR","PRUNISOR",51,113233,0,3,596,357,272,85,338,19,699,342,189,149,
27,"MEHEDINTI",252,113233,,218,0,"CAMINUL CULTURAL FINTINA DOMNEASCA","PRUNISOR",51,113233,0,3,422,300,217,83,295,5,500,200,166,129,
27,"MEHEDINTI",252,113233,,219,0,"SCOALA GENERALA CERVENITA","PRUNISOR",51,113233,0,3,383,332,231,101,325,7,401,69,224,101,
27,"MEHEDINTI",252,113233,,220,0,"SCOALA GENERALA GHELMEGIOAIA","PRUNISOR",51,113233,0,3,400,200,138,62,196,4,400,196,141,55,
27,"MEHEDINTI",252,113233,,221,0,"SCOALA GENERALA ZEGAIA","PRUNISOR",51,113233,0,3,263,243,134,109,240,3,298,55,135,105,
27,"MEHEDINTI",252,113395,,222,0,"CAMINUL CULTURAL PUNGHINA","PUNGHINA",52,113395,0,3,1102,650,539,111,634,16,1200,550,404,230,
27,"MEHEDINTI",252,113395,,223,0,"CAMINUL CULTURAL DRINCEA","PUNGHINA",52,113395,0,3,534,356,267,89,346,10,600,244,204,142,
27,"MEHEDINTI",252,113395,,224,0,"SCOALA GENERALA RECEA","PUNGHINA",52,113395,0,3,738,528,483,45,526,2,800,272,403,123,
27,"MEHEDINTI",252,113466,,225,0,"SCOALA GENERALA ROGOVA","ROGOVA",53,113466,0,3,1177,658,571,87,655,3,1300,642,473,182,
27,"MEHEDINTI",252,113493,,226,0,"SCOALA GENERALA SALCIA","SALCIA",54,113493,0,3,1438,815,700,115,802,13,1600,785,448,354,
27,"MEHEDINTI",252,113493,,227,0,"SCOALA GENERALA SALCIA","SALCIA",54,113493,0,3,1586,838,756,82,832,6,1803,965,408,424,
27,"MEHEDINTI",252,113518,,228,0,"GRADINITA STANGACEAUA","STANGACEAUA",58,113518,0,3,861,678,597,81,668,10,900,222,468,200,
27,"MEHEDINTI",252,113518,,229,0,"SCOALA GENERALA SATU MARE","STANGACEAUA",58,113518,0,3,435,276,223,53,272,4,500,224,207,65,
27,"MEHEDINTI",252,113607,,230,0,"PRIMARIA SVINITA","SVINITA",59,113607,0,3,960,648,571,77,648,0,1100,452,393,255,
27,"MEHEDINTI",252,109826,,231,0,"SCOALA GENERALA SIMIAN","SIMIAN",55,109826,0,3,1497,696,587,109,689,7,1600,904,391,298,
27,"MEHEDINTI",252,109826,,232,0,"LICEUL AGROINDUSTRIAL SIMIAN","SIMIAN",55,109826,0,3,1458,653,557,96,649,4,1600,947,393,256,
27,"MEHEDINTI",252,109826,,233,0,"SCOALA GENERALA CERNETI","SIMIAN",55,109826,0,3,1076,636,531,105,632,4,1200,564,250,382,
27,"MEHEDINTI",252,109826,,234,0,"SCOALA GENERALA CERNETI","SIMIAN",55,109826,0,3,1225,712,598,114,705,7,1400,688,374,331,
27,"MEHEDINTI",252,109826,,235,0,"SCOALA GENERALA DUDASU","SIMIAN",55,109826,0,3,719,510,412,98,491,19,800,290,336,155,
27,"MEHEDINTI",252,109826,,236,0,"SCOALA GENERALA POROINA","SIMIAN",55,109826,0,3,626,376,286,90,371,5,700,324,191,180,
27,"MEHEDINTI",252,113625,,237,0,"CAMINUL CULTURAL SISESTI","SISESTI",56,113625,0,3,1077,834,656,178,828,6,1200,366,547,281,
27,"MEHEDINTI",252,113625,,238,0,"SCOALA GENERALA CRAGUESTI","SISESTI",56,113625,0,3,669,534,432,102,524,10,701,167,357,167,
27,"MEHEDINTI",252,113625,,239,0,"SCOALA GENERALA NOAPTESA","SISESTI",56,113625,0,3,735,581,527,54,570,11,800,219,429,141,
27,"MEHEDINTI",252,113698,,240,0,"PRIMARIA SOVARNA","SOVARNA",57,113698,0,3,1109,671,546,125,665,6,1200,529,434,231,
27,"MEHEDINTI",252,113732,,241,0,"PRIMARIA TAMNA","TAMNA",60,113732,0,3,913,378,275,103,376,2,1000,622,243,133,
27,"MEHEDINTI",252,113732,,242,0,"SCOALA GENERALA TAMNA","TAMNA",60,113732,0,3,714,390,301,89,389,1,800,410,267,122,
27,"MEHEDINTI",252,113732,,243,0,"SCOALA GENERALA IZVORALU","TAMNA",60,113732,0,3,371,243,180,63,241,2,400,157,167,74,
27,"MEHEDINTI",252,113732,,244,0,"SCOALA GENERALA PLOPI","TAMNA",60,113732,0,3,552,353,263,90,350,3,605,252,273,77,
27,"MEHEDINTI",252,113849,,245,0,"CAMINUL CULTURAL VANATORI","VANATORI",61,113849,0,3,1027,611,527,84,605,6,1100,489,365,240,
27,"MEHEDINTI",252,113849,,246,0,"SCOALA GENERALA ROSIORI","VANATORI",61,113849,0,3,907,524,414,110,522,2,1000,476,312,210,
27,"MEHEDINTI",252,113849,,247,0,"SCOALA GENERALA GOANTA","VANATORI",61,113849,0,3,438,313,232,81,308,5,500,187,168,140,
27,"MEHEDINTI",252,113849,,248,0,"SCOALA GENERALA BRANISTEA","VANATORI",61,113849,0,3,1340,792,676,116,774,18,1500,708,257,517,
27,"MEHEDINTI",252,113894,,249,0,"CAMINUL CULTURAL VANJULET","VANJULET",62,113894,0,3,1413,1389,1231,158,1328,61,1603,214,1210,118,
27,"MEHEDINTI",252,113929,,250,0,"CAMINUL CULTURAL VLADAIA","VLADAIA",63,113929,0,3,942,584,482,102,575,9,1000,416,403,172,
27,"MEHEDINTI",252,113929,,251,0,"SCOALA GENERALA ALMAJEL","VLADAIA",63,113929,0,3,635,332,283,49,326,6,700,368,209,117,
27,"MEHEDINTI",252,113929,,252,0,"SCOALA GENERALA SCORILA","VLADAIA",63,113929,0,3,295,177,143,34,177,0,300,123,46,131,
27,"MEHEDINTI",252,113974,,253,0,"SCOALA GENERALA VOLOIAC","VOLOIAC",64,113974,0,3,919,512,432,80,504,8,900,388,214,290,
27,"MEHEDINTI",252,113974,,254,0,"SCOALA GENERALA COTOROAIA","VOLOIAC",64,113974,0,3,504,303,247,56,297,6,600,297,141,156,
27,"MEHEDINTI",252,113974,,255,0,"SCOALA GENERALA LAC","VOLOIAC",64,113974,0,3,125,111,72,39,111,0,201,90,71,40,
28,"MURES",261,114319,,1,0,"CASA APOLLO, STR.P-TA TRANDAFIRILOR, NR.5","MUNICIPIUL TARGU MURES",1,114319,1,1,1829,1158,1004,154,1126,32,2020,862,875,251,
28,"MURES",261,114319,,2,0,"UNIVERSITATEA PETRU MAIOR, STR.NICOLAR IORGA, NR.1","MUNICIPIUL TARGU MURES",1,114319,1,1,1756,917,831,86,903,14,1920,1003,701,202,
28,"MURES",261,114319,,3,0,"LICEUL TEORETIC BOLYAI-FARCAS, STR.BOLYAI, NR.3","MUNICIPIUL TARGU MURES",1,114319,1,1,1755,1299,917,382,1254,45,1942,643,1043,211,
28,"MURES",261,114319,,4,0,"INTERNATUL GRUP SC. A.IANCU, STR. IULIU MANIU, NR.4","MUNICIPIUL TARGU MURES",1,114319,1,1,1757,984,859,125,965,19,1930,946,811,154,
28,"MURES",261,114319,,5,0,"SCOALA GENERALA NR.13, STR. IALOMITEI, NR.3","MUNICIPIUL TARGU MURES",1,114319,1,1,1736,952,880,72,938,14,1900,948,726,212,
28,"MURES",261,114319,,6,0,"SCOALA GENERALA NR.13, STR. IALOMITEI, NR.3","MUNICIPIUL TARGU MURES",1,114319,1,1,1098,481,408,73,477,4,1100,619,264,213,
28,"MURES",261,114319,,7,0,"SCOALA GENERALA NR.13, STR. IALOMITEI, NR.3","MUNICIPIUL TARGU MURES",1,114319,1,1,1223,742,639,103,728,14,1420,678,535,193,
28,"MURES",261,114319,,8,0,"SCOALA GENERALA NR.13, STR. IALOMITEI, NR.3","MUNICIPIUL TARGU MURES",1,114319,1,1,2028,1100,1033,67,1077,23,2230,1130,882,195,
28,"MURES",261,114319,,9,0,"SCOALA PROFESIONALA TRANSPORT AUTO, STR. MILCOVULUI, NR.5","MUNICIPIUL TARGU MURES",1,114319,1,1,2082,913,832,81,896,17,2280,1367,562,334,
28,"MURES",261,114319,,10,0,"SCOALA GENERALA NR.12, STR. LIBERTATII, NR.36/A","MUNICIPIUL TARGU MURES",1,114319,1,1,1852,1038,983,55,1006,32,2030,992,836,170,
28,"MURES",261,114319,,11,0,"CASA DE CULTURA A SINDICATELOR, STR. CUZA VODA, NR.22","MUNICIPIUL TARGU MURES",1,114319,1,1,1471,905,793,112,884,21,1620,715,742,142,
28,"MURES",261,114319,,12,0,"GRUP SCOLAR AGRICOL, STR. CALARASILOR, NR.108","MUNICIPIUL TARGU MURES",1,114319,1,1,1640,1048,841,207,1026,22,2060,1012,762,264,
28,"MURES",261,114319,,13,0,"SCOALA GENERALA NR.8, STR. BARAGANULUI, NR.2/A","MUNICIPIUL TARGU MURES",1,114319,1,1,1590,849,769,80,843,6,1744,895,471,372,
28,"MURES",261,114319,,14,0,"SCOALA GENERALA NR.8, STR. BARAGANULUI, NR.2/A","MUNICIPIUL TARGU MURES",1,114319,1,1,1768,978,930,48,970,8,1950,972,578,392,
28,"MURES",261,114319,,15,0,"SCOALA GENERALA NR.8, STR. BARAGANULUI, NR.2/A","MUNICIPIUL TARGU MURES",1,114319,1,1,1564,1015,780,235,1003,12,2000,985,687,316,
28,"MURES",261,114319,,16,0,"SCOALA GENERALA NR.8, STR. BARAGANULUI, NR.2/A","MUNICIPIUL TARGU MURES",1,114319,1,1,1646,906,787,119,886,20,1810,904,683,203,
28,"MURES",261,114319,,17,0,"SCOALA GENERALA NR.8, STR. BARAGANULUI, NR.2/A","MUNICIPIUL TARGU MURES",1,114319,1,1,2098,1107,1080,27,1095,12,2310,1203,562,533,
28,"MURES",261,114319,,18,0,"SCOALA GENERALA NR.16, STR. ALEEA CARPATI, NR.23","MUNICIPIUL TARGU MURES",1,114319,1,1,1495,825,723,102,806,19,1640,815,648,158,
28,"MURES",261,114319,,19,0,"SCOALA GENERALA NR.16, STR. ALEEA CARPATI, NR.23","MUNICIPIUL TARGU MURES",1,114319,1,1,1470,823,779,44,806,17,1645,822,671,135,
28,"MURES",261,114319,,20,0,"SCOALA GENERALA NR.9, STR. PAVEL CHINEZU, NR.9/A","MUNICIPIUL TARGU MURES",1,114319,1,1,1816,931,845,86,898,33,1982,1051,753,145,
28,"MURES",261,114319,,21,0,"GRADINITA CU PROGRAM PRELUNGIT NR.6, STR. MARASTI, NR.1","MUNICIPIUL TARGU MURES",1,114319,1,1,1979,1000,945,55,987,13,1725,725,672,315,
28,"MURES",261,114319,,22,0,"GRUP SCOLAR CONSTANTIN BRANCUSI, STR. VICTOR BABES, NR.11","MUNICIPIUL TARGU MURES",1,114319,1,1,1440,829,754,75,810,19,1596,767,647,163,
28,"MURES",261,114319,,23,0,"GRUP SCOLAR CONSTANTIN BRANCUSI, STR. VICTOR BABES, NR.11","MUNICIPIUL TARGU MURES",1,114319,1,1,1085,701,632,69,685,16,1200,499,534,151,
28,"MURES",261,114319,,24,0,"SCOALA GENERALA NR.7, STR. ALEEA CONSTRUCTORILOR, NR.49","MUNICIPIUL TARGU MURES",1,114319,1,1,1903,1046,956,90,1019,27,2120,1074,749,270,
28,"MURES",261,114319,,25,0,"SCOALA GENERALA NR.6, STR. SECUILOR MARTIRI, NR.14","MUNICIPIUL TARGU MURES",1,114319,1,1,1051,791,533,258,778,13,1160,369,535,243,
28,"MURES",261,114319,,26,0,"SCOALA GENERALA NR.6, STR. SECUILOR MARTIRI, NR.14","MUNICIPIUL TARGU MURES",1,114319,1,1,1438,849,768,81,833,16,1999,1150,670,163,
28,"MURES",261,114319,,27,0,"GRUP SCOLAR PRELUCRAREA LEMNULUI, STR. GH. MARINESCU, NR.62","MUNICIPIUL TARGU MURES",1,114319,1,1,1968,1195,1079,116,1179,16,2157,962,732,447,
28,"MURES",261,114319,,28,0,"CASA MIHAI EMINESCU, STR. N, GRIGORSCU, NR.19","MUNICIPIUL TARGU MURES",1,114319,1,1,1045,780,589,191,762,18,1150,370,643,119,
28,"MURES",261,114319,,29,0,"LICEUL UNIREA, STR. MIHAI VITEAZUL, NR.15-17","MUNICIPIUL TARGU MURES",1,114319,1,1,1875,1128,963,165,1102,26,2105,977,869,233,
28,"MURES",261,114319,,30,0,"SCOALA NORMALA MIHAI EMINESCU, STR. PAPIU ILARIAN, NR.37","MUNICIPIUL TARGU MURES",1,114319,1,1,2152,957,899,58,938,19,2260,1303,587,351,
28,"MURES",261,114319,,31,0,"SCOALA GENERALA NR.20, STR. CUTEZANTEI, NR.51","MUNICIPIUL TARGU MURES",1,114319,1,1,2041,990,927,63,977,13,2230,1240,594,383,
28,"MURES",261,114319,,32,0,"SCOALA GENERALA NR.20, STR. CUTEZANTEI, NR.51","MUNICIPIUL TARGU MURES",1,114319,1,1,2135,1148,1105,43,1138,10,2360,1212,654,484,
28,"MURES",261,114319,,33,0,"SCOALA GENERALA NR.20, STR. CUTEZANTEI, NR.51","MUNICIPIUL TARGU MURES",1,114319,1,1,2188,1202,1156,46,1192,10,2420,1218,709,483,
28,"MURES",261,114319,,34,0,"GRUPUL SC. IND. ELECTROMURES, STR. LIVEZENI, NR.5","MUNICIPIUL TARGU MURES",1,114319,1,1,2218,1065,1011,54,1045,20,2430,1365,639,406,
28,"MURES",261,114319,,35,0,"SCOALA GENERALA NR.20, STR. CUTEZANTEI, NR.51","MUNICIPIUL TARGU MURES",1,114319,1,1,2010,989,958,31,975,14,2220,1231,609,366,
28,"MURES",261,114319,,36,0,"SCOALA GENERALA NR.20, STR. CUTEZANTEI, NR.51","MUNICIPIUL TARGU MURES",1,114319,1,1,1997,997,965,32,981,16,2200,1203,621,360,
28,"MURES",261,114319,,37,0,"SCOALA GENERALA NR.5, STR. MUNCII, NR.17","MUNICIPIUL TARGU MURES",1,114319,1,1,1918,981,921,60,970,11,2110,1129,674,296,
28,"MURES",261,114319,,38,0,"SCOALA GENERALA NR.5, STR. MUNCII, NR.17","MUNICIPIUL TARGU MURES",1,114319,1,1,2111,1138,1102,36,1122,16,2330,1192,655,467,
28,"MURES",261,114319,,39,0,"SCOALA GENERALA NR.5, STR. MUNCII, NR.17","MUNICIPIUL TARGU MURES",1,114319,1,1,1712,861,804,57,854,7,1879,1018,526,328,
28,"MURES",261,114319,,40,0,"GRUPUL SC. IND. ELECTROMURES, STR. LIVEZENI, NR.5","MUNICIPIUL TARGU MURES",1,114319,1,1,1798,879,854,25,874,5,1990,1111,492,382,
28,"MURES",261,114319,,41,0,"GRUPUL SC. IND. ELECTROMURES, STR. LIVEZENI, NR.5","MUNICIPIUL TARGU MURES",1,114319,1,1,2018,1098,986,112,1080,18,2340,1242,640,440,
28,"MURES",261,114319,,42,0,"SCOALA GENERALA NR.18, STR. CERNAVODA, NR.2","MUNICIPIUL TARGU MURES",1,114319,1,1,1995,1100,1023,77,1078,22,2180,1080,643,435,
28,"MURES",261,114319,,43,0,"SCOALA GENERALA NR.18, STR. CERNAVODA, NR.2","MUNICIPIUL TARGU MURES",1,114319,1,1,2113,1145,1086,59,1129,16,2320,1175,678,451,
28,"MURES",261,114319,,44,0,"SCOALA GENERALA NR.18, STR. CERNAVODA, NR.2","MUNICIPIUL TARGU MURES",1,114319,1,1,1702,881,844,37,867,14,1860,979,488,379,
28,"MURES",261,114319,,45,0,"GRADINITA CU PROGRAM PRELUNGIT NR.9, STR.MOLDOVEI, NR.1","MUNICIPIUL TARGU MURES",1,114319,1,1,1970,1021,980,41,1011,10,2170,1149,610,401,
28,"MURES",261,114319,,46,0,"SCOALA GENERALA NR.3, STR. MOLDOVEI, NR.30","MUNICIPIUL TARGU MURES",1,114319,1,1,1648,855,816,39,842,13,1830,975,680,162,
28,"MURES",261,114319,,47,0,"SCOALA GENERALA NR.3, STR. MOLDOVEI, NR.30","MUNICIPIUL TARGU MURES",1,114319,1,1,1503,808,780,28,788,20,1660,852,678,110,
28,"MURES",261,114319,,48,0,"SCOALA GENERALA NR.14, STR. T. VLADIMIRESCU, NR.122","MUNICIPIUL TARGU MURES",1,114319,1,1,1682,934,862,72,921,13,1860,926,716,205,
28,"MURES",261,114319,,49,0,"SCOALA GENERALA NR.14, STR. T. VLADIMIRESCU, NR.122","MUNICIPIUL TARGU MURES",1,114319,1,1,1860,1057,1021,36,1044,13,2030,973,803,241,
28,"MURES",261,114319,,50,0,"SCOALA AJUTATOARE NR.1, B-DUL 1 DECEMBRIE 1918, NR.84","MUNICIPIUL TARGU MURES",1,114319,1,1,1486,836,720,116,824,12,1640,804,576,248,
28,"MURES",261,114319,,51,0,"SCOALA AJUTATOARE NR.1, B-DUL 1 DECEMBRIE 1918, NR.84","MUNICIPIUL TARGU MURES",1,114319,1,1,1851,1133,910,223,1108,25,2050,917,937,171,
28,"MURES",261,114319,,52,0,"SCOALA GENERALA NR.10, PASAJUL PANSELUTELOR, NR.6","MUNICIPIUL TARGU MURES",1,114319,1,1,2005,1048,1011,37,1031,17,2200,1152,714,317,
28,"MURES",261,114319,,53,0,"SCOALA GENERALA NR.10, PASAJUL PANSELUTELOR, NR.6","MUNICIPIUL TARGU MURES",1,114319,1,1,1947,1052,915,137,1038,14,2240,1188,839,199,
28,"MURES",261,114319,,54,0,"GRUPUL SC. IND. AVRAM IANCU, B-DUL 1848, NR.7","MUNICIPIUL TARGU MURES",1,114319,1,1,1684,826,784,42,812,14,2060,1234,663,149,
28,"MURES",261,114319,,55,0,"GRADINITA CU PROGRAM PRELUNGIT NR.13, STR. PARANGULUI, NR.23","MUNICIPIUL TARGU MURES",1,114319,1,1,1953,1090,1024,66,1077,13,2145,1055,811,266,
28,"MURES",261,114319,,56,0,"GRUPUL SC. IND. GH. SINCAI, STR. SURIANU, NR.1","MUNICIPIUL TARGU MURES",1,114319,1,1,1937,932,884,48,914,18,2120,1188,671,243,
28,"MURES",261,114319,,57,0,"GRUPUL SC. IND. GH. SINCAI, STR. SURIANU, NR.1","MUNICIPIUL TARGU MURES",1,114319,1,1,1953,1046,998,48,1035,11,2150,1104,743,292,
28,"MURES",261,114319,,58,0,"GRADINITA CU PROGRAM PRELUNGIT, STR. GH. DOJA, NR.27","MUNICIPIUL TARGU MURES",1,114319,1,1,2004,977,940,37,963,14,2210,1233,723,240,
28,"MURES",261,114319,,59,0,"GRUPUL SC. IND. GH. SINCAI, STR. SURIANU, NR.1","MUNICIPIUL TARGU MURES",1,114319,1,1,2010,1041,1005,36,1027,14,2210,1169,759,268,
28,"MURES",261,114319,,60,0,"GRADINITA CU PROGRAM PRELUNGIT NR.17, STR. LAMAITEI, NR.18","MUNICIPIUL TARGU MURES",1,114319,1,1,1824,962,921,41,946,16,2006,1044,712,234,
28,"MURES",261,114319,,61,0,"GRADINITA CU PROGRAM PRELUNGIT NR.17, STR. LAMAITEI, NR.18","MUNICIPIUL TARGU MURES",1,114319,1,1,1570,863,809,54,842,21,1730,867,619,223,
28,"MURES",261,114319,,62,0,"SCOALA GENERALA NR.15, B-DUL 1848, NR.55","MUNICIPIUL TARGU MURES",1,114319,1,1,1585,808,753,55,800,8,1740,932,614,186,
28,"MURES",261,114319,,63,0,"SCOALA GENERALA NR.15, B-DUL 1848, NR.55","MUNICIPIUL TARGU MURES",1,114319,1,1,1720,905,866,39,887,18,1900,995,619,268,
28,"MURES",261,114319,,64,0,"SCOALA GENERALA NR.17, STR. SURIANU, NR.3","MUNICIPIUL TARGU MURES",1,114319,1,1,1527,910,866,44,896,14,1680,770,751,145,
28,"MURES",261,114319,,65,0,"SCOALA GENERALA NR.17, STR. SURIANU, NR.3","MUNICIPIUL TARGU MURES",1,114319,1,1,1983,1033,988,45,1018,15,2190,1157,693,325,
28,"MURES",261,114319,,66,0,"GRADINITA CU PROGRAM PRELUNGIT NR.14, STR. I. BUTEANU, NR.18","MUNICIPIUL TARGU MURES",1,114319,1,1,1972,904,841,63,884,20,2170,1266,654,230,
28,"MURES",261,114319,,67,0,"SCOALA GENERALA NR.15, B-DUL 1848, NR.55","MUNICIPIUL TARGU MURES",1,114319,1,1,1887,939,895,44,930,9,2090,1151,676,254,
28,"MURES",261,114319,,68,0,"GRUPUL SC. IND. A. IANCU, STR. GH. DOJA, NR. 13","MUNICIPIUL TARGU MURES",1,114319,1,1,1671,906,829,77,892,14,1840,934,689,203,
28,"MURES",261,114319,,69,0,"SCOALA GENERALA NR.11, STR. BUDIULUI, NR.50/A","MUNICIPIUL TARGU MURES",1,114319,1,1,1853,898,861,37,883,15,2030,1132,673,210,
28,"MURES",261,114319,,70,0,"GRUPUL SC. IND. T. VUIA, STR. GH. DOJA, NR.102","MUNICIPIUL TARGU MURES",1,114319,1,1,1746,901,832,69,891,10,1924,1023,499,392,
28,"MURES",261,114319,,71,0,"GRUPUL SC. IND. T. VUIA, STR. GH. DOJA, NR.102","MUNICIPIUL TARGU MURES",1,114319,1,1,1676,863,778,85,840,23,1837,974,443,397,
28,"MURES",261,114319,,72,0,"SCOALA GENERALA NR.1, STR. HUNEDOARA, NR.38","MUNICIPIUL TARGU MURES",1,114319,1,1,2028,970,870,100,952,18,2230,1260,563,389,
28,"MURES",261,114319,,73,0,"SCOALA GENERALA NR.1, STR. HUNEDOARA, NR.38","MUNICIPIUL TARGU MURES",1,114319,1,1,1788,933,861,72,909,24,1960,1027,612,297,
28,"MURES",261,114319,,74,0,"GRADINITA CU PROGRAM NORMAL NR.18, STR. CAMINULUI, NR.13","MUNICIPIUL TARGU MURES",1,114319,1,1,1549,805,664,141,787,18,1700,895,469,318,
28,"MURES",261,114319,,75,1,"U.M. 0526, CART. T. VLADIMIRESCU","MUNICIPIUL TARGU MURES",1,114319,1,1,275,293,236,57,289,4,350,57,160,129,
28,"MURES",261,114319,,76,1,"CLINICA DE OBSTRETICA GINECOLOGIE, STR. KOTLETES SAMUEL, NR.29","MUNICIPIUL TARGU MURES",1,114319,1,1,0,152,0,152,149,3,260,108,103,46,
28,"MURES",261,114319,,77,1,"CLINICA UROLOGIE, CLINICA MEDICALA III, CLINICA CHIRURGIE II, STR. GH. MARINESCU, NR.3","MUNICIPIUL TARGU MURES",1,114319,1,1,0,426,0,426,421,5,660,234,296,125,
28,"MURES",261,114319,,78,1,"SPITALUL JUDETEAN MURES, STR. GH. MARINESCU, NR.50","MUNICIPIUL TARGU MURES",1,114319,1,1,0,763,0,763,759,4,1567,804,482,277,
28,"MURES",261,114319,,79,1,"CLINICA MEDICALA II, STR. REVOLUTIEI, NR.33","MUNICIPIUL TARGU MURES",1,114319,1,1,0,87,0,87,84,3,140,53,64,20,
28,"MURES",261,114319,,80,1,"CLINICA BOLI INFECTIOASE, STR. GH. DOJA, NR.89","MUNICIPIUL TARGU MURES",1,114319,1,1,0,73,0,73,73,0,150,77,53,20,
28,"MURES",261,114319,,81,1,"CAMINELE STUDENTESTI, STR. GRIGORESCU","MUNICIPIUL TARGU MURES",1,114319,1,1,0,609,0,609,596,13,1622,1013,468,128,
28,"MURES",261,114319,,82,1,"GARA CFR, STR. LIVIU REBREANU, NR.52","MUNICIPIUL TARGU MURES",1,114319,1,1,0,400,0,400,397,3,1300,900,187,210,
28,"MURES",261,114809,,83,0,"SCOALA GENERALA NR.2, P-TA PETRU MAIOR, NR.13","MUNICIPIUL REGHIN",2,114809,1,1,1631,848,774,74,846,2,1790,942,519,327,
28,"MURES",261,114809,,84,0,"CLUBUL COPIILOR, STR. M. EMINESCU, NR.10","MUNICIPIUL REGHIN",2,114809,1,1,1778,961,894,67,939,22,1950,989,540,399,
28,"MURES",261,114809,,85,0,"LICEUL TEORETIC, STR. VINATORILOR, NR.29","MUNICIPIUL REGHIN",2,114809,1,1,1931,979,905,74,966,13,2130,1151,569,397,
28,"MURES",261,114809,,86,0,"LICEUL PETRU MAIOR, STR. GARII, NR.20","MUNICIPIUL REGHIN",2,114809,1,1,1697,865,819,46,853,12,1862,997,443,410,
28,"MURES",261,114809,,87,0,"LICEUL PETRU MAIOR, STR. GARII, NR.20","MUNICIPIUL REGHIN",2,114809,1,1,1696,833,793,40,828,5,1869,1036,420,408,
28,"MURES",261,114809,,88,0,"GRUPUL SCOLAR AGRICOL, STR. RAULUI, NR.16","MUNICIPIUL REGHIN",2,114809,1,1,2004,983,923,60,972,11,2210,1227,590,382,
28,"MURES",261,114809,,89,0,"GRUPUL SCOLAR AGRICOL, STR. RAULUI, NR.16","MUNICIPIUL REGHIN",2,114809,1,1,2010,904,877,27,895,9,2200,1296,488,407,
28,"MURES",261,114809,,90,0,"CLUBUL IRUM, STR. AXENTE SEVER, NR.7","MUNICIPIUL REGHIN",2,114809,1,1,1356,779,726,53,766,13,1496,717,393,373,
28,"MURES",261,114809,,91,0,"CAMINUL DE ZI AMIS, STR. SALCAMILOR, NR.1","MUNICIPIUL REGHIN",2,114809,1,1,1663,1027,865,162,1019,8,1840,813,389,630,
28,"MURES",261,114809,,92,0,"CAMINUL CULTURAL IERNUTENI, STR. IERNUTENI, NR.138/A","MUNICIPIUL REGHIN",2,114809,1,1,1247,711,649,62,702,9,1370,659,379,323,
28,"MURES",261,114809,,93,0,"SCOALA GENERALA NR.4, STR. CASTELULUI, NR.35","MUNICIPIUL REGHIN",2,114809,1,1,1923,1060,979,81,1026,34,2022,962,738,288,
28,"MURES",261,114809,,94,0,"CAMINUL DE ZI IERNUTENI, STR. IERNUTENI, NR.26","MUNICIPIUL REGHIN",2,114809,1,1,2268,1232,1156,76,1224,8,2500,1268,719,505,
28,"MURES",261,114809,,95,0,"SCOALA GENERALA NR.6, STR. POMILOR, NR.6","MUNICIPIUL REGHIN",2,114809,1,1,1861,971,881,90,951,20,2050,1079,552,399,
28,"MURES",261,114809,,96,0,"SC PAJIMUR SA, STR. APALINEI, NR.37","MUNICIPIUL REGHIN",2,114809,1,1,1820,892,825,67,883,9,2000,1108,475,408,
28,"MURES",261,114809,,97,0,"SCOALA GENERALA NR.1, STR. M. VITEAZUL, NR.85","MUNICIPIUL REGHIN",2,114809,1,1,2088,1185,1099,86,1170,15,2310,1125,632,538,
28,"MURES",261,114809,,98,0,"CAMINUL DE ZI DIN ANSAMBLUL DE LOCUINTE MIHAI VITEAZUL","MUNICIPIUL REGHIN",2,114809,1,1,2054,1108,1040,68,1092,16,2266,1158,668,424,
28,"MURES",261,114809,,99,0,"GIMNAZIUL DE STAT AUGUSTIN MAIOR, STR. SCOLII, NR.3","MUNICIPIUL REGHIN",2,114809,1,1,1601,875,821,54,861,14,1770,895,623,238,
28,"MURES",261,114809,,100,1,"U.M. MOCIAR REGHIN","MUNICIPIUL REGHIN",2,114809,1,1,0,62,0,62,62,0,100,38,36,26,
28,"MURES",261,114809,,101,1,"SPITALUL MUNICIPAL, STR. SPITALULUI","MUNICIPIUL REGHIN",2,114809,1,1,0,187,0,187,183,4,305,118,83,100,
28,"MURES",261,114809,,102,1,"CAMINUL DE BATRANI, STR. PANDURILOR","MUNICIPIUL REGHIN",2,114809,1,1,0,107,0,107,100,7,150,43,53,47,
28,"MURES",261,114514,,103,0,"SCOALA GENERALA NR.5, STR. A. IPATESCU, NR.14","MUNICIPIUL SIGHISOARA",3,114514,1,1,1513,836,792,44,808,28,1660,824,452,356,
28,"MURES",261,114514,,104,0,"LICEUL NR.1, STR. T. IONESCU, NR.18","MUNICIPIUL SIGHISOARA",3,114514,1,1,1998,960,859,101,938,22,2200,1240,631,307,
28,"MURES",261,114514,,105,0,"SALA M. EMINESCU, P-TA OBERTH, NR.22","MUNICIPIUL SIGHISOARA",3,114514,1,1,1718,821,737,84,801,20,1880,1059,514,287,
28,"MURES",261,114514,,106,0,"SALA C. PORUMBESCU, STR. TURNULUI, NR.1","MUNICIPIUL SIGHISOARA",3,114514,1,1,500,327,257,70,319,8,550,223,211,108,
28,"MURES",261,114514,,107,0,"SCOALA GENERALA NR.3, STR. H. TECULESCU, NR.2","MUNICIPIUL SIGHISOARA",3,114514,1,1,1798,873,805,68,851,22,1980,1107,505,346,
28,"MURES",261,114514,,108,0,"GRADINITA NR.6, STR. PLOPILOR, NR.19","MUNICIPIUL SIGHISOARA",3,114514,1,1,1330,647,613,34,632,15,1460,813,398,234,
28,"MURES",261,114514,,109,0,"SCOALA GENERALA NR.6, STR. DUMBRAVEI, NR.28","MUNICIPIUL SIGHISOARA",3,114514,1,1,1189,544,509,35,534,10,1280,736,370,164,
28,"MURES",261,114514,,110,0,"SCOALA GENERALA NR.6, STR. DUMBRAVEI, NR.28","MUNICIPIUL SIGHISOARA",3,114514,1,1,1180,555,535,20,541,14,1310,755,373,168,
28,"MURES",261,114514,,111,0,"SCOALA GENERALA NR.6, STR. DUMBRAVEI, NR.28","MUNICIPIUL SIGHISOARA",3,114514,1,1,1535,702,657,45,678,24,1690,988,449,229,
28,"MURES",261,114514,,112,0,"SC NICOVALA SA, STR. M. VITEAZUL, NR.96","MUNICIPIUL SIGHISOARA",3,114514,1,1,1576,746,627,119,735,11,1740,994,435,300,
28,"MURES",261,114514,,113,0,"GIMNAZIUL Z. BOIU, STR. CRIZANTEMELOR, NR.20","MUNICIPIUL SIGHISOARA",3,114514,1,1,1571,762,708,54,744,18,1740,978,433,311,
28,"MURES",261,114514,,114,0,"GIMNAZIUL Z. BOIU, STR. CRIZANTEMELOR, NR.20","MUNICIPIUL SIGHISOARA",3,114514,1,1,1911,804,743,61,784,20,2100,1296,467,317,
28,"MURES",261,114514,,115,0,"GIMNAZIUL Z. BOIU, STR. CRIZANTEMELOR, NR.20","MUNICIPIUL SIGHISOARA",3,114514,1,1,1450,689,659,30,679,10,1580,891,382,297,
28,"MURES",261,114514,,116,0,"CAMINUL DE NEFAMILISTI, STR. M. VITEAZUL, NR.5/A","MUNICIPIUL SIGHISOARA",3,114514,1,1,1291,616,532,84,608,8,1430,814,365,243,
28,"MURES",261,114514,,117,0,"ALIMENTARA VIILOR, STR. VIILOR, NR.68","MUNICIPIUL SIGHISOARA",3,114514,1,1,1131,589,502,87,569,20,1240,651,387,182,
28,"MURES",261,114514,,118,0,"CLUBUL CFR, STR. N. TITULESCU, NR.9","MUNICIPIUL SIGHISOARA",3,114514,1,1,1019,603,521,82,587,16,1120,517,437,150,
28,"MURES",261,114514,,119,0,"GIMNAZIUL A. MOSORA, STR. ANDREI SAGUNA, NR.6","MUNICIPIUL SIGHISOARA",3,114514,1,1,1904,1071,903,168,1044,27,2240,1169,725,319,
28,"MURES",261,114514,,120,0,"SCOALA GENERALA NR.1, STR. MORII, NR.28","MUNICIPIUL SIGHISOARA",3,114514,1,1,1643,824,777,47,806,18,1820,996,549,257,
28,"MURES",261,114514,,121,0,"SCOALA GENERALA NR.4, STR. NOUA, NR.6","MUNICIPIUL SIGHISOARA",3,114514,1,1,1056,605,559,46,595,10,1160,555,409,186,
28,"MURES",261,114514,,122,0,"SCOALA GENERALA NR.4, STR. NOUA, NR.6","MUNICIPIUL SIGHISOARA",3,114514,1,1,1015,495,393,102,486,9,1110,615,300,186,
28,"MURES",261,114514,,123,0,"GRADINITA HETIUR, LOC HETIUR","MUNICIPIUL SIGHISOARA",3,114514,1,1,662,476,348,128,471,5,730,254,254,217,
28,"MURES",261,114514,,124,1,"U.M. SIGHISOARA, STR. N. FILIPESCU, NR.1","MUNICIPIUL SIGHISOARA",3,114514,1,1,0,104,0,104,97,7,150,46,58,39,
28,"MURES",261,114514,,125,1,"STATIA CFR, STR. LIBERTATII, NR.51","MUNICIPIUL SIGHISOARA",3,114514,1,1,0,100,0,100,94,6,100,0,54,40,
28,"MURES",261,114925,,126,0,"SCOALA GENERALA NR.3, STR. 1 IUNIE","MUNICIPIUL TARNAVENI",4,114925,1,1,1580,990,762,228,967,23,1730,740,649,318,
28,"MURES",261,114925,,127,0,"GRADINITA CU PROGRAM PRELUNGIT NR.1, STR. A. IANCU, NR.12","MUNICIPIUL TARNAVENI",4,114925,1,1,1202,706,668,38,694,12,1330,624,493,201,
28,"MURES",261,114925,,128,0,"GIMNAZIUL DE STAT TRAIAN, STR. REPUBLICII, NR.2","MUNICIPIUL TARNAVENI",4,114925,1,1,1300,637,595,42,626,11,1430,793,443,183,
28,"MURES",261,114925,,129,0,"SCOALA DE COOPERATIE, STR. TRANDAFIRILOR, NR.10","MUNICIPIUL TARNAVENI",4,114925,1,1,1531,826,748,78,811,15,1680,854,574,237,
28,"MURES",261,114925,,130,0,"CASA DE CULTURA M. EMINESCU, STR. REPUBLICII, NR.32","MUNICIPIUL TARNAVENI",4,114925,1,1,1352,793,740,53,782,11,1480,687,473,309,
28,"MURES",261,114925,,131,0,"GRADINITA NR.4, STR. REPUBLICII, NR.34","MUNICIPIUL TARNAVENI",4,114925,1,1,1456,773,738,35,766,7,1600,827,496,270,
28,"MURES",261,114925,,132,0,"GRUPUL SCOLAR DE CHIMIE INDUSTRIALA, STR. REPUBLICII, NR.30","MUNICIPIUL TARNAVENI",4,114925,1,1,972,597,494,103,583,14,1070,473,389,194,
28,"MURES",261,114925,,133,0,"SCOALA GENERALA NR.1, STR. SOIMILOR, NR.27","MUNICIPIUL TARNAVENI",4,114925,1,1,1103,548,511,37,541,7,1210,662,296,245,
28,"MURES",261,114925,,134,0,"SCOALA GENERALA NR.1, STR. SOIMILOR, NR.27","MUNICIPIUL TARNAVENI",4,114925,1,1,784,406,380,26,403,3,859,453,287,116,
28,"MURES",261,114925,,135,0,"AUTOGARA TARNAVENI, STR. VICTORIEI, NR.20","MUNICIPIUL TARNAVENI",4,114925,1,1,1496,878,761,117,874,4,1650,772,525,349,
28,"MURES",261,114925,,136,0,"AUTOGARA TARNAVENI, STR. VICTORIEI, NR.20","MUNICIPIUL TARNAVENI",4,114925,1,1,1380,719,664,55,713,6,1500,781,439,274,
28,"MURES",261,114925,,137,0,"COFETARIA BUCEGI, CART 1 DEC. 1918, NR.46/R","MUNICIPIUL TARNAVENI",4,114925,1,1,1711,747,706,41,740,7,1880,1133,405,335,
28,"MURES",261,114925,,138,0,"COFETARIA BUCEGI, CART 1 DEC. 1918, NR.46/R","MUNICIPIUL TARNAVENI",4,114925,1,1,1531,655,590,65,647,8,1690,1035,327,320,
28,"MURES",261,114925,,139,0,"CANTINA SCCA TEHNOLEMN, STR. 1 DEC 1918, NR.32","MUNICIPIUL TARNAVENI",4,114925,1,1,1169,648,615,33,630,18,1280,632,386,244,
28,"MURES",261,114925,,140,0,"GIMNAZIUL DE STAT V. MOLDOVAN, STR. FABRICILOR, NR.4","MUNICIPIUL TARNAVENI",4,114925,1,1,1272,631,578,53,622,9,1490,859,296,326,
28,"MURES",261,114925,,141,0,"CLUBUL GECSAT, STR. ARMATEI","MUNICIPIUL TARNAVENI",4,114925,1,1,891,499,460,39,493,6,1000,501,230,263,
28,"MURES",261,114925,,142,0,"SCOALA PRIMARA BOTORCA","MUNICIPIUL TARNAVENI",4,114925,1,1,295,202,155,47,197,5,320,118,98,99,
28,"MURES",261,114925,,143,0,"GIMNAZIUL DE STAT V. MOLDOVAN, STR. FABRICII, NR.4","MUNICIPIUL TARNAVENI",4,114925,1,1,1120,644,556,88,632,12,1230,586,388,244,
28,"MURES",261,114925,,144,0,"CAMINUL CULTURAL BOBOHALMA, SAT BOBOHALMA","MUNICIPIUL TARNAVENI",4,114925,1,1,1136,735,684,51,728,7,1250,515,170,558,
28,"MURES",261,117827,,145,0,"CASA DE CULTURA IERNUT, P-TA 1 DEC 1918","ORAS IERNUT",5,117827,2,1,1160,610,551,59,603,7,1160,550,343,260,
28,"MURES",261,117827,,146,0,"SCOALA GENERALA IERNUT, STR. GH. DOJA","ORAS IERNUT",5,117827,2,1,1705,929,858,71,917,12,1880,951,548,369,
28,"MURES",261,117827,,147,0,"SCOALA GENERALA IERNUT, STR. MIHAI EMINESCU","ORAS IERNUT",5,117827,2,1,1937,1074,987,87,1067,7,2130,1056,571,496,
28,"MURES",261,117827,,148,0,"SCOALA GENERALA CIPAU","ORAS IERNUT",5,117827,2,1,796,463,398,65,450,13,870,407,245,205,
28,"MURES",261,117827,,149,0,"SCOALA GENERALA DEAG","ORAS IERNUT",5,117827,2,1,364,282,229,53,278,4,400,118,181,97,
28,"MURES",261,117827,,150,0,"SCOALA GENERALA LECHINTA","ORAS IERNUT",5,117827,2,1,675,414,372,42,406,8,740,326,166,240,
28,"MURES",261,117827,,151,0,"SCOALA GENERALA OARBA DE M.","ORAS IERNUT",5,117827,2,1,182,130,94,36,130,0,200,70,40,90,
28,"MURES",261,117827,,152,0,"SCOALA GENERALA SALCUD","ORAS IERNUT",5,117827,2,1,741,492,450,42,481,11,820,328,235,246,
28,"MURES",261,117827,,153,0,"SCOALA GENERALA SF. GHEORGHE","ORAS IERNUT",5,117827,2,1,264,179,160,19,177,2,290,111,53,124,
28,"MURES",261,114710,,154,0,"SCOALA GENERALA NR.1, STR. REPUBLICII, NR.57","ORAS LUDUS",6,114710,2,1,1089,550,504,46,546,4,1200,650,325,221,
28,"MURES",261,114710,,155,0,"SCOALA GENERALA NR.1, STR. REPUBLICII, NR.57","ORAS LUDUS",6,114710,2,1,820,481,412,69,473,8,910,429,302,171,
28,"MURES",261,114710,,156,0,"GRADINITA CU PROGRAM PRELUNGIT NR.1, STR. VANATORILOR","ORAS LUDUS",6,114710,2,1,1171,637,586,51,622,15,1290,653,367,255,
28,"MURES",261,114710,,157,0,"SCOALA GENERALA NR.2, STR. CRINULUI, NR.2","ORAS LUDUS",6,114710,2,1,1514,719,681,38,714,5,1660,941,401,313,
28,"MURES",261,114710,,158,0,"CASA ORASENEASCA DE CULTURA","ORAS LUDUS",6,114710,2,1,1652,824,762,62,811,13,1810,986,438,373,
28,"MURES",261,114710,,159,0,"GRUPUL SCOLAR INDUSTRIAL, STR. CRINULUI, NR.2","ORAS LUDUS",6,114710,2,1,1600,839,781,58,830,9,1760,921,504,326,
28,"MURES",261,114710,,160,0,"GRADINITA CU PROGRAM PRELUNGIT NR.2, STR. RANDUNELELOR, NR.3BIS","ORAS LUDUS",6,114710,2,1,1726,878,823,55,868,10,1900,1022,472,396,
28,"MURES",261,114710,,161,0,"GRADINITA CU PROGRAM NORMAL NR.2, STR. CRINULUI, NR.38","ORAS LUDUS",6,114710,2,1,1529,821,762,59,817,4,1680,859,465,352,
28,"MURES",261,114710,,162,0,"SCOALA GENERALA NR.2, STR. CRINULUI, NR.2","ORAS LUDUS",6,114710,2,1,1488,715,699,16,707,8,1630,915,375,332,
28,"MURES",261,114710,,163,0,"CAMINUL CULTURAL GHEJA, LOC. GHEJA","ORAS LUDUS",6,114710,2,1,1149,753,686,67,743,10,1260,507,351,392,
28,"MURES",261,114710,,164,0,"CAMINUL CULTURAL ROSIORI, LOC. ROSIORI","ORAS LUDUS",6,114710,2,1,932,449,421,28,441,8,1020,571,364,77,
28,"MURES",261,114854,,165,0,"SCOALA GENERALA SACADAT DE JOS, STR. LUNGA","ORAS SOVATA",7,114854,2,1,954,430,377,53,416,14,1050,620,363,53,
28,"MURES",261,114854,,166,0,"SCOALA GENERALA NR.1, STR. PRINCIPALA, NR.196/A","ORAS SOVATA",7,114854,2,1,1450,512,480,32,490,22,1580,1068,446,44,
28,"MURES",261,114854,,167,0,"SEDIUL PRIMARIEI SOVATA, STR. PRINCIPALA, NR.155","ORAS SOVATA",7,114854,2,1,1814,739,658,81,708,31,2000,1261,654,54,
28,"MURES",261,114854,,168,0,"BIROUL DE CAZARE - S.C.B. SOVATA, STR. TRANDAFIRILOR","ORAS SOVATA",7,114854,2,1,1337,589,392,197,574,15,1470,881,498,76,
28,"MURES",261,114854,,169,0,"CAMINUL CULTURAL ORASENESC SOVATA, STR. PRINCIPALA, NR.32","ORAS SOVATA",7,114854,2,1,1195,543,501,42,525,18,1310,767,500,25,
28,"MURES",261,114854,,170,0,"CAMINUL CULTURAL ORASENESC SOVATA, STR. PRINCIPALA, NR.32","ORAS SOVATA",7,114854,2,1,1232,442,391,51,418,24,1360,918,385,33,
28,"MURES",261,114854,,171,0,"CAMINUL CULTURAL ILIESI","ORAS SOVATA",7,114854,2,1,281,241,169,72,233,8,310,69,229,4,
28,"MURES",261,114854,,172,0,"GRADINITA DE COPII SARATENI","ORAS SOVATA",7,114854,2,1,1226,685,615,70,673,12,1350,665,637,36,
28,"MURES",261,117042,,173,0,"SCOALA GENERALA ACATARI, NR.99","GHINDARI",44,117042,0,3,1562,833,761,72,808,25,1720,887,777,31,
28,"MURES",261,114970,,174,0,"SCOALA GENERALA GRUISOR, NR.37","ACATARI",8,114970,0,3,307,208,165,43,202,6,340,132,196,6,
28,"MURES",261,114970,,175,0,"CAMINUL CULTURAL ROTENI, NR.73","ACATARI",8,114970,0,3,666,397,366,31,380,17,730,333,365,15,
28,"MURES",261,114970,,176,0,"CAMINUL CULTURAL SUVEICA, NR.152","ACATARI",8,114970,0,3,224,149,130,19,142,7,250,101,129,13,
28,"MURES",261,114970,,177,0,"SCOALA GENERALA VALENI, NR.140","ACATARI",8,114970,0,3,933,566,519,47,551,15,1030,464,524,27,
28,"MURES",261,115076,,178,0,"SCOALA GENERALA ADAMUS, STR. LIVEZII, NR.77","ADAMUS",9,115076,0,3,1710,866,793,73,849,17,1880,1014,557,292,
28,"MURES",261,115076,,179,0,"SCOALA GENERALA CORNESTI, STR. VIILOR, NR.5","ADAMUS",9,115076,0,3,1010,632,586,46,612,20,1110,478,300,312,
28,"MURES",261,115076,,180,0,"GRADINITA CRAIESTI, STR. MARE","ADAMUS",9,115076,0,3,1067,548,498,50,530,18,1180,632,421,109,
28,"MURES",261,115076,,181,0,"GRADINITA DAMBAU, STR. MARE, NR.76","ADAMUS",9,115076,0,3,918,567,515,52,560,7,1050,483,395,165,
28,"MURES",261,114603,,182,0,"CAMINUL CULTURAL ALBESTI","ALBESTI",10,114603,0,3,1215,641,528,113,622,19,1320,679,410,212,
28,"MURES",261,114603,,183,0,"SCOALA GENERALA ALBESTI","ALBESTI",10,114603,0,3,1379,700,554,146,690,10,1530,830,425,265,
28,"MURES",261,114603,,184,0,"SCOALA GENERALA BOIU","ALBESTI",10,114603,0,3,1407,765,611,154,741,24,1553,788,507,234,
28,"MURES",261,115147,,185,0,"CAMINUL CULTURAL ALUNIS","ALUNIS",11,115147,0,3,1644,1270,1216,54,1246,24,1810,540,1088,158,
28,"MURES",261,115147,,186,0,"SCOALA GENERALA FITCAU","ALUNIS",11,115147,0,3,386,381,363,18,380,1,430,49,354,26,
28,"MURES",261,115147,,187,0,"CAMINUL CULTURAL LUNCA MURESULUI","ALUNIS",11,115147,0,3,562,439,412,27,427,12,620,181,405,22,
28,"MURES",261,115183,,188,0,"SEDIUL PRIMARIEI APOLD","APOLD",12,115183,0,3,581,442,344,98,440,2,640,198,256,184,
28,"MURES",261,115183,,189,0,"CAMINUL CULTURAL SAES","APOLD",12,115183,0,3,787,490,408,82,482,8,860,370,234,248,
28,"MURES",261,115183,,190,0,"GRADINITA DAIA","APOLD",12,115183,0,3,430,382,288,94,352,30,470,88,247,105,
28,"MURES",261,115236,,191,0,"SEDIUL PRIMARIEI ATINTIS","ATINTIS",13,115236,0,3,638,390,359,31,386,4,700,310,134,252,
28,"MURES",261,115236,,192,0,"SCOALA GENERALA BOTEZ","ATINTIS",13,115236,0,3,169,102,81,21,102,0,190,88,36,66,
28,"MURES",261,115236,,193,0,"CAMINUL CULTURAL CECALACA","ATINTIS",13,115236,0,3,350,214,186,28,212,2,380,166,172,40,
28,"MURES",261,115236,,194,0,"SCOALA GENERALA ISTIHAZA","ATINTIS",13,115236,0,3,161,123,107,16,116,7,180,57,101,15,
28,"MURES",261,115307,,195,0,"STR. REPUBLICII, NR.55","BAHNEA",15,115307,0,3,1394,726,635,91,709,17,1530,804,431,278,
28,"MURES",261,115307,,196,0,"SCOALA GENERALA BERNADEA","BAHNEA",15,115307,0,3,132,113,82,31,112,1,150,37,65,47,
28,"MURES",261,115307,,197,0,"SCOALA GENERALA CUND","BAHNEA",15,115307,0,3,124,87,50,37,86,1,140,53,43,43,
28,"MURES",261,115307,,198,0,"SCOALA GENERALA DAIA","BAHNEA",15,115307,0,3,188,125,103,22,117,8,212,87,76,41,
28,"MURES",261,115307,,199,0,"SCOALA GENERALA GOGAN","BAHNEA",15,115307,0,3,549,274,245,29,269,5,605,331,187,82,
28,"MURES",261,115307,,200,0,"SCOALA GENERALA IDICIU","BAHNEA",15,115307,0,3,257,219,164,55,217,2,280,61,107,110,
28,"MURES",261,115307,,201,0,"SCOALA GENERALA LEPINDEA","BAHNEA",15,115307,0,3,201,144,117,27,142,1,220,77,52,90,
28,"MURES",261,115389,,202,0,"CAMINUL CULTURAL BAND","BAND",18,115389,0,3,2625,1571,1355,216,1522,49,2890,1319,1291,231,
28,"MURES",261,115389,,203,0,"CAMINUL CULTURAL MADARAS","BAND",18,115389,0,3,1268,809,697,112,794,15,1420,611,658,136,
28,"MURES",261,115389,,204,0,"SCOALA GENERALA TIPTELNIC","BAND",18,115389,0,3,110,104,83,21,104,0,130,26,78,26,
28,"MURES",261,115389,,205,0,"SCOALA GENERALA VALEA RECE","BAND",18,115389,0,3,257,224,149,75,217,7,280,56,109,108,
28,"MURES",261,115389,,206,0,"SCOALA GENERALA MARASESTI","BAND",18,115389,0,3,342,252,165,87,243,9,375,123,120,123,
28,"MURES",261,115389,,207,0,"CAMINUL CULTURAL FINATE","BAND",18,115389,0,3,681,440,369,71,438,2,750,310,207,231,
28,"MURES",261,115389,,208,0,"CAMINUL CULTURAL OROIU","BAND",18,115389,0,3,304,223,186,37,219,4,330,107,94,125,
28,"MURES",261,115389,,209,0,"CAMINUL CULTURAL PETEA","BAND",18,115389,0,3,179,186,139,47,184,2,200,14,97,87,
28,"MURES",261,115520,,210,0,"CAMINUL CULTURAL BATOS","BATOS",19,115520,0,3,1063,653,587,66,636,17,1170,517,226,410,
28,"MURES",261,115520,,211,0,"SCOALA GENERALA DEDRAD","BATOS",19,115520,0,3,1088,753,662,91,748,5,1190,437,224,524,
28,"MURES",261,115520,,212,0,"SCOALA GENERALA GORENI","BATOS",19,115520,0,3,546,413,372,41,408,5,600,187,249,159,
28,"MURES",261,115520,,213,0,"SCOALA GENERALA UILA","BATOS",19,115520,0,3,453,286,261,25,278,8,500,214,202,76,
28,"MURES",261,115575,,214,0,"CAMINUL CULTURAL BAGACIU","BAGACIU",14,115575,0,3,801,526,436,90,512,14,880,354,288,224,
28,"MURES",261,115575,,215,0,"GRADINITA DELENII","BAGACIU",14,115575,0,3,957,629,587,42,616,13,1050,421,481,135,
28,"MURES",261,115600,,216,0,"SEDIUL PRIMARIEI BALA","BALA",16,115600,0,3,684,468,437,31,432,5,750,313,122,310,
28,"MURES",261,115600,,217,0,"CAMINUL CULTURAL ERCEA","BALA",16,115600,0,3,193,133,109,24,129,4,212,79,35,94,
28,"MURES",261,115637,,218,0,"CAMINUL CULTURAL BALAUSERI","BALAUSERI",17,115637,0,3,989,433,395,38,428,5,1080,647,389,39,
28,"MURES",261,115637,,219,0,"CAMINUL CULTURAL AGRISTEU","BALAUSERI",17,115637,0,3,518,260,227,33,245,15,565,305,217,28,
28,"MURES",261,115637,,220,0,"CAMINUL CULTURAL FILITELNIC","BALAUSERI",17,115637,0,3,1280,722,667,55,709,13,1400,678,685,24,
28,"MURES",261,115637,,221,0,"SCOALA GENERALA CHENDU","BALAUSERI",17,115637,0,3,488,329,286,43,321,8,530,201,318,3,
28,"MURES",261,115637,,222,0,"SCOALA GENERALA DUMITRENI","BALAUSERI",17,115637,0,3,199,143,105,38,141,2,220,77,51,90,
28,"MURES",261,115637,,223,0,"SCOALA GENERALA SENEREUS","BALAUSERI",17,115637,0,3,523,398,353,45,386,12,580,182,231,155,
28,"MURES",261,115708,,224,0,"CAMINUL CULTURAL BEICA DE JOS, NR.41","BEICA DE JOS",20,115708,0,3,1092,783,664,119,764,19,1200,417,587,177,
28,"MURES",261,115708,,225,0,"CAMINUL CULTURAL SERBENI, NR.37","BEICA DE JOS",20,115708,0,3,697,424,357,67,418,6,770,346,158,260,
28,"MURES",261,115771,,226,0,"SEDIUL PRIMARIEI BICHIS","BICHIS",21,115771,0,3,340,232,194,38,227,5,370,138,189,38,
28,"MURES",261,115771,,227,0,"CAMINUL CULTURAL GHIMBUT","BICHIS",21,115771,0,3,166,139,115,24,134,5,180,41,51,83,
28,"MURES",261,115771,,228,0,"CAMINUL CULTURAL OZD","BICHIS",21,115771,0,3,332,207,185,22,194,13,370,163,175,19,
28,"MURES",261,115824,,229,0,"PRIMARIA BOGATA, LOC. BOGATA, NR.122","BOGATA",22,115824,0,3,1523,723,668,55,713,10,1670,947,444,269,
28,"MURES",261,115851,,230,0,"SEDIUL PRIMARIEI BREAZA","BREAZA",24,115851,0,3,926,500,450,50,491,9,1020,520,320,171,
28,"MURES",261,115851,,231,0,"SCOALA GENERALA FILPISU MARE","BREAZA",24,115851,0,3,690,454,390,64,439,15,760,306,240,199,
28,"MURES",261,115851,,232,0,"SCOALA GENERALA FILPISU MIC","BREAZA",24,115851,0,3,378,264,252,12,257,7,410,146,167,90,
28,"MURES",261,115897,,233,0,"SCOALA GENERALA BRANCOVENESTI, NR.149","BRANCOVENESTI",23,115897,0,3,1225,684,625,59,661,23,1350,666,578,83,
28,"MURES",261,115897,,234,0,"SCOALA PRIMARA IDICEL SAT, NR.12","BRANCOVENESTI",23,115897,0,3,431,297,267,30,295,2,470,173,100,195,
28,"MURES",261,115897,,235,0,"CAMINUL CULTURAL IDICEL PADURE, NR.470","BRANCOVENESTI",23,115897,0,3,526,475,442,33,475,0,580,105,101,374,
28,"MURES",261,115897,,236,0,"SCOALA PRIMARA SACALU DE PADURE, NR.128","BRANCOVENESTI",23,115897,0,3,375,312,285,27,310,2,410,98,133,177,
28,"MURES",261,115897,,237,0,"GRADINITA DE COPII VALENII DE MUNTE, NR.168","BRANCOVENESTI",23,115897,0,3,1062,829,783,46,819,10,1170,341,746,73,
28,"MURES",261,115959,,238,0,"CAMINUL CULTURAL BOZED","CEUASU DE CAMPIE",25,115959,0,3,193,144,124,20,142,2,388,244,49,93,
28,"MURES",261,115959,,239,0,"CAMINUL CULTURAL CEUASU DE CIMPIE","CEUASU DE CAMPIE",25,115959,0,3,1973,985,874,111,976,9,2170,1185,693,283,
28,"MURES",261,115959,,240,0,"CAMINUL CULTURAL CULPIU","CEUASU DE CAMPIE",25,115959,0,3,311,236,208,28,234,2,340,104,176,58,
28,"MURES",261,115959,,241,0,"CAMINUL CULTURAL SABED","CEUASU DE CAMPIE",25,115959,0,3,520,358,294,64,349,9,570,212,321,28,
28,"MURES",261,115959,,242,0,"CAMINUL CULTURAL VOINICENI","CEUASU DE CAMPIE",25,115959,0,3,1021,619,549,70,599,20,1110,491,318,281,
28,"MURES",261,116046,,243,0,"CLUBUL CHETANI","CHETANI",26,116046,0,3,1047,723,670,53,719,4,1150,427,377,342,
28,"MURES",261,116046,,244,0,"CAMINUL CULTURAL GRINDENI","CHETANI",26,116046,0,3,560,365,336,29,361,4,620,255,255,106,
28,"MURES",261,116046,,245,0,"CAMINUL CULTURAL HADARENI","CHETANI",26,116046,0,3,631,363,307,56,358,5,690,327,174,184,
28,"MURES",261,116126,,246,0,"SEDIUL PRIMARIEI CHIHERU DE JOS","CHIHERU DE JOS",27,116126,0,3,750,475,398,77,467,8,820,345,198,269,
28,"MURES",261,116126,,247,0,"CAMINUL CULTURAL URISIU DE SUS","CHIHERU DE JOS",27,116126,0,3,816,579,533,46,573,6,900,321,218,355,
28,"MURES",261,116171,,248,0,"SCOALA GENERALA COROISANMARTIN","COROISANMARTIN",28,116171,0,3,847,373,312,61,366,7,1030,657,236,130,
28,"MURES",261,116171,,249,0,"SCOALA GENERALA SOIMUS","COROISANMARTIN",28,116171,0,3,388,345,288,57,338,7,430,85,202,136,
28,"MURES",261,116224,,250,0,"SEDIUL PRIMARIEI COZMA","COZMA",29,116224,0,3,391,256,222,34,250,6,430,174,81,169,
28,"MURES",261,116224,,251,0,"CAMINUL CULTURAL SOCOL","COZMA",29,116224,0,3,168,104,88,16,100,4,178,74,22,78,
28,"MURES",261,116288,,252,0,"CAMINUL CULTURAL CRACIUNESTI","CRACIUNESTI",30,116288,0,3,1853,863,788,75,850,13,2040,1177,829,21,
28,"MURES",261,116288,,253,0,"CAMINUL CULTURAL CORNESTI","CRACIUNESTI",30,116288,0,3,696,529,487,42,520,9,770,241,513,7,
28,"MURES",261,116288,,254,0,"CAMINUL CULTURAL CINTA","CRACIUNESTI",30,116288,0,3,415,310,270,40,293,17,450,140,264,29,
28,"MURES",261,116288,,255,0,"SCOALA GENERALA BUDIU-MIC","CRACIUNESTI",30,116288,0,3,320,132,108,24,129,3,350,218,125,4,
28,"MURES",261,116340,,256,0,"SEDIUL PRIMARIEI CRAIESTI, NR.194","CRAIESTI",31,116340,0,3,673,361,340,21,359,2,740,379,153,206,
28,"MURES",261,116340,,257,0,"SCOALA GENERALA MILASEL, NR.46","CRAIESTI",31,116340,0,3,215,144,130,14,140,4,240,96,62,78,
28,"MURES",261,114355,,258,0,"SEDIUL PRIMARIEI CRISTESTI","CRISTESTI",32,114355,0,3,2087,1084,1008,76,1067,17,2290,1206,641,426,
28,"MURES",261,114355,,259,0,"SCOALA GENERALA CRISTESTI","CRISTESTI",32,114355,0,3,1434,704,605,99,693,11,1580,876,447,246,
28,"MURES",261,114355,,260,0,"CAMINUL CULTURAL VALURENI","CRISTESTI",32,114355,0,3,854,336,300,36,321,15,930,594,311,10,
28,"MURES",261,116395,,261,0,"SEDIUL PRIMARIEI CUCERDEA","CUCERDEA",33,116395,0,3,809,456,414,42,451,5,890,434,245,206,
28,"MURES",261,116395,,262,0,"SCOALA GENERALA SEULIA DE MURES","CUCERDEA",33,116395,0,3,674,456,380,76,451,5,740,284,145,306,
28,"MURES",261,116439,,263,0,"SEDIUL PRIMARIEI CUCI","CUCI",34,116439,0,3,908,625,536,89,615,10,1000,375,345,270,
28,"MURES",261,116439,,264,0,"CAMINUL CULTURAL PETRILACA","CUCI",34,116439,0,3,532,348,312,36,347,1,580,232,167,180,
28,"MURES",261,116439,,265,0,"SCOALA GENERALA DATASENI","CUCI",34,116439,0,3,357,260,217,43,254,6,390,130,93,161,
28,"MURES",261,116493,,266,0,"CAMINUL CULTURAL DANES","DANES",35,116493,0,3,1737,925,812,113,918,7,1910,985,461,457,
28,"MURES",261,116493,,267,0,"SCOALA GENERALA SELEUS","DANES",35,116493,0,3,1247,577,487,90,560,17,1370,793,314,246,
28,"MURES",261,116493,,268,0,"SCOALA GENERALA CRIS","DANES",35,116493,0,3,477,206,168,38,197,9,520,314,94,103,
28,"MURES",261,116493,,269,0,"SCOALA GENERALA STEJARENII","DANES",35,116493,0,3,208,120,77,43,119,1,230,110,77,42,
28,"MURES",261,116545,,270,0,"CAMINUL CULTURAL DEDA","DEDA",36,116545,0,3,1435,1079,975,104,1074,5,1580,501,534,540,
28,"MURES",261,116545,,271,0,"CAMINUL CULTURAL BISTRA MURESULUI","DEDA",36,116545,0,3,822,627,564,63,624,3,890,263,224,400,
28,"MURES",261,116545,,272,0,"SCOALA GENERALA FILEA","DEDA",36,116545,0,3,598,446,395,51,441,5,650,204,160,281,
28,"MURES",261,116545,,273,0,"CAMINUL CULTURAL PIETRIS","DEDA",36,116545,0,3,432,278,248,30,275,3,470,192,108,167,
28,"MURES",261,116590,,274,0,"SCOALA GENERALA EREMITU","EREMITU",37,116590,0,3,1341,846,760,86,783,63,1480,634,764,19,
28,"MURES",261,116590,,275,0,"SCOALA GENERALA CALUGARENI","EREMITU",37,116590,0,3,413,188,162,26,187,1,450,262,180,7,
28,"MURES",261,116590,,276,0,"SCOALA GENERALA CAMPUL CETATII","EREMITU",37,116590,0,3,343,268,231,37,264,4,380,112,257,7,
28,"MURES",261,116590,,277,0,"SCOALA GENERALA DAMIENI","EREMITU",37,116590,0,3,204,114,95,19,106,8,220,106,94,12,
28,"MURES",261,116590,,278,0,"SCOALA GENERALA MATRICI","EREMITU",37,116590,0,3,566,344,287,57,339,5,620,276,326,13,
28,"MURES",261,116652,,279,0,"CAMINUL CULTURAL ERNEI","ERNEI",38,116652,0,3,1504,699,643,56,686,13,1650,951,647,39,
28,"MURES",261,116652,,280,0,"CLUBUL CALUSERI","ERNEI",38,116652,0,3,469,356,294,62,347,9,510,154,330,17,
28,"MURES",261,116652,,281,0,"CAMINUL CULTURAL DUMBRAVIOARA","ERNEI",38,116652,0,3,1175,594,519,75,568,26,1286,692,536,32,
28,"MURES",261,116652,,282,0,"SCOALA GENERALA ICLAND","ERNEI",38,116652,0,3,426,203,136,67,196,7,474,271,183,13,
28,"MURES",261,116652,,283,0,"SCOALA GENERALA SANGERU DE PADURE","ERNEI",38,116652,0,3,222,169,120,49,165,4,250,81,97,68,
28,"MURES",261,116723,,284,0,"SEDIUL PRIMARIEI FARAGAU","FARAGAU",40,116723,0,3,513,333,303,30,324,9,570,237,122,202,
28,"MURES",261,116723,,285,0,"SEDIUL FOSTULUI CAP POARTA","FARAGAU",40,116723,0,3,253,141,117,24,133,8,280,139,48,85,
28,"MURES",261,116723,,286,0,"SEDIUL FOSTULUI CAP TONCIU","FARAGAU",40,116723,0,3,551,365,322,43,355,10,600,235,249,106,
28,"MURES",261,116796,,287,0,"SCOALA GENERALA FANTANELE","FANTANELE",39,116796,0,3,1017,435,416,19,428,7,1120,685,413,15,
28,"MURES",261,116796,,288,0,"SCOALA GENERALA FANTANELE","FANTANELE",39,116796,0,3,1045,499,476,23,489,10,1150,651,479,10,
28,"MURES",261,116796,,289,0,"SCOALA GENERALA BORDOSIU","FANTANELE",39,116796,0,3,401,201,177,24,196,5,440,239,188,8,
28,"MURES",261,116796,,290,0,"SCOALA GENERALA CALIMANESTI","FANTANELE",39,116796,0,3,704,502,456,46,489,13,770,268,473,16,
28,"MURES",261,116796,,291,0,"SCOALA PRIMARA ROUA","FANTANELE",39,116796,0,3,332,230,200,30,225,5,270,40,204,21,
28,"MURES",261,116796,,292,0,"CAMINUL CULTURAL VIFOROASA","FANTANELE",39,116796,0,3,707,445,406,39,430,15,770,325,405,25,
28,"MURES",261,116867,,293,0,"CAMINUL CULTURAL GALESTI","GALESTI",41,116867,0,3,1035,471,433,38,446,25,1130,659,428,18,
28,"MURES",261,116867,,294,0,"CAMINUL CULTURAL TROITA","GALESTI",41,116867,0,3,842,548,497,51,530,18,920,372,517,13,
28,"MURES",261,116867,,295,0,"CAMINUL CULTURAL MAIAD","GALESTI",41,116867,0,3,274,172,142,30,160,12,300,128,151,9,
28,"MURES",261,116867,,296,0,"CAMINUL CULTURAL ADRIANU MARE","GALESTI",41,116867,0,3,170,132,107,25,123,9,190,58,122,1,
28,"MURES",261,116938,,297,0,"SCOALA GENERALA GANESTI","GANESTI",42,116938,0,3,1241,707,613,94,681,26,1360,653,562,119,
28,"MURES",261,116938,,298,0,"CAMINUL CULTURAL GANESTI","GANESTI",42,116938,0,3,639,370,278,92,362,8,700,330,261,101,
28,"MURES",261,116938,,299,0,"SCOALA GENERALA SEUCA","GANESTI",42,116938,0,3,970,606,444,162,594,12,1070,464,465,129,
28,"MURES",261,116938,,300,0,"SCOALA GENERALA CUSTELNIC","GANESTI",42,116938,0,3,459,313,255,58,310,3,500,187,155,155,
28,"MURES",261,116983,,301,0,"CAMINUL CULTURAL GHORGHE DOJA","GHEORGHE DOJA",43,116983,0,3,1545,827,747,80,817,10,1700,873,790,27,
28,"MURES",261,116983,,302,0,"SCOALA GENERALA TIRIMIA","GHEORGHE DOJA",43,116983,0,3,598,385,334,51,375,10,650,265,176,199,
28,"MURES",261,117042,,303,0,"CAMINUL CULTURAL GHINDARI","GHINDARI",44,117042,0,3,1249,831,760,71,823,8,1380,549,815,8,
28,"MURES",261,117042,,304,0,"SCOALA ELEMENTARA ABUD","GHINDARI",44,117042,0,3,166,127,113,14,124,3,180,53,122,2,
28,"MURES",261,117042,,305,0,"CLADIREA FOSTEI PRIMARII CHIBED, NR.452","GHINDARI",44,117042,0,3,1473,942,884,58,915,27,1620,678,912,3,
28,"MURES",261,117042,,306,0,"SCOALA ELEMENTARA SOLOCMA","GHINDARI",44,117042,0,3,350,289,249,40,289,0,390,101,286,3,
28,"MURES",261,117042,,307,0,"IMOBILUL CU CONSTRUCTII DIN TREI SATE, NR.244","GHINDARI",44,117042,0,3,997,768,688,80,762,6,1100,332,754,8,
28,"MURES",261,117113,,308,0,"SCOALA GENERALA GLODENI","GLODENI",45,117113,0,3,1726,632,580,52,617,15,1900,1268,583,34,
28,"MURES",261,117113,,309,0,"SCOALA GENERALA MERISOR","GLODENI",45,117113,0,3,199,175,154,21,173,2,220,45,39,134,
28,"MURES",261,117113,,310,0,"SCOALA GENERALA MOISA","GLODENI",45,117113,0,3,297,226,194,32,222,4,320,94,38,184,
28,"MURES",261,117113,,311,0,"SCOALA GENERALA PACURENI","GLODENI",45,117113,0,3,215,145,127,18,143,2,240,95,135,8,
28,"MURES",261,117113,,312,0,"SCOALA GENERALA PAINGENI","GLODENI",45,117113,0,3,380,212,190,22,203,9,420,208,184,19,
28,"MURES",261,117177,,313,0,"SCOALA GENERALA GORNESTI","GORNESTI",46,117177,0,3,1546,802,723,79,788,14,1950,1148,629,159,
28,"MURES",261,117177,,314,0,"CAMINUL CULTURAL ILIOARA","GORNESTI",46,117177,0,3,102,76,54,22,75,1,110,34,75,0,
28,"MURES",261,117177,,315,0,"SCOALA GENERALA IARA DE MURES","GORNESTI",46,117177,0,3,303,175,134,41,167,8,330,155,147,20,
28,"MURES",261,117177,,316,0,"CAMINUL CULTURAL PADURENI","GORNESTI",46,117177,0,3,363,246,216,30,234,12,400,154,231,3,
28,"MURES",261,117177,,317,0,"CAMINUL CULTURAL PERIS","GORNESTI",46,117177,0,3,1423,830,748,82,819,11,1560,730,796,23,
28,"MURES",261,117177,,318,0,"CAMINUL CULTURAL PETRILACA","GORNESTI",46,117177,0,3,416,292,267,25,287,5,460,168,270,17,
28,"MURES",261,117177,,319,0,"SCOALA GENERALA TELEAC","GORNESTI",46,117177,0,3,460,404,340,64,396,8,510,106,251,145,
28,"MURES",261,117275,,320,0,"CAMINUL CULTURAL GREBENISU DE CIMPIE","GREBENISU DE CAMPIE",47,117275,0,3,1241,707,648,59,703,4,1364,657,386,317,
28,"MURES",261,117319,,321,0,"CAMINUL CULTURAL CLUB GURGHIU","GURGHIU",48,117319,0,3,1405,769,688,81,760,9,1540,771,379,381,
28,"MURES",261,117319,,322,0,"SCOALA GENERALA ADRIAN","GURGHIU",48,117319,0,3,245,165,147,18,162,3,270,105,63,99,
28,"MURES",261,117319,,323,0,"SCOALA GENERALA CASVA","GURGHIU",48,117319,0,3,694,474,398,76,469,5,760,286,132,337,
28,"MURES",261,117319,,324,0,"SCOALA GENERALA COMORI","GURGHIU",48,117319,0,3,217,178,168,10,170,8,240,62,33,137,
28,"MURES",261,117319,,325,0,"CLUBUL GLAJARIE","GURGHIU",48,117319,0,3,1397,773,712,61,756,17,1530,757,665,91,
28,"MURES",261,117319,,326,0,"SCOALA GENERALA LARGA","GURGHIU",48,117319,0,3,185,142,119,23,140,2,200,58,87,53,
28,"MURES",261,117319,,327,0,"CLUBUL ORSOVA","GURGHIU",48,117319,0,3,784,598,566,32,589,9,870,272,134,455,
28,"MURES",261,117426,,328,0,"CAMINUL CULTURAL HODAC","HODAC",49,117426,0,3,1933,1177,1087,90,1166,11,2130,953,594,572,
28,"MURES",261,117426,,329,0,"CAMINUL CULTURAL TOACA","HODAC",49,117426,0,3,1808,1039,974,65,1028,11,1990,951,272,756,
28,"MURES",261,117505,,330,0,"SCOALA GENERALA HODOSA, NR.136","HODOSA",50,117505,0,3,187,139,130,9,137,2,200,61,135,2,
28,"MURES",261,117505,,331,0,"SCOALA GENERALA IHOD, NR.1444","HODOSA",50,117505,0,3,94,94,71,23,93,1,110,16,87,6,
28,"MURES",261,117505,,332,0,"SCOALA GENERALA ISLA, NR.55","HODOSA",50,117505,0,3,258,172,157,15,166,6,279,107,160,6,
28,"MURES",261,117505,,333,0,"SCOALA GENERALA SAMBRIASI, NR.105","HODOSA",50,117505,0,3,634,484,450,34,477,7,700,216,474,3,
28,"MURES",261,117550,,334,0,"CAMINUL CULTURAL IBANESTI-SAT, NR. 606A","IBANESTI",51,117550,0,3,1353,957,860,97,951,6,1490,533,371,580,
28,"MURES",261,117550,,335,0,"DISPENSARUL VETERINAR IBANESTI, NR.467","IBANESTI",51,117550,0,3,463,407,294,113,400,7,510,103,113,287,
28,"MURES",261,117550,,336,0,"CAMINUL CULTURAL IBANESTI PADURE, NR.13","IBANESTI",51,117550,0,3,854,562,513,49,556,6,940,378,102,454,
28,"MURES",261,117550,,337,0,"GRADINITA DULCEA","IBANESTI",51,117550,0,3,859,668,598,70,665,3,940,272,80,585,
28,"MURES",261,117667,,338,0,"SCOALA GENERALA ICLANZEL","ICLANZEL",52,117667,0,3,1155,748,675,73,741,7,1270,522,424,317,
28,"MURES",261,117667,,339,0,"CAMINUL CULTURAL CAPUSU DE CIMPIE","ICLANZEL",52,117667,0,3,579,379,303,76,374,5,640,261,215,159,
28,"MURES",261,117783,,340,0,"CAMINUL CULTURAL IDECIU DE JOS","IDECIU DE JOS",53,117783,0,3,714,491,362,129,486,5,781,290,261,225,
28,"MURES",261,117783,,341,0,"SCOALA GENERALA IDECIU DE JOS","IDECIU DE JOS",53,117783,0,3,537,350,302,48,349,1,590,240,144,205,
28,"MURES",261,117783,,342,0,"SCOALA GENERALA DELENI","IDECIU DE JOS",53,117783,0,3,293,236,225,11,236,0,320,84,59,177,
28,"MURES",261,117925,,343,0,"CAMINUL CULTURAL LIVEZENI, NR.76","LIVEZENI",54,117925,0,3,1037,509,450,59,499,10,1140,631,446,53,
28,"MURES",261,117925,,344,0,"CAMINUL CULTURAL CORUNCA, NR.83","LIVEZENI",54,117925,0,3,1318,692,628,64,670,22,1450,758,630,40,
28,"MURES",261,117925,,345,0,"CAMINUL CULTURAL IVANESTI, NR.42","LIVEZENI",54,117925,0,3,410,177,148,29,169,8,450,273,139,30,
28,"MURES",261,117998,,346,0,"SEDIUL PRIMARIEI LUNCA, NR.228","LUNCA",55,117998,0,3,538,453,418,35,449,4,590,137,277,172,
28,"MURES",261,117998,,347,0,"SCOALA GENERALA BAITA, NR.98","LUNCA",55,117998,0,3,733,612,595,17,606,6,800,188,301,305,
28,"MURES",261,117998,,348,0,"SCOALA GENERALA FRUNZENI, NR.158","LUNCA",55,117998,0,3,390,302,283,19,289,13,430,128,156,133,
28,"MURES",261,117998,,349,0,"SEDIUL SOCIETATII AGRICOLE LOGIGANA LOGIG, NR.199","LUNCA",55,117998,0,3,411,358,338,20,353,5,450,92,219,134,
28,"MURES",261,117998,,350,0,"SCOALA GENERALA SANTU, NR.41","LUNCA",55,117998,0,3,343,303,275,28,299,4,380,77,139,160,
28,"MURES",261,118058,,351,0,"CAMINUL CULTURAL LUNCA BRADULUI, NR.187","LUNCA BRADULUI",56,118058,0,3,1383,870,751,119,853,17,1530,660,298,555,
28,"MURES",261,118058,,352,0,"SCOALA GENERALA NEAGRA, NR.513","LUNCA BRADULUI",56,118058,0,3,376,307,266,41,303,4,410,103,98,205,
28,"MURES",261,118094,,353,0,"CAMINUL CULTURAL MAGHERANI","MAGHERANI",57,118094,0,3,775,469,428,41,453,16,850,381,442,11,
28,"MURES",261,118094,,354,0,"CAMINUL CULTURAL BERENI","MAGHERANI",57,118094,0,3,397,350,317,33,342,8,440,90,334,8,
28,"MURES",261,118094,,355,0,"CAMINUL CULTURAL EREMIENI","MAGHERANI",57,118094,0,3,187,165,129,36,162,3,210,45,161,1,
28,"MURES",261,118094,,356,0,"CAMINUL CULTURAL MARCULENI","MAGHERANI",57,118094,0,3,497,357,318,39,355,2,550,193,351,4,
28,"MURES",261,118094,,357,0,"SCOALA GENERALA SILEA NIRAJULUI","MAGHERANI",57,118094,0,3,458,315,285,30,311,4,500,185,307,4,
28,"MURES",261,118209,,358,0,"CAMINUL CULTURAL MICA","MICA",58,118209,0,3,902,403,344,59,390,13,1000,597,298,92,
28,"MURES",261,118209,,359,0,"CAMINUL CULTURAL DEAJ","MICA",58,118209,0,3,1098,636,589,47,607,29,1210,574,462,145,
28,"MURES",261,118209,,360,0,"CAMINUL CULTURAL HARANGLAB","MICA",58,118209,0,3,635,397,348,49,387,10,700,303,303,84,
28,"MURES",261,118209,,361,0,"CAMINUL CULTURAL CEUAS","MICA",58,118209,0,3,645,432,401,31,413,19,710,278,393,20,
28,"MURES",261,118209,,362,0,"CAMINUL CULTURAL SOMOSTELNIC","MICA",58,118209,0,3,228,177,146,31,176,1,250,73,62,114,
28,"MURES",261,118281,,363,0,"SCOALA GENERALA MIERCUREA NIRAJULUI","MIERCUREA NIRAJULUI",59,118281,0,3,1942,733,653,80,720,13,2140,1407,678,42,
28,"MURES",261,118281,,364,0,"CAMINUL CULTURAL MIERCUREA NIRAJULUI","MIERCUREA NIRAJULUI",59,118281,0,3,1470,778,610,168,758,20,1620,842,722,36,
28,"MURES",261,118281,,365,0,"SCOALA GENERALA SARDU-NIRAJULUI","MIERCUREA NIRAJULUI",59,118281,0,3,837,332,268,64,324,8,920,588,269,55,
28,"MURES",261,118281,,366,0,"CAMINUL CULTURAL MOSUNI","MIERCUREA NIRAJULUI",59,118281,0,3,385,213,173,40,209,4,420,207,109,100,
28,"MURES",261,118370,,367,0,"CAMINUL CULTURAL MIHESU DE CIMPIE","MIHESU DE CAMPIE",60,118370,0,3,1239,674,602,72,667,7,1360,686,395,272,
28,"MURES",261,118370,,368,0,"CAMINUL CULTURAL RAZOARE","MIHESU DE CAMPIE",60,118370,0,3,733,386,319,67,377,9,800,414,210,167,
28,"MURES",261,118469,,369,0,"SCOALA GENERALA NADES","NADES",61,118469,0,3,1038,544,461,83,536,8,1140,596,362,174,
28,"MURES",261,118469,,370,0,"SCOALA GENERALA TIGMANDRU","NADES",61,118469,0,3,607,380,307,73,371,9,660,280,221,150,
28,"MURES",261,118469,,371,0,"SCOALA GENERALA MAGHERUS","NADES",61,118469,0,3,144,93,75,18,93,0,159,66,44,49,
28,"MURES",261,118511,,372,0,"SCOALA GENERALA NEAUA","NEAUA",62,118511,0,3,955,547,507,40,540,7,1050,503,536,4,
28,"MURES",261,118511,,373,0,"SCOALA GENERALA GHINESTI","NEAUA",62,118511,0,3,314,197,181,16,192,5,350,153,187,5,
28,"MURES",261,118575,,374,0,"CAMINUL CULTURAL OGRA","OGRA",63,118575,0,3,1091,756,670,86,738,18,1200,444,549,189,
28,"MURES",261,118575,,375,0,"SCOALA GENERALA DILEUL VECHI","OGRA",63,118575,0,3,208,172,133,39,167,5,220,48,100,67,
28,"MURES",261,118575,,376,0,"SCOALA GENERALA GIULUS","OGRA",63,118575,0,3,177,122,88,34,118,4,190,68,55,63,
28,"MURES",261,118575,,377,0,"CAMINUL CULTURAL LASCUD","OGRA",63,118575,0,3,180,155,113,42,154,1,200,45,88,66,
28,"MURES",261,118575,,378,0,"CAMINUL CULTURAL VAIDEIU","OGRA",63,118575,0,3,136,104,80,24,103,1,150,46,47,56,
28,"MURES",261,118637,,379,0,"CAMINUL CULTURAL PAPIU ILARIAN, STR.PRINCIPALA, NR.2","PAPIU ILARIAN",65,118637,0,3,828,376,354,22,373,3,910,534,235,138,
28,"MURES",261,118691,,380,0,"CAMINUL CULTURAL PANET","PANET",64,118691,0,3,1836,952,887,65,932,20,2020,1068,897,35,
28,"MURES",261,118691,,381,0,"SCOALA GENERALA BERGHIA","PANET",64,118691,0,3,929,631,562,69,617,14,1020,389,466,151,
28,"MURES",261,118691,,382,0,"SCOALA GENERALA CUIESD","PANET",64,118691,0,3,554,325,300,25,316,9,610,285,305,11,
28,"MURES",261,118691,,383,0,"SCOALA GENERALA HARTAU","PANET",64,118691,0,3,258,117,97,20,115,2,280,163,89,26,
28,"MURES",261,118691,,384,0,"SCOALA GENERALA SINTIOANA","PANET",64,118691,0,3,1052,716,675,41,706,10,1150,434,653,53,
28,"MURES",261,118753,,385,0,"SCOALA GENERALA PASARENI","PASARENI",66,118753,0,3,945,579,536,43,571,8,1040,461,528,43,
28,"MURES",261,118753,,386,0,"CAMIN CULTURAL GALATENI","PASARENI",66,118753,0,3,656,485,442,43,480,5,720,235,479,1,
28,"MURES",261,118799,,387,0,"SEDIUL PRIMARIEI PETELEA, NR.726","PETELEA",67,118799,0,3,1730,980,890,90,961,19,1890,910,523,438,
28,"MURES",261,118799,,388,0,"SCOALA GENERALA HABIC, NR.84","PETELEA",67,118799,0,3,276,184,157,27,178,6,300,116,50,128,
28,"MURES",261,118824,,389,0,"SALA DE SEDINTE A CONSILIULUI LOCAL POGACEAUA","POGACEAUA",68,118824,0,3,1054,666,553,113,651,15,1160,494,292,359,
28,"MURES",261,118824,,390,0,"CAMINUL CULTURAL VALENI","POGACEAUA",68,118824,0,3,449,289,212,77,285,4,500,211,145,140,
28,"MURES",261,118931,,391,0,"CAMINUL CULTURAL RASTOLITA","RASTOLITA",69,118931,0,3,1314,997,777,220,989,8,1450,453,391,598,
28,"MURES",261,118995,,392,0,"SCOALA GENERALA RACIU","RICIU",70,118995,0,3,1336,865,786,79,856,9,1480,615,470,386,
28,"MURES",261,118995,,393,0,"CAMINUL CULTURAL SANMARTINU DE CIMPIE","RICIU",70,118995,0,3,746,523,434,89,515,8,820,297,235,280,
28,"MURES",261,118995,,394,0,"SCOALA GENERALA ULIES","RICIU",70,118995,0,3,702,400,351,49,395,5,770,370,197,198,
28,"MURES",261,118995,,395,0,"CAMINUL CULTURAL NIMA RACIULUI","RICIU",70,118995,0,3,202,142,118,24,138,4,220,78,41,97,
28,"MURES",261,119153,,396,0,"SEDIUL PRIMARIEI RUSII MUNTI","RUSII-MUNTI",71,119153,0,3,1769,1172,1094,78,1166,6,1950,778,595,571,
28,"MURES",261,119206,,397,0,"CAMINUL CULTURAL SASCHIZ","SASCHIZ",80,119206,0,3,1195,587,499,88,570,17,1320,733,315,255,
28,"MURES",261,119206,,398,0,"CAMINUL CULTURAL M. VITEAZUL","SASCHIZ",80,119206,0,3,230,162,120,42,156,6,250,88,101,55,
28,"MURES",261,119206,,399,0,"SCOALA PRIMARA CLOASTERF","SASCHIZ",80,119206,0,3,136,104,64,40,101,3,150,46,70,31,
28,"MURES",261,119242,,400,0,"CAMINUL CULTURAL SARMASU, STR. REPUBLICII, NR.94","SARMASU",79,119242,0,3,1940,843,752,91,831,12,2100,1257,551,280,
28,"MURES",261,119242,,401,0,"GRADINITA SARMASU, STR.SONDELOR, NR.38","SARMASU",79,119242,0,3,1267,525,478,47,515,10,1400,875,365,150,
28,"MURES",261,119242,,402,0,"CAMINUL CULTURAL BALDA, STR. DEZROBIRII, NR.24","SARMASU",79,119242,0,3,914,501,438,63,492,9,1010,509,210,282,
28,"MURES",261,119242,,403,0,"CAMINUL CULTURAL SARMASELU, STR. 1 MAI, NR.1","SARMASU",79,119242,0,3,628,357,313,44,354,3,685,328,159,195,
28,"MURES",261,119242,,404,0,"GRADINITA SARMASEL GARA, STR. REPUBLICII, NR.2","SARMASU",79,119242,0,3,583,363,292,71,359,4,640,277,163,196,
28,"MURES",261,119242,,405,0,"CAMINUL CULTURAL VISINELU, STR. PLOPILOR, NR.36","SARMASU",79,119242,0,3,501,289,251,38,284,5,650,361,118,166,
28,"MURES",261,114382,,406,0,"CAMINUL CULTURAL SINCRAIU DE MURES","SANCRAIU DE MURES",72,114382,0,3,1883,945,764,181,937,8,2000,1055,597,340,
28,"MURES",261,114382,,407,0,"SCOALA GENERALA SINCRAIU DE MURES","SANCRAIU DE MURES",72,114382,0,3,1651,859,714,145,849,10,1820,961,510,339,
28,"MURES",261,114382,,408,0,"CAMINUL CULTURAL NAZNA","SANCRAIU DE MURES",72,114382,0,3,1431,1046,866,180,1034,12,1640,594,366,668,
28,"MURES",261,114417,,409,0,"SCOALA GENERALA SANGEORGIU DE MURES, STR. TOFALAU, NR.610","SANGEORGIU DE MURES",73,114417,0,3,1976,963,737,226,943,20,2490,1527,776,167,
28,"MURES",261,114417,,410,0,"SCOALA GENERALA SANGEORGIU DE MURES, STR. TOFALAU, NR.610","SANGEORGIU DE MURES",73,114417,0,3,1866,931,834,97,912,19,2050,1119,662,250,
28,"MURES",261,114417,,411,0,"CAMINUL CULTURAL SANGEORGIU DE MURES","SANGEORGIU DE MURES",73,114417,0,3,1418,1029,549,480,1002,27,1940,911,648,354,
28,"MURES",261,114417,,412,0,"SCOALA GENERALA COTUS","SANGEORGIU DE MURES",73,114417,0,3,326,142,104,38,138,4,370,228,122,16,
28,"MURES",261,119331,,413,0,"SCOALA GENERALA SANGEORGIU DE PADURE, STR. SCOLII, NR.10","SANGEORGIU DE PADURE",74,119331,0,3,1270,578,428,150,569,9,1270,692,510,59,
28,"MURES",261,119331,,414,0,"CAMINUL CULTURAL SANGEORGIU DE PADURE, STR. BALCESCU, NR.13","SANGEORGIU DE PADURE",74,119331,0,3,2513,771,691,80,747,24,2760,1989,627,120,
28,"MURES",261,119331,,415,0,"SCOALA GENERALA BEZID, STR. PRINCIPALA","SANGEORGIU DE PADURE",74,119331,0,3,672,268,228,40,260,8,740,472,242,18,
28,"MURES",261,119386,,416,0,"GRADINITA SANGER","SANGER",75,119386,0,3,1211,646,598,48,639,7,1340,694,370,269,
28,"MURES",261,119386,,417,0,"CAMINUL CULTURAL CIPAIENI","SANGER",75,119386,0,3,770,467,415,52,460,7,850,383,310,150,
28,"MURES",261,119466,,418,0,"CLUBUL SANPAUL","SANPAUL",76,119466,0,3,1128,715,613,102,701,14,1380,665,585,116,
28,"MURES",261,119466,,419,0,"GRADINITA CHIRILEU","SANPAUL",76,119466,0,3,616,505,396,109,496,9,670,165,275,221,
28,"MURES",261,119466,,420,0,"CAMINUL CULTURAL VALEA IZVOARELOR","SANPAUL",76,119466,0,3,794,546,476,70,542,4,870,324,422,120,
28,"MURES",261,119527,,421,0,"CAMINUL CULTURAL SANPETRU DE CIMPIE","SANPETRU DE CAMPIE",77,119527,0,3,986,562,484,78,554,8,1090,528,330,224,
28,"MURES",261,119527,,422,0,"CAMINUL CULTURAL DIMBU","SANPETRU DE CAMPIE",77,119527,0,3,723,414,357,57,405,9,790,376,189,216,
28,"MURES",261,119527,,423,0,"SCOALA GENERALA SANGEORGIU DE CIMPIE","SANPETRU DE CAMPIE",77,119527,0,3,352,246,213,33,240,6,390,144,128,112,
28,"MURES",261,119527,,424,0,"MAGAZINUL SATESC TUSINU","SANPETRU DE CAMPIE",77,119527,0,3,576,375,329,46,371,4,630,255,138,233,
28,"MURES",261,114453,,425,0,"SCOALA GENERALA SANTANA DE MURES","SANTANA DE MURES",78,114453,0,3,1609,956,871,85,942,14,1790,834,590,352,
28,"MURES",261,114453,,426,0,"SCOALA GENERALA CURTENI","SANTANA DE MURES",78,114453,0,3,705,398,358,40,383,15,770,372,371,12,
28,"MURES",261,114453,,427,0,"SCOALA GENERALA CHINARI","SANTANA DE MURES",78,114453,0,3,435,326,282,44,314,12,480,154,214,100,
28,"MURES",261,114453,,428,0,"SCOALA GENERALA BARDESTI","SANTANA DE MURES",78,114453,0,3,266,252,203,49,251,1,300,48,88,163,
28,"MURES",261,119590,,429,0,"SCOALA GENERALA SOLOVASTRU","SOLOVASTRU",83,119590,0,3,1265,753,705,48,746,7,1390,637,330,416,
28,"MURES",261,119590,,430,0,"CAMINUL CULTURAL JABENITA","SOLOVASTRU",83,119590,0,3,929,656,584,72,647,9,1020,364,338,309,
28,"MURES",261,119625,,431,0,"CAMINUL CULTURAL STANCENI, STR. PRINCIPALA, NR.38","STANCENI",84,119625,0,3,1216,706,632,74,700,6,1338,632,295,405,
28,"MURES",261,119661,,432,0,"SCOALA GENERALA SUPLAC","SUPLAC",85,119661,0,3,654,482,404,78,474,8,720,238,342,132,
28,"MURES",261,119661,,433,0,"SCOALA GENERALA IDRIFAIA","SUPLAC",85,119661,0,3,542,378,333,45,371,7,600,222,321,50,
28,"MURES",261,119661,,434,0,"SCOALA GENERALA LASLAU MARE","SUPLAC",85,119661,0,3,728,487,402,85,484,3,790,303,263,221,
28,"MURES",261,119723,,435,0,"SEDIUL PRIMARIEI SUSENI","SUSENI",86,119723,0,3,1133,653,591,62,641,12,1250,597,419,222,
28,"MURES",261,119723,,436,0,"CAMINUL CULTURAL LUIERIU","SUSENI",86,119723,0,3,633,560,516,44,557,3,700,140,284,273,
28,"MURES",261,119750,,437,0,"CLUBUL TINERETULUI SAULIA","SAULIA",81,119750,0,3,1579,1111,945,166,1095,16,1730,619,554,541,
28,"MURES",261,119803,,438,0,"SEDIUL PRIMARIEI SINCAI","SINCAI",82,119803,0,3,926,572,511,61,554,18,1100,528,409,145,
28,"MURES",261,119803,,439,0,"SCOALA GENERALA FANATE","SINCAI",82,119803,0,3,251,140,118,22,137,3,280,140,72,65,
28,"MURES",261,119803,,440,0,"SCOALA GENERALA PUSTA","SINCAI",82,119803,0,3,97,105,64,41,105,0,110,5,64,41,
28,"MURES",261,119858,,441,0,"CAMINUL CULTURAL TAURENI, NR.259","TAURENI",87,119858,0,3,871,419,380,39,418,1,960,541,162,256,
28,"MURES",261,119894,,442,0,"SCOALA GENERALA UNGHENI","UNGHENI",88,119894,0,3,1322,683,596,87,671,12,1450,767,264,407,
28,"MURES",261,119894,,443,0,"CAMINUL CULTURAL UNGHENI","UNGHENI",88,119894,0,3,1520,879,737,142,864,15,1680,801,459,405,
28,"MURES",261,119894,,444,0,"CAMINUL CULTURAL MORESTI","UNGHENI",88,119894,0,3,519,404,347,57,394,10,570,166,264,130,
28,"MURES",261,119894,,445,0,"CAMINUL CULTURAL SAUSA","UNGHENI",88,119894,0,3,195,147,114,33,147,0,210,63,48,99,
28,"MURES",261,119894,,446,0,"CAMINUL CULTURAL VIDRASAU","UNGHENI",88,119894,0,3,722,612,489,123,612,0,790,178,369,243,
28,"MURES",261,119894,,447,0,"CAMINUL CULTURAL CERGHIZEL","UNGHENI",88,119894,0,3,340,291,247,44,290,1,370,79,138,152,
28,"MURES",261,119894,,448,0,"CAMINUL CULTURAL CERGHID","UNGHENI",88,119894,0,3,425,288,245,43,286,2,450,162,141,145,
28,"MURES",261,119974,,449,0,"SEDIUL PRIMARIEI VALEA LARGA","VALEA LARGA",89,119974,0,3,2367,720,653,67,716,4,2610,1890,281,435,
28,"MURES",261,119974,,450,0,"SCOALA GENERALA VALEA FRAJII","VALEA LARGA",89,119974,0,3,440,194,147,47,192,2,480,286,63,129,
28,"MURES",261,120076,,451,0,"CAMINUL CULTURAL VARGATA","VARGATA",91,120076,0,3,1208,750,691,59,741,9,1330,580,723,18,
28,"MURES",261,120076,,452,0,"SCOALA GENERALA GRAUSORUL","VARGATA",91,120076,0,3,177,134,110,24,128,6,190,56,127,1,
28,"MURES",261,120076,,453,0,"SCOALA GENERALA VADU","VARGATA",91,120076,0,3,208,173,142,31,169,4,230,57,164,5,
28,"MURES",261,120138,,454,0,"CAMINUL CULTURAL VATAVA","VATAVA",92,120138,0,3,740,517,476,41,510,7,820,303,130,380,
28,"MURES",261,120138,,455,0,"SCOALA GENERALA DUMBRAVA","VATAVA",92,120138,0,3,670,414,390,24,409,5,740,326,137,272,
28,"MURES",261,120138,,456,0,"SCOALA GENERALA RAPA DE JOS","VATAVA",92,120138,0,3,480,325,298,27,319,6,530,205,101,218,
28,"MURES",261,120174,,457,0,"CAMINUL CULTURAL VETCA, NR.53","VETCA",93,120174,0,3,491,285,259,26,281,4,540,255,273,8,
28,"MURES",261,120174,,458,0,"CAMINUL CULTURAL JACODU, NR.189","VETCA",93,120174,0,3,246,174,151,23,166,8,270,96,155,11,
28,"MURES",261,120218,,459,0,"SCOALA GENERALA VIISOARA","VIISOARA",94,120218,0,3,580,226,177,49,225,1,640,414,73,152,
28,"MURES",261,120218,,460,0,"SCOALA GENERALA SANTIOARA","VIISOARA",94,120218,0,3,388,232,190,42,225,7,430,198,96,129,
28,"MURES",261,120218,,461,0,"SCOALA GENERALA ORMENIS","VIISOARA",94,120218,0,3,250,177,128,49,177,0,270,93,116,61,
28,"MURES",261,120254,,462,0,"GRADINITA VANATORI","VANATORI",90,120254,0,3,1154,555,459,96,543,12,1270,715,368,175,
28,"MURES",261,120254,,463,0,"SCOALA CLS. I-IV ARCHITA","VANATORI",90,120254,0,3,486,369,258,111,360,9,530,161,231,129,
28,"MURES",261,120254,,464,0,"SCOALA GENERALA FELEAG","VANATORI",90,120254,0,3,183,178,133,45,175,3,200,22,93,82,
28,"MURES",261,120254,,465,0,"SCOALA CLS. I-IV MURENI","VANATORI",90,120254,0,3,273,198,151,47,192,6,300,102,158,34,
28,"MURES",261,120254,,466,0,"SCOALA CLS. I-IV SOARD","VANATORI",90,120254,0,3,435,264,227,37,261,3,470,206,172,89,
28,"MURES",261,120316,,467,0,"LOC. VOIVODENI, NR.97","VOIVODENI",95,120316,0,3,1331,541,491,50,526,15,1470,929,409,117,
28,"MURES",261,120316,,468,0,"LOC. TOLDAL, NR.96","VOIVODENI",95,120316,0,3,236,170,143,27,163,7,260,90,98,65,
28,"MURES",261,120343,,469,0,"SEDIUL PRIMARIEI ZAGAR, STR. HOREA, NR.266","ZAGAR",96,120343,0,3,875,478,398,80,472,6,960,482,329,143,
28,"MURES",261,120370,,470,0,"CAMINUL CULTURAL ZAU DE CIMPIE","ZAU DE CAMPIE",97,120370,0,3,2173,1119,985,134,1102,17,2410,1291,660,442,
28,"MURES",261,120370,,471,0,"SCOALA GENERALA BARBOSI","ZAU DE CAMPIE",97,120370,0,3,426,283,246,37,282,1,470,187,177,105,
29,"NEAMT",270,120726,,1,0,"PIATA 22 DECEMBRIE, 1 - SCOALA NR.3","MUNICIPIUL PIATRA NEAMT",1,120726,1,1,1297,756,706,50,741,15,1499,743,572,169,
29,"NEAMT",270,120726,,2,0,"PAHARNICULUI, 3 - SC PUBLISERV SRL","MUNICIPIUL PIATRA NEAMT",1,120726,1,1,1236,757,683,74,746,11,1394,637,558,188,
29,"NEAMT",270,120726,,3,0,"CUZA VODA - GRADINITA NR.6","MUNICIPIUL PIATRA NEAMT",1,120726,1,1,1211,722,662,60,712,10,1400,678,544,168,
29,"NEAMT",270,120726,,4,0,"STEFAN CEL MARE, 4 - LICEUL PETRU RARES","MUNICIPIUL PIATRA NEAMT",1,120726,1,1,1594,806,724,82,793,13,1800,994,569,224,
29,"NEAMT",270,120726,,5,0,"MARATEI, 2 - SCOALA NR.2","MUNICIPIUL PIATRA NEAMT",1,120726,1,1,1254,647,604,43,638,9,1400,753,449,189,
29,"NEAMT",270,120726,,6,0,"LT DRAGHESCU, 13 - SUCURSALA HIDROCENTRALE BISTRITA","MUNICIPIUL PIATRA NEAMT",1,120726,1,1,2227,1261,1133,128,1239,22,2500,1239,889,350,
29,"NEAMT",270,120726,,7,0,"PIATA 22 DECEMBRIE, 1 - SCOALA NR.3","MUNICIPIUL PIATRA NEAMT",1,120726,1,1,1385,770,658,112,758,12,1600,830,574,184,
29,"NEAMT",270,120726,,8,0,"LT DRAGHESCU, 20 - SC AQUA CALOR SA","MUNICIPIUL PIATRA NEAMT",1,120726,1,1,1292,708,653,55,703,5,1500,792,498,205,
29,"NEAMT",270,120726,,9,0,"B-DUL REPUBLICII, 17 - COMPLEX EXPOZITIONAL MUNICIPAL","MUNICIPIUL PIATRA NEAMT",1,120726,1,1,1591,931,808,123,918,13,1800,869,684,234,
29,"NEAMT",270,120726,,10,0,"B-DUL DECEBAL, 72 - SCOALA NR.4","MUNICIPIUL PIATRA NEAMT",1,120726,1,1,1678,931,842,89,915,16,1900,969,612,303,
29,"NEAMT",270,120726,,11,0,"ALEXANDRU CEL BUN, 2 - LICEUL DE ARTA","MUNICIPIUL PIATRA NEAMT",1,120726,1,1,1394,603,563,40,597,6,1600,997,412,185,
29,"NEAMT",270,120726,,12,0,"ECOULUI, 1 - SCOALA NR.10","MUNICIPIUL PIATRA NEAMT",1,120726,1,1,1940,997,907,90,989,8,2200,1203,677,312,
29,"NEAMT",270,120726,,13,0,"ECOULUI, 1 - SCOALA NR.10","MUNICIPIUL PIATRA NEAMT",1,120726,1,1,1702,1002,848,154,992,10,1900,898,664,328,
29,"NEAMT",270,120726,,14,0,"ARCULUI, 8 - SCOALA DE SOFERI","MUNICIPIUL PIATRA NEAMT",1,120726,1,1,1512,716,676,40,706,10,1700,984,430,276,
29,"NEAMT",270,120726,,15,0,"B-DUL DECEBAL, 73 - SC MOLDOCOR SA","MUNICIPIUL PIATRA NEAMT",1,120726,1,1,2322,1127,1078,49,1116,11,2600,1473,772,344,
29,"NEAMT",270,120726,,16,0,"B-DUL DECEBAL, 171 - SC PETROCART SA","MUNICIPIUL PIATRA NEAMT",1,120726,1,1,1755,978,906,72,967,11,2000,1022,629,338,
29,"NEAMT",270,120726,,17,0,"PETRU MOVILA, 67 - SCOALA NR.19","MUNICIPIUL PIATRA NEAMT",1,120726,1,1,1253,818,725,93,807,11,1400,582,545,262,
29,"NEAMT",270,120726,,18,0,"B-DUL DECEBAL, 72 - SCOALA NR.4","MUNICIPIUL PIATRA NEAMT",1,120726,1,1,1309,798,712,86,784,14,1500,702,578,206,
29,"NEAMT",270,120726,,19,0,"SOARELUI, 1 - LICEUL AUTO","MUNICIPIUL PIATRA NEAMT",1,120726,1,1,950,517,462,55,506,11,1100,583,353,153,
29,"NEAMT",270,120726,,20,0,"EROILOR, 18 - CLUBUL SPORTIV VOINTA","MUNICIPIUL PIATRA NEAMT",1,120726,1,1,1810,973,876,97,945,27,1996,1024,619,326,
29,"NEAMT",270,120726,,21,0,"AL LAPUSNEANU, 16 - CRUP SCOLAR ECONOMIC","MUNICIPIUL PIATRA NEAMT",1,120726,1,1,1654,878,829,49,865,13,1900,1022,584,281,
29,"NEAMT",270,120726,,22,0,"STEFAN CEL MARE, 67 - LICEUL FORESTIER","MUNICIPIUL PIATRA NEAMT",1,120726,1,1,1355,1030,779,251,1004,26,1500,470,680,324,
29,"NEAMT",270,120726,,23,0,"ALEXANDRU CEL BUN, 19 - LICEUL CALISTRAT HOGAS","MUNICIPIUL PIATRA NEAMT",1,120726,1,1,1063,642,573,69,625,17,1200,558,448,177,
29,"NEAMT",270,120726,,24,0,"PETRU RARES, 30 - SCOALA NR.12","MUNICIPIUL PIATRA NEAMT",1,120726,1,1,1591,850,782,68,843,7,1800,950,599,244,
29,"NEAMT",270,120726,,25,0,"PETRU RARES, 30 - SCOALA NR.12","MUNICIPIUL PIATRA NEAMT",1,120726,1,1,1383,756,722,34,747,9,1596,840,461,286,
29,"NEAMT",270,120726,,26,0,"B-DUL DACIA, 14 - GRADINITA CU PROGRAM PRELUNGIT NR.3","MUNICIPIUL PIATRA NEAMT",1,120726,1,1,1388,751,699,52,742,9,1604,853,500,242,
29,"NEAMT",270,120726,,27,0,"OBOR, 2 - LICEUL CU PROGRAM SPORTIV","MUNICIPIUL PIATRA NEAMT",1,120726,1,1,1338,757,693,64,749,8,1500,743,516,233,
29,"NEAMT",270,120726,,28,0,"OBOR, 2 - LICEUL CU PROGRAM SPORTIV","MUNICIPIUL PIATRA NEAMT",1,120726,1,1,1513,792,755,37,772,20,1700,908,540,232,
29,"NEAMT",270,120726,,29,0,"DARMANESTI, 33 - SCOALA NR.27","MUNICIPIUL PIATRA NEAMT",1,120726,1,1,1917,1019,937,82,1005,14,2200,1181,708,297,
29,"NEAMT",270,120726,,30,0,"DARMANESTI, 42 - GRADINITA NR.5","MUNICIPIUL PIATRA NEAMT",1,120726,1,1,1691,876,814,62,867,9,1900,1024,588,279,
29,"NEAMT",270,120726,,31,0,"DARMANESTI, 41 - GRADINITA NR.8","MUNICIPIUL PIATRA NEAMT",1,120726,1,1,2236,989,875,114,982,7,2500,1511,661,321,
29,"NEAMT",270,120726,,32,0,"CETATEA NEAMTULUI, 34 - SCOALA NR.20","MUNICIPIUL PIATRA NEAMT",1,120726,1,1,1460,815,765,50,803,12,1700,885,523,280,
29,"NEAMT",270,120726,,33,0,"G GALINESCU, 11 - CENTRUL DE PLASAMENT PIETRICICA","MUNICIPIUL PIATRA NEAMT",1,120726,1,1,1346,783,590,193,772,10,1500,717,482,290,
29,"NEAMT",270,120726,,34,0,"G GALINESCU, 13 - SCOALA NR.28","MUNICIPIUL PIATRA NEAMT",1,120726,1,1,1569,778,735,43,768,10,1796,1018,500,268,
29,"NEAMT",270,120726,,35,0,"AUDIA, 2 - LICEUL GHEORGHE ASACHI","MUNICIPIUL PIATRA NEAMT",1,120726,1,1,1937,908,834,74,901,7,2200,1292,557,344,
29,"NEAMT",270,120726,,36,0,"1 DECEMBRIE 1918, 32 - SCOALA NR.5","MUNICIPIUL PIATRA NEAMT",1,120726,1,1,2091,947,866,81,934,13,2325,1378,681,253,
29,"NEAMT",270,120726,,37,0,"1 DECEMBRIE 1918, 32 - SCOALA NR.5                                                                                             1","MUNICIPIUL PIATRA NEAMT",1,120726,1,1,955,610,369,241,605,5,1100,490,431,174,
29,"NEAMT",270,120726,,38,0,"ALEEA GAROFITEI, 13 - DISPENSARUL COMASAT","MUNICIPIUL PIATRA NEAMT",1,120726,1,1,1570,918,821,97,902,16,1800,882,604,298,
29,"NEAMT",270,120726,,39,0,"ALEEA ULMILOR, 9 - GRADINITA NR.12","MUNICIPIUL PIATRA NEAMT",1,120726,1,1,1514,748,690,58,737,11,1682,934,516,221,
29,"NEAMT",270,120726,,40,0,"ALEEA ULMILOR, 9 - GRADINITA NR.12","MUNICIPIUL PIATRA NEAMT",1,120726,1,1,1516,800,721,79,787,13,1700,900,511,276,
29,"NEAMT",270,120726,,41,0,"DARMANESTI, 33 - SCOALA NR.33","MUNICIPIUL PIATRA NEAMT",1,120726,1,1,1860,952,841,111,944,8,2100,1148,649,295,
29,"NEAMT",270,120726,,42,0,"MIHAI VITEAZU, 32 - OFICIUL DE REPRODUCERE SI SELECTIE A ANIMALELOR","MUNICIPIUL PIATRA NEAMT",1,120726,1,1,2164,1107,990,117,1086,21,2400,1293,711,375,
29,"NEAMT",270,120726,,43,0,"NUFARULUI, 10 - CAMINUL DE PENSIONARI","MUNICIPIUL PIATRA NEAMT",1,120726,1,1,942,524,421,103,515,9,1100,576,357,158,
29,"NEAMT",270,120726,,44,0,"MIHAI VITEAZU, 34 - DISPENSARUL SANITAR VETERINAR","MUNICIPIUL PIATRA NEAMT",1,120726,1,1,1530,861,804,57,850,11,1700,839,548,302,
29,"NEAMT",270,120726,,45,0,"MIHAI VITEAZU, 12 - LICEUL DE INFORMATICA","MUNICIPIUL PIATRA NEAMT",1,120726,1,1,1967,1014,925,89,999,15,2200,1186,682,317,
29,"NEAMT",270,120726,,46,0,"MIHAI VITEAZU, 12 - LICEUL DE INFORMATICA","MUNICIPIUL PIATRA NEAMT",1,120726,1,1,1978,922,846,76,906,16,2204,1282,580,326,
29,"NEAMT",270,120726,,47,0,"MARATEI, 4 SCOALA NR.2","MUNICIPIUL PIATRA NEAMT",1,120726,1,1,1675,897,821,76,888,9,1900,1003,644,244,
29,"NEAMT",270,120726,,48,0,"MARATEI, 6 SCOALA NR.2","MUNICIPIUL PIATRA NEAMT",1,120726,1,1,2011,1005,956,49,995,10,2300,1295,666,329,
29,"NEAMT",270,120726,,49,0,"B-DUL TRAIAN, 8 - SC ASIROM SA","MUNICIPIUL PIATRA NEAMT",1,120726,1,1,1549,957,830,127,938,19,1700,743,678,260,
29,"NEAMT",270,120726,,50,0,"PRIVIGHETORII, 10, B8 - SINDICATUL PENSIONARILOR","MUNICIPIUL PIATRA NEAMT",1,120726,1,1,1530,813,766,47,804,9,1701,888,609,195,
29,"NEAMT",270,120726,,51,0,"B-DUL TRAIAN, 31 - LICEUL GHEORGHE CARTIANU","MUNICIPIUL PIATRA NEAMT",1,120726,1,1,1686,911,784,127,901,10,1900,989,605,296,
29,"NEAMT",270,120726,,52,0,"G-RAL N DASCALESCU, 4 - SCOALA NR.1","MUNICIPIUL PIATRA NEAMT",1,120726,1,1,1467,819,761,58,811,8,1699,880,519,292,
29,"NEAMT",270,120726,,53,0,"B-DUL MARASESTI, 13 - SCOALA NR.9","MUNICIPIUL PIATRA NEAMT",1,120726,1,1,1870,1107,992,115,1083,24,2100,993,791,292,
29,"NEAMT",270,120726,,54,0,"G-RAL DASCALESCU, 426 - SCOALA PRODESIONALA NR.1","MUNICIPIUL PIATRA NEAMT",1,120726,1,1,2091,1224,1128,96,1161,18,2300,1121,790,371,
29,"NEAMT",270,120726,,55,0,"B-DUL TRAIAN, 31 - LICEUL GHEORGHE CARTIANU","MUNICIPIUL PIATRA NEAMT",1,120726,1,1,2064,988,925,63,973,15,2294,1306,647,326,
29,"NEAMT",270,120726,,56,0,"D. LEONIDA, 115 - SC PUBLISERV SRL","MUNICIPIUL PIATRA NEAMT",1,120726,1,1,1824,967,830,137,959,8,2000,1033,606,353,
29,"NEAMT",270,120726,,57,0,"PROGRESULUI, 106C - SCOALA NR. 26","MUNICIPIUL PIATRA NEAMT",1,120726,1,1,1325,741,576,165,733,8,1496,755,419,314,
29,"NEAMT",270,120726,,58,0,"PROGRESULUI, 106A - SCOALA NR. 26","MUNICIPIUL PIATRA NEAMT",1,120726,1,1,1107,544,509,35,539,5,1308,764,337,202,
29,"NEAMT",270,120726,,59,0,"PROGRESULUI, 106 - SCOALA NR. 26","MUNICIPIUL PIATRA NEAMT",1,120726,1,1,2542,1303,1226,77,1294,9,2800,1497,901,393,
29,"NEAMT",270,120726,,60,0,"D LEONIDA, 2 - SC PERGODUR CANTINA","MUNICIPIUL PIATRA NEAMT",1,120726,1,1,1805,890,824,66,879,11,2000,1110,590,289,
29,"NEAMT",270,120726,,61,0,"ALEEA PLAIULUI, 7A - GRADINITA NR.1","MUNICIPIUL PIATRA NEAMT",1,120726,1,1,1385,854,781,73,841,13,1599,745,618,223,
29,"NEAMT",270,120726,,62,0,"PROGRESULUI, 32 - GRADINITA NR.7","MUNICIPIUL PIATRA NEAMT",1,120726,1,1,1916,924,870,54,910,14,2100,1176,633,277,
29,"NEAMT",270,120726,,63,0,"GH ASACHI, 3 - SCOALA NR.7","MUNICIPIUL PIATRA NEAMT",1,120726,1,1,1069,755,625,130,742,13,1200,445,419,323,
29,"NEAMT",270,120726,,64,1,"SPITALUL JUDETEAN","MUNICIPIUL PIATRA NEAMT",1,120726,1,1,0,514,0,514,511,3,596,82,392,119,
29,"NEAMT",270,120860,,65,0,"PIATA ROMAN VODA, 1 - CASA DE CULTURA A SINDICATELOR","MUNICIPIUL ROMAN",2,120860,1,1,1273,690,646,44,676,14,1400,710,491,185,
29,"NEAMT",270,120860,,66,0,"CUZA VODA, 34 - SCOALA NR.5","MUNICIPIUL ROMAN",2,120860,1,1,1993,1073,1024,49,1065,8,2200,1127,705,360,
29,"NEAMT",270,120860,,67,0,"CUZA VODA, 84 - SCOALA NR.3","MUNICIPIUL ROMAN",2,120860,1,1,1101,653,592,61,642,11,1300,647,464,178,
29,"NEAMT",270,120860,,68,0,"DOBROGEANU GHEREA, 39 - CASA CASATORIILOR","MUNICIPIUL ROMAN",2,120860,1,1,1630,1142,946,196,1126,16,1800,658,869,257,
29,"NEAMT",270,120860,,69,0,"1 DECEMBRIE 1918, 4 - GRADINITA SOMACO","MUNICIPIUL ROMAN",2,120860,1,1,1317,837,755,82,809,28,1498,661,590,219,
29,"NEAMT",270,120860,,70,0,"B-DUL REPUBLICII, 34 - INSTITUTUL DE AMENAJARI SILVICE STATIUNEA ROMAN","MUNICIPIUL ROMAN",2,120860,1,1,1412,892,817,75,882,10,1600,708,644,238,
29,"NEAMT",270,120860,,71,0,"MIHAI VITEAZU, 15 - SCOALA NR.8","MUNICIPIUL ROMAN",2,120860,1,1,2183,1214,1134,80,1194,20,2400,1186,776,418,
29,"NEAMT",270,120860,,72,0,"MIHAI VITEAZU, 13 - SC ROMTRANS SA","MUNICIPIUL ROMAN",2,120860,1,1,2432,1331,1161,170,1320,11,2700,1369,810,510,
29,"NEAMT",270,120860,,73,0,"ION NANU, 4 - CENTRUL DE PLASAMENT ROMAN VODA","MUNICIPIUL ROMAN",2,120860,1,1,1860,1101,1019,82,1089,12,2100,999,730,359,
29,"NEAMT",270,120860,,74,0,"PRIMAVERII, 4 - GRADINITA NR.6","MUNICIPIUL ROMAN",2,120860,1,1,1145,683,642,41,671,12,1300,617,473,198,
29,"NEAMT",270,120860,,75,0,"ALBA IULIA, 14 - CLUB CONEL","MUNICIPIUL ROMAN",2,120860,1,1,1410,773,716,57,760,13,1600,827,589,171,
29,"NEAMT",270,120860,,76,0,"MIHAI EMINESCU, 27 - SCOALA NR.11","MUNICIPIUL ROMAN",2,120860,1,1,1464,805,775,30,797,8,1690,885,579,218,
29,"NEAMT",270,120860,,77,0,"MIHAI EMINESCU, 4 - LICEUL ROMAN VODA","MUNICIPIUL ROMAN",2,120860,1,1,1326,766,715,51,757,9,1500,734,532,225,
29,"NEAMT",270,120860,,78,0,"ION CREANGA, 13 - GRADINITA NR.1","MUNICIPIUL ROMAN",2,120860,1,1,1891,967,910,57,948,19,2100,1133,628,320,
29,"NEAMT",270,120860,,79,0,"B-DUL REPUBLICII, 46 - LICEUL INDUSTRIAL NR.2","MUNICIPIUL ROMAN",2,120860,1,1,1263,724,671,53,722,2,1400,676,481,241,
29,"NEAMT",270,120860,,80,0,"BANATULUI, 2 - CIRCUMSCRIPTIA SANITAR VETERINARA","MUNICIPIUL ROMAN",2,120860,1,1,1673,841,811,30,834,7,1897,1056,567,267,
29,"NEAMT",270,120860,,81,0,"SMIRODAVA, 28 - CRESA SMIRODAVA","MUNICIPIUL ROMAN",2,120860,1,1,1688,916,878,38,895,21,1900,984,625,270,
29,"NEAMT",270,120860,,82,0,"BOGDAN DRAGOS, 109 - DISPENSARUL UMAN 3-5","MUNICIPIUL ROMAN",2,120860,1,1,1517,896,822,74,881,15,1705,809,588,293,
29,"NEAMT",270,120860,,83,0,"BOGDAN DRAGOS, 91 - SCOALA NR.7","MUNICIPIUL ROMAN",2,120860,1,1,2188,1274,1208,66,1244,30,2400,1126,866,378,
29,"NEAMT",270,120860,,84,0,"ECATERINA TEODOROIU NR.7 - GRADINATA DE COPII NR.4","MUNICIPIUL ROMAN",2,120860,1,1,1767,1003,964,39,991,12,2000,997,692,299,
29,"NEAMT",270,120860,,85,0,"MIHAI EMINESCU, 5-7, GRADINITA NR.4","MUNICIPIUL ROMAN",2,120860,1,1,2109,1108,1048,60,1092,16,2400,1292,757,335,
29,"NEAMT",270,120860,,86,0,"ECATERINA TEODOROIU, 1A - GRADINITA PETROTUB","MUNICIPIUL ROMAN",2,120860,1,1,1284,774,734,40,767,7,1500,726,539,228,
29,"NEAMT",270,120860,,87,0,"BOGDAN DRAGOS, 43 - SEDIUL EURO 85","MUNICIPIUL ROMAN",2,120860,1,1,1601,909,849,60,887,22,1800,891,630,257,
29,"NEAMT",270,120860,,88,0,"BOGDAN DRAGOS, 183 - GRADINITA NR.10","MUNICIPIUL ROMAN",2,120860,1,1,1272,814,743,71,805,9,1400,586,589,216,
29,"NEAMT",270,120860,,89,0,"BOGDAN DRAGOS, 183 - SCOALA NR.183","MUNICIPIUL ROMAN",2,120860,1,1,1219,777,732,45,764,13,1400,623,603,161,
29,"NEAMT",270,120860,,90,0,"SOLDAT POROJAN, 5 - SC MOLDAGREMIN SA","MUNICIPIUL ROMAN",2,120860,1,1,1340,811,752,59,799,12,1500,689,560,239,
29,"NEAMT",270,120860,,91,0,"C A ROSETTI, 8 - SCOALA NR.1","MUNICIPIUL ROMAN",2,120860,1,1,1712,1056,904,152,1043,13,1890,834,740,303,
29,"NEAMT",270,120860,,92,0,"C A ROSETTI, 8 - SCOALA NR.1","MUNICIPIUL ROMAN",2,120860,1,1,1405,712,680,32,701,11,1600,888,519,182,
29,"NEAMT",270,120860,,93,0,"CUZA VODA, 12 - CLUBUL ELEVILOR","MUNICIPIUL ROMAN",2,120860,1,1,1425,771,730,41,756,15,1600,829,525,231,
29,"NEAMT",270,120860,,94,0,"STEFAN CEL MARE - CAR PENSIONARI","MUNICIPIUL ROMAN",2,120860,1,1,1381,909,868,41,875,34,1600,691,642,233,
29,"NEAMT",270,120860,,95,0,"CUZA VODA, 17 - GRADINITA NR.12","MUNICIPIUL ROMAN",2,120860,1,1,1829,936,904,32,926,10,2105,1169,644,282,
29,"NEAMT",270,120860,,96,0,"NICOLAE TITULESCU, 5 - BIBLIOTECA MUNICIPALA ROMAN","MUNICIPIUL ROMAN",2,120860,1,1,1255,759,713,46,744,15,1404,645,571,173,
29,"NEAMT",270,120860,,97,0,"ALEXANDRU CEL BUN, 2 - SEMINARUL TEOLOGIC","MUNICIPIUL ROMAN",2,120860,1,1,1598,994,834,160,985,9,1800,806,625,360,
29,"NEAMT",270,120860,,98,0,"SUCEDAVA, 4 SCOALA NR.9","MUNICIPIUL ROMAN",2,120860,1,1,1094,613,576,37,605,8,1200,587,399,206,
29,"NEAMT",270,120860,,99,0,"PANAITE DONICI, 9 - CLUB IRE","MUNICIPIUL ROMAN",2,120860,1,1,2497,1251,1218,33,1236,15,2800,1549,814,422,
29,"NEAMT",270,120860,,100,0,"ION IONESCU DE LA BRAD, 5 - GRADINITA NR.5","MUNICIPIUL ROMAN",2,120860,1,1,1461,807,769,38,797,10,1604,797,567,230,
29,"NEAMT",270,120860,,101,0,"MIRON COSTIN, 3 - SCOALA NR.4","MUNICIPIUL ROMAN",2,120860,1,1,2114,1158,1085,73,1139,19,2400,1242,798,341,
29,"NEAMT",270,120860,,102,0,"B-DUL REPUBLICII, - LICEUL NR.3","MUNICIPIUL ROMAN",2,120860,1,1,1485,879,771,108,826,53,1700,821,600,226,
29,"NEAMT",270,120860,,103,0,"PETRU RARES, 1 - SCOALA NR.2","MUNICIPIUL ROMAN",2,120860,1,1,1261,744,678,66,729,15,1400,656,496,233,
29,"NEAMT",270,120860,,104,0,"ENERGIEI, 3 - CLUB DANUBIANA","MUNICIPIUL ROMAN",2,120860,1,1,930,577,505,72,572,5,1100,523,360,212,
29,"NEAMT",270,120968,,105,0,"BARAJULUI, 2 - CLUBUL COPIILOR","ORAS BICAZ",3,120968,2,1,1310,751,713,38,741,10,1500,749,469,272,
29,"NEAMT",270,120968,,106,0,"MARCENI - SCOALA GENERALA MARCENI","ORAS BICAZ",3,120968,2,1,722,470,445,25,468,2,800,330,298,170,
29,"NEAMT",270,120968,,107,0,"DIMITRIE LEONIDA - GRADINITA MARCENI","ORAS BICAZ",3,120968,2,1,1522,930,872,58,923,7,1600,669,469,454,
29,"NEAMT",270,120968,,108,0,"REPUBLICI - GRUP SCOLAR","ORAS BICAZ",3,120968,2,1,392,285,238,47,279,6,500,215,184,95,
29,"NEAMT",270,120968,,109,0,"PLAIULUI - GRADINITA CAPSA","ORAS BICAZ",3,120968,2,1,629,434,404,30,431,3,700,266,272,159,
29,"NEAMT",270,120968,,110,0,"COJUSNA - SCOALA GENERALA DODENI","ORAS BICAZ",3,120968,2,1,1877,1100,959,141,1085,15,2100,1000,539,546,
29,"NEAMT",270,120968,,111,0,"IZVORU MUNTELUI - SCOALA GENERALA IZVORUL MUNTELUI","ORAS BICAZ",3,120968,2,1,394,261,224,37,261,0,500,239,167,94,
29,"NEAMT",270,120968,,112,0,"SCOALA GENERALA IZVORUL ALB","ORAS BICAZ",3,120968,2,1,211,158,130,28,157,1,300,142,103,54,
29,"NEAMT",270,120968,,113,0,"SCOALA GENERALA POTOCI","ORAS BICAZ",3,120968,2,1,228,169,147,22,169,0,300,131,122,47,
29,"NEAMT",270,120968,,114,0,"SCOALA GENERALA SECU","ORAS BICAZ",3,120968,2,1,67,89,51,38,89,0,100,11,61,28,
29,"NEAMT",270,121055,,115,0,"STEFAN CEL MARE, 24 - GRADINITA NR.2","ORAS TARGU NEAMT",4,121055,2,1,977,588,552,36,581,7,1100,512,387,194,
29,"NEAMT",270,121055,,116,0,"STEFAN CEL MARE, 30 - GRADINITA NR.2","ORAS TARGU NEAMT",4,121055,2,1,2052,1220,1140,80,1206,14,2300,1080,809,397,
29,"NEAMT",270,121055,,117,0,"RADU TEOHARIE - SCOALA GENERALA NR.8","ORAS TARGU NEAMT",4,121055,2,1,1648,877,814,63,866,11,1898,1021,604,262,
29,"NEAMT",270,121055,,118,0,"STEFAN CEL MARE, 52 - SCOALA GENERALA NR.5","ORAS TARGU NEAMT",4,121055,2,1,1739,883,817,66,867,16,2000,1117,578,289,
29,"NEAMT",270,121055,,119,0,"TARGU NEAMT, 55 - CASA CULTURII ION CREANGA","ORAS TARGU NEAMT",4,121055,2,1,1778,960,885,75,944,16,2000,1040,674,270,
29,"NEAMT",270,121055,,120,0,"MARASESTI, 101 - CLUBUL COPIILOR SI ELEVILOR","ORAS TARGU NEAMT",4,121055,2,1,1833,1006,929,77,993,13,2000,994,692,301,
29,"NEAMT",270,121055,,121,0,"STEFAN CEL MARE - LICEUL TEORETIC STEFAN CEL MARE","ORAS TARGU NEAMT",4,121055,2,1,1790,1122,996,126,1109,13,2000,878,761,348,
29,"NEAMT",270,121055,,122,0,"STEFAN CEL MARE, 147 - SCOALA GENERALA NR.1","ORAS TARGU NEAMT",4,121055,2,1,1705,1059,887,172,1040,19,1900,841,690,350,
29,"NEAMT",270,121055,,123,0,"VANATORULUI, 26 - SCOALA GENERALA NR.4","ORAS TARGU NEAMT",4,121055,2,1,705,426,396,30,421,5,800,374,278,143,
29,"NEAMT",270,121055,,124,0,"MIHAIL SADOVEANU, - SCOALA GENERLA NR.3","ORAS TARGU NEAMT",4,121055,2,1,1266,718,686,32,701,17,1401,683,471,230,
29,"NEAMT",270,121055,,125,0,"MIHAIL SADOVEANU, 21 - SCOALA GENERLA NR.3","ORAS TARGU NEAMT",4,121055,2,1,1641,1035,946,89,1023,12,1800,765,756,267,
29,"NEAMT",270,121055,,126,0,"HANGULUI, 38 - SCOALA GENERALA NR.7","ORAS TARGU NEAMT",4,121055,2,1,399,286,250,36,281,5,500,214,175,106,
29,"NEAMT",270,121055,,127,1,"STEFAN CEL MARE, 35 - CLUBUL SPITALULUI ORASANESC","ORAS TARGU NEAMT",4,121055,2,1,0,213,0,213,209,4,400,187,160,49,
29,"NEAMT",270,121108,,128,0,"AGAPIA CAMIN CULTURAL","AGAPIA",5,121108,0,3,1536,999,727,272,941,58,1700,701,703,238,
29,"NEAMT",270,121108,,129,0,"FILIOARA, SCOALA VECHE","AGAPIA",5,121108,0,3,866,545,436,109,540,5,1000,455,371,169,
29,"NEAMT",270,121108,,130,0,"SACALUSESTI, SCOALA PRIMARA","AGAPIA",5,121108,0,3,449,333,235,98,329,4,500,167,221,108,
29,"NEAMT",270,121108,,131,0,"VARATEC, SCOALA PRIMARA","AGAPIA",5,121108,0,3,734,510,388,122,490,20,900,390,326,164,
29,"NEAMT",270,121153,,132,0,"BAHNA, SCOALA GENERALA","BAHNA",6,121153,0,3,1207,612,498,114,602,10,1400,788,459,143,
29,"NEAMT",270,121153,,133,0,"BROSTENI, SCOALA GENERALA","BAHNA",6,121153,0,3,438,319,220,99,314,5,500,181,246,68,
29,"NEAMT",270,121153,,134,0,"TUTCANII DIN VALE, SCOALA GENERALA","BAHNA",6,121153,0,3,288,220,150,70,217,3,400,180,142,75,
29,"NEAMT",270,121153,,135,0,"IZVOARE, SCOALA GENERALA","BAHNA",6,121153,0,3,1091,654,537,117,645,9,1194,540,528,117,
29,"NEAMT",270,121242,,136,0,"BALTATESTI, CAMINUL CULTURAL","BALTATESTI",7,121242,0,3,2156,1260,893,367,1249,11,2400,1140,834,415,
29,"NEAMT",270,121242,,137,0,"GHINDAOANI, CAMINUL CULTURAL","BALTATESTI",7,121242,0,3,1509,841,675,166,829,12,1700,859,671,158,
29,"NEAMT",270,121242,,138,0,"VALEA MARE, SCOALA GENERALA","BALTATESTI",7,121242,0,3,481,396,264,132,392,4,600,204,309,83,
29,"NEAMT",270,121242,,139,0,"VALEA SEACA, SCOALA GENERALA","BALTATESTI",7,121242,0,3,1076,728,505,223,724,4,1200,472,543,181,
29,"NEAMT",270,121242,,140,0,"VALEA ARINI, SCOALA GENERALA","BALTATESTI",7,121242,0,3,355,331,163,168,328,3,400,69,204,124,
29,"NEAMT",270,121297,,141,0,"BICAZ CHEI, CAMINUL CULTURAL","BICAZ-CHEI",9,121297,0,3,1988,1294,1037,257,1288,6,2196,902,428,860,
29,"NEAMT",270,121297,,142,0,"BICAZ CHEI, SCOALA GENERALA NR.2","BICAZ-CHEI",9,121297,0,3,831,515,366,149,512,3,1000,485,153,359,
29,"NEAMT",270,121297,,143,0,"IVANES, SCOALA GENERALA NR.1","BICAZ-CHEI",9,121297,0,3,618,468,344,124,461,7,700,232,260,201,
29,"NEAMT",270,121340,,144,0,"TICOS, SCOALA GENERALA","BICAZU ARDELEAN",10,121340,0,3,275,199,169,30,197,2,400,201,79,118,
29,"NEAMT",270,121340,,145,0,"BICAZU ARDELEAN, CAMINUL CULTURAL","BICAZU ARDELEAN",10,121340,0,3,1383,808,716,92,798,10,1596,788,332,466,
29,"NEAMT",270,121340,,146,0,"TELEC, CAMINUL CULTURAL","BICAZU ARDELEAN",10,121340,0,3,1222,634,570,64,628,6,1400,766,303,325,
29,"NEAMT",270,121340,,147,0,"TOSOROG, SCOALA GENERALA","BICAZU ARDELEAN",10,121340,0,3,450,303,250,53,296,7,500,197,148,148,
29,"NEAMT",270,121386,,148,0,"BIRA, GRADINITA","BIRA",11,121386,0,3,915,499,424,75,488,11,1000,501,350,138,
29,"NEAMT",270,121386,,149,0,"REDIU II, SCOALA GENERALA","BIRA",11,121386,0,3,650,376,299,77,370,6,800,424,283,87,
29,"NEAMT",270,121386,,150,0,"BOGHICEA, SCOALA GENERALA","BIRA",11,121386,0,3,1147,765,655,110,748,17,1300,535,574,174,
29,"NEAMT",270,121386,,151,0,"SLOBOZIA, SCOALA GENERALA","BIRA",11,121386,0,3,774,477,382,95,465,12,900,423,373,92,
29,"NEAMT",270,121466,,152,0,"BARGAUANI, CONSILIUL LOCAL","BARGAUANI",8,121466,0,3,1251,1047,957,90,1034,13,1398,351,746,288,
29,"NEAMT",270,121466,,153,0,"BALANESTI, SCOALA GENERALA","BARGAUANI",8,121466,0,3,777,892,770,122,883,9,897,5,691,192,
29,"NEAMT",270,121466,,154,0,"TALPA, SCOALA GENERALA","BARGAUANI",8,121466,0,3,855,578,519,59,566,12,1000,422,396,170,
29,"NEAMT",270,121466,,155,0,"VLADICENI, SCOALA GENERALA","BARGAUANI",8,121466,0,3,558,447,367,80,442,5,700,253,358,84,
29,"NEAMT",270,121607,,156,0,"BODESTI, SCOALA GENERALA NR.4","BODESTI",12,121607,0,3,1774,1019,846,173,1009,10,2000,981,834,175,
29,"NEAMT",270,121607,,157,0,"BODESTII DE JOS, GRADINITA","BODESTI",12,121607,0,3,546,385,265,120,381,4,600,215,316,65,
29,"NEAMT",270,121607,,158,0,"BODESTII DE JOS, SCOALA GENERALA","BODESTI",12,121607,0,3,953,631,476,155,625,6,1100,469,552,73,
29,"NEAMT",270,121607,,159,0,"OSLOBENI, SCOALA GENERALA","BODESTI",12,121607,0,3,751,553,382,171,547,6,900,347,470,77,
29,"NEAMT",270,121652,,160,0,"BORCA, SCOALA GENERALA","BORCA",13,121652,0,3,828,545,472,73,538,7,900,355,288,250,
29,"NEAMT",270,121652,,161,0,"MADEI, SALA DE FESTIVITATI","BORCA",13,121652,0,3,912,664,606,58,662,2,1000,336,383,279,
29,"NEAMT",270,121652,,162,0,"PARAUL CARJEI, SCOALA GENERALA","BORCA",13,121652,0,3,592,402,366,36,401,1,700,298,174,227,
29,"NEAMT",270,121652,,163,0,"BORCA, CAMINUL CULTURAL","BORCA",13,121652,0,3,1578,1083,940,143,1072,11,1800,717,548,524,
29,"NEAMT",270,121652,,164,0,"PARAUL PANTEI, SCOALA GENERALA","BORCA",13,121652,0,3,459,319,270,49,316,3,500,181,211,105,
29,"NEAMT",270,121652,,165,0,"SOCI, SCOALA GENERALA","BORCA",13,121652,0,3,691,475,446,29,469,6,800,325,265,204,
29,"NEAMT",270,121732,,166,0,"BORLESTI, SCOALA GENERALA NR.1","BORLESTI",14,121732,0,3,1428,725,555,170,718,7,1600,875,496,222,
29,"NEAMT",270,121732,,167,0,"BORLESTI, SCOALA GENERALA NR.2","BORLESTI",14,121732,0,3,785,396,301,95,392,4,910,514,201,191,
29,"NEAMT",270,121732,,168,0,"RUSENI, SCOALA GENERALA NR.1","BORLESTI",14,121732,0,3,1490,716,555,161,702,14,1700,984,474,228,
29,"NEAMT",270,121732,,169,0,"RUSENI, SCOALA GENERALA NR.2","BORLESTI",14,121732,0,3,1128,593,450,143,586,7,1300,707,385,201,
29,"NEAMT",270,121732,,170,0,"MASATACAN, SCOALA GENERALA","BORLESTI",14,121732,0,3,1555,712,616,96,698,11,1802,1090,365,333,
29,"NEAMT",270,121732,,171,0,"SOVOAIA, SCOALA GENERALA","BORLESTI",14,121732,0,3,439,249,158,91,244,5,500,251,124,120,
29,"NEAMT",270,121732,,172,0,"NECHIT, SCOALA GENERALA","BORLESTI",14,121732,0,3,240,167,129,38,166,1,300,133,77,89,
29,"NEAMT",270,121796,,173,0,"BOTESTI, SCOALA GENERALA","BOTESTI",15,121796,0,3,639,382,269,113,376,6,700,318,245,131,
29,"NEAMT",270,121796,,174,0,"BARTICESTI, SCOALA GENERALA","BOTESTI",15,121796,0,3,1497,952,805,147,940,12,1700,748,582,358,
29,"NEAMT",270,121796,,175,0,"NISIPORESTI, SCOALA GENERALA","BOTESTI",15,121796,0,3,1664,924,813,111,895,29,1900,976,605,290,
29,"NEAMT",270,121796,,176,0,"MORENI, SCOALA GENERALA","BOTESTI",15,121796,0,3,449,360,248,112,356,4,500,140,277,79,
29,"NEAMT",270,121796,,177,0,"VALENI, SCOALA GENERALA","BOTESTI",15,121796,0,3,752,577,450,127,572,5,887,310,486,86,
29,"NEAMT",270,121876,,178,0,"BOZIENI, SCOALA GENERALA","BOZIENI",16,121876,0,3,1031,664,525,139,650,14,1200,536,494,156,
29,"NEAMT",270,121876,,179,0,"CUCI, SCOALA GENERALA","BOZIENI",16,121876,0,3,629,519,398,121,513,6,700,181,421,92,
29,"NEAMT",270,121876,,180,0,"IUCSA, SCOALA GENERALA","BOZIENI",16,121876,0,3,624,532,374,158,522,10,700,168,376,146,
29,"NEAMT",270,121938,,181,0,"BRUSTURI, SCOALA GENERALA","BRUSTURI-DRAGANESTI",17,121938,0,3,1522,932,813,119,919,13,1700,768,624,295,
29,"NEAMT",270,121938,,182,0,"DRAGANESTI, SCOALA GENERALA","BRUSTURI-DRAGANESTI",17,121938,0,3,870,538,450,88,537,1,1000,462,359,178,
29,"NEAMT",270,121938,,183,0,"GROSI, SCOALA GENERALA","BRUSTURI-DRAGANESTI",17,121938,0,3,417,222,175,47,220,2,500,278,144,76,
29,"NEAMT",270,121938,,184,0,"POIANA, SCOALA GENERALA","BRUSTURI-DRAGANESTI",17,121938,0,3,621,414,320,94,412,2,700,286,276,136,
29,"NEAMT",270,121938,,185,0,"SOIMARESTI, SCOALA GENERALA","BRUSTURI-DRAGANESTI",17,121938,0,3,397,259,211,48,253,6,500,241,152,101,
29,"NEAMT",270,121938,,186,0,"TARZIA, SCOALA GENERALA","BRUSTURI-DRAGANESTI",17,121938,0,3,533,375,277,98,371,4,600,225,250,121,
29,"NEAMT",270,122025,,187,0,"CEAHLAU, SCOALA GENERALA NR.1","CEAHLAU",19,122025,0,3,1450,1030,874,156,1019,11,1600,570,709,310,
29,"NEAMT",270,122025,,188,0,"BISTRICIOARA, GRADINITA","CEAHLAU",19,122025,0,3,585,433,321,112,419,14,700,267,265,154,
29,"NEAMT",270,122061,,189,0,"CANDESTI, SCOALA GENERALA","CANDESTI",18,122061,0,3,1330,657,531,126,651,6,1500,843,475,176,
29,"NEAMT",270,122061,,190,0,"VADURELE, SCOALA GENERALA","CANDESTI",18,122061,0,3,978,564,488,76,559,5,1100,536,428,131,
29,"NEAMT",270,122061,,191,0,"BARCANESTI, SCOALA GENERALA","CANDESTI",18,122061,0,3,787,402,339,63,393,9,900,498,285,108,
29,"NEAMT",270,122061,,192,0,"PADURENI, SCOALA GENERALA","CANDESTI",18,122061,0,3,265,170,113,57,163,7,300,130,126,37,
29,"NEAMT",270,122132,,193,0,"COSTISA, SCOALA GENERALA NR.1","COSTISA",21,122132,0,3,1313,820,692,128,816,4,1500,680,648,168,
29,"NEAMT",270,122132,,194,0,"COSTISA, SCOALA GENERALA NR.2","COSTISA",21,122132,0,3,238,203,148,55,203,0,300,97,176,27,
29,"NEAMT",270,122132,,195,0,"FRUNZENI, SCOALA GENERALA","COSTISA",21,122132,0,3,497,287,244,43,286,1,600,313,158,128,
29,"NEAMT",270,122132,,196,0,"MANOAIA, SCOALA GENERALA","COSTISA",21,122132,0,3,754,499,428,71,498,1,900,401,390,108,
29,"NEAMT",270,120888,,197,0,"CORDUN, CAMINUL CULTURAL","CORDUN",20,120888,0,3,1439,939,793,146,932,7,1600,661,692,240,
29,"NEAMT",270,120888,,198,0,"CORDUN, SCOALA GENERALA","CORDUN",20,120888,0,3,665,567,425,142,564,3,800,233,432,132,
29,"NEAMT",270,120888,,199,0,"SIMIONESTI, CAMINUL CULTURAL","CORDUN",20,120888,0,3,544,510,367,143,508,2,600,90,390,118,
29,"NEAMT",270,120888,,200,0,"PILDESTI, CAMINUL CULTURAL","CORDUN",20,120888,0,3,1457,759,685,74,731,28,1600,841,443,288,
29,"NEAMT",270,120888,,201,0,"PILDESTI, SCOALA GENERALA","CORDUN",20,120888,0,3,1414,680,612,68,665,15,1600,920,416,249,
29,"NEAMT",270,122187,,202,0,"CRACAOANI, CAMINUL CULTURAL","CRACAOANI",22,122187,0,3,1778,1140,1005,135,1124,16,2000,860,738,386,
29,"NEAMT",270,122187,,203,0,"MAGAZIA, SCOALA GENERALA","CRACAOANI",22,122187,0,3,533,407,334,73,403,4,600,193,275,128,
29,"NEAMT",270,122187,,204,0,"CRACAUL NEGRU, SCOALA GENERALA","CRACAOANI",22,122187,0,3,971,777,726,51,767,10,1100,323,550,217,
29,"NEAMT",270,122187,,205,0,"MITOCU BALAN, SCOALA GENERALA","CRACAOANI",22,122187,0,3,266,217,188,29,216,1,300,83,181,35,
29,"NEAMT",270,122249,,206,0,"DAMUC, CAMINUL CULTURAL","DAMUC",23,122249,0,3,1307,791,638,153,785,6,1500,709,299,486,
29,"NEAMT",270,122249,,207,0,"DAMUC II, SCOALA GENERALA","DAMUC",23,122249,0,3,545,393,344,49,391,2,600,207,142,249,
29,"NEAMT",270,122249,,208,0,"HUISUREZ, SCOALA GENERALA","DAMUC",23,122249,0,3,573,359,217,142,354,5,700,341,173,181,
29,"NEAMT",270,122285,,209,0,"DOBRENI, SCOALA VECHE","DOBRENI",24,122285,0,3,1297,910,760,150,898,12,1500,590,655,243,
29,"NEAMT",270,122285,,210,0,"NEGRESTI, SCOALA GENERALA","DOBRENI",24,122285,0,3,1249,781,652,129,769,12,1400,619,604,165,
29,"NEAMT",270,122285,,211,0,"POIANA, SCOALA GENERALA","DOBRENI",24,122285,0,3,265,259,184,75,254,5,300,41,189,65,
29,"NEAMT",270,122347,,212,0,"DOLJESTI, SCOALA GENERALA","DOLJESTI",25,122347,0,3,1097,961,884,77,949,12,1200,239,858,91,
29,"NEAMT",270,122347,,213,0,"BUHONCA, SCOALA GENERALA","DOLJESTI",25,122347,0,3,425,331,269,62,323,8,500,169,248,75,
29,"NEAMT",270,122347,,214,0,"ROTUNDA, SCOALA GENERALA","DOLJESTI",25,122347,0,3,1174,971,890,81,958,13,1300,329,843,115,
29,"NEAMT",270,122347,,215,0,"BURUIENESTI, SCOALA GENERALA","DOLJESTI",25,122347,0,3,1238,957,889,68,936,21,1400,443,681,255,
29,"NEAMT",270,122347,,216,0,"BURUIENESTI, CAMINUL CULTURAL","DOLJESTI",25,122347,0,3,1300,980,922,58,960,20,1500,520,799,161,
29,"NEAMT",270,122392,,217,0,"DRAGOMIRESTI, SCOALA GENERALA","DRAGOMIRESTI",26,122392,0,3,1061,724,579,145,713,11,1204,480,583,130,
29,"NEAMT",270,122392,,218,0,"HLAPESTI, SCOALA GENERALA","DRAGOMIRESTI",26,122392,0,3,794,472,408,64,461,11,900,428,302,159,
29,"NEAMT",270,122463,,219,0,"BOZIENII DE SUS, SCOALA GENERALA","DULCESTI",27,122463,0,3,193,203,86,117,197,6,300,97,147,50,
29,"NEAMT",270,122463,,220,0,"CARLIG, SCOALA GENERALA","DULCESTI",27,122463,0,3,539,413,294,119,408,5,600,187,278,130,
29,"NEAMT",270,122463,,221,0,"CORHANA, CAMINUL CULTURAL","DULCESTI",27,122463,0,3,519,393,322,71,382,11,600,207,251,131,
29,"NEAMT",270,122463,,222,0,"DULCESTI, CAMINUL CULTURAL","DULCESTI",27,122463,0,3,1009,597,469,128,590,7,1200,603,428,162,
29,"NEAMT",270,122463,,223,0,"ROSIORI, SCOALA GENERALA","DULCESTI",27,122463,0,3,215,191,140,51,189,2,300,109,149,40,
29,"NEAMT",270,122463,,224,0,"RUGINOASA, SCOALA GENERALA","DULCESTI",27,122463,0,3,1437,842,706,136,834,8,1600,758,540,294,
29,"NEAMT",270,120771,,225,0,"BRASAUTI, SCOALA GENERALA NR.22","DUMBRAVA ROSIE",28,120771,0,3,463,390,274,116,388,2,500,110,274,114,
29,"NEAMT",270,120771,,226,0,"CUT, SCOALA GENERALA NR.14","DUMBRAVA ROSIE",28,120771,0,3,2042,1037,888,149,1023,14,2300,1263,682,341,
29,"NEAMT",270,120771,,227,0,"DUMBRAVA ROSIE, SCOALA GENERALA NR.13","DUMBRAVA ROSIE",28,120771,0,3,1738,1053,800,253,1044,9,1900,847,691,353,
29,"NEAMT",270,120771,,228,0,"IZVOARE, SCOALA GENERALA NR.16","DUMBRAVA ROSIE",28,120771,0,3,837,585,441,144,577,8,900,315,384,193,
29,"NEAMT",270,122551,,229,0,"FARCASA, CAMINUL CULTURAL","FARCASA",29,122551,0,3,1205,735,662,73,731,4,1399,664,380,351,
29,"NEAMT",270,122551,,230,0,"FRUMOSU, CAMINUL CULTURAL","FARCASA",29,122551,0,3,762,574,496,78,566,8,900,326,318,248,
29,"NEAMT",270,122551,,231,0,"STEJARU, CAMINUL CULTURAL","FARCASA",29,122551,0,3,581,374,321,53,372,2,700,326,180,192,
29,"NEAMT",270,122613,,232,0,"FAUREI, SCOALA GENERALA","FAUREI",30,122613,0,3,1048,819,662,157,816,3,1200,381,642,174,
29,"NEAMT",270,122613,,233,0,"BUDESTI, FOSTUL MAGAZIN","FAUREI",30,122613,0,3,853,678,531,147,674,4,1000,322,508,166,
29,"NEAMT",270,122668,,234,0,"GHERAESTI, CAMINUL CULTURAL","GHERAESTI",32,122668,0,3,2110,954,910,44,935,19,2400,1446,696,239,
29,"NEAMT",270,122668,,235,0,"GHERAESTI, SCOALA GENERALA","GHERAESTI",32,122668,0,3,1751,898,849,49,881,17,2000,1102,676,205,
29,"NEAMT",270,122668,,236,0,"GHERAESTII NOI, SCOALA GENERALA","GHERAESTI",32,122668,0,3,419,306,227,79,304,2,500,194,223,81,
29,"NEAMT",270,122668,,237,0,"TETCANI, SCOALA GENERALA","GHERAESTI",32,122668,0,3,614,388,308,80,380,8,700,312,266,114,
29,"NEAMT",270,122702,,238,0,"GIROV, BIBLIOTECA COMUNALA","GIROV",33,122702,0,3,1179,843,594,249,827,16,1300,457,585,242,
29,"NEAMT",270,122702,,239,0,"DOCHIA, SCOALA GENERALA","GIROV",33,122702,0,3,1854,1238,1027,211,1226,12,2100,862,830,396,
29,"NEAMT",270,122702,,240,0,"CACIULESTI, SCOALA GENERALA","GIROV",33,122702,0,3,415,307,195,112,296,11,600,293,211,85,
29,"NEAMT",270,122702,,241,0,"BOTESTI, SCOALA GENERALA","GIROV",33,122702,0,3,592,415,240,175,415,0,700,285,299,116,
29,"NEAMT",270,122702,,242,0,"GURA VAII, SCOALA GENERALA","GIROV",33,122702,0,3,613,529,381,148,526,3,700,171,417,109,
29,"NEAMT",270,122702,,243,0,"DANESTI, SCOALA GENERALA","GIROV",33,122702,0,3,222,198,122,76,194,4,300,102,146,48,
29,"NEAMT",270,122702,,244,0,"TURTURESTI, SCOALA GENERALA","GIROV",33,122702,0,3,255,199,121,78,198,1,299,100,125,73,
29,"NEAMT",270,122702,,245,0,"VERSESTI, SCOALA GENERALA","GIROV",33,122702,0,3,229,232,142,90,227,5,300,68,165,62,
29,"NEAMT",270,122828,,246,0,"GARCINA, SCOALA GENERALA","GARCINA",31,122828,0,3,890,655,496,159,647,8,1000,345,409,238,
29,"NEAMT",270,122828,,247,0,"GARCINA, GRADINITA","GARCINA",31,122828,0,3,839,650,471,179,645,5,2000,1350,391,254,
29,"NEAMT",270,122828,,248,0,"ALMAS, SCOALA GENERALA","GARCINA",31,122828,0,3,451,420,337,83,415,5,500,80,273,142,
29,"NEAMT",270,122828,,249,0,"CUEJDIU, SCOALA GENERALA","GARCINA",31,122828,0,3,1125,539,472,67,537,2,1300,761,365,172,
29,"NEAMT",270,122864,,250,0,"POIANA, CAMINUL CULTURAL","GRINTIES",34,122864,0,3,1466,840,740,100,827,13,1700,860,429,398,
29,"NEAMT",270,122864,,251,0,"BRADU, SALA DE FESTIVITATI","GRINTIES",34,122864,0,3,592,410,320,90,404,6,700,290,180,224,
29,"NEAMT",270,122908,,252,0,"GRUMAZESTI, GRADINITA","GRUMAZESTI",35,122908,0,3,1437,764,721,43,758,6,1600,836,591,167,
29,"NEAMT",270,122908,,253,0,"GRUMAZESTI, CAMINUL CULTURAL","GRUMAZESTI",35,122908,0,3,1103,646,585,61,634,12,1200,554,509,125,
29,"NEAMT",270,122908,,254,0,"CURECHISTEA, SCOALA GENERALA","GRUMAZESTI",35,122908,0,3,583,391,363,28,384,7,700,309,322,62,
29,"NEAMT",270,122908,,255,0,"TOPOLITA, GRADINITA","GRUMAZESTI",35,122908,0,3,1278,821,756,65,812,9,1400,579,629,183,
29,"NEAMT",270,122953,,256,0,"HANGU, SCOALA GENERALA","HANGU",36,122953,0,3,1506,885,799,86,871,14,1700,815,544,327,
29,"NEAMT",270,122953,,257,0,"BOBOTENI, SCOALA GENERALA","HANGU",36,122953,0,3,547,350,297,53,346,4,600,250,184,162,
29,"NEAMT",270,122953,,258,0,"BUHALNITA, SCOALA GENERALA","HANGU",36,122953,0,3,1044,641,592,49,637,4,1200,559,393,244,
29,"NEAMT",270,122953,,259,0,"GROZAVESTI, SCOALA GENERALA","HANGU",36,122953,0,3,413,257,224,33,256,1,500,243,136,120,
29,"NEAMT",270,120922,,260,0,"HORIA, SCOALA GENERALA NR.14","HORIA",37,120922,0,3,1427,900,765,135,890,10,1600,700,639,251,
29,"NEAMT",270,120922,,261,0,"HORIA, CAMINUL CULTURAL","HORIA",37,120922,0,3,1412,795,701,94,788,7,1600,805,576,212,
29,"NEAMT",270,120922,,262,0,"COTU VAMES, SCOALA GENERALA OTILIA CAZIMIR","HORIA",37,120922,0,3,1260,785,686,99,772,13,1400,615,586,186,
29,"NEAMT",270,120922,,263,0,"COTU VAMES , GRADINITA","HORIA",37,120922,0,3,1286,814,749,65,804,10,1500,686,621,183,
29,"NEAMT",270,123013,,264,0,"ICUSESTI, SCOALA GENERALA","ICUSESTI",38,123013,0,3,824,447,373,74,440,7,900,453,312,128,
29,"NEAMT",270,123013,,265,0,"BALUSESTI, SCOALA GENERALA","ICUSESTI",38,123013,0,3,921,553,440,113,548,5,900,347,397,151,
29,"NEAMT",270,123013,,266,0,"BALUSESTI, SCOALA GENERALA","ICUSESTI",38,123013,0,3,971,736,599,137,725,11,1100,364,362,363,
29,"NEAMT",270,123013,,267,0,"MESTEACAN, SCOALA GENERALA","ICUSESTI",38,123013,0,3,346,281,203,78,278,3,400,119,190,88,
29,"NEAMT",270,123013,,268,0,"ROCNA, SCOALA GENERALA","ICUSESTI",38,123013,0,3,405,332,242,90,324,8,500,168,245,79,
29,"NEAMT",270,123013,,269,0,"SPIRIDONESTI, SCOALA GENERALA","ICUSESTI",38,123013,0,3,204,179,121,58,174,5,300,121,144,30,
29,"NEAMT",270,123102,,270,0,"ION CREANGA, CAMINUL CULTURAL","ION CREANGA",39,123102,0,3,2090,1379,1222,157,1361,18,2300,921,1011,350,
29,"NEAMT",270,123102,,271,0,"AVERESTI, CAMINUL CULTURAL","ION CREANGA",39,123102,0,3,1018,1047,869,178,1041,6,1194,147,842,199,
29,"NEAMT",270,123102,,272,0,"RECEA, SCOALA GENERALA","ION CREANGA",39,123102,0,3,587,470,364,106,467,3,700,230,369,98,
29,"NEAMT",270,123102,,273,0,"STEJARU, SCOALA GENERALA","ION CREANGA",39,123102,0,3,657,529,432,97,528,1,700,171,425,103,
29,"NEAMT",270,123175,,274,0,"MARGINENI, SCOALA GENERALA","MARGINENI",40,123175,0,3,2016,1087,948,139,1065,22,2300,1213,807,258,
29,"NEAMT",270,123175,,275,0,"HOISESTI, SCOALA GENERALA","MARGINENI",40,123175,0,3,852,525,448,77,519,6,1000,475,424,95,
29,"NEAMT",270,123175,,276,0,"HARTESTI, SCOALA GENERALA","MARGINENI",40,123175,0,3,196,157,113,44,153,4,300,143,117,36,
29,"NEAMT",270,123175,,277,0,"ITRINESTI, SCOALA GENERALA","MARGINENI",40,123175,0,3,298,208,157,51,200,8,404,196,146,54,
29,"NEAMT",270,123228,,278,0,"MOLDOVENI, SCOALA GENERALA","MOLDOVENI",41,123228,0,3,1241,697,603,94,687,10,1400,703,496,191,
29,"NEAMT",270,123228,,279,0,"HOCIUNGI, SCOALA GENERALA","MOLDOVENI",41,123228,0,3,850,583,437,146,564,19,1000,417,407,157,
29,"NEAMT",270,123255,,280,0,"ONICENI, SCOALA GENERALA","ONICENI",42,123255,0,3,854,414,320,94,412,2,1000,586,297,115,
29,"NEAMT",270,123255,,281,0,"MARMURENI, SCOALA GENERALA","ONICENI",42,123255,0,3,347,278,215,63,273,5,400,122,247,26,
29,"NEAMT",270,123255,,282,0,"VALEA ENEI, SCOALA GENERALA","ONICENI",42,123255,0,3,467,408,285,123,403,5,500,92,332,71,
29,"NEAMT",270,123255,,283,0,"SOLCA, SCOALA GENERALA","ONICENI",42,123255,0,3,709,584,472,112,573,11,800,216,488,85,
29,"NEAMT",270,123371,,284,0,"PASTRAVENI, SCOALA GENERALA","PASTRAVENI",44,123371,0,3,1321,842,768,74,840,2,1500,658,694,146,
29,"NEAMT",270,123371,,285,0,"RADENI, SCOALA GENERALA","PASTRAVENI",44,123371,0,3,1364,791,713,78,775,16,1502,711,532,243,
29,"NEAMT",270,123371,,286,0,"LUNCA MOLDOVEI, SCOALA GENERALA","PASTRAVENI",44,123371,0,3,261,228,188,40,227,1,300,72,200,27,
29,"NEAMT",270,123424,,287,0,"PETRICANI, SCOALA GENERALA NR.1","PETRICANI",45,123424,0,3,1432,809,699,110,805,4,1600,791,601,204,
29,"NEAMT",270,123424,,288,0,"BOISTEA, SCOALA GENERALA","PETRICANI",45,123424,0,3,748,494,421,73,482,12,900,406,400,82,
29,"NEAMT",270,123424,,289,0,"TARPESTI, SCOALA GENERALA","PETRICANI",45,123424,0,3,1012,577,458,119,565,12,1100,523,433,132,
29,"NEAMT",270,123424,,290,0,"TOLICI, SCOALA GENERALA","PETRICANI",45,123424,0,3,891,585,486,99,574,11,1000,415,500,74,
29,"NEAMT",270,123479,,291,0,"PIATRA SOIMULUI, SCOALA GENERALA NR.1","PIATRA SOIMULUI",46,123479,0,3,1442,788,644,144,783,5,1600,812,584,199,
29,"NEAMT",270,123479,,292,0,"PIATRA SOIMULUI, SCOALA GENERALA NR.1","PIATRA SOIMULUI",46,123479,0,3,1473,872,765,107,857,15,1700,828,568,289,
29,"NEAMT",270,123479,,293,0,"LUMINIS, SCOALA GENERALA","PIATRA SOIMULUI",46,123479,0,3,2037,1154,1064,90,1148,6,2300,1146,852,296,
29,"NEAMT",270,123479,,294,0,"NEGULESTI, SCOALA GENERALA","PIATRA SOIMULUI",46,123479,0,3,528,352,307,45,348,4,600,248,251,97,
29,"NEAMT",270,123479,,295,0,"POIENI, SCOALA GENERALA","PIATRA SOIMULUI",46,123479,0,3,973,606,537,69,599,7,1100,494,473,126,
29,"NEAMT",270,123521,,296,0,"PIPIRIG, CAMINUL CULTURAL","PIPIRIG",47,123521,0,3,1203,723,617,106,720,3,1400,677,455,265,
29,"NEAMT",270,123521,,297,0,"PIPIRIG, SCOALA GENERALA NR.2","PIPIRIG",47,123521,0,3,849,513,457,56,503,10,1000,487,361,142,
29,"NEAMT",270,123521,,298,0,"BOBOIESTI, SCOALA GENERALA","PIPIRIG",47,123521,0,3,1214,786,745,41,775,11,1400,614,555,220,
29,"NEAMT",270,123521,,299,0,"LEGHIN, SCOALA GENERALA","PIPIRIG",47,123521,0,3,382,254,223,31,254,0,500,246,174,80,
29,"NEAMT",270,123521,,300,0,"STANCA, SCOALA GENERALA","PIPIRIG",47,123521,0,3,886,537,478,59,531,6,1000,463,377,154,
29,"NEAMT",270,123521,,301,0,"DOLHESTI, SCOALA GENERALA","PIPIRIG",47,123521,0,3,856,493,456,37,487,6,1000,507,354,133,
29,"NEAMT",270,123521,,302,0,"PLUTON, SCOALA GENERALA","PIPIRIG",47,123521,0,3,805,470,434,36,466,4,900,430,243,223,
29,"NEAMT",270,123601,,303,0,"PANGARACIOR, SCOALA GENERALA","PANGARATI",43,123601,0,3,1427,788,628,160,784,4,1593,805,566,218,
29,"NEAMT",270,123601,,304,0,"OANTU, SCOALA GENERALA","PANGARATI",43,123601,0,3,1244,755,639,116,745,10,1400,645,442,303,
29,"NEAMT",270,123601,,305,0,"STEJARU, SCOALA GENERALA","PANGARATI",43,123601,0,3,793,572,428,144,568,4,900,328,360,208,
29,"NEAMT",270,123601,,306,0,"PANGARATI, SCOALA GENERALA","PANGARATI",43,123601,0,3,661,407,287,120,401,6,800,393,245,156,
29,"NEAMT",270,123674,,307,0,"PODOLENI, SCOALA GENERALA ALEXANDRU PODOLEANU","PODOLENI",48,123674,0,3,1996,1136,960,176,1130,6,2200,1064,912,218,
29,"NEAMT",270,123674,,308,0,"PODOLENI, SCOALA GENERALA NR.2","PODOLENI",48,123674,0,3,1228,744,616,128,731,13,1400,656,589,142,
29,"NEAMT",270,123674,,309,0,"PODOLENI, SCOALA GENERALA NR.3","PODOLENI",48,123674,0,3,1026,656,564,92,652,4,1200,544,547,105,
29,"NEAMT",270,123674,,310,0,"NEGRITESTI, SCOLALA GENERALA NR.4","PODOLENI",48,123674,0,3,354,279,238,41,277,2,400,121,189,88,
29,"NEAMT",270,123709,,311,0,"POIENARI, SCOALA GENERALA NR.1","POIENARI",50,123709,0,3,1145,649,548,101,643,6,1300,651,524,119,
29,"NEAMT",270,123709,,312,0,"PANCESTI, SCOALA GENERALA","POIENARI",50,123709,0,3,971,665,550,115,658,7,1100,435,502,156,
29,"NEAMT",270,123709,,313,0,"CIUREA, SCOALA GENERALA","POIENARI",50,123709,0,3,291,209,151,58,206,3,400,191,153,53,
29,"NEAMT",270,123709,,314,0,"SACALENI, SCOALA GENERALA","POIENARI",50,123709,0,3,326,255,209,46,254,1,400,145,215,39,
29,"NEAMT",270,123790,,315,0,"POIANA TEIULUI, GRADINITA","POIANA TEIULUI",49,123790,0,3,1293,906,731,175,892,14,1500,594,389,503,
29,"NEAMT",270,123790,,316,0,"DREPTU, SCOALA GENERALA","POIANA TEIULUI",49,123790,0,3,957,682,584,98,675,7,800,118,379,296,
29,"NEAMT",270,123790,,317,0,"POIANA LARGULUI, SCOALA GENERALA","POIANA TEIULUI",49,123790,0,3,735,464,382,82,457,7,800,336,191,266,
29,"NEAMT",270,123790,,318,0,"PETRU VODA, SCOALA GENERALA","POIANA TEIULUI",49,123790,0,3,812,535,477,58,535,0,900,365,293,242,
29,"NEAMT",270,123914,,319,0,"RAUCESTI, SCOALA GENERALA NR.1","RAUCESTI",51,123914,0,3,1191,778,657,121,771,7,1400,622,624,147,
29,"NEAMT",270,123914,,320,0,"RAUCESTI, SCOALA GENERALA NR.2","RAUCESTI",51,123914,0,3,1253,804,681,123,798,6,1400,596,629,169,
29,"NEAMT",270,123914,,321,0,"OGLINZI, SCOALA GENERALA NR.2","RAUCESTI",51,123914,0,3,710,557,333,224,555,2,800,243,440,115,
29,"NEAMT",270,123914,,322,0,"OGLINZI, SCOALA GENERALA NR.1","RAUCESTI",51,123914,0,3,1904,1205,955,250,1198,7,2200,995,1001,197,
29,"NEAMT",270,123914,,323,0,"SAVESTI, SCOALA GENERALA","RAUCESTI",51,123914,0,3,403,290,246,44,287,3,500,210,226,61,
29,"NEAMT",270,123914,,324,0,"UNGHENI, SCOALA GENERALA","RAUCESTI",51,123914,0,3,442,351,275,76,345,6,500,149,268,77,
29,"NEAMT",270,123969,,325,0,"RAZBOIENII DE JOS, SCOALA GENERALA NR. 1","RAZBOIENI",52,123969,0,3,1023,655,533,122,638,17,1200,545,498,140,
29,"NEAMT",270,123969,,326,0,"RAZBOIENI, SCOALA GENERALA NR.3","RAZBOIENI",52,123969,0,3,824,592,471,121,585,7,900,308,463,122,
29,"NEAMT",270,124028,,327,0,"REDIU, SCOALA GENERALA","REDIU",53,124028,0,3,2021,1016,853,163,1007,9,2300,1284,709,298,
29,"NEAMT",270,124028,,328,0,"POLOBOC, SCOALA GENERALA","REDIU",53,124028,0,3,982,665,529,136,662,3,1100,435,442,220,
29,"NEAMT",270,124028,,329,0,"BETESTI, SCOALA GENERALA","REDIU",53,124028,0,3,565,395,307,88,391,4,700,305,306,85,
29,"NEAMT",270,124028,,330,0,"SOCEA, SCOALA GENERALA","REDIU",53,124028,0,3,544,356,262,94,351,5,600,244,259,92,
29,"NEAMT",270,124073,,331,0,"ROMANI, SCOALA GENERALA","ROMANI",54,124073,0,3,965,596,473,123,588,8,1100,504,422,166,
29,"NEAMT",270,124073,,332,0,"SILISTEA, SCOALA GENERALA","ROMANI",54,124073,0,3,1026,714,589,125,706,8,1200,486,525,181,
29,"NEAMT",270,124073,,333,0,"SILISTEA, SCOALA GENERALA","ROMANI",54,124073,0,3,725,551,421,130,541,10,800,249,415,126,
29,"NEAMT",270,124073,,334,0,"GOSMANI, SCOALA GENERALA","ROMANI",54,124073,0,3,818,638,510,128,630,8,900,262,505,125,
29,"NEAMT",270,124117,,335,0,"ROZNOV, GRADINITA","ROZNOV",55,124117,0,3,1527,821,478,343,812,9,1700,879,577,235,
29,"NEAMT",270,124117,,336,0,"ROZNOV, CAMINUL CULTURAL","ROZNOV",55,124117,0,3,1213,831,463,368,817,14,1400,569,579,238,
29,"NEAMT",270,124117,,337,0,"ROZNOV, SALA DE SPORT","ROZNOV",55,124117,0,3,746,861,401,460,848,13,900,39,614,234,
29,"NEAMT",270,124117,,338,0,"SLOBOZIA, DISPENSARUL MEDICAL","ROZNOV",55,124117,0,3,1524,989,553,436,983,6,1700,711,670,313,
29,"NEAMT",270,124117,,339,0,"SLOBOZIA, CAMINUL CULTURAL","ROZNOV",55,124117,0,3,1081,1005,577,428,983,22,1200,195,748,235,
29,"NEAMT",270,124117,,340,0,"CHINTINICI, CAMINUL CULTURAL","ROZNOV",55,124117,0,3,956,682,487,195,679,3,1100,418,456,223,
29,"NEAMT",270,124153,,341,0,"SAGNA, SCOALA GENERALA NR.3","SAGNA",57,124153,0,3,1470,1001,946,55,983,18,1700,699,580,403,
29,"NEAMT",270,124153,,342,0,"SAGNA, SCOALA GENERALA NR.4","SAGNA",57,124153,0,3,1353,906,819,87,896,10,1500,594,529,367,
29,"NEAMT",270,124153,,343,0,"GADINTI, SCOALA GENERALA","SAGNA",57,124153,0,3,1669,1105,964,141,1093,12,1900,795,764,329,
29,"NEAMT",270,124153,,344,0,"LUTCA. SCOALA GENERALA","SAGNA",57,124153,0,3,302,247,188,59,246,1,400,153,174,72,
29,"NEAMT",270,124153,,345,0,"VULPASESTI, SCOALA GENERALA","SAGNA",57,124153,0,3,628,532,431,101,526,6,700,168,376,150,
29,"NEAMT",270,124206,,346,0,"SABAOANI, LICEUL","SABAOANI",56,124206,0,3,1972,950,870,80,926,24,2195,1245,657,269,
29,"NEAMT",270,124206,,347,0,"SABAOANI, SCOALA GENERALA NR.1","SABAOANI",56,124206,0,3,1675,675,644,31,656,19,1902,1227,421,235,
29,"NEAMT",270,124206,,348,0,"SABAOANI, SCOALA GENERALA NR.2","SABAOANI",56,124206,0,3,1854,845,790,55,817,28,2100,1255,559,258,
29,"NEAMT",270,124206,,349,0,"SABAOANI, SCOALA GENERALA NR.1","SABAOANI",56,124206,0,3,2188,1005,926,79,977,28,2380,1375,648,329,
29,"NEAMT",270,124206,,350,0,"TRAIAN, GRADINITA","SABAOANI",56,124206,0,3,797,511,440,71,499,12,900,389,351,148,
29,"NEAMT",270,120824,,351,0,"SAVINESTI, SCOALA GENERALA NR.10","SAVINESTI",58,120824,0,3,2403,1211,875,336,1195,16,2700,1489,808,387,
29,"NEAMT",270,120824,,352,0,"SAVINESTI SAT, SCOALA GENERALA NR.16","SAVINESTI",58,120824,0,3,1146,793,509,284,787,6,1300,507,551,236,
29,"NEAMT",270,120824,,353,0,"DUMBRAVA VALE, SCOALA GENERALA NR.23","SAVINESTI",58,120824,0,3,890,628,399,229,621,7,1000,372,466,155,
29,"NEAMT",270,120824,,354,0,"DUMBRAVA DEAL, SCOALA GENERALA NR. 24","SAVINESTI",58,120824,0,3,369,244,188,56,240,4,400,156,192,48,
29,"NEAMT",270,124233,,355,0,"SECUIENI, SCOALA GENERALA","SECUIENI",59,124233,0,3,1041,660,580,80,657,3,1200,540,461,196,
29,"NEAMT",270,124233,,356,0,"BASTA, SCOALA GENERALA","SECUIENI",59,124233,0,3,479,357,274,83,351,6,600,243,255,96,
29,"NEAMT",270,124233,,357,0,"BUTNARESTI, SCOALA GENERALA","SECUIENI",59,124233,0,3,1017,657,544,113,650,7,1203,546,539,111,
29,"NEAMT",270,124233,,358,0,"GIULESTI, SCOALA GENERALA","SECUIENI",59,124233,0,3,262,214,147,67,212,2,300,86,171,41,
29,"NEAMT",270,124331,,359,0,"STANITA, SCOALA GENERALA","STANITA",60,124331,0,3,1027,534,456,78,520,14,1200,666,400,120,
29,"NEAMT",270,124331,,360,0,"TODIRENI, SCOALA GENERALA","STANITA",60,124331,0,3,862,536,415,121,527,9,1000,464,366,161,
29,"NEAMT",270,124411,,361,0,"STEFAN CEL MARE, SCOALA GENERALA","STEFAN CEL MARE",61,124411,0,3,1368,1025,914,111,1008,17,1500,475,786,222,
29,"NEAMT",270,124411,,362,0,"GHIGOIESTI, SCOALA GENERALA","STEFAN CEL MARE",61,124411,0,3,500,359,274,85,353,6,600,241,244,109,
29,"NEAMT",270,124411,,363,0,"CARLIGI, SCOALA GENERALA","STEFAN CEL MARE",61,124411,0,3,427,302,242,60,293,9,500,198,242,51,
29,"NEAMT",270,124411,,364,0,"SOCI, SCOALA GENERALA","STEFAN CEL MARE",61,124411,0,3,304,249,191,58,248,1,422,173,161,87,
29,"NEAMT",270,124493,,365,0,"TARCAU, SCOALA GENERALA","TARCAU",63,124493,0,3,1520,955,825,130,946,9,1695,740,571,375,
29,"NEAMT",270,124493,,366,0,"STRAJA, CAMINUL CULTURAL","TARCAU",63,124493,0,3,514,368,306,62,366,2,598,230,193,173,
29,"NEAMT",270,124493,,367,0,"CAZACI, SCOALA GENERALA","TARCAU",63,124493,0,3,404,341,254,87,338,3,500,159,150,188,
29,"NEAMT",270,124493,,368,0,"BRATES, SCOALA GENERALA","TARCAU",63,124493,0,3,279,192,150,42,192,0,300,108,51,141,
29,"NEAMT",270,124563,,369,0,"TASCA, CAMINUL CULTURAL","TASCA",64,124563,0,3,1415,987,911,76,976,11,1586,599,559,417,
29,"NEAMT",270,124563,,370,0,"NEAGRA, SCOALA GENERALA","TASCA",64,124563,0,3,680,486,415,71,485,1,800,314,318,167,
29,"NEAMT",270,124616,,371,0,"TAZLAU, SCOALA GENERALA","TAZLAU",65,124616,0,3,1067,608,578,30,599,9,1200,592,390,209,
29,"NEAMT",270,124616,,372,0,"TAZLAU, CAMINUL CULTURAL","TAZLAU",65,124616,0,3,1334,804,744,60,794,10,1500,696,501,293,
29,"NEAMT",270,124634,,373,0,"TAMASENI, SCOALA GENERALA","TAMASENI",62,124634,0,3,1477,638,562,76,623,15,1700,1062,439,184,
29,"NEAMT",270,124634,,374,0,"TAMASENI, CAMINUL CULTURAL","TAMASENI",62,124634,0,3,693,366,314,52,360,6,800,434,278,82,
29,"NEAMT",270,124634,,375,0,"TAMASENI, GRADINITA","TAMASENI",62,124634,0,3,1107,603,546,57,586,17,1300,697,403,183,
29,"NEAMT",270,124634,,376,0,"ADJUDENI, SCOALA GENERALA","TAMASENI",62,124634,0,3,1375,664,554,110,636,28,1600,936,416,220,
29,"NEAMT",270,124634,,377,0,"ADJUDENI, ATELIER SCOALA","TAMASENI",62,124634,0,3,810,399,324,75,381,18,900,501,237,144,
29,"NEAMT",270,124634,,378,0,"ADJUDENI, GRADINITA","TAMASENI",62,124634,0,3,958,463,345,118,439,24,1100,637,294,145,
29,"NEAMT",270,124661,,379,0,"TIMISESTI, SCOALA GENERALA","TIMISESTI",67,124661,0,3,1112,698,619,79,687,11,1304,606,484,203,
29,"NEAMT",270,124661,,380,0,"DUMBRAVA, SCOALA GENERALA","TIMISESTI",67,124661,0,3,845,627,546,81,624,3,1000,373,496,128,
29,"NEAMT",270,124661,,381,0,"PLAIESU, SCOALA GENERALA","TIMISESTI",67,124661,0,3,600,439,392,47,438,1,700,261,307,131,
29,"NEAMT",270,124661,,382,0,"PREUTESTI, SCOALA GENERALA","TIMISESTI",67,124661,0,3,483,376,338,38,371,5,600,224,294,77,
29,"NEAMT",270,124723,,383,0,"TRIFESTI, SCOALA GENERALA","TRIFESTI",68,124723,0,3,1896,1047,936,111,1034,13,2100,1053,803,231,
29,"NEAMT",270,124723,,384,0,"TRIFESTI, SCOALA GENERALA NR.2","TRIFESTI",68,124723,0,3,696,531,406,125,524,7,800,269,359,165,
29,"NEAMT",270,124723,,385,0,"MIRON COSTIN ,SCOALA GENERALA NR.1","TRIFESTI",68,124723,0,3,897,653,527,126,647,6,996,343,522,125,
29,"NEAMT",270,124723,,386,0,"MIRON COSTIN, SCOALA GENERALA NR.2","TRIFESTI",68,124723,0,3,626,500,363,137,491,9,700,200,396,95,
29,"NEAMT",270,124750,,387,0,"TUPILATI, SCOALA GENERALA","TUPILATI",69,124750,0,3,1555,1082,909,173,1068,14,1700,618,775,293,
29,"NEAMT",270,124750,,388,0,"TOTOIESTI, SCOALA GENERALA","TUPILATI",69,124750,0,3,317,227,178,49,224,3,400,173,148,76,
29,"NEAMT",270,124803,,389,0,"TIBUCANI, SCOALA GENERALA NR.1","TIBUCANI",66,124803,0,3,1402,905,792,113,892,13,1599,694,670,222,
29,"NEAMT",270,124803,,390,0,"TIBUCANI, SCOALA GENERALA NR.3","TIBUCANI",66,124803,0,3,902,672,530,142,666,6,1000,328,482,184,
29,"NEAMT",270,124803,,391,0,"DAVIDENI, SCOALA GENERALA","TIBUCANI",66,124803,0,3,766,624,492,132,619,5,900,276,426,193,
29,"NEAMT",270,124803,,392,0,"TIBUCANII DE JOS, SCOALA GENERALA","TIBUCANI",66,124803,0,3,417,306,259,47,305,1,500,194,219,86,
29,"NEAMT",270,124849,,393,0,"URECHENI, SCOALA GENERALA NR.1","URECHENI",70,124849,0,3,1719,972,711,261,963,9,1900,928,753,210,
29,"NEAMT",270,124849,,394,0,"INGARESTI, SCOALA GENERALA","URECHENI",70,124849,0,3,714,536,436,100,528,8,800,264,397,131,
29,"NEAMT",270,124849,,395,0,"FUNDATURA, GRADINITA","URECHENI",70,124849,0,3,824,511,310,201,508,3,900,389,422,86,
29,"NEAMT",270,124885,,396,0,"VALEA URSULUI, SCOALA GENERALA","VALEA URSULUI",71,124885,0,3,862,442,347,95,437,5,1000,558,365,72,
29,"NEAMT",270,124885,,397,0,"BUCIUM, SCOALA GENERALA","VALEA URSULUI",71,124885,0,3,417,427,266,161,421,6,500,73,337,84,
29,"NEAMT",270,124885,,398,0,"CHILII, SCOALA GENERALA","VALEA URSULUI",71,124885,0,3,809,528,444,84,523,5,900,372,402,121,
29,"NEAMT",270,124885,,399,0,"GIURGENI, SCOALA GENERALA","VALEA URSULUI",71,124885,0,3,547,373,281,92,362,11,600,227,240,122,
29,"NEAMT",270,124885,,400,0,"MUNCELU DE JOS, SCOALA GENERALA","VALEA URSULUI",71,124885,0,3,233,248,126,122,239,9,300,52,187,52,
29,"NEAMT",270,124938,,401,0,"VIISOARA, SCOALA GENERALA","VIISOARA",73,124938,0,3,618,345,301,44,345,0,700,355,214,131,
29,"NEAMT",270,124938,,402,0,"BISTRITA, SCOALA GENERALA","VIISOARA",73,124938,0,3,1747,986,877,109,979,7,2000,1014,604,375,
29,"NEAMT",270,124938,,403,0,"VADURI, SCOALA GENERALA","VIISOARA",73,124938,0,3,1611,964,879,85,952,12,1800,836,667,285,
29,"NEAMT",270,124938,,404,0,"BISERICANI, SALA DE FESTIVITATI","VIISOARA",73,124938,0,3,60,339,29,310,329,10,399,60,185,144,
29,"NEAMT",270,125016,,405,0,"VANATORI-NEAMT, SCOALA GENERALA NR.1","VANATORI-NEAMT",72,125016,0,3,1484,788,611,177,784,4,1700,912,508,276,
29,"NEAMT",270,125016,,406,0,"UNGURENI, GRADINITA NR.2","VANATORI-NEAMT",72,125016,0,3,1153,743,594,149,734,9,1300,557,504,230,
29,"NEAMT",270,125016,,407,0,"VANATORI-NEAMT, SCOALA GENERALA NR.2","VANATORI-NEAMT",72,125016,0,3,1174,762,579,183,747,15,1300,538,565,182,
29,"NEAMT",270,125016,,408,0,"LUNCA, SCOALA GENERALA","VANATORI-NEAMT",72,125016,0,3,934,598,508,90,593,5,1100,502,429,164,
29,"NEAMT",270,125016,,409,0,"MANASTIREA NEAMT, SCOALA GENERALA","VANATORI-NEAMT",72,125016,0,3,164,214,92,122,211,3,400,186,146,65,
29,"NEAMT",270,125016,,410,0,"NEMTISOR, SCOALA GENERALA","VANATORI-NEAMT",72,125016,0,3,1263,916,792,124,905,11,1400,484,619,286,
29,"NEAMT",270,125016,,411,0,"MANASTIREA SIHASTRIA, SALA DE MESE","VANATORI-NEAMT",72,125016,0,3,67,180,20,160,163,17,300,120,89,74,
29,"NEAMT",270,125061,,412,0,"ZANESTI, SCOALA GENERALA NR.2","ZANESTI",74,125061,0,3,1712,914,786,128,897,17,1900,986,650,247,
29,"NEAMT",270,125061,,413,0,"ZANESTI, SCOALA GENERALA NR.1","ZANESTI",74,125061,0,3,1320,865,693,172,853,12,1500,635,612,241,
29,"NEAMT",270,125061,,414,0,"ZANESTI, SCOALA GENERALA NR.3","ZANESTI",74,125061,0,3,961,667,523,144,660,7,1100,433,511,149,
29,"NEAMT",270,125061,,415,0,"TRAIAN, SCOALA GENERALA","ZANESTI",74,125061,0,3,801,544,451,93,535,9,900,356,419,116,
29,"NEAMT",270,120726,,416,1,"PIATRA NEAMT, UM 01027","MUNICIPIUL PIATRA NEAMT",1,120726,1,1,0,431,0,431,409,22,600,169,249,160,
29,"NEAMT",270,120860,,417,1,"ROMAN, UM 0765","MUNICIPIUL ROMAN",2,120860,1,1,0,76,0,76,76,0,200,124,46,30,
29,"NEAMT",270,120860,,418,1,"ROMAN, UM 01386","MUNICIPIUL ROMAN",2,120860,1,1,0,76,0,76,76,0,200,124,47,29,
29,"NEAMT",270,120860,,419,1,"ROMAN, ANTON PANN, UM 01147","MUNICIPIUL ROMAN",2,120860,1,1,0,108,0,108,105,3,200,92,68,37,
29,"NEAMT",270,120860,,420,1,"ROMAN, STATIA CFR","MUNICIPIUL ROMAN",2,120860,1,1,0,263,0,263,249,14,300,37,135,114,
30,"OLT",289,125347,,1,0,"LICEUL RADU GRECEANU , STR. N. BALCESCU , TELEF 424710","MUNICIPIUL SLATINA",1,125347,1,1,2102,1019,949,70,999,20,2200,1181,680,319,
30,"OLT",289,125347,,2,0,"LICEUL RADU GRECEANU , STR. N. BALCESCU , TELEF 424710","MUNICIPIUL SLATINA",1,125347,1,1,2016,1031,964,67,1009,22,2200,1169,756,253,
30,"OLT",289,125347,,3,0,"SCOALA GENERALA NR. 1 , STR. ION MOROSANU NR. 2 , TELEF 422333","MUNICIPIUL SLATINA",1,125347,1,1,1850,1068,918,150,1053,15,2000,932,728,325,
30,"OLT",289,125347,,4,0,"LICEUL ION MINULESCU , STR. BASARABILOR NR. 33 , TELEF 422390","MUNICIPIUL SLATINA",1,125347,1,1,2221,1046,955,91,1020,26,2300,1254,604,416,
30,"OLT",289,125347,,5,0,"LICEUL ION MINULESCU , STR. BASARABILOR NR 33 , TELEF 422390","MUNICIPIUL SLATINA",1,125347,1,1,2482,1332,1227,105,1322,10,2600,1268,769,553,
30,"OLT",289,125347,,6,0,"SCOALA GENERALA NR. 2 , STR. ARINULUI NR. 2, TELEF 421518","MUNICIPIUL SLATINA",1,125347,1,1,1956,1026,949,77,1006,20,2100,1074,650,356,
30,"OLT",289,125347,,7,0,"SCOALA GENERALA NR. 2 , STR. ARINULUI NR. 2 , TELEF 421518","MUNICIPIUL SLATINA",1,125347,1,1,1986,962,894,68,958,4,2100,1138,498,460,
30,"OLT",289,125347,,8,0,"LICEUL NICOLAE TITULESCU , STR. ALEEA ROZELOR NR. 1, TELEF 439497","MUNICIPIUL SLATINA",1,125347,1,1,1547,739,667,72,734,5,1600,861,431,303,
30,"OLT",289,125347,,9,0,"LICEUL NICOLAE TITULESCU , STR. ALEEA ROZELOR NR. 1, TELEF 439497","MUNICIPIUL SLATINA",1,125347,1,1,1810,876,817,59,869,7,2000,1124,525,344,
30,"OLT",289,125347,,10,0,"LICEUL NICOLAE TITULESCU , STR. ALEEA ROZELOR NR. 1, TELEF 439497","MUNICIPIUL SLATINA",1,125347,1,1,2424,1250,1094,156,1243,7,2600,1350,767,476,
30,"OLT",289,125347,,11,0,"SCOALA GENERALA NR. 5 , STR. LIBERTATII NR. 5 , TELEF 433317","MUNICIPIUL SLATINA",1,125347,1,1,2001,1001,947,54,998,3,2200,1199,642,356,
30,"OLT",289,125347,,12,0,"SCOALA GENERALA NR. 5 , STR. LIBERTATII NR. 5 , TELEF 433317","MUNICIPIUL SLATINA",1,125347,1,1,1719,932,899,33,922,10,1800,868,610,312,
30,"OLT",289,125347,,13,0,"SCOALA GENERALA NR. 8 EUGEN IONESCU , STR. UNIRII NR. 1, TELEF 435470","MUNICIPIUL SLATINA",1,125347,1,1,1825,908,839,69,903,5,2000,1092,464,439,
30,"OLT",289,125347,,14,0,"SCOALA GENERALA NR. 8 EUGEN IONESCU , STR. UNIRII NR. 1, TELEF 435470","MUNICIPIUL SLATINA",1,125347,1,1,1572,771,726,45,750,21,1700,929,457,293,
30,"OLT",289,125347,,15,0,"SCOALA GENERALA NR. 8 EUGEN IONESCU , STR. UNIRII NR. 1, TELEF 435470","MUNICIPIUL SLATINA",1,125347,1,1,1602,777,738,39,770,7,1700,923,456,314,
30,"OLT",289,125347,,16,0,"SCOALA GENERALA NR. 10 , STR. ALEEA MUNCII NR. 6 , TELEF 433350","MUNICIPIUL SLATINA",1,125347,1,1,1459,684,645,39,675,9,1600,916,428,247,
30,"OLT",289,125347,,17,0,"SCOALA GENERALA NR. 10 , STR. ALEEA MUNCII NR. 6 , TELEF 433350","MUNICIPIUL SLATINA",1,125347,1,1,1369,661,634,27,657,4,1500,839,376,281,
30,"OLT",289,125347,,18,0,"SCOALA GENERALA NR. 7 , STR. ALEEA INFRATIRII NR. 6 , TELEF 433866","MUNICIPIUL SLATINA",1,125347,1,1,2341,1153,1093,60,1143,10,2500,1347,675,468,
30,"OLT",289,125347,,19,0,"SCOALA GENERALA NR. 7 , STR. ALEEA INFRATIRII NR. 6 , TELEF 433866","MUNICIPIUL SLATINA",1,125347,1,1,2201,1096,1036,60,1074,22,2300,1204,656,418,
30,"OLT",289,125347,,20,0,"GRUP SCOLAR ECONOMIC ADMINISTRATIV , STR. PRIMAVERII NR. 5 , TELEF 432507","MUNICIPIUL SLATINA",1,125347,1,1,1481,789,695,94,778,11,1500,711,502,276,
30,"OLT",289,125347,,21,0,"GRUP SCOLAR ECONOMIC ADMINISTRATIV , STR. PRIMAVERII NR. 5 , TELEF 432507","MUNICIPIUL SLATINA",1,125347,1,1,1534,762,667,95,750,12,1600,838,388,362,
30,"OLT",289,125347,,22,0,"LICEUL CU PROGRAM SPORTIV , STR. TOAMNEI NR. 10, TELEF 435182","MUNICIPIUL SLATINA",1,125347,1,1,2050,1174,934,240,1164,10,2194,1020,675,489,
30,"OLT",289,125347,,23,0,"LICEUL CU PROGRAM SPORTIV , STR. TOAMNEI NR. 10, TELEF 435182","MUNICIPIUL SLATINA",1,125347,1,1,1574,981,845,136,977,4,2000,1019,590,387,
30,"OLT",289,125347,,24,0,"LICEUL CU PROGRAM SPORTIV , STR. TOAMNEI NR. 10, TELEF 435182","MUNICIPIUL SLATINA",1,125347,1,1,1658,896,702,194,888,8,1800,904,546,342,
30,"OLT",289,125347,,25,0,"SCOALA GENERALA NR. 3 , STR. DRAGANESTI NR. 2 , TELEF 431478","MUNICIPIUL SLATINA",1,125347,1,1,2585,1204,1128,76,1195,9,2700,1496,645,550,
30,"OLT",289,125347,,26,0,"SCOALA GENERALA NR. 3 , STR. DRAGANESTI NR. 2 , TELEF 431478","MUNICIPIUL SLATINA",1,125347,1,1,1946,950,910,40,946,4,2100,1150,564,382,
30,"OLT",289,125347,,27,0,"SCOALA GENERALA NR. 3 , STR. DRAGANESTI NR. 2 , TELEF 431478","MUNICIPIUL SLATINA",1,125347,1,1,1868,904,867,37,898,6,2010,1106,489,409,
30,"OLT",289,125347,,28,0,"GRUP SCOLAR INDUSTRIAL METALURGIC , STR. EC. TEODOROIU NR. 64A, TELEF 431446","MUNICIPIUL SLATINA",1,125347,1,1,1623,798,702,96,795,3,1800,1002,423,372,
30,"OLT",289,125347,,29,0,"GRUP SCOLAR INDUSTRIAL METALURGIC , STR. EC. TEODOROIU NR. 64A, TELEF 431446","MUNICIPIUL SLATINA",1,125347,1,1,1683,841,785,56,838,3,1800,959,440,398,
30,"OLT",289,125347,,30,0,"SCOALA GENERALA NR. 11 CONSTANTIN BRANCOVEANU , STR. DRAGANESTI NR. 31 , TELEF 432271","MUNICIPIUL SLATINA",1,125347,1,1,2385,1233,1143,90,1220,13,2500,1267,597,623,
30,"OLT",289,125347,,31,0,"SCOALA GENERALA NR. 11 CONSTANTIN BRANCOVEANU , STR. DRAGANESTI NR. 31 , TELEF 433271","MUNICIPIUL SLATINA",1,125347,1,1,2228,1264,1164,100,1260,4,2400,1136,638,622,
30,"OLT",289,125347,,32,0,"SCOALA GENERALA NR. 11 CONSTANTIN BRANCOVEANU , STR. DRAGANESTI NR. 31(PLEVNEI), TELEF 433271","MUNICIPIUL SLATINA",1,125347,1,1,2260,1156,1108,48,1147,9,2400,1244,567,580,
30,"OLT",289,125347,,33,0,"SCOALA GENERALA NR. 6 CLOCOCIOV , STR. MANASTIRII NR. 39, TELEF 432955","MUNICIPIUL SLATINA",1,125347,1,1,931,559,497,62,545,14,1100,541,353,192,
30,"OLT",289,125347,,34,0,"GRUP SCOLAR INDUSTRIAL CONSTRUCTII MASINI (IPTAPA), STR. CIREASOV NR.19 , TELEF 436210","MUNICIPIUL SLATINA",1,125347,1,1,2135,1054,965,89,1050,4,2200,1146,547,503,
30,"OLT",289,125347,,35,0,"GRUP SCOLAR INDUSTRIAL CONSTRUCTII MASINI (IPTAPA), STR. CIREASOV NR. 19, TELEF 436210","MUNICIPIUL SLATINA",1,125347,1,1,1977,941,871,70,933,8,2100,1159,492,441,
30,"OLT",289,125347,,36,0,"SCOALA GENERALA CIREASOV","MUNICIPIUL SLATINA",1,125347,1,1,571,355,333,22,352,3,700,345,230,122,
30,"OLT",289,125347,,37,0,"SCOALA GENERALA SATU NOU","MUNICIPIUL SLATINA",1,125347,1,1,347,255,218,37,253,2,395,140,157,96,
30,"OLT",289,125347,,38,0,"SC. GEN. NR. 12 GEORGE POBORAN, B-DUL A.I. CUZA NR. 29A, TELEF 438090","MUNICIPIUL SLATINA",1,125347,1,1,903,456,419,37,454,2,1000,544,269,185,
30,"OLT",289,125347,,39,0,"SC. GEN. NR. 12 GEORGE POBORAN, B-DUL A.I. CUZA NR. 29A , TELEF 438090","MUNICIPIUL SLATINA",1,125347,1,1,1523,680,623,57,679,1,1600,920,371,308,
30,"OLT",289,125347,,40,1,"UM 0310 , STR. CAZARMII NR. 40","MUNICIPIUL SLATINA",1,125347,1,1,0,838,0,838,802,36,900,62,503,299,
30,"OLT",289,125347,,41,1,"UM 0217 , STR. TUNARI NR.1","MUNICIPIUL SLATINA",1,125347,1,1,170,195,162,33,192,3,200,5,111,81,
30,"OLT",289,125347,,42,1,"SPITALUL JUDETEAN OLT , STR. CRISAN NR. 9-11","MUNICIPIUL SLATINA",1,125347,1,1,0,730,0,730,723,7,1000,270,430,293,
30,"OLT",289,125472,,43,0,"LICEUL IONITA ASAN , B-DUL N. TITULESCU NR. 19","MUNICIPIUL CARACAL",2,125472,1,1,1697,933,866,67,920,13,1900,967,712,208,
30,"OLT",289,125472,,44,0,"GRADINITA CU PROGRAM NORMAL NR. 6 , B-DUL N. TITULESCU NR. 2","MUNICIPIUL CARACAL",2,125472,1,1,1705,840,792,48,831,9,1905,1065,655,176,
30,"OLT",289,125472,,45,0,"GRADINITA CU PROGRAM NORMAL NR. 4 , B-DUL N. TITULESCU NR. 46","MUNICIPIUL CARACAL",2,125472,1,1,1675,922,824,98,910,12,1900,978,637,273,
30,"OLT",289,125472,,46,0,"SCOALA GENERALA NR. 6 , STR. VASILE ALECSANDRI NR. 11","MUNICIPIUL CARACAL",2,125472,1,1,1996,1012,818,194,1004,8,2095,1083,724,280,
30,"OLT",289,125472,,47,0,"LICEUL MIHAI VITEAZUL (CLUBUL SPORTIV) , STR. PLEVNEI NR. 15","MUNICIPIUL CARACAL",2,125472,1,1,1443,796,633,163,786,10,1600,804,506,280,
30,"OLT",289,125472,,48,0,"GRUP SCOLAR INDULTRIAL , STR. AL. 1 DECEMBRIE 1918 , NR.9","MUNICIPIUL CARACAL",2,125472,1,1,1824,789,695,94,784,5,1997,1208,520,264,
30,"OLT",289,125472,,49,0,"GRADINITA CU PROGRAM PRELUNGIT NR. 3 , STR. AL. CRESEI NR. 6","MUNICIPIUL CARACAL",2,125472,1,1,1964,881,791,90,879,2,2000,1119,523,356,
30,"OLT",289,125472,,50,0,"CENTRUL DE PLASAMENT OPTIMISTII , STR. GEN. MAGHERU NR. 13A","MUNICIPIUL CARACAL",2,125472,1,1,1994,1031,888,143,1025,6,2100,1069,656,369,
30,"OLT",289,125472,,51,0,"SCOALA GENERALA NR. 7 , STR. GEN. MAGHERU NR. 13","MUNICIPIUL CARACAL",2,125472,1,1,1763,867,733,134,862,5,1900,1033,586,276,
30,"OLT",289,125472,,52,0,"SCOALA GENERALA NR. 2 , STR. ELIADE RADULESCU NR.2","MUNICIPIUL CARACAL",2,125472,1,1,2039,1063,973,90,1053,10,2100,1037,714,339,
30,"OLT",289,125472,,53,0,"GRADINITA CU PROGRAM PRELUNGIT NR. 4 , STR. IANCU JIANU NR. 9","MUNICIPIUL CARACAL",2,125472,1,1,1883,920,817,103,913,7,2000,1080,660,253,
30,"OLT",289,125472,,54,0,"BIROUL MUNICIPAL DE STATISTICA, STR. IANCU JIANU NR.23","MUNICIPIUL CARACAL",2,125472,1,1,2207,1094,977,117,1085,9,2300,1206,709,376,
30,"OLT",289,125472,,55,0,"CASA DE CULTURA RADU SERBAN , STR. PIATA VICTORIEI NR. 8","MUNICIPIUL CARACAL",2,125472,1,1,1737,915,781,134,906,9,1800,885,643,263,
30,"OLT",289,125472,,56,0,"SCOALA GENERALA NR. 5 , STR. RADU CALOMFIRESCU NR. 7","MUNICIPIUL CARACAL",2,125472,1,1,1767,945,877,68,935,10,1900,955,656,279,
30,"OLT",289,125472,,57,0,"SCOALA GENERALA NR. 4 , STR. GHEORGHE DOJA NR. 62","MUNICIPIUL CARACAL",2,125472,1,1,1749,920,873,47,913,7,1900,980,597,316,
30,"OLT",289,125472,,58,0,"SCOALA GENERALA NR. 3 , STR. GHEORGHE DOJA NR.93","MUNICIPIUL CARACAL",2,125472,1,1,1866,1075,1017,58,1049,26,2000,925,779,270,
30,"OLT",289,125472,,59,0,"SCOALA GENERALA NR. 1, STR. MIHAI VITEAZU NR. 2","MUNICIPIUL CARACAL",2,125472,1,1,1706,944,856,88,937,7,1800,856,659,278,
30,"OLT",289,125472,,60,1,"UM 01841 , STR. INFRATIRII NR.7","MUNICIPIUL CARACAL",2,125472,1,1,0,518,0,518,506,12,600,82,291,215,
30,"OLT",289,125472,,61,1,"UM 02246 , STR. GENERAL MAGHERU NR. 94","MUNICIPIUL CARACAL",2,125472,1,1,0,138,0,138,137,1,200,62,79,58,
30,"OLT",289,125418,,62,0,"SCOALA GENERALA NR. 3 , STR. CRINILOR NR. 1","ORAS BALS",3,125418,2,1,988,595,563,32,588,7,1000,405,350,238,
30,"OLT",289,125418,,63,0,"SCOALA GENERALA NR. 2 VARTINA, STR. TUDOR VLADIMIRESCU NR. 144","ORAS BALS",3,125418,2,1,1261,813,762,51,792,21,1300,487,516,276,
30,"OLT",289,125418,,64,0,"SCOALA PROFESIONALA  SPECIALA NR. 1, STR. CIRESULUI 100","ORAS BALS",3,125418,2,1,945,565,522,43,560,5,1000,435,361,199,
30,"OLT",289,125418,,65,0,"SCOALA AJUTATOARE , STR.PLOPULUI NR. 56B","ORAS BALS",3,125418,2,1,1861,1055,967,88,1044,11,2000,945,770,274,
30,"OLT",289,125418,,66,0,"BIBLIOTECA, STR. NICOLAE BALCESCU NR. 11","ORAS BALS",3,125418,2,1,3264,1741,1584,157,1718,23,3439,1698,1121,597,
30,"OLT",289,125418,,67,0,"SCOALA GENERALA NR. 5 , STR. NICOLAE BALCESCU NR. 51","ORAS BALS",3,125418,2,1,3245,1523,1361,162,1512,11,3500,1977,894,618,
30,"OLT",289,125418,,68,0,"GRADINITA NR. 9 , STR. NICOLAE BALCESCU NR. 185","ORAS BALS",3,125418,2,1,2684,1409,1062,347,1388,21,3000,1591,796,592,
30,"OLT",289,125418,,69,0,"GRUP SCOLAR INDUSTRIAL SMR, STR.NICOLAE BALCESCU NR. 213","ORAS BALS",3,125418,2,1,3487,1686,1496,190,1675,11,4000,2314,919,756,
30,"OLT",289,125542,,70,0,"SCOALA GENERALA NR. 1 , STR. NICOLAE TITULESCU NR. 70B","ORAS CORABIA",4,125542,2,1,2121,1034,973,61,1018,16,2350,1316,791,227,
30,"OLT",289,125542,,71,0,"SCOALA GENERALA NR. 2 , STR.DUMITRU BUZDUN NR. 1","ORAS CORABIA",4,125542,2,1,1305,922,705,217,906,16,1500,578,674,232,
30,"OLT",289,125542,,72,0,"SCOALA GENERALA NR. 3 , STR. CUZA VODA NR. 71","ORAS CORABIA",4,125542,2,1,1936,858,780,78,843,15,2150,1292,558,285,
30,"OLT",289,125542,,73,0,"SCOALA GENERALA NR. 3 , STR. TUDOR VLADIMIRESCU NR. 77","ORAS CORABIA",4,125542,2,1,1723,785,738,47,780,5,1950,1165,559,221,
30,"OLT",289,125542,,74,0,"LICEUL TEORETIC , STR. 1 MAI NR. 5","ORAS CORABIA",4,125542,2,1,2464,1098,991,107,1090,8,2650,1552,779,311,
30,"OLT",289,125542,,75,0,"SCOALA GENERALA NR. 4 , STRADA STEFAN CEL MARE NR. 49","ORAS CORABIA",4,125542,2,1,2107,1091,1026,65,1071,20,2350,1259,803,268,
30,"OLT",289,125542,,76,0,"SCOALA CORABIA VECHE , STR. CARPATI NR. 2","ORAS CORABIA",4,125542,2,1,2190,923,828,95,913,10,2400,1477,570,343,
30,"OLT",289,125542,,77,0,"SCOALA GENERALA CELEI, STR.LIBERTATII NR. 1","ORAS CORABIA",4,125542,2,1,1685,877,821,56,859,18,1800,923,571,288,
30,"OLT",289,125542,,78,0,"SCOALA GENERALA VARTOPU","ORAS CORABIA",4,125542,2,1,509,324,256,68,317,7,550,226,196,121,
30,"OLT",289,125542,,79,0,"SCOALA GENERALA TUDOR VLADIMIRESCU","ORAS CORABIA",4,125542,2,1,571,347,302,45,341,6,600,253,210,131,
30,"OLT",289,125542,,80,0,"SCOALA GENERALA SILISTOARA","ORAS CORABIA",4,125542,2,1,526,337,313,24,335,2,600,263,249,86,
30,"OLT",289,125622,,81,0,"LICEUL TUDOR VLADIMIRESCU , STR. N. TITULESCU NR.113A","ORAS DRAGANESTI-OLT",5,125622,2,1,3026,1712,1559,153,1699,13,3500,1788,782,917,
30,"OLT",289,125622,,82,0,"SCOALA GENERALA NR. 2 , STR. N.TITULESCU NR. 308","ORAS DRAGANESTI-OLT",5,125622,2,1,2310,1327,1204,123,1308,19,2500,1173,620,688,
30,"OLT",289,125622,,83,0,"LICEUL TUDOR VLADIMIRESCU , STR. N. TITULESCU NR. 58A","ORAS DRAGANESTI-OLT",5,125622,2,1,1962,1225,1125,100,1205,20,2000,775,673,532,
30,"OLT",289,125622,,84,0,"CAMINUL CULTURAL COMANI, STR. GEN. TELUSANU NR. 52","ORAS DRAGANESTI-OLT",5,125622,2,1,2667,1669,1557,112,1648,21,2900,1231,800,848,
30,"OLT",289,128105,,85,0,"CLADIREA MUZEULUI PIATRA-OLT","ORAS PIATRA-OLT",6,128105,2,1,1645,1106,935,171,1092,14,1800,694,691,401,
30,"OLT",289,128105,,86,0,"SCOALA PRIMARA BISTRITA-NOUA","ORAS PIATRA-OLT",6,128105,2,1,490,363,298,65,354,9,600,237,211,143,
30,"OLT",289,128105,,87,0,"SCOALA PRIMARA ENOSESTI","ORAS PIATRA-OLT",6,128105,2,1,262,235,179,56,233,2,395,160,179,54,
30,"OLT",289,128105,,88,0,"SCOALA GIMNAZIALA PIATRA","ORAS PIATRA-OLT",6,128105,2,1,1833,1108,987,121,1099,9,1800,692,734,365,
30,"OLT",289,128105,,89,0,"FOSTA CLADIRE SCOALA PRIMARA CRIVA DE SUS","ORAS PIATRA-OLT",6,128105,2,1,687,660,415,245,649,11,800,140,433,216,
30,"OLT",289,128711,,90,0,"GRUP SCOLAR AGROIND SCORNICESTI","ORAS SCORNICESTI",7,128711,2,1,3466,3085,2848,237,3064,21,3600,515,1932,1132,
30,"OLT",289,128711,,91,0,"SCOALA GENERALA MARGINENI","ORAS SCORNICESTI",7,128711,2,1,1427,1207,1091,116,1116,91,1550,343,704,412,
30,"OLT",289,128711,,92,0,"SCOALA GENERALA BIRCII-CHITEASCA","ORAS SCORNICESTI",7,128711,2,1,1086,899,797,102,894,5,1250,351,636,258,
30,"OLT",289,128711,,93,0,"SCOALA GENERALA MOGOSESTI","ORAS SCORNICESTI",7,128711,2,1,550,570,512,58,549,21,600,30,428,121,
30,"OLT",289,128711,,94,0,"SCOALA GENERALA CONSTANTINESTI","ORAS SCORNICESTI",7,128711,2,1,427,282,218,64,281,1,450,168,141,140,
30,"OLT",289,128711,,95,0,"SCOALA GENERALA NEGRENI-ISAROAIA","ORAS SCORNICESTI",7,128711,2,1,1123,768,694,74,744,24,1200,432,432,312,
30,"OLT",289,128711,,96,0,"SCOALA GENERALA TEIUS-RUSCIORI","ORAS SCORNICESTI",7,128711,2,1,472,428,371,57,423,5,500,72,265,158,
30,"OLT",289,128711,,97,0,"SCOALA GENERALA SUICA","ORAS SCORNICESTI",7,128711,2,1,250,197,161,36,196,1,300,103,91,105,
30,"OLT",289,125677,,98,0,"SCOALA GENERALA BALDOVINESTI","BALDOVINESTI",9,125677,0,3,990,596,526,70,589,7,1017,421,390,199,
30,"OLT",289,125677,,99,0,"SCOALA GENERALA BALEASA","BALDOVINESTI",9,125677,0,3,815,665,600,65,657,8,840,175,510,147,
30,"OLT",289,125677,,100,0,"CAMINUL CULTURAL GAVANESTI","BALDOVINESTI",9,125677,0,3,765,666,636,30,639,27,790,124,444,195,
30,"OLT",289,125677,,101,0,"SCOALA GENERALA BROSTENI","BALDOVINESTI",9,125677,0,3,329,299,246,53,297,2,354,55,155,142,
30,"OLT",289,125659,,102,0,"CAMINUL CULTURAL BABICIU","BABICIU",8,125659,0,3,1965,1591,1474,117,1568,23,2100,509,1256,312,
30,"OLT",289,125757,,103,0,"SCOALA GENERALA BARASTI DE VEDE","BARASTI",10,125757,0,3,941,704,536,168,700,4,1091,387,349,351,
30,"OLT",289,125757,,104,0,"SCOALA GENERALA BARASTI-CEPTURI","BARASTI",10,125757,0,3,622,461,351,110,448,13,672,211,277,171,
30,"OLT",289,125757,,105,0,"FERMA FOST CAP SATUL MOTOESTI","BARASTI",10,125757,0,3,105,115,70,45,112,3,137,22,76,36,
30,"OLT",289,125846,,106,0,"SCOALA GENERALA BRANET","BARZA",11,125846,0,3,1213,882,805,77,870,12,1200,318,555,315,
30,"OLT",289,125846,,107,0,"SCOALA GENERALA BARZA","BARZA",11,125846,0,3,827,654,611,43,646,8,900,246,466,180,
30,"OLT",289,125873,,108,0,"CAMINUL CULTURAL BOBICESTI","BOBICESTI",12,125873,0,3,1484,831,722,109,823,8,1500,669,556,267,
30,"OLT",289,125873,,109,0,"SCOALA GENERALA LEOTESTI","BOBICESTI",12,125873,0,3,1195,762,661,101,754,8,1400,638,426,328,
30,"OLT",289,125962,,110,0,"SCOALA GENERALA NR. 1 BRASTAVATU","BRASTAVATU",14,125962,0,3,1565,785,695,90,775,10,1724,939,358,417,
30,"OLT",289,125962,,111,0,"CAMINUL CULTURAL BRASTAVATU","BRASTAVATU",14,125962,0,3,1541,776,677,99,760,16,1700,924,416,344,
30,"OLT",289,125962,,112,0,"SCOALA GENERALA CRUSOV","BRASTAVATU",14,125962,0,3,1166,669,592,77,660,9,1284,615,460,200,
30,"OLT",289,125999,,113,0,"SCOALA GENERALA BREBENI","BREBENI",15,125999,0,3,2106,2000,1802,198,1991,9,2300,300,1389,602,
30,"OLT",289,126022,,114,0,"SCOALA GENERALA BRANCOVENI","BRANCOVENI",13,126022,0,3,1592,934,843,91,930,4,1600,666,616,314,
30,"OLT",289,126022,,115,0,"SCOALA GENERALA MAGHERU-MARGHIENI","BRANCOVENI",13,126022,0,3,1051,753,605,148,750,3,1300,547,466,284,
30,"OLT",289,126077,,116,0,"SCOALA GENERALA BUCINISU","BUCINISU",16,126077,0,3,1903,1210,1061,149,1202,8,2103,893,862,340,
30,"OLT",289,126102,,117,0,"CAMINUL CULTURAL CEZIENI","CEZIENI",18,126102,0,3,1213,845,775,70,836,9,1300,455,650,186,
30,"OLT",289,126102,,118,0,"SCOALA GENERALA CORLATESTI","CEZIENI",18,126102,0,3,585,405,350,55,400,5,700,295,300,100,
30,"OLT",289,126148,,119,0,"SCOALA GENERALA CILIENI","CILIENI",19,126148,0,3,2965,2037,1888,149,1998,39,3300,1263,1541,457,
30,"OLT",289,126166,,120,0,"SCOALA GENERALA CARLOGANI","CARLOGANI",17,126166,0,3,1381,833,730,103,826,7,1400,567,478,348,
30,"OLT",289,126166,,121,0,"SCOALA GENERALA CEPARI","CARLOGANI",17,126166,0,3,826,627,465,162,623,4,1087,460,432,191,
30,"OLT",289,126228,,122,0,"SCOALA GENERALA COLONESTI","COLONESTI",20,126228,0,3,820,927,805,122,863,64,950,23,686,177,
30,"OLT",289,126228,,123,0,"SCOALA GENERALA MARUNTEI","COLONESTI",20,126228,0,3,468,640,458,182,468,172,700,60,433,35,
30,"OLT",289,126228,,124,0,"SCOALA GENERALA VLAICI","COLONESTI",20,126228,0,3,363,490,353,137,400,90,550,60,371,29,
30,"OLT",289,126326,,125,0,"SCOALA GENERALA CORBU","CORBU",21,126326,0,3,931,575,454,121,565,10,999,424,415,150,
30,"OLT",289,126326,,126,0,"SCOALA GENERALA BUZESTI","CORBU",21,126326,0,3,947,609,521,88,604,5,999,390,381,223,
30,"OLT",289,126380,,127,0,"SCOALA GENERALA COTEANA","COTEANA",22,126380,0,3,2157,1637,1438,199,1619,18,2400,763,1196,423,
30,"OLT",289,126406,,128,0,"CAMINUL CULTURAL CRAMPOIA","CRAMPOIA",23,126406,0,3,2599,1334,1221,113,1315,19,2800,1466,678,637,
30,"OLT",289,126406,,129,0,"SCOALA GENERALA CRAMPOIA - BUTA","CRAMPOIA",23,126406,0,3,453,390,272,118,385,5,500,110,187,198,
30,"OLT",289,126503,,130,0,"CAMINUL CULTURAL CUNGREA","CUNGREA",24,126503,0,3,1096,476,380,96,472,4,1000,524,274,198,
30,"OLT",289,126503,,131,0,"SCOALA GENERALA SPATARU","CUNGREA",24,126503,0,3,245,252,161,91,248,4,400,148,148,100,
30,"OLT",289,126503,,132,0,"SCOALA GENERALA OTESTII DE SUS","CUNGREA",24,126503,0,3,666,503,319,184,502,1,800,297,344,158,
30,"OLT",289,126433,,133,0,"CAMINUL CULTURAL CURTISOARA","CURTISOARA",25,126433,0,3,1389,814,639,175,807,7,1500,686,503,304,
30,"OLT",289,126433,,134,0,"SCOALA GENERALA DOBROTINET","CURTISOARA",25,126433,0,3,1226,748,611,137,743,5,1350,602,434,309,
30,"OLT",289,126433,,135,0,"SCOALA GENERALA PROASPETI","CURTISOARA",25,126433,0,3,819,553,459,94,547,6,850,297,289,258,
30,"OLT",289,126585,,136,0,"SCOALA GENERALA DANEASA","DANEASA",26,126585,0,3,1184,708,615,93,701,7,1328,620,305,396,
30,"OLT",289,126585,,137,0,"SCOALA GENERALA BERINDEI-CIOFLAN","DANEASA",26,126585,0,3,1043,640,556,84,632,8,1128,488,389,243,
30,"OLT",289,126585,,138,0,"SCOALA GENERALA PESTRA","DANEASA",26,126585,0,3,508,382,327,55,377,5,548,166,161,216,
30,"OLT",289,126585,,139,0,"SCOALA GENERALA ZANOAGA","DANEASA",26,126585,0,3,373,319,260,59,319,0,396,77,191,128,
30,"OLT",289,126647,,140,0,"CAMINUL CULTURAL DEVESELU","DEVESELU",27,126647,0,3,1664,914,843,71,904,10,1700,786,532,372,
30,"OLT",289,126647,,141,0,"SCOALA GENERALA COMANCA","DEVESELU",27,126647,0,3,1057,656,563,93,650,6,1100,444,416,234,
30,"OLT",289,126674,,142,0,"SCOALA GENERALA CURTISOARA","DOBRETU",28,126674,0,3,1183,1030,827,203,991,39,1300,270,747,244,
30,"OLT",289,126718,,143,0,"SCOALA GENERALA DOBROSLOVENI","DOBROSLOVENI",29,126718,0,3,1680,936,869,67,914,22,1850,914,694,220,
30,"OLT",289,126718,,144,0,"SCOALA GENERALA RESCA","DOBROSLOVENI",29,126718,0,3,1002,632,571,61,623,9,1100,468,445,178,
30,"OLT",289,126718,,145,0,"SCOALA GENERALA FRASINETU","DOBROSLOVENI",29,126718,0,3,401,305,270,35,304,1,450,145,193,111,
30,"OLT",289,126772,,146,0,"CAMINUL CULTURAL DOBROTEASA","DOBROTEASA",30,126772,0,3,1668,1089,910,179,1077,12,1800,711,670,407,
30,"OLT",289,126825,,147,0,"SCOALA GENERALA OSICA DE JOS","DOBRUN",31,126825,0,3,1297,923,788,135,912,11,1500,577,635,277,
30,"OLT",289,126825,,148,0,"SCOALA GENERALA DOBRUN","DOBRUN",31,126825,0,3,865,743,616,127,732,11,1000,257,593,139,
30,"OLT",289,125490,,149,0,"SCOALA GENERALA DRAGHICENI","DRAGHICENI",32,125490,0,3,1522,1308,1239,69,1302,6,1700,392,1028,274,
30,"OLT",289,126905,,150,0,"SCOALA GENERALA FAGETELU","FAGETELU",33,126905,0,3,687,580,417,163,574,6,700,120,399,175,
30,"OLT",289,126905,,151,0,"SCOALA GENERALA CHILIA","FAGETELU",33,126905,0,3,364,326,203,123,322,4,400,74,232,90,
30,"OLT",289,126978,,152,0,"SCOALA GENERALA FALCOIU","FALCOIU",34,126978,0,3,2101,1310,1157,153,1295,15,2300,990,1050,245,
30,"OLT",289,126978,,153,0,"SCOALA GENERALA CIOROIU","FALCOIU",34,126978,0,3,1163,1043,858,185,1018,25,1300,257,755,263,
30,"OLT",289,127019,,154,0,"CAMINUL CULTURAL FARCASELE","FARCASELE",35,127019,0,3,1381,829,777,52,816,13,1495,666,585,231,
30,"OLT",289,127019,,155,0,"SCOALA GENERALA HOTARANI","FARCASELE",35,127019,0,3,992,624,552,72,616,8,1205,581,424,192,
30,"OLT",289,127064,,156,0,"SCOALA GENERALA GANEASA","GANEASA",36,127064,0,3,1300,855,729,126,840,15,1300,445,498,342,
30,"OLT",289,127064,,157,0,"SCOALA GENERALA DRANOVATU","GANEASA",36,127064,0,3,802,464,322,142,459,5,1000,536,236,223,
30,"OLT",289,127064,,158,0,"SCOALA GENERALA IZVORU","GANEASA",36,127064,0,3,642,482,320,162,476,6,1000,518,267,209,
30,"OLT",289,127126,,159,0,"SCOALA GENERALA GIUVARASTI","GIUVARASTI",38,127126,0,3,2141,1265,1166,99,1253,12,2300,1035,793,460,
30,"OLT",289,125588,,160,0,"SCOALA GENERALA GARCOV","GARCOV",37,125588,0,3,1297,704,639,65,699,5,1300,596,468,231,
30,"OLT",289,125588,,161,0,"SCOALA GENERALA URSA","GARCOV",37,125588,0,3,832,578,517,61,565,13,1004,426,348,217,
30,"OLT",289,127144,,162,0,"SCOALA GENERALA GOSTAVATU","GOSTAVATU",39,127144,0,3,1523,858,747,111,851,7,1600,742,635,216,
30,"OLT",289,127144,,163,0,"SCOALA GENERALA SLAVENI","GOSTAVATU",39,127144,0,3,1229,824,727,97,819,5,1400,576,618,201,
30,"OLT",289,127171,,164,0,"SCOALA GENERALA GRADINARI","GRADINARI",40,127171,0,3,1563,1109,902,207,1099,10,1500,391,933,166,
30,"OLT",289,127171,,165,0,"SCOALA GENERALA SATU NOU","GRADINARI",40,127171,0,3,239,230,154,76,228,2,500,270,136,92,
30,"OLT",289,127224,,166,0,"SCOALA GENERALA GROJDIBODU","GROJDIBODU",41,127224,0,3,1873,1101,975,126,1079,22,2000,899,756,323,
30,"OLT",289,127224,,167,0,"SCOALA GENERALA HOTARU","GROJDIBODU",41,127224,0,3,914,726,607,119,715,11,998,272,492,223,
30,"OLT",289,127251,,168,0,"CAMINUL CULTURAL IANCA","IANCA",42,127251,0,3,2500,1398,1274,124,1374,24,2500,1102,826,548,
30,"OLT",289,127251,,169,0,"SCOALA GENERALA POTELU","IANCA",42,127251,0,3,1144,735,609,126,724,11,1504,769,537,187,
30,"OLT",289,127288,,170,0,"SCOALA GENERALA NR. 1 IANCU JIANU","IANCU JIANU",43,127288,0,3,1616,914,784,130,900,14,1700,786,562,338,
30,"OLT",289,127288,,171,0,"LICEUL TEORETIC IANCU JIANU","IANCU JIANU",43,127288,0,3,1200,683,606,77,673,10,1300,617,419,254,
30,"OLT",289,127288,,172,0,"SCOALA GENERALA DOBRICENI","IANCU JIANU",43,127288,0,3,806,490,429,61,477,13,900,410,296,181,
30,"OLT",289,127322,,173,0,"SCOALA GENERALA ICOANA","ICOANA",44,127322,0,3,820,415,342,73,408,7,700,285,214,194,
30,"OLT",289,127322,,174,0,"SCOALA GENERALA URSOAIA","ICOANA",44,127322,0,3,610,430,372,58,419,11,700,270,202,217,
30,"OLT",289,127322,,175,0,"SCOALA GENERALA FLORU","ICOANA",44,127322,0,3,481,351,315,36,345,6,700,349,229,116,
30,"OLT",289,127368,,176,0,"SEDIUL FOSTULUI CAP IZBICENI","IZBICENI",45,127368,0,3,2355,1032,941,91,1024,8,2200,1168,626,398,
30,"OLT",289,127368,,177,0,"SCOALA GENERALA IZBICENI","IZBICENI",45,127368,0,3,1710,1087,838,249,1082,5,2200,1113,659,423,
30,"OLT",289,127386,,178,0,"SCOALA GENERALA IZVOARELE","IZVOARELE",46,127386,0,3,1577,1352,1216,136,1332,20,1500,148,649,683,
30,"OLT",289,127386,,179,0,"SCOALA GENERALA ALIMANESTI","IZVOARELE",46,127386,0,3,1432,1431,1098,333,1399,32,1800,369,769,630,
30,"OLT",289,127411,,180,0,"CAMINUL CULTURAL LELEASCA","LELEASCA",47,127411,0,3,741,409,330,79,406,3,750,341,305,101,
30,"OLT",289,127411,,181,0,"SCOALA GENERALA URSI","LELEASCA",47,127411,0,3,518,348,227,121,345,3,550,202,235,110,
30,"OLT",289,127411,,182,0,"SCOALA GENERALA TONESTI","LELEASCA",47,127411,0,3,276,315,164,151,314,1,400,85,221,93,
30,"OLT",289,127493,,183,0,"SCOALA GENERALA MARUNTEI","MARUNTEI",48,127493,0,3,2188,1208,1065,143,1198,10,2300,1092,695,503,
30,"OLT",289,127493,,184,0,"SCOALA GENERALA BALANESTI","MARUNTEI",48,127493,0,3,1191,799,587,212,790,9,1400,601,488,302,
30,"OLT",289,127536,,185,0,"SCOALA GENERALA MIHAESTI","MIHAESTI",49,127536,0,3,1023,571,508,63,564,7,1100,529,408,156,
30,"OLT",289,127536,,186,0,"SCOALA GENERALA BUSCA","MIHAESTI",49,127536,0,3,723,545,452,93,541,4,800,255,335,206,
30,"OLT",289,127563,,187,0,"GRADINITA DE COPII ULMI","MILCOV",50,127563,0,3,527,357,277,80,355,2,600,243,202,153,
30,"OLT",289,127563,,188,0,"SCOALA GENERALA IPOTESTI","MILCOV",50,127563,0,3,1086,670,552,118,662,8,1200,530,377,285,
30,"OLT",289,127563,,189,0,"SCOALA GENERALA MILCOV DEAL","MILCOV",50,127563,0,3,573,365,269,96,363,2,600,235,235,128,
30,"OLT",289,127625,,190,0,"CAMINUL CULTURAL MORUNGLAV","MORUNGLAV",51,127625,0,3,1412,927,825,102,848,79,1530,603,555,293,
30,"OLT",289,127625,,191,0,"SCOALA GENERALA MORUNESTI","MORUNGLAV",51,127625,0,3,603,436,398,38,430,6,670,234,333,97,
30,"OLT",289,126825,,192,0,"SCOALA GENERALA ROSIENI","DOBRUN",31,126825,0,3,459,367,321,46,360,7,500,133,279,81,
30,"OLT",289,127625,,193,0,"SCOALA GENERALA BARASTI","MORUNGLAV",51,127625,0,3,358,294,244,50,291,3,400,106,220,71,
30,"OLT",289,127689,,194,0,"SCOALA GENERALA MOVILENI","MOVILENI",52,127689,0,3,1987,988,881,107,972,16,2100,1112,558,414,
30,"OLT",289,127689,,195,0,"SCOALA GENERALA BACEA","MOVILENI",52,127689,0,3,1113,780,627,153,765,15,1300,520,377,388,
30,"OLT",289,127714,,196,0,"SCOALA GENERALA NICOLAE TITULESCU","NICOLAE TITULESCU",53,127714,0,3,1185,762,626,136,757,5,1300,538,525,232,
30,"OLT",289,127714,,197,0,"SCOALA GENERALA GHIMPETENI","NICOLAE TITULESCU",53,127714,0,3,1275,729,600,129,712,17,1400,671,348,364,
30,"OLT",289,127750,,198,0,"SCOALA GENERALA OBARSIA VECHE","OBARSIA",54,127750,0,3,1129,739,649,90,736,3,1240,501,560,176,
30,"OLT",289,127750,,199,0,"SCOALA GENERALA OBARSIA NOUA","OBARSIA",54,127750,0,3,1108,822,724,98,816,6,1250,428,544,272,
30,"OLT",289,127750,,200,0,"SCOALA GENERALA CAMPUL PARULUI","OBARSIA",54,127750,0,3,369,263,230,33,260,3,412,149,182,78,
30,"OLT",289,127812,,201,0,"CAMINUL CULTURAL OBOGA","OBOGA",55,127812,0,3,1608,668,585,83,657,11,1700,1032,316,341,
30,"OLT",289,127812,,202,0,"GRADINITA DE COPII OBOGA - CALUI","OBOGA",55,127812,0,3,1386,774,583,191,752,22,1600,826,490,262,
30,"OLT",289,127858,,203,0,"CAMINUL CULTURAL OPORELU","OPORELU",56,127858,0,3,1098,810,687,123,803,7,1200,390,413,390,
30,"OLT",289,127901,,204,0,"SCOALA GENERALA OPTASI-MAGURA","OPTASI-MAGURA",57,127901,0,3,1137,1074,955,119,1062,12,1200,126,887,175,
30,"OLT",289,127901,,205,0,"SCOALA GENERALA VITANESTI","OPTASI-MAGURA",57,127901,0,3,920,848,715,133,839,9,1000,152,570,269,
30,"OLT",289,127901,,206,0,"SCOALA GENERALA BRANISTE","OPTASI-MAGURA",57,127901,0,3,949,824,674,150,818,6,1000,176,608,210,
30,"OLT",289,127938,,207,0,"GRADINITA DE COPII ORLEA","ORLEA",58,127938,0,3,2309,1418,1235,183,1393,25,2500,1082,948,445,
30,"OLT",289,127938,,208,0,"GRADINITA DE COPII GURA PADINII","ORLEA",58,127938,0,3,1528,1070,932,138,1052,18,1700,630,627,425,
30,"OLT",289,127983,,209,0,"CAMINUL CULTURAL OSICA DE SUS","OSICA DE SUS",59,127983,0,3,2980,2531,2418,113,2519,12,3400,869,1994,525,
30,"OLT",289,127983,,210,0,"SCOALA GENERALA GRECI","OSICA DE SUS",59,127983,0,3,1175,1007,842,165,995,12,1400,393,754,241,
30,"OLT",289,128052,,211,0,"CAMINUL CULTURAL PERIETI","PERIETI",61,128052,0,3,2325,1868,1650,218,1852,16,2100,232,1477,375,
30,"OLT",289,128052,,212,0,"SCOALA GENERALA BALTENI","PERIETI",61,128052,0,3,1449,1266,1163,103,1253,13,1400,134,833,420,
30,"OLT",289,128178,,213,0,"SCOALA GENERALA NR. 1 PARSCOVENI","PARSCOVENI",60,128178,0,3,1593,923,753,170,903,20,1800,877,578,325,
30,"OLT",289,128178,,214,0,"SCOALA GENERALA SOPARLITA","PARSCOVENI",60,128178,0,3,1124,722,599,123,716,6,1200,478,465,251,
30,"OLT",289,128178,,215,0,"SCOALA GENERALA OLARI","PARSCOVENI",60,128178,0,3,1004,667,517,150,657,10,1100,433,405,252,
30,"OLT",289,128221,,216,0,"SCOALA GENERALA PLESOIU","PLESOIU",62,128221,0,3,1493,775,638,137,764,11,1500,725,474,290,
30,"OLT",289,128221,,217,0,"SCOALA GENERALA DOBA","PLESOIU",62,128221,0,3,1126,789,577,212,776,13,1400,611,599,177,
30,"OLT",289,128301,,218,0,"SCOALA GENERALA POBORU","POBORU",63,128301,0,3,693,466,387,79,460,6,900,434,231,229,
30,"OLT",289,128301,,219,0,"SCOALA GENERALA CORNATELU","POBORU",63,128301,0,3,1080,683,553,130,681,2,1100,417,364,317,
30,"OLT",289,128374,,220,0,"SCOALA GENERALA POTCOAVA","POTCOAVA",64,128374,0,3,3244,1430,1227,203,1430,0,3000,1570,829,601,
30,"OLT",289,128374,,221,0,"SCOALA GENERALA SINESTI","POTCOAVA",64,128374,0,3,1323,962,653,309,944,18,2000,1020,401,543,
30,"OLT",289,128436,,222,0,"SCOALA GENERALA PRISEACA","PRISEACA",65,128436,0,3,1635,965,862,103,957,8,1800,835,461,496,
30,"OLT",289,128472,,223,0,"SCOALA GENERALA RADOMIRESTI","RADOMIRESTI",66,128472,0,3,1514,855,771,84,842,13,1665,810,610,232,
30,"OLT",289,128472,,224,0,"SCOALA GENERALA CRACIUNEI","RADOMIRESTI",66,128472,0,3,802,511,446,65,503,8,856,345,336,167,
30,"OLT",289,128472,,225,0,"SCOALA GENERALA POIANA","RADOMIRESTI",66,128472,0,3,286,267,181,86,264,3,344,77,190,74,
30,"OLT",289,128472,,226,0,"SCOALA GENERALA CALINESTI","RADOMIRESTI",66,128472,0,3,1123,600,528,72,587,13,1235,635,421,166,
30,"OLT",289,128524,,227,0,"CAMINUL CULTURAL REDEA","REDEA",67,128524,0,3,1981,946,763,183,936,10,2100,1154,663,273,
30,"OLT",289,128524,,228,0,"SCOALA GENERALA NR.2 REDISOARA","REDEA",67,128524,0,3,670,315,249,66,310,5,800,485,246,64,
30,"OLT",289,128560,,229,0,"SEDIUL FOST CAP ROTUNDA","ROTUNDA",68,128560,0,3,2650,1418,1306,112,1395,23,2900,1482,952,443,
30,"OLT",289,128588,,230,0,"SCOALA GENERALA RUSANESTI","RUSANESTI",69,128588,0,3,1413,1079,849,230,1059,20,1550,471,725,334,
30,"OLT",289,128588,,231,0,"SCOALA GENERALA NR. 2 RUSANESTI","RUSANESTI",69,128588,0,3,1480,1045,804,241,1037,8,1550,505,705,332,
30,"OLT",289,128588,,232,0,"SCOALA GENERALA JIENI","RUSANESTI",69,128588,0,3,972,779,626,153,774,5,1100,321,466,308,
30,"OLT",289,128613,,233,0,"CAMINUL CULTURAL SCARISOARA","SCARISOARA",71,128613,0,3,1845,998,909,89,977,21,2000,1002,732,245,
30,"OLT",289,128613,,234,0,"SCOALA GENERALA PLAVICENI","SCARISOARA",71,128613,0,3,610,471,417,54,470,1,700,229,350,120,
30,"OLT",289,128659,,235,0,"SCOALA GENERALA GRECI","SCHITU",72,128659,0,3,1673,1533,1444,89,1505,28,1800,267,1171,334,
30,"OLT",289,128659,,236,0,"PRIMARIA SCHITU","SCHITU",72,128659,0,3,790,760,694,66,754,6,900,140,584,170,
30,"OLT",289,128864,,237,0,"GRADINITA DE COPII SEACA","SEACA",73,128864,0,3,2087,1188,1086,102,1168,20,2300,1112,848,320,
30,"OLT",289,128882,,238,0,"SCOALA GENERALA SAMBURESTI","SAMBURESTI",70,128882,0,3,1037,608,525,83,596,12,1100,492,301,295,
30,"OLT",289,125374,,239,0,"GRADINITA DE COPII SLATIOARA","SLATIOARA",75,125374,0,3,1984,1271,1158,113,1253,18,2200,929,770,483,
30,"OLT",289,128962,,240,0,"SCOALA GENERALA ALUNISU","SPINENI",76,128962,0,3,545,438,303,135,432,6,600,162,298,134,
30,"OLT",289,128962,,241,0,"SCOALA GENERALA PROFA","SPINENI",76,128962,0,3,370,484,234,250,481,3,500,16,320,161,
30,"OLT",289,128962,,242,0,"CAMINUL CULTURAL SPINENI","SPINENI",76,128962,0,3,846,450,333,117,429,21,800,350,320,109,
30,"OLT",289,129040,,243,0,"CAMINUL CULTURAL SPRANCENATA","SPRANCENATA",77,129040,0,3,1827,1066,927,139,1056,10,2009,943,862,194,
30,"OLT",289,129040,,244,0,"CAMINUL CULTURAL FRUNZARU","SPRANCENATA",77,129040,0,3,624,528,414,114,521,7,700,172,406,115,
30,"OLT",289,129095,,245,0,"SCOALA GENERALA STOENESTI","STOENESTI",79,129095,0,3,1834,1285,1121,164,1265,20,2008,723,981,284,
30,"OLT",289,129111,,246,0,"SCOALA GENERALA STOICANESTII DIN VALE","STOICANESTI",80,129111,0,3,2769,1735,1592,143,1699,36,3000,1265,1223,476,
30,"OLT",289,129139,,247,0,"SCOALA GENERALA STREJESTII DE JOS","STREJESTI",81,129139,0,3,866,663,583,80,653,10,900,237,478,175,
30,"OLT",289,129139,,248,0,"SCOALA GENERALA STREJESTII DE SUS","STREJESTI",81,129139,0,3,1412,1011,915,96,992,19,1495,484,741,251,
30,"OLT",289,129139,,249,0,"SCOALA GENERALA COLIBASI","STREJESTI",81,129139,0,3,409,308,261,47,305,3,500,192,200,105,
30,"OLT",289,129184,,250,0,"CAMINUL CULTURAL STUDINA","STUDINA",82,129184,0,3,1524,807,734,73,791,16,1500,693,522,269,
30,"OLT",289,129184,,251,0,"SCOALA GENERALA GRADINILE","STUDINA",82,129184,0,3,1263,905,770,135,895,10,1500,595,605,290,
30,"OLT",289,129184,,252,0,"SCOALA GENERALA STUDINITA","STUDINA",82,129184,0,3,1009,625,548,77,621,4,1204,579,468,153,
30,"OLT",289,129246,,253,0,"SCOALA GENERALA SERBANESTI","SERBANESTI",74,129246,0,3,2524,1738,1581,157,1718,20,2800,1062,914,804,
30,"OLT",289,129282,,254,0,"SCOALA GENERALA STEFAN CEL MARE","STEFAN CEL MARE",78,129282,0,3,1929,1093,1006,87,1070,23,2100,1007,683,387,
30,"OLT",289,129317,,255,0,"CAMINUL CULTURAL TATULESTI","TATULESTI",83,129317,0,3,480,365,271,94,363,2,500,135,173,190,
30,"OLT",289,129317,,256,0,"SCOALA GENERALA MIRCESTI","TATULESTI",83,129317,0,3,214,211,117,94,209,2,300,89,103,106,
30,"OLT",289,129317,,257,0,"SCOALA GENERALA BARBALAI","TATULESTI",83,129317,0,3,284,268,190,78,265,3,300,32,182,83,
30,"OLT",289,129380,,258,0,"SCOALA GENERALA TESLUI","TESLUI",84,129380,0,3,1362,722,589,133,713,9,1400,678,375,338,
30,"OLT",289,129380,,259,0,"SCOALA GENERALA COMANITA","TESLUI",84,129380,0,3,792,556,400,156,555,1,900,344,375,180,
30,"OLT",289,129460,,260,0,"SCOALA GENERALA DOANCA","TIA MARE",85,129460,0,3,1066,583,535,48,576,7,1170,587,349,227,
30,"OLT",289,129460,,261,0,"SCOALA GENERALA POTLOGENI","TIA MARE",85,129460,0,3,1321,843,763,80,836,7,1430,587,653,183,
30,"OLT",289,129460,,262,0,"SCOALA GENERALA TIA MARE","TIA MARE",85,129460,0,3,1389,771,708,63,756,15,1600,829,561,195,
30,"OLT",289,129503,,263,0,"SCOALA GENERALA TOPANA","TOPANA",86,129503,0,3,375,306,201,105,301,5,390,84,186,115,
30,"OLT",289,129503,,264,0,"SCOALA GENERALA UNGURENI","TOPANA",86,129503,0,3,183,131,100,31,130,1,220,89,83,47,
30,"OLT",289,129503,,265,0,"SCOALA GENERALA GOJGARAI","TOPANA",86,129503,0,3,382,234,172,62,234,0,390,156,154,80,
30,"OLT",289,129567,,266,0,"SCOALA GENERALA TRAIANU","TRAIAN",87,129567,0,3,2796,1747,1655,92,1731,16,3100,1353,1201,530,
30,"OLT",289,129585,,267,0,"SCOALA GENERALA TUFENI","TUFENI",88,129585,0,3,1454,795,682,113,792,3,1600,805,551,241,
30,"OLT",289,129585,,268,0,"SCOALA GENERALA STOBORASTI","TUFENI",88,129585,0,3,1028,572,514,58,565,7,1100,528,379,186,
30,"OLT",289,129629,,269,0,"SCOALA GENERALA URZICA","URZICA",89,129629,0,3,1421,853,774,79,841,12,1500,647,508,333,
30,"OLT",289,129629,,270,0,"SCOALA GENERALA STAVARU","URZICA",89,129629,0,3,740,507,429,78,500,7,900,393,309,191,
30,"OLT",289,129656,,271,0,"SCOALA GENERALA VALEA MARE","VALEA MARE",93,129656,0,3,2017,969,864,105,959,10,2200,1231,544,415,
30,"OLT",289,129656,,272,0,"SCOALA GENERALA RECEA","VALEA MARE",93,129656,0,3,1065,565,464,101,555,10,1200,635,296,259,
30,"OLT",289,129718,,273,0,"SCOALA GENERALA VADASTRA","VADASTRA",90,129718,0,3,1410,905,787,118,896,9,1600,695,629,267,
30,"OLT",289,129718,,274,0,"SCOALA GENERALA VISINA NOUA","VADASTRA",90,129718,0,3,1594,997,902,95,987,10,1700,703,657,330,
30,"OLT",289,129745,,275,0,"SCOALA GENERALA VADASTRITA","VADASTRITA",91,129745,0,3,3117,1804,1684,120,1779,25,3400,1596,1134,645,
30,"OLT",289,129763,,276,0,"SCOALA GENERALA VALENI","VALENI",94,129763,0,3,2050,1168,1002,166,1143,25,2200,1032,795,348,
30,"OLT",289,129763,,277,0,"SCOALA GENERALA MANDRA","VALENI",94,129763,0,3,649,412,345,67,406,6,1000,588,247,159,
30,"OLT",289,129816,,278,0,"SCOALA GENERALA CUCUIETI","VERGULEASA",95,129816,0,3,868,530,439,91,526,4,899,369,341,185,
30,"OLT",289,129816,,279,0,"CAMINUL CULTURAL POGANU","VERGULEASA",95,129816,0,3,1505,670,540,130,664,6,1099,429,486,178,
30,"OLT",289,129816,,280,0,"SCOALA GENERALA DUMITRESTI","VERGULEASA",95,129816,0,3,677,586,426,160,577,9,900,314,411,166,
30,"OLT",289,129898,,281,0,"CAMINUL CULTURAL VISINA","VISINA",96,129898,0,3,2740,1561,1443,118,1546,15,3000,1439,854,692,
30,"OLT",289,129914,,282,0,"SCOALA GENERALA VITOMIRESTI","VITOMIRESTI",97,129914,0,3,1110,526,414,112,522,4,1200,674,289,233,
30,"OLT",289,129914,,283,0,"SCOALA GENERALA DEJESTI","VITOMIRESTI",97,129914,0,3,998,621,484,137,613,8,1100,479,435,178,
30,"OLT",289,129987,,284,0,"SCOALA GENERALA VALCELE","VALCELE",92,129987,0,3,1646,997,829,168,986,11,1700,703,542,444,
30,"OLT",289,129987,,285,0,"SCOALA GENERALA BARCANESTI","VALCELE",92,129987,0,3,595,476,343,133,472,4,800,324,227,245,
30,"OLT",289,130026,,286,0,"SCOALA GENERALA VLADILA","VLADILA",98,130026,0,3,1708,954,895,59,941,13,2000,1046,651,290,
30,"OLT",289,130062,,287,0,"SCOALA GENERALA VOINEASA","VOINEASA",99,130062,0,3,922,470,385,85,458,12,1000,530,295,163,
30,"OLT",289,130062,,288,0,"SCOALA GENERALA MARGARITESTI","VOINEASA",99,130062,0,3,891,612,433,179,605,7,1000,388,413,192,
30,"OLT",289,130124,,289,0,"SCOALA GENERALA VULPENI","VULPENI",100,130124,0,3,1459,1044,932,112,1018,26,1600,556,582,436,
30,"OLT",289,130124,,290,0,"SCOALA GENERALA GROPSANI","VULPENI",100,130124,0,3,760,519,411,108,515,4,900,381,279,236,
30,"OLT",289,130231,,291,0,"SCOALA GENERALA VULTURESTI","VULTURESTI",101,130231,0,3,1337,860,742,118,856,4,1500,640,664,192,
30,"OLT",289,130231,,292,0,"SEDIUL FOSTULUI CAP - SCOALA GENERALA DIENCI","VULTURESTI",101,130231,0,3,987,598,477,121,591,7,1100,502,437,154,
30,"OLT",289,128711,,293,0,"SCOALA GENERALA JITARU","ORAS SCORNICESTI",7,128711,2,1,499,540,421,119,507,33,550,10,473,34,
30,"OLT",289,127019,,294,0,"SCOALA GENERALA FARCASELE DE JOS","FARCASELE",35,127019,0,3,1397,846,806,40,840,6,1500,654,558,282,
31,"PRAHOVA",298,130534,,1,0,"PALATUL CULTURII,B-DUL REPUBLICII,NR.4","MUNICIPIUL PLOIESTI",1,130534,1,1,1409,873,777,96,861,12,1507,634,691,170,
31,"PRAHOVA",298,130534,,2,0,"CASA DE CULTURA A SINDICATELOR,B-DUL REPUBLICII,NR.65","MUNICIPIUL PLOIESTI",1,130534,1,1,1459,898,788,110,883,15,1600,702,724,159,
31,"PRAHOVA",298,130534,,3,0,"CASA DE CULTURA A SINDICATELOR,B-DUL REPUBLICII,NR.65","MUNICIPIUL PLOIESTI",1,130534,1,1,1615,961,921,40,932,29,1800,839,766,166,
31,"PRAHOVA",298,130534,,4,0,"LIC.A.I.CUZA,STR.TREI IERARHI,NR.10","MUNICIPIUL PLOIESTI",1,130534,1,1,909,509,472,37,492,17,1000,491,391,101,
31,"PRAHOVA",298,130534,,5,0,"SC.NR.4,STR.ELENA DOAMNA,NR.25","MUNICIPIUL PLOIESTI",1,130534,1,1,1602,1093,879,214,1068,25,1800,707,854,214,
31,"PRAHOVA",298,130534,,6,0,"SC.NR.7,STR.NUCILOR,NR.39","MUNICIPIUL PLOIESTI",1,130534,1,1,1728,971,925,46,961,10,1900,929,742,219,
31,"PRAHOVA",298,130534,,7,0,"SC.NR.4,STR.ELENA DOAMNA,NR.25","MUNICIPIUL PLOIESTI",1,130534,1,1,1753,1149,1065,84,1049,16,1900,751,810,239,
31,"PRAHOVA",298,130534,,8,0,"LIC.I.L.CARAGIALE,STR.GH.DOJA,NR.98","MUNICIPIUL PLOIESTI",1,130534,1,1,1803,983,879,104,964,19,2000,1017,686,278,
31,"PRAHOVA",298,130534,,9,0,"SC.NR.7,STR.NUCILOR,NR.39","MUNICIPIUL PLOIESTI",1,130534,1,1,862,474,452,22,464,10,900,426,353,111,
31,"PRAHOVA",298,130534,,10,0,"LIC.I.L.CARAGIALE,STR.GH.DOJA,NR.98","MUNICIPIUL PLOIESTI",1,130534,1,1,1032,776,543,233,757,19,1100,324,593,164,
31,"PRAHOVA",298,130534,,11,0,"DIR.JUD.SPORTURILOR,STR.PIELARI,NR.5","MUNICIPIUL PLOIESTI",1,130534,1,1,1614,883,819,64,870,13,1800,917,650,220,
31,"PRAHOVA",298,130534,,12,0,"ANEXA SC.NR.21,STR.STADIONULUI,NR.9","MUNICIPIUL PLOIESTI",1,130534,1,1,1203,699,625,74,687,12,1300,601,547,140,
31,"PRAHOVA",298,130534,,13,0,"MUZEUL DE ISTORIE,STR.TOMA CARAGIU,NR.10","MUNICIPIUL PLOIESTI",1,130534,1,1,1136,685,595,90,666,19,1300,615,540,126,
31,"PRAHOVA",298,130534,,14,0,"LIC.M.VITEAZU,B-DUL INDEPENDENTEI,NR.8","MUNICIPIUL PLOIESTI",1,130534,1,1,962,601,534,67,583,18,1100,499,458,125,
31,"PRAHOVA",298,130534,,15,0,"CLUBUL SPORTIV SCOLAR,STR.STEFAN CEL MARE,NR.5","MUNICIPIUL PLOIESTI",1,130534,1,1,1095,645,587,58,623,22,1200,555,501,122,
31,"PRAHOVA",298,130534,,16,0,"FILIALA RETELE ELECTRICE PLOIESTI,STR.MARASESTI,NR.44","MUNICIPIUL PLOIESTI",1,130534,1,1,830,501,445,56,487,14,900,399,377,110,
31,"PRAHOVA",298,130534,,17,0,"SALA SPORTURILOR OLIMPIA,PARCUL TINERETULUI","MUNICIPIUL PLOIESTI",1,130534,1,1,1071,604,570,34,586,18,1200,596,462,124,
31,"PRAHOVA",298,130534,,18,0,"SC.NR.12,STR.POPA FARCAS,NR.23","MUNICIPIUL PLOIESTI",1,130534,1,1,1235,770,673,97,743,27,1402,632,568,175,
31,"PRAHOVA",298,130534,,19,0,"SC.NR.12,STR.POPA FARCAS,NR.23","MUNICIPIUL PLOIESTI",1,130534,1,1,1829,842,771,71,832,10,2000,1158,613,219,
31,"PRAHOVA",298,130534,,20,0,"S.C.GEOROM S.A.,STR.TRAIAN,NR.28","MUNICIPIUL PLOIESTI",1,130534,1,1,1511,856,737,119,841,15,1700,844,611,230,
31,"PRAHOVA",298,130534,,21,0,"SC.NR.14,B-DUL REPUBLICII,NR.145","MUNICIPIUL PLOIESTI",1,130534,1,1,1609,996,956,40,973,23,1800,804,748,225,
31,"PRAHOVA",298,130534,,22,0,"SC.NR.14,B-DUL REBUPLICII,NR.145","MUNICIPIUL PLOIESTI",1,130534,1,1,1401,856,792,64,831,25,1500,644,659,172,
31,"PRAHOVA",298,130534,,23,0,"SC.NR.13,STR.D.BOLINTINEANU,NR.32","MUNICIPIUL PLOIESTI",1,130534,1,1,1202,715,659,56,709,6,1300,585,537,172,
31,"PRAHOVA",298,130534,,24,0,"S.C.INDUSTRIE MICA,STR.GAGENI,NR.117","MUNICIPIUL PLOIESTI",1,130534,1,1,1694,947,865,82,933,14,1900,953,719,214,
31,"PRAHOVA",298,130534,,25,0,"SEDIUL AUTOSERVICE DACIA,STR.GAGENI,NR.92","MUNICIPIUL PLOIESTI",1,130534,1,1,1889,1127,992,135,1101,26,2100,973,791,310,
31,"PRAHOVA",298,130534,,26,0,"SEDIUL ROMCEREAL S.A.,STR.VALENI,NR.137","MUNICIPIUL PLOIESTI",1,130534,1,1,1583,995,851,144,980,15,2000,1005,715,265,
31,"PRAHOVA",298,130534,,27,0,"SC.NR.16,STR.LUMINISULUI,NR.8","MUNICIPIUL PLOIESTI",1,130534,1,1,2017,1090,1041,49,1071,19,2200,1110,710,361,
31,"PRAHOVA",298,130534,,28,0,"SC.NR.16,STR.LUMINISULUI,NR.8","MUNICIPIUL PLOIESTI",1,130534,1,1,2176,1247,1144,103,1234,13,2400,1153,875,359,
31,"PRAHOVA",298,130534,,29,0,"DIR.JUD.A SPORTURILOR,STR.PIELARI,NR.5","MUNICIPIUL PLOIESTI",1,130534,1,1,1836,1031,977,54,918,13,1900,969,703,215,
31,"PRAHOVA",298,130534,,30,0,"BL.24B,PARTER,STR.M.BRAVU,NR.214","MUNICIPIUL PLOIESTI",1,130534,1,1,1637,840,814,26,836,4,1800,960,548,288,
31,"PRAHOVA",298,130534,,31,0,"MAG.FEROEMAIL,STR.M.BRAVU,NR.231","MUNICIPIUL PLOIESTI",1,130534,1,1,2216,1345,1099,246,1319,26,2400,1055,829,490,
31,"PRAHOVA",298,130534,,32,0,"BL.24B,PARTER,STR.M.BRAVU,NR.214","MUNICIPIUL PLOIESTI",1,130534,1,1,1801,1002,966,36,985,17,2200,1198,677,308,
31,"PRAHOVA",298,130534,,33,0,"OF.POSTAL NR.11,STR.CHIMIEI,NR.3","MUNICIPIUL PLOIESTI",1,130534,1,1,2313,1316,1200,116,1296,20,2500,1184,828,468,
31,"PRAHOVA",298,130534,,34,0,"GRADINITA DE COPII NR.4,STR.ROSIORI,NR.28","MUNICIPIUL PLOIESTI",1,130534,1,1,799,688,433,255,679,9,1300,605,490,189,
31,"PRAHOVA",298,130534,,35,0,"SC.NR.17,STR.IZVOARE,NR.81","MUNICIPIUL PLOIESTI",1,130534,1,1,2065,1095,1025,70,1079,16,2300,1205,758,321,
31,"PRAHOVA",298,130534,,36,0,"SC.RARES VODA,STR.VORNICUL BOLDUR,NR.3","MUNICIPIUL PLOIESTI",1,130534,1,1,1174,685,628,57,659,26,1300,615,503,156,
31,"PRAHOVA",298,130534,,37,0,"CASA CORPULUI DIDACTIC,STR.DEMOCRATIEI,NR.35","MUNICIPIUL PLOIESTI",1,130534,1,1,1624,893,807,86,867,26,1800,907,617,250,
31,"PRAHOVA",298,130534,,38,0,"SC.NORMALA PLOIESTI,STR.N.IORGA,NR.7","MUNICIPIUL PLOIESTI",1,130534,1,1,1841,1163,1094,69,1117,46,2014,851,844,273,
31,"PRAHOVA",298,130534,,39,0,"SC.NR.32,STR.TELEAJEN,NR.11","MUNICIPIUL PLOIESTI",1,130534,1,1,1425,822,757,65,804,18,1600,778,630,174,
31,"PRAHOVA",298,130534,,40,0,"SC.NR.32,STR.TELEAJEN,NR.11","MUNICIPIUL PLOIESTI",1,130534,1,1,1388,861,827,34,842,19,1500,639,663,179,
31,"PRAHOVA",298,130534,,41,0,"SC.NR.10,STR.AL.LAPUSNEANU,NR.17","MUNICIPIUL PLOIESTI",1,130534,1,1,1233,796,698,98,779,17,1300,504,577,202,
31,"PRAHOVA",298,130534,,42,0,"SC.NR.10,STR.AL.LAPUSNEANU,NR.17","MUNICIPIUL PLOIESTI",1,130534,1,1,1284,694,654,40,683,11,1400,706,485,198,
31,"PRAHOVA",298,130534,,43,0,"SC.NR.17,STR.IZVOARE,NR.81","MUNICIPIUL PLOIESTI",1,130534,1,1,1596,1027,985,42,1013,14,1700,673,747,266,
31,"PRAHOVA",298,130534,,44,0,"SC.NR.18,STR.FAGARAS,NR.1","MUNICIPIUL PLOIESTI",1,130534,1,1,1640,1027,972,55,1016,11,1800,773,686,330,
31,"PRAHOVA",298,130534,,45,0,"GRUPUL SC.IND.AL S.C.UPETROM S.A.,B-DUL PETROLULUI,NR.16","MUNICIPIUL PLOIESTI",1,130534,1,1,1807,962,897,65,942,20,2000,1038,615,327,
31,"PRAHOVA",298,130534,,46,0,"GRUPUL SC.DE CHIMIE NR.4,B-DUL PETROLULUI,NR.14","MUNICIPIUL PLOIESTI",1,130534,1,1,2051,1070,986,84,1055,15,2200,1130,715,340,
31,"PRAHOVA",298,130534,,47,0,"GRUPUL SCOLAR AL S.C.UPETROM S.A.,B-DUL PETROLULUI,NR.16","MUNICIPIUL PLOIESTI",1,130534,1,1,1677,921,815,106,905,16,1800,879,631,274,
31,"PRAHOVA",298,130534,,48,0,"SC.NR.15,B-DUL BUCURESTI,NR.25","MUNICIPIUL PLOIESTI",1,130534,1,1,1831,1085,1011,74,1069,16,2000,915,745,324,
31,"PRAHOVA",298,130534,,49,0,"SC.NR.15,B-DUL BUCURESTI,NR.25","MUNICIPIUL PLOIESTI",1,130534,1,1,1331,762,733,29,748,14,1500,738,519,229,
31,"PRAHOVA",298,130534,,50,0,"SC.NR.19,B-DUL PETROLULUI,NR.7","MUNICIPIUL PLOIESTI",1,130534,1,1,800,497,359,138,492,5,900,403,411,81,
31,"PRAHOVA",298,130534,,51,0,"SC.NR.1,STR.BOBALNA,NR.76","MUNICIPIUL PLOIESTI",1,130534,1,1,1250,751,686,65,738,13,1400,649,576,162,
31,"PRAHOVA",298,130534,,52,0,"LIC.DE ARTA,STR.BOBALNA,NR.44","MUNICIPIUL PLOIESTI",1,130534,1,1,1169,765,599,166,745,20,1300,535,581,164,
31,"PRAHOVA",298,130534,,53,0,"SEDIUL REGIEI DE APA,STR ANA IPATESCU,NR.8","MUNICIPIUL PLOIESTI",1,130534,1,1,1211,1243,653,590,1206,37,1700,457,861,345,
31,"PRAHOVA",298,130534,,54,0,"LIC.DE ARTA,STR.BOBALNA,NR.44","MUNICIPIUL PLOIESTI",1,130534,1,1,855,522,501,21,498,24,900,378,384,114,
31,"PRAHOVA",298,130534,,55,0,"GRUPUL SCOLAR CONSTRUCTII MASINI,STR.CONSTRUCTORULUI,NR.8","MUNICIPIUL PLOIESTI",1,130534,1,1,697,604,439,165,589,15,800,196,433,156,
31,"PRAHOVA",298,130534,,56,0,"SEDIUL S.C.TRUST ANTREPRIZA GENERALA MONTAJ UTILAJ CHIMIC FILIALA PLOIESTI,STR.RUDULUI,NR.262","MUNICIPIUL PLOIESTI",1,130534,1,1,1516,645,616,29,627,18,1697,1052,427,200,
31,"PRAHOVA",298,130534,,57,0,"SC.NR.11,STR.JUPITER,NR.6","MUNICIPIUL PLOIESTI",1,130534,1,1,1742,1001,890,111,981,20,1900,899,742,239,
31,"PRAHOVA",298,130534,,58,0,"SALA SPORTURILOR OLIMPIA,PARCUL TINERETULUI","MUNICIPIUL PLOIESTI",1,130534,1,1,1940,961,879,82,949,12,2100,1139,692,257,
31,"PRAHOVA",298,130534,,59,0,"INSPET,STR.SONDELOR","MUNICIPIUL PLOIESTI",1,130534,1,1,953,545,507,38,535,10,1000,455,368,167,
31,"PRAHOVA",298,130534,,60,0,"SC.NR.20,STR.MARASESTI,NR.239","MUNICIPIUL PLOIESTI",1,130534,1,1,2395,1103,1015,88,1092,11,2100,997,776,316,
31,"PRAHOVA",298,130534,,61,0,"SC.NR.20,STR.MARASESTI,NR.239","MUNICIPIUL PLOIESTI",1,130534,1,1,2035,1217,1081,136,1190,27,2200,983,822,368,
31,"PRAHOVA",298,130534,,62,0,"SC.NR.20,STR.MARASESTI,NR.239","MUNICIPIUL PLOIESTI",1,130534,1,1,1461,756,686,70,747,9,1594,838,456,291,
31,"PRAHOVA",298,130534,,63,0,"SC.NR.20,STR.MARASESTI,NR.239","MUNICIPIUL PLOIESTI",1,130534,1,1,1906,1072,1026,46,1046,26,2106,1034,676,370,
31,"PRAHOVA",298,130534,,64,0,"SC.A.I.BASARABESCU,ALEEA STRUNGA,NR.2","MUNICIPIUL PLOIESTI",1,130534,1,1,2211,1197,1005,192,1183,14,2600,1403,781,402,
31,"PRAHOVA",298,130534,,65,0,"SC.A.I.BASARABESCU,ALEEA STRUNGA,NR.2","MUNICIPIUL PLOIESTI",1,130534,1,1,2087,1171,1125,46,1144,27,2300,1129,739,405,
31,"PRAHOVA",298,130534,,66,0,"SC.NR.29,ALEEA GODEANU,NR.4","MUNICIPIUL PLOIESTI",1,130534,1,1,1702,933,893,40,927,6,1900,967,663,264,
31,"PRAHOVA",298,130534,,67,0,"GRADINITA DE COPII NR.40,STR.ANOTIMPULUI,NR.6A","MUNICIPIUL PLOIESTI",1,130534,1,1,1491,790,760,30,776,14,1600,810,532,244,
31,"PRAHOVA",298,130534,,68,0,"SC.NR.3,STR.MINERVA,NR.4","MUNICIPIUL PLOIESTI",1,130534,1,1,1800,1022,960,62,1006,16,2000,978,720,286,
31,"PRAHOVA",298,130534,,69,0,"GRADINITA DE COPII NR.50,ALEEA GODEANU,NR.4","MUNICIPIUL PLOIESTI",1,130534,1,1,1831,1005,961,44,998,7,2000,995,691,307,
31,"PRAHOVA",298,130534,,70,0,"GRADINITA DE COPII NR.50,ALEEA GODEANU,NR.4","MUNICIPIUL PLOIESTI",1,130534,1,1,1535,886,844,42,874,12,1700,814,587,287,
31,"PRAHOVA",298,130534,,71,0,"SC.NR.3,STR.MINERVA,NR.4","MUNICIPIUL PLOIESTI",1,130534,1,1,2190,1140,1090,50,1125,15,2400,1260,823,302,
31,"PRAHOVA",298,130534,,72,0,"SC.NR.3,STR.MINERVA,NR.4","MUNICIPIUL PLOIESTI",1,130534,1,1,1295,708,670,38,698,10,1400,692,487,211,
31,"PRAHOVA",298,130534,,73,0,"GRADINITA NR.40,STR.ANOTIMPULUI,NR.6A","MUNICIPIUL PLOIESTI",1,130534,1,1,1755,966,920,46,950,16,1905,939,696,254,
31,"PRAHOVA",298,130534,,74,0,"GRADINITA NR.39,STR.GEN.EREMIA GRIGORESCU,NR.11","MUNICIPIUL PLOIESTI",1,130534,1,1,1933,1029,972,57,1009,20,2100,1071,741,268,
31,"PRAHOVA",298,130534,,75,0,"SC.NR.31,STR.MINERVA,NR.2","MUNICIPIUL PLOIESTI",1,130534,1,1,1794,927,889,38,903,24,2000,1073,650,253,
31,"PRAHOVA",298,130534,,76,0,"GRADINITA DE COPII NR.36,STR.SUBLT.EROU MOLDOVEANU MARIAN,NR.5-7","MUNICIPIUL PLOIESTI",1,130534,1,1,1645,909,860,49,892,17,1800,891,639,253,
31,"PRAHOVA",298,130534,,77,0,"SC.NR.6,STR.INFRATIRII,NR.2","MUNICIPIUL PLOIESTI",1,130534,1,1,1796,878,809,69,877,1,2000,1122,556,321,
31,"PRAHOVA",298,130534,,78,0,"GRADINITA DE COPII NR.36,STR.SUBLT.EROU MOLDOVEANU MARIAN,NR.5-7","MUNICIPIUL PLOIESTI",1,130534,1,1,1578,883,814,69,874,9,1700,817,567,307,
31,"PRAHOVA",298,130534,,79,0,"SC.NR.6,STR.INFRATIRII,NR.2","MUNICIPIUL PLOIESTI",1,130534,1,1,1438,723,679,44,715,8,1600,877,456,259,
31,"PRAHOVA",298,130534,,80,0,"GRADINITA DE COPII NR.36,STR.SUBLT.EROU MOLDOVEANU MARIAN,NR.5-7","MUNICIPIUL PLOIESTI",1,130534,1,1,1932,1095,1042,53,1083,12,2100,1005,743,340,
31,"PRAHOVA",298,130534,,81,0,"SC.NR.29,ALEEA GODEANU,NR.4","MUNICIPIUL PLOIESTI",1,130534,1,1,2008,1062,1001,61,1047,15,2200,1138,714,333,
31,"PRAHOVA",298,130534,,82,0,"SC.NR.29,ALEEA GODEANU,NR.4","MUNICIPIUL PLOIESTI",1,130534,1,1,2065,1056,988,68,1036,20,2300,1244,723,313,
31,"PRAHOVA",298,130534,,83,0,"SC.NR.29,ALEEA GODEANU,NR.4","MUNICIPIUL PLOIESTI",1,130534,1,1,2086,952,897,55,943,9,2300,1348,643,300,
31,"PRAHOVA",298,130534,,84,0,"GRADINITA NR.47,ALEEA IEZERULUI,NR.7-8","MUNICIPIUL PLOIESTI",1,130534,1,1,1794,1020,955,65,1012,8,2000,980,729,283,
31,"PRAHOVA",298,130534,,85,0,"GRADINITA NR.47,ALEEA IEZERULUI,NR.7-8","MUNICIPIUL PLOIESTI",1,130534,1,1,1630,868,845,23,858,10,1800,932,610,248,
31,"PRAHOVA",298,130534,,86,0,"SEDIUL REGIEI AUTONOME A APELOR ROMANE,STR.GH.GR.CANTACUZINO,NR.304-308","MUNICIPIUL PLOIESTI",1,130534,1,1,1683,1019,933,86,1000,19,1900,881,751,249,
31,"PRAHOVA",298,130534,,87,0,"SEDIUL AGENTIEI DE SUPRAVEGHERE SI PROTECTIE A MEDIULUI,STR.GH.GR.CANTACUZINO,NR.304-308","MUNICIPIUL PLOIESTI",1,130534,1,1,2200,1232,1174,58,1217,15,2400,1168,874,343,
31,"PRAHOVA",298,130534,,88,0,"SC.NR.2,STR.SPATAR MILESCU,NR.22","MUNICIPIUL PLOIESTI",1,130534,1,1,1842,987,954,33,967,20,2000,1013,700,267,
31,"PRAHOVA",298,130534,,89,0,"SC.NR.2,STR.SPATAR MILESCU,NR.22","MUNICIPIUL PLOIESTI",1,130534,1,1,2077,1158,1113,45,1140,18,2300,1142,829,311,
31,"PRAHOVA",298,130534,,90,0,"GRUPUL SCOLAR CONSTRUCTII TOMA SOCOLESCU,STR.GH.GR.CANTACUZINO,NR.238","MUNICIPIUL PLOIESTI",1,130534,1,1,1688,955,868,87,942,13,1800,845,636,306,
31,"PRAHOVA",298,130534,,91,0,"SC.NR.2,STR.SPATAR MILESCU,NR.22","MUNICIPIUL PLOIESTI",1,130534,1,1,1827,1046,976,70,1039,7,2000,954,740,299,
31,"PRAHOVA",298,130534,,92,0,"GRUPUL SCOLAR ENERGETIC,SOSEAUA VESTULUI,NR.22","MUNICIPIUL PLOIESTI",1,130534,1,1,1685,987,926,61,918,8,1800,874,608,310,
31,"PRAHOVA",298,130534,,93,0,"SEDIUL SCOLII DE SOFERI AMATORI,SOSEAUA VESTULUI,NR.19","MUNICIPIUL PLOIESTI",1,130534,1,1,746,566,374,192,558,8,800,234,385,173,
31,"PRAHOVA",298,130534,,94,0,"SCOALA PROFESOR N.SIMACHE,STR.MALU ROSU,NR.102","MUNICIPIUL PLOIESTI",1,130534,1,1,1135,650,630,20,640,10,1300,650,458,182,
31,"PRAHOVA",298,130534,,95,0,"SCOALA PROFESOR N.SIMACHE,STR.MALU ROSU,NR.102","MUNICIPIUL PLOIESTI",1,130534,1,1,739,397,343,54,392,5,800,403,280,112,
31,"PRAHOVA",298,130534,,96,0,"SCOALA PROFESOR N.SIMACHE,STR.MALU ROSU,NR.102","MUNICIPIUL PLOIESTI",1,130534,1,1,2205,1172,1129,43,1162,10,2400,1228,814,348,
31,"PRAHOVA",298,130534,,97,0,"SC.NR.28,ALEEA SCOLII,NR.2","MUNICIPIUL PLOIESTI",1,130534,1,1,2239,1230,1164,66,1218,12,2400,1170,858,360,
31,"PRAHOVA",298,130534,,98,0,"GRADINITA DE COPII NR.48,STR.MAGURII,NR.6","MUNICIPIUL PLOIESTI",1,130534,1,1,1740,803,763,40,791,12,1900,1097,548,243,
31,"PRAHOVA",298,130534,,99,0,"SC.NR.28,ALEEA SCOLII,NR.2","MUNICIPIUL PLOIESTI",1,130534,1,1,2109,1087,1010,77,1076,11,2300,1213,723,353,
31,"PRAHOVA",298,130534,,100,0," GRUPUL SCOLAR ENERGETIC,SOSEAUA VESTULUI,NR.22","MUNICIPIUL PLOIESTI",1,130534,1,1,1383,742,654,88,732,10,1500,758,504,228,
31,"PRAHOVA",298,130534,,101,0,"GRADINITA DE COPII NR.10,STR.RASNOVENILOR,NR.46","MUNICIPIUL PLOIESTI",1,130534,1,1,1908,929,896,33,920,9,2100,1171,595,325,
31,"PRAHOVA",298,130534,,102,0,"SC.NR.28,ALEEA SCOLII,NR.2","MUNICIPIUL PLOIESTI",1,130534,1,1,1628,865,816,49,851,14,1800,935,577,274,
31,"PRAHOVA",298,130534,,103,0,"S.C.ELCO S.A.,SOSEAUA VESTULUI,NR.26","MUNICIPIUL PLOIESTI",1,130534,1,1,2313,1031,991,40,1020,11,2500,1469,738,282,
31,"PRAHOVA",298,130534,,104,0,"SC.NR.5,STR.8 MARTIE,NR.4","MUNICIPIUL PLOIESTI",1,130534,1,1,2137,1225,1125,100,1206,19,2418,1193,891,315,
31,"PRAHOVA",298,130534,,105,0,"SC.NR.5,STR.8 MARTIE,NR.4","MUNICIPIUL PLOIESTI",1,130534,1,1,1222,780,694,86,764,16,1301,521,583,181,
31,"PRAHOVA",298,130534,,106,0,"GRADINITA NR.33","MUNICIPIUL PLOIESTI",1,130534,1,1,1599,954,901,53,932,22,1800,846,699,233,
31,"PRAHOVA",298,130534,,107,0,"SC.NR.5,STR.8 MARTIE,NR.4","MUNICIPIUL PLOIESTI",1,130534,1,1,2080,1175,1137,38,1153,22,2300,1125,840,313,
31,"PRAHOVA",298,130534,,108,0,"SC.NR.14 ,B-DUL REPUBLICII,NR.145","MUNICIPIUL PLOIESTI",1,130534,1,1,2080,1176,1109,67,1145,31,2300,1124,919,226,
31,"PRAHOVA",298,130534,,109,0,"SC.NR.13,STR.D.BOLINTINEANU,NR.32","MUNICIPIUL PLOIESTI",1,130534,1,1,1275,715,684,31,705,10,1400,685,541,164,
31,"PRAHOVA",298,130534,,110,0,"SC.NR.23,STR.TROTUS,NR.3","MUNICIPIUL PLOIESTI",1,130534,1,1,1383,812,764,48,800,12,1500,688,599,201,
31,"PRAHOVA",298,130534,,111,0,"SC.NR.23,STR.TROTUS,NR.3","MUNICIPIUL PLOIESTI",1,130534,1,1,1195,674,636,38,666,8,1300,626,514,152,
31,"PRAHOVA",298,130534,,112,0,"SEDIUL COOPERATIVEI METALUL,STR.TRAIAN COLT CU STR.N.TITULESCU","MUNICIPIUL PLOIESTI",1,130534,1,1,1689,900,850,50,884,16,1900,1000,663,221,
31,"PRAHOVA",298,130534,,113,0,"SC.NR.5,STR.8 MARTIE,NR.4","MUNICIPIUL PLOIESTI",1,130534,1,1,1220,728,683,45,718,10,1300,572,528,190,
31,"PRAHOVA",298,130534,,114,0,"GRADINITA DE COPII NR.53,STR.ARINULUI,NR.6","MUNICIPIUL PLOIESTI",1,130534,1,1,1165,707,659,48,684,23,1300,593,513,171,
31,"PRAHOVA",298,130534,,115,0,"SC.GEN.HENRI MATHIAS BERTHELOT,STR.ARINULUI,NR.6","MUNICIPIUL PLOIESTI",1,130534,1,1,1112,681,635,46,670,11,1200,519,546,124,
31,"PRAHOVA",298,130534,,116,0,"SC.GEN.HENRI MATHIAS BERTHELOT,STR.ARINULUI,NR.6","MUNICIPIUL PLOIESTI",1,130534,1,1,1106,655,592,63,643,12,1200,545,490,153,
31,"PRAHOVA",298,130534,,117,0,"SC.NR.8,STR.LAURILOR,NR.2","MUNICIPIUL PLOIESTI",1,130534,1,1,1360,753,673,80,744,9,1500,747,561,183,
31,"PRAHOVA",298,130534,,118,0,"SC.NR.8,STR.LAURILOR,NR.2","MUNICIPIUL PLOIESTI",1,130534,1,1,1336,748,714,34,737,11,1500,752,557,180,
31,"PRAHOVA",298,130534,,119,0,"LIC.N.STANESCU,STR.NALBEI,NR.3","MUNICIPIUL PLOIESTI",1,130534,1,1,1085,619,593,26,607,12,1200,581,477,130,
31,"PRAHOVA",298,130534,,120,0,"LIC.N.STANESCU,STR.NALBEI,NR.3","MUNICIPIUL PLOIESTI",1,130534,1,1,1073,662,626,36,645,17,1200,538,490,155,
31,"PRAHOVA",298,130534,,121,0,"POLICLINICA CINA,STR.A MURESANU,NR.56","MUNICIPIUL PLOIESTI",1,130534,1,1,1640,922,856,66,889,33,1800,878,685,204,
31,"PRAHOVA",298,130534,,122,0,"SEDIUL S.C. T.C.I.N.D. S.A.,STR.A.MURESANU,NR.58","MUNICIPIUL PLOIESTI",1,130534,1,1,1353,773,727,46,761,12,1500,727,587,174,
31,"PRAHOVA",298,130534,,123,0,"LIC.N.STANESCU,STR.NALBEI,NR.3","MUNICIPIUL PLOIESTI",1,130534,1,1,1071,679,641,38,661,18,1200,521,510,151,
31,"PRAHOVA",298,130534,,124,0,"LIC.N.STANESCU,STR.NALBEI,NR.3","MUNICIPIUL PLOIESTI",1,130534,1,1,1293,915,849,66,899,16,1400,485,726,173,
31,"PRAHOVA",298,130534,,125,0,"SC.NR.24,ALEEA DEDITEI,NR.4","MUNICIPIUL PLOIESTI",1,130534,1,1,1603,842,800,42,833,9,1800,958,615,218,
31,"PRAHOVA",298,130534,,126,0,"SC.NR.24,ALEEA DEDITEI,NR.4","MUNICIPIUL PLOIESTI",1,130534,1,1,1401,813,763,50,797,16,1500,687,618,179,
31,"PRAHOVA",298,130534,,127,0,"SC.NR.24,ALEEA DEDITEI,NR.4","MUNICIPIUL PLOIESTI",1,130534,1,1,1544,891,860,31,883,8,1700,809,649,234,
31,"PRAHOVA",298,130534,,128,0,"SC.NR.24,STR.PETUNIEI,NR.1","MUNICIPIUL PLOIESTI",1,130534,1,1,1760,1012,978,34,985,27,1900,888,776,209,
31,"PRAHOVA",298,130534,,129,0,"SC.NR.24,STR.PETUNIEI,NR.1","MUNICIPIUL PLOIESTI",1,130534,1,1,1904,965,913,52,948,17,2100,1135,720,228,
31,"PRAHOVA",298,130534,,130,0,"SC.NR.22,STR.CIOCARLIEI,NR.12","MUNICIPIUL PLOIESTI",1,130534,1,1,859,570,501,69,564,6,1000,430,331,233,
31,"PRAHOVA",298,130534,,131,1,"U.M.0599,STR.GH.GR.CANTACUZINO","MUNICIPIUL PLOIESTI",1,130534,1,1,0,557,0,557,540,17,600,43,339,201,
31,"PRAHOVA",298,130534,,132,1,"U.M.01948,STR.TORCATORI","MUNICIPIUL PLOIESTI",1,130534,1,1,118,135,110,25,130,5,300,165,84,46,
31,"PRAHOVA",298,130534,,133,1,"GARA DE SUD","MUNICIPIUL PLOIESTI",1,130534,1,1,0,687,0,687,682,5,2000,1313,347,335,
31,"PRAHOVA",298,130534,,134,1,"GARA DE VEST","MUNICIPIUL PLOIESTI",1,130534,1,1,0,138,0,138,138,0,2000,1862,67,71,
31,"PRAHOVA",298,130534,,135,1,"GARA DE NORD","MUNICIPIUL PLOIESTI",1,130534,1,1,0,66,0,66,65,1,1000,934,40,25,
31,"PRAHOVA",298,130534,,136,1,"SPITALUL SCHULLER,STR.ANA IPATESCU,NR.59","MUNICIPIUL PLOIESTI",1,130534,1,1,0,106,0,106,103,3,300,194,79,24,
31,"PRAHOVA",298,130534,,137,1,"SPITALUL DERMATO","MUNICIPIUL PLOIESTI",1,130534,1,1,0,60,0,60,59,1,100,40,39,20,
31,"PRAHOVA",298,130534,,138,1,"MATERNITATEA PLOIESTI,STR.M.BRAVU,NR.102","MUNICIPIUL PLOIESTI",1,130534,1,1,0,206,0,206,200,6,395,189,156,44,
31,"PRAHOVA",298,130534,,139,1,"SPITALUL JUDETEAN,STR.GAGENI,NR.100","MUNICIPIUL PLOIESTI",1,130534,1,1,0,350,0,350,341,9,700,350,257,84,
31,"PRAHOVA",298,130534,,140,1,"UNIVERSITATEA PLOIESTI,B-DUL BUCURESTI,NR.3","MUNICIPIUL PLOIESTI",1,130534,1,1,0,340,0,340,332,8,1500,1160,204,128,
31,"PRAHOVA",298,131256,,141,0,"CASA DE CULTURA GEO BOGZA,STR.GRIVITEI,NR.95","MUNICIPIUL CAMPINA",2,131256,1,1,1498,902,851,51,886,16,1600,698,693,193,
31,"PRAHOVA",298,131256,,142,0,"COLEGIUL NATIONAL ""N.GRIGORESCU"",CALEA DOFTANEI,NR.4","MUNICIPIUL CAMPINA",2,131256,1,1,925,580,538,42,572,8,1000,420,449,123,
31,"PRAHOVA",298,131256,,143,0,"COLEGIUL NATIONAL ""N.GRIGORESCU"",CALEA DOFTANEI,NR.4","MUNICIPIUL CAMPINA",2,131256,1,1,1997,1208,1145,63,1180,28,2000,792,886,294,
31,"PRAHOVA",298,131256,,144,0,"S.C.EDIL CONST S.A.,STR,BUCEA,NR.2(CANTINA)","MUNICIPIUL CAMPINA",2,131256,1,1,1232,701,634,67,693,8,1300,599,505,188,
31,"PRAHOVA",298,131256,,145,0,"SC.GEN.NR.2,CALEA DOFTANEI,NR.13","MUNICIPIUL CAMPINA",2,131256,1,1,1237,670,623,47,660,10,1300,630,454,206,
31,"PRAHOVA",298,131256,,146,0,"GRUPUL SCOLAR INDUSTRIAL ENERGETIC,STR.GRIVITEI,NR.1","MUNICIPIUL CAMPINA",2,131256,1,1,1359,746,714,32,731,15,1500,754,580,151,
31,"PRAHOVA",298,131256,,147,0,"SC.GENR.7,STR.M.KOGALNICEANU,NR.31","MUNICIPIUL CAMPINA",2,131256,1,1,1714,877,821,56,861,16,1900,1023,622,239,
31,"PRAHOVA",298,131256,,148,0,"CASA TINERETULUI,B-DUL N.BALCESCU,NR.50","MUNICIPIUL CAMPINA",2,131256,1,1,1155,659,612,47,653,6,1300,641,490,163,
31,"PRAHOVA",298,131256,,149,0,"CLUBUL RAFINARIEI STEAUA ROMANA,CALEA DOFTANEI,NR.72","MUNICIPIUL CAMPINA",2,131256,1,1,1626,846,801,45,828,18,1800,954,577,251,
31,"PRAHOVA",298,131256,,150,0,"GRUPUL SCOLAR IND.ENERGETIC(SALA DE SPORT),STR.GRIVITEI,NR.1","MUNICIPIUL CAMPINA",2,131256,1,1,1117,623,581,42,618,5,1200,577,476,142,
31,"PRAHOVA",298,131256,,151,0,"GRUPUL SCOLAR FORESTIER(SALA DE SPORT),B-DUL CAROL I,NR.31","MUNICIPIUL CAMPINA",2,131256,1,1,1480,876,804,72,861,15,1600,724,614,247,
31,"PRAHOVA",298,131256,,152,0,"GRUPUL SCOLAR FORESTIER(SALA DE CLASA),B-DUL CAROL I,NR.31","MUNICIPIUL CAMPINA",2,131256,1,1,1486,869,822,47,857,12,1600,731,671,186,
31,"PRAHOVA",298,131256,,153,0,"SC.GEN.NR.1,STR.ERUPTIEI,NR.2","MUNICIPIUL CAMPINA",2,131256,1,1,1487,817,743,74,804,13,1500,683,561,243,
31,"PRAHOVA",298,131256,,154,0,"GRUPUL SCOLAR IND.PETROL(CAMIN),B-DUL N.BALCESCU,NR.45","MUNICIPIUL CAMPINA",2,131256,1,1,2010,1155,1080,75,1145,10,2190,1035,822,323,
31,"PRAHOVA",298,131256,,155,0,"S.C.ICIM-NOVA S.A.,STR.EC.TEODOROIU,NR.31","MUNICIPIUL CAMPINA",2,131256,1,1,1461,794,748,46,789,5,1600,806,587,202,
31,"PRAHOVA",298,131256,,156,0,"GRUPUL SCOLAR INDUSTRIAL PETROL,STR.GRIVITEI,NR.91","MUNICIPIUL CAMPINA",2,131256,1,1,1815,1269,974,295,1236,33,2000,731,906,330,
31,"PRAHOVA",298,131256,,157,0,"SC.GEN.NR.6,STR.CICEU,NR.2","MUNICIPIUL CAMPINA",2,131256,1,1,1144,755,687,68,742,13,1200,445,533,209,
31,"PRAHOVA",298,131256,,158,0,"GRUPUL SCOLAR IND.CONSTRUCTII DE MASINI(SALA DE SPORT),STR.EC.TEODOROIU,NR.34","MUNICIPIUL CAMPINA",2,131256,1,1,1461,786,750,36,772,14,1600,814,515,257,
31,"PRAHOVA",298,131256,,159,0,"GRADINITA NR.4,B-DUL CAROL,NR.131","MUNICIPIUL CAMPINA",2,131256,1,1,1428,903,846,57,893,10,1600,697,677,216,
31,"PRAHOVA",298,131256,,160,0,"S.C.ELECTROUTILAJ S.A.(CANTINA),STR.BOBALNA,NR.44","MUNICIPIUL CAMPINA",2,131256,1,1,1650,979,846,133,966,13,1700,721,669,297,
31,"PRAHOVA",298,131256,,161,0,"SC.GEN.NR.3,STR.VOILA,NR.11","MUNICIPIUL CAMPINA",2,131256,1,1,1401,1059,776,283,1040,19,1500,441,758,282,
31,"PRAHOVA",298,131256,,162,0,"GRUPUL SCOLAR IND.CONSTRUCTII MASINI,STR.EC.TEODOROIU,NR.34(CANTINA)","MUNICIPIUL CAMPINA",2,131256,1,1,1547,885,765,120,875,10,1700,815,563,312,
31,"PRAHOVA",298,131256,,163,0,"SC.GEN.NR.8,B-DUL CAROL I,NR.104","MUNICIPIUL CAMPINA",2,131256,1,1,1671,953,891,62,938,15,1900,947,696,242,
31,"PRAHOVA",298,131256,,164,1,"U.M.0433","MUNICIPIUL CAMPINA",2,131256,1,1,0,402,0,402,396,6,500,98,199,197,
31,"PRAHOVA",298,131256,,165,1,"U.M.0865","MUNICIPIUL CAMPINA",2,131256,1,1,0,504,0,504,480,24,600,96,307,173,
31,"PRAHOVA",298,130954,,166,0,"OCOLUL SILVIC AZUGA,STR.VICTORIEI,NR.63","ORAS AZUGA",3,130954,2,1,1704,1086,930,156,1074,12,1900,814,654,420,
31,"PRAHOVA",298,130954,,167,0,"LIC.TEORETIC AZUGA,STR.INDEPENDENTEI,NR.53","ORAS AZUGA",3,130954,2,1,1028,642,480,162,638,4,1100,458,413,225,
31,"PRAHOVA",298,130954,,168,0,"GRADINITA DE COPII,STR.VALEA AZUGII,NR.3","ORAS AZUGA",3,130954,2,1,1699,889,813,76,875,14,1900,1011,545,330,
31,"PRAHOVA",298,130981,,169,0,"CLUBUL ELEVILOR,STR.UNIRII,NR.4","ORAS BAICOI",4,130981,2,1,1833,1023,959,64,1014,9,2000,977,768,246,
31,"PRAHOVA",298,130981,,170,0,"LIC.DE CULTURA GENERALA BAICOI,STR.REPUBLICII,NR.111","ORAS BAICOI",4,130981,2,1,1893,1038,954,84,1031,7,2100,1062,702,329,
31,"PRAHOVA",298,130981,,171,0,"CLUBUL SCHELEI BAICOI,STR.REPUBLICII,NR.27","ORAS BAICOI",4,130981,2,1,1112,872,620,252,859,13,1200,328,605,254,
31,"PRAHOVA",298,130981,,172,0,"SC.GENERALA TUFENI,STR.POPA SAPCA,NR.117","ORAS BAICOI",4,130981,2,1,1183,684,603,81,684,0,1300,616,436,248,
31,"PRAHOVA",298,130981,,173,0,"SC.GEN.LILIESTI,STR.PROGRESULUI,NR.2","ORAS BAICOI",4,130981,2,1,1548,821,766,55,816,5,1700,879,481,335,
31,"PRAHOVA",298,130981,,174,0,"GRADINITA LILIESTI,STR.PROGRESULUI,NR.1","ORAS BAICOI",4,130981,2,1,1139,620,572,48,614,6,1300,680,414,200,
31,"PRAHOVA",298,130981,,175,0,"SC.NR.3,ANEXA LILIESTI,STR.REPUBLICII,NR.317","ORAS BAICOI",4,130981,2,1,1564,855,808,47,843,12,1700,845,585,258,
31,"PRAHOVA",298,130981,,176,0,"CASA DE CULTURA LILIESTI,STR.DOROBANTI,NR.6","ORAS BAICOI",4,130981,2,1,1277,832,677,155,827,5,1400,568,538,289,
31,"PRAHOVA",298,130981,,177,0,"GRADINITA LILIESTI,STR.DOROBANTI,NR.5","ORAS BAICOI",4,130981,2,1,1104,606,574,32,600,6,1200,594,406,194,
31,"PRAHOVA",298,130981,,178,0,"SC.GEN.TINTEA,STR.INDEPENDENTEI,NR.188","ORAS BAICOI",4,130981,2,1,1259,722,656,66,716,6,1400,678,493,223,
31,"PRAHOVA",298,130981,,179,0,"CASA DE CULTURA TINTEA,STR.INDEPENDENTEI,NR.177","ORAS BAICOI",4,130981,2,1,1114,636,586,50,629,7,1200,564,434,195,
31,"PRAHOVA",298,130981,,180,0,"SC.GEN.DAMBU,STR.DUMBRAVA ROSIE,NR.7","ORAS BAICOI",4,130981,2,1,1078,681,638,43,678,3,1200,519,478,200,
31,"PRAHOVA",298,131069,,181,0,"SC.GEN.NR.1 DIN CARTIERUL BOLDESTI,STR.PODGORIEI,NR.12","ORAS BOLDESTI-SCAENI",5,131069,2,1,1253,763,670,93,760,3,1400,637,453,307,
31,"PRAHOVA",298,131069,,182,0,"SC.GEN.NR.1 DIN CARTIERUL BOLDESTI,STR.PODGORIEI,NR.12","ORAS BOLDESTI-SCAENI",5,131069,2,1,1775,1013,960,53,1008,5,2000,987,592,416,
31,"PRAHOVA",298,131069,,183,0,"SC.GEN.NR.1 DIN CARTIERUL BOLDESTI,STR.PODGORIEI,NR.12","ORAS BOLDESTI-SCAENI",5,131069,2,1,1519,741,710,31,729,12,1700,959,469,260,
31,"PRAHOVA",298,131069,,184,0,"CASA DE CULTURA DIN CARTIERUL SCAIENI,STR.BUCOVULUI,NR.5","ORAS BOLDESTI-SCAENI",5,131069,2,1,1237,702,621,81,691,11,1400,698,423,268,
31,"PRAHOVA",298,131069,,185,0,"CASA DE CULTURA DIN CARTIERUL SCAIENI,STR.BUCOVULUI,NR.5","ORAS BOLDESTI-SCAENI",5,131069,2,1,1200,610,573,37,608,2,1300,690,372,236,
31,"PRAHOVA",298,131069,,186,0,"LIC.IND.SCAIENI,STR.BUCOVULUI,NR.6","ORAS BOLDESTI-SCAENI",5,131069,2,1,1167,676,622,54,667,9,1300,624,406,261,
31,"PRAHOVA",298,131069,,187,0,"SC.GEN.NR.3 DIN CARTIERUL SECIU","ORAS BOLDESTI-SCAENI",5,131069,2,1,872,427,396,31,424,3,1000,573,278,146,
31,"PRAHOVA",298,131069,,188,1,"U.M.0443","ORAS BOLDESTI-SCAENI",5,131069,2,1,0,307,0,307,293,14,400,93,191,102,
31,"PRAHOVA",298,131103,,189,0,"SC.PODU VADULUI,STR.23 AUGUST,NR.126","ORAS BREAZA",6,131103,2,1,1490,878,807,71,869,9,1600,722,607,262,
31,"PRAHOVA",298,131103,,190,0,"SC.BREAZA DE JOS,STR.LIBERTATII,NR.14","ORAS BREAZA",6,131103,2,1,1014,555,500,55,554,1,1100,545,434,120,
31,"PRAHOVA",298,131103,,191,0,"SC.BREAZA DE JOS,STR.LIBERTATII,NR.14","ORAS BREAZA",6,131103,2,1,1082,624,566,58,622,2,1200,576,481,141,
31,"PRAHOVA",298,131103,,192,0,"SC.PROFESIONALA UCECOM,STR.REPUBLICII,NR.25","ORAS BREAZA",6,131103,2,1,1477,867,784,83,853,14,1600,733,578,275,
31,"PRAHOVA",298,131103,,193,0,"SC.PROFESIONALA UCECOM,STR.REPUBLICII,NR.25","ORAS BREAZA",6,131103,2,1,1244,783,626,157,768,15,1400,617,576,192,
31,"PRAHOVA",298,131103,,194,0,"LICEUL A.VLAICU,STR.REPUBLICII,NR.94","ORAS BREAZA",6,131103,2,1,1652,957,861,96,945,12,1800,843,705,240,
31,"PRAHOVA",298,131103,,195,0,"LICEUL A.VLAICU,STR.REPUBLICII,NR.94","ORAS BREAZA",6,131103,2,1,1127,622,564,58,614,8,1200,578,429,185,
31,"PRAHOVA",298,131103,,196,0,"GRADINITA CU PROGRAM PRELUNGIT BREAZA,ALEEA LILIACULUI","ORAS BREAZA",6,131103,2,1,1058,588,543,45,579,9,1200,612,407,172,
31,"PRAHOVA",298,131103,,197,0,"SC.GEN.CAPUL CAMPULUI,STR.REPUBLICII,NR.214","ORAS BREAZA",6,131103,2,1,1313,812,725,87,800,12,1500,688,622,178,
31,"PRAHOVA",298,131103,,198,0,"GRADINITA GURA BELIEI,STR.30 DECEMBRIE,NR.57","ORAS BREAZA",6,131103,2,1,1070,588,535,53,584,4,1101,513,377,207,
31,"PRAHOVA",298,131103,,199,0,"SC.GEN.NISTORESTI","ORAS BREAZA",6,131103,2,1,1110,705,612,93,696,9,1200,495,482,214,
31,"PRAHOVA",298,131103,,200,0,"SC.GEN.VALEA TARSEI,STR.OCINEI,NR.183","ORAS BREAZA",6,131103,2,1,1168,572,533,39,566,6,1300,728,347,219,
31,"PRAHOVA",298,131103,,201,1,"LICEUL MILITAR D.CANTEMIR BREAZA","ORAS BREAZA",6,131103,2,1,0,141,0,141,139,2,200,59,61,78,
31,"PRAHOVA",298,131210,,202,0,"LIC.IND.BUSTENI,STR.ALPINISTILOR,NR.1","ORAS BUSTENI",7,131210,2,1,1153,707,523,184,697,10,1200,493,469,228,
31,"PRAHOVA",298,131210,,203,0,"SC.GEN.NR.1,B-DUL LIBERTATII,NR.123","ORAS BUSTENI",7,131210,2,1,1133,746,548,198,730,16,1301,555,525,205,
31,"PRAHOVA",298,131210,,204,0,"SC.GEN.NR.1,B-DUL LIBERTATII,NR.123","ORAS BUSTENI",7,131210,2,1,902,616,508,108,602,14,1000,384,414,188,
31,"PRAHOVA",298,131210,,205,0,"CENTRUL DE PLASAMENT BUSTENI,STR.CEZAR PETRESCU,NR.9","ORAS BUSTENI",7,131210,2,1,1031,600,516,84,592,8,1100,500,410,182,
31,"PRAHOVA",298,131210,,206,0,"GRADINITA NR.4 ZAMORA,STR.PANDURI","ORAS BUSTENI",7,131210,2,1,1186,641,538,103,631,10,1400,759,449,182,
31,"PRAHOVA",298,131210,,207,0,"SC.NR.3 DIN POIANA TAPULUI,STR.CRINULUI,NR.2","ORAS BUSTENI",7,131210,2,1,1253,892,671,221,877,15,1404,512,568,309,
31,"PRAHOVA",298,131210,,208,0,"SC.GEN.NR.2,STR.SCOLII,NR.20","ORAS BUSTENI",7,131210,2,1,1288,786,658,128,774,12,1400,614,514,260,
31,"PRAHOVA",298,131210,,209,0,"SC.GEN.NR.2,STR.SCOLII,NR.20","ORAS BUSTENI",7,131210,2,1,1269,732,643,89,726,6,1400,668,478,248,
31,"PRAHOVA",298,131336,,210,0,"GRUPUL SCOLAR SIMION STOLNICU COMARNIC,STR.REPUBLICII,NR.30","ORAS COMARNIC",8,131336,2,1,1613,886,787,99,879,7,1800,914,632,247,
31,"PRAHOVA",298,131336,,211,0,"SC.GEN.NR.2 COMARNIC(VATRA SATULUI) CORPUL 1,STR.EROU NICOARA STELIAN,NR.2","ORAS COMARNIC",8,131336,2,1,940,568,531,37,561,7,1000,432,398,163,
31,"PRAHOVA",298,131336,,212,0,"SC.GEN.NR.2 COMARNIC(VATRA SATULUI) CORPUL 2,STR.EROU NICOARA STELIAN,NR.2","ORAS COMARNIC",8,131336,2,1,1418,690,662,28,686,4,1600,910,505,181,
31,"PRAHOVA",298,131336,,213,0,"SC.GEN.NR.3 COMARNIC (POIANA),STR.POIANA,NR.183","ORAS COMARNIC",8,131336,2,1,1577,857,819,38,846,11,1700,843,613,233,
31,"PRAHOVA",298,131336,,214,0,"GRADINITA DE PRESCOLARI POIANA COMARNIC,STR.POIANA,NR.153","ORAS COMARNIC",8,131336,2,1,866,535,499,36,532,3,1000,465,369,163,
31,"PRAHOVA",298,131336,,215,0,"SC.PRIMARA PODUL LUNG,STR.PODUL LUNG,NR.33","ORAS COMARNIC",8,131336,2,1,503,304,285,19,302,2,600,296,215,87,
31,"PRAHOVA",298,131336,,216,0,"GRADINITA DE PRESCOLARI NR.2 GHIOSESTI,STR.GHIOSESTI,NR.298","ORAS COMARNIC",8,131336,2,1,1621,903,840,63,890,13,1800,897,629,261,
31,"PRAHOVA",298,131336,,217,0,"SC.PRIMARA GHIOSESTI,STR.GHIOSESTI,NR.89","ORAS COMARNIC",8,131336,2,1,1162,604,559,45,600,4,1300,696,431,169,
31,"PRAHOVA",298,131336,,218,0,"SC.GEN.NR.4 COMARNIC(POSADA),STR.PODUL VARTOS,NR.118","ORAS COMARNIC",8,131336,2,1,1108,684,618,66,677,7,1200,516,450,227,
31,"PRAHOVA",298,131407,,219,0,"AGROMEC,STR.M.BRAVU,NR.216","ORAS MIZIL",9,131407,2,1,1982,1132,1052,80,1113,19,2200,1068,827,286,
31,"PRAHOVA",298,131407,,220,0,"SC.NR.2,STR.TOHANI,NR.38","ORAS MIZIL",9,131407,2,1,2389,1355,1284,71,1336,19,2600,1245,1009,327,
31,"PRAHOVA",298,131407,,221,0,"SC.NR.1,STR.M.BRAVU,NR.110","ORAS MIZIL",9,131407,2,1,2037,1047,1000,47,1031,16,2200,1153,695,336,
31,"PRAHOVA",298,131407,,222,0,"CASA DE CULTURA,STR.M.BRAVU,NR.110","ORAS MIZIL",9,131407,2,1,2087,1065,1011,54,1055,10,2302,1237,685,370,
31,"PRAHOVA",298,131407,,223,0,"LIC.TEORETIC,STR. N.BALCESCU,NR.133","ORAS MIZIL",9,131407,2,1,1941,1039,939,100,1030,9,2102,1063,723,307,
31,"PRAHOVA",298,131407,,224,0,"SC.NR.3,STR.EROU LT.RADU NICOLAE,NR.2","ORAS MIZIL",9,131407,2,1,1392,778,721,57,770,8,1502,724,532,238,
31,"PRAHOVA",298,131407,,225,0,"SC.NR.3,STR.EROU LT.RADU NICOLAE,NR.2","ORAS MIZIL",9,131407,2,1,1223,700,674,26,683,17,1302,602,469,214,
31,"PRAHOVA",298,131443,,226,0,"CASA DE CULTURA,B-DUL REPUBLICII,NR.2","ORAS PLOPENI",10,131443,2,1,1383,985,846,139,977,8,1500,515,674,303,
31,"PRAHOVA",298,131443,,227,0,"CLUB S.C.PLOPENI S.A.,B-DUL REPUBLICII,NR.2","ORAS PLOPENI",10,131443,2,1,1714,1257,1031,226,1243,14,1900,643,817,426,
31,"PRAHOVA",298,131443,,228,0,"LIC.IND.PLOPENI,B-DUL REPUBLICII,NR.21B","ORAS PLOPENI",10,131443,2,1,1642,986,954,32,978,8,1800,814,636,342,
31,"PRAHOVA",298,131443,,229,0,"SC.PROF.,B-DUL REPUBLICII,NR.10","ORAS PLOPENI",10,131443,2,1,1582,886,845,41,877,9,1700,814,549,328,
31,"PRAHOVA",298,131443,,230,0,"SC.GENERALA,B-DUL REPUBLICII,NR.25","ORAS PLOPENI",10,131443,2,1,1491,868,833,35,857,11,1600,732,568,289,
31,"PRAHOVA",298,131540,,231,0,"SC.GEN.NR.1,B-DUL CAROL I,NR.36","ORAS SINAIA",11,131540,2,1,1253,1064,664,400,1044,20,1400,336,747,297,
31,"PRAHOVA",298,131540,,232,0,"TABARA SCOLARA SINAIA,B-DUL CAROL I,NR.38","ORAS SINAIA",11,131540,2,1,1225,826,642,184,812,14,1400,574,588,224,
31,"PRAHOVA",298,131540,,233,0,"SOC.REPREZENTARE SI PROTOCOL-SUCURSALA SINAIA,STR.FURNICA,NR.52","ORAS SINAIA",11,131540,2,1,958,707,516,191,698,9,1100,393,499,199,
31,"PRAHOVA",298,131540,,234,0,"SC.M.KOGALNICEANU,STR.M.KOGALNICEANU,NR.80","ORAS SINAIA",11,131540,2,1,1168,653,577,76,646,7,1300,647,469,177,
31,"PRAHOVA",298,131540,,235,0,"CLUBUL S.C.MEFIN S.A. SINAIA(PARTER),B-DUL REPUBLICII,NR.16","ORAS SINAIA",11,131540,2,1,988,686,589,97,681,5,1100,414,511,170,
31,"PRAHOVA",298,131540,,236,0,"CLUBUL S.C.MEFIN S.A. SINAIA(ETAJ),B-DUL REPUBLICII,NR.16","ORAS SINAIA",11,131540,2,1,924,580,546,34,569,11,1000,420,426,143,
31,"PRAHOVA",298,131540,,237,0,"SC.GEN.NR.2,CALEA MOROIENI,NR.25(CORP A)","ORAS SINAIA",11,131540,2,1,1560,980,856,124,953,27,1700,720,616,337,
31,"PRAHOVA",298,131540,,238,0,"SC.GEN.NR.2,CALEA MOROIENI,NR.25(CORP B)","ORAS SINAIA",11,131540,2,1,1524,983,885,98,966,17,1700,717,670,296,
31,"PRAHOVA",298,131540,,239,0,"GRUPUL SCOLAR M.CANTACUZINO SINAIA,CALEA BUCURESTI,NR.40","ORAS SINAIA",11,131540,2,1,1185,677,625,52,661,16,1300,623,433,228,
31,"PRAHOVA",298,131540,,240,0,"GRUPUL SCOLAR M.CANTACUZINO SINAIA(CANTINA),CALEA BUCURESTI,NR.40","ORAS SINAIA",11,131540,2,1,803,455,402,53,448,7,900,445,303,145,
31,"PRAHOVA",298,131540,,241,1,"U.M.01692","ORAS SINAIA",11,131540,2,1,353,319,291,28,312,7,600,281,212,100,
31,"PRAHOVA",298,131577,,242,0,"SC.PRAJANI,CALEA PLOIESTI NR.248","ORAS SLANIC",12,131577,2,1,1141,748,676,72,739,9,1302,554,500,239,
31,"PRAHOVA",298,131577,,243,0,"LIC.TEORETIC SLANIC(PARTER),STR.SLANICULUI,NR.11","ORAS SLANIC",12,131577,2,1,1721,1009,866,143,994,15,1600,591,618,376,
31,"PRAHOVA",298,131577,,244,0,"LIC.TEORETIC SLANIC(ETAJ),STR.SLANICULUI,NR.11","ORAS SLANIC",12,131577,2,1,1367,1017,757,260,1000,17,2000,983,649,351,
31,"PRAHOVA",298,131577,,245,0,"SC.GROSANI,STR.STEFAN CEL MARE,NR.24","ORAS SLANIC",12,131577,2,1,1720,1122,1073,49,1111,11,1700,578,808,303,
31,"PRAHOVA",298,131620,,246,0,"CRESA-GRADINITA,STR.T.VLADIMIRESCU,NR.10A","ORAS URLATI",13,131620,2,1,1419,794,738,56,785,9,1500,706,505,280,
31,"PRAHOVA",298,131620,,247,0,"LIC.TEORETIC URLATI(CLADIREA VECHE),STR.1 MAI,NR.73","ORAS URLATI",13,131620,2,1,1941,1077,1017,60,1060,17,2100,1023,714,346,
31,"PRAHOVA",298,131620,,248,0,"LIC.TEORETIC URLATI,STR.1 MAI,NR.30","ORAS URLATI",13,131620,2,1,1321,748,671,77,737,11,1500,752,538,199,
31,"PRAHOVA",298,131620,,249,0,"SC.GEN.NR.2,STR.VIILOR,NR.1","ORAS URLATI",13,131620,2,1,1563,913,865,48,902,11,1700,787,565,337,
31,"PRAHOVA",298,131620,,250,0,"CASA DE CULTURA,STR.T.VLADIMIRESCU,NR.47","ORAS URLATI",13,131620,2,1,1331,776,686,90,764,12,1500,724,508,256,
31,"PRAHOVA",298,131620,,251,0,"SC.JERCALAI","ORAS URLATI",13,131620,2,1,636,320,295,25,317,3,700,380,199,118,
31,"PRAHOVA",298,131620,,252,0,"SC.GENERALA(CLADIREA NOUA),STR.CHERBA,NR.1","ORAS URLATI",13,131620,2,1,835,402,352,50,395,7,900,498,251,144,
31,"PRAHOVA",298,131817,,253,0,"SALA DE SEDINTE A PRIMARIEI,B-DUL N.IORGA,NR.77","ORAS VALENII DE MUNTE",14,131817,2,1,1591,924,834,90,913,11,1700,776,599,314,
31,"PRAHOVA",298,131817,,254,0,"CASA DE CULTURA ,STR.BEREVOIESTI,NR.9","ORAS VALENII DE MUNTE",14,131817,2,1,1559,893,795,98,884,9,1700,807,598,286,
31,"PRAHOVA",298,131817,,255,0,"CLUBUL ELEVILOR,STR.BERCENI,NR.1","ORAS VALENII DE MUNTE",14,131817,2,1,1487,879,816,63,871,8,1603,724,615,256,
31,"PRAHOVA",298,131817,,256,0,"SC.GEN.NR.3,STR.BERCENI,NR.18","ORAS VALENII DE MUNTE",14,131817,2,1,1636,1086,976,110,1070,16,1800,714,765,305,
31,"PRAHOVA",298,131817,,257,0,"GRADINITA NR.4,B-DUL N.IORGA,NR.96","ORAS VALENII DE MUNTE",14,131817,2,1,1009,581,542,39,573,8,1100,519,405,168,
31,"PRAHOVA",298,131817,,258,0,"GRUPUL SCOLAR AGROMONTAN ROMEO CONSTANTINESCU,STR.BRAZILOR,NR.1","ORAS VALENII DE MUNTE",14,131817,2,1,1305,662,614,48,659,3,1383,721,453,206,
31,"PRAHOVA",298,131817,,259,0,"SCOALA DIN CARTIERUL MIULESTI,B-DUL N.IORGA,NR.188","ORAS VALENII DE MUNTE",14,131817,2,1,1440,925,849,76,910,15,1600,675,625,285,
31,"PRAHOVA",298,131817,,260,0,"SCOALA DIN CARTIERUL VALEA GARDULUI,STR.DR.ISTRATE,NR.2","ORAS VALENII DE MUNTE",14,131817,2,1,805,590,552,38,579,11,900,310,392,187,
31,"PRAHOVA",298,131899,,261,0,"Caminul cultural din Adunati","ADUNATI",15,131899,0,3,1841,1104,1034,70,1085,19,2000,896,706,379,
31,"PRAHOVA",298,131933,,262,0,"Gradinita ALBESTI PALEOLOGU","ALBESTI-PALEOLOGU",16,131933,0,3,1616,853,752,101,835,18,1800,947,544,291,
31,"PRAHOVA",298,131933,,263,0,"Scoala VADU PARULUI","ALBESTI-PALEOLOGU",16,131933,0,3,1671,836,740,96,823,13,1800,964,552,271,
31,"PRAHOVA",298,131933,,264,0,"Gradinita ALBESTI MURU","ALBESTI-PALEOLOGU",16,131933,0,3,848,524,456,68,520,4,900,376,344,176,
31,"PRAHOVA",298,131933,,265,0,"Scoala CIOCENI","ALBESTI-PALEOLOGU",16,131933,0,3,657,421,373,48,414,7,700,279,300,114,
31,"PRAHOVA",298,131988,,266,0,"Scoala nr.1 ALUNIS","ALUNIS",17,131988,0,3,1408,876,750,126,866,10,1600,724,586,280,
31,"PRAHOVA",298,131988,,267,0,"Scoala NR.2 ALUNIS (VALE)","ALUNIS",17,131988,0,3,792,474,406,68,471,3,800,326,296,175,
31,"PRAHOVA",298,131988,,268,0,"Scoala nr.3 OSTROV","ALUNIS",17,131988,0,3,815,515,420,95,509,6,900,385,347,162,
31,"PRAHOVA",298,132011,,269,0,"Caminul cultural APOSTOLACHE","APOSTOLACHE",18,132011,0,3,1848,830,752,78,826,4,2000,1170,497,329,
31,"PRAHOVA",298,132075,,270,0,"Scoala ARICESTII RAHTIVANI","ARICESTII RAHTIVANI",19,132075,0,3,1107,606,545,61,595,11,1200,594,387,208,
31,"PRAHOVA",298,132075,,271,0,"Caminul cultural ARICESTII RAHTIVANI","ARICESTII RAHTIVANI",19,132075,0,3,1078,513,445,68,503,10,1200,687,306,197,
31,"PRAHOVA",298,132075,,272,0,"Scoala NEDELEA","ARICESTII RAHTIVANI",19,132075,0,3,1916,1017,941,76,1008,9,2100,1083,616,392,
31,"PRAHOVA",298,132075,,273,0,"Scoala BUDA","ARICESTII RAHTIVANI",19,132075,0,3,235,235,140,95,235,0,300,65,165,70,
31,"PRAHOVA",298,132075,,274,0,"Scoala STOENESTI","ARICESTII RAHTIVANI",19,132075,0,3,987,533,463,70,530,3,1100,567,349,181,
31,"PRAHOVA",298,132075,,275,0,"Scoala TARGSORUL NOU","ARICESTII RAHTIVANI",19,132075,0,3,846,594,485,109,582,12,900,306,405,177,
31,"PRAHOVA",298,132137,,276,0,"Primarie ARICESTII ZELETIN","ARICESTII ZELETIN",20,132137,0,3,1181,583,516,67,575,8,1301,718,420,155,
31,"PRAHOVA",298,132164,,277,0,"Scoala BABA ANA","BABA ANA",21,132164,0,3,1679,967,906,61,958,9,1800,833,655,303,
31,"PRAHOVA",298,132164,,278,0,"Scoala CONDURATU","BABA ANA",21,132164,0,3,969,638,552,86,634,4,1100,462,490,144,
31,"PRAHOVA",298,132164,,279,0,"Scoala CIRESANI","BABA ANA",21,132164,0,3,677,430,373,57,426,4,700,270,348,78,
31,"PRAHOVA",298,132226,,280,0,"Scoala BALTA DOAMNEI","BALTA DOAMNEI",22,132226,0,3,1224,552,499,53,542,10,1300,748,334,208,
31,"PRAHOVA",298,132226,,281,0,"Scoala BARA","BALTA DOAMNEI",22,132226,0,3,879,519,454,65,514,5,1000,481,419,95,
31,"PRAHOVA",298,132271,,282,0,"Caminul cultural PODENII VECHI","BALTESTI",23,132271,0,3,1476,879,817,62,862,17,1600,721,457,405,
31,"PRAHOVA",298,132271,,283,0,"Caminul cultural BALTESTI","BALTESTI",23,132271,0,3,1221,809,691,118,800,9,1300,491,448,352,
31,"PRAHOVA",298,132315,,284,0,"Scoala BANESTI","BANESTI",24,132315,0,3,1582,774,698,76,768,6,1700,926,576,192,
31,"PRAHOVA",298,132315,,285,0,"Fost camin cultural BANESTI STR.URLETII 583","BANESTI",24,132315,0,3,1121,786,657,129,779,7,1200,414,592,187,
31,"PRAHOVA",298,132315,,286,0,"Gradinita URLETA","BANESTI",24,132315,0,3,1091,636,563,73,630,6,1200,564,444,186,
31,"PRAHOVA",298,132315,,287,0,"Scoala URLETA(LOCAL VECHI)","BANESTI",24,132315,0,3,856,608,513,95,601,7,900,292,408,193,
31,"PRAHOVA",298,130552,,288,0,"Scoala BARCANESTI","BARCANESTI",25,130552,0,3,1307,521,425,96,518,3,1400,879,360,158,
31,"PRAHOVA",298,130552,,289,0,"SCoala BARCANESTI","BARCANESTI",25,130552,0,3,1063,591,490,101,587,4,1202,611,394,193,
31,"PRAHOVA",298,130552,,290,0,"Scoala ROMANESTI","BARCANESTI",25,130552,0,3,1682,797,676,121,782,15,1900,1103,543,239,
31,"PRAHOVA",298,130552,,291,0,"Scoala TATARANI","BARCANESTI",25,130552,0,3,1258,580,512,68,571,9,1400,820,377,194,
31,"PRAHOVA",298,130552,,292,0,"Scoala TATARANI","BARCANESTI",25,130552,0,3,1111,609,518,91,604,5,1200,591,348,256,
31,"PRAHOVA",298,130552,,293,0,"Scoala GHIGHIU","BARCANESTI",25,130552,0,3,519,287,240,47,284,3,600,313,190,94,
31,"PRAHOVA",298,130614,,294,0,"Scoala BERCENI","BERCENI",26,130614,0,3,1471,740,663,77,737,3,1600,860,446,291,
31,"PRAHOVA",298,130614,,295,0,"Gradinita BERCENI","BERCENI",26,130614,0,3,681,489,363,126,481,8,800,311,284,197,
31,"PRAHOVA",298,130614,,296,0,"Scoala CORLATESTI","BERCENI",26,130614,0,3,1057,660,562,98,647,13,1200,540,426,221,
31,"PRAHOVA",298,130614,,297,0,"Caminul cultural DAMBU","BERCENI",26,130614,0,3,337,243,190,53,243,0,400,157,192,51,
31,"PRAHOVA",298,130614,,298,0,"Scoala CATUNU","BERCENI",26,130614,0,3,463,333,236,97,323,10,500,167,193,130,
31,"PRAHOVA",298,130614,,299,0,"Scoala MOARA NOUA","BERCENI",26,130614,0,3,657,414,314,100,408,6,600,186,300,108,
31,"PRAHOVA",298,132342,,300,0,"Gradinita nr.1 BERTEA","BERTEA",27,132342,0,3,1560,837,790,47,828,9,1800,963,520,308,
31,"PRAHOVA",298,132342,,301,0,"Gradinita nr.2 BERTEA","BERTEA",27,132342,0,3,1158,683,633,50,673,10,1200,517,457,216,
31,"PRAHOVA",298,130678,,302,0,"Scoala BLEJOI","BLEJOI",28,130678,0,3,1447,813,674,139,802,11,1600,787,563,239,
31,"PRAHOVA",298,130678,,303,0,"Gradinita BLEJOI","BLEJOI",28,130678,0,3,1615,762,636,126,753,9,1800,1038,492,261,
31,"PRAHOVA",298,130678,,304,0,"Gradinita PLOIESTIORI","BLEJOI",28,130678,0,3,1050,544,451,93,540,4,1200,656,351,189,
31,"PRAHOVA",298,130678,,305,0,"Scoala PLOIESTIORI","BLEJOI",28,130678,0,3,1164,596,497,99,586,10,1302,706,409,177,
31,"PRAHOVA",298,130678,,306,0,"Gradinita TANTARENI","BLEJOI",28,130678,0,3,996,649,465,184,646,3,1098,449,466,180,
31,"PRAHOVA",298,132379,,307,0,"Scoala BOLDESTI","BOLDESTI-GRADISTEA",29,132379,0,3,853,572,532,40,564,8,1000,428,396,168,
31,"PRAHOVA",298,132379,,308,0,"Scoala GRADISTEA","BOLDESTI-GRADISTEA",29,132379,0,3,858,537,504,33,527,10,900,363,369,158,
31,"PRAHOVA",298,130712,,309,0,"Scoala BATESTI","BRAZI",30,130712,0,3,1316,775,707,68,774,1,1500,725,500,274,
31,"PRAHOVA",298,130712,,310,0,"Scoala BRAZII DE SUS","BRAZI",30,130712,0,3,1735,900,798,102,892,8,1900,1000,571,321,
31,"PRAHOVA",298,130712,,311,0,"Scoala POPESTI","BRAZI",30,130712,0,3,1360,838,747,91,830,8,1500,662,492,338,
31,"PRAHOVA",298,130712,,312,0,"Scoala NEGOIESTI","BRAZI",30,130712,0,3,1499,927,858,69,918,9,1600,673,653,265,
31,"PRAHOVA",298,130712,,313,0,"Scoala STEJARU","BRAZI",30,130712,0,3,450,282,242,40,278,4,500,218,113,165,
31,"PRAHOVA",298,130712,,314,1,"UNITATE MILITARA 01065 NEGOIESTI","BRAZI",30,130712,0,3,0,96,0,96,95,1,100,4,58,37,
31,"PRAHOVA",298,132404,,315,0,"Scoala BREBU MANASTIREI(LOCALUL VECHI)","BREBU",31,132404,0,3,877,504,457,47,501,3,1000,496,408,93,
31,"PRAHOVA",298,132404,,316,0,"Scoala NR.1 BREBU MANASTIREI(LOCALUL NOU)","BREBU",31,132404,0,3,1431,769,706,63,755,14,1600,831,549,206,
31,"PRAHOVA",298,132404,,317,0,"Scoala NR.2 BREBU MEGIESESC(LACUL SEC)","BREBU",31,132404,0,3,1552,874,789,85,861,13,1600,726,665,196,
31,"PRAHOVA",298,132404,,318,0,"Scoala BREBU MEGIESESC","BREBU",31,132404,0,3,1232,723,645,78,714,9,1300,577,502,212,
31,"PRAHOVA",298,132404,,319,0,"Scoala PIETRICEAUA","BREBU",31,132404,0,3,1075,571,536,35,560,11,1200,629,388,172,
31,"PRAHOVA",298,130785,,320,0,"Scoala BUCOV","BUCOV",32,130785,0,3,1760,776,685,91,769,7,1900,1124,566,203,
31,"PRAHOVA",298,130785,,321,0,"Gradinita BUCOV","BUCOV",32,130785,0,3,1745,988,878,110,978,10,1900,912,668,310,
31,"PRAHOVA",298,130785,,322,0,"Scoala PLEASA","BUCOV",32,130785,0,3,1203,602,517,85,592,10,1300,698,358,234,
31,"PRAHOVA",298,130785,,323,0,"Gradinita PLEASA","BUCOV",32,130785,0,3,1121,654,542,112,643,11,1200,546,368,275,
31,"PRAHOVA",298,130785,,324,0,"Grdinita CHITORANI","BUCOV",32,130785,0,3,1096,560,479,81,553,7,1200,640,371,182,
31,"PRAHOVA",298,130785,,325,0,"Gradinita PLEASA","BUCOV",32,130785,0,3,639,500,247,253,497,3,700,200,219,278,
31,"PRAHOVA",298,132459,,326,0,"Caminul cultural CALUGARENI","CALUGARENI",33,132459,0,3,1139,654,577,77,643,11,1300,646,437,206,
31,"PRAHOVA",298,132486,,327,0,"Scoala CARBUNESTI(SALA DE GIMNASTICA)","CARBUNESTI",34,132486,0,3,1469,778,729,49,769,9,1600,822,470,299,
31,"PRAHOVA",298,132510,,328,0,"Scoala CEPTURA DE JOS","CEPTURA",35,132510,0,3,2060,1064,945,119,1047,17,2300,1236,819,228,
31,"PRAHOVA",298,132510,,329,0,"Scoala CEPTURA DE SUS","CEPTURA",35,132510,0,3,527,389,306,83,385,4,600,211,310,75,
31,"PRAHOVA",298,132510,,330,0,"Scoala SOIMESTI","CEPTURA",35,132510,0,3,651,354,300,54,351,3,700,346,244,107,
31,"PRAHOVA",298,132510,,331,0,"Fostul CAP ROTARI","CEPTURA",35,132510,0,3,715,365,289,76,362,3,800,435,245,117,
31,"PRAHOVA",298,132510,,332,0,"Scoala MALU ROSU","CEPTURA",35,132510,0,3,215,128,96,32,125,3,300,172,99,26,
31,"PRAHOVA",298,132574,,333,0,"Scoala NR.1 CERASU","CERASU",36,132574,0,3,2023,1239,1147,92,1224,15,2200,961,858,366,
31,"PRAHOVA",298,132574,,334,0,"Scoala SLON","CERASU",36,132574,0,3,1754,1087,1043,44,1076,11,1900,813,828,248,
31,"PRAHOVA",298,132645,,335,0,"Gradinita CHIOJDEANCA","CHIOJDEANCA",37,132645,0,3,954,468,424,44,458,10,1100,632,286,172,
31,"PRAHOVA",298,132645,,336,0,"Caminul CULTURAL TRENU","CHIOJDEANCA",37,132645,0,3,506,342,298,44,335,7,500,158,216,119,
31,"PRAHOVA",298,132681,,337,0,"Liceul CIORANI  (cladire veche)","CIORANI",38,132681,0,3,1413,739,684,55,727,12,1600,861,512,215,
31,"PRAHOVA",298,132681,,338,0,"Liceul CIORANI  (cladire noua)","CIORANI",38,132681,0,3,1519,949,851,98,939,10,1700,751,714,225,
31,"PRAHOVA",298,132681,,339,0,"Caminul cultural CIORANII DE JOS","CIORANI",38,132681,0,3,936,642,550,92,633,9,1000,358,462,171,
31,"PRAHOVA",298,132681,,340,0,"Scoala CIORANII DE SUS (cladire noua)","CIORANI",38,132681,0,3,891,686,594,92,670,16,1000,314,502,168,
31,"PRAHOVA",298,132681,,341,0,"Scoala CIORANII DE SUS (cladire veche)","CIORANI",38,132681,0,3,951,699,600,99,689,10,1000,301,505,184,
31,"PRAHOVA",298,132681,,342,1,"UM 0235 CIORANI","CIORANI",38,132681,0,3,98,120,98,22,117,3,300,180,79,38,
31,"PRAHOVA",298,132716,,343,0,"Caminul cultural COCORASTII MISLII","COCORASTII MISLII",39,132716,0,3,1586,1045,980,65,1040,5,1800,755,672,368,
31,"PRAHOVA",298,132716,,344,0,"Scoala GORUNA","COCORASTII MISLII",39,132716,0,3,1267,883,806,77,875,8,1300,417,620,255,
31,"PRAHOVA",298,132752,,345,0,"Scoala COLCEAG","COLCEAG",40,132752,0,3,1965,990,820,170,965,25,2202,1212,757,208,
31,"PRAHOVA",298,132752,,346,0,"Scoala INOTESTI","COLCEAG",40,132752,0,3,1568,975,760,215,965,10,1700,725,700,265,
31,"PRAHOVA",298,132752,,347,0,"Scoala PAREPA -RUSANI","COLCEAG",40,132752,0,3,1008,700,588,112,666,34,1100,400,568,98,
31,"PRAHOVA",298,132805,,348,0,"Gradinita CORNU DE JOS","CORNU",41,132805,0,3,1370,747,654,93,742,5,1400,653,591,151,
31,"PRAHOVA",298,132805,,349,0,"Scoala CORNU DE JOS","CORNU",41,132805,0,3,1313,816,690,126,812,4,1500,684,637,175,
31,"PRAHOVA",298,132805,,350,0,"Scoala CORNU DE SUS","CORNU",41,132805,0,3,856,579,536,43,570,9,1000,421,477,93,
31,"PRAHOVA",298,132841,,351,0,"Caminul cultural COSMINA DE JOS","COSMINELE",42,132841,0,3,1064,658,617,41,655,3,1200,542,346,309,
31,"PRAHOVA",298,132896,,352,0,"Scoala DRAJNA DE JOS","DRAJNA",44,132896,0,3,1607,960,868,92,951,9,1802,842,665,286,
31,"PRAHOVA",298,132896,,353,0,"Scoala PLAISANI","DRAJNA",44,132896,0,3,644,388,333,55,385,3,700,312,293,92,
31,"PRAHOVA",298,132896,,354,0,"Scoala DRAJNA DE SUS","DRAJNA",44,132896,0,3,1207,650,571,79,644,6,1102,452,416,228,
31,"PRAHOVA",298,132896,,355,0,"Scoala OGRETIN","DRAJNA",44,132896,0,3,1092,561,477,84,555,6,1202,641,353,202,
31,"PRAHOVA",298,132896,,356,1,"Sanatoriul TBC DRAJNA","DRAJNA",44,132896,0,3,0,159,0,159,157,2,400,241,76,81,
31,"PRAHOVA",298,133018,,357,0,"Scoala DRAGANESTI","DRAGANESTI",43,133018,0,3,975,684,625,59,669,15,1100,416,470,199,
31,"PRAHOVA",298,133018,,358,0,"Scoala MERI","DRAGANESTI",43,133018,0,3,794,478,418,60,471,7,900,422,328,143,
31,"PRAHOVA",298,133018,,359,0,"Scoala BARAITARU","DRAGANESTI",43,133018,0,3,724,475,429,46,466,9,800,325,327,139,
31,"PRAHOVA",298,133018,,360,0,"Gradinita BELCIUG","DRAGANESTI",43,133018,0,3,513,331,271,60,322,9,600,269,208,114,
31,"PRAHOVA",298,133018,,361,0,"Scoala CORNU DE JOS","DRAGANESTI",43,133018,0,3,497,343,275,68,340,3,600,257,241,99,
31,"PRAHOVA",298,133018,,362,0,"Scoala HATCARAU","DRAGANESTI",43,133018,0,3,484,321,287,34,316,5,500,179,222,94,
31,"PRAHOVA",298,133090,,363,0,"Scoala DUMBRAVA","DUMBRAVA",45,133090,0,3,1539,804,695,109,794,10,1700,896,480,314,
31,"PRAHOVA",298,133090,,364,0,"Scoala ZANOAGA","DUMBRAVA",45,133090,0,3,658,412,328,84,408,4,700,288,276,132,
31,"PRAHOVA",298,133090,,365,0,"Scoala CIUPELNITA","DUMBRAVA",45,133090,0,3,1227,666,539,127,655,11,1300,634,465,190,
31,"PRAHOVA",298,131461,,366,0,"Caminul cultural DUMBRAVESTI","DUMBRAVESTI",46,131461,0,3,1661,862,732,130,855,7,1800,938,542,313,
31,"PRAHOVA",298,131461,,367,0,"Scoala PLOPENI SAT","DUMBRAVESTI",46,131461,0,3,1198,780,690,90,770,10,1300,520,511,259,
31,"PRAHOVA",298,133161,,368,0,"Clubul MINERUL FILIPESTII DE PADURE","FILIPESTII DE PADURE",48,133161,0,3,1012,496,425,71,490,6,1100,604,285,205,
31,"PRAHOVA",298,133161,,369,0,"Scoala VECHE FILIPESTII DE PADURE","FILIPESTII DE PADURE",48,133161,0,3,1342,723,650,73,716,7,1500,777,436,280,
31,"PRAHOVA",298,133161,,370,0,"Liceul Teoretic FILIPESTII DE PADURE","FILIPESTII DE PADURE",48,133161,0,3,1775,1049,915,134,1038,11,1900,851,622,416,
31,"PRAHOVA",298,133161,,371,0,"Scoala DITESTI corpul 2","FILIPESTII DE PADURE",48,133161,0,3,1279,646,537,109,642,4,1400,754,401,241,
31,"PRAHOVA",298,133161,,372,0,"Scoala DITESTI corpul 3","FILIPESTII DE PADURE",48,133161,0,3,1526,821,771,50,810,11,1700,879,550,260,
31,"PRAHOVA",298,133161,,373,0,"Grup SCOLAR INDUSTRIAL SAT MINIER","FILIPESTII DE PADURE",48,133161,0,3,1076,583,494,89,581,2,1200,617,326,255,
31,"PRAHOVA",298,133214,,374,0,"Scoala FILIPESTII DE TARG","FILIPESTII DE TARG",49,133214,0,3,1217,547,479,68,540,7,1300,753,350,190,
31,"PRAHOVA",298,133214,,375,0,"Caminul cultural FILIPESTII DE TARG","FILIPESTII DE TARG",49,133214,0,3,964,570,468,102,562,8,1100,530,330,232,
31,"PRAHOVA",298,133214,,376,0,"Scoala BRATASANCA","FILIPESTII DE TARG",49,133214,0,3,1418,900,799,101,874,26,1600,700,535,339,
31,"PRAHOVA",298,133214,,377,0,"Scoala MARGINENII DE JOS (scoala noua)","FILIPESTII DE TARG",49,133214,0,3,1428,638,560,78,630,8,1600,962,451,179,
31,"PRAHOVA",298,133214,,378,0,"Scoala MARGINENII DE JOS (scoala veche)","FILIPESTII DE TARG",49,133214,0,3,1006,437,350,87,430,7,1100,663,366,64,
31,"PRAHOVA",298,133278,,379,0,"Caminul cultural FANTANELE","FANTANELE",47,133278,0,3,1839,863,795,68,838,25,2000,1137,589,249,
31,"PRAHOVA",298,133278,,380,0,"Caminul cultural VADU SAPAT","FANTANELE",47,133278,0,3,1385,803,692,111,681,11,1500,808,497,184,
31,"PRAHOVA",298,133330,,381,0,"Gradinita FLORESTI","FLORESTI",50,133330,0,3,1134,685,479,206,679,6,1200,515,324,355,
31,"PRAHOVA",298,133330,,382,0,"Scoala localul nou","FLORESTI",50,133330,0,3,1829,980,785,195,975,5,2000,1020,608,367,
31,"PRAHOVA",298,133330,,383,0,"Scoala localul vechi","FLORESTI",50,133330,0,3,904,663,436,227,660,3,1000,337,435,225,
31,"PRAHOVA",298,133330,,384,0,"Gradinita CALINESTI","FLORESTI",50,133330,0,3,821,533,434,99,526,7,900,367,413,113,
31,"PRAHOVA",298,133330,,385,0,"Scoala NOVACESTI","FLORESTI",50,133330,0,3,929,631,513,118,623,8,1000,369,440,183,
31,"PRAHOVA",298,133394,,386,0,"Caminul cultural FULGA DE JOS","FULGA",51,133394,0,3,1435,661,608,53,654,7,1700,1039,535,119,
31,"PRAHOVA",298,133394,,387,0,"Scoala FULGA DE SUS","FULGA",51,133394,0,3,1738,905,842,63,892,13,1800,895,622,270,
31,"PRAHOVA",298,133429,,388,0,"Scoala GHERGHITA","GHERGHITA",52,133429,0,3,1331,619,574,45,614,5,1400,781,435,179,
31,"PRAHOVA",298,133429,,389,0,"Scoala MALAMUC","GHERGHITA",52,133429,0,3,341,254,214,40,251,3,400,146,191,60,
31,"PRAHOVA",298,133429,,390,0,"Scoala OLARII VECHI","GHERGHITA",52,133429,0,3,829,324,307,17,316,8,800,476,214,102,
31,"PRAHOVA",298,133429,,391,0,"Gradinita OLARI","GHERGHITA",52,133429,0,3,1021,497,460,37,494,3,900,403,336,158,
31,"PRAHOVA",298,133508,,392,0,"Scoala POTIGRAFU","GORGOTA",53,133508,0,3,1001,530,424,106,529,1,1100,570,369,160,
31,"PRAHOVA",298,133508,,393,0,"Scoala GORGOTA","GORGOTA",53,133508,0,3,1380,600,540,60,596,4,1500,900,446,150,
31,"PRAHOVA",298,133508,,394,0,"Caminul cultural POIENARII APOSTOLI","GORGOTA",53,133508,0,3,1206,596,529,67,585,11,1300,704,382,203,
31,"PRAHOVA",298,133508,,395,0,"Scoala CRIVINA","GORGOTA",53,133508,0,3,795,496,428,68,492,4,900,404,375,117,
31,"PRAHOVA",298,133562,,396,0,"Scoala GORNET","GORNET",54,133562,0,3,974,530,502,28,528,2,1100,570,337,191,
31,"PRAHOVA",298,133562,,397,0,"Caminul cultural GORNET","GORNET",54,133562,0,3,979,520,498,22,511,9,1100,580,340,171,
31,"PRAHOVA",298,133562,,398,0,"Scoala CUIB","GORNET",54,133562,0,3,360,205,182,23,203,2,400,195,104,99,
31,"PRAHOVA",298,133562,,399,0,"Caminul cultural NUCET","GORNET",54,133562,0,3,212,111,94,17,109,2,300,189,52,57,
31,"PRAHOVA",298,133615,,400,0,"Gradinita GORNET CRICOV","GORNET-CRICOV",55,133615,0,3,945,456,395,61,451,5,1000,544,258,193,
31,"PRAHOVA",298,133615,,401,0,"Gradinita COSERELE","GORNET-CRICOV",55,133615,0,3,1160,525,466,59,520,5,1300,775,264,256,
31,"PRAHOVA",298,133688,,402,0,"Caminul cultural GURA VADULUI","GURA VADULUI",56,133688,0,3,1262,632,543,89,622,10,1400,768,433,189,
31,"PRAHOVA",298,133688,,403,0,"Scoala PERSUNARI","GURA VADULUI",56,133688,0,3,781,422,359,63,412,10,900,478,277,135,
31,"PRAHOVA",298,131835,,404,0,"Scoala GURA VITIOAREI","GURA VITIOAREI",57,131835,0,3,1597,859,789,70,851,8,1700,841,549,302,
31,"PRAHOVA",298,131835,,405,0,"Scoala BUGHEA DE JOS","GURA VITIOAREI",57,131835,0,3,747,433,387,46,421,12,800,367,222,199,
31,"PRAHOVA",298,131835,,406,0,"Scoala POIANA COPACENI","GURA VITIOAREI",57,131835,0,3,775,538,488,50,531,7,800,262,351,180,
31,"PRAHOVA",298,131835,,407,0,"Scoala FAGET","GURA VITIOAREI",57,131835,0,3,987,657,598,59,652,5,1100,443,375,277,
31,"PRAHOVA",298,131835,,408,0,"Scoala FUNDENI","GURA VITIOAREI",57,131835,0,3,613,363,342,21,358,5,700,337,238,120,
31,"PRAHOVA",298,133722,,409,0,"Gradinita IORDACHEANU","IORDACHEANU",58,133722,0,3,963,477,414,63,472,5,1102,625,296,176,
31,"PRAHOVA",298,133722,,410,0,"Scoala MOCESTI","IORDACHEANU",58,133722,0,3,900,490,425,65,485,5,1000,510,277,208,
31,"PRAHOVA",298,133722,,411,0,"Caminul cultural VALEA CUCULUI","IORDACHEANU",58,133722,0,3,1019,612,528,84,611,1,1100,488,250,361,
31,"PRAHOVA",298,133722,,412,0,"Scoala VARBILA","IORDACHEANU",58,133722,0,3,1028,551,507,44,546,5,1100,549,338,208,
31,"PRAHOVA",298,133795,,413,0,"Scoala TRAIAN SAVULESCU","IZVOARELE",59,133795,0,3,1976,1176,1079,97,1160,16,2200,1024,815,345,
31,"PRAHOVA",298,133795,,414,0,"Scoala HOMORACIU","IZVOARELE",59,133795,0,3,1663,1022,947,75,1016,6,1986,964,642,374,
31,"PRAHOVA",298,133795,,415,0,"Scoala MALU VANAT","IZVOARELE",59,133795,0,3,634,429,351,78,423,6,700,271,269,154,
31,"PRAHOVA",298,133795,,416,0,"Scoala SCHIULESTI","IZVOARELE",59,133795,0,3,1010,638,609,29,636,2,1100,462,464,172,
31,"PRAHOVA",298,133866,,417,0,"Caminul cultural JUGURENI","JUGURENI",60,133866,0,3,630,470,352,118,465,5,700,230,385,80,
31,"PRAHOVA",298,133919,,418,0,"Scoala LAPOS","LAPOS",61,133919,0,3,1168,566,517,49,561,5,1300,734,395,166,
31,"PRAHOVA",298,133964,,419,0,"Caminul cultural LIPANESTI","LIPANESTI",62,133964,0,3,1433,820,711,109,812,8,1600,780,540,272,
31,"PRAHOVA",298,133964,,420,0,"Scoala ZAMFIRA","LIPANESTI",62,133964,0,3,661,497,425,72,492,5,700,203,345,147,
31,"PRAHOVA",298,133964,,421,0,"Scoala SIPOTU","LIPANESTI",62,133964,0,3,1716,980,846,134,964,16,1900,920,591,373,
31,"PRAHOVA",298,134014,,422,0,"Caminul cultural MAGURELE","MAGURELE",63,134014,0,3,1273,784,658,126,772,12,1500,716,505,267,
31,"PRAHOVA",298,134014,,423,0,"Scoala veche MAGURELE","MAGURELE",63,134014,0,3,1377,750,698,52,744,6,1400,650,482,262,
31,"PRAHOVA",298,134014,,424,0,"Scoala COADA MALULUI","MAGURELE",63,134014,0,3,626,382,346,36,378,4,700,318,244,134,
31,"PRAHOVA",298,134014,,425,0,"Gradinita IAZU","MAGURELE",63,134014,0,3,498,304,257,47,302,2,600,296,207,95,
31,"PRAHOVA",298,134050,,426,0,"Scoala NR.1 corp B MAGURENI","MAGURENI",64,134050,0,3,1507,789,745,44,779,10,2000,1211,559,220,
31,"PRAHOVA",298,134050,,427,0,"Scoala NR.2 MAGURENI","MAGURENI",64,134050,0,3,1011,621,572,49,619,2,1100,479,431,188,
31,"PRAHOVA",298,134050,,428,0,"Scoala NR.1 corp A MAGURENI","MAGURENI",64,134050,0,3,1326,702,666,36,694,8,1300,598,472,222,
31,"PRAHOVA",298,134050,,429,0,"Scoala LUNCA PRAHOVEI","MAGURENI",64,134050,0,3,787,537,483,54,530,7,800,263,415,115,
31,"PRAHOVA",298,134050,,430,0,"Scoala COCORASTII CAPLII","MAGURENI",64,134050,0,3,683,406,360,46,404,2,700,294,246,158,
31,"PRAHOVA",298,134096,,431,0,"Gradinita MANECIU UNGURENI NR.613","MANECIU",65,134096,0,3,1565,952,655,297,950,2,1800,848,841,109,
31,"PRAHOVA",298,134096,,432,0,"Scoala mica GHEABA","MANECIU",65,134096,0,3,1601,901,557,344,885,16,1700,799,615,270,
31,"PRAHOVA",298,134096,,433,0,"Grup Scolar MANECIU sat GHEABA NR.5","MANECIU",65,134096,0,3,919,622,435,187,616,6,1000,378,450,166,
31,"PRAHOVA",298,134096,,434,0,"Grup Scolar MANECIU sat GHEABA NR.5","MANECIU",65,134096,0,3,1217,790,555,235,782,8,1300,510,581,201,
31,"PRAHOVA",298,134096,,435,0,"Scoala MANECIU PAMANTENI   NR.396","MANECIU",65,134096,0,3,1501,922,604,318,918,4,1593,671,600,318,
31,"PRAHOVA",298,134096,,436,0,"Scoala MANECIU PAMANTENI","MANECIU",65,134096,0,3,1785,852,616,236,846,6,1800,948,598,248,
31,"PRAHOVA",298,134096,,437,0,"Scoala CHEIA","MANECIU",65,134096,0,3,263,318,155,163,312,6,500,182,217,95,
31,"PRAHOVA",298,134194,,438,0,"Scoala ZALHANAUA","MANESTI",66,134194,0,3,715,464,381,83,460,4,700,236,265,195,
31,"PRAHOVA",298,134194,,439,0,"Scoala MANESTI","MANESTI",66,134194,0,3,1141,471,392,79,465,6,1500,1029,258,207,
31,"PRAHOVA",298,134194,,440,0,"Scoala COADA IZVORULUI","MANESTI",66,134194,0,3,672,423,314,109,410,13,700,277,229,181,
31,"PRAHOVA",298,134194,,441,0,"Scoala BALTITA","MANESTI",66,134194,0,3,791,431,381,50,429,2,900,469,270,159,
31,"PRAHOVA",298,134194,,442,0,"Scoala COCORASTII GRIND","MANESTI",66,134194,0,3,720,567,347,220,562,5,600,33,365,197,
31,"PRAHOVA",298,134194,,443,0,"Scoala COCORASTII COLT","MANESTI",66,134194,0,3,1657,800,712,88,791,9,1900,1100,506,285,
31,"PRAHOVA",298,134336,,444,0,"Gradinita PACURETI","PACURETI",67,134336,0,3,1096,568,485,83,562,6,1200,632,330,232,
31,"PRAHOVA",298,134336,,445,0,"Scoala MATITA","PACURETI",67,134336,0,3,669,400,341,59,393,7,700,300,235,158,
31,"PRAHOVA",298,130847,,446,0,"Scoala PAULESTI","PAULESTI",68,130847,0,3,1100,486,420,66,480,6,1100,614,271,209,
31,"PRAHOVA",298,130847,,447,0,"Caminul cultural PAULESTI","PAULESTI",68,130847,0,3,840,614,480,134,605,9,900,286,386,219,
31,"PRAHOVA",298,130847,,448,0,"Scoala COCOSESTI","PAULESTI",68,130847,0,3,596,384,336,48,380,4,700,316,220,160,
31,"PRAHOVA",298,130847,,449,0,"Scoala GAGENI","PAULESTI",68,130847,0,3,716,429,368,61,423,6,800,371,278,145,
31,"PRAHOVA",298,130847,,450,0,"Caminul cultural GAGENI","PAULESTI",68,130847,0,3,871,528,466,62,520,8,900,372,339,181,
31,"PRAHOVA",298,134390,,451,0,"Gradinita PLOPU","PLOPU",69,134390,0,3,812,394,346,48,391,3,900,506,242,149,
31,"PRAHOVA",298,134390,,452,0,"Scoala NISIPOASA","PLOPU",69,134390,0,3,590,324,287,37,321,3,700,376,201,120,
31,"PRAHOVA",298,134390,,453,0,"Scoala HARSA","PLOPU",69,134390,0,3,200,103,91,12,102,1,299,196,68,34,
31,"PRAHOVA",298,134390,,454,0,"Scoala GALMEIA","PLOPU",69,134390,0,3,152,110,68,42,109,1,200,90,65,44,
31,"PRAHOVA",298,134443,,455,0,"Scoala PODENII NOI","PODENII NOI",70,134443,0,3,1080,550,460,90,542,8,1200,650,317,225,
31,"PRAHOVA",298,134443,,456,0,"Scoala VALEA DULCE","PODENII NOI",70,134443,0,3,1314,840,762,78,836,4,1400,560,510,326,
31,"PRAHOVA",298,134443,,457,0,"Scoala MEHEDINTA","PODENII NOI",70,134443,0,3,1100,645,560,85,641,4,1200,555,354,287,
31,"PRAHOVA",298,131274,,458,0,"Scoala POIANA CAMPINA STR. BISERICII","POIANA CAMPINA",71,131274,0,3,1116,648,550,98,640,8,1200,552,459,181,
31,"PRAHOVA",298,131274,,459,0,"Primaria POIANA CAMPINA,STR.UZINEI,NR.462","POIANA CAMPINA",71,131274,0,3,1776,1090,900,190,1078,12,1900,810,654,424,
31,"PRAHOVA",298,131274,,460,0,"Scoala POIANA CAMPINA  STR. PIETRIS","POIANA CAMPINA",71,131274,0,3,460,310,275,35,306,4,500,190,216,90,
31,"PRAHOVA",298,131274,,461,0,"Scoala BOBOLIA","POIANA CAMPINA",71,131274,0,3,807,492,405,87,491,1,900,408,303,188,
31,"PRAHOVA",298,134559,,462,0,"Scoala POIENARII BURCHII","POIENARII BURCHII",72,134559,0,3,1380,554,461,93,549,5,1600,1046,347,202,
31,"PRAHOVA",298,134559,,463,0,"Gradinita CARBUNARI","POIENARII BURCHII",72,134559,0,3,508,338,203,135,335,3,600,262,212,123,
31,"PRAHOVA",298,134559,,464,0,"Scoala POIENARII RALI","POIENARII BURCHII",72,134559,0,3,1014,618,505,113,607,11,1100,482,376,231,
31,"PRAHOVA",298,134559,,465,0,"Scoala","POIENARII BURCHII",72,134559,0,3,1241,691,595,96,686,5,1400,709,481,205,
31,"PRAHOVA",298,134559,,466,0,"Caminul cultural TATARAI","POIENARII BURCHII",72,134559,0,3,427,327,256,71,322,5,400,73,250,72,
31,"PRAHOVA",298,134648,,467,0,"Caminul cultural POSESTI PAMANTENI","POSESTI",73,134648,0,3,812,456,399,57,454,2,900,444,306,148,
31,"PRAHOVA",298,134648,,468,0,"Fosta Primarie NUCSOARA","POSESTI",73,134648,0,3,1260,720,669,51,709,11,1400,680,512,197,
31,"PRAHOVA",298,134648,,469,0,"Caminul cultural VALEA PLOPULUI","POSESTI",73,134648,0,3,671,437,404,33,434,3,700,263,299,135,
31,"PRAHOVA",298,134648,,470,0,"Scoala TARLESTI","POSESTI",73,134648,0,3,570,370,342,28,365,5,600,230,279,86,
31,"PRAHOVA",298,134755,,471,0,"Gradinita PREDEAL","PREDEAL-SARARI",74,134755,0,3,856,522,447,75,517,5,900,378,245,272,
31,"PRAHOVA",298,134755,,472,0,"Scoala ZAMBROAIA","PREDEAL-SARARI",74,134755,0,3,200,126,86,40,123,3,300,174,82,41,
31,"PRAHOVA",298,134755,,473,0,"Scoala VITIOARA DE SUS","PREDEAL-SARARI",74,134755,0,3,1019,567,513,54,562,5,1100,533,334,228,
31,"PRAHOVA",298,134853,,474,0,"Scoala PROVITA DE JOS","PROVITA DE JOS",75,134853,0,3,1026,581,508,73,576,5,1200,619,374,202,
31,"PRAHOVA",298,134853,,475,0,"Gradinita DRAGANEASA","PROVITA DE JOS",75,134853,0,3,954,576,515,61,562,14,1000,424,379,183,
31,"PRAHOVA",298,134899,,476,0,"Scoala PROVITA DE SUS","PROVITA DE SUS",76,134899,0,3,1623,883,802,81,874,9,1800,917,581,293,
31,"PRAHOVA",298,134899,,477,0,"Scoala IZVORU","PROVITA DE SUS",76,134899,0,3,350,250,197,53,245,5,400,150,158,87,
31,"PRAHOVA",298,134942,,478,0,"Scoala PUCHENII MARI","PUCHENII MARI",77,134942,0,3,1353,626,552,74,616,10,1500,874,443,173,
31,"PRAHOVA",298,134942,,479,0,"Scoala PIETROSANI","PUCHENII MARI",77,134942,0,3,1113,581,524,57,567,14,1200,619,385,182,
31,"PRAHOVA",298,134942,,480,0,"Gradinita PIETROSANI","PUCHENII MARI",77,134942,0,3,826,484,444,40,480,4,900,416,333,147,
31,"PRAHOVA",298,134942,,481,0,"Scoala PUCHENII MOSNENI","PUCHENII MARI",77,134942,0,3,1227,641,536,105,635,6,1300,659,435,200,
31,"PRAHOVA",298,134942,,482,0,"Scoala MIROSLAVESTI","PUCHENII MARI",77,134942,0,3,1369,828,690,138,822,6,1500,672,549,273,
31,"PRAHOVA",298,134942,,483,0,"Scoala ODAILE","PUCHENII MARI",77,134942,0,3,1308,662,563,99,656,6,1400,738,422,234,
31,"PRAHOVA",298,135020,,484,0,"Scoala MALAIESTI","RAFOV",78,135020,0,3,973,547,492,55,544,3,1100,553,341,203,
31,"PRAHOVA",298,135020,,485,0,"Scoala MOARA DOMNEASCA","RAFOV",78,135020,0,3,722,430,387,43,426,4,800,370,262,164,
31,"PRAHOVA",298,135020,,486,0,"Scoala BUDA","RAFOV",78,135020,0,3,885,420,366,54,410,10,1000,580,217,193,
31,"PRAHOVA",298,135020,,487,0,"Scoala PALANCA","RAFOV",78,135020,0,3,868,485,428,57,480,5,1000,515,260,220,
31,"PRAHOVA",298,135020,,488,0,"Scoala GOGA","RAFOV",78,135020,0,3,511,296,255,41,291,5,600,304,182,109,
31,"PRAHOVA",298,135020,,489,0,"Scoala SICRITA","RAFOV",78,135020,0,3,349,221,181,40,215,6,400,179,160,55,
31,"PRAHOVA",298,135128,,490,0,"Scoala SALCIA","SALCIA",79,135128,0,3,1027,589,530,59,586,3,1100,511,340,246,
31,"PRAHOVA",298,135146,,491,0,"Scoala SALCIILE(LOCALUL VECHI)","SALCIILE",80,135146,0,3,1083,605,574,31,595,10,1200,595,478,117,
31,"PRAHOVA",298,135146,,492,0,"Caminul cultural SALCIILE","SALCIILE",80,135146,0,3,915,567,522,45,555,12,1000,433,440,115,
31,"PRAHOVA",298,135164,,493,0,"Scoala SCORTENI","SCORTENI",82,135164,0,3,1247,651,524,127,649,2,1400,749,401,248,
31,"PRAHOVA",298,135164,,494,0,"Scoala MISLEA","SCORTENI",82,135164,0,3,1431,764,599,165,759,5,1599,835,460,299,
31,"PRAHOVA",298,135164,,495,0,"Scoala SARCA","SCORTENI",82,135164,0,3,824,460,373,87,457,3,900,440,245,212,
31,"PRAHOVA",298,135164,,496,0,"Scoala BORDENII MARI","SCORTENI",82,135164,0,3,1223,670,551,119,660,10,1300,630,403,257,
31,"PRAHOVA",298,135226,,497,0,"Caminul cultural SECARIA","SECARIA",83,135226,0,3,1049,870,833,37,860,10,1095,225,724,136,
31,"PRAHOVA",298,135244,,498,0,"Scoala SANGERU","SANGERU",81,135244,0,3,2430,1107,1016,91,1084,23,2700,1593,735,349,
31,"PRAHOVA",298,135244,,499,0,"Scoala MIRESU MARE","SANGERU",81,135244,0,3,1659,1027,920,107,1011,16,1800,773,568,443,
31,"PRAHOVA",298,135315,,500,0,"Gradinita STARCHIOJD","STARCHIOJD",87,135315,0,3,1570,806,725,81,796,10,1900,1094,490,306,
31,"PRAHOVA",298,135315,,501,0,"Scoala NR.2 STARCHIOJD","STARCHIOJD",87,135315,0,3,1128,674,565,109,668,6,1200,526,408,260,
31,"PRAHOVA",298,135315,,502,0,"Gradinita BATRANI NR.1","STARCHIOJD",87,135315,0,3,1703,1085,1019,66,1075,10,1900,815,790,285,
31,"PRAHOVA",298,135315,,503,0,"Scoala VALEA ANEI","STARCHIOJD",87,135315,0,3,577,372,311,61,365,7,600,228,262,103,
31,"PRAHOVA",298,135404,,504,0,"Gradinita SURANI","SURANI",89,135404,0,3,1449,678,609,69,667,11,1600,922,477,190,
31,"PRAHOVA",298,135431,,505,0,"Scoala TARICENI","SIRNA",84,135431,0,3,1304,550,499,51,543,7,1400,850,388,155,
31,"PRAHOVA",298,135431,,506,0,"Scoala TARICENI","SIRNA",84,135431,0,3,331,194,144,50,194,0,400,206,129,65,
31,"PRAHOVA",298,135431,,507,0,"Scoala SIRNA","SIRNA",84,135431,0,3,1631,664,587,77,653,11,1800,1136,401,252,
31,"PRAHOVA",298,135431,,508,0,"Scoala HABUD","SIRNA",84,135431,0,3,1166,529,446,83,526,3,1300,771,346,180,
31,"PRAHOVA",298,135501,,509,0,"Scoala SOIMARI","SOIMARI",85,135501,0,3,1309,804,688,116,793,11,1400,596,477,316,
31,"PRAHOVA",298,135501,,510,0,"Gradinita LOPATNITA","SOIMARI",85,135501,0,3,572,315,271,44,311,4,600,285,189,122,
31,"PRAHOVA",298,135501,,511,0,"Caminul cultural MAGURA","SOIMARI",85,135501,0,3,453,316,253,63,313,3,502,186,200,113,
31,"PRAHOVA",298,135547,,512,0,"Scoala SOTRILE","SOTRILE",86,135547,0,3,1497,651,603,48,645,6,1700,1049,455,190,
31,"PRAHOVA",298,135547,,513,0,"Caminul cultural LUNCA MARE","SOTRILE",86,135547,0,3,1299,538,450,88,533,5,1200,662,401,132,
31,"PRAHOVA",298,135618,,514,0,"Scoala STEFESTI","STEFESTI",88,135618,0,3,1943,983,943,40,973,10,2100,1117,573,400,
31,"PRAHOVA",298,135654,,515,0,"Scoala TALEA","TALEA",90,135654,0,3,979,690,642,48,684,6,1100,410,424,260,
31,"PRAHOVA",298,135681,,516,0,"Caminul cultural CORBU EUGENIU","TATARU",92,135681,0,3,999,492,442,50,480,12,1100,608,279,201,
31,"PRAHOVA",298,135725,,517,0,"Primaria TEISANI","TEISANI",93,135725,0,3,1511,894,814,80,882,12,1600,706,571,311,
31,"PRAHOVA",298,135725,,518,0,"Scoala OLTENI","TEISANI",93,135725,0,3,1625,907,854,53,897,10,1800,893,616,281,
31,"PRAHOVA",298,135725,,519,0,"Sala de festivitati BUGHEA DE SUS","TEISANI",93,135725,0,3,87,61,50,11,60,1,100,39,43,17,
31,"PRAHOVA",298,135789,,520,0,"Scoala TELEGA centru","TELEGA",94,135789,0,3,1312,588,547,41,582,6,1700,1112,400,182,
31,"PRAHOVA",298,135789,,521,0,"Gradinita TELEGA  centru","TELEGA",94,135789,0,3,1275,708,644,64,699,9,1300,592,481,218,
31,"PRAHOVA",298,135789,,522,0,"Scoala TELEGA VALE","TELEGA",94,135789,0,3,1551,861,795,66,851,10,1600,739,592,259,
31,"PRAHOVA",298,135789,,523,0,"Gradinita BUSTENARI","TELEGA",94,135789,0,3,612,339,279,60,337,2,600,261,250,87,
31,"PRAHOVA",298,135789,,524,0,"Scoala MELICESTI","TELEGA",94,135789,0,3,479,267,239,28,264,3,500,233,174,90,
31,"PRAHOVA",298,135850,,525,0,"Gradinita TINOSU","TINOSU",95,135850,0,3,1518,787,733,54,781,6,1700,913,566,215,
31,"PRAHOVA",298,135850,,526,0,"Scoala PREDESTI","TINOSU",95,135850,0,3,542,381,317,64,375,6,600,219,252,123,
31,"PRAHOVA",298,130892,,527,0,"Gradinita STREJNICU","TARGSORU VECHI",91,130892,0,3,2154,983,880,103,973,10,2000,1017,646,327,
31,"PRAHOVA",298,130892,,528,0,"Scoala STREJNICU","TARGSORU VECHI",91,130892,0,3,1634,946,776,170,938,8,1800,854,610,328,
31,"PRAHOVA",298,130892,,529,0,"Scoala TARGSORU VECHI","TARGSORU VECHI",91,130892,0,3,1998,885,762,123,866,19,2400,1515,649,217,
31,"PRAHOVA",298,130892,,530,0,"Scoala STANCESTI","TARGSORU VECHI",91,130892,0,3,471,432,257,175,422,10,600,168,285,137,
31,"PRAHOVA",298,130892,,531,1,"UM 01808 STREJNICU","TARGSORU VECHI",91,130892,0,3,0,68,0,68,66,2,100,32,33,33,
31,"PRAHOVA",298,135896,,532,0,"Scoala TOMSANI MAGULA","TOMSANI",96,135896,0,3,1329,655,605,50,650,5,1500,845,412,238,
31,"PRAHOVA",298,135896,,533,0,"Scoala MAGULA","TOMSANI",96,135896,0,3,1036,650,565,85,644,6,1100,450,378,266,
31,"PRAHOVA",298,135896,,534,0,"Caminul cultural LOLOIASCA","TOMSANI",96,135896,0,3,1148,611,540,71,605,6,1300,689,420,185,
31,"PRAHOVA",298,135949,,535,0,"Scoala NR.1 VALEA CALUGAREASCA","VALEA CALUGAREASCA",98,135949,0,3,2641,1008,835,173,999,9,2900,1892,663,336,
31,"PRAHOVA",298,135949,,536,0,"Caminul cultural VALEA CALUGAREASCA","VALEA CALUGAREASCA",98,135949,0,3,934,509,366,143,500,9,1002,493,336,164,
31,"PRAHOVA",298,135949,,537,0,"Scoala NICOVANI","VALEA CALUGAREASCA",98,135949,0,3,923,539,382,157,531,8,1002,459,361,170,
31,"PRAHOVA",298,135949,,538,0,"Scoala DARVARI","VALEA CALUGAREASCA",98,135949,0,3,1339,591,521,70,588,3,1500,909,420,168,
31,"PRAHOVA",298,135949,,539,0,"Scoala PANTAZI","VALEA CALUGAREASCA",98,135949,0,3,834,516,403,113,514,2,900,384,376,138,
31,"PRAHOVA",298,135949,,540,0,"Grup scolar agricol VALEA CALUGAREASCA","VALEA CALUGAREASCA",98,135949,0,3,1412,673,531,142,661,12,1600,927,467,194,
31,"PRAHOVA",298,135949,,541,0,"Cabana FILIALEI DE VANATOARE DIN SAT VIRFURI","VALEA CALUGAREASCA",98,135949,0,3,75,63,26,37,63,0,100,37,44,19,
31,"PRAHOVA",298,136107,,542,0,"Liceul Agromontan VALEA DOFTANEI","VALEA DOFTANEI",99,136107,0,3,1335,710,629,81,705,5,1500,790,455,250,
31,"PRAHOVA",298,136107,,543,0,"Gradinita VALEA DOFTANEI","VALEA DOFTANEI",99,136107,0,3,1215,644,583,61,634,10,1300,656,365,269,
31,"PRAHOVA",298,136107,,544,0,"Gradinita NR.2 VALEA DOFTANEI","VALEA DOFTANEI",99,136107,0,3,939,538,481,57,532,6,1000,462,296,236,
31,"PRAHOVA",298,136107,,545,0,"Gradinita VALEA DOFTANEI","VALEA DOFTANEI",99,136107,0,3,1084,666,588,78,662,4,1200,534,436,226,
31,"PRAHOVA",298,136107,,546,0,"Scoala VALEA DOFTANEI","VALEA DOFTANEI",99,136107,0,3,1021,685,612,73,680,5,1100,415,456,224,
31,"PRAHOVA",298,136134,,547,0,"Caminul cultural VARBILAU","VARBILAU",100,136134,0,3,1800,1067,1001,66,1062,5,2000,933,797,265,
31,"PRAHOVA",298,136134,,548,0,"Scoala VARBILAU","VARBILAU",100,136134,0,3,1131,786,658,128,782,4,1200,414,590,192,
31,"PRAHOVA",298,136134,,549,0,"Scoala LIVADEA","VARBILAU",100,136134,0,3,911,551,506,45,543,8,1000,449,404,139,
31,"PRAHOVA",298,136134,,550,0,"Scoala POIANA VARBILAU","VARBILAU",100,136134,0,3,961,593,517,76,581,12,1000,407,436,145,
31,"PRAHOVA",298,136134,,551,0,"Scoala COTOFENESTI","VARBILAU",100,136134,0,3,722,506,437,69,502,4,800,294,369,133,
31,"PRAHOVA",298,136198,,552,0,"Primaria VALCANESTI","VALCANESTI",97,136198,0,3,1393,833,762,71,823,10,1450,617,626,197,
31,"PRAHOVA",298,136198,,553,0,"Gradinita BRANZARI","VALCANESTI",97,136198,0,3,842,606,576,30,602,4,950,344,444,158,
31,"PRAHOVA",298,136198,,554,0,"Scoala CARJARI","VALCANESTI",97,136198,0,3,613,413,381,32,408,5,650,237,313,95,
31,"PRAHOVA",298,136198,,555,0,"Scoala TRESTIOARA","VALCANESTI",97,136198,0,3,425,305,287,18,302,3,550,245,174,128,
32,"SATU MARE",305,136483,,1,0,"Scoala Generala Nr. 15, Bulevardul Unirii nr. 95","MUNICIPIUL SATU MARE",1,136483,1,1,2129,818,757,61,807,11,2400,1582,751,56,
32,"SATU MARE",305,136483,,2,0,"Sectia de Drumuri Nationale, Str. Baritiu nr. 127","MUNICIPIUL SATU MARE",1,136483,1,1,1262,495,466,29,485,10,1406,911,395,90,
32,"SATU MARE",305,136483,,3,0,"S.C. Florisal S.A., Str. Serelor nr. 17","MUNICIPIUL SATU MARE",1,136483,1,1,1802,772,742,30,761,11,2000,1228,728,33,
32,"SATU MARE",305,136483,,4,0,"Gradinita de copii nr. 15, Bulevardul Unirii nr. 9","MUNICIPIUL SATU MARE",1,136483,1,1,1251,577,541,36,574,3,1400,823,535,39,
32,"SATU MARE",305,136483,,5,0,"Scoala Generala Nr. 3, Str. George Calinescu nr.51","MUNICIPIUL SATU MARE",1,136483,1,1,1866,600,559,41,591,9,2100,1500,493,98,
32,"SATU MARE",305,136483,,6,0,"Gradinita de copii nr. 12, Aleea Ilisesti nr. 4","MUNICIPIUL SATU MARE",1,136483,1,1,1489,682,512,170,675,7,1600,918,548,127,
32,"SATU MARE",305,136483,,7,0,"Scoala Generala Nr. 3, Str. George Calinescu nr.51","MUNICIPIUL SATU MARE",1,136483,1,1,1315,532,491,41,525,7,1500,968,402,123,
32,"SATU MARE",305,136483,,8,0,"Scoala Generala Nr. 21, Str. Rodnei nr. 64","MUNICIPIUL SATU MARE",1,136483,1,1,1401,622,575,47,614,8,1500,878,533,81,
32,"SATU MARE",305,136483,,9,0,"Gradinita cu program prelungit 14 Mai, Aleea Gladiolei nr.4","MUNICIPIUL SATU MARE",1,136483,1,1,1717,667,639,28,654,13,1900,1233,515,139,
32,"SATU MARE",305,136483,,10,0,"Gradinita cu program prelungit 14 Mai, Aleea Gladiolei nr.4","MUNICIPIUL SATU MARE",1,136483,1,1,1836,657,628,29,648,9,2000,1343,509,139,
32,"SATU MARE",305,136483,,11,0,"Grupul Scolar Forestier, Str. Crisan nr. 1","MUNICIPIUL SATU MARE",1,136483,1,1,1761,796,697,99,779,17,1900,1104,682,97,
32,"SATU MARE",305,136483,,12,0,"Liceul cu program sportiv, Str. Ioan Slavici nr. 43","MUNICIPIUL SATU MARE",1,136483,1,1,1674,766,711,55,758,8,1800,1034,698,60,
32,"SATU MARE",305,136483,,13,0,"Scoala Generala Grigore Moisil, Str. Mileniului nr.1","MUNICIPIUL SATU MARE",1,136483,1,1,1239,712,553,159,703,9,1400,688,617,86,
32,"SATU MARE",305,136483,,14,0,"Scoala Generala Grigore Moisil, Str. Mileniului nr.1","MUNICIPIUL SATU MARE",1,136483,1,1,1481,713,637,76,697,16,1600,887,615,82,
32,"SATU MARE",305,136483,,15,0,"Grupul Scolar Industrial Cai Ferate, Bulevardul Vasile Lucaciu nr. 1","MUNICIPIUL SATU MARE",1,136483,1,1,1384,761,526,235,745,16,1600,839,650,95,
32,"SATU MARE",305,136483,,16,0,"Grupul Scolar Industrie Alimentara, Str. 1 Decembrie 1918 nr. 2","MUNICIPIUL SATU MARE",1,136483,1,1,1500,554,484,70,544,10,1594,1040,444,100,
32,"SATU MARE",305,136483,,17,0,"Fundatia pentru Tineret, Str. Stefan cel Mare nr. 18","MUNICIPIUL SATU MARE",1,136483,1,1,993,625,400,225,613,12,1100,475,533,80,
32,"SATU MARE",305,136483,,18,0,"Scoala Generala Nr. 10, Str. Ana Ipatescu nr. 8","MUNICIPIUL SATU MARE",1,136483,1,1,1255,561,515,46,558,3,1600,1039,526,32,
32,"SATU MARE",305,136483,,19,0,"Gradinita Tricotex, Str. Gheorghe Lazar de Purcaret nr. 27","MUNICIPIUL SATU MARE",1,136483,1,1,1285,567,528,39,560,7,1400,833,503,57,
32,"SATU MARE",305,136483,,20,0,"Liceul Doamna Stanca, Str. Stefan cel Mare nr. 5","MUNICIPIUL SATU MARE",1,136483,1,1,1340,595,546,49,590,5,1500,905,525,65,
32,"SATU MARE",305,136483,,21,0,"Scoala Generala Constantin Brâncoveanu, Str. Constantin Brâncoveanu nr. 6","MUNICIPIUL SATU MARE",1,136483,1,1,1295,802,565,237,786,16,1392,590,642,144,
32,"SATU MARE",305,136483,,22,0,"Colegiul Mihail Eminescu, Str. Mihail Eminescu nr. 5","MUNICIPIUL SATU MARE",1,136483,1,1,2634,1090,972,118,1072,18,2800,1710,909,163,
32,"SATU MARE",305,136483,,23,0,"Liceul Economic, Str. Henri Coanda nr. 23","MUNICIPIUL SATU MARE",1,136483,1,1,1392,615,564,51,611,4,1500,885,462,149,
32,"SATU MARE",305,136483,,24,0,"Scoala Generala Nr. 13, Str. Botizului nr. 4","MUNICIPIUL SATU MARE",1,136483,1,1,1623,604,522,82,594,10,1700,1096,448,146,
32,"SATU MARE",305,136483,,25,0,"Scoala Generala Nr. 13, Str. Botizului nr. 4","MUNICIPIUL SATU MARE",1,136483,1,1,1801,689,646,43,675,14,2100,1411,500,175,
32,"SATU MARE",305,136483,,26,0,"Sediul CONSUMCOOP, Piata Soarelui","MUNICIPIUL SATU MARE",1,136483,1,1,1752,723,562,161,713,10,1897,1174,506,207,
32,"SATU MARE",305,136483,,27,0,"Scoala Generala Ion Creanga, Str. Somesului nr. 6","MUNICIPIUL SATU MARE",1,136483,1,1,1666,658,601,57,651,7,1796,1138,472,179,
32,"SATU MARE",305,136483,,28,0,"Scoala Generala Ion Creanga, Str. Somesului nr. 6","MUNICIPIUL SATU MARE",1,136483,1,1,2025,795,721,74,787,8,2100,1305,615,172,
32,"SATU MARE",305,136483,,29,0,"Scoala Generala Lucian Blaga, Bulevardul Independentei nr. 42 - 44","MUNICIPIUL SATU MARE",1,136483,1,1,2401,1009,899,110,1004,5,2600,1591,720,284,
32,"SATU MARE",305,136483,,30,0,"Scoala Generala Lucian Blaga, Bulevardul Independentei nr. 42 - 44","MUNICIPIUL SATU MARE",1,136483,1,1,1863,853,814,39,847,6,2400,1547,612,235,
32,"SATU MARE",305,136483,,31,0,"Scoala Generala Octavian Goga, Aleea Postavaru nr.3","MUNICIPIUL SATU MARE",1,136483,1,1,1488,570,535,35,561,9,1600,1030,471,90,
32,"SATU MARE",305,136483,,32,0,"Scoala Generala Octavian Goga, Aleea Postavaru nr.3","MUNICIPIUL SATU MARE",1,136483,1,1,1575,532,505,27,522,10,1704,1172,383,139,
32,"SATU MARE",305,136483,,33,0,"Clubul Unio, Bulevardul Lucian Blaga nr. 68","MUNICIPIUL SATU MARE",1,136483,1,1,1879,668,623,45,662,6,2100,1432,549,113,
32,"SATU MARE",305,136483,,34,0,"Gradinita de copii nr. 32, Bulevardul Lcian Blaga, bloc CU 10","MUNICIPIUL SATU MARE",1,136483,1,1,2268,801,700,101,794,7,2500,1699,580,214,
32,"SATU MARE",305,136483,,35,0,"Scoala Generala Nr. 7, Bulevardul Lucian Blaga nr. 121","MUNICIPIUL SATU MARE",1,136483,1,1,1960,730,639,91,722,8,2100,1370,515,207,
32,"SATU MARE",305,136483,,36,0,"Scoala Generala Nr. 7, Bulevardul Lucian Blaga nr. 121","MUNICIPIUL SATU MARE",1,136483,1,1,2119,760,710,50,751,9,2310,1550,530,221,
32,"SATU MARE",305,136483,,37,0,"Scoala Generala Nr. 9, Bulevardul Lucian Blaga nr. 409","MUNICIPIUL SATU MARE",1,136483,1,1,1388,599,473,126,592,7,1500,901,339,253,
32,"SATU MARE",305,136483,,38,0,"Statia CFR Ferastrau, Str. Pintea Haiducul","MUNICIPIUL SATU MARE",1,136483,1,1,1248,687,440,247,670,17,1399,712,460,210,
32,"SATU MARE",305,136483,,39,0,"Gradinita Unio, Bulevardul Lucian Blaga nr. 19/A","MUNICIPIUL SATU MARE",1,136483,1,1,846,447,252,195,440,7,1000,553,278,162,
32,"SATU MARE",305,136483,,40,0,"Directia Judeteana de Drumuri si Poduri, Bulevardul Closca nr. 6/A","MUNICIPIUL SATU MARE",1,136483,1,1,2336,906,856,50,898,8,2500,1594,721,177,
32,"SATU MARE",305,136483,,41,0,"Liceul German, Bulevardul Closca nr. 72","MUNICIPIUL SATU MARE",1,136483,1,1,1632,838,474,364,812,26,1800,962,544,268,
32,"SATU MARE",305,136483,,42,0,"Scoala Generala Mircea Eliade, Str. Mircea Eliade nr. 3","MUNICIPIUL SATU MARE",1,136483,1,1,1472,575,502,73,569,6,1600,1025,457,112,
32,"SATU MARE",305,136483,,43,0,"Scoala Generala Nr. 4, Aleea Trotusului nr. 2","MUNICIPIUL SATU MARE",1,136483,1,1,3117,1199,1091,108,1182,17,3300,2101,952,230,
32,"SATU MARE",305,136483,,44,0,"Gradinita cu program prelungit, Aleea Milcov nr. 4","MUNICIPIUL SATU MARE",1,136483,1,1,2127,833,768,65,827,6,2300,1467,637,190,
32,"SATU MARE",305,136483,,45,0,"Scoala Generala Nr. 4, Aleea Trotusului nr. 2","MUNICIPIUL SATU MARE",1,136483,1,1,2048,967,667,300,956,11,2300,1333,720,236,
32,"SATU MARE",305,136483,,46,0,"Scoala Generala Mircea Eliade, Str. Mircea Eliade nr. 3","MUNICIPIUL SATU MARE",1,136483,1,1,2105,836,788,48,823,13,2200,1364,679,144,
32,"SATU MARE",305,136483,,47,0,"Caminul nr. 5, Aleea Tisa nr. 8","MUNICIPIUL SATU MARE",1,136483,1,1,2000,748,700,48,742,6,2000,1252,554,188,
32,"SATU MARE",305,136483,,48,0,"Scoala Generala Mircea Eliade, Str. Mircea Eliade nr. 3","MUNICIPIUL SATU MARE",1,136483,1,1,2464,850,794,56,834,16,2700,1850,647,187,
32,"SATU MARE",305,136483,,49,0,"Gradinita cu program prelungit nr. 9, Aleea Târnavei nr. 18","MUNICIPIUL SATU MARE",1,136483,1,1,2103,849,749,100,835,14,2304,1455,665,170,
32,"SATU MARE",305,136483,,50,0,"Scoala Generala Mircea Eliade, Str. Mircea Eliade nr. 3","MUNICIPIUL SATU MARE",1,136483,1,1,1863,772,681,91,757,15,2000,1228,595,162,
32,"SATU MARE",305,136483,,51,0,"Gradinita cu program prelungit nr. 15, Bulevardul Muncii nr. 24","MUNICIPIUL SATU MARE",1,136483,1,1,2565,935,818,117,931,4,3000,2065,721,210,
32,"SATU MARE",305,136483,,52,0,"Scoala Generala Avram Iancu, Bulevardul Muncii Bloc 19","MUNICIPIUL SATU MARE",1,136483,1,1,2047,784,691,93,779,5,2200,1416,598,181,
32,"SATU MARE",305,136483,,53,0,"Gradinita cu program prelungit, Str. Aurora, Bloc E 21","MUNICIPIUL SATU MARE",1,136483,1,1,2794,1114,1044,70,1104,10,3000,1886,846,258,
32,"SATU MARE",305,136483,,54,0,"Scoala Generala Avram Iancu, Bulevardul Muncii Bloc 19","MUNICIPIUL SATU MARE",1,136483,1,1,2823,1079,996,83,1075,4,3000,1921,812,263,
32,"SATU MARE",305,136483,,55,0,"Scoala Generala Nr. 20, Str. Crizantemei nr.3","MUNICIPIUL SATU MARE",1,136483,1,1,2409,913,866,47,902,11,2600,1687,705,197,
32,"SATU MARE",305,136483,,56,0,"Scoala Generala Nr. 20, Str. Crizantemei nr.3","MUNICIPIUL SATU MARE",1,136483,1,1,2237,793,760,33,785,8,2400,1607,581,204,
32,"SATU MARE",305,136483,,57,0,"Scoala Generala Nr. 20, Str. Crizantemei nr.3","MUNICIPIUL SATU MARE",1,136483,1,1,2228,789,754,35,780,9,2400,1611,555,225,
32,"SATU MARE",305,136483,,58,0,"Scoala Generala  Cartier Satmarel","MUNICIPIUL SATU MARE",1,136483,1,1,1001,621,544,77,614,7,1100,479,341,273,
32,"SATU MARE",305,136483,,59,1,"Gara CFR Satu Mare, Str. Grivitei nr. 1","MUNICIPIUL SATU MARE",1,136483,1,1,0,203,0,203,201,2,500,297,117,84,
32,"SATU MARE",305,136526,,60,0,"Grupul Scolar Agricol, Str. Iuliu Maniu nr. 1","MUNICIPIUL CAREI",2,136526,1,1,1514,623,554,69,613,10,1600,977,521,92,
32,"SATU MARE",305,136526,,61,0,"Grupul Scolar Iuliu Maniu, Str. Iuliu Maniu","MUNICIPIUL CAREI",2,136526,1,1,1546,711,646,65,704,7,1700,989,593,111,
32,"SATU MARE",305,136526,,62,0,"Scoala profesionala Nr. 10, Str. R. Ferencz","MUNICIPIUL CAREI",2,136526,1,1,2079,730,670,60,724,6,2300,1570,642,82,
32,"SATU MARE",305,136526,,63,0,"Scoala Generala Nr. 1, Str. 1 Decembrie 1918","MUNICIPIUL CAREI",2,136526,1,1,1713,722,632,90,718,4,1900,1178,626,92,
32,"SATU MARE",305,136526,,64,0,"Scoala Generala Nr. 2, Str. Vasile Lucaciu","MUNICIPIUL CAREI",2,136526,1,1,1115,586,373,213,582,4,1300,714,469,113,
32,"SATU MARE",305,136526,,65,0,"Gradinita de copii Nr. 9, Str. Vasile Lucaciu","MUNICIPIUL CAREI",2,136526,1,1,2018,747,598,149,743,4,2200,1453,608,135,
32,"SATU MARE",305,136526,,66,0,"Gradinita de copii Nr. 10, Calea Mihai Viteazu","MUNICIPIUL CAREI",2,136526,1,1,1626,696,429,267,689,7,1800,1104,557,132,
32,"SATU MARE",305,136526,,67,0,"Scoala Generala Nr. 3, Str. Ignisului","MUNICIPIUL CAREI",2,136526,1,1,2097,718,615,103,707,11,2300,1582,549,158,
32,"SATU MARE",305,136526,,68,0,"Liceul Teoretic, Str. Ignisului","MUNICIPIUL CAREI",2,136526,1,1,2330,1039,763,276,1026,13,2600,1561,858,168,
32,"SATU MARE",305,136526,,69,0,"Gradinita de copii Nr. 5, Str. Tireamului","MUNICIPIUL CAREI",2,136526,1,1,1108,720,417,303,710,10,1200,480,558,152,
32,"SATU MARE",305,136526,,70,0,"Gradinita de copii Nr. 8, Str. Viilor","MUNICIPIUL CAREI",2,136526,1,1,1973,648,595,53,647,1,2100,1452,571,76,
32,"SATU MARE",305,136526,,71,0,"Scoala Generala Nr. 4, Bulevardul 25 Octombrie","MUNICIPIUL CAREI",2,136526,1,1,1992,860,753,107,853,7,2200,1340,734,119,
32,"SATU MARE",305,136526,,72,1,"U.M. Casa Armatei, Str. Grof Krolyi Sandor","MUNICIPIUL CAREI",2,136526,1,1,708,698,689,9,681,17,700,2,404,277,
32,"SATU MARE",305,136526,,73,0,"Scoala Generala Ianculesti","MUNICIPIUL CAREI",2,136526,1,1,349,318,257,61,318,0,400,82,153,165,
32,"SATU MARE",305,136599,,74,0,"Scoala Generala Nr. 2","ORAS NEGRESTI-OAS",3,136599,2,1,717,364,312,52,353,11,1900,1536,206,147,
32,"SATU MARE",305,136599,,75,0,"Scoala Generala Nr. 3","ORAS NEGRESTI-OAS",3,136599,2,1,4062,1167,984,183,1155,12,3600,2433,717,438,
32,"SATU MARE",305,136599,,76,0,"Scoala Generala Nr. 1","ORAS NEGRESTI-OAS",3,136599,2,1,2236,868,630,238,829,39,3300,2432,574,255,
32,"SATU MARE",305,136599,,77,0,"Liceul Teoretic","ORAS NEGRESTI-OAS",3,136599,2,1,2981,926,795,131,919,7,3300,2374,637,282,
32,"SATU MARE",305,136599,,78,0,"Scoala Generala Tur","ORAS NEGRESTI-OAS",3,136599,2,1,1384,430,388,42,423,7,1500,1070,278,145,
32,"SATU MARE",305,136642,,79,0,"Scoala Generala Tasnad, Str. Nicolae Balcescu nr. 25","ORAS TASNAD",4,136642,2,1,1347,641,586,55,631,10,1500,859,446,185,
32,"SATU MARE",305,136642,,80,0,"Scoala Generala  Tasnad, Str. Lacrimioarelor nr. 25","ORAS TASNAD",4,136642,2,1,1752,679,573,106,670,9,1600,921,476,194,
32,"SATU MARE",305,136642,,81,0,"Muzeul orasenesc Tasnad, Str. Lacrimioarelor nr. 14","ORAS TASNAD",4,136642,2,1,1778,784,703,81,778,6,1700,916,528,250,
32,"SATU MARE",305,136642,,82,0,"Casa de cultura Tasnad, Str. Înfratirii nr. 3","ORAS TASNAD",4,136642,2,1,1356,679,608,71,670,9,1500,821,552,118,
32,"SATU MARE",305,136642,,83,0,"Scoala Generala Blaja","ORAS TASNAD",4,136642,2,1,178,159,115,44,158,1,300,141,82,76,
32,"SATU MARE",305,136642,,84,0,"Scoala Generala Cig","ORAS TASNAD",4,136642,2,1,389,241,182,59,240,1,500,259,129,111,
32,"SATU MARE",305,136642,,85,0,"Scoala Generala Sarauad","ORAS TASNAD",4,136642,2,1,765,504,418,86,495,9,900,396,377,118,
32,"SATU MARE",305,136642,,86,0,"Scoala Generala  Valea Morii","ORAS TASNAD",4,136642,2,1,152,121,98,23,117,4,200,79,56,61,
32,"SATU MARE",305,136642,,87,1,"U.M. 0728, Str. Stefan cel Mare","ORAS TASNAD",4,136642,2,1,0,457,0,457,449,8,500,43,222,227,
32,"SATU MARE",305,136642,,88,0,"Scoala Generala Tasnadu Nou","ORAS TASNAD",4,136642,2,1,161,104,71,33,103,1,200,96,97,6,
32,"SATU MARE",305,136713,,89,0,"Caminul Cultural Acâs","ACIS",5,136713,0,3,1318,637,521,116,617,20,1500,863,514,103,
32,"SATU MARE",305,136713,,90,0,"Scoala Generala Unimat","ACIS",5,136713,0,3,461,278,234,44,275,3,500,222,189,86,
32,"SATU MARE",305,136713,,91,0,"Scoala Generala Mihaileni","ACIS",5,136713,0,3,453,277,237,40,271,6,500,223,257,14,
32,"SATU MARE",305,136768,,92,0,"Scoala Generala Andrid","ANDRID",6,136768,0,3,1091,449,382,67,437,12,1200,751,329,108,
32,"SATU MARE",305,136768,,93,0,"Scoala Generala Dindesti","ANDRID",6,136768,0,3,639,355,275,80,351,4,700,345,214,137,
32,"SATU MARE",305,136768,,94,0,"Scoala Generala Irina","ANDRID",6,136768,0,3,393,235,193,42,228,7,500,265,220,8,
32,"SATU MARE",305,136802,,95,0,"Caminul Cultural Apa","APA",7,136802,0,3,1889,1061,1009,52,1035,26,2000,939,687,348,
32,"SATU MARE",305,136802,,96,0,"Caminul Cultural Someseni","APA",7,136802,0,3,282,204,171,33,198,6,300,96,132,66,
32,"SATU MARE",305,136848,,97,0,"Liceul Teoretic Ardud","ARDUD",8,136848,0,3,1753,712,532,180,709,3,1900,1188,519,190,
32,"SATU MARE",305,136848,,98,0,"Primaria Ardud","ARDUD",8,136848,0,3,1167,497,323,174,485,12,1300,803,444,41,
32,"SATU MARE",305,136848,,99,0,"Caminul Cultural Baba-Novac","ARDUD",8,136848,0,3,452,314,243,71,306,8,500,186,179,127,
32,"SATU MARE",305,136848,,100,0,"Scoala Generala Gerausa","ARDUD",8,136848,0,3,452,358,292,66,355,3,500,142,202,153,
32,"SATU MARE",305,136848,,101,0,"Asociatia Agricola Madaras","ARDUD",8,136848,0,3,769,441,368,73,434,7,900,459,293,141,
32,"SATU MARE",305,136919,,102,0,"Scoala Generala Batarci","BATARCI",10,136919,0,3,1766,633,569,64,624,9,2000,1367,377,247,
32,"SATU MARE",305,136919,,103,0,"Scoala Generala Comlausa","BATARCI",10,136919,0,3,854,478,410,68,468,10,1000,522,245,223,
32,"SATU MARE",305,136919,,104,0,"Scoala Generala Tamaseni","BATARCI",10,136919,0,3,345,205,188,17,203,2,400,195,194,9,
32,"SATU MARE",305,136964,,105,0,"Scoala Generala Beltuig","BELTIUG",11,136964,0,3,1170,476,402,74,461,15,1300,824,378,83,
32,"SATU MARE",305,136964,,106,0,"Caminul Cultural Bolda","BELTIUG",11,136964,0,3,126,109,88,21,103,6,200,91,69,34,
32,"SATU MARE",305,136964,,107,0,"Scoala Generala Ghirisa","BELTIUG",11,136964,0,3,578,266,217,49,262,4,700,434,260,2,
32,"SATU MARE",305,136964,,108,0,"Scoala Generala Giungi","BELTIUG",11,136964,0,3,142,134,87,47,132,2,200,66,110,22,
32,"SATU MARE",305,136964,,109,0,"Scoala Generala Ratesti","BELTIUG",11,136964,0,3,612,272,211,61,264,8,700,428,219,45,
32,"SATU MARE",305,137032,,110,0,"Scoala Generala Berveni","BERVENI",12,137032,0,3,2043,1237,1161,76,1217,20,2300,1063,1156,61,
32,"SATU MARE",305,137032,,111,0,"Scoala Generala Lucaceni","BERVENI",12,137032,0,3,807,506,491,15,505,1,1000,494,342,163,
32,"SATU MARE",305,137069,,112,0,"Scoala Generala Bixad","BIXAD",13,137069,0,3,2335,757,683,74,745,12,2600,1843,293,452,
32,"SATU MARE",305,137069,,113,0,"Scoala Generala Boinesti","BIXAD",13,137069,0,3,1129,411,380,31,405,6,1300,889,178,227,
32,"SATU MARE",305,137069,,114,0,"Scoala Generala Trip - Bai","BIXAD",13,137069,0,3,2244,708,498,210,705,3,2600,1892,348,357,
32,"SATU MARE",305,137103,,115,0,"Scoala Generala Bârsaul de Sus","BARSAU",9,137103,0,3,1446,851,789,62,836,15,1700,849,369,467,
32,"SATU MARE",305,137103,,116,0,"Biroul public admin. Bârsaul de Jos","BARSAU",9,137103,0,3,558,320,259,61,313,7,600,280,183,130,
32,"SATU MARE",305,137130,,117,0,"Consiliul Local Bogdand","BOGDAND",14,137130,0,3,982,320,300,20,317,3,1100,780,300,17,
32,"SATU MARE",305,137130,,118,0,"Sediul fostei CAP Babta","BOGDAND",14,137130,0,3,790,346,301,45,339,7,900,554,150,189,
32,"SATU MARE",305,137130,,119,0,"Scoala Generala Corund","BOGDAND",14,137130,0,3,447,293,228,65,290,3,500,207,198,92,
32,"SATU MARE",305,137130,,120,0,"Scoala Generala Ser","BOGDAND",14,137130,0,3,663,266,231,35,257,9,700,434,239,18,
32,"SATU MARE",305,137185,,121,0,"Caminul Cultural Agris","BOTIZ",15,137185,0,3,828,401,371,30,397,4,900,494,383,14,
32,"SATU MARE",305,137185,,122,0,"Primaria Botiz","BOTIZ",15,137185,0,3,1499,394,334,60,386,8,1700,1306,309,77,
32,"SATU MARE",305,137185,,123,0,"Scoala Generala Osvareu","BOTIZ",15,137185,0,3,954,389,267,122,381,8,1000,611,255,126,
32,"SATU MARE",305,137185,,124,0,"Scoala Generala Ciuperceni","BOTIZ",15,137185,0,3,396,190,150,40,186,4,500,310,147,39,
32,"SATU MARE",305,137229,,125,0,"Primaria Calinesti Oas","CALINESTI-OAS",16,137229,0,3,2056,622,570,52,613,9,2200,1578,239,374,
32,"SATU MARE",305,137229,,126,0,"Scoala Generala Lechinta","CALINESTI-OAS",16,137229,0,3,675,307,271,36,303,4,800,493,97,206,
32,"SATU MARE",305,137229,,127,0,"Scoala Generala Coca","CALINESTI-OAS",16,137229,0,3,715,324,244,80,321,3,800,476,139,182,
32,"SATU MARE",305,136553,,128,0,"Primaria Capleni","CAPLENI",18,136553,0,3,2510,1128,1034,94,1121,7,2800,1672,1105,16,
32,"SATU MARE",305,136553,,129,0,"Scoala Generala Camin","CAPLENI",18,136553,0,3,1062,596,498,98,590,6,1200,604,568,22,
32,"SATU MARE",305,137274,,130,0,"Primaria Camarzana","CAMARZANA",17,137274,0,3,1275,454,418,36,446,8,1400,946,74,372,
32,"SATU MARE",305,137274,,131,0,"Scoala Generala Centru","CAMARZANA",17,137274,0,3,802,301,241,60,297,4,900,599,72,225,
32,"SATU MARE",305,137292,,132,0,"Scoala Generala Cauas","CAUAS",19,137292,0,3,488,307,253,54,298,9,600,293,195,103,
32,"SATU MARE",305,137292,,133,0,"Dispensarul uman","CAUAS",19,137292,0,3,918,330,293,37,321,9,1000,670,297,24,
32,"SATU MARE",305,137292,,134,0,"Scoala Generala Hotoan","CAUAS",19,137292,0,3,180,130,102,28,129,1,200,70,62,67,
32,"SATU MARE",305,137292,,135,0,"Scoala Generala Ady Endre","CAUAS",19,137292,0,3,149,86,58,28,84,2,200,114,64,20,
32,"SATU MARE",305,137292,,136,0,"Scoala Generala Ghilesti","CAUAS",19,137292,0,3,110,80,61,19,77,3,200,120,42,35,
32,"SATU MARE",305,137292,,137,0,"Magazinul satesc Radulesti","CAUAS",19,137292,0,3,91,86,57,29,86,0,100,14,41,45,
32,"SATU MARE",305,137363,,138,0,"Scoala Generala Cehal","CEHAL",20,137363,0,3,902,469,415,54,461,8,1000,531,168,293,
32,"SATU MARE",305,137363,,139,0,"Scoala Generala Cehalut","CEHAL",20,137363,0,3,633,336,300,36,324,12,700,364,288,36,
32,"SATU MARE",305,137363,,140,0,"Scoala Generala Orbau","CEHAL",20,137363,0,3,331,209,168,41,206,3,400,191,153,53,
32,"SATU MARE",305,137407,,141,0,"Caminul Cultural Certeze","CERTEZE",21,137407,0,3,2637,667,582,85,667,0,2900,2233,354,313,
32,"SATU MARE",305,137407,,142,0,"Scoala Generala Huta","CERTEZE",21,137407,0,3,841,361,292,69,355,6,1000,639,157,198,
32,"SATU MARE",305,137407,,143,0,"Scoala Generala Moiseni","CERTEZE",21,137407,0,3,937,383,322,61,376,7,1100,717,188,188,
32,"SATU MARE",305,137443,,144,0,"Scoala Generala Craidorolt","CRAIDOROLT",22,137443,0,3,1033,551,460,91,544,7,1100,549,435,109,
32,"SATU MARE",305,137443,,145,0,"Scoala Generala Eriu Sâncrai","CRAIDOROLT",22,137443,0,3,687,349,276,73,337,12,800,451,245,92,
32,"SATU MARE",305,137504,,146,0,"Caminul Cultural Crucisor","CRUCISOR",23,137504,0,3,572,272,236,36,266,6,700,428,140,126,
32,"SATU MARE",305,137504,,147,0,"Scoala Generala Iegheriste","CRUCISOR",23,137504,0,3,472,273,232,41,273,0,600,327,145,128,
32,"SATU MARE",305,137504,,148,0,"Scoala Generala Poina Codrului","CRUCISOR",23,137504,0,3,1129,695,599,96,686,9,1300,605,416,270,
32,"SATU MARE",305,137540,,149,0,"Consiliul Local Culciu","CULCIU",24,137540,0,3,633,235,203,32,227,8,700,465,186,41,
32,"SATU MARE",305,137540,,150,0,"Scoala Generala Caraseu","CULCIU",24,137540,0,3,921,377,311,66,365,12,1000,623,331,34,
32,"SATU MARE",305,137540,,151,0,"Scoala Generala Corod","CULCIU",24,137540,0,3,623,250,174,76,241,9,700,450,196,45,
32,"SATU MARE",305,137540,,152,0,"Scoala Generala Culciu Mic nr. 122","CULCIU",24,137540,0,3,483,154,122,32,152,2,600,446,125,27,
32,"SATU MARE",305,137540,,153,0,"Scoala Generala Lipau","CULCIU",24,137540,0,3,483,297,228,69,291,6,600,303,197,94,
32,"SATU MARE",305,137611,,154,0,"Primaria Doba","DOBA",25,137611,0,3,933,364,295,69,354,10,1000,636,268,86,
32,"SATU MARE",305,137611,,155,0,"Scoala Generala Boghis","DOBA",25,137611,0,3,717,267,212,55,263,4,1000,733,196,67,
32,"SATU MARE",305,137611,,156,0,"Scoala Generala Paulian","DOBA",25,137611,0,3,537,326,262,64,316,10,500,174,149,167,
32,"SATU MARE",305,137675,,157,0,"Primaria Dorolt","DOROLT",26,137675,0,3,1375,545,400,145,508,37,1500,955,492,16,
32,"SATU MARE",305,137675,,158,0,"Scoala Generala Dara","DOROLT",26,137675,0,3,1085,512,448,64,506,6,1200,688,503,3,
32,"SATU MARE",305,137675,,159,0,"Caminul Cultural Atea","DOROLT",26,137675,0,3,280,190,160,30,190,0,400,210,190,0,
32,"SATU MARE",305,137728,,160,0,"Consiliul Local Foieni","FOIENI",27,137728,0,3,1627,731,697,34,718,13,1800,1069,706,12,
32,"SATU MARE",305,137746,,161,0,"Caminul Gherta Mica","GHERTA MICA",28,137746,0,3,1056,439,406,33,434,5,1150,711,256,178,
32,"SATU MARE",305,137746,,162,0,"Scoala Generala Gherta Mica","GHERTA MICA",28,137746,0,3,952,392,369,23,390,2,1150,758,250,140,
32,"SATU MARE",305,137764,,163,0,"Caminul Cultural Babesti","HALMEU",29,137764,0,3,322,183,166,17,172,11,500,317,164,8,
32,"SATU MARE",305,137764,,164,0,"Scoala Generala Cidreag","HALMEU",29,137764,0,3,761,454,428,26,444,10,900,446,420,24,
32,"SATU MARE",305,137764,,165,0,"Scoala Generala Dabolt","HALMEU",29,137764,0,3,277,135,112,23,132,3,300,165,107,25,
32,"SATU MARE",305,137764,,166,0,"Perceptia Halmeu, Str. Eliberarii nr. 27","HALMEU",29,137764,0,3,1282,469,384,85,455,14,1450,981,314,141,
32,"SATU MARE",305,137764,,167,0,"Gradinita de copii Halmeu, Str. Eliberarii nr. 74","HALMEU",29,137764,0,3,1323,606,433,173,589,17,1500,894,389,200,
32,"SATU MARE",305,137764,,168,0,"Scoala Generala Mesteacan","HALMEU",29,137764,0,3,349,145,125,20,143,2,350,205,79,64,
32,"SATU MARE",305,137764,,169,0,"Caminul Cultural Porumbesti","HALMEU",29,137764,0,3,1200,480,432,48,475,5,1283,803,447,28,
32,"SATU MARE",305,137844,,170,0,"Primaria Hodod","HODOD",30,137844,0,3,800,241,218,23,238,3,900,659,220,18,
32,"SATU MARE",305,137844,,171,0,"Scoala Generala Giurtelec","HODOD",30,137844,0,3,562,369,292,77,366,3,600,231,235,131,
32,"SATU MARE",305,137844,,172,0,"Scoala Generala Lelei","HODOD",30,137844,0,3,508,239,205,34,225,14,600,361,214,11,
32,"SATU MARE",305,137844,,173,0,"Fostul sediu al CAP Nadis","HODOD",30,137844,0,3,600,278,242,36,269,9,700,422,267,2,
32,"SATU MARE",305,137899,,174,0,"Scoala Generala Homorodul de Mijloc","HOMOROADE",31,137899,0,3,973,506,432,74,499,7,1100,594,319,180,
32,"SATU MARE",305,137899,,175,0,"Scoala Generala Solduba","HOMOROADE",31,137899,0,3,337,202,189,13,199,3,400,198,146,53,
32,"SATU MARE",305,137899,,176,0,"Scoala Generala Homorodu de Jos","HOMOROADE",31,137899,0,3,515,239,216,23,236,3,600,361,145,91,
32,"SATU MARE",305,137960,,177,0,"Scoala Generala Bercu","LAZURI",32,137960,0,3,560,212,135,77,208,4,600,388,180,28,
32,"SATU MARE",305,137960,,178,0,"Caminul Cultural Lazuri","LAZURI",32,137960,0,3,1793,704,616,88,690,14,2000,1296,614,76,
32,"SATU MARE",305,137960,,179,0,"Scoala Generala Nisipeni","LAZURI",32,137960,0,3,548,235,175,60,232,3,600,365,224,8,
32,"SATU MARE",305,137960,,180,0,"Scoala Generala Noroieni","LAZURI",32,137960,0,3,230,110,80,30,109,1,300,190,65,44,
32,"SATU MARE",305,137960,,181,0,"Caminul Cultural Pelisor","LAZURI",32,137960,0,3,161,93,64,29,93,0,200,107,90,3,
32,"SATU MARE",305,137960,,182,0,"Caminul Cultural Peles","LAZURI",32,137960,0,3,659,318,265,53,312,6,700,382,282,30,
32,"SATU MARE",305,138039,,183,0,"Scoala Generala Livada Noua, Str. 23 August nr. 67","LIVADA",33,138039,0,3,2206,765,712,53,751,14,2400,1635,681,70,
32,"SATU MARE",305,138039,,184,0,"Scoala Generala Livada Veche, Str. Oasului nr. 7","LIVADA",33,138039,0,3,1521,539,500,39,534,5,1700,1161,489,45,
32,"SATU MARE",305,138039,,185,0,"Scoala Generala Dumbrava","LIVADA",33,138039,0,3,738,382,311,71,376,6,800,418,176,200,
32,"SATU MARE",305,138039,,186,0,"Scoala Generala Adrian","LIVADA",33,138039,0,3,391,228,203,25,222,6,500,272,209,13,
32,"SATU MARE",305,138039,,187,0,"Caminul Cultural Livada Mica","LIVADA",33,138039,0,3,243,218,185,33,216,2,300,82,110,106,
32,"SATU MARE",305,138084,,188,0,"Primaria Mediesu Aurit","MEDIESU AURIT",34,138084,0,3,2238,911,823,88,902,9,2400,1489,513,389,
32,"SATU MARE",305,138084,,189,0,"Scoala Generala Potau","MEDIESU AURIT",34,138084,0,3,809,402,333,69,396,6,900,498,269,127,
32,"SATU MARE",305,138084,,190,0,"Gradinita de copii Babasesti","MEDIESU AURIT",34,138084,0,3,457,282,212,70,281,1,500,218,120,161,
32,"SATU MARE",305,138084,,191,0,"Scoala Generala Românesti","MEDIESU AURIT",34,138084,0,3,539,278,199,79,272,6,600,322,143,129,
32,"SATU MARE",305,138084,,192,0,"Scoala Generala Iojib","MEDIESU AURIT",34,138084,0,3,822,376,309,67,366,10,900,524,283,83,
32,"SATU MARE",305,138084,,193,0,"Scoala Generala Medies Râturi","MEDIESU AURIT",34,138084,0,3,166,144,82,62,140,4,200,56,60,80,
32,"SATU MARE",305,138084,,194,0,"Scoala Generala Medies Vii","MEDIESU AURIT",34,138084,0,3,151,97,52,45,97,0,200,103,36,61,
32,"SATU MARE",305,138164,,195,0,"Caminul Cultural Micula","MICULA",35,138164,0,3,2371,940,810,130,919,21,2600,1660,654,265,
32,"SATU MARE",305,138164,,196,0,"Scoala Generala Micula Noua","MICULA",35,138164,0,3,393,267,147,120,265,2,400,133,170,95,
32,"SATU MARE",305,138208,,197,0,"Caminul Cultural Moftinu Mic","MOFTIN",36,138208,0,3,988,389,307,82,386,3,1100,711,279,107,
32,"SATU MARE",305,138208,,198,0,"Gradinita de copii Domanesti","MOFTIN",36,138208,0,3,829,335,257,78,330,5,900,565,285,45,
32,"SATU MARE",305,138208,,199,0,"Scoala Generala Moftinu Mare","MOFTIN",36,138208,0,3,986,460,326,134,452,8,1094,634,329,123,
32,"SATU MARE",305,138208,,200,0,"Sediul SC Megarom SRL Sânmiclaus","MOFTIN",36,138208,0,3,483,269,210,59,265,4,600,331,180,85,
32,"SATU MARE",305,138280,,201,0,"Gradinita de copii Odoreu, Str. Republicii","ODOREU",37,138280,0,3,1870,439,372,67,434,5,2000,1561,268,166,
32,"SATU MARE",305,138280,,202,0,"Scoala Generala Odoreu, Str. Tineretului nr. 1","ODOREU",37,138280,0,3,1863,600,500,100,587,13,2000,1400,449,138,
32,"SATU MARE",305,138351,,203,0,"Consiliul Local Orasu Nou","ORASU NOU",38,138351,0,3,1648,780,760,20,756,24,1900,1120,680,76,
32,"SATU MARE",305,138351,,204,0,"Scoala Generala Orasu Nou Vii","ORASU NOU",38,138351,0,3,535,430,385,45,418,12,600,170,295,123,
32,"SATU MARE",305,138351,,205,0,"Scoala Generala Prilog","ORASU NOU",38,138351,0,3,715,280,267,13,273,7,900,620,120,153,
32,"SATU MARE",305,138351,,206,0,"Scoala Generala Racsa","ORASU NOU",38,138351,0,3,2080,1125,1095,30,1110,15,2200,1075,572,538,
32,"SATU MARE",305,138351,,207,0,"Scoala Generala Remetea","ORASU NOU",38,138351,0,3,471,190,178,12,188,2,600,410,178,10,
32,"SATU MARE",305,138431,,208,0,"Scoala Generala Paulesti","PAULESTI",39,138431,0,3,651,281,230,51,273,8,700,419,195,78,
32,"SATU MARE",305,138431,,209,0,"Scoala Generala Ambud","PAULESTI",39,138431,0,3,814,323,281,42,321,2,900,577,309,12,
32,"SATU MARE",305,138431,,210,0,"Scoala Generala Petin","PAULESTI",39,138431,0,3,453,197,157,40,196,1,500,303,187,9,
32,"SATU MARE",305,138431,,211,0,"Scoala Generala Amati","PAULESTI",39,138431,0,3,649,287,246,41,284,3,700,413,170,114,
32,"SATU MARE",305,138431,,212,0,"Scoala Generala Ruseni","PAULESTI",39,138431,0,3,193,150,116,34,144,6,200,50,69,75,
32,"SATU MARE",305,138431,,213,0,"Scoala Generala Hrip","PAULESTI",39,138431,0,3,458,246,220,26,242,4,500,254,195,47,
32,"SATU MARE",305,138501,,214,0,"Consiliul Local Petresti","PETRESTI",40,138501,0,3,1498,677,593,84,663,14,1600,923,628,35,
32,"SATU MARE",305,138538,,215,0,"Scoala Generala Pir","PIR",41,138538,0,3,1431,595,562,33,579,16,1500,905,521,58,
32,"SATU MARE",305,138574,,216,0,"Scoala Generala Piscolt","PISCOLT",42,138574,0,3,1777,879,805,74,859,20,1900,1021,666,193,
32,"SATU MARE",305,138574,,217,0,"Scoala Generala Resighea","PISCOLT",42,138574,0,3,312,197,145,52,193,4,400,203,163,30,
32,"SATU MARE",305,138574,,218,0,"Scoala Generala Scarisoara","PISCOLT",42,138574,0,3,382,349,240,109,345,4,500,151,185,160,
32,"SATU MARE",305,138618,,219,0,"Primaria Pomi","POMI",43,138618,0,3,821,421,351,70,414,7,900,479,223,191,
32,"SATU MARE",305,138618,,220,0,"Scoala Generala Borlesti","POMI",43,138618,0,3,599,262,202,60,256,6,700,438,156,100,
32,"SATU MARE",305,138618,,221,0,"Scoala Generala Aciua","POMI",43,138618,0,3,143,78,47,31,77,1,200,122,41,36,
32,"SATU MARE",305,138618,,222,0,"Scoala Generala Bicau","POMI",43,138618,0,3,179,112,89,23,111,1,300,188,72,39,
32,"SATU MARE",305,138663,,223,0,"Gradinita de copii nr. 1 Sanislau","SANISLAU",45,138663,0,3,1306,612,515,97,602,10,1398,786,537,65,
32,"SATU MARE",305,138663,,224,0,"Gradinita de copii nr. 2 Sanislau","SANISLAU",45,138663,0,3,1221,642,529,113,628,14,1400,758,474,154,
32,"SATU MARE",305,138663,,225,0,"Caminul Cultural Ciumesti","SANISLAU",45,138663,0,3,1158,699,594,105,693,6,1300,601,651,42,
32,"SATU MARE",305,138663,,226,0,"Caminul Cultural Horea","SANISLAU",45,138663,0,3,213,217,136,81,213,4,300,83,101,112,
32,"SATU MARE",305,138663,,227,0,"Scoala Generala Marna","SANISLAU",45,138663,0,3,240,205,149,56,205,0,300,95,55,150,
32,"SATU MARE",305,138734,,228,0,"Scoala Generala Santau","SANTAU",46,138734,0,3,1442,782,683,99,763,19,1600,818,470,293,
32,"SATU MARE",305,138734,,229,0,"Scoala Generala Chereusa","SANTAU",46,138734,0,3,539,275,226,49,274,1,600,325,224,50,
32,"SATU MARE",305,138734,,230,0,"Scoala Generala Sudurau","SANTAU",46,138734,0,3,167,107,86,21,100,7,200,93,78,22,
32,"SATU MARE",305,138770,,231,0,"Primaria Sacaseni","SACASENI",44,138770,0,3,822,430,358,72,419,11,900,470,360,59,
32,"SATU MARE",305,138770,,232,0,"Scoala Generala Chegea","SACASENI",44,138770,0,3,254,170,131,39,164,6,300,130,46,118,
32,"SATU MARE",305,138805,,233,0,"Scoala Generala Becheni","SAUCA",47,138805,0,3,457,251,210,41,246,5,500,249,233,13,
32,"SATU MARE",305,138805,,234,0,"Scoala Generala Cean","SAUCA",47,138805,0,3,255,170,135,35,166,4,300,130,124,42,
32,"SATU MARE",305,138805,,235,0,"Scoala Generala Sauca","SAUCA",47,138805,0,3,327,215,159,56,212,3,500,285,144,68,
32,"SATU MARE",305,138805,,236,0,"Scoala Generala Silvas","SAUCA",47,138805,0,3,135,108,78,30,105,3,200,92,69,36,
32,"SATU MARE",305,138869,,237,0,"Scoala Generala Socond","SOCOND",48,138869,0,3,324,161,112,49,156,5,400,239,96,60,
32,"SATU MARE",305,138869,,238,0,"Scoala Generala Hodisa","SOCOND",48,138869,0,3,305,214,175,39,214,0,400,186,107,107,
32,"SATU MARE",305,138869,,239,0,"Scoala Generala Cuta","SOCOND",48,138869,0,3,430,244,218,26,241,3,500,256,136,105,
32,"SATU MARE",305,138869,,240,0,"Scoala Generala Soconzel","SOCOND",48,138869,0,3,386,224,183,41,223,1,500,276,44,179,
32,"SATU MARE",305,138869,,241,0,"Scoala Generala Stâna","SOCOND",48,138869,0,3,748,446,392,54,439,7,900,454,249,190,
32,"SATU MARE",305,138921,,242,0,"Primaria Supur","SUPUR",49,138921,0,3,1061,439,346,93,434,5,1200,761,274,160,
32,"SATU MARE",305,138921,,243,0,"Scoala Generala Dobra","SUPUR",49,138921,0,3,974,383,332,51,362,21,1100,717,346,16,
32,"SATU MARE",305,138921,,244,0,"Scoala Generala Giorocuta","SUPUR",49,138921,0,3,623,293,239,54,283,10,700,407,146,137,
32,"SATU MARE",305,138921,,245,0,"Scoala Generala Horezu Mare","SUPUR",49,138921,0,3,346,234,181,53,232,2,400,166,151,81,
32,"SATU MARE",305,138921,,246,0,"Scoala Generala Racova","SUPUR",49,138921,0,3,286,181,147,34,171,10,300,119,97,74,
32,"SATU MARE",305,138921,,247,0,"Scoala Generala Supuru de Sus","SUPUR",49,138921,0,3,366,231,153,78,229,2,400,169,106,123,
32,"SATU MARE",305,138921,,248,0,"Scoala Generala Secheresa","SUPUR",49,138921,0,3,73,63,49,14,63,0,100,37,63,0,
32,"SATU MARE",305,139009,,249,0,"Primaria Tarna Mare","TARNA MARE",50,139009,0,3,1559,800,664,136,779,21,1700,900,399,380,
32,"SATU MARE",305,139009,,250,0,"Gradinita de copii Valea Seaca","TARNA MARE",50,139009,0,3,920,480,424,56,474,6,1100,620,217,257,
32,"SATU MARE",305,139009,,251,0,"Scoala Generala Bocicau","TARNA MARE",50,139009,0,3,491,277,232,45,270,7,600,323,149,121,
32,"SATU MARE",305,139054,,252,0,"Scoala Generala Terebesti","TEREBESTI",52,139054,0,3,525,283,235,48,269,14,600,317,194,75,
32,"SATU MARE",305,139054,,253,0,"Scoala Generala Gelu","TEREBESTI",52,139054,0,3,380,273,216,57,268,5,400,127,138,130,
32,"SATU MARE",305,139054,,254,0,"Scoala Generala Piscari","TEREBESTI",52,139054,0,3,381,246,207,39,246,0,396,150,185,61,
32,"SATU MARE",305,139107,,255,0,"Primaria Tiream","TIREAM",53,139107,0,3,1275,826,704,122,815,11,1400,574,656,159,
32,"SATU MARE",305,139107,,256,0,"Caminul Cultural Vezendiu","TIREAM",53,139107,0,3,578,332,247,85,329,3,700,368,206,123,
32,"SATU MARE",305,139143,,257,0,"Scoala Generala Târsolt","TARSOLT",51,139143,0,3,2025,501,461,40,487,14,2200,1699,207,280,
32,"SATU MARE",305,139143,,258,0,"Scoala Generala Aliceni","TARSOLT",51,139143,0,3,230,107,64,43,106,1,300,193,42,64,
32,"SATU MARE",305,139170,,259,0,"Scoala Generala nr. 1 Turt","TURT",54,139170,0,3,2393,697,531,166,679,18,2600,1903,361,318,
32,"SATU MARE",305,139170,,260,0,"Scoala Generala nr. 2 Turt","TURT",54,139170,0,3,1121,442,338,104,429,13,2300,1858,196,233,
32,"SATU MARE",305,139170,,261,0,"Scoala de patru ani Susan de Jos","TURT",54,139170,0,3,760,340,244,96,334,6,800,460,153,181,
32,"SATU MARE",305,139170,,262,0,"Scoala Generala Gherta Mare","TURT",54,139170,0,3,1083,445,364,81,436,9,1200,755,191,245,
32,"SATU MARE",305,139214,,263,0,"Primaria Turulung","TURULUNG",55,139214,0,3,1269,400,358,42,394,6,1400,1000,379,15,
32,"SATU MARE",305,139214,,264,0,"Scoala Generala Turulung","TURULUNG",55,139214,0,3,890,444,332,112,437,7,1000,556,419,18,
32,"SATU MARE",305,139214,,265,0,"Scoala Generala Draguseni","TURULUNG",55,139214,0,3,788,419,320,99,416,3,900,481,231,185,
32,"SATU MARE",305,139214,,266,0,"Scoala Generala Turulung Vii","TURULUNG",55,139214,0,3,156,87,43,44,85,2,200,113,79,6,
32,"SATU MARE",305,139250,,267,0,"Caminul Cultural Urziceni","URZICENI",56,139250,0,3,1107,776,691,85,767,9,1300,524,720,47,
32,"SATU MARE",305,139287,,268,0,"Consiliul Local Valea Vinului","VALEA VINULUI",57,139287,0,3,763,344,305,39,341,3,800,456,132,209,
32,"SATU MARE",305,139287,,269,0,"Scoala Generala Marius","VALEA VINULUI",57,139287,0,3,232,127,78,49,125,2,300,173,64,61,
32,"SATU MARE",305,139287,,270,0,"Scoala Generala Rosiori","VALEA VINULUI",57,139287,0,3,429,261,212,49,258,3,500,239,152,106,
32,"SATU MARE",305,139287,,271,0,"Scoala Generala Sâi","VALEA VINULUI",57,139287,0,3,341,173,104,69,170,3,400,227,112,58,
32,"SATU MARE",305,139330,,272,0,"Scoala Generala Vama","VAMA",58,139330,0,3,2296,740,687,53,733,7,2500,1760,473,260,
32,"SATU MARE",305,139330,,273,0,"Scoala Generala Vama Bai","VAMA",58,139330,0,3,534,200,154,46,192,8,600,400,95,97,
32,"SATU MARE",305,139358,,274,0,"Scoala Generala Vetis","VETIS",59,139358,0,3,1312,331,267,64,324,7,1600,1269,263,61,
32,"SATU MARE",305,139358,,275,0,"Caminul Cultural Oar","VETIS",59,139358,0,3,1202,503,353,150,486,17,1300,797,405,81,
32,"SATU MARE",305,139358,,276,0,"Scoala Generala Decebal","VETIS",59,139358,0,3,643,358,241,117,354,4,700,342,249,105,
32,"SATU MARE",305,139394,,277,0,"Primaria Viile Satu Mare","VIILE SATU MARE",60,139394,0,3,1590,488,436,52,479,9,1600,1112,440,39,
32,"SATU MARE",305,139394,,278,0,"Scoala Generala Tataresti","VIILE SATU MARE",60,139394,0,3,553,267,208,59,263,4,800,533,202,61,
32,"SATU MARE",305,139394,,279,0,"Scoala Generala Medisa","VIILE SATU MARE",60,139394,0,3,208,151,109,42,148,3,300,149,101,47,
32,"SATU MARE",305,139394,,280,0,"Scoala Generala Cionchesti","VIILE SATU MARE",60,139394,0,3,117,105,70,35,102,3,200,95,56,46,
33,"SALAJ",314,139704,,1,0,"STR. 22 DECEMBRIE 1989,NR. 1","MUNICIPIUL ZALAU",1,139704,1,1,2017,966,875,91,944,22,2180,1214,780,164,
33,"SALAJ",314,139704,,2,0,"STR.GH.DOJA,NR.19","MUNICIPIUL ZALAU",1,139704,1,1,2482,1147,1105,42,1139,8,2700,1553,706,433,
33,"SALAJ",314,139704,,3,0,"STR.AVRAM IANCU,NR.4","MUNICIPIUL ZALAU",1,139704,1,1,2740,1274,1194,80,1246,28,2880,1606,782,464,
33,"SALAJ",314,139704,,4,0,"STR.TIPOGRAFILOR,NR.1","MUNICIPIUL ZALAU",1,139704,1,1,2364,964,903,61,956,8,2570,1606,572,384,
33,"SALAJ",314,139704,,5,0,"STR.CORNELIU COPOSU,NR.9","MUNICIPIUL ZALAU",1,139704,1,1,2326,1220,1118,102,1206,14,2520,1300,933,273,
33,"SALAJ",314,139704,,6,0,"STR.9 MAI,NR.9","MUNICIPIUL ZALAU",1,139704,1,1,2274,1181,1095,86,1164,17,2450,1269,763,401,
33,"SALAJ",314,139704,,7,0,"STR.GH.LAZAR,NR.3","MUNICIPIUL ZALAU",1,139704,1,1,2382,1042,1010,32,1027,15,2600,1558,630,397,
33,"SALAJ",314,139704,,8,0,"STR.TUDOR VLADIMIRESCU,NR.5","MUNICIPIUL ZALAU",1,139704,1,1,2270,1043,951,92,1036,7,2470,1427,702,334,
33,"SALAJ",314,139704,,9,0,"STR.POROLISSUM,NR.9","MUNICIPIUL ZALAU",1,139704,1,1,2702,1175,1089,86,1159,16,2940,1765,629,530,
33,"SALAJ",314,139704,,10,0,"B-DUL MIHAI VITEAZUL,NR.35","MUNICIPIUL ZALAU",1,139704,1,1,2191,984,858,126,976,8,2380,1396,528,448,
33,"SALAJ",314,139704,,11,0,"STR.ALEEA TOAMNEI,NR.3","MUNICIPIUL ZALAU",1,139704,1,1,2357,973,915,58,965,8,2550,1577,489,476,
33,"SALAJ",314,139704,,12,0,"B-DUL MIHAI VITEAZUL,NR.49","MUNICIPIUL ZALAU",1,139704,1,1,2121,843,772,71,834,9,2300,1457,446,388,
33,"SALAJ",314,139704,,13,0,"B-DUL MIHAI VITEAZUL,NR.49","MUNICIPIUL ZALAU",1,139704,1,1,2409,1046,990,56,1039,7,2600,1554,465,574,
33,"SALAJ",314,139704,,14,0,"STR.SIMION BARNUTIU,SC GEN NR 8","MUNICIPIUL ZALAU",1,139704,1,1,2583,1202,1140,62,1202,0,2782,1580,511,691,
33,"SALAJ",314,139704,,15,0,"STR.SIMION BARNUTIU,NR.51","MUNICIPIUL ZALAU",1,139704,1,1,2252,1047,978,69,1041,6,2440,1393,451,590,
33,"SALAJ",314,139704,,16,0,"STR.SIMION BARNUTIU,NR.51","MUNICIPIUL ZALAU",1,139704,1,1,2237,970,858,112,956,14,2440,1470,457,499,
33,"SALAJ",314,139704,,17,0,"STR.SIMION BARNUTIU,NR.14","MUNICIPIUL ZALAU",1,139704,1,1,1801,903,773,130,890,13,1950,1047,456,434,
33,"SALAJ",314,139704,,18,0,"STR.TORENTULUI,NR.9","MUNICIPIUL ZALAU",1,139704,1,1,2420,1066,992,74,1062,4,2640,1574,498,564,
33,"SALAJ",314,139704,,19,0,"STR.SFANTA VINERI,NR.8","MUNICIPIUL ZALAU",1,139704,1,1,2290,1076,954,122,1063,13,2480,1404,496,567,
33,"SALAJ",314,139704,,20,0,"STR.SIMION BARNUTIU,NR.6","MUNICIPIUL ZALAU",1,139704,1,1,2369,1074,1001,73,1067,7,2550,1476,646,421,
33,"SALAJ",314,139704,,21,0,"STR.CRISAN, SC NORMALA","MUNICIPIUL ZALAU",1,139704,1,1,2306,1138,1084,54,1130,8,2500,1362,724,406,
33,"SALAJ",314,139704,,22,0,"B-DUL MIHAI VITEAZUL,NR.25","MUNICIPIUL ZALAU",1,139704,1,1,2208,1069,1021,48,1062,7,2400,1331,652,410,
33,"SALAJ",314,139704,,23,0,"SCOALA GENERALA - CARTIER ORTELEC","MUNICIPIUL ZALAU",1,139704,1,1,1230,623,578,45,614,9,1330,707,232,382,
33,"SALAJ",314,139704,,24,0,"CAMINUL CULTURAL STANA","MUNICIPIUL ZALAU",1,139704,1,1,287,234,180,54,231,3,300,66,175,56,
33,"SALAJ",314,139704,,25,1,"SPITALUL JUDETEAN","MUNICIPIUL ZALAU",1,139704,1,1,0,385,0,385,380,5,700,315,240,140,
33,"SALAJ",314,139704,,26,1,"CASA ARMATEI","MUNICIPIUL ZALAU",1,139704,1,1,0,945,0,945,902,43,1080,135,422,480,
33,"SALAJ",314,139740,,27,0,"STR.OBORULUI,NR.1","ORAS CEHU SILVANIEI",2,139740,2,1,1505,583,554,29,576,7,1630,1047,472,104,
33,"SALAJ",314,139740,,28,0,"PIATA GH.POP DE BASESTI,NR.37","ORAS CEHU SILVANIEI",2,139740,2,1,1454,526,478,48,515,11,1540,1014,400,115,
33,"SALAJ",314,139740,,29,0,"PIATA GH.POP DE BASESTI,NR.26","ORAS CEHU SILVANIEI",2,139740,2,1,1569,729,681,48,715,14,1700,971,560,155,
33,"SALAJ",314,139740,,30,0,"SCOALA GENERALA HOROATU CEHULUI","ORAS CEHU SILVANIEI",2,139740,2,1,167,146,113,33,142,4,180,34,60,82,
33,"SALAJ",314,139740,,31,0,"SCOALA GENERALA MOTIS","ORAS CEHU SILVANIEI",2,139740,2,1,561,381,363,18,380,1,600,219,246,134,
33,"SALAJ",314,139740,,32,0,"SCOALA GENERALA NADIS","ORAS CEHU SILVANIEI",2,139740,2,1,523,396,372,24,385,11,570,174,222,163,
33,"SALAJ",314,139740,,33,0,"CAMINUL CULTURAL ULCIUG","ORAS CEHU SILVANIEI",2,139740,2,1,823,374,357,17,369,5,900,526,301,68,
33,"SALAJ",314,139811,,34,0,"STR.1 DECEMBRIE 1918,NR.8","ORAS JIBOU",3,139811,2,1,2208,1045,978,67,1037,8,2400,1355,598,439,
33,"SALAJ",314,139811,,35,0,"STR.PARCULUI,NR.3","ORAS JIBOU",3,139811,2,1,2152,1010,898,112,1004,6,2350,1340,597,407,
33,"SALAJ",314,139811,,36,0,"STR.GAROAFELOR,NR.7","ORAS JIBOU",3,139811,2,1,1503,711,667,44,708,3,1630,919,448,260,
33,"SALAJ",314,139811,,37,0,"STR.TUDOR VLADIMIRESCU,NR.9","ORAS JIBOU",3,139811,2,1,1996,867,795,72,855,12,2180,1313,596,259,
33,"SALAJ",314,139811,,38,0,"SCOALA GENERALA CUCEU","ORAS JIBOU",3,139811,2,1,396,247,219,28,244,3,430,183,85,159,
33,"SALAJ",314,139811,,39,0,"SCOALA GENERALA HUSIA","ORAS JIBOU",3,139811,2,1,216,132,116,16,127,5,240,108,75,52,
33,"SALAJ",314,139811,,40,0,"SCOALA GENERALA RONA","ORAS JIBOU",3,139811,2,1,314,208,190,18,201,7,340,132,113,88,
33,"SALAJ",314,139811,,41,0,"SCOALA GENERALA VAR","ORAS JIBOU",3,139811,2,1,426,280,257,23,278,2,460,180,161,117,
33,"SALAJ",314,139884,,42,0,"STR.HOREA","ORAS SIMLEU SILVANIEI",4,139884,2,1,1484,746,690,56,734,12,1620,874,342,392,
33,"SALAJ",314,139884,,43,0,"STR.S.BARNUTIU,NR.3","ORAS SIMLEU SILVANIEI",4,139884,2,1,1573,723,691,32,714,9,1710,987,455,259,
33,"SALAJ",314,139884,,44,0,"STR.A.MURESANU,NR.1","ORAS SIMLEU SILVANIEI",4,139884,2,1,1565,692,659,33,677,15,1700,1008,476,201,
33,"SALAJ",314,139884,,45,0,"STR.M.KOGALNICEANU,NR.11","ORAS SIMLEU SILVANIEI",4,139884,2,1,1450,693,599,94,686,7,1580,887,441,245,
33,"SALAJ",314,139884,,46,0,"STR.N.BALCESCU,NR.19","ORAS SIMLEU SILVANIEI",4,139884,2,1,1883,610,565,45,601,9,2050,1440,360,241,
33,"SALAJ",314,139884,,47,0,"STR.1 DECEMBRIE 1918,CLUBUL COPIILOR","ORAS SIMLEU SILVANIEI",4,139884,2,1,1715,736,683,53,724,12,1870,1134,411,313,
33,"SALAJ",314,139884,,48,0,"STR.GHIOCEILOR,GRADINITA CU CRESA","ORAS SIMLEU SILVANIEI",4,139884,2,1,1696,876,773,103,858,18,1857,981,516,342,
33,"SALAJ",314,139884,,49,0,"SCOALA GENERALA CEHEI","ORAS SIMLEU SILVANIEI",4,139884,2,1,804,506,462,44,496,10,880,374,137,359,
33,"SALAJ",314,139884,,50,0,"SCOALA GENERALA PUSTA","ORAS SIMLEU SILVANIEI",4,139884,2,1,860,416,374,42,402,14,930,514,291,111,
33,"SALAJ",314,139884,,51,1,"STR.M.SADOVEANU GRADINITA","ORAS SIMLEU SILVANIEI",4,139884,2,1,0,148,0,148,141,7,150,2,72,69,
33,"SALAJ",314,139937,,52,0,"PRIMARIA AGRIJ","AGRIJ",5,139937,0,3,752,428,378,50,421,7,820,392,177,244,
33,"SALAJ",314,139937,,53,0,"SCOALA PRIMARA RASTOLTU DESERT","AGRIJ",5,139937,0,3,305,215,162,53,213,2,330,115,76,137,
33,"SALAJ",314,139982,,54,0,"PRIMARIA COMUNEI ALMASU","ALMASU",6,139982,0,3,915,575,494,81,565,10,1000,425,335,230,
33,"SALAJ",314,139982,,55,0,"CAMINUL CULTURAL JEBUCU","ALMASU",6,139982,0,3,393,329,275,54,320,9,430,101,285,35,
33,"SALAJ",314,139982,,56,0,"SCOALA GENERALA MESTEACANU","ALMASU",6,139982,0,3,539,437,377,60,432,5,580,143,187,245,
33,"SALAJ",314,139982,,57,0,"CAMINUL CULTURAL PETRINZEL","ALMASU",6,139982,0,3,344,259,217,42,256,3,370,111,246,10,
33,"SALAJ",314,139982,,58,0,"SCOALA GENERALA TAUDU","ALMASU",6,139982,0,3,190,152,131,21,150,2,200,48,53,97,
33,"SALAJ",314,140084,,59,0,"SCOALA GENERALA BABENI","BABENI",7,140084,0,3,635,358,321,37,356,2,660,302,187,169,
33,"SALAJ",314,140084,,60,0,"SCOALA GENERALA CIOCMANI","BABENI",7,140084,0,3,584,359,279,80,349,10,630,271,180,169,
33,"SALAJ",314,140084,,61,0,"SCOALA GENERALA POIENITA","BABENI",7,140084,0,3,298,250,201,49,248,2,320,70,164,84,
33,"SALAJ",314,140084,,62,0,"SCOALA PRIMARA CLIT","BABENI",7,140084,0,3,214,176,140,36,173,3,230,54,131,42,
33,"SALAJ",314,140084,,63,0,"MAGAZIN SATESC PIROSA","BABENI",7,140084,0,3,135,120,104,16,120,0,150,30,85,35,
33,"SALAJ",314,140146,,64,0,"CAMINUL CULTURAL BALAN","BALAN",8,140146,0,3,939,443,404,39,434,9,1020,577,157,277,
33,"SALAJ",314,140146,,65,0,"SCOALA GENERALA CHECHIS","BALAN",8,140146,0,3,539,363,279,84,357,6,580,217,190,167,
33,"SALAJ",314,140146,,66,0,"SCOALA GENERALA CHENDREA","BALAN",8,140146,0,3,712,408,377,31,401,7,770,362,193,208,
33,"SALAJ",314,140146,,67,0,"SCOALA GENERALA GALPAIA","BALAN",8,140146,0,3,465,256,241,15,250,6,500,244,165,85,
33,"SALAJ",314,140146,,68,0,"SCOALA GENERALA GALGAU ALMASULUI","BALAN",8,140146,0,3,795,451,366,85,446,5,870,419,193,253,
33,"SALAJ",314,140208,,69,0,"CONSILIUL LOCAL BANISOR","BANISOR",9,140208,0,3,1127,613,554,59,605,8,1230,617,210,395,
33,"SALAJ",314,140208,,70,0,"SCOALA GENERALA PECEI","BANISOR",9,140208,0,3,857,508,475,33,498,10,930,422,116,382,
33,"SALAJ",314,140244,,71,0,"SCOALA GENERALA BENESAT","BENESAT",10,140244,0,3,412,215,191,24,211,4,440,225,136,75,
33,"SALAJ",314,140244,,72,0,"SCOALA GENERALA ALUNIS","BENESAT",10,140244,0,3,539,403,353,50,395,8,590,187,206,189,
33,"SALAJ",314,140244,,73,0,"SCOALA GENERALA BIUSA","BENESAT",10,140244,0,3,471,260,242,18,256,4,510,250,207,49,
33,"SALAJ",314,140280,,74,0,"CAMINUL CULTURAL,SALA DE GRADINITA BOBOTA","BOBOTA",11,140280,0,3,1249,899,792,107,891,8,1360,461,381,510,
33,"SALAJ",314,140280,,75,0,"CAMINUL CULTURAL DERSIDA","BOBOTA",11,140280,0,3,1326,848,753,95,828,20,1440,592,436,392,
33,"SALAJ",314,140280,,76,0,"SCOALA GENERALA SALA DE CLS. ZALNOC","BOBOTA",11,140280,0,3,541,322,283,39,308,14,590,268,157,151,
33,"SALAJ",314,140324,,77,0,"GRADINITA BOCSA","BOCSA",12,140324,0,3,793,483,448,35,477,6,860,377,230,247,
33,"SALAJ",314,140324,,78,0,"SCOALA GENERALA BORLA","BOCSA",12,140324,0,3,1221,702,676,26,679,23,1320,618,646,33,
33,"SALAJ",314,140324,,79,0,"SCOALA GENERALA SALAJENI","BOCSA",12,140324,0,3,685,454,393,61,445,9,750,296,228,217,
33,"SALAJ",314,140379,,80,0,"PRIMARIA BUCIUMI","BUCIUMI",13,140379,0,3,1326,710,614,96,693,17,1440,730,248,445,
33,"SALAJ",314,140379,,81,0,"SCOALA GENERALA BOGDANA","BUCIUMI",13,140379,0,3,376,284,209,75,284,0,410,126,134,150,
33,"SALAJ",314,140379,,82,0,"SCOALA GENERALA RASTOLTU","BUCIUMI",13,140379,0,3,264,134,101,33,130,4,290,156,39,91,
33,"SALAJ",314,140379,,83,0,"SCOALA GENERALA SINGEORGIU DE MESES","BUCIUMI",13,140379,0,3,374,258,194,64,251,7,400,142,83,168,
33,"SALAJ",314,140440,,84,0,"CAMINUL CULTURAL CAMAR","CAMAR",14,140440,0,3,1539,1122,1091,31,1117,5,1680,558,1077,40,
33,"SALAJ",314,140477,,85,0,"PRIMARIA CARASTELEC","CARASTELEC",15,140477,0,3,918,574,539,35,571,3,1000,426,558,13,
33,"SALAJ",314,140477,,86,0,"SCOALA GENERALA DUMUSLAU","CARASTELEC",15,140477,0,3,103,66,49,17,65,1,110,44,33,32,
33,"SALAJ",314,140501,,87,0,"SCOALA GENERALA CHIESD","CHIESD",16,140501,0,3,1568,849,804,45,832,17,1700,851,517,315,
33,"SALAJ",314,140501,,88,0,"SCOALA GENERALA SIGHETU SILV.","CHIESD",16,140501,0,3,440,327,285,42,323,4,480,153,184,139,
33,"SALAJ",314,140547,,89,0,"SCOALA GENERALA HOREA","CIZER",17,140547,0,3,1592,851,755,96,834,17,1740,889,239,595,
33,"SALAJ",314,140547,,90,0,"SCOALA GENERALA PRIA","CIZER",17,140547,0,3,436,300,211,89,292,8,480,180,76,216,
33,"SALAJ",314,140583,,91,0,"PRIMARIA COSEIU","COSEIU",18,140583,0,3,430,226,188,38,222,4,470,244,146,76,
33,"SALAJ",314,140583,,92,0,"SCOALA GENERALA ARCHID","COSEIU",18,140583,0,3,397,220,204,16,218,2,430,210,209,9,
33,"SALAJ",314,140583,,93,0,"SCOALA GENERALA CHILIOARA","COSEIU",18,140583,0,3,287,234,145,89,231,3,310,76,114,117,
33,"SALAJ",314,140627,,94,0,"CAMINUL CULTURAL CRASNA","CRASNA",19,140627,0,3,2042,1239,1127,112,1217,22,2220,981,1140,77,
33,"SALAJ",314,140627,,95,0,"SCOALA GENERALA NR.2 CRASNA","CRASNA",19,140627,0,3,1489,917,854,63,896,21,1620,703,837,59,
33,"SALAJ",314,140627,,96,0,"CAMINUL CULTURAL MARIN","CRASNA",19,140627,0,3,826,587,524,63,585,2,900,313,132,453,
33,"SALAJ",314,140627,,97,0,"CAMINUL CULTURAL RATIN","CRASNA",19,140627,0,3,317,237,210,27,232,5,340,103,214,18,
33,"SALAJ",314,140627,,98,0,"SCOALA GENERAL HUSENI","CRASNA",19,140627,0,3,364,254,225,29,243,11,390,136,137,106,
33,"SALAJ",314,140672,,99,0,"SCOALA GENERALA CREACA","CREACA",20,140672,0,3,598,301,262,39,297,4,660,359,132,165,
33,"SALAJ",314,140672,,100,0,"SCOALA GENERALA BREBI","CREACA",20,140672,0,3,450,265,227,38,259,6,490,225,103,156,
33,"SALAJ",314,140672,,101,0,"SCOALA GENERALA JAC","CREACA",20,140672,0,3,740,406,365,41,402,4,800,394,153,249,
33,"SALAJ",314,140672,,102,0,"SCOALA GENERALA PRODANESTI","CREACA",20,140672,0,3,550,203,176,27,199,4,590,387,99,100,
33,"SALAJ",314,140770,,103,0,"CAMINUL CULTURAL SALA MICA","CRISTOLT",22,140770,0,3,755,407,384,23,387,20,820,413,202,185,
33,"SALAJ",314,140770,,104,0,"SCOALA GENERALA MUNCEL","CRISTOLT",22,140770,0,3,199,158,135,23,155,3,220,62,71,84,
33,"SALAJ",314,140770,,105,0,"SCOALA GENERALA VALENI","CRISTOLT",22,140770,0,3,416,247,225,22,242,5,450,203,154,88,
33,"SALAJ",314,140823,,106,0,"SCOALA GENERALA CRISENI","CRISENI",21,140823,0,3,921,572,533,39,558,14,1000,428,231,327,
33,"SALAJ",314,140823,,107,0,"CAMINUL CULTURAL CRISTUR-CRISENI","CRISENI",21,140823,0,3,351,158,128,30,154,4,380,222,141,13,
33,"SALAJ",314,140823,,108,0,"SCOALA PRIMARA GARCEIU","CRISENI",21,140823,0,3,517,338,270,68,335,3,560,222,194,141,
33,"SALAJ",314,140869,,109,0,"CAMINUL CULTURAL CUZAPLAC","CUZAPLAC",23,140869,0,3,843,502,445,57,493,9,920,418,253,240,
33,"SALAJ",314,140869,,110,0,"CAMINUL CULTURAL GALASENI","CUZAPLAC",23,140869,0,3,145,99,76,23,99,0,160,61,23,76,
33,"SALAJ",314,140869,,111,0,"CAMINUL CULTURAL MIERTA","CUZAPLAC",23,140869,0,3,173,138,121,17,135,3,190,52,96,39,
33,"SALAJ",314,140869,,112,0,"CAMINUL CULTURAL PETRINDU","CUZAPLAC",23,140869,0,3,439,347,306,41,344,3,480,133,217,127,
33,"SALAJ",314,140869,,113,0,"CAMINUL CULTURAL RUGINOASA","CUZAPLAC",23,140869,0,3,153,85,50,35,85,0,170,85,58,27,
33,"SALAJ",314,140958,,114,0,"CAMINUL CULTURAL DOBRIN","DOBRIN",24,140958,0,3,407,264,245,19,260,4,440,176,193,67,
33,"SALAJ",314,140958,,115,0,"SCOALA GENERALA CU CLS. I-VIII DOBA","DOBRIN",24,140958,0,3,557,229,210,19,221,8,600,371,199,22,
33,"SALAJ",314,140958,,116,0,"SCOALA GENERALA CU CLS. I-IV NAIMON","DOBRIN",24,140958,0,3,144,98,63,35,95,3,150,52,70,25,
33,"SALAJ",314,140958,,117,0,"SCOALA GENERALA CU CLS. I-IV VERVEGHIU","DOBRIN",24,140958,0,3,361,211,183,28,207,4,390,179,189,18,
33,"SALAJ",314,141027,,118,0,"PRIMARIA COMUNEI DRAGU","DRAGU",25,141027,0,3,477,341,242,99,339,2,510,169,267,72,
33,"SALAJ",314,141027,,119,0,"SCOALA GENERALA CU CLS. I-IV ADALIN","DRAGU",25,141027,0,3,165,138,72,66,133,5,180,42,65,68,
33,"SALAJ",314,141027,,120,0,"CASA CU NR.20, SATUL UGRUTIU","DRAGU",25,141027,0,3,57,65,24,41,65,0,70,5,22,43,
33,"SALAJ",314,141027,,121,0,"SCOALA GENERALA CU CLS. I-IV VOIVODENI","DRAGU",25,141027,0,3,284,186,109,77,178,8,310,124,114,64,
33,"SALAJ",314,141081,,122,0,"PRIMARIA FILDU DE JOS","FILDU DE JOS",26,141081,0,3,514,288,235,53,283,5,560,272,173,110,
33,"SALAJ",314,141081,,123,0,"SCOALA GENERALA FILDU DE JOS","FILDU DE JOS",26,141081,0,3,747,415,342,73,403,12,810,395,134,269,
33,"SALAJ",314,141134,,124,0,"SCOALA GENERALA CU CLS. I-VIII GILGAU","GALGAU",27,141134,0,3,967,534,457,77,526,8,1050,516,273,253,
33,"SALAJ",314,141134,,125,0,"SCOALA GENERALA CU CLS. I-VIII FODORA","GALGAU",27,141134,0,3,630,432,348,84,428,4,680,248,220,208,
33,"SALAJ",314,141134,,126,0,"SCOALA GENERALA CU CLS. I-VIII GLOD","GALGAU",27,141134,0,3,615,379,299,80,375,4,670,291,172,203,
33,"SALAJ",314,141232,,127,0,"SCOALA CU CLS. I-IV  BEZDED","GARBOU",28,141232,0,3,213,140,109,31,139,1,240,100,83,56,
33,"SALAJ",314,141232,,128,0,"CAMINUL CULTURAL CALACEA","GARBOU",28,141232,0,3,343,212,182,30,207,5,370,158,111,96,
33,"SALAJ",314,141232,,129,0,"SCOALA CU CLS. I-IV CERNUC","GARBOU",28,141232,0,3,209,159,136,23,152,7,220,61,75,77,
33,"SALAJ",314,141232,,130,0,"SEDIUL PRIMARIEI","GARBOU",28,141232,0,3,717,356,326,30,354,2,780,424,191,163,
33,"SALAJ",314,141232,,131,0,"GRADINITA POPTELEAC","GARBOU",28,141232,0,3,354,172,140,32,167,5,380,208,53,114,
33,"SALAJ",314,141232,,132,0,"SCOALA CU CLS. I-IV SOLOMON","GARBOU",28,141232,0,3,409,242,227,15,239,3,440,198,120,119,
33,"SALAJ",314,141312,,133,0,"CAMINUL CULTURAL HALMASD","HALMASD",29,141312,0,3,990,533,491,42,519,14,1080,547,190,329,
33,"SALAJ",314,141312,,134,0,"SCOALA GENERALA ALEUS","HALMASD",29,141312,0,3,315,164,150,14,160,4,340,176,74,86,
33,"SALAJ",314,141312,,135,0,"SCOALA GENERALA CERISA","HALMASD",29,141312,0,3,426,269,243,26,265,4,460,191,103,162,
33,"SALAJ",314,141312,,136,0,"SCOALA GENERALA DRIGHIU","HALMASD",29,141312,0,3,424,209,185,24,196,13,460,251,66,130,
33,"SALAJ",314,141376,,137,0,"CAMINUL CULTURAL HERECLEAN","HERECLEAN",30,141376,0,3,411,212,178,34,209,3,450,238,115,94,
33,"SALAJ",314,141376,,138,0,"CAMINUL CULTURAL BADON","HERECLEAN",30,141376,0,3,513,365,333,32,359,6,560,195,142,217,
33,"SALAJ",314,141376,,139,0,"SCOALA PRIMARA BOCSITA","HERECLEAN",30,141376,0,3,109,100,62,38,100,0,120,20,48,52,
33,"SALAJ",314,141376,,140,0,"SCOALA GIMNAZIALA DIOSOD","HERECLEAN",30,141376,0,3,892,547,512,35,546,1,970,423,519,27,
33,"SALAJ",314,141376,,141,0,"SCOALA GIMNAZIALA GURUSLAU","HERECLEAN",30,141376,0,3,477,198,175,23,194,4,520,322,178,16,
33,"SALAJ",314,141376,,142,0,"CAMINUL CULTURAL PANIC","HERECLEAN",30,141376,0,3,699,333,314,19,326,7,760,427,302,24,
33,"SALAJ",314,141447,,143,0,"GRUP SCOLAR HIDA","HIDA",31,141447,0,3,1070,639,557,82,625,14,1160,521,389,236,
33,"SALAJ",314,141447,,144,0,"SCOALA GENERALA RACIS","HIDA",31,141447,0,3,468,228,189,39,224,4,510,282,110,114,
33,"SALAJ",314,141447,,145,0,"SCOALA GENERALA SINPETRU ALMASULUI","HIDA",31,141447,0,3,604,281,245,36,273,8,650,369,151,122,
33,"SALAJ",314,141447,,146,0,"SCOALA GENERALA STUPINI","HIDA",31,141447,0,3,147,129,56,73,129,0,160,31,79,50,
33,"SALAJ",314,141447,,147,0,"SCOALA GENERALA TRESTIA","HIDA",31,141447,0,3,299,190,162,28,188,2,320,130,123,65,
33,"SALAJ",314,141535,,148,0,"GRADINITA HOROATU CRASNEI","HOROATU CRASNEI",32,141535,0,3,798,437,380,57,431,6,870,433,242,189,
33,"SALAJ",314,141535,,149,0,"CAMINUL CULTURAL HUREZ","HOROATU CRASNEI",32,141535,0,3,353,216,164,52,213,3,380,164,79,134,
33,"SALAJ",314,141535,,150,0,"CAMINUL CULTURAL STIRCIU","HOROATU CRASNEI",32,141535,0,3,835,483,381,102,473,10,910,427,154,319,
33,"SALAJ",314,141535,,151,0,"CAMINUL CULTURAL SEREDEIU","HOROATU CRASNEI",32,141535,0,3,319,177,137,40,171,6,340,163,56,115,
33,"SALAJ",314,141580,,152,0,"CAMINUL CULTURAL ILEANDA","ILEANDA",33,141580,0,3,1100,657,524,133,648,9,1190,533,373,275,
33,"SALAJ",314,141580,,153,0,"SCOALA DOLHENI","ILEANDA",33,141580,0,3,211,138,102,36,135,3,230,92,56,79,
33,"SALAJ",314,141580,,154,0,"SCOALA LUMINISU","ILEANDA",33,141580,0,3,108,86,67,19,83,3,120,34,47,36,
33,"SALAJ",314,141580,,155,0,"SCOALA NEGRENI","ILEANDA",33,141580,0,3,117,85,61,24,83,2,130,45,28,55,
33,"SALAJ",314,141580,,156,0,"SCOALA RASTOCI","ILEANDA",33,141580,0,3,259,155,129,26,154,1,280,125,84,70,
33,"SALAJ",314,141580,,157,0,"SCOALA ROGNA","ILEANDA",33,141580,0,3,247,128,98,30,126,2,270,142,57,69,
33,"SALAJ",314,141722,,158,0,"CAMINUL CULTURAL IP","IP",34,141722,0,3,1433,697,646,51,686,11,1560,863,550,136,
33,"SALAJ",314,141722,,159,0,"CAMINUL CULTURAL ZAUAN","IP",34,141722,0,3,867,475,440,35,467,8,940,465,446,21,
33,"SALAJ",314,141722,,160,0,"SCOALA CU CLS.I-VIII COSNICIU DE JOS","IP",34,141722,0,3,907,526,491,35,505,21,980,454,193,312,
33,"SALAJ",314,141786,,161,0,"PRIMARIA LETCA","LETCA",35,141786,0,3,540,353,324,29,348,5,590,237,210,138,
33,"SALAJ",314,141786,,162,0,"SCOALA GENERALA COZLA","LETCA",35,141786,0,3,546,248,219,29,245,3,590,342,123,122,
33,"SALAJ",314,141786,,163,0,"SCOALA CU CLS.I-VIII LEMNIU","LETCA",35,141786,0,3,532,341,301,40,339,2,580,239,170,169,
33,"SALAJ",314,141786,,164,0,"SCOALA PURCARET","LETCA",35,141786,0,3,183,105,85,20,100,5,200,95,46,54,
33,"SALAJ",314,141786,,165,0,"SCOALA CU CLS.I-IV CUCIULAT","LETCA",35,141786,0,3,217,163,138,25,162,1,230,67,100,62,
33,"SALAJ",314,141884,,166,0,"PRIMARIA COMUNEI","LOZNA",36,141884,0,3,588,380,297,83,378,2,640,260,265,113,
33,"SALAJ",314,141884,,167,0,"SCOALA CU CLS.I-IV VALEA LUNGA","LOZNA",36,141884,0,3,232,180,136,44,180,0,250,70,112,68,
33,"SALAJ",314,141884,,168,0,"SCOALA CU CLS.I-IV CORMANIS","LOZNA",36,141884,0,3,167,158,128,30,152,6,180,22,99,53,
33,"SALAJ",314,141946,,169,0,"CONSILIUL LOCAL MARCA","MARCA",38,141946,0,3,1466,735,684,51,668,16,1600,916,289,379,
33,"SALAJ",314,141946,,170,0,"SCOALA GENERALA LESMIR","MARCA",38,141946,0,3,398,218,207,11,215,3,430,212,196,19,
33,"SALAJ",314,141946,,171,0,"CAMINUL CULTURAL SUMAL","MARCA",38,141946,0,3,501,299,275,24,296,3,550,251,64,232,
33,"SALAJ",314,142006,,172,0,"SCOALA GENERALA MAERISTE","MAERISTE",37,142006,0,3,689,404,369,35,401,3,740,336,187,214,
33,"SALAJ",314,142006,,173,0,"SCOALA GENERALA CRISTELEC","MAERISTE",37,142006,0,3,507,284,253,31,281,3,550,266,118,163,
33,"SALAJ",314,142006,,174,0,"SCOALA GENERALA DOH","MAERISTE",37,142006,0,3,233,139,114,25,134,5,250,111,61,73,
33,"SALAJ",314,142006,,175,0,"SCOALA GENERALA GIURTELECU SIMLEULUI","MAERISTE",37,142006,0,3,871,402,373,29,386,16,950,548,121,265,
33,"SALAJ",314,142006,,176,0,"SCOALA GENERALA MALADIA","MAERISTE",37,142006,0,3,226,108,91,17,108,0,240,132,35,73,
33,"SALAJ",314,142006,,177,0,"SCOALA GENERALA UILEACU SIMLEULUI","MAERISTE",37,142006,0,3,396,248,225,23,246,2,430,182,214,32,
33,"SALAJ",314,142079,,178,0,"PRIMARIA COMUNEI MESESENII DE JOS","MESESENII DE JOS",39,142079,0,3,563,328,281,47,321,7,610,282,219,102,
33,"SALAJ",314,142079,,179,0,"GRADINITA AGHIRES","MESESENII DE JOS",39,142079,0,3,902,518,439,79,510,8,970,452,286,224,
33,"SALAJ",314,142079,,180,0,"SCOALA GENERALA FETINDIA","MESESENII DE JOS",39,142079,0,3,92,112,59,53,111,1,150,38,77,34,
33,"SALAJ",314,142079,,181,0,"SCOALA GENERALA MESESENII DE SUS","MESESENII DE JOS",39,142079,0,3,731,448,375,73,442,6,790,342,150,292,
33,"SALAJ",314,142122,,182,0,"CENTRUL AGRICOL MIRSID","MIRSID",40,142122,0,3,530,264,230,34,262,2,570,306,109,153,
33,"SALAJ",314,142122,,183,0,"SCOALA CU CLS.I-IV FIRMINIS","MIRSID",40,142122,0,3,198,143,119,24,141,2,210,67,59,82,
33,"SALAJ",314,142122,,184,0,"SCOALA CU CLS.I-IV MOIGRAD POROLISSUM","MIRSID",40,142122,0,3,419,202,172,30,202,0,450,248,89,113,
33,"SALAJ",314,142122,,185,0,"CAMINUL CULTURAL POPENI","MIRSID",40,142122,0,3,664,342,306,36,336,6,720,378,138,198,
33,"SALAJ",314,142177,,186,0,"CAMINUL CULTURAL NAPRADEA","NAPRADEA",41,142177,0,3,770,463,425,38,462,1,840,377,291,171,
33,"SALAJ",314,142177,,187,0,"SCOALA GENERALA CHEUD","NAPRADEA",41,142177,0,3,676,382,332,50,375,7,730,348,218,157,
33,"SALAJ",314,142177,,188,0,"SCOALA GENERALA TRANIS","NAPRADEA",41,142177,0,3,511,264,235,29,259,5,550,286,146,113,
33,"SALAJ",314,142177,,189,0,"SCOALA GENERALA GURUSLAU","NAPRADEA",41,142177,0,3,393,256,209,47,254,2,430,174,166,88,
33,"SALAJ",314,142239,,190,0,"CAMINUL CULTURAL NUSFALAU","NUSFALAU",42,142239,0,3,2518,1587,1548,39,1559,28,2740,1153,1459,100,
33,"SALAJ",314,142239,,191,0,"GRADINITA BILGHEZ","NUSFALAU",42,142239,0,3,377,392,347,45,392,0,410,18,389,3,
33,"SALAJ",314,142239,,192,0,"CLUBUL TINERETULUI BOGHIS","NUSFALAU",42,142239,0,3,1416,1041,934,107,1017,24,1540,499,973,44,
33,"SALAJ",314,142284,,193,0,"PRIMARIA COMUNEI PERICEI","PERICEI",43,142284,0,3,2258,1187,1146,41,1153,34,2460,1273,1012,141,
33,"SALAJ",314,142284,,194,0,"GRADINITA BADACINI","PERICEI",43,142284,0,3,632,433,390,43,429,4,680,247,207,222,
33,"SALAJ",314,142284,,195,0,"SCOALA GENERALA SICI","PERICEI",43,142284,0,3,248,155,119,36,154,1,270,115,81,73,
33,"SALAJ",314,142337,,196,0,"SCOALA CU CLS.I-VIII PLOPIS","PLOPIS",44,142337,0,3,942,447,420,27,431,16,1030,583,169,262,
33,"SALAJ",314,142337,,197,0,"SCOALA CU CLS.I-VIII IAZ","PLOPIS",44,142337,0,3,656,251,218,33,241,10,710,459,105,136,
33,"SALAJ",314,142337,,198,0,"SCOALA NR.1 FAGETU","PLOPIS",44,142337,0,3,557,276,218,58,267,9,610,334,87,180,
33,"SALAJ",314,142373,,199,0,"SCOALA CU CLS.I-VIII POIANA BLENCHII","POIANA BLENCHII",45,142373,0,3,695,354,300,54,350,4,760,406,185,165,
33,"SALAJ",314,142373,,200,0,"SCOALA CU CLS.I-VIII GOSTILA","POIANA BLENCHII",45,142373,0,3,452,284,248,36,282,2,490,206,112,170,
33,"SALAJ",314,142426,,201,0,"SCOALA GENERALA ROMANASI","ROMANASI",46,142426,0,3,685,404,337,67,394,10,740,336,204,190,
33,"SALAJ",314,142426,,202,0,"SCOALA GENERALA CIUMARNA","ROMANASI",46,142426,0,3,398,319,255,64,319,0,430,111,196,123,
33,"SALAJ",314,142426,,203,0,"SCOALA GENERALA PAUSA","ROMANASI",46,142426,0,3,360,215,173,42,213,2,390,175,121,92,
33,"SALAJ",314,142426,,204,0,"SCOALA GENERALA POARTA SALAJULUI","ROMANASI",46,142426,0,3,329,239,194,45,237,2,360,121,143,94,
33,"SALAJ",314,142426,,205,0,"SCOALA GENERALA ROMITA","ROMANASI",46,142426,0,3,454,255,224,31,253,2,490,235,114,139,
33,"SALAJ",314,142499,,206,0,"SCOALA CU CLS.I-VIII","RUS",47,142499,0,3,815,360,303,57,353,7,890,530,187,166,
33,"SALAJ",314,142499,,207,0,"SCOALA CU CLS.I-VIII FINTINELE-RUS","RUS",47,142499,0,3,219,157,130,27,156,1,230,73,55,101,
33,"SALAJ",314,142499,,208,0,"SCOALA CU CLS.I-IV HASMAS","RUS",47,142499,0,3,392,304,276,28,296,8,420,116,164,132,
33,"SALAJ",314,142499,,209,0,"SCOALA GENERALA SIMISNA","RUS",47,142499,0,3,881,463,396,67,458,5,960,497,264,194,
33,"SALAJ",314,142550,,210,0,"SCOALA GENERALA SALATIG","SALATIG",49,142550,0,3,392,244,206,38,240,4,430,186,126,114,
33,"SALAJ",314,142550,,211,0,"SCOALA GENERALA BULGARI","SALATIG",49,142550,0,3,213,148,122,26,142,6,230,82,49,93,
33,"SALAJ",314,142550,,212,0,"SCOALA GENERALA DEJA","SALATIG",49,142550,0,3,995,752,726,26,744,8,1080,328,715,29,
33,"SALAJ",314,142550,,213,0,"SCOALA GENERALA MINEU","SALATIG",49,142550,0,3,320,184,151,33,173,11,350,166,117,56,
33,"SALAJ",314,142550,,214,0,"SCOALA GENERALA NOTIG","SALATIG",49,142550,0,3,554,561,513,48,561,0,600,39,265,296,
33,"SALAJ",314,142612,,215,0,"CAMINUL CULTURAL SIG","SAG",48,142612,0,3,1039,473,419,54,465,8,1130,657,194,271,
33,"SALAJ",314,142612,,216,0,"SCOALA CU CLS. I-IV MAL","SAG",48,142612,0,3,1018,498,455,43,495,3,1100,602,155,340,
33,"SALAJ",314,142612,,217,0,"TABARA SCOLARA TUSA","SAG",48,142612,0,3,748,384,348,36,377,7,810,426,97,280,
33,"SALAJ",314,142676,,218,0,"PRIMARIA COMUNEI SINMIHAIU ALMASULUI","SANMIHAIU ALMASULUI",51,142676,0,3,926,454,378,76,449,5,1000,546,231,218,
33,"SALAJ",314,142676,,219,0,"SCOALA GENERALA CU CLS. I-IV SINTAMARIE","SANMIHAIU ALMASULUI",51,142676,0,3,467,293,229,64,290,3,510,217,66,224,
33,"SALAJ",314,142710,,220,0,"CAMINUL CULTURAL SOMES ODORHEI","SOMES-ODORHEI",53,142710,0,3,1061,886,797,89,877,9,1150,264,574,303,
33,"SALAJ",314,142710,,221,0,"CAMINUL CULTURAL DOMNIN","SOMES-ODORHEI",53,142710,0,3,425,253,169,84,244,9,460,207,143,101,
33,"SALAJ",314,142710,,222,0,"SCOALA CU CLS. I-IV INAU","SOMES-ODORHEI",53,142710,0,3,552,467,417,50,459,8,600,133,289,170,
33,"SALAJ",314,142710,,223,0,"CAMINUL CULTURAL SOIMUS","SOMES-ODORHEI",53,142710,0,3,298,210,165,45,206,4,320,110,116,90,
33,"SALAJ",314,142774,,224,0,"CAMINUL CULTURAL SURDUC","SURDUC",54,142774,0,3,1063,603,542,61,593,10,1160,557,374,219,
33,"SALAJ",314,142774,,225,0,"SCOALA GENERALA TIHAU","SURDUC",54,142774,0,3,891,533,494,39,522,11,970,437,290,232,
33,"SALAJ",314,142774,,226,0,"SCOALA GENERALA CRISTOLTEL","SURDUC",54,142774,0,3,391,267,233,34,259,8,430,163,167,92,
33,"SALAJ",314,142774,,227,0,"SCOALA GENERALA TURBUTA","SURDUC",54,142774,0,3,307,134,112,22,129,5,330,196,95,34,
33,"SALAJ",314,142774,,228,0,"SCOALA GENERALA BRIGLEZ","SURDUC",54,142774,0,3,318,189,173,16,186,3,340,151,91,95,
33,"SALAJ",314,142774,,229,0,"SCOALA GENERALA SOLONA","SURDUC",54,142774,0,3,372,276,245,31,273,3,410,134,186,87,
33,"SALAJ",314,142854,,230,0,"PRIMARIA COMUNEI SAMSUD","SAMSUD",50,142854,0,3,1302,656,629,27,636,20,1410,754,606,30,
33,"SALAJ",314,142881,,231,0,"CAMINUL CULTURAL SARMASAG","SARMASAG",52,142881,0,3,1356,657,617,40,649,8,1480,823,631,18,
33,"SALAJ",314,142881,,232,0,"GRADINITA NR.3 SARMASAG","SARMASAG",52,142881,0,3,1129,634,585,49,632,2,1230,596,607,25,
33,"SALAJ",314,142881,,233,0,"SCOALA GENERALA NR.2 SARMASAG","SARMASAG",52,142881,0,3,1162,492,456,36,489,3,1260,768,350,139,
33,"SALAJ",314,142881,,234,0,"SCOALA GENERALA ILISUA","SARMASAG",52,142881,0,3,631,403,372,31,394,9,690,287,368,26,
33,"SALAJ",314,142881,,235,0,"SCOALA GENERALA LOMPIRT","SARMASAG",52,142881,0,3,671,350,331,19,345,5,730,380,322,23,
33,"SALAJ",314,142881,,236,0,"SCOALA GENERALA MOIAD","SARMASAG",52,142881,0,3,175,145,124,21,142,3,190,45,52,90,
33,"SALAJ",314,179631,,237,0,"SCOALA GENERALA TREZNEA","TREZNEA",55,179631,0,3,533,390,306,84,387,3,580,190,171,216,
33,"SALAJ",314,179631,,238,0,"SCOALA GENERALA BOZNA","TREZNEA",55,179631,0,3,242,182,141,41,178,4,260,78,99,79,
33,"SALAJ",314,142952,,239,0,"CAMINUL CULTURAL VALCAU DE JOS","VALCAU DE JOS",56,142952,0,3,1826,835,792,43,814,21,1973,1138,295,519,
33,"SALAJ",314,142952,,240,0,"CAMINUL CULTURAL DIN SATUL PREOTEASA","VALCAU DE JOS",56,142952,0,3,799,365,346,19,360,5,870,505,53,307,
33,"SALAJ",314,143021,,241,0,"PRIMARIA COMUNEI VIRSOLT","VARSOLT",57,143021,0,3,1341,664,637,27,646,18,1460,796,594,52,
33,"SALAJ",314,143021,,242,0,"SCOALA CU CLS. I-VIII RECEA","VARSOLT",57,143021,0,3,653,372,316,56,365,7,710,338,181,184,
33,"SALAJ",314,143067,,243,0,"CAMINUL CULTURAL ZALHA","ZALHA",58,143067,0,3,500,320,279,41,318,2,540,220,140,178,
33,"SALAJ",314,143067,,244,0,"SCOALA PRIMARA CEACA","ZALHA",58,143067,0,3,286,194,164,30,189,5,310,116,71,118,
33,"SALAJ",314,143067,,245,0,"SCOALA PRIMARA VALEA HRANEI","ZALHA",58,143067,0,3,132,106,90,16,104,2,140,34,27,77,
33,"SALAJ",314,143067,,246,0,"SCOALA PRIMARA  VALEA LUNGA","ZALHA",58,143067,0,3,159,115,100,15,112,3,170,55,28,84,
33,"SALAJ",314,143147,,247,0,"CONSILIUL LOCAL AL COMUNEI ZIMBOR","ZIMBOR",59,143147,0,3,728,441,382,59,437,4,790,349,271,166,
33,"SALAJ",314,143147,,248,0,"SCOALA CU CLS. I-IV DOLU","ZIMBOR",59,143147,0,3,87,89,45,44,89,0,100,11,39,50,
33,"SALAJ",314,143147,,249,0,"SINCRAIU ALMASULUI   SCOALA CU CLS. I-IV","ZIMBOR",59,143147,0,3,205,168,129,39,162,6,220,52,69,93,
34,"SIBIU",323,143450,,1,0,"PIATA IANCU DE HUNEDOARA NR.3","MUNICIPIUL SIBIU",1,143450,1,1,1857,763,677,86,744,19,2040,1277,379,365,
34,"SIBIU",323,143450,,2,0,"STR. E.A.BIELTZ NR.60","MUNICIPIUL SIBIU",1,143450,1,1,1785,739,678,61,721,18,1960,1221,469,252,
34,"SIBIU",323,143450,,3,0,"STR.E.A.BIELTZ NR.60","MUNICIPIUL SIBIU",1,143450,1,1,2254,1007,931,76,995,12,2470,1463,568,427,
34,"SIBIU",323,143450,,4,0,"PIATA CLUJ NR.3","MUNICIPIUL SIBIU",1,143450,1,1,1240,656,599,57,644,12,1370,714,406,238,
34,"SIBIU",323,143450,,5,0,"PIATA CLUJ NR.3","MUNICIPIUL SIBIU",1,143450,1,1,1323,740,683,57,727,13,1450,710,437,290,
34,"SIBIU",323,143450,,6,0,"STR.PARIS NR.1","MUNICIPIUL SIBIU",1,143450,1,1,1318,701,672,29,679,22,1450,749,425,254,
34,"SIBIU",323,143450,,7,0,"STR.PEDAGOGILOR NR.7","MUNICIPIUL SIBIU",1,143450,1,1,1495,841,577,264,825,16,1800,959,519,306,
34,"SIBIU",323,143450,,8,0,"STR.LUNGA NR.60","MUNICIPIUL SIBIU",1,143450,1,1,1260,604,540,64,589,15,1399,795,364,225,
34,"SIBIU",323,143450,,9,0,"STR.LUNGA NR.60","MUNICIPIUL SIBIU",1,143450,1,1,1854,856,771,85,832,24,2030,1174,506,326,
34,"SIBIU",323,143450,,10,0,"TIGLARI SC.GEN.NR.23","MUNICIPIUL SIBIU",1,143450,1,1,1277,639,606,33,631,8,1400,761,366,265,
34,"SIBIU",323,143450,,11,0,"TIGLARI SC.GEN.NR.23","MUNICIPIUL SIBIU",1,143450,1,1,2087,976,908,68,956,20,2300,1324,448,508,
34,"SIBIU",323,143450,,12,0,"STR.GLADIOLELOR NR.2","MUNICIPIUL SIBIU",1,143450,1,1,1607,1007,761,246,997,10,1770,763,472,525,
34,"SIBIU",323,143450,,13,0,"STR.POSTAVARILOR NR.18","MUNICIPIUL SIBIU",1,143450,1,1,1635,866,738,128,854,12,1800,934,561,293,
34,"SIBIU",323,143450,,14,0,"STR.LUNGA NR.65","MUNICIPIUL SIBIU",1,143450,1,1,1990,981,894,87,947,34,2200,1219,605,342,
34,"SIBIU",323,143450,,15,0,"STR.LUNGA NR.65","MUNICIPIUL SIBIU",1,143450,1,1,1735,860,772,88,835,25,2200,1340,503,332,
34,"SIBIU",323,143450,,16,0,"STR.SMARDAN NR.5","MUNICIPIUL SIBIU",1,143450,1,1,2270,1009,884,125,998,11,2270,1261,493,505,
34,"SIBIU",323,143450,,17,0,"STR.MACARALEI NR.20","MUNICIPIUL SIBIU",1,143450,1,1,1243,628,570,58,619,9,1400,772,369,250,
34,"SIBIU",323,143450,,18,0,"STR.MACARALEI NR.20","MUNICIPIUL SIBIU",1,143450,1,1,1446,784,722,62,767,17,1606,822,491,276,
34,"SIBIU",323,143450,,19,0,"STR.HENRI COANDA NR.51","MUNICIPIUL SIBIU",1,143450,1,1,1313,737,668,69,729,8,1436,699,419,310,
34,"SIBIU",323,143450,,20,0,"STR.HENRI COANDA NR.51","MUNICIPIUL SIBIU",1,143450,1,1,2088,1168,965,203,1146,22,2600,1432,433,713,
34,"SIBIU",323,143450,,21,0,"STR.LUPENI NR.50","MUNICIPIUL SIBIU",1,143450,1,1,1450,705,680,25,682,23,1600,895,445,237,
34,"SIBIU",323,143450,,22,0,"STR.LUPENI NR.50","MUNICIPIUL SIBIU",1,143450,1,1,1588,801,744,57,771,30,1750,949,503,268,
34,"SIBIU",323,143450,,23,0,"STR.JOHANN SEBASTIAN BACH NR.1-3","MUNICIPIUL SIBIU",1,143450,1,1,1508,736,669,67,721,14,1650,915,420,301,
34,"SIBIU",323,143450,,24,0,"STR.LIVIU REBREANU  GRADINITA NR.17","MUNICIPIUL SIBIU",1,143450,1,1,1749,728,661,67,711,17,1700,972,451,260,
34,"SIBIU",323,143450,,25,0,"STR.NICOLAE TECLU NR.41","MUNICIPIUL SIBIU",1,143450,1,1,1817,965,877,88,946,19,2000,1035,551,395,
34,"SIBIU",323,143450,,26,0,"STR.CONSTITUTIEI NR.2-4","MUNICIPIUL SIBIU",1,143450,1,1,1916,969,878,91,947,22,2100,1131,651,296,
34,"SIBIU",323,143450,,27,0,"STR. AVRAM IANCU NR.13","MUNICIPIUL SIBIU",1,143450,1,1,1102,563,492,71,546,17,1200,637,369,177,
34,"SIBIU",323,143450,,28,0,"STR.GHEORGHE LAZAR NR.1","MUNICIPIUL SIBIU",1,143450,1,1,1653,1025,937,88,911,26,1800,863,693,218,
34,"SIBIU",323,143450,,29,0,"STR. AVRAM IANCU NR.10","MUNICIPIUL SIBIU",1,143450,1,1,1076,556,493,63,540,16,1200,644,369,171,
34,"SIBIU",323,143450,,30,0,"STR.OCNEI NR.31","MUNICIPIUL SIBIU",1,143450,1,1,1742,917,775,142,889,28,1900,983,538,351,
34,"SIBIU",323,143450,,31,0,"STR.ALEXANDRU ODOBESCU NR.2","MUNICIPIUL SIBIU",1,143450,1,1,1651,795,732,63,768,27,1800,1005,543,225,
34,"SIBIU",323,143450,,32,0,"STR.MITROPOLIEI NR.31","MUNICIPIUL SIBIU",1,143450,1,1,1347,724,656,68,696,28,1500,776,489,207,
34,"SIBIU",323,143450,,33,0,"STR.BASTIONULUI NR.7","MUNICIPIUL SIBIU",1,143450,1,1,1349,691,615,76,669,22,1500,809,485,184,
34,"SIBIU",323,143450,,34,0,"STR.ZAHARIA BOIU NR.1","MUNICIPIUL SIBIU",1,143450,1,1,1530,853,787,66,829,24,1700,847,634,195,
34,"SIBIU",323,143450,,35,0,"STR.ZAHARIA BOIU NR.1","MUNICIPIUL SIBIU",1,143450,1,1,1865,947,880,67,934,13,2050,1103,700,234,
34,"SIBIU",323,143450,,36,0,"STR.BANATULUI NR.2","MUNICIPIUL SIBIU",1,143450,1,1,1456,833,695,138,805,28,1600,767,594,211,
34,"SIBIU",323,143450,,37,0,"STR.TURISMULUI NR.15","MUNICIPIUL SIBIU",1,143450,1,1,1406,856,667,189,827,29,1550,694,608,219,
34,"SIBIU",323,143450,,38,0,"STR.BIHORULUI NR.3","MUNICIPIUL SIBIU",1,143450,1,1,1859,998,927,71,972,26,2050,1052,601,371,
34,"SIBIU",323,143450,,39,0,"STR.HATEGULUI NR.8","MUNICIPIUL SIBIU",1,143450,1,1,1473,762,669,93,738,24,1600,838,460,278,
34,"SIBIU",323,143450,,40,0,"STR.HATEGULUI NR.8","MUNICIPIUL SIBIU",1,143450,1,1,1895,1046,991,55,1017,29,2105,1059,663,354,
34,"SIBIU",323,143450,,41,0,"STR.CRISTIAN NR.21","MUNICIPIUL SIBIU",1,143450,1,1,2018,1042,985,57,1018,24,2200,1158,716,302,
34,"SIBIU",323,143450,,42,0,"STR.HOCHMEISTER NR.11","MUNICIPIUL SIBIU",1,143450,1,1,1653,917,818,99,887,30,1801,884,650,237,
34,"SIBIU",323,143450,,43,0,"CALEA POPLACII NR.11","MUNICIPIUL SIBIU",1,143450,1,1,1892,934,878,56,914,20,2050,1116,543,371,
34,"SIBIU",323,143450,,44,0,"CALEA POPLACII NR.11","MUNICIPIUL SIBIU",1,143450,1,1,1950,898,865,33,882,16,2150,1252,523,359,
34,"SIBIU",323,143450,,45,0,"STR.SIBIEL NR.6","MUNICIPIUL SIBIU",1,143450,1,1,1963,921,853,68,909,12,2150,1229,537,372,
34,"SIBIU",323,143450,,46,0,"STR.SIBIEL NR.6","MUNICIPIUL SIBIU",1,143450,1,1,1969,990,905,85,970,20,2150,1160,550,420,
34,"SIBIU",323,143450,,47,0,"STR.VASILE ALECSANDRI NR.10","MUNICIPIUL SIBIU",1,143450,1,1,1205,643,602,41,626,17,1300,657,494,132,
34,"SIBIU",323,143450,,48,0,"STR.VASILE ALECSANDRI NR.10","MUNICIPIUL SIBIU",1,143450,1,1,1096,531,480,51,522,9,1200,669,351,171,
34,"SIBIU",323,143450,,49,0,"STR.MIHAIL SEBASTIAN NR.1","MUNICIPIUL SIBIU",1,143450,1,1,1324,758,711,47,731,27,1450,692,568,163,
34,"SIBIU",323,143450,,50,0,"STR.EMIL CIORAN NR.1 A","MUNICIPIUL SIBIU",1,143450,1,1,1554,942,814,128,919,23,1600,658,699,220,
34,"SIBIU",323,143450,,51,0,"STR.OITUZ NR.27","MUNICIPIUL SIBIU",1,143450,1,1,1527,791,712,79,776,15,1700,909,506,270,
34,"SIBIU",323,143450,,52,0,"STR.OITUZ NR.31","MUNICIPIUL SIBIU",1,143450,1,1,1263,706,641,65,685,21,1400,694,506,179,
34,"SIBIU",323,143450,,53,0,"STR.OITUZ NR.31","MUNICIPIUL SIBIU",1,143450,1,1,1551,787,714,73,768,19,1700,913,527,241,
34,"SIBIU",323,143450,,54,0,"STR.INDEPENDENTEI NR.1","MUNICIPIUL SIBIU",1,143450,1,1,1293,714,605,109,691,23,1320,606,533,158,
34,"SIBIU",323,143450,,55,0,"STR.INDEPENDENTEI NR.1","MUNICIPIUL SIBIU",1,143450,1,1,939,503,469,34,487,16,1030,527,390,97,
34,"SIBIU",323,143450,,56,0,"STR.SPARTACUS NR.47","MUNICIPIUL SIBIU",1,143450,1,1,1653,900,829,71,875,25,1800,900,568,307,
34,"SIBIU",323,143450,,57,0,"STR.SPARTACUS NR.47","MUNICIPIUL SIBIU",1,143450,1,1,1612,822,770,52,801,21,1800,978,623,178,
34,"SIBIU",323,143450,,58,0,"STR.VASILE AARON NR.26","MUNICIPIUL SIBIU",1,143450,1,1,1655,793,723,70,782,11,1800,1007,524,258,
34,"SIBIU",323,143450,,59,0,"STR.VASILE AARON NR.18","MUNICIPIUL SIBIU",1,143450,1,1,1539,886,691,195,874,12,1700,814,430,444,
34,"SIBIU",323,143450,,60,0,"STR.VASILE AARON NR.18","MUNICIPIUL SIBIU",1,143450,1,1,2151,1001,937,64,978,23,2370,1369,584,394,
34,"SIBIU",323,143450,,61,0,"STR.SUREANU NR.1","MUNICIPIUL SIBIU",1,143450,1,1,2440,1206,1045,161,1189,17,2700,1494,510,679,
34,"SIBIU",323,143450,,62,0,"STR.SUREANU NR.1","MUNICIPIUL SIBIU",1,143450,1,1,2180,1202,1129,73,1177,25,1900,698,731,446,
34,"SIBIU",323,143450,,63,0,"STR.SUREANU NR.1","MUNICIPIUL SIBIU",1,143450,1,1,2199,1063,1001,62,1037,26,2400,1337,514,523,
34,"SIBIU",323,143450,,64,0,"STR.NEGOVEANU NR.9","MUNICIPIUL SIBIU",1,143450,1,1,2028,1027,939,88,1007,20,2236,1209,577,430,
34,"SIBIU",323,143450,,65,0,"STR.SOIMULUI NR.13","MUNICIPIUL SIBIU",1,143450,1,1,1949,907,852,55,884,23,2148,1241,528,356,
34,"SIBIU",323,143450,,66,0,"STR.SOIMULUI NR.13","MUNICIPIUL SIBIU",1,143450,1,1,2238,1035,966,69,1013,22,2450,1415,566,447,
34,"SIBIU",323,143450,,67,0,"STR.ARTILERISTILOR NR.4","MUNICIPIUL SIBIU",1,143450,1,1,1860,950,868,82,927,23,2050,1100,666,261,
34,"SIBIU",323,143450,,68,0,"STR.LUPTEI NR.27","MUNICIPIUL SIBIU",1,143450,1,1,1618,860,781,79,851,9,1800,940,586,265,
34,"SIBIU",323,143450,,69,0,"STR.LUPTEI NR.27","MUNICIPIUL SIBIU",1,143450,1,1,1626,917,826,91,904,13,1800,883,652,252,
34,"SIBIU",323,143450,,70,0,"STR.LUPTEI NR.27","MUNICIPIUL SIBIU",1,143450,1,1,1190,597,534,63,581,16,1300,703,394,187,
34,"SIBIU",323,143450,,71,0,"STR.NICOLAE IORGA NR.56","MUNICIPIUL SIBIU",1,143450,1,1,1865,975,895,80,963,12,2050,1075,634,329,
34,"SIBIU",323,143450,,72,0,"STR.NICOLAE IORGA NR.56","MUNICIPIUL SIBIU",1,143450,1,1,1860,897,816,81,877,20,2050,1153,562,315,
34,"SIBIU",323,143450,,73,0,"STR.OSTIRII NR.5","MUNICIPIUL SIBIU",1,143450,1,1,1592,812,762,50,798,14,1750,938,535,263,
34,"SIBIU",323,143450,,74,0,"STR.OSTIRII NR.5","MUNICIPIUL SIBIU",1,143450,1,1,1392,749,684,65,735,14,1540,791,459,276,
34,"SIBIU",323,143450,,75,0,"STR.OSTIRII NR.5","MUNICIPIUL SIBIU",1,143450,1,1,2009,989,917,72,955,34,2200,1211,581,374,
34,"SIBIU",323,143450,,76,0,"ALLEA HAIDUCULUI NR.8","MUNICIPIUL SIBIU",1,143450,1,1,1579,823,743,80,799,24,1700,877,523,276,
34,"SIBIU",323,143450,,77,0,"ALLEA TURNU ROSU NR.2","MUNICIPIUL SIBIU",1,143450,1,1,1278,682,596,86,667,15,1400,718,425,242,
34,"SIBIU",323,143450,,78,0,"ALLEA TURNU ROSU NR.2","MUNICIPIUL SIBIU",1,143450,1,1,2012,1025,955,70,994,31,2200,1175,698,296,
34,"SIBIU",323,143450,,79,0,"STR.NICOLAE IORGA NR.62","MUNICIPIUL SIBIU",1,143450,1,1,2046,1134,1049,85,1109,25,2250,1116,804,305,
34,"SIBIU",323,143450,,80,0,"ALLEA STREIU GRADINITA NR.43","MUNICIPIUL SIBIU",1,143450,1,1,1559,697,638,59,673,24,1700,1003,355,318,
34,"SIBIU",323,143450,,81,0,"STR.SIRETULUI NR.5","MUNICIPIUL SIBIU",1,143450,1,1,1643,897,835,62,824,11,1800,965,536,288,
34,"SIBIU",323,143450,,82,0,"CALEA DUMBRAVII NR.135","MUNICIPIUL SIBIU",1,143450,1,1,2091,981,939,42,965,16,2300,1319,563,402,
34,"SIBIU",323,143450,,83,0,"STR.VICTOR PAPILIAN NR.16","MUNICIPIUL SIBIU",1,143450,1,1,1870,834,771,63,817,17,2050,1216,461,356,
34,"SIBIU",323,143450,,84,0,"STATIUNEA PALTINIS VILA NR.18","MUNICIPIUL SIBIU",1,143450,1,1,28,92,14,78,90,2,200,108,42,48,
34,"SIBIU",323,143450,,85,1,"STR.STEFAN CEL MARE NR.1 (UM.01512)","MUNICIPIUL SIBIU",1,143450,1,1,0,704,0,704,676,28,800,96,256,420,
34,"SIBIU",323,143450,,86,1,"STR.AVRIG NR.3 (UM.01473)","MUNICIPIUL SIBIU",1,143450,1,1,0,180,0,180,178,2,300,120,94,84,
34,"SIBIU",323,143450,,87,1,"STR.GENERAL VASILE MILEA NR.3 (UM.01606)","MUNICIPIUL SIBIU",1,143450,1,1,0,255,0,255,250,5,400,145,108,142,
34,"SIBIU",323,143450,,88,1,"SOS.ALBA IULIA NR.73 (UM.01813)","MUNICIPIUL SIBIU",1,143450,1,1,0,86,0,86,82,4,202,116,46,36,
34,"SIBIU",323,143450,,89,1,"CALEA POPLACII NR.85 (UM.0815)","MUNICIPIUL SIBIU",1,143450,1,1,0,571,0,571,546,25,700,129,308,238,
34,"SIBIU",323,143450,,90,1,"B-DUL VICTORIEI NR.31 (UNIVERSITATE)","MUNICIPIUL SIBIU",1,143450,1,1,0,409,0,409,395,14,1500,1091,276,119,
34,"SIBIU",323,143450,,91,1,"PIATA 1 DECEMBRIE 1918 NR.6 (GARA)","MUNICIPIUL SIBIU",1,143450,1,1,0,612,0,612,596,16,700,88,296,300,
34,"SIBIU",323,143450,,92,1,"B-DUL CORNELIU COPOSU NR.2-4 (SPITALUL CLINIC JUDETEAN)","MUNICIPIUL SIBIU",1,143450,1,1,0,559,0,559,547,12,798,239,307,240,
34,"SIBIU",323,143450,,93,1,"ALEEA FILOZOFILOR NR.3 (SPITALUL PNEUMOFTIZIOLOGIE)","MUNICIPIUL SIBIU",1,143450,1,1,0,84,0,84,83,1,150,66,42,41,
34,"SIBIU",323,143450,,94,1,"STR.DOCTOR BAGDAZAR NR.10 (SPITALUL DE NEUROPSIHIATRIE)","MUNICIPIUL SIBIU",1,143450,1,1,0,117,0,117,115,2,200,83,56,59,
34,"SIBIU",323,143619,,95,0,"STR.REGELE FERDINAND NR.23","MUNICIPIUL MEDIAS",2,143619,1,1,996,493,446,47,481,12,1100,607,346,135,
34,"SIBIU",323,143619,,96,0,"STR.CARPATI NR.9","MUNICIPIUL MEDIAS",2,143619,1,1,1242,687,627,60,669,18,1370,683,444,225,
34,"SIBIU",323,143619,,97,0,"STR. MIHAI VITEAZU NR.48","MUNICIPIUL MEDIAS",2,143619,1,1,1271,580,546,34,563,17,1380,800,412,151,
34,"SIBIU",323,143619,,98,0,"STR.DUPA ZID NR.11","MUNICIPIUL MEDIAS",2,143619,1,1,1410,713,690,23,699,14,1550,837,482,217,
34,"SIBIU",323,143619,,99,0,"STR.STADIONULUI NR.85","MUNICIPIUL MEDIAS",2,143619,1,1,777,417,381,36,409,8,850,433,293,116,
34,"SIBIU",323,143619,,100,0,"STR.STADIONULUI NR.55","MUNICIPIUL MEDIAS",2,143619,1,1,933,468,446,22,463,5,1020,552,299,164,
34,"SIBIU",323,143619,,101,0,"STR.NUCULUI NR.7","MUNICIPIUL MEDIAS",2,143619,1,1,1147,572,540,32,559,13,1260,688,312,247,
34,"SIBIU",323,143619,,102,0,"STR.PISCULUI NR.8","MUNICIPIUL MEDIAS",2,143619,1,1,955,458,397,61,446,12,1050,592,278,168,
34,"SIBIU",323,143619,,103,0,"STR.CLUJ NR.2","MUNICIPIUL MEDIAS",2,143619,1,1,1247,616,587,29,611,5,1370,754,392,219,
34,"SIBIU",323,143619,,104,0,"STR.PISCULUI NR.8","MUNICIPIUL MEDIAS",2,143619,1,1,1162,521,495,26,513,8,1280,759,338,175,
34,"SIBIU",323,143619,,105,0,"STR.1 DECEMBRIE NR.42","MUNICIPIUL MEDIAS",2,143619,1,1,1074,466,433,33,457,9,1180,714,287,170,
34,"SIBIU",323,143619,,106,0,"STR.1 DECEMBRIE NR.34","MUNICIPIUL MEDIAS",2,143619,1,1,1096,492,469,23,483,9,1200,708,328,155,
34,"SIBIU",323,143619,,107,0,"STR.1 DECEMBRIE NR.34","MUNICIPIUL MEDIAS",2,143619,1,1,1136,559,525,34,548,11,1250,691,331,217,
34,"SIBIU",323,143619,,108,0,"STR.CLUJ NR.12","MUNICIPIUL MEDIAS",2,143619,1,1,980,488,457,31,482,6,1080,592,326,156,
34,"SIBIU",323,143619,,109,0,"STR.1 DECEMBRIE NR.26","MUNICIPIUL MEDIAS",2,143619,1,1,871,472,444,28,467,5,897,425,377,90,
34,"SIBIU",323,143619,,110,0,"STR.1 DECEMBRIE NR.23","MUNICIPIUL MEDIAS",2,143619,1,1,1203,651,609,42,634,17,1300,649,447,187,
34,"SIBIU",323,143619,,111,0,"STR.1 DECEMBRIE NR.23","MUNICIPIUL MEDIAS",2,143619,1,1,1231,648,588,60,628,20,1365,717,397,231,
34,"SIBIU",323,143619,,112,0,"STR.1 DECEMBRIE NR.14","MUNICIPIUL MEDIAS",2,143619,1,1,1309,652,603,49,639,13,1340,688,389,250,
34,"SIBIU",323,143619,,113,0,"STR.I.C.BRATIANU NR.22-26","MUNICIPIUL MEDIAS",2,143619,1,1,1239,712,606,106,696,16,1400,688,449,247,
34,"SIBIU",323,143619,,114,0,"STR.ST.L.ROTH NR.21","MUNICIPIUL MEDIAS",2,143619,1,1,1111,575,526,49,556,19,1222,647,360,196,
34,"SIBIU",323,143619,,115,0,"STR.ANDREI SAGUNA NR.9","MUNICIPIUL MEDIAS",2,143619,1,1,808,426,400,26,414,12,900,474,269,145,
34,"SIBIU",323,143619,,116,0,"STR.GEORGE TOPIRCEANU NR.8","MUNICIPIUL MEDIAS",2,143619,1,1,824,409,374,35,405,4,901,492,289,116,
34,"SIBIU",323,143619,,117,0,"STR.DEALUL FURCILOR NR.7","MUNICIPIUL MEDIAS",2,143619,1,1,1029,563,518,45,550,13,1130,567,375,175,
34,"SIBIU",323,143619,,118,0,"STR.AUREL VLAICU NR.35","MUNICIPIUL MEDIAS",2,143619,1,1,926,520,429,91,508,12,1020,500,286,222,
34,"SIBIU",323,143619,,119,0,"STR.GEORGE COSBUC NR.29","MUNICIPIUL MEDIAS",2,143619,1,1,958,547,490,57,536,11,1050,503,350,186,
34,"SIBIU",323,143619,,120,0,"STR.STEJARULUI NR.1","MUNICIPIUL MEDIAS",2,143619,1,1,1132,635,591,44,618,17,1250,615,402,216,
34,"SIBIU",323,143619,,121,0,"STR.ANTON PANN NR.2A","MUNICIPIUL MEDIAS",2,143619,1,1,1386,741,716,25,724,17,1420,679,447,277,
34,"SIBIU",323,143619,,122,0,"STR.AVRAM IANCU NR.42","MUNICIPIUL MEDIAS",2,143619,1,1,1031,496,457,39,489,7,1132,636,250,239,
34,"SIBIU",323,143619,,123,0,"STR.AVRAM IANCU NR.42","MUNICIPIUL MEDIAS",2,143619,1,1,1449,800,763,37,770,30,1600,800,491,279,
34,"SIBIU",323,143619,,124,0,"STR.METANULUI NR.1","MUNICIPIUL MEDIAS",2,143619,1,1,1647,872,817,55,853,19,1800,928,510,343,
34,"SIBIU",323,143619,,125,0,"STR.AVRAM IANCU NR.12","MUNICIPIUL MEDIAS",2,143619,1,1,1103,579,548,31,569,10,1200,621,383,186,
34,"SIBIU",323,143619,,126,0,"STR.SIBIULUI NR.12","MUNICIPIUL MEDIAS",2,143619,1,1,979,542,502,40,525,17,1092,550,368,157,
34,"SIBIU",323,143619,,127,0,"STR.SIBIULUI NR.38","MUNICIPIUL MEDIAS",2,143619,1,1,913,486,413,73,481,5,1000,514,292,189,
34,"SIBIU",323,143619,,128,0,"STR.STICLEI NR.11","MUNICIPIUL MEDIAS",2,143619,1,1,722,379,356,23,368,11,800,421,259,109,
34,"SIBIU",323,143619,,129,0,"STR.STICLEI NR.9","MUNICIPIUL MEDIAS",2,143619,1,1,953,522,453,69,513,9,1050,528,311,202,
34,"SIBIU",323,143619,,130,0,"STR.RUBINULUI NR.3","MUNICIPIUL MEDIAS",2,143619,1,1,1210,535,505,30,525,10,1330,795,298,227,
34,"SIBIU",323,143619,,131,0,"STR.ILARIE CHENDI NR.1","MUNICIPIUL MEDIAS",2,143619,1,1,1930,848,811,37,832,16,2120,1272,414,418,
34,"SIBIU",323,143619,,132,0,"STR.SEBES NR.3","MUNICIPIUL MEDIAS",2,143619,1,1,1189,520,495,25,508,12,1300,780,259,249,
34,"SIBIU",323,143619,,133,0,"STR.SEBES NR.3","MUNICIPIUL MEDIAS",2,143619,1,1,1452,663,635,28,650,13,1600,937,335,315,
34,"SIBIU",323,143619,,134,0,"STR.SIBIULUI NR.67","MUNICIPIUL MEDIAS",2,143619,1,1,1594,673,616,57,661,12,1750,1077,320,341,
34,"SIBIU",323,143619,,135,0,"STR.CALAFAT NR.8","MUNICIPIUL MEDIAS",2,143619,1,1,1104,538,482,56,527,11,1200,662,279,248,
34,"SIBIU",323,143619,,136,0,"STR.BLAJULUI NR.9","MUNICIPIUL MEDIAS",2,143619,1,1,1244,560,537,23,543,17,1370,810,300,243,
34,"SIBIU",323,143619,,137,0,"STR.BLAJULUI NR.13","MUNICIPIUL MEDIAS",2,143619,1,1,1469,693,652,41,680,13,1600,907,318,362,
34,"SIBIU",323,143619,,138,0,"STR.SEBES NR.3","MUNICIPIUL MEDIAS",2,143619,1,1,1203,507,498,9,503,4,1280,773,268,235,
34,"SIBIU",323,143619,,139,0,"IGHISUL NOU SC.GENERALA","MUNICIPIUL MEDIAS",2,143619,1,1,1015,656,520,136,644,12,1130,474,198,446,
34,"SIBIU",323,143619,,140,1,"STR.MIHAI VITEAZU NR.12 (CASA ARMATEI)","MUNICIPIUL MEDIAS",2,143619,1,1,0,367,0,367,348,19,500,133,132,216,
34,"SIBIU",323,143619,,141,1,"STR.I.G.DUCA NR.34 (SPITALUL MUNICIPAL)","MUNICIPIUL MEDIAS",2,143619,1,1,0,238,0,238,232,6,705,467,138,94,
34,"SIBIU",323,143619,,142,1,"STR.UNIRII NR.2 (GARA)","MUNICIPIUL MEDIAS",2,143619,1,1,0,153,0,153,152,1,500,347,82,70,
34,"SIBIU",323,143682,,143,0,"STR.MIHAI VITEAZU NR.83","ORAS AGNITA",3,143682,2,1,1248,461,404,57,453,8,1370,909,203,250,
34,"SIBIU",323,143682,,144,0,"STR.FABRICII NR.44","ORAS AGNITA",3,143682,2,1,1111,493,445,48,484,9,1250,757,218,266,
34,"SIBIU",323,143682,,145,0,"STR.MIHAI VITEAZU NR.16","ORAS AGNITA",3,143682,2,1,1479,648,579,69,643,5,1570,922,336,307,
34,"SIBIU",323,143682,,146,0,"STR.NOUA NR.16","ORAS AGNITA",3,143682,2,1,1154,550,486,64,534,16,1270,720,270,264,
34,"SIBIU",323,143682,,147,0,"STR.SCOLII NR.2","ORAS AGNITA",3,143682,2,1,987,443,388,55,438,5,1100,657,233,205,
34,"SIBIU",323,143682,,148,0,"STR.AVRAM IANCU NR.31","ORAS AGNITA",3,143682,2,1,1276,556,493,63,545,11,1400,844,277,268,
34,"SIBIU",323,143682,,149,0,"STR.HORIA NR.38","ORAS AGNITA",3,143682,2,1,1163,616,533,83,608,8,1280,664,300,308,
34,"SIBIU",323,143682,,150,0,"SAT COVES SCOALA GENERALA","ORAS AGNITA",3,143682,2,1,516,418,320,98,403,15,560,142,194,209,
34,"SIBIU",323,143682,,151,0,"SAT RUJA SCOALA GENERALA","ORAS AGNITA",3,143682,2,1,786,436,356,80,435,1,900,464,130,305,
34,"SIBIU",323,144054,,152,0,"STR.GHEORGHE LAZAR NR.37","ORAS AVRIG",4,144054,2,1,1344,782,565,217,778,4,1550,768,360,418,
34,"SIBIU",323,144054,,153,0,"STR.GHEORGHE LAZAR NR.10","ORAS AVRIG",4,144054,2,1,1180,657,598,59,653,4,1300,643,328,325,
34,"SIBIU",323,144054,,154,0,"STR.SAMUEL BRUKANTHAL NR.41","ORAS AVRIG",4,144054,2,1,1092,518,487,31,508,10,1200,682,235,273,
34,"SIBIU",323,144054,,155,0,"GRADINITA NR.2 STICLA","ORAS AVRIG",4,144054,2,1,1735,867,789,78,849,18,1900,1033,329,520,
34,"SIBIU",323,144054,,156,0,"STR.HOREA NR.15","ORAS AVRIG",4,144054,2,1,1790,818,767,51,803,15,1850,1032,300,503,
34,"SIBIU",323,144054,,157,0,"SAT MARSA SCOALA GENERALA","ORAS AVRIG",4,144054,2,1,1080,706,525,181,694,12,1200,494,285,409,
34,"SIBIU",323,144054,,158,0,"SAT MARSA GRUPUL SCOLAR","ORAS AVRIG",4,144054,2,1,1068,523,474,49,518,5,1150,627,247,271,
34,"SIBIU",323,144054,,159,1,"SAT MARSA UNITATEA MILITARA","ORAS AVRIG",4,144054,2,1,0,105,0,105,103,2,200,95,48,55,
34,"SIBIU",323,144054,,160,0,"SAT BRADU SCOALA GENERALA","ORAS AVRIG",4,144054,2,1,828,459,378,81,458,1,900,441,138,320,
34,"SIBIU",323,144054,,161,0,"SAT SACADATE SCOALA GENERALA","ORAS AVRIG",4,144054,2,1,500,328,269,59,324,4,550,222,143,181,
34,"SIBIU",323,144054,,162,0,"SAT GLAMBOACA SCOALA GENERALA","ORAS AVRIG",4,144054,2,1,188,136,108,28,136,0,200,64,45,91,
34,"SIBIU",323,143735,,163,0,"SAT CISNADIOARA SCOALA GENERALA","ORAS CISNADIE",5,143735,2,1,442,127,94,33,126,1,500,373,60,66,
34,"SIBIU",323,143735,,164,0,"STR.MAGURII NR.99","ORAS CISNADIE",5,143735,2,1,1515,731,703,28,722,9,1650,919,329,393,
34,"SIBIU",323,143735,,165,0,"STR. MAGURII NR.93","ORAS CISNADIE",5,143735,2,1,1441,663,645,18,650,13,1600,937,309,341,
34,"SIBIU",323,143735,,166,0,"STR.STEJARULUI GRADINITA NR.6","ORAS CISNADIE",5,143735,2,1,1351,812,771,41,702,10,1500,788,326,376,
34,"SIBIU",323,143735,,167,0,"STR. MAGURII NR.63","ORAS CISNADIE",5,143735,2,1,1283,694,636,58,674,20,1400,706,355,319,
34,"SIBIU",323,143735,,168,0,"STR.MAGURII NR.5","ORAS CISNADIE",5,143735,2,1,1594,815,765,50,805,10,1700,885,400,405,
34,"SIBIU",323,143735,,169,0,"STR.UNIRII NR.6","ORAS CISNADIE",5,143735,2,1,1192,593,566,27,582,11,1300,707,307,275,
34,"SIBIU",323,143735,,170,0,"STR.TESATORILOR NR.47","ORAS CISNADIE",5,143735,2,1,1353,707,668,39,696,11,1500,793,348,348,
34,"SIBIU",323,143735,,171,0,"STR.TARGULUI NR.14","ORAS CISNADIE",5,143735,2,1,1647,935,793,142,912,23,1800,865,415,497,
34,"SIBIU",323,143735,,172,0,"STR.SELIMBARULUI NR.1","ORAS CISNADIE",5,143735,2,1,1766,968,897,71,952,16,1950,982,435,517,
34,"SIBIU",323,143771,,173,0,"SOS.MEDIASULUI NR.121","ORAS COPSA MICA",6,143771,2,1,1321,675,544,131,660,15,1450,775,433,227,
34,"SIBIU",323,143771,,174,0,"ALEEA CASTANILOR NR.8","ORAS COPSA MICA",6,143771,2,1,1147,555,452,103,548,7,1260,705,304,244,
34,"SIBIU",323,143771,,175,0,"SOS.SIBIULUI NR.62","ORAS COPSA MICA",6,143771,2,1,1494,738,578,160,730,8,1690,952,335,395,
34,"SIBIU",323,143806,,176,0,"STR.MIHAAI EMINESCU NR.6","ORAS DUMBRAVENI",7,143806,2,1,1341,534,493,41,532,2,1470,936,296,236,
34,"SIBIU",323,143806,,177,0,"STR.AVRAM IANCU NR.23","ORAS DUMBRAVENI",7,143806,2,1,1059,504,441,63,498,6,1150,646,319,179,
34,"SIBIU",323,143806,,178,0,"PIATA TIMOTEI CIPARIU NR.9","ORAS DUMBRAVENI",7,143806,2,1,1237,575,535,40,559,16,1350,775,349,210,
34,"SIBIU",323,143806,,179,0,"STR.TUDOR VLADIMIRESCU NR.32","ORAS DUMBRAVENI",7,143806,2,1,1203,433,395,38,428,5,1300,867,256,172,
34,"SIBIU",323,143806,,180,0,"BD.MIHAI EMINESCU NR.54","ORAS DUMBRAVENI",7,143806,2,1,234,184,97,87,146,38,250,66,79,67,
34,"SIBIU",323,143806,,181,0,"SAT ERNEA NR.56","ORAS DUMBRAVENI",7,143806,2,1,360,227,189,38,219,8,400,173,108,111,
34,"SIBIU",323,143806,,182,0,"SAT SAROSU PE TARNAVE NR.371","ORAS DUMBRAVENI",7,143806,2,1,1147,655,567,88,642,13,1380,725,308,334,
34,"SIBIU",323,143851,,183,0,"PIATA TRAIAN NR.15","ORAS OCNA SIBIULUI",8,143851,2,1,859,453,402,51,449,4,950,497,181,268,
34,"SIBIU",323,143851,,184,0,"PIATA TRAIAN NR.15","ORAS OCNA SIBIULUI",8,143851,2,1,934,447,447,0,439,8,1050,603,228,211,
34,"SIBIU",323,143851,,185,0,"STR.MIHAI VITEAZU NR.82","ORAS OCNA SIBIULUI",8,143851,2,1,1408,719,657,62,702,17,1550,831,264,438,
34,"SIBIU",323,143851,,186,0,"SAT TOPARCEA NR.55","ORAS OCNA SIBIULUI",8,143851,2,1,138,116,74,42,114,2,150,34,24,90,
34,"SIBIU",323,145827,,187,0,"STR.NICOLAE BALCESCU NR.24","ORAS TALMACIU",9,145827,2,1,981,451,397,54,444,7,1100,649,185,259,
34,"SIBIU",323,145827,,188,0,"STR.NICOLAE BALCESCU SC.GENERALA NR.1","ORAS TALMACIU",9,145827,2,1,1000,552,491,61,534,18,1100,548,255,279,
34,"SIBIU",323,145827,,189,0,"PIATA TEXTILISTILOR","ORAS TALMACIU",9,145827,2,1,1385,782,703,79,773,9,1600,818,400,373,
34,"SIBIU",323,145827,,190,0,"STR.MIHAI EMINESCU SC.GENERALA NR.2","ORAS TALMACIU",9,145827,2,1,1171,577,497,80,554,23,1300,723,276,278,
34,"SIBIU",323,145827,,191,0,"SAT BOITA CAMINUL CULTURAL","ORAS TALMACIU",9,145827,2,1,1268,717,662,55,711,6,1400,683,122,589,
34,"SIBIU",323,145827,,192,0,"SAT TALMACEL SCOALA GENERALA","ORAS TALMACIU",9,145827,2,1,1029,532,477,55,528,4,1100,568,156,372,
34,"SIBIU",323,143888,,193,0,"SAT ALTANA NR.94","ALTINA",10,143888,0,3,963,561,481,80,549,12,1100,539,296,253,
34,"SIBIU",323,143888,,194,0,"SAT BENESTI NR.43","ALTINA",10,143888,0,3,177,121,85,36,119,2,200,79,65,54,
34,"SIBIU",323,143888,,195,0,"SAT GHIJASA DE SUS NR.77","ALTINA",10,143888,0,3,171,159,110,49,159,0,200,41,97,62,
34,"SIBIU",323,143922,,196,0,"SAT APOLDU DE JOS NR.189","APOLDU DE JOS",11,143922,0,3,920,605,516,89,598,7,1000,395,217,381,
34,"SIBIU",323,143922,,197,0,"SAT SANGATIN NR.123","APOLDU DE JOS",11,143922,0,3,252,199,166,33,196,3,300,101,103,93,
34,"SIBIU",323,143959,,198,0,"ARPASU DE JOS NR.214","ARPASU DE JOS",12,143959,0,3,875,471,386,85,466,5,948,477,254,212,
34,"SIBIU",323,143959,,199,0,"SAT ARPASU DE SUS NR.13","ARPASU DE JOS",12,143959,0,3,895,543,447,96,542,1,1000,457,270,272,
34,"SIBIU",323,143959,,200,0,"SAT NOU ROMAN NR.199","ARPASU DE JOS",12,143959,0,3,313,264,211,53,260,4,350,86,185,75,
34,"SIBIU",323,143995,,201,0,"SAT ATEL NR.92","ATEL",13,143995,0,3,971,505,418,87,498,7,1100,595,165,333,
34,"SIBIU",323,143995,,202,0,"SAT DUPUS NR.104","ATEL",13,143995,0,3,157,133,80,53,131,2,160,27,48,83,
34,"SIBIU",323,143995,,203,0,"SAT ALMA NR.127","ATEL",13,143995,0,3,639,461,394,67,457,4,700,239,219,238,
34,"SIBIU",323,143995,,204,0,"SAT GEACAS NR.76","ATEL",13,143995,0,3,219,162,136,26,162,0,240,78,58,104,
34,"SIBIU",323,143995,,205,0,"SAT SMIG NR.238A","ATEL",13,143995,0,3,731,495,437,58,489,6,800,305,234,255,
34,"SIBIU",323,144116,,206,0,"SAT AXENTE SEVER CAMINUL CULTURAL","AXENTE SEVER",14,144116,0,3,1867,894,793,101,877,17,2050,1156,480,397,
34,"SIBIU",323,144116,,207,0,"SAT AGARBICIU CAMINUL CULTURAL","AXENTE SEVER",14,144116,0,3,1049,525,415,110,520,5,1150,625,217,303,
34,"SIBIU",323,144116,,208,0,"SAT SOALA CAMINUL CULTURAL","AXENTE SEVER",14,144116,0,3,249,156,115,41,152,4,300,144,49,103,
34,"SIBIU",323,144152,,209,0,"SAT BAZNA NR.500","BAZNA",15,144152,0,3,1278,928,781,147,916,12,1400,472,704,212,
34,"SIBIU",323,144152,,210,0,"SAT BOIAN SCOALA GENERALA","BAZNA",15,144152,0,3,1168,776,679,97,768,8,1300,524,218,550,
34,"SIBIU",323,144152,,211,0,"SAT VELT CAMINUL CULTURAL","BAZNA",15,144152,0,3,465,273,222,51,264,9,600,327,159,105,
34,"SIBIU",323,144198,,212,0,"SAT BIERTAN STR.1 DECEMBRIE NR.19","BIERTAN",16,144198,0,3,1129,631,538,93,615,16,1250,619,290,325,
34,"SIBIU",323,144198,,213,0,"SAT COPSA MARE NR.135","BIERTAN",16,144198,0,3,347,261,193,68,253,8,400,139,87,166,
34,"SIBIU",323,144198,,214,0,"SAT RICHIS NR.3","BIERTAN",16,144198,0,3,565,322,237,85,315,7,650,328,163,152,
34,"SIBIU",323,144232,,215,0,"SAT BARGHIS NR.202","BIRGHIS",17,144232,0,3,610,429,346,83,427,2,700,271,214,213,
34,"SIBIU",323,144232,,216,0,"SAT APOS NR.137","BIRGHIS",17,144232,0,3,154,114,74,40,113,1,180,66,34,79,
34,"SIBIU",323,144232,,217,0,"SAT PELISOR NR.158","BIRGHIS",17,144232,0,3,341,190,145,45,188,2,380,190,128,60,
34,"SIBIU",323,144232,,218,0,"SAT ZLAGNA NR.89","BIRGHIS",17,144232,0,3,118,120,73,47,120,0,131,11,71,49,
34,"SIBIU",323,144232,,219,0,"SAT IGHISU VECHI NR.39","BIRGHIS",17,144232,0,3,264,182,140,42,179,3,280,98,82,97,
34,"SIBIU",323,144232,,220,0,"SAT VECERD NR.125","BIRGHIS",17,144232,0,3,110,103,82,21,103,0,130,27,71,32,
34,"SIBIU",323,144303,,221,0,"SAT BLAJEL NR.77","BLAJEL",18,144303,0,3,1541,827,807,20,806,21,1700,873,397,409,
34,"SIBIU",323,144303,,222,0,"SAT PAUCEA NR.176","BLAJEL",18,144303,0,3,367,251,208,43,245,6,397,146,138,107,
34,"SIBIU",323,144349,,223,0,"SAT BRATEIU NR.31","BRATEIU",20,144349,0,3,1439,820,728,92,800,20,1650,830,404,396,
34,"SIBIU",323,144349,,224,0,"SAT BUZD NR.35","BRATEIU",20,144349,0,3,579,369,259,110,363,6,650,281,169,194,
34,"SIBIU",323,144376,,225,0,"SAT BRADENI NR.31","BRADENI",19,144376,0,3,550,425,356,69,423,2,600,175,247,176,
34,"SIBIU",323,144376,,226,0,"SAT RETIS NR.234","BRADENI",19,144376,0,3,486,367,310,57,364,3,550,183,247,117,
34,"SIBIU",323,144376,,227,0,"SAT TELINE NR.142","BRADENI",19,144376,0,3,122,110,78,32,110,0,150,40,56,54,
34,"SIBIU",323,144410,,228,0,"SAT BRUIU NR.19","BRUIU",21,144410,0,3,702,310,231,79,307,3,800,490,165,142,
34,"SIBIU",323,144456,,229,0,"SAT CHIRPAR NR.447","CHIRPAR",24,144456,0,3,784,320,246,74,320,0,900,580,196,124,
34,"SIBIU",323,144456,,230,0,"SAT SASAUS NR.137","CHIRPAR",24,144456,0,3,117,145,98,47,143,2,150,5,71,72,
34,"SIBIU",323,144456,,231,0,"SAT VARD NR.28","CHIRPAR",24,144456,0,3,190,172,96,76,169,3,200,28,89,80,
34,"SIBIU",323,144456,,232,0,"SAT VESEUD SCOALA GENERALA","CHIRPAR",24,144456,0,3,118,56,33,23,56,0,150,94,25,31,
34,"SIBIU",323,144508,,233,0,"SAT CARTA NR.104","CARTA",22,144508,0,3,884,440,360,80,428,12,1000,560,268,160,
34,"SIBIU",323,144535,,234,0,"SAT CARTISOARA NR.55","CARTISOARA",23,144535,0,3,910,604,513,91,593,11,1097,493,274,319,
34,"SIBIU",323,143487,,235,0,"STR.I NR.1","CRISTIAN",25,143487,0,3,1280,782,668,114,774,8,1500,718,387,387,
34,"SIBIU",323,143487,,236,0,"STR.XI NR.30","CRISTIAN",25,143487,0,3,946,505,448,57,485,20,1200,695,229,256,
34,"SIBIU",323,144553,,237,0,"SAT DARLOS CAMINUL CULTURAL","DARLOS",26,144553,0,3,1911,1073,969,104,1054,19,2100,1027,658,396,
34,"SIBIU",323,144553,,238,0,"SAT CURCIU NR.168","DARLOS",26,144553,0,3,619,325,288,37,323,2,700,375,151,172,
34,"SIBIU",323,144599,,239,0,"SAT GURA RAULUI NR.70","GURA RAULUI",27,144599,0,3,1472,738,674,64,733,5,1600,862,202,531,
34,"SIBIU",323,144599,,240,0,"SAT GURA RAULUI NR.538","GURA RAULUI",27,144599,0,3,1293,741,667,74,723,18,1400,659,223,500,
34,"SIBIU",323,144615,,241,0,"SAT HOGHILAG NR.305","HOGHILAG",28,144615,0,3,737,401,345,56,394,7,800,399,204,190,
34,"SIBIU",323,144615,,242,0,"SAT PROD NR.111","HOGHILAG",28,144615,0,3,242,177,151,26,175,2,300,123,66,109,
34,"SIBIU",323,144615,,243,0,"SAT VALCHID NR.229","HOGHILAG",28,144615,0,3,429,309,229,80,305,4,500,191,148,157,
34,"SIBIU",323,144651,,244,0,"SAT IACOBENI NR.57","IACOBENI",29,144651,0,3,594,342,307,35,333,9,650,308,111,222,
34,"SIBIU",323,144651,,245,0,"SAT STEJERIS NR.72","IACOBENI",29,144651,0,3,373,224,196,28,220,4,400,176,74,146,
34,"SIBIU",323,144651,,246,0,"SAT NETUS NR.52","IACOBENI",29,144651,0,3,308,202,160,42,201,1,350,148,114,87,
34,"SIBIU",323,144651,,247,0,"SAT NOISTAT NR.171","IACOBENI",29,144651,0,3,371,210,164,46,206,4,400,190,54,152,
34,"SIBIU",323,144651,,248,0,"SAT MOVILE NR.75","IACOBENI",29,144651,0,3,260,154,132,22,152,2,300,146,86,66,
34,"SIBIU",323,144713,,249,0,"NR.1210","JINA",30,144713,0,3,1318,424,393,31,402,22,1500,1076,151,251,
34,"SIBIU",323,144713,,250,0,"NR.1019","JINA",30,144713,0,3,1473,622,583,39,608,14,1600,978,133,475,
34,"SIBIU",323,144731,,251,0,"SAT LASLEA CLUBUL IAS","LASLEA",31,144731,0,3,835,489,391,98,483,6,1002,513,269,214,
34,"SIBIU",323,144731,,252,0,"ROANDOLA SCOALA GENERALA","LASLEA",31,144731,0,3,88,80,50,30,79,1,202,122,41,38,
34,"SIBIU",323,144731,,253,0,"SAT NOU SASESC SCOALA VECHE","LASLEA",31,144731,0,3,260,178,149,29,174,4,652,474,137,37,
34,"SIBIU",323,144731,,254,0,"SAT MALINCRAV FOSTA PRIMARIE","LASLEA",31,144731,0,3,631,424,362,62,423,1,902,478,122,301,
34,"SIBIU",323,144731,,255,0,"SAT FLORESTI SCOALA GENERALA","LASLEA",31,144731,0,3,91,64,47,17,64,0,152,88,21,43,
34,"SIBIU",323,144795,,256,0,"SAT LOAMNES NR.202","LOAMNES",32,144795,0,3,800,485,442,43,483,2,900,415,266,217,
34,"SIBIU",323,144795,,257,0,"SAT ALAMOR CAMINUL CULTURAL","LOAMNES",32,144795,0,3,739,434,383,51,426,8,800,366,212,214,
34,"SIBIU",323,144795,,258,0,"SAT ARMENI SCOALA GENERALA","LOAMNES",32,144795,0,3,572,269,237,32,263,6,650,381,91,172,
34,"SIBIU",323,144795,,259,0,"SAT HASAG CAMINUL CULTURAL","LOAMNES",32,144795,0,3,428,327,237,90,322,5,450,123,168,154,
34,"SIBIU",323,144866,,260,0,"SAT LUDOS NR.73","LUDOS",33,144866,0,3,721,487,417,70,477,10,800,313,259,218,
34,"SIBIU",323,144893,,261,0,"NR.327","MARPOD",34,144893,0,3,543,422,295,127,410,12,600,178,230,180,
34,"SIBIU",323,144964,,262,0,"SAT MERGHINDEAL NR.60","MERGHINDEAL",35,144964,0,3,586,345,274,71,345,0,700,355,155,190,
34,"SIBIU",323,144964,,263,0,"SAT DEALU FRUMOS SCOALA GENERALA","MERGHINDEAL",35,144964,0,3,432,239,172,67,237,2,500,261,138,99,
34,"SIBIU",323,144991,,264,0,"SAT MICASASA PRIMARIE","MICASASA",36,144991,0,3,1180,573,513,60,563,10,1350,777,277,286,
34,"SIBIU",323,144991,,265,0,"SAT TAPU SCOALA GENERALA","MICASASA",36,144991,0,3,603,352,283,69,349,3,700,348,150,199,
34,"SIBIU",323,144991,,266,0,"SAT CHESLER SCOALA GENERALA","MICASASA",36,144991,0,3,139,87,69,18,81,6,150,63,63,18,
34,"SIBIU",323,144928,,267,0,"SAT MIERCUREA NR.214","MIERCUREA SIBIULUI",37,144928,0,3,1585,1041,918,123,1003,38,1750,709,571,432,
34,"SIBIU",323,144928,,268,0,"SAT APOLDU DE SUS NR.169","MIERCUREA SIBIULUI",37,144928,0,3,1346,760,684,76,742,18,1500,740,562,180,
34,"SIBIU",323,144928,,269,0,"SAT DOBARCA NR.61","MIERCUREA SIBIULUI",37,144928,0,3,539,322,292,30,320,2,550,228,252,68,
34,"SIBIU",323,145042,,270,0,"SAT MIHAILENI PRIMARIA","MIHAILENI",38,145042,0,3,428,187,152,35,185,2,500,313,73,112,
34,"SIBIU",323,145042,,271,0,"SAT METIS SCOALA GENERALA","MIHAILENI",38,145042,0,3,252,159,98,61,157,2,300,141,94,63,
34,"SIBIU",323,145104,,272,0,"SAT MOSNA NR.452","MOSNA",39,145104,0,3,1524,795,690,105,790,5,1700,905,315,475,
34,"SIBIU",323,145104,,273,0,"SAT NEMSA NR.123","MOSNA",39,145104,0,3,391,240,210,30,236,4,400,160,77,159,
34,"SIBIU",323,145104,,274,0,"SAT ALMA VII NR.121","MOSNA",39,145104,0,3,266,210,169,41,205,5,300,90,91,114,
34,"SIBIU",323,145140,,275,0,"SAT NOCRICH NR.206","NOCRICH",40,145140,0,3,906,484,425,59,480,4,1000,516,180,300,
34,"SIBIU",323,145140,,276,0,"SAT HOSMAN NR.328","NOCRICH",40,145140,0,3,530,280,223,57,275,5,600,320,93,182,
34,"SIBIU",323,145140,,277,0,"SAT FOFELDEA NR.189","NOCRICH",40,145140,0,3,220,171,108,63,167,4,250,79,84,83,
34,"SIBIU",323,145140,,278,0,"SAT GHIJASA DE JOS NR.68","NOCRICH",40,145140,0,3,90,79,49,30,78,1,100,21,35,43,
34,"SIBIU",323,145140,,279,0,"SAT TICHINDEAL NR.130","NOCRICH",40,145140,0,3,108,90,58,32,85,5,150,60,40,45,
34,"SIBIU",323,145202,,280,0,"NR.634","ORLAT",41,145202,0,3,1382,697,645,52,683,14,1600,903,226,457,
34,"SIBIU",323,145202,,281,0,"NR.634","ORLAT",41,145202,0,3,998,521,484,37,516,5,1100,579,119,397,
34,"SIBIU",323,145220,,282,0,"SAT PAUCA PRIMARIE","PAUCA",42,145220,0,3,744,374,345,29,371,3,900,526,183,188,
34,"SIBIU",323,145220,,283,0,"SAT BOGATU ROMAN SCOALA GENERALA","PAUCA",42,145220,0,3,594,352,323,29,344,8,650,298,116,228,
34,"SIBIU",323,145220,,284,0,"SAT BROSTENI CAMINUL CULTURAL","PAUCA",42,145220,0,3,334,250,220,30,221,29,350,100,151,70,
34,"SIBIU",323,145220,,285,0,"SAT PRESACA SCOALA GENERALA","PAUCA",42,145220,0,3,454,227,203,24,224,3,500,273,126,98,
34,"SIBIU",323,145275,,286,0,"SCOALA GENERALA","POIANA SIBIULUI",43,145275,0,3,1894,499,420,79,492,7,2100,1601,330,162,
34,"SIBIU",323,143502,,287,0,"NR.376","POPLACA",44,143502,0,3,1221,585,498,87,572,13,1400,815,246,326,
34,"SIBIU",323,145293,,288,0,"SAT PORUMBACU DE JOS NR.254","PORUMBACU DE JOS",45,145293,0,3,879,508,507,1,500,8,1000,492,218,282,
34,"SIBIU",323,145293,,289,0,"SAT PORUMBACU DE SUS NR.373","PORUMBACU DE JOS",45,145293,0,3,647,484,343,141,480,4,700,216,223,257,
34,"SIBIU",323,145293,,290,0,"SAT SCOREIU CAMINUL CULTURAL","PORUMBACU DE JOS",45,145293,0,3,494,367,283,84,362,5,540,173,132,230,
34,"SIBIU",323,145293,,291,0,"SAT SARATA SCOALA GENERALA","PORUMBACU DE JOS",45,145293,0,3,299,247,188,59,244,3,310,63,56,188,
34,"SIBIU",323,145293,,292,0,"SAT COLUN SCOALA GENERALA","PORUMBACU DE JOS",45,145293,0,3,144,104,68,36,102,2,150,46,57,45,
34,"SIBIU",323,145355,,293,0,"SAT RACOVITA NR.90","RACOVITA",46,145355,0,3,1711,916,830,86,904,12,1900,984,408,496,
34,"SIBIU",323,145355,,294,0,"SAT SEBESU DE SUS NR.264","RACOVITA",46,145355,0,3,595,383,335,48,374,9,700,317,168,206,
34,"SIBIU",323,143520,,295,0,"NR.537","RASINARI",47,143520,0,3,1435,553,473,80,546,7,1600,1047,181,365,
34,"SIBIU",323,143520,,296,0,"NR.1512","RASINARI",47,143520,0,3,1310,603,477,126,595,8,1400,797,188,407,
34,"SIBIU",323,143520,,297,0,"NR.1527","RASINARI",47,143520,0,3,1426,570,487,83,563,7,1600,1030,179,384,
34,"SIBIU",323,145382,,298,0,"NR.248","RAU SADULUI",48,145382,0,3,545,265,224,41,262,3,600,335,76,186,
34,"SIBIU",323,145408,,299,0,"SAT ROSIA NR.22","ROSIA",49,145408,0,3,871,498,406,92,487,11,950,452,189,298,
34,"SIBIU",323,145408,,300,0,"SAT NOU NR.6","ROSIA",49,145408,0,3,1041,604,540,64,593,11,1150,546,335,258,
34,"SIBIU",323,145408,,301,0,"SAT DAIA NR.177","ROSIA",49,145408,0,3,528,320,258,62,319,1,600,280,139,180,
34,"SIBIU",323,145408,,302,0,"SAT CASOLT NR.50","ROSIA",49,145408,0,3,444,256,204,52,253,3,490,234,107,146,
34,"SIBIU",323,145408,,303,0,"SAT CORNATEL NR.44","ROSIA",49,145408,0,3,298,217,154,63,212,5,310,93,89,123,
34,"SIBIU",323,145408,,304,0,"SAT NUCET NR.102","ROSIA",49,145408,0,3,64,69,37,32,67,2,100,31,35,32,
34,"SIBIU",323,145471,,305,0,"NR.512","SADU",50,145471,0,3,1901,985,926,59,975,10,2100,1115,340,635,
34,"SIBIU",323,145499,,306,0,"SAT SALISTE NR.1235","SALISTE",51,145499,0,3,834,494,418,76,487,7,1150,656,229,258,
34,"SIBIU",323,145499,,307,0,"SAT SALISTE NR.1235","SALISTE",51,145499,0,3,995,496,392,104,486,10,1100,604,224,262,
34,"SIBIU",323,145499,,308,0,"SAT GALES NR.247","SALISTE",51,145499,0,3,251,170,141,29,168,2,300,130,68,100,
34,"SIBIU",323,145499,,309,0,"SAT VALE NR.90","SALISTE",51,145499,0,3,294,205,152,53,204,1,310,105,96,108,
34,"SIBIU",323,145499,,310,0,"SAT SIBIEL NR.300","SALISTE",51,145499,0,3,316,189,146,43,185,4,340,151,66,119,
34,"SIBIU",323,145499,,311,0,"SAT FANTANELE NR.28","SALISTE",51,145499,0,3,241,160,133,27,157,3,300,140,57,100,
34,"SIBIU",323,145499,,312,0,"SAT SACEL NR.222","SALISTE",51,145499,0,3,383,217,190,27,215,2,400,183,78,137,
34,"SIBIU",323,145499,,313,0,"SAT MAG NR.160","SALISTE",51,145499,0,3,273,189,142,47,189,0,300,111,65,124,
34,"SIBIU",323,145499,,314,0,"SAT AMNAS NR.365","SALISTE",51,145499,0,3,280,197,126,71,194,3,300,103,90,104,
34,"SIBIU",323,145499,,315,0,"SAT ACILIU NR.45","SALISTE",51,145499,0,3,276,171,131,40,164,7,300,129,54,110,
34,"SIBIU",323,145603,,316,0,"SAT SLIMNIC NR.7","SLIMNIC",55,145603,0,3,928,346,282,64,338,8,1000,654,142,196,
34,"SIBIU",323,145603,,317,0,"SAT SLIMNIC NR.7","SLIMNIC",55,145603,0,3,1029,410,339,71,406,4,1150,740,138,268,
34,"SIBIU",323,145603,,318,0,"SAT RUSI NR.157","SLIMNIC",55,145603,0,3,628,369,288,81,364,5,700,331,161,203,
34,"SIBIU",323,145603,,319,0,"SAT VESEUD SCOALA GENERALA","SLIMNIC",55,145603,0,3,217,168,132,36,167,1,250,82,58,109,
34,"SIBIU",323,145667,,320,0,"SAT SEICA MARE NR.418","SEICA MARE",52,145667,0,3,1836,807,652,155,794,13,2050,1243,348,446,
34,"SIBIU",323,145667,,321,0,"SAT SEICA MARE NR.770","SEICA MARE",52,145667,0,3,830,456,323,133,453,3,930,474,152,301,
34,"SIBIU",323,145667,,322,0,"SAT BOARTA NR.34","SEICA MARE",52,145667,0,3,360,181,138,43,180,1,400,219,89,91,
34,"SIBIU",323,145667,,323,0,"SAT BUIA NR.120","SEICA MARE",52,145667,0,3,481,259,211,48,252,7,550,291,120,132,
34,"SIBIU",323,145667,,324,0,"SAT STENIA NR.38","SEICA MARE",52,145667,0,3,150,103,74,29,97,6,170,67,55,42,
34,"SIBIU",323,145667,,325,0,"SAT PETIS NR.20","SEICA MARE",52,145667,0,3,83,50,26,24,48,2,100,50,19,29,
34,"SIBIU",323,145738,,326,0,"SAT SEICA MICA NR.75","SEICA MICA",53,145738,0,3,954,449,388,61,443,6,1046,597,154,289,
34,"SIBIU",323,145738,,327,0,"SAT SOROSTIN NR.82","SEICA MICA",53,145738,0,3,485,325,284,41,323,2,550,225,250,73,
34,"SIBIU",323,143557,,328,0,"SAT SELIMBAR NR.226","SELIMBAR",54,143557,0,3,1464,712,588,124,703,9,1600,888,320,383,
34,"SIBIU",323,143557,,329,0,"SAT VESTEM NR.149","SELIMBAR",54,143557,0,3,1230,622,542,80,619,3,1400,778,267,352,
34,"SIBIU",323,143557,,330,0,"SAT MOHU NR.313","SELIMBAR",54,143557,0,3,506,312,273,39,303,9,550,238,147,156,
34,"SIBIU",323,143557,,331,0,"SAT BUNGARD NR.19","SELIMBAR",54,143557,0,3,388,255,200,55,251,4,450,195,171,80,
34,"SIBIU",323,145765,,332,0,"SAT SURA MARE NR.487","SURA MARE",56,145765,0,3,1679,739,618,121,726,13,1900,1161,272,454,
34,"SIBIU",323,145765,,333,0,"SAT HAMBA NR.53","SURA MARE",56,145765,0,3,436,266,191,75,262,4,500,234,76,186,
34,"SIBIU",323,145792,,334,0,"SAT SURA MICA NR.408","SURA MICA",57,145792,0,3,1246,639,549,90,637,2,1385,746,264,373,
34,"SIBIU",323,145792,,335,0,"SAT RUSCIORI NR.96","SURA MICA",57,145792,0,3,370,237,203,34,234,3,400,163,122,112,
34,"SIBIU",323,145907,,336,0,"SAT TILISCA NR.531","TILISCA",59,145907,0,3,921,419,381,38,415,4,1050,631,181,234,
34,"SIBIU",323,145907,,337,0,"SAT ROD NR.10","TILISCA",59,145907,0,3,384,231,208,23,228,3,450,219,90,138,
34,"SIBIU",323,143646,,338,0,"STR. MIHAI EMINESCU NR.2","TARNAVA",58,143646,0,3,1057,586,504,82,576,10,1200,614,307,269,
34,"SIBIU",323,143646,,339,0,"STR. 1 DECEMBRIE NR.1","TARNAVA",58,143646,0,3,954,570,499,71,564,6,1100,530,274,290,
34,"SIBIU",323,145934,,340,0,"SAT TURNU ROSU CAMINUL CULTURAL","TURNU ROSU",60,145934,0,3,1354,785,659,126,769,16,1550,765,370,399,
34,"SIBIU",323,145934,,341,0,"SAT SEBESU DE JOS CAMINUL CULTURAL","TURNU ROSU",60,145934,0,3,578,404,338,66,400,4,650,246,193,207,
34,"SIBIU",323,145961,,342,0,"SAT VALEA VIILOR NR.344","VALEA VIILOR",61,145961,0,3,1188,676,627,49,667,9,1350,674,284,383,
34,"SIBIU",323,145961,,343,0,"SAT MOTIS NR.181","VALEA VIILOR",61,145961,0,3,392,268,199,69,263,5,450,182,100,163,
34,"SIBIU",323,145998,,344,0,"NR.455","VURPAR",62,145998,0,3,1665,853,750,103,836,17,1900,1047,254,582,
35,"SUCEAVA",332,146263,,1,0,"Casa Culturii str. Stefan cel Mare nr.20A","MUNICIPIUL SUCEAVA",1,146263,1,1,1242,891,769,122,876,15,1400,509,671,205,
35,"SUCEAVA",332,146263,,2,0,"Localul Liceului de Arta (fosta Scoala generala nr.2) Corpul A   str. Petru Rare","MUNICIPIUL SUCEAVA",1,146263,1,1,1416,849,780,69,836,13,1500,651,604,232,
35,"SUCEAVA",332,146263,,3,0,"Localul Liceului de Arta Corpul  B str. Curtea Domneasca nr.58","MUNICIPIUL SUCEAVA",1,146263,1,1,1253,726,645,81,718,8,1398,672,544,174,
35,"SUCEAVA",332,146263,,4,0,"Localul Scolii Generale nr.1 str. Tudor Vladimirescu nr.5","MUNICIPIUL SUCEAVA",1,146263,1,1,1412,857,800,57,840,17,1500,643,671,169,
35,"SUCEAVA",332,146263,,5,0,"Localul Grupului Scolar Nr.4 str. Samoil Isopescu nr.19","MUNICIPIUL SUCEAVA",1,146263,1,1,1311,805,742,63,796,9,1400,595,595,201,
35,"SUCEAVA",332,146263,,6,0,"Localul Gradinitei nr.2 str. Alexandru cel Bun nr.31","MUNICIPIUL SUCEAVA",1,146263,1,1,1463,846,781,65,835,11,1600,754,652,183,
35,"SUCEAVA",332,146263,,7,0,"Localul FEDERAL COOP str. Mihai Viteazu nr.27","MUNICIPIUL SUCEAVA",1,146263,1,1,1205,815,767,48,810,5,1300,485,642,168,
35,"SUCEAVA",332,146263,,8,0,"Localul Colegiului  National ""Stefan cel Mare"" Sala A str. Vasile Alecsandri nr.","MUNICIPIUL SUCEAVA",1,146263,1,1,1120,759,699,60,750,9,1200,441,545,205,
35,"SUCEAVA",332,146263,,9,0,"Localul Liceului ""Petru Rares"" Sala  A str. Mihai Viteazu nr.29","MUNICIPIUL SUCEAVA",1,146263,1,1,1121,727,627,100,712,15,1200,473,512,200,
35,"SUCEAVA",332,146263,,10,0,"Localul Liceului ""Petru Rares"" Sala  B  str. Mihai Viteazu nr.29","MUNICIPIUL SUCEAVA",1,146263,1,1,1214,793,718,75,761,32,1300,507,564,197,
35,"SUCEAVA",332,146263,,11,0,"Localul Scolii Generale nr.3  Sala  A str. Marasesti nr.38","MUNICIPIUL SUCEAVA",1,146263,1,1,1307,792,655,137,776,16,1400,608,566,210,
35,"SUCEAVA",332,146263,,12,0,"Localul Scolii Generale nr.3 Sala  B str. Marasesti nr.38","MUNICIPIUL SUCEAVA",1,146263,1,1,1276,814,717,97,806,8,1400,586,624,182,
35,"SUCEAVA",332,146263,,13,0,"Localul Grupului Scolar Ec. Adm.""Dimitrie Cantemir""  Sala  A Aleea Prof. Leca Mo","MUNICIPIUL SUCEAVA",1,146263,1,1,1749,953,876,77,941,12,1900,947,661,280,
35,"SUCEAVA",332,146263,,14,0,"Localul Grupului Scolar Ec. Adm."" Dimitrie Cantemir"" Sala  B Aleea Prof. Leca Mo","MUNICIPIUL SUCEAVA",1,146263,1,1,1426,819,721,98,795,24,1600,781,574,221,
35,"SUCEAVA",332,146263,,15,0,"Localul Universitatii ""Stefan cel Mare"" str. Universitatii nr.13","MUNICIPIUL SUCEAVA",1,146263,1,1,1629,1429,829,600,1405,24,1799,370,900,505,
35,"SUCEAVA",332,146263,,16,0,"Localul Directiei Silvice Suceava Bd. 1 Mai nr.6","MUNICIPIUL SUCEAVA",1,146263,1,1,1828,1037,955,82,1020,17,2000,963,673,347,
35,"SUCEAVA",332,146263,,17,0,"Localul Liceului de Informatica ""Spiru Haret"" (fostul Liceu Sanitar) Sala  A str","MUNICIPIUL SUCEAVA",1,146263,1,1,1816,987,906,81,978,9,2000,1013,630,348,
35,"SUCEAVA",332,146263,,18,0,"Localul Scolii Generale nr.4  Sala  A str. Zorilor nr.10A","MUNICIPIUL SUCEAVA",1,146263,1,1,1909,1113,1023,90,1084,29,2100,987,697,387,
35,"SUCEAVA",332,146263,,19,0,"Localul Scolii Generale nr.4 Sala  B str. Zorilor nr.10A","MUNICIPIUL SUCEAVA",1,146263,1,1,1722,928,878,50,909,19,1900,972,640,269,
35,"SUCEAVA",332,146263,,20,0,"Localul Scolii Generale nr.9  Sala  A str. Dornelor","MUNICIPIUL SUCEAVA",1,146263,1,1,1329,713,648,65,705,8,1396,683,463,242,
35,"SUCEAVA",332,146263,,21,0,"Localul Liceului de Informatica ""Spiru Haret"" (fostul Liceu Sanitar ) Sala B str","MUNICIPIUL SUCEAVA",1,146263,1,1,1364,692,593,99,681,11,1500,808,438,243,
35,"SUCEAVA",332,146263,,22,0,"Localul S.C. ""ACET"" SA Sectia apa str. Slatioara nr.4A","MUNICIPIUL SUCEAVA",1,146263,1,1,1579,928,869,59,916,12,1700,772,600,316,
35,"SUCEAVA",332,146263,,23,0,"Localul Scolii Generale nr.9 (fostul Liceu de Informatica ) Sala  A str. Dornelo","MUNICIPIUL SUCEAVA",1,146263,1,1,1572,942,816,126,930,12,1700,758,606,324,
35,"SUCEAVA",332,146263,,24,0,"Localul Scolii Generale nr.9 (fostul Liceu de Informatica ) Sala B str. Dornelor","MUNICIPIUL SUCEAVA",1,146263,1,1,2005,1104,1029,75,1092,12,2200,1096,725,367,
35,"SUCEAVA",332,146263,,25,0,"Localul Scolii generale nr.9 Sala  Bstr. Dornelor","MUNICIPIUL SUCEAVA",1,146263,1,1,1421,756,666,90,747,9,1499,743,445,302,
35,"SUCEAVA",332,146263,,26,0,"Localul Gradinitei nr.1 Aleea Lalelelor f.n.","MUNICIPIUL SUCEAVA",1,146263,1,1,2115,1144,1071,73,1130,14,2300,1156,805,325,
35,"SUCEAVA",332,146263,,27,0,"Localul Scoii Generale nr.8  Sala  A  Aleea  Jupiter nr.12","MUNICIPIUL SUCEAVA",1,146263,1,1,1711,958,856,102,943,15,1800,842,639,304,
35,"SUCEAVA",332,146263,,28,0,"Localul Scolii Generale nr.8  Sala  B  Aleea  Jupiter nr.12","MUNICIPIUL SUCEAVA",1,146263,1,1,2038,1084,1027,57,1068,16,2200,1116,680,388,
35,"SUCEAVA",332,146263,,29,0,"Localul Gradinitei nr.5 Aleea. Jupiter f.n.","MUNICIPIUL SUCEAVA",1,146263,1,1,2129,1157,1108,49,1137,20,2300,1143,714,423,
35,"SUCEAVA",332,146263,,30,0,"Localul Scolii Generale nr.12  Sala  A Bd. George Enescu nr.26A","MUNICIPIUL SUCEAVA",1,146263,1,1,1786,908,860,48,899,9,1900,992,582,317,
35,"SUCEAVA",332,146263,,31,0,"Localul Scolii generale nr.12  Sala  B Bd. George Enescu nr.26A","MUNICIPIUL SUCEAVA",1,146263,1,1,1735,968,924,44,956,12,1900,932,636,320,
35,"SUCEAVA",332,146263,,32,0,"Localul Grupului Scolar Alimentar  Sala  A str. Dimitrie Cantemir nr.5","MUNICIPIUL SUCEAVA",1,146263,1,1,1315,812,728,84,798,14,1400,588,536,262,
35,"SUCEAVA",332,146263,,33,0,"Localul Grupului Scolar Alimentar  Sala  B str. Dimitrie Cantemir nr.5","MUNICIPIUL SUCEAVA",1,146263,1,1,2022,1108,1046,62,1092,16,2200,1092,680,412,
35,"SUCEAVA",332,146263,,34,0,"Localul Colegiului National ""Mihai Eminescu"" (fostul Liceu Pedagogic) str. Maras","MUNICIPIUL SUCEAVA",1,146263,1,1,1728,1048,952,96,1024,24,1900,852,644,380,
35,"SUCEAVA",332,146263,,35,0,"Localul S.C. ""Castor"" SA str. Grigore Ureche nr.19","MUNICIPIUL SUCEAVA",1,146263,1,1,2176,1326,1226,100,1305,21,2300,974,801,504,
35,"SUCEAVA",332,146263,,36,0,"Localul Colegiului National ""Stefan cel Mare""  Sala   B str. Vasile Alecsandri n","MUNICIPIUL SUCEAVA",1,146263,1,1,2120,1135,1033,102,1111,24,2302,1167,760,351,
35,"SUCEAVA",332,146263,,37,0,"Localul Grupului Scolar nr.2 Calea Unirii nr.15","MUNICIPIUL SUCEAVA",1,146263,1,1,1373,777,661,116,771,6,1500,723,462,309,
35,"SUCEAVA",332,146263,,38,0,"Localul Oficiului Postal Itcani str. Garii nr.7","MUNICIPIUL SUCEAVA",1,146263,1,1,1611,1093,896,197,1085,8,1700,607,714,371,
35,"SUCEAVA",332,146263,,39,0,"Localul Scolii Generale nr.7 str. E. Bucevschi nr.7","MUNICIPIUL SUCEAVA",1,146263,1,1,1700,1014,918,96,999,15,1800,786,645,354,
35,"SUCEAVA",332,146263,,40,0,"Localul  S.C. ""ELCO  ""S.A.( fost Santier CM RENEL)  str. 22 Decembrie nr.1","MUNICIPIUL SUCEAVA",1,146263,1,1,1364,733,680,53,724,9,1500,767,429,295,
35,"SUCEAVA",332,146263,,41,0,"Localul Atelier Zona CFR str. Nicolae Iorga nr.9","MUNICIPIUL SUCEAVA",1,146263,1,1,2831,1699,1406,293,1677,22,3100,1401,959,718,
35,"SUCEAVA",332,146263,,42,0,"Localul Scolii Generale nr.10   Sala  A  str. Baladei  nr.6","MUNICIPIUL SUCEAVA",1,146263,1,1,1643,967,901,66,954,13,1800,833,556,398,
35,"SUCEAVA",332,146263,,43,0,"Localul Scolii Generale nr.10  Sala  B  str. Baladei nr.6","MUNICIPIUL SUCEAVA",1,146263,1,1,1474,792,758,34,781,11,1600,808,518,263,
35,"SUCEAVA",332,146263,,44,0,"Localul Gradinitei de Copii str. Baladei nr.8","MUNICIPIUL SUCEAVA",1,146263,1,1,1591,832,794,38,814,18,1701,869,455,359,
35,"SUCEAVA",332,146263,,45,0,"Localul Grupului Scolar nr.1 Sala   A Calea Unirii nr. 49","MUNICIPIUL SUCEAVA",1,146263,1,1,1595,903,826,77,895,8,1700,797,519,376,
35,"SUCEAVA",332,146263,,46,0,"Localul Scolii Generale nr.11  Sala  A str. Pacii nr.8","MUNICIPIUL SUCEAVA",1,146263,1,1,1697,973,934,39,961,12,1800,827,550,411,
35,"SUCEAVA",332,146263,,47,0,"Localul Grupului Scolar nr.1 Sala  B Calea Unirii nr.49","MUNICIPIUL SUCEAVA",1,146263,1,1,1623,806,768,38,796,10,1800,994,435,361,
35,"SUCEAVA",332,146263,,48,0,"Localul Scolii generale nr.11  Sala B str. Pacii nr.8","MUNICIPIUL SUCEAVA",1,146263,1,1,1434,767,709,58,756,11,1500,733,438,318,
35,"SUCEAVA",332,146263,,49,0,"Localul Scolii Generale nr.11  Sala  C str. Pacii nr.8","MUNICIPIUL SUCEAVA",1,146263,1,1,1733,1010,906,104,999,11,1900,890,565,434,
35,"SUCEAVA",332,146263,,50,0,"Localul Gradinitei de copii  str. Tineretului nr.6A","MUNICIPIUL SUCEAVA",1,146263,1,1,2043,1149,1063,86,1128,21,2200,1051,686,442,
35,"SUCEAVA",332,146263,,51,0,"Localul Scolii Generale nr.5 Calea Unirii nr.53","MUNICIPIUL SUCEAVA",1,146263,1,1,1725,934,856,78,927,7,1797,862,548,379,
35,"SUCEAVA",332,146263,,52,0,"Localul Scolii Profesionale nr.5 Calea Unirii nr.82","MUNICIPIUL SUCEAVA",1,146263,1,1,1840,1075,1006,69,1071,4,2000,925,618,453,
35,"SUCEAVA",332,146263,,53,0,"Localul Scolii Generale nr.5. Anexa str. Gh. Doja nr.237A","MUNICIPIUL SUCEAVA",1,146263,1,1,1520,966,898,68,940,26,1601,635,553,387,
35,"SUCEAVA",332,146263,,54,0,"Localul Scolii Generale nr.6 str. 22 Decembrie nr.189","MUNICIPIUL SUCEAVA",1,146263,1,1,1112,665,635,30,656,9,1200,535,374,282,
35,"SUCEAVA",332,146263,,55,0,"Localul Scolii generale nr.6 str. Crangului nr.1A","MUNICIPIUL SUCEAVA",1,146263,1,1,1522,845,792,53,828,17,1600,755,511,317,
35,"SUCEAVA",332,146263,,56,1,"Ministerul de Interne. Grupul de Pompieri al Judetului Suceava str. Universitati","MUNICIPIUL SUCEAVA",1,146263,1,1,0,232,0,232,225,7,500,268,166,59,
35,"SUCEAVA",332,146263,,57,1,"Spitalul Judetean Suceava Bd. 1 Mai nr.21","MUNICIPIUL SUCEAVA",1,146263,1,1,0,654,0,654,651,3,1300,646,414,237,
35,"SUCEAVA",332,146502,,58,0,"Scoala generala nr.1- Calea Transilvaniei nr.114","MUNICIPIUL CAMPULUNG MOLDOVENESC",2,146502,1,1,1410,910,852,58,897,13,1500,590,527,370,
35,"SUCEAVA",332,146502,,59,0,"Liceul de Constructii - Calea Transilvaniei nr.55","MUNICIPIUL CAMPULUNG MOLDOVENESC",2,146502,1,1,995,749,555,194,743,6,1100,351,495,248,
35,"SUCEAVA",332,146502,,60,0,"Circumscriptia Sanitar-Veterninara - str.Eudoxiu Hurmuzachi nr.8","MUNICIPIUL CAMPULUNG MOLDOVENESC",2,146502,1,1,1326,892,833,59,880,12,1400,508,538,342,
35,"SUCEAVA",332,146502,,61,0,"Scoala generala nr.4- Calea Transilvaniei nr.36","MUNICIPIUL CAMPULUNG MOLDOVENESC",2,146502,1,1,866,550,473,77,542,8,1000,450,352,190,
35,"SUCEAVA",332,146502,,62,0,"Liceul Dragos Voda - Str.Liceului nr.3","MUNICIPIUL CAMPULUNG MOLDOVENESC",2,146502,1,1,1437,844,772,72,835,9,1600,756,523,312,
35,"SUCEAVA",332,146502,,63,0,"Clubul Copiilor si Elevilor - str.22 Decembrie nr.3","MUNICIPIUL CAMPULUNG MOLDOVENESC",2,146502,1,1,1476,924,863,61,909,15,1600,676,588,321,
35,"SUCEAVA",332,146502,,64,0,"Scoala generala nr.3 Bogdan Voda - Calea Bucovinei nr.36","MUNICIPIUL CAMPULUNG MOLDOVENESC",2,146502,1,1,1621,1108,961,147,1087,21,1800,692,645,442,
35,"SUCEAVA",332,146502,,65,0,"Complexul ""Ioana"" (B.T.T.) - str.Pinului nr.37","MUNICIPIUL CAMPULUNG MOLDOVENESC",2,146502,1,1,665,417,392,25,412,5,694,277,253,159,
35,"SUCEAVA",332,146502,,66,0,"Liceul Silvic (localul nou) - Calea Bucovinei nr.56","MUNICIPIUL CAMPULUNG MOLDOVENESC",2,146502,1,1,2244,1178,1082,96,1163,15,2400,1222,641,522,
35,"SUCEAVA",332,146502,,67,0,"Liceul Silvic (localul vechi) - Calea Bucovinei nr.56","MUNICIPIUL CAMPULUNG MOLDOVENESC",2,146502,1,1,2228,1309,1259,50,1289,20,2400,1091,774,515,
35,"SUCEAVA",332,146502,,68,0,"S.C. Transport Auto ""Raraul"" S.A. - str. Dobrogeanu Gherea nr.19","MUNICIPIUL CAMPULUNG MOLDOVENESC",2,146502,1,1,1058,645,616,29,640,5,1200,555,417,223,
35,"SUCEAVA",332,146502,,69,0,"Scoala generala nr.2 - Calea Bucovinei nr.208","MUNICIPIUL CAMPULUNG MOLDOVENESC",2,146502,1,1,1003,678,628,50,671,7,1100,422,418,253,
35,"SUCEAVA",332,146502,,70,0,"Clubul C.F.R. - Calea Bucovinei nr.213","MUNICIPIUL CAMPULUNG MOLDOVENESC",2,146502,1,1,1046,699,652,47,693,6,1100,401,404,289,
35,"SUCEAVA",332,146502,,71,1,"Colegiul Liceal Militar ""Stefan cel Mare"" - str. Izvorul Malului nr.1","MUNICIPIUL CAMPULUNG MOLDOVENESC",2,146502,1,1,0,136,0,136,125,11,200,64,61,64,
35,"SUCEAVA",332,146539,,72,0,"Liceul Industrial nr.1 - str.N.Beldiceanu","MUNICIPIUL FALTICENI",3,146539,1,1,1388,834,760,74,825,9,1500,666,608,217,
35,"SUCEAVA",332,146539,,73,0,"Scoala generala nr.1 - str. Sucevei nr.78","MUNICIPIUL FALTICENI",3,146539,1,1,1465,900,851,49,893,7,1600,700,607,286,
35,"SUCEAVA",332,146539,,74,0,"Liceul ""Nicu Gane""- str. Sucevei nr.111","MUNICIPIUL FALTICENI",3,146539,1,1,1543,907,831,76,902,5,1700,793,622,280,
35,"SUCEAVA",332,146539,,75,0,"S.C.""GOSCOM""S.A.- str.13 Decembrie nr.13","MUNICIPIUL FALTICENI",3,146539,1,1,1536,873,821,52,871,2,1700,827,557,314,
35,"SUCEAVA",332,146539,,76,0,"Scoala generala nr.6 - str.13 Decembrie nr.19","MUNICIPIUL FALTICENI",3,146539,1,1,1311,807,685,122,802,5,1400,593,444,358,
35,"SUCEAVA",332,146539,,77,0,"Scoala generala nr.6 - str.13 Decembrie nr.19","MUNICIPIUL FALTICENI",3,146539,1,1,1604,975,900,75,970,5,1700,725,516,454,
35,"SUCEAVA",332,146539,,78,0,"Scoala generala nr.3 - str. Ana Ipatescu nr.115","MUNICIPIUL FALTICENI",3,146539,1,1,1924,1098,967,131,1089,9,2100,1002,669,420,
35,"SUCEAVA",332,146539,,79,0,"Scoala generala nr.3 - str. Ana Ipatescu nr.115","MUNICIPIUL FALTICENI",3,146539,1,1,1437,801,705,96,793,8,1600,799,499,294,
35,"SUCEAVA",332,146539,,80,0,"Scoala generala nr.2 - str. N.Beldiceanu nr.23","MUNICIPIUL FALTICENI",3,146539,1,1,2187,1220,1012,208,1209,11,2400,1180,791,418,
35,"SUCEAVA",332,146539,,81,0,"Scoala generala nr.3 - str. Ion Dragoslav nr.9","MUNICIPIUL FALTICENI",3,146539,1,1,1240,752,704,48,739,13,1600,848,490,249,
35,"SUCEAVA",332,146539,,82,0,"S.C.""FINTEX"" S.A.","MUNICIPIUL FALTICENI",3,146539,1,1,1532,821,650,171,811,10,1600,779,460,351,
35,"SUCEAVA",332,146539,,83,0,"Liceul  Agroindustrial - str. Maior Ioan nr.16","MUNICIPIUL FALTICENI",3,146539,1,1,1689,962,877,85,956,6,1800,838,579,377,
35,"SUCEAVA",332,146539,,84,0,"Liceul Agroindustrial - str. Maior Ioan nr.16","MUNICIPIUL FALTICENI",3,146539,1,1,1741,989,932,57,978,11,1900,911,729,249,
35,"SUCEAVA",332,146539,,85,0,"Scoala generala nr.5 - str. Ion Creanga nr.82","MUNICIPIUL FALTICENI",3,146539,1,1,1140,665,614,51,663,2,1200,535,435,228,
35,"SUCEAVA",332,146539,,86,0,"Scoala generala nr.4 - str. Armatei nr.20","MUNICIPIUL FALTICENI",3,146539,1,1,1289,888,766,122,880,8,1400,512,589,291,
35,"SUCEAVA",332,146539,,87,0,"Scoala Tarna Mare","MUNICIPIUL FALTICENI",3,146539,1,1,594,337,313,24,330,7,700,363,188,142,
35,"SUCEAVA",332,146539,,88,0,"S.C.""FALTIN""S.A.","MUNICIPIUL FALTICENI",3,146539,1,1,1775,968,853,115,961,7,1900,932,584,377,
35,"SUCEAVA",332,146539,,89,1,"U.M. Jandarmi, Compania Pompieri","MUNICIPIUL FALTICENI",3,146539,1,1,731,733,717,16,714,19,1100,367,498,216,
35,"SUCEAVA",332,146539,,90,1,"Spitalul  Municipal","MUNICIPIUL FALTICENI",3,146539,1,1,0,235,0,235,234,1,800,565,158,76,
35,"SUCEAVA",332,146628,,91,0,"Biblioteca municipiului Radauti - Piata Unirii","MUNICIPIUL RADAUTI",4,146628,1,1,2195,1160,1043,117,1133,27,2400,1240,756,377,
35,"SUCEAVA",332,146628,,92,0,"Casa de Cultura - str.Bogdan Voda nr.12","MUNICIPIUL RADAUTI",4,146628,1,1,1865,1034,971,63,994,40,2000,966,709,285,
35,"SUCEAVA",332,146628,,93,0,"Scoala generala ""Bogdan Voda"" - str.Eudoxiu Hurmuzachi","MUNICIPIUL RADAUTI",4,146628,1,1,1996,1143,1085,58,1123,20,2100,957,763,360,
35,"SUCEAVA",332,146628,,94,0,"Colegiul Eudoxiu Hurmuzachi-Calea Bucovinei nr.5","MUNICIPIUL RADAUTI",4,146628,1,1,2161,1011,953,58,997,14,2400,1389,658,339,
35,"SUCEAVA",332,146628,,95,0,"Scoala generala nr.3 - Str.Iancu Flondor nr.3","MUNICIPIUL RADAUTI",4,146628,1,1,2157,1110,1010,100,1086,24,2400,1290,738,348,
35,"SUCEAVA",332,146628,,96,0,"Circumscriptia medicala - Cresa Hipodroom - str.Mihai Viteazu f.n.","MUNICIPIUL RADAUTI",4,146628,1,1,2460,1183,1084,99,1167,16,2400,1217,787,380,
35,"SUCEAVA",332,146628,,97,0,"Grupul Scolar nr.1, str. Tudor Vladimirescu nr.4","MUNICIPIUL RADAUTI",4,146628,1,1,2314,1102,1039,63,1086,16,2600,1498,673,413,
35,"SUCEAVA",332,146628,,98,0,"Gradinita  ""Robu"" - str. Mihail Kogalniceanu nr. 25","MUNICIPIUL RADAUTI",4,146628,1,1,2128,991,927,64,969,22,2400,1409,617,352,
35,"SUCEAVA",332,146628,,99,0,"Scoala generala nr.4 - str.Stefan cel Mare nr.18","MUNICIPIUL RADAUTI",4,146628,1,1,2230,1203,1125,78,1177,26,2400,1197,759,418,
35,"SUCEAVA",332,146628,,100,0,"Scoala generala nr.2 - str.Horia nr.44","MUNICIPIUL RADAUTI",4,146628,1,1,2285,1158,1112,46,1138,20,2500,1342,732,406,
35,"SUCEAVA",332,146628,,101,0,"Scoala generala nr.1 - str.D.Gherea nr.12","MUNICIPIUL RADAUTI",4,146628,1,1,2246,1131,1098,33,1110,21,2400,1269,684,426,
35,"SUCEAVA",332,4,,102,1,"U.M.0594"," U.M.0925 Jandarmi","MUNICIPIUL RADAUTI",4,146628,1,1,142,404,130,274,401,3,600,196,271,130
35,"SUCEAVA",332,146744,,103,0,"Casa de Cultura - str.Garii nr.2","ORAS VATRA DORNEI",8,146744,2,1,1681,1281,984,297,1266,15,1798,517,770,496,
35,"SUCEAVA",332,146744,,104,0,"Hotelul ""Bradul"" - str.Republicii nr.5","ORAS VATRA DORNEI",8,146744,2,1,2005,1455,1051,404,1441,14,2200,745,942,499,
35,"SUCEAVA",332,146744,,105,0,"Scoala  generala nr.1 - str.Republicii nr.63","ORAS VATRA DORNEI",8,146744,2,1,1092,706,621,85,691,15,1200,494,474,217,
35,"SUCEAVA",332,146744,,106,0,"Clubul S.C.""Dorna""S.A. - Calea Transilvaniei nr.24","ORAS VATRA DORNEI",8,146744,2,1,1248,763,702,61,755,8,1400,637,415,340,
35,"SUCEAVA",332,146744,,107,0,"Scoala generala ""ROSU"" - str.Rosu nr.64","ORAS VATRA DORNEI",8,146744,2,1,531,443,390,53,440,3,600,157,249,191,
35,"SUCEAVA",332,146744,,108,0,"Scoala generala nr.2 - str.Unirii nr.52","ORAS VATRA DORNEI",8,146744,2,1,2439,1422,1312,110,1400,22,2600,1178,888,512,
35,"SUCEAVA",332,146744,,109,0,"Caminul de copii cu orar prelungit - str.Unirii nr.35","ORAS VATRA DORNEI",8,146744,2,1,1301,965,668,297,962,3,1400,435,626,336,
35,"SUCEAVA",332,146744,,110,0,"Clubul S.C.""Dorna Foresta""S.A.","ORAS VATRA DORNEI",8,146744,2,1,1032,624,575,49,620,4,1100,476,352,268,
35,"SUCEAVA",332,146744,,111,0,"Scoala generala nr.3 - str.Chiliei nr.13","ORAS VATRA DORNEI",8,146744,2,1,1947,1235,1036,199,1228,7,2100,865,688,540,
35,"SUCEAVA",332,146744,,112,0,"Complex C.F.R. - Gara Mare - str.Podu Verde nr.15","ORAS VATRA DORNEI",8,146744,2,1,926,652,490,162,645,7,1000,348,288,357,
35,"SUCEAVA",332,146744,,113,0,"Caminul Cultural Argestru","ORAS VATRA DORNEI",8,146744,2,1,553,371,340,31,367,4,600,229,161,206,
35,"SUCEAVA",332,146744,,114,1,"Casa Armatei - str.Republicii nr.15","ORAS VATRA DORNEI",8,146744,2,1,0,372,0,372,357,15,500,128,220,137,
35,"SUCEAVA",332,146584,,115,0,"Muzeul Obiceiurilor Populare - Gura Humorului","ORAS GURA HUMORULUI",5,146584,2,1,2491,1528,1395,133,1515,13,2700,1172,879,636,
35,"SUCEAVA",332,146584,,116,0,"Scoala generala clasele I-VIII nr.4","ORAS GURA HUMORULUI",5,146584,2,1,2059,1266,1198,68,1255,11,2200,934,789,466,
35,"SUCEAVA",332,146584,,117,0,"Scoala generala clasele I-VIII nr.1","ORAS GURA HUMORULUI",5,146584,2,1,1092,766,631,135,757,9,1200,434,460,297,
35,"SUCEAVA",332,146584,,118,0,"Scoala generala clasele I-VIII nr.2","ORAS GURA HUMORULUI",5,146584,2,1,2827,1622,1500,122,1606,16,3100,1478,1056,550,
35,"SUCEAVA",332,146584,,119,0,"Grupul Scolar Gura Humorului","ORAS GURA HUMORULUI",5,146584,2,1,2323,1298,1202,96,1282,16,2500,1202,704,578,
35,"SUCEAVA",332,146584,,120,0,"Centru de Plasament nr.4 (fosta Casa de Copii Scolari)","ORAS GURA HUMORULUI",5,146584,2,1,1698,1001,950,51,993,8,1800,799,665,328,
35,"SUCEAVA",332,146584,,121,0,"Caminul Cultural Voronet","ORAS GURA HUMORULUI",5,146584,2,1,611,467,419,48,455,12,700,233,221,234,
35,"SUCEAVA",332,146655,,122,0,"Casa de Cultura - str.Latcu Voda nr.2","ORAS SIRET",6,146655,2,1,1743,1032,942,90,1018,14,1898,866,625,393,
35,"SUCEAVA",332,146655,,123,0,"Liceul ""Latcu Voda"" Siret - str.Latcu Voda  nr.7","ORAS SIRET",6,146655,2,1,1544,904,837,67,888,16,1700,796,475,413,
35,"SUCEAVA",332,146655,,124,0,"Gradinita de copii cu orar prelungit - str.Mihai Teliman nr.16A","ORAS SIRET",6,146655,2,1,1874,997,951,46,991,6,2000,1003,517,474,
35,"SUCEAVA",332,146655,,125,0,"Muzeul Orasului Siret - str.9 Mai nr.17","ORAS SIRET",6,146655,2,1,1051,670,599,71,657,13,1200,530,369,288,
35,"SUCEAVA",332,146655,,126,0,"Scoala generala Padureni - str.Moldovei nr.18","ORAS SIRET",6,146655,2,1,419,303,277,26,297,6,500,197,209,88,
35,"SUCEAVA",332,146655,,127,0,"Scoala generala Manastioara - str.Livezilor nr.23","ORAS SIRET",6,146655,2,1,445,364,317,47,362,2,500,136,252,110,
35,"SUCEAVA",332,146708,,128,0,"Primaria Solca","ORAS SOLCA",7,146708,2,1,2025,1302,1198,104,1291,11,2200,898,814,477,
35,"SUCEAVA",332,146708,,129,0,"Caminul Cultural Poieni Solca","ORAS SOLCA",7,146708,2,1,1531,876,815,61,870,6,1700,824,687,183,
35,"SUCEAVA",332,146799,,130,0,"Scoala generala cu clasele I-VIII satul AdOncata","ADANCATA",9,146799,0,3,2336,1551,1472,79,1509,42,2500,949,966,543,
35,"SUCEAVA",332,146799,,131,0,"Scoala generala din satul Beresti","ADANCATA",9,146799,0,3,441,453,352,101,407,46,499,46,304,103,
35,"SUCEAVA",332,146799,,132,0,"Scoala generala  din satul Calugareni","ADANCATA",9,146799,0,3,504,428,354,74,425,3,600,172,267,158,
35,"SUCEAVA",332,146799,,133,0,"Scoala generala  din satul Fetesti","ADANCATA",9,146799,0,3,398,317,256,61,301,16,500,183,204,97,
35,"SUCEAVA",332,146799,,134,0,"Scoala generala din satul Hantesti","ADANCATA",9,146799,0,3,2314,1894,1715,179,1863,31,2500,606,1388,475,
35,"SUCEAVA",332,146860,,135,0,"Scoala generala nr.1 Arbore","ARBORE",10,146860,0,3,2412,1516,1313,203,1489,27,2600,1084,800,689,
35,"SUCEAVA",332,146860,,136,0,"Scoala Generala nr.2 Arbore","ARBORE",10,146860,0,3,2027,1073,999,74,1061,12,2200,1127,696,365,
35,"SUCEAVA",332,146860,,137,0,"Scoala generala din satul Clit","ARBORE",10,146860,0,3,928,689,614,75,678,11,1000,311,451,227,
35,"SUCEAVA",332,146904,,138,0,"Caminul Cultural Baia","BAIA",11,146904,0,3,2159,1402,1230,172,1388,14,2300,898,1035,353,
35,"SUCEAVA",332,146904,,139,0,"Gradinita nr.20 Baia","BAIA",11,146904,0,3,1805,1082,914,168,1065,17,2000,918,732,333,
35,"SUCEAVA",332,146904,,140,0,"Caminul Cultural Bogata","BAIA",11,146904,0,3,933,639,549,90,631,8,1000,361,486,145,
35,"SUCEAVA",332,146995,,141,0,"Primaria comunei Balcauti","BALCAUTI",12,146995,0,3,1487,834,758,76,819,15,1600,766,447,372,
35,"SUCEAVA",332,146995,,142,0,"Scoala generala clasele I-VIII Negostina","BALCAUTI",12,146995,0,3,1019,673,602,71,666,7,1100,427,435,231,
35,"SUCEAVA",332,147036,,143,0,"Consiliul local Bilca","BILCA",13,147036,0,3,1128,621,577,44,607,14,1195,574,443,164,
35,"SUCEAVA",332,147036,,144,0,"Scoala generala nr.2 Bilca","BILCA",13,147036,0,3,898,605,556,49,597,8,997,392,347,250,
35,"SUCEAVA",332,147036,,145,0,"Scoala generala nr.3 Bilca","BILCA",13,147036,0,3,667,486,432,54,482,4,798,312,361,121,
35,"SUCEAVA",332,147054,,146,0,"Scoala generala cu clasele I-VIII nr.1 Bogdanesti","BOGDANESTI",14,147054,0,3,1757,1049,923,126,1036,13,1900,851,658,378,
35,"SUCEAVA",332,147054,,147,0,"Scoala generala cu clasele I-VIII nr.2 Bogdanesti","BOGDANESTI",14,147054,0,3,1196,792,681,111,784,8,1300,508,464,320,
35,"SUCEAVA",332,147072,,148,0,"Caminul cultural Boroaia (cladirea noua)","BOROAIA",15,147072,0,3,1688,914,807,107,904,10,1800,886,643,261,
35,"SUCEAVA",332,147072,,149,0,"Caminul cultural din satul Giulesti","BOROAIA",15,147072,0,3,441,384,339,45,375,9,500,116,250,125,
35,"SUCEAVA",332,147072,,150,0,"Scoala generala din satul Barasti","BOROAIA",15,147072,0,3,700,446,384,62,440,6,800,354,322,118,
35,"SUCEAVA",332,147072,,151,0,"Caminul cultural  din satul Moisa","BOROAIA",15,147072,0,3,1053,745,667,78,739,6,1200,455,473,266,
35,"SUCEAVA",332,147134,,152,0,"Caminul Cultural Bosanci","BOSANCI",16,147134,0,3,2132,803,737,66,778,25,2300,1497,533,245,
35,"SUCEAVA",332,147134,,153,0,"Scoala Vale Bosanci","BOSANCI",16,147134,0,3,1078,548,451,97,536,12,1200,652,312,224,
35,"SUCEAVA",332,147134,,154,0,"Scoala Generala Bosanci Deal","BOSANCI",16,147134,0,3,1517,740,630,110,718,22,1600,860,375,343,
35,"SUCEAVA",332,147134,,155,0,"Scoala generala din satul Cumparatura","BOSANCI",16,147134,0,3,184,133,104,29,129,4,200,67,50,79,
35,"SUCEAVA",332,147161,,156,0,"Caminul cultural din Botosana","BOTOSANA",17,147161,0,3,2035,1347,1293,54,1336,11,2201,854,871,465,
35,"SUCEAVA",332,147161,,157,0,"Caminul cultural Comanesti","BOTOSANA",17,147161,0,3,1030,738,678,60,733,5,1099,361,461,272,
35,"SUCEAVA",332,147161,,158,0,"Caminul cultural Humoreni","BOTOSANA",17,147161,0,3,779,494,444,50,490,4,900,406,302,188,
35,"SUCEAVA",332,147205,,159,0,"Primaria comunei Breaza","BREAZA",18,147205,0,3,1423,866,789,77,854,12,1500,634,675,179,
35,"SUCEAVA",332,147241,,160,0,"Caminul cultural Brodina","BRODINA",19,147241,0,3,1164,663,565,98,647,16,1305,642,379,268,
35,"SUCEAVA",332,147241,,161,0,"Scoala generala din satul Brodina de Jos","BRODINA",19,147241,0,3,695,294,271,23,284,10,800,506,106,178,
35,"SUCEAVA",332,147241,,162,0,"Clubul satesc Falcau","BRODINA",19,147241,0,3,919,731,551,180,715,16,1003,272,432,283,
35,"SUCEAVA",332,147358,,163,0,"Caminul cultural Holda","BROSTENI",20,147358,0,3,1065,793,735,58,788,5,1200,407,407,381,
35,"SUCEAVA",332,147358,,164,0,"Primaria comunei Brosteni","BROSTENI",20,147358,0,3,1290,819,718,101,814,5,1400,581,518,296,
35,"SUCEAVA",332,147358,,165,0,"Scoala generala nr.1 Brosteni","BROSTENI",20,147358,0,3,1389,813,661,152,805,8,1500,687,514,291,
35,"SUCEAVA",332,147358,,166,0,"Caminul cultural Cotrgasi","BROSTENI",20,147358,0,3,1328,865,808,57,859,6,1400,535,423,436,
35,"SUCEAVA",332,147358,,167,0,"Scoala Drmoxa","BROSTENI",20,147358,0,3,119,121,81,40,121,0,200,79,90,31,
35,"SUCEAVA",332,147465,,168,0,"Primaria comunei Bunesti","BUNESTI",21,147465,0,3,844,524,481,43,518,6,900,376,381,137,
35,"SUCEAVA",332,147465,,169,0,"Scoala cu clasele I-VIII Petia","BUNESTI",21,147465,0,3,681,430,399,31,423,7,800,370,317,106,
35,"SUCEAVA",332,147465,,170,0,"Scoala cu clasele I-VIII Uncesti","BUNESTI",21,147465,0,3,578,369,332,37,364,5,700,331,229,135,
35,"SUCEAVA",332,147526,,171,0,"Primaria comunei Cacica","CACICA",22,147526,0,3,1460,978,906,72,954,24,1600,622,359,595,
35,"SUCEAVA",332,147526,,172,0,"Scoala generala Cacica","CACICA",22,147526,0,3,1085,689,640,49,681,8,1199,510,380,301,
35,"SUCEAVA",332,147526,,173,0,"Scoala generala Solonetul Nou","CACICA",22,147526,0,3,767,463,439,24,457,6,900,437,238,219,
35,"SUCEAVA",332,147633,,174,0,"Scoala generala ""Centru""","CAJVANA",23,147633,0,3,1916,737,712,25,733,4,2100,1363,367,366,
35,"SUCEAVA",332,147633,,175,0,"Scoala generala de lnga Racar","CAJVANA",23,147633,0,3,869,457,415,42,455,2,1000,543,297,158,
35,"SUCEAVA",332,147633,,176,0,"Scoala Generala cu clasele I- IV","CAJVANA",23,147633,0,3,2324,794,735,59,786,8,2500,1706,336,450,
35,"SUCEAVA",332,147580,,177,0,"Caminul cultural Calafindesti","CALAFINDESTI",24,147580,0,3,1880,1225,1192,33,1198,27,2000,775,758,440,
35,"SUCEAVA",332,147580,,178,0,"Scoala generala Botosenita","CALAFINDESTI",24,147580,0,3,279,241,195,46,239,2,300,59,170,69,
35,"SUCEAVA",332,147580,,179,0,"Caminul cultural Serbauti","CALAFINDESTI",24,147580,0,3,1495,1183,1115,68,1162,21,1600,417,709,453,
35,"SUCEAVA",332,147580,,180,0,"Caminul cultural Calinesti Arini","CALAFINDESTI",24,147580,0,3,849,584,534,50,574,10,900,316,400,174,
35,"SUCEAVA",332,147660,,181,0,"Primaria comunei Ciprian Porumbescu","CIPRIAN PORUMBESCU",26,147660,0,3,1700,1234,1089,145,1226,8,2100,866,758,468,
35,"SUCEAVA",332,147660,,182,0,"Caminul cultural Balaceana","CIPRIAN PORUMBESCU",26,147660,0,3,1288,781,702,79,768,13,1400,619,529,239,
35,"SUCEAVA",332,147660,,183,0,"Caminul cultural Ciprian Porumbescu","CIPRIAN PORUMBESCU",26,147660,0,3,1467,916,833,83,903,13,1600,684,577,326,
35,"SUCEAVA",332,147713,,184,0,"Primaria comunei COrlibaba","CARLIBABA",25,147713,0,3,1429,884,792,92,879,5,1604,720,479,400,
35,"SUCEAVA",332,147786,,185,0,"Scoala generala cu clasele I-VIII Cornu Luncii","CORNU LUNCII",27,147786,0,3,1365,741,660,81,731,10,1500,759,478,253,
35,"SUCEAVA",332,147786,,186,0,"Scoala generala  cu clasele I-VIII Baisesti","CORNU LUNCII",27,147786,0,3,1226,802,737,65,789,13,1300,498,454,335,
35,"SUCEAVA",332,147786,,187,0,"Scoala generala cu clasele I-VIII Braiesti","CORNU LUNCII",27,147786,0,3,944,657,565,92,653,4,1000,343,274,379,
35,"SUCEAVA",332,147786,,188,0,"Scoala generala cu clasele I-VIII Sasca Mica","CORNU LUNCII",27,147786,0,3,605,464,359,105,453,11,700,236,274,179,
35,"SUCEAVA",332,147786,,189,0,"Scoala generala cu clasele I-VIII Sasca Mare","CORNU LUNCII",27,147786,0,3,1218,756,671,85,739,17,1300,544,527,212,
35,"SUCEAVA",332,147884,,190,0,"Consiliul local Crucea","CRUCEA",28,147884,0,3,1209,828,729,99,826,2,1299,471,402,424,
35,"SUCEAVA",332,147884,,191,0,"Caminul cultural Chiril","CRUCEA",28,147884,0,3,418,359,296,63,356,3,500,141,202,154,
35,"SUCEAVA",332,147937,,192,0,"Scoala generala Darmanesti Centru","DARMANESTI",29,147937,0,3,1049,690,620,70,684,6,1100,410,409,275,
35,"SUCEAVA",332,147937,,193,0,"Scoala generala Darmanesti Chilibancina","DARMANESTI",29,147937,0,3,660,512,435,77,508,4,700,188,321,187,
35,"SUCEAVA",332,147937,,194,0,"Scoala generala Maritei","DARMANESTI",29,147937,0,3,1335,837,775,62,832,5,1500,663,525,307,
35,"SUCEAVA",332,147937,,195,0,"Scoala generala Calinesti - Enache","DARMANESTI",29,147937,0,3,656,430,343,87,425,5,700,270,304,121,
35,"SUCEAVA",332,147937,,196,0,"Scoala generala Danila","DARMANESTI",29,147937,0,3,780,537,471,66,530,7,900,363,316,214,
35,"SUCEAVA",332,148006,,197,0,"Liceul Dolhasca Vest","DOLHASCA",30,148006,0,3,1795,963,787,176,941,22,1900,937,552,389,
35,"SUCEAVA",332,148006,,198,0,"Scoala cu 10 clase Dolhasca Est","DOLHASCA",30,148006,0,3,1495,972,770,202,959,13,1600,628,616,343,
35,"SUCEAVA",332,148006,,199,0,"Scoala generala Poiana","DOLHASCA",30,148006,0,3,394,259,219,40,203,56,500,241,159,44,
35,"SUCEAVA",332,148006,,200,0,"Scoala generala Gulia","DOLHASCA",30,148006,0,3,1283,856,716,140,843,13,1400,544,666,177,
35,"SUCEAVA",332,148006,,201,0,"Scoala generala Probota","DOLHASCA",30,148006,0,3,1614,1110,942,168,1088,22,1700,590,807,281,
35,"SUCEAVA",332,148006,,202,0,"Scoala generala Budeni","DOLHASCA",30,148006,0,3,1094,716,626,90,701,15,1200,484,503,198,
35,"SUCEAVA",332,148006,,203,0,"Scoala generala Silistea Noua","DOLHASCA",30,148006,0,3,575,368,300,68,363,5,700,332,268,95,
35,"SUCEAVA",332,148097,,204,0,"Primaria Dolhesti","DOLHESTI",31,148097,0,3,1630,1100,979,121,1087,13,1800,700,724,363,
35,"SUCEAVA",332,148097,,205,0,"Scoala generala Dolhestii Mici","DOLHESTI",31,148097,0,3,1002,696,606,90,689,7,1100,404,442,247,
35,"SUCEAVA",332,148097,,206,0,"Scoala generala Valea Bourei","DOLHESTI",31,148097,0,3,635,474,405,69,467,7,700,226,349,118,
35,"SUCEAVA",332,148131,,207,0,"Caminul cultural din satul Cozanesti","DORNA-ARINI",33,148131,0,3,1776,1145,1019,126,1122,23,1500,355,571,551,
35,"SUCEAVA",332,148131,,208,0,"Scoala Rusca","DORNA-ARINI",33,148131,0,3,672,550,469,81,543,7,1200,650,284,259,
35,"SUCEAVA",332,148202,,209,0,"Caminul cultural Dorna Candrenilor","DORNA CANDRENILOR",32,148202,0,3,1608,976,850,126,965,11,1700,724,502,463,
35,"SUCEAVA",332,148202,,210,0,"Caminul cultural Cosna","DORNA CANDRENILOR",32,148202,0,3,1195,755,664,91,751,4,1300,545,412,339,
35,"SUCEAVA",332,148202,,211,0,"Scoala Poiana Negri cu clasele I-VIII","DORNA CANDRENILOR",32,148202,0,3,694,404,353,51,403,1,799,395,164,239,
35,"SUCEAVA",332,148293,,212,0,"Caminul Cultural Dornesti","DORNESTI",34,148293,0,3,1894,1062,941,121,1045,17,2000,938,594,451,
35,"SUCEAVA",332,148293,,213,0,"Scoala veche Dornesti","DORNESTI",34,148293,0,3,1398,739,659,80,730,9,1500,761,468,262,
35,"SUCEAVA",332,148328,,214,0,"Primaria comunei Dragoiesti","DRAGOIESTI",35,148328,0,3,750,703,639,64,700,3,800,97,456,244,
35,"SUCEAVA",332,148328,,215,0,"Caminul cultural Berchisesti","DRAGOIESTI",35,148328,0,3,1534,1055,911,144,1040,15,1700,645,525,515,
35,"SUCEAVA",332,148328,,216,0,"Caminul cultural Corlata","DRAGOIESTI",35,148328,0,3,392,307,260,47,303,4,500,193,202,101,
35,"SUCEAVA",332,148328,,217,0,"Caminul cultural Dragoiesti","DRAGOIESTI",35,148328,0,3,1476,874,791,83,863,11,1600,726,466,397,
35,"SUCEAVA",332,148382,,218,0,"Primaria comunei Draguseni","DRAGUSENI",36,148382,0,3,1814,1112,1022,90,1079,33,2000,888,706,373,
35,"SUCEAVA",332,148382,,219,0,"Scoala Brosteni","DRAGUSENI",36,148382,0,3,366,245,215,30,239,6,400,155,192,47,
35,"SUCEAVA",332,148426,,220,0,"Scoala generala din Centru","DUMBRAVENI",37,148426,0,3,2808,1368,995,373,1354,14,3000,1632,838,516,
35,"SUCEAVA",332,148426,,221,0,"Scoala Generala nr.1","DUMBRAVENI",37,148426,0,3,1575,846,533,313,834,12,1700,854,520,314,
35,"SUCEAVA",332,148426,,222,0,"Scoala generala nr.2","DUMBRAVENI",37,148426,0,3,1048,732,462,270,725,7,1200,468,462,263,
35,"SUCEAVA",332,148426,,223,0,"Scoala generala Salageni","DUMBRAVENI",37,148426,0,3,393,261,199,62,259,2,500,239,156,103,
35,"SUCEAVA",332,148453,,224,0,"Caminul cultural din satul Banesti","FANTANELE",38,148453,0,3,1057,682,600,82,675,7,1200,518,420,255,
35,"SUCEAVA",332,148453,,225,0,"Caminul cultural din satul FOntOnele","FANTANELE",38,148453,0,3,1129,668,604,64,660,8,1200,532,485,175,
35,"SUCEAVA",332,148453,,226,0,"Caminul cultural din satul Stamate","FANTANELE",38,148453,0,3,1586,1035,945,90,1026,9,1700,665,731,295,
35,"SUCEAVA",332,148514,,227,0,"Caminul cultural Forasti","FORASTI",39,148514,0,3,1307,775,706,69,771,4,1400,625,514,257,
35,"SUCEAVA",332,148514,,228,0,"Scoala generala Oniceni","FORASTI",39,148514,0,3,1078,818,706,112,814,4,1200,382,591,223,
35,"SUCEAVA",332,148514,,229,0,"Scoala generala Manolea","FORASTI",39,148514,0,3,1708,1072,986,86,1062,10,1800,728,941,121,
35,"SUCEAVA",332,148612,,230,0,"Clubul muncitoresc Frasin","FRASIN",40,148612,0,3,2341,1329,1156,173,1323,6,2500,1171,614,709,
35,"SUCEAVA",332,148612,,231,0,"Scoala generala Bucsoaia","FRASIN",40,148612,0,3,1134,828,684,144,791,37,1200,372,445,346,
35,"SUCEAVA",332,148612,,232,0,"Caminul Cultural Plutonita","FRASIN",40,148612,0,3,1605,952,856,96,936,16,1700,748,537,399,
35,"SUCEAVA",332,148667,,233,0,"Caminul cultural Fratautii Noi","FRATAUTII NOI",41,148667,0,3,1438,916,723,193,882,34,1600,684,520,362,
35,"SUCEAVA",332,148667,,234,0,"Scoala generala nr.2 Fratautii Noi","FRATAUTII NOI",41,148667,0,3,1345,749,609,140,727,22,1500,751,509,218,
35,"SUCEAVA",332,148667,,235,0,"Caminul Cultural Costisa","FRATAUTII NOI",41,148667,0,3,1360,659,613,46,641,18,1500,841,423,218,
35,"SUCEAVA",332,148694,,236,0,"Consiliul local Fratautii Vechi","FRATAUTII VECHI",42,148694,0,3,2215,1041,960,81,1031,10,2400,1359,686,345,
35,"SUCEAVA",332,148694,,237,0,"Scoala cu clasele I-VIII Maneuti","FRATAUTII VECHI",42,148694,0,3,1438,785,703,82,773,12,1600,815,515,258,
35,"SUCEAVA",332,148729,,238,0,"Primaria comunei Frumosu","FRUMOSU",43,148729,0,3,1869,1319,1266,53,1310,9,2000,681,653,657,
35,"SUCEAVA",332,148729,,239,0,"Caminul cultural din satul Deia","FRUMOSU",43,148729,0,3,703,544,519,25,541,3,800,256,231,310,
35,"SUCEAVA",332,148729,,240,0,"Scoala generala cu clasele I-IV Dragosa","FRUMOSU",43,148729,0,3,312,241,216,25,238,3,400,159,89,149,
35,"SUCEAVA",332,148765,,241,0,"Caminul cultural centru  Fundu Moldovei","FUNDU MOLDOVEI",44,148765,0,3,1573,932,854,78,925,7,1700,768,473,452,
35,"SUCEAVA",332,148765,,242,0,"Caminul cultural din satul Colacu","FUNDU MOLDOVEI",44,148765,0,3,796,532,478,54,529,3,900,368,332,197,
35,"SUCEAVA",332,148765,,243,0,"Caminul cultural din satul Botus","FUNDU MOLDOVEI",44,148765,0,3,970,639,551,88,631,8,1100,461,455,176,
35,"SUCEAVA",332,148872,,244,0,"Caminul cultural Galanesti","GALANESTI",45,148872,0,3,2079,1002,954,48,990,12,2200,1198,620,370,
35,"SUCEAVA",332,148872,,245,0,"Caminul cultural din satul Voitinel","GALANESTI",45,148872,0,3,2312,1085,1023,62,1056,29,2500,1415,682,374,
35,"SUCEAVA",332,148916,,246,0,"Caminul  cultural Gramesti","GRAMESTI",46,148916,0,3,1639,1050,964,86,1033,17,1800,750,605,428,
35,"SUCEAVA",332,148916,,247,0,"Scoala generala Balinesti","GRAMESTI",46,148916,0,3,757,465,401,64,458,7,800,335,288,170,
35,"SUCEAVA",332,148970,,248,0,"Scoala generala Granicesti","GRANICESTI",47,148970,0,3,1897,1010,966,44,997,13,2000,990,524,473,
35,"SUCEAVA",332,148970,,249,0,"Scoala generala Romanesti","GRANICESTI",47,148970,0,3,900,564,509,55,557,7,1000,436,281,276,
35,"SUCEAVA",332,148970,,250,0,"Scoala generala Slobozia Sucevei","GRANICESTI",47,148970,0,3,434,262,222,40,259,3,500,238,131,128,
35,"SUCEAVA",332,148970,,251,0,"Scoala generala Gura Solcii","GRANICESTI",47,148970,0,3,375,289,262,27,285,4,400,111,203,82,
35,"SUCEAVA",332,149101,,252,0,"Caminul cultural Horodnic de Jos","HORODNIC",48,149101,0,3,1350,705,633,72,699,6,1500,795,380,319,
35,"SUCEAVA",332,149101,,253,0,"Scoala generala nr.2 Horodnic de Jos-Calugarita","HORODNIC",48,149101,0,3,640,393,364,29,389,4,700,307,239,150,
35,"SUCEAVA",332,149101,,254,0,"Sala de sport Horodnic de Sus","HORODNIC",48,149101,0,3,1556,897,807,90,889,8,1700,803,583,306,
35,"SUCEAVA",332,149101,,255,0,"Scoala nr.2 Horodnic de Sus","HORODNIC",48,149101,0,3,779,420,357,63,414,6,900,480,222,192,
35,"SUCEAVA",332,149101,,256,0,"Scoala nr.3 Horodnic de Sus","HORODNIC",48,149101,0,3,872,636,581,55,624,12,1000,364,431,193,
35,"SUCEAVA",332,149049,,257,0,"Primaria Horodniceni","HORODNICENI",49,149049,0,3,1419,783,678,105,772,11,1500,717,518,254,
35,"SUCEAVA",332,149049,,258,0,"Caminul cultural Rotopanesti","HORODNICENI",49,149049,0,3,1829,1042,939,103,1034,8,2000,958,808,226,
35,"SUCEAVA",332,149138,,259,0,"Casa Nationala Iacobeni","IACOBENI",50,149138,0,3,1738,1114,994,120,1099,15,1900,786,625,474,
35,"SUCEAVA",332,149138,,260,0,"Scoala generala Mestecanis","IACOBENI",50,149138,0,3,244,191,145,46,188,3,300,109,109,79,
35,"SUCEAVA",332,149138,,261,0,"Caminul cultural Ciocanesti","IACOBENI",50,149138,0,3,885,639,582,57,634,5,1000,361,372,262,
35,"SUCEAVA",332,149138,,262,0,"Caminul cultural Botos","IACOBENI",50,149138,0,3,286,243,203,40,238,5,300,57,92,146,
35,"SUCEAVA",332,146281,,263,0,"Caminul cultural Ipotesti","IPOTESTI",51,146281,0,3,2446,1439,1351,88,1410,29,2600,1161,763,647,
35,"SUCEAVA",332,146281,,264,0,"Scoala Generala Tisauti","IPOTESTI",51,146281,0,3,613,465,396,69,456,9,700,235,290,166,
35,"SUCEAVA",332,146281,,265,0,"Scoala generala Lisaura","IPOTESTI",51,146281,0,3,555,450,396,54,443,7,600,150,247,196,
35,"SUCEAVA",332,149183,,266,0,"Primaria Izvoarele Sucevei","IZVOARELE SUCEVEI",52,149183,0,3,786,392,289,103,379,13,900,508,212,167,
35,"SUCEAVA",332,149183,,267,0,"Scoala generala Bobeica","IZVOARELE SUCEVEI",52,149183,0,3,363,219,181,38,202,17,400,181,126,76,
35,"SUCEAVA",332,149183,,268,0,"Scoala generala Brodina","IZVOARELE SUCEVEI",52,149183,0,3,581,284,244,40,272,12,700,416,92,180,
35,"SUCEAVA",332,149227,,269,0,"Caminul cultural Liteni","LITENI",53,149227,0,3,1681,956,826,130,952,4,1800,844,613,339,
35,"SUCEAVA",332,149227,,270,0,"Corpul III - Grup scolar Liteni","LITENI",53,149227,0,3,1909,1056,974,82,1050,6,2100,1044,618,432,
35,"SUCEAVA",332,149227,,271,0,"Scoala cu clasele I-VIII Rotunda","LITENI",53,149227,0,3,1648,893,832,61,879,14,1800,907,594,285,
35,"SUCEAVA",332,149227,,272,0,"Scoala cu clasele I-VIII Roscani","LITENI",53,149227,0,3,1043,602,540,62,595,7,1100,498,403,192,
35,"SUCEAVA",332,149227,,273,0,"Scoala cu clasele I-VIII Corni","LITENI",53,149227,0,3,644,445,394,51,435,10,700,255,226,209,
35,"SUCEAVA",332,149227,,274,0,"Scoala cu clasele I-VIII Silistea","LITENI",53,149227,0,3,628,406,348,58,400,6,700,294,246,154,
35,"SUCEAVA",332,149290,,275,0,"Scoala generala nr.2 Marginea-sediul vechi","MARGINEA",56,149290,0,3,1903,784,754,30,776,8,2100,1316,403,373,
35,"SUCEAVA",332,149290,,276,0,"Scoala generala nr.1 Marginea-sediul vechi","MARGINEA",56,149290,0,3,815,366,344,22,358,8,900,534,186,172,
35,"SUCEAVA",332,149290,,277,0,"Caminul cultural Marginea","MARGINEA",56,149290,0,3,1841,807,757,50,797,10,2000,1193,379,418,
35,"SUCEAVA",332,149290,,278,0,"Scoala nr.3 Marginea","MARGINEA",56,149290,0,3,1622,863,793,70,860,3,1796,933,442,418,
35,"SUCEAVA",332,149316,,279,0,"Primaria comunei Malini","MALINI",54,149316,0,3,1527,1010,824,186,1003,7,1599,589,702,301,
35,"SUCEAVA",332,149316,,280,0,"Scoala generala nr. 2 Malini(Suha)","MALINI",54,149316,0,3,1108,841,543,298,835,6,1200,359,516,319,
35,"SUCEAVA",332,149316,,281,0,"Scoala generala  din satul Praie","MALINI",54,149316,0,3,1317,664,606,58,656,8,1400,736,252,404,
35,"SUCEAVA",332,149316,,282,0,"Scoala generala  din satul Poiana Marului","MALINI",54,149316,0,3,990,656,594,62,652,4,1100,444,389,263,
35,"SUCEAVA",332,149316,,283,0,"Scoala generala Valeni","MALINI",54,149316,0,3,627,527,452,75,519,8,700,173,343,176,
35,"SUCEAVA",332,149370,,284,0,"Caminul cultural din satul Manastirea Humorului","MANASTIREA HUMORULUI",55,149370,0,3,1869,1082,1015,67,1057,25,2000,918,293,764,
35,"SUCEAVA",332,149370,,285,0,"Caminul cultural  Poiana Micului","MANASTIREA HUMORULUI",55,149370,0,3,692,504,440,64,503,1,800,296,133,370,
35,"SUCEAVA",332,149370,,286,0,"Caminul cultural din satul Plesa","MANASTIREA HUMORULUI",55,149370,0,3,150,103,87,16,103,0,200,97,21,82,
35,"SUCEAVA",332,146931,,287,0,"Caminul cultural Milisauti","MILISAUTI",57,146931,0,3,2792,1493,1387,106,1478,15,3000,1507,887,591,
35,"SUCEAVA",332,146931,,288,0,"Caminul cultural Iaslovat","MILISAUTI",57,146931,0,3,1397,1218,1177,41,1190,28,2600,1382,686,504,
35,"SUCEAVA",332,146931,,289,0,"Scoala Generala Badeuti","MILISAUTI",57,146931,0,3,1116,618,579,39,604,14,1200,582,361,243,
35,"SUCEAVA",332,146325,,290,0,"Scoala cu clasele I-VIII Mitoc-Centru","MITOCU DRAGOMIRNEI",58,146325,0,3,1225,852,719,133,833,19,1300,448,397,436,
35,"SUCEAVA",332,146325,,291,0,"Caminul Cultural Mitocu Dragomirnei","MITOCU DRAGOMIRNEI",58,146325,0,3,1194,972,812,160,944,28,1300,328,619,325,
35,"SUCEAVA",332,146325,,292,0,"Scoala din satul Lipoveni","MITOCU DRAGOMIRNEI",58,146325,0,3,320,305,248,57,305,0,400,95,198,107,
35,"SUCEAVA",332,149414,,293,0,"Primaria comunei Moara","MOARA",59,149414,0,3,1749,872,807,65,862,10,1900,1028,605,257,
35,"SUCEAVA",332,149414,,294,0,"Scoala generala Moara Carp","MOARA",59,149414,0,3,612,387,355,32,384,3,699,312,282,102,
35,"SUCEAVA",332,149414,,295,0,"Caminul cultural Liteni","MOARA",59,149414,0,3,795,563,454,109,558,5,900,337,330,228,
35,"SUCEAVA",332,149502,,296,0,"Primaria comunei Moldova Sulita","MOLDOVA-SULITA",60,149502,0,3,1033,647,559,88,636,11,1100,453,445,191,
35,"SUCEAVA",332,149502,,297,0,"Scoala Generala  din satul Benia","MOLDOVA-SULITA",60,149502,0,3,580,326,295,31,319,7,700,374,228,91,
35,"SUCEAVA",332,149539,,298,0,"Grupul Scolar Moldovita","MOLDOVITA",61,149539,0,3,2129,1555,1418,137,1530,25,2000,445,794,736,
35,"SUCEAVA",332,149539,,299,0,"Scoala generala de 4 ani Putna-Secries","MOLDOVITA",61,149539,0,3,987,675,617,58,670,5,1400,725,225,445,
35,"SUCEAVA",332,149539,,300,0,"Scoala generala de 8 ani Argel","MOLDOVITA",61,149539,0,3,754,667,625,42,661,6,800,133,338,323,
35,"SUCEAVA",332,149584,,301,0,"Caminul cultural din satul Bainet","MUSENITA",62,149584,0,3,746,525,477,48,516,9,800,275,257,259,
35,"SUCEAVA",332,149584,,302,0,"Scoala cu clasele I-VIII Vascauti","MUSENITA",62,149584,0,3,786,556,498,58,550,6,900,344,315,235,
35,"SUCEAVA",332,149584,,303,0,"Scoala generala Vicsani","MUSENITA",62,149584,0,3,199,182,128,54,180,2,300,118,92,88,
35,"SUCEAVA",332,149655,,304,0,"Caminul cultural Ostra","OSTRA",63,149655,0,3,2206,1377,1196,181,1366,11,2400,1023,920,446,
35,"SUCEAVA",332,149682,,305,0,"Primaria comunei Panaci","PANACI",65,149682,0,3,1286,821,747,74,817,4,1400,579,489,328,
35,"SUCEAVA",332,149682,,306,0,"Scoala cu clasele I-VIII satul Glodu","PANACI",65,149682,0,3,565,368,328,40,368,0,600,232,163,205,
35,"SUCEAVA",332,149753,,307,0,"Caminul cultural  din satul Paltinoasa","PALTINOASA",64,149753,0,3,2244,1695,1535,160,1686,9,2400,705,825,861,
35,"SUCEAVA",332,149753,,308,0,"Caminul Cultural  din centrul satului  Capu Codrului","PALTINOASA",64,149753,0,3,1986,1347,1245,102,1341,6,2100,753,795,546,
35,"SUCEAVA",332,149833,,309,0,"Consiliul local Patrauti","PATRAUTI",67,149833,0,3,1511,886,819,67,879,7,1600,714,554,325,
35,"SUCEAVA",332,149833,,310,0,"Localul fostului sediu al primariei","PATRAUTI",67,149833,0,3,1114,805,740,65,795,10,1200,395,643,152,
35,"SUCEAVA",332,149780,,311,0,"Caminul cultural POrtestii de Jos","PARTESTII DE JOS",66,149780,0,3,1648,971,876,95,960,11,1800,829,497,463,
35,"SUCEAVA",332,149780,,312,0,"Caminul cultural Deleni","PARTESTII DE JOS",66,149780,0,3,711,500,435,65,494,6,800,300,259,235,
35,"SUCEAVA",332,149851,,313,0,"Caminul cultural Poiana Stampei","POIANA STAMPEI",68,149851,0,3,1479,932,813,119,930,2,1600,668,574,356,
35,"SUCEAVA",332,149851,,314,0,"S.C.""Lex""Dornisoara din satul Dornisoara","POIANA STAMPEI",68,149851,0,3,226,269,148,121,269,0,300,31,203,66,
35,"SUCEAVA",332,149931,,315,0,"Scoala generala de 4 ani Pojorta","POJORATA",69,149931,0,3,830,617,490,127,611,6,900,283,353,258,
35,"SUCEAVA",332,149931,,316,0,"Caminul cultural Pojorta - Sala veche","POJORATA",69,149931,0,3,1218,922,801,121,912,10,1300,378,567,345,
35,"SUCEAVA",332,149931,,317,0,"Caminul cultural Valea Putnei","POJORATA",69,149931,0,3,233,208,165,43,206,2,300,92,90,116,
35,"SUCEAVA",332,149968,,318,0,"Scoala cu clasele I-VIII din satul  Arghira","PREUTESTI",70,149968,0,3,914,790,691,99,783,7,1000,210,577,206,
35,"SUCEAVA",332,149968,,319,0,"Scoala cu clasele I-VIII din satul  Basarabi","PREUTESTI",70,149968,0,3,1340,787,699,88,778,9,1500,713,547,231,
35,"SUCEAVA",332,149968,,320,0,"Caminul cultural din  satul  Preutesti","PREUTESTI",70,149968,0,3,1609,1396,1282,114,1364,32,1800,404,908,456,
35,"SUCEAVA",332,149968,,321,0,"Scoala cu clasele I-VIII din satul  Husi","PREUTESTI",70,149968,0,3,494,506,454,52,492,14,600,94,308,184,
35,"SUCEAVA",332,149968,,322,0,"Scoala cu clasele I-VIII  din satul  Leucusesti","PREUTESTI",70,149968,0,3,715,595,518,77,591,4,800,205,340,251,
35,"SUCEAVA",332,149968,,323,0,"Scoala nr.1 din satul HOrtop","PREUTESTI",70,149968,0,3,1604,1411,1321,90,1404,7,1700,289,876,528,
35,"SUCEAVA",332,150043,,324,0,"Caminul cultural Putna","PUTNA",71,150043,0,3,1944,1225,1122,103,1217,8,2100,875,899,318,
35,"SUCEAVA",332,150043,,325,0,"Caminul cultural din satul Gura Putnei","PUTNA",71,150043,0,3,903,610,574,36,609,1,1000,390,428,181,
35,"SUCEAVA",332,150070,,326,0,"Scoala generala Radaseni","RADASENI",72,150070,0,3,2176,1376,1244,132,1359,17,2296,920,779,580,
35,"SUCEAVA",332,150070,,327,0,"Scoala generala Lamaseni","RADASENI",72,150070,0,3,1115,773,721,52,770,3,1200,427,433,337,
35,"SUCEAVA",332,150070,,328,0,"Scoala generala Pocoleni","RADASENI",72,150070,0,3,166,150,129,21,149,1,200,50,91,58,
35,"SUCEAVA",332,150114,,329,0,"Caminul cultural Rsca","RASCA",73,150114,0,3,2309,1405,1247,158,1384,21,2500,1095,860,524,
35,"SUCEAVA",332,150114,,330,0,"Scoala cu clasele I-VIII Buda","RASCA",73,150114,0,3,1332,788,679,109,777,11,1400,612,494,283,
35,"SUCEAVA",332,150178,,331,0,"Caminul cultural din comuna Sadova","SADOVA",74,150178,0,3,1889,1151,1066,85,1141,10,2000,849,529,612,
35,"SUCEAVA",332,146370,,332,0,"Caminul cultural din Salcea","SALCEA",75,146370,0,3,2056,1273,1095,178,1247,26,2200,927,797,450,
35,"SUCEAVA",332,146370,,333,0,"Caminul cultural Plopeni","SALCEA",75,146370,0,3,2295,1198,1078,120,1184,14,2500,1302,812,372,
35,"SUCEAVA",332,146370,,334,0,"Caminul cultural Prelipca","SALCEA",75,146370,0,3,883,572,515,57,560,12,1000,428,328,232,
35,"SUCEAVA",332,146370,,335,0,"Caminul cultural Varatec","SALCEA",75,146370,0,3,1034,551,497,54,538,13,1102,551,345,193,
35,"SUCEAVA",332,150196,,336,0,"Caminul cultural Satu Mare","SATU MARE",77,150196,0,3,953,555,523,32,543,12,1000,445,354,189,
35,"SUCEAVA",332,150196,,337,0,"Scoala generala Satu Mare","SATU MARE",77,150196,0,3,1078,713,668,45,704,9,1199,486,429,275,
35,"SUCEAVA",332,150196,,338,0,"Scoala generala Tibeni","SATU MARE",77,150196,0,3,900,517,464,53,514,3,1000,483,301,213,
35,"SUCEAVA",332,150221,,339,0,"Caminul cultural Siminicea","SIMINICEA",79,150221,0,3,1295,773,721,52,748,25,1414,641,512,236,
35,"SUCEAVA",332,150221,,340,0,"Scoala generala Siminicea","SIMINICEA",79,150221,0,3,1149,733,671,62,725,8,1300,567,515,210,
35,"SUCEAVA",332,150258,,341,0,"Primaria comunei Slatina","SLATINA",80,150258,0,3,1429,777,712,65,770,7,1600,823,547,223,
35,"SUCEAVA",332,150258,,342,0,"Caminul cultural Gainesti","SLATINA",80,150258,0,3,1558,1083,1012,71,1069,14,1700,617,810,259,
35,"SUCEAVA",332,150258,,343,0,"Scoala Generala Herla - localul vechi","SLATINA",80,150258,0,3,972,631,568,63,624,7,1100,469,391,233,
35,"SUCEAVA",332,150294,,344,0,"Caminul Cultural Straja","STRAJA",81,150294,0,3,2127,1187,1086,101,1161,26,2300,1113,585,576,
35,"SUCEAVA",332,150294,,345,0,"Scoala generala nr.2 Straja","STRAJA",81,150294,0,3,2026,922,834,88,906,16,2200,1278,523,383,
35,"SUCEAVA",332,150310,,346,0,"Caminul cultural Stroiesti","STROIESTI",82,150310,0,3,2038,1262,1197,65,1254,8,2200,938,698,556,
35,"SUCEAVA",332,150310,,347,0,"Scoala generala Zaharesti","STROIESTI",82,150310,0,3,687,423,386,37,415,8,800,377,243,172,
35,"SUCEAVA",332,150356,,348,0,"Caminul cultural Stulpicani","STULPICANI",83,150356,0,3,2292,1210,1140,70,1192,18,2500,1290,838,354,
35,"SUCEAVA",332,150356,,349,0,"Scoala generala Negrileasa","STULPICANI",83,150356,0,3,852,602,557,45,594,8,900,298,389,205,
35,"SUCEAVA",332,150356,,350,0,"Caminul cultural Vadu Negrilesii","STULPICANI",83,150356,0,3,408,364,282,82,360,4,500,136,254,106,
35,"SUCEAVA",332,150356,,351,0,"Scoala generala Gemenea","STULPICANI",83,150356,0,3,715,557,488,69,547,10,800,243,317,230,
35,"SUCEAVA",332,150356,,352,0,"Caminul cultural Slatioara","STULPICANI",83,150356,0,3,516,354,327,27,349,5,600,246,233,116,
35,"SUCEAVA",332,150418,,353,0,"Caminul cultural Sucevita","SUCEVITA",84,150418,0,3,1104,717,641,76,700,17,1200,483,456,244,
35,"SUCEAVA",332,150418,,354,0,"Caminul cultural Voivodeasa","SUCEVITA",84,150418,0,3,835,540,509,31,526,14,900,360,346,180,
35,"SUCEAVA",332,150445,,355,0,"Caminul cultural Neagra Sarului","SARU DORNEI",76,150445,0,3,1903,1210,1084,126,1200,10,2096,886,627,573,
35,"SUCEAVA",332,150445,,356,0,"Scoala cu clasele I-VIII Saru Dornei","SARU DORNEI",76,150445,0,3,1329,771,679,92,752,19,1400,629,411,341,
35,"SUCEAVA",332,146432,,357,0,"Primaria comunei Scheia","SCHEIA",78,146432,0,3,1815,961,857,104,944,17,2000,1039,583,361,
35,"SUCEAVA",332,146432,,358,0,"Scoala generala Mihoveni","SCHEIA",78,146432,0,3,1677,1123,992,131,1114,9,1800,677,549,565,
35,"SUCEAVA",332,146432,,359,0,"Scoala generala Sf.Ilie","SCHEIA",78,146432,0,3,1927,1118,966,152,1110,8,2100,982,703,407,
35,"SUCEAVA",332,150524,,360,0,"Caminul cultural Todiresti","TODIRESTI",85,150524,0,3,1212,1070,997,73,1058,12,1300,230,780,278,
35,"SUCEAVA",332,150524,,361,0,"Scoala nr.2 Solonet","TODIRESTI",85,150524,0,3,1285,828,772,56,825,3,1400,572,517,308,
35,"SUCEAVA",332,150524,,362,0,"Scoala generala Parhauti","TODIRESTI",85,150524,0,3,1008,677,592,85,667,10,1100,423,390,277,
35,"SUCEAVA",332,150524,,363,0,"Scoala generala Costna","TODIRESTI",85,150524,0,3,815,557,475,82,554,3,900,343,335,219,
35,"SUCEAVA",332,150588,,364,0,"Primaria  Udesti","UDESTI",86,150588,0,3,1880,1166,1065,101,1154,12,2007,841,777,377,
35,"SUCEAVA",332,150588,,365,0,"Caminul cultural  din satul Chiliseni","UDESTI",86,150588,0,3,1586,1016,912,104,996,20,1699,683,648,348,
35,"SUCEAVA",332,150588,,366,0,"Scoala generala din satul  Reuseni","UDESTI",86,150588,0,3,2158,1126,1063,63,1107,19,2300,1174,720,387,
35,"SUCEAVA",332,150702,,367,0,"Scoala cu clasele I-VIII din satul Ulma","ULMA",87,150702,0,3,967,530,479,51,519,11,1100,570,309,210,
35,"SUCEAVA",332,150702,,368,0,"Scoala cu clasele I-VIII satul Lupcina","ULMA",87,150702,0,3,742,434,375,59,428,6,800,366,277,151,
35,"SUCEAVA",332,150766,,369,0,"Scoala Vadu Moldovei","VADU MOLDOVEI",88,150766,0,3,1330,840,702,138,832,8,1395,555,592,240,
35,"SUCEAVA",332,150766,,370,0,"Scoala FOntOna Mare - Deal","VADU MOLDOVEI",88,150766,0,3,1062,729,643,86,723,6,1200,471,430,293,
35,"SUCEAVA",332,150766,,371,0,"Scoala Cotu Baii","VADU MOLDOVEI",88,150766,0,3,739,514,442,72,510,4,800,286,299,211,
35,"SUCEAVA",332,150766,,372,0,"Scoala Dumbravita","VADU MOLDOVEI",88,150766,0,3,1203,851,732,119,843,8,1300,449,633,210,
35,"SUCEAVA",332,150766,,373,0,"Scoala Nigotesti","VADU MOLDOVEI",88,150766,0,3,1202,736,625,111,728,8,1300,564,504,224,
35,"SUCEAVA",332,150891,,374,0,"Caminul cultural Valea Moldovei","VALEA MOLDOVEI",89,150891,0,3,2249,1571,1486,85,1551,20,2400,829,977,574,
35,"SUCEAVA",332,150891,,375,0,"Caminul cultural Capu Cmpului","VALEA MOLDOVEI",89,150891,0,3,1729,1279,1176,103,1262,17,1900,621,650,612,
35,"SUCEAVA",332,150935,,376,0,"Caminul cultural Vama","VAMA",90,150935,0,3,1247,714,515,199,710,4,1395,681,336,374,
35,"SUCEAVA",332,150935,,377,0,"Scoala Generala Vama de Sus","VAMA",90,150935,0,3,1231,834,579,255,831,3,1300,466,445,386,
35,"SUCEAVA",332,150935,,378,0,"Scoala generala Strmtura","VAMA",90,150935,0,3,703,528,397,131,521,7,900,372,319,202,
35,"SUCEAVA",332,150935,,379,0,"Scoala generala Molid","VAMA",90,150935,0,3,459,334,283,51,332,2,497,163,176,156,
35,"SUCEAVA",332,150935,,380,0,"Scoala generala Prisaca Dornei","VAMA",90,150935,0,3,542,413,305,108,410,3,600,187,191,219,
35,"SUCEAVA",332,150980,,381,0,"Caminul cultural Vatra Moldovitei","VATRA MOLDOVITEI",91,150980,0,3,1252,765,670,95,759,6,1402,637,287,472,
35,"SUCEAVA",332,150980,,382,0,"Scoala generala cu clasele I-IV Valea Stnii","VATRA MOLDOVITEI",91,150980,0,3,675,489,422,67,479,10,796,307,220,259,
35,"SUCEAVA",332,150980,,383,0,"Caminul cultural Paltinu","VATRA MOLDOVITEI",91,150980,0,3,1261,762,718,44,755,7,1400,638,328,427,
35,"SUCEAVA",332,150980,,384,0,"Scoala generala cu clasele I-IV Ciumrna","VATRA MOLDOVITEI",91,150980,0,3,364,261,242,19,259,2,400,139,97,162,
35,"SUCEAVA",332,151022,,385,0,"Caminul cultural Veresti","VERESTI",92,151022,0,3,1825,1159,982,177,1144,15,2000,841,768,376,
35,"SUCEAVA",332,151022,,386,0,"Scoala cu clasele I-VIII Corocaiesti","VERESTI",92,151022,0,3,2176,1198,1114,84,1176,22,2300,1102,780,396,
35,"SUCEAVA",332,151022,,387,0,"Scoala veche din satul Bursuceni","VERESTI",92,151022,0,3,1163,662,612,50,646,16,1300,638,369,277,
35,"SUCEAVA",332,151077,,388,0,"Caminul cultural Vicovu de Jos","VICOVU DE JOS",93,151077,0,3,2511,1260,1209,51,1255,5,2700,1440,798,457,
35,"SUCEAVA",332,151077,,389,0,"Scoala generala nr.2 Remezau","VICOVU DE JOS",93,151077,0,3,1814,1009,950,59,990,19,2000,991,548,442,
35,"SUCEAVA",332,151095,,390,0,"Caminul cultural Est","VICOVU DE SUS",94,151095,0,3,1989,1194,1111,83,1171,23,2097,903,927,244,
35,"SUCEAVA",332,151095,,391,0,"Caminul cultural Centru","VICOVU DE SUS",94,151095,0,3,1936,1091,888,203,1077,14,2100,1009,788,289,
35,"SUCEAVA",332,151095,,392,0,"Scoala generala veche - Plai","VICOVU DE SUS",94,151095,0,3,928,574,490,84,564,10,1000,426,453,111,
35,"SUCEAVA",332,151095,,393,0,"Caminul cultural Laura","VICOVU DE SUS",94,151095,0,3,2919,1905,1745,160,1879,26,3200,1295,1409,470,
35,"SUCEAVA",332,151095,,394,0,"Caminul cultural Bivolarie","VICOVU DE SUS",94,151095,0,3,1728,989,892,97,970,19,1900,911,650,320,
35,"SUCEAVA",332,151120,,395,0,"Caminul cultural din satul Volovat","VOLOVAT",95,151120,0,3,1534,739,694,45,719,20,1698,959,342,377,
35,"SUCEAVA",332,151120,,396,0,"Primaria comunei Volovat","VOLOVAT",95,151120,0,3,1627,860,813,47,841,19,1799,939,462,379,
35,"SUCEAVA",332,151120,,397,0,"Caminul cultural Burla","VOLOVAT",95,151120,0,3,1439,809,764,45,795,14,1600,791,471,324,
35,"SUCEAVA",332,151157,,398,0,"Consiliul local Plesesti","VULTURESTI",96,151157,0,3,757,439,388,51,435,4,800,361,260,175,
35,"SUCEAVA",332,151157,,399,0,"Scoala generala Valea Glodului","VULTURESTI",96,151157,0,3,1068,667,583,84,653,14,1200,533,414,239,
35,"SUCEAVA",332,151157,,400,0,"Scoala generala Giurgesti","VULTURESTI",96,151157,0,3,592,457,404,53,453,4,700,243,324,129,
35,"SUCEAVA",332,151157,,401,0,"Scoala generala Hreatca","VULTURESTI",96,151157,0,3,334,208,174,34,207,1,400,192,133,74,
35,"SUCEAVA",332,151157,,402,0,"Scoala generala Meresti","VULTURESTI",96,151157,0,3,235,197,140,57,194,3,300,103,105,89,
35,"SUCEAVA",332,151246,,403,0,"Caminul cultural Zamostea","ZAMOSTEA",97,151246,0,3,2082,1174,1058,116,1162,12,2200,1026,754,408,
35,"SUCEAVA",332,151246,,404,0,"Scoala Ciomrtan","ZAMOSTEA",97,151246,0,3,441,304,274,30,303,1,506,202,167,136,
35,"SUCEAVA",332,151344,,405,0,"Caminul cultural Zvorstea","ZVORISTEA",98,151344,0,3,837,478,414,64,472,6,900,422,354,118,
35,"SUCEAVA",332,151344,,406,0,"Scoala generala Buda","ZVORISTEA",98,151344,0,3,1418,924,805,119,910,14,1500,576,664,246,
35,"SUCEAVA",332,151344,,407,0,"Scoala generala Serbanesti","ZVORISTEA",98,151344,0,3,880,594,502,92,586,8,1000,406,399,187,
35,"SUCEAVA",332,151344,,408,0,"Scoala generala Slobozia","ZVORISTEA",98,151344,0,3,535,368,330,38,361,7,600,232,252,109,
35,"SUCEAVA",332,151344,,409,0,"Scoala generala Stnca","ZVORISTEA",98,151344,0,3,491,393,348,45,386,7,598,205,313,73,
35,"SUCEAVA",332,151344,,410,0,"Scoala generala Poiana","ZVORISTEA",98,151344,0,3,522,381,325,56,375,6,595,214,284,91,
36,"TELEORMAN",341,151790,,1,0,"SC. GENERALA NR. 7, STR. 1907, NR.5","MUNICIPIUL ALEXANDRIA",1,151790,1,1,1706,866,809,57,861,5,1800,934,504,357,
36,"TELEORMAN",341,151790,,2,0,"GRADINITA DE COPII NR. 6, STR. 1907, NR. 55","MUNICIPIUL ALEXANDRIA",1,151790,1,1,1571,705,658,47,697,8,1600,895,437,260,
36,"TELEORMAN",341,151790,,3,0,"SC. AJUTATOARE, STR. LIBERTATII, NR. 1","MUNICIPIUL ALEXANDRIA",1,151790,1,1,1593,861,779,82,858,3,1700,839,556,302,
36,"TELEORMAN",341,151790,,4,0,"SC. GENERALA NR. 7, STR. 1907, NR. 5","MUNICIPIUL ALEXANDRIA",1,151790,1,1,1725,965,916,49,959,6,1900,935,644,315,
36,"TELEORMAN",341,151790,,5,0,"GRUPUL SCOLAR AGRICOL, STR. LIBERTATII, NR. 69","MUNICIPIUL ALEXANDRIA",1,151790,1,1,1782,1008,944,64,1004,4,1900,892,666,338,
36,"TELEORMAN",341,151790,,6,0,"GRUPUL SCOLAR AGRICOL, STR. LIBERTATII, NR. 69","MUNICIPIUL ALEXANDRIA",1,151790,1,1,1706,920,885,35,908,12,1900,980,591,317,
36,"TELEORMAN",341,151790,,7,0,"LICEUL ALEXANDRU GHICA, STR. VIITORULUI, NR. 78","MUNICIPIUL ALEXANDRIA",1,151790,1,1,1768,961,907,54,946,15,1900,939,660,286,
36,"TELEORMAN",341,151790,,8,0,"GRADINITA DE COPII NR. 10, STR. DUNARII, NR. 131","MUNICIPIUL ALEXANDRIA",1,151790,1,1,1843,1022,965,57,1010,12,2000,978,696,314,
36,"TELEORMAN",341,151790,,9,0,"LICEUL TEORETIC NR. 3, STR. DUNARII, NR. 133","MUNICIPIUL ALEXANDRIA",1,151790,1,1,1599,897,831,66,890,7,1700,803,606,284,
36,"TELEORMAN",341,151790,,10,0,"SC. GENERALA NR. 5, STR. LIBERTATII, NR. 148","MUNICIPIUL ALEXANDRIA",1,151790,1,1,1805,1052,913,139,1045,7,1900,848,778,267,
36,"TELEORMAN",341,151790,,11,0,"GRADINITA DE COPII NR. 7, STR. ALEXANDRU COLFESCU, NR. 70","MUNICIPIUL ALEXANDRIA",1,151790,1,1,1495,808,771,37,805,3,1600,792,594,211,
36,"TELEORMAN",341,151790,,12,0,"GRADINITA DE COPII NR. 7, STR. ALEXANDRU COLFESCU, NR. 70","MUNICIPIUL ALEXANDRIA",1,151790,1,1,1190,675,637,38,665,10,1300,625,461,204,
36,"TELEORMAN",341,151790,,13,0,"SCOALA NORMALA, STR. NEGRU VODA, NR. 99","MUNICIPIUL ALEXANDRIA",1,151790,1,1,988,549,516,33,545,4,1100,551,421,124,
36,"TELEORMAN",341,151790,,14,0,"LICEUL ALEXANDRU IOAN CUZA, STR. CARPATI, NR. 27","MUNICIPIUL ALEXANDRIA",1,151790,1,1,1525,787,728,59,777,10,1700,913,540,237,
36,"TELEORMAN",341,151790,,15,0,"SCOALA GENERALA NR. 2, STR. ALEXANDRU COLFESCU, NR. 34","MUNICIPIUL ALEXANDRIA",1,151790,1,1,1427,728,638,90,725,3,1600,872,508,217,
36,"TELEORMAN",341,151790,,16,0,"SCOALA GENERALA NR. 3, STR. CARPATI, NR. 15","MUNICIPIUL ALEXANDRIA",1,151790,1,1,1158,668,619,49,662,6,1300,632,476,186,
36,"TELEORMAN",341,151790,,17,0,"LICEUL ALEXANDRU IOAN CUZA, STR. CARPATI, NR. 27","MUNICIPIUL ALEXANDRIA",1,151790,1,1,1863,879,821,58,868,11,2000,1121,612,256,
36,"TELEORMAN",341,151790,,18,0,"LICEUL ALEXANDRU IOAN CUZA, STR. CARPATI, NR. 27","MUNICIPIUL ALEXANDRIA",1,151790,1,1,1430,723,686,37,717,6,1600,877,541,176,
36,"TELEORMAN",341,151790,,19,0,"SCOALA GENERALA NR. 3, STR. CARPATI NR. 15","MUNICIPIUL ALEXANDRIA",1,151790,1,1,1184,636,602,34,634,2,1300,664,460,174,
36,"TELEORMAN",341,151790,,20,0,"SALA POLIVALENTA, STR. ALEXANDRU GHICA, NR. 86 - 88","MUNICIPIUL ALEXANDRIA",1,151790,1,1,983,675,631,44,673,2,1400,725,515,158,
36,"TELEORMAN",341,151790,,21,0,"SC SIMCA (IACMT), STR. ALEXANDRU GHICA, NR. 121","MUNICIPIUL ALEXANDRIA",1,151790,1,1,1219,585,543,42,583,2,1400,815,388,195,
36,"TELEORMAN",341,151790,,22,0,"SCOALA GENERALA NR. 6, STR. 1 MAI, NR. 107","MUNICIPIUL ALEXANDRIA",1,151790,1,1,955,515,489,26,510,5,1100,585,321,189,
36,"TELEORMAN",341,151790,,23,0,"SCOALA GENERALA NR. 6, STR. 1 MAI, NR. 107","MUNICIPIUL ALEXANDRIA",1,151790,1,1,1308,692,648,44,687,5,1402,710,449,238,
36,"TELEORMAN",341,151790,,24,0,"SCOALA GENERALA NR. 6, STR. 1 MAI, NR. 107","MUNICIPIUL ALEXANDRIA",1,151790,1,1,1713,826,786,40,818,8,1800,974,558,260,
36,"TELEORMAN",341,151790,,25,0,"SCOALA GENERALA NR. 4, STR. DUNARII, NR. 292","MUNICIPIUL ALEXANDRIA",1,151790,1,1,1320,683,624,59,674,9,1400,717,454,220,
36,"TELEORMAN",341,151790,,26,0,"GRADINITA DE COPII NR.4, STR. ALEXANDRU GHICA , NR . 148","MUNICIPIUL ALEXANDRIA",1,151790,1,1,1849,976,929,47,967,9,1900,924,655,312,
36,"TELEORMAN",341,151790,,27,0,"SCOALA GENERALA NR.4 , STR. DUNARII, NR.292","MUNICIPIUL ALEXANDRIA",1,151790,1,1,1350,700,662,38,692,8,1400,700,508,184,
36,"TELEORMAN",341,151790,,28,0,"GRADINITA DE COPII NR.4 , STR ALEXANDRU GHICA , NR.143","MUNICIPIUL ALEXANDRIA",1,151790,1,1,1427,706,664,42,705,1,1500,794,429,276,
36,"TELEORMAN",341,151790,,29,0,"SCOALA GENERALA NR.4 , STR. DUNARII , NR.292 ,","MUNICIPIUL ALEXANDRIA",1,151790,1,1,1572,811,767,44,803,8,1602,791,574,229,
36,"TELEORMAN",341,151790,,30,0,"GRADINITA DE COPII NR.8 , STR. DUNARII , NR.364","MUNICIPIUL ALEXANDRIA",1,151790,1,1,1670,966,861,105,938,28,1700,734,731,207,
36,"TELEORMAN",341,151790,,31,0,"GRADINITA DE COPII NR. 1 , STR. DUNARII , NR.288","MUNICIPIUL ALEXANDRIA",1,151790,1,1,1581,913,884,29,902,11,1600,687,681,221,
36,"TELEORMAN",341,151790,,32,1,"OCOLUL SILVIC ALEXANDRIA , STR. SOSEAUA TURNU MAGURELE , NR.1","MUNICIPIUL ALEXANDRIA",1,151790,1,1,0,238,0,238,236,2,592,354,145,91,
36,"TELEORMAN",341,151790,,33,1,"SPITALUL JUDETEAN TELEORMAN , STR. LIBERTATII , NR.1","MUNICIPIUL ALEXANDRIA",1,151790,1,1,0,434,0,434,431,3,602,168,347,84,
36,"TELEORMAN",341,151870,,34,0,"SCOALA NR .6 , STR.CARPATI NR .77","MUNICIPIUL ROSIORI DE VEDE",2,151870,1,1,1371,770,702,68,760,10,1500,730,469,291,
36,"TELEORMAN",341,151870,,35,0,"SCOALA NR.4 , STR. CARPATI , NR. 40","MUNICIPIUL ROSIORI DE VEDE",2,151870,1,1,1295,845,623,222,822,23,1600,755,553,269,
36,"TELEORMAN",341,151870,,36,0,"LICEUL I.M.M.R. , STR. RENASTERII , NR.15","MUNICIPIUL ROSIORI DE VEDE",2,151870,1,1,1510,757,718,39,746,11,1600,843,483,263,
36,"TELEORMAN",341,151870,,37,0,"LOCALUL ATELIERELOR SCOLARE , STR. M KOGALNICEANU , NR.52A","MUNICIPIUL ROSIORI DE VEDE",2,151870,1,1,1436,729,687,42,718,11,1500,771,479,239,
36,"TELEORMAN",341,151870,,38,0,"LOCALUL CANTINEI DE AJUTOR SOCIAL , STR. MARASESTI . NR. 38","MUNICIPIUL ROSIORI DE VEDE",2,151870,1,1,1250,679,634,45,668,11,1400,721,482,186,
36,"TELEORMAN",341,151870,,39,0,"GRADINITA NR.7 , STR. PLT. RADULESCU , NR.9","MUNICIPIUL ROSIORI DE VEDE",2,151870,1,1,1322,700,665,35,690,10,1400,700,454,236,
36,"TELEORMAN",341,151870,,40,0,"MUZEUL DE ISTORIE , STR. DUNARII , NR.54","MUNICIPIUL ROSIORI DE VEDE",2,151870,1,1,1244,641,578,63,630,11,1400,759,438,192,
36,"TELEORMAN",341,151870,,41,0,"CLUBUL ELEVILOR , STR. SF. TEODOR , NR.16","MUNICIPIUL ROSIORI DE VEDE",2,151870,1,1,1378,764,680,84,756,8,1600,836,481,275,
36,"TELEORMAN",341,151870,,42,0,"SCOALA GALA GALACTION , STR. SF. VINERI , NR. 10","MUNICIPIUL ROSIORI DE VEDE",2,151870,1,1,1490,683,644,39,677,6,1600,917,493,184,
36,"TELEORMAN",341,151870,,43,0,"SCOALA NR.2 , STR. DUNARII , NR.126","MUNICIPIUL ROSIORI DE VEDE",2,151870,1,1,1560,818,781,37,809,9,1700,882,588,221,
36,"TELEORMAN",341,151870,,44,0,"LOCALUL OFICIULUI GOSPODARIRE A APELOR , STR. ALEX DOBRESCU, NR.3","MUNICIPIUL ROSIORI DE VEDE",2,151870,1,1,1535,1022,801,221,1013,9,1700,678,771,242,
36,"TELEORMAN",341,151870,,45,0,"SCOALA NR.5 , STR.STEGARULUI , NR.2","MUNICIPIUL ROSIORI DE VEDE",2,151870,1,1,1563,916,870,46,910,6,1700,784,630,280,
36,"TELEORMAN",341,151870,,46,0,"GRADINITA NR.5 , STR. DOROBANTI , NR.23","MUNICIPIUL ROSIORI DE VEDE",2,151870,1,1,114,703,672,31,692,11,1300,597,424,268,
36,"TELEORMAN",341,151870,,47,0,"SCOALA NR. 2 , STR. DUNARII , NR. 126","MUNICIPIUL ROSIORI DE VEDE",2,151870,1,1,1287,725,697,28,714,11,1400,675,492,222,
36,"TELEORMAN",341,151870,,48,0,"LOCALUL SCOLII NR.1 , STR. I.L. CARAGIALE , NR.2","MUNICIPIUL ROSIORI DE VEDE",2,151870,1,1,1540,760,714,46,743,17,1700,940,535,208,
36,"TELEORMAN",341,151870,,49,0,"LOCALUL CASEI DE CULTURA , STR. RENASTERII , NR. 1","MUNICIPIUL ROSIORI DE VEDE",2,151870,1,1,1241,623,589,34,617,6,1400,777,413,204,
36,"TELEORMAN",341,151870,,50,0,"LICEUL ANASTASESCU, STR.REPUBLICII , NR.9","MUNICIPIUL ROSIORI DE VEDE",2,151870,1,1,1354,751,674,77,742,9,1500,749,495,247,
36,"TELEORMAN",341,151870,,51,0,"GRADINITA NR.3 ZONA IZBICEANU  , NR.28","MUNICIPIUL ROSIORI DE VEDE",2,151870,1,1,1773,889,846,43,879,10,2000,1111,556,323,
36,"TELEORMAN",341,151870,,52,0,"LICEUL ECONOMIC , STR. REPUBLICII , NR. 11","MUNICIPIUL ROSIORI DE VEDE",2,151870,1,1,1570,781,665,116,779,2,1772,991,515,264,
36,"TELEORMAN",341,151870,,53,0,"SCOALA NR. 6 , STR. CARPATI . NR 77","MUNICIPIUL ROSIORI DE VEDE",2,151870,1,1,1238,626,573,53,621,5,1400,774,403,218,
36,"TELEORMAN",341,151870,,54,0,"GRADINITA NR.6 , STR CARPATI , NR.75","MUNICIPIUL ROSIORI DE VEDE",2,151870,1,1,1443,734,688,46,725,9,1603,869,483,242,
36,"TELEORMAN",341,151683,,55,0,"LOCALUL SCOLII VECHI CARTIERUL ODAIA ,","MUNICIPIUL TURNU MAGURELE",3,151683,1,1,1697,938,880,58,927,11,1797,859,675,252,
36,"TELEORMAN",341,151683,,56,0,"SCOALA NOUA , STR. OLTULUI, NR.140  CARTIERUL ODAIA","MUNICIPIUL TURNU MAGURELE",3,151683,1,1,1324,642,598,44,626,16,1424,782,467,159,
36,"TELEORMAN",341,151683,,57,0,"SCOALA GENERALA  , NR.4 , STR. CHIMIEI . NR.18","MUNICIPIUL TURNU MAGURELE",3,151683,1,1,2025,892,773,119,887,5,2225,1333,561,326,
36,"TELEORMAN",341,151683,,58,0,"GRADINITA TURNU SA , STR. TABEREI , NR.1","MUNICIPIUL TURNU MAGURELE",3,151683,1,1,2010,926,841,85,914,12,2210,1284,597,317,
36,"TELEORMAN",341,151683,,59,0,"GRUPUL SCOLAR DAVID PRAPORGESCU , STR. TABEREI , NR.2","MUNICIPIUL TURNU MAGURELE",3,151683,1,1,2088,1028,932,96,1027,1,2288,1260,696,331,
36,"TELEORMAN",341,151683,,60,0,"GRADINITA DIN  STR. TRAIAN , NR. 3","MUNICIPIUL TURNU MAGURELE",3,151683,1,1,1778,870,752,118,863,7,1878,1008,589,274,
36,"TELEORMAN",341,151683,,61,0," LOCALUL POLICLINICII MUNICIPIULUI TURNU MAGURELE , STR. G-RAL PRAPOGESCU","MUNICIPIUL TURNU MAGURELE",3,151683,1,1,1663,854,803,51,844,10,1763,909,612,232,
36,"TELEORMAN",341,151683,,62,0,"LOCALUL COLEGIULUI NATIONAL UNIREA , STR CASTANILOR, NR.25","MUNICIPIUL TURNU MAGURELE",3,151683,1,1,1253,574,510,64,571,3,1353,779,416,155,
36,"TELEORMAN",341,151683,,63,0,"LOCALUL COLEGIULUI NATIONAL UNIREA , STR. CASTANILOR , NR.25","MUNICIPIUL TURNU MAGURELE",3,151683,1,1,1618,779,721,58,777,2,1718,939,555,222,
36,"TELEORMAN",341,151683,,64,0,"SCALA GENERALA NR.1 , STR. AVANTULUI , NR.1","MUNICIPIUL TURNU MAGURELE",3,151683,1,1,1471,648,593,55,639,9,1571,923,486,153,
36,"TELEORMAN",341,151683,,65,0,"SCOALA GENERALA NR.1 , STR. AVANTULUI , NR.1","MUNICIPIUL TURNU MAGURELE",3,151683,1,1,1935,970,881,89,966,4,2135,1165,688,278,
36,"TELEORMAN",341,151683,,66,0,"LOCALUL GRUPUULUI SCOLAR AGRICOL ""SF. HARALAMBIE"" , STR OITUZ NR.11","MUNICIPIUL TURNU MAGURELE",3,151683,1,1,1243,608,534,74,607,1,1343,735,459,148,
36,"TELEORMAN",341,151683,,67,0,"LOCALUL GRUPULUI SCOLAR AGRICOL ""SF HARALAMBIE"" , STR. OITUZ NR.11","MUNICIPIUL TURNU MAGURELE",3,151683,1,1,1096,492,439,53,487,5,1196,704,355,132,
36,"TELEORMAN",341,151683,,68,0,"LICEUL "" MARIN PREDA"" , STR.CETATEA TURNU , NR.9","MUNICIPIUL TURNU MAGURELE",3,151683,1,1,1465,666,624,42,659,7,1565,899,508,151,
36,"TELEORMAN",341,151683,,69,0,"LOCALUL GRADINITEI NR.5, STR CETATEA TURNU NR.3","MUNICIPIUL TURNU MAGURELE",3,151683,1,1,1294,634,581,53,629,5,1394,760,463,166,
36,"TELEORMAN",341,151683,,70,0,"LOCALUL GRADINITEI MAGURELE , STR. LIBERTATII NR.104","MUNICIPIUL TURNU MAGURELE",3,151683,1,1,1436,661,616,45,657,4,1536,875,502,155,
36,"TELEORMAN",341,151683,,71,0,"LOCALUL SCOLII NOI MAGURELE , STR, ALEXANDRU VLAHUTA NR.17","MUNICIPIUL TURNU MAGURELE",3,151683,1,1,1640,808,760,48,797,11,1740,932,599,198,
36,"TELEORMAN",341,151683,,72,0,"LOCALUL SCOLII VECHI MAGURELE , STR. LIBERTATII NR.37","MUNICIPIUL TURNU MAGURELE",3,151683,1,1,1565,905,852,53,888,17,1665,760,600,288,
36,"TELEORMAN",341,151683,,73,1,"CLUBUL SCOLARULUI DIN SOSEAUA ALEXANDRIEI NR.5","MUNICIPIUL TURNU MAGURELE",3,151683,1,1,0,324,0,324,315,9,400,76,205,110,
36,"TELEORMAN",341,151683,,74,1,"SPITALUL TURNU MAGURELE , STR.CASTANILOR NR.42","MUNICIPIUL TURNU MAGURELE",3,151683,1,1,0,180,0,180,178,2,345,165,140,38,
36,"TELEORMAN",341,151905,,75,0,"SCOALA GENERALA NR.3 VIDELE ,STR. PARCULUI NR.21","ORAS VIDELE",4,151905,2,1,1778,903,801,102,893,10,1900,997,615,278,
36,"TELEORMAN",341,151905,,76,0,"CANTINA LICEULUI VIDELE , STR. REPUBLICII NR.7","ORAS VIDELE",4,151905,2,1,1432,909,666,243,902,7,1600,691,593,309,
36,"TELEORMAN",341,151905,,77,0,"CASA DE CULTURA VIDELE , STR FLORILOR NR.34","ORAS VIDELE",4,151905,2,1,1624,765,673,92,755,10,1700,935,505,250,
36,"TELEORMAN",341,151905,,78,0,"SCOALA GENERALA DE 4 ANI FOTACHESTI DE PE SOSEAUA PITESTI NR.69","ORAS VIDELE",4,151905,2,1,884,550,417,133,540,10,1000,450,389,151,
36,"TELEORMAN",341,151905,,79,0,"SCOALA GENERALA DE4 ANI FURCULESTI  , STR. FRASINETULUI NR.6","ORAS VIDELE",4,151905,2,1,1457,758,702,56,743,15,1600,842,516,227,
36,"TELEORMAN",341,151905,,80,0,"SCOALA GENERALA DE 4 ANI CARTOJANCA , STR. PROGRESULUI NR 74","ORAS VIDELE",4,151905,2,1,721,445,405,40,437,8,800,355,287,150,
36,"TELEORMAN",341,151905,,81,0,"SCOALA GENERALA DE 10 ANI TAMASESTI , STR. PLANTELOR NR.69","ORAS VIDELE",4,151905,2,1,759,335,308,27,329,6,900,565,231,98,
36,"TELEORMAN",341,151905,,82,0,"SCOALA GENERALA DE 4 ANI PARISESTI , STR. PLANTELOR NR.173","ORAS VIDELE",4,151905,2,1,553,413,359,54,408,5,600,187,289,119,
36,"TELEORMAN",341,151905,,83,0,"SOALA GENERALA DE 4 ANI SATUL COSOAIA","ORAS VIDELE",4,151905,2,1,380,225,190,35,224,1,447,222,132,92,
36,"TELEORMAN",341,151978,,84,0,"SCOALA GENRALA NR.4 , STR. CETATII","ORAS ZIMNICEA",5,151978,2,1,1459,942,884,58,923,19,1600,658,728,195,
36,"TELEORMAN",341,151978,,85,0,"SCOALA GENERALA NR.4 , STR. TURNU MAGURELE","ORAS ZIMNICEA",5,151978,2,1,1798,1104,1066,38,1087,17,1900,796,847,240,
36,"TELEORMAN",341,151978,,86,0,"GRADINITA DE COPII , STR IMPARATUL TRAIAN","ORAS ZIMNICEA",5,151978,2,1,1566,995,799,196,989,6,1890,895,709,280,
36,"TELEORMAN",341,151978,,87,0,"SCOALA GENERALA NR.3 , BULEVARDUL EROILOR","ORAS ZIMNICEA",5,151978,2,1,1810,824,762,62,816,8,2110,1286,583,233,
36,"TELEORMAN",341,151978,,88,0,"SCOALA GENERALA NR. 1 , STR, PRIMAVERII","ORAS ZIMNICEA",5,151978,2,1,1596,707,657,50,699,8,1690,983,465,234,
36,"TELEORMAN",341,151978,,89,0,"CASA DE CULTURA , STR MIHAI VITEAZUL","ORAS ZIMNICEA",5,151978,2,1,1283,630,582,48,623,7,1320,690,428,195,
36,"TELEORMAN",341,151978,,90,0,"SCOALA GENERALA NR.2 , STR I MAI","ORAS ZIMNICEA",5,151978,2,1,1567,948,915,33,898,17,1700,785,632,266,
36,"TELEORMAN",341,151978,,91,0,"SCOALA GENERALA NR.2 , STR. MIRCEA VODA","ORAS ZIMNICEA",5,151978,2,1,1535,919,863,56,910,9,1675,756,625,285,
36,"TELEORMAN",341,151978,,92,0,"CLUBUL TINERETULUI , STR. PRIMAVERII","ORAS ZIMNICEA",5,151978,2,1,1419,826,768,58,816,10,1566,740,541,275,
36,"TELEORMAN",341,151996,,93,0,"SCOALA GENERALA DIN SATUL BALACI","BALACI",7,151996,0,3,1128,747,652,95,733,14,1200,453,549,184,
36,"TELEORMAN",341,151996,,94,0,"SCOALA GENERALA DIN SATUL TECUCI","BALACI",7,151996,0,3,884,572,458,114,564,8,1021,449,398,166,
36,"TELEORMAN",341,152038,,95,0,"SCOALA VECHE BABAITA","BABAITA",6,152038,0,3,1709,816,753,63,811,5,1891,1075,571,240,
36,"TELEORMAN",341,152038,,96,0,"SCOALA GENERALA FRASINET","BABAITA",6,152038,0,3,1734,738,680,58,730,8,1922,1184,513,217,
36,"TELEORMAN",341,152038,,97,0,"SCOALA GENERALA MERISANI","BABAITA",6,152038,0,3,949,597,547,50,591,6,1046,449,433,158,
36,"TELEORMAN",341,152038,,98,0,"GRADINITA CLANITA","BABAITA",6,152038,0,3,681,372,321,51,363,9,755,383,240,123,
36,"TELEORMAN",341,152083,,99,0,"SCOALA GENERALA BLEBESTI","BLEJESTI",8,152083,0,3,1915,969,827,142,953,16,1600,631,707,246,
36,"TELEORMAN",341,152083,,100,0,"SCOALA GENERALA BACIU","BLEJESTI",8,152083,0,3,960,614,506,108,607,7,1479,865,357,250,
36,"TELEORMAN",341,152083,,101,0,"SCOALA GENERALA SERICU","BLEJESTI",8,152083,0,3,374,223,179,44,219,4,500,277,142,77,
36,"TELEORMAN",341,152127,,102,0,"SCOALA GENERALA BOGDANA","BOGDANA",9,152127,0,3,962,613,468,145,609,4,1027,414,427,182,
36,"TELEORMAN",341,152127,,103,0,"SCOALA GENERALA ULMENI","BOGDANA",9,152127,0,3,752,476,379,97,475,1,887,411,346,129,
36,"TELEORMAN",341,152127,,104,0,"SCOALA GENERALA URLUIU","BOGDANA",9,152127,0,3,753,471,370,101,466,5,797,326,359,107,
36,"TELEORMAN",341,152172,,105,0,"SCOALA GENERALA DE 10 ANI BOTOROAGA","BOTOROAGA",10,152172,0,3,1328,1063,937,126,1047,16,1530,467,754,293,
36,"TELEORMAN",341,152172,,106,0,"SCOALA GENERALA DE 8 ANI CALUGARU","BOTOROAGA",10,152172,0,3,934,891,858,33,881,10,1020,129,742,139,
36,"TELEORMAN",341,152172,,107,0,"SCOALA GENERALA DE 8 ANI TIRNAVA","BOTOROAGA",10,152172,0,3,1484,1200,1128,72,1180,20,1630,430,911,269,
36,"TELEORMAN",341,152172,,108,0,"SCOALA ELEMENTARA DE 4 ANI TUNARI","BOTOROAGA",10,152172,0,3,234,143,129,14,143,0,253,110,108,35,
36,"TELEORMAN",341,152172,,109,0,"SCOALA GENERALA DE 8 ANI VALEA CIRESULUI","BOTOROAGA",10,152172,0,3,1460,1311,1199,112,1287,24,1580,269,1064,223,
36,"TELEORMAN",341,152234,,110,0,"GRADINITA-SAT BRAGADIRU","BRAGADIRU",11,152234,0,3,1384,576,516,60,571,5,1530,954,374,197,
36,"TELEORMAN",341,152234,,111,0,"CAMINUL CULTURAL BRAGADIRU","BRAGADIRU",11,152234,0,3,1334,545,492,53,541,4,1500,955,352,189,
36,"TELEORMAN",341,152234,,112,0,"SCOALA GENERALA NR.2","BRAGADIRU",11,152234,0,3,1299,612,551,61,601,11,1400,788,416,185,
36,"TELEORMAN",341,152252,,113,0,"SCOALA GENERALA CU CLASELE I-VIII BRANCENI","BRANCENI",12,152252,0,3,1273,837,755,82,822,15,1397,560,583,239,
36,"TELEORMAN",341,152252,,114,0,"GRADINITA DE COPII","BRANCENI",12,152252,0,3,1226,795,757,38,740,17,1349,592,531,209,
36,"TELEORMAN",341,152270,,115,0,"CAMINUL CULTURAL-SAT BUJORENI","BUJORENI",13,152270,0,3,604,480,417,63,469,11,687,207,408,61,
36,"TELEORMAN",341,152270,,116,0,"SCOALA ELEMENTARA CLASELE I-IV-SAT PRUNARU","BUJORENI",13,152270,0,3,376,333,248,85,327,6,400,67,238,89,
36,"TELEORMAN",341,152314,,117,0,"SCOALA GENERALA BUJORU","BUJORU",14,152314,0,3,843,448,375,73,444,4,925,477,280,164,
36,"TELEORMAN",341,152314,,118,0,"CAMINUL CULTURAL BUJORU","BUJORU",14,152314,0,3,880,488,405,83,484,4,976,488,308,176,
36,"TELEORMAN",341,152332,,119,0,"CAMINUL CULTURAL","BUZESCU",15,152332,0,3,1071,612,563,49,603,9,1190,578,410,193,
36,"TELEORMAN",341,152332,,120,0,"GRADINITA DE COPII","BUZESCU",15,152332,0,3,1332,737,682,55,730,7,1441,704,513,217,
36,"TELEORMAN",341,152332,,121,0,"SCOALA GENERALA","BUZESCU",15,152332,0,3,1139,976,925,51,969,7,1258,282,749,220,
36,"TELEORMAN",341,152350,,122,0,"SCOALA GENERALA CALINESTI","CALINESTI",16,152350,0,3,1622,1431,1348,83,1426,5,1794,363,1336,90,
36,"TELEORMAN",341,152350,,123,0,"SCOALA GENERALA LICURICIU","CALINESTI",16,152350,0,3,872,763,630,133,762,1,959,196,616,146,
36,"TELEORMAN",341,152350,,124,0,"SCOALA GENERALA COPACEANCA","CALINESTI",16,152350,0,3,842,821,681,140,780,41,923,102,716,64,
36,"TELEORMAN",341,152412,,125,0,"SCOALA GENERALA VECHE , CLS I-VIII-SATUL CALMATUIU","CALMATUIU",17,152412,0,3,788,468,374,94,460,8,867,399,309,151,
36,"TELEORMAN",341,152412,,126,0,"SCOALA GENERAL CLS I-IV-SATUL CARAVANETI","CALMATUIU",17,152412,0,3,335,268,198,70,265,3,370,102,203,62,
36,"TELEORMAN",341,152412,,127,0,"SCOALA GENERALA CLS I-IV- SATUL BUJORU","CALMATUIU",17,152412,0,3,386,320,235,85,304,16,425,105,221,83,
36,"TELEORMAN",341,152412,,128,0,"SCOALA GENERALA CLS I-VIII , SAT N. BALCESCU","CALMATUIU",17,152412,0,3,824,492,397,95,488,4,917,425,325,163,
36,"TELEORMAN",341,152467,,129,0,"SCOALA GENERALA NR.1","CALMATUIU DE SUS",18,152467,0,3,1311,631,534,97,625,6,1442,811,467,158,
36,"TELEORMAN",341,152467,,130,0,"SALA DE FESTIV A FOSTULUI CAP BACALESTI","CALMATUIU DE SUS",18,152467,0,3,1101,591,502,89,580,11,1211,620,374,206,
36,"TELEORMAN",341,152500,,131,0,"SCOALA CERVENIA IN CLADIRI DIFERITE , CORPUL DE CLADIRE SITUAT IN VECIN LOC BAJAN FLOREA","CERVENIA",19,152500,0,3,1519,864,770,94,844,20,1700,836,566,278,
36,"TELEORMAN",341,152500,,132,0,"SCOALA-CORPUL DE CLADIRE SITUAT IN VECINATATEA LOCUITORULUI BOBOC ION","CERVENIA",19,152500,0,3,1254,717,637,80,708,9,1362,645,452,256,
36,"TELEORMAN",341,152528,,133,0,"SCOALA GENERALA NR.1-SAT CIOLANESTI DEAL","CIOLANESTI",20,152528,0,3,1063,569,445,124,557,12,1171,602,404,153,
36,"TELEORMAN",341,152528,,134,0,"SCOALA GENERALA NR.2 , CIOLANESTI DEAL","CIOLANESTI",20,152528,0,3,853,512,387,125,501,11,950,438,438,63,
36,"TELEORMAN",341,152528,,135,0,"SCOALA GENERALA NR. 3 -CIOLANESTI VALE","CIOLANESTI",20,152528,0,3,726,411,352,59,404,7,850,439,311,93,
36,"TELEORMAN",341,152528,,136,0,"SCOALA GENERALA-SAT BALDOVONESTI","CIOLANESTI",20,152528,0,3,505,312,256,56,306,6,500,188,235,71,
36,"TELEORMAN",341,151709,,137,0,"CAMINUL CULTURAL CIUPERCENI","CIUPERCENI",21,151709,0,3,960,603,505,98,597,6,1074,471,358,239,
36,"TELEORMAN",341,151709,,138,0,"SCOALA GENERALA POIANA","CIUPERCENI",21,151709,0,3,735,452,373,79,448,4,800,348,316,132,
36,"TELEORMAN",341,152564,,139,0,"GRADINITA","CONTESTI",22,152564,0,3,1583,919,741,178,913,6,1700,781,695,218,
36,"TELEORMAN",341,152564,,140,0,"SCOALA GENERALA -LOCAL B","CONTESTI",22,152564,0,3,1486,880,740,140,875,5,1681,801,659,216,
36,"TELEORMAN",341,152582,,141,0,"SCOALA GENERALA DE 8 ANI COSMESTI","COSMESTI",23,152582,0,3,894,664,592,72,656,8,975,311,528,128,
36,"TELEORMAN",341,152582,,142,0,"SCOALA GENERALA DE 8 ANI -SAT CIUPERCENI","COSMESTI",23,152582,0,3,1265,900,809,91,890,10,1400,500,685,205,
36,"TELEORMAN",341,151932,,143,0,"GRADINITA DECOPII DIN SATUL CREVENICU","CREVENICU",26,151932,0,3,931,560,500,60,555,5,1019,459,413,142,
36,"TELEORMAN",341,151932,,144,0,"CAMINUL CULTURAL-SAT RADULESTI","CREVENICU",26,151932,0,3,540,391,348,43,384,7,600,209,283,101,
36,"TELEORMAN",341,152617,,145,0,"SCOALA GENERALA CRANGENI","CRANGENI",24,152617,0,3,1794,1142,1101,41,1117,25,2036,894,794,323,
36,"TELEORMAN",341,152617,,146,0,"SCOALA GENERALA BALTA SARATA","CRANGENI",24,152617,0,3,867,651,548,103,640,11,900,249,535,105,
36,"TELEORMAN",341,152617,,147,0,"SCOALA DE 4 ANI-SAT DOROBANTU","CRANGENI",24,152617,0,3,402,333,200,133,330,3,440,107,244,86,
36,"TELEORMAN",341,152662,,148,0,"CAMINUL CULTURAL CRANGU","CRANGU",25,152662,0,3,1304,838,673,165,829,9,1400,562,639,190,
36,"TELEORMAN",341,152662,,149,0,"SCOALA GENERALA DE 8 ANI -DRACEA","CRANGU",25,152662,0,3,1229,687,568,119,683,0,1400,717,514,169,
36,"TELEORMAN",341,152662,,150,0,"SCOALA DE  4 ANI FLORICA","CRANGU",25,152662,0,3,400,299,212,87,292,7,434,135,234,58,
36,"TELEORMAN",341,152724,,151,0,"SCOALA GENERALA DIDESTI","DIDESTI",27,152724,0,3,1232,798,699,99,788,10,1361,563,594,194,
36,"TELEORMAN",341,152760,,152,0,"SCOALA GENERALA NR.1 DOBROTESTI","DOBROTESTI",28,152760,0,3,1594,814,707,107,803,11,1744,930,484,319,
36,"TELEORMAN",341,152760,,153,0,"SCOALA GENERALA NR.2 DOBROTESTI","DOBROTESTI",28,152760,0,3,1472,755,622,133,743,12,1638,883,482,261,
36,"TELEORMAN",341,152760,,154,0,"SCOALA GENERALA NR.3-SAT MERISANI","DOBROTESTI",28,152760,0,3,1167,639,543,96,635,4,1286,647,412,223,
36,"TELEORMAN",341,152797,,155,0,"SCOALA CU CLS I-IV -DRACSENEI","DRACSENEI",29,152797,0,3,1244,877,758,119,859,18,1366,489,685,174,
36,"TELEORMAN",341,152797,,156,0,"SCOALA CU CLS. I-IV -ODOBEASCA","DRACSENEI",29,152797,0,3,486,427,367,60,425,2,532,105,350,75,
36,"TELEORMAN",341,152797,,157,0,"CAMINUL CULTURAL BEUCA","DRACSENEI",29,152797,0,3,1244,758,674,84,745,13,1280,522,483,262,
36,"TELEORMAN",341,152797,,158,0,"CAMINUL CULTURAL PLOPI","DRACSENEI",29,152797,0,3,234,214,155,59,212,2,260,46,139,73,
36,"TELEORMAN",341,152868,,159,0,"SCOALA GENERALA DRAGANESTI-DE  VEDE","DRAGANESTI DE VEDE",30,152868,0,3,1291,632,525,107,624,8,1423,791,422,202,
36,"TELEORMAN",341,152868,,160,0,"SCOALA GENERALA VACARESTI","DRAGANESTI DE VEDE",30,152868,0,3,471,309,232,77,308,1,517,208,241,67,
36,"TELEORMAN",341,152902,,161,0,"GRUPUL SCOLAR AGRICOL-SAT DRAGANESTI VLASCA","DRAGANESTI-VLASCA",31,152902,0,3,2124,978,891,87,969,9,2300,1322,671,298,
36,"TELEORMAN",341,152902,,162,0,"SCOALA GENERALA-SAT DRAGANESTI VLASCA","DRAGANESTI-VLASCA",31,152902,0,3,1146,584,514,70,574,10,1256,672,391,183,
36,"TELEORMAN",341,152902,,163,0,"SCOALA GENERALA DE4 ANI-SAT VACENI","DRAGANESTI-VLASCA",31,152902,0,3,277,181,149,32,180,1,300,119,132,48,
36,"TELEORMAN",341,152902,,164,0,"SCOALA GENERALA -SAT COMOARA","DRAGANESTI-VLASCA",31,152902,0,3,610,425,358,67,417,8,700,275,334,83,
36,"TELEORMAN",341,152948,,165,0,"SCOALA CU CLS. I-VIII-FURCULESTI","FURCULESTI",33,152948,0,3,1496,1089,915,174,1070,19,1600,511,875,195,
36,"TELEORMAN",341,152948,,166,0,"SCOALA CU CLSI-VIII-SPATAREI","FURCULESTI",33,152948,0,3,1047,732,628,104,728,4,1200,468,558,170,
36,"TELEORMAN",341,152948,,167,0,"SCOALA CU CLS I-IV -VOIEVODA","FURCULESTI",33,152948,0,3,663,505,429,76,498,7,730,225,331,167,
36,"TELEORMAN",341,152993,,168,0,"SCOALA GENERALA FRUMOASA","FRUMOASA",32,152993,0,3,1604,951,854,97,945,6,1766,815,652,293,
36,"TELEORMAN",341,152993,,169,0,"SCOALA GENERALA PAULEASCA","FRUMOASA",32,152993,0,3,572,337,297,40,334,3,629,292,219,115,
36,"TELEORMAN",341,153026,,170,0,"SOALA GENERALA GALATENI","GALATENI",34,153026,0,3,1683,585,502,83,580,5,1887,1302,354,226,
36,"TELEORMAN",341,153026,,171,0,"SCOALA GENERALA -BASCOVENI","GALATENI",34,153026,0,3,1027,554,405,149,540,14,1100,546,396,144,
36,"TELEORMAN",341,153062,,172,0,"SCOALA GEBNERALA FARCASANCA","GRATIA",35,153062,0,3,1147,582,513,69,575,7,1269,687,443,132,
36,"TELEORMAN",341,153062,,173,0,"SCOALA GENERALA CIURARI DEAL","GRATIA",35,153062,0,3,1315,603,497,106,597,6,1447,844,413,184,
36,"TELEORMAN",341,151736,,174,0,"SCOALA GENERALA NR.2 , GRADINITA DE COPII -SAT ISLAZ","ISLAZ",36,151736,0,3,1770,1014,920,94,996,18,1952,938,745,251,
36,"TELEORMAN",341,151736,,175,0,"CAMINUL CULTUTRAL-SAT ISLAZ","ISLAZ",36,151736,0,3,1557,854,764,90,835,19,1711,857,572,263,
36,"TELEORMAN",341,151736,,176,0,"SCOALA GENERALA NR.1 , SAT ISLAZ","ISLAZ",36,151736,0,3,940,503,441,62,489,14,1033,530,363,126,
36,"TELEORMAN",341,151736,,177,0,"SCOALA GENERALA -SAT MOLDOVENI","ISLAZ",36,151736,0,3,945,546,483,63,537,9,1040,494,378,159,
36,"TELEORMAN",341,153106,,178,0,"GRADINITA DE COPII","IZVOARELE",37,153106,0,3,1258,1016,898,118,1002,14,1389,373,611,391,
36,"TELEORMAN",341,153106,,179,0,"SCOALA GENERALA","IZVOARELE",37,153106,0,3,1186,889,772,117,875,14,1304,415,572,303,
36,"TELEORMAN",341,153124,,180,0,"PRIMARIA LISA","LISA",38,153124,0,3,1455,918,850,68,908,10,1609,691,783,125,
36,"TELEORMAN",341,153124,,181,0,"PRIMARIA VANATORI","LISA",38,153124,0,3,737,469,423,46,461,8,798,329,347,114,
36,"TELEORMAN",341,151763,,182,0,"SCOALA GENERALA NR.1","LITA",39,151763,0,3,1408,880,736,144,870,10,1576,696,574,296,
36,"TELEORMAN",341,151763,,183,0,"GRADINITA DE COPII NR. 2","LITA",39,151763,0,3,1383,1231,1064,167,1217,14,1500,269,721,496,
36,"TELEORMAN",341,153151,,184,0,"SCOALA GENERALA LUNCA","LUNCA",40,153151,0,3,1220,685,480,205,674,11,1309,624,528,146,
36,"TELEORMAN",341,153151,,185,0,"GRADINITA LUNCA","LUNCA",40,153151,0,3,800,419,262,157,408,11,900,481,279,129,
36,"TELEORMAN",341,153151,,186,0,"SCOALA GENERALA PRUNDU","LUNCA",40,153151,0,3,807,543,416,127,537,6,900,357,424,113,
36,"TELEORMAN",341,153151,,187,0,"SCOALA GENERALA PLEASOV","LUNCA",40,153151,0,3,1006,511,385,126,502,9,1100,589,389,113,
36,"TELEORMAN",341,153151,,188,0,"CAMINUL CULTURAL SAELE","LUNCA",40,153151,0,3,551,437,219,218,429,8,700,263,313,116,
36,"TELEORMAN",341,153151,,189,0,"SCOALA GENERALA SAELE","LUNCA",40,153151,0,3,920,547,345,202,543,4,1000,453,360,183,
36,"TELEORMAN",341,153204,,190,0,"SCOALA GENERALA MAVRODIN  -LOCAL VECHI","MAVRODIN",44,153204,0,3,1473,841,755,86,832,9,1600,759,613,219,
36,"TELEORMAN",341,153204,,191,0,"SCOALA GENERALA MAVRODIN-LOCAL NOU","MAVRODIN",44,153204,0,3,819,486,411,75,481,5,900,414,359,122,
36,"TELEORMAN",341,153204,,192,0,"SCOALA GENERALA NENCIULESTI","MAVRODIN",44,153204,0,3,1772,941,835,106,927,14,2000,1059,647,280,
36,"TELEORMAN",341,153204,,193,0,"SCOALA GENERALA PARUL ROTUND","MAVRODIN",44,153204,0,3,447,311,235,76,309,2,453,142,208,101,
36,"TELEORMAN",341,153240,,194,0,"GRADINITA DE COPII MAGURA","MAGURA",41,153240,0,3,1650,953,843,110,930,23,1737,784,607,323,
36,"TELEORMAN",341,153240,,195,0,"SCOALA GENERALA GURUIENI","MAGURA",41,153240,0,3,927,573,513,60,562,11,1100,527,375,187,
36,"TELEORMAN",341,153277,,196,0,"SCOALA GENERALA NR.1 MALDAENI","MALDAENI",42,153277,0,3,1236,652,552,100,644,8,1274,622,423,221,
36,"TELEORMAN",341,153277,,197,0,"GRADINITA NR.1","MALDAENI",42,153277,0,3,1077,566,483,83,560,6,1178,612,389,171,
36,"TELEORMAN",341,153277,,198,0,"GRADINITA NR.2","MALDAENI",42,153277,0,3,1489,839,743,96,819,20,1750,911,571,248,
36,"TELEORMAN",341,153295,,199,0,"SCOALA GENERALA MERENII DE JOS","MERENI",45,153295,0,3,1605,1603,1437,166,1477,126,1900,297,1081,396,
36,"TELEORMAN",341,153295,,200,0,"SCOALA GENERALA MERENII DE SUS","MERENI",45,153295,0,3,1127,982,841,141,966,16,1114,132,811,155,
36,"TELEORMAN",341,153339,,201,0,"SCOALA VECHE-SAT CERNETU","MARZANESTI",43,153339,0,3,1220,955,790,165,937,18,1337,382,712,225,
36,"TELEORMAN",341,153339,,202,0,"SCOALA GENERALA VALEA PARULUI","MARZANESTI",43,153339,0,3,774,562,437,125,552,10,854,292,395,157,
36,"TELEORMAN",341,153339,,203,0,"SCOALA GENERALA MARZANESTI","MARZANESTI",43,153339,0,3,604,460,365,95,453,7,668,208,285,168,
36,"TELEORMAN",341,153339,,204,0,"SCOALA GENERALA TELEORMANU","MARZANESTI",43,153339,0,3,929,564,448,116,551,13,1025,461,392,159,
36,"TELEORMAN",341,153384,,205,0,"SCOALA GENERALA MOSTENI-LOCAL NOU","MOSTENI",46,153384,0,3,1459,792,728,64,786,6,1617,825,500,286,
36,"TELEORMAN",341,151816,,206,0,"GRADINITA DE COPII NR.1","NANOV",47,151816,0,3,1504,889,861,28,847,14,1600,739,510,337,
36,"TELEORMAN",341,151816,,207,0,"SCOALA GENERALA NR.2","NANOV",47,151816,0,3,1406,796,651,145,784,12,1600,804,534,250,
36,"TELEORMAN",341,153400,,208,0,"SCOALA GENERALA NASTURELU","NASTURELU",48,153400,0,3,1643,937,871,66,933,4,1429,492,617,316,
36,"TELEORMAN",341,153400,,209,0,"SCOALA GENERALA ZIMNICELE","NASTURELU",48,153400,0,3,651,632,396,236,620,12,1100,468,422,198,
36,"TELEORMAN",341,153437,,210,0,"SCOALA GENERALA NECSESTI","NECSESTI",49,153437,0,3,664,447,397,50,438,9,705,258,355,83,
36,"TELEORMAN",341,153437,,211,0,"SCOALA GENERALA GARDESTI","NECSESTI",49,153437,0,3,749,375,333,42,367,8,859,484,257,110,
36,"TELEORMAN",341,153473,,212,0,"SCOALA GENERALA OLTENI","OLTENI",50,153473,0,3,1525,854,716,138,845,9,1685,831,616,229,
36,"TELEORMAN",341,153473,,213,0,"SCOALA GENERALA PERII-BROSTENI","OLTENI",50,153473,0,3,1025,557,452,105,551,6,1128,571,386,165,
36,"TELEORMAN",341,153507,,214,0,"SCOALA GENERALA CU CLS I-VIII , LOCALUL NOU-ORBEASCA DE JOS","ORBEASCA",51,153507,0,3,842,438,303,135,435,3,925,487,284,151,
36,"TELEORMAN",341,153507,,215,0,"SCOALA GENERALA CLS ,I-VIII-LOCALUL NOU-ORBEASCA DE JOS","ORBEASCA",51,153507,0,3,1344,734,555,179,728,6,1485,751,515,213,
36,"TELEORMAN",341,153507,,216,0,"GRADINITA DE COPII-ORBEASCA DE SUS","ORBEASCA",51,153507,0,3,1367,718,568,150,709,9,1342,624,550,159,
36,"TELEORMAN",341,153507,,217,0,"GRADINITA DE COPII-ORBEASCA DE SUS","ORBEASCA",51,153507,0,3,1545,790,637,153,783,7,1700,910,574,209,
36,"TELEORMAN",341,153507,,218,0,"SCOALA GENERALA CLS I-VIII-LOCALUL NOU-LACENI","ORBEASCA",51,153507,0,3,797,566,459,107,561,5,876,310,390,171,
36,"TELEORMAN",341,153507,,219,0,"SCOALA GENERALA CLS I -VIII-LOCALUL NOU LACENI","ORBEASCA",51,153507,0,3,1271,938,828,110,930,8,1404,466,707,223,
36,"TELEORMAN",341,153543,,220,0,"GRADINITA IAS PERETU","PERETU",52,153543,0,3,1105,1093,995,98,1084,9,1200,107,890,194,
36,"TELEORMAN",341,153543,,221,0,"CAMINUL CULTURAL PERETU","PERETU",52,153543,0,3,1442,816,749,67,799,17,1600,784,542,257,
36,"TELEORMAN",341,153543,,222,0,"SCOALA GENERALA PERETU","PERETU",52,153543,0,3,1473,940,890,50,913,26,1600,661,683,230,
36,"TELEORMAN",341,153543,,223,0,"SCOALA GENERALA PERETU","PERETU",52,153543,0,3,1263,909,820,89,903,6,1400,491,691,212,
36,"TELEORMAN",341,153543,,224,0,"SCOALA VECHE PERETU","PERETU",52,153543,0,3,1274,910,845,65,905,5,1434,524,661,244,
36,"TELEORMAN",341,153561,,225,0,"SCOALA GENERALA NR.1 PIATRA","PIATRA",53,153561,0,3,1139,702,596,106,693,9,1300,598,518,175,
36,"TELEORMAN",341,153561,,226,0,"SCOALA GENERALA NR.2 PIATRA","PIATRA",53,153561,0,3,1060,632,521,111,613,19,1200,568,433,180,
36,"TELEORMAN",341,153561,,227,0,"SC AGROZOOTEHNICA SA PIATRA","PIATRA",53,153561,0,3,1008,597,529,68,583,14,1039,442,451,132,
36,"TELEORMAN",341,153589,,228,0,"SCOALA VECHE PIETROSANI","PIETROSANI",54,153589,0,3,1258,596,498,98,583,13,1507,911,317,266,
36,"TELEORMAN",341,153589,,229,0,"SCOALA NOUA PIETROSANI","PIETROSANI",54,153589,0,3,1474,762,651,111,746,16,1507,745,413,333,
36,"TELEORMAN",341,153605,,230,0,"SCOALA GENERALA RASFIRATI PLOSCA","PLOSCA",56,153605,0,3,1484,889,864,25,883,6,1600,711,623,260,
36,"TELEORMAN",341,153605,,231,0,"SCOALA GENERALA CLS I-VIII (SCOALA MARE) PLOSCA","PLOSCA",56,153605,0,3,778,554,473,81,545,9,1041,487,362,183,
36,"TELEORMAN",341,153605,,232,0,"SCOALA GENERALA-DEAL COMUNA PLOSCA","PLOSCA",56,153605,0,3,1412,737,712,25,729,8,1500,763,473,256,
36,"TELEORMAN",341,153605,,233,0,"SCOALA GNERALA-DEAL COMUNA PLOSCA","PLOSCA",56,153605,0,3,1457,847,796,51,836,11,1500,653,574,262,
36,"TELEORMAN",341,153623,,234,0,"SCOALA GENERALA -SATUL PLOPII-SLAVITESTI","PLOPII-SLAVITESTI",55,153623,0,3,697,430,394,36,427,3,700,270,301,126,
36,"TELEORMAN",341,153623,,235,0,"SCOALA GENERALA -SAT BRANCOVEANCA","PLOPII-SLAVITESTI",55,153623,0,3,1086,564,549,15,557,7,1200,636,440,117,
36,"TELEORMAN",341,153623,,236,0,"SCOALA GENERALA-SAT DUDU","PLOPII-SLAVITESTI",55,153623,0,3,732,492,401,91,488,4,794,302,290,198,
36,"TELEORMAN",341,153623,,237,0,"SCOALA GENERALA-SAT BECIU","PLOPII-SLAVITESTI",55,153623,0,3,1329,541,442,99,534,7,1400,859,367,167,
36,"TELEORMAN",341,153623,,238,0,"GRADINITA DE COPII-SAT SMARDAN","PLOPII-SLAVITESTI",55,153623,0,3,356,346,180,166,341,5,400,54,253,88,
36,"TELEORMAN",341,153696,,239,0,"SCOALA GENERALA POENI","POENI",57,153696,0,3,1132,726,602,124,717,9,1249,523,469,248,
36,"TELEORMAN",341,153696,,240,0,"SCOALA GENERALA -SATUL VATASI","POENI",57,153696,0,3,921,472,413,59,469,3,1003,531,339,130,
36,"TELEORMAN",341,153696,,241,0,"SCOALA PRIMARA-SAT CATUNU","POENI",57,153696,0,3,455,283,237,46,280,3,515,232,203,77,
36,"TELEORMAN",341,151834,,242,0,"SCOALA GENERALA -LOCALUL NOU-SAT POROSCHIA","POROSCHIA",58,151834,0,3,1496,904,802,102,893,11,1600,696,604,289,
36,"TELEORMAN",341,151834,,243,0,"SCOALA GENERALA LOCALUL VECHI SAT POROSCHIA","POROSCHIA",58,151834,0,3,1340,841,753,88,830,11,1500,659,551,279,
36,"TELEORMAN",341,151834,,244,0,"SCOALA GENERALA-SAT CALOMFIRESTI","POROSCHIA",58,151834,0,3,966,692,592,100,679,13,1083,391,496,183,
36,"TELEORMAN",341,153829,,245,0,"SCOALA VECHE -SAT PUTINEIU","PUTINEIU",59,153829,0,3,1465,1214,872,342,1198,16,1616,402,961,237,
36,"TELEORMAN",341,153829,,246,0,"GRADINITA DE COPII BADULEASA","PUTINEIU",59,153829,0,3,885,649,466,183,644,5,972,323,488,156,
36,"TELEORMAN",341,153865,,247,0,"SCOALA GENERALA RADOIESTI-VALE","RADOIESTI",60,153865,0,3,1146,879,787,92,853,13,1276,410,757,96,
36,"TELEORMAN",341,153865,,248,0,"SCOALA GENERALA RODOIESTI-DEAL","RADOIESTI",60,153865,0,3,1006,645,574,71,641,4,1100,455,454,187,
36,"TELEORMAN",341,153909,,249,0,"CAMINUL CULTURAL -SALA MICA RASMIRESTI","RASMIRESTI",61,153909,0,3,928,547,440,107,539,8,1024,477,363,176,
36,"TELEORMAN",341,153936,,250,0,"SCOALA GENERALA DE 8 ANI SALCIA","SALCIA",63,153936,0,3,1052,580,469,111,574,6,1160,580,377,197,
36,"TELEORMAN",341,153936,,251,0,"SCOALA GENERALA DE 4 ANI TUDOR VLADIMIRESCU","SALCIA",63,153936,0,3,875,580,461,119,569,11,966,386,356,213,
36,"TELEORMAN",341,153936,,252,0,"CAMINUL CULTURAL-SAT BANEASA","SALCIA",63,153936,0,3,963,631,534,97,627,4,1062,431,432,195,
36,"TELEORMAN",341,153972,,253,0,"SCOALA GENERALA-SAT SACENI","SACENI",62,153972,0,3,771,530,478,52,523,7,811,281,436,87,
36,"TELEORMAN",341,153972,,254,0,"SCOALA GENERALA -SAT CIURARI","SACENI",62,153972,0,3,686,397,347,50,389,8,800,403,266,123,
36,"TELEORMAN",341,154013,,255,0,"CAMINUL CULTURAL-SAT SCRIOASTEA","SCRIOASTEA",65,154013,0,3,1916,1488,1328,160,1465,23,2095,607,1069,396,
36,"TELEORMAN",341,154013,,256,0,"PUNCTUL SANITAR-BREBINA","SCRIOASTEA",65,154013,0,3,707,500,403,97,489,11,800,300,355,134,
36,"TELEORMAN",341,154013,,257,0,"CAMINUL CULTURAL -SAT CUCUIETI","SCRIOASTEA",65,154013,0,3,815,415,348,67,412,3,900,485,297,115,
36,"TELEORMAN",341,154068,,258,0,"SCOALA GENERALA DE 8 ANI -SAT SCURTU MARE","SCURTU MARE",66,154068,0,3,1177,873,784,89,862,11,1300,427,570,292,
36,"TELEORMAN",341,154068,,259,0,"SCOALA GENERALA -SAT DRACESTI","SCURTU MARE",66,154068,0,3,414,302,271,31,292,10,466,164,167,125,
36,"TELEORMAN",341,154068,,260,0,"SCOALA GENERALA-SAT ALBENI","SCURTU MARE",66,154068,0,3,286,244,191,53,241,3,300,56,175,66,
36,"TELEORMAN",341,154139,,261,0,"GRADINITA DE COPII-SAT SEACA","SEACA",67,154139,0,3,1442,815,698,117,803,12,1500,685,590,213,
36,"TELEORMAN",341,154139,,262,0,"GRADINITA DE COPII-SAT NAVODARI","SEACA",67,154139,0,3,943,759,689,70,755,4,1127,368,551,204,
36,"TELEORMAN",341,154166,,263,0,"CAMINUL CULTURAL SFINTESTI","SFINTESTI",69,154166,0,3,1219,688,594,94,680,8,1348,660,464,216,
36,"TELEORMAN",341,154184,,264,0,"SCOALA GENERALA SEGARCEA VALE","SEGARCEA-VALE",68,154184,0,3,1063,725,570,155,720,5,1100,375,505,215,
36,"TELEORMAN",341,154184,,265,0,"SCOALA GENERALA SAT OLTEANCA","SEGARCEA-VALE",68,154184,0,3,920,630,569,61,619,11,1000,370,423,196,
36,"TELEORMAN",341,154184,,266,0,"SCOALA GENERALA SEGARCEA DEAL","SEGARCEA-VALE",68,154184,0,3,1283,773,678,95,753,20,1454,681,415,338,
36,"TELEORMAN",341,154228,,267,0,"SCOALA GENERALA I-VIII , SILISTEA","SILISTEA",70,154228,0,3,1513,1242,1168,74,1202,40,1683,441,969,233,
36,"TELEORMAN",341,154228,,268,0,"SCOALA GENERALA CLS I-VIII PURANII DE SUS","SILISTEA",70,154228,0,3,1308,748,673,75,735,13,1400,652,546,189,
36,"TELEORMAN",341,154228,,269,0,"SCOALA GENERALA CU CLS I-IV SAT BUTESTI","SILISTEA",70,154228,0,3,691,475,424,51,472,3,800,325,356,116,
36,"TELEORMAN",341,154282,,270,0,"GRADINITA DE COPII-SCOALA VECHE-SILISTEA GUMESTI","SILISTEA-GUMESTI",71,154282,0,3,1493,886,772,114,870,16,1604,718,633,237,
36,"TELEORMAN",341,154282,,271,0,"SCOALA GENERALA MAGURA","SILISTEA-GUMESTI",71,154282,0,3,962,546,450,96,539,7,1100,554,418,121,
36,"TELEORMAN",341,154308,,272,0,"SCOALA CU CLASELE I-IV SARBENI","SARBENI",64,154308,0,3,680,335,277,58,332,3,700,365,262,70,
36,"TELEORMAN",341,154308,,273,0,"SCOALA CU CLS I-VIII SARBENI DE JOS","SARBENI",64,154308,0,3,758,346,297,49,342,4,900,554,244,98,
36,"TELEORMAN",341,154344,,274,0,"SCOALA GENERALA SLABOZIA MANDRA , LOCAL B","SLOBOZIA MANDRA",72,154344,0,3,1018,676,526,150,672,4,1100,424,503,169,
36,"TELEORMAN",341,154344,,275,0,"SCOALA GENERALA SLOBOZIA MANDRA , LOCAL A","SLOBOZIA MANDRA",72,154344,0,3,997,736,571,165,731,5,1100,364,573,158,
36,"TELEORMAN",341,154344,,276,0,"CAMINUL CULTURAL UDA CLOCOCIOV","SLOBOZIA MANDRA",72,154344,0,3,891,663,570,93,653,10,1000,337,415,238,
36,"TELEORMAN",341,154344,,277,0,"SCOALA GENERALA UDA PACIUREA","SLOBOZIA MANDRA",72,154344,0,3,954,710,589,121,704,6,1060,350,394,310,
36,"TELEORMAN",341,154380,,278,0,"SCOALA CU CLS I-IV SOIMU","SMARDIOASA",73,154380,0,3,1636,1096,920,176,1079,17,1799,703,761,318,
36,"TELEORMAN",341,154380,,279,0,"SCOALA GENERALA CU CLS I-VIII SMARDIOASA","SMARDIOASA",73,154380,0,3,441,431,333,98,427,4,486,55,268,159,
36,"TELEORMAN",341,154415,,280,0,"CAMINUL CULTURAL STEJARU","STEJARU",74,154415,0,3,850,585,466,119,578,7,939,354,442,136,
36,"TELEORMAN",341,154415,,281,0,"SCOALA CU CLS I-IV SOCETU","STEJARU",74,154415,0,3,803,555,461,94,549,6,910,355,439,110,
36,"TELEORMAN",341,154415,,282,0,"FOSTA PRIMARIE BRATCOV","STEJARU",74,154415,0,3,169,170,141,29,168,2,186,16,113,55,
36,"TELEORMAN",341,154460,,283,0,"SCOALA VECHE SUHAIA","SUHAIA",76,154460,0,3,1237,719,626,93,709,10,1362,643,505,204,
36,"TELEORMAN",341,154460,,284,0,"SCOALA VECHE SUHAIA","SUHAIA",76,154460,0,3,1311,708,642,66,704,4,1448,740,512,192,
36,"TELEORMAN",341,154460,,285,0,"GRADINITA FANTANELE","SUHAIA",76,154460,0,3,1720,900,810,90,891,9,1899,999,620,271,
36,"TELEORMAN",341,154497,,286,0,"SCOALA CU CLS I-VIII STOROBANEASA","STOROBANEASA",75,154497,0,3,1584,1024,924,100,973,21,1747,753,687,286,
36,"TELEORMAN",341,154497,,287,0,"SCOALA CLS I-VIII BEIU","STOROBANEASA",75,154497,0,3,1544,959,881,78,944,15,1711,752,743,201,
36,"TELEORMAN",341,154521,,288,0,"SCOALA GENERALA CU CLSI-VIII -TALPA OGRAZILE","TALPA",77,154521,0,3,1085,572,503,69,557,15,1211,639,398,159,
36,"TELEORMAN",341,154521,,289,0,"ACOALA GENERALA CU CLS I-VIII -TALPA BASCOVENI","TALPA",77,154521,0,3,907,468,450,18,457,11,1000,532,378,79,
36,"TELEORMAN",341,154585,,290,0,"CAMINUL CULTURAL TATARASTII DE JOS","TATARASTII DE JOS",78,154585,0,3,1529,914,776,138,897,17,1697,783,685,212,
36,"TELEORMAN",341,154585,,291,0,"SCOALA CU CLS I-VIII-SLAVESTI","TATARASTII DE JOS",78,154585,0,3,979,740,649,91,738,2,1103,363,544,194,
36,"TELEORMAN",341,154585,,292,0,"SCOALA CU CLS I-VIII -SAT NEGRENI","TATARASTII DE JOS",78,154585,0,3,1125,758,666,92,742,16,1200,442,549,193,
36,"TELEORMAN",341,154665,,293,0,"SCOALA CU CLS I-IV -TATARASTII DE SUS","TATARASTII DE SUS",79,154665,0,3,1272,845,661,184,824,21,1403,558,656,168,
36,"TELEORMAN",341,154665,,294,0,"SCOALA CU CLS I-IV -SAT UDUPU","TATARASTII DE SUS",79,154665,0,3,1385,881,681,200,867,14,1531,650,698,169,
36,"TELEORMAN",341,154736,,295,0,"SCOALA CU CLS I-IV -COMUNA TRAIAN","TRAIAN",81,154736,0,3,908,504,416,88,501,3,912,408,332,169,
36,"TELEORMAN",341,154736,,296,0,"SCOALA GENERALA  DE 8 ANI-COMUNA TRAIAN","TRAIAN",81,154736,0,3,1002,600,512,88,592,8,1200,600,404,188,
36,"TELEORMAN",341,154754,,297,0,"SCOALA GENERALA DE 8 ANI-SATUL TRIVALEA","TRIVALEA-MOSTENI",82,154754,0,3,881,722,606,116,651,71,1000,278,533,118,
36,"TELEORMAN",341,154754,,298,0,"SCOALA GENERALA DE 8 ANI-SATUL BRATASANI","TRIVALEA-MOSTENI",82,154754,0,3,742,661,595,66,658,3,900,239,572,86,
36,"TELEORMAN",341,154754,,299,0,"SCOALA GENERALA-SATUL SCHELA","TRIVALEA-MOSTENI",82,154754,0,3,1163,666,580,86,658,8,1166,500,520,138,
36,"TELEORMAN",341,154790,,300,0,"SCOALA GENERALA NR1-CENTRU , COMUNA TROIANUL","TROIANUL",83,154790,0,3,1667,1056,917,139,1044,12,1791,735,769,275,
36,"TELEORMAN",341,154790,,301,0,"SCOALA GENERALA NR 2 , RASFIRATI , COMUNA TROIANUL","TROIANUL",83,154790,0,3,1211,975,857,118,957,18,1311,336,697,260,
36,"TELEORMAN",341,154790,,302,0,"SCOALA GENERALA VATRA , SATUL VATRA","TROIANUL",83,154790,0,3,236,217,177,40,214,3,326,109,164,50,
36,"TELEORMAN",341,154834,,303,0,"SCOALA GENERALA CU CLSI-IV -COMUNA TIGANESTI","TIGANESTI",80,154834,0,3,1548,1079,989,90,1069,10,1706,627,887,182,
36,"TELEORMAN",341,154834,,304,0,"GRADINITA DE COPII-PRIMARIE-COMUNA TIGANESTI","TIGANESTI",80,154834,0,3,1651,1012,923,89,1004,8,1821,809,716,288,
36,"TELEORMAN",341,154834,,305,0,"SCOALA GENERALA I. GH. DUCA-COMUNA TIGANESTI","TIGANESTI",80,154834,0,3,1524,1112,1003,109,1095,17,1680,568,721,374,
36,"TELEORMAN",341,154852,,306,0,"SCOALA GENERALA DE 8 ANI COMUNA VEDEA","VEDEA",85,154852,0,3,997,676,593,83,666,10,1099,423,477,189,
36,"TELEORMAN",341,154852,,307,0,"SCOALA GENERALA CU CLS I-IV SAT ALBESTI","VEDEA",85,154852,0,3,1218,678,633,45,670,8,1350,672,544,126,
36,"TELEORMAN",341,154852,,308,0,"SCOALA CU CLS I-IV -SATUL COSOTENI","VEDEA",85,154852,0,3,483,308,270,38,302,6,533,225,187,115,
36,"TELEORMAN",341,154914,,309,0,"SCOALA GENERALA-COMUNA VIISOARA","VIISOARA",86,154914,0,3,1083,625,554,71,618,7,1200,575,358,260,
36,"TELEORMAN",341,154914,,310,0,"GRADINITA DE COPII -COMUNA VIISOARA","VIISOARA",86,154914,0,3,811,579,508,71,564,15,912,333,309,255,
36,"TELEORMAN",341,153776,,311,0,"SCOALA GENERALA CU CLS I-IV SATUL PURANI","VITANESTI",87,153776,0,3,615,457,365,92,453,4,700,243,320,133,
36,"TELEORMAN",341,153776,,312,0,"SCOALA GENERALA DE 8 ANI -SAT SILISTEA","VITANESTI",87,153776,0,3,1007,622,530,92,616,6,1100,478,396,220,
36,"TELEORMAN",341,153776,,313,0,"SCOALA GENERALA CU CLS I-IV -COMUNA VITANESTI","VITANESTI",87,153776,0,3,953,611,520,91,604,7,1045,434,476,128,
36,"TELEORMAN",341,154932,,314,0,"CAMINUL CULTURAL-SAT VARTOAPELE DE SUS","VARTOAPE",84,154932,0,3,1042,600,495,105,578,22,1038,438,427,151,
36,"TELEORMAN",341,154932,,315,0,"CAMINUL CULTURAL -SATUL VARTOAPELE DE JOS","VARTOAPE",84,154932,0,3,927,700,621,79,675,25,1000,300,366,309,
36,"TELEORMAN",341,154932,,316,0,"FOSTA PROIMARIE -SATUL GARAGAU","VARTOAPE",84,154932,0,3,697,496,422,74,484,12,900,404,364,120,
36,"TELEORMAN",341,154978,,317,0,"CAMINUL CULTURAL -COMUNA ZAMBREASCA","ZAMBREASCA",88,154978,0,3,1108,884,791,93,868,16,1200,316,636,232,
36,"TELEORMAN",341,154978,,318,0,"SCOALA CU CLS I-IV COMUNA ZAMBREASCA","ZAMBREASCA",88,154978,0,3,634,453,396,57,451,2,634,181,365,86,
37,"TIMIS",350,155243,,1,0,"UNIVERSITATEA DE MEDICINA, PIATA E. MURGU NR.2","MUNICIPIUL TIMISOARA",1,155243,1,1,1327,808,704,104,788,20,1500,692,640,148,
37,"TIMIS",350,155243,,2,0,"UNIVERSITATEA DE MEDICINA, CAMINUL DE FETE, PIATA E. MURGU NR4","MUNICIPIUL TIMISOARA",1,155243,1,1,1380,1065,625,440,1039,26,1400,335,774,265,
37,"TIMIS",350,155243,,3,0,"LICEUL TEORETIC ""N. LENAU"", STR. GH. LAZAR NR.2","MUNICIPIUL TIMISOARA",1,155243,1,1,1056,508,470,38,489,19,1200,692,395,94,
37,"TIMIS",350,155243,,4,0,"LICEUL PEDAGOGIC ""E. MURGU"", B-DUL C.D. LOGA NR 45","MUNICIPIUL TIMISOARA",1,155243,1,1,1001,555,459,96,532,23,1200,645,457,75,
37,"TIMIS",350,155243,,5,0,"GRUPUL SC. IND.""E. UNGUREANU"", PIATA IANCU HUNIADE NR.3","MUNICIPIUL TIMISOARA",1,155243,1,1,1098,624,531,93,600,24,1300,676,475,125,
37,"TIMIS",350,155243,,6,0,"LICEUL TEORETIC ""N. LENAU"", STR. GH. LAZAR NR.2","MUNICIPIUL TIMISOARA",1,155243,1,1,1030,518,429,89,510,8,1200,682,398,112,
37,"TIMIS",350,155243,,7,0,"LICEUL TEORETIC ""N. LENAU"", STR. GHE. LAZAR NR2","MUNICIPIUL TIMISOARA",1,155243,1,1,1354,582,489,93,563,19,1500,918,374,189,
37,"TIMIS",350,155243,,8,0,"GRUP SCOLAR INDUSTRIAL ""HENRY COANDA"", STR. CORIOLAN BREDICEANU NR.37","MUNICIPIUL TIMISOARA",1,155243,1,1,1084,522,411,111,514,8,1200,678,411,103,
37,"TIMIS",350,155243,,9,0,"GRUP SCOLAR INDUSTRIAL ""HENRY COANDA"", STR. CORIOLAN BREDICEANU NR.37","MUNICIPIUL TIMISOARA",1,155243,1,1,1415,596,540,56,589,7,1600,1004,438,151,
37,"TIMIS",350,155243,,10,0,"UNIVERSITATEA TEHNICA, PIATA HORATIU NR.1","MUNICIPIUL TIMISOARA",1,155243,1,1,1234,699,643,56,684,15,1400,701,545,139,
37,"TIMIS",350,155243,,11,0,"CASA ""ADAM M. GUTTENBRUNN"", STR. GH. LAZAR NR.10","MUNICIPIUL TIMISOARA",1,155243,1,1,937,634,479,155,626,8,1000,366,501,125,
37,"TIMIS",350,155243,,12,0,"SCOALA GENERALA NR.16, STR. BUCURESTI NR1","MUNICIPIUL TIMISOARA",1,155243,1,1,831,486,445,41,476,10,900,414,396,80,
37,"TIMIS",350,155243,,13,0,"SCOALA GENERALA NR.16, STR. BUCURESTI NR1","MUNICIPIUL TIMISOARA",1,155243,1,1,1236,720,667,53,704,16,1402,682,610,94,
37,"TIMIS",350,155243,,14,0,"SCOALA GENERALA NR.16, STR. BUCURESTI NR1","MUNICIPIUL TIMISOARA",1,155243,1,1,680,425,344,81,415,10,700,275,330,85,
37,"TIMIS",350,155243,,15,0,"SCOALA GENERALA NR.16, STR. BUCURESTI NR1","MUNICIPIUL TIMISOARA",1,155243,1,1,1028,628,599,29,617,11,1200,572,492,125,
37,"TIMIS",350,155243,,16,0,"SEDIUL R.A.T.T.,B-DUL TAKE IONESCU NR.56","MUNICIPIUL TIMISOARA",1,155243,1,1,1020,582,468,114,572,10,1181,599,429,143,
37,"TIMIS",350,155243,,17,0,"GRADINITA NR.48, STR. DRAGASANI NR1","MUNICIPIUL TIMISOARA",1,155243,1,1,1081,526,475,51,513,13,1200,674,374,139,
37,"TIMIS",350,155243,,18,0,"CLUBUL R.A.T.T., STR. AVRAM IMBROANE NR.54","MUNICIPIUL TIMISOARA",1,155243,1,1,398,167,128,39,163,4,400,233,102,61,
37,"TIMIS",350,155243,,19,0,"GRUPUL SC. ENERGETIC, STR. RENASTERII NR.42A","MUNICIPIUL TIMISOARA",1,155243,1,1,1422,703,536,167,686,17,1600,897,458,228,
37,"TIMIS",350,155243,,20,0,"SCOALA GEN. NR.21, STR. MIHAI KOGALNICEANU NR.4","MUNICIPIUL TIMISOARA",1,155243,1,1,1366,635,567,68,617,18,1500,865,399,218,
37,"TIMIS",350,155243,,21,0,"SCOALA GEN. NR.21, STR. MIHAI KOGALNICEANU NR.4","MUNICIPIUL TIMISOARA",1,155243,1,1,1621,753,629,124,737,16,1800,1047,490,247,
37,"TIMIS",350,155243,,22,0,"SCOALA GEN. NR.21, BV. SIMION BARNUTIU NR.9","MUNICIPIUL TIMISOARA",1,155243,1,1,1824,783,701,82,768,15,2000,1217,539,229,
37,"TIMIS",350,155243,,23,0,"SCOALA GEN. NR.21, BV. SIMION BARNUTIU NR.9","MUNICIPIUL TIMISOARA",1,155243,1,1,1184,587,477,110,574,13,1300,713,375,199,
37,"TIMIS",350,155243,,24,0,"S.C.""MECTRANS"" SA, STR. I.I.DE LA BRAD NR.13","MUNICIPIUL TIMISOARA",1,155243,1,1,1647,534,437,97,522,12,1800,1266,327,195,
37,"TIMIS",350,155243,,25,0,"SCOALA GEN. NR.7, STR. I.I.DE LA BRAD NR.2","MUNICIPIUL TIMISOARA",1,155243,1,1,1772,610,485,125,591,19,1900,1290,354,237,
37,"TIMIS",350,155243,,26,0,"S.C.""COMAT"" SA TIMISOARA, STR. I.I.DE LA BRAD NR.15","MUNICIPIUL TIMISOARA",1,155243,1,1,1626,635,517,118,621,14,1800,1165,358,263,
37,"TIMIS",350,155243,,27,0,"GRADINITA NR.37, CALEA ARADULUI NR.38, BLOC 21","MUNICIPIUL TIMISOARA",1,155243,1,1,1667,702,586,116,687,15,1800,1098,513,174,
37,"TIMIS",350,155243,,28,0,"SCOALA GENERALA NR.7, STR. I.I.DE LA BRAD NR.2","MUNICIPIUL TIMISOARA",1,155243,1,1,2056,881,721,160,864,17,2200,1319,603,261,
37,"TIMIS",350,155243,,29,0,"SCOALA GENERALA NR.7, STR. I.I.DE LA BRAD NR.2","MUNICIPIUL TIMISOARA",1,155243,1,1,1426,659,368,291,647,12,1600,941,368,279,
37,"TIMIS",350,155243,,30,0,"SCOALA GENERALA NR.7, STR. I.I.DE LA BRAD NR.2","MUNICIPIUL TIMISOARA",1,155243,1,1,1280,519,249,270,506,13,1400,881,318,188,
37,"TIMIS",350,155243,,31,0,"SCOALA GENERALA NR.7, STR. I.I.DE LA BRAD NR.2","MUNICIPIUL TIMISOARA",1,155243,1,1,943,536,328,208,523,13,1000,464,298,225,
37,"TIMIS",350,155243,,32,0,"GRADINITA CU PROGRAM PRELUNGIT NR20, STR. IRLANDA NR.53","MUNICIPIUL TIMISOARA",1,155243,1,1,1814,969,586,383,938,31,2000,1031,603,335,
37,"TIMIS",350,155243,,33,0,"GRADINITA CU PROGRAM PRELUNGIT NR20, STR. IRLANDA NR.53","MUNICIPIUL TIMISOARA",1,155243,1,1,2114,837,731,106,814,23,1900,1063,546,268,
37,"TIMIS",350,155243,,34,0,"SCOALA GENERALA NR.7, ALEEA LIREI NR.4","MUNICIPIUL TIMISOARA",1,155243,1,1,1018,439,310,129,432,7,1200,761,218,214,
37,"TIMIS",350,155243,,35,0,"SCOALA GENERALA NR.7, ALEEA LIREI NR.4","MUNICIPIUL TIMISOARA",1,155243,1,1,1114,645,510,135,632,13,1300,655,327,305,
37,"TIMIS",350,155243,,36,0,"CAMINUL CULTURAL, CALEA LIPOVEI","MUNICIPIUL TIMISOARA",1,155243,1,1,472,309,164,145,301,8,500,191,200,101,
37,"TIMIS",350,155243,,37,0,"GRADINITA CU PROGRAM PRELUNGIT NR.47, INTRAREA LIREI NR.4","MUNICIPIUL TIMISOARA",1,155243,1,1,1290,533,464,69,524,9,1400,867,373,151,
37,"TIMIS",350,155243,,38,0,"GRADINITA CU PROGRAM PRELUNGIT NR.47, INTRAREA LIREI NR.4","MUNICIPIUL TIMISOARA",1,155243,1,1,1382,565,513,52,554,11,1500,935,330,224,
37,"TIMIS",350,155243,,39,0,"GARAJ ""COMTIM"", B-DUL. CETATII","MUNICIPIUL TIMISOARA",1,155243,1,1,1752,803,705,98,788,15,1900,1097,540,248,
37,"TIMIS",350,155243,,40,0,"R.A. ""SALUBRITATE"", STR. IALOMITA, NR.17","MUNICIPIUL TIMISOARA",1,155243,1,1,1343,594,526,68,579,15,1500,906,387,192,
37,"TIMIS",350,155243,,41,0,"S.C. RETIM S.A., STR. IALOMITA, NR.17","MUNICIPIUL TIMISOARA",1,155243,1,1,1304,474,421,53,463,8,1500,1029,334,129,
37,"TIMIS",350,155243,,42,0,"S.C. U.T.T - CALEA ARADULUI NR.48","MUNICIPIUL TIMISOARA",1,155243,1,1,2094,943,817,126,921,22,2200,1257,618,303,
37,"TIMIS",350,155243,,43,0,"GRADINITA NR.37, CALEA ARADULUI NR 38, BLOC 21","MUNICIPIUL TIMISOARA",1,155243,1,1,182,82,47,35,81,1,200,118,54,27,
37,"TIMIS",350,155243,,44,0,"GRUP SCOLAR AGRICOL, CALEA ARADULUI NR.56","MUNICIPIUL TIMISOARA",1,155243,1,1,1841,783,704,79,777,6,2000,1217,523,254,
37,"TIMIS",350,155243,,45,0,"GRUP SCOLAR AGRICOL, CALEA ARADULUI NR.56","MUNICIPIUL TIMISOARA",1,155243,1,1,1684,751,574,177,731,20,1792,1041,466,265,
37,"TIMIS",350,155243,,46,0,"GRUP SCOLAR AGRICOL, CALEA ARADULUI NR.56","MUNICIPIUL TIMISOARA",1,155243,1,1,1813,750,699,51,734,16,2000,1250,542,192,
37,"TIMIS",350,155243,,47,0,"GRADINITA NR.37, STR. SOMNULUI NR.13","MUNICIPIUL TIMISOARA",1,155243,1,1,1382,633,572,61,626,7,1500,867,384,242,
37,"TIMIS",350,155243,,48,0,"GRADINITA CU PROGRAM PRELUNGIT NR27, STR. BRANDUSEI NR.15","MUNICIPIUL TIMISOARA",1,155243,1,1,1395,665,607,58,650,15,1500,835,475,175,
37,"TIMIS",350,155243,,49,0,"GRADINITA CU PROGRAM PRELUNGIT NR27, STR. BRANDUSEI NR.15","MUNICIPIUL TIMISOARA",1,155243,1,1,1288,592,542,50,574,18,1400,808,438,136,
37,"TIMIS",350,155243,,50,0,"SCOALA GENERALA NR.19 ""AVRAM IANCU"", BD. CETATII NR.24","MUNICIPIUL TIMISOARA",1,155243,1,1,1331,548,488,60,532,16,1500,952,361,171,
37,"TIMIS",350,155243,,51,0,"GRADINITA CU PROGRAM NORMAL NR29, P-TA AVRAM IANCU, NR.15","MUNICIPIUL TIMISOARA",1,155243,1,1,1186,522,404,118,504,18,1300,778,357,147,
37,"TIMIS",350,155243,,52,0,"SCOALA GENERALA NR.24, STR. BRANDUSEI NR.7","MUNICIPIUL TIMISOARA",1,155243,1,1,1581,740,695,45,714,26,1700,960,562,152,
37,"TIMIS",350,155243,,53,0,"SCOALA GENERALA NR.24, STR. BRANDUSEI NR.7","MUNICIPIUL TIMISOARA",1,155243,1,1,1658,874,789,85,845,29,1800,926,672,173,
37,"TIMIS",350,155243,,54,0,"SCOALA GENERALA NR.24, STR. BRANDUSEI NR.7","MUNICIPIUL TIMISOARA",1,155243,1,1,1395,607,547,60,597,10,1500,893,420,177,
37,"TIMIS",350,155243,,55,0,"SCOALA GENERALA NR.24, STR. BRANDUSEI NR.7","MUNICIPIUL TIMISOARA",1,155243,1,1,1110,574,523,51,565,9,1300,726,415,150,
37,"TIMIS",350,155243,,56,0,"SCOALA GENERALA NR.26, STR. ULMULUI NR.2","MUNICIPIUL TIMISOARA",1,155243,1,1,1177,559,487,72,544,15,1300,741,380,164,
37,"TIMIS",350,155243,,57,0,"SCOALA GENERALA NR.26, STR. ULMULUI NR.2","MUNICIPIUL TIMISOARA",1,155243,1,1,831,402,366,36,386,16,900,498,307,79,
37,"TIMIS",350,155243,,58,0,"SCOALA GENERALA NR.26, STR. ULMULUI NR.2","MUNICIPIUL TIMISOARA",1,155243,1,1,1563,662,526,136,648,14,1700,1038,499,149,
37,"TIMIS",350,155243,,59,0,"SCOALA GENERALA NR.26, STR. ULMULUI NR.2","MUNICIPIUL TIMISOARA",1,155243,1,1,1587,640,598,42,620,20,1700,1060,442,178,
37,"TIMIS",350,155243,,60,0,"SCOALA GENERALA NR.18, STR. AMFOREI NR.6","MUNICIPIUL TIMISOARA",1,155243,1,1,717,399,326,73,388,11,800,401,288,100,
37,"TIMIS",350,155243,,61,0,"SCOALA GENERALA NR.18, STR. AMFOREI NR.6","MUNICIPIUL TIMISOARA",1,155243,1,1,1294,644,594,50,625,19,1400,756,485,140,
37,"TIMIS",350,155243,,62,0,"SCOALA GENERALA NR.18, STR. AMFOREI NR.6","MUNICIPIUL TIMISOARA",1,155243,1,1,1183,564,533,31,539,25,1300,736,406,133,
37,"TIMIS",350,155243,,63,0,"CLUBUL SPORTIV SCOLAR NR.1, STR. AMFOREI NR.4","MUNICIPIUL TIMISOARA",1,155243,1,1,1054,578,511,67,564,14,1200,622,413,151,
37,"TIMIS",350,155243,,64,0,"GRADINITA NR.36, STR. TEIULUI NR.5","MUNICIPIUL TIMISOARA",1,155243,1,1,1459,718,643,75,698,20,1600,882,531,167,
37,"TIMIS",350,155243,,65,0,"SCOALA GENERALA NR.19 "" AVRAM IANCU"", B-DUL CETATII NR.24","MUNICIPIUL TIMISOARA",1,155243,1,1,1320,685,628,57,668,17,1500,815,538,130,
37,"TIMIS",350,155243,,66,0,"SCOALA GENERALA NR.19 "" AVRAM IANCU"", B-DUL CETATII NR.24","MUNICIPIUL TIMISOARA",1,155243,1,1,1426,751,700,51,725,26,1600,849,576,149,
37,"TIMIS",350,155243,,67,0,"SCOALA GENERALA NR.19 "" AVRAM IANCU"", B-DUL CETATII NR.24","MUNICIPIUL TIMISOARA",1,155243,1,1,980,586,494,92,576,10,1000,414,460,116,
37,"TIMIS",350,155243,,68,0,"CASIERIA DIRECTIEI PATRIMONIU, STR AMFOREI","MUNICIPIUL TIMISOARA",1,155243,1,1,1348,638,593,45,627,11,1500,862,449,178,
37,"TIMIS",350,155243,,69,0,"GRADINITA CU PROGRAM PRELUNGIT NR26, STR. TEIULUI NR.3","MUNICIPIUL TIMISOARA",1,155243,1,1,781,475,381,94,461,14,800,325,359,102,
37,"TIMIS",350,155243,,70,0,"GRADINITA CU PROGRAM PRELUNGIT NR26, STR. TEIULUI NR.3","MUNICIPIUL TIMISOARA",1,155243,1,1,1161,670,538,132,649,21,1300,630,509,140,
37,"TIMIS",350,155243,,71,0,"GRADINITA CU PROGRAM PRELUNGIT NR26, STR. TEIULUI NR.3","MUNICIPIUL TIMISOARA",1,155243,1,1,1056,435,413,22,428,7,1200,765,308,120,
37,"TIMIS",350,155243,,72,0,"GRADINITA CU PROGRAM PRELUNGIT NR26, STR. CRISAN NR.23","MUNICIPIUL TIMISOARA",1,155243,1,1,1483,732,645,87,713,19,1600,868,464,249,
37,"TIMIS",350,155243,,73,0,"GRADINITA CU PROGRAM PRELUNGIT NR26, STR. CRISAN NR.23","MUNICIPIUL TIMISOARA",1,155243,1,1,1768,870,692,178,854,16,1900,1030,573,281,
37,"TIMIS",350,155243,,74,0,"CLUBUL ELECTROMOTOR, SPLAIUL N. TITULESCU","MUNICIPIUL TIMISOARA",1,155243,1,1,1715,754,653,101,740,14,1900,1146,504,236,
37,"TIMIS",350,155243,,75,0,"BIROUL LOCUINTE - DIRECTIA PATRIMONIU, STR. OITUZ NR.1","MUNICIPIUL TIMISOARA",1,155243,1,1,1296,679,588,91,659,20,1400,721,507,152,
37,"TIMIS",350,155243,,76,0,"GRUP SCOLAR DE INDUSTRIE ALIMENTARA, CALEA BOGDANESTILOR NR.32A","MUNICIPIUL TIMISOARA",1,155243,1,1,1600,752,598,154,735,17,1800,1048,524,211,
37,"TIMIS",350,155243,,77,0,"GRUP SCOLAR DE INDUSTRIE ALIMENTARA, CALEA BOGDANESTILOR NR.32A","MUNICIPIUL TIMISOARA",1,155243,1,1,805,430,327,103,426,4,900,470,307,119,
37,"TIMIS",350,155243,,78,0,"GRUP SCOLAR DE ARTE SI MESERII""SPIRU HARET"", CALEA BOGDANESTILOR NR.32A","MUNICIPIUL TIMISOARA",1,155243,1,1,1195,533,458,75,528,5,1300,767,366,162,
37,"TIMIS",350,155243,,79,0,"GRUP SCOLAR DE ARTE SI MESERII""SPIRU HARET"", CALEA BOGDANESTILOR NR.32A","MUNICIPIUL TIMISOARA",1,155243,1,1,1049,472,404,68,466,3,1206,737,300,166,
37,"TIMIS",350,155243,,80,0,"GRUP SCOLAR ""TUDOR TANASESCU"", STR LORENA NR.35","MUNICIPIUL TIMISOARA",1,155243,1,1,1523,659,623,36,649,10,1700,1041,434,215,
37,"TIMIS",350,155243,,81,0,"GRUP SCOLAR ""TUDOR TANASESCU"", STR LORENA NR.35","MUNICIPIUL TIMISOARA",1,155243,1,1,987,514,329,185,508,6,1000,486,327,181,
37,"TIMIS",350,155243,,82,0,"GRUP SCOLAR ""TUDOR TANASESCU"", STR LORENA NR.35","MUNICIPIUL TIMISOARA",1,155243,1,1,1146,530,447,83,520,10,1300,770,378,142,
37,"TIMIS",350,155243,,83,0,"GRUP SCOLAR ""TUDOR TANASESCU"", STR LORENA NR.35","MUNICIPIUL TIMISOARA",1,155243,1,1,1044,363,296,67,355,8,1200,837,251,104,
37,"TIMIS",350,155243,,84,0,"S.C. U.M.T. S.A., STR. IMBROANE(ALEEA C.F.R.), NR.2A","MUNICIPIUL TIMISOARA",1,155243,1,1,2275,1114,951,163,1078,36,2400,1286,519,559,
37,"TIMIS",350,155243,,85,0,"S.C. ""SERVCON"" S.A., STR. I.I. DE LA BRAD NR. 29A","MUNICIPIUL TIMISOARA",1,155243,1,1,1834,613,450,163,599,14,2000,1387,370,229,
37,"TIMIS",350,155243,,86,0,"SCOALA GENERALA NR.11, STR TACIT 23","MUNICIPIUL TIMISOARA",1,155243,1,1,1237,630,549,81,611,19,1400,770,396,215,
37,"TIMIS",350,155243,,87,0,"SCOALA GENERALA NR.11, STR TACIT 23","MUNICIPIUL TIMISOARA",1,155243,1,1,1451,703,589,114,684,19,1600,897,365,319,
37,"TIMIS",350,155243,,88,0,"SCOALA GENERALA NR.11, STR. RAZBOIENI NR.2","MUNICIPIUL TIMISOARA",1,155243,1,1,993,481,420,61,466,15,1000,519,291,175,
37,"TIMIS",350,155243,,89,0,"SCOALA GENERALA NR.9,(4 ANI) STR APRODUL MOVILA NR.10","MUNICIPIUL TIMISOARA",1,155243,1,1,1142,509,470,39,495,14,1299,790,338,157,
37,"TIMIS",350,155243,,90,0,"SCOALA GENERALA NR.9,(4 ANI) STR APRODUL MOVILA NR.10","MUNICIPIUL TIMISOARA",1,155243,1,1,1605,718,661,57,700,18,1800,1082,477,223,
37,"TIMIS",350,155243,,91,0,"SCOALA GENERALA NR.9,(4 ANI) STR APRODUL MOVILA NR.10","MUNICIPIUL TIMISOARA",1,155243,1,1,1688,659,584,75,641,18,1800,1141,340,301,
37,"TIMIS",350,155243,,92,0,"CANTINA CFR, B-DUL G-RAL ION DRAGALINA NR.71/A","MUNICIPIUL TIMISOARA",1,155243,1,1,1126,741,638,103,714,27,1400,659,543,171,
37,"TIMIS",350,155243,,93,0,"CANTINA CFR, B-DUL G-RAL ION DRAGALINA NR.71/A","MUNICIPIUL TIMISOARA",1,155243,1,1,833,348,274,74,344,4,900,552,237,107,
37,"TIMIS",350,155243,,94,0,"GRUPUL SCOLAR INDUSTRIAL DE CONSTRUCTII MONTAJ, B-DUL G-RAL ION DRAGALINA NR.8","MUNICIPIUL TIMISOARA",1,155243,1,1,1485,726,639,87,707,19,1600,874,539,168,
37,"TIMIS",350,155243,,95,0,"CLUB TACEREA, STR. TREBONIU LAURIAN NR.2","MUNICIPIUL TIMISOARA",1,155243,1,1,1048,550,442,108,535,15,1200,650,376,159,
37,"TIMIS",350,155243,,96,0,"GRUP SCOLAR INDUSTRIAL CONSTR. MONTAJ, B-DUL TINERETII NR.11","MUNICIPIUL TIMISOARA",1,155243,1,1,1204,640,508,132,627,13,1400,760,425,202,
37,"TIMIS",350,155243,,97,0,"GRUP SCOLAR INDUSTRIAL CONSTR. MONTAJ, B-DUL TINERETII NR.11","MUNICIPIUL TIMISOARA",1,155243,1,1,1208,541,479,62,531,10,1400,859,338,193,
37,"TIMIS",350,155243,,98,0,"SCOALA GENERALA NR.12, D-DUL TINERETII NR.17","MUNICIPIUL TIMISOARA",1,155243,1,1,1026,569,467,102,554,15,1200,631,409,145,
37,"TIMIS",350,155243,,99,0,"SCOALA GENERALA NR.12, D-DUL TINERETII NR.17","MUNICIPIUL TIMISOARA",1,155243,1,1,1246,608,541,67,593,15,1400,792,420,173,
37,"TIMIS",350,155243,,100,0,"GRUP SCOLAR ECON. ADM. ""F.S. NITTI"", STR. CORBULUI NR.7C","MUNICIPIUL TIMISOARA",1,155243,1,1,1638,643,559,84,629,14,1800,1157,416,213,
37,"TIMIS",350,155243,,101,0,"GRUP SCOLAR ECON. ADM. ""F.S. NITTI"", STR. CORBULUI NR.7C","MUNICIPIUL TIMISOARA",1,155243,1,1,862,386,331,55,377,9,900,514,261,116,
37,"TIMIS",350,155243,,102,0,"GRUP SCOLAR ECON. ADM. ""F.S. NITTI"", STR. CORBULUI NR.7C","MUNICIPIUL TIMISOARA",1,155243,1,1,1673,847,723,124,827,20,1800,953,641,186,
37,"TIMIS",350,155243,,103,0,"SCOALA GENERALA NR.22, STR. GH. DOJA","MUNICIPIUL TIMISOARA",1,155243,1,1,933,553,465,88,528,25,1000,447,418,110,
37,"TIMIS",350,155243,,104,0,"SCOALA GENERALA NR.22, STR. GH. DOJA","MUNICIPIUL TIMISOARA",1,155243,1,1,1203,598,530,68,577,21,1400,802,442,135,
37,"TIMIS",350,155243,,105,0,"SCOALA GENERALA NR.22, P-TA N. BALCESCU NR.2","MUNICIPIUL TIMISOARA",1,155243,1,1,1388,736,605,131,722,14,1500,764,566,156,
37,"TIMIS",350,155243,,106,0,"SCOALA GENERALA NR.22, P-TA N. BALCESCU NR.2","MUNICIPIUL TIMISOARA",1,155243,1,1,1305,603,543,60,590,13,1500,897,456,134,
37,"TIMIS",350,155243,,107,0,"LICEUL DE INFORMATICA ""G. MOISIL"", STR. GHIRLANDEI NR.4","MUNICIPIUL TIMISOARA",1,155243,1,1,1399,721,672,49,696,25,1600,879,537,159,
37,"TIMIS",350,155243,,108,0,"LICEUL DE INFORMATICA ""G. MOISIL"", STR. GHIRLANDEI NR.4","MUNICIPIUL TIMISOARA",1,155243,1,1,1013,552,493,59,537,15,1200,648,443,94,
37,"TIMIS",350,155243,,109,0,"GRADINITA CU PROGRAM PRELUNGIT NR28, ZONA STADION 1 MAI","MUNICIPIUL TIMISOARA",1,155243,1,1,914,455,407,48,449,6,1000,545,346,103,
37,"TIMIS",350,155243,,110,0,"LICEUL CU PROGRAM SPORTIV ""BANATUL"", ZONA STADION 1 MAI","MUNICIPIUL TIMISOARA",1,155243,1,1,665,383,305,78,367,16,700,317,270,97,
37,"TIMIS",350,155243,,111,0,"LICEUL CU PROGRAM SPORTIV ""BANATUL"", ZONA STADION 1 MAI","MUNICIPIUL TIMISOARA",1,155243,1,1,1207,601,516,85,579,22,1400,799,438,141,
37,"TIMIS",350,155243,,112,0,"LICEUL DE MUZICA ""ION VIDU"", STR. CLUJ NR.12","MUNICIPIUL TIMISOARA",1,155243,1,1,720,731,359,372,703,28,800,69,536,167,
37,"TIMIS",350,155243,,113,0,"SCOALA GENERALA NR.30, STR. FARULUI - ZONA SOARELUI","MUNICIPIUL TIMISOARA",1,155243,1,1,1477,655,592,63,641,14,1600,945,447,194,
37,"TIMIS",350,155243,,114,0,"CASA TINERETULUI, STR ARIES NR.19","MUNICIPIUL TIMISOARA",1,155243,1,1,1511,722,577,145,702,20,1700,978,490,212,
37,"TIMIS",350,155243,,115,0,"SCOALA GENERALA NR.30, STR. FARULUI - ZONA SOARELUI","MUNICIPIUL TIMISOARA",1,155243,1,1,1401,650,601,49,637,13,1600,950,435,202,
37,"TIMIS",350,155243,,116,0,"CASA TINERETULUI, STR ARIES NR.19","MUNICIPIUL TIMISOARA",1,155243,1,1,932,364,328,36,350,14,1002,638,271,79,
37,"TIMIS",350,155243,,117,0,"UNIVERSITATEA ""BANATULUI"", CALEA MARTIRILOR NR.1","MUNICIPIUL TIMISOARA",1,155243,1,1,718,439,348,91,434,5,800,361,332,102,
37,"TIMIS",350,155243,,118,0,"S.C. ""HIDROTIM"" S.A., CALEA MARTIRILOR","MUNICIPIUL TIMISOARA",1,155243,1,1,1230,546,473,73,531,15,1400,854,401,130,
37,"TIMIS",350,155243,,119,0,"UNIVERSITATEA ""TIBISCUS"", STR. DALIEI NR.11","MUNICIPIUL TIMISOARA",1,155243,1,1,1153,595,398,197,575,20,1300,705,386,189,
37,"TIMIS",350,155243,,120,0,"SCOALA GENERALA NR.28, STR. FAGULUI","MUNICIPIUL TIMISOARA",1,155243,1,1,1051,445,350,95,436,9,1200,755,285,151,
37,"TIMIS",350,155243,,121,0,"SCOALA GENERALA NR.28, STR. FAGULUI","MUNICIPIUL TIMISOARA",1,155243,1,1,1075,459,424,35,447,12,1200,741,287,160,
37,"TIMIS",350,155243,,122,0,"GRADINITA CU PROGRAM PRELUNGIT NR28, ZONA STADION 1 MAI","MUNICIPIUL TIMISOARA",1,155243,1,1,959,417,357,60,401,16,1000,583,292,109,
37,"TIMIS",350,155243,,123,0,"LICEUL TEORETIC ""W. SHAKESPEARE"", STR. I.L. CARAGIALE NR.6","MUNICIPIUL TIMISOARA",1,155243,1,1,922,514,477,37,500,14,1000,486,385,115,
37,"TIMIS",350,155243,,124,0,"LICEUL TEORETIC ""W. SHAKESPEARE"", STR. I.L. CARAGIALE NR.6","MUNICIPIUL TIMISOARA",1,155243,1,1,990,517,470,47,507,10,1000,483,402,105,
37,"TIMIS",350,155243,,125,0,"SCOALA AJUTATOARE ""PAUL POPESCU"", STR MUSORGSKI NR.2-6","MUNICIPIUL TIMISOARA",1,155243,1,1,1166,507,451,56,505,2,1300,793,305,200,
37,"TIMIS",350,155243,,126,0,"SCOALA AJUTATOARE ""PAUL POPESCU"", STR MUSORGSKI NR.2-6","MUNICIPIUL TIMISOARA",1,155243,1,1,1193,459,402,57,454,5,1300,841,300,154,
37,"TIMIS",350,155243,,127,0,"SCOALA AJUTATOARE ""PAUL POPESCU"", STR MUSORGSKI NR.2-6","MUNICIPIUL TIMISOARA",1,155243,1,1,1068,493,464,29,483,10,1200,707,321,162,
37,"TIMIS",350,155243,,128,0,"SCOALA AJUTATOARE ""PAUL POPESCU"", STR MUSORGSKI NR.2-6","MUNICIPIUL TIMISOARA",1,155243,1,1,1140,458,404,54,437,21,1300,842,278,159,
37,"TIMIS",350,155243,,129,0,"SCOALA GENERALA NR.1, STR. COMANESTI NR.3","MUNICIPIUL TIMISOARA",1,155243,1,1,1289,548,489,59,537,11,1600,1052,331,206,
37,"TIMIS",350,155243,,130,0,"S.C. ""BERE"" S.A., STR. STEFAN CEL MARE NR.38","MUNICIPIUL TIMISOARA",1,155243,1,1,1747,838,750,88,811,27,1900,1062,522,289,
37,"TIMIS",350,155243,,131,0,"LICEUL TEORETIC ""JEAN LUIS CALDERON"", STR. PESTALOZZI NR.14","MUNICIPIUL TIMISOARA",1,155243,1,1,800,410,355,55,404,6,900,490,327,77,
37,"TIMIS",350,155243,,132,0,"LICEUL TEORETIC ""JEAN LUIS CALDERON"", STR. PESTALOZZI NR.14","MUNICIPIUL TIMISOARA",1,155243,1,1,975,512,453,59,497,15,1000,488,358,139,
37,"TIMIS",350,155243,,133,0,"SCOALA GENERALA NR.5, STR. MOISE NICOARA NR.17","MUNICIPIUL TIMISOARA",1,155243,1,1,1105,462,419,43,452,10,1300,838,308,144,
37,"TIMIS",350,155243,,134,0,"SCOALA GENERALA NR.5, STR. MOISE NICOARA NR.17","MUNICIPIUL TIMISOARA",1,155243,1,1,1099,654,478,176,642,12,1200,546,427,215,
37,"TIMIS",350,155243,,135,0,"SCOALA GENERALA NR.30, STR. FARULUI - ZONA SOARELUI","MUNICIPIUL TIMISOARA",1,155243,1,1,1253,627,540,87,614,13,1400,773,406,208,
37,"TIMIS",350,155243,,136,0,"SCOALA GENERALA NR.30, STR. FARULUI - ZONA SOARELUI","MUNICIPIUL TIMISOARA",1,155243,1,1,2099,882,818,64,862,20,2200,1318,557,305,
37,"TIMIS",350,155243,,137,0,"SCOALA GENERALA NR.30, STR. FARULUI - ZONA SOARELUI","MUNICIPIUL TIMISOARA",1,155243,1,1,1404,686,622,64,667,19,1600,914,420,247,
37,"TIMIS",350,155243,,138,0,"GRADINITA DE COPII NR.11, STR. VERSULUI NR.2","MUNICIPIUL TIMISOARA",1,155243,1,1,1322,605,540,65,596,9,1500,895,375,221,
37,"TIMIS",350,155243,,139,0,"GRADINITA DE COPII NR.11, STR. VERSULUI NR.2","MUNICIPIUL TIMISOARA",1,155243,1,1,1187,519,474,45,502,17,1300,781,347,155,
37,"TIMIS",350,155243,,140,0,"BIR. CHIRII - DIR. ECONOMICA, STR. NATURII NR.2A","MUNICIPIUL TIMISOARA",1,155243,1,1,1766,875,765,110,845,30,1900,1025,582,263,
37,"TIMIS",350,155243,,141,0,"GRUP SCOLAR INDUSTRIAL DE CHIMIE ""AZUR"", CALEA MARTIRILOR NR.64","MUNICIPIUL TIMISOARA",1,155243,1,1,1327,644,578,66,625,19,1500,856,437,188,
37,"TIMIS",350,155243,,142,0,"GRUP SCOLAR INDUSTRIAL DE CHIMIE ""AZUR"", CALEA MARTIRILOR NR.64","MUNICIPIUL TIMISOARA",1,155243,1,1,1018,602,352,250,587,15,1200,598,425,162,
37,"TIMIS",350,155243,,143,0,"GRUP SCOLAR INDUSTRIAL DE CHIMIE ""AZUR"", CALEA MARTIRILOR NR.64","MUNICIPIUL TIMISOARA",1,155243,1,1,1911,867,741,126,855,12,2100,1233,575,280,
37,"TIMIS",350,155243,,144,0,"GRUP SCOLAR INDUSTRIAL DE CHIMIE ""AZUR"", CALEA MARTIRILOR NR.64","MUNICIPIUL TIMISOARA",1,155243,1,1,1548,723,617,106,706,17,1700,977,468,238,
37,"TIMIS",350,155243,,145,0,"SCOALA SPECIALA AMBLIOPI, STR. COSMINULUI NR.40","MUNICIPIUL TIMISOARA",1,155243,1,1,1442,664,603,61,643,21,1600,936,422,221,
37,"TIMIS",350,155243,,146,0,"SCOALA GENERALA NR.25, STR. COSMINULUI NR.42","MUNICIPIUL TIMISOARA",1,155243,1,1,1512,688,610,78,671,17,1700,1012,508,163,
37,"TIMIS",350,155243,,147,0,"SCOALA GENERALA NR.25, STR. COSMINULUI NR.42","MUNICIPIUL TIMISOARA",1,155243,1,1,1715,818,754,64,795,23,1900,1082,585,210,
37,"TIMIS",350,155243,,148,0,"SCOALA GENERALA NR.25, STR. COSMINULUI NR.42","MUNICIPIUL TIMISOARA",1,155243,1,1,1463,667,625,42,652,15,1600,933,466,186,
37,"TIMIS",350,155243,,149,0,"SCOALA GENERALA NR.25, STR. COSMINULUI NR.42","MUNICIPIUL TIMISOARA",1,155243,1,1,1307,647,503,144,624,23,1500,853,431,193,
37,"TIMIS",350,155243,,150,0,"S.C. ""GIROTIM-DAEWOO"" S.A. STR. MURES NR.116A","MUNICIPIUL TIMISOARA",1,155243,1,1,1206,641,439,202,623,18,1400,759,444,179,
37,"TIMIS",350,155243,,151,0,"GRADINITA DE COPII NR12, STR. AXENTE SEVER NR.10","MUNICIPIUL TIMISOARA",1,155243,1,1,766,368,315,53,363,5,800,432,282,81,
37,"TIMIS",350,155243,,152,0,"SCOALA GENERALA NR.9, STR. LIVIU REBREANU NR.35","MUNICIPIUL TIMISOARA",1,155243,1,1,1188,535,489,46,527,8,1323,788,409,118,
37,"TIMIS",350,155243,,153,0,"SCOALA GENERALA NR.9, STR. LIVIU REBREANU NR.35","MUNICIPIUL TIMISOARA",1,155243,1,1,1985,546,537,9,539,7,2100,1554,412,127,
37,"TIMIS",350,155243,,154,0,"SCOALA GENERALA NR.9, STR. LIVIU REBREANU NR.35","MUNICIPIUL TIMISOARA",1,155243,1,1,690,329,246,83,316,13,600,271,252,64,
37,"TIMIS",350,155243,,155,0,"SCOALA GENERALA NR.9, STR. LIVIU REBREANU NR.35","MUNICIPIUL TIMISOARA",1,155243,1,1,1182,450,402,48,436,14,1300,850,320,116,
37,"TIMIS",350,155243,,156,0,"GRADINITA CU PROGRAM PRELUNGIT NR.3, STR. N.LEONARD NR.13","MUNICIPIUL TIMISOARA",1,155243,1,1,1099,532,470,62,523,9,1200,668,365,158,
37,"TIMIS",350,155243,,157,0,"GRADINITA CU PROGRAM PRELUNGIT NR.3, STR. N.LEONARD NR.13","MUNICIPIUL TIMISOARA",1,155243,1,1,1539,663,591,72,646,17,1700,1037,432,214,
37,"TIMIS",350,155243,,158,0,"SCOALA GENERALA NR.27, STR. GORNISTILOR NR.3","MUNICIPIUL TIMISOARA",1,155243,1,1,1912,836,781,55,813,23,2100,1264,554,259,
37,"TIMIS",350,155243,,159,0,"SCOALA GENERALA NR.27, STR. GORNISTILOR NR.3","MUNICIPIUL TIMISOARA",1,155243,1,1,1478,601,559,42,591,10,1600,999,365,226,
37,"TIMIS",350,155243,,160,0,"SCOALA GENERALA NR.27, STR. GORNISTILOR NR.3","MUNICIPIUL TIMISOARA",1,155243,1,1,1703,784,701,83,753,31,1900,1116,522,231,
37,"TIMIS",350,155243,,161,0,"SCOALA GENERALA NR.27, STR. GORNISTILOR NR.3","MUNICIPIUL TIMISOARA",1,155243,1,1,1438,621,566,55,608,13,1600,979,438,170,
37,"TIMIS",350,155243,,162,0,"SCOALA GENERALA NR.27, STR. TRANSILVANIA","MUNICIPIUL TIMISOARA",1,155243,1,1,1403,631,560,71,625,6,1600,969,436,189,
37,"TIMIS",350,155243,,163,0,"SCOALA GENERALA NR.27, STR. TRANSILVANIA","MUNICIPIUL TIMISOARA",1,155243,1,1,1070,477,430,47,471,6,1200,723,295,176,
37,"TIMIS",350,155243,,164,0,"GRADINITA CU PROGRAM NORMAL NR.13, STR. TRANSILVANIA NR.10","MUNICIPIUL TIMISOARA",1,155243,1,1,1217,577,517,60,567,10,1400,823,356,211,
37,"TIMIS",350,155243,,165,0,"GRADINITA CU PROGRAM NORMAL NR.13, STR. TRANSILVANIA NR.10","MUNICIPIUL TIMISOARA",1,155243,1,1,1251,628,577,51,613,15,1385,757,410,203,
37,"TIMIS",350,155243,,166,0,"GRADINITA CU PROGRAM PRELUNGIT NR.30, STR. VASILE LUPU NR.29/A","MUNICIPIUL TIMISOARA",1,155243,1,1,1406,585,499,86,571,14,1600,1015,372,199,
37,"TIMIS",350,155243,,167,0,"GRADINITA CU PROGRAM PRELUNGIT NR.30, STR. VASILE LUPU NR.29/A","MUNICIPIUL TIMISOARA",1,155243,1,1,1470,677,603,74,658,19,1600,923,457,201,
37,"TIMIS",350,155243,,168,0,"SCOALA GENERALA NR.6, STR. VULTURILOR NR.89","MUNICIPIUL TIMISOARA",1,155243,1,1,1214,500,458,42,483,17,1400,900,329,154,
37,"TIMIS",350,155243,,169,0,"SCOALA GENERALA NR.6, STR. VULTURILOR NR.89","MUNICIPIUL TIMISOARA",1,155243,1,1,943,474,439,35,462,12,1000,526,312,150,
37,"TIMIS",350,155243,,170,0,"SCOALA GENERALA NR.6, STR. VULTURILOR NR.89","MUNICIPIUL TIMISOARA",1,155243,1,1,1400,552,524,28,539,13,1398,846,352,187,
37,"TIMIS",350,155243,,171,0,"SCOALA GENERALA NR.6, STR. VULTURILOR NR.89","MUNICIPIUL TIMISOARA",1,155243,1,1,1800,787,720,67,773,14,2000,1213,500,273,
37,"TIMIS",350,155243,,172,0,"GRUP SCOLAR INDUSTRIAL DE TRANSPORT AUTO, STR. ARDEALULUI NR.1","MUNICIPIUL TIMISOARA",1,155243,1,1,1311,577,529,48,558,19,1499,922,308,250,
37,"TIMIS",350,155243,,173,0,"GRUP SCOLAR INDUSTRIAL DE TRANSPORT AUTO, STR. ARDEALULUI NR.1","MUNICIPIUL TIMISOARA",1,155243,1,1,867,386,339,47,379,7,906,520,267,112,
37,"TIMIS",350,155243,,174,0,"GRUP SCOLAR INDUSTRIAL DE TRANSPORT AUTO, STR. ARDEALULUI NR.1","MUNICIPIUL TIMISOARA",1,155243,1,1,1549,664,616,48,643,14,1701,1044,380,263,
37,"TIMIS",350,155243,,175,0,"SCOALA GENERALA NR.29, STR. ION SLAVICI NR.51","MUNICIPIUL TIMISOARA",1,155243,1,1,1577,636,589,47,629,7,1700,1064,361,268,
37,"TIMIS",350,155243,,176,0,"SCOALA GENERALA NR.29, STR. ION SLAVICI NR.51","MUNICIPIUL TIMISOARA",1,155243,1,1,1515,720,590,130,700,20,1700,980,393,307,
37,"TIMIS",350,155243,,177,0,"SCOALA GENERALA NR.15, STR. IZLAZ NR.44","MUNICIPIUL TIMISOARA",1,155243,1,1,1186,523,445,78,512,11,1300,777,334,178,
37,"TIMIS",350,155243,,178,0,"SCOALA GENERALA NR.15, STR. IZLAZ NR.44","MUNICIPIUL TIMISOARA",1,155243,1,1,1852,757,592,165,736,21,2000,1243,453,283,
37,"TIMIS",350,155243,,179,0,"SANTIER DRUMURI MUNICIPALE, STR. ETERNITATII NR.45","MUNICIPIUL TIMISOARA",1,155243,1,1,1539,558,477,81,555,3,1700,1142,350,205,
37,"TIMIS",350,155243,,180,0,"SANTIER DRUMURI MUNICIPALE, STR. ETERNITATII NR.45","MUNICIPIUL TIMISOARA",1,155243,1,1,971,442,324,118,433,9,1000,558,317,116,
37,"TIMIS",350,155243,,181,0,"SCOALA GENERALA NR.15, STR. CHISODEI NR.1","MUNICIPIUL TIMISOARA",1,155243,1,1,1426,720,586,134,708,12,1600,880,478,230,
37,"TIMIS",350,155243,,182,0,"SCOALA GENERALA NR.15, STR. CHISODEI NR.1","MUNICIPIUL TIMISOARA",1,155243,1,1,929,483,343,140,472,11,1000,517,340,132,
37,"TIMIS",350,155243,,183,0,"SCOALA GENERALA NR.15, STR. CHISODEI NR.1","MUNICIPIUL TIMISOARA",1,155243,1,1,1621,758,610,148,732,26,1793,1035,514,218,
37,"TIMIS",350,155243,,184,0,"GRADINITA CU PROGRAM PRELUNGIT NR.23, STR. GAVRIL MUZICESCU NR.9","MUNICIPIUL TIMISOARA",1,155243,1,1,1334,629,587,42,620,9,1500,871,473,147,
37,"TIMIS",350,155243,,185,0,"SCOALA GENERALA NR.13, STR. GAVRIL MUZICESCU NR.9","MUNICIPIUL TIMISOARA",1,155243,1,1,1414,673,570,103,660,13,1600,927,404,256,
37,"TIMIS",350,155243,,186,0,"SCOALA GENERALA NR.13, STR. GAVRIL MUZICESCU NR.14","MUNICIPIUL TIMISOARA",1,155243,1,1,1891,897,806,91,890,7,2000,1103,611,279,
37,"TIMIS",350,155243,,187,0,"SCOALA GENERALA NR.13, STR. GAVRIL MUZICESCU NR.14","MUNICIPIUL TIMISOARA",1,155243,1,1,1435,697,608,89,688,9,1600,903,447,241,
37,"TIMIS",350,155243,,188,0,"GRADINITA CU PROGRAM PRELUNGIT NR.29 ""COMTIM CARNEX"", STR. MURES NR.6","MUNICIPIUL TIMISOARA",1,155243,1,1,1409,620,564,56,603,17,1600,980,466,137,
37,"TIMIS",350,155243,,189,0,"GRADINITA CU PROGRAM PRELUNGIT NR.29 ""COMTIM CARNEX"", STR. MURES NR.6","MUNICIPIUL TIMISOARA",1,155243,1,1,1440,716,609,107,705,11,1600,884,494,211,
37,"TIMIS",350,155243,,190,0,"SCOALA GENERALA NR.2, STR. MURES NR.8","MUNICIPIUL TIMISOARA",1,155243,1,1,1551,616,547,69,602,14,1700,1084,432,170,
37,"TIMIS",350,155243,,191,0,"SCOALA GENERALA NR.2, STR. MURES NR.8","MUNICIPIUL TIMISOARA",1,155243,1,1,1374,694,615,79,682,12,1500,806,473,209,
37,"TIMIS",350,155243,,192,0,"SCOALA GENERALA NR.2, STR. MURES NR.8","MUNICIPIUL TIMISOARA",1,155243,1,1,1552,902,783,119,864,38,1800,898,603,261,
37,"TIMIS",350,155243,,193,0,"SCOALA GENERALA NR.14, STR. ALUNIS NR.41A","MUNICIPIUL TIMISOARA",1,155243,1,1,1207,553,491,62,541,12,1400,847,372,169,
37,"TIMIS",350,155243,,194,0,"SCOALA GENERALA NR.14, STR. ALUNIS NR.41A","MUNICIPIUL TIMISOARA",1,155243,1,1,1309,585,527,58,574,11,1500,915,407,167,
37,"TIMIS",350,155243,,195,0,"GRUP SCOLAR INDUSTRIAL ""ELECTROTIMIS"", STR. MATEI MILLO NR.2A","MUNICIPIUL TIMISOARA",1,155243,1,1,1239,548,490,58,537,11,1400,852,322,215,
37,"TIMIS",350,155243,,196,0,"GRUP SCOLAR INDUSTRIAL ""ELECTROTIMIS"", STR. MATEI MILLO NR.2A","MUNICIPIUL TIMISOARA",1,155243,1,1,1177,490,451,39,484,6,1300,810,316,168,
37,"TIMIS",350,155243,,197,0,"GRUP SCOLAR INDUSTRIAL ""ELECTROTIMIS"", STR. MATEI MILLO NR.2A","MUNICIPIUL TIMISOARA",1,155243,1,1,1057,456,401,55,447,9,1200,744,270,177,
37,"TIMIS",350,155243,,198,0,"GRUP SCOLAR INDUSTRIAL ""ELECTROTIMIS"", STR. MATEI MILLO NR.2A","MUNICIPIUL TIMISOARA",1,155243,1,1,1532,654,546,108,643,11,1700,1046,313,330,
37,"TIMIS",350,155243,,199,0,"SCOALA GENERALA NR.20, STR. HUMULESTI(MARTIR C. RADU) NR.23","MUNICIPIUL TIMISOARA",1,155243,1,1,1106,556,495,61,549,7,1300,744,377,172,
37,"TIMIS",350,155243,,200,0,"SCOALA GENERALA NR.4 PLOPI, STR JULES VERNE NR.64","MUNICIPIUL TIMISOARA",1,155243,1,1,1139,528,443,85,514,14,1300,772,303,211,
37,"TIMIS",350,155243,,201,0,"SCOALA GENERALA NR.4 PLOPI, STR JULES VERNE NR.64","MUNICIPIUL TIMISOARA",1,155243,1,1,730,379,306,73,368,11,800,421,193,175,
37,"TIMIS",350,155243,,202,0,"GRADINITA CU PROGRAM PRELUNGIT NR.6, STR. VLAD TEPES NR.17","MUNICIPIUL TIMISOARA",1,155243,1,1,1110,554,511,43,540,14,1300,746,334,206,
37,"TIMIS",350,155243,,203,0,"GRADINITA CU PROGRAM PRELUNGIT NR.6, STR. VLAD TEPES NR.17","MUNICIPIUL TIMISOARA",1,155243,1,1,1070,512,472,40,495,17,1200,688,276,219,
37,"TIMIS",350,155243,,204,0,"ADMINISTRATIA TABERELOR, STR. TORAC NR.47","MUNICIPIUL TIMISOARA",1,155243,1,1,1735,784,674,110,768,16,1900,1116,467,301,
37,"TIMIS",350,155243,,205,0,"SCOALA GENERALA NR.23, STR. NEGOIU NR.47","MUNICIPIUL TIMISOARA",1,155243,1,1,1002,495,420,75,472,23,1200,705,390,82,
37,"TIMIS",350,155243,,206,0,"SCOALA GENERALA NR.23, STR. NEGOIU NR.47","MUNICIPIUL TIMISOARA",1,155243,1,1,1950,834,727,107,811,23,2100,1266,514,297,
37,"TIMIS",350,155243,,207,0,"SCOALA GENERALA DE HIPOACUZICI ""C. PUFAN"" STR. BUGEGI NR.2","MUNICIPIUL TIMISOARA",1,155243,1,1,1543,737,648,89,701,36,1700,963,480,221,
37,"TIMIS",350,155243,,208,0,"GRADINITA CU PROGRAM NORMAL NR.19, STR. LUMINII (MARTIR V.BALMUS) NR.22","MUNICIPIUL TIMISOARA",1,155243,1,1,1715,813,734,79,794,19,1900,1087,551,243,
37,"TIMIS",350,155243,,209,0,"GRADINITA CU PROGRAM NORMAL NR.19, STR. LUMINII NR.22","MUNICIPIUL TIMISOARA",1,155243,1,1,1547,715,634,81,698,17,1700,985,473,225,
37,"TIMIS",350,155243,,210,1,"CLUBUL U.M. AEROPORT, COM. GHIRODA","MUNICIPIUL TIMISOARA",1,155243,1,1,463,356,252,104,349,7,500,144,188,161,
37,"TIMIS",350,155243,,211,1,"U.M.01185, CHISODA","MUNICIPIUL TIMISOARA",1,155243,1,1,107,107,77,30,102,5,202,95,48,54,
37,"TIMIS",350,155243,,212,1,"U.M.01115, CALEA MARTIRILOR","MUNICIPIUL TIMISOARA",1,155243,1,1,0,134,0,134,127,7,200,66,69,58,
37,"TIMIS",350,155243,,213,1,"U.M.01125, PIATA OITUZ","MUNICIPIUL TIMISOARA",1,155243,1,1,793,823,752,71,797,26,900,77,445,352,
37,"TIMIS",350,155243,,214,1,"U.M.0301, GRANICERI, CALEA LIPOVEI","MUNICIPIUL TIMISOARA",1,155243,1,1,0,741,0,741,714,27,900,159,457,257,
37,"TIMIS",350,155243,,215,1,"U.M.0502, STR. GHE BARITIU","MUNICIPIUL TIMISOARA",1,155243,1,1,506,488,410,78,458,30,600,112,255,203,
37,"TIMIS",350,155243,,216,1,"CANTINA 1C DIN COMPLEXUL STUDENTESC","MUNICIPIUL TIMISOARA",1,155243,1,1,0,1077,0,1077,1047,30,3735,2658,277,770,
37,"TIMIS",350,155243,,217,1,"CANTINA 1C DIN COMPLEXUL STUDENTESC","MUNICIPIUL TIMISOARA",1,155243,1,1,0,1280,0,1280,1250,30,3800,2520,927,323,
37,"TIMIS",350,155243,,218,1,"CANTINA 1C DIN COMPLEXUL STUDENTESC","MUNICIPIUL TIMISOARA",1,155243,1,1,0,1580,0,1580,1530,50,3800,2220,1111,419,
37,"TIMIS",350,155243,,219,1,"FACULTATEA DE ZOOTEHNIE, UNIVERSITATEA DE STIINTE AGRICOLE","MUNICIPIUL TIMISOARA",1,155243,1,1,0,747,0,747,718,29,2100,1353,448,270,
37,"TIMIS",350,155243,,220,1,"LICEUL C.D. LOGA, STR. C.D. LOGA NR.37","MUNICIPIUL TIMISOARA",1,155243,1,1,0,66,0,66,64,2,800,734,48,16,
37,"TIMIS",350,155243,,221,1,"SPITALUL CLINIC NR.1 JUDETEAN NR.156","MUNICIPIUL TIMISOARA",1,155243,1,1,0,625,0,625,608,17,1000,375,399,209,
37,"TIMIS",350,155243,,222,1,"CLINICA OBSTRETICA-GINECOLOGIE, B-DUL VICTOR BABES NR.12","MUNICIPIUL TIMISOARA",1,155243,1,1,0,92,0,92,87,5,200,108,66,21,
37,"TIMIS",350,155243,,223,1,"CLINICA DE CHIRURGIE GENERALA, STR. GHEORGHE DIMA NR.5","MUNICIPIUL TIMISOARA",1,155243,1,1,0,354,0,354,348,6,1400,1046,218,130,
37,"TIMIS",350,155243,,224,1,"CLINICA DE CARDIOLOGIE, B-DUL REVOLUTIEI DIN 1989 NR.12","MUNICIPIUL TIMISOARA",1,155243,1,1,0,179,0,179,175,4,400,221,112,63,
37,"TIMIS",350,155243,,225,1,"SPITALUL CLINIC NR.4 DE BOLI INFECTIOASE SI PENUMOFTIZIOLOGICE ""V.BABES"" TIMISOARA, STR. SPITALUL NOU NR.13","MUNICIPIUL TIMISOARA",1,155243,1,1,0,270,0,270,264,6,600,330,165,99,
37,"TIMIS",350,155243,,226,1,"SPITALUL CLINIC NR.5 DE OBSTRETICA-GINECOLOGIE TIMISOARA, B-DUL 16 DECEMBRIE 1989","MUNICIPIUL TIMISOARA",1,155243,1,1,0,114,0,114,111,3,500,386,78,33,
37,"TIMIS",350,155243,,227,1,"SPITALUL C.F.R., SPL. T. VLADIMIRESCU NR.13","MUNICIPIUL TIMISOARA",1,155243,1,1,0,103,0,103,101,2,300,197,44,57,
37,"TIMIS",350,155243,,228,1,"STATIA C.F.R., GARA DE NORD","MUNICIPIUL TIMISOARA",1,155243,1,1,0,1215,0,1215,1192,23,2200,985,626,566,
37,"TIMIS",350,155243,,229,1,"AEROPORTUL INTERNATIONAL TIMISOARA","MUNICIPIUL TIMISOARA",1,155243,1,1,0,86,0,86,85,1,600,514,50,35,
37,"TIMIS",350,155350,,230,0,"LICEUL ""IULIA HASDEU"", P-TA VICTORIEI","MUNICIPIUL LUGOJ",2,155350,1,1,1544,781,693,88,772,9,1700,919,516,256,
37,"TIMIS",350,155350,,231,0,"SCOALA GENERALA NR.3, STR.20 DECEMBRIE 1989","MUNICIPIUL LUGOJ",2,155350,1,1,1872,913,833,80,896,17,2000,1087,625,271,
37,"TIMIS",350,155350,,232,0,"GRADINITA NR.3, STR. FAGETULUI NR.3","MUNICIPIUL LUGOJ",2,155350,1,1,1445,706,601,105,690,16,1600,894,411,279,
37,"TIMIS",350,155350,,233,0,"GRADINITA NR.4, AL. BRAZILOR NR.3","MUNICIPIUL LUGOJ",2,155350,1,1,2472,1312,1229,83,1281,31,2600,1288,853,428,
37,"TIMIS",350,155350,,234,0,"SCOALA GENERALA NR.4, STR. STEFAN CEL MARE NR.7","MUNICIPIUL LUGOJ",2,155350,1,1,1206,548,520,28,535,13,1400,852,377,158,
37,"TIMIS",350,155350,,235,0,"GRADINITA NR.5, STR. CEAHLAU NR.21","MUNICIPIUL LUGOJ",2,155350,1,1,2502,1151,1037,114,1132,19,2700,1549,734,398,
37,"TIMIS",350,155350,,236,0,"SCOALA GENERALA NR.2, STR. ASTALAS NR.31A","MUNICIPIUL LUGOJ",2,155350,1,1,1969,930,763,167,924,6,2100,1170,557,367,
37,"TIMIS",350,155350,,237,0,"CARTIER I.C. DRAGAN SCOALA GENERALA, STR. BUZIASULUI NR.36","MUNICIPIUL LUGOJ",2,155350,1,1,1033,501,418,83,495,6,1200,699,256,239,
37,"TIMIS",350,155350,,238,0,"GRADINITA DIN STR. LIBERTATII NR.62","MUNICIPIUL LUGOJ",2,155350,1,1,1748,835,787,48,821,14,1900,1065,474,347,
37,"TIMIS",350,155350,,239,0,"SALA SPORTURILOR VIITORUL, STR. TIMISORII","MUNICIPIUL LUGOJ",2,155350,1,1,2580,1202,1145,57,1177,25,2700,1498,747,430,
37,"TIMIS",350,155350,,240,0,"SALA SPORTURILOR VIITORUL, STR. TIMISORII","MUNICIPIUL LUGOJ",2,155350,1,1,1556,792,708,84,781,11,1700,908,506,275,
37,"TIMIS",350,155350,,241,0,"CLUBUL F.M.N., STR. TIMISORII NR.125","MUNICIPIUL LUGOJ",2,155350,1,1,1141,565,519,46,558,7,1300,735,297,261,
37,"TIMIS",350,155350,,242,0,"LICEUL TEXTIL, STR. GHE. DOJA NR.41","MUNICIPIUL LUGOJ",2,155350,1,1,2886,1216,1108,108,1198,18,3000,1784,747,451,
37,"TIMIS",350,155350,,243,0,"SALA DE SPORT, STR. BUGEGI NR.37","MUNICIPIUL LUGOJ",2,155350,1,1,1855,891,818,73,875,16,2000,1109,648,227,
37,"TIMIS",350,155350,,244,0,"GRADINITA DE COPII, STR. JABARULUI NR.7","MUNICIPIUL LUGOJ",2,155350,1,1,801,509,379,130,497,12,900,391,298,199,
37,"TIMIS",350,155350,,245,0,"GRADINITA NR.2, STR. XENOPOL NR.18","MUNICIPIUL LUGOJ",2,155350,1,1,1663,831,724,107,820,11,1800,969,520,300,
37,"TIMIS",350,155350,,246,0,"SCOALA DE MECANICI AGRICOLI, STR. BUZIASULUI NR.35","MUNICIPIUL LUGOJ",2,155350,1,1,1358,545,519,26,539,6,1500,955,361,178,
37,"TIMIS",350,155350,,247,0,"CLUBUL TINERETULUI, STR. AL.MOCIONI NR.9","MUNICIPIUL LUGOJ",2,155350,1,1,1310,788,614,174,774,14,1700,912,500,274,
37,"TIMIS",350,155350,,248,0,"SALA DE LUPTE, STR. PLOPILOR","MUNICIPIUL LUGOJ",2,155350,1,1,1295,569,525,44,564,5,1200,631,425,139,
37,"TIMIS",350,155350,,249,0,"BAZA SPORTIVA ""STRAND""","MUNICIPIUL LUGOJ",2,155350,1,1,1467,654,630,24,643,11,1600,946,434,209,
37,"TIMIS",350,155350,,250,0,"OCOLUL SILVIC, STR. CARANSEBESULUI","MUNICIPIUL LUGOJ",2,155350,1,1,2809,1263,1198,65,1246,17,3000,1737,689,557,
37,"TIMIS",350,155350,,251,0,"GRADINITA, STR. CARANSEBESULUI NR.1","MUNICIPIUL LUGOJ",2,155350,1,1,1632,704,661,43,683,21,1800,1096,431,252,
37,"TIMIS",350,155350,,252,0,"SCOALA GENERALA NR.1. STR. BOCSEI NR.21","MUNICIPIUL LUGOJ",2,155350,1,1,1627,758,701,57,741,17,1800,1042,453,288,
37,"TIMIS",350,155350,,253,1,"U.M.0389, STR. PLEVNEI","MUNICIPIUL LUGOJ",2,155350,1,1,330,349,330,19,333,16,500,151,173,160,
37,"TIMIS",350,155350,,254,1,"U.M.01428, STR. TIMISORII","MUNICIPIUL LUGOJ",2,155350,1,1,0,423,0,423,405,18,500,77,184,221,
37,"TIMIS",350,155350,,255,0,"SCOALA GENERALA MAGURI","MUNICIPIUL LUGOJ",2,155350,1,1,605,293,250,43,292,1,700,407,200,92,
37,"TIMIS",350,155350,,256,0,"SCOALA GENERALA TAPIA","MUNICIPIUL LUGOJ",2,155350,1,1,274,142,113,29,140,2,300,158,62,78,
37,"TIMIS",350,155403,,257,0,"CASA DE CULTURA BUZIAS, STR. PRINCIPALA NR.10","ORAS BUZIAS",3,155403,2,1,2194,1361,1040,321,1333,28,2400,1039,816,517,
37,"TIMIS",350,155403,,258,0,"GRADINITA DE COPII NR.2, STR. BREDICIANU NR.2","ORAS BUZIAS",3,155403,2,1,2248,1189,1069,120,1171,18,2400,1211,695,476,
37,"TIMIS",350,155403,,259,0,"CAMINUL CULTURAL BACOVA","ORAS BUZIAS",3,155403,2,1,1076,605,466,139,597,8,1200,595,255,342,
37,"TIMIS",350,155403,,260,0,"CAMINUL CULTURAL SILAGIU","ORAS BUZIAS",3,155403,2,1,677,451,389,62,447,4,700,249,243,204,
37,"TIMIS",350,155458,,261,0,"GRUP SCOLAR FORESTIER DETA, STR. MIHAI VITEAZU NR.12","ORAS DETA",4,155458,2,1,1639,762,690,72,739,23,1700,938,489,250,
37,"TIMIS",350,155458,,262,0,"SALA CASEI DE CULTURA ORASENESTI, STR. ST. CEL MARE NR.9","ORAS DETA",4,155458,2,1,2173,1018,910,108,1004,14,2500,1482,595,409,
37,"TIMIS",350,155458,,263,0,"SEDIUL RAIF, STR. TARGU MARE NR.18","ORAS DETA",4,155458,2,1,1456,622,530,92,608,14,1600,978,328,280,
37,"TIMIS",350,155458,,264,0,"SEDIUL SOC. AGR. OPATITA, SAT OPATITA","ORAS DETA",4,155458,2,1,461,286,245,41,283,3,500,214,156,127,
37,"TIMIS",350,156801,,265,0,"CASA DE CULTURA FAGET, CALEA LUGOJULUI NR.26","ORAS FAGET",5,156801,2,1,1980,1213,974,239,1200,13,2101,888,863,337,
37,"TIMIS",350,156801,,266,0,"GRADINITA P.P. FAGET, STR. STEFAN CEL MARE NR.4","ORAS FAGET",5,156801,2,1,1345,855,783,72,829,26,1500,645,621,208,
37,"TIMIS",350,156801,,267,0,"CAMINUL CULTURAL BATESTI","ORAS FAGET",5,156801,2,1,373,278,231,47,274,4,400,122,145,129,
37,"TIMIS",350,156801,,268,0,"CAMINUL CULTURAL BEGHEIU MIC","ORAS FAGET",5,156801,2,1,300,209,177,32,207,2,400,191,152,55,
37,"TIMIS",350,156801,,269,0,"CAMINUL CULTURAL BICHIGI","ORAS FAGET",5,156801,2,1,476,302,267,35,296,6,500,198,213,83,
37,"TIMIS",350,156801,,270,0,"CAMINUL CULTURAL BRANESTI","ORAS FAGET",5,156801,2,1,442,330,285,45,322,8,500,170,257,65,
37,"TIMIS",350,156801,,271,0,"CAMINUL CULTURAL BUNEA MARE","ORAS FAGET",5,156801,2,1,246,195,142,53,192,3,300,105,106,86,
37,"TIMIS",350,156801,,272,0,"CAMINUL CULTURAL JUPINESTI","ORAS FAGET",5,156801,2,1,176,131,111,20,129,2,200,69,84,45,
37,"TIMIS",350,156801,,273,0,"CAMINUL CULTURAL POVERGINA","ORAS FAGET",5,156801,2,1,169,150,127,23,150,0,200,50,76,74,
37,"TIMIS",350,156801,,274,0,"CAMINUL CULTURAL TEMERESTI","ORAS FAGET",5,156801,2,1,436,383,300,83,380,3,500,117,322,58,
37,"TIMIS",350,155494,,275,0,"GRUP SCOLAR STR. GHE. DOJA NR.14","ORAS JIMBOLIA",6,155494,2,1,1925,764,654,110,755,9,2100,1336,415,340,
37,"TIMIS",350,155494,,276,0,"SCOALA CU CLASELE I-VIII, STR. LORENA NR.35","ORAS JIMBOLIA",6,155494,2,1,1709,697,612,85,678,19,1900,1203,421,257,
37,"TIMIS",350,155494,,277,0,"SC ""JIMTIM"" SA, STR. CALEA TIMISORII NR.28","ORAS JIMBOLIA",6,155494,2,1,2285,1027,837,190,1016,11,2400,1373,608,408,
37,"TIMIS",350,155494,,278,0,"CASA DE CULTURA, STR. T. VLADIMIRESCU NR.88","ORAS JIMBOLIA",6,155494,2,1,1967,831,699,132,815,16,2100,1269,513,302,
37,"TIMIS",350,155494,,279,0,"SCOALA GENERALA NR.2, STR. G.ENESCU NR.2","ORAS JIMBOLIA",6,155494,2,1,2223,943,871,72,922,21,2400,1457,498,424,
37,"TIMIS",350,155494,,280,1,"U.M.0301, STR. MOTILOR NR.1","ORAS JIMBOLIA",6,155494,2,1,70,73,64,9,66,7,200,127,24,42,
37,"TIMIS",350,155528,,281,0,"SALA CASEI DE CULTURA(CASTEL), STR. REPUBLICII NR.14","ORAS SÂNNICOLAU MARE",7,155528,2,1,2856,1293,1185,108,1263,30,3000,1707,841,422,
37,"TIMIS",350,155528,,282,0,"SALA MARE A CASEI DE CULTURA, STR. N.OPREAN NR.1","ORAS SÂNNICOLAU MARE",7,155528,2,1,2179,1110,992,118,1078,32,2300,1190,718,360,
37,"TIMIS",350,155528,,283,0,"SALA UNITA, STR. DECEBAL NR.24","ORAS SÂNNICOLAU MARE",7,155528,2,1,2353,1205,1086,119,1173,32,2500,1295,718,455,
37,"TIMIS",350,155528,,284,0,"GRADINITA DE COPII, STR. 16 DECEMBRIE 1989, NR.54","ORAS SÂNNICOLAU MARE",7,155528,2,1,1790,867,783,84,845,22,1900,1033,554,291,
37,"TIMIS",350,155528,,285,0,"FOSTUL SPITAL DE COPII, STR. HORIA NR.2","ORAS SÂNNICOLAU MARE",7,155528,2,1,1800,821,672,149,798,23,1800,979,463,335,
37,"TIMIS",350,155546,,286,0,"CAMINUL CULTURAL BALINT, NR.135","BALINT",8,155546,0,3,773,436,364,72,427,9,800,364,201,226,
37,"TIMIS",350,155546,,287,0,"SCOALA GENERALA BODO","BALINT",8,155546,0,3,381,231,182,49,227,4,400,169,189,38,
37,"TIMIS",350,155546,,288,0,"SCOALA GENERALA FADIMAC","BALINT",8,155546,0,3,191,151,120,31,148,3,200,49,72,76,
37,"TIMIS",350,155591,,289,0,"SCOALA GENERALA BANLOC","BANLOC",9,155591,0,3,1613,758,661,97,747,11,1800,1042,526,221,
37,"TIMIS",350,155591,,290,0,"SCOALA GENERALA DOLAT","BANLOC",9,155591,0,3,408,221,176,45,220,1,500,279,115,105,
37,"TIMIS",350,155591,,291,0,"SCOALA GENERALA LIVEZILE","BANLOC",9,155591,0,3,824,444,371,73,438,6,900,456,299,139,
37,"TIMIS",350,155591,,292,0,"SCOALA GENERALA PARTOS","BANLOC",9,155591,0,3,323,218,155,63,212,6,400,182,152,60,
37,"TIMIS",350,155591,,293,0,"CAMINUL CULTURAL SOCA","BANLOC",9,155591,0,3,418,283,231,52,271,12,500,217,185,86,
37,"TIMIS",350,155662,,294,0,"SEDIUL PRIMARIEI BARA NR.44","BARA",10,155662,0,3,116,117,74,43,113,4,200,83,58,55,
37,"TIMIS",350,155662,,295,0,"LOC. DOBRESTI NR.17 (IMOBIL LIBER)","BARA",10,155662,0,3,23,46,19,27,43,3,100,54,13,30,
37,"TIMIS",350,155662,,296,0,"LAPUSNIC NR.81 (FOSTA SCOALA)","BARA",10,155662,0,3,34,37,18,19,37,0,100,63,13,24,
37,"TIMIS",350,155662,,297,0,"RADMANESTI NR.147 (FOSTA PRIMARIE)","BARA",10,155662,0,3,51,61,35,26,61,0,100,39,22,39,
37,"TIMIS",350,155724,,298,0,"CAMINUL CULTURAL BEBA VECHE","BEBA VECHE",12,155724,0,3,820,499,408,91,484,15,900,401,301,183,
37,"TIMIS",350,155724,,299,0,"CAMINUL CULTURAL CHERESTUR","BEBA VECHE",12,155724,0,3,394,207,180,27,205,2,400,193,174,31,
37,"TIMIS",350,155760,,300,0,"CAMINUL CULTURAL BECICHERECU MIC NR.647","BECICHERECU MIC",13,155760,0,3,1961,953,821,132,927,26,2100,1147,389,538,
37,"TIMIS",350,155760,,301,0,"CAMINUL CULTURAL DUDESTII NOI NR.102","BECICHERECU MIC",13,155760,0,3,1602,878,671,207,854,24,1800,922,354,500,
37,"TIMIS",350,155797,,302,0,"SEDIUL PRIMARIEI BELINT NR.146","BELINT",14,155797,0,3,1264,764,648,116,748,16,1400,636,459,289,
37,"TIMIS",350,155797,,303,0,"CAMINUL CULTURAL BABSA NR.145","BELINT",14,155797,0,3,208,174,130,44,171,3,300,126,134,37,
37,"TIMIS",350,155797,,304,0,"CAMINUL CULTURAL CHIZATAU NR.274","BELINT",14,155797,0,3,682,510,413,97,496,14,700,190,297,199,
37,"TIMIS",350,155797,,305,0,"CAMINUL CULTURALGRUNI NR.206","BELINT",14,155797,0,3,219,182,152,30,179,3,300,118,102,77,
37,"TIMIS",350,155840,,306,0,"CAMINUL CULTURAL BETHAUSEN NR.180","BETHAUSEN",15,155840,0,3,630,403,354,49,402,1,700,297,151,251,
37,"TIMIS",350,155840,,307,0,"CAMINUL CULTURAL CLADOVA NR.86/A","BETHAUSEN",15,155840,0,3,408,236,217,19,236,0,500,264,89,147,
37,"TIMIS",350,155840,,308,0,"CAMINUL CULTURALCLICIOVA NR.54","BETHAUSEN",15,155840,0,3,370,221,188,33,218,3,400,179,109,109,
37,"TIMIS",350,155840,,309,0,"SEDIUL MAGAZINULUI SATESC CUTINA 160","BETHAUSEN",15,155840,0,3,271,192,164,28,188,4,300,108,83,105,
37,"TIMIS",350,155840,,310,0,"CAMINUL CULTURAL LEUCUSESTI NR.77","BETHAUSEN",15,155840,0,3,413,251,223,28,249,2,500,249,131,118,
37,"TIMIS",350,155840,,311,0,"SEDIUL MAGAZINULUI SATESC NEVRINCEA","BETHAUSEN",15,155840,0,3,162,106,82,24,106,0,200,94,40,66,
37,"TIMIS",350,155911,,312,0,"SEDIUL PRIMARIEI BILED, STR. PRINCIPALA NR.359","BILED",16,155911,0,3,1572,721,591,130,712,9,1700,979,363,349,
37,"TIMIS",350,155911,,313,0,"CAMINUL CULTURAL BILED NR.353","BILED",16,155911,0,3,1219,601,482,119,585,16,1400,799,265,320,
37,"TIMIS",350,155911,,314,0,"CAMINUL CULTURAL SANDRA","BILED",16,155911,0,3,1595,930,750,180,923,7,1800,870,454,469,
37,"TIMIS",350,155911,,315,0,"SCOALA GENERALA UIHEI","BILED",16,155911,0,3,364,227,181,46,222,5,400,173,146,76,
37,"TIMIS",350,155957,,316,0,"CAMINUL CULTURAL BIRNA,NR.71","BARNA",11,155957,0,3,525,246,211,35,243,3,600,354,122,121,
37,"TIMIS",350,155957,,317,0,"SCOALA GENERALA SARAZANI NR.22","BARNA",11,155957,0,3,319,171,141,30,169,2,400,229,45,124,
37,"TIMIS",350,155957,,318,0,"SCOALA GENERALA JURESTI NR.23","BARNA",11,155957,0,3,379,245,198,47,244,1,400,155,154,90,
37,"TIMIS",350,156035,,319,0,"SEDIUL PRIMARIEI BOGDA NR.9","BOGDA",17,156035,0,3,224,154,95,59,153,1,300,146,78,75,
37,"TIMIS",350,156035,,320,0,"CAMINUL CULTURAL BUZAD NR.63","BOGDA",17,156035,0,3,178,157,97,60,155,2,200,43,97,58,
37,"TIMIS",350,156106,,321,0,"SCOALA GENERALA BOLDUR NR.184","BOLDUR",18,156106,0,3,501,296,255,41,294,2,600,304,166,128,
37,"TIMIS",350,156106,,322,0,"SCOALA PRIMARA JABAR NR.17","BOLDUR",18,156106,0,3,356,293,232,61,288,5,400,107,196,92,
37,"TIMIS",350,156106,,323,0,"SCOALA GENERALA OHABA-FORGACI NR.255","BOLDUR",18,156106,0,3,616,375,313,62,369,6,700,325,176,193,
37,"TIMIS",350,156106,,324,0,"SCOALA GENERALA SINERSIG NR.146","BOLDUR",18,156106,0,3,490,319,272,47,315,4,500,181,130,185,
37,"TIMIS",350,156151,,325,0,"SEDIUL PRIMARIEI BRESTOVAT NR.20","BRESTOVAT",19,156151,0,3,252,211,167,44,206,5,300,89,129,77,
37,"TIMIS",350,156151,,326,0,"SCOALA GENERALA COSARI","BRESTOVAT",19,156151,0,3,150,131,78,53,129,2,200,69,112,17,
37,"TIMIS",350,156151,,327,0,"CAMINUL CULTURAL TES NR.31","BRESTOVAT",19,156151,0,3,209,188,124,64,184,4,300,112,65,119,
37,"TIMIS",350,156213,,328,0,"SEDIUL PRIMARIEI CARPINIS STR. A III-A NR.42","CARPINIS",20,156213,0,3,1535,740,657,83,727,13,1702,962,355,372,
37,"TIMIS",350,156213,,329,0,"CARPINIS,STR. A III-A NR.27","CARPINIS",20,156213,0,3,1362,625,541,84,618,7,1498,873,341,277,
37,"TIMIS",350,156213,,330,0,"CAMINUL CULTURAL DIN IECEA MARE","CARPINIS",20,156213,0,3,1779,858,711,147,841,17,1900,1042,404,437,
37,"TIMIS",350,156213,,331,0,"GRADINITA DIN IECEA MICA","CARPINIS",20,156213,0,3,756,454,333,121,446,8,800,346,148,298,
37,"TIMIS",350,156259,,332,0,"SCOALA GENERALA CENAD 1578","CENAD",21,156259,0,3,1598,652,560,92,640,12,1700,1048,373,267,
37,"TIMIS",350,156259,,333,0,"SCOALA GENERALA CENAD1578","CENAD",21,156259,0,3,1535,677,601,76,665,12,1700,1023,375,290,
37,"TIMIS",350,156277,,334,0,"SEDIUL PRIMARIEI CENEI NR.134","CENEI",22,156277,0,3,1700,928,809,119,913,15,1900,972,517,396,
37,"TIMIS",350,156277,,335,0,"GRADINITA BOBDA NR.54","CENEI",22,156277,0,3,588,428,321,107,421,7,600,172,225,196,
37,"TIMIS",350,156277,,336,0,"GRADINITA CHECEA NR.363","CENEI",22,156277,0,3,1283,789,597,192,771,18,1400,611,466,305,
37,"TIMIS",350,156311,,337,0,"SEDIUL PRIMARIEI CHEVERESU MARE NR.277","CHEVERESU MARE",23,156311,0,3,747,483,347,136,481,2,800,317,318,163,
37,"TIMIS",350,156311,,338,0,"SEDIUL FOSTULUI CAP NR.46","CHEVERESU MARE",23,156311,0,3,308,268,114,154,268,0,400,132,197,71,
37,"TIMIS",350,156311,,339,0,"SEDIUL FOSTULUI CAP NR.46","CHEVERESU MARE",23,156311,0,3,287,194,151,43,192,2,300,106,116,76,
37,"TIMIS",350,156357,,340,0,"SEDIUL PRIMARIEI CIACOVA, P-TA CETATII NR.8","CIACOVA",24,156357,0,3,1268,770,514,256,753,17,1400,630,535,218,
37,"TIMIS",350,156357,,341,0,"LICEUL TEORETIC ""ALEXANDRU MOCIONI"", STR. T. VLADIMIRESCU","CIACOVA",24,156357,0,3,838,430,353,77,424,6,900,470,231,193,
37,"TIMIS",350,156357,,342,0,"SCOALA GENERALA NR.140/A","CIACOVA",24,156357,0,3,585,316,237,79,310,6,600,284,193,117,
37,"TIMIS",350,156357,,343,0,"CAMINUL CULTURAL NR.235","CIACOVA",24,156357,0,3,188,82,59,23,81,1,200,118,45,36,
37,"TIMIS",350,156357,,344,0,"SCOALA GENERALA NR.741","CIACOVA",24,156357,0,3,1401,639,543,96,634,5,1600,961,262,372,
37,"TIMIS",350,156357,,345,0,"CAMINUL CULTURAL NR.92","CIACOVA",24,156357,0,3,334,256,208,48,248,8,400,144,140,108,
37,"TIMIS",350,156357,,346,0,"SCOALA GENERALA NR.82","CIACOVA",24,156357,0,3,454,264,227,37,263,1,500,236,89,174,
37,"TIMIS",350,156357,,347,0,"CAMINUL CULTURAL PETROMAN NR.15/B","CIACOVA",24,156357,0,3,569,360,310,50,355,5,600,240,173,182,
37,"TIMIS",350,156437,,348,0,"CAMINUL CULTURAL COMLOSU MARE NR.605","COMLOSU MARE",25,156437,0,3,1756,1048,827,221,1016,32,1900,852,660,356,
37,"TIMIS",350,156437,,349,0,"SCOALA CU CLASELE I-VIII COMLOSU MARE NR.485","COMLOSU MARE",25,156437,0,3,1235,676,603,73,663,13,1400,724,453,210,
37,"TIMIS",350,156437,,350,0,"BIBLIOTECA DIN COMLOSU MIC NR.219","COMLOSU MARE",25,156437,0,3,726,426,356,70,412,14,800,374,143,269,
37,"TIMIS",350,156473,,351,0,"PRIMARIA COMUNEI COSTEIU NR.668","COSTEIU",26,156473,0,3,1761,860,745,115,846,14,1900,1040,404,442,
37,"TIMIS",350,156473,,352,0,"SCOALA GENERALA HEZERIS","COSTEIU",26,156473,0,3,315,229,162,67,216,13,400,171,70,146,
37,"TIMIS",350,156473,,353,0,"SCOALA GENERALA TIPARI","COSTEIU",26,156473,0,3,756,382,319,63,379,3,800,418,235,144,
37,"TIMIS",350,156534,,354,0,"SALA DE SEDINTE A PRIMARIEI CRICIOVA","CRICIOVA",27,156534,0,3,526,444,364,80,440,4,600,156,262,178,
37,"TIMIS",350,156534,,355,0,"CAMINUL CULTURAL CIRESU","CRICIOVA",27,156534,0,3,309,249,210,39,249,0,400,151,106,143,
37,"TIMIS",350,156534,,356,0,"CAMINUL CULTURAL JDIOARA","CRICIOVA",27,156534,0,3,469,284,248,36,280,4,500,216,113,167,
37,"TIMIS",350,156589,,357,0,"CAMINUL CULTURAL CURTEA","CURTEA",28,156589,0,3,612,388,348,40,383,5,700,312,202,181,
37,"TIMIS",350,156589,,358,0,"CAMINUL CULTURAL COSOVA","CURTEA",28,156589,0,3,448,286,241,45,280,6,500,214,153,127,
37,"TIMIS",350,156623,,359,0,"CAMINUL CULTURAL DAROVA","DAROVA",29,156623,0,3,1097,630,541,89,623,7,1400,770,203,420,
37,"TIMIS",350,156623,,360,0,"CAMINUL CULTURAL HODOS NR.11","DAROVA",29,156623,0,3,324,166,129,37,162,4,400,234,70,92,
37,"TIMIS",350,156623,,361,0,"CAMINUL CULTURAL SACOSU MARE","DAROVA",29,156623,0,3,824,507,431,76,503,4,900,393,164,339,
37,"TIMIS",350,156669,,362,0,"CAMINUL CULTURAL DENTA","DENTA",30,156669,0,3,1753,860,755,105,843,17,1900,1040,429,414,
37,"TIMIS",350,156669,,363,0,"CAMINUL CULTURAL BRESTEA","DENTA",30,156669,0,3,443,284,247,37,271,13,500,216,149,122,
37,"TIMIS",350,156669,,364,0,"CAMINUL CULTURAL ROVINITA MARE","DENTA",30,156669,0,3,327,212,172,40,208,4,400,188,108,100,
37,"TIMIS",350,156712,,365,0,"SALA DE SPORT A LICEULUI DIN DUDESTII VECHI","DUDESTII VECHI",31,156712,0,3,1731,772,679,93,747,25,1983,1211,393,354,
37,"TIMIS",350,156712,,366,0,"SALA DE SEDINTE A PRIMARIEI DUDESTII VECHI","DUDESTII VECHI",31,156712,0,3,1522,592,497,95,577,15,1700,1108,288,289,
37,"TIMIS",350,156712,,367,0,"CAMINUL CULTURAL CHEGLEVICI","DUDESTII VECHI",31,156712,0,3,468,227,160,67,220,7,500,273,149,71,
37,"TIMIS",350,156712,,368,0,"CLADIREA FOSTULUI SEDIU CAP","DUDESTII VECHI",31,156712,0,3,1014,601,508,93,589,12,1200,599,310,279,
37,"TIMIS",350,156767,,369,0,"SEDIUL PRIMARIEI DUMBRAVA","DUMBRAVA",32,156767,0,3,755,429,359,70,426,3,800,371,343,83,
37,"TIMIS",350,156767,,370,0,"SCOALA GENERALA BUCOVAT","DUMBRAVA",32,156767,0,3,419,270,227,43,269,1,500,230,137,132,
37,"TIMIS",350,156767,,371,0,"SCOALA GENERALA RACHITA","DUMBRAVA",32,156767,0,3,901,422,381,41,420,2,1000,578,201,219,
37,"TIMIS",350,155261,,372,0,"PETOFI-33 DUMBRAVITA","DUMBRAVITA",33,155261,0,3,2011,969,846,123,946,23,2199,1230,723,223,
37,"TIMIS",350,156927,,373,0,"SALA DE SEDINTE A PRIMARIEI FIRDEA, STR. PRINCIPALA","FARDEA",34,156927,0,3,809,435,396,39,432,3,900,465,194,238,
37,"TIMIS",350,156927,,374,0,"CAMINUL CULTURAL GLADNA MONTANA","FARDEA",34,156927,0,3,267,229,195,34,226,3,300,71,132,94,
37,"TIMIS",350,156927,,375,0,"CAMINUL CULTURAL GLADNA ROMANA","FARDEA",34,156927,0,3,529,295,263,32,294,1,600,305,184,110,
37,"TIMIS",350,157004,,376,0,"SEDIUL PRIMARIEI FOENI NR.381","FOENI",35,157004,0,3,952,531,449,82,521,10,1000,469,202,319,
37,"TIMIS",350,157004,,377,0,"FOSTA PRIMARIE CRUCENI ,NR 76-A","FOENI",35,157004,0,3,356,297,170,127,288,9,400,103,149,139,
37,"TIMIS",350,157086,,378,0,"CASA NATIONALA GATAIA,STR.REPUBLICII 111","GATAIA",36,157086,0,3,1208,659,521,138,644,15,1400,741,403,241,
37,"TIMIS",350,157086,,379,0,"GRADINITA MAGHIARA GATAIA, STR CARPATI 72","GATAIA",36,157086,0,3,1166,497,401,96,493,4,1300,803,328,165,
37,"TIMIS",350,157086,,380,0,"SC ""SOCGAT"" SA, SCULEA NR.44","GATAIA",36,157086,0,3,1388,628,525,103,616,12,1500,872,322,294,
37,"TIMIS",350,157086,,381,0,"SCOALA GENERALA MANASTIRE","GATAIA",36,157086,0,3,313,196,149,47,196,0,400,204,81,115,
37,"TIMIS",350,157086,,382,0,"SCOALA GENERALA BIRDA","GATAIA",36,157086,0,3,784,441,372,69,434,7,800,359,148,286,
37,"TIMIS",350,157086,,383,0,"SCOALA GENERALA BUTIN","GATAIA",36,157086,0,3,361,220,188,32,218,2,400,180,97,121,
37,"TIMIS",350,157086,,384,0,"SCOALA GENERALA PERCOSOVA","GATAIA",36,157086,0,3,242,206,142,64,199,7,300,94,113,86,
37,"TIMIS",350,157086,,385,0,"SEDIU SCOALA SINGEORGE","GATAIA",36,157086,0,3,382,268,215,53,265,3,400,132,121,144,
37,"TIMIS",350,157086,,386,0,"SCOALA GENERALA SEMLACU MARE","GATAIA",36,157086,0,3,295,179,104,75,171,8,300,121,73,98,
37,"TIMIS",350,157086,,387,0,"SCOALA GENERALA SEMLACU MIC","GATAIA",36,157086,0,3,140,114,73,41,110,4,200,86,74,36,
37,"TIMIS",350,157031,,388,0,"SEDIUL PRIMARIEI GAVOJDIA 295","GAVOJDIA",37,157031,0,3,975,513,447,66,502,11,1000,487,299,203,
37,"TIMIS",350,157031,,389,0,"CAMINUL CULTURAL JENA FN","GAVOJDIA",37,157031,0,3,414,285,239,46,281,4,500,215,139,142,
37,"TIMIS",350,157031,,390,0,"CAMINUL CULTURAL LUGOJEL 274","GAVOJDIA",37,157031,0,3,535,331,277,54,328,3,600,269,116,212,
37,"TIMIS",350,157031,,391,0,"CAMINUL CULTURAL SALBAGEL 34","GAVOJDIA",37,157031,0,3,257,147,129,18,147,0,300,153,71,76,
37,"TIMIS",350,155289,,392,0,"GRADINITA CU PROGRAM NORMAL GHIRODA, STR.VICTORIA NR.52","GHIRODA",38,155289,0,3,2805,1341,1209,132,1186,28,3100,1886,639,547,
37,"TIMIS",350,155289,,393,0,"CAMINUL CULTURAL GIARMATA VII, STR.INFRATIRII NR.91-93","GHIRODA",38,155289,0,3,1053,599,517,82,593,6,1200,601,329,264,
37,"TIMIS",350,157193,,394,0,"SEDIUL PRIMARIEI GHIZELA NR.41","GHIZELA",39,157193,0,3,367,271,203,68,268,3,400,129,190,78,
37,"TIMIS",350,157193,,395,0,"CAMINUL CULTURAL PANIOVA 124","GHIZELA",39,157193,0,3,245,207,149,58,201,6,300,93,110,91,
37,"TIMIS",350,157193,,396,0,"CAMINUL CULTURAL SANOVITA","GHIZELA",39,157193,0,3,420,334,299,35,331,3,500,166,207,124,
37,"TIMIS",350,157246,,397,0,"CAMINUL CULTURAL GIARMATA, STR MORII NR.729","GIARMATA",40,157246,0,3,1169,925,705,220,915,10,2100,1175,429,486,
37,"TIMIS",350,157246,,398,0,"SCOALA GENERALA CL.I-VIII GIARMATA,STR PRINCIPALA","GIARMATA",40,157246,0,3,1425,725,538,187,720,5,1600,875,304,416,
37,"TIMIS",350,157246,,399,0,"SCOALA GENERALA CL.I-IV CERNATEAZ,STR.PRINCIPALA","GIARMATA",40,157246,0,3,669,369,228,141,360,9,700,331,172,188,
37,"TIMIS",350,157273,,400,0,"SALA DE SEDINTE A PRIMARIEI GIERA","GIERA",41,157273,0,3,585,306,262,44,300,6,600,294,196,104,
37,"TIMIS",350,157273,,401,0,"SCOALA GENERALA CL.I-IV GRANICERI","GIERA",41,157273,0,3,191,138,78,60,135,3,200,62,54,81,
37,"TIMIS",350,157273,,402,0,"SCOALA GENERALA CL.I-IV TOAGER","GIERA",41,157273,0,3,266,202,139,63,200,2,300,98,93,107,
37,"TIMIS",350,155314,,403,0,"CAMINUL CULTURAL GIROC,STR.TRANDAFIRILOR NR.26","GIROC",42,155314,0,3,1729,751,655,96,740,11,1900,1149,355,385,
37,"TIMIS",350,155314,,404,0,"CASA NATIONALA CHISODA, STR.PRIMAVERII","GIROC",42,155314,0,3,1440,717,581,136,701,16,1600,883,444,257,
37,"TIMIS",350,157317,,405,0,"SEDIUL PRIMARIEI GIULVAZ, NR.172","GIULVAZ",43,157317,0,3,813,451,375,76,449,2,900,449,242,207,
37,"TIMIS",350,157317,,406,0,"CAMINUL CULTURAL CRAI NOU","GIULVAZ",43,157317,0,3,393,257,198,59,255,2,400,143,92,163,
37,"TIMIS",350,157317,,407,0,"SCOALA GENERALA IVANDA","GIULVAZ",43,157317,0,3,437,225,188,37,223,2,500,275,92,131,
37,"TIMIS",350,157317,,408,0,"CAMINUL CULTURAL RUDNA","GIULVAZ",43,157317,0,3,480,296,228,68,288,8,500,204,114,174,
37,"TIMIS",350,157362,,409,0,"SEDIUL PRIMARIEI JAMU MARE, NR.181","JAMU MARE",44,157362,0,3,1156,618,529,89,613,5,1300,682,304,309,
37,"TIMIS",350,157362,,410,0,"SCOALA CU CLASELE I-IV CLOPODIA NR.259","JAMU MARE",44,157362,0,3,517,313,257,56,313,0,600,287,175,138,
37,"TIMIS",350,157362,,411,0,"SCOALA CU CLASELE I-IV FERENDIA","JAMU MARE",44,157362,0,3,427,255,203,52,250,5,500,245,115,135,
37,"TIMIS",350,157362,,412,0,"CAMINUL CULTURAL GHERMAN, NR.86","JAMU MARE",44,157362,0,3,253,181,124,57,176,5,300,119,98,78,
37,"TIMIS",350,157362,,413,0,"CAMINUL CULTURAL LATUNAS","JAMU MARE",44,157362,0,3,225,164,122,42,164,0,300,136,75,89,
37,"TIMIS",350,157424,,414,0,"CASA NATIONALA JEBEL, STR.PRINCIPALA 831","JEBEL",45,157424,0,3,1432,580,462,118,571,9,1600,1020,279,292,
37,"TIMIS",350,157424,,415,0,"GRADINITA DE COPII JEBEL","JEBEL",45,157424,0,3,1151,626,473,153,612,14,1300,674,312,300,
37,"TIMIS",350,157424,,416,0,"CASA NATIONALA PADURENI, STR.PRINCIPALA NR.220","JEBEL",45,157424,0,3,1180,604,485,119,597,7,1300,696,270,327,
37,"TIMIS",350,157451,,417,0,"CAMINUL CULTURAL LENAUHEIM, 205","LENAUHEIM",46,157451,0,3,1300,610,520,90,605,5,1500,890,247,358,
37,"TIMIS",350,157451,,418,0,"CAMINUL CULTURAL BULGARAS, 251","LENAUHEIM",46,157451,0,3,1412,881,754,127,875,6,1600,719,419,456,
37,"TIMIS",350,157451,,419,0,"CAMINUL CULTURAL GRABAT, 238","LENAUHEIM",46,157451,0,3,1537,840,717,123,810,30,1700,860,497,313,
37,"TIMIS",350,157497,,420,0,"CAMINUL CULTURAL LIEBLING, 466","LIEBLING",47,157497,0,3,2393,1236,1134,102,1229,7,2600,1364,589,640,
37,"TIMIS",350,157497,,421,0,"SEDIUL PRIMARIEI VECHI DIN CERNA NT.73","LIEBLING",47,157497,0,3,172,147,95,52,146,1,200,53,73,73,
37,"TIMIS",350,157497,,422,0,"SCOALA GENERALA DIN IOSIF","LIEBLING",47,157497,0,3,158,134,67,67,134,0,200,66,76,58,
37,"TIMIS",350,157530,,423,0,"CAMINUL CULTURAL LOVRIN, NR.266","LOVRIN",48,157530,0,3,2875,1351,1207,144,1336,15,3100,1749,746,590,
37,"TIMIS",350,157530,,424,0,"SEDIUL FOSTEI PRIMARII GOTTLOB, NR.433","LOVRIN",48,157530,0,3,1578,737,659,78,725,12,1700,963,484,241,
37,"TIMIS",350,157530,,425,0,"GRADINITA TOMNATIC, NR.188","LOVRIN",48,157530,0,3,2466,1158,1000,158,1135,23,2600,1442,548,587,
37,"TIMIS",350,157530,,426,0,"SCOALA GENERALA VIZEJDIA, NR.169","LOVRIN",48,157530,0,3,296,150,112,38,149,1,300,150,51,98,
37,"TIMIS",350,157585,,427,0,"CAMINUL CULTURAL MARGINA, STR.PRINCIPALA NR.50","MARGINA",50,157585,0,3,918,562,481,81,554,8,1000,438,360,194,
37,"TIMIS",350,157585,,428,0,"CAMINUL CULTURAL BREAZOVA, NR.92","MARGINA",50,157585,0,3,173,171,129,42,162,9,200,29,84,78,
37,"TIMIS",350,157585,,429,0,"CAMINUL CULTURAL COSTEIU DE SUS, NR.38","MARGINA",50,157585,0,3,194,185,144,41,174,11,200,15,101,73,
37,"TIMIS",350,157585,,430,0,"CAMINUL CULTURAL GROSI, NR.39/A","MARGINA",50,157585,0,3,155,105,73,32,101,4,200,95,43,58,
37,"TIMIS",350,157585,,431,0,"CAMINUL CULTURAL SINTESTI, NR.200","MARGINA",50,157585,0,3,379,306,259,47,299,7,400,94,144,155,
37,"TIMIS",350,157683,,432,0,"SALA DE SEDINTE A PRIMARIEI MASLOC, STR.PRINCIPALA","MASLOC",51,157683,0,3,702,337,248,89,333,4,800,463,129,204,
37,"TIMIS",350,157683,,433,0,"CAMINUL CULTURAL ALIOS","MASLOC",51,157683,0,3,654,425,323,102,424,1,700,275,190,234,
37,"TIMIS",350,157683,,434,0,"CAMINUL CULTURAL FIBIS","MASLOC",51,157683,0,3,1179,710,547,163,695,15,1300,590,284,411,
37,"TIMIS",350,157683,,435,0,"CAMINUL CULTURAL REMETEA MICA","MASLOC",51,157683,0,3,361,213,168,45,211,2,400,187,64,147,
37,"TIMIS",350,157736,,436,0,"SEDIUL PRIMARIEI MANASTIUR, NR.297","MANASTIUR",49,157736,0,3,891,572,461,111,564,8,900,328,308,256,
37,"TIMIS",350,157736,,437,0,"SCOALA GENERALA PADURANI, NR.24","MANASTIUR",49,157736,0,3,107,72,45,27,70,2,200,128,45,25,
37,"TIMIS",350,157736,,438,0,"SCOALA GENERALA REMETEA LUNCA","MANASTIUR",49,157736,0,3,316,213,186,27,211,2,400,187,113,98,
37,"TIMIS",350,157781,,439,0,"SEDIUL PRIMARIEI MORAVITA 261","MORAVITA",52,157781,0,3,908,462,350,112,453,9,1000,538,263,190,
37,"TIMIS",350,157781,,440,0,"CAMINUL CULTURAL DEJAN","MORAVITA",52,157781,0,3,182,141,80,61,141,0,200,59,106,35,
37,"TIMIS",350,157781,,441,0,"SCOALA GENERALA GAIU MIC","MORAVITA",52,157781,0,3,151,131,84,47,130,1,200,69,80,50,
37,"TIMIS",350,157781,,442,0,"SCOALA GENERALA STAMORA GERMANA","MORAVITA",52,157781,0,3,668,387,295,92,382,5,700,313,218,164,
37,"TIMIS",350,157834,,443,0,"CAMINUL CULTURAL MOSNITA NOUA","MOSNITA NOUA",53,157834,0,3,1106,524,421,103,506,18,1300,776,280,226,
37,"TIMIS",350,157834,,444,0,"CAMINUL CULTURAL ALBINA","MOSNITA NOUA",53,157834,0,3,197,186,124,62,183,3,200,14,118,65,
37,"TIMIS",350,157834,,445,0,"SEDIUL FOSTEI PRIMARII MOSNITA VECHE","MOSNITA NOUA",53,157834,0,3,836,491,356,135,486,5,900,409,223,263,
37,"TIMIS",350,157834,,446,0,"CAMINUL CULTURAL URSENI","MOSNITA NOUA",53,157834,0,3,868,479,373,106,471,8,900,421,212,259,
37,"TIMIS",350,157898,,447,0,"CLUBUL MUNCITORESC NADRAG, PIATA PARC, 13","NADRAG",54,157898,0,3,1249,658,610,48,646,12,1400,742,441,205,
37,"TIMIS",350,157898,,448,0,"SCOALA GENERALA NADRAG, STR.SCOLII NR.1","NADRAG",54,157898,0,3,1220,597,560,37,585,12,1400,803,360,225,
37,"TIMIS",350,157898,,449,0,"CAMINUL CULTURAL CRIVINA, NR.70","NADRAG",54,157898,0,3,268,188,170,18,187,1,300,112,100,87,
37,"TIMIS",350,157923,,450,0,"HOLUL PRIMARIEI NITCHIDORF, NR,212","NITCHIDORF",55,157923,0,3,867,487,411,76,477,10,900,413,211,266,
37,"TIMIS",350,157923,,451,0,"CLADIREA SCOLII BLAJOVA, NR.53/A","NITCHIDORF",55,157923,0,3,148,97,76,21,96,1,200,103,59,37,
37,"TIMIS",350,157923,,452,0,"CAMINUL CULTURAL DUBOZ, NR.157","NITCHIDORF",55,157923,0,3,180,143,105,38,141,2,200,57,77,64,
37,"TIMIS",350,157969,,453,0,"CAMINUL CULTURAL OHABA LUNGA, NR.36","OHABA LUNGA",56,157969,0,3,297,202,162,40,199,3,300,98,103,96,
37,"TIMIS",350,157969,,454,0,"CAMINUL CULTURAL DUBESTI, NR.147","OHABA LUNGA",56,157969,0,3,227,132,117,15,129,3,300,168,47,82,
37,"TIMIS",350,157969,,455,0,"CAMINUL CULTURAL IERSNIC","OHABA LUNGA",56,157969,0,3,171,159,120,39,158,1,200,41,85,73,
37,"TIMIS",350,157969,,456,0,"CAMINUL CULTURAL OHABA ROMANAN NR.167","OHABA LUNGA",56,157969,0,3,218,198,151,47,196,2,300,102,92,104,
37,"TIMIS",350,158010,,457,0,"CAMINUL CULTURAL ORTISOARA, NR.266","ORTISOARA",57,158010,0,3,1717,988,853,135,975,13,1900,912,453,522,
37,"TIMIS",350,158010,,458,0,"CAMINUL CULTURAL CALACEA, NR.290","ORTISOARA",57,158010,0,3,519,333,261,72,327,6,600,267,181,146,
37,"TIMIS",350,158010,,459,0,"GRADINITA DE COPII COMESTI, NR.95","ORTISOARA",57,158010,0,3,388,265,202,63,257,8,400,135,114,143,
37,"TIMIS",350,158010,,460,0,"CAMINUL CULTURAL SECEANI, NR.100","ORTISOARA",57,158010,0,3,435,290,220,70,285,5,500,210,189,96,
37,"TIMIS",350,158065,,461,0,"SEDIUL SC PETIM SA PECIU NOU","PECIU NOU",58,158065,0,3,1325,699,547,152,690,9,1500,801,390,300,
37,"TIMIS",350,158065,,462,0,"SEDIUL ASOCIATIEI AGRICOLE OGORUL PECIU NOU","PECIU NOU",58,158065,0,3,1064,534,426,108,528,6,1200,666,283,245,
37,"TIMIS",350,158065,,463,0,"SEDIUL ASOCIATIEI AGRICOLE AGROPRODUCT DINIAS","PECIU NOU",58,158065,0,3,735,500,393,107,498,2,800,300,281,217,
37,"TIMIS",350,158065,,464,0,"PARTERUL BLOCULUI NR.280 SINMARTINU SIRBESC","PECIU NOU",58,158065,0,3,732,387,309,78,383,4,800,413,188,195,
37,"TIMIS",350,158109,,465,0,"CAMINUL CULTURAL PERIAM","PERIAM",59,158109,0,3,2015,975,837,138,952,23,2200,1225,490,462,
37,"TIMIS",350,158109,,466,0,"SCOALA GENERALA PERIAM","PERIAM",59,158109,0,3,1809,742,681,61,729,13,2000,1258,373,356,
37,"TIMIS",350,158109,,467,0,"SCOALA GENERALA PESAC","PERIAM",59,158109,0,3,1455,829,708,121,817,12,1600,771,546,271,
37,"TIMIS",350,158136,,468,0,"CAMINUL CULTURAL PIETROASA, NR.27","PIETROASA",60,158136,0,3,430,302,277,25,296,6,500,198,174,122,
37,"TIMIS",350,158136,,469,0,"CAMINUL CULTURAL FARASESTI","PIETROASA",60,158136,0,3,204,137,126,11,137,0,300,163,68,69,
37,"TIMIS",350,158136,,470,0,"CAMINUL CULTURAL POIENI, NR.19","PIETROASA",60,158136,0,3,234,163,143,20,160,3,300,137,106,54,
37,"TIMIS",350,158181,,471,0,"SEDIUL PRIMARIEI PISCHIA, NR.261","PISCHIA",61,158181,0,3,870,470,398,72,460,10,900,430,200,260,
37,"TIMIS",350,158181,,472,0,"SCOALA PRIMARA BENCECU DE JOS","PISCHIA",61,158181,0,3,312,209,144,65,205,4,400,191,105,100,
37,"TIMIS",350,158181,,473,0,"SCOALA GENERALA BENCECU DE SUS","PISCHIA",61,158181,0,3,661,388,343,45,385,3,700,312,128,257,
37,"TIMIS",350,158181,,474,0,"IMOBILUL CU NR.384 (FOSTUL SEDIU CAP)","PISCHIA",61,158181,0,3,400,287,239,48,276,11,500,213,123,153,
37,"TIMIS",350,158243,,475,0,"SCOALA GENERALA RACOVITA","RACOVITA",62,158243,0,3,760,502,423,79,494,8,800,298,311,183,
37,"TIMIS",350,158243,,476,0,"CAMINUL CULTURAL HITIAS","RACOVITA",62,158243,0,3,662,440,360,80,437,3,700,260,200,237,
37,"TIMIS",350,158243,,477,0,"CAMINUL CULTURAL DRAGOESTI","RACOVITA",62,158243,0,3,332,229,189,40,227,2,400,171,145,82,
37,"TIMIS",350,158243,,478,0,"SCOALA GENERALA FICATARI","RACOVITA",62,158243,0,3,342,243,189,54,240,3,400,157,96,144,
37,"TIMIS",350,158243,,479,0,"SCOALA GENERALA CAPAT","RACOVITA",62,158243,0,3,215,158,130,28,154,4,300,142,69,85,
37,"TIMIS",350,158243,,480,0,"SCOALA GENERALA SARBOVA","RACOVITA",62,158243,0,3,204,169,143,26,168,1,300,131,117,51,
37,"TIMIS",350,158314,,481,0,"SEDIUL PRIMARIEI RECAS, NR.134-135","RECAS",63,158314,0,3,2207,1040,745,295,1024,16,2400,1360,523,501,
37,"TIMIS",350,158314,,482,0,"SEDIUL LICEULUI TEORETIC RECAS","RECAS",63,158314,0,3,1423,758,517,241,752,6,1600,842,395,357,
37,"TIMIS",350,158314,,483,0,"SCOALA GENERALABAZOS","RECAS",63,158314,0,3,624,327,188,139,327,0,700,373,187,140,
37,"TIMIS",350,158314,,484,0,"SCOALA GENERALA HERNEACOVA","RECAS",63,158314,0,3,316,246,159,87,243,3,400,154,113,130,
37,"TIMIS",350,158314,,485,0,"SCOALA GENERALA IZVIN","RECAS",63,158314,0,3,1003,599,458,141,587,12,1200,601,274,313,
37,"TIMIS",350,158314,,486,0,"SCOALA GENERALA PETROVASELO","RECAS",63,158314,0,3,281,180,138,42,176,4,300,120,91,85,
37,"TIMIS",350,158314,,487,0,"SCOALA GENERALA STANCIOVA","RECAS",63,158314,0,3,351,249,190,59,243,6,400,151,135,108,
37,"TIMIS",350,158396,,488,0,"SCOALA GENERALA REMETEA MARE","REMETEA MARE",64,158396,0,3,993,537,417,120,534,3,1000,463,284,250,
37,"TIMIS",350,158396,,489,0,"SCOALA GENERALA BAZOSU NOU","REMETEA MARE",64,158396,0,3,182,148,100,48,144,4,200,52,88,56,
37,"TIMIS",350,158396,,490,0,"SCOALA GENERALA BUCOVAT","REMETEA MARE",64,158396,0,3,712,530,369,161,452,78,800,270,263,189,
37,"TIMIS",350,158396,,491,0,"SCOALA GENERALA IANOVA","REMETEA MARE",64,158396,0,3,598,436,347,89,422,14,600,164,231,191,
37,"TIMIS",350,158449,,492,0,"CAMINUL CULTURAL SACOSU TURCESC","SACOSU TURCESC",66,158449,0,3,564,272,202,70,269,3,600,328,114,155,
37,"TIMIS",350,158449,,493,0,"SCOALA GENERALA BERINI","SACOSU TURCESC",66,158449,0,3,352,185,133,52,178,7,400,215,70,108,
37,"TIMIS",350,158449,,494,0,"SCOALA CU CLASELE I-IV ICLODA","SACOSU TURCESC",66,158449,0,3,200,135,90,45,133,2,300,165,68,65,
37,"TIMIS",350,158449,,495,0,"SCOALA CU CLASELE I-IV OTVESTI","SACOSU TURCESC",66,158449,0,3,210,145,99,46,144,1,300,155,112,32,
37,"TIMIS",350,158449,,496,0,"SCOALA CU CLASELE I-IV STAMORA ROMANA","SACOSU TURCESC",66,158449,0,3,250,129,85,44,125,4,300,171,58,67,
37,"TIMIS",350,158449,,497,0,"SCOALA CU CLASELE I-VIII ULIUC","SACOSU TURCESC",66,158449,0,3,448,370,271,99,365,5,500,130,169,196,
37,"TIMIS",350,158449,,498,0,"CAMINUL CULTURAL UNIP","SACOSU TURCESC",66,158449,0,3,189,178,116,62,174,4,200,22,84,90,
37,"TIMIS",350,158528,,499,0,"SCOALA CU CLASELE I-VIII SATCHINEZ","SATCHINEZ",71,158528,0,3,2109,1099,937,162,1080,19,2300,1201,634,446,
37,"TIMIS",350,158528,,500,0,"SCOALA CU CLASELE I-VIII BARATEAZ","SATCHINEZ",71,158528,0,3,416,285,220,65,282,3,500,215,109,173,
37,"TIMIS",350,158528,,501,0,"SCOALA CU CLASELE I-VIII HODONI","SATCHINEZ",71,158528,0,3,864,507,421,86,499,8,900,393,230,269,
37,"TIMIS",350,158564,,502,0,"SCOALA GENERALA CU CLASELE I-VIII SACALAZ, NR.294","SACALAZ",65,158564,0,3,1490,802,525,277,782,20,1600,798,345,437,
37,"TIMIS",350,158564,,503,0,"CAMINUL CULTURAL DIN SACALAZ, STR. A IV-A NT.368","SACALAZ",65,158564,0,3,1258,556,424,132,547,9,1400,844,216,331,
37,"TIMIS",350,158564,,504,0,"CAMINUL CULTURAL BEREGSAU MARE","SACALAZ",65,158564,0,3,1264,647,508,139,628,19,1400,753,214,414,
37,"TIMIS",350,158564,,505,0,"SCOALA GENERALA BEREGSAU MIC","SACALAZ",65,158564,0,3,547,367,257,110,364,3,600,233,189,175,
37,"TIMIS",350,158608,,506,0,"SEDIUL PRIMARIEI SECAS NR 20","SECAS",72,158608,0,3,242,237,206,31,233,4,300,63,167,66,
37,"TIMIS",350,158653,,507,0,"SEDIUL PRIMARIEI SANANDREI, NR 516","SANANDREI",68,158653,0,3,1180,547,466,81,536,11,1300,753,197,339,
37,"TIMIS",350,158653,,508,0,"SCOALA GENERALA SANANDREI, NR 515","SANANDREI",68,158653,0,3,1105,535,482,53,526,9,1300,765,191,335,
37,"TIMIS",350,158653,,509,0,"GRADINITA CARANI NR.84","SANANDREI",68,158653,0,3,1318,699,583,116,686,13,1500,801,245,441,
37,"TIMIS",350,158653,,510,0,"SCOALA GENERALA COVACI","SANANDREI",68,158653,0,3,456,333,255,78,329,4,500,167,163,166,
37,"TIMIS",350,158699,,511,0,"SEDIUL PRIMARIEI SINMIHAIU ROMAN","SANMIHAIU ROMAN",69,158699,0,3,1393,584,479,105,578,6,1500,916,292,286,
37,"TIMIS",350,158699,,512,0,"SCOALA GENERALA SANMIHAIU GERMAN","SANMIHAIU ROMAN",69,158699,0,3,492,261,194,67,256,5,500,239,102,154,
37,"TIMIS",350,158699,,513,0,"CAMINUL CULTURAL UTVIN","SANMIHAIU ROMAN",69,158699,0,3,1300,588,491,97,578,10,1500,912,263,315,
37,"TIMIS",350,158733,,514,0,"SCOALA GENERALA SINPETRU MARE","SANPETRU MARE",70,158733,0,3,1617,831,749,82,817,14,1800,969,466,351,
37,"TIMIS",350,158733,,515,0,"CAMINUL CULTURAL IGRIS","SANPETRU MARE",70,158733,0,3,949,441,377,64,419,22,1000,559,258,161,
37,"TIMIS",350,158733,,516,0,"SCOALA GENERALA SARAVALE","SANPETRU MARE",70,158733,0,3,1792,951,853,98,927,24,1900,949,432,495,
37,"TIMIS",350,158779,,517,0,"CAMINUL CULTURAL SAG","SAG",67,158779,0,3,2011,895,762,133,882,13,2200,1305,484,398,
37,"TIMIS",350,158779,,518,0,"CAMINUL CULTURAL PARTA","SAG",67,158779,0,3,1188,573,445,128,559,14,1300,727,310,249,
37,"TIMIS",350,158804,,519,0,"CAMINUL CULTURAL STIUCA","STIUCA",73,158804,0,3,497,307,252,55,306,1,500,193,86,220,
37,"TIMIS",350,158804,,520,0,"CASA SATEASCA DRAGOMIRESTI","STIUCA",73,158804,0,3,284,155,138,17,151,4,300,145,70,81,
37,"TIMIS",350,158804,,521,0,"CAMINUL CULTURAL OLOSAG","STIUCA",73,158804,0,3,219,191,142,49,187,4,300,109,80,107,
37,"TIMIS",350,158804,,522,0,"CAMINUL CULTURAL ZGRIBESTI","STIUCA",73,158804,0,3,213,217,159,58,216,1,300,83,136,80,
37,"TIMIS",350,158859,,523,0,"CAMINUL CULTURAL TEREMIA MARE, 53","TEREMIA MARE",74,158859,0,3,1920,780,693,87,763,17,2100,1320,339,424,
37,"TIMIS",350,158859,,524,0,"SCOALA GENERALA NERAU, 75","TEREMIA MARE",74,158859,0,3,836,422,362,60,420,2,900,478,259,161,
37,"TIMIS",350,158859,,525,0,"CAMINUL CULTURAL TEREMIA MICA, 293","TEREMIA MARE",74,158859,0,3,450,249,183,66,249,0,500,251,125,124,
37,"TIMIS",350,158895,,526,0,"CAMINUL CULTURAL TOMESTI - SAT","TOMESTI",75,158895,0,3,461,310,263,47,303,7,500,190,183,120,
37,"TIMIS",350,158895,,527,0,"CAMINUL CULTURAL COLONIA FABRICII","TOMESTI",75,158895,0,3,795,496,445,51,489,7,900,404,276,213,
37,"TIMIS",350,158895,,528,0,"CAMINUL CULTURAL LUNCANII DE JOS","TOMESTI",75,158895,0,3,385,246,221,25,243,3,400,154,119,124,
37,"TIMIS",350,158895,,529,0,"CAMINUL CULTURAL ROMANESTI, 135","TOMESTI",75,158895,0,3,513,297,275,22,289,8,600,303,186,103,
37,"TIMIS",350,158966,,530,0,"SEDIUL PRIMARIEI TOPOLOVATU MARE, NR.321","TOPOLOVATU MARE",76,158966,0,3,921,651,481,170,640,11,1000,349,281,359,
37,"TIMIS",350,158966,,531,0,"FOSTUL SEDIU CAP CRALOVAT","TOPOLOVATU MARE",76,158966,0,3,184,123,94,29,122,1,200,77,73,49,
37,"TIMIS",350,158966,,532,0,"CAMINUL CULTURAL ICTAR - BUDINT","TOPOLOVATU MARE",76,158966,0,3,381,269,185,84,268,1,400,131,123,145,
37,"TIMIS",350,158966,,533,0,"SEDIUL SC IOSITIM IOSIFALAU","TOPOLOVATU MARE",76,158966,0,3,402,259,203,56,252,7,500,241,91,161,
37,"TIMIS",350,158966,,534,0,"CAMINUL CULTURAL SUSTRA","TOPOLOVATU MARE",76,158966,0,3,360,205,141,64,202,3,400,195,121,81,
37,"TIMIS",350,159035,,535,0,"CAMINUL CULTURAL TORMAC, NR.515","TORMAC",77,159035,0,3,1237,672,588,84,656,16,1400,728,583,73,
37,"TIMIS",350,159035,,536,0,"CAMINUL CULTURAL CADAR, NR.1","TORMAC",77,159035,0,3,225,170,131,39,166,4,300,130,73,93,
37,"TIMIS",350,159035,,537,0,"CAMINUL CULTURAL SIPET NR.140","TORMAC",77,159035,0,3,631,391,335,56,390,1,700,309,324,66,
37,"TIMIS",350,159071,,538,0,"CAMINUL CULTURAL TRAIAN VUIA 32 B","TRAIAN VUIA",78,159071,0,3,342,243,185,58,242,1,400,157,143,99,
37,"TIMIS",350,159071,,539,0,"SEDIUL PRIMARIEI TRAIAN VUIA (SUDRIAS)","TRAIAN VUIA",78,159071,0,3,612,325,261,64,321,4,700,375,163,158,
37,"TIMIS",350,159071,,540,0,"CAMINUL CULTURAL SACENI","TRAIAN VUIA",78,159071,0,3,162,141,104,37,137,4,200,59,90,47,
37,"TIMIS",350,159071,,541,0,"CAMINUL CULTURAL SURDUCU MIC","TRAIAN VUIA",78,159071,0,3,302,190,148,42,188,2,400,210,106,82,
37,"TIMIS",350,159071,,542,0,"CAMINUL CULTURAL SUSANI","TRAIAN VUIA",78,159071,0,3,288,177,138,39,176,1,300,123,77,99,
37,"TIMIS",350,159142,,543,0,"SEDIUL PRIMARIEI UIVAR","UIVAR",79,159142,0,3,1079,446,368,78,443,3,1200,754,226,217,
37,"TIMIS",350,159142,,544,0,"SCOALA GENERALA DIN IONEL","UIVAR",79,159142,0,3,666,340,285,55,332,8,700,360,131,201,
37,"TIMIS",350,159142,,545,0,"SEDIUL FOSTEI PRIMARII OTELEC","UIVAR",79,159142,0,3,624,387,292,95,378,9,700,313,344,34,
37,"TIMIS",350,159142,,546,0,"CAMINUL CULTURAL PUSTINIS","UIVAR",79,159142,0,3,480,321,237,84,316,5,500,179,203,113,
37,"TIMIS",350,159142,,547,0,"FOSTUL SEDIU C.A.P. RAUTI","UIVAR",79,159142,0,3,369,217,165,52,214,3,400,183,115,99,
37,"TIMIS",350,159142,,548,0,"FOSTUL SEDIU C.A.P. SANMARTINU MAGHIAR","UIVAR",79,159142,0,3,185,149,103,46,144,5,200,51,116,28,
37,"TIMIS",350,159213,,549,0,"CAMINUL CULTURAL VARIAS","VARIAS",80,159213,0,3,1956,1029,850,179,1018,11,2100,1071,479,539,
37,"TIMIS",350,159213,,550,0,"SEDIUL PRIMARIEI VARIAS","VARIAS",80,159213,0,3,1279,693,536,157,687,6,1400,707,335,352,
37,"TIMIS",350,159213,,551,0,"CAMINUL CULTURAL GELU","VARIAS",80,159213,0,3,1069,633,544,89,622,11,1200,567,308,314,
37,"TIMIS",350,159213,,552,0,"SCOALA PRIMARA SINPETRU MIC","VARIAS",80,159213,0,3,378,189,158,31,188,1,400,211,85,103,
37,"TIMIS",350,159259,,553,0,"SEDIUL PRIMARIEI V.V.DELAMARINA","VICTOR VLAD DELAMARINA",81,159259,0,3,372,301,244,57,294,7,400,99,175,119,
37,"TIMIS",350,159259,,554,0,"CAMINUL CULTURAL HERENDESTI","VICTOR VLAD DELAMARINA",81,159259,0,3,368,239,192,47,235,4,400,161,106,129,
37,"TIMIS",350,159259,,555,0,"SCOALA PRIMARA HONORICI","VICTOR VLAD DELAMARINA",81,159259,0,3,275,217,168,49,215,2,300,83,87,128,
37,"TIMIS",350,159259,,556,0,"SCOALA PRIMARA PADURENI","VICTOR VLAD DELAMARINA",81,159259,0,3,195,161,112,49,158,3,200,39,67,91,
37,"TIMIS",350,159259,,557,0,"SCOALA PRIMARA PETROASA MARE","VICTOR VLAD DELAMARINA",81,159259,0,3,574,246,189,57,237,9,600,354,118,119,
37,"TIMIS",350,159259,,558,0,"SCOALA PRIMARA VISAG","VICTOR VLAD DELAMARINA",81,159259,0,3,319,269,189,80,263,6,400,131,117,146,
37,"TIMIS",350,159339,,559,0,"SEDIUL PRIMARIEI VOITEG","VOITEG",82,159339,0,3,1455,722,621,101,713,9,1600,878,415,298,
37,"TIMIS",350,159339,,560,0,"SCOALA GENERALA FOLEA","VOITEG",82,159339,0,3,386,216,159,57,215,1,400,184,124,91,
38,"TULCEA",369,159614,,1,0,"COLEGIUL DOBROGEAN ""SPIRU C. HARET"",STR.14 NOIEMBRIE,NR.24","MUNICIPIUL TULCEA",1,159614,1,1,1684,998,835,163,988,10,1800,802,520,468,
38,"TULCEA",369,159614,,2,0,"SCOALA GENERALA ""NIFON BALASESCU"",STR.NICOLAE BALCESCU,NR.43","MUNICIPIUL TULCEA",1,159614,1,1,2301,1260,1195,65,1239,21,2700,1440,624,615,
38,"TULCEA",369,159614,,3,0,"SCOALA GENERALA ""NIFON BALASESCU"",STR.NICOLAE BALCESCU,NR.43","MUNICIPIUL TULCEA",1,159614,1,1,2183,1261,1176,85,1242,19,2500,1239,704,538,
38,"TULCEA",369,159614,,4,0,"SCOALA GENERALA NR.3,STR.AVRAM IANCU,NR.61A","MUNICIPIUL TULCEA",1,159614,1,1,2428,1338,1246,92,1319,19,2611,1273,723,596,
38,"TULCEA",369,159614,,5,0,"SCOALA GENERALA NR.9,STR.MAHMUDIEI,NR.123","MUNICIPIUL TULCEA",1,159614,1,1,2421,1437,1329,108,1427,10,2600,1163,734,693,
38,"TULCEA",369,159614,,6,0,"LICEUL DE ARTE PLASTICE ""GEORGE GEORGESCU"",STR.SLT.GAVRILOV CORNELIU,NR.166 (FOSTA SCOALA DE MUZICA)","MUNICIPIUL TULCEA",1,159614,1,1,2274,1286,1164,122,1260,26,2400,1114,755,505,
38,"TULCEA",369,159614,,7,0,"SCOALA GENERALA NR.11,STR.MIRON COSTIN","MUNICIPIUL TULCEA",1,159614,1,1,2452,1371,1280,91,1358,13,2576,1205,722,636,
38,"TULCEA",369,159614,,8,0,"GRADINITA DE COPII NR.16,STR.MIRON COSTIN,NR.24A","MUNICIPIUL TULCEA",1,159614,1,1,2311,1210,1122,88,1195,15,2536,1326,596,599,
38,"TULCEA",369,159614,,9,0,"SCOALA CU CLASELE I-VIII ""I.L.CARAGIALE""(FOSTA SCOALA NR.4),STR. I.L.CARAGIALE,NR.20","MUNICIPIUL TULCEA",1,159614,1,1,2740,1382,1295,87,1369,13,2939,1557,701,668,
38,"TULCEA",369,159614,,10,0,"SCOALA CU CLASELE I-VIII ""I.L.CARAGIALE"" (FOSTA SCOALA NR.4),STR. I.L.CARAGIALE,NR.20","MUNICIPIUL TULCEA",1,159614,1,1,2636,1415,1278,137,1400,15,2812,1397,732,668,
38,"TULCEA",369,159614,,11,0,"GRADINITA DE COPII NR.13,STR.ALEEA TRIFOIULUI,NR.4","MUNICIPIUL TULCEA",1,159614,1,1,2252,1152,1043,109,1144,8,2432,1280,643,501,
38,"TULCEA",369,159614,,12,0,"LICEUL DE ARTE PLASTICE ""GEORGE GEORGESCU"",STR.SLT.GAVRILOV CORNELIU,NR.166 (FOSTA SCOALA DE MUZICA)","MUNICIPIUL TULCEA",1,159614,1,1,1441,780,703,77,769,11,1608,828,509,260,
38,"TULCEA",369,159614,,13,0,"GRADINITA DE COPII NR.12,STR.24 IANUARIE,NR.2","MUNICIPIUL TULCEA",1,159614,1,1,2021,1129,1061,68,1116,13,2200,1071,700,416,
38,"TULCEA",369,159614,,14,0,"LICEUL PEDAGOGIC (FOSTA SCOALA NORMALA),STR.COMERTULUI,NR.1","MUNICIPIUL TULCEA",1,159614,1,1,2305,1203,1095,108,1189,14,2500,1297,666,523,
38,"TULCEA",369,159614,,15,0,"SCOALA GENERALA NR.2,STR.BABADAG,NR.138","MUNICIPIUL TULCEA",1,159614,1,1,2451,1358,1194,164,1346,12,2617,1259,835,511,
38,"TULCEA",369,159614,,16,0,"SCOALA GENERALA NR.5,STR.BABADAG,NR.146","MUNICIPIUL TULCEA",1,159614,1,1,2507,1287,1180,107,1271,16,2600,1313,830,441,
38,"TULCEA",369,159614,,17,0,"SEMINARUL TEOLOGIC,STR.TOAMNEI,NR.7","MUNICIPIUL TULCEA",1,159614,1,1,2168,1231,1126,105,1219,12,2300,1069,730,489,
38,"TULCEA",369,159614,,18,0,"SEDIUL CEREALCOM-FILIALA TULCEA(ICAPA),STR.PROGRESULUI,NR.26","MUNICIPIUL TULCEA",1,159614,1,1,2123,1263,1203,60,1253,10,2300,1037,891,362,
38,"TULCEA",369,159614,,19,0,"SCOALA ""GRIGORE ANTIPA""(FOSTA SCOALA G-RALA NR.6),STR.VICTORIEI,NR.66","MUNICIPIUL TULCEA",1,159614,1,1,2362,1312,1213,99,1296,16,2509,1197,788,508,
38,"TULCEA",369,159614,,20,0,"SCOALA ""MIHAIL SADOVEANU""(FOSTA SCOALA G-RALA NR.7),STR.LIBERTATII,NR.78","MUNICIPIUL TULCEA",1,159614,1,1,1308,810,700,110,809,1,1600,790,402,407,
38,"TULCEA",369,159614,,21,0,"SCOALA ""ALEXANDRU CIUCURENCU""(FOSTA SCOALA G-RALA NR.10),STR.VICTORIEI,NR.101","MUNICIPIUL TULCEA",1,159614,1,1,1292,718,644,74,715,3,1500,782,397,318,
38,"TULCEA",369,159614,,22,0,"SEDIUL CONEL TULCEA (LOCAL NOU),STR.PODGORIILOR,NR.2","MUNICIPIUL TULCEA",1,159614,1,1,2389,1350,1265,85,1340,10,2700,1350,791,549,
38,"TULCEA",369,159614,,23,0,"CARTIER E.3 SCOALA GENERALA ""CONSTANTIN GAVENEA"",STR.1848,NR.29","MUNICIPIUL TULCEA",1,159614,1,1,3364,1760,1678,82,1745,15,3715,1955,905,840,
38,"TULCEA",369,159614,,24,0,"CARTIER E.3 SCOALA GENERALA ""CONSTANTIN GAVENEA"",STR.1848,NR.29","MUNICIPIUL TULCEA",1,159614,1,1,2991,1737,1637,100,1728,9,3100,1363,936,792,
38,"TULCEA",369,159614,,25,0,"LICEUL ""GRIGORE MOISIL"",STR.1848,NR.7","MUNICIPIUL TULCEA",1,159614,1,1,2541,1373,1221,152,1360,13,2700,1327,771,589,
38,"TULCEA",369,159614,,26,0,"SCOALA GENERALA NR.12,STR.1848,NR.5A","MUNICIPIUL TULCEA",1,159614,1,1,3114,1551,1460,91,1530,21,3200,1649,841,689,
38,"TULCEA",369,159614,,27,0,"FUNDATIA PENTRU TINERET,STR.ISACCEI,NR.24","MUNICIPIUL TULCEA",1,159614,1,1,2360,1162,1030,132,1151,11,2530,1368,590,561,
38,"TULCEA",369,159614,,28,0,"GRADINITA DE COPII NR.17,STR.ALEEA ECOULUI NR.2,MICRORAION E.2","MUNICIPIUL TULCEA",1,159614,1,1,3190,1732,1444,288,1723,9,3300,1568,825,898,
38,"TULCEA",369,159614,,29,0,"GRUPUL ""HENRI COANDA"",STR.TINERETULUI,NR.2 (FOST LICEUL METALURGIC)","MUNICIPIUL TULCEA",1,159614,1,1,1543,842,745,97,828,14,1700,858,392,436,
38,"TULCEA",369,159614,,30,0,"BIBLIOTECA JUDETEANA,STR.ISACCEI,NR.20","MUNICIPIUL TULCEA",1,159614,1,1,1662,1073,925,148,1069,4,1793,720,642,427,
38,"TULCEA",369,159614,,31,0,"GRUP SCOLAR ECONOMIC,STR.TABEREI,NR.32","MUNICIPIUL TULCEA",1,159614,1,1,2850,1791,1316,475,1775,16,3400,1609,747,1028,
38,"TULCEA",369,159614,,32,0,"CASA DE CULTURA,STR.PIATA INDEPENDENTEI,NR.1","MUNICIPIUL TULCEA",1,159614,1,1,2096,1263,1125,138,1258,5,2200,937,741,517,
38,"TULCEA",369,159614,,33,1,"SPITALUL JUDETEAN,STR.1848,NR.20","MUNICIPIUL TULCEA",1,159614,1,1,0,500,0,500,499,1,772,272,278,221,
38,"TULCEA",369,159614,,34,1,"CASA ARMATEI,STR.PROGRESULUI,NR.22","MUNICIPIUL TULCEA",1,159614,1,1,0,588,0,588,576,12,1014,426,342,234,
38,"TULCEA",369,159650,,35,0,"LICEUL ""DIMITRIE CANTEMIR"",STR.AUREL VLAICU,NR.1","ORAS BABADAG",2,159650,2,1,1994,1041,910,131,1023,18,2190,1149,610,413,
38,"TULCEA",369,159650,,36,0,"SCOALA GENERALA NR.3,STR.HERACLEEA","ORAS BABADAG",2,159650,2,1,1693,913,817,96,892,21,1860,947,591,301,
38,"TULCEA",369,159650,,37,0,"SCOALA GENERALA NR.1,STR.CABANEI","ORAS BABADAG",2,159650,2,1,1704,1060,861,199,1055,5,1820,760,580,475,
38,"TULCEA",369,159650,,38,0,"SCOALA GENERALA NR.2,STR.REPUBLICII","ORAS BABADAG",2,159650,2,1,1349,773,682,91,761,12,1480,707,419,342,
38,"TULCEA",369,159650,,39,0,"SC AGROMEC SA,STR.CIUCUROVEI","ORAS BABADAG",2,159650,2,1,1064,574,540,34,564,10,1170,596,296,268,
38,"TULCEA",369,159650,,40,1,"SC AVICOLA SA,STR.HERACLEEA","ORAS BABADAG",2,159650,2,1,254,171,163,8,170,1,484,313,83,87,
38,"TULCEA",369,159687,,41,0,"CASA DE CULTURA","ORAS ISACCEA",3,159687,2,1,1842,1067,945,122,1051,16,2009,942,695,356,
38,"TULCEA",369,159687,,42,0,"LICEUL ""CONSTANTIN BRATESCU""","ORAS ISACCEA",3,159687,2,1,1687,957,869,88,928,29,1450,493,563,365,
38,"TULCEA",369,159687,,43,0,"SCOALA GENERALA REVARSAREA","ORAS ISACCEA",3,159687,2,1,491,325,282,43,318,7,362,37,218,100,
38,"TULCEA",369,159687,,44,0,"CLUBUL SPITALULUI TICHILESTI","ORAS ISACCEA",3,159687,2,1,11,34,8,26,32,2,64,30,12,20,
38,"TULCEA",369,159730,,45,0,"SCOALA GENERALA NR.1,STR.GRIVITEI,NR.11","ORAS MACIN",4,159730,2,1,3059,1501,1436,65,1485,16,3360,1859,1046,439,
38,"TULCEA",369,159730,,46,0,"SCOALA GENERALA NR.2,STR.FLORILOR NR.35","ORAS MACIN",4,159730,2,1,2211,1133,1067,66,1122,11,2439,1306,743,379,
38,"TULCEA",369,159730,,47,0,"GRADINITA DE COPII NR.3,STR.VANATORI,NR.3","ORAS MACIN",4,159730,2,1,1940,1144,973,171,1136,8,2131,987,734,402,
38,"TULCEA",369,159730,,48,0,"LICEUL ""GHEORGHE MURGOCI"",STR.CETATII,NR.19","ORAS MACIN",4,159730,2,1,2245,1155,1093,62,1143,12,2470,1315,783,360,
38,"TULCEA",369,159767,,49,0,"STR.1,NR.180,SEDIUL PRIMARIEI ORASULUI SULINA,SALA DE SEDINTE","ORAS SULINA",5,159767,2,1,1935,1205,1030,175,1190,15,2120,915,644,546,
38,"TULCEA",369,159767,,50,0,"SALA DE SPORT-LICEUL SULINA,STR.C.A.ROSETTI","ORAS SULINA",5,159767,2,1,2018,1260,1149,111,1250,10,2229,969,734,516,
38,"TULCEA",369,159767,,51,1,"SALA CLASA -LICEUL ""JEAN BART""","ORAS SULINA",5,159767,2,1,0,11,0,11,11,0,509,498,8,3,
38,"TULCEA",369,159785,,52,0,"SCOALA GENERALA BAIA","BAIA",6,159785,0,3,2320,1493,1390,103,1483,10,2525,1032,975,508,
38,"TULCEA",369,159785,,53,0,"SCOALA GENERALA CAMENA","BAIA",6,159785,0,3,413,224,195,29,221,3,500,276,143,78,
38,"TULCEA",369,159785,,54,0,"SCOALA GENERALA CAUGAGIA","BAIA",6,159785,0,3,157,147,107,40,143,4,200,53,77,66,
38,"TULCEA",369,159785,,55,0,"SCOALA GENERALA NR.2 CEAMURLIA DE SUS","BAIA",6,159785,0,3,708,318,285,33,317,1,765,447,191,126,
38,"TULCEA",369,159785,,56,0,"SCOALA GENERALA PANDURU","BAIA",6,159785,0,3,329,197,157,40,191,6,325,128,92,99,
38,"TULCEA",369,159847,,57,0,"SALA DE SPORT BEIDAUD","BEIDAUD",7,159847,0,3,480,260,213,47,259,1,528,268,159,100,
38,"TULCEA",369,159847,,58,0,"CAMIN CULTURAL NEATARNAREA","BEIDAUD",7,159847,0,3,431,299,246,53,295,4,470,171,189,106,
38,"TULCEA",369,159847,,59,0,"CAMIN CULTURAL SARIGHIOL DE DEAL","BEIDAUD",7,159847,0,3,431,240,200,40,239,1,475,235,103,136,
38,"TULCEA",369,159883,,60,0,"SCOALA C.A.ROSETTI","C.A. ROSETTI",8,159883,0,3,346,145,119,26,143,2,377,232,72,71,
38,"TULCEA",369,159883,,61,0,"SCOALA LETEA","C.A. ROSETTI",8,159883,0,3,279,214,134,80,211,3,300,86,119,92,
38,"TULCEA",369,159883,,62,0,"SCOALA PERIPRAVA","C.A. ROSETTI",8,159883,0,3,244,140,106,34,139,1,260,120,75,64,
38,"TULCEA",369,159883,,63,0,"SCOALA SFISTOFCA","C.A. ROSETTI",8,159883,0,3,121,101,62,39,98,3,141,40,53,45,
38,"TULCEA",369,159945,,64,0,"SCOALA GENERALA CARCALIU","CARCALIU",9,159945,0,3,1933,915,881,34,904,11,2120,1205,728,176,
38,"TULCEA",369,159945,,65,0,"SCOALA GENERALA CARCALIU","CARCALIU",9,159945,0,3,1360,736,679,57,728,8,1360,624,535,193,
38,"TULCEA",369,159963,,66,0,"CAMIN CULTURAL CASIMCEA","CASIMCEA",10,159963,0,3,1174,642,530,112,633,9,1290,648,402,231,
38,"TULCEA",369,159963,,67,0,"FOSTUL SEDIU C.A.P. CORUGEA","CASIMCEA",10,159963,0,3,313,292,228,64,289,3,343,51,200,89,
38,"TULCEA",369,159963,,68,0,"SCOALA RAZBOIENI","CASIMCEA",10,159963,0,3,544,312,264,48,306,6,590,278,143,163,
38,"TULCEA",369,159963,,69,0,"SCOALA RAHMANU","CASIMCEA",10,159963,0,3,320,237,188,49,233,4,320,83,172,61,
38,"TULCEA",369,160092,,70,0,"SCOALA GENERALA CEAMURLIA DE JOS","CEAMURLIA DE JOS",11,160092,0,3,971,597,518,79,592,5,1060,463,287,305,
38,"TULCEA",369,160092,,71,0,"SCOALA GENERALA LUNCA","CEAMURLIA DE JOS",11,160092,0,3,1054,754,662,92,741,13,1160,406,383,358,
38,"TULCEA",369,160127,,72,0,"SCOALA GENERALA CERNA","CERNA",13,160127,0,3,1971,992,917,75,983,9,2160,1168,601,382,
38,"TULCEA",369,160127,,73,0,"SCOALA GENERALA TRAIAN","CERNA",13,160127,0,3,978,696,620,76,690,6,1070,374,504,186,
38,"TULCEA",369,160127,,74,0,"SCOALA GENERALA MIRCEA VODA","CERNA",13,160127,0,3,564,314,250,64,311,3,620,306,185,126,
38,"TULCEA",369,160047,,75,0,"SCOALA GENERALA CEATALCHIOI","CEATALCHIOI",12,160047,0,3,419,298,191,107,298,0,460,162,145,153,
38,"TULCEA",369,160047,,76,0,"SCOALA GENERALA PATLAGEANCA","CEATALCHIOI",12,160047,0,3,122,120,67,53,119,1,130,10,45,74,
38,"TULCEA",369,160172,,77,0,"SCOALA GENERALA CHILIA VECHE","CHILIA VECHE",14,160172,0,3,2153,1188,1074,114,1166,22,2380,1192,562,604,
38,"TULCEA",369,160225,,78,0,"SCOALA GENERALA CIUCUROVA","CIUCUROVA",15,160225,0,3,1051,624,534,90,619,5,1170,546,390,229,
38,"TULCEA",369,160225,,79,0,"SCOALA GENERALA FANTANA MARE","CIUCUROVA",15,160225,0,3,466,261,215,46,258,3,510,249,168,90,
38,"TULCEA",369,160225,,80,0,"SCOALA GENERALA ATMAGEA","CIUCUROVA",15,160225,0,3,149,74,50,24,71,3,161,87,29,42,
38,"TULCEA",369,160261,,81,0,"SCOALA GENERALA CRISAN","CRISAN",16,160261,0,3,422,305,200,105,300,5,460,155,200,100,
38,"TULCEA",369,160261,,82,0,"SCOALA GENERALA CARAORMAN","CRISAN",16,160261,0,3,334,324,266,58,323,1,360,36,227,96,
38,"TULCEA",369,160261,,83,0,"SCOALA GENERALA MILA 23","CRISAN",16,160261,0,3,274,256,175,81,255,1,300,44,159,96,
38,"TULCEA",369,160305,,84,0,"CAMINUL CULTURAL DAENI","DAENI",17,160305,0,3,2148,1162,1100,62,1130,32,2360,1198,730,400,
38,"TULCEA",369,160323,,85,0,"SCOALA CU CLASELE I-VIII DOROBANTU","DOROBANTU",18,160323,0,3,793,424,392,32,421,3,872,448,228,193,
38,"TULCEA",369,160323,,86,0,"SCOALA CU CLASELE I-IV CARJELARI","DOROBANTU",18,160323,0,3,420,240,197,43,237,3,460,220,141,96,
38,"TULCEA",369,160323,,87,0,"SCOALA DIN SATUL MESTERU","DOROBANTU",18,160323,0,3,144,114,80,34,111,3,150,36,62,49,
38,"TULCEA",369,160323,,88,0,"SCOALA DIN SATUL FANTANA OILOR","DOROBANTU",18,160323,0,3,82,68,49,19,68,0,90,22,51,17,
38,"TULCEA",369,160387,,89,0,"SCOALA GENERALA FRECATEI","FRECATEI",19,160387,0,3,1013,617,511,106,594,23,1110,493,293,301,
38,"TULCEA",369,160387,,90,0,"SCOALA GENERALA CATALOI","FRECATEI",19,160387,0,3,1002,571,498,73,565,6,1100,529,252,313,
38,"TULCEA",369,160387,,91,0,"SCOALA GENERALA POSTA","FRECATEI",19,160387,0,3,546,351,237,114,342,9,602,251,165,177,
38,"TULCEA",369,160387,,92,0,"SCOALA GENERALA TELITA","FRECATEI",19,160387,0,3,441,287,214,73,280,7,474,187,109,171,
38,"TULCEA",369,160430,,93,0,"SCOALA ""CENTRU"" GRECI","GRECI",20,160430,0,3,1836,962,855,107,952,10,2000,1038,535,417,
38,"TULCEA",369,160430,,94,0,"SCOALA ""STEJARU"" GRECI","GRECI",20,160430,0,3,2522,1181,1118,63,1166,15,2770,1589,597,569,
38,"TULCEA",369,160458,,95,0,"CAMINUL CULTURAL GRINDU","GRINDU",21,160458,0,3,1139,902,810,92,885,17,1250,348,716,169,
38,"TULCEA",369,160476,,96,0,"SCOALA GENERALA HAMCEARCA","HAMCEARCA",22,160476,0,3,419,204,150,54,204,0,456,252,131,73,
38,"TULCEA",369,160476,,97,0,"SCOALA GENERALA BALABANCEA","HAMCEARCA",22,160476,0,3,297,255,183,72,250,5,320,65,154,96,
38,"TULCEA",369,160476,,98,0,"SCOALA GENERALA NIFON","HAMCEARCA",22,160476,0,3,551,340,246,94,329,11,600,260,181,148,
38,"TULCEA",369,160528,,99,0,"SCOALA VECHE HORIA","HORIA",23,160528,0,3,1043,881,807,74,873,8,1140,259,653,220,
38,"TULCEA",369,160528,,100,0,"CAMINUL CULTURAL FLORESTI","HORIA",23,160528,0,3,305,257,225,32,252,5,330,73,161,91,
38,"TULCEA",369,161525,,101,0,"SEDIUL CONSILIULUI LOCAL I.C.BRATIANU","I.C.BRATIANU",24,161525,0,3,894,534,397,137,528,6,980,446,326,202,
38,"TULCEA",369,160564,,102,0,"SCOALA GENERALA IZVOARELE","IZVOARELE",25,160564,0,3,1580,796,735,61,777,19,1718,922,411,366,
38,"TULCEA",369,160564,,103,0,"SCOALA GENERALA ALBA","IZVOARELE",25,160564,0,3,236,171,102,69,165,6,260,89,83,82,
38,"TULCEA",369,160564,,104,0,"SCOALA GENERALA VALEA TEILOR","IZVOARELE",25,160564,0,3,1265,755,627,128,733,22,1390,635,444,289,
38,"TULCEA",369,160564,,105,0,"SCOALA GENERALA IULIA","IZVOARELE",25,160564,0,3,235,176,131,45,173,3,246,70,110,63,
38,"TULCEA",369,160617,,106,0,"CAMINUL CULTURAL JIJILA","JIJILA",26,160617,0,3,3396,1962,1877,85,1937,25,3730,1768,1438,499,
38,"TULCEA",369,160617,,107,0,"SCOALA GENERALA GARVAN","JIJILA",26,160617,0,3,1037,789,655,134,779,10,1130,341,508,271,
38,"TULCEA",369,160644,,108,0,"GRADINITA DE COPII JURILOVCA","JURILOVCA",27,160644,0,3,1318,802,732,70,788,14,1440,638,481,307,
38,"TULCEA",369,160644,,109,0,"SCOALA GENERALA JURILOVCA","JURILOVCA",27,160644,0,3,1129,733,660,73,724,9,1200,467,417,307,
38,"TULCEA",369,160644,,110,0,"SCOALA GENERALA VISINA","JURILOVCA",27,160644,0,3,680,466,382,84,456,10,740,274,293,163,
38,"TULCEA",369,160644,,111,0,"SCOALA GENERALA SALCIOARA","JURILOVCA",27,160644,0,3,1117,714,639,75,695,19,1220,506,459,236,
38,"TULCEA",369,160680,,112,0,"CAMINUL CULTURAL LUNCAVITA","LUNCAVITA",28,160680,0,3,3040,1735,1584,151,1720,15,3340,1605,874,846,
38,"TULCEA",369,160680,,113,0,"SCOALA GENERALA VACARENI","LUNCAVITA",28,160680,0,3,1847,1072,949,123,1060,12,2050,978,739,321,
38,"TULCEA",369,160680,,114,0,"SCOALA GENERALA RACHELU","LUNCAVITA",28,160680,0,3,775,553,449,104,543,10,850,297,305,238,
38,"TULCEA",369,160724,,115,0,"CAMINUL CULTURAL SALA MICA MAHMUDIA","MAHMUDIA",29,160724,0,3,2317,1316,1171,145,1309,7,2540,1224,618,691,
38,"TULCEA",369,160724,,116,0,"SCOALA GENERALA BESTEPE","MAHMUDIA",29,160724,0,3,1629,1060,918,142,1052,8,1790,730,595,457,
38,"TULCEA",369,160779,,117,0,"SCOALA GENERALA MALIUC","MALIUC",30,160779,0,3,280,203,152,51,199,4,323,120,97,102,
38,"TULCEA",369,160779,,118,0,"SCOALA GENERALA PARTIZANI","MALIUC",30,160779,0,3,374,249,210,39,246,3,410,161,105,141,
38,"TULCEA",369,160779,,119,0,"DISPENSAR UMAN GORGOVA","MALIUC",30,160779,0,3,135,126,81,45,123,3,155,29,42,81,
38,"TULCEA",369,160831,,120,0,"SCOALA GENERALA MIHAI BRAVU","MIHAI BRAVU",31,160831,0,3,595,341,301,40,339,2,652,311,209,130,
38,"TULCEA",369,160831,,121,0,"SCOALA GENERALA SATU NOU","MIHAI BRAVU",31,160831,0,3,553,349,297,52,342,7,612,263,171,171,
38,"TULCEA",369,160831,,122,0,"CAMINUL CULTURAL TURDA","MIHAI BRAVU",31,160831,0,3,976,588,510,78,583,5,1054,466,309,274,
38,"TULCEA",369,160877,,123,0,"SCOALA GENERALA MIHAIL KOGALNICEANU","MIHAIL KOGALNICEANU",32,160877,0,3,1577,857,764,93,844,13,1730,873,450,394,
38,"TULCEA",369,160877,,124,0,"SCOALA GENERALA LASTUNI","MIHAIL KOGALNICEANU",32,160877,0,3,484,361,303,58,356,5,530,169,190,166,
38,"TULCEA",369,160877,,125,0,"SCOALA GENERALA RANDUNICA","MIHAIL KOGALNICEANU",32,160877,0,3,490,340,279,61,336,4,540,200,196,140,
38,"TULCEA",369,160911,,126,0,"SCOALA GENERALA MURIGHIOL","MURIGHIOL",33,160911,0,3,1167,670,548,122,668,2,1280,610,321,347,
38,"TULCEA",369,160911,,127,0,"SCOALA GENERALA DUNAVATUL DE JOS","MURIGHIOL",33,160911,0,3,638,387,274,113,378,9,700,313,131,247,
38,"TULCEA",369,160911,,128,0,"SCOALA GENERALA PLOPU","MURIGHIOL",33,160911,0,3,511,409,341,68,406,3,560,151,266,140,
38,"TULCEA",369,160911,,129,0,"ASOCIATIA AGRICOLA (SEDIU) SARINASUF","MURIGHIOL",33,160911,0,3,519,353,260,93,350,3,570,217,236,114,
38,"TULCEA",369,160993,,130,0,"SCOALA GENERALA NALBANT","NALBANT",34,160993,0,3,830,526,429,97,525,1,900,374,224,301,
38,"TULCEA",369,160993,,131,0,"SCOALA GENERALA NICOLAE BALCESCU","NALBANT",34,160993,0,3,691,501,371,130,486,15,760,259,110,376,
38,"TULCEA",369,160993,,132,0,"SCOALA GENERALA TRESTENIC","NALBANT",34,160993,0,3,297,235,160,75,234,1,315,80,56,178,
38,"TULCEA",369,161035,,133,0,"PRIMARIA NICULITEL","NICULITEL",35,161035,0,3,2231,1208,1098,110,1196,12,2473,1265,518,678,
38,"TULCEA",369,161035,,134,0,"SCOALA GENERALA NR.2 NICULITEL","NICULITEL",35,161035,0,3,1824,995,882,113,977,18,2000,1005,459,518,
38,"TULCEA",369,161053,,135,0,"SCOALA GENERALA CLS.I-VIII NUFARU","NUFARU",36,161053,0,3,1068,591,474,117,580,11,1171,580,273,307,
38,"TULCEA",369,161053,,136,0,"GRADINITA CU PROGRAM NORMAL MALCOCI","NUFARU",36,161053,0,3,573,509,304,205,503,6,631,122,245,258,
38,"TULCEA",369,161053,,137,0,"SCOALA CU CLASELE I-IV VICTORIA","NUFARU",36,161053,0,3,99,240,48,192,236,4,270,30,98,138,
38,"TULCEA",369,161106,,138,0,"GRADINITA DE COPII OSTROV","OSTROV",37,161106,0,3,1942,1036,983,53,1020,16,2146,1110,721,299,
38,"TULCEA",369,161133,,139,0,"SCOALA GENERALA PARDINA","PARDINA",38,161133,0,3,393,296,205,91,291,5,430,134,158,133,
38,"TULCEA",369,161151,,140,0,"CAMINUL CULTURAL PECENEAGA","PECENEAGA",39,161151,0,3,1731,1079,990,89,1062,17,1905,826,800,262,
38,"TULCEA",369,161179,,141,0,"LOCAL SCOALA VECHE SARICHIOI","SARICHIOI",40,161179,0,3,1754,1020,979,41,1007,13,1892,872,510,497,
38,"TULCEA",369,161179,,142,0,"LOCAL SCOALA VECHE SARICHIOI","SARICHIOI",40,161179,0,3,1507,790,762,28,770,20,1660,870,379,391,
38,"TULCEA",369,161179,,143,0,"LOCAL SCOALA SABANGIA","SARICHIOI",40,161179,0,3,556,363,303,60,358,5,610,247,192,166,
38,"TULCEA",369,161179,,144,0,"LOCAL SCOALA ZEBIL","SARICHIOI",40,161179,0,3,1310,772,693,79,759,13,1400,628,497,262,
38,"TULCEA",369,161179,,145,0,"LOCAL SCOALA ENISALA","SARICHIOI",40,161179,0,3,908,630,577,53,614,16,990,360,352,262,
38,"TULCEA",369,161179,,146,0,"LOCAL SCOALA VISTERNA","SARICHIOI",40,161179,0,3,350,268,223,45,263,5,380,112,103,160,
38,"TULCEA",369,161231,,147,0,"CAMIN CULTURAL SF.GHEORGHE","SFANTU GHEORGHE",41,161231,0,3,873,441,405,36,435,6,959,518,299,136,
38,"TULCEA",369,161259,,148,0,"SEDIUL PRIMARIEI SLAVA CERCHEZA","SLAVA CERCHEZA",42,161259,0,3,1294,621,551,70,615,6,1419,798,432,183,
38,"TULCEA",369,161259,,149,0,"SCOALA GENERALA SLAVA RUSA","SLAVA CERCHEZA",42,161259,0,3,1098,553,451,102,544,9,1219,666,344,200,
38,"TULCEA",369,161286,,150,0,"SCOALA GENERALA SMARDAN","SMARDAN",43,161286,0,3,831,538,446,92,535,3,900,362,296,239,
38,"TULCEA",369,161302,,151,0,"SCOALA GENERALA SOMOVA","SOMOVA",44,161302,0,3,1825,996,861,135,979,17,2007,1011,497,482,
38,"TULCEA",369,161302,,152,0,"SCOALA GENERALA MINERI","SOMOVA",44,161302,0,3,972,643,527,116,629,14,1036,393,253,376,
38,"TULCEA",369,161302,,153,0,"SCOALA GENERALA PARCHES","SOMOVA",44,161302,0,3,635,437,370,67,420,17,650,213,262,158,
38,"TULCEA",369,161348,,154,0,"GRADINITA DE COPII STEJARU","STEJARU",45,161348,0,3,726,314,266,48,310,4,800,486,252,58,
38,"TULCEA",369,161348,,155,0,"SCOALA GENERALA ALTAN-TEPE","STEJARU",45,161348,0,3,530,387,292,95,386,1,549,162,270,116,
38,"TULCEA",369,161348,,156,0,"SCOALA GENERALA VASILE ALECSANDRI","STEJARU",45,161348,0,3,421,270,208,62,270,0,432,162,199,71,
38,"TULCEA",369,161384,,157,0,"CAMIN CULTURAL TOPOLOG","TOPOLOG",46,161384,0,3,1885,1104,982,122,1079,25,2067,963,687,392,
38,"TULCEA",369,161384,,158,0,"SCOALA GENERALA CALFA","TOPOLOG",46,161384,0,3,126,111,76,35,109,2,130,19,73,36,
38,"TULCEA",369,161384,,159,0,"SCOALA GENERALA CERBU","TOPOLOG",46,161384,0,3,193,181,104,77,181,0,210,29,134,47,
38,"TULCEA",369,161384,,160,0,"SCOALA GENERALA FAGARASU NOU","TOPOLOG",46,161384,0,3,579,312,274,38,308,4,630,318,171,137,
38,"TULCEA",369,161384,,161,0,"SCOALA GENERALA LUMINITA","TOPOLOG",46,161384,0,3,232,140,118,22,139,1,250,110,70,69,
38,"TULCEA",369,161384,,162,0,"SCOALA GENERALA MAGURELE","TOPOLOG",46,161384,0,3,228,182,121,61,181,1,250,68,129,52,
38,"TULCEA",369,161384,,163,0,"SCOALA GENERALA SAMBATA NOUA","TOPOLOG",46,161384,0,3,477,319,261,58,316,3,530,211,237,79,
38,"TULCEA",369,161464,,164,0,"CAMINUL CULTURAL TURCOAIA","TURCOAIA",47,161464,0,3,1678,1052,994,58,1044,8,1720,668,643,401,
38,"TULCEA",369,161464,,165,0,"SCOALA GENERALA NR.1","TURCOAIA",47,161464,0,3,1410,860,832,28,852,8,1496,636,562,290,
38,"TULCEA",369,161482,,166,0,"SCOALA GENERALA VALEA NUCARILOR","VALEA NUCARILOR",48,161482,0,3,1111,592,487,105,577,15,1234,642,296,281,
38,"TULCEA",369,161482,,167,0,"SCOALA GENERALA IAZURILE","VALEA NUCARILOR",48,161482,0,3,466,456,217,239,447,9,500,44,237,210,
38,"TULCEA",369,161482,,168,0,"SCOALA GENERALA AGIGHIOL","VALEA NUCARILOR",48,161482,0,3,1580,866,680,186,850,16,1722,856,338,512,
39,"VASLUI",378,161945,,1,0,"str. Stefan cel Mare","MUNICIPIUL VASLUI",1,161945,1,1,1730,1025,932,93,1010,15,1903,878,737,273,
39,"VASLUI",378,161945,,2,0,"str. Stefan cel Mare,nr. 81","MUNICIPIUL VASLUI",1,161945,1,1,1750,1030,930,100,1015,15,1925,895,743,272,
39,"VASLUI",378,161945,,3,0,"str. M. Kogalniceanu,nr. 16","MUNICIPIUL VASLUI",1,161945,1,1,1565,846,803,43,837,9,1722,876,603,234,
39,"VASLUI",378,161945,,4,0,"str. M. Kogalniceanu,nr. 16","MUNICIPIUL VASLUI",1,161945,1,1,1337,820,771,49,814,6,1470,650,651,163,
39,"VASLUI",378,161945,,5,0,"str. Spiru Haret","MUNICIPIUL VASLUI",1,161945,1,1,1821,1102,1017,85,1094,8,2003,901,785,309,
39,"VASLUI",378,161945,,6,0,"str. Eternitatii","MUNICIPIUL VASLUI",1,161945,1,1,2166,1326,1094,232,1314,12,2383,1057,948,366,
39,"VASLUI",378,161945,,7,0,"str. M. Kogalniceanu,nr. 24","MUNICIPIUL VASLUI",1,161945,1,1,1559,826,784,42,819,7,1718,892,594,225,
39,"VASLUI",378,161945,,8,0,"str. Avintului","MUNICIPIUL VASLUI",1,161945,1,1,1906,1021,921,100,1012,9,2096,1075,699,313,
39,"VASLUI",378,161945,,9,0,"str. Veteran Turcanu,nr. 61","MUNICIPIUL VASLUI",1,161945,1,1,2055,1097,1054,43,1084,13,2260,1163,838,246,
39,"VASLUI",378,161945,,10,0,"str. Spitalului,nr. 25","MUNICIPIUL VASLUI",1,161945,1,1,1530,1029,791,238,1021,8,1683,654,704,317,
39,"VASLUI",378,161945,,11,0,"str. V. Babes,nr. 1","MUNICIPIUL VASLUI",1,161945,1,1,1573,899,858,41,889,10,1730,831,580,309,
39,"VASLUI",378,161945,,12,0,"str. V. Babes","MUNICIPIUL VASLUI",1,161945,1,1,1262,730,687,43,730,0,1388,658,506,224,
39,"VASLUI",378,161945,,13,0,"str. Stefan cel Mare,nr. 193","MUNICIPIUL VASLUI",1,161945,1,1,1458,947,885,62,938,9,1604,657,641,297,
39,"VASLUI",378,161945,,14,0,"str. Stefan cel Mare,nr. 193","MUNICIPIUL VASLUI",1,161945,1,1,1342,755,692,63,750,5,1476,721,535,215,
39,"VASLUI",378,161945,,15,0,"str. D. Bolintineanu,nr. 10","MUNICIPIUL VASLUI",1,161945,1,1,1610,840,773,67,828,12,1771,931,557,271,
39,"VASLUI",378,161945,,16,0,"str. V. Alecsandri,nr. 1","MUNICIPIUL VASLUI",1,161945,1,1,1339,770,692,78,765,5,1473,703,555,210,
39,"VASLUI",378,161945,,17,0,"str. Maresal C. Prezan,nr. 4","MUNICIPIUL VASLUI",1,161945,1,1,1688,985,904,81,975,10,1857,872,725,250,
39,"VASLUI",378,161945,,18,0,"str. Maresal C. Prezan,nr. 4","MUNICIPIUL VASLUI",1,161945,1,1,1848,1051,943,108,1037,14,2033,982,748,289,
39,"VASLUI",378,161945,,19,0,"str. Cuza Voda,nr. 1","MUNICIPIUL VASLUI",1,161945,1,1,1966,1057,1010,47,1044,13,2175,1118,721,323,
39,"VASLUI",378,161945,,20,0,"str. Husului,nr. 48","MUNICIPIUL VASLUI",1,161945,1,1,1770,964,917,47,952,12,1944,980,654,298,
39,"VASLUI",378,161945,,21,0,"str. Husului,nr. 2","MUNICIPIUL VASLUI",1,161945,1,1,1673,950,891,59,937,13,1840,890,667,270,
39,"VASLUI",378,161945,,22,0,"str. Gh. Racovita,nr. 191","MUNICIPIUL VASLUI",1,161945,1,1,1518,772,730,42,765,7,1670,898,585,180,
39,"VASLUI",378,161945,,23,0,"str. Ana Ipatescu,nr. 21","MUNICIPIUL VASLUI",1,161945,1,1,1662,856,805,51,849,7,1828,972,602,247,
39,"VASLUI",378,161945,,24,0,"str. Decebal","MUNICIPIUL VASLUI",1,161945,1,1,1464,793,755,38,790,3,1610,817,544,246,
39,"VASLUI",378,161945,,25,0,"str. Stefan cel Mare,nr. 60","MUNICIPIUL VASLUI",1,161945,1,1,1530,858,790,68,853,5,1683,825,623,230,
39,"VASLUI",378,161945,,26,0,"str. Biruintei,nr. 1","MUNICIPIUL VASLUI",1,161945,1,1,2010,1067,1012,55,1053,14,2211,1144,736,317,
39,"VASLUI",378,161945,,27,0,"str. Biruintei,nr. 1","MUNICIPIUL VASLUI",1,161945,1,1,2170,1205,1098,107,1189,16,2387,1182,797,392,
39,"VASLUI",378,161945,,28,0,"str. Pacii,nr. 2","MUNICIPIUL VASLUI",1,161945,1,1,2034,1066,1019,47,1060,6,2235,1169,738,322,
39,"VASLUI",378,161945,,29,0,"str. Pacii,nr. 2","MUNICIPIUL VASLUI",1,161945,1,1,2041,1155,1058,97,1146,9,2239,1084,771,375,
39,"VASLUI",378,161945,,30,0,"str. Traian,nr. 1","MUNICIPIUL VASLUI",1,161945,1,1,1746,1042,946,96,1028,14,1920,878,738,290,
39,"VASLUI",378,161945,,31,0,"str M. Viteazu,nr. 10","MUNICIPIUL VASLUI",1,161945,1,1,1839,1046,972,74,1038,8,2023,977,720,318,
39,"VASLUI",378,161945,,32,0,"str. Racova,nr. 69","MUNICIPIUL VASLUI",1,161945,1,1,0,0,0,0,0,0,0,0,0,0,
39,"VASLUI",378,161945,,33,0,"str. Branistei","MUNICIPIUL VASLUI",1,161945,1,1,370,313,164,149,280,33,410,97,206,74,
39,"VASLUI",378,161945,,34,0,"str. Egalitatii","MUNICIPIUL VASLUI",1,161945,1,1,713,504,397,107,496,8,783,279,327,169,
39,"VASLUI",378,161945,,35,0,"str Gh. Doja","MUNICIPIUL VASLUI",1,161945,1,1,959,630,514,116,622,8,1055,425,466,156,
39,"VASLUI",378,161945,,36,0,"str. Pompelor","MUNICIPIUL VASLUI",1,161945,1,1,1501,747,587,160,736,11,1651,904,527,209,
39,"VASLUI",378,161945,,37,0,"str. C-tin Brincoveanu","MUNICIPIUL VASLUI",1,161945,1,1,873,546,432,114,530,16,718,172,389,141,
39,"VASLUI",378,161945,,38,1,"str. Stefan cel Mare,Casa Armatei","MUNICIPIUL VASLUI",1,161945,1,1,418,437,395,42,427,10,474,37,325,102,
39,"VASLUI",378,161794,,39,0,"str. I.C. Bratianu","MUNICIPIUL BARLAD",2,161794,1,1,2107,1342,1271,71,1321,21,2311,969,954,367,
39,"VASLUI",378,161794,,40,0,"str. I.C. Bratianu","MUNICIPIUL BARLAD",2,161794,1,1,1823,1141,1059,82,1123,18,1993,852,855,268,
39,"VASLUI",378,161794,,41,0,"str. 1 Mai","MUNICIPIUL BARLAD",2,161794,1,1,1896,1071,1038,33,1054,17,2086,1015,763,291,
39,"VASLUI",378,161794,,42,0,"str. N. Balcescu,nr. 6","MUNICIPIUL BARLAD",2,161794,1,1,1441,832,785,47,823,9,1585,753,610,213,
39,"VASLUI",378,161794,,43,0,"str. N. Balcescu","MUNICIPIUL BARLAD",2,161794,1,1,2162,1289,1185,104,1272,17,2386,1097,978,294,
39,"VASLUI",378,161794,,44,0,"str. M. Kogalniceanu","MUNICIPIUL BARLAD",2,161794,1,1,2192,1341,1239,102,1318,23,2411,1070,1027,291,
39,"VASLUI",378,161794,,45,0,"str. N. Tonitza,nr. 20","MUNICIPIUL BARLAD",2,161794,1,1,1899,1123,1001,122,1112,11,2089,966,882,230,
39,"VASLUI",378,161794,,46,0,"str. N. Tonitza,nr. 20","MUNICIPIUL BARLAD",2,161794,1,1,1951,989,921,68,983,6,2146,1157,797,186,
39,"VASLUI",378,161794,,47,0,"Aleea Parc,nr. 1","MUNICIPIUL BARLAD",2,161794,1,1,1563,963,881,82,948,15,1716,753,709,239,
39,"VASLUI",378,161794,,48,0,"B-dul Republicii,nr. 268","MUNICIPIUL BARLAD",2,161794,1,1,1960,1139,1042,97,1110,29,2156,1017,910,200,
39,"VASLUI",378,161794,,49,0,"B-dul Republicii,nr. 268","MUNICIPIUL BARLAD",2,161794,1,1,2714,1471,1390,81,1456,15,2980,1509,1041,415,
39,"VASLUI",378,161794,,50,0,"str. Vasile Pirvan,nr. 1","MUNICIPIUL BARLAD",2,161794,1,1,2089,1104,1056,48,1093,11,2291,1187,807,286,
39,"VASLUI",378,161794,,51,0,"str. Vasile Pirvan,nr. 1","MUNICIPIUL BARLAD",2,161794,1,1,1802,1013,927,86,1005,8,1972,959,748,257,
39,"VASLUI",378,161794,,52,0,"str. Vasile Pirvan,nr. 1","MUNICIPIUL BARLAD",2,161794,1,1,2014,1091,1032,59,1083,8,2212,1121,832,251,
39,"VASLUI",378,161794,,53,0,"str. Vasile Pirvan,nr. 1","MUNICIPIUL BARLAD",2,161794,1,1,2657,1356,1283,73,1341,15,2923,1567,1003,338,
39,"VASLUI",378,161794,,54,0,"str. Petru Rares,nr. 41","MUNICIPIUL BARLAD",2,161794,1,1,1733,1114,957,157,1101,13,1905,791,779,322,
39,"VASLUI",378,161794,,55,0,"str. Petru Rares,nr. 41","MUNICIPIUL BARLAD",2,161794,1,1,1607,948,888,60,933,15,1768,820,725,208,
39,"VASLUI",378,161794,,56,0,"str. Dimitrie Cantemir,nr. 15","MUNICIPIUL BARLAD",2,161794,1,1,1650,987,924,63,967,20,1816,829,736,231,
39,"VASLUI",378,161794,,57,0,"str. Dimitrie Cantemir,nr. 15","MUNICIPIUL BARLAD",2,161794,1,1,1684,1022,969,53,1006,16,1848,826,677,329,
39,"VASLUI",378,161794,,58,0,"str. 1 Decembrie","MUNICIPIUL BARLAD",2,161794,1,1,1668,1020,935,85,1004,16,1835,815,754,250,
39,"VASLUI",378,161794,,59,0,"str. 1 Decembrie","MUNICIPIUL BARLAD",2,161794,1,1,1938,1093,1026,67,1074,19,2124,1031,758,316,
39,"VASLUI",378,161794,,60,0,"str. Popa Sapca","MUNICIPIUL BARLAD",2,161794,1,1,1672,900,844,56,888,12,1836,936,662,226,
39,"VASLUI",378,161794,,61,0,"str. Popa Sapca","MUNICIPIUL BARLAD",2,161794,1,1,1584,942,882,60,928,14,1731,789,649,279,
39,"VASLUI",378,161794,,62,0,"str. M. Viteazul,nr. 37","MUNICIPIUL BARLAD",2,161794,1,1,2415,1468,1380,88,1451,17,2657,1189,974,477,
39,"VASLUI",378,161794,,63,0,"str. Carpati,nr. 5","MUNICIPIUL BARLAD",2,161794,1,1,2414,1312,1257,55,1284,28,2655,1343,934,350,
39,"VASLUI",378,161794,,64,0,"str. Carpati,nr. 5","MUNICIPIUL BARLAD",2,161794,1,1,2104,1148,1107,41,1138,10,2314,1166,798,340,
39,"VASLUI",378,161794,,65,0,"str. Carpati,nr. 5","MUNICIPIUL BARLAD",2,161794,1,1,1735,947,887,60,936,11,1907,960,660,276,
39,"VASLUI",378,161794,,66,0,"str. Carpati,nr. 5","MUNICIPIUL BARLAD",2,161794,1,1,1697,956,911,45,944,12,1871,915,639,305,
39,"VASLUI",378,161794,,67,0,"str. Carpati,nr. 5","MUNICIPIUL BARLAD",2,161794,1,1,1942,1140,1069,71,1131,9,2131,991,760,371,
39,"VASLUI",378,161794,,68,0,"B-dul Republicii","MUNICIPIUL BARLAD",2,161794,1,1,2152,1314,1208,106,1296,18,2363,1049,911,385,
39,"VASLUI",378,161794,,69,0,"B-dul Republicii","MUNICIPIUL BARLAD",2,161794,1,1,2469,1479,1354,125,1463,16,2700,1221,977,486,
39,"VASLUI",378,161794,,70,1,"B-dul Republicii,Spitalul municipal de adulti","MUNICIPIUL BARLAD",2,161794,1,1,0,354,0,354,353,1,925,571,273,80,
39,"VASLUI",378,161794,,71,1,"str. Soseaua Tecuciului,nr. 2,UM 01458","MUNICIPIUL BARLAD",2,161794,1,1,0,699,0,699,669,30,825,126,418,251,
39,"VASLUI",378,161829,,72,0,"str. I.A. Anghelus","MUNICIPIUL HUSI",3,161829,1,1,1615,873,817,56,865,8,1777,904,552,313,
39,"VASLUI",378,161829,,73,0,"str. Alex Giugaru","MUNICIPIUL HUSI",3,161829,1,1,1917,1100,989,111,1089,11,2109,1009,725,364,
39,"VASLUI",378,161829,,74,0,"str. A.I. Cuza","MUNICIPIUL HUSI",3,161829,1,1,2080,1158,1068,90,1145,13,2288,1130,763,382,
39,"VASLUI",378,161829,,75,0,"str. A.I. Cuza","MUNICIPIUL HUSI",3,161829,1,1,1126,625,578,47,620,5,1239,614,420,200,
39,"VASLUI",378,161829,,76,0,"str. A.I. Cuza","MUNICIPIUL HUSI",3,161829,1,1,2288,1236,1117,119,1219,17,2517,1281,835,384,
39,"VASLUI",378,161829,,77,0,"str. Ioan Voda cel Viteaz","MUNICIPIUL HUSI",3,161829,1,1,1152,701,610,91,685,16,1272,571,462,223,
39,"VASLUI",378,161829,,78,0,"str. 1 Decembrie","MUNICIPIUL HUSI",3,161829,1,1,1648,978,794,184,964,14,1813,835,624,340,
39,"VASLUI",378,161829,,79,0,"str. Aleea Scolii","MUNICIPIUL HUSI",3,161829,1,1,1855,1022,867,155,1015,7,2040,1018,667,348,
39,"VASLUI",378,161829,,80,0,"str. Aleea Scolii","MUNICIPIUL HUSI",3,161829,1,1,1517,834,746,88,825,9,1665,831,549,276,
39,"VASLUI",378,161829,,81,0,"str. Corni","MUNICIPIUL HUSI",3,161829,1,1,983,508,479,29,484,24,1084,576,304,180,
39,"VASLUI",378,161829,,82,0,"str. Corni","MUNICIPIUL HUSI",3,161829,1,1,1724,1034,941,93,1007,27,1896,862,591,416,
39,"VASLUI",378,161829,,83,0,"str. I.L. Caragiale","MUNICIPIUL HUSI",3,161829,1,1,1932,1136,1054,82,1117,19,2152,1016,723,394,
39,"VASLUI",378,161829,,84,0,"str. Anton Sirbu","MUNICIPIUL HUSI",3,161829,1,1,2048,1116,1041,75,1106,10,2253,1137,701,405,
39,"VASLUI",378,161829,,85,0,"Soseaua Husi-Drinceni","MUNICIPIUL HUSI",3,161829,1,1,2038,1132,1027,105,1120,12,2242,1110,672,448,
39,"VASLUI",378,161829,,86,1,"str. G-ral Teleman,Casa Armatei","MUNICIPIUL HUSI",3,161829,1,1,0,83,0,83,82,1,86,3,50,32,
39,"VASLUI",378,161829,,87,1,"Caminul de batrini","MUNICIPIUL HUSI",3,161829,1,1,108,111,96,15,108,3,115,4,86,22,
39,"VASLUI",378,161856,,88,0,"Casa de Cultura","ORAS NEGRESTI",4,161856,2,1,1413,875,770,105,862,13,1558,683,524,338,
39,"VASLUI",378,161856,,89,0,"Casa de Cultura","ORAS NEGRESTI",4,161856,2,1,1391,886,812,74,878,8,1530,644,544,334,
39,"VASLUI",378,161856,,90,0,"Clubul Elevilor","ORAS NEGRESTI",4,161856,2,1,1373,885,795,90,866,19,1510,625,506,360,
39,"VASLUI",378,161856,,91,0,"Scoala generala","ORAS NEGRESTI",4,161856,2,1,799,511,459,52,505,6,883,372,319,186,
39,"VASLUI",378,161856,,92,0,"Camin Cultural Glodeni","ORAS NEGRESTI",4,161856,2,1,243,215,182,33,206,9,273,58,155,51,
39,"VASLUI",378,161856,,93,0,"Scoala generala Valea Mare","ORAS NEGRESTI",4,161856,2,1,892,553,511,42,537,16,981,428,336,201,
39,"VASLUI",378,161856,,94,0,"Scoala generala Cioatele","ORAS NEGRESTI",4,161856,2,1,183,162,144,18,155,7,203,41,90,65,
39,"VASLUI",378,161856,,95,0,"Scoala generala Parpanita","ORAS NEGRESTI",4,161856,2,1,450,320,277,43,310,10,498,178,209,101,
39,"VASLUI",378,161856,,96,0,"Scoala generala Cazanesti","ORAS NEGRESTI",4,161856,2,1,367,260,218,42,253,7,403,143,183,70,
39,"VASLUI",378,162014,,97,0,"Scoala generala","ALBESTI",5,162014,0,3,1280,825,629,196,810,15,1408,583,586,224,
39,"VASLUI",378,162014,,98,0,"Scoala generala CORNI-ALBESTI","ALBESTI",5,162014,0,3,1260,665,565,100,641,24,1386,721,464,177,
39,"VASLUI",378,162069,,99,0,"Scoala generala clasele I-VIII","ALEXANDRU VLAHUTA",6,162069,0,3,812,531,381,150,519,12,892,361,439,80,
39,"VASLUI",378,162069,,100,0,"Scoala generala BUDA","ALEXANDRU VLAHUTA",6,162069,0,3,425,326,250,76,315,11,565,239,262,53,
39,"VASLUI",378,162069,,101,0,"Scoala generala FLORESTI","ALEXANDRU VLAHUTA",6,162069,0,3,524,396,284,112,382,14,576,180,334,48,
39,"VASLUI",378,162069,,102,0,"Scoala generala IBANESTI","ALEXANDRU VLAHUTA",6,162069,0,3,647,441,350,91,435,6,864,423,310,125,
39,"VASLUI",378,162069,,103,0,"Scoala generala MINZATI","ALEXANDRU VLAHUTA",6,162069,0,3,549,355,274,81,349,6,480,125,262,87,
39,"VASLUI",378,162149,,104,0,"Scoala generala","ARSURA",7,162149,0,3,785,622,535,87,531,4,863,328,424,107,
39,"VASLUI",378,162149,,105,0,"Scoala generala PIHNESTI","ARSURA",7,162149,0,3,707,535,443,92,523,12,1021,486,372,151,
39,"VASLUI",378,162194,,106,0,"Scoala generala GARA BANCA","BANCA",11,162194,0,3,956,700,534,166,690,10,1052,352,556,134,
39,"VASLUI",378,162194,,107,0,"Scoala generala","BANCA",11,162194,0,3,1164,536,469,67,523,13,1281,745,406,117,
39,"VASLUI",378,162194,,108,0,"Scoala generala GHERMANESTI","BANCA",11,162194,0,3,499,296,251,45,290,6,549,253,231,59,
39,"VASLUI",378,162194,,109,0,"Scoala generala STOISESTI","BANCA",11,162194,0,3,622,384,329,55,373,11,684,300,305,68,
39,"VASLUI",378,162194,,110,0,"Scoala generala TIFU","BANCA",11,162194,0,3,533,335,279,56,327,8,586,251,269,58,
39,"VASLUI",378,162194,,111,0,"Scoala generala SIRBI","BANCA",11,162194,0,3,620,582,472,110,576,6,682,100,499,77,
39,"VASLUI",378,162327,,112,0,"Scoala generala","BACANI",8,162327,0,3,1435,785,702,83,767,18,1579,794,627,140,
39,"VASLUI",378,162327,,113,0,"Scoala generala SUSENI","BACANI",8,162327,0,3,503,353,278,75,348,5,553,200,263,85,
39,"VASLUI",378,162381,,114,0,"Scoala generala","BACESTI",9,162381,0,3,2252,1320,1098,222,1291,29,2481,1161,953,338,
39,"VASLUI",378,162381,,115,0,"Scoala generala VOVRIESTI","BACESTI",9,162381,0,3,519,324,269,55,320,4,570,246,233,87,
39,"VASLUI",378,162452,,116,0,"Scoala generala","BALTENI",10,162452,0,3,1258,884,782,102,865,19,1384,500,625,240,
39,"VASLUI",378,162498,,117,0,"Scoala generala nr. 1","BEREZENI",12,162498,0,3,2042,1461,1421,40,1439,22,2246,785,1198,241,
39,"VASLUI",378,162498,,118,0,"Scoala generala MUSATA","BEREZENI",12,162498,0,3,420,320,274,46,312,8,462,142,248,64,
39,"VASLUI",378,162498,,119,0,"Scoala generala MUSATA","BEREZENI",12,162498,0,3,575,410,332,78,402,8,633,223,345,57,
39,"VASLUI",378,162498,,120,0,"Scoala generala nr. 2","BEREZENI",12,162498,0,3,1147,814,683,131,802,12,1267,453,690,112,
39,"VASLUI",378,162498,,121,0,"Scoala generala STUHULET","BEREZENI",12,162498,0,3,258,211,180,31,205,6,284,73,180,25,
39,"VASLUI",378,162559,,122,0,"Caminul Cultural","BLAGESTI",13,162559,0,3,1152,641,550,91,622,19,1270,629,462,160,
39,"VASLUI",378,162559,,123,0,"Scoala generala IGESTI","BLAGESTI",13,162559,0,3,427,230,183,47,224,6,470,240,163,61,
39,"VASLUI",378,162595,,124,0,"Scoala generala","BOGDANA",14,162595,0,3,1069,625,540,85,613,12,1176,551,421,192,
39,"VASLUI",378,162595,,125,0,"Scoala generala LACUL BABEI","BOGDANA",14,162595,0,3,292,192,160,32,187,5,339,147,135,52,
39,"VASLUI",378,162693,,126,0,"Scoala generala clasele I-VIII","BOGDANESTI",15,162693,0,3,1061,735,584,151,724,11,1169,434,566,158,
39,"VASLUI",378,162693,,127,0,"Scoala generala clasele I-VIII ORGOIESTI","BOGDANESTI",15,162693,0,3,300,181,140,41,178,3,332,151,133,45,
39,"VASLUI",378,162693,,128,0,"Scoala generala clasele I-VIII UNTESTI","BOGDANESTI",15,162693,0,3,1148,713,575,138,701,12,1263,550,568,133,
39,"VASLUI",378,162791,,129,0,"Scoala generala","BOGDANITA",16,162791,0,3,756,382,310,72,373,9,831,449,289,84,
39,"VASLUI",378,162791,,130,0,"Scoala generala CEPESTI","BOGDANITA",16,162791,0,3,485,294,245,49,288,6,542,248,216,72,
39,"VASLUI",378,162871,,131,0,"Scoala generala","BOTESTI",17,162871,0,3,932,619,525,94,616,3,1052,433,478,138,
39,"VASLUI",378,162871,,132,0,"Scoala generala GUGESTI","BOTESTI",17,162871,0,3,963,646,574,72,636,10,1062,416,497,139,
39,"VASLUI",378,162924,,133,0,"Scoala generala BUNESTI","BUNESTI-AVERESTI",18,162924,0,3,1307,923,813,110,914,9,1438,515,659,255,
39,"VASLUI",378,162924,,134,0,"Scoala generala AVERESTI","BUNESTI-AVERESTI",18,162924,0,3,1191,631,551,80,624,7,1310,679,505,119,
39,"VASLUI",378,163002,,135,0,"Scoala generala","CODAESTI",19,163002,0,3,1252,792,695,97,773,19,1383,591,580,193,
39,"VASLUI",378,163002,,136,0,"Liceul Codaiesti","CODAESTI",19,163002,0,3,1143,574,509,65,564,10,1254,680,438,126,
39,"VASLUI",378,163002,,137,0,"Scoala generala PRIBESTI","CODAESTI",19,163002,0,3,1101,664,608,56,658,6,1211,547,523,135,
39,"VASLUI",378,163002,,138,0,"Cooperatia de Consum Codaiesti","CODAESTI",19,163002,0,3,411,305,272,33,299,6,453,148,221,78,
39,"VASLUI",378,163057,,139,0,"Scoala generala Coroiestii de Jos","COROIESTI",20,163057,0,3,838,506,416,90,491,15,922,416,387,104,
39,"VASLUI",378,163057,,140,0,"Scoala generala clasele I-VIII MIRENI","COROIESTI",20,163057,0,3,881,603,585,18,585,18,969,366,472,113,
39,"VASLUI",378,163137,,141,0,"Caminul Cultural","COSTESTI",21,163137,0,3,1745,1044,918,126,1029,15,1921,877,666,363,
39,"VASLUI",378,163137,,142,0,"Scoala generala PUNTISENI","COSTESTI",21,163137,0,3,619,372,296,76,364,8,681,309,274,90,
39,"VASLUI",378,163137,,143,0,"Scoala generala CHITCANI","COSTESTI",21,163137,0,3,294,216,177,39,215,1,324,108,153,62,
39,"VASLUI",378,163208,,144,0,"Caminul Cultural","CRETESTI",22,163208,0,3,1514,865,726,139,851,14,1664,799,619,232,
39,"VASLUI",378,163253,,145,0,"Caminul Cultural","DANESTI",23,163253,0,3,585,324,260,64,317,7,647,323,243,74,
39,"VASLUI",378,163253,,146,0,"Scoala generala EMIL RACOVITA","DANESTI",23,163253,0,3,940,513,456,57,499,14,1034,521,416,83,
39,"VASLUI",378,163253,,147,0,"Scoala generala BEREASA","DANESTI",23,163253,0,3,332,214,170,44,212,2,365,151,157,55,
39,"VASLUI",378,163253,,148,0,"Scoala generala TATARANI","DANESTI",23,163253,0,3,215,134,101,33,131,3,237,103,110,21,
39,"VASLUI",378,163324,,149,0,"Caminul Cultural","DELENI",24,163324,0,3,1403,873,751,122,859,14,1536,663,547,312,
39,"VASLUI",378,163324,,150,0,"Scoala generala BULBOACA","DELENI",24,163324,0,3,518,389,313,76,383,6,570,181,284,99,
39,"VASLUI",378,163379,,151,0,"Scoala generala","DELESTI",25,163379,0,3,975,597,528,69,579,18,1110,513,412,167,
39,"VASLUI",378,163379,,152,0,"Scoala generala HIRSOVA","DELESTI",25,163379,0,3,1175,681,597,84,653,28,1277,596,527,126,
39,"VASLUI",378,163379,,153,0,"Scoala generala  COZMESTI","DELESTI",25,163379,0,3,998,569,489,80,565,4,1271,702,430,135,
39,"VASLUI",378,163379,,154,0,"Scoala generala FISTICI","DELESTI",25,163379,0,3,903,535,453,82,519,16,799,264,425,94,
39,"VASLUI",378,164277,,155,0,"Scoala generala HURDUGI","DIMITRIE CANTEMIR",26,164277,0,3,599,392,348,44,383,9,660,268,313,70,
39,"VASLUI",378,164277,,156,0,"Scoala generala GRUMEZOAIA","DIMITRIE CANTEMIR",26,164277,0,3,545,439,388,51,430,9,602,163,300,130,
39,"VASLUI",378,164277,,157,0,"Scoala generala GUSITEI","DIMITRIE CANTEMIR",26,164277,0,3,684,572,516,56,565,7,750,178,486,79,
39,"VASLUI",378,164277,,158,0,"Scoala generala PLOTONESTI","DIMITRIE CANTEMIR",26,164277,0,3,325,292,265,27,284,8,359,67,236,48,
39,"VASLUI",378,164277,,159,0,"Scoala generala URLATI","DIMITRIE CANTEMIR",26,164277,0,3,251,242,205,37,219,23,277,35,198,21,
39,"VASLUI",378,163486,,160,0,"Caminul Cultural","DRAGOMIRESTI",27,163486,0,3,851,482,400,82,476,6,967,485,336,140,
39,"VASLUI",378,163486,,161,0,"Caminul Cultural DOAGELE","DRAGOMIRESTI",27,163486,0,3,768,443,382,61,420,23,842,399,323,97,
39,"VASLUI",378,163486,,162,0,"Scoala generala VLADIA","DRAGOMIRESTI",27,163486,0,3,508,374,301,73,372,2,563,189,243,129,
39,"VASLUI",378,163486,,163,0,"Caminul Cultural RADENI","DRAGOMIRESTI",27,163486,0,3,1281,717,577,140,690,27,1383,666,606,84,
39,"VASLUI",378,163618,,164,0,"Scoala generala cu clasele I-VIII GHERMANESTI","DRANCENI",28,163618,0,3,1856,1163,1035,128,1155,8,2042,879,796,359,
39,"VASLUI",378,163618,,165,0,"Scoala generala","DRANCENI",28,163618,0,3,447,306,222,84,297,9,490,184,232,65,
39,"VASLUI",378,163618,,166,0,"Scoala generala  RISESTI","DRANCENI",28,163618,0,3,1354,855,701,154,842,13,1487,632,566,276,
39,"VASLUI",378,163681,,167,0,"Scoala generala","DUDA-EPURENI",29,163681,0,3,1449,821,739,82,793,28,1592,771,601,192,
39,"VASLUI",378,163681,,168,0,"Scoala generala cu clasele I-VIII DUDA","DUDA-EPURENI",29,163681,0,3,1304,898,770,128,883,15,1434,536,522,361,
39,"VASLUI",378,163681,,169,0,"Scoala generala cu clasele I-VIII VALEA GRECULUI","DUDA-EPURENI",29,163681,0,3,1188,811,671,140,797,14,1188,377,440,357,
39,"VASLUI",378,163734,,170,0,"Caminul Cultural","DUMESTI",30,163734,0,3,1976,967,851,116,957,10,2169,1202,659,298,
39,"VASLUI",378,163734,,171,0,"Scoala generala VALEA MARE","DUMESTI",30,163734,0,3,828,550,433,117,532,18,913,363,377,155,
39,"VASLUI",378,163789,,172,0,"Scoala generala","EPURENI",31,163789,0,3,1868,1042,900,142,1028,14,2055,1013,726,302,
39,"VASLUI",378,163789,,173,0,"Scoala veche  BURSUCI","EPURENI",31,163789,0,3,740,436,375,61,430,6,818,382,324,106,
39,"VASLUI",378,163832,,174,0,"Scoala generala","FALCIU",32,163832,0,3,1085,699,578,121,688,11,1194,495,468,220,
39,"VASLUI",378,163832,,175,0,"Caminul Cultural","FALCIU",32,163832,0,3,1242,995,805,190,988,7,1366,371,700,288,
39,"VASLUI",378,163832,,176,0,"Scoala generala BOGDANESTI","FALCIU",32,163832,0,3,542,371,311,60,361,10,596,225,281,80,
39,"VASLUI",378,163832,,177,0,"Scoala generala RINZESTI","FALCIU",32,163832,0,3,972,710,611,99,698,12,1069,359,574,124,
39,"VASLUI",378,163832,,178,0,"Scoala generala BOZIA","FALCIU",32,163832,0,3,480,373,338,35,362,11,528,155,263,99,
39,"VASLUI",378,163832,,179,0,"Scoala generala COPACEANA","FALCIU",32,163832,0,3,548,436,368,68,421,15,604,168,346,75,
39,"VASLUI",378,163903,,180,0,"fosta Primarie","GAGESTI",33,163903,0,3,431,275,237,38,273,2,474,199,207,66,
39,"VASLUI",378,163903,,181,0,"Scoala generala GIURCANI","GAGESTI",33,163903,0,3,905,557,494,63,549,8,996,439,390,159,
39,"VASLUI",378,163903,,182,0,"Scoala generala TUPILATI","GAGESTI",33,163903,0,3,320,271,210,61,262,9,352,81,185,77,
39,"VASLUI",378,163967,,183,0,"Caminul Cultural","GHERGHESTI",35,163967,0,3,965,544,396,148,536,8,1060,516,444,92,
39,"VASLUI",378,163967,,184,0,"Scoala generala LUNCA","GHERGHESTI",35,163967,0,3,367,219,182,37,219,0,404,185,179,40,
39,"VASLUI",378,163967,,185,0,"Scoala generala CORODESTI","GHERGHESTI",35,163967,0,3,284,201,150,51,197,4,312,111,144,53,
39,"VASLUI",378,163967,,186,0,"Scoala generala CHETROSU","GHERGHESTI",35,163967,0,3,587,493,376,117,486,7,645,152,365,121,
39,"VASLUI",378,164062,,187,0,"Gradinita de copii","GIRCENI",34,164062,0,3,1107,766,669,97,750,16,1219,453,534,216,
39,"VASLUI",378,164062,,188,0,"Scoala generala RACOVA","GIRCENI",34,164062,0,3,848,558,448,110,550,8,934,376,430,120,
39,"VASLUI",378,164133,,189,0,"Scoala generala","GRIVITA",36,164133,0,3,1093,780,634,146,768,12,1203,423,614,154,
39,"VASLUI",378,164133,,190,0,"Scoala generala TRESTIANA","GRIVITA",36,164133,0,3,924,616,534,82,609,7,1011,395,435,174,
39,"VASLUI",378,164133,,191,0,"Scoala generala  ODAIA BURSUCANI","GRIVITA",36,164133,0,3,464,345,267,78,336,9,510,165,285,51,
39,"VASLUI",378,164133,,192,0,"Scoala generala  FRUNTISENI","GRIVITA",36,164133,0,3,727,466,418,48,459,7,800,334,399,60,
39,"VASLUI",378,164133,,193,0,"Scoala generala  GRAJDENI","GRIVITA",36,164133,0,3,574,401,329,72,338,63,632,231,302,36,
39,"VASLUI",378,164197,,194,0,"Scoala generala","HOCENI",37,164197,0,3,512,337,275,62,334,3,553,216,270,64,
39,"VASLUI",378,164197,,195,0,"Gradinita de copii BARBOSI","HOCENI",37,164197,0,3,635,437,368,69,427,10,697,260,362,65,
39,"VASLUI",378,164197,,196,0,"Scoala generala DELENI","HOCENI",37,164197,0,3,533,326,275,51,321,5,586,260,248,73,
39,"VASLUI",378,164197,,197,0,"Scoala generala OTELENI","HOCENI",37,164197,0,3,535,410,325,85,404,6,588,178,312,92,
39,"VASLUI",378,164197,,198,0,"Scoala generala SISCANI","HOCENI",37,164197,0,3,467,328,270,58,318,10,515,187,258,60,
39,"VASLUI",378,164339,,199,0,"Scoala generala","IANA",38,164339,0,3,1904,1182,980,202,1160,22,2087,905,704,456,
39,"VASLUI",378,164339,,200,0,"Scoala generala SILISTEA","IANA",38,164339,0,3,912,656,574,82,651,5,1003,347,445,206,
39,"VASLUI",378,164393,,201,0,"Scoala generala","IVANESTI",39,164393,0,3,1068,723,553,170,707,16,1170,447,595,112,
39,"VASLUI",378,164393,,202,0,"Scoala generala BLESCA","IVANESTI",39,164393,0,3,1086,708,526,182,689,19,1195,487,581,108,
39,"VASLUI",378,164393,,203,0,"Scoala generala COSESTI","IVANESTI",39,164393,0,3,758,410,319,91,396,14,836,426,304,92,
39,"VASLUI",378,164393,,204,0,"Scoala generala VALEA MARE","IVANESTI",39,164393,0,3,440,303,247,56,297,6,483,180,252,45,
39,"VASLUI",378,164393,,205,0,"Scoala generala  BROSTENI","IVANESTI",39,164393,0,3,509,285,228,57,278,7,560,275,231,47,
39,"VASLUI",378,164543,,206,0,"Scoala generala cu clasele I-VIII","IVESTI",40,164543,0,3,2279,1386,1288,98,1364,22,2508,1122,1129,235,
39,"VASLUI",378,164543,,207,0,"Scoala generala cu clasele I-VIII POGONESTI","IVESTI",40,164543,0,3,1489,930,828,102,923,7,1642,712,742,181,
39,"VASLUI",378,164598,,208,0,"Scoala generala","LAZA",41,164598,0,3,1779,978,839,139,954,24,1957,979,679,275,
39,"VASLUI",378,164598,,209,0,"Scoala generala  SAUCA","LAZA",41,164598,0,3,879,527,440,87,518,9,967,440,418,100,
39,"VASLUI",378,164598,,210,0,"Scoala generala  PUSCASI","LAZA",41,164598,0,3,1806,965,836,129,936,29,1981,1016,643,293,
39,"VASLUI",378,164598,,211,0,"Scoala generala  TEISOR","LAZA",41,164598,0,3,344,221,192,29,209,12,377,156,156,53,
39,"VASLUI",378,164598,,212,0,"Scoala generala  VALEA TARGULUI","LAZA",41,164598,0,3,152,130,94,36,126,4,167,37,93,33,
39,"VASLUI",378,164687,,213,0,"Caminul Cultural","LIPOVAT",42,164687,0,3,1670,1101,957,144,1079,22,1843,742,867,212,
39,"VASLUI",378,164687,,214,0,"Scoala generala  CHITOC","LIPOVAT",42,164687,0,3,840,665,596,69,654,11,925,260,468,186,
39,"VASLUI",378,164687,,215,0,"Scoala generala FUNDU VAII","LIPOVAT",42,164687,0,3,615,398,332,66,390,8,679,281,319,71,
39,"VASLUI",378,164749,,216,0,"Scoala generala","LUNCA BANULUI",43,164749,0,3,1619,1048,942,106,1029,19,1780,732,778,251,
39,"VASLUI",378,164749,,217,0,"Scoala generala OTETOAIA","LUNCA BANULUI",43,164749,0,3,906,509,468,41,501,8,996,487,339,162,
39,"VASLUI",378,164749,,218,0,"Scoala generala BROSCOSESTI","LUNCA BANULUI",43,164749,0,3,469,253,219,34,248,5,516,263,167,81,
39,"VASLUI",378,164829,,219,0,"Scoala generala","MALUSTENI",44,164829,0,3,757,471,375,96,464,7,833,362,316,148,
39,"VASLUI",378,164829,,220,0,"Scoala generala TUTCANI","MALUSTENI",44,164829,0,3,733,474,382,92,460,14,806,332,311,149,
39,"VASLUI",378,164829,,221,0,"Scoala generala LUPESTI","MALUSTENI",44,164829,0,3,880,583,518,65,573,10,967,384,489,84,
39,"VASLUI",378,164892,,222,0,"Caminul Cultural","MICLESTI",45,164892,0,3,829,619,479,140,608,11,912,293,453,155,
39,"VASLUI",378,164892,,223,0,"Scoala generala CHIRCESTI","MICLESTI",45,164892,0,3,1166,666,586,80,643,23,1283,617,505,138,
39,"VASLUI",378,164892,,224,0,"Scoala generala POPESTI","MICLESTI",45,164892,0,3,430,306,259,47,303,3,470,164,236,67,
39,"VASLUI",378,164936,,225,0,"Scoala generala","MUNTENI DE JOS",46,164936,0,3,2074,1221,1074,147,1200,21,2276,1055,895,305,
39,"VASLUI",378,164936,,226,0,"Scoala generala MINJESTI","MUNTENI DE JOS",46,164936,0,3,760,513,431,82,496,17,834,321,389,107,
39,"VASLUI",378,164981,,227,0,"Caminul Cultural","MURGENI",47,164981,0,3,2573,1551,1401,150,1534,17,2826,1275,957,577,
39,"VASLUI",378,164981,,228,0,"Scoala generala CIRJA","MURGENI",47,164981,0,3,913,738,561,177,723,15,999,261,567,156,
39,"VASLUI",378,164981,,229,0,"Scoala generala FLORENI","MURGENI",47,164981,0,3,509,347,282,65,342,5,562,215,200,142,
39,"VASLUI",378,164981,,230,0,"Magazinul satesc SARATENI","MURGENI",47,164981,0,3,599,365,293,72,365,0,658,293,239,126,
39,"VASLUI",378,164981,,231,0,"Scoala generala SCHINENI","MURGENI",47,164981,0,3,546,337,285,52,329,8,603,266,261,68,
39,"VASLUI",378,164981,,232,0,"Scoala generala RAIU","MURGENI",47,164981,0,3,588,380,336,44,374,6,647,267,296,78,
39,"VASLUI",378,165069,,233,0,"Scoala generala","OLTENESTI",48,165069,0,3,714,428,353,75,416,12,787,359,302,114,
39,"VASLUI",378,165069,,234,0,"Scoala generala VINETESTI","OLTENESTI",48,165069,0,3,612,389,303,86,381,8,675,286,314,67,
39,"VASLUI",378,165069,,235,0,"Scoala generala TIRZII","OLTENESTI",48,165069,0,3,984,732,610,122,729,3,1087,355,543,186,
39,"VASLUI",378,165130,,236,0,"Caminul Cultural","OSESTI",49,165130,0,3,1384,839,738,101,831,8,1522,683,599,232,
39,"VASLUI",378,165130,,237,0,"Scoala generala cu clasele I-VIII BUDA","OSESTI",49,165130,0,3,1033,621,545,76,603,18,1136,515,429,174,
39,"VASLUI",378,165185,,238,0,"Scoala generala","PADURENI",50,165185,0,3,2135,1106,1006,100,1075,31,2349,1243,742,333,
39,"VASLUI",378,165185,,239,0,"Scoala generala VALENI","PADURENI",50,165185,0,3,1194,717,657,60,695,22,1311,594,435,260,
39,"VASLUI",378,165185,,240,0,"Scoala generala IVANESTI","PADURENI",50,165185,0,3,439,271,232,39,261,10,481,210,212,49,
39,"VASLUI",378,165274,,241,0,"Caminul Cultural","PERIENI",51,165274,0,3,2618,1768,1599,169,1737,31,2888,1120,1424,313,
39,"VASLUI",378,165274,,242,0,"Scoala generala CIOCANI","PERIENI",51,165274,0,3,740,493,354,139,485,8,810,317,403,82,
39,"VASLUI",378,165274,,243,0,"Scoala generala CRING","PERIENI",51,165274,0,3,354,313,266,47,308,5,380,67,232,76,
39,"VASLUI",378,165416,,244,0,"Scoala generala","POGANA",52,165416,0,3,1177,605,518,87,595,10,1290,685,463,132,
39,"VASLUI",378,165416,,245,0,"Scoala generala  BOGESTI","POGANA",52,165416,0,3,1205,432,380,52,417,15,1322,890,340,77,
39,"VASLUI",378,165336,,246,0,"Scoala generala","POIENESTI",53,165336,0,3,1030,558,480,78,554,4,1133,575,445,109,
39,"VASLUI",378,165336,,247,0,"Scoala generala OPRISITA","POIENESTI",53,165336,0,3,623,442,359,83,437,5,688,246,313,124,
39,"VASLUI",378,165470,,248,0,"Scoala generala","PUIESTI",54,165470,0,3,1450,989,769,220,980,9,1595,606,795,185,
39,"VASLUI",378,165470,,249,0,"Scoala generala RUSI","PUIESTI",54,165470,0,3,418,326,246,80,311,15,455,129,253,58,
39,"VASLUI",378,165470,,250,0,"Scoala generala CALIMANESTI","PUIESTI",54,165470,0,3,304,277,172,105,266,11,329,52,241,25,
39,"VASLUI",378,165470,,251,0,"Scoala generala  LALESTI","PUIESTI",54,165470,0,3,835,567,432,135,561,6,925,358,493,68,
39,"VASLUI",378,165470,,252,0,"Scoala generala CETATUIA","PUIESTI",54,165470,0,3,454,274,228,46,270,4,498,224,219,51,
39,"VASLUI",378,165470,,253,0,"Scoala generala BARTALUS-RAZESI","PUIESTI",54,165470,0,3,305,219,157,62,213,6,343,124,175,38,
39,"VASLUI",378,165611,,254,0,"Scoala generala","PUNGESTI",55,165611,0,3,904,591,448,143,585,6,992,401,409,176,
39,"VASLUI",378,165611,,255,0,"Scoala generala ARMASOAIA","PUNGESTI",55,165611,0,3,694,448,373,75,436,12,764,316,278,158,
39,"VASLUI",378,165611,,256,0,"Scoala generala  TOPORASTI","PUNGESTI",55,165611,0,3,438,353,236,117,345,8,491,138,214,131,
39,"VASLUI",378,165611,,257,0,"Scoala generala CURSESTI-DEAL","PUNGESTI",55,165611,0,3,553,245,199,46,239,6,608,363,197,42,
39,"VASLUI",378,165719,,258,0,"Scoala generala","REBRICEA",56,165719,0,3,1546,865,699,166,851,14,1702,837,647,204,
39,"VASLUI",378,165719,,259,0,"Scoala generala DRAXENI","REBRICEA",56,165719,0,3,1225,699,576,123,685,14,1343,644,518,167,
39,"VASLUI",378,165817,,260,0,"Scoala generala","ROSIESTI",57,165817,0,3,1088,685,579,106,673,12,1188,503,452,221,
39,"VASLUI",378,165817,,261,0,"Scoala generala VALEA LUI DARIE","ROSIESTI",57,165817,0,3,587,378,343,35,373,5,644,266,315,58,
39,"VASLUI",378,165817,,262,0,"Scoala generala IDRICI","ROSIESTI",57,165817,0,3,602,400,327,73,386,14,659,259,303,83,
39,"VASLUI",378,165817,,263,0,"Scoala generala GURA IDRICI","ROSIESTI",57,165817,0,3,414,253,204,49,241,12,457,204,184,57,
39,"VASLUI",378,165817,,264,0,"Scoala generala GARA ROSIESTI","ROSIESTI",57,165817,0,3,284,225,205,20,222,3,323,98,159,63,
39,"VASLUI",378,165899,,265,0,"Caminul Cultural","SOLESTI",58,165899,0,3,1128,728,632,96,720,8,1242,514,570,150,
39,"VASLUI",378,165899,,266,0,"Scoala generala SERBOTESTI","SOLESTI",58,165899,0,3,850,549,461,88,536,13,936,387,420,116,
39,"VASLUI",378,165899,,267,0,"Scoala generala  STIOBORANI","SOLESTI",58,165899,0,3,477,260,210,50,249,11,525,265,203,46,
39,"VASLUI",378,165899,,268,0,"Scoala generala VALEA SILISTEI","SOLESTI",58,165899,0,3,610,316,275,41,310,6,671,355,238,72,
39,"VASLUI",378,165979,,269,0,"Scoala generala","STANILESTI",59,165979,0,3,2820,1774,1655,119,1744,30,3105,1331,1253,491,
39,"VASLUI",378,165979,,270,0,"Scoala generala BUDU CANTEMIR","STANILESTI",59,165979,0,3,432,251,229,22,246,5,476,225,180,66,
39,"VASLUI",378,165979,,271,0,"Scoala generala POGONESTI","STANILESTI",59,165979,0,3,1296,774,689,85,759,15,1429,655,569,190,
39,"VASLUI",378,166057,,272,0,"Caminul Cultural","STEFAN CEL MARE",60,166057,0,3,810,583,474,109,573,10,891,308,425,148,
39,"VASLUI",378,166057,,273,0,"Scoala generala BIRZESTI","STEFAN CEL MARE",60,166057,0,3,1085,792,695,97,772,20,1194,402,595,177,
39,"VASLUI",378,166057,,274,0,"Scoala generala MARASENI","STEFAN CEL MARE",60,166057,0,3,613,478,393,85,471,7,676,198,380,91,
39,"VASLUI",378,166137,,275,0,"Caminul Cultural","SULETEA",61,166137,0,3,1513,918,787,131,901,17,1661,743,635,266,
39,"VASLUI",378,166137,,276,0,"Scoala generala FEDESTI","SULETEA",61,166137,0,3,524,326,283,43,315,11,576,250,253,62,
39,"VASLUI",378,166182,,277,0,"Scoala generala nr.1","TANACU",63,166182,0,3,1874,1167,1027,140,1145,22,2067,900,843,302,
39,"VASLUI",378,166182,,278,0,"Scoala generala MUNTENI DE SUS","TANACU",63,166182,0,3,1133,680,569,111,671,9,1246,566,489,182,
39,"VASLUI",378,166182,,279,0,"Scoala generala SATU NOU","TANACU",63,166182,0,3,1488,1105,936,169,1093,12,1609,504,794,299,
39,"VASLUI",378,166235,,280,0,"Caminul Cultural","TACUTA",62,166235,0,3,685,453,380,73,444,9,759,306,355,89,
39,"VASLUI",378,166235,,281,0,"Scoala generala DUMASCA","TACUTA",62,166235,0,3,356,234,202,32,232,2,397,163,171,61,
39,"VASLUI",378,166235,,282,0,"Scoala generala MIRCESTI","TACUTA",62,166235,0,3,297,217,160,57,212,5,335,118,178,34,
39,"VASLUI",378,166235,,283,0,"Scoala generala FOCSASCA","TACUTA",62,166235,0,3,524,364,322,42,358,6,582,218,247,111,
39,"VASLUI",378,166235,,284,0,"Scoala generala PROTOPOPESTI","TACUTA",62,166235,0,3,778,436,390,46,422,14,864,428,286,136,
39,"VASLUI",378,166315,,285,0,"Caminul Cultural","TATARANI",64,166315,0,3,958,599,502,97,592,7,1055,456,406,186,
39,"VASLUI",378,166315,,286,0,"Scoala generala BALTATI","TATARANI",64,166315,0,3,585,334,299,35,330,4,642,308,253,77,
39,"VASLUI",378,166315,,287,0,"Scoala generala STROIESTI","TATARANI",64,166315,0,3,529,321,268,53,317,4,584,263,252,65,
39,"VASLUI",378,166413,,288,0,"Scoala generala","TODIRESTI",65,166413,0,3,1785,976,869,107,956,19,1958,983,663,293,
39,"VASLUI",378,166413,,289,0,"Scoala generala SOFRONESTI","TODIRESTI",65,166413,0,3,767,488,418,70,488,0,840,352,387,101,
39,"VASLUI",378,166413,,290,0,"Scoala generala RAFAILA","TODIRESTI",65,166413,0,3,1529,740,697,43,721,19,1679,939,525,196,
39,"VASLUI",378,166529,,291,0,"Scoala generala","TUTOVA",66,166529,0,3,1292,910,697,213,897,13,1425,515,606,291,
39,"VASLUI",378,166529,,292,0,"Scoala generala CRIVESTI","TUTOVA",66,166529,0,3,685,422,357,65,414,8,754,332,301,113,
39,"VASLUI",378,166529,,293,0,"Scoala generala SALCENI","TUTOVA",66,166529,0,3,785,602,509,93,584,18,862,260,453,131,
39,"VASLUI",378,166529,,294,0,"Scoala generala POCHIDIA","TUTOVA",66,166529,0,3,601,400,304,96,390,10,659,259,293,97,
39,"VASLUI",378,166529,,295,0,"Scoala generala BADEANA","TUTOVA",66,166529,0,3,797,560,517,43,552,8,877,317,375,177,
39,"VASLUI",378,166636,,296,0,"Scoala generala","VALENI",67,166636,0,3,2243,1381,1210,171,1359,22,2475,1094,924,435,
39,"VASLUI",378,166636,,297,0,"Scoala generala FERESTI","VALENI",67,166636,0,3,1851,1007,894,113,997,10,2038,1031,832,165,
39,"VASLUI",378,166636,,298,0,"Scoala generala MOARA DOMNEASCA","VALENI",67,166636,0,3,1019,604,498,106,595,9,1117,513,444,151,
39,"VASLUI",378,166672,,299,0,"Caminul Cultural","VETRISOAIA",68,166672,0,3,1789,1184,1073,111,1157,27,2023,839,953,204,
39,"VASLUI",378,166672,,300,0,"Scoala generala nr.2","VETRISOAIA",68,166672,0,3,1050,684,579,105,668,16,1117,433,524,144,
39,"VASLUI",378,166672,,301,0,"Scoala generala BUMBATA","VETRISOAIA",68,166672,0,3,193,178,127,51,173,5,212,34,120,53,
39,"VASLUI",378,166707,,302,0,"Scoala generala","VIISOARA",69,166707,0,3,1020,655,518,137,645,10,1122,467,525,120,
39,"VASLUI",378,166707,,303,0,"Scoala generala DODESTI","VIISOARA",69,166707,0,3,1572,1096,966,130,1081,15,1727,631,895,186,
39,"VASLUI",378,166707,,304,0,"Scoala generala VALENI","VIISOARA",69,166707,0,3,506,369,270,99,360,9,560,191,297,63,
39,"VASLUI",378,166770,,305,0,"Scoala generala","VINDEREI",70,166770,0,3,1353,691,624,67,678,13,1503,812,466,212,
39,"VASLUI",378,166770,,306,0,"Scoala generala BRADESTI","VINDEREI",70,166770,0,3,562,324,255,69,314,10,623,299,264,50,
39,"VASLUI",378,166770,,307,0,"Scoala generala DOCANI","VINDEREI",70,166770,0,3,560,417,359,58,414,3,617,200,345,69,
39,"VASLUI",378,166770,,308,0,"Scoala generala DOCANEASA","VINDEREI",70,166770,0,3,390,254,220,34,249,5,429,175,139,110,
39,"VASLUI",378,166770,,309,0,"Scoala generala OBARSENI","VINDEREI",70,166770,0,3,926,755,694,61,739,16,1025,270,559,180,
39,"VASLUI",378,166869,,310,0,"Scoala generala","VOINESTI",71,166869,0,3,358,277,200,77,270,7,393,116,234,36,
39,"VASLUI",378,166869,,311,0,"Scoala generala OBIRSENI","VOINESTI",71,166869,0,3,847,632,537,95,625,7,933,301,573,52,
39,"VASLUI",378,166869,,312,0,"Scoala generala BANCESTI","VOINESTI",71,166869,0,3,487,350,295,55,343,7,536,186,321,22,
39,"VASLUI",378,166869,,313,0,"Scoala generala STINCASENI","VOINESTI",71,166869,0,3,146,142,85,57,142,0,160,18,98,44,
39,"VASLUI",378,166869,,314,0,"Scoala generala MARASESTI","VOINESTI",71,166869,0,3,211,171,125,46,165,6,231,60,138,27,
39,"VASLUI",378,166869,,315,0,"Scoala generala  AVRAMESTI","VOINESTI",71,166869,0,3,617,429,337,92,414,15,679,250,353,61,
39,"VASLUI",378,166985,,316,0,"Caminul Cultural","VULTURESTI",72,166985,0,3,987,712,592,120,705,7,1082,370,494,211,
39,"VASLUI",378,166985,,317,0,"Caminul Cultural BUHAIESTI","VULTURESTI",72,166985,0,3,793,546,444,102,523,23,793,247,414,109,
39,"VASLUI",378,167035,,318,0,"Scoala generala","VUTCANI",73,167035,0,3,995,667,552,115,647,20,1097,430,491,156,
39,"VASLUI",378,167035,,319,0,"Scoala generala","VUTCANI",73,167035,0,3,937,572,464,108,557,15,1033,461,450,107,
39,"VASLUI",378,167071,,320,0,"Caminul Cultural","ZAPODENI",74,167071,0,3,1507,946,815,131,928,18,1663,717,785,143,
39,"VASLUI",378,167071,,321,0,"Scoala generala PORTARI","ZAPODENI",74,167071,0,3,822,424,338,86,414,10,814,390,337,77,
39,"VASLUI",378,167071,,322,0,"Scoala generala BUTUCARIE","ZAPODENI",74,167071,0,3,761,434,358,76,412,22,835,401,345,67,
39,"VASLUI",378,167071,,323,0,"Scoala generala UNCESTI","ZAPODENI",74,167071,0,3,327,280,204,76,275,5,360,80,212,63,
39,"VASLUI",378,167179,,324,0,"Scoala generala","ZORLENI",75,167179,0,3,3283,1786,1618,168,1763,23,3601,1815,1254,509,
39,"VASLUI",378,167179,,325,0,"Scoala generala","ZORLENI",75,167179,0,3,1167,840,637,203,832,8,1285,445,656,176,
39,"VASLUI",378,167179,,326,0,"Scoala generala POPENI","ZORLENI",75,167179,0,3,2069,1336,1229,107,1300,36,2270,934,1016,284,
39,"VASLUI",378,167179,,327,0,"Scoala generala DEALU MARE","ZORLENI",75,167179,0,3,192,140,115,25,134,6,211,71,97,37,
40,"VALCEA",387,167473,,1,0,"LICEUL ENERGETIC","MUNICIPIUL RAMNICU VALCEA",1,167473,1,1,1270,776,663,113,762,14,1400,624,460,302,
40,"VALCEA",387,167473,,2,0,"LICEUL SANITAR","MUNICIPIUL RAMNICU VALCEA",1,167473,1,1,1053,590,507,83,585,5,1200,610,356,229,
40,"VALCEA",387,167473,,3,0,"LICEUL SANITAR","MUNICIPIUL RAMNICU VALCEA",1,167473,1,1,974,499,452,47,492,7,1203,704,322,170,
40,"VALCEA",387,167473,,4,0,"LICEUL SANITAR","MUNICIPIUL RAMNICU VALCEA",1,167473,1,1,1030,518,396,122,507,11,1200,682,281,226,
40,"VALCEA",387,167473,,5,0,"GRADINITA NORD II","MUNICIPIUL RAMNICU VALCEA",1,167473,1,1,1343,681,626,55,677,4,1507,826,412,265,
40,"VALCEA",387,167473,,6,0,"GRADINITA NORD II","MUNICIPIUL RAMNICU VALCEA",1,167473,1,1,1254,680,597,83,680,0,1200,520,453,227,
40,"VALCEA",387,167473,,7,0,"LICEUL HENRY COANDA","MUNICIPIUL RAMNICU VALCEA",1,167473,1,1,1383,698,610,88,691,7,1600,902,471,220,
40,"VALCEA",387,167473,,8,0,"LICEUL HENRY COANDA","MUNICIPIUL RAMNICU VALCEA",1,167473,1,1,1336,646,554,92,635,11,1700,1054,389,246,
40,"VALCEA",387,167473,,9,0,"LICEUL HENRY COANDA","MUNICIPIUL RAMNICU VALCEA",1,167473,1,1,1322,731,649,82,720,11,1500,769,476,244,
40,"VALCEA",387,167473,,10,0,"LICEUL HENRY COANDA","MUNICIPIUL RAMNICU VALCEA",1,167473,1,1,1380,699,615,84,687,12,1500,801,420,267,
40,"VALCEA",387,167473,,11,0,"SCOALA NORMALA","MUNICIPIUL RAMNICU VALCEA",1,167473,1,1,1380,711,645,66,697,14,1499,788,460,237,
40,"VALCEA",387,167473,,12,0,"SCOALA NORMALA","MUNICIPIUL RAMNICU VALCEA",1,167473,1,1,1195,556,529,27,551,5,1300,744,317,234,
40,"VALCEA",387,167473,,13,0,"SCOALA NORMALA","MUNICIPIUL RAMNICU VALCEA",1,167473,1,1,1155,552,503,49,547,5,1300,748,361,186,
40,"VALCEA",387,167473,,14,0,"SCOALA NORMALA","MUNICIPIUL RAMNICU VALCEA",1,167473,1,1,1083,548,513,35,544,4,1200,652,349,195,
40,"VALCEA",387,167473,,15,0,"LICEUL SILVIC","MUNICIPIUL RAMNICU VALCEA",1,167473,1,1,1237,604,568,36,597,7,1400,796,413,184,
40,"VALCEA",387,167473,,16,0,"LICEUL SILVIC","MUNICIPIUL RAMNICU VALCEA",1,167473,1,1,1429,720,630,90,709,11,1600,880,462,247,
40,"VALCEA",387,167473,,17,0,"LICEUL SILVIC","MUNICIPIUL RAMNICU VALCEA",1,167473,1,1,1290,765,697,68,750,15,1395,630,533,217,
40,"VALCEA",387,167473,,18,0,"SCOALA GENERALA NR. 2","MUNICIPIUL RAMNICU VALCEA",1,167473,1,1,1631,823,770,53,808,15,1400,577,505,303,
40,"VALCEA",387,167473,,19,0,"SCOALA GENERALA NR. 2","MUNICIPIUL RAMNICU VALCEA",1,167473,1,1,989,521,472,49,519,2,1500,979,331,188,
40,"VALCEA",387,167473,,20,0,"SCOALA GENERALA NR. 2","MUNICIPIUL RAMNICU VALCEA",1,167473,1,1,1253,698,579,119,690,8,1400,702,417,273,
40,"VALCEA",387,167473,,21,0,"SCOALA GENERALA NR. 2","MUNICIPIUL RAMNICU VALCEA",1,167473,1,1,1338,811,668,143,805,6,1500,689,533,272,
40,"VALCEA",387,167473,,22,0,"SCOALA GENERALA NR. 2","MUNICIPIUL RAMNICU VALCEA",1,167473,1,1,1305,709,640,69,700,9,1400,691,444,256,
40,"VALCEA",387,167473,,23,0,"COLEGIUL NATIONAL ALEXANDRU LAHOVARY","MUNICIPIUL RAMNICU VALCEA",1,167473,1,1,1249,724,660,64,706,18,1400,676,510,196,
40,"VALCEA",387,167473,,24,0,"COLEGIUL NATIONAL ALEXANDRU LAHOVARY","MUNICIPIUL RAMNICU VALCEA",1,167473,1,1,1170,661,598,63,655,6,1293,632,491,164,
40,"VALCEA",387,167473,,25,0,"COLEGIUL NATIONAL ALEXANDRU LAHOVARY","MUNICIPIUL RAMNICU VALCEA",1,167473,1,1,1344,722,674,48,708,14,1400,678,497,211,
40,"VALCEA",387,167473,,26,0,"GRUPUL SCOLAR OLTCHIM","MUNICIPIUL RAMNICU VALCEA",1,167473,1,1,1039,787,517,270,773,14,1104,317,455,318,
40,"VALCEA",387,167473,,27,0,"GRUPUL SCOLAR OLTCHIM","MUNICIPIUL RAMNICU VALCEA",1,167473,1,1,1032,560,489,71,552,8,1100,540,323,229,
40,"VALCEA",387,167473,,28,0,"SCOALA GENERALA TACHE IONESCU","MUNICIPIUL RAMNICU VALCEA",1,167473,1,1,1061,673,573,100,656,17,1400,727,487,169,
40,"VALCEA",387,167473,,29,0,"SCOALA GENERALA NR. 5","MUNICIPIUL RAMNICU VALCEA",1,167473,1,1,1182,730,635,95,720,10,1407,677,540,180,
40,"VALCEA",387,167473,,30,0,"DADP BLOC A17","MUNICIPIUL RAMNICU VALCEA",1,167473,1,1,1087,624,558,66,611,13,1200,576,396,215,
40,"VALCEA",387,167473,,31,0,"CAMERA DE COMERT","MUNICIPIUL RAMNICU VALCEA",1,167473,1,1,1264,711,646,65,703,8,1500,789,486,217,
40,"VALCEA",387,167473,,32,0,"CAMERA DE COMERT","MUNICIPIUL RAMNICU VALCEA",1,167473,1,1,1291,716,650,66,706,10,1402,686,446,260,
40,"VALCEA",387,167473,,33,0,"GRADINITA NR. 1 COZIA","MUNICIPIUL RAMNICU VALCEA",1,167473,1,1,1411,795,719,76,792,3,1600,805,577,215,
40,"VALCEA",387,167473,,34,0,"GRADINITA NR. 1 COZIA","MUNICIPIUL RAMNICU VALCEA",1,167473,1,1,1399,757,713,44,751,6,1600,843,517,234,
40,"VALCEA",387,167473,,35,0,"CAR PENSIONARI","MUNICIPIUL RAMNICU VALCEA",1,167473,1,1,1365,742,682,60,732,10,1595,853,550,182,
40,"VALCEA",387,167473,,36,0,"SEDIUL CONEL","MUNICIPIUL RAMNICU VALCEA",1,167473,1,1,1122,668,588,80,657,11,1303,635,497,160,
40,"VALCEA",387,167473,,37,0,"SCOALA GENERALA NR. 3","MUNICIPIUL RAMNICU VALCEA",1,167473,1,1,1128,584,545,39,575,9,1302,718,384,191,
40,"VALCEA",387,167473,,38,0,"ATELIERELE GRUPULUI SCOLAR ''NICOLAE PLESOIANU'' -STR. MORILOR","MUNICIPIUL RAMNICU VALCEA",1,167473,1,1,1103,605,562,43,577,28,1200,595,314,263,
40,"VALCEA",387,167473,,39,0,"SCOALA GENERALA NR. 4","MUNICIPIUL RAMNICU VALCEA",1,167473,1,1,1239,586,534,52,580,6,1400,814,306,274,
40,"VALCEA",387,167473,,40,0,"SCOALA GENERALA NR. 4","MUNICIPIUL RAMNICU VALCEA",1,167473,1,1,1384,740,700,40,732,8,1510,770,531,201,
40,"VALCEA",387,167473,,41,0,"SCOALA GENERALA NR. 4","MUNICIPIUL RAMNICU VALCEA",1,167473,1,1,1394,786,730,56,774,12,1500,714,503,271,
40,"VALCEA",387,167473,,42,0,"SCOALA GENERALA NR. 4","MUNICIPIUL RAMNICU VALCEA",1,167473,1,1,1303,709,674,35,695,14,1500,791,510,185,
40,"VALCEA",387,167473,,43,0,"LICEUL ECONOMIC","MUNICIPIUL RAMNICU VALCEA",1,167473,1,1,1003,574,528,46,571,3,1103,529,373,198,
40,"VALCEA",387,167473,,44,0,"LICEUL ECONOMIC","MUNICIPIUL RAMNICU VALCEA",1,167473,1,1,1231,713,663,50,709,4,1400,687,482,227,
40,"VALCEA",387,167473,,45,0,"LICEUL ECONOMIC","MUNICIPIUL RAMNICU VALCEA",1,167473,1,1,1250,657,600,57,647,10,1415,758,365,282,
40,"VALCEA",387,167473,,46,0,"SCOALA GENERALA NR. 10","MUNICIPIUL RAMNICU VALCEA",1,167473,1,1,906,484,459,25,479,5,1000,516,296,183,
40,"VALCEA",387,167473,,47,0,"SCOALA GENERALA NR. 10","MUNICIPIUL RAMNICU VALCEA",1,167473,1,1,987,539,496,43,528,11,1100,561,319,209,
40,"VALCEA",387,167473,,48,0,"SCOALA GENERALA NR. 10","MUNICIPIUL RAMNICU VALCEA",1,167473,1,1,1104,661,616,45,658,3,1200,539,394,264,
40,"VALCEA",387,167473,,49,0,"SCOALA GENERALA NR. 10","MUNICIPIUL RAMNICU VALCEA",1,167473,1,1,1087,513,472,41,511,2,1200,687,263,248,
40,"VALCEA",387,167473,,50,0,"GRADINITA OSTROVENI 1","MUNICIPIUL RAMNICU VALCEA",1,167473,1,1,1301,660,615,45,651,9,1400,740,373,278,
40,"VALCEA",387,167473,,51,0,"LICEUL DE CONSTRUCTII","MUNICIPIUL RAMNICU VALCEA",1,167473,1,1,1372,711,659,52,703,8,1500,789,423,280,
40,"VALCEA",387,167473,,52,0,"LICEUL DE CONSTRUCTII","MUNICIPIUL RAMNICU VALCEA",1,167473,1,1,1307,656,616,40,647,9,1400,744,403,244,
40,"VALCEA",387,167473,,53,0,"LICEUL DE CONSTRUCTII","MUNICIPIUL RAMNICU VALCEA",1,167473,1,1,1297,643,599,44,634,9,1501,858,400,234,
40,"VALCEA",387,167473,,54,0,"LICEUL DE CONSTRUCTII","MUNICIPIUL RAMNICU VALCEA",1,167473,1,1,1326,677,613,64,667,10,1500,823,389,278,
40,"VALCEA",387,167473,,55,0,"LICEUL DE CONSTRUCTII","MUNICIPIUL RAMNICU VALCEA",1,167473,1,1,1205,629,575,54,625,4,1300,671,368,257,
40,"VALCEA",387,167473,,56,0,"GRADINITA OSTROVENI 2","MUNICIPIUL RAMNICU VALCEA",1,167473,1,1,1513,757,729,28,754,3,1701,944,402,352,
40,"VALCEA",387,167473,,57,0,"GRADINITA OSTROVENI 2","MUNICIPIUL RAMNICU VALCEA",1,167473,1,1,1439,666,643,23,663,3,1600,934,369,294,
40,"VALCEA",387,167473,,58,0,"GRADINITA OSTROVENI 2","MUNICIPIUL RAMNICU VALCEA",1,167473,1,1,1278,625,570,55,614,11,1400,775,363,251,
40,"VALCEA",387,167473,,59,0,"SCOALA GENERALA NR. 9","MUNICIPIUL RAMNICU VALCEA",1,167473,1,1,1373,671,618,53,659,12,1499,828,418,241,
40,"VALCEA",387,167473,,60,0,"SCOALA GENERALA NR. 9","MUNICIPIUL RAMNICU VALCEA",1,167473,1,1,1377,691,641,50,681,10,1500,809,376,305,
40,"VALCEA",387,167473,,61,0,"SCOALA GENERALA NR. 9","MUNICIPIUL RAMNICU VALCEA",1,167473,1,1,1298,711,653,58,706,5,1400,689,420,286,
40,"VALCEA",387,167473,,62,0,"SCOALA GENERALA NR. 9","MUNICIPIUL RAMNICU VALCEA",1,167473,1,1,1326,660,609,51,654,6,1500,840,392,262,
40,"VALCEA",387,167473,,63,0,"SCOALA GENERALA NR. 9","MUNICIPIUL RAMNICU VALCEA",1,167473,1,1,1399,685,652,33,683,2,1507,822,395,288,
40,"VALCEA",387,167473,,64,0,"SCOALA GENERALA NR. 9","MUNICIPIUL RAMNICU VALCEA",1,167473,1,1,1126,598,560,38,593,5,1200,602,286,307,
40,"VALCEA",387,167473,,65,0,"SCOALA GENERALA NR. 9","MUNICIPIUL RAMNICU VALCEA",1,167473,1,1,1217,561,528,33,557,4,1403,842,306,251,
40,"VALCEA",387,167473,,66,0,"SCOALA GENERALA NR.13","MUNICIPIUL RAMNICU VALCEA",1,167473,1,1,1289,690,629,61,686,2,1400,710,405,281,
40,"VALCEA",387,167473,,67,0,"SCOALA GENERALA NR.13","MUNICIPIUL RAMNICU VALCEA",1,167473,1,1,1220,676,617,59,669,7,1300,624,358,311,
40,"VALCEA",387,167473,,68,0,"SCOALA GENERALA NR.13","MUNICIPIUL RAMNICU VALCEA",1,167473,1,1,1418,731,683,48,723,8,1500,769,427,296,
40,"VALCEA",387,167473,,69,0,"SCOALA GENERALA NR.13","MUNICIPIUL RAMNICU VALCEA",1,167473,1,1,1249,641,593,48,635,6,1300,659,366,269,
40,"VALCEA",387,167473,,70,0,"SCOALA GENERALA NR.13","MUNICIPIUL RAMNICU VALCEA",1,167473,1,1,1273,636,604,32,628,8,1403,767,350,278,
40,"VALCEA",387,167473,,71,0,"SCOALA CU CLASELE I-IV RIURENI","MUNICIPIUL RAMNICU VALCEA",1,167473,1,1,990,483,388,95,479,4,1000,517,312,167,
40,"VALCEA",387,167473,,72,0,"SCOALA CU CLASELE I-IV STOLNICENI","MUNICIPIUL RAMNICU VALCEA",1,167473,1,1,384,387,212,175,385,2,601,214,235,150,
40,"VALCEA",387,167473,,73,0,"SCOALA CU CLASELE I-VIII COPACELU","MUNICIPIUL RAMNICU VALCEA",1,167473,1,1,1106,811,557,254,797,14,1295,484,506,291,
40,"VALCEA",387,167473,,74,0,"SCOALA CU CLASELE I-IV CAZANESTI","MUNICIPIUL RAMNICU VALCEA",1,167473,1,1,658,443,354,89,439,4,700,257,267,172,
40,"VALCEA",387,167473,,75,0,"SCOALA GENERALA GORANU","MUNICIPIUL RAMNICU VALCEA",1,167473,1,1,1068,528,490,38,518,10,1100,572,358,160,
40,"VALCEA",387,167473,,76,0,"SCOALA GENERALA GORANU","MUNICIPIUL RAMNICU VALCEA",1,167473,1,1,1138,773,574,199,765,8,1299,526,518,247,
40,"VALCEA",387,167473,,77,0,"SCOALA GENERALA FETENI","MUNICIPIUL RAMNICU VALCEA",1,167473,1,1,496,142,97,45,142,0,299,157,94,48,
40,"VALCEA",387,167473,,78,1,"INSTITUTUL MILITAR ''PANAIT DONICI''","MUNICIPIUL RAMNICU VALCEA",1,167473,1,1,0,115,0,115,114,1,300,185,62,52,
40,"VALCEA",387,167473,,79,1,"UNITATILE MILITARE VLADESTI","MUNICIPIUL RAMNICU VALCEA",1,167473,1,1,0,315,0,315,313,2,597,282,168,145,
40,"VALCEA",387,167473,,80,1,"UNITATEA MILITARA DE JANDARMI","MUNICIPIUL RAMNICU VALCEA",1,167473,1,1,0,291,0,291,290,1,350,59,188,102,
40,"VALCEA",387,167473,,81,1,"SPITALUL JUDETEAN NR.1","MUNICIPIUL RAMNICU VALCEA",1,167473,1,1,0,651,0,651,644,7,700,49,432,212,
40,"VALCEA",387,167473,,82,0,"SCOALA GENERALA COLONIA NUCI","MUNICIPIUL RAMNICU VALCEA",1,167473,1,1,639,468,329,139,458,10,700,232,257,201,
40,"VALCEA",387,167981,,83,0,"SCOALA TUDOR VLADIMIRESCU,STR. REGELE CAROL, NR.18","MUNICIPIUL DRAGASANI",2,167981,1,1,1531,725,689,36,711,14,1700,975,491,220,
40,"VALCEA",387,167981,,84,0,"GRUPUL SCOLAR AGRICOL ''I.C.BRATIANU'',STR.M.KOGALNICEANU,NR.5","MUNICIPIUL DRAGASANI",2,167981,1,1,1438,625,563,62,622,3,1600,975,385,237,
40,"VALCEA",387,167981,,85,0,"CAMINUL DE COPII,ALEEA MUNCII","MUNICIPIUL DRAGASANI",2,167981,1,1,2193,1130,1039,91,1119,11,2400,1270,706,413,
40,"VALCEA",387,167981,,86,0,"SCOALA N.BALCESCU,STR.PROF.NICOLITA SANDA,NR.9","MUNICIPIUL DRAGASANI",2,167981,1,1,1231,589,547,42,586,3,1300,711,395,191,
40,"VALCEA",387,167981,,87,0,"GRUPUL SCOLAR AGRICOL I.C.BRATIANU,STR.M.KOGALNICEANU,NR.5","MUNICIPIUL DRAGASANI",2,167981,1,1,1407,671,631,40,667,4,1600,929,428,239,
40,"VALCEA",387,167981,,88,0,"COLEGIUL NATIONAL GIB MIHAESCU,STR.ALEEA SCOLII NR.1","MUNICIPIUL DRAGASANI",2,167981,1,1,1431,663,626,37,660,3,1600,937,418,242,
40,"VALCEA",387,167981,,89,0,"SC AGROMEC SA SCOALA PROFESIONALA","MUNICIPIUL DRAGASANI",2,167981,1,1,1031,593,544,49,586,7,1100,507,420,166,
40,"VALCEA",387,167981,,90,0,"SCOALA GEN. BARSANU,STR.T.VLADIMIRESCU,NR.110","MUNICIPIUL DRAGASANI",2,167981,1,1,1427,832,789,43,820,12,1600,768,604,216,
40,"VALCEA",387,167981,,91,0,"SCOALA GENERALA N. BALCESCU,STR.PROF.NICOLITA SANDA","MUNICIPIUL DRAGASANI",2,167981,1,1,1427,711,668,43,700,11,1600,889,459,241,
40,"VALCEA",387,167981,,92,0,"SCOALA GENERALA T. VLADIMIRESCU,STR.REGELE CAROL NR.18","MUNICIPIUL DRAGASANI",2,167981,1,1,1578,812,730,82,807,5,1700,888,557,250,
40,"VALCEA",387,167981,,93,0,"SCOALA GENERALA MOMOTESTI,STR.T VLADIMIRESCU,NR.666","MUNICIPIUL DRAGASANI",2,167981,1,1,948,592,562,30,571,21,1090,498,425,146,
40,"VALCEA",387,167981,,94,0,"SCOALA GENERALA CAPU DEALULUI","MUNICIPIUL DRAGASANI",2,167981,1,1,821,436,397,39,426,10,1007,571,288,138,
40,"VALCEA",387,167981,,95,0,"SCOALA GENERALA ZLATAREI,STR.SCOLII","MUNICIPIUL DRAGASANI",2,167981,1,1,1217,756,733,23,742,14,1400,644,532,210,
40,"VALCEA",387,167981,,96,1,"SPITALUL MUNICIPAL,STR.DR.BAGDAZAR,NR.6","MUNICIPIUL DRAGASANI",2,167981,1,1,0,175,0,175,173,2,300,125,126,47,
40,"VALCEA",387,167981,,97,1,"CENTRUL DE INSTRUCTIE JANDARMI,B-DUL I.C.BRATIANU,NR.29","MUNICIPIUL DRAGASANI",2,167981,1,1,0,444,0,444,436,8,600,156,311,125,
40,"VALCEA",387,167641,,98,0,"INCINTA PRIMARIEI","ORAS BAILE GOVORA",3,167641,2,1,2235,1746,1361,385,1723,23,2500,754,1118,605,
40,"VALCEA",387,167641,,99,0,"SCOALA CU CLASELE I-IV GATEJESTI","ORAS BAILE GOVORA",3,167641,2,1,305,259,223,36,257,2,401,142,145,112,
40,"VALCEA",387,167696,,100,0,"LICEUL BAILE OLANESTI","ORAS BAILE OLANESTI",4,167696,2,1,1667,1138,1041,97,1028,110,1801,663,664,364,
40,"VALCEA",387,167696,,101,0,"SCOALA CU CLASELE I-VIII OLANESTI","ORAS BAILE OLANESTI",4,167696,2,1,1239,766,716,50,750,16,1400,634,460,290,
40,"VALCEA",387,167696,,102,0,"SCOALA CU CLASELE I-VIII CHEIA","ORAS BAILE OLANESTI",4,167696,2,1,817,582,506,76,569,13,900,318,359,210,
40,"VALCEA",387,167696,,103,1,"PENSIUNEA NR.2 SC OLANESTI SA,STR.TRANDAFIRILOR ,NR.15","ORAS BAILE OLANESTI",4,167696,2,1,0,667,0,667,655,12,1600,933,441,214,
40,"VALCEA",387,167794,,104,0,"SCOALA GENERALA PASCOAIA","ORAS BREZOI",5,167794,2,1,403,234,204,30,226,8,504,270,171,55,
40,"VALCEA",387,167794,,105,0,"SCOALA GENERALA NR.2 BREZOI","ORAS BREZOI",5,167794,2,1,1057,612,568,44,600,12,1200,588,330,270,
40,"VALCEA",387,167794,,106,0,"BLOCUL DIN STR.UNIRII,BL.M6,SC.C,PARTER","ORAS BREZOI",5,167794,2,1,2144,1190,1080,110,1174,16,2300,1110,587,587,
40,"VALCEA",387,167794,,107,0,"SCOALA GEN.NR.1 BREZOI","ORAS BREZOI",5,167794,2,1,1284,761,635,126,747,14,1400,639,424,323,
40,"VALCEA",387,167794,,108,0,"CAMINUL CULTURAL CALINESTI","ORAS BREZOI",5,167794,2,1,637,389,342,47,386,3,700,311,203,183,
40,"VALCEA",387,167909,,109,0,"SCOALA CU CLASELE I-IV SEACA","ORAS CALIMANESTI",6,167909,2,1,448,277,261,16,274,3,504,227,193,81,
40,"VALCEA",387,167909,,110,0,"SCOALA CU CLASELE I-VIII CALIMANESTI","ORAS CALIMANESTI",6,167909,2,1,1624,998,919,79,984,14,1800,802,644,340,
40,"VALCEA",387,167909,,111,0,"SCOALA CU CLASELE I-IV CALIMANESTI","ORAS CALIMANESTI",6,167909,2,1,974,638,603,35,633,5,1104,466,386,247,
40,"VALCEA",387,167909,,112,0,"PAVILIONUL CENTRAL CALIMANESTI","ORAS CALIMANESTI",6,167909,2,1,1019,672,504,168,662,10,1204,532,434,228,
40,"VALCEA",387,167909,,113,0,"HOTEL CACIULATA","ORAS CALIMANESTI",6,167909,2,1,350,630,154,476,613,17,1000,370,361,252,
40,"VALCEA",387,167909,,114,0,"SCOALA JIBLEA VECHE","ORAS CALIMANESTI",6,167909,2,1,1662,901,846,55,882,19,1800,899,572,310,
40,"VALCEA",387,167909,,115,0,"SCOALA JIBLEA NOUA","ORAS CALIMANESTI",6,167909,2,1,738,443,414,29,442,1,1006,563,237,205,
40,"VALCEA",387,168041,,116,0,"LICEUL C. BRANCOVEANU","ORAS HOREZU",7,168041,2,1,1539,888,789,99,878,10,1600,712,633,245,
40,"VALCEA",387,168041,,117,0,"CASA DE CULTURA HOREZU","ORAS HOREZU",7,168041,2,1,1912,1021,879,142,1006,15,2300,1279,697,309,
40,"VALCEA",387,168041,,118,0,"CAMINUL CULTURAL ROMANII DE JOS","ORAS HOREZU",7,168041,2,1,644,440,366,74,437,3,703,263,326,111,
40,"VALCEA",387,168041,,119,0,"MAGAZINUL SATESC ROMANII DE SUS","ORAS HOREZU",7,168041,2,1,739,500,449,51,491,9,800,300,264,227,
40,"VALCEA",387,168041,,120,0,"CAMINUL RAMESTI","ORAS HOREZU",7,168041,2,1,390,217,196,21,215,2,500,283,159,56,
40,"VALCEA",387,168041,,121,0,"CAMINUL CULTURAL URSANI","ORAS HOREZU",7,168041,2,1,543,269,238,31,269,0,600,331,176,93,
40,"VALCEA",387,168130,,122,0,"SCOALA CU CLASELE I-VIII OCNELE MARI","ORAS OCNELE MARI",8,168130,2,1,1219,809,694,115,801,8,1400,591,485,316,
40,"VALCEA",387,168130,,123,0,"SCOALA CU CLASELE I-VIII OCNITA","ORAS OCNELE MARI",8,168130,2,1,1540,899,824,75,885,14,1802,903,562,323,
40,"VALCEA",387,168229,,124,0,"SCOALA CU CLASELE I-VIII ALUNU","ALUNU",9,168229,0,3,1685,830,739,91,823,7,1900,1070,477,346,
40,"VALCEA",387,168229,,125,0,"SCOALA CU CLASELE I-VIII COLTESTI","ALUNU",9,168229,0,3,1684,967,871,96,950,17,1900,933,545,405,
40,"VALCEA",387,168309,,126,0,"SCOALA CU CLASELE I-VIII AMARASTI","AMARASTI",10,168309,0,3,1155,623,526,97,616,7,1300,677,431,185,
40,"VALCEA",387,168309,,127,0,"SCOALA CU CLASELE I-VIII NEMOIU","AMARASTI",10,168309,0,3,674,442,354,88,430,12,800,358,260,170,
40,"VALCEA",387,168372,,128,0,"CASA DE CULTURA BABENI","BABENI",11,168372,0,3,2706,1365,1107,258,1356,9,3000,1635,694,662,
40,"VALCEA",387,168372,,129,0,"SC COZIA FOREST","BABENI",11,168372,0,3,736,485,279,206,482,3,900,415,273,209,
40,"VALCEA",387,168372,,130,0,"SCOALA GENERALA VALEA MARE","BABENI",11,168372,0,3,1562,887,617,270,876,11,1800,913,574,302,
40,"VALCEA",387,168372,,131,0,"SCOALA GENERALA TATARANI","BABENI",11,168372,0,3,400,330,249,81,326,4,500,170,170,156,
40,"VALCEA",387,168372,,132,0,"SCOALA GENERALA ROMANI","BABENI",11,168372,0,3,1364,741,647,94,731,10,1500,759,444,287,
40,"VALCEA",387,168452,,133,0,"CASA DE CULTURA BALCESTI","BALCESTI",12,168452,0,3,2276,1130,975,155,1120,10,2700,1570,810,310,
40,"VALCEA",387,168452,,134,0,"SCOALA CU CLASELE I-VIII GORUNESTI","BALCESTI",12,168452,0,3,722,383,277,106,374,9,800,417,263,111,
40,"VALCEA",387,168452,,135,0,"SCOALA CU CLASELE I-VIII IRIMESTI","BALCESTI",12,168452,0,3,611,330,238,92,321,9,700,370,231,90,
40,"VALCEA",387,168452,,136,0,"SCOALA CU CLASELE I-VIII OTETELISU","BALCESTI",12,168452,0,3,765,546,431,115,535,11,900,354,391,144,
40,"VALCEA",387,168452,,137,0,"GRADINITA PREOTESTI","BALCESTI",12,168452,0,3,86,171,49,122,168,3,200,29,133,35,
40,"VALCEA",387,168452,,138,0,"SCOALA CU CLASELE I-VIII BENESTI","BALCESTI",12,168452,0,3,316,240,152,88,232,8,400,160,157,75,
40,"VALCEA",387,168559,,139,0,"CAMINUL CULTURAL BARBATESTI","BARBATESTI",13,168559,0,3,1416,879,769,110,873,6,1600,721,558,315,
40,"VALCEA",387,168559,,140,0,"SCOALA GENERALA BARZESTI","BARBATESTI",13,168559,0,3,1672,1070,912,158,1052,18,1808,738,622,430,
40,"VALCEA",387,168602,,141,0,"GRADINITA NR.1 BLOCURI","BERBESTI",14,168602,0,3,1664,818,628,190,809,9,1800,982,447,362,
40,"VALCEA",387,168602,,142,0,"SCOALA CU CLASELE I-VIII BERBESTI","BERBESTI",14,168602,0,3,1650,787,707,80,777,10,1794,1007,553,224,
40,"VALCEA",387,168602,,143,0,"SCOALA CU CLASELE I-VIII TARGU GANGULESTI","BERBESTI",14,168602,0,3,1308,663,573,90,661,2,1000,337,449,212,
40,"VALCEA",387,168675,,144,0,"CAMINUL CULTURAL STOENESTI","BERISLAVESTI",15,168675,0,3,1171,614,553,61,607,7,1300,686,314,293,
40,"VALCEA",387,168675,,145,0,"CAMINUL CULTURAL DANGESTI","BERISLAVESTI",15,168675,0,3,380,251,213,38,250,1,500,249,129,121,
40,"VALCEA",387,168675,,146,0,"CAMINUL CULTURAL RADACINESTI","BERISLAVESTI",15,168675,0,3,673,324,279,45,323,1,800,476,130,193,
40,"VALCEA",387,168675,,147,0,"CAMINUL CULTURAL ROBAIA","BERISLAVESTI",15,168675,0,3,282,166,143,23,165,1,400,234,82,83,
40,"VALCEA",387,168755,,148,0,"SCOALA CU CLASELE I-VIII BOISOARA","BOISOARA",16,168755,0,3,1566,682,635,47,674,8,1700,1018,187,487,
40,"VALCEA",387,168791,,149,0,"PRIMARIA BUDESTI","BUDESTI",17,168791,0,3,2720,1296,1145,151,1273,23,3100,1804,783,490,
40,"VALCEA",387,168791,,150,0,"SCOALA DIN SATUL RUDA","BUDESTI",17,168791,0,3,1255,746,614,132,735,11,1600,854,442,293,
40,"VALCEA",387,168880,,151,0,"SCOALA OLTENI","BUJORENI",18,168880,0,3,1153,589,467,122,584,5,1300,711,362,222,
40,"VALCEA",387,168880,,152,0,"SCOALA GURA VAII","BUJORENI",18,168880,0,3,1480,830,663,167,817,13,1600,770,506,311,
40,"VALCEA",387,168960,,153,0,"SCOALA BUNESTI","BUNESTI",19,168960,0,3,1698,1140,988,152,1130,10,1900,760,694,436,
40,"VALCEA",387,168960,,154,0,"SCOALA TEIUSU","BUNESTI",19,168960,0,3,466,205,164,41,204,1,500,295,142,62,
40,"VALCEA",387,169039,,155,0,"SCOALA GENERALA GROSI","CERNISOARA",21,169039,0,3,1347,799,678,121,793,6,1500,701,414,379,
40,"VALCEA",387,169039,,156,0,"SCOALA GENERALA CERNISOARA","CERNISOARA",21,169039,0,3,846,544,487,57,534,10,900,356,263,271,
40,"VALCEA",387,169039,,157,0,"SCOALA GENERALA MADULARI","CERNISOARA",21,169039,0,3,1083,657,569,88,648,9,1200,543,452,196,
40,"VALCEA",387,169119,,158,0,"SCOALA CAINENII MICI","CAINENI",20,169119,0,3,1078,573,468,105,558,15,1200,627,210,348,
40,"VALCEA",387,169119,,159,0,"GRADINITA GREBLESTI","CAINENI",20,169119,0,3,738,466,376,90,457,9,800,334,181,276,
40,"VALCEA",387,169119,,160,0,"SCOALA ROBESTI","CAINENI",20,169119,0,3,192,144,105,39,139,5,300,156,95,44,
40,"VALCEA",387,169182,,161,0,"SCOALA GENERALA ULMETU","COPACENI",22,169182,0,3,1491,841,742,99,826,15,1700,859,491,335,
40,"VALCEA",387,169182,,162,0,"SCOALA GENERALA VETELU","COPACENI",22,169182,0,3,739,499,410,89,493,6,800,301,332,161,
40,"VALCEA",387,169253,,163,0,"SCOALA GENERALA COSTESTI","COSTESTI",23,169253,0,3,1644,1097,1004,93,1076,21,1800,703,801,275,
40,"VALCEA",387,169253,,164,0,"SCOALA BISTRITA","COSTESTI",23,169253,0,3,613,439,381,58,428,11,700,261,240,188,
40,"VALCEA",387,169253,,165,0,"SCOALA GENERALA PIETRENI","COSTESTI",23,169253,0,3,566,371,338,33,367,4,606,235,266,101,
40,"VALCEA",387,169306,,166,0,"SCOALA GENERALA CRETENI","CRETENI",24,169306,0,3,1053,557,502,55,549,8,1200,643,400,149,
40,"VALCEA",387,169306,,167,0,"SCOALA CU CLASELE I-IV IZVORU","CRETENI",24,169306,0,3,1116,618,536,82,610,8,1200,582,356,254,
40,"VALCEA",387,169351,,168,0,"SCOALA GENERALA DAESTI","DAESTI",25,169351,0,3,888,520,464,56,514,6,997,477,371,143,
40,"VALCEA",387,169351,,169,0,"CAMINUL CULTURAL SAMBOTIN","DAESTI",25,169351,0,3,491,341,278,63,336,5,602,261,227,109,
40,"VALCEA",387,169351,,170,0,"CAMINUL CULTURAL FEDELESOIU","DAESTI",25,169351,0,3,677,421,337,84,410,11,799,378,226,184,
40,"VALCEA",387,169404,,171,0,"SCOALA CU CLASELE I-VIII DANICEI UDRESTI","DANICEI",26,169404,0,3,1165,507,402,105,499,8,1300,793,299,200,
40,"VALCEA",387,169404,,172,0,"SCOALA CU CLASELE I-VIII LAUNELE DE JOS","DANICEI",26,169404,0,3,817,484,394,90,480,4,900,416,256,224,
40,"VALCEA",387,169547,,173,0,"SCOALA CU CLASELE I-VIII DRAGOESTI","DRAGOESTI",27,169547,0,3,1218,723,637,86,713,10,1400,677,446,267,
40,"VALCEA",387,169547,,174,0,"SCOALA CU CLASELE I-IV GEAMANA","DRAGOESTI",27,169547,0,3,708,464,396,68,458,6,800,336,327,131,
40,"VALCEA",387,169583,,175,0,"SCOALA FAURESTI","FAURESTI",29,169583,0,3,1412,624,532,92,617,7,1600,976,437,180,
40,"VALCEA",387,169583,,176,0,"SCOALA BABENI-OLTETU","FAURESTI",29,169583,0,3,1496,845,744,101,845,0,1700,845,579,266,
40,"VALCEA",387,169681,,177,0,"PRIMARIA FARTATESTI","FARTATESTI",28,169681,0,3,470,326,263,63,318,8,600,274,218,100,
40,"VALCEA",387,169681,,178,0,"CAMINUL CULTURAL DEJOI","FARTATESTI",28,169681,0,3,493,360,271,89,353,7,600,240,270,83,
40,"VALCEA",387,169681,,179,0,"SCOALA GENERALA CATETU","FARTATESTI",28,169681,0,3,447,284,214,70,279,5,600,316,199,80,
40,"VALCEA",387,169681,,180,0,"SCOALA GENERALA DOZESTI","FARTATESTI",28,169681,0,3,917,483,409,74,477,6,1000,517,388,89,
40,"VALCEA",387,169681,,181,0,"SCOALA GENERALA TANISLAVI","FARTATESTI",28,169681,0,3,363,218,159,59,218,0,400,182,131,87,
40,"VALCEA",387,169681,,182,0,"SCOALA GENERALA RUSANESTI","FARTATESTI",28,169681,0,3,1084,522,452,70,511,11,1200,678,391,120,
40,"VALCEA",387,169896,,183,0,"SCOALA FRANCESTI","FRANCESTI",30,169896,0,3,2196,1012,917,95,1003,9,1800,788,705,298,
40,"VALCEA",387,169896,,184,0,"SCOALA GENUNENI","FRANCESTI",30,169896,0,3,1102,658,559,99,647,11,1200,542,449,198,
40,"VALCEA",387,169896,,185,0,"SCOALA DEZROBITI","FRANCESTI",30,169896,0,3,1100,737,573,164,718,19,1100,363,493,225,
40,"VALCEA",387,169994,,186,0,"CAMINUL CULTURAL GALICEA","GALICEA",31,169994,0,3,1808,871,759,112,861,10,2100,1229,567,294,
40,"VALCEA",387,169994,,187,0,"SEDIU FERMA AGROINDCOM","GALICEA",31,169994,0,3,884,606,472,134,603,3,1100,494,380,223,
40,"VALCEA",387,169994,,188,0,"CAMINUL CULTURAL CREMENARI","GALICEA",31,169994,0,3,629,424,318,106,422,2,800,376,285,137,
40,"VALCEA",387,170097,,189,0,"SCOALA GENERALA STIRBESTI","GHIOROIU",32,170097,0,3,596,403,295,108,390,13,700,297,290,100,
40,"VALCEA",387,170097,,190,0,"SCOALA GENERALA GHIOROIU","GHIOROIU",32,170097,0,3,676,470,337,133,464,6,800,330,283,181,
40,"VALCEA",387,170097,,191,0,"SCOALA GENERALA POENARI","GHIOROIU",32,170097,0,3,364,225,198,27,220,5,400,175,155,65,
40,"VALCEA",387,170168,,192,0,"SCOALA GENERALA GLAVILE","GLAVILE",33,170168,0,3,1084,595,510,85,582,13,1200,605,342,240,
40,"VALCEA",387,170168,,193,0,"SCOALA GENERALA ANINOASA","GLAVILE",33,170168,0,3,309,239,180,59,230,9,400,161,138,92,
40,"VALCEA",387,170168,,194,0,"SCOALA GENERALA OLTEANCA","GLAVILE",33,170168,0,3,781,446,361,85,438,8,900,454,281,157,
40,"VALCEA",387,170220,,195,0,"SCOALA GENERALA POPESTI","GOLESTI",34,170220,0,3,739,384,307,77,383,1,900,516,220,163,
40,"VALCEA",387,170220,,196,0,"SCOALA GENERALA BLIDARI","GOLESTI",34,170220,0,3,740,519,432,87,512,7,857,338,360,152,
40,"VALCEA",387,170220,,197,0,"SCOALA GENERALA POENITA","GOLESTI",34,170220,0,3,694,382,297,85,377,5,800,418,242,135,
40,"VALCEA",387,170346,,198,0,"GRADINITA GRADISTEA","GRADISTEA",35,170346,0,3,618,344,267,77,336,8,618,274,239,97,
40,"VALCEA",387,170346,,199,0,"SCOALA GENERALA DOBRICEA","GRADISTEA",35,170346,0,3,665,424,346,78,418,6,800,376,256,162,
40,"VALCEA",387,170346,,200,0,"GRADINITA LINIA OBISLAVU","GRADISTEA",35,170346,0,3,1129,582,524,58,580,2,2400,1818,324,256,
40,"VALCEA",387,170444,,201,0,"SCOALA GENERALA GUSOENI","GUSOENI",36,170444,0,3,967,562,492,70,549,13,1100,538,374,175,
40,"VALCEA",387,170444,,202,0,"SCOALA I-IV GUSOIANCA","GUSOENI",36,170444,0,3,606,419,367,52,415,4,700,281,288,127,
40,"VALCEA",387,170514,,203,0,"SCOALA GENERALA IONESTI","IONESTI",37,170514,0,3,1428,724,547,177,708,16,1880,1156,413,295,
40,"VALCEA",387,170514,,204,0,"SCOALA GENERALA MARCEA","IONESTI",37,170514,0,3,1164,659,507,152,651,8,1000,341,419,232,
40,"VALCEA",387,170514,,205,0,"SCOALA GENERALA FISCALIA","IONESTI",37,170514,0,3,787,536,399,137,534,2,900,364,301,233,
40,"VALCEA",387,170612,,206,0,"SCOALA GENERALA LALOSU","LALOSU",39,170612,0,3,762,407,363,44,403,4,900,493,268,135,
40,"VALCEA",387,170612,,207,0,"SCOALA GENERALA MOLOGESTI","LALOSU",39,170612,0,3,569,277,235,42,272,5,700,423,165,107,
40,"VALCEA",387,170612,,208,0,"SCOALA GENERALA BERBESTI","LALOSU",39,170612,0,3,653,358,316,42,353,5,700,342,294,59,
40,"VALCEA",387,170685,,209,0,"CAMINUL CULTURAL LADESTI","LADESTI",38,170685,0,3,1203,703,537,166,683,20,1300,597,473,210,
40,"VALCEA",387,170685,,210,0,"SCOALA GENERALA CHIRICESTI","LADESTI",38,170685,0,3,665,374,314,60,370,4,793,419,267,103,
40,"VALCEA",387,170792,,211,0,"SCOALA GENERALA SARULESTI","LAPUSATA",40,170792,0,3,1305,944,845,99,927,17,1479,535,601,326,
40,"VALCEA",387,170792,,212,0,"SCOALA I-IV SERBANESTI-LAPUSATA","LAPUSATA",40,170792,0,3,700,411,357,54,410,1,700,289,293,117,
40,"VALCEA",387,170872,,213,0,"SCOALA GENERALA TINA","LIVEZI",41,170872,0,3,1022,595,501,94,583,12,1200,605,367,216,
40,"VALCEA",387,170872,,214,0,"SCOALA GENERALA PARAIENI","LIVEZI",41,170872,0,3,987,540,479,61,528,12,1095,555,315,213,
40,"VALCEA",387,170952,,215,0,"CAMINUL CULTURAL LUNGESTI","LUNGESTI",42,170952,0,3,1863,1087,940,147,1072,15,2000,913,795,277,
40,"VALCEA",387,170952,,216,0,"CAMINUL CULTURAL FUMURENI","LUNGESTI",42,170952,0,3,1098,662,549,113,655,7,1300,638,506,149,
40,"VALCEA",387,171021,,217,0,"GRADINITA NR.1 MALAIA","MALAIA",45,171021,0,3,898,498,462,36,492,6,1000,502,299,193,
40,"VALCEA",387,171021,,218,0,"SCOALA I-IV CIUNGET","MALAIA",45,171021,0,3,368,221,167,54,220,1,400,179,95,125,
40,"VALCEA",387,171021,,219,0,"SCOALA I-IV SALISTE","MALAIA",45,171021,0,3,243,195,165,30,194,1,300,105,110,84,
40,"VALCEA",387,171067,,220,0,"SCOALA GENERALA GRECI","MATEESTI",47,171067,0,3,503,311,258,53,310,1,600,289,213,97,
40,"VALCEA",387,171067,,221,0,"PRIMARIA MATEESTI","MATEESTI",47,171067,0,3,1052,602,534,68,596,6,1200,598,416,180,
40,"VALCEA",387,171067,,222,0,"GRADINITA TURCESTI","MATEESTI",47,171067,0,3,986,588,511,77,582,6,1100,512,407,175,
40,"VALCEA",387,171101,,223,0,"PRIMARIA MACIUCA","MACIUCA",43,171101,0,3,1793,1003,876,127,979,24,2000,997,709,270,
40,"VALCEA",387,171209,,224,0,"SCOALA I-VIII MADULARI","MADULARI",44,171209,0,3,825,604,521,83,594,10,700,96,440,154,
40,"VALCEA",387,171209,,225,0,"SCOALA I-IV BAISOARA","MADULARI",44,171209,0,3,434,330,283,47,327,3,400,70,258,69,
40,"VALCEA",387,171209,,226,0,"SCOALA I-IV BANTESTI","MADULARI",44,171209,0,3,347,244,207,37,241,3,400,156,186,55,
40,"VALCEA",387,171272,,227,0,"SCOALA VECHE - SALA DE SPORT MALDARESTI","MALDARESTI",46,171272,0,3,1706,942,873,69,933,9,1900,948,628,305,
40,"VALCEA",387,171325,,228,0,"CAMINUL CULTURAL BULETA","MIHAESTI",48,171325,0,3,1485,807,728,79,799,8,1700,893,504,295,
40,"VALCEA",387,171325,,229,0,"CAMINUL CULTURAL MAGURA","MIHAESTI",48,171325,0,3,1414,933,708,225,918,15,1600,667,585,333,
40,"VALCEA",387,171325,,230,0,"CAMINUL CULTURAL VULPUIESTI","MIHAESTI",48,171325,0,3,1339,815,744,71,803,12,1500,685,529,274,
40,"VALCEA",387,171325,,231,0,"GRADINITA STUPAREI","MIHAESTI",48,171325,0,3,562,425,320,105,421,4,601,176,320,101,
40,"VALCEA",387,171469,,232,0,"PRIMARIA MILCOIU","MILCOIU",49,171469,0,3,1051,649,548,101,644,5,1188,539,439,205,
40,"VALCEA",387,171539,,233,0,"DISPENSARUL UMAN MUEREASCA","MUEREASCA",50,171539,0,3,820,468,433,35,459,9,1100,632,213,246,
40,"VALCEA",387,171539,,234,0,"CAMINUL CULTURAL MUEREASCA DE SUS","MUEREASCA",50,171539,0,3,1265,690,625,65,680,10,1120,430,394,286,
40,"VALCEA",387,171628,,235,0,"SCOALA I-VIII ROTARASTI","NICOLAE BALCESCU",51,171628,0,3,1327,796,670,126,785,11,1500,704,538,247,
40,"VALCEA",387,171628,,236,0,"GRADINITA PREDESTI","NICOLAE BALCESCU",51,171628,0,3,1801,979,851,128,967,12,2000,1021,588,379,
40,"VALCEA",387,171806,,237,0,"CAMINUL CULTURAL OLANU","OLANU",52,171806,0,3,1872,1121,1007,114,1115,6,2100,979,661,454,
40,"VALCEA",387,171806,,238,0,"SCOALA I-IV DRAGIOIU","OLANU",52,171806,0,3,881,582,478,104,573,9,1000,418,358,215,
40,"VALCEA",387,171879,,239,0,"CAMINUL CULTURAL ORLESTI","ORLESTI",53,171879,0,3,1637,862,739,123,836,26,1900,1038,503,333,
40,"VALCEA",387,171879,,240,0,"SCOALA I-IV PROCOPOAIA","ORLESTI",53,171879,0,3,1335,777,691,86,765,12,1400,623,503,262,
40,"VALCEA",387,171931,,241,0,"CAMINUL CULTURAL OTESANI","OTESANI",54,171931,0,3,1300,739,673,66,726,13,1500,761,399,327,
40,"VALCEA",387,171931,,242,0,"SCOALA I-VIII CARSTANESTI","OTESANI",54,171931,0,3,1247,720,638,82,713,7,1400,680,432,281,
40,"VALCEA",387,171995,,243,0,"CAMINUL CULTURAL PAUSESTI","PAUSESTI",55,171995,0,3,1459,994,928,66,981,13,1600,606,587,394,
40,"VALCEA",387,171995,,244,0,"CAMINUL CULTURAL SERBANESTI","PAUSESTI",55,171995,0,3,1097,675,638,37,659,16,1180,505,402,257,
40,"VALCEA",387,172082,,245,0,"CAMINUL CULTURAL PAUSESTI-MAGLASI","PAUSESTI-MAGLASI",56,172082,0,3,1911,1355,1130,225,1323,32,2100,745,754,569,
40,"VALCEA",387,172082,,246,0,"CAMINUL CULTURAL VALEA CHEII","PAUSESTI-MAGLASI",56,172082,0,3,690,426,318,108,423,3,800,374,219,204,
40,"VALCEA",387,172153,,247,0,"SCOALA GENERALA PERISANI","PERISANI",57,172153,0,3,967,502,431,71,492,10,1100,598,231,261,
40,"VALCEA",387,172153,,248,0,"GRADINITA MLACENI","PERISANI",57,172153,0,3,690,452,406,46,448,4,800,348,253,195,
40,"VALCEA",387,172153,,249,0,"SCOALA GENERALA POIANA","PERISANI",57,172153,0,3,545,425,367,58,421,4,600,175,287,134,
40,"VALCEA",387,172153,,250,0,"SCOALA GENERALA TITESTI","PERISANI",57,172153,0,3,963,450,384,66,443,7,1100,650,202,241,
40,"VALCEA",387,172279,,251,0,"SCOALA VECHE DIN PESCEANA","PESCEANA",58,172279,0,3,1704,1002,892,110,990,12,1900,898,558,432,
40,"VALCEA",387,172340,,252,0,"SCOALA I-VIII PIETRARI","PIETRARI",59,172340,0,3,1468,975,872,103,965,10,1600,625,509,456,
40,"VALCEA",387,172340,,253,0,"SCOALA I-IV PIETRARII DE SUS","PIETRARI",59,172340,0,3,1253,811,746,65,802,9,1400,589,533,269,
40,"VALCEA",387,172377,,254,0,"SCOALA GENERALA DAESTI","POPESTI",60,172377,0,3,1193,698,576,122,689,9,1300,602,451,238,
40,"VALCEA",387,172377,,255,0,"SCOALA GENERALA POPESTI","POPESTI",60,172377,0,3,1381,756,655,101,747,9,1500,744,431,316,
40,"VALCEA",387,172457,,256,0,"SCOALA PRUNDENI","PRUNDENI",61,172457,0,3,1722,1043,839,204,1021,22,1900,857,682,339,
40,"VALCEA",387,172457,,257,0,"SCOALA CALINA","PRUNDENI",61,172457,0,3,1054,883,769,114,872,11,1200,317,584,288,
40,"VALCEA",387,172457,,258,0,"SCOALA ZAVIDENI-BARBUCENI","PRUNDENI",61,172457,0,3,940,768,666,102,766,2,1100,332,531,235,
40,"VALCEA",387,172509,,259,0,"CAMINUL CULTURAL RACOVITA","RACOVITA",62,172509,0,3,836,470,379,91,463,7,900,430,212,251,
40,"VALCEA",387,172509,,260,0,"CAMINUL CULTURAL BALOTA","RACOVITA",62,172509,0,3,309,207,141,66,195,12,400,193,133,62,
40,"VALCEA",387,172509,,261,0,"SCOALA GRUIUL -LUPULUI","RACOVITA",62,172509,0,3,203,118,94,24,114,4,300,182,46,68,
40,"VALCEA",387,172581,,262,0,"SCOALA I-IV ROESTI","ROESTI",63,172581,0,3,1129,660,566,94,657,3,1300,640,388,269,
40,"VALCEA",387,172581,,263,0,"SCOALA I-VIII CUIENI","ROESTI",63,172581,0,3,662,402,327,75,398,4,700,298,252,146,
40,"VALCEA",387,172698,,264,0,"SCOALA I-VIII ROSIILE","ROSIILE",64,172698,0,3,1331,652,511,141,631,21,1500,848,358,273,
40,"VALCEA",387,172698,,265,0,"SCOALA I-VIII ROMANESTI","ROSIILE",64,172698,0,3,1294,800,674,126,701,99,1500,700,500,201,
40,"VALCEA",387,172812,,266,0,"SCOALA I-IV RUNCU","RUNCU",65,172812,0,3,627,356,302,54,349,7,694,338,180,169,
40,"VALCEA",387,172812,,267,0,"SCOALA I-IV VALEA BABEI","RUNCU",65,172812,0,3,368,278,205,73,275,3,500,222,174,101,
40,"VALCEA",387,172894,,268,0,"CAMINUL CULTURAL SALATRUCEL","SALATRUCEL",66,172894,0,3,1156,633,557,76,620,13,1300,667,324,296,
40,"VALCEA",387,172894,,269,0,"SCOALA GENERALA SERBANESTI","SALATRUCEL",66,172894,0,3,652,337,306,31,330,7,700,363,160,170,
40,"VALCEA",387,172947,,270,0,"SCOALA I-VIII SCUNDU","SCUNDU",67,172947,0,3,1224,652,611,41,637,15,1500,848,418,219,
40,"VALCEA",387,172947,,271,0,"SCOALA I-VIII AVRAMESTI","SCUNDU",67,172947,0,3,743,412,357,55,403,9,800,388,183,220,
40,"VALCEA",387,172992,,272,0,"CAMINUL CULTURAL SINESTI","SINESTI",68,172992,0,3,1189,678,586,92,664,14,1300,622,498,166,
40,"VALCEA",387,172992,,273,0,"SCOALA I-VIII URZICA","SINESTI",68,172992,0,3,815,509,461,48,506,3,900,391,377,129,
40,"VALCEA",387,173061,,274,0,"CAMINUL CULTURAL SLATIOARA","SLATIOARA",70,173061,0,3,2307,1158,1006,152,1142,16,2600,1442,818,324,
40,"VALCEA",387,173061,,275,0,"SCOALA I-VIII MILOSTEA","SLATIOARA",70,173061,0,3,728,404,352,52,399,5,800,396,301,98,
40,"VALCEA",387,173132,,276,0,"CAMINUL CULTURAL STANESTI","STANESTI",71,173132,0,3,1279,637,549,88,625,12,1500,863,497,128,
40,"VALCEA",387,173230,,277,0,"SCOALA GENERALA STOENESTI","STOENESTI",73,173230,0,3,1348,801,738,63,787,14,1500,699,429,358,
40,"VALCEA",387,173230,,278,0,"SCOALA GENERALA DOBRICENI","STOENESTI",73,173230,0,3,1083,664,594,70,655,9,1208,544,374,281,
40,"VALCEA",387,173230,,279,0,"SCOALA GENERALA PISCU MARE","STOENESTI",73,173230,0,3,818,470,409,61,455,15,899,429,259,196,
40,"VALCEA",387,173374,,280,0,"SCOALA I-VIII STOILESTI","STOILESTI",74,173374,0,3,947,468,366,102,461,7,1100,632,255,206,
40,"VALCEA",387,173374,,281,0,"SCOALA I-IV GEAMANA","STOILESTI",74,173374,0,3,765,404,271,133,402,2,900,496,198,204,
40,"VALCEA",387,173374,,282,0,"SCOALA I-VIII URSI","STOILESTI",74,173374,0,3,1009,577,356,221,572,5,1100,523,266,306,
40,"VALCEA",387,173374,,283,0,"SCOALA I-VIII BARSOIU","STOILESTI",74,173374,0,3,652,358,274,84,355,3,700,342,194,161,
40,"VALCEA",387,173533,,284,0,"SCOALA I-VIII STROESTI","STROESTI",75,173533,0,3,1070,622,516,106,611,11,1288,666,311,300,
40,"VALCEA",387,173533,,285,0,"SCOALA I-VIII CIRESU","STROESTI",75,173533,0,3,911,555,498,57,552,3,1000,445,326,226,
40,"VALCEA",387,173533,,286,0,"SCOALA I-VIII DIANU","STROESTI",75,173533,0,3,551,358,319,39,353,5,600,242,235,118,
40,"VALCEA",387,173597,,287,0,"CAMINUL CULTURAL SUTESTI","SUTESTI",77,173597,0,3,1750,930,811,119,919,11,1900,970,623,296,
40,"VALCEA",387,173597,,288,0,"SCOALA I-VIII MITROFANI","SUTESTI",77,173597,0,3,648,462,384,78,458,4,800,338,325,133,
40,"VALCEA",387,173597,,289,0,"SCOALA I-IV RACU","SUTESTI",77,173597,0,3,266,267,199,68,265,2,300,33,191,74,
40,"VALCEA",387,173597,,290,0,"SCOALA I-IV VERDEA","SUTESTI",77,173597,0,3,428,306,234,72,305,1,506,200,225,80,
40,"VALCEA",387,173686,,291,0,"SCOALA GENERALA SIRINEASA","SIRINEASA",69,173686,0,3,1528,787,733,54,768,19,1700,913,417,351,
40,"VALCEA",387,173686,,292,0,"SCOALA I-IV CIORASTI","SIRINEASA",69,173686,0,3,553,370,332,38,367,3,600,230,235,132,
40,"VALCEA",387,173748,,293,0,"SCOALA GENERALA STEFANESTI","STEFANESTI",72,173748,0,3,1872,1100,934,166,1089,11,2100,1000,814,275,
40,"VALCEA",387,173748,,294,0,"SCOALA GENERALA DOBRUSA DE JOS","STEFANESTI",72,173748,0,3,1125,860,623,237,845,15,1300,440,649,196,
40,"VALCEA",387,173793,,295,0,"SCOALA I-IV SUSANII DE SUS","SUSANI",76,173793,0,3,1279,657,491,166,647,10,1209,552,487,160,
40,"VALCEA",387,173793,,296,0,"SCOALA I-VIII USUREI","SUSANI",76,173793,0,3,606,392,287,105,385,7,700,308,242,143,
40,"VALCEA",387,173793,,297,0,"SCOALA I-VIII RAMESTI","SUSANI",76,173793,0,3,1394,872,632,240,864,8,1596,724,625,239,
40,"VALCEA",387,173855,,298,0,"CAMINUL CULTURAL TETOIU","TETOIU",78,173855,0,3,1054,605,487,118,592,13,1200,595,426,166,
40,"VALCEA",387,173855,,299,0,"CAMINUL CULTURAL TEPESTI","TETOIU",78,173855,0,3,811,543,412,131,540,3,900,357,360,180,
40,"VALCEA",387,173855,,300,0,"SCOALA I-IV NENCIULESTI","TETOIU",78,173855,0,3,517,279,202,77,264,15,600,321,157,107,
40,"VALCEA",387,173935,,301,0,"SCOALA GENERALA TOMSANI","TOMSANI",79,173935,0,3,1618,896,789,107,887,9,1800,904,687,200,
40,"VALCEA",387,173935,,302,0,"SCOALA GENERALA FOLESTII DE SUS","TOMSANI",79,173935,0,3,1098,745,579,166,732,13,1305,560,442,290,
40,"VALCEA",387,173935,,303,0,"SCOALA GENERALA FOLESTII DE JOS","TOMSANI",79,173935,0,3,764,529,410,119,523,6,800,271,329,194,
40,"VALCEA",387,174021,,304,0,"SCOALA VECHE VAIDEENI","VAIDEENI",80,174021,0,3,2288,915,862,53,896,19,2600,1685,510,386,
40,"VALCEA",387,174021,,305,0,"SCOALA I-IV IZVORU RECE","VAIDEENI",80,174021,0,3,692,369,329,40,358,11,800,431,202,156,
40,"VALCEA",387,174021,,306,0,"SCOALA I-IV MARITA","VAIDEENI",80,174021,0,3,527,364,308,56,363,1,600,236,214,149,
40,"VALCEA",387,174085,,307,0,"SCOALA GENERALA VALEA MARE","VALEA MARE",81,174085,0,3,1131,570,498,72,555,15,1300,730,454,101,
40,"VALCEA",387,174085,,308,0,"SCOALA GENERALA MARGINENI","VALEA MARE",81,174085,0,3,889,516,427,89,506,10,1000,484,357,149,
40,"VALCEA",387,174085,,309,0,"SCOALA GENERALA DRAGANU","VALEA MARE",81,174085,0,3,563,373,312,61,369,4,600,227,283,86,
40,"VALCEA",387,174156,,310,0,"CAMINUL CULTURAL VLADESTI","VLADESTI",82,174156,0,3,1772,1086,968,118,1086,0,1600,505,545,541,
40,"VALCEA",387,174218,,311,0,"CAMINUL CULTURAL VOICESTI","VOICESTI",83,174218,0,3,1392,865,805,60,850,15,1604,739,654,196,
40,"VALCEA",387,174254,,312,0,"CAMINUL CULTURAL VOINEASA","VOINEASA",84,174254,0,3,1363,939,754,185,927,12,1500,561,502,425,
40,"VALCEA",387,174290,,313,0,"CLUBUL COPIILOR ZATRENI","ZATRENI",85,174290,0,3,593,389,284,105,384,5,700,311,257,127,
40,"VALCEA",387,174290,,314,0,"SCOALA I-IV STANOMIRU","ZATRENI",85,174290,0,3,451,297,264,33,294,3,501,204,221,73,
40,"VALCEA",387,174290,,315,0,"SCOALA I-IV GANESTI","ZATRENI",85,174290,0,3,508,354,276,78,331,23,600,246,265,66,
40,"VALCEA",387,174290,,316,0,"SCOALA I-IV LACUSTENI","ZATRENI",85,174290,0,3,717,498,448,50,493,5,800,302,327,166,
40,"VALCEA",387,174290,,317,0,"SCOALA I-IV VALENI","ZATRENI",85,174290,0,3,459,260,206,54,255,5,500,240,161,94,
40,"VALCEA",387,174290,,318,0,"SCOALA I-VIII DEALU VALENI","ZATRENI",85,174290,0,3,386,215,156,59,213,2,500,285,135,78,
40,"VALCEA",387,174290,,319,0,"SCOALA GENERALA SASCIOARA","ZATRENI",85,174290,0,3,475,283,214,69,273,10,600,317,187,86,
41,"VRANCEA",396,174744,,1,0,"Aurora,nr 5","MUNICIPIUL FOCSANI",1,174744,1,1,2353,1311,1174,137,1285,26,2588,1277,951,334,
41,"VRANCEA",396,174744,,2,0,"Republicii,nr 95","MUNICIPIUL FOCSANI",1,174744,1,1,1477,841,767,74,827,14,1630,789,626,201,
41,"VRANCEA",396,174744,,3,0,"M. Kogalniceanu,nr 12","MUNICIPIUL FOCSANI",1,174744,1,1,1671,916,858,58,892,24,1838,922,668,224,
41,"VRANCEA",396,174744,,4,0,"M. Kogalniceanu,nr 12","MUNICIPIUL FOCSANI",1,174744,1,1,1662,909,819,90,901,8,1828,919,619,282,
41,"VRANCEA",396,174744,,5,0,"Stefan cel Mare,nr 12","MUNICIPIUL FOCSANI",1,174744,1,1,1468,820,786,34,805,15,1611,791,606,199,
41,"VRANCEA",396,174744,,6,0,"Stefan cel Mare,nr 21","MUNICIPIUL FOCSANI",1,174744,1,1,1006,588,567,21,576,12,1108,520,468,108,
41,"VRANCEA",396,174744,,7,0,"Cotesti,nr 17","MUNICIPIUL FOCSANI",1,174744,1,1,1761,861,817,44,844,17,1937,1076,593,251,
41,"VRANCEA",396,174744,,8,0,"Prof. Longinescu,nr 33 bis5","MUNICIPIUL FOCSANI",1,174744,1,1,1571,865,798,67,850,15,1728,863,598,252,
41,"VRANCEA",396,174744,,9,0,"B-dul Garii,nr 25","MUNICIPIUL FOCSANI",1,174744,1,1,848,553,494,59,535,18,927,374,425,110,
41,"VRANCEA",396,174744,,10,0,"B-dul Garii,nr 25","MUNICIPIUL FOCSANI",1,174744,1,1,1631,891,862,29,880,11,1794,903,629,251,
41,"VRANCEA",396,174744,,11,0,"Republicii,nr 14","MUNICIPIUL FOCSANI",1,174744,1,1,1368,703,632,71,691,12,1368,665,502,189,
41,"VRANCEA",396,174744,,12,0,"Aleea Scolii,nr 47","MUNICIPIUL FOCSANI",1,174744,1,1,2464,1399,1305,94,1383,16,2700,1301,987,396,
41,"VRANCEA",396,174744,,13,0,"Birsei,nr 8","MUNICIPIUL FOCSANI",1,174744,1,1,820,403,368,35,400,3,904,501,276,124,
41,"VRANCEA",396,174744,,14,0,"Bicaz,nr 26","MUNICIPIUL FOCSANI",1,174744,1,1,1530,881,789,92,868,13,1685,804,610,258,
41,"VRANCEA",396,174744,,15,0,"Marasesti,nr 50","MUNICIPIUL FOCSANI",1,174744,1,1,1742,939,803,136,927,12,1919,980,661,266,
41,"VRANCEA",396,174744,,16,0,"Mare a Unirii,nr 64","MUNICIPIUL FOCSANI",1,174744,1,1,2683,1492,1373,119,1481,11,2943,1451,1001,480,
41,"VRANCEA",396,174744,,17,0,"Mare a Unirii,nr 24A","MUNICIPIUL FOCSANI",1,174744,1,1,1440,766,717,49,760,6,1589,823,509,251,
41,"VRANCEA",396,174744,,18,0,"Cuza Voda,nr 46","MUNICIPIUL FOCSANI",1,174744,1,1,2050,1464,1120,344,1449,15,2258,794,1118,331,
41,"VRANCEA",396,174744,,19,0,"Cuza Voda,nr 47","MUNICIPIUL FOCSANI",1,174744,1,1,792,461,379,82,454,7,871,410,319,135,
41,"VRANCEA",396,174744,,20,0,"Moldova,nr 8","MUNICIPIUL FOCSANI",1,174744,1,1,1660,845,775,70,828,17,1826,981,598,230,
41,"VRANCEA",396,174744,,21,0,"Moldova,nr 8","MUNICIPIUL FOCSANI",1,174744,1,1,1659,796,675,121,784,12,1829,1033,551,233,
41,"VRANCEA",396,174744,,22,0,"Mindresti - Munteni, str Lacramioarei,nr 19","MUNICIPIUL FOCSANI",1,174744,1,1,1088,1014,639,375,996,18,1498,484,702,294,
41,"VRANCEA",396,174744,,23,0,"Brailei,nr 121Bis","MUNICIPIUL FOCSANI",1,174744,1,1,1803,799,752,47,790,9,1983,1184,560,230,
41,"VRANCEA",396,174744,,24,0,"Aleea Caminului,nr 1","MUNICIPIUL FOCSANI",1,174744,1,1,2460,1090,1038,52,1077,13,2700,1610,755,322,
41,"VRANCEA",396,174744,,25,0,"Cezar Boliac,nr 13-15","MUNICIPIUL FOCSANI",1,174744,1,1,1426,859,675,184,843,16,1572,713,596,247,
41,"VRANCEA",396,174744,,26,0,"Dornei,nr 2","MUNICIPIUL FOCSANI",1,174744,1,1,2185,995,952,43,992,3,2411,1416,725,267,
41,"VRANCEA",396,174744,,27,0,"Brailei,nr 2","MUNICIPIUL FOCSANI",1,174744,1,1,1814,969,869,100,957,12,1995,1026,710,247,
41,"VRANCEA",396,174744,,28,0,"1 Decembrie 1918,nr 10","MUNICIPIUL FOCSANI",1,174744,1,1,2142,1067,961,106,1048,19,2350,1283,728,320,
41,"VRANCEA",396,174744,,29,0,"B-dul Uniruu,nr 12","MUNICIPIUL FOCSANI",1,174744,1,1,1421,791,738,53,778,13,1567,776,592,186,
41,"VRANCEA",396,174744,,30,0,"B-dul Dimitrie Cantemir,nr 12","MUNICIPIUL FOCSANI",1,174744,1,1,1641,852,759,93,841,11,1804,952,611,230,
41,"VRANCEA",396,174744,,31,0,"B-dul Unirii,nr 12","MUNICIPIUL FOCSANI",1,174744,1,1,1800,898,857,41,890,8,1981,1083,653,237,
41,"VRANCEA",396,174744,,32,0,"Maresal Ion Antonescu,nr 28","MUNICIPIUL FOCSANI",1,174744,1,1,2198,1182,1085,97,1170,12,2418,1236,839,331,
41,"VRANCEA",396,174744,,33,0,"Tineretii,nr 2","MUNICIPIUL FOCSANI",1,174744,1,1,1956,988,952,36,974,14,2150,1162,674,300,
41,"VRANCEA",396,174744,,34,0,"Tineretii,nr 2","MUNICIPIUL FOCSANI",1,174744,1,1,1883,958,901,57,945,13,2071,1113,676,269,
41,"VRANCEA",396,174744,,35,0,"Timotei Cipariu,nr 5","MUNICIPIUL FOCSANI",1,174744,1,1,2308,1230,1174,56,1218,12,2534,1304,894,324,
41,"VRANCEA",396,174744,,36,0,"Unirea Principatelor,nr 2","MUNICIPIUL FOCSANI",1,174744,1,1,1698,837,751,86,826,11,1824,987,596,230,
41,"VRANCEA",396,174744,,37,0,"Popa Sapca,nr 8","MUNICIPIUL FOCSANI",1,174744,1,1,930,463,424,39,458,5,1024,561,335,123,
41,"VRANCEA",396,174744,,38,0,"Anghel Saligny,nr 14Bis","MUNICIPIUL FOCSANI",1,174744,1,1,1356,713,657,56,705,8,1488,775,487,218,
41,"VRANCEA",396,174744,,39,0,"1 Decembrie 1918,nr 32","MUNICIPIUL FOCSANI",1,174744,1,1,2492,1158,1089,69,1145,13,2749,1591,838,307,
41,"VRANCEA",396,174744,,40,0,"B-dul Bucuresti,nr 11","MUNICIPIUL FOCSANI",1,174744,1,1,2075,995,933,62,987,8,2282,1287,694,293,
41,"VRANCEA",396,174744,,41,0,"Aleea 1 Iunie,nr 6","MUNICIPIUL FOCSANI",1,174744,1,1,808,434,316,118,427,7,887,453,278,149,
41,"VRANCEA",396,174744,,42,0,"Aleea 1 Iunie,nr 6","MUNICIPIUL FOCSANI",1,174744,1,1,1417,808,680,128,802,6,1555,747,564,238,
41,"VRANCEA",396,174744,,43,0,"Aleea Echitatii,nr 1","MUNICIPIUL FOCSANI",1,174744,1,1,2587,1383,1055,328,1368,15,2846,1463,1000,368,
41,"VRANCEA",396,174744,,44,0,"Aleea 1 Iunie,nr 6","MUNICIPIUL FOCSANI",1,174744,1,1,1127,696,562,134,684,12,1234,538,480,204,
41,"VRANCEA",396,174744,,45,0,"Aleea 1 Iunie,nr 6","MUNICIPIUL FOCSANI",1,174744,1,1,1274,578,533,45,573,5,1401,823,407,166,
41,"VRANCEA",396,174744,,46,0,"Aleea 1 Iunie,nr 1","MUNICIPIUL FOCSANI",1,174744,1,1,618,450,423,27,445,5,976,526,347,98,
41,"VRANCEA",396,174744,,47,0,"Aleea Stadionului,nr 2","MUNICIPIUL FOCSANI",1,174744,1,1,1626,741,708,33,733,8,1786,1045,483,250,
41,"VRANCEA",396,174744,,48,0,"Brailei,nr 121B","MUNICIPIUL FOCSANI",1,174744,1,1,1211,604,561,43,598,6,1332,728,392,206,
41,"VRANCEA",396,174744,,49,1,"B-dul Garii, Statia CFR","MUNICIPIUL FOCSANI",1,174744,1,1,0,372,0,372,368,4,500,128,242,126,
41,"VRANCEA",396,174744,,50,1,"Piata Victoriei,nr 1","MUNICIPIUL FOCSANI",1,174744,1,1,0,203,0,203,200,3,250,47,127,73,
41,"VRANCEA",396,174744,,51,1,"B-dul Bucuresti,nr 6","MUNICIPIUL FOCSANI",1,174744,1,1,0,226,0,226,224,2,254,28,136,88,
41,"VRANCEA",396,174744,,52,1,"B-dul Bucuresti,nr 3","MUNICIPIUL FOCSANI",1,174744,1,1,0,291,0,291,284,7,383,92,194,90,
41,"VRANCEA",396,174744,,53,1,"Dornisoarei,nr 10","MUNICIPIUL FOCSANI",1,174744,1,1,0,72,0,72,71,1,79,7,40,31,
41,"VRANCEA",396,174860,,54,0,"Libertatii,nr 15","ORAS ADJUD",2,174860,2,1,1848,948,860,88,939,9,2033,1085,641,298,
41,"VRANCEA",396,174860,,55,0,"Libertatii,nr 2","ORAS ADJUD",2,174860,2,1,1758,1141,1056,85,1130,11,1934,793,891,239,
41,"VRANCEA",396,174860,,56,0,"Tudor Vladimirescu,nr 1","ORAS ADJUD",2,174860,2,1,1955,820,758,62,811,9,2150,1330,546,265,
41,"VRANCEA",396,174860,,57,0,"Tudor Vladimirescu,nr 1","ORAS ADJUD",2,174860,2,1,1931,965,814,151,945,20,2126,1161,623,322,
41,"VRANCEA",396,174860,,58,0,"B-dul Garii,nr 32","ORAS ADJUD",2,174860,2,1,1558,1034,684,350,1022,12,1714,680,643,379,
41,"VRANCEA",396,174860,,59,0,"Al Ioan Cuza,nr 338","ORAS ADJUD",2,174860,2,1,1163,702,576,126,694,8,1279,577,480,214,
41,"VRANCEA",396,174860,,60,0,"Republicii,nr 90","ORAS ADJUD",2,174860,2,1,1840,986,891,95,973,13,2026,1040,646,327,
41,"VRANCEA",396,174860,,61,0,"Republicii,nr 105","ORAS ADJUD",2,174860,2,1,1215,752,653,99,734,18,1336,584,525,209,
41,"VRANCEA",396,174860,,62,0,"SC.GEN.BURCIOAIA","ORAS ADJUD",2,174860,2,1,444,346,291,55,342,4,487,141,234,108,
41,"VRANCEA",396,174860,,63,0,"SC,GEN.SISCANI","ORAS ADJUD",2,174860,2,1,606,436,386,50,429,7,666,230,288,141,
41,"VRANCEA",396,174860,,64,0,"SC.GEN.ADJUDU VECHI","ORAS ADJUD",2,174860,2,1,1308,790,701,89,782,8,1437,647,487,295,
41,"VRANCEA",396,174922,,65,0,"Maresal Ion Antonescu,nr 3","ORAS MARASESTI",3,174922,2,1,1422,830,781,49,816,14,1569,739,602,214,
41,"VRANCEA",396,174922,,66,0,"Cartier Siret","ORAS MARASESTI",3,174922,2,1,1699,1083,1047,36,1061,22,1873,790,901,160,
41,"VRANCEA",396,174922,,67,0,"Republicii,nr 99","ORAS MARASESTI",3,174922,2,1,2801,1438,1364,74,1417,21,3091,1653,956,461,
41,"VRANCEA",396,174922,,68,0,"Republicii,nr 74","ORAS MARASESTI",3,174922,2,1,1856,1046,919,127,1033,13,2046,1000,748,285,
41,"VRANCEA",396,174922,,69,0,"SC.GEN.Sat Haret","ORAS MARASESTI",3,174922,2,1,480,330,283,47,327,3,533,203,227,100,
41,"VRANCEA",396,174922,,70,0,"SC.GEN.Sat Padureni","ORAS MARASESTI",3,174922,2,1,416,266,215,51,264,2,459,193,159,105,
41,"VRANCEA",396,174922,,71,0,"SC.GEN.sat Calimanesti","ORAS MARASESTI",3,174922,2,1,305,262,177,85,258,4,336,74,205,53,
41,"VRANCEA",396,174922,,72,0,"SC.GEN.Sat Doaga","ORAS MARASESTI",3,174922,2,1,204,125,105,20,122,3,222,97,93,29,
41,"VRANCEA",396,174922,,73,1,"Statia CFR Marasesti","ORAS MARASESTI",3,174922,2,1,0,167,0,167,166,1,250,83,86,80,
41,"VRANCEA",396,175019,,74,0,"Piata Libertatii,nr 2","ORAS ODOBESTI",4,175019,2,1,2036,1292,1114,178,1286,6,2234,942,867,419,
41,"VRANCEA",396,175019,,75,0,"St cel Mare,nr 42","ORAS ODOBESTI",4,175019,2,1,1993,1294,1110,184,1274,20,2192,898,935,339,
41,"VRANCEA",396,175019,,76,0,"Maresal Ion Antonescu,nr 71","ORAS ODOBESTI",4,175019,2,1,1264,706,632,74,699,7,1268,562,460,239,
41,"VRANCEA",396,175019,,77,0,"SC.GEN,Sat Unirea","ORAS ODOBESTI",4,175019,2,1,1174,694,621,73,677,17,1295,601,467,210,
41,"VRANCEA",396,175055,,78,0,"Casa de Cultura Panciu","ORAS PANCIU",5,175055,2,1,2523,1293,1156,137,1264,29,2775,1482,823,441,
41,"VRANCEA",396,175055,,79,0,"Spitalul orasenesc Panciu","ORAS PANCIU",5,175055,2,1,2152,1201,999,202,1179,22,2367,1166,796,383,
41,"VRANCEA",396,175055,,80,0,"SC.GEN.Cartier Satu Nou","ORAS PANCIU",5,175055,2,1,833,540,466,74,535,5,916,376,379,156,
41,"VRANCEA",396,175055,,81,0,"SC.GEN.Cartier Crucea de Jos","ORAS PANCIU",5,175055,2,1,805,557,469,88,551,6,885,328,379,172,
41,"VRANCEA",396,175055,,82,0,"SC.GEN.Cartier Crucea deSus","ORAS PANCIU",5,175055,2,1,722,520,454,66,512,8,794,274,382,130,
41,"VRANCEA",396,175055,,83,0,"Camin Cultural cartier Neicu","ORAS PANCIU",5,175055,2,1,523,347,304,43,337,10,575,228,240,97,
41,"VRANCEA",396,175126,,84,0,"SC.GEN.ANDREIASU DE JOS","ANDREIASU DE JOS",6,175126,0,3,735,425,371,54,421,4,809,384,338,83,
41,"VRANCEA",396,175126,,85,0,"SC.GEN ANDREIASU DE SUS","ANDREIASU DE JOS",6,175126,0,3,427,355,311,44,349,6,470,115,281,68,
41,"VRANCEA",396,175126,,86,0,"SC.GEN.SAT RACHITASU","ANDREIASU DE JOS",6,175126,0,3,497,427,334,93,420,7,546,119,344,76,
41,"VRANCEA",396,175206,,87,0,"SC.GEN.BALESTI","BALESTI",7,175206,0,3,2026,1377,1291,86,1349,28,2227,850,1124,225,
41,"VRANCEA",396,175224,,88,0,"SC.GEN.BIRSESTI","BARSESTI",8,175224,0,3,1393,847,758,89,828,19,1441,594,507,321,
41,"VRANCEA",396,175224,,89,0,"CAMIN CULTURAL SAT NEGRILESTI","BARSESTI",8,175224,0,3,1630,1179,1113,66,1167,12,1791,612,903,264,
41,"VRANCEA",396,175260,,90,0,"MAGAZIN SAT BOGHESTI","BOGHESTI",9,175260,0,3,952,544,463,81,529,15,1047,503,374,155,
41,"VRANCEA",396,175260,,91,0,"SC.GEN 1-4 SAT PRISECANI","BOGHESTI",9,175260,0,3,545,363,307,56,360,3,602,239,259,101,
41,"VRANCEA",396,175368,,92,0,"CAMIN CULTURAL SAT BOLOTESTI","BOLOTESTI",10,175368,0,3,1114,806,654,152,793,13,1214,408,611,182,
41,"VRANCEA",396,175368,,93,0,"SC.GEN. SAT IVANCESTI","BOLOTESTI",10,175368,0,3,345,252,204,48,248,4,387,135,197,51,
41,"VRANCEA",396,175368,,94,0,"SC.GEN. SAT GAGESTI","BOLOTESTI",10,175368,0,3,1609,1181,1044,137,1164,17,1777,596,906,258,
41,"VRANCEA",396,175368,,95,0,"SC,GEN.SAT VITANESTI","BOLOTESTI",10,175368,0,3,547,396,318,78,387,9,600,204,292,95,
41,"VRANCEA",396,175439,,96,0,"CAMIN CULTURAL BORDESTI","BORDESTI",11,175439,0,3,1574,931,826,105,916,15,1740,809,754,162,
41,"VRANCEA",396,175466,,97,0,"CAMIN CULTURAL SAT BROSTENI","BROSTENI",12,175466,0,3,1599,1041,927,114,1034,7,1755,714,835,199,
41,"VRANCEA",396,175509,,98,0,"SC.GEN. SAT CHIOJDENI","CHIOJDENI",16,175509,0,3,1393,904,828,76,886,18,1535,631,719,167,
41,"VRANCEA",396,175509,,99,0,"SC.GEN.SAT CATAUTI","CHIOJDENI",16,175509,0,3,415,336,302,34,304,32,463,127,238,66,
41,"VRANCEA",396,175590,,100,0,"SALON DE DANS --CAMIN CULTURAL CIORASTI","CIORASTI",17,175590,0,3,1018,642,593,49,625,17,1125,483,458,167,
41,"VRANCEA",396,175590,,101,0,"FOSTUL MAGAZIN MIXT SAT CODRESTI","CIORASTI",17,175590,0,3,275,223,190,33,217,6,302,79,176,41,
41,"VRANCEA",396,175590,,102,0,"SC.GEN. SAT MIHALCENI","CIORASTI",17,175590,0,3,788,517,445,72,506,11,872,355,427,79,
41,"VRANCEA",396,175590,,103,0,"SC. GEN.SATSALCIA NOUA","CIORASTI",17,175590,0,3,516,393,348,45,382,11,567,174,311,71,
41,"VRANCEA",396,175590,,104,0,"SC. GEN. SAT SALCIA VECHE","CIORASTI",17,175590,0,3,296,260,219,41,257,3,325,65,212,45,
41,"VRANCEA",396,175590,,105,0,"SC. GEN. SAT  SATU NOU","CIORASTI",17,175590,0,3,249,192,171,21,189,3,274,82,135,54,
41,"VRANCEA",396,175590,,106,0,"FOSTUL MAGAZIN MIXT  SAT SPATAREASA","CIORASTI",17,175590,0,3,251,206,184,22,202,4,276,70,163,39,
41,"VRANCEA",396,174780,,107,0,"SC. GEN. CIMPINEANCA","CAMPINEANCA",13,174780,0,3,2462,1450,1326,124,1432,18,2694,1244,997,435,
41,"VRANCEA",396,175670,,108,0,"SC. GEN. NR.2 TEI","CAMPURI",14,175670,0,3,866,633,559,74,622,11,952,319,502,120,
41,"VRANCEA",396,175670,,109,0,"Caminul Cultural Cimpuri","CAMPURI",14,175670,0,3,1035,784,675,109,752,32,1138,354,649,103,
41,"VRANCEA",396,175670,,110,0,"SC.GEN. SAT ROTILESTII MARI","CAMPURI",14,175670,0,3,536,481,401,80,467,14,591,110,378,89,
41,"VRANCEA",396,175670,,111,0,"SC.GEN. SAT  FETESTI","CAMPURI",14,175670,0,3,770,679,601,78,674,5,851,172,560,114,
41,"VRANCEA",396,175732,,112,0,"CAMINUL CULTURAL  SAT CIRLIGELE","CARLIGELE",15,175732,0,3,945,650,507,143,638,12,995,345,520,118,
41,"VRANCEA",396,175732,,113,0,"SC. GEN. SAT BLIDARI","CARLIGELE",15,175732,0,3,513,471,405,66,463,8,565,94,319,144,
41,"VRANCEA",396,175732,,114,0,"SC.GEN. SAT BONTESTI","CARLIGELE",15,175732,0,3,306,379,274,105,370,9,386,7,309,61,
41,"VRANCEA",396,175732,,115,0,"SC.GEN. SAT DALHAUTI","CARLIGELE",15,175732,0,3,528,562,473,89,553,9,581,19,495,58,
41,"VRANCEA",396,175787,,116,0,"SC.GEN. SAT SERBANESTI","CORBITA",18,175787,0,3,751,502,433,69,496,6,826,324,353,143,
41,"VRANCEA",396,175787,,117,0,"SC.GEN. SAT RADACINESTI","CORBITA",18,175787,0,3,362,287,241,46,282,5,397,110,190,92,
41,"VRANCEA",396,175787,,118,0,"GRADINITA SAT BUDA","CORBITA",18,175787,0,3,516,382,345,37,378,4,566,184,272,106,
41,"VRANCEA",396,175885,,119,0,"SC.GEN.NR.1  SAT COTESTI","COTESTI",19,175885,0,3,2025,1131,921,210,1111,20,2232,1101,903,208,
41,"VRANCEA",396,175885,,120,0,"CAMIN CULTURAL  SAT BUDESTI","COTESTI",19,175885,0,3,1431,858,730,128,764,94,1577,719,640,124,
41,"VRANCEA",396,175938,,121,0,"CAMIN CULTURAL  SAT DUMBRAVENI","DUMBRAVENI",20,175938,0,3,2171,1339,1180,159,1305,34,2378,1039,991,314,
41,"VRANCEA",396,175938,,122,0,"CAMIN CULTURAL  SAT CINDESTI","DUMBRAVENI",20,175938,0,3,1038,654,548,106,642,12,1134,480,468,174,
41,"VRANCEA",396,175983,,123,0,"Liceul teoretic sat Dumitresti","DUMITRESTI",21,175983,0,3,917,572,491,81,568,4,1009,437,459,109,
41,"VRANCEA",396,175983,,124,0,"Caminul cultural sat Dumitresti","DUMITRESTI",21,175983,0,3,954,576,471,105,570,6,1051,475,425,145,
41,"VRANCEA",396,175983,,125,0,"SC. GEN.  SAT MOTNAU","DUMITRESTI",21,175983,0,3,518,359,334,25,350,9,571,212,197,153,
41,"VRANCEA",396,175983,,126,0,"CAMIN CULTURAL  SAT TINOASA","DUMITRESTI",21,175983,0,3,204,185,161,24,182,3,225,40,154,28,
41,"VRANCEA",396,175983,,127,0,"SC.PRIMARA  SAT POIENITA","DUMITRESTI",21,175983,0,3,656,501,449,52,488,13,719,218,369,119,
41,"VRANCEA",396,175983,,128,0,"SC.GEN. SAT DUMITRESTI  FATA","DUMITRESTI",21,175983,0,3,235,160,147,13,159,1,256,96,114,45,
41,"VRANCEA",396,175983,,129,0,"SC.PRIMARA  SAT BICESTII DE SUS","DUMITRESTI",21,175983,0,3,668,435,389,46,432,3,531,96,305,127,
41,"VRANCEA",396,176150,,130,0,"CAMIN CULTURAL SAT FITIONESTI","FITIONESTI",22,176150,0,3,1471,706,634,72,692,14,1611,905,310,382,
41,"VRANCEA",396,176150,,131,0,"SC.GEN. DE 8 ANI  SAT MANASTIOARA HOLBANESTI","FITIONESTI",22,176150,0,3,1043,527,478,49,514,13,1147,620,303,211,
41,"VRANCEA",396,176212,,132,0,"CAMIN CULTURAL SAT GAROAFA","GAROAFA",23,176212,0,3,1786,982,822,160,969,13,1956,974,620,349,
41,"VRANCEA",396,176212,,133,0,"SC.GEN. SAT DOAGA","GAROAFA",23,176212,0,3,418,279,224,55,273,6,460,181,178,95,
41,"VRANCEA",396,176212,,134,0,"SC.GEN. SAT CIUSLEA","GAROAFA",23,176212,0,3,1207,775,647,128,757,18,1021,246,511,246,
41,"VRANCEA",396,174824,,135,0,"SC.GEN. SAT GOLESTI","GOLESTI",24,174824,0,3,2448,1438,1273,165,1422,16,2800,1362,949,473,
41,"VRANCEA",396,176301,,136,0,"SC.GEN. NR.2  SAT GUGESTI","GUGESTI",25,176301,0,3,1469,1263,1171,92,1249,14,1614,351,1024,225,
41,"VRANCEA",396,176301,,137,0,"Gugesti Poiana","GUGESTI",25,176301,0,3,827,717,628,89,710,7,913,196,565,145,
41,"VRANCEA",396,176301,,138,0,"Camin cultural Gugesti","GUGESTI",25,176301,0,3,2147,1723,1550,173,1708,15,2365,642,1556,152,
41,"VRANCEA",396,176301,,139,0,"SCOALA OREAVU","GUGESTI",25,176301,0,3,457,414,365,49,410,4,503,89,308,102,
41,"VRANCEA",396,176338,,140,0,"SC.GEN. SAT GURA CALITEI","GURA CALITEI",26,176338,0,3,879,425,378,47,417,8,971,546,303,114,
41,"VRANCEA",396,176338,,141,0,"SC.GEN. SAT LACU LUI BABAN","GURA CALITEI",26,176338,0,3,865,475,401,74,461,14,952,477,333,128,
41,"VRANCEA",396,176338,,142,0,"SC.GEN. SAT DEALUL LUNG","GURA CALITEI",26,176338,0,3,756,403,370,33,398,5,834,431,297,101,
41,"VRANCEA",396,176445,,143,0,"SC.GEN. SAT HOMOCEA","HOMOCEA",27,176445,0,3,3426,1849,1696,153,1826,23,3767,1918,1550,276,
41,"VRANCEA",396,176445,,144,0,"SC.GEN. SAT PLOSCUTENI","HOMOCEA",27,176445,0,3,2417,1504,1377,127,1467,37,2417,913,1173,294,
41,"VRANCEA",396,176445,,145,0,"SC.GEN.SAT LESPEZI","HOMOCEA",27,176445,0,3,1244,762,629,133,759,3,1368,606,583,176,
41,"VRANCEA",396,176506,,146,0,"CAMIN CULTURAL JARISTEA","JARISTEA",28,176506,0,3,2277,1384,1155,229,1353,31,2595,1211,1006,347,
41,"VRANCEA",396,176506,,147,0,"GRADINITA PADURENI","JARISTEA",28,176506,0,3,396,297,231,66,295,2,403,106,221,74,
41,"VRANCEA",396,176506,,148,0,"SC.GEN. SAT VARSATURA","JARISTEA",28,176506,0,3,417,291,218,73,290,1,432,141,202,88,
41,"VRANCEA",396,176506,,149,0,"SC.GEN. SAT SCINTEIA","JARISTEA",28,176506,0,3,198,169,134,35,167,2,201,32,132,35,
41,"VRANCEA",396,176551,,150,0,"SC.GEN.5-8  JITIA","JITIA",29,176551,0,3,1103,722,630,92,707,15,1203,481,436,271,
41,"VRANCEA",396,176551,,151,0,"SC.GEN. 1-4 SAT JITIA DE JOS","JITIA",29,176551,0,3,317,232,203,29,229,3,349,117,186,43,
41,"VRANCEA",396,176613,,152,0,"SC.GEN. SAT MAICANESTI","MAICANESTI",30,176613,0,3,1981,1220,1049,171,1203,17,2185,965,956,247,
41,"VRANCEA",396,176613,,153,0,"SC.GEN. SAT RIMNICENI","MAICANESTI",30,176613,0,3,1722,1000,884,116,978,22,1894,894,805,173,
41,"VRANCEA",396,176613,,154,0,"SC.GEN. SAT SL.BOTESTI","MAICANESTI",30,176613,0,3,570,474,368,106,465,9,631,157,362,103,
41,"VRANCEA",396,176613,,155,0,"SC.GEN.SAT STUPINA","MAICANESTI",30,176613,0,3,379,351,297,54,346,5,417,66,251,95,
41,"VRANCEA",396,176686,,156,0,"CAMIN CULTURAL MERA","MERA",31,176686,0,3,1633,1093,901,192,975,118,1789,696,938,37,
41,"VRANCEA",396,176686,,157,0,"SC.GEN. SAT VULCANEASA","MERA",31,176686,0,3,1329,1024,820,204,1011,13,1463,439,871,140,
41,"VRANCEA",396,176748,,158,0,"SC. GEN. SAT MILCOVUL","MILCOVUL",32,176748,0,3,2271,1446,1299,147,1423,23,2495,1049,1164,259,
41,"VRANCEA",396,176748,,159,0,"SC .GEN. SAT LAMOTESTI","MILCOVUL",32,176748,0,3,677,451,376,75,439,12,745,294,314,125,
41,"VRANCEA",396,176748,,160,0,"SC.GE. SAT RASTOACA","MILCOVUL",32,176748,0,3,1997,1995,1881,114,1989,6,2198,203,1792,197,
41,"VRANCEA",396,176748,,161,0,"SC.GEN. SAT GOLOGANU","MILCOVUL",32,176748,0,3,2722,1530,1403,127,1520,10,2996,1466,1079,441,
41,"VRANCEA",396,176793,,162,0,"SC.GEN. SAT DIOCHETI-REDIU","MOVILITA",33,176793,0,3,639,386,341,45,376,10,702,316,293,83,
41,"VRANCEA",396,176793,,163,0,"SC.GEN.NR.2  SAT MOVILITA","MOVILITA",33,176793,0,3,1103,600,504,96,588,12,1214,614,421,167,
41,"VRANCEA",396,176793,,164,0,"Gradinita  NR.1 SAT MOVILITA","MOVILITA",33,176793,0,3,1223,527,484,43,522,5,1334,807,320,202,
41,"VRANCEA",396,176793,,165,0,"SC.GEN. SAT TROTUSANU","MOVILITA",33,176793,0,3,379,249,220,29,246,3,417,168,165,81,
41,"VRANCEA",396,176855,,166,0,"SC.GEN. SAT NANESTI","NANESTI",34,176855,0,3,1173,659,586,73,647,12,1294,635,446,201,
41,"VRANCEA",396,176855,,167,0,"SC.GEN. SAT CALIENII VECHI","NANESTI",34,176855,0,3,1097,671,601,70,657,14,1211,540,522,135,
41,"VRANCEA",396,176891,,168,0,"CAMIN CULTURAL  SAT NARUJA","NARUJA",35,176891,0,3,1559,1222,1128,94,1202,20,1722,500,949,253,
41,"VRANCEA",396,176944,,169,0,"SC.GEN. NR.1 SAT NEREJU","NEREJU",36,176944,0,3,1331,1086,1016,70,1083,3,1459,373,767,316,
41,"VRANCEA",396,176944,,170,0,"SC.GEN. NR.2 SAT NEREJU MIC","NEREJU",36,176944,0,3,1633,1055,963,92,1039,16,1796,741,689,350,
41,"VRANCEA",396,177003,,171,0,"CAMIN CULTURAL  SAT NISTORESTI","NISTORESTI",37,177003,0,3,1074,652,612,40,637,15,1180,528,456,181,
41,"VRANCEA",396,177003,,172,0,"CAMIN CULTURAL SAT VETRESTI-HERASTRAU","NISTORESTI",37,177003,0,3,927,621,580,41,612,9,1020,399,455,157,
41,"VRANCEA",396,177101,,173,0,"CAMIN CULTURAL  SAT PALTIN","PALTIN",38,177101,0,3,1131,746,644,102,741,5,1242,496,557,184,
41,"VRANCEA",396,177101,,174,0,"CAMIN CULTURAL SAT PRAHUDA","PALTIN",38,177101,0,3,597,352,309,43,351,1,659,307,303,48,
41,"VRANCEA",396,177101,,175,0,"CAMIN CULTURAL SAT SPULBER","PALTIN",38,177101,0,3,1069,637,595,42,596,41,1176,539,512,84,
41,"VRANCEA",396,177236,,176,0,"GRADINITA  NOVACESTI","PAUNESTI",39,177236,0,3,1657,822,695,127,808,14,1841,1019,621,187,
41,"VRANCEA",396,177236,,177,0,"SC. GEN. SAT BOSTANESTI","PAUNESTI",39,177236,0,3,1464,766,571,195,744,22,1616,850,585,159,
41,"VRANCEA",396,177236,,178,0,"CAMIN CULTURAL PAUNESTI","PAUNESTI",39,177236,0,3,1600,721,547,174,706,15,1769,1048,570,136,
41,"VRANCEA",396,177236,,179,0,"CAMIN CULTURAL VIISOARA","PAUNESTI",39,177236,0,3,796,439,375,64,428,11,878,439,350,78,
41,"VRANCEA",396,177263,,180,0,"SC.GEN. SAT POIANA CRISTEI","POIANA CRISTEI",40,177263,0,3,1668,1395,1337,58,1376,19,1833,438,1078,298,
41,"VRANCEA",396,177263,,181,0,"CAMIN CULTURAL SAT MAHRIU","POIANA CRISTEI",40,177263,0,3,329,234,212,22,233,1,362,128,165,68,
41,"VRANCEA",396,177263,,182,0,"SC.PRIMARA  SAT PETREANU","POIANA CRISTEI",40,177263,0,3,200,165,146,19,162,3,220,55,145,17,
41,"VRANCEA",396,177263,,183,0,"SC.PRIMARA  SAT TIRITU","POIANA CRISTEI",40,177263,0,3,232,196,185,11,195,1,255,59,159,36,
41,"VRANCEA",396,177352,,184,0,"SC.VECHE  SAT PUFESTI","PUFESTI",41,177352,0,3,2023,1228,1061,167,1204,24,2150,922,823,381,
41,"VRANCEA",396,177352,,185,0,"SC.GEN. SAT DOMNESTI TIRG (SATU L  NOU)","PUFESTI",41,177352,0,3,1020,687,574,113,679,8,1120,433,489,190,
41,"VRANCEA",396,177405,,186,0,"CAMIN CULTURAL  SAT RACOASA","RACOASA",42,177405,0,3,1008,697,585,112,662,35,1108,411,470,192,
41,"VRANCEA",396,177405,,187,0,"CAMIN CULTURAL  SAT MARASTI","RACOASA",42,177405,0,3,566,407,361,46,389,18,624,217,239,150,
41,"VRANCEA",396,177405,,188,0,"SCOALA  SAT VERDEA","RACOASA",42,177405,0,3,684,431,392,39,422,9,752,321,216,206,
41,"VRANCEA",396,177405,,189,0,"SCOALA SAT VARNITA","RACOASA",42,177405,0,3,442,335,272,63,329,6,485,150,285,44,
41,"VRANCEA",396,177405,,190,0,"SCOALA SAT GOGOIU","RACOASA",42,177405,0,3,183,157,132,25,156,1,200,43,93,63,
41,"VRANCEA",396,177469,,191,0,"SC.GEN.NR1  SAT SINDRILARI","REGHIU",43,177469,0,3,1154,993,937,56,949,44,1269,276,816,133,
41,"VRANCEA",396,177469,,192,0,"SC.GEN. SAT REGHIU","REGHIU",43,177469,0,3,539,395,373,22,357,38,595,200,317,40,
41,"VRANCEA",396,177469,,193,0,"SC. GEN. SAT RAIUTI","REGHIU",43,177469,0,3,412,381,355,26,379,2,457,76,343,36,
41,"VRANCEA",396,177557,,194,0,"CAMIN CULTURAL SAT RUGINESTI","RUGINESTI",44,177557,0,3,1989,1055,952,103,1031,24,2188,1133,746,285,
41,"VRANCEA",396,177557,,195,0,"SC.GEN. SAT ANGHELESTI","RUGINESTI",44,177557,0,3,952,638,590,48,631,7,1050,412,498,133,
41,"VRANCEA",396,177557,,196,0,"SC. GEN. SAT COPACESTI","RUGINESTI",44,177557,0,3,646,394,359,35,383,11,713,319,300,83,
41,"VRANCEA",396,177600,,197,0,"GRADINITA SAT SIHLEA","SIHLEA",45,177600,0,3,1870,1020,895,125,995,25,2059,1039,739,256,
41,"VRANCEA",396,177600,,198,0,"SC.GEN. SAT CAIATA","SIHLEA",45,177600,0,3,485,331,252,79,320,11,534,203,262,58,
41,"VRANCEA",396,177600,,199,0,"GRADINITA  SAT BOGZA","SIHLEA",45,177600,0,3,900,628,483,145,609,19,992,364,497,112,
41,"VRANCEA",396,177600,,200,0,"SC.GEN. SAT VOETIN","SIHLEA",45,177600,0,3,1014,779,573,206,769,10,1114,335,609,160,
41,"VRANCEA",396,177600,,201,1,"pt militari  COADA VAII   DIN SAT SIHLEA","SIHLEA",45,177600,0,3,0,190,0,190,184,6,280,90,101,83,
41,"VRANCEA",396,177655,,202,0,"SC.GEN. SAT SL. BRADULUI","SLOBOZIA BRADULUI",46,177655,0,3,981,545,347,198,524,21,1063,518,402,122,
41,"VRANCEA",396,177655,,203,0,"SC. GEN. SAT CORATENI","SLOBOZIA BRADULUI",46,177655,0,3,787,596,487,109,582,14,862,266,417,165,
41,"VRANCEA",396,177655,,204,0,"SC.GEN. SAT COTRNETU","SLOBOZIA BRADULUI",46,177655,0,3,1279,768,606,162,751,17,1427,659,726,25,
41,"VRANCEA",396,177726,,205,0,"SC. GEN. DE 4 ANI   SAT JILISTE","SLOBOZIA CIORASTI",47,177726,0,3,536,344,315,29,341,3,592,248,229,112,
41,"VRANCEA",396,177726,,206,0,"GRADINITA  SAT SL. CIORASTI","SLOBOZIA CIORASTI",47,177726,0,3,1132,787,689,98,784,3,1247,460,580,204,
41,"VRANCEA",396,177762,,207,0,"SC.GEN.  ""SIMION M EHEDINTI""","SOVEJA",48,177762,0,3,1375,883,780,103,862,21,1515,632,644,218,
41,"VRANCEA",396,177762,,208,0,"SC.GEN. NR.2  SAT RUCARENI","SOVEJA",48,177762,0,3,1037,648,604,44,637,11,1187,539,482,155,
41,"VRANCEA",396,177799,,209,0,"Camin cultural Straoane de Jos","STRAOANE",49,177799,0,3,1300,741,629,112,722,19,1435,694,448,274,
41,"VRANCEA",396,177799,,210,0,"Camin cultural Straoane de Sus","STRAOANE",49,177799,0,3,927,560,457,103,551,9,1023,463,354,197,
41,"VRANCEA",396,177799,,211,0,"SC.GEN. SAT REPEDEA","STRAOANE",49,177799,0,3,324,227,201,26,224,3,358,131,171,53,
41,"VRANCEA",396,177799,,212,0,"CAMIN CULTURAL  SAT MUNCELU","STRAOANE",49,177799,0,3,834,469,420,49,456,13,920,451,305,151,
41,"VRANCEA",396,177842,,213,0," Scoala gen nr 1 SAT SURAIA","SURAIA",50,177842,0,3,3061,1393,1221,172,1366,27,3061,1668,927,439,
41,"VRANCEA",396,177842,,214,0,"Scoala gen nr 2  SAT SURAIA ""DIMACI""","SURAIA",50,177842,0,3,2080,940,798,142,929,11,2292,1352,621,308,
41,"VRANCEA",396,177842,,215,0,"SC.GEN.NR.1  SAT BILIESTI","SURAIA",50,177842,0,3,1894,1061,956,105,1046,15,2081,1020,797,249,
41,"VRANCEA",396,177879,,216,0,"CAMIN CULTURAL   SAT TANASOAIA","TANASOAIA",52,177879,0,3,1160,697,598,99,690,7,1276,579,564,126,
41,"VRANCEA",396,177879,,217,0,"SC. GEN. SAT FELDIOARA","TANASOAIA",52,177879,0,3,759,459,388,71,450,9,836,377,332,118,
41,"VRANCEA",396,177986,,218,0,"SC.GEN. SAT TATARANU","TATARANU",53,177986,0,3,1308,798,780,18,781,17,1439,641,576,205,
41,"VRANCEA",396,177986,,219,0,"SC.GEN. SAT MARTINESTI","TATARANU",53,177986,0,3,982,796,796,0,783,13,982,186,606,177,
41,"VRANCEA",396,177986,,220,0,"Sc gen Bordeasca Veche nr 2","TATARANU",53,177986,0,3,1225,775,775,0,768,7,1347,572,599,169,
41,"VRANCEA",396,177986,,221,0,"Sc gen Bordeasca Veche nr1","TATARANU",53,177986,0,3,882,854,854,0,840,14,971,117,698,142,
41,"VRANCEA",396,178046,,222,0,"CONS.LOCAL  TIMBOIESTI--(SALA  DE SEDINTE)","TAMBOESTI",51,178046,0,3,1141,566,487,79,550,16,1257,691,475,75,
41,"VRANCEA",396,178046,,223,0,"SC.GEN. SAT SLIMNIC","TAMBOESTI",51,178046,0,3,932,590,444,146,576,14,1028,438,440,136,
41,"VRANCEA",396,178046,,224,0,"SC.GEN. SAT TRESTIENI","TAMBOESTI",51,178046,0,3,154,121,92,29,120,1,171,50,95,25,
41,"VRANCEA",396,178046,,225,0,"SC.GEN. SAT OBREJITA","TAMBOESTI",51,178046,0,3,1122,670,538,132,654,16,1234,564,481,173,
41,"VRANCEA",396,178117,,226,0,"CONS.LOCAL    SAT  TULNICI","TULNICI",55,178117,0,3,2052,1909,1796,113,1893,16,2265,356,1614,279,
41,"VRANCEA",396,178117,,227,0,"CAMIN CULTURAL  SAT COZA","TULNICI",55,178117,0,3,736,669,627,42,668,1,809,140,562,106,
41,"VRANCEA",396,178117,,228,0,"CAMIN CULTURAL  SAT PAULESTI","TULNICI",55,178117,0,3,1105,1061,1011,50,1037,24,1216,155,894,143,
41,"VRANCEA",396,178117,,229,0,"CAMIN CULTURAL  SAT HAULUSCA","TULNICI",55,178117,0,3,662,656,626,30,630,26,729,73,557,73,
41,"VRANCEA",396,178117,,230,0,"SC.GEN. SAT LEPSA","TULNICI",55,178117,0,3,269,272,170,102,245,27,297,25,210,35,
41,"VRANCEA",396,178180,,231,0,"SC.GEN. COMUNA  TIFESTI","TIFESTI",54,178180,0,3,850,448,348,100,442,6,937,489,328,114,
41,"VRANCEA",396,178180,,232,0,"SC.GEN.  SAT BATINESTI","TIFESTI",54,178180,0,3,1251,717,626,91,707,10,1384,667,542,165,
41,"VRANCEA",396,178180,,233,0,"SC.GEN.  SAT OLESESTI","TIFESTI",54,178180,0,3,718,441,358,83,439,2,793,352,338,101,
41,"VRANCEA",396,178180,,234,0,"SC.GEN.  SAT SARBI","TIFESTI",54,178180,0,3,692,423,328,95,415,8,760,337,303,112,
41,"VRANCEA",396,178180,,235,0,"SC.GEN. SAT CLIPICESTI","TIFESTI",54,178180,0,3,729,636,543,93,629,7,804,168,543,86,
41,"VRANCEA",396,178279,,236,0,"CAMIN CULTURAL  SAT URECHESTI","URECHESTI",56,178279,0,3,2253,1151,948,203,1136,15,2479,1328,825,311,
41,"VRANCEA",396,178279,,237,0,"SC.GEN.  SAT POPESTI","URECHESTI",56,178279,0,3,1586,880,700,180,866,14,1747,867,615,251,
41,"VRANCEA",396,178279,,238,0,"Gradinita Runcu  ( POPESTI)","URECHESTI",56,178279,0,3,585,347,246,101,338,9,643,296,254,84,
41,"VRANCEA",396,178313,,239,0,"SC.GEN. VALEA SARII","VALEA SARII",57,178313,0,3,819,512,471,41,503,9,902,390,385,118,
41,"VRANCEA",396,178313,,240,0,"SC.GEN.  SAT COLACU","VALEA SARII",57,178313,0,3,933,890,840,50,835,55,1027,137,730,105,
41,"VRANCEA",396,178377,,241,0,"SC.GEN. NR.1  VIDRA","VIDRA",60,178377,0,3,2167,1353,1131,222,1296,57,2380,1027,992,304,
41,"VRANCEA",396,178377,,242,0,"SC.GEN.  SAT IRESTI","VIDRA",60,178377,0,3,1413,766,693,73,759,7,1552,786,562,197,
41,"VRANCEA",396,178377,,243,0,"SC.GEN. SAT BURCA","VIDRA",60,178377,0,3,1217,713,637,76,698,15,1337,624,553,145,
41,"VRANCEA",396,178377,,244,0,"CAMIN CULTURAL  SAT TICHIRIS","VIDRA",60,178377,0,3,713,430,398,32,426,4,783,353,295,131,
41,"VRANCEA",396,178377,,245,0,"SC.GEN. SAT VIISOARA","VIDRA",60,178377,0,3,702,363,343,20,359,4,771,408,224,135,
41,"VRANCEA",396,178475,,246,0,"SC.GE. VINTILEASCA","VINTILEASCA",61,178475,0,3,1045,622,589,33,615,7,1149,527,434,181,
41,"VRANCEA",396,178475,,247,0,"SC.GEN.  SAT BAHNELE","VINTILEASCA",61,178475,0,3,637,420,337,83,412,8,698,278,282,130,
41,"VRANCEA",396,178545,,248,0,"SC.GEN. SAT  VIZANTEA  RAZASEASCA","VIZANTEA-LIVEZI",62,178545,0,3,747,389,338,51,386,3,826,437,220,166,
41,"VRANCEA",396,178545,,249,0,"SC.GEN. SAT VIZANTEA MANASTIREASCA","VIZANTEA-LIVEZI",62,178545,0,3,1460,773,714,59,763,10,1606,833,579,184,
41,"VRANCEA",396,178545,,250,0,"SC. GEN. SAT PISCU RADULUI","VIZANTEA-LIVEZI",62,178545,0,3,442,232,196,36,228,4,486,254,148,80,
41,"VRANCEA",396,178545,,251,0,"SC.GEN. SAT MESTEACANU","VIZANTEA-LIVEZI",62,178545,0,3,348,226,208,18,222,4,384,158,81,141,
41,"VRANCEA",396,178545,,252,0,"SC.GEN. SAT LIVEZILE","VIZANTEA-LIVEZI",62,178545,0,3,661,436,354,82,420,16,727,291,239,181,
41,"VRANCEA",396,178607,,253,0,"SC.GEN. SAT VINATORI","VANATORI",58,178607,0,3,644,400,326,74,398,2,709,309,294,104,
41,"VRANCEA",396,178607,,254,0,"SC.GEN. SAT JORASTI","VANATORI",58,178607,0,3,1212,731,662,69,714,17,1331,600,507,207,
41,"VRANCEA",396,178607,,255,0,"SC.GEN. SAT PETRESTI","VANATORI",58,178607,0,3,747,454,402,52,446,8,828,374,309,137,
41,"VRANCEA",396,178607,,256,0,"SC.GEN. SAT MIRCESTII NOI","VANATORI",58,178607,0,3,1088,737,653,84,728,9,1194,457,536,192,
41,"VRANCEA",396,178607,,257,0,"SC.GEN. SAT RADULESTI","VANATORI",58,178607,0,3,697,457,394,63,454,3,764,307,308,146,
41,"VRANCEA",396,178689,,258,0,"CAMIN CULTURAL SAT  VIRESCOIU","VARTESCOIU",59,178689,0,3,1685,958,843,115,944,14,1851,893,690,254,
41,"VRANCEA",396,178689,,259,0,"CAMIN CULTURAL  SAT FARAOANELE","VARTESCOIU",59,178689,0,3,844,654,539,115,647,7,928,274,555,92,
41,"VRANCEA",396,178750,,260,0,"CAMIN CULTURAL  SAT VRINCIOAIA","VRANCIOAIA",63,178750,0,3,599,325,298,27,317,8,660,335,209,108,
41,"VRANCEA",396,178750,,261,0,"SC.GEN. SAT MUNCEI","VRANCIOAIA",63,178750,0,3,568,296,261,35,288,8,624,328,194,94,
41,"VRANCEA",396,178750,,262,0,"SC.GEN. SAT SPINESTI","VRANCIOAIA",63,178750,0,3,708,370,336,34,364,6,779,409,285,79,
41,"VRANCEA",396,178750,,263,0,"PUNCTUL SANITAR  POIANA","VRANCIOAIA",63,178750,0,3,653,350,323,27,350,0,719,369,221,129,
41,"VRANCEA",396,178821,,264,0,"CAMIN CULTURAL VULTURU","VULTURU",64,178821,0,3,3723,1790,1624,166,1758,32,4109,2319,1443,315,
41,"VRANCEA",396,178821,,265,0,"SC.GEN.SAT BOTIRLAU","VULTURU",64,178821,0,3,981,593,478,115,582,11,1082,489,464,118,
41,"VRANCEA",396,178821,,266,0,"SC.GEN. SAT HINGULESTI","VULTURU",64,178821,0,3,1200,726,597,129,722,4,1318,592,636,86,
41,"VRANCEA",396,178821,,267,0,"SC.GEN. SAT MALURI","VULTURU",64,178821,0,3,478,448,267,181,445,3,525,77,384,61,
41,"VRANCEA",396,178821,,268,0,"SC.GEN. SAT  VADU -ROSCA","VULTURU",64,178821,0,3,827,415,317,98,406,9,916,501,348,58,
42,"MUNICIPIUL BUCURESTI",403,179141,,1,0,"B-dul DACIA nr. 32 , Liceul V. MADGEARU","BUCURESTI SECTORUL 1",1,179141,1,1,1511,1041,826,215,1005,36,1768,727,819,186,
42,"MUNICIPIUL BUCURESTI",403,179141,,2,0,"B-dul DACIA nr. 32 , Liceul V. MADGEARU","BUCURESTI SECTORUL 1",1,179141,1,1,1549,842,714,128,824,18,1706,864,701,123,
42,"MUNICIPIUL BUCURESTI",403,179141,,3,0,"Str. PIATA ROMANA nr. 1 , Academia de Stiinte Economice","BUCURESTI SECTORUL 1",1,179141,1,1,1514,832,712,120,812,20,1670,838,688,124,
42,"MUNICIPIUL BUCURESTI",403,179141,,4,0,"Str. PIATA ROMANA nr. 1 , Academia de Stiinte Economice","BUCURESTI SECTORUL 1",1,179141,1,1,1243,732,582,150,706,24,1374,642,552,154,
42,"MUNICIPIUL BUCURESTI",403,179141,,5,0,"Str. ACADEMIEI nr. 18-20 , Institutul de Arhitectura I. MINCU","BUCURESTI SECTORUL 1",1,179141,1,1,1479,856,724,132,828,28,1632,776,669,159,
42,"MUNICIPIUL BUCURESTI",403,179141,,6,0,"Str. ACADEMIEI nr. 18-20 , Institutul de Arhitectura I. MINCU","BUCURESTI SECTORUL 1",1,179141,1,1,1569,848,697,151,818,30,1730,882,660,158,
42,"MUNICIPIUL BUCURESTI",403,179141,,7,0,"Cal. VICTORIEI nr. 114 , Scoala nr. 5 C. POPESCU","BUCURESTI SECTORUL 1",1,179141,1,1,1744,1035,844,191,1006,29,1921,886,805,201,
42,"MUNICIPIUL BUCURESTI",403,179141,,8,0,"Cal. VICTORIEI nr. 114 , Scoala nr. 5 C. POPESCU","BUCURESTI SECTORUL 1",1,179141,1,1,156,710,547,163,679,31,1460,750,556,123,
42,"MUNICIPIUL BUCURESTI",403,179141,,9,0,"Str. MANU GHEORGHE nr. 30 , Liceul de Muzica GEORGE ENESCU","BUCURESTI SECTORUL 1",1,179141,1,1,1642,935,762,173,900,35,1810,875,722,178,
42,"MUNICIPIUL BUCURESTI",403,179141,,10,0,"Str. MANU GHEORGHE nr. 30 , Liceul de Muzica GEORGE ENESCU","BUCURESTI SECTORUL 1",1,179141,1,1,1681,760,684,76,744,12,1870,1110,587,157,
42,"MUNICIPIUL BUCURESTI",403,179141,,11,0,"Str. OCCIDENTULUI nr. 12 , Grupul Scolar de Arhitectura si Sistematizare","BUCURESTI SECTORUL 1",1,179141,1,1,1281,734,603,131,720,14,1411,677,615,105,
42,"MUNICIPIUL BUCURESTI",403,179141,,12,0,"Str. G-RAL BERTHELOT nr. 23 , Colegiul National SF. SAVA","BUCURESTI SECTORUL 1",1,179141,1,1,1159,678,558,120,660,18,1279,601,521,139,
42,"MUNICIPIUL BUCURESTI",403,179141,,13,0,"Str. G-RAL BERTHELOT nr. 23 , Colegiul National SF. SAVA","BUCURESTI SECTORUL 1",1,179141,1,1,1347,721,664,57,678,43,1487,766,565,113,
42,"MUNICIPIUL BUCURESTI",403,179141,,14,0,"Str. G-RAL BERTHELOT nr. 23 , Colegiul National SF. SAVA","BUCURESTI SECTORUL 1",1,179141,1,1,1576,819,764,55,803,16,1514,695,656,147,
42,"MUNICIPIUL BUCURESTI",403,179141,,15,0,"Str. G-RAL BERTHELOT nr. 23 , Colegiul National SF. SAVA","BUCURESTI SECTORUL 1",1,179141,1,1,1684,769,708,61,741,28,1861,1092,587,154,
42,"MUNICIPIUL BUCURESTI",403,179141,,16,0,"Str. STIRBEI VODA nr. 33 , Academia de Muzica","BUCURESTI SECTORUL 1",1,179141,1,1,1373,704,627,77,670,34,1515,811,551,119,
42,"MUNICIPIUL BUCURESTI",403,179141,,17,0,"Str. STIRBEI VODA nr. 33 , Academia de Muzica","BUCURESTI SECTORUL 1",1,179141,1,1,1386,793,703,90,772,21,1523,730,658,114,
42,"MUNICIPIUL BUCURESTI",403,179141,,18,0,"Str. G-RAL. BERTHELOT nr. 58 , Liceul de Arte Plastice N. TONIZA","BUCURESTI SECTORUL 1",1,179141,1,1,1803,963,822,141,927,36,1772,809,704,223,
42,"MUNICIPIUL BUCURESTI",403,179141,,19,0,"Cal. PLEVNEI nr. 40 , Lineul Teotetic MIGUEL DE CERVANTES","BUCURESTI SECTORUL 1",1,179141,1,1,1492,857,682,175,834,23,1650,793,653,181,
42,"MUNICIPIUL BUCURESTI",403,179141,,20,0,"Cal. PLEVNEI nr. 40 , Lineul Teotetic MIGUEL DE CERVANTES","BUCURESTI SECTORUL 1",1,179141,1,1,1550,762,647,115,735,27,1550,788,580,155,
42,"MUNICIPIUL BUCURESTI",403,179141,,21,0,"Str. VIRGILIU nr. 40 , Scoala nr. 152 URUGUAY","BUCURESTI SECTORUL 1",1,179141,1,1,1617,670,613,57,651,19,1790,1120,500,151,
42,"MUNICIPIUL BUCURESTI",403,179141,,22,0,"Str. VIRGILIU nr. 40 , Scoala nr. 152 URUGUAY","BUCURESTI SECTORUL 1",1,179141,1,1,1229,653,574,79,636,17,1357,704,532,104,
42,"MUNICIPIUL BUCURESTI",403,179141,,23,0,"Str. VIRGILIU nr. 40 , Scoala nr. 152 URUGUAY","BUCURESTI SECTORUL 1",1,179141,1,1,1726,916,836,80,892,24,1902,986,722,170,
42,"MUNICIPIUL BUCURESTI",403,179141,,24,0,"Str. VIRGILIU nr. 40 , Scoala nr. 152 URUGUAY","BUCURESTI SECTORUL 1",1,179141,1,1,1468,618,558,60,602,16,1624,1006,466,136,
42,"MUNICIPIUL BUCURESTI",403,179141,,25,0,"Cal. PLEVNEI nr. 124 , Clubul Sportiv Scolar nr. 5 RAPID","BUCURESTI SECTORUL 1",1,179141,1,1,1911,889,777,112,870,19,2106,1217,638,232,
42,"MUNICIPIUL BUCURESTI",403,179141,,26,0,"Str. ATELIERULUI nr. 25 , Scoala nr. 1 SFINTII VOIEVOZI","BUCURESTI SECTORUL 1",1,179141,1,1,1295,771,565,206,754,17,1430,659,567,187,
42,"MUNICIPIUL BUCURESTI",403,179141,,27,0,"Str. ATELIERULUI nr. 25 , Scoala nr. 1 SFINTII VOIEVOZI","BUCURESTI SECTORUL 1",1,179141,1,1,1114,614,537,77,600,14,1225,611,472,128,
42,"MUNICIPIUL BUCURESTI",403,179141,,28,0,"Str. ATELIERULUI nr. 25 , Scoala nr. 1 SFINTII VOIEVOZI","BUCURESTI SECTORUL 1",1,179141,1,1,1295,753,681,72,730,23,1434,681,558,172,
42,"MUNICIPIUL BUCURESTI",403,179141,,29,0,"Str. ATELIERULUI nr. 25 , Scoala nr. 1 SFINTII VOIEVOZI","BUCURESTI SECTORUL 1",1,179141,1,1,1762,934,828,106,912,22,1946,1012,663,249,
42,"MUNICIPIUL BUCURESTI",403,179141,,30,0,"Str. ATELIERULUI nr. 25 , Scoala nr. 1 SFINTII VOIEVOZI","BUCURESTI SECTORUL 1",1,179141,1,1,1235,698,554,144,683,15,1760,1062,537,146,
42,"MUNICIPIUL BUCURESTI",403,179141,,31,0,"Cal. GRIVITEI nr. 193 b , Centrul de Perfectionare, Documentare SNCFR","BUCURESTI SECTORUL 1",1,179141,1,1,1754,1008,832,176,980,28,1934,926,757,223,
42,"MUNICIPIUL BUCURESTI",403,179141,,32,0,"Sos. N. TITULESCU nr. 52 , Scoala nr. 3 N. TITULESCU","BUCURESTI SECTORUL 1",1,179141,1,1,1635,794,700,94,769,25,1792,998,607,162,
42,"MUNICIPIUL BUCURESTI",403,179141,,33,0,"Sos. N. TITULESCU nr. 52 , Scoala nr. 3 N. TITULESCU","BUCURESTI SECTORUL 1",1,179141,1,1,1046,622,457,165,604,18,1483,861,463,141,
42,"MUNICIPIUL BUCURESTI",403,179141,,34,0,"Sos. N. TITULESCU nr. 52 , Scoala nr. 3 N. TITULESCU","BUCURESTI SECTORUL 1",1,179141,1,1,1581,1064,962,102,1029,35,1851,787,849,180,
42,"MUNICIPIUL BUCURESTI",403,179141,,35,0,"Sos. N. TITULESCU nr. 52 , Scoala nr. 3 N. TITULESCU","BUCURESTI SECTORUL 1",1,179141,1,1,1657,925,868,57,908,17,1835,910,701,207,
42,"MUNICIPIUL BUCURESTI",403,179141,,36,0,"Sos. N. TITULESCU nr. 52 , Scoala nr. 3 N. TITULESCU","BUCURESTI SECTORUL 1",1,179141,1,1,1508,885,781,104,863,22,1941,1056,695,168,
42,"MUNICIPIUL BUCURESTI",403,179141,,37,0,"Str. G-RAL VLADOIANU nr. 7 , Liceul Teoretic ION NECULCE","BUCURESTI SECTORUL 1",1,179141,1,1,1836,1038,975,63,1014,24,2024,986,838,176,
42,"MUNICIPIUL BUCURESTI",403,179141,,38,0,"Str. G-RAL VLADOIANU nr. 7 , Liceul Teoretic ION NECULCE","BUCURESTI SECTORUL 1",1,179141,1,1,1375,767,608,159,752,15,1793,1026,621,131,
42,"MUNICIPIUL BUCURESTI",403,179141,,39,0,"Str. ION NECULCE nr. 2 , Liceul Teoretic ION NECULCE","BUCURESTI SECTORUL 1",1,179141,1,1,1736,856,771,85,838,18,1914,1058,646,192,
42,"MUNICIPIUL BUCURESTI",403,179141,,40,0,"Str. ION NECULCE nr. 2 , Liceul Teoretic ION NECULCE","BUCURESTI SECTORUL 1",1,179141,1,1,1673,850,775,75,820,30,1835,985,654,166,
42,"MUNICIPIUL BUCURESTI",403,179141,,41,0,"Str. ION NECULCE nr. 2 , Liceul Teoretic ION NECULCE","BUCURESTI SECTORUL 1",1,179141,1,1,1511,670,630,40,663,5,1671,1001,471,192,
42,"MUNICIPIUL BUCURESTI",403,179141,,42,0,"Cal. GRIVITEI nr. 343 , Grupul Scolar Centrul de Calificare Cai Ferate","BUCURESTI SECTORUL 1",1,179141,1,1,1467,849,769,80,833,16,1620,771,658,175,
42,"MUNICIPIUL BUCURESTI",403,179141,,43,0,"Cal. GRIVITEI nr. 343 , Grupul Scolar Centrul de Calificare Cai Ferate","BUCURESTI SECTORUL 1",1,179141,1,1,1668,955,880,75,941,14,1827,872,756,185,
42,"MUNICIPIUL BUCURESTI",403,179141,,44,0,"Str. BARBU LAUTARU nr. 2-4 , Scoala nr. 170 GEO BOGZA","BUCURESTI SECTORUL 1",1,179141,1,1,1695,873,832,41,858,15,1871,998,634,224,
42,"MUNICIPIUL BUCURESTI",403,179141,,45,0,"Str. BARBU LAUTARU nr. 2-4 , Scoala nr. 170 GEO BOGZA","BUCURESTI SECTORUL 1",1,179141,1,1,1658,796,744,52,778,18,1924,1128,593,185,
42,"MUNICIPIUL BUCURESTI",403,179141,,46,0,"Str. VASILE GHERGHEL nr. 2 , Scoala nr. 171 PETRE ISPIRESCU","BUCURESTI SECTORUL 1",1,179141,1,1,1540,853,796,57,838,15,1695,842,669,169,
42,"MUNICIPIUL BUCURESTI",403,179141,,47,0,"Str. VASILE GHERGHEL nr. 2 , Scoala nr. 171 PETRE ISPIRESCU","BUCURESTI SECTORUL 1",1,179141,1,1,1567,822,772,50,800,22,1726,904,638,162,
42,"MUNICIPIUL BUCURESTI",403,179141,,48,0,"Str. VASILE GHERGHEL nr. 2 , Scoala nr. 171 PETRE ISPIRESCU","BUCURESTI SECTORUL 1",1,179141,1,1,1669,863,774,89,845,18,1848,985,673,172,
42,"MUNICIPIUL BUCURESTI",403,179141,,49,0,"Str. VASILE GHERGHEL nr. 2 , Scoala nr. 171 PETRE ISPIRESCU","BUCURESTI SECTORUL 1",1,179141,1,1,1748,856,799,57,827,29,1932,1076,628,199,
42,"MUNICIPIUL BUCURESTI",403,179141,,50,0,"B-dul I. MIHALACHE nr. 126 , Liceul Teoretic N. IORGA","BUCURESTI SECTORUL 1",1,179141,1,1,1571,896,811,85,862,34,1729,833,710,152,
42,"MUNICIPIUL BUCURESTI",403,179141,,51,0,"B-dul I. MIHALACHE nr. 126 , Liceul Teoretic N. IORGA","BUCURESTI SECTORUL 1",1,179141,1,1,1778,1081,978,103,1054,27,1960,879,850,204,
42,"MUNICIPIUL BUCURESTI",403,179141,,52,0,"B-dul I. MIHALACHE nr. 126 , Liceul Teoretic N. IORGA","BUCURESTI SECTORUL 1",1,179141,1,1,995,604,560,44,581,23,1099,495,481,100,
42,"MUNICIPIUL BUCURESTI",403,179141,,53,0,"B-dul I. MIHALACHE nr. 126 , Liceul Teoretic N. IORGA","BUCURESTI SECTORUL 1",1,179141,1,1,1321,765,734,31,745,20,1456,691,630,115,
42,"MUNICIPIUL BUCURESTI",403,179141,,54,0,"Str. LAINICI nr. 4 , Scoala nr. 175","BUCURESTI SECTORUL 1",1,179141,1,1,1567,820,774,46,813,7,1718,898,674,139,
42,"MUNICIPIUL BUCURESTI",403,179141,,55,0,"Str. LAINICI nr. 4 , Scoala nr. 175","BUCURESTI SECTORUL 1",1,179141,1,1,1468,787,722,65,780,7,1609,822,640,140,
42,"MUNICIPIUL BUCURESTI",403,179141,,56,0,"Str. ROTH STEPHAN LUDWIG nr. 1 , Liceul Teoretic AUREL VLAICU","BUCURESTI SECTORUL 1",1,179141,1,1,1604,825,762,63,808,17,1793,968,651,157,
42,"MUNICIPIUL BUCURESTI",403,179141,,57,0,"Str. ROTH STEPHAN LUDWIG nr. 1 , Liceul Teoretic AUREL VLAICU","BUCURESTI SECTORUL 1",1,179141,1,1,1741,965,850,115,949,16,1986,1021,756,193,
42,"MUNICIPIUL BUCURESTI",403,179141,,58,0,"Str. BUCEGI nr. 97 , Scoala nr. 180","BUCURESTI SECTORUL 1",1,179141,1,1,1805,949,886,63,923,26,1995,1046,742,181,
42,"MUNICIPIUL BUCURESTI",403,179141,,59,0,"Str. BUCEGI nr. 97 , Scoala nr. 180","BUCURESTI SECTORUL 1",1,179141,1,1,1882,934,839,95,919,15,2076,1142,673,246,
42,"MUNICIPIUL BUCURESTI",403,179141,,60,0,"Cal. GRIVITEI nr. 363 , Grupul Scolar Industrial GRIVITA","BUCURESTI SECTORUL 1",1,179141,1,1,1325,751,669,82,731,20,1463,712,556,175,
42,"MUNICIPIUL BUCURESTI",403,179141,,61,0,"Cal. GRIVITEI nr. 363 , Grupul Scolar Industrial GRIVITA","BUCURESTI SECTORUL 1",1,179141,1,1,1503,819,744,75,804,15,1663,844,615,189,
42,"MUNICIPIUL BUCURESTI",403,179141,,62,0,"Cal. GRIVITEI nr. 363 , Grupul Scolar Industrial GRIVITA","BUCURESTI SECTORUL 1",1,179141,1,1,1520,904,799,105,889,15,1674,770,668,221,
42,"MUNICIPIUL BUCURESTI",403,179141,,63,0,"Str. BUTUCENI nr. 10 , Grupul Scolar Transporturi Cai Ferate","BUCURESTI SECTORUL 1",1,179141,1,1,2103,1054,927,127,1031,23,2319,1265,677,354,
42,"MUNICIPIUL BUCURESTI",403,179141,,64,0,"Str. COPSA MICA nr. 1 , Scoala nr. 162","BUCURESTI SECTORUL 1",1,179141,1,1,1985,995,891,104,980,15,2188,1193,680,300,
42,"MUNICIPIUL BUCURESTI",403,179141,,65,0,"Str. AMINTIRII nr. 26 , Scoala nr. 182","BUCURESTI SECTORUL 1",1,179141,1,1,1820,900,821,79,883,17,1989,1089,593,290,
42,"MUNICIPIUL BUCURESTI",403,179141,,66,0,"Str. AMINTIRII nr. 26 , Scoala nr. 182","BUCURESTI SECTORUL 1",1,179141,1,1,1749,934,827,107,916,18,1920,986,644,272,
42,"MUNICIPIUL BUCURESTI",403,179141,,67,0,"Str. AMINTIRII nr. 26 , Scoala nr. 182","BUCURESTI SECTORUL 1",1,179141,1,1,1716,762,701,61,750,9,1899,1137,543,207,
42,"MUNICIPIUL BUCURESTI",403,179141,,68,0,"Str. DUNEI nr. 1 , Scoala nr. 183","BUCURESTI SECTORUL 1",1,179141,1,1,1951,884,814,70,872,12,2146,1262,589,283,
42,"MUNICIPIUL BUCURESTI",403,179141,,69,0,"Str. DUNEI nr. 1 , Scoala nr. 183","BUCURESTI SECTORUL 1",1,179141,1,1,1909,963,887,76,954,9,2112,1149,613,341,
42,"MUNICIPIUL BUCURESTI",403,179141,,70,0,"Str. DUNEI nr. 1 , Scoala nr. 183","BUCURESTI SECTORUL 1",1,179141,1,1,1819,965,877,88,945,20,2003,1038,717,228,
42,"MUNICIPIUL BUCURESTI",403,179141,,71,0,"Str. DUNEI nr. 1 , Scoala nr. 183","BUCURESTI SECTORUL 1",1,179141,1,1,1745,828,768,60,806,22,1916,1088,581,225,
42,"MUNICIPIUL BUCURESTI",403,179141,,72,0,"Str. DRUMUL SAVARENI nr. 21 , Scoala nr. 153","BUCURESTI SECTORUL 1",1,179141,1,1,820,447,320,127,442,5,905,458,278,164,
42,"MUNICIPIUL BUCURESTI",403,179141,,73,0,"Str. HOTIN nr. 13 , Scoala nr. 184","BUCURESTI SECTORUL 1",1,179141,1,1,1912,785,730,55,775,10,2110,1325,513,262,
42,"MUNICIPIUL BUCURESTI",403,179141,,74,0,"Str. HOTIN nr. 13 , Scoala nr. 184","BUCURESTI SECTORUL 1",1,179141,1,1,1817,856,792,64,843,13,2007,1151,566,277,
42,"MUNICIPIUL BUCURESTI",403,179141,,75,0,"Str. HOTIN nr. 13 , Scoala nr. 184","BUCURESTI SECTORUL 1",1,179141,1,1,1753,811,751,60,802,9,1932,1121,569,233,
42,"MUNICIPIUL BUCURESTI",403,179141,,76,0,"Str. NAZARCEA nr. 30 , Scoala nr. 181","BUCURESTI SECTORUL 1",1,179141,1,1,2089,1137,1049,88,1118,19,2307,1170,717,401,
42,"MUNICIPIUL BUCURESTI",403,179141,,77,0,"Str. NAZARCEA nr. 30 , Scoala nr. 181","BUCURESTI SECTORUL 1",1,179141,1,1,1954,877,804,73,861,16,2158,1281,570,291,
42,"MUNICIPIUL BUCURESTI",403,179141,,78,0,"B-dul PETRILA nr. 10-12 , Scoala nr. 13","BUCURESTI SECTORUL 1",1,179141,1,1,1277,696,567,129,682,14,1523,827,461,221,
42,"MUNICIPIUL BUCURESTI",403,179141,,79,0,"B-dul PETRILA nr. 10-12 , Scoala nr. 13","BUCURESTI SECTORUL 1",1,179141,1,1,1035,560,513,47,550,10,1145,585,340,210,
42,"MUNICIPIUL BUCURESTI",403,179141,,80,0,"Str. ARDEALULUI nr. 34 , Scoala nr. 179","BUCURESTI SECTORUL 1",1,179141,1,1,1241,555,502,53,543,11,1366,811,373,170,
42,"MUNICIPIUL BUCURESTI",403,179141,,81,0,"Str. ARDEALULUI nr. 34 , Scoala nr. 179","BUCURESTI SECTORUL 1",1,179141,1,1,1497,695,592,103,690,5,1740,1045,514,176,
42,"MUNICIPIUL BUCURESTI",403,179141,,82,0,"Str. ARDEALULUI nr. 34 , Scoala nr. 179","BUCURESTI SECTORUL 1",1,179141,1,1,1764,935,868,67,918,17,1945,1010,668,250,
42,"MUNICIPIUL BUCURESTI",403,179141,,83,0,"Str. MUNTENIEI nr. 28 , Scoala nr. 192","BUCURESTI SECTORUL 1",1,179141,1,1,1742,935,847,88,913,22,1922,987,673,240,
42,"MUNICIPIUL BUCURESTI",403,179141,,84,0,"Str. MUNTENIEI nr. 28 , Scoala nr. 192","BUCURESTI SECTORUL 1",1,179141,1,1,1340,771,641,130,762,9,1483,712,627,135,
42,"MUNICIPIUL BUCURESTI",403,179141,,85,0,"Str. PAJUREI nr. 9 , Liceul Teoretic CONSTANTIN BRANCOVEANU","BUCURESTI SECTORUL 1",1,179141,1,1,2127,1082,954,128,1060,22,2348,1266,800,260,
42,"MUNICIPIUL BUCURESTI",403,179141,,86,0,"Str. PAJUREI nr. 9 , Liceul Teoretic CONSTANTIN BRANCOVEANU","BUCURESTI SECTORUL 1",1,179141,1,1,1375,769,692,77,756,13,1518,749,599,157,
42,"MUNICIPIUL BUCURESTI",403,179141,,87,0,"Str. PAJUREI nr. 9 , Liceul Teoretic CONSTANTIN BRANCOVEANU","BUCURESTI SECTORUL 1",1,179141,1,1,1598,972,877,95,953,18,1661,689,759,194,
42,"MUNICIPIUL BUCURESTI",403,179141,,88,0,"Str. DRIDU nr. 2 , Scoala nr. 178","BUCURESTI SECTORUL 1",1,179141,1,1,1591,894,775,119,865,29,1760,866,675,190,
42,"MUNICIPIUL BUCURESTI",403,179141,,89,0,"Str. DRIDU nr. 2 , Scoala nr. 178","BUCURESTI SECTORUL 1",1,179141,1,1,1420,842,784,58,807,35,1565,723,620,187,
42,"MUNICIPIUL BUCURESTI",403,179141,,90,0,"Str. DRIDU nr. 2 , Scoala nr. 178","BUCURESTI SECTORUL 1",1,179141,1,1,1177,680,606,74,651,29,1303,623,529,122,
42,"MUNICIPIUL BUCURESTI",403,179141,,91,0,"Str. DAIMACA VICTOR nr. 2 , Scoala Speciala nr. 8","BUCURESTI SECTORUL 1",1,179141,1,1,1204,650,530,120,634,16,1330,680,418,216,
42,"MUNICIPIUL BUCURESTI",403,179141,,92,0,"Str. DAIMACA VICTOR nr. 2 , Scoala Speciala nr. 8","BUCURESTI SECTORUL 1",1,179141,1,1,1062,538,439,99,527,11,1167,629,376,151,
42,"MUNICIPIUL BUCURESTI",403,179141,,93,0,"Str. CORALILOR nr. 1 , Scoala nr. 177","BUCURESTI SECTORUL 1",1,179141,1,1,1169,602,547,55,596,6,1293,691,421,175,
42,"MUNICIPIUL BUCURESTI",403,179141,,94,0,"Str. CORALILOR nr. 1 , Scoala nr. 177","BUCURESTI SECTORUL 1",1,179141,1,1,1383,762,655,107,744,18,1535,773,544,200,
42,"MUNICIPIUL BUCURESTI",403,179141,,95,0,"B-dul APICULTORILOR nr. 3 , Scoala nr. 6","BUCURESTI SECTORUL 1",1,179141,1,1,1795,862,770,92,849,13,1979,1117,604,245,
42,"MUNICIPIUL BUCURESTI",403,179141,,96,0,"Str. DOBROGEANU GHEREA nr. 74 , Scoala nr. 6","BUCURESTI SECTORUL 1",1,179141,1,1,1577,817,697,120,795,22,1744,927,595,200,
42,"MUNICIPIUL BUCURESTI",403,179141,,97,0,"Str. NEAGOE VODA nr. 11 , Scoala nr. 7","BUCURESTI SECTORUL 1",1,179141,1,1,2301,1329,1136,193,1309,20,2537,1208,1035,274,
42,"MUNICIPIUL BUCURESTI",403,179141,,98,0,"Str. NEAGOE VODA nr. 11 , Scoala nr. 7","BUCURESTI SECTORUL 1",1,179141,1,1,2104,1138,1089,49,1118,20,2316,1178,842,276,
42,"MUNICIPIUL BUCURESTI",403,179141,,99,0,"B-dul FICUSULUI nr. 18 , Liceul Apicol V. HARNAJ","BUCURESTI SECTORUL 1",1,179141,1,1,1759,926,866,60,910,16,1937,1011,702,208,
42,"MUNICIPIUL BUCURESTI",403,179141,,100,0,"B-dul FICUSULUI nr. 18 , Liceul Apicol V. HARNAJ","BUCURESTI SECTORUL 1",1,179141,1,1,786,571,351,220,553,18,865,294,393,160,
42,"MUNICIPIUL BUCURESTI",403,179141,,101,0,"Str. CARAMFIL NICOLAE nr. 24 , Scoala nr. 12","BUCURESTI SECTORUL 1",1,179141,1,1,2101,952,881,71,926,26,2270,1318,708,218,
42,"MUNICIPIUL BUCURESTI",403,179141,,102,0,"Str. CARAMFIL NICOLAE nr. 24 , Scoala nr. 12","BUCURESTI SECTORUL 1",1,179141,1,1,1911,969,904,65,946,23,2087,1118,714,232,
42,"MUNICIPIUL BUCURESTI",403,179141,,103,0,"Str. CARAMFIL NICOLAE nr. 24 , Scoala nr. 12","BUCURESTI SECTORUL 1",1,179141,1,1,1639,855,771,84,845,9,1802,947,636,209,
42,"MUNICIPIUL BUCURESTI",403,179141,,104,0,"Str. CARAMFIL NICOLAE nr. 24 , Scoala nr. 12","BUCURESTI SECTORUL 1",1,179141,1,1,2151,986,938,48,970,16,2373,1387,692,278,
42,"MUNICIPIUL BUCURESTI",403,179141,,105,0,"Str. BORSA nr. 27 , Scoala nr. 12","BUCURESTI SECTORUL 1",1,179141,1,1,2057,1026,972,54,1009,17,2261,1235,724,285,
42,"MUNICIPIUL BUCURESTI",403,179141,,106,0,"Str. BORSA nr. 27 , Scoala nr. 12","BUCURESTI SECTORUL 1",1,179141,1,1,2256,1076,985,91,1062,14,2255,1179,751,311,
42,"MUNICIPIUL BUCURESTI",403,179141,,107,0,"Str. BORSA nr. 27 , Scoala nr. 12","BUCURESTI SECTORUL 1",1,179141,1,1,2203,1187,1065,122,1173,14,2432,1245,890,283,
42,"MUNICIPIUL BUCURESTI",403,179141,,108,0,"B-dul MARASTI nr. 59 , Institutul Agronomic NICOLAE BALCESCU","BUCURESTI SECTORUL 1",1,179141,1,1,1457,719,624,95,697,22,1605,886,543,154,
42,"MUNICIPIUL BUCURESTI",403,179141,,109,0,"B-dul MARASTI nr. 59 , Institutul Agronomic NICOLAE BALCESCU","BUCURESTI SECTORUL 1",1,179141,1,1,1815,972,908,64,951,21,2000,1028,802,149,
42,"MUNICIPIUL BUCURESTI",403,179141,,110,0,"B-dul AVERESCU nr. 8 - 10 , Institutul de Cercetari in Informati","BUCURESTI SECTORUL 1",1,179141,1,1,1382,920,832,88,885,35,1533,613,763,122,
42,"MUNICIPIUL BUCURESTI",403,179141,,111,0,"Str. AL. PETOFI nr. 16 , Scoala nr. 17","BUCURESTI SECTORUL 1",1,179141,1,1,1404,816,765,51,791,25,1548,732,638,153,
42,"MUNICIPIUL BUCURESTI",403,179141,,112,0,"Str. AL. PETOFI nr. 16 , Scoala nr. 17","BUCURESTI SECTORUL 1",1,179141,1,1,1517,880,796,84,852,28,1673,793,717,135,
42,"MUNICIPIUL BUCURESTI",403,179141,,113,0,"Str. ARH. ION MINCU nr. 10 , Colegiul National de Informatica T. VIANU","BUCURESTI SECTORUL 1",1,179141,1,1,1475,992,833,159,951,41,1628,636,782,169,
42,"MUNICIPIUL BUCURESTI",403,179141,,114,0,"Str. ARH. ION MINCU nr. 10 , Colegiul National de Informatica T. VIANU","BUCURESTI SECTORUL 1",1,179141,1,1,1768,1029,968,61,993,36,1945,916,853,140,
42,"MUNICIPIUL BUCURESTI",403,179141,,115,0,"Str. ARH. ION MINCU nr. 10 , Colegiul National de Informatica T. VIANU","BUCURESTI SECTORUL 1",1,179141,1,1,1402,855,705,150,833,22,1611,756,669,164,
42,"MUNICIPIUL BUCURESTI",403,179141,,116,0,"Cal. DOROBANTILOR nr. 163 , Colegiul National I.L. CARAGIALE","BUCURESTI SECTORUL 1",1,179141,1,1,1691,957,855,102,925,32,1866,909,796,129,
42,"MUNICIPIUL BUCURESTI",403,179141,,117,0,"Cal. DOROBANTILOR nr. 163 , Colegiul National I.L. CARAGIALE","BUCURESTI SECTORUL 1",1,179141,1,1,1449,898,804,94,878,20,1595,697,727,151,
42,"MUNICIPIUL BUCURESTI",403,179141,,118,0,"Cal. DOROBANTILOR nr. 163 , Scoala nr. 45","BUCURESTI SECTORUL 1",1,179141,1,1,1720,1109,894,215,1071,38,2341,1232,930,141,
42,"MUNICIPIUL BUCURESTI",403,179141,,119,0,"Cal. DOROBANTILOR nr. 163 , Scoala nr. 45","BUCURESTI SECTORUL 1",1,179141,1,1,1817,1011,929,82,971,40,1997,986,817,154,
42,"MUNICIPIUL BUCURESTI",403,179141,,120,0,"Str. JEAN MONNET nr. 2 , Liceul Teoretic JEAN MONNET","BUCURESTI SECTORUL 1",1,179141,1,1,1835,1180,1024,156,1137,26,2020,840,966,171,
42,"MUNICIPIUL BUCURESTI",403,179141,,121,0,"Str. JEAN MONNET nr. 2 , Liceul Teoretic JEAN MONNET","BUCURESTI SECTORUL 1",1,179141,1,1,1792,1116,992,124,1045,39,1977,861,908,137,
42,"MUNICIPIUL BUCURESTI",403,179141,,122,0,"Str. SCOALA FLOREASCA nr. 5 , Scoala nr. 15 A. VLAHUTA","BUCURESTI SECTORUL 1",1,179141,1,1,1505,1136,730,406,1113,23,2482,1346,896,217,
42,"MUNICIPIUL BUCURESTI",403,179141,,123,0,"Str. SCOALA FLOREASCA nr. 5 , Scoala nr. 15 A. VLAHUTA","BUCURESTI SECTORUL 1",1,179141,1,1,1580,843,777,66,819,24,1746,903,666,153,
42,"MUNICIPIUL BUCURESTI",403,179141,,124,0,"Str. SCOALA FLOREASCA nr. 5 , Scoala nr. 15 A. VLAHUTA","BUCURESTI SECTORUL 1",1,179141,1,1,1637,874,825,49,850,24,1805,931,716,134,
42,"MUNICIPIUL BUCURESTI",403,179141,,125,0,"B-dul IANCU DE HUNEDOARA nr. 27 , Liceul de Arte Plastice N. TONITZA","BUCURESTI SECTORUL 1",1,179141,1,1,1689,900,844,56,871,29,1857,957,735,136,
42,"MUNICIPIUL BUCURESTI",403,179141,,126,0,"B-dul IANCU DE HUNEDOARA nr. 27 , Liceul de Arte Plastice N. TONITZA","BUCURESTI SECTORUL 1",1,179141,1,1,1674,905,850,55,883,22,1847,942,748,135,
42,"MUNICIPIUL BUCURESTI",403,179141,,127,0,"B-dul IANCU DE HUNEDOARA nr. 27 , Liceul de Arte Plastice N. TONITZA","BUCURESTI SECTORUL 1",1,179141,1,1,1894,1066,980,86,1045,21,2084,1018,864,181,
42,"MUNICIPIUL BUCURESTI",403,179141,,128,0,"Str. STANISLAV CIHOSCHI nr. 15 , Scoala nr. 186 E. VACARESCU","BUCURESTI SECTORUL 1",1,179141,1,1,1755,860,803,57,834,26,1940,1080,699,135,
42,"MUNICIPIUL BUCURESTI",403,179141,,129,0,"Str. STANISLAV CIHOSCHI nr. 17 , Liceul Teoretic HERMAN OBERTH","BUCURESTI SECTORUL 1",1,179141,1,1,1697,916,833,83,881,34,1866,950,720,161,
42,"MUNICIPIUL BUCURESTI",403,179141,,130,0,"Str. STANISLAV CIHOSCHI nr. 17 , Liceul Teoretic HERMAN OBERTH","BUCURESTI SECTORUL 1",1,179141,1,1,1024,481,439,42,459,22,1130,649,377,82,
42,"MUNICIPIUL BUCURESTI",403,179141,,131,0,"Str. STANISLAV CIHOSCHI nr. 17 , Liceul Teoretic HERMAN OBERTH","BUCURESTI SECTORUL 1",1,179141,1,1,1010,482,444,38,472,10,1113,631,362,110,
42,"MUNICIPIUL BUCURESTI",403,179150,,132,0,"Str. TUDOR ARGHEZI nr. 46-50 , Scoala nr. 19","BUCURESTI SECTORUL 2",2,179150,1,1,1640,870,772,98,832,38,2000,1130,685,147,
42,"MUNICIPIUL BUCURESTI",403,179150,,133,0,"Str. TUDOR ARGHEZI nr. 46-50 , Scoala nr. 19","BUCURESTI SECTORUL 2",2,179150,1,1,1527,792,695,97,766,26,2000,1208,642,124,
42,"MUNICIPIUL BUCURESTI",403,179150,,134,0,"Str. ITALIANA nr. 17 , Liceul Teoretic SPIRU HARET","BUCURESTI SECTORUL 2",2,179150,1,1,1740,984,794,190,958,26,2200,1216,780,178,
42,"MUNICIPIUL BUCURESTI",403,179150,,135,0,"Str. ITALIANA nr. 17 , Liceul Teoretic SPIRU HARET","BUCURESTI SECTORUL 2",2,179150,1,1,1659,808,753,55,783,25,2000,1192,626,157,
42,"MUNICIPIUL BUCURESTI",403,179150,,136,0,"Str. VIITORULUI nr. 60 , Colegiul National CANTEMIR VODA","BUCURESTI SECTORUL 2",2,179150,1,1,1419,729,613,116,710,19,2000,1271,588,122,
42,"MUNICIPIUL BUCURESTI",403,179150,,137,0,"Str. VIITORULUI nr. 60 , Colegiul National CANTEMIR VODA","BUCURESTI SECTORUL 2",2,179150,1,1,1667,901,775,126,861,40,2000,1099,726,135,
42,"MUNICIPIUL BUCURESTI",403,179150,,138,0,"Str. VIITORULUI nr. 60 , Colegiul National CANTEMIR VODA","BUCURESTI SECTORUL 2",2,179150,1,1,1605,798,704,94,774,24,2000,1202,609,165,
42,"MUNICIPIUL BUCURESTI",403,179150,,139,0,"Str. VIITORULUI nr. 60 , Colegiul National CANTEMIR VODA","BUCURESTI SECTORUL 2",2,179150,1,1,1883,889,804,85,868,21,2200,1311,679,189,
42,"MUNICIPIUL BUCURESTI",403,179150,,140,0,"Str. TUNARI nr. 52 , Scoala nr. 24","BUCURESTI SECTORUL 2",2,179150,1,1,2068,1023,924,99,1000,23,2401,1378,802,198,
42,"MUNICIPIUL BUCURESTI",403,179150,,141,0,"Str. TUNARI nr. 52 , Scoala nr. 24","BUCURESTI SECTORUL 2",2,179150,1,1,1934,1047,899,148,1028,19,2200,1153,786,242,
42,"MUNICIPIUL BUCURESTI",403,179150,,142,0,"Al. CIRCULUI nr. 1 , Scoala nr. 28","BUCURESTI SECTORUL 2",2,179150,1,1,1858,925,889,36,903,22,2200,1275,723,180,
42,"MUNICIPIUL BUCURESTI",403,179150,,143,0,"Al. CIRCULUI nr. 1 , Scoala nr. 28","BUCURESTI SECTORUL 2",2,179150,1,1,1333,683,643,40,657,26,2000,1317,527,130,
42,"MUNICIPIUL BUCURESTI",403,179150,,144,0,"Al. CIRCULUI nr. 1 , Scoala nr. 28","BUCURESTI SECTORUL 2",2,179150,1,1,1839,1125,1002,123,1094,31,2200,1075,916,178,
42,"MUNICIPIUL BUCURESTI",403,179150,,145,0,"Str. BUSOLEI nr. 6 , Scoala pentru Hipoacuzici","BUCURESTI SECTORUL 2",2,179150,1,1,1467,685,618,67,664,21,2000,1315,518,146,
42,"MUNICIPIUL BUCURESTI",403,179150,,146,0,"Str. BUSOLEI nr. 6 , Scoala pentru Hipoacuzici","BUCURESTI SECTORUL 2",2,179150,1,1,1591,751,692,59,735,16,2000,1249,567,168,
42,"MUNICIPIUL BUCURESTI",403,179150,,147,0,"Str. COBILITEI nr. 8 , Scoala nr. 26","BUCURESTI SECTORUL 2",2,179150,1,1,1256,537,476,61,527,10,1800,1263,418,109,
42,"MUNICIPIUL BUCURESTI",403,179150,,148,0,"Str. COBILITEI nr. 8 , Scoala nr. 26","BUCURESTI SECTORUL 2",2,179150,1,1,1562,768,722,46,754,14,2000,1232,573,181,
42,"MUNICIPIUL BUCURESTI",403,179150,,149,0,"Str. MARCEL IANCU nr. 7 , Scoala Profesionala Spec. nr. 3","BUCURESTI SECTORUL 2",2,179150,1,1,1670,811,712,99,794,17,2001,1190,587,207,
42,"MUNICIPIUL BUCURESTI",403,179150,,150,0,"Str. MARCEL IANCU nr. 7 , Scoala Profesionala Spec. nr. 3","BUCURESTI SECTORUL 2",2,179150,1,1,1008,647,590,57,637,10,2000,1353,490,147,
42,"MUNICIPIUL BUCURESTI",403,179150,,151,0,"Str. LUNCSOARA nr. 17 , Scoala nr. 307","BUCURESTI SECTORUL 2",2,179150,1,1,1287,800,637,163,781,19,1800,1000,604,177,
42,"MUNICIPIUL BUCURESTI",403,179150,,152,0,"Str. LUNCSOARA nr. 17 , Scoala nr. 307","BUCURESTI SECTORUL 2",2,179150,1,1,1365,711,627,84,678,33,1800,1089,541,137,
42,"MUNICIPIUL BUCURESTI",403,179150,,153,0,"Str. LUNCSOARA nr. 17 , Scoala nr. 307","BUCURESTI SECTORUL 2",2,179150,1,1,1640,885,817,68,873,12,2000,1115,644,229,
42,"MUNICIPIUL BUCURESTI",403,179150,,154,0,"Cal. MOSILOR nr. 148 , Scoala nr. 71 IOVAN DUCICI","BUCURESTI SECTORUL 2",2,179150,1,1,2142,1021,879,142,991,30,2400,1379,790,201,
42,"MUNICIPIUL BUCURESTI",403,179150,,155,0,"Cal. MOSILOR nr. 148 , Scoala nr. 71 IOVAN DUCICI","BUCURESTI SECTORUL 2",2,179150,1,1,1912,902,818,84,877,25,2400,1498,721,156,
42,"MUNICIPIUL BUCURESTI",403,179150,,156,0,"Str. TRAIAN nr. 165 , Grup Scolar Ec.- Adm. A.D. XENOPOL","BUCURESTI SECTORUL 2",2,179150,1,1,1692,887,793,94,853,34,2000,1113,684,169,
42,"MUNICIPIUL BUCURESTI",403,179150,,157,0,"Str. TRAIAN nr. 165 , Grup Scolar Ec.- Adm. A.D. XENOPOL","BUCURESTI SECTORUL 2",2,179150,1,1,1399,684,601,83,661,23,1800,1116,536,125,
42,"MUNICIPIUL BUCURESTI",403,179150,,158,0,"Str. TRAIAN nr. 165 , Grup Scolar Ec. -Adm. A.D. XENOPOL","BUCURESTI SECTORUL 2",2,179150,1,1,1517,794,718,76,769,25,1800,1006,597,172,
42,"MUNICIPIUL BUCURESTI",403,179150,,159,0,"Str. TRAIAN nr. 165 , Grup Scolar Ec.- adm. A.D. XENOPOL","BUCURESTI SECTORUL 2",2,179150,1,1,1552,691,623,68,670,21,1800,1109,515,155,
42,"MUNICIPIUL BUCURESTI",403,179150,,160,0,"Str. OLARI nr. 29 , Liceul Bilingv GEORGE COSBUC","BUCURESTI SECTORUL 2",2,179150,1,1,1787,988,899,89,960,28,2000,1012,746,214,
42,"MUNICIPIUL BUCURESTI",403,179150,,161,0,"Str. OLARI nr. 29 , Liceul Bilingv GEORGE COSBUC","BUCURESTI SECTORUL 2",2,179150,1,1,1987,1030,931,99,1006,24,2200,1170,799,207,
42,"MUNICIPIUL BUCURESTI",403,179150,,162,0,"Str. GARIBALDI GIUSEPPE nr. 3 , Scoala nr. 10","BUCURESTI SECTORUL 2",2,179150,1,1,1742,928,850,78,911,17,2200,1272,740,171,
42,"MUNICIPIUL BUCURESTI",403,179150,,163,0,"Str. GARIBALDI GIUSEPPE nr. 3 , Scoala nr. 10","BUCURESTI SECTORUL 2",2,179150,1,1,1229,745,657,88,715,30,1600,855,592,123,
42,"MUNICIPIUL BUCURESTI",403,179150,,164,0,"Str. GARIBALDI GIUSEPPE nr. 3 , Scoala nr. 10","BUCURESTI SECTORUL 2",2,179150,1,1,1213,616,548,68,593,23,1600,984,508,85,
42,"MUNICIPIUL BUCURESTI",403,179150,,165,0,"Str. GARIBALDI GIUSEPPE nr. 11 , Liceul Teoretic C.A.ROSETTI","BUCURESTI SECTORUL 2",2,179150,1,1,1338,783,673,110,764,19,1600,817,635,129,
42,"MUNICIPIUL BUCURESTI",403,179150,,166,0,"Str. GARIBALDI GIUSEPPE nr. 11 , Liceul Teoretic C.A.ROSETTI","BUCURESTI SECTORUL 2",2,179150,1,1,1447,812,702,110,795,17,1800,988,629,166,
42,"MUNICIPIUL BUCURESTI",403,179150,,167,0,"Str. GARIBALDI GIUSEPPE nr. 11 , Liceul Teoretic C.A.ROSETTI","BUCURESTI SECTORUL 2",2,179150,1,1,1626,941,858,83,901,40,2000,1059,717,184,
42,"MUNICIPIUL BUCURESTI",403,179150,,168,0,"Str. GALVANI LUIGI nr. 20 , Grup Scolar Ind. TRAIAN","BUCURESTI SECTORUL 2",2,179150,1,1,1879,982,887,95,960,22,2200,1218,777,183,
42,"MUNICIPIUL BUCURESTI",403,179150,,169,0,"Str. GALVANI LUIGI nr. 20 , Grup Scolar Ind. TRAIAN","BUCURESTI SECTORUL 2",2,179150,1,1,1897,912,825,87,900,12,2200,1288,603,297,
42,"MUNICIPIUL BUCURESTI",403,179150,,170,0,"Str. GALVANI LUIGI nr. 20 , Grup Scolar Ind. TRAIAN","BUCURESTI SECTORUL 2",2,179150,1,1,1808,817,750,67,802,15,2200,1383,572,230,
42,"MUNICIPIUL BUCURESTI",403,179150,,171,0,"Str. GALVANI LUIGI nr. 20 , Grup Scolar Ind. TRAIAN","BUCURESTI SECTORUL 2",2,179150,1,1,1892,1028,976,52,993,35,2200,1172,757,236,
42,"MUNICIPIUL BUCURESTI",403,179150,,172,0,"B-dul LACUL TEI nr. 116 , Scoala nr. 31","BUCURESTI SECTORUL 2",2,179150,1,1,1702,930,836,94,917,13,2000,1070,634,283,
42,"MUNICIPIUL BUCURESTI",403,179150,,173,0,"B-dul LACUL TEI nr. 116 , Scoala nr. 31","BUCURESTI SECTORUL 2",2,179150,1,1,1927,954,820,134,948,6,2400,1446,723,225,
42,"MUNICIPIUL BUCURESTI",403,179150,,174,0,"B-dul LACUL TEI nr. 116 , Scoala nr. 31","BUCURESTI SECTORUL 2",2,179150,1,1,1830,961,879,82,944,17,2200,1239,583,361,
42,"MUNICIPIUL BUCURESTI",403,179150,,175,0,"B-dul LACUL TEI nr. 116 , Scoala nr. 31","BUCURESTI SECTORUL 2",2,179150,1,1,1898,1018,846,172,991,27,2199,1181,754,237,
42,"MUNICIPIUL BUCURESTI",403,179150,,176,0,"B-dul LACUL TEI nr. 116 , Scoala nr. 31","BUCURESTI SECTORUL 2",2,179150,1,1,1679,786,738,48,778,8,2000,1214,609,169,
42,"MUNICIPIUL BUCURESTI",403,179150,,177,0,"B-dul LACUL TEI nr. 124 , Univ. Tehnica de Constructii Buc.","BUCURESTI SECTORUL 2",2,179150,1,1,2045,1205,1109,96,1181,24,2400,1195,920,261,
42,"MUNICIPIUL BUCURESTI",403,179150,,178,0,"B-dul LACUL TEI nr. 124 , Univ. Tehnica de Constructii Buc.","BUCURESTI SECTORUL 2",2,179150,1,1,1961,903,823,80,889,14,2000,1097,620,269,
42,"MUNICIPIUL BUCURESTI",403,179150,,179,0,"B-dul LACUL TEI nr. 124 , Univ. Tehnica de Constructii Buc.","BUCURESTI SECTORUL 2",2,179150,1,1,1994,921,789,132,903,18,2200,1279,670,233,
42,"MUNICIPIUL BUCURESTI",403,179150,,180,0,"B-dul LACUL TEI nr. 124 , Univ. Tehnica de Constructii Buc.","BUCURESTI SECTORUL 2",2,179150,1,1,1735,716,674,42,703,13,2000,1284,495,208,
42,"MUNICIPIUL BUCURESTI",403,179150,,181,0,"B-dul LACUL TEI nr. 124 , Univ. Tehnica de Constructii Buc.","BUCURESTI SECTORUL 2",2,179150,1,1,1848,912,822,90,895,17,2199,1287,675,220,
42,"MUNICIPIUL BUCURESTI",403,179150,,182,0,"B-dul LACUL TEI nr. 124 , Univ. Tehnica de Constructii Buc.","BUCURESTI SECTORUL 2",2,179150,1,1,2047,994,940,54,974,20,2400,1406,732,242,
42,"MUNICIPIUL BUCURESTI",403,179150,,183,0,"B-dul LACUL TEI nr. 124 , Univ. Tehnica de Constructii Buc.","BUCURESTI SECTORUL 2",2,179150,1,1,1968,934,834,100,913,21,2200,1266,707,206,
42,"MUNICIPIUL BUCURESTI",403,179150,,184,0,"B-dul LACUL TEI nr. 124 , Univ. Tehnica de Constructii Buc.","BUCURESTI SECTORUL 2",2,179150,1,1,1864,751,673,78,737,14,2200,1449,505,232,
42,"MUNICIPIUL BUCURESTI",403,179150,,185,0,"B-dul LACUL TEI nr. 124 , Univ. Tehnica de Constructii Buc.","BUCURESTI SECTORUL 2",2,179150,1,1,1653,839,656,183,813,26,2000,1161,643,170,
42,"MUNICIPIUL BUCURESTI",403,179150,,186,0,"Str. LAPTARI TEI nr. 5 - 7 , Scoala nr. 30","BUCURESTI SECTORUL 2",2,179150,1,1,1530,1042,954,88,1022,20,2400,1358,808,214,
42,"MUNICIPIUL BUCURESTI",403,179150,,187,0,"Str. LAPTARI TEI nr. 5 - 7 , Scoala nr. 30","BUCURESTI SECTORUL 2",2,179150,1,1,1719,843,768,75,828,15,2000,1157,635,193,
42,"MUNICIPIUL BUCURESTI",403,179150,,188,0,"Str. LAPTARI TEI nr. 5 - 7 , Scoala nr. 30","BUCURESTI SECTORUL 2",2,179150,1,1,1785,865,785,80,848,17,2000,1135,611,237,
42,"MUNICIPIUL BUCURESTI",403,179150,,189,0,"Str. LAPTARI TEI nr. 5 - 7 , Scoala nr. 30","BUCURESTI SECTORUL 2",2,179150,1,1,2016,930,883,47,910,20,2400,1470,662,248,
42,"MUNICIPIUL BUCURESTI",403,179150,,190,0,"Str. LAPTARI TEI nr. 5 - 7 , Scoala nr. 30","BUCURESTI SECTORUL 2",2,179150,1,1,1893,992,966,26,974,18,2200,1208,738,236,
42,"MUNICIPIUL BUCURESTI",403,179150,,191,0,"Str. LAPTARI TEI nr. 5 - 7 , Scoala nr. 30","BUCURESTI SECTORUL 2",2,179150,1,1,1571,773,706,67,764,9,2000,1227,574,190,
42,"MUNICIPIUL BUCURESTI",403,179150,,192,0,"Str. LAPTARI TEI nr. 5 - 7 , Scoala nr. 30","BUCURESTI SECTORUL 2",2,179150,1,1,1813,827,762,65,806,21,2200,1373,595,211,
42,"MUNICIPIUL BUCURESTI",403,179150,,193,0,"Str. PETRE ANTONESCU nr. 20 , Gradinita nr. 233","BUCURESTI SECTORUL 2",2,179150,1,1,1654,917,871,46,888,29,2000,1083,719,169,
42,"MUNICIPIUL BUCURESTI",403,179150,,194,0,"Str. PETRE ANTONESCU nr. 20 , Gradinita nr. 233","BUCURESTI SECTORUL 2",2,179150,1,1,1490,840,774,66,813,27,2000,1160,641,172,
42,"MUNICIPIUL BUCURESTI",403,179150,,195,0,"B-dul POMPEI DIMITRIE PROFESOR Grup Sc. Ind. Lemn. C-TIN BRANCUSI","BUCURESTI SECTORUL 2",2,179150,1,1,612,559,228,331,556,3,1000,441,303,253,
42,"MUNICIPIUL BUCURESTI",403,179150,,196,0,"Sos. COLENTINA nr. 91 , Scoala nr. 39","BUCURESTI SECTORUL 2",2,179150,1,1,1776,937,823,114,922,15,2000,1063,671,251,
42,"MUNICIPIUL BUCURESTI",403,179150,,197,0,"Sos. COLENTINA nr. 91 , Scoala nr. 39","BUCURESTI SECTORUL 2",2,179150,1,1,1679,878,794,84,860,18,2000,1122,645,215,
42,"MUNICIPIUL BUCURESTI",403,179150,,198,0,"Sos. COLENTINA nr. 91 , Scoala nr. 39","BUCURESTI SECTORUL 2",2,179150,1,1,1730,701,668,33,692,9,2000,1299,474,218,
42,"MUNICIPIUL BUCURESTI",403,179150,,199,0,"Sos. COLENTINA nr. 91 , Scoala nr. 39","BUCURESTI SECTORUL 2",2,179150,1,1,1663,714,660,54,695,19,2000,1286,480,215,
42,"MUNICIPIUL BUCURESTI",403,179150,,200,0,"Sos. COLENTINA nr. 91 , Scoala nr. 39","BUCURESTI SECTORUL 2",2,179150,1,1,1824,898,849,49,879,19,2200,1302,638,241,
42,"MUNICIPIUL BUCURESTI",403,179150,,201,0,"Sos. COLENTINA nr. 91 , Scoala nr. 39","BUCURESTI SECTORUL 2",2,179150,1,1,1462,676,640,36,655,21,2000,1324,473,182,
42,"MUNICIPIUL BUCURESTI",403,179150,,202,0,"Sos. COLENTINA nr. 91 , Scoala nr. 39","BUCURESTI SECTORUL 2",2,179150,1,1,1671,831,775,56,807,24,2000,1169,621,186,
42,"MUNICIPIUL BUCURESTI",403,179150,,203,0,"Str. PERIS nr. 27 , Scoala nr. 40","BUCURESTI SECTORUL 2",2,179150,1,1,1723,792,731,61,785,7,2200,1408,540,245,
42,"MUNICIPIUL BUCURESTI",403,179150,,204,0,"Str. PERIS nr. 27 , Scoala nr. 40","BUCURESTI SECTORUL 2",2,179150,1,1,1714,765,697,68,754,11,2000,1235,509,245,
42,"MUNICIPIUL BUCURESTI",403,179150,,205,0,"Str. PERIS nr. 27 , Scoala nr. 40","BUCURESTI SECTORUL 2",2,179150,1,1,1750,811,750,61,808,3,2000,1189,538,270,
42,"MUNICIPIUL BUCURESTI",403,179150,,206,0,"Str. PERIS nr. 27 , Scoala nr. 40","BUCURESTI SECTORUL 2",2,179150,1,1,1555,729,666,63,716,13,2000,1271,483,233,
42,"MUNICIPIUL BUCURESTI",403,179150,,207,0,"Str. PERIS nr. 27 , Scoala nr. 40","BUCURESTI SECTORUL 2",2,179150,1,1,1622,705,649,56,694,11,2000,1295,490,204,
42,"MUNICIPIUL BUCURESTI",403,179150,,208,0,"Str. NICOLAE APOSTOL nr. 2 , Scoala nr. 41","BUCURESTI SECTORUL 2",2,179150,1,1,1303,619,530,89,611,8,1800,1181,433,178,
42,"MUNICIPIUL BUCURESTI",403,179150,,209,0,"Str. NICOLAE APOSTOL nr. 2 , Scoala nr. 41","BUCURESTI SECTORUL 2",2,179150,1,1,1537,748,673,75,738,10,2000,1252,490,248,
42,"MUNICIPIUL BUCURESTI",403,179150,,210,0,"Str. NICOLAE APOSTOL nr. 2 , Scoala nr. 41","BUCURESTI SECTORUL 2",2,179150,1,1,1626,767,713,54,753,14,2000,1233,513,240,
42,"MUNICIPIUL BUCURESTI",403,179150,,211,0,"Str. SPORTULUI nr. 21 , Scoala nr. 32","BUCURESTI SECTORUL 2",2,179150,1,1,1791,863,792,71,849,14,2000,1137,590,259,
42,"MUNICIPIUL BUCURESTI",403,179150,,212,0,"Str. SPORTULUI nr. 21 , Scoala nr. 32","BUCURESTI SECTORUL 2",2,179150,1,1,1665,795,746,49,782,13,2000,1205,582,200,
42,"MUNICIPIUL BUCURESTI",403,179150,,213,0,"Str. SPORTULUI nr. 21 , Scoala nr. 32","BUCURESTI SECTORUL 2",2,179150,1,1,1614,743,677,66,732,11,2000,1257,555,177,
42,"MUNICIPIUL BUCURESTI",403,179150,,214,0,"Str. SPORTULUI nr. 21 , Scoala nr. 32","BUCURESTI SECTORUL 2",2,179150,1,1,1840,855,768,87,846,9,2250,1395,610,236,
42,"MUNICIPIUL BUCURESTI",403,179150,,215,0,"Sos. FUNDENI nr. 254 , Liceul Teoretic VICTOR BABES","BUCURESTI SECTORUL 2",2,179150,1,1,1942,700,620,80,688,12,2199,1499,485,203,
42,"MUNICIPIUL BUCURESTI",403,179150,,216,0,"Sos. FUNDENI nr. 254 , Liceul Teoretic VICTOR BABES","BUCURESTI SECTORUL 2",2,179150,1,1,2261,910,817,93,901,9,2600,1690,646,255,
42,"MUNICIPIUL BUCURESTI",403,179150,,217,0,"Sos. FUNDENI nr. 254 , Liceul Teoretic VICTOR BABES","BUCURESTI SECTORUL 2",2,179150,1,1,2147,811,758,53,805,6,2400,1589,537,268,
42,"MUNICIPIUL BUCURESTI",403,179150,,218,0,"Al. SINAIA nr. 2 , Gradinita nr. 11","BUCURESTI SECTORUL 2",2,179150,1,1,1697,807,727,80,800,7,2000,1193,588,212,
42,"MUNICIPIUL BUCURESTI",403,179150,,219,0,"Al. SINAIA nr. 2 , Gradinita nr. 11","BUCURESTI SECTORUL 2",2,179150,1,1,1887,862,752,110,847,15,2200,1338,635,212,
42,"MUNICIPIUL BUCURESTI",403,179150,,220,0,"Str. SILVIA nr. 54 , Scoala nr. 25","BUCURESTI SECTORUL 2",2,179150,1,1,1394,701,587,114,685,16,1800,1099,521,164,
42,"MUNICIPIUL BUCURESTI",403,179150,,221,0,"Str. SILVIA nr. 54 , Scoala nr. 25","BUCURESTI SECTORUL 2",2,179150,1,1,1836,837,776,61,825,12,2000,1163,628,197,
42,"MUNICIPIUL BUCURESTI",403,179150,,222,0,"Str. SILVIA nr. 54 , Scoala nr. 25","BUCURESTI SECTORUL 2",2,179150,1,1,1659,807,729,78,795,12,2000,1193,610,185,
42,"MUNICIPIUL BUCURESTI",403,179150,,223,0,"Str. HELIADE INTRE VII nr. 36 , Scoala nr. 145","BUCURESTI SECTORUL 2",2,179150,1,1,1553,667,561,106,653,14,1800,1133,441,212,
42,"MUNICIPIUL BUCURESTI",403,179150,,224,0,"Str. HELIADE INTRE VII nr. 36 , Scoala nr. 145","BUCURESTI SECTORUL 2",2,179150,1,1,2138,881,800,81,857,24,2400,1519,556,301,
42,"MUNICIPIUL BUCURESTI",403,179150,,225,0,"Str. HELIADE INTRE VII nr. 36 , Scoala nr. 145","BUCURESTI SECTORUL 2",2,179150,1,1,1961,860,821,39,853,7,2200,1340,602,251,
42,"MUNICIPIUL BUCURESTI",403,179150,,226,0,"Str. HELIADE INTRE VII nr. 36 , Scoala nr. 145","BUCURESTI SECTORUL 2",2,179150,1,1,2252,982,905,77,956,13,2600,1618,677,279,
42,"MUNICIPIUL BUCURESTI",403,179150,,227,0,"Str. HELIADE INTRE VII nr. 36 , Scoala nr. 145","BUCURESTI SECTORUL 2",2,179150,1,1,1923,840,737,103,823,10,2200,1360,521,302,
42,"MUNICIPIUL BUCURESTI",403,179150,,228,0,"Str. HELIADE INTRE VII nr. 36 , Scoala nr. 145","BUCURESTI SECTORUL 2",2,179150,1,1,1722,701,637,64,690,11,2000,1299,491,199,
42,"MUNICIPIUL BUCURESTI",403,179150,,229,0,"Sos. COLENTINA nr. 16 , S.C. SUVEICA S.A.","BUCURESTI SECTORUL 2",2,179150,1,1,1783,1055,965,90,1035,20,2000,945,824,211,
42,"MUNICIPIUL BUCURESTI",403,179150,,230,0,"B-dul GARII OBOR nr. 8 , Scoala nr. 64","BUCURESTI SECTORUL 2",2,179150,1,1,1694,905,818,87,889,16,2000,1095,701,188,
42,"MUNICIPIUL BUCURESTI",403,179150,,231,0,"B-dul GARII OBOR nr. 8 , Scoala nr. 64","BUCURESTI SECTORUL 2",2,179150,1,1,1802,854,806,48,834,20,2000,1146,635,199,
42,"MUNICIPIUL BUCURESTI",403,179150,,232,0,"B-dul GARII OBOR nr. 8 , Scoala nr. 64","BUCURESTI SECTORUL 2",2,179150,1,1,1251,635,607,28,628,7,1800,1165,452,176,
42,"MUNICIPIUL BUCURESTI",403,179150,,233,0,"B-dul GARII OBOR nr. 8 , Scoala nr. 64","BUCURESTI SECTORUL 2",2,179150,1,1,1418,709,632,77,696,13,1800,1091,459,237,
42,"MUNICIPIUL BUCURESTI",403,179150,,234,0,"B-dul GARII OBOR nr. 8 , Scoala nr. 64","BUCURESTI SECTORUL 2",2,179150,1,1,1288,593,523,70,585,7,1801,1208,437,148,
42,"MUNICIPIUL BUCURESTI",403,179150,,235,0,"Str. MASINA DE PAINE nr. 65 , Gradinita nr. 135","BUCURESTI SECTORUL 2",2,179150,1,1,1601,788,678,110,771,17,2000,1212,586,185,
42,"MUNICIPIUL BUCURESTI",403,179150,,236,0,"Str. MASINA DE PAINE nr. 65 - 67 , Scoala nr. 27","BUCURESTI SECTORUL 2",2,179150,1,1,1720,951,880,71,912,39,2000,1049,736,176,
42,"MUNICIPIUL BUCURESTI",403,179150,,237,0,"Str. MASINA DE PAINE nr. 65 - 67 , Scoala nr. 27","BUCURESTI SECTORUL 2",2,179150,1,1,1623,829,758,71,809,20,2000,1171,611,198,
42,"MUNICIPIUL BUCURESTI",403,179150,,238,0,"Str. MASINA DE PAINE nr. 65 - 67 , Scoala nr. 27","BUCURESTI SECTORUL 2",2,179150,1,1,1569,930,856,74,900,30,2000,1070,702,198,
42,"MUNICIPIUL BUCURESTI",403,179150,,239,0,"Str. MASINA DE PAINE nr. 65 - 67 , Scoala nr. 27","BUCURESTI SECTORUL 2",2,179150,1,1,1314,673,612,61,644,29,1800,1127,483,161,
42,"MUNICIPIUL BUCURESTI",403,179150,,240,0,"Sos. PANTELIMON nr. 25 , Grup Scolar Electronica Industr.","BUCURESTI SECTORUL 2",2,179150,1,1,1838,958,838,120,939,19,2400,1442,695,244,
42,"MUNICIPIUL BUCURESTI",403,179150,,241,0,"Sos. PANTELIMON nr. 25 , Grup Scolar Electronica Industr.","BUCURESTI SECTORUL 2",2,179150,1,1,1916,929,852,77,894,35,2204,1275,723,171,
42,"MUNICIPIUL BUCURESTI",403,179150,,242,0,"Sos. PANTELIMON nr. 25 , Grup Scolar Electronica Industr.","BUCURESTI SECTORUL 2",2,179150,1,1,1158,781,730,51,756,25,2000,1219,609,147,
42,"MUNICIPIUL BUCURESTI",403,179150,,243,0,"B-dul FERDINAND nr. 91 , Liceul Teoretic IULIA HASDEU","BUCURESTI SECTORUL 2",2,179150,1,1,1771,1018,877,141,989,29,2200,1182,795,194,
42,"MUNICIPIUL BUCURESTI",403,179150,,244,0,"B-dul FERDINAND nr. 91 , Liceul Teoretic IULIA HASDEU","BUCURESTI SECTORUL 2",2,179150,1,1,1809,1035,872,163,1016,19,2200,1165,796,220,
42,"MUNICIPIUL BUCURESTI",403,179150,,245,0,"B-dul FERDINAND nr. 91 , Liceul Teoretic IULIA HASDEU","BUCURESTI SECTORUL 2",2,179150,1,1,1815,976,879,97,953,23,2000,1024,743,210,
42,"MUNICIPIUL BUCURESTI",403,179150,,246,0,"Str. ION MAIORESCU nr. 32 , Scoala nr. 50","BUCURESTI SECTORUL 2",2,179150,1,1,1709,971,895,76,936,35,2000,1029,748,188,
42,"MUNICIPIUL BUCURESTI",403,179150,,247,0,"Str. ION MAIORESCU nr. 32 , Scoala nr. 50","BUCURESTI SECTORUL 2",2,179150,1,1,1780,990,916,74,956,34,2000,1010,760,196,
42,"MUNICIPIUL BUCURESTI",403,179150,,248,0,"Str. ION MAIORESCU nr. 32 , Scoala nr. 50","BUCURESTI SECTORUL 2",2,179150,1,1,1940,1004,911,93,980,24,2200,1196,717,263,
42,"MUNICIPIUL BUCURESTI",403,179150,,249,0,"Str. POPA LAZAR nr. 8 , Grup Scolar Mecanica Fina","BUCURESTI SECTORUL 2",2,179150,1,1,1384,827,745,82,807,20,2000,1173,624,183,
42,"MUNICIPIUL BUCURESTI",403,179150,,250,0,"Str. POPA LAZAR nr. 8 , Grup Scolar Mecanica Fina","BUCURESTI SECTORUL 2",2,179150,1,1,1595,786,729,57,765,21,2000,1214,606,159,
42,"MUNICIPIUL BUCURESTI",403,179150,,251,0,"Str. POPA LAZAR nr. 8 , Grup Scolar Mecanica Fina","BUCURESTI SECTORUL 2",2,179150,1,1,1295,687,600,87,667,20,2000,1313,520,147,
42,"MUNICIPIUL BUCURESTI",403,179150,,252,0,"Str. POPA LAZAR nr. 8 , Grup Scolar Mecanica Fina","BUCURESTI SECTORUL 2",2,179150,1,1,1756,845,794,51,827,18,2000,1155,648,179,
42,"MUNICIPIUL BUCURESTI",403,179150,,253,0,"B-dul PACHE PROTOPOPESCU nr. 62 , Colegiul National MIHAI VITEAZUL","BUCURESTI SECTORUL 2",2,179150,1,1,1962,1139,840,299,1117,22,2600,1461,886,231,
42,"MUNICIPIUL BUCURESTI",403,179150,,254,0,"B-dul PACHE PROTOPOPESCU nr. 62 , Colegiul National MIHAI VITEAZUL","BUCURESTI SECTORUL 2",2,179150,1,1,1898,1098,899,199,1082,16,2400,1302,856,226,
42,"MUNICIPIUL BUCURESTI",403,179150,,255,0,"B-dul PACHE PROTOPOPESCU nr. 109 , Scoala nr. 56 JOSE MARTI","BUCURESTI SECTORUL 2",2,179150,1,1,1674,930,815,115,896,34,2000,1070,730,166,
42,"MUNICIPIUL BUCURESTI",403,179150,,256,0,"B-dul PACHE PROTOPOPESCU nr. 109 , Scoala nr. 56 JOSE MARTI","BUCURESTI SECTORUL 2",2,179150,1,1,1538,826,764,62,811,15,2000,1174,644,167,
42,"MUNICIPIUL BUCURESTI",403,179150,,257,0,"Str. MEDIC ZLATESCU nr. 7A , Scoala nr. 85 VASILE BUNESCU","BUCURESTI SECTORUL 2",2,179150,1,1,1237,662,603,59,643,19,1800,1138,513,130,
42,"MUNICIPIUL BUCURESTI",403,179150,,258,0,"Str. MEDIC ZLATESCU nr. 7A , Scoala nr. 85 VASILE BUNESCU","BUCURESTI SECTORUL 2",2,179150,1,1,1639,731,683,48,713,18,2000,1269,555,158,
42,"MUNICIPIUL BUCURESTI",403,179150,,259,0,"Str. MEDIC ZLATESCU nr. 7A , Scoala nr. 85 VASILE BUNESCU","BUCURESTI SECTORUL 2",2,179150,1,1,1433,768,727,41,754,14,1800,1032,604,150,
42,"MUNICIPIUL BUCURESTI",403,179150,,260,0,"Str. MEDIC ZLATESCU nr. 7A , Scoala nr. 85 VASILE BUNESCU","BUCURESTI SECTORUL 2",2,179150,1,1,1290,723,670,53,706,17,1804,1081,585,121,
42,"MUNICIPIUL BUCURESTI",403,179150,,261,0,"B-dul FERDINAND nr. 128 , Club Sportiv Scolar nr. 2","BUCURESTI SECTORUL 2",2,179150,1,1,1640,900,795,105,878,22,2000,1100,696,182,
42,"MUNICIPIUL BUCURESTI",403,179150,,262,0,"B-dul FERDINAND nr. 128 , Club Sportiv Scolar nr. 2","BUCURESTI SECTORUL 2",2,179150,1,1,1633,914,775,139,900,14,1988,1074,700,200,
42,"MUNICIPIUL BUCURESTI",403,179150,,263,0,"Str. MAGURA VULTURULUI nr. 64 BIS , Gradinita nr.201","BUCURESTI SECTORUL 2",2,179150,1,1,1585,807,743,64,795,12,1800,993,599,196,
42,"MUNICIPIUL BUCURESTI",403,179150,,264,0,"Str. MAGURA VULTURULUI nr. 64 BIS , Gradinita nr.201","BUCURESTI SECTORUL 2",2,179150,1,1,1827,947,900,47,920,27,2200,1253,716,204,
42,"MUNICIPIUL BUCURESTI",403,179150,,265,0,"Str. MAGURA VULTURULUI nr. 64 BIS , Gradinita nr.201","BUCURESTI SECTORUL 2",2,179150,1,1,1552,793,745,48,778,15,2000,1207,626,152,
42,"MUNICIPIUL BUCURESTI",403,179150,,266,0,"Str. MAGURA VULTURULUI nr. 64 BIS , Gradinita nr.201","BUCURESTI SECTORUL 2",2,179150,1,1,1463,754,712,42,733,21,1604,850,597,136,
42,"MUNICIPIUL BUCURESTI",403,179150,,267,0,"Str. POPA NAN nr. 47 BIS , Scoala nr. 85 VASILE BUNESCU","BUCURESTI SECTORUL 2",2,179150,1,1,1361,602,548,54,586,16,1800,1198,447,139,
42,"MUNICIPIUL BUCURESTI",403,179150,,268,0,"Str. POPA NAN nr. 47 BIS , Scoala nr. 85 VASILE BUNESCU","BUCURESTI SECTORUL 2",2,179150,1,1,1540,781,692,89,749,32,2000,1219,575,174,
42,"MUNICIPIUL BUCURESTI",403,179150,,269,0,"Sos. MIHAI BRAVU nr. 169 , Liceul Teoretic EMIL RACOVITA","BUCURESTI SECTORUL 2",2,179150,1,1,1382,922,855,67,899,23,2000,1078,713,186,
42,"MUNICIPIUL BUCURESTI",403,179150,,270,0,"Sos. MIHAI BRAVU nr. 169 , Liceul Teoretic EMIL RACOVITA","BUCURESTI SECTORUL 2",2,179150,1,1,1314,738,666,72,721,17,2000,1262,555,166,
42,"MUNICIPIUL BUCURESTI",403,179150,,271,0,"Sos. MIHAI BRAVU nr. 169 , Liceul Teoretic EMIL RACOVITA","BUCURESTI SECTORUL 2",2,179150,1,1,1763,974,843,131,938,36,2007,1033,734,204,
42,"MUNICIPIUL BUCURESTI",403,179150,,272,0,"Sos. IANCULUI nr. 4 , Gradinita nr.16","BUCURESTI SECTORUL 2",2,179150,1,1,1565,864,810,54,854,10,2000,1136,678,176,
42,"MUNICIPIUL BUCURESTI",403,179150,,273,0,"Sos. IANCULUI nr. 4 , Gradinita nr.16","BUCURESTI SECTORUL 2",2,179150,1,1,1426,798,686,112,776,22,1800,1002,622,154,
42,"MUNICIPIUL BUCURESTI",403,179150,,274,0,"Str. CORABEASCA nr. 16 , Gradinita nr. 256","BUCURESTI SECTORUL 2",2,179150,1,1,1817,986,907,79,941,45,2000,1014,772,169,
42,"MUNICIPIUL BUCURESTI",403,179150,,275,0,"Str. VATRA LUMINOASA nr. 99 , Scoala nr. 49","BUCURESTI SECTORUL 2",2,179150,1,1,1413,789,685,104,754,35,1797,1008,607,147,
42,"MUNICIPIUL BUCURESTI",403,179150,,276,0,"Str. VATRA LUMINOASA nr. 99 , Scoala nr. 49","BUCURESTI SECTORUL 2",2,179150,1,1,1361,761,698,63,720,41,1800,1039,595,125,
42,"MUNICIPIUL BUCURESTI",403,179150,,277,0,"Str. HAMBARULUI nr. 4 , Grup Scolar Ind. SF. PANTELIMON","BUCURESTI SECTORUL 2",2,179150,1,1,1959,988,860,128,954,34,2200,1212,756,198,
42,"MUNICIPIUL BUCURESTI",403,179150,,278,0,"Str. HAMBARULUI nr. 4 , Grup Scolar Ind. SF. PANTELIMON","BUCURESTI SECTORUL 2",2,179150,1,1,1630,771,727,44,756,15,2000,1229,601,155,
42,"MUNICIPIUL BUCURESTI",403,179150,,279,0,"Str. STANESCU GHEORGHE nr. 2 , Scoala nr.46","BUCURESTI SECTORUL 2",2,179150,1,1,1408,724,650,74,712,12,1800,1076,508,204,
42,"MUNICIPIUL BUCURESTI",403,179150,,280,0,"Str. STANESCU GHEORGHE nr. 2 , Scoala nr.46","BUCURESTI SECTORUL 2",2,179150,1,1,1817,943,857,86,929,14,2200,1257,690,239,
42,"MUNICIPIUL BUCURESTI",403,179150,,281,0,"Str. STANESCU GHEORGHE nr. 2 , Scoala nr.46","BUCURESTI SECTORUL 2",2,179150,1,1,1889,1015,962,53,998,17,2200,1185,740,258,
42,"MUNICIPIUL BUCURESTI",403,179150,,282,0,"Str. STANESCU GHEORGHE nr. 2 , Scoala nr.46","BUCURESTI SECTORUL 2",2,179150,1,1,2082,1082,1040,42,1057,20,2400,1318,794,263,
42,"MUNICIPIUL BUCURESTI",403,179150,,283,0,"Str. PIERRE DE COUBERTIN nr. 1 - 3 , S.C. ELECTROAPARATAJ S.A","BUCURESTI SECTORUL 2",2,179150,1,1,1771,902,841,61,886,16,2200,1298,646,240,
42,"MUNICIPIUL BUCURESTI",403,179150,,284,0,"Str. PIERRE DE COUBERTIN nr. 1 - 3 , S.C. ELECTROAPARATAJ S.A","BUCURESTI SECTORUL 2",2,179150,1,1,2000,1011,940,71,979,32,2200,1189,730,249,
42,"MUNICIPIUL BUCURESTI",403,179150,,285,0,"Str. HERTA nr. 1 , Scoala nr. 51","BUCURESTI SECTORUL 2",2,179150,1,1,1734,918,866,52,900,18,2004,1086,710,190,
42,"MUNICIPIUL BUCURESTI",403,179150,,286,0,"Str. HERTA nr. 1 , Scoala nr. 51","BUCURESTI SECTORUL 2",2,179150,1,1,1657,690,601,89,678,12,2000,1310,502,176,
42,"MUNICIPIUL BUCURESTI",403,179150,,287,0,"Str. HERTA nr. 1 , Scoala nr. 51","BUCURESTI SECTORUL 2",2,179150,1,1,1514,772,713,59,763,9,2000,1228,548,215,
42,"MUNICIPIUL BUCURESTI",403,179150,,288,0,"Str. POTIRNICHII nr. 3 , Scoala nr. 62","BUCURESTI SECTORUL 2",2,179150,1,1,1679,901,758,143,886,15,2000,1099,616,270,
42,"MUNICIPIUL BUCURESTI",403,179150,,289,0,"Str. POTIRNICHII nr. 3 , Scoala nr. 62","BUCURESTI SECTORUL 2",2,179150,1,1,1597,664,596,68,657,7,2000,1336,441,216,
42,"MUNICIPIUL BUCURESTI",403,179150,,290,0,"Str. POTIRNICHII nr. 3 , Scoala nr. 62","BUCURESTI SECTORUL 2",2,179150,1,1,1819,880,824,56,857,23,2000,1120,615,242,
42,"MUNICIPIUL BUCURESTI",403,179150,,291,0,"Str. POTIRNICHII nr. 3 , Scoala nr. 62","BUCURESTI SECTORUL 2",2,179150,1,1,1577,791,751,40,773,18,2000,1209,556,217,
42,"MUNICIPIUL BUCURESTI",403,179150,,292,0,"Str. POTIRNICHII nr. 3 , Scoala nr. 62","BUCURESTI SECTORUL 2",2,179150,1,1,1682,765,694,71,747,18,2000,1235,533,214,
42,"MUNICIPIUL BUCURESTI",403,179150,,293,0,"Str. POTIRNICHII nr. 3 , Scoala nr. 62","BUCURESTI SECTORUL 2",2,179150,1,1,1534,836,775,61,820,16,1800,964,617,203,
42,"MUNICIPIUL BUCURESTI",403,179150,,294,0,"Str. DELFINULUI nr. 4 , Gradinita nr. 280","BUCURESTI SECTORUL 2",2,179150,1,1,1551,730,672,58,709,21,2000,1270,499,210,
42,"MUNICIPIUL BUCURESTI",403,179150,,295,0,"Str. DELFINULUI nr. 4 , Gradinita nr. 280","BUCURESTI SECTORUL 2",2,179150,1,1,1548,882,812,70,868,14,2200,1318,630,238,
42,"MUNICIPIUL BUCURESTI",403,179150,,296,0,"Sos. PANTELIMON nr. 289 , Scoala nr. 77","BUCURESTI SECTORUL 2",2,179150,1,1,1442,650,594,56,636,14,1800,1150,434,202,
42,"MUNICIPIUL BUCURESTI",403,179150,,297,0,"Str. DELFINULUI nr. 4 , Gradinita nr. 280","BUCURESTI SECTORUL 2",2,179150,1,1,1635,881,811,70,867,14,2000,1119,641,226,
42,"MUNICIPIUL BUCURESTI",403,179150,,298,0,"Str. DELFINULUI nr. 4 , Gradinita nr. 280","BUCURESTI SECTORUL 2",2,179150,1,1,1753,897,832,65,884,13,2400,1503,650,234,
42,"MUNICIPIUL BUCURESTI",403,179150,,299,0,"Str. DELFINULUI nr. 4 , Gradinita nr. 280","BUCURESTI SECTORUL 2",2,179150,1,1,1703,873,810,63,852,21,2000,1127,636,216,
42,"MUNICIPIUL BUCURESTI",403,179150,,300,0,"Str. DELFINULUI nr. 4 , Gradinita nr. 280","BUCURESTI SECTORUL 2",2,179150,1,1,1640,846,768,78,834,12,2000,1154,569,265,
42,"MUNICIPIUL BUCURESTI",403,179150,,301,0,"Str. DELFINULUI nr. 4 , Gradinita nr. 280","BUCURESTI SECTORUL 2",2,179150,1,1,1733,888,854,34,880,8,2000,1112,672,208,
42,"MUNICIPIUL BUCURESTI",403,179150,,302,0,"Sos. PANTELIMON nr. 355 , Liceul Teoretic LUCIAN BLAGA","BUCURESTI SECTORUL 2",2,179150,1,1,1765,909,791,118,890,19,2000,1091,635,255,
42,"MUNICIPIUL BUCURESTI",403,179150,,303,0,"Sos. PANTELIMON nr. 355 , Liceul Teoretic LUCIAN BLAGA","BUCURESTI SECTORUL 2",2,179150,1,1,2072,820,723,97,807,13,2400,1580,531,276,
42,"MUNICIPIUL BUCURESTI",403,179150,,304,0,"Sos. PANTELIMON nr. 355 , Liceul Teoretic LUCIAN BLAGA","BUCURESTI SECTORUL 2",2,179150,1,1,1816,835,772,63,823,12,2200,1365,584,239,
42,"MUNICIPIUL BUCURESTI",403,179150,,305,0,"Sos. PANTELIMON nr. 355 , Liceul Teoretic LUCIAN BLAGA","BUCURESTI SECTORUL 2",2,179150,1,1,1903,880,805,75,865,15,2200,1320,577,288,
42,"MUNICIPIUL BUCURESTI",403,179150,,306,0,"Sos. PANTELIMON nr. 355 , Liceul Teoretic LUCIAN BLAGA","BUCURESTI SECTORUL 2",2,179150,1,1,1295,691,649,42,674,17,1800,1109,503,171,
42,"MUNICIPIUL BUCURESTI",403,179150,,307,0,"Str. LOGOFATUL DAN nr. 1 , Scoala nr. 66","BUCURESTI SECTORUL 2",2,179150,1,1,2118,1002,939,63,975,27,2400,1398,695,280,
42,"MUNICIPIUL BUCURESTI",403,179150,,308,0,"Str. LOGOFATUL DAN nr. 1 , Scoala nr. 66","BUCURESTI SECTORUL 2",2,179150,1,1,1884,1060,871,189,1049,11,2600,1540,750,299,
42,"MUNICIPIUL BUCURESTI",403,179150,,309,0,"Str. LOGOFATUL DAN nr. 1 , Scoala nr. 66","BUCURESTI SECTORUL 2",2,179150,1,1,2052,906,860,46,891,15,2400,1494,653,238,
42,"MUNICIPIUL BUCURESTI",403,179150,,310,0,"Str. LOGOFATUL DAN nr. 1 , Scoala nr. 66","BUCURESTI SECTORUL 2",2,179150,1,1,2102,1018,953,65,994,24,2396,1378,712,282,
42,"MUNICIPIUL BUCURESTI",403,179150,,311,0,"Sos. VERGULUI nr. 12 , Gradinita nr. 189","BUCURESTI SECTORUL 2",2,179150,1,1,988,481,438,43,477,4,1200,719,336,141,
42,"MUNICIPIUL BUCURESTI",403,179150,,312,0,"Sos. VERGULUI nr. 12 , Gradinita nr. 189","BUCURESTI SECTORUL 2",2,179150,1,1,1401,774,735,39,764,10,1800,1026,549,215,
42,"MUNICIPIUL BUCURESTI",403,179150,,313,0,"B-dul BASARABIA nr. 47 , Grup Scolar DIMITRIE LEONIDA","BUCURESTI SECTORUL 2",2,179150,1,1,1326,891,644,247,869,22,1800,909,661,208,
42,"MUNICIPIUL BUCURESTI",403,179150,,314,0,"B-dul BASARABIA nr. 47 , Grup Scolar DIMITRIE LEONIDA","BUCURESTI SECTORUL 2",2,179150,1,1,1388,799,659,140,782,17,2000,1201,543,239,
42,"MUNICIPIUL BUCURESTI",403,179150,,315,0,"Str. PESCARUSULUI nr. 124 , Scoala nr. 58","BUCURESTI SECTORUL 2",2,179150,1,1,1892,915,832,83,902,13,2200,1285,669,233,
42,"MUNICIPIUL BUCURESTI",403,179150,,316,0,"Str. PESCARUSULUI nr. 124 , Scoala nr. 58","BUCURESTI SECTORUL 2",2,179150,1,1,1855,950,860,90,933,17,2200,1250,712,221,
42,"MUNICIPIUL BUCURESTI",403,179150,,317,0,"Str. PESCARUSULUI nr. 124 , Scoala nr. 58","BUCURESTI SECTORUL 2",2,179150,1,1,2217,1063,966,97,1041,22,2600,1537,767,274,
42,"MUNICIPIUL BUCURESTI",403,179150,,318,0,"Str. PESCARUSULUI nr. 124 , Scoala nr. 58","BUCURESTI SECTORUL 2",2,179150,1,1,2078,1097,1026,71,1083,14,2400,1303,820,263,
42,"MUNICIPIUL BUCURESTI",403,179150,,319,0,"Str. PESCARUSULUI nr. 124 , Scoala nr. 58","BUCURESTI SECTORUL 2",2,179150,1,1,1925,902,864,38,895,7,2200,1298,624,271,
42,"MUNICIPIUL BUCURESTI",403,179150,,320,0,"Str. HERTA nr. 14 , Scoala nr. 4","BUCURESTI SECTORUL 2",2,179150,1,1,1685,870,799,71,854,16,2000,1130,612,242,
42,"MUNICIPIUL BUCURESTI",403,179150,,321,0,"Str. HERTA nr. 14 , Scoala nr. 4","BUCURESTI SECTORUL 2",2,179150,1,1,1868,946,900,46,929,16,2200,1255,668,261,
42,"MUNICIPIUL BUCURESTI",403,179150,,322,0,"Str. HERTA nr. 14 , Scoala nr. 4","BUCURESTI SECTORUL 2",2,179150,1,1,1926,896,851,45,888,8,2200,1304,645,243,
42,"MUNICIPIUL BUCURESTI",403,179150,,323,0,"Str. HERTA nr. 14 , Scoala nr. 4","BUCURESTI SECTORUL 2",2,179150,1,1,1792,859,817,42,839,20,2200,1341,625,214,
42,"MUNICIPIUL BUCURESTI",403,179150,,324,0,"Str. HERTA nr. 14 , Scoala nr. 4","BUCURESTI SECTORUL 2",2,179150,1,1,1634,805,759,46,795,10,2000,1195,551,244,
42,"MUNICIPIUL BUCURESTI",403,179169,,325,0,"Str. HRISTO BOTEV  nr. 17 , Liceul NICOLAE KRETZULESCU","BUCURESTI SECTORUL 3",3,179169,1,1,1490,815,631,184,803,10,2200,1385,669,134,
42,"MUNICIPIUL BUCURESTI",403,179169,,326,0,"Str. HRISTO BOTEV  nr. 17 , Liceul NICOLAE KRETZULESCU","BUCURESTI SECTORUL 3",3,179169,1,1,1533,639,501,138,622,17,2200,1561,455,167,
42,"MUNICIPIUL BUCURESTI",403,179169,,327,0,"Str. HRISTO BOTEV  nr. 17 , Liceul NICOLAE KRETZULESCU","BUCURESTI SECTORUL 3",3,179169,1,1,1489,851,606,245,824,27,2200,1349,660,164,
42,"MUNICIPIUL BUCURESTI",403,179169,,328,0,"Str. ZBORULUI  nr. 7 - 9 , Liceul Industrial UNIREA","BUCURESTI SECTORUL 3",3,179169,1,1,1511,744,578,166,725,19,1800,1056,583,142,
42,"MUNICIPIUL BUCURESTI",403,179169,,329,0,"Str. ZBORULUI  nr. 7 - 9 , Liceul Industrial UNIREA","BUCURESTI SECTORUL 3",3,179169,1,1,1635,700,637,63,679,18,1907,1207,546,133,
42,"MUNICIPIUL BUCURESTI",403,179169,,330,0,"Str. ZBORULUI  nr. 7 - 9 , Liceul Industrial UNIREA","BUCURESTI SECTORUL 3",3,179169,1,1,1715,852,734,118,841,11,1800,948,693,148,
42,"MUNICIPIUL BUCURESTI",403,179169,,331,0,"Str. MATEI BASARAB  nr. 32 , Liceul MATEI BASARAB","BUCURESTI SECTORUL 3",3,179169,1,1,1568,840,717,123,821,19,1892,1052,658,163,
42,"MUNICIPIUL BUCURESTI",403,179169,,332,0,"Str. MATEI BASARAB  nr. 32 , Liceul MATEI BASARAB","BUCURESTI SECTORUL 3",3,179169,1,1,1500,639,560,79,620,19,1600,961,474,146,
42,"MUNICIPIUL BUCURESTI",403,179169,,333,0,"Str. ANTON PANN  nr. 44 , Scoala Generala nr. 72","BUCURESTI SECTORUL 3",3,179169,1,1,2015,1012,842,170,1005,7,2400,1388,818,187,
42,"MUNICIPIUL BUCURESTI",403,179169,,334,0,"Str. ANTON PANN  nr. 44 , Scoala Generala nr. 72","BUCURESTI SECTORUL 3",3,179169,1,1,1989,1077,805,272,1060,17,2400,1323,829,231,
42,"MUNICIPIUL BUCURESTI",403,179169,,335,0,"Str. LUCACI  nr. 16 , Scoala de Muzica nr. 5","BUCURESTI SECTORUL 3",3,179169,1,1,2091,986,877,109,958,28,2499,1513,747,211,
42,"MUNICIPIUL BUCURESTI",403,179169,,336,0,"Str. TURTURELELOR  nr. 13 , Scoala Ajutatoare nr. 5","BUCURESTI SECTORUL 3",3,179169,1,1,1704,820,729,91,807,13,2003,1183,620,187,
42,"MUNICIPIUL BUCURESTI",403,179169,,337,0,"Str. TURTURELELOR  nr. 13 , Scoala Ajutatoare nr. 5","BUCURESTI SECTORUL 3",3,179169,1,1,1427,709,647,62,703,6,1700,991,547,156,
42,"MUNICIPIUL BUCURESTI",403,179169,,338,0,"Str. TURTURELELOR  nr. 13 , Scoala Ajutatoare nr. 5","BUCURESTI SECTORUL 3",3,179169,1,1,1295,546,455,91,535,11,1500,954,415,120,
42,"MUNICIPIUL BUCURESTI",403,179169,,339,0,"Str. TURTURELELOR  nr. 13 , Scoala Ajutatoare nr. 5","BUCURESTI SECTORUL 3",3,179169,1,1,1145,540,468,72,529,11,1400,860,395,134,
42,"MUNICIPIUL BUCURESTI",403,179169,,340,0,"Str. TURTURELELOR  nr. 13 , Scoala Ajutatoare nr. 5","BUCURESTI SECTORUL 3",3,179169,1,1,1775,757,638,119,742,14,2100,1343,586,156,
42,"MUNICIPIUL BUCURESTI",403,179169,,341,0,"Str. TURTURELELOR  nr. 13 , Scoala Ajutatoare nr. 5","BUCURESTI SECTORUL 3",3,179169,1,1,1688,790,706,84,778,12,2000,1210,624,154,
42,"MUNICIPIUL BUCURESTI",403,179169,,342,0,"Str. TIGLINA nr. 37 , Scoala Generala nr. 70","BUCURESTI SECTORUL 3",3,179169,1,1,1932,938,829,109,918,20,2300,1362,724,194,
42,"MUNICIPIUL BUCURESTI",403,179169,,343,0,"Str. TIGLINA nr. 37 , Scoala Generala nr. 70","BUCURESTI SECTORUL 3",3,179169,1,1,1461,842,730,112,829,13,2100,1258,667,162,
42,"MUNICIPIUL BUCURESTI",403,179169,,344,0,"Str. TIGLINA nr. 37 , Scoala Generala nr. 70","BUCURESTI SECTORUL 3",3,179169,1,1,1635,821,707,114,800,20,1900,1079,584,216,
42,"MUNICIPIUL BUCURESTI",403,179169,,345,0,"Str. TIGLINA nr. 37 , Scoala Generala nr. 70","BUCURESTI SECTORUL 3",3,179169,1,1,1705,979,915,64,945,34,2000,1021,720,225,
42,"MUNICIPIUL BUCURESTI",403,179169,,346,0,"Str. TIGLINA nr. 37 , Scoala Generala nr. 70","BUCURESTI SECTORUL 3",3,179169,1,1,1598,759,665,94,740,19,1899,1140,577,163,
42,"MUNICIPIUL BUCURESTI",403,179169,,347,0,"Str. TIGLINA nr. 37 , Scoala Generala nr. 70","BUCURESTI SECTORUL 3",3,179169,1,1,1591,809,732,77,790,19,1900,1091,612,178,
42,"MUNICIPIUL BUCURESTI",403,179169,,348,0,"Cal. DUDESTI nr. 191 , Scoala Generala nr. 80","BUCURESTI SECTORUL 3",3,179169,1,1,2114,1013,966,47,991,22,2500,1487,763,228,
42,"MUNICIPIUL BUCURESTI",403,179169,,349,0,"Cal. DUDESTI nr. 191 , Scoala Generala nr. 80","BUCURESTI SECTORUL 3",3,179169,1,1,1224,721,614,107,692,18,1600,879,570,122,
42,"MUNICIPIUL BUCURESTI",403,179169,,350,0,"Cal. DUDESTI nr. 191 , Scoala Generala nr. 80","BUCURESTI SECTORUL 3",3,179169,1,1,1468,848,747,101,833,15,1700,852,654,179,
42,"MUNICIPIUL BUCURESTI",403,179169,,351,0,"Cal. DUDESTI nr. 191 , Scoala Generala nr. 80","BUCURESTI SECTORUL 3",3,179169,1,1,1502,801,688,113,791,10,1800,999,602,189,
42,"MUNICIPIUL BUCURESTI",403,179169,,352,0,"Cal. DUDESTI nr. 191 , Scoala Generala nr. 80","BUCURESTI SECTORUL 3",3,179169,1,1,1220,715,618,97,696,19,1401,686,543,153,
42,"MUNICIPIUL BUCURESTI",403,179169,,353,0,"Cal. DUDESTI nr. 127 , Grup Scolar TIMPURI NOI","BUCURESTI SECTORUL 3",3,179169,1,1,1684,1267,1197,70,1245,22,2000,733,1067,178,
42,"MUNICIPIUL BUCURESTI",403,179169,,354,0,"Cal. DUDESTI nr. 127 , Grup Scolar TIMPURI NOI","BUCURESTI SECTORUL 3",3,179169,1,1,1968,1077,1005,72,1060,17,2400,1323,863,197,
42,"MUNICIPIUL BUCURESTI",403,179169,,355,0,"Cal. DUDESTI nr. 127 , Grup Scolar TIMPURI NOI","BUCURESTI SECTORUL 3",3,179169,1,1,1865,1614,1381,233,1591,23,2200,586,1390,201,
42,"MUNICIPIUL BUCURESTI",403,179169,,356,0,"Str. NERVA TRAIAN nr. 33 , Scoala Generala nr. 81","BUCURESTI SECTORUL 3",3,179169,1,1,1905,963,846,117,945,18,2297,1334,676,269,
42,"MUNICIPIUL BUCURESTI",403,179169,,357,0,"Str. NERVA TRAIAN nr. 33 , Scoala Generala nr. 81","BUCURESTI SECTORUL 3",3,179169,1,1,1480,720,586,134,707,13,1700,980,554,153,
42,"MUNICIPIUL BUCURESTI",403,179169,,358,0,"Str. NERVA TRAIAN nr. 33 , Scoala Generala nr. 81","BUCURESTI SECTORUL 3",3,179169,1,1,1970,1045,922,123,1024,20,2300,1255,776,248,
42,"MUNICIPIUL BUCURESTI",403,179169,,359,0,"Str. NERVA TRAIAN nr. 33 , Scoala Generala nr. 81","BUCURESTI SECTORUL 3",3,179169,1,1,2437,1280,1092,188,1267,13,2900,1620,951,316,
42,"MUNICIPIUL BUCURESTI",403,179169,,360,0,"Str. NERVA TRAIAN nr. 33 , Scoala Generala nr. 81","BUCURESTI SECTORUL 3",3,179169,1,1,1875,753,661,92,746,7,2200,1447,562,184,
42,"MUNICIPIUL BUCURESTI",403,179169,,361,0,"Str. NERVA TRAIAN nr. 33 , Scoala Generala nr. 81","BUCURESTI SECTORUL 3",3,179169,1,1,1999,1026,878,148,1019,7,2400,1374,697,322,
42,"MUNICIPIUL BUCURESTI",403,179169,,362,0,"Str. FOISORULUI nr. 111 - 113 , Scoala Generala nr. 95","BUCURESTI SECTORUL 3",3,179169,1,1,1366,669,564,105,660,9,1600,931,483,177,
42,"MUNICIPIUL BUCURESTI",403,179169,,363,0,"Str. FOISORULUI nr. 111 - 113 , Scoala Generala nr. 95","BUCURESTI SECTORUL 3",3,179169,1,1,2098,887,718,169,875,12,2500,1613,582,293,
42,"MUNICIPIUL BUCURESTI",403,179169,,364,0,"Str. FOISORULUI nr. 111 - 113 , Scoala Generala nr. 95","BUCURESTI SECTORUL 3",3,179169,1,1,1627,696,605,91,685,11,1900,1204,497,188,
42,"MUNICIPIUL BUCURESTI",403,179169,,365,0,"Str. FOISORULUI nr. 111 - 113 , Scoala Generala nr. 95","BUCURESTI SECTORUL 3",3,179169,1,1,1051,526,363,163,519,7,1200,674,373,146,
42,"MUNICIPIUL BUCURESTI",403,179169,,366,0,"Str. FOISORULUI nr. 111 - 113 , Scoala Generala nr. 95","BUCURESTI SECTORUL 3",3,179169,1,1,1297,513,482,31,505,7,1500,987,375,130,
42,"MUNICIPIUL BUCURESTI",403,179169,,367,0,"Str. FOISORULUI nr. 111 - 113 , Scoala Generala nr. 95","BUCURESTI SECTORUL 3",3,179169,1,1,1818,818,759,59,811,7,2200,1382,544,267,
42,"MUNICIPIUL BUCURESTI",403,179169,,368,0,"Cal. VITAN nr. 135 , Scoala Generala nr.84","BUCURESTI SECTORUL 3",3,179169,1,1,1422,835,576,259,824,11,1698,863,624,200,
42,"MUNICIPIUL BUCURESTI",403,179169,,369,0,"Cal. VITAN nr. 135 , Scoala Generala nr.84","BUCURESTI SECTORUL 3",3,179169,1,1,1128,503,465,38,497,6,1300,797,353,144,
42,"MUNICIPIUL BUCURESTI",403,179169,,370,0,"Cal. VITAN nr. 135 , Scoala Generala nr.84","BUCURESTI SECTORUL 3",3,179169,1,1,1267,612,504,108,601,11,1500,888,433,168,
42,"MUNICIPIUL BUCURESTI",403,179169,,371,0,"Cal. VITAN nr. 135 , Scoala Generala nr.84","BUCURESTI SECTORUL 3",3,179169,1,1,2255,933,841,92,910,23,2700,1767,606,304,
42,"MUNICIPIUL BUCURESTI",403,179169,,372,0,"Cal. VITAN nr. 135 , Scoala Generala nr.84","BUCURESTI SECTORUL 3",3,179169,1,1,1350,626,567,59,612,14,1600,974,465,147,
42,"MUNICIPIUL BUCURESTI",403,179169,,373,0,"Cal. VITAN nr. 135 , Scoala Generala nr.84","BUCURESTI SECTORUL 3",3,179169,1,1,1873,853,801,52,840,13,2200,1347,574,266,
42,"MUNICIPIUL BUCURESTI",403,179169,,374,0,"Cal. VITAN nr. 135 , Scoala Generala nr.84","BUCURESTI SECTORUL 3",3,179169,1,1,1971,903,725,178,892,11,2300,1397,616,276,
42,"MUNICIPIUL BUCURESTI",403,179169,,375,0,"Cal. VITAN nr. 135 , Scoala Generala nr.84","BUCURESTI SECTORUL 3",3,179169,1,1,1171,548,493,55,541,7,1400,852,371,170,
42,"MUNICIPIUL BUCURESTI",403,179169,,376,0,"Sos. MIHAI BRAVU nr. 428 , Grup Scolar de Constructii nr. 2","BUCURESTI SECTORUL 3",3,179169,1,1,1769,852,764,88,829,23,2100,1248,604,225,
42,"MUNICIPIUL BUCURESTI",403,179169,,377,0,"Sos. MIHAI BRAVU nr. 428 , Grup Scolar de Constructii nr. 2","BUCURESTI SECTORUL 3",3,179169,1,1,1185,600,540,60,587,13,1400,800,436,151,
42,"MUNICIPIUL BUCURESTI",403,179169,,378,0,"Sos. MIHAI BRAVU nr. 428 , Grup Scolar de Constructii nr. 2","BUCURESTI SECTORUL 3",3,179169,1,1,1013,515,466,49,513,2,1200,685,362,151,
42,"MUNICIPIUL BUCURESTI",403,179169,,379,0,"Sos. MIHAI BRAVU nr. 428 , Grup Scolar de Constructii nr. 2","BUCURESTI SECTORUL 3",3,179169,1,1,1428,717,681,36,699,18,1700,983,542,157,
42,"MUNICIPIUL BUCURESTI",403,179169,,380,0,"Sos. MIHAI BRAVU nr. 428 , Grup Scolar de Constructii nr. 2","BUCURESTI SECTORUL 3",3,179169,1,1,1204,632,596,36,624,8,1400,768,456,168,
42,"MUNICIPIUL BUCURESTI",403,179169,,381,0,"Sos. MIHAI BRAVU nr. 428 , Grup Scolar de Constructii nr. 2","BUCURESTI SECTORUL 3",3,179169,1,1,1521,810,750,60,796,14,1800,990,577,219,
42,"MUNICIPIUL BUCURESTI",403,179169,,382,0,"Sos. MIHAI BRAVU nr. 428 , Grup Scolar de Constructii nr. 2","BUCURESTI SECTORUL 3",3,179169,1,1,1060,531,498,33,529,2,1300,769,380,149,
42,"MUNICIPIUL BUCURESTI",403,179169,,383,0,"Sos. MIHAI BRAVU nr. 428 , Grup Scolar de Constructii nr. 2","BUCURESTI SECTORUL 3",3,179169,1,1,1498,668,619,49,652,16,1500,832,480,172,
42,"MUNICIPIUL BUCURESTI",403,179169,,384,0,"Sos. MIHAI BRAVU nr. 428 , Grup Scolar de Constructii nr. 2","BUCURESTI SECTORUL 3",3,179169,1,1,765,547,473,74,534,13,1400,853,394,140,
42,"MUNICIPIUL BUCURESTI",403,179169,,385,0,"Intr. RECONSTRUCTIEI nr. 6A , Scoala Generala nr. 86","BUCURESTI SECTORUL 3",3,179169,1,1,1343,606,542,64,594,12,1600,994,461,133,
42,"MUNICIPIUL BUCURESTI",403,179169,,386,0,"Intr. RECONSTRUCTIEI nr. 6A , Scoala Generala nr. 86","BUCURESTI SECTORUL 3",3,179169,1,1,1307,751,694,57,726,25,1600,849,599,127,
42,"MUNICIPIUL BUCURESTI",403,179169,,387,0,"Intr. RECONSTRUCTIEI nr. 6A , Scoala Generala nr. 86","BUCURESTI SECTORUL 3",3,179169,1,1,1102,640,602,38,622,18,1300,660,485,137,
42,"MUNICIPIUL BUCURESTI",403,179169,,388,0,"Intr. RECONSTRUCTIEI nr. 6A , Scoala Generala nr. 86","BUCURESTI SECTORUL 3",3,179169,1,1,1189,658,602,56,646,12,1398,740,510,136,
42,"MUNICIPIUL BUCURESTI",403,179169,,389,0,"Intr. RECONSTRUCTIEI nr. 6A , Scoala Generala nr. 86","BUCURESTI SECTORUL 3",3,179169,1,1,1538,850,772,78,828,22,1800,950,631,197,
42,"MUNICIPIUL BUCURESTI",403,179169,,390,0,"Intr. RECONSTRUCTIEI nr. 6A , Scoala Generala nr. 86","BUCURESTI SECTORUL 3",3,179169,1,1,1441,771,716,55,759,12,1700,929,587,172,
42,"MUNICIPIUL BUCURESTI",403,179169,,391,0,"Str. RIMNICU VILCEA nr. 32 , Scoala Generala nr. 87","BUCURESTI SECTORUL 3",3,179169,1,1,1611,727,643,84,713,14,1900,1173,569,144,
42,"MUNICIPIUL BUCURESTI",403,179169,,392,0,"Str. RIMNICU VILCEA nr. 32 , Scoala Generala nr. 87","BUCURESTI SECTORUL 3",3,179169,1,1,1211,601,504,97,590,11,1400,799,424,166,
42,"MUNICIPIUL BUCURESTI",403,179169,,393,0,"Str. RIMNICU VILCEA nr. 32 , Scoala Generala nr. 87","BUCURESTI SECTORUL 3",3,179169,1,1,1440,690,645,45,677,13,1700,1010,451,226,
42,"MUNICIPIUL BUCURESTI",403,179169,,394,0,"Str. RIMNICU VILCEA nr. 32 , Scoala Generala nr. 87","BUCURESTI SECTORUL 3",3,179169,1,1,1483,670,605,65,661,9,1800,1130,439,222,
42,"MUNICIPIUL BUCURESTI",403,179169,,395,0,"Str. RIMNICU VILCEA nr. 32 , Scoala Generala nr. 87","BUCURESTI SECTORUL 3",3,179169,1,1,1401,716,654,62,712,4,1700,984,489,223,
42,"MUNICIPIUL BUCURESTI",403,179169,,396,0,"Str. RIMNICU VILCEA nr. 32 , Scoala Generala nr. 87","BUCURESTI SECTORUL 3",3,179169,1,1,1301,635,575,60,625,10,1500,865,405,220,
42,"MUNICIPIUL BUCURESTI",403,179169,,397,0,"Str. RIMNICU VILCEA nr. 32 , Scoala Generala nr. 87","BUCURESTI SECTORUL 3",3,179169,1,1,1549,759,711,48,748,11,1800,1041,527,221,
42,"MUNICIPIUL BUCURESTI",403,179169,,398,0,"Str. RIMNICU VILCEA nr. 32 , Scoala Generala nr. 87","BUCURESTI SECTORUL 3",3,179169,1,1,1367,670,625,45,661,9,1600,930,426,235,
42,"MUNICIPIUL BUCURESTI",403,179169,,399,0,"Str. RIMNICU VILCEA nr. 32 , Scoala Generala nr. 87","BUCURESTI SECTORUL 3",3,179169,1,1,1259,616,579,37,598,18,1500,884,389,209,
42,"MUNICIPIUL BUCURESTI",403,179169,,400,0,"Str. GH. PETRASCU nr.49 , Scoala Generala nr. 75","BUCURESTI SECTORUL 3",3,179169,1,1,1488,829,741,88,817,12,2200,1371,648,169,
42,"MUNICIPIUL BUCURESTI",403,179169,,401,0,"Str. GH. PETRASCU nr.49 , Scoala Generala nr. 75","BUCURESTI SECTORUL 3",3,179169,1,1,1164,588,557,31,579,9,1400,812,429,150,
42,"MUNICIPIUL BUCURESTI",403,179169,,402,0,"Str. GH. PETRASCU nr.49 , Scoala Generala nr. 75","BUCURESTI SECTORUL 3",3,179169,1,1,1441,812,751,61,802,10,1700,888,616,186,
42,"MUNICIPIUL BUCURESTI",403,179169,,403,0,"Str. GH. PETRASCU nr.49 , Scoala Generala nr. 75","BUCURESTI SECTORUL 3",3,179169,1,1,1598,878,835,43,856,22,1900,1022,696,160,
42,"MUNICIPIUL BUCURESTI",403,179169,,404,0,"Str. ION TUCULESCU nr. 42 , Grup Scolar Sticla","BUCURESTI SECTORUL 3",3,179169,1,1,1463,877,744,133,864,13,1700,823,700,164,
42,"MUNICIPIUL BUCURESTI",403,179169,,405,0,"Str. ION TUCULESCU nr. 42 , Grup Scolar Sticla","BUCURESTI SECTORUL 3",3,179169,1,1,1399,797,720,77,764,33,1700,903,567,197,
42,"MUNICIPIUL BUCURESTI",403,179169,,406,0,"Str. ION TUCULESCU nr. 42 , Grup Scolar Sticla","BUCURESTI SECTORUL 3",3,179169,1,1,1289,672,618,54,648,24,1500,828,497,151,
42,"MUNICIPIUL BUCURESTI",403,179169,,407,0,"Str. ION TUCULESCU nr. 42 , Grup Scolar Sticla","BUCURESTI SECTORUL 3",3,179169,1,1,1561,755,693,62,739,16,1800,1045,553,186,
42,"MUNICIPIUL BUCURESTI",403,179169,,408,0,"Str. ION TUCULESCU nr. 42 , Grup Scolar Sticla","BUCURESTI SECTORUL 3",3,179169,1,1,1184,678,624,54,664,14,1400,722,523,141,
42,"MUNICIPIUL BUCURESTI",403,179169,,409,0,"Str. ION TUCULESCU nr. 42 , Grup Scolar Sticla","BUCURESTI SECTORUL 3",3,179169,1,1,1510,785,739,46,767,18,1800,1015,591,176,
42,"MUNICIPIUL BUCURESTI",403,179169,,410,0,"Str. PICTOR GHEORGHE TATTARASCU nr. 1 , Liceul I.O.R.","BUCURESTI SECTORUL 3",3,179169,1,1,1404,762,726,36,750,12,1688,926,606,144,
42,"MUNICIPIUL BUCURESTI",403,179169,,411,0,"Str. PICTOR GHEORGHE TATTARASCU nr. 1 , Liceul I.O.R.","BUCURESTI SECTORUL 3",3,179169,1,1,1508,625,546,79,619,5,1500,875,489,130,
42,"MUNICIPIUL BUCURESTI",403,179169,,412,0,"Str. PICTOR GHEORGHE TATTARASCU nr. 1 , Liceul I.O.R.","BUCURESTI SECTORUL 3",3,179169,1,1,1356,689,634,55,663,26,1600,911,527,136,
42,"MUNICIPIUL BUCURESTI",403,179169,,413,0,"Str. PICTOR GHEORGHE TATTARASCU nr. 1 , Liceul I.O.R.","BUCURESTI SECTORUL 3",3,179169,1,1,1383,743,702,41,726,17,1600,857,557,169,
42,"MUNICIPIUL BUCURESTI",403,179169,,414,0,"B-dul NICOLAE GRIGORESCU nr. 14 , Scoala Generala nr. 199","BUCURESTI SECTORUL 3",3,179169,1,1,1162,609,572,37,603,6,1400,791,466,137,
42,"MUNICIPIUL BUCURESTI",403,179169,,415,0,"B-dul NICOLAE GRIGORESCU nr. 14 , Scoala Generala nr. 199","BUCURESTI SECTORUL 3",3,179169,1,1,1397,656,608,48,638,18,1600,944,453,185,
42,"MUNICIPIUL BUCURESTI",403,179169,,416,0,"B-dul NICOLAE GRIGORESCU nr. 14 , Scoala Generala nr. 199","BUCURESTI SECTORUL 3",3,179169,1,1,1737,839,803,36,831,8,2000,1161,566,265,
42,"MUNICIPIUL BUCURESTI",403,179169,,417,0,"B-dul NICOLAE GRIGORESCU nr. 12 , Grup Scolar Constructii nr. 1","BUCURESTI SECTORUL 3",3,179169,1,1,1587,829,772,57,816,13,1902,1073,631,185,
42,"MUNICIPIUL BUCURESTI",403,179169,,418,0,"B-dul NICOLAE GRIGORESCU nr. 12 , Grup Scolar Constructii nr. 1","BUCURESTI SECTORUL 3",3,179169,1,1,1148,584,535,49,576,8,1400,816,468,108,
42,"MUNICIPIUL BUCURESTI",403,179169,,419,0,"B-dul NICOLAE GRIGORESCU nr. 12 , Grup Scolar Constructii nr. 1","BUCURESTI SECTORUL 3",3,179169,1,1,1118,667,553,114,648,19,1304,637,510,138,
42,"MUNICIPIUL BUCURESTI",403,179169,,420,0,"Str. ODOBESTI nr. 3 , Scoala Generala nr. 88","BUCURESTI SECTORUL 3",3,179169,1,1,1564,708,613,95,692,16,1900,1192,495,197,
42,"MUNICIPIUL BUCURESTI",403,179169,,421,0,"Str. ODOBESTI nr. 3 , Scoala Generala nr. 88","BUCURESTI SECTORUL 3",3,179169,1,1,1422,718,669,49,697,21,1700,982,549,148,
42,"MUNICIPIUL BUCURESTI",403,179169,,422,0,"Str. ODOBESTI nr. 3 , Scoala Generala nr. 88","BUCURESTI SECTORUL 3",3,179169,1,1,1781,973,882,91,960,13,2097,1124,773,187,
42,"MUNICIPIUL BUCURESTI",403,179169,,423,0,"Str. ODOBESTI nr. 3 , Scoala Generala nr. 88","BUCURESTI SECTORUL 3",3,179169,1,1,1338,810,712,98,785,25,1600,790,601,184,
42,"MUNICIPIUL BUCURESTI",403,179169,,424,0,"Str. ODOBESTI nr. 3 , Scoala Generala nr. 88","BUCURESTI SECTORUL 3",3,179169,1,1,1609,865,808,57,844,21,1900,1035,651,193,
42,"MUNICIPIUL BUCURESTI",403,179169,,425,0,"Str. ODOBESTI nr. 3 , Scoala Generala nr. 88","BUCURESTI SECTORUL 3",3,179169,1,1,1299,727,666,61,713,14,1500,773,562,151,
42,"MUNICIPIUL BUCURESTI",403,179169,,426,0,"Str. ODOBESTI nr. 3 , Scoala Generala nr. 88","BUCURESTI SECTORUL 3",3,179169,1,1,1976,996,935,61,970,26,2300,1304,731,239,
42,"MUNICIPIUL BUCURESTI",403,179169,,427,0,"B-dul ENERGETICIENILOR nr. 5 , Grup Scolar Constructii nr. 3","BUCURESTI SECTORUL 3",3,179169,1,1,1375,489,355,134,481,8,1596,1107,300,181,
42,"MUNICIPIUL BUCURESTI",403,179169,,428,0,"B-dul ENERGETICIENILOR nr. 5 , Grup Scolar Constructii nr. 3","BUCURESTI SECTORUL 3",3,179169,1,1,1535,635,580,55,627,8,1799,1164,439,188,
42,"MUNICIPIUL BUCURESTI",403,179169,,429,0,"B-dul ENERGETICIENILOR nr. 5 , Grup Scolar Constructii nr. 3","BUCURESTI SECTORUL 3",3,179169,1,1,1429,624,582,42,615,9,1700,1076,455,160,
42,"MUNICIPIUL BUCURESTI",403,179169,,430,0,"B-dul ENERGETICIENILOR nr. 5 , Grup Scolar Constructii nr. 3","BUCURESTI SECTORUL 3",3,179169,1,1,1093,513,455,58,511,2,1300,787,347,164,
42,"MUNICIPIUL BUCURESTI",403,179169,,431,0,"B-dul ENERGETICIENILOR nr. 5 , Grup Scolar Constructii nr. 3","BUCURESTI SECTORUL 3",3,179169,1,1,1465,655,602,53,640,15,1700,1045,431,209,
42,"MUNICIPIUL BUCURESTI",403,179169,,432,0,"B-dul ENERGETICIENILOR nr. 5 , Grup Scolar Constructii nr. 3","BUCURESTI SECTORUL 3",3,179169,1,1,1914,852,773,79,842,10,2300,1448,562,280,
42,"MUNICIPIUL BUCURESTI",403,179169,,433,0,"B-dul ENERGETICIENILOR nr. 5 , Grup Scolar Constructii nr. 3","BUCURESTI SECTORUL 3",3,179169,1,1,1255,623,461,162,614,9,1900,1277,459,155,
42,"MUNICIPIUL BUCURESTI",403,179169,,434,0,"Str. ISTRIEI nr. 19 , Scoala Generala nr. 54","BUCURESTI SECTORUL 3",3,179169,1,1,1360,654,601,53,640,14,1600,946,455,185,
42,"MUNICIPIUL BUCURESTI",403,179169,,435,0,"Str. ISTRIEI nr. 19 , Scoala Generala nr. 54","BUCURESTI SECTORUL 3",3,179169,1,1,1447,779,705,74,763,16,1700,921,598,165,
42,"MUNICIPIUL BUCURESTI",403,179169,,436,0,"Str. ISTRIEI nr. 19 , Scoala Generala nr. 54","BUCURESTI SECTORUL 3",3,179169,1,1,1261,745,676,69,732,13,1500,755,504,228,
42,"MUNICIPIUL BUCURESTI",403,179169,,437,0,"Str. ISTRIEI nr. 19 , Scoala Generala nr. 54","BUCURESTI SECTORUL 3",3,179169,1,1,1582,738,687,51,723,15,1900,1162,490,233,
42,"MUNICIPIUL BUCURESTI",403,179169,,438,0,"Str. ISTRIEI nr. 19 , Scoala Generala nr. 54","BUCURESTI SECTORUL 3",3,179169,1,1,1191,558,523,35,547,11,1400,842,339,208,
42,"MUNICIPIUL BUCURESTI",403,179169,,439,0,"Str. ISTRIEI nr. 19 , Scoala Generala nr. 54","BUCURESTI SECTORUL 3",3,179169,1,1,1176,545,506,39,545,0,1400,855,361,184,
42,"MUNICIPIUL BUCURESTI",403,179169,,440,0,"Str. ISTRIEI nr. 19 , Scoala Generala nr. 54","BUCURESTI SECTORUL 3",3,179169,1,1,1211,549,514,35,536,13,1404,855,369,167,
42,"MUNICIPIUL BUCURESTI",403,179169,,441,0,"B-dul ENERGETICIENILOR nr. 9 - 11 , Liceul DECEBAL","BUCURESTI SECTORUL 3",3,179169,1,1,1386,720,541,179,713,7,1600,880,486,227,
42,"MUNICIPIUL BUCURESTI",403,179169,,442,0,"B-dul ENERGETICIENILOR nr. 9 - 11 , Liceul DECEBAL","BUCURESTI SECTORUL 3",3,179169,1,1,1201,562,505,57,559,3,1400,838,376,183,
42,"MUNICIPIUL BUCURESTI",403,179169,,443,0,"B-dul ENERGETICIENILOR nr. 9 - 11 , Liceul DECEBAL","BUCURESTI SECTORUL 3",3,179169,1,1,1275,594,544,50,592,2,1500,906,392,200,
42,"MUNICIPIUL BUCURESTI",403,179169,,444,0,"B-dul ENERGETICIENILOR nr. 9 - 11 , Liceul DECEBAL","BUCURESTI SECTORUL 3",3,179169,1,1,1013,481,446,35,472,9,1200,719,339,133,
42,"MUNICIPIUL BUCURESTI",403,179169,,445,0,"B-dul ENERGETICIENILOR nr. 9 - 11 , Liceul DECEBAL","BUCURESTI SECTORUL 3",3,179169,1,1,1258,602,559,43,593,9,1400,798,392,201,
42,"MUNICIPIUL BUCURESTI",403,179169,,446,0,"B-dul ENERGETICIENILOR nr. 9 - 11 , Liceul DECEBAL","BUCURESTI SECTORUL 3",3,179169,1,1,1014,433,391,42,427,6,1200,767,275,152,
42,"MUNICIPIUL BUCURESTI",403,179169,,447,0,"B-dul ENERGETICIENILOR nr. 9 - 11 , Liceul DECEBAL","BUCURESTI SECTORUL 3",3,179169,1,1,1231,538,469,69,535,3,1500,962,300,235,
42,"MUNICIPIUL BUCURESTI",403,179169,,448,0,"Str. FIRIDEI nr. 2 , Scoala Generala nr. 89","BUCURESTI SECTORUL 3",3,179169,1,1,1829,925,862,63,915,10,2200,1275,692,223,
42,"MUNICIPIUL BUCURESTI",403,179169,,449,0,"Str. FIRIDEI nr. 2 , Scoala Generala nr. 89","BUCURESTI SECTORUL 3",3,179169,1,1,1618,683,606,77,675,8,1900,1217,494,181,
42,"MUNICIPIUL BUCURESTI",403,179169,,450,0,"Str. FIRIDEI nr. 2 , Scoala Generala nr. 89","BUCURESTI SECTORUL 3",3,179169,1,1,1974,893,757,136,878,15,2300,1407,559,319,
42,"MUNICIPIUL BUCURESTI",403,179169,,451,0,"Str. FIRIDEI nr. 2 , Scoala Generala nr. 89","BUCURESTI SECTORUL 3",3,179169,1,1,1808,884,755,129,870,14,2100,1216,623,247,
42,"MUNICIPIUL BUCURESTI",403,179169,,452,0,"Str. FIRIDEI nr. 2 , Scoala Generala nr. 89","BUCURESTI SECTORUL 3",3,179169,1,1,2035,818,744,74,795,23,2400,1582,610,185,
42,"MUNICIPIUL BUCURESTI",403,179169,,453,0,"Str. FUIORULUI nr. 9 , Liceul DANTE ALIGHERI","BUCURESTI SECTORUL 3",3,179169,1,1,1265,821,768,53,815,6,1900,1079,616,199,
42,"MUNICIPIUL BUCURESTI",403,179169,,454,0,"Str. FUIORULUI nr. 9 , Liceul DANTE ALIGHERI","BUCURESTI SECTORUL 3",3,179169,1,1,1606,783,752,31,771,12,1900,1117,569,202,
42,"MUNICIPIUL BUCURESTI",403,179169,,455,0,"Str. FUIORULUI nr. 9 , Liceul DANTE ALIGHERI","BUCURESTI SECTORUL 3",3,179169,1,1,1675,938,855,83,906,32,2000,1062,704,202,
42,"MUNICIPIUL BUCURESTI",403,179169,,456,0,"Str. FUIORULUI nr. 9 , Liceul DANTE ALIGHERI","BUCURESTI SECTORUL 3",3,179169,1,1,1249,720,644,76,703,17,1500,780,551,152,
42,"MUNICIPIUL BUCURESTI",403,179169,,457,0,"Str. FUIORULUI nr. 9 , Liceul DANTE ALIGHERI","BUCURESTI SECTORUL 3",3,179169,1,1,1062,725,506,219,715,10,1300,575,592,123,
42,"MUNICIPIUL BUCURESTI",403,179169,,458,0,"Str. LUNCA BRADULUI nr. 2 , Scoala Generala nr. 195","BUCURESTI SECTORUL 3",3,179169,1,1,1383,559,484,75,540,19,1600,1041,426,114,
42,"MUNICIPIUL BUCURESTI",403,179169,,459,0,"Str. LUNCA BRADULUI nr. 2 , Scoala Generala nr. 195","BUCURESTI SECTORUL 3",3,179169,1,1,1487,782,712,70,767,15,1800,1018,593,174,
42,"MUNICIPIUL BUCURESTI",403,179169,,460,0,"Str. LUNCA BRADULUI nr. 2 , Scoala Generala nr. 195","BUCURESTI SECTORUL 3",3,179169,1,1,1460,789,749,40,753,36,1700,911,632,121,
42,"MUNICIPIUL BUCURESTI",403,179169,,461,0,"Str. LUNCA BRADULUI nr. 2 , Scoala Generala nr. 195","BUCURESTI SECTORUL 3",3,179169,1,1,1372,729,673,56,708,21,1600,871,570,138,
42,"MUNICIPIUL BUCURESTI",403,179169,,462,0,"Str. LUNCA BRADULUI nr. 2 , Scoala Generala nr. 195","BUCURESTI SECTORUL 3",3,179169,1,1,1255,754,643,111,740,14,1500,746,625,115,
42,"MUNICIPIUL BUCURESTI",403,179169,,463,0,"Str. LUNCA BRADULUI nr. 2 , Scoala Generala nr. 195","BUCURESTI SECTORUL 3",3,179169,1,1,977,502,452,50,497,5,1200,698,410,87,
42,"MUNICIPIUL BUCURESTI",403,179169,,464,0,"Str. LUNCA BRADULUI nr. 2 , Scoala Generala nr. 195","BUCURESTI SECTORUL 3",3,179169,1,1,1021,614,553,61,605,9,1900,1286,468,137,
42,"MUNICIPIUL BUCURESTI",403,179169,,465,0,"B-dul THEODOR PALLADY nr. 26 , Grup Scolar de Chimie","BUCURESTI SECTORUL 3",3,179169,1,1,1504,709,598,111,700,9,1800,1091,495,205,
42,"MUNICIPIUL BUCURESTI",403,179169,,466,0,"B-dul THEODOR PALLADY nr. 26 , Grup Scolar de Chimie","BUCURESTI SECTORUL 3",3,179169,1,1,1271,721,594,127,714,7,1500,779,524,190,
42,"MUNICIPIUL BUCURESTI",403,179169,,467,0,"B-dul THEODOR PALLADY nr. 26 , Grup Scolar de Chimie","BUCURESTI SECTORUL 3",3,179169,1,1,1349,525,487,38,518,7,1600,1075,358,160,
42,"MUNICIPIUL BUCURESTI",403,179169,,468,0,"B-dul THEODOR PALLADY nr. 26 , Grup Scolar de Chimie","BUCURESTI SECTORUL 3",3,179169,1,1,1448,760,687,73,754,6,1700,940,567,187,
42,"MUNICIPIUL BUCURESTI",403,179169,,469,0,"B-dul THEODOR PALLADY nr. 26 , Grup Scolar de Chimie","BUCURESTI SECTORUL 3",3,179169,1,1,1630,723,660,63,714,9,1900,1177,534,180,
42,"MUNICIPIUL BUCURESTI",403,179169,,470,0,"B-dul THEODOR PALLADY nr. 26 , Grup Scolar de Chimie","BUCURESTI SECTORUL 3",3,179169,1,1,1186,714,586,128,701,13,1400,686,506,195,
42,"MUNICIPIUL BUCURESTI",403,179169,,471,0,"B-dul THEODOR PALLADY nr. 26 , Grup Scolar de Chimie","BUCURESTI SECTORUL 3",3,179169,1,1,1671,862,777,85,845,17,2007,1145,647,198,
42,"MUNICIPIUL BUCURESTI",403,179169,,472,0,"Al. VLAHITA nr. 1A , Scoala Generala nr. 92","BUCURESTI SECTORUL 3",3,179169,1,1,1471,742,637,105,730,12,1700,958,524,206,
42,"MUNICIPIUL BUCURESTI",403,179169,,473,0,"Al. VLAHITA nr. 1A , Scoala Generala nr. 92","BUCURESTI SECTORUL 3",3,179169,1,1,1458,814,621,193,806,8,1700,886,577,229,
42,"MUNICIPIUL BUCURESTI",403,179169,,474,0,"Al. VLAHITA nr. 1A , Scoala Generala nr. 92","BUCURESTI SECTORUL 3",3,179169,1,1,1171,490,459,31,483,7,1400,910,336,147,
42,"MUNICIPIUL BUCURESTI",403,179169,,475,0,"Al. VLAHITA nr. 1A , Scoala Generala nr. 92","BUCURESTI SECTORUL 3",3,179169,1,1,1664,765,712,53,758,7,2000,1235,574,184,
42,"MUNICIPIUL BUCURESTI",403,179169,,476,0,"Al. VLAHITA nr. 1A , Scoala Generala nr. 92","BUCURESTI SECTORUL 3",3,179169,1,1,1483,925,842,83,905,20,2100,1175,662,243,
42,"MUNICIPIUL BUCURESTI",403,179169,,477,0,"Al. VLAHITA nr. 1A , Scoala Generala nr. 92","BUCURESTI SECTORUL 3",3,179169,1,1,1687,850,681,169,836,14,1996,1146,575,261,
42,"MUNICIPIUL BUCURESTI",403,179169,,478,0,"Str. PREVEDERII nr. 19 , Scoala Generala nr. 20","BUCURESTI SECTORUL 3",3,179169,1,1,1480,750,705,45,733,12,1700,950,549,184,
42,"MUNICIPIUL BUCURESTI",403,179169,,479,0,"Str. PREVEDERII nr. 19 , Scoala Generala nr. 20","BUCURESTI SECTORUL 3",3,179169,1,1,1617,754,690,64,743,11,1900,1146,577,166,
42,"MUNICIPIUL BUCURESTI",403,179169,,480,0,"Str. PREVEDERII nr. 19 , Scoala Generala nr. 20","BUCURESTI SECTORUL 3",3,179169,1,1,1549,788,727,61,773,15,1800,1012,600,173,
42,"MUNICIPIUL BUCURESTI",403,179169,,481,0,"Str. PREVEDERII nr. 19 , Scoala Generala nr. 20","BUCURESTI SECTORUL 3",3,179169,1,1,1465,758,696,62,749,9,1700,942,516,233,
42,"MUNICIPIUL BUCURESTI",403,179169,,482,0,"Str. PREVEDERII nr. 19 , Scoala Generala nr. 20","BUCURESTI SECTORUL 3",3,179169,1,1,1465,750,680,70,734,16,1700,950,539,195,
42,"MUNICIPIUL BUCURESTI",403,179169,,483,0,"Str. PREVEDERII nr. 19 , Scoala Generala nr. 20","BUCURESTI SECTORUL 3",3,179169,1,1,1232,683,574,109,670,13,1500,817,480,190,
42,"MUNICIPIUL BUCURESTI",403,179169,,484,0,"Str. PREVEDERII nr. 19 , Scoala Generala nr. 20","BUCURESTI SECTORUL 3",3,179169,1,1,1250,534,383,151,531,3,1500,966,371,160,
42,"MUNICIPIUL BUCURESTI",403,179169,,485,0,"Str. PATULULUI nr. 2 , Scoala Generala nr. 112","BUCURESTI SECTORUL 3",3,179169,1,1,1412,721,640,81,706,15,1700,979,511,195,
42,"MUNICIPIUL BUCURESTI",403,179169,,486,0,"Str. PATULULUI nr. 2 , Scoala Generala nr. 112","BUCURESTI SECTORUL 3",3,179169,1,1,1626,819,713,106,792,20,1900,1081,564,228,
42,"MUNICIPIUL BUCURESTI",403,179169,,487,0,"Str. PATULULUI nr. 2 , Scoala Generala nr. 112","BUCURESTI SECTORUL 3",3,179169,1,1,1329,694,624,70,683,11,1600,906,508,175,
42,"MUNICIPIUL BUCURESTI",403,179169,,488,0,"Str. PATULULUI nr. 2 , Scoala Generala nr. 112","BUCURESTI SECTORUL 3",3,179169,1,1,1865,1069,884,185,1048,21,2200,1131,771,277,
42,"MUNICIPIUL BUCURESTI",403,179169,,489,0,"Str. PATULULUI nr. 2 , Scoala Generala nr. 112","BUCURESTI SECTORUL 3",3,179169,1,1,1879,942,870,72,918,24,2200,1258,672,246,
42,"MUNICIPIUL BUCURESTI",403,179169,,490,0,"Str. PATULULUI nr. 2 , Scoala Generala nr. 112","BUCURESTI SECTORUL 3",3,179169,1,1,1011,728,653,75,717,11,1800,1072,501,216,
42,"MUNICIPIUL BUCURESTI",403,179169,,491,0,"Str. PATULULUI nr. 2 , Scoala Generala nr. 112","BUCURESTI SECTORUL 3",3,179169,1,1,1525,819,729,90,801,18,1800,981,581,220,
42,"MUNICIPIUL BUCURESTI",403,179169,,492,0,"Str. PATULULUI nr. 2 , Scoala Generala nr. 112","BUCURESTI SECTORUL 3",3,179169,1,1,1548,618,567,51,603,15,1800,1182,387,216,
42,"MUNICIPIUL BUCURESTI",403,179169,,493,0,"Al. PERISORU nr. 4 , Scoala Generala nr. 149","BUCURESTI SECTORUL 3",3,179169,1,1,1615,926,835,91,907,19,1900,974,691,216,
42,"MUNICIPIUL BUCURESTI",403,179169,,494,0,"Al. PERISORU nr. 4 , Scoala Generala nr. 149","BUCURESTI SECTORUL 3",3,179169,1,1,1444,680,542,138,669,11,1700,1020,484,185,
42,"MUNICIPIUL BUCURESTI",403,179169,,495,0,"Al. PERISORU nr. 4 , Scoala Generala nr. 149","BUCURESTI SECTORUL 3",3,179169,1,1,1578,711,660,51,701,10,1900,1189,531,170,
42,"MUNICIPIUL BUCURESTI",403,179169,,496,0,"Al. PERISORU nr. 4 , Scoala Generala nr. 149","BUCURESTI SECTORUL 3",3,179169,1,1,1392,732,687,45,716,16,1600,868,538,178,
42,"MUNICIPIUL BUCURESTI",403,179169,,497,0,"Str. JEAN STERIADI nr. 17 , Scoala Generala nr. 82","BUCURESTI SECTORUL 3",3,179169,1,1,1509,749,719,30,738,11,1800,1051,573,165,
42,"MUNICIPIUL BUCURESTI",403,179169,,498,0,"Str. JEAN STERIADI nr. 17 , Scoala Generala nr. 82","BUCURESTI SECTORUL 3",3,179169,1,1,1548,804,747,57,769,13,1700,896,591,178,
42,"MUNICIPIUL BUCURESTI",403,179169,,499,0,"Str. JEAN STERIADI nr. 17 , Scoala Generala nr. 82","BUCURESTI SECTORUL 3",3,179169,1,1,1364,725,637,88,705,15,1600,875,523,182,
42,"MUNICIPIUL BUCURESTI",403,179169,,500,0,"Str. JEAN STERIADI nr. 17 , Scoala Generala nr. 82","BUCURESTI SECTORUL 3",3,179169,1,1,1347,758,683,75,741,17,1600,842,574,167,
42,"MUNICIPIUL BUCURESTI",403,179169,,501,0,"Str. JEAN STERIADI nr. 17 , Scoala Generala nr. 82","BUCURESTI SECTORUL 3",3,179169,1,1,1130,591,535,56,583,8,1300,709,447,136,
42,"MUNICIPIUL BUCURESTI",403,179169,,502,0,"Str. JEAN STERIADI nr. 17 , Scoala Generala nr. 82","BUCURESTI SECTORUL 3",3,179169,1,1,1559,825,780,45,815,10,1800,975,614,201,
42,"MUNICIPIUL BUCURESTI",403,179169,,503,0,"Str. GURA IALOMITEI nr. 20 , Scoala Generala nr. 116","BUCURESTI SECTORUL 3",3,179169,1,1,1527,724,661,63,712,12,1800,1076,542,170,
42,"MUNICIPIUL BUCURESTI",403,179169,,504,0,"Str. GURA IALOMITEI nr. 20 , Scoala Generala nr. 116","BUCURESTI SECTORUL 3",3,179169,1,1,1933,880,841,39,859,21,2300,1420,616,243,
42,"MUNICIPIUL BUCURESTI",403,179169,,505,0,"Str. GURA IALOMITEI nr. 20 , Scoala Generala nr. 116","BUCURESTI SECTORUL 3",3,179169,1,1,1855,842,782,60,833,9,2200,1358,560,273,
42,"MUNICIPIUL BUCURESTI",403,179169,,506,0,"Str. GURA IALOMITEI nr. 20 , Scoala Generala nr. 116","BUCURESTI SECTORUL 3",3,179169,1,1,1845,862,798,64,852,10,2200,1338,578,274,
42,"MUNICIPIUL BUCURESTI",403,179169,,507,0,"Str. GURA IALOMITEI nr. 20 , Scoala Generala nr. 116","BUCURESTI SECTORUL 3",3,179169,1,1,1485,718,648,70,711,7,1800,1082,552,159,
42,"MUNICIPIUL BUCURESTI",403,179169,,508,0,"Str. GURA IALOMITEI nr. 20 , Scoala Generala nr. 116","BUCURESTI SECTORUL 3",3,179169,1,1,1646,639,570,69,631,8,1900,1261,483,148,
42,"MUNICIPIUL BUCURESTI",403,179169,,509,0,"B-dul 1 DECEMBRIE 1918 nr. 34 , Scoala Generala nr. 22","BUCURESTI SECTORUL 3",3,179169,1,1,1259,587,538,49,572,15,1500,913,448,124,
42,"MUNICIPIUL BUCURESTI",403,179169,,510,0,"B-dul 1 DECEMBRIE 1918 nr. 34 , Scoala Generala nr. 22","BUCURESTI SECTORUL 3",3,179169,1,1,1710,784,724,60,772,12,2000,1216,540,232,
42,"MUNICIPIUL BUCURESTI",403,179169,,511,0,"B-dul 1 DECEMBRIE 1918 nr. 34 , Scoala Generala nr. 22","BUCURESTI SECTORUL 3",3,179169,1,1,1563,769,703,66,761,8,1900,1131,514,247,
42,"MUNICIPIUL BUCURESTI",403,179169,,512,0,"B-dul 1 DECEMBRIE 1918 nr. 34 , Scoala Generala nr. 22","BUCURESTI SECTORUL 3",3,179169,1,1,1633,791,692,99,776,15,1916,1125,512,264,
42,"MUNICIPIUL BUCURESTI",403,179169,,513,0,"B-dul 1 DECEMBRIE 1918 nr. 34 , Scoala Generala nr. 22","BUCURESTI SECTORUL 3",3,179169,1,1,1896,895,830,65,887,8,2200,1305,587,300,
42,"MUNICIPIUL BUCURESTI",403,179169,,514,0,"B-dul 1 DECEMBRIE 1918 nr. 34 , Scoala Generala nr. 22","BUCURESTI SECTORUL 3",3,179169,1,1,1707,880,758,122,870,9,2000,1120,601,269,
42,"MUNICIPIUL BUCURESTI",403,179169,,515,0,"Str. POSTAVARULUI nr. 13 , Scoala Generala nr. 200","BUCURESTI SECTORUL 3",3,179169,1,1,1652,940,842,98,929,11,2400,1460,732,197,
42,"MUNICIPIUL BUCURESTI",403,179169,,516,0,"Str. POSTAVARULUI nr. 13 , Scoala Generala nr. 200","BUCURESTI SECTORUL 3",3,179169,1,1,1370,749,656,93,736,13,1600,851,609,127,
42,"MUNICIPIUL BUCURESTI",403,179169,,517,0,"Str. POSTAVARULUI nr. 13 , Scoala Generala nr. 200","BUCURESTI SECTORUL 3",3,179169,1,1,1218,642,584,58,621,21,1400,758,521,100,
42,"MUNICIPIUL BUCURESTI",403,179169,,518,0,"Str. POSTAVARULUI nr. 13 , Scoala Generala nr. 200","BUCURESTI SECTORUL 3",3,179169,1,1,1708,714,645,69,701,13,2000,1286,497,204,
42,"MUNICIPIUL BUCURESTI",403,179169,,519,0,"Str. POSTAVARULUI nr. 13 , Scoala Generala nr. 200","BUCURESTI SECTORUL 3",3,179169,1,1,1547,773,733,40,757,15,1798,1025,578,179,
42,"MUNICIPIUL BUCURESTI",403,179169,,520,0,"Str. POSTAVARULUI nr. 13 , Scoala Generala nr. 200","BUCURESTI SECTORUL 3",3,179169,1,1,1634,674,626,48,657,13,1900,1226,440,217,
42,"MUNICIPIUL BUCURESTI",403,179169,,521,0,"Str. POSTAVARULUI nr. 13 , Scoala Generala nr. 200","BUCURESTI SECTORUL 3",3,179169,1,1,1067,476,444,32,469,7,1300,824,308,161,
42,"MUNICIPIUL BUCURESTI",403,179169,,522,0,"Str. COZLA nr. 1 , Scoala Generala nr. 196","BUCURESTI SECTORUL 3",3,179169,1,1,1328,646,574,72,638,8,1600,954,496,142,
42,"MUNICIPIUL BUCURESTI",403,179169,,523,0,"Str. COZLA nr. 1 , Scoala Generala nr. 196","BUCURESTI SECTORUL 3",3,179169,1,1,1089,596,560,36,582,14,1300,704,462,120,
42,"MUNICIPIUL BUCURESTI",403,179169,,524,0,"Str. COZLA nr. 1 , Scoala Generala nr. 196","BUCURESTI SECTORUL 3",3,179169,1,1,1730,910,856,54,897,13,2004,1094,691,206,
42,"MUNICIPIUL BUCURESTI",403,179169,,525,0,"Str. COZLA nr. 1 , Scoala Generala nr. 196","BUCURESTI SECTORUL 3",3,179169,1,1,1229,670,625,45,651,19,1500,830,523,128,
42,"MUNICIPIUL BUCURESTI",403,179169,,526,0,"Str. COZLA nr. 1 , Scoala Generala nr. 196","BUCURESTI SECTORUL 3",3,179169,1,1,1119,523,472,51,512,11,1300,777,408,104,
42,"MUNICIPIUL BUCURESTI",403,179169,,527,0,"Str. COZLA nr. 1 , Scoala Generala nr. 196","BUCURESTI SECTORUL 3",3,179169,1,1,1726,857,820,37,842,15,2000,1143,658,184,
42,"MUNICIPIUL BUCURESTI",403,179169,,528,0,"Str. COZLA nr. 1 , Scoala Generala nr. 196","BUCURESTI SECTORUL 3",3,179169,1,1,2053,993,917,76,980,13,2400,1407,712,268,
42,"MUNICIPIUL BUCURESTI",403,179169,,529,0,"Al. BARAJUL DUNARII nr. 5 , Liceul ALEXANDRU IOAN CUZA","BUCURESTI SECTORUL 3",3,179169,1,1,1391,695,587,108,682,13,1600,905,561,121,
42,"MUNICIPIUL BUCURESTI",403,179169,,530,0,"Al. BARAJUL DUNARII nr. 5 , Liceul ALEXANDRU IOAN CUZA","BUCURESTI SECTORUL 3",3,179169,1,1,1385,739,659,80,721,18,1600,861,576,145,
42,"MUNICIPIUL BUCURESTI",403,179169,,531,0,"Al. BARAJUL DUNARII nr. 5 , Liceul ALEXANDRU IOAN CUZA","BUCURESTI SECTORUL 3",3,179169,1,1,1347,754,704,50,740,14,1600,846,556,184,
42,"MUNICIPIUL BUCURESTI",403,179169,,532,0,"Al. BARAJUL DUNARII nr. 5 , Liceul ALEXANDRU IOAN CUZA","BUCURESTI SECTORUL 3",3,179169,1,1,1416,815,776,39,792,23,1700,885,605,187,
42,"MUNICIPIUL BUCURESTI",403,179169,,533,0,"Al. BARAJUL DUNARII nr. 5 , Liceul ALEXANDRU IOAN CUZA","BUCURESTI SECTORUL 3",3,179169,1,1,1799,938,894,44,922,16,2100,1162,687,235,
42,"MUNICIPIUL BUCURESTI",403,179169,,534,0,"Al. BARAJUL DUNARII nr. 5 , Liceul ALEXANDRU IOAN CUZA","BUCURESTI SECTORUL 3",3,179169,1,1,1526,771,736,35,756,15,1802,1031,593,163,
42,"MUNICIPIUL BUCURESTI",403,179169,,535,0,"Al. BARAJUL DUNARII nr. 5 , Liceul ALEXANDRU IOAN CUZA","BUCURESTI SECTORUL 3",3,179169,1,1,1395,694,644,50,682,12,1702,1008,507,175,
42,"MUNICIPIUL BUCURESTI",403,179169,,536,0,"Al. BARAJUL ROVINARI nr. 1 , Scoala Generala nr. 21","BUCURESTI SECTORUL 3",3,179169,1,1,1813,829,771,58,818,11,2100,1271,645,173,
42,"MUNICIPIUL BUCURESTI",403,179169,,537,0,"Al. BARAJUL ROVINARI nr. 1 , Scoala Generala nr. 21","BUCURESTI SECTORUL 3",3,179169,1,1,1952,886,822,64,874,12,2300,1414,690,184,
42,"MUNICIPIUL BUCURESTI",403,179169,,538,0,"Al. BARAJUL ROVINARI nr. 1 , Scoala Generala nr. 21","BUCURESTI SECTORUL 3",3,179169,1,1,1679,888,828,60,871,17,2000,1112,647,224,
42,"MUNICIPIUL BUCURESTI",403,179169,,539,0,"Al. BARAJ IEZER nr. 1 , Scoala Generala nr. 94","BUCURESTI SECTORUL 3",3,179169,1,1,1045,562,476,86,552,10,1200,638,428,124,
42,"MUNICIPIUL BUCURESTI",403,179169,,540,0,"Al. BARAJ IEZER nr. 1 , Scoala Generala nr. 94","BUCURESTI SECTORUL 3",3,179169,1,1,1267,719,631,88,699,20,1500,781,595,104,
42,"MUNICIPIUL BUCURESTI",403,179169,,541,0,"Al. BARAJ IEZER nr. 1 , Scoala Generala nr. 94","BUCURESTI SECTORUL 3",3,179169,1,1,1639,633,582,51,620,13,1900,1267,459,161,
42,"MUNICIPIUL BUCURESTI",403,179169,,542,0,"Str. MAGNETULUI nr. 1 - 3 , Scoala Generala nr. 67","BUCURESTI SECTORUL 3",3,179169,1,1,1500,776,583,193,764,12,1800,1024,533,231,
42,"MUNICIPIUL BUCURESTI",403,179169,,543,0,"Sos. GARII CATELU nr. 50 , Scoala Generala nr. 78","BUCURESTI SECTORUL 3",3,179169,1,1,1695,780,748,32,770,10,2000,1220,556,214,
42,"MUNICIPIUL BUCURESTI",403,179169,,544,0,"Sos. GARII CATELU nr. 50 , Scoala Generala nr. 78","BUCURESTI SECTORUL 3",3,179169,1,1,1780,789,735,54,781,8,2100,1311,565,216,
42,"MUNICIPIUL BUCURESTI",403,179169,,545,0,"Sos. GARII CATELU nr. 50 , Scoala Generala nr. 78","BUCURESTI SECTORUL 3",3,179169,1,1,1513,703,637,66,694,9,1800,1097,512,182,
42,"MUNICIPIUL BUCURESTI",403,179169,,546,0,"Sos. GARII CATELU nr. 130 , Scoala Generala nr. 47","BUCURESTI SECTORUL 3",3,179169,1,1,1648,709,646,63,700,9,1896,1187,483,217,
42,"MUNICIPIUL BUCURESTI",403,179169,,547,0,"Sos. GARII CATELU nr. 130 , Scoala Generala nr. 47","BUCURESTI SECTORUL 3",3,179169,1,1,1396,616,545,71,610,6,1600,984,417,193,
42,"MUNICIPIUL BUCURESTI",403,179169,,548,0,"Sos. GARII CATELU nr. 130 , Scoala Generala nr. 47","BUCURESTI SECTORUL 3",3,179169,1,1,1714,652,610,42,646,6,2000,1348,465,181,
42,"MUNICIPIUL BUCURESTI",403,179169,,549,0,"Str. INDUSTRIILOR nr. 46 , Scoala Generala nr. 55","BUCURESTI SECTORUL 3",3,179169,1,1,1490,687,647,40,677,9,1800,1113,472,205,
42,"MUNICIPIUL BUCURESTI",403,179169,,550,0,"Str. INDUSTRIILOR nr. 46 , Scoala Generala nr. 55","BUCURESTI SECTORUL 3",3,179169,1,1,1770,704,645,59,695,9,2100,1396,465,230,
42,"MUNICIPIUL BUCURESTI",403,179169,,551,0,"Str. INDUSTRIILOR nr. 46 , Scoala Generala nr. 55","BUCURESTI SECTORUL 3",3,179169,1,1,1316,707,542,165,702,5,1600,893,512,190,
42,"MUNICIPIUL BUCURESTI",403,179169,,552,0,"Str. INDUSTRIILOR nr. 46 , Scoala Generala nr. 55","BUCURESTI SECTORUL 3",3,179169,1,1,1533,674,578,96,666,8,1800,1126,493,173,
42,"MUNICIPIUL BUCURESTI",403,179169,,553,0,"Str. LUCRETIU PATRASCANU nr. 3 , Grup Scolar Industrie Usoara","BUCURESTI SECTORUL 3",3,179169,1,1,2010,1043,883,160,1024,19,2400,1357,722,302,
42,"MUNICIPIUL BUCURESTI",403,179169,,554,0,"Str. LUCRETIU PATRASCANU nr. 3 , Grup Scolar Industrie Usoara","BUCURESTI SECTORUL 3",3,179169,1,1,1656,955,782,173,938,15,1996,1041,738,200,
42,"MUNICIPIUL BUCURESTI",403,179169,,555,0,"Str. LUCRETIU PATRASCANU nr. 3 , Grup Scolar Industrie Usoara","BUCURESTI SECTORUL 3",3,179169,1,1,1675,838,746,92,823,15,2000,1162,649,174,
42,"MUNICIPIUL BUCURESTI",403,179169,,556,0,"Al. BUDACU nr. 4 , Scoala Generala nr. 16","BUCURESTI SECTORUL 3",3,179169,1,1,1577,838,729,109,814,24,1900,1062,639,175,
42,"MUNICIPIUL BUCURESTI",403,179169,,557,0,"Al. BUDACU nr. 4 , Scoala Generala nr. 16","BUCURESTI SECTORUL 3",3,179169,1,1,1225,706,630,76,701,5,1598,892,536,165,
42,"MUNICIPIUL BUCURESTI",403,179169,,558,0,"Al. BUDACU nr. 4 , Scoala Generala nr. 16","BUCURESTI SECTORUL 3",3,179169,1,1,1561,804,749,55,785,19,1800,996,650,135,
42,"MUNICIPIUL BUCURESTI",403,179178,,559,0,"Str. GEORGE GEORGESCU nr. 2 , Liceul Teoretic MIHAI EMINESCU","BUCURESTI SECTORUL 4",4,179178,1,1,1357,858,722,136,842,14,1800,942,683,159,
42,"MUNICIPIUL BUCURESTI",403,179178,,560,0,"Str. GEORGE GEORGESCU nr. 2 , Liceul Teoretic MIHAI EMINESCU","BUCURESTI SECTORUL 4",4,179178,1,1,1476,721,603,118,707,14,1800,1079,531,176,
42,"MUNICIPIUL BUCURESTI",403,179178,,561,0,"Str. GEORGE GEORGESCU nr. 2 , Liceul Teoretic MIHAI EMINESCU","BUCURESTI SECTORUL 4",4,179178,1,1,1296,540,501,39,530,10,1600,1060,418,112,
42,"MUNICIPIUL BUCURESTI",403,179178,,562,0,"Str. GRAMONT nr. 25 , Gradinita de copii nr. 224","BUCURESTI SECTORUL 4",4,179178,1,1,1266,596,508,88,582,14,1600,1004,444,138,
42,"MUNICIPIUL BUCURESTI",403,179178,,563,0,"Str. GRAMONT nr. 25 , Gradinita de copii nr. 224","BUCURESTI SECTORUL 4",4,179178,1,1,1349,690,636,54,670,20,1800,1110,514,156,
42,"MUNICIPIUL BUCURESTI",403,179178,,564,0,"Cal. SERBAN VODA nr. 62-64 , Scoala nr. 74 ENACHITA VACARESCU","BUCURESTI SECTORUL 4",4,179178,1,1,1396,741,663,78,712,29,1800,1059,585,127,
42,"MUNICIPIUL BUCURESTI",403,179178,,565,0,"Cal. SERBAN VODA nr. 62-64 , Scoala nr. 74 ENACHITA VACARESCU","BUCURESTI SECTORUL 4",4,179178,1,1,1443,801,668,133,775,26,1800,999,592,183,
42,"MUNICIPIUL BUCURESTI",403,179178,,566,0,"Cal. SERBAN VODA nr. 62-64 , Scoala nr. 74 ENACHITA VACARESCU","BUCURESTI SECTORUL 4",4,179178,1,1,1367,769,677,92,754,15,1800,1031,607,147,
42,"MUNICIPIUL BUCURESTI",403,179178,,567,0,"Cal. SERBAN VODA nr. 62-64 , Scoala nr. 74 ENACHITA VACARESCU","BUCURESTI SECTORUL 4",4,179178,1,1,1441,698,661,37,683,15,1799,1101,527,156,
42,"MUNICIPIUL BUCURESTI",403,179178,,568,0,"Str. CUZA VODA nr. 51 , Scoala nr. 79","BUCURESTI SECTORUL 4",4,179178,1,1,1280,763,686,77,747,16,1800,1037,606,141,
42,"MUNICIPIUL BUCURESTI",403,179178,,569,0,"Str. CUZA VODA nr. 51 , Scoala nr. 79","BUCURESTI SECTORUL 4",4,179178,1,1,1338,879,734,145,842,37,1800,921,673,169,
42,"MUNICIPIUL BUCURESTI",403,179178,,570,0,"Str. CUZA VODA nr. 51 , Scoala nr. 79","BUCURESTI SECTORUL 4",4,179178,1,1,1244,633,519,114,628,5,1600,967,474,154,
42,"MUNICIPIUL BUCURESTI",403,179178,,571,0,"Str. C-TIN RADULESCU MOTRU nr. 51 , Liceul Teoretic ION CREANGA","BUCURESTI SECTORUL 4",4,179178,1,1,1317,573,494,79,563,10,1601,1028,435,128,
42,"MUNICIPIUL BUCURESTI",403,179178,,572,0,"Str. C-TIN RADULESCU MOTRU nr. 51 , Liceul Teoretic ION CREANGA","BUCURESTI SECTORUL 4",4,179178,1,1,1337,723,675,48,708,15,1600,877,569,139,
42,"MUNICIPIUL BUCURESTI",403,179178,,573,0,"Cal. SERBAN VODA nr. 280 , Grupul Scolar GRIGORE CERCHEZ","BUCURESTI SECTORUL 4",4,179178,1,1,1250,739,650,89,720,19,1605,866,534,186,
42,"MUNICIPIUL BUCURESTI",403,179178,,574,0,"Cal. SERBAN VODA nr. 280 , Grupul Scolar GRIGORE CERCHEZ","BUCURESTI SECTORUL 4",4,179178,1,1,1310,673,592,81,659,11,1600,927,483,176,
42,"MUNICIPIUL BUCURESTI",403,179178,,575,0,"Cal. SERBAN VODA nr. 167 , Liceul Teoretic GHEORGHE SINCAI","BUCURESTI SECTORUL 4",4,179178,1,1,1395,799,643,156,783,16,2000,1201,613,170,
42,"MUNICIPIUL BUCURESTI",403,179178,,576,0,"Cal. SERBAN VODA nr. 167 , Liceul Teoretic GHEORGHE SINCAI","BUCURESTI SECTORUL 4",4,179178,1,1,1118,719,553,166,696,23,1600,881,541,155,
42,"MUNICIPIUL BUCURESTI",403,179178,,577,0,"Cal. SERBAN VODA nr. 167 , Liceul Teoretic GHEORGHE SINCAI","BUCURESTI SECTORUL 4",4,179178,1,1,1569,934,867,67,915,19,2000,1066,743,172,
42,"MUNICIPIUL BUCURESTI",403,179178,,578,0,"Cal. SERBAN VODA nr. 167 , Liceul Teoretic GHEORGHE SINCAI","BUCURESTI SECTORUL 4",4,179178,1,1,1379,840,777,63,817,23,1799,959,654,163,
42,"MUNICIPIUL BUCURESTI",403,179178,,579,0,"Cal. SERBAN VODA nr. 167 , Liceul Teoretic GHEORGHE SINCAI","BUCURESTI SECTORUL 4",4,179178,1,1,1714,937,878,59,922,14,2202,1265,746,176,
42,"MUNICIPIUL BUCURESTI",403,179178,,580,0,"Str. VIORELE nr. 7 , Scoala nr. 97","BUCURESTI SECTORUL 4",4,179178,1,1,1267,671,641,30,656,15,1600,929,538,118,
42,"MUNICIPIUL BUCURESTI",403,179178,,581,0,"Str. VIORELE nr. 7 , Scoala nr. 97","BUCURESTI SECTORUL 4",4,179178,1,1,1607,833,798,35,808,25,2008,1175,656,152,
42,"MUNICIPIUL BUCURESTI",403,179178,,582,0,"Str. VIORELE nr. 7 , Scoala nr. 97","BUCURESTI SECTORUL 4",4,179178,1,1,1285,800,692,108,783,17,1600,800,623,160,
42,"MUNICIPIUL BUCURESTI",403,179178,,583,0,"Str. VIORELE nr. 7 , Scoala nr. 97","BUCURESTI SECTORUL 4",4,179178,1,1,1310,746,638,108,722,24,1600,854,535,187,
42,"MUNICIPIUL BUCURESTI",403,179178,,584,0,"Str. VIORELE nr. 7 , Scoala nr. 97","BUCURESTI SECTORUL 4",4,179178,1,1,1522,825,733,92,805,20,1995,1170,601,204,
42,"MUNICIPIUL BUCURESTI",403,179178,,585,0,"Str. V.V.STANCIU nr. 6 , Grupul Scolar PETRU RARES","BUCURESTI SECTORUL 4",4,179178,1,1,1129,615,571,44,600,15,1408,793,453,147,
42,"MUNICIPIUL BUCURESTI",403,179178,,586,0,"Str. V.V.STANCIU nr. 6 , Grupul Scolar PETRU RARES","BUCURESTI SECTORUL 4",4,179178,1,1,1228,672,605,67,661,11,1593,921,500,161,
42,"MUNICIPIUL BUCURESTI",403,179178,,587,0,"Str. V.V.STANCIU nr. 6 , Grupul Scolar PETRU RARES","BUCURESTI SECTORUL 4",4,179178,1,1,1190,632,589,43,620,12,1600,968,478,142,
42,"MUNICIPIUL BUCURESTI",403,179178,,588,0,"Str. V.V.STANCIU nr. 6 , Grupul Scolar PETRU RARES","BUCURESTI SECTORUL 4",4,179178,1,1,1042,576,510,66,559,17,1400,824,435,124,
42,"MUNICIPIUL BUCURESTI",403,179178,,589,0,"Cal. VACARESTI nr. 296 , Scoala nr. 100 ANDREI SAGUNA","BUCURESTI SECTORUL 4",4,179178,1,1,1531,805,736,69,782,23,2000,1195,612,170,
42,"MUNICIPIUL BUCURESTI",403,179178,,590,0,"Cal. VACARESTI nr. 296 , Scoala nr. 100 ANDREI SAGUNA","BUCURESTI SECTORUL 4",4,179178,1,1,1546,833,763,70,823,10,2000,1167,615,208,
42,"MUNICIPIUL BUCURESTI",403,179178,,591,0,"Cal. VACARESTI nr. 296 , Scoala nr. 100 ANDREI SAGUNA","BUCURESTI SECTORUL 4",4,179178,1,1,1449,669,621,48,661,8,1800,1131,495,166,
42,"MUNICIPIUL BUCURESTI",403,179178,,592,0,"Cal. VACARESTI nr. 296 , Scoala nr. 100 ANDREI SAGUNA","BUCURESTI SECTORUL 4",4,179178,1,1,1477,815,750,65,802,13,1799,984,633,169,
42,"MUNICIPIUL BUCURESTI",403,179178,,593,0,"Cal. VACARESTI nr. 296 , Scoala nr. 100 ANDREI SAGUNA","BUCURESTI SECTORUL 4",4,179178,1,1,1364,742,693,49,729,13,1794,1052,562,167,
42,"MUNICIPIUL BUCURESTI",403,179178,,594,0,"Str. MARTISOR nr. 39 , Scoala nr. 120 MARTISOR","BUCURESTI SECTORUL 4",4,179178,1,1,1833,946,823,123,926,20,2200,1254,685,241,
42,"MUNICIPIUL BUCURESTI",403,179178,,595,0,"Str. MARTISOR nr. 39 , Scoala nr. 120 MARTISOR","BUCURESTI SECTORUL 4",4,179178,1,1,1379,726,642,84,704,17,1802,1076,542,162,
42,"MUNICIPIUL BUCURESTI",403,179178,,596,0,"Str. MARTISOR nr. 39 , Scoala nr. 120 MARTISOR","BUCURESTI SECTORUL 4",4,179178,1,1,1428,678,628,50,664,14,1800,1122,454,210,
42,"MUNICIPIUL BUCURESTI",403,179178,,597,0,"Str. MARTISOR nr. 39 , Scoala nr. 120 MARTISOR","BUCURESTI SECTORUL 4",4,179178,1,1,1468,660,634,26,643,17,1800,1140,447,196,
42,"MUNICIPIUL BUCURESTI",403,179178,,598,0,"Str. MARTISOR nr. 39 , Scoala nr. 120 MARTISOR","BUCURESTI SECTORUL 4",4,179178,1,1,1458,693,656,37,676,17,1800,1107,523,153,
42,"MUNICIPIUL BUCURESTI",403,179178,,599,0,"Str. FAGETULUI nr. 28 , Gradinita nr. 27","BUCURESTI SECTORUL 4",4,179178,1,1,1298,600,555,45,590,10,1600,1000,418,172,
42,"MUNICIPIUL BUCURESTI",403,179178,,600,0,"Str. FAGETULUI nr. 28 , Gradinita nr. 27","BUCURESTI SECTORUL 4",4,179178,1,1,1281,650,600,50,644,6,1600,950,465,179,
42,"MUNICIPIUL BUCURESTI",403,179178,,601,0,"Str. STOIAN MILITARU nr. 72 , Scoala nr. 111 GEORGE BACOVIA","BUCURESTI SECTORUL 4",4,179178,1,1,1786,893,767,126,879,14,2200,1307,609,270,
42,"MUNICIPIUL BUCURESTI",403,179178,,602,0,"Str. STOIAN MILITARU nr. 72 , Scoala nr. 111 GEORGE BACOVIA","BUCURESTI SECTORUL 4",4,179178,1,1,1745,840,785,55,818,22,2200,1360,601,217,
42,"MUNICIPIUL BUCURESTI",403,179178,,603,0,"Str. STOIAN MILITARU nr. 72 , Scoala nr. 111 GEORGE BACOVIA","BUCURESTI SECTORUL 4",4,179178,1,1,1786,800,730,70,790,10,2200,1400,547,243,
42,"MUNICIPIUL BUCURESTI",403,179178,,604,0,"Str. STOIAN MILITARU nr. 72 , Scoala nr. 111 GEORGE BACOVIA","BUCURESTI SECTORUL 4",4,179178,1,1,1881,982,864,118,968,14,2200,1218,726,242,
42,"MUNICIPIUL BUCURESTI",403,179178,,605,0,"Str. STOIAN MILITARU nr. 72 , Scoala nr. 111 GEORGE BACOVIA","BUCURESTI SECTORUL 4",4,179178,1,1,1834,903,810,93,885,18,2204,1301,644,241,
42,"MUNICIPIUL BUCURESTI",403,179178,,606,0,"Str. STOIAN MILITARU nr. 95-97 , Gradinita nr. 263","BUCURESTI SECTORUL 4",4,179178,1,1,1311,824,702,122,811,13,1600,776,626,185,
42,"MUNICIPIUL BUCURESTI",403,179178,,607,0,"Str. STOIAN MILITARU nr. 95-97 , Gradinita nr. 263","BUCURESTI SECTORUL 4",4,179178,1,1,1380,814,701,113,803,11,1800,986,602,201,
42,"MUNICIPIUL BUCURESTI",403,179178,,608,0,"Str. IMPARATUL TRAIAN nr. 46 , Gradinita nr. 261","BUCURESTI SECTORUL 4",4,179178,1,1,1912,891,818,73,880,11,2400,1509,641,239,
42,"MUNICIPIUL BUCURESTI",403,179178,,609,0,"Str. IMPARATUL TRAIAN nr. 46 , Gradinita nr. 261","BUCURESTI SECTORUL 4",4,179178,1,1,1783,829,782,47,817,12,2200,1371,585,232,
42,"MUNICIPIUL BUCURESTI",403,179178,,610,0,"Str. IMPARATUL TRAIAN nr. 46 , Gradinita nr. 261","BUCURESTI SECTORUL 4",4,179178,1,1,1785,757,656,101,748,9,2200,1443,457,291,
42,"MUNICIPIUL BUCURESTI",403,179178,,611,0,"Str. NITU VASILE nr. 16 , Scoala nr. 190 SCOALA DE SUD","BUCURESTI SECTORUL 4",4,179178,1,1,2427,1300,1141,159,1274,22,2801,1501,944,330,
42,"MUNICIPIUL BUCURESTI",403,179178,,612,0,"Str. NITU VASILE nr. 16 , Scoala nr. 190 SCOALA DE SUD","BUCURESTI SECTORUL 4",4,179178,1,1,1303,743,636,107,732,11,1600,857,544,188,
42,"MUNICIPIUL BUCURESTI",403,179178,,613,0,"Str. NITU VASILE nr. 16 , Scoala nr. 190 SCOALA DE SUD","BUCURESTI SECTORUL 4",4,179178,1,1,1301,584,531,53,572,12,1600,1016,404,168,
42,"MUNICIPIUL BUCURESTI",403,179178,,614,0,"Str. NITU VASILE nr. 16 , Scoala nr. 190 SCOALA DE SUD","BUCURESTI SECTORUL 4",4,179178,1,1,1453,633,591,42,615,18,1800,1167,425,190,
42,"MUNICIPIUL BUCURESTI",403,179178,,615,0,"Str. NITU VASILE nr. 16 , Scoala nr. 190 SCOALA DE SUD","BUCURESTI SECTORUL 4",4,179178,1,1,1356,700,660,40,691,9,1800,1100,482,209,
42,"MUNICIPIUL BUCURESTI",403,179178,,616,0,"Str. NITU VASILE nr. 16 , Scoala nr. 190 SCOALA DE SUD","BUCURESTI SECTORUL 4",4,179178,1,1,1547,820,737,83,796,24,2004,1184,588,208,
42,"MUNICIPIUL BUCURESTI",403,179178,,617,0,"Str. NITU VASILE nr. 16 , Scoala nr. 190 SCOALA DE SUD","BUCURESTI SECTORUL 4",4,179178,1,1,981,493,430,63,483,10,1400,907,348,135,
42,"MUNICIPIUL BUCURESTI",403,179178,,618,0,"Str. REZONANTEI nr. 2 , Scoala nr. 96","BUCURESTI SECTORUL 4",4,179178,1,1,1023,572,535,37,564,8,1400,828,430,134,
42,"MUNICIPIUL BUCURESTI",403,179178,,619,0,"Str. REZONANTEI nr. 2 , Scoala nr. 96","BUCURESTI SECTORUL 4",4,179178,1,1,1292,627,572,55,618,9,1600,973,470,148,
42,"MUNICIPIUL BUCURESTI",403,179178,,620,0,"Str. REZONANTEI nr. 2 , Scoala nr. 96","BUCURESTI SECTORUL 4",4,179178,1,1,1250,617,567,50,605,12,1600,983,473,132,
42,"MUNICIPIUL BUCURESTI",403,179178,,621,0,"Str. REZONANTEI nr. 2 , Scoala nr. 96","BUCURESTI SECTORUL 4",4,179178,1,1,1771,887,778,109,873,14,2200,1313,609,264,
42,"MUNICIPIUL BUCURESTI",403,179178,,622,0,"Str. REZONANTEI nr. 2 , Scoala nr. 96","BUCURESTI SECTORUL 4",4,179178,1,1,1312,712,653,59,694,18,1600,888,523,171,
42,"MUNICIPIUL BUCURESTI",403,179178,,623,0,"Str. PETRE TUTEA nr. 3 , Scoala nr. 109","BUCURESTI SECTORUL 4",4,179178,1,1,1466,561,486,75,556,5,1800,1239,362,194,
42,"MUNICIPIUL BUCURESTI",403,179178,,624,0,"Str. PETRE TUTEA nr. 3 , Scoala nr. 109","BUCURESTI SECTORUL 4",4,179178,1,1,1490,616,563,53,613,3,1800,1184,440,173,
42,"MUNICIPIUL BUCURESTI",403,179178,,625,0,"Str. PETRE TUTEA nr. 3 , Scoala nr. 109","BUCURESTI SECTORUL 4",4,179178,1,1,1559,787,738,49,769,18,2018,1231,569,200,
42,"MUNICIPIUL BUCURESTI",403,179178,,626,0,"Str. PETRE TUTEA nr. 3 , Scoala nr. 109","BUCURESTI SECTORUL 4",4,179178,1,1,1394,694,636,58,674,20,1800,1106,506,168,
42,"MUNICIPIUL BUCURESTI",403,179178,,627,0,"Str. PETRE TUTEA nr. 3 , Scoala nr. 109","BUCURESTI SECTORUL 4",4,179178,1,1,1501,870,785,85,849,21,1800,930,616,233,
42,"MUNICIPIUL BUCURESTI",403,179178,,628,0,"Intr. CRISUL ALB nr. 30 , Gradinita nr. 262","BUCURESTI SECTORUL 4",4,179178,1,1,1384,694,609,85,677,17,1803,1109,514,163,
42,"MUNICIPIUL BUCURESTI",403,179178,,629,0,"Intr. CRISUL ALB nr. 30 , Gradinita nr. 262","BUCURESTI SECTORUL 4",4,179178,1,1,1159,566,525,41,555,11,1400,834,405,150,
42,"MUNICIPIUL BUCURESTI",403,179178,,630,0,"Str. SPINIS nr. 1 , Gradinita nr. 228","BUCURESTI SECTORUL 4",4,179178,1,1,1613,832,760,72,826,6,2000,1168,560,266,
42,"MUNICIPIUL BUCURESTI",403,179178,,631,0,"Str. SPINIS nr. 1 , Gradinita nr. 228","BUCURESTI SECTORUL 4",4,179178,1,1,1448,761,655,106,752,9,1800,1039,563,189,
42,"MUNICIPIUL BUCURESTI",403,179178,,632,0,"Str. RIUL SOIMULUI nr. 6 , Scoala nr. 308","BUCURESTI SECTORUL 4",4,179178,1,1,1417,702,651,51,700,2,1800,1098,496,204,
42,"MUNICIPIUL BUCURESTI",403,179178,,633,0,"Str. RIUL SOIMULUI nr. 6 , Scoala nr. 308","BUCURESTI SECTORUL 4",4,179178,1,1,1318,744,673,71,737,7,1599,855,531,206,
42,"MUNICIPIUL BUCURESTI",403,179178,,634,0,"Str. RIUL SOIMULUI nr. 6 , Scoala nr. 308","BUCURESTI SECTORUL 4",4,179178,1,1,1406,646,581,65,639,7,1796,1150,433,206,
42,"MUNICIPIUL BUCURESTI",403,179178,,635,0,"Str. RIUL SOIMULUI nr. 6 , Scoala nr. 308","BUCURESTI SECTORUL 4",4,179178,1,1,1605,718,665,53,703,15,2000,1282,511,192,
42,"MUNICIPIUL BUCURESTI",403,179178,,636,0,"Str. ARGESULUI nr. 6 , Scoala nr. 110 GEORGE TOPARCEANU","BUCURESTI SECTORUL 4",4,179178,1,1,1496,776,671,105,770,6,1808,1032,558,212,
42,"MUNICIPIUL BUCURESTI",403,179178,,637,0,"Str. ARGESULUI nr. 6 , Scoala nr. 110 GEORGE TOPARCEANU","BUCURESTI SECTORUL 4",4,179178,1,1,1511,743,695,48,722,21,1800,1057,501,221,
42,"MUNICIPIUL BUCURESTI",403,179178,,638,0,"Str. ARGESULUI nr. 6 , Scoala nr. 110 GEORGE TOPARCEANU","BUCURESTI SECTORUL 4",4,179178,1,1,1503,708,643,65,693,15,1799,1091,440,253,
42,"MUNICIPIUL BUCURESTI",403,179178,,639,0,"Str. ARGESULUI nr. 6 , Scoala nr. 110 GEORGE TOPARCEANU","BUCURESTI SECTORUL 4",4,179178,1,1,1639,815,755,60,808,7,2000,1185,522,286,
42,"MUNICIPIUL BUCURESTI",403,179178,,640,0,"Str. CRISULUI nr. 6 , Scoala nr. 129","BUCURESTI SECTORUL 4",4,179178,1,1,1622,843,788,55,832,11,2000,1157,646,186,
42,"MUNICIPIUL BUCURESTI",403,179178,,641,0,"Str. CRISULUI nr. 6 , Scoala nr. 129","BUCURESTI SECTORUL 4",4,179178,1,1,1607,915,838,77,894,21,2000,1085,712,182,
42,"MUNICIPIUL BUCURESTI",403,179178,,642,0,"Str. CRISULUI nr. 6 , Scoala nr. 129","BUCURESTI SECTORUL 4",4,179178,1,1,1097,924,861,63,907,17,2200,1276,669,238,
42,"MUNICIPIUL BUCURESTI",403,179178,,643,0,"Str. CRISULUI nr. 6 , Scoala nr. 129","BUCURESTI SECTORUL 4",4,179178,1,1,1849,1023,963,60,999,17,2200,1177,739,260,
42,"MUNICIPIUL BUCURESTI",403,179178,,644,0,"Str. IZVORUL CRISULUI nr. 4 , Liceul MIRCEA VULCANESCU","BUCURESTI SECTORUL 4",4,179178,1,1,1514,729,651,78,715,14,1800,1071,549,166,
42,"MUNICIPIUL BUCURESTI",403,179178,,645,0,"Str. IZVORUL CRISULUI nr. 4 , Liceul MIRCEA VULCANESCU","BUCURESTI SECTORUL 4",4,179178,1,1,1533,803,693,110,791,12,2004,1201,633,158,
42,"MUNICIPIUL BUCURESTI",403,179178,,646,0,"Str. TRIVALE nr. 29 , Grup Scolar OCTAV ONICESCU","BUCURESTI SECTORUL 4",4,179178,1,1,1714,843,772,71,837,6,2200,1357,593,244,
42,"MUNICIPIUL BUCURESTI",403,179178,,647,0,"Str. TRIVALE nr. 29 , Grup Scolar OCTAV ONICESCU","BUCURESTI SECTORUL 4",4,179178,1,1,1406,782,724,58,770,12,1800,1018,594,176,
42,"MUNICIPIUL BUCURESTI",403,179178,,648,0,"Str. TRIVALE nr. 29 , Grup Scolar OCTAV ONICESCU","BUCURESTI SECTORUL 4",4,179178,1,1,1539,766,707,59,755,11,2000,1234,563,192,
42,"MUNICIPIUL BUCURESTI",403,179178,,649,0,"Str. TRIVALE nr. 29 , Grup Scolar OCTAV ONICESCU","BUCURESTI SECTORUL 4",4,179178,1,1,1546,820,766,54,806,14,2000,1180,623,183,
42,"MUNICIPIUL BUCURESTI",403,179178,,650,0,"Str. ALMASU MIC nr. 4 , Scoala nr. 119","BUCURESTI SECTORUL 4",4,179178,1,1,2092,1196,991,205,1178,13,2605,1409,839,339,
42,"MUNICIPIUL BUCURESTI",403,179178,,651,0,"Str. ALMASU MIC nr. 4 , Scoala nr. 119","BUCURESTI SECTORUL 4",4,179178,1,1,1768,841,803,38,823,18,2202,1361,567,256,
42,"MUNICIPIUL BUCURESTI",403,179178,,652,0,"Str. ALMASU MIC nr. 4 , Scoala nr. 119","BUCURESTI SECTORUL 4",4,179178,1,1,1723,855,765,90,845,10,2200,1345,608,237,
42,"MUNICIPIUL BUCURESTI",403,179178,,653,0,"Str. ALMASU MIC nr. 4 , Scoala nr. 119","BUCURESTI SECTORUL 4",4,179178,1,1,1765,746,681,65,737,9,2200,1454,498,239,
42,"MUNICIPIUL BUCURESTI",403,179178,,654,0,"Str. COSTILA nr. 3 , Scoala nr. 36 IONEL TEODOREANU","BUCURESTI SECTORUL 4",4,179178,1,1,1459,772,678,94,759,13,1800,1028,546,213,
42,"MUNICIPIUL BUCURESTI",403,179178,,655,0,"Str. COSTILA nr. 3 , Scoala nr. 36 IONEL TEODOREANU","BUCURESTI SECTORUL 4",4,179178,1,1,1258,830,569,261,814,16,1600,770,595,219,
42,"MUNICIPIUL BUCURESTI",403,179178,,656,0,"Str. COSTILA nr. 3 , Scoala nr. 36 IONEL TEODOREANU","BUCURESTI SECTORUL 4",4,179178,1,1,1536,711,607,104,697,14,2000,1289,482,215,
42,"MUNICIPIUL BUCURESTI",403,179178,,657,0,"Str. COSTILA nr. 3 , Scoala nr. 36 IONEL TEODOREANU","BUCURESTI SECTORUL 4",4,179178,1,1,1636,720,618,102,705,15,2000,1280,425,280,
42,"MUNICIPIUL BUCURESTI",403,179178,,658,0,"Str. COSTILA nr. 3 , Scoala nr. 36 IONEL TEODOREANU","BUCURESTI SECTORUL 4",4,179178,1,1,1543,712,641,71,704,8,2004,1292,485,219,
42,"MUNICIPIUL BUCURESTI",403,179178,,659,0,"Str. COSTILA nr. 3 , Scoala nr. 36 IONEL TEODOREANU","BUCURESTI SECTORUL 4",4,179178,1,1,1438,796,713,83,777,17,1796,1000,533,244,
42,"MUNICIPIUL BUCURESTI",403,179178,,660,0,"Str. HUEDIN nr. 13 , Scoala nr. 99","BUCURESTI SECTORUL 4",4,179178,1,1,1359,695,586,109,674,21,1800,1105,470,204,
42,"MUNICIPIUL BUCURESTI",403,179178,,661,0,"Str. HUEDIN nr. 13 , Scoala nr. 99","BUCURESTI SECTORUL 4",4,179178,1,1,1539,831,687,144,813,18,2000,1169,542,271,
42,"MUNICIPIUL BUCURESTI",403,179178,,662,0,"Str. HUEDIN nr. 13 , Scoala nr. 99","BUCURESTI SECTORUL 4",4,179178,1,1,1666,756,684,72,750,6,2001,1245,512,238,
42,"MUNICIPIUL BUCURESTI",403,179178,,663,0,"Str. HUEDIN nr. 13 , Scoala nr. 99","BUCURESTI SECTORUL 4",4,179178,1,1,1653,724,662,62,718,6,2000,1276,489,229,
42,"MUNICIPIUL BUCURESTI",403,179178,,664,0,"Str. VATRA DORNEI nr. 8 , Scoala nr. 108","BUCURESTI SECTORUL 4",4,179178,1,1,1423,786,708,78,773,13,1816,1030,628,145,
42,"MUNICIPIUL BUCURESTI",403,179178,,665,0,"Str. VATRA DORNEI nr. 8 , Scoala nr. 108","BUCURESTI SECTORUL 4",4,179178,1,1,1478,814,761,53,798,16,1800,986,618,180,
42,"MUNICIPIUL BUCURESTI",403,179178,,666,0,"Str. VATRA DORNEI nr. 8 , Scoala nr. 108","BUCURESTI SECTORUL 4",4,179178,1,1,1559,809,748,61,794,15,2000,1191,619,175,
42,"MUNICIPIUL BUCURESTI",403,179178,,667,0,"Str. VATRA DORNEI nr. 8 , Scoala nr. 108","BUCURESTI SECTORUL 4",4,179178,1,1,1410,629,566,63,623,6,1799,1170,460,163,
42,"MUNICIPIUL BUCURESTI",403,179178,,668,0,"Str. VATRA DORNEI nr. 8 , Scoala nr. 108","BUCURESTI SECTORUL 4",4,179178,1,1,1502,806,775,31,781,25,1802,996,605,176,
42,"MUNICIPIUL BUCURESTI",403,179178,,669,0,"Str. STUPILOR nr. 1 , Scoala nr. 98 AVRAM IANCU","BUCURESTI SECTORUL 4",4,179178,1,1,1900,967,888,79,952,15,2400,1433,708,244,
42,"MUNICIPIUL BUCURESTI",403,179178,,670,0,"Str. STUPILOR nr. 1 , Scoala nr. 98 AVRAM IANCU","BUCURESTI SECTORUL 4",4,179178,1,1,1398,782,729,53,767,15,1800,1018,570,197,
42,"MUNICIPIUL BUCURESTI",403,179178,,671,0,"Str. STUPILOR nr. 1 , Scoala nr. 98 AVRAM IANCU","BUCURESTI SECTORUL 4",4,179178,1,1,1606,784,728,56,771,13,2000,1216,596,175,
42,"MUNICIPIUL BUCURESTI",403,179178,,672,0,"Str. STUPILOR nr. 1 , Scoala nr. 98 AVRAM IANCU","BUCURESTI SECTORUL 4",4,179178,1,1,1675,728,667,61,715,13,2000,1272,535,180,
42,"MUNICIPIUL BUCURESTI",403,179178,,673,0,"Str. STUPILOR nr. 1 , Scoala nr. 98 AVRAM IANCU","BUCURESTI SECTORUL 4",4,179178,1,1,1558,887,797,90,867,20,2000,1113,654,213,
42,"MUNICIPIUL BUCURESTI",403,179178,,674,0,"Str. IZVORUL OLTULUI nr. 3 , Gradinita nr. 167","BUCURESTI SECTORUL 4",4,179178,1,1,1767,923,818,105,906,17,2196,1273,658,248,
42,"MUNICIPIUL BUCURESTI",403,179178,,675,0,"Str. IZVORUL OLTULUI nr. 3 , Gradinita nr. 167","BUCURESTI SECTORUL 4",4,179178,1,1,1924,974,867,107,961,13,2400,1426,689,272,
42,"MUNICIPIUL BUCURESTI",403,179178,,676,0,"Str. IZVORUL OLTULUI nr. 3 , Gradinita nr. 167","BUCURESTI SECTORUL 4",4,179178,1,1,1748,826,754,72,816,10,2200,1374,544,272,
42,"MUNICIPIUL BUCURESTI",403,179178,,677,0,"Str. IZVORUL OLTULUI nr. 3 , Gradinita nr. 167","BUCURESTI SECTORUL 4",4,179178,1,1,1610,501,400,101,492,9,2000,1499,370,122,
42,"MUNICIPIUL BUCURESTI",403,179178,,678,0,"Al. SLATIOARA nr. 8 , Scoala nr. 165","BUCURESTI SECTORUL 4",4,179178,1,1,1818,905,800,105,901,4,2200,1295,611,290,
42,"MUNICIPIUL BUCURESTI",403,179178,,679,0,"Al. SLATIOARA nr. 8 , Scoala nr. 165","BUCURESTI SECTORUL 4",4,179178,1,1,1768,900,766,134,886,14,2194,1294,579,307,
42,"MUNICIPIUL BUCURESTI",403,179178,,680,0,"Al. SLATIOARA nr. 8 , Scoala nr. 165","BUCURESTI SECTORUL 4",4,179178,1,1,1794,819,689,130,813,6,2200,1381,483,330,
42,"MUNICIPIUL BUCURESTI",403,179178,,681,0,"Al. SLATIOARA nr. 8 , Scoala nr. 165","BUCURESTI SECTORUL 4",4,179178,1,1,1753,782,706,76,774,8,2199,1417,510,264,
42,"MUNICIPIUL BUCURESTI",403,179178,,682,0,"Str. ALMASU MARE nr. 1 , Gradinita nr. 243","BUCURESTI SECTORUL 4",4,179178,1,1,1478,717,676,41,711,6,1800,1083,475,236,
42,"MUNICIPIUL BUCURESTI",403,179178,,683,0,"Str. ALMASU MARE nr. 1 , Gradinita nr. 243","BUCURESTI SECTORUL 4",4,179178,1,1,1331,568,519,49,551,17,1600,1032,398,153,
42,"MUNICIPIUL BUCURESTI",403,179178,,684,0,"Sos. GIURGIULUI nr. 247 , Gradinita nr. 28","BUCURESTI SECTORUL 4",4,179178,1,1,1380,649,539,110,642,7,1800,1151,417,225,
42,"MUNICIPIUL BUCURESTI",403,179178,,685,0,"Sos. GIURGIULUI nr. 247 , Gradinita nr. 28","BUCURESTI SECTORUL 4",4,179178,1,1,1452,764,648,116,745,19,1800,1036,451,294,
42,"MUNICIPIUL BUCURESTI",403,179178,,686,0,"Al. CICEU nr. 12 , Scoala nr. 189 ALEX. ODOBESCU","BUCURESTI SECTORUL 4",4,179178,1,1,1113,521,490,31,502,19,1600,1079,369,133,
42,"MUNICIPIUL BUCURESTI",403,179178,,687,0,"Al. CICEU nr. 12 , Scoala nr. 189 ALEX. ODOBESCU","BUCURESTI SECTORUL 4",4,179178,1,1,1075,523,464,59,506,17,1400,877,394,112,
42,"MUNICIPIUL BUCURESTI",403,179178,,688,0,"Al. CICEU nr. 12 , Scoala nr. 189 ALEX. ODOBESCU","BUCURESTI SECTORUL 4",4,179178,1,1,973,500,420,80,490,10,1400,900,390,100,
42,"MUNICIPIUL BUCURESTI",403,179178,,689,0,"Al. CICEU nr. 12 , Scoala nr. 189 ALEX. ODOBESCU","BUCURESTI SECTORUL 4",4,179178,1,1,1170,616,555,61,597,19,1600,984,463,134,
42,"MUNICIPIUL BUCURESTI",403,179178,,690,0,"Al. CICEU nr. 12 , Scoala nr. 189 ALEX. ODOBESCU","BUCURESTI SECTORUL 4",4,179178,1,1,1333,633,597,36,616,17,1600,967,482,134,
42,"MUNICIPIUL BUCURESTI",403,179178,,691,0,"Str. CAP. GRIGORE MARIN nr. 42 , Grup Scolar AUTO DACIA","BUCURESTI SECTORUL 4",4,179178,1,1,1522,760,658,102,743,17,2000,1240,494,249,
42,"MUNICIPIUL BUCURESTI",403,179178,,692,0,"Str. CAP. GRIGORE MARIN nr. 42 , Grup Scolar AUTO DACIA","BUCURESTI SECTORUL 4",4,179178,1,1,1380,546,477,69,545,1,1800,1254,360,185,
42,"MUNICIPIUL BUCURESTI",403,179178,,693,0,"Bdul METALURGIEI nr. 89 , Grup Scolar MIRON NICOLESCU","BUCURESTI SECTORUL 4",4,179178,1,1,1410,680,536,144,672,8,1800,1120,449,223,
42,"MUNICIPIUL BUCURESTI",403,179178,,694,0,"Bdul METALURGIEI nr. 89 , Grup Scolar MIRON NICOLESCU","BUCURESTI SECTORUL 4",4,179178,1,1,1286,644,501,143,637,7,1600,956,341,296,
42,"MUNICIPIUL BUCURESTI",403,179178,,695,0,"Str. PANSELELOR nr. 38-40 , Gradinita nr. 166","BUCURESTI SECTORUL 4",4,179178,1,1,2075,1036,969,67,1029,7,2600,1564,697,332,
42,"MUNICIPIUL BUCURESTI",403,179178,,696,0,"Str. PANSELELOR nr. 38-40 , Gradinita nr. 166","BUCURESTI SECTORUL 4",4,179178,1,1,2060,977,900,77,962,15,2400,1423,613,349,
42,"MUNICIPIUL BUCURESTI",403,179178,,697,0,"Str. PANSELELOR nr. 38-40 , Gradinita nr. 166","BUCURESTI SECTORUL 4",4,179178,1,1,2070,926,846,80,909,17,2600,1674,599,310,
42,"MUNICIPIUL BUCURESTI",403,179178,,698,0,"Str. PANSELELOR nr. 38-40 , Gradinita nr. 166","BUCURESTI SECTORUL 4",4,179178,1,1,1942,879,827,52,865,14,2400,1521,563,302,
42,"MUNICIPIUL BUCURESTI",403,179178,,699,0,"Str. PANSELELOR nr. 38-40 , Gradinita nr. 166","BUCURESTI SECTORUL 4",4,179178,1,1,1806,852,796,56,837,15,2200,1348,577,260,
42,"MUNICIPIUL BUCURESTI",403,179178,,700,0,"Str. CPT. EREMIA POPESCU nr. 27 , Scoala nr. 102 G-RAl EREMIA GRIGORESCU","BUCURESTI SECTORUL 4",4,179178,1,1,1695,783,720,63,767,16,2000,1217,533,234,
42,"MUNICIPIUL BUCURESTI",403,179178,,701,0,"Str. CPT. EREMIA POPESCU nr. 27 , Scoala nr. 102 G-RAl EREMIA GRIGORESCU","BUCURESTI SECTORUL 4",4,179178,1,1,1677,841,783,58,831,10,2000,1159,496,335,
42,"MUNICIPIUL BUCURESTI",403,179178,,702,0,"Str. CPT. EREMIA POPESCU nr. 27 , Scoala nr. 102 G-RAl EREMIA GRIGORESCU","BUCURESTI SECTORUL 4",4,179178,1,1,1792,876,801,75,862,14,2200,1324,548,314,
42,"MUNICIPIUL BUCURESTI",403,179178,,703,0,"Str. CPT. EREMIA POPESCU nr. 27 , Scoala nr. 102 G-RAl EREMIA GRIGORESCU","BUCURESTI SECTORUL 4",4,179178,1,1,1684,978,801,177,967,11,2000,1022,629,338,
42,"MUNICIPIUL BUCURESTI",403,179178,,704,0,"Str. CPT. EREMIA POPESCU nr. 27 , Scoala nr. 102 G-RAl EREMIA GRIGORESCU","BUCURESTI SECTORUL 4",4,179178,1,1,1626,812,730,82,806,6,2000,1188,491,315,
42,"MUNICIPIUL BUCURESTI",403,179178,,705,0,"Str. CPT. EREMIA POPESCU nr. 27 , Scoala nr. 102 G-RAl EREMIA GRIGORESCU","BUCURESTI SECTORUL 4",4,179178,1,1,1891,894,849,45,885,9,2200,1306,602,283,
42,"MUNICIPIUL BUCURESTI",403,179178,,706,0,"Str. CPT. EREMIA POPESCU nr. 27 , Scoala nr. 102 G-RAl EREMIA GRIGORESCU","BUCURESTI SECTORUL 4",4,179178,1,1,1685,853,782,71,838,15,2007,1154,554,284,
42,"MUNICIPIUL BUCURESTI",403,179178,,707,0,"Al. EMIL RACOVITA nr. 1 , Scoala nr. 93","BUCURESTI SECTORUL 4",4,179178,1,1,1549,688,635,53,678,10,2000,1312,441,237,
42,"MUNICIPIUL BUCURESTI",403,179178,,708,0,"Al. EMIL RACOVITA nr. 1 , Scoala nr. 93","BUCURESTI SECTORUL 4",4,179178,1,1,1513,733,674,59,717,16,1800,1067,558,159,
42,"MUNICIPIUL BUCURESTI",403,179178,,709,0,"Al. EMIL RACOVITA nr. 1 , Scoala nr. 93","BUCURESTI SECTORUL 4",4,179178,1,1,1533,896,708,188,884,12,1998,1102,621,263,
42,"MUNICIPIUL BUCURESTI",403,179178,,710,0,"Al. EMIL RACOVITA nr. 1 , Scoala nr. 93","BUCURESTI SECTORUL 4",4,179178,1,1,1645,826,736,90,812,14,2000,1174,558,254,
42,"MUNICIPIUL BUCURESTI",403,179178,,711,0,"Str. ALIORULUI nr. 5 , Gradinita nr. 264","BUCURESTI SECTORUL 4",4,179178,1,1,1341,731,686,45,705,26,1604,873,502,203,
42,"MUNICIPIUL BUCURESTI",403,179178,,712,0,"Str. ALIORULUI nr. 5 , Gradinita nr. 264","BUCURESTI SECTORUL 4",4,179178,1,1,1238,669,611,58,657,12,1600,931,512,145,
42,"MUNICIPIUL BUCURESTI",403,179178,,713,0,"Str. ALIORULUI nr. 5 , Gradinita nr. 264","BUCURESTI SECTORUL 4",4,179178,1,1,1551,864,802,62,845,19,2000,1136,633,212,
42,"MUNICIPIUL BUCURESTI",403,179178,,714,0,"Str. STINJENEILOR nr. 3 , Scoala nr. 133","BUCURESTI SECTORUL 4",4,179178,1,1,1787,865,774,91,856,9,2203,1338,550,306,
42,"MUNICIPIUL BUCURESTI",403,179178,,715,0,"Str. STINJENEILOR nr. 3 , Scoala nr. 133","BUCURESTI SECTORUL 4",4,179178,1,1,1683,890,835,55,877,13,2000,1110,588,289,
42,"MUNICIPIUL BUCURESTI",403,179178,,716,0,"Str. STINJENEILOR nr. 3 , Scoala nr. 133","BUCURESTI SECTORUL 4",4,179178,1,1,1792,885,824,61,873,12,2199,1314,622,251,
42,"MUNICIPIUL BUCURESTI",403,179178,,717,0,"Str. STINJENEILOR nr. 3 , Scoala nr. 133","BUCURESTI SECTORUL 4",4,179178,1,1,1673,855,766,89,841,14,2000,1145,570,271,
42,"MUNICIPIUL BUCURESTI",403,179178,,718,0,"Str. STINJENEILOR nr. 3 , Scoala nr. 133","BUCURESTI SECTORUL 4",4,179178,1,1,1731,818,766,52,803,15,2200,1382,534,269,
42,"MUNICIPIUL BUCURESTI",403,179178,,719,0,"Str. STINJENEILOR nr. 3 , Scoala nr. 133","BUCURESTI SECTORUL 4",4,179178,1,1,1587,837,778,59,826,11,1800,963,579,247,
42,"MUNICIPIUL BUCURESTI",403,179178,,720,0,"Bdul ALEX. OBREGIA nr. 3A , Scoala nr. 194 MARIN SORESCU","BUCURESTI SECTORUL 4",4,179178,1,1,1168,604,561,43,597,7,1600,996,481,116,
42,"MUNICIPIUL BUCURESTI",403,179178,,721,0,"Bdul ALEX. OBREGIA nr. 3A , Scoala nr. 194 MARIN SORESCU","BUCURESTI SECTORUL 4",4,179178,1,1,1188,636,575,61,622,14,1603,967,509,113,
42,"MUNICIPIUL BUCURESTI",403,179178,,722,0,"Bdul ALEX. OBREGIA nr. 3A , Scoala nr. 194 MARIN SORESCU","BUCURESTI SECTORUL 4",4,179178,1,1,1279,652,590,62,633,19,1600,948,449,184,
42,"MUNICIPIUL BUCURESTI",403,179178,,723,0,"Bdul ALEX. OBREGIA nr. 3A , Scoala nr. 194 MARIN SORESCU","BUCURESTI SECTORUL 4",4,179178,1,1,1350,682,625,57,660,22,1804,1122,522,138,
42,"MUNICIPIUL BUCURESTI",403,179178,,724,0,"Bdul ALEX. OBREGIA nr. 3A , Scoala nr. 194 MARIN SORESCU","BUCURESTI SECTORUL 4",4,179178,1,1,1597,754,688,66,739,15,2001,1247,575,164,
42,"MUNICIPIUL BUCURESTI",403,179178,,725,0,"Bdul ALEX. OBREGIA nr. 3A , Scoala nr. 194 MARIN SORESCU","BUCURESTI SECTORUL 4",4,179178,1,1,1322,746,681,65,734,12,1804,1058,596,138,
42,"MUNICIPIUL BUCURESTI",403,179178,,726,0,"Al. TERASEI nr. 8 , Gradinita nr. 193","BUCURESTI SECTORUL 4",4,179178,1,1,1057,528,480,48,522,6,1400,872,380,142,
42,"MUNICIPIUL BUCURESTI",403,179178,,727,0,"Al. TERASEI nr. 8 , Gradinita nr. 193","BUCURESTI SECTORUL 4",4,179178,1,1,1232,704,638,66,692,12,1600,896,549,143,
42,"MUNICIPIUL BUCURESTI",403,179178,,728,0,"Str. PARINCEA nr. 4 , Scoala nr. 113","BUCURESTI SECTORUL 4",4,179178,1,1,1618,804,730,74,790,14,1999,1195,536,254,
42,"MUNICIPIUL BUCURESTI",403,179178,,729,0,"Str. PARINCEA nr. 4 , Scoala nr. 113","BUCURESTI SECTORUL 4",4,179178,1,1,1586,850,790,60,833,17,2016,1166,582,251,
42,"MUNICIPIUL BUCURESTI",403,179178,,730,0,"Str. PARINCEA nr. 4 , Scoala nr. 113","BUCURESTI SECTORUL 4",4,179178,1,1,1810,963,902,61,956,7,2257,1294,673,283,
42,"MUNICIPIUL BUCURESTI",403,179178,,731,0,"Str. PARINCEA nr. 4 , Scoala nr. 113","BUCURESTI SECTORUL 4",4,179178,1,1,1925,1025,992,33,1001,24,2400,1375,689,312,
42,"MUNICIPIUL BUCURESTI",403,179178,,732,0,"Str. PARINCEA nr. 4 , Scoala nr. 113","BUCURESTI SECTORUL 4",4,179178,1,1,1830,852,801,51,845,7,2195,1343,586,259,
42,"MUNICIPIUL BUCURESTI",403,179178,,733,0,"Str. PARINCEA nr. 4 , Scoala nr. 113","BUCURESTI SECTORUL 4",4,179178,1,1,1786,921,840,81,909,12,2197,1276,612,297,
42,"MUNICIPIUL BUCURESTI",403,179187,,734,0,"Str. BACIULUI nr. 4 , Scoala Generala nr. 134","BUCURESTI SECTORUL 5",5,179187,1,1,1095,410,377,33,407,3,1300,890,251,156,
42,"MUNICIPIUL BUCURESTI",403,179187,,735,0,"Str. BACIULUI nr. 4 , Scoala Generala nr. 134","BUCURESTI SECTORUL 5",5,179187,1,1,1333,607,564,43,597,10,1600,993,383,214,
42,"MUNICIPIUL BUCURESTI",403,179187,,736,0,"Str. BACIULUI nr. 4 , Scoala Generala nr. 134","BUCURESTI SECTORUL 5",5,179187,1,1,1153,549,515,34,538,11,1400,851,366,172,
42,"MUNICIPIUL BUCURESTI",403,179187,,737,0,"Str. BACIULUI nr. 4 , Scoala Generala nr. 134","BUCURESTI SECTORUL 5",5,179187,1,1,1054,358,310,48,357,1,1300,942,196,161,
42,"MUNICIPIUL BUCURESTI",403,179187,,738,0,"Str. BACIULUI nr. 4 , Scoala Generala nr. 134","BUCURESTI SECTORUL 5",5,179187,1,1,1085,574,471,103,554,20,1300,726,348,206,
42,"MUNICIPIUL BUCURESTI",403,179187,,739,0,"Str. BACIULUI nr. 4 , Scoala Generala nr. 134","BUCURESTI SECTORUL 5",5,179187,1,1,1601,775,736,39,764,11,1900,1125,484,280,
42,"MUNICIPIUL BUCURESTI",403,179187,,740,0,"Str. BACIULUI nr. 4 , Scoala Generala nr. 134","BUCURESTI SECTORUL 5",5,179187,1,1,1248,527,472,55,521,6,1500,973,342,179,
42,"MUNICIPIUL BUCURESTI",403,179187,,741,0,"Str. BACIULUI nr. 4 , Scoala Generala nr. 134","BUCURESTI SECTORUL 5",5,179187,1,1,1466,618,540,78,607,11,1799,1181,379,228,
42,"MUNICIPIUL BUCURESTI",403,179187,,742,0,"Str. BACIULUI nr. 4 , Scoala Generala nr. 134","BUCURESTI SECTORUL 5",5,179187,1,1,1476,536,459,77,528,8,1796,1260,322,206,
42,"MUNICIPIUL BUCURESTI",403,179187,,743,0,"Str. BACIULUI nr. 4 , Scoala Generala nr. 134","BUCURESTI SECTORUL 5",5,179187,1,1,1589,577,531,46,574,3,1890,1313,300,274,
42,"MUNICIPIUL BUCURESTI",403,179187,,744,0,"Str. BACIULUI nr. 4 , Scoala Generala nr. 134","BUCURESTI SECTORUL 5",5,179187,1,1,832,338,296,42,333,5,1100,762,201,132,
42,"MUNICIPIUL BUCURESTI",403,179187,,745,0,"Str. PODUL GIURGIULUI nr. 5 , Grupul Scolar Industrial ENERGETIC","BUCURESTI SECTORUL 5",5,179187,1,1,1525,886,774,112,879,7,1799,913,671,208,
42,"MUNICIPIUL BUCURESTI",403,179187,,746,0,"Str. PODUL GIURGIULUI nr. 5 , Grupul Scolar Industrial ENERGETIC","BUCURESTI SECTORUL 5",5,179187,1,1,1159,688,621,67,673,15,1412,724,522,151,
42,"MUNICIPIUL BUCURESTI",403,179187,,747,0,"Str. PODUL GIURGIULUI nr. 5 , Grupul Scolar Industrial ENERGETIC","BUCURESTI SECTORUL 5",5,179187,1,1,1028,537,487,50,527,10,1304,767,391,136,
42,"MUNICIPIUL BUCURESTI",403,179187,,748,0,"Str. PODUL GIURGIULUI nr. 5 , Grupul Scolar Industrial ENERGETIC","BUCURESTI SECTORUL 5",5,179187,1,1,1122,634,517,117,618,16,1400,766,442,176,
42,"MUNICIPIUL BUCURESTI",403,179187,,749,0,"Prel. FERENTARILOR nr. 68 , Scoala Generala nr. 136","BUCURESTI SECTORUL 5",5,179187,1,1,1649,600,530,70,587,13,2000,1400,391,196,
42,"MUNICIPIUL BUCURESTI",403,179187,,750,0,"Prel. FERENTARILOR nr. 68 , Scoala Generala nr. 136","BUCURESTI SECTORUL 5",5,179187,1,1,1002,386,318,68,373,13,1300,914,248,125,
42,"MUNICIPIUL BUCURESTI",403,179187,,751,0,"Prel. FERENTARILOR nr. 68 , Scoala Generala nr. 136","BUCURESTI SECTORUL 5",5,179187,1,1,1193,461,405,56,453,8,1500,1039,246,207,
42,"MUNICIPIUL BUCURESTI",403,179187,,752,0,"Prel. FERENTARILOR nr. 68 , Scoala Generala nr. 136","BUCURESTI SECTORUL 5",5,179187,1,1,1205,522,486,36,516,6,1500,978,309,207,
42,"MUNICIPIUL BUCURESTI",403,179187,,753,0,"Prel. FERENTARILOR nr. 68 , Scoala Generala nr. 136","BUCURESTI SECTORUL 5",5,179187,1,1,1377,581,502,79,568,13,1695,1114,354,214,
42,"MUNICIPIUL BUCURESTI",403,179187,,754,0,"Prel. FERENTARILOR nr. 68 , Scoala Generala nr. 136","BUCURESTI SECTORUL 5",5,179187,1,1,1380,600,553,47,592,8,1704,1104,389,203,
42,"MUNICIPIUL BUCURESTI",403,179187,,755,0,"Prel. FERENTARILOR nr. 68 , Scoala Generala nr. 136","BUCURESTI SECTORUL 5",5,179187,1,1,1115,655,494,161,638,17,1400,745,384,254,
42,"MUNICIPIUL BUCURESTI",403,179187,,756,0,"Str. LACUL BUCURA nr. 4 , Scoala Generala nr. 2","BUCURESTI SECTORUL 5",5,179187,1,1,1071,443,375,68,441,2,1300,857,302,139,
42,"MUNICIPIUL BUCURESTI",403,179187,,757,0,"Str. LACUL BUCURA nr. 4 , Scoala Generala nr. 2","BUCURESTI SECTORUL 5",5,179187,1,1,1052,508,448,60,504,4,1300,792,338,166,
42,"MUNICIPIUL BUCURESTI",403,179187,,758,0,"Str. LACUL BUCURA nr. 4 , Scoala Generala nr. 2","BUCURESTI SECTORUL 5",5,179187,1,1,1140,486,446,40,481,5,1400,914,324,157,
42,"MUNICIPIUL BUCURESTI",403,179187,,759,0,"Str. LACUL BUCURA nr. 4 , Scoala Generala nr. 2","BUCURESTI SECTORUL 5",5,179187,1,1,898,396,348,48,390,6,1100,704,249,141,
42,"MUNICIPIUL BUCURESTI",403,179187,,760,0,"Str. LACUL BUCURA nr. 4 , Scoala Generala nr. 2","BUCURESTI SECTORUL 5",5,179187,1,1,1016,495,435,60,490,5,1300,805,316,174,
42,"MUNICIPIUL BUCURESTI",403,179187,,761,0,"Str. TUFISULUI nr. 13 , Scoala Generala 188","BUCURESTI SECTORUL 5",5,179187,1,1,976,555,487,68,543,12,1200,645,391,152,
42,"MUNICIPIUL BUCURESTI",403,179187,,762,0,"Str. TUFISULUI nr. 13 , Scoala Generala 188","BUCURESTI SECTORUL 5",5,179187,1,1,1020,494,419,75,487,7,1300,806,316,171,
42,"MUNICIPIUL BUCURESTI",403,179187,,763,0,"Str. TUFISULUI nr. 13 , Scoala Generala 188","BUCURESTI SECTORUL 5",5,179187,1,1,1004,499,467,32,487,12,1200,701,337,150,
42,"MUNICIPIUL BUCURESTI",403,179187,,764,0,"Str. TUFISULUI nr. 13 , Scoala Generala 188","BUCURESTI SECTORUL 5",5,179187,1,1,980,465,387,78,459,6,1200,735,307,152,
42,"MUNICIPIUL BUCURESTI",403,179187,,765,0,"Str. TUFISULUI nr. 13 , Scoala Generala 188","BUCURESTI SECTORUL 5",5,179187,1,1,853,369,346,23,364,5,1199,830,249,115,
42,"MUNICIPIUL BUCURESTI",403,179187,,766,0,"Str. PANDELE ROSCA nr. 2-4 , Scoala Generala nr. 114","BUCURESTI SECTORUL 5",5,179187,1,1,909,616,447,169,607,9,1700,1084,434,173,
42,"MUNICIPIUL BUCURESTI",403,179187,,767,0,"Str. PANDELE ROSCA nr. 2-4 , Scoala Generala nr. 114","BUCURESTI SECTORUL 5",5,179187,1,1,1071,436,393,43,427,9,1400,964,283,144,
42,"MUNICIPIUL BUCURESTI",403,179187,,768,0,"Str. PANDELE ROSCA nr. 2-4 , Scoala Generala nr. 114","BUCURESTI SECTORUL 5",5,179187,1,1,1173,603,528,75,593,10,1400,797,420,173,
42,"MUNICIPIUL BUCURESTI",403,179187,,769,0,"Str. PANDELE ROSCA nr. 2-4 , Scoala Generala nr. 114","BUCURESTI SECTORUL 5",5,179187,1,1,1085,549,495,54,546,3,1300,751,431,115,
42,"MUNICIPIUL BUCURESTI",403,179187,,770,0,"Sos. VIILOR nr. 38 , Grupul Scolar Economic Administrativ nr. 4","BUCURESTI SECTORUL 5",5,179187,1,1,1001,452,389,63,443,9,1200,748,305,138,
42,"MUNICIPIUL BUCURESTI",403,179187,,771,0,"Sos. VIILOR nr. 38 , Grupul Scolar Economic Administrativ nr. 4","BUCURESTI SECTORUL 5",5,179187,1,1,914,453,375,78,444,9,1100,647,342,102,
42,"MUNICIPIUL BUCURESTI",403,179187,,772,0,"Str. SPATARUL PREDA nr. 16 , Grupul Scolar Industrial Alimentar DUMITRU M","BUCURESTI SECTORUL 5",5,179187,1,1,1188,536,439,97,528,8,1400,864,358,170,
42,"MUNICIPIUL BUCURESTI",403,179187,,773,0,"Str. SPATARUL PREDA nr. 16 , Grupul Scolar Industrial Alimentar DUMITRU M","BUCURESTI SECTORUL 5",5,179187,1,1,1074,556,468,88,547,9,1400,844,369,178,
42,"MUNICIPIUL BUCURESTI",403,179187,,774,0,"Str. SPATARUL PREDA nr. 16 , Grupul Scolar Industrial Alimentar DUMITRU M","BUCURESTI SECTORUL 5",5,179187,1,1,1044,435,406,29,431,4,1300,865,303,128,
42,"MUNICIPIUL BUCURESTI",403,179187,,775,0,"Str. SPATARUL PREDA nr. 16 , Grupul Scolar Industrial Alimentar DUMITRU M","BUCURESTI SECTORUL 5",5,179187,1,1,1264,629,533,96,620,9,1500,871,425,195,
42,"MUNICIPIUL BUCURESTI",403,179187,,776,0,"Str. NASAUD nr. 93 , Scoala Generala nr. 130","BUCURESTI SECTORUL 5",5,179187,1,1,1327,709,617,92,701,8,1600,891,469,232,
42,"MUNICIPIUL BUCURESTI",403,179187,,777,0,"Str. NASAUD nr. 93 , Scoala Generala nr. 130","BUCURESTI SECTORUL 5",5,179187,1,1,1383,704,637,67,695,9,1693,989,463,232,
42,"MUNICIPIUL BUCURESTI",403,179187,,778,0,"Cal. FERENTARILOR nr. 72 , Scoala Generala nr. 135","BUCURESTI SECTORUL 5",5,179187,1,1,905,518,427,91,513,5,1100,582,352,161,
42,"MUNICIPIUL BUCURESTI",403,179187,,779,0,"Cal. FERENTARILOR nr. 72 , Scoala Generala nr. 135","BUCURESTI SECTORUL 5",5,179187,1,1,1295,603,541,62,600,3,1600,997,401,199,
42,"MUNICIPIUL BUCURESTI",403,179187,,780,0,"Cal. FERENTARILOR nr. 72 , Scoala Generala nr. 135","BUCURESTI SECTORUL 5",5,179187,1,1,1240,461,404,57,455,6,1500,1039,282,173,
42,"MUNICIPIUL BUCURESTI",403,179187,,781,0,"Cal. FERENTARILOR nr. 72 , Scoala Generala nr. 135","BUCURESTI SECTORUL 5",5,179187,1,1,1452,813,688,125,797,16,1700,887,554,243,
42,"MUNICIPIUL BUCURESTI",403,179187,,782,0,"Str. GH. DONICI nr. 4A , Scoala Generala nr. 280","BUCURESTI SECTORUL 5",5,179187,1,1,1318,655,574,81,639,16,1700,1045,449,190,
42,"MUNICIPIUL BUCURESTI",403,179187,,783,0,"Str. GH. DONICI nr. 4A , Scoala Generala nr. 280","BUCURESTI SECTORUL 5",5,179187,1,1,1317,666,612,54,602,10,1700,1034,427,175,
42,"MUNICIPIUL BUCURESTI",403,179187,,784,0,"Str. GH. DONICI nr. 4A , Scoala Generala nr. 280","BUCURESTI SECTORUL 5",5,179187,1,1,1065,474,447,27,468,6,1400,926,306,162,
42,"MUNICIPIUL BUCURESTI",403,179187,,785,0,"Str. GH. DONICI nr. 4A , Scoala Generala nr. 280","BUCURESTI SECTORUL 5",5,179187,1,1,1078,516,484,32,509,7,1300,784,335,174,
42,"MUNICIPIUL BUCURESTI",403,179187,,786,0,"Str. GH. DONICI nr. 4A , Scoala Generala nr. 280","BUCURESTI SECTORUL 5",5,179187,1,1,997,477,439,38,467,10,1200,723,295,172,
42,"MUNICIPIUL BUCURESTI",403,179187,,787,0,"Str. GH. DONICI nr. 4A , Scoala Generala nr. 280","BUCURESTI SECTORUL 5",5,179187,1,1,1810,796,747,49,782,14,2100,1304,553,229,
42,"MUNICIPIUL BUCURESTI",403,179187,,788,0,"Str. GH. DONICI nr. 4A , Scoala Generala nr. 280","BUCURESTI SECTORUL 5",5,179187,1,1,928,472,421,51,467,5,1100,628,321,146,
42,"MUNICIPIUL BUCURESTI",403,179187,,789,0,"Str. GH. DONICI nr. 4A , Scoala Generala nr. 280","BUCURESTI SECTORUL 5",5,179187,1,1,1235,593,556,37,591,2,1500,907,408,183,
42,"MUNICIPIUL BUCURESTI",403,179187,,790,0,"Str. GRIGORE TOCILESCU nr. 20 , Scoala Generala nr. 132","BUCURESTI SECTORUL 5",5,179187,1,1,1230,531,487,44,525,6,1500,969,335,190,
42,"MUNICIPIUL BUCURESTI",403,179187,,791,0,"Str. GRIGORE TOCILESCU nr. 20 , Scoala Generala nr. 132","BUCURESTI SECTORUL 5",5,179187,1,1,1343,642,576,66,634,8,1604,962,460,174,
42,"MUNICIPIUL BUCURESTI",403,179187,,792,0,"Str. GRIGORE TOCILESCU nr. 20 , Scoala Generala nr. 132","BUCURESTI SECTORUL 5",5,179187,1,1,1291,621,559,62,609,12,1604,983,385,224,
42,"MUNICIPIUL BUCURESTI",403,179187,,793,0,"Str. GRIGORE TOCILESCU nr. 20 , Scoala Generala nr. 132","BUCURESTI SECTORUL 5",5,179187,1,1,1383,778,678,100,768,10,1700,922,522,246,
42,"MUNICIPIUL BUCURESTI",403,179187,,794,0,"Str. GRIGORE TOCILESCU nr. 20 , Scoala Generala nr. 132","BUCURESTI SECTORUL 5",5,179187,1,1,1225,699,594,105,690,9,1500,801,441,249,
42,"MUNICIPIUL BUCURESTI",403,179187,,795,0,"Str. GRIGORE TOCILESCU nr. 20 , Scoala Generala nr. 132","BUCURESTI SECTORUL 5",5,179187,1,1,1341,687,588,99,680,7,1600,913,449,231,
42,"MUNICIPIUL BUCURESTI",403,179187,,796,0,"Str. GRIGORE TOCILESCU nr. 20 , Scoala Generala nr. 132","BUCURESTI SECTORUL 5",5,179187,1,1,1141,596,550,46,585,11,1400,804,371,214,
42,"MUNICIPIUL BUCURESTI",403,179187,,797,0,"Str. GRIGORE TOCILESCU nr. 20 , Scoala Generala nr. 132","BUCURESTI SECTORUL 5",5,179187,1,1,1263,690,638,52,675,15,1500,810,441,234,
42,"MUNICIPIUL BUCURESTI",403,179187,,798,0,"Cal. RAHOVEI nr. 311 , Liceul Teoretic DIMITRIE BOLINTINEANU","BUCURESTI SECTORUL 5",5,179187,1,1,1230,582,521,61,569,13,1400,818,376,193,
42,"MUNICIPIUL BUCURESTI",403,179187,,799,0,"Cal. RAHOVEI nr. 311 , Liceul Teoretic DIMITRIE BOLINTINEANU","BUCURESTI SECTORUL 5",5,179187,1,1,1171,624,537,87,618,6,1400,776,406,212,
42,"MUNICIPIUL BUCURESTI",403,179187,,800,0,"Cal. RAHOVEI nr. 311 , Liceul Teoretic DIMITRIE BOLINTINEANU","BUCURESTI SECTORUL 5",5,179187,1,1,1251,692,592,100,679,13,1500,808,457,222,
42,"MUNICIPIUL BUCURESTI",403,179187,,801,0,"Cal. RAHOVEI nr. 311 , Liceul Teoretic DIMITRIE BOLINTINEANU","BUCURESTI SECTORUL 5",5,179187,1,1,1260,674,594,80,671,3,1504,830,488,183,
42,"MUNICIPIUL BUCURESTI",403,179187,,802,0,"Cal. RAHOVEI nr. 311 , Liceul Teoretic DIMITRIE BOLINTINEANU","BUCURESTI SECTORUL 5",5,179187,1,1,1228,612,553,59,601,11,1500,888,408,193,
42,"MUNICIPIUL BUCURESTI",403,179187,,803,0,"Cal. RAHOVEI nr. 311 , Liceul Teoretic DIMITRIE BOLINTINEANU","BUCURESTI SECTORUL 5",5,179187,1,1,1347,586,526,60,577,9,1600,1014,400,177,
42,"MUNICIPIUL BUCURESTI",403,179187,,804,0,"Cal. RAHOVEI nr. 311 , Liceul Teoretic DIMITRIE BOLINTINEANU","BUCURESTI SECTORUL 5",5,179187,1,1,1170,575,522,53,567,8,1404,829,382,185,
42,"MUNICIPIUL BUCURESTI",403,179187,,805,0,"Cal. RAHOVEI nr. 311 , Liceul Teoretic DIMITRIE BOLINTINEANU","BUCURESTI SECTORUL 5",5,179187,1,1,1248,628,572,56,623,5,1500,872,434,189,
42,"MUNICIPIUL BUCURESTI",403,179187,,806,0,"Cal. RAHOVEI nr. 311 , Liceul Teoretic DIMITRIE BOLINTINEANU","BUCURESTI SECTORUL 5",5,179187,1,1,1043,523,497,26,513,10,1300,777,339,174,
42,"MUNICIPIUL BUCURESTI",403,179187,,807,0,"Str. AMURGULUI nr. 35 , Scoala Generala nr. 141","BUCURESTI SECTORUL 5",5,179187,1,1,1122,590,539,51,584,6,1400,810,371,213,
42,"MUNICIPIUL BUCURESTI",403,179187,,808,0,"Str. AMURGULUI nr. 35 , Scoala Generala nr. 141","BUCURESTI SECTORUL 5",5,179187,1,1,1020,515,472,43,507,8,1400,885,340,167,
42,"MUNICIPIUL BUCURESTI",403,179187,,809,0,"Str. AMURGULUI nr. 35 , Scoala Generala nr. 141","BUCURESTI SECTORUL 5",5,179187,1,1,1413,679,644,35,674,5,1700,1021,444,230,
42,"MUNICIPIUL BUCURESTI",403,179187,,810,0,"Str. AMURGULUI nr. 35 , Scoala Generala nr. 141","BUCURESTI SECTORUL 5",5,179187,1,1,1047,533,463,70,526,7,1300,767,346,180,
42,"MUNICIPIUL BUCURESTI",403,179187,,811,0,"Str. AMURGULUI nr. 35 , Scoala Generala nr. 141","BUCURESTI SECTORUL 5",5,179187,1,1,1164,524,475,49,517,7,1300,776,332,185,
42,"MUNICIPIUL BUCURESTI",403,179187,,812,0,"Str. AMURGULUI nr. 35 , Scoala Generala nr. 141","BUCURESTI SECTORUL 5",5,179187,1,1,1261,532,482,50,528,4,1500,968,366,162,
42,"MUNICIPIUL BUCURESTI",403,179187,,813,0,"Str. AMURGULUI nr. 35 , Scoala Generala nr. 141","BUCURESTI SECTORUL 5",5,179187,1,1,961,490,382,108,482,8,1200,710,294,188,
42,"MUNICIPIUL BUCURESTI",403,179187,,814,0,"Str. AMURGULUI nr. 35 , Scoala Generala nr. 141","BUCURESTI SECTORUL 5",5,179187,1,1,1700,795,707,88,785,10,2000,1205,473,312,
42,"MUNICIPIUL BUCURESTI",403,179187,,815,0,"Str. AMURGULUI nr. 35 , Scoala Generala nr. 141","BUCURESTI SECTORUL 5",5,179187,1,1,1165,537,472,65,524,13,1400,863,337,187,
42,"MUNICIPIUL BUCURESTI",403,179187,,816,0,"Str. AMURGULUI nr. 35 , Scoala Generala nr. 141","BUCURESTI SECTORUL 5",5,179187,1,1,1057,477,445,32,468,9,1300,823,318,150,
42,"MUNICIPIUL BUCURESTI",403,179187,,817,0,"Str. AMURGULUI nr. 35 , Scoala Generala nr. 141","BUCURESTI SECTORUL 5",5,179187,1,1,1079,486,448,38,483,3,1300,814,331,152,
42,"MUNICIPIUL BUCURESTI",403,179187,,818,0,"Str. BACHUS nr. 42 , Scoala Generala 148","BUCURESTI SECTORUL 5",5,179187,1,1,1088,551,461,90,539,12,1300,749,345,194,
42,"MUNICIPIUL BUCURESTI",403,179187,,819,0,"Str. BACHUS nr. 42 , Scoala Generala 148","BUCURESTI SECTORUL 5",5,179187,1,1,1132,510,462,48,500,10,1400,890,328,172,
42,"MUNICIPIUL BUCURESTI",403,179187,,820,0,"Str. BACHUS nr. 42 , Scoala Generala 148","BUCURESTI SECTORUL 5",5,179187,1,1,1300,537,494,43,523,14,1399,862,343,180,
42,"MUNICIPIUL BUCURESTI",403,179187,,821,0,"Str. BACHUS nr. 42 , Scoala Generala 148","BUCURESTI SECTORUL 5",5,179187,1,1,1217,553,504,49,544,9,1500,947,378,166,
42,"MUNICIPIUL BUCURESTI",403,179187,,822,0,"Str. BACHUS nr. 42 , Scoala Generala 148","BUCURESTI SECTORUL 5",5,179187,1,1,1291,593,545,48,582,11,1599,1006,413,169,
42,"MUNICIPIUL BUCURESTI",403,179187,,823,0,"Str. HUMULESTI nr. 31 , Gradinita nr. 244","BUCURESTI SECTORUL 5",5,179187,1,1,1236,517,469,48,514,3,1500,983,375,139,
42,"MUNICIPIUL BUCURESTI",403,179187,,824,0,"Str. HUMULESTI nr. 31 , Gradinita nr. 244","BUCURESTI SECTORUL 5",5,179187,1,1,1235,642,555,87,636,6,1500,858,456,180,
42,"MUNICIPIUL BUCURESTI",403,179187,,825,0,"Str. BACAU nr. 1 , Scoala Generala 147","BUCURESTI SECTORUL 5",5,179187,1,1,1065,550,452,98,538,12,1300,750,336,202,
42,"MUNICIPIUL BUCURESTI",403,179187,,826,0,"Str. BACAU nr. 1 , Scoala Generala 147","BUCURESTI SECTORUL 5",5,179187,1,1,1015,543,486,57,535,8,1300,757,361,174,
42,"MUNICIPIUL BUCURESTI",403,179187,,827,0,"Str. BACAU nr. 1 , Scoala Generala 147","BUCURESTI SECTORUL 5",5,179187,1,1,1011,505,463,42,495,10,1201,696,340,155,
42,"MUNICIPIUL BUCURESTI",403,179187,,828,0,"Str. BACAU nr. 1 , Scoala Generala 147","BUCURESTI SECTORUL 5",5,179187,1,1,1012,499,460,39,497,2,1300,801,337,160,
42,"MUNICIPIUL BUCURESTI",403,179187,,829,0,"Str. BACAU nr. 1 , Scoala Generala 147","BUCURESTI SECTORUL 5",5,179187,1,1,1043,487,430,57,480,7,1315,828,344,136,
42,"MUNICIPIUL BUCURESTI",403,179187,,830,0,"Str. BACAU nr. 1 , Scoala Generala 147","BUCURESTI SECTORUL 5",5,179187,1,1,1144,558,505,53,549,9,1395,837,319,230,
42,"MUNICIPIUL BUCURESTI",403,179187,,831,0,"Str. BACAU nr. 1 , Scoala Generala 147","BUCURESTI SECTORUL 5",5,179187,1,1,1023,472,441,31,466,6,1296,824,327,139,
42,"MUNICIPIUL BUCURESTI",403,179187,,832,0,"Str. MUNTII CARPATI nr. 72 , Scoala Generala nr. 127","BUCURESTI SECTORUL 5",5,179187,1,1,1230,552,507,45,543,9,1500,948,388,155,
42,"MUNICIPIUL BUCURESTI",403,179187,,833,0,"Str. MUNTII CARPATI nr. 72 , Scoala Generala nr. 127","BUCURESTI SECTORUL 5",5,179187,1,1,1103,467,437,30,457,10,1299,832,301,156,
42,"MUNICIPIUL BUCURESTI",403,179187,,834,0,"Str. MUNTII CARPATI nr. 72 , Scoala Generala nr. 127","BUCURESTI SECTORUL 5",5,179187,1,1,1372,659,600,59,650,9,1602,943,415,235,
42,"MUNICIPIUL BUCURESTI",403,179187,,835,0,"Str. MUNTII CARPATI nr. 72 , Scoala Generala nr. 127","BUCURESTI SECTORUL 5",5,179187,1,1,1291,641,585,56,635,6,1496,855,446,189,
42,"MUNICIPIUL BUCURESTI",403,179187,,836,0,"Str. MUNTII CARPATI nr. 72 , Scoala Generala nr. 127","BUCURESTI SECTORUL 5",5,179187,1,1,1339,648,586,62,635,13,1697,1049,407,228,
42,"MUNICIPIUL BUCURESTI",403,179187,,837,0,"Sos. BUCURESTI MAGURELE nr. 45 , Scoala Generala nr. 125","BUCURESTI SECTORUL 5",5,179187,1,1,1069,585,475,110,582,3,1300,715,388,194,
42,"MUNICIPIUL BUCURESTI",403,179187,,838,0,"Sos. BUCURESTI MAGURELE nr. 45 , Scoala Generala nr. 125","BUCURESTI SECTORUL 5",5,179187,1,1,1071,506,444,62,499,7,1300,794,335,164,
42,"MUNICIPIUL BUCURESTI",403,179187,,839,0,"Sos. BUCURESTI MAGURELE nr. 45 , Scoala Generala nr. 125","BUCURESTI SECTORUL 5",5,179187,1,1,1088,551,476,75,540,11,1300,749,389,151,
42,"MUNICIPIUL BUCURESTI",403,179187,,840,0,"Str. GUTUILOR nr. 1 , Scoala Generala nr. 131","BUCURESTI SECTORUL 5",5,179187,1,1,1113,472,398,74,470,2,1400,928,308,162,
42,"MUNICIPIUL BUCURESTI",403,179187,,841,0,"Str. GUTUILOR nr. 1 , Scoala Generala nr. 131","BUCURESTI SECTORUL 5",5,179187,1,1,1096,488,433,55,483,5,1300,812,322,161,
42,"MUNICIPIUL BUCURESTI",403,179187,,842,0,"Str. GUTUILOR nr. 1 , Scoala Generala nr. 131","BUCURESTI SECTORUL 5",5,179187,1,1,1035,462,400,62,460,2,1286,824,317,143,
42,"MUNICIPIUL BUCURESTI",403,179187,,843,0,"Str. GUTUILOR nr. 1 , Scoala Generala nr. 131","BUCURESTI SECTORUL 5",5,179187,1,1,1027,606,403,203,600,6,1500,894,441,159,
42,"MUNICIPIUL BUCURESTI",403,179187,,844,0,"Str. GUTUILOR nr. 1 , Scoala Generala nr. 131","BUCURESTI SECTORUL 5",5,179187,1,1,1162,570,516,54,563,7,1400,830,391,172,
42,"MUNICIPIUL BUCURESTI",403,179187,,845,0,"Str. GUTUILOR nr. 1 , Scoala Generala nr. 131","BUCURESTI SECTORUL 5",5,179187,1,1,1410,574,530,44,570,4,1700,1126,408,162,
42,"MUNICIPIUL BUCURESTI",403,179187,,846,0,"Str. LERESTI nr. 12 , Scoala Generala nr. 126","BUCURESTI SECTORUL 5",5,179187,1,1,1353,688,638,50,676,12,1600,912,500,176,
42,"MUNICIPIUL BUCURESTI",403,179187,,847,0,"Str. LERESTI nr. 12 , Scoala Generala nr. 126","BUCURESTI SECTORUL 5",5,179187,1,1,1281,657,573,84,649,8,1500,843,416,233,
42,"MUNICIPIUL BUCURESTI",403,179187,,848,0,"Str. LERESTI nr. 12 , Scoala Generala nr. 126","BUCURESTI SECTORUL 5",5,179187,1,1,1241,700,638,62,689,11,1500,800,477,212,
42,"MUNICIPIUL BUCURESTI",403,179187,,849,0,"Str. LERESTI nr. 12 , Scoala Generala nr. 126","BUCURESTI SECTORUL 5",5,179187,1,1,1455,600,553,47,591,9,1700,1100,350,241,
42,"MUNICIPIUL BUCURESTI",403,179187,,850,0,"Sos. ALEXANDRIEI nr. 21 , Scoala Generala nr. 139","BUCURESTI SECTORUL 5",5,179187,1,1,1088,559,528,31,552,7,1297,738,355,197,
42,"MUNICIPIUL BUCURESTI",403,179187,,851,0,"Sos. ALEXANDRIEI nr. 21 , Scoala Generala nr. 139","BUCURESTI SECTORUL 5",5,179187,1,1,903,498,384,114,495,3,1101,603,348,147,
42,"MUNICIPIUL BUCURESTI",403,179187,,852,0,"Sos. ALEXANDRIEI nr. 21 , Scoala Generala nr. 139","BUCURESTI SECTORUL 5",5,179187,1,1,1077,611,580,31,589,22,1300,689,422,167,
42,"MUNICIPIUL BUCURESTI",403,179187,,853,0,"Sos. ALEXANDRIEI nr. 21 , Scoala Generala nr. 139","BUCURESTI SECTORUL 5",5,179187,1,1,1108,584,553,31,578,6,1300,716,394,184,
42,"MUNICIPIUL BUCURESTI",403,179187,,854,0,"Sos. ALEXANDRIEI nr. 21 , Scoala Generala nr. 139","BUCURESTI SECTORUL 5",5,179187,1,1,1141,577,547,30,567,10,1300,723,401,166,
42,"MUNICIPIUL BUCURESTI",403,179187,,855,0,"Str. MARGEANULUI nr. 25 , Scoala Generala nr. 124","BUCURESTI SECTORUL 5",5,179187,1,1,1226,656,586,70,644,12,1500,844,386,258,
42,"MUNICIPIUL BUCURESTI",403,179187,,856,0,"Str. MARGEANULUI nr. 25 , Scoala Generala nr. 124","BUCURESTI SECTORUL 5",5,179187,1,1,1184,688,610,78,683,5,1399,711,467,216,
42,"MUNICIPIUL BUCURESTI",403,179187,,857,0,"Str. MARGEANULUI nr. 25 , Scoala Generala nr. 124","BUCURESTI SECTORUL 5",5,179187,1,1,1284,681,642,39,675,6,1497,816,446,229,
42,"MUNICIPIUL BUCURESTI",403,179187,,858,0,"Str. MARGEANULUI nr. 25 , Scoala Generala nr. 124","BUCURESTI SECTORUL 5",5,179187,1,1,1189,566,518,48,556,10,1400,834,374,182,
42,"MUNICIPIUL BUCURESTI",403,179187,,859,0,"Str. MARGEANULUI nr. 25 , Scoala Generala nr. 124","BUCURESTI SECTORUL 5",5,179187,1,1,1214,641,584,57,632,9,1500,859,416,216,
42,"MUNICIPIUL BUCURESTI",403,179187,,860,0,"Str. MARGEANULUI nr. 25 , Scoala Generala nr. 124","BUCURESTI SECTORUL 5",5,179187,1,1,1055,541,505,36,535,6,1300,759,379,156,
42,"MUNICIPIUL BUCURESTI",403,179187,,861,0,"Str. MARGEANULUI nr. 25 , Scoala Generala nr. 124","BUCURESTI SECTORUL 5",5,179187,1,1,1153,575,526,49,564,11,1400,825,386,178,
42,"MUNICIPIUL BUCURESTI",403,179187,,862,0,"Str. MARGEANULUI nr. 25 , Scoala Generala nr. 124","BUCURESTI SECTORUL 5",5,179187,1,1,1284,639,594,45,633,6,1500,861,400,233,
42,"MUNICIPIUL BUCURESTI",403,179187,,863,0,"Str. MARGEANULUI nr. 25 , Scoala Generala nr. 124","BUCURESTI SECTORUL 5",5,179187,1,1,1139,535,474,61,529,6,1396,861,362,167,
42,"MUNICIPIUL BUCURESTI",403,179187,,864,0,"Str. MARGEANULUI nr. 25 , Scoala Generala nr. 124","BUCURESTI SECTORUL 5",5,179187,1,1,1291,605,539,66,594,11,1496,891,419,175,
42,"MUNICIPIUL BUCURESTI",403,179187,,865,0,"Str. MARGEANULUI nr. 81 , Gradinita nr. 55","BUCURESTI SECTORUL 5",5,179187,1,1,854,412,358,54,407,5,1100,688,276,131,
42,"MUNICIPIUL BUCURESTI",403,179187,,866,0,"Str. MARGEANULUI nr. 81 , Gradinita nr. 55","BUCURESTI SECTORUL 5",5,179187,1,1,883,386,346,40,381,5,1106,720,256,125,
42,"MUNICIPIUL BUCURESTI",403,179187,,867,0,"Prel. GHENCEA nr. 87 , Scoala Generala 144","BUCURESTI SECTORUL 5",5,179187,1,1,1287,673,554,119,662,11,1504,831,465,197,
42,"MUNICIPIUL BUCURESTI",403,179187,,868,0,"Prel. GHENCEA nr. 87 , Scoala Generala 144","BUCURESTI SECTORUL 5",5,179187,1,1,1147,589,506,83,579,10,1403,814,400,179,
42,"MUNICIPIUL BUCURESTI",403,179187,,869,0,"Str. BANU MARACINE nr. 16 , Scoala Generala nr. 143","BUCURESTI SECTORUL 5",5,179187,1,1,1181,560,500,60,552,8,1400,840,381,171,
42,"MUNICIPIUL BUCURESTI",403,179187,,870,0,"Str. BANU MARACINE nr. 16 , Scoala Generala nr. 143","BUCURESTI SECTORUL 5",5,179187,1,1,1325,598,554,44,594,4,1600,1002,351,243,
42,"MUNICIPIUL BUCURESTI",403,179187,,871,0,"Str. BANU MARACINE nr. 16 , Scoala Generala nr. 143","BUCURESTI SECTORUL 5",5,179187,1,1,1238,523,491,32,517,6,1500,977,308,209,
42,"MUNICIPIUL BUCURESTI",403,179187,,872,0,"Str. BANU MARACINE nr. 16 , Scoala Generala nr. 143","BUCURESTI SECTORUL 5",5,179187,1,1,1280,583,530,53,578,5,1500,917,402,176,
42,"MUNICIPIUL BUCURESTI",403,179187,,873,0,"Str. BANU MARACINE nr. 16 , Scoala Generala nr. 143","BUCURESTI SECTORUL 5",5,179187,1,1,1014,530,497,33,523,7,1200,670,359,164,
42,"MUNICIPIUL BUCURESTI",403,179187,,874,0,"Str. BANU MARACINE nr. 16 , Scoala Generala nr. 143","BUCURESTI SECTORUL 5",5,179187,1,1,1295,662,633,29,656,6,1600,938,403,253,
42,"MUNICIPIUL BUCURESTI",403,179187,,875,0,"Str. BANU MARACINE nr. 16 , Scoala Generala nr. 143","BUCURESTI SECTORUL 5",5,179187,1,1,1223,648,616,32,645,3,1500,852,408,237,
42,"MUNICIPIUL BUCURESTI",403,179187,,876,0,"Str. BANU MARACINE nr. 16 , Scoala Generala nr. 143","BUCURESTI SECTORUL 5",5,179187,1,1,1229,490,450,40,485,5,1500,1010,325,160,
42,"MUNICIPIUL BUCURESTI",403,179187,,877,0,"Str. BANU MARACINE nr. 16 , Scoala Generala nr. 143","BUCURESTI SECTORUL 5",5,179187,1,1,1224,564,529,35,554,10,1500,936,361,193,
42,"MUNICIPIUL BUCURESTI",403,179187,,878,0,"Str. BANU MARACINE nr. 16 , Scoala Generala nr. 143","BUCURESTI SECTORUL 5",5,179187,1,1,1207,545,503,42,536,9,1500,955,347,189,
42,"MUNICIPIUL BUCURESTI",403,179187,,879,0,"Str. BANU MARACINE nr. 16 , Scoala Generala nr. 143","BUCURESTI SECTORUL 5",5,179187,1,1,1219,485,451,34,483,2,1500,1015,336,147,
42,"MUNICIPIUL BUCURESTI",403,179187,,880,0,"Str. BANU MARACINE nr. 16 , Scoala Generala nr. 143","BUCURESTI SECTORUL 5",5,179187,1,1,1025,423,389,34,410,13,1400,977,274,136,
42,"MUNICIPIUL BUCURESTI",403,179187,,881,0,"Str. BANU MARACINE nr. 16 , Scoala Generala nr. 143","BUCURESTI SECTORUL 5",5,179187,1,1,1129,458,420,38,448,10,1295,837,305,143,
42,"MUNICIPIUL BUCURESTI",403,179187,,882,0,"Str. BANU MARACINE nr. 16 , Scoala Generala nr. 143","BUCURESTI SECTORUL 5",5,179187,1,1,1128,592,573,19,576,5,1300,708,371,205,
42,"MUNICIPIUL BUCURESTI",403,179187,,883,0,"Str. IANCU JIANU nr. 26 , Gradinita nr. 178","BUCURESTI SECTORUL 5",5,179187,1,1,1427,688,598,90,667,21,1705,1017,434,233,
42,"MUNICIPIUL BUCURESTI",403,179187,,884,0,"Str. IANCU JIANU nr. 26 , Gradinita nr. 178","BUCURESTI SECTORUL 5",5,179187,1,1,1112,469,420,49,462,7,1307,838,316,146,
42,"MUNICIPIUL BUCURESTI",403,179187,,885,0,"Str. IANCU JIANU nr. 26 , Gradinita nr. 178","BUCURESTI SECTORUL 5",5,179187,1,1,1667,686,634,52,676,10,2002,1316,458,218,
42,"MUNICIPIUL BUCURESTI",403,179187,,886,0,"Str. NABUCULUI nr. 18 , Liceul Teoretic IOn BARBU","BUCURESTI SECTORUL 5",5,179187,1,1,664,454,411,43,449,5,1400,946,313,136,
42,"MUNICIPIUL BUCURESTI",403,179187,,887,0,"Str. NABUCULUI nr. 18 , Liceul Teoretic IOn BARBU","BUCURESTI SECTORUL 5",5,179187,1,1,1323,627,540,87,622,5,1600,973,447,175,
42,"MUNICIPIUL BUCURESTI",403,179187,,888,0,"Str. NABUCULUI nr. 18 , Liceul Teoretic IOn BARBU","BUCURESTI SECTORUL 5",5,179187,1,1,1044,477,441,36,468,9,1304,827,340,128,
42,"MUNICIPIUL BUCURESTI",403,179187,,889,0,"Str. NABUCULUI nr. 18 , Liceul Teoretic IOn BARBU","BUCURESTI SECTORUL 5",5,179187,1,1,1075,532,493,39,526,6,1304,772,383,143,
42,"MUNICIPIUL BUCURESTI",403,179187,,890,0,"Str. NABUCULUI nr. 18 , Liceul Teoretic IOn BARBU","BUCURESTI SECTORUL 5",5,179187,1,1,1146,582,538,44,576,6,1400,818,439,137,
42,"MUNICIPIUL BUCURESTI",403,179187,,891,0,"Str. NABUCULUI nr. 18 , Liceul Teoretic IOn BARBU","BUCURESTI SECTORUL 5",5,179187,1,1,1445,616,575,41,603,13,1720,1104,433,170,
42,"MUNICIPIUL BUCURESTI",403,179187,,892,0,"Str. NABUCULUI nr. 18 , Liceul Teoretic IOn BARBU","BUCURESTI SECTORUL 5",5,179187,1,1,1002,563,508,55,554,9,1195,632,408,146,
42,"MUNICIPIUL BUCURESTI",403,179187,,893,0,"Str. NABUCULUI nr. 18 , Liceul Teoretic IOn BARBU","BUCURESTI SECTORUL 5",5,179187,1,1,1233,584,537,47,580,4,1500,916,399,181,
42,"MUNICIPIUL BUCURESTI",403,179187,,894,0,"Str. NABUCULUI nr. 18 , Liceul Teoretic IOn BARBU","BUCURESTI SECTORUL 5",5,179187,1,1,860,329,301,28,325,4,1100,771,236,89,
42,"MUNICIPIUL BUCURESTI",403,179187,,895,0,"Cal. 13 SEPTEMBRIE nr. 177 , Scoala Generala nr. 115","BUCURESTI SECTORUL 5",5,179187,1,1,1325,634,600,34,630,4,1600,966,414,216,
42,"MUNICIPIUL BUCURESTI",403,179187,,896,0,"Cal. 13 SEPTEMBRIE nr. 177 , Scoala Generala nr. 115","BUCURESTI SECTORUL 5",5,179187,1,1,1252,581,535,46,570,11,1500,919,413,157,
42,"MUNICIPIUL BUCURESTI",403,179187,,897,0,"Cal. 13 SEPTEMBRIE nr. 177 , Scoala Generala nr. 115","BUCURESTI SECTORUL 5",5,179187,1,1,1334,581,535,46,580,1,1600,1018,381,199,
42,"MUNICIPIUL BUCURESTI",403,179187,,898,0,"Cal. 13 SEPTEMBRIE nr. 177 , Scoala Generala nr. 115","BUCURESTI SECTORUL 5",5,179187,1,1,1172,621,539,82,614,7,1400,779,439,175,
42,"MUNICIPIUL BUCURESTI",403,179187,,899,0,"Cal. 13 SEPTEMBRIE nr. 177 , Scoala Generala nr. 115","BUCURESTI SECTORUL 5",5,179187,1,1,1113,551,477,74,545,6,1300,749,372,173,
42,"MUNICIPIUL BUCURESTI",403,179187,,900,0,"Cal. 13 SEPTEMBRIE nr. 177 , Scoala Generala nr. 115","BUCURESTI SECTORUL 5",5,179187,1,1,1106,598,508,90,591,7,1300,702,387,204,
42,"MUNICIPIUL BUCURESTI",403,179187,,901,0,"Sos. PANDURI nr. 42 , Scoala Generala nr. 146","BUCURESTI SECTORUL 5",5,179187,1,1,1304,773,657,116,745,28,1600,827,583,162,
42,"MUNICIPIUL BUCURESTI",403,179187,,902,0,"Sos. PANDURI nr. 42 , Scoala Generala nr. 146","BUCURESTI SECTORUL 5",5,179187,1,1,894,529,457,72,523,6,1100,571,428,95,
42,"MUNICIPIUL BUCURESTI",403,179187,,903,0,"Sos. PANDURI nr. 42 , Scoala Generala nr. 146","BUCURESTI SECTORUL 5",5,179187,1,1,1130,686,587,99,673,13,1404,718,533,140,
42,"MUNICIPIUL BUCURESTI",403,179187,,904,0,"Sos. PANDURI nr. 42 , Scoala Generala nr. 146","BUCURESTI SECTORUL 5",5,179187,1,1,932,673,477,196,660,13,1497,824,532,128,
42,"MUNICIPIUL BUCURESTI",403,179187,,905,0,"Sos. PANDURI nr. 42 , Scoala Generala nr. 146","BUCURESTI SECTORUL 5",5,179187,1,1,948,668,503,165,651,17,1500,832,525,126,
42,"MUNICIPIUL BUCURESTI",403,179187,,906,0,"Bdul EROILOR SANITARI nr. 29-31 , Scoala Generala nr. 150","BUCURESTI SECTORUL 5",5,179187,1,1,956,600,508,92,584,16,1200,600,480,104,
42,"MUNICIPIUL BUCURESTI",403,179187,,907,0,"Bdul EROILOR SANITARI nr. 29-31 , Scoala Generala nr. 150","BUCURESTI SECTORUL 5",5,179187,1,1,999,620,559,61,606,14,1200,580,495,111,
42,"MUNICIPIUL BUCURESTI",403,179187,,908,0,"Bdul EROILOR SANITARI nr. 29-31 , Scoala Generala nr. 150","BUCURESTI SECTORUL 5",5,179187,1,1,1045,549,485,64,524,25,1299,750,407,117,
42,"MUNICIPIUL BUCURESTI",403,179187,,909,0,"Bdul EROILOR SANITARI nr. 29-31 , Scoala Generala nr. 150","BUCURESTI SECTORUL 5",5,179187,1,1,964,533,491,42,479,12,1200,709,365,114,
42,"MUNICIPIUL BUCURESTI",403,179187,,910,0,"Bdul EROILOR SANITARI nr. 29-31 , Scoala Generala nr. 150","BUCURESTI SECTORUL 5",5,179187,1,1,1004,536,508,28,518,18,1300,764,432,86,
42,"MUNICIPIUL BUCURESTI",403,179187,,911,0,"Bdul EROILOR SANITARI nr. 29-31 , Scoala Generala nr. 150","BUCURESTI SECTORUL 5",5,179187,1,1,1028,544,489,55,516,28,1300,756,428,88,
42,"MUNICIPIUL BUCURESTI",403,179187,,912,0,"Str. DOINEI nr. 1 , Scoala Generala nr. 130","BUCURESTI SECTORUL 5",5,179187,1,1,1183,482,436,46,466,16,1404,922,332,134,
42,"MUNICIPIUL BUCURESTI",403,179187,,913,0,"Str. DOINEI nr. 1 , Scoala Generala nr. 130","BUCURESTI SECTORUL 5",5,179187,1,1,1413,573,533,40,565,8,1716,1143,363,202,
42,"MUNICIPIUL BUCURESTI",403,179187,,914,0,"Str. DOINEI nr. 1 , Scoala Generala nr. 130","BUCURESTI SECTORUL 5",5,179187,1,1,1200,562,512,50,556,6,1500,938,410,146,
42,"MUNICIPIUL BUCURESTI",403,179187,,915,0,"Str. ION CREANGA nr. 6 , Scoala Generala nr. 128","BUCURESTI SECTORUL 5",5,179187,1,1,871,417,381,36,404,13,1000,583,311,93,
42,"MUNICIPIUL BUCURESTI",403,179187,,916,0,"Str. ION CREANGA nr. 6 , Scoala Generala nr. 128","BUCURESTI SECTORUL 5",5,179187,1,1,833,365,325,40,357,8,1100,735,276,81,
42,"MUNICIPIUL BUCURESTI",403,179187,,917,0,"Str. ION CREANGA nr. 6 , Scoala Generala nr. 128","BUCURESTI SECTORUL 5",5,179187,1,1,893,396,339,57,387,9,1100,704,285,102,
42,"MUNICIPIUL BUCURESTI",403,179187,,918,0,"Str. ION CREANGA nr. 6 , Scoala Generala nr. 128","BUCURESTI SECTORUL 5",5,179187,1,1,940,567,539,28,565,2,1200,633,454,111,
42,"MUNICIPIUL BUCURESTI",403,179187,,919,0,"Str. ION CREANGA nr. 8 , Gradinita nr. 268","BUCURESTI SECTORUL 5",5,179187,1,1,931,599,580,19,593,6,1200,601,457,136,
42,"MUNICIPIUL BUCURESTI",403,179187,,920,0,"Str. ION CREANGA nr. 8 , Gradinita nr. 268","BUCURESTI SECTORUL 5",5,179187,1,1,1330,804,764,40,794,10,1600,796,624,170,
42,"MUNICIPIUL BUCURESTI",403,179187,,921,0,"Str. ION CREANGA nr. 8 , Gradinita nr. 268","BUCURESTI SECTORUL 5",5,179187,1,1,1100,626,565,61,616,10,1200,574,500,116,
42,"MUNICIPIUL BUCURESTI",403,179187,,922,0,"Bdul M. KOGALNICEANU nr. 74 , Facultatea de Drept","BUCURESTI SECTORUL 5",5,179187,1,1,940,493,401,92,477,16,1200,707,378,99,
42,"MUNICIPIUL BUCURESTI",403,179187,,923,0,"Bdul M. KOGALNICEANU nr. 74 , Facultatea de Drept","BUCURESTI SECTORUL 5",5,179187,1,1,778,446,358,88,438,8,1000,554,370,68,
42,"MUNICIPIUL BUCURESTI",403,179187,,924,0,"Bdul M. KOGALNICEANU nr. 74 , Facultatea de Drept","BUCURESTI SECTORUL 5",5,179187,1,1,798,482,367,115,461,21,1000,518,371,90,
42,"MUNICIPIUL BUCURESTI",403,179187,,925,0,"Bdul REGINA ELISABETA nr. 48 , Colegiul National GHEORGHE LAZAR","BUCURESTI SECTORUL 5",5,179187,1,1,951,507,451,56,500,6,1200,693,405,95,
42,"MUNICIPIUL BUCURESTI",403,179187,,926,0,"Bdul REGINA ELISABETA nr. 48 , Colegiul National GHEORGHE LAZAR","BUCURESTI SECTORUL 5",5,179187,1,1,1149,542,477,65,531,11,1400,858,444,87,
42,"MUNICIPIUL BUCURESTI",403,179187,,927,0,"Bdul REGINA ELISABETA nr. 48 , Colegiul National GHEORGHE LAZAR","BUCURESTI SECTORUL 5",5,179187,1,1,1025,628,471,157,605,23,1300,672,471,134,
42,"MUNICIPIUL BUCURESTI",403,179187,,928,0,"Bdul REGINA ELISABETA nr. 48 , Colegiul National GHEORGHE LAZAR","BUCURESTI SECTORUL 5",5,179187,1,1,1115,705,535,170,678,27,1400,695,534,144,
42,"MUNICIPIUL BUCURESTI",403,179187,,929,0,"Bdul REGINA ELISABETA nr. 48 , Colegiul National GHEORGHE LAZAR","BUCURESTI SECTORUL 5",5,179187,1,1,1064,517,451,66,497,20,1299,782,411,86,
42,"MUNICIPIUL BUCURESTI",403,179196,,930,0,"Drumul SARII nr. 85 , Oficiul de Stare Civila","BUCURESTI SECTORUL 6",6,179196,1,1,1277,734,668,66,719,15,1400,666,582,137,
42,"MUNICIPIUL BUCURESTI",403,179196,,931,0,"Drumul SARII nr. 85 , Oficiul de Stare Civila","BUCURESTI SECTORUL 6",6,179196,1,1,1309,653,649,4,629,23,1400,747,491,138,
42,"MUNICIPIUL BUCURESTI",403,179196,,932,0,"Str. GARLENI nr. 10 , Scoala Generala nr. 311","BUCURESTI SECTORUL 6",6,179196,1,1,1629,836,743,93,818,18,1800,964,598,220,
42,"MUNICIPIUL BUCURESTI",403,179196,,933,0,"Str. GARLENI nr. 10 , Scoala Generala nr. 311","BUCURESTI SECTORUL 6",6,179196,1,1,1558,836,721,115,824,12,1600,764,604,220,
42,"MUNICIPIUL BUCURESTI",403,179196,,934,0,"Str. GARLENI nr. 10 , Scoala Generala nr. 311","BUCURESTI SECTORUL 6",6,179196,1,1,1572,842,788,54,826,16,1600,758,629,197,
42,"MUNICIPIUL BUCURESTI",403,179196,,935,0,"Str. GARLENI nr. 10 , Scoala Generala nr. 311","BUCURESTI SECTORUL 6",6,179196,1,1,1125,872,825,47,851,21,1800,928,634,217,
42,"MUNICIPIUL BUCURESTI",403,179196,,936,0,"Str. GARLENI nr. 10 , Scoala Generala nr. 311","BUCURESTI SECTORUL 6",6,179196,1,1,1361,795,722,73,782,13,1600,805,530,252,
42,"MUNICIPIUL BUCURESTI",403,179196,,937,0,"Str. GARLENI nr. 10 , Scoala Generala nr. 311","BUCURESTI SECTORUL 6",6,179196,1,1,1378,783,737,46,779,4,1400,617,583,196,
42,"MUNICIPIUL BUCURESTI",403,179196,,938,0,"Str. VLADEASA nr. 9 , Scoala Generala nr. 59","BUCURESTI SECTORUL 6",6,179196,1,1,1093,745,635,110,728,17,1200,455,548,180,
42,"MUNICIPIUL BUCURESTI",403,179196,,939,0,"Str. VLADEASA nr. 9 , Scoala Generala nr. 59","BUCURESTI SECTORUL 6",6,179196,1,1,1280,747,662,85,736,11,1400,653,551,185,
42,"MUNICIPIUL BUCURESTI",403,179196,,940,0,"Str. VLADEASA nr. 9 , Scoala Generala nr. 59","BUCURESTI SECTORUL 6",6,179196,1,1,1381,679,620,59,669,10,1400,721,496,173,
42,"MUNICIPIUL BUCURESTI",403,179196,,941,0,"Str. VLADEASA nr. 9 , Scoala Generala nr. 59","BUCURESTI SECTORUL 6",6,179196,1,1,1499,767,695,72,756,11,1600,833,586,170,
42,"MUNICIPIUL BUCURESTI",403,179196,,942,0,"Str. VLADEASA nr. 9 , Scoala Generala nr. 59","BUCURESTI SECTORUL 6",6,179196,1,1,1302,654,606,48,637,17,1400,746,516,121,
42,"MUNICIPIUL BUCURESTI",403,179196,,943,0,"Str. VLADEASA nr. 9 , Scoala Generala nr. 59","BUCURESTI SECTORUL 6",6,179196,1,1,1342,741,701,40,731,10,1398,657,552,179,
42,"MUNICIPIUL BUCURESTI",403,179196,,944,0,"Al. VALEA PRAHOVEI nr. 1 , Scoala Generala nr. 205","BUCURESTI SECTORUL 6",6,179196,1,1,1422,807,760,47,785,22,1600,793,627,158,
42,"MUNICIPIUL BUCURESTI",403,179196,,945,0,"Al. VALEA PRAHOVEI nr. 1 , Scoala Generala nr. 205","BUCURESTI SECTORUL 6",6,179196,1,1,1582,873,704,169,837,36,1600,727,655,182,
42,"MUNICIPIUL BUCURESTI",403,179196,,946,0,"Al. VALEA PRAHOVEI nr. 1 , Scoala Generala nr. 205","BUCURESTI SECTORUL 6",6,179196,1,1,1044,561,458,103,538,23,1200,639,419,119,
42,"MUNICIPIUL BUCURESTI",403,179196,,947,0,"Al. VALEA PRAHOVEI nr. 1 , Scoala Generala nr. 205","BUCURESTI SECTORUL 6",6,179196,1,1,1602,928,832,96,906,22,1800,872,693,213,
42,"MUNICIPIUL BUCURESTI",403,179196,,948,0,"Al. VALEA PRAHOVEI nr. 1 , Scoala Generala nr. 205","BUCURESTI SECTORUL 6",6,179196,1,1,1598,824,782,42,798,26,1800,976,643,155,
42,"MUNICIPIUL BUCURESTI",403,179196,,949,0,"Al. VALEA PRAHOVEI nr. 1 , Scoala Generala nr. 205","BUCURESTI SECTORUL 6",6,179196,1,1,1281,682,606,76,671,11,1400,718,542,129,
42,"MUNICIPIUL BUCURESTI",403,179196,,950,0,"Str. OBCINA MARE nr. 2 , Scoala Generala nr. 197","BUCURESTI SECTORUL 6",6,179196,1,1,1726,943,851,92,924,19,1800,857,773,151,
42,"MUNICIPIUL BUCURESTI",403,179196,,951,0,"Str. OBCINA MARE nr. 2 , Scoala Generala nr. 197","BUCURESTI SECTORUL 6",6,179196,1,1,927,585,485,100,575,10,1000,415,450,125,
42,"MUNICIPIUL BUCURESTI",403,179196,,952,0,"Str. OBCINA MARE nr. 2 , Scoala Generala nr. 197","BUCURESTI SECTORUL 6",6,179196,1,1,1730,929,852,77,905,24,1800,871,768,137,
42,"MUNICIPIUL BUCURESTI",403,179196,,953,0,"Str. OBCINA MARE nr. 2 , Scoala Generala nr. 197","BUCURESTI SECTORUL 6",6,179196,1,1,1572,946,884,62,919,27,1600,654,735,184,
42,"MUNICIPIUL BUCURESTI",403,179196,,954,0,"Str. OBCINA MARE nr. 2 , Scoala Generala nr. 197","BUCURESTI SECTORUL 6",6,179196,1,1,1384,730,673,57,706,24,1400,670,580,126,
42,"MUNICIPIUL BUCURESTI",403,179196,,955,0,"Str. OBCINA MARE nr. 2 , Scoala Generala nr. 197","BUCURESTI SECTORUL 6",6,179196,1,1,1292,756,707,49,746,10,1400,644,574,172,
42,"MUNICIPIUL BUCURESTI",403,179196,,956,0,"Str. OBCINA MARE nr. 2 , Scoala Generala nr. 197","BUCURESTI SECTORUL 6",6,179196,1,1,1248,648,598,50,625,23,1400,752,498,127,
42,"MUNICIPIUL BUCURESTI",403,179196,,957,0,"Intr. LT. AV. CARANDA GHEORGHE nr. 9 , A.D.P.","BUCURESTI SECTORUL 6",6,179196,1,1,1620,995,902,93,963,32,1800,805,829,134,
42,"MUNICIPIUL BUCURESTI",403,179196,,958,0,"Str. MIHAELA RUXANDRA MARCU nr. 3 , Scoala Generala nr. 193","BUCURESTI SECTORUL 6",6,179196,1,1,1218,807,667,140,777,27,1400,593,640,137,
42,"MUNICIPIUL BUCURESTI",403,179196,,959,0,"Str. MIHAELA RUXANDRA MARCU nr. 3 , Scoala Generala nr. 193","BUCURESTI SECTORUL 6",6,179196,1,1,1084,810,750,60,796,14,1400,590,644,152,
42,"MUNICIPIUL BUCURESTI",403,179196,,960,0,"Str. MIHAELA RUXANDRA MARCU nr. 3 , Scoala Generala nr. 193","BUCURESTI SECTORUL 6",6,179196,1,1,1205,719,654,65,702,17,1400,681,602,100,
42,"MUNICIPIUL BUCURESTI",403,179196,,961,0,"Str. MIHAELA RUXANDRA MARCU nr. 3 , Scoala Generala nr. 193","BUCURESTI SECTORUL 6",6,179196,1,1,1515,816,764,52,798,18,1600,784,618,180,
42,"MUNICIPIUL BUCURESTI",403,179196,,962,0,"Str. PRAVAT nr. 22 , Scoala Generala nr. 164","BUCURESTI SECTORUL 6",6,179196,1,1,1305,808,664,144,794,14,1600,792,656,138,
42,"MUNICIPIUL BUCURESTI",403,179196,,963,0,"Str. PRAVAT nr. 22 , Scoala Generala nr. 164","BUCURESTI SECTORUL 6",6,179196,1,1,1409,880,789,91,858,22,1600,720,666,192,
42,"MUNICIPIUL BUCURESTI",403,179196,,964,0,"Str. PRAVAT nr. 22 , Scoala Generala nr. 164","BUCURESTI SECTORUL 6",6,179196,1,1,1286,749,652,97,738,11,1400,651,587,151,
42,"MUNICIPIUL BUCURESTI",403,179196,,965,0,"Bdul TIMISOARA nr. 33 , Liceul GRIGORE MOISIL","BUCURESTI SECTORUL 6",6,179196,1,1,1345,820,715,105,799,21,1400,580,628,171,
42,"MUNICIPIUL BUCURESTI",403,179196,,966,0,"Bdul TIMISOARA nr. 33 , Liceul GRIGORE MOISIL","BUCURESTI SECTORUL 6",6,179196,1,1,1376,765,694,71,744,21,1400,635,581,163,
42,"MUNICIPIUL BUCURESTI",403,179196,,967,0,"Bdul TIMISOARA nr. 33 , Liceul GRIGORE MOISIL","BUCURESTI SECTORUL 6",6,179196,1,1,1439,773,730,43,751,22,1600,827,589,162,
42,"MUNICIPIUL BUCURESTI",403,179196,,968,0,"Bdul TIMISOARA nr. 33 , Liceul GRIGORE MOISIL","BUCURESTI SECTORUL 6",6,179196,1,1,1364,792,740,52,765,27,1400,608,584,181,
42,"MUNICIPIUL BUCURESTI",403,179196,,969,0,"Str. PRAVAT nr. 24 , Grup Scolar Industrial GHEORGHE ASACHI","BUCURESTI SECTORUL 6",6,179196,1,1,1595,845,797,48,834,11,1600,755,656,178,
42,"MUNICIPIUL BUCURESTI",403,179196,,970,0,"Str. PRAVAT nr. 24 , Grup Scolar Industrial GHEORGHE ASACHI","BUCURESTI SECTORUL 6",6,179196,1,1,1277,734,668,66,719,15,1400,666,582,137,
42,"MUNICIPIUL BUCURESTI",403,179196,,971,0,"Str. PRAVAT nr. 24 , Grup Scolar Industrial GHEORGHE ASACHI","BUCURESTI SECTORUL 6",6,179196,1,1,1352,834,737,97,808,26,1400,566,671,137,
42,"MUNICIPIUL BUCURESTI",403,179196,,972,0,"Str. PRAVAT nr. 24 , Grup Scolar Industrial GHEORGHE ASACHI","BUCURESTI SECTORUL 6",6,179196,1,1,1338,813,753,60,788,23,1400,587,639,149,
42,"MUNICIPIUL BUCURESTI",403,179196,,973,0,"Al. POIANA MUNTELUI nr. 1 , Scoala Generala nr. 191","BUCURESTI SECTORUL 6",6,179196,1,1,1237,684,604,80,669,15,1400,716,548,121,
42,"MUNICIPIUL BUCURESTI",403,179196,,974,0,"Al. POIANA MUNTELUI nr. 1 , Scoala Generala nr. 191","BUCURESTI SECTORUL 6",6,179196,1,1,1417,813,736,77,788,25,1595,782,635,153,
42,"MUNICIPIUL BUCURESTI",403,179196,,975,0,"Al. POIANA MUNTELUI nr. 1 , Scoala Generala nr. 191","BUCURESTI SECTORUL 6",6,179196,1,1,1294,809,728,81,782,27,1400,591,637,145,
42,"MUNICIPIUL BUCURESTI",403,179196,,976,0,"Al. POIANA MUNTELUI nr. 1 , Scoala Generala nr. 191","BUCURESTI SECTORUL 6",6,179196,1,1,1486,852,792,60,820,32,1597,745,652,168,
42,"MUNICIPIUL BUCURESTI",403,179196,,977,0,"Al. POIANA MUNTELUI nr. 1 , Scoala Generala nr. 191","BUCURESTI SECTORUL 6",6,179196,1,1,1388,609,548,61,599,10,1400,791,439,160,
42,"MUNICIPIUL BUCURESTI",403,179196,,978,0,"Al. POIANA MUNTELUI nr. 1 , Scoala Generala nr. 191","BUCURESTI SECTORUL 6",6,179196,1,1,1187,662,593,69,650,12,1200,538,502,148,
42,"MUNICIPIUL BUCURESTI",403,179196,,979,0,"Al. POIANA MUNTELUI nr. 1 , Scoala Generala nr. 191","BUCURESTI SECTORUL 6",6,179196,1,1,1378,689,625,64,679,10,1400,711,526,153,
42,"MUNICIPIUL BUCURESTI",403,179196,,980,0,"Str. PASCANI nr. 2 , Scoala Generala nr. 169","BUCURESTI SECTORUL 6",6,179196,1,1,1376,826,742,84,802,24,1400,574,630,172,
42,"MUNICIPIUL BUCURESTI",403,179196,,981,0,"Str. PASCANI nr. 2 , Scoala Generala nr. 169","BUCURESTI SECTORUL 6",6,179196,1,1,1241,697,648,49,683,14,1396,699,500,183,
42,"MUNICIPIUL BUCURESTI",403,179196,,982,0,"Str. PASCANI nr. 2 , Scoala Generala nr. 169","BUCURESTI SECTORUL 6",6,179196,1,1,1407,772,718,54,747,24,1596,824,597,150,
42,"MUNICIPIUL BUCURESTI",403,179196,,983,0,"Str. PASCANI nr. 2 , Scoala Generala nr. 169","BUCURESTI SECTORUL 6",6,179196,1,1,1527,854,805,49,832,22,1600,746,669,163,
42,"MUNICIPIUL BUCURESTI",403,179196,,984,0,"Str. PASCANI nr. 2 , Scoala Generala nr. 169","BUCURESTI SECTORUL 6",6,179196,1,1,1449,865,804,61,841,23,1600,735,642,199,
42,"MUNICIPIUL BUCURESTI",403,179196,,985,0,"Str. PASCANI nr. 6 , Scoala Generala nr. 155","BUCURESTI SECTORUL 6",6,179196,1,1,1588,893,820,73,871,22,1600,707,678,193,
42,"MUNICIPIUL BUCURESTI",403,179196,,986,0,"Str. PASCANI nr. 6 , Scoala Generala nr. 155","BUCURESTI SECTORUL 6",6,179196,1,1,1420,850,784,66,819,31,1600,750,627,192,
42,"MUNICIPIUL BUCURESTI",403,179196,,987,0,"Str. PASCANI nr. 6 , Scoala Generala nr. 155","BUCURESTI SECTORUL 6",6,179196,1,1,1349,709,675,34,704,5,1400,691,536,168,
42,"MUNICIPIUL BUCURESTI",403,179196,,988,0,"Str. PASCANI nr. 6 , Scoala Generala nr. 155","BUCURESTI SECTORUL 6",6,179196,1,1,1386,712,673,39,702,10,1400,688,553,149,
42,"MUNICIPIUL BUCURESTI",403,179196,,989,0,"Str. PESTERA SCARISOARA nr. 1 , Colegiul National ELENA CUZA","BUCURESTI SECTORUL 6",6,179196,1,1,1262,695,645,50,689,6,1400,705,565,124,
42,"MUNICIPIUL BUCURESTI",403,179196,,990,0,"Str. PESTERA SCARISOARA nr. 1 , Colegiul National ELENA CUZA","BUCURESTI SECTORUL 6",6,179196,1,1,1321,748,649,99,721,27,1400,652,570,151,
42,"MUNICIPIUL BUCURESTI",403,179196,,991,0,"Str. PESTERA SCARISOARA nr. 1 , Colegiul National ELENA CUZA","BUCURESTI SECTORUL 6",6,179196,1,1,1318,728,674,54,710,18,1400,672,536,174,
42,"MUNICIPIUL BUCURESTI",403,179196,,992,0,"Str. PESTERA SCARISOARA nr. 1 , Colegiul National ELENA CUZA","BUCURESTI SECTORUL 6",6,179196,1,1,1114,614,586,28,601,13,1200,586,496,105,
42,"MUNICIPIUL BUCURESTI",403,179196,,993,0,"Str. VALEA LUI MIHAI nr. 6 , Liceul EUGEN LOVINESCU","BUCURESTI SECTORUL 6",6,179196,1,1,1556,912,819,93,899,13,1600,688,723,176,
42,"MUNICIPIUL BUCURESTI",403,179196,,994,0,"Str. VALEA LUI MIHAI nr. 6 , Liceul EUGEN LOVINESCU","BUCURESTI SECTORUL 6",6,179196,1,1,1481,783,727,56,768,15,1600,817,606,162,
42,"MUNICIPIUL BUCURESTI",403,179196,,995,0,"Str. VALEA LUI MIHAI nr. 6 , Liceul EUGEN LOVINESCU","BUCURESTI SECTORUL 6",6,179196,1,1,1641,908,819,89,889,19,1800,892,702,187,
42,"MUNICIPIUL BUCURESTI",403,179196,,996,0,"Str. VALEA LUI MIHAI nr. 6 , Liceul EUGEN LOVINESCU","BUCURESTI SECTORUL 6",6,179196,1,1,1620,884,811,73,874,10,1800,916,679,195,
42,"MUNICIPIUL BUCURESTI",403,179196,,997,0,"Str. VALEA LUI MIHAI nr. 6 , Liceul EUGEN LOVINESCU","BUCURESTI SECTORUL 6",6,179196,1,1,1622,968,915,53,949,19,1800,832,756,193,
42,"MUNICIPIUL BUCURESTI",403,179196,,998,0,"Str. VALEA LUI MIHAI nr. 6 , Liceul EUGEN LOVINESCU","BUCURESTI SECTORUL 6",6,179196,1,1,1313,816,710,106,801,15,1400,584,613,188,
42,"MUNICIPIUL BUCURESTI",403,179196,,999,0,"Str. VALEA LUI MIHAI nr. 6 , Scoala Generala nr. 154","BUCURESTI SECTORUL 6",6,179196,1,1,1330,701,667,34,689,12,1400,699,517,172,
42,"MUNICIPIUL BUCURESTI",403,179196,,1000,0,"Str. VALEA LUI MIHAI nr. 6 , Scoala Generala nr. 154","BUCURESTI SECTORUL 6",6,179196,1,1,1409,834,775,59,810,24,1600,766,622,188,
42,"MUNICIPIUL BUCURESTI",403,179196,,1001,0,"Str. VALEA LUI MIHAI nr. 6 , Scoala Generala nr. 154","BUCURESTI SECTORUL 6",6,179196,1,1,986,533,479,54,518,15,1000,467,404,114,
42,"MUNICIPIUL BUCURESTI",403,179196,,1002,0,"Prel. GHENCEA nr. 24 , Scoala Generala nr. 121","BUCURESTI SECTORUL 6",6,179196,1,1,1581,855,765,90,840,15,1600,745,655,185,
42,"MUNICIPIUL BUCURESTI",403,179196,,1003,0,"Prel. GHENCEA nr. 24 , Scoala Generala nr. 121","BUCURESTI SECTORUL 6",6,179196,1,1,1538,774,724,50,754,20,1600,826,586,168,
42,"MUNICIPIUL BUCURESTI",403,179196,,1004,0,"Prel. GHENCEA nr. 24 , Scoala Generala nr. 121","BUCURESTI SECTORUL 6",6,179196,1,1,1778,893,796,97,883,10,1800,907,642,241,
42,"MUNICIPIUL BUCURESTI",403,179196,,1005,0,"Prel. GHENCEA nr. 24 , Scoala Generala nr. 121","BUCURESTI SECTORUL 6",6,179196,1,1,1599,818,767,51,798,20,1800,982,641,157,
42,"MUNICIPIUL BUCURESTI",403,179196,,1006,0,"Al. ISTRU nr. 6 , Scoala Speciala nr. 2","BUCURESTI SECTORUL 6",6,179196,1,1,1466,809,756,53,788,21,1604,795,618,170,
42,"MUNICIPIUL BUCURESTI",403,179196,,1007,0,"Al. ISTRU nr. 6 , Scoala Speciala nr. 2","BUCURESTI SECTORUL 6",6,179196,1,1,1752,812,745,67,797,15,1800,988,573,224,
42,"MUNICIPIUL BUCURESTI",403,179196,,1008,0,"Al. ISTRU nr. 4 , Scoala Speciala nr. 11","BUCURESTI SECTORUL 6",6,179196,1,1,1384,762,717,45,746,16,1400,638,560,186,
42,"MUNICIPIUL BUCURESTI",403,179196,,1009,0,"Al. ISTRU nr. 4 , Scoala Speciala nr. 11","BUCURESTI SECTORUL 6",6,179196,1,1,1448,754,688,66,744,10,1600,846,520,224,
42,"MUNICIPIUL BUCURESTI",403,179196,,1010,0,"Al. PARVA nr. 3-5 , Scoala Generala nr. 172","BUCURESTI SECTORUL 6",6,179196,1,1,1516,767,689,78,755,12,1600,833,579,176,
42,"MUNICIPIUL BUCURESTI",403,179196,,1011,0,"Al. PARVA nr. 3-5 , Scoala Generala nr. 172","BUCURESTI SECTORUL 6",6,179196,1,1,1652,912,814,98,890,22,1800,888,666,224,
42,"MUNICIPIUL BUCURESTI",403,179196,,1012,0,"Al. PARVA nr. 3-5 , Scoala Generala nr. 172","BUCURESTI SECTORUL 6",6,179196,1,1,1575,899,848,51,882,17,1602,703,704,178,
42,"MUNICIPIUL BUCURESTI",403,179196,,1013,0,"Al. PARVA nr. 3-5 , Scoala Generala nr. 172","BUCURESTI SECTORUL 6",6,179196,1,1,1700,944,882,62,922,22,1804,860,731,191,
42,"MUNICIPIUL BUCURESTI",403,179196,,1014,0,"Al. PARVA nr. 3-5 , Scoala Generala nr. 172","BUCURESTI SECTORUL 6",6,179196,1,1,1220,665,615,50,647,18,1400,735,506,141,
42,"MUNICIPIUL BUCURESTI",403,179196,,1015,0,"Al. PARVA nr. 3-5 , Scoala Generala nr. 172","BUCURESTI SECTORUL 6",6,179196,1,1,1584,840,795,45,830,10,1600,760,593,237,
42,"MUNICIPIUL BUCURESTI",403,179196,,1016,0,"Al. PARVA nr. 3-5 , Scoala Generala nr. 172","BUCURESTI SECTORUL 6",6,179196,1,1,1688,853,797,56,824,29,1800,947,666,158,
42,"MUNICIPIUL BUCURESTI",403,179196,,1017,0,"Al. PARVA nr. 3-5 , Scoala Generala nr. 172","BUCURESTI SECTORUL 6",6,179196,1,1,1432,827,747,80,802,25,1600,773,654,148,
42,"MUNICIPIUL BUCURESTI",403,179196,,1018,0,"Al. ARIES nr. 5 , Scoala Generala nr. 206","BUCURESTI SECTORUL 6",6,179196,1,1,1443,832,710,122,817,15,1600,768,621,196,
42,"MUNICIPIUL BUCURESTI",403,179196,,1019,0,"Al. ARIES nr. 5 , Scoala Generala nr. 206","BUCURESTI SECTORUL 6",6,179196,1,1,1708,857,797,60,841,14,1798,941,641,200,
42,"MUNICIPIUL BUCURESTI",403,179196,,1020,0,"Al. ARIES nr. 5 , Scoala Generala nr. 206","BUCURESTI SECTORUL 6",6,179196,1,1,1617,803,750,53,795,8,1800,997,579,216,
42,"MUNICIPIUL BUCURESTI",403,179196,,1021,0,"Al. ARIES nr. 5 , Scoala Generala nr. 206","BUCURESTI SECTORUL 6",6,179196,1,1,1466,805,763,42,798,7,1400,595,634,164,
42,"MUNICIPIUL BUCURESTI",403,179196,,1022,0,"Al. ARIES nr. 5 , Scoala Generala nr. 206","BUCURESTI SECTORUL 6",6,179196,1,1,1643,807,760,47,791,16,1800,993,588,203,
42,"MUNICIPIUL BUCURESTI",403,179196,,1023,0,"Al. ARIES nr. 5 , Scoala Generala nr. 206","BUCURESTI SECTORUL 6",6,179196,1,1,1662,876,830,46,854,21,1806,930,650,204,
42,"MUNICIPIUL BUCURESTI",403,179196,,1024,0,"Al. LUNCA CERNEI nr. 3 , Scoala Generala nr. 176","BUCURESTI SECTORUL 6",6,179196,1,1,1495,719,674,45,703,16,1600,881,490,213,
42,"MUNICIPIUL BUCURESTI",403,179196,,1025,0,"Al. LUNCA CERNEI nr. 3 , Scoala Generala nr. 176","BUCURESTI SECTORUL 6",6,179196,1,1,1600,823,772,51,812,11,1800,977,613,199,
42,"MUNICIPIUL BUCURESTI",403,179196,,1026,0,"Al. LUNCA CERNEI nr. 3 , Scoala Generala nr. 176","BUCURESTI SECTORUL 6",6,179196,1,1,1368,757,678,79,738,19,1400,643,568,170,
42,"MUNICIPIUL BUCURESTI",403,179196,,1027,0,"Al. LUNCA CERNEI nr. 3 , Scoala Generala nr. 176","BUCURESTI SECTORUL 6",6,179196,1,1,1483,802,757,45,800,2,1600,798,606,194,
42,"MUNICIPIUL BUCURESTI",403,179196,,1028,0,"Al. LUNCA CERNEI nr. 3 , Scoala Generala nr. 176","BUCURESTI SECTORUL 6",6,179196,1,1,1629,873,829,44,854,19,1803,930,616,238,
42,"MUNICIPIUL BUCURESTI",403,179196,,1029,0,"Al. LUNCA CERNEI nr. 3 , Scoala Generala nr. 176","BUCURESTI SECTORUL 6",6,179196,1,1,1177,465,391,74,462,3,1200,735,310,152,
42,"MUNICIPIUL BUCURESTI",403,179196,,1030,0,"Str. ROMANCIERILOR nr. 1 , Grup Scolar PTTR","BUCURESTI SECTORUL 6",6,179196,1,1,1451,777,633,144,751,26,1600,823,561,190,
42,"MUNICIPIUL BUCURESTI",403,179196,,1031,0,"Str. ROMANCIERILOR nr. 1 , Grup Scolar PTTR","BUCURESTI SECTORUL 6",6,179196,1,1,1288,818,645,173,808,10,1400,582,553,255,
42,"MUNICIPIUL BUCURESTI",403,179196,,1032,0,"Str. PESTERA DAMBOVICIOARA nr. 12 , Grup Scolar Economic Administrativ nr","BUCURESTI SECTORUL 6",6,179196,1,1,1381,631,598,33,612,19,1400,769,442,170,
42,"MUNICIPIUL BUCURESTI",403,179196,,1033,0,"Str. PESTERA DAMBOVICIOARA nr. 12 , Grup Scolar Economic Administrativ nr","BUCURESTI SECTORUL 6",6,179196,1,1,1592,824,755,69,808,16,1600,776,600,208,
42,"MUNICIPIUL BUCURESTI",403,179196,,1034,0,"Str. PESTERA DAMBOVICIOARA nr. 12 , Grup Scolar Economic Administrativ nr","BUCURESTI SECTORUL 6",6,179196,1,1,1436,788,673,115,776,12,1600,812,565,211,
42,"MUNICIPIUL BUCURESTI",403,179196,,1035,0,"Str. PESTERA DAMBOVICIOARA nr. 12 , Grup Scolar Economic Administrativ nr","BUCURESTI SECTORUL 6",6,179196,1,1,1504,738,685,53,718,20,1600,862,531,187,
42,"MUNICIPIUL BUCURESTI",403,179196,,1036,0,"Str. PESTERA DAMBOVICIOARA nr. 12 , Grup Scolar Economic Administrativ nr","BUCURESTI SECTORUL 6",6,179196,1,1,1571,751,683,68,739,12,1600,849,569,170,
42,"MUNICIPIUL BUCURESTI",403,179196,,1037,0,"Str. CENTURII nr. 4 , Scoala Generala nr. 142","BUCURESTI SECTORUL 6",6,179196,1,1,1423,592,545,47,583,9,1600,1008,395,188,
42,"MUNICIPIUL BUCURESTI",403,179196,,1038,0,"Str. CENTURII nr. 4 , Scoala Generala nr. 142","BUCURESTI SECTORUL 6",6,179196,1,1,1557,819,745,74,792,27,1600,781,610,182,
42,"MUNICIPIUL BUCURESTI",403,179196,,1039,0,"Str. CENTURII nr. 4 , Scoala Generala nr. 142","BUCURESTI SECTORUL 6",6,179196,1,1,1603,832,779,53,817,15,1800,968,585,232,
42,"MUNICIPIUL BUCURESTI",403,179196,,1040,0,"Str. CENTURII nr. 4 , Scoala Generala nr. 142","BUCURESTI SECTORUL 6",6,179196,1,1,1679,748,665,83,728,20,1800,1052,492,236,
42,"MUNICIPIUL BUCURESTI",403,179196,,1041,0,"Str. CENTURII nr. 4 , Scoala Generala nr. 142","BUCURESTI SECTORUL 6",6,179196,1,1,1323,651,540,111,635,16,1400,749,435,200,
42,"MUNICIPIUL BUCURESTI",403,179196,,1042,0,"Str. CENTURII nr. 4 , Scoala Generala nr. 142","BUCURESTI SECTORUL 6",6,179196,1,1,2043,1039,883,156,1026,13,2200,1161,723,303,
42,"MUNICIPIUL BUCURESTI",403,179196,,1043,0,"Str. CENTURII nr. 4 , Scoala Generala nr. 142","BUCURESTI SECTORUL 6",6,179196,1,1,1654,671,649,22,663,8,1800,1129,470,193,
42,"MUNICIPIUL BUCURESTI",403,179196,,1044,0,"Str. CENTURII nr. 4 , Scoala Generala nr. 142","BUCURESTI SECTORUL 6",6,179196,1,1,1489,810,738,72,803,7,1600,790,587,216,
42,"MUNICIPIUL BUCURESTI",403,179196,,1045,0,"Str. CENTURII nr. 4 , Scoala Generala nr. 142","BUCURESTI SECTORUL 6",6,179196,1,1,1736,792,745,47,779,13,1800,1008,562,217,
42,"MUNICIPIUL BUCURESTI",403,179196,,1046,0,"Str. MOINESTI nr. 9 , Scoala Generala nr. 309","BUCURESTI SECTORUL 6",6,179196,1,1,1712,994,860,134,973,21,1800,806,662,311,
42,"MUNICIPIUL BUCURESTI",403,179196,,1047,0,"Str. MOINESTI nr. 9 , Scoala Generala nr. 309","BUCURESTI SECTORUL 6",6,179196,1,1,1710,916,852,64,903,13,1800,884,620,283,
42,"MUNICIPIUL BUCURESTI",403,179196,,1048,0,"Str. MOINESTI nr. 9 , Scoala Generala nr. 309","BUCURESTI SECTORUL 6",6,179196,1,1,1448,806,659,147,793,13,1600,794,503,290,
42,"MUNICIPIUL BUCURESTI",403,179196,,1049,0,"Str. MOINESTI nr. 9 , Scoala Generala nr. 309","BUCURESTI SECTORUL 6",6,179196,1,1,1279,628,586,42,621,7,1400,772,420,201,
42,"MUNICIPIUL BUCURESTI",403,179196,,1050,0,"Str. MOINESTI nr. 9 , Scoala Generala nr. 309","BUCURESTI SECTORUL 6",6,179196,1,1,1146,560,526,34,551,9,1200,640,400,151,
42,"MUNICIPIUL BUCURESTI",403,179196,,1051,0,"Str. MOINESTI nr. 9 , Scoala Generala nr. 309","BUCURESTI SECTORUL 6",6,179196,1,1,1388,692,622,70,679,13,1400,708,465,214,
42,"MUNICIPIUL BUCURESTI",403,179196,,1052,0,"Str. HANUL ANCUTEI nr. 12 , Scoala Generala nr. 157","BUCURESTI SECTORUL 6",6,179196,1,1,1463,737,682,55,724,13,1600,863,524,200,
42,"MUNICIPIUL BUCURESTI",403,179196,,1053,0,"Str. HANUL ANCUTEI nr. 12 , Scoala Generala nr. 157","BUCURESTI SECTORUL 6",6,179196,1,1,1906,829,770,59,824,5,1996,1167,600,224,
42,"MUNICIPIUL BUCURESTI",403,179196,,1054,0,"Str. HANUL ANCUTEI nr. 12 , Scoala Generala nr. 157","BUCURESTI SECTORUL 6",6,179196,1,1,1421,698,652,46,680,18,1600,902,454,226,
42,"MUNICIPIUL BUCURESTI",403,179196,,1055,0,"Str. HANUL ANCUTEI nr. 12 , Scoala Generala nr. 157","BUCURESTI SECTORUL 6",6,179196,1,1,1517,694,625,69,688,6,1600,906,459,229,
42,"MUNICIPIUL BUCURESTI",403,179196,,1056,0,"Str. HANUL ANCUTEI nr. 12 , Scoala Generala nr. 157","BUCURESTI SECTORUL 6",6,179196,1,1,1560,798,736,62,785,13,1600,802,537,248,
42,"MUNICIPIUL BUCURESTI",403,179196,,1057,0,"Str. HANUL ANCUTEI nr. 12 , Scoala Generala nr. 157","BUCURESTI SECTORUL 6",6,179196,1,1,1608,804,726,78,792,12,1800,996,557,235,
42,"MUNICIPIUL BUCURESTI",403,179196,,1058,0,"Str. HANUL ANCUTEI nr. 12 , Scoala Generala nr. 157","BUCURESTI SECTORUL 6",6,179196,1,1,1461,674,624,50,671,3,1400,726,441,230,
42,"MUNICIPIUL BUCURESTI",403,179196,,1059,0,"Str. HANUL ANCUTEI nr. 12 , Scoala Generala nr. 157","BUCURESTI SECTORUL 6",6,179196,1,1,1714,868,781,87,850,18,1800,932,605,245,
42,"MUNICIPIUL BUCURESTI",403,179196,,1060,0,"Str. HANUL ANCUTEI nr. 12 , Scoala Generala nr. 157","BUCURESTI SECTORUL 6",6,179196,1,1,1961,896,824,72,880,16,2000,1104,621,259,
42,"MUNICIPIUL BUCURESTI",403,179196,,1061,0,"Str. HANUL ANCUTEI nr. 12 , Scoala Generala nr. 157","BUCURESTI SECTORUL 6",6,179196,1,1,1241,490,437,53,478,12,1400,910,280,198,
42,"MUNICIPIUL BUCURESTI",403,179196,,1062,0,"Bdul IULIU MANIU nr. 218 , Cantina TURBOMECANICA","BUCURESTI SECTORUL 6",6,179196,1,1,1469,841,749,92,832,9,1599,758,581,251,
42,"MUNICIPIUL BUCURESTI",403,179196,,1063,0,"Str. PRECIZIEI nr. 18 , Grupul Scolar Industrial PETRU PONT","BUCURESTI SECTORUL 6",6,179196,1,1,1513,677,522,155,674,3,1600,923,341,333,
42,"MUNICIPIUL BUCURESTI",403,179196,,1064,0,"Str. GHIRLANDEI nr. 7 , Scoala Generala nr. 160","BUCURESTI SECTORUL 6",6,179196,1,1,1641,731,685,46,711,20,1800,1069,498,213,
42,"MUNICIPIUL BUCURESTI",403,179196,,1065,0,"Str. GHIRLANDEI nr. 7 , Scoala Generala nr. 160","BUCURESTI SECTORUL 6",6,179196,1,1,1748,858,781,77,852,6,1800,942,580,272,
42,"MUNICIPIUL BUCURESTI",403,179196,,1066,0,"Str. GHIRLANDEI nr. 7 , Scoala Generala nr. 160","BUCURESTI SECTORUL 6",6,179196,1,1,1740,794,706,88,784,10,1800,1006,506,278,
42,"MUNICIPIUL BUCURESTI",403,179196,,1067,0,"Str. GHIRLANDEI nr. 7 , Scoala Generala nr. 160","BUCURESTI SECTORUL 6",6,179196,1,1,1192,654,580,74,642,12,1200,546,472,170,
42,"MUNICIPIUL BUCURESTI",403,179196,,1068,0,"Str. GHIRLANDEI nr. 7 , Scoala Generala nr. 160","BUCURESTI SECTORUL 6",6,179196,1,1,1285,704,601,103,684,20,1400,696,512,172,
42,"MUNICIPIUL BUCURESTI",403,179196,,1069,0,"Str. GHIRLANDEI nr. 7 , Scoala Generala nr. 160","BUCURESTI SECTORUL 6",6,179196,1,1,1987,870,782,88,853,17,2000,1130,540,313,
42,"MUNICIPIUL BUCURESTI",403,179196,,1070,0,"Str. GHIRLANDEI nr. 7 , Scoala Generala nr. 160","BUCURESTI SECTORUL 6",6,179196,1,1,1559,775,725,50,769,6,1600,825,535,234,
42,"MUNICIPIUL BUCURESTI",403,179196,,1071,0,"Str. APUSULUI nr. 73 , Scoala Generala nr. 198","BUCURESTI SECTORUL 6",6,179196,1,1,1067,551,503,48,534,17,1200,649,366,168,
42,"MUNICIPIUL BUCURESTI",403,179196,,1072,0,"Str. APUSULUI nr. 73 , Scoala Generala nr. 198","BUCURESTI SECTORUL 6",6,179196,1,1,1802,864,783,81,843,20,2000,1136,609,234,
42,"MUNICIPIUL BUCURESTI",403,179196,,1073,0,"Str. APUSULUI nr. 73 , Scoala Generala nr. 198","BUCURESTI SECTORUL 6",6,179196,1,1,1583,813,762,51,798,15,1600,787,587,211,
42,"MUNICIPIUL BUCURESTI",403,179196,,1074,0,"Str. APUSULUI nr. 73 , Scoala Generala nr. 198","BUCURESTI SECTORUL 6",6,179196,1,1,1550,803,749,54,799,4,1600,797,589,210,
42,"MUNICIPIUL BUCURESTI",403,179196,,1075,0,"Str. APUSULUI nr. 73 , Scoala Generala nr. 198","BUCURESTI SECTORUL 6",6,179196,1,1,1681,840,784,56,827,13,1800,960,519,308,
42,"MUNICIPIUL BUCURESTI",403,179196,,1076,0,"Str. APUSULUI nr. 73 , Scoala Generala nr. 198","BUCURESTI SECTORUL 6",6,179196,1,1,1557,773,714,59,749,22,1600,827,570,179,
42,"MUNICIPIUL BUCURESTI",403,179196,,1077,0,"Str. ROSIA MONTANA nr. 41 , Scoala Generala nr. 174","BUCURESTI SECTORUL 6",6,179196,1,1,1382,687,641,46,678,9,1400,713,492,186,
42,"MUNICIPIUL BUCURESTI",403,179196,,1078,0,"Str. ROSIA MONTANA nr. 41 , Scoala Generala nr. 174","BUCURESTI SECTORUL 6",6,179196,1,1,1613,900,809,91,880,20,1800,900,667,213,
42,"MUNICIPIUL BUCURESTI",403,179196,,1079,0,"Str. ROSIA MONTANA nr. 41 , Scoala Generala nr. 174","BUCURESTI SECTORUL 6",6,179196,1,1,1657,1033,869,164,1012,21,1800,767,768,244,
42,"MUNICIPIUL BUCURESTI",403,179196,,1080,0,"Str. ROSIA MONTANA nr. 41 , Scoala Generala nr. 174","BUCURESTI SECTORUL 6",6,179196,1,1,1574,785,700,85,772,13,1600,815,597,175,
42,"MUNICIPIUL BUCURESTI",403,179196,,1081,0,"Str. ROSIA MONTANA nr. 41 , Scoala Generala nr. 174","BUCURESTI SECTORUL 6",6,179196,1,1,1656,869,833,36,850,19,1800,931,617,233,
42,"MUNICIPIUL BUCURESTI",403,179196,,1082,0,"Str. ROSIA MONTANA nr. 42 , Scoala Generala nr. 310","BUCURESTI SECTORUL 6",6,179196,1,1,1572,854,790,64,830,24,1600,746,571,259,
42,"MUNICIPIUL BUCURESTI",403,179196,,1083,0,"Str. ROSIA MONTANA nr. 42 , Scoala Generala nr. 310","BUCURESTI SECTORUL 6",6,179196,1,1,1451,688,612,76,675,13,1600,912,478,197,
42,"MUNICIPIUL BUCURESTI",403,179196,,1084,0,"Str. ROSIA MONTANA nr. 42 , Scoala Generala nr. 310","BUCURESTI SECTORUL 6",6,179196,1,1,1117,614,555,59,604,10,1200,586,464,140,
42,"MUNICIPIUL BUCURESTI",403,179196,,1085,0,"Str. ROSIA MONTANA nr. 42 , Scoala Generala nr. 310","BUCURESTI SECTORUL 6",6,179196,1,1,1137,576,547,29,557,19,1200,624,420,137,
42,"MUNICIPIUL BUCURESTI",403,179196,,1086,0,"Str. ROSIA MONTANA nr. 42 , Scoala Generala nr. 310","BUCURESTI SECTORUL 6",6,179196,1,1,898,490,437,53,484,6,1000,510,364,120,
42,"MUNICIPIUL BUCURESTI",403,179196,,1087,0,"Str. ROSIA MONTANA nr. 42 , Scoala Generala nr. 310","BUCURESTI SECTORUL 6",6,179196,1,1,1017,544,505,39,529,15,1200,656,372,157,
42,"MUNICIPIUL BUCURESTI",403,179196,,1088,0,"Str. DEALUL TUGULEA nr. 35 , Scoala Generala nr. 156","BUCURESTI SECTORUL 6",6,179196,1,1,1333,692,665,27,681,11,1400,708,507,174,
42,"MUNICIPIUL BUCURESTI",403,179196,,1089,0,"Str. DEALUL TUGULEA nr. 35 , Scoala Generala nr. 156","BUCURESTI SECTORUL 6",6,179196,1,1,1108,784,716,68,763,21,1600,816,599,164,
42,"MUNICIPIUL BUCURESTI",403,179196,,1090,0,"Str. DEALUL TUGULEA nr. 35 , Scoala Generala nr. 156","BUCURESTI SECTORUL 6",6,179196,1,1,1254,647,593,54,636,11,1400,753,468,168,
42,"MUNICIPIUL BUCURESTI",403,179196,,1091,0,"Str. DEALUL TUGULEA nr. 35 , Scoala Generala nr. 156","BUCURESTI SECTORUL 6",6,179196,1,1,1235,662,582,80,651,11,1400,738,464,187,
42,"MUNICIPIUL BUCURESTI",403,179196,,1092,0,"Str. DEALUL TUGULEA nr. 35 , Scoala Generala nr. 156","BUCURESTI SECTORUL 6",6,179196,1,1,1713,886,789,97,873,13,1800,914,639,234,
42,"MUNICIPIUL BUCURESTI",403,179196,,1093,0,"Str. DEALUL TUGULEA nr. 35 , Scoala Generala nr. 156","BUCURESTI SECTORUL 6",6,179196,1,1,1919,950,875,75,934,16,2000,1050,618,316,
42,"MUNICIPIUL BUCURESTI",403,179196,,1094,0,"Str. DEALUL TUGULEA nr. 35 , Scoala Generala nr. 156","BUCURESTI SECTORUL 6",6,179196,1,1,1454,772,722,50,756,16,1600,828,548,208,
42,"MUNICIPIUL BUCURESTI",403,179196,,1095,0,"Str. DEALUL TUGULEA nr. 35 , Scoala Generala nr. 156","BUCURESTI SECTORUL 6",6,179196,1,1,1198,684,621,63,669,15,1400,716,527,142,
42,"MUNICIPIUL BUCURESTI",403,179196,,1096,0,"Str. PESTERA DAMBOVICIOARA nr. 12 , Grupul Scolar Economic Adminstrativ n","BUCURESTI SECTORUL 6",6,179196,1,1,1063,690,637,53,664,26,1400,710,478,186,
42,"MUNICIPIUL BUCURESTI",403,179196,,1097,0,"Str. PESTERA DAMBOVICIOARA nr. 12 , Grupul Scolar Economic Adminstrativ n","BUCURESTI SECTORUL 6",6,179196,1,1,1408,757,696,61,738,19,1600,843,604,134,
42,"MUNICIPIUL BUCURESTI",403,179196,,1098,0,"Str. PESTERA DAMBOVICIOARA nr. 12 , Grupul Scolar Economic Adminstrativ n","BUCURESTI SECTORUL 6",6,179196,1,1,1193,763,712,51,677,86,1400,637,479,198,
42,"MUNICIPIUL BUCURESTI",403,179196,,1099,0,"Str. DEALUL TUGULEA nr. 35 , Scoala Generala nr. 156","BUCURESTI SECTORUL 6",6,179196,1,1,2001,793,720,73,786,7,2200,1407,555,231,
42,"MUNICIPIUL BUCURESTI",403,179196,,1100,0,"Str. DEALUL TUGULEA nr. 35 , Scoala Generala nr. 156","BUCURESTI SECTORUL 6",6,179196,1,1,1762,767,723,44,747,20,1800,1033,608,139,
42,"MUNICIPIUL BUCURESTI",403,179196,,1101,0,"Str. DEALUL TUGULEA nr. 35 , Scoala Generala nr. 156","BUCURESTI SECTORUL 6",6,179196,1,1,1310,663,606,57,655,8,1400,737,444,211,
42,"MUNICIPIUL BUCURESTI",403,179196,,1102,0,"Str. DEALUL TUGULEA nr. 35 , Scoala Generala nr. 156","BUCURESTI SECTORUL 6",6,179196,1,1,1822,894,811,83,877,17,2000,1106,600,277,
42,"MUNICIPIUL BUCURESTI",403,179196,,1103,0,"Str. DEALUL TUGULEA nr. 35 , Scoala Generala nr. 156","BUCURESTI SECTORUL 6",6,179196,1,1,1984,1003,808,195,985,18,2000,997,731,254,
42,"MUNICIPIUL BUCURESTI",403,179196,,1104,0,"Str. FABRICII nr. 22 , Scoala Generala nr. 117","BUCURESTI SECTORUL 6",6,179196,1,1,1208,852,794,58,841,11,1800,948,619,222,
42,"MUNICIPIUL BUCURESTI",403,179196,,1105,0,"Str. FABRICII nr. 22 , Scoala Generala nr. 117","BUCURESTI SECTORUL 6",6,179196,1,1,1673,844,775,69,832,12,1800,956,609,223,
42,"MUNICIPIUL BUCURESTI",403,179196,,1106,0,"Str. FABRICII nr. 22 , Scoala Generala nr. 117","BUCURESTI SECTORUL 6",6,179196,1,1,1231,657,598,59,634,23,1400,743,492,142,
42,"MUNICIPIUL BUCURESTI",403,179196,,1107,0,"Str. FABRICII nr. 22 , Scoala Generala nr. 117","BUCURESTI SECTORUL 6",6,179196,1,1,1512,809,676,133,794,14,1600,791,600,194,
42,"MUNICIPIUL BUCURESTI",403,179196,,1108,0,"Str. FABRICII nr. 22 , Scoala Generala nr. 117","BUCURESTI SECTORUL 6",6,179196,1,1,1385,634,561,73,622,12,1400,766,406,216,
42,"MUNICIPIUL BUCURESTI",403,179196,,1109,0,"Str. FABRICII nr. 22 , Scoala Generala nr. 117","BUCURESTI SECTORUL 6",6,179196,1,1,1744,796,666,130,790,6,1800,1004,549,241,
42,"MUNICIPIUL BUCURESTI",403,179196,,1110,0,"Str. FABRICII nr. 22 , Scoala Generala nr. 117","BUCURESTI SECTORUL 6",6,179196,1,1,1391,735,662,73,714,21,1400,665,529,185,
42,"MUNICIPIUL BUCURESTI",403,179196,,1111,0,"Bdul IULIU MANIU nr. 15 , Liceul TUDOR VLADIMIRESCU","BUCURESTI SECTORUL 6",6,179196,1,1,1372,806,679,127,781,25,1400,594,629,152,
42,"MUNICIPIUL BUCURESTI",403,179196,,1112,0,"Bdul IULIU MANIU nr. 15 , Liceul TUDOR VLADIMIRESCU","BUCURESTI SECTORUL 6",6,179196,1,1,1294,714,591,123,696,18,1404,690,510,186,
42,"MUNICIPIUL BUCURESTI",403,179196,,1113,0,"Bdul IULIU MANIU nr. 15 , Liceul TUDOR VLADIMIRESCU","BUCURESTI SECTORUL 6",6,179196,1,1,1604,921,815,106,887,34,1800,879,669,218,
42,"MUNICIPIUL BUCURESTI",403,179196,,1114,0,"Bdul IULIU MANIU nr. 15 , Liceul TUDOR VLADIMIRESCU","BUCURESTI SECTORUL 6",6,179196,1,1,1174,578,538,40,568,10,1200,622,426,142,
42,"MUNICIPIUL BUCURESTI",403,179196,,1115,0,"Bdul IULIU MANIU nr. 15 , Liceul TUDOR VLADIMIRESCU","BUCURESTI SECTORUL 6",6,179196,1,1,1407,797,730,67,780,16,1600,803,635,145,
42,"MUNICIPIUL BUCURESTI",403,179196,,1116,0,"Cal. PLEVNEI nr. 124 , Club Sportiv Scolar nr. 5","BUCURESTI SECTORUL 6",6,179196,1,1,1270,726,558,168,708,18,1200,474,568,140,
42,"MUNICIPIUL BUCURESTI",403,179196,,1117,0,"Str. ECONOM CEZARESCU nr. 47 , Scoala de Arte si Meserii SPIRU HARET","BUCURESTI SECTORUL 6",6,179196,1,1,621,428,201,227,420,8,1000,572,289,131,
42,"MUNICIPIUL BUCURESTI",403,179196,,1118,0,"Cal. GIULESTI nr. 7 , Scoala Generala nr. 168","BUCURESTI SECTORUL 6",6,179196,1,1,1801,804,694,110,786,18,1800,996,585,201,
42,"MUNICIPIUL BUCURESTI",403,179196,,1119,0,"Cal. GIULESTI nr. 7 , Scoala Generala nr. 168","BUCURESTI SECTORUL 6",6,179196,1,1,1528,725,623,102,711,14,1600,875,525,186,
42,"MUNICIPIUL BUCURESTI",403,179196,,1120,0,"Str. ALIZEULUI nr. 9 , Scoala Generala nr. 168","BUCURESTI SECTORUL 6",6,179196,1,1,1223,613,529,84,594,19,1400,787,452,142,
42,"MUNICIPIUL BUCURESTI",403,179196,,1121,0,"Str. ALIZEULUI nr. 9 , Scoala Generala nr. 168","BUCURESTI SECTORUL 6",6,179196,1,1,1414,632,606,26,627,5,1600,968,454,173,
42,"MUNICIPIUL BUCURESTI",403,179196,,1122,0,"Sos. VIRTUTII nr. 9-11 , Scoala Generala nr. 167","BUCURESTI SECTORUL 6",6,179196,1,1,1775,1091,819,272,1071,20,1800,709,713,358,
42,"MUNICIPIUL BUCURESTI",403,179196,,1123,0,"Sos. VIRTUTII nr. 9-11 , Scoala Generala nr. 167","BUCURESTI SECTORUL 6",6,179196,1,1,1461,746,569,177,732,14,1600,854,488,244,
42,"MUNICIPIUL BUCURESTI",403,179196,,1124,0,"Sos. VIRTUTII nr. 9-11 , Scoala Generala nr. 167","BUCURESTI SECTORUL 6",6,179196,1,1,1675,872,722,150,849,23,1800,928,593,256,
42,"MUNICIPIUL BUCURESTI",403,179196,,1125,0,"Str. RUSETU nr. 17 , Liceul MARIN PREDA","BUCURESTI SECTORUL 6",6,179196,1,1,1593,800,723,77,791,9,1600,800,586,205,
42,"MUNICIPIUL BUCURESTI",403,179196,,1126,0,"Str. PORUMBACU nr. 5 , Grup Scolar Industrial TEHNOMETAL","BUCURESTI SECTORUL 6",6,179196,1,1,1741,793,711,82,770,23,1800,1007,539,231,
42,"MUNICIPIUL BUCURESTI",403,179196,,1127,0,"Str. PORUMBACU nr. 5 , Grup Scolar Industrial TEHNOMETAL","BUCURESTI SECTORUL 6",6,179196,1,1,1766,909,813,96,898,11,1800,891,616,282,
42,"MUNICIPIUL BUCURESTI",403,179196,,1128,0,"Str. PORUMBACU nr. 5 , Grup Scolar Industrial TEHNOMETAL","BUCURESTI SECTORUL 6",6,179196,1,1,1972,858,794,64,839,19,2000,1142,610,229,
42,"MUNICIPIUL BUCURESTI",403,179196,,1129,0,"Str. PORUMBACU nr. 5 , Grup Scolar Industrial TEHNOMETAL","BUCURESTI SECTORUL 6",6,179196,1,1,1588,644,587,57,637,7,1600,956,422,215,
42,"MUNICIPIUL BUCURESTI",403,179196,,1130,0,"Str. PORUMBACU nr. 5 , Grup Scolar Industrial TEHNOMETAL","BUCURESTI SECTORUL 6",6,179196,1,1,1454,672,624,48,666,6,1600,928,464,202,
42,"MUNICIPIUL BUCURESTI",403,179196,,1131,0,"Str. PORUMBACU nr. 5 , Grup Scolar Industrial TEHNOMETAL","BUCURESTI SECTORUL 6",6,179196,1,1,1305,630,605,25,616,14,1400,770,410,206,
42,"MUNICIPIUL BUCURESTI",403,179196,,1132,0,"Str. PORUMBACU nr. 5 , Grup Scolar Industrial TEHNOMETAL","BUCURESTI SECTORUL 6",6,179196,1,1,1518,703,667,36,691,12,1600,897,509,182,
42,"MUNICIPIUL BUCURESTI",403,179196,,1133,0,"Str. PORUMBACU nr. 5 , Grup Scolar Industrial TEHNOMETAL","BUCURESTI SECTORUL 6",6,179196,1,1,1286,614,572,42,605,9,1400,786,451,154,
42,"MUNICIPIUL BUCURESTI",403,179196,,1134,0,"Str. TABLA BUTII nr. 60 , Gradinita nr. 40","BUCURESTI SECTORUL 6",6,179196,1,1,1689,871,789,82,863,8,1800,929,602,261,
42,"MUNICIPIUL BUCURESTI",403,179196,,1135,0,"Str. TABLA BUTII nr. 60 , Gradinita nr. 40","BUCURESTI SECTORUL 6",6,179196,1,1,1717,838,775,63,817,21,1800,962,572,245,
42,"MUNICIPIUL BUCURESTI",403,179196,,1136,0,"Str. TABLA BUTII nr. 60 , Gradinita nr. 40","BUCURESTI SECTORUL 6",6,179196,1,1,1105,579,435,144,565,14,1200,621,387,178,
42,"MUNICIPIUL BUCURESTI",403,179196,,1137,0,"Str. TABLA BUTII nr. 60 , Gradinita nr. 40","BUCURESTI SECTORUL 6",6,179196,1,1,906,576,377,199,570,6,1000,424,408,162,
42,"MUNICIPIUL BUCURESTI",403,179196,,1138,0,"Cal. GIULESTI nr. 34 , Scoala Generala nr. 163","BUCURESTI SECTORUL 6",6,179196,1,1,1321,710,635,75,702,8,1398,688,505,197,
42,"MUNICIPIUL BUCURESTI",403,179196,,1139,0,"Cal. GIULESTI nr. 34 , Scoala Generala nr. 163","BUCURESTI SECTORUL 6",6,179196,1,1,1305,655,618,37,630,25,1400,745,422,208,
42,"MUNICIPIUL BUCURESTI",403,179196,,1140,0,"Cal. GIULESTI nr. 34 , Scoala Generala nr. 163","BUCURESTI SECTORUL 6",6,179196,1,1,1489,848,796,52,832,16,1600,752,647,185,
42,"MUNICIPIUL BUCURESTI",403,179196,,1141,0,"Cal. GIULESTI nr. 34 , Scoala Generala nr. 163","BUCURESTI SECTORUL 6",6,179196,1,1,1241,646,604,42,632,14,1400,754,500,132,
42,"MUNICIPIUL BUCURESTI",403,179196,,1142,0,"Cal. GIULESTI nr. 34 , Scoala Generala nr. 163","BUCURESTI SECTORUL 6",6,179196,1,1,1350,790,723,67,775,15,1402,612,584,191,
42,"MUNICIPIUL BUCURESTI",403,179196,,1143,0,"Str. RUSETU nr. 13 , Liceul MARIN PREDA","BUCURESTI SECTORUL 6",6,179196,1,1,1364,716,668,48,701,15,1400,684,544,157,
42,"MUNICIPIUL BUCURESTI",403,179196,,1144,0,"Str. RUSETU nr. 13 , Liceul MARIN PREDA","BUCURESTI SECTORUL 6",6,179196,1,1,1416,800,746,54,785,15,1600,800,596,189,
42,"MUNICIPIUL BUCURESTI",403,179196,,1145,0,"Str. RUSETU nr. 13 , Liceul MARIN PREDA","BUCURESTI SECTORUL 6",6,179196,1,1,1112,641,583,58,626,15,1200,559,449,177,
42,"MUNICIPIUL BUCURESTI",403,179196,,1146,0,"Str. MEHADIA , Scoala Generala nr. 202","BUCURESTI SECTORUL 6",6,179196,1,1,1286,676,593,83,660,16,1400,724,485,175,
42,"MUNICIPIUL BUCURESTI",403,179196,,1147,0,"Str. MEHADIA , Scoala Generala nr. 202","BUCURESTI SECTORUL 6",6,179196,1,1,1232,492,449,43,484,8,1400,908,325,159,
42,"MUNICIPIUL BUCURESTI",403,179196,,1148,0,"Str. MEHADIA , Scoala Generala nr. 202","BUCURESTI SECTORUL 6",6,179196,1,1,1168,527,492,35,523,4,1200,673,380,143,
42,"MUNICIPIUL BUCURESTI",403,179196,,1149,0,"Str. MEHADIA , Scoala Generala nr. 202","BUCURESTI SECTORUL 6",6,179196,1,1,1570,715,663,52,705,10,1600,885,471,234,
42,"MUNICIPIUL BUCURESTI",403,179196,,1150,0,"Str. MEHADIA , Scoala Generala nr. 202","BUCURESTI SECTORUL 6",6,179196,1,1,1202,575,525,50,560,15,1400,825,395,165,
42,"MUNICIPIUL BUCURESTI",403,179196,,1151,0,"Str. MEHADIA , Scoala Generala nr. 202","BUCURESTI SECTORUL 6",6,179196,1,1,1158,563,518,45,555,8,1197,634,381,174,
42,"MUNICIPIUL BUCURESTI",403,179196,,1152,0,"Str. MEHADIA , Scoala Generala nr. 202","BUCURESTI SECTORUL 6",6,179196,1,1,1269,622,566,56,612,10,1400,778,442,170,
42,"MUNICIPIUL BUCURESTI",403,179196,,1153,0,"Cal. GIULESTI nr. 254 , Scoala Generala nr. 162","BUCURESTI SECTORUL 6",6,179196,1,1,1694,878,776,102,861,17,1800,922,607,254,
42,"MUNICIPIUL BUCURESTI",403,179196,,1154,0,"Str. DRUMUL SABARENI nr. 21 , Scoala Generala nr. 153","BUCURESTI SECTORUL 6",6,179196,1,1,1995,1055,861,194,1040,15,2000,945,726,314,
42,"MUNICIPIUL BUCURESTI",403,179196,,1155,0,"Cal. GIULESTi nr.486A , Scoala Generala nr. 161","BUCURESTI SECTORUL 6",6,179196,1,1,1434,647,519,128,634,13,1404,757,459,175,
42,"MUNICIPIUL BUCURESTI",403,179141,,1201,1,"Str. MIRCEA VULCANESCU  nr. 88 , U.M. 02482 Bucuresti","BUCURESTI SECTORUL 1",1,179141,1,1,0,937,0,937,925,12,1964,1027,634,291,
42,"MUNICIPIUL BUCURESTI",403,179141,,1202,1,"Sos. BUCURESTI - PLOIESTI km 12,5 , U.M. 01668","BUCURESTI SECTORUL 1",1,179141,1,1,0,340,0,340,324,16,506,166,182,142,
42,"MUNICIPIUL BUCURESTI",403,179141,,1203,1,"Str. CRINULUI  nr. 2 , U.M. 01659","BUCURESTI SECTORUL 1",1,179141,1,1,0,426,0,426,408,18,550,124,256,152,
42,"MUNICIPIUL BUCURESTI",403,179141,,1204,1,"Al. PADINA  nr. 3 , U.M. 01829","BUCURESTI SECTORUL 1",1,179141,1,1,0,262,0,262,254,8,297,35,156,98,
42,"MUNICIPIUL BUCURESTI",403,179141,,1205,1,"Str. JANDARMERIEI  nr. 9 - 11 , CAZARMA BANEASA","BUCURESTI SECTORUL 1",1,179141,1,1,0,2064,0,2064,2007,57,2475,411,1206,801,
42,"MUNICIPIUL BUCURESTI",403,179141,,1206,1,"Str. AV. ALEXANDRU ERBANESCU  nr. 4 , Sectia A 4 - A POMPIERI","BUCURESTI SECTORUL 1",1,179141,1,1,0,134,0,134,131,3,211,77,93,38,
42,"MUNICIPIUL BUCURESTI",403,179141,,1207,1,"Al. PRIVIGHETORILOR  nr. 1 , Academia de Politie ALEXANDRU IOAN CUZA","BUCURESTI SECTORUL 1",1,179141,1,1,0,1766,0,1766,1684,82,2050,284,855,829,
42,"MUNICIPIUL BUCURESTI",403,179150,,1208,1,"B-dul FERDINAND 1 nr. 139 , Detasamentul 2 Pompieri","BUCURESTI SECTORUL 2",2,179150,1,1,0,212,0,212,201,11,600,388,126,75,
42,"MUNICIPIUL BUCURESTI",403,179169,,1209,1,"Str. PAPAHAGI PERICLE nr. 4, Sectia 7 Pompieri","BUCURESTI SECTORUL 3",3,179169,1,1,0,96,0,96,91,5,200,104,66,25,
42,"MUNICIPIUL BUCURESTI",403,179178,,1210,1,"Sos. OLTENITEI nr. 227 , U.M. 01046","BUCURESTI SECTORUL 4",4,179178,1,1,0,288,0,288,279,9,1000,712,173,106,
42,"MUNICIPIUL BUCURESTI",403,179178,,1211,1,"Str. GEORGE GEORGESCU nr. 2-4 , Cazarma U.M. 0530","BUCURESTI SECTORUL 4",4,179178,1,1,0,641,0,641,622,19,1000,359,373,249,
42,"MUNICIPIUL BUCURESTI",403,179178,,1212,1,"Cal. VITAN BIRZESTI nr. 24 , Sectia a 8-a POMPIERI","BUCURESTI SECTORUL 4",4,179178,1,1,0,279,97,182,270,9,800,521,185,85,
42,"MUNICIPIUL BUCURESTI",403,179187,,1213,1,"Sos. ANTIAERIANA nr. 6-8 , U.M. 01210","BUCURESTI SECTORUL 5",5,179187,1,1,142,183,128,55,177,6,300,117,95,82,
42,"MUNICIPIUL BUCURESTI",403,179187,,1214,1,"Bdul GHENCEA nr. 35-37 , U.M. 02210","BUCURESTI SECTORUL 5",5,179187,1,1,0,314,0,314,302,12,703,389,186,116,
42,"MUNICIPIUL BUCURESTI",403,179187,,1215,1,"Bdul GEORGE COSBUC nr. 81-83 , U.M. 02648","BUCURESTI SECTORUL 5",5,179187,1,1,0,218,0,218,217,1,600,382,119,98,
42,"MUNICIPIUL BUCURESTI",403,179187,,1216,1,"Sos. MAGURELE nr. 33 , U.M. 01656","BUCURESTI SECTORUL 5",5,179187,1,1,0,291,0,291,279,12,700,409,160,119,
42,"MUNICIPIUL BUCURESTI",403,179187,,1217,1,"Sos ANTIAERIANA nr. 8 , U.M. 01436","BUCURESTI SECTORUL 5",5,179187,1,1,0,1312,0,1312,1262,50,1600,288,728,534,
42,"MUNICIPIUL BUCURESTI",403,179187,,1218,1,"Str. ELIE RADU nr. 2 , Detasamentul I POMPIERI","BUCURESTI SECTORUL 5",5,179187,1,1,0,462,0,462,452,10,700,238,300,152,
42,"MUNICIPIUL BUCURESTI",403,179196,,1219,1,"Str. GL.VASILE MILEA nr. 5-7 , U.M. 01026","BUCURESTI SECTORUL 6",6,179196,1,1,0,1186,0,1186,1159,27,2000,814,591,568,
42,"MUNICIPIUL BUCURESTI",403,179196,,1220,1,"Str. Lt. Col. MARINESCU CONSTANTIN nr. 6 , U.M. 02456","BUCURESTI SECTORUL 6",6,179196,1,1,0,364,0,364,357,7,600,236,229,128,
42,"MUNICIPIUL BUCURESTI",403,179196,,1221,1,"Str. BARBATESTI nr. 1 , Cazarma U.M. 0456","BUCURESTI SECTORUL 6",6,179196,1,1,1040,958,927,31,933,25,1200,242,563,370,
42,"MUNICIPIUL BUCURESTI",403,179196,,1222,1,"Bdul TIMISOARA nr. 22 , Statia a III-a POMPIERI","BUCURESTI SECTORUL 6",6,179196,1,1,0,125,0,125,121,4,200,75,73,48,
42,"MUNICIPIUL BUCURESTI",403,179141,,1301,1,"B-dul MARASTI  nr. 17 , Spitalul ELIAS","BUCURESTI SECTORUL 1",1,179141,1,1,0,340,0,340,332,7,770,430,262,70,
42,"MUNICIPIUL BUCURESTI",403,179141,,1302,1,"Cal. PLEVNEI  nr. 142 - 144 , Spitalul CFR nr. 1","BUCURESTI SECTORUL 1",1,179141,1,1,0,201,0,201,192,9,390,189,154,38,
42,"MUNICIPIUL BUCURESTI",403,179141,,1303,1,"B-dul MARASTI  nr. 63 , Spitalul CFR nr. 2","BUCURESTI SECTORUL 1",1,179141,1,1,0,179,0,179,177,2,682,503,125,52,
42,"MUNICIPIUL BUCURESTI",403,179141,,1304,1,"B-dul MARASTI  nr. 59 , Caminul Institutului Agronomic","BUCURESTI SECTORUL 1",1,179141,1,1,0,1280,0,1280,1251,29,2750,1470,879,372,
42,"MUNICIPIUL BUCURESTI",403,179141,,1305,1,"Str. MIHAIL MOXA  nr. 11 , Caminul A.S.E.","BUCURESTI SECTORUL 1",1,179141,1,1,0,500,0,500,491,9,1650,1150,434,57,
42,"MUNICIPIUL BUCURESTI",403,179141,,1306,1,"P-ta GARII DE NORD  nr. 1 , GARA DE NORD","BUCURESTI SECTORUL 1",1,179141,1,1,0,2693,0,2693,2657,36,10001,7308,1839,818,
42,"MUNICIPIUL BUCURESTI",403,179150,,1307,1,"Str. ION MOVILA nr. 5 - 7 , Spitalul CANTACUZINO","BUCURESTI SECTORUL 2",2,179150,1,1,0,307,0,307,301,6,2000,1693,227,74,
42,"MUNICIPIUL BUCURESTI",403,179150,,1308,1,"Sos. PANTELIMON nr. 340 , Spitalul SF. PANTELIMON","BUCURESTI SECTORUL 2",2,179150,1,1,0,303,0,303,298,5,1000,697,235,63,
42,"MUNICIPIUL BUCURESTI",403,179150,,1309,1,"Sos. STEFAN CEL MARE nr. 19 - 21 , Spitalul PROF.DR.N.GH.LUPU","BUCURESTI SECTORUL 2",2,179150,1,1,0,396,0,396,393,3,1600,1204,297,96,
42,"MUNICIPIUL BUCURESTI",403,179150,,1310,1,"Sos. FUNDENI nr. 258 , Spitalul FUNDENI","BUCURESTI SECTORUL 2",2,179150,1,1,0,946,0,946,937,9,2400,1454,733,204,
42,"MUNICIPIUL BUCURESTI",403,179150,,1311,1,"Str. DR.GROZOVICI nr. 1 , Spitalul COLENTINA","BUCURESTI SECTORUL 2",2,179150,1,1,0,192,0,192,189,3,1200,1008,130,59,
42,"MUNICIPIUL BUCURESTI",403,179150,,1312,1,"Str. INGINERILOR TEI nr. 11 , Caminul nr.3 al Universitatii Teh. Construc","BUCURESTI SECTORUL 2",2,179150,1,1,0,792,0,792,760,32,2400,1608,533,227,
42,"MUNICIPIUL BUCURESTI",403,179169,,1313,1,"Sos. MIHAI BRAVU nr. 281 , Spitalul VICTOR BABES","BUCURESTI SECTORUL 3",3,179169,1,1,0,376,0,376,355,21,906,530,299,56,
42,"MUNICIPIUL BUCURESTI",403,179178,,1314,1,"Sos. BERCENI nr. 12 , Spitalul SF. LUCA","BUCURESTI SECTORUL 4",4,179178,1,1,0,841,0,841,835,6,2400,1559,614,221,
42,"MUNICIPIUL BUCURESTI",403,179178,,1315,1,"Sos. VITAN BIRZESTI nr. 13 , Spitalul SF. IOAN","BUCURESTI SECTORUL 4",4,179178,1,1,0,383,0,383,380,3,1000,617,301,79,
42,"MUNICIPIUL BUCURESTI",403,179178,,1316,1,"Str. MOLDOVITA nr. 5 , Caminul C2 al Universitatii SPIRU HARET","BUCURESTI SECTORUL 4",4,179178,1,1,0,247,0,247,239,8,800,553,171,68,
42,"MUNICIPIUL BUCURESTI",403,179187,,1317,1,"Spl. INDEPENDENTEI nr. 169 , Spitalul Universitar BUCURESTI","BUCURESTI SECTORUL 5",5,179187,1,1,0,946,0,946,926,20,1404,458,711,215,
42,"MUNICIPIUL BUCURESTI",403,179187,,1318,1,"Bdul MIHAIL KOGALNICEANU nr. 36-46 , Caminul Facultatii de Drept","BUCURESTI SECTORUL 5",5,179187,1,1,0,427,0,427,419,8,1900,1473,335,84,
42,"MUNICIPIUL BUCURESTI",403,179196,,1319,1,"Str. PASCAL CRISTIAN nr. 11 , Spitalul STUDENTESC","BUCURESTI SECTORUL 6",6,179196,1,1,0,420,0,420,401,19,1000,580,320,81,
42,"MUNICIPIUL BUCURESTI",403,179196,,1320,1,"Bdul IULIU MANIU nr. 1-3 , Caminul A COMPLEX LEU al Universitati","BUCURESTI SECTORUL 6",6,179196,1,1,0,689,0,689,667,22,1800,1111,522,145,
42,"MUNICIPIUL BUCURESTI",403,179196,,1321,1,"Spl. INDEPENDENTEI nr. 290 , Cantina R1 Complex REGIEI al UPB","BUCURESTI SECTORUL 6",6,179196,1,1,0,970,0,970,933,37,2000,1030,708,225,
42,"MUNICIPIUL BUCURESTI",403,179196,,1322,1,"Spl. INDEPENDENTEI nr. 290 , Cantina R1 Complex REGIEI al UPB","BUCURESTI SECTORUL 6",6,179196,1,1,0,803,0,803,777,26,2000,1197,514,263,
42,"MUNICIPIUL BUCURESTI",403,179196,,1323,1,"Spl. INDEPENDENTEI nr. 290 , Cantina R2 Complex REGIEI al UPB","BUCURESTI SECTORUL 6",6,179196,1,1,0,521,0,521,501,20,2000,1479,335,166,
42,"MUNICIPIUL BUCURESTI",403,179196,,1324,1,"Spl. INDEPENDENTEI nr. 290 , Cantina R3 Complex REGIEI al UPB","BUCURESTI SECTORUL 6",6,179196,1,1,0,609,0,609,596,13,2000,1391,448,148,
42,"MUNICIPIUL BUCURESTI",403,179196,,1325,1,"Spl. INDEPENDENTEI nr. 290 , Cantina R3 Complex REGIEI al UPB","BUCURESTI SECTORUL 6",6,179196,1,1,0,760,0,760,743,17,2200,1440,611,132,
42,"MUNICIPIUL BUCURESTI",403,179196,,1326,1,"Spl. INDEPENDENTEI nr. 192 , Caminul E al Univ. de Medicina si Farmacie","BUCURESTI SECTORUL 6",6,179196,1,1,0,173,0,173,165,8,1210,1037,128,37,
42,"MUNICIPIUL BUCURESTI",403,179196,,1327,1,"Spl. INDEPENDENTEI nr. 192 , Caminul P20 al Univ.de Medicina si Farmacie","BUCURESTI SECTORUL 6",6,179196,1,1,0,716,0,716,703,13,2004,1288,592,111,
42,"MUNICIPIUL BUCURESTI",403,179196,,1328,1,"Spl. INDEPENDENTEI nr. 192 , Cantina Grozavesti a Universitatii Bucuresti","BUCURESTI SECTORUL 6",6,179196,1,1,0,620,0,620,599,21,2202,1582,500,99,
42,"MUNICIPIUL BUCURESTI",,,"ZA",1400,2,,"AFRICA DE SUD - PRETORIA  1401/1",1,179141,1,1,0,31,0,31,31,0,200,169,20,11,
42,"MUNICIPIUL BUCURESTI",,,"ZA",1401,2,,"AFRICA DE SUD - CAPE TOWN 1401/2",1,179141,1,1,0,34,0,34,34,0,100,66,19,15,
42,"MUNICIPIUL BUCURESTI",,,"ZA",1402,2,,"AFRICA DE SUD - DURBAN 1401/3",1,179141,1,1,0,5,0,5,4,1,100,95,3,1,
42,"MUNICIPIUL BUCURESTI",,,"AL",1403,2,,"ALBANIA - TIRANA 1402",1,179141,1,1,0,35,0,35,35,0,100,65,25,10,
42,"MUNICIPIUL BUCURESTI",,,"DZ",1404,2,,"ALGERIA - ALGER 1403",1,179141,1,1,0,51,0,51,49,2,100,49,42,7,
42,"MUNICIPIUL BUCURESTI",,,"AO",1405,2,,"ANGOLA - LUANDA 1404",1,179141,1,1,0,15,0,15,15,0,100,85,14,1,
42,"MUNICIPIUL BUCURESTI",,,"SA",1406,2,,"ARABIA SAUDITA - RIYADH 1405",1,179141,1,1,0,34,0,34,34,0,200,166,27,7,
42,"MUNICIPIUL BUCURESTI",,,"AR",1407,2,,"ARGENTINA - BUENOS AIRES 1406",1,179141,1,1,0,63,0,63,61,2,300,237,40,21,
42,"MUNICIPIUL BUCURESTI",,,"AM",1408,2,,"ARMENIA - EREVAN 1407",1,179141,1,1,0,7,0,7,7,0,100,93,7,0,
42,"MUNICIPIUL BUCURESTI",,,"AU",1409,2,,"AUSTRALIA CANBERRA 1408/1",1,179141,1,1,0,20,0,20,19,1,100,80,14,5,
42,"MUNICIPIUL BUCURESTI",,,"AU",1410,2,,"AUSTRALIA MELBOURNE 1408/2",1,179141,1,1,0,49,0,49,45,4,500,451,29,16,
42,"MUNICIPIUL BUCURESTI",,,"AU",1411,2,,"AUSTRALIA SYDNEY 1408/3",1,179141,1,1,0,30,0,30,29,1,400,370,19,10,
42,"MUNICIPIUL BUCURESTI",,,"AT",1412,2,,"AUSTRIA - VIENA 1409",1,179141,1,1,0,356,0,356,345,11,2000,1644,246,99,
42,"MUNICIPIUL BUCURESTI",,,"AZ",1413,2,,"AZERBAIDJAN - BAKU 1410",1,179141,1,1,0,22,0,22,22,0,100,78,18,4,
42,"MUNICIPIUL BUCURESTI",,,"BY",1414,2,,"BELARUS - MINSK 1411",1,179141,1,1,0,7,0,7,7,0,100,93,7,0,
42,"MUNICIPIUL BUCURESTI",,,"BE",1415,2,,"BELGIA - BRUXELLES 1412",1,179141,1,1,0,381,0,381,366,15,2000,1619,281,85,
42,"MUNICIPIUL BUCURESTI",,,"BA",1416,2,,"BOSNIA-HERTEGOVINA - SARAJEVO 1413",1,179141,1,1,0,69,0,69,68,1,100,31,37,31,
42,"MUNICIPIUL BUCURESTI",,,"BR",1417,2,,"BRAZILIA - BRASILIA 1414/1",1,179141,1,1,0,21,0,21,20,1,30,9,17,3,
42,"MUNICIPIUL BUCURESTI",,,"BR",1418,2,,"BRAZILIA - RIO DE JANEIRO 1414/2",1,179141,1,1,0,21,0,21,21,0,135,114,12,9,
42,"MUNICIPIUL BUCURESTI",,,"BR",1419,2,,"BRAZILIA - SAO PAOLO 1414/3",1,179141,1,1,0,20,0,20,20,0,135,115,15,5,
42,"MUNICIPIUL BUCURESTI",,,"BG",1420,2,,"BULGARIA - SOFIA 1415",1,179141,1,1,0,65,0,65,62,3,300,235,55,7,
42,"MUNICIPIUL BUCURESTI",,,"CM",1421,2,,"CAMERUN - YAOUNDE 1416/1",1,179141,1,1,0,0,0,0,0,0,0,0,0,0,
42,"MUNICIPIUL BUCURESTI",,,"CM",1422,2,,"CAMERUN - DOUALA 1416/2",1,179141,1,1,0,0,0,0,0,0,0,0,0,0,
42,"MUNICIPIUL BUCURESTI",,,"CA",1423,2,,"CANADA - OTTAWA 1417/1",1,179141,1,1,0,86,0,86,86,0,2000,1914,69,17,
42,"MUNICIPIUL BUCURESTI",,,"CA",1424,2,,"CANADA - MONTREAL 1417/2",1,179141,1,1,0,165,0,165,162,3,3000,2835,103,59,
42,"MUNICIPIUL BUCURESTI",,,"CA",1425,2,,"CANADA - TORONTO 1417/3",1,179141,1,1,0,181,0,181,176,5,2500,2319,128,48,
42,"MUNICIPIUL BUCURESTI",,,"CZ",1426,2,,"CEHIA - PRAGA 1418",1,179141,1,1,0,118,0,118,117,1,500,382,85,32,
42,"MUNICIPIUL BUCURESTI",,,"CL",1427,2,,"CHILE - SANTIAGO DE CHILE 1419",1,179141,1,1,0,11,0,11,11,0,50,39,11,0,
42,"MUNICIPIUL BUCURESTI",,,"CN",1428,2,,"CHINA - BEIJING 1420/1",1,179141,1,1,0,76,0,76,74,2,350,274,65,9,
42,"MUNICIPIUL BUCURESTI",,,"CN",1429,2,,"CHINA - SHANGHAI 1420/2",1,179141,1,1,0,9,0,9,9,0,50,41,7,2,
42,"MUNICIPIUL BUCURESTI",,,"CY",1430,2,,"CIPRU - NICOSIA 1421",1,179141,1,1,0,208,0,208,203,5,800,592,105,98,
42,"MUNICIPIUL BUCURESTI",,,"CO",1431,2,,"COLUMBIA - BOGOTA 1422",1,179141,1,1,0,32,0,32,32,0,100,68,31,1,
42,"MUNICIPIUL BUCURESTI",,,"KP",1432,2,,"COREEA DE NORD - PHENIAN 1423",1,179141,1,1,0,8,0,8,8,0,100,92,2,6,
42,"MUNICIPIUL BUCURESTI",,,"KR",1433,2,,"COREEA DE SUD - SEOUL 1424",1,179141,1,1,0,29,0,29,27,2,100,71,23,4,
42,"MUNICIPIUL BUCURESTI",,,"HR",1434,2,,"CROATIA - ZAGREB 1425",1,179141,1,1,0,36,0,36,34,2,200,164,27,7,
42,"MUNICIPIUL BUCURESTI",,,"CU",1435,2,,"CUBA - HAVANA 1426",1,179141,1,1,0,14,0,14,14,0,100,86,14,0,
42,"MUNICIPIUL BUCURESTI",,,"DK",1436,2,,"DANEMARCA - COPENHAGA 1427",1,179141,1,1,0,59,0,59,56,3,700,641,43,13,
42,"MUNICIPIUL BUCURESTI",,,"EG",1437,2,,"EGIPT - CAIRO 1428",1,179141,1,1,0,74,0,74,74,0,300,226,54,20,
42,"MUNICIPIUL BUCURESTI",,,"CH",1438,2,,"ELVETIA - BERNA 1429/1",1,179141,1,1,0,28,0,28,26,2,100,72,20,6,
42,"MUNICIPIUL BUCURESTI",,,"CH",1439,2,,"ELVETIA - GENEVA 1429/2",1,179141,1,1,0,149,0,149,133,16,1500,1351,118,15,
42,"MUNICIPIUL BUCURESTI",,,"AE",1440,2,,"EMIRATE ARABE UNITE-ABU DHABI 1430/1",1,179141,1,1,0,94,0,94,94,0,500,406,57,37,
42,"MUNICIPIUL BUCURESTI",,,"AE",1441,2,,"EMIRATELE ARABE UNITE-DUBAI 1430/2",1,179141,1,1,0,51,0,51,50,1,500,449,34,16,
42,"MUNICIPIUL BUCURESTI",,,"ET",1442,2,,"ETIOPIA - ADDIS ABEBA 1431",1,179141,1,1,0,8,0,8,8,0,100,92,6,2,
42,"MUNICIPIUL BUCURESTI",,,"PH",1443,2,,"FILIPINE - MANILA 1432",1,179141,1,1,0,17,0,17,17,0,100,83,7,10,
42,"MUNICIPIUL BUCURESTI",,,"FI",1444,2,,"FINLANDA - HELSINKI 1433",1,179141,1,1,0,103,0,103,100,3,400,297,89,11,
42,"MUNICIPIUL BUCURESTI",,,"FR",1445,2,,"FRANTA - PARIS 1434/1",1,179141,1,1,0,736,0,736,694,42,3000,2264,567,127,
42,"MUNICIPIUL BUCURESTI",,,"FR",1446,2,,"FRANTA - STRASBOURG 1434/2",1,179141,1,1,0,190,0,190,177,13,1000,810,134,43,
42,"MUNICIPIUL BUCURESTI",,,"FR",1447,2,,"FRANTA - MARSILIA 1434/3",1,179141,1,1,0,68,0,68,63,5,500,432,46,17,
42,"MUNICIPIUL BUCURESTI",,,"GE",1448,2,,"GEORGIA - TBILISI 1435",1,179141,1,1,0,11,0,11,11,0,200,189,9,2,
42,"MUNICIPIUL BUCURESTI",,,"DE",1449,2,,"GERMANIA - BERLIN 1436/1",1,179141,1,1,0,137,0,137,132,5,1500,1363,110,22,
42,"MUNICIPIUL BUCURESTI",,,"DE",1450,2,,"GERMANIA - BONN 1436/2",1,179141,1,1,0,129,0,129,127,2,1000,871,92,35,
42,"MUNICIPIUL BUCURESTI",,,"DE",1451,2,,"GERMANIA - MUNCHEN 1436/3",1,179141,1,1,0,423,0,423,413,10,1300,877,266,147,
42,"MUNICIPIUL BUCURESTI",,,"GR",1452,2,,"GRECIA - ATENA 1437/1",1,179141,1,1,0,422,0,422,410,12,2000,1578,273,137,
42,"MUNICIPIUL BUCURESTI",,,"GR",1453,2,,"GRECIA - SALONIC 1437/2",1,179141,1,1,0,169,0,169,168,1,500,331,113,55,
42,"MUNICIPIUL BUCURESTI",,,"IN",1454,2,,"INDIA - NEW DELHI 1438",1,179141,1,1,0,28,0,28,26,2,100,72,20,6,
42,"MUNICIPIUL BUCURESTI",,,"ID",1455,2,,"INDONEZIA - JAKARTA 1439",1,179141,1,1,0,19,0,19,19,0,100,81,9,10,
42,"MUNICIPIUL BUCURESTI",,,"JO",1456,2,,"IORDANIA - AMMAN 1440",1,179141,1,1,0,143,0,143,142,1,1000,857,80,62,
42,"MUNICIPIUL BUCURESTI",,,"IQ",1457,2,,"IRAK - BAGDAD 1441",1,179141,1,1,0,18,0,18,17,1,20,2,15,2,
42,"MUNICIPIUL BUCURESTI",,,"IR",1458,2,,"IRAN - TEHERAN 1442",1,179141,1,1,0,48,0,48,47,1,100,52,42,5,
42,"MUNICIPIUL BUCURESTI",,,"IE",1459,2,,"IRLANDA - DUBLIN 1443",1,179141,1,1,0,59,0,59,59,0,498,439,37,22,
42,"MUNICIPIUL BUCURESTI",,,"IL",1460,2,,"ISRAEL - TEL AVIV 1444/1",1,179141,1,1,0,360,0,360,350,10,400,40,257,93,
42,"MUNICIPIUL BUCURESTI",,,"IL",1461,2,,"ISRAEL - TEL AVIV  1444/2",1,179141,1,1,0,374,0,374,370,4,400,26,279,91,
42,"MUNICIPIUL BUCURESTI",,,"IL",1462,2,,"ISRAEL - IERUSALIM 1444/3",1,179141,1,1,0,412,0,412,396,16,800,388,227,169,
42,"MUNICIPIUL BUCURESTI",,,"IL",1463,2,,"ISRAEL - NAZARET ILLITH 1444/4",1,179141,1,1,0,93,0,93,93,0,600,507,84,9,
42,"MUNICIPIUL BUCURESTI",,,"IL",1464,2,,"ISRAEL - HAIFA 1444/5",1,179141,1,1,0,606,0,606,603,3,700,94,442,161,
42,"MUNICIPIUL BUCURESTI",,,"IL",1465,2,,"ISRAEL - NATANYA 1444/6",1,179141,1,1,0,202,0,202,198,4,299,97,101,97,
42,"MUNICIPIUL BUCURESTI",,,"IL",1466,2,,"ISRAEL - ASHDOD 1444/7",1,179141,1,1,0,163,0,163,163,0,200,37,133,30,
42,"MUNICIPIUL BUCURESTI",,,"IL",1467,2,,"ISRAEL - BEER SHEVA 1444/8",1,179141,1,1,0,264,0,264,261,3,300,36,147,114,
42,"MUNICIPIUL BUCURESTI",,,"IL",1468,2,,"ISRAEL - RISHON LE ZION 1444/9",1,179141,1,1,0,133,0,133,131,2,600,467,103,28,
42,"MUNICIPIUL BUCURESTI",,,"IL",1469,2,,"ISRAEL - MODI'N 1444/10",1,179141,1,1,0,135,0,135,131,4,135,0,56,75,
42,"MUNICIPIUL BUCURESTI",,,"IL",1470,2,,"ISRAEL - PETAH TIKVA 1444/11",1,179141,1,1,0,292,0,292,290,2,800,508,190,100,
42,"MUNICIPIUL BUCURESTI",,,"IT",1471,2,,"ITALIA - ROMA 1445/1",1,179141,1,1,0,474,0,474,460,14,500,26,246,214,
42,"MUNICIPIUL BUCURESTI",,,"IT",1472,2,,"ITALIA - MILANO 1445/2",1,179141,1,1,0,230,0,230,226,4,1000,770,130,96,
42,"MUNICIPIUL BUCURESTI",,,"YU",1473,2,,"IUGOSLAVIA - BELGRAD 1446",1,179141,1,1,0,70,0,70,70,0,1000,930,45,25,
42,"MUNICIPIUL BUCURESTI",,,"JP",1474,2,,"JAPONIA - TOKYO 1447",1,179141,1,1,0,69,0,69,65,4,1000,931,63,2,
42,"MUNICIPIUL BUCURESTI",,,"KZ",1475,2,,"KAZAHSTAN - ALMA ATA 1448/1",1,179141,1,1,0,17,0,17,16,1,140,123,13,3,
42,"MUNICIPIUL BUCURESTI",,,"KZ",1476,2,,"KAZAHSTAN - AKTAU 1448/2",1,179141,1,1,0,33,0,33,32,1,60,27,18,14,
42,"MUNICIPIUL BUCURESTI",,,"KE",1477,2,,"KENYA - NAIROBI 1449",1,179141,1,1,0,8,0,8,7,1,100,92,7,0,
42,"MUNICIPIUL BUCURESTI",,,"KW",1478,2,,"KUWAIT - AL KUWAIT 1450",1,179141,1,1,0,93,0,93,92,1,600,507,69,23,
42,"MUNICIPIUL BUCURESTI",,,"LB",1479,2,,"LIBAN - BEIRUT 1451",1,179141,1,1,0,94,0,94,94,0,500,406,64,30,
42,"MUNICIPIUL BUCURESTI",,,"LY",1480,2,,"LIBIA - TRIPOLI 1452/1",1,179141,1,1,0,54,0,54,54,0,392,338,32,22,
42,"MUNICIPIUL BUCURESTI",,,"LY",1481,2,,"LIBIA - UBARI 1452/2",1,179141,1,1,0,60,0,60,52,8,150,90,24,28,
42,"MUNICIPIUL BUCURESTI",,,"LY",1482,2,,"LIBIA - ABU KAMASH 1452/3",1,179141,1,1,0,56,0,56,55,1,150,94,28,27,
42,"MUNICIPIUL BUCURESTI",,,"LU",1483,2,,"LUXEMBOURG - LUXEMBOURG 1453",1,179141,1,1,0,64,0,64,63,1,600,536,58,5,
42,"MUNICIPIUL BUCURESTI",,,"MK",1484,2,,"MACEDONIA - SKOPJE 1454",1,179141,1,1,0,53,0,53,52,1,300,247,47,5,
42,"MUNICIPIUL BUCURESTI",,,"MY",1485,2,,"MALAYEZIA - KUALA LUMPUR 1455",1,179141,1,1,0,18,0,18,16,2,100,82,15,1,
42,"MUNICIPIUL BUCURESTI",,,"GB",1486,2,,"MAREA BRITANIE - LONDRA 1456",1,179141,1,1,0,278,0,278,272,6,2500,2222,225,47,
42,"MUNICIPIUL BUCURESTI",,,"MA",1487,2,,"MAROC - RABAT 1457/1",1,179141,1,1,0,0,0,0,0,0,0,0,0,0,
42,"MUNICIPIUL BUCURESTI",,,"MA",1488,2,,"MAROC - DAKHLA 1457/2",1,179141,1,1,0,108,0,108,106,2,400,292,78,28,
42,"MUNICIPIUL BUCURESTI",,,"MX",1489,2,,"MEXIC - CIUDAD DE MEXICO 1458",1,179141,1,1,0,50,0,50,48,2,200,150,43,5,
42,"MUNICIPIUL BUCURESTI",,,"MD",1490,2,,"MOLDOVA - CHISINAU 1459",1,179141,1,1,0,1019,0,1019,1018,1,5000,3981,448,570,
42,"MUNICIPIUL BUCURESTI",,,"NG",1491,2,,"NIGERIA - LAGOS 1460/1",1,179141,1,1,0,40,0,40,38,2,200,160,35,3,
42,"MUNICIPIUL BUCURESTI",,,"NO",1492,2,,"NORVEGIA - OSLO 1461",1,179141,1,1,0,42,0,42,41,1,300,258,27,14,
42,"MUNICIPIUL BUCURESTI",,,"NL",1493,2,,"OLANDA - HAGA 1462",1,179141,1,1,0,201,0,201,197,4,800,599,158,39,
42,"MUNICIPIUL BUCURESTI",,,"PK",1494,2,,"PAKISTAN - ISLAMABAD 1463",1,179141,1,1,0,13,0,13,10,3,100,87,6,4,
42,"MUNICIPIUL BUCURESTI",,,"PE",1495,2,,"PERU - LIMA 1464",1,179141,1,1,0,26,0,26,26,0,100,74,24,2,
42,"MUNICIPIUL BUCURESTI",,,"PL",1496,2,,"POLONIA - VARSOVIA 1465",1,179141,1,1,0,74,0,74,71,3,400,326,60,11,
42,"MUNICIPIUL BUCURESTI",,,"PT",1497,2,,"PORTUGALIA - LISABONA 1466",1,179141,1,1,0,123,0,123,118,5,800,677,59,59,
42,"MUNICIPIUL BUCURESTI",,,"QA",1498,2,,"QATAR - DOHA 1467",1,179141,1,1,0,24,0,24,20,4,300,276,15,5,
42,"MUNICIPIUL BUCURESTI",,,"RU",1499,2,,"FEDERATIA RUSA - MOSCOVA 1468",1,179141,1,1,0,133,0,133,131,2,300,167,113,18,
42,"MUNICIPIUL BUCURESTI",,,"US",1500,2,,"S.U.A. - WASHINGTON (D.C.) 1469/1",1,179141,1,1,0,193,0,193,182,11,6500,6307,160,22,
42,"MUNICIPIUL BUCURESTI",,,"US",1501,2,,"S.U.A. - NEW YORK 1469/2",1,179141,1,1,0,362,0,362,351,11,5000,4638,229,122,
42,"MUNICIPIUL BUCURESTI",,,"US",1502,2,,"S.U.A. - LOS ANGELES 1469/3",1,179141,1,1,0,107,0,107,106,1,4400,4293,54,52,
42,"MUNICIPIUL BUCURESTI",,,"US",1503,2,,"S.U.A. - CHICAGO 1469/4",1,179141,1,1,0,78,0,78,70,8,3000,2922,49,21,
42,"MUNICIPIUL BUCURESTI",,,"US",1504,2,,"S.U.A. - ATLANTA 1469/5",1,179141,1,1,0,69,0,69,66,3,400,331,41,25,
42,"MUNICIPIUL BUCURESTI",,,"US",1505,2,,"S.U.A. - DALLAS 1469/6",1,179141,1,1,0,30,0,30,30,0,600,570,28,2,
42,"MUNICIPIUL BUCURESTI",,,"US",1506,2,,"S.U.A. - NORFOLK 1469/7",1,179141,1,1,0,22,0,22,22,0,100,78,14,8,
42,"MUNICIPIUL BUCURESTI",,,"US",1507,2,,"S.U.A. - CLEVELAND 1469/8",1,179141,1,1,0,103,0,103,103,0,200,97,31,72,
42,"MUNICIPIUL BUCURESTI",,,"US",1508,2,,"S.U.A. - BOSTON 1469/9",1,179141,1,1,0,74,0,74,74,0,200,126,68,6,
42,"MUNICIPIUL BUCURESTI",,,"US",1509,2,,"S.U.A. - DETROIT 1469/10",1,179141,1,1,0,78,0,78,77,1,800,722,49,28,
42,"MUNICIPIUL BUCURESTI",,,"US",1510,2,,"S.U.A. - MINEAPOLIS 1469/11",1,179141,1,1,0,22,0,22,22,0,200,178,21,1,
42,"MUNICIPIUL BUCURESTI",,,"US",1511,2,,"S.U.A. - SAN FRANCISCO 1469/12",1,179141,1,1,0,41,0,41,40,1,400,359,33,7,
42,"MUNICIPIUL BUCURESTI",,,"US",1512,2,,"S.U.A. - LAS VEGAS 1469/13",1,179141,1,1,0,26,0,26,26,0,200,174,23,3,
42,"MUNICIPIUL BUCURESTI",,,"US",1513,2,,"S.U.A. - SLAT LAKE CITY 1469/14",1,179141,1,1,0,18,0,18,17,1,200,182,17,0,
42,"MUNICIPIUL BUCURESTI",,,"US",1514,2,,"S.U.A. - NEW ORLEANS 1469/15",1,179141,1,1,0,0,0,0,0,0,0,0,0,0,
42,"MUNICIPIUL BUCURESTI",,,"US",1515,2,,"S.U.A. - HOUSTON 1469/16",1,179141,1,1,0,0,0,0,0,0,0,0,0,0,
42,"MUNICIPIUL BUCURESTI",,,"US",1516,2,,"S.U.A. - HOLLYWOOD 1469/17",1,179141,1,1,0,100,0,100,100,0,200,100,41,59,
42,"MUNICIPIUL BUCURESTI",,,"US",1517,2,,"S.U.A. - PORTLAND 1469/18",1,179141,1,1,0,47,0,47,46,1,400,353,22,24,
42,"MUNICIPIUL BUCURESTI",,,"US",1518,2,,"S.U.A. - SEATTLE 1469/19",1,179141,1,1,0,64,0,64,64,0,400,336,52,12,
42,"MUNICIPIUL BUCURESTI",,,"US",1519,2,,"S.U.A. - BRIDGEPORT 1469/20",1,179141,1,1,0,41,0,41,41,0,200,159,11,30,
42,"MUNICIPIUL BUCURESTI",,,"US",1520,2,,"S.U.A. - LOS ANGELES-ANNAHEIM1469/21",1,179141,1,1,0,0,0,0,0,0,0,0,0,0,
42,"MUNICIPIUL BUCURESTI",,,"US",1521,2,,"S.U.A. - LOS ANGELES-GLENDALE1469/22",1,179141,1,1,0,32,0,32,32,0,200,168,21,11,
42,"MUNICIPIUL BUCURESTI",,,"SN",1522,2,,"SENEGAL - DAKAR 1470",1,179141,1,1,0,26,0,26,26,0,100,74,19,7,
42,"MUNICIPIUL BUCURESTI",,,"SG",1523,2,,"SINGAPORE - SINGAPORE 1471",1,179141,1,1,0,16,0,16,16,0,100,84,13,3,
42,"MUNICIPIUL BUCURESTI",,,"SY",1524,2,,"SIRIA - DAMASC 1472",1,179141,1,1,0,51,0,51,50,1,700,649,43,7,
42,"MUNICIPIUL BUCURESTI",,,"SK",1525,2,,"SLOVACIA - BRATISLAVA 1473",1,179141,1,1,0,43,0,43,40,3,100,57,30,10,
42,"MUNICIPIUL BUCURESTI",,,"SI",1526,2,,"SLOVENIA - LJUBLJANA 1474",1,179141,1,1,0,19,0,19,19,0,100,81,14,5,
42,"MUNICIPIUL BUCURESTI",,,"ES",1527,2,,"SPANIA - MADRID 1475",1,179141,1,1,0,533,0,533,516,17,1500,967,202,314,
42,"MUNICIPIUL BUCURESTI",,,"SD",1528,2,,"SUDAN - KHARTOUM 1476",1,179141,1,1,0,17,0,17,15,2,100,83,11,4,
42,"MUNICIPIUL BUCURESTI",,,"SE",1529,2,,"SUEDIA - STOCKHOLM 1477",1,179141,1,1,0,69,0,69,69,0,500,431,66,3,
42,"MUNICIPIUL BUCURESTI",,,"TH",1530,2,,"THAILANDA - BANGKOK 1478",1,179141,1,1,0,22,0,22,20,2,100,78,20,0,
42,"MUNICIPIUL BUCURESTI",,,"TN",1531,2,,"TUNISIA - TUNIS 1479",1,179141,1,1,0,33,0,33,33,0,300,267,25,8,
42,"MUNICIPIUL BUCURESTI",,,"TR",1532,2,,"TURCIA - ANKARA 1480/1",1,179141,1,1,0,55,0,55,55,0,200,145,48,7,
42,"MUNICIPIUL BUCURESTI",,,"TR",1533,2,,"TURCIA - ISTANBUL 1480/2",1,179141,1,1,0,80,0,80,80,0,1000,920,55,25,
42,"MUNICIPIUL BUCURESTI",,,"TM",1534,2,,"TURKMENISTAN - ASHABAT 1481/1",1,179141,1,1,0,12,0,12,12,0,300,288,9,3,
42,"MUNICIPIUL BUCURESTI",,,"TM",1535,2,,"TURKMENISTAN - BALKANABAT 1481/2",1,179141,1,1,0,0,0,0,0,0,0,0,0,0,
42,"MUNICIPIUL BUCURESTI",,,"TM",1536,2,,"TURKMENISTAN - MARI 1481/3",1,179141,1,1,0,0,0,0,0,0,0,0,0,0,
42,"MUNICIPIUL BUCURESTI",,,"UA",1537,2,,"UCRAINA - KIEV 1482/1",1,179141,1,1,0,20,0,20,20,0,100,80,15,5,
42,"MUNICIPIUL BUCURESTI",,,"UA",1538,2,,"UCRAINA - CERNAUTI 1482/2",1,179141,1,1,0,19,0,19,19,0,100,81,15,4,
42,"MUNICIPIUL BUCURESTI",,,"UA",1539,2,,"UCRAINA - ODESSA 1482/3",1,179141,1,1,0,79,0,79,79,0,200,121,53,26,
42,"MUNICIPIUL BUCURESTI",,,"HU",1540,2,,"UNGARIA - BUDAPESTA 1483/1",1,179141,1,1,0,963,0,963,953,10,3000,2037,887,66,
42,"MUNICIPIUL BUCURESTI",,,"HU",1541,2,,"UNGARIA - BUDAPESTA 1483/2",1,179141,1,1,0,185,0,185,182,3,2800,2615,162,20,
42,"MUNICIPIUL BUCURESTI",,,"HU",1542,2,,"UNGARIA - SZEGED 1483/3",1,179141,1,1,0,210,0,210,210,0,399,189,194,16,
42,"MUNICIPIUL BUCURESTI",,,"HU",1543,2,,"UNGARIA - DEBRECEN 1483/4",1,179141,1,1,0,133,0,133,133,0,1000,867,130,3,
42,"MUNICIPIUL BUCURESTI",,,"HU",1544,2,,"UNGARIA - PECS 1483/5",1,179141,1,1,0,44,0,44,41,3,600,556,39,2,
42,"MUNICIPIUL BUCURESTI",,,"HU",1545,2,,"UNGARIA - GYOR 1483/6",1,179141,1,1,0,43,0,43,43,0,600,557,42,1,
42,"MUNICIPIUL BUCURESTI",,,"UY",1546,2,,"URUGUAY - MONTEVIDEO 1484",1,179141,1,1,0,12,0,12,12,0,100,88,12,0,
42,"MUNICIPIUL BUCURESTI",,,"VE",1547,2,,"VENEZUELA - CARACAS 1485",1,179141,1,1,0,43,0,43,42,1,200,157,39,3,
42,"MUNICIPIUL BUCURESTI",,,"VN",1548,2,,"VIET'NAM - HANOI 1486",1,179141,1,1,0,12,0,12,12,0,100,88,11,1,
42,"MUNICIPIUL BUCURESTI",,,"YE",1549,2,,"YEMEN - SANA'A 1487/1",1,179141,1,1,0,21,0,21,21,0,200,179,8,13,
42,"MUNICIPIUL BUCURESTI",,,"YE",1550,2,,"YEMEN - BUREIKA 1487/2",1,179141,1,1,0,0,0,0,0,0,0,0,0,0,
42,"MUNICIPIUL BUCURESTI",,,"ZW",1551,2,,"ZIMBABWE - HARARE 1488",1,179141,1,1,0,14,0,14,12,2,100,86,10,2,
